Meetpunt surrogate key,Meetpunt locatie,Datum,Tijd,Aantal fietsers,Aantal fietsers van,Aantal fietsers naar,Meetpunt code
651,Kolonel Silvertopstraat 5333,2022-08-22,00:00:00,34,15,19,FMN 03 Kolonel Silvertopstraat
651,Kolonel Silvertopstraat 5333,2022-08-22,01:00:00,23,10,13,FMN 03 Kolonel Silvertopstraat
651,Kolonel Silvertopstraat 5333,2022-08-22,02:00:00,13,6,7,FMN 03 Kolonel Silvertopstraat
651,Kolonel Silvertopstraat 5333,2022-08-22,03:00:00,11,6,5,FMN 03 Kolonel Silvertopstraat
651,Kolonel Silvertopstraat 5333,2022-08-22,04:00:00,22,16,6,FMN 03 Kolonel Silvertopstraat
651,Kolonel Silvertopstraat 5333,2022-08-22,05:00:00,54,44,10,FMN 03 Kolonel Silvertopstraat
651,Kolonel Silvertopstraat 5333,2022-08-22,06:00:00,119,92,27,FMN 03 Kolonel Silvertopstraat
651,Kolonel Silvertopstraat 5333,2022-08-22,07:00:00,242,185,57,FMN 03 Kolonel Silvertopstraat
651,Kolonel Silvertopstraat 5333,2022-08-22,08:00:00,366,304,62,FMN 03 Kolonel Silvertopstraat
651,Kolonel Silvertopstraat 5333,2022-08-22,09:00:00,180,140,40,FMN 03 Kolonel Silvertopstraat
651,Kolonel Silvertopstraat 5333,2022-08-22,10:00:00,147,107,40,FMN 03 Kolonel Silvertopstraat
651,Kolonel Silvertopstraat 5333,2022-08-22,11:00:00,133,96,37,FMN 03 Kolonel Silvertopstraat
651,Kolonel Silvertopstraat 5333,2022-08-22,12:00:00,189,135,54,FMN 03 Kolonel Silvertopstraat
651,Kolonel Silvertopstraat 5333,2022-08-22,13:00:00,199,130,69,FMN 03 Kolonel Silvertopstraat
651,Kolonel Silvertopstraat 5333,2022-08-22,14:00:00,209,154,55,FMN 03 Kolonel Silvertopstraat
651,Kolonel Silvertopstraat 5333,2022-08-22,15:00:00,166,115,51,FMN 03 Kolonel Silvertopstraat
651,Kolonel Silvertopstraat 5333,2022-08-22,16:00:00,269,176,93,FMN 03 Kolonel Silvertopstraat
651,Kolonel Silvertopstraat 5333,2022-08-22,17:00:00,359,227,132,FMN 03 Kolonel Silvertopstraat
651,Kolonel Silvertopstraat 5333,2022-08-22,18:00:00,262,163,99,FMN 03 Kolonel Silvertopstraat
651,Kolonel Silvertopstraat 5333,2022-08-22,19:00:00,205,114,91,FMN 03 Kolonel Silvertopstraat
651,Kolonel Silvertopstraat 5333,2022-08-22,20:00:00,181,101,80,FMN 03 Kolonel Silvertopstraat
651,Kolonel Silvertopstraat 5333,2022-08-22,21:00:00,135,65,70,FMN 03 Kolonel Silvertopstraat
651,Kolonel Silvertopstraat 5333,2022-08-22,22:00:00,117,62,55,FMN 03 Kolonel Silvertopstraat
651,Kolonel Silvertopstraat 5333,2022-08-22,23:00:00,78,46,32,FMN 03 Kolonel Silvertopstraat
651,Kolonel Silvertopstraat 5333,2022-08-23,00:00:00,41,13,28,FMN 03 Kolonel Silvertopstraat
651,Kolonel Silvertopstraat 5333,2022-08-23,01:00:00,32,13,19,FMN 03 Kolonel Silvertopstraat
651,Kolonel Silvertopstraat 5333,2022-08-23,02:00:00,24,9,15,FMN 03 Kolonel Silvertopstraat
651,Kolonel Silvertopstraat 5333,2022-08-23,03:00:00,15,8,7,FMN 03 Kolonel Silvertopstraat
651,Kolonel Silvertopstraat 5333,2022-08-23,04:00:00,26,19,7,FMN 03 Kolonel Silvertopstraat
651,Kolonel Silvertopstraat 5333,2022-08-23,05:00:00,59,44,15,FMN 03 Kolonel Silvertopstraat
651,Kolonel Silvertopstraat 5333,2022-08-23,06:00:00,148,114,34,FMN 03 Kolonel Silvertopstraat
651,Kolonel Silvertopstraat 5333,2022-08-23,07:00:00,246,185,61,FMN 03 Kolonel Silvertopstraat
651,Kolonel Silvertopstraat 5333,2022-08-23,08:00:00,432,361,71,FMN 03 Kolonel Silvertopstraat
651,Kolonel Silvertopstraat 5333,2022-08-23,09:00:00,246,194,52,FMN 03 Kolonel Silvertopstraat
651,Kolonel Silvertopstraat 5333,2022-08-23,10:00:00,180,149,31,FMN 03 Kolonel Silvertopstraat
651,Kolonel Silvertopstraat 5333,2022-08-23,11:00:00,173,115,58,FMN 03 Kolonel Silvertopstraat
651,Kolonel Silvertopstraat 5333,2022-08-23,12:00:00,203,148,55,FMN 03 Kolonel Silvertopstraat
651,Kolonel Silvertopstraat 5333,2022-08-23,13:00:00,174,114,60,FMN 03 Kolonel Silvertopstraat
651,Kolonel Silvertopstraat 5333,2022-08-23,14:00:00,205,143,62,FMN 03 Kolonel Silvertopstraat
651,Kolonel Silvertopstraat 5333,2022-08-23,15:00:00,235,152,83,FMN 03 Kolonel Silvertopstraat
651,Kolonel Silvertopstraat 5333,2022-08-23,16:00:00,347,214,133,FMN 03 Kolonel Silvertopstraat
651,Kolonel Silvertopstraat 5333,2022-08-23,17:00:00,325,202,123,FMN 03 Kolonel Silvertopstraat
651,Kolonel Silvertopstraat 5333,2022-08-23,18:00:00,313,200,113,FMN 03 Kolonel Silvertopstraat
651,Kolonel Silvertopstraat 5333,2022-08-23,19:00:00,222,132,90,FMN 03 Kolonel Silvertopstraat
651,Kolonel Silvertopstraat 5333,2022-08-23,20:00:00,193,110,83,FMN 03 Kolonel Silvertopstraat
651,Kolonel Silvertopstraat 5333,2022-08-23,21:00:00,162,84,78,FMN 03 Kolonel Silvertopstraat
651,Kolonel Silvertopstraat 5333,2022-08-23,22:00:00,142,75,67,FMN 03 Kolonel Silvertopstraat
651,Kolonel Silvertopstraat 5333,2022-08-23,23:00:00,104,39,65,FMN 03 Kolonel Silvertopstraat
651,Kolonel Silvertopstraat 5333,2022-08-24,00:00:00,53,29,24,FMN 03 Kolonel Silvertopstraat
651,Kolonel Silvertopstraat 5333,2022-08-24,01:00:00,22,11,11,FMN 03 Kolonel Silvertopstraat
651,Kolonel Silvertopstraat 5333,2022-08-24,02:00:00,19,9,10,FMN 03 Kolonel Silvertopstraat
651,Kolonel Silvertopstraat 5333,2022-08-24,03:00:00,18,7,11,FMN 03 Kolonel Silvertopstraat
651,Kolonel Silvertopstraat 5333,2022-08-24,04:00:00,44,30,14,FMN 03 Kolonel Silvertopstraat
651,Kolonel Silvertopstraat 5333,2022-08-24,05:00:00,64,45,19,FMN 03 Kolonel Silvertopstraat
651,Kolonel Silvertopstraat 5333,2022-08-24,06:00:00,133,97,36,FMN 03 Kolonel Silvertopstraat
651,Kolonel Silvertopstraat 5333,2022-08-24,07:00:00,232,168,64,FMN 03 Kolonel Silvertopstraat
651,Kolonel Silvertopstraat 5333,2022-08-24,08:00:00,390,326,64,FMN 03 Kolonel Silvertopstraat
651,Kolonel Silvertopstraat 5333,2022-08-24,09:00:00,254,194,60,FMN 03 Kolonel Silvertopstraat
651,Kolonel Silvertopstraat 5333,2022-08-24,10:00:00,175,122,53,FMN 03 Kolonel Silvertopstraat
651,Kolonel Silvertopstraat 5333,2022-08-24,11:00:00,157,103,54,FMN 03 Kolonel Silvertopstraat
651,Kolonel Silvertopstraat 5333,2022-08-24,12:00:00,200,144,56,FMN 03 Kolonel Silvertopstraat
651,Kolonel Silvertopstraat 5333,2022-08-24,13:00:00,209,137,72,FMN 03 Kolonel Silvertopstraat
651,Kolonel Silvertopstraat 5333,2022-08-24,14:00:00,204,133,71,FMN 03 Kolonel Silvertopstraat
651,Kolonel Silvertopstraat 5333,2022-08-24,15:00:00,251,167,84,FMN 03 Kolonel Silvertopstraat
651,Kolonel Silvertopstraat 5333,2022-08-24,16:00:00,327,218,109,FMN 03 Kolonel Silvertopstraat
651,Kolonel Silvertopstraat 5333,2022-08-24,17:00:00,343,239,104,FMN 03 Kolonel Silvertopstraat
651,Kolonel Silvertopstraat 5333,2022-08-24,18:00:00,299,176,123,FMN 03 Kolonel Silvertopstraat
651,Kolonel Silvertopstraat 5333,2022-08-24,19:00:00,190,118,72,FMN 03 Kolonel Silvertopstraat
651,Kolonel Silvertopstraat 5333,2022-08-24,20:00:00,202,120,82,FMN 03 Kolonel Silvertopstraat
651,Kolonel Silvertopstraat 5333,2022-08-24,21:00:00,135,67,68,FMN 03 Kolonel Silvertopstraat
651,Kolonel Silvertopstraat 5333,2022-08-24,22:00:00,167,97,70,FMN 03 Kolonel Silvertopstraat
651,Kolonel Silvertopstraat 5333,2022-08-24,23:00:00,87,39,48,FMN 03 Kolonel Silvertopstraat
651,Kolonel Silvertopstraat 5333,2022-08-25,00:00:00,41,23,18,FMN 03 Kolonel Silvertopstraat
651,Kolonel Silvertopstraat 5333,2022-08-25,01:00:00,29,14,15,FMN 03 Kolonel Silvertopstraat
651,Kolonel Silvertopstraat 5333,2022-08-25,02:00:00,23,11,12,FMN 03 Kolonel Silvertopstraat
651,Kolonel Silvertopstraat 5333,2022-08-25,03:00:00,16,8,8,FMN 03 Kolonel Silvertopstraat
651,Kolonel Silvertopstraat 5333,2022-08-25,04:00:00,32,21,11,FMN 03 Kolonel Silvertopstraat
651,Kolonel Silvertopstraat 5333,2022-08-25,05:00:00,59,42,17,FMN 03 Kolonel Silvertopstraat
651,Kolonel Silvertopstraat 5333,2022-08-25,06:00:00,126,95,31,FMN 03 Kolonel Silvertopstraat
651,Kolonel Silvertopstraat 5333,2022-08-25,07:00:00,259,197,62,FMN 03 Kolonel Silvertopstraat
651,Kolonel Silvertopstraat 5333,2022-08-25,08:00:00,446,372,74,FMN 03 Kolonel Silvertopstraat
651,Kolonel Silvertopstraat 5333,2022-08-25,09:00:00,247,191,56,FMN 03 Kolonel Silvertopstraat
651,Kolonel Silvertopstraat 5333,2022-08-25,10:00:00,196,148,48,FMN 03 Kolonel Silvertopstraat
651,Kolonel Silvertopstraat 5333,2022-08-25,11:00:00,159,123,36,FMN 03 Kolonel Silvertopstraat
651,Kolonel Silvertopstraat 5333,2022-08-25,12:00:00,222,157,65,FMN 03 Kolonel Silvertopstraat
651,Kolonel Silvertopstraat 5333,2022-08-25,13:00:00,196,131,65,FMN 03 Kolonel Silvertopstraat
651,Kolonel Silvertopstraat 5333,2022-08-25,14:00:00,204,136,68,FMN 03 Kolonel Silvertopstraat
651,Kolonel Silvertopstraat 5333,2022-08-25,15:00:00,254,182,72,FMN 03 Kolonel Silvertopstraat
651,Kolonel Silvertopstraat 5333,2022-08-25,16:00:00,329,217,112,FMN 03 Kolonel Silvertopstraat
651,Kolonel Silvertopstraat 5333,2022-08-25,17:00:00,358,215,143,FMN 03 Kolonel Silvertopstraat
651,Kolonel Silvertopstraat 5333,2022-08-25,18:00:00,340,211,129,FMN 03 Kolonel Silvertopstraat
651,Kolonel Silvertopstraat 5333,2022-08-25,19:00:00,206,129,77,FMN 03 Kolonel Silvertopstraat
651,Kolonel Silvertopstraat 5333,2022-08-25,20:00:00,179,113,66,FMN 03 Kolonel Silvertopstraat
651,Kolonel Silvertopstraat 5333,2022-08-25,21:00:00,132,72,60,FMN 03 Kolonel Silvertopstraat
651,Kolonel Silvertopstraat 5333,2022-08-25,22:00:00,142,83,59,FMN 03 Kolonel Silvertopstraat
651,Kolonel Silvertopstraat 5333,2022-08-25,23:00:00,97,50,47,FMN 03 Kolonel Silvertopstraat
651,Kolonel Silvertopstraat 5333,2022-08-26,00:00:00,51,22,29,FMN 03 Kolonel Silvertopstraat
651,Kolonel Silvertopstraat 5333,2022-08-26,01:00:00,29,11,18,FMN 03 Kolonel Silvertopstraat
651,Kolonel Silvertopstraat 5333,2022-08-26,02:00:00,16,3,13,FMN 03 Kolonel Silvertopstraat
651,Kolonel Silvertopstraat 5333,2022-08-26,03:00:00,18,8,10,FMN 03 Kolonel Silvertopstraat
651,Kolonel Silvertopstraat 5333,2022-08-26,04:00:00,34,20,14,FMN 03 Kolonel Silvertopstraat
651,Kolonel Silvertopstraat 5333,2022-08-26,05:00:00,56,41,15,FMN 03 Kolonel Silvertopstraat
651,Kolonel Silvertopstraat 5333,2022-08-26,06:00:00,112,83,29,FMN 03 Kolonel Silvertopstraat
651,Kolonel Silvertopstraat 5333,2022-08-26,07:00:00,169,133,36,FMN 03 Kolonel Silvertopstraat
651,Kolonel Silvertopstraat 5333,2022-08-26,08:00:00,363,293,70,FMN 03 Kolonel Silvertopstraat
651,Kolonel Silvertopstraat 5333,2022-08-26,09:00:00,196,160,36,FMN 03 Kolonel Silvertopstraat
651,Kolonel Silvertopstraat 5333,2022-08-26,10:00:00,162,130,32,FMN 03 Kolonel Silvertopstraat
651,Kolonel Silvertopstraat 5333,2022-08-26,11:00:00,148,103,45,FMN 03 Kolonel Silvertopstraat
651,Kolonel Silvertopstraat 5333,2022-08-26,12:00:00,168,112,56,FMN 03 Kolonel Silvertopstraat
651,Kolonel Silvertopstraat 5333,2022-08-26,13:00:00,225,155,70,FMN 03 Kolonel Silvertopstraat
651,Kolonel Silvertopstraat 5333,2022-08-26,14:00:00,211,145,66,FMN 03 Kolonel Silvertopstraat
651,Kolonel Silvertopstraat 5333,2022-08-26,15:00:00,282,185,97,FMN 03 Kolonel Silvertopstraat
651,Kolonel Silvertopstraat 5333,2022-08-26,16:00:00,325,215,110,FMN 03 Kolonel Silvertopstraat
651,Kolonel Silvertopstraat 5333,2022-08-26,17:00:00,323,196,127,FMN 03 Kolonel Silvertopstraat
651,Kolonel Silvertopstraat 5333,2022-08-26,18:00:00,282,178,104,FMN 03 Kolonel Silvertopstraat
651,Kolonel Silvertopstraat 5333,2022-08-26,19:00:00,249,169,80,FMN 03 Kolonel Silvertopstraat
651,Kolonel Silvertopstraat 5333,2022-08-26,20:00:00,205,147,58,FMN 03 Kolonel Silvertopstraat
651,Kolonel Silvertopstraat 5333,2022-08-26,21:00:00,179,111,68,FMN 03 Kolonel Silvertopstraat
651,Kolonel Silvertopstraat 5333,2022-08-26,22:00:00,152,81,71,FMN 03 Kolonel Silvertopstraat
651,Kolonel Silvertopstraat 5333,2022-08-26,23:00:00,119,54,65,FMN 03 Kolonel Silvertopstraat
651,Kolonel Silvertopstraat 5333,2022-08-27,00:00:00,69,28,41,FMN 03 Kolonel Silvertopstraat
651,Kolonel Silvertopstraat 5333,2022-08-27,01:00:00,50,18,32,FMN 03 Kolonel Silvertopstraat
651,Kolonel Silvertopstraat 5333,2022-08-27,02:00:00,34,19,15,FMN 03 Kolonel Silvertopstraat
651,Kolonel Silvertopstraat 5333,2022-08-27,03:00:00,24,6,18,FMN 03 Kolonel Silvertopstraat
651,Kolonel Silvertopstraat 5333,2022-08-27,04:00:00,30,14,16,FMN 03 Kolonel Silvertopstraat
651,Kolonel Silvertopstraat 5333,2022-08-27,05:00:00,36,15,21,FMN 03 Kolonel Silvertopstraat
651,Kolonel Silvertopstraat 5333,2022-08-27,06:00:00,37,33,4,FMN 03 Kolonel Silvertopstraat
651,Kolonel Silvertopstraat 5333,2022-08-27,07:00:00,36,30,6,FMN 03 Kolonel Silvertopstraat
651,Kolonel Silvertopstraat 5333,2022-08-27,08:00:00,73,57,16,FMN 03 Kolonel Silvertopstraat
651,Kolonel Silvertopstraat 5333,2022-08-27,09:00:00,151,114,37,FMN 03 Kolonel Silvertopstraat
651,Kolonel Silvertopstraat 5333,2022-08-27,10:00:00,165,132,33,FMN 03 Kolonel Silvertopstraat
651,Kolonel Silvertopstraat 5333,2022-08-27,11:00:00,196,136,60,FMN 03 Kolonel Silvertopstraat
651,Kolonel Silvertopstraat 5333,2022-08-27,12:00:00,231,167,64,FMN 03 Kolonel Silvertopstraat
651,Kolonel Silvertopstraat 5333,2022-08-27,13:00:00,177,136,41,FMN 03 Kolonel Silvertopstraat
651,Kolonel Silvertopstraat 5333,2022-08-27,14:00:00,233,166,67,FMN 03 Kolonel Silvertopstraat
651,Kolonel Silvertopstraat 5333,2022-08-27,15:00:00,233,168,65,FMN 03 Kolonel Silvertopstraat
651,Kolonel Silvertopstraat 5333,2022-08-27,16:00:00,194,131,63,FMN 03 Kolonel Silvertopstraat
651,Kolonel Silvertopstraat 5333,2022-08-27,17:00:00,220,140,80,FMN 03 Kolonel Silvertopstraat
651,Kolonel Silvertopstraat 5333,2022-08-27,18:00:00,227,152,75,FMN 03 Kolonel Silvertopstraat
651,Kolonel Silvertopstraat 5333,2022-08-27,19:00:00,162,96,66,FMN 03 Kolonel Silvertopstraat
651,Kolonel Silvertopstraat 5333,2022-08-27,20:00:00,142,99,43,FMN 03 Kolonel Silvertopstraat
651,Kolonel Silvertopstraat 5333,2022-08-27,21:00:00,130,90,40,FMN 03 Kolonel Silvertopstraat
651,Kolonel Silvertopstraat 5333,2022-08-27,22:00:00,101,55,46,FMN 03 Kolonel Silvertopstraat
651,Kolonel Silvertopstraat 5333,2022-08-27,23:00:00,84,38,46,FMN 03 Kolonel Silvertopstraat
651,Kolonel Silvertopstraat 5333,2022-08-28,00:00:00,76,29,47,FMN 03 Kolonel Silvertopstraat
651,Kolonel Silvertopstraat 5333,2022-08-28,01:00:00,32,11,21,FMN 03 Kolonel Silvertopstraat
651,Kolonel Silvertopstraat 5333,2022-08-28,02:00:00,33,7,26,FMN 03 Kolonel Silvertopstraat
651,Kolonel Silvertopstraat 5333,2022-08-28,03:00:00,25,6,19,FMN 03 Kolonel Silvertopstraat
651,Kolonel Silvertopstraat 5333,2022-08-28,04:00:00,22,8,14,FMN 03 Kolonel Silvertopstraat
651,Kolonel Silvertopstraat 5333,2022-08-28,05:00:00,20,17,3,FMN 03 Kolonel Silvertopstraat
651,Kolonel Silvertopstraat 5333,2022-08-28,06:00:00,31,25,6,FMN 03 Kolonel Silvertopstraat
651,Kolonel Silvertopstraat 5333,2022-08-28,07:00:00,29,27,2,FMN 03 Kolonel Silvertopstraat
651,Kolonel Silvertopstraat 5333,2022-08-28,08:00:00,56,41,15,FMN 03 Kolonel Silvertopstraat
651,Kolonel Silvertopstraat 5333,2022-08-28,09:00:00,110,91,19,FMN 03 Kolonel Silvertopstraat
651,Kolonel Silvertopstraat 5333,2022-08-28,10:00:00,124,102,22,FMN 03 Kolonel Silvertopstraat
651,Kolonel Silvertopstraat 5333,2022-08-28,11:00:00,191,159,32,FMN 03 Kolonel Silvertopstraat
651,Kolonel Silvertopstraat 5333,2022-08-28,12:00:00,198,140,58,FMN 03 Kolonel Silvertopstraat
651,Kolonel Silvertopstraat 5333,2022-08-28,13:00:00,234,178,56,FMN 03 Kolonel Silvertopstraat
651,Kolonel Silvertopstraat 5333,2022-08-28,14:00:00,214,147,67,FMN 03 Kolonel Silvertopstraat
651,Kolonel Silvertopstraat 5333,2022-08-28,15:00:00,204,133,71,FMN 03 Kolonel Silvertopstraat
651,Kolonel Silvertopstraat 5333,2022-08-28,16:00:00,164,106,58,FMN 03 Kolonel Silvertopstraat
651,Kolonel Silvertopstraat 5333,2022-08-28,17:00:00,193,132,61,FMN 03 Kolonel Silvertopstraat
651,Kolonel Silvertopstraat 5333,2022-08-28,18:00:00,194,126,68,FMN 03 Kolonel Silvertopstraat
651,Kolonel Silvertopstraat 5333,2022-08-28,19:00:00,210,136,74,FMN 03 Kolonel Silvertopstraat
651,Kolonel Silvertopstraat 5333,2022-08-28,20:00:00,147,83,64,FMN 03 Kolonel Silvertopstraat
651,Kolonel Silvertopstraat 5333,2022-08-28,21:00:00,155,93,62,FMN 03 Kolonel Silvertopstraat
651,Kolonel Silvertopstraat 5333,2022-08-28,22:00:00,112,65,47,FMN 03 Kolonel Silvertopstraat
651,Kolonel Silvertopstraat 5333,2022-08-28,23:00:00,77,44,33,FMN 03 Kolonel Silvertopstraat
651,Kolonel Silvertopstraat 5333,2022-08-29,00:00:00,32,16,16,FMN 03 Kolonel Silvertopstraat
651,Kolonel Silvertopstraat 5333,2022-08-29,01:00:00,22,14,8,FMN 03 Kolonel Silvertopstraat
651,Kolonel Silvertopstraat 5333,2022-08-29,02:00:00,14,4,10,FMN 03 Kolonel Silvertopstraat
651,Kolonel Silvertopstraat 5333,2022-08-29,03:00:00,13,11,2,FMN 03 Kolonel Silvertopstraat
651,Kolonel Silvertopstraat 5333,2022-08-29,04:00:00,28,17,11,FMN 03 Kolonel Silvertopstraat
651,Kolonel Silvertopstraat 5333,2022-08-29,05:00:00,61,49,12,FMN 03 Kolonel Silvertopstraat
651,Kolonel Silvertopstraat 5333,2022-08-29,06:00:00,121,96,25,FMN 03 Kolonel Silvertopstraat
651,Kolonel Silvertopstraat 5333,2022-08-29,07:00:00,246,193,53,FMN 03 Kolonel Silvertopstraat
651,Kolonel Silvertopstraat 5333,2022-08-29,08:00:00,426,357,69,FMN 03 Kolonel Silvertopstraat
651,Kolonel Silvertopstraat 5333,2022-08-29,09:00:00,242,189,53,FMN 03 Kolonel Silvertopstraat
651,Kolonel Silvertopstraat 5333,2022-08-29,10:00:00,150,115,35,FMN 03 Kolonel Silvertopstraat
651,Kolonel Silvertopstraat 5333,2022-08-29,11:00:00,164,124,40,FMN 03 Kolonel Silvertopstraat
651,Kolonel Silvertopstraat 5333,2022-08-29,12:00:00,185,136,49,FMN 03 Kolonel Silvertopstraat
651,Kolonel Silvertopstraat 5333,2022-08-29,13:00:00,201,146,55,FMN 03 Kolonel Silvertopstraat
651,Kolonel Silvertopstraat 5333,2022-08-29,14:00:00,207,145,62,FMN 03 Kolonel Silvertopstraat
651,Kolonel Silvertopstraat 5333,2022-08-29,15:00:00,246,173,73,FMN 03 Kolonel Silvertopstraat
651,Kolonel Silvertopstraat 5333,2022-08-29,16:00:00,361,253,108,FMN 03 Kolonel Silvertopstraat
651,Kolonel Silvertopstraat 5333,2022-08-29,17:00:00,367,224,143,FMN 03 Kolonel Silvertopstraat
651,Kolonel Silvertopstraat 5333,2022-08-29,18:00:00,307,186,121,FMN 03 Kolonel Silvertopstraat
651,Kolonel Silvertopstraat 5333,2022-08-29,19:00:00,213,126,87,FMN 03 Kolonel Silvertopstraat
651,Kolonel Silvertopstraat 5333,2022-08-29,20:00:00,145,83,62,FMN 03 Kolonel Silvertopstraat
651,Kolonel Silvertopstraat 5333,2022-08-29,21:00:00,129,75,54,FMN 03 Kolonel Silvertopstraat
651,Kolonel Silvertopstraat 5333,2022-08-29,22:00:00,142,81,61,FMN 03 Kolonel Silvertopstraat
651,Kolonel Silvertopstraat 5333,2022-08-29,23:00:00,74,32,42,FMN 03 Kolonel Silvertopstraat
651,Kolonel Silvertopstraat 5333,2022-08-30,00:00:00,40,19,21,FMN 03 Kolonel Silvertopstraat
651,Kolonel Silvertopstraat 5333,2022-08-30,01:00:00,26,16,10,FMN 03 Kolonel Silvertopstraat
651,Kolonel Silvertopstraat 5333,2022-08-30,02:00:00,21,8,13,FMN 03 Kolonel Silvertopstraat
651,Kolonel Silvertopstraat 5333,2022-08-30,03:00:00,15,9,6,FMN 03 Kolonel Silvertopstraat
651,Kolonel Silvertopstraat 5333,2022-08-30,04:00:00,28,19,9,FMN 03 Kolonel Silvertopstraat
651,Kolonel Silvertopstraat 5333,2022-08-30,05:00:00,60,46,14,FMN 03 Kolonel Silvertopstraat
651,Kolonel Silvertopstraat 5333,2022-08-30,06:00:00,139,106,33,FMN 03 Kolonel Silvertopstraat
651,Kolonel Silvertopstraat 5333,2022-08-30,07:00:00,279,204,75,FMN 03 Kolonel Silvertopstraat
651,Kolonel Silvertopstraat 5333,2022-08-30,08:00:00,468,395,73,FMN 03 Kolonel Silvertopstraat
651,Kolonel Silvertopstraat 5333,2022-08-30,09:00:00,281,225,56,FMN 03 Kolonel Silvertopstraat
651,Kolonel Silvertopstraat 5333,2022-08-30,10:00:00,179,136,43,FMN 03 Kolonel Silvertopstraat
651,Kolonel Silvertopstraat 5333,2022-08-30,11:00:00,204,151,53,FMN 03 Kolonel Silvertopstraat
651,Kolonel Silvertopstraat 5333,2022-08-30,12:00:00,221,157,64,FMN 03 Kolonel Silvertopstraat
651,Kolonel Silvertopstraat 5333,2022-08-30,13:00:00,222,153,69,FMN 03 Kolonel Silvertopstraat
651,Kolonel Silvertopstraat 5333,2022-08-30,14:00:00,255,175,80,FMN 03 Kolonel Silvertopstraat
651,Kolonel Silvertopstraat 5333,2022-08-30,15:00:00,266,174,92,FMN 03 Kolonel Silvertopstraat
651,Kolonel Silvertopstraat 5333,2022-08-30,16:00:00,386,262,124,FMN 03 Kolonel Silvertopstraat
651,Kolonel Silvertopstraat 5333,2022-08-30,17:00:00,409,247,162,FMN 03 Kolonel Silvertopstraat
651,Kolonel Silvertopstraat 5333,2022-08-30,18:00:00,298,179,119,FMN 03 Kolonel Silvertopstraat
651,Kolonel Silvertopstraat 5333,2022-08-30,19:00:00,253,152,101,FMN 03 Kolonel Silvertopstraat
651,Kolonel Silvertopstraat 5333,2022-08-30,20:00:00,174,102,72,FMN 03 Kolonel Silvertopstraat
651,Kolonel Silvertopstraat 5333,2022-08-30,21:00:00,149,88,61,FMN 03 Kolonel Silvertopstraat
651,Kolonel Silvertopstraat 5333,2022-08-30,22:00:00,129,64,65,FMN 03 Kolonel Silvertopstraat
651,Kolonel Silvertopstraat 5333,2022-08-30,23:00:00,71,31,40,FMN 03 Kolonel Silvertopstraat
651,Kolonel Silvertopstraat 5333,2022-08-31,00:00:00,45,19,26,FMN 03 Kolonel Silvertopstraat
651,Kolonel Silvertopstraat 5333,2022-08-31,01:00:00,36,13,23,FMN 03 Kolonel Silvertopstraat
651,Kolonel Silvertopstraat 5333,2022-08-31,02:00:00,21,10,11,FMN 03 Kolonel Silvertopstraat
651,Kolonel Silvertopstraat 5333,2022-08-31,03:00:00,16,6,10,FMN 03 Kolonel Silvertopstraat
651,Kolonel Silvertopstraat 5333,2022-08-31,04:00:00,38,27,11,FMN 03 Kolonel Silvertopstraat
651,Kolonel Silvertopstraat 5333,2022-08-31,05:00:00,62,45,17,FMN 03 Kolonel Silvertopstraat
651,Kolonel Silvertopstraat 5333,2022-08-31,06:00:00,136,106,30,FMN 03 Kolonel Silvertopstraat
651,Kolonel Silvertopstraat 5333,2022-08-31,07:00:00,245,188,57,FMN 03 Kolonel Silvertopstraat
651,Kolonel Silvertopstraat 5333,2022-08-31,08:00:00,389,322,67,FMN 03 Kolonel Silvertopstraat
651,Kolonel Silvertopstraat 5333,2022-08-31,09:00:00,246,200,46,FMN 03 Kolonel Silvertopstraat
651,Kolonel Silvertopstraat 5333,2022-08-31,10:00:00,162,116,46,FMN 03 Kolonel Silvertopstraat
651,Kolonel Silvertopstraat 5333,2022-08-31,11:00:00,166,117,49,FMN 03 Kolonel Silvertopstraat
651,Kolonel Silvertopstraat 5333,2022-08-31,12:00:00,235,164,71,FMN 03 Kolonel Silvertopstraat
651,Kolonel Silvertopstraat 5333,2022-08-31,13:00:00,226,154,72,FMN 03 Kolonel Silvertopstraat
651,Kolonel Silvertopstraat 5333,2022-08-31,14:00:00,265,178,87,FMN 03 Kolonel Silvertopstraat
651,Kolonel Silvertopstraat 5333,2022-08-31,15:00:00,243,163,80,FMN 03 Kolonel Silvertopstraat
651,Kolonel Silvertopstraat 5333,2022-08-31,16:00:00,360,250,110,FMN 03 Kolonel Silvertopstraat
651,Kolonel Silvertopstraat 5333,2022-08-31,17:00:00,390,241,149,FMN 03 Kolonel Silvertopstraat
651,Kolonel Silvertopstraat 5333,2022-08-31,18:00:00,335,218,117,FMN 03 Kolonel Silvertopstraat
651,Kolonel Silvertopstraat 5333,2022-08-31,19:00:00,221,138,83,FMN 03 Kolonel Silvertopstraat
651,Kolonel Silvertopstraat 5333,2022-08-31,20:00:00,180,112,68,FMN 03 Kolonel Silvertopstraat
651,Kolonel Silvertopstraat 5333,2022-08-31,21:00:00,146,79,67,FMN 03 Kolonel Silvertopstraat
651,Kolonel Silvertopstraat 5333,2022-08-31,22:00:00,110,49,61,FMN 03 Kolonel Silvertopstraat
651,Kolonel Silvertopstraat 5333,2022-08-31,23:00:00,77,33,44,FMN 03 Kolonel Silvertopstraat
651,Kolonel Silvertopstraat 5333,2022-09-01,00:00:00,32,12,20,FMN 03 Kolonel Silvertopstraat
651,Kolonel Silvertopstraat 5333,2022-09-01,01:00:00,27,12,15,FMN 03 Kolonel Silvertopstraat
651,Kolonel Silvertopstraat 5333,2022-09-01,02:00:00,14,7,7,FMN 03 Kolonel Silvertopstraat
651,Kolonel Silvertopstraat 5333,2022-09-01,03:00:00,16,6,10,FMN 03 Kolonel Silvertopstraat
651,Kolonel Silvertopstraat 5333,2022-09-01,04:00:00,38,27,11,FMN 03 Kolonel Silvertopstraat
651,Kolonel Silvertopstraat 5333,2022-09-01,05:00:00,64,46,18,FMN 03 Kolonel Silvertopstraat
651,Kolonel Silvertopstraat 5333,2022-09-01,06:00:00,155,123,32,FMN 03 Kolonel Silvertopstraat
651,Kolonel Silvertopstraat 5333,2022-09-01,07:00:00,361,286,75,FMN 03 Kolonel Silvertopstraat
651,Kolonel Silvertopstraat 5333,2022-09-01,08:00:00,716,619,97,FMN 03 Kolonel Silvertopstraat
651,Kolonel Silvertopstraat 5333,2022-09-01,09:00:00,345,278,67,FMN 03 Kolonel Silvertopstraat
651,Kolonel Silvertopstraat 5333,2022-09-01,10:00:00,181,131,50,FMN 03 Kolonel Silvertopstraat
651,Kolonel Silvertopstraat 5333,2022-09-01,11:00:00,188,146,42,FMN 03 Kolonel Silvertopstraat
651,Kolonel Silvertopstraat 5333,2022-09-01,12:00:00,243,184,59,FMN 03 Kolonel Silvertopstraat
651,Kolonel Silvertopstraat 5333,2022-09-01,13:00:00,228,159,69,FMN 03 Kolonel Silvertopstraat
651,Kolonel Silvertopstraat 5333,2022-09-01,14:00:00,252,181,71,FMN 03 Kolonel Silvertopstraat
651,Kolonel Silvertopstraat 5333,2022-09-01,15:00:00,365,213,152,FMN 03 Kolonel Silvertopstraat
651,Kolonel Silvertopstraat 5333,2022-09-01,16:00:00,386,234,152,FMN 03 Kolonel Silvertopstraat
651,Kolonel Silvertopstraat 5333,2022-09-01,17:00:00,430,270,160,FMN 03 Kolonel Silvertopstraat
651,Kolonel Silvertopstraat 5333,2022-09-01,18:00:00,358,210,148,FMN 03 Kolonel Silvertopstraat
651,Kolonel Silvertopstraat 5333,2022-09-01,19:00:00,228,149,79,FMN 03 Kolonel Silvertopstraat
651,Kolonel Silvertopstraat 5333,2022-09-01,20:00:00,204,130,74,FMN 03 Kolonel Silvertopstraat
651,Kolonel Silvertopstraat 5333,2022-09-01,21:00:00,136,76,60,FMN 03 Kolonel Silvertopstraat
651,Kolonel Silvertopstraat 5333,2022-09-01,22:00:00,134,77,57,FMN 03 Kolonel Silvertopstraat
651,Kolonel Silvertopstraat 5333,2022-09-01,23:00:00,78,32,46,FMN 03 Kolonel Silvertopstraat
651,Kolonel Silvertopstraat 5333,2022-09-02,00:00:00,43,22,21,FMN 03 Kolonel Silvertopstraat
651,Kolonel Silvertopstraat 5333,2022-09-02,01:00:00,28,11,17,FMN 03 Kolonel Silvertopstraat
651,Kolonel Silvertopstraat 5333,2022-09-02,02:00:00,15,6,9,FMN 03 Kolonel Silvertopstraat
651,Kolonel Silvertopstraat 5333,2022-09-02,03:00:00,17,6,11,FMN 03 Kolonel Silvertopstraat
651,Kolonel Silvertopstraat 5333,2022-09-02,04:00:00,32,21,11,FMN 03 Kolonel Silvertopstraat
651,Kolonel Silvertopstraat 5333,2022-09-02,05:00:00,63,46,17,FMN 03 Kolonel Silvertopstraat
651,Kolonel Silvertopstraat 5333,2022-09-02,06:00:00,122,95,27,FMN 03 Kolonel Silvertopstraat
651,Kolonel Silvertopstraat 5333,2022-09-02,07:00:00,402,334,68,FMN 03 Kolonel Silvertopstraat
651,Kolonel Silvertopstraat 5333,2022-09-02,08:00:00,678,560,118,FMN 03 Kolonel Silvertopstraat
651,Kolonel Silvertopstraat 5333,2022-09-02,09:00:00,237,189,48,FMN 03 Kolonel Silvertopstraat
651,Kolonel Silvertopstraat 5333,2022-09-02,10:00:00,177,129,48,FMN 03 Kolonel Silvertopstraat
651,Kolonel Silvertopstraat 5333,2022-09-02,11:00:00,198,145,53,FMN 03 Kolonel Silvertopstraat
651,Kolonel Silvertopstraat 5333,2022-09-02,12:00:00,239,168,71,FMN 03 Kolonel Silvertopstraat
651,Kolonel Silvertopstraat 5333,2022-09-02,13:00:00,256,173,83,FMN 03 Kolonel Silvertopstraat
651,Kolonel Silvertopstraat 5333,2022-09-02,14:00:00,272,164,108,FMN 03 Kolonel Silvertopstraat
651,Kolonel Silvertopstraat 5333,2022-09-02,15:00:00,363,244,119,FMN 03 Kolonel Silvertopstraat
651,Kolonel Silvertopstraat 5333,2022-09-02,16:00:00,444,272,172,FMN 03 Kolonel Silvertopstraat
651,Kolonel Silvertopstraat 5333,2022-09-02,17:00:00,384,238,146,FMN 03 Kolonel Silvertopstraat
651,Kolonel Silvertopstraat 5333,2022-09-02,18:00:00,378,248,130,FMN 03 Kolonel Silvertopstraat
651,Kolonel Silvertopstraat 5333,2022-09-02,19:00:00,279,194,85,FMN 03 Kolonel Silvertopstraat
651,Kolonel Silvertopstraat 5333,2022-09-02,20:00:00,210,146,64,FMN 03 Kolonel Silvertopstraat
651,Kolonel Silvertopstraat 5333,2022-09-02,21:00:00,194,119,75,FMN 03 Kolonel Silvertopstraat
651,Kolonel Silvertopstraat 5333,2022-09-02,22:00:00,141,74,67,FMN 03 Kolonel Silvertopstraat
651,Kolonel Silvertopstraat 5333,2022-09-02,23:00:00,97,49,48,FMN 03 Kolonel Silvertopstraat
651,Kolonel Silvertopstraat 5333,2022-09-03,00:00:00,107,57,50,FMN 03 Kolonel Silvertopstraat
651,Kolonel Silvertopstraat 5333,2022-09-03,01:00:00,45,22,23,FMN 03 Kolonel Silvertopstraat
651,Kolonel Silvertopstraat 5333,2022-09-03,02:00:00,29,11,18,FMN 03 Kolonel Silvertopstraat
651,Kolonel Silvertopstraat 5333,2022-09-03,03:00:00,36,11,25,FMN 03 Kolonel Silvertopstraat
651,Kolonel Silvertopstraat 5333,2022-09-03,04:00:00,24,14,10,FMN 03 Kolonel Silvertopstraat
651,Kolonel Silvertopstraat 5333,2022-09-03,05:00:00,33,23,10,FMN 03 Kolonel Silvertopstraat
651,Kolonel Silvertopstraat 5333,2022-09-03,06:00:00,52,40,12,FMN 03 Kolonel Silvertopstraat
651,Kolonel Silvertopstraat 5333,2022-09-03,07:00:00,60,35,25,FMN 03 Kolonel Silvertopstraat
651,Kolonel Silvertopstraat 5333,2022-09-03,08:00:00,78,61,17,FMN 03 Kolonel Silvertopstraat
651,Kolonel Silvertopstraat 5333,2022-09-03,09:00:00,162,126,36,FMN 03 Kolonel Silvertopstraat
651,Kolonel Silvertopstraat 5333,2022-09-03,10:00:00,152,120,32,FMN 03 Kolonel Silvertopstraat
651,Kolonel Silvertopstraat 5333,2022-09-03,11:00:00,170,131,39,FMN 03 Kolonel Silvertopstraat
651,Kolonel Silvertopstraat 5333,2022-09-03,12:00:00,204,143,61,FMN 03 Kolonel Silvertopstraat
651,Kolonel Silvertopstraat 5333,2022-09-03,13:00:00,258,192,66,FMN 03 Kolonel Silvertopstraat
651,Kolonel Silvertopstraat 5333,2022-09-03,14:00:00,280,199,81,FMN 03 Kolonel Silvertopstraat
651,Kolonel Silvertopstraat 5333,2022-09-03,15:00:00,258,185,73,FMN 03 Kolonel Silvertopstraat
651,Kolonel Silvertopstraat 5333,2022-09-03,16:00:00,218,138,80,FMN 03 Kolonel Silvertopstraat
651,Kolonel Silvertopstraat 5333,2022-09-03,17:00:00,267,205,62,FMN 03 Kolonel Silvertopstraat
651,Kolonel Silvertopstraat 5333,2022-09-03,18:00:00,241,153,88,FMN 03 Kolonel Silvertopstraat
651,Kolonel Silvertopstraat 5333,2022-09-03,19:00:00,207,146,61,FMN 03 Kolonel Silvertopstraat
651,Kolonel Silvertopstraat 5333,2022-09-03,20:00:00,178,126,52,FMN 03 Kolonel Silvertopstraat
651,Kolonel Silvertopstraat 5333,2022-09-03,21:00:00,135,83,52,FMN 03 Kolonel Silvertopstraat
651,Kolonel Silvertopstraat 5333,2022-09-03,22:00:00,115,65,50,FMN 03 Kolonel Silvertopstraat
651,Kolonel Silvertopstraat 5333,2022-09-03,23:00:00,99,48,51,FMN 03 Kolonel Silvertopstraat
651,Kolonel Silvertopstraat 5333,2022-09-04,00:00:00,100,39,61,FMN 03 Kolonel Silvertopstraat
651,Kolonel Silvertopstraat 5333,2022-09-04,01:00:00,67,35,32,FMN 03 Kolonel Silvertopstraat
651,Kolonel Silvertopstraat 5333,2022-09-04,02:00:00,29,12,17,FMN 03 Kolonel Silvertopstraat
651,Kolonel Silvertopstraat 5333,2022-09-04,03:00:00,33,15,18,FMN 03 Kolonel Silvertopstraat
651,Kolonel Silvertopstraat 5333,2022-09-04,04:00:00,37,22,15,FMN 03 Kolonel Silvertopstraat
651,Kolonel Silvertopstraat 5333,2022-09-04,05:00:00,20,12,8,FMN 03 Kolonel Silvertopstraat
651,Kolonel Silvertopstraat 5333,2022-09-04,06:00:00,32,21,11,FMN 03 Kolonel Silvertopstraat
651,Kolonel Silvertopstraat 5333,2022-09-04,07:00:00,37,30,7,FMN 03 Kolonel Silvertopstraat
651,Kolonel Silvertopstraat 5333,2022-09-04,08:00:00,56,44,12,FMN 03 Kolonel Silvertopstraat
651,Kolonel Silvertopstraat 5333,2022-09-04,09:00:00,118,88,30,FMN 03 Kolonel Silvertopstraat
651,Kolonel Silvertopstraat 5333,2022-09-04,10:00:00,168,137,31,FMN 03 Kolonel Silvertopstraat
651,Kolonel Silvertopstraat 5333,2022-09-04,11:00:00,215,158,57,FMN 03 Kolonel Silvertopstraat
651,Kolonel Silvertopstraat 5333,2022-09-04,12:00:00,229,170,59,FMN 03 Kolonel Silvertopstraat
651,Kolonel Silvertopstraat 5333,2022-09-04,13:00:00,291,236,55,FMN 03 Kolonel Silvertopstraat
651,Kolonel Silvertopstraat 5333,2022-09-04,14:00:00,253,172,81,FMN 03 Kolonel Silvertopstraat
651,Kolonel Silvertopstraat 5333,2022-09-04,15:00:00,236,174,62,FMN 03 Kolonel Silvertopstraat
651,Kolonel Silvertopstraat 5333,2022-09-04,16:00:00,220,163,57,FMN 03 Kolonel Silvertopstraat
651,Kolonel Silvertopstraat 5333,2022-09-04,17:00:00,247,160,87,FMN 03 Kolonel Silvertopstraat
651,Kolonel Silvertopstraat 5333,2022-09-04,18:00:00,244,157,87,FMN 03 Kolonel Silvertopstraat
651,Kolonel Silvertopstraat 5333,2022-09-04,19:00:00,205,131,74,FMN 03 Kolonel Silvertopstraat
651,Kolonel Silvertopstraat 5333,2022-09-04,20:00:00,169,100,69,FMN 03 Kolonel Silvertopstraat
651,Kolonel Silvertopstraat 5333,2022-09-04,21:00:00,118,56,62,FMN 03 Kolonel Silvertopstraat
651,Kolonel Silvertopstraat 5333,2022-09-04,22:00:00,117,49,68,FMN 03 Kolonel Silvertopstraat
651,Kolonel Silvertopstraat 5333,2022-09-04,23:00:00,69,30,39,FMN 03 Kolonel Silvertopstraat
651,Kolonel Silvertopstraat 5333,2022-09-05,00:00:00,32,9,23,FMN 03 Kolonel Silvertopstraat
651,Kolonel Silvertopstraat 5333,2022-09-05,01:00:00,19,6,13,FMN 03 Kolonel Silvertopstraat
651,Kolonel Silvertopstraat 5333,2022-09-05,02:00:00,16,5,11,FMN 03 Kolonel Silvertopstraat
651,Kolonel Silvertopstraat 5333,2022-09-05,03:00:00,18,11,7,FMN 03 Kolonel Silvertopstraat
651,Kolonel Silvertopstraat 5333,2022-09-05,04:00:00,31,19,12,FMN 03 Kolonel Silvertopstraat
651,Kolonel Silvertopstraat 5333,2022-09-05,05:00:00,55,37,18,FMN 03 Kolonel Silvertopstraat
651,Kolonel Silvertopstraat 5333,2022-09-05,06:00:00,150,120,30,FMN 03 Kolonel Silvertopstraat
651,Kolonel Silvertopstraat 5333,2022-09-05,07:00:00,437,359,78,FMN 03 Kolonel Silvertopstraat
651,Kolonel Silvertopstraat 5333,2022-09-05,08:00:00,746,658,88,FMN 03 Kolonel Silvertopstraat
651,Kolonel Silvertopstraat 5333,2022-09-05,09:00:00,243,195,48,FMN 03 Kolonel Silvertopstraat
651,Kolonel Silvertopstraat 5333,2022-09-05,10:00:00,158,119,39,FMN 03 Kolonel Silvertopstraat
651,Kolonel Silvertopstraat 5333,2022-09-05,11:00:00,190,149,41,FMN 03 Kolonel Silvertopstraat
651,Kolonel Silvertopstraat 5333,2022-09-05,12:00:00,222,146,76,FMN 03 Kolonel Silvertopstraat
651,Kolonel Silvertopstraat 5333,2022-09-05,13:00:00,195,137,58,FMN 03 Kolonel Silvertopstraat
651,Kolonel Silvertopstraat 5333,2022-09-05,14:00:00,208,157,51,FMN 03 Kolonel Silvertopstraat
651,Kolonel Silvertopstraat 5333,2022-09-05,15:00:00,348,225,123,FMN 03 Kolonel Silvertopstraat
651,Kolonel Silvertopstraat 5333,2022-09-05,16:00:00,397,277,120,FMN 03 Kolonel Silvertopstraat
651,Kolonel Silvertopstraat 5333,2022-09-05,17:00:00,430,265,165,FMN 03 Kolonel Silvertopstraat
651,Kolonel Silvertopstraat 5333,2022-09-05,18:00:00,232,151,81,FMN 03 Kolonel Silvertopstraat
651,Kolonel Silvertopstraat 5333,2022-09-05,19:00:00,189,115,74,FMN 03 Kolonel Silvertopstraat
651,Kolonel Silvertopstraat 5333,2022-09-05,20:00:00,184,108,76,FMN 03 Kolonel Silvertopstraat
651,Kolonel Silvertopstraat 5333,2022-09-05,21:00:00,91,45,46,FMN 03 Kolonel Silvertopstraat
651,Kolonel Silvertopstraat 5333,2022-09-05,22:00:00,92,52,40,FMN 03 Kolonel Silvertopstraat
651,Kolonel Silvertopstraat 5333,2022-09-05,23:00:00,35,16,19,FMN 03 Kolonel Silvertopstraat
651,Kolonel Silvertopstraat 5333,2022-09-06,00:00:00,34,18,16,FMN 03 Kolonel Silvertopstraat
651,Kolonel Silvertopstraat 5333,2022-09-06,01:00:00,16,7,9,FMN 03 Kolonel Silvertopstraat
651,Kolonel Silvertopstraat 5333,2022-09-06,02:00:00,9,3,6,FMN 03 Kolonel Silvertopstraat
651,Kolonel Silvertopstraat 5333,2022-09-06,03:00:00,9,6,3,FMN 03 Kolonel Silvertopstraat
651,Kolonel Silvertopstraat 5333,2022-09-06,04:00:00,23,17,6,FMN 03 Kolonel Silvertopstraat
651,Kolonel Silvertopstraat 5333,2022-09-06,05:00:00,69,43,26,FMN 03 Kolonel Silvertopstraat
651,Kolonel Silvertopstraat 5333,2022-09-06,06:00:00,165,131,34,FMN 03 Kolonel Silvertopstraat
651,Kolonel Silvertopstraat 5333,2022-09-06,07:00:00,453,383,70,FMN 03 Kolonel Silvertopstraat
651,Kolonel Silvertopstraat 5333,2022-09-06,08:00:00,796,679,117,FMN 03 Kolonel Silvertopstraat
651,Kolonel Silvertopstraat 5333,2022-09-06,09:00:00,248,204,44,FMN 03 Kolonel Silvertopstraat
651,Kolonel Silvertopstraat 5333,2022-09-06,10:00:00,185,143,42,FMN 03 Kolonel Silvertopstraat
651,Kolonel Silvertopstraat 5333,2022-09-06,11:00:00,150,114,36,FMN 03 Kolonel Silvertopstraat
651,Kolonel Silvertopstraat 5333,2022-09-06,12:00:00,219,145,74,FMN 03 Kolonel Silvertopstraat
651,Kolonel Silvertopstraat 5333,2022-09-06,13:00:00,196,143,53,FMN 03 Kolonel Silvertopstraat
651,Kolonel Silvertopstraat 5333,2022-09-06,14:00:00,257,178,79,FMN 03 Kolonel Silvertopstraat
651,Kolonel Silvertopstraat 5333,2022-09-06,15:00:00,352,222,130,FMN 03 Kolonel Silvertopstraat
651,Kolonel Silvertopstraat 5333,2022-09-06,16:00:00,459,310,149,FMN 03 Kolonel Silvertopstraat
651,Kolonel Silvertopstraat 5333,2022-09-06,17:00:00,481,292,189,FMN 03 Kolonel Silvertopstraat
651,Kolonel Silvertopstraat 5333,2022-09-06,18:00:00,298,180,118,FMN 03 Kolonel Silvertopstraat
651,Kolonel Silvertopstraat 5333,2022-09-06,19:00:00,229,148,81,FMN 03 Kolonel Silvertopstraat
651,Kolonel Silvertopstraat 5333,2022-09-06,20:00:00,184,110,74,FMN 03 Kolonel Silvertopstraat
651,Kolonel Silvertopstraat 5333,2022-09-06,21:00:00,146,76,70,FMN 03 Kolonel Silvertopstraat
651,Kolonel Silvertopstraat 5333,2022-09-06,22:00:00,109,59,50,FMN 03 Kolonel Silvertopstraat
651,Kolonel Silvertopstraat 5333,2022-09-06,23:00:00,53,19,34,FMN 03 Kolonel Silvertopstraat
651,Kolonel Silvertopstraat 5333,2022-09-07,00:00:00,20,12,8,FMN 03 Kolonel Silvertopstraat
651,Kolonel Silvertopstraat 5333,2022-09-07,01:00:00,20,7,13,FMN 03 Kolonel Silvertopstraat
651,Kolonel Silvertopstraat 5333,2022-09-07,02:00:00,10,5,5,FMN 03 Kolonel Silvertopstraat
651,Kolonel Silvertopstraat 5333,2022-09-07,03:00:00,8,6,2,FMN 03 Kolonel Silvertopstraat
651,Kolonel Silvertopstraat 5333,2022-09-07,04:00:00,32,22,10,FMN 03 Kolonel Silvertopstraat
651,Kolonel Silvertopstraat 5333,2022-09-07,05:00:00,47,32,15,FMN 03 Kolonel Silvertopstraat
651,Kolonel Silvertopstraat 5333,2022-09-07,06:00:00,161,121,40,FMN 03 Kolonel Silvertopstraat
651,Kolonel Silvertopstraat 5333,2022-09-07,07:00:00,391,335,56,FMN 03 Kolonel Silvertopstraat
651,Kolonel Silvertopstraat 5333,2022-09-07,08:00:00,668,564,104,FMN 03 Kolonel Silvertopstraat
651,Kolonel Silvertopstraat 5333,2022-09-07,09:00:00,236,185,51,FMN 03 Kolonel Silvertopstraat
651,Kolonel Silvertopstraat 5333,2022-09-07,10:00:00,169,127,42,FMN 03 Kolonel Silvertopstraat
651,Kolonel Silvertopstraat 5333,2022-09-07,11:00:00,197,153,44,FMN 03 Kolonel Silvertopstraat
651,Kolonel Silvertopstraat 5333,2022-09-07,12:00:00,410,270,140,FMN 03 Kolonel Silvertopstraat
651,Kolonel Silvertopstraat 5333,2022-09-07,13:00:00,254,167,87,FMN 03 Kolonel Silvertopstraat
651,Kolonel Silvertopstraat 5333,2022-09-07,14:00:00,235,165,70,FMN 03 Kolonel Silvertopstraat
651,Kolonel Silvertopstraat 5333,2022-09-07,15:00:00,254,176,78,FMN 03 Kolonel Silvertopstraat
651,Kolonel Silvertopstraat 5333,2022-09-07,16:00:00,381,258,123,FMN 03 Kolonel Silvertopstraat
651,Kolonel Silvertopstraat 5333,2022-09-07,17:00:00,411,276,135,FMN 03 Kolonel Silvertopstraat
651,Kolonel Silvertopstraat 5333,2022-09-07,18:00:00,351,232,119,FMN 03 Kolonel Silvertopstraat
651,Kolonel Silvertopstraat 5333,2022-09-07,19:00:00,269,174,95,FMN 03 Kolonel Silvertopstraat
651,Kolonel Silvertopstraat 5333,2022-09-07,20:00:00,174,102,72,FMN 03 Kolonel Silvertopstraat
651,Kolonel Silvertopstraat 5333,2022-09-07,21:00:00,137,73,64,FMN 03 Kolonel Silvertopstraat
651,Kolonel Silvertopstraat 5333,2022-09-07,22:00:00,126,60,66,FMN 03 Kolonel Silvertopstraat
651,Kolonel Silvertopstraat 5333,2022-09-07,23:00:00,95,55,40,FMN 03 Kolonel Silvertopstraat
651,Kolonel Silvertopstraat 5333,2022-09-08,00:00:00,39,16,23,FMN 03 Kolonel Silvertopstraat
651,Kolonel Silvertopstraat 5333,2022-09-08,01:00:00,26,6,20,FMN 03 Kolonel Silvertopstraat
651,Kolonel Silvertopstraat 5333,2022-09-08,02:00:00,9,4,5,FMN 03 Kolonel Silvertopstraat
651,Kolonel Silvertopstraat 5333,2022-09-08,03:00:00,12,7,5,FMN 03 Kolonel Silvertopstraat
651,Kolonel Silvertopstraat 5333,2022-09-08,04:00:00,26,19,7,FMN 03 Kolonel Silvertopstraat
651,Kolonel Silvertopstraat 5333,2022-09-08,05:00:00,58,43,15,FMN 03 Kolonel Silvertopstraat
651,Kolonel Silvertopstraat 5333,2022-09-08,06:00:00,141,107,34,FMN 03 Kolonel Silvertopstraat
651,Kolonel Silvertopstraat 5333,2022-09-08,07:00:00,384,324,60,FMN 03 Kolonel Silvertopstraat
651,Kolonel Silvertopstraat 5333,2022-09-08,08:00:00,706,601,105,FMN 03 Kolonel Silvertopstraat
651,Kolonel Silvertopstraat 5333,2022-09-08,09:00:00,232,178,54,FMN 03 Kolonel Silvertopstraat
651,Kolonel Silvertopstraat 5333,2022-09-08,10:00:00,151,119,32,FMN 03 Kolonel Silvertopstraat
651,Kolonel Silvertopstraat 5333,2022-09-08,11:00:00,172,129,43,FMN 03 Kolonel Silvertopstraat
651,Kolonel Silvertopstraat 5333,2022-09-08,12:00:00,203,143,60,FMN 03 Kolonel Silvertopstraat
651,Kolonel Silvertopstraat 5333,2022-09-08,13:00:00,184,118,66,FMN 03 Kolonel Silvertopstraat
651,Kolonel Silvertopstraat 5333,2022-09-08,14:00:00,231,150,81,FMN 03 Kolonel Silvertopstraat
651,Kolonel Silvertopstraat 5333,2022-09-08,15:00:00,333,203,130,FMN 03 Kolonel Silvertopstraat
651,Kolonel Silvertopstraat 5333,2022-09-08,16:00:00,404,259,145,FMN 03 Kolonel Silvertopstraat
651,Kolonel Silvertopstraat 5333,2022-09-08,17:00:00,387,237,150,FMN 03 Kolonel Silvertopstraat
651,Kolonel Silvertopstraat 5333,2022-09-08,18:00:00,293,192,101,FMN 03 Kolonel Silvertopstraat
651,Kolonel Silvertopstraat 5333,2022-09-08,19:00:00,205,140,65,FMN 03 Kolonel Silvertopstraat
651,Kolonel Silvertopstraat 5333,2022-09-08,20:00:00,127,68,59,FMN 03 Kolonel Silvertopstraat
651,Kolonel Silvertopstraat 5333,2022-09-08,21:00:00,112,59,53,FMN 03 Kolonel Silvertopstraat
651,Kolonel Silvertopstraat 5333,2022-09-08,22:00:00,117,68,49,FMN 03 Kolonel Silvertopstraat
651,Kolonel Silvertopstraat 5333,2022-09-08,23:00:00,72,36,36,FMN 03 Kolonel Silvertopstraat
651,Kolonel Silvertopstraat 5333,2022-09-09,00:00:00,37,24,13,FMN 03 Kolonel Silvertopstraat
651,Kolonel Silvertopstraat 5333,2022-09-09,01:00:00,29,19,10,FMN 03 Kolonel Silvertopstraat
651,Kolonel Silvertopstraat 5333,2022-09-09,02:00:00,15,9,6,FMN 03 Kolonel Silvertopstraat
651,Kolonel Silvertopstraat 5333,2022-09-09,03:00:00,16,5,11,FMN 03 Kolonel Silvertopstraat
651,Kolonel Silvertopstraat 5333,2022-09-09,04:00:00,23,15,8,FMN 03 Kolonel Silvertopstraat
651,Kolonel Silvertopstraat 5333,2022-09-09,05:00:00,51,38,13,FMN 03 Kolonel Silvertopstraat
651,Kolonel Silvertopstraat 5333,2022-09-09,06:00:00,119,90,29,FMN 03 Kolonel Silvertopstraat
651,Kolonel Silvertopstraat 5333,2022-09-09,07:00:00,313,269,44,FMN 03 Kolonel Silvertopstraat
651,Kolonel Silvertopstraat 5333,2022-09-09,08:00:00,599,502,97,FMN 03 Kolonel Silvertopstraat
651,Kolonel Silvertopstraat 5333,2022-09-09,09:00:00,215,173,42,FMN 03 Kolonel Silvertopstraat
651,Kolonel Silvertopstraat 5333,2022-09-09,10:00:00,143,115,28,FMN 03 Kolonel Silvertopstraat
651,Kolonel Silvertopstraat 5333,2022-09-09,11:00:00,133,81,52,FMN 03 Kolonel Silvertopstraat
651,Kolonel Silvertopstraat 5333,2022-09-09,12:00:00,216,152,64,FMN 03 Kolonel Silvertopstraat
651,Kolonel Silvertopstraat 5333,2022-09-09,13:00:00,211,142,69,FMN 03 Kolonel Silvertopstraat
651,Kolonel Silvertopstraat 5333,2022-09-09,14:00:00,198,136,62,FMN 03 Kolonel Silvertopstraat
651,Kolonel Silvertopstraat 5333,2022-09-09,15:00:00,340,207,133,FMN 03 Kolonel Silvertopstraat
651,Kolonel Silvertopstraat 5333,2022-09-09,16:00:00,356,235,121,FMN 03 Kolonel Silvertopstraat
651,Kolonel Silvertopstraat 5333,2022-09-09,17:00:00,305,205,100,FMN 03 Kolonel Silvertopstraat
651,Kolonel Silvertopstraat 5333,2022-09-09,18:00:00,267,146,121,FMN 03 Kolonel Silvertopstraat
651,Kolonel Silvertopstraat 5333,2022-09-09,19:00:00,253,152,101,FMN 03 Kolonel Silvertopstraat
651,Kolonel Silvertopstraat 5333,2022-09-09,20:00:00,145,93,52,FMN 03 Kolonel Silvertopstraat
651,Kolonel Silvertopstraat 5333,2022-09-09,21:00:00,126,78,48,FMN 03 Kolonel Silvertopstraat
651,Kolonel Silvertopstraat 5333,2022-09-09,22:00:00,179,135,44,FMN 03 Kolonel Silvertopstraat
651,Kolonel Silvertopstraat 5333,2022-09-09,23:00:00,104,60,44,FMN 03 Kolonel Silvertopstraat
651,Kolonel Silvertopstraat 5333,2022-09-10,00:00:00,72,42,30,FMN 03 Kolonel Silvertopstraat
651,Kolonel Silvertopstraat 5333,2022-09-10,01:00:00,50,27,23,FMN 03 Kolonel Silvertopstraat
651,Kolonel Silvertopstraat 5333,2022-09-10,02:00:00,29,11,18,FMN 03 Kolonel Silvertopstraat
651,Kolonel Silvertopstraat 5333,2022-09-10,03:00:00,24,5,19,FMN 03 Kolonel Silvertopstraat
651,Kolonel Silvertopstraat 5333,2022-09-10,04:00:00,26,11,15,FMN 03 Kolonel Silvertopstraat
651,Kolonel Silvertopstraat 5333,2022-09-10,05:00:00,26,14,12,FMN 03 Kolonel Silvertopstraat
651,Kolonel Silvertopstraat 5333,2022-09-10,06:00:00,29,25,4,FMN 03 Kolonel Silvertopstraat
651,Kolonel Silvertopstraat 5333,2022-09-10,07:00:00,30,20,10,FMN 03 Kolonel Silvertopstraat
651,Kolonel Silvertopstraat 5333,2022-09-10,08:00:00,54,43,11,FMN 03 Kolonel Silvertopstraat
651,Kolonel Silvertopstraat 5333,2022-09-10,09:00:00,54,44,10,FMN 03 Kolonel Silvertopstraat
651,Kolonel Silvertopstraat 5333,2022-09-10,10:00:00,65,54,11,FMN 03 Kolonel Silvertopstraat
651,Kolonel Silvertopstraat 5333,2022-09-10,11:00:00,44,29,15,FMN 03 Kolonel Silvertopstraat
651,Kolonel Silvertopstraat 5333,2022-09-10,12:00:00,86,60,26,FMN 03 Kolonel Silvertopstraat
651,Kolonel Silvertopstraat 5333,2022-09-10,13:00:00,96,68,28,FMN 03 Kolonel Silvertopstraat
651,Kolonel Silvertopstraat 5333,2022-09-10,14:00:00,117,80,37,FMN 03 Kolonel Silvertopstraat
651,Kolonel Silvertopstraat 5333,2022-09-10,15:00:00,146,104,42,FMN 03 Kolonel Silvertopstraat
651,Kolonel Silvertopstraat 5333,2022-09-10,16:00:00,179,124,55,FMN 03 Kolonel Silvertopstraat
651,Kolonel Silvertopstraat 5333,2022-09-10,17:00:00,200,146,54,FMN 03 Kolonel Silvertopstraat
651,Kolonel Silvertopstraat 5333,2022-09-10,18:00:00,192,120,72,FMN 03 Kolonel Silvertopstraat
651,Kolonel Silvertopstraat 5333,2022-09-10,19:00:00,182,124,58,FMN 03 Kolonel Silvertopstraat
651,Kolonel Silvertopstraat 5333,2022-09-10,20:00:00,134,86,48,FMN 03 Kolonel Silvertopstraat
651,Kolonel Silvertopstraat 5333,2022-09-10,21:00:00,137,91,46,FMN 03 Kolonel Silvertopstraat
651,Kolonel Silvertopstraat 5333,2022-09-10,22:00:00,121,73,48,FMN 03 Kolonel Silvertopstraat
651,Kolonel Silvertopstraat 5333,2022-09-10,23:00:00,86,38,48,FMN 03 Kolonel Silvertopstraat
651,Kolonel Silvertopstraat 5333,2022-09-11,00:00:00,60,26,34,FMN 03 Kolonel Silvertopstraat
651,Kolonel Silvertopstraat 5333,2022-09-11,01:00:00,45,9,36,FMN 03 Kolonel Silvertopstraat
651,Kolonel Silvertopstraat 5333,2022-09-11,02:00:00,20,10,10,FMN 03 Kolonel Silvertopstraat
651,Kolonel Silvertopstraat 5333,2022-09-11,03:00:00,29,13,16,FMN 03 Kolonel Silvertopstraat
651,Kolonel Silvertopstraat 5333,2022-09-11,04:00:00,12,8,4,FMN 03 Kolonel Silvertopstraat
651,Kolonel Silvertopstraat 5333,2022-09-11,05:00:00,24,17,7,FMN 03 Kolonel Silvertopstraat
651,Kolonel Silvertopstraat 5333,2022-09-11,06:00:00,35,28,7,FMN 03 Kolonel Silvertopstraat
651,Kolonel Silvertopstraat 5333,2022-09-11,07:00:00,38,30,8,FMN 03 Kolonel Silvertopstraat
651,Kolonel Silvertopstraat 5333,2022-09-11,08:00:00,92,76,16,FMN 03 Kolonel Silvertopstraat
651,Kolonel Silvertopstraat 5333,2022-09-11,09:00:00,151,116,35,FMN 03 Kolonel Silvertopstraat
651,Kolonel Silvertopstraat 5333,2022-09-11,10:00:00,234,130,104,FMN 03 Kolonel Silvertopstraat
651,Kolonel Silvertopstraat 5333,2022-09-11,11:00:00,244,188,56,FMN 03 Kolonel Silvertopstraat
651,Kolonel Silvertopstraat 5333,2022-09-11,12:00:00,308,249,59,FMN 03 Kolonel Silvertopstraat
651,Kolonel Silvertopstraat 5333,2022-09-11,13:00:00,272,206,66,FMN 03 Kolonel Silvertopstraat
651,Kolonel Silvertopstraat 5333,2022-09-11,14:00:00,256,191,65,FMN 03 Kolonel Silvertopstraat
651,Kolonel Silvertopstraat 5333,2022-09-11,15:00:00,227,163,64,FMN 03 Kolonel Silvertopstraat
651,Kolonel Silvertopstraat 5333,2022-09-11,16:00:00,243,161,82,FMN 03 Kolonel Silvertopstraat
651,Kolonel Silvertopstraat 5333,2022-09-11,17:00:00,238,147,91,FMN 03 Kolonel Silvertopstraat
651,Kolonel Silvertopstraat 5333,2022-09-11,18:00:00,199,131,68,FMN 03 Kolonel Silvertopstraat
651,Kolonel Silvertopstraat 5333,2022-09-11,19:00:00,182,97,85,FMN 03 Kolonel Silvertopstraat
651,Kolonel Silvertopstraat 5333,2022-09-11,20:00:00,167,101,66,FMN 03 Kolonel Silvertopstraat
651,Kolonel Silvertopstraat 5333,2022-09-11,21:00:00,118,68,50,FMN 03 Kolonel Silvertopstraat
651,Kolonel Silvertopstraat 5333,2022-09-11,22:00:00,93,45,48,FMN 03 Kolonel Silvertopstraat
651,Kolonel Silvertopstraat 5333,2022-09-11,23:00:00,48,20,28,FMN 03 Kolonel Silvertopstraat
651,Kolonel Silvertopstraat 5333,2022-09-12,00:00:00,31,7,24,FMN 03 Kolonel Silvertopstraat
651,Kolonel Silvertopstraat 5333,2022-09-12,01:00:00,23,8,15,FMN 03 Kolonel Silvertopstraat
651,Kolonel Silvertopstraat 5333,2022-09-12,02:00:00,16,7,9,FMN 03 Kolonel Silvertopstraat
651,Kolonel Silvertopstraat 5333,2022-09-12,03:00:00,10,6,4,FMN 03 Kolonel Silvertopstraat
651,Kolonel Silvertopstraat 5333,2022-09-12,04:00:00,31,24,7,FMN 03 Kolonel Silvertopstraat
651,Kolonel Silvertopstraat 5333,2022-09-12,05:00:00,59,46,13,FMN 03 Kolonel Silvertopstraat
651,Kolonel Silvertopstraat 5333,2022-09-12,06:00:00,146,107,39,FMN 03 Kolonel Silvertopstraat
651,Kolonel Silvertopstraat 5333,2022-09-12,07:00:00,435,372,63,FMN 03 Kolonel Silvertopstraat
651,Kolonel Silvertopstraat 5333,2022-09-12,08:00:00,737,623,114,FMN 03 Kolonel Silvertopstraat
651,Kolonel Silvertopstraat 5333,2022-09-12,09:00:00,232,177,55,FMN 03 Kolonel Silvertopstraat
651,Kolonel Silvertopstraat 5333,2022-09-12,10:00:00,146,108,38,FMN 03 Kolonel Silvertopstraat
651,Kolonel Silvertopstraat 5333,2022-09-12,11:00:00,168,133,35,FMN 03 Kolonel Silvertopstraat
651,Kolonel Silvertopstraat 5333,2022-09-12,12:00:00,239,176,63,FMN 03 Kolonel Silvertopstraat
651,Kolonel Silvertopstraat 5333,2022-09-12,13:00:00,192,130,62,FMN 03 Kolonel Silvertopstraat
651,Kolonel Silvertopstraat 5333,2022-09-12,14:00:00,261,192,69,FMN 03 Kolonel Silvertopstraat
651,Kolonel Silvertopstraat 5333,2022-09-12,15:00:00,384,240,144,FMN 03 Kolonel Silvertopstraat
651,Kolonel Silvertopstraat 5333,2022-09-12,16:00:00,458,301,157,FMN 03 Kolonel Silvertopstraat
651,Kolonel Silvertopstraat 5333,2022-09-12,17:00:00,438,283,155,FMN 03 Kolonel Silvertopstraat
651,Kolonel Silvertopstraat 5333,2022-09-12,18:00:00,339,226,113,FMN 03 Kolonel Silvertopstraat
651,Kolonel Silvertopstraat 5333,2022-09-12,19:00:00,239,160,79,FMN 03 Kolonel Silvertopstraat
651,Kolonel Silvertopstraat 5333,2022-09-12,20:00:00,176,85,91,FMN 03 Kolonel Silvertopstraat
651,Kolonel Silvertopstraat 5333,2022-09-12,21:00:00,156,69,87,FMN 03 Kolonel Silvertopstraat
651,Kolonel Silvertopstraat 5333,2022-09-12,22:00:00,144,79,65,FMN 03 Kolonel Silvertopstraat
651,Kolonel Silvertopstraat 5333,2022-09-12,23:00:00,64,32,32,FMN 03 Kolonel Silvertopstraat
651,Kolonel Silvertopstraat 5333,2022-09-13,00:00:00,21,11,10,FMN 03 Kolonel Silvertopstraat
651,Kolonel Silvertopstraat 5333,2022-09-13,01:00:00,26,10,16,FMN 03 Kolonel Silvertopstraat
651,Kolonel Silvertopstraat 5333,2022-09-13,02:00:00,16,6,10,FMN 03 Kolonel Silvertopstraat
651,Kolonel Silvertopstraat 5333,2022-09-13,03:00:00,7,6,1,FMN 03 Kolonel Silvertopstraat
651,Kolonel Silvertopstraat 5333,2022-09-13,04:00:00,34,23,11,FMN 03 Kolonel Silvertopstraat
651,Kolonel Silvertopstraat 5333,2022-09-13,05:00:00,64,46,18,FMN 03 Kolonel Silvertopstraat
651,Kolonel Silvertopstraat 5333,2022-09-13,06:00:00,155,125,30,FMN 03 Kolonel Silvertopstraat
651,Kolonel Silvertopstraat 5333,2022-09-13,07:00:00,423,349,74,FMN 03 Kolonel Silvertopstraat
651,Kolonel Silvertopstraat 5333,2022-09-13,08:00:00,759,654,105,FMN 03 Kolonel Silvertopstraat
651,Kolonel Silvertopstraat 5333,2022-09-13,09:00:00,258,207,51,FMN 03 Kolonel Silvertopstraat
651,Kolonel Silvertopstraat 5333,2022-09-13,10:00:00,172,134,38,FMN 03 Kolonel Silvertopstraat
651,Kolonel Silvertopstraat 5333,2022-09-13,11:00:00,151,106,45,FMN 03 Kolonel Silvertopstraat
651,Kolonel Silvertopstraat 5333,2022-09-13,12:00:00,227,152,75,FMN 03 Kolonel Silvertopstraat
651,Kolonel Silvertopstraat 5333,2022-09-13,13:00:00,203,149,54,FMN 03 Kolonel Silvertopstraat
651,Kolonel Silvertopstraat 5333,2022-09-13,14:00:00,205,130,75,FMN 03 Kolonel Silvertopstraat
651,Kolonel Silvertopstraat 5333,2022-09-13,15:00:00,369,223,146,FMN 03 Kolonel Silvertopstraat
651,Kolonel Silvertopstraat 5333,2022-09-13,16:00:00,382,252,130,FMN 03 Kolonel Silvertopstraat
651,Kolonel Silvertopstraat 5333,2022-09-13,17:00:00,419,260,159,FMN 03 Kolonel Silvertopstraat
651,Kolonel Silvertopstraat 5333,2022-09-13,18:00:00,260,158,102,FMN 03 Kolonel Silvertopstraat
651,Kolonel Silvertopstraat 5333,2022-09-13,19:00:00,210,135,75,FMN 03 Kolonel Silvertopstraat
651,Kolonel Silvertopstraat 5333,2022-09-13,20:00:00,165,104,61,FMN 03 Kolonel Silvertopstraat
651,Kolonel Silvertopstraat 5333,2022-09-13,21:00:00,114,57,57,FMN 03 Kolonel Silvertopstraat
651,Kolonel Silvertopstraat 5333,2022-09-13,22:00:00,84,53,31,FMN 03 Kolonel Silvertopstraat
651,Kolonel Silvertopstraat 5333,2022-09-13,23:00:00,51,24,27,FMN 03 Kolonel Silvertopstraat
651,Kolonel Silvertopstraat 5333,2022-09-14,00:00:00,30,12,18,FMN 03 Kolonel Silvertopstraat
651,Kolonel Silvertopstraat 5333,2022-09-14,01:00:00,20,8,12,FMN 03 Kolonel Silvertopstraat
651,Kolonel Silvertopstraat 5333,2022-09-14,02:00:00,6,4,2,FMN 03 Kolonel Silvertopstraat
651,Kolonel Silvertopstraat 5333,2022-09-14,03:00:00,6,4,2,FMN 03 Kolonel Silvertopstraat
651,Kolonel Silvertopstraat 5333,2022-09-14,04:00:00,24,17,7,FMN 03 Kolonel Silvertopstraat
651,Kolonel Silvertopstraat 5333,2022-09-14,05:00:00,43,32,11,FMN 03 Kolonel Silvertopstraat
651,Kolonel Silvertopstraat 5333,2022-09-14,06:00:00,121,95,26,FMN 03 Kolonel Silvertopstraat
651,Kolonel Silvertopstraat 5333,2022-09-14,07:00:00,257,205,52,FMN 03 Kolonel Silvertopstraat
651,Kolonel Silvertopstraat 5333,2022-09-14,08:00:00,447,355,92,FMN 03 Kolonel Silvertopstraat
651,Kolonel Silvertopstraat 5333,2022-09-14,09:00:00,128,97,31,FMN 03 Kolonel Silvertopstraat
651,Kolonel Silvertopstraat 5333,2022-09-14,10:00:00,97,67,30,FMN 03 Kolonel Silvertopstraat
651,Kolonel Silvertopstraat 5333,2022-09-14,11:00:00,84,64,20,FMN 03 Kolonel Silvertopstraat
651,Kolonel Silvertopstraat 5333,2022-09-14,12:00:00,197,132,65,FMN 03 Kolonel Silvertopstraat
651,Kolonel Silvertopstraat 5333,2022-09-14,13:00:00,125,72,53,FMN 03 Kolonel Silvertopstraat
651,Kolonel Silvertopstraat 5333,2022-09-14,14:00:00,94,59,35,FMN 03 Kolonel Silvertopstraat
651,Kolonel Silvertopstraat 5333,2022-09-14,15:00:00,118,73,45,FMN 03 Kolonel Silvertopstraat
651,Kolonel Silvertopstraat 5333,2022-09-14,16:00:00,213,156,57,FMN 03 Kolonel Silvertopstraat
651,Kolonel Silvertopstraat 5333,2022-09-14,17:00:00,257,167,90,FMN 03 Kolonel Silvertopstraat
651,Kolonel Silvertopstraat 5333,2022-09-14,18:00:00,235,147,88,FMN 03 Kolonel Silvertopstraat
651,Kolonel Silvertopstraat 5333,2022-09-14,19:00:00,191,113,78,FMN 03 Kolonel Silvertopstraat
651,Kolonel Silvertopstraat 5333,2022-09-14,20:00:00,125,83,42,FMN 03 Kolonel Silvertopstraat
651,Kolonel Silvertopstraat 5333,2022-09-14,21:00:00,88,51,37,FMN 03 Kolonel Silvertopstraat
651,Kolonel Silvertopstraat 5333,2022-09-14,22:00:00,109,55,54,FMN 03 Kolonel Silvertopstraat
651,Kolonel Silvertopstraat 5333,2022-09-14,23:00:00,49,19,30,FMN 03 Kolonel Silvertopstraat
651,Kolonel Silvertopstraat 5333,2022-09-15,00:00:00,29,12,17,FMN 03 Kolonel Silvertopstraat
651,Kolonel Silvertopstraat 5333,2022-09-15,01:00:00,17,11,6,FMN 03 Kolonel Silvertopstraat
651,Kolonel Silvertopstraat 5333,2022-09-15,02:00:00,5,1,4,FMN 03 Kolonel Silvertopstraat
651,Kolonel Silvertopstraat 5333,2022-09-15,03:00:00,13,7,6,FMN 03 Kolonel Silvertopstraat
651,Kolonel Silvertopstraat 5333,2022-09-15,04:00:00,27,22,5,FMN 03 Kolonel Silvertopstraat
651,Kolonel Silvertopstraat 5333,2022-09-15,05:00:00,53,46,7,FMN 03 Kolonel Silvertopstraat
651,Kolonel Silvertopstraat 5333,2022-09-15,06:00:00,148,117,31,FMN 03 Kolonel Silvertopstraat
651,Kolonel Silvertopstraat 5333,2022-09-15,07:00:00,373,314,59,FMN 03 Kolonel Silvertopstraat
651,Kolonel Silvertopstraat 5333,2022-09-15,08:00:00,692,575,117,FMN 03 Kolonel Silvertopstraat
651,Kolonel Silvertopstraat 5333,2022-09-15,09:00:00,242,179,63,FMN 03 Kolonel Silvertopstraat
651,Kolonel Silvertopstraat 5333,2022-09-15,10:00:00,154,112,42,FMN 03 Kolonel Silvertopstraat
651,Kolonel Silvertopstraat 5333,2022-09-15,11:00:00,154,121,33,FMN 03 Kolonel Silvertopstraat
651,Kolonel Silvertopstraat 5333,2022-09-15,12:00:00,214,154,60,FMN 03 Kolonel Silvertopstraat
651,Kolonel Silvertopstraat 5333,2022-09-15,13:00:00,144,102,42,FMN 03 Kolonel Silvertopstraat
651,Kolonel Silvertopstraat 5333,2022-09-15,14:00:00,213,157,56,FMN 03 Kolonel Silvertopstraat
651,Kolonel Silvertopstraat 5333,2022-09-15,15:00:00,356,217,139,FMN 03 Kolonel Silvertopstraat
651,Kolonel Silvertopstraat 5333,2022-09-15,16:00:00,408,248,160,FMN 03 Kolonel Silvertopstraat
651,Kolonel Silvertopstraat 5333,2022-09-15,17:00:00,411,265,146,FMN 03 Kolonel Silvertopstraat
651,Kolonel Silvertopstraat 5333,2022-09-15,18:00:00,343,217,126,FMN 03 Kolonel Silvertopstraat
651,Kolonel Silvertopstraat 5333,2022-09-15,19:00:00,248,163,85,FMN 03 Kolonel Silvertopstraat
651,Kolonel Silvertopstraat 5333,2022-09-15,20:00:00,187,112,75,FMN 03 Kolonel Silvertopstraat
651,Kolonel Silvertopstraat 5333,2022-09-15,21:00:00,143,72,71,FMN 03 Kolonel Silvertopstraat
651,Kolonel Silvertopstraat 5333,2022-09-15,22:00:00,124,65,59,FMN 03 Kolonel Silvertopstraat
651,Kolonel Silvertopstraat 5333,2022-09-15,23:00:00,66,28,38,FMN 03 Kolonel Silvertopstraat
651,Kolonel Silvertopstraat 5333,2022-09-16,00:00:00,35,20,15,FMN 03 Kolonel Silvertopstraat
651,Kolonel Silvertopstraat 5333,2022-09-16,01:00:00,28,14,14,FMN 03 Kolonel Silvertopstraat
651,Kolonel Silvertopstraat 5333,2022-09-16,02:00:00,17,6,11,FMN 03 Kolonel Silvertopstraat
651,Kolonel Silvertopstraat 5333,2022-09-16,03:00:00,10,5,5,FMN 03 Kolonel Silvertopstraat
651,Kolonel Silvertopstraat 5333,2022-09-16,04:00:00,26,19,7,FMN 03 Kolonel Silvertopstraat
651,Kolonel Silvertopstraat 5333,2022-09-16,05:00:00,67,47,20,FMN 03 Kolonel Silvertopstraat
651,Kolonel Silvertopstraat 5333,2022-09-16,06:00:00,98,77,21,FMN 03 Kolonel Silvertopstraat
651,Kolonel Silvertopstraat 5333,2022-09-16,07:00:00,284,227,57,FMN 03 Kolonel Silvertopstraat
651,Kolonel Silvertopstraat 5333,2022-09-16,08:00:00,482,405,77,FMN 03 Kolonel Silvertopstraat
651,Kolonel Silvertopstraat 5333,2022-09-16,09:00:00,185,144,41,FMN 03 Kolonel Silvertopstraat
651,Kolonel Silvertopstraat 5333,2022-09-16,10:00:00,140,107,33,FMN 03 Kolonel Silvertopstraat
651,Kolonel Silvertopstraat 5333,2022-09-16,11:00:00,114,75,39,FMN 03 Kolonel Silvertopstraat
651,Kolonel Silvertopstraat 5333,2022-09-16,12:00:00,172,114,58,FMN 03 Kolonel Silvertopstraat
651,Kolonel Silvertopstraat 5333,2022-09-16,13:00:00,143,90,53,FMN 03 Kolonel Silvertopstraat
651,Kolonel Silvertopstraat 5333,2022-09-16,14:00:00,169,113,56,FMN 03 Kolonel Silvertopstraat
651,Kolonel Silvertopstraat 5333,2022-09-16,15:00:00,303,205,98,FMN 03 Kolonel Silvertopstraat
651,Kolonel Silvertopstraat 5333,2022-09-16,16:00:00,288,196,92,FMN 03 Kolonel Silvertopstraat
651,Kolonel Silvertopstraat 5333,2022-09-16,17:00:00,269,164,105,FMN 03 Kolonel Silvertopstraat
651,Kolonel Silvertopstraat 5333,2022-09-16,18:00:00,189,123,66,FMN 03 Kolonel Silvertopstraat
651,Kolonel Silvertopstraat 5333,2022-09-16,19:00:00,117,66,51,FMN 03 Kolonel Silvertopstraat
651,Kolonel Silvertopstraat 5333,2022-09-16,20:00:00,85,44,41,FMN 03 Kolonel Silvertopstraat
651,Kolonel Silvertopstraat 5333,2022-09-16,21:00:00,95,51,44,FMN 03 Kolonel Silvertopstraat
651,Kolonel Silvertopstraat 5333,2022-09-16,22:00:00,76,34,42,FMN 03 Kolonel Silvertopstraat
651,Kolonel Silvertopstraat 5333,2022-09-16,23:00:00,35,18,17,FMN 03 Kolonel Silvertopstraat
651,Kolonel Silvertopstraat 5333,2022-09-17,00:00:00,48,15,33,FMN 03 Kolonel Silvertopstraat
651,Kolonel Silvertopstraat 5333,2022-09-17,01:00:00,27,7,20,FMN 03 Kolonel Silvertopstraat
651,Kolonel Silvertopstraat 5333,2022-09-17,02:00:00,17,6,11,FMN 03 Kolonel Silvertopstraat
651,Kolonel Silvertopstraat 5333,2022-09-17,03:00:00,18,6,12,FMN 03 Kolonel Silvertopstraat
651,Kolonel Silvertopstraat 5333,2022-09-17,04:00:00,17,8,9,FMN 03 Kolonel Silvertopstraat
651,Kolonel Silvertopstraat 5333,2022-09-17,05:00:00,24,14,10,FMN 03 Kolonel Silvertopstraat
651,Kolonel Silvertopstraat 5333,2022-09-17,06:00:00,24,21,3,FMN 03 Kolonel Silvertopstraat
651,Kolonel Silvertopstraat 5333,2022-09-17,07:00:00,37,31,6,FMN 03 Kolonel Silvertopstraat
651,Kolonel Silvertopstraat 5333,2022-09-17,08:00:00,74,60,14,FMN 03 Kolonel Silvertopstraat
651,Kolonel Silvertopstraat 5333,2022-09-17,09:00:00,105,86,19,FMN 03 Kolonel Silvertopstraat
651,Kolonel Silvertopstraat 5333,2022-09-17,10:00:00,116,90,26,FMN 03 Kolonel Silvertopstraat
651,Kolonel Silvertopstraat 5333,2022-09-17,11:00:00,70,41,29,FMN 03 Kolonel Silvertopstraat
651,Kolonel Silvertopstraat 5333,2022-09-17,12:00:00,107,80,27,FMN 03 Kolonel Silvertopstraat
651,Kolonel Silvertopstraat 5333,2022-09-17,13:00:00,145,95,50,FMN 03 Kolonel Silvertopstraat
651,Kolonel Silvertopstraat 5333,2022-09-17,14:00:00,148,113,35,FMN 03 Kolonel Silvertopstraat
651,Kolonel Silvertopstraat 5333,2022-09-17,15:00:00,145,100,45,FMN 03 Kolonel Silvertopstraat
651,Kolonel Silvertopstraat 5333,2022-09-17,16:00:00,154,115,39,FMN 03 Kolonel Silvertopstraat
651,Kolonel Silvertopstraat 5333,2022-09-17,17:00:00,159,96,63,FMN 03 Kolonel Silvertopstraat
651,Kolonel Silvertopstraat 5333,2022-09-17,18:00:00,161,106,55,FMN 03 Kolonel Silvertopstraat
651,Kolonel Silvertopstraat 5333,2022-09-17,19:00:00,115,83,32,FMN 03 Kolonel Silvertopstraat
651,Kolonel Silvertopstraat 5333,2022-09-17,20:00:00,97,59,38,FMN 03 Kolonel Silvertopstraat
651,Kolonel Silvertopstraat 5333,2022-09-17,21:00:00,66,37,29,FMN 03 Kolonel Silvertopstraat
651,Kolonel Silvertopstraat 5333,2022-09-17,22:00:00,68,43,25,FMN 03 Kolonel Silvertopstraat
651,Kolonel Silvertopstraat 5333,2022-09-17,23:00:00,54,29,25,FMN 03 Kolonel Silvertopstraat
651,Kolonel Silvertopstraat 5333,2022-09-18,00:00:00,53,17,36,FMN 03 Kolonel Silvertopstraat
651,Kolonel Silvertopstraat 5333,2022-09-18,01:00:00,30,9,21,FMN 03 Kolonel Silvertopstraat
651,Kolonel Silvertopstraat 5333,2022-09-18,02:00:00,28,8,20,FMN 03 Kolonel Silvertopstraat
651,Kolonel Silvertopstraat 5333,2022-09-18,03:00:00,22,6,16,FMN 03 Kolonel Silvertopstraat
651,Kolonel Silvertopstraat 5333,2022-09-18,04:00:00,18,3,15,FMN 03 Kolonel Silvertopstraat
651,Kolonel Silvertopstraat 5333,2022-09-18,05:00:00,14,11,3,FMN 03 Kolonel Silvertopstraat
651,Kolonel Silvertopstraat 5333,2022-09-18,06:00:00,21,16,5,FMN 03 Kolonel Silvertopstraat
651,Kolonel Silvertopstraat 5333,2022-09-18,07:00:00,22,18,4,FMN 03 Kolonel Silvertopstraat
651,Kolonel Silvertopstraat 5333,2022-09-18,08:00:00,47,38,9,FMN 03 Kolonel Silvertopstraat
651,Kolonel Silvertopstraat 5333,2022-09-18,09:00:00,61,45,16,FMN 03 Kolonel Silvertopstraat
651,Kolonel Silvertopstraat 5333,2022-09-18,10:00:00,87,68,19,FMN 03 Kolonel Silvertopstraat
651,Kolonel Silvertopstraat 5333,2022-09-18,11:00:00,97,68,29,FMN 03 Kolonel Silvertopstraat
651,Kolonel Silvertopstraat 5333,2022-09-18,12:00:00,126,85,41,FMN 03 Kolonel Silvertopstraat
651,Kolonel Silvertopstraat 5333,2022-09-18,13:00:00,144,103,41,FMN 03 Kolonel Silvertopstraat
651,Kolonel Silvertopstraat 5333,2022-09-18,14:00:00,149,111,38,FMN 03 Kolonel Silvertopstraat
651,Kolonel Silvertopstraat 5333,2022-09-18,15:00:00,156,107,49,FMN 03 Kolonel Silvertopstraat
651,Kolonel Silvertopstraat 5333,2022-09-18,16:00:00,135,87,48,FMN 03 Kolonel Silvertopstraat
651,Kolonel Silvertopstraat 5333,2022-09-18,17:00:00,140,86,54,FMN 03 Kolonel Silvertopstraat
651,Kolonel Silvertopstraat 5333,2022-09-18,18:00:00,98,52,46,FMN 03 Kolonel Silvertopstraat
651,Kolonel Silvertopstraat 5333,2022-09-18,19:00:00,82,45,37,FMN 03 Kolonel Silvertopstraat
651,Kolonel Silvertopstraat 5333,2022-09-18,20:00:00,101,65,36,FMN 03 Kolonel Silvertopstraat
651,Kolonel Silvertopstraat 5333,2022-09-18,21:00:00,63,35,28,FMN 03 Kolonel Silvertopstraat
651,Kolonel Silvertopstraat 5333,2022-09-18,22:00:00,54,27,27,FMN 03 Kolonel Silvertopstraat
651,Kolonel Silvertopstraat 5333,2022-09-18,23:00:00,39,17,22,FMN 03 Kolonel Silvertopstraat
651,Kolonel Silvertopstraat 5333,2022-09-19,00:00:00,19,11,8,FMN 03 Kolonel Silvertopstraat
651,Kolonel Silvertopstraat 5333,2022-09-19,01:00:00,14,7,7,FMN 03 Kolonel Silvertopstraat
651,Kolonel Silvertopstraat 5333,2022-09-19,02:00:00,6,3,3,FMN 03 Kolonel Silvertopstraat
651,Kolonel Silvertopstraat 5333,2022-09-19,03:00:00,10,5,5,FMN 03 Kolonel Silvertopstraat
651,Kolonel Silvertopstraat 5333,2022-09-19,04:00:00,26,16,10,FMN 03 Kolonel Silvertopstraat
651,Kolonel Silvertopstraat 5333,2022-09-19,05:00:00,50,35,15,FMN 03 Kolonel Silvertopstraat
651,Kolonel Silvertopstraat 5333,2022-09-19,06:00:00,133,106,27,FMN 03 Kolonel Silvertopstraat
651,Kolonel Silvertopstraat 5333,2022-09-19,07:00:00,374,311,63,FMN 03 Kolonel Silvertopstraat
651,Kolonel Silvertopstraat 5333,2022-09-19,08:00:00,748,664,84,FMN 03 Kolonel Silvertopstraat
651,Kolonel Silvertopstraat 5333,2022-09-19,09:00:00,235,185,50,FMN 03 Kolonel Silvertopstraat
651,Kolonel Silvertopstraat 5333,2022-09-19,10:00:00,165,129,36,FMN 03 Kolonel Silvertopstraat
651,Kolonel Silvertopstraat 5333,2022-09-19,11:00:00,149,111,38,FMN 03 Kolonel Silvertopstraat
651,Kolonel Silvertopstraat 5333,2022-09-19,12:00:00,209,151,58,FMN 03 Kolonel Silvertopstraat
651,Kolonel Silvertopstraat 5333,2022-09-19,13:00:00,194,135,59,FMN 03 Kolonel Silvertopstraat
651,Kolonel Silvertopstraat 5333,2022-09-19,14:00:00,242,164,78,FMN 03 Kolonel Silvertopstraat
651,Kolonel Silvertopstraat 5333,2022-09-19,15:00:00,335,224,111,FMN 03 Kolonel Silvertopstraat
651,Kolonel Silvertopstraat 5333,2022-09-19,16:00:00,436,277,159,FMN 03 Kolonel Silvertopstraat
651,Kolonel Silvertopstraat 5333,2022-09-19,17:00:00,408,263,145,FMN 03 Kolonel Silvertopstraat
651,Kolonel Silvertopstraat 5333,2022-09-19,18:00:00,306,198,108,FMN 03 Kolonel Silvertopstraat
651,Kolonel Silvertopstraat 5333,2022-09-19,19:00:00,186,103,83,FMN 03 Kolonel Silvertopstraat
651,Kolonel Silvertopstraat 5333,2022-09-19,20:00:00,141,79,62,FMN 03 Kolonel Silvertopstraat
651,Kolonel Silvertopstraat 5333,2022-09-19,21:00:00,113,53,60,FMN 03 Kolonel Silvertopstraat
651,Kolonel Silvertopstraat 5333,2022-09-19,22:00:00,85,50,35,FMN 03 Kolonel Silvertopstraat
651,Kolonel Silvertopstraat 5333,2022-09-19,23:00:00,58,25,33,FMN 03 Kolonel Silvertopstraat
651,Kolonel Silvertopstraat 5333,2022-09-20,00:00:00,28,14,14,FMN 03 Kolonel Silvertopstraat
651,Kolonel Silvertopstraat 5333,2022-09-20,01:00:00,18,9,9,FMN 03 Kolonel Silvertopstraat
651,Kolonel Silvertopstraat 5333,2022-09-20,02:00:00,4,2,2,FMN 03 Kolonel Silvertopstraat
651,Kolonel Silvertopstraat 5333,2022-09-20,03:00:00,10,6,4,FMN 03 Kolonel Silvertopstraat
651,Kolonel Silvertopstraat 5333,2022-09-20,04:00:00,25,17,8,FMN 03 Kolonel Silvertopstraat
651,Kolonel Silvertopstraat 5333,2022-09-20,05:00:00,67,47,20,FMN 03 Kolonel Silvertopstraat
651,Kolonel Silvertopstraat 5333,2022-09-20,06:00:00,145,111,34,FMN 03 Kolonel Silvertopstraat
651,Kolonel Silvertopstraat 5333,2022-09-20,07:00:00,438,369,69,FMN 03 Kolonel Silvertopstraat
651,Kolonel Silvertopstraat 5333,2022-09-20,08:00:00,772,669,103,FMN 03 Kolonel Silvertopstraat
651,Kolonel Silvertopstraat 5333,2022-09-20,09:00:00,251,207,44,FMN 03 Kolonel Silvertopstraat
651,Kolonel Silvertopstraat 5333,2022-09-20,10:00:00,201,160,41,FMN 03 Kolonel Silvertopstraat
651,Kolonel Silvertopstraat 5333,2022-09-20,11:00:00,152,112,40,FMN 03 Kolonel Silvertopstraat
651,Kolonel Silvertopstraat 5333,2022-09-20,12:00:00,191,137,54,FMN 03 Kolonel Silvertopstraat
651,Kolonel Silvertopstraat 5333,2022-09-20,13:00:00,187,131,56,FMN 03 Kolonel Silvertopstraat
651,Kolonel Silvertopstraat 5333,2022-09-20,14:00:00,216,134,82,FMN 03 Kolonel Silvertopstraat
651,Kolonel Silvertopstraat 5333,2022-09-20,15:00:00,373,246,127,FMN 03 Kolonel Silvertopstraat
651,Kolonel Silvertopstraat 5333,2022-09-20,16:00:00,452,300,152,FMN 03 Kolonel Silvertopstraat
651,Kolonel Silvertopstraat 5333,2022-09-20,17:00:00,440,281,159,FMN 03 Kolonel Silvertopstraat
651,Kolonel Silvertopstraat 5333,2022-09-20,18:00:00,360,224,136,FMN 03 Kolonel Silvertopstraat
651,Kolonel Silvertopstraat 5333,2022-09-20,19:00:00,224,144,80,FMN 03 Kolonel Silvertopstraat
651,Kolonel Silvertopstraat 5333,2022-09-20,20:00:00,176,95,81,FMN 03 Kolonel Silvertopstraat
651,Kolonel Silvertopstraat 5333,2022-09-20,21:00:00,139,74,65,FMN 03 Kolonel Silvertopstraat
651,Kolonel Silvertopstraat 5333,2022-09-20,22:00:00,120,77,43,FMN 03 Kolonel Silvertopstraat
651,Kolonel Silvertopstraat 5333,2022-09-20,23:00:00,54,23,31,FMN 03 Kolonel Silvertopstraat
651,Kolonel Silvertopstraat 5333,2022-09-21,00:00:00,38,17,21,FMN 03 Kolonel Silvertopstraat
651,Kolonel Silvertopstraat 5333,2022-09-21,01:00:00,12,5,7,FMN 03 Kolonel Silvertopstraat
651,Kolonel Silvertopstraat 5333,2022-09-21,02:00:00,11,4,7,FMN 03 Kolonel Silvertopstraat
651,Kolonel Silvertopstraat 5333,2022-09-21,03:00:00,14,6,8,FMN 03 Kolonel Silvertopstraat
651,Kolonel Silvertopstraat 5333,2022-09-21,04:00:00,31,25,6,FMN 03 Kolonel Silvertopstraat
651,Kolonel Silvertopstraat 5333,2022-09-21,05:00:00,65,48,17,FMN 03 Kolonel Silvertopstraat
651,Kolonel Silvertopstraat 5333,2022-09-21,06:00:00,163,130,33,FMN 03 Kolonel Silvertopstraat
651,Kolonel Silvertopstraat 5333,2022-09-21,07:00:00,427,360,67,FMN 03 Kolonel Silvertopstraat
651,Kolonel Silvertopstraat 5333,2022-09-21,08:00:00,748,638,110,FMN 03 Kolonel Silvertopstraat
651,Kolonel Silvertopstraat 5333,2022-09-21,09:00:00,253,205,48,FMN 03 Kolonel Silvertopstraat
651,Kolonel Silvertopstraat 5333,2022-09-21,10:00:00,211,170,41,FMN 03 Kolonel Silvertopstraat
651,Kolonel Silvertopstraat 5333,2022-09-21,11:00:00,214,161,53,FMN 03 Kolonel Silvertopstraat
651,Kolonel Silvertopstraat 5333,2022-09-21,12:00:00,399,261,138,FMN 03 Kolonel Silvertopstraat
651,Kolonel Silvertopstraat 5333,2022-09-21,13:00:00,290,212,78,FMN 03 Kolonel Silvertopstraat
651,Kolonel Silvertopstraat 5333,2022-09-21,14:00:00,238,174,64,FMN 03 Kolonel Silvertopstraat
651,Kolonel Silvertopstraat 5333,2022-09-21,15:00:00,285,183,102,FMN 03 Kolonel Silvertopstraat
651,Kolonel Silvertopstraat 5333,2022-09-21,16:00:00,388,270,118,FMN 03 Kolonel Silvertopstraat
651,Kolonel Silvertopstraat 5333,2022-09-21,17:00:00,472,307,165,FMN 03 Kolonel Silvertopstraat
651,Kolonel Silvertopstraat 5333,2022-09-21,18:00:00,338,222,116,FMN 03 Kolonel Silvertopstraat
651,Kolonel Silvertopstraat 5333,2022-09-21,19:00:00,303,196,107,FMN 03 Kolonel Silvertopstraat
651,Kolonel Silvertopstraat 5333,2022-09-21,20:00:00,182,109,73,FMN 03 Kolonel Silvertopstraat
651,Kolonel Silvertopstraat 5333,2022-09-21,21:00:00,132,72,60,FMN 03 Kolonel Silvertopstraat
651,Kolonel Silvertopstraat 5333,2022-09-21,22:00:00,142,90,52,FMN 03 Kolonel Silvertopstraat
651,Kolonel Silvertopstraat 5333,2022-09-21,23:00:00,67,29,38,FMN 03 Kolonel Silvertopstraat
651,Kolonel Silvertopstraat 5333,2022-09-22,00:00:00,42,15,27,FMN 03 Kolonel Silvertopstraat
651,Kolonel Silvertopstraat 5333,2022-09-22,01:00:00,17,6,11,FMN 03 Kolonel Silvertopstraat
651,Kolonel Silvertopstraat 5333,2022-09-22,02:00:00,10,3,7,FMN 03 Kolonel Silvertopstraat
651,Kolonel Silvertopstraat 5333,2022-09-22,03:00:00,14,7,7,FMN 03 Kolonel Silvertopstraat
651,Kolonel Silvertopstraat 5333,2022-09-22,04:00:00,23,17,6,FMN 03 Kolonel Silvertopstraat
651,Kolonel Silvertopstraat 5333,2022-09-22,05:00:00,63,44,19,FMN 03 Kolonel Silvertopstraat
651,Kolonel Silvertopstraat 5333,2022-09-22,06:00:00,148,114,34,FMN 03 Kolonel Silvertopstraat
651,Kolonel Silvertopstraat 5333,2022-09-22,07:00:00,401,335,66,FMN 03 Kolonel Silvertopstraat
651,Kolonel Silvertopstraat 5333,2022-09-22,08:00:00,759,651,108,FMN 03 Kolonel Silvertopstraat
651,Kolonel Silvertopstraat 5333,2022-09-22,09:00:00,259,205,54,FMN 03 Kolonel Silvertopstraat
651,Kolonel Silvertopstraat 5333,2022-09-22,10:00:00,216,170,46,FMN 03 Kolonel Silvertopstraat
651,Kolonel Silvertopstraat 5333,2022-09-22,11:00:00,194,148,46,FMN 03 Kolonel Silvertopstraat
651,Kolonel Silvertopstraat 5333,2022-09-22,12:00:00,266,192,74,FMN 03 Kolonel Silvertopstraat
651,Kolonel Silvertopstraat 5333,2022-09-22,13:00:00,250,179,71,FMN 03 Kolonel Silvertopstraat
651,Kolonel Silvertopstraat 5333,2022-09-22,14:00:00,228,164,64,FMN 03 Kolonel Silvertopstraat
651,Kolonel Silvertopstraat 5333,2022-09-22,15:00:00,316,203,113,FMN 03 Kolonel Silvertopstraat
651,Kolonel Silvertopstraat 5333,2022-09-22,16:00:00,433,270,163,FMN 03 Kolonel Silvertopstraat
651,Kolonel Silvertopstraat 5333,2022-09-22,17:00:00,460,299,161,FMN 03 Kolonel Silvertopstraat
651,Kolonel Silvertopstraat 5333,2022-09-22,18:00:00,333,219,114,FMN 03 Kolonel Silvertopstraat
651,Kolonel Silvertopstraat 5333,2022-09-22,19:00:00,224,145,79,FMN 03 Kolonel Silvertopstraat
651,Kolonel Silvertopstraat 5333,2022-09-22,20:00:00,150,93,57,FMN 03 Kolonel Silvertopstraat
651,Kolonel Silvertopstraat 5333,2022-09-22,21:00:00,159,77,82,FMN 03 Kolonel Silvertopstraat
651,Kolonel Silvertopstraat 5333,2022-09-22,22:00:00,140,74,66,FMN 03 Kolonel Silvertopstraat
651,Kolonel Silvertopstraat 5333,2022-09-22,23:00:00,75,35,40,FMN 03 Kolonel Silvertopstraat
651,Kolonel Silvertopstraat 5333,2022-09-23,00:00:00,48,24,24,FMN 03 Kolonel Silvertopstraat
651,Kolonel Silvertopstraat 5333,2022-09-23,01:00:00,23,9,14,FMN 03 Kolonel Silvertopstraat
651,Kolonel Silvertopstraat 5333,2022-09-23,02:00:00,27,8,19,FMN 03 Kolonel Silvertopstraat
651,Kolonel Silvertopstraat 5333,2022-09-23,03:00:00,10,6,4,FMN 03 Kolonel Silvertopstraat
651,Kolonel Silvertopstraat 5333,2022-09-23,04:00:00,27,17,10,FMN 03 Kolonel Silvertopstraat
651,Kolonel Silvertopstraat 5333,2022-09-23,05:00:00,58,43,15,FMN 03 Kolonel Silvertopstraat
651,Kolonel Silvertopstraat 5333,2022-09-23,06:00:00,113,87,26,FMN 03 Kolonel Silvertopstraat
651,Kolonel Silvertopstraat 5333,2022-09-23,07:00:00,340,289,51,FMN 03 Kolonel Silvertopstraat
651,Kolonel Silvertopstraat 5333,2022-09-23,08:00:00,672,592,80,FMN 03 Kolonel Silvertopstraat
651,Kolonel Silvertopstraat 5333,2022-09-23,09:00:00,281,234,47,FMN 03 Kolonel Silvertopstraat
651,Kolonel Silvertopstraat 5333,2022-09-23,10:00:00,236,151,85,FMN 03 Kolonel Silvertopstraat
651,Kolonel Silvertopstraat 5333,2022-09-23,11:00:00,184,120,64,FMN 03 Kolonel Silvertopstraat
651,Kolonel Silvertopstraat 5333,2022-09-23,12:00:00,246,161,85,FMN 03 Kolonel Silvertopstraat
651,Kolonel Silvertopstraat 5333,2022-09-23,13:00:00,257,192,65,FMN 03 Kolonel Silvertopstraat
651,Kolonel Silvertopstraat 5333,2022-09-23,14:00:00,255,161,94,FMN 03 Kolonel Silvertopstraat
651,Kolonel Silvertopstraat 5333,2022-09-23,15:00:00,444,293,151,FMN 03 Kolonel Silvertopstraat
651,Kolonel Silvertopstraat 5333,2022-09-23,16:00:00,403,250,153,FMN 03 Kolonel Silvertopstraat
651,Kolonel Silvertopstraat 5333,2022-09-23,17:00:00,364,237,127,FMN 03 Kolonel Silvertopstraat
651,Kolonel Silvertopstraat 5333,2022-09-23,18:00:00,284,168,116,FMN 03 Kolonel Silvertopstraat
651,Kolonel Silvertopstraat 5333,2022-09-23,19:00:00,175,116,59,FMN 03 Kolonel Silvertopstraat
651,Kolonel Silvertopstraat 5333,2022-09-23,20:00:00,144,91,53,FMN 03 Kolonel Silvertopstraat
651,Kolonel Silvertopstraat 5333,2022-09-23,21:00:00,125,77,48,FMN 03 Kolonel Silvertopstraat
651,Kolonel Silvertopstraat 5333,2022-09-23,22:00:00,80,35,45,FMN 03 Kolonel Silvertopstraat
651,Kolonel Silvertopstraat 5333,2022-09-23,23:00:00,71,39,32,FMN 03 Kolonel Silvertopstraat
651,Kolonel Silvertopstraat 5333,2022-09-24,00:00:00,61,38,23,FMN 03 Kolonel Silvertopstraat
651,Kolonel Silvertopstraat 5333,2022-09-24,01:00:00,50,19,31,FMN 03 Kolonel Silvertopstraat
651,Kolonel Silvertopstraat 5333,2022-09-24,02:00:00,38,13,25,FMN 03 Kolonel Silvertopstraat
651,Kolonel Silvertopstraat 5333,2022-09-24,03:00:00,25,5,20,FMN 03 Kolonel Silvertopstraat
651,Kolonel Silvertopstraat 5333,2022-09-24,04:00:00,19,10,9,FMN 03 Kolonel Silvertopstraat
651,Kolonel Silvertopstraat 5333,2022-09-24,05:00:00,23,14,9,FMN 03 Kolonel Silvertopstraat
651,Kolonel Silvertopstraat 5333,2022-09-24,06:00:00,31,23,8,FMN 03 Kolonel Silvertopstraat
651,Kolonel Silvertopstraat 5333,2022-09-24,07:00:00,35,27,8,FMN 03 Kolonel Silvertopstraat
651,Kolonel Silvertopstraat 5333,2022-09-24,08:00:00,73,56,17,FMN 03 Kolonel Silvertopstraat
651,Kolonel Silvertopstraat 5333,2022-09-24,09:00:00,116,97,19,FMN 03 Kolonel Silvertopstraat
651,Kolonel Silvertopstraat 5333,2022-09-24,10:00:00,126,101,25,FMN 03 Kolonel Silvertopstraat
651,Kolonel Silvertopstraat 5333,2022-09-24,11:00:00,111,73,38,FMN 03 Kolonel Silvertopstraat
651,Kolonel Silvertopstraat 5333,2022-09-24,12:00:00,132,101,31,FMN 03 Kolonel Silvertopstraat
651,Kolonel Silvertopstraat 5333,2022-09-24,13:00:00,146,100,46,FMN 03 Kolonel Silvertopstraat
651,Kolonel Silvertopstraat 5333,2022-09-24,14:00:00,183,132,51,FMN 03 Kolonel Silvertopstraat
651,Kolonel Silvertopstraat 5333,2022-09-24,15:00:00,185,145,40,FMN 03 Kolonel Silvertopstraat
651,Kolonel Silvertopstraat 5333,2022-09-24,16:00:00,153,110,43,FMN 03 Kolonel Silvertopstraat
651,Kolonel Silvertopstraat 5333,2022-09-24,17:00:00,170,123,47,FMN 03 Kolonel Silvertopstraat
651,Kolonel Silvertopstraat 5333,2022-09-24,18:00:00,173,110,63,FMN 03 Kolonel Silvertopstraat
651,Kolonel Silvertopstraat 5333,2022-09-24,19:00:00,172,132,40,FMN 03 Kolonel Silvertopstraat
651,Kolonel Silvertopstraat 5333,2022-09-24,20:00:00,138,91,47,FMN 03 Kolonel Silvertopstraat
651,Kolonel Silvertopstraat 5333,2022-09-24,21:00:00,105,78,27,FMN 03 Kolonel Silvertopstraat
651,Kolonel Silvertopstraat 5333,2022-09-24,22:00:00,117,71,46,FMN 03 Kolonel Silvertopstraat
651,Kolonel Silvertopstraat 5333,2022-09-24,23:00:00,71,36,35,FMN 03 Kolonel Silvertopstraat
651,Kolonel Silvertopstraat 5333,2022-09-25,00:00:00,64,19,45,FMN 03 Kolonel Silvertopstraat
651,Kolonel Silvertopstraat 5333,2022-09-25,01:00:00,35,16,19,FMN 03 Kolonel Silvertopstraat
651,Kolonel Silvertopstraat 5333,2022-09-25,02:00:00,24,4,20,FMN 03 Kolonel Silvertopstraat
651,Kolonel Silvertopstraat 5333,2022-09-25,03:00:00,19,4,15,FMN 03 Kolonel Silvertopstraat
651,Kolonel Silvertopstraat 5333,2022-09-25,04:00:00,11,6,5,FMN 03 Kolonel Silvertopstraat
651,Kolonel Silvertopstraat 5333,2022-09-25,05:00:00,20,10,10,FMN 03 Kolonel Silvertopstraat
651,Kolonel Silvertopstraat 5333,2022-09-25,06:00:00,32,22,10,FMN 03 Kolonel Silvertopstraat
651,Kolonel Silvertopstraat 5333,2022-09-25,07:00:00,19,14,5,FMN 03 Kolonel Silvertopstraat
651,Kolonel Silvertopstraat 5333,2022-09-25,08:00:00,56,45,11,FMN 03 Kolonel Silvertopstraat
651,Kolonel Silvertopstraat 5333,2022-09-25,09:00:00,105,87,18,FMN 03 Kolonel Silvertopstraat
651,Kolonel Silvertopstraat 5333,2022-09-25,10:00:00,161,137,24,FMN 03 Kolonel Silvertopstraat
651,Kolonel Silvertopstraat 5333,2022-09-25,11:00:00,196,157,39,FMN 03 Kolonel Silvertopstraat
651,Kolonel Silvertopstraat 5333,2022-09-25,12:00:00,204,163,41,FMN 03 Kolonel Silvertopstraat
651,Kolonel Silvertopstraat 5333,2022-09-25,13:00:00,236,167,69,FMN 03 Kolonel Silvertopstraat
651,Kolonel Silvertopstraat 5333,2022-09-25,14:00:00,255,193,62,FMN 03 Kolonel Silvertopstraat
651,Kolonel Silvertopstraat 5333,2022-09-25,15:00:00,239,166,73,FMN 03 Kolonel Silvertopstraat
651,Kolonel Silvertopstraat 5333,2022-09-25,16:00:00,226,157,69,FMN 03 Kolonel Silvertopstraat
651,Kolonel Silvertopstraat 5333,2022-09-25,17:00:00,230,153,77,FMN 03 Kolonel Silvertopstraat
651,Kolonel Silvertopstraat 5333,2022-09-25,18:00:00,254,152,102,FMN 03 Kolonel Silvertopstraat
651,Kolonel Silvertopstraat 5333,2022-09-25,19:00:00,182,124,58,FMN 03 Kolonel Silvertopstraat
651,Kolonel Silvertopstraat 5333,2022-09-25,20:00:00,168,101,67,FMN 03 Kolonel Silvertopstraat
651,Kolonel Silvertopstraat 5333,2022-09-25,21:00:00,111,60,51,FMN 03 Kolonel Silvertopstraat
651,Kolonel Silvertopstraat 5333,2022-09-25,22:00:00,82,47,35,FMN 03 Kolonel Silvertopstraat
651,Kolonel Silvertopstraat 5333,2022-09-25,23:00:00,45,20,25,FMN 03 Kolonel Silvertopstraat
651,Kolonel Silvertopstraat 5333,2022-09-26,00:00:00,21,10,11,FMN 03 Kolonel Silvertopstraat
651,Kolonel Silvertopstraat 5333,2022-09-26,01:00:00,9,4,5,FMN 03 Kolonel Silvertopstraat
651,Kolonel Silvertopstraat 5333,2022-09-26,02:00:00,2,1,1,FMN 03 Kolonel Silvertopstraat
651,Kolonel Silvertopstraat 5333,2022-09-26,03:00:00,5,2,3,FMN 03 Kolonel Silvertopstraat
651,Kolonel Silvertopstraat 5333,2022-09-26,04:00:00,25,17,8,FMN 03 Kolonel Silvertopstraat
651,Kolonel Silvertopstraat 5333,2022-09-26,05:00:00,46,32,14,FMN 03 Kolonel Silvertopstraat
651,Kolonel Silvertopstraat 5333,2022-09-26,06:00:00,125,103,22,FMN 03 Kolonel Silvertopstraat
651,Kolonel Silvertopstraat 5333,2022-09-26,07:00:00,337,283,54,FMN 03 Kolonel Silvertopstraat
651,Kolonel Silvertopstraat 5333,2022-09-26,08:00:00,677,575,102,FMN 03 Kolonel Silvertopstraat
651,Kolonel Silvertopstraat 5333,2022-09-26,09:00:00,201,160,41,FMN 03 Kolonel Silvertopstraat
651,Kolonel Silvertopstraat 5333,2022-09-26,10:00:00,170,128,42,FMN 03 Kolonel Silvertopstraat
651,Kolonel Silvertopstraat 5333,2022-09-26,11:00:00,101,73,28,FMN 03 Kolonel Silvertopstraat
651,Kolonel Silvertopstraat 5333,2022-09-26,12:00:00,141,103,38,FMN 03 Kolonel Silvertopstraat
651,Kolonel Silvertopstraat 5333,2022-09-26,13:00:00,160,108,52,FMN 03 Kolonel Silvertopstraat
651,Kolonel Silvertopstraat 5333,2022-09-26,14:00:00,198,132,66,FMN 03 Kolonel Silvertopstraat
651,Kolonel Silvertopstraat 5333,2022-09-26,15:00:00,233,137,96,FMN 03 Kolonel Silvertopstraat
651,Kolonel Silvertopstraat 5333,2022-09-26,16:00:00,336,208,128,FMN 03 Kolonel Silvertopstraat
651,Kolonel Silvertopstraat 5333,2022-09-26,17:00:00,255,159,96,FMN 03 Kolonel Silvertopstraat
651,Kolonel Silvertopstraat 5333,2022-09-26,18:00:00,231,147,84,FMN 03 Kolonel Silvertopstraat
651,Kolonel Silvertopstraat 5333,2022-09-26,19:00:00,135,83,52,FMN 03 Kolonel Silvertopstraat
651,Kolonel Silvertopstraat 5333,2022-09-26,20:00:00,113,65,48,FMN 03 Kolonel Silvertopstraat
651,Kolonel Silvertopstraat 5333,2022-09-26,21:00:00,82,48,34,FMN 03 Kolonel Silvertopstraat
651,Kolonel Silvertopstraat 5333,2022-09-26,22:00:00,64,37,27,FMN 03 Kolonel Silvertopstraat
651,Kolonel Silvertopstraat 5333,2022-09-26,23:00:00,31,13,18,FMN 03 Kolonel Silvertopstraat
651,Kolonel Silvertopstraat 5333,2022-09-27,00:00:00,10,5,5,FMN 03 Kolonel Silvertopstraat
651,Kolonel Silvertopstraat 5333,2022-09-27,01:00:00,12,4,8,FMN 03 Kolonel Silvertopstraat
651,Kolonel Silvertopstraat 5333,2022-09-27,02:00:00,8,2,6,FMN 03 Kolonel Silvertopstraat
651,Kolonel Silvertopstraat 5333,2022-09-27,03:00:00,11,7,4,FMN 03 Kolonel Silvertopstraat
651,Kolonel Silvertopstraat 5333,2022-09-27,04:00:00,18,16,2,FMN 03 Kolonel Silvertopstraat
651,Kolonel Silvertopstraat 5333,2022-09-27,05:00:00,49,35,14,FMN 03 Kolonel Silvertopstraat
651,Kolonel Silvertopstraat 5333,2022-09-27,06:00:00,94,70,24,FMN 03 Kolonel Silvertopstraat
651,Kolonel Silvertopstraat 5333,2022-09-27,07:00:00,296,230,66,FMN 03 Kolonel Silvertopstraat
651,Kolonel Silvertopstraat 5333,2022-09-27,08:00:00,537,465,72,FMN 03 Kolonel Silvertopstraat
651,Kolonel Silvertopstraat 5333,2022-09-27,09:00:00,196,138,58,FMN 03 Kolonel Silvertopstraat
651,Kolonel Silvertopstraat 5333,2022-09-27,10:00:00,118,86,32,FMN 03 Kolonel Silvertopstraat
651,Kolonel Silvertopstraat 5333,2022-09-27,11:00:00,89,73,16,FMN 03 Kolonel Silvertopstraat
651,Kolonel Silvertopstraat 5333,2022-09-27,12:00:00,203,156,47,FMN 03 Kolonel Silvertopstraat
651,Kolonel Silvertopstraat 5333,2022-09-27,13:00:00,183,122,61,FMN 03 Kolonel Silvertopstraat
651,Kolonel Silvertopstraat 5333,2022-09-27,14:00:00,178,119,59,FMN 03 Kolonel Silvertopstraat
651,Kolonel Silvertopstraat 5333,2022-09-27,15:00:00,269,185,84,FMN 03 Kolonel Silvertopstraat
651,Kolonel Silvertopstraat 5333,2022-09-27,16:00:00,335,220,115,FMN 03 Kolonel Silvertopstraat
651,Kolonel Silvertopstraat 5333,2022-09-27,17:00:00,318,201,117,FMN 03 Kolonel Silvertopstraat
651,Kolonel Silvertopstraat 5333,2022-09-27,18:00:00,275,174,101,FMN 03 Kolonel Silvertopstraat
651,Kolonel Silvertopstraat 5333,2022-09-27,19:00:00,182,124,58,FMN 03 Kolonel Silvertopstraat
651,Kolonel Silvertopstraat 5333,2022-09-27,20:00:00,102,54,48,FMN 03 Kolonel Silvertopstraat
651,Kolonel Silvertopstraat 5333,2022-09-27,21:00:00,83,51,32,FMN 03 Kolonel Silvertopstraat
651,Kolonel Silvertopstraat 5333,2022-09-27,22:00:00,76,44,32,FMN 03 Kolonel Silvertopstraat
651,Kolonel Silvertopstraat 5333,2022-09-27,23:00:00,48,23,25,FMN 03 Kolonel Silvertopstraat
651,Kolonel Silvertopstraat 5333,2022-09-28,00:00:00,17,7,10,FMN 03 Kolonel Silvertopstraat
651,Kolonel Silvertopstraat 5333,2022-09-28,01:00:00,14,8,6,FMN 03 Kolonel Silvertopstraat
651,Kolonel Silvertopstraat 5333,2022-09-28,02:00:00,11,4,7,FMN 03 Kolonel Silvertopstraat
651,Kolonel Silvertopstraat 5333,2022-09-28,03:00:00,11,6,5,FMN 03 Kolonel Silvertopstraat
651,Kolonel Silvertopstraat 5333,2022-09-28,04:00:00,21,18,3,FMN 03 Kolonel Silvertopstraat
651,Kolonel Silvertopstraat 5333,2022-09-28,05:00:00,48,29,19,FMN 03 Kolonel Silvertopstraat
651,Kolonel Silvertopstraat 5333,2022-09-28,06:00:00,105,85,20,FMN 03 Kolonel Silvertopstraat
651,Kolonel Silvertopstraat 5333,2022-09-28,07:00:00,303,252,51,FMN 03 Kolonel Silvertopstraat
651,Kolonel Silvertopstraat 5333,2022-09-28,08:00:00,576,480,96,FMN 03 Kolonel Silvertopstraat
651,Kolonel Silvertopstraat 5333,2022-09-28,09:00:00,237,185,52,FMN 03 Kolonel Silvertopstraat
651,Kolonel Silvertopstraat 5333,2022-09-28,10:00:00,189,143,46,FMN 03 Kolonel Silvertopstraat
651,Kolonel Silvertopstraat 5333,2022-09-28,11:00:00,165,121,44,FMN 03 Kolonel Silvertopstraat
651,Kolonel Silvertopstraat 5333,2022-09-28,12:00:00,383,255,128,FMN 03 Kolonel Silvertopstraat
651,Kolonel Silvertopstraat 5333,2022-09-28,13:00:00,267,179,88,FMN 03 Kolonel Silvertopstraat
651,Kolonel Silvertopstraat 5333,2022-09-28,14:00:00,203,118,85,FMN 03 Kolonel Silvertopstraat
651,Kolonel Silvertopstraat 5333,2022-09-28,15:00:00,223,156,67,FMN 03 Kolonel Silvertopstraat
651,Kolonel Silvertopstraat 5333,2022-09-28,16:00:00,308,201,107,FMN 03 Kolonel Silvertopstraat
651,Kolonel Silvertopstraat 5333,2022-09-28,17:00:00,349,223,126,FMN 03 Kolonel Silvertopstraat
651,Kolonel Silvertopstraat 5333,2022-09-28,18:00:00,289,187,102,FMN 03 Kolonel Silvertopstraat
651,Kolonel Silvertopstraat 5333,2022-09-28,19:00:00,228,150,78,FMN 03 Kolonel Silvertopstraat
651,Kolonel Silvertopstraat 5333,2022-09-28,20:00:00,162,97,65,FMN 03 Kolonel Silvertopstraat
651,Kolonel Silvertopstraat 5333,2022-09-28,21:00:00,105,52,53,FMN 03 Kolonel Silvertopstraat
651,Kolonel Silvertopstraat 5333,2022-09-28,22:00:00,118,63,55,FMN 03 Kolonel Silvertopstraat
651,Kolonel Silvertopstraat 5333,2022-09-28,23:00:00,59,30,29,FMN 03 Kolonel Silvertopstraat
651,Kolonel Silvertopstraat 5333,2022-09-29,00:00:00,33,16,17,FMN 03 Kolonel Silvertopstraat
651,Kolonel Silvertopstraat 5333,2022-09-29,01:00:00,15,4,11,FMN 03 Kolonel Silvertopstraat
651,Kolonel Silvertopstraat 5333,2022-09-29,02:00:00,7,5,2,FMN 03 Kolonel Silvertopstraat
651,Kolonel Silvertopstraat 5333,2022-09-29,03:00:00,12,4,8,FMN 03 Kolonel Silvertopstraat
651,Kolonel Silvertopstraat 5333,2022-09-29,04:00:00,28,23,5,FMN 03 Kolonel Silvertopstraat
651,Kolonel Silvertopstraat 5333,2022-09-29,05:00:00,58,33,25,FMN 03 Kolonel Silvertopstraat
651,Kolonel Silvertopstraat 5333,2022-09-29,06:00:00,132,106,26,FMN 03 Kolonel Silvertopstraat
651,Kolonel Silvertopstraat 5333,2022-09-29,07:00:00,354,294,60,FMN 03 Kolonel Silvertopstraat
651,Kolonel Silvertopstraat 5333,2022-09-29,08:00:00,753,662,91,FMN 03 Kolonel Silvertopstraat
651,Kolonel Silvertopstraat 5333,2022-09-29,09:00:00,250,202,48,FMN 03 Kolonel Silvertopstraat
651,Kolonel Silvertopstraat 5333,2022-09-29,10:00:00,176,139,37,FMN 03 Kolonel Silvertopstraat
651,Kolonel Silvertopstraat 5333,2022-09-29,11:00:00,167,125,42,FMN 03 Kolonel Silvertopstraat
651,Kolonel Silvertopstraat 5333,2022-09-29,12:00:00,277,189,88,FMN 03 Kolonel Silvertopstraat
651,Kolonel Silvertopstraat 5333,2022-09-29,13:00:00,226,150,76,FMN 03 Kolonel Silvertopstraat
651,Kolonel Silvertopstraat 5333,2022-09-29,14:00:00,230,155,75,FMN 03 Kolonel Silvertopstraat
651,Kolonel Silvertopstraat 5333,2022-09-29,15:00:00,337,211,126,FMN 03 Kolonel Silvertopstraat
651,Kolonel Silvertopstraat 5333,2022-09-29,16:00:00,465,301,164,FMN 03 Kolonel Silvertopstraat
651,Kolonel Silvertopstraat 5333,2022-09-29,17:00:00,400,261,139,FMN 03 Kolonel Silvertopstraat
651,Kolonel Silvertopstraat 5333,2022-09-29,18:00:00,293,172,121,FMN 03 Kolonel Silvertopstraat
651,Kolonel Silvertopstraat 5333,2022-09-29,19:00:00,215,149,66,FMN 03 Kolonel Silvertopstraat
651,Kolonel Silvertopstraat 5333,2022-09-29,20:00:00,132,83,49,FMN 03 Kolonel Silvertopstraat
651,Kolonel Silvertopstraat 5333,2022-09-29,21:00:00,131,68,63,FMN 03 Kolonel Silvertopstraat
651,Kolonel Silvertopstraat 5333,2022-09-29,22:00:00,127,56,71,FMN 03 Kolonel Silvertopstraat
651,Kolonel Silvertopstraat 5333,2022-09-29,23:00:00,67,33,34,FMN 03 Kolonel Silvertopstraat
651,Kolonel Silvertopstraat 5333,2022-09-30,00:00:00,52,28,24,FMN 03 Kolonel Silvertopstraat
651,Kolonel Silvertopstraat 5333,2022-09-30,01:00:00,24,6,18,FMN 03 Kolonel Silvertopstraat
651,Kolonel Silvertopstraat 5333,2022-09-30,02:00:00,10,3,7,FMN 03 Kolonel Silvertopstraat
651,Kolonel Silvertopstraat 5333,2022-09-30,03:00:00,10,6,4,FMN 03 Kolonel Silvertopstraat
651,Kolonel Silvertopstraat 5333,2022-09-30,04:00:00,32,21,11,FMN 03 Kolonel Silvertopstraat
651,Kolonel Silvertopstraat 5333,2022-09-30,05:00:00,66,48,18,FMN 03 Kolonel Silvertopstraat
651,Kolonel Silvertopstraat 5333,2022-09-30,06:00:00,113,82,31,FMN 03 Kolonel Silvertopstraat
651,Kolonel Silvertopstraat 5333,2022-09-30,07:00:00,320,254,66,FMN 03 Kolonel Silvertopstraat
651,Kolonel Silvertopstraat 5333,2022-09-30,08:00:00,680,582,98,FMN 03 Kolonel Silvertopstraat
651,Kolonel Silvertopstraat 5333,2022-09-30,09:00:00,270,216,54,FMN 03 Kolonel Silvertopstraat
651,Kolonel Silvertopstraat 5333,2022-09-30,10:00:00,220,180,40,FMN 03 Kolonel Silvertopstraat
651,Kolonel Silvertopstraat 5333,2022-09-30,11:00:00,169,124,45,FMN 03 Kolonel Silvertopstraat
651,Kolonel Silvertopstraat 5333,2022-09-30,12:00:00,257,183,74,FMN 03 Kolonel Silvertopstraat
651,Kolonel Silvertopstraat 5333,2022-09-30,13:00:00,281,196,85,FMN 03 Kolonel Silvertopstraat
651,Kolonel Silvertopstraat 5333,2022-09-30,14:00:00,298,207,91,FMN 03 Kolonel Silvertopstraat
651,Kolonel Silvertopstraat 5333,2022-09-30,15:00:00,375,239,136,FMN 03 Kolonel Silvertopstraat
651,Kolonel Silvertopstraat 5333,2022-09-30,16:00:00,434,292,142,FMN 03 Kolonel Silvertopstraat
651,Kolonel Silvertopstraat 5333,2022-09-30,17:00:00,395,255,140,FMN 03 Kolonel Silvertopstraat
651,Kolonel Silvertopstraat 5333,2022-09-30,18:00:00,343,229,114,FMN 03 Kolonel Silvertopstraat
651,Kolonel Silvertopstraat 5333,2022-09-30,19:00:00,247,165,82,FMN 03 Kolonel Silvertopstraat
651,Kolonel Silvertopstraat 5333,2022-09-30,20:00:00,182,120,62,FMN 03 Kolonel Silvertopstraat
651,Kolonel Silvertopstraat 5333,2022-09-30,21:00:00,161,88,73,FMN 03 Kolonel Silvertopstraat
651,Kolonel Silvertopstraat 5333,2022-09-30,22:00:00,117,51,66,FMN 03 Kolonel Silvertopstraat
651,Kolonel Silvertopstraat 5333,2022-09-30,23:00:00,91,34,57,FMN 03 Kolonel Silvertopstraat
651,Kolonel Silvertopstraat 5333,2022-10-01,00:00:00,56,22,34,FMN 03 Kolonel Silvertopstraat
651,Kolonel Silvertopstraat 5333,2022-10-01,01:00:00,28,8,20,FMN 03 Kolonel Silvertopstraat
651,Kolonel Silvertopstraat 5333,2022-10-01,02:00:00,17,5,12,FMN 03 Kolonel Silvertopstraat
651,Kolonel Silvertopstraat 5333,2022-10-01,03:00:00,28,12,16,FMN 03 Kolonel Silvertopstraat
651,Kolonel Silvertopstraat 5333,2022-10-01,04:00:00,36,26,10,FMN 03 Kolonel Silvertopstraat
651,Kolonel Silvertopstraat 5333,2022-10-01,05:00:00,29,22,7,FMN 03 Kolonel Silvertopstraat
651,Kolonel Silvertopstraat 5333,2022-10-01,06:00:00,44,29,15,FMN 03 Kolonel Silvertopstraat
651,Kolonel Silvertopstraat 5333,2022-10-01,07:00:00,43,33,10,FMN 03 Kolonel Silvertopstraat
651,Kolonel Silvertopstraat 5333,2022-10-01,08:00:00,69,55,14,FMN 03 Kolonel Silvertopstraat
651,Kolonel Silvertopstraat 5333,2022-10-01,09:00:00,135,109,26,FMN 03 Kolonel Silvertopstraat
651,Kolonel Silvertopstraat 5333,2022-10-01,10:00:00,162,126,36,FMN 03 Kolonel Silvertopstraat
651,Kolonel Silvertopstraat 5333,2022-10-01,11:00:00,158,113,45,FMN 03 Kolonel Silvertopstraat
651,Kolonel Silvertopstraat 5333,2022-10-01,12:00:00,163,113,50,FMN 03 Kolonel Silvertopstraat
651,Kolonel Silvertopstraat 5333,2022-10-01,13:00:00,198,151,47,FMN 03 Kolonel Silvertopstraat
651,Kolonel Silvertopstraat 5333,2022-10-01,14:00:00,236,176,60,FMN 03 Kolonel Silvertopstraat
651,Kolonel Silvertopstraat 5333,2022-10-01,15:00:00,235,162,73,FMN 03 Kolonel Silvertopstraat
651,Kolonel Silvertopstraat 5333,2022-10-01,16:00:00,224,156,68,FMN 03 Kolonel Silvertopstraat
651,Kolonel Silvertopstraat 5333,2022-10-01,17:00:00,215,129,86,FMN 03 Kolonel Silvertopstraat
651,Kolonel Silvertopstraat 5333,2022-10-01,18:00:00,272,177,95,FMN 03 Kolonel Silvertopstraat
651,Kolonel Silvertopstraat 5333,2022-10-01,19:00:00,268,153,115,FMN 03 Kolonel Silvertopstraat
651,Kolonel Silvertopstraat 5333,2022-10-01,20:00:00,174,108,66,FMN 03 Kolonel Silvertopstraat
651,Kolonel Silvertopstraat 5333,2022-10-01,21:00:00,127,78,49,FMN 03 Kolonel Silvertopstraat
651,Kolonel Silvertopstraat 5333,2022-10-01,22:00:00,156,109,47,FMN 03 Kolonel Silvertopstraat
651,Kolonel Silvertopstraat 5333,2022-10-01,23:00:00,111,78,33,FMN 03 Kolonel Silvertopstraat
651,Kolonel Silvertopstraat 5333,2022-10-02,00:00:00,69,32,37,FMN 03 Kolonel Silvertopstraat
651,Kolonel Silvertopstraat 5333,2022-10-02,01:00:00,55,29,26,FMN 03 Kolonel Silvertopstraat
651,Kolonel Silvertopstraat 5333,2022-10-02,02:00:00,51,21,30,FMN 03 Kolonel Silvertopstraat
651,Kolonel Silvertopstraat 5333,2022-10-02,03:00:00,34,9,25,FMN 03 Kolonel Silvertopstraat
651,Kolonel Silvertopstraat 5333,2022-10-02,04:00:00,22,6,16,FMN 03 Kolonel Silvertopstraat
651,Kolonel Silvertopstraat 5333,2022-10-02,05:00:00,31,18,13,FMN 03 Kolonel Silvertopstraat
651,Kolonel Silvertopstraat 5333,2022-10-02,06:00:00,25,17,8,FMN 03 Kolonel Silvertopstraat
651,Kolonel Silvertopstraat 5333,2022-10-02,07:00:00,21,17,4,FMN 03 Kolonel Silvertopstraat
651,Kolonel Silvertopstraat 5333,2022-10-02,08:00:00,50,39,11,FMN 03 Kolonel Silvertopstraat
651,Kolonel Silvertopstraat 5333,2022-10-02,09:00:00,100,79,21,FMN 03 Kolonel Silvertopstraat
651,Kolonel Silvertopstraat 5333,2022-10-02,10:00:00,139,100,39,FMN 03 Kolonel Silvertopstraat
651,Kolonel Silvertopstraat 5333,2022-10-02,11:00:00,169,143,26,FMN 03 Kolonel Silvertopstraat
651,Kolonel Silvertopstraat 5333,2022-10-02,12:00:00,193,130,63,FMN 03 Kolonel Silvertopstraat
651,Kolonel Silvertopstraat 5333,2022-10-02,13:00:00,204,131,73,FMN 03 Kolonel Silvertopstraat
651,Kolonel Silvertopstraat 5333,2022-10-02,14:00:00,246,184,62,FMN 03 Kolonel Silvertopstraat
651,Kolonel Silvertopstraat 5333,2022-10-02,15:00:00,153,105,48,FMN 03 Kolonel Silvertopstraat
651,Kolonel Silvertopstraat 5333,2022-10-02,16:00:00,215,139,76,FMN 03 Kolonel Silvertopstraat
651,Kolonel Silvertopstraat 5333,2022-10-02,17:00:00,198,134,64,FMN 03 Kolonel Silvertopstraat
651,Kolonel Silvertopstraat 5333,2022-10-02,18:00:00,176,97,79,FMN 03 Kolonel Silvertopstraat
651,Kolonel Silvertopstraat 5333,2022-10-02,19:00:00,194,121,73,FMN 03 Kolonel Silvertopstraat
651,Kolonel Silvertopstraat 5333,2022-10-02,20:00:00,135,68,67,FMN 03 Kolonel Silvertopstraat
651,Kolonel Silvertopstraat 5333,2022-10-02,21:00:00,127,70,57,FMN 03 Kolonel Silvertopstraat
651,Kolonel Silvertopstraat 5333,2022-10-02,22:00:00,79,31,48,FMN 03 Kolonel Silvertopstraat
651,Kolonel Silvertopstraat 5333,2022-10-02,23:00:00,37,22,15,FMN 03 Kolonel Silvertopstraat
651,Kolonel Silvertopstraat 5333,2022-10-03,00:00:00,22,11,11,FMN 03 Kolonel Silvertopstraat
651,Kolonel Silvertopstraat 5333,2022-10-03,01:00:00,14,4,10,FMN 03 Kolonel Silvertopstraat
651,Kolonel Silvertopstraat 5333,2022-10-03,02:00:00,13,5,8,FMN 03 Kolonel Silvertopstraat
651,Kolonel Silvertopstraat 5333,2022-10-03,03:00:00,12,8,4,FMN 03 Kolonel Silvertopstraat
651,Kolonel Silvertopstraat 5333,2022-10-03,04:00:00,23,16,7,FMN 03 Kolonel Silvertopstraat
651,Kolonel Silvertopstraat 5333,2022-10-03,05:00:00,48,34,14,FMN 03 Kolonel Silvertopstraat
651,Kolonel Silvertopstraat 5333,2022-10-03,06:00:00,133,104,29,FMN 03 Kolonel Silvertopstraat
651,Kolonel Silvertopstraat 5333,2022-10-03,07:00:00,311,270,41,FMN 03 Kolonel Silvertopstraat
651,Kolonel Silvertopstraat 5333,2022-10-03,08:00:00,697,605,92,FMN 03 Kolonel Silvertopstraat
651,Kolonel Silvertopstraat 5333,2022-10-03,09:00:00,239,187,52,FMN 03 Kolonel Silvertopstraat
651,Kolonel Silvertopstraat 5333,2022-10-03,10:00:00,204,155,49,FMN 03 Kolonel Silvertopstraat
651,Kolonel Silvertopstraat 5333,2022-10-03,11:00:00,154,115,39,FMN 03 Kolonel Silvertopstraat
651,Kolonel Silvertopstraat 5333,2022-10-03,12:00:00,244,162,82,FMN 03 Kolonel Silvertopstraat
651,Kolonel Silvertopstraat 5333,2022-10-03,13:00:00,222,160,62,FMN 03 Kolonel Silvertopstraat
651,Kolonel Silvertopstraat 5333,2022-10-03,14:00:00,236,172,64,FMN 03 Kolonel Silvertopstraat
651,Kolonel Silvertopstraat 5333,2022-10-03,15:00:00,313,193,120,FMN 03 Kolonel Silvertopstraat
651,Kolonel Silvertopstraat 5333,2022-10-03,16:00:00,388,246,142,FMN 03 Kolonel Silvertopstraat
651,Kolonel Silvertopstraat 5333,2022-10-03,17:00:00,392,249,143,FMN 03 Kolonel Silvertopstraat
651,Kolonel Silvertopstraat 5333,2022-10-03,18:00:00,291,172,119,FMN 03 Kolonel Silvertopstraat
651,Kolonel Silvertopstraat 5333,2022-10-03,19:00:00,201,116,85,FMN 03 Kolonel Silvertopstraat
651,Kolonel Silvertopstraat 5333,2022-10-03,20:00:00,156,83,73,FMN 03 Kolonel Silvertopstraat
651,Kolonel Silvertopstraat 5333,2022-10-03,21:00:00,97,54,43,FMN 03 Kolonel Silvertopstraat
651,Kolonel Silvertopstraat 5333,2022-10-03,22:00:00,111,53,58,FMN 03 Kolonel Silvertopstraat
651,Kolonel Silvertopstraat 5333,2022-10-03,23:00:00,51,25,26,FMN 03 Kolonel Silvertopstraat
651,Kolonel Silvertopstraat 5333,2022-10-04,00:00:00,25,11,14,FMN 03 Kolonel Silvertopstraat
651,Kolonel Silvertopstraat 5333,2022-10-04,01:00:00,8,3,5,FMN 03 Kolonel Silvertopstraat
651,Kolonel Silvertopstraat 5333,2022-10-04,02:00:00,8,5,3,FMN 03 Kolonel Silvertopstraat
651,Kolonel Silvertopstraat 5333,2022-10-04,03:00:00,9,6,3,FMN 03 Kolonel Silvertopstraat
651,Kolonel Silvertopstraat 5333,2022-10-04,04:00:00,24,19,5,FMN 03 Kolonel Silvertopstraat
651,Kolonel Silvertopstraat 5333,2022-10-04,05:00:00,52,34,18,FMN 03 Kolonel Silvertopstraat
651,Kolonel Silvertopstraat 5333,2022-10-04,06:00:00,141,102,39,FMN 03 Kolonel Silvertopstraat
651,Kolonel Silvertopstraat 5333,2022-10-04,07:00:00,406,335,71,FMN 03 Kolonel Silvertopstraat
651,Kolonel Silvertopstraat 5333,2022-10-04,08:00:00,808,693,115,FMN 03 Kolonel Silvertopstraat
651,Kolonel Silvertopstraat 5333,2022-10-04,09:00:00,276,227,49,FMN 03 Kolonel Silvertopstraat
651,Kolonel Silvertopstraat 5333,2022-10-04,10:00:00,192,147,45,FMN 03 Kolonel Silvertopstraat
651,Kolonel Silvertopstraat 5333,2022-10-04,11:00:00,152,110,42,FMN 03 Kolonel Silvertopstraat
651,Kolonel Silvertopstraat 5333,2022-10-04,12:00:00,277,198,79,FMN 03 Kolonel Silvertopstraat
651,Kolonel Silvertopstraat 5333,2022-10-04,13:00:00,277,206,71,FMN 03 Kolonel Silvertopstraat
651,Kolonel Silvertopstraat 5333,2022-10-04,14:00:00,256,164,92,FMN 03 Kolonel Silvertopstraat
651,Kolonel Silvertopstraat 5333,2022-10-04,15:00:00,350,232,118,FMN 03 Kolonel Silvertopstraat
651,Kolonel Silvertopstraat 5333,2022-10-04,16:00:00,489,328,161,FMN 03 Kolonel Silvertopstraat
651,Kolonel Silvertopstraat 5333,2022-10-04,17:00:00,471,306,165,FMN 03 Kolonel Silvertopstraat
651,Kolonel Silvertopstraat 5333,2022-10-04,18:00:00,361,219,142,FMN 03 Kolonel Silvertopstraat
651,Kolonel Silvertopstraat 5333,2022-10-04,19:00:00,263,168,95,FMN 03 Kolonel Silvertopstraat
651,Kolonel Silvertopstraat 5333,2022-10-04,20:00:00,165,98,67,FMN 03 Kolonel Silvertopstraat
651,Kolonel Silvertopstraat 5333,2022-10-04,21:00:00,150,78,72,FMN 03 Kolonel Silvertopstraat
651,Kolonel Silvertopstraat 5333,2022-10-04,22:00:00,118,69,49,FMN 03 Kolonel Silvertopstraat
651,Kolonel Silvertopstraat 5333,2022-10-04,23:00:00,88,44,44,FMN 03 Kolonel Silvertopstraat
651,Kolonel Silvertopstraat 5333,2022-10-05,00:00:00,29,16,13,FMN 03 Kolonel Silvertopstraat
651,Kolonel Silvertopstraat 5333,2022-10-05,01:00:00,20,9,11,FMN 03 Kolonel Silvertopstraat
651,Kolonel Silvertopstraat 5333,2022-10-05,02:00:00,7,3,4,FMN 03 Kolonel Silvertopstraat
651,Kolonel Silvertopstraat 5333,2022-10-05,03:00:00,13,9,4,FMN 03 Kolonel Silvertopstraat
651,Kolonel Silvertopstraat 5333,2022-10-05,04:00:00,27,15,12,FMN 03 Kolonel Silvertopstraat
651,Kolonel Silvertopstraat 5333,2022-10-05,05:00:00,56,38,18,FMN 03 Kolonel Silvertopstraat
651,Kolonel Silvertopstraat 5333,2022-10-05,06:00:00,132,96,36,FMN 03 Kolonel Silvertopstraat
651,Kolonel Silvertopstraat 5333,2022-10-05,07:00:00,361,311,50,FMN 03 Kolonel Silvertopstraat
651,Kolonel Silvertopstraat 5333,2022-10-05,08:00:00,646,561,85,FMN 03 Kolonel Silvertopstraat
651,Kolonel Silvertopstraat 5333,2022-10-05,09:00:00,274,218,56,FMN 03 Kolonel Silvertopstraat
651,Kolonel Silvertopstraat 5333,2022-10-05,10:00:00,173,119,54,FMN 03 Kolonel Silvertopstraat
651,Kolonel Silvertopstraat 5333,2022-10-05,11:00:00,195,149,46,FMN 03 Kolonel Silvertopstraat
651,Kolonel Silvertopstraat 5333,2022-10-05,12:00:00,338,220,118,FMN 03 Kolonel Silvertopstraat
651,Kolonel Silvertopstraat 5333,2022-10-05,13:00:00,285,196,89,FMN 03 Kolonel Silvertopstraat
651,Kolonel Silvertopstraat 5333,2022-10-05,14:00:00,235,163,72,FMN 03 Kolonel Silvertopstraat
651,Kolonel Silvertopstraat 5333,2022-10-05,15:00:00,312,212,100,FMN 03 Kolonel Silvertopstraat
651,Kolonel Silvertopstraat 5333,2022-10-05,16:00:00,325,220,105,FMN 03 Kolonel Silvertopstraat
651,Kolonel Silvertopstraat 5333,2022-10-05,17:00:00,384,258,126,FMN 03 Kolonel Silvertopstraat
651,Kolonel Silvertopstraat 5333,2022-10-05,18:00:00,301,182,119,FMN 03 Kolonel Silvertopstraat
651,Kolonel Silvertopstraat 5333,2022-10-05,19:00:00,218,147,71,FMN 03 Kolonel Silvertopstraat
651,Kolonel Silvertopstraat 5333,2022-10-05,20:00:00,143,84,59,FMN 03 Kolonel Silvertopstraat
651,Kolonel Silvertopstraat 5333,2022-10-05,21:00:00,123,68,55,FMN 03 Kolonel Silvertopstraat
651,Kolonel Silvertopstraat 5333,2022-10-05,22:00:00,143,95,48,FMN 03 Kolonel Silvertopstraat
651,Kolonel Silvertopstraat 5333,2022-10-05,23:00:00,77,38,39,FMN 03 Kolonel Silvertopstraat
651,Kolonel Silvertopstraat 5333,2022-10-06,00:00:00,37,21,16,FMN 03 Kolonel Silvertopstraat
651,Kolonel Silvertopstraat 5333,2022-10-06,01:00:00,17,9,8,FMN 03 Kolonel Silvertopstraat
651,Kolonel Silvertopstraat 5333,2022-10-06,02:00:00,11,5,6,FMN 03 Kolonel Silvertopstraat
651,Kolonel Silvertopstraat 5333,2022-10-06,03:00:00,20,11,9,FMN 03 Kolonel Silvertopstraat
651,Kolonel Silvertopstraat 5333,2022-10-06,04:00:00,24,15,9,FMN 03 Kolonel Silvertopstraat
651,Kolonel Silvertopstraat 5333,2022-10-06,05:00:00,56,38,18,FMN 03 Kolonel Silvertopstraat
651,Kolonel Silvertopstraat 5333,2022-10-06,06:00:00,145,120,25,FMN 03 Kolonel Silvertopstraat
651,Kolonel Silvertopstraat 5333,2022-10-06,07:00:00,406,340,66,FMN 03 Kolonel Silvertopstraat
651,Kolonel Silvertopstraat 5333,2022-10-06,08:00:00,852,730,122,FMN 03 Kolonel Silvertopstraat
651,Kolonel Silvertopstraat 5333,2022-10-06,09:00:00,251,199,52,FMN 03 Kolonel Silvertopstraat
651,Kolonel Silvertopstraat 5333,2022-10-06,10:00:00,226,185,41,FMN 03 Kolonel Silvertopstraat
651,Kolonel Silvertopstraat 5333,2022-10-06,11:00:00,196,146,50,FMN 03 Kolonel Silvertopstraat
651,Kolonel Silvertopstraat 5333,2022-10-06,12:00:00,253,181,72,FMN 03 Kolonel Silvertopstraat
651,Kolonel Silvertopstraat 5333,2022-10-06,13:00:00,277,193,84,FMN 03 Kolonel Silvertopstraat
651,Kolonel Silvertopstraat 5333,2022-10-06,14:00:00,238,162,76,FMN 03 Kolonel Silvertopstraat
651,Kolonel Silvertopstraat 5333,2022-10-06,15:00:00,374,231,143,FMN 03 Kolonel Silvertopstraat
651,Kolonel Silvertopstraat 5333,2022-10-06,16:00:00,466,303,163,FMN 03 Kolonel Silvertopstraat
651,Kolonel Silvertopstraat 5333,2022-10-06,17:00:00,467,284,183,FMN 03 Kolonel Silvertopstraat
651,Kolonel Silvertopstraat 5333,2022-10-06,18:00:00,394,257,137,FMN 03 Kolonel Silvertopstraat
651,Kolonel Silvertopstraat 5333,2022-10-06,19:00:00,287,201,86,FMN 03 Kolonel Silvertopstraat
651,Kolonel Silvertopstraat 5333,2022-10-06,20:00:00,175,100,75,FMN 03 Kolonel Silvertopstraat
651,Kolonel Silvertopstraat 5333,2022-10-06,21:00:00,123,67,56,FMN 03 Kolonel Silvertopstraat
651,Kolonel Silvertopstraat 5333,2022-10-06,22:00:00,143,65,78,FMN 03 Kolonel Silvertopstraat
651,Kolonel Silvertopstraat 5333,2022-10-06,23:00:00,100,50,50,FMN 03 Kolonel Silvertopstraat
651,Kolonel Silvertopstraat 5333,2022-10-07,00:00:00,29,19,10,FMN 03 Kolonel Silvertopstraat
651,Kolonel Silvertopstraat 5333,2022-10-07,01:00:00,21,6,15,FMN 03 Kolonel Silvertopstraat
651,Kolonel Silvertopstraat 5333,2022-10-07,02:00:00,18,9,9,FMN 03 Kolonel Silvertopstraat
651,Kolonel Silvertopstraat 5333,2022-10-07,03:00:00,21,6,15,FMN 03 Kolonel Silvertopstraat
651,Kolonel Silvertopstraat 5333,2022-10-07,04:00:00,28,19,9,FMN 03 Kolonel Silvertopstraat
651,Kolonel Silvertopstraat 5333,2022-10-07,05:00:00,52,35,17,FMN 03 Kolonel Silvertopstraat
651,Kolonel Silvertopstraat 5333,2022-10-07,06:00:00,124,93,31,FMN 03 Kolonel Silvertopstraat
651,Kolonel Silvertopstraat 5333,2022-10-07,07:00:00,335,284,51,FMN 03 Kolonel Silvertopstraat
651,Kolonel Silvertopstraat 5333,2022-10-07,08:00:00,698,602,96,FMN 03 Kolonel Silvertopstraat
651,Kolonel Silvertopstraat 5333,2022-10-07,09:00:00,261,205,56,FMN 03 Kolonel Silvertopstraat
651,Kolonel Silvertopstraat 5333,2022-10-07,10:00:00,220,160,60,FMN 03 Kolonel Silvertopstraat
651,Kolonel Silvertopstraat 5333,2022-10-07,11:00:00,241,179,62,FMN 03 Kolonel Silvertopstraat
651,Kolonel Silvertopstraat 5333,2022-10-07,12:00:00,316,228,88,FMN 03 Kolonel Silvertopstraat
651,Kolonel Silvertopstraat 5333,2022-10-07,13:00:00,274,187,87,FMN 03 Kolonel Silvertopstraat
651,Kolonel Silvertopstraat 5333,2022-10-07,14:00:00,280,200,80,FMN 03 Kolonel Silvertopstraat
651,Kolonel Silvertopstraat 5333,2022-10-07,15:00:00,349,224,125,FMN 03 Kolonel Silvertopstraat
651,Kolonel Silvertopstraat 5333,2022-10-07,16:00:00,425,304,121,FMN 03 Kolonel Silvertopstraat
651,Kolonel Silvertopstraat 5333,2022-10-07,17:00:00,418,273,145,FMN 03 Kolonel Silvertopstraat
651,Kolonel Silvertopstraat 5333,2022-10-07,18:00:00,373,247,126,FMN 03 Kolonel Silvertopstraat
651,Kolonel Silvertopstraat 5333,2022-10-07,19:00:00,313,221,92,FMN 03 Kolonel Silvertopstraat
651,Kolonel Silvertopstraat 5333,2022-10-07,20:00:00,203,139,64,FMN 03 Kolonel Silvertopstraat
651,Kolonel Silvertopstraat 5333,2022-10-07,21:00:00,148,85,63,FMN 03 Kolonel Silvertopstraat
651,Kolonel Silvertopstraat 5333,2022-10-07,22:00:00,155,87,68,FMN 03 Kolonel Silvertopstraat
651,Kolonel Silvertopstraat 5333,2022-10-07,23:00:00,121,57,64,FMN 03 Kolonel Silvertopstraat
651,Kolonel Silvertopstraat 5333,2022-10-08,00:00:00,58,24,34,FMN 03 Kolonel Silvertopstraat
651,Kolonel Silvertopstraat 5333,2022-10-08,01:00:00,56,26,30,FMN 03 Kolonel Silvertopstraat
651,Kolonel Silvertopstraat 5333,2022-10-08,02:00:00,41,17,24,FMN 03 Kolonel Silvertopstraat
651,Kolonel Silvertopstraat 5333,2022-10-08,03:00:00,29,13,16,FMN 03 Kolonel Silvertopstraat
651,Kolonel Silvertopstraat 5333,2022-10-08,04:00:00,30,16,14,FMN 03 Kolonel Silvertopstraat
651,Kolonel Silvertopstraat 5333,2022-10-08,05:00:00,30,17,13,FMN 03 Kolonel Silvertopstraat
651,Kolonel Silvertopstraat 5333,2022-10-08,06:00:00,37,28,9,FMN 03 Kolonel Silvertopstraat
651,Kolonel Silvertopstraat 5333,2022-10-08,07:00:00,43,36,7,FMN 03 Kolonel Silvertopstraat
651,Kolonel Silvertopstraat 5333,2022-10-08,08:00:00,77,55,22,FMN 03 Kolonel Silvertopstraat
651,Kolonel Silvertopstraat 5333,2022-10-08,09:00:00,181,151,30,FMN 03 Kolonel Silvertopstraat
651,Kolonel Silvertopstraat 5333,2022-10-08,10:00:00,171,134,37,FMN 03 Kolonel Silvertopstraat
651,Kolonel Silvertopstraat 5333,2022-10-08,11:00:00,211,168,43,FMN 03 Kolonel Silvertopstraat
651,Kolonel Silvertopstraat 5333,2022-10-08,12:00:00,238,185,53,FMN 03 Kolonel Silvertopstraat
651,Kolonel Silvertopstraat 5333,2022-10-08,13:00:00,264,205,59,FMN 03 Kolonel Silvertopstraat
651,Kolonel Silvertopstraat 5333,2022-10-08,14:00:00,263,190,73,FMN 03 Kolonel Silvertopstraat
651,Kolonel Silvertopstraat 5333,2022-10-08,15:00:00,261,186,75,FMN 03 Kolonel Silvertopstraat
651,Kolonel Silvertopstraat 5333,2022-10-08,16:00:00,234,143,91,FMN 03 Kolonel Silvertopstraat
651,Kolonel Silvertopstraat 5333,2022-10-08,17:00:00,243,151,92,FMN 03 Kolonel Silvertopstraat
651,Kolonel Silvertopstraat 5333,2022-10-08,18:00:00,229,143,86,FMN 03 Kolonel Silvertopstraat
651,Kolonel Silvertopstraat 5333,2022-10-08,19:00:00,230,168,62,FMN 03 Kolonel Silvertopstraat
651,Kolonel Silvertopstraat 5333,2022-10-08,20:00:00,176,108,68,FMN 03 Kolonel Silvertopstraat
651,Kolonel Silvertopstraat 5333,2022-10-08,21:00:00,135,78,57,FMN 03 Kolonel Silvertopstraat
651,Kolonel Silvertopstraat 5333,2022-10-08,22:00:00,98,47,51,FMN 03 Kolonel Silvertopstraat
651,Kolonel Silvertopstraat 5333,2022-10-08,23:00:00,80,43,37,FMN 03 Kolonel Silvertopstraat
651,Kolonel Silvertopstraat 5333,2022-10-09,00:00:00,65,27,38,FMN 03 Kolonel Silvertopstraat
651,Kolonel Silvertopstraat 5333,2022-10-09,01:00:00,52,25,27,FMN 03 Kolonel Silvertopstraat
651,Kolonel Silvertopstraat 5333,2022-10-09,02:00:00,40,16,24,FMN 03 Kolonel Silvertopstraat
651,Kolonel Silvertopstraat 5333,2022-10-09,03:00:00,25,9,16,FMN 03 Kolonel Silvertopstraat
651,Kolonel Silvertopstraat 5333,2022-10-09,04:00:00,28,14,14,FMN 03 Kolonel Silvertopstraat
651,Kolonel Silvertopstraat 5333,2022-10-09,05:00:00,21,16,5,FMN 03 Kolonel Silvertopstraat
651,Kolonel Silvertopstraat 5333,2022-10-09,06:00:00,27,23,4,FMN 03 Kolonel Silvertopstraat
651,Kolonel Silvertopstraat 5333,2022-10-09,07:00:00,28,18,10,FMN 03 Kolonel Silvertopstraat
651,Kolonel Silvertopstraat 5333,2022-10-09,08:00:00,48,34,14,FMN 03 Kolonel Silvertopstraat
651,Kolonel Silvertopstraat 5333,2022-10-09,09:00:00,123,103,20,FMN 03 Kolonel Silvertopstraat
651,Kolonel Silvertopstraat 5333,2022-10-09,10:00:00,127,103,24,FMN 03 Kolonel Silvertopstraat
651,Kolonel Silvertopstraat 5333,2022-10-09,11:00:00,174,131,43,FMN 03 Kolonel Silvertopstraat
651,Kolonel Silvertopstraat 5333,2022-10-09,12:00:00,173,128,45,FMN 03 Kolonel Silvertopstraat
651,Kolonel Silvertopstraat 5333,2022-10-09,13:00:00,226,183,43,FMN 03 Kolonel Silvertopstraat
651,Kolonel Silvertopstraat 5333,2022-10-09,14:00:00,262,188,74,FMN 03 Kolonel Silvertopstraat
651,Kolonel Silvertopstraat 5333,2022-10-09,15:00:00,217,145,72,FMN 03 Kolonel Silvertopstraat
651,Kolonel Silvertopstraat 5333,2022-10-09,16:00:00,202,144,58,FMN 03 Kolonel Silvertopstraat
651,Kolonel Silvertopstraat 5333,2022-10-09,17:00:00,216,127,89,FMN 03 Kolonel Silvertopstraat
651,Kolonel Silvertopstraat 5333,2022-10-09,18:00:00,198,128,70,FMN 03 Kolonel Silvertopstraat
651,Kolonel Silvertopstraat 5333,2022-10-09,19:00:00,163,109,54,FMN 03 Kolonel Silvertopstraat
651,Kolonel Silvertopstraat 5333,2022-10-09,20:00:00,126,57,69,FMN 03 Kolonel Silvertopstraat
651,Kolonel Silvertopstraat 5333,2022-10-09,21:00:00,83,45,38,FMN 03 Kolonel Silvertopstraat
651,Kolonel Silvertopstraat 5333,2022-10-09,22:00:00,74,35,39,FMN 03 Kolonel Silvertopstraat
651,Kolonel Silvertopstraat 5333,2022-10-09,23:00:00,44,16,28,FMN 03 Kolonel Silvertopstraat
651,Kolonel Silvertopstraat 5333,2022-10-10,00:00:00,33,18,15,FMN 03 Kolonel Silvertopstraat
651,Kolonel Silvertopstraat 5333,2022-10-10,01:00:00,14,5,9,FMN 03 Kolonel Silvertopstraat
651,Kolonel Silvertopstraat 5333,2022-10-10,02:00:00,18,13,5,FMN 03 Kolonel Silvertopstraat
651,Kolonel Silvertopstraat 5333,2022-10-10,03:00:00,12,11,1,FMN 03 Kolonel Silvertopstraat
651,Kolonel Silvertopstraat 5333,2022-10-10,04:00:00,20,17,3,FMN 03 Kolonel Silvertopstraat
651,Kolonel Silvertopstraat 5333,2022-10-10,05:00:00,45,34,11,FMN 03 Kolonel Silvertopstraat
651,Kolonel Silvertopstraat 5333,2022-10-10,06:00:00,120,93,27,FMN 03 Kolonel Silvertopstraat
651,Kolonel Silvertopstraat 5333,2022-10-10,07:00:00,367,308,59,FMN 03 Kolonel Silvertopstraat
651,Kolonel Silvertopstraat 5333,2022-10-10,08:00:00,717,614,103,FMN 03 Kolonel Silvertopstraat
651,Kolonel Silvertopstraat 5333,2022-10-10,09:00:00,221,184,37,FMN 03 Kolonel Silvertopstraat
651,Kolonel Silvertopstraat 5333,2022-10-10,10:00:00,177,145,32,FMN 03 Kolonel Silvertopstraat
651,Kolonel Silvertopstraat 5333,2022-10-10,11:00:00,172,132,40,FMN 03 Kolonel Silvertopstraat
651,Kolonel Silvertopstraat 5333,2022-10-10,12:00:00,205,141,64,FMN 03 Kolonel Silvertopstraat
651,Kolonel Silvertopstraat 5333,2022-10-10,13:00:00,260,191,69,FMN 03 Kolonel Silvertopstraat
651,Kolonel Silvertopstraat 5333,2022-10-10,14:00:00,222,149,73,FMN 03 Kolonel Silvertopstraat
651,Kolonel Silvertopstraat 5333,2022-10-10,15:00:00,330,212,118,FMN 03 Kolonel Silvertopstraat
651,Kolonel Silvertopstraat 5333,2022-10-10,16:00:00,418,269,149,FMN 03 Kolonel Silvertopstraat
651,Kolonel Silvertopstraat 5333,2022-10-10,17:00:00,379,231,148,FMN 03 Kolonel Silvertopstraat
651,Kolonel Silvertopstraat 5333,2022-10-10,18:00:00,327,211,116,FMN 03 Kolonel Silvertopstraat
651,Kolonel Silvertopstraat 5333,2022-10-10,19:00:00,170,102,68,FMN 03 Kolonel Silvertopstraat
651,Kolonel Silvertopstraat 5333,2022-10-10,20:00:00,149,88,61,FMN 03 Kolonel Silvertopstraat
651,Kolonel Silvertopstraat 5333,2022-10-10,21:00:00,119,58,61,FMN 03 Kolonel Silvertopstraat
651,Kolonel Silvertopstraat 5333,2022-10-10,22:00:00,110,70,40,FMN 03 Kolonel Silvertopstraat
651,Kolonel Silvertopstraat 5333,2022-10-10,23:00:00,36,23,13,FMN 03 Kolonel Silvertopstraat
651,Kolonel Silvertopstraat 5333,2022-10-11,00:00:00,20,7,13,FMN 03 Kolonel Silvertopstraat
651,Kolonel Silvertopstraat 5333,2022-10-11,01:00:00,20,5,15,FMN 03 Kolonel Silvertopstraat
651,Kolonel Silvertopstraat 5333,2022-10-11,02:00:00,6,2,4,FMN 03 Kolonel Silvertopstraat
651,Kolonel Silvertopstraat 5333,2022-10-11,03:00:00,11,10,1,FMN 03 Kolonel Silvertopstraat
651,Kolonel Silvertopstraat 5333,2022-10-11,04:00:00,25,19,6,FMN 03 Kolonel Silvertopstraat
651,Kolonel Silvertopstraat 5333,2022-10-11,05:00:00,62,46,16,FMN 03 Kolonel Silvertopstraat
651,Kolonel Silvertopstraat 5333,2022-10-11,06:00:00,139,102,37,FMN 03 Kolonel Silvertopstraat
651,Kolonel Silvertopstraat 5333,2022-10-11,07:00:00,389,327,62,FMN 03 Kolonel Silvertopstraat
651,Kolonel Silvertopstraat 5333,2022-10-11,08:00:00,783,666,117,FMN 03 Kolonel Silvertopstraat
651,Kolonel Silvertopstraat 5333,2022-10-11,09:00:00,271,211,60,FMN 03 Kolonel Silvertopstraat
651,Kolonel Silvertopstraat 5333,2022-10-11,10:00:00,173,145,28,FMN 03 Kolonel Silvertopstraat
651,Kolonel Silvertopstraat 5333,2022-10-11,11:00:00,190,144,46,FMN 03 Kolonel Silvertopstraat
651,Kolonel Silvertopstraat 5333,2022-10-11,12:00:00,237,166,71,FMN 03 Kolonel Silvertopstraat
651,Kolonel Silvertopstraat 5333,2022-10-11,13:00:00,219,148,71,FMN 03 Kolonel Silvertopstraat
651,Kolonel Silvertopstraat 5333,2022-10-11,14:00:00,259,186,73,FMN 03 Kolonel Silvertopstraat
651,Kolonel Silvertopstraat 5333,2022-10-11,15:00:00,360,236,124,FMN 03 Kolonel Silvertopstraat
651,Kolonel Silvertopstraat 5333,2022-10-11,16:00:00,469,299,170,FMN 03 Kolonel Silvertopstraat
651,Kolonel Silvertopstraat 5333,2022-10-11,17:00:00,496,322,174,FMN 03 Kolonel Silvertopstraat
651,Kolonel Silvertopstraat 5333,2022-10-11,18:00:00,322,191,131,FMN 03 Kolonel Silvertopstraat
651,Kolonel Silvertopstraat 5333,2022-10-11,19:00:00,238,156,82,FMN 03 Kolonel Silvertopstraat
651,Kolonel Silvertopstraat 5333,2022-10-11,20:00:00,181,115,66,FMN 03 Kolonel Silvertopstraat
651,Kolonel Silvertopstraat 5333,2022-10-11,21:00:00,128,59,69,FMN 03 Kolonel Silvertopstraat
651,Kolonel Silvertopstraat 5333,2022-10-11,22:00:00,111,60,51,FMN 03 Kolonel Silvertopstraat
651,Kolonel Silvertopstraat 5333,2022-10-11,23:00:00,56,24,32,FMN 03 Kolonel Silvertopstraat
651,Kolonel Silvertopstraat 5333,2022-10-12,00:00:00,27,9,18,FMN 03 Kolonel Silvertopstraat
651,Kolonel Silvertopstraat 5333,2022-10-12,01:00:00,21,12,9,FMN 03 Kolonel Silvertopstraat
651,Kolonel Silvertopstraat 5333,2022-10-12,02:00:00,9,5,4,FMN 03 Kolonel Silvertopstraat
651,Kolonel Silvertopstraat 5333,2022-10-12,03:00:00,7,5,2,FMN 03 Kolonel Silvertopstraat
651,Kolonel Silvertopstraat 5333,2022-10-12,04:00:00,27,23,4,FMN 03 Kolonel Silvertopstraat
651,Kolonel Silvertopstraat 5333,2022-10-12,05:00:00,62,45,17,FMN 03 Kolonel Silvertopstraat
651,Kolonel Silvertopstraat 5333,2022-10-12,06:00:00,115,85,30,FMN 03 Kolonel Silvertopstraat
651,Kolonel Silvertopstraat 5333,2022-10-12,07:00:00,354,288,66,FMN 03 Kolonel Silvertopstraat
651,Kolonel Silvertopstraat 5333,2022-10-12,08:00:00,680,577,103,FMN 03 Kolonel Silvertopstraat
651,Kolonel Silvertopstraat 5333,2022-10-12,09:00:00,243,195,48,FMN 03 Kolonel Silvertopstraat
651,Kolonel Silvertopstraat 5333,2022-10-12,10:00:00,218,166,52,FMN 03 Kolonel Silvertopstraat
651,Kolonel Silvertopstraat 5333,2022-10-12,11:00:00,231,175,56,FMN 03 Kolonel Silvertopstraat
651,Kolonel Silvertopstraat 5333,2022-10-12,12:00:00,374,243,131,FMN 03 Kolonel Silvertopstraat
651,Kolonel Silvertopstraat 5333,2022-10-12,13:00:00,308,194,114,FMN 03 Kolonel Silvertopstraat
651,Kolonel Silvertopstraat 5333,2022-10-12,14:00:00,236,162,74,FMN 03 Kolonel Silvertopstraat
651,Kolonel Silvertopstraat 5333,2022-10-12,15:00:00,256,170,86,FMN 03 Kolonel Silvertopstraat
651,Kolonel Silvertopstraat 5333,2022-10-12,16:00:00,401,281,120,FMN 03 Kolonel Silvertopstraat
651,Kolonel Silvertopstraat 5333,2022-10-12,17:00:00,433,285,148,FMN 03 Kolonel Silvertopstraat
651,Kolonel Silvertopstraat 5333,2022-10-12,18:00:00,356,231,125,FMN 03 Kolonel Silvertopstraat
651,Kolonel Silvertopstraat 5333,2022-10-12,19:00:00,244,161,83,FMN 03 Kolonel Silvertopstraat
651,Kolonel Silvertopstraat 5333,2022-10-12,20:00:00,184,114,70,FMN 03 Kolonel Silvertopstraat
651,Kolonel Silvertopstraat 5333,2022-10-12,21:00:00,107,61,46,FMN 03 Kolonel Silvertopstraat
651,Kolonel Silvertopstraat 5333,2022-10-12,22:00:00,137,76,61,FMN 03 Kolonel Silvertopstraat
651,Kolonel Silvertopstraat 5333,2022-10-12,23:00:00,86,38,48,FMN 03 Kolonel Silvertopstraat
651,Kolonel Silvertopstraat 5333,2022-10-13,00:00:00,26,10,16,FMN 03 Kolonel Silvertopstraat
651,Kolonel Silvertopstraat 5333,2022-10-13,01:00:00,18,7,11,FMN 03 Kolonel Silvertopstraat
651,Kolonel Silvertopstraat 5333,2022-10-13,02:00:00,7,3,4,FMN 03 Kolonel Silvertopstraat
651,Kolonel Silvertopstraat 5333,2022-10-13,03:00:00,7,6,1,FMN 03 Kolonel Silvertopstraat
651,Kolonel Silvertopstraat 5333,2022-10-13,04:00:00,27,20,7,FMN 03 Kolonel Silvertopstraat
651,Kolonel Silvertopstraat 5333,2022-10-13,05:00:00,54,39,15,FMN 03 Kolonel Silvertopstraat
651,Kolonel Silvertopstraat 5333,2022-10-13,06:00:00,141,111,30,FMN 03 Kolonel Silvertopstraat
651,Kolonel Silvertopstraat 5333,2022-10-13,07:00:00,369,309,60,FMN 03 Kolonel Silvertopstraat
651,Kolonel Silvertopstraat 5333,2022-10-13,08:00:00,761,636,125,FMN 03 Kolonel Silvertopstraat
651,Kolonel Silvertopstraat 5333,2022-10-13,09:00:00,273,223,50,FMN 03 Kolonel Silvertopstraat
651,Kolonel Silvertopstraat 5333,2022-10-13,10:00:00,167,131,36,FMN 03 Kolonel Silvertopstraat
651,Kolonel Silvertopstraat 5333,2022-10-13,11:00:00,131,105,26,FMN 03 Kolonel Silvertopstraat
651,Kolonel Silvertopstraat 5333,2022-10-13,12:00:00,225,158,67,FMN 03 Kolonel Silvertopstraat
651,Kolonel Silvertopstraat 5333,2022-10-13,13:00:00,199,133,66,FMN 03 Kolonel Silvertopstraat
651,Kolonel Silvertopstraat 5333,2022-10-13,14:00:00,188,115,73,FMN 03 Kolonel Silvertopstraat
651,Kolonel Silvertopstraat 5333,2022-10-13,15:00:00,315,207,108,FMN 03 Kolonel Silvertopstraat
651,Kolonel Silvertopstraat 5333,2022-10-13,16:00:00,410,283,127,FMN 03 Kolonel Silvertopstraat
651,Kolonel Silvertopstraat 5333,2022-10-13,17:00:00,412,259,153,FMN 03 Kolonel Silvertopstraat
651,Kolonel Silvertopstraat 5333,2022-10-13,18:00:00,285,177,108,FMN 03 Kolonel Silvertopstraat
651,Kolonel Silvertopstraat 5333,2022-10-13,19:00:00,180,118,62,FMN 03 Kolonel Silvertopstraat
651,Kolonel Silvertopstraat 5333,2022-10-13,20:00:00,158,93,65,FMN 03 Kolonel Silvertopstraat
651,Kolonel Silvertopstraat 5333,2022-10-13,21:00:00,130,58,72,FMN 03 Kolonel Silvertopstraat
651,Kolonel Silvertopstraat 5333,2022-10-13,22:00:00,110,51,59,FMN 03 Kolonel Silvertopstraat
651,Kolonel Silvertopstraat 5333,2022-10-13,23:00:00,64,28,36,FMN 03 Kolonel Silvertopstraat
651,Kolonel Silvertopstraat 5333,2022-10-14,00:00:00,41,19,22,FMN 03 Kolonel Silvertopstraat
651,Kolonel Silvertopstraat 5333,2022-10-14,01:00:00,23,9,14,FMN 03 Kolonel Silvertopstraat
651,Kolonel Silvertopstraat 5333,2022-10-14,02:00:00,19,5,14,FMN 03 Kolonel Silvertopstraat
651,Kolonel Silvertopstraat 5333,2022-10-14,03:00:00,12,5,7,FMN 03 Kolonel Silvertopstraat
651,Kolonel Silvertopstraat 5333,2022-10-14,04:00:00,21,17,4,FMN 03 Kolonel Silvertopstraat
651,Kolonel Silvertopstraat 5333,2022-10-14,05:00:00,59,43,16,FMN 03 Kolonel Silvertopstraat
651,Kolonel Silvertopstraat 5333,2022-10-14,06:00:00,114,83,31,FMN 03 Kolonel Silvertopstraat
651,Kolonel Silvertopstraat 5333,2022-10-14,07:00:00,341,295,46,FMN 03 Kolonel Silvertopstraat
651,Kolonel Silvertopstraat 5333,2022-10-14,08:00:00,642,547,95,FMN 03 Kolonel Silvertopstraat
651,Kolonel Silvertopstraat 5333,2022-10-14,09:00:00,180,147,33,FMN 03 Kolonel Silvertopstraat
651,Kolonel Silvertopstraat 5333,2022-10-14,10:00:00,186,143,43,FMN 03 Kolonel Silvertopstraat
651,Kolonel Silvertopstraat 5333,2022-10-14,11:00:00,140,97,43,FMN 03 Kolonel Silvertopstraat
651,Kolonel Silvertopstraat 5333,2022-10-14,12:00:00,203,137,66,FMN 03 Kolonel Silvertopstraat
651,Kolonel Silvertopstraat 5333,2022-10-14,13:00:00,242,180,62,FMN 03 Kolonel Silvertopstraat
651,Kolonel Silvertopstraat 5333,2022-10-14,14:00:00,192,123,69,FMN 03 Kolonel Silvertopstraat
651,Kolonel Silvertopstraat 5333,2022-10-14,15:00:00,356,238,118,FMN 03 Kolonel Silvertopstraat
651,Kolonel Silvertopstraat 5333,2022-10-14,16:00:00,389,264,125,FMN 03 Kolonel Silvertopstraat
651,Kolonel Silvertopstraat 5333,2022-10-14,17:00:00,393,258,135,FMN 03 Kolonel Silvertopstraat
651,Kolonel Silvertopstraat 5333,2022-10-14,18:00:00,332,219,113,FMN 03 Kolonel Silvertopstraat
651,Kolonel Silvertopstraat 5333,2022-10-14,19:00:00,278,187,91,FMN 03 Kolonel Silvertopstraat
651,Kolonel Silvertopstraat 5333,2022-10-14,20:00:00,193,126,67,FMN 03 Kolonel Silvertopstraat
651,Kolonel Silvertopstraat 5333,2022-10-14,21:00:00,156,92,64,FMN 03 Kolonel Silvertopstraat
651,Kolonel Silvertopstraat 5333,2022-10-14,22:00:00,142,71,71,FMN 03 Kolonel Silvertopstraat
651,Kolonel Silvertopstraat 5333,2022-10-14,23:00:00,112,62,50,FMN 03 Kolonel Silvertopstraat
651,Kolonel Silvertopstraat 5333,2022-10-15,00:00:00,97,50,47,FMN 03 Kolonel Silvertopstraat
651,Kolonel Silvertopstraat 5333,2022-10-15,01:00:00,92,55,37,FMN 03 Kolonel Silvertopstraat
651,Kolonel Silvertopstraat 5333,2022-10-15,02:00:00,72,39,33,FMN 03 Kolonel Silvertopstraat
651,Kolonel Silvertopstraat 5333,2022-10-15,03:00:00,62,46,16,FMN 03 Kolonel Silvertopstraat
651,Kolonel Silvertopstraat 5333,2022-10-15,04:00:00,39,23,16,FMN 03 Kolonel Silvertopstraat
651,Kolonel Silvertopstraat 5333,2022-10-15,05:00:00,32,18,14,FMN 03 Kolonel Silvertopstraat
651,Kolonel Silvertopstraat 5333,2022-10-15,06:00:00,41,35,6,FMN 03 Kolonel Silvertopstraat
651,Kolonel Silvertopstraat 5333,2022-10-15,07:00:00,48,38,10,FMN 03 Kolonel Silvertopstraat
651,Kolonel Silvertopstraat 5333,2022-10-15,08:00:00,80,60,20,FMN 03 Kolonel Silvertopstraat
651,Kolonel Silvertopstraat 5333,2022-10-15,09:00:00,157,130,27,FMN 03 Kolonel Silvertopstraat
651,Kolonel Silvertopstraat 5333,2022-10-15,10:00:00,129,99,30,FMN 03 Kolonel Silvertopstraat
651,Kolonel Silvertopstraat 5333,2022-10-15,11:00:00,169,134,35,FMN 03 Kolonel Silvertopstraat
651,Kolonel Silvertopstraat 5333,2022-10-15,12:00:00,150,117,33,FMN 03 Kolonel Silvertopstraat
651,Kolonel Silvertopstraat 5333,2022-10-15,13:00:00,190,144,46,FMN 03 Kolonel Silvertopstraat
651,Kolonel Silvertopstraat 5333,2022-10-15,14:00:00,223,163,60,FMN 03 Kolonel Silvertopstraat
651,Kolonel Silvertopstraat 5333,2022-10-15,15:00:00,223,165,58,FMN 03 Kolonel Silvertopstraat
651,Kolonel Silvertopstraat 5333,2022-10-15,16:00:00,214,140,74,FMN 03 Kolonel Silvertopstraat
651,Kolonel Silvertopstraat 5333,2022-10-15,17:00:00,237,161,76,FMN 03 Kolonel Silvertopstraat
651,Kolonel Silvertopstraat 5333,2022-10-15,18:00:00,245,172,73,FMN 03 Kolonel Silvertopstraat
651,Kolonel Silvertopstraat 5333,2022-10-15,19:00:00,200,138,62,FMN 03 Kolonel Silvertopstraat
651,Kolonel Silvertopstraat 5333,2022-10-15,20:00:00,167,105,62,FMN 03 Kolonel Silvertopstraat
651,Kolonel Silvertopstraat 5333,2022-10-15,21:00:00,119,66,53,FMN 03 Kolonel Silvertopstraat
651,Kolonel Silvertopstraat 5333,2022-10-15,22:00:00,99,59,40,FMN 03 Kolonel Silvertopstraat
651,Kolonel Silvertopstraat 5333,2022-10-15,23:00:00,118,59,59,FMN 03 Kolonel Silvertopstraat
651,Kolonel Silvertopstraat 5333,2022-10-16,00:00:00,58,31,27,FMN 03 Kolonel Silvertopstraat
651,Kolonel Silvertopstraat 5333,2022-10-16,01:00:00,46,18,28,FMN 03 Kolonel Silvertopstraat
651,Kolonel Silvertopstraat 5333,2022-10-16,02:00:00,32,14,18,FMN 03 Kolonel Silvertopstraat
651,Kolonel Silvertopstraat 5333,2022-10-16,03:00:00,14,6,8,FMN 03 Kolonel Silvertopstraat
651,Kolonel Silvertopstraat 5333,2022-10-16,04:00:00,28,8,20,FMN 03 Kolonel Silvertopstraat
651,Kolonel Silvertopstraat 5333,2022-10-16,05:00:00,21,12,9,FMN 03 Kolonel Silvertopstraat
651,Kolonel Silvertopstraat 5333,2022-10-16,06:00:00,37,28,9,FMN 03 Kolonel Silvertopstraat
651,Kolonel Silvertopstraat 5333,2022-10-16,07:00:00,29,25,4,FMN 03 Kolonel Silvertopstraat
651,Kolonel Silvertopstraat 5333,2022-10-16,08:00:00,54,44,10,FMN 03 Kolonel Silvertopstraat
651,Kolonel Silvertopstraat 5333,2022-10-16,09:00:00,112,97,15,FMN 03 Kolonel Silvertopstraat
651,Kolonel Silvertopstraat 5333,2022-10-16,10:00:00,135,109,26,FMN 03 Kolonel Silvertopstraat
651,Kolonel Silvertopstraat 5333,2022-10-16,11:00:00,185,154,31,FMN 03 Kolonel Silvertopstraat
651,Kolonel Silvertopstraat 5333,2022-10-16,12:00:00,193,156,37,FMN 03 Kolonel Silvertopstraat
651,Kolonel Silvertopstraat 5333,2022-10-16,13:00:00,193,145,48,FMN 03 Kolonel Silvertopstraat
651,Kolonel Silvertopstraat 5333,2022-10-16,14:00:00,207,151,56,FMN 03 Kolonel Silvertopstraat
651,Kolonel Silvertopstraat 5333,2022-10-16,15:00:00,200,141,59,FMN 03 Kolonel Silvertopstraat
651,Kolonel Silvertopstraat 5333,2022-10-16,16:00:00,203,152,51,FMN 03 Kolonel Silvertopstraat
651,Kolonel Silvertopstraat 5333,2022-10-16,17:00:00,230,155,75,FMN 03 Kolonel Silvertopstraat
651,Kolonel Silvertopstraat 5333,2022-10-16,18:00:00,200,107,93,FMN 03 Kolonel Silvertopstraat
651,Kolonel Silvertopstraat 5333,2022-10-16,19:00:00,192,100,92,FMN 03 Kolonel Silvertopstraat
651,Kolonel Silvertopstraat 5333,2022-10-16,20:00:00,123,57,66,FMN 03 Kolonel Silvertopstraat
651,Kolonel Silvertopstraat 5333,2022-10-16,21:00:00,110,67,43,FMN 03 Kolonel Silvertopstraat
651,Kolonel Silvertopstraat 5333,2022-10-16,22:00:00,154,119,35,FMN 03 Kolonel Silvertopstraat
651,Kolonel Silvertopstraat 5333,2022-10-16,23:00:00,53,30,23,FMN 03 Kolonel Silvertopstraat
651,Kolonel Silvertopstraat 5333,2022-10-17,00:00:00,27,11,16,FMN 03 Kolonel Silvertopstraat
651,Kolonel Silvertopstraat 5333,2022-10-17,01:00:00,13,6,7,FMN 03 Kolonel Silvertopstraat
651,Kolonel Silvertopstraat 5333,2022-10-17,02:00:00,6,3,3,FMN 03 Kolonel Silvertopstraat
651,Kolonel Silvertopstraat 5333,2022-10-17,03:00:00,9,7,2,FMN 03 Kolonel Silvertopstraat
651,Kolonel Silvertopstraat 5333,2022-10-17,04:00:00,32,22,10,FMN 03 Kolonel Silvertopstraat
651,Kolonel Silvertopstraat 5333,2022-10-17,05:00:00,53,35,18,FMN 03 Kolonel Silvertopstraat
651,Kolonel Silvertopstraat 5333,2022-10-17,06:00:00,137,107,30,FMN 03 Kolonel Silvertopstraat
651,Kolonel Silvertopstraat 5333,2022-10-17,07:00:00,385,331,54,FMN 03 Kolonel Silvertopstraat
651,Kolonel Silvertopstraat 5333,2022-10-17,08:00:00,679,584,95,FMN 03 Kolonel Silvertopstraat
651,Kolonel Silvertopstraat 5333,2022-10-17,09:00:00,153,113,40,FMN 03 Kolonel Silvertopstraat
651,Kolonel Silvertopstraat 5333,2022-10-17,10:00:00,94,75,19,FMN 03 Kolonel Silvertopstraat
651,Kolonel Silvertopstraat 5333,2022-10-17,11:00:00,101,74,27,FMN 03 Kolonel Silvertopstraat
651,Kolonel Silvertopstraat 5333,2022-10-17,12:00:00,152,99,53,FMN 03 Kolonel Silvertopstraat
651,Kolonel Silvertopstraat 5333,2022-10-17,13:00:00,165,123,42,FMN 03 Kolonel Silvertopstraat
651,Kolonel Silvertopstraat 5333,2022-10-17,14:00:00,187,126,61,FMN 03 Kolonel Silvertopstraat
651,Kolonel Silvertopstraat 5333,2022-10-17,15:00:00,307,190,117,FMN 03 Kolonel Silvertopstraat
651,Kolonel Silvertopstraat 5333,2022-10-17,16:00:00,392,271,121,FMN 03 Kolonel Silvertopstraat
651,Kolonel Silvertopstraat 5333,2022-10-17,17:00:00,398,257,141,FMN 03 Kolonel Silvertopstraat
651,Kolonel Silvertopstraat 5333,2022-10-17,18:00:00,302,186,116,FMN 03 Kolonel Silvertopstraat
651,Kolonel Silvertopstraat 5333,2022-10-17,19:00:00,201,115,86,FMN 03 Kolonel Silvertopstraat
651,Kolonel Silvertopstraat 5333,2022-10-17,20:00:00,140,72,68,FMN 03 Kolonel Silvertopstraat
651,Kolonel Silvertopstraat 5333,2022-10-17,21:00:00,100,54,46,FMN 03 Kolonel Silvertopstraat
651,Kolonel Silvertopstraat 5333,2022-10-17,22:00:00,99,57,42,FMN 03 Kolonel Silvertopstraat
651,Kolonel Silvertopstraat 5333,2022-10-17,23:00:00,52,25,27,FMN 03 Kolonel Silvertopstraat
651,Kolonel Silvertopstraat 5333,2022-10-18,00:00:00,33,17,16,FMN 03 Kolonel Silvertopstraat
651,Kolonel Silvertopstraat 5333,2022-10-18,01:00:00,22,7,15,FMN 03 Kolonel Silvertopstraat
651,Kolonel Silvertopstraat 5333,2022-10-18,02:00:00,14,5,9,FMN 03 Kolonel Silvertopstraat
651,Kolonel Silvertopstraat 5333,2022-10-18,03:00:00,10,8,2,FMN 03 Kolonel Silvertopstraat
651,Kolonel Silvertopstraat 5333,2022-10-18,04:00:00,26,19,7,FMN 03 Kolonel Silvertopstraat
651,Kolonel Silvertopstraat 5333,2022-10-18,05:00:00,57,37,20,FMN 03 Kolonel Silvertopstraat
651,Kolonel Silvertopstraat 5333,2022-10-18,06:00:00,157,118,39,FMN 03 Kolonel Silvertopstraat
651,Kolonel Silvertopstraat 5333,2022-10-18,07:00:00,400,340,60,FMN 03 Kolonel Silvertopstraat
651,Kolonel Silvertopstraat 5333,2022-10-18,08:00:00,815,705,110,FMN 03 Kolonel Silvertopstraat
651,Kolonel Silvertopstraat 5333,2022-10-18,09:00:00,265,216,49,FMN 03 Kolonel Silvertopstraat
651,Kolonel Silvertopstraat 5333,2022-10-18,10:00:00,224,161,63,FMN 03 Kolonel Silvertopstraat
651,Kolonel Silvertopstraat 5333,2022-10-18,11:00:00,193,141,52,FMN 03 Kolonel Silvertopstraat
651,Kolonel Silvertopstraat 5333,2022-10-18,12:00:00,285,207,78,FMN 03 Kolonel Silvertopstraat
651,Kolonel Silvertopstraat 5333,2022-10-18,13:00:00,256,171,85,FMN 03 Kolonel Silvertopstraat
651,Kolonel Silvertopstraat 5333,2022-10-18,14:00:00,280,211,69,FMN 03 Kolonel Silvertopstraat
651,Kolonel Silvertopstraat 5333,2022-10-18,15:00:00,381,235,146,FMN 03 Kolonel Silvertopstraat
651,Kolonel Silvertopstraat 5333,2022-10-18,16:00:00,494,302,192,FMN 03 Kolonel Silvertopstraat
651,Kolonel Silvertopstraat 5333,2022-10-18,17:00:00,492,303,189,FMN 03 Kolonel Silvertopstraat
651,Kolonel Silvertopstraat 5333,2022-10-18,18:00:00,415,262,153,FMN 03 Kolonel Silvertopstraat
651,Kolonel Silvertopstraat 5333,2022-10-18,19:00:00,242,149,93,FMN 03 Kolonel Silvertopstraat
651,Kolonel Silvertopstraat 5333,2022-10-18,20:00:00,170,87,83,FMN 03 Kolonel Silvertopstraat
651,Kolonel Silvertopstraat 5333,2022-10-18,21:00:00,144,87,57,FMN 03 Kolonel Silvertopstraat
651,Kolonel Silvertopstraat 5333,2022-10-18,22:00:00,123,64,59,FMN 03 Kolonel Silvertopstraat
651,Kolonel Silvertopstraat 5333,2022-10-18,23:00:00,66,22,44,FMN 03 Kolonel Silvertopstraat
651,Kolonel Silvertopstraat 5333,2022-10-19,00:00:00,52,29,23,FMN 03 Kolonel Silvertopstraat
651,Kolonel Silvertopstraat 5333,2022-10-19,01:00:00,25,9,16,FMN 03 Kolonel Silvertopstraat
651,Kolonel Silvertopstraat 5333,2022-10-19,02:00:00,41,34,7,FMN 03 Kolonel Silvertopstraat
651,Kolonel Silvertopstraat 5333,2022-10-19,03:00:00,39,32,7,FMN 03 Kolonel Silvertopstraat
651,Kolonel Silvertopstraat 5333,2022-10-19,04:00:00,68,55,13,FMN 03 Kolonel Silvertopstraat
651,Kolonel Silvertopstraat 5333,2022-10-19,05:00:00,79,61,18,FMN 03 Kolonel Silvertopstraat
651,Kolonel Silvertopstraat 5333,2022-10-19,06:00:00,141,109,32,FMN 03 Kolonel Silvertopstraat
651,Kolonel Silvertopstraat 5333,2022-10-19,07:00:00,379,307,72,FMN 03 Kolonel Silvertopstraat
651,Kolonel Silvertopstraat 5333,2022-10-19,08:00:00,688,583,105,FMN 03 Kolonel Silvertopstraat
651,Kolonel Silvertopstraat 5333,2022-10-19,09:00:00,206,164,42,FMN 03 Kolonel Silvertopstraat
651,Kolonel Silvertopstraat 5333,2022-10-19,10:00:00,221,166,55,FMN 03 Kolonel Silvertopstraat
651,Kolonel Silvertopstraat 5333,2022-10-19,11:00:00,189,149,40,FMN 03 Kolonel Silvertopstraat
651,Kolonel Silvertopstraat 5333,2022-10-19,12:00:00,435,288,147,FMN 03 Kolonel Silvertopstraat
651,Kolonel Silvertopstraat 5333,2022-10-19,13:00:00,286,198,88,FMN 03 Kolonel Silvertopstraat
651,Kolonel Silvertopstraat 5333,2022-10-19,14:00:00,276,204,72,FMN 03 Kolonel Silvertopstraat
651,Kolonel Silvertopstraat 5333,2022-10-19,15:00:00,282,192,90,FMN 03 Kolonel Silvertopstraat
651,Kolonel Silvertopstraat 5333,2022-10-19,16:00:00,370,259,111,FMN 03 Kolonel Silvertopstraat
651,Kolonel Silvertopstraat 5333,2022-10-19,17:00:00,427,290,137,FMN 03 Kolonel Silvertopstraat
651,Kolonel Silvertopstraat 5333,2022-10-19,18:00:00,334,215,119,FMN 03 Kolonel Silvertopstraat
651,Kolonel Silvertopstraat 5333,2022-10-19,19:00:00,272,200,72,FMN 03 Kolonel Silvertopstraat
651,Kolonel Silvertopstraat 5333,2022-10-19,20:00:00,167,94,73,FMN 03 Kolonel Silvertopstraat
651,Kolonel Silvertopstraat 5333,2022-10-19,21:00:00,155,76,79,FMN 03 Kolonel Silvertopstraat
651,Kolonel Silvertopstraat 5333,2022-10-19,22:00:00,129,66,63,FMN 03 Kolonel Silvertopstraat
651,Kolonel Silvertopstraat 5333,2022-10-19,23:00:00,72,31,41,FMN 03 Kolonel Silvertopstraat
651,Kolonel Silvertopstraat 5333,2022-10-20,00:00:00,42,19,23,FMN 03 Kolonel Silvertopstraat
651,Kolonel Silvertopstraat 5333,2022-10-20,01:00:00,25,14,11,FMN 03 Kolonel Silvertopstraat
651,Kolonel Silvertopstraat 5333,2022-10-20,02:00:00,12,4,8,FMN 03 Kolonel Silvertopstraat
651,Kolonel Silvertopstraat 5333,2022-10-20,03:00:00,11,6,5,FMN 03 Kolonel Silvertopstraat
651,Kolonel Silvertopstraat 5333,2022-10-20,04:00:00,29,14,15,FMN 03 Kolonel Silvertopstraat
651,Kolonel Silvertopstraat 5333,2022-10-20,05:00:00,47,30,17,FMN 03 Kolonel Silvertopstraat
651,Kolonel Silvertopstraat 5333,2022-10-20,06:00:00,146,110,36,FMN 03 Kolonel Silvertopstraat
651,Kolonel Silvertopstraat 5333,2022-10-20,07:00:00,391,330,61,FMN 03 Kolonel Silvertopstraat
651,Kolonel Silvertopstraat 5333,2022-10-20,08:00:00,772,638,134,FMN 03 Kolonel Silvertopstraat
651,Kolonel Silvertopstraat 5333,2022-10-20,09:00:00,262,218,44,FMN 03 Kolonel Silvertopstraat
651,Kolonel Silvertopstraat 5333,2022-10-20,10:00:00,203,160,43,FMN 03 Kolonel Silvertopstraat
651,Kolonel Silvertopstraat 5333,2022-10-20,11:00:00,126,96,30,FMN 03 Kolonel Silvertopstraat
651,Kolonel Silvertopstraat 5333,2022-10-20,12:00:00,217,139,78,FMN 03 Kolonel Silvertopstraat
651,Kolonel Silvertopstraat 5333,2022-10-20,13:00:00,189,140,49,FMN 03 Kolonel Silvertopstraat
651,Kolonel Silvertopstraat 5333,2022-10-20,14:00:00,209,139,70,FMN 03 Kolonel Silvertopstraat
651,Kolonel Silvertopstraat 5333,2022-10-20,15:00:00,332,216,116,FMN 03 Kolonel Silvertopstraat
651,Kolonel Silvertopstraat 5333,2022-10-20,16:00:00,433,298,135,FMN 03 Kolonel Silvertopstraat
651,Kolonel Silvertopstraat 5333,2022-10-20,17:00:00,500,316,184,FMN 03 Kolonel Silvertopstraat
651,Kolonel Silvertopstraat 5333,2022-10-20,18:00:00,350,218,132,FMN 03 Kolonel Silvertopstraat
651,Kolonel Silvertopstraat 5333,2022-10-20,19:00:00,255,159,96,FMN 03 Kolonel Silvertopstraat
651,Kolonel Silvertopstraat 5333,2022-10-20,20:00:00,178,113,65,FMN 03 Kolonel Silvertopstraat
651,Kolonel Silvertopstraat 5333,2022-10-20,21:00:00,147,70,77,FMN 03 Kolonel Silvertopstraat
651,Kolonel Silvertopstraat 5333,2022-10-20,22:00:00,137,81,56,FMN 03 Kolonel Silvertopstraat
651,Kolonel Silvertopstraat 5333,2022-10-20,23:00:00,87,46,41,FMN 03 Kolonel Silvertopstraat
651,Kolonel Silvertopstraat 5333,2022-10-21,00:00:00,35,14,21,FMN 03 Kolonel Silvertopstraat
651,Kolonel Silvertopstraat 5333,2022-10-21,01:00:00,40,13,27,FMN 03 Kolonel Silvertopstraat
651,Kolonel Silvertopstraat 5333,2022-10-21,02:00:00,12,6,6,FMN 03 Kolonel Silvertopstraat
651,Kolonel Silvertopstraat 5333,2022-10-21,03:00:00,15,7,8,FMN 03 Kolonel Silvertopstraat
651,Kolonel Silvertopstraat 5333,2022-10-21,04:00:00,21,13,8,FMN 03 Kolonel Silvertopstraat
651,Kolonel Silvertopstraat 5333,2022-10-21,05:00:00,59,39,20,FMN 03 Kolonel Silvertopstraat
651,Kolonel Silvertopstraat 5333,2022-10-21,06:00:00,174,140,34,FMN 03 Kolonel Silvertopstraat
651,Kolonel Silvertopstraat 5333,2022-10-21,07:00:00,366,309,57,FMN 03 Kolonel Silvertopstraat
651,Kolonel Silvertopstraat 5333,2022-10-21,08:00:00,661,564,97,FMN 03 Kolonel Silvertopstraat
651,Kolonel Silvertopstraat 5333,2022-10-21,09:00:00,259,209,50,FMN 03 Kolonel Silvertopstraat
651,Kolonel Silvertopstraat 5333,2022-10-21,10:00:00,202,157,45,FMN 03 Kolonel Silvertopstraat
651,Kolonel Silvertopstraat 5333,2022-10-21,11:00:00,182,133,49,FMN 03 Kolonel Silvertopstraat
651,Kolonel Silvertopstraat 5333,2022-10-21,12:00:00,254,191,63,FMN 03 Kolonel Silvertopstraat
651,Kolonel Silvertopstraat 5333,2022-10-21,13:00:00,274,207,67,FMN 03 Kolonel Silvertopstraat
651,Kolonel Silvertopstraat 5333,2022-10-21,14:00:00,285,181,104,FMN 03 Kolonel Silvertopstraat
651,Kolonel Silvertopstraat 5333,2022-10-21,15:00:00,376,247,129,FMN 03 Kolonel Silvertopstraat
651,Kolonel Silvertopstraat 5333,2022-10-21,16:00:00,418,284,134,FMN 03 Kolonel Silvertopstraat
651,Kolonel Silvertopstraat 5333,2022-10-21,17:00:00,444,285,159,FMN 03 Kolonel Silvertopstraat
651,Kolonel Silvertopstraat 5333,2022-10-21,18:00:00,370,231,139,FMN 03 Kolonel Silvertopstraat
651,Kolonel Silvertopstraat 5333,2022-10-21,19:00:00,303,213,90,FMN 03 Kolonel Silvertopstraat
651,Kolonel Silvertopstraat 5333,2022-10-21,20:00:00,192,128,64,FMN 03 Kolonel Silvertopstraat
651,Kolonel Silvertopstraat 5333,2022-10-21,21:00:00,168,101,67,FMN 03 Kolonel Silvertopstraat
651,Kolonel Silvertopstraat 5333,2022-10-21,22:00:00,149,83,66,FMN 03 Kolonel Silvertopstraat
651,Kolonel Silvertopstraat 5333,2022-10-21,23:00:00,118,61,57,FMN 03 Kolonel Silvertopstraat
651,Kolonel Silvertopstraat 5333,2022-10-22,00:00:00,88,39,49,FMN 03 Kolonel Silvertopstraat
651,Kolonel Silvertopstraat 5333,2022-10-22,01:00:00,48,19,29,FMN 03 Kolonel Silvertopstraat
651,Kolonel Silvertopstraat 5333,2022-10-22,02:00:00,31,8,23,FMN 03 Kolonel Silvertopstraat
651,Kolonel Silvertopstraat 5333,2022-10-22,03:00:00,34,5,29,FMN 03 Kolonel Silvertopstraat
651,Kolonel Silvertopstraat 5333,2022-10-22,04:00:00,27,11,16,FMN 03 Kolonel Silvertopstraat
651,Kolonel Silvertopstraat 5333,2022-10-22,05:00:00,37,22,15,FMN 03 Kolonel Silvertopstraat
651,Kolonel Silvertopstraat 5333,2022-10-22,06:00:00,36,27,9,FMN 03 Kolonel Silvertopstraat
651,Kolonel Silvertopstraat 5333,2022-10-22,07:00:00,58,40,18,FMN 03 Kolonel Silvertopstraat
651,Kolonel Silvertopstraat 5333,2022-10-22,08:00:00,93,75,18,FMN 03 Kolonel Silvertopstraat
651,Kolonel Silvertopstraat 5333,2022-10-22,09:00:00,155,132,23,FMN 03 Kolonel Silvertopstraat
651,Kolonel Silvertopstraat 5333,2022-10-22,10:00:00,209,165,44,FMN 03 Kolonel Silvertopstraat
651,Kolonel Silvertopstraat 5333,2022-10-22,11:00:00,199,159,40,FMN 03 Kolonel Silvertopstraat
651,Kolonel Silvertopstraat 5333,2022-10-22,12:00:00,179,130,49,FMN 03 Kolonel Silvertopstraat
651,Kolonel Silvertopstraat 5333,2022-10-22,13:00:00,232,165,67,FMN 03 Kolonel Silvertopstraat
651,Kolonel Silvertopstraat 5333,2022-10-22,14:00:00,252,185,67,FMN 03 Kolonel Silvertopstraat
651,Kolonel Silvertopstraat 5333,2022-10-22,15:00:00,222,147,75,FMN 03 Kolonel Silvertopstraat
651,Kolonel Silvertopstraat 5333,2022-10-22,16:00:00,249,152,97,FMN 03 Kolonel Silvertopstraat
651,Kolonel Silvertopstraat 5333,2022-10-22,17:00:00,254,170,84,FMN 03 Kolonel Silvertopstraat
651,Kolonel Silvertopstraat 5333,2022-10-22,18:00:00,261,170,91,FMN 03 Kolonel Silvertopstraat
651,Kolonel Silvertopstraat 5333,2022-10-22,19:00:00,250,169,81,FMN 03 Kolonel Silvertopstraat
651,Kolonel Silvertopstraat 5333,2022-10-22,20:00:00,175,113,62,FMN 03 Kolonel Silvertopstraat
651,Kolonel Silvertopstraat 5333,2022-10-22,21:00:00,152,95,57,FMN 03 Kolonel Silvertopstraat
651,Kolonel Silvertopstraat 5333,2022-10-22,22:00:00,93,54,39,FMN 03 Kolonel Silvertopstraat
651,Kolonel Silvertopstraat 5333,2022-10-22,23:00:00,95,40,55,FMN 03 Kolonel Silvertopstraat
651,Kolonel Silvertopstraat 5333,2022-10-23,00:00:00,78,29,49,FMN 03 Kolonel Silvertopstraat
651,Kolonel Silvertopstraat 5333,2022-10-23,01:00:00,46,11,35,FMN 03 Kolonel Silvertopstraat
651,Kolonel Silvertopstraat 5333,2022-10-23,02:00:00,28,6,22,FMN 03 Kolonel Silvertopstraat
651,Kolonel Silvertopstraat 5333,2022-10-23,03:00:00,29,12,17,FMN 03 Kolonel Silvertopstraat
651,Kolonel Silvertopstraat 5333,2022-10-23,04:00:00,18,10,8,FMN 03 Kolonel Silvertopstraat
651,Kolonel Silvertopstraat 5333,2022-10-23,05:00:00,22,14,8,FMN 03 Kolonel Silvertopstraat
651,Kolonel Silvertopstraat 5333,2022-10-23,06:00:00,40,31,9,FMN 03 Kolonel Silvertopstraat
651,Kolonel Silvertopstraat 5333,2022-10-23,07:00:00,21,16,5,FMN 03 Kolonel Silvertopstraat
651,Kolonel Silvertopstraat 5333,2022-10-23,08:00:00,55,41,14,FMN 03 Kolonel Silvertopstraat
651,Kolonel Silvertopstraat 5333,2022-10-23,09:00:00,96,77,19,FMN 03 Kolonel Silvertopstraat
651,Kolonel Silvertopstraat 5333,2022-10-23,10:00:00,128,107,21,FMN 03 Kolonel Silvertopstraat
651,Kolonel Silvertopstraat 5333,2022-10-23,11:00:00,110,91,19,FMN 03 Kolonel Silvertopstraat
651,Kolonel Silvertopstraat 5333,2022-10-23,12:00:00,178,136,42,FMN 03 Kolonel Silvertopstraat
651,Kolonel Silvertopstraat 5333,2022-10-23,13:00:00,192,151,41,FMN 03 Kolonel Silvertopstraat
651,Kolonel Silvertopstraat 5333,2022-10-23,14:00:00,212,153,59,FMN 03 Kolonel Silvertopstraat
651,Kolonel Silvertopstraat 5333,2022-10-23,15:00:00,182,129,53,FMN 03 Kolonel Silvertopstraat
651,Kolonel Silvertopstraat 5333,2022-10-23,16:00:00,197,129,68,FMN 03 Kolonel Silvertopstraat
651,Kolonel Silvertopstraat 5333,2022-10-23,17:00:00,235,156,79,FMN 03 Kolonel Silvertopstraat
651,Kolonel Silvertopstraat 5333,2022-10-23,18:00:00,204,124,80,FMN 03 Kolonel Silvertopstraat
651,Kolonel Silvertopstraat 5333,2022-10-23,19:00:00,162,103,59,FMN 03 Kolonel Silvertopstraat
651,Kolonel Silvertopstraat 5333,2022-10-23,20:00:00,105,54,51,FMN 03 Kolonel Silvertopstraat
651,Kolonel Silvertopstraat 5333,2022-10-23,21:00:00,85,47,38,FMN 03 Kolonel Silvertopstraat
651,Kolonel Silvertopstraat 5333,2022-10-23,22:00:00,88,44,44,FMN 03 Kolonel Silvertopstraat
651,Kolonel Silvertopstraat 5333,2022-10-23,23:00:00,53,22,31,FMN 03 Kolonel Silvertopstraat
651,Kolonel Silvertopstraat 5333,2022-10-24,00:00:00,16,5,11,FMN 03 Kolonel Silvertopstraat
651,Kolonel Silvertopstraat 5333,2022-10-24,01:00:00,17,4,13,FMN 03 Kolonel Silvertopstraat
651,Kolonel Silvertopstraat 5333,2022-10-24,02:00:00,9,4,5,FMN 03 Kolonel Silvertopstraat
651,Kolonel Silvertopstraat 5333,2022-10-24,03:00:00,5,5,0,FMN 03 Kolonel Silvertopstraat
651,Kolonel Silvertopstraat 5333,2022-10-24,04:00:00,28,22,6,FMN 03 Kolonel Silvertopstraat
651,Kolonel Silvertopstraat 5333,2022-10-24,05:00:00,38,22,16,FMN 03 Kolonel Silvertopstraat
651,Kolonel Silvertopstraat 5333,2022-10-24,06:00:00,153,115,38,FMN 03 Kolonel Silvertopstraat
651,Kolonel Silvertopstraat 5333,2022-10-24,07:00:00,370,310,60,FMN 03 Kolonel Silvertopstraat
651,Kolonel Silvertopstraat 5333,2022-10-24,08:00:00,735,634,101,FMN 03 Kolonel Silvertopstraat
651,Kolonel Silvertopstraat 5333,2022-10-24,09:00:00,237,179,58,FMN 03 Kolonel Silvertopstraat
651,Kolonel Silvertopstraat 5333,2022-10-24,10:00:00,177,130,47,FMN 03 Kolonel Silvertopstraat
651,Kolonel Silvertopstraat 5333,2022-10-24,11:00:00,158,123,35,FMN 03 Kolonel Silvertopstraat
651,Kolonel Silvertopstraat 5333,2022-10-24,12:00:00,215,144,71,FMN 03 Kolonel Silvertopstraat
651,Kolonel Silvertopstraat 5333,2022-10-24,13:00:00,184,126,58,FMN 03 Kolonel Silvertopstraat
651,Kolonel Silvertopstraat 5333,2022-10-24,14:00:00,206,142,64,FMN 03 Kolonel Silvertopstraat
651,Kolonel Silvertopstraat 5333,2022-10-24,15:00:00,340,215,125,FMN 03 Kolonel Silvertopstraat
651,Kolonel Silvertopstraat 5333,2022-10-24,16:00:00,433,289,144,FMN 03 Kolonel Silvertopstraat
651,Kolonel Silvertopstraat 5333,2022-10-24,17:00:00,444,282,162,FMN 03 Kolonel Silvertopstraat
651,Kolonel Silvertopstraat 5333,2022-10-24,18:00:00,320,210,110,FMN 03 Kolonel Silvertopstraat
651,Kolonel Silvertopstraat 5333,2022-10-24,19:00:00,172,105,67,FMN 03 Kolonel Silvertopstraat
651,Kolonel Silvertopstraat 5333,2022-10-24,20:00:00,144,77,67,FMN 03 Kolonel Silvertopstraat
651,Kolonel Silvertopstraat 5333,2022-10-24,21:00:00,89,50,39,FMN 03 Kolonel Silvertopstraat
651,Kolonel Silvertopstraat 5333,2022-10-24,22:00:00,104,50,54,FMN 03 Kolonel Silvertopstraat
651,Kolonel Silvertopstraat 5333,2022-10-24,23:00:00,47,20,27,FMN 03 Kolonel Silvertopstraat
651,Kolonel Silvertopstraat 5333,2022-10-25,00:00:00,20,12,8,FMN 03 Kolonel Silvertopstraat
651,Kolonel Silvertopstraat 5333,2022-10-25,01:00:00,19,9,10,FMN 03 Kolonel Silvertopstraat
651,Kolonel Silvertopstraat 5333,2022-10-25,02:00:00,11,4,7,FMN 03 Kolonel Silvertopstraat
651,Kolonel Silvertopstraat 5333,2022-10-25,03:00:00,10,6,4,FMN 03 Kolonel Silvertopstraat
651,Kolonel Silvertopstraat 5333,2022-10-25,04:00:00,24,17,7,FMN 03 Kolonel Silvertopstraat
651,Kolonel Silvertopstraat 5333,2022-10-25,05:00:00,58,39,19,FMN 03 Kolonel Silvertopstraat
651,Kolonel Silvertopstraat 5333,2022-10-25,06:00:00,165,126,39,FMN 03 Kolonel Silvertopstraat
651,Kolonel Silvertopstraat 5333,2022-10-25,07:00:00,419,345,74,FMN 03 Kolonel Silvertopstraat
651,Kolonel Silvertopstraat 5333,2022-10-25,08:00:00,798,686,112,FMN 03 Kolonel Silvertopstraat
651,Kolonel Silvertopstraat 5333,2022-10-25,09:00:00,284,227,57,FMN 03 Kolonel Silvertopstraat
651,Kolonel Silvertopstraat 5333,2022-10-25,10:00:00,187,141,46,FMN 03 Kolonel Silvertopstraat
651,Kolonel Silvertopstraat 5333,2022-10-25,11:00:00,175,133,42,FMN 03 Kolonel Silvertopstraat
651,Kolonel Silvertopstraat 5333,2022-10-25,12:00:00,267,193,74,FMN 03 Kolonel Silvertopstraat
651,Kolonel Silvertopstraat 5333,2022-10-25,13:00:00,259,179,80,FMN 03 Kolonel Silvertopstraat
651,Kolonel Silvertopstraat 5333,2022-10-25,14:00:00,259,187,72,FMN 03 Kolonel Silvertopstraat
651,Kolonel Silvertopstraat 5333,2022-10-25,15:00:00,400,232,168,FMN 03 Kolonel Silvertopstraat
651,Kolonel Silvertopstraat 5333,2022-10-25,16:00:00,473,314,159,FMN 03 Kolonel Silvertopstraat
651,Kolonel Silvertopstraat 5333,2022-10-25,17:00:00,496,319,177,FMN 03 Kolonel Silvertopstraat
651,Kolonel Silvertopstraat 5333,2022-10-25,18:00:00,383,245,138,FMN 03 Kolonel Silvertopstraat
651,Kolonel Silvertopstraat 5333,2022-10-25,19:00:00,252,157,95,FMN 03 Kolonel Silvertopstraat
651,Kolonel Silvertopstraat 5333,2022-10-25,20:00:00,171,102,69,FMN 03 Kolonel Silvertopstraat
651,Kolonel Silvertopstraat 5333,2022-10-25,21:00:00,120,58,62,FMN 03 Kolonel Silvertopstraat
651,Kolonel Silvertopstraat 5333,2022-10-25,22:00:00,124,69,55,FMN 03 Kolonel Silvertopstraat
651,Kolonel Silvertopstraat 5333,2022-10-25,23:00:00,78,40,38,FMN 03 Kolonel Silvertopstraat
651,Kolonel Silvertopstraat 5333,2022-10-26,00:00:00,38,25,13,FMN 03 Kolonel Silvertopstraat
651,Kolonel Silvertopstraat 5333,2022-10-26,01:00:00,21,8,13,FMN 03 Kolonel Silvertopstraat
651,Kolonel Silvertopstraat 5333,2022-10-26,02:00:00,14,4,10,FMN 03 Kolonel Silvertopstraat
651,Kolonel Silvertopstraat 5333,2022-10-26,03:00:00,7,7,0,FMN 03 Kolonel Silvertopstraat
651,Kolonel Silvertopstraat 5333,2022-10-26,04:00:00,31,21,10,FMN 03 Kolonel Silvertopstraat
651,Kolonel Silvertopstraat 5333,2022-10-26,05:00:00,48,34,14,FMN 03 Kolonel Silvertopstraat
651,Kolonel Silvertopstraat 5333,2022-10-26,06:00:00,163,118,45,FMN 03 Kolonel Silvertopstraat
651,Kolonel Silvertopstraat 5333,2022-10-26,07:00:00,365,305,60,FMN 03 Kolonel Silvertopstraat
651,Kolonel Silvertopstraat 5333,2022-10-26,08:00:00,655,553,102,FMN 03 Kolonel Silvertopstraat
651,Kolonel Silvertopstraat 5333,2022-10-26,09:00:00,275,227,48,FMN 03 Kolonel Silvertopstraat
651,Kolonel Silvertopstraat 5333,2022-10-26,10:00:00,222,174,48,FMN 03 Kolonel Silvertopstraat
651,Kolonel Silvertopstraat 5333,2022-10-26,11:00:00,200,145,55,FMN 03 Kolonel Silvertopstraat
651,Kolonel Silvertopstraat 5333,2022-10-26,12:00:00,412,267,145,FMN 03 Kolonel Silvertopstraat
651,Kolonel Silvertopstraat 5333,2022-10-26,13:00:00,283,186,97,FMN 03 Kolonel Silvertopstraat
651,Kolonel Silvertopstraat 5333,2022-10-26,14:00:00,299,207,92,FMN 03 Kolonel Silvertopstraat
651,Kolonel Silvertopstraat 5333,2022-10-26,15:00:00,302,201,101,FMN 03 Kolonel Silvertopstraat
651,Kolonel Silvertopstraat 5333,2022-10-26,16:00:00,385,271,114,FMN 03 Kolonel Silvertopstraat
651,Kolonel Silvertopstraat 5333,2022-10-26,17:00:00,449,292,157,FMN 03 Kolonel Silvertopstraat
651,Kolonel Silvertopstraat 5333,2022-10-26,18:00:00,382,259,123,FMN 03 Kolonel Silvertopstraat
651,Kolonel Silvertopstraat 5333,2022-10-26,19:00:00,269,190,79,FMN 03 Kolonel Silvertopstraat
651,Kolonel Silvertopstraat 5333,2022-10-26,20:00:00,176,105,71,FMN 03 Kolonel Silvertopstraat
651,Kolonel Silvertopstraat 5333,2022-10-26,21:00:00,137,69,68,FMN 03 Kolonel Silvertopstraat
651,Kolonel Silvertopstraat 5333,2022-10-26,22:00:00,142,79,63,FMN 03 Kolonel Silvertopstraat
651,Kolonel Silvertopstraat 5333,2022-10-26,23:00:00,90,44,46,FMN 03 Kolonel Silvertopstraat
651,Kolonel Silvertopstraat 5333,2022-10-27,00:00:00,42,14,28,FMN 03 Kolonel Silvertopstraat
651,Kolonel Silvertopstraat 5333,2022-10-27,01:00:00,21,5,16,FMN 03 Kolonel Silvertopstraat
651,Kolonel Silvertopstraat 5333,2022-10-27,02:00:00,18,9,9,FMN 03 Kolonel Silvertopstraat
651,Kolonel Silvertopstraat 5333,2022-10-27,03:00:00,12,9,3,FMN 03 Kolonel Silvertopstraat
651,Kolonel Silvertopstraat 5333,2022-10-27,04:00:00,35,26,9,FMN 03 Kolonel Silvertopstraat
651,Kolonel Silvertopstraat 5333,2022-10-27,05:00:00,64,46,18,FMN 03 Kolonel Silvertopstraat
651,Kolonel Silvertopstraat 5333,2022-10-27,06:00:00,158,116,42,FMN 03 Kolonel Silvertopstraat
651,Kolonel Silvertopstraat 5333,2022-10-27,07:00:00,383,326,57,FMN 03 Kolonel Silvertopstraat
651,Kolonel Silvertopstraat 5333,2022-10-27,08:00:00,775,666,109,FMN 03 Kolonel Silvertopstraat
651,Kolonel Silvertopstraat 5333,2022-10-27,09:00:00,316,249,67,FMN 03 Kolonel Silvertopstraat
651,Kolonel Silvertopstraat 5333,2022-10-27,10:00:00,237,183,54,FMN 03 Kolonel Silvertopstraat
651,Kolonel Silvertopstraat 5333,2022-10-27,11:00:00,198,147,51,FMN 03 Kolonel Silvertopstraat
651,Kolonel Silvertopstraat 5333,2022-10-27,12:00:00,310,224,86,FMN 03 Kolonel Silvertopstraat
651,Kolonel Silvertopstraat 5333,2022-10-27,13:00:00,247,175,72,FMN 03 Kolonel Silvertopstraat
651,Kolonel Silvertopstraat 5333,2022-10-27,14:00:00,265,174,91,FMN 03 Kolonel Silvertopstraat
651,Kolonel Silvertopstraat 5333,2022-10-27,15:00:00,356,227,129,FMN 03 Kolonel Silvertopstraat
651,Kolonel Silvertopstraat 5333,2022-10-27,16:00:00,462,312,150,FMN 03 Kolonel Silvertopstraat
651,Kolonel Silvertopstraat 5333,2022-10-27,17:00:00,532,350,182,FMN 03 Kolonel Silvertopstraat
651,Kolonel Silvertopstraat 5333,2022-10-27,18:00:00,386,252,134,FMN 03 Kolonel Silvertopstraat
651,Kolonel Silvertopstraat 5333,2022-10-27,19:00:00,262,165,97,FMN 03 Kolonel Silvertopstraat
651,Kolonel Silvertopstraat 5333,2022-10-27,20:00:00,187,109,78,FMN 03 Kolonel Silvertopstraat
651,Kolonel Silvertopstraat 5333,2022-10-27,21:00:00,128,74,54,FMN 03 Kolonel Silvertopstraat
651,Kolonel Silvertopstraat 5333,2022-10-27,22:00:00,161,86,75,FMN 03 Kolonel Silvertopstraat
651,Kolonel Silvertopstraat 5333,2022-10-27,23:00:00,86,45,41,FMN 03 Kolonel Silvertopstraat
651,Kolonel Silvertopstraat 5333,2022-10-28,00:00:00,60,24,36,FMN 03 Kolonel Silvertopstraat
651,Kolonel Silvertopstraat 5333,2022-10-28,01:00:00,17,8,9,FMN 03 Kolonel Silvertopstraat
651,Kolonel Silvertopstraat 5333,2022-10-28,02:00:00,26,7,19,FMN 03 Kolonel Silvertopstraat
651,Kolonel Silvertopstraat 5333,2022-10-28,03:00:00,24,8,16,FMN 03 Kolonel Silvertopstraat
651,Kolonel Silvertopstraat 5333,2022-10-28,04:00:00,37,26,11,FMN 03 Kolonel Silvertopstraat
651,Kolonel Silvertopstraat 5333,2022-10-28,05:00:00,55,34,21,FMN 03 Kolonel Silvertopstraat
651,Kolonel Silvertopstraat 5333,2022-10-28,06:00:00,138,98,40,FMN 03 Kolonel Silvertopstraat
651,Kolonel Silvertopstraat 5333,2022-10-28,07:00:00,372,318,54,FMN 03 Kolonel Silvertopstraat
651,Kolonel Silvertopstraat 5333,2022-10-28,08:00:00,696,625,71,FMN 03 Kolonel Silvertopstraat
651,Kolonel Silvertopstraat 5333,2022-10-28,09:00:00,239,197,42,FMN 03 Kolonel Silvertopstraat
651,Kolonel Silvertopstraat 5333,2022-10-28,10:00:00,217,162,55,FMN 03 Kolonel Silvertopstraat
651,Kolonel Silvertopstraat 5333,2022-10-28,11:00:00,234,165,69,FMN 03 Kolonel Silvertopstraat
651,Kolonel Silvertopstraat 5333,2022-10-28,12:00:00,320,239,81,FMN 03 Kolonel Silvertopstraat
651,Kolonel Silvertopstraat 5333,2022-10-28,13:00:00,270,185,85,FMN 03 Kolonel Silvertopstraat
651,Kolonel Silvertopstraat 5333,2022-10-28,14:00:00,269,176,93,FMN 03 Kolonel Silvertopstraat
651,Kolonel Silvertopstraat 5333,2022-10-28,15:00:00,392,263,129,FMN 03 Kolonel Silvertopstraat
651,Kolonel Silvertopstraat 5333,2022-10-28,16:00:00,430,266,164,FMN 03 Kolonel Silvertopstraat
651,Kolonel Silvertopstraat 5333,2022-10-28,17:00:00,436,297,139,FMN 03 Kolonel Silvertopstraat
651,Kolonel Silvertopstraat 5333,2022-10-28,18:00:00,358,254,104,FMN 03 Kolonel Silvertopstraat
651,Kolonel Silvertopstraat 5333,2022-10-28,19:00:00,278,181,97,FMN 03 Kolonel Silvertopstraat
651,Kolonel Silvertopstraat 5333,2022-10-28,20:00:00,220,143,77,FMN 03 Kolonel Silvertopstraat
651,Kolonel Silvertopstraat 5333,2022-10-28,21:00:00,153,103,50,FMN 03 Kolonel Silvertopstraat
651,Kolonel Silvertopstraat 5333,2022-10-28,22:00:00,122,76,46,FMN 03 Kolonel Silvertopstraat
651,Kolonel Silvertopstraat 5333,2022-10-28,23:00:00,124,62,62,FMN 03 Kolonel Silvertopstraat
651,Kolonel Silvertopstraat 5333,2022-10-29,00:00:00,108,41,67,FMN 03 Kolonel Silvertopstraat
651,Kolonel Silvertopstraat 5333,2022-10-29,01:00:00,51,20,31,FMN 03 Kolonel Silvertopstraat
651,Kolonel Silvertopstraat 5333,2022-10-29,02:00:00,33,12,21,FMN 03 Kolonel Silvertopstraat
651,Kolonel Silvertopstraat 5333,2022-10-29,03:00:00,35,12,23,FMN 03 Kolonel Silvertopstraat
651,Kolonel Silvertopstraat 5333,2022-10-29,04:00:00,42,22,20,FMN 03 Kolonel Silvertopstraat
651,Kolonel Silvertopstraat 5333,2022-10-29,05:00:00,22,14,8,FMN 03 Kolonel Silvertopstraat
651,Kolonel Silvertopstraat 5333,2022-10-29,06:00:00,58,44,14,FMN 03 Kolonel Silvertopstraat
651,Kolonel Silvertopstraat 5333,2022-10-29,07:00:00,51,39,12,FMN 03 Kolonel Silvertopstraat
651,Kolonel Silvertopstraat 5333,2022-10-29,08:00:00,92,68,24,FMN 03 Kolonel Silvertopstraat
651,Kolonel Silvertopstraat 5333,2022-10-29,09:00:00,162,134,28,FMN 03 Kolonel Silvertopstraat
651,Kolonel Silvertopstraat 5333,2022-10-29,10:00:00,162,129,33,FMN 03 Kolonel Silvertopstraat
651,Kolonel Silvertopstraat 5333,2022-10-29,11:00:00,174,141,33,FMN 03 Kolonel Silvertopstraat
651,Kolonel Silvertopstraat 5333,2022-10-29,12:00:00,201,148,53,FMN 03 Kolonel Silvertopstraat
651,Kolonel Silvertopstraat 5333,2022-10-29,13:00:00,240,180,60,FMN 03 Kolonel Silvertopstraat
651,Kolonel Silvertopstraat 5333,2022-10-29,14:00:00,276,212,64,FMN 03 Kolonel Silvertopstraat
651,Kolonel Silvertopstraat 5333,2022-10-29,15:00:00,263,193,70,FMN 03 Kolonel Silvertopstraat
651,Kolonel Silvertopstraat 5333,2022-10-29,16:00:00,244,173,71,FMN 03 Kolonel Silvertopstraat
651,Kolonel Silvertopstraat 5333,2022-10-29,17:00:00,299,169,130,FMN 03 Kolonel Silvertopstraat
651,Kolonel Silvertopstraat 5333,2022-10-29,18:00:00,280,172,108,FMN 03 Kolonel Silvertopstraat
651,Kolonel Silvertopstraat 5333,2022-10-29,19:00:00,240,140,100,FMN 03 Kolonel Silvertopstraat
651,Kolonel Silvertopstraat 5333,2022-10-29,20:00:00,186,124,62,FMN 03 Kolonel Silvertopstraat
651,Kolonel Silvertopstraat 5333,2022-10-29,21:00:00,125,82,43,FMN 03 Kolonel Silvertopstraat
651,Kolonel Silvertopstraat 5333,2022-10-29,22:00:00,243,183,60,FMN 03 Kolonel Silvertopstraat
651,Kolonel Silvertopstraat 5333,2022-10-29,23:00:00,139,91,48,FMN 03 Kolonel Silvertopstraat
651,Kolonel Silvertopstraat 5333,2022-10-30,00:00:00,92,52,40,FMN 03 Kolonel Silvertopstraat
651,Kolonel Silvertopstraat 5333,2022-10-30,01:00:00,67,34,33,FMN 03 Kolonel Silvertopstraat
651,Kolonel Silvertopstraat 5333,2022-10-30,02:00:00,73,23,50,FMN 03 Kolonel Silvertopstraat
651,Kolonel Silvertopstraat 5333,2022-10-30,03:00:00,14,5,9,FMN 03 Kolonel Silvertopstraat
651,Kolonel Silvertopstraat 5333,2022-10-30,04:00:00,12,8,4,FMN 03 Kolonel Silvertopstraat
651,Kolonel Silvertopstraat 5333,2022-10-30,05:00:00,20,13,7,FMN 03 Kolonel Silvertopstraat
651,Kolonel Silvertopstraat 5333,2022-10-30,06:00:00,35,27,8,FMN 03 Kolonel Silvertopstraat
651,Kolonel Silvertopstraat 5333,2022-10-30,07:00:00,32,29,3,FMN 03 Kolonel Silvertopstraat
651,Kolonel Silvertopstraat 5333,2022-10-30,08:00:00,76,62,14,FMN 03 Kolonel Silvertopstraat
651,Kolonel Silvertopstraat 5333,2022-10-30,09:00:00,112,93,19,FMN 03 Kolonel Silvertopstraat
651,Kolonel Silvertopstraat 5333,2022-10-30,10:00:00,147,124,23,FMN 03 Kolonel Silvertopstraat
651,Kolonel Silvertopstraat 5333,2022-10-30,11:00:00,203,147,56,FMN 03 Kolonel Silvertopstraat
651,Kolonel Silvertopstraat 5333,2022-10-30,12:00:00,182,130,52,FMN 03 Kolonel Silvertopstraat
651,Kolonel Silvertopstraat 5333,2022-10-30,13:00:00,187,136,51,FMN 03 Kolonel Silvertopstraat
651,Kolonel Silvertopstraat 5333,2022-10-30,14:00:00,249,187,62,FMN 03 Kolonel Silvertopstraat
651,Kolonel Silvertopstraat 5333,2022-10-30,15:00:00,204,164,40,FMN 03 Kolonel Silvertopstraat
651,Kolonel Silvertopstraat 5333,2022-10-30,16:00:00,225,160,65,FMN 03 Kolonel Silvertopstraat
651,Kolonel Silvertopstraat 5333,2022-10-30,17:00:00,215,143,72,FMN 03 Kolonel Silvertopstraat
651,Kolonel Silvertopstraat 5333,2022-10-30,18:00:00,188,113,75,FMN 03 Kolonel Silvertopstraat
651,Kolonel Silvertopstraat 5333,2022-10-30,19:00:00,129,84,45,FMN 03 Kolonel Silvertopstraat
651,Kolonel Silvertopstraat 5333,2022-10-30,20:00:00,125,71,54,FMN 03 Kolonel Silvertopstraat
651,Kolonel Silvertopstraat 5333,2022-10-30,21:00:00,94,44,50,FMN 03 Kolonel Silvertopstraat
651,Kolonel Silvertopstraat 5333,2022-10-30,22:00:00,91,52,39,FMN 03 Kolonel Silvertopstraat
651,Kolonel Silvertopstraat 5333,2022-10-30,23:00:00,60,31,29,FMN 03 Kolonel Silvertopstraat
651,Kolonel Silvertopstraat 5333,2022-10-31,00:00:00,32,18,14,FMN 03 Kolonel Silvertopstraat
651,Kolonel Silvertopstraat 5333,2022-10-31,01:00:00,14,7,7,FMN 03 Kolonel Silvertopstraat
651,Kolonel Silvertopstraat 5333,2022-10-31,02:00:00,18,5,13,FMN 03 Kolonel Silvertopstraat
651,Kolonel Silvertopstraat 5333,2022-10-31,03:00:00,11,7,4,FMN 03 Kolonel Silvertopstraat
651,Kolonel Silvertopstraat 5333,2022-10-31,04:00:00,17,11,6,FMN 03 Kolonel Silvertopstraat
651,Kolonel Silvertopstraat 5333,2022-10-31,05:00:00,40,24,16,FMN 03 Kolonel Silvertopstraat
651,Kolonel Silvertopstraat 5333,2022-10-31,06:00:00,83,59,24,FMN 03 Kolonel Silvertopstraat
651,Kolonel Silvertopstraat 5333,2022-10-31,07:00:00,118,99,19,FMN 03 Kolonel Silvertopstraat
651,Kolonel Silvertopstraat 5333,2022-10-31,08:00:00,168,137,31,FMN 03 Kolonel Silvertopstraat
651,Kolonel Silvertopstraat 5333,2022-10-31,09:00:00,130,101,29,FMN 03 Kolonel Silvertopstraat
651,Kolonel Silvertopstraat 5333,2022-10-31,10:00:00,124,87,37,FMN 03 Kolonel Silvertopstraat
651,Kolonel Silvertopstraat 5333,2022-10-31,11:00:00,137,103,34,FMN 03 Kolonel Silvertopstraat
651,Kolonel Silvertopstraat 5333,2022-10-31,12:00:00,129,93,36,FMN 03 Kolonel Silvertopstraat
651,Kolonel Silvertopstraat 5333,2022-10-31,13:00:00,198,130,68,FMN 03 Kolonel Silvertopstraat
651,Kolonel Silvertopstraat 5333,2022-10-31,14:00:00,220,167,53,FMN 03 Kolonel Silvertopstraat
651,Kolonel Silvertopstraat 5333,2022-10-31,15:00:00,211,151,60,FMN 03 Kolonel Silvertopstraat
651,Kolonel Silvertopstraat 5333,2022-10-31,16:00:00,260,185,75,FMN 03 Kolonel Silvertopstraat
651,Kolonel Silvertopstraat 5333,2022-10-31,17:00:00,314,203,111,FMN 03 Kolonel Silvertopstraat
651,Kolonel Silvertopstraat 5333,2022-10-31,18:00:00,239,159,80,FMN 03 Kolonel Silvertopstraat
651,Kolonel Silvertopstraat 5333,2022-10-31,19:00:00,211,143,68,FMN 03 Kolonel Silvertopstraat
651,Kolonel Silvertopstraat 5333,2022-10-31,20:00:00,163,100,63,FMN 03 Kolonel Silvertopstraat
651,Kolonel Silvertopstraat 5333,2022-10-31,21:00:00,123,74,49,FMN 03 Kolonel Silvertopstraat
651,Kolonel Silvertopstraat 5333,2022-10-31,22:00:00,76,47,29,FMN 03 Kolonel Silvertopstraat
651,Kolonel Silvertopstraat 5333,2022-10-31,23:00:00,84,46,38,FMN 03 Kolonel Silvertopstraat
651,Kolonel Silvertopstraat 5333,2022-11-01,00:00:00,60,32,28,FMN 03 Kolonel Silvertopstraat
651,Kolonel Silvertopstraat 5333,2022-11-01,01:00:00,36,19,17,FMN 03 Kolonel Silvertopstraat
651,Kolonel Silvertopstraat 5333,2022-11-01,02:00:00,35,10,25,FMN 03 Kolonel Silvertopstraat
651,Kolonel Silvertopstraat 5333,2022-11-01,03:00:00,32,20,12,FMN 03 Kolonel Silvertopstraat
651,Kolonel Silvertopstraat 5333,2022-11-01,04:00:00,37,26,11,FMN 03 Kolonel Silvertopstraat
651,Kolonel Silvertopstraat 5333,2022-11-01,05:00:00,28,15,13,FMN 03 Kolonel Silvertopstraat
651,Kolonel Silvertopstraat 5333,2022-11-01,06:00:00,49,30,19,FMN 03 Kolonel Silvertopstraat
651,Kolonel Silvertopstraat 5333,2022-11-01,07:00:00,29,20,9,FMN 03 Kolonel Silvertopstraat
651,Kolonel Silvertopstraat 5333,2022-11-01,08:00:00,80,57,23,FMN 03 Kolonel Silvertopstraat
651,Kolonel Silvertopstraat 5333,2022-11-01,09:00:00,106,81,25,FMN 03 Kolonel Silvertopstraat
651,Kolonel Silvertopstraat 5333,2022-11-01,10:00:00,153,119,34,FMN 03 Kolonel Silvertopstraat
651,Kolonel Silvertopstraat 5333,2022-11-01,11:00:00,157,124,33,FMN 03 Kolonel Silvertopstraat
651,Kolonel Silvertopstraat 5333,2022-11-01,12:00:00,166,125,41,FMN 03 Kolonel Silvertopstraat
651,Kolonel Silvertopstraat 5333,2022-11-01,13:00:00,189,135,54,FMN 03 Kolonel Silvertopstraat
651,Kolonel Silvertopstraat 5333,2022-11-01,14:00:00,227,159,68,FMN 03 Kolonel Silvertopstraat
651,Kolonel Silvertopstraat 5333,2022-11-01,15:00:00,221,158,63,FMN 03 Kolonel Silvertopstraat
651,Kolonel Silvertopstraat 5333,2022-11-01,16:00:00,243,155,88,FMN 03 Kolonel Silvertopstraat
651,Kolonel Silvertopstraat 5333,2022-11-01,17:00:00,210,122,88,FMN 03 Kolonel Silvertopstraat
651,Kolonel Silvertopstraat 5333,2022-11-01,18:00:00,171,106,65,FMN 03 Kolonel Silvertopstraat
651,Kolonel Silvertopstraat 5333,2022-11-01,19:00:00,132,87,45,FMN 03 Kolonel Silvertopstraat
651,Kolonel Silvertopstraat 5333,2022-11-01,20:00:00,76,44,32,FMN 03 Kolonel Silvertopstraat
651,Kolonel Silvertopstraat 5333,2022-11-01,21:00:00,64,35,29,FMN 03 Kolonel Silvertopstraat
651,Kolonel Silvertopstraat 5333,2022-11-01,22:00:00,75,40,35,FMN 03 Kolonel Silvertopstraat
651,Kolonel Silvertopstraat 5333,2022-11-01,23:00:00,40,20,20,FMN 03 Kolonel Silvertopstraat
651,Kolonel Silvertopstraat 5333,2022-11-02,00:00:00,21,8,13,FMN 03 Kolonel Silvertopstraat
651,Kolonel Silvertopstraat 5333,2022-11-02,01:00:00,15,9,6,FMN 03 Kolonel Silvertopstraat
651,Kolonel Silvertopstraat 5333,2022-11-02,02:00:00,7,3,4,FMN 03 Kolonel Silvertopstraat
651,Kolonel Silvertopstraat 5333,2022-11-02,03:00:00,10,5,5,FMN 03 Kolonel Silvertopstraat
651,Kolonel Silvertopstraat 5333,2022-11-02,04:00:00,34,20,14,FMN 03 Kolonel Silvertopstraat
651,Kolonel Silvertopstraat 5333,2022-11-02,05:00:00,47,30,17,FMN 03 Kolonel Silvertopstraat
651,Kolonel Silvertopstraat 5333,2022-11-02,06:00:00,128,92,36,FMN 03 Kolonel Silvertopstraat
651,Kolonel Silvertopstraat 5333,2022-11-02,07:00:00,198,155,43,FMN 03 Kolonel Silvertopstraat
651,Kolonel Silvertopstraat 5333,2022-11-02,08:00:00,268,225,43,FMN 03 Kolonel Silvertopstraat
651,Kolonel Silvertopstraat 5333,2022-11-02,09:00:00,211,160,51,FMN 03 Kolonel Silvertopstraat
651,Kolonel Silvertopstraat 5333,2022-11-02,10:00:00,180,138,42,FMN 03 Kolonel Silvertopstraat
651,Kolonel Silvertopstraat 5333,2022-11-02,11:00:00,155,116,39,FMN 03 Kolonel Silvertopstraat
651,Kolonel Silvertopstraat 5333,2022-11-02,12:00:00,188,132,56,FMN 03 Kolonel Silvertopstraat
651,Kolonel Silvertopstraat 5333,2022-11-02,13:00:00,206,152,54,FMN 03 Kolonel Silvertopstraat
651,Kolonel Silvertopstraat 5333,2022-11-02,14:00:00,236,176,60,FMN 03 Kolonel Silvertopstraat
651,Kolonel Silvertopstraat 5333,2022-11-02,15:00:00,254,169,85,FMN 03 Kolonel Silvertopstraat
651,Kolonel Silvertopstraat 5333,2022-11-02,16:00:00,297,213,84,FMN 03 Kolonel Silvertopstraat
651,Kolonel Silvertopstraat 5333,2022-11-02,17:00:00,362,233,129,FMN 03 Kolonel Silvertopstraat
651,Kolonel Silvertopstraat 5333,2022-11-02,18:00:00,276,181,95,FMN 03 Kolonel Silvertopstraat
651,Kolonel Silvertopstraat 5333,2022-11-02,19:00:00,186,119,67,FMN 03 Kolonel Silvertopstraat
651,Kolonel Silvertopstraat 5333,2022-11-02,20:00:00,134,71,63,FMN 03 Kolonel Silvertopstraat
651,Kolonel Silvertopstraat 5333,2022-11-02,21:00:00,80,44,36,FMN 03 Kolonel Silvertopstraat
651,Kolonel Silvertopstraat 5333,2022-11-02,22:00:00,99,51,48,FMN 03 Kolonel Silvertopstraat
651,Kolonel Silvertopstraat 5333,2022-11-02,23:00:00,62,32,30,FMN 03 Kolonel Silvertopstraat
651,Kolonel Silvertopstraat 5333,2022-11-03,00:00:00,41,20,21,FMN 03 Kolonel Silvertopstraat
651,Kolonel Silvertopstraat 5333,2022-11-03,01:00:00,27,8,19,FMN 03 Kolonel Silvertopstraat
651,Kolonel Silvertopstraat 5333,2022-11-03,02:00:00,9,6,3,FMN 03 Kolonel Silvertopstraat
651,Kolonel Silvertopstraat 5333,2022-11-03,03:00:00,7,4,3,FMN 03 Kolonel Silvertopstraat
651,Kolonel Silvertopstraat 5333,2022-11-03,04:00:00,28,15,13,FMN 03 Kolonel Silvertopstraat
651,Kolonel Silvertopstraat 5333,2022-11-03,05:00:00,44,29,15,FMN 03 Kolonel Silvertopstraat
651,Kolonel Silvertopstraat 5333,2022-11-03,06:00:00,124,96,28,FMN 03 Kolonel Silvertopstraat
651,Kolonel Silvertopstraat 5333,2022-11-03,07:00:00,199,157,42,FMN 03 Kolonel Silvertopstraat
651,Kolonel Silvertopstraat 5333,2022-11-03,08:00:00,332,268,64,FMN 03 Kolonel Silvertopstraat
651,Kolonel Silvertopstraat 5333,2022-11-03,09:00:00,205,154,51,FMN 03 Kolonel Silvertopstraat
651,Kolonel Silvertopstraat 5333,2022-11-03,10:00:00,148,122,26,FMN 03 Kolonel Silvertopstraat
651,Kolonel Silvertopstraat 5333,2022-11-03,11:00:00,166,124,42,FMN 03 Kolonel Silvertopstraat
651,Kolonel Silvertopstraat 5333,2022-11-03,12:00:00,175,130,45,FMN 03 Kolonel Silvertopstraat
651,Kolonel Silvertopstraat 5333,2022-11-03,13:00:00,200,132,68,FMN 03 Kolonel Silvertopstraat
651,Kolonel Silvertopstraat 5333,2022-11-03,14:00:00,184,124,60,FMN 03 Kolonel Silvertopstraat
651,Kolonel Silvertopstraat 5333,2022-11-03,15:00:00,231,148,83,FMN 03 Kolonel Silvertopstraat
651,Kolonel Silvertopstraat 5333,2022-11-03,16:00:00,254,180,74,FMN 03 Kolonel Silvertopstraat
651,Kolonel Silvertopstraat 5333,2022-11-03,17:00:00,260,161,99,FMN 03 Kolonel Silvertopstraat
651,Kolonel Silvertopstraat 5333,2022-11-03,18:00:00,222,134,88,FMN 03 Kolonel Silvertopstraat
651,Kolonel Silvertopstraat 5333,2022-11-03,19:00:00,128,90,38,FMN 03 Kolonel Silvertopstraat
651,Kolonel Silvertopstraat 5333,2022-11-03,20:00:00,114,74,40,FMN 03 Kolonel Silvertopstraat
651,Kolonel Silvertopstraat 5333,2022-11-03,21:00:00,70,33,37,FMN 03 Kolonel Silvertopstraat
651,Kolonel Silvertopstraat 5333,2022-11-03,22:00:00,66,30,36,FMN 03 Kolonel Silvertopstraat
651,Kolonel Silvertopstraat 5333,2022-11-03,23:00:00,51,25,26,FMN 03 Kolonel Silvertopstraat
651,Kolonel Silvertopstraat 5333,2022-11-04,00:00:00,29,10,19,FMN 03 Kolonel Silvertopstraat
651,Kolonel Silvertopstraat 5333,2022-11-04,01:00:00,12,1,11,FMN 03 Kolonel Silvertopstraat
651,Kolonel Silvertopstraat 5333,2022-11-04,02:00:00,14,8,6,FMN 03 Kolonel Silvertopstraat
651,Kolonel Silvertopstraat 5333,2022-11-04,03:00:00,14,5,9,FMN 03 Kolonel Silvertopstraat
651,Kolonel Silvertopstraat 5333,2022-11-04,04:00:00,25,17,8,FMN 03 Kolonel Silvertopstraat
651,Kolonel Silvertopstraat 5333,2022-11-04,05:00:00,41,25,16,FMN 03 Kolonel Silvertopstraat
651,Kolonel Silvertopstraat 5333,2022-11-04,06:00:00,117,84,33,FMN 03 Kolonel Silvertopstraat
651,Kolonel Silvertopstraat 5333,2022-11-04,07:00:00,145,118,27,FMN 03 Kolonel Silvertopstraat
651,Kolonel Silvertopstraat 5333,2022-11-04,08:00:00,247,195,52,FMN 03 Kolonel Silvertopstraat
651,Kolonel Silvertopstraat 5333,2022-11-04,09:00:00,178,144,34,FMN 03 Kolonel Silvertopstraat
651,Kolonel Silvertopstraat 5333,2022-11-04,10:00:00,133,103,30,FMN 03 Kolonel Silvertopstraat
651,Kolonel Silvertopstraat 5333,2022-11-04,11:00:00,124,94,30,FMN 03 Kolonel Silvertopstraat
651,Kolonel Silvertopstraat 5333,2022-11-04,12:00:00,163,110,53,FMN 03 Kolonel Silvertopstraat
651,Kolonel Silvertopstraat 5333,2022-11-04,13:00:00,203,138,65,FMN 03 Kolonel Silvertopstraat
651,Kolonel Silvertopstraat 5333,2022-11-04,14:00:00,201,129,72,FMN 03 Kolonel Silvertopstraat
651,Kolonel Silvertopstraat 5333,2022-11-04,15:00:00,241,162,79,FMN 03 Kolonel Silvertopstraat
651,Kolonel Silvertopstraat 5333,2022-11-04,16:00:00,266,190,76,FMN 03 Kolonel Silvertopstraat
651,Kolonel Silvertopstraat 5333,2022-11-04,17:00:00,305,190,115,FMN 03 Kolonel Silvertopstraat
651,Kolonel Silvertopstraat 5333,2022-11-04,18:00:00,270,189,81,FMN 03 Kolonel Silvertopstraat
651,Kolonel Silvertopstraat 5333,2022-11-04,19:00:00,206,148,58,FMN 03 Kolonel Silvertopstraat
651,Kolonel Silvertopstraat 5333,2022-11-04,20:00:00,151,104,47,FMN 03 Kolonel Silvertopstraat
651,Kolonel Silvertopstraat 5333,2022-11-04,21:00:00,122,73,49,FMN 03 Kolonel Silvertopstraat
651,Kolonel Silvertopstraat 5333,2022-11-04,22:00:00,102,50,52,FMN 03 Kolonel Silvertopstraat
651,Kolonel Silvertopstraat 5333,2022-11-04,23:00:00,99,40,59,FMN 03 Kolonel Silvertopstraat
651,Kolonel Silvertopstraat 5333,2022-11-05,00:00:00,78,36,42,FMN 03 Kolonel Silvertopstraat
651,Kolonel Silvertopstraat 5333,2022-11-05,01:00:00,36,15,21,FMN 03 Kolonel Silvertopstraat
651,Kolonel Silvertopstraat 5333,2022-11-05,02:00:00,39,16,23,FMN 03 Kolonel Silvertopstraat
651,Kolonel Silvertopstraat 5333,2022-11-05,03:00:00,21,9,12,FMN 03 Kolonel Silvertopstraat
651,Kolonel Silvertopstraat 5333,2022-11-05,04:00:00,18,9,9,FMN 03 Kolonel Silvertopstraat
651,Kolonel Silvertopstraat 5333,2022-11-05,05:00:00,30,14,16,FMN 03 Kolonel Silvertopstraat
651,Kolonel Silvertopstraat 5333,2022-11-05,06:00:00,41,32,9,FMN 03 Kolonel Silvertopstraat
651,Kolonel Silvertopstraat 5333,2022-11-05,07:00:00,34,29,5,FMN 03 Kolonel Silvertopstraat
651,Kolonel Silvertopstraat 5333,2022-11-05,08:00:00,83,61,22,FMN 03 Kolonel Silvertopstraat
651,Kolonel Silvertopstraat 5333,2022-11-05,09:00:00,148,131,17,FMN 03 Kolonel Silvertopstraat
651,Kolonel Silvertopstraat 5333,2022-11-05,10:00:00,174,141,33,FMN 03 Kolonel Silvertopstraat
651,Kolonel Silvertopstraat 5333,2022-11-05,11:00:00,209,145,64,FMN 03 Kolonel Silvertopstraat
651,Kolonel Silvertopstraat 5333,2022-11-05,12:00:00,178,127,51,FMN 03 Kolonel Silvertopstraat
651,Kolonel Silvertopstraat 5333,2022-11-05,13:00:00,209,152,57,FMN 03 Kolonel Silvertopstraat
651,Kolonel Silvertopstraat 5333,2022-11-05,14:00:00,219,155,64,FMN 03 Kolonel Silvertopstraat
651,Kolonel Silvertopstraat 5333,2022-11-05,15:00:00,190,128,62,FMN 03 Kolonel Silvertopstraat
651,Kolonel Silvertopstraat 5333,2022-11-05,16:00:00,206,140,66,FMN 03 Kolonel Silvertopstraat
651,Kolonel Silvertopstraat 5333,2022-11-05,17:00:00,198,118,80,FMN 03 Kolonel Silvertopstraat
651,Kolonel Silvertopstraat 5333,2022-11-05,18:00:00,200,130,70,FMN 03 Kolonel Silvertopstraat
651,Kolonel Silvertopstraat 5333,2022-11-05,19:00:00,159,105,54,FMN 03 Kolonel Silvertopstraat
651,Kolonel Silvertopstraat 5333,2022-11-05,20:00:00,125,76,49,FMN 03 Kolonel Silvertopstraat
651,Kolonel Silvertopstraat 5333,2022-11-05,21:00:00,122,72,50,FMN 03 Kolonel Silvertopstraat
651,Kolonel Silvertopstraat 5333,2022-11-05,22:00:00,91,52,39,FMN 03 Kolonel Silvertopstraat
651,Kolonel Silvertopstraat 5333,2022-11-05,23:00:00,89,39,50,FMN 03 Kolonel Silvertopstraat
651,Kolonel Silvertopstraat 5333,2022-11-06,00:00:00,54,21,33,FMN 03 Kolonel Silvertopstraat
651,Kolonel Silvertopstraat 5333,2022-11-06,01:00:00,34,17,17,FMN 03 Kolonel Silvertopstraat
651,Kolonel Silvertopstraat 5333,2022-11-06,02:00:00,28,12,16,FMN 03 Kolonel Silvertopstraat
651,Kolonel Silvertopstraat 5333,2022-11-06,03:00:00,18,7,11,FMN 03 Kolonel Silvertopstraat
651,Kolonel Silvertopstraat 5333,2022-11-06,04:00:00,21,12,9,FMN 03 Kolonel Silvertopstraat
651,Kolonel Silvertopstraat 5333,2022-11-06,05:00:00,18,12,6,FMN 03 Kolonel Silvertopstraat
651,Kolonel Silvertopstraat 5333,2022-11-06,06:00:00,23,17,6,FMN 03 Kolonel Silvertopstraat
651,Kolonel Silvertopstraat 5333,2022-11-06,07:00:00,26,20,6,FMN 03 Kolonel Silvertopstraat
651,Kolonel Silvertopstraat 5333,2022-11-06,08:00:00,53,32,21,FMN 03 Kolonel Silvertopstraat
651,Kolonel Silvertopstraat 5333,2022-11-06,09:00:00,66,52,14,FMN 03 Kolonel Silvertopstraat
651,Kolonel Silvertopstraat 5333,2022-11-06,10:00:00,132,108,24,FMN 03 Kolonel Silvertopstraat
651,Kolonel Silvertopstraat 5333,2022-11-06,11:00:00,128,92,36,FMN 03 Kolonel Silvertopstraat
651,Kolonel Silvertopstraat 5333,2022-11-06,12:00:00,97,72,25,FMN 03 Kolonel Silvertopstraat
651,Kolonel Silvertopstraat 5333,2022-11-06,13:00:00,123,86,37,FMN 03 Kolonel Silvertopstraat
651,Kolonel Silvertopstraat 5333,2022-11-06,14:00:00,88,62,26,FMN 03 Kolonel Silvertopstraat
651,Kolonel Silvertopstraat 5333,2022-11-06,15:00:00,74,42,32,FMN 03 Kolonel Silvertopstraat
651,Kolonel Silvertopstraat 5333,2022-11-06,16:00:00,92,55,37,FMN 03 Kolonel Silvertopstraat
651,Kolonel Silvertopstraat 5333,2022-11-06,17:00:00,116,72,44,FMN 03 Kolonel Silvertopstraat
651,Kolonel Silvertopstraat 5333,2022-11-06,18:00:00,126,75,51,FMN 03 Kolonel Silvertopstraat
651,Kolonel Silvertopstraat 5333,2022-11-06,19:00:00,113,76,37,FMN 03 Kolonel Silvertopstraat
651,Kolonel Silvertopstraat 5333,2022-11-06,20:00:00,84,39,45,FMN 03 Kolonel Silvertopstraat
651,Kolonel Silvertopstraat 5333,2022-11-06,21:00:00,67,38,29,FMN 03 Kolonel Silvertopstraat
651,Kolonel Silvertopstraat 5333,2022-11-06,22:00:00,41,23,18,FMN 03 Kolonel Silvertopstraat
651,Kolonel Silvertopstraat 5333,2022-11-06,23:00:00,34,14,20,FMN 03 Kolonel Silvertopstraat
651,Kolonel Silvertopstraat 5333,2022-11-07,00:00:00,26,12,14,FMN 03 Kolonel Silvertopstraat
651,Kolonel Silvertopstraat 5333,2022-11-07,01:00:00,15,6,9,FMN 03 Kolonel Silvertopstraat
651,Kolonel Silvertopstraat 5333,2022-11-07,02:00:00,6,2,4,FMN 03 Kolonel Silvertopstraat
651,Kolonel Silvertopstraat 5333,2022-11-07,03:00:00,6,4,2,FMN 03 Kolonel Silvertopstraat
651,Kolonel Silvertopstraat 5333,2022-11-07,04:00:00,20,14,6,FMN 03 Kolonel Silvertopstraat
651,Kolonel Silvertopstraat 5333,2022-11-07,05:00:00,51,31,20,FMN 03 Kolonel Silvertopstraat
651,Kolonel Silvertopstraat 5333,2022-11-07,06:00:00,135,109,26,FMN 03 Kolonel Silvertopstraat
651,Kolonel Silvertopstraat 5333,2022-11-07,07:00:00,312,262,50,FMN 03 Kolonel Silvertopstraat
651,Kolonel Silvertopstraat 5333,2022-11-07,08:00:00,662,550,112,FMN 03 Kolonel Silvertopstraat
651,Kolonel Silvertopstraat 5333,2022-11-07,09:00:00,224,165,59,FMN 03 Kolonel Silvertopstraat
651,Kolonel Silvertopstraat 5333,2022-11-07,10:00:00,164,132,32,FMN 03 Kolonel Silvertopstraat
651,Kolonel Silvertopstraat 5333,2022-11-07,11:00:00,124,102,22,FMN 03 Kolonel Silvertopstraat
651,Kolonel Silvertopstraat 5333,2022-11-07,12:00:00,203,132,71,FMN 03 Kolonel Silvertopstraat
651,Kolonel Silvertopstraat 5333,2022-11-07,13:00:00,205,134,71,FMN 03 Kolonel Silvertopstraat
651,Kolonel Silvertopstraat 5333,2022-11-07,14:00:00,212,144,68,FMN 03 Kolonel Silvertopstraat
651,Kolonel Silvertopstraat 5333,2022-11-07,15:00:00,290,193,97,FMN 03 Kolonel Silvertopstraat
651,Kolonel Silvertopstraat 5333,2022-11-07,16:00:00,382,263,119,FMN 03 Kolonel Silvertopstraat
651,Kolonel Silvertopstraat 5333,2022-11-07,17:00:00,402,249,153,FMN 03 Kolonel Silvertopstraat
651,Kolonel Silvertopstraat 5333,2022-11-07,18:00:00,267,169,98,FMN 03 Kolonel Silvertopstraat
651,Kolonel Silvertopstraat 5333,2022-11-07,19:00:00,197,122,75,FMN 03 Kolonel Silvertopstraat
651,Kolonel Silvertopstraat 5333,2022-11-07,20:00:00,165,86,79,FMN 03 Kolonel Silvertopstraat
651,Kolonel Silvertopstraat 5333,2022-11-07,21:00:00,120,73,47,FMN 03 Kolonel Silvertopstraat
651,Kolonel Silvertopstraat 5333,2022-11-07,22:00:00,110,69,41,FMN 03 Kolonel Silvertopstraat
651,Kolonel Silvertopstraat 5333,2022-11-07,23:00:00,66,26,40,FMN 03 Kolonel Silvertopstraat
651,Kolonel Silvertopstraat 5333,2022-11-08,00:00:00,36,14,22,FMN 03 Kolonel Silvertopstraat
651,Kolonel Silvertopstraat 5333,2022-11-08,01:00:00,14,8,6,FMN 03 Kolonel Silvertopstraat
651,Kolonel Silvertopstraat 5333,2022-11-08,02:00:00,11,6,5,FMN 03 Kolonel Silvertopstraat
651,Kolonel Silvertopstraat 5333,2022-11-08,03:00:00,8,2,6,FMN 03 Kolonel Silvertopstraat
651,Kolonel Silvertopstraat 5333,2022-11-08,04:00:00,23,18,5,FMN 03 Kolonel Silvertopstraat
651,Kolonel Silvertopstraat 5333,2022-11-08,05:00:00,66,46,20,FMN 03 Kolonel Silvertopstraat
651,Kolonel Silvertopstraat 5333,2022-11-08,06:00:00,149,124,25,FMN 03 Kolonel Silvertopstraat
651,Kolonel Silvertopstraat 5333,2022-11-08,07:00:00,408,333,75,FMN 03 Kolonel Silvertopstraat
651,Kolonel Silvertopstraat 5333,2022-11-08,08:00:00,737,631,106,FMN 03 Kolonel Silvertopstraat
651,Kolonel Silvertopstraat 5333,2022-11-08,09:00:00,266,207,59,FMN 03 Kolonel Silvertopstraat
651,Kolonel Silvertopstraat 5333,2022-11-08,10:00:00,176,143,33,FMN 03 Kolonel Silvertopstraat
651,Kolonel Silvertopstraat 5333,2022-11-08,11:00:00,148,109,39,FMN 03 Kolonel Silvertopstraat
651,Kolonel Silvertopstraat 5333,2022-11-08,12:00:00,261,183,78,FMN 03 Kolonel Silvertopstraat
651,Kolonel Silvertopstraat 5333,2022-11-08,13:00:00,238,169,69,FMN 03 Kolonel Silvertopstraat
651,Kolonel Silvertopstraat 5333,2022-11-08,14:00:00,238,170,68,FMN 03 Kolonel Silvertopstraat
651,Kolonel Silvertopstraat 5333,2022-11-08,15:00:00,339,198,141,FMN 03 Kolonel Silvertopstraat
651,Kolonel Silvertopstraat 5333,2022-11-08,16:00:00,472,306,166,FMN 03 Kolonel Silvertopstraat
651,Kolonel Silvertopstraat 5333,2022-11-08,17:00:00,456,293,163,FMN 03 Kolonel Silvertopstraat
651,Kolonel Silvertopstraat 5333,2022-11-08,18:00:00,357,213,144,FMN 03 Kolonel Silvertopstraat
651,Kolonel Silvertopstraat 5333,2022-11-08,19:00:00,204,128,76,FMN 03 Kolonel Silvertopstraat
651,Kolonel Silvertopstraat 5333,2022-11-08,20:00:00,168,99,69,FMN 03 Kolonel Silvertopstraat
651,Kolonel Silvertopstraat 5333,2022-11-08,21:00:00,135,70,65,FMN 03 Kolonel Silvertopstraat
651,Kolonel Silvertopstraat 5333,2022-11-08,22:00:00,102,56,46,FMN 03 Kolonel Silvertopstraat
651,Kolonel Silvertopstraat 5333,2022-11-08,23:00:00,64,30,34,FMN 03 Kolonel Silvertopstraat
651,Kolonel Silvertopstraat 5333,2022-11-09,00:00:00,37,15,22,FMN 03 Kolonel Silvertopstraat
651,Kolonel Silvertopstraat 5333,2022-11-09,01:00:00,13,3,10,FMN 03 Kolonel Silvertopstraat
651,Kolonel Silvertopstraat 5333,2022-11-09,02:00:00,11,5,6,FMN 03 Kolonel Silvertopstraat
651,Kolonel Silvertopstraat 5333,2022-11-09,03:00:00,4,3,1,FMN 03 Kolonel Silvertopstraat
651,Kolonel Silvertopstraat 5333,2022-11-09,04:00:00,23,17,6,FMN 03 Kolonel Silvertopstraat
651,Kolonel Silvertopstraat 5333,2022-11-09,05:00:00,49,39,10,FMN 03 Kolonel Silvertopstraat
651,Kolonel Silvertopstraat 5333,2022-11-09,06:00:00,128,97,31,FMN 03 Kolonel Silvertopstraat
651,Kolonel Silvertopstraat 5333,2022-11-09,07:00:00,443,369,74,FMN 03 Kolonel Silvertopstraat
651,Kolonel Silvertopstraat 5333,2022-11-09,08:00:00,649,561,88,FMN 03 Kolonel Silvertopstraat
651,Kolonel Silvertopstraat 5333,2022-11-09,09:00:00,281,232,49,FMN 03 Kolonel Silvertopstraat
651,Kolonel Silvertopstraat 5333,2022-11-09,10:00:00,220,170,50,FMN 03 Kolonel Silvertopstraat
651,Kolonel Silvertopstraat 5333,2022-11-09,11:00:00,193,149,44,FMN 03 Kolonel Silvertopstraat
651,Kolonel Silvertopstraat 5333,2022-11-09,12:00:00,381,222,159,FMN 03 Kolonel Silvertopstraat
651,Kolonel Silvertopstraat 5333,2022-11-09,13:00:00,269,175,94,FMN 03 Kolonel Silvertopstraat
651,Kolonel Silvertopstraat 5333,2022-11-09,14:00:00,222,154,68,FMN 03 Kolonel Silvertopstraat
651,Kolonel Silvertopstraat 5333,2022-11-09,15:00:00,293,206,87,FMN 03 Kolonel Silvertopstraat
651,Kolonel Silvertopstraat 5333,2022-11-09,16:00:00,385,264,121,FMN 03 Kolonel Silvertopstraat
651,Kolonel Silvertopstraat 5333,2022-11-09,17:00:00,411,277,134,FMN 03 Kolonel Silvertopstraat
651,Kolonel Silvertopstraat 5333,2022-11-09,18:00:00,322,207,115,FMN 03 Kolonel Silvertopstraat
651,Kolonel Silvertopstraat 5333,2022-11-09,19:00:00,213,135,78,FMN 03 Kolonel Silvertopstraat
651,Kolonel Silvertopstraat 5333,2022-11-09,20:00:00,162,104,58,FMN 03 Kolonel Silvertopstraat
651,Kolonel Silvertopstraat 5333,2022-11-09,21:00:00,127,74,53,FMN 03 Kolonel Silvertopstraat
651,Kolonel Silvertopstraat 5333,2022-11-09,22:00:00,107,47,60,FMN 03 Kolonel Silvertopstraat
651,Kolonel Silvertopstraat 5333,2022-11-09,23:00:00,75,34,41,FMN 03 Kolonel Silvertopstraat
651,Kolonel Silvertopstraat 5333,2022-11-10,00:00:00,46,27,19,FMN 03 Kolonel Silvertopstraat
651,Kolonel Silvertopstraat 5333,2022-11-10,01:00:00,10,7,3,FMN 03 Kolonel Silvertopstraat
651,Kolonel Silvertopstraat 5333,2022-11-10,02:00:00,13,6,7,FMN 03 Kolonel Silvertopstraat
651,Kolonel Silvertopstraat 5333,2022-11-10,03:00:00,8,4,4,FMN 03 Kolonel Silvertopstraat
651,Kolonel Silvertopstraat 5333,2022-11-10,04:00:00,25,15,10,FMN 03 Kolonel Silvertopstraat
651,Kolonel Silvertopstraat 5333,2022-11-10,05:00:00,56,34,22,FMN 03 Kolonel Silvertopstraat
651,Kolonel Silvertopstraat 5333,2022-11-10,06:00:00,131,109,22,FMN 03 Kolonel Silvertopstraat
651,Kolonel Silvertopstraat 5333,2022-11-10,07:00:00,385,321,64,FMN 03 Kolonel Silvertopstraat
651,Kolonel Silvertopstraat 5333,2022-11-10,08:00:00,726,631,95,FMN 03 Kolonel Silvertopstraat
651,Kolonel Silvertopstraat 5333,2022-11-10,09:00:00,285,232,53,FMN 03 Kolonel Silvertopstraat
651,Kolonel Silvertopstraat 5333,2022-11-10,10:00:00,199,159,40,FMN 03 Kolonel Silvertopstraat
651,Kolonel Silvertopstraat 5333,2022-11-10,11:00:00,166,114,52,FMN 03 Kolonel Silvertopstraat
651,Kolonel Silvertopstraat 5333,2022-11-10,12:00:00,272,189,83,FMN 03 Kolonel Silvertopstraat
651,Kolonel Silvertopstraat 5333,2022-11-10,13:00:00,220,167,53,FMN 03 Kolonel Silvertopstraat
651,Kolonel Silvertopstraat 5333,2022-11-10,14:00:00,244,157,87,FMN 03 Kolonel Silvertopstraat
651,Kolonel Silvertopstraat 5333,2022-11-10,15:00:00,354,218,136,FMN 03 Kolonel Silvertopstraat
651,Kolonel Silvertopstraat 5333,2022-11-10,16:00:00,487,332,155,FMN 03 Kolonel Silvertopstraat
651,Kolonel Silvertopstraat 5333,2022-11-10,17:00:00,416,257,159,FMN 03 Kolonel Silvertopstraat
651,Kolonel Silvertopstraat 5333,2022-11-10,18:00:00,380,230,150,FMN 03 Kolonel Silvertopstraat
651,Kolonel Silvertopstraat 5333,2022-11-10,19:00:00,234,171,63,FMN 03 Kolonel Silvertopstraat
651,Kolonel Silvertopstraat 5333,2022-11-10,20:00:00,203,140,63,FMN 03 Kolonel Silvertopstraat
651,Kolonel Silvertopstraat 5333,2022-11-10,21:00:00,161,86,75,FMN 03 Kolonel Silvertopstraat
651,Kolonel Silvertopstraat 5333,2022-11-10,22:00:00,165,107,58,FMN 03 Kolonel Silvertopstraat
651,Kolonel Silvertopstraat 5333,2022-11-10,23:00:00,96,47,49,FMN 03 Kolonel Silvertopstraat
651,Kolonel Silvertopstraat 5333,2022-11-11,00:00:00,55,27,28,FMN 03 Kolonel Silvertopstraat
651,Kolonel Silvertopstraat 5333,2022-11-11,01:00:00,56,24,32,FMN 03 Kolonel Silvertopstraat
651,Kolonel Silvertopstraat 5333,2022-11-11,02:00:00,41,16,25,FMN 03 Kolonel Silvertopstraat
651,Kolonel Silvertopstraat 5333,2022-11-11,03:00:00,42,14,28,FMN 03 Kolonel Silvertopstraat
651,Kolonel Silvertopstraat 5333,2022-11-11,04:00:00,28,11,17,FMN 03 Kolonel Silvertopstraat
651,Kolonel Silvertopstraat 5333,2022-11-11,05:00:00,32,14,18,FMN 03 Kolonel Silvertopstraat
651,Kolonel Silvertopstraat 5333,2022-11-11,06:00:00,32,26,6,FMN 03 Kolonel Silvertopstraat
651,Kolonel Silvertopstraat 5333,2022-11-11,07:00:00,26,19,7,FMN 03 Kolonel Silvertopstraat
651,Kolonel Silvertopstraat 5333,2022-11-11,08:00:00,52,40,12,FMN 03 Kolonel Silvertopstraat
651,Kolonel Silvertopstraat 5333,2022-11-11,09:00:00,89,58,31,FMN 03 Kolonel Silvertopstraat
651,Kolonel Silvertopstraat 5333,2022-11-11,10:00:00,126,92,34,FMN 03 Kolonel Silvertopstraat
651,Kolonel Silvertopstraat 5333,2022-11-11,11:00:00,148,107,41,FMN 03 Kolonel Silvertopstraat
651,Kolonel Silvertopstraat 5333,2022-11-11,12:00:00,180,128,52,FMN 03 Kolonel Silvertopstraat
651,Kolonel Silvertopstraat 5333,2022-11-11,13:00:00,213,154,59,FMN 03 Kolonel Silvertopstraat
651,Kolonel Silvertopstraat 5333,2022-11-11,14:00:00,247,183,64,FMN 03 Kolonel Silvertopstraat
651,Kolonel Silvertopstraat 5333,2022-11-11,15:00:00,212,145,67,FMN 03 Kolonel Silvertopstraat
651,Kolonel Silvertopstraat 5333,2022-11-11,16:00:00,213,151,62,FMN 03 Kolonel Silvertopstraat
651,Kolonel Silvertopstraat 5333,2022-11-11,17:00:00,225,148,77,FMN 03 Kolonel Silvertopstraat
651,Kolonel Silvertopstraat 5333,2022-11-11,18:00:00,192,139,53,FMN 03 Kolonel Silvertopstraat
651,Kolonel Silvertopstraat 5333,2022-11-11,19:00:00,185,116,69,FMN 03 Kolonel Silvertopstraat
651,Kolonel Silvertopstraat 5333,2022-11-11,20:00:00,148,77,71,FMN 03 Kolonel Silvertopstraat
651,Kolonel Silvertopstraat 5333,2022-11-11,21:00:00,95,57,38,FMN 03 Kolonel Silvertopstraat
651,Kolonel Silvertopstraat 5333,2022-11-11,22:00:00,91,57,34,FMN 03 Kolonel Silvertopstraat
651,Kolonel Silvertopstraat 5333,2022-11-11,23:00:00,84,47,37,FMN 03 Kolonel Silvertopstraat
651,Kolonel Silvertopstraat 5333,2022-11-12,00:00:00,52,17,35,FMN 03 Kolonel Silvertopstraat
651,Kolonel Silvertopstraat 5333,2022-11-12,01:00:00,39,15,24,FMN 03 Kolonel Silvertopstraat
651,Kolonel Silvertopstraat 5333,2022-11-12,02:00:00,29,16,13,FMN 03 Kolonel Silvertopstraat
651,Kolonel Silvertopstraat 5333,2022-11-12,03:00:00,24,11,13,FMN 03 Kolonel Silvertopstraat
651,Kolonel Silvertopstraat 5333,2022-11-12,04:00:00,34,22,12,FMN 03 Kolonel Silvertopstraat
651,Kolonel Silvertopstraat 5333,2022-11-12,05:00:00,41,27,14,FMN 03 Kolonel Silvertopstraat
651,Kolonel Silvertopstraat 5333,2022-11-12,06:00:00,51,39,12,FMN 03 Kolonel Silvertopstraat
651,Kolonel Silvertopstraat 5333,2022-11-12,07:00:00,35,24,11,FMN 03 Kolonel Silvertopstraat
651,Kolonel Silvertopstraat 5333,2022-11-12,08:00:00,92,70,22,FMN 03 Kolonel Silvertopstraat
651,Kolonel Silvertopstraat 5333,2022-11-12,09:00:00,153,123,30,FMN 03 Kolonel Silvertopstraat
651,Kolonel Silvertopstraat 5333,2022-11-12,10:00:00,168,130,38,FMN 03 Kolonel Silvertopstraat
651,Kolonel Silvertopstraat 5333,2022-11-12,11:00:00,199,158,41,FMN 03 Kolonel Silvertopstraat
651,Kolonel Silvertopstraat 5333,2022-11-12,12:00:00,212,161,51,FMN 03 Kolonel Silvertopstraat
651,Kolonel Silvertopstraat 5333,2022-11-12,13:00:00,267,213,54,FMN 03 Kolonel Silvertopstraat
651,Kolonel Silvertopstraat 5333,2022-11-12,14:00:00,247,186,61,FMN 03 Kolonel Silvertopstraat
651,Kolonel Silvertopstraat 5333,2022-11-12,15:00:00,256,166,90,FMN 03 Kolonel Silvertopstraat
651,Kolonel Silvertopstraat 5333,2022-11-12,16:00:00,217,155,62,FMN 03 Kolonel Silvertopstraat
651,Kolonel Silvertopstraat 5333,2022-11-12,17:00:00,255,163,92,FMN 03 Kolonel Silvertopstraat
651,Kolonel Silvertopstraat 5333,2022-11-12,18:00:00,166,102,64,FMN 03 Kolonel Silvertopstraat
651,Kolonel Silvertopstraat 5333,2022-11-12,19:00:00,216,134,82,FMN 03 Kolonel Silvertopstraat
651,Kolonel Silvertopstraat 5333,2022-11-12,20:00:00,143,80,63,FMN 03 Kolonel Silvertopstraat
651,Kolonel Silvertopstraat 5333,2022-11-12,21:00:00,95,60,35,FMN 03 Kolonel Silvertopstraat
651,Kolonel Silvertopstraat 5333,2022-11-12,22:00:00,132,95,37,FMN 03 Kolonel Silvertopstraat
651,Kolonel Silvertopstraat 5333,2022-11-12,23:00:00,102,50,52,FMN 03 Kolonel Silvertopstraat
651,Kolonel Silvertopstraat 5333,2022-11-13,00:00:00,72,40,32,FMN 03 Kolonel Silvertopstraat
651,Kolonel Silvertopstraat 5333,2022-11-13,01:00:00,49,21,28,FMN 03 Kolonel Silvertopstraat
651,Kolonel Silvertopstraat 5333,2022-11-13,02:00:00,31,9,22,FMN 03 Kolonel Silvertopstraat
651,Kolonel Silvertopstraat 5333,2022-11-13,03:00:00,22,14,8,FMN 03 Kolonel Silvertopstraat
651,Kolonel Silvertopstraat 5333,2022-11-13,04:00:00,19,5,14,FMN 03 Kolonel Silvertopstraat
651,Kolonel Silvertopstraat 5333,2022-11-13,05:00:00,12,9,3,FMN 03 Kolonel Silvertopstraat
651,Kolonel Silvertopstraat 5333,2022-11-13,06:00:00,31,24,7,FMN 03 Kolonel Silvertopstraat
651,Kolonel Silvertopstraat 5333,2022-11-13,07:00:00,23,14,9,FMN 03 Kolonel Silvertopstraat
651,Kolonel Silvertopstraat 5333,2022-11-13,08:00:00,57,46,11,FMN 03 Kolonel Silvertopstraat
651,Kolonel Silvertopstraat 5333,2022-11-13,09:00:00,86,66,20,FMN 03 Kolonel Silvertopstraat
651,Kolonel Silvertopstraat 5333,2022-11-13,10:00:00,138,114,24,FMN 03 Kolonel Silvertopstraat
651,Kolonel Silvertopstraat 5333,2022-11-13,11:00:00,134,101,33,FMN 03 Kolonel Silvertopstraat
651,Kolonel Silvertopstraat 5333,2022-11-13,12:00:00,146,120,26,FMN 03 Kolonel Silvertopstraat
651,Kolonel Silvertopstraat 5333,2022-11-13,13:00:00,185,151,34,FMN 03 Kolonel Silvertopstraat
651,Kolonel Silvertopstraat 5333,2022-11-13,14:00:00,209,167,42,FMN 03 Kolonel Silvertopstraat
651,Kolonel Silvertopstraat 5333,2022-11-13,15:00:00,189,136,53,FMN 03 Kolonel Silvertopstraat
651,Kolonel Silvertopstraat 5333,2022-11-13,16:00:00,185,129,56,FMN 03 Kolonel Silvertopstraat
651,Kolonel Silvertopstraat 5333,2022-11-13,17:00:00,195,107,88,FMN 03 Kolonel Silvertopstraat
651,Kolonel Silvertopstraat 5333,2022-11-13,18:00:00,180,102,78,FMN 03 Kolonel Silvertopstraat
651,Kolonel Silvertopstraat 5333,2022-11-13,19:00:00,113,66,47,FMN 03 Kolonel Silvertopstraat
651,Kolonel Silvertopstraat 5333,2022-11-13,20:00:00,110,52,58,FMN 03 Kolonel Silvertopstraat
651,Kolonel Silvertopstraat 5333,2022-11-13,21:00:00,85,45,40,FMN 03 Kolonel Silvertopstraat
651,Kolonel Silvertopstraat 5333,2022-11-13,22:00:00,59,28,31,FMN 03 Kolonel Silvertopstraat
651,Kolonel Silvertopstraat 5333,2022-11-13,23:00:00,47,23,24,FMN 03 Kolonel Silvertopstraat
651,Kolonel Silvertopstraat 5333,2022-11-14,00:00:00,29,15,14,FMN 03 Kolonel Silvertopstraat
651,Kolonel Silvertopstraat 5333,2022-11-14,01:00:00,14,6,8,FMN 03 Kolonel Silvertopstraat
651,Kolonel Silvertopstraat 5333,2022-11-14,02:00:00,6,2,4,FMN 03 Kolonel Silvertopstraat
651,Kolonel Silvertopstraat 5333,2022-11-14,03:00:00,4,0,4,FMN 03 Kolonel Silvertopstraat
651,Kolonel Silvertopstraat 5333,2022-11-14,04:00:00,28,20,8,FMN 03 Kolonel Silvertopstraat
651,Kolonel Silvertopstraat 5333,2022-11-14,05:00:00,48,31,17,FMN 03 Kolonel Silvertopstraat
651,Kolonel Silvertopstraat 5333,2022-11-14,06:00:00,124,100,24,FMN 03 Kolonel Silvertopstraat
651,Kolonel Silvertopstraat 5333,2022-11-14,07:00:00,353,297,56,FMN 03 Kolonel Silvertopstraat
651,Kolonel Silvertopstraat 5333,2022-11-14,08:00:00,695,599,96,FMN 03 Kolonel Silvertopstraat
651,Kolonel Silvertopstraat 5333,2022-11-14,09:00:00,204,159,45,FMN 03 Kolonel Silvertopstraat
651,Kolonel Silvertopstraat 5333,2022-11-14,10:00:00,171,131,40,FMN 03 Kolonel Silvertopstraat
651,Kolonel Silvertopstraat 5333,2022-11-14,11:00:00,156,115,41,FMN 03 Kolonel Silvertopstraat
651,Kolonel Silvertopstraat 5333,2022-11-14,12:00:00,222,148,74,FMN 03 Kolonel Silvertopstraat
651,Kolonel Silvertopstraat 5333,2022-11-14,13:00:00,225,158,67,FMN 03 Kolonel Silvertopstraat
651,Kolonel Silvertopstraat 5333,2022-11-14,14:00:00,198,153,45,FMN 03 Kolonel Silvertopstraat
651,Kolonel Silvertopstraat 5333,2022-11-14,15:00:00,350,220,130,FMN 03 Kolonel Silvertopstraat
651,Kolonel Silvertopstraat 5333,2022-11-14,16:00:00,437,281,156,FMN 03 Kolonel Silvertopstraat
651,Kolonel Silvertopstraat 5333,2022-11-14,17:00:00,388,252,136,FMN 03 Kolonel Silvertopstraat
651,Kolonel Silvertopstraat 5333,2022-11-14,18:00:00,247,163,84,FMN 03 Kolonel Silvertopstraat
651,Kolonel Silvertopstraat 5333,2022-11-14,19:00:00,166,87,79,FMN 03 Kolonel Silvertopstraat
651,Kolonel Silvertopstraat 5333,2022-11-14,20:00:00,121,60,61,FMN 03 Kolonel Silvertopstraat
651,Kolonel Silvertopstraat 5333,2022-11-14,21:00:00,123,56,67,FMN 03 Kolonel Silvertopstraat
651,Kolonel Silvertopstraat 5333,2022-11-14,22:00:00,79,42,37,FMN 03 Kolonel Silvertopstraat
651,Kolonel Silvertopstraat 5333,2022-11-14,23:00:00,49,22,27,FMN 03 Kolonel Silvertopstraat
651,Kolonel Silvertopstraat 5333,2022-11-15,00:00:00,18,13,5,FMN 03 Kolonel Silvertopstraat
651,Kolonel Silvertopstraat 5333,2022-11-15,01:00:00,13,7,6,FMN 03 Kolonel Silvertopstraat
651,Kolonel Silvertopstraat 5333,2022-11-15,02:00:00,9,3,6,FMN 03 Kolonel Silvertopstraat
651,Kolonel Silvertopstraat 5333,2022-11-15,03:00:00,5,4,1,FMN 03 Kolonel Silvertopstraat
651,Kolonel Silvertopstraat 5333,2022-11-15,04:00:00,29,24,5,FMN 03 Kolonel Silvertopstraat
651,Kolonel Silvertopstraat 5333,2022-11-15,05:00:00,49,37,12,FMN 03 Kolonel Silvertopstraat
651,Kolonel Silvertopstraat 5333,2022-11-15,06:00:00,139,110,29,FMN 03 Kolonel Silvertopstraat
651,Kolonel Silvertopstraat 5333,2022-11-15,07:00:00,379,319,60,FMN 03 Kolonel Silvertopstraat
651,Kolonel Silvertopstraat 5333,2022-11-15,08:00:00,709,601,108,FMN 03 Kolonel Silvertopstraat
651,Kolonel Silvertopstraat 5333,2022-11-15,09:00:00,263,208,55,FMN 03 Kolonel Silvertopstraat
651,Kolonel Silvertopstraat 5333,2022-11-15,10:00:00,188,151,37,FMN 03 Kolonel Silvertopstraat
651,Kolonel Silvertopstraat 5333,2022-11-15,11:00:00,188,129,59,FMN 03 Kolonel Silvertopstraat
651,Kolonel Silvertopstraat 5333,2022-11-15,12:00:00,264,186,78,FMN 03 Kolonel Silvertopstraat
651,Kolonel Silvertopstraat 5333,2022-11-15,13:00:00,217,135,82,FMN 03 Kolonel Silvertopstraat
651,Kolonel Silvertopstraat 5333,2022-11-15,14:00:00,188,127,61,FMN 03 Kolonel Silvertopstraat
651,Kolonel Silvertopstraat 5333,2022-11-15,15:00:00,314,198,116,FMN 03 Kolonel Silvertopstraat
651,Kolonel Silvertopstraat 5333,2022-11-15,16:00:00,386,251,135,FMN 03 Kolonel Silvertopstraat
651,Kolonel Silvertopstraat 5333,2022-11-15,17:00:00,339,218,121,FMN 03 Kolonel Silvertopstraat
651,Kolonel Silvertopstraat 5333,2022-11-15,18:00:00,237,139,98,FMN 03 Kolonel Silvertopstraat
651,Kolonel Silvertopstraat 5333,2022-11-15,19:00:00,175,114,61,FMN 03 Kolonel Silvertopstraat
651,Kolonel Silvertopstraat 5333,2022-11-15,20:00:00,113,62,51,FMN 03 Kolonel Silvertopstraat
651,Kolonel Silvertopstraat 5333,2022-11-15,21:00:00,100,46,54,FMN 03 Kolonel Silvertopstraat
651,Kolonel Silvertopstraat 5333,2022-11-15,22:00:00,87,53,34,FMN 03 Kolonel Silvertopstraat
651,Kolonel Silvertopstraat 5333,2022-11-15,23:00:00,61,32,29,FMN 03 Kolonel Silvertopstraat
651,Kolonel Silvertopstraat 5333,2022-11-16,00:00:00,24,12,12,FMN 03 Kolonel Silvertopstraat
651,Kolonel Silvertopstraat 5333,2022-11-16,01:00:00,6,3,3,FMN 03 Kolonel Silvertopstraat
651,Kolonel Silvertopstraat 5333,2022-11-16,02:00:00,9,6,3,FMN 03 Kolonel Silvertopstraat
651,Kolonel Silvertopstraat 5333,2022-11-16,03:00:00,5,3,2,FMN 03 Kolonel Silvertopstraat
651,Kolonel Silvertopstraat 5333,2022-11-16,04:00:00,18,14,4,FMN 03 Kolonel Silvertopstraat
651,Kolonel Silvertopstraat 5333,2022-11-16,05:00:00,50,35,15,FMN 03 Kolonel Silvertopstraat
651,Kolonel Silvertopstraat 5333,2022-11-16,06:00:00,121,101,20,FMN 03 Kolonel Silvertopstraat
651,Kolonel Silvertopstraat 5333,2022-11-16,07:00:00,388,324,64,FMN 03 Kolonel Silvertopstraat
651,Kolonel Silvertopstraat 5333,2022-11-16,08:00:00,643,544,99,FMN 03 Kolonel Silvertopstraat
651,Kolonel Silvertopstraat 5333,2022-11-16,09:00:00,215,165,50,FMN 03 Kolonel Silvertopstraat
651,Kolonel Silvertopstraat 5333,2022-11-16,10:00:00,180,140,40,FMN 03 Kolonel Silvertopstraat
651,Kolonel Silvertopstraat 5333,2022-11-16,11:00:00,191,142,49,FMN 03 Kolonel Silvertopstraat
651,Kolonel Silvertopstraat 5333,2022-11-16,12:00:00,359,221,138,FMN 03 Kolonel Silvertopstraat
651,Kolonel Silvertopstraat 5333,2022-11-16,13:00:00,279,178,101,FMN 03 Kolonel Silvertopstraat
651,Kolonel Silvertopstraat 5333,2022-11-16,14:00:00,194,135,59,FMN 03 Kolonel Silvertopstraat
651,Kolonel Silvertopstraat 5333,2022-11-16,15:00:00,251,163,88,FMN 03 Kolonel Silvertopstraat
651,Kolonel Silvertopstraat 5333,2022-11-16,16:00:00,349,229,120,FMN 03 Kolonel Silvertopstraat
651,Kolonel Silvertopstraat 5333,2022-11-16,17:00:00,402,259,143,FMN 03 Kolonel Silvertopstraat
651,Kolonel Silvertopstraat 5333,2022-11-16,18:00:00,308,208,100,FMN 03 Kolonel Silvertopstraat
651,Kolonel Silvertopstraat 5333,2022-11-16,19:00:00,222,147,75,FMN 03 Kolonel Silvertopstraat
651,Kolonel Silvertopstraat 5333,2022-11-16,20:00:00,123,72,51,FMN 03 Kolonel Silvertopstraat
651,Kolonel Silvertopstraat 5333,2022-11-16,21:00:00,100,58,42,FMN 03 Kolonel Silvertopstraat
651,Kolonel Silvertopstraat 5333,2022-11-16,22:00:00,100,49,51,FMN 03 Kolonel Silvertopstraat
651,Kolonel Silvertopstraat 5333,2022-11-16,23:00:00,54,21,33,FMN 03 Kolonel Silvertopstraat
651,Kolonel Silvertopstraat 5333,2022-11-17,00:00:00,28,13,15,FMN 03 Kolonel Silvertopstraat
651,Kolonel Silvertopstraat 5333,2022-11-17,01:00:00,7,4,3,FMN 03 Kolonel Silvertopstraat
651,Kolonel Silvertopstraat 5333,2022-11-17,02:00:00,9,6,3,FMN 03 Kolonel Silvertopstraat
651,Kolonel Silvertopstraat 5333,2022-11-17,03:00:00,12,3,9,FMN 03 Kolonel Silvertopstraat
651,Kolonel Silvertopstraat 5333,2022-11-17,04:00:00,30,18,12,FMN 03 Kolonel Silvertopstraat
651,Kolonel Silvertopstraat 5333,2022-11-17,05:00:00,40,20,20,FMN 03 Kolonel Silvertopstraat
651,Kolonel Silvertopstraat 5333,2022-11-17,06:00:00,109,88,21,FMN 03 Kolonel Silvertopstraat
651,Kolonel Silvertopstraat 5333,2022-11-17,07:00:00,306,260,46,FMN 03 Kolonel Silvertopstraat
651,Kolonel Silvertopstraat 5333,2022-11-17,08:00:00,587,487,100,FMN 03 Kolonel Silvertopstraat
651,Kolonel Silvertopstraat 5333,2022-11-17,09:00:00,183,152,31,FMN 03 Kolonel Silvertopstraat
651,Kolonel Silvertopstraat 5333,2022-11-17,10:00:00,128,105,23,FMN 03 Kolonel Silvertopstraat
651,Kolonel Silvertopstraat 5333,2022-11-17,11:00:00,115,87,28,FMN 03 Kolonel Silvertopstraat
651,Kolonel Silvertopstraat 5333,2022-11-17,12:00:00,201,145,56,FMN 03 Kolonel Silvertopstraat
651,Kolonel Silvertopstraat 5333,2022-11-17,13:00:00,161,106,55,FMN 03 Kolonel Silvertopstraat
651,Kolonel Silvertopstraat 5333,2022-11-17,14:00:00,169,112,57,FMN 03 Kolonel Silvertopstraat
651,Kolonel Silvertopstraat 5333,2022-11-17,15:00:00,300,188,112,FMN 03 Kolonel Silvertopstraat
651,Kolonel Silvertopstraat 5333,2022-11-17,16:00:00,358,239,119,FMN 03 Kolonel Silvertopstraat
651,Kolonel Silvertopstraat 5333,2022-11-17,17:00:00,361,238,123,FMN 03 Kolonel Silvertopstraat
651,Kolonel Silvertopstraat 5333,2022-11-17,18:00:00,265,161,104,FMN 03 Kolonel Silvertopstraat
651,Kolonel Silvertopstraat 5333,2022-11-17,19:00:00,175,123,52,FMN 03 Kolonel Silvertopstraat
651,Kolonel Silvertopstraat 5333,2022-11-17,20:00:00,148,92,56,FMN 03 Kolonel Silvertopstraat
651,Kolonel Silvertopstraat 5333,2022-11-17,21:00:00,118,55,63,FMN 03 Kolonel Silvertopstraat
651,Kolonel Silvertopstraat 5333,2022-11-17,22:00:00,142,68,74,FMN 03 Kolonel Silvertopstraat
651,Kolonel Silvertopstraat 5333,2022-11-17,23:00:00,62,28,34,FMN 03 Kolonel Silvertopstraat
651,Kolonel Silvertopstraat 5333,2022-11-18,00:00:00,32,14,18,FMN 03 Kolonel Silvertopstraat
651,Kolonel Silvertopstraat 5333,2022-11-18,01:00:00,17,1,16,FMN 03 Kolonel Silvertopstraat
651,Kolonel Silvertopstraat 5333,2022-11-18,02:00:00,16,8,8,FMN 03 Kolonel Silvertopstraat
651,Kolonel Silvertopstraat 5333,2022-11-18,03:00:00,11,5,6,FMN 03 Kolonel Silvertopstraat
651,Kolonel Silvertopstraat 5333,2022-11-18,04:00:00,23,16,7,FMN 03 Kolonel Silvertopstraat
651,Kolonel Silvertopstraat 5333,2022-11-18,05:00:00,46,37,9,FMN 03 Kolonel Silvertopstraat
651,Kolonel Silvertopstraat 5333,2022-11-18,06:00:00,114,90,24,FMN 03 Kolonel Silvertopstraat
651,Kolonel Silvertopstraat 5333,2022-11-18,07:00:00,315,263,52,FMN 03 Kolonel Silvertopstraat
651,Kolonel Silvertopstraat 5333,2022-11-18,08:00:00,618,535,83,FMN 03 Kolonel Silvertopstraat
651,Kolonel Silvertopstraat 5333,2022-11-18,09:00:00,221,167,54,FMN 03 Kolonel Silvertopstraat
651,Kolonel Silvertopstraat 5333,2022-11-18,10:00:00,222,164,58,FMN 03 Kolonel Silvertopstraat
651,Kolonel Silvertopstraat 5333,2022-11-18,11:00:00,178,122,56,FMN 03 Kolonel Silvertopstraat
651,Kolonel Silvertopstraat 5333,2022-11-18,12:00:00,245,165,80,FMN 03 Kolonel Silvertopstraat
651,Kolonel Silvertopstraat 5333,2022-11-18,13:00:00,194,137,57,FMN 03 Kolonel Silvertopstraat
651,Kolonel Silvertopstraat 5333,2022-11-18,14:00:00,209,144,65,FMN 03 Kolonel Silvertopstraat
651,Kolonel Silvertopstraat 5333,2022-11-18,15:00:00,273,159,114,FMN 03 Kolonel Silvertopstraat
651,Kolonel Silvertopstraat 5333,2022-11-18,16:00:00,349,224,125,FMN 03 Kolonel Silvertopstraat
651,Kolonel Silvertopstraat 5333,2022-11-18,17:00:00,287,179,108,FMN 03 Kolonel Silvertopstraat
651,Kolonel Silvertopstraat 5333,2022-11-18,18:00:00,183,106,77,FMN 03 Kolonel Silvertopstraat
651,Kolonel Silvertopstraat 5333,2022-11-18,19:00:00,141,84,57,FMN 03 Kolonel Silvertopstraat
651,Kolonel Silvertopstraat 5333,2022-11-18,20:00:00,98,59,39,FMN 03 Kolonel Silvertopstraat
651,Kolonel Silvertopstraat 5333,2022-11-18,21:00:00,79,55,24,FMN 03 Kolonel Silvertopstraat
651,Kolonel Silvertopstraat 5333,2022-11-18,22:00:00,84,49,35,FMN 03 Kolonel Silvertopstraat
651,Kolonel Silvertopstraat 5333,2022-11-18,23:00:00,72,40,32,FMN 03 Kolonel Silvertopstraat
651,Kolonel Silvertopstraat 5333,2022-11-19,00:00:00,69,32,37,FMN 03 Kolonel Silvertopstraat
651,Kolonel Silvertopstraat 5333,2022-11-19,01:00:00,38,28,10,FMN 03 Kolonel Silvertopstraat
651,Kolonel Silvertopstraat 5333,2022-11-19,02:00:00,16,9,7,FMN 03 Kolonel Silvertopstraat
651,Kolonel Silvertopstraat 5333,2022-11-19,03:00:00,31,11,20,FMN 03 Kolonel Silvertopstraat
651,Kolonel Silvertopstraat 5333,2022-11-19,04:00:00,27,12,15,FMN 03 Kolonel Silvertopstraat
651,Kolonel Silvertopstraat 5333,2022-11-19,05:00:00,27,19,8,FMN 03 Kolonel Silvertopstraat
651,Kolonel Silvertopstraat 5333,2022-11-19,06:00:00,31,24,7,FMN 03 Kolonel Silvertopstraat
651,Kolonel Silvertopstraat 5333,2022-11-19,07:00:00,22,18,4,FMN 03 Kolonel Silvertopstraat
651,Kolonel Silvertopstraat 5333,2022-11-19,08:00:00,60,39,21,FMN 03 Kolonel Silvertopstraat
651,Kolonel Silvertopstraat 5333,2022-11-19,09:00:00,90,77,13,FMN 03 Kolonel Silvertopstraat
651,Kolonel Silvertopstraat 5333,2022-11-19,10:00:00,100,80,20,FMN 03 Kolonel Silvertopstraat
651,Kolonel Silvertopstraat 5333,2022-11-19,11:00:00,118,82,36,FMN 03 Kolonel Silvertopstraat
651,Kolonel Silvertopstraat 5333,2022-11-19,12:00:00,139,92,47,FMN 03 Kolonel Silvertopstraat
651,Kolonel Silvertopstraat 5333,2022-11-19,13:00:00,181,126,55,FMN 03 Kolonel Silvertopstraat
651,Kolonel Silvertopstraat 5333,2022-11-19,14:00:00,170,112,58,FMN 03 Kolonel Silvertopstraat
651,Kolonel Silvertopstraat 5333,2022-11-19,15:00:00,185,100,85,FMN 03 Kolonel Silvertopstraat
651,Kolonel Silvertopstraat 5333,2022-11-19,16:00:00,168,113,55,FMN 03 Kolonel Silvertopstraat
651,Kolonel Silvertopstraat 5333,2022-11-19,17:00:00,182,111,71,FMN 03 Kolonel Silvertopstraat
651,Kolonel Silvertopstraat 5333,2022-11-19,18:00:00,188,127,61,FMN 03 Kolonel Silvertopstraat
651,Kolonel Silvertopstraat 5333,2022-11-19,19:00:00,156,105,51,FMN 03 Kolonel Silvertopstraat
651,Kolonel Silvertopstraat 5333,2022-11-19,20:00:00,125,86,39,FMN 03 Kolonel Silvertopstraat
651,Kolonel Silvertopstraat 5333,2022-11-19,21:00:00,72,48,24,FMN 03 Kolonel Silvertopstraat
651,Kolonel Silvertopstraat 5333,2022-11-19,22:00:00,76,46,30,FMN 03 Kolonel Silvertopstraat
651,Kolonel Silvertopstraat 5333,2022-11-19,23:00:00,81,43,38,FMN 03 Kolonel Silvertopstraat
651,Kolonel Silvertopstraat 5333,2022-11-20,00:00:00,56,18,38,FMN 03 Kolonel Silvertopstraat
651,Kolonel Silvertopstraat 5333,2022-11-20,01:00:00,29,7,22,FMN 03 Kolonel Silvertopstraat
651,Kolonel Silvertopstraat 5333,2022-11-20,02:00:00,21,8,13,FMN 03 Kolonel Silvertopstraat
651,Kolonel Silvertopstraat 5333,2022-11-20,03:00:00,28,10,18,FMN 03 Kolonel Silvertopstraat
651,Kolonel Silvertopstraat 5333,2022-11-20,04:00:00,14,6,8,FMN 03 Kolonel Silvertopstraat
651,Kolonel Silvertopstraat 5333,2022-11-20,05:00:00,20,12,8,FMN 03 Kolonel Silvertopstraat
651,Kolonel Silvertopstraat 5333,2022-11-20,06:00:00,37,27,10,FMN 03 Kolonel Silvertopstraat
651,Kolonel Silvertopstraat 5333,2022-11-20,07:00:00,25,21,4,FMN 03 Kolonel Silvertopstraat
651,Kolonel Silvertopstraat 5333,2022-11-20,08:00:00,69,56,13,FMN 03 Kolonel Silvertopstraat
651,Kolonel Silvertopstraat 5333,2022-11-20,09:00:00,127,109,18,FMN 03 Kolonel Silvertopstraat
651,Kolonel Silvertopstraat 5333,2022-11-20,10:00:00,121,102,19,FMN 03 Kolonel Silvertopstraat
651,Kolonel Silvertopstraat 5333,2022-11-20,11:00:00,84,55,29,FMN 03 Kolonel Silvertopstraat
651,Kolonel Silvertopstraat 5333,2022-11-20,12:00:00,131,94,37,FMN 03 Kolonel Silvertopstraat
651,Kolonel Silvertopstraat 5333,2022-11-20,13:00:00,129,76,53,FMN 03 Kolonel Silvertopstraat
651,Kolonel Silvertopstraat 5333,2022-11-20,14:00:00,76,46,30,FMN 03 Kolonel Silvertopstraat
651,Kolonel Silvertopstraat 5333,2022-11-20,15:00:00,82,51,31,FMN 03 Kolonel Silvertopstraat
651,Kolonel Silvertopstraat 5333,2022-11-20,16:00:00,95,62,33,FMN 03 Kolonel Silvertopstraat
651,Kolonel Silvertopstraat 5333,2022-11-20,17:00:00,126,84,42,FMN 03 Kolonel Silvertopstraat
651,Kolonel Silvertopstraat 5333,2022-11-20,18:00:00,105,60,45,FMN 03 Kolonel Silvertopstraat
651,Kolonel Silvertopstraat 5333,2022-11-20,19:00:00,103,65,38,FMN 03 Kolonel Silvertopstraat
651,Kolonel Silvertopstraat 5333,2022-11-20,20:00:00,77,44,33,FMN 03 Kolonel Silvertopstraat
651,Kolonel Silvertopstraat 5333,2022-11-20,21:00:00,61,33,28,FMN 03 Kolonel Silvertopstraat
651,Kolonel Silvertopstraat 5333,2022-11-20,22:00:00,47,26,21,FMN 03 Kolonel Silvertopstraat
651,Kolonel Silvertopstraat 5333,2022-11-20,23:00:00,31,11,20,FMN 03 Kolonel Silvertopstraat
651,Kolonel Silvertopstraat 5333,2022-11-21,00:00:00,18,5,13,FMN 03 Kolonel Silvertopstraat
651,Kolonel Silvertopstraat 5333,2022-11-21,01:00:00,11,7,4,FMN 03 Kolonel Silvertopstraat
651,Kolonel Silvertopstraat 5333,2022-11-21,02:00:00,6,2,4,FMN 03 Kolonel Silvertopstraat
651,Kolonel Silvertopstraat 5333,2022-11-21,03:00:00,7,6,1,FMN 03 Kolonel Silvertopstraat
651,Kolonel Silvertopstraat 5333,2022-11-21,04:00:00,18,14,4,FMN 03 Kolonel Silvertopstraat
651,Kolonel Silvertopstraat 5333,2022-11-21,05:00:00,45,28,17,FMN 03 Kolonel Silvertopstraat
651,Kolonel Silvertopstraat 5333,2022-11-21,06:00:00,119,99,20,FMN 03 Kolonel Silvertopstraat
651,Kolonel Silvertopstraat 5333,2022-11-21,07:00:00,337,289,48,FMN 03 Kolonel Silvertopstraat
651,Kolonel Silvertopstraat 5333,2022-11-21,08:00:00,676,575,101,FMN 03 Kolonel Silvertopstraat
651,Kolonel Silvertopstraat 5333,2022-11-21,09:00:00,221,173,48,FMN 03 Kolonel Silvertopstraat
651,Kolonel Silvertopstraat 5333,2022-11-21,10:00:00,178,139,39,FMN 03 Kolonel Silvertopstraat
651,Kolonel Silvertopstraat 5333,2022-11-21,11:00:00,152,113,39,FMN 03 Kolonel Silvertopstraat
651,Kolonel Silvertopstraat 5333,2022-11-21,12:00:00,224,151,73,FMN 03 Kolonel Silvertopstraat
651,Kolonel Silvertopstraat 5333,2022-11-21,13:00:00,176,115,61,FMN 03 Kolonel Silvertopstraat
651,Kolonel Silvertopstraat 5333,2022-11-21,14:00:00,162,119,43,FMN 03 Kolonel Silvertopstraat
651,Kolonel Silvertopstraat 5333,2022-11-21,15:00:00,321,206,115,FMN 03 Kolonel Silvertopstraat
651,Kolonel Silvertopstraat 5333,2022-11-21,16:00:00,401,270,131,FMN 03 Kolonel Silvertopstraat
651,Kolonel Silvertopstraat 5333,2022-11-21,17:00:00,377,228,149,FMN 03 Kolonel Silvertopstraat
651,Kolonel Silvertopstraat 5333,2022-11-21,18:00:00,239,131,108,FMN 03 Kolonel Silvertopstraat
651,Kolonel Silvertopstraat 5333,2022-11-21,19:00:00,128,69,59,FMN 03 Kolonel Silvertopstraat
651,Kolonel Silvertopstraat 5333,2022-11-21,20:00:00,82,42,40,FMN 03 Kolonel Silvertopstraat
651,Kolonel Silvertopstraat 5333,2022-11-21,21:00:00,70,40,30,FMN 03 Kolonel Silvertopstraat
651,Kolonel Silvertopstraat 5333,2022-11-21,22:00:00,59,38,21,FMN 03 Kolonel Silvertopstraat
651,Kolonel Silvertopstraat 5333,2022-11-21,23:00:00,29,18,11,FMN 03 Kolonel Silvertopstraat
651,Kolonel Silvertopstraat 5333,2022-11-22,00:00:00,15,3,12,FMN 03 Kolonel Silvertopstraat
651,Kolonel Silvertopstraat 5333,2022-11-22,01:00:00,8,3,5,FMN 03 Kolonel Silvertopstraat
651,Kolonel Silvertopstraat 5333,2022-11-22,02:00:00,2,1,1,FMN 03 Kolonel Silvertopstraat
651,Kolonel Silvertopstraat 5333,2022-11-22,03:00:00,12,7,5,FMN 03 Kolonel Silvertopstraat
651,Kolonel Silvertopstraat 5333,2022-11-22,04:00:00,21,17,4,FMN 03 Kolonel Silvertopstraat
651,Kolonel Silvertopstraat 5333,2022-11-22,05:00:00,52,35,17,FMN 03 Kolonel Silvertopstraat
651,Kolonel Silvertopstraat 5333,2022-11-22,06:00:00,120,96,24,FMN 03 Kolonel Silvertopstraat
651,Kolonel Silvertopstraat 5333,2022-11-22,07:00:00,332,268,64,FMN 03 Kolonel Silvertopstraat
651,Kolonel Silvertopstraat 5333,2022-11-22,08:00:00,616,529,87,FMN 03 Kolonel Silvertopstraat
651,Kolonel Silvertopstraat 5333,2022-11-22,09:00:00,217,167,50,FMN 03 Kolonel Silvertopstraat
651,Kolonel Silvertopstraat 5333,2022-11-22,10:00:00,191,150,41,FMN 03 Kolonel Silvertopstraat
651,Kolonel Silvertopstraat 5333,2022-11-22,11:00:00,130,95,35,FMN 03 Kolonel Silvertopstraat
651,Kolonel Silvertopstraat 5333,2022-11-22,12:00:00,250,182,68,FMN 03 Kolonel Silvertopstraat
651,Kolonel Silvertopstraat 5333,2022-11-22,13:00:00,196,134,62,FMN 03 Kolonel Silvertopstraat
651,Kolonel Silvertopstraat 5333,2022-11-22,14:00:00,169,107,62,FMN 03 Kolonel Silvertopstraat
651,Kolonel Silvertopstraat 5333,2022-11-22,15:00:00,306,202,104,FMN 03 Kolonel Silvertopstraat
651,Kolonel Silvertopstraat 5333,2022-11-22,16:00:00,402,260,142,FMN 03 Kolonel Silvertopstraat
651,Kolonel Silvertopstraat 5333,2022-11-22,17:00:00,366,235,131,FMN 03 Kolonel Silvertopstraat
651,Kolonel Silvertopstraat 5333,2022-11-22,18:00:00,299,194,105,FMN 03 Kolonel Silvertopstraat
651,Kolonel Silvertopstraat 5333,2022-11-22,19:00:00,181,99,82,FMN 03 Kolonel Silvertopstraat
651,Kolonel Silvertopstraat 5333,2022-11-22,20:00:00,113,58,55,FMN 03 Kolonel Silvertopstraat
651,Kolonel Silvertopstraat 5333,2022-11-22,21:00:00,104,53,51,FMN 03 Kolonel Silvertopstraat
651,Kolonel Silvertopstraat 5333,2022-11-22,22:00:00,86,48,38,FMN 03 Kolonel Silvertopstraat
651,Kolonel Silvertopstraat 5333,2022-11-22,23:00:00,54,21,33,FMN 03 Kolonel Silvertopstraat
651,Kolonel Silvertopstraat 5333,2022-11-23,00:00:00,27,12,15,FMN 03 Kolonel Silvertopstraat
651,Kolonel Silvertopstraat 5333,2022-11-23,01:00:00,10,5,5,FMN 03 Kolonel Silvertopstraat
651,Kolonel Silvertopstraat 5333,2022-11-23,02:00:00,8,5,3,FMN 03 Kolonel Silvertopstraat
651,Kolonel Silvertopstraat 5333,2022-11-23,03:00:00,6,5,1,FMN 03 Kolonel Silvertopstraat
651,Kolonel Silvertopstraat 5333,2022-11-23,04:00:00,34,23,11,FMN 03 Kolonel Silvertopstraat
651,Kolonel Silvertopstraat 5333,2022-11-23,05:00:00,49,26,23,FMN 03 Kolonel Silvertopstraat
651,Kolonel Silvertopstraat 5333,2022-11-23,06:00:00,114,87,27,FMN 03 Kolonel Silvertopstraat
651,Kolonel Silvertopstraat 5333,2022-11-23,07:00:00,314,252,62,FMN 03 Kolonel Silvertopstraat
651,Kolonel Silvertopstraat 5333,2022-11-23,08:00:00,613,512,101,FMN 03 Kolonel Silvertopstraat
651,Kolonel Silvertopstraat 5333,2022-11-23,09:00:00,200,158,42,FMN 03 Kolonel Silvertopstraat
651,Kolonel Silvertopstraat 5333,2022-11-23,10:00:00,195,151,44,FMN 03 Kolonel Silvertopstraat
651,Kolonel Silvertopstraat 5333,2022-11-23,11:00:00,133,103,30,FMN 03 Kolonel Silvertopstraat
651,Kolonel Silvertopstraat 5333,2022-11-23,12:00:00,345,215,130,FMN 03 Kolonel Silvertopstraat
651,Kolonel Silvertopstraat 5333,2022-11-23,13:00:00,213,145,68,FMN 03 Kolonel Silvertopstraat
651,Kolonel Silvertopstraat 5333,2022-11-23,14:00:00,122,79,43,FMN 03 Kolonel Silvertopstraat
651,Kolonel Silvertopstraat 5333,2022-11-23,15:00:00,176,114,62,FMN 03 Kolonel Silvertopstraat
651,Kolonel Silvertopstraat 5333,2022-11-23,16:00:00,249,169,80,FMN 03 Kolonel Silvertopstraat
651,Kolonel Silvertopstraat 5333,2022-11-23,17:00:00,370,254,116,FMN 03 Kolonel Silvertopstraat
651,Kolonel Silvertopstraat 5333,2022-11-23,18:00:00,301,190,111,FMN 03 Kolonel Silvertopstraat
651,Kolonel Silvertopstraat 5333,2022-11-23,19:00:00,193,127,66,FMN 03 Kolonel Silvertopstraat
651,Kolonel Silvertopstraat 5333,2022-11-23,20:00:00,121,60,61,FMN 03 Kolonel Silvertopstraat
651,Kolonel Silvertopstraat 5333,2022-11-23,21:00:00,72,40,32,FMN 03 Kolonel Silvertopstraat
651,Kolonel Silvertopstraat 5333,2022-11-23,22:00:00,132,70,62,FMN 03 Kolonel Silvertopstraat
651,Kolonel Silvertopstraat 5333,2022-11-23,23:00:00,66,33,33,FMN 03 Kolonel Silvertopstraat
651,Kolonel Silvertopstraat 5333,2022-11-24,00:00:00,27,7,20,FMN 03 Kolonel Silvertopstraat
651,Kolonel Silvertopstraat 5333,2022-11-24,01:00:00,16,5,11,FMN 03 Kolonel Silvertopstraat
651,Kolonel Silvertopstraat 5333,2022-11-24,02:00:00,10,4,6,FMN 03 Kolonel Silvertopstraat
651,Kolonel Silvertopstraat 5333,2022-11-24,03:00:00,5,4,1,FMN 03 Kolonel Silvertopstraat
651,Kolonel Silvertopstraat 5333,2022-11-24,04:00:00,27,19,8,FMN 03 Kolonel Silvertopstraat
651,Kolonel Silvertopstraat 5333,2022-11-24,05:00:00,63,38,25,FMN 03 Kolonel Silvertopstraat
651,Kolonel Silvertopstraat 5333,2022-11-24,06:00:00,134,113,21,FMN 03 Kolonel Silvertopstraat
651,Kolonel Silvertopstraat 5333,2022-11-24,07:00:00,357,291,66,FMN 03 Kolonel Silvertopstraat
651,Kolonel Silvertopstraat 5333,2022-11-24,08:00:00,739,625,114,FMN 03 Kolonel Silvertopstraat
651,Kolonel Silvertopstraat 5333,2022-11-24,09:00:00,218,185,33,FMN 03 Kolonel Silvertopstraat
651,Kolonel Silvertopstraat 5333,2022-11-24,10:00:00,173,135,38,FMN 03 Kolonel Silvertopstraat
651,Kolonel Silvertopstraat 5333,2022-11-24,11:00:00,156,116,40,FMN 03 Kolonel Silvertopstraat
651,Kolonel Silvertopstraat 5333,2022-11-24,12:00:00,225,164,61,FMN 03 Kolonel Silvertopstraat
651,Kolonel Silvertopstraat 5333,2022-11-24,13:00:00,198,144,54,FMN 03 Kolonel Silvertopstraat
651,Kolonel Silvertopstraat 5333,2022-11-24,14:00:00,203,129,74,FMN 03 Kolonel Silvertopstraat
651,Kolonel Silvertopstraat 5333,2022-11-24,15:00:00,316,198,118,FMN 03 Kolonel Silvertopstraat
651,Kolonel Silvertopstraat 5333,2022-11-24,16:00:00,416,272,144,FMN 03 Kolonel Silvertopstraat
651,Kolonel Silvertopstraat 5333,2022-11-24,17:00:00,440,274,166,FMN 03 Kolonel Silvertopstraat
651,Kolonel Silvertopstraat 5333,2022-11-24,18:00:00,298,178,120,FMN 03 Kolonel Silvertopstraat
651,Kolonel Silvertopstraat 5333,2022-11-24,19:00:00,206,132,74,FMN 03 Kolonel Silvertopstraat
651,Kolonel Silvertopstraat 5333,2022-11-24,20:00:00,152,76,76,FMN 03 Kolonel Silvertopstraat
651,Kolonel Silvertopstraat 5333,2022-11-24,21:00:00,132,67,65,FMN 03 Kolonel Silvertopstraat
651,Kolonel Silvertopstraat 5333,2022-11-24,22:00:00,114,56,58,FMN 03 Kolonel Silvertopstraat
651,Kolonel Silvertopstraat 5333,2022-11-24,23:00:00,69,30,39,FMN 03 Kolonel Silvertopstraat
651,Kolonel Silvertopstraat 5333,2022-11-25,00:00:00,38,19,19,FMN 03 Kolonel Silvertopstraat
651,Kolonel Silvertopstraat 5333,2022-11-25,01:00:00,17,7,10,FMN 03 Kolonel Silvertopstraat
651,Kolonel Silvertopstraat 5333,2022-11-25,02:00:00,13,6,7,FMN 03 Kolonel Silvertopstraat
651,Kolonel Silvertopstraat 5333,2022-11-25,03:00:00,8,1,7,FMN 03 Kolonel Silvertopstraat
651,Kolonel Silvertopstraat 5333,2022-11-25,04:00:00,24,18,6,FMN 03 Kolonel Silvertopstraat
651,Kolonel Silvertopstraat 5333,2022-11-25,05:00:00,56,36,20,FMN 03 Kolonel Silvertopstraat
651,Kolonel Silvertopstraat 5333,2022-11-25,06:00:00,124,96,28,FMN 03 Kolonel Silvertopstraat
651,Kolonel Silvertopstraat 5333,2022-11-25,07:00:00,319,265,54,FMN 03 Kolonel Silvertopstraat
651,Kolonel Silvertopstraat 5333,2022-11-25,08:00:00,621,545,76,FMN 03 Kolonel Silvertopstraat
651,Kolonel Silvertopstraat 5333,2022-11-25,09:00:00,236,188,48,FMN 03 Kolonel Silvertopstraat
651,Kolonel Silvertopstraat 5333,2022-11-25,10:00:00,206,155,51,FMN 03 Kolonel Silvertopstraat
651,Kolonel Silvertopstraat 5333,2022-11-25,11:00:00,171,119,52,FMN 03 Kolonel Silvertopstraat
651,Kolonel Silvertopstraat 5333,2022-11-25,12:00:00,250,180,70,FMN 03 Kolonel Silvertopstraat
651,Kolonel Silvertopstraat 5333,2022-11-25,13:00:00,256,180,76,FMN 03 Kolonel Silvertopstraat
651,Kolonel Silvertopstraat 5333,2022-11-25,14:00:00,228,151,77,FMN 03 Kolonel Silvertopstraat
651,Kolonel Silvertopstraat 5333,2022-11-25,15:00:00,317,195,122,FMN 03 Kolonel Silvertopstraat
651,Kolonel Silvertopstraat 5333,2022-11-25,16:00:00,362,225,137,FMN 03 Kolonel Silvertopstraat
651,Kolonel Silvertopstraat 5333,2022-11-25,17:00:00,407,256,151,FMN 03 Kolonel Silvertopstraat
651,Kolonel Silvertopstraat 5333,2022-11-25,18:00:00,281,188,93,FMN 03 Kolonel Silvertopstraat
651,Kolonel Silvertopstraat 5333,2022-11-25,19:00:00,224,147,77,FMN 03 Kolonel Silvertopstraat
651,Kolonel Silvertopstraat 5333,2022-11-25,20:00:00,169,112,57,FMN 03 Kolonel Silvertopstraat
651,Kolonel Silvertopstraat 5333,2022-11-25,21:00:00,121,70,51,FMN 03 Kolonel Silvertopstraat
651,Kolonel Silvertopstraat 5333,2022-11-25,22:00:00,118,70,48,FMN 03 Kolonel Silvertopstraat
651,Kolonel Silvertopstraat 5333,2022-11-25,23:00:00,109,49,60,FMN 03 Kolonel Silvertopstraat
651,Kolonel Silvertopstraat 5333,2022-11-26,00:00:00,56,27,29,FMN 03 Kolonel Silvertopstraat
651,Kolonel Silvertopstraat 5333,2022-11-26,01:00:00,53,19,34,FMN 03 Kolonel Silvertopstraat
651,Kolonel Silvertopstraat 5333,2022-11-26,02:00:00,23,9,14,FMN 03 Kolonel Silvertopstraat
651,Kolonel Silvertopstraat 5333,2022-11-26,03:00:00,30,10,20,FMN 03 Kolonel Silvertopstraat
651,Kolonel Silvertopstraat 5333,2022-11-26,04:00:00,22,8,14,FMN 03 Kolonel Silvertopstraat
651,Kolonel Silvertopstraat 5333,2022-11-26,05:00:00,35,22,13,FMN 03 Kolonel Silvertopstraat
651,Kolonel Silvertopstraat 5333,2022-11-26,06:00:00,47,28,19,FMN 03 Kolonel Silvertopstraat
651,Kolonel Silvertopstraat 5333,2022-11-26,07:00:00,36,30,6,FMN 03 Kolonel Silvertopstraat
651,Kolonel Silvertopstraat 5333,2022-11-26,08:00:00,88,62,26,FMN 03 Kolonel Silvertopstraat
651,Kolonel Silvertopstraat 5333,2022-11-26,09:00:00,157,134,23,FMN 03 Kolonel Silvertopstraat
651,Kolonel Silvertopstraat 5333,2022-11-26,10:00:00,175,140,35,FMN 03 Kolonel Silvertopstraat
651,Kolonel Silvertopstraat 5333,2022-11-26,11:00:00,166,121,45,FMN 03 Kolonel Silvertopstraat
651,Kolonel Silvertopstraat 5333,2022-11-26,12:00:00,196,144,52,FMN 03 Kolonel Silvertopstraat
651,Kolonel Silvertopstraat 5333,2022-11-26,13:00:00,201,149,52,FMN 03 Kolonel Silvertopstraat
651,Kolonel Silvertopstraat 5333,2022-11-26,14:00:00,187,132,55,FMN 03 Kolonel Silvertopstraat
651,Kolonel Silvertopstraat 5333,2022-11-26,15:00:00,210,162,48,FMN 03 Kolonel Silvertopstraat
651,Kolonel Silvertopstraat 5333,2022-11-26,16:00:00,234,153,81,FMN 03 Kolonel Silvertopstraat
651,Kolonel Silvertopstraat 5333,2022-11-26,17:00:00,236,156,80,FMN 03 Kolonel Silvertopstraat
651,Kolonel Silvertopstraat 5333,2022-11-26,18:00:00,197,126,71,FMN 03 Kolonel Silvertopstraat
651,Kolonel Silvertopstraat 5333,2022-11-26,19:00:00,195,124,71,FMN 03 Kolonel Silvertopstraat
651,Kolonel Silvertopstraat 5333,2022-11-26,20:00:00,111,60,51,FMN 03 Kolonel Silvertopstraat
651,Kolonel Silvertopstraat 5333,2022-11-26,21:00:00,91,62,29,FMN 03 Kolonel Silvertopstraat
651,Kolonel Silvertopstraat 5333,2022-11-26,22:00:00,110,55,55,FMN 03 Kolonel Silvertopstraat
651,Kolonel Silvertopstraat 5333,2022-11-26,23:00:00,88,38,50,FMN 03 Kolonel Silvertopstraat
651,Kolonel Silvertopstraat 5333,2022-11-27,00:00:00,61,27,34,FMN 03 Kolonel Silvertopstraat
651,Kolonel Silvertopstraat 5333,2022-11-27,01:00:00,31,15,16,FMN 03 Kolonel Silvertopstraat
651,Kolonel Silvertopstraat 5333,2022-11-27,02:00:00,34,11,23,FMN 03 Kolonel Silvertopstraat
651,Kolonel Silvertopstraat 5333,2022-11-27,03:00:00,17,6,11,FMN 03 Kolonel Silvertopstraat
651,Kolonel Silvertopstraat 5333,2022-11-27,04:00:00,15,7,8,FMN 03 Kolonel Silvertopstraat
651,Kolonel Silvertopstraat 5333,2022-11-27,05:00:00,18,11,7,FMN 03 Kolonel Silvertopstraat
651,Kolonel Silvertopstraat 5333,2022-11-27,06:00:00,22,16,6,FMN 03 Kolonel Silvertopstraat
651,Kolonel Silvertopstraat 5333,2022-11-27,07:00:00,19,16,3,FMN 03 Kolonel Silvertopstraat
651,Kolonel Silvertopstraat 5333,2022-11-27,08:00:00,38,32,6,FMN 03 Kolonel Silvertopstraat
651,Kolonel Silvertopstraat 5333,2022-11-27,09:00:00,79,59,20,FMN 03 Kolonel Silvertopstraat
651,Kolonel Silvertopstraat 5333,2022-11-27,10:00:00,69,50,19,FMN 03 Kolonel Silvertopstraat
651,Kolonel Silvertopstraat 5333,2022-11-27,11:00:00,95,69,26,FMN 03 Kolonel Silvertopstraat
651,Kolonel Silvertopstraat 5333,2022-11-27,12:00:00,79,58,21,FMN 03 Kolonel Silvertopstraat
651,Kolonel Silvertopstraat 5333,2022-11-27,13:00:00,160,116,44,FMN 03 Kolonel Silvertopstraat
651,Kolonel Silvertopstraat 5333,2022-11-27,14:00:00,87,68,19,FMN 03 Kolonel Silvertopstraat
651,Kolonel Silvertopstraat 5333,2022-11-27,15:00:00,93,66,27,FMN 03 Kolonel Silvertopstraat
651,Kolonel Silvertopstraat 5333,2022-11-27,16:00:00,127,86,41,FMN 03 Kolonel Silvertopstraat
651,Kolonel Silvertopstraat 5333,2022-11-27,17:00:00,156,84,72,FMN 03 Kolonel Silvertopstraat
651,Kolonel Silvertopstraat 5333,2022-11-27,18:00:00,128,72,56,FMN 03 Kolonel Silvertopstraat
651,Kolonel Silvertopstraat 5333,2022-11-27,19:00:00,92,57,35,FMN 03 Kolonel Silvertopstraat
651,Kolonel Silvertopstraat 5333,2022-11-27,20:00:00,65,34,31,FMN 03 Kolonel Silvertopstraat
651,Kolonel Silvertopstraat 5333,2022-11-27,21:00:00,63,30,33,FMN 03 Kolonel Silvertopstraat
651,Kolonel Silvertopstraat 5333,2022-11-27,22:00:00,40,16,24,FMN 03 Kolonel Silvertopstraat
651,Kolonel Silvertopstraat 5333,2022-11-27,23:00:00,33,16,17,FMN 03 Kolonel Silvertopstraat
651,Kolonel Silvertopstraat 5333,2022-11-28,00:00:00,17,13,4,FMN 03 Kolonel Silvertopstraat
651,Kolonel Silvertopstraat 5333,2022-11-28,01:00:00,7,5,2,FMN 03 Kolonel Silvertopstraat
651,Kolonel Silvertopstraat 5333,2022-11-28,02:00:00,6,4,2,FMN 03 Kolonel Silvertopstraat
651,Kolonel Silvertopstraat 5333,2022-11-28,03:00:00,9,4,5,FMN 03 Kolonel Silvertopstraat
651,Kolonel Silvertopstraat 5333,2022-11-28,04:00:00,17,12,5,FMN 03 Kolonel Silvertopstraat
651,Kolonel Silvertopstraat 5333,2022-11-28,05:00:00,42,25,17,FMN 03 Kolonel Silvertopstraat
651,Kolonel Silvertopstraat 5333,2022-11-28,06:00:00,134,104,30,FMN 03 Kolonel Silvertopstraat
651,Kolonel Silvertopstraat 5333,2022-11-28,07:00:00,317,262,55,FMN 03 Kolonel Silvertopstraat
651,Kolonel Silvertopstraat 5333,2022-11-28,08:00:00,667,578,89,FMN 03 Kolonel Silvertopstraat
651,Kolonel Silvertopstraat 5333,2022-11-28,09:00:00,200,167,33,FMN 03 Kolonel Silvertopstraat
651,Kolonel Silvertopstraat 5333,2022-11-28,10:00:00,161,122,39,FMN 03 Kolonel Silvertopstraat
651,Kolonel Silvertopstraat 5333,2022-11-28,11:00:00,115,93,22,FMN 03 Kolonel Silvertopstraat
651,Kolonel Silvertopstraat 5333,2022-11-28,12:00:00,197,131,66,FMN 03 Kolonel Silvertopstraat
651,Kolonel Silvertopstraat 5333,2022-11-28,13:00:00,175,129,46,FMN 03 Kolonel Silvertopstraat
651,Kolonel Silvertopstraat 5333,2022-11-28,14:00:00,181,130,51,FMN 03 Kolonel Silvertopstraat
651,Kolonel Silvertopstraat 5333,2022-11-28,15:00:00,323,192,131,FMN 03 Kolonel Silvertopstraat
651,Kolonel Silvertopstraat 5333,2022-11-28,16:00:00,387,252,135,FMN 03 Kolonel Silvertopstraat
651,Kolonel Silvertopstraat 5333,2022-11-28,17:00:00,383,225,158,FMN 03 Kolonel Silvertopstraat
651,Kolonel Silvertopstraat 5333,2022-11-28,18:00:00,269,172,97,FMN 03 Kolonel Silvertopstraat
651,Kolonel Silvertopstraat 5333,2022-11-28,19:00:00,161,99,62,FMN 03 Kolonel Silvertopstraat
651,Kolonel Silvertopstraat 5333,2022-11-28,20:00:00,121,65,56,FMN 03 Kolonel Silvertopstraat
651,Kolonel Silvertopstraat 5333,2022-11-28,21:00:00,97,43,54,FMN 03 Kolonel Silvertopstraat
651,Kolonel Silvertopstraat 5333,2022-11-28,22:00:00,74,40,34,FMN 03 Kolonel Silvertopstraat
651,Kolonel Silvertopstraat 5333,2022-11-28,23:00:00,41,21,20,FMN 03 Kolonel Silvertopstraat
651,Kolonel Silvertopstraat 5333,2022-11-29,00:00:00,23,11,12,FMN 03 Kolonel Silvertopstraat
651,Kolonel Silvertopstraat 5333,2022-11-29,01:00:00,6,4,2,FMN 03 Kolonel Silvertopstraat
651,Kolonel Silvertopstraat 5333,2022-11-29,02:00:00,13,4,9,FMN 03 Kolonel Silvertopstraat
651,Kolonel Silvertopstraat 5333,2022-11-29,03:00:00,7,3,4,FMN 03 Kolonel Silvertopstraat
651,Kolonel Silvertopstraat 5333,2022-11-29,04:00:00,25,19,6,FMN 03 Kolonel Silvertopstraat
651,Kolonel Silvertopstraat 5333,2022-11-29,05:00:00,47,25,22,FMN 03 Kolonel Silvertopstraat
651,Kolonel Silvertopstraat 5333,2022-11-29,06:00:00,127,100,27,FMN 03 Kolonel Silvertopstraat
651,Kolonel Silvertopstraat 5333,2022-11-29,07:00:00,332,289,43,FMN 03 Kolonel Silvertopstraat
651,Kolonel Silvertopstraat 5333,2022-11-29,08:00:00,672,573,99,FMN 03 Kolonel Silvertopstraat
651,Kolonel Silvertopstraat 5333,2022-11-29,09:00:00,236,192,44,FMN 03 Kolonel Silvertopstraat
651,Kolonel Silvertopstraat 5333,2022-11-29,10:00:00,176,142,34,FMN 03 Kolonel Silvertopstraat
651,Kolonel Silvertopstraat 5333,2022-11-29,11:00:00,145,104,41,FMN 03 Kolonel Silvertopstraat
651,Kolonel Silvertopstraat 5333,2022-11-29,12:00:00,236,178,58,FMN 03 Kolonel Silvertopstraat
651,Kolonel Silvertopstraat 5333,2022-11-29,13:00:00,223,157,66,FMN 03 Kolonel Silvertopstraat
651,Kolonel Silvertopstraat 5333,2022-11-29,14:00:00,155,106,49,FMN 03 Kolonel Silvertopstraat
651,Kolonel Silvertopstraat 5333,2022-11-29,15:00:00,309,185,124,FMN 03 Kolonel Silvertopstraat
651,Kolonel Silvertopstraat 5333,2022-11-29,16:00:00,380,240,140,FMN 03 Kolonel Silvertopstraat
651,Kolonel Silvertopstraat 5333,2022-11-29,17:00:00,423,262,161,FMN 03 Kolonel Silvertopstraat
651,Kolonel Silvertopstraat 5333,2022-11-29,18:00:00,321,200,121,FMN 03 Kolonel Silvertopstraat
651,Kolonel Silvertopstraat 5333,2022-11-29,19:00:00,178,112,66,FMN 03 Kolonel Silvertopstraat
651,Kolonel Silvertopstraat 5333,2022-11-29,20:00:00,114,70,44,FMN 03 Kolonel Silvertopstraat
651,Kolonel Silvertopstraat 5333,2022-11-29,21:00:00,100,60,40,FMN 03 Kolonel Silvertopstraat
651,Kolonel Silvertopstraat 5333,2022-11-29,22:00:00,101,58,43,FMN 03 Kolonel Silvertopstraat
651,Kolonel Silvertopstraat 5333,2022-11-29,23:00:00,52,19,33,FMN 03 Kolonel Silvertopstraat
651,Kolonel Silvertopstraat 5333,2022-11-30,00:00:00,30,14,16,FMN 03 Kolonel Silvertopstraat
651,Kolonel Silvertopstraat 5333,2022-11-30,01:00:00,8,5,3,FMN 03 Kolonel Silvertopstraat
651,Kolonel Silvertopstraat 5333,2022-11-30,02:00:00,10,5,5,FMN 03 Kolonel Silvertopstraat
651,Kolonel Silvertopstraat 5333,2022-11-30,03:00:00,5,0,5,FMN 03 Kolonel Silvertopstraat
651,Kolonel Silvertopstraat 5333,2022-11-30,04:00:00,30,25,5,FMN 03 Kolonel Silvertopstraat
651,Kolonel Silvertopstraat 5333,2022-11-30,05:00:00,54,33,21,FMN 03 Kolonel Silvertopstraat
651,Kolonel Silvertopstraat 5333,2022-11-30,06:00:00,121,101,20,FMN 03 Kolonel Silvertopstraat
651,Kolonel Silvertopstraat 5333,2022-11-30,07:00:00,293,246,47,FMN 03 Kolonel Silvertopstraat
651,Kolonel Silvertopstraat 5333,2022-11-30,08:00:00,631,544,87,FMN 03 Kolonel Silvertopstraat
651,Kolonel Silvertopstraat 5333,2022-11-30,09:00:00,190,158,32,FMN 03 Kolonel Silvertopstraat
651,Kolonel Silvertopstraat 5333,2022-11-30,10:00:00,154,126,28,FMN 03 Kolonel Silvertopstraat
651,Kolonel Silvertopstraat 5333,2022-11-30,11:00:00,153,105,48,FMN 03 Kolonel Silvertopstraat
651,Kolonel Silvertopstraat 5333,2022-11-30,12:00:00,336,212,124,FMN 03 Kolonel Silvertopstraat
651,Kolonel Silvertopstraat 5333,2022-11-30,13:00:00,257,177,80,FMN 03 Kolonel Silvertopstraat
651,Kolonel Silvertopstraat 5333,2022-11-30,14:00:00,202,137,65,FMN 03 Kolonel Silvertopstraat
651,Kolonel Silvertopstraat 5333,2022-11-30,15:00:00,206,138,68,FMN 03 Kolonel Silvertopstraat
651,Kolonel Silvertopstraat 5333,2022-11-30,16:00:00,299,202,97,FMN 03 Kolonel Silvertopstraat
651,Kolonel Silvertopstraat 5333,2022-11-30,17:00:00,333,219,114,FMN 03 Kolonel Silvertopstraat
651,Kolonel Silvertopstraat 5333,2022-11-30,18:00:00,303,201,102,FMN 03 Kolonel Silvertopstraat
651,Kolonel Silvertopstraat 5333,2022-11-30,19:00:00,186,123,63,FMN 03 Kolonel Silvertopstraat
651,Kolonel Silvertopstraat 5333,2022-11-30,20:00:00,139,87,52,FMN 03 Kolonel Silvertopstraat
651,Kolonel Silvertopstraat 5333,2022-11-30,21:00:00,85,38,47,FMN 03 Kolonel Silvertopstraat
651,Kolonel Silvertopstraat 5333,2022-11-30,22:00:00,106,55,51,FMN 03 Kolonel Silvertopstraat
651,Kolonel Silvertopstraat 5333,2022-11-30,23:00:00,74,34,40,FMN 03 Kolonel Silvertopstraat
651,Kolonel Silvertopstraat 5333,2022-12-01,00:00:00,24,11,13,FMN 03 Kolonel Silvertopstraat
651,Kolonel Silvertopstraat 5333,2022-12-01,01:00:00,14,3,11,FMN 03 Kolonel Silvertopstraat
651,Kolonel Silvertopstraat 5333,2022-12-01,02:00:00,5,3,2,FMN 03 Kolonel Silvertopstraat
651,Kolonel Silvertopstraat 5333,2022-12-01,03:00:00,11,4,7,FMN 03 Kolonel Silvertopstraat
651,Kolonel Silvertopstraat 5333,2022-12-01,04:00:00,22,15,7,FMN 03 Kolonel Silvertopstraat
651,Kolonel Silvertopstraat 5333,2022-12-01,05:00:00,64,37,27,FMN 03 Kolonel Silvertopstraat
651,Kolonel Silvertopstraat 5333,2022-12-01,06:00:00,112,92,20,FMN 03 Kolonel Silvertopstraat
651,Kolonel Silvertopstraat 5333,2022-12-01,07:00:00,347,292,55,FMN 03 Kolonel Silvertopstraat
651,Kolonel Silvertopstraat 5333,2022-12-01,08:00:00,656,558,98,FMN 03 Kolonel Silvertopstraat
651,Kolonel Silvertopstraat 5333,2022-12-01,09:00:00,265,213,52,FMN 03 Kolonel Silvertopstraat
651,Kolonel Silvertopstraat 5333,2022-12-01,10:00:00,194,145,49,FMN 03 Kolonel Silvertopstraat
651,Kolonel Silvertopstraat 5333,2022-12-01,11:00:00,167,123,44,FMN 03 Kolonel Silvertopstraat
651,Kolonel Silvertopstraat 5333,2022-12-01,12:00:00,221,147,74,FMN 03 Kolonel Silvertopstraat
651,Kolonel Silvertopstraat 5333,2022-12-01,13:00:00,228,165,63,FMN 03 Kolonel Silvertopstraat
651,Kolonel Silvertopstraat 5333,2022-12-01,14:00:00,203,133,70,FMN 03 Kolonel Silvertopstraat
651,Kolonel Silvertopstraat 5333,2022-12-01,15:00:00,373,234,139,FMN 03 Kolonel Silvertopstraat
651,Kolonel Silvertopstraat 5333,2022-12-01,16:00:00,404,251,153,FMN 03 Kolonel Silvertopstraat
651,Kolonel Silvertopstraat 5333,2022-12-01,17:00:00,301,190,111,FMN 03 Kolonel Silvertopstraat
651,Kolonel Silvertopstraat 5333,2022-12-01,18:00:00,312,184,128,FMN 03 Kolonel Silvertopstraat
651,Kolonel Silvertopstraat 5333,2022-12-01,19:00:00,210,155,55,FMN 03 Kolonel Silvertopstraat
651,Kolonel Silvertopstraat 5333,2022-12-01,20:00:00,151,97,54,FMN 03 Kolonel Silvertopstraat
651,Kolonel Silvertopstraat 5333,2022-12-01,21:00:00,135,57,78,FMN 03 Kolonel Silvertopstraat
651,Kolonel Silvertopstraat 5333,2022-12-01,22:00:00,117,50,67,FMN 03 Kolonel Silvertopstraat
651,Kolonel Silvertopstraat 5333,2022-12-01,23:00:00,71,32,39,FMN 03 Kolonel Silvertopstraat
651,Kolonel Silvertopstraat 5333,2022-12-02,00:00:00,34,16,18,FMN 03 Kolonel Silvertopstraat
651,Kolonel Silvertopstraat 5333,2022-12-02,01:00:00,15,7,8,FMN 03 Kolonel Silvertopstraat
651,Kolonel Silvertopstraat 5333,2022-12-02,02:00:00,15,3,12,FMN 03 Kolonel Silvertopstraat
651,Kolonel Silvertopstraat 5333,2022-12-02,03:00:00,6,2,4,FMN 03 Kolonel Silvertopstraat
651,Kolonel Silvertopstraat 5333,2022-12-02,04:00:00,32,21,11,FMN 03 Kolonel Silvertopstraat
651,Kolonel Silvertopstraat 5333,2022-12-02,05:00:00,50,31,19,FMN 03 Kolonel Silvertopstraat
651,Kolonel Silvertopstraat 5333,2022-12-02,06:00:00,106,86,20,FMN 03 Kolonel Silvertopstraat
651,Kolonel Silvertopstraat 5333,2022-12-02,07:00:00,314,261,53,FMN 03 Kolonel Silvertopstraat
651,Kolonel Silvertopstraat 5333,2022-12-02,08:00:00,599,507,92,FMN 03 Kolonel Silvertopstraat
651,Kolonel Silvertopstraat 5333,2022-12-02,09:00:00,210,173,37,FMN 03 Kolonel Silvertopstraat
651,Kolonel Silvertopstraat 5333,2022-12-02,10:00:00,217,172,45,FMN 03 Kolonel Silvertopstraat
651,Kolonel Silvertopstraat 5333,2022-12-02,11:00:00,149,105,44,FMN 03 Kolonel Silvertopstraat
651,Kolonel Silvertopstraat 5333,2022-12-02,12:00:00,240,173,67,FMN 03 Kolonel Silvertopstraat
651,Kolonel Silvertopstraat 5333,2022-12-02,13:00:00,196,130,66,FMN 03 Kolonel Silvertopstraat
651,Kolonel Silvertopstraat 5333,2022-12-02,14:00:00,194,129,65,FMN 03 Kolonel Silvertopstraat
651,Kolonel Silvertopstraat 5333,2022-12-02,15:00:00,374,212,162,FMN 03 Kolonel Silvertopstraat
651,Kolonel Silvertopstraat 5333,2022-12-02,16:00:00,350,227,123,FMN 03 Kolonel Silvertopstraat
651,Kolonel Silvertopstraat 5333,2022-12-02,17:00:00,308,199,109,FMN 03 Kolonel Silvertopstraat
651,Kolonel Silvertopstraat 5333,2022-12-02,18:00:00,253,165,88,FMN 03 Kolonel Silvertopstraat
651,Kolonel Silvertopstraat 5333,2022-12-02,19:00:00,199,130,69,FMN 03 Kolonel Silvertopstraat
651,Kolonel Silvertopstraat 5333,2022-12-02,20:00:00,130,81,49,FMN 03 Kolonel Silvertopstraat
651,Kolonel Silvertopstraat 5333,2022-12-02,21:00:00,106,62,44,FMN 03 Kolonel Silvertopstraat
651,Kolonel Silvertopstraat 5333,2022-12-02,22:00:00,105,50,55,FMN 03 Kolonel Silvertopstraat
651,Kolonel Silvertopstraat 5333,2022-12-02,23:00:00,70,29,41,FMN 03 Kolonel Silvertopstraat
651,Kolonel Silvertopstraat 5333,2022-12-03,00:00:00,57,25,32,FMN 03 Kolonel Silvertopstraat
651,Kolonel Silvertopstraat 5333,2022-12-03,01:00:00,31,17,14,FMN 03 Kolonel Silvertopstraat
651,Kolonel Silvertopstraat 5333,2022-12-03,02:00:00,31,6,25,FMN 03 Kolonel Silvertopstraat
651,Kolonel Silvertopstraat 5333,2022-12-03,03:00:00,19,11,8,FMN 03 Kolonel Silvertopstraat
651,Kolonel Silvertopstraat 5333,2022-12-03,04:00:00,14,7,7,FMN 03 Kolonel Silvertopstraat
651,Kolonel Silvertopstraat 5333,2022-12-03,05:00:00,25,11,14,FMN 03 Kolonel Silvertopstraat
651,Kolonel Silvertopstraat 5333,2022-12-03,06:00:00,37,28,9,FMN 03 Kolonel Silvertopstraat
651,Kolonel Silvertopstraat 5333,2022-12-03,07:00:00,40,32,8,FMN 03 Kolonel Silvertopstraat
651,Kolonel Silvertopstraat 5333,2022-12-03,08:00:00,70,47,23,FMN 03 Kolonel Silvertopstraat
651,Kolonel Silvertopstraat 5333,2022-12-03,09:00:00,124,101,23,FMN 03 Kolonel Silvertopstraat
651,Kolonel Silvertopstraat 5333,2022-12-03,10:00:00,138,105,33,FMN 03 Kolonel Silvertopstraat
651,Kolonel Silvertopstraat 5333,2022-12-03,11:00:00,152,115,37,FMN 03 Kolonel Silvertopstraat
651,Kolonel Silvertopstraat 5333,2022-12-03,12:00:00,155,104,51,FMN 03 Kolonel Silvertopstraat
651,Kolonel Silvertopstraat 5333,2022-12-03,13:00:00,176,122,54,FMN 03 Kolonel Silvertopstraat
651,Kolonel Silvertopstraat 5333,2022-12-03,14:00:00,144,107,37,FMN 03 Kolonel Silvertopstraat
651,Kolonel Silvertopstraat 5333,2022-12-03,15:00:00,158,101,57,FMN 03 Kolonel Silvertopstraat
651,Kolonel Silvertopstraat 5333,2022-12-03,16:00:00,150,96,54,FMN 03 Kolonel Silvertopstraat
651,Kolonel Silvertopstraat 5333,2022-12-03,17:00:00,187,120,67,FMN 03 Kolonel Silvertopstraat
651,Kolonel Silvertopstraat 5333,2022-12-03,18:00:00,176,115,61,FMN 03 Kolonel Silvertopstraat
651,Kolonel Silvertopstraat 5333,2022-12-03,19:00:00,167,114,53,FMN 03 Kolonel Silvertopstraat
651,Kolonel Silvertopstraat 5333,2022-12-03,20:00:00,108,71,37,FMN 03 Kolonel Silvertopstraat
651,Kolonel Silvertopstraat 5333,2022-12-03,21:00:00,57,35,22,FMN 03 Kolonel Silvertopstraat
651,Kolonel Silvertopstraat 5333,2022-12-03,22:00:00,73,30,43,FMN 03 Kolonel Silvertopstraat
651,Kolonel Silvertopstraat 5333,2022-12-03,23:00:00,92,45,47,FMN 03 Kolonel Silvertopstraat
651,Kolonel Silvertopstraat 5333,2022-12-04,00:00:00,51,21,30,FMN 03 Kolonel Silvertopstraat
651,Kolonel Silvertopstraat 5333,2022-12-04,01:00:00,52,18,34,FMN 03 Kolonel Silvertopstraat
651,Kolonel Silvertopstraat 5333,2022-12-04,02:00:00,24,5,19,FMN 03 Kolonel Silvertopstraat
651,Kolonel Silvertopstraat 5333,2022-12-04,03:00:00,25,6,19,FMN 03 Kolonel Silvertopstraat
651,Kolonel Silvertopstraat 5333,2022-12-04,04:00:00,15,6,9,FMN 03 Kolonel Silvertopstraat
651,Kolonel Silvertopstraat 5333,2022-12-04,05:00:00,14,8,6,FMN 03 Kolonel Silvertopstraat
651,Kolonel Silvertopstraat 5333,2022-12-04,06:00:00,29,19,10,FMN 03 Kolonel Silvertopstraat
651,Kolonel Silvertopstraat 5333,2022-12-04,07:00:00,27,13,14,FMN 03 Kolonel Silvertopstraat
651,Kolonel Silvertopstraat 5333,2022-12-04,08:00:00,25,19,6,FMN 03 Kolonel Silvertopstraat
651,Kolonel Silvertopstraat 5333,2022-12-04,09:00:00,83,66,17,FMN 03 Kolonel Silvertopstraat
651,Kolonel Silvertopstraat 5333,2022-12-04,10:00:00,83,66,17,FMN 03 Kolonel Silvertopstraat
651,Kolonel Silvertopstraat 5333,2022-12-04,11:00:00,97,80,17,FMN 03 Kolonel Silvertopstraat
651,Kolonel Silvertopstraat 5333,2022-12-04,12:00:00,99,68,31,FMN 03 Kolonel Silvertopstraat
651,Kolonel Silvertopstraat 5333,2022-12-04,13:00:00,134,91,43,FMN 03 Kolonel Silvertopstraat
651,Kolonel Silvertopstraat 5333,2022-12-04,14:00:00,133,93,40,FMN 03 Kolonel Silvertopstraat
651,Kolonel Silvertopstraat 5333,2022-12-04,15:00:00,104,70,34,FMN 03 Kolonel Silvertopstraat
651,Kolonel Silvertopstraat 5333,2022-12-04,16:00:00,117,68,49,FMN 03 Kolonel Silvertopstraat
651,Kolonel Silvertopstraat 5333,2022-12-04,17:00:00,125,73,52,FMN 03 Kolonel Silvertopstraat
651,Kolonel Silvertopstraat 5333,2022-12-04,18:00:00,115,65,50,FMN 03 Kolonel Silvertopstraat
651,Kolonel Silvertopstraat 5333,2022-12-04,19:00:00,103,68,35,FMN 03 Kolonel Silvertopstraat
651,Kolonel Silvertopstraat 5333,2022-12-04,20:00:00,76,35,41,FMN 03 Kolonel Silvertopstraat
651,Kolonel Silvertopstraat 5333,2022-12-04,21:00:00,64,31,33,FMN 03 Kolonel Silvertopstraat
651,Kolonel Silvertopstraat 5333,2022-12-04,22:00:00,72,38,34,FMN 03 Kolonel Silvertopstraat
651,Kolonel Silvertopstraat 5333,2022-12-04,23:00:00,28,11,17,FMN 03 Kolonel Silvertopstraat
651,Kolonel Silvertopstraat 5333,2022-12-05,00:00:00,20,8,12,FMN 03 Kolonel Silvertopstraat
651,Kolonel Silvertopstraat 5333,2022-12-05,01:00:00,8,3,5,FMN 03 Kolonel Silvertopstraat
651,Kolonel Silvertopstraat 5333,2022-12-05,02:00:00,5,2,3,FMN 03 Kolonel Silvertopstraat
651,Kolonel Silvertopstraat 5333,2022-12-05,03:00:00,5,4,1,FMN 03 Kolonel Silvertopstraat
651,Kolonel Silvertopstraat 5333,2022-12-05,04:00:00,17,13,4,FMN 03 Kolonel Silvertopstraat
651,Kolonel Silvertopstraat 5333,2022-12-05,05:00:00,41,25,16,FMN 03 Kolonel Silvertopstraat
651,Kolonel Silvertopstraat 5333,2022-12-05,06:00:00,107,87,20,FMN 03 Kolonel Silvertopstraat
651,Kolonel Silvertopstraat 5333,2022-12-05,07:00:00,284,220,64,FMN 03 Kolonel Silvertopstraat
651,Kolonel Silvertopstraat 5333,2022-12-05,08:00:00,601,510,91,FMN 03 Kolonel Silvertopstraat
651,Kolonel Silvertopstraat 5333,2022-12-05,09:00:00,195,155,40,FMN 03 Kolonel Silvertopstraat
651,Kolonel Silvertopstraat 5333,2022-12-05,10:00:00,109,83,26,FMN 03 Kolonel Silvertopstraat
651,Kolonel Silvertopstraat 5333,2022-12-05,11:00:00,108,78,30,FMN 03 Kolonel Silvertopstraat
651,Kolonel Silvertopstraat 5333,2022-12-05,12:00:00,139,96,43,FMN 03 Kolonel Silvertopstraat
651,Kolonel Silvertopstraat 5333,2022-12-05,13:00:00,146,103,43,FMN 03 Kolonel Silvertopstraat
651,Kolonel Silvertopstraat 5333,2022-12-05,14:00:00,158,100,58,FMN 03 Kolonel Silvertopstraat
651,Kolonel Silvertopstraat 5333,2022-12-05,15:00:00,268,166,102,FMN 03 Kolonel Silvertopstraat
651,Kolonel Silvertopstraat 5333,2022-12-05,16:00:00,333,204,129,FMN 03 Kolonel Silvertopstraat
651,Kolonel Silvertopstraat 5333,2022-12-05,17:00:00,322,207,115,FMN 03 Kolonel Silvertopstraat
651,Kolonel Silvertopstraat 5333,2022-12-05,18:00:00,239,157,82,FMN 03 Kolonel Silvertopstraat
651,Kolonel Silvertopstraat 5333,2022-12-05,19:00:00,137,88,49,FMN 03 Kolonel Silvertopstraat
651,Kolonel Silvertopstraat 5333,2022-12-05,20:00:00,116,62,54,FMN 03 Kolonel Silvertopstraat
651,Kolonel Silvertopstraat 5333,2022-12-05,21:00:00,83,34,49,FMN 03 Kolonel Silvertopstraat
651,Kolonel Silvertopstraat 5333,2022-12-05,22:00:00,78,50,28,FMN 03 Kolonel Silvertopstraat
651,Kolonel Silvertopstraat 5333,2022-12-05,23:00:00,25,14,11,FMN 03 Kolonel Silvertopstraat
651,Kolonel Silvertopstraat 5333,2022-12-06,00:00:00,22,15,7,FMN 03 Kolonel Silvertopstraat
651,Kolonel Silvertopstraat 5333,2022-12-06,01:00:00,5,2,3,FMN 03 Kolonel Silvertopstraat
651,Kolonel Silvertopstraat 5333,2022-12-06,02:00:00,8,2,6,FMN 03 Kolonel Silvertopstraat
651,Kolonel Silvertopstraat 5333,2022-12-06,03:00:00,5,3,2,FMN 03 Kolonel Silvertopstraat
651,Kolonel Silvertopstraat 5333,2022-12-06,04:00:00,20,15,5,FMN 03 Kolonel Silvertopstraat
651,Kolonel Silvertopstraat 5333,2022-12-06,05:00:00,40,28,12,FMN 03 Kolonel Silvertopstraat
651,Kolonel Silvertopstraat 5333,2022-12-06,06:00:00,149,123,26,FMN 03 Kolonel Silvertopstraat
651,Kolonel Silvertopstraat 5333,2022-12-06,07:00:00,329,274,55,FMN 03 Kolonel Silvertopstraat
651,Kolonel Silvertopstraat 5333,2022-12-06,08:00:00,624,535,89,FMN 03 Kolonel Silvertopstraat
651,Kolonel Silvertopstraat 5333,2022-12-06,09:00:00,261,201,60,FMN 03 Kolonel Silvertopstraat
651,Kolonel Silvertopstraat 5333,2022-12-06,10:00:00,166,125,41,FMN 03 Kolonel Silvertopstraat
651,Kolonel Silvertopstraat 5333,2022-12-06,11:00:00,147,104,43,FMN 03 Kolonel Silvertopstraat
651,Kolonel Silvertopstraat 5333,2022-12-06,12:00:00,232,166,66,FMN 03 Kolonel Silvertopstraat
651,Kolonel Silvertopstraat 5333,2022-12-06,13:00:00,236,157,79,FMN 03 Kolonel Silvertopstraat
651,Kolonel Silvertopstraat 5333,2022-12-06,14:00:00,189,125,64,FMN 03 Kolonel Silvertopstraat
651,Kolonel Silvertopstraat 5333,2022-12-06,15:00:00,326,194,132,FMN 03 Kolonel Silvertopstraat
651,Kolonel Silvertopstraat 5333,2022-12-06,16:00:00,355,219,136,FMN 03 Kolonel Silvertopstraat
651,Kolonel Silvertopstraat 5333,2022-12-06,17:00:00,373,221,152,FMN 03 Kolonel Silvertopstraat
651,Kolonel Silvertopstraat 5333,2022-12-06,18:00:00,265,159,106,FMN 03 Kolonel Silvertopstraat
651,Kolonel Silvertopstraat 5333,2022-12-06,19:00:00,214,124,90,FMN 03 Kolonel Silvertopstraat
651,Kolonel Silvertopstraat 5333,2022-12-06,20:00:00,144,90,54,FMN 03 Kolonel Silvertopstraat
651,Kolonel Silvertopstraat 5333,2022-12-06,21:00:00,118,61,57,FMN 03 Kolonel Silvertopstraat
651,Kolonel Silvertopstraat 5333,2022-12-06,22:00:00,107,54,53,FMN 03 Kolonel Silvertopstraat
651,Kolonel Silvertopstraat 5333,2022-12-06,23:00:00,48,20,28,FMN 03 Kolonel Silvertopstraat
651,Kolonel Silvertopstraat 5333,2022-12-07,00:00:00,22,9,13,FMN 03 Kolonel Silvertopstraat
651,Kolonel Silvertopstraat 5333,2022-12-07,01:00:00,10,7,3,FMN 03 Kolonel Silvertopstraat
651,Kolonel Silvertopstraat 5333,2022-12-07,02:00:00,7,4,3,FMN 03 Kolonel Silvertopstraat
651,Kolonel Silvertopstraat 5333,2022-12-07,03:00:00,6,4,2,FMN 03 Kolonel Silvertopstraat
651,Kolonel Silvertopstraat 5333,2022-12-07,04:00:00,23,18,5,FMN 03 Kolonel Silvertopstraat
651,Kolonel Silvertopstraat 5333,2022-12-07,05:00:00,46,32,14,FMN 03 Kolonel Silvertopstraat
651,Kolonel Silvertopstraat 5333,2022-12-07,06:00:00,103,93,10,FMN 03 Kolonel Silvertopstraat
651,Kolonel Silvertopstraat 5333,2022-12-07,07:00:00,261,212,49,FMN 03 Kolonel Silvertopstraat
651,Kolonel Silvertopstraat 5333,2022-12-07,08:00:00,532,439,93,FMN 03 Kolonel Silvertopstraat
651,Kolonel Silvertopstraat 5333,2022-12-07,09:00:00,205,166,39,FMN 03 Kolonel Silvertopstraat
651,Kolonel Silvertopstraat 5333,2022-12-07,10:00:00,163,117,46,FMN 03 Kolonel Silvertopstraat
651,Kolonel Silvertopstraat 5333,2022-12-07,11:00:00,156,114,42,FMN 03 Kolonel Silvertopstraat
651,Kolonel Silvertopstraat 5333,2022-12-07,12:00:00,308,212,96,FMN 03 Kolonel Silvertopstraat
651,Kolonel Silvertopstraat 5333,2022-12-07,13:00:00,202,134,68,FMN 03 Kolonel Silvertopstraat
651,Kolonel Silvertopstraat 5333,2022-12-07,14:00:00,170,102,68,FMN 03 Kolonel Silvertopstraat
651,Kolonel Silvertopstraat 5333,2022-12-07,15:00:00,195,130,65,FMN 03 Kolonel Silvertopstraat
651,Kolonel Silvertopstraat 5333,2022-12-07,16:00:00,282,202,80,FMN 03 Kolonel Silvertopstraat
651,Kolonel Silvertopstraat 5333,2022-12-07,17:00:00,295,181,114,FMN 03 Kolonel Silvertopstraat
651,Kolonel Silvertopstraat 5333,2022-12-07,18:00:00,231,141,90,FMN 03 Kolonel Silvertopstraat
651,Kolonel Silvertopstraat 5333,2022-12-07,19:00:00,185,120,65,FMN 03 Kolonel Silvertopstraat
651,Kolonel Silvertopstraat 5333,2022-12-07,20:00:00,123,71,52,FMN 03 Kolonel Silvertopstraat
651,Kolonel Silvertopstraat 5333,2022-12-07,21:00:00,80,42,38,FMN 03 Kolonel Silvertopstraat
651,Kolonel Silvertopstraat 5333,2022-12-07,22:00:00,97,49,48,FMN 03 Kolonel Silvertopstraat
651,Kolonel Silvertopstraat 5333,2022-12-07,23:00:00,53,28,25,FMN 03 Kolonel Silvertopstraat
651,Kolonel Silvertopstraat 5333,2022-12-08,00:00:00,22,11,11,FMN 03 Kolonel Silvertopstraat
651,Kolonel Silvertopstraat 5333,2022-12-08,01:00:00,12,4,8,FMN 03 Kolonel Silvertopstraat
651,Kolonel Silvertopstraat 5333,2022-12-08,02:00:00,7,2,5,FMN 03 Kolonel Silvertopstraat
651,Kolonel Silvertopstraat 5333,2022-12-08,03:00:00,8,5,3,FMN 03 Kolonel Silvertopstraat
651,Kolonel Silvertopstraat 5333,2022-12-08,04:00:00,18,16,2,FMN 03 Kolonel Silvertopstraat
651,Kolonel Silvertopstraat 5333,2022-12-08,05:00:00,50,33,17,FMN 03 Kolonel Silvertopstraat
651,Kolonel Silvertopstraat 5333,2022-12-08,06:00:00,102,89,13,FMN 03 Kolonel Silvertopstraat
651,Kolonel Silvertopstraat 5333,2022-12-08,07:00:00,302,250,52,FMN 03 Kolonel Silvertopstraat
651,Kolonel Silvertopstraat 5333,2022-12-08,08:00:00,601,513,88,FMN 03 Kolonel Silvertopstraat
651,Kolonel Silvertopstraat 5333,2022-12-08,09:00:00,221,172,49,FMN 03 Kolonel Silvertopstraat
651,Kolonel Silvertopstraat 5333,2022-12-08,10:00:00,198,151,47,FMN 03 Kolonel Silvertopstraat
651,Kolonel Silvertopstraat 5333,2022-12-08,11:00:00,155,104,51,FMN 03 Kolonel Silvertopstraat
651,Kolonel Silvertopstraat 5333,2022-12-08,12:00:00,229,156,73,FMN 03 Kolonel Silvertopstraat
651,Kolonel Silvertopstraat 5333,2022-12-08,13:00:00,164,117,47,FMN 03 Kolonel Silvertopstraat
651,Kolonel Silvertopstraat 5333,2022-12-08,14:00:00,144,82,62,FMN 03 Kolonel Silvertopstraat
651,Kolonel Silvertopstraat 5333,2022-12-08,15:00:00,242,149,93,FMN 03 Kolonel Silvertopstraat
651,Kolonel Silvertopstraat 5333,2022-12-08,16:00:00,357,235,122,FMN 03 Kolonel Silvertopstraat
651,Kolonel Silvertopstraat 5333,2022-12-08,17:00:00,373,231,142,FMN 03 Kolonel Silvertopstraat
651,Kolonel Silvertopstraat 5333,2022-12-08,18:00:00,261,151,110,FMN 03 Kolonel Silvertopstraat
651,Kolonel Silvertopstraat 5333,2022-12-08,19:00:00,174,116,58,FMN 03 Kolonel Silvertopstraat
651,Kolonel Silvertopstraat 5333,2022-12-08,20:00:00,125,77,48,FMN 03 Kolonel Silvertopstraat
651,Kolonel Silvertopstraat 5333,2022-12-08,21:00:00,106,40,66,FMN 03 Kolonel Silvertopstraat
651,Kolonel Silvertopstraat 5333,2022-12-08,22:00:00,109,56,53,FMN 03 Kolonel Silvertopstraat
651,Kolonel Silvertopstraat 5333,2022-12-08,23:00:00,60,23,37,FMN 03 Kolonel Silvertopstraat
651,Kolonel Silvertopstraat 5333,2022-12-09,00:00:00,32,17,15,FMN 03 Kolonel Silvertopstraat
651,Kolonel Silvertopstraat 5333,2022-12-09,01:00:00,21,7,14,FMN 03 Kolonel Silvertopstraat
651,Kolonel Silvertopstraat 5333,2022-12-09,02:00:00,10,2,8,FMN 03 Kolonel Silvertopstraat
651,Kolonel Silvertopstraat 5333,2022-12-09,03:00:00,12,6,6,FMN 03 Kolonel Silvertopstraat
651,Kolonel Silvertopstraat 5333,2022-12-09,04:00:00,19,15,4,FMN 03 Kolonel Silvertopstraat
651,Kolonel Silvertopstraat 5333,2022-12-09,05:00:00,31,21,10,FMN 03 Kolonel Silvertopstraat
651,Kolonel Silvertopstraat 5333,2022-12-09,06:00:00,96,78,18,FMN 03 Kolonel Silvertopstraat
651,Kolonel Silvertopstraat 5333,2022-12-09,07:00:00,241,199,42,FMN 03 Kolonel Silvertopstraat
651,Kolonel Silvertopstraat 5333,2022-12-09,08:00:00,495,410,85,FMN 03 Kolonel Silvertopstraat
651,Kolonel Silvertopstraat 5333,2022-12-09,09:00:00,194,153,41,FMN 03 Kolonel Silvertopstraat
651,Kolonel Silvertopstraat 5333,2022-12-09,10:00:00,205,154,51,FMN 03 Kolonel Silvertopstraat
651,Kolonel Silvertopstraat 5333,2022-12-09,11:00:00,142,101,41,FMN 03 Kolonel Silvertopstraat
651,Kolonel Silvertopstraat 5333,2022-12-09,12:00:00,201,140,61,FMN 03 Kolonel Silvertopstraat
651,Kolonel Silvertopstraat 5333,2022-12-09,13:00:00,192,129,63,FMN 03 Kolonel Silvertopstraat
651,Kolonel Silvertopstraat 5333,2022-12-09,14:00:00,211,139,72,FMN 03 Kolonel Silvertopstraat
651,Kolonel Silvertopstraat 5333,2022-12-09,15:00:00,261,163,98,FMN 03 Kolonel Silvertopstraat
651,Kolonel Silvertopstraat 5333,2022-12-09,16:00:00,305,194,111,FMN 03 Kolonel Silvertopstraat
651,Kolonel Silvertopstraat 5333,2022-12-09,17:00:00,291,181,110,FMN 03 Kolonel Silvertopstraat
651,Kolonel Silvertopstraat 5333,2022-12-09,18:00:00,256,167,89,FMN 03 Kolonel Silvertopstraat
651,Kolonel Silvertopstraat 5333,2022-12-09,19:00:00,170,115,55,FMN 03 Kolonel Silvertopstraat
651,Kolonel Silvertopstraat 5333,2022-12-09,20:00:00,139,78,61,FMN 03 Kolonel Silvertopstraat
651,Kolonel Silvertopstraat 5333,2022-12-09,21:00:00,86,54,32,FMN 03 Kolonel Silvertopstraat
651,Kolonel Silvertopstraat 5333,2022-12-09,22:00:00,80,44,36,FMN 03 Kolonel Silvertopstraat
651,Kolonel Silvertopstraat 5333,2022-12-09,23:00:00,73,34,39,FMN 03 Kolonel Silvertopstraat
651,Kolonel Silvertopstraat 5333,2022-12-10,00:00:00,65,32,33,FMN 03 Kolonel Silvertopstraat
651,Kolonel Silvertopstraat 5333,2022-12-10,01:00:00,36,12,24,FMN 03 Kolonel Silvertopstraat
651,Kolonel Silvertopstraat 5333,2022-12-10,02:00:00,24,8,16,FMN 03 Kolonel Silvertopstraat
651,Kolonel Silvertopstraat 5333,2022-12-10,03:00:00,20,2,18,FMN 03 Kolonel Silvertopstraat
651,Kolonel Silvertopstraat 5333,2022-12-10,04:00:00,12,0,12,FMN 03 Kolonel Silvertopstraat
651,Kolonel Silvertopstraat 5333,2022-12-10,05:00:00,15,11,4,FMN 03 Kolonel Silvertopstraat
651,Kolonel Silvertopstraat 5333,2022-12-10,06:00:00,18,12,6,FMN 03 Kolonel Silvertopstraat
651,Kolonel Silvertopstraat 5333,2022-12-10,07:00:00,30,16,14,FMN 03 Kolonel Silvertopstraat
651,Kolonel Silvertopstraat 5333,2022-12-10,08:00:00,68,54,14,FMN 03 Kolonel Silvertopstraat
651,Kolonel Silvertopstraat 5333,2022-12-10,09:00:00,83,72,11,FMN 03 Kolonel Silvertopstraat
651,Kolonel Silvertopstraat 5333,2022-12-10,10:00:00,123,96,27,FMN 03 Kolonel Silvertopstraat
651,Kolonel Silvertopstraat 5333,2022-12-10,11:00:00,124,93,31,FMN 03 Kolonel Silvertopstraat
651,Kolonel Silvertopstraat 5333,2022-12-10,12:00:00,97,63,34,FMN 03 Kolonel Silvertopstraat
651,Kolonel Silvertopstraat 5333,2022-12-10,13:00:00,143,99,44,FMN 03 Kolonel Silvertopstraat
651,Kolonel Silvertopstraat 5333,2022-12-10,14:00:00,148,98,50,FMN 03 Kolonel Silvertopstraat
651,Kolonel Silvertopstraat 5333,2022-12-10,15:00:00,154,107,47,FMN 03 Kolonel Silvertopstraat
651,Kolonel Silvertopstraat 5333,2022-12-10,16:00:00,133,86,47,FMN 03 Kolonel Silvertopstraat
651,Kolonel Silvertopstraat 5333,2022-12-10,17:00:00,133,87,46,FMN 03 Kolonel Silvertopstraat
651,Kolonel Silvertopstraat 5333,2022-12-10,18:00:00,134,88,46,FMN 03 Kolonel Silvertopstraat
651,Kolonel Silvertopstraat 5333,2022-12-10,19:00:00,124,86,38,FMN 03 Kolonel Silvertopstraat
651,Kolonel Silvertopstraat 5333,2022-12-10,20:00:00,94,55,39,FMN 03 Kolonel Silvertopstraat
651,Kolonel Silvertopstraat 5333,2022-12-10,21:00:00,68,40,28,FMN 03 Kolonel Silvertopstraat
651,Kolonel Silvertopstraat 5333,2022-12-10,22:00:00,72,30,42,FMN 03 Kolonel Silvertopstraat
651,Kolonel Silvertopstraat 5333,2022-12-10,23:00:00,62,29,33,FMN 03 Kolonel Silvertopstraat
651,Kolonel Silvertopstraat 5333,2022-12-11,00:00:00,41,11,30,FMN 03 Kolonel Silvertopstraat
651,Kolonel Silvertopstraat 5333,2022-12-11,01:00:00,33,10,23,FMN 03 Kolonel Silvertopstraat
651,Kolonel Silvertopstraat 5333,2022-12-11,02:00:00,29,12,17,FMN 03 Kolonel Silvertopstraat
651,Kolonel Silvertopstraat 5333,2022-12-11,03:00:00,15,4,11,FMN 03 Kolonel Silvertopstraat
651,Kolonel Silvertopstraat 5333,2022-12-11,04:00:00,13,1,12,FMN 03 Kolonel Silvertopstraat
651,Kolonel Silvertopstraat 5333,2022-12-11,05:00:00,14,3,11,FMN 03 Kolonel Silvertopstraat
651,Kolonel Silvertopstraat 5333,2022-12-11,06:00:00,24,19,5,FMN 03 Kolonel Silvertopstraat
651,Kolonel Silvertopstraat 5333,2022-12-11,07:00:00,10,8,2,FMN 03 Kolonel Silvertopstraat
651,Kolonel Silvertopstraat 5333,2022-12-11,08:00:00,40,33,7,FMN 03 Kolonel Silvertopstraat
651,Kolonel Silvertopstraat 5333,2022-12-11,09:00:00,59,47,12,FMN 03 Kolonel Silvertopstraat
651,Kolonel Silvertopstraat 5333,2022-12-11,10:00:00,74,55,19,FMN 03 Kolonel Silvertopstraat
651,Kolonel Silvertopstraat 5333,2022-12-11,11:00:00,75,59,16,FMN 03 Kolonel Silvertopstraat
651,Kolonel Silvertopstraat 5333,2022-12-11,12:00:00,91,67,24,FMN 03 Kolonel Silvertopstraat
651,Kolonel Silvertopstraat 5333,2022-12-11,13:00:00,108,76,32,FMN 03 Kolonel Silvertopstraat
651,Kolonel Silvertopstraat 5333,2022-12-11,14:00:00,116,85,31,FMN 03 Kolonel Silvertopstraat
651,Kolonel Silvertopstraat 5333,2022-12-11,15:00:00,125,75,50,FMN 03 Kolonel Silvertopstraat
651,Kolonel Silvertopstraat 5333,2022-12-11,16:00:00,161,87,74,FMN 03 Kolonel Silvertopstraat
651,Kolonel Silvertopstraat 5333,2022-12-11,17:00:00,110,52,58,FMN 03 Kolonel Silvertopstraat
651,Kolonel Silvertopstraat 5333,2022-12-11,18:00:00,111,68,43,FMN 03 Kolonel Silvertopstraat
651,Kolonel Silvertopstraat 5333,2022-12-11,19:00:00,123,90,33,FMN 03 Kolonel Silvertopstraat
651,Kolonel Silvertopstraat 5333,2022-12-11,20:00:00,68,38,30,FMN 03 Kolonel Silvertopstraat
651,Kolonel Silvertopstraat 5333,2022-12-11,21:00:00,71,37,34,FMN 03 Kolonel Silvertopstraat
651,Kolonel Silvertopstraat 5333,2022-12-11,22:00:00,40,19,21,FMN 03 Kolonel Silvertopstraat
651,Kolonel Silvertopstraat 5333,2022-12-11,23:00:00,27,15,12,FMN 03 Kolonel Silvertopstraat
651,Kolonel Silvertopstraat 5333,2022-12-12,00:00:00,10,3,7,FMN 03 Kolonel Silvertopstraat
651,Kolonel Silvertopstraat 5333,2022-12-12,01:00:00,10,5,5,FMN 03 Kolonel Silvertopstraat
651,Kolonel Silvertopstraat 5333,2022-12-12,02:00:00,4,2,2,FMN 03 Kolonel Silvertopstraat
651,Kolonel Silvertopstraat 5333,2022-12-12,03:00:00,6,2,4,FMN 03 Kolonel Silvertopstraat
651,Kolonel Silvertopstraat 5333,2022-12-12,04:00:00,14,9,5,FMN 03 Kolonel Silvertopstraat
651,Kolonel Silvertopstraat 5333,2022-12-12,05:00:00,34,16,18,FMN 03 Kolonel Silvertopstraat
651,Kolonel Silvertopstraat 5333,2022-12-12,06:00:00,77,64,13,FMN 03 Kolonel Silvertopstraat
651,Kolonel Silvertopstraat 5333,2022-12-12,07:00:00,269,218,51,FMN 03 Kolonel Silvertopstraat
651,Kolonel Silvertopstraat 5333,2022-12-12,08:00:00,488,411,77,FMN 03 Kolonel Silvertopstraat
651,Kolonel Silvertopstraat 5333,2022-12-12,09:00:00,134,103,31,FMN 03 Kolonel Silvertopstraat
651,Kolonel Silvertopstraat 5333,2022-12-12,10:00:00,160,121,39,FMN 03 Kolonel Silvertopstraat
651,Kolonel Silvertopstraat 5333,2022-12-12,11:00:00,88,62,26,FMN 03 Kolonel Silvertopstraat
651,Kolonel Silvertopstraat 5333,2022-12-12,12:00:00,165,98,67,FMN 03 Kolonel Silvertopstraat
651,Kolonel Silvertopstraat 5333,2022-12-12,13:00:00,137,92,45,FMN 03 Kolonel Silvertopstraat
651,Kolonel Silvertopstraat 5333,2022-12-12,14:00:00,106,75,31,FMN 03 Kolonel Silvertopstraat
651,Kolonel Silvertopstraat 5333,2022-12-12,15:00:00,199,133,66,FMN 03 Kolonel Silvertopstraat
651,Kolonel Silvertopstraat 5333,2022-12-12,16:00:00,296,201,95,FMN 03 Kolonel Silvertopstraat
651,Kolonel Silvertopstraat 5333,2022-12-12,17:00:00,271,167,104,FMN 03 Kolonel Silvertopstraat
651,Kolonel Silvertopstraat 5333,2022-12-12,18:00:00,214,124,90,FMN 03 Kolonel Silvertopstraat
651,Kolonel Silvertopstraat 5333,2022-12-12,19:00:00,101,53,48,FMN 03 Kolonel Silvertopstraat
651,Kolonel Silvertopstraat 5333,2022-12-12,20:00:00,97,51,46,FMN 03 Kolonel Silvertopstraat
651,Kolonel Silvertopstraat 5333,2022-12-12,21:00:00,66,29,37,FMN 03 Kolonel Silvertopstraat
651,Kolonel Silvertopstraat 5333,2022-12-12,22:00:00,59,27,32,FMN 03 Kolonel Silvertopstraat
651,Kolonel Silvertopstraat 5333,2022-12-12,23:00:00,32,20,12,FMN 03 Kolonel Silvertopstraat
651,Kolonel Silvertopstraat 5333,2022-12-13,00:00:00,17,5,12,FMN 03 Kolonel Silvertopstraat
651,Kolonel Silvertopstraat 5333,2022-12-13,01:00:00,4,1,3,FMN 03 Kolonel Silvertopstraat
651,Kolonel Silvertopstraat 5333,2022-12-13,02:00:00,5,2,3,FMN 03 Kolonel Silvertopstraat
651,Kolonel Silvertopstraat 5333,2022-12-13,03:00:00,3,1,2,FMN 03 Kolonel Silvertopstraat
651,Kolonel Silvertopstraat 5333,2022-12-13,04:00:00,7,7,0,FMN 03 Kolonel Silvertopstraat
651,Kolonel Silvertopstraat 5333,2022-12-13,05:00:00,2,1,1,FMN 03 Kolonel Silvertopstraat
651,Kolonel Silvertopstraat 5333,2022-12-13,06:00:00,48,38,10,FMN 03 Kolonel Silvertopstraat
651,Kolonel Silvertopstraat 5333,2022-12-13,07:00:00,7,2,5,FMN 03 Kolonel Silvertopstraat
651,Kolonel Silvertopstraat 5333,2022-12-13,08:00:00,186,141,45,FMN 03 Kolonel Silvertopstraat
651,Kolonel Silvertopstraat 5333,2022-12-13,09:00:00,20,8,12,FMN 03 Kolonel Silvertopstraat
651,Kolonel Silvertopstraat 5333,2022-12-13,10:00:00,139,96,43,FMN 03 Kolonel Silvertopstraat
651,Kolonel Silvertopstraat 5333,2022-12-13,11:00:00,96,58,38,FMN 03 Kolonel Silvertopstraat
651,Kolonel Silvertopstraat 5333,2022-12-13,12:00:00,132,86,46,FMN 03 Kolonel Silvertopstraat
651,Kolonel Silvertopstraat 5333,2022-12-13,13:00:00,133,92,41,FMN 03 Kolonel Silvertopstraat
651,Kolonel Silvertopstraat 5333,2022-12-13,14:00:00,125,80,45,FMN 03 Kolonel Silvertopstraat
651,Kolonel Silvertopstraat 5333,2022-12-13,15:00:00,203,136,67,FMN 03 Kolonel Silvertopstraat
651,Kolonel Silvertopstraat 5333,2022-12-13,16:00:00,228,143,85,FMN 03 Kolonel Silvertopstraat
651,Kolonel Silvertopstraat 5333,2022-12-13,17:00:00,269,156,113,FMN 03 Kolonel Silvertopstraat
651,Kolonel Silvertopstraat 5333,2022-12-13,18:00:00,191,113,78,FMN 03 Kolonel Silvertopstraat
651,Kolonel Silvertopstraat 5333,2022-12-13,19:00:00,118,60,58,FMN 03 Kolonel Silvertopstraat
651,Kolonel Silvertopstraat 5333,2022-12-13,20:00:00,77,40,37,FMN 03 Kolonel Silvertopstraat
651,Kolonel Silvertopstraat 5333,2022-12-13,21:00:00,75,33,42,FMN 03 Kolonel Silvertopstraat
651,Kolonel Silvertopstraat 5333,2022-12-13,22:00:00,76,36,40,FMN 03 Kolonel Silvertopstraat
651,Kolonel Silvertopstraat 5333,2022-12-13,23:00:00,28,8,20,FMN 03 Kolonel Silvertopstraat
651,Kolonel Silvertopstraat 5333,2022-12-14,00:00:00,10,4,6,FMN 03 Kolonel Silvertopstraat
651,Kolonel Silvertopstraat 5333,2022-12-14,01:00:00,5,1,4,FMN 03 Kolonel Silvertopstraat
651,Kolonel Silvertopstraat 5333,2022-12-14,02:00:00,3,2,1,FMN 03 Kolonel Silvertopstraat
651,Kolonel Silvertopstraat 5333,2022-12-14,03:00:00,4,3,1,FMN 03 Kolonel Silvertopstraat
651,Kolonel Silvertopstraat 5333,2022-12-14,04:00:00,16,12,4,FMN 03 Kolonel Silvertopstraat
651,Kolonel Silvertopstraat 5333,2022-12-14,05:00:00,36,19,17,FMN 03 Kolonel Silvertopstraat
651,Kolonel Silvertopstraat 5333,2022-12-14,06:00:00,67,50,17,FMN 03 Kolonel Silvertopstraat
651,Kolonel Silvertopstraat 5333,2022-12-14,07:00:00,184,138,46,FMN 03 Kolonel Silvertopstraat
651,Kolonel Silvertopstraat 5333,2022-12-14,08:00:00,384,317,67,FMN 03 Kolonel Silvertopstraat
651,Kolonel Silvertopstraat 5333,2022-12-14,09:00:00,122,85,37,FMN 03 Kolonel Silvertopstraat
651,Kolonel Silvertopstraat 5333,2022-12-14,10:00:00,142,95,47,FMN 03 Kolonel Silvertopstraat
651,Kolonel Silvertopstraat 5333,2022-12-14,11:00:00,117,72,45,FMN 03 Kolonel Silvertopstraat
651,Kolonel Silvertopstraat 5333,2022-12-14,12:00:00,174,100,74,FMN 03 Kolonel Silvertopstraat
651,Kolonel Silvertopstraat 5333,2022-12-14,13:00:00,157,101,56,FMN 03 Kolonel Silvertopstraat
651,Kolonel Silvertopstraat 5333,2022-12-14,14:00:00,135,88,47,FMN 03 Kolonel Silvertopstraat
651,Kolonel Silvertopstraat 5333,2022-12-14,15:00:00,168,100,68,FMN 03 Kolonel Silvertopstraat
651,Kolonel Silvertopstraat 5333,2022-12-14,16:00:00,202,135,67,FMN 03 Kolonel Silvertopstraat
651,Kolonel Silvertopstraat 5333,2022-12-14,17:00:00,259,167,92,FMN 03 Kolonel Silvertopstraat
651,Kolonel Silvertopstraat 5333,2022-12-14,18:00:00,194,119,75,FMN 03 Kolonel Silvertopstraat
651,Kolonel Silvertopstraat 5333,2022-12-14,19:00:00,124,70,54,FMN 03 Kolonel Silvertopstraat
651,Kolonel Silvertopstraat 5333,2022-12-14,20:00:00,82,51,31,FMN 03 Kolonel Silvertopstraat
651,Kolonel Silvertopstraat 5333,2022-12-14,21:00:00,42,17,25,FMN 03 Kolonel Silvertopstraat
651,Kolonel Silvertopstraat 5333,2022-12-14,22:00:00,7,1,6,FMN 03 Kolonel Silvertopstraat
651,Kolonel Silvertopstraat 5333,2022-12-14,23:00:00,1,0,1,FMN 03 Kolonel Silvertopstraat
651,Kolonel Silvertopstraat 5333,2022-12-15,00:00:00,2,1,1,FMN 03 Kolonel Silvertopstraat
651,Kolonel Silvertopstraat 5333,2022-12-15,01:00:00,0,0,0,FMN 03 Kolonel Silvertopstraat
651,Kolonel Silvertopstraat 5333,2022-12-15,02:00:00,0,0,0,FMN 03 Kolonel Silvertopstraat
651,Kolonel Silvertopstraat 5333,2022-12-15,03:00:00,0,0,0,FMN 03 Kolonel Silvertopstraat
651,Kolonel Silvertopstraat 5333,2022-12-15,04:00:00,0,0,0,FMN 03 Kolonel Silvertopstraat
651,Kolonel Silvertopstraat 5333,2022-12-15,05:00:00,0,0,0,FMN 03 Kolonel Silvertopstraat
651,Kolonel Silvertopstraat 5333,2022-12-15,06:00:00,0,0,0,FMN 03 Kolonel Silvertopstraat
651,Kolonel Silvertopstraat 5333,2022-12-15,07:00:00,0,0,0,FMN 03 Kolonel Silvertopstraat
651,Kolonel Silvertopstraat 5333,2022-12-15,08:00:00,0,0,0,FMN 03 Kolonel Silvertopstraat
651,Kolonel Silvertopstraat 5333,2022-12-15,09:00:00,0,0,0,FMN 03 Kolonel Silvertopstraat
651,Kolonel Silvertopstraat 5333,2022-12-15,10:00:00,9,6,3,FMN 03 Kolonel Silvertopstraat
651,Kolonel Silvertopstraat 5333,2022-12-15,11:00:00,107,75,32,FMN 03 Kolonel Silvertopstraat
651,Kolonel Silvertopstraat 5333,2022-12-15,12:00:00,156,99,57,FMN 03 Kolonel Silvertopstraat
651,Kolonel Silvertopstraat 5333,2022-12-15,13:00:00,122,87,35,FMN 03 Kolonel Silvertopstraat
651,Kolonel Silvertopstraat 5333,2022-12-15,14:00:00,121,67,54,FMN 03 Kolonel Silvertopstraat
651,Kolonel Silvertopstraat 5333,2022-12-15,15:00:00,193,121,72,FMN 03 Kolonel Silvertopstraat
651,Kolonel Silvertopstraat 5333,2022-12-15,16:00:00,232,133,99,FMN 03 Kolonel Silvertopstraat
651,Kolonel Silvertopstraat 5333,2022-12-15,17:00:00,253,170,83,FMN 03 Kolonel Silvertopstraat
651,Kolonel Silvertopstraat 5333,2022-12-15,18:00:00,217,137,80,FMN 03 Kolonel Silvertopstraat
651,Kolonel Silvertopstraat 5333,2022-12-15,19:00:00,154,105,49,FMN 03 Kolonel Silvertopstraat
651,Kolonel Silvertopstraat 5333,2022-12-15,20:00:00,84,54,30,FMN 03 Kolonel Silvertopstraat
651,Kolonel Silvertopstraat 5333,2022-12-15,21:00:00,58,27,31,FMN 03 Kolonel Silvertopstraat
651,Kolonel Silvertopstraat 5333,2022-12-15,22:00:00,70,30,40,FMN 03 Kolonel Silvertopstraat
651,Kolonel Silvertopstraat 5333,2022-12-15,23:00:00,42,10,32,FMN 03 Kolonel Silvertopstraat
651,Kolonel Silvertopstraat 5333,2022-12-16,00:00:00,30,11,19,FMN 03 Kolonel Silvertopstraat
651,Kolonel Silvertopstraat 5333,2022-12-16,01:00:00,17,6,11,FMN 03 Kolonel Silvertopstraat
651,Kolonel Silvertopstraat 5333,2022-12-16,02:00:00,7,0,7,FMN 03 Kolonel Silvertopstraat
651,Kolonel Silvertopstraat 5333,2022-12-16,03:00:00,6,4,2,FMN 03 Kolonel Silvertopstraat
651,Kolonel Silvertopstraat 5333,2022-12-16,04:00:00,17,12,5,FMN 03 Kolonel Silvertopstraat
651,Kolonel Silvertopstraat 5333,2022-12-16,05:00:00,26,13,13,FMN 03 Kolonel Silvertopstraat
651,Kolonel Silvertopstraat 5333,2022-12-16,06:00:00,83,64,19,FMN 03 Kolonel Silvertopstraat
651,Kolonel Silvertopstraat 5333,2022-12-16,07:00:00,205,159,46,FMN 03 Kolonel Silvertopstraat
651,Kolonel Silvertopstraat 5333,2022-12-16,08:00:00,355,291,64,FMN 03 Kolonel Silvertopstraat
651,Kolonel Silvertopstraat 5333,2022-12-16,09:00:00,167,118,49,FMN 03 Kolonel Silvertopstraat
651,Kolonel Silvertopstraat 5333,2022-12-16,10:00:00,173,128,45,FMN 03 Kolonel Silvertopstraat
651,Kolonel Silvertopstraat 5333,2022-12-16,11:00:00,134,92,42,FMN 03 Kolonel Silvertopstraat
651,Kolonel Silvertopstraat 5333,2022-12-16,12:00:00,190,117,73,FMN 03 Kolonel Silvertopstraat
651,Kolonel Silvertopstraat 5333,2022-12-16,13:00:00,174,120,54,FMN 03 Kolonel Silvertopstraat
651,Kolonel Silvertopstraat 5333,2022-12-16,14:00:00,188,113,75,FMN 03 Kolonel Silvertopstraat
651,Kolonel Silvertopstraat 5333,2022-12-16,15:00:00,226,144,82,FMN 03 Kolonel Silvertopstraat
651,Kolonel Silvertopstraat 5333,2022-12-16,16:00:00,297,185,112,FMN 03 Kolonel Silvertopstraat
651,Kolonel Silvertopstraat 5333,2022-12-16,17:00:00,261,171,90,FMN 03 Kolonel Silvertopstraat
651,Kolonel Silvertopstraat 5333,2022-12-16,18:00:00,235,146,89,FMN 03 Kolonel Silvertopstraat
651,Kolonel Silvertopstraat 5333,2022-12-16,19:00:00,150,95,55,FMN 03 Kolonel Silvertopstraat
651,Kolonel Silvertopstraat 5333,2022-12-16,20:00:00,108,60,48,FMN 03 Kolonel Silvertopstraat
651,Kolonel Silvertopstraat 5333,2022-12-16,21:00:00,102,62,40,FMN 03 Kolonel Silvertopstraat
651,Kolonel Silvertopstraat 5333,2022-12-16,22:00:00,63,31,32,FMN 03 Kolonel Silvertopstraat
651,Kolonel Silvertopstraat 5333,2022-12-16,23:00:00,69,34,35,FMN 03 Kolonel Silvertopstraat
651,Kolonel Silvertopstraat 5333,2022-12-17,00:00:00,47,21,26,FMN 03 Kolonel Silvertopstraat
651,Kolonel Silvertopstraat 5333,2022-12-17,01:00:00,32,11,21,FMN 03 Kolonel Silvertopstraat
651,Kolonel Silvertopstraat 5333,2022-12-17,02:00:00,17,8,9,FMN 03 Kolonel Silvertopstraat
651,Kolonel Silvertopstraat 5333,2022-12-17,03:00:00,9,3,6,FMN 03 Kolonel Silvertopstraat
651,Kolonel Silvertopstraat 5333,2022-12-17,04:00:00,6,1,5,FMN 03 Kolonel Silvertopstraat
651,Kolonel Silvertopstraat 5333,2022-12-17,05:00:00,0,0,0,FMN 03 Kolonel Silvertopstraat
651,Kolonel Silvertopstraat 5333,2022-12-17,06:00:00,0,0,0,FMN 03 Kolonel Silvertopstraat
651,Kolonel Silvertopstraat 5333,2022-12-17,07:00:00,0,0,0,FMN 03 Kolonel Silvertopstraat
651,Kolonel Silvertopstraat 5333,2022-12-17,08:00:00,0,0,0,FMN 03 Kolonel Silvertopstraat
651,Kolonel Silvertopstraat 5333,2022-12-17,09:00:00,0,0,0,FMN 03 Kolonel Silvertopstraat
651,Kolonel Silvertopstraat 5333,2022-12-17,10:00:00,12,8,4,FMN 03 Kolonel Silvertopstraat
651,Kolonel Silvertopstraat 5333,2022-12-17,11:00:00,76,57,19,FMN 03 Kolonel Silvertopstraat
651,Kolonel Silvertopstraat 5333,2022-12-17,12:00:00,78,51,27,FMN 03 Kolonel Silvertopstraat
651,Kolonel Silvertopstraat 5333,2022-12-17,13:00:00,119,84,35,FMN 03 Kolonel Silvertopstraat
651,Kolonel Silvertopstraat 5333,2022-12-17,14:00:00,121,88,33,FMN 03 Kolonel Silvertopstraat
651,Kolonel Silvertopstraat 5333,2022-12-17,15:00:00,130,90,40,FMN 03 Kolonel Silvertopstraat
651,Kolonel Silvertopstraat 5333,2022-12-17,16:00:00,127,73,54,FMN 03 Kolonel Silvertopstraat
651,Kolonel Silvertopstraat 5333,2022-12-17,17:00:00,104,69,35,FMN 03 Kolonel Silvertopstraat
651,Kolonel Silvertopstraat 5333,2022-12-17,18:00:00,107,51,56,FMN 03 Kolonel Silvertopstraat
651,Kolonel Silvertopstraat 5333,2022-12-17,19:00:00,86,60,26,FMN 03 Kolonel Silvertopstraat
651,Kolonel Silvertopstraat 5333,2022-12-17,20:00:00,71,44,27,FMN 03 Kolonel Silvertopstraat
651,Kolonel Silvertopstraat 5333,2022-12-17,21:00:00,48,29,19,FMN 03 Kolonel Silvertopstraat
651,Kolonel Silvertopstraat 5333,2022-12-17,22:00:00,36,24,12,FMN 03 Kolonel Silvertopstraat
651,Kolonel Silvertopstraat 5333,2022-12-17,23:00:00,11,5,6,FMN 03 Kolonel Silvertopstraat
651,Kolonel Silvertopstraat 5333,2022-12-18,00:00:00,1,1,0,FMN 03 Kolonel Silvertopstraat
651,Kolonel Silvertopstraat 5333,2022-12-18,01:00:00,0,0,0,FMN 03 Kolonel Silvertopstraat
651,Kolonel Silvertopstraat 5333,2022-12-18,02:00:00,0,0,0,FMN 03 Kolonel Silvertopstraat
651,Kolonel Silvertopstraat 5333,2022-12-18,03:00:00,0,0,0,FMN 03 Kolonel Silvertopstraat
651,Kolonel Silvertopstraat 5333,2022-12-18,04:00:00,0,0,0,FMN 03 Kolonel Silvertopstraat
651,Kolonel Silvertopstraat 5333,2022-12-18,05:00:00,0,0,0,FMN 03 Kolonel Silvertopstraat
651,Kolonel Silvertopstraat 5333,2022-12-18,06:00:00,0,0,0,FMN 03 Kolonel Silvertopstraat
651,Kolonel Silvertopstraat 5333,2022-12-18,07:00:00,0,0,0,FMN 03 Kolonel Silvertopstraat
651,Kolonel Silvertopstraat 5333,2022-12-18,08:00:00,0,0,0,FMN 03 Kolonel Silvertopstraat
651,Kolonel Silvertopstraat 5333,2022-12-18,09:00:00,0,0,0,FMN 03 Kolonel Silvertopstraat
651,Kolonel Silvertopstraat 5333,2022-12-18,10:00:00,37,28,9,FMN 03 Kolonel Silvertopstraat
651,Kolonel Silvertopstraat 5333,2022-12-18,11:00:00,34,27,7,FMN 03 Kolonel Silvertopstraat
651,Kolonel Silvertopstraat 5333,2022-12-18,12:00:00,46,32,14,FMN 03 Kolonel Silvertopstraat
651,Kolonel Silvertopstraat 5333,2022-12-18,13:00:00,71,53,18,FMN 03 Kolonel Silvertopstraat
651,Kolonel Silvertopstraat 5333,2022-12-18,14:00:00,76,52,24,FMN 03 Kolonel Silvertopstraat
651,Kolonel Silvertopstraat 5333,2022-12-18,15:00:00,74,55,19,FMN 03 Kolonel Silvertopstraat
651,Kolonel Silvertopstraat 5333,2022-12-18,16:00:00,51,24,27,FMN 03 Kolonel Silvertopstraat
651,Kolonel Silvertopstraat 5333,2022-12-18,17:00:00,83,51,32,FMN 03 Kolonel Silvertopstraat
651,Kolonel Silvertopstraat 5333,2022-12-18,18:00:00,60,29,31,FMN 03 Kolonel Silvertopstraat
651,Kolonel Silvertopstraat 5333,2022-12-18,19:00:00,43,20,23,FMN 03 Kolonel Silvertopstraat
651,Kolonel Silvertopstraat 5333,2022-12-18,20:00:00,31,13,18,FMN 03 Kolonel Silvertopstraat
651,Kolonel Silvertopstraat 5333,2022-12-18,21:00:00,9,5,4,FMN 03 Kolonel Silvertopstraat
651,Kolonel Silvertopstraat 5333,2022-12-18,22:00:00,21,9,12,FMN 03 Kolonel Silvertopstraat
651,Kolonel Silvertopstraat 5333,2022-12-18,23:00:00,22,10,12,FMN 03 Kolonel Silvertopstraat
651,Kolonel Silvertopstraat 5333,2022-12-19,00:00:00,11,6,5,FMN 03 Kolonel Silvertopstraat
651,Kolonel Silvertopstraat 5333,2022-12-19,01:00:00,3,0,3,FMN 03 Kolonel Silvertopstraat
651,Kolonel Silvertopstraat 5333,2022-12-19,02:00:00,6,3,3,FMN 03 Kolonel Silvertopstraat
651,Kolonel Silvertopstraat 5333,2022-12-19,03:00:00,5,3,2,FMN 03 Kolonel Silvertopstraat
651,Kolonel Silvertopstraat 5333,2022-12-19,04:00:00,15,11,4,FMN 03 Kolonel Silvertopstraat
651,Kolonel Silvertopstraat 5333,2022-12-19,05:00:00,31,16,15,FMN 03 Kolonel Silvertopstraat
651,Kolonel Silvertopstraat 5333,2022-12-19,06:00:00,90,73,17,FMN 03 Kolonel Silvertopstraat
651,Kolonel Silvertopstraat 5333,2022-12-19,07:00:00,223,185,38,FMN 03 Kolonel Silvertopstraat
651,Kolonel Silvertopstraat 5333,2022-12-19,08:00:00,442,379,63,FMN 03 Kolonel Silvertopstraat
651,Kolonel Silvertopstraat 5333,2022-12-19,09:00:00,180,134,46,FMN 03 Kolonel Silvertopstraat
651,Kolonel Silvertopstraat 5333,2022-12-19,10:00:00,172,128,44,FMN 03 Kolonel Silvertopstraat
651,Kolonel Silvertopstraat 5333,2022-12-19,11:00:00,133,95,38,FMN 03 Kolonel Silvertopstraat
651,Kolonel Silvertopstraat 5333,2022-12-19,12:00:00,159,105,54,FMN 03 Kolonel Silvertopstraat
651,Kolonel Silvertopstraat 5333,2022-12-19,13:00:00,151,113,38,FMN 03 Kolonel Silvertopstraat
651,Kolonel Silvertopstraat 5333,2022-12-19,14:00:00,157,101,56,FMN 03 Kolonel Silvertopstraat
651,Kolonel Silvertopstraat 5333,2022-12-19,15:00:00,224,151,73,FMN 03 Kolonel Silvertopstraat
651,Kolonel Silvertopstraat 5333,2022-12-19,16:00:00,253,168,85,FMN 03 Kolonel Silvertopstraat
651,Kolonel Silvertopstraat 5333,2022-12-19,17:00:00,280,159,121,FMN 03 Kolonel Silvertopstraat
651,Kolonel Silvertopstraat 5333,2022-12-19,18:00:00,212,127,85,FMN 03 Kolonel Silvertopstraat
651,Kolonel Silvertopstraat 5333,2022-12-19,19:00:00,139,92,47,FMN 03 Kolonel Silvertopstraat
651,Kolonel Silvertopstraat 5333,2022-12-19,20:00:00,122,61,61,FMN 03 Kolonel Silvertopstraat
651,Kolonel Silvertopstraat 5333,2022-12-19,21:00:00,75,39,36,FMN 03 Kolonel Silvertopstraat
651,Kolonel Silvertopstraat 5333,2022-12-19,22:00:00,75,45,30,FMN 03 Kolonel Silvertopstraat
651,Kolonel Silvertopstraat 5333,2022-12-19,23:00:00,47,25,22,FMN 03 Kolonel Silvertopstraat
651,Kolonel Silvertopstraat 5333,2022-12-20,00:00:00,15,4,11,FMN 03 Kolonel Silvertopstraat
651,Kolonel Silvertopstraat 5333,2022-12-20,01:00:00,12,3,9,FMN 03 Kolonel Silvertopstraat
651,Kolonel Silvertopstraat 5333,2022-12-20,02:00:00,13,3,10,FMN 03 Kolonel Silvertopstraat
651,Kolonel Silvertopstraat 5333,2022-12-20,03:00:00,10,4,6,FMN 03 Kolonel Silvertopstraat
651,Kolonel Silvertopstraat 5333,2022-12-20,04:00:00,14,10,4,FMN 03 Kolonel Silvertopstraat
651,Kolonel Silvertopstraat 5333,2022-12-20,05:00:00,56,36,20,FMN 03 Kolonel Silvertopstraat
651,Kolonel Silvertopstraat 5333,2022-12-20,06:00:00,105,84,21,FMN 03 Kolonel Silvertopstraat
651,Kolonel Silvertopstraat 5333,2022-12-20,07:00:00,255,207,48,FMN 03 Kolonel Silvertopstraat
651,Kolonel Silvertopstraat 5333,2022-12-20,08:00:00,420,364,56,FMN 03 Kolonel Silvertopstraat
651,Kolonel Silvertopstraat 5333,2022-12-20,09:00:00,162,120,42,FMN 03 Kolonel Silvertopstraat
651,Kolonel Silvertopstraat 5333,2022-12-20,10:00:00,127,103,24,FMN 03 Kolonel Silvertopstraat
651,Kolonel Silvertopstraat 5333,2022-12-20,11:00:00,84,54,30,FMN 03 Kolonel Silvertopstraat
651,Kolonel Silvertopstraat 5333,2022-12-20,12:00:00,132,92,40,FMN 03 Kolonel Silvertopstraat
651,Kolonel Silvertopstraat 5333,2022-12-20,13:00:00,128,89,39,FMN 03 Kolonel Silvertopstraat
651,Kolonel Silvertopstraat 5333,2022-12-20,14:00:00,118,77,41,FMN 03 Kolonel Silvertopstraat
651,Kolonel Silvertopstraat 5333,2022-12-20,15:00:00,191,114,77,FMN 03 Kolonel Silvertopstraat
651,Kolonel Silvertopstraat 5333,2022-12-20,16:00:00,210,147,63,FMN 03 Kolonel Silvertopstraat
651,Kolonel Silvertopstraat 5333,2022-12-20,17:00:00,264,159,105,FMN 03 Kolonel Silvertopstraat
651,Kolonel Silvertopstraat 5333,2022-12-20,18:00:00,190,104,86,FMN 03 Kolonel Silvertopstraat
651,Kolonel Silvertopstraat 5333,2022-12-20,19:00:00,122,77,45,FMN 03 Kolonel Silvertopstraat
651,Kolonel Silvertopstraat 5333,2022-12-20,20:00:00,90,51,39,FMN 03 Kolonel Silvertopstraat
651,Kolonel Silvertopstraat 5333,2022-12-20,21:00:00,68,30,38,FMN 03 Kolonel Silvertopstraat
651,Kolonel Silvertopstraat 5333,2022-12-20,22:00:00,68,38,30,FMN 03 Kolonel Silvertopstraat
651,Kolonel Silvertopstraat 5333,2022-12-20,23:00:00,43,19,24,FMN 03 Kolonel Silvertopstraat
651,Kolonel Silvertopstraat 5333,2022-12-21,00:00:00,32,15,17,FMN 03 Kolonel Silvertopstraat
651,Kolonel Silvertopstraat 5333,2022-12-21,01:00:00,12,4,8,FMN 03 Kolonel Silvertopstraat
651,Kolonel Silvertopstraat 5333,2022-12-21,02:00:00,13,5,8,FMN 03 Kolonel Silvertopstraat
651,Kolonel Silvertopstraat 5333,2022-12-21,03:00:00,12,6,6,FMN 03 Kolonel Silvertopstraat
651,Kolonel Silvertopstraat 5333,2022-12-21,04:00:00,20,14,6,FMN 03 Kolonel Silvertopstraat
651,Kolonel Silvertopstraat 5333,2022-12-21,05:00:00,39,24,15,FMN 03 Kolonel Silvertopstraat
651,Kolonel Silvertopstraat 5333,2022-12-21,06:00:00,106,90,16,FMN 03 Kolonel Silvertopstraat
651,Kolonel Silvertopstraat 5333,2022-12-21,07:00:00,204,153,51,FMN 03 Kolonel Silvertopstraat
651,Kolonel Silvertopstraat 5333,2022-12-21,08:00:00,394,333,61,FMN 03 Kolonel Silvertopstraat
651,Kolonel Silvertopstraat 5333,2022-12-21,09:00:00,186,149,37,FMN 03 Kolonel Silvertopstraat
651,Kolonel Silvertopstraat 5333,2022-12-21,10:00:00,161,123,38,FMN 03 Kolonel Silvertopstraat
651,Kolonel Silvertopstraat 5333,2022-12-21,11:00:00,161,131,30,FMN 03 Kolonel Silvertopstraat
651,Kolonel Silvertopstraat 5333,2022-12-21,12:00:00,238,177,61,FMN 03 Kolonel Silvertopstraat
651,Kolonel Silvertopstraat 5333,2022-12-21,13:00:00,197,142,55,FMN 03 Kolonel Silvertopstraat
651,Kolonel Silvertopstraat 5333,2022-12-21,14:00:00,174,119,55,FMN 03 Kolonel Silvertopstraat
651,Kolonel Silvertopstraat 5333,2022-12-21,15:00:00,201,122,79,FMN 03 Kolonel Silvertopstraat
651,Kolonel Silvertopstraat 5333,2022-12-21,16:00:00,253,183,70,FMN 03 Kolonel Silvertopstraat
651,Kolonel Silvertopstraat 5333,2022-12-21,17:00:00,280,188,92,FMN 03 Kolonel Silvertopstraat
651,Kolonel Silvertopstraat 5333,2022-12-21,18:00:00,228,140,88,FMN 03 Kolonel Silvertopstraat
651,Kolonel Silvertopstraat 5333,2022-12-21,19:00:00,152,113,39,FMN 03 Kolonel Silvertopstraat
651,Kolonel Silvertopstraat 5333,2022-12-21,20:00:00,116,70,46,FMN 03 Kolonel Silvertopstraat
651,Kolonel Silvertopstraat 5333,2022-12-21,21:00:00,94,43,51,FMN 03 Kolonel Silvertopstraat
651,Kolonel Silvertopstraat 5333,2022-12-21,22:00:00,77,35,42,FMN 03 Kolonel Silvertopstraat
651,Kolonel Silvertopstraat 5333,2022-12-21,23:00:00,51,17,34,FMN 03 Kolonel Silvertopstraat
651,Kolonel Silvertopstraat 5333,2022-12-22,00:00:00,20,8,12,FMN 03 Kolonel Silvertopstraat
651,Kolonel Silvertopstraat 5333,2022-12-22,01:00:00,15,5,10,FMN 03 Kolonel Silvertopstraat
651,Kolonel Silvertopstraat 5333,2022-12-22,02:00:00,11,6,5,FMN 03 Kolonel Silvertopstraat
651,Kolonel Silvertopstraat 5333,2022-12-22,03:00:00,6,3,3,FMN 03 Kolonel Silvertopstraat
651,Kolonel Silvertopstraat 5333,2022-12-22,04:00:00,21,11,10,FMN 03 Kolonel Silvertopstraat
651,Kolonel Silvertopstraat 5333,2022-12-22,05:00:00,37,22,15,FMN 03 Kolonel Silvertopstraat
651,Kolonel Silvertopstraat 5333,2022-12-22,06:00:00,83,69,14,FMN 03 Kolonel Silvertopstraat
651,Kolonel Silvertopstraat 5333,2022-12-22,07:00:00,186,149,37,FMN 03 Kolonel Silvertopstraat
651,Kolonel Silvertopstraat 5333,2022-12-22,08:00:00,463,392,71,FMN 03 Kolonel Silvertopstraat
651,Kolonel Silvertopstraat 5333,2022-12-22,09:00:00,250,212,38,FMN 03 Kolonel Silvertopstraat
651,Kolonel Silvertopstraat 5333,2022-12-22,10:00:00,179,145,34,FMN 03 Kolonel Silvertopstraat
651,Kolonel Silvertopstraat 5333,2022-12-22,11:00:00,180,125,55,FMN 03 Kolonel Silvertopstraat
651,Kolonel Silvertopstraat 5333,2022-12-22,12:00:00,185,117,68,FMN 03 Kolonel Silvertopstraat
651,Kolonel Silvertopstraat 5333,2022-12-22,13:00:00,199,148,51,FMN 03 Kolonel Silvertopstraat
651,Kolonel Silvertopstraat 5333,2022-12-22,14:00:00,189,123,66,FMN 03 Kolonel Silvertopstraat
651,Kolonel Silvertopstraat 5333,2022-12-22,15:00:00,220,143,77,FMN 03 Kolonel Silvertopstraat
651,Kolonel Silvertopstraat 5333,2022-12-22,16:00:00,288,190,98,FMN 03 Kolonel Silvertopstraat
651,Kolonel Silvertopstraat 5333,2022-12-22,17:00:00,295,191,104,FMN 03 Kolonel Silvertopstraat
651,Kolonel Silvertopstraat 5333,2022-12-22,18:00:00,219,136,83,FMN 03 Kolonel Silvertopstraat
651,Kolonel Silvertopstraat 5333,2022-12-22,19:00:00,161,105,56,FMN 03 Kolonel Silvertopstraat
651,Kolonel Silvertopstraat 5333,2022-12-22,20:00:00,126,70,56,FMN 03 Kolonel Silvertopstraat
651,Kolonel Silvertopstraat 5333,2022-12-22,21:00:00,90,43,47,FMN 03 Kolonel Silvertopstraat
651,Kolonel Silvertopstraat 5333,2022-12-22,22:00:00,84,44,40,FMN 03 Kolonel Silvertopstraat
651,Kolonel Silvertopstraat 5333,2022-12-22,23:00:00,61,27,34,FMN 03 Kolonel Silvertopstraat
651,Kolonel Silvertopstraat 5333,2022-12-23,00:00:00,33,12,21,FMN 03 Kolonel Silvertopstraat
651,Kolonel Silvertopstraat 5333,2022-12-23,01:00:00,28,14,14,FMN 03 Kolonel Silvertopstraat
651,Kolonel Silvertopstraat 5333,2022-12-23,02:00:00,14,6,8,FMN 03 Kolonel Silvertopstraat
651,Kolonel Silvertopstraat 5333,2022-12-23,03:00:00,10,3,7,FMN 03 Kolonel Silvertopstraat
651,Kolonel Silvertopstraat 5333,2022-12-23,04:00:00,26,17,9,FMN 03 Kolonel Silvertopstraat
651,Kolonel Silvertopstraat 5333,2022-12-23,05:00:00,30,17,13,FMN 03 Kolonel Silvertopstraat
651,Kolonel Silvertopstraat 5333,2022-12-23,06:00:00,92,71,21,FMN 03 Kolonel Silvertopstraat
651,Kolonel Silvertopstraat 5333,2022-12-23,07:00:00,146,119,27,FMN 03 Kolonel Silvertopstraat
651,Kolonel Silvertopstraat 5333,2022-12-23,08:00:00,330,272,58,FMN 03 Kolonel Silvertopstraat
651,Kolonel Silvertopstraat 5333,2022-12-23,09:00:00,214,170,44,FMN 03 Kolonel Silvertopstraat
651,Kolonel Silvertopstraat 5333,2022-12-23,10:00:00,144,104,40,FMN 03 Kolonel Silvertopstraat
651,Kolonel Silvertopstraat 5333,2022-12-23,11:00:00,99,70,29,FMN 03 Kolonel Silvertopstraat
651,Kolonel Silvertopstraat 5333,2022-12-23,12:00:00,127,81,46,FMN 03 Kolonel Silvertopstraat
651,Kolonel Silvertopstraat 5333,2022-12-23,13:00:00,91,52,39,FMN 03 Kolonel Silvertopstraat
651,Kolonel Silvertopstraat 5333,2022-12-23,14:00:00,164,94,70,FMN 03 Kolonel Silvertopstraat
651,Kolonel Silvertopstraat 5333,2022-12-23,15:00:00,189,136,53,FMN 03 Kolonel Silvertopstraat
651,Kolonel Silvertopstraat 5333,2022-12-23,16:00:00,202,143,59,FMN 03 Kolonel Silvertopstraat
651,Kolonel Silvertopstraat 5333,2022-12-23,17:00:00,221,146,75,FMN 03 Kolonel Silvertopstraat
651,Kolonel Silvertopstraat 5333,2022-12-23,18:00:00,202,129,73,FMN 03 Kolonel Silvertopstraat
651,Kolonel Silvertopstraat 5333,2022-12-23,19:00:00,150,96,54,FMN 03 Kolonel Silvertopstraat
651,Kolonel Silvertopstraat 5333,2022-12-23,20:00:00,135,87,48,FMN 03 Kolonel Silvertopstraat
651,Kolonel Silvertopstraat 5333,2022-12-23,21:00:00,87,39,48,FMN 03 Kolonel Silvertopstraat
651,Kolonel Silvertopstraat 5333,2022-12-23,22:00:00,78,45,33,FMN 03 Kolonel Silvertopstraat
651,Kolonel Silvertopstraat 5333,2022-12-23,23:00:00,64,29,35,FMN 03 Kolonel Silvertopstraat
651,Kolonel Silvertopstraat 5333,2022-12-24,00:00:00,50,25,25,FMN 03 Kolonel Silvertopstraat
651,Kolonel Silvertopstraat 5333,2022-12-24,01:00:00,28,12,16,FMN 03 Kolonel Silvertopstraat
651,Kolonel Silvertopstraat 5333,2022-12-24,02:00:00,19,6,13,FMN 03 Kolonel Silvertopstraat
651,Kolonel Silvertopstraat 5333,2022-12-24,03:00:00,20,8,12,FMN 03 Kolonel Silvertopstraat
651,Kolonel Silvertopstraat 5333,2022-12-24,04:00:00,15,9,6,FMN 03 Kolonel Silvertopstraat
651,Kolonel Silvertopstraat 5333,2022-12-24,05:00:00,23,9,14,FMN 03 Kolonel Silvertopstraat
651,Kolonel Silvertopstraat 5333,2022-12-24,06:00:00,26,20,6,FMN 03 Kolonel Silvertopstraat
651,Kolonel Silvertopstraat 5333,2022-12-24,07:00:00,31,25,6,FMN 03 Kolonel Silvertopstraat
651,Kolonel Silvertopstraat 5333,2022-12-24,08:00:00,42,29,13,FMN 03 Kolonel Silvertopstraat
651,Kolonel Silvertopstraat 5333,2022-12-24,09:00:00,98,74,24,FMN 03 Kolonel Silvertopstraat
651,Kolonel Silvertopstraat 5333,2022-12-24,10:00:00,149,116,33,FMN 03 Kolonel Silvertopstraat
651,Kolonel Silvertopstraat 5333,2022-12-24,11:00:00,131,107,24,FMN 03 Kolonel Silvertopstraat
651,Kolonel Silvertopstraat 5333,2022-12-24,12:00:00,133,100,33,FMN 03 Kolonel Silvertopstraat
651,Kolonel Silvertopstraat 5333,2022-12-24,13:00:00,136,94,42,FMN 03 Kolonel Silvertopstraat
651,Kolonel Silvertopstraat 5333,2022-12-24,14:00:00,161,110,51,FMN 03 Kolonel Silvertopstraat
651,Kolonel Silvertopstraat 5333,2022-12-24,15:00:00,157,89,68,FMN 03 Kolonel Silvertopstraat
651,Kolonel Silvertopstraat 5333,2022-12-24,16:00:00,129,75,54,FMN 03 Kolonel Silvertopstraat
651,Kolonel Silvertopstraat 5333,2022-12-24,17:00:00,127,81,46,FMN 03 Kolonel Silvertopstraat
651,Kolonel Silvertopstraat 5333,2022-12-24,18:00:00,103,59,44,FMN 03 Kolonel Silvertopstraat
651,Kolonel Silvertopstraat 5333,2022-12-24,19:00:00,58,32,26,FMN 03 Kolonel Silvertopstraat
651,Kolonel Silvertopstraat 5333,2022-12-24,20:00:00,67,42,25,FMN 03 Kolonel Silvertopstraat
651,Kolonel Silvertopstraat 5333,2022-12-24,21:00:00,39,22,17,FMN 03 Kolonel Silvertopstraat
651,Kolonel Silvertopstraat 5333,2022-12-24,22:00:00,42,26,16,FMN 03 Kolonel Silvertopstraat
651,Kolonel Silvertopstraat 5333,2022-12-24,23:00:00,51,32,19,FMN 03 Kolonel Silvertopstraat
651,Kolonel Silvertopstraat 5333,2022-12-25,00:00:00,34,14,20,FMN 03 Kolonel Silvertopstraat
651,Kolonel Silvertopstraat 5333,2022-12-25,01:00:00,34,22,12,FMN 03 Kolonel Silvertopstraat
651,Kolonel Silvertopstraat 5333,2022-12-25,02:00:00,23,12,11,FMN 03 Kolonel Silvertopstraat
651,Kolonel Silvertopstraat 5333,2022-12-25,03:00:00,7,3,4,FMN 03 Kolonel Silvertopstraat
651,Kolonel Silvertopstraat 5333,2022-12-25,04:00:00,7,2,5,FMN 03 Kolonel Silvertopstraat
651,Kolonel Silvertopstraat 5333,2022-12-25,05:00:00,10,5,5,FMN 03 Kolonel Silvertopstraat
651,Kolonel Silvertopstraat 5333,2022-12-25,06:00:00,12,11,1,FMN 03 Kolonel Silvertopstraat
651,Kolonel Silvertopstraat 5333,2022-12-25,07:00:00,11,10,1,FMN 03 Kolonel Silvertopstraat
651,Kolonel Silvertopstraat 5333,2022-12-25,08:00:00,24,17,7,FMN 03 Kolonel Silvertopstraat
651,Kolonel Silvertopstraat 5333,2022-12-25,09:00:00,29,23,6,FMN 03 Kolonel Silvertopstraat
651,Kolonel Silvertopstraat 5333,2022-12-25,10:00:00,24,19,5,FMN 03 Kolonel Silvertopstraat
651,Kolonel Silvertopstraat 5333,2022-12-25,11:00:00,41,29,12,FMN 03 Kolonel Silvertopstraat
651,Kolonel Silvertopstraat 5333,2022-12-25,12:00:00,34,21,13,FMN 03 Kolonel Silvertopstraat
651,Kolonel Silvertopstraat 5333,2022-12-25,13:00:00,41,28,13,FMN 03 Kolonel Silvertopstraat
651,Kolonel Silvertopstraat 5333,2022-12-25,14:00:00,58,35,23,FMN 03 Kolonel Silvertopstraat
651,Kolonel Silvertopstraat 5333,2022-12-25,15:00:00,38,22,16,FMN 03 Kolonel Silvertopstraat
651,Kolonel Silvertopstraat 5333,2022-12-25,16:00:00,52,43,9,FMN 03 Kolonel Silvertopstraat
651,Kolonel Silvertopstraat 5333,2022-12-25,17:00:00,55,31,24,FMN 03 Kolonel Silvertopstraat
651,Kolonel Silvertopstraat 5333,2022-12-25,18:00:00,57,40,17,FMN 03 Kolonel Silvertopstraat
651,Kolonel Silvertopstraat 5333,2022-12-25,19:00:00,70,43,27,FMN 03 Kolonel Silvertopstraat
651,Kolonel Silvertopstraat 5333,2022-12-25,20:00:00,46,24,22,FMN 03 Kolonel Silvertopstraat
651,Kolonel Silvertopstraat 5333,2022-12-25,21:00:00,35,22,13,FMN 03 Kolonel Silvertopstraat
651,Kolonel Silvertopstraat 5333,2022-12-25,22:00:00,33,19,14,FMN 03 Kolonel Silvertopstraat
651,Kolonel Silvertopstraat 5333,2022-12-25,23:00:00,31,14,17,FMN 03 Kolonel Silvertopstraat
651,Kolonel Silvertopstraat 5333,2022-12-26,00:00:00,17,11,6,FMN 03 Kolonel Silvertopstraat
651,Kolonel Silvertopstraat 5333,2022-12-26,01:00:00,16,8,8,FMN 03 Kolonel Silvertopstraat
651,Kolonel Silvertopstraat 5333,2022-12-26,02:00:00,10,5,5,FMN 03 Kolonel Silvertopstraat
651,Kolonel Silvertopstraat 5333,2022-12-26,03:00:00,9,6,3,FMN 03 Kolonel Silvertopstraat
651,Kolonel Silvertopstraat 5333,2022-12-26,04:00:00,20,13,7,FMN 03 Kolonel Silvertopstraat
651,Kolonel Silvertopstraat 5333,2022-12-26,05:00:00,26,16,10,FMN 03 Kolonel Silvertopstraat
651,Kolonel Silvertopstraat 5333,2022-12-26,06:00:00,42,35,7,FMN 03 Kolonel Silvertopstraat
651,Kolonel Silvertopstraat 5333,2022-12-26,07:00:00,61,53,8,FMN 03 Kolonel Silvertopstraat
651,Kolonel Silvertopstraat 5333,2022-12-26,08:00:00,79,65,14,FMN 03 Kolonel Silvertopstraat
651,Kolonel Silvertopstraat 5333,2022-12-26,09:00:00,71,54,17,FMN 03 Kolonel Silvertopstraat
651,Kolonel Silvertopstraat 5333,2022-12-26,10:00:00,88,65,23,FMN 03 Kolonel Silvertopstraat
651,Kolonel Silvertopstraat 5333,2022-12-26,11:00:00,75,48,27,FMN 03 Kolonel Silvertopstraat
651,Kolonel Silvertopstraat 5333,2022-12-26,12:00:00,98,65,33,FMN 03 Kolonel Silvertopstraat
651,Kolonel Silvertopstraat 5333,2022-12-26,13:00:00,111,83,28,FMN 03 Kolonel Silvertopstraat
651,Kolonel Silvertopstraat 5333,2022-12-26,14:00:00,134,94,40,FMN 03 Kolonel Silvertopstraat
651,Kolonel Silvertopstraat 5333,2022-12-26,15:00:00,122,89,33,FMN 03 Kolonel Silvertopstraat
651,Kolonel Silvertopstraat 5333,2022-12-26,16:00:00,150,108,42,FMN 03 Kolonel Silvertopstraat
651,Kolonel Silvertopstraat 5333,2022-12-26,17:00:00,161,104,57,FMN 03 Kolonel Silvertopstraat
651,Kolonel Silvertopstraat 5333,2022-12-26,18:00:00,146,90,56,FMN 03 Kolonel Silvertopstraat
651,Kolonel Silvertopstraat 5333,2022-12-26,19:00:00,112,63,49,FMN 03 Kolonel Silvertopstraat
651,Kolonel Silvertopstraat 5333,2022-12-26,20:00:00,87,52,35,FMN 03 Kolonel Silvertopstraat
651,Kolonel Silvertopstraat 5333,2022-12-26,21:00:00,77,42,35,FMN 03 Kolonel Silvertopstraat
651,Kolonel Silvertopstraat 5333,2022-12-26,22:00:00,53,27,26,FMN 03 Kolonel Silvertopstraat
651,Kolonel Silvertopstraat 5333,2022-12-26,23:00:00,53,31,22,FMN 03 Kolonel Silvertopstraat
651,Kolonel Silvertopstraat 5333,2022-12-27,00:00:00,17,6,11,FMN 03 Kolonel Silvertopstraat
651,Kolonel Silvertopstraat 5333,2022-12-27,01:00:00,13,5,8,FMN 03 Kolonel Silvertopstraat
651,Kolonel Silvertopstraat 5333,2022-12-27,02:00:00,6,4,2,FMN 03 Kolonel Silvertopstraat
651,Kolonel Silvertopstraat 5333,2022-12-27,03:00:00,10,6,4,FMN 03 Kolonel Silvertopstraat
651,Kolonel Silvertopstraat 5333,2022-12-27,04:00:00,23,16,7,FMN 03 Kolonel Silvertopstraat
651,Kolonel Silvertopstraat 5333,2022-12-27,05:00:00,36,23,13,FMN 03 Kolonel Silvertopstraat
651,Kolonel Silvertopstraat 5333,2022-12-27,06:00:00,59,47,12,FMN 03 Kolonel Silvertopstraat
651,Kolonel Silvertopstraat 5333,2022-12-27,07:00:00,91,66,25,FMN 03 Kolonel Silvertopstraat
651,Kolonel Silvertopstraat 5333,2022-12-27,08:00:00,138,110,28,FMN 03 Kolonel Silvertopstraat
651,Kolonel Silvertopstraat 5333,2022-12-27,09:00:00,118,102,16,FMN 03 Kolonel Silvertopstraat
651,Kolonel Silvertopstraat 5333,2022-12-27,10:00:00,110,84,26,FMN 03 Kolonel Silvertopstraat
651,Kolonel Silvertopstraat 5333,2022-12-27,11:00:00,107,81,26,FMN 03 Kolonel Silvertopstraat
651,Kolonel Silvertopstraat 5333,2022-12-27,12:00:00,156,118,38,FMN 03 Kolonel Silvertopstraat
651,Kolonel Silvertopstraat 5333,2022-12-27,13:00:00,148,105,43,FMN 03 Kolonel Silvertopstraat
651,Kolonel Silvertopstraat 5333,2022-12-27,14:00:00,152,110,42,FMN 03 Kolonel Silvertopstraat
651,Kolonel Silvertopstraat 5333,2022-12-27,15:00:00,168,113,55,FMN 03 Kolonel Silvertopstraat
651,Kolonel Silvertopstraat 5333,2022-12-27,16:00:00,205,133,72,FMN 03 Kolonel Silvertopstraat
651,Kolonel Silvertopstraat 5333,2022-12-27,17:00:00,231,152,79,FMN 03 Kolonel Silvertopstraat
651,Kolonel Silvertopstraat 5333,2022-12-27,18:00:00,180,108,72,FMN 03 Kolonel Silvertopstraat
651,Kolonel Silvertopstraat 5333,2022-12-27,19:00:00,122,65,57,FMN 03 Kolonel Silvertopstraat
651,Kolonel Silvertopstraat 5333,2022-12-27,20:00:00,83,55,28,FMN 03 Kolonel Silvertopstraat
651,Kolonel Silvertopstraat 5333,2022-12-27,21:00:00,90,48,42,FMN 03 Kolonel Silvertopstraat
651,Kolonel Silvertopstraat 5333,2022-12-27,22:00:00,64,28,36,FMN 03 Kolonel Silvertopstraat
651,Kolonel Silvertopstraat 5333,2022-12-27,23:00:00,59,17,42,FMN 03 Kolonel Silvertopstraat
651,Kolonel Silvertopstraat 5333,2022-12-28,00:00:00,26,7,19,FMN 03 Kolonel Silvertopstraat
651,Kolonel Silvertopstraat 5333,2022-12-28,01:00:00,18,8,10,FMN 03 Kolonel Silvertopstraat
651,Kolonel Silvertopstraat 5333,2022-12-28,02:00:00,13,4,9,FMN 03 Kolonel Silvertopstraat
651,Kolonel Silvertopstraat 5333,2022-12-28,03:00:00,9,3,6,FMN 03 Kolonel Silvertopstraat
651,Kolonel Silvertopstraat 5333,2022-12-28,04:00:00,19,16,3,FMN 03 Kolonel Silvertopstraat
651,Kolonel Silvertopstraat 5333,2022-12-28,05:00:00,36,21,15,FMN 03 Kolonel Silvertopstraat
651,Kolonel Silvertopstraat 5333,2022-12-28,06:00:00,60,44,16,FMN 03 Kolonel Silvertopstraat
651,Kolonel Silvertopstraat 5333,2022-12-28,07:00:00,87,65,22,FMN 03 Kolonel Silvertopstraat
651,Kolonel Silvertopstraat 5333,2022-12-28,08:00:00,126,104,22,FMN 03 Kolonel Silvertopstraat
651,Kolonel Silvertopstraat 5333,2022-12-28,09:00:00,109,86,23,FMN 03 Kolonel Silvertopstraat
651,Kolonel Silvertopstraat 5333,2022-12-28,10:00:00,106,88,18,FMN 03 Kolonel Silvertopstraat
651,Kolonel Silvertopstraat 5333,2022-12-28,11:00:00,85,67,18,FMN 03 Kolonel Silvertopstraat
651,Kolonel Silvertopstraat 5333,2022-12-28,12:00:00,102,68,34,FMN 03 Kolonel Silvertopstraat
651,Kolonel Silvertopstraat 5333,2022-12-28,13:00:00,119,73,46,FMN 03 Kolonel Silvertopstraat
651,Kolonel Silvertopstraat 5333,2022-12-28,14:00:00,128,102,26,FMN 03 Kolonel Silvertopstraat
651,Kolonel Silvertopstraat 5333,2022-12-28,15:00:00,137,87,50,FMN 03 Kolonel Silvertopstraat
651,Kolonel Silvertopstraat 5333,2022-12-28,16:00:00,155,106,49,FMN 03 Kolonel Silvertopstraat
651,Kolonel Silvertopstraat 5333,2022-12-28,17:00:00,160,99,61,FMN 03 Kolonel Silvertopstraat
651,Kolonel Silvertopstraat 5333,2022-12-28,18:00:00,141,95,46,FMN 03 Kolonel Silvertopstraat
651,Kolonel Silvertopstraat 5333,2022-12-28,19:00:00,121,78,43,FMN 03 Kolonel Silvertopstraat
651,Kolonel Silvertopstraat 5333,2022-12-28,20:00:00,86,50,36,FMN 03 Kolonel Silvertopstraat
651,Kolonel Silvertopstraat 5333,2022-12-28,21:00:00,66,39,27,FMN 03 Kolonel Silvertopstraat
651,Kolonel Silvertopstraat 5333,2022-12-28,22:00:00,61,22,39,FMN 03 Kolonel Silvertopstraat
651,Kolonel Silvertopstraat 5333,2022-12-28,23:00:00,45,14,31,FMN 03 Kolonel Silvertopstraat
651,Kolonel Silvertopstraat 5333,2022-12-29,00:00:00,23,10,13,FMN 03 Kolonel Silvertopstraat
651,Kolonel Silvertopstraat 5333,2022-12-29,01:00:00,14,3,11,FMN 03 Kolonel Silvertopstraat
651,Kolonel Silvertopstraat 5333,2022-12-29,02:00:00,18,8,10,FMN 03 Kolonel Silvertopstraat
651,Kolonel Silvertopstraat 5333,2022-12-29,03:00:00,8,5,3,FMN 03 Kolonel Silvertopstraat
651,Kolonel Silvertopstraat 5333,2022-12-29,04:00:00,25,14,11,FMN 03 Kolonel Silvertopstraat
651,Kolonel Silvertopstraat 5333,2022-12-29,05:00:00,37,22,15,FMN 03 Kolonel Silvertopstraat
651,Kolonel Silvertopstraat 5333,2022-12-29,06:00:00,52,41,11,FMN 03 Kolonel Silvertopstraat
651,Kolonel Silvertopstraat 5333,2022-12-29,07:00:00,83,65,18,FMN 03 Kolonel Silvertopstraat
651,Kolonel Silvertopstraat 5333,2022-12-29,08:00:00,132,114,18,FMN 03 Kolonel Silvertopstraat
651,Kolonel Silvertopstraat 5333,2022-12-29,09:00:00,116,85,31,FMN 03 Kolonel Silvertopstraat
651,Kolonel Silvertopstraat 5333,2022-12-29,10:00:00,85,62,23,FMN 03 Kolonel Silvertopstraat
651,Kolonel Silvertopstraat 5333,2022-12-29,11:00:00,81,57,24,FMN 03 Kolonel Silvertopstraat
651,Kolonel Silvertopstraat 5333,2022-12-29,12:00:00,97,75,22,FMN 03 Kolonel Silvertopstraat
651,Kolonel Silvertopstraat 5333,2022-12-29,13:00:00,107,66,41,FMN 03 Kolonel Silvertopstraat
651,Kolonel Silvertopstraat 5333,2022-12-29,14:00:00,106,83,23,FMN 03 Kolonel Silvertopstraat
651,Kolonel Silvertopstraat 5333,2022-12-29,15:00:00,140,92,48,FMN 03 Kolonel Silvertopstraat
651,Kolonel Silvertopstraat 5333,2022-12-29,16:00:00,162,114,48,FMN 03 Kolonel Silvertopstraat
651,Kolonel Silvertopstraat 5333,2022-12-29,17:00:00,185,132,53,FMN 03 Kolonel Silvertopstraat
651,Kolonel Silvertopstraat 5333,2022-12-29,18:00:00,166,112,54,FMN 03 Kolonel Silvertopstraat
651,Kolonel Silvertopstraat 5333,2022-12-29,19:00:00,148,99,49,FMN 03 Kolonel Silvertopstraat
651,Kolonel Silvertopstraat 5333,2022-12-29,20:00:00,107,67,40,FMN 03 Kolonel Silvertopstraat
651,Kolonel Silvertopstraat 5333,2022-12-29,21:00:00,69,33,36,FMN 03 Kolonel Silvertopstraat
651,Kolonel Silvertopstraat 5333,2022-12-29,22:00:00,79,40,39,FMN 03 Kolonel Silvertopstraat
651,Kolonel Silvertopstraat 5333,2022-12-29,23:00:00,62,29,33,FMN 03 Kolonel Silvertopstraat
651,Kolonel Silvertopstraat 5333,2022-12-30,00:00:00,38,15,23,FMN 03 Kolonel Silvertopstraat
651,Kolonel Silvertopstraat 5333,2022-12-30,01:00:00,22,9,13,FMN 03 Kolonel Silvertopstraat
651,Kolonel Silvertopstraat 5333,2022-12-30,02:00:00,16,4,12,FMN 03 Kolonel Silvertopstraat
651,Kolonel Silvertopstraat 5333,2022-12-30,03:00:00,22,5,17,FMN 03 Kolonel Silvertopstraat
651,Kolonel Silvertopstraat 5333,2022-12-30,04:00:00,22,15,7,FMN 03 Kolonel Silvertopstraat
651,Kolonel Silvertopstraat 5333,2022-12-30,05:00:00,33,22,11,FMN 03 Kolonel Silvertopstraat
651,Kolonel Silvertopstraat 5333,2022-12-30,06:00:00,56,43,13,FMN 03 Kolonel Silvertopstraat
651,Kolonel Silvertopstraat 5333,2022-12-30,07:00:00,72,52,20,FMN 03 Kolonel Silvertopstraat
651,Kolonel Silvertopstraat 5333,2022-12-30,08:00:00,90,69,21,FMN 03 Kolonel Silvertopstraat
651,Kolonel Silvertopstraat 5333,2022-12-30,09:00:00,108,84,24,FMN 03 Kolonel Silvertopstraat
651,Kolonel Silvertopstraat 5333,2022-12-30,10:00:00,127,97,30,FMN 03 Kolonel Silvertopstraat
651,Kolonel Silvertopstraat 5333,2022-12-30,11:00:00,107,84,23,FMN 03 Kolonel Silvertopstraat
651,Kolonel Silvertopstraat 5333,2022-12-30,12:00:00,115,82,33,FMN 03 Kolonel Silvertopstraat
651,Kolonel Silvertopstraat 5333,2022-12-30,13:00:00,98,55,43,FMN 03 Kolonel Silvertopstraat
651,Kolonel Silvertopstraat 5333,2022-12-30,14:00:00,101,67,34,FMN 03 Kolonel Silvertopstraat
651,Kolonel Silvertopstraat 5333,2022-12-30,15:00:00,124,79,45,FMN 03 Kolonel Silvertopstraat
651,Kolonel Silvertopstraat 5333,2022-12-30,16:00:00,140,97,43,FMN 03 Kolonel Silvertopstraat
651,Kolonel Silvertopstraat 5333,2022-12-30,17:00:00,154,105,49,FMN 03 Kolonel Silvertopstraat
651,Kolonel Silvertopstraat 5333,2022-12-30,18:00:00,136,89,47,FMN 03 Kolonel Silvertopstraat
651,Kolonel Silvertopstraat 5333,2022-12-30,19:00:00,112,61,51,FMN 03 Kolonel Silvertopstraat
651,Kolonel Silvertopstraat 5333,2022-12-30,20:00:00,80,43,37,FMN 03 Kolonel Silvertopstraat
651,Kolonel Silvertopstraat 5333,2022-12-30,21:00:00,92,56,36,FMN 03 Kolonel Silvertopstraat
651,Kolonel Silvertopstraat 5333,2022-12-30,22:00:00,65,38,27,FMN 03 Kolonel Silvertopstraat
651,Kolonel Silvertopstraat 5333,2022-12-30,23:00:00,50,25,25,FMN 03 Kolonel Silvertopstraat
651,Kolonel Silvertopstraat 5333,2022-12-31,00:00:00,40,17,23,FMN 03 Kolonel Silvertopstraat
651,Kolonel Silvertopstraat 5333,2022-12-31,01:00:00,17,8,9,FMN 03 Kolonel Silvertopstraat
651,Kolonel Silvertopstraat 5333,2022-12-31,02:00:00,25,9,16,FMN 03 Kolonel Silvertopstraat
651,Kolonel Silvertopstraat 5333,2022-12-31,03:00:00,11,9,2,FMN 03 Kolonel Silvertopstraat
651,Kolonel Silvertopstraat 5333,2022-12-31,04:00:00,8,6,2,FMN 03 Kolonel Silvertopstraat
651,Kolonel Silvertopstraat 5333,2022-12-31,05:00:00,14,7,7,FMN 03 Kolonel Silvertopstraat
651,Kolonel Silvertopstraat 5333,2022-12-31,06:00:00,23,16,7,FMN 03 Kolonel Silvertopstraat
651,Kolonel Silvertopstraat 5333,2022-12-31,07:00:00,32,23,9,FMN 03 Kolonel Silvertopstraat
651,Kolonel Silvertopstraat 5333,2022-12-31,08:00:00,34,29,5,FMN 03 Kolonel Silvertopstraat
651,Kolonel Silvertopstraat 5333,2022-12-31,09:00:00,65,50,15,FMN 03 Kolonel Silvertopstraat
651,Kolonel Silvertopstraat 5333,2022-12-31,10:00:00,69,59,10,FMN 03 Kolonel Silvertopstraat
651,Kolonel Silvertopstraat 5333,2022-12-31,11:00:00,85,60,25,FMN 03 Kolonel Silvertopstraat
651,Kolonel Silvertopstraat 5333,2022-12-31,12:00:00,96,62,34,FMN 03 Kolonel Silvertopstraat
651,Kolonel Silvertopstraat 5333,2022-12-31,13:00:00,97,72,25,FMN 03 Kolonel Silvertopstraat
651,Kolonel Silvertopstraat 5333,2022-12-31,14:00:00,107,62,45,FMN 03 Kolonel Silvertopstraat
651,Kolonel Silvertopstraat 5333,2022-12-31,15:00:00,118,85,33,FMN 03 Kolonel Silvertopstraat
651,Kolonel Silvertopstraat 5333,2022-12-31,16:00:00,164,101,63,FMN 03 Kolonel Silvertopstraat
651,Kolonel Silvertopstraat 5333,2022-12-31,17:00:00,146,100,46,FMN 03 Kolonel Silvertopstraat
651,Kolonel Silvertopstraat 5333,2022-12-31,18:00:00,133,90,43,FMN 03 Kolonel Silvertopstraat
651,Kolonel Silvertopstraat 5333,2022-12-31,19:00:00,112,87,25,FMN 03 Kolonel Silvertopstraat
651,Kolonel Silvertopstraat 5333,2022-12-31,20:00:00,76,51,25,FMN 03 Kolonel Silvertopstraat
651,Kolonel Silvertopstraat 5333,2022-12-31,21:00:00,72,51,21,FMN 03 Kolonel Silvertopstraat
651,Kolonel Silvertopstraat 5333,2022-12-31,22:00:00,82,64,18,FMN 03 Kolonel Silvertopstraat
651,Kolonel Silvertopstraat 5333,2022-12-31,23:00:00,196,178,18,FMN 03 Kolonel Silvertopstraat
651,Kolonel Silvertopstraat 5333,2023-01-01,00:00:00,77,35,42,FMN 03 Kolonel Silvertopstraat
651,Kolonel Silvertopstraat 5333,2023-01-01,01:00:00,104,58,46,FMN 03 Kolonel Silvertopstraat
651,Kolonel Silvertopstraat 5333,2023-01-01,02:00:00,90,59,31,FMN 03 Kolonel Silvertopstraat
651,Kolonel Silvertopstraat 5333,2023-01-01,03:00:00,75,21,54,FMN 03 Kolonel Silvertopstraat
651,Kolonel Silvertopstraat 5333,2023-01-01,04:00:00,39,13,26,FMN 03 Kolonel Silvertopstraat
651,Kolonel Silvertopstraat 5333,2023-01-01,05:00:00,44,17,27,FMN 03 Kolonel Silvertopstraat
651,Kolonel Silvertopstraat 5333,2023-01-01,06:00:00,40,19,21,FMN 03 Kolonel Silvertopstraat
651,Kolonel Silvertopstraat 5333,2023-01-01,07:00:00,19,11,8,FMN 03 Kolonel Silvertopstraat
651,Kolonel Silvertopstraat 5333,2023-01-01,08:00:00,26,17,9,FMN 03 Kolonel Silvertopstraat
651,Kolonel Silvertopstraat 5333,2023-01-01,09:00:00,21,16,5,FMN 03 Kolonel Silvertopstraat
651,Kolonel Silvertopstraat 5333,2023-01-01,10:00:00,34,24,10,FMN 03 Kolonel Silvertopstraat
651,Kolonel Silvertopstraat 5333,2023-01-01,11:00:00,40,27,13,FMN 03 Kolonel Silvertopstraat
651,Kolonel Silvertopstraat 5333,2023-01-01,12:00:00,57,45,12,FMN 03 Kolonel Silvertopstraat
651,Kolonel Silvertopstraat 5333,2023-01-01,13:00:00,54,40,14,FMN 03 Kolonel Silvertopstraat
651,Kolonel Silvertopstraat 5333,2023-01-01,14:00:00,77,46,31,FMN 03 Kolonel Silvertopstraat
651,Kolonel Silvertopstraat 5333,2023-01-01,15:00:00,92,59,33,FMN 03 Kolonel Silvertopstraat
651,Kolonel Silvertopstraat 5333,2023-01-01,16:00:00,78,52,26,FMN 03 Kolonel Silvertopstraat
651,Kolonel Silvertopstraat 5333,2023-01-01,17:00:00,91,63,28,FMN 03 Kolonel Silvertopstraat
651,Kolonel Silvertopstraat 5333,2023-01-01,18:00:00,66,40,26,FMN 03 Kolonel Silvertopstraat
651,Kolonel Silvertopstraat 5333,2023-01-01,19:00:00,64,37,27,FMN 03 Kolonel Silvertopstraat
651,Kolonel Silvertopstraat 5333,2023-01-01,20:00:00,38,24,14,FMN 03 Kolonel Silvertopstraat
651,Kolonel Silvertopstraat 5333,2023-01-01,21:00:00,46,22,24,FMN 03 Kolonel Silvertopstraat
651,Kolonel Silvertopstraat 5333,2023-01-01,22:00:00,39,21,18,FMN 03 Kolonel Silvertopstraat
651,Kolonel Silvertopstraat 5333,2023-01-01,23:00:00,42,17,25,FMN 03 Kolonel Silvertopstraat
651,Kolonel Silvertopstraat 5333,2023-01-02,00:00:00,27,10,17,FMN 03 Kolonel Silvertopstraat
651,Kolonel Silvertopstraat 5333,2023-01-02,01:00:00,4,1,3,FMN 03 Kolonel Silvertopstraat
651,Kolonel Silvertopstraat 5333,2023-01-02,02:00:00,5,0,5,FMN 03 Kolonel Silvertopstraat
651,Kolonel Silvertopstraat 5333,2023-01-02,03:00:00,7,3,4,FMN 03 Kolonel Silvertopstraat
651,Kolonel Silvertopstraat 5333,2023-01-02,04:00:00,6,4,2,FMN 03 Kolonel Silvertopstraat
651,Kolonel Silvertopstraat 5333,2023-01-02,05:00:00,16,11,5,FMN 03 Kolonel Silvertopstraat
651,Kolonel Silvertopstraat 5333,2023-01-02,06:00:00,59,48,11,FMN 03 Kolonel Silvertopstraat
651,Kolonel Silvertopstraat 5333,2023-01-02,07:00:00,73,56,17,FMN 03 Kolonel Silvertopstraat
651,Kolonel Silvertopstraat 5333,2023-01-02,08:00:00,121,101,20,FMN 03 Kolonel Silvertopstraat
651,Kolonel Silvertopstraat 5333,2023-01-02,09:00:00,78,61,17,FMN 03 Kolonel Silvertopstraat
651,Kolonel Silvertopstraat 5333,2023-01-02,10:00:00,99,78,21,FMN 03 Kolonel Silvertopstraat
651,Kolonel Silvertopstraat 5333,2023-01-02,11:00:00,94,66,28,FMN 03 Kolonel Silvertopstraat
651,Kolonel Silvertopstraat 5333,2023-01-02,12:00:00,105,76,29,FMN 03 Kolonel Silvertopstraat
651,Kolonel Silvertopstraat 5333,2023-01-02,13:00:00,117,82,35,FMN 03 Kolonel Silvertopstraat
651,Kolonel Silvertopstraat 5333,2023-01-02,14:00:00,102,70,32,FMN 03 Kolonel Silvertopstraat
651,Kolonel Silvertopstraat 5333,2023-01-02,15:00:00,137,97,40,FMN 03 Kolonel Silvertopstraat
651,Kolonel Silvertopstraat 5333,2023-01-02,16:00:00,130,89,41,FMN 03 Kolonel Silvertopstraat
651,Kolonel Silvertopstraat 5333,2023-01-02,17:00:00,156,97,59,FMN 03 Kolonel Silvertopstraat
651,Kolonel Silvertopstraat 5333,2023-01-02,18:00:00,116,72,44,FMN 03 Kolonel Silvertopstraat
651,Kolonel Silvertopstraat 5333,2023-01-02,19:00:00,108,61,47,FMN 03 Kolonel Silvertopstraat
651,Kolonel Silvertopstraat 5333,2023-01-02,20:00:00,76,42,34,FMN 03 Kolonel Silvertopstraat
651,Kolonel Silvertopstraat 5333,2023-01-02,21:00:00,69,40,29,FMN 03 Kolonel Silvertopstraat
651,Kolonel Silvertopstraat 5333,2023-01-02,22:00:00,49,32,17,FMN 03 Kolonel Silvertopstraat
651,Kolonel Silvertopstraat 5333,2023-01-02,23:00:00,33,18,15,FMN 03 Kolonel Silvertopstraat
651,Kolonel Silvertopstraat 5333,2023-01-03,00:00:00,23,8,15,FMN 03 Kolonel Silvertopstraat
651,Kolonel Silvertopstraat 5333,2023-01-03,01:00:00,19,6,13,FMN 03 Kolonel Silvertopstraat
651,Kolonel Silvertopstraat 5333,2023-01-03,02:00:00,7,1,6,FMN 03 Kolonel Silvertopstraat
651,Kolonel Silvertopstraat 5333,2023-01-03,03:00:00,13,8,5,FMN 03 Kolonel Silvertopstraat
651,Kolonel Silvertopstraat 5333,2023-01-03,04:00:00,18,12,6,FMN 03 Kolonel Silvertopstraat
651,Kolonel Silvertopstraat 5333,2023-01-03,05:00:00,31,24,7,FMN 03 Kolonel Silvertopstraat
651,Kolonel Silvertopstraat 5333,2023-01-03,06:00:00,88,65,23,FMN 03 Kolonel Silvertopstraat
651,Kolonel Silvertopstraat 5333,2023-01-03,07:00:00,150,122,28,FMN 03 Kolonel Silvertopstraat
651,Kolonel Silvertopstraat 5333,2023-01-03,08:00:00,206,170,36,FMN 03 Kolonel Silvertopstraat
651,Kolonel Silvertopstraat 5333,2023-01-03,09:00:00,142,115,27,FMN 03 Kolonel Silvertopstraat
651,Kolonel Silvertopstraat 5333,2023-01-03,10:00:00,138,107,31,FMN 03 Kolonel Silvertopstraat
651,Kolonel Silvertopstraat 5333,2023-01-03,11:00:00,110,76,34,FMN 03 Kolonel Silvertopstraat
651,Kolonel Silvertopstraat 5333,2023-01-03,12:00:00,136,102,34,FMN 03 Kolonel Silvertopstraat
651,Kolonel Silvertopstraat 5333,2023-01-03,13:00:00,149,95,54,FMN 03 Kolonel Silvertopstraat
651,Kolonel Silvertopstraat 5333,2023-01-03,14:00:00,161,106,55,FMN 03 Kolonel Silvertopstraat
651,Kolonel Silvertopstraat 5333,2023-01-03,15:00:00,176,111,65,FMN 03 Kolonel Silvertopstraat
651,Kolonel Silvertopstraat 5333,2023-01-03,16:00:00,225,149,76,FMN 03 Kolonel Silvertopstraat
651,Kolonel Silvertopstraat 5333,2023-01-03,17:00:00,253,153,100,FMN 03 Kolonel Silvertopstraat
651,Kolonel Silvertopstraat 5333,2023-01-03,18:00:00,204,121,83,FMN 03 Kolonel Silvertopstraat
651,Kolonel Silvertopstraat 5333,2023-01-03,19:00:00,165,90,75,FMN 03 Kolonel Silvertopstraat
651,Kolonel Silvertopstraat 5333,2023-01-03,20:00:00,88,45,43,FMN 03 Kolonel Silvertopstraat
651,Kolonel Silvertopstraat 5333,2023-01-03,21:00:00,77,42,35,FMN 03 Kolonel Silvertopstraat
651,Kolonel Silvertopstraat 5333,2023-01-03,22:00:00,78,46,32,FMN 03 Kolonel Silvertopstraat
651,Kolonel Silvertopstraat 5333,2023-01-03,23:00:00,43,20,23,FMN 03 Kolonel Silvertopstraat
651,Kolonel Silvertopstraat 5333,2023-01-04,00:00:00,17,6,11,FMN 03 Kolonel Silvertopstraat
651,Kolonel Silvertopstraat 5333,2023-01-04,01:00:00,21,11,10,FMN 03 Kolonel Silvertopstraat
651,Kolonel Silvertopstraat 5333,2023-01-04,02:00:00,10,4,6,FMN 03 Kolonel Silvertopstraat
651,Kolonel Silvertopstraat 5333,2023-01-04,03:00:00,9,5,4,FMN 03 Kolonel Silvertopstraat
651,Kolonel Silvertopstraat 5333,2023-01-04,04:00:00,21,19,2,FMN 03 Kolonel Silvertopstraat
651,Kolonel Silvertopstraat 5333,2023-01-04,05:00:00,34,19,15,FMN 03 Kolonel Silvertopstraat
651,Kolonel Silvertopstraat 5333,2023-01-04,06:00:00,94,70,24,FMN 03 Kolonel Silvertopstraat
651,Kolonel Silvertopstraat 5333,2023-01-04,07:00:00,117,89,28,FMN 03 Kolonel Silvertopstraat
651,Kolonel Silvertopstraat 5333,2023-01-04,08:00:00,192,151,41,FMN 03 Kolonel Silvertopstraat
651,Kolonel Silvertopstraat 5333,2023-01-04,09:00:00,148,120,28,FMN 03 Kolonel Silvertopstraat
651,Kolonel Silvertopstraat 5333,2023-01-04,10:00:00,91,68,23,FMN 03 Kolonel Silvertopstraat
651,Kolonel Silvertopstraat 5333,2023-01-04,11:00:00,95,67,28,FMN 03 Kolonel Silvertopstraat
651,Kolonel Silvertopstraat 5333,2023-01-04,12:00:00,95,58,37,FMN 03 Kolonel Silvertopstraat
651,Kolonel Silvertopstraat 5333,2023-01-04,13:00:00,128,86,42,FMN 03 Kolonel Silvertopstraat
651,Kolonel Silvertopstraat 5333,2023-01-04,14:00:00,131,88,43,FMN 03 Kolonel Silvertopstraat
651,Kolonel Silvertopstraat 5333,2023-01-04,15:00:00,123,78,45,FMN 03 Kolonel Silvertopstraat
651,Kolonel Silvertopstraat 5333,2023-01-04,16:00:00,172,132,40,FMN 03 Kolonel Silvertopstraat
651,Kolonel Silvertopstraat 5333,2023-01-04,17:00:00,246,155,91,FMN 03 Kolonel Silvertopstraat
651,Kolonel Silvertopstraat 5333,2023-01-04,18:00:00,213,137,76,FMN 03 Kolonel Silvertopstraat
651,Kolonel Silvertopstraat 5333,2023-01-04,19:00:00,115,74,41,FMN 03 Kolonel Silvertopstraat
651,Kolonel Silvertopstraat 5333,2023-01-04,20:00:00,96,57,39,FMN 03 Kolonel Silvertopstraat
651,Kolonel Silvertopstraat 5333,2023-01-04,21:00:00,68,34,34,FMN 03 Kolonel Silvertopstraat
651,Kolonel Silvertopstraat 5333,2023-01-04,22:00:00,89,46,43,FMN 03 Kolonel Silvertopstraat
651,Kolonel Silvertopstraat 5333,2023-01-04,23:00:00,38,15,23,FMN 03 Kolonel Silvertopstraat
651,Kolonel Silvertopstraat 5333,2023-01-05,00:00:00,25,10,15,FMN 03 Kolonel Silvertopstraat
651,Kolonel Silvertopstraat 5333,2023-01-05,01:00:00,10,2,8,FMN 03 Kolonel Silvertopstraat
651,Kolonel Silvertopstraat 5333,2023-01-05,02:00:00,20,8,12,FMN 03 Kolonel Silvertopstraat
651,Kolonel Silvertopstraat 5333,2023-01-05,03:00:00,10,7,3,FMN 03 Kolonel Silvertopstraat
651,Kolonel Silvertopstraat 5333,2023-01-05,04:00:00,18,15,3,FMN 03 Kolonel Silvertopstraat
651,Kolonel Silvertopstraat 5333,2023-01-05,05:00:00,39,24,15,FMN 03 Kolonel Silvertopstraat
651,Kolonel Silvertopstraat 5333,2023-01-05,06:00:00,89,70,19,FMN 03 Kolonel Silvertopstraat
651,Kolonel Silvertopstraat 5333,2023-01-05,07:00:00,149,115,34,FMN 03 Kolonel Silvertopstraat
651,Kolonel Silvertopstraat 5333,2023-01-05,08:00:00,259,215,44,FMN 03 Kolonel Silvertopstraat
651,Kolonel Silvertopstraat 5333,2023-01-05,09:00:00,171,131,40,FMN 03 Kolonel Silvertopstraat
651,Kolonel Silvertopstraat 5333,2023-01-05,10:00:00,129,104,25,FMN 03 Kolonel Silvertopstraat
651,Kolonel Silvertopstraat 5333,2023-01-05,11:00:00,143,101,42,FMN 03 Kolonel Silvertopstraat
651,Kolonel Silvertopstraat 5333,2023-01-05,12:00:00,158,107,51,FMN 03 Kolonel Silvertopstraat
651,Kolonel Silvertopstraat 5333,2023-01-05,13:00:00,184,134,50,FMN 03 Kolonel Silvertopstraat
651,Kolonel Silvertopstraat 5333,2023-01-05,14:00:00,146,115,31,FMN 03 Kolonel Silvertopstraat
651,Kolonel Silvertopstraat 5333,2023-01-05,15:00:00,166,112,54,FMN 03 Kolonel Silvertopstraat
651,Kolonel Silvertopstraat 5333,2023-01-05,16:00:00,226,165,61,FMN 03 Kolonel Silvertopstraat
651,Kolonel Silvertopstraat 5333,2023-01-05,17:00:00,258,158,100,FMN 03 Kolonel Silvertopstraat
651,Kolonel Silvertopstraat 5333,2023-01-05,18:00:00,220,119,101,FMN 03 Kolonel Silvertopstraat
651,Kolonel Silvertopstraat 5333,2023-01-05,19:00:00,135,93,42,FMN 03 Kolonel Silvertopstraat
651,Kolonel Silvertopstraat 5333,2023-01-05,20:00:00,105,61,44,FMN 03 Kolonel Silvertopstraat
651,Kolonel Silvertopstraat 5333,2023-01-05,21:00:00,70,28,42,FMN 03 Kolonel Silvertopstraat
651,Kolonel Silvertopstraat 5333,2023-01-05,22:00:00,84,43,41,FMN 03 Kolonel Silvertopstraat
651,Kolonel Silvertopstraat 5333,2023-01-05,23:00:00,54,21,33,FMN 03 Kolonel Silvertopstraat
651,Kolonel Silvertopstraat 5333,2023-01-06,00:00:00,28,18,10,FMN 03 Kolonel Silvertopstraat
651,Kolonel Silvertopstraat 5333,2023-01-06,01:00:00,17,7,10,FMN 03 Kolonel Silvertopstraat
651,Kolonel Silvertopstraat 5333,2023-01-06,02:00:00,17,6,11,FMN 03 Kolonel Silvertopstraat
651,Kolonel Silvertopstraat 5333,2023-01-06,03:00:00,7,3,4,FMN 03 Kolonel Silvertopstraat
651,Kolonel Silvertopstraat 5333,2023-01-06,04:00:00,21,15,6,FMN 03 Kolonel Silvertopstraat
651,Kolonel Silvertopstraat 5333,2023-01-06,05:00:00,38,27,11,FMN 03 Kolonel Silvertopstraat
651,Kolonel Silvertopstraat 5333,2023-01-06,06:00:00,91,69,22,FMN 03 Kolonel Silvertopstraat
651,Kolonel Silvertopstraat 5333,2023-01-06,07:00:00,127,97,30,FMN 03 Kolonel Silvertopstraat
651,Kolonel Silvertopstraat 5333,2023-01-06,08:00:00,201,157,44,FMN 03 Kolonel Silvertopstraat
651,Kolonel Silvertopstraat 5333,2023-01-06,09:00:00,163,126,37,FMN 03 Kolonel Silvertopstraat
651,Kolonel Silvertopstraat 5333,2023-01-06,10:00:00,152,124,28,FMN 03 Kolonel Silvertopstraat
651,Kolonel Silvertopstraat 5333,2023-01-06,11:00:00,132,94,38,FMN 03 Kolonel Silvertopstraat
651,Kolonel Silvertopstraat 5333,2023-01-06,12:00:00,183,133,50,FMN 03 Kolonel Silvertopstraat
651,Kolonel Silvertopstraat 5333,2023-01-06,13:00:00,192,137,55,FMN 03 Kolonel Silvertopstraat
651,Kolonel Silvertopstraat 5333,2023-01-06,14:00:00,215,150,65,FMN 03 Kolonel Silvertopstraat
651,Kolonel Silvertopstraat 5333,2023-01-06,15:00:00,218,148,70,FMN 03 Kolonel Silvertopstraat
651,Kolonel Silvertopstraat 5333,2023-01-06,16:00:00,225,157,68,FMN 03 Kolonel Silvertopstraat
651,Kolonel Silvertopstraat 5333,2023-01-06,17:00:00,252,180,72,FMN 03 Kolonel Silvertopstraat
651,Kolonel Silvertopstraat 5333,2023-01-06,18:00:00,220,151,69,FMN 03 Kolonel Silvertopstraat
651,Kolonel Silvertopstraat 5333,2023-01-06,19:00:00,135,86,49,FMN 03 Kolonel Silvertopstraat
651,Kolonel Silvertopstraat 5333,2023-01-06,20:00:00,117,72,45,FMN 03 Kolonel Silvertopstraat
651,Kolonel Silvertopstraat 5333,2023-01-06,21:00:00,84,52,32,FMN 03 Kolonel Silvertopstraat
651,Kolonel Silvertopstraat 5333,2023-01-06,22:00:00,86,43,43,FMN 03 Kolonel Silvertopstraat
651,Kolonel Silvertopstraat 5333,2023-01-06,23:00:00,74,35,39,FMN 03 Kolonel Silvertopstraat
651,Kolonel Silvertopstraat 5333,2023-01-07,00:00:00,61,20,41,FMN 03 Kolonel Silvertopstraat
651,Kolonel Silvertopstraat 5333,2023-01-07,01:00:00,41,12,29,FMN 03 Kolonel Silvertopstraat
651,Kolonel Silvertopstraat 5333,2023-01-07,02:00:00,16,2,14,FMN 03 Kolonel Silvertopstraat
651,Kolonel Silvertopstraat 5333,2023-01-07,03:00:00,15,6,9,FMN 03 Kolonel Silvertopstraat
651,Kolonel Silvertopstraat 5333,2023-01-07,04:00:00,9,6,3,FMN 03 Kolonel Silvertopstraat
651,Kolonel Silvertopstraat 5333,2023-01-07,05:00:00,21,10,11,FMN 03 Kolonel Silvertopstraat
651,Kolonel Silvertopstraat 5333,2023-01-07,06:00:00,27,23,4,FMN 03 Kolonel Silvertopstraat
651,Kolonel Silvertopstraat 5333,2023-01-07,07:00:00,37,23,14,FMN 03 Kolonel Silvertopstraat
651,Kolonel Silvertopstraat 5333,2023-01-07,08:00:00,61,52,9,FMN 03 Kolonel Silvertopstraat
651,Kolonel Silvertopstraat 5333,2023-01-07,09:00:00,114,92,22,FMN 03 Kolonel Silvertopstraat
651,Kolonel Silvertopstraat 5333,2023-01-07,10:00:00,126,95,31,FMN 03 Kolonel Silvertopstraat
651,Kolonel Silvertopstraat 5333,2023-01-07,11:00:00,147,103,44,FMN 03 Kolonel Silvertopstraat
651,Kolonel Silvertopstraat 5333,2023-01-07,12:00:00,150,102,48,FMN 03 Kolonel Silvertopstraat
651,Kolonel Silvertopstraat 5333,2023-01-07,13:00:00,174,131,43,FMN 03 Kolonel Silvertopstraat
651,Kolonel Silvertopstraat 5333,2023-01-07,14:00:00,194,133,61,FMN 03 Kolonel Silvertopstraat
651,Kolonel Silvertopstraat 5333,2023-01-07,15:00:00,165,118,47,FMN 03 Kolonel Silvertopstraat
651,Kolonel Silvertopstraat 5333,2023-01-07,16:00:00,122,83,39,FMN 03 Kolonel Silvertopstraat
651,Kolonel Silvertopstraat 5333,2023-01-07,17:00:00,136,95,41,FMN 03 Kolonel Silvertopstraat
651,Kolonel Silvertopstraat 5333,2023-01-07,18:00:00,132,83,49,FMN 03 Kolonel Silvertopstraat
651,Kolonel Silvertopstraat 5333,2023-01-07,19:00:00,118,76,42,FMN 03 Kolonel Silvertopstraat
651,Kolonel Silvertopstraat 5333,2023-01-07,20:00:00,76,56,20,FMN 03 Kolonel Silvertopstraat
651,Kolonel Silvertopstraat 5333,2023-01-07,21:00:00,67,40,27,FMN 03 Kolonel Silvertopstraat
651,Kolonel Silvertopstraat 5333,2023-01-07,22:00:00,69,41,28,FMN 03 Kolonel Silvertopstraat
651,Kolonel Silvertopstraat 5333,2023-01-07,23:00:00,60,31,29,FMN 03 Kolonel Silvertopstraat
651,Kolonel Silvertopstraat 5333,2023-01-08,00:00:00,44,15,29,FMN 03 Kolonel Silvertopstraat
651,Kolonel Silvertopstraat 5333,2023-01-08,01:00:00,39,15,24,FMN 03 Kolonel Silvertopstraat
651,Kolonel Silvertopstraat 5333,2023-01-08,02:00:00,21,6,15,FMN 03 Kolonel Silvertopstraat
651,Kolonel Silvertopstraat 5333,2023-01-08,03:00:00,21,4,17,FMN 03 Kolonel Silvertopstraat
651,Kolonel Silvertopstraat 5333,2023-01-08,04:00:00,15,8,7,FMN 03 Kolonel Silvertopstraat
651,Kolonel Silvertopstraat 5333,2023-01-08,05:00:00,9,3,6,FMN 03 Kolonel Silvertopstraat
651,Kolonel Silvertopstraat 5333,2023-01-08,06:00:00,24,18,6,FMN 03 Kolonel Silvertopstraat
651,Kolonel Silvertopstraat 5333,2023-01-08,07:00:00,21,17,4,FMN 03 Kolonel Silvertopstraat
651,Kolonel Silvertopstraat 5333,2023-01-08,08:00:00,27,20,7,FMN 03 Kolonel Silvertopstraat
651,Kolonel Silvertopstraat 5333,2023-01-08,09:00:00,90,74,16,FMN 03 Kolonel Silvertopstraat
651,Kolonel Silvertopstraat 5333,2023-01-08,10:00:00,85,63,22,FMN 03 Kolonel Silvertopstraat
651,Kolonel Silvertopstraat 5333,2023-01-08,11:00:00,125,107,18,FMN 03 Kolonel Silvertopstraat
651,Kolonel Silvertopstraat 5333,2023-01-08,12:00:00,130,95,35,FMN 03 Kolonel Silvertopstraat
651,Kolonel Silvertopstraat 5333,2023-01-08,13:00:00,145,118,27,FMN 03 Kolonel Silvertopstraat
651,Kolonel Silvertopstraat 5333,2023-01-08,14:00:00,158,124,34,FMN 03 Kolonel Silvertopstraat
651,Kolonel Silvertopstraat 5333,2023-01-08,15:00:00,147,96,51,FMN 03 Kolonel Silvertopstraat
651,Kolonel Silvertopstraat 5333,2023-01-08,16:00:00,137,92,45,FMN 03 Kolonel Silvertopstraat
651,Kolonel Silvertopstraat 5333,2023-01-08,17:00:00,141,76,65,FMN 03 Kolonel Silvertopstraat
651,Kolonel Silvertopstraat 5333,2023-01-08,18:00:00,143,86,57,FMN 03 Kolonel Silvertopstraat
651,Kolonel Silvertopstraat 5333,2023-01-08,19:00:00,106,63,43,FMN 03 Kolonel Silvertopstraat
651,Kolonel Silvertopstraat 5333,2023-01-08,20:00:00,83,39,44,FMN 03 Kolonel Silvertopstraat
651,Kolonel Silvertopstraat 5333,2023-01-08,21:00:00,80,40,40,FMN 03 Kolonel Silvertopstraat
651,Kolonel Silvertopstraat 5333,2023-01-08,22:00:00,27,17,10,FMN 03 Kolonel Silvertopstraat
651,Kolonel Silvertopstraat 5333,2023-01-08,23:00:00,34,10,24,FMN 03 Kolonel Silvertopstraat
651,Kolonel Silvertopstraat 5333,2023-01-09,00:00:00,15,6,9,FMN 03 Kolonel Silvertopstraat
651,Kolonel Silvertopstraat 5333,2023-01-09,01:00:00,9,5,4,FMN 03 Kolonel Silvertopstraat
651,Kolonel Silvertopstraat 5333,2023-01-09,02:00:00,6,2,4,FMN 03 Kolonel Silvertopstraat
651,Kolonel Silvertopstraat 5333,2023-01-09,03:00:00,11,7,4,FMN 03 Kolonel Silvertopstraat
651,Kolonel Silvertopstraat 5333,2023-01-09,04:00:00,13,9,4,FMN 03 Kolonel Silvertopstraat
651,Kolonel Silvertopstraat 5333,2023-01-09,05:00:00,42,25,17,FMN 03 Kolonel Silvertopstraat
651,Kolonel Silvertopstraat 5333,2023-01-09,06:00:00,106,85,21,FMN 03 Kolonel Silvertopstraat
651,Kolonel Silvertopstraat 5333,2023-01-09,07:00:00,335,281,54,FMN 03 Kolonel Silvertopstraat
651,Kolonel Silvertopstraat 5333,2023-01-09,08:00:00,605,523,82,FMN 03 Kolonel Silvertopstraat
651,Kolonel Silvertopstraat 5333,2023-01-09,09:00:00,181,147,34,FMN 03 Kolonel Silvertopstraat
651,Kolonel Silvertopstraat 5333,2023-01-09,10:00:00,153,114,39,FMN 03 Kolonel Silvertopstraat
651,Kolonel Silvertopstraat 5333,2023-01-09,11:00:00,113,77,36,FMN 03 Kolonel Silvertopstraat
651,Kolonel Silvertopstraat 5333,2023-01-09,12:00:00,192,127,65,FMN 03 Kolonel Silvertopstraat
651,Kolonel Silvertopstraat 5333,2023-01-09,13:00:00,145,106,39,FMN 03 Kolonel Silvertopstraat
651,Kolonel Silvertopstraat 5333,2023-01-09,14:00:00,160,112,48,FMN 03 Kolonel Silvertopstraat
651,Kolonel Silvertopstraat 5333,2023-01-09,15:00:00,241,151,90,FMN 03 Kolonel Silvertopstraat
651,Kolonel Silvertopstraat 5333,2023-01-09,16:00:00,327,205,122,FMN 03 Kolonel Silvertopstraat
651,Kolonel Silvertopstraat 5333,2023-01-09,17:00:00,319,191,128,FMN 03 Kolonel Silvertopstraat
651,Kolonel Silvertopstraat 5333,2023-01-09,18:00:00,235,134,101,FMN 03 Kolonel Silvertopstraat
651,Kolonel Silvertopstraat 5333,2023-01-09,19:00:00,139,88,51,FMN 03 Kolonel Silvertopstraat
651,Kolonel Silvertopstraat 5333,2023-01-09,20:00:00,92,53,39,FMN 03 Kolonel Silvertopstraat
651,Kolonel Silvertopstraat 5333,2023-01-09,21:00:00,69,38,31,FMN 03 Kolonel Silvertopstraat
651,Kolonel Silvertopstraat 5333,2023-01-09,22:00:00,70,41,29,FMN 03 Kolonel Silvertopstraat
651,Kolonel Silvertopstraat 5333,2023-01-09,23:00:00,28,11,17,FMN 03 Kolonel Silvertopstraat
651,Kolonel Silvertopstraat 5333,2023-01-10,00:00:00,24,13,11,FMN 03 Kolonel Silvertopstraat
651,Kolonel Silvertopstraat 5333,2023-01-10,01:00:00,11,6,5,FMN 03 Kolonel Silvertopstraat
651,Kolonel Silvertopstraat 5333,2023-01-10,02:00:00,4,1,3,FMN 03 Kolonel Silvertopstraat
651,Kolonel Silvertopstraat 5333,2023-01-10,03:00:00,9,6,3,FMN 03 Kolonel Silvertopstraat
651,Kolonel Silvertopstraat 5333,2023-01-10,04:00:00,23,19,4,FMN 03 Kolonel Silvertopstraat
651,Kolonel Silvertopstraat 5333,2023-01-10,05:00:00,54,37,17,FMN 03 Kolonel Silvertopstraat
651,Kolonel Silvertopstraat 5333,2023-01-10,06:00:00,121,94,27,FMN 03 Kolonel Silvertopstraat
651,Kolonel Silvertopstraat 5333,2023-01-10,07:00:00,297,248,49,FMN 03 Kolonel Silvertopstraat
651,Kolonel Silvertopstraat 5333,2023-01-10,08:00:00,628,550,78,FMN 03 Kolonel Silvertopstraat
651,Kolonel Silvertopstraat 5333,2023-01-10,09:00:00,212,164,48,FMN 03 Kolonel Silvertopstraat
651,Kolonel Silvertopstraat 5333,2023-01-10,10:00:00,168,137,31,FMN 03 Kolonel Silvertopstraat
651,Kolonel Silvertopstraat 5333,2023-01-10,11:00:00,108,77,31,FMN 03 Kolonel Silvertopstraat
651,Kolonel Silvertopstraat 5333,2023-01-10,12:00:00,183,122,61,FMN 03 Kolonel Silvertopstraat
651,Kolonel Silvertopstraat 5333,2023-01-10,13:00:00,161,104,57,FMN 03 Kolonel Silvertopstraat
651,Kolonel Silvertopstraat 5333,2023-01-10,14:00:00,146,95,51,FMN 03 Kolonel Silvertopstraat
651,Kolonel Silvertopstraat 5333,2023-01-10,15:00:00,240,144,96,FMN 03 Kolonel Silvertopstraat
651,Kolonel Silvertopstraat 5333,2023-01-10,16:00:00,326,208,118,FMN 03 Kolonel Silvertopstraat
651,Kolonel Silvertopstraat 5333,2023-01-10,17:00:00,338,205,133,FMN 03 Kolonel Silvertopstraat
651,Kolonel Silvertopstraat 5333,2023-01-10,18:00:00,229,136,93,FMN 03 Kolonel Silvertopstraat
651,Kolonel Silvertopstraat 5333,2023-01-10,19:00:00,130,80,50,FMN 03 Kolonel Silvertopstraat
651,Kolonel Silvertopstraat 5333,2023-01-10,20:00:00,99,65,34,FMN 03 Kolonel Silvertopstraat
651,Kolonel Silvertopstraat 5333,2023-01-10,21:00:00,91,46,45,FMN 03 Kolonel Silvertopstraat
651,Kolonel Silvertopstraat 5333,2023-01-10,22:00:00,84,47,37,FMN 03 Kolonel Silvertopstraat
651,Kolonel Silvertopstraat 5333,2023-01-10,23:00:00,37,16,21,FMN 03 Kolonel Silvertopstraat
651,Kolonel Silvertopstraat 5333,2023-01-11,00:00:00,13,8,5,FMN 03 Kolonel Silvertopstraat
651,Kolonel Silvertopstraat 5333,2023-01-11,01:00:00,12,4,8,FMN 03 Kolonel Silvertopstraat
651,Kolonel Silvertopstraat 5333,2023-01-11,02:00:00,6,3,3,FMN 03 Kolonel Silvertopstraat
651,Kolonel Silvertopstraat 5333,2023-01-11,03:00:00,6,2,4,FMN 03 Kolonel Silvertopstraat
651,Kolonel Silvertopstraat 5333,2023-01-11,04:00:00,18,14,4,FMN 03 Kolonel Silvertopstraat
651,Kolonel Silvertopstraat 5333,2023-01-11,05:00:00,49,27,22,FMN 03 Kolonel Silvertopstraat
651,Kolonel Silvertopstraat 5333,2023-01-11,06:00:00,112,90,22,FMN 03 Kolonel Silvertopstraat
651,Kolonel Silvertopstraat 5333,2023-01-11,07:00:00,285,231,54,FMN 03 Kolonel Silvertopstraat
651,Kolonel Silvertopstraat 5333,2023-01-11,08:00:00,537,472,65,FMN 03 Kolonel Silvertopstraat
651,Kolonel Silvertopstraat 5333,2023-01-11,09:00:00,186,145,41,FMN 03 Kolonel Silvertopstraat
651,Kolonel Silvertopstraat 5333,2023-01-11,10:00:00,140,104,36,FMN 03 Kolonel Silvertopstraat
651,Kolonel Silvertopstraat 5333,2023-01-11,11:00:00,156,117,39,FMN 03 Kolonel Silvertopstraat
651,Kolonel Silvertopstraat 5333,2023-01-11,12:00:00,283,176,107,FMN 03 Kolonel Silvertopstraat
651,Kolonel Silvertopstraat 5333,2023-01-11,13:00:00,202,134,68,FMN 03 Kolonel Silvertopstraat
651,Kolonel Silvertopstraat 5333,2023-01-11,14:00:00,190,131,59,FMN 03 Kolonel Silvertopstraat
651,Kolonel Silvertopstraat 5333,2023-01-11,15:00:00,207,131,76,FMN 03 Kolonel Silvertopstraat
651,Kolonel Silvertopstraat 5333,2023-01-11,16:00:00,284,197,87,FMN 03 Kolonel Silvertopstraat
651,Kolonel Silvertopstraat 5333,2023-01-11,17:00:00,351,236,115,FMN 03 Kolonel Silvertopstraat
651,Kolonel Silvertopstraat 5333,2023-01-11,18:00:00,264,153,111,FMN 03 Kolonel Silvertopstraat
651,Kolonel Silvertopstraat 5333,2023-01-11,19:00:00,145,83,62,FMN 03 Kolonel Silvertopstraat
651,Kolonel Silvertopstraat 5333,2023-01-11,20:00:00,97,58,39,FMN 03 Kolonel Silvertopstraat
651,Kolonel Silvertopstraat 5333,2023-01-11,21:00:00,81,47,34,FMN 03 Kolonel Silvertopstraat
651,Kolonel Silvertopstraat 5333,2023-01-11,22:00:00,68,31,37,FMN 03 Kolonel Silvertopstraat
651,Kolonel Silvertopstraat 5333,2023-01-11,23:00:00,51,24,27,FMN 03 Kolonel Silvertopstraat
651,Kolonel Silvertopstraat 5333,2023-01-12,00:00:00,21,7,14,FMN 03 Kolonel Silvertopstraat
651,Kolonel Silvertopstraat 5333,2023-01-12,01:00:00,9,4,5,FMN 03 Kolonel Silvertopstraat
651,Kolonel Silvertopstraat 5333,2023-01-12,02:00:00,4,1,3,FMN 03 Kolonel Silvertopstraat
651,Kolonel Silvertopstraat 5333,2023-01-12,03:00:00,5,4,1,FMN 03 Kolonel Silvertopstraat
651,Kolonel Silvertopstraat 5333,2023-01-12,04:00:00,13,10,3,FMN 03 Kolonel Silvertopstraat
651,Kolonel Silvertopstraat 5333,2023-01-12,05:00:00,37,21,16,FMN 03 Kolonel Silvertopstraat
651,Kolonel Silvertopstraat 5333,2023-01-12,06:00:00,85,70,15,FMN 03 Kolonel Silvertopstraat
651,Kolonel Silvertopstraat 5333,2023-01-12,07:00:00,228,189,39,FMN 03 Kolonel Silvertopstraat
651,Kolonel Silvertopstraat 5333,2023-01-12,08:00:00,426,365,61,FMN 03 Kolonel Silvertopstraat
651,Kolonel Silvertopstraat 5333,2023-01-12,09:00:00,125,105,20,FMN 03 Kolonel Silvertopstraat
651,Kolonel Silvertopstraat 5333,2023-01-12,10:00:00,90,65,25,FMN 03 Kolonel Silvertopstraat
651,Kolonel Silvertopstraat 5333,2023-01-12,11:00:00,68,53,15,FMN 03 Kolonel Silvertopstraat
651,Kolonel Silvertopstraat 5333,2023-01-12,12:00:00,102,61,41,FMN 03 Kolonel Silvertopstraat
651,Kolonel Silvertopstraat 5333,2023-01-12,13:00:00,91,61,30,FMN 03 Kolonel Silvertopstraat
651,Kolonel Silvertopstraat 5333,2023-01-12,14:00:00,111,66,45,FMN 03 Kolonel Silvertopstraat
651,Kolonel Silvertopstraat 5333,2023-01-12,15:00:00,176,100,76,FMN 03 Kolonel Silvertopstraat
651,Kolonel Silvertopstraat 5333,2023-01-12,16:00:00,195,128,67,FMN 03 Kolonel Silvertopstraat
651,Kolonel Silvertopstraat 5333,2023-01-12,17:00:00,235,160,75,FMN 03 Kolonel Silvertopstraat
651,Kolonel Silvertopstraat 5333,2023-01-12,18:00:00,169,109,60,FMN 03 Kolonel Silvertopstraat
651,Kolonel Silvertopstraat 5333,2023-01-12,19:00:00,116,66,50,FMN 03 Kolonel Silvertopstraat
651,Kolonel Silvertopstraat 5333,2023-01-12,20:00:00,79,42,37,FMN 03 Kolonel Silvertopstraat
651,Kolonel Silvertopstraat 5333,2023-01-12,21:00:00,59,27,32,FMN 03 Kolonel Silvertopstraat
651,Kolonel Silvertopstraat 5333,2023-01-12,22:00:00,60,29,31,FMN 03 Kolonel Silvertopstraat
651,Kolonel Silvertopstraat 5333,2023-01-12,23:00:00,42,23,19,FMN 03 Kolonel Silvertopstraat
651,Kolonel Silvertopstraat 5333,2023-01-13,00:00:00,26,10,16,FMN 03 Kolonel Silvertopstraat
651,Kolonel Silvertopstraat 5333,2023-01-13,01:00:00,14,5,9,FMN 03 Kolonel Silvertopstraat
651,Kolonel Silvertopstraat 5333,2023-01-13,02:00:00,6,2,4,FMN 03 Kolonel Silvertopstraat
651,Kolonel Silvertopstraat 5333,2023-01-13,03:00:00,6,3,3,FMN 03 Kolonel Silvertopstraat
651,Kolonel Silvertopstraat 5333,2023-01-13,04:00:00,20,13,7,FMN 03 Kolonel Silvertopstraat
651,Kolonel Silvertopstraat 5333,2023-01-13,05:00:00,50,34,16,FMN 03 Kolonel Silvertopstraat
651,Kolonel Silvertopstraat 5333,2023-01-13,06:00:00,100,76,24,FMN 03 Kolonel Silvertopstraat
651,Kolonel Silvertopstraat 5333,2023-01-13,07:00:00,265,217,48,FMN 03 Kolonel Silvertopstraat
651,Kolonel Silvertopstraat 5333,2023-01-13,08:00:00,498,434,64,FMN 03 Kolonel Silvertopstraat
651,Kolonel Silvertopstraat 5333,2023-01-13,09:00:00,199,162,37,FMN 03 Kolonel Silvertopstraat
651,Kolonel Silvertopstraat 5333,2023-01-13,10:00:00,172,127,45,FMN 03 Kolonel Silvertopstraat
651,Kolonel Silvertopstraat 5333,2023-01-13,11:00:00,125,90,35,FMN 03 Kolonel Silvertopstraat
651,Kolonel Silvertopstraat 5333,2023-01-13,12:00:00,188,128,60,FMN 03 Kolonel Silvertopstraat
651,Kolonel Silvertopstraat 5333,2023-01-13,13:00:00,157,103,54,FMN 03 Kolonel Silvertopstraat
651,Kolonel Silvertopstraat 5333,2023-01-13,14:00:00,166,111,55,FMN 03 Kolonel Silvertopstraat
651,Kolonel Silvertopstraat 5333,2023-01-13,15:00:00,277,180,97,FMN 03 Kolonel Silvertopstraat
651,Kolonel Silvertopstraat 5333,2023-01-13,16:00:00,338,213,125,FMN 03 Kolonel Silvertopstraat
651,Kolonel Silvertopstraat 5333,2023-01-13,17:00:00,291,200,91,FMN 03 Kolonel Silvertopstraat
651,Kolonel Silvertopstraat 5333,2023-01-13,18:00:00,241,150,91,FMN 03 Kolonel Silvertopstraat
651,Kolonel Silvertopstraat 5333,2023-01-13,19:00:00,172,120,52,FMN 03 Kolonel Silvertopstraat
651,Kolonel Silvertopstraat 5333,2023-01-13,20:00:00,140,84,56,FMN 03 Kolonel Silvertopstraat
651,Kolonel Silvertopstraat 5333,2023-01-13,21:00:00,103,62,41,FMN 03 Kolonel Silvertopstraat
651,Kolonel Silvertopstraat 5333,2023-01-13,22:00:00,99,53,46,FMN 03 Kolonel Silvertopstraat
651,Kolonel Silvertopstraat 5333,2023-01-13,23:00:00,84,38,46,FMN 03 Kolonel Silvertopstraat
651,Kolonel Silvertopstraat 5333,2023-01-14,00:00:00,59,28,31,FMN 03 Kolonel Silvertopstraat
651,Kolonel Silvertopstraat 5333,2023-01-14,01:00:00,40,15,25,FMN 03 Kolonel Silvertopstraat
651,Kolonel Silvertopstraat 5333,2023-01-14,02:00:00,31,10,21,FMN 03 Kolonel Silvertopstraat
651,Kolonel Silvertopstraat 5333,2023-01-14,03:00:00,17,5,12,FMN 03 Kolonel Silvertopstraat
651,Kolonel Silvertopstraat 5333,2023-01-14,04:00:00,12,7,5,FMN 03 Kolonel Silvertopstraat
651,Kolonel Silvertopstraat 5333,2023-01-14,05:00:00,24,12,12,FMN 03 Kolonel Silvertopstraat
651,Kolonel Silvertopstraat 5333,2023-01-14,06:00:00,24,20,4,FMN 03 Kolonel Silvertopstraat
651,Kolonel Silvertopstraat 5333,2023-01-14,07:00:00,24,19,5,FMN 03 Kolonel Silvertopstraat
651,Kolonel Silvertopstraat 5333,2023-01-14,08:00:00,45,33,12,FMN 03 Kolonel Silvertopstraat
651,Kolonel Silvertopstraat 5333,2023-01-14,09:00:00,62,47,15,FMN 03 Kolonel Silvertopstraat
651,Kolonel Silvertopstraat 5333,2023-01-14,10:00:00,61,43,18,FMN 03 Kolonel Silvertopstraat
651,Kolonel Silvertopstraat 5333,2023-01-14,11:00:00,79,56,23,FMN 03 Kolonel Silvertopstraat
651,Kolonel Silvertopstraat 5333,2023-01-14,12:00:00,77,55,22,FMN 03 Kolonel Silvertopstraat
651,Kolonel Silvertopstraat 5333,2023-01-14,13:00:00,68,51,17,FMN 03 Kolonel Silvertopstraat
651,Kolonel Silvertopstraat 5333,2023-01-14,14:00:00,86,58,28,FMN 03 Kolonel Silvertopstraat
651,Kolonel Silvertopstraat 5333,2023-01-14,15:00:00,91,58,33,FMN 03 Kolonel Silvertopstraat
651,Kolonel Silvertopstraat 5333,2023-01-14,16:00:00,84,57,27,FMN 03 Kolonel Silvertopstraat
651,Kolonel Silvertopstraat 5333,2023-01-14,17:00:00,92,64,28,FMN 03 Kolonel Silvertopstraat
651,Kolonel Silvertopstraat 5333,2023-01-14,18:00:00,118,78,40,FMN 03 Kolonel Silvertopstraat
651,Kolonel Silvertopstraat 5333,2023-01-14,19:00:00,115,86,29,FMN 03 Kolonel Silvertopstraat
651,Kolonel Silvertopstraat 5333,2023-01-14,20:00:00,79,51,28,FMN 03 Kolonel Silvertopstraat
651,Kolonel Silvertopstraat 5333,2023-01-14,21:00:00,72,43,29,FMN 03 Kolonel Silvertopstraat
651,Kolonel Silvertopstraat 5333,2023-01-14,22:00:00,77,35,42,FMN 03 Kolonel Silvertopstraat
651,Kolonel Silvertopstraat 5333,2023-01-14,23:00:00,70,40,30,FMN 03 Kolonel Silvertopstraat
651,Kolonel Silvertopstraat 5333,2023-01-15,00:00:00,56,26,30,FMN 03 Kolonel Silvertopstraat
651,Kolonel Silvertopstraat 5333,2023-01-15,01:00:00,40,16,24,FMN 03 Kolonel Silvertopstraat
651,Kolonel Silvertopstraat 5333,2023-01-15,02:00:00,36,15,21,FMN 03 Kolonel Silvertopstraat
651,Kolonel Silvertopstraat 5333,2023-01-15,03:00:00,44,30,14,FMN 03 Kolonel Silvertopstraat
651,Kolonel Silvertopstraat 5333,2023-01-15,04:00:00,28,24,4,FMN 03 Kolonel Silvertopstraat
651,Kolonel Silvertopstraat 5333,2023-01-15,05:00:00,39,29,10,FMN 03 Kolonel Silvertopstraat
651,Kolonel Silvertopstraat 5333,2023-01-15,06:00:00,24,20,4,FMN 03 Kolonel Silvertopstraat
651,Kolonel Silvertopstraat 5333,2023-01-15,07:00:00,15,11,4,FMN 03 Kolonel Silvertopstraat
651,Kolonel Silvertopstraat 5333,2023-01-15,08:00:00,41,33,8,FMN 03 Kolonel Silvertopstraat
651,Kolonel Silvertopstraat 5333,2023-01-15,09:00:00,92,72,20,FMN 03 Kolonel Silvertopstraat
651,Kolonel Silvertopstraat 5333,2023-01-15,10:00:00,112,96,16,FMN 03 Kolonel Silvertopstraat
651,Kolonel Silvertopstraat 5333,2023-01-15,11:00:00,102,75,27,FMN 03 Kolonel Silvertopstraat
651,Kolonel Silvertopstraat 5333,2023-01-15,12:00:00,96,64,32,FMN 03 Kolonel Silvertopstraat
651,Kolonel Silvertopstraat 5333,2023-01-15,13:00:00,103,75,28,FMN 03 Kolonel Silvertopstraat
651,Kolonel Silvertopstraat 5333,2023-01-15,14:00:00,122,76,46,FMN 03 Kolonel Silvertopstraat
651,Kolonel Silvertopstraat 5333,2023-01-15,15:00:00,103,73,30,FMN 03 Kolonel Silvertopstraat
651,Kolonel Silvertopstraat 5333,2023-01-15,16:00:00,103,74,29,FMN 03 Kolonel Silvertopstraat
651,Kolonel Silvertopstraat 5333,2023-01-15,17:00:00,129,84,45,FMN 03 Kolonel Silvertopstraat
651,Kolonel Silvertopstraat 5333,2023-01-15,18:00:00,90,54,36,FMN 03 Kolonel Silvertopstraat
651,Kolonel Silvertopstraat 5333,2023-01-15,19:00:00,73,40,33,FMN 03 Kolonel Silvertopstraat
651,Kolonel Silvertopstraat 5333,2023-01-15,20:00:00,66,31,35,FMN 03 Kolonel Silvertopstraat
651,Kolonel Silvertopstraat 5333,2023-01-15,21:00:00,57,30,27,FMN 03 Kolonel Silvertopstraat
651,Kolonel Silvertopstraat 5333,2023-01-15,22:00:00,44,21,23,FMN 03 Kolonel Silvertopstraat
651,Kolonel Silvertopstraat 5333,2023-01-15,23:00:00,31,9,22,FMN 03 Kolonel Silvertopstraat
651,Kolonel Silvertopstraat 5333,2023-01-16,00:00:00,16,8,8,FMN 03 Kolonel Silvertopstraat
651,Kolonel Silvertopstraat 5333,2023-01-16,01:00:00,7,0,7,FMN 03 Kolonel Silvertopstraat
651,Kolonel Silvertopstraat 5333,2023-01-16,02:00:00,2,2,0,FMN 03 Kolonel Silvertopstraat
651,Kolonel Silvertopstraat 5333,2023-01-16,03:00:00,8,6,2,FMN 03 Kolonel Silvertopstraat
651,Kolonel Silvertopstraat 5333,2023-01-16,04:00:00,8,5,3,FMN 03 Kolonel Silvertopstraat
651,Kolonel Silvertopstraat 5333,2023-01-16,05:00:00,33,21,12,FMN 03 Kolonel Silvertopstraat
651,Kolonel Silvertopstraat 5333,2023-01-16,06:00:00,102,81,21,FMN 03 Kolonel Silvertopstraat
651,Kolonel Silvertopstraat 5333,2023-01-16,07:00:00,204,166,38,FMN 03 Kolonel Silvertopstraat
651,Kolonel Silvertopstraat 5333,2023-01-16,08:00:00,449,376,73,FMN 03 Kolonel Silvertopstraat
651,Kolonel Silvertopstraat 5333,2023-01-16,09:00:00,152,113,39,FMN 03 Kolonel Silvertopstraat
651,Kolonel Silvertopstraat 5333,2023-01-16,10:00:00,128,98,30,FMN 03 Kolonel Silvertopstraat
651,Kolonel Silvertopstraat 5333,2023-01-16,11:00:00,90,63,27,FMN 03 Kolonel Silvertopstraat
651,Kolonel Silvertopstraat 5333,2023-01-16,12:00:00,99,64,35,FMN 03 Kolonel Silvertopstraat
651,Kolonel Silvertopstraat 5333,2023-01-16,13:00:00,127,78,49,FMN 03 Kolonel Silvertopstraat
651,Kolonel Silvertopstraat 5333,2023-01-16,14:00:00,128,84,44,FMN 03 Kolonel Silvertopstraat
651,Kolonel Silvertopstraat 5333,2023-01-16,15:00:00,205,126,79,FMN 03 Kolonel Silvertopstraat
651,Kolonel Silvertopstraat 5333,2023-01-16,16:00:00,260,150,110,FMN 03 Kolonel Silvertopstraat
651,Kolonel Silvertopstraat 5333,2023-01-16,17:00:00,245,142,103,FMN 03 Kolonel Silvertopstraat
651,Kolonel Silvertopstraat 5333,2023-01-16,18:00:00,164,96,68,FMN 03 Kolonel Silvertopstraat
651,Kolonel Silvertopstraat 5333,2023-01-16,19:00:00,93,54,39,FMN 03 Kolonel Silvertopstraat
651,Kolonel Silvertopstraat 5333,2023-01-16,20:00:00,83,44,39,FMN 03 Kolonel Silvertopstraat
651,Kolonel Silvertopstraat 5333,2023-01-16,21:00:00,50,24,26,FMN 03 Kolonel Silvertopstraat
651,Kolonel Silvertopstraat 5333,2023-01-16,22:00:00,57,33,24,FMN 03 Kolonel Silvertopstraat
651,Kolonel Silvertopstraat 5333,2023-01-16,23:00:00,19,9,10,FMN 03 Kolonel Silvertopstraat
651,Kolonel Silvertopstraat 5333,2023-01-17,00:00:00,8,4,4,FMN 03 Kolonel Silvertopstraat
651,Kolonel Silvertopstraat 5333,2023-01-17,01:00:00,7,2,5,FMN 03 Kolonel Silvertopstraat
651,Kolonel Silvertopstraat 5333,2023-01-17,02:00:00,4,2,2,FMN 03 Kolonel Silvertopstraat
651,Kolonel Silvertopstraat 5333,2023-01-17,03:00:00,5,4,1,FMN 03 Kolonel Silvertopstraat
651,Kolonel Silvertopstraat 5333,2023-01-17,04:00:00,17,17,0,FMN 03 Kolonel Silvertopstraat
651,Kolonel Silvertopstraat 5333,2023-01-17,05:00:00,33,21,12,FMN 03 Kolonel Silvertopstraat
651,Kolonel Silvertopstraat 5333,2023-01-17,06:00:00,119,98,21,FMN 03 Kolonel Silvertopstraat
651,Kolonel Silvertopstraat 5333,2023-01-17,07:00:00,280,225,55,FMN 03 Kolonel Silvertopstraat
651,Kolonel Silvertopstraat 5333,2023-01-17,08:00:00,499,429,70,FMN 03 Kolonel Silvertopstraat
651,Kolonel Silvertopstraat 5333,2023-01-17,09:00:00,195,153,42,FMN 03 Kolonel Silvertopstraat
651,Kolonel Silvertopstraat 5333,2023-01-17,10:00:00,143,104,39,FMN 03 Kolonel Silvertopstraat
651,Kolonel Silvertopstraat 5333,2023-01-17,11:00:00,121,81,40,FMN 03 Kolonel Silvertopstraat
651,Kolonel Silvertopstraat 5333,2023-01-17,12:00:00,174,126,48,FMN 03 Kolonel Silvertopstraat
651,Kolonel Silvertopstraat 5333,2023-01-17,13:00:00,180,121,59,FMN 03 Kolonel Silvertopstraat
651,Kolonel Silvertopstraat 5333,2023-01-17,14:00:00,187,119,68,FMN 03 Kolonel Silvertopstraat
651,Kolonel Silvertopstraat 5333,2023-01-17,15:00:00,238,148,90,FMN 03 Kolonel Silvertopstraat
651,Kolonel Silvertopstraat 5333,2023-01-17,16:00:00,341,213,128,FMN 03 Kolonel Silvertopstraat
651,Kolonel Silvertopstraat 5333,2023-01-17,17:00:00,342,213,129,FMN 03 Kolonel Silvertopstraat
651,Kolonel Silvertopstraat 5333,2023-01-17,18:00:00,239,132,107,FMN 03 Kolonel Silvertopstraat
651,Kolonel Silvertopstraat 5333,2023-01-17,19:00:00,164,107,57,FMN 03 Kolonel Silvertopstraat
651,Kolonel Silvertopstraat 5333,2023-01-17,20:00:00,113,58,55,FMN 03 Kolonel Silvertopstraat
651,Kolonel Silvertopstraat 5333,2023-01-17,21:00:00,76,37,39,FMN 03 Kolonel Silvertopstraat
651,Kolonel Silvertopstraat 5333,2023-01-17,22:00:00,73,44,29,FMN 03 Kolonel Silvertopstraat
651,Kolonel Silvertopstraat 5333,2023-01-17,23:00:00,42,13,29,FMN 03 Kolonel Silvertopstraat
651,Kolonel Silvertopstraat 5333,2023-01-18,00:00:00,8,3,5,FMN 03 Kolonel Silvertopstraat
651,Kolonel Silvertopstraat 5333,2023-01-18,01:00:00,6,0,6,FMN 03 Kolonel Silvertopstraat
651,Kolonel Silvertopstraat 5333,2023-01-18,02:00:00,5,1,4,FMN 03 Kolonel Silvertopstraat
651,Kolonel Silvertopstraat 5333,2023-01-18,03:00:00,2,1,1,FMN 03 Kolonel Silvertopstraat
651,Kolonel Silvertopstraat 5333,2023-01-18,04:00:00,19,14,5,FMN 03 Kolonel Silvertopstraat
651,Kolonel Silvertopstraat 5333,2023-01-18,05:00:00,23,17,6,FMN 03 Kolonel Silvertopstraat
651,Kolonel Silvertopstraat 5333,2023-01-18,06:00:00,99,76,23,FMN 03 Kolonel Silvertopstraat
651,Kolonel Silvertopstraat 5333,2023-01-18,07:00:00,231,183,48,FMN 03 Kolonel Silvertopstraat
651,Kolonel Silvertopstraat 5333,2023-01-18,08:00:00,468,373,95,FMN 03 Kolonel Silvertopstraat
651,Kolonel Silvertopstraat 5333,2023-01-18,09:00:00,146,115,31,FMN 03 Kolonel Silvertopstraat
651,Kolonel Silvertopstraat 5333,2023-01-18,10:00:00,134,90,44,FMN 03 Kolonel Silvertopstraat
651,Kolonel Silvertopstraat 5333,2023-01-18,11:00:00,132,92,40,FMN 03 Kolonel Silvertopstraat
651,Kolonel Silvertopstraat 5333,2023-01-18,12:00:00,227,138,89,FMN 03 Kolonel Silvertopstraat
651,Kolonel Silvertopstraat 5333,2023-01-18,13:00:00,207,124,83,FMN 03 Kolonel Silvertopstraat
651,Kolonel Silvertopstraat 5333,2023-01-18,14:00:00,169,120,49,FMN 03 Kolonel Silvertopstraat
651,Kolonel Silvertopstraat 5333,2023-01-18,15:00:00,200,131,69,FMN 03 Kolonel Silvertopstraat
651,Kolonel Silvertopstraat 5333,2023-01-18,16:00:00,270,177,93,FMN 03 Kolonel Silvertopstraat
651,Kolonel Silvertopstraat 5333,2023-01-18,17:00:00,290,205,85,FMN 03 Kolonel Silvertopstraat
651,Kolonel Silvertopstraat 5333,2023-01-18,18:00:00,233,149,84,FMN 03 Kolonel Silvertopstraat
651,Kolonel Silvertopstraat 5333,2023-01-18,19:00:00,163,104,59,FMN 03 Kolonel Silvertopstraat
651,Kolonel Silvertopstraat 5333,2023-01-18,20:00:00,100,56,44,FMN 03 Kolonel Silvertopstraat
651,Kolonel Silvertopstraat 5333,2023-01-18,21:00:00,87,47,40,FMN 03 Kolonel Silvertopstraat
651,Kolonel Silvertopstraat 5333,2023-01-18,22:00:00,74,35,39,FMN 03 Kolonel Silvertopstraat
651,Kolonel Silvertopstraat 5333,2023-01-18,23:00:00,52,22,30,FMN 03 Kolonel Silvertopstraat
651,Kolonel Silvertopstraat 5333,2023-01-19,00:00:00,30,11,19,FMN 03 Kolonel Silvertopstraat
651,Kolonel Silvertopstraat 5333,2023-01-19,01:00:00,10,4,6,FMN 03 Kolonel Silvertopstraat
651,Kolonel Silvertopstraat 5333,2023-01-19,02:00:00,4,4,0,FMN 03 Kolonel Silvertopstraat
651,Kolonel Silvertopstraat 5333,2023-01-19,03:00:00,6,5,1,FMN 03 Kolonel Silvertopstraat
651,Kolonel Silvertopstraat 5333,2023-01-19,04:00:00,14,12,2,FMN 03 Kolonel Silvertopstraat
651,Kolonel Silvertopstraat 5333,2023-01-19,05:00:00,38,28,10,FMN 03 Kolonel Silvertopstraat
651,Kolonel Silvertopstraat 5333,2023-01-19,06:00:00,90,66,24,FMN 03 Kolonel Silvertopstraat
651,Kolonel Silvertopstraat 5333,2023-01-19,07:00:00,267,223,44,FMN 03 Kolonel Silvertopstraat
651,Kolonel Silvertopstraat 5333,2023-01-19,08:00:00,506,429,77,FMN 03 Kolonel Silvertopstraat
651,Kolonel Silvertopstraat 5333,2023-01-19,09:00:00,172,127,45,FMN 03 Kolonel Silvertopstraat
651,Kolonel Silvertopstraat 5333,2023-01-19,10:00:00,119,84,35,FMN 03 Kolonel Silvertopstraat
651,Kolonel Silvertopstraat 5333,2023-01-19,11:00:00,114,85,29,FMN 03 Kolonel Silvertopstraat
651,Kolonel Silvertopstraat 5333,2023-01-19,12:00:00,130,88,42,FMN 03 Kolonel Silvertopstraat
651,Kolonel Silvertopstraat 5333,2023-01-19,13:00:00,152,92,60,FMN 03 Kolonel Silvertopstraat
651,Kolonel Silvertopstraat 5333,2023-01-19,14:00:00,147,89,58,FMN 03 Kolonel Silvertopstraat
651,Kolonel Silvertopstraat 5333,2023-01-19,15:00:00,232,132,100,FMN 03 Kolonel Silvertopstraat
651,Kolonel Silvertopstraat 5333,2023-01-19,16:00:00,307,196,111,FMN 03 Kolonel Silvertopstraat
651,Kolonel Silvertopstraat 5333,2023-01-19,17:00:00,277,172,105,FMN 03 Kolonel Silvertopstraat
651,Kolonel Silvertopstraat 5333,2023-01-19,18:00:00,208,130,78,FMN 03 Kolonel Silvertopstraat
651,Kolonel Silvertopstraat 5333,2023-01-19,19:00:00,151,94,57,FMN 03 Kolonel Silvertopstraat
651,Kolonel Silvertopstraat 5333,2023-01-19,20:00:00,107,62,45,FMN 03 Kolonel Silvertopstraat
651,Kolonel Silvertopstraat 5333,2023-01-19,21:00:00,63,21,42,FMN 03 Kolonel Silvertopstraat
651,Kolonel Silvertopstraat 5333,2023-01-19,22:00:00,72,27,45,FMN 03 Kolonel Silvertopstraat
651,Kolonel Silvertopstraat 5333,2023-01-19,23:00:00,35,16,19,FMN 03 Kolonel Silvertopstraat
651,Kolonel Silvertopstraat 5333,2023-01-20,00:00:00,18,6,12,FMN 03 Kolonel Silvertopstraat
651,Kolonel Silvertopstraat 5333,2023-01-20,01:00:00,20,8,12,FMN 03 Kolonel Silvertopstraat
651,Kolonel Silvertopstraat 5333,2023-01-20,02:00:00,10,3,7,FMN 03 Kolonel Silvertopstraat
651,Kolonel Silvertopstraat 5333,2023-01-20,03:00:00,5,4,1,FMN 03 Kolonel Silvertopstraat
651,Kolonel Silvertopstraat 5333,2023-01-20,04:00:00,15,13,2,FMN 03 Kolonel Silvertopstraat
651,Kolonel Silvertopstraat 5333,2023-01-20,05:00:00,37,24,13,FMN 03 Kolonel Silvertopstraat
651,Kolonel Silvertopstraat 5333,2023-01-20,06:00:00,82,62,20,FMN 03 Kolonel Silvertopstraat
651,Kolonel Silvertopstraat 5333,2023-01-20,07:00:00,201,171,30,FMN 03 Kolonel Silvertopstraat
651,Kolonel Silvertopstraat 5333,2023-01-20,08:00:00,320,276,44,FMN 03 Kolonel Silvertopstraat
651,Kolonel Silvertopstraat 5333,2023-01-20,09:00:00,115,86,29,FMN 03 Kolonel Silvertopstraat
651,Kolonel Silvertopstraat 5333,2023-01-20,10:00:00,72,53,19,FMN 03 Kolonel Silvertopstraat
651,Kolonel Silvertopstraat 5333,2023-01-20,11:00:00,97,67,30,FMN 03 Kolonel Silvertopstraat
651,Kolonel Silvertopstraat 5333,2023-01-20,12:00:00,104,67,37,FMN 03 Kolonel Silvertopstraat
651,Kolonel Silvertopstraat 5333,2023-01-20,13:00:00,91,54,37,FMN 03 Kolonel Silvertopstraat
651,Kolonel Silvertopstraat 5333,2023-01-20,14:00:00,110,68,42,FMN 03 Kolonel Silvertopstraat
651,Kolonel Silvertopstraat 5333,2023-01-20,15:00:00,202,136,66,FMN 03 Kolonel Silvertopstraat
651,Kolonel Silvertopstraat 5333,2023-01-20,16:00:00,212,135,77,FMN 03 Kolonel Silvertopstraat
651,Kolonel Silvertopstraat 5333,2023-01-20,17:00:00,206,123,83,FMN 03 Kolonel Silvertopstraat
651,Kolonel Silvertopstraat 5333,2023-01-20,18:00:00,151,100,51,FMN 03 Kolonel Silvertopstraat
651,Kolonel Silvertopstraat 5333,2023-01-20,19:00:00,124,82,42,FMN 03 Kolonel Silvertopstraat
651,Kolonel Silvertopstraat 5333,2023-01-20,20:00:00,83,47,36,FMN 03 Kolonel Silvertopstraat
651,Kolonel Silvertopstraat 5333,2023-01-20,21:00:00,59,30,29,FMN 03 Kolonel Silvertopstraat
651,Kolonel Silvertopstraat 5333,2023-01-20,22:00:00,62,38,24,FMN 03 Kolonel Silvertopstraat
651,Kolonel Silvertopstraat 5333,2023-01-20,23:00:00,50,20,30,FMN 03 Kolonel Silvertopstraat
651,Kolonel Silvertopstraat 5333,2023-01-21,00:00:00,39,18,21,FMN 03 Kolonel Silvertopstraat
651,Kolonel Silvertopstraat 5333,2023-01-21,01:00:00,26,10,16,FMN 03 Kolonel Silvertopstraat
651,Kolonel Silvertopstraat 5333,2023-01-21,02:00:00,22,8,14,FMN 03 Kolonel Silvertopstraat
651,Kolonel Silvertopstraat 5333,2023-01-21,03:00:00,10,5,5,FMN 03 Kolonel Silvertopstraat
651,Kolonel Silvertopstraat 5333,2023-01-21,04:00:00,11,6,5,FMN 03 Kolonel Silvertopstraat
651,Kolonel Silvertopstraat 5333,2023-01-21,05:00:00,10,5,5,FMN 03 Kolonel Silvertopstraat
651,Kolonel Silvertopstraat 5333,2023-01-21,06:00:00,22,18,4,FMN 03 Kolonel Silvertopstraat
651,Kolonel Silvertopstraat 5333,2023-01-21,07:00:00,24,21,3,FMN 03 Kolonel Silvertopstraat
651,Kolonel Silvertopstraat 5333,2023-01-21,08:00:00,38,28,10,FMN 03 Kolonel Silvertopstraat
651,Kolonel Silvertopstraat 5333,2023-01-21,09:00:00,86,66,20,FMN 03 Kolonel Silvertopstraat
651,Kolonel Silvertopstraat 5333,2023-01-21,10:00:00,90,69,21,FMN 03 Kolonel Silvertopstraat
651,Kolonel Silvertopstraat 5333,2023-01-21,11:00:00,106,79,27,FMN 03 Kolonel Silvertopstraat
651,Kolonel Silvertopstraat 5333,2023-01-21,12:00:00,111,76,35,FMN 03 Kolonel Silvertopstraat
651,Kolonel Silvertopstraat 5333,2023-01-21,13:00:00,142,117,25,FMN 03 Kolonel Silvertopstraat
651,Kolonel Silvertopstraat 5333,2023-01-21,14:00:00,129,97,32,FMN 03 Kolonel Silvertopstraat
651,Kolonel Silvertopstraat 5333,2023-01-21,15:00:00,149,94,55,FMN 03 Kolonel Silvertopstraat
651,Kolonel Silvertopstraat 5333,2023-01-21,16:00:00,128,82,46,FMN 03 Kolonel Silvertopstraat
651,Kolonel Silvertopstraat 5333,2023-01-21,17:00:00,143,92,51,FMN 03 Kolonel Silvertopstraat
651,Kolonel Silvertopstraat 5333,2023-01-21,18:00:00,122,70,52,FMN 03 Kolonel Silvertopstraat
651,Kolonel Silvertopstraat 5333,2023-01-21,19:00:00,109,76,33,FMN 03 Kolonel Silvertopstraat
651,Kolonel Silvertopstraat 5333,2023-01-21,20:00:00,68,38,30,FMN 03 Kolonel Silvertopstraat
651,Kolonel Silvertopstraat 5333,2023-01-21,21:00:00,56,36,20,FMN 03 Kolonel Silvertopstraat
651,Kolonel Silvertopstraat 5333,2023-01-21,22:00:00,64,28,36,FMN 03 Kolonel Silvertopstraat
651,Kolonel Silvertopstraat 5333,2023-01-21,23:00:00,47,16,31,FMN 03 Kolonel Silvertopstraat
651,Kolonel Silvertopstraat 5333,2023-01-22,00:00:00,30,14,16,FMN 03 Kolonel Silvertopstraat
651,Kolonel Silvertopstraat 5333,2023-01-22,01:00:00,20,2,18,FMN 03 Kolonel Silvertopstraat
651,Kolonel Silvertopstraat 5333,2023-01-22,02:00:00,11,3,8,FMN 03 Kolonel Silvertopstraat
651,Kolonel Silvertopstraat 5333,2023-01-22,03:00:00,17,5,12,FMN 03 Kolonel Silvertopstraat
651,Kolonel Silvertopstraat 5333,2023-01-22,04:00:00,10,3,7,FMN 03 Kolonel Silvertopstraat
651,Kolonel Silvertopstraat 5333,2023-01-22,05:00:00,16,11,5,FMN 03 Kolonel Silvertopstraat
651,Kolonel Silvertopstraat 5333,2023-01-22,06:00:00,18,11,7,FMN 03 Kolonel Silvertopstraat
651,Kolonel Silvertopstraat 5333,2023-01-22,07:00:00,19,17,2,FMN 03 Kolonel Silvertopstraat
651,Kolonel Silvertopstraat 5333,2023-01-22,08:00:00,32,28,4,FMN 03 Kolonel Silvertopstraat
651,Kolonel Silvertopstraat 5333,2023-01-22,09:00:00,67,56,11,FMN 03 Kolonel Silvertopstraat
651,Kolonel Silvertopstraat 5333,2023-01-22,10:00:00,73,61,12,FMN 03 Kolonel Silvertopstraat
651,Kolonel Silvertopstraat 5333,2023-01-22,11:00:00,64,45,19,FMN 03 Kolonel Silvertopstraat
651,Kolonel Silvertopstraat 5333,2023-01-22,12:00:00,76,55,21,FMN 03 Kolonel Silvertopstraat
651,Kolonel Silvertopstraat 5333,2023-01-22,13:00:00,86,57,29,FMN 03 Kolonel Silvertopstraat
651,Kolonel Silvertopstraat 5333,2023-01-22,14:00:00,100,71,29,FMN 03 Kolonel Silvertopstraat
651,Kolonel Silvertopstraat 5333,2023-01-22,15:00:00,81,56,25,FMN 03 Kolonel Silvertopstraat
651,Kolonel Silvertopstraat 5333,2023-01-22,16:00:00,78,57,21,FMN 03 Kolonel Silvertopstraat
651,Kolonel Silvertopstraat 5333,2023-01-22,17:00:00,98,64,34,FMN 03 Kolonel Silvertopstraat
651,Kolonel Silvertopstraat 5333,2023-01-22,18:00:00,84,55,29,FMN 03 Kolonel Silvertopstraat
651,Kolonel Silvertopstraat 5333,2023-01-22,19:00:00,78,45,33,FMN 03 Kolonel Silvertopstraat
651,Kolonel Silvertopstraat 5333,2023-01-22,20:00:00,66,39,27,FMN 03 Kolonel Silvertopstraat
651,Kolonel Silvertopstraat 5333,2023-01-22,21:00:00,57,31,26,FMN 03 Kolonel Silvertopstraat
651,Kolonel Silvertopstraat 5333,2023-01-22,22:00:00,37,18,19,FMN 03 Kolonel Silvertopstraat
651,Kolonel Silvertopstraat 5333,2023-01-22,23:00:00,12,2,10,FMN 03 Kolonel Silvertopstraat
651,Kolonel Silvertopstraat 5333,2023-01-23,00:00:00,12,6,6,FMN 03 Kolonel Silvertopstraat
651,Kolonel Silvertopstraat 5333,2023-01-23,01:00:00,13,5,8,FMN 03 Kolonel Silvertopstraat
651,Kolonel Silvertopstraat 5333,2023-01-23,02:00:00,0,0,0,FMN 03 Kolonel Silvertopstraat
651,Kolonel Silvertopstraat 5333,2023-01-23,03:00:00,3,0,3,FMN 03 Kolonel Silvertopstraat
651,Kolonel Silvertopstraat 5333,2023-01-23,04:00:00,18,13,5,FMN 03 Kolonel Silvertopstraat
651,Kolonel Silvertopstraat 5333,2023-01-23,05:00:00,48,28,20,FMN 03 Kolonel Silvertopstraat
651,Kolonel Silvertopstraat 5333,2023-01-23,06:00:00,99,80,19,FMN 03 Kolonel Silvertopstraat
651,Kolonel Silvertopstraat 5333,2023-01-23,07:00:00,279,235,44,FMN 03 Kolonel Silvertopstraat
651,Kolonel Silvertopstraat 5333,2023-01-23,08:00:00,552,465,87,FMN 03 Kolonel Silvertopstraat
651,Kolonel Silvertopstraat 5333,2023-01-23,09:00:00,162,127,35,FMN 03 Kolonel Silvertopstraat
651,Kolonel Silvertopstraat 5333,2023-01-23,10:00:00,127,98,29,FMN 03 Kolonel Silvertopstraat
651,Kolonel Silvertopstraat 5333,2023-01-23,11:00:00,114,81,33,FMN 03 Kolonel Silvertopstraat
651,Kolonel Silvertopstraat 5333,2023-01-23,12:00:00,148,95,53,FMN 03 Kolonel Silvertopstraat
651,Kolonel Silvertopstraat 5333,2023-01-23,13:00:00,139,90,49,FMN 03 Kolonel Silvertopstraat
651,Kolonel Silvertopstraat 5333,2023-01-23,14:00:00,163,123,40,FMN 03 Kolonel Silvertopstraat
651,Kolonel Silvertopstraat 5333,2023-01-23,15:00:00,273,181,92,FMN 03 Kolonel Silvertopstraat
651,Kolonel Silvertopstraat 5333,2023-01-23,16:00:00,363,228,135,FMN 03 Kolonel Silvertopstraat
651,Kolonel Silvertopstraat 5333,2023-01-23,17:00:00,293,172,121,FMN 03 Kolonel Silvertopstraat
651,Kolonel Silvertopstraat 5333,2023-01-23,18:00:00,210,128,82,FMN 03 Kolonel Silvertopstraat
651,Kolonel Silvertopstraat 5333,2023-01-23,19:00:00,119,74,45,FMN 03 Kolonel Silvertopstraat
651,Kolonel Silvertopstraat 5333,2023-01-23,20:00:00,96,46,50,FMN 03 Kolonel Silvertopstraat
651,Kolonel Silvertopstraat 5333,2023-01-23,21:00:00,70,39,31,FMN 03 Kolonel Silvertopstraat
651,Kolonel Silvertopstraat 5333,2023-01-23,22:00:00,48,25,23,FMN 03 Kolonel Silvertopstraat
651,Kolonel Silvertopstraat 5333,2023-01-23,23:00:00,30,10,20,FMN 03 Kolonel Silvertopstraat
651,Kolonel Silvertopstraat 5333,2023-01-24,00:00:00,14,6,8,FMN 03 Kolonel Silvertopstraat
651,Kolonel Silvertopstraat 5333,2023-01-24,01:00:00,13,7,6,FMN 03 Kolonel Silvertopstraat
651,Kolonel Silvertopstraat 5333,2023-01-24,02:00:00,5,1,4,FMN 03 Kolonel Silvertopstraat
651,Kolonel Silvertopstraat 5333,2023-01-24,03:00:00,6,4,2,FMN 03 Kolonel Silvertopstraat
651,Kolonel Silvertopstraat 5333,2023-01-24,04:00:00,21,13,8,FMN 03 Kolonel Silvertopstraat
651,Kolonel Silvertopstraat 5333,2023-01-24,05:00:00,61,43,18,FMN 03 Kolonel Silvertopstraat
651,Kolonel Silvertopstraat 5333,2023-01-24,06:00:00,121,94,27,FMN 03 Kolonel Silvertopstraat
651,Kolonel Silvertopstraat 5333,2023-01-24,07:00:00,289,238,51,FMN 03 Kolonel Silvertopstraat
651,Kolonel Silvertopstraat 5333,2023-01-24,08:00:00,590,514,76,FMN 03 Kolonel Silvertopstraat
651,Kolonel Silvertopstraat 5333,2023-01-24,09:00:00,202,162,40,FMN 03 Kolonel Silvertopstraat
651,Kolonel Silvertopstraat 5333,2023-01-24,10:00:00,146,110,36,FMN 03 Kolonel Silvertopstraat
651,Kolonel Silvertopstraat 5333,2023-01-24,11:00:00,122,83,39,FMN 03 Kolonel Silvertopstraat
651,Kolonel Silvertopstraat 5333,2023-01-24,12:00:00,192,135,57,FMN 03 Kolonel Silvertopstraat
651,Kolonel Silvertopstraat 5333,2023-01-24,13:00:00,151,113,38,FMN 03 Kolonel Silvertopstraat
651,Kolonel Silvertopstraat 5333,2023-01-24,14:00:00,142,102,40,FMN 03 Kolonel Silvertopstraat
651,Kolonel Silvertopstraat 5333,2023-01-24,15:00:00,225,129,96,FMN 03 Kolonel Silvertopstraat
651,Kolonel Silvertopstraat 5333,2023-01-24,16:00:00,336,222,114,FMN 03 Kolonel Silvertopstraat
651,Kolonel Silvertopstraat 5333,2023-01-24,17:00:00,317,190,127,FMN 03 Kolonel Silvertopstraat
651,Kolonel Silvertopstraat 5333,2023-01-24,18:00:00,240,142,98,FMN 03 Kolonel Silvertopstraat
651,Kolonel Silvertopstraat 5333,2023-01-24,19:00:00,153,95,58,FMN 03 Kolonel Silvertopstraat
651,Kolonel Silvertopstraat 5333,2023-01-24,20:00:00,116,57,59,FMN 03 Kolonel Silvertopstraat
651,Kolonel Silvertopstraat 5333,2023-01-24,21:00:00,75,40,35,FMN 03 Kolonel Silvertopstraat
651,Kolonel Silvertopstraat 5333,2023-01-24,22:00:00,78,37,41,FMN 03 Kolonel Silvertopstraat
651,Kolonel Silvertopstraat 5333,2023-01-24,23:00:00,28,12,16,FMN 03 Kolonel Silvertopstraat
651,Kolonel Silvertopstraat 5333,2023-01-25,00:00:00,20,6,14,FMN 03 Kolonel Silvertopstraat
651,Kolonel Silvertopstraat 5333,2023-01-25,01:00:00,18,4,14,FMN 03 Kolonel Silvertopstraat
651,Kolonel Silvertopstraat 5333,2023-01-25,02:00:00,9,2,7,FMN 03 Kolonel Silvertopstraat
651,Kolonel Silvertopstraat 5333,2023-01-25,03:00:00,5,3,2,FMN 03 Kolonel Silvertopstraat
651,Kolonel Silvertopstraat 5333,2023-01-25,04:00:00,22,15,7,FMN 03 Kolonel Silvertopstraat
651,Kolonel Silvertopstraat 5333,2023-01-25,05:00:00,36,22,14,FMN 03 Kolonel Silvertopstraat
651,Kolonel Silvertopstraat 5333,2023-01-25,06:00:00,117,97,20,FMN 03 Kolonel Silvertopstraat
651,Kolonel Silvertopstraat 5333,2023-01-25,07:00:00,291,240,51,FMN 03 Kolonel Silvertopstraat
651,Kolonel Silvertopstraat 5333,2023-01-25,08:00:00,456,373,83,FMN 03 Kolonel Silvertopstraat
651,Kolonel Silvertopstraat 5333,2023-01-25,09:00:00,155,122,33,FMN 03 Kolonel Silvertopstraat
651,Kolonel Silvertopstraat 5333,2023-01-25,10:00:00,129,96,33,FMN 03 Kolonel Silvertopstraat
651,Kolonel Silvertopstraat 5333,2023-01-25,11:00:00,142,111,31,FMN 03 Kolonel Silvertopstraat
651,Kolonel Silvertopstraat 5333,2023-01-25,12:00:00,269,171,98,FMN 03 Kolonel Silvertopstraat
651,Kolonel Silvertopstraat 5333,2023-01-25,13:00:00,169,111,58,FMN 03 Kolonel Silvertopstraat
651,Kolonel Silvertopstraat 5333,2023-01-25,14:00:00,158,114,44,FMN 03 Kolonel Silvertopstraat
651,Kolonel Silvertopstraat 5333,2023-01-25,15:00:00,168,122,46,FMN 03 Kolonel Silvertopstraat
651,Kolonel Silvertopstraat 5333,2023-01-25,16:00:00,247,166,81,FMN 03 Kolonel Silvertopstraat
651,Kolonel Silvertopstraat 5333,2023-01-25,17:00:00,274,189,85,FMN 03 Kolonel Silvertopstraat
651,Kolonel Silvertopstraat 5333,2023-01-25,18:00:00,224,138,86,FMN 03 Kolonel Silvertopstraat
651,Kolonel Silvertopstraat 5333,2023-01-25,19:00:00,118,71,47,FMN 03 Kolonel Silvertopstraat
651,Kolonel Silvertopstraat 5333,2023-01-25,20:00:00,111,59,52,FMN 03 Kolonel Silvertopstraat
651,Kolonel Silvertopstraat 5333,2023-01-25,21:00:00,64,33,31,FMN 03 Kolonel Silvertopstraat
651,Kolonel Silvertopstraat 5333,2023-01-25,22:00:00,52,25,27,FMN 03 Kolonel Silvertopstraat
651,Kolonel Silvertopstraat 5333,2023-01-25,23:00:00,53,15,38,FMN 03 Kolonel Silvertopstraat
651,Kolonel Silvertopstraat 5333,2023-01-26,00:00:00,13,4,9,FMN 03 Kolonel Silvertopstraat
651,Kolonel Silvertopstraat 5333,2023-01-26,01:00:00,8,1,7,FMN 03 Kolonel Silvertopstraat
651,Kolonel Silvertopstraat 5333,2023-01-26,02:00:00,5,3,2,FMN 03 Kolonel Silvertopstraat
651,Kolonel Silvertopstraat 5333,2023-01-26,03:00:00,5,3,2,FMN 03 Kolonel Silvertopstraat
651,Kolonel Silvertopstraat 5333,2023-01-26,04:00:00,19,13,6,FMN 03 Kolonel Silvertopstraat
651,Kolonel Silvertopstraat 5333,2023-01-26,05:00:00,40,24,16,FMN 03 Kolonel Silvertopstraat
651,Kolonel Silvertopstraat 5333,2023-01-26,06:00:00,96,74,22,FMN 03 Kolonel Silvertopstraat
651,Kolonel Silvertopstraat 5333,2023-01-26,07:00:00,283,234,49,FMN 03 Kolonel Silvertopstraat
651,Kolonel Silvertopstraat 5333,2023-01-26,08:00:00,505,431,74,FMN 03 Kolonel Silvertopstraat
651,Kolonel Silvertopstraat 5333,2023-01-26,09:00:00,178,134,44,FMN 03 Kolonel Silvertopstraat
651,Kolonel Silvertopstraat 5333,2023-01-26,10:00:00,120,89,31,FMN 03 Kolonel Silvertopstraat
651,Kolonel Silvertopstraat 5333,2023-01-26,11:00:00,120,95,25,FMN 03 Kolonel Silvertopstraat
651,Kolonel Silvertopstraat 5333,2023-01-26,12:00:00,172,136,36,FMN 03 Kolonel Silvertopstraat
651,Kolonel Silvertopstraat 5333,2023-01-26,13:00:00,161,116,45,FMN 03 Kolonel Silvertopstraat
651,Kolonel Silvertopstraat 5333,2023-01-26,14:00:00,173,113,60,FMN 03 Kolonel Silvertopstraat
651,Kolonel Silvertopstraat 5333,2023-01-26,15:00:00,257,167,90,FMN 03 Kolonel Silvertopstraat
651,Kolonel Silvertopstraat 5333,2023-01-26,16:00:00,347,213,134,FMN 03 Kolonel Silvertopstraat
651,Kolonel Silvertopstraat 5333,2023-01-26,17:00:00,305,190,115,FMN 03 Kolonel Silvertopstraat
651,Kolonel Silvertopstraat 5333,2023-01-26,18:00:00,241,145,96,FMN 03 Kolonel Silvertopstraat
651,Kolonel Silvertopstraat 5333,2023-01-26,19:00:00,161,102,59,FMN 03 Kolonel Silvertopstraat
651,Kolonel Silvertopstraat 5333,2023-01-26,20:00:00,116,73,43,FMN 03 Kolonel Silvertopstraat
651,Kolonel Silvertopstraat 5333,2023-01-26,21:00:00,99,54,45,FMN 03 Kolonel Silvertopstraat
651,Kolonel Silvertopstraat 5333,2023-01-26,22:00:00,82,35,47,FMN 03 Kolonel Silvertopstraat
651,Kolonel Silvertopstraat 5333,2023-01-26,23:00:00,54,29,25,FMN 03 Kolonel Silvertopstraat
651,Kolonel Silvertopstraat 5333,2023-01-27,00:00:00,25,9,16,FMN 03 Kolonel Silvertopstraat
651,Kolonel Silvertopstraat 5333,2023-01-27,01:00:00,26,6,20,FMN 03 Kolonel Silvertopstraat
651,Kolonel Silvertopstraat 5333,2023-01-27,02:00:00,7,1,6,FMN 03 Kolonel Silvertopstraat
651,Kolonel Silvertopstraat 5333,2023-01-27,03:00:00,9,3,6,FMN 03 Kolonel Silvertopstraat
651,Kolonel Silvertopstraat 5333,2023-01-27,04:00:00,15,9,6,FMN 03 Kolonel Silvertopstraat
651,Kolonel Silvertopstraat 5333,2023-01-27,05:00:00,46,27,19,FMN 03 Kolonel Silvertopstraat
651,Kolonel Silvertopstraat 5333,2023-01-27,06:00:00,96,72,24,FMN 03 Kolonel Silvertopstraat
651,Kolonel Silvertopstraat 5333,2023-01-27,07:00:00,243,195,48,FMN 03 Kolonel Silvertopstraat
651,Kolonel Silvertopstraat 5333,2023-01-27,08:00:00,409,344,65,FMN 03 Kolonel Silvertopstraat
651,Kolonel Silvertopstraat 5333,2023-01-27,09:00:00,182,147,35,FMN 03 Kolonel Silvertopstraat
651,Kolonel Silvertopstraat 5333,2023-01-27,10:00:00,166,123,43,FMN 03 Kolonel Silvertopstraat
651,Kolonel Silvertopstraat 5333,2023-01-27,11:00:00,132,97,35,FMN 03 Kolonel Silvertopstraat
651,Kolonel Silvertopstraat 5333,2023-01-27,12:00:00,167,126,41,FMN 03 Kolonel Silvertopstraat
651,Kolonel Silvertopstraat 5333,2023-01-27,13:00:00,163,101,62,FMN 03 Kolonel Silvertopstraat
651,Kolonel Silvertopstraat 5333,2023-01-27,14:00:00,187,126,61,FMN 03 Kolonel Silvertopstraat
651,Kolonel Silvertopstraat 5333,2023-01-27,15:00:00,270,185,85,FMN 03 Kolonel Silvertopstraat
651,Kolonel Silvertopstraat 5333,2023-01-27,16:00:00,268,180,88,FMN 03 Kolonel Silvertopstraat
651,Kolonel Silvertopstraat 5333,2023-01-27,17:00:00,317,204,113,FMN 03 Kolonel Silvertopstraat
651,Kolonel Silvertopstraat 5333,2023-01-27,18:00:00,198,123,75,FMN 03 Kolonel Silvertopstraat
651,Kolonel Silvertopstraat 5333,2023-01-27,19:00:00,207,111,96,FMN 03 Kolonel Silvertopstraat
651,Kolonel Silvertopstraat 5333,2023-01-27,20:00:00,108,68,40,FMN 03 Kolonel Silvertopstraat
651,Kolonel Silvertopstraat 5333,2023-01-27,21:00:00,112,69,43,FMN 03 Kolonel Silvertopstraat
651,Kolonel Silvertopstraat 5333,2023-01-27,22:00:00,131,90,41,FMN 03 Kolonel Silvertopstraat
651,Kolonel Silvertopstraat 5333,2023-01-27,23:00:00,124,80,44,FMN 03 Kolonel Silvertopstraat
651,Kolonel Silvertopstraat 5333,2023-01-28,00:00:00,75,39,36,FMN 03 Kolonel Silvertopstraat
651,Kolonel Silvertopstraat 5333,2023-01-28,01:00:00,44,21,23,FMN 03 Kolonel Silvertopstraat
651,Kolonel Silvertopstraat 5333,2023-01-28,02:00:00,30,11,19,FMN 03 Kolonel Silvertopstraat
651,Kolonel Silvertopstraat 5333,2023-01-28,03:00:00,21,10,11,FMN 03 Kolonel Silvertopstraat
651,Kolonel Silvertopstraat 5333,2023-01-28,04:00:00,15,6,9,FMN 03 Kolonel Silvertopstraat
651,Kolonel Silvertopstraat 5333,2023-01-28,05:00:00,33,15,18,FMN 03 Kolonel Silvertopstraat
651,Kolonel Silvertopstraat 5333,2023-01-28,06:00:00,31,23,8,FMN 03 Kolonel Silvertopstraat
651,Kolonel Silvertopstraat 5333,2023-01-28,07:00:00,41,34,7,FMN 03 Kolonel Silvertopstraat
651,Kolonel Silvertopstraat 5333,2023-01-28,08:00:00,67,50,17,FMN 03 Kolonel Silvertopstraat
651,Kolonel Silvertopstraat 5333,2023-01-28,09:00:00,129,104,25,FMN 03 Kolonel Silvertopstraat
651,Kolonel Silvertopstraat 5333,2023-01-28,10:00:00,139,111,28,FMN 03 Kolonel Silvertopstraat
651,Kolonel Silvertopstraat 5333,2023-01-28,11:00:00,141,113,28,FMN 03 Kolonel Silvertopstraat
651,Kolonel Silvertopstraat 5333,2023-01-28,12:00:00,151,95,56,FMN 03 Kolonel Silvertopstraat
651,Kolonel Silvertopstraat 5333,2023-01-28,13:00:00,186,127,59,FMN 03 Kolonel Silvertopstraat
651,Kolonel Silvertopstraat 5333,2023-01-28,14:00:00,182,130,52,FMN 03 Kolonel Silvertopstraat
651,Kolonel Silvertopstraat 5333,2023-01-28,15:00:00,170,123,47,FMN 03 Kolonel Silvertopstraat
651,Kolonel Silvertopstraat 5333,2023-01-28,16:00:00,147,92,55,FMN 03 Kolonel Silvertopstraat
651,Kolonel Silvertopstraat 5333,2023-01-28,17:00:00,154,84,70,FMN 03 Kolonel Silvertopstraat
651,Kolonel Silvertopstraat 5333,2023-01-28,18:00:00,185,131,54,FMN 03 Kolonel Silvertopstraat
651,Kolonel Silvertopstraat 5333,2023-01-28,19:00:00,138,110,28,FMN 03 Kolonel Silvertopstraat
651,Kolonel Silvertopstraat 5333,2023-01-28,20:00:00,106,68,38,FMN 03 Kolonel Silvertopstraat
651,Kolonel Silvertopstraat 5333,2023-01-28,21:00:00,76,52,24,FMN 03 Kolonel Silvertopstraat
651,Kolonel Silvertopstraat 5333,2023-01-28,22:00:00,71,28,43,FMN 03 Kolonel Silvertopstraat
651,Kolonel Silvertopstraat 5333,2023-01-28,23:00:00,55,23,32,FMN 03 Kolonel Silvertopstraat
651,Kolonel Silvertopstraat 5333,2023-01-29,00:00:00,60,31,29,FMN 03 Kolonel Silvertopstraat
651,Kolonel Silvertopstraat 5333,2023-01-29,01:00:00,45,15,30,FMN 03 Kolonel Silvertopstraat
651,Kolonel Silvertopstraat 5333,2023-01-29,02:00:00,18,13,5,FMN 03 Kolonel Silvertopstraat
651,Kolonel Silvertopstraat 5333,2023-01-29,03:00:00,27,9,18,FMN 03 Kolonel Silvertopstraat
651,Kolonel Silvertopstraat 5333,2023-01-29,04:00:00,8,2,6,FMN 03 Kolonel Silvertopstraat
651,Kolonel Silvertopstraat 5333,2023-01-29,05:00:00,15,8,7,FMN 03 Kolonel Silvertopstraat
651,Kolonel Silvertopstraat 5333,2023-01-29,06:00:00,24,17,7,FMN 03 Kolonel Silvertopstraat
651,Kolonel Silvertopstraat 5333,2023-01-29,07:00:00,9,6,3,FMN 03 Kolonel Silvertopstraat
651,Kolonel Silvertopstraat 5333,2023-01-29,08:00:00,27,24,3,FMN 03 Kolonel Silvertopstraat
651,Kolonel Silvertopstraat 5333,2023-01-29,09:00:00,62,50,12,FMN 03 Kolonel Silvertopstraat
651,Kolonel Silvertopstraat 5333,2023-01-29,10:00:00,68,54,14,FMN 03 Kolonel Silvertopstraat
651,Kolonel Silvertopstraat 5333,2023-01-29,11:00:00,97,70,27,FMN 03 Kolonel Silvertopstraat
651,Kolonel Silvertopstraat 5333,2023-01-29,12:00:00,104,82,22,FMN 03 Kolonel Silvertopstraat
651,Kolonel Silvertopstraat 5333,2023-01-29,13:00:00,111,77,34,FMN 03 Kolonel Silvertopstraat
651,Kolonel Silvertopstraat 5333,2023-01-29,14:00:00,106,76,30,FMN 03 Kolonel Silvertopstraat
651,Kolonel Silvertopstraat 5333,2023-01-29,15:00:00,100,65,35,FMN 03 Kolonel Silvertopstraat
651,Kolonel Silvertopstraat 5333,2023-01-29,16:00:00,104,76,28,FMN 03 Kolonel Silvertopstraat
651,Kolonel Silvertopstraat 5333,2023-01-29,17:00:00,121,74,47,FMN 03 Kolonel Silvertopstraat
651,Kolonel Silvertopstraat 5333,2023-01-29,18:00:00,109,70,39,FMN 03 Kolonel Silvertopstraat
651,Kolonel Silvertopstraat 5333,2023-01-29,19:00:00,101,58,43,FMN 03 Kolonel Silvertopstraat
651,Kolonel Silvertopstraat 5333,2023-01-29,20:00:00,76,37,39,FMN 03 Kolonel Silvertopstraat
651,Kolonel Silvertopstraat 5333,2023-01-29,21:00:00,58,33,25,FMN 03 Kolonel Silvertopstraat
651,Kolonel Silvertopstraat 5333,2023-01-29,22:00:00,42,23,19,FMN 03 Kolonel Silvertopstraat
651,Kolonel Silvertopstraat 5333,2023-01-29,23:00:00,36,16,20,FMN 03 Kolonel Silvertopstraat
651,Kolonel Silvertopstraat 5333,2023-01-30,00:00:00,24,10,14,FMN 03 Kolonel Silvertopstraat
651,Kolonel Silvertopstraat 5333,2023-01-30,01:00:00,7,5,2,FMN 03 Kolonel Silvertopstraat
651,Kolonel Silvertopstraat 5333,2023-01-30,02:00:00,7,3,4,FMN 03 Kolonel Silvertopstraat
651,Kolonel Silvertopstraat 5333,2023-01-30,03:00:00,6,4,2,FMN 03 Kolonel Silvertopstraat
651,Kolonel Silvertopstraat 5333,2023-01-30,04:00:00,13,10,3,FMN 03 Kolonel Silvertopstraat
651,Kolonel Silvertopstraat 5333,2023-01-30,05:00:00,38,21,17,FMN 03 Kolonel Silvertopstraat
651,Kolonel Silvertopstraat 5333,2023-01-30,06:00:00,112,89,23,FMN 03 Kolonel Silvertopstraat
651,Kolonel Silvertopstraat 5333,2023-01-30,07:00:00,287,239,48,FMN 03 Kolonel Silvertopstraat
651,Kolonel Silvertopstraat 5333,2023-01-30,08:00:00,551,475,76,FMN 03 Kolonel Silvertopstraat
651,Kolonel Silvertopstraat 5333,2023-01-30,09:00:00,190,152,38,FMN 03 Kolonel Silvertopstraat
651,Kolonel Silvertopstraat 5333,2023-01-30,10:00:00,149,107,42,FMN 03 Kolonel Silvertopstraat
651,Kolonel Silvertopstraat 5333,2023-01-30,11:00:00,119,92,27,FMN 03 Kolonel Silvertopstraat
651,Kolonel Silvertopstraat 5333,2023-01-30,12:00:00,163,116,47,FMN 03 Kolonel Silvertopstraat
651,Kolonel Silvertopstraat 5333,2023-01-30,13:00:00,167,106,61,FMN 03 Kolonel Silvertopstraat
651,Kolonel Silvertopstraat 5333,2023-01-30,14:00:00,177,119,58,FMN 03 Kolonel Silvertopstraat
651,Kolonel Silvertopstraat 5333,2023-01-30,15:00:00,270,179,91,FMN 03 Kolonel Silvertopstraat
651,Kolonel Silvertopstraat 5333,2023-01-30,16:00:00,333,202,131,FMN 03 Kolonel Silvertopstraat
651,Kolonel Silvertopstraat 5333,2023-01-30,17:00:00,322,197,125,FMN 03 Kolonel Silvertopstraat
651,Kolonel Silvertopstraat 5333,2023-01-30,18:00:00,236,157,79,FMN 03 Kolonel Silvertopstraat
651,Kolonel Silvertopstraat 5333,2023-01-30,19:00:00,119,72,47,FMN 03 Kolonel Silvertopstraat
651,Kolonel Silvertopstraat 5333,2023-01-30,20:00:00,115,59,56,FMN 03 Kolonel Silvertopstraat
651,Kolonel Silvertopstraat 5333,2023-01-30,21:00:00,90,39,51,FMN 03 Kolonel Silvertopstraat
651,Kolonel Silvertopstraat 5333,2023-01-30,22:00:00,76,53,23,FMN 03 Kolonel Silvertopstraat
651,Kolonel Silvertopstraat 5333,2023-01-30,23:00:00,32,16,16,FMN 03 Kolonel Silvertopstraat
651,Kolonel Silvertopstraat 5333,2023-01-31,00:00:00,24,7,17,FMN 03 Kolonel Silvertopstraat
651,Kolonel Silvertopstraat 5333,2023-01-31,01:00:00,10,2,8,FMN 03 Kolonel Silvertopstraat
651,Kolonel Silvertopstraat 5333,2023-01-31,02:00:00,9,4,5,FMN 03 Kolonel Silvertopstraat
651,Kolonel Silvertopstraat 5333,2023-01-31,03:00:00,3,3,0,FMN 03 Kolonel Silvertopstraat
651,Kolonel Silvertopstraat 5333,2023-01-31,04:00:00,14,11,3,FMN 03 Kolonel Silvertopstraat
651,Kolonel Silvertopstraat 5333,2023-01-31,05:00:00,47,28,19,FMN 03 Kolonel Silvertopstraat
651,Kolonel Silvertopstraat 5333,2023-01-31,06:00:00,112,91,21,FMN 03 Kolonel Silvertopstraat
651,Kolonel Silvertopstraat 5333,2023-01-31,07:00:00,314,267,47,FMN 03 Kolonel Silvertopstraat
651,Kolonel Silvertopstraat 5333,2023-01-31,08:00:00,545,466,79,FMN 03 Kolonel Silvertopstraat
651,Kolonel Silvertopstraat 5333,2023-01-31,09:00:00,183,142,41,FMN 03 Kolonel Silvertopstraat
651,Kolonel Silvertopstraat 5333,2023-01-31,10:00:00,129,97,32,FMN 03 Kolonel Silvertopstraat
651,Kolonel Silvertopstraat 5333,2023-01-31,11:00:00,132,87,45,FMN 03 Kolonel Silvertopstraat
651,Kolonel Silvertopstraat 5333,2023-01-31,12:00:00,166,113,53,FMN 03 Kolonel Silvertopstraat
651,Kolonel Silvertopstraat 5333,2023-01-31,13:00:00,138,86,52,FMN 03 Kolonel Silvertopstraat
651,Kolonel Silvertopstraat 5333,2023-01-31,14:00:00,151,86,65,FMN 03 Kolonel Silvertopstraat
651,Kolonel Silvertopstraat 5333,2023-01-31,15:00:00,259,157,102,FMN 03 Kolonel Silvertopstraat
651,Kolonel Silvertopstraat 5333,2023-01-31,16:00:00,361,233,128,FMN 03 Kolonel Silvertopstraat
651,Kolonel Silvertopstraat 5333,2023-01-31,17:00:00,368,239,129,FMN 03 Kolonel Silvertopstraat
651,Kolonel Silvertopstraat 5333,2023-01-31,18:00:00,259,151,108,FMN 03 Kolonel Silvertopstraat
651,Kolonel Silvertopstraat 5333,2023-01-31,19:00:00,165,117,48,FMN 03 Kolonel Silvertopstraat
651,Kolonel Silvertopstraat 5333,2023-01-31,20:00:00,132,72,60,FMN 03 Kolonel Silvertopstraat
651,Kolonel Silvertopstraat 5333,2023-01-31,21:00:00,100,50,50,FMN 03 Kolonel Silvertopstraat
651,Kolonel Silvertopstraat 5333,2023-01-31,22:00:00,91,57,34,FMN 03 Kolonel Silvertopstraat
651,Kolonel Silvertopstraat 5333,2023-01-31,23:00:00,35,17,18,FMN 03 Kolonel Silvertopstraat
651,Kolonel Silvertopstraat 5333,2023-02-01,00:00:00,25,14,11,FMN 03 Kolonel Silvertopstraat
651,Kolonel Silvertopstraat 5333,2023-02-01,01:00:00,21,7,14,FMN 03 Kolonel Silvertopstraat
651,Kolonel Silvertopstraat 5333,2023-02-01,02:00:00,6,2,4,FMN 03 Kolonel Silvertopstraat
651,Kolonel Silvertopstraat 5333,2023-02-01,03:00:00,16,5,11,FMN 03 Kolonel Silvertopstraat
651,Kolonel Silvertopstraat 5333,2023-02-01,04:00:00,20,16,4,FMN 03 Kolonel Silvertopstraat
651,Kolonel Silvertopstraat 5333,2023-02-01,05:00:00,43,30,13,FMN 03 Kolonel Silvertopstraat
651,Kolonel Silvertopstraat 5333,2023-02-01,06:00:00,117,92,25,FMN 03 Kolonel Silvertopstraat
651,Kolonel Silvertopstraat 5333,2023-02-01,07:00:00,260,224,36,FMN 03 Kolonel Silvertopstraat
651,Kolonel Silvertopstraat 5333,2023-02-01,08:00:00,492,410,82,FMN 03 Kolonel Silvertopstraat
651,Kolonel Silvertopstraat 5333,2023-02-01,09:00:00,197,156,41,FMN 03 Kolonel Silvertopstraat
651,Kolonel Silvertopstraat 5333,2023-02-01,10:00:00,127,91,36,FMN 03 Kolonel Silvertopstraat
651,Kolonel Silvertopstraat 5333,2023-02-01,11:00:00,153,111,42,FMN 03 Kolonel Silvertopstraat
651,Kolonel Silvertopstraat 5333,2023-02-01,12:00:00,291,181,110,FMN 03 Kolonel Silvertopstraat
651,Kolonel Silvertopstraat 5333,2023-02-01,13:00:00,208,126,82,FMN 03 Kolonel Silvertopstraat
651,Kolonel Silvertopstraat 5333,2023-02-01,14:00:00,172,113,59,FMN 03 Kolonel Silvertopstraat
651,Kolonel Silvertopstraat 5333,2023-02-01,15:00:00,186,122,64,FMN 03 Kolonel Silvertopstraat
651,Kolonel Silvertopstraat 5333,2023-02-01,16:00:00,245,165,80,FMN 03 Kolonel Silvertopstraat
651,Kolonel Silvertopstraat 5333,2023-02-01,17:00:00,307,201,106,FMN 03 Kolonel Silvertopstraat
651,Kolonel Silvertopstraat 5333,2023-02-01,18:00:00,238,150,88,FMN 03 Kolonel Silvertopstraat
651,Kolonel Silvertopstraat 5333,2023-02-01,19:00:00,164,100,64,FMN 03 Kolonel Silvertopstraat
651,Kolonel Silvertopstraat 5333,2023-02-01,20:00:00,122,80,42,FMN 03 Kolonel Silvertopstraat
651,Kolonel Silvertopstraat 5333,2023-02-01,21:00:00,74,35,39,FMN 03 Kolonel Silvertopstraat
651,Kolonel Silvertopstraat 5333,2023-02-01,22:00:00,86,58,28,FMN 03 Kolonel Silvertopstraat
651,Kolonel Silvertopstraat 5333,2023-02-01,23:00:00,56,26,30,FMN 03 Kolonel Silvertopstraat
651,Kolonel Silvertopstraat 5333,2023-02-02,00:00:00,26,10,16,FMN 03 Kolonel Silvertopstraat
651,Kolonel Silvertopstraat 5333,2023-02-02,01:00:00,13,4,9,FMN 03 Kolonel Silvertopstraat
651,Kolonel Silvertopstraat 5333,2023-02-02,02:00:00,13,4,9,FMN 03 Kolonel Silvertopstraat
651,Kolonel Silvertopstraat 5333,2023-02-02,03:00:00,12,7,5,FMN 03 Kolonel Silvertopstraat
651,Kolonel Silvertopstraat 5333,2023-02-02,04:00:00,17,13,4,FMN 03 Kolonel Silvertopstraat
651,Kolonel Silvertopstraat 5333,2023-02-02,05:00:00,47,28,19,FMN 03 Kolonel Silvertopstraat
651,Kolonel Silvertopstraat 5333,2023-02-02,06:00:00,114,92,22,FMN 03 Kolonel Silvertopstraat
651,Kolonel Silvertopstraat 5333,2023-02-02,07:00:00,314,261,53,FMN 03 Kolonel Silvertopstraat
651,Kolonel Silvertopstraat 5333,2023-02-02,08:00:00,560,482,78,FMN 03 Kolonel Silvertopstraat
651,Kolonel Silvertopstraat 5333,2023-02-02,09:00:00,213,165,48,FMN 03 Kolonel Silvertopstraat
651,Kolonel Silvertopstraat 5333,2023-02-02,10:00:00,136,103,33,FMN 03 Kolonel Silvertopstraat
651,Kolonel Silvertopstraat 5333,2023-02-02,11:00:00,150,118,32,FMN 03 Kolonel Silvertopstraat
651,Kolonel Silvertopstraat 5333,2023-02-02,12:00:00,158,117,41,FMN 03 Kolonel Silvertopstraat
651,Kolonel Silvertopstraat 5333,2023-02-02,13:00:00,186,122,64,FMN 03 Kolonel Silvertopstraat
651,Kolonel Silvertopstraat 5333,2023-02-02,14:00:00,175,97,78,FMN 03 Kolonel Silvertopstraat
651,Kolonel Silvertopstraat 5333,2023-02-02,15:00:00,272,160,112,FMN 03 Kolonel Silvertopstraat
651,Kolonel Silvertopstraat 5333,2023-02-02,16:00:00,345,227,118,FMN 03 Kolonel Silvertopstraat
651,Kolonel Silvertopstraat 5333,2023-02-02,17:00:00,354,221,133,FMN 03 Kolonel Silvertopstraat
651,Kolonel Silvertopstraat 5333,2023-02-02,18:00:00,242,151,91,FMN 03 Kolonel Silvertopstraat
651,Kolonel Silvertopstraat 5333,2023-02-02,19:00:00,174,110,64,FMN 03 Kolonel Silvertopstraat
651,Kolonel Silvertopstraat 5333,2023-02-02,20:00:00,126,73,53,FMN 03 Kolonel Silvertopstraat
651,Kolonel Silvertopstraat 5333,2023-02-02,21:00:00,100,51,49,FMN 03 Kolonel Silvertopstraat
651,Kolonel Silvertopstraat 5333,2023-02-02,22:00:00,99,57,42,FMN 03 Kolonel Silvertopstraat
651,Kolonel Silvertopstraat 5333,2023-02-02,23:00:00,58,24,34,FMN 03 Kolonel Silvertopstraat
651,Kolonel Silvertopstraat 5333,2023-02-03,00:00:00,38,12,26,FMN 03 Kolonel Silvertopstraat
651,Kolonel Silvertopstraat 5333,2023-02-03,01:00:00,26,17,9,FMN 03 Kolonel Silvertopstraat
651,Kolonel Silvertopstraat 5333,2023-02-03,02:00:00,20,11,9,FMN 03 Kolonel Silvertopstraat
651,Kolonel Silvertopstraat 5333,2023-02-03,03:00:00,12,6,6,FMN 03 Kolonel Silvertopstraat
651,Kolonel Silvertopstraat 5333,2023-02-03,04:00:00,18,10,8,FMN 03 Kolonel Silvertopstraat
651,Kolonel Silvertopstraat 5333,2023-02-03,05:00:00,50,34,16,FMN 03 Kolonel Silvertopstraat
651,Kolonel Silvertopstraat 5333,2023-02-03,06:00:00,110,91,19,FMN 03 Kolonel Silvertopstraat
651,Kolonel Silvertopstraat 5333,2023-02-03,07:00:00,273,224,49,FMN 03 Kolonel Silvertopstraat
651,Kolonel Silvertopstraat 5333,2023-02-03,08:00:00,490,414,76,FMN 03 Kolonel Silvertopstraat
651,Kolonel Silvertopstraat 5333,2023-02-03,09:00:00,200,164,36,FMN 03 Kolonel Silvertopstraat
651,Kolonel Silvertopstraat 5333,2023-02-03,10:00:00,158,126,32,FMN 03 Kolonel Silvertopstraat
651,Kolonel Silvertopstraat 5333,2023-02-03,11:00:00,143,104,39,FMN 03 Kolonel Silvertopstraat
651,Kolonel Silvertopstraat 5333,2023-02-03,12:00:00,193,127,66,FMN 03 Kolonel Silvertopstraat
651,Kolonel Silvertopstraat 5333,2023-02-03,13:00:00,173,115,58,FMN 03 Kolonel Silvertopstraat
651,Kolonel Silvertopstraat 5333,2023-02-03,14:00:00,227,156,71,FMN 03 Kolonel Silvertopstraat
651,Kolonel Silvertopstraat 5333,2023-02-03,15:00:00,269,160,109,FMN 03 Kolonel Silvertopstraat
651,Kolonel Silvertopstraat 5333,2023-02-03,16:00:00,326,221,105,FMN 03 Kolonel Silvertopstraat
651,Kolonel Silvertopstraat 5333,2023-02-03,17:00:00,329,212,117,FMN 03 Kolonel Silvertopstraat
651,Kolonel Silvertopstraat 5333,2023-02-03,18:00:00,244,165,79,FMN 03 Kolonel Silvertopstraat
651,Kolonel Silvertopstraat 5333,2023-02-03,19:00:00,194,130,64,FMN 03 Kolonel Silvertopstraat
651,Kolonel Silvertopstraat 5333,2023-02-03,20:00:00,172,109,63,FMN 03 Kolonel Silvertopstraat
651,Kolonel Silvertopstraat 5333,2023-02-03,21:00:00,98,60,38,FMN 03 Kolonel Silvertopstraat
651,Kolonel Silvertopstraat 5333,2023-02-03,22:00:00,99,53,46,FMN 03 Kolonel Silvertopstraat
651,Kolonel Silvertopstraat 5333,2023-02-03,23:00:00,77,38,39,FMN 03 Kolonel Silvertopstraat
651,Kolonel Silvertopstraat 5333,2023-02-04,00:00:00,57,25,32,FMN 03 Kolonel Silvertopstraat
651,Kolonel Silvertopstraat 5333,2023-02-04,01:00:00,33,15,18,FMN 03 Kolonel Silvertopstraat
651,Kolonel Silvertopstraat 5333,2023-02-04,02:00:00,26,10,16,FMN 03 Kolonel Silvertopstraat
651,Kolonel Silvertopstraat 5333,2023-02-04,03:00:00,21,12,9,FMN 03 Kolonel Silvertopstraat
651,Kolonel Silvertopstraat 5333,2023-02-04,04:00:00,15,8,7,FMN 03 Kolonel Silvertopstraat
651,Kolonel Silvertopstraat 5333,2023-02-04,05:00:00,27,17,10,FMN 03 Kolonel Silvertopstraat
651,Kolonel Silvertopstraat 5333,2023-02-04,06:00:00,37,31,6,FMN 03 Kolonel Silvertopstraat
651,Kolonel Silvertopstraat 5333,2023-02-04,07:00:00,30,26,4,FMN 03 Kolonel Silvertopstraat
651,Kolonel Silvertopstraat 5333,2023-02-04,08:00:00,64,43,21,FMN 03 Kolonel Silvertopstraat
651,Kolonel Silvertopstraat 5333,2023-02-04,09:00:00,96,76,20,FMN 03 Kolonel Silvertopstraat
651,Kolonel Silvertopstraat 5333,2023-02-04,10:00:00,101,79,22,FMN 03 Kolonel Silvertopstraat
651,Kolonel Silvertopstraat 5333,2023-02-04,11:00:00,126,84,42,FMN 03 Kolonel Silvertopstraat
651,Kolonel Silvertopstraat 5333,2023-02-04,12:00:00,103,82,21,FMN 03 Kolonel Silvertopstraat
651,Kolonel Silvertopstraat 5333,2023-02-04,13:00:00,124,91,33,FMN 03 Kolonel Silvertopstraat
651,Kolonel Silvertopstraat 5333,2023-02-04,14:00:00,137,96,41,FMN 03 Kolonel Silvertopstraat
651,Kolonel Silvertopstraat 5333,2023-02-04,15:00:00,147,103,44,FMN 03 Kolonel Silvertopstraat
651,Kolonel Silvertopstraat 5333,2023-02-04,16:00:00,153,106,47,FMN 03 Kolonel Silvertopstraat
651,Kolonel Silvertopstraat 5333,2023-02-04,17:00:00,161,109,52,FMN 03 Kolonel Silvertopstraat
651,Kolonel Silvertopstraat 5333,2023-02-04,18:00:00,172,115,57,FMN 03 Kolonel Silvertopstraat
651,Kolonel Silvertopstraat 5333,2023-02-04,19:00:00,123,89,34,FMN 03 Kolonel Silvertopstraat
651,Kolonel Silvertopstraat 5333,2023-02-04,20:00:00,103,71,32,FMN 03 Kolonel Silvertopstraat
651,Kolonel Silvertopstraat 5333,2023-02-04,21:00:00,101,58,43,FMN 03 Kolonel Silvertopstraat
651,Kolonel Silvertopstraat 5333,2023-02-04,22:00:00,83,52,31,FMN 03 Kolonel Silvertopstraat
651,Kolonel Silvertopstraat 5333,2023-02-04,23:00:00,76,37,39,FMN 03 Kolonel Silvertopstraat
651,Kolonel Silvertopstraat 5333,2023-02-05,00:00:00,48,23,25,FMN 03 Kolonel Silvertopstraat
651,Kolonel Silvertopstraat 5333,2023-02-05,01:00:00,48,23,25,FMN 03 Kolonel Silvertopstraat
651,Kolonel Silvertopstraat 5333,2023-02-05,02:00:00,15,5,10,FMN 03 Kolonel Silvertopstraat
651,Kolonel Silvertopstraat 5333,2023-02-05,03:00:00,18,5,13,FMN 03 Kolonel Silvertopstraat
651,Kolonel Silvertopstraat 5333,2023-02-05,04:00:00,21,12,9,FMN 03 Kolonel Silvertopstraat
651,Kolonel Silvertopstraat 5333,2023-02-05,05:00:00,14,8,6,FMN 03 Kolonel Silvertopstraat
651,Kolonel Silvertopstraat 5333,2023-02-05,06:00:00,18,13,5,FMN 03 Kolonel Silvertopstraat
651,Kolonel Silvertopstraat 5333,2023-02-05,07:00:00,28,22,6,FMN 03 Kolonel Silvertopstraat
651,Kolonel Silvertopstraat 5333,2023-02-05,08:00:00,38,28,10,FMN 03 Kolonel Silvertopstraat
651,Kolonel Silvertopstraat 5333,2023-02-05,09:00:00,79,68,11,FMN 03 Kolonel Silvertopstraat
651,Kolonel Silvertopstraat 5333,2023-02-05,10:00:00,98,79,19,FMN 03 Kolonel Silvertopstraat
651,Kolonel Silvertopstraat 5333,2023-02-05,11:00:00,122,90,32,FMN 03 Kolonel Silvertopstraat
651,Kolonel Silvertopstraat 5333,2023-02-05,12:00:00,115,78,37,FMN 03 Kolonel Silvertopstraat
651,Kolonel Silvertopstraat 5333,2023-02-05,13:00:00,151,107,44,FMN 03 Kolonel Silvertopstraat
651,Kolonel Silvertopstraat 5333,2023-02-05,14:00:00,168,104,64,FMN 03 Kolonel Silvertopstraat
651,Kolonel Silvertopstraat 5333,2023-02-05,15:00:00,125,94,31,FMN 03 Kolonel Silvertopstraat
651,Kolonel Silvertopstraat 5333,2023-02-05,16:00:00,124,81,43,FMN 03 Kolonel Silvertopstraat
651,Kolonel Silvertopstraat 5333,2023-02-05,17:00:00,146,108,38,FMN 03 Kolonel Silvertopstraat
651,Kolonel Silvertopstraat 5333,2023-02-05,18:00:00,136,86,50,FMN 03 Kolonel Silvertopstraat
651,Kolonel Silvertopstraat 5333,2023-02-05,19:00:00,120,74,46,FMN 03 Kolonel Silvertopstraat
651,Kolonel Silvertopstraat 5333,2023-02-05,20:00:00,101,56,45,FMN 03 Kolonel Silvertopstraat
651,Kolonel Silvertopstraat 5333,2023-02-05,21:00:00,81,42,39,FMN 03 Kolonel Silvertopstraat
651,Kolonel Silvertopstraat 5333,2023-02-05,22:00:00,55,29,26,FMN 03 Kolonel Silvertopstraat
651,Kolonel Silvertopstraat 5333,2023-02-05,23:00:00,38,21,17,FMN 03 Kolonel Silvertopstraat
651,Kolonel Silvertopstraat 5333,2023-02-06,00:00:00,15,9,6,FMN 03 Kolonel Silvertopstraat
651,Kolonel Silvertopstraat 5333,2023-02-06,01:00:00,9,3,6,FMN 03 Kolonel Silvertopstraat
651,Kolonel Silvertopstraat 5333,2023-02-06,02:00:00,7,2,5,FMN 03 Kolonel Silvertopstraat
651,Kolonel Silvertopstraat 5333,2023-02-06,03:00:00,12,4,8,FMN 03 Kolonel Silvertopstraat
651,Kolonel Silvertopstraat 5333,2023-02-06,04:00:00,26,19,7,FMN 03 Kolonel Silvertopstraat
651,Kolonel Silvertopstraat 5333,2023-02-06,05:00:00,47,30,17,FMN 03 Kolonel Silvertopstraat
651,Kolonel Silvertopstraat 5333,2023-02-06,06:00:00,112,91,21,FMN 03 Kolonel Silvertopstraat
651,Kolonel Silvertopstraat 5333,2023-02-06,07:00:00,307,256,51,FMN 03 Kolonel Silvertopstraat
651,Kolonel Silvertopstraat 5333,2023-02-06,08:00:00,580,508,72,FMN 03 Kolonel Silvertopstraat
651,Kolonel Silvertopstraat 5333,2023-02-06,09:00:00,202,148,54,FMN 03 Kolonel Silvertopstraat
651,Kolonel Silvertopstraat 5333,2023-02-06,10:00:00,137,96,41,FMN 03 Kolonel Silvertopstraat
651,Kolonel Silvertopstraat 5333,2023-02-06,11:00:00,99,74,25,FMN 03 Kolonel Silvertopstraat
651,Kolonel Silvertopstraat 5333,2023-02-06,12:00:00,149,110,39,FMN 03 Kolonel Silvertopstraat
651,Kolonel Silvertopstraat 5333,2023-02-06,13:00:00,182,126,56,FMN 03 Kolonel Silvertopstraat
651,Kolonel Silvertopstraat 5333,2023-02-06,14:00:00,186,123,63,FMN 03 Kolonel Silvertopstraat
651,Kolonel Silvertopstraat 5333,2023-02-06,15:00:00,256,157,99,FMN 03 Kolonel Silvertopstraat
651,Kolonel Silvertopstraat 5333,2023-02-06,16:00:00,360,230,130,FMN 03 Kolonel Silvertopstraat
651,Kolonel Silvertopstraat 5333,2023-02-06,17:00:00,357,220,137,FMN 03 Kolonel Silvertopstraat
651,Kolonel Silvertopstraat 5333,2023-02-06,18:00:00,248,143,105,FMN 03 Kolonel Silvertopstraat
651,Kolonel Silvertopstraat 5333,2023-02-06,19:00:00,136,91,45,FMN 03 Kolonel Silvertopstraat
651,Kolonel Silvertopstraat 5333,2023-02-06,20:00:00,102,60,42,FMN 03 Kolonel Silvertopstraat
651,Kolonel Silvertopstraat 5333,2023-02-06,21:00:00,88,45,43,FMN 03 Kolonel Silvertopstraat
651,Kolonel Silvertopstraat 5333,2023-02-06,22:00:00,78,39,39,FMN 03 Kolonel Silvertopstraat
651,Kolonel Silvertopstraat 5333,2023-02-06,23:00:00,33,14,19,FMN 03 Kolonel Silvertopstraat
651,Kolonel Silvertopstraat 5333,2023-02-07,00:00:00,22,10,12,FMN 03 Kolonel Silvertopstraat
651,Kolonel Silvertopstraat 5333,2023-02-07,01:00:00,11,7,4,FMN 03 Kolonel Silvertopstraat
651,Kolonel Silvertopstraat 5333,2023-02-07,02:00:00,7,3,4,FMN 03 Kolonel Silvertopstraat
651,Kolonel Silvertopstraat 5333,2023-02-07,03:00:00,9,5,4,FMN 03 Kolonel Silvertopstraat
651,Kolonel Silvertopstraat 5333,2023-02-07,04:00:00,21,18,3,FMN 03 Kolonel Silvertopstraat
651,Kolonel Silvertopstraat 5333,2023-02-07,05:00:00,53,32,21,FMN 03 Kolonel Silvertopstraat
651,Kolonel Silvertopstraat 5333,2023-02-07,06:00:00,116,97,19,FMN 03 Kolonel Silvertopstraat
651,Kolonel Silvertopstraat 5333,2023-02-07,07:00:00,323,275,48,FMN 03 Kolonel Silvertopstraat
651,Kolonel Silvertopstraat 5333,2023-02-07,08:00:00,601,524,77,FMN 03 Kolonel Silvertopstraat
651,Kolonel Silvertopstraat 5333,2023-02-07,09:00:00,198,151,47,FMN 03 Kolonel Silvertopstraat
651,Kolonel Silvertopstraat 5333,2023-02-07,10:00:00,132,105,27,FMN 03 Kolonel Silvertopstraat
651,Kolonel Silvertopstraat 5333,2023-02-07,11:00:00,134,98,36,FMN 03 Kolonel Silvertopstraat
651,Kolonel Silvertopstraat 5333,2023-02-07,12:00:00,193,138,55,FMN 03 Kolonel Silvertopstraat
651,Kolonel Silvertopstraat 5333,2023-02-07,13:00:00,179,122,57,FMN 03 Kolonel Silvertopstraat
651,Kolonel Silvertopstraat 5333,2023-02-07,14:00:00,173,109,64,FMN 03 Kolonel Silvertopstraat
651,Kolonel Silvertopstraat 5333,2023-02-07,15:00:00,256,160,96,FMN 03 Kolonel Silvertopstraat
651,Kolonel Silvertopstraat 5333,2023-02-07,16:00:00,334,206,128,FMN 03 Kolonel Silvertopstraat
651,Kolonel Silvertopstraat 5333,2023-02-07,17:00:00,366,209,157,FMN 03 Kolonel Silvertopstraat
651,Kolonel Silvertopstraat 5333,2023-02-07,18:00:00,279,176,103,FMN 03 Kolonel Silvertopstraat
651,Kolonel Silvertopstraat 5333,2023-02-07,19:00:00,144,88,56,FMN 03 Kolonel Silvertopstraat
651,Kolonel Silvertopstraat 5333,2023-02-07,20:00:00,132,74,58,FMN 03 Kolonel Silvertopstraat
651,Kolonel Silvertopstraat 5333,2023-02-07,21:00:00,108,62,46,FMN 03 Kolonel Silvertopstraat
651,Kolonel Silvertopstraat 5333,2023-02-07,22:00:00,95,58,37,FMN 03 Kolonel Silvertopstraat
651,Kolonel Silvertopstraat 5333,2023-02-07,23:00:00,37,18,19,FMN 03 Kolonel Silvertopstraat
651,Kolonel Silvertopstraat 5333,2023-02-08,00:00:00,26,10,16,FMN 03 Kolonel Silvertopstraat
651,Kolonel Silvertopstraat 5333,2023-02-08,01:00:00,13,3,10,FMN 03 Kolonel Silvertopstraat
651,Kolonel Silvertopstraat 5333,2023-02-08,02:00:00,6,3,3,FMN 03 Kolonel Silvertopstraat
651,Kolonel Silvertopstraat 5333,2023-02-08,03:00:00,9,7,2,FMN 03 Kolonel Silvertopstraat
651,Kolonel Silvertopstraat 5333,2023-02-08,04:00:00,19,14,5,FMN 03 Kolonel Silvertopstraat
651,Kolonel Silvertopstraat 5333,2023-02-08,05:00:00,47,27,20,FMN 03 Kolonel Silvertopstraat
651,Kolonel Silvertopstraat 5333,2023-02-08,06:00:00,107,83,24,FMN 03 Kolonel Silvertopstraat
651,Kolonel Silvertopstraat 5333,2023-02-08,07:00:00,235,190,45,FMN 03 Kolonel Silvertopstraat
651,Kolonel Silvertopstraat 5333,2023-02-08,08:00:00,414,331,83,FMN 03 Kolonel Silvertopstraat
651,Kolonel Silvertopstraat 5333,2023-02-08,09:00:00,170,129,41,FMN 03 Kolonel Silvertopstraat
651,Kolonel Silvertopstraat 5333,2023-02-08,10:00:00,125,96,29,FMN 03 Kolonel Silvertopstraat
651,Kolonel Silvertopstraat 5333,2023-02-08,11:00:00,133,95,38,FMN 03 Kolonel Silvertopstraat
651,Kolonel Silvertopstraat 5333,2023-02-08,12:00:00,267,176,91,FMN 03 Kolonel Silvertopstraat
651,Kolonel Silvertopstraat 5333,2023-02-08,13:00:00,191,123,68,FMN 03 Kolonel Silvertopstraat
651,Kolonel Silvertopstraat 5333,2023-02-08,14:00:00,193,132,61,FMN 03 Kolonel Silvertopstraat
651,Kolonel Silvertopstraat 5333,2023-02-08,15:00:00,200,124,76,FMN 03 Kolonel Silvertopstraat
651,Kolonel Silvertopstraat 5333,2023-02-08,16:00:00,306,213,93,FMN 03 Kolonel Silvertopstraat
651,Kolonel Silvertopstraat 5333,2023-02-08,17:00:00,326,218,108,FMN 03 Kolonel Silvertopstraat
651,Kolonel Silvertopstraat 5333,2023-02-08,18:00:00,247,159,88,FMN 03 Kolonel Silvertopstraat
651,Kolonel Silvertopstraat 5333,2023-02-08,19:00:00,148,87,61,FMN 03 Kolonel Silvertopstraat
651,Kolonel Silvertopstraat 5333,2023-02-08,20:00:00,114,62,52,FMN 03 Kolonel Silvertopstraat
651,Kolonel Silvertopstraat 5333,2023-02-08,21:00:00,92,51,41,FMN 03 Kolonel Silvertopstraat
651,Kolonel Silvertopstraat 5333,2023-02-08,22:00:00,76,41,35,FMN 03 Kolonel Silvertopstraat
651,Kolonel Silvertopstraat 5333,2023-02-08,23:00:00,51,23,28,FMN 03 Kolonel Silvertopstraat
651,Kolonel Silvertopstraat 5333,2023-02-09,00:00:00,17,5,12,FMN 03 Kolonel Silvertopstraat
651,Kolonel Silvertopstraat 5333,2023-02-09,01:00:00,14,5,9,FMN 03 Kolonel Silvertopstraat
651,Kolonel Silvertopstraat 5333,2023-02-09,02:00:00,5,1,4,FMN 03 Kolonel Silvertopstraat
651,Kolonel Silvertopstraat 5333,2023-02-09,03:00:00,7,3,4,FMN 03 Kolonel Silvertopstraat
651,Kolonel Silvertopstraat 5333,2023-02-09,04:00:00,20,17,3,FMN 03 Kolonel Silvertopstraat
651,Kolonel Silvertopstraat 5333,2023-02-09,05:00:00,42,27,15,FMN 03 Kolonel Silvertopstraat
651,Kolonel Silvertopstraat 5333,2023-02-09,06:00:00,97,73,24,FMN 03 Kolonel Silvertopstraat
651,Kolonel Silvertopstraat 5333,2023-02-09,07:00:00,281,234,47,FMN 03 Kolonel Silvertopstraat
651,Kolonel Silvertopstraat 5333,2023-02-09,08:00:00,539,443,96,FMN 03 Kolonel Silvertopstraat
651,Kolonel Silvertopstraat 5333,2023-02-09,09:00:00,188,145,43,FMN 03 Kolonel Silvertopstraat
651,Kolonel Silvertopstraat 5333,2023-02-09,10:00:00,147,106,41,FMN 03 Kolonel Silvertopstraat
651,Kolonel Silvertopstraat 5333,2023-02-09,11:00:00,119,88,31,FMN 03 Kolonel Silvertopstraat
651,Kolonel Silvertopstraat 5333,2023-02-09,12:00:00,161,112,49,FMN 03 Kolonel Silvertopstraat
651,Kolonel Silvertopstraat 5333,2023-02-09,13:00:00,189,137,52,FMN 03 Kolonel Silvertopstraat
651,Kolonel Silvertopstraat 5333,2023-02-09,14:00:00,155,93,62,FMN 03 Kolonel Silvertopstraat
651,Kolonel Silvertopstraat 5333,2023-02-09,15:00:00,242,163,79,FMN 03 Kolonel Silvertopstraat
651,Kolonel Silvertopstraat 5333,2023-02-09,16:00:00,400,244,156,FMN 03 Kolonel Silvertopstraat
651,Kolonel Silvertopstraat 5333,2023-02-09,17:00:00,369,242,127,FMN 03 Kolonel Silvertopstraat
651,Kolonel Silvertopstraat 5333,2023-02-09,18:00:00,261,176,85,FMN 03 Kolonel Silvertopstraat
651,Kolonel Silvertopstraat 5333,2023-02-09,19:00:00,159,100,59,FMN 03 Kolonel Silvertopstraat
651,Kolonel Silvertopstraat 5333,2023-02-09,20:00:00,123,80,43,FMN 03 Kolonel Silvertopstraat
651,Kolonel Silvertopstraat 5333,2023-02-09,21:00:00,98,61,37,FMN 03 Kolonel Silvertopstraat
651,Kolonel Silvertopstraat 5333,2023-02-09,22:00:00,76,29,47,FMN 03 Kolonel Silvertopstraat
651,Kolonel Silvertopstraat 5333,2023-02-09,23:00:00,49,21,28,FMN 03 Kolonel Silvertopstraat
651,Kolonel Silvertopstraat 5333,2023-02-10,00:00:00,34,16,18,FMN 03 Kolonel Silvertopstraat
651,Kolonel Silvertopstraat 5333,2023-02-10,01:00:00,13,5,8,FMN 03 Kolonel Silvertopstraat
651,Kolonel Silvertopstraat 5333,2023-02-10,02:00:00,9,4,5,FMN 03 Kolonel Silvertopstraat
651,Kolonel Silvertopstraat 5333,2023-02-10,03:00:00,9,6,3,FMN 03 Kolonel Silvertopstraat
651,Kolonel Silvertopstraat 5333,2023-02-10,04:00:00,18,14,4,FMN 03 Kolonel Silvertopstraat
651,Kolonel Silvertopstraat 5333,2023-02-10,05:00:00,59,38,21,FMN 03 Kolonel Silvertopstraat
651,Kolonel Silvertopstraat 5333,2023-02-10,06:00:00,100,77,23,FMN 03 Kolonel Silvertopstraat
651,Kolonel Silvertopstraat 5333,2023-02-10,07:00:00,255,206,49,FMN 03 Kolonel Silvertopstraat
651,Kolonel Silvertopstraat 5333,2023-02-10,08:00:00,522,454,68,FMN 03 Kolonel Silvertopstraat
651,Kolonel Silvertopstraat 5333,2023-02-10,09:00:00,202,148,54,FMN 03 Kolonel Silvertopstraat
651,Kolonel Silvertopstraat 5333,2023-02-10,10:00:00,138,108,30,FMN 03 Kolonel Silvertopstraat
651,Kolonel Silvertopstraat 5333,2023-02-10,11:00:00,131,96,35,FMN 03 Kolonel Silvertopstraat
651,Kolonel Silvertopstraat 5333,2023-02-10,12:00:00,180,122,58,FMN 03 Kolonel Silvertopstraat
651,Kolonel Silvertopstraat 5333,2023-02-10,13:00:00,178,129,49,FMN 03 Kolonel Silvertopstraat
651,Kolonel Silvertopstraat 5333,2023-02-10,14:00:00,192,140,52,FMN 03 Kolonel Silvertopstraat
651,Kolonel Silvertopstraat 5333,2023-02-10,15:00:00,273,178,95,FMN 03 Kolonel Silvertopstraat
651,Kolonel Silvertopstraat 5333,2023-02-10,16:00:00,317,194,123,FMN 03 Kolonel Silvertopstraat
651,Kolonel Silvertopstraat 5333,2023-02-10,17:00:00,303,192,111,FMN 03 Kolonel Silvertopstraat
651,Kolonel Silvertopstraat 5333,2023-02-10,18:00:00,232,152,80,FMN 03 Kolonel Silvertopstraat
651,Kolonel Silvertopstraat 5333,2023-02-10,19:00:00,195,135,60,FMN 03 Kolonel Silvertopstraat
651,Kolonel Silvertopstraat 5333,2023-02-10,20:00:00,135,82,53,FMN 03 Kolonel Silvertopstraat
651,Kolonel Silvertopstraat 5333,2023-02-10,21:00:00,90,56,34,FMN 03 Kolonel Silvertopstraat
651,Kolonel Silvertopstraat 5333,2023-02-10,22:00:00,83,44,39,FMN 03 Kolonel Silvertopstraat
651,Kolonel Silvertopstraat 5333,2023-02-10,23:00:00,93,48,45,FMN 03 Kolonel Silvertopstraat
651,Kolonel Silvertopstraat 5333,2023-02-11,00:00:00,30,14,16,FMN 03 Kolonel Silvertopstraat
651,Kolonel Silvertopstraat 5333,2023-02-11,01:00:00,43,12,31,FMN 03 Kolonel Silvertopstraat
651,Kolonel Silvertopstraat 5333,2023-02-11,02:00:00,37,10,27,FMN 03 Kolonel Silvertopstraat
651,Kolonel Silvertopstraat 5333,2023-02-11,03:00:00,22,5,17,FMN 03 Kolonel Silvertopstraat
651,Kolonel Silvertopstraat 5333,2023-02-11,04:00:00,10,4,6,FMN 03 Kolonel Silvertopstraat
651,Kolonel Silvertopstraat 5333,2023-02-11,05:00:00,19,11,8,FMN 03 Kolonel Silvertopstraat
651,Kolonel Silvertopstraat 5333,2023-02-11,06:00:00,33,27,6,FMN 03 Kolonel Silvertopstraat
651,Kolonel Silvertopstraat 5333,2023-02-11,07:00:00,39,30,9,FMN 03 Kolonel Silvertopstraat
651,Kolonel Silvertopstraat 5333,2023-02-11,08:00:00,69,54,15,FMN 03 Kolonel Silvertopstraat
651,Kolonel Silvertopstraat 5333,2023-02-11,09:00:00,132,114,18,FMN 03 Kolonel Silvertopstraat
651,Kolonel Silvertopstraat 5333,2023-02-11,10:00:00,129,110,19,FMN 03 Kolonel Silvertopstraat
651,Kolonel Silvertopstraat 5333,2023-02-11,11:00:00,124,74,50,FMN 03 Kolonel Silvertopstraat
651,Kolonel Silvertopstraat 5333,2023-02-11,12:00:00,149,109,40,FMN 03 Kolonel Silvertopstraat
651,Kolonel Silvertopstraat 5333,2023-02-11,13:00:00,176,134,42,FMN 03 Kolonel Silvertopstraat
651,Kolonel Silvertopstraat 5333,2023-02-11,14:00:00,159,108,51,FMN 03 Kolonel Silvertopstraat
651,Kolonel Silvertopstraat 5333,2023-02-11,15:00:00,169,119,50,FMN 03 Kolonel Silvertopstraat
651,Kolonel Silvertopstraat 5333,2023-02-11,16:00:00,175,112,63,FMN 03 Kolonel Silvertopstraat
651,Kolonel Silvertopstraat 5333,2023-02-11,17:00:00,186,127,59,FMN 03 Kolonel Silvertopstraat
651,Kolonel Silvertopstraat 5333,2023-02-11,18:00:00,183,118,65,FMN 03 Kolonel Silvertopstraat
651,Kolonel Silvertopstraat 5333,2023-02-11,19:00:00,146,98,48,FMN 03 Kolonel Silvertopstraat
651,Kolonel Silvertopstraat 5333,2023-02-11,20:00:00,96,57,39,FMN 03 Kolonel Silvertopstraat
651,Kolonel Silvertopstraat 5333,2023-02-11,21:00:00,84,49,35,FMN 03 Kolonel Silvertopstraat
651,Kolonel Silvertopstraat 5333,2023-02-11,22:00:00,78,43,35,FMN 03 Kolonel Silvertopstraat
651,Kolonel Silvertopstraat 5333,2023-02-11,23:00:00,86,44,42,FMN 03 Kolonel Silvertopstraat
651,Kolonel Silvertopstraat 5333,2023-02-12,00:00:00,67,35,32,FMN 03 Kolonel Silvertopstraat
651,Kolonel Silvertopstraat 5333,2023-02-12,01:00:00,38,17,21,FMN 03 Kolonel Silvertopstraat
651,Kolonel Silvertopstraat 5333,2023-02-12,02:00:00,15,8,7,FMN 03 Kolonel Silvertopstraat
651,Kolonel Silvertopstraat 5333,2023-02-12,03:00:00,27,9,18,FMN 03 Kolonel Silvertopstraat
651,Kolonel Silvertopstraat 5333,2023-02-12,04:00:00,22,7,15,FMN 03 Kolonel Silvertopstraat
651,Kolonel Silvertopstraat 5333,2023-02-12,05:00:00,15,7,8,FMN 03 Kolonel Silvertopstraat
651,Kolonel Silvertopstraat 5333,2023-02-12,06:00:00,25,17,8,FMN 03 Kolonel Silvertopstraat
651,Kolonel Silvertopstraat 5333,2023-02-12,07:00:00,16,15,1,FMN 03 Kolonel Silvertopstraat
651,Kolonel Silvertopstraat 5333,2023-02-12,08:00:00,49,39,10,FMN 03 Kolonel Silvertopstraat
651,Kolonel Silvertopstraat 5333,2023-02-12,09:00:00,91,71,20,FMN 03 Kolonel Silvertopstraat
651,Kolonel Silvertopstraat 5333,2023-02-12,10:00:00,122,93,29,FMN 03 Kolonel Silvertopstraat
651,Kolonel Silvertopstraat 5333,2023-02-12,11:00:00,114,85,29,FMN 03 Kolonel Silvertopstraat
651,Kolonel Silvertopstraat 5333,2023-02-12,12:00:00,124,92,32,FMN 03 Kolonel Silvertopstraat
651,Kolonel Silvertopstraat 5333,2023-02-12,13:00:00,139,99,40,FMN 03 Kolonel Silvertopstraat
651,Kolonel Silvertopstraat 5333,2023-02-12,14:00:00,131,92,39,FMN 03 Kolonel Silvertopstraat
651,Kolonel Silvertopstraat 5333,2023-02-12,15:00:00,115,70,45,FMN 03 Kolonel Silvertopstraat
651,Kolonel Silvertopstraat 5333,2023-02-12,16:00:00,115,76,39,FMN 03 Kolonel Silvertopstraat
651,Kolonel Silvertopstraat 5333,2023-02-12,17:00:00,151,88,63,FMN 03 Kolonel Silvertopstraat
651,Kolonel Silvertopstraat 5333,2023-02-12,18:00:00,173,95,78,FMN 03 Kolonel Silvertopstraat
651,Kolonel Silvertopstraat 5333,2023-02-12,19:00:00,108,61,47,FMN 03 Kolonel Silvertopstraat
651,Kolonel Silvertopstraat 5333,2023-02-12,20:00:00,99,57,42,FMN 03 Kolonel Silvertopstraat
651,Kolonel Silvertopstraat 5333,2023-02-12,21:00:00,133,99,34,FMN 03 Kolonel Silvertopstraat
651,Kolonel Silvertopstraat 5333,2023-02-12,22:00:00,65,40,25,FMN 03 Kolonel Silvertopstraat
651,Kolonel Silvertopstraat 5333,2023-02-12,23:00:00,45,18,27,FMN 03 Kolonel Silvertopstraat
651,Kolonel Silvertopstraat 5333,2023-02-13,00:00:00,16,7,9,FMN 03 Kolonel Silvertopstraat
651,Kolonel Silvertopstraat 5333,2023-02-13,01:00:00,13,4,9,FMN 03 Kolonel Silvertopstraat
651,Kolonel Silvertopstraat 5333,2023-02-13,02:00:00,5,3,2,FMN 03 Kolonel Silvertopstraat
651,Kolonel Silvertopstraat 5333,2023-02-13,03:00:00,4,3,1,FMN 03 Kolonel Silvertopstraat
651,Kolonel Silvertopstraat 5333,2023-02-13,04:00:00,21,13,8,FMN 03 Kolonel Silvertopstraat
651,Kolonel Silvertopstraat 5333,2023-02-13,05:00:00,45,33,12,FMN 03 Kolonel Silvertopstraat
651,Kolonel Silvertopstraat 5333,2023-02-13,06:00:00,117,91,26,FMN 03 Kolonel Silvertopstraat
651,Kolonel Silvertopstraat 5333,2023-02-13,07:00:00,331,266,65,FMN 03 Kolonel Silvertopstraat
651,Kolonel Silvertopstraat 5333,2023-02-13,08:00:00,617,530,87,FMN 03 Kolonel Silvertopstraat
651,Kolonel Silvertopstraat 5333,2023-02-13,09:00:00,197,160,37,FMN 03 Kolonel Silvertopstraat
651,Kolonel Silvertopstraat 5333,2023-02-13,10:00:00,177,128,49,FMN 03 Kolonel Silvertopstraat
651,Kolonel Silvertopstraat 5333,2023-02-13,11:00:00,126,90,36,FMN 03 Kolonel Silvertopstraat
651,Kolonel Silvertopstraat 5333,2023-02-13,12:00:00,183,132,51,FMN 03 Kolonel Silvertopstraat
651,Kolonel Silvertopstraat 5333,2023-02-13,13:00:00,196,129,67,FMN 03 Kolonel Silvertopstraat
651,Kolonel Silvertopstraat 5333,2023-02-13,14:00:00,184,137,47,FMN 03 Kolonel Silvertopstraat
651,Kolonel Silvertopstraat 5333,2023-02-13,15:00:00,290,172,118,FMN 03 Kolonel Silvertopstraat
651,Kolonel Silvertopstraat 5333,2023-02-13,16:00:00,374,231,143,FMN 03 Kolonel Silvertopstraat
651,Kolonel Silvertopstraat 5333,2023-02-13,17:00:00,412,266,146,FMN 03 Kolonel Silvertopstraat
651,Kolonel Silvertopstraat 5333,2023-02-13,18:00:00,256,158,98,FMN 03 Kolonel Silvertopstraat
651,Kolonel Silvertopstraat 5333,2023-02-13,19:00:00,185,107,78,FMN 03 Kolonel Silvertopstraat
651,Kolonel Silvertopstraat 5333,2023-02-13,20:00:00,136,78,58,FMN 03 Kolonel Silvertopstraat
651,Kolonel Silvertopstraat 5333,2023-02-13,21:00:00,103,50,53,FMN 03 Kolonel Silvertopstraat
651,Kolonel Silvertopstraat 5333,2023-02-13,22:00:00,84,50,34,FMN 03 Kolonel Silvertopstraat
651,Kolonel Silvertopstraat 5333,2023-02-13,23:00:00,44,20,24,FMN 03 Kolonel Silvertopstraat
651,Kolonel Silvertopstraat 5333,2023-02-14,00:00:00,19,6,13,FMN 03 Kolonel Silvertopstraat
651,Kolonel Silvertopstraat 5333,2023-02-14,01:00:00,9,3,6,FMN 03 Kolonel Silvertopstraat
651,Kolonel Silvertopstraat 5333,2023-02-14,02:00:00,7,4,3,FMN 03 Kolonel Silvertopstraat
651,Kolonel Silvertopstraat 5333,2023-02-14,03:00:00,8,4,4,FMN 03 Kolonel Silvertopstraat
651,Kolonel Silvertopstraat 5333,2023-02-14,04:00:00,22,19,3,FMN 03 Kolonel Silvertopstraat
651,Kolonel Silvertopstraat 5333,2023-02-14,05:00:00,51,33,18,FMN 03 Kolonel Silvertopstraat
651,Kolonel Silvertopstraat 5333,2023-02-14,06:00:00,136,107,29,FMN 03 Kolonel Silvertopstraat
651,Kolonel Silvertopstraat 5333,2023-02-14,07:00:00,362,301,61,FMN 03 Kolonel Silvertopstraat
651,Kolonel Silvertopstraat 5333,2023-02-14,08:00:00,624,536,88,FMN 03 Kolonel Silvertopstraat
651,Kolonel Silvertopstraat 5333,2023-02-14,09:00:00,272,219,53,FMN 03 Kolonel Silvertopstraat
651,Kolonel Silvertopstraat 5333,2023-02-14,10:00:00,203,156,47,FMN 03 Kolonel Silvertopstraat
651,Kolonel Silvertopstraat 5333,2023-02-14,11:00:00,164,127,37,FMN 03 Kolonel Silvertopstraat
651,Kolonel Silvertopstraat 5333,2023-02-14,12:00:00,260,191,69,FMN 03 Kolonel Silvertopstraat
651,Kolonel Silvertopstraat 5333,2023-02-14,13:00:00,253,180,73,FMN 03 Kolonel Silvertopstraat
651,Kolonel Silvertopstraat 5333,2023-02-14,14:00:00,231,161,70,FMN 03 Kolonel Silvertopstraat
651,Kolonel Silvertopstraat 5333,2023-02-14,15:00:00,327,203,124,FMN 03 Kolonel Silvertopstraat
651,Kolonel Silvertopstraat 5333,2023-02-14,16:00:00,410,264,146,FMN 03 Kolonel Silvertopstraat
651,Kolonel Silvertopstraat 5333,2023-02-14,17:00:00,444,296,148,FMN 03 Kolonel Silvertopstraat
651,Kolonel Silvertopstraat 5333,2023-02-14,18:00:00,338,198,140,FMN 03 Kolonel Silvertopstraat
651,Kolonel Silvertopstraat 5333,2023-02-14,19:00:00,194,121,73,FMN 03 Kolonel Silvertopstraat
651,Kolonel Silvertopstraat 5333,2023-02-14,20:00:00,174,97,77,FMN 03 Kolonel Silvertopstraat
651,Kolonel Silvertopstraat 5333,2023-02-14,21:00:00,119,61,58,FMN 03 Kolonel Silvertopstraat
651,Kolonel Silvertopstraat 5333,2023-02-14,22:00:00,92,58,34,FMN 03 Kolonel Silvertopstraat
651,Kolonel Silvertopstraat 5333,2023-02-14,23:00:00,59,18,41,FMN 03 Kolonel Silvertopstraat
651,Kolonel Silvertopstraat 5333,2023-02-15,00:00:00,35,16,19,FMN 03 Kolonel Silvertopstraat
651,Kolonel Silvertopstraat 5333,2023-02-15,01:00:00,14,8,6,FMN 03 Kolonel Silvertopstraat
651,Kolonel Silvertopstraat 5333,2023-02-15,02:00:00,8,3,5,FMN 03 Kolonel Silvertopstraat
651,Kolonel Silvertopstraat 5333,2023-02-15,03:00:00,12,6,6,FMN 03 Kolonel Silvertopstraat
651,Kolonel Silvertopstraat 5333,2023-02-15,04:00:00,14,12,2,FMN 03 Kolonel Silvertopstraat
651,Kolonel Silvertopstraat 5333,2023-02-15,05:00:00,44,29,15,FMN 03 Kolonel Silvertopstraat
651,Kolonel Silvertopstraat 5333,2023-02-15,06:00:00,110,92,18,FMN 03 Kolonel Silvertopstraat
651,Kolonel Silvertopstraat 5333,2023-02-15,07:00:00,269,220,49,FMN 03 Kolonel Silvertopstraat
651,Kolonel Silvertopstraat 5333,2023-02-15,08:00:00,570,486,84,FMN 03 Kolonel Silvertopstraat
651,Kolonel Silvertopstraat 5333,2023-02-15,09:00:00,206,159,47,FMN 03 Kolonel Silvertopstraat
651,Kolonel Silvertopstraat 5333,2023-02-15,10:00:00,165,118,47,FMN 03 Kolonel Silvertopstraat
651,Kolonel Silvertopstraat 5333,2023-02-15,11:00:00,167,137,30,FMN 03 Kolonel Silvertopstraat
651,Kolonel Silvertopstraat 5333,2023-02-15,12:00:00,311,181,130,FMN 03 Kolonel Silvertopstraat
651,Kolonel Silvertopstraat 5333,2023-02-15,13:00:00,233,149,84,FMN 03 Kolonel Silvertopstraat
651,Kolonel Silvertopstraat 5333,2023-02-15,14:00:00,188,129,59,FMN 03 Kolonel Silvertopstraat
651,Kolonel Silvertopstraat 5333,2023-02-15,15:00:00,223,161,62,FMN 03 Kolonel Silvertopstraat
651,Kolonel Silvertopstraat 5333,2023-02-15,16:00:00,300,215,85,FMN 03 Kolonel Silvertopstraat
651,Kolonel Silvertopstraat 5333,2023-02-15,17:00:00,364,240,124,FMN 03 Kolonel Silvertopstraat
651,Kolonel Silvertopstraat 5333,2023-02-15,18:00:00,317,213,104,FMN 03 Kolonel Silvertopstraat
651,Kolonel Silvertopstraat 5333,2023-02-15,19:00:00,205,132,73,FMN 03 Kolonel Silvertopstraat
651,Kolonel Silvertopstraat 5333,2023-02-15,20:00:00,122,70,52,FMN 03 Kolonel Silvertopstraat
651,Kolonel Silvertopstraat 5333,2023-02-15,21:00:00,94,50,44,FMN 03 Kolonel Silvertopstraat
651,Kolonel Silvertopstraat 5333,2023-02-15,22:00:00,112,65,47,FMN 03 Kolonel Silvertopstraat
651,Kolonel Silvertopstraat 5333,2023-02-15,23:00:00,70,31,39,FMN 03 Kolonel Silvertopstraat
651,Kolonel Silvertopstraat 5333,2023-02-16,00:00:00,30,12,18,FMN 03 Kolonel Silvertopstraat
651,Kolonel Silvertopstraat 5333,2023-02-16,01:00:00,10,3,7,FMN 03 Kolonel Silvertopstraat
651,Kolonel Silvertopstraat 5333,2023-02-16,02:00:00,8,3,5,FMN 03 Kolonel Silvertopstraat
651,Kolonel Silvertopstraat 5333,2023-02-16,03:00:00,4,3,1,FMN 03 Kolonel Silvertopstraat
651,Kolonel Silvertopstraat 5333,2023-02-16,04:00:00,21,15,6,FMN 03 Kolonel Silvertopstraat
651,Kolonel Silvertopstraat 5333,2023-02-16,05:00:00,45,31,14,FMN 03 Kolonel Silvertopstraat
651,Kolonel Silvertopstraat 5333,2023-02-16,06:00:00,115,103,12,FMN 03 Kolonel Silvertopstraat
651,Kolonel Silvertopstraat 5333,2023-02-16,07:00:00,321,273,48,FMN 03 Kolonel Silvertopstraat
651,Kolonel Silvertopstraat 5333,2023-02-16,08:00:00,635,538,97,FMN 03 Kolonel Silvertopstraat
651,Kolonel Silvertopstraat 5333,2023-02-16,09:00:00,195,162,33,FMN 03 Kolonel Silvertopstraat
651,Kolonel Silvertopstraat 5333,2023-02-16,10:00:00,144,113,31,FMN 03 Kolonel Silvertopstraat
651,Kolonel Silvertopstraat 5333,2023-02-16,11:00:00,103,75,28,FMN 03 Kolonel Silvertopstraat
651,Kolonel Silvertopstraat 5333,2023-02-16,12:00:00,193,121,72,FMN 03 Kolonel Silvertopstraat
651,Kolonel Silvertopstraat 5333,2023-02-16,13:00:00,181,116,65,FMN 03 Kolonel Silvertopstraat
651,Kolonel Silvertopstraat 5333,2023-02-16,14:00:00,181,123,58,FMN 03 Kolonel Silvertopstraat
651,Kolonel Silvertopstraat 5333,2023-02-16,15:00:00,268,154,114,FMN 03 Kolonel Silvertopstraat
651,Kolonel Silvertopstraat 5333,2023-02-16,16:00:00,367,243,124,FMN 03 Kolonel Silvertopstraat
651,Kolonel Silvertopstraat 5333,2023-02-16,17:00:00,370,238,132,FMN 03 Kolonel Silvertopstraat
651,Kolonel Silvertopstraat 5333,2023-02-16,18:00:00,277,170,107,FMN 03 Kolonel Silvertopstraat
651,Kolonel Silvertopstraat 5333,2023-02-16,19:00:00,186,123,63,FMN 03 Kolonel Silvertopstraat
651,Kolonel Silvertopstraat 5333,2023-02-16,20:00:00,119,64,55,FMN 03 Kolonel Silvertopstraat
651,Kolonel Silvertopstraat 5333,2023-02-16,21:00:00,95,49,46,FMN 03 Kolonel Silvertopstraat
651,Kolonel Silvertopstraat 5333,2023-02-16,22:00:00,105,59,46,FMN 03 Kolonel Silvertopstraat
651,Kolonel Silvertopstraat 5333,2023-02-16,23:00:00,45,16,29,FMN 03 Kolonel Silvertopstraat
651,Kolonel Silvertopstraat 5333,2023-02-17,00:00:00,27,15,12,FMN 03 Kolonel Silvertopstraat
651,Kolonel Silvertopstraat 5333,2023-02-17,01:00:00,18,5,13,FMN 03 Kolonel Silvertopstraat
651,Kolonel Silvertopstraat 5333,2023-02-17,02:00:00,15,4,11,FMN 03 Kolonel Silvertopstraat
651,Kolonel Silvertopstraat 5333,2023-02-17,03:00:00,8,5,3,FMN 03 Kolonel Silvertopstraat
651,Kolonel Silvertopstraat 5333,2023-02-17,04:00:00,24,15,9,FMN 03 Kolonel Silvertopstraat
651,Kolonel Silvertopstraat 5333,2023-02-17,05:00:00,45,33,12,FMN 03 Kolonel Silvertopstraat
651,Kolonel Silvertopstraat 5333,2023-02-17,06:00:00,107,88,19,FMN 03 Kolonel Silvertopstraat
651,Kolonel Silvertopstraat 5333,2023-02-17,07:00:00,292,245,47,FMN 03 Kolonel Silvertopstraat
651,Kolonel Silvertopstraat 5333,2023-02-17,08:00:00,572,481,91,FMN 03 Kolonel Silvertopstraat
651,Kolonel Silvertopstraat 5333,2023-02-17,09:00:00,188,152,36,FMN 03 Kolonel Silvertopstraat
651,Kolonel Silvertopstraat 5333,2023-02-17,10:00:00,171,128,43,FMN 03 Kolonel Silvertopstraat
651,Kolonel Silvertopstraat 5333,2023-02-17,11:00:00,160,110,50,FMN 03 Kolonel Silvertopstraat
651,Kolonel Silvertopstraat 5333,2023-02-17,12:00:00,219,152,67,FMN 03 Kolonel Silvertopstraat
651,Kolonel Silvertopstraat 5333,2023-02-17,13:00:00,214,147,67,FMN 03 Kolonel Silvertopstraat
651,Kolonel Silvertopstraat 5333,2023-02-17,14:00:00,222,146,76,FMN 03 Kolonel Silvertopstraat
651,Kolonel Silvertopstraat 5333,2023-02-17,15:00:00,311,176,135,FMN 03 Kolonel Silvertopstraat
651,Kolonel Silvertopstraat 5333,2023-02-17,16:00:00,341,230,111,FMN 03 Kolonel Silvertopstraat
651,Kolonel Silvertopstraat 5333,2023-02-17,17:00:00,299,209,90,FMN 03 Kolonel Silvertopstraat
651,Kolonel Silvertopstraat 5333,2023-02-17,18:00:00,237,156,81,FMN 03 Kolonel Silvertopstraat
651,Kolonel Silvertopstraat 5333,2023-02-17,19:00:00,202,144,58,FMN 03 Kolonel Silvertopstraat
651,Kolonel Silvertopstraat 5333,2023-02-17,20:00:00,145,95,50,FMN 03 Kolonel Silvertopstraat
651,Kolonel Silvertopstraat 5333,2023-02-17,21:00:00,132,86,46,FMN 03 Kolonel Silvertopstraat
651,Kolonel Silvertopstraat 5333,2023-02-17,22:00:00,97,53,44,FMN 03 Kolonel Silvertopstraat
651,Kolonel Silvertopstraat 5333,2023-02-17,23:00:00,82,40,42,FMN 03 Kolonel Silvertopstraat
651,Kolonel Silvertopstraat 5333,2023-02-18,00:00:00,62,26,36,FMN 03 Kolonel Silvertopstraat
651,Kolonel Silvertopstraat 5333,2023-02-18,01:00:00,43,16,27,FMN 03 Kolonel Silvertopstraat
651,Kolonel Silvertopstraat 5333,2023-02-18,02:00:00,29,10,19,FMN 03 Kolonel Silvertopstraat
651,Kolonel Silvertopstraat 5333,2023-02-18,03:00:00,25,9,16,FMN 03 Kolonel Silvertopstraat
651,Kolonel Silvertopstraat 5333,2023-02-18,04:00:00,15,12,3,FMN 03 Kolonel Silvertopstraat
651,Kolonel Silvertopstraat 5333,2023-02-18,05:00:00,18,10,8,FMN 03 Kolonel Silvertopstraat
651,Kolonel Silvertopstraat 5333,2023-02-18,06:00:00,30,24,6,FMN 03 Kolonel Silvertopstraat
651,Kolonel Silvertopstraat 5333,2023-02-18,07:00:00,31,24,7,FMN 03 Kolonel Silvertopstraat
651,Kolonel Silvertopstraat 5333,2023-02-18,08:00:00,43,34,9,FMN 03 Kolonel Silvertopstraat
651,Kolonel Silvertopstraat 5333,2023-02-18,09:00:00,133,104,29,FMN 03 Kolonel Silvertopstraat
651,Kolonel Silvertopstraat 5333,2023-02-18,10:00:00,113,91,22,FMN 03 Kolonel Silvertopstraat
651,Kolonel Silvertopstraat 5333,2023-02-18,11:00:00,114,91,23,FMN 03 Kolonel Silvertopstraat
651,Kolonel Silvertopstraat 5333,2023-02-18,12:00:00,122,92,30,FMN 03 Kolonel Silvertopstraat
651,Kolonel Silvertopstraat 5333,2023-02-18,13:00:00,123,90,33,FMN 03 Kolonel Silvertopstraat
651,Kolonel Silvertopstraat 5333,2023-02-18,14:00:00,156,114,42,FMN 03 Kolonel Silvertopstraat
651,Kolonel Silvertopstraat 5333,2023-02-18,15:00:00,136,87,49,FMN 03 Kolonel Silvertopstraat
651,Kolonel Silvertopstraat 5333,2023-02-18,16:00:00,146,102,44,FMN 03 Kolonel Silvertopstraat
651,Kolonel Silvertopstraat 5333,2023-02-18,17:00:00,177,129,48,FMN 03 Kolonel Silvertopstraat
651,Kolonel Silvertopstraat 5333,2023-02-18,18:00:00,162,105,57,FMN 03 Kolonel Silvertopstraat
651,Kolonel Silvertopstraat 5333,2023-02-18,19:00:00,147,108,39,FMN 03 Kolonel Silvertopstraat
651,Kolonel Silvertopstraat 5333,2023-02-18,20:00:00,93,59,34,FMN 03 Kolonel Silvertopstraat
651,Kolonel Silvertopstraat 5333,2023-02-18,21:00:00,84,53,31,FMN 03 Kolonel Silvertopstraat
651,Kolonel Silvertopstraat 5333,2023-02-18,22:00:00,85,46,39,FMN 03 Kolonel Silvertopstraat
651,Kolonel Silvertopstraat 5333,2023-02-18,23:00:00,84,45,39,FMN 03 Kolonel Silvertopstraat
651,Kolonel Silvertopstraat 5333,2023-02-19,00:00:00,48,21,27,FMN 03 Kolonel Silvertopstraat
651,Kolonel Silvertopstraat 5333,2023-02-19,01:00:00,37,15,22,FMN 03 Kolonel Silvertopstraat
651,Kolonel Silvertopstraat 5333,2023-02-19,02:00:00,33,15,18,FMN 03 Kolonel Silvertopstraat
651,Kolonel Silvertopstraat 5333,2023-02-19,03:00:00,22,7,15,FMN 03 Kolonel Silvertopstraat
651,Kolonel Silvertopstraat 5333,2023-02-19,04:00:00,19,5,14,FMN 03 Kolonel Silvertopstraat
651,Kolonel Silvertopstraat 5333,2023-02-19,05:00:00,28,15,13,FMN 03 Kolonel Silvertopstraat
651,Kolonel Silvertopstraat 5333,2023-02-19,06:00:00,31,19,12,FMN 03 Kolonel Silvertopstraat
651,Kolonel Silvertopstraat 5333,2023-02-19,07:00:00,20,18,2,FMN 03 Kolonel Silvertopstraat
651,Kolonel Silvertopstraat 5333,2023-02-19,08:00:00,39,31,8,FMN 03 Kolonel Silvertopstraat
651,Kolonel Silvertopstraat 5333,2023-02-19,09:00:00,91,67,24,FMN 03 Kolonel Silvertopstraat
651,Kolonel Silvertopstraat 5333,2023-02-19,10:00:00,92,68,24,FMN 03 Kolonel Silvertopstraat
651,Kolonel Silvertopstraat 5333,2023-02-19,11:00:00,104,79,25,FMN 03 Kolonel Silvertopstraat
651,Kolonel Silvertopstraat 5333,2023-02-19,12:00:00,126,87,39,FMN 03 Kolonel Silvertopstraat
651,Kolonel Silvertopstraat 5333,2023-02-19,13:00:00,119,88,31,FMN 03 Kolonel Silvertopstraat
651,Kolonel Silvertopstraat 5333,2023-02-19,14:00:00,145,109,36,FMN 03 Kolonel Silvertopstraat
651,Kolonel Silvertopstraat 5333,2023-02-19,15:00:00,99,58,41,FMN 03 Kolonel Silvertopstraat
651,Kolonel Silvertopstraat 5333,2023-02-19,16:00:00,131,98,33,FMN 03 Kolonel Silvertopstraat
651,Kolonel Silvertopstraat 5333,2023-02-19,17:00:00,111,73,38,FMN 03 Kolonel Silvertopstraat
651,Kolonel Silvertopstraat 5333,2023-02-19,18:00:00,125,89,36,FMN 03 Kolonel Silvertopstraat
651,Kolonel Silvertopstraat 5333,2023-02-19,19:00:00,109,70,39,FMN 03 Kolonel Silvertopstraat
651,Kolonel Silvertopstraat 5333,2023-02-19,20:00:00,91,51,40,FMN 03 Kolonel Silvertopstraat
651,Kolonel Silvertopstraat 5333,2023-02-19,21:00:00,67,33,34,FMN 03 Kolonel Silvertopstraat
651,Kolonel Silvertopstraat 5333,2023-02-19,22:00:00,64,36,28,FMN 03 Kolonel Silvertopstraat
651,Kolonel Silvertopstraat 5333,2023-02-19,23:00:00,28,13,15,FMN 03 Kolonel Silvertopstraat
651,Kolonel Silvertopstraat 5333,2023-02-20,00:00:00,20,6,14,FMN 03 Kolonel Silvertopstraat
651,Kolonel Silvertopstraat 5333,2023-02-20,01:00:00,16,9,7,FMN 03 Kolonel Silvertopstraat
651,Kolonel Silvertopstraat 5333,2023-02-20,02:00:00,7,5,2,FMN 03 Kolonel Silvertopstraat
651,Kolonel Silvertopstraat 5333,2023-02-20,03:00:00,7,2,5,FMN 03 Kolonel Silvertopstraat
651,Kolonel Silvertopstraat 5333,2023-02-20,04:00:00,26,22,4,FMN 03 Kolonel Silvertopstraat
651,Kolonel Silvertopstraat 5333,2023-02-20,05:00:00,58,33,25,FMN 03 Kolonel Silvertopstraat
651,Kolonel Silvertopstraat 5333,2023-02-20,06:00:00,101,83,18,FMN 03 Kolonel Silvertopstraat
651,Kolonel Silvertopstraat 5333,2023-02-20,07:00:00,196,161,35,FMN 03 Kolonel Silvertopstraat
651,Kolonel Silvertopstraat 5333,2023-02-20,08:00:00,304,252,52,FMN 03 Kolonel Silvertopstraat
651,Kolonel Silvertopstraat 5333,2023-02-20,09:00:00,186,154,32,FMN 03 Kolonel Silvertopstraat
651,Kolonel Silvertopstraat 5333,2023-02-20,10:00:00,138,99,39,FMN 03 Kolonel Silvertopstraat
651,Kolonel Silvertopstraat 5333,2023-02-20,11:00:00,120,88,32,FMN 03 Kolonel Silvertopstraat
651,Kolonel Silvertopstraat 5333,2023-02-20,12:00:00,141,103,38,FMN 03 Kolonel Silvertopstraat
651,Kolonel Silvertopstraat 5333,2023-02-20,13:00:00,169,113,56,FMN 03 Kolonel Silvertopstraat
651,Kolonel Silvertopstraat 5333,2023-02-20,14:00:00,158,108,50,FMN 03 Kolonel Silvertopstraat
651,Kolonel Silvertopstraat 5333,2023-02-20,15:00:00,182,128,54,FMN 03 Kolonel Silvertopstraat
651,Kolonel Silvertopstraat 5333,2023-02-20,16:00:00,229,160,69,FMN 03 Kolonel Silvertopstraat
651,Kolonel Silvertopstraat 5333,2023-02-20,17:00:00,307,191,116,FMN 03 Kolonel Silvertopstraat
651,Kolonel Silvertopstraat 5333,2023-02-20,18:00:00,215,131,84,FMN 03 Kolonel Silvertopstraat
651,Kolonel Silvertopstraat 5333,2023-02-20,19:00:00,128,82,46,FMN 03 Kolonel Silvertopstraat
651,Kolonel Silvertopstraat 5333,2023-02-20,20:00:00,115,58,57,FMN 03 Kolonel Silvertopstraat
651,Kolonel Silvertopstraat 5333,2023-02-20,21:00:00,63,30,33,FMN 03 Kolonel Silvertopstraat
651,Kolonel Silvertopstraat 5333,2023-02-20,22:00:00,75,50,25,FMN 03 Kolonel Silvertopstraat
651,Kolonel Silvertopstraat 5333,2023-02-20,23:00:00,31,12,19,FMN 03 Kolonel Silvertopstraat
651,Kolonel Silvertopstraat 5333,2023-02-21,00:00:00,22,11,11,FMN 03 Kolonel Silvertopstraat
651,Kolonel Silvertopstraat 5333,2023-02-21,01:00:00,10,5,5,FMN 03 Kolonel Silvertopstraat
651,Kolonel Silvertopstraat 5333,2023-02-21,02:00:00,5,2,3,FMN 03 Kolonel Silvertopstraat
651,Kolonel Silvertopstraat 5333,2023-02-21,03:00:00,7,5,2,FMN 03 Kolonel Silvertopstraat
651,Kolonel Silvertopstraat 5333,2023-02-21,04:00:00,32,26,6,FMN 03 Kolonel Silvertopstraat
651,Kolonel Silvertopstraat 5333,2023-02-21,05:00:00,41,28,13,FMN 03 Kolonel Silvertopstraat
651,Kolonel Silvertopstraat 5333,2023-02-21,06:00:00,109,89,20,FMN 03 Kolonel Silvertopstraat
651,Kolonel Silvertopstraat 5333,2023-02-21,07:00:00,200,161,39,FMN 03 Kolonel Silvertopstraat
651,Kolonel Silvertopstraat 5333,2023-02-21,08:00:00,339,283,56,FMN 03 Kolonel Silvertopstraat
651,Kolonel Silvertopstraat 5333,2023-02-21,09:00:00,199,156,43,FMN 03 Kolonel Silvertopstraat
651,Kolonel Silvertopstraat 5333,2023-02-21,10:00:00,130,99,31,FMN 03 Kolonel Silvertopstraat
651,Kolonel Silvertopstraat 5333,2023-02-21,11:00:00,123,90,33,FMN 03 Kolonel Silvertopstraat
651,Kolonel Silvertopstraat 5333,2023-02-21,12:00:00,145,111,34,FMN 03 Kolonel Silvertopstraat
651,Kolonel Silvertopstraat 5333,2023-02-21,13:00:00,134,95,39,FMN 03 Kolonel Silvertopstraat
651,Kolonel Silvertopstraat 5333,2023-02-21,14:00:00,177,134,43,FMN 03 Kolonel Silvertopstraat
651,Kolonel Silvertopstraat 5333,2023-02-21,15:00:00,186,118,68,FMN 03 Kolonel Silvertopstraat
651,Kolonel Silvertopstraat 5333,2023-02-21,16:00:00,266,183,83,FMN 03 Kolonel Silvertopstraat
651,Kolonel Silvertopstraat 5333,2023-02-21,17:00:00,331,197,134,FMN 03 Kolonel Silvertopstraat
651,Kolonel Silvertopstraat 5333,2023-02-21,18:00:00,250,161,89,FMN 03 Kolonel Silvertopstraat
651,Kolonel Silvertopstraat 5333,2023-02-21,19:00:00,157,100,57,FMN 03 Kolonel Silvertopstraat
651,Kolonel Silvertopstraat 5333,2023-02-21,20:00:00,127,65,62,FMN 03 Kolonel Silvertopstraat
651,Kolonel Silvertopstraat 5333,2023-02-21,21:00:00,85,47,38,FMN 03 Kolonel Silvertopstraat
651,Kolonel Silvertopstraat 5333,2023-02-21,22:00:00,82,47,35,FMN 03 Kolonel Silvertopstraat
651,Kolonel Silvertopstraat 5333,2023-02-21,23:00:00,49,20,29,FMN 03 Kolonel Silvertopstraat
651,Kolonel Silvertopstraat 5333,2023-02-22,00:00:00,23,12,11,FMN 03 Kolonel Silvertopstraat
651,Kolonel Silvertopstraat 5333,2023-02-22,01:00:00,11,3,8,FMN 03 Kolonel Silvertopstraat
651,Kolonel Silvertopstraat 5333,2023-02-22,02:00:00,7,2,5,FMN 03 Kolonel Silvertopstraat
651,Kolonel Silvertopstraat 5333,2023-02-22,03:00:00,2,0,2,FMN 03 Kolonel Silvertopstraat
651,Kolonel Silvertopstraat 5333,2023-02-22,04:00:00,25,18,7,FMN 03 Kolonel Silvertopstraat
651,Kolonel Silvertopstraat 5333,2023-02-22,05:00:00,50,29,21,FMN 03 Kolonel Silvertopstraat
651,Kolonel Silvertopstraat 5333,2023-02-22,06:00:00,96,74,22,FMN 03 Kolonel Silvertopstraat
651,Kolonel Silvertopstraat 5333,2023-02-22,07:00:00,155,116,39,FMN 03 Kolonel Silvertopstraat
651,Kolonel Silvertopstraat 5333,2023-02-22,08:00:00,289,243,46,FMN 03 Kolonel Silvertopstraat
651,Kolonel Silvertopstraat 5333,2023-02-22,09:00:00,172,141,31,FMN 03 Kolonel Silvertopstraat
651,Kolonel Silvertopstraat 5333,2023-02-22,10:00:00,121,94,27,FMN 03 Kolonel Silvertopstraat
651,Kolonel Silvertopstraat 5333,2023-02-22,11:00:00,102,74,28,FMN 03 Kolonel Silvertopstraat
651,Kolonel Silvertopstraat 5333,2023-02-22,12:00:00,134,86,48,FMN 03 Kolonel Silvertopstraat
651,Kolonel Silvertopstraat 5333,2023-02-22,13:00:00,154,108,46,FMN 03 Kolonel Silvertopstraat
651,Kolonel Silvertopstraat 5333,2023-02-22,14:00:00,145,111,34,FMN 03 Kolonel Silvertopstraat
651,Kolonel Silvertopstraat 5333,2023-02-22,15:00:00,188,127,61,FMN 03 Kolonel Silvertopstraat
651,Kolonel Silvertopstraat 5333,2023-02-22,16:00:00,272,188,84,FMN 03 Kolonel Silvertopstraat
651,Kolonel Silvertopstraat 5333,2023-02-22,17:00:00,285,189,96,FMN 03 Kolonel Silvertopstraat
651,Kolonel Silvertopstraat 5333,2023-02-22,18:00:00,236,153,83,FMN 03 Kolonel Silvertopstraat
651,Kolonel Silvertopstraat 5333,2023-02-22,19:00:00,168,117,51,FMN 03 Kolonel Silvertopstraat
651,Kolonel Silvertopstraat 5333,2023-02-22,20:00:00,116,75,41,FMN 03 Kolonel Silvertopstraat
651,Kolonel Silvertopstraat 5333,2023-02-22,21:00:00,73,44,29,FMN 03 Kolonel Silvertopstraat
651,Kolonel Silvertopstraat 5333,2023-02-22,22:00:00,98,42,56,FMN 03 Kolonel Silvertopstraat
651,Kolonel Silvertopstraat 5333,2023-02-22,23:00:00,54,25,29,FMN 03 Kolonel Silvertopstraat
651,Kolonel Silvertopstraat 5333,2023-02-23,00:00:00,31,16,15,FMN 03 Kolonel Silvertopstraat
651,Kolonel Silvertopstraat 5333,2023-02-23,01:00:00,21,9,12,FMN 03 Kolonel Silvertopstraat
651,Kolonel Silvertopstraat 5333,2023-02-23,02:00:00,9,4,5,FMN 03 Kolonel Silvertopstraat
651,Kolonel Silvertopstraat 5333,2023-02-23,03:00:00,9,5,4,FMN 03 Kolonel Silvertopstraat
651,Kolonel Silvertopstraat 5333,2023-02-23,04:00:00,21,18,3,FMN 03 Kolonel Silvertopstraat
651,Kolonel Silvertopstraat 5333,2023-02-23,05:00:00,49,29,20,FMN 03 Kolonel Silvertopstraat
651,Kolonel Silvertopstraat 5333,2023-02-23,06:00:00,108,83,25,FMN 03 Kolonel Silvertopstraat
651,Kolonel Silvertopstraat 5333,2023-02-23,07:00:00,170,139,31,FMN 03 Kolonel Silvertopstraat
651,Kolonel Silvertopstraat 5333,2023-02-23,08:00:00,275,220,55,FMN 03 Kolonel Silvertopstraat
651,Kolonel Silvertopstraat 5333,2023-02-23,09:00:00,194,157,37,FMN 03 Kolonel Silvertopstraat
651,Kolonel Silvertopstraat 5333,2023-02-23,10:00:00,124,97,27,FMN 03 Kolonel Silvertopstraat
651,Kolonel Silvertopstraat 5333,2023-02-23,11:00:00,123,85,38,FMN 03 Kolonel Silvertopstraat
651,Kolonel Silvertopstraat 5333,2023-02-23,12:00:00,144,114,30,FMN 03 Kolonel Silvertopstraat
651,Kolonel Silvertopstraat 5333,2023-02-23,13:00:00,151,97,54,FMN 03 Kolonel Silvertopstraat
651,Kolonel Silvertopstraat 5333,2023-02-23,14:00:00,153,95,58,FMN 03 Kolonel Silvertopstraat
651,Kolonel Silvertopstraat 5333,2023-02-23,15:00:00,193,134,59,FMN 03 Kolonel Silvertopstraat
651,Kolonel Silvertopstraat 5333,2023-02-23,16:00:00,275,204,71,FMN 03 Kolonel Silvertopstraat
651,Kolonel Silvertopstraat 5333,2023-02-23,17:00:00,301,195,106,FMN 03 Kolonel Silvertopstraat
651,Kolonel Silvertopstraat 5333,2023-02-23,18:00:00,248,149,99,FMN 03 Kolonel Silvertopstraat
651,Kolonel Silvertopstraat 5333,2023-02-23,19:00:00,175,123,52,FMN 03 Kolonel Silvertopstraat
651,Kolonel Silvertopstraat 5333,2023-02-23,20:00:00,137,81,56,FMN 03 Kolonel Silvertopstraat
651,Kolonel Silvertopstraat 5333,2023-02-23,21:00:00,87,52,35,FMN 03 Kolonel Silvertopstraat
651,Kolonel Silvertopstraat 5333,2023-02-23,22:00:00,107,65,42,FMN 03 Kolonel Silvertopstraat
651,Kolonel Silvertopstraat 5333,2023-02-23,23:00:00,79,31,48,FMN 03 Kolonel Silvertopstraat
651,Kolonel Silvertopstraat 5333,2023-02-24,00:00:00,43,16,27,FMN 03 Kolonel Silvertopstraat
651,Kolonel Silvertopstraat 5333,2023-02-24,01:00:00,14,10,4,FMN 03 Kolonel Silvertopstraat
651,Kolonel Silvertopstraat 5333,2023-02-24,02:00:00,10,5,5,FMN 03 Kolonel Silvertopstraat
651,Kolonel Silvertopstraat 5333,2023-02-24,03:00:00,14,6,8,FMN 03 Kolonel Silvertopstraat
651,Kolonel Silvertopstraat 5333,2023-02-24,04:00:00,30,20,10,FMN 03 Kolonel Silvertopstraat
651,Kolonel Silvertopstraat 5333,2023-02-24,05:00:00,46,31,15,FMN 03 Kolonel Silvertopstraat
651,Kolonel Silvertopstraat 5333,2023-02-24,06:00:00,95,78,17,FMN 03 Kolonel Silvertopstraat
651,Kolonel Silvertopstraat 5333,2023-02-24,07:00:00,132,102,30,FMN 03 Kolonel Silvertopstraat
651,Kolonel Silvertopstraat 5333,2023-02-24,08:00:00,244,201,43,FMN 03 Kolonel Silvertopstraat
651,Kolonel Silvertopstraat 5333,2023-02-24,09:00:00,169,134,35,FMN 03 Kolonel Silvertopstraat
651,Kolonel Silvertopstraat 5333,2023-02-24,10:00:00,169,128,41,FMN 03 Kolonel Silvertopstraat
651,Kolonel Silvertopstraat 5333,2023-02-24,11:00:00,126,90,36,FMN 03 Kolonel Silvertopstraat
651,Kolonel Silvertopstraat 5333,2023-02-24,12:00:00,157,110,47,FMN 03 Kolonel Silvertopstraat
651,Kolonel Silvertopstraat 5333,2023-02-24,13:00:00,181,126,55,FMN 03 Kolonel Silvertopstraat
651,Kolonel Silvertopstraat 5333,2023-02-24,14:00:00,158,108,50,FMN 03 Kolonel Silvertopstraat
651,Kolonel Silvertopstraat 5333,2023-02-24,15:00:00,165,110,55,FMN 03 Kolonel Silvertopstraat
651,Kolonel Silvertopstraat 5333,2023-02-24,16:00:00,204,141,63,FMN 03 Kolonel Silvertopstraat
651,Kolonel Silvertopstraat 5333,2023-02-24,17:00:00,249,170,79,FMN 03 Kolonel Silvertopstraat
651,Kolonel Silvertopstraat 5333,2023-02-24,18:00:00,207,128,79,FMN 03 Kolonel Silvertopstraat
651,Kolonel Silvertopstraat 5333,2023-02-24,19:00:00,196,136,60,FMN 03 Kolonel Silvertopstraat
651,Kolonel Silvertopstraat 5333,2023-02-24,20:00:00,137,90,47,FMN 03 Kolonel Silvertopstraat
651,Kolonel Silvertopstraat 5333,2023-02-24,21:00:00,93,59,34,FMN 03 Kolonel Silvertopstraat
651,Kolonel Silvertopstraat 5333,2023-02-24,22:00:00,88,47,41,FMN 03 Kolonel Silvertopstraat
651,Kolonel Silvertopstraat 5333,2023-02-24,23:00:00,64,23,41,FMN 03 Kolonel Silvertopstraat
651,Kolonel Silvertopstraat 5333,2023-02-25,00:00:00,66,30,36,FMN 03 Kolonel Silvertopstraat
651,Kolonel Silvertopstraat 5333,2023-02-25,01:00:00,45,19,26,FMN 03 Kolonel Silvertopstraat
651,Kolonel Silvertopstraat 5333,2023-02-25,02:00:00,21,11,10,FMN 03 Kolonel Silvertopstraat
651,Kolonel Silvertopstraat 5333,2023-02-25,03:00:00,21,8,13,FMN 03 Kolonel Silvertopstraat
651,Kolonel Silvertopstraat 5333,2023-02-25,04:00:00,29,15,14,FMN 03 Kolonel Silvertopstraat
651,Kolonel Silvertopstraat 5333,2023-02-25,05:00:00,22,13,9,FMN 03 Kolonel Silvertopstraat
651,Kolonel Silvertopstraat 5333,2023-02-25,06:00:00,41,30,11,FMN 03 Kolonel Silvertopstraat
651,Kolonel Silvertopstraat 5333,2023-02-25,07:00:00,31,25,6,FMN 03 Kolonel Silvertopstraat
651,Kolonel Silvertopstraat 5333,2023-02-25,08:00:00,55,39,16,FMN 03 Kolonel Silvertopstraat
651,Kolonel Silvertopstraat 5333,2023-02-25,09:00:00,128,98,30,FMN 03 Kolonel Silvertopstraat
651,Kolonel Silvertopstraat 5333,2023-02-25,10:00:00,122,102,20,FMN 03 Kolonel Silvertopstraat
651,Kolonel Silvertopstraat 5333,2023-02-25,11:00:00,131,101,30,FMN 03 Kolonel Silvertopstraat
651,Kolonel Silvertopstraat 5333,2023-02-25,12:00:00,152,105,47,FMN 03 Kolonel Silvertopstraat
651,Kolonel Silvertopstraat 5333,2023-02-25,13:00:00,159,121,38,FMN 03 Kolonel Silvertopstraat
651,Kolonel Silvertopstraat 5333,2023-02-25,14:00:00,143,105,38,FMN 03 Kolonel Silvertopstraat
651,Kolonel Silvertopstraat 5333,2023-02-25,15:00:00,151,85,66,FMN 03 Kolonel Silvertopstraat
651,Kolonel Silvertopstraat 5333,2023-02-25,16:00:00,148,103,45,FMN 03 Kolonel Silvertopstraat
651,Kolonel Silvertopstraat 5333,2023-02-25,17:00:00,155,116,39,FMN 03 Kolonel Silvertopstraat
651,Kolonel Silvertopstraat 5333,2023-02-25,18:00:00,180,117,63,FMN 03 Kolonel Silvertopstraat
651,Kolonel Silvertopstraat 5333,2023-02-25,19:00:00,141,101,40,FMN 03 Kolonel Silvertopstraat
651,Kolonel Silvertopstraat 5333,2023-02-25,20:00:00,107,71,36,FMN 03 Kolonel Silvertopstraat
651,Kolonel Silvertopstraat 5333,2023-02-25,21:00:00,75,41,34,FMN 03 Kolonel Silvertopstraat
651,Kolonel Silvertopstraat 5333,2023-02-25,22:00:00,88,51,37,FMN 03 Kolonel Silvertopstraat
651,Kolonel Silvertopstraat 5333,2023-02-25,23:00:00,67,25,42,FMN 03 Kolonel Silvertopstraat
651,Kolonel Silvertopstraat 5333,2023-02-26,00:00:00,52,15,37,FMN 03 Kolonel Silvertopstraat
651,Kolonel Silvertopstraat 5333,2023-02-26,01:00:00,57,27,30,FMN 03 Kolonel Silvertopstraat
651,Kolonel Silvertopstraat 5333,2023-02-26,02:00:00,26,9,17,FMN 03 Kolonel Silvertopstraat
651,Kolonel Silvertopstraat 5333,2023-02-26,03:00:00,24,14,10,FMN 03 Kolonel Silvertopstraat
651,Kolonel Silvertopstraat 5333,2023-02-26,04:00:00,20,11,9,FMN 03 Kolonel Silvertopstraat
651,Kolonel Silvertopstraat 5333,2023-02-26,05:00:00,28,26,2,FMN 03 Kolonel Silvertopstraat
651,Kolonel Silvertopstraat 5333,2023-02-26,06:00:00,50,40,10,FMN 03 Kolonel Silvertopstraat
651,Kolonel Silvertopstraat 5333,2023-02-26,07:00:00,15,11,4,FMN 03 Kolonel Silvertopstraat
651,Kolonel Silvertopstraat 5333,2023-02-26,08:00:00,40,29,11,FMN 03 Kolonel Silvertopstraat
651,Kolonel Silvertopstraat 5333,2023-02-26,09:00:00,80,63,17,FMN 03 Kolonel Silvertopstraat
651,Kolonel Silvertopstraat 5333,2023-02-26,10:00:00,84,66,18,FMN 03 Kolonel Silvertopstraat
651,Kolonel Silvertopstraat 5333,2023-02-26,11:00:00,90,62,28,FMN 03 Kolonel Silvertopstraat
651,Kolonel Silvertopstraat 5333,2023-02-26,12:00:00,115,74,41,FMN 03 Kolonel Silvertopstraat
651,Kolonel Silvertopstraat 5333,2023-02-26,13:00:00,126,90,36,FMN 03 Kolonel Silvertopstraat
651,Kolonel Silvertopstraat 5333,2023-02-26,14:00:00,142,101,41,FMN 03 Kolonel Silvertopstraat
651,Kolonel Silvertopstraat 5333,2023-02-26,15:00:00,133,70,63,FMN 03 Kolonel Silvertopstraat
651,Kolonel Silvertopstraat 5333,2023-02-26,16:00:00,119,74,45,FMN 03 Kolonel Silvertopstraat
651,Kolonel Silvertopstraat 5333,2023-02-26,17:00:00,154,104,50,FMN 03 Kolonel Silvertopstraat
651,Kolonel Silvertopstraat 5333,2023-02-26,18:00:00,172,118,54,FMN 03 Kolonel Silvertopstraat
651,Kolonel Silvertopstraat 5333,2023-02-26,19:00:00,106,65,41,FMN 03 Kolonel Silvertopstraat
651,Kolonel Silvertopstraat 5333,2023-02-26,20:00:00,75,46,29,FMN 03 Kolonel Silvertopstraat
651,Kolonel Silvertopstraat 5333,2023-02-26,21:00:00,63,41,22,FMN 03 Kolonel Silvertopstraat
651,Kolonel Silvertopstraat 5333,2023-02-26,22:00:00,62,28,34,FMN 03 Kolonel Silvertopstraat
651,Kolonel Silvertopstraat 5333,2023-02-26,23:00:00,32,18,14,FMN 03 Kolonel Silvertopstraat
651,Kolonel Silvertopstraat 5333,2023-02-27,00:00:00,15,7,8,FMN 03 Kolonel Silvertopstraat
651,Kolonel Silvertopstraat 5333,2023-02-27,01:00:00,15,6,9,FMN 03 Kolonel Silvertopstraat
651,Kolonel Silvertopstraat 5333,2023-02-27,02:00:00,6,4,2,FMN 03 Kolonel Silvertopstraat
651,Kolonel Silvertopstraat 5333,2023-02-27,03:00:00,5,2,3,FMN 03 Kolonel Silvertopstraat
651,Kolonel Silvertopstraat 5333,2023-02-27,04:00:00,15,11,4,FMN 03 Kolonel Silvertopstraat
651,Kolonel Silvertopstraat 5333,2023-02-27,05:00:00,50,28,22,FMN 03 Kolonel Silvertopstraat
651,Kolonel Silvertopstraat 5333,2023-02-27,06:00:00,115,88,27,FMN 03 Kolonel Silvertopstraat
651,Kolonel Silvertopstraat 5333,2023-02-27,07:00:00,290,239,51,FMN 03 Kolonel Silvertopstraat
651,Kolonel Silvertopstraat 5333,2023-02-27,08:00:00,600,507,93,FMN 03 Kolonel Silvertopstraat
651,Kolonel Silvertopstraat 5333,2023-02-27,09:00:00,184,140,44,FMN 03 Kolonel Silvertopstraat
651,Kolonel Silvertopstraat 5333,2023-02-27,10:00:00,155,116,39,FMN 03 Kolonel Silvertopstraat
651,Kolonel Silvertopstraat 5333,2023-02-27,11:00:00,121,89,32,FMN 03 Kolonel Silvertopstraat
651,Kolonel Silvertopstraat 5333,2023-02-27,12:00:00,166,103,63,FMN 03 Kolonel Silvertopstraat
651,Kolonel Silvertopstraat 5333,2023-02-27,13:00:00,169,110,59,FMN 03 Kolonel Silvertopstraat
651,Kolonel Silvertopstraat 5333,2023-02-27,14:00:00,174,131,43,FMN 03 Kolonel Silvertopstraat
651,Kolonel Silvertopstraat 5333,2023-02-27,15:00:00,280,173,107,FMN 03 Kolonel Silvertopstraat
651,Kolonel Silvertopstraat 5333,2023-02-27,16:00:00,382,253,129,FMN 03 Kolonel Silvertopstraat
651,Kolonel Silvertopstraat 5333,2023-02-27,17:00:00,359,232,127,FMN 03 Kolonel Silvertopstraat
651,Kolonel Silvertopstraat 5333,2023-02-27,18:00:00,271,167,104,FMN 03 Kolonel Silvertopstraat
651,Kolonel Silvertopstraat 5333,2023-02-27,19:00:00,137,86,51,FMN 03 Kolonel Silvertopstraat
651,Kolonel Silvertopstraat 5333,2023-02-27,20:00:00,125,64,61,FMN 03 Kolonel Silvertopstraat
651,Kolonel Silvertopstraat 5333,2023-02-27,21:00:00,97,46,51,FMN 03 Kolonel Silvertopstraat
651,Kolonel Silvertopstraat 5333,2023-02-27,22:00:00,68,30,38,FMN 03 Kolonel Silvertopstraat
651,Kolonel Silvertopstraat 5333,2023-02-27,23:00:00,33,15,18,FMN 03 Kolonel Silvertopstraat
651,Kolonel Silvertopstraat 5333,2023-02-28,00:00:00,24,12,12,FMN 03 Kolonel Silvertopstraat
651,Kolonel Silvertopstraat 5333,2023-02-28,01:00:00,9,4,5,FMN 03 Kolonel Silvertopstraat
651,Kolonel Silvertopstraat 5333,2023-02-28,02:00:00,3,1,2,FMN 03 Kolonel Silvertopstraat
651,Kolonel Silvertopstraat 5333,2023-02-28,03:00:00,6,5,1,FMN 03 Kolonel Silvertopstraat
651,Kolonel Silvertopstraat 5333,2023-02-28,04:00:00,18,14,4,FMN 03 Kolonel Silvertopstraat
651,Kolonel Silvertopstraat 5333,2023-02-28,05:00:00,47,26,21,FMN 03 Kolonel Silvertopstraat
651,Kolonel Silvertopstraat 5333,2023-02-28,06:00:00,131,109,22,FMN 03 Kolonel Silvertopstraat
651,Kolonel Silvertopstraat 5333,2023-02-28,07:00:00,334,276,58,FMN 03 Kolonel Silvertopstraat
651,Kolonel Silvertopstraat 5333,2023-02-28,08:00:00,634,543,91,FMN 03 Kolonel Silvertopstraat
651,Kolonel Silvertopstraat 5333,2023-02-28,09:00:00,206,161,45,FMN 03 Kolonel Silvertopstraat
651,Kolonel Silvertopstraat 5333,2023-02-28,10:00:00,161,122,39,FMN 03 Kolonel Silvertopstraat
651,Kolonel Silvertopstraat 5333,2023-02-28,11:00:00,137,102,35,FMN 03 Kolonel Silvertopstraat
651,Kolonel Silvertopstraat 5333,2023-02-28,12:00:00,198,132,66,FMN 03 Kolonel Silvertopstraat
651,Kolonel Silvertopstraat 5333,2023-02-28,13:00:00,160,114,46,FMN 03 Kolonel Silvertopstraat
651,Kolonel Silvertopstraat 5333,2023-02-28,14:00:00,150,106,44,FMN 03 Kolonel Silvertopstraat
651,Kolonel Silvertopstraat 5333,2023-02-28,15:00:00,299,170,129,FMN 03 Kolonel Silvertopstraat
651,Kolonel Silvertopstraat 5333,2023-02-28,16:00:00,381,241,140,FMN 03 Kolonel Silvertopstraat
651,Kolonel Silvertopstraat 5333,2023-02-28,17:00:00,391,235,156,FMN 03 Kolonel Silvertopstraat
651,Kolonel Silvertopstraat 5333,2023-02-28,18:00:00,277,173,104,FMN 03 Kolonel Silvertopstraat
651,Kolonel Silvertopstraat 5333,2023-02-28,19:00:00,159,98,61,FMN 03 Kolonel Silvertopstraat
651,Kolonel Silvertopstraat 5333,2023-02-28,20:00:00,128,69,59,FMN 03 Kolonel Silvertopstraat
651,Kolonel Silvertopstraat 5333,2023-02-28,21:00:00,91,44,47,FMN 03 Kolonel Silvertopstraat
651,Kolonel Silvertopstraat 5333,2023-02-28,22:00:00,95,59,36,FMN 03 Kolonel Silvertopstraat
651,Kolonel Silvertopstraat 5333,2023-02-28,23:00:00,63,31,32,FMN 03 Kolonel Silvertopstraat
651,Kolonel Silvertopstraat 5333,2023-03-01,00:00:00,22,7,15,FMN 03 Kolonel Silvertopstraat
651,Kolonel Silvertopstraat 5333,2023-03-01,01:00:00,14,6,8,FMN 03 Kolonel Silvertopstraat
651,Kolonel Silvertopstraat 5333,2023-03-01,02:00:00,5,2,3,FMN 03 Kolonel Silvertopstraat
651,Kolonel Silvertopstraat 5333,2023-03-01,03:00:00,3,1,2,FMN 03 Kolonel Silvertopstraat
651,Kolonel Silvertopstraat 5333,2023-03-01,04:00:00,17,12,5,FMN 03 Kolonel Silvertopstraat
651,Kolonel Silvertopstraat 5333,2023-03-01,05:00:00,51,34,17,FMN 03 Kolonel Silvertopstraat
651,Kolonel Silvertopstraat 5333,2023-03-01,06:00:00,107,90,17,FMN 03 Kolonel Silvertopstraat
651,Kolonel Silvertopstraat 5333,2023-03-01,07:00:00,285,228,57,FMN 03 Kolonel Silvertopstraat
651,Kolonel Silvertopstraat 5333,2023-03-01,08:00:00,556,458,98,FMN 03 Kolonel Silvertopstraat
651,Kolonel Silvertopstraat 5333,2023-03-01,09:00:00,186,143,43,FMN 03 Kolonel Silvertopstraat
651,Kolonel Silvertopstraat 5333,2023-03-01,10:00:00,151,115,36,FMN 03 Kolonel Silvertopstraat
651,Kolonel Silvertopstraat 5333,2023-03-01,11:00:00,148,118,30,FMN 03 Kolonel Silvertopstraat
651,Kolonel Silvertopstraat 5333,2023-03-01,12:00:00,305,197,108,FMN 03 Kolonel Silvertopstraat
651,Kolonel Silvertopstraat 5333,2023-03-01,13:00:00,235,147,88,FMN 03 Kolonel Silvertopstraat
651,Kolonel Silvertopstraat 5333,2023-03-01,14:00:00,172,103,69,FMN 03 Kolonel Silvertopstraat
651,Kolonel Silvertopstraat 5333,2023-03-01,15:00:00,209,126,83,FMN 03 Kolonel Silvertopstraat
651,Kolonel Silvertopstraat 5333,2023-03-01,16:00:00,316,212,104,FMN 03 Kolonel Silvertopstraat
651,Kolonel Silvertopstraat 5333,2023-03-01,17:00:00,368,244,124,FMN 03 Kolonel Silvertopstraat
651,Kolonel Silvertopstraat 5333,2023-03-01,18:00:00,273,168,105,FMN 03 Kolonel Silvertopstraat
651,Kolonel Silvertopstraat 5333,2023-03-01,19:00:00,190,119,71,FMN 03 Kolonel Silvertopstraat
651,Kolonel Silvertopstraat 5333,2023-03-01,20:00:00,132,75,57,FMN 03 Kolonel Silvertopstraat
651,Kolonel Silvertopstraat 5333,2023-03-01,21:00:00,84,39,45,FMN 03 Kolonel Silvertopstraat
651,Kolonel Silvertopstraat 5333,2023-03-01,22:00:00,83,50,33,FMN 03 Kolonel Silvertopstraat
651,Kolonel Silvertopstraat 5333,2023-03-01,23:00:00,47,16,31,FMN 03 Kolonel Silvertopstraat
651,Kolonel Silvertopstraat 5333,2023-03-02,00:00:00,30,15,15,FMN 03 Kolonel Silvertopstraat
651,Kolonel Silvertopstraat 5333,2023-03-02,01:00:00,14,7,7,FMN 03 Kolonel Silvertopstraat
651,Kolonel Silvertopstraat 5333,2023-03-02,02:00:00,1,1,0,FMN 03 Kolonel Silvertopstraat
651,Kolonel Silvertopstraat 5333,2023-03-02,03:00:00,2,1,1,FMN 03 Kolonel Silvertopstraat
651,Kolonel Silvertopstraat 5333,2023-03-02,04:00:00,16,13,3,FMN 03 Kolonel Silvertopstraat
651,Kolonel Silvertopstraat 5333,2023-03-02,05:00:00,55,37,18,FMN 03 Kolonel Silvertopstraat
651,Kolonel Silvertopstraat 5333,2023-03-02,06:00:00,110,88,22,FMN 03 Kolonel Silvertopstraat
651,Kolonel Silvertopstraat 5333,2023-03-02,07:00:00,302,251,51,FMN 03 Kolonel Silvertopstraat
651,Kolonel Silvertopstraat 5333,2023-03-02,08:00:00,605,520,85,FMN 03 Kolonel Silvertopstraat
651,Kolonel Silvertopstraat 5333,2023-03-02,09:00:00,230,169,61,FMN 03 Kolonel Silvertopstraat
651,Kolonel Silvertopstraat 5333,2023-03-02,10:00:00,141,109,32,FMN 03 Kolonel Silvertopstraat
651,Kolonel Silvertopstraat 5333,2023-03-02,11:00:00,126,95,31,FMN 03 Kolonel Silvertopstraat
651,Kolonel Silvertopstraat 5333,2023-03-02,12:00:00,175,121,54,FMN 03 Kolonel Silvertopstraat
651,Kolonel Silvertopstraat 5333,2023-03-02,13:00:00,186,130,56,FMN 03 Kolonel Silvertopstraat
651,Kolonel Silvertopstraat 5333,2023-03-02,14:00:00,177,114,63,FMN 03 Kolonel Silvertopstraat
651,Kolonel Silvertopstraat 5333,2023-03-02,15:00:00,259,148,111,FMN 03 Kolonel Silvertopstraat
651,Kolonel Silvertopstraat 5333,2023-03-02,16:00:00,392,253,139,FMN 03 Kolonel Silvertopstraat
651,Kolonel Silvertopstraat 5333,2023-03-02,17:00:00,386,247,139,FMN 03 Kolonel Silvertopstraat
651,Kolonel Silvertopstraat 5333,2023-03-02,18:00:00,301,193,108,FMN 03 Kolonel Silvertopstraat
651,Kolonel Silvertopstraat 5333,2023-03-02,19:00:00,221,143,78,FMN 03 Kolonel Silvertopstraat
651,Kolonel Silvertopstraat 5333,2023-03-02,20:00:00,125,73,52,FMN 03 Kolonel Silvertopstraat
651,Kolonel Silvertopstraat 5333,2023-03-02,21:00:00,119,60,59,FMN 03 Kolonel Silvertopstraat
651,Kolonel Silvertopstraat 5333,2023-03-02,22:00:00,91,39,52,FMN 03 Kolonel Silvertopstraat
651,Kolonel Silvertopstraat 5333,2023-03-02,23:00:00,61,22,39,FMN 03 Kolonel Silvertopstraat
651,Kolonel Silvertopstraat 5333,2023-03-03,00:00:00,27,14,13,FMN 03 Kolonel Silvertopstraat
651,Kolonel Silvertopstraat 5333,2023-03-03,01:00:00,19,6,13,FMN 03 Kolonel Silvertopstraat
651,Kolonel Silvertopstraat 5333,2023-03-03,02:00:00,8,3,5,FMN 03 Kolonel Silvertopstraat
651,Kolonel Silvertopstraat 5333,2023-03-03,03:00:00,9,5,4,FMN 03 Kolonel Silvertopstraat
651,Kolonel Silvertopstraat 5333,2023-03-03,04:00:00,17,9,8,FMN 03 Kolonel Silvertopstraat
651,Kolonel Silvertopstraat 5333,2023-03-03,05:00:00,53,34,19,FMN 03 Kolonel Silvertopstraat
651,Kolonel Silvertopstraat 5333,2023-03-03,06:00:00,117,91,26,FMN 03 Kolonel Silvertopstraat
651,Kolonel Silvertopstraat 5333,2023-03-03,07:00:00,278,224,54,FMN 03 Kolonel Silvertopstraat
651,Kolonel Silvertopstraat 5333,2023-03-03,08:00:00,535,463,72,FMN 03 Kolonel Silvertopstraat
651,Kolonel Silvertopstraat 5333,2023-03-03,09:00:00,226,176,50,FMN 03 Kolonel Silvertopstraat
651,Kolonel Silvertopstraat 5333,2023-03-03,10:00:00,156,119,37,FMN 03 Kolonel Silvertopstraat
651,Kolonel Silvertopstraat 5333,2023-03-03,11:00:00,136,84,52,FMN 03 Kolonel Silvertopstraat
651,Kolonel Silvertopstraat 5333,2023-03-03,12:00:00,187,131,56,FMN 03 Kolonel Silvertopstraat
651,Kolonel Silvertopstraat 5333,2023-03-03,13:00:00,213,141,72,FMN 03 Kolonel Silvertopstraat
651,Kolonel Silvertopstraat 5333,2023-03-03,14:00:00,229,145,84,FMN 03 Kolonel Silvertopstraat
651,Kolonel Silvertopstraat 5333,2023-03-03,15:00:00,274,172,102,FMN 03 Kolonel Silvertopstraat
651,Kolonel Silvertopstraat 5333,2023-03-03,16:00:00,342,225,117,FMN 03 Kolonel Silvertopstraat
651,Kolonel Silvertopstraat 5333,2023-03-03,17:00:00,321,207,114,FMN 03 Kolonel Silvertopstraat
651,Kolonel Silvertopstraat 5333,2023-03-03,18:00:00,249,159,90,FMN 03 Kolonel Silvertopstraat
651,Kolonel Silvertopstraat 5333,2023-03-03,19:00:00,218,158,60,FMN 03 Kolonel Silvertopstraat
651,Kolonel Silvertopstraat 5333,2023-03-03,20:00:00,125,70,55,FMN 03 Kolonel Silvertopstraat
651,Kolonel Silvertopstraat 5333,2023-03-03,21:00:00,98,56,42,FMN 03 Kolonel Silvertopstraat
651,Kolonel Silvertopstraat 5333,2023-03-03,22:00:00,117,73,44,FMN 03 Kolonel Silvertopstraat
651,Kolonel Silvertopstraat 5333,2023-03-03,23:00:00,89,43,46,FMN 03 Kolonel Silvertopstraat
651,Kolonel Silvertopstraat 5333,2023-03-04,00:00:00,69,32,37,FMN 03 Kolonel Silvertopstraat
651,Kolonel Silvertopstraat 5333,2023-03-04,01:00:00,43,21,22,FMN 03 Kolonel Silvertopstraat
651,Kolonel Silvertopstraat 5333,2023-03-04,02:00:00,27,9,18,FMN 03 Kolonel Silvertopstraat
651,Kolonel Silvertopstraat 5333,2023-03-04,03:00:00,15,0,15,FMN 03 Kolonel Silvertopstraat
651,Kolonel Silvertopstraat 5333,2023-03-04,04:00:00,24,6,18,FMN 03 Kolonel Silvertopstraat
651,Kolonel Silvertopstraat 5333,2023-03-04,05:00:00,22,11,11,FMN 03 Kolonel Silvertopstraat
651,Kolonel Silvertopstraat 5333,2023-03-04,06:00:00,33,29,4,FMN 03 Kolonel Silvertopstraat
651,Kolonel Silvertopstraat 5333,2023-03-04,07:00:00,34,24,10,FMN 03 Kolonel Silvertopstraat
651,Kolonel Silvertopstraat 5333,2023-03-04,08:00:00,81,67,14,FMN 03 Kolonel Silvertopstraat
651,Kolonel Silvertopstraat 5333,2023-03-04,09:00:00,120,94,26,FMN 03 Kolonel Silvertopstraat
651,Kolonel Silvertopstraat 5333,2023-03-04,10:00:00,142,116,26,FMN 03 Kolonel Silvertopstraat
651,Kolonel Silvertopstraat 5333,2023-03-04,11:00:00,169,129,40,FMN 03 Kolonel Silvertopstraat
651,Kolonel Silvertopstraat 5333,2023-03-04,12:00:00,159,113,46,FMN 03 Kolonel Silvertopstraat
651,Kolonel Silvertopstraat 5333,2023-03-04,13:00:00,150,107,43,FMN 03 Kolonel Silvertopstraat
651,Kolonel Silvertopstraat 5333,2023-03-04,14:00:00,156,112,44,FMN 03 Kolonel Silvertopstraat
651,Kolonel Silvertopstraat 5333,2023-03-04,15:00:00,152,100,52,FMN 03 Kolonel Silvertopstraat
651,Kolonel Silvertopstraat 5333,2023-03-04,16:00:00,132,85,47,FMN 03 Kolonel Silvertopstraat
651,Kolonel Silvertopstraat 5333,2023-03-04,17:00:00,165,102,63,FMN 03 Kolonel Silvertopstraat
651,Kolonel Silvertopstraat 5333,2023-03-04,18:00:00,176,123,53,FMN 03 Kolonel Silvertopstraat
651,Kolonel Silvertopstraat 5333,2023-03-04,19:00:00,126,89,37,FMN 03 Kolonel Silvertopstraat
651,Kolonel Silvertopstraat 5333,2023-03-04,20:00:00,117,79,38,FMN 03 Kolonel Silvertopstraat
651,Kolonel Silvertopstraat 5333,2023-03-04,21:00:00,91,59,32,FMN 03 Kolonel Silvertopstraat
651,Kolonel Silvertopstraat 5333,2023-03-04,22:00:00,72,42,30,FMN 03 Kolonel Silvertopstraat
651,Kolonel Silvertopstraat 5333,2023-03-04,23:00:00,65,27,38,FMN 03 Kolonel Silvertopstraat
651,Kolonel Silvertopstraat 5333,2023-03-05,00:00:00,57,28,29,FMN 03 Kolonel Silvertopstraat
651,Kolonel Silvertopstraat 5333,2023-03-05,01:00:00,41,21,20,FMN 03 Kolonel Silvertopstraat
651,Kolonel Silvertopstraat 5333,2023-03-05,02:00:00,18,13,5,FMN 03 Kolonel Silvertopstraat
651,Kolonel Silvertopstraat 5333,2023-03-05,03:00:00,27,9,18,FMN 03 Kolonel Silvertopstraat
651,Kolonel Silvertopstraat 5333,2023-03-05,04:00:00,19,9,10,FMN 03 Kolonel Silvertopstraat
651,Kolonel Silvertopstraat 5333,2023-03-05,05:00:00,20,13,7,FMN 03 Kolonel Silvertopstraat
651,Kolonel Silvertopstraat 5333,2023-03-05,06:00:00,33,25,8,FMN 03 Kolonel Silvertopstraat
651,Kolonel Silvertopstraat 5333,2023-03-05,07:00:00,23,17,6,FMN 03 Kolonel Silvertopstraat
651,Kolonel Silvertopstraat 5333,2023-03-05,08:00:00,47,36,11,FMN 03 Kolonel Silvertopstraat
651,Kolonel Silvertopstraat 5333,2023-03-05,09:00:00,60,46,14,FMN 03 Kolonel Silvertopstraat
651,Kolonel Silvertopstraat 5333,2023-03-05,10:00:00,88,68,20,FMN 03 Kolonel Silvertopstraat
651,Kolonel Silvertopstraat 5333,2023-03-05,11:00:00,89,65,24,FMN 03 Kolonel Silvertopstraat
651,Kolonel Silvertopstraat 5333,2023-03-05,12:00:00,113,85,28,FMN 03 Kolonel Silvertopstraat
651,Kolonel Silvertopstraat 5333,2023-03-05,13:00:00,96,52,44,FMN 03 Kolonel Silvertopstraat
651,Kolonel Silvertopstraat 5333,2023-03-05,14:00:00,118,79,39,FMN 03 Kolonel Silvertopstraat
651,Kolonel Silvertopstraat 5333,2023-03-05,15:00:00,96,62,34,FMN 03 Kolonel Silvertopstraat
651,Kolonel Silvertopstraat 5333,2023-03-05,16:00:00,116,78,38,FMN 03 Kolonel Silvertopstraat
651,Kolonel Silvertopstraat 5333,2023-03-05,17:00:00,123,80,43,FMN 03 Kolonel Silvertopstraat
651,Kolonel Silvertopstraat 5333,2023-03-05,18:00:00,130,76,54,FMN 03 Kolonel Silvertopstraat
651,Kolonel Silvertopstraat 5333,2023-03-05,19:00:00,88,55,33,FMN 03 Kolonel Silvertopstraat
651,Kolonel Silvertopstraat 5333,2023-03-05,20:00:00,69,38,31,FMN 03 Kolonel Silvertopstraat
651,Kolonel Silvertopstraat 5333,2023-03-05,21:00:00,48,21,27,FMN 03 Kolonel Silvertopstraat
651,Kolonel Silvertopstraat 5333,2023-03-05,22:00:00,42,21,21,FMN 03 Kolonel Silvertopstraat
651,Kolonel Silvertopstraat 5333,2023-03-05,23:00:00,21,8,13,FMN 03 Kolonel Silvertopstraat
651,Kolonel Silvertopstraat 5333,2023-03-06,00:00:00,15,8,7,FMN 03 Kolonel Silvertopstraat
651,Kolonel Silvertopstraat 5333,2023-03-06,01:00:00,10,3,7,FMN 03 Kolonel Silvertopstraat
651,Kolonel Silvertopstraat 5333,2023-03-06,02:00:00,8,4,4,FMN 03 Kolonel Silvertopstraat
651,Kolonel Silvertopstraat 5333,2023-03-06,03:00:00,6,2,4,FMN 03 Kolonel Silvertopstraat
651,Kolonel Silvertopstraat 5333,2023-03-06,04:00:00,30,25,5,FMN 03 Kolonel Silvertopstraat
651,Kolonel Silvertopstraat 5333,2023-03-06,05:00:00,40,25,15,FMN 03 Kolonel Silvertopstraat
651,Kolonel Silvertopstraat 5333,2023-03-06,06:00:00,122,104,18,FMN 03 Kolonel Silvertopstraat
651,Kolonel Silvertopstraat 5333,2023-03-06,07:00:00,304,255,49,FMN 03 Kolonel Silvertopstraat
651,Kolonel Silvertopstraat 5333,2023-03-06,08:00:00,594,504,90,FMN 03 Kolonel Silvertopstraat
651,Kolonel Silvertopstraat 5333,2023-03-06,09:00:00,190,144,46,FMN 03 Kolonel Silvertopstraat
651,Kolonel Silvertopstraat 5333,2023-03-06,10:00:00,126,100,26,FMN 03 Kolonel Silvertopstraat
651,Kolonel Silvertopstraat 5333,2023-03-06,11:00:00,104,74,30,FMN 03 Kolonel Silvertopstraat
651,Kolonel Silvertopstraat 5333,2023-03-06,12:00:00,181,137,44,FMN 03 Kolonel Silvertopstraat
651,Kolonel Silvertopstraat 5333,2023-03-06,13:00:00,174,120,54,FMN 03 Kolonel Silvertopstraat
651,Kolonel Silvertopstraat 5333,2023-03-06,14:00:00,154,107,47,FMN 03 Kolonel Silvertopstraat
651,Kolonel Silvertopstraat 5333,2023-03-06,15:00:00,254,154,100,FMN 03 Kolonel Silvertopstraat
651,Kolonel Silvertopstraat 5333,2023-03-06,16:00:00,348,220,128,FMN 03 Kolonel Silvertopstraat
651,Kolonel Silvertopstraat 5333,2023-03-06,17:00:00,375,244,131,FMN 03 Kolonel Silvertopstraat
651,Kolonel Silvertopstraat 5333,2023-03-06,18:00:00,236,141,95,FMN 03 Kolonel Silvertopstraat
651,Kolonel Silvertopstraat 5333,2023-03-06,19:00:00,131,81,50,FMN 03 Kolonel Silvertopstraat
651,Kolonel Silvertopstraat 5333,2023-03-06,20:00:00,84,46,38,FMN 03 Kolonel Silvertopstraat
651,Kolonel Silvertopstraat 5333,2023-03-06,21:00:00,86,39,47,FMN 03 Kolonel Silvertopstraat
651,Kolonel Silvertopstraat 5333,2023-03-06,22:00:00,76,37,39,FMN 03 Kolonel Silvertopstraat
651,Kolonel Silvertopstraat 5333,2023-03-06,23:00:00,34,15,19,FMN 03 Kolonel Silvertopstraat
651,Kolonel Silvertopstraat 5333,2023-03-07,00:00:00,9,2,7,FMN 03 Kolonel Silvertopstraat
651,Kolonel Silvertopstraat 5333,2023-03-07,01:00:00,9,1,8,FMN 03 Kolonel Silvertopstraat
651,Kolonel Silvertopstraat 5333,2023-03-07,02:00:00,3,2,1,FMN 03 Kolonel Silvertopstraat
651,Kolonel Silvertopstraat 5333,2023-03-07,03:00:00,1,1,0,FMN 03 Kolonel Silvertopstraat
651,Kolonel Silvertopstraat 5333,2023-03-07,04:00:00,21,15,6,FMN 03 Kolonel Silvertopstraat
651,Kolonel Silvertopstraat 5333,2023-03-07,05:00:00,40,27,13,FMN 03 Kolonel Silvertopstraat
651,Kolonel Silvertopstraat 5333,2023-03-07,06:00:00,121,99,22,FMN 03 Kolonel Silvertopstraat
651,Kolonel Silvertopstraat 5333,2023-03-07,07:00:00,316,265,51,FMN 03 Kolonel Silvertopstraat
651,Kolonel Silvertopstraat 5333,2023-03-07,08:00:00,535,463,72,FMN 03 Kolonel Silvertopstraat
651,Kolonel Silvertopstraat 5333,2023-03-07,09:00:00,165,127,38,FMN 03 Kolonel Silvertopstraat
651,Kolonel Silvertopstraat 5333,2023-03-07,10:00:00,117,97,20,FMN 03 Kolonel Silvertopstraat
651,Kolonel Silvertopstraat 5333,2023-03-07,11:00:00,107,81,26,FMN 03 Kolonel Silvertopstraat
651,Kolonel Silvertopstraat 5333,2023-03-07,12:00:00,144,101,43,FMN 03 Kolonel Silvertopstraat
651,Kolonel Silvertopstraat 5333,2023-03-07,13:00:00,139,100,39,FMN 03 Kolonel Silvertopstraat
651,Kolonel Silvertopstraat 5333,2023-03-07,14:00:00,145,97,48,FMN 03 Kolonel Silvertopstraat
651,Kolonel Silvertopstraat 5333,2023-03-07,15:00:00,204,106,98,FMN 03 Kolonel Silvertopstraat
651,Kolonel Silvertopstraat 5333,2023-03-07,16:00:00,273,173,100,FMN 03 Kolonel Silvertopstraat
651,Kolonel Silvertopstraat 5333,2023-03-07,17:00:00,318,180,138,FMN 03 Kolonel Silvertopstraat
651,Kolonel Silvertopstraat 5333,2023-03-07,18:00:00,205,124,81,FMN 03 Kolonel Silvertopstraat
651,Kolonel Silvertopstraat 5333,2023-03-07,19:00:00,117,67,50,FMN 03 Kolonel Silvertopstraat
651,Kolonel Silvertopstraat 5333,2023-03-07,20:00:00,99,64,35,FMN 03 Kolonel Silvertopstraat
651,Kolonel Silvertopstraat 5333,2023-03-07,21:00:00,82,36,46,FMN 03 Kolonel Silvertopstraat
651,Kolonel Silvertopstraat 5333,2023-03-07,22:00:00,73,42,31,FMN 03 Kolonel Silvertopstraat
651,Kolonel Silvertopstraat 5333,2023-03-07,23:00:00,40,21,19,FMN 03 Kolonel Silvertopstraat
651,Kolonel Silvertopstraat 5333,2023-03-08,00:00:00,12,8,4,FMN 03 Kolonel Silvertopstraat
651,Kolonel Silvertopstraat 5333,2023-03-08,01:00:00,17,7,10,FMN 03 Kolonel Silvertopstraat
651,Kolonel Silvertopstraat 5333,2023-03-08,02:00:00,6,3,3,FMN 03 Kolonel Silvertopstraat
651,Kolonel Silvertopstraat 5333,2023-03-08,03:00:00,3,1,2,FMN 03 Kolonel Silvertopstraat
651,Kolonel Silvertopstraat 5333,2023-03-08,04:00:00,25,17,8,FMN 03 Kolonel Silvertopstraat
651,Kolonel Silvertopstraat 5333,2023-03-08,05:00:00,35,23,12,FMN 03 Kolonel Silvertopstraat
651,Kolonel Silvertopstraat 5333,2023-03-08,06:00:00,94,73,21,FMN 03 Kolonel Silvertopstraat
651,Kolonel Silvertopstraat 5333,2023-03-08,07:00:00,180,142,38,FMN 03 Kolonel Silvertopstraat
651,Kolonel Silvertopstraat 5333,2023-03-08,08:00:00,300,253,47,FMN 03 Kolonel Silvertopstraat
651,Kolonel Silvertopstraat 5333,2023-03-08,09:00:00,91,68,23,FMN 03 Kolonel Silvertopstraat
651,Kolonel Silvertopstraat 5333,2023-03-08,10:00:00,59,49,10,FMN 03 Kolonel Silvertopstraat
651,Kolonel Silvertopstraat 5333,2023-03-08,11:00:00,79,62,17,FMN 03 Kolonel Silvertopstraat
651,Kolonel Silvertopstraat 5333,2023-03-08,12:00:00,166,89,77,FMN 03 Kolonel Silvertopstraat
651,Kolonel Silvertopstraat 5333,2023-03-08,13:00:00,137,82,55,FMN 03 Kolonel Silvertopstraat
651,Kolonel Silvertopstraat 5333,2023-03-08,14:00:00,140,98,42,FMN 03 Kolonel Silvertopstraat
651,Kolonel Silvertopstraat 5333,2023-03-08,15:00:00,133,84,49,FMN 03 Kolonel Silvertopstraat
651,Kolonel Silvertopstraat 5333,2023-03-08,16:00:00,196,137,59,FMN 03 Kolonel Silvertopstraat
651,Kolonel Silvertopstraat 5333,2023-03-08,17:00:00,217,134,83,FMN 03 Kolonel Silvertopstraat
651,Kolonel Silvertopstraat 5333,2023-03-08,18:00:00,164,104,60,FMN 03 Kolonel Silvertopstraat
651,Kolonel Silvertopstraat 5333,2023-03-08,19:00:00,105,62,43,FMN 03 Kolonel Silvertopstraat
651,Kolonel Silvertopstraat 5333,2023-03-08,20:00:00,75,45,30,FMN 03 Kolonel Silvertopstraat
651,Kolonel Silvertopstraat 5333,2023-03-08,21:00:00,76,45,31,FMN 03 Kolonel Silvertopstraat
651,Kolonel Silvertopstraat 5333,2023-03-08,22:00:00,56,26,30,FMN 03 Kolonel Silvertopstraat
651,Kolonel Silvertopstraat 5333,2023-03-08,23:00:00,36,14,22,FMN 03 Kolonel Silvertopstraat
651,Kolonel Silvertopstraat 5333,2023-03-09,00:00:00,16,6,10,FMN 03 Kolonel Silvertopstraat
651,Kolonel Silvertopstraat 5333,2023-03-09,01:00:00,14,8,6,FMN 03 Kolonel Silvertopstraat
651,Kolonel Silvertopstraat 5333,2023-03-09,02:00:00,3,0,3,FMN 03 Kolonel Silvertopstraat
651,Kolonel Silvertopstraat 5333,2023-03-09,03:00:00,6,4,2,FMN 03 Kolonel Silvertopstraat
651,Kolonel Silvertopstraat 5333,2023-03-09,04:00:00,23,17,6,FMN 03 Kolonel Silvertopstraat
651,Kolonel Silvertopstraat 5333,2023-03-09,05:00:00,39,23,16,FMN 03 Kolonel Silvertopstraat
651,Kolonel Silvertopstraat 5333,2023-03-09,06:00:00,108,88,20,FMN 03 Kolonel Silvertopstraat
651,Kolonel Silvertopstraat 5333,2023-03-09,07:00:00,242,191,51,FMN 03 Kolonel Silvertopstraat
651,Kolonel Silvertopstraat 5333,2023-03-09,08:00:00,524,450,74,FMN 03 Kolonel Silvertopstraat
651,Kolonel Silvertopstraat 5333,2023-03-09,09:00:00,198,154,44,FMN 03 Kolonel Silvertopstraat
651,Kolonel Silvertopstraat 5333,2023-03-09,10:00:00,141,107,34,FMN 03 Kolonel Silvertopstraat
651,Kolonel Silvertopstraat 5333,2023-03-09,11:00:00,113,84,29,FMN 03 Kolonel Silvertopstraat
651,Kolonel Silvertopstraat 5333,2023-03-09,12:00:00,137,101,36,FMN 03 Kolonel Silvertopstraat
651,Kolonel Silvertopstraat 5333,2023-03-09,13:00:00,150,97,53,FMN 03 Kolonel Silvertopstraat
651,Kolonel Silvertopstraat 5333,2023-03-09,14:00:00,150,94,56,FMN 03 Kolonel Silvertopstraat
651,Kolonel Silvertopstraat 5333,2023-03-09,15:00:00,198,114,84,FMN 03 Kolonel Silvertopstraat
651,Kolonel Silvertopstraat 5333,2023-03-09,16:00:00,280,190,90,FMN 03 Kolonel Silvertopstraat
651,Kolonel Silvertopstraat 5333,2023-03-09,17:00:00,284,169,115,FMN 03 Kolonel Silvertopstraat
651,Kolonel Silvertopstraat 5333,2023-03-09,18:00:00,210,127,83,FMN 03 Kolonel Silvertopstraat
651,Kolonel Silvertopstraat 5333,2023-03-09,19:00:00,139,86,53,FMN 03 Kolonel Silvertopstraat
651,Kolonel Silvertopstraat 5333,2023-03-09,20:00:00,76,42,34,FMN 03 Kolonel Silvertopstraat
651,Kolonel Silvertopstraat 5333,2023-03-09,21:00:00,70,35,35,FMN 03 Kolonel Silvertopstraat
651,Kolonel Silvertopstraat 5333,2023-03-09,22:00:00,68,27,41,FMN 03 Kolonel Silvertopstraat
651,Kolonel Silvertopstraat 5333,2023-03-09,23:00:00,30,11,19,FMN 03 Kolonel Silvertopstraat
651,Kolonel Silvertopstraat 5333,2023-03-10,00:00:00,18,9,9,FMN 03 Kolonel Silvertopstraat
651,Kolonel Silvertopstraat 5333,2023-03-10,01:00:00,16,4,12,FMN 03 Kolonel Silvertopstraat
651,Kolonel Silvertopstraat 5333,2023-03-10,02:00:00,15,4,11,FMN 03 Kolonel Silvertopstraat
651,Kolonel Silvertopstraat 5333,2023-03-10,03:00:00,6,4,2,FMN 03 Kolonel Silvertopstraat
651,Kolonel Silvertopstraat 5333,2023-03-10,04:00:00,20,12,8,FMN 03 Kolonel Silvertopstraat
651,Kolonel Silvertopstraat 5333,2023-03-10,05:00:00,48,33,15,FMN 03 Kolonel Silvertopstraat
651,Kolonel Silvertopstraat 5333,2023-03-10,06:00:00,93,74,19,FMN 03 Kolonel Silvertopstraat
651,Kolonel Silvertopstraat 5333,2023-03-10,07:00:00,254,199,55,FMN 03 Kolonel Silvertopstraat
651,Kolonel Silvertopstraat 5333,2023-03-10,08:00:00,521,449,72,FMN 03 Kolonel Silvertopstraat
651,Kolonel Silvertopstraat 5333,2023-03-10,09:00:00,139,112,27,FMN 03 Kolonel Silvertopstraat
651,Kolonel Silvertopstraat 5333,2023-03-10,10:00:00,132,102,30,FMN 03 Kolonel Silvertopstraat
651,Kolonel Silvertopstraat 5333,2023-03-10,11:00:00,129,93,36,FMN 03 Kolonel Silvertopstraat
651,Kolonel Silvertopstraat 5333,2023-03-10,12:00:00,179,136,43,FMN 03 Kolonel Silvertopstraat
651,Kolonel Silvertopstraat 5333,2023-03-10,13:00:00,173,114,59,FMN 03 Kolonel Silvertopstraat
651,Kolonel Silvertopstraat 5333,2023-03-10,14:00:00,140,78,62,FMN 03 Kolonel Silvertopstraat
651,Kolonel Silvertopstraat 5333,2023-03-10,15:00:00,245,131,114,FMN 03 Kolonel Silvertopstraat
651,Kolonel Silvertopstraat 5333,2023-03-10,16:00:00,252,155,97,FMN 03 Kolonel Silvertopstraat
651,Kolonel Silvertopstraat 5333,2023-03-10,17:00:00,274,191,83,FMN 03 Kolonel Silvertopstraat
651,Kolonel Silvertopstraat 5333,2023-03-10,18:00:00,213,141,72,FMN 03 Kolonel Silvertopstraat
651,Kolonel Silvertopstraat 5333,2023-03-10,19:00:00,190,107,83,FMN 03 Kolonel Silvertopstraat
651,Kolonel Silvertopstraat 5333,2023-03-10,20:00:00,108,67,41,FMN 03 Kolonel Silvertopstraat
651,Kolonel Silvertopstraat 5333,2023-03-10,21:00:00,109,74,35,FMN 03 Kolonel Silvertopstraat
651,Kolonel Silvertopstraat 5333,2023-03-10,22:00:00,135,98,37,FMN 03 Kolonel Silvertopstraat
651,Kolonel Silvertopstraat 5333,2023-03-10,23:00:00,117,61,56,FMN 03 Kolonel Silvertopstraat
651,Kolonel Silvertopstraat 5333,2023-03-11,00:00:00,79,32,47,FMN 03 Kolonel Silvertopstraat
651,Kolonel Silvertopstraat 5333,2023-03-11,01:00:00,38,15,23,FMN 03 Kolonel Silvertopstraat
651,Kolonel Silvertopstraat 5333,2023-03-11,02:00:00,30,8,22,FMN 03 Kolonel Silvertopstraat
651,Kolonel Silvertopstraat 5333,2023-03-11,03:00:00,17,6,11,FMN 03 Kolonel Silvertopstraat
651,Kolonel Silvertopstraat 5333,2023-03-11,04:00:00,20,9,11,FMN 03 Kolonel Silvertopstraat
651,Kolonel Silvertopstraat 5333,2023-03-11,05:00:00,19,7,12,FMN 03 Kolonel Silvertopstraat
651,Kolonel Silvertopstraat 5333,2023-03-11,06:00:00,35,24,11,FMN 03 Kolonel Silvertopstraat
651,Kolonel Silvertopstraat 5333,2023-03-11,07:00:00,40,29,11,FMN 03 Kolonel Silvertopstraat
651,Kolonel Silvertopstraat 5333,2023-03-11,08:00:00,67,56,11,FMN 03 Kolonel Silvertopstraat
651,Kolonel Silvertopstraat 5333,2023-03-11,09:00:00,136,115,21,FMN 03 Kolonel Silvertopstraat
651,Kolonel Silvertopstraat 5333,2023-03-11,10:00:00,156,127,29,FMN 03 Kolonel Silvertopstraat
651,Kolonel Silvertopstraat 5333,2023-03-11,11:00:00,155,119,36,FMN 03 Kolonel Silvertopstraat
651,Kolonel Silvertopstraat 5333,2023-03-11,12:00:00,169,121,48,FMN 03 Kolonel Silvertopstraat
651,Kolonel Silvertopstraat 5333,2023-03-11,13:00:00,219,156,63,FMN 03 Kolonel Silvertopstraat
651,Kolonel Silvertopstraat 5333,2023-03-11,14:00:00,168,122,46,FMN 03 Kolonel Silvertopstraat
651,Kolonel Silvertopstraat 5333,2023-03-11,15:00:00,195,137,58,FMN 03 Kolonel Silvertopstraat
651,Kolonel Silvertopstraat 5333,2023-03-11,16:00:00,196,136,60,FMN 03 Kolonel Silvertopstraat
651,Kolonel Silvertopstraat 5333,2023-03-11,17:00:00,209,130,79,FMN 03 Kolonel Silvertopstraat
651,Kolonel Silvertopstraat 5333,2023-03-11,18:00:00,178,116,62,FMN 03 Kolonel Silvertopstraat
651,Kolonel Silvertopstraat 5333,2023-03-11,19:00:00,187,136,51,FMN 03 Kolonel Silvertopstraat
651,Kolonel Silvertopstraat 5333,2023-03-11,20:00:00,133,88,45,FMN 03 Kolonel Silvertopstraat
651,Kolonel Silvertopstraat 5333,2023-03-11,21:00:00,70,43,27,FMN 03 Kolonel Silvertopstraat
651,Kolonel Silvertopstraat 5333,2023-03-11,22:00:00,86,39,47,FMN 03 Kolonel Silvertopstraat
651,Kolonel Silvertopstraat 5333,2023-03-11,23:00:00,76,41,35,FMN 03 Kolonel Silvertopstraat
651,Kolonel Silvertopstraat 5333,2023-03-12,00:00:00,49,15,34,FMN 03 Kolonel Silvertopstraat
651,Kolonel Silvertopstraat 5333,2023-03-12,01:00:00,31,9,22,FMN 03 Kolonel Silvertopstraat
651,Kolonel Silvertopstraat 5333,2023-03-12,02:00:00,29,13,16,FMN 03 Kolonel Silvertopstraat
651,Kolonel Silvertopstraat 5333,2023-03-12,03:00:00,19,6,13,FMN 03 Kolonel Silvertopstraat
651,Kolonel Silvertopstraat 5333,2023-03-12,04:00:00,19,11,8,FMN 03 Kolonel Silvertopstraat
651,Kolonel Silvertopstraat 5333,2023-03-12,05:00:00,29,14,15,FMN 03 Kolonel Silvertopstraat
651,Kolonel Silvertopstraat 5333,2023-03-12,06:00:00,19,11,8,FMN 03 Kolonel Silvertopstraat
651,Kolonel Silvertopstraat 5333,2023-03-12,07:00:00,20,12,8,FMN 03 Kolonel Silvertopstraat
651,Kolonel Silvertopstraat 5333,2023-03-12,08:00:00,31,25,6,FMN 03 Kolonel Silvertopstraat
651,Kolonel Silvertopstraat 5333,2023-03-12,09:00:00,57,49,8,FMN 03 Kolonel Silvertopstraat
651,Kolonel Silvertopstraat 5333,2023-03-12,10:00:00,94,65,29,FMN 03 Kolonel Silvertopstraat
651,Kolonel Silvertopstraat 5333,2023-03-12,11:00:00,84,62,22,FMN 03 Kolonel Silvertopstraat
651,Kolonel Silvertopstraat 5333,2023-03-12,12:00:00,110,82,28,FMN 03 Kolonel Silvertopstraat
651,Kolonel Silvertopstraat 5333,2023-03-12,13:00:00,126,93,33,FMN 03 Kolonel Silvertopstraat
651,Kolonel Silvertopstraat 5333,2023-03-12,14:00:00,126,89,37,FMN 03 Kolonel Silvertopstraat
651,Kolonel Silvertopstraat 5333,2023-03-12,15:00:00,112,85,27,FMN 03 Kolonel Silvertopstraat
651,Kolonel Silvertopstraat 5333,2023-03-12,16:00:00,125,78,47,FMN 03 Kolonel Silvertopstraat
651,Kolonel Silvertopstraat 5333,2023-03-12,17:00:00,129,88,41,FMN 03 Kolonel Silvertopstraat
651,Kolonel Silvertopstraat 5333,2023-03-12,18:00:00,107,71,36,FMN 03 Kolonel Silvertopstraat
651,Kolonel Silvertopstraat 5333,2023-03-12,19:00:00,120,81,39,FMN 03 Kolonel Silvertopstraat
651,Kolonel Silvertopstraat 5333,2023-03-12,20:00:00,78,38,40,FMN 03 Kolonel Silvertopstraat
651,Kolonel Silvertopstraat 5333,2023-03-12,21:00:00,67,33,34,FMN 03 Kolonel Silvertopstraat
651,Kolonel Silvertopstraat 5333,2023-03-12,22:00:00,45,25,20,FMN 03 Kolonel Silvertopstraat
651,Kolonel Silvertopstraat 5333,2023-03-12,23:00:00,32,10,22,FMN 03 Kolonel Silvertopstraat
651,Kolonel Silvertopstraat 5333,2023-03-13,00:00:00,18,5,13,FMN 03 Kolonel Silvertopstraat
651,Kolonel Silvertopstraat 5333,2023-03-13,01:00:00,13,0,13,FMN 03 Kolonel Silvertopstraat
651,Kolonel Silvertopstraat 5333,2023-03-13,02:00:00,5,4,1,FMN 03 Kolonel Silvertopstraat
651,Kolonel Silvertopstraat 5333,2023-03-13,03:00:00,4,2,2,FMN 03 Kolonel Silvertopstraat
651,Kolonel Silvertopstraat 5333,2023-03-13,04:00:00,13,11,2,FMN 03 Kolonel Silvertopstraat
651,Kolonel Silvertopstraat 5333,2023-03-13,05:00:00,48,38,10,FMN 03 Kolonel Silvertopstraat
651,Kolonel Silvertopstraat 5333,2023-03-13,06:00:00,119,99,20,FMN 03 Kolonel Silvertopstraat
651,Kolonel Silvertopstraat 5333,2023-03-13,07:00:00,297,247,50,FMN 03 Kolonel Silvertopstraat
651,Kolonel Silvertopstraat 5333,2023-03-13,08:00:00,603,511,92,FMN 03 Kolonel Silvertopstraat
651,Kolonel Silvertopstraat 5333,2023-03-13,09:00:00,175,132,43,FMN 03 Kolonel Silvertopstraat
651,Kolonel Silvertopstraat 5333,2023-03-13,10:00:00,158,122,36,FMN 03 Kolonel Silvertopstraat
651,Kolonel Silvertopstraat 5333,2023-03-13,11:00:00,102,81,21,FMN 03 Kolonel Silvertopstraat
651,Kolonel Silvertopstraat 5333,2023-03-13,12:00:00,181,115,66,FMN 03 Kolonel Silvertopstraat
651,Kolonel Silvertopstraat 5333,2023-03-13,13:00:00,168,118,50,FMN 03 Kolonel Silvertopstraat
651,Kolonel Silvertopstraat 5333,2023-03-13,14:00:00,166,120,46,FMN 03 Kolonel Silvertopstraat
651,Kolonel Silvertopstraat 5333,2023-03-13,15:00:00,240,146,94,FMN 03 Kolonel Silvertopstraat
651,Kolonel Silvertopstraat 5333,2023-03-13,16:00:00,380,256,124,FMN 03 Kolonel Silvertopstraat
651,Kolonel Silvertopstraat 5333,2023-03-13,17:00:00,374,248,126,FMN 03 Kolonel Silvertopstraat
651,Kolonel Silvertopstraat 5333,2023-03-13,18:00:00,262,165,97,FMN 03 Kolonel Silvertopstraat
651,Kolonel Silvertopstraat 5333,2023-03-13,19:00:00,197,106,91,FMN 03 Kolonel Silvertopstraat
651,Kolonel Silvertopstraat 5333,2023-03-13,20:00:00,121,63,58,FMN 03 Kolonel Silvertopstraat
651,Kolonel Silvertopstraat 5333,2023-03-13,21:00:00,103,46,57,FMN 03 Kolonel Silvertopstraat
651,Kolonel Silvertopstraat 5333,2023-03-13,22:00:00,97,50,47,FMN 03 Kolonel Silvertopstraat
651,Kolonel Silvertopstraat 5333,2023-03-13,23:00:00,47,15,32,FMN 03 Kolonel Silvertopstraat
651,Kolonel Silvertopstraat 5333,2023-03-14,00:00:00,18,11,7,FMN 03 Kolonel Silvertopstraat
651,Kolonel Silvertopstraat 5333,2023-03-14,01:00:00,15,4,11,FMN 03 Kolonel Silvertopstraat
651,Kolonel Silvertopstraat 5333,2023-03-14,02:00:00,6,3,3,FMN 03 Kolonel Silvertopstraat
651,Kolonel Silvertopstraat 5333,2023-03-14,03:00:00,7,5,2,FMN 03 Kolonel Silvertopstraat
651,Kolonel Silvertopstraat 5333,2023-03-14,04:00:00,16,10,6,FMN 03 Kolonel Silvertopstraat
651,Kolonel Silvertopstraat 5333,2023-03-14,05:00:00,54,36,18,FMN 03 Kolonel Silvertopstraat
651,Kolonel Silvertopstraat 5333,2023-03-14,06:00:00,118,94,24,FMN 03 Kolonel Silvertopstraat
651,Kolonel Silvertopstraat 5333,2023-03-14,07:00:00,274,222,52,FMN 03 Kolonel Silvertopstraat
651,Kolonel Silvertopstraat 5333,2023-03-14,08:00:00,490,419,71,FMN 03 Kolonel Silvertopstraat
651,Kolonel Silvertopstraat 5333,2023-03-14,09:00:00,198,150,48,FMN 03 Kolonel Silvertopstraat
651,Kolonel Silvertopstraat 5333,2023-03-14,10:00:00,113,97,16,FMN 03 Kolonel Silvertopstraat
651,Kolonel Silvertopstraat 5333,2023-03-14,11:00:00,95,67,28,FMN 03 Kolonel Silvertopstraat
651,Kolonel Silvertopstraat 5333,2023-03-14,12:00:00,131,91,40,FMN 03 Kolonel Silvertopstraat
651,Kolonel Silvertopstraat 5333,2023-03-14,13:00:00,174,113,61,FMN 03 Kolonel Silvertopstraat
651,Kolonel Silvertopstraat 5333,2023-03-14,14:00:00,156,107,49,FMN 03 Kolonel Silvertopstraat
651,Kolonel Silvertopstraat 5333,2023-03-14,15:00:00,250,156,94,FMN 03 Kolonel Silvertopstraat
651,Kolonel Silvertopstraat 5333,2023-03-14,16:00:00,328,216,112,FMN 03 Kolonel Silvertopstraat
651,Kolonel Silvertopstraat 5333,2023-03-14,17:00:00,323,213,110,FMN 03 Kolonel Silvertopstraat
651,Kolonel Silvertopstraat 5333,2023-03-14,18:00:00,239,150,89,FMN 03 Kolonel Silvertopstraat
651,Kolonel Silvertopstraat 5333,2023-03-14,19:00:00,168,104,64,FMN 03 Kolonel Silvertopstraat
651,Kolonel Silvertopstraat 5333,2023-03-14,20:00:00,122,66,56,FMN 03 Kolonel Silvertopstraat
651,Kolonel Silvertopstraat 5333,2023-03-14,21:00:00,102,51,51,FMN 03 Kolonel Silvertopstraat
651,Kolonel Silvertopstraat 5333,2023-03-14,22:00:00,88,50,38,FMN 03 Kolonel Silvertopstraat
651,Kolonel Silvertopstraat 5333,2023-03-14,23:00:00,37,14,23,FMN 03 Kolonel Silvertopstraat
651,Kolonel Silvertopstraat 5333,2023-03-15,00:00:00,20,9,11,FMN 03 Kolonel Silvertopstraat
651,Kolonel Silvertopstraat 5333,2023-03-15,01:00:00,12,3,9,FMN 03 Kolonel Silvertopstraat
651,Kolonel Silvertopstraat 5333,2023-03-15,02:00:00,8,4,4,FMN 03 Kolonel Silvertopstraat
651,Kolonel Silvertopstraat 5333,2023-03-15,03:00:00,3,1,2,FMN 03 Kolonel Silvertopstraat
651,Kolonel Silvertopstraat 5333,2023-03-15,04:00:00,13,8,5,FMN 03 Kolonel Silvertopstraat
651,Kolonel Silvertopstraat 5333,2023-03-15,05:00:00,45,30,15,FMN 03 Kolonel Silvertopstraat
651,Kolonel Silvertopstraat 5333,2023-03-15,06:00:00,91,68,23,FMN 03 Kolonel Silvertopstraat
651,Kolonel Silvertopstraat 5333,2023-03-15,07:00:00,273,226,47,FMN 03 Kolonel Silvertopstraat
651,Kolonel Silvertopstraat 5333,2023-03-15,08:00:00,535,445,90,FMN 03 Kolonel Silvertopstraat
651,Kolonel Silvertopstraat 5333,2023-03-15,09:00:00,184,138,46,FMN 03 Kolonel Silvertopstraat
651,Kolonel Silvertopstraat 5333,2023-03-15,10:00:00,135,108,27,FMN 03 Kolonel Silvertopstraat
651,Kolonel Silvertopstraat 5333,2023-03-15,11:00:00,159,120,39,FMN 03 Kolonel Silvertopstraat
651,Kolonel Silvertopstraat 5333,2023-03-15,12:00:00,289,181,108,FMN 03 Kolonel Silvertopstraat
651,Kolonel Silvertopstraat 5333,2023-03-15,13:00:00,241,154,87,FMN 03 Kolonel Silvertopstraat
651,Kolonel Silvertopstraat 5333,2023-03-15,14:00:00,196,143,53,FMN 03 Kolonel Silvertopstraat
651,Kolonel Silvertopstraat 5333,2023-03-15,15:00:00,200,130,70,FMN 03 Kolonel Silvertopstraat
651,Kolonel Silvertopstraat 5333,2023-03-15,16:00:00,291,202,89,FMN 03 Kolonel Silvertopstraat
651,Kolonel Silvertopstraat 5333,2023-03-15,17:00:00,342,231,111,FMN 03 Kolonel Silvertopstraat
651,Kolonel Silvertopstraat 5333,2023-03-15,18:00:00,278,173,105,FMN 03 Kolonel Silvertopstraat
651,Kolonel Silvertopstraat 5333,2023-03-15,19:00:00,196,126,70,FMN 03 Kolonel Silvertopstraat
651,Kolonel Silvertopstraat 5333,2023-03-15,20:00:00,128,70,58,FMN 03 Kolonel Silvertopstraat
651,Kolonel Silvertopstraat 5333,2023-03-15,21:00:00,95,45,50,FMN 03 Kolonel Silvertopstraat
651,Kolonel Silvertopstraat 5333,2023-03-15,22:00:00,102,52,50,FMN 03 Kolonel Silvertopstraat
651,Kolonel Silvertopstraat 5333,2023-03-15,23:00:00,67,22,45,FMN 03 Kolonel Silvertopstraat
651,Kolonel Silvertopstraat 5333,2023-03-16,00:00:00,34,13,21,FMN 03 Kolonel Silvertopstraat
651,Kolonel Silvertopstraat 5333,2023-03-16,01:00:00,15,7,8,FMN 03 Kolonel Silvertopstraat
651,Kolonel Silvertopstraat 5333,2023-03-16,02:00:00,17,5,12,FMN 03 Kolonel Silvertopstraat
651,Kolonel Silvertopstraat 5333,2023-03-16,03:00:00,7,3,4,FMN 03 Kolonel Silvertopstraat
651,Kolonel Silvertopstraat 5333,2023-03-16,04:00:00,20,17,3,FMN 03 Kolonel Silvertopstraat
651,Kolonel Silvertopstraat 5333,2023-03-16,05:00:00,51,34,17,FMN 03 Kolonel Silvertopstraat
651,Kolonel Silvertopstraat 5333,2023-03-16,06:00:00,115,98,17,FMN 03 Kolonel Silvertopstraat
651,Kolonel Silvertopstraat 5333,2023-03-16,07:00:00,330,272,58,FMN 03 Kolonel Silvertopstraat
651,Kolonel Silvertopstraat 5333,2023-03-16,08:00:00,664,570,94,FMN 03 Kolonel Silvertopstraat
651,Kolonel Silvertopstraat 5333,2023-03-16,09:00:00,235,194,41,FMN 03 Kolonel Silvertopstraat
651,Kolonel Silvertopstraat 5333,2023-03-16,10:00:00,158,126,32,FMN 03 Kolonel Silvertopstraat
651,Kolonel Silvertopstraat 5333,2023-03-16,11:00:00,143,112,31,FMN 03 Kolonel Silvertopstraat
651,Kolonel Silvertopstraat 5333,2023-03-16,12:00:00,226,177,49,FMN 03 Kolonel Silvertopstraat
651,Kolonel Silvertopstraat 5333,2023-03-16,13:00:00,193,141,52,FMN 03 Kolonel Silvertopstraat
651,Kolonel Silvertopstraat 5333,2023-03-16,14:00:00,203,138,65,FMN 03 Kolonel Silvertopstraat
651,Kolonel Silvertopstraat 5333,2023-03-16,15:00:00,320,179,141,FMN 03 Kolonel Silvertopstraat
651,Kolonel Silvertopstraat 5333,2023-03-16,16:00:00,371,241,130,FMN 03 Kolonel Silvertopstraat
651,Kolonel Silvertopstraat 5333,2023-03-16,17:00:00,401,251,150,FMN 03 Kolonel Silvertopstraat
651,Kolonel Silvertopstraat 5333,2023-03-16,18:00:00,298,202,96,FMN 03 Kolonel Silvertopstraat
651,Kolonel Silvertopstraat 5333,2023-03-16,19:00:00,215,136,79,FMN 03 Kolonel Silvertopstraat
651,Kolonel Silvertopstraat 5333,2023-03-16,20:00:00,158,94,64,FMN 03 Kolonel Silvertopstraat
651,Kolonel Silvertopstraat 5333,2023-03-16,21:00:00,143,63,80,FMN 03 Kolonel Silvertopstraat
651,Kolonel Silvertopstraat 5333,2023-03-16,22:00:00,106,53,53,FMN 03 Kolonel Silvertopstraat
651,Kolonel Silvertopstraat 5333,2023-03-16,23:00:00,74,27,47,FMN 03 Kolonel Silvertopstraat
651,Kolonel Silvertopstraat 5333,2023-03-17,00:00:00,32,14,18,FMN 03 Kolonel Silvertopstraat
651,Kolonel Silvertopstraat 5333,2023-03-17,01:00:00,14,7,7,FMN 03 Kolonel Silvertopstraat
651,Kolonel Silvertopstraat 5333,2023-03-17,02:00:00,13,4,9,FMN 03 Kolonel Silvertopstraat
651,Kolonel Silvertopstraat 5333,2023-03-17,03:00:00,10,2,8,FMN 03 Kolonel Silvertopstraat
651,Kolonel Silvertopstraat 5333,2023-03-17,04:00:00,24,19,5,FMN 03 Kolonel Silvertopstraat
651,Kolonel Silvertopstraat 5333,2023-03-17,05:00:00,49,37,12,FMN 03 Kolonel Silvertopstraat
651,Kolonel Silvertopstraat 5333,2023-03-17,06:00:00,101,83,18,FMN 03 Kolonel Silvertopstraat
651,Kolonel Silvertopstraat 5333,2023-03-17,07:00:00,297,245,52,FMN 03 Kolonel Silvertopstraat
651,Kolonel Silvertopstraat 5333,2023-03-17,08:00:00,554,480,74,FMN 03 Kolonel Silvertopstraat
651,Kolonel Silvertopstraat 5333,2023-03-17,09:00:00,199,158,41,FMN 03 Kolonel Silvertopstraat
651,Kolonel Silvertopstraat 5333,2023-03-17,10:00:00,179,143,36,FMN 03 Kolonel Silvertopstraat
651,Kolonel Silvertopstraat 5333,2023-03-17,11:00:00,149,104,45,FMN 03 Kolonel Silvertopstraat
651,Kolonel Silvertopstraat 5333,2023-03-17,12:00:00,238,153,85,FMN 03 Kolonel Silvertopstraat
651,Kolonel Silvertopstraat 5333,2023-03-17,13:00:00,205,137,68,FMN 03 Kolonel Silvertopstraat
651,Kolonel Silvertopstraat 5333,2023-03-17,14:00:00,204,138,66,FMN 03 Kolonel Silvertopstraat
651,Kolonel Silvertopstraat 5333,2023-03-17,15:00:00,312,191,121,FMN 03 Kolonel Silvertopstraat
651,Kolonel Silvertopstraat 5333,2023-03-17,16:00:00,389,268,121,FMN 03 Kolonel Silvertopstraat
651,Kolonel Silvertopstraat 5333,2023-03-17,17:00:00,363,245,118,FMN 03 Kolonel Silvertopstraat
651,Kolonel Silvertopstraat 5333,2023-03-17,18:00:00,303,194,109,FMN 03 Kolonel Silvertopstraat
651,Kolonel Silvertopstraat 5333,2023-03-17,19:00:00,227,165,62,FMN 03 Kolonel Silvertopstraat
651,Kolonel Silvertopstraat 5333,2023-03-17,20:00:00,166,108,58,FMN 03 Kolonel Silvertopstraat
651,Kolonel Silvertopstraat 5333,2023-03-17,21:00:00,118,77,41,FMN 03 Kolonel Silvertopstraat
651,Kolonel Silvertopstraat 5333,2023-03-17,22:00:00,125,65,60,FMN 03 Kolonel Silvertopstraat
651,Kolonel Silvertopstraat 5333,2023-03-17,23:00:00,103,44,59,FMN 03 Kolonel Silvertopstraat
651,Kolonel Silvertopstraat 5333,2023-03-18,00:00:00,115,61,54,FMN 03 Kolonel Silvertopstraat
651,Kolonel Silvertopstraat 5333,2023-03-18,01:00:00,46,22,24,FMN 03 Kolonel Silvertopstraat
651,Kolonel Silvertopstraat 5333,2023-03-18,02:00:00,42,10,32,FMN 03 Kolonel Silvertopstraat
651,Kolonel Silvertopstraat 5333,2023-03-18,03:00:00,21,8,13,FMN 03 Kolonel Silvertopstraat
651,Kolonel Silvertopstraat 5333,2023-03-18,04:00:00,32,14,18,FMN 03 Kolonel Silvertopstraat
651,Kolonel Silvertopstraat 5333,2023-03-18,05:00:00,37,19,18,FMN 03 Kolonel Silvertopstraat
651,Kolonel Silvertopstraat 5333,2023-03-18,06:00:00,30,26,4,FMN 03 Kolonel Silvertopstraat
651,Kolonel Silvertopstraat 5333,2023-03-18,07:00:00,46,36,10,FMN 03 Kolonel Silvertopstraat
651,Kolonel Silvertopstraat 5333,2023-03-18,08:00:00,83,69,14,FMN 03 Kolonel Silvertopstraat
651,Kolonel Silvertopstraat 5333,2023-03-18,09:00:00,174,139,35,FMN 03 Kolonel Silvertopstraat
651,Kolonel Silvertopstraat 5333,2023-03-18,10:00:00,171,134,37,FMN 03 Kolonel Silvertopstraat
651,Kolonel Silvertopstraat 5333,2023-03-18,11:00:00,180,134,46,FMN 03 Kolonel Silvertopstraat
651,Kolonel Silvertopstraat 5333,2023-03-18,12:00:00,174,130,44,FMN 03 Kolonel Silvertopstraat
651,Kolonel Silvertopstraat 5333,2023-03-18,13:00:00,191,135,56,FMN 03 Kolonel Silvertopstraat
651,Kolonel Silvertopstraat 5333,2023-03-18,14:00:00,206,151,55,FMN 03 Kolonel Silvertopstraat
651,Kolonel Silvertopstraat 5333,2023-03-18,15:00:00,187,122,65,FMN 03 Kolonel Silvertopstraat
651,Kolonel Silvertopstraat 5333,2023-03-18,16:00:00,198,125,73,FMN 03 Kolonel Silvertopstraat
651,Kolonel Silvertopstraat 5333,2023-03-18,17:00:00,197,134,63,FMN 03 Kolonel Silvertopstraat
651,Kolonel Silvertopstraat 5333,2023-03-18,18:00:00,166,103,63,FMN 03 Kolonel Silvertopstraat
651,Kolonel Silvertopstraat 5333,2023-03-18,19:00:00,126,82,44,FMN 03 Kolonel Silvertopstraat
651,Kolonel Silvertopstraat 5333,2023-03-18,20:00:00,139,80,59,FMN 03 Kolonel Silvertopstraat
651,Kolonel Silvertopstraat 5333,2023-03-18,21:00:00,103,68,35,FMN 03 Kolonel Silvertopstraat
651,Kolonel Silvertopstraat 5333,2023-03-18,22:00:00,101,58,43,FMN 03 Kolonel Silvertopstraat
651,Kolonel Silvertopstraat 5333,2023-03-18,23:00:00,60,24,36,FMN 03 Kolonel Silvertopstraat
651,Kolonel Silvertopstraat 5333,2023-03-19,00:00:00,48,21,27,FMN 03 Kolonel Silvertopstraat
651,Kolonel Silvertopstraat 5333,2023-03-19,01:00:00,37,16,21,FMN 03 Kolonel Silvertopstraat
651,Kolonel Silvertopstraat 5333,2023-03-19,02:00:00,29,4,25,FMN 03 Kolonel Silvertopstraat
651,Kolonel Silvertopstraat 5333,2023-03-19,03:00:00,21,9,12,FMN 03 Kolonel Silvertopstraat
651,Kolonel Silvertopstraat 5333,2023-03-19,04:00:00,27,17,10,FMN 03 Kolonel Silvertopstraat
651,Kolonel Silvertopstraat 5333,2023-03-19,05:00:00,25,12,13,FMN 03 Kolonel Silvertopstraat
651,Kolonel Silvertopstraat 5333,2023-03-19,06:00:00,51,36,15,FMN 03 Kolonel Silvertopstraat
651,Kolonel Silvertopstraat 5333,2023-03-19,07:00:00,27,21,6,FMN 03 Kolonel Silvertopstraat
651,Kolonel Silvertopstraat 5333,2023-03-19,08:00:00,49,40,9,FMN 03 Kolonel Silvertopstraat
651,Kolonel Silvertopstraat 5333,2023-03-19,09:00:00,106,89,17,FMN 03 Kolonel Silvertopstraat
651,Kolonel Silvertopstraat 5333,2023-03-19,10:00:00,125,96,29,FMN 03 Kolonel Silvertopstraat
651,Kolonel Silvertopstraat 5333,2023-03-19,11:00:00,128,99,29,FMN 03 Kolonel Silvertopstraat
651,Kolonel Silvertopstraat 5333,2023-03-19,12:00:00,119,89,30,FMN 03 Kolonel Silvertopstraat
651,Kolonel Silvertopstraat 5333,2023-03-19,13:00:00,141,108,33,FMN 03 Kolonel Silvertopstraat
651,Kolonel Silvertopstraat 5333,2023-03-19,14:00:00,174,128,46,FMN 03 Kolonel Silvertopstraat
651,Kolonel Silvertopstraat 5333,2023-03-19,15:00:00,144,89,55,FMN 03 Kolonel Silvertopstraat
651,Kolonel Silvertopstraat 5333,2023-03-19,16:00:00,154,117,37,FMN 03 Kolonel Silvertopstraat
651,Kolonel Silvertopstraat 5333,2023-03-19,17:00:00,154,91,63,FMN 03 Kolonel Silvertopstraat
651,Kolonel Silvertopstraat 5333,2023-03-19,18:00:00,136,70,66,FMN 03 Kolonel Silvertopstraat
651,Kolonel Silvertopstraat 5333,2023-03-19,19:00:00,108,70,38,FMN 03 Kolonel Silvertopstraat
651,Kolonel Silvertopstraat 5333,2023-03-19,20:00:00,92,44,48,FMN 03 Kolonel Silvertopstraat
651,Kolonel Silvertopstraat 5333,2023-03-19,21:00:00,75,39,36,FMN 03 Kolonel Silvertopstraat
651,Kolonel Silvertopstraat 5333,2023-03-19,22:00:00,65,33,32,FMN 03 Kolonel Silvertopstraat
651,Kolonel Silvertopstraat 5333,2023-03-19,23:00:00,36,19,17,FMN 03 Kolonel Silvertopstraat
651,Kolonel Silvertopstraat 5333,2023-03-20,00:00:00,10,6,4,FMN 03 Kolonel Silvertopstraat
651,Kolonel Silvertopstraat 5333,2023-03-20,01:00:00,14,4,10,FMN 03 Kolonel Silvertopstraat
651,Kolonel Silvertopstraat 5333,2023-03-20,02:00:00,7,2,5,FMN 03 Kolonel Silvertopstraat
651,Kolonel Silvertopstraat 5333,2023-03-20,03:00:00,10,5,5,FMN 03 Kolonel Silvertopstraat
651,Kolonel Silvertopstraat 5333,2023-03-20,04:00:00,31,23,8,FMN 03 Kolonel Silvertopstraat
651,Kolonel Silvertopstraat 5333,2023-03-20,05:00:00,61,41,20,FMN 03 Kolonel Silvertopstraat
651,Kolonel Silvertopstraat 5333,2023-03-20,06:00:00,127,104,23,FMN 03 Kolonel Silvertopstraat
651,Kolonel Silvertopstraat 5333,2023-03-20,07:00:00,340,289,51,FMN 03 Kolonel Silvertopstraat
651,Kolonel Silvertopstraat 5333,2023-03-20,08:00:00,623,539,84,FMN 03 Kolonel Silvertopstraat
651,Kolonel Silvertopstraat 5333,2023-03-20,09:00:00,197,157,40,FMN 03 Kolonel Silvertopstraat
651,Kolonel Silvertopstraat 5333,2023-03-20,10:00:00,142,110,32,FMN 03 Kolonel Silvertopstraat
651,Kolonel Silvertopstraat 5333,2023-03-20,11:00:00,137,107,30,FMN 03 Kolonel Silvertopstraat
651,Kolonel Silvertopstraat 5333,2023-03-20,12:00:00,228,167,61,FMN 03 Kolonel Silvertopstraat
651,Kolonel Silvertopstraat 5333,2023-03-20,13:00:00,167,115,52,FMN 03 Kolonel Silvertopstraat
651,Kolonel Silvertopstraat 5333,2023-03-20,14:00:00,191,131,60,FMN 03 Kolonel Silvertopstraat
651,Kolonel Silvertopstraat 5333,2023-03-20,15:00:00,237,145,92,FMN 03 Kolonel Silvertopstraat
651,Kolonel Silvertopstraat 5333,2023-03-20,16:00:00,379,237,142,FMN 03 Kolonel Silvertopstraat
651,Kolonel Silvertopstraat 5333,2023-03-20,17:00:00,386,230,156,FMN 03 Kolonel Silvertopstraat
651,Kolonel Silvertopstraat 5333,2023-03-20,18:00:00,243,146,97,FMN 03 Kolonel Silvertopstraat
651,Kolonel Silvertopstraat 5333,2023-03-20,19:00:00,149,91,58,FMN 03 Kolonel Silvertopstraat
651,Kolonel Silvertopstraat 5333,2023-03-20,20:00:00,137,83,54,FMN 03 Kolonel Silvertopstraat
651,Kolonel Silvertopstraat 5333,2023-03-20,21:00:00,97,64,33,FMN 03 Kolonel Silvertopstraat
651,Kolonel Silvertopstraat 5333,2023-03-20,22:00:00,85,49,36,FMN 03 Kolonel Silvertopstraat
651,Kolonel Silvertopstraat 5333,2023-03-20,23:00:00,48,25,23,FMN 03 Kolonel Silvertopstraat
651,Kolonel Silvertopstraat 5333,2023-03-21,00:00:00,27,12,15,FMN 03 Kolonel Silvertopstraat
651,Kolonel Silvertopstraat 5333,2023-03-21,01:00:00,11,5,6,FMN 03 Kolonel Silvertopstraat
651,Kolonel Silvertopstraat 5333,2023-03-21,02:00:00,8,3,5,FMN 03 Kolonel Silvertopstraat
651,Kolonel Silvertopstraat 5333,2023-03-21,03:00:00,6,4,2,FMN 03 Kolonel Silvertopstraat
651,Kolonel Silvertopstraat 5333,2023-03-21,04:00:00,33,24,9,FMN 03 Kolonel Silvertopstraat
651,Kolonel Silvertopstraat 5333,2023-03-21,05:00:00,54,37,17,FMN 03 Kolonel Silvertopstraat
651,Kolonel Silvertopstraat 5333,2023-03-21,06:00:00,132,111,21,FMN 03 Kolonel Silvertopstraat
651,Kolonel Silvertopstraat 5333,2023-03-21,07:00:00,344,299,45,FMN 03 Kolonel Silvertopstraat
651,Kolonel Silvertopstraat 5333,2023-03-21,08:00:00,599,510,89,FMN 03 Kolonel Silvertopstraat
651,Kolonel Silvertopstraat 5333,2023-03-21,09:00:00,206,166,40,FMN 03 Kolonel Silvertopstraat
651,Kolonel Silvertopstraat 5333,2023-03-21,10:00:00,146,111,35,FMN 03 Kolonel Silvertopstraat
651,Kolonel Silvertopstraat 5333,2023-03-21,11:00:00,155,118,37,FMN 03 Kolonel Silvertopstraat
651,Kolonel Silvertopstraat 5333,2023-03-21,12:00:00,236,168,68,FMN 03 Kolonel Silvertopstraat
651,Kolonel Silvertopstraat 5333,2023-03-21,13:00:00,182,142,40,FMN 03 Kolonel Silvertopstraat
651,Kolonel Silvertopstraat 5333,2023-03-21,14:00:00,198,136,62,FMN 03 Kolonel Silvertopstraat
651,Kolonel Silvertopstraat 5333,2023-03-21,15:00:00,289,170,119,FMN 03 Kolonel Silvertopstraat
651,Kolonel Silvertopstraat 5333,2023-03-21,16:00:00,338,221,117,FMN 03 Kolonel Silvertopstraat
651,Kolonel Silvertopstraat 5333,2023-03-21,17:00:00,346,230,116,FMN 03 Kolonel Silvertopstraat
651,Kolonel Silvertopstraat 5333,2023-03-21,18:00:00,312,207,105,FMN 03 Kolonel Silvertopstraat
651,Kolonel Silvertopstraat 5333,2023-03-21,19:00:00,179,121,58,FMN 03 Kolonel Silvertopstraat
651,Kolonel Silvertopstraat 5333,2023-03-21,20:00:00,120,78,42,FMN 03 Kolonel Silvertopstraat
651,Kolonel Silvertopstraat 5333,2023-03-21,21:00:00,123,70,53,FMN 03 Kolonel Silvertopstraat
651,Kolonel Silvertopstraat 5333,2023-03-21,22:00:00,99,54,45,FMN 03 Kolonel Silvertopstraat
651,Kolonel Silvertopstraat 5333,2023-03-21,23:00:00,50,27,23,FMN 03 Kolonel Silvertopstraat
651,Kolonel Silvertopstraat 5333,2023-03-22,00:00:00,34,17,17,FMN 03 Kolonel Silvertopstraat
651,Kolonel Silvertopstraat 5333,2023-03-22,01:00:00,20,7,13,FMN 03 Kolonel Silvertopstraat
651,Kolonel Silvertopstraat 5333,2023-03-22,02:00:00,9,5,4,FMN 03 Kolonel Silvertopstraat
651,Kolonel Silvertopstraat 5333,2023-03-22,03:00:00,7,3,4,FMN 03 Kolonel Silvertopstraat
651,Kolonel Silvertopstraat 5333,2023-03-22,04:00:00,31,22,9,FMN 03 Kolonel Silvertopstraat
651,Kolonel Silvertopstraat 5333,2023-03-22,05:00:00,52,35,17,FMN 03 Kolonel Silvertopstraat
651,Kolonel Silvertopstraat 5333,2023-03-22,06:00:00,142,115,27,FMN 03 Kolonel Silvertopstraat
651,Kolonel Silvertopstraat 5333,2023-03-22,07:00:00,283,233,50,FMN 03 Kolonel Silvertopstraat
651,Kolonel Silvertopstraat 5333,2023-03-22,08:00:00,567,478,89,FMN 03 Kolonel Silvertopstraat
651,Kolonel Silvertopstraat 5333,2023-03-22,09:00:00,192,144,48,FMN 03 Kolonel Silvertopstraat
651,Kolonel Silvertopstraat 5333,2023-03-22,10:00:00,137,101,36,FMN 03 Kolonel Silvertopstraat
651,Kolonel Silvertopstraat 5333,2023-03-22,11:00:00,143,100,43,FMN 03 Kolonel Silvertopstraat
651,Kolonel Silvertopstraat 5333,2023-03-22,12:00:00,298,191,107,FMN 03 Kolonel Silvertopstraat
651,Kolonel Silvertopstraat 5333,2023-03-22,13:00:00,212,130,82,FMN 03 Kolonel Silvertopstraat
651,Kolonel Silvertopstraat 5333,2023-03-22,14:00:00,155,90,65,FMN 03 Kolonel Silvertopstraat
651,Kolonel Silvertopstraat 5333,2023-03-22,15:00:00,183,119,64,FMN 03 Kolonel Silvertopstraat
651,Kolonel Silvertopstraat 5333,2023-03-22,16:00:00,220,154,66,FMN 03 Kolonel Silvertopstraat
651,Kolonel Silvertopstraat 5333,2023-03-22,17:00:00,276,184,92,FMN 03 Kolonel Silvertopstraat
651,Kolonel Silvertopstraat 5333,2023-03-22,18:00:00,230,144,86,FMN 03 Kolonel Silvertopstraat
651,Kolonel Silvertopstraat 5333,2023-03-22,19:00:00,145,91,54,FMN 03 Kolonel Silvertopstraat
651,Kolonel Silvertopstraat 5333,2023-03-22,20:00:00,102,67,35,FMN 03 Kolonel Silvertopstraat
651,Kolonel Silvertopstraat 5333,2023-03-22,21:00:00,92,48,44,FMN 03 Kolonel Silvertopstraat
651,Kolonel Silvertopstraat 5333,2023-03-22,22:00:00,106,53,53,FMN 03 Kolonel Silvertopstraat
651,Kolonel Silvertopstraat 5333,2023-03-22,23:00:00,52,22,30,FMN 03 Kolonel Silvertopstraat
651,Kolonel Silvertopstraat 5333,2023-03-23,00:00:00,24,11,13,FMN 03 Kolonel Silvertopstraat
651,Kolonel Silvertopstraat 5333,2023-03-23,01:00:00,17,9,8,FMN 03 Kolonel Silvertopstraat
651,Kolonel Silvertopstraat 5333,2023-03-23,02:00:00,11,5,6,FMN 03 Kolonel Silvertopstraat
651,Kolonel Silvertopstraat 5333,2023-03-23,03:00:00,10,5,5,FMN 03 Kolonel Silvertopstraat
651,Kolonel Silvertopstraat 5333,2023-03-23,04:00:00,20,17,3,FMN 03 Kolonel Silvertopstraat
651,Kolonel Silvertopstraat 5333,2023-03-23,05:00:00,55,32,23,FMN 03 Kolonel Silvertopstraat
651,Kolonel Silvertopstraat 5333,2023-03-23,06:00:00,118,93,25,FMN 03 Kolonel Silvertopstraat
651,Kolonel Silvertopstraat 5333,2023-03-23,07:00:00,272,224,48,FMN 03 Kolonel Silvertopstraat
651,Kolonel Silvertopstraat 5333,2023-03-23,08:00:00,499,420,79,FMN 03 Kolonel Silvertopstraat
651,Kolonel Silvertopstraat 5333,2023-03-23,09:00:00,193,153,40,FMN 03 Kolonel Silvertopstraat
651,Kolonel Silvertopstraat 5333,2023-03-23,10:00:00,177,138,39,FMN 03 Kolonel Silvertopstraat
651,Kolonel Silvertopstraat 5333,2023-03-23,11:00:00,137,110,27,FMN 03 Kolonel Silvertopstraat
651,Kolonel Silvertopstraat 5333,2023-03-23,12:00:00,200,145,55,FMN 03 Kolonel Silvertopstraat
651,Kolonel Silvertopstraat 5333,2023-03-23,13:00:00,172,124,48,FMN 03 Kolonel Silvertopstraat
651,Kolonel Silvertopstraat 5333,2023-03-23,14:00:00,163,103,60,FMN 03 Kolonel Silvertopstraat
651,Kolonel Silvertopstraat 5333,2023-03-23,15:00:00,249,150,99,FMN 03 Kolonel Silvertopstraat
651,Kolonel Silvertopstraat 5333,2023-03-23,16:00:00,313,191,122,FMN 03 Kolonel Silvertopstraat
651,Kolonel Silvertopstraat 5333,2023-03-23,17:00:00,327,205,122,FMN 03 Kolonel Silvertopstraat
651,Kolonel Silvertopstraat 5333,2023-03-23,18:00:00,258,161,97,FMN 03 Kolonel Silvertopstraat
651,Kolonel Silvertopstraat 5333,2023-03-23,19:00:00,163,110,53,FMN 03 Kolonel Silvertopstraat
651,Kolonel Silvertopstraat 5333,2023-03-23,20:00:00,116,65,51,FMN 03 Kolonel Silvertopstraat
651,Kolonel Silvertopstraat 5333,2023-03-23,21:00:00,91,57,34,FMN 03 Kolonel Silvertopstraat
651,Kolonel Silvertopstraat 5333,2023-03-23,22:00:00,95,52,43,FMN 03 Kolonel Silvertopstraat
651,Kolonel Silvertopstraat 5333,2023-03-23,23:00:00,63,26,37,FMN 03 Kolonel Silvertopstraat
651,Kolonel Silvertopstraat 5333,2023-03-24,00:00:00,32,17,15,FMN 03 Kolonel Silvertopstraat
651,Kolonel Silvertopstraat 5333,2023-03-24,01:00:00,17,6,11,FMN 03 Kolonel Silvertopstraat
651,Kolonel Silvertopstraat 5333,2023-03-24,02:00:00,20,6,14,FMN 03 Kolonel Silvertopstraat
651,Kolonel Silvertopstraat 5333,2023-03-24,03:00:00,8,1,7,FMN 03 Kolonel Silvertopstraat
651,Kolonel Silvertopstraat 5333,2023-03-24,04:00:00,26,22,4,FMN 03 Kolonel Silvertopstraat
651,Kolonel Silvertopstraat 5333,2023-03-24,05:00:00,54,32,22,FMN 03 Kolonel Silvertopstraat
651,Kolonel Silvertopstraat 5333,2023-03-24,06:00:00,108,88,20,FMN 03 Kolonel Silvertopstraat
651,Kolonel Silvertopstraat 5333,2023-03-24,07:00:00,293,245,48,FMN 03 Kolonel Silvertopstraat
651,Kolonel Silvertopstraat 5333,2023-03-24,08:00:00,555,472,83,FMN 03 Kolonel Silvertopstraat
651,Kolonel Silvertopstraat 5333,2023-03-24,09:00:00,183,139,44,FMN 03 Kolonel Silvertopstraat
651,Kolonel Silvertopstraat 5333,2023-03-24,10:00:00,175,131,44,FMN 03 Kolonel Silvertopstraat
651,Kolonel Silvertopstraat 5333,2023-03-24,11:00:00,132,86,46,FMN 03 Kolonel Silvertopstraat
651,Kolonel Silvertopstraat 5333,2023-03-24,12:00:00,193,122,71,FMN 03 Kolonel Silvertopstraat
651,Kolonel Silvertopstraat 5333,2023-03-24,13:00:00,206,142,64,FMN 03 Kolonel Silvertopstraat
651,Kolonel Silvertopstraat 5333,2023-03-24,14:00:00,193,133,60,FMN 03 Kolonel Silvertopstraat
651,Kolonel Silvertopstraat 5333,2023-03-24,15:00:00,280,166,114,FMN 03 Kolonel Silvertopstraat
651,Kolonel Silvertopstraat 5333,2023-03-24,16:00:00,287,183,104,FMN 03 Kolonel Silvertopstraat
651,Kolonel Silvertopstraat 5333,2023-03-24,17:00:00,298,191,107,FMN 03 Kolonel Silvertopstraat
651,Kolonel Silvertopstraat 5333,2023-03-24,18:00:00,241,154,87,FMN 03 Kolonel Silvertopstraat
651,Kolonel Silvertopstraat 5333,2023-03-24,19:00:00,176,127,49,FMN 03 Kolonel Silvertopstraat
651,Kolonel Silvertopstraat 5333,2023-03-24,20:00:00,146,91,55,FMN 03 Kolonel Silvertopstraat
651,Kolonel Silvertopstraat 5333,2023-03-24,21:00:00,90,62,28,FMN 03 Kolonel Silvertopstraat
651,Kolonel Silvertopstraat 5333,2023-03-24,22:00:00,96,62,34,FMN 03 Kolonel Silvertopstraat
651,Kolonel Silvertopstraat 5333,2023-03-24,23:00:00,81,41,40,FMN 03 Kolonel Silvertopstraat
651,Kolonel Silvertopstraat 5333,2023-03-25,00:00:00,63,30,33,FMN 03 Kolonel Silvertopstraat
651,Kolonel Silvertopstraat 5333,2023-03-25,01:00:00,48,21,27,FMN 03 Kolonel Silvertopstraat
651,Kolonel Silvertopstraat 5333,2023-03-25,02:00:00,22,9,13,FMN 03 Kolonel Silvertopstraat
651,Kolonel Silvertopstraat 5333,2023-03-25,03:00:00,19,6,13,FMN 03 Kolonel Silvertopstraat
651,Kolonel Silvertopstraat 5333,2023-03-25,04:00:00,23,6,17,FMN 03 Kolonel Silvertopstraat
651,Kolonel Silvertopstraat 5333,2023-03-25,05:00:00,16,6,10,FMN 03 Kolonel Silvertopstraat
651,Kolonel Silvertopstraat 5333,2023-03-25,06:00:00,33,27,6,FMN 03 Kolonel Silvertopstraat
651,Kolonel Silvertopstraat 5333,2023-03-25,07:00:00,29,24,5,FMN 03 Kolonel Silvertopstraat
651,Kolonel Silvertopstraat 5333,2023-03-25,08:00:00,61,46,15,FMN 03 Kolonel Silvertopstraat
651,Kolonel Silvertopstraat 5333,2023-03-25,09:00:00,108,88,20,FMN 03 Kolonel Silvertopstraat
651,Kolonel Silvertopstraat 5333,2023-03-25,10:00:00,114,91,23,FMN 03 Kolonel Silvertopstraat
651,Kolonel Silvertopstraat 5333,2023-03-25,11:00:00,115,74,41,FMN 03 Kolonel Silvertopstraat
651,Kolonel Silvertopstraat 5333,2023-03-25,12:00:00,112,73,39,FMN 03 Kolonel Silvertopstraat
651,Kolonel Silvertopstraat 5333,2023-03-25,13:00:00,131,96,35,FMN 03 Kolonel Silvertopstraat
651,Kolonel Silvertopstraat 5333,2023-03-25,14:00:00,140,89,51,FMN 03 Kolonel Silvertopstraat
651,Kolonel Silvertopstraat 5333,2023-03-25,15:00:00,126,80,46,FMN 03 Kolonel Silvertopstraat
651,Kolonel Silvertopstraat 5333,2023-03-25,16:00:00,133,94,39,FMN 03 Kolonel Silvertopstraat
651,Kolonel Silvertopstraat 5333,2023-03-25,17:00:00,136,100,36,FMN 03 Kolonel Silvertopstraat
651,Kolonel Silvertopstraat 5333,2023-03-25,18:00:00,173,115,58,FMN 03 Kolonel Silvertopstraat
651,Kolonel Silvertopstraat 5333,2023-03-25,19:00:00,129,90,39,FMN 03 Kolonel Silvertopstraat
651,Kolonel Silvertopstraat 5333,2023-03-25,20:00:00,96,63,33,FMN 03 Kolonel Silvertopstraat
651,Kolonel Silvertopstraat 5333,2023-03-25,21:00:00,73,44,29,FMN 03 Kolonel Silvertopstraat
651,Kolonel Silvertopstraat 5333,2023-03-25,22:00:00,60,33,27,FMN 03 Kolonel Silvertopstraat
651,Kolonel Silvertopstraat 5333,2023-03-25,23:00:00,55,27,28,FMN 03 Kolonel Silvertopstraat
651,Kolonel Silvertopstraat 5333,2023-03-26,00:00:00,54,19,35,FMN 03 Kolonel Silvertopstraat
651,Kolonel Silvertopstraat 5333,2023-03-26,01:00:00,41,18,23,FMN 03 Kolonel Silvertopstraat
651,Kolonel Silvertopstraat 5333,2023-03-26,02:00:00,0,0,0,FMN 03 Kolonel Silvertopstraat
651,Kolonel Silvertopstraat 5333,2023-03-26,03:00:00,27,11,16,FMN 03 Kolonel Silvertopstraat
651,Kolonel Silvertopstraat 5333,2023-03-26,04:00:00,27,12,15,FMN 03 Kolonel Silvertopstraat
651,Kolonel Silvertopstraat 5333,2023-03-26,05:00:00,18,15,3,FMN 03 Kolonel Silvertopstraat
651,Kolonel Silvertopstraat 5333,2023-03-26,06:00:00,26,15,11,FMN 03 Kolonel Silvertopstraat
651,Kolonel Silvertopstraat 5333,2023-03-26,07:00:00,12,9,3,FMN 03 Kolonel Silvertopstraat
651,Kolonel Silvertopstraat 5333,2023-03-26,08:00:00,28,22,6,FMN 03 Kolonel Silvertopstraat
651,Kolonel Silvertopstraat 5333,2023-03-26,09:00:00,32,26,6,FMN 03 Kolonel Silvertopstraat
651,Kolonel Silvertopstraat 5333,2023-03-26,10:00:00,42,30,12,FMN 03 Kolonel Silvertopstraat
651,Kolonel Silvertopstraat 5333,2023-03-26,11:00:00,45,37,8,FMN 03 Kolonel Silvertopstraat
651,Kolonel Silvertopstraat 5333,2023-03-26,12:00:00,59,49,10,FMN 03 Kolonel Silvertopstraat
651,Kolonel Silvertopstraat 5333,2023-03-26,13:00:00,71,49,22,FMN 03 Kolonel Silvertopstraat
651,Kolonel Silvertopstraat 5333,2023-03-26,14:00:00,104,72,32,FMN 03 Kolonel Silvertopstraat
651,Kolonel Silvertopstraat 5333,2023-03-26,15:00:00,107,74,33,FMN 03 Kolonel Silvertopstraat
651,Kolonel Silvertopstraat 5333,2023-03-26,16:00:00,82,54,28,FMN 03 Kolonel Silvertopstraat
651,Kolonel Silvertopstraat 5333,2023-03-26,17:00:00,103,63,40,FMN 03 Kolonel Silvertopstraat
651,Kolonel Silvertopstraat 5333,2023-03-26,18:00:00,100,63,37,FMN 03 Kolonel Silvertopstraat
651,Kolonel Silvertopstraat 5333,2023-03-26,19:00:00,114,72,42,FMN 03 Kolonel Silvertopstraat
651,Kolonel Silvertopstraat 5333,2023-03-26,20:00:00,69,37,32,FMN 03 Kolonel Silvertopstraat
651,Kolonel Silvertopstraat 5333,2023-03-26,21:00:00,91,52,39,FMN 03 Kolonel Silvertopstraat
651,Kolonel Silvertopstraat 5333,2023-03-26,22:00:00,61,38,23,FMN 03 Kolonel Silvertopstraat
651,Kolonel Silvertopstraat 5333,2023-03-26,23:00:00,46,28,18,FMN 03 Kolonel Silvertopstraat
651,Kolonel Silvertopstraat 5333,2023-03-27,00:00:00,29,15,14,FMN 03 Kolonel Silvertopstraat
651,Kolonel Silvertopstraat 5333,2023-03-27,01:00:00,15,7,8,FMN 03 Kolonel Silvertopstraat
651,Kolonel Silvertopstraat 5333,2023-03-27,02:00:00,12,6,6,FMN 03 Kolonel Silvertopstraat
651,Kolonel Silvertopstraat 5333,2023-03-27,03:00:00,7,4,3,FMN 03 Kolonel Silvertopstraat
651,Kolonel Silvertopstraat 5333,2023-03-27,04:00:00,12,7,5,FMN 03 Kolonel Silvertopstraat
651,Kolonel Silvertopstraat 5333,2023-03-27,05:00:00,53,34,19,FMN 03 Kolonel Silvertopstraat
651,Kolonel Silvertopstraat 5333,2023-03-27,06:00:00,104,86,18,FMN 03 Kolonel Silvertopstraat
651,Kolonel Silvertopstraat 5333,2023-03-27,07:00:00,278,222,56,FMN 03 Kolonel Silvertopstraat
651,Kolonel Silvertopstraat 5333,2023-03-27,08:00:00,594,496,98,FMN 03 Kolonel Silvertopstraat
651,Kolonel Silvertopstraat 5333,2023-03-27,09:00:00,175,144,31,FMN 03 Kolonel Silvertopstraat
651,Kolonel Silvertopstraat 5333,2023-03-27,10:00:00,147,116,31,FMN 03 Kolonel Silvertopstraat
651,Kolonel Silvertopstraat 5333,2023-03-27,11:00:00,137,98,39,FMN 03 Kolonel Silvertopstraat
651,Kolonel Silvertopstraat 5333,2023-03-27,12:00:00,177,116,61,FMN 03 Kolonel Silvertopstraat
651,Kolonel Silvertopstraat 5333,2023-03-27,13:00:00,161,105,56,FMN 03 Kolonel Silvertopstraat
651,Kolonel Silvertopstraat 5333,2023-03-27,14:00:00,177,114,63,FMN 03 Kolonel Silvertopstraat
651,Kolonel Silvertopstraat 5333,2023-03-27,15:00:00,245,167,78,FMN 03 Kolonel Silvertopstraat
651,Kolonel Silvertopstraat 5333,2023-03-27,16:00:00,329,216,113,FMN 03 Kolonel Silvertopstraat
651,Kolonel Silvertopstraat 5333,2023-03-27,17:00:00,346,221,125,FMN 03 Kolonel Silvertopstraat
651,Kolonel Silvertopstraat 5333,2023-03-27,18:00:00,249,152,97,FMN 03 Kolonel Silvertopstraat
651,Kolonel Silvertopstraat 5333,2023-03-27,19:00:00,183,113,70,FMN 03 Kolonel Silvertopstraat
651,Kolonel Silvertopstraat 5333,2023-03-27,20:00:00,116,53,63,FMN 03 Kolonel Silvertopstraat
651,Kolonel Silvertopstraat 5333,2023-03-27,21:00:00,127,78,49,FMN 03 Kolonel Silvertopstraat
651,Kolonel Silvertopstraat 5333,2023-03-27,22:00:00,83,47,36,FMN 03 Kolonel Silvertopstraat
651,Kolonel Silvertopstraat 5333,2023-03-27,23:00:00,61,32,29,FMN 03 Kolonel Silvertopstraat
651,Kolonel Silvertopstraat 5333,2023-03-28,00:00:00,36,14,22,FMN 03 Kolonel Silvertopstraat
651,Kolonel Silvertopstraat 5333,2023-03-28,01:00:00,17,3,14,FMN 03 Kolonel Silvertopstraat
651,Kolonel Silvertopstraat 5333,2023-03-28,02:00:00,11,3,8,FMN 03 Kolonel Silvertopstraat
651,Kolonel Silvertopstraat 5333,2023-03-28,03:00:00,8,4,4,FMN 03 Kolonel Silvertopstraat
651,Kolonel Silvertopstraat 5333,2023-03-28,04:00:00,17,13,4,FMN 03 Kolonel Silvertopstraat
651,Kolonel Silvertopstraat 5333,2023-03-28,05:00:00,56,34,22,FMN 03 Kolonel Silvertopstraat
651,Kolonel Silvertopstraat 5333,2023-03-28,06:00:00,124,98,26,FMN 03 Kolonel Silvertopstraat
651,Kolonel Silvertopstraat 5333,2023-03-28,07:00:00,297,244,53,FMN 03 Kolonel Silvertopstraat
651,Kolonel Silvertopstraat 5333,2023-03-28,08:00:00,547,474,73,FMN 03 Kolonel Silvertopstraat
651,Kolonel Silvertopstraat 5333,2023-03-28,09:00:00,204,161,43,FMN 03 Kolonel Silvertopstraat
651,Kolonel Silvertopstraat 5333,2023-03-28,10:00:00,150,119,31,FMN 03 Kolonel Silvertopstraat
651,Kolonel Silvertopstraat 5333,2023-03-28,11:00:00,140,110,30,FMN 03 Kolonel Silvertopstraat
651,Kolonel Silvertopstraat 5333,2023-03-28,12:00:00,198,139,59,FMN 03 Kolonel Silvertopstraat
651,Kolonel Silvertopstraat 5333,2023-03-28,13:00:00,178,122,56,FMN 03 Kolonel Silvertopstraat
651,Kolonel Silvertopstraat 5333,2023-03-28,14:00:00,187,120,67,FMN 03 Kolonel Silvertopstraat
651,Kolonel Silvertopstraat 5333,2023-03-28,15:00:00,254,164,90,FMN 03 Kolonel Silvertopstraat
651,Kolonel Silvertopstraat 5333,2023-03-28,16:00:00,342,217,125,FMN 03 Kolonel Silvertopstraat
651,Kolonel Silvertopstraat 5333,2023-03-28,17:00:00,348,213,135,FMN 03 Kolonel Silvertopstraat
651,Kolonel Silvertopstraat 5333,2023-03-28,18:00:00,295,183,112,FMN 03 Kolonel Silvertopstraat
651,Kolonel Silvertopstraat 5333,2023-03-28,19:00:00,141,86,55,FMN 03 Kolonel Silvertopstraat
651,Kolonel Silvertopstraat 5333,2023-03-28,20:00:00,99,57,42,FMN 03 Kolonel Silvertopstraat
651,Kolonel Silvertopstraat 5333,2023-03-28,21:00:00,88,48,40,FMN 03 Kolonel Silvertopstraat
651,Kolonel Silvertopstraat 5333,2023-03-28,22:00:00,96,48,48,FMN 03 Kolonel Silvertopstraat
651,Kolonel Silvertopstraat 5333,2023-03-28,23:00:00,46,24,22,FMN 03 Kolonel Silvertopstraat
651,Kolonel Silvertopstraat 5333,2023-03-29,00:00:00,27,10,17,FMN 03 Kolonel Silvertopstraat
651,Kolonel Silvertopstraat 5333,2023-03-29,01:00:00,11,5,6,FMN 03 Kolonel Silvertopstraat
651,Kolonel Silvertopstraat 5333,2023-03-29,02:00:00,13,7,6,FMN 03 Kolonel Silvertopstraat
651,Kolonel Silvertopstraat 5333,2023-03-29,03:00:00,8,1,7,FMN 03 Kolonel Silvertopstraat
651,Kolonel Silvertopstraat 5333,2023-03-29,04:00:00,22,17,5,FMN 03 Kolonel Silvertopstraat
651,Kolonel Silvertopstraat 5333,2023-03-29,05:00:00,44,26,18,FMN 03 Kolonel Silvertopstraat
651,Kolonel Silvertopstraat 5333,2023-03-29,06:00:00,121,94,27,FMN 03 Kolonel Silvertopstraat
651,Kolonel Silvertopstraat 5333,2023-03-29,07:00:00,272,217,55,FMN 03 Kolonel Silvertopstraat
651,Kolonel Silvertopstraat 5333,2023-03-29,08:00:00,499,414,85,FMN 03 Kolonel Silvertopstraat
651,Kolonel Silvertopstraat 5333,2023-03-29,09:00:00,198,160,38,FMN 03 Kolonel Silvertopstraat
651,Kolonel Silvertopstraat 5333,2023-03-29,10:00:00,125,91,34,FMN 03 Kolonel Silvertopstraat
651,Kolonel Silvertopstraat 5333,2023-03-29,11:00:00,149,114,35,FMN 03 Kolonel Silvertopstraat
651,Kolonel Silvertopstraat 5333,2023-03-29,12:00:00,291,182,109,FMN 03 Kolonel Silvertopstraat
651,Kolonel Silvertopstraat 5333,2023-03-29,13:00:00,243,164,79,FMN 03 Kolonel Silvertopstraat
651,Kolonel Silvertopstraat 5333,2023-03-29,14:00:00,174,128,46,FMN 03 Kolonel Silvertopstraat
651,Kolonel Silvertopstraat 5333,2023-03-29,15:00:00,223,146,77,FMN 03 Kolonel Silvertopstraat
651,Kolonel Silvertopstraat 5333,2023-03-29,16:00:00,298,195,103,FMN 03 Kolonel Silvertopstraat
651,Kolonel Silvertopstraat 5333,2023-03-29,17:00:00,324,215,109,FMN 03 Kolonel Silvertopstraat
651,Kolonel Silvertopstraat 5333,2023-03-29,18:00:00,306,199,107,FMN 03 Kolonel Silvertopstraat
651,Kolonel Silvertopstraat 5333,2023-03-29,19:00:00,199,129,70,FMN 03 Kolonel Silvertopstraat
651,Kolonel Silvertopstraat 5333,2023-03-29,20:00:00,146,90,56,FMN 03 Kolonel Silvertopstraat
651,Kolonel Silvertopstraat 5333,2023-03-29,21:00:00,126,77,49,FMN 03 Kolonel Silvertopstraat
651,Kolonel Silvertopstraat 5333,2023-03-29,22:00:00,116,67,49,FMN 03 Kolonel Silvertopstraat
651,Kolonel Silvertopstraat 5333,2023-03-29,23:00:00,69,31,38,FMN 03 Kolonel Silvertopstraat
651,Kolonel Silvertopstraat 5333,2023-03-30,00:00:00,28,11,17,FMN 03 Kolonel Silvertopstraat
651,Kolonel Silvertopstraat 5333,2023-03-30,01:00:00,30,7,23,FMN 03 Kolonel Silvertopstraat
651,Kolonel Silvertopstraat 5333,2023-03-30,02:00:00,13,5,8,FMN 03 Kolonel Silvertopstraat
651,Kolonel Silvertopstraat 5333,2023-03-30,03:00:00,11,5,6,FMN 03 Kolonel Silvertopstraat
651,Kolonel Silvertopstraat 5333,2023-03-30,04:00:00,20,12,8,FMN 03 Kolonel Silvertopstraat
651,Kolonel Silvertopstraat 5333,2023-03-30,05:00:00,43,24,19,FMN 03 Kolonel Silvertopstraat
651,Kolonel Silvertopstraat 5333,2023-03-30,06:00:00,120,95,25,FMN 03 Kolonel Silvertopstraat
651,Kolonel Silvertopstraat 5333,2023-03-30,07:00:00,277,225,52,FMN 03 Kolonel Silvertopstraat
651,Kolonel Silvertopstraat 5333,2023-03-30,08:00:00,576,492,84,FMN 03 Kolonel Silvertopstraat
651,Kolonel Silvertopstraat 5333,2023-03-30,09:00:00,214,170,44,FMN 03 Kolonel Silvertopstraat
651,Kolonel Silvertopstraat 5333,2023-03-30,10:00:00,151,117,34,FMN 03 Kolonel Silvertopstraat
651,Kolonel Silvertopstraat 5333,2023-03-30,11:00:00,166,122,44,FMN 03 Kolonel Silvertopstraat
651,Kolonel Silvertopstraat 5333,2023-03-30,12:00:00,188,140,48,FMN 03 Kolonel Silvertopstraat
651,Kolonel Silvertopstraat 5333,2023-03-30,13:00:00,172,129,43,FMN 03 Kolonel Silvertopstraat
651,Kolonel Silvertopstraat 5333,2023-03-30,14:00:00,190,117,73,FMN 03 Kolonel Silvertopstraat
651,Kolonel Silvertopstraat 5333,2023-03-30,15:00:00,259,164,95,FMN 03 Kolonel Silvertopstraat
651,Kolonel Silvertopstraat 5333,2023-03-30,16:00:00,325,217,108,FMN 03 Kolonel Silvertopstraat
651,Kolonel Silvertopstraat 5333,2023-03-30,17:00:00,313,199,114,FMN 03 Kolonel Silvertopstraat
651,Kolonel Silvertopstraat 5333,2023-03-30,18:00:00,255,161,94,FMN 03 Kolonel Silvertopstraat
651,Kolonel Silvertopstraat 5333,2023-03-30,19:00:00,235,158,77,FMN 03 Kolonel Silvertopstraat
651,Kolonel Silvertopstraat 5333,2023-03-30,20:00:00,146,81,65,FMN 03 Kolonel Silvertopstraat
651,Kolonel Silvertopstraat 5333,2023-03-30,21:00:00,125,68,57,FMN 03 Kolonel Silvertopstraat
651,Kolonel Silvertopstraat 5333,2023-03-30,22:00:00,125,70,55,FMN 03 Kolonel Silvertopstraat
651,Kolonel Silvertopstraat 5333,2023-03-30,23:00:00,80,41,39,FMN 03 Kolonel Silvertopstraat
651,Kolonel Silvertopstraat 5333,2023-03-31,00:00:00,50,17,33,FMN 03 Kolonel Silvertopstraat
651,Kolonel Silvertopstraat 5333,2023-03-31,01:00:00,37,13,24,FMN 03 Kolonel Silvertopstraat
651,Kolonel Silvertopstraat 5333,2023-03-31,02:00:00,11,7,4,FMN 03 Kolonel Silvertopstraat
651,Kolonel Silvertopstraat 5333,2023-03-31,03:00:00,9,4,5,FMN 03 Kolonel Silvertopstraat
651,Kolonel Silvertopstraat 5333,2023-03-31,04:00:00,20,14,6,FMN 03 Kolonel Silvertopstraat
651,Kolonel Silvertopstraat 5333,2023-03-31,05:00:00,40,25,15,FMN 03 Kolonel Silvertopstraat
651,Kolonel Silvertopstraat 5333,2023-03-31,06:00:00,66,52,14,FMN 03 Kolonel Silvertopstraat
651,Kolonel Silvertopstraat 5333,2023-03-31,07:00:00,178,148,30,FMN 03 Kolonel Silvertopstraat
651,Kolonel Silvertopstraat 5333,2023-03-31,08:00:00,354,293,61,FMN 03 Kolonel Silvertopstraat
651,Kolonel Silvertopstraat 5333,2023-03-31,09:00:00,173,150,23,FMN 03 Kolonel Silvertopstraat
651,Kolonel Silvertopstraat 5333,2023-03-31,10:00:00,136,103,33,FMN 03 Kolonel Silvertopstraat
651,Kolonel Silvertopstraat 5333,2023-03-31,11:00:00,157,108,49,FMN 03 Kolonel Silvertopstraat
651,Kolonel Silvertopstraat 5333,2023-03-31,12:00:00,164,105,59,FMN 03 Kolonel Silvertopstraat
651,Kolonel Silvertopstraat 5333,2023-03-31,13:00:00,158,104,54,FMN 03 Kolonel Silvertopstraat
651,Kolonel Silvertopstraat 5333,2023-03-31,14:00:00,146,96,50,FMN 03 Kolonel Silvertopstraat
651,Kolonel Silvertopstraat 5333,2023-03-31,15:00:00,198,124,74,FMN 03 Kolonel Silvertopstraat
651,Kolonel Silvertopstraat 5333,2023-03-31,16:00:00,225,143,82,FMN 03 Kolonel Silvertopstraat
651,Kolonel Silvertopstraat 5333,2023-03-31,17:00:00,202,133,69,FMN 03 Kolonel Silvertopstraat
651,Kolonel Silvertopstraat 5333,2023-03-31,18:00:00,217,144,73,FMN 03 Kolonel Silvertopstraat
651,Kolonel Silvertopstraat 5333,2023-03-31,19:00:00,159,106,53,FMN 03 Kolonel Silvertopstraat
651,Kolonel Silvertopstraat 5333,2023-03-31,20:00:00,100,67,33,FMN 03 Kolonel Silvertopstraat
651,Kolonel Silvertopstraat 5333,2023-03-31,21:00:00,102,62,40,FMN 03 Kolonel Silvertopstraat
651,Kolonel Silvertopstraat 5333,2023-03-31,22:00:00,78,38,40,FMN 03 Kolonel Silvertopstraat
651,Kolonel Silvertopstraat 5333,2023-03-31,23:00:00,69,28,41,FMN 03 Kolonel Silvertopstraat
651,Kolonel Silvertopstraat 5333,2023-04-01,00:00:00,45,12,33,FMN 03 Kolonel Silvertopstraat
651,Kolonel Silvertopstraat 5333,2023-04-01,01:00:00,33,12,21,FMN 03 Kolonel Silvertopstraat
651,Kolonel Silvertopstraat 5333,2023-04-01,02:00:00,21,6,15,FMN 03 Kolonel Silvertopstraat
651,Kolonel Silvertopstraat 5333,2023-04-01,03:00:00,21,10,11,FMN 03 Kolonel Silvertopstraat
651,Kolonel Silvertopstraat 5333,2023-04-01,04:00:00,17,8,9,FMN 03 Kolonel Silvertopstraat
651,Kolonel Silvertopstraat 5333,2023-04-01,05:00:00,23,11,12,FMN 03 Kolonel Silvertopstraat
651,Kolonel Silvertopstraat 5333,2023-04-01,06:00:00,25,24,1,FMN 03 Kolonel Silvertopstraat
651,Kolonel Silvertopstraat 5333,2023-04-01,07:00:00,21,16,5,FMN 03 Kolonel Silvertopstraat
651,Kolonel Silvertopstraat 5333,2023-04-01,08:00:00,37,32,5,FMN 03 Kolonel Silvertopstraat
651,Kolonel Silvertopstraat 5333,2023-04-01,09:00:00,61,50,11,FMN 03 Kolonel Silvertopstraat
651,Kolonel Silvertopstraat 5333,2023-04-01,10:00:00,81,66,15,FMN 03 Kolonel Silvertopstraat
651,Kolonel Silvertopstraat 5333,2023-04-01,11:00:00,73,54,19,FMN 03 Kolonel Silvertopstraat
651,Kolonel Silvertopstraat 5333,2023-04-01,12:00:00,77,57,20,FMN 03 Kolonel Silvertopstraat
651,Kolonel Silvertopstraat 5333,2023-04-01,13:00:00,90,63,27,FMN 03 Kolonel Silvertopstraat
651,Kolonel Silvertopstraat 5333,2023-04-01,14:00:00,83,61,22,FMN 03 Kolonel Silvertopstraat
651,Kolonel Silvertopstraat 5333,2023-04-01,15:00:00,83,60,23,FMN 03 Kolonel Silvertopstraat
651,Kolonel Silvertopstraat 5333,2023-04-01,16:00:00,83,51,32,FMN 03 Kolonel Silvertopstraat
651,Kolonel Silvertopstraat 5333,2023-04-01,17:00:00,115,75,40,FMN 03 Kolonel Silvertopstraat
651,Kolonel Silvertopstraat 5333,2023-04-01,18:00:00,135,89,46,FMN 03 Kolonel Silvertopstraat
651,Kolonel Silvertopstraat 5333,2023-04-01,19:00:00,106,66,40,FMN 03 Kolonel Silvertopstraat
651,Kolonel Silvertopstraat 5333,2023-04-01,20:00:00,88,58,30,FMN 03 Kolonel Silvertopstraat
651,Kolonel Silvertopstraat 5333,2023-04-01,21:00:00,78,52,26,FMN 03 Kolonel Silvertopstraat
651,Kolonel Silvertopstraat 5333,2023-04-01,22:00:00,62,35,27,FMN 03 Kolonel Silvertopstraat
651,Kolonel Silvertopstraat 5333,2023-04-01,23:00:00,58,28,30,FMN 03 Kolonel Silvertopstraat
651,Kolonel Silvertopstraat 5333,2023-04-02,00:00:00,33,11,22,FMN 03 Kolonel Silvertopstraat
651,Kolonel Silvertopstraat 5333,2023-04-02,01:00:00,42,19,23,FMN 03 Kolonel Silvertopstraat
651,Kolonel Silvertopstraat 5333,2023-04-02,02:00:00,25,12,13,FMN 03 Kolonel Silvertopstraat
651,Kolonel Silvertopstraat 5333,2023-04-02,03:00:00,29,13,16,FMN 03 Kolonel Silvertopstraat
651,Kolonel Silvertopstraat 5333,2023-04-02,04:00:00,26,10,16,FMN 03 Kolonel Silvertopstraat
651,Kolonel Silvertopstraat 5333,2023-04-02,05:00:00,34,27,7,FMN 03 Kolonel Silvertopstraat
651,Kolonel Silvertopstraat 5333,2023-04-02,06:00:00,37,28,9,FMN 03 Kolonel Silvertopstraat
651,Kolonel Silvertopstraat 5333,2023-04-02,07:00:00,11,9,2,FMN 03 Kolonel Silvertopstraat
651,Kolonel Silvertopstraat 5333,2023-04-02,08:00:00,41,33,8,FMN 03 Kolonel Silvertopstraat
651,Kolonel Silvertopstraat 5333,2023-04-02,09:00:00,74,59,15,FMN 03 Kolonel Silvertopstraat
651,Kolonel Silvertopstraat 5333,2023-04-02,10:00:00,89,72,17,FMN 03 Kolonel Silvertopstraat
651,Kolonel Silvertopstraat 5333,2023-04-02,11:00:00,110,90,20,FMN 03 Kolonel Silvertopstraat
651,Kolonel Silvertopstraat 5333,2023-04-02,12:00:00,136,94,42,FMN 03 Kolonel Silvertopstraat
651,Kolonel Silvertopstraat 5333,2023-04-02,13:00:00,141,103,38,FMN 03 Kolonel Silvertopstraat
651,Kolonel Silvertopstraat 5333,2023-04-02,14:00:00,163,124,39,FMN 03 Kolonel Silvertopstraat
651,Kolonel Silvertopstraat 5333,2023-04-02,15:00:00,116,58,58,FMN 03 Kolonel Silvertopstraat
651,Kolonel Silvertopstraat 5333,2023-04-02,16:00:00,108,68,40,FMN 03 Kolonel Silvertopstraat
651,Kolonel Silvertopstraat 5333,2023-04-02,17:00:00,128,79,49,FMN 03 Kolonel Silvertopstraat
651,Kolonel Silvertopstraat 5333,2023-04-02,18:00:00,156,88,68,FMN 03 Kolonel Silvertopstraat
651,Kolonel Silvertopstraat 5333,2023-04-02,19:00:00,160,94,66,FMN 03 Kolonel Silvertopstraat
651,Kolonel Silvertopstraat 5333,2023-04-02,20:00:00,98,61,37,FMN 03 Kolonel Silvertopstraat
651,Kolonel Silvertopstraat 5333,2023-04-02,21:00:00,148,107,41,FMN 03 Kolonel Silvertopstraat
651,Kolonel Silvertopstraat 5333,2023-04-02,22:00:00,78,50,28,FMN 03 Kolonel Silvertopstraat
651,Kolonel Silvertopstraat 5333,2023-04-02,23:00:00,61,24,37,FMN 03 Kolonel Silvertopstraat
651,Kolonel Silvertopstraat 5333,2023-04-03,00:00:00,20,8,12,FMN 03 Kolonel Silvertopstraat
651,Kolonel Silvertopstraat 5333,2023-04-03,01:00:00,30,15,15,FMN 03 Kolonel Silvertopstraat
651,Kolonel Silvertopstraat 5333,2023-04-03,02:00:00,12,4,8,FMN 03 Kolonel Silvertopstraat
651,Kolonel Silvertopstraat 5333,2023-04-03,03:00:00,8,4,4,FMN 03 Kolonel Silvertopstraat
651,Kolonel Silvertopstraat 5333,2023-04-03,04:00:00,30,23,7,FMN 03 Kolonel Silvertopstraat
651,Kolonel Silvertopstraat 5333,2023-04-03,05:00:00,58,34,24,FMN 03 Kolonel Silvertopstraat
651,Kolonel Silvertopstraat 5333,2023-04-03,06:00:00,100,75,25,FMN 03 Kolonel Silvertopstraat
651,Kolonel Silvertopstraat 5333,2023-04-03,07:00:00,164,126,38,FMN 03 Kolonel Silvertopstraat
651,Kolonel Silvertopstraat 5333,2023-04-03,08:00:00,269,216,53,FMN 03 Kolonel Silvertopstraat
651,Kolonel Silvertopstraat 5333,2023-04-03,09:00:00,144,113,31,FMN 03 Kolonel Silvertopstraat
651,Kolonel Silvertopstraat 5333,2023-04-03,10:00:00,124,97,27,FMN 03 Kolonel Silvertopstraat
651,Kolonel Silvertopstraat 5333,2023-04-03,11:00:00,126,103,23,FMN 03 Kolonel Silvertopstraat
651,Kolonel Silvertopstraat 5333,2023-04-03,12:00:00,120,93,27,FMN 03 Kolonel Silvertopstraat
651,Kolonel Silvertopstraat 5333,2023-04-03,13:00:00,138,94,44,FMN 03 Kolonel Silvertopstraat
651,Kolonel Silvertopstraat 5333,2023-04-03,14:00:00,180,129,51,FMN 03 Kolonel Silvertopstraat
651,Kolonel Silvertopstraat 5333,2023-04-03,15:00:00,183,117,66,FMN 03 Kolonel Silvertopstraat
651,Kolonel Silvertopstraat 5333,2023-04-03,16:00:00,244,173,71,FMN 03 Kolonel Silvertopstraat
651,Kolonel Silvertopstraat 5333,2023-04-03,17:00:00,304,174,130,FMN 03 Kolonel Silvertopstraat
651,Kolonel Silvertopstraat 5333,2023-04-03,18:00:00,221,127,94,FMN 03 Kolonel Silvertopstraat
651,Kolonel Silvertopstraat 5333,2023-04-03,19:00:00,189,110,79,FMN 03 Kolonel Silvertopstraat
651,Kolonel Silvertopstraat 5333,2023-04-03,20:00:00,118,72,46,FMN 03 Kolonel Silvertopstraat
651,Kolonel Silvertopstraat 5333,2023-04-03,21:00:00,108,68,40,FMN 03 Kolonel Silvertopstraat
651,Kolonel Silvertopstraat 5333,2023-04-03,22:00:00,85,50,35,FMN 03 Kolonel Silvertopstraat
651,Kolonel Silvertopstraat 5333,2023-04-03,23:00:00,64,24,40,FMN 03 Kolonel Silvertopstraat
651,Kolonel Silvertopstraat 5333,2023-04-04,00:00:00,21,14,7,FMN 03 Kolonel Silvertopstraat
651,Kolonel Silvertopstraat 5333,2023-04-04,01:00:00,24,13,11,FMN 03 Kolonel Silvertopstraat
651,Kolonel Silvertopstraat 5333,2023-04-04,02:00:00,10,4,6,FMN 03 Kolonel Silvertopstraat
651,Kolonel Silvertopstraat 5333,2023-04-04,03:00:00,9,6,3,FMN 03 Kolonel Silvertopstraat
651,Kolonel Silvertopstraat 5333,2023-04-04,04:00:00,24,17,7,FMN 03 Kolonel Silvertopstraat
651,Kolonel Silvertopstraat 5333,2023-04-04,05:00:00,62,41,21,FMN 03 Kolonel Silvertopstraat
651,Kolonel Silvertopstraat 5333,2023-04-04,06:00:00,127,103,24,FMN 03 Kolonel Silvertopstraat
651,Kolonel Silvertopstraat 5333,2023-04-04,07:00:00,209,173,36,FMN 03 Kolonel Silvertopstraat
651,Kolonel Silvertopstraat 5333,2023-04-04,08:00:00,301,246,55,FMN 03 Kolonel Silvertopstraat
651,Kolonel Silvertopstraat 5333,2023-04-04,09:00:00,185,146,39,FMN 03 Kolonel Silvertopstraat
651,Kolonel Silvertopstraat 5333,2023-04-04,10:00:00,138,107,31,FMN 03 Kolonel Silvertopstraat
651,Kolonel Silvertopstraat 5333,2023-04-04,11:00:00,117,90,27,FMN 03 Kolonel Silvertopstraat
651,Kolonel Silvertopstraat 5333,2023-04-04,12:00:00,160,109,51,FMN 03 Kolonel Silvertopstraat
651,Kolonel Silvertopstraat 5333,2023-04-04,13:00:00,165,119,46,FMN 03 Kolonel Silvertopstraat
651,Kolonel Silvertopstraat 5333,2023-04-04,14:00:00,188,132,56,FMN 03 Kolonel Silvertopstraat
651,Kolonel Silvertopstraat 5333,2023-04-04,15:00:00,195,122,73,FMN 03 Kolonel Silvertopstraat
651,Kolonel Silvertopstraat 5333,2023-04-04,16:00:00,254,174,80,FMN 03 Kolonel Silvertopstraat
651,Kolonel Silvertopstraat 5333,2023-04-04,17:00:00,347,230,117,FMN 03 Kolonel Silvertopstraat
651,Kolonel Silvertopstraat 5333,2023-04-04,18:00:00,266,167,99,FMN 03 Kolonel Silvertopstraat
651,Kolonel Silvertopstraat 5333,2023-04-04,19:00:00,180,118,62,FMN 03 Kolonel Silvertopstraat
651,Kolonel Silvertopstraat 5333,2023-04-04,20:00:00,140,79,61,FMN 03 Kolonel Silvertopstraat
651,Kolonel Silvertopstraat 5333,2023-04-04,21:00:00,88,43,45,FMN 03 Kolonel Silvertopstraat
651,Kolonel Silvertopstraat 5333,2023-04-04,22:00:00,90,51,39,FMN 03 Kolonel Silvertopstraat
651,Kolonel Silvertopstraat 5333,2023-04-04,23:00:00,72,35,37,FMN 03 Kolonel Silvertopstraat
651,Kolonel Silvertopstraat 5333,2023-04-05,00:00:00,28,17,11,FMN 03 Kolonel Silvertopstraat
651,Kolonel Silvertopstraat 5333,2023-04-05,01:00:00,20,9,11,FMN 03 Kolonel Silvertopstraat
651,Kolonel Silvertopstraat 5333,2023-04-05,02:00:00,10,3,7,FMN 03 Kolonel Silvertopstraat
651,Kolonel Silvertopstraat 5333,2023-04-05,03:00:00,10,6,4,FMN 03 Kolonel Silvertopstraat
651,Kolonel Silvertopstraat 5333,2023-04-05,04:00:00,23,17,6,FMN 03 Kolonel Silvertopstraat
651,Kolonel Silvertopstraat 5333,2023-04-05,05:00:00,46,25,21,FMN 03 Kolonel Silvertopstraat
651,Kolonel Silvertopstraat 5333,2023-04-05,06:00:00,131,111,20,FMN 03 Kolonel Silvertopstraat
651,Kolonel Silvertopstraat 5333,2023-04-05,07:00:00,189,140,49,FMN 03 Kolonel Silvertopstraat
651,Kolonel Silvertopstraat 5333,2023-04-05,08:00:00,270,227,43,FMN 03 Kolonel Silvertopstraat
651,Kolonel Silvertopstraat 5333,2023-04-05,09:00:00,165,136,29,FMN 03 Kolonel Silvertopstraat
651,Kolonel Silvertopstraat 5333,2023-04-05,10:00:00,144,101,43,FMN 03 Kolonel Silvertopstraat
651,Kolonel Silvertopstraat 5333,2023-04-05,11:00:00,119,95,24,FMN 03 Kolonel Silvertopstraat
651,Kolonel Silvertopstraat 5333,2023-04-05,12:00:00,173,124,49,FMN 03 Kolonel Silvertopstraat
651,Kolonel Silvertopstraat 5333,2023-04-05,13:00:00,164,114,50,FMN 03 Kolonel Silvertopstraat
651,Kolonel Silvertopstraat 5333,2023-04-05,14:00:00,204,142,62,FMN 03 Kolonel Silvertopstraat
651,Kolonel Silvertopstraat 5333,2023-04-05,15:00:00,181,136,45,FMN 03 Kolonel Silvertopstraat
651,Kolonel Silvertopstraat 5333,2023-04-05,16:00:00,264,165,99,FMN 03 Kolonel Silvertopstraat
651,Kolonel Silvertopstraat 5333,2023-04-05,17:00:00,321,208,113,FMN 03 Kolonel Silvertopstraat
651,Kolonel Silvertopstraat 5333,2023-04-05,18:00:00,267,173,94,FMN 03 Kolonel Silvertopstraat
651,Kolonel Silvertopstraat 5333,2023-04-05,19:00:00,203,137,66,FMN 03 Kolonel Silvertopstraat
651,Kolonel Silvertopstraat 5333,2023-04-05,20:00:00,130,78,52,FMN 03 Kolonel Silvertopstraat
651,Kolonel Silvertopstraat 5333,2023-04-05,21:00:00,106,77,29,FMN 03 Kolonel Silvertopstraat
651,Kolonel Silvertopstraat 5333,2023-04-05,22:00:00,120,62,58,FMN 03 Kolonel Silvertopstraat
651,Kolonel Silvertopstraat 5333,2023-04-05,23:00:00,78,39,39,FMN 03 Kolonel Silvertopstraat
651,Kolonel Silvertopstraat 5333,2023-04-06,00:00:00,49,24,25,FMN 03 Kolonel Silvertopstraat
651,Kolonel Silvertopstraat 5333,2023-04-06,01:00:00,26,14,12,FMN 03 Kolonel Silvertopstraat
651,Kolonel Silvertopstraat 5333,2023-04-06,02:00:00,18,4,14,FMN 03 Kolonel Silvertopstraat
651,Kolonel Silvertopstraat 5333,2023-04-06,03:00:00,14,9,5,FMN 03 Kolonel Silvertopstraat
651,Kolonel Silvertopstraat 5333,2023-04-06,04:00:00,27,19,8,FMN 03 Kolonel Silvertopstraat
651,Kolonel Silvertopstraat 5333,2023-04-06,05:00:00,53,31,22,FMN 03 Kolonel Silvertopstraat
651,Kolonel Silvertopstraat 5333,2023-04-06,06:00:00,96,78,18,FMN 03 Kolonel Silvertopstraat
651,Kolonel Silvertopstraat 5333,2023-04-06,07:00:00,172,134,38,FMN 03 Kolonel Silvertopstraat
651,Kolonel Silvertopstraat 5333,2023-04-06,08:00:00,248,198,50,FMN 03 Kolonel Silvertopstraat
651,Kolonel Silvertopstraat 5333,2023-04-06,09:00:00,128,98,30,FMN 03 Kolonel Silvertopstraat
651,Kolonel Silvertopstraat 5333,2023-04-06,10:00:00,82,62,20,FMN 03 Kolonel Silvertopstraat
651,Kolonel Silvertopstraat 5333,2023-04-06,11:00:00,73,56,17,FMN 03 Kolonel Silvertopstraat
651,Kolonel Silvertopstraat 5333,2023-04-06,12:00:00,84,60,24,FMN 03 Kolonel Silvertopstraat
651,Kolonel Silvertopstraat 5333,2023-04-06,13:00:00,100,72,28,FMN 03 Kolonel Silvertopstraat
651,Kolonel Silvertopstraat 5333,2023-04-06,14:00:00,142,107,35,FMN 03 Kolonel Silvertopstraat
651,Kolonel Silvertopstraat 5333,2023-04-06,15:00:00,132,85,47,FMN 03 Kolonel Silvertopstraat
651,Kolonel Silvertopstraat 5333,2023-04-06,16:00:00,216,142,74,FMN 03 Kolonel Silvertopstraat
651,Kolonel Silvertopstraat 5333,2023-04-06,17:00:00,224,140,84,FMN 03 Kolonel Silvertopstraat
651,Kolonel Silvertopstraat 5333,2023-04-06,18:00:00,179,109,70,FMN 03 Kolonel Silvertopstraat
651,Kolonel Silvertopstraat 5333,2023-04-06,19:00:00,132,90,42,FMN 03 Kolonel Silvertopstraat
651,Kolonel Silvertopstraat 5333,2023-04-06,20:00:00,93,47,46,FMN 03 Kolonel Silvertopstraat
651,Kolonel Silvertopstraat 5333,2023-04-06,21:00:00,68,43,25,FMN 03 Kolonel Silvertopstraat
651,Kolonel Silvertopstraat 5333,2023-04-06,22:00:00,75,38,37,FMN 03 Kolonel Silvertopstraat
651,Kolonel Silvertopstraat 5333,2023-04-06,23:00:00,36,15,21,FMN 03 Kolonel Silvertopstraat
651,Kolonel Silvertopstraat 5333,2023-04-07,00:00:00,31,16,15,FMN 03 Kolonel Silvertopstraat
651,Kolonel Silvertopstraat 5333,2023-04-07,01:00:00,26,8,18,FMN 03 Kolonel Silvertopstraat
651,Kolonel Silvertopstraat 5333,2023-04-07,02:00:00,19,8,11,FMN 03 Kolonel Silvertopstraat
651,Kolonel Silvertopstraat 5333,2023-04-07,03:00:00,11,4,7,FMN 03 Kolonel Silvertopstraat
651,Kolonel Silvertopstraat 5333,2023-04-07,04:00:00,31,19,12,FMN 03 Kolonel Silvertopstraat
651,Kolonel Silvertopstraat 5333,2023-04-07,05:00:00,59,37,22,FMN 03 Kolonel Silvertopstraat
651,Kolonel Silvertopstraat 5333,2023-04-07,06:00:00,83,65,18,FMN 03 Kolonel Silvertopstraat
651,Kolonel Silvertopstraat 5333,2023-04-07,07:00:00,127,91,36,FMN 03 Kolonel Silvertopstraat
651,Kolonel Silvertopstraat 5333,2023-04-07,08:00:00,208,161,47,FMN 03 Kolonel Silvertopstraat
651,Kolonel Silvertopstraat 5333,2023-04-07,09:00:00,141,119,22,FMN 03 Kolonel Silvertopstraat
651,Kolonel Silvertopstraat 5333,2023-04-07,10:00:00,141,108,33,FMN 03 Kolonel Silvertopstraat
651,Kolonel Silvertopstraat 5333,2023-04-07,11:00:00,140,98,42,FMN 03 Kolonel Silvertopstraat
651,Kolonel Silvertopstraat 5333,2023-04-07,12:00:00,143,99,44,FMN 03 Kolonel Silvertopstraat
651,Kolonel Silvertopstraat 5333,2023-04-07,13:00:00,174,130,44,FMN 03 Kolonel Silvertopstraat
651,Kolonel Silvertopstraat 5333,2023-04-07,14:00:00,170,111,59,FMN 03 Kolonel Silvertopstraat
651,Kolonel Silvertopstraat 5333,2023-04-07,15:00:00,214,150,64,FMN 03 Kolonel Silvertopstraat
651,Kolonel Silvertopstraat 5333,2023-04-07,16:00:00,228,160,68,FMN 03 Kolonel Silvertopstraat
651,Kolonel Silvertopstraat 5333,2023-04-07,17:00:00,235,160,75,FMN 03 Kolonel Silvertopstraat
651,Kolonel Silvertopstraat 5333,2023-04-07,18:00:00,227,148,79,FMN 03 Kolonel Silvertopstraat
651,Kolonel Silvertopstraat 5333,2023-04-07,19:00:00,170,121,49,FMN 03 Kolonel Silvertopstraat
651,Kolonel Silvertopstraat 5333,2023-04-07,20:00:00,127,85,42,FMN 03 Kolonel Silvertopstraat
651,Kolonel Silvertopstraat 5333,2023-04-07,21:00:00,119,75,44,FMN 03 Kolonel Silvertopstraat
651,Kolonel Silvertopstraat 5333,2023-04-07,22:00:00,117,68,49,FMN 03 Kolonel Silvertopstraat
651,Kolonel Silvertopstraat 5333,2023-04-07,23:00:00,77,33,44,FMN 03 Kolonel Silvertopstraat
651,Kolonel Silvertopstraat 5333,2023-04-08,00:00:00,67,30,37,FMN 03 Kolonel Silvertopstraat
651,Kolonel Silvertopstraat 5333,2023-04-08,01:00:00,70,29,41,FMN 03 Kolonel Silvertopstraat
651,Kolonel Silvertopstraat 5333,2023-04-08,02:00:00,24,8,16,FMN 03 Kolonel Silvertopstraat
651,Kolonel Silvertopstraat 5333,2023-04-08,03:00:00,28,5,23,FMN 03 Kolonel Silvertopstraat
651,Kolonel Silvertopstraat 5333,2023-04-08,04:00:00,18,7,11,FMN 03 Kolonel Silvertopstraat
651,Kolonel Silvertopstraat 5333,2023-04-08,05:00:00,43,19,24,FMN 03 Kolonel Silvertopstraat
651,Kolonel Silvertopstraat 5333,2023-04-08,06:00:00,31,26,5,FMN 03 Kolonel Silvertopstraat
651,Kolonel Silvertopstraat 5333,2023-04-08,07:00:00,27,20,7,FMN 03 Kolonel Silvertopstraat
651,Kolonel Silvertopstraat 5333,2023-04-08,08:00:00,61,53,8,FMN 03 Kolonel Silvertopstraat
651,Kolonel Silvertopstraat 5333,2023-04-08,09:00:00,120,102,18,FMN 03 Kolonel Silvertopstraat
651,Kolonel Silvertopstraat 5333,2023-04-08,10:00:00,149,125,24,FMN 03 Kolonel Silvertopstraat
651,Kolonel Silvertopstraat 5333,2023-04-08,11:00:00,145,109,36,FMN 03 Kolonel Silvertopstraat
651,Kolonel Silvertopstraat 5333,2023-04-08,12:00:00,120,83,37,FMN 03 Kolonel Silvertopstraat
651,Kolonel Silvertopstraat 5333,2023-04-08,13:00:00,203,157,46,FMN 03 Kolonel Silvertopstraat
651,Kolonel Silvertopstraat 5333,2023-04-08,14:00:00,168,122,46,FMN 03 Kolonel Silvertopstraat
651,Kolonel Silvertopstraat 5333,2023-04-08,15:00:00,169,123,46,FMN 03 Kolonel Silvertopstraat
651,Kolonel Silvertopstraat 5333,2023-04-08,16:00:00,204,143,61,FMN 03 Kolonel Silvertopstraat
651,Kolonel Silvertopstraat 5333,2023-04-08,17:00:00,212,142,70,FMN 03 Kolonel Silvertopstraat
651,Kolonel Silvertopstraat 5333,2023-04-08,18:00:00,203,139,64,FMN 03 Kolonel Silvertopstraat
651,Kolonel Silvertopstraat 5333,2023-04-08,19:00:00,156,98,58,FMN 03 Kolonel Silvertopstraat
651,Kolonel Silvertopstraat 5333,2023-04-08,20:00:00,128,83,45,FMN 03 Kolonel Silvertopstraat
651,Kolonel Silvertopstraat 5333,2023-04-08,21:00:00,112,74,38,FMN 03 Kolonel Silvertopstraat
651,Kolonel Silvertopstraat 5333,2023-04-08,22:00:00,97,51,46,FMN 03 Kolonel Silvertopstraat
651,Kolonel Silvertopstraat 5333,2023-04-08,23:00:00,88,45,43,FMN 03 Kolonel Silvertopstraat
651,Kolonel Silvertopstraat 5333,2023-04-09,00:00:00,45,18,27,FMN 03 Kolonel Silvertopstraat
651,Kolonel Silvertopstraat 5333,2023-04-09,01:00:00,21,12,9,FMN 03 Kolonel Silvertopstraat
651,Kolonel Silvertopstraat 5333,2023-04-09,02:00:00,38,9,29,FMN 03 Kolonel Silvertopstraat
651,Kolonel Silvertopstraat 5333,2023-04-09,03:00:00,31,11,20,FMN 03 Kolonel Silvertopstraat
651,Kolonel Silvertopstraat 5333,2023-04-09,04:00:00,18,8,10,FMN 03 Kolonel Silvertopstraat
651,Kolonel Silvertopstraat 5333,2023-04-09,05:00:00,17,9,8,FMN 03 Kolonel Silvertopstraat
651,Kolonel Silvertopstraat 5333,2023-04-09,06:00:00,22,18,4,FMN 03 Kolonel Silvertopstraat
651,Kolonel Silvertopstraat 5333,2023-04-09,07:00:00,22,19,3,FMN 03 Kolonel Silvertopstraat
651,Kolonel Silvertopstraat 5333,2023-04-09,08:00:00,45,33,12,FMN 03 Kolonel Silvertopstraat
651,Kolonel Silvertopstraat 5333,2023-04-09,09:00:00,72,61,11,FMN 03 Kolonel Silvertopstraat
651,Kolonel Silvertopstraat 5333,2023-04-09,10:00:00,111,93,18,FMN 03 Kolonel Silvertopstraat
651,Kolonel Silvertopstraat 5333,2023-04-09,11:00:00,135,106,29,FMN 03 Kolonel Silvertopstraat
651,Kolonel Silvertopstraat 5333,2023-04-09,12:00:00,133,97,36,FMN 03 Kolonel Silvertopstraat
651,Kolonel Silvertopstraat 5333,2023-04-09,13:00:00,145,106,39,FMN 03 Kolonel Silvertopstraat
651,Kolonel Silvertopstraat 5333,2023-04-09,14:00:00,124,91,33,FMN 03 Kolonel Silvertopstraat
651,Kolonel Silvertopstraat 5333,2023-04-09,15:00:00,128,82,46,FMN 03 Kolonel Silvertopstraat
651,Kolonel Silvertopstraat 5333,2023-04-09,16:00:00,169,123,46,FMN 03 Kolonel Silvertopstraat
651,Kolonel Silvertopstraat 5333,2023-04-09,17:00:00,166,113,53,FMN 03 Kolonel Silvertopstraat
651,Kolonel Silvertopstraat 5333,2023-04-09,18:00:00,161,116,45,FMN 03 Kolonel Silvertopstraat
651,Kolonel Silvertopstraat 5333,2023-04-09,19:00:00,149,95,54,FMN 03 Kolonel Silvertopstraat
651,Kolonel Silvertopstraat 5333,2023-04-09,20:00:00,103,63,40,FMN 03 Kolonel Silvertopstraat
651,Kolonel Silvertopstraat 5333,2023-04-09,21:00:00,121,75,46,FMN 03 Kolonel Silvertopstraat
651,Kolonel Silvertopstraat 5333,2023-04-09,22:00:00,93,42,51,FMN 03 Kolonel Silvertopstraat
651,Kolonel Silvertopstraat 5333,2023-04-09,23:00:00,63,34,29,FMN 03 Kolonel Silvertopstraat
651,Kolonel Silvertopstraat 5333,2023-04-10,00:00:00,45,19,26,FMN 03 Kolonel Silvertopstraat
651,Kolonel Silvertopstraat 5333,2023-04-10,01:00:00,32,16,16,FMN 03 Kolonel Silvertopstraat
651,Kolonel Silvertopstraat 5333,2023-04-10,02:00:00,23,9,14,FMN 03 Kolonel Silvertopstraat
651,Kolonel Silvertopstraat 5333,2023-04-10,03:00:00,22,11,11,FMN 03 Kolonel Silvertopstraat
651,Kolonel Silvertopstraat 5333,2023-04-10,04:00:00,17,7,10,FMN 03 Kolonel Silvertopstraat
651,Kolonel Silvertopstraat 5333,2023-04-10,05:00:00,23,15,8,FMN 03 Kolonel Silvertopstraat
651,Kolonel Silvertopstraat 5333,2023-04-10,06:00:00,30,22,8,FMN 03 Kolonel Silvertopstraat
651,Kolonel Silvertopstraat 5333,2023-04-10,07:00:00,23,19,4,FMN 03 Kolonel Silvertopstraat
651,Kolonel Silvertopstraat 5333,2023-04-10,08:00:00,37,28,9,FMN 03 Kolonel Silvertopstraat
651,Kolonel Silvertopstraat 5333,2023-04-10,09:00:00,75,56,19,FMN 03 Kolonel Silvertopstraat
651,Kolonel Silvertopstraat 5333,2023-04-10,10:00:00,108,91,17,FMN 03 Kolonel Silvertopstraat
651,Kolonel Silvertopstraat 5333,2023-04-10,11:00:00,116,84,32,FMN 03 Kolonel Silvertopstraat
651,Kolonel Silvertopstraat 5333,2023-04-10,12:00:00,131,101,30,FMN 03 Kolonel Silvertopstraat
651,Kolonel Silvertopstraat 5333,2023-04-10,13:00:00,101,67,34,FMN 03 Kolonel Silvertopstraat
651,Kolonel Silvertopstraat 5333,2023-04-10,14:00:00,110,66,44,FMN 03 Kolonel Silvertopstraat
651,Kolonel Silvertopstraat 5333,2023-04-10,15:00:00,97,60,37,FMN 03 Kolonel Silvertopstraat
651,Kolonel Silvertopstraat 5333,2023-04-10,16:00:00,122,83,39,FMN 03 Kolonel Silvertopstraat
651,Kolonel Silvertopstraat 5333,2023-04-10,17:00:00,97,62,35,FMN 03 Kolonel Silvertopstraat
651,Kolonel Silvertopstraat 5333,2023-04-10,18:00:00,87,51,36,FMN 03 Kolonel Silvertopstraat
651,Kolonel Silvertopstraat 5333,2023-04-10,19:00:00,84,47,37,FMN 03 Kolonel Silvertopstraat
651,Kolonel Silvertopstraat 5333,2023-04-10,20:00:00,103,64,39,FMN 03 Kolonel Silvertopstraat
651,Kolonel Silvertopstraat 5333,2023-04-10,21:00:00,71,45,26,FMN 03 Kolonel Silvertopstraat
651,Kolonel Silvertopstraat 5333,2023-04-10,22:00:00,69,28,41,FMN 03 Kolonel Silvertopstraat
651,Kolonel Silvertopstraat 5333,2023-04-10,23:00:00,52,31,21,FMN 03 Kolonel Silvertopstraat
651,Kolonel Silvertopstraat 5333,2023-04-11,00:00:00,37,18,19,FMN 03 Kolonel Silvertopstraat
651,Kolonel Silvertopstraat 5333,2023-04-11,01:00:00,17,6,11,FMN 03 Kolonel Silvertopstraat
651,Kolonel Silvertopstraat 5333,2023-04-11,02:00:00,9,7,2,FMN 03 Kolonel Silvertopstraat
651,Kolonel Silvertopstraat 5333,2023-04-11,03:00:00,15,7,8,FMN 03 Kolonel Silvertopstraat
651,Kolonel Silvertopstraat 5333,2023-04-11,04:00:00,30,21,9,FMN 03 Kolonel Silvertopstraat
651,Kolonel Silvertopstraat 5333,2023-04-11,05:00:00,50,32,18,FMN 03 Kolonel Silvertopstraat
651,Kolonel Silvertopstraat 5333,2023-04-11,06:00:00,117,92,25,FMN 03 Kolonel Silvertopstraat
651,Kolonel Silvertopstraat 5333,2023-04-11,07:00:00,185,145,40,FMN 03 Kolonel Silvertopstraat
651,Kolonel Silvertopstraat 5333,2023-04-11,08:00:00,286,234,52,FMN 03 Kolonel Silvertopstraat
651,Kolonel Silvertopstraat 5333,2023-04-11,09:00:00,191,146,45,FMN 03 Kolonel Silvertopstraat
651,Kolonel Silvertopstraat 5333,2023-04-11,10:00:00,134,103,31,FMN 03 Kolonel Silvertopstraat
651,Kolonel Silvertopstraat 5333,2023-04-11,11:00:00,150,110,40,FMN 03 Kolonel Silvertopstraat
651,Kolonel Silvertopstraat 5333,2023-04-11,12:00:00,175,129,46,FMN 03 Kolonel Silvertopstraat
651,Kolonel Silvertopstraat 5333,2023-04-11,13:00:00,181,128,53,FMN 03 Kolonel Silvertopstraat
651,Kolonel Silvertopstraat 5333,2023-04-11,14:00:00,169,106,63,FMN 03 Kolonel Silvertopstraat
651,Kolonel Silvertopstraat 5333,2023-04-11,15:00:00,204,144,60,FMN 03 Kolonel Silvertopstraat
651,Kolonel Silvertopstraat 5333,2023-04-11,16:00:00,246,171,75,FMN 03 Kolonel Silvertopstraat
651,Kolonel Silvertopstraat 5333,2023-04-11,17:00:00,321,194,127,FMN 03 Kolonel Silvertopstraat
651,Kolonel Silvertopstraat 5333,2023-04-11,18:00:00,240,157,83,FMN 03 Kolonel Silvertopstraat
651,Kolonel Silvertopstraat 5333,2023-04-11,19:00:00,178,113,65,FMN 03 Kolonel Silvertopstraat
651,Kolonel Silvertopstraat 5333,2023-04-11,20:00:00,122,64,58,FMN 03 Kolonel Silvertopstraat
651,Kolonel Silvertopstraat 5333,2023-04-11,21:00:00,112,61,51,FMN 03 Kolonel Silvertopstraat
651,Kolonel Silvertopstraat 5333,2023-04-11,22:00:00,93,44,49,FMN 03 Kolonel Silvertopstraat
651,Kolonel Silvertopstraat 5333,2023-04-11,23:00:00,57,27,30,FMN 03 Kolonel Silvertopstraat
651,Kolonel Silvertopstraat 5333,2023-04-12,00:00:00,19,11,8,FMN 03 Kolonel Silvertopstraat
651,Kolonel Silvertopstraat 5333,2023-04-12,01:00:00,16,9,7,FMN 03 Kolonel Silvertopstraat
651,Kolonel Silvertopstraat 5333,2023-04-12,02:00:00,8,4,4,FMN 03 Kolonel Silvertopstraat
651,Kolonel Silvertopstraat 5333,2023-04-12,03:00:00,14,6,8,FMN 03 Kolonel Silvertopstraat
651,Kolonel Silvertopstraat 5333,2023-04-12,04:00:00,28,21,7,FMN 03 Kolonel Silvertopstraat
651,Kolonel Silvertopstraat 5333,2023-04-12,05:00:00,42,24,18,FMN 03 Kolonel Silvertopstraat
651,Kolonel Silvertopstraat 5333,2023-04-12,06:00:00,87,70,17,FMN 03 Kolonel Silvertopstraat
651,Kolonel Silvertopstraat 5333,2023-04-12,07:00:00,113,80,33,FMN 03 Kolonel Silvertopstraat
651,Kolonel Silvertopstraat 5333,2023-04-12,08:00:00,198,151,47,FMN 03 Kolonel Silvertopstraat
651,Kolonel Silvertopstraat 5333,2023-04-12,09:00:00,141,109,32,FMN 03 Kolonel Silvertopstraat
651,Kolonel Silvertopstraat 5333,2023-04-12,10:00:00,96,75,21,FMN 03 Kolonel Silvertopstraat
651,Kolonel Silvertopstraat 5333,2023-04-12,11:00:00,102,79,23,FMN 03 Kolonel Silvertopstraat
651,Kolonel Silvertopstraat 5333,2023-04-12,12:00:00,108,86,22,FMN 03 Kolonel Silvertopstraat
651,Kolonel Silvertopstraat 5333,2023-04-12,13:00:00,94,64,30,FMN 03 Kolonel Silvertopstraat
651,Kolonel Silvertopstraat 5333,2023-04-12,14:00:00,121,94,27,FMN 03 Kolonel Silvertopstraat
651,Kolonel Silvertopstraat 5333,2023-04-12,15:00:00,143,87,56,FMN 03 Kolonel Silvertopstraat
651,Kolonel Silvertopstraat 5333,2023-04-12,16:00:00,203,141,62,FMN 03 Kolonel Silvertopstraat
651,Kolonel Silvertopstraat 5333,2023-04-12,17:00:00,243,166,77,FMN 03 Kolonel Silvertopstraat
651,Kolonel Silvertopstraat 5333,2023-04-12,18:00:00,198,127,71,FMN 03 Kolonel Silvertopstraat
651,Kolonel Silvertopstraat 5333,2023-04-12,19:00:00,145,90,55,FMN 03 Kolonel Silvertopstraat
651,Kolonel Silvertopstraat 5333,2023-04-12,20:00:00,134,87,47,FMN 03 Kolonel Silvertopstraat
651,Kolonel Silvertopstraat 5333,2023-04-12,21:00:00,89,54,35,FMN 03 Kolonel Silvertopstraat
651,Kolonel Silvertopstraat 5333,2023-04-12,22:00:00,101,59,42,FMN 03 Kolonel Silvertopstraat
651,Kolonel Silvertopstraat 5333,2023-04-12,23:00:00,61,29,32,FMN 03 Kolonel Silvertopstraat
651,Kolonel Silvertopstraat 5333,2023-04-13,00:00:00,41,21,20,FMN 03 Kolonel Silvertopstraat
651,Kolonel Silvertopstraat 5333,2023-04-13,01:00:00,19,11,8,FMN 03 Kolonel Silvertopstraat
651,Kolonel Silvertopstraat 5333,2023-04-13,02:00:00,14,9,5,FMN 03 Kolonel Silvertopstraat
651,Kolonel Silvertopstraat 5333,2023-04-13,03:00:00,8,3,5,FMN 03 Kolonel Silvertopstraat
651,Kolonel Silvertopstraat 5333,2023-04-13,04:00:00,25,17,8,FMN 03 Kolonel Silvertopstraat
651,Kolonel Silvertopstraat 5333,2023-04-13,05:00:00,51,29,22,FMN 03 Kolonel Silvertopstraat
651,Kolonel Silvertopstraat 5333,2023-04-13,06:00:00,102,84,18,FMN 03 Kolonel Silvertopstraat
651,Kolonel Silvertopstraat 5333,2023-04-13,07:00:00,179,135,44,FMN 03 Kolonel Silvertopstraat
651,Kolonel Silvertopstraat 5333,2023-04-13,08:00:00,275,222,53,FMN 03 Kolonel Silvertopstraat
651,Kolonel Silvertopstraat 5333,2023-04-13,09:00:00,161,133,28,FMN 03 Kolonel Silvertopstraat
651,Kolonel Silvertopstraat 5333,2023-04-13,10:00:00,106,81,25,FMN 03 Kolonel Silvertopstraat
651,Kolonel Silvertopstraat 5333,2023-04-13,11:00:00,116,84,32,FMN 03 Kolonel Silvertopstraat
651,Kolonel Silvertopstraat 5333,2023-04-13,12:00:00,162,119,43,FMN 03 Kolonel Silvertopstraat
651,Kolonel Silvertopstraat 5333,2023-04-13,13:00:00,120,83,37,FMN 03 Kolonel Silvertopstraat
651,Kolonel Silvertopstraat 5333,2023-04-13,14:00:00,176,124,52,FMN 03 Kolonel Silvertopstraat
651,Kolonel Silvertopstraat 5333,2023-04-13,15:00:00,177,123,54,FMN 03 Kolonel Silvertopstraat
651,Kolonel Silvertopstraat 5333,2023-04-13,16:00:00,265,167,98,FMN 03 Kolonel Silvertopstraat
651,Kolonel Silvertopstraat 5333,2023-04-13,17:00:00,292,199,93,FMN 03 Kolonel Silvertopstraat
651,Kolonel Silvertopstraat 5333,2023-04-13,18:00:00,286,185,101,FMN 03 Kolonel Silvertopstraat
651,Kolonel Silvertopstraat 5333,2023-04-13,19:00:00,181,118,63,FMN 03 Kolonel Silvertopstraat
651,Kolonel Silvertopstraat 5333,2023-04-13,20:00:00,159,98,61,FMN 03 Kolonel Silvertopstraat
651,Kolonel Silvertopstraat 5333,2023-04-13,21:00:00,112,63,49,FMN 03 Kolonel Silvertopstraat
651,Kolonel Silvertopstraat 5333,2023-04-13,22:00:00,112,61,51,FMN 03 Kolonel Silvertopstraat
651,Kolonel Silvertopstraat 5333,2023-04-13,23:00:00,83,51,32,FMN 03 Kolonel Silvertopstraat
651,Kolonel Silvertopstraat 5333,2023-04-14,00:00:00,46,16,30,FMN 03 Kolonel Silvertopstraat
651,Kolonel Silvertopstraat 5333,2023-04-14,01:00:00,33,16,17,FMN 03 Kolonel Silvertopstraat
651,Kolonel Silvertopstraat 5333,2023-04-14,02:00:00,10,5,5,FMN 03 Kolonel Silvertopstraat
651,Kolonel Silvertopstraat 5333,2023-04-14,03:00:00,13,7,6,FMN 03 Kolonel Silvertopstraat
651,Kolonel Silvertopstraat 5333,2023-04-14,04:00:00,21,15,6,FMN 03 Kolonel Silvertopstraat
651,Kolonel Silvertopstraat 5333,2023-04-14,05:00:00,50,31,19,FMN 03 Kolonel Silvertopstraat
651,Kolonel Silvertopstraat 5333,2023-04-14,06:00:00,94,75,19,FMN 03 Kolonel Silvertopstraat
651,Kolonel Silvertopstraat 5333,2023-04-14,07:00:00,152,111,41,FMN 03 Kolonel Silvertopstraat
651,Kolonel Silvertopstraat 5333,2023-04-14,08:00:00,249,203,46,FMN 03 Kolonel Silvertopstraat
651,Kolonel Silvertopstraat 5333,2023-04-14,09:00:00,161,131,30,FMN 03 Kolonel Silvertopstraat
651,Kolonel Silvertopstraat 5333,2023-04-14,10:00:00,161,131,30,FMN 03 Kolonel Silvertopstraat
651,Kolonel Silvertopstraat 5333,2023-04-14,11:00:00,153,121,32,FMN 03 Kolonel Silvertopstraat
651,Kolonel Silvertopstraat 5333,2023-04-14,12:00:00,162,112,50,FMN 03 Kolonel Silvertopstraat
651,Kolonel Silvertopstraat 5333,2023-04-14,13:00:00,220,154,66,FMN 03 Kolonel Silvertopstraat
651,Kolonel Silvertopstraat 5333,2023-04-14,14:00:00,190,129,61,FMN 03 Kolonel Silvertopstraat
651,Kolonel Silvertopstraat 5333,2023-04-14,15:00:00,215,151,64,FMN 03 Kolonel Silvertopstraat
651,Kolonel Silvertopstraat 5333,2023-04-14,16:00:00,246,169,77,FMN 03 Kolonel Silvertopstraat
651,Kolonel Silvertopstraat 5333,2023-04-14,17:00:00,284,188,96,FMN 03 Kolonel Silvertopstraat
651,Kolonel Silvertopstraat 5333,2023-04-14,18:00:00,244,166,78,FMN 03 Kolonel Silvertopstraat
651,Kolonel Silvertopstraat 5333,2023-04-14,19:00:00,217,130,87,FMN 03 Kolonel Silvertopstraat
651,Kolonel Silvertopstraat 5333,2023-04-14,20:00:00,154,99,55,FMN 03 Kolonel Silvertopstraat
651,Kolonel Silvertopstraat 5333,2023-04-14,21:00:00,112,76,36,FMN 03 Kolonel Silvertopstraat
651,Kolonel Silvertopstraat 5333,2023-04-14,22:00:00,178,118,60,FMN 03 Kolonel Silvertopstraat
651,Kolonel Silvertopstraat 5333,2023-04-14,23:00:00,119,68,51,FMN 03 Kolonel Silvertopstraat
651,Kolonel Silvertopstraat 5333,2023-04-15,00:00:00,62,32,30,FMN 03 Kolonel Silvertopstraat
651,Kolonel Silvertopstraat 5333,2023-04-15,01:00:00,57,22,35,FMN 03 Kolonel Silvertopstraat
651,Kolonel Silvertopstraat 5333,2023-04-15,02:00:00,35,14,21,FMN 03 Kolonel Silvertopstraat
651,Kolonel Silvertopstraat 5333,2023-04-15,03:00:00,27,14,13,FMN 03 Kolonel Silvertopstraat
651,Kolonel Silvertopstraat 5333,2023-04-15,04:00:00,25,7,18,FMN 03 Kolonel Silvertopstraat
651,Kolonel Silvertopstraat 5333,2023-04-15,05:00:00,19,14,5,FMN 03 Kolonel Silvertopstraat
651,Kolonel Silvertopstraat 5333,2023-04-15,06:00:00,53,38,15,FMN 03 Kolonel Silvertopstraat
651,Kolonel Silvertopstraat 5333,2023-04-15,07:00:00,40,33,7,FMN 03 Kolonel Silvertopstraat
651,Kolonel Silvertopstraat 5333,2023-04-15,08:00:00,60,47,13,FMN 03 Kolonel Silvertopstraat
651,Kolonel Silvertopstraat 5333,2023-04-15,09:00:00,112,95,17,FMN 03 Kolonel Silvertopstraat
651,Kolonel Silvertopstraat 5333,2023-04-15,10:00:00,147,121,26,FMN 03 Kolonel Silvertopstraat
651,Kolonel Silvertopstraat 5333,2023-04-15,11:00:00,163,127,36,FMN 03 Kolonel Silvertopstraat
651,Kolonel Silvertopstraat 5333,2023-04-15,12:00:00,181,136,45,FMN 03 Kolonel Silvertopstraat
651,Kolonel Silvertopstraat 5333,2023-04-15,13:00:00,215,169,46,FMN 03 Kolonel Silvertopstraat
651,Kolonel Silvertopstraat 5333,2023-04-15,14:00:00,243,178,65,FMN 03 Kolonel Silvertopstraat
651,Kolonel Silvertopstraat 5333,2023-04-15,15:00:00,204,132,72,FMN 03 Kolonel Silvertopstraat
651,Kolonel Silvertopstraat 5333,2023-04-15,16:00:00,215,158,57,FMN 03 Kolonel Silvertopstraat
651,Kolonel Silvertopstraat 5333,2023-04-15,17:00:00,197,133,64,FMN 03 Kolonel Silvertopstraat
651,Kolonel Silvertopstraat 5333,2023-04-15,18:00:00,224,156,68,FMN 03 Kolonel Silvertopstraat
651,Kolonel Silvertopstraat 5333,2023-04-15,19:00:00,196,117,79,FMN 03 Kolonel Silvertopstraat
651,Kolonel Silvertopstraat 5333,2023-04-15,20:00:00,140,89,51,FMN 03 Kolonel Silvertopstraat
651,Kolonel Silvertopstraat 5333,2023-04-15,21:00:00,119,83,36,FMN 03 Kolonel Silvertopstraat
651,Kolonel Silvertopstraat 5333,2023-04-15,22:00:00,108,60,48,FMN 03 Kolonel Silvertopstraat
651,Kolonel Silvertopstraat 5333,2023-04-15,23:00:00,90,52,38,FMN 03 Kolonel Silvertopstraat
651,Kolonel Silvertopstraat 5333,2023-04-16,00:00:00,75,32,43,FMN 03 Kolonel Silvertopstraat
651,Kolonel Silvertopstraat 5333,2023-04-16,01:00:00,57,18,39,FMN 03 Kolonel Silvertopstraat
651,Kolonel Silvertopstraat 5333,2023-04-16,02:00:00,33,7,26,FMN 03 Kolonel Silvertopstraat
651,Kolonel Silvertopstraat 5333,2023-04-16,03:00:00,31,8,23,FMN 03 Kolonel Silvertopstraat
651,Kolonel Silvertopstraat 5333,2023-04-16,04:00:00,27,8,19,FMN 03 Kolonel Silvertopstraat
651,Kolonel Silvertopstraat 5333,2023-04-16,05:00:00,22,11,11,FMN 03 Kolonel Silvertopstraat
651,Kolonel Silvertopstraat 5333,2023-04-16,06:00:00,41,28,13,FMN 03 Kolonel Silvertopstraat
651,Kolonel Silvertopstraat 5333,2023-04-16,07:00:00,19,15,4,FMN 03 Kolonel Silvertopstraat
651,Kolonel Silvertopstraat 5333,2023-04-16,08:00:00,45,38,7,FMN 03 Kolonel Silvertopstraat
651,Kolonel Silvertopstraat 5333,2023-04-16,09:00:00,52,37,15,FMN 03 Kolonel Silvertopstraat
651,Kolonel Silvertopstraat 5333,2023-04-16,10:00:00,108,85,23,FMN 03 Kolonel Silvertopstraat
651,Kolonel Silvertopstraat 5333,2023-04-16,11:00:00,107,82,25,FMN 03 Kolonel Silvertopstraat
651,Kolonel Silvertopstraat 5333,2023-04-16,12:00:00,86,59,27,FMN 03 Kolonel Silvertopstraat
651,Kolonel Silvertopstraat 5333,2023-04-16,13:00:00,133,104,29,FMN 03 Kolonel Silvertopstraat
651,Kolonel Silvertopstraat 5333,2023-04-16,14:00:00,129,83,46,FMN 03 Kolonel Silvertopstraat
651,Kolonel Silvertopstraat 5333,2023-04-16,15:00:00,139,90,49,FMN 03 Kolonel Silvertopstraat
651,Kolonel Silvertopstraat 5333,2023-04-16,16:00:00,142,91,51,FMN 03 Kolonel Silvertopstraat
651,Kolonel Silvertopstraat 5333,2023-04-16,17:00:00,146,105,41,FMN 03 Kolonel Silvertopstraat
651,Kolonel Silvertopstraat 5333,2023-04-16,18:00:00,137,98,39,FMN 03 Kolonel Silvertopstraat
651,Kolonel Silvertopstraat 5333,2023-04-16,19:00:00,130,72,58,FMN 03 Kolonel Silvertopstraat
651,Kolonel Silvertopstraat 5333,2023-04-16,20:00:00,105,59,46,FMN 03 Kolonel Silvertopstraat
651,Kolonel Silvertopstraat 5333,2023-04-16,21:00:00,69,43,26,FMN 03 Kolonel Silvertopstraat
651,Kolonel Silvertopstraat 5333,2023-04-16,22:00:00,85,50,35,FMN 03 Kolonel Silvertopstraat
651,Kolonel Silvertopstraat 5333,2023-04-16,23:00:00,45,23,22,FMN 03 Kolonel Silvertopstraat
651,Kolonel Silvertopstraat 5333,2023-04-17,00:00:00,29,12,17,FMN 03 Kolonel Silvertopstraat
651,Kolonel Silvertopstraat 5333,2023-04-17,01:00:00,33,15,18,FMN 03 Kolonel Silvertopstraat
651,Kolonel Silvertopstraat 5333,2023-04-17,02:00:00,18,10,8,FMN 03 Kolonel Silvertopstraat
651,Kolonel Silvertopstraat 5333,2023-04-17,03:00:00,12,7,5,FMN 03 Kolonel Silvertopstraat
651,Kolonel Silvertopstraat 5333,2023-04-17,04:00:00,20,13,7,FMN 03 Kolonel Silvertopstraat
651,Kolonel Silvertopstraat 5333,2023-04-17,05:00:00,60,38,22,FMN 03 Kolonel Silvertopstraat
651,Kolonel Silvertopstraat 5333,2023-04-17,06:00:00,123,101,22,FMN 03 Kolonel Silvertopstraat
651,Kolonel Silvertopstraat 5333,2023-04-17,07:00:00,369,315,54,FMN 03 Kolonel Silvertopstraat
651,Kolonel Silvertopstraat 5333,2023-04-17,08:00:00,647,554,93,FMN 03 Kolonel Silvertopstraat
651,Kolonel Silvertopstraat 5333,2023-04-17,09:00:00,191,154,37,FMN 03 Kolonel Silvertopstraat
651,Kolonel Silvertopstraat 5333,2023-04-17,10:00:00,170,127,43,FMN 03 Kolonel Silvertopstraat
651,Kolonel Silvertopstraat 5333,2023-04-17,11:00:00,110,81,29,FMN 03 Kolonel Silvertopstraat
651,Kolonel Silvertopstraat 5333,2023-04-17,12:00:00,212,155,57,FMN 03 Kolonel Silvertopstraat
651,Kolonel Silvertopstraat 5333,2023-04-17,13:00:00,189,133,56,FMN 03 Kolonel Silvertopstraat
651,Kolonel Silvertopstraat 5333,2023-04-17,14:00:00,184,130,54,FMN 03 Kolonel Silvertopstraat
651,Kolonel Silvertopstraat 5333,2023-04-17,15:00:00,302,171,131,FMN 03 Kolonel Silvertopstraat
651,Kolonel Silvertopstraat 5333,2023-04-17,16:00:00,399,268,131,FMN 03 Kolonel Silvertopstraat
651,Kolonel Silvertopstraat 5333,2023-04-17,17:00:00,424,252,172,FMN 03 Kolonel Silvertopstraat
651,Kolonel Silvertopstraat 5333,2023-04-17,18:00:00,288,173,115,FMN 03 Kolonel Silvertopstraat
651,Kolonel Silvertopstraat 5333,2023-04-17,19:00:00,178,103,75,FMN 03 Kolonel Silvertopstraat
651,Kolonel Silvertopstraat 5333,2023-04-17,20:00:00,171,83,88,FMN 03 Kolonel Silvertopstraat
651,Kolonel Silvertopstraat 5333,2023-04-17,21:00:00,108,56,52,FMN 03 Kolonel Silvertopstraat
651,Kolonel Silvertopstraat 5333,2023-04-17,22:00:00,122,67,55,FMN 03 Kolonel Silvertopstraat
651,Kolonel Silvertopstraat 5333,2023-04-17,23:00:00,50,23,27,FMN 03 Kolonel Silvertopstraat
651,Kolonel Silvertopstraat 5333,2023-04-18,00:00:00,45,29,16,FMN 03 Kolonel Silvertopstraat
651,Kolonel Silvertopstraat 5333,2023-04-18,01:00:00,29,11,18,FMN 03 Kolonel Silvertopstraat
651,Kolonel Silvertopstraat 5333,2023-04-18,02:00:00,16,4,12,FMN 03 Kolonel Silvertopstraat
651,Kolonel Silvertopstraat 5333,2023-04-18,03:00:00,14,8,6,FMN 03 Kolonel Silvertopstraat
651,Kolonel Silvertopstraat 5333,2023-04-18,04:00:00,28,19,9,FMN 03 Kolonel Silvertopstraat
651,Kolonel Silvertopstraat 5333,2023-04-18,05:00:00,67,46,21,FMN 03 Kolonel Silvertopstraat
651,Kolonel Silvertopstraat 5333,2023-04-18,06:00:00,147,121,26,FMN 03 Kolonel Silvertopstraat
651,Kolonel Silvertopstraat 5333,2023-04-18,07:00:00,386,325,61,FMN 03 Kolonel Silvertopstraat
651,Kolonel Silvertopstraat 5333,2023-04-18,08:00:00,681,595,86,FMN 03 Kolonel Silvertopstraat
651,Kolonel Silvertopstraat 5333,2023-04-18,09:00:00,249,195,54,FMN 03 Kolonel Silvertopstraat
651,Kolonel Silvertopstraat 5333,2023-04-18,10:00:00,185,147,38,FMN 03 Kolonel Silvertopstraat
651,Kolonel Silvertopstraat 5333,2023-04-18,11:00:00,167,123,44,FMN 03 Kolonel Silvertopstraat
651,Kolonel Silvertopstraat 5333,2023-04-18,12:00:00,212,144,68,FMN 03 Kolonel Silvertopstraat
651,Kolonel Silvertopstraat 5333,2023-04-18,13:00:00,208,142,66,FMN 03 Kolonel Silvertopstraat
651,Kolonel Silvertopstraat 5333,2023-04-18,14:00:00,179,116,63,FMN 03 Kolonel Silvertopstraat
651,Kolonel Silvertopstraat 5333,2023-04-18,15:00:00,293,185,108,FMN 03 Kolonel Silvertopstraat
651,Kolonel Silvertopstraat 5333,2023-04-18,16:00:00,427,266,161,FMN 03 Kolonel Silvertopstraat
651,Kolonel Silvertopstraat 5333,2023-04-18,17:00:00,414,249,165,FMN 03 Kolonel Silvertopstraat
651,Kolonel Silvertopstraat 5333,2023-04-18,18:00:00,308,198,110,FMN 03 Kolonel Silvertopstraat
651,Kolonel Silvertopstraat 5333,2023-04-18,19:00:00,238,147,91,FMN 03 Kolonel Silvertopstraat
651,Kolonel Silvertopstraat 5333,2023-04-18,20:00:00,175,107,68,FMN 03 Kolonel Silvertopstraat
651,Kolonel Silvertopstraat 5333,2023-04-18,21:00:00,117,63,54,FMN 03 Kolonel Silvertopstraat
651,Kolonel Silvertopstraat 5333,2023-04-18,22:00:00,131,72,59,FMN 03 Kolonel Silvertopstraat
651,Kolonel Silvertopstraat 5333,2023-04-18,23:00:00,73,30,43,FMN 03 Kolonel Silvertopstraat
651,Kolonel Silvertopstraat 5333,2023-04-19,00:00:00,37,20,17,FMN 03 Kolonel Silvertopstraat
651,Kolonel Silvertopstraat 5333,2023-04-19,01:00:00,28,12,16,FMN 03 Kolonel Silvertopstraat
651,Kolonel Silvertopstraat 5333,2023-04-19,02:00:00,16,8,8,FMN 03 Kolonel Silvertopstraat
651,Kolonel Silvertopstraat 5333,2023-04-19,03:00:00,11,2,9,FMN 03 Kolonel Silvertopstraat
651,Kolonel Silvertopstraat 5333,2023-04-19,04:00:00,26,19,7,FMN 03 Kolonel Silvertopstraat
651,Kolonel Silvertopstraat 5333,2023-04-19,05:00:00,51,31,20,FMN 03 Kolonel Silvertopstraat
651,Kolonel Silvertopstraat 5333,2023-04-19,06:00:00,139,115,24,FMN 03 Kolonel Silvertopstraat
651,Kolonel Silvertopstraat 5333,2023-04-19,07:00:00,338,277,61,FMN 03 Kolonel Silvertopstraat
651,Kolonel Silvertopstraat 5333,2023-04-19,08:00:00,624,531,93,FMN 03 Kolonel Silvertopstraat
651,Kolonel Silvertopstraat 5333,2023-04-19,09:00:00,220,175,45,FMN 03 Kolonel Silvertopstraat
651,Kolonel Silvertopstraat 5333,2023-04-19,10:00:00,175,133,42,FMN 03 Kolonel Silvertopstraat
651,Kolonel Silvertopstraat 5333,2023-04-19,11:00:00,179,139,40,FMN 03 Kolonel Silvertopstraat
651,Kolonel Silvertopstraat 5333,2023-04-19,12:00:00,346,239,107,FMN 03 Kolonel Silvertopstraat
651,Kolonel Silvertopstraat 5333,2023-04-19,13:00:00,274,177,97,FMN 03 Kolonel Silvertopstraat
651,Kolonel Silvertopstraat 5333,2023-04-19,14:00:00,227,158,69,FMN 03 Kolonel Silvertopstraat
651,Kolonel Silvertopstraat 5333,2023-04-19,15:00:00,184,126,58,FMN 03 Kolonel Silvertopstraat
651,Kolonel Silvertopstraat 5333,2023-04-19,16:00:00,330,234,96,FMN 03 Kolonel Silvertopstraat
651,Kolonel Silvertopstraat 5333,2023-04-19,17:00:00,376,261,115,FMN 03 Kolonel Silvertopstraat
651,Kolonel Silvertopstraat 5333,2023-04-19,18:00:00,343,225,118,FMN 03 Kolonel Silvertopstraat
651,Kolonel Silvertopstraat 5333,2023-04-19,19:00:00,205,124,81,FMN 03 Kolonel Silvertopstraat
651,Kolonel Silvertopstraat 5333,2023-04-19,20:00:00,190,114,76,FMN 03 Kolonel Silvertopstraat
651,Kolonel Silvertopstraat 5333,2023-04-19,21:00:00,112,70,42,FMN 03 Kolonel Silvertopstraat
651,Kolonel Silvertopstraat 5333,2023-04-19,22:00:00,139,77,62,FMN 03 Kolonel Silvertopstraat
651,Kolonel Silvertopstraat 5333,2023-04-19,23:00:00,83,30,53,FMN 03 Kolonel Silvertopstraat
651,Kolonel Silvertopstraat 5333,2023-04-20,00:00:00,43,28,15,FMN 03 Kolonel Silvertopstraat
651,Kolonel Silvertopstraat 5333,2023-04-20,01:00:00,25,9,16,FMN 03 Kolonel Silvertopstraat
651,Kolonel Silvertopstraat 5333,2023-04-20,02:00:00,23,15,8,FMN 03 Kolonel Silvertopstraat
651,Kolonel Silvertopstraat 5333,2023-04-20,03:00:00,16,5,11,FMN 03 Kolonel Silvertopstraat
651,Kolonel Silvertopstraat 5333,2023-04-20,04:00:00,22,19,3,FMN 03 Kolonel Silvertopstraat
651,Kolonel Silvertopstraat 5333,2023-04-20,05:00:00,54,33,21,FMN 03 Kolonel Silvertopstraat
651,Kolonel Silvertopstraat 5333,2023-04-20,06:00:00,125,103,22,FMN 03 Kolonel Silvertopstraat
651,Kolonel Silvertopstraat 5333,2023-04-20,07:00:00,357,284,73,FMN 03 Kolonel Silvertopstraat
651,Kolonel Silvertopstraat 5333,2023-04-20,08:00:00,625,538,87,FMN 03 Kolonel Silvertopstraat
651,Kolonel Silvertopstraat 5333,2023-04-20,09:00:00,252,205,47,FMN 03 Kolonel Silvertopstraat
651,Kolonel Silvertopstraat 5333,2023-04-20,10:00:00,178,141,37,FMN 03 Kolonel Silvertopstraat
651,Kolonel Silvertopstraat 5333,2023-04-20,11:00:00,138,108,30,FMN 03 Kolonel Silvertopstraat
651,Kolonel Silvertopstraat 5333,2023-04-20,12:00:00,210,148,62,FMN 03 Kolonel Silvertopstraat
651,Kolonel Silvertopstraat 5333,2023-04-20,13:00:00,194,134,60,FMN 03 Kolonel Silvertopstraat
651,Kolonel Silvertopstraat 5333,2023-04-20,14:00:00,176,99,77,FMN 03 Kolonel Silvertopstraat
651,Kolonel Silvertopstraat 5333,2023-04-20,15:00:00,270,151,119,FMN 03 Kolonel Silvertopstraat
651,Kolonel Silvertopstraat 5333,2023-04-20,16:00:00,376,233,143,FMN 03 Kolonel Silvertopstraat
651,Kolonel Silvertopstraat 5333,2023-04-20,17:00:00,350,235,115,FMN 03 Kolonel Silvertopstraat
651,Kolonel Silvertopstraat 5333,2023-04-20,18:00:00,315,192,123,FMN 03 Kolonel Silvertopstraat
651,Kolonel Silvertopstraat 5333,2023-04-20,19:00:00,187,121,66,FMN 03 Kolonel Silvertopstraat
651,Kolonel Silvertopstraat 5333,2023-04-20,20:00:00,164,95,69,FMN 03 Kolonel Silvertopstraat
651,Kolonel Silvertopstraat 5333,2023-04-20,21:00:00,126,67,59,FMN 03 Kolonel Silvertopstraat
651,Kolonel Silvertopstraat 5333,2023-04-20,22:00:00,125,65,60,FMN 03 Kolonel Silvertopstraat
651,Kolonel Silvertopstraat 5333,2023-04-20,23:00:00,92,41,51,FMN 03 Kolonel Silvertopstraat
651,Kolonel Silvertopstraat 5333,2023-04-21,00:00:00,41,17,24,FMN 03 Kolonel Silvertopstraat
651,Kolonel Silvertopstraat 5333,2023-04-21,01:00:00,22,13,9,FMN 03 Kolonel Silvertopstraat
651,Kolonel Silvertopstraat 5333,2023-04-21,02:00:00,26,17,9,FMN 03 Kolonel Silvertopstraat
651,Kolonel Silvertopstraat 5333,2023-04-21,03:00:00,12,6,6,FMN 03 Kolonel Silvertopstraat
651,Kolonel Silvertopstraat 5333,2023-04-21,04:00:00,30,18,12,FMN 03 Kolonel Silvertopstraat
651,Kolonel Silvertopstraat 5333,2023-04-21,05:00:00,50,33,17,FMN 03 Kolonel Silvertopstraat
651,Kolonel Silvertopstraat 5333,2023-04-21,06:00:00,112,87,25,FMN 03 Kolonel Silvertopstraat
651,Kolonel Silvertopstraat 5333,2023-04-21,07:00:00,259,198,61,FMN 03 Kolonel Silvertopstraat
651,Kolonel Silvertopstraat 5333,2023-04-21,08:00:00,538,456,82,FMN 03 Kolonel Silvertopstraat
651,Kolonel Silvertopstraat 5333,2023-04-21,09:00:00,223,173,50,FMN 03 Kolonel Silvertopstraat
651,Kolonel Silvertopstraat 5333,2023-04-21,10:00:00,177,144,33,FMN 03 Kolonel Silvertopstraat
651,Kolonel Silvertopstraat 5333,2023-04-21,11:00:00,182,129,53,FMN 03 Kolonel Silvertopstraat
651,Kolonel Silvertopstraat 5333,2023-04-21,12:00:00,224,154,70,FMN 03 Kolonel Silvertopstraat
651,Kolonel Silvertopstraat 5333,2023-04-21,13:00:00,233,153,80,FMN 03 Kolonel Silvertopstraat
651,Kolonel Silvertopstraat 5333,2023-04-21,14:00:00,228,148,80,FMN 03 Kolonel Silvertopstraat
651,Kolonel Silvertopstraat 5333,2023-04-21,15:00:00,289,189,100,FMN 03 Kolonel Silvertopstraat
651,Kolonel Silvertopstraat 5333,2023-04-21,16:00:00,369,242,127,FMN 03 Kolonel Silvertopstraat
651,Kolonel Silvertopstraat 5333,2023-04-21,17:00:00,350,233,117,FMN 03 Kolonel Silvertopstraat
651,Kolonel Silvertopstraat 5333,2023-04-21,18:00:00,316,213,103,FMN 03 Kolonel Silvertopstraat
651,Kolonel Silvertopstraat 5333,2023-04-21,19:00:00,241,165,76,FMN 03 Kolonel Silvertopstraat
651,Kolonel Silvertopstraat 5333,2023-04-21,20:00:00,156,94,62,FMN 03 Kolonel Silvertopstraat
651,Kolonel Silvertopstraat 5333,2023-04-21,21:00:00,149,99,50,FMN 03 Kolonel Silvertopstraat
651,Kolonel Silvertopstraat 5333,2023-04-21,22:00:00,147,93,54,FMN 03 Kolonel Silvertopstraat
651,Kolonel Silvertopstraat 5333,2023-04-21,23:00:00,100,49,51,FMN 03 Kolonel Silvertopstraat
651,Kolonel Silvertopstraat 5333,2023-04-22,00:00:00,75,26,49,FMN 03 Kolonel Silvertopstraat
651,Kolonel Silvertopstraat 5333,2023-04-22,01:00:00,74,27,47,FMN 03 Kolonel Silvertopstraat
651,Kolonel Silvertopstraat 5333,2023-04-22,02:00:00,56,21,35,FMN 03 Kolonel Silvertopstraat
651,Kolonel Silvertopstraat 5333,2023-04-22,03:00:00,50,28,22,FMN 03 Kolonel Silvertopstraat
651,Kolonel Silvertopstraat 5333,2023-04-22,04:00:00,58,38,20,FMN 03 Kolonel Silvertopstraat
651,Kolonel Silvertopstraat 5333,2023-04-22,05:00:00,25,13,12,FMN 03 Kolonel Silvertopstraat
651,Kolonel Silvertopstraat 5333,2023-04-22,06:00:00,32,26,6,FMN 03 Kolonel Silvertopstraat
651,Kolonel Silvertopstraat 5333,2023-04-22,07:00:00,34,23,11,FMN 03 Kolonel Silvertopstraat
651,Kolonel Silvertopstraat 5333,2023-04-22,08:00:00,82,64,18,FMN 03 Kolonel Silvertopstraat
651,Kolonel Silvertopstraat 5333,2023-04-22,09:00:00,164,133,31,FMN 03 Kolonel Silvertopstraat
651,Kolonel Silvertopstraat 5333,2023-04-22,10:00:00,150,120,30,FMN 03 Kolonel Silvertopstraat
651,Kolonel Silvertopstraat 5333,2023-04-22,11:00:00,160,115,45,FMN 03 Kolonel Silvertopstraat
651,Kolonel Silvertopstraat 5333,2023-04-22,12:00:00,132,87,45,FMN 03 Kolonel Silvertopstraat
651,Kolonel Silvertopstraat 5333,2023-04-22,13:00:00,116,81,35,FMN 03 Kolonel Silvertopstraat
651,Kolonel Silvertopstraat 5333,2023-04-22,14:00:00,142,88,54,FMN 03 Kolonel Silvertopstraat
651,Kolonel Silvertopstraat 5333,2023-04-22,15:00:00,107,79,28,FMN 03 Kolonel Silvertopstraat
651,Kolonel Silvertopstraat 5333,2023-04-22,16:00:00,118,76,42,FMN 03 Kolonel Silvertopstraat
651,Kolonel Silvertopstraat 5333,2023-04-22,17:00:00,126,77,49,FMN 03 Kolonel Silvertopstraat
651,Kolonel Silvertopstraat 5333,2023-04-22,18:00:00,171,120,51,FMN 03 Kolonel Silvertopstraat
651,Kolonel Silvertopstraat 5333,2023-04-22,19:00:00,150,110,40,FMN 03 Kolonel Silvertopstraat
651,Kolonel Silvertopstraat 5333,2023-04-22,20:00:00,109,72,37,FMN 03 Kolonel Silvertopstraat
651,Kolonel Silvertopstraat 5333,2023-04-22,21:00:00,97,63,34,FMN 03 Kolonel Silvertopstraat
651,Kolonel Silvertopstraat 5333,2023-04-22,22:00:00,98,65,33,FMN 03 Kolonel Silvertopstraat
651,Kolonel Silvertopstraat 5333,2023-04-22,23:00:00,93,54,39,FMN 03 Kolonel Silvertopstraat
651,Kolonel Silvertopstraat 5333,2023-04-23,00:00:00,69,30,39,FMN 03 Kolonel Silvertopstraat
651,Kolonel Silvertopstraat 5333,2023-04-23,01:00:00,49,25,24,FMN 03 Kolonel Silvertopstraat
651,Kolonel Silvertopstraat 5333,2023-04-23,02:00:00,36,12,24,FMN 03 Kolonel Silvertopstraat
651,Kolonel Silvertopstraat 5333,2023-04-23,03:00:00,16,2,14,FMN 03 Kolonel Silvertopstraat
651,Kolonel Silvertopstraat 5333,2023-04-23,04:00:00,23,8,15,FMN 03 Kolonel Silvertopstraat
651,Kolonel Silvertopstraat 5333,2023-04-23,05:00:00,19,14,5,FMN 03 Kolonel Silvertopstraat
651,Kolonel Silvertopstraat 5333,2023-04-23,06:00:00,30,23,7,FMN 03 Kolonel Silvertopstraat
651,Kolonel Silvertopstraat 5333,2023-04-23,07:00:00,31,22,9,FMN 03 Kolonel Silvertopstraat
651,Kolonel Silvertopstraat 5333,2023-04-23,08:00:00,54,44,10,FMN 03 Kolonel Silvertopstraat
651,Kolonel Silvertopstraat 5333,2023-04-23,09:00:00,130,108,22,FMN 03 Kolonel Silvertopstraat
651,Kolonel Silvertopstraat 5333,2023-04-23,10:00:00,165,132,33,FMN 03 Kolonel Silvertopstraat
651,Kolonel Silvertopstraat 5333,2023-04-23,11:00:00,222,173,49,FMN 03 Kolonel Silvertopstraat
651,Kolonel Silvertopstraat 5333,2023-04-23,12:00:00,237,193,44,FMN 03 Kolonel Silvertopstraat
651,Kolonel Silvertopstraat 5333,2023-04-23,13:00:00,274,229,45,FMN 03 Kolonel Silvertopstraat
651,Kolonel Silvertopstraat 5333,2023-04-23,14:00:00,293,236,57,FMN 03 Kolonel Silvertopstraat
651,Kolonel Silvertopstraat 5333,2023-04-23,15:00:00,188,108,80,FMN 03 Kolonel Silvertopstraat
651,Kolonel Silvertopstraat 5333,2023-04-23,16:00:00,160,84,76,FMN 03 Kolonel Silvertopstraat
651,Kolonel Silvertopstraat 5333,2023-04-23,17:00:00,142,79,63,FMN 03 Kolonel Silvertopstraat
651,Kolonel Silvertopstraat 5333,2023-04-23,18:00:00,153,74,79,FMN 03 Kolonel Silvertopstraat
651,Kolonel Silvertopstraat 5333,2023-04-23,19:00:00,102,59,43,FMN 03 Kolonel Silvertopstraat
651,Kolonel Silvertopstraat 5333,2023-04-23,20:00:00,92,51,41,FMN 03 Kolonel Silvertopstraat
651,Kolonel Silvertopstraat 5333,2023-04-23,21:00:00,71,36,35,FMN 03 Kolonel Silvertopstraat
651,Kolonel Silvertopstraat 5333,2023-04-23,22:00:00,53,24,29,FMN 03 Kolonel Silvertopstraat
651,Kolonel Silvertopstraat 5333,2023-04-23,23:00:00,32,17,15,FMN 03 Kolonel Silvertopstraat
651,Kolonel Silvertopstraat 5333,2023-04-24,00:00:00,20,11,9,FMN 03 Kolonel Silvertopstraat
651,Kolonel Silvertopstraat 5333,2023-04-24,01:00:00,12,5,7,FMN 03 Kolonel Silvertopstraat
651,Kolonel Silvertopstraat 5333,2023-04-24,02:00:00,12,6,6,FMN 03 Kolonel Silvertopstraat
651,Kolonel Silvertopstraat 5333,2023-04-24,03:00:00,11,3,8,FMN 03 Kolonel Silvertopstraat
651,Kolonel Silvertopstraat 5333,2023-04-24,04:00:00,19,15,4,FMN 03 Kolonel Silvertopstraat
651,Kolonel Silvertopstraat 5333,2023-04-24,05:00:00,44,28,16,FMN 03 Kolonel Silvertopstraat
651,Kolonel Silvertopstraat 5333,2023-04-24,06:00:00,97,81,16,FMN 03 Kolonel Silvertopstraat
651,Kolonel Silvertopstraat 5333,2023-04-24,07:00:00,258,204,54,FMN 03 Kolonel Silvertopstraat
651,Kolonel Silvertopstraat 5333,2023-04-24,08:00:00,482,413,69,FMN 03 Kolonel Silvertopstraat
651,Kolonel Silvertopstraat 5333,2023-04-24,09:00:00,179,137,42,FMN 03 Kolonel Silvertopstraat
651,Kolonel Silvertopstraat 5333,2023-04-24,10:00:00,151,114,37,FMN 03 Kolonel Silvertopstraat
651,Kolonel Silvertopstraat 5333,2023-04-24,11:00:00,101,78,23,FMN 03 Kolonel Silvertopstraat
651,Kolonel Silvertopstraat 5333,2023-04-24,12:00:00,172,125,47,FMN 03 Kolonel Silvertopstraat
651,Kolonel Silvertopstraat 5333,2023-04-24,13:00:00,170,112,58,FMN 03 Kolonel Silvertopstraat
651,Kolonel Silvertopstraat 5333,2023-04-24,14:00:00,167,117,50,FMN 03 Kolonel Silvertopstraat
651,Kolonel Silvertopstraat 5333,2023-04-24,15:00:00,247,153,94,FMN 03 Kolonel Silvertopstraat
651,Kolonel Silvertopstraat 5333,2023-04-24,16:00:00,325,211,114,FMN 03 Kolonel Silvertopstraat
651,Kolonel Silvertopstraat 5333,2023-04-24,17:00:00,363,248,115,FMN 03 Kolonel Silvertopstraat
651,Kolonel Silvertopstraat 5333,2023-04-24,18:00:00,253,169,84,FMN 03 Kolonel Silvertopstraat
651,Kolonel Silvertopstraat 5333,2023-04-24,19:00:00,189,123,66,FMN 03 Kolonel Silvertopstraat
651,Kolonel Silvertopstraat 5333,2023-04-24,20:00:00,140,76,64,FMN 03 Kolonel Silvertopstraat
651,Kolonel Silvertopstraat 5333,2023-04-24,21:00:00,124,51,73,FMN 03 Kolonel Silvertopstraat
651,Kolonel Silvertopstraat 5333,2023-04-24,22:00:00,103,52,51,FMN 03 Kolonel Silvertopstraat
651,Kolonel Silvertopstraat 5333,2023-04-24,23:00:00,51,26,25,FMN 03 Kolonel Silvertopstraat
651,Kolonel Silvertopstraat 5333,2023-04-25,00:00:00,45,24,21,FMN 03 Kolonel Silvertopstraat
651,Kolonel Silvertopstraat 5333,2023-04-25,01:00:00,14,5,9,FMN 03 Kolonel Silvertopstraat
651,Kolonel Silvertopstraat 5333,2023-04-25,02:00:00,8,3,5,FMN 03 Kolonel Silvertopstraat
651,Kolonel Silvertopstraat 5333,2023-04-25,03:00:00,12,5,7,FMN 03 Kolonel Silvertopstraat
651,Kolonel Silvertopstraat 5333,2023-04-25,04:00:00,27,21,6,FMN 03 Kolonel Silvertopstraat
651,Kolonel Silvertopstraat 5333,2023-04-25,05:00:00,54,34,20,FMN 03 Kolonel Silvertopstraat
651,Kolonel Silvertopstraat 5333,2023-04-25,06:00:00,136,106,30,FMN 03 Kolonel Silvertopstraat
651,Kolonel Silvertopstraat 5333,2023-04-25,07:00:00,380,313,67,FMN 03 Kolonel Silvertopstraat
651,Kolonel Silvertopstraat 5333,2023-04-25,08:00:00,706,611,95,FMN 03 Kolonel Silvertopstraat
651,Kolonel Silvertopstraat 5333,2023-04-25,09:00:00,243,189,54,FMN 03 Kolonel Silvertopstraat
651,Kolonel Silvertopstraat 5333,2023-04-25,10:00:00,152,123,29,FMN 03 Kolonel Silvertopstraat
651,Kolonel Silvertopstraat 5333,2023-04-25,11:00:00,140,106,34,FMN 03 Kolonel Silvertopstraat
651,Kolonel Silvertopstraat 5333,2023-04-25,12:00:00,241,171,70,FMN 03 Kolonel Silvertopstraat
651,Kolonel Silvertopstraat 5333,2023-04-25,13:00:00,169,109,60,FMN 03 Kolonel Silvertopstraat
651,Kolonel Silvertopstraat 5333,2023-04-25,14:00:00,183,124,59,FMN 03 Kolonel Silvertopstraat
651,Kolonel Silvertopstraat 5333,2023-04-25,15:00:00,274,178,96,FMN 03 Kolonel Silvertopstraat
651,Kolonel Silvertopstraat 5333,2023-04-25,16:00:00,400,255,145,FMN 03 Kolonel Silvertopstraat
651,Kolonel Silvertopstraat 5333,2023-04-25,17:00:00,389,250,139,FMN 03 Kolonel Silvertopstraat
651,Kolonel Silvertopstraat 5333,2023-04-25,18:00:00,305,184,121,FMN 03 Kolonel Silvertopstraat
651,Kolonel Silvertopstraat 5333,2023-04-25,19:00:00,186,115,71,FMN 03 Kolonel Silvertopstraat
651,Kolonel Silvertopstraat 5333,2023-04-25,20:00:00,161,100,61,FMN 03 Kolonel Silvertopstraat
651,Kolonel Silvertopstraat 5333,2023-04-25,21:00:00,128,68,60,FMN 03 Kolonel Silvertopstraat
651,Kolonel Silvertopstraat 5333,2023-04-25,22:00:00,119,61,58,FMN 03 Kolonel Silvertopstraat
651,Kolonel Silvertopstraat 5333,2023-04-25,23:00:00,83,28,55,FMN 03 Kolonel Silvertopstraat
651,Kolonel Silvertopstraat 5333,2023-04-26,00:00:00,42,25,17,FMN 03 Kolonel Silvertopstraat
651,Kolonel Silvertopstraat 5333,2023-04-26,01:00:00,22,11,11,FMN 03 Kolonel Silvertopstraat
651,Kolonel Silvertopstraat 5333,2023-04-26,02:00:00,15,7,8,FMN 03 Kolonel Silvertopstraat
651,Kolonel Silvertopstraat 5333,2023-04-26,03:00:00,14,4,10,FMN 03 Kolonel Silvertopstraat
651,Kolonel Silvertopstraat 5333,2023-04-26,04:00:00,23,15,8,FMN 03 Kolonel Silvertopstraat
651,Kolonel Silvertopstraat 5333,2023-04-26,05:00:00,61,37,24,FMN 03 Kolonel Silvertopstraat
651,Kolonel Silvertopstraat 5333,2023-04-26,06:00:00,116,88,28,FMN 03 Kolonel Silvertopstraat
651,Kolonel Silvertopstraat 5333,2023-04-26,07:00:00,350,280,70,FMN 03 Kolonel Silvertopstraat
651,Kolonel Silvertopstraat 5333,2023-04-26,08:00:00,605,516,89,FMN 03 Kolonel Silvertopstraat
651,Kolonel Silvertopstraat 5333,2023-04-26,09:00:00,211,176,35,FMN 03 Kolonel Silvertopstraat
651,Kolonel Silvertopstraat 5333,2023-04-26,10:00:00,153,122,31,FMN 03 Kolonel Silvertopstraat
651,Kolonel Silvertopstraat 5333,2023-04-26,11:00:00,171,118,53,FMN 03 Kolonel Silvertopstraat
651,Kolonel Silvertopstraat 5333,2023-04-26,12:00:00,365,236,129,FMN 03 Kolonel Silvertopstraat
651,Kolonel Silvertopstraat 5333,2023-04-26,13:00:00,255,163,92,FMN 03 Kolonel Silvertopstraat
651,Kolonel Silvertopstraat 5333,2023-04-26,14:00:00,224,144,80,FMN 03 Kolonel Silvertopstraat
651,Kolonel Silvertopstraat 5333,2023-04-26,15:00:00,260,177,83,FMN 03 Kolonel Silvertopstraat
651,Kolonel Silvertopstraat 5333,2023-04-26,16:00:00,299,199,100,FMN 03 Kolonel Silvertopstraat
651,Kolonel Silvertopstraat 5333,2023-04-26,17:00:00,375,250,125,FMN 03 Kolonel Silvertopstraat
651,Kolonel Silvertopstraat 5333,2023-04-26,18:00:00,275,193,82,FMN 03 Kolonel Silvertopstraat
651,Kolonel Silvertopstraat 5333,2023-04-26,19:00:00,237,163,74,FMN 03 Kolonel Silvertopstraat
651,Kolonel Silvertopstraat 5333,2023-04-26,20:00:00,178,105,73,FMN 03 Kolonel Silvertopstraat
651,Kolonel Silvertopstraat 5333,2023-04-26,21:00:00,125,57,68,FMN 03 Kolonel Silvertopstraat
651,Kolonel Silvertopstraat 5333,2023-04-26,22:00:00,116,51,65,FMN 03 Kolonel Silvertopstraat
651,Kolonel Silvertopstraat 5333,2023-04-26,23:00:00,81,36,45,FMN 03 Kolonel Silvertopstraat
651,Kolonel Silvertopstraat 5333,2023-04-27,00:00:00,33,20,13,FMN 03 Kolonel Silvertopstraat
651,Kolonel Silvertopstraat 5333,2023-04-27,01:00:00,31,10,21,FMN 03 Kolonel Silvertopstraat
651,Kolonel Silvertopstraat 5333,2023-04-27,02:00:00,18,5,13,FMN 03 Kolonel Silvertopstraat
651,Kolonel Silvertopstraat 5333,2023-04-27,03:00:00,16,8,8,FMN 03 Kolonel Silvertopstraat
651,Kolonel Silvertopstraat 5333,2023-04-27,04:00:00,22,14,8,FMN 03 Kolonel Silvertopstraat
651,Kolonel Silvertopstraat 5333,2023-04-27,05:00:00,59,39,20,FMN 03 Kolonel Silvertopstraat
651,Kolonel Silvertopstraat 5333,2023-04-27,06:00:00,135,105,30,FMN 03 Kolonel Silvertopstraat
651,Kolonel Silvertopstraat 5333,2023-04-27,07:00:00,376,313,63,FMN 03 Kolonel Silvertopstraat
651,Kolonel Silvertopstraat 5333,2023-04-27,08:00:00,680,591,89,FMN 03 Kolonel Silvertopstraat
651,Kolonel Silvertopstraat 5333,2023-04-27,09:00:00,262,205,57,FMN 03 Kolonel Silvertopstraat
651,Kolonel Silvertopstraat 5333,2023-04-27,10:00:00,175,138,37,FMN 03 Kolonel Silvertopstraat
651,Kolonel Silvertopstraat 5333,2023-04-27,11:00:00,156,118,38,FMN 03 Kolonel Silvertopstraat
651,Kolonel Silvertopstraat 5333,2023-04-27,12:00:00,253,184,69,FMN 03 Kolonel Silvertopstraat
651,Kolonel Silvertopstraat 5333,2023-04-27,13:00:00,209,151,58,FMN 03 Kolonel Silvertopstraat
651,Kolonel Silvertopstraat 5333,2023-04-27,14:00:00,208,139,69,FMN 03 Kolonel Silvertopstraat
651,Kolonel Silvertopstraat 5333,2023-04-27,15:00:00,316,185,131,FMN 03 Kolonel Silvertopstraat
651,Kolonel Silvertopstraat 5333,2023-04-27,16:00:00,436,297,139,FMN 03 Kolonel Silvertopstraat
651,Kolonel Silvertopstraat 5333,2023-04-27,17:00:00,389,228,161,FMN 03 Kolonel Silvertopstraat
651,Kolonel Silvertopstraat 5333,2023-04-27,18:00:00,351,226,125,FMN 03 Kolonel Silvertopstraat
651,Kolonel Silvertopstraat 5333,2023-04-27,19:00:00,208,155,53,FMN 03 Kolonel Silvertopstraat
651,Kolonel Silvertopstraat 5333,2023-04-27,20:00:00,191,116,75,FMN 03 Kolonel Silvertopstraat
651,Kolonel Silvertopstraat 5333,2023-04-27,21:00:00,146,70,76,FMN 03 Kolonel Silvertopstraat
651,Kolonel Silvertopstraat 5333,2023-04-27,22:00:00,131,67,64,FMN 03 Kolonel Silvertopstraat
651,Kolonel Silvertopstraat 5333,2023-04-27,23:00:00,72,29,43,FMN 03 Kolonel Silvertopstraat
651,Kolonel Silvertopstraat 5333,2023-04-28,00:00:00,48,24,24,FMN 03 Kolonel Silvertopstraat
651,Kolonel Silvertopstraat 5333,2023-04-28,01:00:00,22,11,11,FMN 03 Kolonel Silvertopstraat
651,Kolonel Silvertopstraat 5333,2023-04-28,02:00:00,12,9,3,FMN 03 Kolonel Silvertopstraat
651,Kolonel Silvertopstraat 5333,2023-04-28,03:00:00,13,6,7,FMN 03 Kolonel Silvertopstraat
651,Kolonel Silvertopstraat 5333,2023-04-28,04:00:00,21,15,6,FMN 03 Kolonel Silvertopstraat
651,Kolonel Silvertopstraat 5333,2023-04-28,05:00:00,55,29,26,FMN 03 Kolonel Silvertopstraat
651,Kolonel Silvertopstraat 5333,2023-04-28,06:00:00,119,88,31,FMN 03 Kolonel Silvertopstraat
651,Kolonel Silvertopstraat 5333,2023-04-28,07:00:00,319,265,54,FMN 03 Kolonel Silvertopstraat
651,Kolonel Silvertopstraat 5333,2023-04-28,08:00:00,516,436,80,FMN 03 Kolonel Silvertopstraat
651,Kolonel Silvertopstraat 5333,2023-04-28,09:00:00,194,164,30,FMN 03 Kolonel Silvertopstraat
651,Kolonel Silvertopstraat 5333,2023-04-28,10:00:00,160,116,44,FMN 03 Kolonel Silvertopstraat
651,Kolonel Silvertopstraat 5333,2023-04-28,11:00:00,172,111,61,FMN 03 Kolonel Silvertopstraat
651,Kolonel Silvertopstraat 5333,2023-04-28,12:00:00,217,160,57,FMN 03 Kolonel Silvertopstraat
651,Kolonel Silvertopstraat 5333,2023-04-28,13:00:00,204,150,54,FMN 03 Kolonel Silvertopstraat
651,Kolonel Silvertopstraat 5333,2023-04-28,14:00:00,221,141,80,FMN 03 Kolonel Silvertopstraat
651,Kolonel Silvertopstraat 5333,2023-04-28,15:00:00,341,209,132,FMN 03 Kolonel Silvertopstraat
651,Kolonel Silvertopstraat 5333,2023-04-28,16:00:00,354,230,124,FMN 03 Kolonel Silvertopstraat
651,Kolonel Silvertopstraat 5333,2023-04-28,17:00:00,321,196,125,FMN 03 Kolonel Silvertopstraat
651,Kolonel Silvertopstraat 5333,2023-04-28,18:00:00,283,204,79,FMN 03 Kolonel Silvertopstraat
651,Kolonel Silvertopstraat 5333,2023-04-28,19:00:00,189,116,73,FMN 03 Kolonel Silvertopstraat
651,Kolonel Silvertopstraat 5333,2023-04-28,20:00:00,154,98,56,FMN 03 Kolonel Silvertopstraat
651,Kolonel Silvertopstraat 5333,2023-04-28,21:00:00,141,77,64,FMN 03 Kolonel Silvertopstraat
651,Kolonel Silvertopstraat 5333,2023-04-28,22:00:00,120,69,51,FMN 03 Kolonel Silvertopstraat
651,Kolonel Silvertopstraat 5333,2023-04-28,23:00:00,110,47,63,FMN 03 Kolonel Silvertopstraat
651,Kolonel Silvertopstraat 5333,2023-04-29,00:00:00,72,26,46,FMN 03 Kolonel Silvertopstraat
651,Kolonel Silvertopstraat 5333,2023-04-29,01:00:00,52,31,21,FMN 03 Kolonel Silvertopstraat
651,Kolonel Silvertopstraat 5333,2023-04-29,02:00:00,48,29,19,FMN 03 Kolonel Silvertopstraat
651,Kolonel Silvertopstraat 5333,2023-04-29,03:00:00,32,14,18,FMN 03 Kolonel Silvertopstraat
651,Kolonel Silvertopstraat 5333,2023-04-29,04:00:00,26,12,14,FMN 03 Kolonel Silvertopstraat
651,Kolonel Silvertopstraat 5333,2023-04-29,05:00:00,31,17,14,FMN 03 Kolonel Silvertopstraat
651,Kolonel Silvertopstraat 5333,2023-04-29,06:00:00,35,20,15,FMN 03 Kolonel Silvertopstraat
651,Kolonel Silvertopstraat 5333,2023-04-29,07:00:00,43,31,12,FMN 03 Kolonel Silvertopstraat
651,Kolonel Silvertopstraat 5333,2023-04-29,08:00:00,79,60,19,FMN 03 Kolonel Silvertopstraat
651,Kolonel Silvertopstraat 5333,2023-04-29,09:00:00,157,130,27,FMN 03 Kolonel Silvertopstraat
651,Kolonel Silvertopstraat 5333,2023-04-29,10:00:00,158,125,33,FMN 03 Kolonel Silvertopstraat
651,Kolonel Silvertopstraat 5333,2023-04-29,11:00:00,165,130,35,FMN 03 Kolonel Silvertopstraat
651,Kolonel Silvertopstraat 5333,2023-04-29,12:00:00,175,123,52,FMN 03 Kolonel Silvertopstraat
651,Kolonel Silvertopstraat 5333,2023-04-29,13:00:00,181,128,53,FMN 03 Kolonel Silvertopstraat
651,Kolonel Silvertopstraat 5333,2023-04-29,14:00:00,162,108,54,FMN 03 Kolonel Silvertopstraat
651,Kolonel Silvertopstraat 5333,2023-04-29,15:00:00,158,113,45,FMN 03 Kolonel Silvertopstraat
651,Kolonel Silvertopstraat 5333,2023-04-29,16:00:00,185,134,51,FMN 03 Kolonel Silvertopstraat
651,Kolonel Silvertopstraat 5333,2023-04-29,17:00:00,197,143,54,FMN 03 Kolonel Silvertopstraat
651,Kolonel Silvertopstraat 5333,2023-04-29,18:00:00,201,123,78,FMN 03 Kolonel Silvertopstraat
651,Kolonel Silvertopstraat 5333,2023-04-29,19:00:00,199,146,53,FMN 03 Kolonel Silvertopstraat
651,Kolonel Silvertopstraat 5333,2023-04-29,20:00:00,151,99,52,FMN 03 Kolonel Silvertopstraat
651,Kolonel Silvertopstraat 5333,2023-04-29,21:00:00,101,55,46,FMN 03 Kolonel Silvertopstraat
651,Kolonel Silvertopstraat 5333,2023-04-29,22:00:00,110,68,42,FMN 03 Kolonel Silvertopstraat
651,Kolonel Silvertopstraat 5333,2023-04-29,23:00:00,88,33,55,FMN 03 Kolonel Silvertopstraat
651,Kolonel Silvertopstraat 5333,2023-04-30,00:00:00,74,27,47,FMN 03 Kolonel Silvertopstraat
651,Kolonel Silvertopstraat 5333,2023-04-30,01:00:00,54,24,30,FMN 03 Kolonel Silvertopstraat
651,Kolonel Silvertopstraat 5333,2023-04-30,02:00:00,29,12,17,FMN 03 Kolonel Silvertopstraat
651,Kolonel Silvertopstraat 5333,2023-04-30,03:00:00,36,15,21,FMN 03 Kolonel Silvertopstraat
651,Kolonel Silvertopstraat 5333,2023-04-30,04:00:00,23,7,16,FMN 03 Kolonel Silvertopstraat
651,Kolonel Silvertopstraat 5333,2023-04-30,05:00:00,33,21,12,FMN 03 Kolonel Silvertopstraat
651,Kolonel Silvertopstraat 5333,2023-04-30,06:00:00,51,41,10,FMN 03 Kolonel Silvertopstraat
651,Kolonel Silvertopstraat 5333,2023-04-30,07:00:00,27,18,9,FMN 03 Kolonel Silvertopstraat
651,Kolonel Silvertopstraat 5333,2023-04-30,08:00:00,70,54,16,FMN 03 Kolonel Silvertopstraat
651,Kolonel Silvertopstraat 5333,2023-04-30,09:00:00,108,88,20,FMN 03 Kolonel Silvertopstraat
651,Kolonel Silvertopstraat 5333,2023-04-30,10:00:00,177,140,37,FMN 03 Kolonel Silvertopstraat
651,Kolonel Silvertopstraat 5333,2023-04-30,11:00:00,175,147,28,FMN 03 Kolonel Silvertopstraat
651,Kolonel Silvertopstraat 5333,2023-04-30,12:00:00,161,122,39,FMN 03 Kolonel Silvertopstraat
651,Kolonel Silvertopstraat 5333,2023-04-30,13:00:00,202,149,53,FMN 03 Kolonel Silvertopstraat
651,Kolonel Silvertopstraat 5333,2023-04-30,14:00:00,194,137,57,FMN 03 Kolonel Silvertopstraat
651,Kolonel Silvertopstraat 5333,2023-04-30,15:00:00,59,40,19,FMN 03 Kolonel Silvertopstraat
651,Kolonel Silvertopstraat 5333,2023-04-30,16:00:00,113,87,26,FMN 03 Kolonel Silvertopstraat
651,Kolonel Silvertopstraat 5333,2023-04-30,17:00:00,169,109,60,FMN 03 Kolonel Silvertopstraat
651,Kolonel Silvertopstraat 5333,2023-04-30,18:00:00,230,166,64,FMN 03 Kolonel Silvertopstraat
651,Kolonel Silvertopstraat 5333,2023-04-30,19:00:00,159,106,53,FMN 03 Kolonel Silvertopstraat
651,Kolonel Silvertopstraat 5333,2023-04-30,20:00:00,172,99,73,FMN 03 Kolonel Silvertopstraat
651,Kolonel Silvertopstraat 5333,2023-04-30,21:00:00,133,79,54,FMN 03 Kolonel Silvertopstraat
651,Kolonel Silvertopstraat 5333,2023-04-30,22:00:00,97,58,39,FMN 03 Kolonel Silvertopstraat
651,Kolonel Silvertopstraat 5333,2023-04-30,23:00:00,95,50,45,FMN 03 Kolonel Silvertopstraat
651,Kolonel Silvertopstraat 5333,2023-05-01,00:00:00,60,32,28,FMN 03 Kolonel Silvertopstraat
651,Kolonel Silvertopstraat 5333,2023-05-01,01:00:00,55,26,29,FMN 03 Kolonel Silvertopstraat
651,Kolonel Silvertopstraat 5333,2023-05-01,02:00:00,36,13,23,FMN 03 Kolonel Silvertopstraat
651,Kolonel Silvertopstraat 5333,2023-05-01,03:00:00,19,3,16,FMN 03 Kolonel Silvertopstraat
651,Kolonel Silvertopstraat 5333,2023-05-01,04:00:00,24,18,6,FMN 03 Kolonel Silvertopstraat
651,Kolonel Silvertopstraat 5333,2023-05-01,05:00:00,28,14,14,FMN 03 Kolonel Silvertopstraat
651,Kolonel Silvertopstraat 5333,2023-05-01,06:00:00,39,26,13,FMN 03 Kolonel Silvertopstraat
651,Kolonel Silvertopstraat 5333,2023-05-01,07:00:00,37,26,11,FMN 03 Kolonel Silvertopstraat
651,Kolonel Silvertopstraat 5333,2023-05-01,08:00:00,54,41,13,FMN 03 Kolonel Silvertopstraat
651,Kolonel Silvertopstraat 5333,2023-05-01,09:00:00,116,104,12,FMN 03 Kolonel Silvertopstraat
651,Kolonel Silvertopstraat 5333,2023-05-01,10:00:00,151,127,24,FMN 03 Kolonel Silvertopstraat
651,Kolonel Silvertopstraat 5333,2023-05-01,11:00:00,133,94,39,FMN 03 Kolonel Silvertopstraat
651,Kolonel Silvertopstraat 5333,2023-05-01,12:00:00,137,100,37,FMN 03 Kolonel Silvertopstraat
651,Kolonel Silvertopstraat 5333,2023-05-01,13:00:00,143,97,46,FMN 03 Kolonel Silvertopstraat
651,Kolonel Silvertopstraat 5333,2023-05-01,14:00:00,172,121,51,FMN 03 Kolonel Silvertopstraat
651,Kolonel Silvertopstraat 5333,2023-05-01,15:00:00,157,91,66,FMN 03 Kolonel Silvertopstraat
651,Kolonel Silvertopstraat 5333,2023-05-01,16:00:00,141,99,42,FMN 03 Kolonel Silvertopstraat
651,Kolonel Silvertopstraat 5333,2023-05-01,17:00:00,215,133,82,FMN 03 Kolonel Silvertopstraat
651,Kolonel Silvertopstraat 5333,2023-05-01,18:00:00,154,91,63,FMN 03 Kolonel Silvertopstraat
651,Kolonel Silvertopstraat 5333,2023-05-01,19:00:00,165,103,62,FMN 03 Kolonel Silvertopstraat
651,Kolonel Silvertopstraat 5333,2023-05-01,20:00:00,146,79,67,FMN 03 Kolonel Silvertopstraat
651,Kolonel Silvertopstraat 5333,2023-05-01,21:00:00,118,55,63,FMN 03 Kolonel Silvertopstraat
651,Kolonel Silvertopstraat 5333,2023-05-01,22:00:00,97,46,51,FMN 03 Kolonel Silvertopstraat
651,Kolonel Silvertopstraat 5333,2023-05-01,23:00:00,60,36,24,FMN 03 Kolonel Silvertopstraat
651,Kolonel Silvertopstraat 5333,2023-05-02,00:00:00,21,9,12,FMN 03 Kolonel Silvertopstraat
651,Kolonel Silvertopstraat 5333,2023-05-02,01:00:00,12,4,8,FMN 03 Kolonel Silvertopstraat
651,Kolonel Silvertopstraat 5333,2023-05-02,02:00:00,5,3,2,FMN 03 Kolonel Silvertopstraat
651,Kolonel Silvertopstraat 5333,2023-05-02,03:00:00,9,4,5,FMN 03 Kolonel Silvertopstraat
651,Kolonel Silvertopstraat 5333,2023-05-02,04:00:00,30,22,8,FMN 03 Kolonel Silvertopstraat
651,Kolonel Silvertopstraat 5333,2023-05-02,05:00:00,68,44,24,FMN 03 Kolonel Silvertopstraat
651,Kolonel Silvertopstraat 5333,2023-05-02,06:00:00,130,100,30,FMN 03 Kolonel Silvertopstraat
651,Kolonel Silvertopstraat 5333,2023-05-02,07:00:00,388,320,68,FMN 03 Kolonel Silvertopstraat
651,Kolonel Silvertopstraat 5333,2023-05-02,08:00:00,690,618,72,FMN 03 Kolonel Silvertopstraat
651,Kolonel Silvertopstraat 5333,2023-05-02,09:00:00,258,209,49,FMN 03 Kolonel Silvertopstraat
651,Kolonel Silvertopstraat 5333,2023-05-02,10:00:00,194,147,47,FMN 03 Kolonel Silvertopstraat
651,Kolonel Silvertopstraat 5333,2023-05-02,11:00:00,167,126,41,FMN 03 Kolonel Silvertopstraat
651,Kolonel Silvertopstraat 5333,2023-05-02,12:00:00,239,173,66,FMN 03 Kolonel Silvertopstraat
651,Kolonel Silvertopstraat 5333,2023-05-02,13:00:00,210,155,55,FMN 03 Kolonel Silvertopstraat
651,Kolonel Silvertopstraat 5333,2023-05-02,14:00:00,214,148,66,FMN 03 Kolonel Silvertopstraat
651,Kolonel Silvertopstraat 5333,2023-05-02,15:00:00,302,185,117,FMN 03 Kolonel Silvertopstraat
651,Kolonel Silvertopstraat 5333,2023-05-02,16:00:00,369,231,138,FMN 03 Kolonel Silvertopstraat
651,Kolonel Silvertopstraat 5333,2023-05-02,17:00:00,457,296,161,FMN 03 Kolonel Silvertopstraat
651,Kolonel Silvertopstraat 5333,2023-05-02,18:00:00,334,215,119,FMN 03 Kolonel Silvertopstraat
651,Kolonel Silvertopstraat 5333,2023-05-02,19:00:00,241,152,89,FMN 03 Kolonel Silvertopstraat
651,Kolonel Silvertopstraat 5333,2023-05-02,20:00:00,170,105,65,FMN 03 Kolonel Silvertopstraat
651,Kolonel Silvertopstraat 5333,2023-05-02,21:00:00,150,77,73,FMN 03 Kolonel Silvertopstraat
651,Kolonel Silvertopstraat 5333,2023-05-02,22:00:00,125,68,57,FMN 03 Kolonel Silvertopstraat
651,Kolonel Silvertopstraat 5333,2023-05-02,23:00:00,63,30,33,FMN 03 Kolonel Silvertopstraat
651,Kolonel Silvertopstraat 5333,2023-05-03,00:00:00,43,21,22,FMN 03 Kolonel Silvertopstraat
651,Kolonel Silvertopstraat 5333,2023-05-03,01:00:00,23,9,14,FMN 03 Kolonel Silvertopstraat
651,Kolonel Silvertopstraat 5333,2023-05-03,02:00:00,12,9,3,FMN 03 Kolonel Silvertopstraat
651,Kolonel Silvertopstraat 5333,2023-05-03,03:00:00,10,6,4,FMN 03 Kolonel Silvertopstraat
651,Kolonel Silvertopstraat 5333,2023-05-03,04:00:00,30,21,9,FMN 03 Kolonel Silvertopstraat
651,Kolonel Silvertopstraat 5333,2023-05-03,05:00:00,64,39,25,FMN 03 Kolonel Silvertopstraat
651,Kolonel Silvertopstraat 5333,2023-05-03,06:00:00,137,104,33,FMN 03 Kolonel Silvertopstraat
651,Kolonel Silvertopstraat 5333,2023-05-03,07:00:00,373,302,71,FMN 03 Kolonel Silvertopstraat
651,Kolonel Silvertopstraat 5333,2023-05-03,08:00:00,631,553,78,FMN 03 Kolonel Silvertopstraat
651,Kolonel Silvertopstraat 5333,2023-05-03,09:00:00,240,195,45,FMN 03 Kolonel Silvertopstraat
651,Kolonel Silvertopstraat 5333,2023-05-03,10:00:00,183,133,50,FMN 03 Kolonel Silvertopstraat
651,Kolonel Silvertopstraat 5333,2023-05-03,11:00:00,189,148,41,FMN 03 Kolonel Silvertopstraat
651,Kolonel Silvertopstraat 5333,2023-05-03,12:00:00,374,240,134,FMN 03 Kolonel Silvertopstraat
651,Kolonel Silvertopstraat 5333,2023-05-03,13:00:00,277,184,93,FMN 03 Kolonel Silvertopstraat
651,Kolonel Silvertopstraat 5333,2023-05-03,14:00:00,229,166,63,FMN 03 Kolonel Silvertopstraat
651,Kolonel Silvertopstraat 5333,2023-05-03,15:00:00,223,155,68,FMN 03 Kolonel Silvertopstraat
651,Kolonel Silvertopstraat 5333,2023-05-03,16:00:00,333,235,98,FMN 03 Kolonel Silvertopstraat
651,Kolonel Silvertopstraat 5333,2023-05-03,17:00:00,423,292,131,FMN 03 Kolonel Silvertopstraat
651,Kolonel Silvertopstraat 5333,2023-05-03,18:00:00,331,214,117,FMN 03 Kolonel Silvertopstraat
651,Kolonel Silvertopstraat 5333,2023-05-03,19:00:00,245,164,81,FMN 03 Kolonel Silvertopstraat
651,Kolonel Silvertopstraat 5333,2023-05-03,20:00:00,215,132,83,FMN 03 Kolonel Silvertopstraat
651,Kolonel Silvertopstraat 5333,2023-05-03,21:00:00,144,82,62,FMN 03 Kolonel Silvertopstraat
651,Kolonel Silvertopstraat 5333,2023-05-03,22:00:00,150,61,89,FMN 03 Kolonel Silvertopstraat
651,Kolonel Silvertopstraat 5333,2023-05-03,23:00:00,80,34,46,FMN 03 Kolonel Silvertopstraat
651,Kolonel Silvertopstraat 5333,2023-05-04,00:00:00,32,14,18,FMN 03 Kolonel Silvertopstraat
651,Kolonel Silvertopstraat 5333,2023-05-04,01:00:00,27,15,12,FMN 03 Kolonel Silvertopstraat
651,Kolonel Silvertopstraat 5333,2023-05-04,02:00:00,8,4,4,FMN 03 Kolonel Silvertopstraat
651,Kolonel Silvertopstraat 5333,2023-05-04,03:00:00,11,6,5,FMN 03 Kolonel Silvertopstraat
651,Kolonel Silvertopstraat 5333,2023-05-04,04:00:00,29,19,10,FMN 03 Kolonel Silvertopstraat
651,Kolonel Silvertopstraat 5333,2023-05-04,05:00:00,57,35,22,FMN 03 Kolonel Silvertopstraat
651,Kolonel Silvertopstraat 5333,2023-05-04,06:00:00,129,96,33,FMN 03 Kolonel Silvertopstraat
651,Kolonel Silvertopstraat 5333,2023-05-04,07:00:00,396,322,74,FMN 03 Kolonel Silvertopstraat
651,Kolonel Silvertopstraat 5333,2023-05-04,08:00:00,780,679,101,FMN 03 Kolonel Silvertopstraat
651,Kolonel Silvertopstraat 5333,2023-05-04,09:00:00,280,222,58,FMN 03 Kolonel Silvertopstraat
651,Kolonel Silvertopstraat 5333,2023-05-04,10:00:00,231,175,56,FMN 03 Kolonel Silvertopstraat
651,Kolonel Silvertopstraat 5333,2023-05-04,11:00:00,184,133,51,FMN 03 Kolonel Silvertopstraat
651,Kolonel Silvertopstraat 5333,2023-05-04,12:00:00,237,166,71,FMN 03 Kolonel Silvertopstraat
651,Kolonel Silvertopstraat 5333,2023-05-04,13:00:00,228,161,67,FMN 03 Kolonel Silvertopstraat
651,Kolonel Silvertopstraat 5333,2023-05-04,14:00:00,212,132,80,FMN 03 Kolonel Silvertopstraat
651,Kolonel Silvertopstraat 5333,2023-05-04,15:00:00,330,201,129,FMN 03 Kolonel Silvertopstraat
651,Kolonel Silvertopstraat 5333,2023-05-04,16:00:00,441,286,155,FMN 03 Kolonel Silvertopstraat
651,Kolonel Silvertopstraat 5333,2023-05-04,17:00:00,488,330,158,FMN 03 Kolonel Silvertopstraat
651,Kolonel Silvertopstraat 5333,2023-05-04,18:00:00,361,245,116,FMN 03 Kolonel Silvertopstraat
651,Kolonel Silvertopstraat 5333,2023-05-04,19:00:00,252,159,93,FMN 03 Kolonel Silvertopstraat
651,Kolonel Silvertopstraat 5333,2023-05-04,20:00:00,203,133,70,FMN 03 Kolonel Silvertopstraat
651,Kolonel Silvertopstraat 5333,2023-05-04,21:00:00,180,98,82,FMN 03 Kolonel Silvertopstraat
651,Kolonel Silvertopstraat 5333,2023-05-04,22:00:00,156,75,81,FMN 03 Kolonel Silvertopstraat
651,Kolonel Silvertopstraat 5333,2023-05-04,23:00:00,101,42,59,FMN 03 Kolonel Silvertopstraat
651,Kolonel Silvertopstraat 5333,2023-05-05,00:00:00,43,17,26,FMN 03 Kolonel Silvertopstraat
651,Kolonel Silvertopstraat 5333,2023-05-05,01:00:00,32,14,18,FMN 03 Kolonel Silvertopstraat
651,Kolonel Silvertopstraat 5333,2023-05-05,02:00:00,14,7,7,FMN 03 Kolonel Silvertopstraat
651,Kolonel Silvertopstraat 5333,2023-05-05,03:00:00,11,5,6,FMN 03 Kolonel Silvertopstraat
651,Kolonel Silvertopstraat 5333,2023-05-05,04:00:00,40,21,19,FMN 03 Kolonel Silvertopstraat
651,Kolonel Silvertopstraat 5333,2023-05-05,05:00:00,63,40,23,FMN 03 Kolonel Silvertopstraat
651,Kolonel Silvertopstraat 5333,2023-05-05,06:00:00,125,91,34,FMN 03 Kolonel Silvertopstraat
651,Kolonel Silvertopstraat 5333,2023-05-05,07:00:00,340,272,68,FMN 03 Kolonel Silvertopstraat
651,Kolonel Silvertopstraat 5333,2023-05-05,08:00:00,663,568,95,FMN 03 Kolonel Silvertopstraat
651,Kolonel Silvertopstraat 5333,2023-05-05,09:00:00,246,208,38,FMN 03 Kolonel Silvertopstraat
651,Kolonel Silvertopstraat 5333,2023-05-05,10:00:00,168,126,42,FMN 03 Kolonel Silvertopstraat
651,Kolonel Silvertopstraat 5333,2023-05-05,11:00:00,111,76,35,FMN 03 Kolonel Silvertopstraat
651,Kolonel Silvertopstraat 5333,2023-05-05,12:00:00,198,138,60,FMN 03 Kolonel Silvertopstraat
651,Kolonel Silvertopstraat 5333,2023-05-05,13:00:00,148,116,32,FMN 03 Kolonel Silvertopstraat
651,Kolonel Silvertopstraat 5333,2023-05-05,14:00:00,173,107,66,FMN 03 Kolonel Silvertopstraat
651,Kolonel Silvertopstraat 5333,2023-05-05,15:00:00,315,192,123,FMN 03 Kolonel Silvertopstraat
651,Kolonel Silvertopstraat 5333,2023-05-05,16:00:00,362,247,115,FMN 03 Kolonel Silvertopstraat
651,Kolonel Silvertopstraat 5333,2023-05-05,17:00:00,340,228,112,FMN 03 Kolonel Silvertopstraat
651,Kolonel Silvertopstraat 5333,2023-05-05,18:00:00,317,224,93,FMN 03 Kolonel Silvertopstraat
651,Kolonel Silvertopstraat 5333,2023-05-05,19:00:00,272,183,89,FMN 03 Kolonel Silvertopstraat
651,Kolonel Silvertopstraat 5333,2023-05-05,20:00:00,190,134,56,FMN 03 Kolonel Silvertopstraat
651,Kolonel Silvertopstraat 5333,2023-05-05,21:00:00,159,102,57,FMN 03 Kolonel Silvertopstraat
651,Kolonel Silvertopstraat 5333,2023-05-05,22:00:00,140,87,53,FMN 03 Kolonel Silvertopstraat
651,Kolonel Silvertopstraat 5333,2023-05-05,23:00:00,124,69,55,FMN 03 Kolonel Silvertopstraat
651,Kolonel Silvertopstraat 5333,2023-05-06,00:00:00,88,45,43,FMN 03 Kolonel Silvertopstraat
651,Kolonel Silvertopstraat 5333,2023-05-06,01:00:00,72,28,44,FMN 03 Kolonel Silvertopstraat
651,Kolonel Silvertopstraat 5333,2023-05-06,02:00:00,50,23,27,FMN 03 Kolonel Silvertopstraat
651,Kolonel Silvertopstraat 5333,2023-05-06,03:00:00,35,12,23,FMN 03 Kolonel Silvertopstraat
651,Kolonel Silvertopstraat 5333,2023-05-06,04:00:00,18,10,8,FMN 03 Kolonel Silvertopstraat
651,Kolonel Silvertopstraat 5333,2023-05-06,05:00:00,29,19,10,FMN 03 Kolonel Silvertopstraat
651,Kolonel Silvertopstraat 5333,2023-05-06,06:00:00,39,24,15,FMN 03 Kolonel Silvertopstraat
651,Kolonel Silvertopstraat 5333,2023-05-06,07:00:00,46,34,12,FMN 03 Kolonel Silvertopstraat
651,Kolonel Silvertopstraat 5333,2023-05-06,08:00:00,103,75,28,FMN 03 Kolonel Silvertopstraat
651,Kolonel Silvertopstraat 5333,2023-05-06,09:00:00,184,147,37,FMN 03 Kolonel Silvertopstraat
651,Kolonel Silvertopstraat 5333,2023-05-06,10:00:00,204,160,44,FMN 03 Kolonel Silvertopstraat
651,Kolonel Silvertopstraat 5333,2023-05-06,11:00:00,198,153,45,FMN 03 Kolonel Silvertopstraat
651,Kolonel Silvertopstraat 5333,2023-05-06,12:00:00,216,152,64,FMN 03 Kolonel Silvertopstraat
651,Kolonel Silvertopstraat 5333,2023-05-06,13:00:00,212,157,55,FMN 03 Kolonel Silvertopstraat
651,Kolonel Silvertopstraat 5333,2023-05-06,14:00:00,238,166,72,FMN 03 Kolonel Silvertopstraat
651,Kolonel Silvertopstraat 5333,2023-05-06,15:00:00,232,165,67,FMN 03 Kolonel Silvertopstraat
651,Kolonel Silvertopstraat 5333,2023-05-06,16:00:00,249,162,87,FMN 03 Kolonel Silvertopstraat
651,Kolonel Silvertopstraat 5333,2023-05-06,17:00:00,229,151,78,FMN 03 Kolonel Silvertopstraat
651,Kolonel Silvertopstraat 5333,2023-05-06,18:00:00,201,124,77,FMN 03 Kolonel Silvertopstraat
651,Kolonel Silvertopstraat 5333,2023-05-06,19:00:00,185,128,57,FMN 03 Kolonel Silvertopstraat
651,Kolonel Silvertopstraat 5333,2023-05-06,20:00:00,168,125,43,FMN 03 Kolonel Silvertopstraat
651,Kolonel Silvertopstraat 5333,2023-05-06,21:00:00,110,75,35,FMN 03 Kolonel Silvertopstraat
651,Kolonel Silvertopstraat 5333,2023-05-06,22:00:00,134,79,55,FMN 03 Kolonel Silvertopstraat
651,Kolonel Silvertopstraat 5333,2023-05-06,23:00:00,100,49,51,FMN 03 Kolonel Silvertopstraat
651,Kolonel Silvertopstraat 5333,2023-05-07,00:00:00,75,40,35,FMN 03 Kolonel Silvertopstraat
651,Kolonel Silvertopstraat 5333,2023-05-07,01:00:00,60,24,36,FMN 03 Kolonel Silvertopstraat
651,Kolonel Silvertopstraat 5333,2023-05-07,02:00:00,33,12,21,FMN 03 Kolonel Silvertopstraat
651,Kolonel Silvertopstraat 5333,2023-05-07,03:00:00,30,11,19,FMN 03 Kolonel Silvertopstraat
651,Kolonel Silvertopstraat 5333,2023-05-07,04:00:00,28,11,17,FMN 03 Kolonel Silvertopstraat
651,Kolonel Silvertopstraat 5333,2023-05-07,05:00:00,36,14,22,FMN 03 Kolonel Silvertopstraat
651,Kolonel Silvertopstraat 5333,2023-05-07,06:00:00,33,19,14,FMN 03 Kolonel Silvertopstraat
651,Kolonel Silvertopstraat 5333,2023-05-07,07:00:00,28,21,7,FMN 03 Kolonel Silvertopstraat
651,Kolonel Silvertopstraat 5333,2023-05-07,08:00:00,57,42,15,FMN 03 Kolonel Silvertopstraat
651,Kolonel Silvertopstraat 5333,2023-05-07,09:00:00,112,82,30,FMN 03 Kolonel Silvertopstraat
651,Kolonel Silvertopstraat 5333,2023-05-07,10:00:00,143,116,27,FMN 03 Kolonel Silvertopstraat
651,Kolonel Silvertopstraat 5333,2023-05-07,11:00:00,157,120,37,FMN 03 Kolonel Silvertopstraat
651,Kolonel Silvertopstraat 5333,2023-05-07,12:00:00,118,74,44,FMN 03 Kolonel Silvertopstraat
651,Kolonel Silvertopstraat 5333,2023-05-07,13:00:00,116,77,39,FMN 03 Kolonel Silvertopstraat
651,Kolonel Silvertopstraat 5333,2023-05-07,14:00:00,115,71,44,FMN 03 Kolonel Silvertopstraat
651,Kolonel Silvertopstraat 5333,2023-05-07,15:00:00,112,78,34,FMN 03 Kolonel Silvertopstraat
651,Kolonel Silvertopstraat 5333,2023-05-07,16:00:00,141,92,49,FMN 03 Kolonel Silvertopstraat
651,Kolonel Silvertopstraat 5333,2023-05-07,17:00:00,211,147,64,FMN 03 Kolonel Silvertopstraat
651,Kolonel Silvertopstraat 5333,2023-05-07,18:00:00,166,118,48,FMN 03 Kolonel Silvertopstraat
651,Kolonel Silvertopstraat 5333,2023-05-07,19:00:00,150,94,56,FMN 03 Kolonel Silvertopstraat
651,Kolonel Silvertopstraat 5333,2023-05-07,20:00:00,116,70,46,FMN 03 Kolonel Silvertopstraat
651,Kolonel Silvertopstraat 5333,2023-05-07,21:00:00,86,49,37,FMN 03 Kolonel Silvertopstraat
651,Kolonel Silvertopstraat 5333,2023-05-07,22:00:00,79,43,36,FMN 03 Kolonel Silvertopstraat
651,Kolonel Silvertopstraat 5333,2023-05-07,23:00:00,38,16,22,FMN 03 Kolonel Silvertopstraat
651,Kolonel Silvertopstraat 5333,2023-05-08,00:00:00,20,5,15,FMN 03 Kolonel Silvertopstraat
651,Kolonel Silvertopstraat 5333,2023-05-08,01:00:00,16,9,7,FMN 03 Kolonel Silvertopstraat
651,Kolonel Silvertopstraat 5333,2023-05-08,02:00:00,5,3,2,FMN 03 Kolonel Silvertopstraat
651,Kolonel Silvertopstraat 5333,2023-05-08,03:00:00,9,4,5,FMN 03 Kolonel Silvertopstraat
651,Kolonel Silvertopstraat 5333,2023-05-08,04:00:00,18,15,3,FMN 03 Kolonel Silvertopstraat
651,Kolonel Silvertopstraat 5333,2023-05-08,05:00:00,59,38,21,FMN 03 Kolonel Silvertopstraat
651,Kolonel Silvertopstraat 5333,2023-05-08,06:00:00,152,117,35,FMN 03 Kolonel Silvertopstraat
651,Kolonel Silvertopstraat 5333,2023-05-08,07:00:00,367,304,63,FMN 03 Kolonel Silvertopstraat
651,Kolonel Silvertopstraat 5333,2023-05-08,08:00:00,689,604,85,FMN 03 Kolonel Silvertopstraat
651,Kolonel Silvertopstraat 5333,2023-05-08,09:00:00,209,158,51,FMN 03 Kolonel Silvertopstraat
651,Kolonel Silvertopstraat 5333,2023-05-08,10:00:00,171,133,38,FMN 03 Kolonel Silvertopstraat
651,Kolonel Silvertopstraat 5333,2023-05-08,11:00:00,151,114,37,FMN 03 Kolonel Silvertopstraat
651,Kolonel Silvertopstraat 5333,2023-05-08,12:00:00,192,125,67,FMN 03 Kolonel Silvertopstraat
651,Kolonel Silvertopstraat 5333,2023-05-08,13:00:00,196,148,48,FMN 03 Kolonel Silvertopstraat
651,Kolonel Silvertopstraat 5333,2023-05-08,14:00:00,210,130,80,FMN 03 Kolonel Silvertopstraat
651,Kolonel Silvertopstraat 5333,2023-05-08,15:00:00,321,202,119,FMN 03 Kolonel Silvertopstraat
651,Kolonel Silvertopstraat 5333,2023-05-08,16:00:00,408,271,137,FMN 03 Kolonel Silvertopstraat
651,Kolonel Silvertopstraat 5333,2023-05-08,17:00:00,445,271,174,FMN 03 Kolonel Silvertopstraat
651,Kolonel Silvertopstraat 5333,2023-05-08,18:00:00,318,216,102,FMN 03 Kolonel Silvertopstraat
651,Kolonel Silvertopstraat 5333,2023-05-08,19:00:00,235,154,81,FMN 03 Kolonel Silvertopstraat
651,Kolonel Silvertopstraat 5333,2023-05-08,20:00:00,172,94,78,FMN 03 Kolonel Silvertopstraat
651,Kolonel Silvertopstraat 5333,2023-05-08,21:00:00,122,66,56,FMN 03 Kolonel Silvertopstraat
651,Kolonel Silvertopstraat 5333,2023-05-08,22:00:00,118,64,54,FMN 03 Kolonel Silvertopstraat
651,Kolonel Silvertopstraat 5333,2023-05-08,23:00:00,71,36,35,FMN 03 Kolonel Silvertopstraat
651,Kolonel Silvertopstraat 5333,2023-05-09,00:00:00,36,17,19,FMN 03 Kolonel Silvertopstraat
651,Kolonel Silvertopstraat 5333,2023-05-09,01:00:00,22,10,12,FMN 03 Kolonel Silvertopstraat
651,Kolonel Silvertopstraat 5333,2023-05-09,02:00:00,18,8,10,FMN 03 Kolonel Silvertopstraat
651,Kolonel Silvertopstraat 5333,2023-05-09,03:00:00,16,8,8,FMN 03 Kolonel Silvertopstraat
651,Kolonel Silvertopstraat 5333,2023-05-09,04:00:00,18,15,3,FMN 03 Kolonel Silvertopstraat
651,Kolonel Silvertopstraat 5333,2023-05-09,05:00:00,52,31,21,FMN 03 Kolonel Silvertopstraat
651,Kolonel Silvertopstraat 5333,2023-05-09,06:00:00,131,102,29,FMN 03 Kolonel Silvertopstraat
651,Kolonel Silvertopstraat 5333,2023-05-09,07:00:00,296,239,57,FMN 03 Kolonel Silvertopstraat
651,Kolonel Silvertopstraat 5333,2023-05-09,08:00:00,555,475,80,FMN 03 Kolonel Silvertopstraat
651,Kolonel Silvertopstraat 5333,2023-05-09,09:00:00,205,166,39,FMN 03 Kolonel Silvertopstraat
651,Kolonel Silvertopstraat 5333,2023-05-09,10:00:00,122,92,30,FMN 03 Kolonel Silvertopstraat
651,Kolonel Silvertopstraat 5333,2023-05-09,11:00:00,113,87,26,FMN 03 Kolonel Silvertopstraat
651,Kolonel Silvertopstraat 5333,2023-05-09,12:00:00,138,92,46,FMN 03 Kolonel Silvertopstraat
651,Kolonel Silvertopstraat 5333,2023-05-09,13:00:00,99,58,41,FMN 03 Kolonel Silvertopstraat
651,Kolonel Silvertopstraat 5333,2023-05-09,14:00:00,84,56,28,FMN 03 Kolonel Silvertopstraat
651,Kolonel Silvertopstraat 5333,2023-05-09,15:00:00,202,130,72,FMN 03 Kolonel Silvertopstraat
651,Kolonel Silvertopstraat 5333,2023-05-09,16:00:00,282,167,115,FMN 03 Kolonel Silvertopstraat
651,Kolonel Silvertopstraat 5333,2023-05-09,17:00:00,272,160,112,FMN 03 Kolonel Silvertopstraat
651,Kolonel Silvertopstraat 5333,2023-05-09,18:00:00,194,133,61,FMN 03 Kolonel Silvertopstraat
651,Kolonel Silvertopstraat 5333,2023-05-09,19:00:00,137,82,55,FMN 03 Kolonel Silvertopstraat
651,Kolonel Silvertopstraat 5333,2023-05-09,20:00:00,114,66,48,FMN 03 Kolonel Silvertopstraat
651,Kolonel Silvertopstraat 5333,2023-05-09,21:00:00,97,58,39,FMN 03 Kolonel Silvertopstraat
651,Kolonel Silvertopstraat 5333,2023-05-09,22:00:00,71,39,32,FMN 03 Kolonel Silvertopstraat
651,Kolonel Silvertopstraat 5333,2023-05-09,23:00:00,43,22,21,FMN 03 Kolonel Silvertopstraat
651,Kolonel Silvertopstraat 5333,2023-05-10,00:00:00,24,13,11,FMN 03 Kolonel Silvertopstraat
651,Kolonel Silvertopstraat 5333,2023-05-10,01:00:00,18,7,11,FMN 03 Kolonel Silvertopstraat
651,Kolonel Silvertopstraat 5333,2023-05-10,02:00:00,10,6,4,FMN 03 Kolonel Silvertopstraat
651,Kolonel Silvertopstraat 5333,2023-05-10,03:00:00,11,8,3,FMN 03 Kolonel Silvertopstraat
651,Kolonel Silvertopstraat 5333,2023-05-10,04:00:00,16,12,4,FMN 03 Kolonel Silvertopstraat
651,Kolonel Silvertopstraat 5333,2023-05-10,05:00:00,53,34,19,FMN 03 Kolonel Silvertopstraat
651,Kolonel Silvertopstraat 5333,2023-05-10,06:00:00,111,84,27,FMN 03 Kolonel Silvertopstraat
651,Kolonel Silvertopstraat 5333,2023-05-10,07:00:00,283,230,53,FMN 03 Kolonel Silvertopstraat
651,Kolonel Silvertopstraat 5333,2023-05-10,08:00:00,623,541,82,FMN 03 Kolonel Silvertopstraat
651,Kolonel Silvertopstraat 5333,2023-05-10,09:00:00,207,173,34,FMN 03 Kolonel Silvertopstraat
651,Kolonel Silvertopstraat 5333,2023-05-10,10:00:00,174,124,50,FMN 03 Kolonel Silvertopstraat
651,Kolonel Silvertopstraat 5333,2023-05-10,11:00:00,181,128,53,FMN 03 Kolonel Silvertopstraat
651,Kolonel Silvertopstraat 5333,2023-05-10,12:00:00,308,192,116,FMN 03 Kolonel Silvertopstraat
651,Kolonel Silvertopstraat 5333,2023-05-10,13:00:00,180,119,61,FMN 03 Kolonel Silvertopstraat
651,Kolonel Silvertopstraat 5333,2023-05-10,14:00:00,161,112,49,FMN 03 Kolonel Silvertopstraat
651,Kolonel Silvertopstraat 5333,2023-05-10,15:00:00,229,151,78,FMN 03 Kolonel Silvertopstraat
651,Kolonel Silvertopstraat 5333,2023-05-10,16:00:00,263,174,89,FMN 03 Kolonel Silvertopstraat
651,Kolonel Silvertopstraat 5333,2023-05-10,17:00:00,272,170,102,FMN 03 Kolonel Silvertopstraat
651,Kolonel Silvertopstraat 5333,2023-05-10,18:00:00,220,130,90,FMN 03 Kolonel Silvertopstraat
651,Kolonel Silvertopstraat 5333,2023-05-10,19:00:00,166,112,54,FMN 03 Kolonel Silvertopstraat
651,Kolonel Silvertopstraat 5333,2023-05-10,20:00:00,117,71,46,FMN 03 Kolonel Silvertopstraat
651,Kolonel Silvertopstraat 5333,2023-05-10,21:00:00,108,63,45,FMN 03 Kolonel Silvertopstraat
651,Kolonel Silvertopstraat 5333,2023-05-10,22:00:00,93,46,47,FMN 03 Kolonel Silvertopstraat
651,Kolonel Silvertopstraat 5333,2023-05-10,23:00:00,62,26,36,FMN 03 Kolonel Silvertopstraat
651,Kolonel Silvertopstraat 5333,2023-05-11,00:00:00,24,9,15,FMN 03 Kolonel Silvertopstraat
651,Kolonel Silvertopstraat 5333,2023-05-11,01:00:00,16,5,11,FMN 03 Kolonel Silvertopstraat
651,Kolonel Silvertopstraat 5333,2023-05-11,02:00:00,13,6,7,FMN 03 Kolonel Silvertopstraat
651,Kolonel Silvertopstraat 5333,2023-05-11,03:00:00,15,7,8,FMN 03 Kolonel Silvertopstraat
651,Kolonel Silvertopstraat 5333,2023-05-11,04:00:00,16,14,2,FMN 03 Kolonel Silvertopstraat
651,Kolonel Silvertopstraat 5333,2023-05-11,05:00:00,53,29,24,FMN 03 Kolonel Silvertopstraat
651,Kolonel Silvertopstraat 5333,2023-05-11,06:00:00,130,107,23,FMN 03 Kolonel Silvertopstraat
651,Kolonel Silvertopstraat 5333,2023-05-11,07:00:00,347,287,60,FMN 03 Kolonel Silvertopstraat
651,Kolonel Silvertopstraat 5333,2023-05-11,08:00:00,684,593,91,FMN 03 Kolonel Silvertopstraat
651,Kolonel Silvertopstraat 5333,2023-05-11,09:00:00,241,187,54,FMN 03 Kolonel Silvertopstraat
651,Kolonel Silvertopstraat 5333,2023-05-11,10:00:00,195,147,48,FMN 03 Kolonel Silvertopstraat
651,Kolonel Silvertopstraat 5333,2023-05-11,11:00:00,166,126,40,FMN 03 Kolonel Silvertopstraat
651,Kolonel Silvertopstraat 5333,2023-05-11,12:00:00,199,143,56,FMN 03 Kolonel Silvertopstraat
651,Kolonel Silvertopstraat 5333,2023-05-11,13:00:00,184,121,63,FMN 03 Kolonel Silvertopstraat
651,Kolonel Silvertopstraat 5333,2023-05-11,14:00:00,213,140,73,FMN 03 Kolonel Silvertopstraat
651,Kolonel Silvertopstraat 5333,2023-05-11,15:00:00,216,128,88,FMN 03 Kolonel Silvertopstraat
651,Kolonel Silvertopstraat 5333,2023-05-11,16:00:00,314,197,117,FMN 03 Kolonel Silvertopstraat
651,Kolonel Silvertopstraat 5333,2023-05-11,17:00:00,361,225,136,FMN 03 Kolonel Silvertopstraat
651,Kolonel Silvertopstraat 5333,2023-05-11,18:00:00,298,192,106,FMN 03 Kolonel Silvertopstraat
651,Kolonel Silvertopstraat 5333,2023-05-11,19:00:00,212,150,62,FMN 03 Kolonel Silvertopstraat
651,Kolonel Silvertopstraat 5333,2023-05-11,20:00:00,142,87,55,FMN 03 Kolonel Silvertopstraat
651,Kolonel Silvertopstraat 5333,2023-05-11,21:00:00,126,57,69,FMN 03 Kolonel Silvertopstraat
651,Kolonel Silvertopstraat 5333,2023-05-11,22:00:00,114,56,58,FMN 03 Kolonel Silvertopstraat
651,Kolonel Silvertopstraat 5333,2023-05-11,23:00:00,84,30,54,FMN 03 Kolonel Silvertopstraat
651,Kolonel Silvertopstraat 5333,2023-05-12,00:00:00,54,28,26,FMN 03 Kolonel Silvertopstraat
651,Kolonel Silvertopstraat 5333,2023-05-12,01:00:00,24,9,15,FMN 03 Kolonel Silvertopstraat
651,Kolonel Silvertopstraat 5333,2023-05-12,02:00:00,16,9,7,FMN 03 Kolonel Silvertopstraat
651,Kolonel Silvertopstraat 5333,2023-05-12,03:00:00,16,4,12,FMN 03 Kolonel Silvertopstraat
651,Kolonel Silvertopstraat 5333,2023-05-12,04:00:00,28,17,11,FMN 03 Kolonel Silvertopstraat
651,Kolonel Silvertopstraat 5333,2023-05-12,05:00:00,47,28,19,FMN 03 Kolonel Silvertopstraat
651,Kolonel Silvertopstraat 5333,2023-05-12,06:00:00,88,65,23,FMN 03 Kolonel Silvertopstraat
651,Kolonel Silvertopstraat 5333,2023-05-12,07:00:00,213,177,36,FMN 03 Kolonel Silvertopstraat
651,Kolonel Silvertopstraat 5333,2023-05-12,08:00:00,469,417,52,FMN 03 Kolonel Silvertopstraat
651,Kolonel Silvertopstraat 5333,2023-05-12,09:00:00,173,138,35,FMN 03 Kolonel Silvertopstraat
651,Kolonel Silvertopstraat 5333,2023-05-12,10:00:00,131,96,35,FMN 03 Kolonel Silvertopstraat
651,Kolonel Silvertopstraat 5333,2023-05-12,11:00:00,138,96,42,FMN 03 Kolonel Silvertopstraat
651,Kolonel Silvertopstraat 5333,2023-05-12,12:00:00,200,134,66,FMN 03 Kolonel Silvertopstraat
651,Kolonel Silvertopstraat 5333,2023-05-12,13:00:00,183,129,54,FMN 03 Kolonel Silvertopstraat
651,Kolonel Silvertopstraat 5333,2023-05-12,14:00:00,201,127,74,FMN 03 Kolonel Silvertopstraat
651,Kolonel Silvertopstraat 5333,2023-05-12,15:00:00,299,173,126,FMN 03 Kolonel Silvertopstraat
651,Kolonel Silvertopstraat 5333,2023-05-12,16:00:00,296,200,96,FMN 03 Kolonel Silvertopstraat
651,Kolonel Silvertopstraat 5333,2023-05-12,17:00:00,302,199,103,FMN 03 Kolonel Silvertopstraat
651,Kolonel Silvertopstraat 5333,2023-05-12,18:00:00,308,208,100,FMN 03 Kolonel Silvertopstraat
651,Kolonel Silvertopstraat 5333,2023-05-12,19:00:00,232,170,62,FMN 03 Kolonel Silvertopstraat
651,Kolonel Silvertopstraat 5333,2023-05-12,20:00:00,154,111,43,FMN 03 Kolonel Silvertopstraat
651,Kolonel Silvertopstraat 5333,2023-05-12,21:00:00,160,112,48,FMN 03 Kolonel Silvertopstraat
651,Kolonel Silvertopstraat 5333,2023-05-12,22:00:00,154,83,71,FMN 03 Kolonel Silvertopstraat
651,Kolonel Silvertopstraat 5333,2023-05-12,23:00:00,89,46,43,FMN 03 Kolonel Silvertopstraat
651,Kolonel Silvertopstraat 5333,2023-05-13,00:00:00,68,36,32,FMN 03 Kolonel Silvertopstraat
651,Kolonel Silvertopstraat 5333,2023-05-13,01:00:00,52,14,38,FMN 03 Kolonel Silvertopstraat
651,Kolonel Silvertopstraat 5333,2023-05-13,02:00:00,45,12,33,FMN 03 Kolonel Silvertopstraat
651,Kolonel Silvertopstraat 5333,2023-05-13,03:00:00,32,15,17,FMN 03 Kolonel Silvertopstraat
651,Kolonel Silvertopstraat 5333,2023-05-13,04:00:00,18,8,10,FMN 03 Kolonel Silvertopstraat
651,Kolonel Silvertopstraat 5333,2023-05-13,05:00:00,32,18,14,FMN 03 Kolonel Silvertopstraat
651,Kolonel Silvertopstraat 5333,2023-05-13,06:00:00,35,25,10,FMN 03 Kolonel Silvertopstraat
651,Kolonel Silvertopstraat 5333,2023-05-13,07:00:00,33,21,12,FMN 03 Kolonel Silvertopstraat
651,Kolonel Silvertopstraat 5333,2023-05-13,08:00:00,86,69,17,FMN 03 Kolonel Silvertopstraat
651,Kolonel Silvertopstraat 5333,2023-05-13,09:00:00,180,153,27,FMN 03 Kolonel Silvertopstraat
651,Kolonel Silvertopstraat 5333,2023-05-13,10:00:00,203,170,33,FMN 03 Kolonel Silvertopstraat
651,Kolonel Silvertopstraat 5333,2023-05-13,11:00:00,229,174,55,FMN 03 Kolonel Silvertopstraat
651,Kolonel Silvertopstraat 5333,2023-05-13,12:00:00,242,178,64,FMN 03 Kolonel Silvertopstraat
651,Kolonel Silvertopstraat 5333,2023-05-13,13:00:00,274,206,68,FMN 03 Kolonel Silvertopstraat
651,Kolonel Silvertopstraat 5333,2023-05-13,14:00:00,278,193,85,FMN 03 Kolonel Silvertopstraat
651,Kolonel Silvertopstraat 5333,2023-05-13,15:00:00,280,166,114,FMN 03 Kolonel Silvertopstraat
651,Kolonel Silvertopstraat 5333,2023-05-13,16:00:00,238,170,68,FMN 03 Kolonel Silvertopstraat
651,Kolonel Silvertopstraat 5333,2023-05-13,17:00:00,233,152,81,FMN 03 Kolonel Silvertopstraat
651,Kolonel Silvertopstraat 5333,2023-05-13,18:00:00,253,187,66,FMN 03 Kolonel Silvertopstraat
651,Kolonel Silvertopstraat 5333,2023-05-13,19:00:00,214,150,64,FMN 03 Kolonel Silvertopstraat
651,Kolonel Silvertopstraat 5333,2023-05-13,20:00:00,195,132,63,FMN 03 Kolonel Silvertopstraat
651,Kolonel Silvertopstraat 5333,2023-05-13,21:00:00,142,99,43,FMN 03 Kolonel Silvertopstraat
651,Kolonel Silvertopstraat 5333,2023-05-13,22:00:00,94,45,49,FMN 03 Kolonel Silvertopstraat
651,Kolonel Silvertopstraat 5333,2023-05-13,23:00:00,109,51,58,FMN 03 Kolonel Silvertopstraat
651,Kolonel Silvertopstraat 5333,2023-05-14,00:00:00,95,43,52,FMN 03 Kolonel Silvertopstraat
651,Kolonel Silvertopstraat 5333,2023-05-14,01:00:00,67,37,30,FMN 03 Kolonel Silvertopstraat
651,Kolonel Silvertopstraat 5333,2023-05-14,02:00:00,44,14,30,FMN 03 Kolonel Silvertopstraat
651,Kolonel Silvertopstraat 5333,2023-05-14,03:00:00,33,5,28,FMN 03 Kolonel Silvertopstraat
651,Kolonel Silvertopstraat 5333,2023-05-14,04:00:00,25,10,15,FMN 03 Kolonel Silvertopstraat
651,Kolonel Silvertopstraat 5333,2023-05-14,05:00:00,39,26,13,FMN 03 Kolonel Silvertopstraat
651,Kolonel Silvertopstraat 5333,2023-05-14,06:00:00,31,21,10,FMN 03 Kolonel Silvertopstraat
651,Kolonel Silvertopstraat 5333,2023-05-14,07:00:00,22,18,4,FMN 03 Kolonel Silvertopstraat
651,Kolonel Silvertopstraat 5333,2023-05-14,08:00:00,69,56,13,FMN 03 Kolonel Silvertopstraat
651,Kolonel Silvertopstraat 5333,2023-05-14,09:00:00,114,88,26,FMN 03 Kolonel Silvertopstraat
651,Kolonel Silvertopstraat 5333,2023-05-14,10:00:00,170,135,35,FMN 03 Kolonel Silvertopstraat
651,Kolonel Silvertopstraat 5333,2023-05-14,11:00:00,138,107,31,FMN 03 Kolonel Silvertopstraat
651,Kolonel Silvertopstraat 5333,2023-05-14,12:00:00,143,105,38,FMN 03 Kolonel Silvertopstraat
651,Kolonel Silvertopstraat 5333,2023-05-14,13:00:00,189,134,55,FMN 03 Kolonel Silvertopstraat
651,Kolonel Silvertopstraat 5333,2023-05-14,14:00:00,170,113,57,FMN 03 Kolonel Silvertopstraat
651,Kolonel Silvertopstraat 5333,2023-05-14,15:00:00,159,115,44,FMN 03 Kolonel Silvertopstraat
651,Kolonel Silvertopstraat 5333,2023-05-14,16:00:00,199,138,61,FMN 03 Kolonel Silvertopstraat
651,Kolonel Silvertopstraat 5333,2023-05-14,17:00:00,219,154,65,FMN 03 Kolonel Silvertopstraat
651,Kolonel Silvertopstraat 5333,2023-05-14,18:00:00,178,113,65,FMN 03 Kolonel Silvertopstraat
651,Kolonel Silvertopstraat 5333,2023-05-14,19:00:00,150,100,50,FMN 03 Kolonel Silvertopstraat
651,Kolonel Silvertopstraat 5333,2023-05-14,20:00:00,144,76,68,FMN 03 Kolonel Silvertopstraat
651,Kolonel Silvertopstraat 5333,2023-05-14,21:00:00,87,44,43,FMN 03 Kolonel Silvertopstraat
651,Kolonel Silvertopstraat 5333,2023-05-14,22:00:00,78,37,41,FMN 03 Kolonel Silvertopstraat
651,Kolonel Silvertopstraat 5333,2023-05-14,23:00:00,54,20,34,FMN 03 Kolonel Silvertopstraat
651,Kolonel Silvertopstraat 5333,2023-05-15,00:00:00,26,11,15,FMN 03 Kolonel Silvertopstraat
651,Kolonel Silvertopstraat 5333,2023-05-15,01:00:00,19,13,6,FMN 03 Kolonel Silvertopstraat
651,Kolonel Silvertopstraat 5333,2023-05-15,02:00:00,5,3,2,FMN 03 Kolonel Silvertopstraat
651,Kolonel Silvertopstraat 5333,2023-05-15,03:00:00,9,5,4,FMN 03 Kolonel Silvertopstraat
651,Kolonel Silvertopstraat 5333,2023-05-15,04:00:00,33,26,7,FMN 03 Kolonel Silvertopstraat
651,Kolonel Silvertopstraat 5333,2023-05-15,05:00:00,58,33,25,FMN 03 Kolonel Silvertopstraat
651,Kolonel Silvertopstraat 5333,2023-05-15,06:00:00,126,98,28,FMN 03 Kolonel Silvertopstraat
651,Kolonel Silvertopstraat 5333,2023-05-15,07:00:00,334,262,72,FMN 03 Kolonel Silvertopstraat
651,Kolonel Silvertopstraat 5333,2023-05-15,08:00:00,669,581,88,FMN 03 Kolonel Silvertopstraat
651,Kolonel Silvertopstraat 5333,2023-05-15,09:00:00,209,159,50,FMN 03 Kolonel Silvertopstraat
651,Kolonel Silvertopstraat 5333,2023-05-15,10:00:00,158,117,41,FMN 03 Kolonel Silvertopstraat
651,Kolonel Silvertopstraat 5333,2023-05-15,11:00:00,140,99,41,FMN 03 Kolonel Silvertopstraat
651,Kolonel Silvertopstraat 5333,2023-05-15,12:00:00,192,143,49,FMN 03 Kolonel Silvertopstraat
651,Kolonel Silvertopstraat 5333,2023-05-15,13:00:00,161,98,63,FMN 03 Kolonel Silvertopstraat
651,Kolonel Silvertopstraat 5333,2023-05-15,14:00:00,152,102,50,FMN 03 Kolonel Silvertopstraat
651,Kolonel Silvertopstraat 5333,2023-05-15,15:00:00,244,147,97,FMN 03 Kolonel Silvertopstraat
651,Kolonel Silvertopstraat 5333,2023-05-15,16:00:00,349,223,126,FMN 03 Kolonel Silvertopstraat
651,Kolonel Silvertopstraat 5333,2023-05-15,17:00:00,320,198,122,FMN 03 Kolonel Silvertopstraat
651,Kolonel Silvertopstraat 5333,2023-05-15,18:00:00,263,158,105,FMN 03 Kolonel Silvertopstraat
651,Kolonel Silvertopstraat 5333,2023-05-15,19:00:00,158,103,55,FMN 03 Kolonel Silvertopstraat
651,Kolonel Silvertopstraat 5333,2023-05-15,20:00:00,119,72,47,FMN 03 Kolonel Silvertopstraat
651,Kolonel Silvertopstraat 5333,2023-05-15,21:00:00,99,49,50,FMN 03 Kolonel Silvertopstraat
651,Kolonel Silvertopstraat 5333,2023-05-15,22:00:00,101,56,45,FMN 03 Kolonel Silvertopstraat
651,Kolonel Silvertopstraat 5333,2023-05-15,23:00:00,37,16,21,FMN 03 Kolonel Silvertopstraat
651,Kolonel Silvertopstraat 5333,2023-05-16,00:00:00,17,9,8,FMN 03 Kolonel Silvertopstraat
651,Kolonel Silvertopstraat 5333,2023-05-16,01:00:00,13,10,3,FMN 03 Kolonel Silvertopstraat
651,Kolonel Silvertopstraat 5333,2023-05-16,02:00:00,11,9,2,FMN 03 Kolonel Silvertopstraat
651,Kolonel Silvertopstraat 5333,2023-05-16,03:00:00,12,4,8,FMN 03 Kolonel Silvertopstraat
651,Kolonel Silvertopstraat 5333,2023-05-16,04:00:00,24,18,6,FMN 03 Kolonel Silvertopstraat
651,Kolonel Silvertopstraat 5333,2023-05-16,05:00:00,63,35,28,FMN 03 Kolonel Silvertopstraat
651,Kolonel Silvertopstraat 5333,2023-05-16,06:00:00,133,95,38,FMN 03 Kolonel Silvertopstraat
651,Kolonel Silvertopstraat 5333,2023-05-16,07:00:00,377,309,68,FMN 03 Kolonel Silvertopstraat
651,Kolonel Silvertopstraat 5333,2023-05-16,08:00:00,718,631,87,FMN 03 Kolonel Silvertopstraat
651,Kolonel Silvertopstraat 5333,2023-05-16,09:00:00,258,203,55,FMN 03 Kolonel Silvertopstraat
651,Kolonel Silvertopstraat 5333,2023-05-16,10:00:00,159,122,37,FMN 03 Kolonel Silvertopstraat
651,Kolonel Silvertopstraat 5333,2023-05-16,11:00:00,149,116,33,FMN 03 Kolonel Silvertopstraat
651,Kolonel Silvertopstraat 5333,2023-05-16,12:00:00,212,145,67,FMN 03 Kolonel Silvertopstraat
651,Kolonel Silvertopstraat 5333,2023-05-16,13:00:00,196,124,72,FMN 03 Kolonel Silvertopstraat
651,Kolonel Silvertopstraat 5333,2023-05-16,14:00:00,233,151,82,FMN 03 Kolonel Silvertopstraat
651,Kolonel Silvertopstraat 5333,2023-05-16,15:00:00,270,175,95,FMN 03 Kolonel Silvertopstraat
651,Kolonel Silvertopstraat 5333,2023-05-16,16:00:00,438,269,169,FMN 03 Kolonel Silvertopstraat
651,Kolonel Silvertopstraat 5333,2023-05-16,17:00:00,453,283,170,FMN 03 Kolonel Silvertopstraat
651,Kolonel Silvertopstraat 5333,2023-05-16,18:00:00,330,231,99,FMN 03 Kolonel Silvertopstraat
651,Kolonel Silvertopstraat 5333,2023-05-16,19:00:00,230,154,76,FMN 03 Kolonel Silvertopstraat
651,Kolonel Silvertopstraat 5333,2023-05-16,20:00:00,207,119,88,FMN 03 Kolonel Silvertopstraat
651,Kolonel Silvertopstraat 5333,2023-05-16,21:00:00,136,68,68,FMN 03 Kolonel Silvertopstraat
651,Kolonel Silvertopstraat 5333,2023-05-16,22:00:00,150,101,49,FMN 03 Kolonel Silvertopstraat
651,Kolonel Silvertopstraat 5333,2023-05-16,23:00:00,70,29,41,FMN 03 Kolonel Silvertopstraat
651,Kolonel Silvertopstraat 5333,2023-05-17,00:00:00,40,16,24,FMN 03 Kolonel Silvertopstraat
651,Kolonel Silvertopstraat 5333,2023-05-17,01:00:00,25,10,15,FMN 03 Kolonel Silvertopstraat
651,Kolonel Silvertopstraat 5333,2023-05-17,02:00:00,19,10,9,FMN 03 Kolonel Silvertopstraat
651,Kolonel Silvertopstraat 5333,2023-05-17,03:00:00,10,7,3,FMN 03 Kolonel Silvertopstraat
651,Kolonel Silvertopstraat 5333,2023-05-17,04:00:00,25,19,6,FMN 03 Kolonel Silvertopstraat
651,Kolonel Silvertopstraat 5333,2023-05-17,05:00:00,49,33,16,FMN 03 Kolonel Silvertopstraat
651,Kolonel Silvertopstraat 5333,2023-05-17,06:00:00,133,100,33,FMN 03 Kolonel Silvertopstraat
651,Kolonel Silvertopstraat 5333,2023-05-17,07:00:00,313,255,58,FMN 03 Kolonel Silvertopstraat
651,Kolonel Silvertopstraat 5333,2023-05-17,08:00:00,580,491,89,FMN 03 Kolonel Silvertopstraat
651,Kolonel Silvertopstraat 5333,2023-05-17,09:00:00,222,177,45,FMN 03 Kolonel Silvertopstraat
651,Kolonel Silvertopstraat 5333,2023-05-17,10:00:00,192,149,43,FMN 03 Kolonel Silvertopstraat
651,Kolonel Silvertopstraat 5333,2023-05-17,11:00:00,182,137,45,FMN 03 Kolonel Silvertopstraat
651,Kolonel Silvertopstraat 5333,2023-05-17,12:00:00,334,209,125,FMN 03 Kolonel Silvertopstraat
651,Kolonel Silvertopstraat 5333,2023-05-17,13:00:00,263,157,106,FMN 03 Kolonel Silvertopstraat
651,Kolonel Silvertopstraat 5333,2023-05-17,14:00:00,233,158,75,FMN 03 Kolonel Silvertopstraat
651,Kolonel Silvertopstraat 5333,2023-05-17,15:00:00,202,132,70,FMN 03 Kolonel Silvertopstraat
651,Kolonel Silvertopstraat 5333,2023-05-17,16:00:00,213,152,61,FMN 03 Kolonel Silvertopstraat
651,Kolonel Silvertopstraat 5333,2023-05-17,17:00:00,394,271,123,FMN 03 Kolonel Silvertopstraat
651,Kolonel Silvertopstraat 5333,2023-05-17,18:00:00,341,247,94,FMN 03 Kolonel Silvertopstraat
651,Kolonel Silvertopstraat 5333,2023-05-17,19:00:00,236,165,71,FMN 03 Kolonel Silvertopstraat
651,Kolonel Silvertopstraat 5333,2023-05-17,20:00:00,184,127,57,FMN 03 Kolonel Silvertopstraat
651,Kolonel Silvertopstraat 5333,2023-05-17,21:00:00,163,99,64,FMN 03 Kolonel Silvertopstraat
651,Kolonel Silvertopstraat 5333,2023-05-17,22:00:00,110,66,44,FMN 03 Kolonel Silvertopstraat
651,Kolonel Silvertopstraat 5333,2023-05-17,23:00:00,104,49,55,FMN 03 Kolonel Silvertopstraat
651,Kolonel Silvertopstraat 5333,2023-05-18,00:00:00,76,34,42,FMN 03 Kolonel Silvertopstraat
651,Kolonel Silvertopstraat 5333,2023-05-18,01:00:00,51,16,35,FMN 03 Kolonel Silvertopstraat
651,Kolonel Silvertopstraat 5333,2023-05-18,02:00:00,43,18,25,FMN 03 Kolonel Silvertopstraat
651,Kolonel Silvertopstraat 5333,2023-05-18,03:00:00,18,4,14,FMN 03 Kolonel Silvertopstraat
651,Kolonel Silvertopstraat 5333,2023-05-18,04:00:00,19,8,11,FMN 03 Kolonel Silvertopstraat
651,Kolonel Silvertopstraat 5333,2023-05-18,05:00:00,28,18,10,FMN 03 Kolonel Silvertopstraat
651,Kolonel Silvertopstraat 5333,2023-05-18,06:00:00,28,19,9,FMN 03 Kolonel Silvertopstraat
651,Kolonel Silvertopstraat 5333,2023-05-18,07:00:00,26,21,5,FMN 03 Kolonel Silvertopstraat
651,Kolonel Silvertopstraat 5333,2023-05-18,08:00:00,71,54,17,FMN 03 Kolonel Silvertopstraat
651,Kolonel Silvertopstraat 5333,2023-05-18,09:00:00,108,83,25,FMN 03 Kolonel Silvertopstraat
651,Kolonel Silvertopstraat 5333,2023-05-18,10:00:00,120,95,25,FMN 03 Kolonel Silvertopstraat
651,Kolonel Silvertopstraat 5333,2023-05-18,11:00:00,151,106,45,FMN 03 Kolonel Silvertopstraat
651,Kolonel Silvertopstraat 5333,2023-05-18,12:00:00,179,129,50,FMN 03 Kolonel Silvertopstraat
651,Kolonel Silvertopstraat 5333,2023-05-18,13:00:00,192,150,42,FMN 03 Kolonel Silvertopstraat
651,Kolonel Silvertopstraat 5333,2023-05-18,14:00:00,198,136,62,FMN 03 Kolonel Silvertopstraat
651,Kolonel Silvertopstraat 5333,2023-05-18,15:00:00,163,114,49,FMN 03 Kolonel Silvertopstraat
651,Kolonel Silvertopstraat 5333,2023-05-18,16:00:00,129,97,32,FMN 03 Kolonel Silvertopstraat
651,Kolonel Silvertopstraat 5333,2023-05-18,17:00:00,234,155,79,FMN 03 Kolonel Silvertopstraat
651,Kolonel Silvertopstraat 5333,2023-05-18,18:00:00,208,136,72,FMN 03 Kolonel Silvertopstraat
651,Kolonel Silvertopstraat 5333,2023-05-18,19:00:00,211,145,66,FMN 03 Kolonel Silvertopstraat
651,Kolonel Silvertopstraat 5333,2023-05-18,20:00:00,151,96,55,FMN 03 Kolonel Silvertopstraat
651,Kolonel Silvertopstraat 5333,2023-05-18,21:00:00,133,80,53,FMN 03 Kolonel Silvertopstraat
651,Kolonel Silvertopstraat 5333,2023-05-18,22:00:00,118,56,62,FMN 03 Kolonel Silvertopstraat
651,Kolonel Silvertopstraat 5333,2023-05-18,23:00:00,98,45,53,FMN 03 Kolonel Silvertopstraat
651,Kolonel Silvertopstraat 5333,2023-05-19,00:00:00,46,26,20,FMN 03 Kolonel Silvertopstraat
651,Kolonel Silvertopstraat 5333,2023-05-19,01:00:00,44,26,18,FMN 03 Kolonel Silvertopstraat
651,Kolonel Silvertopstraat 5333,2023-05-19,02:00:00,31,14,17,FMN 03 Kolonel Silvertopstraat
651,Kolonel Silvertopstraat 5333,2023-05-19,03:00:00,25,12,13,FMN 03 Kolonel Silvertopstraat
651,Kolonel Silvertopstraat 5333,2023-05-19,04:00:00,27,16,11,FMN 03 Kolonel Silvertopstraat
651,Kolonel Silvertopstraat 5333,2023-05-19,05:00:00,47,28,19,FMN 03 Kolonel Silvertopstraat
651,Kolonel Silvertopstraat 5333,2023-05-19,06:00:00,62,45,17,FMN 03 Kolonel Silvertopstraat
651,Kolonel Silvertopstraat 5333,2023-05-19,07:00:00,87,65,22,FMN 03 Kolonel Silvertopstraat
651,Kolonel Silvertopstraat 5333,2023-05-19,08:00:00,156,134,22,FMN 03 Kolonel Silvertopstraat
651,Kolonel Silvertopstraat 5333,2023-05-19,09:00:00,166,131,35,FMN 03 Kolonel Silvertopstraat
651,Kolonel Silvertopstraat 5333,2023-05-19,10:00:00,163,133,30,FMN 03 Kolonel Silvertopstraat
651,Kolonel Silvertopstraat 5333,2023-05-19,11:00:00,178,140,38,FMN 03 Kolonel Silvertopstraat
651,Kolonel Silvertopstraat 5333,2023-05-19,12:00:00,204,145,59,FMN 03 Kolonel Silvertopstraat
651,Kolonel Silvertopstraat 5333,2023-05-19,13:00:00,271,195,76,FMN 03 Kolonel Silvertopstraat
651,Kolonel Silvertopstraat 5333,2023-05-19,14:00:00,211,142,69,FMN 03 Kolonel Silvertopstraat
651,Kolonel Silvertopstraat 5333,2023-05-19,15:00:00,102,74,28,FMN 03 Kolonel Silvertopstraat
651,Kolonel Silvertopstraat 5333,2023-05-19,16:00:00,183,132,51,FMN 03 Kolonel Silvertopstraat
651,Kolonel Silvertopstraat 5333,2023-05-19,17:00:00,278,181,97,FMN 03 Kolonel Silvertopstraat
651,Kolonel Silvertopstraat 5333,2023-05-19,18:00:00,254,172,82,FMN 03 Kolonel Silvertopstraat
651,Kolonel Silvertopstraat 5333,2023-05-19,19:00:00,221,153,68,FMN 03 Kolonel Silvertopstraat
651,Kolonel Silvertopstraat 5333,2023-05-19,20:00:00,178,109,69,FMN 03 Kolonel Silvertopstraat
651,Kolonel Silvertopstraat 5333,2023-05-19,21:00:00,147,92,55,FMN 03 Kolonel Silvertopstraat
651,Kolonel Silvertopstraat 5333,2023-05-19,22:00:00,128,80,48,FMN 03 Kolonel Silvertopstraat
651,Kolonel Silvertopstraat 5333,2023-05-19,23:00:00,99,41,58,FMN 03 Kolonel Silvertopstraat
651,Kolonel Silvertopstraat 5333,2023-05-20,00:00:00,66,28,38,FMN 03 Kolonel Silvertopstraat
651,Kolonel Silvertopstraat 5333,2023-05-20,01:00:00,56,18,38,FMN 03 Kolonel Silvertopstraat
651,Kolonel Silvertopstraat 5333,2023-05-20,02:00:00,35,8,27,FMN 03 Kolonel Silvertopstraat
651,Kolonel Silvertopstraat 5333,2023-05-20,03:00:00,20,7,13,FMN 03 Kolonel Silvertopstraat
651,Kolonel Silvertopstraat 5333,2023-05-20,04:00:00,17,8,9,FMN 03 Kolonel Silvertopstraat
651,Kolonel Silvertopstraat 5333,2023-05-20,05:00:00,30,16,14,FMN 03 Kolonel Silvertopstraat
651,Kolonel Silvertopstraat 5333,2023-05-20,06:00:00,43,33,10,FMN 03 Kolonel Silvertopstraat
651,Kolonel Silvertopstraat 5333,2023-05-20,07:00:00,48,32,16,FMN 03 Kolonel Silvertopstraat
651,Kolonel Silvertopstraat 5333,2023-05-20,08:00:00,62,44,18,FMN 03 Kolonel Silvertopstraat
651,Kolonel Silvertopstraat 5333,2023-05-20,09:00:00,130,99,31,FMN 03 Kolonel Silvertopstraat
651,Kolonel Silvertopstraat 5333,2023-05-20,10:00:00,163,138,25,FMN 03 Kolonel Silvertopstraat
651,Kolonel Silvertopstraat 5333,2023-05-20,11:00:00,171,128,43,FMN 03 Kolonel Silvertopstraat
651,Kolonel Silvertopstraat 5333,2023-05-20,12:00:00,224,179,45,FMN 03 Kolonel Silvertopstraat
651,Kolonel Silvertopstraat 5333,2023-05-20,13:00:00,231,166,65,FMN 03 Kolonel Silvertopstraat
651,Kolonel Silvertopstraat 5333,2023-05-20,14:00:00,228,156,72,FMN 03 Kolonel Silvertopstraat
651,Kolonel Silvertopstraat 5333,2023-05-20,15:00:00,183,130,53,FMN 03 Kolonel Silvertopstraat
651,Kolonel Silvertopstraat 5333,2023-05-20,16:00:00,192,130,62,FMN 03 Kolonel Silvertopstraat
651,Kolonel Silvertopstraat 5333,2023-05-20,17:00:00,198,129,69,FMN 03 Kolonel Silvertopstraat
651,Kolonel Silvertopstraat 5333,2023-05-20,18:00:00,273,184,89,FMN 03 Kolonel Silvertopstraat
651,Kolonel Silvertopstraat 5333,2023-05-20,19:00:00,174,116,58,FMN 03 Kolonel Silvertopstraat
651,Kolonel Silvertopstraat 5333,2023-05-20,20:00:00,165,100,65,FMN 03 Kolonel Silvertopstraat
651,Kolonel Silvertopstraat 5333,2023-05-20,21:00:00,117,57,60,FMN 03 Kolonel Silvertopstraat
651,Kolonel Silvertopstraat 5333,2023-05-20,22:00:00,123,68,55,FMN 03 Kolonel Silvertopstraat
651,Kolonel Silvertopstraat 5333,2023-05-20,23:00:00,132,63,69,FMN 03 Kolonel Silvertopstraat
651,Kolonel Silvertopstraat 5333,2023-05-21,00:00:00,68,41,27,FMN 03 Kolonel Silvertopstraat
651,Kolonel Silvertopstraat 5333,2023-05-21,01:00:00,49,23,26,FMN 03 Kolonel Silvertopstraat
651,Kolonel Silvertopstraat 5333,2023-05-21,02:00:00,37,17,20,FMN 03 Kolonel Silvertopstraat
651,Kolonel Silvertopstraat 5333,2023-05-21,03:00:00,26,12,14,FMN 03 Kolonel Silvertopstraat
651,Kolonel Silvertopstraat 5333,2023-05-21,04:00:00,14,6,8,FMN 03 Kolonel Silvertopstraat
651,Kolonel Silvertopstraat 5333,2023-05-21,05:00:00,35,22,13,FMN 03 Kolonel Silvertopstraat
651,Kolonel Silvertopstraat 5333,2023-05-21,06:00:00,31,23,8,FMN 03 Kolonel Silvertopstraat
651,Kolonel Silvertopstraat 5333,2023-05-21,07:00:00,27,21,6,FMN 03 Kolonel Silvertopstraat
651,Kolonel Silvertopstraat 5333,2023-05-21,08:00:00,57,40,17,FMN 03 Kolonel Silvertopstraat
651,Kolonel Silvertopstraat 5333,2023-05-21,09:00:00,105,82,23,FMN 03 Kolonel Silvertopstraat
651,Kolonel Silvertopstraat 5333,2023-05-21,10:00:00,142,115,27,FMN 03 Kolonel Silvertopstraat
651,Kolonel Silvertopstraat 5333,2023-05-21,11:00:00,176,154,22,FMN 03 Kolonel Silvertopstraat
651,Kolonel Silvertopstraat 5333,2023-05-21,12:00:00,172,132,40,FMN 03 Kolonel Silvertopstraat
651,Kolonel Silvertopstraat 5333,2023-05-21,13:00:00,175,124,51,FMN 03 Kolonel Silvertopstraat
651,Kolonel Silvertopstraat 5333,2023-05-21,14:00:00,207,153,54,FMN 03 Kolonel Silvertopstraat
651,Kolonel Silvertopstraat 5333,2023-05-21,15:00:00,182,123,59,FMN 03 Kolonel Silvertopstraat
651,Kolonel Silvertopstraat 5333,2023-05-21,16:00:00,158,111,47,FMN 03 Kolonel Silvertopstraat
651,Kolonel Silvertopstraat 5333,2023-05-21,17:00:00,198,125,73,FMN 03 Kolonel Silvertopstraat
651,Kolonel Silvertopstraat 5333,2023-05-21,18:00:00,207,137,70,FMN 03 Kolonel Silvertopstraat
651,Kolonel Silvertopstraat 5333,2023-05-21,19:00:00,156,99,57,FMN 03 Kolonel Silvertopstraat
651,Kolonel Silvertopstraat 5333,2023-05-21,20:00:00,150,95,55,FMN 03 Kolonel Silvertopstraat
651,Kolonel Silvertopstraat 5333,2023-05-21,21:00:00,122,68,54,FMN 03 Kolonel Silvertopstraat
651,Kolonel Silvertopstraat 5333,2023-05-21,22:00:00,100,52,48,FMN 03 Kolonel Silvertopstraat
651,Kolonel Silvertopstraat 5333,2023-05-21,23:00:00,55,22,33,FMN 03 Kolonel Silvertopstraat
651,Kolonel Silvertopstraat 5333,2023-05-22,00:00:00,36,17,19,FMN 03 Kolonel Silvertopstraat
651,Kolonel Silvertopstraat 5333,2023-05-22,01:00:00,24,12,12,FMN 03 Kolonel Silvertopstraat
651,Kolonel Silvertopstraat 5333,2023-05-22,02:00:00,11,2,9,FMN 03 Kolonel Silvertopstraat
651,Kolonel Silvertopstraat 5333,2023-05-22,03:00:00,10,2,8,FMN 03 Kolonel Silvertopstraat
651,Kolonel Silvertopstraat 5333,2023-05-22,04:00:00,18,16,2,FMN 03 Kolonel Silvertopstraat
651,Kolonel Silvertopstraat 5333,2023-05-22,05:00:00,63,38,25,FMN 03 Kolonel Silvertopstraat
651,Kolonel Silvertopstraat 5333,2023-05-22,06:00:00,141,106,35,FMN 03 Kolonel Silvertopstraat
651,Kolonel Silvertopstraat 5333,2023-05-22,07:00:00,421,351,70,FMN 03 Kolonel Silvertopstraat
651,Kolonel Silvertopstraat 5333,2023-05-22,08:00:00,789,683,106,FMN 03 Kolonel Silvertopstraat
651,Kolonel Silvertopstraat 5333,2023-05-22,09:00:00,272,217,55,FMN 03 Kolonel Silvertopstraat
651,Kolonel Silvertopstraat 5333,2023-05-22,10:00:00,205,151,54,FMN 03 Kolonel Silvertopstraat
651,Kolonel Silvertopstraat 5333,2023-05-22,11:00:00,156,113,43,FMN 03 Kolonel Silvertopstraat
651,Kolonel Silvertopstraat 5333,2023-05-22,12:00:00,198,140,58,FMN 03 Kolonel Silvertopstraat
651,Kolonel Silvertopstraat 5333,2023-05-22,13:00:00,223,158,65,FMN 03 Kolonel Silvertopstraat
651,Kolonel Silvertopstraat 5333,2023-05-22,14:00:00,230,152,78,FMN 03 Kolonel Silvertopstraat
651,Kolonel Silvertopstraat 5333,2023-05-22,15:00:00,374,229,145,FMN 03 Kolonel Silvertopstraat
651,Kolonel Silvertopstraat 5333,2023-05-22,16:00:00,436,296,140,FMN 03 Kolonel Silvertopstraat
651,Kolonel Silvertopstraat 5333,2023-05-22,17:00:00,458,299,159,FMN 03 Kolonel Silvertopstraat
651,Kolonel Silvertopstraat 5333,2023-05-22,18:00:00,299,197,102,FMN 03 Kolonel Silvertopstraat
651,Kolonel Silvertopstraat 5333,2023-05-22,19:00:00,212,145,67,FMN 03 Kolonel Silvertopstraat
651,Kolonel Silvertopstraat 5333,2023-05-22,20:00:00,174,92,82,FMN 03 Kolonel Silvertopstraat
651,Kolonel Silvertopstraat 5333,2023-05-22,21:00:00,166,94,72,FMN 03 Kolonel Silvertopstraat
651,Kolonel Silvertopstraat 5333,2023-05-22,22:00:00,124,71,53,FMN 03 Kolonel Silvertopstraat
651,Kolonel Silvertopstraat 5333,2023-05-22,23:00:00,81,35,46,FMN 03 Kolonel Silvertopstraat
651,Kolonel Silvertopstraat 5333,2023-05-23,00:00:00,34,14,20,FMN 03 Kolonel Silvertopstraat
651,Kolonel Silvertopstraat 5333,2023-05-23,01:00:00,17,7,10,FMN 03 Kolonel Silvertopstraat
651,Kolonel Silvertopstraat 5333,2023-05-23,02:00:00,12,9,3,FMN 03 Kolonel Silvertopstraat
651,Kolonel Silvertopstraat 5333,2023-05-23,03:00:00,14,9,5,FMN 03 Kolonel Silvertopstraat
651,Kolonel Silvertopstraat 5333,2023-05-23,04:00:00,21,15,6,FMN 03 Kolonel Silvertopstraat
651,Kolonel Silvertopstraat 5333,2023-05-23,05:00:00,64,39,25,FMN 03 Kolonel Silvertopstraat
651,Kolonel Silvertopstraat 5333,2023-05-23,06:00:00,156,117,39,FMN 03 Kolonel Silvertopstraat
651,Kolonel Silvertopstraat 5333,2023-05-23,07:00:00,406,334,72,FMN 03 Kolonel Silvertopstraat
651,Kolonel Silvertopstraat 5333,2023-05-23,08:00:00,684,598,86,FMN 03 Kolonel Silvertopstraat
651,Kolonel Silvertopstraat 5333,2023-05-23,09:00:00,273,221,52,FMN 03 Kolonel Silvertopstraat
651,Kolonel Silvertopstraat 5333,2023-05-23,10:00:00,167,124,43,FMN 03 Kolonel Silvertopstraat
651,Kolonel Silvertopstraat 5333,2023-05-23,11:00:00,153,112,41,FMN 03 Kolonel Silvertopstraat
651,Kolonel Silvertopstraat 5333,2023-05-23,12:00:00,247,175,72,FMN 03 Kolonel Silvertopstraat
651,Kolonel Silvertopstraat 5333,2023-05-23,13:00:00,195,139,56,FMN 03 Kolonel Silvertopstraat
651,Kolonel Silvertopstraat 5333,2023-05-23,14:00:00,190,127,63,FMN 03 Kolonel Silvertopstraat
651,Kolonel Silvertopstraat 5333,2023-05-23,15:00:00,297,190,107,FMN 03 Kolonel Silvertopstraat
651,Kolonel Silvertopstraat 5333,2023-05-23,16:00:00,408,255,153,FMN 03 Kolonel Silvertopstraat
651,Kolonel Silvertopstraat 5333,2023-05-23,17:00:00,409,273,136,FMN 03 Kolonel Silvertopstraat
651,Kolonel Silvertopstraat 5333,2023-05-23,18:00:00,327,209,118,FMN 03 Kolonel Silvertopstraat
651,Kolonel Silvertopstraat 5333,2023-05-23,19:00:00,276,171,105,FMN 03 Kolonel Silvertopstraat
651,Kolonel Silvertopstraat 5333,2023-05-23,20:00:00,185,122,63,FMN 03 Kolonel Silvertopstraat
651,Kolonel Silvertopstraat 5333,2023-05-23,21:00:00,146,69,77,FMN 03 Kolonel Silvertopstraat
651,Kolonel Silvertopstraat 5333,2023-05-23,22:00:00,140,80,60,FMN 03 Kolonel Silvertopstraat
651,Kolonel Silvertopstraat 5333,2023-05-23,23:00:00,65,32,33,FMN 03 Kolonel Silvertopstraat
651,Kolonel Silvertopstraat 5333,2023-05-24,00:00:00,34,19,15,FMN 03 Kolonel Silvertopstraat
651,Kolonel Silvertopstraat 5333,2023-05-24,01:00:00,23,12,11,FMN 03 Kolonel Silvertopstraat
651,Kolonel Silvertopstraat 5333,2023-05-24,02:00:00,10,3,7,FMN 03 Kolonel Silvertopstraat
651,Kolonel Silvertopstraat 5333,2023-05-24,03:00:00,9,5,4,FMN 03 Kolonel Silvertopstraat
651,Kolonel Silvertopstraat 5333,2023-05-24,04:00:00,17,16,1,FMN 03 Kolonel Silvertopstraat
651,Kolonel Silvertopstraat 5333,2023-05-24,05:00:00,73,44,29,FMN 03 Kolonel Silvertopstraat
651,Kolonel Silvertopstraat 5333,2023-05-24,06:00:00,149,114,35,FMN 03 Kolonel Silvertopstraat
651,Kolonel Silvertopstraat 5333,2023-05-24,07:00:00,346,274,72,FMN 03 Kolonel Silvertopstraat
651,Kolonel Silvertopstraat 5333,2023-05-24,08:00:00,618,526,92,FMN 03 Kolonel Silvertopstraat
651,Kolonel Silvertopstraat 5333,2023-05-24,09:00:00,255,213,42,FMN 03 Kolonel Silvertopstraat
651,Kolonel Silvertopstraat 5333,2023-05-24,10:00:00,188,140,48,FMN 03 Kolonel Silvertopstraat
651,Kolonel Silvertopstraat 5333,2023-05-24,11:00:00,199,161,38,FMN 03 Kolonel Silvertopstraat
651,Kolonel Silvertopstraat 5333,2023-05-24,12:00:00,356,217,139,FMN 03 Kolonel Silvertopstraat
651,Kolonel Silvertopstraat 5333,2023-05-24,13:00:00,267,173,94,FMN 03 Kolonel Silvertopstraat
651,Kolonel Silvertopstraat 5333,2023-05-24,14:00:00,211,157,54,FMN 03 Kolonel Silvertopstraat
651,Kolonel Silvertopstraat 5333,2023-05-24,15:00:00,269,178,91,FMN 03 Kolonel Silvertopstraat
651,Kolonel Silvertopstraat 5333,2023-05-24,16:00:00,336,233,103,FMN 03 Kolonel Silvertopstraat
651,Kolonel Silvertopstraat 5333,2023-05-24,17:00:00,385,269,116,FMN 03 Kolonel Silvertopstraat
651,Kolonel Silvertopstraat 5333,2023-05-24,18:00:00,327,216,111,FMN 03 Kolonel Silvertopstraat
651,Kolonel Silvertopstraat 5333,2023-05-24,19:00:00,201,130,71,FMN 03 Kolonel Silvertopstraat
651,Kolonel Silvertopstraat 5333,2023-05-24,20:00:00,158,91,67,FMN 03 Kolonel Silvertopstraat
651,Kolonel Silvertopstraat 5333,2023-05-24,21:00:00,140,88,52,FMN 03 Kolonel Silvertopstraat
651,Kolonel Silvertopstraat 5333,2023-05-24,22:00:00,131,72,59,FMN 03 Kolonel Silvertopstraat
651,Kolonel Silvertopstraat 5333,2023-05-24,23:00:00,77,33,44,FMN 03 Kolonel Silvertopstraat
651,Kolonel Silvertopstraat 5333,2023-05-25,00:00:00,24,10,14,FMN 03 Kolonel Silvertopstraat
651,Kolonel Silvertopstraat 5333,2023-05-25,01:00:00,25,10,15,FMN 03 Kolonel Silvertopstraat
651,Kolonel Silvertopstraat 5333,2023-05-25,02:00:00,15,8,7,FMN 03 Kolonel Silvertopstraat
651,Kolonel Silvertopstraat 5333,2023-05-25,03:00:00,12,10,2,FMN 03 Kolonel Silvertopstraat
651,Kolonel Silvertopstraat 5333,2023-05-25,04:00:00,17,17,0,FMN 03 Kolonel Silvertopstraat
651,Kolonel Silvertopstraat 5333,2023-05-25,05:00:00,69,41,28,FMN 03 Kolonel Silvertopstraat
651,Kolonel Silvertopstraat 5333,2023-05-25,06:00:00,168,118,50,FMN 03 Kolonel Silvertopstraat
651,Kolonel Silvertopstraat 5333,2023-05-25,07:00:00,404,331,73,FMN 03 Kolonel Silvertopstraat
651,Kolonel Silvertopstraat 5333,2023-05-25,08:00:00,731,630,101,FMN 03 Kolonel Silvertopstraat
651,Kolonel Silvertopstraat 5333,2023-05-25,09:00:00,267,221,46,FMN 03 Kolonel Silvertopstraat
651,Kolonel Silvertopstraat 5333,2023-05-25,10:00:00,195,148,47,FMN 03 Kolonel Silvertopstraat
651,Kolonel Silvertopstraat 5333,2023-05-25,11:00:00,166,127,39,FMN 03 Kolonel Silvertopstraat
651,Kolonel Silvertopstraat 5333,2023-05-25,12:00:00,247,170,77,FMN 03 Kolonel Silvertopstraat
651,Kolonel Silvertopstraat 5333,2023-05-25,13:00:00,208,147,61,FMN 03 Kolonel Silvertopstraat
651,Kolonel Silvertopstraat 5333,2023-05-25,14:00:00,209,140,69,FMN 03 Kolonel Silvertopstraat
651,Kolonel Silvertopstraat 5333,2023-05-25,15:00:00,311,182,129,FMN 03 Kolonel Silvertopstraat
651,Kolonel Silvertopstraat 5333,2023-05-25,16:00:00,369,248,121,FMN 03 Kolonel Silvertopstraat
651,Kolonel Silvertopstraat 5333,2023-05-25,17:00:00,448,297,151,FMN 03 Kolonel Silvertopstraat
651,Kolonel Silvertopstraat 5333,2023-05-25,18:00:00,339,216,123,FMN 03 Kolonel Silvertopstraat
651,Kolonel Silvertopstraat 5333,2023-05-25,19:00:00,275,186,89,FMN 03 Kolonel Silvertopstraat
651,Kolonel Silvertopstraat 5333,2023-05-25,20:00:00,184,114,70,FMN 03 Kolonel Silvertopstraat
651,Kolonel Silvertopstraat 5333,2023-05-25,21:00:00,118,62,56,FMN 03 Kolonel Silvertopstraat
651,Kolonel Silvertopstraat 5333,2023-05-25,22:00:00,155,76,79,FMN 03 Kolonel Silvertopstraat
651,Kolonel Silvertopstraat 5333,2023-05-25,23:00:00,92,32,60,FMN 03 Kolonel Silvertopstraat
651,Kolonel Silvertopstraat 5333,2023-05-26,00:00:00,53,20,33,FMN 03 Kolonel Silvertopstraat
651,Kolonel Silvertopstraat 5333,2023-05-26,01:00:00,27,12,15,FMN 03 Kolonel Silvertopstraat
651,Kolonel Silvertopstraat 5333,2023-05-26,02:00:00,7,3,4,FMN 03 Kolonel Silvertopstraat
651,Kolonel Silvertopstraat 5333,2023-05-26,03:00:00,12,7,5,FMN 03 Kolonel Silvertopstraat
651,Kolonel Silvertopstraat 5333,2023-05-26,04:00:00,16,9,7,FMN 03 Kolonel Silvertopstraat
651,Kolonel Silvertopstraat 5333,2023-05-26,05:00:00,67,45,22,FMN 03 Kolonel Silvertopstraat
651,Kolonel Silvertopstraat 5333,2023-05-26,06:00:00,120,83,37,FMN 03 Kolonel Silvertopstraat
651,Kolonel Silvertopstraat 5333,2023-05-26,07:00:00,305,251,54,FMN 03 Kolonel Silvertopstraat
651,Kolonel Silvertopstraat 5333,2023-05-26,08:00:00,623,545,78,FMN 03 Kolonel Silvertopstraat
651,Kolonel Silvertopstraat 5333,2023-05-26,09:00:00,253,200,53,FMN 03 Kolonel Silvertopstraat
651,Kolonel Silvertopstraat 5333,2023-05-26,10:00:00,206,147,59,FMN 03 Kolonel Silvertopstraat
651,Kolonel Silvertopstraat 5333,2023-05-26,11:00:00,182,134,48,FMN 03 Kolonel Silvertopstraat
651,Kolonel Silvertopstraat 5333,2023-05-26,12:00:00,229,152,77,FMN 03 Kolonel Silvertopstraat
651,Kolonel Silvertopstraat 5333,2023-05-26,13:00:00,230,148,82,FMN 03 Kolonel Silvertopstraat
651,Kolonel Silvertopstraat 5333,2023-05-26,14:00:00,220,149,71,FMN 03 Kolonel Silvertopstraat
651,Kolonel Silvertopstraat 5333,2023-05-26,15:00:00,199,126,73,FMN 03 Kolonel Silvertopstraat
651,Kolonel Silvertopstraat 5333,2023-05-26,16:00:00,222,154,68,FMN 03 Kolonel Silvertopstraat
651,Kolonel Silvertopstraat 5333,2023-05-26,17:00:00,387,251,136,FMN 03 Kolonel Silvertopstraat
651,Kolonel Silvertopstraat 5333,2023-05-26,18:00:00,345,247,98,FMN 03 Kolonel Silvertopstraat
651,Kolonel Silvertopstraat 5333,2023-05-26,19:00:00,277,200,77,FMN 03 Kolonel Silvertopstraat
651,Kolonel Silvertopstraat 5333,2023-05-26,20:00:00,234,170,64,FMN 03 Kolonel Silvertopstraat
651,Kolonel Silvertopstraat 5333,2023-05-26,21:00:00,167,108,59,FMN 03 Kolonel Silvertopstraat
651,Kolonel Silvertopstraat 5333,2023-05-26,22:00:00,137,81,56,FMN 03 Kolonel Silvertopstraat
651,Kolonel Silvertopstraat 5333,2023-05-26,23:00:00,123,55,68,FMN 03 Kolonel Silvertopstraat
651,Kolonel Silvertopstraat 5333,2023-05-27,00:00:00,69,35,34,FMN 03 Kolonel Silvertopstraat
651,Kolonel Silvertopstraat 5333,2023-05-27,01:00:00,53,16,37,FMN 03 Kolonel Silvertopstraat
651,Kolonel Silvertopstraat 5333,2023-05-27,02:00:00,37,14,23,FMN 03 Kolonel Silvertopstraat
651,Kolonel Silvertopstraat 5333,2023-05-27,03:00:00,26,5,21,FMN 03 Kolonel Silvertopstraat
651,Kolonel Silvertopstraat 5333,2023-05-27,04:00:00,23,17,6,FMN 03 Kolonel Silvertopstraat
651,Kolonel Silvertopstraat 5333,2023-05-27,05:00:00,34,22,12,FMN 03 Kolonel Silvertopstraat
651,Kolonel Silvertopstraat 5333,2023-05-27,06:00:00,41,29,12,FMN 03 Kolonel Silvertopstraat
651,Kolonel Silvertopstraat 5333,2023-05-27,07:00:00,41,30,11,FMN 03 Kolonel Silvertopstraat
651,Kolonel Silvertopstraat 5333,2023-05-27,08:00:00,83,65,18,FMN 03 Kolonel Silvertopstraat
651,Kolonel Silvertopstraat 5333,2023-05-27,09:00:00,168,139,29,FMN 03 Kolonel Silvertopstraat
651,Kolonel Silvertopstraat 5333,2023-05-27,10:00:00,183,144,39,FMN 03 Kolonel Silvertopstraat
651,Kolonel Silvertopstraat 5333,2023-05-27,11:00:00,211,161,50,FMN 03 Kolonel Silvertopstraat
651,Kolonel Silvertopstraat 5333,2023-05-27,12:00:00,211,155,56,FMN 03 Kolonel Silvertopstraat
651,Kolonel Silvertopstraat 5333,2023-05-27,13:00:00,220,163,57,FMN 03 Kolonel Silvertopstraat
651,Kolonel Silvertopstraat 5333,2023-05-27,14:00:00,210,147,63,FMN 03 Kolonel Silvertopstraat
651,Kolonel Silvertopstraat 5333,2023-05-27,15:00:00,41,33,8,FMN 03 Kolonel Silvertopstraat
651,Kolonel Silvertopstraat 5333,2023-05-27,16:00:00,61,38,23,FMN 03 Kolonel Silvertopstraat
651,Kolonel Silvertopstraat 5333,2023-05-27,17:00:00,228,154,74,FMN 03 Kolonel Silvertopstraat
651,Kolonel Silvertopstraat 5333,2023-05-27,18:00:00,208,125,83,FMN 03 Kolonel Silvertopstraat
651,Kolonel Silvertopstraat 5333,2023-05-27,19:00:00,195,142,53,FMN 03 Kolonel Silvertopstraat
651,Kolonel Silvertopstraat 5333,2023-05-27,20:00:00,160,100,60,FMN 03 Kolonel Silvertopstraat
651,Kolonel Silvertopstraat 5333,2023-05-27,21:00:00,149,91,58,FMN 03 Kolonel Silvertopstraat
651,Kolonel Silvertopstraat 5333,2023-05-27,22:00:00,153,96,57,FMN 03 Kolonel Silvertopstraat
651,Kolonel Silvertopstraat 5333,2023-05-27,23:00:00,101,41,60,FMN 03 Kolonel Silvertopstraat
651,Kolonel Silvertopstraat 5333,2023-05-28,00:00:00,86,40,46,FMN 03 Kolonel Silvertopstraat
651,Kolonel Silvertopstraat 5333,2023-05-28,01:00:00,69,31,38,FMN 03 Kolonel Silvertopstraat
651,Kolonel Silvertopstraat 5333,2023-05-28,02:00:00,30,10,20,FMN 03 Kolonel Silvertopstraat
651,Kolonel Silvertopstraat 5333,2023-05-28,03:00:00,25,15,10,FMN 03 Kolonel Silvertopstraat
651,Kolonel Silvertopstraat 5333,2023-05-28,04:00:00,23,14,9,FMN 03 Kolonel Silvertopstraat
651,Kolonel Silvertopstraat 5333,2023-05-28,05:00:00,24,15,9,FMN 03 Kolonel Silvertopstraat
651,Kolonel Silvertopstraat 5333,2023-05-28,06:00:00,23,15,8,FMN 03 Kolonel Silvertopstraat
651,Kolonel Silvertopstraat 5333,2023-05-28,07:00:00,24,15,9,FMN 03 Kolonel Silvertopstraat
651,Kolonel Silvertopstraat 5333,2023-05-28,08:00:00,63,49,14,FMN 03 Kolonel Silvertopstraat
651,Kolonel Silvertopstraat 5333,2023-05-28,09:00:00,116,91,25,FMN 03 Kolonel Silvertopstraat
651,Kolonel Silvertopstraat 5333,2023-05-28,10:00:00,172,149,23,FMN 03 Kolonel Silvertopstraat
651,Kolonel Silvertopstraat 5333,2023-05-28,11:00:00,189,147,42,FMN 03 Kolonel Silvertopstraat
651,Kolonel Silvertopstraat 5333,2023-05-28,12:00:00,191,126,65,FMN 03 Kolonel Silvertopstraat
651,Kolonel Silvertopstraat 5333,2023-05-28,13:00:00,220,170,50,FMN 03 Kolonel Silvertopstraat
651,Kolonel Silvertopstraat 5333,2023-05-28,14:00:00,153,104,49,FMN 03 Kolonel Silvertopstraat
651,Kolonel Silvertopstraat 5333,2023-05-28,15:00:00,37,26,11,FMN 03 Kolonel Silvertopstraat
651,Kolonel Silvertopstraat 5333,2023-05-28,16:00:00,54,41,13,FMN 03 Kolonel Silvertopstraat
651,Kolonel Silvertopstraat 5333,2023-05-28,17:00:00,185,111,74,FMN 03 Kolonel Silvertopstraat
651,Kolonel Silvertopstraat 5333,2023-05-28,18:00:00,180,117,63,FMN 03 Kolonel Silvertopstraat
651,Kolonel Silvertopstraat 5333,2023-05-28,19:00:00,185,122,63,FMN 03 Kolonel Silvertopstraat
651,Kolonel Silvertopstraat 5333,2023-05-28,20:00:00,185,127,58,FMN 03 Kolonel Silvertopstraat
651,Kolonel Silvertopstraat 5333,2023-05-28,21:00:00,131,87,44,FMN 03 Kolonel Silvertopstraat
651,Kolonel Silvertopstraat 5333,2023-05-28,22:00:00,137,75,62,FMN 03 Kolonel Silvertopstraat
651,Kolonel Silvertopstraat 5333,2023-05-28,23:00:00,103,45,58,FMN 03 Kolonel Silvertopstraat
651,Kolonel Silvertopstraat 5333,2023-05-29,00:00:00,67,32,35,FMN 03 Kolonel Silvertopstraat
651,Kolonel Silvertopstraat 5333,2023-05-29,01:00:00,42,16,26,FMN 03 Kolonel Silvertopstraat
651,Kolonel Silvertopstraat 5333,2023-05-29,02:00:00,21,9,12,FMN 03 Kolonel Silvertopstraat
651,Kolonel Silvertopstraat 5333,2023-05-29,03:00:00,14,6,8,FMN 03 Kolonel Silvertopstraat
651,Kolonel Silvertopstraat 5333,2023-05-29,04:00:00,26,16,10,FMN 03 Kolonel Silvertopstraat
651,Kolonel Silvertopstraat 5333,2023-05-29,05:00:00,32,16,16,FMN 03 Kolonel Silvertopstraat
651,Kolonel Silvertopstraat 5333,2023-05-29,06:00:00,32,19,13,FMN 03 Kolonel Silvertopstraat
651,Kolonel Silvertopstraat 5333,2023-05-29,07:00:00,32,20,12,FMN 03 Kolonel Silvertopstraat
651,Kolonel Silvertopstraat 5333,2023-05-29,08:00:00,51,41,10,FMN 03 Kolonel Silvertopstraat
651,Kolonel Silvertopstraat 5333,2023-05-29,09:00:00,80,62,18,FMN 03 Kolonel Silvertopstraat
651,Kolonel Silvertopstraat 5333,2023-05-29,10:00:00,116,90,26,FMN 03 Kolonel Silvertopstraat
651,Kolonel Silvertopstraat 5333,2023-05-29,11:00:00,128,79,49,FMN 03 Kolonel Silvertopstraat
651,Kolonel Silvertopstraat 5333,2023-05-29,12:00:00,155,116,39,FMN 03 Kolonel Silvertopstraat
651,Kolonel Silvertopstraat 5333,2023-05-29,13:00:00,206,159,47,FMN 03 Kolonel Silvertopstraat
651,Kolonel Silvertopstraat 5333,2023-05-29,14:00:00,208,155,53,FMN 03 Kolonel Silvertopstraat
651,Kolonel Silvertopstraat 5333,2023-05-29,15:00:00,178,120,58,FMN 03 Kolonel Silvertopstraat
651,Kolonel Silvertopstraat 5333,2023-05-29,16:00:00,170,116,54,FMN 03 Kolonel Silvertopstraat
651,Kolonel Silvertopstraat 5333,2023-05-29,17:00:00,215,145,70,FMN 03 Kolonel Silvertopstraat
651,Kolonel Silvertopstraat 5333,2023-05-29,18:00:00,193,116,77,FMN 03 Kolonel Silvertopstraat
651,Kolonel Silvertopstraat 5333,2023-05-29,19:00:00,185,116,69,FMN 03 Kolonel Silvertopstraat
651,Kolonel Silvertopstraat 5333,2023-05-29,20:00:00,135,84,51,FMN 03 Kolonel Silvertopstraat
651,Kolonel Silvertopstraat 5333,2023-05-29,21:00:00,118,67,51,FMN 03 Kolonel Silvertopstraat
651,Kolonel Silvertopstraat 5333,2023-05-29,22:00:00,100,50,50,FMN 03 Kolonel Silvertopstraat
651,Kolonel Silvertopstraat 5333,2023-05-29,23:00:00,48,14,34,FMN 03 Kolonel Silvertopstraat
651,Kolonel Silvertopstraat 5333,2023-05-30,00:00:00,37,15,22,FMN 03 Kolonel Silvertopstraat
651,Kolonel Silvertopstraat 5333,2023-05-30,01:00:00,11,5,6,FMN 03 Kolonel Silvertopstraat
651,Kolonel Silvertopstraat 5333,2023-05-30,02:00:00,9,5,4,FMN 03 Kolonel Silvertopstraat
651,Kolonel Silvertopstraat 5333,2023-05-30,03:00:00,16,11,5,FMN 03 Kolonel Silvertopstraat
651,Kolonel Silvertopstraat 5333,2023-05-30,04:00:00,40,34,6,FMN 03 Kolonel Silvertopstraat
651,Kolonel Silvertopstraat 5333,2023-05-30,05:00:00,54,33,21,FMN 03 Kolonel Silvertopstraat
651,Kolonel Silvertopstraat 5333,2023-05-30,06:00:00,126,94,32,FMN 03 Kolonel Silvertopstraat
651,Kolonel Silvertopstraat 5333,2023-05-30,07:00:00,381,319,62,FMN 03 Kolonel Silvertopstraat
651,Kolonel Silvertopstraat 5333,2023-05-30,08:00:00,718,615,103,FMN 03 Kolonel Silvertopstraat
651,Kolonel Silvertopstraat 5333,2023-05-30,09:00:00,248,194,54,FMN 03 Kolonel Silvertopstraat
651,Kolonel Silvertopstraat 5333,2023-05-30,10:00:00,196,145,51,FMN 03 Kolonel Silvertopstraat
651,Kolonel Silvertopstraat 5333,2023-05-30,11:00:00,186,138,48,FMN 03 Kolonel Silvertopstraat
651,Kolonel Silvertopstraat 5333,2023-05-30,12:00:00,275,196,79,FMN 03 Kolonel Silvertopstraat
651,Kolonel Silvertopstraat 5333,2023-05-30,13:00:00,241,153,88,FMN 03 Kolonel Silvertopstraat
651,Kolonel Silvertopstraat 5333,2023-05-30,14:00:00,183,120,63,FMN 03 Kolonel Silvertopstraat
651,Kolonel Silvertopstraat 5333,2023-05-30,15:00:00,174,110,64,FMN 03 Kolonel Silvertopstraat
651,Kolonel Silvertopstraat 5333,2023-05-30,16:00:00,247,182,65,FMN 03 Kolonel Silvertopstraat
651,Kolonel Silvertopstraat 5333,2023-05-30,17:00:00,379,243,136,FMN 03 Kolonel Silvertopstraat
651,Kolonel Silvertopstraat 5333,2023-05-30,18:00:00,325,210,115,FMN 03 Kolonel Silvertopstraat
651,Kolonel Silvertopstraat 5333,2023-05-30,19:00:00,238,157,81,FMN 03 Kolonel Silvertopstraat
651,Kolonel Silvertopstraat 5333,2023-05-30,20:00:00,194,109,85,FMN 03 Kolonel Silvertopstraat
651,Kolonel Silvertopstraat 5333,2023-05-30,21:00:00,166,109,57,FMN 03 Kolonel Silvertopstraat
651,Kolonel Silvertopstraat 5333,2023-05-30,22:00:00,159,83,76,FMN 03 Kolonel Silvertopstraat
651,Kolonel Silvertopstraat 5333,2023-05-30,23:00:00,75,32,43,FMN 03 Kolonel Silvertopstraat
651,Kolonel Silvertopstraat 5333,2023-05-31,00:00:00,39,19,20,FMN 03 Kolonel Silvertopstraat
651,Kolonel Silvertopstraat 5333,2023-05-31,01:00:00,23,11,12,FMN 03 Kolonel Silvertopstraat
651,Kolonel Silvertopstraat 5333,2023-05-31,02:00:00,9,7,2,FMN 03 Kolonel Silvertopstraat
651,Kolonel Silvertopstraat 5333,2023-05-31,03:00:00,10,6,4,FMN 03 Kolonel Silvertopstraat
651,Kolonel Silvertopstraat 5333,2023-05-31,04:00:00,33,27,6,FMN 03 Kolonel Silvertopstraat
651,Kolonel Silvertopstraat 5333,2023-05-31,05:00:00,58,37,21,FMN 03 Kolonel Silvertopstraat
651,Kolonel Silvertopstraat 5333,2023-05-31,06:00:00,147,108,39,FMN 03 Kolonel Silvertopstraat
651,Kolonel Silvertopstraat 5333,2023-05-31,07:00:00,343,273,70,FMN 03 Kolonel Silvertopstraat
651,Kolonel Silvertopstraat 5333,2023-05-31,08:00:00,675,574,101,FMN 03 Kolonel Silvertopstraat
651,Kolonel Silvertopstraat 5333,2023-05-31,09:00:00,245,204,41,FMN 03 Kolonel Silvertopstraat
651,Kolonel Silvertopstraat 5333,2023-05-31,10:00:00,186,140,46,FMN 03 Kolonel Silvertopstraat
651,Kolonel Silvertopstraat 5333,2023-05-31,11:00:00,197,149,48,FMN 03 Kolonel Silvertopstraat
651,Kolonel Silvertopstraat 5333,2023-05-31,12:00:00,376,241,135,FMN 03 Kolonel Silvertopstraat
651,Kolonel Silvertopstraat 5333,2023-05-31,13:00:00,265,161,104,FMN 03 Kolonel Silvertopstraat
651,Kolonel Silvertopstraat 5333,2023-05-31,14:00:00,186,120,66,FMN 03 Kolonel Silvertopstraat
651,Kolonel Silvertopstraat 5333,2023-05-31,15:00:00,27,20,7,FMN 03 Kolonel Silvertopstraat
651,Kolonel Silvertopstraat 5333,2023-05-31,16:00:00,54,41,13,FMN 03 Kolonel Silvertopstraat
651,Kolonel Silvertopstraat 5333,2023-05-31,17:00:00,376,233,143,FMN 03 Kolonel Silvertopstraat
651,Kolonel Silvertopstraat 5333,2023-05-31,18:00:00,322,211,111,FMN 03 Kolonel Silvertopstraat
651,Kolonel Silvertopstraat 5333,2023-05-31,19:00:00,246,158,88,FMN 03 Kolonel Silvertopstraat
651,Kolonel Silvertopstraat 5333,2023-05-31,20:00:00,238,151,87,FMN 03 Kolonel Silvertopstraat
651,Kolonel Silvertopstraat 5333,2023-05-31,21:00:00,148,77,71,FMN 03 Kolonel Silvertopstraat
651,Kolonel Silvertopstraat 5333,2023-05-31,22:00:00,148,74,74,FMN 03 Kolonel Silvertopstraat
651,Kolonel Silvertopstraat 5333,2023-05-31,23:00:00,99,43,56,FMN 03 Kolonel Silvertopstraat
651,Kolonel Silvertopstraat 5333,2023-06-01,00:00:00,45,20,25,FMN 03 Kolonel Silvertopstraat
651,Kolonel Silvertopstraat 5333,2023-06-01,01:00:00,28,9,19,FMN 03 Kolonel Silvertopstraat
651,Kolonel Silvertopstraat 5333,2023-06-01,02:00:00,16,8,8,FMN 03 Kolonel Silvertopstraat
651,Kolonel Silvertopstraat 5333,2023-06-01,03:00:00,12,5,7,FMN 03 Kolonel Silvertopstraat
651,Kolonel Silvertopstraat 5333,2023-06-01,04:00:00,28,23,5,FMN 03 Kolonel Silvertopstraat
651,Kolonel Silvertopstraat 5333,2023-06-01,05:00:00,69,41,28,FMN 03 Kolonel Silvertopstraat
651,Kolonel Silvertopstraat 5333,2023-06-01,06:00:00,136,100,36,FMN 03 Kolonel Silvertopstraat
651,Kolonel Silvertopstraat 5333,2023-06-01,07:00:00,400,347,53,FMN 03 Kolonel Silvertopstraat
651,Kolonel Silvertopstraat 5333,2023-06-01,08:00:00,724,641,83,FMN 03 Kolonel Silvertopstraat
651,Kolonel Silvertopstraat 5333,2023-06-01,09:00:00,277,228,49,FMN 03 Kolonel Silvertopstraat
651,Kolonel Silvertopstraat 5333,2023-06-01,10:00:00,193,147,46,FMN 03 Kolonel Silvertopstraat
651,Kolonel Silvertopstraat 5333,2023-06-01,11:00:00,174,132,42,FMN 03 Kolonel Silvertopstraat
651,Kolonel Silvertopstraat 5333,2023-06-01,12:00:00,239,167,72,FMN 03 Kolonel Silvertopstraat
651,Kolonel Silvertopstraat 5333,2023-06-01,13:00:00,220,151,69,FMN 03 Kolonel Silvertopstraat
651,Kolonel Silvertopstraat 5333,2023-06-01,14:00:00,214,142,72,FMN 03 Kolonel Silvertopstraat
651,Kolonel Silvertopstraat 5333,2023-06-01,15:00:00,120,73,47,FMN 03 Kolonel Silvertopstraat
651,Kolonel Silvertopstraat 5333,2023-06-01,16:00:00,148,103,45,FMN 03 Kolonel Silvertopstraat
651,Kolonel Silvertopstraat 5333,2023-06-01,17:00:00,427,270,157,FMN 03 Kolonel Silvertopstraat
651,Kolonel Silvertopstraat 5333,2023-06-01,18:00:00,404,265,139,FMN 03 Kolonel Silvertopstraat
651,Kolonel Silvertopstraat 5333,2023-06-01,19:00:00,261,172,89,FMN 03 Kolonel Silvertopstraat
651,Kolonel Silvertopstraat 5333,2023-06-01,20:00:00,192,128,64,FMN 03 Kolonel Silvertopstraat
651,Kolonel Silvertopstraat 5333,2023-06-01,21:00:00,161,79,82,FMN 03 Kolonel Silvertopstraat
651,Kolonel Silvertopstraat 5333,2023-06-01,22:00:00,149,82,67,FMN 03 Kolonel Silvertopstraat
651,Kolonel Silvertopstraat 5333,2023-06-01,23:00:00,107,40,67,FMN 03 Kolonel Silvertopstraat
651,Kolonel Silvertopstraat 5333,2023-06-02,00:00:00,55,21,34,FMN 03 Kolonel Silvertopstraat
651,Kolonel Silvertopstraat 5333,2023-06-02,01:00:00,19,6,13,FMN 03 Kolonel Silvertopstraat
651,Kolonel Silvertopstraat 5333,2023-06-02,02:00:00,15,10,5,FMN 03 Kolonel Silvertopstraat
651,Kolonel Silvertopstraat 5333,2023-06-02,03:00:00,8,3,5,FMN 03 Kolonel Silvertopstraat
651,Kolonel Silvertopstraat 5333,2023-06-02,04:00:00,31,22,9,FMN 03 Kolonel Silvertopstraat
651,Kolonel Silvertopstraat 5333,2023-06-02,05:00:00,66,44,22,FMN 03 Kolonel Silvertopstraat
651,Kolonel Silvertopstraat 5333,2023-06-02,06:00:00,133,99,34,FMN 03 Kolonel Silvertopstraat
651,Kolonel Silvertopstraat 5333,2023-06-02,07:00:00,328,264,64,FMN 03 Kolonel Silvertopstraat
651,Kolonel Silvertopstraat 5333,2023-06-02,08:00:00,678,592,86,FMN 03 Kolonel Silvertopstraat
651,Kolonel Silvertopstraat 5333,2023-06-02,09:00:00,295,248,47,FMN 03 Kolonel Silvertopstraat
651,Kolonel Silvertopstraat 5333,2023-06-02,10:00:00,167,131,36,FMN 03 Kolonel Silvertopstraat
651,Kolonel Silvertopstraat 5333,2023-06-02,11:00:00,178,127,51,FMN 03 Kolonel Silvertopstraat
651,Kolonel Silvertopstraat 5333,2023-06-02,12:00:00,279,210,69,FMN 03 Kolonel Silvertopstraat
651,Kolonel Silvertopstraat 5333,2023-06-02,13:00:00,248,162,86,FMN 03 Kolonel Silvertopstraat
651,Kolonel Silvertopstraat 5333,2023-06-02,14:00:00,237,165,72,FMN 03 Kolonel Silvertopstraat
651,Kolonel Silvertopstraat 5333,2023-06-02,15:00:00,200,145,55,FMN 03 Kolonel Silvertopstraat
651,Kolonel Silvertopstraat 5333,2023-06-02,16:00:00,213,150,63,FMN 03 Kolonel Silvertopstraat
651,Kolonel Silvertopstraat 5333,2023-06-02,17:00:00,433,302,131,FMN 03 Kolonel Silvertopstraat
651,Kolonel Silvertopstraat 5333,2023-06-02,18:00:00,350,242,108,FMN 03 Kolonel Silvertopstraat
651,Kolonel Silvertopstraat 5333,2023-06-02,19:00:00,322,220,102,FMN 03 Kolonel Silvertopstraat
651,Kolonel Silvertopstraat 5333,2023-06-02,20:00:00,194,134,60,FMN 03 Kolonel Silvertopstraat
651,Kolonel Silvertopstraat 5333,2023-06-02,21:00:00,193,122,71,FMN 03 Kolonel Silvertopstraat
651,Kolonel Silvertopstraat 5333,2023-06-02,22:00:00,155,97,58,FMN 03 Kolonel Silvertopstraat
651,Kolonel Silvertopstraat 5333,2023-06-02,23:00:00,123,55,68,FMN 03 Kolonel Silvertopstraat
651,Kolonel Silvertopstraat 5333,2023-06-03,00:00:00,148,71,77,FMN 03 Kolonel Silvertopstraat
651,Kolonel Silvertopstraat 5333,2023-06-03,01:00:00,91,47,44,FMN 03 Kolonel Silvertopstraat
651,Kolonel Silvertopstraat 5333,2023-06-03,02:00:00,52,23,29,FMN 03 Kolonel Silvertopstraat
651,Kolonel Silvertopstraat 5333,2023-06-03,03:00:00,36,12,24,FMN 03 Kolonel Silvertopstraat
651,Kolonel Silvertopstraat 5333,2023-06-03,04:00:00,29,15,14,FMN 03 Kolonel Silvertopstraat
651,Kolonel Silvertopstraat 5333,2023-06-03,05:00:00,36,19,17,FMN 03 Kolonel Silvertopstraat
651,Kolonel Silvertopstraat 5333,2023-06-03,06:00:00,34,26,8,FMN 03 Kolonel Silvertopstraat
651,Kolonel Silvertopstraat 5333,2023-06-03,07:00:00,39,32,7,FMN 03 Kolonel Silvertopstraat
651,Kolonel Silvertopstraat 5333,2023-06-03,08:00:00,82,58,24,FMN 03 Kolonel Silvertopstraat
651,Kolonel Silvertopstraat 5333,2023-06-03,09:00:00,179,148,31,FMN 03 Kolonel Silvertopstraat
651,Kolonel Silvertopstraat 5333,2023-06-03,10:00:00,181,142,39,FMN 03 Kolonel Silvertopstraat
651,Kolonel Silvertopstraat 5333,2023-06-03,11:00:00,215,156,59,FMN 03 Kolonel Silvertopstraat
651,Kolonel Silvertopstraat 5333,2023-06-03,12:00:00,244,180,64,FMN 03 Kolonel Silvertopstraat
651,Kolonel Silvertopstraat 5333,2023-06-03,13:00:00,228,173,55,FMN 03 Kolonel Silvertopstraat
651,Kolonel Silvertopstraat 5333,2023-06-03,14:00:00,219,148,71,FMN 03 Kolonel Silvertopstraat
651,Kolonel Silvertopstraat 5333,2023-06-03,15:00:00,36,22,14,FMN 03 Kolonel Silvertopstraat
651,Kolonel Silvertopstraat 5333,2023-06-03,16:00:00,30,22,8,FMN 03 Kolonel Silvertopstraat
651,Kolonel Silvertopstraat 5333,2023-06-03,17:00:00,232,144,88,FMN 03 Kolonel Silvertopstraat
651,Kolonel Silvertopstraat 5333,2023-06-03,18:00:00,217,140,77,FMN 03 Kolonel Silvertopstraat
651,Kolonel Silvertopstraat 5333,2023-06-03,19:00:00,211,141,70,FMN 03 Kolonel Silvertopstraat
651,Kolonel Silvertopstraat 5333,2023-06-03,20:00:00,166,110,56,FMN 03 Kolonel Silvertopstraat
651,Kolonel Silvertopstraat 5333,2023-06-03,21:00:00,121,82,39,FMN 03 Kolonel Silvertopstraat
651,Kolonel Silvertopstraat 5333,2023-06-03,22:00:00,127,70,57,FMN 03 Kolonel Silvertopstraat
651,Kolonel Silvertopstraat 5333,2023-06-03,23:00:00,102,49,53,FMN 03 Kolonel Silvertopstraat
651,Kolonel Silvertopstraat 5333,2023-06-04,00:00:00,98,46,52,FMN 03 Kolonel Silvertopstraat
651,Kolonel Silvertopstraat 5333,2023-06-04,01:00:00,57,29,28,FMN 03 Kolonel Silvertopstraat
651,Kolonel Silvertopstraat 5333,2023-06-04,02:00:00,31,16,15,FMN 03 Kolonel Silvertopstraat
651,Kolonel Silvertopstraat 5333,2023-06-04,03:00:00,26,7,19,FMN 03 Kolonel Silvertopstraat
651,Kolonel Silvertopstraat 5333,2023-06-04,04:00:00,23,12,11,FMN 03 Kolonel Silvertopstraat
651,Kolonel Silvertopstraat 5333,2023-06-04,05:00:00,37,22,15,FMN 03 Kolonel Silvertopstraat
651,Kolonel Silvertopstraat 5333,2023-06-04,06:00:00,40,32,8,FMN 03 Kolonel Silvertopstraat
651,Kolonel Silvertopstraat 5333,2023-06-04,07:00:00,34,25,9,FMN 03 Kolonel Silvertopstraat
651,Kolonel Silvertopstraat 5333,2023-06-04,08:00:00,70,60,10,FMN 03 Kolonel Silvertopstraat
651,Kolonel Silvertopstraat 5333,2023-06-04,09:00:00,125,99,26,FMN 03 Kolonel Silvertopstraat
651,Kolonel Silvertopstraat 5333,2023-06-04,10:00:00,186,145,41,FMN 03 Kolonel Silvertopstraat
651,Kolonel Silvertopstraat 5333,2023-06-04,11:00:00,208,161,47,FMN 03 Kolonel Silvertopstraat
651,Kolonel Silvertopstraat 5333,2023-06-04,12:00:00,261,206,55,FMN 03 Kolonel Silvertopstraat
651,Kolonel Silvertopstraat 5333,2023-06-04,13:00:00,268,202,66,FMN 03 Kolonel Silvertopstraat
651,Kolonel Silvertopstraat 5333,2023-06-04,14:00:00,233,168,65,FMN 03 Kolonel Silvertopstraat
651,Kolonel Silvertopstraat 5333,2023-06-04,15:00:00,52,39,13,FMN 03 Kolonel Silvertopstraat
651,Kolonel Silvertopstraat 5333,2023-06-04,16:00:00,21,16,5,FMN 03 Kolonel Silvertopstraat
651,Kolonel Silvertopstraat 5333,2023-06-04,17:00:00,202,128,74,FMN 03 Kolonel Silvertopstraat
651,Kolonel Silvertopstraat 5333,2023-06-04,18:00:00,212,146,66,FMN 03 Kolonel Silvertopstraat
651,Kolonel Silvertopstraat 5333,2023-06-04,19:00:00,191,114,77,FMN 03 Kolonel Silvertopstraat
651,Kolonel Silvertopstraat 5333,2023-06-04,20:00:00,175,113,62,FMN 03 Kolonel Silvertopstraat
651,Kolonel Silvertopstraat 5333,2023-06-04,21:00:00,148,80,68,FMN 03 Kolonel Silvertopstraat
651,Kolonel Silvertopstraat 5333,2023-06-04,22:00:00,102,52,50,FMN 03 Kolonel Silvertopstraat
651,Kolonel Silvertopstraat 5333,2023-06-04,23:00:00,78,35,43,FMN 03 Kolonel Silvertopstraat
651,Kolonel Silvertopstraat 5333,2023-06-05,00:00:00,42,19,23,FMN 03 Kolonel Silvertopstraat
651,Kolonel Silvertopstraat 5333,2023-06-05,01:00:00,25,11,14,FMN 03 Kolonel Silvertopstraat
651,Kolonel Silvertopstraat 5333,2023-06-05,02:00:00,11,6,5,FMN 03 Kolonel Silvertopstraat
651,Kolonel Silvertopstraat 5333,2023-06-05,03:00:00,19,11,8,FMN 03 Kolonel Silvertopstraat
651,Kolonel Silvertopstraat 5333,2023-06-05,04:00:00,27,19,8,FMN 03 Kolonel Silvertopstraat
651,Kolonel Silvertopstraat 5333,2023-06-05,05:00:00,71,48,23,FMN 03 Kolonel Silvertopstraat
651,Kolonel Silvertopstraat 5333,2023-06-05,06:00:00,140,105,35,FMN 03 Kolonel Silvertopstraat
651,Kolonel Silvertopstraat 5333,2023-06-05,07:00:00,380,317,63,FMN 03 Kolonel Silvertopstraat
651,Kolonel Silvertopstraat 5333,2023-06-05,08:00:00,732,625,107,FMN 03 Kolonel Silvertopstraat
651,Kolonel Silvertopstraat 5333,2023-06-05,09:00:00,239,189,50,FMN 03 Kolonel Silvertopstraat
651,Kolonel Silvertopstraat 5333,2023-06-05,10:00:00,194,141,53,FMN 03 Kolonel Silvertopstraat
651,Kolonel Silvertopstraat 5333,2023-06-05,11:00:00,158,121,37,FMN 03 Kolonel Silvertopstraat
651,Kolonel Silvertopstraat 5333,2023-06-05,12:00:00,227,156,71,FMN 03 Kolonel Silvertopstraat
651,Kolonel Silvertopstraat 5333,2023-06-05,13:00:00,230,161,69,FMN 03 Kolonel Silvertopstraat
651,Kolonel Silvertopstraat 5333,2023-06-05,14:00:00,228,170,58,FMN 03 Kolonel Silvertopstraat
651,Kolonel Silvertopstraat 5333,2023-06-05,15:00:00,93,63,30,FMN 03 Kolonel Silvertopstraat
651,Kolonel Silvertopstraat 5333,2023-06-05,16:00:00,144,103,41,FMN 03 Kolonel Silvertopstraat
651,Kolonel Silvertopstraat 5333,2023-06-05,17:00:00,481,318,163,FMN 03 Kolonel Silvertopstraat
651,Kolonel Silvertopstraat 5333,2023-06-05,18:00:00,354,236,118,FMN 03 Kolonel Silvertopstraat
651,Kolonel Silvertopstraat 5333,2023-06-05,19:00:00,212,135,77,FMN 03 Kolonel Silvertopstraat
651,Kolonel Silvertopstraat 5333,2023-06-05,20:00:00,207,128,79,FMN 03 Kolonel Silvertopstraat
651,Kolonel Silvertopstraat 5333,2023-06-05,21:00:00,159,87,72,FMN 03 Kolonel Silvertopstraat
651,Kolonel Silvertopstraat 5333,2023-06-05,22:00:00,123,61,62,FMN 03 Kolonel Silvertopstraat
651,Kolonel Silvertopstraat 5333,2023-06-05,23:00:00,66,27,39,FMN 03 Kolonel Silvertopstraat
651,Kolonel Silvertopstraat 5333,2023-06-06,00:00:00,38,13,25,FMN 03 Kolonel Silvertopstraat
651,Kolonel Silvertopstraat 5333,2023-06-06,01:00:00,23,12,11,FMN 03 Kolonel Silvertopstraat
651,Kolonel Silvertopstraat 5333,2023-06-06,02:00:00,12,6,6,FMN 03 Kolonel Silvertopstraat
651,Kolonel Silvertopstraat 5333,2023-06-06,03:00:00,10,5,5,FMN 03 Kolonel Silvertopstraat
651,Kolonel Silvertopstraat 5333,2023-06-06,04:00:00,27,18,9,FMN 03 Kolonel Silvertopstraat
651,Kolonel Silvertopstraat 5333,2023-06-06,05:00:00,72,51,21,FMN 03 Kolonel Silvertopstraat
651,Kolonel Silvertopstraat 5333,2023-06-06,06:00:00,148,109,39,FMN 03 Kolonel Silvertopstraat
651,Kolonel Silvertopstraat 5333,2023-06-06,07:00:00,410,343,67,FMN 03 Kolonel Silvertopstraat
651,Kolonel Silvertopstraat 5333,2023-06-06,08:00:00,768,675,93,FMN 03 Kolonel Silvertopstraat
651,Kolonel Silvertopstraat 5333,2023-06-06,09:00:00,317,254,63,FMN 03 Kolonel Silvertopstraat
651,Kolonel Silvertopstraat 5333,2023-06-06,10:00:00,188,141,47,FMN 03 Kolonel Silvertopstraat
651,Kolonel Silvertopstraat 5333,2023-06-06,11:00:00,196,132,64,FMN 03 Kolonel Silvertopstraat
651,Kolonel Silvertopstraat 5333,2023-06-06,12:00:00,245,171,74,FMN 03 Kolonel Silvertopstraat
651,Kolonel Silvertopstraat 5333,2023-06-06,13:00:00,219,148,71,FMN 03 Kolonel Silvertopstraat
651,Kolonel Silvertopstraat 5333,2023-06-06,14:00:00,212,149,63,FMN 03 Kolonel Silvertopstraat
651,Kolonel Silvertopstraat 5333,2023-06-06,15:00:00,71,46,25,FMN 03 Kolonel Silvertopstraat
651,Kolonel Silvertopstraat 5333,2023-06-06,16:00:00,360,245,115,FMN 03 Kolonel Silvertopstraat
651,Kolonel Silvertopstraat 5333,2023-06-06,17:00:00,455,286,169,FMN 03 Kolonel Silvertopstraat
651,Kolonel Silvertopstraat 5333,2023-06-06,18:00:00,360,216,144,FMN 03 Kolonel Silvertopstraat
651,Kolonel Silvertopstraat 5333,2023-06-06,19:00:00,227,150,77,FMN 03 Kolonel Silvertopstraat
651,Kolonel Silvertopstraat 5333,2023-06-06,20:00:00,187,122,65,FMN 03 Kolonel Silvertopstraat
651,Kolonel Silvertopstraat 5333,2023-06-06,21:00:00,159,78,81,FMN 03 Kolonel Silvertopstraat
651,Kolonel Silvertopstraat 5333,2023-06-06,22:00:00,159,96,63,FMN 03 Kolonel Silvertopstraat
651,Kolonel Silvertopstraat 5333,2023-06-06,23:00:00,102,52,50,FMN 03 Kolonel Silvertopstraat
651,Kolonel Silvertopstraat 5333,2023-06-07,00:00:00,41,15,26,FMN 03 Kolonel Silvertopstraat
651,Kolonel Silvertopstraat 5333,2023-06-07,01:00:00,23,15,8,FMN 03 Kolonel Silvertopstraat
651,Kolonel Silvertopstraat 5333,2023-06-07,02:00:00,11,6,5,FMN 03 Kolonel Silvertopstraat
651,Kolonel Silvertopstraat 5333,2023-06-07,03:00:00,14,8,6,FMN 03 Kolonel Silvertopstraat
651,Kolonel Silvertopstraat 5333,2023-06-07,04:00:00,14,11,3,FMN 03 Kolonel Silvertopstraat
651,Kolonel Silvertopstraat 5333,2023-06-07,05:00:00,73,51,22,FMN 03 Kolonel Silvertopstraat
651,Kolonel Silvertopstraat 5333,2023-06-07,06:00:00,139,103,36,FMN 03 Kolonel Silvertopstraat
651,Kolonel Silvertopstraat 5333,2023-06-07,07:00:00,373,308,65,FMN 03 Kolonel Silvertopstraat
651,Kolonel Silvertopstraat 5333,2023-06-07,08:00:00,661,576,85,FMN 03 Kolonel Silvertopstraat
651,Kolonel Silvertopstraat 5333,2023-06-07,09:00:00,259,210,49,FMN 03 Kolonel Silvertopstraat
651,Kolonel Silvertopstraat 5333,2023-06-07,10:00:00,203,159,44,FMN 03 Kolonel Silvertopstraat
651,Kolonel Silvertopstraat 5333,2023-06-07,11:00:00,192,144,48,FMN 03 Kolonel Silvertopstraat
651,Kolonel Silvertopstraat 5333,2023-06-07,12:00:00,400,236,164,FMN 03 Kolonel Silvertopstraat
651,Kolonel Silvertopstraat 5333,2023-06-07,13:00:00,264,176,88,FMN 03 Kolonel Silvertopstraat
651,Kolonel Silvertopstraat 5333,2023-06-07,14:00:00,248,154,94,FMN 03 Kolonel Silvertopstraat
651,Kolonel Silvertopstraat 5333,2023-06-07,15:00:00,267,189,78,FMN 03 Kolonel Silvertopstraat
651,Kolonel Silvertopstraat 5333,2023-06-07,16:00:00,348,256,92,FMN 03 Kolonel Silvertopstraat
651,Kolonel Silvertopstraat 5333,2023-06-07,17:00:00,401,256,145,FMN 03 Kolonel Silvertopstraat
651,Kolonel Silvertopstraat 5333,2023-06-07,18:00:00,321,218,103,FMN 03 Kolonel Silvertopstraat
651,Kolonel Silvertopstraat 5333,2023-06-07,19:00:00,226,157,69,FMN 03 Kolonel Silvertopstraat
651,Kolonel Silvertopstraat 5333,2023-06-07,20:00:00,203,131,72,FMN 03 Kolonel Silvertopstraat
651,Kolonel Silvertopstraat 5333,2023-06-07,21:00:00,138,80,58,FMN 03 Kolonel Silvertopstraat
651,Kolonel Silvertopstraat 5333,2023-06-07,22:00:00,163,84,79,FMN 03 Kolonel Silvertopstraat
651,Kolonel Silvertopstraat 5333,2023-06-07,23:00:00,96,46,50,FMN 03 Kolonel Silvertopstraat
651,Kolonel Silvertopstraat 5333,2023-06-08,00:00:00,34,16,18,FMN 03 Kolonel Silvertopstraat
651,Kolonel Silvertopstraat 5333,2023-06-08,01:00:00,29,18,11,FMN 03 Kolonel Silvertopstraat
651,Kolonel Silvertopstraat 5333,2023-06-08,02:00:00,22,10,12,FMN 03 Kolonel Silvertopstraat
651,Kolonel Silvertopstraat 5333,2023-06-08,03:00:00,25,8,17,FMN 03 Kolonel Silvertopstraat
651,Kolonel Silvertopstraat 5333,2023-06-08,04:00:00,23,18,5,FMN 03 Kolonel Silvertopstraat
651,Kolonel Silvertopstraat 5333,2023-06-08,05:00:00,69,48,21,FMN 03 Kolonel Silvertopstraat
651,Kolonel Silvertopstraat 5333,2023-06-08,06:00:00,133,104,29,FMN 03 Kolonel Silvertopstraat
651,Kolonel Silvertopstraat 5333,2023-06-08,07:00:00,372,302,70,FMN 03 Kolonel Silvertopstraat
651,Kolonel Silvertopstraat 5333,2023-06-08,08:00:00,787,692,95,FMN 03 Kolonel Silvertopstraat
651,Kolonel Silvertopstraat 5333,2023-06-08,09:00:00,254,208,46,FMN 03 Kolonel Silvertopstraat
651,Kolonel Silvertopstraat 5333,2023-06-08,10:00:00,196,147,49,FMN 03 Kolonel Silvertopstraat
651,Kolonel Silvertopstraat 5333,2023-06-08,11:00:00,222,169,53,FMN 03 Kolonel Silvertopstraat
651,Kolonel Silvertopstraat 5333,2023-06-08,12:00:00,303,208,95,FMN 03 Kolonel Silvertopstraat
651,Kolonel Silvertopstraat 5333,2023-06-08,13:00:00,256,158,98,FMN 03 Kolonel Silvertopstraat
651,Kolonel Silvertopstraat 5333,2023-06-08,14:00:00,231,151,80,FMN 03 Kolonel Silvertopstraat
651,Kolonel Silvertopstraat 5333,2023-06-08,15:00:00,88,59,29,FMN 03 Kolonel Silvertopstraat
651,Kolonel Silvertopstraat 5333,2023-06-08,16:00:00,222,158,64,FMN 03 Kolonel Silvertopstraat
651,Kolonel Silvertopstraat 5333,2023-06-08,17:00:00,441,283,158,FMN 03 Kolonel Silvertopstraat
651,Kolonel Silvertopstraat 5333,2023-06-08,18:00:00,328,218,110,FMN 03 Kolonel Silvertopstraat
651,Kolonel Silvertopstraat 5333,2023-06-08,19:00:00,250,160,90,FMN 03 Kolonel Silvertopstraat
651,Kolonel Silvertopstraat 5333,2023-06-08,20:00:00,215,116,99,FMN 03 Kolonel Silvertopstraat
651,Kolonel Silvertopstraat 5333,2023-06-08,21:00:00,166,88,78,FMN 03 Kolonel Silvertopstraat
651,Kolonel Silvertopstraat 5333,2023-06-08,22:00:00,161,78,83,FMN 03 Kolonel Silvertopstraat
651,Kolonel Silvertopstraat 5333,2023-06-08,23:00:00,106,51,55,FMN 03 Kolonel Silvertopstraat
651,Kolonel Silvertopstraat 5333,2023-06-09,00:00:00,66,25,41,FMN 03 Kolonel Silvertopstraat
651,Kolonel Silvertopstraat 5333,2023-06-09,01:00:00,33,11,22,FMN 03 Kolonel Silvertopstraat
651,Kolonel Silvertopstraat 5333,2023-06-09,02:00:00,20,8,12,FMN 03 Kolonel Silvertopstraat
651,Kolonel Silvertopstraat 5333,2023-06-09,03:00:00,19,12,7,FMN 03 Kolonel Silvertopstraat
651,Kolonel Silvertopstraat 5333,2023-06-09,04:00:00,22,14,8,FMN 03 Kolonel Silvertopstraat
651,Kolonel Silvertopstraat 5333,2023-06-09,05:00:00,65,47,18,FMN 03 Kolonel Silvertopstraat
651,Kolonel Silvertopstraat 5333,2023-06-09,06:00:00,134,104,30,FMN 03 Kolonel Silvertopstraat
651,Kolonel Silvertopstraat 5333,2023-06-09,07:00:00,354,299,55,FMN 03 Kolonel Silvertopstraat
651,Kolonel Silvertopstraat 5333,2023-06-09,08:00:00,738,626,112,FMN 03 Kolonel Silvertopstraat
651,Kolonel Silvertopstraat 5333,2023-06-09,09:00:00,267,219,48,FMN 03 Kolonel Silvertopstraat
651,Kolonel Silvertopstraat 5333,2023-06-09,10:00:00,225,180,45,FMN 03 Kolonel Silvertopstraat
651,Kolonel Silvertopstraat 5333,2023-06-09,11:00:00,234,166,68,FMN 03 Kolonel Silvertopstraat
651,Kolonel Silvertopstraat 5333,2023-06-09,12:00:00,276,192,84,FMN 03 Kolonel Silvertopstraat
651,Kolonel Silvertopstraat 5333,2023-06-09,13:00:00,278,186,92,FMN 03 Kolonel Silvertopstraat
651,Kolonel Silvertopstraat 5333,2023-06-09,14:00:00,308,185,123,FMN 03 Kolonel Silvertopstraat
651,Kolonel Silvertopstraat 5333,2023-06-09,15:00:00,392,264,128,FMN 03 Kolonel Silvertopstraat
651,Kolonel Silvertopstraat 5333,2023-06-09,16:00:00,424,281,143,FMN 03 Kolonel Silvertopstraat
651,Kolonel Silvertopstraat 5333,2023-06-09,17:00:00,397,274,123,FMN 03 Kolonel Silvertopstraat
651,Kolonel Silvertopstraat 5333,2023-06-09,18:00:00,384,277,107,FMN 03 Kolonel Silvertopstraat
651,Kolonel Silvertopstraat 5333,2023-06-09,19:00:00,311,224,87,FMN 03 Kolonel Silvertopstraat
651,Kolonel Silvertopstraat 5333,2023-06-09,20:00:00,223,140,83,FMN 03 Kolonel Silvertopstraat
651,Kolonel Silvertopstraat 5333,2023-06-09,21:00:00,187,121,66,FMN 03 Kolonel Silvertopstraat
651,Kolonel Silvertopstraat 5333,2023-06-09,22:00:00,172,97,75,FMN 03 Kolonel Silvertopstraat
651,Kolonel Silvertopstraat 5333,2023-06-09,23:00:00,120,49,71,FMN 03 Kolonel Silvertopstraat
651,Kolonel Silvertopstraat 5333,2023-06-10,00:00:00,71,26,45,FMN 03 Kolonel Silvertopstraat
651,Kolonel Silvertopstraat 5333,2023-06-10,01:00:00,76,28,48,FMN 03 Kolonel Silvertopstraat
651,Kolonel Silvertopstraat 5333,2023-06-10,02:00:00,52,21,31,FMN 03 Kolonel Silvertopstraat
651,Kolonel Silvertopstraat 5333,2023-06-10,03:00:00,51,14,37,FMN 03 Kolonel Silvertopstraat
651,Kolonel Silvertopstraat 5333,2023-06-10,04:00:00,22,6,16,FMN 03 Kolonel Silvertopstraat
651,Kolonel Silvertopstraat 5333,2023-06-10,05:00:00,30,16,14,FMN 03 Kolonel Silvertopstraat
651,Kolonel Silvertopstraat 5333,2023-06-10,06:00:00,43,28,15,FMN 03 Kolonel Silvertopstraat
651,Kolonel Silvertopstraat 5333,2023-06-10,07:00:00,52,41,11,FMN 03 Kolonel Silvertopstraat
651,Kolonel Silvertopstraat 5333,2023-06-10,08:00:00,116,84,32,FMN 03 Kolonel Silvertopstraat
651,Kolonel Silvertopstraat 5333,2023-06-10,09:00:00,192,147,45,FMN 03 Kolonel Silvertopstraat
651,Kolonel Silvertopstraat 5333,2023-06-10,10:00:00,239,180,59,FMN 03 Kolonel Silvertopstraat
651,Kolonel Silvertopstraat 5333,2023-06-10,11:00:00,216,169,47,FMN 03 Kolonel Silvertopstraat
651,Kolonel Silvertopstraat 5333,2023-06-10,12:00:00,237,177,60,FMN 03 Kolonel Silvertopstraat
651,Kolonel Silvertopstraat 5333,2023-06-10,13:00:00,231,168,63,FMN 03 Kolonel Silvertopstraat
651,Kolonel Silvertopstraat 5333,2023-06-10,14:00:00,226,162,64,FMN 03 Kolonel Silvertopstraat
651,Kolonel Silvertopstraat 5333,2023-06-10,15:00:00,231,156,75,FMN 03 Kolonel Silvertopstraat
651,Kolonel Silvertopstraat 5333,2023-06-10,16:00:00,208,148,60,FMN 03 Kolonel Silvertopstraat
651,Kolonel Silvertopstraat 5333,2023-06-10,17:00:00,219,158,61,FMN 03 Kolonel Silvertopstraat
651,Kolonel Silvertopstraat 5333,2023-06-10,18:00:00,267,186,81,FMN 03 Kolonel Silvertopstraat
651,Kolonel Silvertopstraat 5333,2023-06-10,19:00:00,233,162,71,FMN 03 Kolonel Silvertopstraat
651,Kolonel Silvertopstraat 5333,2023-06-10,20:00:00,207,123,84,FMN 03 Kolonel Silvertopstraat
651,Kolonel Silvertopstraat 5333,2023-06-10,21:00:00,161,105,56,FMN 03 Kolonel Silvertopstraat
651,Kolonel Silvertopstraat 5333,2023-06-10,22:00:00,132,67,65,FMN 03 Kolonel Silvertopstraat
651,Kolonel Silvertopstraat 5333,2023-06-10,23:00:00,133,65,68,FMN 03 Kolonel Silvertopstraat
651,Kolonel Silvertopstraat 5333,2023-06-11,00:00:00,108,56,52,FMN 03 Kolonel Silvertopstraat
651,Kolonel Silvertopstraat 5333,2023-06-11,01:00:00,65,24,41,FMN 03 Kolonel Silvertopstraat
651,Kolonel Silvertopstraat 5333,2023-06-11,02:00:00,51,24,27,FMN 03 Kolonel Silvertopstraat
651,Kolonel Silvertopstraat 5333,2023-06-11,03:00:00,39,14,25,FMN 03 Kolonel Silvertopstraat
651,Kolonel Silvertopstraat 5333,2023-06-11,04:00:00,23,11,12,FMN 03 Kolonel Silvertopstraat
651,Kolonel Silvertopstraat 5333,2023-06-11,05:00:00,33,22,11,FMN 03 Kolonel Silvertopstraat
651,Kolonel Silvertopstraat 5333,2023-06-11,06:00:00,33,22,11,FMN 03 Kolonel Silvertopstraat
651,Kolonel Silvertopstraat 5333,2023-06-11,07:00:00,40,27,13,FMN 03 Kolonel Silvertopstraat
651,Kolonel Silvertopstraat 5333,2023-06-11,08:00:00,85,69,16,FMN 03 Kolonel Silvertopstraat
651,Kolonel Silvertopstraat 5333,2023-06-11,09:00:00,153,123,30,FMN 03 Kolonel Silvertopstraat
651,Kolonel Silvertopstraat 5333,2023-06-11,10:00:00,158,125,33,FMN 03 Kolonel Silvertopstraat
651,Kolonel Silvertopstraat 5333,2023-06-11,11:00:00,174,134,40,FMN 03 Kolonel Silvertopstraat
651,Kolonel Silvertopstraat 5333,2023-06-11,12:00:00,173,134,39,FMN 03 Kolonel Silvertopstraat
651,Kolonel Silvertopstraat 5333,2023-06-11,13:00:00,182,112,70,FMN 03 Kolonel Silvertopstraat
651,Kolonel Silvertopstraat 5333,2023-06-11,14:00:00,227,144,83,FMN 03 Kolonel Silvertopstraat
651,Kolonel Silvertopstraat 5333,2023-06-11,15:00:00,180,123,57,FMN 03 Kolonel Silvertopstraat
651,Kolonel Silvertopstraat 5333,2023-06-11,16:00:00,154,97,57,FMN 03 Kolonel Silvertopstraat
651,Kolonel Silvertopstraat 5333,2023-06-11,17:00:00,178,110,68,FMN 03 Kolonel Silvertopstraat
651,Kolonel Silvertopstraat 5333,2023-06-11,18:00:00,172,124,48,FMN 03 Kolonel Silvertopstraat
651,Kolonel Silvertopstraat 5333,2023-06-11,19:00:00,190,125,65,FMN 03 Kolonel Silvertopstraat
651,Kolonel Silvertopstraat 5333,2023-06-11,20:00:00,173,115,58,FMN 03 Kolonel Silvertopstraat
651,Kolonel Silvertopstraat 5333,2023-06-11,21:00:00,122,70,52,FMN 03 Kolonel Silvertopstraat
651,Kolonel Silvertopstraat 5333,2023-06-11,22:00:00,129,70,59,FMN 03 Kolonel Silvertopstraat
651,Kolonel Silvertopstraat 5333,2023-06-11,23:00:00,95,42,53,FMN 03 Kolonel Silvertopstraat
651,Kolonel Silvertopstraat 5333,2023-06-12,00:00:00,38,19,19,FMN 03 Kolonel Silvertopstraat
651,Kolonel Silvertopstraat 5333,2023-06-12,01:00:00,27,10,17,FMN 03 Kolonel Silvertopstraat
651,Kolonel Silvertopstraat 5333,2023-06-12,02:00:00,18,7,11,FMN 03 Kolonel Silvertopstraat
651,Kolonel Silvertopstraat 5333,2023-06-12,03:00:00,14,7,7,FMN 03 Kolonel Silvertopstraat
651,Kolonel Silvertopstraat 5333,2023-06-12,04:00:00,37,26,11,FMN 03 Kolonel Silvertopstraat
651,Kolonel Silvertopstraat 5333,2023-06-12,05:00:00,68,50,18,FMN 03 Kolonel Silvertopstraat
651,Kolonel Silvertopstraat 5333,2023-06-12,06:00:00,147,112,35,FMN 03 Kolonel Silvertopstraat
651,Kolonel Silvertopstraat 5333,2023-06-12,07:00:00,440,361,79,FMN 03 Kolonel Silvertopstraat
651,Kolonel Silvertopstraat 5333,2023-06-12,08:00:00,765,670,95,FMN 03 Kolonel Silvertopstraat
651,Kolonel Silvertopstraat 5333,2023-06-12,09:00:00,241,200,41,FMN 03 Kolonel Silvertopstraat
651,Kolonel Silvertopstraat 5333,2023-06-12,10:00:00,220,170,50,FMN 03 Kolonel Silvertopstraat
651,Kolonel Silvertopstraat 5333,2023-06-12,11:00:00,214,146,68,FMN 03 Kolonel Silvertopstraat
651,Kolonel Silvertopstraat 5333,2023-06-12,12:00:00,279,195,84,FMN 03 Kolonel Silvertopstraat
651,Kolonel Silvertopstraat 5333,2023-06-12,13:00:00,203,135,68,FMN 03 Kolonel Silvertopstraat
651,Kolonel Silvertopstraat 5333,2023-06-12,14:00:00,238,154,84,FMN 03 Kolonel Silvertopstraat
651,Kolonel Silvertopstraat 5333,2023-06-12,15:00:00,350,226,124,FMN 03 Kolonel Silvertopstraat
651,Kolonel Silvertopstraat 5333,2023-06-12,16:00:00,406,275,131,FMN 03 Kolonel Silvertopstraat
651,Kolonel Silvertopstraat 5333,2023-06-12,17:00:00,456,284,172,FMN 03 Kolonel Silvertopstraat
651,Kolonel Silvertopstraat 5333,2023-06-12,18:00:00,307,188,119,FMN 03 Kolonel Silvertopstraat
651,Kolonel Silvertopstraat 5333,2023-06-12,19:00:00,226,160,66,FMN 03 Kolonel Silvertopstraat
651,Kolonel Silvertopstraat 5333,2023-06-12,20:00:00,177,106,71,FMN 03 Kolonel Silvertopstraat
651,Kolonel Silvertopstraat 5333,2023-06-12,21:00:00,135,71,64,FMN 03 Kolonel Silvertopstraat
651,Kolonel Silvertopstraat 5333,2023-06-12,22:00:00,131,74,57,FMN 03 Kolonel Silvertopstraat
651,Kolonel Silvertopstraat 5333,2023-06-12,23:00:00,74,38,36,FMN 03 Kolonel Silvertopstraat
651,Kolonel Silvertopstraat 5333,2023-06-13,00:00:00,47,25,22,FMN 03 Kolonel Silvertopstraat
651,Kolonel Silvertopstraat 5333,2023-06-13,01:00:00,31,18,13,FMN 03 Kolonel Silvertopstraat
651,Kolonel Silvertopstraat 5333,2023-06-13,02:00:00,24,9,15,FMN 03 Kolonel Silvertopstraat
651,Kolonel Silvertopstraat 5333,2023-06-13,03:00:00,11,6,5,FMN 03 Kolonel Silvertopstraat
651,Kolonel Silvertopstraat 5333,2023-06-13,04:00:00,37,28,9,FMN 03 Kolonel Silvertopstraat
651,Kolonel Silvertopstraat 5333,2023-06-13,05:00:00,73,53,20,FMN 03 Kolonel Silvertopstraat
651,Kolonel Silvertopstraat 5333,2023-06-13,06:00:00,151,114,37,FMN 03 Kolonel Silvertopstraat
651,Kolonel Silvertopstraat 5333,2023-06-13,07:00:00,428,364,64,FMN 03 Kolonel Silvertopstraat
651,Kolonel Silvertopstraat 5333,2023-06-13,08:00:00,772,668,104,FMN 03 Kolonel Silvertopstraat
651,Kolonel Silvertopstraat 5333,2023-06-13,09:00:00,289,233,56,FMN 03 Kolonel Silvertopstraat
651,Kolonel Silvertopstraat 5333,2023-06-13,10:00:00,242,188,54,FMN 03 Kolonel Silvertopstraat
651,Kolonel Silvertopstraat 5333,2023-06-13,11:00:00,199,142,57,FMN 03 Kolonel Silvertopstraat
651,Kolonel Silvertopstraat 5333,2023-06-13,12:00:00,272,163,109,FMN 03 Kolonel Silvertopstraat
651,Kolonel Silvertopstraat 5333,2023-06-13,13:00:00,218,146,72,FMN 03 Kolonel Silvertopstraat
651,Kolonel Silvertopstraat 5333,2023-06-13,14:00:00,244,175,69,FMN 03 Kolonel Silvertopstraat
651,Kolonel Silvertopstraat 5333,2023-06-13,15:00:00,341,235,106,FMN 03 Kolonel Silvertopstraat
651,Kolonel Silvertopstraat 5333,2023-06-13,16:00:00,441,289,152,FMN 03 Kolonel Silvertopstraat
651,Kolonel Silvertopstraat 5333,2023-06-13,17:00:00,410,251,159,FMN 03 Kolonel Silvertopstraat
651,Kolonel Silvertopstraat 5333,2023-06-13,18:00:00,357,228,129,FMN 03 Kolonel Silvertopstraat
651,Kolonel Silvertopstraat 5333,2023-06-13,19:00:00,263,187,76,FMN 03 Kolonel Silvertopstraat
651,Kolonel Silvertopstraat 5333,2023-06-13,20:00:00,206,127,79,FMN 03 Kolonel Silvertopstraat
651,Kolonel Silvertopstraat 5333,2023-06-13,21:00:00,182,101,81,FMN 03 Kolonel Silvertopstraat
651,Kolonel Silvertopstraat 5333,2023-06-13,22:00:00,179,97,82,FMN 03 Kolonel Silvertopstraat
651,Kolonel Silvertopstraat 5333,2023-06-13,23:00:00,120,65,55,FMN 03 Kolonel Silvertopstraat
651,Kolonel Silvertopstraat 5333,2023-06-14,00:00:00,51,23,28,FMN 03 Kolonel Silvertopstraat
651,Kolonel Silvertopstraat 5333,2023-06-14,01:00:00,34,17,17,FMN 03 Kolonel Silvertopstraat
651,Kolonel Silvertopstraat 5333,2023-06-14,02:00:00,17,8,9,FMN 03 Kolonel Silvertopstraat
651,Kolonel Silvertopstraat 5333,2023-06-14,03:00:00,11,9,2,FMN 03 Kolonel Silvertopstraat
651,Kolonel Silvertopstraat 5333,2023-06-14,04:00:00,34,25,9,FMN 03 Kolonel Silvertopstraat
651,Kolonel Silvertopstraat 5333,2023-06-14,05:00:00,72,57,15,FMN 03 Kolonel Silvertopstraat
651,Kolonel Silvertopstraat 5333,2023-06-14,06:00:00,150,112,38,FMN 03 Kolonel Silvertopstraat
651,Kolonel Silvertopstraat 5333,2023-06-14,07:00:00,430,364,66,FMN 03 Kolonel Silvertopstraat
651,Kolonel Silvertopstraat 5333,2023-06-14,08:00:00,662,562,100,FMN 03 Kolonel Silvertopstraat
651,Kolonel Silvertopstraat 5333,2023-06-14,09:00:00,235,185,50,FMN 03 Kolonel Silvertopstraat
651,Kolonel Silvertopstraat 5333,2023-06-14,10:00:00,226,174,52,FMN 03 Kolonel Silvertopstraat
651,Kolonel Silvertopstraat 5333,2023-06-14,11:00:00,227,156,71,FMN 03 Kolonel Silvertopstraat
651,Kolonel Silvertopstraat 5333,2023-06-14,12:00:00,353,210,143,FMN 03 Kolonel Silvertopstraat
651,Kolonel Silvertopstraat 5333,2023-06-14,13:00:00,262,163,99,FMN 03 Kolonel Silvertopstraat
651,Kolonel Silvertopstraat 5333,2023-06-14,14:00:00,245,161,84,FMN 03 Kolonel Silvertopstraat
651,Kolonel Silvertopstraat 5333,2023-06-14,15:00:00,266,170,96,FMN 03 Kolonel Silvertopstraat
651,Kolonel Silvertopstraat 5333,2023-06-14,16:00:00,360,247,113,FMN 03 Kolonel Silvertopstraat
651,Kolonel Silvertopstraat 5333,2023-06-14,17:00:00,396,268,128,FMN 03 Kolonel Silvertopstraat
651,Kolonel Silvertopstraat 5333,2023-06-14,18:00:00,345,213,132,FMN 03 Kolonel Silvertopstraat
651,Kolonel Silvertopstraat 5333,2023-06-14,19:00:00,256,173,83,FMN 03 Kolonel Silvertopstraat
651,Kolonel Silvertopstraat 5333,2023-06-14,20:00:00,213,132,81,FMN 03 Kolonel Silvertopstraat
651,Kolonel Silvertopstraat 5333,2023-06-14,21:00:00,158,86,72,FMN 03 Kolonel Silvertopstraat
651,Kolonel Silvertopstraat 5333,2023-06-14,22:00:00,165,89,76,FMN 03 Kolonel Silvertopstraat
651,Kolonel Silvertopstraat 5333,2023-06-14,23:00:00,93,39,54,FMN 03 Kolonel Silvertopstraat
651,Kolonel Silvertopstraat 5333,2023-06-15,00:00:00,45,25,20,FMN 03 Kolonel Silvertopstraat
651,Kolonel Silvertopstraat 5333,2023-06-15,01:00:00,31,18,13,FMN 03 Kolonel Silvertopstraat
651,Kolonel Silvertopstraat 5333,2023-06-15,02:00:00,20,10,10,FMN 03 Kolonel Silvertopstraat
651,Kolonel Silvertopstraat 5333,2023-06-15,03:00:00,9,4,5,FMN 03 Kolonel Silvertopstraat
651,Kolonel Silvertopstraat 5333,2023-06-15,04:00:00,35,24,11,FMN 03 Kolonel Silvertopstraat
651,Kolonel Silvertopstraat 5333,2023-06-15,05:00:00,66,45,21,FMN 03 Kolonel Silvertopstraat
651,Kolonel Silvertopstraat 5333,2023-06-15,06:00:00,138,104,34,FMN 03 Kolonel Silvertopstraat
651,Kolonel Silvertopstraat 5333,2023-06-15,07:00:00,434,362,72,FMN 03 Kolonel Silvertopstraat
651,Kolonel Silvertopstraat 5333,2023-06-15,08:00:00,716,615,101,FMN 03 Kolonel Silvertopstraat
651,Kolonel Silvertopstraat 5333,2023-06-15,09:00:00,289,227,62,FMN 03 Kolonel Silvertopstraat
651,Kolonel Silvertopstraat 5333,2023-06-15,10:00:00,293,209,84,FMN 03 Kolonel Silvertopstraat
651,Kolonel Silvertopstraat 5333,2023-06-15,11:00:00,191,127,64,FMN 03 Kolonel Silvertopstraat
651,Kolonel Silvertopstraat 5333,2023-06-15,12:00:00,276,191,85,FMN 03 Kolonel Silvertopstraat
651,Kolonel Silvertopstraat 5333,2023-06-15,13:00:00,216,146,70,FMN 03 Kolonel Silvertopstraat
651,Kolonel Silvertopstraat 5333,2023-06-15,14:00:00,251,165,86,FMN 03 Kolonel Silvertopstraat
651,Kolonel Silvertopstraat 5333,2023-06-15,15:00:00,316,194,122,FMN 03 Kolonel Silvertopstraat
651,Kolonel Silvertopstraat 5333,2023-06-15,16:00:00,405,268,137,FMN 03 Kolonel Silvertopstraat
651,Kolonel Silvertopstraat 5333,2023-06-15,17:00:00,417,276,141,FMN 03 Kolonel Silvertopstraat
651,Kolonel Silvertopstraat 5333,2023-06-15,18:00:00,331,210,121,FMN 03 Kolonel Silvertopstraat
651,Kolonel Silvertopstraat 5333,2023-06-15,19:00:00,232,155,77,FMN 03 Kolonel Silvertopstraat
651,Kolonel Silvertopstraat 5333,2023-06-15,20:00:00,217,129,88,FMN 03 Kolonel Silvertopstraat
651,Kolonel Silvertopstraat 5333,2023-06-15,21:00:00,169,93,76,FMN 03 Kolonel Silvertopstraat
651,Kolonel Silvertopstraat 5333,2023-06-15,22:00:00,123,67,56,FMN 03 Kolonel Silvertopstraat
651,Kolonel Silvertopstraat 5333,2023-06-15,23:00:00,103,46,57,FMN 03 Kolonel Silvertopstraat
651,Kolonel Silvertopstraat 5333,2023-06-16,00:00:00,60,24,36,FMN 03 Kolonel Silvertopstraat
651,Kolonel Silvertopstraat 5333,2023-06-16,01:00:00,44,15,29,FMN 03 Kolonel Silvertopstraat
651,Kolonel Silvertopstraat 5333,2023-06-16,02:00:00,19,13,6,FMN 03 Kolonel Silvertopstraat
651,Kolonel Silvertopstraat 5333,2023-06-16,03:00:00,11,5,6,FMN 03 Kolonel Silvertopstraat
651,Kolonel Silvertopstraat 5333,2023-06-16,04:00:00,35,27,8,FMN 03 Kolonel Silvertopstraat
651,Kolonel Silvertopstraat 5333,2023-06-16,05:00:00,73,45,28,FMN 03 Kolonel Silvertopstraat
651,Kolonel Silvertopstraat 5333,2023-06-16,06:00:00,125,93,32,FMN 03 Kolonel Silvertopstraat
651,Kolonel Silvertopstraat 5333,2023-06-16,07:00:00,398,319,79,FMN 03 Kolonel Silvertopstraat
651,Kolonel Silvertopstraat 5333,2023-06-16,08:00:00,641,555,86,FMN 03 Kolonel Silvertopstraat
651,Kolonel Silvertopstraat 5333,2023-06-16,09:00:00,304,255,49,FMN 03 Kolonel Silvertopstraat
651,Kolonel Silvertopstraat 5333,2023-06-16,10:00:00,289,217,72,FMN 03 Kolonel Silvertopstraat
651,Kolonel Silvertopstraat 5333,2023-06-16,11:00:00,248,189,59,FMN 03 Kolonel Silvertopstraat
651,Kolonel Silvertopstraat 5333,2023-06-16,12:00:00,270,181,89,FMN 03 Kolonel Silvertopstraat
651,Kolonel Silvertopstraat 5333,2023-06-16,13:00:00,255,196,59,FMN 03 Kolonel Silvertopstraat
651,Kolonel Silvertopstraat 5333,2023-06-16,14:00:00,263,153,110,FMN 03 Kolonel Silvertopstraat
651,Kolonel Silvertopstraat 5333,2023-06-16,15:00:00,274,173,101,FMN 03 Kolonel Silvertopstraat
651,Kolonel Silvertopstraat 5333,2023-06-16,16:00:00,348,222,126,FMN 03 Kolonel Silvertopstraat
651,Kolonel Silvertopstraat 5333,2023-06-16,17:00:00,400,271,129,FMN 03 Kolonel Silvertopstraat
651,Kolonel Silvertopstraat 5333,2023-06-16,18:00:00,330,226,104,FMN 03 Kolonel Silvertopstraat
651,Kolonel Silvertopstraat 5333,2023-06-16,19:00:00,323,247,76,FMN 03 Kolonel Silvertopstraat
651,Kolonel Silvertopstraat 5333,2023-06-16,20:00:00,246,170,76,FMN 03 Kolonel Silvertopstraat
651,Kolonel Silvertopstraat 5333,2023-06-16,21:00:00,232,157,75,FMN 03 Kolonel Silvertopstraat
651,Kolonel Silvertopstraat 5333,2023-06-16,22:00:00,190,109,81,FMN 03 Kolonel Silvertopstraat
651,Kolonel Silvertopstraat 5333,2023-06-16,23:00:00,170,82,88,FMN 03 Kolonel Silvertopstraat
651,Kolonel Silvertopstraat 5333,2023-06-17,00:00:00,151,89,62,FMN 03 Kolonel Silvertopstraat
651,Kolonel Silvertopstraat 5333,2023-06-17,01:00:00,85,38,47,FMN 03 Kolonel Silvertopstraat
651,Kolonel Silvertopstraat 5333,2023-06-17,02:00:00,42,13,29,FMN 03 Kolonel Silvertopstraat
651,Kolonel Silvertopstraat 5333,2023-06-17,03:00:00,46,14,32,FMN 03 Kolonel Silvertopstraat
651,Kolonel Silvertopstraat 5333,2023-06-17,04:00:00,27,11,16,FMN 03 Kolonel Silvertopstraat
651,Kolonel Silvertopstraat 5333,2023-06-17,05:00:00,46,30,16,FMN 03 Kolonel Silvertopstraat
651,Kolonel Silvertopstraat 5333,2023-06-17,06:00:00,47,29,18,FMN 03 Kolonel Silvertopstraat
651,Kolonel Silvertopstraat 5333,2023-06-17,07:00:00,44,28,16,FMN 03 Kolonel Silvertopstraat
651,Kolonel Silvertopstraat 5333,2023-06-17,08:00:00,81,60,21,FMN 03 Kolonel Silvertopstraat
651,Kolonel Silvertopstraat 5333,2023-06-17,09:00:00,167,131,36,FMN 03 Kolonel Silvertopstraat
651,Kolonel Silvertopstraat 5333,2023-06-17,10:00:00,213,172,41,FMN 03 Kolonel Silvertopstraat
651,Kolonel Silvertopstraat 5333,2023-06-17,11:00:00,241,170,71,FMN 03 Kolonel Silvertopstraat
651,Kolonel Silvertopstraat 5333,2023-06-17,12:00:00,232,165,67,FMN 03 Kolonel Silvertopstraat
651,Kolonel Silvertopstraat 5333,2023-06-17,13:00:00,240,168,72,FMN 03 Kolonel Silvertopstraat
651,Kolonel Silvertopstraat 5333,2023-06-17,14:00:00,245,174,71,FMN 03 Kolonel Silvertopstraat
651,Kolonel Silvertopstraat 5333,2023-06-17,15:00:00,232,157,75,FMN 03 Kolonel Silvertopstraat
651,Kolonel Silvertopstraat 5333,2023-06-17,16:00:00,256,174,82,FMN 03 Kolonel Silvertopstraat
651,Kolonel Silvertopstraat 5333,2023-06-17,17:00:00,245,158,87,FMN 03 Kolonel Silvertopstraat
651,Kolonel Silvertopstraat 5333,2023-06-17,18:00:00,238,162,76,FMN 03 Kolonel Silvertopstraat
651,Kolonel Silvertopstraat 5333,2023-06-17,19:00:00,208,136,72,FMN 03 Kolonel Silvertopstraat
651,Kolonel Silvertopstraat 5333,2023-06-17,20:00:00,172,105,67,FMN 03 Kolonel Silvertopstraat
651,Kolonel Silvertopstraat 5333,2023-06-17,21:00:00,171,106,65,FMN 03 Kolonel Silvertopstraat
651,Kolonel Silvertopstraat 5333,2023-06-17,22:00:00,145,96,49,FMN 03 Kolonel Silvertopstraat
651,Kolonel Silvertopstraat 5333,2023-06-17,23:00:00,160,88,72,FMN 03 Kolonel Silvertopstraat
651,Kolonel Silvertopstraat 5333,2023-06-18,00:00:00,94,52,42,FMN 03 Kolonel Silvertopstraat
651,Kolonel Silvertopstraat 5333,2023-06-18,01:00:00,63,26,37,FMN 03 Kolonel Silvertopstraat
651,Kolonel Silvertopstraat 5333,2023-06-18,02:00:00,52,30,22,FMN 03 Kolonel Silvertopstraat
651,Kolonel Silvertopstraat 5333,2023-06-18,03:00:00,50,26,24,FMN 03 Kolonel Silvertopstraat
651,Kolonel Silvertopstraat 5333,2023-06-18,04:00:00,39,22,17,FMN 03 Kolonel Silvertopstraat
651,Kolonel Silvertopstraat 5333,2023-06-18,05:00:00,54,44,10,FMN 03 Kolonel Silvertopstraat
651,Kolonel Silvertopstraat 5333,2023-06-18,06:00:00,34,27,7,FMN 03 Kolonel Silvertopstraat
651,Kolonel Silvertopstraat 5333,2023-06-18,07:00:00,35,21,14,FMN 03 Kolonel Silvertopstraat
651,Kolonel Silvertopstraat 5333,2023-06-18,08:00:00,51,38,13,FMN 03 Kolonel Silvertopstraat
651,Kolonel Silvertopstraat 5333,2023-06-18,09:00:00,126,104,22,FMN 03 Kolonel Silvertopstraat
651,Kolonel Silvertopstraat 5333,2023-06-18,10:00:00,116,89,27,FMN 03 Kolonel Silvertopstraat
651,Kolonel Silvertopstraat 5333,2023-06-18,11:00:00,103,79,24,FMN 03 Kolonel Silvertopstraat
651,Kolonel Silvertopstraat 5333,2023-06-18,12:00:00,123,95,28,FMN 03 Kolonel Silvertopstraat
651,Kolonel Silvertopstraat 5333,2023-06-18,13:00:00,157,101,56,FMN 03 Kolonel Silvertopstraat
651,Kolonel Silvertopstraat 5333,2023-06-18,14:00:00,201,146,55,FMN 03 Kolonel Silvertopstraat
651,Kolonel Silvertopstraat 5333,2023-06-18,15:00:00,198,131,67,FMN 03 Kolonel Silvertopstraat
651,Kolonel Silvertopstraat 5333,2023-06-18,16:00:00,163,123,40,FMN 03 Kolonel Silvertopstraat
651,Kolonel Silvertopstraat 5333,2023-06-18,17:00:00,177,115,62,FMN 03 Kolonel Silvertopstraat
651,Kolonel Silvertopstraat 5333,2023-06-18,18:00:00,183,112,71,FMN 03 Kolonel Silvertopstraat
651,Kolonel Silvertopstraat 5333,2023-06-18,19:00:00,153,98,55,FMN 03 Kolonel Silvertopstraat
651,Kolonel Silvertopstraat 5333,2023-06-18,20:00:00,147,91,56,FMN 03 Kolonel Silvertopstraat
651,Kolonel Silvertopstraat 5333,2023-06-18,21:00:00,111,66,45,FMN 03 Kolonel Silvertopstraat
651,Kolonel Silvertopstraat 5333,2023-06-18,22:00:00,89,45,44,FMN 03 Kolonel Silvertopstraat
651,Kolonel Silvertopstraat 5333,2023-06-18,23:00:00,74,36,38,FMN 03 Kolonel Silvertopstraat
651,Kolonel Silvertopstraat 5333,2023-06-19,00:00:00,28,12,16,FMN 03 Kolonel Silvertopstraat
651,Kolonel Silvertopstraat 5333,2023-06-19,01:00:00,23,8,15,FMN 03 Kolonel Silvertopstraat
651,Kolonel Silvertopstraat 5333,2023-06-19,02:00:00,6,1,5,FMN 03 Kolonel Silvertopstraat
651,Kolonel Silvertopstraat 5333,2023-06-19,03:00:00,9,9,0,FMN 03 Kolonel Silvertopstraat
651,Kolonel Silvertopstraat 5333,2023-06-19,04:00:00,26,15,11,FMN 03 Kolonel Silvertopstraat
651,Kolonel Silvertopstraat 5333,2023-06-19,05:00:00,52,38,14,FMN 03 Kolonel Silvertopstraat
651,Kolonel Silvertopstraat 5333,2023-06-19,06:00:00,143,104,39,FMN 03 Kolonel Silvertopstraat
651,Kolonel Silvertopstraat 5333,2023-06-19,07:00:00,411,345,66,FMN 03 Kolonel Silvertopstraat
651,Kolonel Silvertopstraat 5333,2023-06-19,08:00:00,723,630,93,FMN 03 Kolonel Silvertopstraat
651,Kolonel Silvertopstraat 5333,2023-06-19,09:00:00,245,205,40,FMN 03 Kolonel Silvertopstraat
651,Kolonel Silvertopstraat 5333,2023-06-19,10:00:00,184,137,47,FMN 03 Kolonel Silvertopstraat
651,Kolonel Silvertopstraat 5333,2023-06-19,11:00:00,201,127,74,FMN 03 Kolonel Silvertopstraat
651,Kolonel Silvertopstraat 5333,2023-06-19,12:00:00,292,180,112,FMN 03 Kolonel Silvertopstraat
651,Kolonel Silvertopstraat 5333,2023-06-19,13:00:00,243,170,73,FMN 03 Kolonel Silvertopstraat
651,Kolonel Silvertopstraat 5333,2023-06-19,14:00:00,238,158,80,FMN 03 Kolonel Silvertopstraat
651,Kolonel Silvertopstraat 5333,2023-06-19,15:00:00,326,218,108,FMN 03 Kolonel Silvertopstraat
651,Kolonel Silvertopstraat 5333,2023-06-19,16:00:00,409,288,121,FMN 03 Kolonel Silvertopstraat
651,Kolonel Silvertopstraat 5333,2023-06-19,17:00:00,397,267,130,FMN 03 Kolonel Silvertopstraat
651,Kolonel Silvertopstraat 5333,2023-06-19,18:00:00,325,197,128,FMN 03 Kolonel Silvertopstraat
651,Kolonel Silvertopstraat 5333,2023-06-19,19:00:00,224,155,69,FMN 03 Kolonel Silvertopstraat
651,Kolonel Silvertopstraat 5333,2023-06-19,20:00:00,219,143,76,FMN 03 Kolonel Silvertopstraat
651,Kolonel Silvertopstraat 5333,2023-06-19,21:00:00,145,80,65,FMN 03 Kolonel Silvertopstraat
651,Kolonel Silvertopstraat 5333,2023-06-19,22:00:00,146,78,68,FMN 03 Kolonel Silvertopstraat
651,Kolonel Silvertopstraat 5333,2023-06-19,23:00:00,72,34,38,FMN 03 Kolonel Silvertopstraat
651,Kolonel Silvertopstraat 5333,2023-06-20,00:00:00,50,21,29,FMN 03 Kolonel Silvertopstraat
651,Kolonel Silvertopstraat 5333,2023-06-20,01:00:00,39,15,24,FMN 03 Kolonel Silvertopstraat
651,Kolonel Silvertopstraat 5333,2023-06-20,02:00:00,19,11,8,FMN 03 Kolonel Silvertopstraat
651,Kolonel Silvertopstraat 5333,2023-06-20,03:00:00,12,3,9,FMN 03 Kolonel Silvertopstraat
651,Kolonel Silvertopstraat 5333,2023-06-20,04:00:00,26,19,7,FMN 03 Kolonel Silvertopstraat
651,Kolonel Silvertopstraat 5333,2023-06-20,05:00:00,63,49,14,FMN 03 Kolonel Silvertopstraat
651,Kolonel Silvertopstraat 5333,2023-06-20,06:00:00,154,118,36,FMN 03 Kolonel Silvertopstraat
651,Kolonel Silvertopstraat 5333,2023-06-20,07:00:00,408,337,71,FMN 03 Kolonel Silvertopstraat
651,Kolonel Silvertopstraat 5333,2023-06-20,08:00:00,760,647,113,FMN 03 Kolonel Silvertopstraat
651,Kolonel Silvertopstraat 5333,2023-06-20,09:00:00,305,242,63,FMN 03 Kolonel Silvertopstraat
651,Kolonel Silvertopstraat 5333,2023-06-20,10:00:00,293,214,79,FMN 03 Kolonel Silvertopstraat
651,Kolonel Silvertopstraat 5333,2023-06-20,11:00:00,251,170,81,FMN 03 Kolonel Silvertopstraat
651,Kolonel Silvertopstraat 5333,2023-06-20,12:00:00,324,204,120,FMN 03 Kolonel Silvertopstraat
651,Kolonel Silvertopstraat 5333,2023-06-20,13:00:00,264,182,82,FMN 03 Kolonel Silvertopstraat
651,Kolonel Silvertopstraat 5333,2023-06-20,14:00:00,213,135,78,FMN 03 Kolonel Silvertopstraat
651,Kolonel Silvertopstraat 5333,2023-06-20,15:00:00,335,221,114,FMN 03 Kolonel Silvertopstraat
651,Kolonel Silvertopstraat 5333,2023-06-20,16:00:00,412,269,143,FMN 03 Kolonel Silvertopstraat
651,Kolonel Silvertopstraat 5333,2023-06-20,17:00:00,390,253,137,FMN 03 Kolonel Silvertopstraat
651,Kolonel Silvertopstraat 5333,2023-06-20,18:00:00,226,151,75,FMN 03 Kolonel Silvertopstraat
651,Kolonel Silvertopstraat 5333,2023-06-20,19:00:00,133,76,57,FMN 03 Kolonel Silvertopstraat
651,Kolonel Silvertopstraat 5333,2023-06-20,20:00:00,115,59,56,FMN 03 Kolonel Silvertopstraat
651,Kolonel Silvertopstraat 5333,2023-06-20,21:00:00,66,27,39,FMN 03 Kolonel Silvertopstraat
651,Kolonel Silvertopstraat 5333,2023-06-20,22:00:00,104,61,43,FMN 03 Kolonel Silvertopstraat
651,Kolonel Silvertopstraat 5333,2023-06-20,23:00:00,64,21,43,FMN 03 Kolonel Silvertopstraat
651,Kolonel Silvertopstraat 5333,2023-06-21,00:00:00,42,19,23,FMN 03 Kolonel Silvertopstraat
651,Kolonel Silvertopstraat 5333,2023-06-21,01:00:00,18,6,12,FMN 03 Kolonel Silvertopstraat
651,Kolonel Silvertopstraat 5333,2023-06-21,02:00:00,10,7,3,FMN 03 Kolonel Silvertopstraat
651,Kolonel Silvertopstraat 5333,2023-06-21,03:00:00,16,9,7,FMN 03 Kolonel Silvertopstraat
651,Kolonel Silvertopstraat 5333,2023-06-21,04:00:00,22,16,6,FMN 03 Kolonel Silvertopstraat
651,Kolonel Silvertopstraat 5333,2023-06-21,05:00:00,54,38,16,FMN 03 Kolonel Silvertopstraat
651,Kolonel Silvertopstraat 5333,2023-06-21,06:00:00,143,113,30,FMN 03 Kolonel Silvertopstraat
651,Kolonel Silvertopstraat 5333,2023-06-21,07:00:00,384,302,82,FMN 03 Kolonel Silvertopstraat
651,Kolonel Silvertopstraat 5333,2023-06-21,08:00:00,608,517,91,FMN 03 Kolonel Silvertopstraat
651,Kolonel Silvertopstraat 5333,2023-06-21,09:00:00,260,206,54,FMN 03 Kolonel Silvertopstraat
651,Kolonel Silvertopstraat 5333,2023-06-21,10:00:00,221,160,61,FMN 03 Kolonel Silvertopstraat
651,Kolonel Silvertopstraat 5333,2023-06-21,11:00:00,252,174,78,FMN 03 Kolonel Silvertopstraat
651,Kolonel Silvertopstraat 5333,2023-06-21,12:00:00,315,196,119,FMN 03 Kolonel Silvertopstraat
651,Kolonel Silvertopstraat 5333,2023-06-21,13:00:00,272,177,95,FMN 03 Kolonel Silvertopstraat
651,Kolonel Silvertopstraat 5333,2023-06-21,14:00:00,239,168,71,FMN 03 Kolonel Silvertopstraat
651,Kolonel Silvertopstraat 5333,2023-06-21,15:00:00,184,121,63,FMN 03 Kolonel Silvertopstraat
651,Kolonel Silvertopstraat 5333,2023-06-21,16:00:00,306,218,88,FMN 03 Kolonel Silvertopstraat
651,Kolonel Silvertopstraat 5333,2023-06-21,17:00:00,416,276,140,FMN 03 Kolonel Silvertopstraat
651,Kolonel Silvertopstraat 5333,2023-06-21,18:00:00,343,231,112,FMN 03 Kolonel Silvertopstraat
651,Kolonel Silvertopstraat 5333,2023-06-21,19:00:00,269,166,103,FMN 03 Kolonel Silvertopstraat
651,Kolonel Silvertopstraat 5333,2023-06-21,20:00:00,200,123,77,FMN 03 Kolonel Silvertopstraat
651,Kolonel Silvertopstraat 5333,2023-06-21,21:00:00,185,98,87,FMN 03 Kolonel Silvertopstraat
651,Kolonel Silvertopstraat 5333,2023-06-21,22:00:00,166,89,77,FMN 03 Kolonel Silvertopstraat
651,Kolonel Silvertopstraat 5333,2023-06-21,23:00:00,97,49,48,FMN 03 Kolonel Silvertopstraat
651,Kolonel Silvertopstraat 5333,2023-06-22,00:00:00,53,20,33,FMN 03 Kolonel Silvertopstraat
651,Kolonel Silvertopstraat 5333,2023-06-22,01:00:00,27,8,19,FMN 03 Kolonel Silvertopstraat
651,Kolonel Silvertopstraat 5333,2023-06-22,02:00:00,24,12,12,FMN 03 Kolonel Silvertopstraat
651,Kolonel Silvertopstraat 5333,2023-06-22,03:00:00,16,9,7,FMN 03 Kolonel Silvertopstraat
651,Kolonel Silvertopstraat 5333,2023-06-22,04:00:00,26,17,9,FMN 03 Kolonel Silvertopstraat
651,Kolonel Silvertopstraat 5333,2023-06-22,05:00:00,58,42,16,FMN 03 Kolonel Silvertopstraat
651,Kolonel Silvertopstraat 5333,2023-06-22,06:00:00,133,102,31,FMN 03 Kolonel Silvertopstraat
651,Kolonel Silvertopstraat 5333,2023-06-22,07:00:00,375,307,68,FMN 03 Kolonel Silvertopstraat
651,Kolonel Silvertopstraat 5333,2023-06-22,08:00:00,653,562,91,FMN 03 Kolonel Silvertopstraat
651,Kolonel Silvertopstraat 5333,2023-06-22,09:00:00,267,212,55,FMN 03 Kolonel Silvertopstraat
651,Kolonel Silvertopstraat 5333,2023-06-22,10:00:00,274,202,72,FMN 03 Kolonel Silvertopstraat
651,Kolonel Silvertopstraat 5333,2023-06-22,11:00:00,204,136,68,FMN 03 Kolonel Silvertopstraat
651,Kolonel Silvertopstraat 5333,2023-06-22,12:00:00,202,129,73,FMN 03 Kolonel Silvertopstraat
651,Kolonel Silvertopstraat 5333,2023-06-22,13:00:00,112,60,52,FMN 03 Kolonel Silvertopstraat
651,Kolonel Silvertopstraat 5333,2023-06-22,14:00:00,146,99,47,FMN 03 Kolonel Silvertopstraat
651,Kolonel Silvertopstraat 5333,2023-06-22,15:00:00,184,108,76,FMN 03 Kolonel Silvertopstraat
651,Kolonel Silvertopstraat 5333,2023-06-22,16:00:00,204,133,71,FMN 03 Kolonel Silvertopstraat
651,Kolonel Silvertopstraat 5333,2023-06-22,17:00:00,266,169,97,FMN 03 Kolonel Silvertopstraat
651,Kolonel Silvertopstraat 5333,2023-06-22,18:00:00,226,155,71,FMN 03 Kolonel Silvertopstraat
651,Kolonel Silvertopstraat 5333,2023-06-22,19:00:00,154,109,45,FMN 03 Kolonel Silvertopstraat
651,Kolonel Silvertopstraat 5333,2023-06-22,20:00:00,146,90,56,FMN 03 Kolonel Silvertopstraat
651,Kolonel Silvertopstraat 5333,2023-06-22,21:00:00,118,76,42,FMN 03 Kolonel Silvertopstraat
651,Kolonel Silvertopstraat 5333,2023-06-22,22:00:00,126,61,65,FMN 03 Kolonel Silvertopstraat
651,Kolonel Silvertopstraat 5333,2023-06-22,23:00:00,82,42,40,FMN 03 Kolonel Silvertopstraat
651,Kolonel Silvertopstraat 5333,2023-06-23,00:00:00,59,21,38,FMN 03 Kolonel Silvertopstraat
651,Kolonel Silvertopstraat 5333,2023-06-23,01:00:00,42,23,19,FMN 03 Kolonel Silvertopstraat
651,Kolonel Silvertopstraat 5333,2023-06-23,02:00:00,17,8,9,FMN 03 Kolonel Silvertopstraat
651,Kolonel Silvertopstraat 5333,2023-06-23,03:00:00,20,11,9,FMN 03 Kolonel Silvertopstraat
651,Kolonel Silvertopstraat 5333,2023-06-23,04:00:00,31,16,15,FMN 03 Kolonel Silvertopstraat
651,Kolonel Silvertopstraat 5333,2023-06-23,05:00:00,70,48,22,FMN 03 Kolonel Silvertopstraat
651,Kolonel Silvertopstraat 5333,2023-06-23,06:00:00,120,84,36,FMN 03 Kolonel Silvertopstraat
651,Kolonel Silvertopstraat 5333,2023-06-23,07:00:00,293,240,53,FMN 03 Kolonel Silvertopstraat
651,Kolonel Silvertopstraat 5333,2023-06-23,08:00:00,577,508,69,FMN 03 Kolonel Silvertopstraat
651,Kolonel Silvertopstraat 5333,2023-06-23,09:00:00,289,224,65,FMN 03 Kolonel Silvertopstraat
651,Kolonel Silvertopstraat 5333,2023-06-23,10:00:00,229,184,45,FMN 03 Kolonel Silvertopstraat
651,Kolonel Silvertopstraat 5333,2023-06-23,11:00:00,239,167,72,FMN 03 Kolonel Silvertopstraat
651,Kolonel Silvertopstraat 5333,2023-06-23,12:00:00,272,196,76,FMN 03 Kolonel Silvertopstraat
651,Kolonel Silvertopstraat 5333,2023-06-23,13:00:00,307,220,87,FMN 03 Kolonel Silvertopstraat
651,Kolonel Silvertopstraat 5333,2023-06-23,14:00:00,348,250,98,FMN 03 Kolonel Silvertopstraat
651,Kolonel Silvertopstraat 5333,2023-06-23,15:00:00,384,252,132,FMN 03 Kolonel Silvertopstraat
651,Kolonel Silvertopstraat 5333,2023-06-23,16:00:00,315,229,86,FMN 03 Kolonel Silvertopstraat
651,Kolonel Silvertopstraat 5333,2023-06-23,17:00:00,447,315,132,FMN 03 Kolonel Silvertopstraat
651,Kolonel Silvertopstraat 5333,2023-06-23,18:00:00,337,219,118,FMN 03 Kolonel Silvertopstraat
651,Kolonel Silvertopstraat 5333,2023-06-23,19:00:00,293,203,90,FMN 03 Kolonel Silvertopstraat
651,Kolonel Silvertopstraat 5333,2023-06-23,20:00:00,222,149,73,FMN 03 Kolonel Silvertopstraat
651,Kolonel Silvertopstraat 5333,2023-06-23,21:00:00,187,128,59,FMN 03 Kolonel Silvertopstraat
651,Kolonel Silvertopstraat 5333,2023-06-23,22:00:00,189,122,67,FMN 03 Kolonel Silvertopstraat
651,Kolonel Silvertopstraat 5333,2023-06-23,23:00:00,125,54,71,FMN 03 Kolonel Silvertopstraat
651,Kolonel Silvertopstraat 5333,2023-06-24,00:00:00,139,70,69,FMN 03 Kolonel Silvertopstraat
651,Kolonel Silvertopstraat 5333,2023-06-24,01:00:00,60,19,41,FMN 03 Kolonel Silvertopstraat
651,Kolonel Silvertopstraat 5333,2023-06-24,02:00:00,46,25,21,FMN 03 Kolonel Silvertopstraat
651,Kolonel Silvertopstraat 5333,2023-06-24,03:00:00,46,14,32,FMN 03 Kolonel Silvertopstraat
651,Kolonel Silvertopstraat 5333,2023-06-24,04:00:00,30,6,24,FMN 03 Kolonel Silvertopstraat
651,Kolonel Silvertopstraat 5333,2023-06-24,05:00:00,45,27,18,FMN 03 Kolonel Silvertopstraat
651,Kolonel Silvertopstraat 5333,2023-06-24,06:00:00,53,39,14,FMN 03 Kolonel Silvertopstraat
651,Kolonel Silvertopstraat 5333,2023-06-24,07:00:00,41,28,13,FMN 03 Kolonel Silvertopstraat
651,Kolonel Silvertopstraat 5333,2023-06-24,08:00:00,104,83,21,FMN 03 Kolonel Silvertopstraat
651,Kolonel Silvertopstraat 5333,2023-06-24,09:00:00,201,163,38,FMN 03 Kolonel Silvertopstraat
651,Kolonel Silvertopstraat 5333,2023-06-24,10:00:00,211,163,48,FMN 03 Kolonel Silvertopstraat
651,Kolonel Silvertopstraat 5333,2023-06-24,11:00:00,259,205,54,FMN 03 Kolonel Silvertopstraat
651,Kolonel Silvertopstraat 5333,2023-06-24,12:00:00,268,196,72,FMN 03 Kolonel Silvertopstraat
651,Kolonel Silvertopstraat 5333,2023-06-24,13:00:00,253,196,57,FMN 03 Kolonel Silvertopstraat
651,Kolonel Silvertopstraat 5333,2023-06-24,14:00:00,190,133,57,FMN 03 Kolonel Silvertopstraat
651,Kolonel Silvertopstraat 5333,2023-06-24,15:00:00,1,1,0,FMN 03 Kolonel Silvertopstraat
651,Kolonel Silvertopstraat 5333,2023-06-24,16:00:00,27,16,11,FMN 03 Kolonel Silvertopstraat
651,Kolonel Silvertopstraat 5333,2023-06-24,17:00:00,245,167,78,FMN 03 Kolonel Silvertopstraat
651,Kolonel Silvertopstraat 5333,2023-06-24,18:00:00,224,152,72,FMN 03 Kolonel Silvertopstraat
651,Kolonel Silvertopstraat 5333,2023-06-24,19:00:00,218,151,67,FMN 03 Kolonel Silvertopstraat
651,Kolonel Silvertopstraat 5333,2023-06-24,20:00:00,217,153,64,FMN 03 Kolonel Silvertopstraat
651,Kolonel Silvertopstraat 5333,2023-06-24,21:00:00,144,96,48,FMN 03 Kolonel Silvertopstraat
651,Kolonel Silvertopstraat 5333,2023-06-24,22:00:00,146,85,61,FMN 03 Kolonel Silvertopstraat
651,Kolonel Silvertopstraat 5333,2023-06-24,23:00:00,143,74,69,FMN 03 Kolonel Silvertopstraat
651,Kolonel Silvertopstraat 5333,2023-06-25,00:00:00,116,57,59,FMN 03 Kolonel Silvertopstraat
651,Kolonel Silvertopstraat 5333,2023-06-25,01:00:00,72,30,42,FMN 03 Kolonel Silvertopstraat
651,Kolonel Silvertopstraat 5333,2023-06-25,02:00:00,53,17,36,FMN 03 Kolonel Silvertopstraat
651,Kolonel Silvertopstraat 5333,2023-06-25,03:00:00,43,19,24,FMN 03 Kolonel Silvertopstraat
651,Kolonel Silvertopstraat 5333,2023-06-25,04:00:00,28,8,20,FMN 03 Kolonel Silvertopstraat
651,Kolonel Silvertopstraat 5333,2023-06-25,05:00:00,31,18,13,FMN 03 Kolonel Silvertopstraat
651,Kolonel Silvertopstraat 5333,2023-06-25,06:00:00,39,26,13,FMN 03 Kolonel Silvertopstraat
651,Kolonel Silvertopstraat 5333,2023-06-25,07:00:00,34,24,10,FMN 03 Kolonel Silvertopstraat
651,Kolonel Silvertopstraat 5333,2023-06-25,08:00:00,88,68,20,FMN 03 Kolonel Silvertopstraat
651,Kolonel Silvertopstraat 5333,2023-06-25,09:00:00,148,109,39,FMN 03 Kolonel Silvertopstraat
651,Kolonel Silvertopstraat 5333,2023-06-25,10:00:00,179,149,30,FMN 03 Kolonel Silvertopstraat
651,Kolonel Silvertopstraat 5333,2023-06-25,11:00:00,190,140,50,FMN 03 Kolonel Silvertopstraat
651,Kolonel Silvertopstraat 5333,2023-06-25,12:00:00,202,154,48,FMN 03 Kolonel Silvertopstraat
651,Kolonel Silvertopstraat 5333,2023-06-25,13:00:00,219,177,42,FMN 03 Kolonel Silvertopstraat
651,Kolonel Silvertopstraat 5333,2023-06-25,14:00:00,226,170,56,FMN 03 Kolonel Silvertopstraat
651,Kolonel Silvertopstraat 5333,2023-06-25,15:00:00,201,137,64,FMN 03 Kolonel Silvertopstraat
651,Kolonel Silvertopstraat 5333,2023-06-25,16:00:00,148,101,47,FMN 03 Kolonel Silvertopstraat
651,Kolonel Silvertopstraat 5333,2023-06-25,17:00:00,235,158,77,FMN 03 Kolonel Silvertopstraat
651,Kolonel Silvertopstraat 5333,2023-06-25,18:00:00,184,121,63,FMN 03 Kolonel Silvertopstraat
651,Kolonel Silvertopstraat 5333,2023-06-25,19:00:00,215,149,66,FMN 03 Kolonel Silvertopstraat
651,Kolonel Silvertopstraat 5333,2023-06-25,20:00:00,158,103,55,FMN 03 Kolonel Silvertopstraat
651,Kolonel Silvertopstraat 5333,2023-06-25,21:00:00,146,82,64,FMN 03 Kolonel Silvertopstraat
651,Kolonel Silvertopstraat 5333,2023-06-25,22:00:00,130,67,63,FMN 03 Kolonel Silvertopstraat
651,Kolonel Silvertopstraat 5333,2023-06-25,23:00:00,115,68,47,FMN 03 Kolonel Silvertopstraat
651,Kolonel Silvertopstraat 5333,2023-06-26,00:00:00,74,24,50,FMN 03 Kolonel Silvertopstraat
651,Kolonel Silvertopstraat 5333,2023-06-26,01:00:00,43,18,25,FMN 03 Kolonel Silvertopstraat
651,Kolonel Silvertopstraat 5333,2023-06-26,02:00:00,21,7,14,FMN 03 Kolonel Silvertopstraat
651,Kolonel Silvertopstraat 5333,2023-06-26,03:00:00,21,13,8,FMN 03 Kolonel Silvertopstraat
651,Kolonel Silvertopstraat 5333,2023-06-26,04:00:00,37,26,11,FMN 03 Kolonel Silvertopstraat
651,Kolonel Silvertopstraat 5333,2023-06-26,05:00:00,64,46,18,FMN 03 Kolonel Silvertopstraat
651,Kolonel Silvertopstraat 5333,2023-06-26,06:00:00,144,105,39,FMN 03 Kolonel Silvertopstraat
651,Kolonel Silvertopstraat 5333,2023-06-26,07:00:00,303,245,58,FMN 03 Kolonel Silvertopstraat
651,Kolonel Silvertopstraat 5333,2023-06-26,08:00:00,544,463,81,FMN 03 Kolonel Silvertopstraat
651,Kolonel Silvertopstraat 5333,2023-06-26,09:00:00,257,208,49,FMN 03 Kolonel Silvertopstraat
651,Kolonel Silvertopstraat 5333,2023-06-26,10:00:00,196,147,49,FMN 03 Kolonel Silvertopstraat
651,Kolonel Silvertopstraat 5333,2023-06-26,11:00:00,197,138,59,FMN 03 Kolonel Silvertopstraat
651,Kolonel Silvertopstraat 5333,2023-06-26,12:00:00,231,171,60,FMN 03 Kolonel Silvertopstraat
651,Kolonel Silvertopstraat 5333,2023-06-26,13:00:00,241,173,68,FMN 03 Kolonel Silvertopstraat
651,Kolonel Silvertopstraat 5333,2023-06-26,14:00:00,220,150,70,FMN 03 Kolonel Silvertopstraat
651,Kolonel Silvertopstraat 5333,2023-06-26,15:00:00,302,206,96,FMN 03 Kolonel Silvertopstraat
651,Kolonel Silvertopstraat 5333,2023-06-26,16:00:00,379,262,117,FMN 03 Kolonel Silvertopstraat
651,Kolonel Silvertopstraat 5333,2023-06-26,17:00:00,425,290,135,FMN 03 Kolonel Silvertopstraat
651,Kolonel Silvertopstraat 5333,2023-06-26,18:00:00,352,225,127,FMN 03 Kolonel Silvertopstraat
651,Kolonel Silvertopstraat 5333,2023-06-26,19:00:00,245,181,64,FMN 03 Kolonel Silvertopstraat
651,Kolonel Silvertopstraat 5333,2023-06-26,20:00:00,193,118,75,FMN 03 Kolonel Silvertopstraat
651,Kolonel Silvertopstraat 5333,2023-06-26,21:00:00,167,95,72,FMN 03 Kolonel Silvertopstraat
651,Kolonel Silvertopstraat 5333,2023-06-26,22:00:00,139,90,49,FMN 03 Kolonel Silvertopstraat
651,Kolonel Silvertopstraat 5333,2023-06-26,23:00:00,88,40,48,FMN 03 Kolonel Silvertopstraat
651,Kolonel Silvertopstraat 5333,2023-06-27,00:00:00,62,35,27,FMN 03 Kolonel Silvertopstraat
651,Kolonel Silvertopstraat 5333,2023-06-27,01:00:00,35,11,24,FMN 03 Kolonel Silvertopstraat
651,Kolonel Silvertopstraat 5333,2023-06-27,02:00:00,14,3,11,FMN 03 Kolonel Silvertopstraat
651,Kolonel Silvertopstraat 5333,2023-06-27,03:00:00,14,6,8,FMN 03 Kolonel Silvertopstraat
651,Kolonel Silvertopstraat 5333,2023-06-27,04:00:00,33,29,4,FMN 03 Kolonel Silvertopstraat
651,Kolonel Silvertopstraat 5333,2023-06-27,05:00:00,66,44,22,FMN 03 Kolonel Silvertopstraat
651,Kolonel Silvertopstraat 5333,2023-06-27,06:00:00,150,111,39,FMN 03 Kolonel Silvertopstraat
651,Kolonel Silvertopstraat 5333,2023-06-27,07:00:00,332,268,64,FMN 03 Kolonel Silvertopstraat
651,Kolonel Silvertopstraat 5333,2023-06-27,08:00:00,553,477,76,FMN 03 Kolonel Silvertopstraat
651,Kolonel Silvertopstraat 5333,2023-06-27,09:00:00,267,203,64,FMN 03 Kolonel Silvertopstraat
651,Kolonel Silvertopstraat 5333,2023-06-27,10:00:00,180,138,42,FMN 03 Kolonel Silvertopstraat
651,Kolonel Silvertopstraat 5333,2023-06-27,11:00:00,189,144,45,FMN 03 Kolonel Silvertopstraat
651,Kolonel Silvertopstraat 5333,2023-06-27,12:00:00,223,174,49,FMN 03 Kolonel Silvertopstraat
651,Kolonel Silvertopstraat 5333,2023-06-27,13:00:00,251,170,81,FMN 03 Kolonel Silvertopstraat
651,Kolonel Silvertopstraat 5333,2023-06-27,14:00:00,218,153,65,FMN 03 Kolonel Silvertopstraat
651,Kolonel Silvertopstraat 5333,2023-06-27,15:00:00,330,226,104,FMN 03 Kolonel Silvertopstraat
651,Kolonel Silvertopstraat 5333,2023-06-27,16:00:00,354,231,123,FMN 03 Kolonel Silvertopstraat
651,Kolonel Silvertopstraat 5333,2023-06-27,17:00:00,427,293,134,FMN 03 Kolonel Silvertopstraat
651,Kolonel Silvertopstraat 5333,2023-06-27,18:00:00,347,226,121,FMN 03 Kolonel Silvertopstraat
651,Kolonel Silvertopstraat 5333,2023-06-27,19:00:00,247,157,90,FMN 03 Kolonel Silvertopstraat
651,Kolonel Silvertopstraat 5333,2023-06-27,20:00:00,197,117,80,FMN 03 Kolonel Silvertopstraat
651,Kolonel Silvertopstraat 5333,2023-06-27,21:00:00,169,97,72,FMN 03 Kolonel Silvertopstraat
651,Kolonel Silvertopstraat 5333,2023-06-27,22:00:00,156,84,72,FMN 03 Kolonel Silvertopstraat
651,Kolonel Silvertopstraat 5333,2023-06-27,23:00:00,112,57,55,FMN 03 Kolonel Silvertopstraat
651,Kolonel Silvertopstraat 5333,2023-06-28,00:00:00,58,23,35,FMN 03 Kolonel Silvertopstraat
651,Kolonel Silvertopstraat 5333,2023-06-28,01:00:00,39,21,18,FMN 03 Kolonel Silvertopstraat
651,Kolonel Silvertopstraat 5333,2023-06-28,02:00:00,20,11,9,FMN 03 Kolonel Silvertopstraat
651,Kolonel Silvertopstraat 5333,2023-06-28,03:00:00,19,6,13,FMN 03 Kolonel Silvertopstraat
651,Kolonel Silvertopstraat 5333,2023-06-28,04:00:00,28,21,7,FMN 03 Kolonel Silvertopstraat
651,Kolonel Silvertopstraat 5333,2023-06-28,05:00:00,60,41,19,FMN 03 Kolonel Silvertopstraat
651,Kolonel Silvertopstraat 5333,2023-06-28,06:00:00,124,90,34,FMN 03 Kolonel Silvertopstraat
651,Kolonel Silvertopstraat 5333,2023-06-28,07:00:00,274,224,50,FMN 03 Kolonel Silvertopstraat
651,Kolonel Silvertopstraat 5333,2023-06-28,08:00:00,416,346,70,FMN 03 Kolonel Silvertopstraat
651,Kolonel Silvertopstraat 5333,2023-06-28,09:00:00,212,163,49,FMN 03 Kolonel Silvertopstraat
651,Kolonel Silvertopstraat 5333,2023-06-28,10:00:00,183,137,46,FMN 03 Kolonel Silvertopstraat
651,Kolonel Silvertopstraat 5333,2023-06-28,11:00:00,181,150,31,FMN 03 Kolonel Silvertopstraat
651,Kolonel Silvertopstraat 5333,2023-06-28,12:00:00,265,196,69,FMN 03 Kolonel Silvertopstraat
651,Kolonel Silvertopstraat 5333,2023-06-28,13:00:00,210,141,69,FMN 03 Kolonel Silvertopstraat
651,Kolonel Silvertopstraat 5333,2023-06-28,14:00:00,254,176,78,FMN 03 Kolonel Silvertopstraat
651,Kolonel Silvertopstraat 5333,2023-06-28,15:00:00,251,177,74,FMN 03 Kolonel Silvertopstraat
651,Kolonel Silvertopstraat 5333,2023-06-28,16:00:00,353,241,112,FMN 03 Kolonel Silvertopstraat
651,Kolonel Silvertopstraat 5333,2023-06-28,17:00:00,394,262,132,FMN 03 Kolonel Silvertopstraat
651,Kolonel Silvertopstraat 5333,2023-06-28,18:00:00,355,236,119,FMN 03 Kolonel Silvertopstraat
651,Kolonel Silvertopstraat 5333,2023-06-28,19:00:00,229,162,67,FMN 03 Kolonel Silvertopstraat
651,Kolonel Silvertopstraat 5333,2023-06-28,20:00:00,173,104,69,FMN 03 Kolonel Silvertopstraat
651,Kolonel Silvertopstraat 5333,2023-06-28,21:00:00,161,104,57,FMN 03 Kolonel Silvertopstraat
651,Kolonel Silvertopstraat 5333,2023-06-28,22:00:00,162,90,72,FMN 03 Kolonel Silvertopstraat
651,Kolonel Silvertopstraat 5333,2023-06-28,23:00:00,108,71,37,FMN 03 Kolonel Silvertopstraat
651,Kolonel Silvertopstraat 5333,2023-06-29,00:00:00,71,38,33,FMN 03 Kolonel Silvertopstraat
651,Kolonel Silvertopstraat 5333,2023-06-29,01:00:00,43,16,27,FMN 03 Kolonel Silvertopstraat
651,Kolonel Silvertopstraat 5333,2023-06-29,02:00:00,27,11,16,FMN 03 Kolonel Silvertopstraat
651,Kolonel Silvertopstraat 5333,2023-06-29,03:00:00,16,6,10,FMN 03 Kolonel Silvertopstraat
651,Kolonel Silvertopstraat 5333,2023-06-29,04:00:00,40,28,12,FMN 03 Kolonel Silvertopstraat
651,Kolonel Silvertopstraat 5333,2023-06-29,05:00:00,65,43,22,FMN 03 Kolonel Silvertopstraat
651,Kolonel Silvertopstraat 5333,2023-06-29,06:00:00,126,99,27,FMN 03 Kolonel Silvertopstraat
651,Kolonel Silvertopstraat 5333,2023-06-29,07:00:00,286,224,62,FMN 03 Kolonel Silvertopstraat
651,Kolonel Silvertopstraat 5333,2023-06-29,08:00:00,485,412,73,FMN 03 Kolonel Silvertopstraat
651,Kolonel Silvertopstraat 5333,2023-06-29,09:00:00,304,256,48,FMN 03 Kolonel Silvertopstraat
651,Kolonel Silvertopstraat 5333,2023-06-29,10:00:00,232,179,53,FMN 03 Kolonel Silvertopstraat
651,Kolonel Silvertopstraat 5333,2023-06-29,11:00:00,190,138,52,FMN 03 Kolonel Silvertopstraat
651,Kolonel Silvertopstraat 5333,2023-06-29,12:00:00,232,162,70,FMN 03 Kolonel Silvertopstraat
651,Kolonel Silvertopstraat 5333,2023-06-29,13:00:00,234,153,81,FMN 03 Kolonel Silvertopstraat
651,Kolonel Silvertopstraat 5333,2023-06-29,14:00:00,275,180,95,FMN 03 Kolonel Silvertopstraat
651,Kolonel Silvertopstraat 5333,2023-06-29,15:00:00,302,206,96,FMN 03 Kolonel Silvertopstraat
651,Kolonel Silvertopstraat 5333,2023-06-29,16:00:00,338,230,108,FMN 03 Kolonel Silvertopstraat
651,Kolonel Silvertopstraat 5333,2023-06-29,17:00:00,433,312,121,FMN 03 Kolonel Silvertopstraat
651,Kolonel Silvertopstraat 5333,2023-06-29,18:00:00,348,235,113,FMN 03 Kolonel Silvertopstraat
651,Kolonel Silvertopstraat 5333,2023-06-29,19:00:00,250,173,77,FMN 03 Kolonel Silvertopstraat
651,Kolonel Silvertopstraat 5333,2023-06-29,20:00:00,185,113,72,FMN 03 Kolonel Silvertopstraat
651,Kolonel Silvertopstraat 5333,2023-06-29,21:00:00,139,77,62,FMN 03 Kolonel Silvertopstraat
651,Kolonel Silvertopstraat 5333,2023-06-29,22:00:00,142,72,70,FMN 03 Kolonel Silvertopstraat
651,Kolonel Silvertopstraat 5333,2023-06-29,23:00:00,94,38,56,FMN 03 Kolonel Silvertopstraat
651,Kolonel Silvertopstraat 5333,2023-06-30,00:00:00,95,44,51,FMN 03 Kolonel Silvertopstraat
651,Kolonel Silvertopstraat 5333,2023-06-30,01:00:00,45,17,28,FMN 03 Kolonel Silvertopstraat
651,Kolonel Silvertopstraat 5333,2023-06-30,02:00:00,13,6,7,FMN 03 Kolonel Silvertopstraat
651,Kolonel Silvertopstraat 5333,2023-06-30,03:00:00,21,8,13,FMN 03 Kolonel Silvertopstraat
651,Kolonel Silvertopstraat 5333,2023-06-30,04:00:00,31,23,8,FMN 03 Kolonel Silvertopstraat
651,Kolonel Silvertopstraat 5333,2023-06-30,05:00:00,65,45,20,FMN 03 Kolonel Silvertopstraat
651,Kolonel Silvertopstraat 5333,2023-06-30,06:00:00,117,84,33,FMN 03 Kolonel Silvertopstraat
651,Kolonel Silvertopstraat 5333,2023-06-30,07:00:00,227,179,48,FMN 03 Kolonel Silvertopstraat
651,Kolonel Silvertopstraat 5333,2023-06-30,08:00:00,413,335,78,FMN 03 Kolonel Silvertopstraat
651,Kolonel Silvertopstraat 5333,2023-06-30,09:00:00,268,218,50,FMN 03 Kolonel Silvertopstraat
651,Kolonel Silvertopstraat 5333,2023-06-30,10:00:00,240,195,45,FMN 03 Kolonel Silvertopstraat
651,Kolonel Silvertopstraat 5333,2023-06-30,11:00:00,270,188,82,FMN 03 Kolonel Silvertopstraat
651,Kolonel Silvertopstraat 5333,2023-06-30,12:00:00,273,192,81,FMN 03 Kolonel Silvertopstraat
651,Kolonel Silvertopstraat 5333,2023-06-30,13:00:00,225,150,75,FMN 03 Kolonel Silvertopstraat
651,Kolonel Silvertopstraat 5333,2023-06-30,14:00:00,264,185,79,FMN 03 Kolonel Silvertopstraat
651,Kolonel Silvertopstraat 5333,2023-06-30,15:00:00,284,192,92,FMN 03 Kolonel Silvertopstraat
651,Kolonel Silvertopstraat 5333,2023-06-30,16:00:00,343,224,119,FMN 03 Kolonel Silvertopstraat
651,Kolonel Silvertopstraat 5333,2023-06-30,17:00:00,333,221,112,FMN 03 Kolonel Silvertopstraat
651,Kolonel Silvertopstraat 5333,2023-06-30,18:00:00,297,199,98,FMN 03 Kolonel Silvertopstraat
651,Kolonel Silvertopstraat 5333,2023-06-30,19:00:00,244,170,74,FMN 03 Kolonel Silvertopstraat
651,Kolonel Silvertopstraat 5333,2023-06-30,20:00:00,183,131,52,FMN 03 Kolonel Silvertopstraat
651,Kolonel Silvertopstraat 5333,2023-06-30,21:00:00,156,97,59,FMN 03 Kolonel Silvertopstraat
651,Kolonel Silvertopstraat 5333,2023-06-30,22:00:00,183,101,82,FMN 03 Kolonel Silvertopstraat
651,Kolonel Silvertopstraat 5333,2023-06-30,23:00:00,134,67,67,FMN 03 Kolonel Silvertopstraat
651,Kolonel Silvertopstraat 5333,2023-07-01,00:00:00,112,54,58,FMN 03 Kolonel Silvertopstraat
651,Kolonel Silvertopstraat 5333,2023-07-01,01:00:00,62,25,37,FMN 03 Kolonel Silvertopstraat
651,Kolonel Silvertopstraat 5333,2023-07-01,02:00:00,54,20,34,FMN 03 Kolonel Silvertopstraat
651,Kolonel Silvertopstraat 5333,2023-07-01,03:00:00,43,21,22,FMN 03 Kolonel Silvertopstraat
651,Kolonel Silvertopstraat 5333,2023-07-01,04:00:00,19,10,9,FMN 03 Kolonel Silvertopstraat
651,Kolonel Silvertopstraat 5333,2023-07-01,05:00:00,25,13,12,FMN 03 Kolonel Silvertopstraat
651,Kolonel Silvertopstraat 5333,2023-07-01,06:00:00,29,20,9,FMN 03 Kolonel Silvertopstraat
651,Kolonel Silvertopstraat 5333,2023-07-01,07:00:00,26,19,7,FMN 03 Kolonel Silvertopstraat
651,Kolonel Silvertopstraat 5333,2023-07-01,08:00:00,66,51,15,FMN 03 Kolonel Silvertopstraat
651,Kolonel Silvertopstraat 5333,2023-07-01,09:00:00,110,81,29,FMN 03 Kolonel Silvertopstraat
651,Kolonel Silvertopstraat 5333,2023-07-01,10:00:00,97,77,20,FMN 03 Kolonel Silvertopstraat
651,Kolonel Silvertopstraat 5333,2023-07-01,11:00:00,124,79,45,FMN 03 Kolonel Silvertopstraat
651,Kolonel Silvertopstraat 5333,2023-07-01,12:00:00,116,84,32,FMN 03 Kolonel Silvertopstraat
651,Kolonel Silvertopstraat 5333,2023-07-01,13:00:00,147,109,38,FMN 03 Kolonel Silvertopstraat
651,Kolonel Silvertopstraat 5333,2023-07-01,14:00:00,145,97,48,FMN 03 Kolonel Silvertopstraat
651,Kolonel Silvertopstraat 5333,2023-07-01,15:00:00,146,99,47,FMN 03 Kolonel Silvertopstraat
651,Kolonel Silvertopstraat 5333,2023-07-01,16:00:00,157,120,37,FMN 03 Kolonel Silvertopstraat
651,Kolonel Silvertopstraat 5333,2023-07-01,17:00:00,159,105,54,FMN 03 Kolonel Silvertopstraat
651,Kolonel Silvertopstraat 5333,2023-07-01,18:00:00,196,121,75,FMN 03 Kolonel Silvertopstraat
651,Kolonel Silvertopstraat 5333,2023-07-01,19:00:00,152,107,45,FMN 03 Kolonel Silvertopstraat
651,Kolonel Silvertopstraat 5333,2023-07-01,20:00:00,139,98,41,FMN 03 Kolonel Silvertopstraat
651,Kolonel Silvertopstraat 5333,2023-07-01,21:00:00,103,63,40,FMN 03 Kolonel Silvertopstraat
651,Kolonel Silvertopstraat 5333,2023-07-01,22:00:00,114,58,56,FMN 03 Kolonel Silvertopstraat
651,Kolonel Silvertopstraat 5333,2023-07-01,23:00:00,84,41,43,FMN 03 Kolonel Silvertopstraat
651,Kolonel Silvertopstraat 5333,2023-07-02,00:00:00,50,17,33,FMN 03 Kolonel Silvertopstraat
651,Kolonel Silvertopstraat 5333,2023-07-02,01:00:00,40,16,24,FMN 03 Kolonel Silvertopstraat
651,Kolonel Silvertopstraat 5333,2023-07-02,02:00:00,51,24,27,FMN 03 Kolonel Silvertopstraat
651,Kolonel Silvertopstraat 5333,2023-07-02,03:00:00,28,8,20,FMN 03 Kolonel Silvertopstraat
651,Kolonel Silvertopstraat 5333,2023-07-02,04:00:00,25,11,14,FMN 03 Kolonel Silvertopstraat
651,Kolonel Silvertopstraat 5333,2023-07-02,05:00:00,36,26,10,FMN 03 Kolonel Silvertopstraat
651,Kolonel Silvertopstraat 5333,2023-07-02,06:00:00,25,18,7,FMN 03 Kolonel Silvertopstraat
651,Kolonel Silvertopstraat 5333,2023-07-02,07:00:00,33,28,5,FMN 03 Kolonel Silvertopstraat
651,Kolonel Silvertopstraat 5333,2023-07-02,08:00:00,63,51,12,FMN 03 Kolonel Silvertopstraat
651,Kolonel Silvertopstraat 5333,2023-07-02,09:00:00,116,94,22,FMN 03 Kolonel Silvertopstraat
651,Kolonel Silvertopstraat 5333,2023-07-02,10:00:00,142,118,24,FMN 03 Kolonel Silvertopstraat
651,Kolonel Silvertopstraat 5333,2023-07-02,11:00:00,163,135,28,FMN 03 Kolonel Silvertopstraat
651,Kolonel Silvertopstraat 5333,2023-07-02,12:00:00,177,139,38,FMN 03 Kolonel Silvertopstraat
651,Kolonel Silvertopstraat 5333,2023-07-02,13:00:00,216,156,60,FMN 03 Kolonel Silvertopstraat
651,Kolonel Silvertopstraat 5333,2023-07-02,14:00:00,191,135,56,FMN 03 Kolonel Silvertopstraat
651,Kolonel Silvertopstraat 5333,2023-07-02,15:00:00,168,120,48,FMN 03 Kolonel Silvertopstraat
651,Kolonel Silvertopstraat 5333,2023-07-02,16:00:00,187,120,67,FMN 03 Kolonel Silvertopstraat
651,Kolonel Silvertopstraat 5333,2023-07-02,17:00:00,209,133,76,FMN 03 Kolonel Silvertopstraat
651,Kolonel Silvertopstraat 5333,2023-07-02,18:00:00,192,127,65,FMN 03 Kolonel Silvertopstraat
651,Kolonel Silvertopstraat 5333,2023-07-02,19:00:00,169,117,52,FMN 03 Kolonel Silvertopstraat
651,Kolonel Silvertopstraat 5333,2023-07-02,20:00:00,134,82,52,FMN 03 Kolonel Silvertopstraat
651,Kolonel Silvertopstraat 5333,2023-07-02,21:00:00,123,74,49,FMN 03 Kolonel Silvertopstraat
651,Kolonel Silvertopstraat 5333,2023-07-02,22:00:00,114,61,53,FMN 03 Kolonel Silvertopstraat
651,Kolonel Silvertopstraat 5333,2023-07-02,23:00:00,81,28,53,FMN 03 Kolonel Silvertopstraat
651,Kolonel Silvertopstraat 5333,2023-07-03,00:00:00,55,27,28,FMN 03 Kolonel Silvertopstraat
651,Kolonel Silvertopstraat 5333,2023-07-03,01:00:00,31,13,18,FMN 03 Kolonel Silvertopstraat
651,Kolonel Silvertopstraat 5333,2023-07-03,02:00:00,20,8,12,FMN 03 Kolonel Silvertopstraat
651,Kolonel Silvertopstraat 5333,2023-07-03,03:00:00,12,6,6,FMN 03 Kolonel Silvertopstraat
651,Kolonel Silvertopstraat 5333,2023-07-03,04:00:00,24,19,5,FMN 03 Kolonel Silvertopstraat
651,Kolonel Silvertopstraat 5333,2023-07-03,05:00:00,66,44,22,FMN 03 Kolonel Silvertopstraat
651,Kolonel Silvertopstraat 5333,2023-07-03,06:00:00,111,87,24,FMN 03 Kolonel Silvertopstraat
651,Kolonel Silvertopstraat 5333,2023-07-03,07:00:00,230,192,38,FMN 03 Kolonel Silvertopstraat
651,Kolonel Silvertopstraat 5333,2023-07-03,08:00:00,382,314,68,FMN 03 Kolonel Silvertopstraat
651,Kolonel Silvertopstraat 5333,2023-07-03,09:00:00,218,175,43,FMN 03 Kolonel Silvertopstraat
651,Kolonel Silvertopstraat 5333,2023-07-03,10:00:00,171,133,38,FMN 03 Kolonel Silvertopstraat
651,Kolonel Silvertopstraat 5333,2023-07-03,11:00:00,105,81,24,FMN 03 Kolonel Silvertopstraat
651,Kolonel Silvertopstraat 5333,2023-07-03,12:00:00,169,115,54,FMN 03 Kolonel Silvertopstraat
651,Kolonel Silvertopstraat 5333,2023-07-03,13:00:00,193,135,58,FMN 03 Kolonel Silvertopstraat
651,Kolonel Silvertopstraat 5333,2023-07-03,14:00:00,202,142,60,FMN 03 Kolonel Silvertopstraat
651,Kolonel Silvertopstraat 5333,2023-07-03,15:00:00,219,149,70,FMN 03 Kolonel Silvertopstraat
651,Kolonel Silvertopstraat 5333,2023-07-03,16:00:00,339,230,109,FMN 03 Kolonel Silvertopstraat
651,Kolonel Silvertopstraat 5333,2023-07-03,17:00:00,354,234,120,FMN 03 Kolonel Silvertopstraat
651,Kolonel Silvertopstraat 5333,2023-07-03,18:00:00,277,167,110,FMN 03 Kolonel Silvertopstraat
651,Kolonel Silvertopstraat 5333,2023-07-03,19:00:00,202,122,80,FMN 03 Kolonel Silvertopstraat
651,Kolonel Silvertopstraat 5333,2023-07-03,20:00:00,168,102,66,FMN 03 Kolonel Silvertopstraat
651,Kolonel Silvertopstraat 5333,2023-07-03,21:00:00,138,67,71,FMN 03 Kolonel Silvertopstraat
651,Kolonel Silvertopstraat 5333,2023-07-03,22:00:00,109,62,47,FMN 03 Kolonel Silvertopstraat
651,Kolonel Silvertopstraat 5333,2023-07-03,23:00:00,78,39,39,FMN 03 Kolonel Silvertopstraat
651,Kolonel Silvertopstraat 5333,2023-07-04,00:00:00,39,18,21,FMN 03 Kolonel Silvertopstraat
651,Kolonel Silvertopstraat 5333,2023-07-04,01:00:00,18,8,10,FMN 03 Kolonel Silvertopstraat
651,Kolonel Silvertopstraat 5333,2023-07-04,02:00:00,14,8,6,FMN 03 Kolonel Silvertopstraat
651,Kolonel Silvertopstraat 5333,2023-07-04,03:00:00,16,10,6,FMN 03 Kolonel Silvertopstraat
651,Kolonel Silvertopstraat 5333,2023-07-04,04:00:00,22,16,6,FMN 03 Kolonel Silvertopstraat
651,Kolonel Silvertopstraat 5333,2023-07-04,05:00:00,65,49,16,FMN 03 Kolonel Silvertopstraat
651,Kolonel Silvertopstraat 5333,2023-07-04,06:00:00,119,89,30,FMN 03 Kolonel Silvertopstraat
651,Kolonel Silvertopstraat 5333,2023-07-04,07:00:00,238,195,43,FMN 03 Kolonel Silvertopstraat
651,Kolonel Silvertopstraat 5333,2023-07-04,08:00:00,400,329,71,FMN 03 Kolonel Silvertopstraat
651,Kolonel Silvertopstraat 5333,2023-07-04,09:00:00,269,219,50,FMN 03 Kolonel Silvertopstraat
651,Kolonel Silvertopstraat 5333,2023-07-04,10:00:00,180,134,46,FMN 03 Kolonel Silvertopstraat
651,Kolonel Silvertopstraat 5333,2023-07-04,11:00:00,154,113,41,FMN 03 Kolonel Silvertopstraat
651,Kolonel Silvertopstraat 5333,2023-07-04,12:00:00,161,121,40,FMN 03 Kolonel Silvertopstraat
651,Kolonel Silvertopstraat 5333,2023-07-04,13:00:00,209,135,74,FMN 03 Kolonel Silvertopstraat
651,Kolonel Silvertopstraat 5333,2023-07-04,14:00:00,180,127,53,FMN 03 Kolonel Silvertopstraat
651,Kolonel Silvertopstraat 5333,2023-07-04,15:00:00,235,155,80,FMN 03 Kolonel Silvertopstraat
651,Kolonel Silvertopstraat 5333,2023-07-04,16:00:00,341,234,107,FMN 03 Kolonel Silvertopstraat
651,Kolonel Silvertopstraat 5333,2023-07-04,17:00:00,394,252,142,FMN 03 Kolonel Silvertopstraat
651,Kolonel Silvertopstraat 5333,2023-07-04,18:00:00,296,187,109,FMN 03 Kolonel Silvertopstraat
651,Kolonel Silvertopstraat 5333,2023-07-04,19:00:00,179,109,70,FMN 03 Kolonel Silvertopstraat
651,Kolonel Silvertopstraat 5333,2023-07-04,20:00:00,166,92,74,FMN 03 Kolonel Silvertopstraat
651,Kolonel Silvertopstraat 5333,2023-07-04,21:00:00,106,51,55,FMN 03 Kolonel Silvertopstraat
651,Kolonel Silvertopstraat 5333,2023-07-04,22:00:00,134,89,45,FMN 03 Kolonel Silvertopstraat
651,Kolonel Silvertopstraat 5333,2023-07-04,23:00:00,82,32,50,FMN 03 Kolonel Silvertopstraat
651,Kolonel Silvertopstraat 5333,2023-07-05,00:00:00,34,17,17,FMN 03 Kolonel Silvertopstraat
651,Kolonel Silvertopstraat 5333,2023-07-05,01:00:00,22,9,13,FMN 03 Kolonel Silvertopstraat
651,Kolonel Silvertopstraat 5333,2023-07-05,02:00:00,10,4,6,FMN 03 Kolonel Silvertopstraat
651,Kolonel Silvertopstraat 5333,2023-07-05,03:00:00,16,8,8,FMN 03 Kolonel Silvertopstraat
651,Kolonel Silvertopstraat 5333,2023-07-05,04:00:00,23,17,6,FMN 03 Kolonel Silvertopstraat
651,Kolonel Silvertopstraat 5333,2023-07-05,05:00:00,50,37,13,FMN 03 Kolonel Silvertopstraat
651,Kolonel Silvertopstraat 5333,2023-07-05,06:00:00,106,85,21,FMN 03 Kolonel Silvertopstraat
651,Kolonel Silvertopstraat 5333,2023-07-05,07:00:00,171,142,29,FMN 03 Kolonel Silvertopstraat
651,Kolonel Silvertopstraat 5333,2023-07-05,08:00:00,282,222,60,FMN 03 Kolonel Silvertopstraat
651,Kolonel Silvertopstraat 5333,2023-07-05,09:00:00,178,137,41,FMN 03 Kolonel Silvertopstraat
651,Kolonel Silvertopstraat 5333,2023-07-05,10:00:00,136,105,31,FMN 03 Kolonel Silvertopstraat
651,Kolonel Silvertopstraat 5333,2023-07-05,11:00:00,132,109,23,FMN 03 Kolonel Silvertopstraat
651,Kolonel Silvertopstraat 5333,2023-07-05,12:00:00,174,117,57,FMN 03 Kolonel Silvertopstraat
651,Kolonel Silvertopstraat 5333,2023-07-05,13:00:00,170,109,61,FMN 03 Kolonel Silvertopstraat
651,Kolonel Silvertopstraat 5333,2023-07-05,14:00:00,161,109,52,FMN 03 Kolonel Silvertopstraat
651,Kolonel Silvertopstraat 5333,2023-07-05,15:00:00,181,112,69,FMN 03 Kolonel Silvertopstraat
651,Kolonel Silvertopstraat 5333,2023-07-05,16:00:00,267,194,73,FMN 03 Kolonel Silvertopstraat
651,Kolonel Silvertopstraat 5333,2023-07-05,17:00:00,313,201,112,FMN 03 Kolonel Silvertopstraat
651,Kolonel Silvertopstraat 5333,2023-07-05,18:00:00,206,131,75,FMN 03 Kolonel Silvertopstraat
651,Kolonel Silvertopstraat 5333,2023-07-05,19:00:00,159,103,56,FMN 03 Kolonel Silvertopstraat
651,Kolonel Silvertopstraat 5333,2023-07-05,20:00:00,122,69,53,FMN 03 Kolonel Silvertopstraat
651,Kolonel Silvertopstraat 5333,2023-07-05,21:00:00,100,49,51,FMN 03 Kolonel Silvertopstraat
651,Kolonel Silvertopstraat 5333,2023-07-05,22:00:00,127,63,64,FMN 03 Kolonel Silvertopstraat
651,Kolonel Silvertopstraat 5333,2023-07-05,23:00:00,65,25,40,FMN 03 Kolonel Silvertopstraat
651,Kolonel Silvertopstraat 5333,2023-07-06,00:00:00,58,26,32,FMN 03 Kolonel Silvertopstraat
651,Kolonel Silvertopstraat 5333,2023-07-06,01:00:00,34,11,23,FMN 03 Kolonel Silvertopstraat
651,Kolonel Silvertopstraat 5333,2023-07-06,02:00:00,11,6,5,FMN 03 Kolonel Silvertopstraat
651,Kolonel Silvertopstraat 5333,2023-07-06,03:00:00,12,6,6,FMN 03 Kolonel Silvertopstraat
651,Kolonel Silvertopstraat 5333,2023-07-06,04:00:00,29,25,4,FMN 03 Kolonel Silvertopstraat
651,Kolonel Silvertopstraat 5333,2023-07-06,05:00:00,55,37,18,FMN 03 Kolonel Silvertopstraat
651,Kolonel Silvertopstraat 5333,2023-07-06,06:00:00,122,101,21,FMN 03 Kolonel Silvertopstraat
651,Kolonel Silvertopstraat 5333,2023-07-06,07:00:00,215,162,53,FMN 03 Kolonel Silvertopstraat
651,Kolonel Silvertopstraat 5333,2023-07-06,08:00:00,383,319,64,FMN 03 Kolonel Silvertopstraat
651,Kolonel Silvertopstraat 5333,2023-07-06,09:00:00,218,163,55,FMN 03 Kolonel Silvertopstraat
651,Kolonel Silvertopstraat 5333,2023-07-06,10:00:00,156,123,33,FMN 03 Kolonel Silvertopstraat
651,Kolonel Silvertopstraat 5333,2023-07-06,11:00:00,145,112,33,FMN 03 Kolonel Silvertopstraat
651,Kolonel Silvertopstraat 5333,2023-07-06,12:00:00,188,137,51,FMN 03 Kolonel Silvertopstraat
651,Kolonel Silvertopstraat 5333,2023-07-06,13:00:00,170,133,37,FMN 03 Kolonel Silvertopstraat
651,Kolonel Silvertopstraat 5333,2023-07-06,14:00:00,232,153,79,FMN 03 Kolonel Silvertopstraat
651,Kolonel Silvertopstraat 5333,2023-07-06,15:00:00,161,111,50,FMN 03 Kolonel Silvertopstraat
651,Kolonel Silvertopstraat 5333,2023-07-06,16:00:00,222,141,81,FMN 03 Kolonel Silvertopstraat
651,Kolonel Silvertopstraat 5333,2023-07-06,17:00:00,358,251,107,FMN 03 Kolonel Silvertopstraat
651,Kolonel Silvertopstraat 5333,2023-07-06,18:00:00,275,198,77,FMN 03 Kolonel Silvertopstraat
651,Kolonel Silvertopstraat 5333,2023-07-06,19:00:00,216,150,66,FMN 03 Kolonel Silvertopstraat
651,Kolonel Silvertopstraat 5333,2023-07-06,20:00:00,179,116,63,FMN 03 Kolonel Silvertopstraat
651,Kolonel Silvertopstraat 5333,2023-07-06,21:00:00,129,81,48,FMN 03 Kolonel Silvertopstraat
651,Kolonel Silvertopstraat 5333,2023-07-06,22:00:00,167,91,76,FMN 03 Kolonel Silvertopstraat
651,Kolonel Silvertopstraat 5333,2023-07-06,23:00:00,106,37,69,FMN 03 Kolonel Silvertopstraat
651,Kolonel Silvertopstraat 5333,2023-07-07,00:00:00,59,27,32,FMN 03 Kolonel Silvertopstraat
651,Kolonel Silvertopstraat 5333,2023-07-07,01:00:00,40,19,21,FMN 03 Kolonel Silvertopstraat
651,Kolonel Silvertopstraat 5333,2023-07-07,02:00:00,23,14,9,FMN 03 Kolonel Silvertopstraat
651,Kolonel Silvertopstraat 5333,2023-07-07,03:00:00,23,9,14,FMN 03 Kolonel Silvertopstraat
651,Kolonel Silvertopstraat 5333,2023-07-07,04:00:00,30,20,10,FMN 03 Kolonel Silvertopstraat
651,Kolonel Silvertopstraat 5333,2023-07-07,05:00:00,66,48,18,FMN 03 Kolonel Silvertopstraat
651,Kolonel Silvertopstraat 5333,2023-07-07,06:00:00,100,81,19,FMN 03 Kolonel Silvertopstraat
651,Kolonel Silvertopstraat 5333,2023-07-07,07:00:00,181,133,48,FMN 03 Kolonel Silvertopstraat
651,Kolonel Silvertopstraat 5333,2023-07-07,08:00:00,312,261,51,FMN 03 Kolonel Silvertopstraat
651,Kolonel Silvertopstraat 5333,2023-07-07,09:00:00,236,186,50,FMN 03 Kolonel Silvertopstraat
651,Kolonel Silvertopstraat 5333,2023-07-07,10:00:00,221,167,54,FMN 03 Kolonel Silvertopstraat
651,Kolonel Silvertopstraat 5333,2023-07-07,11:00:00,214,149,65,FMN 03 Kolonel Silvertopstraat
651,Kolonel Silvertopstraat 5333,2023-07-07,12:00:00,248,187,61,FMN 03 Kolonel Silvertopstraat
651,Kolonel Silvertopstraat 5333,2023-07-07,13:00:00,217,154,63,FMN 03 Kolonel Silvertopstraat
651,Kolonel Silvertopstraat 5333,2023-07-07,14:00:00,98,67,31,FMN 03 Kolonel Silvertopstraat
651,Kolonel Silvertopstraat 5333,2023-07-07,15:00:00,0,0,0,FMN 03 Kolonel Silvertopstraat
651,Kolonel Silvertopstraat 5333,2023-07-07,16:00:00,0,0,0,FMN 03 Kolonel Silvertopstraat
651,Kolonel Silvertopstraat 5333,2023-07-07,17:00:00,115,73,42,FMN 03 Kolonel Silvertopstraat
651,Kolonel Silvertopstraat 5333,2023-07-07,18:00:00,142,105,37,FMN 03 Kolonel Silvertopstraat
651,Kolonel Silvertopstraat 5333,2023-07-07,19:00:00,220,144,76,FMN 03 Kolonel Silvertopstraat
651,Kolonel Silvertopstraat 5333,2023-07-07,20:00:00,193,127,66,FMN 03 Kolonel Silvertopstraat
651,Kolonel Silvertopstraat 5333,2023-07-07,21:00:00,165,103,62,FMN 03 Kolonel Silvertopstraat
651,Kolonel Silvertopstraat 5333,2023-07-07,22:00:00,141,80,61,FMN 03 Kolonel Silvertopstraat
651,Kolonel Silvertopstraat 5333,2023-07-07,23:00:00,116,60,56,FMN 03 Kolonel Silvertopstraat
651,Kolonel Silvertopstraat 5333,2023-07-08,00:00:00,109,59,50,FMN 03 Kolonel Silvertopstraat
651,Kolonel Silvertopstraat 5333,2023-07-08,01:00:00,85,47,38,FMN 03 Kolonel Silvertopstraat
651,Kolonel Silvertopstraat 5333,2023-07-08,02:00:00,53,18,35,FMN 03 Kolonel Silvertopstraat
651,Kolonel Silvertopstraat 5333,2023-07-08,03:00:00,31,12,19,FMN 03 Kolonel Silvertopstraat
651,Kolonel Silvertopstraat 5333,2023-07-08,04:00:00,26,10,16,FMN 03 Kolonel Silvertopstraat
651,Kolonel Silvertopstraat 5333,2023-07-08,05:00:00,32,21,11,FMN 03 Kolonel Silvertopstraat
651,Kolonel Silvertopstraat 5333,2023-07-08,06:00:00,40,31,9,FMN 03 Kolonel Silvertopstraat
651,Kolonel Silvertopstraat 5333,2023-07-08,07:00:00,35,18,17,FMN 03 Kolonel Silvertopstraat
651,Kolonel Silvertopstraat 5333,2023-07-08,08:00:00,86,73,13,FMN 03 Kolonel Silvertopstraat
651,Kolonel Silvertopstraat 5333,2023-07-08,09:00:00,182,148,34,FMN 03 Kolonel Silvertopstraat
651,Kolonel Silvertopstraat 5333,2023-07-08,10:00:00,182,148,34,FMN 03 Kolonel Silvertopstraat
651,Kolonel Silvertopstraat 5333,2023-07-08,11:00:00,188,147,41,FMN 03 Kolonel Silvertopstraat
651,Kolonel Silvertopstraat 5333,2023-07-08,12:00:00,200,150,50,FMN 03 Kolonel Silvertopstraat
651,Kolonel Silvertopstraat 5333,2023-07-08,13:00:00,210,151,59,FMN 03 Kolonel Silvertopstraat
651,Kolonel Silvertopstraat 5333,2023-07-08,14:00:00,188,115,73,FMN 03 Kolonel Silvertopstraat
651,Kolonel Silvertopstraat 5333,2023-07-08,15:00:00,171,119,52,FMN 03 Kolonel Silvertopstraat
651,Kolonel Silvertopstraat 5333,2023-07-08,16:00:00,189,135,54,FMN 03 Kolonel Silvertopstraat
651,Kolonel Silvertopstraat 5333,2023-07-08,17:00:00,209,144,65,FMN 03 Kolonel Silvertopstraat
651,Kolonel Silvertopstraat 5333,2023-07-08,18:00:00,235,148,87,FMN 03 Kolonel Silvertopstraat
651,Kolonel Silvertopstraat 5333,2023-07-08,19:00:00,170,113,57,FMN 03 Kolonel Silvertopstraat
651,Kolonel Silvertopstraat 5333,2023-07-08,20:00:00,161,111,50,FMN 03 Kolonel Silvertopstraat
651,Kolonel Silvertopstraat 5333,2023-07-08,21:00:00,123,77,46,FMN 03 Kolonel Silvertopstraat
651,Kolonel Silvertopstraat 5333,2023-07-08,22:00:00,148,87,61,FMN 03 Kolonel Silvertopstraat
651,Kolonel Silvertopstraat 5333,2023-07-08,23:00:00,154,78,76,FMN 03 Kolonel Silvertopstraat
651,Kolonel Silvertopstraat 5333,2023-07-09,00:00:00,91,45,46,FMN 03 Kolonel Silvertopstraat
651,Kolonel Silvertopstraat 5333,2023-07-09,01:00:00,67,30,37,FMN 03 Kolonel Silvertopstraat
651,Kolonel Silvertopstraat 5333,2023-07-09,02:00:00,35,13,22,FMN 03 Kolonel Silvertopstraat
651,Kolonel Silvertopstraat 5333,2023-07-09,03:00:00,23,7,16,FMN 03 Kolonel Silvertopstraat
651,Kolonel Silvertopstraat 5333,2023-07-09,04:00:00,24,4,20,FMN 03 Kolonel Silvertopstraat
651,Kolonel Silvertopstraat 5333,2023-07-09,05:00:00,27,12,15,FMN 03 Kolonel Silvertopstraat
651,Kolonel Silvertopstraat 5333,2023-07-09,06:00:00,36,26,10,FMN 03 Kolonel Silvertopstraat
651,Kolonel Silvertopstraat 5333,2023-07-09,07:00:00,33,23,10,FMN 03 Kolonel Silvertopstraat
651,Kolonel Silvertopstraat 5333,2023-07-09,08:00:00,64,53,11,FMN 03 Kolonel Silvertopstraat
651,Kolonel Silvertopstraat 5333,2023-07-09,09:00:00,108,83,25,FMN 03 Kolonel Silvertopstraat
651,Kolonel Silvertopstraat 5333,2023-07-09,10:00:00,158,122,36,FMN 03 Kolonel Silvertopstraat
651,Kolonel Silvertopstraat 5333,2023-07-09,11:00:00,176,140,36,FMN 03 Kolonel Silvertopstraat
651,Kolonel Silvertopstraat 5333,2023-07-09,12:00:00,172,123,49,FMN 03 Kolonel Silvertopstraat
651,Kolonel Silvertopstraat 5333,2023-07-09,13:00:00,163,120,43,FMN 03 Kolonel Silvertopstraat
651,Kolonel Silvertopstraat 5333,2023-07-09,14:00:00,150,99,51,FMN 03 Kolonel Silvertopstraat
651,Kolonel Silvertopstraat 5333,2023-07-09,15:00:00,64,34,30,FMN 03 Kolonel Silvertopstraat
651,Kolonel Silvertopstraat 5333,2023-07-09,16:00:00,125,82,43,FMN 03 Kolonel Silvertopstraat
651,Kolonel Silvertopstraat 5333,2023-07-09,17:00:00,138,94,44,FMN 03 Kolonel Silvertopstraat
651,Kolonel Silvertopstraat 5333,2023-07-09,18:00:00,127,78,49,FMN 03 Kolonel Silvertopstraat
651,Kolonel Silvertopstraat 5333,2023-07-09,19:00:00,156,97,59,FMN 03 Kolonel Silvertopstraat
651,Kolonel Silvertopstraat 5333,2023-07-09,20:00:00,124,82,42,FMN 03 Kolonel Silvertopstraat
651,Kolonel Silvertopstraat 5333,2023-07-09,21:00:00,108,59,49,FMN 03 Kolonel Silvertopstraat
651,Kolonel Silvertopstraat 5333,2023-07-09,22:00:00,94,54,40,FMN 03 Kolonel Silvertopstraat
651,Kolonel Silvertopstraat 5333,2023-07-09,23:00:00,91,42,49,FMN 03 Kolonel Silvertopstraat
651,Kolonel Silvertopstraat 5333,2023-07-10,00:00:00,40,19,21,FMN 03 Kolonel Silvertopstraat
651,Kolonel Silvertopstraat 5333,2023-07-10,01:00:00,24,12,12,FMN 03 Kolonel Silvertopstraat
651,Kolonel Silvertopstraat 5333,2023-07-10,02:00:00,21,14,7,FMN 03 Kolonel Silvertopstraat
651,Kolonel Silvertopstraat 5333,2023-07-10,03:00:00,12,3,9,FMN 03 Kolonel Silvertopstraat
651,Kolonel Silvertopstraat 5333,2023-07-10,04:00:00,28,22,6,FMN 03 Kolonel Silvertopstraat
651,Kolonel Silvertopstraat 5333,2023-07-10,05:00:00,57,38,19,FMN 03 Kolonel Silvertopstraat
651,Kolonel Silvertopstraat 5333,2023-07-10,06:00:00,113,89,24,FMN 03 Kolonel Silvertopstraat
651,Kolonel Silvertopstraat 5333,2023-07-10,07:00:00,190,143,47,FMN 03 Kolonel Silvertopstraat
651,Kolonel Silvertopstraat 5333,2023-07-10,08:00:00,286,241,45,FMN 03 Kolonel Silvertopstraat
651,Kolonel Silvertopstraat 5333,2023-07-10,09:00:00,175,133,42,FMN 03 Kolonel Silvertopstraat
651,Kolonel Silvertopstraat 5333,2023-07-10,10:00:00,141,99,42,FMN 03 Kolonel Silvertopstraat
651,Kolonel Silvertopstraat 5333,2023-07-10,11:00:00,158,128,30,FMN 03 Kolonel Silvertopstraat
651,Kolonel Silvertopstraat 5333,2023-07-10,12:00:00,175,128,47,FMN 03 Kolonel Silvertopstraat
651,Kolonel Silvertopstraat 5333,2023-07-10,13:00:00,149,116,33,FMN 03 Kolonel Silvertopstraat
651,Kolonel Silvertopstraat 5333,2023-07-10,14:00:00,197,133,64,FMN 03 Kolonel Silvertopstraat
651,Kolonel Silvertopstraat 5333,2023-07-10,15:00:00,249,170,79,FMN 03 Kolonel Silvertopstraat
651,Kolonel Silvertopstraat 5333,2023-07-10,16:00:00,308,220,88,FMN 03 Kolonel Silvertopstraat
651,Kolonel Silvertopstraat 5333,2023-07-10,17:00:00,328,195,133,FMN 03 Kolonel Silvertopstraat
651,Kolonel Silvertopstraat 5333,2023-07-10,18:00:00,275,164,111,FMN 03 Kolonel Silvertopstraat
651,Kolonel Silvertopstraat 5333,2023-07-10,19:00:00,164,111,53,FMN 03 Kolonel Silvertopstraat
651,Kolonel Silvertopstraat 5333,2023-07-10,20:00:00,196,116,80,FMN 03 Kolonel Silvertopstraat
651,Kolonel Silvertopstraat 5333,2023-07-10,21:00:00,149,86,63,FMN 03 Kolonel Silvertopstraat
651,Kolonel Silvertopstraat 5333,2023-07-10,22:00:00,162,96,66,FMN 03 Kolonel Silvertopstraat
651,Kolonel Silvertopstraat 5333,2023-07-10,23:00:00,76,40,36,FMN 03 Kolonel Silvertopstraat
651,Kolonel Silvertopstraat 5333,2023-07-11,00:00:00,53,20,33,FMN 03 Kolonel Silvertopstraat
651,Kolonel Silvertopstraat 5333,2023-07-11,01:00:00,21,15,6,FMN 03 Kolonel Silvertopstraat
651,Kolonel Silvertopstraat 5333,2023-07-11,02:00:00,26,8,18,FMN 03 Kolonel Silvertopstraat
651,Kolonel Silvertopstraat 5333,2023-07-11,03:00:00,13,7,6,FMN 03 Kolonel Silvertopstraat
651,Kolonel Silvertopstraat 5333,2023-07-11,04:00:00,36,31,5,FMN 03 Kolonel Silvertopstraat
651,Kolonel Silvertopstraat 5333,2023-07-11,05:00:00,58,38,20,FMN 03 Kolonel Silvertopstraat
651,Kolonel Silvertopstraat 5333,2023-07-11,06:00:00,105,78,27,FMN 03 Kolonel Silvertopstraat
651,Kolonel Silvertopstraat 5333,2023-07-11,07:00:00,207,156,51,FMN 03 Kolonel Silvertopstraat
651,Kolonel Silvertopstraat 5333,2023-07-11,08:00:00,262,213,49,FMN 03 Kolonel Silvertopstraat
651,Kolonel Silvertopstraat 5333,2023-07-11,09:00:00,181,141,40,FMN 03 Kolonel Silvertopstraat
651,Kolonel Silvertopstraat 5333,2023-07-11,10:00:00,166,126,40,FMN 03 Kolonel Silvertopstraat
651,Kolonel Silvertopstraat 5333,2023-07-11,11:00:00,175,130,45,FMN 03 Kolonel Silvertopstraat
651,Kolonel Silvertopstraat 5333,2023-07-11,12:00:00,179,136,43,FMN 03 Kolonel Silvertopstraat
651,Kolonel Silvertopstraat 5333,2023-07-11,13:00:00,194,144,50,FMN 03 Kolonel Silvertopstraat
651,Kolonel Silvertopstraat 5333,2023-07-11,14:00:00,235,146,89,FMN 03 Kolonel Silvertopstraat
651,Kolonel Silvertopstraat 5333,2023-07-11,15:00:00,199,146,53,FMN 03 Kolonel Silvertopstraat
651,Kolonel Silvertopstraat 5333,2023-07-11,16:00:00,309,221,88,FMN 03 Kolonel Silvertopstraat
651,Kolonel Silvertopstraat 5333,2023-07-11,17:00:00,362,243,119,FMN 03 Kolonel Silvertopstraat
651,Kolonel Silvertopstraat 5333,2023-07-11,18:00:00,348,244,104,FMN 03 Kolonel Silvertopstraat
651,Kolonel Silvertopstraat 5333,2023-07-11,19:00:00,239,160,79,FMN 03 Kolonel Silvertopstraat
651,Kolonel Silvertopstraat 5333,2023-07-11,20:00:00,199,137,62,FMN 03 Kolonel Silvertopstraat
651,Kolonel Silvertopstraat 5333,2023-07-11,21:00:00,148,91,57,FMN 03 Kolonel Silvertopstraat
651,Kolonel Silvertopstraat 5333,2023-07-11,22:00:00,177,106,71,FMN 03 Kolonel Silvertopstraat
651,Kolonel Silvertopstraat 5333,2023-07-11,23:00:00,107,38,69,FMN 03 Kolonel Silvertopstraat
651,Kolonel Silvertopstraat 5333,2023-07-12,00:00:00,67,26,41,FMN 03 Kolonel Silvertopstraat
651,Kolonel Silvertopstraat 5333,2023-07-12,01:00:00,45,18,27,FMN 03 Kolonel Silvertopstraat
651,Kolonel Silvertopstraat 5333,2023-07-12,02:00:00,15,3,12,FMN 03 Kolonel Silvertopstraat
651,Kolonel Silvertopstraat 5333,2023-07-12,03:00:00,8,4,4,FMN 03 Kolonel Silvertopstraat
651,Kolonel Silvertopstraat 5333,2023-07-12,04:00:00,36,32,4,FMN 03 Kolonel Silvertopstraat
651,Kolonel Silvertopstraat 5333,2023-07-12,05:00:00,47,31,16,FMN 03 Kolonel Silvertopstraat
651,Kolonel Silvertopstraat 5333,2023-07-12,06:00:00,119,93,26,FMN 03 Kolonel Silvertopstraat
651,Kolonel Silvertopstraat 5333,2023-07-12,07:00:00,198,142,56,FMN 03 Kolonel Silvertopstraat
651,Kolonel Silvertopstraat 5333,2023-07-12,08:00:00,270,216,54,FMN 03 Kolonel Silvertopstraat
651,Kolonel Silvertopstraat 5333,2023-07-12,09:00:00,206,166,40,FMN 03 Kolonel Silvertopstraat
651,Kolonel Silvertopstraat 5333,2023-07-12,10:00:00,169,125,44,FMN 03 Kolonel Silvertopstraat
651,Kolonel Silvertopstraat 5333,2023-07-12,11:00:00,153,119,34,FMN 03 Kolonel Silvertopstraat
651,Kolonel Silvertopstraat 5333,2023-07-12,12:00:00,188,138,50,FMN 03 Kolonel Silvertopstraat
651,Kolonel Silvertopstraat 5333,2023-07-12,13:00:00,166,114,52,FMN 03 Kolonel Silvertopstraat
651,Kolonel Silvertopstraat 5333,2023-07-12,14:00:00,196,128,68,FMN 03 Kolonel Silvertopstraat
651,Kolonel Silvertopstraat 5333,2023-07-12,15:00:00,237,155,82,FMN 03 Kolonel Silvertopstraat
651,Kolonel Silvertopstraat 5333,2023-07-12,16:00:00,326,232,94,FMN 03 Kolonel Silvertopstraat
651,Kolonel Silvertopstraat 5333,2023-07-12,17:00:00,346,207,139,FMN 03 Kolonel Silvertopstraat
651,Kolonel Silvertopstraat 5333,2023-07-12,18:00:00,280,185,95,FMN 03 Kolonel Silvertopstraat
651,Kolonel Silvertopstraat 5333,2023-07-12,19:00:00,208,141,67,FMN 03 Kolonel Silvertopstraat
651,Kolonel Silvertopstraat 5333,2023-07-12,20:00:00,212,128,84,FMN 03 Kolonel Silvertopstraat
651,Kolonel Silvertopstraat 5333,2023-07-12,21:00:00,178,108,70,FMN 03 Kolonel Silvertopstraat
651,Kolonel Silvertopstraat 5333,2023-07-12,22:00:00,170,109,61,FMN 03 Kolonel Silvertopstraat
651,Kolonel Silvertopstraat 5333,2023-07-12,23:00:00,79,38,41,FMN 03 Kolonel Silvertopstraat
651,Kolonel Silvertopstraat 5333,2023-07-13,00:00:00,57,24,33,FMN 03 Kolonel Silvertopstraat
651,Kolonel Silvertopstraat 5333,2023-07-13,01:00:00,30,11,19,FMN 03 Kolonel Silvertopstraat
651,Kolonel Silvertopstraat 5333,2023-07-13,02:00:00,19,10,9,FMN 03 Kolonel Silvertopstraat
651,Kolonel Silvertopstraat 5333,2023-07-13,03:00:00,13,3,10,FMN 03 Kolonel Silvertopstraat
651,Kolonel Silvertopstraat 5333,2023-07-13,04:00:00,36,30,6,FMN 03 Kolonel Silvertopstraat
651,Kolonel Silvertopstraat 5333,2023-07-13,05:00:00,54,33,21,FMN 03 Kolonel Silvertopstraat
651,Kolonel Silvertopstraat 5333,2023-07-13,06:00:00,148,114,34,FMN 03 Kolonel Silvertopstraat
651,Kolonel Silvertopstraat 5333,2023-07-13,07:00:00,215,159,56,FMN 03 Kolonel Silvertopstraat
651,Kolonel Silvertopstraat 5333,2023-07-13,08:00:00,326,266,60,FMN 03 Kolonel Silvertopstraat
651,Kolonel Silvertopstraat 5333,2023-07-13,09:00:00,199,161,38,FMN 03 Kolonel Silvertopstraat
651,Kolonel Silvertopstraat 5333,2023-07-13,10:00:00,171,132,39,FMN 03 Kolonel Silvertopstraat
651,Kolonel Silvertopstraat 5333,2023-07-13,11:00:00,123,83,40,FMN 03 Kolonel Silvertopstraat
651,Kolonel Silvertopstraat 5333,2023-07-13,12:00:00,162,116,46,FMN 03 Kolonel Silvertopstraat
651,Kolonel Silvertopstraat 5333,2023-07-13,13:00:00,136,91,45,FMN 03 Kolonel Silvertopstraat
651,Kolonel Silvertopstraat 5333,2023-07-13,14:00:00,163,106,57,FMN 03 Kolonel Silvertopstraat
651,Kolonel Silvertopstraat 5333,2023-07-13,15:00:00,189,134,55,FMN 03 Kolonel Silvertopstraat
651,Kolonel Silvertopstraat 5333,2023-07-13,16:00:00,313,220,93,FMN 03 Kolonel Silvertopstraat
651,Kolonel Silvertopstraat 5333,2023-07-13,17:00:00,319,202,117,FMN 03 Kolonel Silvertopstraat
651,Kolonel Silvertopstraat 5333,2023-07-13,18:00:00,259,178,81,FMN 03 Kolonel Silvertopstraat
651,Kolonel Silvertopstraat 5333,2023-07-13,19:00:00,236,170,66,FMN 03 Kolonel Silvertopstraat
651,Kolonel Silvertopstraat 5333,2023-07-13,20:00:00,197,126,71,FMN 03 Kolonel Silvertopstraat
651,Kolonel Silvertopstraat 5333,2023-07-13,21:00:00,131,81,50,FMN 03 Kolonel Silvertopstraat
651,Kolonel Silvertopstraat 5333,2023-07-13,22:00:00,148,88,60,FMN 03 Kolonel Silvertopstraat
651,Kolonel Silvertopstraat 5333,2023-07-13,23:00:00,85,38,47,FMN 03 Kolonel Silvertopstraat
651,Kolonel Silvertopstraat 5333,2023-07-14,00:00:00,41,22,19,FMN 03 Kolonel Silvertopstraat
651,Kolonel Silvertopstraat 5333,2023-07-14,01:00:00,38,13,25,FMN 03 Kolonel Silvertopstraat
651,Kolonel Silvertopstraat 5333,2023-07-14,02:00:00,19,9,10,FMN 03 Kolonel Silvertopstraat
651,Kolonel Silvertopstraat 5333,2023-07-14,03:00:00,11,5,6,FMN 03 Kolonel Silvertopstraat
651,Kolonel Silvertopstraat 5333,2023-07-14,04:00:00,43,31,12,FMN 03 Kolonel Silvertopstraat
651,Kolonel Silvertopstraat 5333,2023-07-14,05:00:00,54,36,18,FMN 03 Kolonel Silvertopstraat
651,Kolonel Silvertopstraat 5333,2023-07-14,06:00:00,109,83,26,FMN 03 Kolonel Silvertopstraat
651,Kolonel Silvertopstraat 5333,2023-07-14,07:00:00,174,126,48,FMN 03 Kolonel Silvertopstraat
651,Kolonel Silvertopstraat 5333,2023-07-14,08:00:00,268,218,50,FMN 03 Kolonel Silvertopstraat
651,Kolonel Silvertopstraat 5333,2023-07-14,09:00:00,200,158,42,FMN 03 Kolonel Silvertopstraat
651,Kolonel Silvertopstraat 5333,2023-07-14,10:00:00,178,136,42,FMN 03 Kolonel Silvertopstraat
651,Kolonel Silvertopstraat 5333,2023-07-14,11:00:00,163,125,38,FMN 03 Kolonel Silvertopstraat
651,Kolonel Silvertopstraat 5333,2023-07-14,12:00:00,206,139,67,FMN 03 Kolonel Silvertopstraat
651,Kolonel Silvertopstraat 5333,2023-07-14,13:00:00,201,144,57,FMN 03 Kolonel Silvertopstraat
651,Kolonel Silvertopstraat 5333,2023-07-14,14:00:00,205,137,68,FMN 03 Kolonel Silvertopstraat
651,Kolonel Silvertopstraat 5333,2023-07-14,15:00:00,252,167,85,FMN 03 Kolonel Silvertopstraat
651,Kolonel Silvertopstraat 5333,2023-07-14,16:00:00,310,213,97,FMN 03 Kolonel Silvertopstraat
651,Kolonel Silvertopstraat 5333,2023-07-14,17:00:00,284,185,99,FMN 03 Kolonel Silvertopstraat
651,Kolonel Silvertopstraat 5333,2023-07-14,18:00:00,279,192,87,FMN 03 Kolonel Silvertopstraat
651,Kolonel Silvertopstraat 5333,2023-07-14,19:00:00,238,168,70,FMN 03 Kolonel Silvertopstraat
651,Kolonel Silvertopstraat 5333,2023-07-14,20:00:00,165,95,70,FMN 03 Kolonel Silvertopstraat
651,Kolonel Silvertopstraat 5333,2023-07-14,21:00:00,184,128,56,FMN 03 Kolonel Silvertopstraat
651,Kolonel Silvertopstraat 5333,2023-07-14,22:00:00,159,92,67,FMN 03 Kolonel Silvertopstraat
651,Kolonel Silvertopstraat 5333,2023-07-14,23:00:00,156,82,74,FMN 03 Kolonel Silvertopstraat
651,Kolonel Silvertopstraat 5333,2023-07-15,00:00:00,96,50,46,FMN 03 Kolonel Silvertopstraat
651,Kolonel Silvertopstraat 5333,2023-07-15,01:00:00,43,14,29,FMN 03 Kolonel Silvertopstraat
651,Kolonel Silvertopstraat 5333,2023-07-15,02:00:00,41,19,22,FMN 03 Kolonel Silvertopstraat
651,Kolonel Silvertopstraat 5333,2023-07-15,03:00:00,49,22,27,FMN 03 Kolonel Silvertopstraat
651,Kolonel Silvertopstraat 5333,2023-07-15,04:00:00,29,11,18,FMN 03 Kolonel Silvertopstraat
651,Kolonel Silvertopstraat 5333,2023-07-15,05:00:00,30,17,13,FMN 03 Kolonel Silvertopstraat
651,Kolonel Silvertopstraat 5333,2023-07-15,06:00:00,38,25,13,FMN 03 Kolonel Silvertopstraat
651,Kolonel Silvertopstraat 5333,2023-07-15,07:00:00,50,35,15,FMN 03 Kolonel Silvertopstraat
651,Kolonel Silvertopstraat 5333,2023-07-15,08:00:00,69,54,15,FMN 03 Kolonel Silvertopstraat
651,Kolonel Silvertopstraat 5333,2023-07-15,09:00:00,133,109,24,FMN 03 Kolonel Silvertopstraat
651,Kolonel Silvertopstraat 5333,2023-07-15,10:00:00,198,144,54,FMN 03 Kolonel Silvertopstraat
651,Kolonel Silvertopstraat 5333,2023-07-15,11:00:00,164,119,45,FMN 03 Kolonel Silvertopstraat
651,Kolonel Silvertopstraat 5333,2023-07-15,12:00:00,175,108,67,FMN 03 Kolonel Silvertopstraat
651,Kolonel Silvertopstraat 5333,2023-07-15,13:00:00,183,130,53,FMN 03 Kolonel Silvertopstraat
651,Kolonel Silvertopstraat 5333,2023-07-15,14:00:00,180,135,45,FMN 03 Kolonel Silvertopstraat
651,Kolonel Silvertopstraat 5333,2023-07-15,15:00:00,198,137,61,FMN 03 Kolonel Silvertopstraat
651,Kolonel Silvertopstraat 5333,2023-07-15,16:00:00,188,126,62,FMN 03 Kolonel Silvertopstraat
651,Kolonel Silvertopstraat 5333,2023-07-15,17:00:00,185,137,48,FMN 03 Kolonel Silvertopstraat
651,Kolonel Silvertopstraat 5333,2023-07-15,18:00:00,213,130,83,FMN 03 Kolonel Silvertopstraat
651,Kolonel Silvertopstraat 5333,2023-07-15,19:00:00,192,135,57,FMN 03 Kolonel Silvertopstraat
651,Kolonel Silvertopstraat 5333,2023-07-15,20:00:00,146,100,46,FMN 03 Kolonel Silvertopstraat
651,Kolonel Silvertopstraat 5333,2023-07-15,21:00:00,128,92,36,FMN 03 Kolonel Silvertopstraat
651,Kolonel Silvertopstraat 5333,2023-07-15,22:00:00,140,78,62,FMN 03 Kolonel Silvertopstraat
651,Kolonel Silvertopstraat 5333,2023-07-15,23:00:00,110,48,62,FMN 03 Kolonel Silvertopstraat
651,Kolonel Silvertopstraat 5333,2023-07-16,00:00:00,75,31,44,FMN 03 Kolonel Silvertopstraat
651,Kolonel Silvertopstraat 5333,2023-07-16,01:00:00,41,23,18,FMN 03 Kolonel Silvertopstraat
651,Kolonel Silvertopstraat 5333,2023-07-16,02:00:00,38,17,21,FMN 03 Kolonel Silvertopstraat
651,Kolonel Silvertopstraat 5333,2023-07-16,03:00:00,32,11,21,FMN 03 Kolonel Silvertopstraat
651,Kolonel Silvertopstraat 5333,2023-07-16,04:00:00,19,9,10,FMN 03 Kolonel Silvertopstraat
651,Kolonel Silvertopstraat 5333,2023-07-16,05:00:00,29,19,10,FMN 03 Kolonel Silvertopstraat
651,Kolonel Silvertopstraat 5333,2023-07-16,06:00:00,39,30,9,FMN 03 Kolonel Silvertopstraat
651,Kolonel Silvertopstraat 5333,2023-07-16,07:00:00,27,21,6,FMN 03 Kolonel Silvertopstraat
651,Kolonel Silvertopstraat 5333,2023-07-16,08:00:00,40,26,14,FMN 03 Kolonel Silvertopstraat
651,Kolonel Silvertopstraat 5333,2023-07-16,09:00:00,88,73,15,FMN 03 Kolonel Silvertopstraat
651,Kolonel Silvertopstraat 5333,2023-07-16,10:00:00,109,87,22,FMN 03 Kolonel Silvertopstraat
651,Kolonel Silvertopstraat 5333,2023-07-16,11:00:00,139,100,39,FMN 03 Kolonel Silvertopstraat
651,Kolonel Silvertopstraat 5333,2023-07-16,12:00:00,110,72,38,FMN 03 Kolonel Silvertopstraat
651,Kolonel Silvertopstraat 5333,2023-07-16,13:00:00,150,100,50,FMN 03 Kolonel Silvertopstraat
651,Kolonel Silvertopstraat 5333,2023-07-16,14:00:00,174,119,55,FMN 03 Kolonel Silvertopstraat
651,Kolonel Silvertopstraat 5333,2023-07-16,15:00:00,129,94,35,FMN 03 Kolonel Silvertopstraat
651,Kolonel Silvertopstraat 5333,2023-07-16,16:00:00,144,104,40,FMN 03 Kolonel Silvertopstraat
651,Kolonel Silvertopstraat 5333,2023-07-16,17:00:00,146,97,49,FMN 03 Kolonel Silvertopstraat
651,Kolonel Silvertopstraat 5333,2023-07-16,18:00:00,167,107,60,FMN 03 Kolonel Silvertopstraat
651,Kolonel Silvertopstraat 5333,2023-07-16,19:00:00,140,90,50,FMN 03 Kolonel Silvertopstraat
651,Kolonel Silvertopstraat 5333,2023-07-16,20:00:00,124,76,48,FMN 03 Kolonel Silvertopstraat
651,Kolonel Silvertopstraat 5333,2023-07-16,21:00:00,86,52,34,FMN 03 Kolonel Silvertopstraat
651,Kolonel Silvertopstraat 5333,2023-07-16,22:00:00,105,62,43,FMN 03 Kolonel Silvertopstraat
651,Kolonel Silvertopstraat 5333,2023-07-16,23:00:00,67,33,34,FMN 03 Kolonel Silvertopstraat
651,Kolonel Silvertopstraat 5333,2023-07-17,00:00:00,34,17,17,FMN 03 Kolonel Silvertopstraat
651,Kolonel Silvertopstraat 5333,2023-07-17,01:00:00,30,8,22,FMN 03 Kolonel Silvertopstraat
651,Kolonel Silvertopstraat 5333,2023-07-17,02:00:00,15,7,8,FMN 03 Kolonel Silvertopstraat
651,Kolonel Silvertopstraat 5333,2023-07-17,03:00:00,16,12,4,FMN 03 Kolonel Silvertopstraat
651,Kolonel Silvertopstraat 5333,2023-07-17,04:00:00,16,11,5,FMN 03 Kolonel Silvertopstraat
651,Kolonel Silvertopstraat 5333,2023-07-17,05:00:00,51,32,19,FMN 03 Kolonel Silvertopstraat
651,Kolonel Silvertopstraat 5333,2023-07-17,06:00:00,118,90,28,FMN 03 Kolonel Silvertopstraat
651,Kolonel Silvertopstraat 5333,2023-07-17,07:00:00,197,148,49,FMN 03 Kolonel Silvertopstraat
651,Kolonel Silvertopstraat 5333,2023-07-17,08:00:00,263,213,50,FMN 03 Kolonel Silvertopstraat
651,Kolonel Silvertopstraat 5333,2023-07-17,09:00:00,196,151,45,FMN 03 Kolonel Silvertopstraat
651,Kolonel Silvertopstraat 5333,2023-07-17,10:00:00,130,103,27,FMN 03 Kolonel Silvertopstraat
651,Kolonel Silvertopstraat 5333,2023-07-17,11:00:00,126,92,34,FMN 03 Kolonel Silvertopstraat
651,Kolonel Silvertopstraat 5333,2023-07-17,12:00:00,152,113,39,FMN 03 Kolonel Silvertopstraat
651,Kolonel Silvertopstraat 5333,2023-07-17,13:00:00,149,95,54,FMN 03 Kolonel Silvertopstraat
651,Kolonel Silvertopstraat 5333,2023-07-17,14:00:00,160,109,51,FMN 03 Kolonel Silvertopstraat
651,Kolonel Silvertopstraat 5333,2023-07-17,15:00:00,188,120,68,FMN 03 Kolonel Silvertopstraat
651,Kolonel Silvertopstraat 5333,2023-07-17,16:00:00,242,174,68,FMN 03 Kolonel Silvertopstraat
651,Kolonel Silvertopstraat 5333,2023-07-17,17:00:00,305,191,114,FMN 03 Kolonel Silvertopstraat
651,Kolonel Silvertopstraat 5333,2023-07-17,18:00:00,250,165,85,FMN 03 Kolonel Silvertopstraat
651,Kolonel Silvertopstraat 5333,2023-07-17,19:00:00,180,111,69,FMN 03 Kolonel Silvertopstraat
651,Kolonel Silvertopstraat 5333,2023-07-17,20:00:00,157,102,55,FMN 03 Kolonel Silvertopstraat
651,Kolonel Silvertopstraat 5333,2023-07-17,21:00:00,135,87,48,FMN 03 Kolonel Silvertopstraat
651,Kolonel Silvertopstraat 5333,2023-07-17,22:00:00,130,73,57,FMN 03 Kolonel Silvertopstraat
651,Kolonel Silvertopstraat 5333,2023-07-17,23:00:00,77,24,53,FMN 03 Kolonel Silvertopstraat
651,Kolonel Silvertopstraat 5333,2023-07-18,00:00:00,47,25,22,FMN 03 Kolonel Silvertopstraat
651,Kolonel Silvertopstraat 5333,2023-07-18,01:00:00,16,10,6,FMN 03 Kolonel Silvertopstraat
651,Kolonel Silvertopstraat 5333,2023-07-18,02:00:00,17,6,11,FMN 03 Kolonel Silvertopstraat
651,Kolonel Silvertopstraat 5333,2023-07-18,03:00:00,14,7,7,FMN 03 Kolonel Silvertopstraat
651,Kolonel Silvertopstraat 5333,2023-07-18,04:00:00,24,18,6,FMN 03 Kolonel Silvertopstraat
651,Kolonel Silvertopstraat 5333,2023-07-18,05:00:00,56,39,17,FMN 03 Kolonel Silvertopstraat
651,Kolonel Silvertopstraat 5333,2023-07-18,06:00:00,129,108,21,FMN 03 Kolonel Silvertopstraat
651,Kolonel Silvertopstraat 5333,2023-07-18,07:00:00,233,176,57,FMN 03 Kolonel Silvertopstraat
651,Kolonel Silvertopstraat 5333,2023-07-18,08:00:00,285,236,49,FMN 03 Kolonel Silvertopstraat
651,Kolonel Silvertopstraat 5333,2023-07-18,09:00:00,204,149,55,FMN 03 Kolonel Silvertopstraat
651,Kolonel Silvertopstraat 5333,2023-07-18,10:00:00,147,115,32,FMN 03 Kolonel Silvertopstraat
651,Kolonel Silvertopstraat 5333,2023-07-18,11:00:00,134,92,42,FMN 03 Kolonel Silvertopstraat
651,Kolonel Silvertopstraat 5333,2023-07-18,12:00:00,162,118,44,FMN 03 Kolonel Silvertopstraat
651,Kolonel Silvertopstraat 5333,2023-07-18,13:00:00,195,140,55,FMN 03 Kolonel Silvertopstraat
651,Kolonel Silvertopstraat 5333,2023-07-18,14:00:00,182,126,56,FMN 03 Kolonel Silvertopstraat
651,Kolonel Silvertopstraat 5333,2023-07-18,15:00:00,3,2,1,FMN 03 Kolonel Silvertopstraat
651,Kolonel Silvertopstraat 5333,2023-07-18,16:00:00,13,12,1,FMN 03 Kolonel Silvertopstraat
651,Kolonel Silvertopstraat 5333,2023-07-18,17:00:00,332,208,124,FMN 03 Kolonel Silvertopstraat
651,Kolonel Silvertopstraat 5333,2023-07-18,18:00:00,232,162,70,FMN 03 Kolonel Silvertopstraat
651,Kolonel Silvertopstraat 5333,2023-07-18,19:00:00,188,117,71,FMN 03 Kolonel Silvertopstraat
651,Kolonel Silvertopstraat 5333,2023-07-18,20:00:00,193,114,79,FMN 03 Kolonel Silvertopstraat
651,Kolonel Silvertopstraat 5333,2023-07-18,21:00:00,153,93,60,FMN 03 Kolonel Silvertopstraat
651,Kolonel Silvertopstraat 5333,2023-07-18,22:00:00,166,105,61,FMN 03 Kolonel Silvertopstraat
651,Kolonel Silvertopstraat 5333,2023-07-18,23:00:00,94,44,50,FMN 03 Kolonel Silvertopstraat
651,Kolonel Silvertopstraat 5333,2023-07-19,00:00:00,53,24,29,FMN 03 Kolonel Silvertopstraat
651,Kolonel Silvertopstraat 5333,2023-07-19,01:00:00,36,19,17,FMN 03 Kolonel Silvertopstraat
651,Kolonel Silvertopstraat 5333,2023-07-19,02:00:00,15,5,10,FMN 03 Kolonel Silvertopstraat
651,Kolonel Silvertopstraat 5333,2023-07-19,03:00:00,12,5,7,FMN 03 Kolonel Silvertopstraat
651,Kolonel Silvertopstraat 5333,2023-07-19,04:00:00,28,22,6,FMN 03 Kolonel Silvertopstraat
651,Kolonel Silvertopstraat 5333,2023-07-19,05:00:00,59,38,21,FMN 03 Kolonel Silvertopstraat
651,Kolonel Silvertopstraat 5333,2023-07-19,06:00:00,111,94,17,FMN 03 Kolonel Silvertopstraat
651,Kolonel Silvertopstraat 5333,2023-07-19,07:00:00,201,145,56,FMN 03 Kolonel Silvertopstraat
651,Kolonel Silvertopstraat 5333,2023-07-19,08:00:00,272,214,58,FMN 03 Kolonel Silvertopstraat
651,Kolonel Silvertopstraat 5333,2023-07-19,09:00:00,173,138,35,FMN 03 Kolonel Silvertopstraat
651,Kolonel Silvertopstraat 5333,2023-07-19,10:00:00,159,123,36,FMN 03 Kolonel Silvertopstraat
651,Kolonel Silvertopstraat 5333,2023-07-19,11:00:00,151,101,50,FMN 03 Kolonel Silvertopstraat
651,Kolonel Silvertopstraat 5333,2023-07-19,12:00:00,142,101,41,FMN 03 Kolonel Silvertopstraat
651,Kolonel Silvertopstraat 5333,2023-07-19,13:00:00,186,113,73,FMN 03 Kolonel Silvertopstraat
651,Kolonel Silvertopstraat 5333,2023-07-19,14:00:00,221,153,68,FMN 03 Kolonel Silvertopstraat
651,Kolonel Silvertopstraat 5333,2023-07-19,15:00:00,213,141,72,FMN 03 Kolonel Silvertopstraat
651,Kolonel Silvertopstraat 5333,2023-07-19,16:00:00,259,184,75,FMN 03 Kolonel Silvertopstraat
651,Kolonel Silvertopstraat 5333,2023-07-19,17:00:00,333,213,120,FMN 03 Kolonel Silvertopstraat
651,Kolonel Silvertopstraat 5333,2023-07-19,18:00:00,217,150,67,FMN 03 Kolonel Silvertopstraat
651,Kolonel Silvertopstraat 5333,2023-07-19,19:00:00,192,124,68,FMN 03 Kolonel Silvertopstraat
651,Kolonel Silvertopstraat 5333,2023-07-19,20:00:00,155,107,48,FMN 03 Kolonel Silvertopstraat
651,Kolonel Silvertopstraat 5333,2023-07-19,21:00:00,154,98,56,FMN 03 Kolonel Silvertopstraat
651,Kolonel Silvertopstraat 5333,2023-07-19,22:00:00,142,78,64,FMN 03 Kolonel Silvertopstraat
651,Kolonel Silvertopstraat 5333,2023-07-19,23:00:00,86,41,45,FMN 03 Kolonel Silvertopstraat
651,Kolonel Silvertopstraat 5333,2023-07-20,00:00:00,46,26,20,FMN 03 Kolonel Silvertopstraat
651,Kolonel Silvertopstraat 5333,2023-07-20,01:00:00,20,9,11,FMN 03 Kolonel Silvertopstraat
651,Kolonel Silvertopstraat 5333,2023-07-20,02:00:00,18,8,10,FMN 03 Kolonel Silvertopstraat
651,Kolonel Silvertopstraat 5333,2023-07-20,03:00:00,15,8,7,FMN 03 Kolonel Silvertopstraat
651,Kolonel Silvertopstraat 5333,2023-07-20,04:00:00,30,23,7,FMN 03 Kolonel Silvertopstraat
651,Kolonel Silvertopstraat 5333,2023-07-20,05:00:00,56,35,21,FMN 03 Kolonel Silvertopstraat
651,Kolonel Silvertopstraat 5333,2023-07-20,06:00:00,112,91,21,FMN 03 Kolonel Silvertopstraat
651,Kolonel Silvertopstraat 5333,2023-07-20,07:00:00,180,142,38,FMN 03 Kolonel Silvertopstraat
651,Kolonel Silvertopstraat 5333,2023-07-20,08:00:00,242,195,47,FMN 03 Kolonel Silvertopstraat
651,Kolonel Silvertopstraat 5333,2023-07-20,09:00:00,188,141,47,FMN 03 Kolonel Silvertopstraat
651,Kolonel Silvertopstraat 5333,2023-07-20,10:00:00,138,106,32,FMN 03 Kolonel Silvertopstraat
651,Kolonel Silvertopstraat 5333,2023-07-20,11:00:00,162,118,44,FMN 03 Kolonel Silvertopstraat
651,Kolonel Silvertopstraat 5333,2023-07-20,12:00:00,178,132,46,FMN 03 Kolonel Silvertopstraat
651,Kolonel Silvertopstraat 5333,2023-07-20,13:00:00,184,120,64,FMN 03 Kolonel Silvertopstraat
651,Kolonel Silvertopstraat 5333,2023-07-20,14:00:00,195,127,68,FMN 03 Kolonel Silvertopstraat
651,Kolonel Silvertopstraat 5333,2023-07-20,15:00:00,222,154,68,FMN 03 Kolonel Silvertopstraat
651,Kolonel Silvertopstraat 5333,2023-07-20,16:00:00,270,176,94,FMN 03 Kolonel Silvertopstraat
651,Kolonel Silvertopstraat 5333,2023-07-20,17:00:00,333,218,115,FMN 03 Kolonel Silvertopstraat
651,Kolonel Silvertopstraat 5333,2023-07-20,18:00:00,209,137,72,FMN 03 Kolonel Silvertopstraat
651,Kolonel Silvertopstraat 5333,2023-07-20,19:00:00,214,138,76,FMN 03 Kolonel Silvertopstraat
651,Kolonel Silvertopstraat 5333,2023-07-20,20:00:00,155,102,53,FMN 03 Kolonel Silvertopstraat
651,Kolonel Silvertopstraat 5333,2023-07-20,21:00:00,128,83,45,FMN 03 Kolonel Silvertopstraat
651,Kolonel Silvertopstraat 5333,2023-07-20,22:00:00,118,68,50,FMN 03 Kolonel Silvertopstraat
651,Kolonel Silvertopstraat 5333,2023-07-20,23:00:00,91,44,47,FMN 03 Kolonel Silvertopstraat
651,Kolonel Silvertopstraat 5333,2023-07-21,00:00:00,52,25,27,FMN 03 Kolonel Silvertopstraat
651,Kolonel Silvertopstraat 5333,2023-07-21,01:00:00,40,16,24,FMN 03 Kolonel Silvertopstraat
651,Kolonel Silvertopstraat 5333,2023-07-21,02:00:00,25,13,12,FMN 03 Kolonel Silvertopstraat
651,Kolonel Silvertopstraat 5333,2023-07-21,03:00:00,21,7,14,FMN 03 Kolonel Silvertopstraat
651,Kolonel Silvertopstraat 5333,2023-07-21,04:00:00,17,6,11,FMN 03 Kolonel Silvertopstraat
651,Kolonel Silvertopstraat 5333,2023-07-21,05:00:00,36,19,17,FMN 03 Kolonel Silvertopstraat
651,Kolonel Silvertopstraat 5333,2023-07-21,06:00:00,40,31,9,FMN 03 Kolonel Silvertopstraat
651,Kolonel Silvertopstraat 5333,2023-07-21,07:00:00,32,24,8,FMN 03 Kolonel Silvertopstraat
651,Kolonel Silvertopstraat 5333,2023-07-21,08:00:00,53,36,17,FMN 03 Kolonel Silvertopstraat
651,Kolonel Silvertopstraat 5333,2023-07-21,09:00:00,88,70,18,FMN 03 Kolonel Silvertopstraat
651,Kolonel Silvertopstraat 5333,2023-07-21,10:00:00,155,119,36,FMN 03 Kolonel Silvertopstraat
651,Kolonel Silvertopstraat 5333,2023-07-21,11:00:00,120,89,31,FMN 03 Kolonel Silvertopstraat
651,Kolonel Silvertopstraat 5333,2023-07-21,12:00:00,78,51,27,FMN 03 Kolonel Silvertopstraat
651,Kolonel Silvertopstraat 5333,2023-07-21,13:00:00,112,77,35,FMN 03 Kolonel Silvertopstraat
651,Kolonel Silvertopstraat 5333,2023-07-21,14:00:00,110,83,27,FMN 03 Kolonel Silvertopstraat
651,Kolonel Silvertopstraat 5333,2023-07-21,15:00:00,137,91,46,FMN 03 Kolonel Silvertopstraat
651,Kolonel Silvertopstraat 5333,2023-07-21,16:00:00,104,71,33,FMN 03 Kolonel Silvertopstraat
651,Kolonel Silvertopstraat 5333,2023-07-21,17:00:00,155,111,44,FMN 03 Kolonel Silvertopstraat
651,Kolonel Silvertopstraat 5333,2023-07-21,18:00:00,143,96,47,FMN 03 Kolonel Silvertopstraat
651,Kolonel Silvertopstraat 5333,2023-07-21,19:00:00,197,124,73,FMN 03 Kolonel Silvertopstraat
651,Kolonel Silvertopstraat 5333,2023-07-21,20:00:00,157,103,54,FMN 03 Kolonel Silvertopstraat
651,Kolonel Silvertopstraat 5333,2023-07-21,21:00:00,145,91,54,FMN 03 Kolonel Silvertopstraat
651,Kolonel Silvertopstraat 5333,2023-07-21,22:00:00,139,65,74,FMN 03 Kolonel Silvertopstraat
651,Kolonel Silvertopstraat 5333,2023-07-21,23:00:00,94,49,45,FMN 03 Kolonel Silvertopstraat
651,Kolonel Silvertopstraat 5333,2023-07-22,00:00:00,83,45,38,FMN 03 Kolonel Silvertopstraat
651,Kolonel Silvertopstraat 5333,2023-07-22,01:00:00,37,17,20,FMN 03 Kolonel Silvertopstraat
651,Kolonel Silvertopstraat 5333,2023-07-22,02:00:00,35,13,22,FMN 03 Kolonel Silvertopstraat
651,Kolonel Silvertopstraat 5333,2023-07-22,03:00:00,19,7,12,FMN 03 Kolonel Silvertopstraat
651,Kolonel Silvertopstraat 5333,2023-07-22,04:00:00,20,11,9,FMN 03 Kolonel Silvertopstraat
651,Kolonel Silvertopstraat 5333,2023-07-22,05:00:00,24,12,12,FMN 03 Kolonel Silvertopstraat
651,Kolonel Silvertopstraat 5333,2023-07-22,06:00:00,31,26,5,FMN 03 Kolonel Silvertopstraat
651,Kolonel Silvertopstraat 5333,2023-07-22,07:00:00,36,25,11,FMN 03 Kolonel Silvertopstraat
651,Kolonel Silvertopstraat 5333,2023-07-22,08:00:00,63,47,16,FMN 03 Kolonel Silvertopstraat
651,Kolonel Silvertopstraat 5333,2023-07-22,09:00:00,115,97,18,FMN 03 Kolonel Silvertopstraat
651,Kolonel Silvertopstraat 5333,2023-07-22,10:00:00,143,108,35,FMN 03 Kolonel Silvertopstraat
651,Kolonel Silvertopstraat 5333,2023-07-22,11:00:00,145,107,38,FMN 03 Kolonel Silvertopstraat
651,Kolonel Silvertopstraat 5333,2023-07-22,12:00:00,178,136,42,FMN 03 Kolonel Silvertopstraat
651,Kolonel Silvertopstraat 5333,2023-07-22,13:00:00,186,132,54,FMN 03 Kolonel Silvertopstraat
651,Kolonel Silvertopstraat 5333,2023-07-22,14:00:00,203,140,63,FMN 03 Kolonel Silvertopstraat
651,Kolonel Silvertopstraat 5333,2023-07-22,15:00:00,190,132,58,FMN 03 Kolonel Silvertopstraat
651,Kolonel Silvertopstraat 5333,2023-07-22,16:00:00,180,121,59,FMN 03 Kolonel Silvertopstraat
651,Kolonel Silvertopstraat 5333,2023-07-22,17:00:00,177,119,58,FMN 03 Kolonel Silvertopstraat
651,Kolonel Silvertopstraat 5333,2023-07-22,18:00:00,165,102,63,FMN 03 Kolonel Silvertopstraat
651,Kolonel Silvertopstraat 5333,2023-07-22,19:00:00,170,115,55,FMN 03 Kolonel Silvertopstraat
651,Kolonel Silvertopstraat 5333,2023-07-22,20:00:00,145,90,55,FMN 03 Kolonel Silvertopstraat
651,Kolonel Silvertopstraat 5333,2023-07-22,21:00:00,122,70,52,FMN 03 Kolonel Silvertopstraat
651,Kolonel Silvertopstraat 5333,2023-07-22,22:00:00,97,48,49,FMN 03 Kolonel Silvertopstraat
651,Kolonel Silvertopstraat 5333,2023-07-22,23:00:00,74,39,35,FMN 03 Kolonel Silvertopstraat
651,Kolonel Silvertopstraat 5333,2023-07-23,00:00:00,57,26,31,FMN 03 Kolonel Silvertopstraat
651,Kolonel Silvertopstraat 5333,2023-07-23,01:00:00,27,16,11,FMN 03 Kolonel Silvertopstraat
651,Kolonel Silvertopstraat 5333,2023-07-23,02:00:00,32,17,15,FMN 03 Kolonel Silvertopstraat
651,Kolonel Silvertopstraat 5333,2023-07-23,03:00:00,26,8,18,FMN 03 Kolonel Silvertopstraat
651,Kolonel Silvertopstraat 5333,2023-07-23,04:00:00,13,6,7,FMN 03 Kolonel Silvertopstraat
651,Kolonel Silvertopstraat 5333,2023-07-23,05:00:00,23,14,9,FMN 03 Kolonel Silvertopstraat
651,Kolonel Silvertopstraat 5333,2023-07-23,06:00:00,30,18,12,FMN 03 Kolonel Silvertopstraat
651,Kolonel Silvertopstraat 5333,2023-07-23,07:00:00,23,16,7,FMN 03 Kolonel Silvertopstraat
651,Kolonel Silvertopstraat 5333,2023-07-23,08:00:00,36,25,11,FMN 03 Kolonel Silvertopstraat
651,Kolonel Silvertopstraat 5333,2023-07-23,09:00:00,55,32,23,FMN 03 Kolonel Silvertopstraat
651,Kolonel Silvertopstraat 5333,2023-07-23,10:00:00,46,35,11,FMN 03 Kolonel Silvertopstraat
651,Kolonel Silvertopstraat 5333,2023-07-23,11:00:00,63,49,14,FMN 03 Kolonel Silvertopstraat
651,Kolonel Silvertopstraat 5333,2023-07-23,12:00:00,92,59,33,FMN 03 Kolonel Silvertopstraat
651,Kolonel Silvertopstraat 5333,2023-07-23,13:00:00,105,72,33,FMN 03 Kolonel Silvertopstraat
651,Kolonel Silvertopstraat 5333,2023-07-23,14:00:00,120,79,41,FMN 03 Kolonel Silvertopstraat
651,Kolonel Silvertopstraat 5333,2023-07-23,15:00:00,109,65,44,FMN 03 Kolonel Silvertopstraat
651,Kolonel Silvertopstraat 5333,2023-07-23,16:00:00,123,82,41,FMN 03 Kolonel Silvertopstraat
651,Kolonel Silvertopstraat 5333,2023-07-23,17:00:00,120,80,40,FMN 03 Kolonel Silvertopstraat
651,Kolonel Silvertopstraat 5333,2023-07-23,18:00:00,125,79,46,FMN 03 Kolonel Silvertopstraat
651,Kolonel Silvertopstraat 5333,2023-07-23,19:00:00,63,35,28,FMN 03 Kolonel Silvertopstraat
651,Kolonel Silvertopstraat 5333,2023-07-23,20:00:00,78,44,34,FMN 03 Kolonel Silvertopstraat
651,Kolonel Silvertopstraat 5333,2023-07-23,21:00:00,79,40,39,FMN 03 Kolonel Silvertopstraat
651,Kolonel Silvertopstraat 5333,2023-07-23,22:00:00,68,39,29,FMN 03 Kolonel Silvertopstraat
651,Kolonel Silvertopstraat 5333,2023-07-23,23:00:00,40,19,21,FMN 03 Kolonel Silvertopstraat
651,Kolonel Silvertopstraat 5333,2023-07-24,00:00:00,21,12,9,FMN 03 Kolonel Silvertopstraat
651,Kolonel Silvertopstraat 5333,2023-07-24,01:00:00,9,4,5,FMN 03 Kolonel Silvertopstraat
651,Kolonel Silvertopstraat 5333,2023-07-24,02:00:00,10,6,4,FMN 03 Kolonel Silvertopstraat
651,Kolonel Silvertopstraat 5333,2023-07-24,03:00:00,8,7,1,FMN 03 Kolonel Silvertopstraat
651,Kolonel Silvertopstraat 5333,2023-07-24,04:00:00,36,31,5,FMN 03 Kolonel Silvertopstraat
651,Kolonel Silvertopstraat 5333,2023-07-24,05:00:00,30,16,14,FMN 03 Kolonel Silvertopstraat
651,Kolonel Silvertopstraat 5333,2023-07-24,06:00:00,78,69,9,FMN 03 Kolonel Silvertopstraat
651,Kolonel Silvertopstraat 5333,2023-07-24,07:00:00,162,120,42,FMN 03 Kolonel Silvertopstraat
651,Kolonel Silvertopstraat 5333,2023-07-24,08:00:00,190,153,37,FMN 03 Kolonel Silvertopstraat
651,Kolonel Silvertopstraat 5333,2023-07-24,09:00:00,124,92,32,FMN 03 Kolonel Silvertopstraat
651,Kolonel Silvertopstraat 5333,2023-07-24,10:00:00,110,83,27,FMN 03 Kolonel Silvertopstraat
651,Kolonel Silvertopstraat 5333,2023-07-24,11:00:00,110,83,27,FMN 03 Kolonel Silvertopstraat
651,Kolonel Silvertopstraat 5333,2023-07-24,12:00:00,129,88,41,FMN 03 Kolonel Silvertopstraat
651,Kolonel Silvertopstraat 5333,2023-07-24,13:00:00,114,81,33,FMN 03 Kolonel Silvertopstraat
651,Kolonel Silvertopstraat 5333,2023-07-24,14:00:00,144,109,35,FMN 03 Kolonel Silvertopstraat
651,Kolonel Silvertopstraat 5333,2023-07-24,15:00:00,154,105,49,FMN 03 Kolonel Silvertopstraat
651,Kolonel Silvertopstraat 5333,2023-07-24,16:00:00,191,129,62,FMN 03 Kolonel Silvertopstraat
651,Kolonel Silvertopstraat 5333,2023-07-24,17:00:00,192,126,66,FMN 03 Kolonel Silvertopstraat
651,Kolonel Silvertopstraat 5333,2023-07-24,18:00:00,169,119,50,FMN 03 Kolonel Silvertopstraat
651,Kolonel Silvertopstraat 5333,2023-07-24,19:00:00,154,94,60,FMN 03 Kolonel Silvertopstraat
651,Kolonel Silvertopstraat 5333,2023-07-24,20:00:00,125,85,40,FMN 03 Kolonel Silvertopstraat
651,Kolonel Silvertopstraat 5333,2023-07-24,21:00:00,105,61,44,FMN 03 Kolonel Silvertopstraat
651,Kolonel Silvertopstraat 5333,2023-07-24,22:00:00,77,54,23,FMN 03 Kolonel Silvertopstraat
651,Kolonel Silvertopstraat 5333,2023-07-24,23:00:00,62,29,33,FMN 03 Kolonel Silvertopstraat
651,Kolonel Silvertopstraat 5333,2023-07-25,00:00:00,30,19,11,FMN 03 Kolonel Silvertopstraat
651,Kolonel Silvertopstraat 5333,2023-07-25,01:00:00,19,8,11,FMN 03 Kolonel Silvertopstraat
651,Kolonel Silvertopstraat 5333,2023-07-25,02:00:00,13,6,7,FMN 03 Kolonel Silvertopstraat
651,Kolonel Silvertopstraat 5333,2023-07-25,03:00:00,12,7,5,FMN 03 Kolonel Silvertopstraat
651,Kolonel Silvertopstraat 5333,2023-07-25,04:00:00,28,23,5,FMN 03 Kolonel Silvertopstraat
651,Kolonel Silvertopstraat 5333,2023-07-25,05:00:00,44,28,16,FMN 03 Kolonel Silvertopstraat
651,Kolonel Silvertopstraat 5333,2023-07-25,06:00:00,106,90,16,FMN 03 Kolonel Silvertopstraat
651,Kolonel Silvertopstraat 5333,2023-07-25,07:00:00,164,122,42,FMN 03 Kolonel Silvertopstraat
651,Kolonel Silvertopstraat 5333,2023-07-25,08:00:00,203,157,46,FMN 03 Kolonel Silvertopstraat
651,Kolonel Silvertopstraat 5333,2023-07-25,09:00:00,156,125,31,FMN 03 Kolonel Silvertopstraat
651,Kolonel Silvertopstraat 5333,2023-07-25,10:00:00,132,109,23,FMN 03 Kolonel Silvertopstraat
651,Kolonel Silvertopstraat 5333,2023-07-25,11:00:00,116,82,34,FMN 03 Kolonel Silvertopstraat
651,Kolonel Silvertopstraat 5333,2023-07-25,12:00:00,149,108,41,FMN 03 Kolonel Silvertopstraat
651,Kolonel Silvertopstraat 5333,2023-07-25,13:00:00,152,98,54,FMN 03 Kolonel Silvertopstraat
651,Kolonel Silvertopstraat 5333,2023-07-25,14:00:00,172,132,40,FMN 03 Kolonel Silvertopstraat
651,Kolonel Silvertopstraat 5333,2023-07-25,15:00:00,184,115,69,FMN 03 Kolonel Silvertopstraat
651,Kolonel Silvertopstraat 5333,2023-07-25,16:00:00,261,186,75,FMN 03 Kolonel Silvertopstraat
651,Kolonel Silvertopstraat 5333,2023-07-25,17:00:00,251,157,94,FMN 03 Kolonel Silvertopstraat
651,Kolonel Silvertopstraat 5333,2023-07-25,18:00:00,245,167,78,FMN 03 Kolonel Silvertopstraat
651,Kolonel Silvertopstraat 5333,2023-07-25,19:00:00,207,136,71,FMN 03 Kolonel Silvertopstraat
651,Kolonel Silvertopstraat 5333,2023-07-25,20:00:00,168,111,57,FMN 03 Kolonel Silvertopstraat
651,Kolonel Silvertopstraat 5333,2023-07-25,21:00:00,111,74,37,FMN 03 Kolonel Silvertopstraat
651,Kolonel Silvertopstraat 5333,2023-07-25,22:00:00,126,73,53,FMN 03 Kolonel Silvertopstraat
651,Kolonel Silvertopstraat 5333,2023-07-25,23:00:00,81,30,51,FMN 03 Kolonel Silvertopstraat
651,Kolonel Silvertopstraat 5333,2023-07-26,00:00:00,48,26,22,FMN 03 Kolonel Silvertopstraat
651,Kolonel Silvertopstraat 5333,2023-07-26,01:00:00,30,14,16,FMN 03 Kolonel Silvertopstraat
651,Kolonel Silvertopstraat 5333,2023-07-26,02:00:00,16,3,13,FMN 03 Kolonel Silvertopstraat
651,Kolonel Silvertopstraat 5333,2023-07-26,03:00:00,13,7,6,FMN 03 Kolonel Silvertopstraat
651,Kolonel Silvertopstraat 5333,2023-07-26,04:00:00,36,25,11,FMN 03 Kolonel Silvertopstraat
651,Kolonel Silvertopstraat 5333,2023-07-26,05:00:00,46,22,24,FMN 03 Kolonel Silvertopstraat
651,Kolonel Silvertopstraat 5333,2023-07-26,06:00:00,103,94,9,FMN 03 Kolonel Silvertopstraat
651,Kolonel Silvertopstraat 5333,2023-07-26,07:00:00,177,133,44,FMN 03 Kolonel Silvertopstraat
651,Kolonel Silvertopstraat 5333,2023-07-26,08:00:00,234,193,41,FMN 03 Kolonel Silvertopstraat
651,Kolonel Silvertopstraat 5333,2023-07-26,09:00:00,195,150,45,FMN 03 Kolonel Silvertopstraat
651,Kolonel Silvertopstraat 5333,2023-07-26,10:00:00,123,92,31,FMN 03 Kolonel Silvertopstraat
651,Kolonel Silvertopstraat 5333,2023-07-26,11:00:00,137,104,33,FMN 03 Kolonel Silvertopstraat
651,Kolonel Silvertopstraat 5333,2023-07-26,12:00:00,132,91,41,FMN 03 Kolonel Silvertopstraat
651,Kolonel Silvertopstraat 5333,2023-07-26,13:00:00,165,114,51,FMN 03 Kolonel Silvertopstraat
651,Kolonel Silvertopstraat 5333,2023-07-26,14:00:00,227,159,68,FMN 03 Kolonel Silvertopstraat
651,Kolonel Silvertopstraat 5333,2023-07-26,15:00:00,193,135,58,FMN 03 Kolonel Silvertopstraat
651,Kolonel Silvertopstraat 5333,2023-07-26,16:00:00,247,175,72,FMN 03 Kolonel Silvertopstraat
651,Kolonel Silvertopstraat 5333,2023-07-26,17:00:00,299,191,108,FMN 03 Kolonel Silvertopstraat
651,Kolonel Silvertopstraat 5333,2023-07-26,18:00:00,294,202,92,FMN 03 Kolonel Silvertopstraat
651,Kolonel Silvertopstraat 5333,2023-07-26,19:00:00,177,120,57,FMN 03 Kolonel Silvertopstraat
651,Kolonel Silvertopstraat 5333,2023-07-26,20:00:00,161,106,55,FMN 03 Kolonel Silvertopstraat
651,Kolonel Silvertopstraat 5333,2023-07-26,21:00:00,132,78,54,FMN 03 Kolonel Silvertopstraat
651,Kolonel Silvertopstraat 5333,2023-07-26,22:00:00,113,62,51,FMN 03 Kolonel Silvertopstraat
651,Kolonel Silvertopstraat 5333,2023-07-26,23:00:00,86,42,44,FMN 03 Kolonel Silvertopstraat
651,Kolonel Silvertopstraat 5333,2023-07-27,00:00:00,49,22,27,FMN 03 Kolonel Silvertopstraat
651,Kolonel Silvertopstraat 5333,2023-07-27,01:00:00,13,7,6,FMN 03 Kolonel Silvertopstraat
651,Kolonel Silvertopstraat 5333,2023-07-27,02:00:00,13,9,4,FMN 03 Kolonel Silvertopstraat
651,Kolonel Silvertopstraat 5333,2023-07-27,03:00:00,13,8,5,FMN 03 Kolonel Silvertopstraat
651,Kolonel Silvertopstraat 5333,2023-07-27,04:00:00,28,24,4,FMN 03 Kolonel Silvertopstraat
651,Kolonel Silvertopstraat 5333,2023-07-27,05:00:00,28,10,18,FMN 03 Kolonel Silvertopstraat
651,Kolonel Silvertopstraat 5333,2023-07-27,06:00:00,63,55,8,FMN 03 Kolonel Silvertopstraat
651,Kolonel Silvertopstraat 5333,2023-07-27,07:00:00,113,88,25,FMN 03 Kolonel Silvertopstraat
651,Kolonel Silvertopstraat 5333,2023-07-27,08:00:00,180,139,41,FMN 03 Kolonel Silvertopstraat
651,Kolonel Silvertopstraat 5333,2023-07-27,09:00:00,127,95,32,FMN 03 Kolonel Silvertopstraat
651,Kolonel Silvertopstraat 5333,2023-07-27,10:00:00,91,69,22,FMN 03 Kolonel Silvertopstraat
651,Kolonel Silvertopstraat 5333,2023-07-27,11:00:00,93,71,22,FMN 03 Kolonel Silvertopstraat
651,Kolonel Silvertopstraat 5333,2023-07-27,12:00:00,107,71,36,FMN 03 Kolonel Silvertopstraat
651,Kolonel Silvertopstraat 5333,2023-07-27,13:00:00,114,82,32,FMN 03 Kolonel Silvertopstraat
651,Kolonel Silvertopstraat 5333,2023-07-27,14:00:00,134,87,47,FMN 03 Kolonel Silvertopstraat
651,Kolonel Silvertopstraat 5333,2023-07-27,15:00:00,138,82,56,FMN 03 Kolonel Silvertopstraat
651,Kolonel Silvertopstraat 5333,2023-07-27,16:00:00,172,116,56,FMN 03 Kolonel Silvertopstraat
651,Kolonel Silvertopstraat 5333,2023-07-27,17:00:00,188,130,58,FMN 03 Kolonel Silvertopstraat
651,Kolonel Silvertopstraat 5333,2023-07-27,18:00:00,202,132,70,FMN 03 Kolonel Silvertopstraat
651,Kolonel Silvertopstraat 5333,2023-07-27,19:00:00,142,97,45,FMN 03 Kolonel Silvertopstraat
651,Kolonel Silvertopstraat 5333,2023-07-27,20:00:00,130,76,54,FMN 03 Kolonel Silvertopstraat
651,Kolonel Silvertopstraat 5333,2023-07-27,21:00:00,81,48,33,FMN 03 Kolonel Silvertopstraat
651,Kolonel Silvertopstraat 5333,2023-07-27,22:00:00,82,50,32,FMN 03 Kolonel Silvertopstraat
651,Kolonel Silvertopstraat 5333,2023-07-27,23:00:00,56,25,31,FMN 03 Kolonel Silvertopstraat
651,Kolonel Silvertopstraat 5333,2023-07-28,00:00:00,38,17,21,FMN 03 Kolonel Silvertopstraat
651,Kolonel Silvertopstraat 5333,2023-07-28,01:00:00,25,11,14,FMN 03 Kolonel Silvertopstraat
651,Kolonel Silvertopstraat 5333,2023-07-28,02:00:00,12,5,7,FMN 03 Kolonel Silvertopstraat
651,Kolonel Silvertopstraat 5333,2023-07-28,03:00:00,17,7,10,FMN 03 Kolonel Silvertopstraat
651,Kolonel Silvertopstraat 5333,2023-07-28,04:00:00,41,33,8,FMN 03 Kolonel Silvertopstraat
651,Kolonel Silvertopstraat 5333,2023-07-28,05:00:00,34,16,18,FMN 03 Kolonel Silvertopstraat
651,Kolonel Silvertopstraat 5333,2023-07-28,06:00:00,72,58,14,FMN 03 Kolonel Silvertopstraat
651,Kolonel Silvertopstraat 5333,2023-07-28,07:00:00,121,89,32,FMN 03 Kolonel Silvertopstraat
651,Kolonel Silvertopstraat 5333,2023-07-28,08:00:00,198,156,42,FMN 03 Kolonel Silvertopstraat
651,Kolonel Silvertopstraat 5333,2023-07-28,09:00:00,137,103,34,FMN 03 Kolonel Silvertopstraat
651,Kolonel Silvertopstraat 5333,2023-07-28,10:00:00,136,110,26,FMN 03 Kolonel Silvertopstraat
651,Kolonel Silvertopstraat 5333,2023-07-28,11:00:00,146,106,40,FMN 03 Kolonel Silvertopstraat
651,Kolonel Silvertopstraat 5333,2023-07-28,12:00:00,155,111,44,FMN 03 Kolonel Silvertopstraat
651,Kolonel Silvertopstraat 5333,2023-07-28,13:00:00,209,136,73,FMN 03 Kolonel Silvertopstraat
651,Kolonel Silvertopstraat 5333,2023-07-28,14:00:00,203,145,58,FMN 03 Kolonel Silvertopstraat
651,Kolonel Silvertopstraat 5333,2023-07-28,15:00:00,216,148,68,FMN 03 Kolonel Silvertopstraat
651,Kolonel Silvertopstraat 5333,2023-07-28,16:00:00,268,186,82,FMN 03 Kolonel Silvertopstraat
651,Kolonel Silvertopstraat 5333,2023-07-28,17:00:00,316,225,91,FMN 03 Kolonel Silvertopstraat
651,Kolonel Silvertopstraat 5333,2023-07-28,18:00:00,265,186,79,FMN 03 Kolonel Silvertopstraat
651,Kolonel Silvertopstraat 5333,2023-07-28,19:00:00,193,130,63,FMN 03 Kolonel Silvertopstraat
651,Kolonel Silvertopstraat 5333,2023-07-28,20:00:00,183,133,50,FMN 03 Kolonel Silvertopstraat
651,Kolonel Silvertopstraat 5333,2023-07-28,21:00:00,119,68,51,FMN 03 Kolonel Silvertopstraat
651,Kolonel Silvertopstraat 5333,2023-07-28,22:00:00,129,81,48,FMN 03 Kolonel Silvertopstraat
651,Kolonel Silvertopstraat 5333,2023-07-28,23:00:00,112,49,63,FMN 03 Kolonel Silvertopstraat
651,Kolonel Silvertopstraat 5333,2023-07-29,00:00:00,80,46,34,FMN 03 Kolonel Silvertopstraat
651,Kolonel Silvertopstraat 5333,2023-07-29,01:00:00,52,15,37,FMN 03 Kolonel Silvertopstraat
651,Kolonel Silvertopstraat 5333,2023-07-29,02:00:00,35,15,20,FMN 03 Kolonel Silvertopstraat
651,Kolonel Silvertopstraat 5333,2023-07-29,03:00:00,32,14,18,FMN 03 Kolonel Silvertopstraat
651,Kolonel Silvertopstraat 5333,2023-07-29,04:00:00,24,10,14,FMN 03 Kolonel Silvertopstraat
651,Kolonel Silvertopstraat 5333,2023-07-29,05:00:00,35,20,15,FMN 03 Kolonel Silvertopstraat
651,Kolonel Silvertopstraat 5333,2023-07-29,06:00:00,37,26,11,FMN 03 Kolonel Silvertopstraat
651,Kolonel Silvertopstraat 5333,2023-07-29,07:00:00,40,26,14,FMN 03 Kolonel Silvertopstraat
651,Kolonel Silvertopstraat 5333,2023-07-29,08:00:00,72,54,18,FMN 03 Kolonel Silvertopstraat
651,Kolonel Silvertopstraat 5333,2023-07-29,09:00:00,110,82,28,FMN 03 Kolonel Silvertopstraat
651,Kolonel Silvertopstraat 5333,2023-07-29,10:00:00,143,110,33,FMN 03 Kolonel Silvertopstraat
651,Kolonel Silvertopstraat 5333,2023-07-29,11:00:00,171,124,47,FMN 03 Kolonel Silvertopstraat
651,Kolonel Silvertopstraat 5333,2023-07-29,12:00:00,147,108,39,FMN 03 Kolonel Silvertopstraat
651,Kolonel Silvertopstraat 5333,2023-07-29,13:00:00,93,60,33,FMN 03 Kolonel Silvertopstraat
651,Kolonel Silvertopstraat 5333,2023-07-29,14:00:00,153,116,37,FMN 03 Kolonel Silvertopstraat
651,Kolonel Silvertopstraat 5333,2023-07-29,15:00:00,172,119,53,FMN 03 Kolonel Silvertopstraat
651,Kolonel Silvertopstraat 5333,2023-07-29,16:00:00,158,106,52,FMN 03 Kolonel Silvertopstraat
651,Kolonel Silvertopstraat 5333,2023-07-29,17:00:00,195,125,70,FMN 03 Kolonel Silvertopstraat
651,Kolonel Silvertopstraat 5333,2023-07-29,18:00:00,179,114,65,FMN 03 Kolonel Silvertopstraat
651,Kolonel Silvertopstraat 5333,2023-07-29,19:00:00,171,122,49,FMN 03 Kolonel Silvertopstraat
651,Kolonel Silvertopstraat 5333,2023-07-29,20:00:00,161,111,50,FMN 03 Kolonel Silvertopstraat
651,Kolonel Silvertopstraat 5333,2023-07-29,21:00:00,116,81,35,FMN 03 Kolonel Silvertopstraat
651,Kolonel Silvertopstraat 5333,2023-07-29,22:00:00,116,71,45,FMN 03 Kolonel Silvertopstraat
651,Kolonel Silvertopstraat 5333,2023-07-29,23:00:00,113,66,47,FMN 03 Kolonel Silvertopstraat
651,Kolonel Silvertopstraat 5333,2023-07-30,00:00:00,84,49,35,FMN 03 Kolonel Silvertopstraat
651,Kolonel Silvertopstraat 5333,2023-07-30,01:00:00,42,9,33,FMN 03 Kolonel Silvertopstraat
651,Kolonel Silvertopstraat 5333,2023-07-30,02:00:00,28,11,17,FMN 03 Kolonel Silvertopstraat
651,Kolonel Silvertopstraat 5333,2023-07-30,03:00:00,36,13,23,FMN 03 Kolonel Silvertopstraat
651,Kolonel Silvertopstraat 5333,2023-07-30,04:00:00,29,13,16,FMN 03 Kolonel Silvertopstraat
651,Kolonel Silvertopstraat 5333,2023-07-30,05:00:00,24,13,11,FMN 03 Kolonel Silvertopstraat
651,Kolonel Silvertopstraat 5333,2023-07-30,06:00:00,29,24,5,FMN 03 Kolonel Silvertopstraat
651,Kolonel Silvertopstraat 5333,2023-07-30,07:00:00,32,24,8,FMN 03 Kolonel Silvertopstraat
651,Kolonel Silvertopstraat 5333,2023-07-30,08:00:00,41,28,13,FMN 03 Kolonel Silvertopstraat
651,Kolonel Silvertopstraat 5333,2023-07-30,09:00:00,73,53,20,FMN 03 Kolonel Silvertopstraat
651,Kolonel Silvertopstraat 5333,2023-07-30,10:00:00,102,81,21,FMN 03 Kolonel Silvertopstraat
651,Kolonel Silvertopstraat 5333,2023-07-30,11:00:00,133,96,37,FMN 03 Kolonel Silvertopstraat
651,Kolonel Silvertopstraat 5333,2023-07-30,12:00:00,121,82,39,FMN 03 Kolonel Silvertopstraat
651,Kolonel Silvertopstraat 5333,2023-07-30,13:00:00,175,131,44,FMN 03 Kolonel Silvertopstraat
651,Kolonel Silvertopstraat 5333,2023-07-30,14:00:00,155,115,40,FMN 03 Kolonel Silvertopstraat
651,Kolonel Silvertopstraat 5333,2023-07-30,15:00:00,160,101,59,FMN 03 Kolonel Silvertopstraat
651,Kolonel Silvertopstraat 5333,2023-07-30,16:00:00,168,103,65,FMN 03 Kolonel Silvertopstraat
651,Kolonel Silvertopstraat 5333,2023-07-30,17:00:00,155,97,58,FMN 03 Kolonel Silvertopstraat
651,Kolonel Silvertopstraat 5333,2023-07-30,18:00:00,106,70,36,FMN 03 Kolonel Silvertopstraat
651,Kolonel Silvertopstraat 5333,2023-07-30,19:00:00,74,48,26,FMN 03 Kolonel Silvertopstraat
651,Kolonel Silvertopstraat 5333,2023-07-30,20:00:00,77,42,35,FMN 03 Kolonel Silvertopstraat
651,Kolonel Silvertopstraat 5333,2023-07-30,21:00:00,64,36,28,FMN 03 Kolonel Silvertopstraat
651,Kolonel Silvertopstraat 5333,2023-07-30,22:00:00,58,32,26,FMN 03 Kolonel Silvertopstraat
651,Kolonel Silvertopstraat 5333,2023-07-30,23:00:00,37,17,20,FMN 03 Kolonel Silvertopstraat
651,Kolonel Silvertopstraat 5333,2023-07-31,00:00:00,21,14,7,FMN 03 Kolonel Silvertopstraat
651,Kolonel Silvertopstraat 5333,2023-07-31,01:00:00,25,17,8,FMN 03 Kolonel Silvertopstraat
651,Kolonel Silvertopstraat 5333,2023-07-31,02:00:00,15,9,6,FMN 03 Kolonel Silvertopstraat
651,Kolonel Silvertopstraat 5333,2023-07-31,03:00:00,19,10,9,FMN 03 Kolonel Silvertopstraat
651,Kolonel Silvertopstraat 5333,2023-07-31,04:00:00,20,16,4,FMN 03 Kolonel Silvertopstraat
651,Kolonel Silvertopstraat 5333,2023-07-31,05:00:00,45,25,20,FMN 03 Kolonel Silvertopstraat
651,Kolonel Silvertopstraat 5333,2023-07-31,06:00:00,86,74,12,FMN 03 Kolonel Silvertopstraat
651,Kolonel Silvertopstraat 5333,2023-07-31,07:00:00,140,105,35,FMN 03 Kolonel Silvertopstraat
651,Kolonel Silvertopstraat 5333,2023-07-31,08:00:00,181,136,45,FMN 03 Kolonel Silvertopstraat
651,Kolonel Silvertopstraat 5333,2023-07-31,09:00:00,105,81,24,FMN 03 Kolonel Silvertopstraat
651,Kolonel Silvertopstraat 5333,2023-07-31,10:00:00,82,56,26,FMN 03 Kolonel Silvertopstraat
651,Kolonel Silvertopstraat 5333,2023-07-31,11:00:00,85,59,26,FMN 03 Kolonel Silvertopstraat
651,Kolonel Silvertopstraat 5333,2023-07-31,12:00:00,130,96,34,FMN 03 Kolonel Silvertopstraat
651,Kolonel Silvertopstraat 5333,2023-07-31,13:00:00,128,88,40,FMN 03 Kolonel Silvertopstraat
651,Kolonel Silvertopstraat 5333,2023-07-31,14:00:00,156,109,47,FMN 03 Kolonel Silvertopstraat
651,Kolonel Silvertopstraat 5333,2023-07-31,15:00:00,123,80,43,FMN 03 Kolonel Silvertopstraat
651,Kolonel Silvertopstraat 5333,2023-07-31,16:00:00,156,98,58,FMN 03 Kolonel Silvertopstraat
651,Kolonel Silvertopstraat 5333,2023-07-31,17:00:00,197,124,73,FMN 03 Kolonel Silvertopstraat
651,Kolonel Silvertopstraat 5333,2023-07-31,18:00:00,121,76,45,FMN 03 Kolonel Silvertopstraat
651,Kolonel Silvertopstraat 5333,2023-07-31,19:00:00,68,40,28,FMN 03 Kolonel Silvertopstraat
651,Kolonel Silvertopstraat 5333,2023-07-31,20:00:00,67,42,25,FMN 03 Kolonel Silvertopstraat
651,Kolonel Silvertopstraat 5333,2023-07-31,21:00:00,49,31,18,FMN 03 Kolonel Silvertopstraat
651,Kolonel Silvertopstraat 5333,2023-07-31,22:00:00,54,30,24,FMN 03 Kolonel Silvertopstraat
651,Kolonel Silvertopstraat 5333,2023-07-31,23:00:00,41,24,17,FMN 03 Kolonel Silvertopstraat
651,Kolonel Silvertopstraat 5333,2023-08-01,00:00:00,27,12,15,FMN 03 Kolonel Silvertopstraat
651,Kolonel Silvertopstraat 5333,2023-08-01,01:00:00,3,0,3,FMN 03 Kolonel Silvertopstraat
651,Kolonel Silvertopstraat 5333,2023-08-01,02:00:00,6,5,1,FMN 03 Kolonel Silvertopstraat
651,Kolonel Silvertopstraat 5333,2023-08-01,03:00:00,12,6,6,FMN 03 Kolonel Silvertopstraat
651,Kolonel Silvertopstraat 5333,2023-08-01,04:00:00,21,15,6,FMN 03 Kolonel Silvertopstraat
651,Kolonel Silvertopstraat 5333,2023-08-01,05:00:00,51,28,23,FMN 03 Kolonel Silvertopstraat
651,Kolonel Silvertopstraat 5333,2023-08-01,06:00:00,104,84,20,FMN 03 Kolonel Silvertopstraat
651,Kolonel Silvertopstraat 5333,2023-08-01,07:00:00,171,128,43,FMN 03 Kolonel Silvertopstraat
651,Kolonel Silvertopstraat 5333,2023-08-01,08:00:00,241,201,40,FMN 03 Kolonel Silvertopstraat
651,Kolonel Silvertopstraat 5333,2023-08-01,09:00:00,146,112,34,FMN 03 Kolonel Silvertopstraat
651,Kolonel Silvertopstraat 5333,2023-08-01,10:00:00,117,95,22,FMN 03 Kolonel Silvertopstraat
651,Kolonel Silvertopstraat 5333,2023-08-01,11:00:00,119,84,35,FMN 03 Kolonel Silvertopstraat
651,Kolonel Silvertopstraat 5333,2023-08-01,12:00:00,152,108,44,FMN 03 Kolonel Silvertopstraat
651,Kolonel Silvertopstraat 5333,2023-08-01,13:00:00,190,131,59,FMN 03 Kolonel Silvertopstraat
651,Kolonel Silvertopstraat 5333,2023-08-01,14:00:00,160,110,50,FMN 03 Kolonel Silvertopstraat
651,Kolonel Silvertopstraat 5333,2023-08-01,15:00:00,187,135,52,FMN 03 Kolonel Silvertopstraat
651,Kolonel Silvertopstraat 5333,2023-08-01,16:00:00,273,179,94,FMN 03 Kolonel Silvertopstraat
651,Kolonel Silvertopstraat 5333,2023-08-01,17:00:00,298,184,114,FMN 03 Kolonel Silvertopstraat
651,Kolonel Silvertopstraat 5333,2023-08-01,18:00:00,220,140,80,FMN 03 Kolonel Silvertopstraat
651,Kolonel Silvertopstraat 5333,2023-08-01,19:00:00,176,107,69,FMN 03 Kolonel Silvertopstraat
651,Kolonel Silvertopstraat 5333,2023-08-01,20:00:00,162,114,48,FMN 03 Kolonel Silvertopstraat
651,Kolonel Silvertopstraat 5333,2023-08-01,21:00:00,114,80,34,FMN 03 Kolonel Silvertopstraat
651,Kolonel Silvertopstraat 5333,2023-08-01,22:00:00,128,77,51,FMN 03 Kolonel Silvertopstraat
651,Kolonel Silvertopstraat 5333,2023-08-01,23:00:00,70,31,39,FMN 03 Kolonel Silvertopstraat
651,Kolonel Silvertopstraat 5333,2023-08-02,00:00:00,51,28,23,FMN 03 Kolonel Silvertopstraat
651,Kolonel Silvertopstraat 5333,2023-08-02,01:00:00,40,16,24,FMN 03 Kolonel Silvertopstraat
651,Kolonel Silvertopstraat 5333,2023-08-02,02:00:00,22,11,11,FMN 03 Kolonel Silvertopstraat
651,Kolonel Silvertopstraat 5333,2023-08-02,03:00:00,15,5,10,FMN 03 Kolonel Silvertopstraat
651,Kolonel Silvertopstraat 5333,2023-08-02,04:00:00,18,12,6,FMN 03 Kolonel Silvertopstraat
651,Kolonel Silvertopstraat 5333,2023-08-02,05:00:00,36,21,15,FMN 03 Kolonel Silvertopstraat
651,Kolonel Silvertopstraat 5333,2023-08-02,06:00:00,82,69,13,FMN 03 Kolonel Silvertopstraat
651,Kolonel Silvertopstraat 5333,2023-08-02,07:00:00,119,89,30,FMN 03 Kolonel Silvertopstraat
651,Kolonel Silvertopstraat 5333,2023-08-02,08:00:00,160,130,30,FMN 03 Kolonel Silvertopstraat
651,Kolonel Silvertopstraat 5333,2023-08-02,09:00:00,97,68,29,FMN 03 Kolonel Silvertopstraat
651,Kolonel Silvertopstraat 5333,2023-08-02,10:00:00,87,69,18,FMN 03 Kolonel Silvertopstraat
651,Kolonel Silvertopstraat 5333,2023-08-02,11:00:00,95,73,22,FMN 03 Kolonel Silvertopstraat
651,Kolonel Silvertopstraat 5333,2023-08-02,12:00:00,109,82,27,FMN 03 Kolonel Silvertopstraat
651,Kolonel Silvertopstraat 5333,2023-08-02,13:00:00,136,84,52,FMN 03 Kolonel Silvertopstraat
651,Kolonel Silvertopstraat 5333,2023-08-02,14:00:00,144,104,40,FMN 03 Kolonel Silvertopstraat
651,Kolonel Silvertopstraat 5333,2023-08-02,15:00:00,159,114,45,FMN 03 Kolonel Silvertopstraat
651,Kolonel Silvertopstraat 5333,2023-08-02,16:00:00,192,148,44,FMN 03 Kolonel Silvertopstraat
651,Kolonel Silvertopstraat 5333,2023-08-02,17:00:00,226,132,94,FMN 03 Kolonel Silvertopstraat
651,Kolonel Silvertopstraat 5333,2023-08-02,18:00:00,213,131,82,FMN 03 Kolonel Silvertopstraat
651,Kolonel Silvertopstraat 5333,2023-08-02,19:00:00,141,98,43,FMN 03 Kolonel Silvertopstraat
651,Kolonel Silvertopstraat 5333,2023-08-02,20:00:00,120,76,44,FMN 03 Kolonel Silvertopstraat
651,Kolonel Silvertopstraat 5333,2023-08-02,21:00:00,77,36,41,FMN 03 Kolonel Silvertopstraat
651,Kolonel Silvertopstraat 5333,2023-08-02,22:00:00,89,50,39,FMN 03 Kolonel Silvertopstraat
651,Kolonel Silvertopstraat 5333,2023-08-02,23:00:00,33,14,19,FMN 03 Kolonel Silvertopstraat
651,Kolonel Silvertopstraat 5333,2023-08-03,00:00:00,26,13,13,FMN 03 Kolonel Silvertopstraat
651,Kolonel Silvertopstraat 5333,2023-08-03,01:00:00,22,7,15,FMN 03 Kolonel Silvertopstraat
651,Kolonel Silvertopstraat 5333,2023-08-03,02:00:00,12,6,6,FMN 03 Kolonel Silvertopstraat
651,Kolonel Silvertopstraat 5333,2023-08-03,03:00:00,13,6,7,FMN 03 Kolonel Silvertopstraat
651,Kolonel Silvertopstraat 5333,2023-08-03,04:00:00,9,7,2,FMN 03 Kolonel Silvertopstraat
651,Kolonel Silvertopstraat 5333,2023-08-03,05:00:00,30,16,14,FMN 03 Kolonel Silvertopstraat
651,Kolonel Silvertopstraat 5333,2023-08-03,06:00:00,95,74,21,FMN 03 Kolonel Silvertopstraat
651,Kolonel Silvertopstraat 5333,2023-08-03,07:00:00,147,110,37,FMN 03 Kolonel Silvertopstraat
651,Kolonel Silvertopstraat 5333,2023-08-03,08:00:00,211,170,41,FMN 03 Kolonel Silvertopstraat
651,Kolonel Silvertopstraat 5333,2023-08-03,09:00:00,114,83,31,FMN 03 Kolonel Silvertopstraat
651,Kolonel Silvertopstraat 5333,2023-08-03,10:00:00,84,69,15,FMN 03 Kolonel Silvertopstraat
651,Kolonel Silvertopstraat 5333,2023-08-03,11:00:00,87,59,28,FMN 03 Kolonel Silvertopstraat
651,Kolonel Silvertopstraat 5333,2023-08-03,12:00:00,104,66,38,FMN 03 Kolonel Silvertopstraat
651,Kolonel Silvertopstraat 5333,2023-08-03,13:00:00,107,65,42,FMN 03 Kolonel Silvertopstraat
651,Kolonel Silvertopstraat 5333,2023-08-03,14:00:00,116,79,37,FMN 03 Kolonel Silvertopstraat
651,Kolonel Silvertopstraat 5333,2023-08-03,15:00:00,166,114,52,FMN 03 Kolonel Silvertopstraat
651,Kolonel Silvertopstraat 5333,2023-08-03,16:00:00,215,151,64,FMN 03 Kolonel Silvertopstraat
651,Kolonel Silvertopstraat 5333,2023-08-03,17:00:00,256,174,82,FMN 03 Kolonel Silvertopstraat
651,Kolonel Silvertopstraat 5333,2023-08-03,18:00:00,202,138,64,FMN 03 Kolonel Silvertopstraat
651,Kolonel Silvertopstraat 5333,2023-08-03,19:00:00,172,122,50,FMN 03 Kolonel Silvertopstraat
651,Kolonel Silvertopstraat 5333,2023-08-03,20:00:00,131,86,45,FMN 03 Kolonel Silvertopstraat
651,Kolonel Silvertopstraat 5333,2023-08-03,21:00:00,110,70,40,FMN 03 Kolonel Silvertopstraat
651,Kolonel Silvertopstraat 5333,2023-08-03,22:00:00,100,57,43,FMN 03 Kolonel Silvertopstraat
651,Kolonel Silvertopstraat 5333,2023-08-03,23:00:00,77,37,40,FMN 03 Kolonel Silvertopstraat
651,Kolonel Silvertopstraat 5333,2023-08-04,00:00:00,48,25,23,FMN 03 Kolonel Silvertopstraat
651,Kolonel Silvertopstraat 5333,2023-08-04,01:00:00,29,16,13,FMN 03 Kolonel Silvertopstraat
651,Kolonel Silvertopstraat 5333,2023-08-04,02:00:00,18,9,9,FMN 03 Kolonel Silvertopstraat
651,Kolonel Silvertopstraat 5333,2023-08-04,03:00:00,16,5,11,FMN 03 Kolonel Silvertopstraat
651,Kolonel Silvertopstraat 5333,2023-08-04,04:00:00,19,14,5,FMN 03 Kolonel Silvertopstraat
651,Kolonel Silvertopstraat 5333,2023-08-04,05:00:00,39,23,16,FMN 03 Kolonel Silvertopstraat
651,Kolonel Silvertopstraat 5333,2023-08-04,06:00:00,92,74,18,FMN 03 Kolonel Silvertopstraat
651,Kolonel Silvertopstraat 5333,2023-08-04,07:00:00,144,101,43,FMN 03 Kolonel Silvertopstraat
651,Kolonel Silvertopstraat 5333,2023-08-04,08:00:00,181,135,46,FMN 03 Kolonel Silvertopstraat
651,Kolonel Silvertopstraat 5333,2023-08-04,09:00:00,124,89,35,FMN 03 Kolonel Silvertopstraat
651,Kolonel Silvertopstraat 5333,2023-08-04,10:00:00,116,86,30,FMN 03 Kolonel Silvertopstraat
651,Kolonel Silvertopstraat 5333,2023-08-04,11:00:00,121,89,32,FMN 03 Kolonel Silvertopstraat
651,Kolonel Silvertopstraat 5333,2023-08-04,12:00:00,153,114,39,FMN 03 Kolonel Silvertopstraat
651,Kolonel Silvertopstraat 5333,2023-08-04,13:00:00,202,137,65,FMN 03 Kolonel Silvertopstraat
651,Kolonel Silvertopstraat 5333,2023-08-04,14:00:00,160,103,57,FMN 03 Kolonel Silvertopstraat
651,Kolonel Silvertopstraat 5333,2023-08-04,15:00:00,205,135,70,FMN 03 Kolonel Silvertopstraat
651,Kolonel Silvertopstraat 5333,2023-08-04,16:00:00,207,143,64,FMN 03 Kolonel Silvertopstraat
651,Kolonel Silvertopstraat 5333,2023-08-04,17:00:00,270,177,93,FMN 03 Kolonel Silvertopstraat
651,Kolonel Silvertopstraat 5333,2023-08-04,18:00:00,274,186,88,FMN 03 Kolonel Silvertopstraat
651,Kolonel Silvertopstraat 5333,2023-08-04,19:00:00,186,142,44,FMN 03 Kolonel Silvertopstraat
651,Kolonel Silvertopstraat 5333,2023-08-04,20:00:00,130,87,43,FMN 03 Kolonel Silvertopstraat
651,Kolonel Silvertopstraat 5333,2023-08-04,21:00:00,166,111,55,FMN 03 Kolonel Silvertopstraat
651,Kolonel Silvertopstraat 5333,2023-08-04,22:00:00,111,65,46,FMN 03 Kolonel Silvertopstraat
651,Kolonel Silvertopstraat 5333,2023-08-04,23:00:00,99,53,46,FMN 03 Kolonel Silvertopstraat
651,Kolonel Silvertopstraat 5333,2023-08-05,00:00:00,77,44,33,FMN 03 Kolonel Silvertopstraat
651,Kolonel Silvertopstraat 5333,2023-08-05,01:00:00,58,33,25,FMN 03 Kolonel Silvertopstraat
651,Kolonel Silvertopstraat 5333,2023-08-05,02:00:00,44,25,19,FMN 03 Kolonel Silvertopstraat
651,Kolonel Silvertopstraat 5333,2023-08-05,03:00:00,23,10,13,FMN 03 Kolonel Silvertopstraat
651,Kolonel Silvertopstraat 5333,2023-08-05,04:00:00,25,9,16,FMN 03 Kolonel Silvertopstraat
651,Kolonel Silvertopstraat 5333,2023-08-05,05:00:00,26,18,8,FMN 03 Kolonel Silvertopstraat
651,Kolonel Silvertopstraat 5333,2023-08-05,06:00:00,46,32,14,FMN 03 Kolonel Silvertopstraat
651,Kolonel Silvertopstraat 5333,2023-08-05,07:00:00,31,17,14,FMN 03 Kolonel Silvertopstraat
651,Kolonel Silvertopstraat 5333,2023-08-05,08:00:00,67,45,22,FMN 03 Kolonel Silvertopstraat
651,Kolonel Silvertopstraat 5333,2023-08-05,09:00:00,108,84,24,FMN 03 Kolonel Silvertopstraat
651,Kolonel Silvertopstraat 5333,2023-08-05,10:00:00,123,88,35,FMN 03 Kolonel Silvertopstraat
651,Kolonel Silvertopstraat 5333,2023-08-05,11:00:00,119,81,38,FMN 03 Kolonel Silvertopstraat
651,Kolonel Silvertopstraat 5333,2023-08-05,12:00:00,151,108,43,FMN 03 Kolonel Silvertopstraat
651,Kolonel Silvertopstraat 5333,2023-08-05,13:00:00,124,86,38,FMN 03 Kolonel Silvertopstraat
651,Kolonel Silvertopstraat 5333,2023-08-05,14:00:00,116,78,38,FMN 03 Kolonel Silvertopstraat
651,Kolonel Silvertopstraat 5333,2023-08-05,15:00:00,114,69,45,FMN 03 Kolonel Silvertopstraat
651,Kolonel Silvertopstraat 5333,2023-08-05,16:00:00,116,75,41,FMN 03 Kolonel Silvertopstraat
651,Kolonel Silvertopstraat 5333,2023-08-05,17:00:00,127,88,39,FMN 03 Kolonel Silvertopstraat
651,Kolonel Silvertopstraat 5333,2023-08-05,18:00:00,142,109,33,FMN 03 Kolonel Silvertopstraat
651,Kolonel Silvertopstraat 5333,2023-08-05,19:00:00,118,89,29,FMN 03 Kolonel Silvertopstraat
651,Kolonel Silvertopstraat 5333,2023-08-05,20:00:00,107,72,35,FMN 03 Kolonel Silvertopstraat
651,Kolonel Silvertopstraat 5333,2023-08-05,21:00:00,65,43,22,FMN 03 Kolonel Silvertopstraat
651,Kolonel Silvertopstraat 5333,2023-08-05,22:00:00,63,39,24,FMN 03 Kolonel Silvertopstraat
651,Kolonel Silvertopstraat 5333,2023-08-05,23:00:00,57,20,37,FMN 03 Kolonel Silvertopstraat
651,Kolonel Silvertopstraat 5333,2023-08-06,00:00:00,62,23,39,FMN 03 Kolonel Silvertopstraat
651,Kolonel Silvertopstraat 5333,2023-08-06,01:00:00,40,12,28,FMN 03 Kolonel Silvertopstraat
651,Kolonel Silvertopstraat 5333,2023-08-06,02:00:00,14,3,11,FMN 03 Kolonel Silvertopstraat
651,Kolonel Silvertopstraat 5333,2023-08-06,03:00:00,33,11,22,FMN 03 Kolonel Silvertopstraat
651,Kolonel Silvertopstraat 5333,2023-08-06,04:00:00,13,8,5,FMN 03 Kolonel Silvertopstraat
651,Kolonel Silvertopstraat 5333,2023-08-06,05:00:00,10,9,1,FMN 03 Kolonel Silvertopstraat
651,Kolonel Silvertopstraat 5333,2023-08-06,06:00:00,18,13,5,FMN 03 Kolonel Silvertopstraat
651,Kolonel Silvertopstraat 5333,2023-08-06,07:00:00,12,9,3,FMN 03 Kolonel Silvertopstraat
651,Kolonel Silvertopstraat 5333,2023-08-06,08:00:00,29,25,4,FMN 03 Kolonel Silvertopstraat
651,Kolonel Silvertopstraat 5333,2023-08-06,09:00:00,54,41,13,FMN 03 Kolonel Silvertopstraat
651,Kolonel Silvertopstraat 5333,2023-08-06,10:00:00,56,45,11,FMN 03 Kolonel Silvertopstraat
651,Kolonel Silvertopstraat 5333,2023-08-06,11:00:00,86,66,20,FMN 03 Kolonel Silvertopstraat
651,Kolonel Silvertopstraat 5333,2023-08-06,12:00:00,65,45,20,FMN 03 Kolonel Silvertopstraat
651,Kolonel Silvertopstraat 5333,2023-08-06,13:00:00,74,57,17,FMN 03 Kolonel Silvertopstraat
651,Kolonel Silvertopstraat 5333,2023-08-06,14:00:00,56,42,14,FMN 03 Kolonel Silvertopstraat
651,Kolonel Silvertopstraat 5333,2023-08-06,15:00:00,68,45,23,FMN 03 Kolonel Silvertopstraat
651,Kolonel Silvertopstraat 5333,2023-08-06,16:00:00,47,30,17,FMN 03 Kolonel Silvertopstraat
651,Kolonel Silvertopstraat 5333,2023-08-06,17:00:00,45,24,21,FMN 03 Kolonel Silvertopstraat
651,Kolonel Silvertopstraat 5333,2023-08-06,18:00:00,108,71,37,FMN 03 Kolonel Silvertopstraat
651,Kolonel Silvertopstraat 5333,2023-08-06,19:00:00,101,69,32,FMN 03 Kolonel Silvertopstraat
651,Kolonel Silvertopstraat 5333,2023-08-06,20:00:00,92,64,28,FMN 03 Kolonel Silvertopstraat
651,Kolonel Silvertopstraat 5333,2023-08-06,21:00:00,81,44,37,FMN 03 Kolonel Silvertopstraat
651,Kolonel Silvertopstraat 5333,2023-08-06,22:00:00,73,40,33,FMN 03 Kolonel Silvertopstraat
651,Kolonel Silvertopstraat 5333,2023-08-06,23:00:00,35,20,15,FMN 03 Kolonel Silvertopstraat
651,Kolonel Silvertopstraat 5333,2023-08-07,00:00:00,30,18,12,FMN 03 Kolonel Silvertopstraat
651,Kolonel Silvertopstraat 5333,2023-08-07,01:00:00,22,8,14,FMN 03 Kolonel Silvertopstraat
651,Kolonel Silvertopstraat 5333,2023-08-07,02:00:00,15,7,8,FMN 03 Kolonel Silvertopstraat
651,Kolonel Silvertopstraat 5333,2023-08-07,03:00:00,15,10,5,FMN 03 Kolonel Silvertopstraat
651,Kolonel Silvertopstraat 5333,2023-08-07,04:00:00,30,24,6,FMN 03 Kolonel Silvertopstraat
651,Kolonel Silvertopstraat 5333,2023-08-07,05:00:00,51,28,23,FMN 03 Kolonel Silvertopstraat
651,Kolonel Silvertopstraat 5333,2023-08-07,06:00:00,102,83,19,FMN 03 Kolonel Silvertopstraat
651,Kolonel Silvertopstraat 5333,2023-08-07,07:00:00,169,134,35,FMN 03 Kolonel Silvertopstraat
651,Kolonel Silvertopstraat 5333,2023-08-07,08:00:00,249,200,49,FMN 03 Kolonel Silvertopstraat
651,Kolonel Silvertopstraat 5333,2023-08-07,09:00:00,163,136,27,FMN 03 Kolonel Silvertopstraat
651,Kolonel Silvertopstraat 5333,2023-08-07,10:00:00,115,89,26,FMN 03 Kolonel Silvertopstraat
651,Kolonel Silvertopstraat 5333,2023-08-07,11:00:00,114,81,33,FMN 03 Kolonel Silvertopstraat
651,Kolonel Silvertopstraat 5333,2023-08-07,12:00:00,142,99,43,FMN 03 Kolonel Silvertopstraat
651,Kolonel Silvertopstraat 5333,2023-08-07,13:00:00,173,115,58,FMN 03 Kolonel Silvertopstraat
651,Kolonel Silvertopstraat 5333,2023-08-07,14:00:00,173,126,47,FMN 03 Kolonel Silvertopstraat
651,Kolonel Silvertopstraat 5333,2023-08-07,15:00:00,195,130,65,FMN 03 Kolonel Silvertopstraat
651,Kolonel Silvertopstraat 5333,2023-08-07,16:00:00,242,161,81,FMN 03 Kolonel Silvertopstraat
651,Kolonel Silvertopstraat 5333,2023-08-07,17:00:00,253,158,95,FMN 03 Kolonel Silvertopstraat
651,Kolonel Silvertopstraat 5333,2023-08-07,18:00:00,229,135,94,FMN 03 Kolonel Silvertopstraat
651,Kolonel Silvertopstraat 5333,2023-08-07,19:00:00,165,112,53,FMN 03 Kolonel Silvertopstraat
651,Kolonel Silvertopstraat 5333,2023-08-07,20:00:00,134,92,42,FMN 03 Kolonel Silvertopstraat
651,Kolonel Silvertopstraat 5333,2023-08-07,21:00:00,117,72,45,FMN 03 Kolonel Silvertopstraat
651,Kolonel Silvertopstraat 5333,2023-08-07,22:00:00,94,44,50,FMN 03 Kolonel Silvertopstraat
651,Kolonel Silvertopstraat 5333,2023-08-07,23:00:00,65,27,38,FMN 03 Kolonel Silvertopstraat
651,Kolonel Silvertopstraat 5333,2023-08-08,00:00:00,47,20,27,FMN 03 Kolonel Silvertopstraat
651,Kolonel Silvertopstraat 5333,2023-08-08,01:00:00,21,7,14,FMN 03 Kolonel Silvertopstraat
651,Kolonel Silvertopstraat 5333,2023-08-08,02:00:00,19,9,10,FMN 03 Kolonel Silvertopstraat
651,Kolonel Silvertopstraat 5333,2023-08-08,03:00:00,17,9,8,FMN 03 Kolonel Silvertopstraat
651,Kolonel Silvertopstraat 5333,2023-08-08,04:00:00,25,19,6,FMN 03 Kolonel Silvertopstraat
651,Kolonel Silvertopstraat 5333,2023-08-08,05:00:00,45,27,18,FMN 03 Kolonel Silvertopstraat
651,Kolonel Silvertopstraat 5333,2023-08-08,06:00:00,122,104,18,FMN 03 Kolonel Silvertopstraat
651,Kolonel Silvertopstraat 5333,2023-08-08,07:00:00,183,136,47,FMN 03 Kolonel Silvertopstraat
651,Kolonel Silvertopstraat 5333,2023-08-08,08:00:00,291,241,50,FMN 03 Kolonel Silvertopstraat
651,Kolonel Silvertopstraat 5333,2023-08-08,09:00:00,157,130,27,FMN 03 Kolonel Silvertopstraat
651,Kolonel Silvertopstraat 5333,2023-08-08,10:00:00,119,97,22,FMN 03 Kolonel Silvertopstraat
651,Kolonel Silvertopstraat 5333,2023-08-08,11:00:00,104,79,25,FMN 03 Kolonel Silvertopstraat
651,Kolonel Silvertopstraat 5333,2023-08-08,12:00:00,149,107,42,FMN 03 Kolonel Silvertopstraat
651,Kolonel Silvertopstraat 5333,2023-08-08,13:00:00,174,119,55,FMN 03 Kolonel Silvertopstraat
651,Kolonel Silvertopstraat 5333,2023-08-08,14:00:00,135,93,42,FMN 03 Kolonel Silvertopstraat
651,Kolonel Silvertopstraat 5333,2023-08-08,15:00:00,190,127,63,FMN 03 Kolonel Silvertopstraat
651,Kolonel Silvertopstraat 5333,2023-08-08,16:00:00,269,185,84,FMN 03 Kolonel Silvertopstraat
651,Kolonel Silvertopstraat 5333,2023-08-08,17:00:00,316,203,113,FMN 03 Kolonel Silvertopstraat
651,Kolonel Silvertopstraat 5333,2023-08-08,18:00:00,237,156,81,FMN 03 Kolonel Silvertopstraat
651,Kolonel Silvertopstraat 5333,2023-08-08,19:00:00,153,97,56,FMN 03 Kolonel Silvertopstraat
651,Kolonel Silvertopstraat 5333,2023-08-08,20:00:00,132,93,39,FMN 03 Kolonel Silvertopstraat
651,Kolonel Silvertopstraat 5333,2023-08-08,21:00:00,61,32,29,FMN 03 Kolonel Silvertopstraat
651,Kolonel Silvertopstraat 5333,2023-08-08,22:00:00,77,47,30,FMN 03 Kolonel Silvertopstraat
651,Kolonel Silvertopstraat 5333,2023-08-08,23:00:00,45,17,28,FMN 03 Kolonel Silvertopstraat
651,Kolonel Silvertopstraat 5333,2023-08-09,00:00:00,28,15,13,FMN 03 Kolonel Silvertopstraat
651,Kolonel Silvertopstraat 5333,2023-08-09,01:00:00,16,6,10,FMN 03 Kolonel Silvertopstraat
651,Kolonel Silvertopstraat 5333,2023-08-09,02:00:00,9,5,4,FMN 03 Kolonel Silvertopstraat
651,Kolonel Silvertopstraat 5333,2023-08-09,03:00:00,9,5,4,FMN 03 Kolonel Silvertopstraat
651,Kolonel Silvertopstraat 5333,2023-08-09,04:00:00,33,22,11,FMN 03 Kolonel Silvertopstraat
651,Kolonel Silvertopstraat 5333,2023-08-09,05:00:00,42,24,18,FMN 03 Kolonel Silvertopstraat
651,Kolonel Silvertopstraat 5333,2023-08-09,06:00:00,106,91,15,FMN 03 Kolonel Silvertopstraat
651,Kolonel Silvertopstraat 5333,2023-08-09,07:00:00,173,129,44,FMN 03 Kolonel Silvertopstraat
651,Kolonel Silvertopstraat 5333,2023-08-09,08:00:00,276,217,59,FMN 03 Kolonel Silvertopstraat
651,Kolonel Silvertopstraat 5333,2023-08-09,09:00:00,176,132,44,FMN 03 Kolonel Silvertopstraat
651,Kolonel Silvertopstraat 5333,2023-08-09,10:00:00,141,115,26,FMN 03 Kolonel Silvertopstraat
651,Kolonel Silvertopstraat 5333,2023-08-09,11:00:00,135,102,33,FMN 03 Kolonel Silvertopstraat
651,Kolonel Silvertopstraat 5333,2023-08-09,12:00:00,177,131,46,FMN 03 Kolonel Silvertopstraat
651,Kolonel Silvertopstraat 5333,2023-08-09,13:00:00,203,138,65,FMN 03 Kolonel Silvertopstraat
651,Kolonel Silvertopstraat 5333,2023-08-09,14:00:00,194,134,60,FMN 03 Kolonel Silvertopstraat
651,Kolonel Silvertopstraat 5333,2023-08-09,15:00:00,143,87,56,FMN 03 Kolonel Silvertopstraat
651,Kolonel Silvertopstraat 5333,2023-08-09,16:00:00,250,186,64,FMN 03 Kolonel Silvertopstraat
651,Kolonel Silvertopstraat 5333,2023-08-09,17:00:00,321,217,104,FMN 03 Kolonel Silvertopstraat
651,Kolonel Silvertopstraat 5333,2023-08-09,18:00:00,242,169,73,FMN 03 Kolonel Silvertopstraat
651,Kolonel Silvertopstraat 5333,2023-08-09,19:00:00,218,126,92,FMN 03 Kolonel Silvertopstraat
651,Kolonel Silvertopstraat 5333,2023-08-09,20:00:00,191,124,67,FMN 03 Kolonel Silvertopstraat
651,Kolonel Silvertopstraat 5333,2023-08-09,21:00:00,110,67,43,FMN 03 Kolonel Silvertopstraat
651,Kolonel Silvertopstraat 5333,2023-08-09,22:00:00,131,73,58,FMN 03 Kolonel Silvertopstraat
651,Kolonel Silvertopstraat 5333,2023-08-09,23:00:00,83,37,46,FMN 03 Kolonel Silvertopstraat
651,Kolonel Silvertopstraat 5333,2023-08-10,00:00:00,44,25,19,FMN 03 Kolonel Silvertopstraat
651,Kolonel Silvertopstraat 5333,2023-08-10,01:00:00,25,9,16,FMN 03 Kolonel Silvertopstraat
651,Kolonel Silvertopstraat 5333,2023-08-10,02:00:00,25,9,16,FMN 03 Kolonel Silvertopstraat
651,Kolonel Silvertopstraat 5333,2023-08-10,03:00:00,14,6,8,FMN 03 Kolonel Silvertopstraat
651,Kolonel Silvertopstraat 5333,2023-08-10,04:00:00,31,24,7,FMN 03 Kolonel Silvertopstraat
651,Kolonel Silvertopstraat 5333,2023-08-10,05:00:00,51,32,19,FMN 03 Kolonel Silvertopstraat
651,Kolonel Silvertopstraat 5333,2023-08-10,06:00:00,119,94,25,FMN 03 Kolonel Silvertopstraat
651,Kolonel Silvertopstraat 5333,2023-08-10,07:00:00,171,133,38,FMN 03 Kolonel Silvertopstraat
651,Kolonel Silvertopstraat 5333,2023-08-10,08:00:00,280,228,52,FMN 03 Kolonel Silvertopstraat
651,Kolonel Silvertopstraat 5333,2023-08-10,09:00:00,204,156,48,FMN 03 Kolonel Silvertopstraat
651,Kolonel Silvertopstraat 5333,2023-08-10,10:00:00,134,103,31,FMN 03 Kolonel Silvertopstraat
651,Kolonel Silvertopstraat 5333,2023-08-10,11:00:00,150,106,44,FMN 03 Kolonel Silvertopstraat
651,Kolonel Silvertopstraat 5333,2023-08-10,12:00:00,176,126,50,FMN 03 Kolonel Silvertopstraat
651,Kolonel Silvertopstraat 5333,2023-08-10,13:00:00,186,132,54,FMN 03 Kolonel Silvertopstraat
651,Kolonel Silvertopstraat 5333,2023-08-10,14:00:00,140,95,45,FMN 03 Kolonel Silvertopstraat
651,Kolonel Silvertopstraat 5333,2023-08-10,15:00:00,2,1,1,FMN 03 Kolonel Silvertopstraat
651,Kolonel Silvertopstraat 5333,2023-08-10,16:00:00,31,23,8,FMN 03 Kolonel Silvertopstraat
651,Kolonel Silvertopstraat 5333,2023-08-10,17:00:00,319,224,95,FMN 03 Kolonel Silvertopstraat
651,Kolonel Silvertopstraat 5333,2023-08-10,18:00:00,292,208,84,FMN 03 Kolonel Silvertopstraat
651,Kolonel Silvertopstraat 5333,2023-08-10,19:00:00,235,167,68,FMN 03 Kolonel Silvertopstraat
651,Kolonel Silvertopstraat 5333,2023-08-10,20:00:00,191,133,58,FMN 03 Kolonel Silvertopstraat
651,Kolonel Silvertopstraat 5333,2023-08-10,21:00:00,157,89,68,FMN 03 Kolonel Silvertopstraat
651,Kolonel Silvertopstraat 5333,2023-08-10,22:00:00,171,96,75,FMN 03 Kolonel Silvertopstraat
651,Kolonel Silvertopstraat 5333,2023-08-10,23:00:00,82,32,50,FMN 03 Kolonel Silvertopstraat
651,Kolonel Silvertopstraat 5333,2023-08-11,00:00:00,44,18,26,FMN 03 Kolonel Silvertopstraat
651,Kolonel Silvertopstraat 5333,2023-08-11,01:00:00,28,13,15,FMN 03 Kolonel Silvertopstraat
651,Kolonel Silvertopstraat 5333,2023-08-11,02:00:00,16,6,10,FMN 03 Kolonel Silvertopstraat
651,Kolonel Silvertopstraat 5333,2023-08-11,03:00:00,22,11,11,FMN 03 Kolonel Silvertopstraat
651,Kolonel Silvertopstraat 5333,2023-08-11,04:00:00,38,26,12,FMN 03 Kolonel Silvertopstraat
651,Kolonel Silvertopstraat 5333,2023-08-11,05:00:00,47,24,23,FMN 03 Kolonel Silvertopstraat
651,Kolonel Silvertopstraat 5333,2023-08-11,06:00:00,95,76,19,FMN 03 Kolonel Silvertopstraat
651,Kolonel Silvertopstraat 5333,2023-08-11,07:00:00,146,102,44,FMN 03 Kolonel Silvertopstraat
651,Kolonel Silvertopstraat 5333,2023-08-11,08:00:00,242,190,52,FMN 03 Kolonel Silvertopstraat
651,Kolonel Silvertopstraat 5333,2023-08-11,09:00:00,190,157,33,FMN 03 Kolonel Silvertopstraat
651,Kolonel Silvertopstraat 5333,2023-08-11,10:00:00,159,122,37,FMN 03 Kolonel Silvertopstraat
651,Kolonel Silvertopstraat 5333,2023-08-11,11:00:00,170,125,45,FMN 03 Kolonel Silvertopstraat
651,Kolonel Silvertopstraat 5333,2023-08-11,12:00:00,220,153,67,FMN 03 Kolonel Silvertopstraat
651,Kolonel Silvertopstraat 5333,2023-08-11,13:00:00,199,144,55,FMN 03 Kolonel Silvertopstraat
651,Kolonel Silvertopstraat 5333,2023-08-11,14:00:00,205,143,62,FMN 03 Kolonel Silvertopstraat
651,Kolonel Silvertopstraat 5333,2023-08-11,15:00:00,244,162,82,FMN 03 Kolonel Silvertopstraat
651,Kolonel Silvertopstraat 5333,2023-08-11,16:00:00,288,199,89,FMN 03 Kolonel Silvertopstraat
651,Kolonel Silvertopstraat 5333,2023-08-11,17:00:00,303,201,102,FMN 03 Kolonel Silvertopstraat
651,Kolonel Silvertopstraat 5333,2023-08-11,18:00:00,295,205,90,FMN 03 Kolonel Silvertopstraat
651,Kolonel Silvertopstraat 5333,2023-08-11,19:00:00,188,138,50,FMN 03 Kolonel Silvertopstraat
651,Kolonel Silvertopstraat 5333,2023-08-11,20:00:00,152,106,46,FMN 03 Kolonel Silvertopstraat
651,Kolonel Silvertopstraat 5333,2023-08-11,21:00:00,147,94,53,FMN 03 Kolonel Silvertopstraat
651,Kolonel Silvertopstraat 5333,2023-08-11,22:00:00,117,60,57,FMN 03 Kolonel Silvertopstraat
651,Kolonel Silvertopstraat 5333,2023-08-11,23:00:00,89,47,42,FMN 03 Kolonel Silvertopstraat
651,Kolonel Silvertopstraat 5333,2023-08-12,00:00:00,73,26,47,FMN 03 Kolonel Silvertopstraat
651,Kolonel Silvertopstraat 5333,2023-08-12,01:00:00,53,19,34,FMN 03 Kolonel Silvertopstraat
651,Kolonel Silvertopstraat 5333,2023-08-12,02:00:00,40,15,25,FMN 03 Kolonel Silvertopstraat
651,Kolonel Silvertopstraat 5333,2023-08-12,03:00:00,24,6,18,FMN 03 Kolonel Silvertopstraat
651,Kolonel Silvertopstraat 5333,2023-08-12,04:00:00,22,9,13,FMN 03 Kolonel Silvertopstraat
651,Kolonel Silvertopstraat 5333,2023-08-12,05:00:00,19,8,11,FMN 03 Kolonel Silvertopstraat
651,Kolonel Silvertopstraat 5333,2023-08-12,06:00:00,28,16,12,FMN 03 Kolonel Silvertopstraat
651,Kolonel Silvertopstraat 5333,2023-08-12,07:00:00,28,21,7,FMN 03 Kolonel Silvertopstraat
651,Kolonel Silvertopstraat 5333,2023-08-12,08:00:00,52,40,12,FMN 03 Kolonel Silvertopstraat
651,Kolonel Silvertopstraat 5333,2023-08-12,09:00:00,95,75,20,FMN 03 Kolonel Silvertopstraat
651,Kolonel Silvertopstraat 5333,2023-08-12,10:00:00,105,92,13,FMN 03 Kolonel Silvertopstraat
651,Kolonel Silvertopstraat 5333,2023-08-12,11:00:00,134,99,35,FMN 03 Kolonel Silvertopstraat
651,Kolonel Silvertopstraat 5333,2023-08-12,12:00:00,164,132,32,FMN 03 Kolonel Silvertopstraat
651,Kolonel Silvertopstraat 5333,2023-08-12,13:00:00,254,215,39,FMN 03 Kolonel Silvertopstraat
651,Kolonel Silvertopstraat 5333,2023-08-12,14:00:00,291,235,56,FMN 03 Kolonel Silvertopstraat
651,Kolonel Silvertopstraat 5333,2023-08-12,15:00:00,283,219,64,FMN 03 Kolonel Silvertopstraat
651,Kolonel Silvertopstraat 5333,2023-08-12,16:00:00,211,139,72,FMN 03 Kolonel Silvertopstraat
651,Kolonel Silvertopstraat 5333,2023-08-12,17:00:00,192,135,57,FMN 03 Kolonel Silvertopstraat
651,Kolonel Silvertopstraat 5333,2023-08-12,18:00:00,192,122,70,FMN 03 Kolonel Silvertopstraat
651,Kolonel Silvertopstraat 5333,2023-08-12,19:00:00,173,114,59,FMN 03 Kolonel Silvertopstraat
651,Kolonel Silvertopstraat 5333,2023-08-12,20:00:00,164,104,60,FMN 03 Kolonel Silvertopstraat
651,Kolonel Silvertopstraat 5333,2023-08-12,21:00:00,117,75,42,FMN 03 Kolonel Silvertopstraat
651,Kolonel Silvertopstraat 5333,2023-08-12,22:00:00,112,67,45,FMN 03 Kolonel Silvertopstraat
651,Kolonel Silvertopstraat 5333,2023-08-12,23:00:00,94,46,48,FMN 03 Kolonel Silvertopstraat
651,Kolonel Silvertopstraat 5333,2023-08-13,00:00:00,71,23,48,FMN 03 Kolonel Silvertopstraat
651,Kolonel Silvertopstraat 5333,2023-08-13,01:00:00,49,21,28,FMN 03 Kolonel Silvertopstraat
651,Kolonel Silvertopstraat 5333,2023-08-13,02:00:00,37,14,23,FMN 03 Kolonel Silvertopstraat
651,Kolonel Silvertopstraat 5333,2023-08-13,03:00:00,28,14,14,FMN 03 Kolonel Silvertopstraat
651,Kolonel Silvertopstraat 5333,2023-08-13,04:00:00,22,12,10,FMN 03 Kolonel Silvertopstraat
651,Kolonel Silvertopstraat 5333,2023-08-13,05:00:00,24,13,11,FMN 03 Kolonel Silvertopstraat
651,Kolonel Silvertopstraat 5333,2023-08-13,06:00:00,41,24,17,FMN 03 Kolonel Silvertopstraat
651,Kolonel Silvertopstraat 5333,2023-08-13,07:00:00,25,17,8,FMN 03 Kolonel Silvertopstraat
651,Kolonel Silvertopstraat 5333,2023-08-13,08:00:00,60,42,18,FMN 03 Kolonel Silvertopstraat
651,Kolonel Silvertopstraat 5333,2023-08-13,09:00:00,85,64,21,FMN 03 Kolonel Silvertopstraat
651,Kolonel Silvertopstraat 5333,2023-08-13,10:00:00,110,87,23,FMN 03 Kolonel Silvertopstraat
651,Kolonel Silvertopstraat 5333,2023-08-13,11:00:00,108,86,22,FMN 03 Kolonel Silvertopstraat
651,Kolonel Silvertopstraat 5333,2023-08-13,12:00:00,128,91,37,FMN 03 Kolonel Silvertopstraat
651,Kolonel Silvertopstraat 5333,2023-08-13,13:00:00,179,135,44,FMN 03 Kolonel Silvertopstraat
651,Kolonel Silvertopstraat 5333,2023-08-13,14:00:00,177,133,44,FMN 03 Kolonel Silvertopstraat
651,Kolonel Silvertopstraat 5333,2023-08-13,15:00:00,183,127,56,FMN 03 Kolonel Silvertopstraat
651,Kolonel Silvertopstraat 5333,2023-08-13,16:00:00,183,127,56,FMN 03 Kolonel Silvertopstraat
651,Kolonel Silvertopstraat 5333,2023-08-13,17:00:00,152,98,54,FMN 03 Kolonel Silvertopstraat
651,Kolonel Silvertopstraat 5333,2023-08-13,18:00:00,185,127,58,FMN 03 Kolonel Silvertopstraat
651,Kolonel Silvertopstraat 5333,2023-08-13,19:00:00,144,95,49,FMN 03 Kolonel Silvertopstraat
651,Kolonel Silvertopstraat 5333,2023-08-13,20:00:00,164,90,74,FMN 03 Kolonel Silvertopstraat
651,Kolonel Silvertopstraat 5333,2023-08-13,21:00:00,120,67,53,FMN 03 Kolonel Silvertopstraat
651,Kolonel Silvertopstraat 5333,2023-08-13,22:00:00,109,52,57,FMN 03 Kolonel Silvertopstraat
651,Kolonel Silvertopstraat 5333,2023-08-13,23:00:00,71,35,36,FMN 03 Kolonel Silvertopstraat
651,Kolonel Silvertopstraat 5333,2023-08-14,00:00:00,40,14,26,FMN 03 Kolonel Silvertopstraat
651,Kolonel Silvertopstraat 5333,2023-08-14,01:00:00,23,13,10,FMN 03 Kolonel Silvertopstraat
651,Kolonel Silvertopstraat 5333,2023-08-14,02:00:00,23,10,13,FMN 03 Kolonel Silvertopstraat
651,Kolonel Silvertopstraat 5333,2023-08-14,03:00:00,14,6,8,FMN 03 Kolonel Silvertopstraat
651,Kolonel Silvertopstraat 5333,2023-08-14,04:00:00,32,25,7,FMN 03 Kolonel Silvertopstraat
651,Kolonel Silvertopstraat 5333,2023-08-14,05:00:00,42,27,15,FMN 03 Kolonel Silvertopstraat
651,Kolonel Silvertopstraat 5333,2023-08-14,06:00:00,65,48,17,FMN 03 Kolonel Silvertopstraat
651,Kolonel Silvertopstraat 5333,2023-08-14,07:00:00,99,70,29,FMN 03 Kolonel Silvertopstraat
651,Kolonel Silvertopstraat 5333,2023-08-14,08:00:00,150,114,36,FMN 03 Kolonel Silvertopstraat
651,Kolonel Silvertopstraat 5333,2023-08-14,09:00:00,133,106,27,FMN 03 Kolonel Silvertopstraat
651,Kolonel Silvertopstraat 5333,2023-08-14,10:00:00,133,106,27,FMN 03 Kolonel Silvertopstraat
651,Kolonel Silvertopstraat 5333,2023-08-14,11:00:00,153,112,41,FMN 03 Kolonel Silvertopstraat
651,Kolonel Silvertopstraat 5333,2023-08-14,12:00:00,179,138,41,FMN 03 Kolonel Silvertopstraat
651,Kolonel Silvertopstraat 5333,2023-08-14,13:00:00,167,107,60,FMN 03 Kolonel Silvertopstraat
651,Kolonel Silvertopstraat 5333,2023-08-14,14:00:00,167,108,59,FMN 03 Kolonel Silvertopstraat
651,Kolonel Silvertopstraat 5333,2023-08-14,15:00:00,44,26,18,FMN 03 Kolonel Silvertopstraat
651,Kolonel Silvertopstraat 5333,2023-08-14,16:00:00,89,66,23,FMN 03 Kolonel Silvertopstraat
651,Kolonel Silvertopstraat 5333,2023-08-14,17:00:00,232,153,79,FMN 03 Kolonel Silvertopstraat
651,Kolonel Silvertopstraat 5333,2023-08-14,18:00:00,234,153,81,FMN 03 Kolonel Silvertopstraat
651,Kolonel Silvertopstraat 5333,2023-08-14,19:00:00,164,114,50,FMN 03 Kolonel Silvertopstraat
651,Kolonel Silvertopstraat 5333,2023-08-14,20:00:00,208,133,75,FMN 03 Kolonel Silvertopstraat
651,Kolonel Silvertopstraat 5333,2023-08-14,21:00:00,113,71,42,FMN 03 Kolonel Silvertopstraat
651,Kolonel Silvertopstraat 5333,2023-08-14,22:00:00,110,65,45,FMN 03 Kolonel Silvertopstraat
651,Kolonel Silvertopstraat 5333,2023-08-14,23:00:00,73,44,29,FMN 03 Kolonel Silvertopstraat
651,Kolonel Silvertopstraat 5333,2023-08-15,00:00:00,59,30,29,FMN 03 Kolonel Silvertopstraat
651,Kolonel Silvertopstraat 5333,2023-08-15,01:00:00,40,25,15,FMN 03 Kolonel Silvertopstraat
651,Kolonel Silvertopstraat 5333,2023-08-15,02:00:00,28,14,14,FMN 03 Kolonel Silvertopstraat
651,Kolonel Silvertopstraat 5333,2023-08-15,03:00:00,11,4,7,FMN 03 Kolonel Silvertopstraat
651,Kolonel Silvertopstraat 5333,2023-08-15,04:00:00,15,9,6,FMN 03 Kolonel Silvertopstraat
651,Kolonel Silvertopstraat 5333,2023-08-15,05:00:00,28,13,15,FMN 03 Kolonel Silvertopstraat
651,Kolonel Silvertopstraat 5333,2023-08-15,06:00:00,37,30,7,FMN 03 Kolonel Silvertopstraat
651,Kolonel Silvertopstraat 5333,2023-08-15,07:00:00,37,23,14,FMN 03 Kolonel Silvertopstraat
651,Kolonel Silvertopstraat 5333,2023-08-15,08:00:00,79,61,18,FMN 03 Kolonel Silvertopstraat
651,Kolonel Silvertopstraat 5333,2023-08-15,09:00:00,149,127,22,FMN 03 Kolonel Silvertopstraat
651,Kolonel Silvertopstraat 5333,2023-08-15,10:00:00,167,143,24,FMN 03 Kolonel Silvertopstraat
651,Kolonel Silvertopstraat 5333,2023-08-15,11:00:00,192,152,40,FMN 03 Kolonel Silvertopstraat
651,Kolonel Silvertopstraat 5333,2023-08-15,12:00:00,166,132,34,FMN 03 Kolonel Silvertopstraat
651,Kolonel Silvertopstraat 5333,2023-08-15,13:00:00,231,171,60,FMN 03 Kolonel Silvertopstraat
651,Kolonel Silvertopstraat 5333,2023-08-15,14:00:00,247,190,57,FMN 03 Kolonel Silvertopstraat
651,Kolonel Silvertopstraat 5333,2023-08-15,15:00:00,232,165,67,FMN 03 Kolonel Silvertopstraat
651,Kolonel Silvertopstraat 5333,2023-08-15,16:00:00,175,120,55,FMN 03 Kolonel Silvertopstraat
651,Kolonel Silvertopstraat 5333,2023-08-15,17:00:00,201,134,67,FMN 03 Kolonel Silvertopstraat
651,Kolonel Silvertopstraat 5333,2023-08-15,18:00:00,188,129,59,FMN 03 Kolonel Silvertopstraat
651,Kolonel Silvertopstraat 5333,2023-08-15,19:00:00,196,119,77,FMN 03 Kolonel Silvertopstraat
651,Kolonel Silvertopstraat 5333,2023-08-15,20:00:00,155,94,61,FMN 03 Kolonel Silvertopstraat
651,Kolonel Silvertopstraat 5333,2023-08-15,21:00:00,139,83,56,FMN 03 Kolonel Silvertopstraat
651,Kolonel Silvertopstraat 5333,2023-08-15,22:00:00,102,64,38,FMN 03 Kolonel Silvertopstraat
651,Kolonel Silvertopstraat 5333,2023-08-15,23:00:00,88,35,53,FMN 03 Kolonel Silvertopstraat
651,Kolonel Silvertopstraat 5333,2023-08-16,00:00:00,32,14,18,FMN 03 Kolonel Silvertopstraat
651,Kolonel Silvertopstraat 5333,2023-08-16,01:00:00,34,17,17,FMN 03 Kolonel Silvertopstraat
651,Kolonel Silvertopstraat 5333,2023-08-16,02:00:00,12,5,7,FMN 03 Kolonel Silvertopstraat
651,Kolonel Silvertopstraat 5333,2023-08-16,03:00:00,16,7,9,FMN 03 Kolonel Silvertopstraat
651,Kolonel Silvertopstraat 5333,2023-08-16,04:00:00,31,24,7,FMN 03 Kolonel Silvertopstraat
651,Kolonel Silvertopstraat 5333,2023-08-16,05:00:00,50,25,25,FMN 03 Kolonel Silvertopstraat
651,Kolonel Silvertopstraat 5333,2023-08-16,06:00:00,128,102,26,FMN 03 Kolonel Silvertopstraat
651,Kolonel Silvertopstraat 5333,2023-08-16,07:00:00,187,143,44,FMN 03 Kolonel Silvertopstraat
651,Kolonel Silvertopstraat 5333,2023-08-16,08:00:00,308,253,55,FMN 03 Kolonel Silvertopstraat
651,Kolonel Silvertopstraat 5333,2023-08-16,09:00:00,207,155,52,FMN 03 Kolonel Silvertopstraat
651,Kolonel Silvertopstraat 5333,2023-08-16,10:00:00,166,132,34,FMN 03 Kolonel Silvertopstraat
651,Kolonel Silvertopstraat 5333,2023-08-16,11:00:00,179,133,46,FMN 03 Kolonel Silvertopstraat
651,Kolonel Silvertopstraat 5333,2023-08-16,12:00:00,177,123,54,FMN 03 Kolonel Silvertopstraat
651,Kolonel Silvertopstraat 5333,2023-08-16,13:00:00,204,130,74,FMN 03 Kolonel Silvertopstraat
651,Kolonel Silvertopstraat 5333,2023-08-16,14:00:00,206,141,65,FMN 03 Kolonel Silvertopstraat
651,Kolonel Silvertopstraat 5333,2023-08-16,15:00:00,264,190,74,FMN 03 Kolonel Silvertopstraat
651,Kolonel Silvertopstraat 5333,2023-08-16,16:00:00,310,205,105,FMN 03 Kolonel Silvertopstraat
651,Kolonel Silvertopstraat 5333,2023-08-16,17:00:00,372,256,116,FMN 03 Kolonel Silvertopstraat
651,Kolonel Silvertopstraat 5333,2023-08-16,18:00:00,281,182,99,FMN 03 Kolonel Silvertopstraat
651,Kolonel Silvertopstraat 5333,2023-08-16,19:00:00,162,104,58,FMN 03 Kolonel Silvertopstraat
651,Kolonel Silvertopstraat 5333,2023-08-16,20:00:00,191,119,72,FMN 03 Kolonel Silvertopstraat
651,Kolonel Silvertopstraat 5333,2023-08-16,21:00:00,124,76,48,FMN 03 Kolonel Silvertopstraat
651,Kolonel Silvertopstraat 5333,2023-08-16,22:00:00,149,79,70,FMN 03 Kolonel Silvertopstraat
651,Kolonel Silvertopstraat 5333,2023-08-16,23:00:00,80,45,35,FMN 03 Kolonel Silvertopstraat
651,Kolonel Silvertopstraat 5333,2023-08-17,00:00:00,34,13,21,FMN 03 Kolonel Silvertopstraat
651,Kolonel Silvertopstraat 5333,2023-08-17,01:00:00,34,15,19,FMN 03 Kolonel Silvertopstraat
651,Kolonel Silvertopstraat 5333,2023-08-17,02:00:00,20,9,11,FMN 03 Kolonel Silvertopstraat
651,Kolonel Silvertopstraat 5333,2023-08-17,03:00:00,7,3,4,FMN 03 Kolonel Silvertopstraat
651,Kolonel Silvertopstraat 5333,2023-08-17,04:00:00,40,30,10,FMN 03 Kolonel Silvertopstraat
651,Kolonel Silvertopstraat 5333,2023-08-17,05:00:00,58,34,24,FMN 03 Kolonel Silvertopstraat
651,Kolonel Silvertopstraat 5333,2023-08-17,06:00:00,124,103,21,FMN 03 Kolonel Silvertopstraat
651,Kolonel Silvertopstraat 5333,2023-08-17,07:00:00,215,169,46,FMN 03 Kolonel Silvertopstraat
651,Kolonel Silvertopstraat 5333,2023-08-17,08:00:00,347,271,76,FMN 03 Kolonel Silvertopstraat
651,Kolonel Silvertopstraat 5333,2023-08-17,09:00:00,236,182,54,FMN 03 Kolonel Silvertopstraat
651,Kolonel Silvertopstraat 5333,2023-08-17,10:00:00,187,137,50,FMN 03 Kolonel Silvertopstraat
651,Kolonel Silvertopstraat 5333,2023-08-17,11:00:00,159,125,34,FMN 03 Kolonel Silvertopstraat
651,Kolonel Silvertopstraat 5333,2023-08-17,12:00:00,183,134,49,FMN 03 Kolonel Silvertopstraat
651,Kolonel Silvertopstraat 5333,2023-08-17,13:00:00,198,141,57,FMN 03 Kolonel Silvertopstraat
651,Kolonel Silvertopstraat 5333,2023-08-17,14:00:00,194,145,49,FMN 03 Kolonel Silvertopstraat
651,Kolonel Silvertopstraat 5333,2023-08-17,15:00:00,223,150,73,FMN 03 Kolonel Silvertopstraat
651,Kolonel Silvertopstraat 5333,2023-08-17,16:00:00,295,199,96,FMN 03 Kolonel Silvertopstraat
651,Kolonel Silvertopstraat 5333,2023-08-17,17:00:00,329,227,102,FMN 03 Kolonel Silvertopstraat
651,Kolonel Silvertopstraat 5333,2023-08-17,18:00:00,279,168,111,FMN 03 Kolonel Silvertopstraat
651,Kolonel Silvertopstraat 5333,2023-08-17,19:00:00,216,133,83,FMN 03 Kolonel Silvertopstraat
651,Kolonel Silvertopstraat 5333,2023-08-17,20:00:00,154,102,52,FMN 03 Kolonel Silvertopstraat
651,Kolonel Silvertopstraat 5333,2023-08-17,21:00:00,149,75,74,FMN 03 Kolonel Silvertopstraat
651,Kolonel Silvertopstraat 5333,2023-08-17,22:00:00,122,68,54,FMN 03 Kolonel Silvertopstraat
651,Kolonel Silvertopstraat 5333,2023-08-17,23:00:00,75,31,44,FMN 03 Kolonel Silvertopstraat
651,Kolonel Silvertopstraat 5333,2023-08-18,00:00:00,53,25,28,FMN 03 Kolonel Silvertopstraat
651,Kolonel Silvertopstraat 5333,2023-08-18,01:00:00,24,12,12,FMN 03 Kolonel Silvertopstraat
651,Kolonel Silvertopstraat 5333,2023-08-18,02:00:00,21,11,10,FMN 03 Kolonel Silvertopstraat
651,Kolonel Silvertopstraat 5333,2023-08-18,03:00:00,13,7,6,FMN 03 Kolonel Silvertopstraat
651,Kolonel Silvertopstraat 5333,2023-08-18,04:00:00,31,26,5,FMN 03 Kolonel Silvertopstraat
651,Kolonel Silvertopstraat 5333,2023-08-18,05:00:00,61,38,23,FMN 03 Kolonel Silvertopstraat
651,Kolonel Silvertopstraat 5333,2023-08-18,06:00:00,102,80,22,FMN 03 Kolonel Silvertopstraat
651,Kolonel Silvertopstraat 5333,2023-08-18,07:00:00,162,124,38,FMN 03 Kolonel Silvertopstraat
651,Kolonel Silvertopstraat 5333,2023-08-18,08:00:00,301,242,59,FMN 03 Kolonel Silvertopstraat
651,Kolonel Silvertopstraat 5333,2023-08-18,09:00:00,221,175,46,FMN 03 Kolonel Silvertopstraat
651,Kolonel Silvertopstraat 5333,2023-08-18,10:00:00,159,122,37,FMN 03 Kolonel Silvertopstraat
651,Kolonel Silvertopstraat 5333,2023-08-18,11:00:00,158,116,42,FMN 03 Kolonel Silvertopstraat
651,Kolonel Silvertopstraat 5333,2023-08-18,12:00:00,202,149,53,FMN 03 Kolonel Silvertopstraat
651,Kolonel Silvertopstraat 5333,2023-08-18,13:00:00,199,143,56,FMN 03 Kolonel Silvertopstraat
651,Kolonel Silvertopstraat 5333,2023-08-18,14:00:00,220,152,68,FMN 03 Kolonel Silvertopstraat
651,Kolonel Silvertopstraat 5333,2023-08-18,15:00:00,282,196,86,FMN 03 Kolonel Silvertopstraat
651,Kolonel Silvertopstraat 5333,2023-08-18,16:00:00,318,215,103,FMN 03 Kolonel Silvertopstraat
651,Kolonel Silvertopstraat 5333,2023-08-18,17:00:00,363,241,122,FMN 03 Kolonel Silvertopstraat
651,Kolonel Silvertopstraat 5333,2023-08-18,18:00:00,280,192,88,FMN 03 Kolonel Silvertopstraat
651,Kolonel Silvertopstraat 5333,2023-08-18,19:00:00,254,175,79,FMN 03 Kolonel Silvertopstraat
651,Kolonel Silvertopstraat 5333,2023-08-18,20:00:00,237,178,59,FMN 03 Kolonel Silvertopstraat
651,Kolonel Silvertopstraat 5333,2023-08-18,21:00:00,194,135,59,FMN 03 Kolonel Silvertopstraat
651,Kolonel Silvertopstraat 5333,2023-08-18,22:00:00,147,99,48,FMN 03 Kolonel Silvertopstraat
651,Kolonel Silvertopstraat 5333,2023-08-18,23:00:00,111,47,64,FMN 03 Kolonel Silvertopstraat
651,Kolonel Silvertopstraat 5333,2023-08-19,00:00:00,106,36,70,FMN 03 Kolonel Silvertopstraat
651,Kolonel Silvertopstraat 5333,2023-08-19,01:00:00,70,21,49,FMN 03 Kolonel Silvertopstraat
651,Kolonel Silvertopstraat 5333,2023-08-19,02:00:00,43,10,33,FMN 03 Kolonel Silvertopstraat
651,Kolonel Silvertopstraat 5333,2023-08-19,03:00:00,42,13,29,FMN 03 Kolonel Silvertopstraat
651,Kolonel Silvertopstraat 5333,2023-08-19,04:00:00,29,15,14,FMN 03 Kolonel Silvertopstraat
651,Kolonel Silvertopstraat 5333,2023-08-19,05:00:00,30,17,13,FMN 03 Kolonel Silvertopstraat
651,Kolonel Silvertopstraat 5333,2023-08-19,06:00:00,48,30,18,FMN 03 Kolonel Silvertopstraat
651,Kolonel Silvertopstraat 5333,2023-08-19,07:00:00,37,25,12,FMN 03 Kolonel Silvertopstraat
651,Kolonel Silvertopstraat 5333,2023-08-19,08:00:00,93,69,24,FMN 03 Kolonel Silvertopstraat
651,Kolonel Silvertopstraat 5333,2023-08-19,09:00:00,133,101,32,FMN 03 Kolonel Silvertopstraat
651,Kolonel Silvertopstraat 5333,2023-08-19,10:00:00,154,126,28,FMN 03 Kolonel Silvertopstraat
651,Kolonel Silvertopstraat 5333,2023-08-19,11:00:00,196,143,53,FMN 03 Kolonel Silvertopstraat
651,Kolonel Silvertopstraat 5333,2023-08-19,12:00:00,187,125,62,FMN 03 Kolonel Silvertopstraat
651,Kolonel Silvertopstraat 5333,2023-08-19,13:00:00,233,176,57,FMN 03 Kolonel Silvertopstraat
651,Kolonel Silvertopstraat 5333,2023-08-19,14:00:00,233,159,74,FMN 03 Kolonel Silvertopstraat
651,Kolonel Silvertopstraat 5333,2023-08-19,15:00:00,247,160,87,FMN 03 Kolonel Silvertopstraat
651,Kolonel Silvertopstraat 5333,2023-08-19,16:00:00,218,144,74,FMN 03 Kolonel Silvertopstraat
651,Kolonel Silvertopstraat 5333,2023-08-19,17:00:00,227,158,69,FMN 03 Kolonel Silvertopstraat
651,Kolonel Silvertopstraat 5333,2023-08-19,18:00:00,295,238,57,FMN 03 Kolonel Silvertopstraat
651,Kolonel Silvertopstraat 5333,2023-08-19,19:00:00,230,183,47,FMN 03 Kolonel Silvertopstraat
651,Kolonel Silvertopstraat 5333,2023-08-19,20:00:00,198,143,55,FMN 03 Kolonel Silvertopstraat
651,Kolonel Silvertopstraat 5333,2023-08-19,21:00:00,145,86,59,FMN 03 Kolonel Silvertopstraat
651,Kolonel Silvertopstraat 5333,2023-08-19,22:00:00,125,67,58,FMN 03 Kolonel Silvertopstraat
651,Kolonel Silvertopstraat 5333,2023-08-19,23:00:00,126,60,66,FMN 03 Kolonel Silvertopstraat
651,Kolonel Silvertopstraat 5333,2023-08-20,00:00:00,76,32,44,FMN 03 Kolonel Silvertopstraat
651,Kolonel Silvertopstraat 5333,2023-08-20,01:00:00,54,23,31,FMN 03 Kolonel Silvertopstraat
651,Kolonel Silvertopstraat 5333,2023-08-20,02:00:00,39,25,14,FMN 03 Kolonel Silvertopstraat
651,Kolonel Silvertopstraat 5333,2023-08-20,03:00:00,36,11,25,FMN 03 Kolonel Silvertopstraat
651,Kolonel Silvertopstraat 5333,2023-08-20,04:00:00,16,6,10,FMN 03 Kolonel Silvertopstraat
651,Kolonel Silvertopstraat 5333,2023-08-20,05:00:00,27,16,11,FMN 03 Kolonel Silvertopstraat
651,Kolonel Silvertopstraat 5333,2023-08-20,06:00:00,29,23,6,FMN 03 Kolonel Silvertopstraat
651,Kolonel Silvertopstraat 5333,2023-08-20,07:00:00,34,23,11,FMN 03 Kolonel Silvertopstraat
651,Kolonel Silvertopstraat 5333,2023-08-20,08:00:00,63,46,17,FMN 03 Kolonel Silvertopstraat
651,Kolonel Silvertopstraat 5333,2023-08-20,09:00:00,115,90,25,FMN 03 Kolonel Silvertopstraat
651,Kolonel Silvertopstraat 5333,2023-08-20,10:00:00,140,124,16,FMN 03 Kolonel Silvertopstraat
651,Kolonel Silvertopstraat 5333,2023-08-20,11:00:00,134,98,36,FMN 03 Kolonel Silvertopstraat
651,Kolonel Silvertopstraat 5333,2023-08-20,12:00:00,158,112,46,FMN 03 Kolonel Silvertopstraat
651,Kolonel Silvertopstraat 5333,2023-08-20,13:00:00,163,123,40,FMN 03 Kolonel Silvertopstraat
651,Kolonel Silvertopstraat 5333,2023-08-20,14:00:00,223,180,43,FMN 03 Kolonel Silvertopstraat
651,Kolonel Silvertopstraat 5333,2023-08-20,15:00:00,219,171,48,FMN 03 Kolonel Silvertopstraat
651,Kolonel Silvertopstraat 5333,2023-08-20,16:00:00,201,129,72,FMN 03 Kolonel Silvertopstraat
651,Kolonel Silvertopstraat 5333,2023-08-20,17:00:00,184,130,54,FMN 03 Kolonel Silvertopstraat
651,Kolonel Silvertopstraat 5333,2023-08-20,18:00:00,179,106,73,FMN 03 Kolonel Silvertopstraat
651,Kolonel Silvertopstraat 5333,2023-08-20,19:00:00,178,130,48,FMN 03 Kolonel Silvertopstraat
651,Kolonel Silvertopstraat 5333,2023-08-20,20:00:00,182,112,70,FMN 03 Kolonel Silvertopstraat
651,Kolonel Silvertopstraat 5333,2023-08-20,21:00:00,156,81,75,FMN 03 Kolonel Silvertopstraat
651,Kolonel Silvertopstraat 5333,2023-08-20,22:00:00,117,56,61,FMN 03 Kolonel Silvertopstraat
651,Kolonel Silvertopstraat 5333,2023-08-20,23:00:00,61,30,31,FMN 03 Kolonel Silvertopstraat
651,Kolonel Silvertopstraat 5333,2023-08-21,00:00:00,49,16,33,FMN 03 Kolonel Silvertopstraat
651,Kolonel Silvertopstraat 5333,2023-08-21,01:00:00,27,14,13,FMN 03 Kolonel Silvertopstraat
651,Kolonel Silvertopstraat 5333,2023-08-21,02:00:00,14,3,11,FMN 03 Kolonel Silvertopstraat
651,Kolonel Silvertopstraat 5333,2023-08-21,03:00:00,10,4,6,FMN 03 Kolonel Silvertopstraat
651,Kolonel Silvertopstraat 5333,2023-08-21,04:00:00,41,34,7,FMN 03 Kolonel Silvertopstraat
651,Kolonel Silvertopstraat 5333,2023-08-21,05:00:00,62,33,29,FMN 03 Kolonel Silvertopstraat
651,Kolonel Silvertopstraat 5333,2023-08-21,06:00:00,133,111,22,FMN 03 Kolonel Silvertopstraat
651,Kolonel Silvertopstraat 5333,2023-08-21,07:00:00,230,180,50,FMN 03 Kolonel Silvertopstraat
651,Kolonel Silvertopstraat 5333,2023-08-21,08:00:00,385,324,61,FMN 03 Kolonel Silvertopstraat
651,Kolonel Silvertopstraat 5333,2023-08-21,09:00:00,237,200,37,FMN 03 Kolonel Silvertopstraat
651,Kolonel Silvertopstraat 5333,2023-08-21,10:00:00,172,139,33,FMN 03 Kolonel Silvertopstraat
651,Kolonel Silvertopstraat 5333,2023-08-21,11:00:00,149,113,36,FMN 03 Kolonel Silvertopstraat
651,Kolonel Silvertopstraat 5333,2023-08-21,12:00:00,206,148,58,FMN 03 Kolonel Silvertopstraat
651,Kolonel Silvertopstraat 5333,2023-08-21,13:00:00,183,127,56,FMN 03 Kolonel Silvertopstraat
651,Kolonel Silvertopstraat 5333,2023-08-21,14:00:00,225,154,71,FMN 03 Kolonel Silvertopstraat
651,Kolonel Silvertopstraat 5333,2023-08-21,15:00:00,232,171,61,FMN 03 Kolonel Silvertopstraat
651,Kolonel Silvertopstraat 5333,2023-08-21,16:00:00,337,238,99,FMN 03 Kolonel Silvertopstraat
651,Kolonel Silvertopstraat 5333,2023-08-21,17:00:00,394,244,150,FMN 03 Kolonel Silvertopstraat
651,Kolonel Silvertopstraat 5333,2023-08-21,18:00:00,296,196,100,FMN 03 Kolonel Silvertopstraat
651,Kolonel Silvertopstraat 5333,2023-08-21,19:00:00,225,154,71,FMN 03 Kolonel Silvertopstraat
651,Kolonel Silvertopstraat 5333,2023-08-21,20:00:00,224,143,81,FMN 03 Kolonel Silvertopstraat
651,Kolonel Silvertopstraat 5333,2023-08-21,21:00:00,116,67,49,FMN 03 Kolonel Silvertopstraat
651,Kolonel Silvertopstraat 5333,2023-08-21,22:00:00,151,81,70,FMN 03 Kolonel Silvertopstraat
651,Kolonel Silvertopstraat 5333,2023-08-21,23:00:00,74,25,49,FMN 03 Kolonel Silvertopstraat
651,Kolonel Silvertopstraat 5333,2023-08-22,00:00:00,34,12,22,FMN 03 Kolonel Silvertopstraat
651,Kolonel Silvertopstraat 5333,2023-08-22,01:00:00,18,4,14,FMN 03 Kolonel Silvertopstraat
651,Kolonel Silvertopstraat 5333,2023-08-22,02:00:00,17,11,6,FMN 03 Kolonel Silvertopstraat
651,Kolonel Silvertopstraat 5333,2023-08-22,03:00:00,10,5,5,FMN 03 Kolonel Silvertopstraat
651,Kolonel Silvertopstraat 5333,2023-08-22,04:00:00,42,33,9,FMN 03 Kolonel Silvertopstraat
651,Kolonel Silvertopstraat 5333,2023-08-22,05:00:00,64,37,27,FMN 03 Kolonel Silvertopstraat
651,Kolonel Silvertopstraat 5333,2023-08-22,06:00:00,139,113,26,FMN 03 Kolonel Silvertopstraat
651,Kolonel Silvertopstraat 5333,2023-08-22,07:00:00,269,212,57,FMN 03 Kolonel Silvertopstraat
651,Kolonel Silvertopstraat 5333,2023-08-22,08:00:00,478,402,76,FMN 03 Kolonel Silvertopstraat
651,Kolonel Silvertopstraat 5333,2023-08-22,09:00:00,262,205,57,FMN 03 Kolonel Silvertopstraat
651,Kolonel Silvertopstraat 5333,2023-08-22,10:00:00,190,146,44,FMN 03 Kolonel Silvertopstraat
651,Kolonel Silvertopstraat 5333,2023-08-22,11:00:00,158,123,35,FMN 03 Kolonel Silvertopstraat
651,Kolonel Silvertopstraat 5333,2023-08-22,12:00:00,207,151,56,FMN 03 Kolonel Silvertopstraat
651,Kolonel Silvertopstraat 5333,2023-08-22,13:00:00,202,143,59,FMN 03 Kolonel Silvertopstraat
651,Kolonel Silvertopstraat 5333,2023-08-22,14:00:00,249,173,76,FMN 03 Kolonel Silvertopstraat
651,Kolonel Silvertopstraat 5333,2023-08-22,15:00:00,267,167,100,FMN 03 Kolonel Silvertopstraat
651,Kolonel Silvertopstraat 5333,2023-08-22,16:00:00,345,235,110,FMN 03 Kolonel Silvertopstraat
651,Kolonel Silvertopstraat 5333,2023-08-22,17:00:00,430,268,162,FMN 03 Kolonel Silvertopstraat
651,Kolonel Silvertopstraat 5333,2023-08-22,18:00:00,336,207,129,FMN 03 Kolonel Silvertopstraat
651,Kolonel Silvertopstraat 5333,2023-08-22,19:00:00,234,160,74,FMN 03 Kolonel Silvertopstraat
651,Kolonel Silvertopstraat 5333,2023-08-22,20:00:00,187,121,66,FMN 03 Kolonel Silvertopstraat
651,Kolonel Silvertopstraat 5333,2023-08-22,21:00:00,165,99,66,FMN 03 Kolonel Silvertopstraat
651,Kolonel Silvertopstraat 5333,2023-08-22,22:00:00,131,74,57,FMN 03 Kolonel Silvertopstraat
651,Kolonel Silvertopstraat 5333,2023-08-22,23:00:00,109,45,64,FMN 03 Kolonel Silvertopstraat
651,Kolonel Silvertopstraat 5333,2023-08-23,00:00:00,51,27,24,FMN 03 Kolonel Silvertopstraat
651,Kolonel Silvertopstraat 5333,2023-08-23,01:00:00,27,11,16,FMN 03 Kolonel Silvertopstraat
651,Kolonel Silvertopstraat 5333,2023-08-23,02:00:00,16,7,9,FMN 03 Kolonel Silvertopstraat
651,Kolonel Silvertopstraat 5333,2023-08-23,03:00:00,13,6,7,FMN 03 Kolonel Silvertopstraat
651,Kolonel Silvertopstraat 5333,2023-08-23,04:00:00,35,27,8,FMN 03 Kolonel Silvertopstraat
651,Kolonel Silvertopstraat 5333,2023-08-23,05:00:00,66,39,27,FMN 03 Kolonel Silvertopstraat
651,Kolonel Silvertopstraat 5333,2023-08-23,06:00:00,131,113,18,FMN 03 Kolonel Silvertopstraat
651,Kolonel Silvertopstraat 5333,2023-08-23,07:00:00,252,185,67,FMN 03 Kolonel Silvertopstraat
651,Kolonel Silvertopstraat 5333,2023-08-23,08:00:00,384,323,61,FMN 03 Kolonel Silvertopstraat
651,Kolonel Silvertopstraat 5333,2023-08-23,09:00:00,281,213,68,FMN 03 Kolonel Silvertopstraat
651,Kolonel Silvertopstraat 5333,2023-08-23,10:00:00,177,134,43,FMN 03 Kolonel Silvertopstraat
651,Kolonel Silvertopstraat 5333,2023-08-23,11:00:00,179,125,54,FMN 03 Kolonel Silvertopstraat
651,Kolonel Silvertopstraat 5333,2023-08-23,12:00:00,249,178,71,FMN 03 Kolonel Silvertopstraat
651,Kolonel Silvertopstraat 5333,2023-08-23,13:00:00,201,143,58,FMN 03 Kolonel Silvertopstraat
651,Kolonel Silvertopstraat 5333,2023-08-23,14:00:00,203,148,55,FMN 03 Kolonel Silvertopstraat
651,Kolonel Silvertopstraat 5333,2023-08-23,15:00:00,270,185,85,FMN 03 Kolonel Silvertopstraat
651,Kolonel Silvertopstraat 5333,2023-08-23,16:00:00,357,245,112,FMN 03 Kolonel Silvertopstraat
651,Kolonel Silvertopstraat 5333,2023-08-23,17:00:00,427,283,144,FMN 03 Kolonel Silvertopstraat
651,Kolonel Silvertopstraat 5333,2023-08-23,18:00:00,305,214,91,FMN 03 Kolonel Silvertopstraat
651,Kolonel Silvertopstraat 5333,2023-08-23,19:00:00,275,177,98,FMN 03 Kolonel Silvertopstraat
651,Kolonel Silvertopstraat 5333,2023-08-23,20:00:00,206,125,81,FMN 03 Kolonel Silvertopstraat
651,Kolonel Silvertopstraat 5333,2023-08-23,21:00:00,165,83,82,FMN 03 Kolonel Silvertopstraat
651,Kolonel Silvertopstraat 5333,2023-08-23,22:00:00,118,68,50,FMN 03 Kolonel Silvertopstraat
651,Kolonel Silvertopstraat 5333,2023-08-23,23:00:00,95,44,51,FMN 03 Kolonel Silvertopstraat
651,Kolonel Silvertopstraat 5333,2023-08-24,00:00:00,51,27,24,FMN 03 Kolonel Silvertopstraat
651,Kolonel Silvertopstraat 5333,2023-08-24,01:00:00,47,27,20,FMN 03 Kolonel Silvertopstraat
651,Kolonel Silvertopstraat 5333,2023-08-24,02:00:00,20,15,5,FMN 03 Kolonel Silvertopstraat
651,Kolonel Silvertopstraat 5333,2023-08-24,03:00:00,23,9,14,FMN 03 Kolonel Silvertopstraat
651,Kolonel Silvertopstraat 5333,2023-08-24,04:00:00,31,24,7,FMN 03 Kolonel Silvertopstraat
651,Kolonel Silvertopstraat 5333,2023-08-24,05:00:00,56,33,23,FMN 03 Kolonel Silvertopstraat
651,Kolonel Silvertopstraat 5333,2023-08-24,06:00:00,132,108,24,FMN 03 Kolonel Silvertopstraat
651,Kolonel Silvertopstraat 5333,2023-08-24,07:00:00,235,182,53,FMN 03 Kolonel Silvertopstraat
651,Kolonel Silvertopstraat 5333,2023-08-24,08:00:00,436,356,80,FMN 03 Kolonel Silvertopstraat
651,Kolonel Silvertopstraat 5333,2023-08-24,09:00:00,270,221,49,FMN 03 Kolonel Silvertopstraat
651,Kolonel Silvertopstraat 5333,2023-08-24,10:00:00,191,147,44,FMN 03 Kolonel Silvertopstraat
651,Kolonel Silvertopstraat 5333,2023-08-24,11:00:00,164,128,36,FMN 03 Kolonel Silvertopstraat
651,Kolonel Silvertopstraat 5333,2023-08-24,12:00:00,174,127,47,FMN 03 Kolonel Silvertopstraat
651,Kolonel Silvertopstraat 5333,2023-08-24,13:00:00,174,116,58,FMN 03 Kolonel Silvertopstraat
651,Kolonel Silvertopstraat 5333,2023-08-24,14:00:00,214,146,68,FMN 03 Kolonel Silvertopstraat
651,Kolonel Silvertopstraat 5333,2023-08-24,15:00:00,235,147,88,FMN 03 Kolonel Silvertopstraat
651,Kolonel Silvertopstraat 5333,2023-08-24,16:00:00,361,226,135,FMN 03 Kolonel Silvertopstraat
651,Kolonel Silvertopstraat 5333,2023-08-24,17:00:00,376,241,135,FMN 03 Kolonel Silvertopstraat
651,Kolonel Silvertopstraat 5333,2023-08-24,18:00:00,305,203,102,FMN 03 Kolonel Silvertopstraat
651,Kolonel Silvertopstraat 5333,2023-08-24,19:00:00,196,134,62,FMN 03 Kolonel Silvertopstraat
651,Kolonel Silvertopstraat 5333,2023-08-24,20:00:00,196,124,72,FMN 03 Kolonel Silvertopstraat
651,Kolonel Silvertopstraat 5333,2023-08-24,21:00:00,132,73,59,FMN 03 Kolonel Silvertopstraat
651,Kolonel Silvertopstraat 5333,2023-08-24,22:00:00,107,57,50,FMN 03 Kolonel Silvertopstraat
651,Kolonel Silvertopstraat 5333,2023-08-24,23:00:00,71,37,34,FMN 03 Kolonel Silvertopstraat
651,Kolonel Silvertopstraat 5333,2023-08-25,00:00:00,36,14,22,FMN 03 Kolonel Silvertopstraat
651,Kolonel Silvertopstraat 5333,2023-08-25,01:00:00,28,8,20,FMN 03 Kolonel Silvertopstraat
651,Kolonel Silvertopstraat 5333,2023-08-25,02:00:00,26,13,13,FMN 03 Kolonel Silvertopstraat
651,Kolonel Silvertopstraat 5333,2023-08-25,03:00:00,14,7,7,FMN 03 Kolonel Silvertopstraat
651,Kolonel Silvertopstraat 5333,2023-08-25,04:00:00,28,25,3,FMN 03 Kolonel Silvertopstraat
651,Kolonel Silvertopstraat 5333,2023-08-25,05:00:00,63,42,21,FMN 03 Kolonel Silvertopstraat
651,Kolonel Silvertopstraat 5333,2023-08-25,06:00:00,111,86,25,FMN 03 Kolonel Silvertopstraat
651,Kolonel Silvertopstraat 5333,2023-08-25,07:00:00,179,136,43,FMN 03 Kolonel Silvertopstraat
651,Kolonel Silvertopstraat 5333,2023-08-25,08:00:00,281,226,55,FMN 03 Kolonel Silvertopstraat
651,Kolonel Silvertopstraat 5333,2023-08-25,09:00:00,187,146,41,FMN 03 Kolonel Silvertopstraat
651,Kolonel Silvertopstraat 5333,2023-08-25,10:00:00,190,146,44,FMN 03 Kolonel Silvertopstraat
651,Kolonel Silvertopstraat 5333,2023-08-25,11:00:00,149,112,37,FMN 03 Kolonel Silvertopstraat
651,Kolonel Silvertopstraat 5333,2023-08-25,12:00:00,235,176,59,FMN 03 Kolonel Silvertopstraat
651,Kolonel Silvertopstraat 5333,2023-08-25,13:00:00,240,162,78,FMN 03 Kolonel Silvertopstraat
651,Kolonel Silvertopstraat 5333,2023-08-25,14:00:00,273,192,81,FMN 03 Kolonel Silvertopstraat
651,Kolonel Silvertopstraat 5333,2023-08-25,15:00:00,274,170,104,FMN 03 Kolonel Silvertopstraat
651,Kolonel Silvertopstraat 5333,2023-08-25,16:00:00,308,209,99,FMN 03 Kolonel Silvertopstraat
651,Kolonel Silvertopstraat 5333,2023-08-25,17:00:00,310,201,109,FMN 03 Kolonel Silvertopstraat
651,Kolonel Silvertopstraat 5333,2023-08-25,18:00:00,319,196,123,FMN 03 Kolonel Silvertopstraat
651,Kolonel Silvertopstraat 5333,2023-08-25,19:00:00,188,121,67,FMN 03 Kolonel Silvertopstraat
651,Kolonel Silvertopstraat 5333,2023-08-25,20:00:00,160,95,65,FMN 03 Kolonel Silvertopstraat
651,Kolonel Silvertopstraat 5333,2023-08-25,21:00:00,127,82,45,FMN 03 Kolonel Silvertopstraat
651,Kolonel Silvertopstraat 5333,2023-08-25,22:00:00,118,69,49,FMN 03 Kolonel Silvertopstraat
651,Kolonel Silvertopstraat 5333,2023-08-25,23:00:00,101,50,51,FMN 03 Kolonel Silvertopstraat
651,Kolonel Silvertopstraat 5333,2023-08-26,00:00:00,86,40,46,FMN 03 Kolonel Silvertopstraat
651,Kolonel Silvertopstraat 5333,2023-08-26,01:00:00,50,25,25,FMN 03 Kolonel Silvertopstraat
651,Kolonel Silvertopstraat 5333,2023-08-26,02:00:00,38,16,22,FMN 03 Kolonel Silvertopstraat
651,Kolonel Silvertopstraat 5333,2023-08-26,03:00:00,23,9,14,FMN 03 Kolonel Silvertopstraat
651,Kolonel Silvertopstraat 5333,2023-08-26,04:00:00,23,12,11,FMN 03 Kolonel Silvertopstraat
651,Kolonel Silvertopstraat 5333,2023-08-26,05:00:00,32,20,12,FMN 03 Kolonel Silvertopstraat
651,Kolonel Silvertopstraat 5333,2023-08-26,06:00:00,29,21,8,FMN 03 Kolonel Silvertopstraat
651,Kolonel Silvertopstraat 5333,2023-08-26,07:00:00,38,27,11,FMN 03 Kolonel Silvertopstraat
651,Kolonel Silvertopstraat 5333,2023-08-26,08:00:00,82,64,18,FMN 03 Kolonel Silvertopstraat
651,Kolonel Silvertopstraat 5333,2023-08-26,09:00:00,172,149,23,FMN 03 Kolonel Silvertopstraat
651,Kolonel Silvertopstraat 5333,2023-08-26,10:00:00,232,179,53,FMN 03 Kolonel Silvertopstraat
651,Kolonel Silvertopstraat 5333,2023-08-26,11:00:00,234,177,57,FMN 03 Kolonel Silvertopstraat
651,Kolonel Silvertopstraat 5333,2023-08-26,12:00:00,226,173,53,FMN 03 Kolonel Silvertopstraat
651,Kolonel Silvertopstraat 5333,2023-08-26,13:00:00,216,155,61,FMN 03 Kolonel Silvertopstraat
651,Kolonel Silvertopstraat 5333,2023-08-26,14:00:00,251,165,86,FMN 03 Kolonel Silvertopstraat
651,Kolonel Silvertopstraat 5333,2023-08-26,15:00:00,256,194,62,FMN 03 Kolonel Silvertopstraat
651,Kolonel Silvertopstraat 5333,2023-08-26,16:00:00,226,161,65,FMN 03 Kolonel Silvertopstraat
651,Kolonel Silvertopstraat 5333,2023-08-26,17:00:00,227,156,71,FMN 03 Kolonel Silvertopstraat
651,Kolonel Silvertopstraat 5333,2023-08-26,18:00:00,210,111,99,FMN 03 Kolonel Silvertopstraat
651,Kolonel Silvertopstraat 5333,2023-08-26,19:00:00,207,141,66,FMN 03 Kolonel Silvertopstraat
651,Kolonel Silvertopstraat 5333,2023-08-26,20:00:00,178,119,59,FMN 03 Kolonel Silvertopstraat
651,Kolonel Silvertopstraat 5333,2023-08-26,21:00:00,136,81,55,FMN 03 Kolonel Silvertopstraat
651,Kolonel Silvertopstraat 5333,2023-08-26,22:00:00,113,56,57,FMN 03 Kolonel Silvertopstraat
651,Kolonel Silvertopstraat 5333,2023-08-26,23:00:00,83,34,49,FMN 03 Kolonel Silvertopstraat
651,Kolonel Silvertopstraat 5333,2023-08-27,00:00:00,66,36,30,FMN 03 Kolonel Silvertopstraat
651,Kolonel Silvertopstraat 5333,2023-08-27,01:00:00,58,26,32,FMN 03 Kolonel Silvertopstraat
651,Kolonel Silvertopstraat 5333,2023-08-27,02:00:00,44,17,27,FMN 03 Kolonel Silvertopstraat
651,Kolonel Silvertopstraat 5333,2023-08-27,03:00:00,29,13,16,FMN 03 Kolonel Silvertopstraat
651,Kolonel Silvertopstraat 5333,2023-08-27,04:00:00,16,10,6,FMN 03 Kolonel Silvertopstraat
651,Kolonel Silvertopstraat 5333,2023-08-27,05:00:00,22,12,10,FMN 03 Kolonel Silvertopstraat
651,Kolonel Silvertopstraat 5333,2023-08-27,06:00:00,34,23,11,FMN 03 Kolonel Silvertopstraat
651,Kolonel Silvertopstraat 5333,2023-08-27,07:00:00,22,16,6,FMN 03 Kolonel Silvertopstraat
651,Kolonel Silvertopstraat 5333,2023-08-27,08:00:00,76,61,15,FMN 03 Kolonel Silvertopstraat
651,Kolonel Silvertopstraat 5333,2023-08-27,09:00:00,223,196,27,FMN 03 Kolonel Silvertopstraat
651,Kolonel Silvertopstraat 5333,2023-08-27,10:00:00,205,175,30,FMN 03 Kolonel Silvertopstraat
651,Kolonel Silvertopstraat 5333,2023-08-27,11:00:00,236,173,63,FMN 03 Kolonel Silvertopstraat
651,Kolonel Silvertopstraat 5333,2023-08-27,12:00:00,248,169,79,FMN 03 Kolonel Silvertopstraat
651,Kolonel Silvertopstraat 5333,2023-08-27,13:00:00,150,94,56,FMN 03 Kolonel Silvertopstraat
651,Kolonel Silvertopstraat 5333,2023-08-27,14:00:00,245,193,52,FMN 03 Kolonel Silvertopstraat
651,Kolonel Silvertopstraat 5333,2023-08-27,15:00:00,207,173,34,FMN 03 Kolonel Silvertopstraat
651,Kolonel Silvertopstraat 5333,2023-08-27,16:00:00,255,200,55,FMN 03 Kolonel Silvertopstraat
651,Kolonel Silvertopstraat 5333,2023-08-27,17:00:00,197,122,75,FMN 03 Kolonel Silvertopstraat
651,Kolonel Silvertopstraat 5333,2023-08-27,18:00:00,188,110,78,FMN 03 Kolonel Silvertopstraat
651,Kolonel Silvertopstraat 5333,2023-08-27,19:00:00,166,105,61,FMN 03 Kolonel Silvertopstraat
651,Kolonel Silvertopstraat 5333,2023-08-27,20:00:00,168,108,60,FMN 03 Kolonel Silvertopstraat
651,Kolonel Silvertopstraat 5333,2023-08-27,21:00:00,115,59,56,FMN 03 Kolonel Silvertopstraat
651,Kolonel Silvertopstraat 5333,2023-08-27,22:00:00,93,47,46,FMN 03 Kolonel Silvertopstraat
651,Kolonel Silvertopstraat 5333,2023-08-27,23:00:00,56,30,26,FMN 03 Kolonel Silvertopstraat
651,Kolonel Silvertopstraat 5333,2023-08-28,00:00:00,40,16,24,FMN 03 Kolonel Silvertopstraat
651,Kolonel Silvertopstraat 5333,2023-08-28,01:00:00,24,7,17,FMN 03 Kolonel Silvertopstraat
651,Kolonel Silvertopstraat 5333,2023-08-28,02:00:00,10,7,3,FMN 03 Kolonel Silvertopstraat
651,Kolonel Silvertopstraat 5333,2023-08-28,03:00:00,12,5,7,FMN 03 Kolonel Silvertopstraat
651,Kolonel Silvertopstraat 5333,2023-08-28,04:00:00,31,25,6,FMN 03 Kolonel Silvertopstraat
651,Kolonel Silvertopstraat 5333,2023-08-28,05:00:00,52,30,22,FMN 03 Kolonel Silvertopstraat
651,Kolonel Silvertopstraat 5333,2023-08-28,06:00:00,101,84,17,FMN 03 Kolonel Silvertopstraat
651,Kolonel Silvertopstraat 5333,2023-08-28,07:00:00,243,197,46,FMN 03 Kolonel Silvertopstraat
651,Kolonel Silvertopstraat 5333,2023-08-28,08:00:00,413,340,73,FMN 03 Kolonel Silvertopstraat
651,Kolonel Silvertopstraat 5333,2023-08-28,09:00:00,250,208,42,FMN 03 Kolonel Silvertopstraat
651,Kolonel Silvertopstraat 5333,2023-08-28,10:00:00,176,126,50,FMN 03 Kolonel Silvertopstraat
651,Kolonel Silvertopstraat 5333,2023-08-28,11:00:00,147,115,32,FMN 03 Kolonel Silvertopstraat
651,Kolonel Silvertopstraat 5333,2023-08-28,12:00:00,216,141,75,FMN 03 Kolonel Silvertopstraat
651,Kolonel Silvertopstraat 5333,2023-08-28,13:00:00,198,144,54,FMN 03 Kolonel Silvertopstraat
651,Kolonel Silvertopstraat 5333,2023-08-28,14:00:00,194,134,60,FMN 03 Kolonel Silvertopstraat
651,Kolonel Silvertopstraat 5333,2023-08-28,15:00:00,248,166,82,FMN 03 Kolonel Silvertopstraat
651,Kolonel Silvertopstraat 5333,2023-08-28,16:00:00,272,185,87,FMN 03 Kolonel Silvertopstraat
651,Kolonel Silvertopstraat 5333,2023-08-28,17:00:00,349,229,120,FMN 03 Kolonel Silvertopstraat
651,Kolonel Silvertopstraat 5333,2023-08-28,18:00:00,189,109,80,FMN 03 Kolonel Silvertopstraat
651,Kolonel Silvertopstraat 5333,2023-08-28,19:00:00,160,89,71,FMN 03 Kolonel Silvertopstraat
651,Kolonel Silvertopstraat 5333,2023-08-28,20:00:00,134,86,48,FMN 03 Kolonel Silvertopstraat
651,Kolonel Silvertopstraat 5333,2023-08-28,21:00:00,95,58,37,FMN 03 Kolonel Silvertopstraat
651,Kolonel Silvertopstraat 5333,2023-08-28,22:00:00,97,58,39,FMN 03 Kolonel Silvertopstraat
651,Kolonel Silvertopstraat 5333,2023-08-28,23:00:00,53,18,35,FMN 03 Kolonel Silvertopstraat
651,Kolonel Silvertopstraat 5333,2023-08-29,00:00:00,44,17,27,FMN 03 Kolonel Silvertopstraat
651,Kolonel Silvertopstraat 5333,2023-08-29,01:00:00,23,13,10,FMN 03 Kolonel Silvertopstraat
651,Kolonel Silvertopstraat 5333,2023-08-29,02:00:00,17,10,7,FMN 03 Kolonel Silvertopstraat
651,Kolonel Silvertopstraat 5333,2023-08-29,03:00:00,17,9,8,FMN 03 Kolonel Silvertopstraat
651,Kolonel Silvertopstraat 5333,2023-08-29,04:00:00,24,20,4,FMN 03 Kolonel Silvertopstraat
651,Kolonel Silvertopstraat 5333,2023-08-29,05:00:00,45,27,18,FMN 03 Kolonel Silvertopstraat
651,Kolonel Silvertopstraat 5333,2023-08-29,06:00:00,116,96,20,FMN 03 Kolonel Silvertopstraat
651,Kolonel Silvertopstraat 5333,2023-08-29,07:00:00,262,210,52,FMN 03 Kolonel Silvertopstraat
651,Kolonel Silvertopstraat 5333,2023-08-29,08:00:00,451,373,78,FMN 03 Kolonel Silvertopstraat
651,Kolonel Silvertopstraat 5333,2023-08-29,09:00:00,254,211,43,FMN 03 Kolonel Silvertopstraat
651,Kolonel Silvertopstraat 5333,2023-08-29,10:00:00,165,130,35,FMN 03 Kolonel Silvertopstraat
651,Kolonel Silvertopstraat 5333,2023-08-29,11:00:00,172,131,41,FMN 03 Kolonel Silvertopstraat
651,Kolonel Silvertopstraat 5333,2023-08-29,12:00:00,211,153,58,FMN 03 Kolonel Silvertopstraat
651,Kolonel Silvertopstraat 5333,2023-08-29,13:00:00,223,144,79,FMN 03 Kolonel Silvertopstraat
651,Kolonel Silvertopstraat 5333,2023-08-29,14:00:00,221,152,69,FMN 03 Kolonel Silvertopstraat
651,Kolonel Silvertopstraat 5333,2023-08-29,15:00:00,269,180,89,FMN 03 Kolonel Silvertopstraat
651,Kolonel Silvertopstraat 5333,2023-08-29,16:00:00,426,274,152,FMN 03 Kolonel Silvertopstraat
651,Kolonel Silvertopstraat 5333,2023-08-29,17:00:00,414,258,156,FMN 03 Kolonel Silvertopstraat
651,Kolonel Silvertopstraat 5333,2023-08-29,18:00:00,291,185,106,FMN 03 Kolonel Silvertopstraat
651,Kolonel Silvertopstraat 5333,2023-08-29,19:00:00,203,131,72,FMN 03 Kolonel Silvertopstraat
651,Kolonel Silvertopstraat 5333,2023-08-29,20:00:00,175,112,63,FMN 03 Kolonel Silvertopstraat
651,Kolonel Silvertopstraat 5333,2023-08-29,21:00:00,135,76,59,FMN 03 Kolonel Silvertopstraat
651,Kolonel Silvertopstraat 5333,2023-08-29,22:00:00,116,59,57,FMN 03 Kolonel Silvertopstraat
651,Kolonel Silvertopstraat 5333,2023-08-29,23:00:00,72,31,41,FMN 03 Kolonel Silvertopstraat
651,Kolonel Silvertopstraat 5333,2023-08-30,00:00:00,36,13,23,FMN 03 Kolonel Silvertopstraat
651,Kolonel Silvertopstraat 5333,2023-08-30,01:00:00,38,12,26,FMN 03 Kolonel Silvertopstraat
651,Kolonel Silvertopstraat 5333,2023-08-30,02:00:00,21,12,9,FMN 03 Kolonel Silvertopstraat
651,Kolonel Silvertopstraat 5333,2023-08-30,03:00:00,13,2,11,FMN 03 Kolonel Silvertopstraat
651,Kolonel Silvertopstraat 5333,2023-08-30,04:00:00,27,23,4,FMN 03 Kolonel Silvertopstraat
651,Kolonel Silvertopstraat 5333,2023-08-30,05:00:00,54,35,19,FMN 03 Kolonel Silvertopstraat
651,Kolonel Silvertopstraat 5333,2023-08-30,06:00:00,124,102,22,FMN 03 Kolonel Silvertopstraat
651,Kolonel Silvertopstraat 5333,2023-08-30,07:00:00,189,135,54,FMN 03 Kolonel Silvertopstraat
651,Kolonel Silvertopstraat 5333,2023-08-30,08:00:00,272,228,44,FMN 03 Kolonel Silvertopstraat
651,Kolonel Silvertopstraat 5333,2023-08-30,09:00:00,184,143,41,FMN 03 Kolonel Silvertopstraat
651,Kolonel Silvertopstraat 5333,2023-08-30,10:00:00,152,116,36,FMN 03 Kolonel Silvertopstraat
651,Kolonel Silvertopstraat 5333,2023-08-30,11:00:00,141,108,33,FMN 03 Kolonel Silvertopstraat
651,Kolonel Silvertopstraat 5333,2023-08-30,12:00:00,184,141,43,FMN 03 Kolonel Silvertopstraat
651,Kolonel Silvertopstraat 5333,2023-08-30,13:00:00,188,133,55,FMN 03 Kolonel Silvertopstraat
651,Kolonel Silvertopstraat 5333,2023-08-30,14:00:00,227,155,72,FMN 03 Kolonel Silvertopstraat
651,Kolonel Silvertopstraat 5333,2023-08-30,15:00:00,252,172,80,FMN 03 Kolonel Silvertopstraat
651,Kolonel Silvertopstraat 5333,2023-08-30,16:00:00,302,220,82,FMN 03 Kolonel Silvertopstraat
651,Kolonel Silvertopstraat 5333,2023-08-30,17:00:00,376,241,135,FMN 03 Kolonel Silvertopstraat
651,Kolonel Silvertopstraat 5333,2023-08-30,18:00:00,301,206,95,FMN 03 Kolonel Silvertopstraat
651,Kolonel Silvertopstraat 5333,2023-08-30,19:00:00,207,127,80,FMN 03 Kolonel Silvertopstraat
651,Kolonel Silvertopstraat 5333,2023-08-30,20:00:00,199,125,74,FMN 03 Kolonel Silvertopstraat
651,Kolonel Silvertopstraat 5333,2023-08-30,21:00:00,114,69,45,FMN 03 Kolonel Silvertopstraat
651,Kolonel Silvertopstraat 5333,2023-08-30,22:00:00,124,77,47,FMN 03 Kolonel Silvertopstraat
651,Kolonel Silvertopstraat 5333,2023-08-30,23:00:00,67,29,38,FMN 03 Kolonel Silvertopstraat
651,Kolonel Silvertopstraat 5333,2023-08-31,00:00:00,57,25,32,FMN 03 Kolonel Silvertopstraat
651,Kolonel Silvertopstraat 5333,2023-08-31,01:00:00,29,11,18,FMN 03 Kolonel Silvertopstraat
651,Kolonel Silvertopstraat 5333,2023-08-31,02:00:00,15,10,5,FMN 03 Kolonel Silvertopstraat
651,Kolonel Silvertopstraat 5333,2023-08-31,03:00:00,13,8,5,FMN 03 Kolonel Silvertopstraat
651,Kolonel Silvertopstraat 5333,2023-08-31,04:00:00,34,24,10,FMN 03 Kolonel Silvertopstraat
651,Kolonel Silvertopstraat 5333,2023-08-31,05:00:00,57,34,23,FMN 03 Kolonel Silvertopstraat
651,Kolonel Silvertopstraat 5333,2023-08-31,06:00:00,112,93,19,FMN 03 Kolonel Silvertopstraat
651,Kolonel Silvertopstraat 5333,2023-08-31,07:00:00,246,193,53,FMN 03 Kolonel Silvertopstraat
651,Kolonel Silvertopstraat 5333,2023-08-31,08:00:00,419,357,62,FMN 03 Kolonel Silvertopstraat
651,Kolonel Silvertopstraat 5333,2023-08-31,09:00:00,253,201,52,FMN 03 Kolonel Silvertopstraat
651,Kolonel Silvertopstraat 5333,2023-08-31,10:00:00,198,150,48,FMN 03 Kolonel Silvertopstraat
651,Kolonel Silvertopstraat 5333,2023-08-31,11:00:00,215,169,46,FMN 03 Kolonel Silvertopstraat
651,Kolonel Silvertopstraat 5333,2023-08-31,12:00:00,256,174,82,FMN 03 Kolonel Silvertopstraat
651,Kolonel Silvertopstraat 5333,2023-08-31,13:00:00,248,185,63,FMN 03 Kolonel Silvertopstraat
651,Kolonel Silvertopstraat 5333,2023-08-31,14:00:00,242,173,69,FMN 03 Kolonel Silvertopstraat
651,Kolonel Silvertopstraat 5333,2023-08-31,15:00:00,255,162,93,FMN 03 Kolonel Silvertopstraat
651,Kolonel Silvertopstraat 5333,2023-08-31,16:00:00,325,220,105,FMN 03 Kolonel Silvertopstraat
651,Kolonel Silvertopstraat 5333,2023-08-31,17:00:00,418,278,140,FMN 03 Kolonel Silvertopstraat
651,Kolonel Silvertopstraat 5333,2023-08-31,18:00:00,300,194,106,FMN 03 Kolonel Silvertopstraat
651,Kolonel Silvertopstraat 5333,2023-08-31,19:00:00,211,135,76,FMN 03 Kolonel Silvertopstraat
651,Kolonel Silvertopstraat 5333,2023-08-31,20:00:00,208,127,81,FMN 03 Kolonel Silvertopstraat
651,Kolonel Silvertopstraat 5333,2023-08-31,21:00:00,150,83,67,FMN 03 Kolonel Silvertopstraat
651,Kolonel Silvertopstraat 5333,2023-08-31,22:00:00,134,76,58,FMN 03 Kolonel Silvertopstraat
651,Kolonel Silvertopstraat 5333,2023-08-31,23:00:00,74,37,37,FMN 03 Kolonel Silvertopstraat
651,Kolonel Silvertopstraat 5333,2023-09-01,00:00:00,37,20,17,FMN 03 Kolonel Silvertopstraat
651,Kolonel Silvertopstraat 5333,2023-09-01,01:00:00,29,11,18,FMN 03 Kolonel Silvertopstraat
651,Kolonel Silvertopstraat 5333,2023-09-01,02:00:00,10,5,5,FMN 03 Kolonel Silvertopstraat
651,Kolonel Silvertopstraat 5333,2023-09-01,03:00:00,15,7,8,FMN 03 Kolonel Silvertopstraat
651,Kolonel Silvertopstraat 5333,2023-09-01,04:00:00,28,22,6,FMN 03 Kolonel Silvertopstraat
651,Kolonel Silvertopstraat 5333,2023-09-01,05:00:00,47,25,22,FMN 03 Kolonel Silvertopstraat
651,Kolonel Silvertopstraat 5333,2023-09-01,06:00:00,105,78,27,FMN 03 Kolonel Silvertopstraat
651,Kolonel Silvertopstraat 5333,2023-09-01,07:00:00,233,200,33,FMN 03 Kolonel Silvertopstraat
651,Kolonel Silvertopstraat 5333,2023-09-01,08:00:00,349,306,43,FMN 03 Kolonel Silvertopstraat
651,Kolonel Silvertopstraat 5333,2023-09-01,09:00:00,182,147,35,FMN 03 Kolonel Silvertopstraat
651,Kolonel Silvertopstraat 5333,2023-09-01,10:00:00,131,108,23,FMN 03 Kolonel Silvertopstraat
651,Kolonel Silvertopstraat 5333,2023-09-01,11:00:00,72,47,25,FMN 03 Kolonel Silvertopstraat
651,Kolonel Silvertopstraat 5333,2023-09-01,12:00:00,124,81,43,FMN 03 Kolonel Silvertopstraat
651,Kolonel Silvertopstraat 5333,2023-09-01,13:00:00,163,109,54,FMN 03 Kolonel Silvertopstraat
651,Kolonel Silvertopstraat 5333,2023-09-01,14:00:00,199,149,50,FMN 03 Kolonel Silvertopstraat
651,Kolonel Silvertopstraat 5333,2023-09-01,15:00:00,302,201,101,FMN 03 Kolonel Silvertopstraat
651,Kolonel Silvertopstraat 5333,2023-09-01,16:00:00,308,209,99,FMN 03 Kolonel Silvertopstraat
651,Kolonel Silvertopstraat 5333,2023-09-01,17:00:00,314,208,106,FMN 03 Kolonel Silvertopstraat
651,Kolonel Silvertopstraat 5333,2023-09-01,18:00:00,259,169,90,FMN 03 Kolonel Silvertopstraat
651,Kolonel Silvertopstraat 5333,2023-09-01,19:00:00,252,174,78,FMN 03 Kolonel Silvertopstraat
651,Kolonel Silvertopstraat 5333,2023-09-01,20:00:00,143,96,47,FMN 03 Kolonel Silvertopstraat
651,Kolonel Silvertopstraat 5333,2023-09-01,21:00:00,138,89,49,FMN 03 Kolonel Silvertopstraat
651,Kolonel Silvertopstraat 5333,2023-09-01,22:00:00,128,74,54,FMN 03 Kolonel Silvertopstraat
651,Kolonel Silvertopstraat 5333,2023-09-01,23:00:00,85,42,43,FMN 03 Kolonel Silvertopstraat
651,Kolonel Silvertopstraat 5333,2023-09-02,00:00:00,66,30,36,FMN 03 Kolonel Silvertopstraat
651,Kolonel Silvertopstraat 5333,2023-09-02,01:00:00,66,29,37,FMN 03 Kolonel Silvertopstraat
651,Kolonel Silvertopstraat 5333,2023-09-02,02:00:00,30,9,21,FMN 03 Kolonel Silvertopstraat
651,Kolonel Silvertopstraat 5333,2023-09-02,03:00:00,48,17,31,FMN 03 Kolonel Silvertopstraat
651,Kolonel Silvertopstraat 5333,2023-09-02,04:00:00,20,7,13,FMN 03 Kolonel Silvertopstraat
651,Kolonel Silvertopstraat 5333,2023-09-02,05:00:00,30,15,15,FMN 03 Kolonel Silvertopstraat
651,Kolonel Silvertopstraat 5333,2023-09-02,06:00:00,50,34,16,FMN 03 Kolonel Silvertopstraat
651,Kolonel Silvertopstraat 5333,2023-09-02,07:00:00,50,40,10,FMN 03 Kolonel Silvertopstraat
651,Kolonel Silvertopstraat 5333,2023-09-02,08:00:00,96,68,28,FMN 03 Kolonel Silvertopstraat
651,Kolonel Silvertopstraat 5333,2023-09-02,09:00:00,132,106,26,FMN 03 Kolonel Silvertopstraat
651,Kolonel Silvertopstraat 5333,2023-09-02,10:00:00,203,167,36,FMN 03 Kolonel Silvertopstraat
651,Kolonel Silvertopstraat 5333,2023-09-02,11:00:00,201,154,47,FMN 03 Kolonel Silvertopstraat
651,Kolonel Silvertopstraat 5333,2023-09-02,12:00:00,194,140,54,FMN 03 Kolonel Silvertopstraat
651,Kolonel Silvertopstraat 5333,2023-09-02,13:00:00,225,169,56,FMN 03 Kolonel Silvertopstraat
651,Kolonel Silvertopstraat 5333,2023-09-02,14:00:00,278,212,66,FMN 03 Kolonel Silvertopstraat
651,Kolonel Silvertopstraat 5333,2023-09-02,15:00:00,239,162,77,FMN 03 Kolonel Silvertopstraat
651,Kolonel Silvertopstraat 5333,2023-09-02,16:00:00,249,163,86,FMN 03 Kolonel Silvertopstraat
651,Kolonel Silvertopstraat 5333,2023-09-02,17:00:00,269,185,84,FMN 03 Kolonel Silvertopstraat
651,Kolonel Silvertopstraat 5333,2023-09-02,18:00:00,269,171,98,FMN 03 Kolonel Silvertopstraat
651,Kolonel Silvertopstraat 5333,2023-09-02,19:00:00,261,175,86,FMN 03 Kolonel Silvertopstraat
651,Kolonel Silvertopstraat 5333,2023-09-02,20:00:00,175,113,62,FMN 03 Kolonel Silvertopstraat
651,Kolonel Silvertopstraat 5333,2023-09-02,21:00:00,145,101,44,FMN 03 Kolonel Silvertopstraat
651,Kolonel Silvertopstraat 5333,2023-09-02,22:00:00,205,147,58,FMN 03 Kolonel Silvertopstraat
651,Kolonel Silvertopstraat 5333,2023-09-02,23:00:00,132,63,69,FMN 03 Kolonel Silvertopstraat
651,Kolonel Silvertopstraat 5333,2023-09-03,00:00:00,100,51,49,FMN 03 Kolonel Silvertopstraat
651,Kolonel Silvertopstraat 5333,2023-09-03,01:00:00,49,18,31,FMN 03 Kolonel Silvertopstraat
651,Kolonel Silvertopstraat 5333,2023-09-03,02:00:00,46,15,31,FMN 03 Kolonel Silvertopstraat
651,Kolonel Silvertopstraat 5333,2023-09-03,03:00:00,30,13,17,FMN 03 Kolonel Silvertopstraat
651,Kolonel Silvertopstraat 5333,2023-09-03,04:00:00,35,15,20,FMN 03 Kolonel Silvertopstraat
651,Kolonel Silvertopstraat 5333,2023-09-03,05:00:00,19,15,4,FMN 03 Kolonel Silvertopstraat
651,Kolonel Silvertopstraat 5333,2023-09-03,06:00:00,32,26,6,FMN 03 Kolonel Silvertopstraat
651,Kolonel Silvertopstraat 5333,2023-09-03,07:00:00,29,20,9,FMN 03 Kolonel Silvertopstraat
651,Kolonel Silvertopstraat 5333,2023-09-03,08:00:00,61,48,13,FMN 03 Kolonel Silvertopstraat
651,Kolonel Silvertopstraat 5333,2023-09-03,09:00:00,126,102,24,FMN 03 Kolonel Silvertopstraat
651,Kolonel Silvertopstraat 5333,2023-09-03,10:00:00,179,134,45,FMN 03 Kolonel Silvertopstraat
651,Kolonel Silvertopstraat 5333,2023-09-03,11:00:00,188,151,37,FMN 03 Kolonel Silvertopstraat
651,Kolonel Silvertopstraat 5333,2023-09-03,12:00:00,215,160,55,FMN 03 Kolonel Silvertopstraat
651,Kolonel Silvertopstraat 5333,2023-09-03,13:00:00,217,157,60,FMN 03 Kolonel Silvertopstraat
651,Kolonel Silvertopstraat 5333,2023-09-03,14:00:00,266,198,68,FMN 03 Kolonel Silvertopstraat
651,Kolonel Silvertopstraat 5333,2023-09-03,15:00:00,232,166,66,FMN 03 Kolonel Silvertopstraat
651,Kolonel Silvertopstraat 5333,2023-09-03,16:00:00,184,124,60,FMN 03 Kolonel Silvertopstraat
651,Kolonel Silvertopstraat 5333,2023-09-03,17:00:00,233,146,87,FMN 03 Kolonel Silvertopstraat
651,Kolonel Silvertopstraat 5333,2023-09-03,18:00:00,240,161,79,FMN 03 Kolonel Silvertopstraat
651,Kolonel Silvertopstraat 5333,2023-09-03,19:00:00,173,111,62,FMN 03 Kolonel Silvertopstraat
651,Kolonel Silvertopstraat 5333,2023-09-03,20:00:00,164,106,58,FMN 03 Kolonel Silvertopstraat
651,Kolonel Silvertopstraat 5333,2023-09-03,21:00:00,135,75,60,FMN 03 Kolonel Silvertopstraat
651,Kolonel Silvertopstraat 5333,2023-09-03,22:00:00,108,44,64,FMN 03 Kolonel Silvertopstraat
651,Kolonel Silvertopstraat 5333,2023-09-03,23:00:00,61,31,30,FMN 03 Kolonel Silvertopstraat
651,Kolonel Silvertopstraat 5333,2023-09-04,00:00:00,34,20,14,FMN 03 Kolonel Silvertopstraat
651,Kolonel Silvertopstraat 5333,2023-09-04,01:00:00,23,8,15,FMN 03 Kolonel Silvertopstraat
651,Kolonel Silvertopstraat 5333,2023-09-04,02:00:00,13,2,11,FMN 03 Kolonel Silvertopstraat
651,Kolonel Silvertopstraat 5333,2023-09-04,03:00:00,17,15,2,FMN 03 Kolonel Silvertopstraat
651,Kolonel Silvertopstraat 5333,2023-09-04,04:00:00,30,25,5,FMN 03 Kolonel Silvertopstraat
651,Kolonel Silvertopstraat 5333,2023-09-04,05:00:00,48,32,16,FMN 03 Kolonel Silvertopstraat
651,Kolonel Silvertopstraat 5333,2023-09-04,06:00:00,143,117,26,FMN 03 Kolonel Silvertopstraat
651,Kolonel Silvertopstraat 5333,2023-09-04,07:00:00,429,360,69,FMN 03 Kolonel Silvertopstraat
651,Kolonel Silvertopstraat 5333,2023-09-04,08:00:00,767,657,110,FMN 03 Kolonel Silvertopstraat
651,Kolonel Silvertopstraat 5333,2023-09-04,09:00:00,290,233,57,FMN 03 Kolonel Silvertopstraat
651,Kolonel Silvertopstraat 5333,2023-09-04,10:00:00,152,115,37,FMN 03 Kolonel Silvertopstraat
651,Kolonel Silvertopstraat 5333,2023-09-04,11:00:00,142,106,36,FMN 03 Kolonel Silvertopstraat
651,Kolonel Silvertopstraat 5333,2023-09-04,12:00:00,216,159,57,FMN 03 Kolonel Silvertopstraat
651,Kolonel Silvertopstraat 5333,2023-09-04,13:00:00,229,159,70,FMN 03 Kolonel Silvertopstraat
651,Kolonel Silvertopstraat 5333,2023-09-04,14:00:00,184,126,58,FMN 03 Kolonel Silvertopstraat
651,Kolonel Silvertopstraat 5333,2023-09-04,15:00:00,120,70,50,FMN 03 Kolonel Silvertopstraat
651,Kolonel Silvertopstraat 5333,2023-09-04,16:00:00,362,218,144,FMN 03 Kolonel Silvertopstraat
651,Kolonel Silvertopstraat 5333,2023-09-04,17:00:00,433,278,155,FMN 03 Kolonel Silvertopstraat
651,Kolonel Silvertopstraat 5333,2023-09-04,18:00:00,301,196,105,FMN 03 Kolonel Silvertopstraat
651,Kolonel Silvertopstraat 5333,2023-09-04,19:00:00,214,146,68,FMN 03 Kolonel Silvertopstraat
651,Kolonel Silvertopstraat 5333,2023-09-04,20:00:00,174,105,69,FMN 03 Kolonel Silvertopstraat
651,Kolonel Silvertopstraat 5333,2023-09-04,21:00:00,137,71,66,FMN 03 Kolonel Silvertopstraat
651,Kolonel Silvertopstraat 5333,2023-09-04,22:00:00,130,66,64,FMN 03 Kolonel Silvertopstraat
651,Kolonel Silvertopstraat 5333,2023-09-04,23:00:00,67,26,41,FMN 03 Kolonel Silvertopstraat
651,Kolonel Silvertopstraat 5333,2023-09-05,00:00:00,25,12,13,FMN 03 Kolonel Silvertopstraat
651,Kolonel Silvertopstraat 5333,2023-09-05,01:00:00,27,11,16,FMN 03 Kolonel Silvertopstraat
651,Kolonel Silvertopstraat 5333,2023-09-05,02:00:00,13,7,6,FMN 03 Kolonel Silvertopstraat
651,Kolonel Silvertopstraat 5333,2023-09-05,03:00:00,15,10,5,FMN 03 Kolonel Silvertopstraat
651,Kolonel Silvertopstraat 5333,2023-09-05,04:00:00,31,25,6,FMN 03 Kolonel Silvertopstraat
651,Kolonel Silvertopstraat 5333,2023-09-05,05:00:00,57,35,22,FMN 03 Kolonel Silvertopstraat
651,Kolonel Silvertopstraat 5333,2023-09-05,06:00:00,169,138,31,FMN 03 Kolonel Silvertopstraat
651,Kolonel Silvertopstraat 5333,2023-09-05,07:00:00,503,434,69,FMN 03 Kolonel Silvertopstraat
651,Kolonel Silvertopstraat 5333,2023-09-05,08:00:00,838,727,111,FMN 03 Kolonel Silvertopstraat
651,Kolonel Silvertopstraat 5333,2023-09-05,09:00:00,297,237,60,FMN 03 Kolonel Silvertopstraat
651,Kolonel Silvertopstraat 5333,2023-09-05,10:00:00,190,145,45,FMN 03 Kolonel Silvertopstraat
651,Kolonel Silvertopstraat 5333,2023-09-05,11:00:00,190,133,57,FMN 03 Kolonel Silvertopstraat
651,Kolonel Silvertopstraat 5333,2023-09-05,12:00:00,238,182,56,FMN 03 Kolonel Silvertopstraat
651,Kolonel Silvertopstraat 5333,2023-09-05,13:00:00,231,152,79,FMN 03 Kolonel Silvertopstraat
651,Kolonel Silvertopstraat 5333,2023-09-05,14:00:00,252,157,95,FMN 03 Kolonel Silvertopstraat
651,Kolonel Silvertopstraat 5333,2023-09-05,15:00:00,364,210,154,FMN 03 Kolonel Silvertopstraat
651,Kolonel Silvertopstraat 5333,2023-09-05,16:00:00,465,319,146,FMN 03 Kolonel Silvertopstraat
651,Kolonel Silvertopstraat 5333,2023-09-05,17:00:00,470,302,168,FMN 03 Kolonel Silvertopstraat
651,Kolonel Silvertopstraat 5333,2023-09-05,18:00:00,352,225,127,FMN 03 Kolonel Silvertopstraat
651,Kolonel Silvertopstraat 5333,2023-09-05,19:00:00,282,194,88,FMN 03 Kolonel Silvertopstraat
651,Kolonel Silvertopstraat 5333,2023-09-05,20:00:00,218,131,87,FMN 03 Kolonel Silvertopstraat
651,Kolonel Silvertopstraat 5333,2023-09-05,21:00:00,179,99,80,FMN 03 Kolonel Silvertopstraat
651,Kolonel Silvertopstraat 5333,2023-09-05,22:00:00,146,85,61,FMN 03 Kolonel Silvertopstraat
651,Kolonel Silvertopstraat 5333,2023-09-05,23:00:00,88,42,46,FMN 03 Kolonel Silvertopstraat
651,Kolonel Silvertopstraat 5333,2023-09-06,00:00:00,46,18,28,FMN 03 Kolonel Silvertopstraat
651,Kolonel Silvertopstraat 5333,2023-09-06,01:00:00,19,10,9,FMN 03 Kolonel Silvertopstraat
651,Kolonel Silvertopstraat 5333,2023-09-06,02:00:00,19,7,12,FMN 03 Kolonel Silvertopstraat
651,Kolonel Silvertopstraat 5333,2023-09-06,03:00:00,17,9,8,FMN 03 Kolonel Silvertopstraat
651,Kolonel Silvertopstraat 5333,2023-09-06,04:00:00,31,28,3,FMN 03 Kolonel Silvertopstraat
651,Kolonel Silvertopstraat 5333,2023-09-06,05:00:00,69,44,25,FMN 03 Kolonel Silvertopstraat
651,Kolonel Silvertopstraat 5333,2023-09-06,06:00:00,150,123,27,FMN 03 Kolonel Silvertopstraat
651,Kolonel Silvertopstraat 5333,2023-09-06,07:00:00,431,350,81,FMN 03 Kolonel Silvertopstraat
651,Kolonel Silvertopstraat 5333,2023-09-06,08:00:00,712,609,103,FMN 03 Kolonel Silvertopstraat
651,Kolonel Silvertopstraat 5333,2023-09-06,09:00:00,288,215,73,FMN 03 Kolonel Silvertopstraat
651,Kolonel Silvertopstraat 5333,2023-09-06,10:00:00,195,157,38,FMN 03 Kolonel Silvertopstraat
651,Kolonel Silvertopstraat 5333,2023-09-06,11:00:00,205,151,54,FMN 03 Kolonel Silvertopstraat
651,Kolonel Silvertopstraat 5333,2023-09-06,12:00:00,411,250,161,FMN 03 Kolonel Silvertopstraat
651,Kolonel Silvertopstraat 5333,2023-09-06,13:00:00,281,168,113,FMN 03 Kolonel Silvertopstraat
651,Kolonel Silvertopstraat 5333,2023-09-06,14:00:00,288,195,93,FMN 03 Kolonel Silvertopstraat
651,Kolonel Silvertopstraat 5333,2023-09-06,15:00:00,286,200,86,FMN 03 Kolonel Silvertopstraat
651,Kolonel Silvertopstraat 5333,2023-09-06,16:00:00,342,228,114,FMN 03 Kolonel Silvertopstraat
651,Kolonel Silvertopstraat 5333,2023-09-06,17:00:00,452,316,136,FMN 03 Kolonel Silvertopstraat
651,Kolonel Silvertopstraat 5333,2023-09-06,18:00:00,388,255,133,FMN 03 Kolonel Silvertopstraat
651,Kolonel Silvertopstraat 5333,2023-09-06,19:00:00,271,184,87,FMN 03 Kolonel Silvertopstraat
651,Kolonel Silvertopstraat 5333,2023-09-06,20:00:00,212,133,79,FMN 03 Kolonel Silvertopstraat
651,Kolonel Silvertopstraat 5333,2023-09-06,21:00:00,151,73,78,FMN 03 Kolonel Silvertopstraat
651,Kolonel Silvertopstraat 5333,2023-09-06,22:00:00,178,100,78,FMN 03 Kolonel Silvertopstraat
651,Kolonel Silvertopstraat 5333,2023-09-06,23:00:00,81,37,44,FMN 03 Kolonel Silvertopstraat
651,Kolonel Silvertopstraat 5333,2023-09-07,00:00:00,53,24,29,FMN 03 Kolonel Silvertopstraat
651,Kolonel Silvertopstraat 5333,2023-09-07,01:00:00,36,15,21,FMN 03 Kolonel Silvertopstraat
651,Kolonel Silvertopstraat 5333,2023-09-07,02:00:00,26,11,15,FMN 03 Kolonel Silvertopstraat
651,Kolonel Silvertopstraat 5333,2023-09-07,03:00:00,15,13,2,FMN 03 Kolonel Silvertopstraat
651,Kolonel Silvertopstraat 5333,2023-09-07,04:00:00,39,29,10,FMN 03 Kolonel Silvertopstraat
651,Kolonel Silvertopstraat 5333,2023-09-07,05:00:00,72,46,26,FMN 03 Kolonel Silvertopstraat
651,Kolonel Silvertopstraat 5333,2023-09-07,06:00:00,164,136,28,FMN 03 Kolonel Silvertopstraat
651,Kolonel Silvertopstraat 5333,2023-09-07,07:00:00,439,364,75,FMN 03 Kolonel Silvertopstraat
651,Kolonel Silvertopstraat 5333,2023-09-07,08:00:00,810,690,120,FMN 03 Kolonel Silvertopstraat
651,Kolonel Silvertopstraat 5333,2023-09-07,09:00:00,258,205,53,FMN 03 Kolonel Silvertopstraat
651,Kolonel Silvertopstraat 5333,2023-09-07,10:00:00,207,171,36,FMN 03 Kolonel Silvertopstraat
651,Kolonel Silvertopstraat 5333,2023-09-07,11:00:00,227,158,69,FMN 03 Kolonel Silvertopstraat
651,Kolonel Silvertopstraat 5333,2023-09-07,12:00:00,228,176,52,FMN 03 Kolonel Silvertopstraat
651,Kolonel Silvertopstraat 5333,2023-09-07,13:00:00,231,158,73,FMN 03 Kolonel Silvertopstraat
651,Kolonel Silvertopstraat 5333,2023-09-07,14:00:00,248,169,79,FMN 03 Kolonel Silvertopstraat
651,Kolonel Silvertopstraat 5333,2023-09-07,15:00:00,376,233,143,FMN 03 Kolonel Silvertopstraat
651,Kolonel Silvertopstraat 5333,2023-09-07,16:00:00,460,290,170,FMN 03 Kolonel Silvertopstraat
651,Kolonel Silvertopstraat 5333,2023-09-07,17:00:00,457,316,141,FMN 03 Kolonel Silvertopstraat
651,Kolonel Silvertopstraat 5333,2023-09-07,18:00:00,489,331,158,FMN 03 Kolonel Silvertopstraat
651,Kolonel Silvertopstraat 5333,2023-09-07,19:00:00,314,225,89,FMN 03 Kolonel Silvertopstraat
651,Kolonel Silvertopstraat 5333,2023-09-07,20:00:00,242,164,78,FMN 03 Kolonel Silvertopstraat
651,Kolonel Silvertopstraat 5333,2023-09-07,21:00:00,175,92,83,FMN 03 Kolonel Silvertopstraat
651,Kolonel Silvertopstraat 5333,2023-09-07,22:00:00,161,75,86,FMN 03 Kolonel Silvertopstraat
651,Kolonel Silvertopstraat 5333,2023-09-07,23:00:00,97,42,55,FMN 03 Kolonel Silvertopstraat
651,Kolonel Silvertopstraat 5333,2023-09-08,00:00:00,64,31,33,FMN 03 Kolonel Silvertopstraat
651,Kolonel Silvertopstraat 5333,2023-09-08,01:00:00,35,16,19,FMN 03 Kolonel Silvertopstraat
651,Kolonel Silvertopstraat 5333,2023-09-08,02:00:00,23,9,14,FMN 03 Kolonel Silvertopstraat
651,Kolonel Silvertopstraat 5333,2023-09-08,03:00:00,16,5,11,FMN 03 Kolonel Silvertopstraat
651,Kolonel Silvertopstraat 5333,2023-09-08,04:00:00,34,29,5,FMN 03 Kolonel Silvertopstraat
651,Kolonel Silvertopstraat 5333,2023-09-08,05:00:00,68,43,25,FMN 03 Kolonel Silvertopstraat
651,Kolonel Silvertopstraat 5333,2023-09-08,06:00:00,132,103,29,FMN 03 Kolonel Silvertopstraat
651,Kolonel Silvertopstraat 5333,2023-09-08,07:00:00,356,305,51,FMN 03 Kolonel Silvertopstraat
651,Kolonel Silvertopstraat 5333,2023-09-08,08:00:00,694,594,100,FMN 03 Kolonel Silvertopstraat
651,Kolonel Silvertopstraat 5333,2023-09-08,09:00:00,253,201,52,FMN 03 Kolonel Silvertopstraat
651,Kolonel Silvertopstraat 5333,2023-09-08,10:00:00,202,160,42,FMN 03 Kolonel Silvertopstraat
651,Kolonel Silvertopstraat 5333,2023-09-08,11:00:00,237,178,59,FMN 03 Kolonel Silvertopstraat
651,Kolonel Silvertopstraat 5333,2023-09-08,12:00:00,289,194,95,FMN 03 Kolonel Silvertopstraat
651,Kolonel Silvertopstraat 5333,2023-09-08,13:00:00,232,157,75,FMN 03 Kolonel Silvertopstraat
651,Kolonel Silvertopstraat 5333,2023-09-08,14:00:00,279,184,95,FMN 03 Kolonel Silvertopstraat
651,Kolonel Silvertopstraat 5333,2023-09-08,15:00:00,383,239,144,FMN 03 Kolonel Silvertopstraat
651,Kolonel Silvertopstraat 5333,2023-09-08,16:00:00,446,281,165,FMN 03 Kolonel Silvertopstraat
651,Kolonel Silvertopstraat 5333,2023-09-08,17:00:00,458,304,154,FMN 03 Kolonel Silvertopstraat
651,Kolonel Silvertopstraat 5333,2023-09-08,18:00:00,388,284,104,FMN 03 Kolonel Silvertopstraat
651,Kolonel Silvertopstraat 5333,2023-09-08,19:00:00,334,246,88,FMN 03 Kolonel Silvertopstraat
651,Kolonel Silvertopstraat 5333,2023-09-08,20:00:00,229,153,76,FMN 03 Kolonel Silvertopstraat
651,Kolonel Silvertopstraat 5333,2023-09-08,21:00:00,216,142,74,FMN 03 Kolonel Silvertopstraat
651,Kolonel Silvertopstraat 5333,2023-09-08,22:00:00,182,105,77,FMN 03 Kolonel Silvertopstraat
651,Kolonel Silvertopstraat 5333,2023-09-08,23:00:00,130,61,69,FMN 03 Kolonel Silvertopstraat
651,Kolonel Silvertopstraat 5333,2023-09-09,00:00:00,113,59,54,FMN 03 Kolonel Silvertopstraat
651,Kolonel Silvertopstraat 5333,2023-09-09,01:00:00,74,37,37,FMN 03 Kolonel Silvertopstraat
651,Kolonel Silvertopstraat 5333,2023-09-09,02:00:00,44,25,19,FMN 03 Kolonel Silvertopstraat
651,Kolonel Silvertopstraat 5333,2023-09-09,03:00:00,24,9,15,FMN 03 Kolonel Silvertopstraat
651,Kolonel Silvertopstraat 5333,2023-09-09,04:00:00,31,10,21,FMN 03 Kolonel Silvertopstraat
651,Kolonel Silvertopstraat 5333,2023-09-09,05:00:00,50,33,17,FMN 03 Kolonel Silvertopstraat
651,Kolonel Silvertopstraat 5333,2023-09-09,06:00:00,55,43,12,FMN 03 Kolonel Silvertopstraat
651,Kolonel Silvertopstraat 5333,2023-09-09,07:00:00,46,36,10,FMN 03 Kolonel Silvertopstraat
651,Kolonel Silvertopstraat 5333,2023-09-09,08:00:00,105,83,22,FMN 03 Kolonel Silvertopstraat
651,Kolonel Silvertopstraat 5333,2023-09-09,09:00:00,188,148,40,FMN 03 Kolonel Silvertopstraat
651,Kolonel Silvertopstraat 5333,2023-09-09,10:00:00,206,163,43,FMN 03 Kolonel Silvertopstraat
651,Kolonel Silvertopstraat 5333,2023-09-09,11:00:00,240,167,73,FMN 03 Kolonel Silvertopstraat
651,Kolonel Silvertopstraat 5333,2023-09-09,12:00:00,241,175,66,FMN 03 Kolonel Silvertopstraat
651,Kolonel Silvertopstraat 5333,2023-09-09,13:00:00,267,199,68,FMN 03 Kolonel Silvertopstraat
651,Kolonel Silvertopstraat 5333,2023-09-09,14:00:00,227,162,65,FMN 03 Kolonel Silvertopstraat
651,Kolonel Silvertopstraat 5333,2023-09-09,15:00:00,234,156,78,FMN 03 Kolonel Silvertopstraat
651,Kolonel Silvertopstraat 5333,2023-09-09,16:00:00,232,155,77,FMN 03 Kolonel Silvertopstraat
651,Kolonel Silvertopstraat 5333,2023-09-09,17:00:00,244,173,71,FMN 03 Kolonel Silvertopstraat
651,Kolonel Silvertopstraat 5333,2023-09-09,18:00:00,248,174,74,FMN 03 Kolonel Silvertopstraat
651,Kolonel Silvertopstraat 5333,2023-09-09,19:00:00,212,151,61,FMN 03 Kolonel Silvertopstraat
651,Kolonel Silvertopstraat 5333,2023-09-09,20:00:00,219,139,80,FMN 03 Kolonel Silvertopstraat
651,Kolonel Silvertopstraat 5333,2023-09-09,21:00:00,140,92,48,FMN 03 Kolonel Silvertopstraat
651,Kolonel Silvertopstraat 5333,2023-09-09,22:00:00,151,83,68,FMN 03 Kolonel Silvertopstraat
651,Kolonel Silvertopstraat 5333,2023-09-09,23:00:00,118,49,69,FMN 03 Kolonel Silvertopstraat
651,Kolonel Silvertopstraat 5333,2023-09-10,00:00:00,95,44,51,FMN 03 Kolonel Silvertopstraat
651,Kolonel Silvertopstraat 5333,2023-09-10,01:00:00,66,33,33,FMN 03 Kolonel Silvertopstraat
651,Kolonel Silvertopstraat 5333,2023-09-10,02:00:00,45,21,24,FMN 03 Kolonel Silvertopstraat
651,Kolonel Silvertopstraat 5333,2023-09-10,03:00:00,31,11,20,FMN 03 Kolonel Silvertopstraat
651,Kolonel Silvertopstraat 5333,2023-09-10,04:00:00,31,15,16,FMN 03 Kolonel Silvertopstraat
651,Kolonel Silvertopstraat 5333,2023-09-10,05:00:00,29,21,8,FMN 03 Kolonel Silvertopstraat
651,Kolonel Silvertopstraat 5333,2023-09-10,06:00:00,45,34,11,FMN 03 Kolonel Silvertopstraat
651,Kolonel Silvertopstraat 5333,2023-09-10,07:00:00,27,21,6,FMN 03 Kolonel Silvertopstraat
651,Kolonel Silvertopstraat 5333,2023-09-10,08:00:00,80,62,18,FMN 03 Kolonel Silvertopstraat
651,Kolonel Silvertopstraat 5333,2023-09-10,09:00:00,161,119,42,FMN 03 Kolonel Silvertopstraat
651,Kolonel Silvertopstraat 5333,2023-09-10,10:00:00,183,142,41,FMN 03 Kolonel Silvertopstraat
651,Kolonel Silvertopstraat 5333,2023-09-10,11:00:00,213,170,43,FMN 03 Kolonel Silvertopstraat
651,Kolonel Silvertopstraat 5333,2023-09-10,12:00:00,219,149,70,FMN 03 Kolonel Silvertopstraat
651,Kolonel Silvertopstraat 5333,2023-09-10,13:00:00,204,139,65,FMN 03 Kolonel Silvertopstraat
651,Kolonel Silvertopstraat 5333,2023-09-10,14:00:00,214,159,55,FMN 03 Kolonel Silvertopstraat
651,Kolonel Silvertopstraat 5333,2023-09-10,15:00:00,196,131,65,FMN 03 Kolonel Silvertopstraat
651,Kolonel Silvertopstraat 5333,2023-09-10,16:00:00,212,149,63,FMN 03 Kolonel Silvertopstraat
651,Kolonel Silvertopstraat 5333,2023-09-10,17:00:00,199,147,52,FMN 03 Kolonel Silvertopstraat
651,Kolonel Silvertopstraat 5333,2023-09-10,18:00:00,219,151,68,FMN 03 Kolonel Silvertopstraat
651,Kolonel Silvertopstraat 5333,2023-09-10,19:00:00,204,147,57,FMN 03 Kolonel Silvertopstraat
651,Kolonel Silvertopstraat 5333,2023-09-10,20:00:00,181,111,70,FMN 03 Kolonel Silvertopstraat
651,Kolonel Silvertopstraat 5333,2023-09-10,21:00:00,130,67,63,FMN 03 Kolonel Silvertopstraat
651,Kolonel Silvertopstraat 5333,2023-09-10,22:00:00,106,59,47,FMN 03 Kolonel Silvertopstraat
651,Kolonel Silvertopstraat 5333,2023-09-10,23:00:00,82,30,52,FMN 03 Kolonel Silvertopstraat
651,Kolonel Silvertopstraat 5333,2023-09-11,00:00:00,47,21,26,FMN 03 Kolonel Silvertopstraat
651,Kolonel Silvertopstraat 5333,2023-09-11,01:00:00,28,12,16,FMN 03 Kolonel Silvertopstraat
651,Kolonel Silvertopstraat 5333,2023-09-11,02:00:00,13,4,9,FMN 03 Kolonel Silvertopstraat
651,Kolonel Silvertopstraat 5333,2023-09-11,03:00:00,16,8,8,FMN 03 Kolonel Silvertopstraat
651,Kolonel Silvertopstraat 5333,2023-09-11,04:00:00,35,24,11,FMN 03 Kolonel Silvertopstraat
651,Kolonel Silvertopstraat 5333,2023-09-11,05:00:00,67,40,27,FMN 03 Kolonel Silvertopstraat
651,Kolonel Silvertopstraat 5333,2023-09-11,06:00:00,141,118,23,FMN 03 Kolonel Silvertopstraat
651,Kolonel Silvertopstraat 5333,2023-09-11,07:00:00,415,345,70,FMN 03 Kolonel Silvertopstraat
651,Kolonel Silvertopstraat 5333,2023-09-11,08:00:00,776,664,112,FMN 03 Kolonel Silvertopstraat
651,Kolonel Silvertopstraat 5333,2023-09-11,09:00:00,308,246,62,FMN 03 Kolonel Silvertopstraat
651,Kolonel Silvertopstraat 5333,2023-09-11,10:00:00,188,133,55,FMN 03 Kolonel Silvertopstraat
651,Kolonel Silvertopstraat 5333,2023-09-11,11:00:00,178,130,48,FMN 03 Kolonel Silvertopstraat
651,Kolonel Silvertopstraat 5333,2023-09-11,12:00:00,219,155,64,FMN 03 Kolonel Silvertopstraat
651,Kolonel Silvertopstraat 5333,2023-09-11,13:00:00,184,114,70,FMN 03 Kolonel Silvertopstraat
651,Kolonel Silvertopstraat 5333,2023-09-11,14:00:00,248,188,60,FMN 03 Kolonel Silvertopstraat
651,Kolonel Silvertopstraat 5333,2023-09-11,15:00:00,365,240,125,FMN 03 Kolonel Silvertopstraat
651,Kolonel Silvertopstraat 5333,2023-09-11,16:00:00,465,281,184,FMN 03 Kolonel Silvertopstraat
651,Kolonel Silvertopstraat 5333,2023-09-11,17:00:00,475,293,182,FMN 03 Kolonel Silvertopstraat
651,Kolonel Silvertopstraat 5333,2023-09-11,18:00:00,355,234,121,FMN 03 Kolonel Silvertopstraat
651,Kolonel Silvertopstraat 5333,2023-09-11,19:00:00,231,154,77,FMN 03 Kolonel Silvertopstraat
651,Kolonel Silvertopstraat 5333,2023-09-11,20:00:00,198,122,76,FMN 03 Kolonel Silvertopstraat
651,Kolonel Silvertopstraat 5333,2023-09-11,21:00:00,142,75,67,FMN 03 Kolonel Silvertopstraat
651,Kolonel Silvertopstraat 5333,2023-09-11,22:00:00,139,77,62,FMN 03 Kolonel Silvertopstraat
651,Kolonel Silvertopstraat 5333,2023-09-11,23:00:00,69,28,41,FMN 03 Kolonel Silvertopstraat
651,Kolonel Silvertopstraat 5333,2023-09-12,00:00:00,31,11,20,FMN 03 Kolonel Silvertopstraat
651,Kolonel Silvertopstraat 5333,2023-09-12,01:00:00,18,11,7,FMN 03 Kolonel Silvertopstraat
651,Kolonel Silvertopstraat 5333,2023-09-12,02:00:00,14,8,6,FMN 03 Kolonel Silvertopstraat
651,Kolonel Silvertopstraat 5333,2023-09-12,03:00:00,11,5,6,FMN 03 Kolonel Silvertopstraat
651,Kolonel Silvertopstraat 5333,2023-09-12,04:00:00,30,20,10,FMN 03 Kolonel Silvertopstraat
651,Kolonel Silvertopstraat 5333,2023-09-12,05:00:00,71,48,23,FMN 03 Kolonel Silvertopstraat
651,Kolonel Silvertopstraat 5333,2023-09-12,06:00:00,150,121,29,FMN 03 Kolonel Silvertopstraat
651,Kolonel Silvertopstraat 5333,2023-09-12,07:00:00,421,340,81,FMN 03 Kolonel Silvertopstraat
651,Kolonel Silvertopstraat 5333,2023-09-12,08:00:00,854,715,139,FMN 03 Kolonel Silvertopstraat
651,Kolonel Silvertopstraat 5333,2023-09-12,09:00:00,288,234,54,FMN 03 Kolonel Silvertopstraat
651,Kolonel Silvertopstraat 5333,2023-09-12,10:00:00,196,165,31,FMN 03 Kolonel Silvertopstraat
651,Kolonel Silvertopstraat 5333,2023-09-12,11:00:00,188,141,47,FMN 03 Kolonel Silvertopstraat
651,Kolonel Silvertopstraat 5333,2023-09-12,12:00:00,211,145,66,FMN 03 Kolonel Silvertopstraat
651,Kolonel Silvertopstraat 5333,2023-09-12,13:00:00,206,126,80,FMN 03 Kolonel Silvertopstraat
651,Kolonel Silvertopstraat 5333,2023-09-12,14:00:00,284,190,94,FMN 03 Kolonel Silvertopstraat
651,Kolonel Silvertopstraat 5333,2023-09-12,15:00:00,291,211,80,FMN 03 Kolonel Silvertopstraat
651,Kolonel Silvertopstraat 5333,2023-09-12,16:00:00,443,326,117,FMN 03 Kolonel Silvertopstraat
651,Kolonel Silvertopstraat 5333,2023-09-12,17:00:00,454,284,170,FMN 03 Kolonel Silvertopstraat
651,Kolonel Silvertopstraat 5333,2023-09-12,18:00:00,325,208,117,FMN 03 Kolonel Silvertopstraat
651,Kolonel Silvertopstraat 5333,2023-09-12,19:00:00,217,144,73,FMN 03 Kolonel Silvertopstraat
651,Kolonel Silvertopstraat 5333,2023-09-12,20:00:00,177,96,81,FMN 03 Kolonel Silvertopstraat
651,Kolonel Silvertopstraat 5333,2023-09-12,21:00:00,133,67,66,FMN 03 Kolonel Silvertopstraat
651,Kolonel Silvertopstraat 5333,2023-09-12,22:00:00,106,54,52,FMN 03 Kolonel Silvertopstraat
651,Kolonel Silvertopstraat 5333,2023-09-12,23:00:00,63,29,34,FMN 03 Kolonel Silvertopstraat
651,Kolonel Silvertopstraat 5333,2023-09-13,00:00:00,31,16,15,FMN 03 Kolonel Silvertopstraat
651,Kolonel Silvertopstraat 5333,2023-09-13,01:00:00,18,8,10,FMN 03 Kolonel Silvertopstraat
651,Kolonel Silvertopstraat 5333,2023-09-13,02:00:00,15,11,4,FMN 03 Kolonel Silvertopstraat
651,Kolonel Silvertopstraat 5333,2023-09-13,03:00:00,11,3,8,FMN 03 Kolonel Silvertopstraat
651,Kolonel Silvertopstraat 5333,2023-09-13,04:00:00,31,20,11,FMN 03 Kolonel Silvertopstraat
651,Kolonel Silvertopstraat 5333,2023-09-13,05:00:00,64,40,24,FMN 03 Kolonel Silvertopstraat
651,Kolonel Silvertopstraat 5333,2023-09-13,06:00:00,143,117,26,FMN 03 Kolonel Silvertopstraat
651,Kolonel Silvertopstraat 5333,2023-09-13,07:00:00,377,308,69,FMN 03 Kolonel Silvertopstraat
651,Kolonel Silvertopstraat 5333,2023-09-13,08:00:00,687,581,106,FMN 03 Kolonel Silvertopstraat
651,Kolonel Silvertopstraat 5333,2023-09-13,09:00:00,228,181,47,FMN 03 Kolonel Silvertopstraat
651,Kolonel Silvertopstraat 5333,2023-09-13,10:00:00,173,129,44,FMN 03 Kolonel Silvertopstraat
651,Kolonel Silvertopstraat 5333,2023-09-13,11:00:00,222,162,60,FMN 03 Kolonel Silvertopstraat
651,Kolonel Silvertopstraat 5333,2023-09-13,12:00:00,351,237,114,FMN 03 Kolonel Silvertopstraat
651,Kolonel Silvertopstraat 5333,2023-09-13,13:00:00,240,156,84,FMN 03 Kolonel Silvertopstraat
651,Kolonel Silvertopstraat 5333,2023-09-13,14:00:00,251,183,68,FMN 03 Kolonel Silvertopstraat
651,Kolonel Silvertopstraat 5333,2023-09-13,15:00:00,261,180,81,FMN 03 Kolonel Silvertopstraat
651,Kolonel Silvertopstraat 5333,2023-09-13,16:00:00,359,247,112,FMN 03 Kolonel Silvertopstraat
651,Kolonel Silvertopstraat 5333,2023-09-13,17:00:00,431,291,140,FMN 03 Kolonel Silvertopstraat
651,Kolonel Silvertopstraat 5333,2023-09-13,18:00:00,331,231,100,FMN 03 Kolonel Silvertopstraat
651,Kolonel Silvertopstraat 5333,2023-09-13,19:00:00,250,148,102,FMN 03 Kolonel Silvertopstraat
651,Kolonel Silvertopstraat 5333,2023-09-13,20:00:00,179,118,61,FMN 03 Kolonel Silvertopstraat
651,Kolonel Silvertopstraat 5333,2023-09-13,21:00:00,143,68,75,FMN 03 Kolonel Silvertopstraat
651,Kolonel Silvertopstraat 5333,2023-09-13,22:00:00,123,71,52,FMN 03 Kolonel Silvertopstraat
651,Kolonel Silvertopstraat 5333,2023-09-13,23:00:00,84,44,40,FMN 03 Kolonel Silvertopstraat
651,Kolonel Silvertopstraat 5333,2023-09-14,00:00:00,39,14,25,FMN 03 Kolonel Silvertopstraat
651,Kolonel Silvertopstraat 5333,2023-09-14,01:00:00,22,8,14,FMN 03 Kolonel Silvertopstraat
651,Kolonel Silvertopstraat 5333,2023-09-14,02:00:00,18,7,11,FMN 03 Kolonel Silvertopstraat
651,Kolonel Silvertopstraat 5333,2023-09-14,03:00:00,18,10,8,FMN 03 Kolonel Silvertopstraat
651,Kolonel Silvertopstraat 5333,2023-09-14,04:00:00,26,21,5,FMN 03 Kolonel Silvertopstraat
651,Kolonel Silvertopstraat 5333,2023-09-14,05:00:00,72,46,26,FMN 03 Kolonel Silvertopstraat
651,Kolonel Silvertopstraat 5333,2023-09-14,06:00:00,153,127,26,FMN 03 Kolonel Silvertopstraat
651,Kolonel Silvertopstraat 5333,2023-09-14,07:00:00,379,318,61,FMN 03 Kolonel Silvertopstraat
651,Kolonel Silvertopstraat 5333,2023-09-14,08:00:00,778,672,106,FMN 03 Kolonel Silvertopstraat
651,Kolonel Silvertopstraat 5333,2023-09-14,09:00:00,271,223,48,FMN 03 Kolonel Silvertopstraat
651,Kolonel Silvertopstraat 5333,2023-09-14,10:00:00,210,169,41,FMN 03 Kolonel Silvertopstraat
651,Kolonel Silvertopstraat 5333,2023-09-14,11:00:00,185,139,46,FMN 03 Kolonel Silvertopstraat
651,Kolonel Silvertopstraat 5333,2023-09-14,12:00:00,246,174,72,FMN 03 Kolonel Silvertopstraat
651,Kolonel Silvertopstraat 5333,2023-09-14,13:00:00,205,152,53,FMN 03 Kolonel Silvertopstraat
651,Kolonel Silvertopstraat 5333,2023-09-14,14:00:00,214,146,68,FMN 03 Kolonel Silvertopstraat
651,Kolonel Silvertopstraat 5333,2023-09-14,15:00:00,372,235,137,FMN 03 Kolonel Silvertopstraat
651,Kolonel Silvertopstraat 5333,2023-09-14,16:00:00,417,284,133,FMN 03 Kolonel Silvertopstraat
651,Kolonel Silvertopstraat 5333,2023-09-14,17:00:00,452,276,176,FMN 03 Kolonel Silvertopstraat
651,Kolonel Silvertopstraat 5333,2023-09-14,18:00:00,365,231,134,FMN 03 Kolonel Silvertopstraat
651,Kolonel Silvertopstraat 5333,2023-09-14,19:00:00,261,175,86,FMN 03 Kolonel Silvertopstraat
651,Kolonel Silvertopstraat 5333,2023-09-14,20:00:00,206,132,74,FMN 03 Kolonel Silvertopstraat
651,Kolonel Silvertopstraat 5333,2023-09-14,21:00:00,188,96,92,FMN 03 Kolonel Silvertopstraat
651,Kolonel Silvertopstraat 5333,2023-09-14,22:00:00,140,68,72,FMN 03 Kolonel Silvertopstraat
651,Kolonel Silvertopstraat 5333,2023-09-14,23:00:00,83,33,50,FMN 03 Kolonel Silvertopstraat
651,Kolonel Silvertopstraat 5333,2023-09-15,00:00:00,47,25,22,FMN 03 Kolonel Silvertopstraat
651,Kolonel Silvertopstraat 5333,2023-09-15,01:00:00,30,13,17,FMN 03 Kolonel Silvertopstraat
651,Kolonel Silvertopstraat 5333,2023-09-15,02:00:00,16,7,9,FMN 03 Kolonel Silvertopstraat
651,Kolonel Silvertopstraat 5333,2023-09-15,03:00:00,15,7,8,FMN 03 Kolonel Silvertopstraat
651,Kolonel Silvertopstraat 5333,2023-09-15,04:00:00,34,22,12,FMN 03 Kolonel Silvertopstraat
651,Kolonel Silvertopstraat 5333,2023-09-15,05:00:00,69,46,23,FMN 03 Kolonel Silvertopstraat
651,Kolonel Silvertopstraat 5333,2023-09-15,06:00:00,141,114,27,FMN 03 Kolonel Silvertopstraat
651,Kolonel Silvertopstraat 5333,2023-09-15,07:00:00,366,304,62,FMN 03 Kolonel Silvertopstraat
651,Kolonel Silvertopstraat 5333,2023-09-15,08:00:00,684,579,105,FMN 03 Kolonel Silvertopstraat
651,Kolonel Silvertopstraat 5333,2023-09-15,09:00:00,266,215,51,FMN 03 Kolonel Silvertopstraat
651,Kolonel Silvertopstraat 5333,2023-09-15,10:00:00,217,157,60,FMN 03 Kolonel Silvertopstraat
651,Kolonel Silvertopstraat 5333,2023-09-15,11:00:00,240,169,71,FMN 03 Kolonel Silvertopstraat
651,Kolonel Silvertopstraat 5333,2023-09-15,12:00:00,308,213,95,FMN 03 Kolonel Silvertopstraat
651,Kolonel Silvertopstraat 5333,2023-09-15,13:00:00,293,207,86,FMN 03 Kolonel Silvertopstraat
651,Kolonel Silvertopstraat 5333,2023-09-15,14:00:00,283,189,94,FMN 03 Kolonel Silvertopstraat
651,Kolonel Silvertopstraat 5333,2023-09-15,15:00:00,384,238,146,FMN 03 Kolonel Silvertopstraat
651,Kolonel Silvertopstraat 5333,2023-09-15,16:00:00,380,227,153,FMN 03 Kolonel Silvertopstraat
651,Kolonel Silvertopstraat 5333,2023-09-15,17:00:00,389,251,138,FMN 03 Kolonel Silvertopstraat
651,Kolonel Silvertopstraat 5333,2023-09-15,18:00:00,354,239,115,FMN 03 Kolonel Silvertopstraat
651,Kolonel Silvertopstraat 5333,2023-09-15,19:00:00,292,212,80,FMN 03 Kolonel Silvertopstraat
651,Kolonel Silvertopstraat 5333,2023-09-15,20:00:00,249,168,81,FMN 03 Kolonel Silvertopstraat
651,Kolonel Silvertopstraat 5333,2023-09-15,21:00:00,183,115,68,FMN 03 Kolonel Silvertopstraat
651,Kolonel Silvertopstraat 5333,2023-09-15,22:00:00,152,85,67,FMN 03 Kolonel Silvertopstraat
651,Kolonel Silvertopstraat 5333,2023-09-15,23:00:00,132,60,72,FMN 03 Kolonel Silvertopstraat
651,Kolonel Silvertopstraat 5333,2023-09-16,00:00:00,103,43,60,FMN 03 Kolonel Silvertopstraat
651,Kolonel Silvertopstraat 5333,2023-09-16,01:00:00,52,19,33,FMN 03 Kolonel Silvertopstraat
651,Kolonel Silvertopstraat 5333,2023-09-16,02:00:00,42,22,20,FMN 03 Kolonel Silvertopstraat
651,Kolonel Silvertopstraat 5333,2023-09-16,03:00:00,33,13,20,FMN 03 Kolonel Silvertopstraat
651,Kolonel Silvertopstraat 5333,2023-09-16,04:00:00,29,12,17,FMN 03 Kolonel Silvertopstraat
651,Kolonel Silvertopstraat 5333,2023-09-16,05:00:00,34,20,14,FMN 03 Kolonel Silvertopstraat
651,Kolonel Silvertopstraat 5333,2023-09-16,06:00:00,80,60,20,FMN 03 Kolonel Silvertopstraat
651,Kolonel Silvertopstraat 5333,2023-09-16,07:00:00,52,36,16,FMN 03 Kolonel Silvertopstraat
651,Kolonel Silvertopstraat 5333,2023-09-16,08:00:00,120,92,28,FMN 03 Kolonel Silvertopstraat
651,Kolonel Silvertopstraat 5333,2023-09-16,09:00:00,177,145,32,FMN 03 Kolonel Silvertopstraat
651,Kolonel Silvertopstraat 5333,2023-09-16,10:00:00,167,137,30,FMN 03 Kolonel Silvertopstraat
651,Kolonel Silvertopstraat 5333,2023-09-16,11:00:00,208,155,53,FMN 03 Kolonel Silvertopstraat
651,Kolonel Silvertopstraat 5333,2023-09-16,12:00:00,235,180,55,FMN 03 Kolonel Silvertopstraat
651,Kolonel Silvertopstraat 5333,2023-09-16,13:00:00,261,186,75,FMN 03 Kolonel Silvertopstraat
651,Kolonel Silvertopstraat 5333,2023-09-16,14:00:00,260,188,72,FMN 03 Kolonel Silvertopstraat
651,Kolonel Silvertopstraat 5333,2023-09-16,15:00:00,258,169,89,FMN 03 Kolonel Silvertopstraat
651,Kolonel Silvertopstraat 5333,2023-09-16,16:00:00,257,157,100,FMN 03 Kolonel Silvertopstraat
651,Kolonel Silvertopstraat 5333,2023-09-16,17:00:00,278,184,94,FMN 03 Kolonel Silvertopstraat
651,Kolonel Silvertopstraat 5333,2023-09-16,18:00:00,278,189,89,FMN 03 Kolonel Silvertopstraat
651,Kolonel Silvertopstraat 5333,2023-09-16,19:00:00,269,160,109,FMN 03 Kolonel Silvertopstraat
651,Kolonel Silvertopstraat 5333,2023-09-16,20:00:00,182,109,73,FMN 03 Kolonel Silvertopstraat
651,Kolonel Silvertopstraat 5333,2023-09-16,21:00:00,142,83,59,FMN 03 Kolonel Silvertopstraat
651,Kolonel Silvertopstraat 5333,2023-09-16,22:00:00,212,146,66,FMN 03 Kolonel Silvertopstraat
651,Kolonel Silvertopstraat 5333,2023-09-16,23:00:00,145,93,52,FMN 03 Kolonel Silvertopstraat
651,Kolonel Silvertopstraat 5333,2023-09-17,00:00:00,92,57,35,FMN 03 Kolonel Silvertopstraat
651,Kolonel Silvertopstraat 5333,2023-09-17,01:00:00,64,30,34,FMN 03 Kolonel Silvertopstraat
651,Kolonel Silvertopstraat 5333,2023-09-17,02:00:00,41,21,20,FMN 03 Kolonel Silvertopstraat
651,Kolonel Silvertopstraat 5333,2023-09-17,03:00:00,44,20,24,FMN 03 Kolonel Silvertopstraat
651,Kolonel Silvertopstraat 5333,2023-09-17,04:00:00,22,11,11,FMN 03 Kolonel Silvertopstraat
651,Kolonel Silvertopstraat 5333,2023-09-17,05:00:00,38,20,18,FMN 03 Kolonel Silvertopstraat
651,Kolonel Silvertopstraat 5333,2023-09-17,06:00:00,54,40,14,FMN 03 Kolonel Silvertopstraat
651,Kolonel Silvertopstraat 5333,2023-09-17,07:00:00,26,21,5,FMN 03 Kolonel Silvertopstraat
651,Kolonel Silvertopstraat 5333,2023-09-17,08:00:00,76,56,20,FMN 03 Kolonel Silvertopstraat
651,Kolonel Silvertopstraat 5333,2023-09-17,09:00:00,117,96,21,FMN 03 Kolonel Silvertopstraat
651,Kolonel Silvertopstraat 5333,2023-09-17,10:00:00,142,120,22,FMN 03 Kolonel Silvertopstraat
651,Kolonel Silvertopstraat 5333,2023-09-17,11:00:00,187,157,30,FMN 03 Kolonel Silvertopstraat
651,Kolonel Silvertopstraat 5333,2023-09-17,12:00:00,208,165,43,FMN 03 Kolonel Silvertopstraat
651,Kolonel Silvertopstraat 5333,2023-09-17,13:00:00,254,195,59,FMN 03 Kolonel Silvertopstraat
651,Kolonel Silvertopstraat 5333,2023-09-17,14:00:00,265,195,70,FMN 03 Kolonel Silvertopstraat
651,Kolonel Silvertopstraat 5333,2023-09-17,15:00:00,275,196,79,FMN 03 Kolonel Silvertopstraat
651,Kolonel Silvertopstraat 5333,2023-09-17,16:00:00,252,182,70,FMN 03 Kolonel Silvertopstraat
651,Kolonel Silvertopstraat 5333,2023-09-17,17:00:00,254,162,92,FMN 03 Kolonel Silvertopstraat
651,Kolonel Silvertopstraat 5333,2023-09-17,18:00:00,189,121,68,FMN 03 Kolonel Silvertopstraat
651,Kolonel Silvertopstraat 5333,2023-09-17,19:00:00,219,142,77,FMN 03 Kolonel Silvertopstraat
651,Kolonel Silvertopstraat 5333,2023-09-17,20:00:00,178,104,74,FMN 03 Kolonel Silvertopstraat
651,Kolonel Silvertopstraat 5333,2023-09-17,21:00:00,137,79,58,FMN 03 Kolonel Silvertopstraat
651,Kolonel Silvertopstraat 5333,2023-09-17,22:00:00,89,48,41,FMN 03 Kolonel Silvertopstraat
651,Kolonel Silvertopstraat 5333,2023-09-17,23:00:00,59,31,28,FMN 03 Kolonel Silvertopstraat
651,Kolonel Silvertopstraat 5333,2023-09-18,00:00:00,42,14,28,FMN 03 Kolonel Silvertopstraat
651,Kolonel Silvertopstraat 5333,2023-09-18,01:00:00,14,9,5,FMN 03 Kolonel Silvertopstraat
651,Kolonel Silvertopstraat 5333,2023-09-18,02:00:00,9,3,6,FMN 03 Kolonel Silvertopstraat
651,Kolonel Silvertopstraat 5333,2023-09-18,03:00:00,11,5,6,FMN 03 Kolonel Silvertopstraat
651,Kolonel Silvertopstraat 5333,2023-09-18,04:00:00,29,26,3,FMN 03 Kolonel Silvertopstraat
651,Kolonel Silvertopstraat 5333,2023-09-18,05:00:00,60,36,24,FMN 03 Kolonel Silvertopstraat
651,Kolonel Silvertopstraat 5333,2023-09-18,06:00:00,136,106,30,FMN 03 Kolonel Silvertopstraat
651,Kolonel Silvertopstraat 5333,2023-09-18,07:00:00,354,307,47,FMN 03 Kolonel Silvertopstraat
651,Kolonel Silvertopstraat 5333,2023-09-18,08:00:00,856,746,110,FMN 03 Kolonel Silvertopstraat
651,Kolonel Silvertopstraat 5333,2023-09-18,09:00:00,260,212,48,FMN 03 Kolonel Silvertopstraat
651,Kolonel Silvertopstraat 5333,2023-09-18,10:00:00,202,162,40,FMN 03 Kolonel Silvertopstraat
651,Kolonel Silvertopstraat 5333,2023-09-18,11:00:00,139,99,40,FMN 03 Kolonel Silvertopstraat
651,Kolonel Silvertopstraat 5333,2023-09-18,12:00:00,246,164,82,FMN 03 Kolonel Silvertopstraat
651,Kolonel Silvertopstraat 5333,2023-09-18,13:00:00,205,126,79,FMN 03 Kolonel Silvertopstraat
651,Kolonel Silvertopstraat 5333,2023-09-18,14:00:00,259,162,97,FMN 03 Kolonel Silvertopstraat
651,Kolonel Silvertopstraat 5333,2023-09-18,15:00:00,327,216,111,FMN 03 Kolonel Silvertopstraat
651,Kolonel Silvertopstraat 5333,2023-09-18,16:00:00,363,243,120,FMN 03 Kolonel Silvertopstraat
651,Kolonel Silvertopstraat 5333,2023-09-18,17:00:00,428,259,169,FMN 03 Kolonel Silvertopstraat
651,Kolonel Silvertopstraat 5333,2023-09-18,18:00:00,304,185,119,FMN 03 Kolonel Silvertopstraat
651,Kolonel Silvertopstraat 5333,2023-09-18,19:00:00,197,133,64,FMN 03 Kolonel Silvertopstraat
651,Kolonel Silvertopstraat 5333,2023-09-18,20:00:00,189,103,86,FMN 03 Kolonel Silvertopstraat
651,Kolonel Silvertopstraat 5333,2023-09-18,21:00:00,152,87,65,FMN 03 Kolonel Silvertopstraat
651,Kolonel Silvertopstraat 5333,2023-09-18,22:00:00,122,74,48,FMN 03 Kolonel Silvertopstraat
651,Kolonel Silvertopstraat 5333,2023-09-18,23:00:00,46,24,22,FMN 03 Kolonel Silvertopstraat
651,Kolonel Silvertopstraat 5333,2023-09-19,00:00:00,33,16,17,FMN 03 Kolonel Silvertopstraat
651,Kolonel Silvertopstraat 5333,2023-09-19,01:00:00,10,5,5,FMN 03 Kolonel Silvertopstraat
651,Kolonel Silvertopstraat 5333,2023-09-19,02:00:00,10,5,5,FMN 03 Kolonel Silvertopstraat
651,Kolonel Silvertopstraat 5333,2023-09-19,03:00:00,10,7,3,FMN 03 Kolonel Silvertopstraat
651,Kolonel Silvertopstraat 5333,2023-09-19,04:00:00,36,25,11,FMN 03 Kolonel Silvertopstraat
651,Kolonel Silvertopstraat 5333,2023-09-19,05:00:00,58,36,22,FMN 03 Kolonel Silvertopstraat
651,Kolonel Silvertopstraat 5333,2023-09-19,06:00:00,149,113,36,FMN 03 Kolonel Silvertopstraat
651,Kolonel Silvertopstraat 5333,2023-09-19,07:00:00,427,368,59,FMN 03 Kolonel Silvertopstraat
651,Kolonel Silvertopstraat 5333,2023-09-19,08:00:00,802,705,97,FMN 03 Kolonel Silvertopstraat
651,Kolonel Silvertopstraat 5333,2023-09-19,09:00:00,237,202,35,FMN 03 Kolonel Silvertopstraat
651,Kolonel Silvertopstraat 5333,2023-09-19,10:00:00,189,157,32,FMN 03 Kolonel Silvertopstraat
651,Kolonel Silvertopstraat 5333,2023-09-19,11:00:00,188,150,38,FMN 03 Kolonel Silvertopstraat
651,Kolonel Silvertopstraat 5333,2023-09-19,12:00:00,231,158,73,FMN 03 Kolonel Silvertopstraat
651,Kolonel Silvertopstraat 5333,2023-09-19,13:00:00,240,169,71,FMN 03 Kolonel Silvertopstraat
651,Kolonel Silvertopstraat 5333,2023-09-19,14:00:00,286,185,101,FMN 03 Kolonel Silvertopstraat
651,Kolonel Silvertopstraat 5333,2023-09-19,15:00:00,363,213,150,FMN 03 Kolonel Silvertopstraat
651,Kolonel Silvertopstraat 5333,2023-09-19,16:00:00,443,303,140,FMN 03 Kolonel Silvertopstraat
651,Kolonel Silvertopstraat 5333,2023-09-19,17:00:00,436,271,165,FMN 03 Kolonel Silvertopstraat
651,Kolonel Silvertopstraat 5333,2023-09-19,18:00:00,350,239,111,FMN 03 Kolonel Silvertopstraat
651,Kolonel Silvertopstraat 5333,2023-09-19,19:00:00,197,122,75,FMN 03 Kolonel Silvertopstraat
651,Kolonel Silvertopstraat 5333,2023-09-19,20:00:00,166,107,59,FMN 03 Kolonel Silvertopstraat
651,Kolonel Silvertopstraat 5333,2023-09-19,21:00:00,120,63,57,FMN 03 Kolonel Silvertopstraat
651,Kolonel Silvertopstraat 5333,2023-09-19,22:00:00,132,78,54,FMN 03 Kolonel Silvertopstraat
651,Kolonel Silvertopstraat 5333,2023-09-19,23:00:00,63,29,34,FMN 03 Kolonel Silvertopstraat
651,Kolonel Silvertopstraat 5333,2023-09-20,00:00:00,30,9,21,FMN 03 Kolonel Silvertopstraat
651,Kolonel Silvertopstraat 5333,2023-09-20,01:00:00,20,9,11,FMN 03 Kolonel Silvertopstraat
651,Kolonel Silvertopstraat 5333,2023-09-20,02:00:00,17,4,13,FMN 03 Kolonel Silvertopstraat
651,Kolonel Silvertopstraat 5333,2023-09-20,03:00:00,8,5,3,FMN 03 Kolonel Silvertopstraat
651,Kolonel Silvertopstraat 5333,2023-09-20,04:00:00,40,33,7,FMN 03 Kolonel Silvertopstraat
651,Kolonel Silvertopstraat 5333,2023-09-20,05:00:00,53,38,15,FMN 03 Kolonel Silvertopstraat
651,Kolonel Silvertopstraat 5333,2023-09-20,06:00:00,153,120,33,FMN 03 Kolonel Silvertopstraat
651,Kolonel Silvertopstraat 5333,2023-09-20,07:00:00,372,306,66,FMN 03 Kolonel Silvertopstraat
651,Kolonel Silvertopstraat 5333,2023-09-20,08:00:00,748,648,100,FMN 03 Kolonel Silvertopstraat
651,Kolonel Silvertopstraat 5333,2023-09-20,09:00:00,246,186,60,FMN 03 Kolonel Silvertopstraat
651,Kolonel Silvertopstraat 5333,2023-09-20,10:00:00,192,142,50,FMN 03 Kolonel Silvertopstraat
651,Kolonel Silvertopstraat 5333,2023-09-20,11:00:00,196,144,52,FMN 03 Kolonel Silvertopstraat
651,Kolonel Silvertopstraat 5333,2023-09-20,12:00:00,373,236,137,FMN 03 Kolonel Silvertopstraat
651,Kolonel Silvertopstraat 5333,2023-09-20,13:00:00,292,186,106,FMN 03 Kolonel Silvertopstraat
651,Kolonel Silvertopstraat 5333,2023-09-20,14:00:00,250,174,76,FMN 03 Kolonel Silvertopstraat
651,Kolonel Silvertopstraat 5333,2023-09-20,15:00:00,303,191,112,FMN 03 Kolonel Silvertopstraat
651,Kolonel Silvertopstraat 5333,2023-09-20,16:00:00,362,250,112,FMN 03 Kolonel Silvertopstraat
651,Kolonel Silvertopstraat 5333,2023-09-20,17:00:00,460,303,157,FMN 03 Kolonel Silvertopstraat
651,Kolonel Silvertopstraat 5333,2023-09-20,18:00:00,324,227,97,FMN 03 Kolonel Silvertopstraat
651,Kolonel Silvertopstraat 5333,2023-09-20,19:00:00,238,174,64,FMN 03 Kolonel Silvertopstraat
651,Kolonel Silvertopstraat 5333,2023-09-20,20:00:00,176,106,70,FMN 03 Kolonel Silvertopstraat
651,Kolonel Silvertopstraat 5333,2023-09-20,21:00:00,144,77,67,FMN 03 Kolonel Silvertopstraat
651,Kolonel Silvertopstraat 5333,2023-09-20,22:00:00,129,73,56,FMN 03 Kolonel Silvertopstraat
651,Kolonel Silvertopstraat 5333,2023-09-20,23:00:00,67,38,29,FMN 03 Kolonel Silvertopstraat
651,Kolonel Silvertopstraat 5333,2023-09-21,00:00:00,38,20,18,FMN 03 Kolonel Silvertopstraat
651,Kolonel Silvertopstraat 5333,2023-09-21,01:00:00,19,10,9,FMN 03 Kolonel Silvertopstraat
651,Kolonel Silvertopstraat 5333,2023-09-21,02:00:00,11,8,3,FMN 03 Kolonel Silvertopstraat
651,Kolonel Silvertopstraat 5333,2023-09-21,03:00:00,11,4,7,FMN 03 Kolonel Silvertopstraat
651,Kolonel Silvertopstraat 5333,2023-09-21,04:00:00,38,30,8,FMN 03 Kolonel Silvertopstraat
651,Kolonel Silvertopstraat 5333,2023-09-21,05:00:00,48,29,19,FMN 03 Kolonel Silvertopstraat
651,Kolonel Silvertopstraat 5333,2023-09-21,06:00:00,115,94,21,FMN 03 Kolonel Silvertopstraat
651,Kolonel Silvertopstraat 5333,2023-09-21,07:00:00,319,277,42,FMN 03 Kolonel Silvertopstraat
651,Kolonel Silvertopstraat 5333,2023-09-21,08:00:00,599,514,85,FMN 03 Kolonel Silvertopstraat
651,Kolonel Silvertopstraat 5333,2023-09-21,09:00:00,239,194,45,FMN 03 Kolonel Silvertopstraat
651,Kolonel Silvertopstraat 5333,2023-09-21,10:00:00,143,116,27,FMN 03 Kolonel Silvertopstraat
651,Kolonel Silvertopstraat 5333,2023-09-21,11:00:00,87,66,21,FMN 03 Kolonel Silvertopstraat
651,Kolonel Silvertopstraat 5333,2023-09-21,12:00:00,144,93,51,FMN 03 Kolonel Silvertopstraat
651,Kolonel Silvertopstraat 5333,2023-09-21,13:00:00,120,82,38,FMN 03 Kolonel Silvertopstraat
651,Kolonel Silvertopstraat 5333,2023-09-21,14:00:00,182,112,70,FMN 03 Kolonel Silvertopstraat
651,Kolonel Silvertopstraat 5333,2023-09-21,15:00:00,217,137,80,FMN 03 Kolonel Silvertopstraat
651,Kolonel Silvertopstraat 5333,2023-09-21,16:00:00,286,183,103,FMN 03 Kolonel Silvertopstraat
651,Kolonel Silvertopstraat 5333,2023-09-21,17:00:00,285,189,96,FMN 03 Kolonel Silvertopstraat
651,Kolonel Silvertopstraat 5333,2023-09-21,18:00:00,222,137,85,FMN 03 Kolonel Silvertopstraat
651,Kolonel Silvertopstraat 5333,2023-09-21,19:00:00,158,112,46,FMN 03 Kolonel Silvertopstraat
651,Kolonel Silvertopstraat 5333,2023-09-21,20:00:00,146,93,53,FMN 03 Kolonel Silvertopstraat
651,Kolonel Silvertopstraat 5333,2023-09-21,21:00:00,117,69,48,FMN 03 Kolonel Silvertopstraat
651,Kolonel Silvertopstraat 5333,2023-09-21,22:00:00,118,61,57,FMN 03 Kolonel Silvertopstraat
651,Kolonel Silvertopstraat 5333,2023-09-21,23:00:00,57,28,29,FMN 03 Kolonel Silvertopstraat
651,Kolonel Silvertopstraat 5333,2023-09-22,00:00:00,37,20,17,FMN 03 Kolonel Silvertopstraat
651,Kolonel Silvertopstraat 5333,2023-09-22,01:00:00,30,10,20,FMN 03 Kolonel Silvertopstraat
651,Kolonel Silvertopstraat 5333,2023-09-22,02:00:00,19,7,12,FMN 03 Kolonel Silvertopstraat
651,Kolonel Silvertopstraat 5333,2023-09-22,03:00:00,13,5,8,FMN 03 Kolonel Silvertopstraat
651,Kolonel Silvertopstraat 5333,2023-09-22,04:00:00,33,24,9,FMN 03 Kolonel Silvertopstraat
651,Kolonel Silvertopstraat 5333,2023-09-22,05:00:00,54,34,20,FMN 03 Kolonel Silvertopstraat
651,Kolonel Silvertopstraat 5333,2023-09-22,06:00:00,112,84,28,FMN 03 Kolonel Silvertopstraat
651,Kolonel Silvertopstraat 5333,2023-09-22,07:00:00,314,265,49,FMN 03 Kolonel Silvertopstraat
651,Kolonel Silvertopstraat 5333,2023-09-22,08:00:00,662,597,65,FMN 03 Kolonel Silvertopstraat
651,Kolonel Silvertopstraat 5333,2023-09-22,09:00:00,215,172,43,FMN 03 Kolonel Silvertopstraat
651,Kolonel Silvertopstraat 5333,2023-09-22,10:00:00,213,179,34,FMN 03 Kolonel Silvertopstraat
651,Kolonel Silvertopstraat 5333,2023-09-22,11:00:00,202,147,55,FMN 03 Kolonel Silvertopstraat
651,Kolonel Silvertopstraat 5333,2023-09-22,12:00:00,268,181,87,FMN 03 Kolonel Silvertopstraat
651,Kolonel Silvertopstraat 5333,2023-09-22,13:00:00,239,157,82,FMN 03 Kolonel Silvertopstraat
651,Kolonel Silvertopstraat 5333,2023-09-22,14:00:00,244,139,105,FMN 03 Kolonel Silvertopstraat
651,Kolonel Silvertopstraat 5333,2023-09-22,15:00:00,331,213,118,FMN 03 Kolonel Silvertopstraat
651,Kolonel Silvertopstraat 5333,2023-09-22,16:00:00,351,227,124,FMN 03 Kolonel Silvertopstraat
651,Kolonel Silvertopstraat 5333,2023-09-22,17:00:00,367,235,132,FMN 03 Kolonel Silvertopstraat
651,Kolonel Silvertopstraat 5333,2023-09-22,18:00:00,285,183,102,FMN 03 Kolonel Silvertopstraat
651,Kolonel Silvertopstraat 5333,2023-09-22,19:00:00,225,150,75,FMN 03 Kolonel Silvertopstraat
651,Kolonel Silvertopstraat 5333,2023-09-22,20:00:00,146,88,58,FMN 03 Kolonel Silvertopstraat
651,Kolonel Silvertopstraat 5333,2023-09-22,21:00:00,107,63,44,FMN 03 Kolonel Silvertopstraat
651,Kolonel Silvertopstraat 5333,2023-09-22,22:00:00,122,74,48,FMN 03 Kolonel Silvertopstraat
651,Kolonel Silvertopstraat 5333,2023-09-22,23:00:00,69,33,36,FMN 03 Kolonel Silvertopstraat
651,Kolonel Silvertopstraat 5333,2023-09-23,00:00:00,64,40,24,FMN 03 Kolonel Silvertopstraat
651,Kolonel Silvertopstraat 5333,2023-09-23,01:00:00,53,23,30,FMN 03 Kolonel Silvertopstraat
651,Kolonel Silvertopstraat 5333,2023-09-23,02:00:00,31,15,16,FMN 03 Kolonel Silvertopstraat
651,Kolonel Silvertopstraat 5333,2023-09-23,03:00:00,24,8,16,FMN 03 Kolonel Silvertopstraat
651,Kolonel Silvertopstraat 5333,2023-09-23,04:00:00,18,3,15,FMN 03 Kolonel Silvertopstraat
651,Kolonel Silvertopstraat 5333,2023-09-23,05:00:00,29,17,12,FMN 03 Kolonel Silvertopstraat
651,Kolonel Silvertopstraat 5333,2023-09-23,06:00:00,39,27,12,FMN 03 Kolonel Silvertopstraat
651,Kolonel Silvertopstraat 5333,2023-09-23,07:00:00,47,35,12,FMN 03 Kolonel Silvertopstraat
651,Kolonel Silvertopstraat 5333,2023-09-23,08:00:00,93,72,21,FMN 03 Kolonel Silvertopstraat
651,Kolonel Silvertopstraat 5333,2023-09-23,09:00:00,158,136,22,FMN 03 Kolonel Silvertopstraat
651,Kolonel Silvertopstraat 5333,2023-09-23,10:00:00,178,139,39,FMN 03 Kolonel Silvertopstraat
651,Kolonel Silvertopstraat 5333,2023-09-23,11:00:00,174,130,44,FMN 03 Kolonel Silvertopstraat
651,Kolonel Silvertopstraat 5333,2023-09-23,12:00:00,179,134,45,FMN 03 Kolonel Silvertopstraat
651,Kolonel Silvertopstraat 5333,2023-09-23,13:00:00,216,164,52,FMN 03 Kolonel Silvertopstraat
651,Kolonel Silvertopstraat 5333,2023-09-23,14:00:00,220,154,66,FMN 03 Kolonel Silvertopstraat
651,Kolonel Silvertopstraat 5333,2023-09-23,15:00:00,214,142,72,FMN 03 Kolonel Silvertopstraat
651,Kolonel Silvertopstraat 5333,2023-09-23,16:00:00,236,167,69,FMN 03 Kolonel Silvertopstraat
651,Kolonel Silvertopstraat 5333,2023-09-23,17:00:00,238,163,75,FMN 03 Kolonel Silvertopstraat
651,Kolonel Silvertopstraat 5333,2023-09-23,18:00:00,222,147,75,FMN 03 Kolonel Silvertopstraat
651,Kolonel Silvertopstraat 5333,2023-09-23,19:00:00,196,136,60,FMN 03 Kolonel Silvertopstraat
651,Kolonel Silvertopstraat 5333,2023-09-23,20:00:00,189,116,73,FMN 03 Kolonel Silvertopstraat
651,Kolonel Silvertopstraat 5333,2023-09-23,21:00:00,125,75,50,FMN 03 Kolonel Silvertopstraat
651,Kolonel Silvertopstraat 5333,2023-09-23,22:00:00,118,64,54,FMN 03 Kolonel Silvertopstraat
651,Kolonel Silvertopstraat 5333,2023-09-23,23:00:00,100,50,50,FMN 03 Kolonel Silvertopstraat
651,Kolonel Silvertopstraat 5333,2023-09-24,00:00:00,78,33,45,FMN 03 Kolonel Silvertopstraat
651,Kolonel Silvertopstraat 5333,2023-09-24,01:00:00,48,27,21,FMN 03 Kolonel Silvertopstraat
651,Kolonel Silvertopstraat 5333,2023-09-24,02:00:00,29,9,20,FMN 03 Kolonel Silvertopstraat
651,Kolonel Silvertopstraat 5333,2023-09-24,03:00:00,34,11,23,FMN 03 Kolonel Silvertopstraat
651,Kolonel Silvertopstraat 5333,2023-09-24,04:00:00,24,12,12,FMN 03 Kolonel Silvertopstraat
651,Kolonel Silvertopstraat 5333,2023-09-24,05:00:00,19,8,11,FMN 03 Kolonel Silvertopstraat
651,Kolonel Silvertopstraat 5333,2023-09-24,06:00:00,35,22,13,FMN 03 Kolonel Silvertopstraat
651,Kolonel Silvertopstraat 5333,2023-09-24,07:00:00,24,12,12,FMN 03 Kolonel Silvertopstraat
651,Kolonel Silvertopstraat 5333,2023-09-24,08:00:00,61,50,11,FMN 03 Kolonel Silvertopstraat
651,Kolonel Silvertopstraat 5333,2023-09-24,09:00:00,122,90,32,FMN 03 Kolonel Silvertopstraat
651,Kolonel Silvertopstraat 5333,2023-09-24,10:00:00,158,125,33,FMN 03 Kolonel Silvertopstraat
651,Kolonel Silvertopstraat 5333,2023-09-24,11:00:00,165,131,34,FMN 03 Kolonel Silvertopstraat
651,Kolonel Silvertopstraat 5333,2023-09-24,12:00:00,200,157,43,FMN 03 Kolonel Silvertopstraat
651,Kolonel Silvertopstraat 5333,2023-09-24,13:00:00,208,155,53,FMN 03 Kolonel Silvertopstraat
651,Kolonel Silvertopstraat 5333,2023-09-24,14:00:00,271,212,59,FMN 03 Kolonel Silvertopstraat
651,Kolonel Silvertopstraat 5333,2023-09-24,15:00:00,228,178,50,FMN 03 Kolonel Silvertopstraat
651,Kolonel Silvertopstraat 5333,2023-09-24,16:00:00,206,146,60,FMN 03 Kolonel Silvertopstraat
651,Kolonel Silvertopstraat 5333,2023-09-24,17:00:00,224,133,91,FMN 03 Kolonel Silvertopstraat
651,Kolonel Silvertopstraat 5333,2023-09-24,18:00:00,192,130,62,FMN 03 Kolonel Silvertopstraat
651,Kolonel Silvertopstraat 5333,2023-09-24,19:00:00,177,106,71,FMN 03 Kolonel Silvertopstraat
651,Kolonel Silvertopstraat 5333,2023-09-24,20:00:00,148,81,67,FMN 03 Kolonel Silvertopstraat
651,Kolonel Silvertopstraat 5333,2023-09-24,21:00:00,108,62,46,FMN 03 Kolonel Silvertopstraat
651,Kolonel Silvertopstraat 5333,2023-09-24,22:00:00,88,47,41,FMN 03 Kolonel Silvertopstraat
651,Kolonel Silvertopstraat 5333,2023-09-24,23:00:00,42,25,17,FMN 03 Kolonel Silvertopstraat
651,Kolonel Silvertopstraat 5333,2023-09-25,00:00:00,29,8,21,FMN 03 Kolonel Silvertopstraat
651,Kolonel Silvertopstraat 5333,2023-09-25,01:00:00,19,3,16,FMN 03 Kolonel Silvertopstraat
651,Kolonel Silvertopstraat 5333,2023-09-25,02:00:00,8,6,2,FMN 03 Kolonel Silvertopstraat
651,Kolonel Silvertopstraat 5333,2023-09-25,03:00:00,13,8,5,FMN 03 Kolonel Silvertopstraat
651,Kolonel Silvertopstraat 5333,2023-09-25,04:00:00,28,21,7,FMN 03 Kolonel Silvertopstraat
651,Kolonel Silvertopstraat 5333,2023-09-25,05:00:00,52,36,16,FMN 03 Kolonel Silvertopstraat
651,Kolonel Silvertopstraat 5333,2023-09-25,06:00:00,141,115,26,FMN 03 Kolonel Silvertopstraat
651,Kolonel Silvertopstraat 5333,2023-09-25,07:00:00,417,341,76,FMN 03 Kolonel Silvertopstraat
651,Kolonel Silvertopstraat 5333,2023-09-25,08:00:00,825,721,104,FMN 03 Kolonel Silvertopstraat
651,Kolonel Silvertopstraat 5333,2023-09-25,09:00:00,248,201,47,FMN 03 Kolonel Silvertopstraat
651,Kolonel Silvertopstraat 5333,2023-09-25,10:00:00,205,163,42,FMN 03 Kolonel Silvertopstraat
651,Kolonel Silvertopstraat 5333,2023-09-25,11:00:00,165,126,39,FMN 03 Kolonel Silvertopstraat
651,Kolonel Silvertopstraat 5333,2023-09-25,12:00:00,243,176,67,FMN 03 Kolonel Silvertopstraat
651,Kolonel Silvertopstraat 5333,2023-09-25,13:00:00,270,193,77,FMN 03 Kolonel Silvertopstraat
651,Kolonel Silvertopstraat 5333,2023-09-25,14:00:00,221,169,52,FMN 03 Kolonel Silvertopstraat
651,Kolonel Silvertopstraat 5333,2023-09-25,15:00:00,338,233,105,FMN 03 Kolonel Silvertopstraat
651,Kolonel Silvertopstraat 5333,2023-09-25,16:00:00,444,303,141,FMN 03 Kolonel Silvertopstraat
651,Kolonel Silvertopstraat 5333,2023-09-25,17:00:00,459,301,158,FMN 03 Kolonel Silvertopstraat
651,Kolonel Silvertopstraat 5333,2023-09-25,18:00:00,378,243,135,FMN 03 Kolonel Silvertopstraat
651,Kolonel Silvertopstraat 5333,2023-09-25,19:00:00,240,151,89,FMN 03 Kolonel Silvertopstraat
651,Kolonel Silvertopstraat 5333,2023-09-25,20:00:00,203,132,71,FMN 03 Kolonel Silvertopstraat
651,Kolonel Silvertopstraat 5333,2023-09-25,21:00:00,116,60,56,FMN 03 Kolonel Silvertopstraat
651,Kolonel Silvertopstraat 5333,2023-09-25,22:00:00,139,79,60,FMN 03 Kolonel Silvertopstraat
651,Kolonel Silvertopstraat 5333,2023-09-25,23:00:00,60,19,41,FMN 03 Kolonel Silvertopstraat
651,Kolonel Silvertopstraat 5333,2023-09-26,00:00:00,33,16,17,FMN 03 Kolonel Silvertopstraat
651,Kolonel Silvertopstraat 5333,2023-09-26,01:00:00,19,7,12,FMN 03 Kolonel Silvertopstraat
651,Kolonel Silvertopstraat 5333,2023-09-26,02:00:00,12,5,7,FMN 03 Kolonel Silvertopstraat
651,Kolonel Silvertopstraat 5333,2023-09-26,03:00:00,13,9,4,FMN 03 Kolonel Silvertopstraat
651,Kolonel Silvertopstraat 5333,2023-09-26,04:00:00,23,19,4,FMN 03 Kolonel Silvertopstraat
651,Kolonel Silvertopstraat 5333,2023-09-26,05:00:00,56,36,20,FMN 03 Kolonel Silvertopstraat
651,Kolonel Silvertopstraat 5333,2023-09-26,06:00:00,156,124,32,FMN 03 Kolonel Silvertopstraat
651,Kolonel Silvertopstraat 5333,2023-09-26,07:00:00,448,377,71,FMN 03 Kolonel Silvertopstraat
651,Kolonel Silvertopstraat 5333,2023-09-26,08:00:00,872,749,123,FMN 03 Kolonel Silvertopstraat
651,Kolonel Silvertopstraat 5333,2023-09-26,09:00:00,303,253,50,FMN 03 Kolonel Silvertopstraat
651,Kolonel Silvertopstraat 5333,2023-09-26,10:00:00,219,182,37,FMN 03 Kolonel Silvertopstraat
651,Kolonel Silvertopstraat 5333,2023-09-26,11:00:00,188,140,48,FMN 03 Kolonel Silvertopstraat
651,Kolonel Silvertopstraat 5333,2023-09-26,12:00:00,276,192,84,FMN 03 Kolonel Silvertopstraat
651,Kolonel Silvertopstraat 5333,2023-09-26,13:00:00,259,177,82,FMN 03 Kolonel Silvertopstraat
651,Kolonel Silvertopstraat 5333,2023-09-26,14:00:00,258,177,81,FMN 03 Kolonel Silvertopstraat
651,Kolonel Silvertopstraat 5333,2023-09-26,15:00:00,395,249,146,FMN 03 Kolonel Silvertopstraat
651,Kolonel Silvertopstraat 5333,2023-09-26,16:00:00,453,303,150,FMN 03 Kolonel Silvertopstraat
651,Kolonel Silvertopstraat 5333,2023-09-26,17:00:00,501,326,175,FMN 03 Kolonel Silvertopstraat
651,Kolonel Silvertopstraat 5333,2023-09-26,18:00:00,394,234,160,FMN 03 Kolonel Silvertopstraat
651,Kolonel Silvertopstraat 5333,2023-09-26,19:00:00,258,166,92,FMN 03 Kolonel Silvertopstraat
651,Kolonel Silvertopstraat 5333,2023-09-26,20:00:00,199,114,85,FMN 03 Kolonel Silvertopstraat
651,Kolonel Silvertopstraat 5333,2023-09-26,21:00:00,148,82,66,FMN 03 Kolonel Silvertopstraat
651,Kolonel Silvertopstraat 5333,2023-09-26,22:00:00,159,94,65,FMN 03 Kolonel Silvertopstraat
651,Kolonel Silvertopstraat 5333,2023-09-26,23:00:00,73,43,30,FMN 03 Kolonel Silvertopstraat
651,Kolonel Silvertopstraat 5333,2023-09-27,00:00:00,26,12,14,FMN 03 Kolonel Silvertopstraat
651,Kolonel Silvertopstraat 5333,2023-09-27,01:00:00,16,6,10,FMN 03 Kolonel Silvertopstraat
651,Kolonel Silvertopstraat 5333,2023-09-27,02:00:00,16,1,15,FMN 03 Kolonel Silvertopstraat
651,Kolonel Silvertopstraat 5333,2023-09-27,03:00:00,12,6,6,FMN 03 Kolonel Silvertopstraat
651,Kolonel Silvertopstraat 5333,2023-09-27,04:00:00,28,21,7,FMN 03 Kolonel Silvertopstraat
651,Kolonel Silvertopstraat 5333,2023-09-27,05:00:00,63,40,23,FMN 03 Kolonel Silvertopstraat
651,Kolonel Silvertopstraat 5333,2023-09-27,06:00:00,147,127,20,FMN 03 Kolonel Silvertopstraat
651,Kolonel Silvertopstraat 5333,2023-09-27,07:00:00,368,306,62,FMN 03 Kolonel Silvertopstraat
651,Kolonel Silvertopstraat 5333,2023-09-27,08:00:00,793,681,112,FMN 03 Kolonel Silvertopstraat
651,Kolonel Silvertopstraat 5333,2023-09-27,09:00:00,285,225,60,FMN 03 Kolonel Silvertopstraat
651,Kolonel Silvertopstraat 5333,2023-09-27,10:00:00,198,149,49,FMN 03 Kolonel Silvertopstraat
651,Kolonel Silvertopstraat 5333,2023-09-27,11:00:00,215,153,62,FMN 03 Kolonel Silvertopstraat
651,Kolonel Silvertopstraat 5333,2023-09-27,12:00:00,420,286,134,FMN 03 Kolonel Silvertopstraat
651,Kolonel Silvertopstraat 5333,2023-09-27,13:00:00,288,189,99,FMN 03 Kolonel Silvertopstraat
651,Kolonel Silvertopstraat 5333,2023-09-27,14:00:00,234,163,71,FMN 03 Kolonel Silvertopstraat
651,Kolonel Silvertopstraat 5333,2023-09-27,15:00:00,295,212,83,FMN 03 Kolonel Silvertopstraat
651,Kolonel Silvertopstraat 5333,2023-09-27,16:00:00,369,263,106,FMN 03 Kolonel Silvertopstraat
651,Kolonel Silvertopstraat 5333,2023-09-27,17:00:00,435,303,132,FMN 03 Kolonel Silvertopstraat
651,Kolonel Silvertopstraat 5333,2023-09-27,18:00:00,366,258,108,FMN 03 Kolonel Silvertopstraat
651,Kolonel Silvertopstraat 5333,2023-09-27,19:00:00,240,160,80,FMN 03 Kolonel Silvertopstraat
651,Kolonel Silvertopstraat 5333,2023-09-27,20:00:00,181,114,67,FMN 03 Kolonel Silvertopstraat
651,Kolonel Silvertopstraat 5333,2023-09-27,21:00:00,127,72,55,FMN 03 Kolonel Silvertopstraat
651,Kolonel Silvertopstraat 5333,2023-09-27,22:00:00,166,98,68,FMN 03 Kolonel Silvertopstraat
651,Kolonel Silvertopstraat 5333,2023-09-27,23:00:00,93,44,49,FMN 03 Kolonel Silvertopstraat
