Meetpunt surrogate key,Meetpunt locatie,Datum,Tijd,Aantal fietsers,Aantal fietsers van,Aantal fietsers naar,Meetpunt code
60,Mechelsesteenweg 365,2018-07-12,00:00:00,0,0,0,FMN GV 05 Lier
60,Mechelsesteenweg 365,2018-07-12,01:00:00,0,0,0,FMN GV 05 Lier
60,Mechelsesteenweg 365,2018-07-12,02:00:00,0,0,0,FMN GV 05 Lier
60,Mechelsesteenweg 365,2018-07-12,03:00:00,0,0,0,FMN GV 05 Lier
60,Mechelsesteenweg 365,2018-07-12,04:00:00,2,2,0,FMN GV 05 Lier
60,Mechelsesteenweg 365,2018-07-12,05:00:00,4,0,4,FMN GV 05 Lier
60,Mechelsesteenweg 365,2018-07-12,06:00:00,18,4,14,FMN GV 05 Lier
60,Mechelsesteenweg 365,2018-07-12,07:00:00,88,24,64,FMN GV 05 Lier
60,Mechelsesteenweg 365,2018-07-12,08:00:00,56,20,36,FMN GV 05 Lier
60,Mechelsesteenweg 365,2018-07-12,09:00:00,98,56,42,FMN GV 05 Lier
60,Mechelsesteenweg 365,2018-07-12,10:00:00,228,76,152,FMN GV 05 Lier
60,Mechelsesteenweg 365,2018-07-12,11:00:00,194,90,104,FMN GV 05 Lier
60,Mechelsesteenweg 365,2018-07-12,12:00:00,130,64,66,FMN GV 05 Lier
60,Mechelsesteenweg 365,2018-07-12,13:00:00,226,82,144,FMN GV 05 Lier
60,Mechelsesteenweg 365,2018-07-12,14:00:00,264,116,148,FMN GV 05 Lier
60,Mechelsesteenweg 365,2018-07-12,15:00:00,240,98,142,FMN GV 05 Lier
60,Mechelsesteenweg 365,2018-07-12,16:00:00,196,78,118,FMN GV 05 Lier
60,Mechelsesteenweg 365,2018-07-12,17:00:00,158,80,78,FMN GV 05 Lier
60,Mechelsesteenweg 365,2018-07-12,18:00:00,138,82,56,FMN GV 05 Lier
60,Mechelsesteenweg 365,2018-07-12,19:00:00,126,78,48,FMN GV 05 Lier
60,Mechelsesteenweg 365,2018-07-12,20:00:00,114,48,66,FMN GV 05 Lier
60,Mechelsesteenweg 365,2018-07-12,21:00:00,64,28,36,FMN GV 05 Lier
60,Mechelsesteenweg 365,2018-07-12,22:00:00,24,10,14,FMN GV 05 Lier
60,Mechelsesteenweg 365,2018-07-12,23:00:00,6,0,6,FMN GV 05 Lier
60,Mechelsesteenweg 365,2018-07-13,00:00:00,6,0,6,FMN GV 05 Lier
60,Mechelsesteenweg 365,2018-07-13,01:00:00,0,0,0,FMN GV 05 Lier
60,Mechelsesteenweg 365,2018-07-13,02:00:00,4,2,2,FMN GV 05 Lier
60,Mechelsesteenweg 365,2018-07-13,03:00:00,2,2,0,FMN GV 05 Lier
60,Mechelsesteenweg 365,2018-07-13,04:00:00,2,2,0,FMN GV 05 Lier
60,Mechelsesteenweg 365,2018-07-13,05:00:00,4,0,4,FMN GV 05 Lier
60,Mechelsesteenweg 365,2018-07-13,06:00:00,12,8,4,FMN GV 05 Lier
60,Mechelsesteenweg 365,2018-07-13,07:00:00,64,24,40,FMN GV 05 Lier
60,Mechelsesteenweg 365,2018-07-13,08:00:00,60,22,38,FMN GV 05 Lier
60,Mechelsesteenweg 365,2018-07-13,09:00:00,70,36,34,FMN GV 05 Lier
60,Mechelsesteenweg 365,2018-07-13,10:00:00,220,80,140,FMN GV 05 Lier
60,Mechelsesteenweg 365,2018-07-13,11:00:00,162,66,96,FMN GV 05 Lier
60,Mechelsesteenweg 365,2018-07-13,12:00:00,122,54,68,FMN GV 05 Lier
60,Mechelsesteenweg 365,2018-07-13,13:00:00,124,76,48,FMN GV 05 Lier
60,Mechelsesteenweg 365,2018-07-13,14:00:00,212,128,84,FMN GV 05 Lier
60,Mechelsesteenweg 365,2018-07-13,15:00:00,210,96,114,FMN GV 05 Lier
60,Mechelsesteenweg 365,2018-07-13,16:00:00,190,86,104,FMN GV 05 Lier
60,Mechelsesteenweg 365,2018-07-13,17:00:00,164,70,94,FMN GV 05 Lier
60,Mechelsesteenweg 365,2018-07-13,18:00:00,104,54,50,FMN GV 05 Lier
60,Mechelsesteenweg 365,2018-07-13,19:00:00,74,38,36,FMN GV 05 Lier
60,Mechelsesteenweg 365,2018-07-13,20:00:00,92,44,48,FMN GV 05 Lier
60,Mechelsesteenweg 365,2018-07-13,21:00:00,62,26,36,FMN GV 05 Lier
60,Mechelsesteenweg 365,2018-07-13,22:00:00,22,14,8,FMN GV 05 Lier
60,Mechelsesteenweg 365,2018-07-13,23:00:00,16,6,10,FMN GV 05 Lier
60,Mechelsesteenweg 365,2018-07-14,00:00:00,8,2,6,FMN GV 05 Lier
60,Mechelsesteenweg 365,2018-07-14,01:00:00,0,0,0,FMN GV 05 Lier
60,Mechelsesteenweg 365,2018-07-14,02:00:00,0,0,0,FMN GV 05 Lier
60,Mechelsesteenweg 365,2018-07-14,03:00:00,0,0,0,FMN GV 05 Lier
60,Mechelsesteenweg 365,2018-07-14,04:00:00,0,0,0,FMN GV 05 Lier
60,Mechelsesteenweg 365,2018-07-14,05:00:00,8,6,2,FMN GV 05 Lier
60,Mechelsesteenweg 365,2018-07-14,06:00:00,14,6,8,FMN GV 05 Lier
60,Mechelsesteenweg 365,2018-07-14,07:00:00,28,16,12,FMN GV 05 Lier
60,Mechelsesteenweg 365,2018-07-14,08:00:00,42,30,12,FMN GV 05 Lier
60,Mechelsesteenweg 365,2018-07-14,09:00:00,132,56,76,FMN GV 05 Lier
60,Mechelsesteenweg 365,2018-07-14,10:00:00,242,94,148,FMN GV 05 Lier
60,Mechelsesteenweg 365,2018-07-14,11:00:00,232,108,124,FMN GV 05 Lier
60,Mechelsesteenweg 365,2018-07-14,12:00:00,188,92,96,FMN GV 05 Lier
60,Mechelsesteenweg 365,2018-07-14,13:00:00,250,116,134,FMN GV 05 Lier
60,Mechelsesteenweg 365,2018-07-14,14:00:00,252,120,132,FMN GV 05 Lier
60,Mechelsesteenweg 365,2018-07-14,15:00:00,240,132,108,FMN GV 05 Lier
60,Mechelsesteenweg 365,2018-07-14,16:00:00,110,44,66,FMN GV 05 Lier
60,Mechelsesteenweg 365,2018-07-14,17:00:00,90,44,46,FMN GV 05 Lier
60,Mechelsesteenweg 365,2018-07-14,18:00:00,92,26,66,FMN GV 05 Lier
60,Mechelsesteenweg 365,2018-07-14,19:00:00,70,36,34,FMN GV 05 Lier
60,Mechelsesteenweg 365,2018-07-14,20:00:00,76,28,48,FMN GV 05 Lier
60,Mechelsesteenweg 365,2018-07-14,21:00:00,52,12,40,FMN GV 05 Lier
60,Mechelsesteenweg 365,2018-07-14,22:00:00,28,10,18,FMN GV 05 Lier
60,Mechelsesteenweg 365,2018-07-14,23:00:00,4,2,2,FMN GV 05 Lier
60,Mechelsesteenweg 365,2018-07-15,00:00:00,14,2,12,FMN GV 05 Lier
60,Mechelsesteenweg 365,2018-07-15,01:00:00,0,0,0,FMN GV 05 Lier
60,Mechelsesteenweg 365,2018-07-15,02:00:00,4,0,4,FMN GV 05 Lier
60,Mechelsesteenweg 365,2018-07-15,03:00:00,0,0,0,FMN GV 05 Lier
60,Mechelsesteenweg 365,2018-07-15,04:00:00,0,0,0,FMN GV 05 Lier
60,Mechelsesteenweg 365,2018-07-15,05:00:00,0,0,0,FMN GV 05 Lier
60,Mechelsesteenweg 365,2018-07-15,06:00:00,8,8,0,FMN GV 05 Lier
60,Mechelsesteenweg 365,2018-07-15,07:00:00,36,26,10,FMN GV 05 Lier
60,Mechelsesteenweg 365,2018-07-15,08:00:00,98,44,54,FMN GV 05 Lier
60,Mechelsesteenweg 365,2018-07-15,09:00:00,238,134,104,FMN GV 05 Lier
60,Mechelsesteenweg 365,2018-07-15,10:00:00,498,252,246,FMN GV 05 Lier
60,Mechelsesteenweg 365,2018-07-15,11:00:00,518,210,308,FMN GV 05 Lier
60,Mechelsesteenweg 365,2018-07-15,12:00:00,288,112,176,FMN GV 05 Lier
60,Mechelsesteenweg 365,2018-07-15,13:00:00,342,164,178,FMN GV 05 Lier
60,Mechelsesteenweg 365,2018-07-15,14:00:00,260,118,142,FMN GV 05 Lier
60,Mechelsesteenweg 365,2018-07-15,15:00:00,250,106,144,FMN GV 05 Lier
60,Mechelsesteenweg 365,2018-07-15,16:00:00,206,72,134,FMN GV 05 Lier
60,Mechelsesteenweg 365,2018-07-15,17:00:00,182,78,104,FMN GV 05 Lier
60,Mechelsesteenweg 365,2018-07-15,18:00:00,114,62,52,FMN GV 05 Lier
60,Mechelsesteenweg 365,2018-07-15,19:00:00,96,38,58,FMN GV 05 Lier
60,Mechelsesteenweg 365,2018-07-15,20:00:00,104,36,68,FMN GV 05 Lier
60,Mechelsesteenweg 365,2018-07-15,21:00:00,84,28,56,FMN GV 05 Lier
60,Mechelsesteenweg 365,2018-07-15,22:00:00,18,8,10,FMN GV 05 Lier
60,Mechelsesteenweg 365,2018-07-15,23:00:00,10,6,4,FMN GV 05 Lier
60,Mechelsesteenweg 365,2018-07-16,00:00:00,4,4,0,FMN GV 05 Lier
60,Mechelsesteenweg 365,2018-07-16,01:00:00,2,2,0,FMN GV 05 Lier
60,Mechelsesteenweg 365,2018-07-16,02:00:00,0,0,0,FMN GV 05 Lier
60,Mechelsesteenweg 365,2018-07-16,03:00:00,4,2,2,FMN GV 05 Lier
60,Mechelsesteenweg 365,2018-07-16,04:00:00,0,0,0,FMN GV 05 Lier
60,Mechelsesteenweg 365,2018-07-16,05:00:00,10,2,8,FMN GV 05 Lier
60,Mechelsesteenweg 365,2018-07-16,06:00:00,28,2,26,FMN GV 05 Lier
60,Mechelsesteenweg 365,2018-07-16,07:00:00,92,34,58,FMN GV 05 Lier
60,Mechelsesteenweg 365,2018-07-16,08:00:00,102,32,70,FMN GV 05 Lier
60,Mechelsesteenweg 365,2018-07-16,09:00:00,98,42,56,FMN GV 05 Lier
60,Mechelsesteenweg 365,2018-07-16,10:00:00,172,104,68,FMN GV 05 Lier
60,Mechelsesteenweg 365,2018-07-16,11:00:00,176,100,76,FMN GV 05 Lier
60,Mechelsesteenweg 365,2018-07-16,12:00:00,132,64,68,FMN GV 05 Lier
60,Mechelsesteenweg 365,2018-07-16,13:00:00,126,50,76,FMN GV 05 Lier
60,Mechelsesteenweg 365,2018-07-16,14:00:00,160,96,64,FMN GV 05 Lier
60,Mechelsesteenweg 365,2018-07-16,15:00:00,166,64,102,FMN GV 05 Lier
60,Mechelsesteenweg 365,2018-07-16,16:00:00,146,64,82,FMN GV 05 Lier
60,Mechelsesteenweg 365,2018-07-16,17:00:00,186,96,90,FMN GV 05 Lier
60,Mechelsesteenweg 365,2018-07-16,18:00:00,132,72,60,FMN GV 05 Lier
60,Mechelsesteenweg 365,2018-07-16,19:00:00,26,10,16,FMN GV 05 Lier
60,Mechelsesteenweg 365,2018-07-16,20:00:00,28,10,18,FMN GV 05 Lier
60,Mechelsesteenweg 365,2018-07-16,21:00:00,8,2,6,FMN GV 05 Lier
60,Mechelsesteenweg 365,2018-07-16,22:00:00,8,4,4,FMN GV 05 Lier
60,Mechelsesteenweg 365,2018-07-16,23:00:00,0,0,0,FMN GV 05 Lier
60,Mechelsesteenweg 365,2018-07-17,00:00:00,0,0,0,FMN GV 05 Lier
60,Mechelsesteenweg 365,2018-07-17,01:00:00,0,0,0,FMN GV 05 Lier
60,Mechelsesteenweg 365,2018-07-17,02:00:00,0,0,0,FMN GV 05 Lier
60,Mechelsesteenweg 365,2018-07-17,03:00:00,14,2,12,FMN GV 05 Lier
60,Mechelsesteenweg 365,2018-07-17,04:00:00,2,0,2,FMN GV 05 Lier
60,Mechelsesteenweg 365,2018-07-17,05:00:00,10,2,8,FMN GV 05 Lier
60,Mechelsesteenweg 365,2018-07-17,06:00:00,28,10,18,FMN GV 05 Lier
60,Mechelsesteenweg 365,2018-07-17,07:00:00,62,26,36,FMN GV 05 Lier
60,Mechelsesteenweg 365,2018-07-17,08:00:00,82,36,46,FMN GV 05 Lier
60,Mechelsesteenweg 365,2018-07-17,09:00:00,96,32,64,FMN GV 05 Lier
60,Mechelsesteenweg 365,2018-07-17,10:00:00,194,90,104,FMN GV 05 Lier
60,Mechelsesteenweg 365,2018-07-17,11:00:00,154,96,58,FMN GV 05 Lier
60,Mechelsesteenweg 365,2018-07-17,12:00:00,94,54,40,FMN GV 05 Lier
60,Mechelsesteenweg 365,2018-07-17,13:00:00,132,58,74,FMN GV 05 Lier
60,Mechelsesteenweg 365,2018-07-17,14:00:00,182,106,76,FMN GV 05 Lier
60,Mechelsesteenweg 365,2018-07-17,15:00:00,166,68,98,FMN GV 05 Lier
60,Mechelsesteenweg 365,2018-07-17,16:00:00,136,54,82,FMN GV 05 Lier
60,Mechelsesteenweg 365,2018-07-17,17:00:00,138,76,62,FMN GV 05 Lier
60,Mechelsesteenweg 365,2018-07-17,18:00:00,112,66,46,FMN GV 05 Lier
60,Mechelsesteenweg 365,2018-07-17,19:00:00,114,66,48,FMN GV 05 Lier
60,Mechelsesteenweg 365,2018-07-17,20:00:00,126,56,70,FMN GV 05 Lier
60,Mechelsesteenweg 365,2018-07-17,21:00:00,100,42,58,FMN GV 05 Lier
60,Mechelsesteenweg 365,2018-07-17,22:00:00,8,4,4,FMN GV 05 Lier
60,Mechelsesteenweg 365,2018-07-17,23:00:00,4,0,4,FMN GV 05 Lier
60,Mechelsesteenweg 365,2018-07-18,00:00:00,0,0,0,FMN GV 05 Lier
60,Mechelsesteenweg 365,2018-07-18,01:00:00,6,0,6,FMN GV 05 Lier
60,Mechelsesteenweg 365,2018-07-18,02:00:00,0,0,0,FMN GV 05 Lier
60,Mechelsesteenweg 365,2018-07-18,03:00:00,2,0,2,FMN GV 05 Lier
60,Mechelsesteenweg 365,2018-07-18,04:00:00,0,0,0,FMN GV 05 Lier
60,Mechelsesteenweg 365,2018-07-18,05:00:00,4,2,2,FMN GV 05 Lier
60,Mechelsesteenweg 365,2018-07-18,06:00:00,40,8,32,FMN GV 05 Lier
60,Mechelsesteenweg 365,2018-07-18,07:00:00,82,28,54,FMN GV 05 Lier
60,Mechelsesteenweg 365,2018-07-18,08:00:00,104,52,52,FMN GV 05 Lier
60,Mechelsesteenweg 365,2018-07-18,09:00:00,118,52,66,FMN GV 05 Lier
60,Mechelsesteenweg 365,2018-07-18,10:00:00,172,62,110,FMN GV 05 Lier
60,Mechelsesteenweg 365,2018-07-18,11:00:00,222,96,126,FMN GV 05 Lier
60,Mechelsesteenweg 365,2018-07-18,12:00:00,210,112,98,FMN GV 05 Lier
60,Mechelsesteenweg 365,2018-07-18,13:00:00,196,100,96,FMN GV 05 Lier
60,Mechelsesteenweg 365,2018-07-18,14:00:00,272,138,134,FMN GV 05 Lier
60,Mechelsesteenweg 365,2018-07-18,15:00:00,192,92,100,FMN GV 05 Lier
60,Mechelsesteenweg 365,2018-07-18,16:00:00,224,80,144,FMN GV 05 Lier
60,Mechelsesteenweg 365,2018-07-18,17:00:00,184,70,114,FMN GV 05 Lier
60,Mechelsesteenweg 365,2018-07-18,18:00:00,180,88,92,FMN GV 05 Lier
60,Mechelsesteenweg 365,2018-07-18,19:00:00,204,144,60,FMN GV 05 Lier
60,Mechelsesteenweg 365,2018-07-18,20:00:00,196,124,72,FMN GV 05 Lier
60,Mechelsesteenweg 365,2018-07-18,21:00:00,50,14,36,FMN GV 05 Lier
60,Mechelsesteenweg 365,2018-07-18,22:00:00,8,6,2,FMN GV 05 Lier
60,Mechelsesteenweg 365,2018-07-18,23:00:00,2,0,2,FMN GV 05 Lier
60,Mechelsesteenweg 365,2018-07-19,00:00:00,0,0,0,FMN GV 05 Lier
60,Mechelsesteenweg 365,2018-07-19,01:00:00,0,0,0,FMN GV 05 Lier
60,Mechelsesteenweg 365,2018-07-19,02:00:00,0,0,0,FMN GV 05 Lier
60,Mechelsesteenweg 365,2018-07-19,03:00:00,0,0,0,FMN GV 05 Lier
60,Mechelsesteenweg 365,2018-07-19,04:00:00,0,0,0,FMN GV 05 Lier
60,Mechelsesteenweg 365,2018-07-19,05:00:00,4,0,4,FMN GV 05 Lier
60,Mechelsesteenweg 365,2018-07-19,06:00:00,34,10,24,FMN GV 05 Lier
60,Mechelsesteenweg 365,2018-07-19,07:00:00,88,30,58,FMN GV 05 Lier
60,Mechelsesteenweg 365,2018-07-19,08:00:00,90,50,40,FMN GV 05 Lier
60,Mechelsesteenweg 365,2018-07-19,09:00:00,152,78,74,FMN GV 05 Lier
60,Mechelsesteenweg 365,2018-07-19,10:00:00,286,148,138,FMN GV 05 Lier
60,Mechelsesteenweg 365,2018-07-19,11:00:00,140,60,80,FMN GV 05 Lier
60,Mechelsesteenweg 365,2018-07-19,12:00:00,176,80,96,FMN GV 05 Lier
60,Mechelsesteenweg 365,2018-07-19,13:00:00,282,136,146,FMN GV 05 Lier
60,Mechelsesteenweg 365,2018-07-19,14:00:00,198,80,118,FMN GV 05 Lier
60,Mechelsesteenweg 365,2018-07-19,15:00:00,256,106,150,FMN GV 05 Lier
60,Mechelsesteenweg 365,2018-07-19,16:00:00,186,84,102,FMN GV 05 Lier
60,Mechelsesteenweg 365,2018-07-19,17:00:00,252,118,134,FMN GV 05 Lier
60,Mechelsesteenweg 365,2018-07-19,18:00:00,98,56,42,FMN GV 05 Lier
60,Mechelsesteenweg 365,2018-07-19,19:00:00,160,70,90,FMN GV 05 Lier
60,Mechelsesteenweg 365,2018-07-19,20:00:00,152,88,64,FMN GV 05 Lier
60,Mechelsesteenweg 365,2018-07-19,21:00:00,70,24,46,FMN GV 05 Lier
60,Mechelsesteenweg 365,2018-07-19,22:00:00,30,8,22,FMN GV 05 Lier
60,Mechelsesteenweg 365,2018-07-19,23:00:00,2,0,2,FMN GV 05 Lier
60,Mechelsesteenweg 365,2018-07-20,00:00:00,12,2,10,FMN GV 05 Lier
60,Mechelsesteenweg 365,2018-07-20,01:00:00,2,2,0,FMN GV 05 Lier
60,Mechelsesteenweg 365,2018-07-20,02:00:00,0,0,0,FMN GV 05 Lier
60,Mechelsesteenweg 365,2018-07-20,03:00:00,2,0,2,FMN GV 05 Lier
60,Mechelsesteenweg 365,2018-07-20,04:00:00,2,2,0,FMN GV 05 Lier
60,Mechelsesteenweg 365,2018-07-20,05:00:00,8,2,6,FMN GV 05 Lier
60,Mechelsesteenweg 365,2018-07-20,06:00:00,20,4,16,FMN GV 05 Lier
60,Mechelsesteenweg 365,2018-07-20,07:00:00,80,40,40,FMN GV 05 Lier
60,Mechelsesteenweg 365,2018-07-20,08:00:00,66,20,46,FMN GV 05 Lier
60,Mechelsesteenweg 365,2018-07-20,09:00:00,122,80,42,FMN GV 05 Lier
60,Mechelsesteenweg 365,2018-07-20,10:00:00,258,134,124,FMN GV 05 Lier
60,Mechelsesteenweg 365,2018-07-20,11:00:00,190,90,100,FMN GV 05 Lier
60,Mechelsesteenweg 365,2018-07-20,12:00:00,142,88,54,FMN GV 05 Lier
60,Mechelsesteenweg 365,2018-07-20,13:00:00,166,86,80,FMN GV 05 Lier
60,Mechelsesteenweg 365,2018-07-20,14:00:00,200,122,78,FMN GV 05 Lier
60,Mechelsesteenweg 365,2018-07-20,15:00:00,206,110,96,FMN GV 05 Lier
60,Mechelsesteenweg 365,2018-07-20,16:00:00,198,84,114,FMN GV 05 Lier
60,Mechelsesteenweg 365,2018-07-20,17:00:00,96,42,54,FMN GV 05 Lier
60,Mechelsesteenweg 365,2018-07-20,18:00:00,92,52,40,FMN GV 05 Lier
60,Mechelsesteenweg 365,2018-07-20,19:00:00,40,10,30,FMN GV 05 Lier
60,Mechelsesteenweg 365,2018-07-20,20:00:00,40,24,16,FMN GV 05 Lier
60,Mechelsesteenweg 365,2018-07-20,21:00:00,18,8,10,FMN GV 05 Lier
60,Mechelsesteenweg 365,2018-07-20,22:00:00,8,2,6,FMN GV 05 Lier
60,Mechelsesteenweg 365,2018-07-20,23:00:00,0,0,0,FMN GV 05 Lier
60,Mechelsesteenweg 365,2018-07-21,00:00:00,0,0,0,FMN GV 05 Lier
60,Mechelsesteenweg 365,2018-07-21,01:00:00,2,2,0,FMN GV 05 Lier
60,Mechelsesteenweg 365,2018-07-21,02:00:00,8,8,0,FMN GV 05 Lier
60,Mechelsesteenweg 365,2018-07-21,03:00:00,0,0,0,FMN GV 05 Lier
60,Mechelsesteenweg 365,2018-07-21,04:00:00,2,0,2,FMN GV 05 Lier
60,Mechelsesteenweg 365,2018-07-21,05:00:00,0,0,0,FMN GV 05 Lier
60,Mechelsesteenweg 365,2018-07-21,06:00:00,4,2,2,FMN GV 05 Lier
60,Mechelsesteenweg 365,2018-07-21,07:00:00,20,14,6,FMN GV 05 Lier
60,Mechelsesteenweg 365,2018-07-21,08:00:00,94,48,46,FMN GV 05 Lier
60,Mechelsesteenweg 365,2018-07-21,09:00:00,310,186,124,FMN GV 05 Lier
60,Mechelsesteenweg 365,2018-07-21,10:00:00,286,120,166,FMN GV 05 Lier
60,Mechelsesteenweg 365,2018-07-21,11:00:00,340,168,172,FMN GV 05 Lier
60,Mechelsesteenweg 365,2018-07-21,12:00:00,248,80,168,FMN GV 05 Lier
60,Mechelsesteenweg 365,2018-07-21,13:00:00,222,94,128,FMN GV 05 Lier
60,Mechelsesteenweg 365,2018-07-21,14:00:00,296,164,132,FMN GV 05 Lier
60,Mechelsesteenweg 365,2018-07-21,15:00:00,288,138,150,FMN GV 05 Lier
60,Mechelsesteenweg 365,2018-07-21,16:00:00,230,82,148,FMN GV 05 Lier
60,Mechelsesteenweg 365,2018-07-21,17:00:00,154,68,86,FMN GV 05 Lier
60,Mechelsesteenweg 365,2018-07-21,18:00:00,148,86,62,FMN GV 05 Lier
60,Mechelsesteenweg 365,2018-07-21,19:00:00,102,50,52,FMN GV 05 Lier
60,Mechelsesteenweg 365,2018-07-21,20:00:00,98,32,66,FMN GV 05 Lier
60,Mechelsesteenweg 365,2018-07-21,21:00:00,68,20,48,FMN GV 05 Lier
60,Mechelsesteenweg 365,2018-07-21,22:00:00,18,0,18,FMN GV 05 Lier
60,Mechelsesteenweg 365,2018-07-21,23:00:00,2,2,0,FMN GV 05 Lier
60,Mechelsesteenweg 365,2018-07-22,00:00:00,2,0,2,FMN GV 05 Lier
60,Mechelsesteenweg 365,2018-07-22,01:00:00,4,4,0,FMN GV 05 Lier
60,Mechelsesteenweg 365,2018-07-22,02:00:00,0,0,0,FMN GV 05 Lier
60,Mechelsesteenweg 365,2018-07-22,03:00:00,0,0,0,FMN GV 05 Lier
60,Mechelsesteenweg 365,2018-07-22,04:00:00,0,0,0,FMN GV 05 Lier
60,Mechelsesteenweg 365,2018-07-22,05:00:00,0,0,0,FMN GV 05 Lier
60,Mechelsesteenweg 365,2018-07-22,06:00:00,2,2,0,FMN GV 05 Lier
60,Mechelsesteenweg 365,2018-07-22,07:00:00,32,24,8,FMN GV 05 Lier
60,Mechelsesteenweg 365,2018-07-22,08:00:00,106,56,50,FMN GV 05 Lier
60,Mechelsesteenweg 365,2018-07-22,09:00:00,272,174,98,FMN GV 05 Lier
60,Mechelsesteenweg 365,2018-07-22,10:00:00,566,160,406,FMN GV 05 Lier
60,Mechelsesteenweg 365,2018-07-22,11:00:00,492,212,280,FMN GV 05 Lier
60,Mechelsesteenweg 365,2018-07-22,12:00:00,302,164,138,FMN GV 05 Lier
60,Mechelsesteenweg 365,2018-07-22,13:00:00,318,184,134,FMN GV 05 Lier
60,Mechelsesteenweg 365,2018-07-22,14:00:00,388,192,196,FMN GV 05 Lier
60,Mechelsesteenweg 365,2018-07-22,15:00:00,490,244,246,FMN GV 05 Lier
60,Mechelsesteenweg 365,2018-07-22,16:00:00,364,156,208,FMN GV 05 Lier
60,Mechelsesteenweg 365,2018-07-22,17:00:00,264,108,156,FMN GV 05 Lier
60,Mechelsesteenweg 365,2018-07-22,18:00:00,142,78,64,FMN GV 05 Lier
60,Mechelsesteenweg 365,2018-07-22,19:00:00,110,40,70,FMN GV 05 Lier
60,Mechelsesteenweg 365,2018-07-22,20:00:00,92,30,62,FMN GV 05 Lier
60,Mechelsesteenweg 365,2018-07-22,21:00:00,30,22,8,FMN GV 05 Lier
60,Mechelsesteenweg 365,2018-07-22,22:00:00,10,6,4,FMN GV 05 Lier
60,Mechelsesteenweg 365,2018-07-22,23:00:00,0,0,0,FMN GV 05 Lier
60,Mechelsesteenweg 365,2018-07-23,00:00:00,0,0,0,FMN GV 05 Lier
60,Mechelsesteenweg 365,2018-07-23,01:00:00,0,0,0,FMN GV 05 Lier
60,Mechelsesteenweg 365,2018-07-23,02:00:00,8,8,0,FMN GV 05 Lier
60,Mechelsesteenweg 365,2018-07-23,03:00:00,0,0,0,FMN GV 05 Lier
60,Mechelsesteenweg 365,2018-07-23,04:00:00,0,0,0,FMN GV 05 Lier
60,Mechelsesteenweg 365,2018-07-23,05:00:00,4,2,2,FMN GV 05 Lier
60,Mechelsesteenweg 365,2018-07-23,06:00:00,22,10,12,FMN GV 05 Lier
60,Mechelsesteenweg 365,2018-07-23,07:00:00,72,28,44,FMN GV 05 Lier
60,Mechelsesteenweg 365,2018-07-23,08:00:00,86,42,44,FMN GV 05 Lier
60,Mechelsesteenweg 365,2018-07-23,09:00:00,120,62,58,FMN GV 05 Lier
60,Mechelsesteenweg 365,2018-07-23,10:00:00,130,44,86,FMN GV 05 Lier
60,Mechelsesteenweg 365,2018-07-23,11:00:00,144,70,74,FMN GV 05 Lier
60,Mechelsesteenweg 365,2018-07-23,12:00:00,108,50,58,FMN GV 05 Lier
60,Mechelsesteenweg 365,2018-07-23,13:00:00,118,60,58,FMN GV 05 Lier
60,Mechelsesteenweg 365,2018-07-23,14:00:00,192,102,90,FMN GV 05 Lier
60,Mechelsesteenweg 365,2018-07-23,15:00:00,126,52,74,FMN GV 05 Lier
60,Mechelsesteenweg 365,2018-07-23,16:00:00,136,66,70,FMN GV 05 Lier
60,Mechelsesteenweg 365,2018-07-23,17:00:00,160,86,74,FMN GV 05 Lier
60,Mechelsesteenweg 365,2018-07-23,18:00:00,136,50,86,FMN GV 05 Lier
60,Mechelsesteenweg 365,2018-07-23,19:00:00,108,44,64,FMN GV 05 Lier
60,Mechelsesteenweg 365,2018-07-23,20:00:00,120,54,66,FMN GV 05 Lier
60,Mechelsesteenweg 365,2018-07-23,21:00:00,98,24,74,FMN GV 05 Lier
60,Mechelsesteenweg 365,2018-07-23,22:00:00,40,16,24,FMN GV 05 Lier
60,Mechelsesteenweg 365,2018-07-23,23:00:00,0,0,0,FMN GV 05 Lier
60,Mechelsesteenweg 365,2018-07-24,00:00:00,0,0,0,FMN GV 05 Lier
60,Mechelsesteenweg 365,2018-07-24,01:00:00,0,0,0,FMN GV 05 Lier
60,Mechelsesteenweg 365,2018-07-24,02:00:00,0,0,0,FMN GV 05 Lier
60,Mechelsesteenweg 365,2018-07-24,03:00:00,2,2,0,FMN GV 05 Lier
60,Mechelsesteenweg 365,2018-07-24,04:00:00,0,0,0,FMN GV 05 Lier
60,Mechelsesteenweg 365,2018-07-24,05:00:00,6,2,4,FMN GV 05 Lier
60,Mechelsesteenweg 365,2018-07-24,06:00:00,48,22,26,FMN GV 05 Lier
60,Mechelsesteenweg 365,2018-07-24,07:00:00,94,44,50,FMN GV 05 Lier
60,Mechelsesteenweg 365,2018-07-24,08:00:00,126,58,68,FMN GV 05 Lier
60,Mechelsesteenweg 365,2018-07-24,09:00:00,152,74,78,FMN GV 05 Lier
60,Mechelsesteenweg 365,2018-07-24,10:00:00,212,98,114,FMN GV 05 Lier
60,Mechelsesteenweg 365,2018-07-24,11:00:00,198,116,82,FMN GV 05 Lier
60,Mechelsesteenweg 365,2018-07-24,12:00:00,126,72,54,FMN GV 05 Lier
60,Mechelsesteenweg 365,2018-07-24,13:00:00,112,40,72,FMN GV 05 Lier
60,Mechelsesteenweg 365,2018-07-24,14:00:00,88,42,46,FMN GV 05 Lier
60,Mechelsesteenweg 365,2018-07-24,15:00:00,140,48,92,FMN GV 05 Lier
60,Mechelsesteenweg 365,2018-07-24,16:00:00,150,76,74,FMN GV 05 Lier
60,Mechelsesteenweg 365,2018-07-24,17:00:00,162,78,84,FMN GV 05 Lier
60,Mechelsesteenweg 365,2018-07-24,18:00:00,142,102,40,FMN GV 05 Lier
60,Mechelsesteenweg 365,2018-07-24,19:00:00,138,74,64,FMN GV 05 Lier
60,Mechelsesteenweg 365,2018-07-24,20:00:00,170,62,108,FMN GV 05 Lier
60,Mechelsesteenweg 365,2018-07-24,21:00:00,78,28,50,FMN GV 05 Lier
60,Mechelsesteenweg 365,2018-07-24,22:00:00,18,4,14,FMN GV 05 Lier
60,Mechelsesteenweg 365,2018-07-24,23:00:00,4,2,2,FMN GV 05 Lier
60,Mechelsesteenweg 365,2018-07-25,00:00:00,0,0,0,FMN GV 05 Lier
60,Mechelsesteenweg 365,2018-07-25,01:00:00,0,0,0,FMN GV 05 Lier
60,Mechelsesteenweg 365,2018-07-25,02:00:00,0,0,0,FMN GV 05 Lier
60,Mechelsesteenweg 365,2018-07-25,03:00:00,0,0,0,FMN GV 05 Lier
60,Mechelsesteenweg 365,2018-07-25,04:00:00,4,2,2,FMN GV 05 Lier
60,Mechelsesteenweg 365,2018-07-25,05:00:00,4,2,2,FMN GV 05 Lier
60,Mechelsesteenweg 365,2018-07-25,06:00:00,24,10,14,FMN GV 05 Lier
60,Mechelsesteenweg 365,2018-07-25,07:00:00,68,32,36,FMN GV 05 Lier
60,Mechelsesteenweg 365,2018-07-25,08:00:00,100,36,64,FMN GV 05 Lier
60,Mechelsesteenweg 365,2018-07-25,09:00:00,126,52,74,FMN GV 05 Lier
60,Mechelsesteenweg 365,2018-07-25,10:00:00,164,56,108,FMN GV 05 Lier
60,Mechelsesteenweg 365,2018-07-25,11:00:00,128,62,66,FMN GV 05 Lier
60,Mechelsesteenweg 365,2018-07-25,12:00:00,106,46,60,FMN GV 05 Lier
60,Mechelsesteenweg 365,2018-07-25,13:00:00,92,56,36,FMN GV 05 Lier
60,Mechelsesteenweg 365,2018-07-25,14:00:00,88,46,42,FMN GV 05 Lier
60,Mechelsesteenweg 365,2018-07-25,15:00:00,76,38,38,FMN GV 05 Lier
60,Mechelsesteenweg 365,2018-07-25,16:00:00,84,36,48,FMN GV 05 Lier
60,Mechelsesteenweg 365,2018-07-25,17:00:00,106,48,58,FMN GV 05 Lier
60,Mechelsesteenweg 365,2018-07-25,18:00:00,80,42,38,FMN GV 05 Lier
60,Mechelsesteenweg 365,2018-07-25,19:00:00,138,76,62,FMN GV 05 Lier
60,Mechelsesteenweg 365,2018-07-25,20:00:00,190,122,68,FMN GV 05 Lier
60,Mechelsesteenweg 365,2018-07-25,21:00:00,106,30,76,FMN GV 05 Lier
60,Mechelsesteenweg 365,2018-07-25,22:00:00,40,8,32,FMN GV 05 Lier
60,Mechelsesteenweg 365,2018-07-25,23:00:00,4,2,2,FMN GV 05 Lier
60,Mechelsesteenweg 365,2018-07-26,00:00:00,4,2,2,FMN GV 05 Lier
60,Mechelsesteenweg 365,2018-07-26,01:00:00,0,0,0,FMN GV 05 Lier
60,Mechelsesteenweg 365,2018-07-26,02:00:00,0,0,0,FMN GV 05 Lier
60,Mechelsesteenweg 365,2018-07-26,03:00:00,2,0,2,FMN GV 05 Lier
60,Mechelsesteenweg 365,2018-07-26,04:00:00,4,2,2,FMN GV 05 Lier
60,Mechelsesteenweg 365,2018-07-26,05:00:00,6,4,2,FMN GV 05 Lier
60,Mechelsesteenweg 365,2018-07-26,06:00:00,26,10,16,FMN GV 05 Lier
60,Mechelsesteenweg 365,2018-07-26,07:00:00,104,40,64,FMN GV 05 Lier
60,Mechelsesteenweg 365,2018-07-26,08:00:00,110,40,70,FMN GV 05 Lier
60,Mechelsesteenweg 365,2018-07-26,09:00:00,122,76,46,FMN GV 05 Lier
60,Mechelsesteenweg 365,2018-07-26,10:00:00,174,50,124,FMN GV 05 Lier
60,Mechelsesteenweg 365,2018-07-26,11:00:00,98,48,50,FMN GV 05 Lier
60,Mechelsesteenweg 365,2018-07-26,12:00:00,76,30,46,FMN GV 05 Lier
60,Mechelsesteenweg 365,2018-07-26,13:00:00,110,38,72,FMN GV 05 Lier
60,Mechelsesteenweg 365,2018-07-26,14:00:00,106,38,68,FMN GV 05 Lier
60,Mechelsesteenweg 365,2018-07-26,15:00:00,76,40,36,FMN GV 05 Lier
60,Mechelsesteenweg 365,2018-07-26,16:00:00,66,34,32,FMN GV 05 Lier
60,Mechelsesteenweg 365,2018-07-26,17:00:00,92,48,44,FMN GV 05 Lier
60,Mechelsesteenweg 365,2018-07-26,18:00:00,80,40,40,FMN GV 05 Lier
60,Mechelsesteenweg 365,2018-07-26,19:00:00,62,18,44,FMN GV 05 Lier
60,Mechelsesteenweg 365,2018-07-26,20:00:00,96,66,30,FMN GV 05 Lier
60,Mechelsesteenweg 365,2018-07-26,21:00:00,62,16,46,FMN GV 05 Lier
60,Mechelsesteenweg 365,2018-07-26,22:00:00,46,16,30,FMN GV 05 Lier
60,Mechelsesteenweg 365,2018-07-26,23:00:00,2,2,0,FMN GV 05 Lier
60,Mechelsesteenweg 365,2018-07-27,00:00:00,0,0,0,FMN GV 05 Lier
60,Mechelsesteenweg 365,2018-07-27,01:00:00,2,0,2,FMN GV 05 Lier
60,Mechelsesteenweg 365,2018-07-27,02:00:00,0,0,0,FMN GV 05 Lier
60,Mechelsesteenweg 365,2018-07-27,03:00:00,0,0,0,FMN GV 05 Lier
60,Mechelsesteenweg 365,2018-07-27,04:00:00,2,2,0,FMN GV 05 Lier
60,Mechelsesteenweg 365,2018-07-27,05:00:00,6,2,4,FMN GV 05 Lier
60,Mechelsesteenweg 365,2018-07-27,06:00:00,36,18,18,FMN GV 05 Lier
60,Mechelsesteenweg 365,2018-07-27,07:00:00,68,38,30,FMN GV 05 Lier
60,Mechelsesteenweg 365,2018-07-27,08:00:00,92,40,52,FMN GV 05 Lier
60,Mechelsesteenweg 365,2018-07-27,09:00:00,88,52,36,FMN GV 05 Lier
60,Mechelsesteenweg 365,2018-07-27,10:00:00,96,52,44,FMN GV 05 Lier
60,Mechelsesteenweg 365,2018-07-27,11:00:00,66,28,38,FMN GV 05 Lier
60,Mechelsesteenweg 365,2018-07-27,12:00:00,54,24,30,FMN GV 05 Lier
60,Mechelsesteenweg 365,2018-07-27,13:00:00,50,20,30,FMN GV 05 Lier
60,Mechelsesteenweg 365,2018-07-27,14:00:00,56,34,22,FMN GV 05 Lier
60,Mechelsesteenweg 365,2018-07-27,15:00:00,52,10,42,FMN GV 05 Lier
60,Mechelsesteenweg 365,2018-07-27,16:00:00,66,40,26,FMN GV 05 Lier
60,Mechelsesteenweg 365,2018-07-27,17:00:00,70,32,38,FMN GV 05 Lier
60,Mechelsesteenweg 365,2018-07-27,18:00:00,46,28,18,FMN GV 05 Lier
60,Mechelsesteenweg 365,2018-07-27,19:00:00,74,36,38,FMN GV 05 Lier
60,Mechelsesteenweg 365,2018-07-27,20:00:00,78,38,40,FMN GV 05 Lier
60,Mechelsesteenweg 365,2018-07-27,21:00:00,60,28,32,FMN GV 05 Lier
60,Mechelsesteenweg 365,2018-07-27,22:00:00,16,10,6,FMN GV 05 Lier
60,Mechelsesteenweg 365,2018-07-27,23:00:00,10,2,8,FMN GV 05 Lier
60,Mechelsesteenweg 365,2018-07-28,00:00:00,2,0,2,FMN GV 05 Lier
60,Mechelsesteenweg 365,2018-07-28,01:00:00,0,0,0,FMN GV 05 Lier
60,Mechelsesteenweg 365,2018-07-28,02:00:00,0,0,0,FMN GV 05 Lier
60,Mechelsesteenweg 365,2018-07-28,03:00:00,0,0,0,FMN GV 05 Lier
60,Mechelsesteenweg 365,2018-07-28,04:00:00,0,0,0,FMN GV 05 Lier
60,Mechelsesteenweg 365,2018-07-28,05:00:00,10,0,10,FMN GV 05 Lier
60,Mechelsesteenweg 365,2018-07-28,06:00:00,16,8,8,FMN GV 05 Lier
60,Mechelsesteenweg 365,2018-07-28,07:00:00,16,4,12,FMN GV 05 Lier
60,Mechelsesteenweg 365,2018-07-28,08:00:00,28,20,8,FMN GV 05 Lier
60,Mechelsesteenweg 365,2018-07-28,09:00:00,56,26,30,FMN GV 05 Lier
60,Mechelsesteenweg 365,2018-07-28,10:00:00,128,72,56,FMN GV 05 Lier
60,Mechelsesteenweg 365,2018-07-28,11:00:00,146,68,78,FMN GV 05 Lier
60,Mechelsesteenweg 365,2018-07-28,12:00:00,90,34,56,FMN GV 05 Lier
60,Mechelsesteenweg 365,2018-07-28,13:00:00,136,72,64,FMN GV 05 Lier
60,Mechelsesteenweg 365,2018-07-28,14:00:00,138,86,52,FMN GV 05 Lier
60,Mechelsesteenweg 365,2018-07-28,15:00:00,144,76,68,FMN GV 05 Lier
60,Mechelsesteenweg 365,2018-07-28,16:00:00,140,78,62,FMN GV 05 Lier
60,Mechelsesteenweg 365,2018-07-28,17:00:00,96,52,44,FMN GV 05 Lier
60,Mechelsesteenweg 365,2018-07-28,18:00:00,52,22,30,FMN GV 05 Lier
60,Mechelsesteenweg 365,2018-07-28,19:00:00,94,28,66,FMN GV 05 Lier
60,Mechelsesteenweg 365,2018-07-28,20:00:00,58,26,32,FMN GV 05 Lier
60,Mechelsesteenweg 365,2018-07-28,21:00:00,62,18,44,FMN GV 05 Lier
60,Mechelsesteenweg 365,2018-07-28,22:00:00,16,12,4,FMN GV 05 Lier
60,Mechelsesteenweg 365,2018-07-28,23:00:00,4,2,2,FMN GV 05 Lier
60,Mechelsesteenweg 365,2018-07-29,00:00:00,0,0,0,FMN GV 05 Lier
60,Mechelsesteenweg 365,2018-07-29,01:00:00,0,0,0,FMN GV 05 Lier
60,Mechelsesteenweg 365,2018-07-29,02:00:00,0,0,0,FMN GV 05 Lier
60,Mechelsesteenweg 365,2018-07-29,03:00:00,0,0,0,FMN GV 05 Lier
60,Mechelsesteenweg 365,2018-07-29,04:00:00,0,0,0,FMN GV 05 Lier
60,Mechelsesteenweg 365,2018-07-29,05:00:00,0,0,0,FMN GV 05 Lier
60,Mechelsesteenweg 365,2018-07-29,06:00:00,4,2,2,FMN GV 05 Lier
60,Mechelsesteenweg 365,2018-07-29,07:00:00,28,18,10,FMN GV 05 Lier
60,Mechelsesteenweg 365,2018-07-29,08:00:00,60,30,30,FMN GV 05 Lier
60,Mechelsesteenweg 365,2018-07-29,09:00:00,230,122,108,FMN GV 05 Lier
60,Mechelsesteenweg 365,2018-07-29,10:00:00,366,158,208,FMN GV 05 Lier
60,Mechelsesteenweg 365,2018-07-29,11:00:00,388,200,188,FMN GV 05 Lier
60,Mechelsesteenweg 365,2018-07-29,12:00:00,308,164,144,FMN GV 05 Lier
60,Mechelsesteenweg 365,2018-07-29,13:00:00,336,180,156,FMN GV 05 Lier
60,Mechelsesteenweg 365,2018-07-29,14:00:00,320,160,160,FMN GV 05 Lier
60,Mechelsesteenweg 365,2018-07-29,15:00:00,310,148,162,FMN GV 05 Lier
60,Mechelsesteenweg 365,2018-07-29,16:00:00,226,96,130,FMN GV 05 Lier
60,Mechelsesteenweg 365,2018-07-29,17:00:00,202,48,154,FMN GV 05 Lier
60,Mechelsesteenweg 365,2018-07-29,18:00:00,72,28,44,FMN GV 05 Lier
60,Mechelsesteenweg 365,2018-07-29,19:00:00,44,20,24,FMN GV 05 Lier
60,Mechelsesteenweg 365,2018-07-29,20:00:00,46,16,30,FMN GV 05 Lier
60,Mechelsesteenweg 365,2018-07-29,21:00:00,50,14,36,FMN GV 05 Lier
60,Mechelsesteenweg 365,2018-07-29,22:00:00,14,10,4,FMN GV 05 Lier
60,Mechelsesteenweg 365,2018-07-29,23:00:00,2,2,0,FMN GV 05 Lier
60,Mechelsesteenweg 365,2018-07-30,00:00:00,0,0,0,FMN GV 05 Lier
60,Mechelsesteenweg 365,2018-07-30,01:00:00,4,4,0,FMN GV 05 Lier
60,Mechelsesteenweg 365,2018-07-30,02:00:00,0,0,0,FMN GV 05 Lier
60,Mechelsesteenweg 365,2018-07-30,03:00:00,0,0,0,FMN GV 05 Lier
60,Mechelsesteenweg 365,2018-07-30,04:00:00,2,2,0,FMN GV 05 Lier
60,Mechelsesteenweg 365,2018-07-30,05:00:00,10,4,6,FMN GV 05 Lier
60,Mechelsesteenweg 365,2018-07-30,06:00:00,34,8,26,FMN GV 05 Lier
60,Mechelsesteenweg 365,2018-07-30,07:00:00,72,22,50,FMN GV 05 Lier
60,Mechelsesteenweg 365,2018-07-30,08:00:00,100,34,66,FMN GV 05 Lier
60,Mechelsesteenweg 365,2018-07-30,09:00:00,52,36,16,FMN GV 05 Lier
60,Mechelsesteenweg 365,2018-07-30,10:00:00,228,160,68,FMN GV 05 Lier
60,Mechelsesteenweg 365,2018-07-30,11:00:00,142,70,72,FMN GV 05 Lier
60,Mechelsesteenweg 365,2018-07-30,12:00:00,134,70,64,FMN GV 05 Lier
60,Mechelsesteenweg 365,2018-07-30,13:00:00,142,72,70,FMN GV 05 Lier
60,Mechelsesteenweg 365,2018-07-30,14:00:00,156,64,92,FMN GV 05 Lier
60,Mechelsesteenweg 365,2018-07-30,15:00:00,200,110,90,FMN GV 05 Lier
60,Mechelsesteenweg 365,2018-07-30,16:00:00,162,102,60,FMN GV 05 Lier
60,Mechelsesteenweg 365,2018-07-30,17:00:00,170,84,86,FMN GV 05 Lier
60,Mechelsesteenweg 365,2018-07-30,18:00:00,114,72,42,FMN GV 05 Lier
60,Mechelsesteenweg 365,2018-07-30,19:00:00,96,42,54,FMN GV 05 Lier
60,Mechelsesteenweg 365,2018-07-30,20:00:00,116,52,64,FMN GV 05 Lier
60,Mechelsesteenweg 365,2018-07-30,21:00:00,44,12,32,FMN GV 05 Lier
60,Mechelsesteenweg 365,2018-07-30,22:00:00,20,8,12,FMN GV 05 Lier
60,Mechelsesteenweg 365,2018-07-30,23:00:00,12,2,10,FMN GV 05 Lier
60,Mechelsesteenweg 365,2018-07-31,00:00:00,2,2,0,FMN GV 05 Lier
60,Mechelsesteenweg 365,2018-07-31,01:00:00,2,2,0,FMN GV 05 Lier
60,Mechelsesteenweg 365,2018-07-31,02:00:00,0,0,0,FMN GV 05 Lier
60,Mechelsesteenweg 365,2018-07-31,03:00:00,4,0,4,FMN GV 05 Lier
60,Mechelsesteenweg 365,2018-07-31,04:00:00,2,0,2,FMN GV 05 Lier
60,Mechelsesteenweg 365,2018-07-31,05:00:00,8,2,6,FMN GV 05 Lier
60,Mechelsesteenweg 365,2018-07-31,06:00:00,34,12,22,FMN GV 05 Lier
60,Mechelsesteenweg 365,2018-07-31,07:00:00,94,34,60,FMN GV 05 Lier
60,Mechelsesteenweg 365,2018-07-31,08:00:00,98,46,52,FMN GV 05 Lier
60,Mechelsesteenweg 365,2018-07-31,09:00:00,128,70,58,FMN GV 05 Lier
60,Mechelsesteenweg 365,2018-07-31,10:00:00,166,108,58,FMN GV 05 Lier
60,Mechelsesteenweg 365,2018-07-31,11:00:00,140,70,70,FMN GV 05 Lier
60,Mechelsesteenweg 365,2018-07-31,12:00:00,162,110,52,FMN GV 05 Lier
60,Mechelsesteenweg 365,2018-07-31,13:00:00,138,48,90,FMN GV 05 Lier
60,Mechelsesteenweg 365,2018-07-31,14:00:00,244,130,114,FMN GV 05 Lier
60,Mechelsesteenweg 365,2018-07-31,15:00:00,194,94,100,FMN GV 05 Lier
60,Mechelsesteenweg 365,2018-07-31,16:00:00,186,94,92,FMN GV 05 Lier
60,Mechelsesteenweg 365,2018-07-31,17:00:00,194,92,102,FMN GV 05 Lier
60,Mechelsesteenweg 365,2018-07-31,18:00:00,116,64,52,FMN GV 05 Lier
60,Mechelsesteenweg 365,2018-07-31,19:00:00,162,74,88,FMN GV 05 Lier
60,Mechelsesteenweg 365,2018-07-31,20:00:00,172,78,94,FMN GV 05 Lier
60,Mechelsesteenweg 365,2018-07-31,21:00:00,48,16,32,FMN GV 05 Lier
60,Mechelsesteenweg 365,2018-07-31,22:00:00,24,8,16,FMN GV 05 Lier
60,Mechelsesteenweg 365,2018-07-31,23:00:00,4,4,0,FMN GV 05 Lier
60,Mechelsesteenweg 365,2018-08-01,00:00:00,0,0,0,FMN GV 05 Lier
60,Mechelsesteenweg 365,2018-08-01,01:00:00,0,0,0,FMN GV 05 Lier
60,Mechelsesteenweg 365,2018-08-01,02:00:00,2,2,0,FMN GV 05 Lier
60,Mechelsesteenweg 365,2018-08-01,03:00:00,2,0,2,FMN GV 05 Lier
60,Mechelsesteenweg 365,2018-08-01,04:00:00,4,2,2,FMN GV 05 Lier
60,Mechelsesteenweg 365,2018-08-01,05:00:00,12,2,10,FMN GV 05 Lier
60,Mechelsesteenweg 365,2018-08-01,06:00:00,54,16,38,FMN GV 05 Lier
60,Mechelsesteenweg 365,2018-08-01,07:00:00,94,42,52,FMN GV 05 Lier
60,Mechelsesteenweg 365,2018-08-01,08:00:00,122,62,60,FMN GV 05 Lier
60,Mechelsesteenweg 365,2018-08-01,09:00:00,114,76,38,FMN GV 05 Lier
60,Mechelsesteenweg 365,2018-08-01,10:00:00,206,102,104,FMN GV 05 Lier
60,Mechelsesteenweg 365,2018-08-01,11:00:00,120,60,60,FMN GV 05 Lier
60,Mechelsesteenweg 365,2018-08-01,12:00:00,178,84,94,FMN GV 05 Lier
60,Mechelsesteenweg 365,2018-08-01,13:00:00,160,68,92,FMN GV 05 Lier
60,Mechelsesteenweg 365,2018-08-01,14:00:00,172,72,100,FMN GV 05 Lier
60,Mechelsesteenweg 365,2018-08-01,15:00:00,150,68,82,FMN GV 05 Lier
60,Mechelsesteenweg 365,2018-08-01,16:00:00,198,74,124,FMN GV 05 Lier
60,Mechelsesteenweg 365,2018-08-01,17:00:00,162,78,84,FMN GV 05 Lier
60,Mechelsesteenweg 365,2018-08-01,18:00:00,110,38,72,FMN GV 05 Lier
60,Mechelsesteenweg 365,2018-08-01,19:00:00,246,180,66,FMN GV 05 Lier
60,Mechelsesteenweg 365,2018-08-01,20:00:00,256,168,88,FMN GV 05 Lier
60,Mechelsesteenweg 365,2018-08-01,21:00:00,50,8,42,FMN GV 05 Lier
60,Mechelsesteenweg 365,2018-08-01,22:00:00,40,16,24,FMN GV 05 Lier
60,Mechelsesteenweg 365,2018-08-01,23:00:00,2,2,0,FMN GV 05 Lier
60,Mechelsesteenweg 365,2018-08-02,00:00:00,0,0,0,FMN GV 05 Lier
60,Mechelsesteenweg 365,2018-08-02,01:00:00,0,0,0,FMN GV 05 Lier
60,Mechelsesteenweg 365,2018-08-02,02:00:00,0,0,0,FMN GV 05 Lier
60,Mechelsesteenweg 365,2018-08-02,03:00:00,0,0,0,FMN GV 05 Lier
60,Mechelsesteenweg 365,2018-08-02,04:00:00,6,0,6,FMN GV 05 Lier
60,Mechelsesteenweg 365,2018-08-02,05:00:00,6,0,6,FMN GV 05 Lier
60,Mechelsesteenweg 365,2018-08-02,06:00:00,42,18,24,FMN GV 05 Lier
60,Mechelsesteenweg 365,2018-08-02,07:00:00,82,32,50,FMN GV 05 Lier
60,Mechelsesteenweg 365,2018-08-02,08:00:00,106,42,64,FMN GV 05 Lier
60,Mechelsesteenweg 365,2018-08-02,09:00:00,122,60,62,FMN GV 05 Lier
60,Mechelsesteenweg 365,2018-08-02,10:00:00,244,128,116,FMN GV 05 Lier
60,Mechelsesteenweg 365,2018-08-02,11:00:00,256,128,128,FMN GV 05 Lier
60,Mechelsesteenweg 365,2018-08-02,12:00:00,100,48,52,FMN GV 05 Lier
60,Mechelsesteenweg 365,2018-08-02,13:00:00,186,102,84,FMN GV 05 Lier
60,Mechelsesteenweg 365,2018-08-02,14:00:00,126,50,76,FMN GV 05 Lier
60,Mechelsesteenweg 365,2018-08-02,15:00:00,172,76,96,FMN GV 05 Lier
60,Mechelsesteenweg 365,2018-08-02,16:00:00,176,106,70,FMN GV 05 Lier
60,Mechelsesteenweg 365,2018-08-02,17:00:00,136,66,70,FMN GV 05 Lier
60,Mechelsesteenweg 365,2018-08-02,18:00:00,120,66,54,FMN GV 05 Lier
60,Mechelsesteenweg 365,2018-08-02,19:00:00,142,76,66,FMN GV 05 Lier
60,Mechelsesteenweg 365,2018-08-02,20:00:00,206,98,108,FMN GV 05 Lier
60,Mechelsesteenweg 365,2018-08-02,21:00:00,94,36,58,FMN GV 05 Lier
60,Mechelsesteenweg 365,2018-08-02,22:00:00,46,14,32,FMN GV 05 Lier
60,Mechelsesteenweg 365,2018-08-02,23:00:00,12,4,8,FMN GV 05 Lier
60,Mechelsesteenweg 365,2018-08-03,00:00:00,2,2,0,FMN GV 05 Lier
60,Mechelsesteenweg 365,2018-08-03,01:00:00,6,2,4,FMN GV 05 Lier
60,Mechelsesteenweg 365,2018-08-03,02:00:00,2,2,0,FMN GV 05 Lier
60,Mechelsesteenweg 365,2018-08-03,03:00:00,2,0,2,FMN GV 05 Lier
60,Mechelsesteenweg 365,2018-08-03,04:00:00,6,0,6,FMN GV 05 Lier
60,Mechelsesteenweg 365,2018-08-03,05:00:00,14,4,10,FMN GV 05 Lier
60,Mechelsesteenweg 365,2018-08-03,06:00:00,38,12,26,FMN GV 05 Lier
60,Mechelsesteenweg 365,2018-08-03,07:00:00,76,32,44,FMN GV 05 Lier
60,Mechelsesteenweg 365,2018-08-03,08:00:00,94,48,46,FMN GV 05 Lier
60,Mechelsesteenweg 365,2018-08-03,09:00:00,152,76,76,FMN GV 05 Lier
60,Mechelsesteenweg 365,2018-08-03,10:00:00,182,94,88,FMN GV 05 Lier
60,Mechelsesteenweg 365,2018-08-03,11:00:00,142,76,66,FMN GV 05 Lier
60,Mechelsesteenweg 365,2018-08-03,12:00:00,108,42,66,FMN GV 05 Lier
60,Mechelsesteenweg 365,2018-08-03,13:00:00,126,64,62,FMN GV 05 Lier
60,Mechelsesteenweg 365,2018-08-03,14:00:00,120,64,56,FMN GV 05 Lier
60,Mechelsesteenweg 365,2018-08-03,15:00:00,80,32,48,FMN GV 05 Lier
60,Mechelsesteenweg 365,2018-08-03,16:00:00,126,60,66,FMN GV 05 Lier
60,Mechelsesteenweg 365,2018-08-03,17:00:00,96,54,42,FMN GV 05 Lier
60,Mechelsesteenweg 365,2018-08-03,18:00:00,114,32,82,FMN GV 05 Lier
60,Mechelsesteenweg 365,2018-08-03,19:00:00,88,38,50,FMN GV 05 Lier
60,Mechelsesteenweg 365,2018-08-03,20:00:00,84,50,34,FMN GV 05 Lier
60,Mechelsesteenweg 365,2018-08-03,21:00:00,44,16,28,FMN GV 05 Lier
60,Mechelsesteenweg 365,2018-08-03,22:00:00,14,4,10,FMN GV 05 Lier
60,Mechelsesteenweg 365,2018-08-03,23:00:00,40,22,18,FMN GV 05 Lier
60,Mechelsesteenweg 365,2018-08-04,00:00:00,18,16,2,FMN GV 05 Lier
60,Mechelsesteenweg 365,2018-08-04,01:00:00,2,0,2,FMN GV 05 Lier
60,Mechelsesteenweg 365,2018-08-04,02:00:00,8,8,0,FMN GV 05 Lier
60,Mechelsesteenweg 365,2018-08-04,03:00:00,0,0,0,FMN GV 05 Lier
60,Mechelsesteenweg 365,2018-08-04,04:00:00,12,2,10,FMN GV 05 Lier
60,Mechelsesteenweg 365,2018-08-04,05:00:00,4,0,4,FMN GV 05 Lier
60,Mechelsesteenweg 365,2018-08-04,06:00:00,18,8,10,FMN GV 05 Lier
60,Mechelsesteenweg 365,2018-08-04,07:00:00,34,28,6,FMN GV 05 Lier
60,Mechelsesteenweg 365,2018-08-04,08:00:00,80,30,50,FMN GV 05 Lier
60,Mechelsesteenweg 365,2018-08-04,09:00:00,194,102,92,FMN GV 05 Lier
60,Mechelsesteenweg 365,2018-08-04,10:00:00,262,120,142,FMN GV 05 Lier
60,Mechelsesteenweg 365,2018-08-04,11:00:00,230,72,158,FMN GV 05 Lier
60,Mechelsesteenweg 365,2018-08-04,12:00:00,132,64,68,FMN GV 05 Lier
60,Mechelsesteenweg 365,2018-08-04,13:00:00,172,64,108,FMN GV 05 Lier
60,Mechelsesteenweg 365,2018-08-04,14:00:00,142,64,78,FMN GV 05 Lier
60,Mechelsesteenweg 365,2018-08-04,15:00:00,130,50,80,FMN GV 05 Lier
60,Mechelsesteenweg 365,2018-08-04,16:00:00,136,76,60,FMN GV 05 Lier
60,Mechelsesteenweg 365,2018-08-04,17:00:00,102,32,70,FMN GV 05 Lier
60,Mechelsesteenweg 365,2018-08-04,18:00:00,50,20,30,FMN GV 05 Lier
60,Mechelsesteenweg 365,2018-08-04,19:00:00,52,22,30,FMN GV 05 Lier
60,Mechelsesteenweg 365,2018-08-04,20:00:00,90,28,62,FMN GV 05 Lier
60,Mechelsesteenweg 365,2018-08-04,21:00:00,64,14,50,FMN GV 05 Lier
60,Mechelsesteenweg 365,2018-08-04,22:00:00,8,0,8,FMN GV 05 Lier
60,Mechelsesteenweg 365,2018-08-04,23:00:00,8,4,4,FMN GV 05 Lier
60,Mechelsesteenweg 365,2018-08-05,00:00:00,6,4,2,FMN GV 05 Lier
60,Mechelsesteenweg 365,2018-08-05,01:00:00,16,16,0,FMN GV 05 Lier
60,Mechelsesteenweg 365,2018-08-05,02:00:00,4,4,0,FMN GV 05 Lier
60,Mechelsesteenweg 365,2018-08-05,03:00:00,4,2,2,FMN GV 05 Lier
60,Mechelsesteenweg 365,2018-08-05,04:00:00,4,0,4,FMN GV 05 Lier
60,Mechelsesteenweg 365,2018-08-05,05:00:00,0,0,0,FMN GV 05 Lier
60,Mechelsesteenweg 365,2018-08-05,06:00:00,24,14,10,FMN GV 05 Lier
60,Mechelsesteenweg 365,2018-08-05,07:00:00,20,14,6,FMN GV 05 Lier
60,Mechelsesteenweg 365,2018-08-05,08:00:00,110,58,52,FMN GV 05 Lier
60,Mechelsesteenweg 365,2018-08-05,09:00:00,238,118,120,FMN GV 05 Lier
60,Mechelsesteenweg 365,2018-08-05,10:00:00,528,190,338,FMN GV 05 Lier
60,Mechelsesteenweg 365,2018-08-05,11:00:00,364,184,180,FMN GV 05 Lier
60,Mechelsesteenweg 365,2018-08-05,12:00:00,280,134,146,FMN GV 05 Lier
60,Mechelsesteenweg 365,2018-08-05,13:00:00,260,118,142,FMN GV 05 Lier
60,Mechelsesteenweg 365,2018-08-05,14:00:00,270,146,124,FMN GV 05 Lier
60,Mechelsesteenweg 365,2018-08-05,15:00:00,270,150,120,FMN GV 05 Lier
60,Mechelsesteenweg 365,2018-08-05,16:00:00,260,98,162,FMN GV 05 Lier
60,Mechelsesteenweg 365,2018-08-05,17:00:00,188,78,110,FMN GV 05 Lier
60,Mechelsesteenweg 365,2018-08-05,18:00:00,116,56,60,FMN GV 05 Lier
60,Mechelsesteenweg 365,2018-08-05,19:00:00,138,64,74,FMN GV 05 Lier
60,Mechelsesteenweg 365,2018-08-05,20:00:00,82,30,52,FMN GV 05 Lier
60,Mechelsesteenweg 365,2018-08-05,21:00:00,86,12,74,FMN GV 05 Lier
60,Mechelsesteenweg 365,2018-08-05,22:00:00,26,8,18,FMN GV 05 Lier
60,Mechelsesteenweg 365,2018-08-05,23:00:00,8,2,6,FMN GV 05 Lier
60,Mechelsesteenweg 365,2018-08-06,00:00:00,0,0,0,FMN GV 05 Lier
60,Mechelsesteenweg 365,2018-08-06,01:00:00,2,2,0,FMN GV 05 Lier
60,Mechelsesteenweg 365,2018-08-06,02:00:00,0,0,0,FMN GV 05 Lier
60,Mechelsesteenweg 365,2018-08-06,03:00:00,0,0,0,FMN GV 05 Lier
60,Mechelsesteenweg 365,2018-08-06,04:00:00,2,2,0,FMN GV 05 Lier
60,Mechelsesteenweg 365,2018-08-06,05:00:00,6,0,6,FMN GV 05 Lier
60,Mechelsesteenweg 365,2018-08-06,06:00:00,30,10,20,FMN GV 05 Lier
60,Mechelsesteenweg 365,2018-08-06,07:00:00,88,34,54,FMN GV 05 Lier
60,Mechelsesteenweg 365,2018-08-06,08:00:00,126,46,80,FMN GV 05 Lier
60,Mechelsesteenweg 365,2018-08-06,09:00:00,124,58,66,FMN GV 05 Lier
60,Mechelsesteenweg 365,2018-08-06,10:00:00,130,78,52,FMN GV 05 Lier
60,Mechelsesteenweg 365,2018-08-06,11:00:00,124,56,68,FMN GV 05 Lier
60,Mechelsesteenweg 365,2018-08-06,12:00:00,128,58,70,FMN GV 05 Lier
60,Mechelsesteenweg 365,2018-08-06,13:00:00,74,30,44,FMN GV 05 Lier
60,Mechelsesteenweg 365,2018-08-06,14:00:00,100,42,58,FMN GV 05 Lier
60,Mechelsesteenweg 365,2018-08-06,15:00:00,108,66,42,FMN GV 05 Lier
60,Mechelsesteenweg 365,2018-08-06,16:00:00,144,66,78,FMN GV 05 Lier
60,Mechelsesteenweg 365,2018-08-06,17:00:00,132,76,56,FMN GV 05 Lier
60,Mechelsesteenweg 365,2018-08-06,18:00:00,96,44,52,FMN GV 05 Lier
60,Mechelsesteenweg 365,2018-08-06,19:00:00,96,40,56,FMN GV 05 Lier
60,Mechelsesteenweg 365,2018-08-06,20:00:00,112,58,54,FMN GV 05 Lier
60,Mechelsesteenweg 365,2018-08-06,21:00:00,86,24,62,FMN GV 05 Lier
60,Mechelsesteenweg 365,2018-08-06,22:00:00,20,18,2,FMN GV 05 Lier
60,Mechelsesteenweg 365,2018-08-06,23:00:00,8,2,6,FMN GV 05 Lier
60,Mechelsesteenweg 365,2018-08-07,00:00:00,0,0,0,FMN GV 05 Lier
60,Mechelsesteenweg 365,2018-08-07,01:00:00,2,0,2,FMN GV 05 Lier
60,Mechelsesteenweg 365,2018-08-07,02:00:00,0,0,0,FMN GV 05 Lier
60,Mechelsesteenweg 365,2018-08-07,03:00:00,0,0,0,FMN GV 05 Lier
60,Mechelsesteenweg 365,2018-08-07,04:00:00,0,0,0,FMN GV 05 Lier
60,Mechelsesteenweg 365,2018-08-07,05:00:00,10,4,6,FMN GV 05 Lier
60,Mechelsesteenweg 365,2018-08-07,06:00:00,46,14,32,FMN GV 05 Lier
60,Mechelsesteenweg 365,2018-08-07,07:00:00,76,22,54,FMN GV 05 Lier
60,Mechelsesteenweg 365,2018-08-07,08:00:00,110,46,64,FMN GV 05 Lier
60,Mechelsesteenweg 365,2018-08-07,09:00:00,142,76,66,FMN GV 05 Lier
60,Mechelsesteenweg 365,2018-08-07,10:00:00,292,162,130,FMN GV 05 Lier
60,Mechelsesteenweg 365,2018-08-07,11:00:00,166,92,74,FMN GV 05 Lier
60,Mechelsesteenweg 365,2018-08-07,12:00:00,56,20,36,FMN GV 05 Lier
60,Mechelsesteenweg 365,2018-08-07,13:00:00,64,40,24,FMN GV 05 Lier
60,Mechelsesteenweg 365,2018-08-07,14:00:00,94,44,50,FMN GV 05 Lier
60,Mechelsesteenweg 365,2018-08-07,15:00:00,64,28,36,FMN GV 05 Lier
60,Mechelsesteenweg 365,2018-08-07,16:00:00,88,44,44,FMN GV 05 Lier
60,Mechelsesteenweg 365,2018-08-07,17:00:00,126,62,64,FMN GV 05 Lier
60,Mechelsesteenweg 365,2018-08-07,18:00:00,54,32,22,FMN GV 05 Lier
60,Mechelsesteenweg 365,2018-08-07,19:00:00,72,38,34,FMN GV 05 Lier
60,Mechelsesteenweg 365,2018-08-07,20:00:00,74,20,54,FMN GV 05 Lier
60,Mechelsesteenweg 365,2018-08-07,21:00:00,28,12,16,FMN GV 05 Lier
60,Mechelsesteenweg 365,2018-08-07,22:00:00,6,6,0,FMN GV 05 Lier
60,Mechelsesteenweg 365,2018-08-07,23:00:00,4,0,4,FMN GV 05 Lier
60,Mechelsesteenweg 365,2018-08-08,00:00:00,0,0,0,FMN GV 05 Lier
60,Mechelsesteenweg 365,2018-08-08,01:00:00,0,0,0,FMN GV 05 Lier
60,Mechelsesteenweg 365,2018-08-08,02:00:00,0,0,0,FMN GV 05 Lier
60,Mechelsesteenweg 365,2018-08-08,03:00:00,0,0,0,FMN GV 05 Lier
60,Mechelsesteenweg 365,2018-08-08,04:00:00,0,0,0,FMN GV 05 Lier
60,Mechelsesteenweg 365,2018-08-08,05:00:00,6,2,4,FMN GV 05 Lier
60,Mechelsesteenweg 365,2018-08-08,06:00:00,12,4,8,FMN GV 05 Lier
60,Mechelsesteenweg 365,2018-08-08,07:00:00,72,26,46,FMN GV 05 Lier
60,Mechelsesteenweg 365,2018-08-08,08:00:00,62,28,34,FMN GV 05 Lier
60,Mechelsesteenweg 365,2018-08-08,09:00:00,52,22,30,FMN GV 05 Lier
60,Mechelsesteenweg 365,2018-08-08,10:00:00,98,44,54,FMN GV 05 Lier
60,Mechelsesteenweg 365,2018-08-08,11:00:00,128,64,64,FMN GV 05 Lier
60,Mechelsesteenweg 365,2018-08-08,12:00:00,72,28,44,FMN GV 05 Lier
60,Mechelsesteenweg 365,2018-08-08,13:00:00,144,52,92,FMN GV 05 Lier
60,Mechelsesteenweg 365,2018-08-08,14:00:00,124,64,60,FMN GV 05 Lier
60,Mechelsesteenweg 365,2018-08-08,15:00:00,134,80,54,FMN GV 05 Lier
60,Mechelsesteenweg 365,2018-08-08,16:00:00,134,84,50,FMN GV 05 Lier
60,Mechelsesteenweg 365,2018-08-08,17:00:00,100,60,40,FMN GV 05 Lier
60,Mechelsesteenweg 365,2018-08-08,18:00:00,70,22,48,FMN GV 05 Lier
60,Mechelsesteenweg 365,2018-08-08,19:00:00,174,112,62,FMN GV 05 Lier
60,Mechelsesteenweg 365,2018-08-08,20:00:00,176,130,46,FMN GV 05 Lier
60,Mechelsesteenweg 365,2018-08-08,21:00:00,48,14,34,FMN GV 05 Lier
60,Mechelsesteenweg 365,2018-08-08,22:00:00,24,10,14,FMN GV 05 Lier
60,Mechelsesteenweg 365,2018-08-08,23:00:00,2,0,2,FMN GV 05 Lier
60,Mechelsesteenweg 365,2018-08-09,00:00:00,4,2,2,FMN GV 05 Lier
60,Mechelsesteenweg 365,2018-08-09,01:00:00,0,0,0,FMN GV 05 Lier
60,Mechelsesteenweg 365,2018-08-09,02:00:00,2,2,0,FMN GV 05 Lier
60,Mechelsesteenweg 365,2018-08-09,03:00:00,4,0,4,FMN GV 05 Lier
60,Mechelsesteenweg 365,2018-08-09,04:00:00,0,0,0,FMN GV 05 Lier
60,Mechelsesteenweg 365,2018-08-09,05:00:00,8,2,6,FMN GV 05 Lier
60,Mechelsesteenweg 365,2018-08-09,06:00:00,20,8,12,FMN GV 05 Lier
60,Mechelsesteenweg 365,2018-08-09,07:00:00,46,24,22,FMN GV 05 Lier
60,Mechelsesteenweg 365,2018-08-09,08:00:00,62,22,40,FMN GV 05 Lier
60,Mechelsesteenweg 365,2018-08-09,09:00:00,70,40,30,FMN GV 05 Lier
60,Mechelsesteenweg 365,2018-08-09,10:00:00,48,42,6,FMN GV 05 Lier
60,Mechelsesteenweg 365,2018-08-09,11:00:00,42,22,20,FMN GV 05 Lier
60,Mechelsesteenweg 365,2018-08-09,12:00:00,28,10,18,FMN GV 05 Lier
60,Mechelsesteenweg 365,2018-08-09,13:00:00,86,10,76,FMN GV 05 Lier
60,Mechelsesteenweg 365,2018-08-09,14:00:00,26,24,2,FMN GV 05 Lier
60,Mechelsesteenweg 365,2018-08-09,15:00:00,28,16,12,FMN GV 05 Lier
60,Mechelsesteenweg 365,2018-08-09,16:00:00,26,20,6,FMN GV 05 Lier
60,Mechelsesteenweg 365,2018-08-09,17:00:00,60,52,8,FMN GV 05 Lier
60,Mechelsesteenweg 365,2018-08-09,18:00:00,32,22,10,FMN GV 05 Lier
60,Mechelsesteenweg 365,2018-08-09,19:00:00,26,12,14,FMN GV 05 Lier
60,Mechelsesteenweg 365,2018-08-09,20:00:00,40,8,32,FMN GV 05 Lier
60,Mechelsesteenweg 365,2018-08-09,21:00:00,6,0,6,FMN GV 05 Lier
60,Mechelsesteenweg 365,2018-08-09,22:00:00,6,2,4,FMN GV 05 Lier
60,Mechelsesteenweg 365,2018-08-09,23:00:00,0,0,0,FMN GV 05 Lier
60,Mechelsesteenweg 365,2018-08-10,00:00:00,2,2,0,FMN GV 05 Lier
60,Mechelsesteenweg 365,2018-08-10,01:00:00,0,0,0,FMN GV 05 Lier
60,Mechelsesteenweg 365,2018-08-10,02:00:00,0,0,0,FMN GV 05 Lier
60,Mechelsesteenweg 365,2018-08-10,03:00:00,0,0,0,FMN GV 05 Lier
60,Mechelsesteenweg 365,2018-08-10,04:00:00,2,0,2,FMN GV 05 Lier
60,Mechelsesteenweg 365,2018-08-10,05:00:00,2,0,2,FMN GV 05 Lier
60,Mechelsesteenweg 365,2018-08-10,06:00:00,22,2,20,FMN GV 05 Lier
60,Mechelsesteenweg 365,2018-08-10,07:00:00,54,22,32,FMN GV 05 Lier
60,Mechelsesteenweg 365,2018-08-10,08:00:00,68,34,34,FMN GV 05 Lier
60,Mechelsesteenweg 365,2018-08-10,09:00:00,60,40,20,FMN GV 05 Lier
60,Mechelsesteenweg 365,2018-08-10,10:00:00,156,68,88,FMN GV 05 Lier
60,Mechelsesteenweg 365,2018-08-10,11:00:00,144,72,72,FMN GV 05 Lier
60,Mechelsesteenweg 365,2018-08-10,12:00:00,126,46,80,FMN GV 05 Lier
60,Mechelsesteenweg 365,2018-08-10,13:00:00,104,66,38,FMN GV 05 Lier
60,Mechelsesteenweg 365,2018-08-10,14:00:00,178,90,88,FMN GV 05 Lier
60,Mechelsesteenweg 365,2018-08-10,15:00:00,116,66,50,FMN GV 05 Lier
60,Mechelsesteenweg 365,2018-08-10,16:00:00,108,50,58,FMN GV 05 Lier
60,Mechelsesteenweg 365,2018-08-10,17:00:00,150,52,98,FMN GV 05 Lier
60,Mechelsesteenweg 365,2018-08-10,18:00:00,52,28,24,FMN GV 05 Lier
60,Mechelsesteenweg 365,2018-08-10,19:00:00,38,28,10,FMN GV 05 Lier
60,Mechelsesteenweg 365,2018-08-10,20:00:00,28,16,12,FMN GV 05 Lier
60,Mechelsesteenweg 365,2018-08-10,21:00:00,16,6,10,FMN GV 05 Lier
60,Mechelsesteenweg 365,2018-08-10,22:00:00,10,2,8,FMN GV 05 Lier
60,Mechelsesteenweg 365,2018-08-10,23:00:00,2,0,2,FMN GV 05 Lier
60,Mechelsesteenweg 365,2018-08-11,00:00:00,0,0,0,FMN GV 05 Lier
60,Mechelsesteenweg 365,2018-08-11,01:00:00,4,0,4,FMN GV 05 Lier
60,Mechelsesteenweg 365,2018-08-11,02:00:00,2,0,2,FMN GV 05 Lier
60,Mechelsesteenweg 365,2018-08-11,03:00:00,2,0,2,FMN GV 05 Lier
60,Mechelsesteenweg 365,2018-08-11,04:00:00,0,0,0,FMN GV 05 Lier
60,Mechelsesteenweg 365,2018-08-11,05:00:00,4,2,2,FMN GV 05 Lier
60,Mechelsesteenweg 365,2018-08-11,06:00:00,6,2,4,FMN GV 05 Lier
60,Mechelsesteenweg 365,2018-08-11,07:00:00,18,10,8,FMN GV 05 Lier
60,Mechelsesteenweg 365,2018-08-11,08:00:00,60,30,30,FMN GV 05 Lier
60,Mechelsesteenweg 365,2018-08-11,09:00:00,86,52,34,FMN GV 05 Lier
60,Mechelsesteenweg 365,2018-08-11,10:00:00,240,86,154,FMN GV 05 Lier
60,Mechelsesteenweg 365,2018-08-11,11:00:00,168,64,104,FMN GV 05 Lier
60,Mechelsesteenweg 365,2018-08-11,12:00:00,128,68,60,FMN GV 05 Lier
60,Mechelsesteenweg 365,2018-08-11,13:00:00,166,90,76,FMN GV 05 Lier
60,Mechelsesteenweg 365,2018-08-11,14:00:00,232,128,104,FMN GV 05 Lier
60,Mechelsesteenweg 365,2018-08-11,15:00:00,300,156,144,FMN GV 05 Lier
60,Mechelsesteenweg 365,2018-08-11,16:00:00,228,142,86,FMN GV 05 Lier
60,Mechelsesteenweg 365,2018-08-11,17:00:00,84,38,46,FMN GV 05 Lier
60,Mechelsesteenweg 365,2018-08-11,18:00:00,76,26,50,FMN GV 05 Lier
60,Mechelsesteenweg 365,2018-08-11,19:00:00,60,30,30,FMN GV 05 Lier
60,Mechelsesteenweg 365,2018-08-11,20:00:00,78,36,42,FMN GV 05 Lier
60,Mechelsesteenweg 365,2018-08-11,21:00:00,24,4,20,FMN GV 05 Lier
60,Mechelsesteenweg 365,2018-08-11,22:00:00,2,2,0,FMN GV 05 Lier
60,Mechelsesteenweg 365,2018-08-11,23:00:00,8,6,2,FMN GV 05 Lier
60,Mechelsesteenweg 365,2018-08-12,00:00:00,2,0,2,FMN GV 05 Lier
60,Mechelsesteenweg 365,2018-08-12,01:00:00,2,0,2,FMN GV 05 Lier
60,Mechelsesteenweg 365,2018-08-12,02:00:00,0,0,0,FMN GV 05 Lier
60,Mechelsesteenweg 365,2018-08-12,03:00:00,2,2,0,FMN GV 05 Lier
60,Mechelsesteenweg 365,2018-08-12,04:00:00,8,0,8,FMN GV 05 Lier
60,Mechelsesteenweg 365,2018-08-12,05:00:00,0,0,0,FMN GV 05 Lier
60,Mechelsesteenweg 365,2018-08-12,06:00:00,4,2,2,FMN GV 05 Lier
60,Mechelsesteenweg 365,2018-08-12,07:00:00,12,12,0,FMN GV 05 Lier
60,Mechelsesteenweg 365,2018-08-12,08:00:00,52,26,26,FMN GV 05 Lier
60,Mechelsesteenweg 365,2018-08-12,09:00:00,300,182,118,FMN GV 05 Lier
60,Mechelsesteenweg 365,2018-08-12,10:00:00,504,204,300,FMN GV 05 Lier
60,Mechelsesteenweg 365,2018-08-12,11:00:00,544,252,292,FMN GV 05 Lier
60,Mechelsesteenweg 365,2018-08-12,12:00:00,326,142,184,FMN GV 05 Lier
60,Mechelsesteenweg 365,2018-08-12,13:00:00,386,190,196,FMN GV 05 Lier
60,Mechelsesteenweg 365,2018-08-12,14:00:00,564,274,290,FMN GV 05 Lier
60,Mechelsesteenweg 365,2018-08-12,15:00:00,522,240,282,FMN GV 05 Lier
60,Mechelsesteenweg 365,2018-08-12,16:00:00,364,148,216,FMN GV 05 Lier
60,Mechelsesteenweg 365,2018-08-12,17:00:00,282,146,136,FMN GV 05 Lier
60,Mechelsesteenweg 365,2018-08-12,18:00:00,142,56,86,FMN GV 05 Lier
60,Mechelsesteenweg 365,2018-08-12,19:00:00,88,18,70,FMN GV 05 Lier
60,Mechelsesteenweg 365,2018-08-12,20:00:00,68,30,38,FMN GV 05 Lier
60,Mechelsesteenweg 365,2018-08-12,21:00:00,14,4,10,FMN GV 05 Lier
60,Mechelsesteenweg 365,2018-08-12,22:00:00,2,2,0,FMN GV 05 Lier
60,Mechelsesteenweg 365,2018-08-12,23:00:00,0,0,0,FMN GV 05 Lier
60,Mechelsesteenweg 365,2018-08-13,00:00:00,2,2,0,FMN GV 05 Lier
60,Mechelsesteenweg 365,2018-08-13,01:00:00,0,0,0,FMN GV 05 Lier
60,Mechelsesteenweg 365,2018-08-13,02:00:00,2,0,2,FMN GV 05 Lier
60,Mechelsesteenweg 365,2018-08-13,03:00:00,0,0,0,FMN GV 05 Lier
60,Mechelsesteenweg 365,2018-08-13,04:00:00,2,2,0,FMN GV 05 Lier
60,Mechelsesteenweg 365,2018-08-13,05:00:00,4,0,4,FMN GV 05 Lier
60,Mechelsesteenweg 365,2018-08-13,06:00:00,10,2,8,FMN GV 05 Lier
60,Mechelsesteenweg 365,2018-08-13,07:00:00,24,10,14,FMN GV 05 Lier
60,Mechelsesteenweg 365,2018-08-13,08:00:00,24,10,14,FMN GV 05 Lier
60,Mechelsesteenweg 365,2018-08-13,09:00:00,16,8,8,FMN GV 05 Lier
60,Mechelsesteenweg 365,2018-08-13,10:00:00,60,50,10,FMN GV 05 Lier
60,Mechelsesteenweg 365,2018-08-13,11:00:00,26,14,12,FMN GV 05 Lier
60,Mechelsesteenweg 365,2018-08-13,12:00:00,28,20,8,FMN GV 05 Lier
60,Mechelsesteenweg 365,2018-08-13,13:00:00,18,10,8,FMN GV 05 Lier
60,Mechelsesteenweg 365,2018-08-13,14:00:00,28,24,4,FMN GV 05 Lier
60,Mechelsesteenweg 365,2018-08-13,15:00:00,30,14,16,FMN GV 05 Lier
60,Mechelsesteenweg 365,2018-08-13,16:00:00,48,28,20,FMN GV 05 Lier
60,Mechelsesteenweg 365,2018-08-13,17:00:00,26,18,8,FMN GV 05 Lier
60,Mechelsesteenweg 365,2018-08-13,18:00:00,32,16,16,FMN GV 05 Lier
60,Mechelsesteenweg 365,2018-08-13,19:00:00,44,20,24,FMN GV 05 Lier
60,Mechelsesteenweg 365,2018-08-13,20:00:00,34,14,20,FMN GV 05 Lier
60,Mechelsesteenweg 365,2018-08-13,21:00:00,20,0,20,FMN GV 05 Lier
60,Mechelsesteenweg 365,2018-08-13,22:00:00,4,4,0,FMN GV 05 Lier
60,Mechelsesteenweg 365,2018-08-13,23:00:00,6,2,4,FMN GV 05 Lier
60,Mechelsesteenweg 365,2018-08-14,00:00:00,0,0,0,FMN GV 05 Lier
60,Mechelsesteenweg 365,2018-08-14,01:00:00,0,0,0,FMN GV 05 Lier
60,Mechelsesteenweg 365,2018-08-14,02:00:00,0,0,0,FMN GV 05 Lier
60,Mechelsesteenweg 365,2018-08-14,03:00:00,4,0,4,FMN GV 05 Lier
60,Mechelsesteenweg 365,2018-08-14,04:00:00,0,0,0,FMN GV 05 Lier
60,Mechelsesteenweg 365,2018-08-14,05:00:00,2,0,2,FMN GV 05 Lier
60,Mechelsesteenweg 365,2018-08-14,06:00:00,22,4,18,FMN GV 05 Lier
60,Mechelsesteenweg 365,2018-08-14,07:00:00,52,18,34,FMN GV 05 Lier
60,Mechelsesteenweg 365,2018-08-14,08:00:00,60,32,28,FMN GV 05 Lier
60,Mechelsesteenweg 365,2018-08-14,09:00:00,76,42,34,FMN GV 05 Lier
60,Mechelsesteenweg 365,2018-08-14,10:00:00,118,48,70,FMN GV 05 Lier
60,Mechelsesteenweg 365,2018-08-14,11:00:00,110,66,44,FMN GV 05 Lier
60,Mechelsesteenweg 365,2018-08-14,12:00:00,68,28,40,FMN GV 05 Lier
60,Mechelsesteenweg 365,2018-08-14,13:00:00,68,28,40,FMN GV 05 Lier
60,Mechelsesteenweg 365,2018-08-14,14:00:00,52,22,30,FMN GV 05 Lier
60,Mechelsesteenweg 365,2018-08-14,15:00:00,120,68,52,FMN GV 05 Lier
60,Mechelsesteenweg 365,2018-08-14,16:00:00,118,42,76,FMN GV 05 Lier
60,Mechelsesteenweg 365,2018-08-14,17:00:00,94,56,38,FMN GV 05 Lier
60,Mechelsesteenweg 365,2018-08-14,18:00:00,82,54,28,FMN GV 05 Lier
60,Mechelsesteenweg 365,2018-08-14,19:00:00,80,38,42,FMN GV 05 Lier
60,Mechelsesteenweg 365,2018-08-14,20:00:00,64,40,24,FMN GV 05 Lier
60,Mechelsesteenweg 365,2018-08-14,21:00:00,18,12,6,FMN GV 05 Lier
60,Mechelsesteenweg 365,2018-08-14,22:00:00,10,4,6,FMN GV 05 Lier
60,Mechelsesteenweg 365,2018-08-14,23:00:00,8,4,4,FMN GV 05 Lier
60,Mechelsesteenweg 365,2018-08-15,00:00:00,0,0,0,FMN GV 05 Lier
60,Mechelsesteenweg 365,2018-08-15,01:00:00,0,0,0,FMN GV 05 Lier
60,Mechelsesteenweg 365,2018-08-15,02:00:00,2,0,2,FMN GV 05 Lier
60,Mechelsesteenweg 365,2018-08-15,03:00:00,0,0,0,FMN GV 05 Lier
60,Mechelsesteenweg 365,2018-08-15,04:00:00,0,0,0,FMN GV 05 Lier
60,Mechelsesteenweg 365,2018-08-15,05:00:00,0,0,0,FMN GV 05 Lier
60,Mechelsesteenweg 365,2018-08-15,06:00:00,16,6,10,FMN GV 05 Lier
60,Mechelsesteenweg 365,2018-08-15,07:00:00,16,4,12,FMN GV 05 Lier
60,Mechelsesteenweg 365,2018-08-15,08:00:00,48,26,22,FMN GV 05 Lier
60,Mechelsesteenweg 365,2018-08-15,09:00:00,180,98,82,FMN GV 05 Lier
60,Mechelsesteenweg 365,2018-08-15,10:00:00,218,114,104,FMN GV 05 Lier
60,Mechelsesteenweg 365,2018-08-15,11:00:00,286,150,136,FMN GV 05 Lier
60,Mechelsesteenweg 365,2018-08-15,12:00:00,224,118,106,FMN GV 05 Lier
60,Mechelsesteenweg 365,2018-08-15,13:00:00,222,98,124,FMN GV 05 Lier
60,Mechelsesteenweg 365,2018-08-15,14:00:00,264,126,138,FMN GV 05 Lier
60,Mechelsesteenweg 365,2018-08-15,15:00:00,334,186,148,FMN GV 05 Lier
60,Mechelsesteenweg 365,2018-08-15,16:00:00,258,120,138,FMN GV 05 Lier
60,Mechelsesteenweg 365,2018-08-15,17:00:00,120,36,84,FMN GV 05 Lier
60,Mechelsesteenweg 365,2018-08-15,18:00:00,110,54,56,FMN GV 05 Lier
60,Mechelsesteenweg 365,2018-08-15,19:00:00,76,34,42,FMN GV 05 Lier
60,Mechelsesteenweg 365,2018-08-15,20:00:00,100,34,66,FMN GV 05 Lier
60,Mechelsesteenweg 365,2018-08-15,21:00:00,16,12,4,FMN GV 05 Lier
60,Mechelsesteenweg 365,2018-08-15,22:00:00,18,2,16,FMN GV 05 Lier
60,Mechelsesteenweg 365,2018-08-15,23:00:00,2,0,2,FMN GV 05 Lier
60,Mechelsesteenweg 365,2018-08-16,00:00:00,2,0,2,FMN GV 05 Lier
60,Mechelsesteenweg 365,2018-08-16,01:00:00,0,0,0,FMN GV 05 Lier
60,Mechelsesteenweg 365,2018-08-16,02:00:00,0,0,0,FMN GV 05 Lier
60,Mechelsesteenweg 365,2018-08-16,03:00:00,2,0,2,FMN GV 05 Lier
60,Mechelsesteenweg 365,2018-08-16,04:00:00,2,2,0,FMN GV 05 Lier
60,Mechelsesteenweg 365,2018-08-16,05:00:00,2,0,2,FMN GV 05 Lier
60,Mechelsesteenweg 365,2018-08-16,06:00:00,38,10,28,FMN GV 05 Lier
60,Mechelsesteenweg 365,2018-08-16,07:00:00,58,18,40,FMN GV 05 Lier
60,Mechelsesteenweg 365,2018-08-16,08:00:00,66,22,44,FMN GV 05 Lier
60,Mechelsesteenweg 365,2018-08-16,09:00:00,68,48,20,FMN GV 05 Lier
60,Mechelsesteenweg 365,2018-08-16,10:00:00,132,54,78,FMN GV 05 Lier
60,Mechelsesteenweg 365,2018-08-16,11:00:00,136,42,94,FMN GV 05 Lier
60,Mechelsesteenweg 365,2018-08-16,12:00:00,116,42,74,FMN GV 05 Lier
60,Mechelsesteenweg 365,2018-08-16,13:00:00,162,94,68,FMN GV 05 Lier
60,Mechelsesteenweg 365,2018-08-16,14:00:00,246,152,94,FMN GV 05 Lier
60,Mechelsesteenweg 365,2018-08-16,15:00:00,214,108,106,FMN GV 05 Lier
60,Mechelsesteenweg 365,2018-08-16,16:00:00,242,112,130,FMN GV 05 Lier
60,Mechelsesteenweg 365,2018-08-16,17:00:00,170,82,88,FMN GV 05 Lier
60,Mechelsesteenweg 365,2018-08-16,18:00:00,114,54,60,FMN GV 05 Lier
60,Mechelsesteenweg 365,2018-08-16,19:00:00,134,64,70,FMN GV 05 Lier
60,Mechelsesteenweg 365,2018-08-16,20:00:00,134,54,80,FMN GV 05 Lier
60,Mechelsesteenweg 365,2018-08-16,21:00:00,32,12,20,FMN GV 05 Lier
60,Mechelsesteenweg 365,2018-08-16,22:00:00,16,6,10,FMN GV 05 Lier
60,Mechelsesteenweg 365,2018-08-16,23:00:00,4,2,2,FMN GV 05 Lier
60,Mechelsesteenweg 365,2018-08-17,00:00:00,6,0,6,FMN GV 05 Lier
60,Mechelsesteenweg 365,2018-08-17,01:00:00,0,0,0,FMN GV 05 Lier
60,Mechelsesteenweg 365,2018-08-17,02:00:00,0,0,0,FMN GV 05 Lier
60,Mechelsesteenweg 365,2018-08-17,03:00:00,0,0,0,FMN GV 05 Lier
60,Mechelsesteenweg 365,2018-08-17,04:00:00,2,0,2,FMN GV 05 Lier
60,Mechelsesteenweg 365,2018-08-17,05:00:00,4,2,2,FMN GV 05 Lier
60,Mechelsesteenweg 365,2018-08-17,06:00:00,18,8,10,FMN GV 05 Lier
60,Mechelsesteenweg 365,2018-08-17,07:00:00,56,18,38,FMN GV 05 Lier
60,Mechelsesteenweg 365,2018-08-17,08:00:00,56,16,40,FMN GV 05 Lier
60,Mechelsesteenweg 365,2018-08-17,09:00:00,60,42,18,FMN GV 05 Lier
60,Mechelsesteenweg 365,2018-08-17,10:00:00,128,48,80,FMN GV 05 Lier
60,Mechelsesteenweg 365,2018-08-17,11:00:00,122,60,62,FMN GV 05 Lier
60,Mechelsesteenweg 365,2018-08-17,12:00:00,128,62,66,FMN GV 05 Lier
60,Mechelsesteenweg 365,2018-08-17,13:00:00,94,52,42,FMN GV 05 Lier
60,Mechelsesteenweg 365,2018-08-17,14:00:00,228,118,110,FMN GV 05 Lier
60,Mechelsesteenweg 365,2018-08-17,15:00:00,130,62,68,FMN GV 05 Lier
60,Mechelsesteenweg 365,2018-08-17,16:00:00,184,74,110,FMN GV 05 Lier
60,Mechelsesteenweg 365,2018-08-17,17:00:00,154,76,78,FMN GV 05 Lier
60,Mechelsesteenweg 365,2018-08-17,18:00:00,96,44,52,FMN GV 05 Lier
60,Mechelsesteenweg 365,2018-08-17,19:00:00,80,36,44,FMN GV 05 Lier
60,Mechelsesteenweg 365,2018-08-17,20:00:00,48,14,34,FMN GV 05 Lier
60,Mechelsesteenweg 365,2018-08-17,21:00:00,36,18,18,FMN GV 05 Lier
60,Mechelsesteenweg 365,2018-08-17,22:00:00,14,4,10,FMN GV 05 Lier
60,Mechelsesteenweg 365,2018-08-17,23:00:00,4,4,0,FMN GV 05 Lier
60,Mechelsesteenweg 365,2018-08-18,00:00:00,2,2,0,FMN GV 05 Lier
60,Mechelsesteenweg 365,2018-08-18,01:00:00,0,0,0,FMN GV 05 Lier
60,Mechelsesteenweg 365,2018-08-18,02:00:00,0,0,0,FMN GV 05 Lier
60,Mechelsesteenweg 365,2018-08-18,03:00:00,0,0,0,FMN GV 05 Lier
60,Mechelsesteenweg 365,2018-08-18,04:00:00,0,0,0,FMN GV 05 Lier
60,Mechelsesteenweg 365,2018-08-18,05:00:00,2,0,2,FMN GV 05 Lier
60,Mechelsesteenweg 365,2018-08-18,06:00:00,8,4,4,FMN GV 05 Lier
60,Mechelsesteenweg 365,2018-08-18,07:00:00,14,2,12,FMN GV 05 Lier
60,Mechelsesteenweg 365,2018-08-18,08:00:00,44,24,20,FMN GV 05 Lier
60,Mechelsesteenweg 365,2018-08-18,09:00:00,94,66,28,FMN GV 05 Lier
60,Mechelsesteenweg 365,2018-08-18,10:00:00,186,90,96,FMN GV 05 Lier
60,Mechelsesteenweg 365,2018-08-18,11:00:00,242,96,146,FMN GV 05 Lier
60,Mechelsesteenweg 365,2018-08-18,12:00:00,194,78,116,FMN GV 05 Lier
60,Mechelsesteenweg 365,2018-08-18,13:00:00,142,78,64,FMN GV 05 Lier
60,Mechelsesteenweg 365,2018-08-18,14:00:00,252,124,128,FMN GV 05 Lier
60,Mechelsesteenweg 365,2018-08-18,15:00:00,284,126,158,FMN GV 05 Lier
60,Mechelsesteenweg 365,2018-08-18,16:00:00,222,60,162,FMN GV 05 Lier
60,Mechelsesteenweg 365,2018-08-18,17:00:00,120,44,76,FMN GV 05 Lier
60,Mechelsesteenweg 365,2018-08-18,18:00:00,62,24,38,FMN GV 05 Lier
60,Mechelsesteenweg 365,2018-08-18,19:00:00,54,28,26,FMN GV 05 Lier
60,Mechelsesteenweg 365,2018-08-18,20:00:00,26,6,20,FMN GV 05 Lier
60,Mechelsesteenweg 365,2018-08-18,21:00:00,28,14,14,FMN GV 05 Lier
60,Mechelsesteenweg 365,2018-08-18,22:00:00,14,0,14,FMN GV 05 Lier
60,Mechelsesteenweg 365,2018-08-18,23:00:00,6,0,6,FMN GV 05 Lier
60,Mechelsesteenweg 365,2018-08-19,00:00:00,8,2,6,FMN GV 05 Lier
60,Mechelsesteenweg 365,2018-08-19,01:00:00,6,4,2,FMN GV 05 Lier
60,Mechelsesteenweg 365,2018-08-19,02:00:00,2,2,0,FMN GV 05 Lier
60,Mechelsesteenweg 365,2018-08-19,03:00:00,2,2,0,FMN GV 05 Lier
60,Mechelsesteenweg 365,2018-08-19,04:00:00,2,2,0,FMN GV 05 Lier
60,Mechelsesteenweg 365,2018-08-19,05:00:00,4,0,4,FMN GV 05 Lier
60,Mechelsesteenweg 365,2018-08-19,06:00:00,8,0,8,FMN GV 05 Lier
60,Mechelsesteenweg 365,2018-08-19,07:00:00,24,12,12,FMN GV 05 Lier
60,Mechelsesteenweg 365,2018-08-19,08:00:00,84,34,50,FMN GV 05 Lier
60,Mechelsesteenweg 365,2018-08-19,09:00:00,198,134,64,FMN GV 05 Lier
60,Mechelsesteenweg 365,2018-08-19,10:00:00,426,210,216,FMN GV 05 Lier
60,Mechelsesteenweg 365,2018-08-19,11:00:00,436,228,208,FMN GV 05 Lier
60,Mechelsesteenweg 365,2018-08-19,12:00:00,254,144,110,FMN GV 05 Lier
60,Mechelsesteenweg 365,2018-08-19,13:00:00,260,130,130,FMN GV 05 Lier
60,Mechelsesteenweg 365,2018-08-19,14:00:00,336,188,148,FMN GV 05 Lier
60,Mechelsesteenweg 365,2018-08-19,15:00:00,338,190,148,FMN GV 05 Lier
60,Mechelsesteenweg 365,2018-08-19,16:00:00,322,134,188,FMN GV 05 Lier
60,Mechelsesteenweg 365,2018-08-19,17:00:00,188,70,118,FMN GV 05 Lier
60,Mechelsesteenweg 365,2018-08-19,18:00:00,124,52,72,FMN GV 05 Lier
60,Mechelsesteenweg 365,2018-08-19,19:00:00,54,14,40,FMN GV 05 Lier
60,Mechelsesteenweg 365,2018-08-19,20:00:00,52,16,36,FMN GV 05 Lier
60,Mechelsesteenweg 365,2018-08-19,21:00:00,10,4,6,FMN GV 05 Lier
60,Mechelsesteenweg 365,2018-08-19,22:00:00,6,2,4,FMN GV 05 Lier
60,Mechelsesteenweg 365,2018-08-19,23:00:00,2,0,2,FMN GV 05 Lier
60,Mechelsesteenweg 365,2018-08-20,00:00:00,0,0,0,FMN GV 05 Lier
60,Mechelsesteenweg 365,2018-08-20,01:00:00,0,0,0,FMN GV 05 Lier
60,Mechelsesteenweg 365,2018-08-20,02:00:00,0,0,0,FMN GV 05 Lier
60,Mechelsesteenweg 365,2018-08-20,03:00:00,0,0,0,FMN GV 05 Lier
60,Mechelsesteenweg 365,2018-08-20,04:00:00,0,0,0,FMN GV 05 Lier
60,Mechelsesteenweg 365,2018-08-20,05:00:00,2,0,2,FMN GV 05 Lier
60,Mechelsesteenweg 365,2018-08-20,06:00:00,34,14,20,FMN GV 05 Lier
60,Mechelsesteenweg 365,2018-08-20,07:00:00,62,14,48,FMN GV 05 Lier
60,Mechelsesteenweg 365,2018-08-20,08:00:00,70,16,54,FMN GV 05 Lier
60,Mechelsesteenweg 365,2018-08-20,09:00:00,52,28,24,FMN GV 05 Lier
60,Mechelsesteenweg 365,2018-08-20,10:00:00,40,20,20,FMN GV 05 Lier
60,Mechelsesteenweg 365,2018-08-20,11:00:00,54,22,32,FMN GV 05 Lier
60,Mechelsesteenweg 365,2018-08-20,12:00:00,52,30,22,FMN GV 05 Lier
60,Mechelsesteenweg 365,2018-08-20,13:00:00,74,26,48,FMN GV 05 Lier
60,Mechelsesteenweg 365,2018-08-20,14:00:00,106,50,56,FMN GV 05 Lier
60,Mechelsesteenweg 365,2018-08-20,15:00:00,114,46,68,FMN GV 05 Lier
60,Mechelsesteenweg 365,2018-08-20,16:00:00,120,64,56,FMN GV 05 Lier
60,Mechelsesteenweg 365,2018-08-20,17:00:00,126,82,44,FMN GV 05 Lier
60,Mechelsesteenweg 365,2018-08-20,18:00:00,94,42,52,FMN GV 05 Lier
60,Mechelsesteenweg 365,2018-08-20,19:00:00,58,28,30,FMN GV 05 Lier
60,Mechelsesteenweg 365,2018-08-20,20:00:00,34,18,16,FMN GV 05 Lier
60,Mechelsesteenweg 365,2018-08-20,21:00:00,22,8,14,FMN GV 05 Lier
60,Mechelsesteenweg 365,2018-08-20,22:00:00,14,8,6,FMN GV 05 Lier
60,Mechelsesteenweg 365,2018-08-20,23:00:00,2,2,0,FMN GV 05 Lier
60,Mechelsesteenweg 365,2018-08-21,00:00:00,0,0,0,FMN GV 05 Lier
60,Mechelsesteenweg 365,2018-08-21,01:00:00,0,0,0,FMN GV 05 Lier
60,Mechelsesteenweg 365,2018-08-21,02:00:00,0,0,0,FMN GV 05 Lier
60,Mechelsesteenweg 365,2018-08-21,03:00:00,0,0,0,FMN GV 05 Lier
60,Mechelsesteenweg 365,2018-08-21,04:00:00,4,2,2,FMN GV 05 Lier
60,Mechelsesteenweg 365,2018-08-21,05:00:00,2,0,2,FMN GV 05 Lier
60,Mechelsesteenweg 365,2018-08-21,06:00:00,26,6,20,FMN GV 05 Lier
60,Mechelsesteenweg 365,2018-08-21,07:00:00,88,30,58,FMN GV 05 Lier
60,Mechelsesteenweg 365,2018-08-21,08:00:00,86,26,60,FMN GV 05 Lier
60,Mechelsesteenweg 365,2018-08-21,09:00:00,70,18,52,FMN GV 05 Lier
60,Mechelsesteenweg 365,2018-08-21,10:00:00,136,66,70,FMN GV 05 Lier
60,Mechelsesteenweg 365,2018-08-21,11:00:00,148,86,62,FMN GV 05 Lier
60,Mechelsesteenweg 365,2018-08-21,12:00:00,88,44,44,FMN GV 05 Lier
60,Mechelsesteenweg 365,2018-08-21,13:00:00,180,98,82,FMN GV 05 Lier
60,Mechelsesteenweg 365,2018-08-21,14:00:00,212,112,100,FMN GV 05 Lier
60,Mechelsesteenweg 365,2018-08-21,15:00:00,246,112,134,FMN GV 05 Lier
60,Mechelsesteenweg 365,2018-08-21,16:00:00,270,138,132,FMN GV 05 Lier
60,Mechelsesteenweg 365,2018-08-21,17:00:00,152,104,48,FMN GV 05 Lier
60,Mechelsesteenweg 365,2018-08-21,18:00:00,144,78,66,FMN GV 05 Lier
60,Mechelsesteenweg 365,2018-08-21,19:00:00,180,104,76,FMN GV 05 Lier
60,Mechelsesteenweg 365,2018-08-21,20:00:00,122,56,66,FMN GV 05 Lier
60,Mechelsesteenweg 365,2018-08-21,21:00:00,44,16,28,FMN GV 05 Lier
60,Mechelsesteenweg 365,2018-08-21,22:00:00,10,2,8,FMN GV 05 Lier
60,Mechelsesteenweg 365,2018-08-21,23:00:00,2,2,0,FMN GV 05 Lier
60,Mechelsesteenweg 365,2018-08-22,00:00:00,2,2,0,FMN GV 05 Lier
60,Mechelsesteenweg 365,2018-08-22,01:00:00,0,0,0,FMN GV 05 Lier
60,Mechelsesteenweg 365,2018-08-22,02:00:00,0,0,0,FMN GV 05 Lier
60,Mechelsesteenweg 365,2018-08-22,03:00:00,0,0,0,FMN GV 05 Lier
60,Mechelsesteenweg 365,2018-08-22,04:00:00,6,2,4,FMN GV 05 Lier
60,Mechelsesteenweg 365,2018-08-22,05:00:00,8,4,4,FMN GV 05 Lier
60,Mechelsesteenweg 365,2018-08-22,06:00:00,44,6,38,FMN GV 05 Lier
60,Mechelsesteenweg 365,2018-08-22,07:00:00,78,36,42,FMN GV 05 Lier
60,Mechelsesteenweg 365,2018-08-22,08:00:00,86,34,52,FMN GV 05 Lier
60,Mechelsesteenweg 365,2018-08-22,09:00:00,108,66,42,FMN GV 05 Lier
60,Mechelsesteenweg 365,2018-08-22,10:00:00,192,92,100,FMN GV 05 Lier
60,Mechelsesteenweg 365,2018-08-22,11:00:00,204,90,114,FMN GV 05 Lier
60,Mechelsesteenweg 365,2018-08-22,12:00:00,198,102,96,FMN GV 05 Lier
60,Mechelsesteenweg 365,2018-08-22,13:00:00,256,130,126,FMN GV 05 Lier
60,Mechelsesteenweg 365,2018-08-22,14:00:00,266,144,122,FMN GV 05 Lier
60,Mechelsesteenweg 365,2018-08-22,15:00:00,230,88,142,FMN GV 05 Lier
60,Mechelsesteenweg 365,2018-08-22,16:00:00,312,138,174,FMN GV 05 Lier
60,Mechelsesteenweg 365,2018-08-22,17:00:00,264,154,110,FMN GV 05 Lier
60,Mechelsesteenweg 365,2018-08-22,18:00:00,136,84,52,FMN GV 05 Lier
60,Mechelsesteenweg 365,2018-08-22,19:00:00,276,168,108,FMN GV 05 Lier
60,Mechelsesteenweg 365,2018-08-22,20:00:00,214,134,80,FMN GV 05 Lier
60,Mechelsesteenweg 365,2018-08-22,21:00:00,48,8,40,FMN GV 05 Lier
60,Mechelsesteenweg 365,2018-08-22,22:00:00,22,12,10,FMN GV 05 Lier
60,Mechelsesteenweg 365,2018-08-22,23:00:00,0,0,0,FMN GV 05 Lier
60,Mechelsesteenweg 365,2018-08-23,00:00:00,0,0,0,FMN GV 05 Lier
60,Mechelsesteenweg 365,2018-08-23,01:00:00,0,0,0,FMN GV 05 Lier
60,Mechelsesteenweg 365,2018-08-23,02:00:00,0,0,0,FMN GV 05 Lier
60,Mechelsesteenweg 365,2018-08-23,03:00:00,0,0,0,FMN GV 05 Lier
60,Mechelsesteenweg 365,2018-08-23,04:00:00,0,0,0,FMN GV 05 Lier
60,Mechelsesteenweg 365,2018-08-23,05:00:00,4,0,4,FMN GV 05 Lier
60,Mechelsesteenweg 365,2018-08-23,06:00:00,34,8,26,FMN GV 05 Lier
60,Mechelsesteenweg 365,2018-08-23,07:00:00,82,22,60,FMN GV 05 Lier
60,Mechelsesteenweg 365,2018-08-23,08:00:00,76,30,46,FMN GV 05 Lier
60,Mechelsesteenweg 365,2018-08-23,09:00:00,68,38,30,FMN GV 05 Lier
60,Mechelsesteenweg 365,2018-08-23,10:00:00,128,40,88,FMN GV 05 Lier
60,Mechelsesteenweg 365,2018-08-23,11:00:00,118,34,84,FMN GV 05 Lier
60,Mechelsesteenweg 365,2018-08-23,12:00:00,100,56,44,FMN GV 05 Lier
60,Mechelsesteenweg 365,2018-08-23,13:00:00,112,40,72,FMN GV 05 Lier
60,Mechelsesteenweg 365,2018-08-23,14:00:00,178,64,114,FMN GV 05 Lier
60,Mechelsesteenweg 365,2018-08-23,15:00:00,136,54,82,FMN GV 05 Lier
60,Mechelsesteenweg 365,2018-08-23,16:00:00,196,84,112,FMN GV 05 Lier
60,Mechelsesteenweg 365,2018-08-23,17:00:00,122,70,52,FMN GV 05 Lier
60,Mechelsesteenweg 365,2018-08-23,18:00:00,100,74,26,FMN GV 05 Lier
60,Mechelsesteenweg 365,2018-08-23,19:00:00,82,58,24,FMN GV 05 Lier
60,Mechelsesteenweg 365,2018-08-23,20:00:00,94,46,48,FMN GV 05 Lier
60,Mechelsesteenweg 365,2018-08-23,21:00:00,28,8,20,FMN GV 05 Lier
60,Mechelsesteenweg 365,2018-08-23,22:00:00,22,4,18,FMN GV 05 Lier
60,Mechelsesteenweg 365,2018-08-23,23:00:00,26,4,22,FMN GV 05 Lier
60,Mechelsesteenweg 365,2018-08-24,00:00:00,22,2,20,FMN GV 05 Lier
60,Mechelsesteenweg 365,2018-08-24,01:00:00,2,2,0,FMN GV 05 Lier
60,Mechelsesteenweg 365,2018-08-24,02:00:00,4,2,2,FMN GV 05 Lier
60,Mechelsesteenweg 365,2018-08-24,03:00:00,0,0,0,FMN GV 05 Lier
60,Mechelsesteenweg 365,2018-08-24,04:00:00,2,0,2,FMN GV 05 Lier
60,Mechelsesteenweg 365,2018-08-24,05:00:00,6,0,6,FMN GV 05 Lier
60,Mechelsesteenweg 365,2018-08-24,06:00:00,30,10,20,FMN GV 05 Lier
60,Mechelsesteenweg 365,2018-08-24,07:00:00,46,14,32,FMN GV 05 Lier
60,Mechelsesteenweg 365,2018-08-24,08:00:00,36,14,22,FMN GV 05 Lier
60,Mechelsesteenweg 365,2018-08-24,09:00:00,36,18,18,FMN GV 05 Lier
60,Mechelsesteenweg 365,2018-08-24,10:00:00,46,26,20,FMN GV 05 Lier
60,Mechelsesteenweg 365,2018-08-24,11:00:00,128,52,76,FMN GV 05 Lier
60,Mechelsesteenweg 365,2018-08-24,12:00:00,86,62,24,FMN GV 05 Lier
60,Mechelsesteenweg 365,2018-08-24,13:00:00,104,28,76,FMN GV 05 Lier
60,Mechelsesteenweg 365,2018-08-24,14:00:00,130,56,74,FMN GV 05 Lier
60,Mechelsesteenweg 365,2018-08-24,15:00:00,90,46,44,FMN GV 05 Lier
60,Mechelsesteenweg 365,2018-08-24,16:00:00,152,58,94,FMN GV 05 Lier
60,Mechelsesteenweg 365,2018-08-24,17:00:00,128,70,58,FMN GV 05 Lier
60,Mechelsesteenweg 365,2018-08-24,18:00:00,60,32,28,FMN GV 05 Lier
60,Mechelsesteenweg 365,2018-08-24,19:00:00,46,22,24,FMN GV 05 Lier
60,Mechelsesteenweg 365,2018-08-24,20:00:00,32,20,12,FMN GV 05 Lier
60,Mechelsesteenweg 365,2018-08-24,21:00:00,10,6,4,FMN GV 05 Lier
60,Mechelsesteenweg 365,2018-08-24,22:00:00,30,12,18,FMN GV 05 Lier
60,Mechelsesteenweg 365,2018-08-24,23:00:00,0,0,0,FMN GV 05 Lier
60,Mechelsesteenweg 365,2018-08-25,00:00:00,2,2,0,FMN GV 05 Lier
60,Mechelsesteenweg 365,2018-08-25,01:00:00,6,4,2,FMN GV 05 Lier
60,Mechelsesteenweg 365,2018-08-25,02:00:00,0,0,0,FMN GV 05 Lier
60,Mechelsesteenweg 365,2018-08-25,03:00:00,4,4,0,FMN GV 05 Lier
60,Mechelsesteenweg 365,2018-08-25,04:00:00,0,0,0,FMN GV 05 Lier
60,Mechelsesteenweg 365,2018-08-25,05:00:00,0,0,0,FMN GV 05 Lier
60,Mechelsesteenweg 365,2018-08-25,06:00:00,6,6,0,FMN GV 05 Lier
60,Mechelsesteenweg 365,2018-08-25,07:00:00,12,4,8,FMN GV 05 Lier
60,Mechelsesteenweg 365,2018-08-25,08:00:00,60,46,14,FMN GV 05 Lier
60,Mechelsesteenweg 365,2018-08-25,09:00:00,22,10,12,FMN GV 05 Lier
60,Mechelsesteenweg 365,2018-08-25,10:00:00,68,32,36,FMN GV 05 Lier
60,Mechelsesteenweg 365,2018-08-25,11:00:00,52,16,36,FMN GV 05 Lier
60,Mechelsesteenweg 365,2018-08-25,12:00:00,76,34,42,FMN GV 05 Lier
60,Mechelsesteenweg 365,2018-08-25,13:00:00,56,18,38,FMN GV 05 Lier
60,Mechelsesteenweg 365,2018-08-25,14:00:00,74,30,44,FMN GV 05 Lier
60,Mechelsesteenweg 365,2018-08-25,15:00:00,80,58,22,FMN GV 05 Lier
60,Mechelsesteenweg 365,2018-08-25,16:00:00,78,34,44,FMN GV 05 Lier
60,Mechelsesteenweg 365,2018-08-25,17:00:00,54,24,30,FMN GV 05 Lier
60,Mechelsesteenweg 365,2018-08-25,18:00:00,34,18,16,FMN GV 05 Lier
60,Mechelsesteenweg 365,2018-08-25,19:00:00,14,12,2,FMN GV 05 Lier
60,Mechelsesteenweg 365,2018-08-25,20:00:00,20,8,12,FMN GV 05 Lier
60,Mechelsesteenweg 365,2018-08-25,21:00:00,8,2,6,FMN GV 05 Lier
60,Mechelsesteenweg 365,2018-08-25,22:00:00,0,0,0,FMN GV 05 Lier
60,Mechelsesteenweg 365,2018-08-25,23:00:00,0,0,0,FMN GV 05 Lier
60,Mechelsesteenweg 365,2018-08-26,00:00:00,4,0,4,FMN GV 05 Lier
60,Mechelsesteenweg 365,2018-08-26,01:00:00,4,4,0,FMN GV 05 Lier
60,Mechelsesteenweg 365,2018-08-26,02:00:00,4,4,0,FMN GV 05 Lier
60,Mechelsesteenweg 365,2018-08-26,03:00:00,0,0,0,FMN GV 05 Lier
60,Mechelsesteenweg 365,2018-08-26,04:00:00,0,0,0,FMN GV 05 Lier
60,Mechelsesteenweg 365,2018-08-26,05:00:00,0,0,0,FMN GV 05 Lier
60,Mechelsesteenweg 365,2018-08-26,06:00:00,2,2,0,FMN GV 05 Lier
60,Mechelsesteenweg 365,2018-08-26,07:00:00,20,12,8,FMN GV 05 Lier
60,Mechelsesteenweg 365,2018-08-26,08:00:00,44,34,10,FMN GV 05 Lier
60,Mechelsesteenweg 365,2018-08-26,09:00:00,166,92,74,FMN GV 05 Lier
60,Mechelsesteenweg 365,2018-08-26,10:00:00,378,190,188,FMN GV 05 Lier
60,Mechelsesteenweg 365,2018-08-26,11:00:00,368,158,210,FMN GV 05 Lier
60,Mechelsesteenweg 365,2018-08-26,12:00:00,288,140,148,FMN GV 05 Lier
60,Mechelsesteenweg 365,2018-08-26,13:00:00,224,96,128,FMN GV 05 Lier
60,Mechelsesteenweg 365,2018-08-26,14:00:00,234,120,114,FMN GV 05 Lier
60,Mechelsesteenweg 365,2018-08-26,15:00:00,330,106,224,FMN GV 05 Lier
60,Mechelsesteenweg 365,2018-08-26,16:00:00,144,62,82,FMN GV 05 Lier
60,Mechelsesteenweg 365,2018-08-26,17:00:00,46,12,34,FMN GV 05 Lier
60,Mechelsesteenweg 365,2018-08-26,18:00:00,24,16,8,FMN GV 05 Lier
60,Mechelsesteenweg 365,2018-08-26,19:00:00,30,8,22,FMN GV 05 Lier
60,Mechelsesteenweg 365,2018-08-26,20:00:00,10,4,6,FMN GV 05 Lier
60,Mechelsesteenweg 365,2018-08-26,21:00:00,4,2,2,FMN GV 05 Lier
60,Mechelsesteenweg 365,2018-08-26,22:00:00,0,0,0,FMN GV 05 Lier
60,Mechelsesteenweg 365,2018-08-26,23:00:00,6,4,2,FMN GV 05 Lier
60,Mechelsesteenweg 365,2018-08-27,00:00:00,2,2,0,FMN GV 05 Lier
60,Mechelsesteenweg 365,2018-08-27,01:00:00,4,4,0,FMN GV 05 Lier
60,Mechelsesteenweg 365,2018-08-27,02:00:00,0,0,0,FMN GV 05 Lier
60,Mechelsesteenweg 365,2018-08-27,03:00:00,4,0,4,FMN GV 05 Lier
60,Mechelsesteenweg 365,2018-08-27,04:00:00,0,0,0,FMN GV 05 Lier
60,Mechelsesteenweg 365,2018-08-27,05:00:00,10,2,8,FMN GV 05 Lier
60,Mechelsesteenweg 365,2018-08-27,06:00:00,10,2,8,FMN GV 05 Lier
60,Mechelsesteenweg 365,2018-08-27,07:00:00,72,28,44,FMN GV 05 Lier
60,Mechelsesteenweg 365,2018-08-27,08:00:00,36,16,20,FMN GV 05 Lier
60,Mechelsesteenweg 365,2018-08-27,09:00:00,38,20,18,FMN GV 05 Lier
60,Mechelsesteenweg 365,2018-08-27,10:00:00,60,42,18,FMN GV 05 Lier
60,Mechelsesteenweg 365,2018-08-27,11:00:00,52,24,28,FMN GV 05 Lier
60,Mechelsesteenweg 365,2018-08-27,12:00:00,16,10,6,FMN GV 05 Lier
60,Mechelsesteenweg 365,2018-08-27,13:00:00,38,20,18,FMN GV 05 Lier
60,Mechelsesteenweg 365,2018-08-27,14:00:00,78,32,46,FMN GV 05 Lier
60,Mechelsesteenweg 365,2018-08-27,15:00:00,60,32,28,FMN GV 05 Lier
60,Mechelsesteenweg 365,2018-08-27,16:00:00,76,34,42,FMN GV 05 Lier
60,Mechelsesteenweg 365,2018-08-27,17:00:00,94,52,42,FMN GV 05 Lier
60,Mechelsesteenweg 365,2018-08-27,18:00:00,64,42,22,FMN GV 05 Lier
60,Mechelsesteenweg 365,2018-08-27,19:00:00,24,12,12,FMN GV 05 Lier
60,Mechelsesteenweg 365,2018-08-27,20:00:00,32,14,18,FMN GV 05 Lier
60,Mechelsesteenweg 365,2018-08-27,21:00:00,2,0,2,FMN GV 05 Lier
60,Mechelsesteenweg 365,2018-08-27,22:00:00,0,0,0,FMN GV 05 Lier
60,Mechelsesteenweg 365,2018-08-27,23:00:00,2,2,0,FMN GV 05 Lier
60,Mechelsesteenweg 365,2018-08-28,00:00:00,0,0,0,FMN GV 05 Lier
60,Mechelsesteenweg 365,2018-08-28,01:00:00,0,0,0,FMN GV 05 Lier
60,Mechelsesteenweg 365,2018-08-28,02:00:00,0,0,0,FMN GV 05 Lier
60,Mechelsesteenweg 365,2018-08-28,03:00:00,2,0,2,FMN GV 05 Lier
60,Mechelsesteenweg 365,2018-08-28,04:00:00,2,0,2,FMN GV 05 Lier
60,Mechelsesteenweg 365,2018-08-28,05:00:00,6,2,4,FMN GV 05 Lier
60,Mechelsesteenweg 365,2018-08-28,06:00:00,30,10,20,FMN GV 05 Lier
60,Mechelsesteenweg 365,2018-08-28,07:00:00,86,34,52,FMN GV 05 Lier
60,Mechelsesteenweg 365,2018-08-28,08:00:00,84,24,60,FMN GV 05 Lier
60,Mechelsesteenweg 365,2018-08-28,09:00:00,136,44,92,FMN GV 05 Lier
60,Mechelsesteenweg 365,2018-08-28,10:00:00,142,72,70,FMN GV 05 Lier
60,Mechelsesteenweg 365,2018-08-28,11:00:00,158,72,86,FMN GV 05 Lier
60,Mechelsesteenweg 365,2018-08-28,12:00:00,112,52,60,FMN GV 05 Lier
60,Mechelsesteenweg 365,2018-08-28,13:00:00,160,70,90,FMN GV 05 Lier
60,Mechelsesteenweg 365,2018-08-28,14:00:00,218,102,116,FMN GV 05 Lier
60,Mechelsesteenweg 365,2018-08-28,15:00:00,212,134,78,FMN GV 05 Lier
60,Mechelsesteenweg 365,2018-08-28,16:00:00,222,116,106,FMN GV 05 Lier
60,Mechelsesteenweg 365,2018-08-28,17:00:00,230,106,124,FMN GV 05 Lier
60,Mechelsesteenweg 365,2018-08-28,18:00:00,164,78,86,FMN GV 05 Lier
60,Mechelsesteenweg 365,2018-08-28,19:00:00,226,120,106,FMN GV 05 Lier
60,Mechelsesteenweg 365,2018-08-28,20:00:00,96,44,52,FMN GV 05 Lier
60,Mechelsesteenweg 365,2018-08-28,21:00:00,8,2,6,FMN GV 05 Lier
60,Mechelsesteenweg 365,2018-08-28,22:00:00,8,8,0,FMN GV 05 Lier
60,Mechelsesteenweg 365,2018-08-28,23:00:00,0,0,0,FMN GV 05 Lier
60,Mechelsesteenweg 365,2018-08-29,00:00:00,2,0,2,FMN GV 05 Lier
60,Mechelsesteenweg 365,2018-08-29,01:00:00,2,0,2,FMN GV 05 Lier
60,Mechelsesteenweg 365,2018-08-29,02:00:00,0,0,0,FMN GV 05 Lier
60,Mechelsesteenweg 365,2018-08-29,03:00:00,6,2,4,FMN GV 05 Lier
60,Mechelsesteenweg 365,2018-08-29,04:00:00,0,0,0,FMN GV 05 Lier
60,Mechelsesteenweg 365,2018-08-29,05:00:00,6,0,6,FMN GV 05 Lier
60,Mechelsesteenweg 365,2018-08-29,06:00:00,22,10,12,FMN GV 05 Lier
60,Mechelsesteenweg 365,2018-08-29,07:00:00,82,34,48,FMN GV 05 Lier
60,Mechelsesteenweg 365,2018-08-29,08:00:00,56,22,34,FMN GV 05 Lier
60,Mechelsesteenweg 365,2018-08-29,09:00:00,38,16,22,FMN GV 05 Lier
60,Mechelsesteenweg 365,2018-08-29,10:00:00,36,14,22,FMN GV 05 Lier
60,Mechelsesteenweg 365,2018-08-29,11:00:00,30,16,14,FMN GV 05 Lier
60,Mechelsesteenweg 365,2018-08-29,12:00:00,16,4,12,FMN GV 05 Lier
60,Mechelsesteenweg 365,2018-08-29,13:00:00,34,18,16,FMN GV 05 Lier
60,Mechelsesteenweg 365,2018-08-29,14:00:00,42,26,16,FMN GV 05 Lier
60,Mechelsesteenweg 365,2018-08-29,15:00:00,62,34,28,FMN GV 05 Lier
60,Mechelsesteenweg 365,2018-08-29,16:00:00,46,20,26,FMN GV 05 Lier
60,Mechelsesteenweg 365,2018-08-29,17:00:00,84,50,34,FMN GV 05 Lier
60,Mechelsesteenweg 365,2018-08-29,18:00:00,34,12,22,FMN GV 05 Lier
60,Mechelsesteenweg 365,2018-08-29,19:00:00,30,28,2,FMN GV 05 Lier
60,Mechelsesteenweg 365,2018-08-29,20:00:00,40,26,14,FMN GV 05 Lier
60,Mechelsesteenweg 365,2018-08-29,21:00:00,8,0,8,FMN GV 05 Lier
60,Mechelsesteenweg 365,2018-08-29,22:00:00,6,2,4,FMN GV 05 Lier
60,Mechelsesteenweg 365,2018-08-29,23:00:00,0,0,0,FMN GV 05 Lier
60,Mechelsesteenweg 365,2018-08-30,00:00:00,0,0,0,FMN GV 05 Lier
60,Mechelsesteenweg 365,2018-08-30,01:00:00,0,0,0,FMN GV 05 Lier
60,Mechelsesteenweg 365,2018-08-30,02:00:00,0,0,0,FMN GV 05 Lier
60,Mechelsesteenweg 365,2018-08-30,03:00:00,2,0,2,FMN GV 05 Lier
60,Mechelsesteenweg 365,2018-08-30,04:00:00,2,0,2,FMN GV 05 Lier
60,Mechelsesteenweg 365,2018-08-30,05:00:00,6,2,4,FMN GV 05 Lier
60,Mechelsesteenweg 365,2018-08-30,06:00:00,16,10,6,FMN GV 05 Lier
60,Mechelsesteenweg 365,2018-08-30,07:00:00,94,36,58,FMN GV 05 Lier
60,Mechelsesteenweg 365,2018-08-30,08:00:00,84,24,60,FMN GV 05 Lier
60,Mechelsesteenweg 365,2018-08-30,09:00:00,58,32,26,FMN GV 05 Lier
60,Mechelsesteenweg 365,2018-08-30,10:00:00,122,42,80,FMN GV 05 Lier
60,Mechelsesteenweg 365,2018-08-30,11:00:00,80,30,50,FMN GV 05 Lier
60,Mechelsesteenweg 365,2018-08-30,12:00:00,106,42,64,FMN GV 05 Lier
60,Mechelsesteenweg 365,2018-08-30,13:00:00,184,110,74,FMN GV 05 Lier
60,Mechelsesteenweg 365,2018-08-30,14:00:00,180,52,128,FMN GV 05 Lier
60,Mechelsesteenweg 365,2018-08-30,15:00:00,200,102,98,FMN GV 05 Lier
60,Mechelsesteenweg 365,2018-08-30,16:00:00,138,64,74,FMN GV 05 Lier
60,Mechelsesteenweg 365,2018-08-30,17:00:00,176,110,66,FMN GV 05 Lier
60,Mechelsesteenweg 365,2018-08-30,18:00:00,104,50,54,FMN GV 05 Lier
60,Mechelsesteenweg 365,2018-08-30,19:00:00,130,62,68,FMN GV 05 Lier
60,Mechelsesteenweg 365,2018-08-30,20:00:00,112,38,74,FMN GV 05 Lier
60,Mechelsesteenweg 365,2018-08-30,21:00:00,20,6,14,FMN GV 05 Lier
60,Mechelsesteenweg 365,2018-08-30,22:00:00,10,6,4,FMN GV 05 Lier
60,Mechelsesteenweg 365,2018-08-30,23:00:00,2,0,2,FMN GV 05 Lier
60,Mechelsesteenweg 365,2018-08-31,00:00:00,2,2,0,FMN GV 05 Lier
60,Mechelsesteenweg 365,2018-08-31,01:00:00,2,0,2,FMN GV 05 Lier
60,Mechelsesteenweg 365,2018-08-31,02:00:00,0,0,0,FMN GV 05 Lier
60,Mechelsesteenweg 365,2018-08-31,03:00:00,4,0,4,FMN GV 05 Lier
60,Mechelsesteenweg 365,2018-08-31,04:00:00,2,0,2,FMN GV 05 Lier
60,Mechelsesteenweg 365,2018-08-31,05:00:00,10,6,4,FMN GV 05 Lier
60,Mechelsesteenweg 365,2018-08-31,06:00:00,30,4,26,FMN GV 05 Lier
60,Mechelsesteenweg 365,2018-08-31,07:00:00,86,36,50,FMN GV 05 Lier
60,Mechelsesteenweg 365,2018-08-31,08:00:00,82,40,42,FMN GV 05 Lier
60,Mechelsesteenweg 365,2018-08-31,09:00:00,34,12,22,FMN GV 05 Lier
60,Mechelsesteenweg 365,2018-08-31,10:00:00,120,50,70,FMN GV 05 Lier
60,Mechelsesteenweg 365,2018-08-31,11:00:00,102,38,64,FMN GV 05 Lier
60,Mechelsesteenweg 365,2018-08-31,12:00:00,86,32,54,FMN GV 05 Lier
60,Mechelsesteenweg 365,2018-08-31,13:00:00,118,70,48,FMN GV 05 Lier
60,Mechelsesteenweg 365,2018-08-31,14:00:00,250,160,90,FMN GV 05 Lier
60,Mechelsesteenweg 365,2018-08-31,15:00:00,166,68,98,FMN GV 05 Lier
60,Mechelsesteenweg 365,2018-08-31,16:00:00,184,90,94,FMN GV 05 Lier
60,Mechelsesteenweg 365,2018-08-31,17:00:00,150,68,82,FMN GV 05 Lier
60,Mechelsesteenweg 365,2018-08-31,18:00:00,80,36,44,FMN GV 05 Lier
60,Mechelsesteenweg 365,2018-08-31,19:00:00,68,34,34,FMN GV 05 Lier
60,Mechelsesteenweg 365,2018-08-31,20:00:00,30,12,18,FMN GV 05 Lier
60,Mechelsesteenweg 365,2018-08-31,21:00:00,10,4,6,FMN GV 05 Lier
60,Mechelsesteenweg 365,2018-08-31,22:00:00,6,2,4,FMN GV 05 Lier
60,Mechelsesteenweg 365,2018-08-31,23:00:00,0,0,0,FMN GV 05 Lier
60,Mechelsesteenweg 365,2018-09-01,00:00:00,0,0,0,FMN GV 05 Lier
60,Mechelsesteenweg 365,2018-09-01,01:00:00,2,2,0,FMN GV 05 Lier
60,Mechelsesteenweg 365,2018-09-01,02:00:00,0,0,0,FMN GV 05 Lier
60,Mechelsesteenweg 365,2018-09-01,03:00:00,0,0,0,FMN GV 05 Lier
60,Mechelsesteenweg 365,2018-09-01,04:00:00,10,6,4,FMN GV 05 Lier
60,Mechelsesteenweg 365,2018-09-01,05:00:00,4,0,4,FMN GV 05 Lier
60,Mechelsesteenweg 365,2018-09-01,06:00:00,4,2,2,FMN GV 05 Lier
60,Mechelsesteenweg 365,2018-09-01,07:00:00,18,10,8,FMN GV 05 Lier
60,Mechelsesteenweg 365,2018-09-01,08:00:00,40,24,16,FMN GV 05 Lier
60,Mechelsesteenweg 365,2018-09-01,09:00:00,114,58,56,FMN GV 05 Lier
60,Mechelsesteenweg 365,2018-09-01,10:00:00,188,96,92,FMN GV 05 Lier
60,Mechelsesteenweg 365,2018-09-01,11:00:00,192,72,120,FMN GV 05 Lier
60,Mechelsesteenweg 365,2018-09-01,12:00:00,164,50,114,FMN GV 05 Lier
60,Mechelsesteenweg 365,2018-09-01,13:00:00,184,70,114,FMN GV 05 Lier
60,Mechelsesteenweg 365,2018-09-01,14:00:00,398,148,250,FMN GV 05 Lier
60,Mechelsesteenweg 365,2018-09-01,15:00:00,226,100,126,FMN GV 05 Lier
60,Mechelsesteenweg 365,2018-09-01,16:00:00,210,66,144,FMN GV 05 Lier
60,Mechelsesteenweg 365,2018-09-01,17:00:00,122,56,66,FMN GV 05 Lier
60,Mechelsesteenweg 365,2018-09-01,18:00:00,72,26,46,FMN GV 05 Lier
60,Mechelsesteenweg 365,2018-09-01,19:00:00,60,24,36,FMN GV 05 Lier
60,Mechelsesteenweg 365,2018-09-01,20:00:00,26,12,14,FMN GV 05 Lier
60,Mechelsesteenweg 365,2018-09-01,21:00:00,12,8,4,FMN GV 05 Lier
60,Mechelsesteenweg 365,2018-09-01,22:00:00,0,0,0,FMN GV 05 Lier
60,Mechelsesteenweg 365,2018-09-01,23:00:00,4,0,4,FMN GV 05 Lier
60,Mechelsesteenweg 365,2018-09-02,00:00:00,0,0,0,FMN GV 05 Lier
60,Mechelsesteenweg 365,2018-09-02,01:00:00,0,0,0,FMN GV 05 Lier
60,Mechelsesteenweg 365,2018-09-02,02:00:00,0,0,0,FMN GV 05 Lier
60,Mechelsesteenweg 365,2018-09-02,03:00:00,0,0,0,FMN GV 05 Lier
60,Mechelsesteenweg 365,2018-09-02,04:00:00,0,0,0,FMN GV 05 Lier
60,Mechelsesteenweg 365,2018-09-02,05:00:00,0,0,0,FMN GV 05 Lier
60,Mechelsesteenweg 365,2018-09-02,06:00:00,2,0,2,FMN GV 05 Lier
60,Mechelsesteenweg 365,2018-09-02,07:00:00,16,8,8,FMN GV 05 Lier
60,Mechelsesteenweg 365,2018-09-02,08:00:00,52,24,28,FMN GV 05 Lier
60,Mechelsesteenweg 365,2018-09-02,09:00:00,276,190,86,FMN GV 05 Lier
60,Mechelsesteenweg 365,2018-09-02,10:00:00,344,144,200,FMN GV 05 Lier
60,Mechelsesteenweg 365,2018-09-02,11:00:00,392,156,236,FMN GV 05 Lier
60,Mechelsesteenweg 365,2018-09-02,12:00:00,312,162,150,FMN GV 05 Lier
60,Mechelsesteenweg 365,2018-09-02,13:00:00,340,150,190,FMN GV 05 Lier
60,Mechelsesteenweg 365,2018-09-02,14:00:00,562,272,290,FMN GV 05 Lier
60,Mechelsesteenweg 365,2018-09-02,15:00:00,474,206,268,FMN GV 05 Lier
60,Mechelsesteenweg 365,2018-09-02,16:00:00,348,124,224,FMN GV 05 Lier
60,Mechelsesteenweg 365,2018-09-02,17:00:00,266,80,186,FMN GV 05 Lier
60,Mechelsesteenweg 365,2018-09-02,18:00:00,154,62,92,FMN GV 05 Lier
60,Mechelsesteenweg 365,2018-09-02,19:00:00,70,40,30,FMN GV 05 Lier
60,Mechelsesteenweg 365,2018-09-02,20:00:00,36,16,20,FMN GV 05 Lier
60,Mechelsesteenweg 365,2018-09-02,21:00:00,14,2,12,FMN GV 05 Lier
60,Mechelsesteenweg 365,2018-09-02,22:00:00,2,0,2,FMN GV 05 Lier
60,Mechelsesteenweg 365,2018-09-02,23:00:00,0,0,0,FMN GV 05 Lier
60,Mechelsesteenweg 365,2018-09-03,00:00:00,0,0,0,FMN GV 05 Lier
60,Mechelsesteenweg 365,2018-09-03,01:00:00,0,0,0,FMN GV 05 Lier
60,Mechelsesteenweg 365,2018-09-03,02:00:00,0,0,0,FMN GV 05 Lier
60,Mechelsesteenweg 365,2018-09-03,03:00:00,2,0,2,FMN GV 05 Lier
60,Mechelsesteenweg 365,2018-09-03,04:00:00,0,0,0,FMN GV 05 Lier
60,Mechelsesteenweg 365,2018-09-03,05:00:00,4,4,0,FMN GV 05 Lier
60,Mechelsesteenweg 365,2018-09-03,06:00:00,26,8,18,FMN GV 05 Lier
60,Mechelsesteenweg 365,2018-09-03,07:00:00,170,90,80,FMN GV 05 Lier
60,Mechelsesteenweg 365,2018-09-03,08:00:00,184,114,70,FMN GV 05 Lier
60,Mechelsesteenweg 365,2018-09-03,09:00:00,106,66,40,FMN GV 05 Lier
60,Mechelsesteenweg 365,2018-09-03,10:00:00,68,46,22,FMN GV 05 Lier
60,Mechelsesteenweg 365,2018-09-03,11:00:00,82,26,56,FMN GV 05 Lier
60,Mechelsesteenweg 365,2018-09-03,12:00:00,186,64,122,FMN GV 05 Lier
60,Mechelsesteenweg 365,2018-09-03,13:00:00,88,42,46,FMN GV 05 Lier
60,Mechelsesteenweg 365,2018-09-03,14:00:00,116,62,54,FMN GV 05 Lier
60,Mechelsesteenweg 365,2018-09-03,15:00:00,210,70,140,FMN GV 05 Lier
60,Mechelsesteenweg 365,2018-09-03,16:00:00,122,52,70,FMN GV 05 Lier
60,Mechelsesteenweg 365,2018-09-03,17:00:00,128,78,50,FMN GV 05 Lier
60,Mechelsesteenweg 365,2018-09-03,18:00:00,80,40,40,FMN GV 05 Lier
60,Mechelsesteenweg 365,2018-09-03,19:00:00,50,20,30,FMN GV 05 Lier
60,Mechelsesteenweg 365,2018-09-03,20:00:00,16,8,8,FMN GV 05 Lier
60,Mechelsesteenweg 365,2018-09-03,21:00:00,18,6,12,FMN GV 05 Lier
60,Mechelsesteenweg 365,2018-09-03,22:00:00,6,4,2,FMN GV 05 Lier
60,Mechelsesteenweg 365,2018-09-03,23:00:00,0,0,0,FMN GV 05 Lier
60,Mechelsesteenweg 365,2018-09-04,00:00:00,0,0,0,FMN GV 05 Lier
60,Mechelsesteenweg 365,2018-09-04,01:00:00,0,0,0,FMN GV 05 Lier
60,Mechelsesteenweg 365,2018-09-04,02:00:00,0,0,0,FMN GV 05 Lier
60,Mechelsesteenweg 365,2018-09-04,03:00:00,0,0,0,FMN GV 05 Lier
60,Mechelsesteenweg 365,2018-09-04,04:00:00,2,0,2,FMN GV 05 Lier
60,Mechelsesteenweg 365,2018-09-04,05:00:00,6,2,4,FMN GV 05 Lier
60,Mechelsesteenweg 365,2018-09-04,06:00:00,20,4,16,FMN GV 05 Lier
60,Mechelsesteenweg 365,2018-09-04,07:00:00,238,136,102,FMN GV 05 Lier
60,Mechelsesteenweg 365,2018-09-04,08:00:00,148,86,62,FMN GV 05 Lier
60,Mechelsesteenweg 365,2018-09-04,09:00:00,56,32,24,FMN GV 05 Lier
60,Mechelsesteenweg 365,2018-09-04,10:00:00,104,64,40,FMN GV 05 Lier
60,Mechelsesteenweg 365,2018-09-04,11:00:00,66,22,44,FMN GV 05 Lier
60,Mechelsesteenweg 365,2018-09-04,12:00:00,68,32,36,FMN GV 05 Lier
60,Mechelsesteenweg 365,2018-09-04,13:00:00,86,30,56,FMN GV 05 Lier
60,Mechelsesteenweg 365,2018-09-04,14:00:00,170,98,72,FMN GV 05 Lier
60,Mechelsesteenweg 365,2018-09-04,15:00:00,184,104,80,FMN GV 05 Lier
60,Mechelsesteenweg 365,2018-09-04,16:00:00,318,108,210,FMN GV 05 Lier
60,Mechelsesteenweg 365,2018-09-04,17:00:00,162,86,76,FMN GV 05 Lier
60,Mechelsesteenweg 365,2018-09-04,18:00:00,110,38,72,FMN GV 05 Lier
60,Mechelsesteenweg 365,2018-09-04,19:00:00,86,56,30,FMN GV 05 Lier
60,Mechelsesteenweg 365,2018-09-04,20:00:00,50,28,22,FMN GV 05 Lier
60,Mechelsesteenweg 365,2018-09-04,21:00:00,10,4,6,FMN GV 05 Lier
60,Mechelsesteenweg 365,2018-09-04,22:00:00,6,0,6,FMN GV 05 Lier
60,Mechelsesteenweg 365,2018-09-04,23:00:00,2,2,0,FMN GV 05 Lier
60,Mechelsesteenweg 365,2018-09-05,00:00:00,0,0,0,FMN GV 05 Lier
60,Mechelsesteenweg 365,2018-09-05,01:00:00,0,0,0,FMN GV 05 Lier
60,Mechelsesteenweg 365,2018-09-05,02:00:00,0,0,0,FMN GV 05 Lier
60,Mechelsesteenweg 365,2018-09-05,03:00:00,0,0,0,FMN GV 05 Lier
60,Mechelsesteenweg 365,2018-09-05,04:00:00,2,0,2,FMN GV 05 Lier
60,Mechelsesteenweg 365,2018-09-05,05:00:00,6,2,4,FMN GV 05 Lier
60,Mechelsesteenweg 365,2018-09-05,06:00:00,14,2,12,FMN GV 05 Lier
60,Mechelsesteenweg 365,2018-09-05,07:00:00,182,124,58,FMN GV 05 Lier
60,Mechelsesteenweg 365,2018-09-05,08:00:00,166,84,82,FMN GV 05 Lier
60,Mechelsesteenweg 365,2018-09-05,09:00:00,160,42,118,FMN GV 05 Lier
60,Mechelsesteenweg 365,2018-09-05,10:00:00,60,28,32,FMN GV 05 Lier
60,Mechelsesteenweg 365,2018-09-05,11:00:00,82,30,52,FMN GV 05 Lier
60,Mechelsesteenweg 365,2018-09-05,12:00:00,308,122,186,FMN GV 05 Lier
60,Mechelsesteenweg 365,2018-09-05,13:00:00,78,38,40,FMN GV 05 Lier
60,Mechelsesteenweg 365,2018-09-05,14:00:00,126,64,62,FMN GV 05 Lier
60,Mechelsesteenweg 365,2018-09-05,15:00:00,116,42,74,FMN GV 05 Lier
60,Mechelsesteenweg 365,2018-09-05,16:00:00,138,62,76,FMN GV 05 Lier
60,Mechelsesteenweg 365,2018-09-05,17:00:00,134,68,66,FMN GV 05 Lier
60,Mechelsesteenweg 365,2018-09-05,18:00:00,92,64,28,FMN GV 05 Lier
60,Mechelsesteenweg 365,2018-09-05,19:00:00,158,74,84,FMN GV 05 Lier
60,Mechelsesteenweg 365,2018-09-05,20:00:00,66,46,20,FMN GV 05 Lier
60,Mechelsesteenweg 365,2018-09-05,21:00:00,4,2,2,FMN GV 05 Lier
60,Mechelsesteenweg 365,2018-09-05,22:00:00,4,2,2,FMN GV 05 Lier
60,Mechelsesteenweg 365,2018-09-05,23:00:00,0,0,0,FMN GV 05 Lier
60,Mechelsesteenweg 365,2018-09-06,00:00:00,4,2,2,FMN GV 05 Lier
60,Mechelsesteenweg 365,2018-09-06,01:00:00,0,0,0,FMN GV 05 Lier
60,Mechelsesteenweg 365,2018-09-06,02:00:00,0,0,0,FMN GV 05 Lier
60,Mechelsesteenweg 365,2018-09-06,03:00:00,0,0,0,FMN GV 05 Lier
60,Mechelsesteenweg 365,2018-09-06,04:00:00,2,0,2,FMN GV 05 Lier
60,Mechelsesteenweg 365,2018-09-06,05:00:00,8,4,4,FMN GV 05 Lier
60,Mechelsesteenweg 365,2018-09-06,06:00:00,10,0,10,FMN GV 05 Lier
60,Mechelsesteenweg 365,2018-09-06,07:00:00,190,124,66,FMN GV 05 Lier
60,Mechelsesteenweg 365,2018-09-06,08:00:00,138,88,50,FMN GV 05 Lier
60,Mechelsesteenweg 365,2018-09-06,09:00:00,28,10,18,FMN GV 05 Lier
60,Mechelsesteenweg 365,2018-09-06,10:00:00,126,50,76,FMN GV 05 Lier
60,Mechelsesteenweg 365,2018-09-06,11:00:00,100,88,12,FMN GV 05 Lier
60,Mechelsesteenweg 365,2018-09-06,12:00:00,64,26,38,FMN GV 05 Lier
60,Mechelsesteenweg 365,2018-09-06,13:00:00,108,54,54,FMN GV 05 Lier
60,Mechelsesteenweg 365,2018-09-06,14:00:00,80,44,36,FMN GV 05 Lier
60,Mechelsesteenweg 365,2018-09-06,15:00:00,146,72,74,FMN GV 05 Lier
60,Mechelsesteenweg 365,2018-09-06,16:00:00,290,118,172,FMN GV 05 Lier
60,Mechelsesteenweg 365,2018-09-06,17:00:00,102,44,58,FMN GV 05 Lier
60,Mechelsesteenweg 365,2018-09-06,18:00:00,72,44,28,FMN GV 05 Lier
60,Mechelsesteenweg 365,2018-09-06,19:00:00,54,26,28,FMN GV 05 Lier
60,Mechelsesteenweg 365,2018-09-06,20:00:00,72,32,40,FMN GV 05 Lier
60,Mechelsesteenweg 365,2018-09-06,21:00:00,2,2,0,FMN GV 05 Lier
60,Mechelsesteenweg 365,2018-09-06,22:00:00,6,2,4,FMN GV 05 Lier
60,Mechelsesteenweg 365,2018-09-06,23:00:00,4,2,2,FMN GV 05 Lier
60,Mechelsesteenweg 365,2018-09-07,00:00:00,2,0,2,FMN GV 05 Lier
60,Mechelsesteenweg 365,2018-09-07,01:00:00,0,0,0,FMN GV 05 Lier
60,Mechelsesteenweg 365,2018-09-07,02:00:00,0,0,0,FMN GV 05 Lier
60,Mechelsesteenweg 365,2018-09-07,03:00:00,0,0,0,FMN GV 05 Lier
60,Mechelsesteenweg 365,2018-09-07,04:00:00,4,2,2,FMN GV 05 Lier
60,Mechelsesteenweg 365,2018-09-07,05:00:00,0,0,0,FMN GV 05 Lier
60,Mechelsesteenweg 365,2018-09-07,06:00:00,12,4,8,FMN GV 05 Lier
60,Mechelsesteenweg 365,2018-09-07,07:00:00,148,92,56,FMN GV 05 Lier
60,Mechelsesteenweg 365,2018-09-07,08:00:00,112,78,34,FMN GV 05 Lier
60,Mechelsesteenweg 365,2018-09-07,09:00:00,240,36,204,FMN GV 05 Lier
60,Mechelsesteenweg 365,2018-09-07,10:00:00,58,16,42,FMN GV 05 Lier
60,Mechelsesteenweg 365,2018-09-07,11:00:00,42,28,14,FMN GV 05 Lier
60,Mechelsesteenweg 365,2018-09-07,12:00:00,50,26,24,FMN GV 05 Lier
60,Mechelsesteenweg 365,2018-09-07,13:00:00,76,50,26,FMN GV 05 Lier
60,Mechelsesteenweg 365,2018-09-07,14:00:00,70,38,32,FMN GV 05 Lier
60,Mechelsesteenweg 365,2018-09-07,15:00:00,140,68,72,FMN GV 05 Lier
60,Mechelsesteenweg 365,2018-09-07,16:00:00,362,190,172,FMN GV 05 Lier
60,Mechelsesteenweg 365,2018-09-07,17:00:00,108,68,40,FMN GV 05 Lier
60,Mechelsesteenweg 365,2018-09-07,18:00:00,54,30,24,FMN GV 05 Lier
60,Mechelsesteenweg 365,2018-09-07,19:00:00,40,22,18,FMN GV 05 Lier
60,Mechelsesteenweg 365,2018-09-07,20:00:00,22,10,12,FMN GV 05 Lier
60,Mechelsesteenweg 365,2018-09-07,21:00:00,8,2,6,FMN GV 05 Lier
60,Mechelsesteenweg 365,2018-09-07,22:00:00,14,2,12,FMN GV 05 Lier
60,Mechelsesteenweg 365,2018-09-07,23:00:00,0,0,0,FMN GV 05 Lier
60,Mechelsesteenweg 365,2018-09-08,00:00:00,10,2,8,FMN GV 05 Lier
60,Mechelsesteenweg 365,2018-09-08,01:00:00,10,10,0,FMN GV 05 Lier
60,Mechelsesteenweg 365,2018-09-08,02:00:00,2,2,0,FMN GV 05 Lier
60,Mechelsesteenweg 365,2018-09-08,03:00:00,12,10,2,FMN GV 05 Lier
60,Mechelsesteenweg 365,2018-09-08,04:00:00,0,0,0,FMN GV 05 Lier
60,Mechelsesteenweg 365,2018-09-08,05:00:00,0,0,0,FMN GV 05 Lier
60,Mechelsesteenweg 365,2018-09-08,06:00:00,6,2,4,FMN GV 05 Lier
60,Mechelsesteenweg 365,2018-09-08,07:00:00,16,14,2,FMN GV 05 Lier
60,Mechelsesteenweg 365,2018-09-08,08:00:00,38,24,14,FMN GV 05 Lier
60,Mechelsesteenweg 365,2018-09-08,09:00:00,92,42,50,FMN GV 05 Lier
60,Mechelsesteenweg 365,2018-09-08,10:00:00,176,48,128,FMN GV 05 Lier
60,Mechelsesteenweg 365,2018-09-08,11:00:00,216,92,124,FMN GV 05 Lier
60,Mechelsesteenweg 365,2018-09-08,12:00:00,98,38,60,FMN GV 05 Lier
60,Mechelsesteenweg 365,2018-09-08,13:00:00,92,38,54,FMN GV 05 Lier
60,Mechelsesteenweg 365,2018-09-08,14:00:00,126,76,50,FMN GV 05 Lier
60,Mechelsesteenweg 365,2018-09-08,15:00:00,138,56,82,FMN GV 05 Lier
60,Mechelsesteenweg 365,2018-09-08,16:00:00,106,68,38,FMN GV 05 Lier
60,Mechelsesteenweg 365,2018-09-08,17:00:00,56,24,32,FMN GV 05 Lier
60,Mechelsesteenweg 365,2018-09-08,18:00:00,60,20,40,FMN GV 05 Lier
60,Mechelsesteenweg 365,2018-09-08,19:00:00,20,6,14,FMN GV 05 Lier
60,Mechelsesteenweg 365,2018-09-08,20:00:00,12,4,8,FMN GV 05 Lier
60,Mechelsesteenweg 365,2018-09-08,21:00:00,6,4,2,FMN GV 05 Lier
60,Mechelsesteenweg 365,2018-09-08,22:00:00,10,4,6,FMN GV 05 Lier
60,Mechelsesteenweg 365,2018-09-08,23:00:00,2,2,0,FMN GV 05 Lier
60,Mechelsesteenweg 365,2018-09-09,00:00:00,2,2,0,FMN GV 05 Lier
60,Mechelsesteenweg 365,2018-09-09,01:00:00,0,0,0,FMN GV 05 Lier
60,Mechelsesteenweg 365,2018-09-09,02:00:00,0,0,0,FMN GV 05 Lier
60,Mechelsesteenweg 365,2018-09-09,03:00:00,0,0,0,FMN GV 05 Lier
60,Mechelsesteenweg 365,2018-09-09,04:00:00,0,0,0,FMN GV 05 Lier
60,Mechelsesteenweg 365,2018-09-09,05:00:00,0,0,0,FMN GV 05 Lier
60,Mechelsesteenweg 365,2018-09-09,06:00:00,0,0,0,FMN GV 05 Lier
60,Mechelsesteenweg 365,2018-09-09,07:00:00,14,8,6,FMN GV 05 Lier
60,Mechelsesteenweg 365,2018-09-09,08:00:00,38,24,14,FMN GV 05 Lier
60,Mechelsesteenweg 365,2018-09-09,09:00:00,266,120,146,FMN GV 05 Lier
60,Mechelsesteenweg 365,2018-09-09,10:00:00,324,160,164,FMN GV 05 Lier
60,Mechelsesteenweg 365,2018-09-09,11:00:00,350,150,200,FMN GV 05 Lier
60,Mechelsesteenweg 365,2018-09-09,12:00:00,288,130,158,FMN GV 05 Lier
60,Mechelsesteenweg 365,2018-09-09,13:00:00,246,116,130,FMN GV 05 Lier
60,Mechelsesteenweg 365,2018-09-09,14:00:00,316,166,150,FMN GV 05 Lier
60,Mechelsesteenweg 365,2018-09-09,15:00:00,302,164,138,FMN GV 05 Lier
60,Mechelsesteenweg 365,2018-09-09,16:00:00,296,126,170,FMN GV 05 Lier
60,Mechelsesteenweg 365,2018-09-09,17:00:00,208,82,126,FMN GV 05 Lier
60,Mechelsesteenweg 365,2018-09-09,18:00:00,130,50,80,FMN GV 05 Lier
60,Mechelsesteenweg 365,2018-09-09,19:00:00,62,18,44,FMN GV 05 Lier
60,Mechelsesteenweg 365,2018-09-09,20:00:00,22,10,12,FMN GV 05 Lier
60,Mechelsesteenweg 365,2018-09-09,21:00:00,12,0,12,FMN GV 05 Lier
60,Mechelsesteenweg 365,2018-09-09,22:00:00,2,0,2,FMN GV 05 Lier
60,Mechelsesteenweg 365,2018-09-09,23:00:00,4,0,4,FMN GV 05 Lier
60,Mechelsesteenweg 365,2018-09-10,00:00:00,0,0,0,FMN GV 05 Lier
60,Mechelsesteenweg 365,2018-09-10,01:00:00,2,2,0,FMN GV 05 Lier
60,Mechelsesteenweg 365,2018-09-10,02:00:00,2,0,2,FMN GV 05 Lier
60,Mechelsesteenweg 365,2018-09-10,03:00:00,0,0,0,FMN GV 05 Lier
60,Mechelsesteenweg 365,2018-09-10,04:00:00,2,0,2,FMN GV 05 Lier
60,Mechelsesteenweg 365,2018-09-10,05:00:00,2,0,2,FMN GV 05 Lier
60,Mechelsesteenweg 365,2018-09-10,06:00:00,12,2,10,FMN GV 05 Lier
60,Mechelsesteenweg 365,2018-09-10,07:00:00,208,112,96,FMN GV 05 Lier
60,Mechelsesteenweg 365,2018-09-10,08:00:00,146,90,56,FMN GV 05 Lier
60,Mechelsesteenweg 365,2018-09-10,09:00:00,40,14,26,FMN GV 05 Lier
60,Mechelsesteenweg 365,2018-09-10,10:00:00,64,30,34,FMN GV 05 Lier
60,Mechelsesteenweg 365,2018-09-10,11:00:00,80,42,38,FMN GV 05 Lier
60,Mechelsesteenweg 365,2018-09-10,12:00:00,100,42,58,FMN GV 05 Lier
60,Mechelsesteenweg 365,2018-09-10,13:00:00,170,74,96,FMN GV 05 Lier
60,Mechelsesteenweg 365,2018-09-10,14:00:00,164,100,64,FMN GV 05 Lier
60,Mechelsesteenweg 365,2018-09-10,15:00:00,134,56,78,FMN GV 05 Lier
60,Mechelsesteenweg 365,2018-09-10,16:00:00,236,90,146,FMN GV 05 Lier
60,Mechelsesteenweg 365,2018-09-10,17:00:00,130,68,62,FMN GV 05 Lier
60,Mechelsesteenweg 365,2018-09-10,18:00:00,68,34,34,FMN GV 05 Lier
60,Mechelsesteenweg 365,2018-09-10,19:00:00,34,12,22,FMN GV 05 Lier
60,Mechelsesteenweg 365,2018-09-10,20:00:00,22,10,12,FMN GV 05 Lier
60,Mechelsesteenweg 365,2018-09-10,21:00:00,10,4,6,FMN GV 05 Lier
60,Mechelsesteenweg 365,2018-09-10,22:00:00,8,4,4,FMN GV 05 Lier
60,Mechelsesteenweg 365,2018-09-10,23:00:00,0,0,0,FMN GV 05 Lier
60,Mechelsesteenweg 365,2018-09-11,00:00:00,0,0,0,FMN GV 05 Lier
60,Mechelsesteenweg 365,2018-09-11,01:00:00,0,0,0,FMN GV 05 Lier
60,Mechelsesteenweg 365,2018-09-11,02:00:00,0,0,0,FMN GV 05 Lier
60,Mechelsesteenweg 365,2018-09-11,03:00:00,0,0,0,FMN GV 05 Lier
60,Mechelsesteenweg 365,2018-09-11,04:00:00,2,0,2,FMN GV 05 Lier
60,Mechelsesteenweg 365,2018-09-11,05:00:00,4,4,0,FMN GV 05 Lier
60,Mechelsesteenweg 365,2018-09-11,06:00:00,22,2,20,FMN GV 05 Lier
60,Mechelsesteenweg 365,2018-09-11,07:00:00,222,120,102,FMN GV 05 Lier
60,Mechelsesteenweg 365,2018-09-11,08:00:00,168,86,82,FMN GV 05 Lier
60,Mechelsesteenweg 365,2018-09-11,09:00:00,120,44,76,FMN GV 05 Lier
60,Mechelsesteenweg 365,2018-09-11,10:00:00,122,54,68,FMN GV 05 Lier
60,Mechelsesteenweg 365,2018-09-11,11:00:00,130,74,56,FMN GV 05 Lier
60,Mechelsesteenweg 365,2018-09-11,12:00:00,98,50,48,FMN GV 05 Lier
60,Mechelsesteenweg 365,2018-09-11,13:00:00,180,66,114,FMN GV 05 Lier
60,Mechelsesteenweg 365,2018-09-11,14:00:00,202,148,54,FMN GV 05 Lier
60,Mechelsesteenweg 365,2018-09-11,15:00:00,204,86,118,FMN GV 05 Lier
60,Mechelsesteenweg 365,2018-09-11,16:00:00,298,108,190,FMN GV 05 Lier
60,Mechelsesteenweg 365,2018-09-11,17:00:00,232,124,108,FMN GV 05 Lier
60,Mechelsesteenweg 365,2018-09-11,18:00:00,104,58,46,FMN GV 05 Lier
60,Mechelsesteenweg 365,2018-09-11,19:00:00,166,86,80,FMN GV 05 Lier
60,Mechelsesteenweg 365,2018-09-11,20:00:00,50,28,22,FMN GV 05 Lier
60,Mechelsesteenweg 365,2018-09-11,21:00:00,24,6,18,FMN GV 05 Lier
60,Mechelsesteenweg 365,2018-09-11,22:00:00,6,4,2,FMN GV 05 Lier
60,Mechelsesteenweg 365,2018-09-11,23:00:00,0,0,0,FMN GV 05 Lier
60,Mechelsesteenweg 365,2018-09-12,00:00:00,0,0,0,FMN GV 05 Lier
60,Mechelsesteenweg 365,2018-09-12,01:00:00,0,0,0,FMN GV 05 Lier
60,Mechelsesteenweg 365,2018-09-12,02:00:00,0,0,0,FMN GV 05 Lier
60,Mechelsesteenweg 365,2018-09-12,03:00:00,0,0,0,FMN GV 05 Lier
60,Mechelsesteenweg 365,2018-09-12,04:00:00,0,0,0,FMN GV 05 Lier
60,Mechelsesteenweg 365,2018-09-12,05:00:00,0,0,0,FMN GV 05 Lier
60,Mechelsesteenweg 365,2018-09-12,06:00:00,24,10,14,FMN GV 05 Lier
60,Mechelsesteenweg 365,2018-09-12,07:00:00,184,120,64,FMN GV 05 Lier
60,Mechelsesteenweg 365,2018-09-12,08:00:00,142,86,56,FMN GV 05 Lier
60,Mechelsesteenweg 365,2018-09-12,09:00:00,52,28,24,FMN GV 05 Lier
60,Mechelsesteenweg 365,2018-09-12,10:00:00,70,30,40,FMN GV 05 Lier
60,Mechelsesteenweg 365,2018-09-12,11:00:00,94,44,50,FMN GV 05 Lier
60,Mechelsesteenweg 365,2018-09-12,12:00:00,204,54,150,FMN GV 05 Lier
60,Mechelsesteenweg 365,2018-09-12,13:00:00,56,24,32,FMN GV 05 Lier
60,Mechelsesteenweg 365,2018-09-12,14:00:00,36,26,10,FMN GV 05 Lier
60,Mechelsesteenweg 365,2018-09-12,15:00:00,52,26,26,FMN GV 05 Lier
60,Mechelsesteenweg 365,2018-09-12,16:00:00,98,40,58,FMN GV 05 Lier
60,Mechelsesteenweg 365,2018-09-12,17:00:00,86,48,38,FMN GV 05 Lier
60,Mechelsesteenweg 365,2018-09-12,18:00:00,56,28,28,FMN GV 05 Lier
60,Mechelsesteenweg 365,2018-09-12,19:00:00,56,36,20,FMN GV 05 Lier
60,Mechelsesteenweg 365,2018-09-12,20:00:00,48,34,14,FMN GV 05 Lier
60,Mechelsesteenweg 365,2018-09-12,21:00:00,2,0,2,FMN GV 05 Lier
60,Mechelsesteenweg 365,2018-09-12,22:00:00,2,0,2,FMN GV 05 Lier
60,Mechelsesteenweg 365,2018-09-12,23:00:00,0,0,0,FMN GV 05 Lier
60,Mechelsesteenweg 365,2018-09-13,00:00:00,0,0,0,FMN GV 05 Lier
60,Mechelsesteenweg 365,2018-09-13,01:00:00,4,0,4,FMN GV 05 Lier
60,Mechelsesteenweg 365,2018-09-13,02:00:00,0,0,0,FMN GV 05 Lier
60,Mechelsesteenweg 365,2018-09-13,03:00:00,0,0,0,FMN GV 05 Lier
60,Mechelsesteenweg 365,2018-09-13,04:00:00,2,0,2,FMN GV 05 Lier
60,Mechelsesteenweg 365,2018-09-13,05:00:00,2,0,2,FMN GV 05 Lier
60,Mechelsesteenweg 365,2018-09-13,06:00:00,4,0,4,FMN GV 05 Lier
60,Mechelsesteenweg 365,2018-09-13,07:00:00,168,108,60,FMN GV 05 Lier
60,Mechelsesteenweg 365,2018-09-13,08:00:00,152,100,52,FMN GV 05 Lier
60,Mechelsesteenweg 365,2018-09-13,09:00:00,48,30,18,FMN GV 05 Lier
60,Mechelsesteenweg 365,2018-09-13,10:00:00,76,20,56,FMN GV 05 Lier
60,Mechelsesteenweg 365,2018-09-13,11:00:00,94,38,56,FMN GV 05 Lier
60,Mechelsesteenweg 365,2018-09-13,12:00:00,86,22,64,FMN GV 05 Lier
60,Mechelsesteenweg 365,2018-09-13,13:00:00,174,64,110,FMN GV 05 Lier
60,Mechelsesteenweg 365,2018-09-13,14:00:00,142,80,62,FMN GV 05 Lier
60,Mechelsesteenweg 365,2018-09-13,15:00:00,168,56,112,FMN GV 05 Lier
60,Mechelsesteenweg 365,2018-09-13,16:00:00,206,76,130,FMN GV 05 Lier
60,Mechelsesteenweg 365,2018-09-13,17:00:00,120,62,58,FMN GV 05 Lier
60,Mechelsesteenweg 365,2018-09-13,18:00:00,130,72,58,FMN GV 05 Lier
60,Mechelsesteenweg 365,2018-09-13,19:00:00,72,42,30,FMN GV 05 Lier
60,Mechelsesteenweg 365,2018-09-13,20:00:00,16,10,6,FMN GV 05 Lier
60,Mechelsesteenweg 365,2018-09-13,21:00:00,12,6,6,FMN GV 05 Lier
60,Mechelsesteenweg 365,2018-09-13,22:00:00,12,4,8,FMN GV 05 Lier
60,Mechelsesteenweg 365,2018-09-13,23:00:00,0,0,0,FMN GV 05 Lier
60,Mechelsesteenweg 365,2018-09-14,00:00:00,2,2,0,FMN GV 05 Lier
60,Mechelsesteenweg 365,2018-09-14,01:00:00,2,2,0,FMN GV 05 Lier
60,Mechelsesteenweg 365,2018-09-14,02:00:00,0,0,0,FMN GV 05 Lier
60,Mechelsesteenweg 365,2018-09-14,03:00:00,0,0,0,FMN GV 05 Lier
60,Mechelsesteenweg 365,2018-09-14,04:00:00,0,0,0,FMN GV 05 Lier
60,Mechelsesteenweg 365,2018-09-14,05:00:00,4,2,2,FMN GV 05 Lier
60,Mechelsesteenweg 365,2018-09-14,06:00:00,20,4,16,FMN GV 05 Lier
60,Mechelsesteenweg 365,2018-09-14,07:00:00,172,110,62,FMN GV 05 Lier
60,Mechelsesteenweg 365,2018-09-14,08:00:00,154,96,58,FMN GV 05 Lier
60,Mechelsesteenweg 365,2018-09-14,09:00:00,62,48,14,FMN GV 05 Lier
60,Mechelsesteenweg 365,2018-09-14,10:00:00,98,30,68,FMN GV 05 Lier
60,Mechelsesteenweg 365,2018-09-14,11:00:00,158,58,100,FMN GV 05 Lier
60,Mechelsesteenweg 365,2018-09-14,12:00:00,102,54,48,FMN GV 05 Lier
60,Mechelsesteenweg 365,2018-09-14,13:00:00,126,62,64,FMN GV 05 Lier
60,Mechelsesteenweg 365,2018-09-14,14:00:00,118,72,46,FMN GV 05 Lier
60,Mechelsesteenweg 365,2018-09-14,15:00:00,158,60,98,FMN GV 05 Lier
60,Mechelsesteenweg 365,2018-09-14,16:00:00,298,100,198,FMN GV 05 Lier
60,Mechelsesteenweg 365,2018-09-14,17:00:00,110,50,60,FMN GV 05 Lier
60,Mechelsesteenweg 365,2018-09-14,18:00:00,54,30,24,FMN GV 05 Lier
60,Mechelsesteenweg 365,2018-09-14,19:00:00,30,10,20,FMN GV 05 Lier
60,Mechelsesteenweg 365,2018-09-14,20:00:00,30,16,14,FMN GV 05 Lier
60,Mechelsesteenweg 365,2018-09-14,21:00:00,0,0,0,FMN GV 05 Lier
60,Mechelsesteenweg 365,2018-09-14,22:00:00,10,8,2,FMN GV 05 Lier
60,Mechelsesteenweg 365,2018-09-14,23:00:00,0,0,0,FMN GV 05 Lier
60,Mechelsesteenweg 365,2018-09-15,00:00:00,4,0,4,FMN GV 05 Lier
60,Mechelsesteenweg 365,2018-09-15,01:00:00,0,0,0,FMN GV 05 Lier
60,Mechelsesteenweg 365,2018-09-15,02:00:00,4,2,2,FMN GV 05 Lier
60,Mechelsesteenweg 365,2018-09-15,03:00:00,0,0,0,FMN GV 05 Lier
60,Mechelsesteenweg 365,2018-09-15,04:00:00,0,0,0,FMN GV 05 Lier
60,Mechelsesteenweg 365,2018-09-15,05:00:00,2,0,2,FMN GV 05 Lier
60,Mechelsesteenweg 365,2018-09-15,06:00:00,6,6,0,FMN GV 05 Lier
60,Mechelsesteenweg 365,2018-09-15,07:00:00,12,6,6,FMN GV 05 Lier
60,Mechelsesteenweg 365,2018-09-15,08:00:00,30,16,14,FMN GV 05 Lier
60,Mechelsesteenweg 365,2018-09-15,09:00:00,74,34,40,FMN GV 05 Lier
60,Mechelsesteenweg 365,2018-09-15,10:00:00,116,52,64,FMN GV 05 Lier
60,Mechelsesteenweg 365,2018-09-15,11:00:00,242,104,138,FMN GV 05 Lier
60,Mechelsesteenweg 365,2018-09-15,12:00:00,148,52,96,FMN GV 05 Lier
60,Mechelsesteenweg 365,2018-09-15,13:00:00,180,80,100,FMN GV 05 Lier
60,Mechelsesteenweg 365,2018-09-15,14:00:00,130,56,74,FMN GV 05 Lier
60,Mechelsesteenweg 365,2018-09-15,15:00:00,168,100,68,FMN GV 05 Lier
60,Mechelsesteenweg 365,2018-09-15,16:00:00,124,70,54,FMN GV 05 Lier
60,Mechelsesteenweg 365,2018-09-15,17:00:00,84,20,64,FMN GV 05 Lier
60,Mechelsesteenweg 365,2018-09-15,18:00:00,44,16,28,FMN GV 05 Lier
60,Mechelsesteenweg 365,2018-09-15,19:00:00,26,14,12,FMN GV 05 Lier
60,Mechelsesteenweg 365,2018-09-15,20:00:00,10,6,4,FMN GV 05 Lier
60,Mechelsesteenweg 365,2018-09-15,21:00:00,2,0,2,FMN GV 05 Lier
60,Mechelsesteenweg 365,2018-09-15,22:00:00,4,0,4,FMN GV 05 Lier
60,Mechelsesteenweg 365,2018-09-15,23:00:00,2,2,0,FMN GV 05 Lier
60,Mechelsesteenweg 365,2018-09-16,00:00:00,0,0,0,FMN GV 05 Lier
60,Mechelsesteenweg 365,2018-09-16,01:00:00,2,0,2,FMN GV 05 Lier
60,Mechelsesteenweg 365,2018-09-16,02:00:00,0,0,0,FMN GV 05 Lier
60,Mechelsesteenweg 365,2018-09-16,03:00:00,0,0,0,FMN GV 05 Lier
60,Mechelsesteenweg 365,2018-09-16,04:00:00,0,0,0,FMN GV 05 Lier
60,Mechelsesteenweg 365,2018-09-16,05:00:00,0,0,0,FMN GV 05 Lier
60,Mechelsesteenweg 365,2018-09-16,06:00:00,0,0,0,FMN GV 05 Lier
60,Mechelsesteenweg 365,2018-09-16,07:00:00,4,0,4,FMN GV 05 Lier
60,Mechelsesteenweg 365,2018-09-16,08:00:00,58,44,14,FMN GV 05 Lier
60,Mechelsesteenweg 365,2018-09-16,09:00:00,202,88,114,FMN GV 05 Lier
60,Mechelsesteenweg 365,2018-09-16,10:00:00,352,184,168,FMN GV 05 Lier
60,Mechelsesteenweg 365,2018-09-16,11:00:00,376,172,204,FMN GV 05 Lier
60,Mechelsesteenweg 365,2018-09-16,12:00:00,242,110,132,FMN GV 05 Lier
60,Mechelsesteenweg 365,2018-09-16,13:00:00,308,156,152,FMN GV 05 Lier
60,Mechelsesteenweg 365,2018-09-16,14:00:00,394,234,160,FMN GV 05 Lier
60,Mechelsesteenweg 365,2018-09-16,15:00:00,376,182,194,FMN GV 05 Lier
60,Mechelsesteenweg 365,2018-09-16,16:00:00,318,122,196,FMN GV 05 Lier
60,Mechelsesteenweg 365,2018-09-16,17:00:00,210,82,128,FMN GV 05 Lier
60,Mechelsesteenweg 365,2018-09-16,18:00:00,118,50,68,FMN GV 05 Lier
60,Mechelsesteenweg 365,2018-09-16,19:00:00,66,24,42,FMN GV 05 Lier
60,Mechelsesteenweg 365,2018-09-16,20:00:00,30,4,26,FMN GV 05 Lier
60,Mechelsesteenweg 365,2018-09-16,21:00:00,12,4,8,FMN GV 05 Lier
60,Mechelsesteenweg 365,2018-09-16,22:00:00,6,4,2,FMN GV 05 Lier
60,Mechelsesteenweg 365,2018-09-16,23:00:00,0,0,0,FMN GV 05 Lier
60,Mechelsesteenweg 365,2018-09-17,00:00:00,0,0,0,FMN GV 05 Lier
60,Mechelsesteenweg 365,2018-09-17,01:00:00,0,0,0,FMN GV 05 Lier
60,Mechelsesteenweg 365,2018-09-17,02:00:00,0,0,0,FMN GV 05 Lier
60,Mechelsesteenweg 365,2018-09-17,03:00:00,0,0,0,FMN GV 05 Lier
60,Mechelsesteenweg 365,2018-09-17,04:00:00,2,0,2,FMN GV 05 Lier
60,Mechelsesteenweg 365,2018-09-17,05:00:00,6,2,4,FMN GV 05 Lier
60,Mechelsesteenweg 365,2018-09-17,06:00:00,20,8,12,FMN GV 05 Lier
60,Mechelsesteenweg 365,2018-09-17,07:00:00,214,122,92,FMN GV 05 Lier
60,Mechelsesteenweg 365,2018-09-17,08:00:00,144,86,58,FMN GV 05 Lier
60,Mechelsesteenweg 365,2018-09-17,09:00:00,64,42,22,FMN GV 05 Lier
60,Mechelsesteenweg 365,2018-09-17,10:00:00,122,76,46,FMN GV 05 Lier
60,Mechelsesteenweg 365,2018-09-17,11:00:00,122,68,54,FMN GV 05 Lier
60,Mechelsesteenweg 365,2018-09-17,12:00:00,102,46,56,FMN GV 05 Lier
60,Mechelsesteenweg 365,2018-09-17,13:00:00,150,78,72,FMN GV 05 Lier
60,Mechelsesteenweg 365,2018-09-17,14:00:00,230,94,136,FMN GV 05 Lier
60,Mechelsesteenweg 365,2018-09-17,15:00:00,250,96,154,FMN GV 05 Lier
60,Mechelsesteenweg 365,2018-09-17,16:00:00,334,116,218,FMN GV 05 Lier
60,Mechelsesteenweg 365,2018-09-17,17:00:00,188,102,86,FMN GV 05 Lier
60,Mechelsesteenweg 365,2018-09-17,18:00:00,90,58,32,FMN GV 05 Lier
60,Mechelsesteenweg 365,2018-09-17,19:00:00,64,24,40,FMN GV 05 Lier
60,Mechelsesteenweg 365,2018-09-17,20:00:00,20,6,14,FMN GV 05 Lier
60,Mechelsesteenweg 365,2018-09-17,21:00:00,10,4,6,FMN GV 05 Lier
60,Mechelsesteenweg 365,2018-09-17,22:00:00,8,4,4,FMN GV 05 Lier
60,Mechelsesteenweg 365,2018-09-17,23:00:00,0,0,0,FMN GV 05 Lier
60,Mechelsesteenweg 365,2018-09-18,00:00:00,0,0,0,FMN GV 05 Lier
60,Mechelsesteenweg 365,2018-09-18,01:00:00,2,2,0,FMN GV 05 Lier
60,Mechelsesteenweg 365,2018-09-18,02:00:00,0,0,0,FMN GV 05 Lier
60,Mechelsesteenweg 365,2018-09-18,03:00:00,0,0,0,FMN GV 05 Lier
60,Mechelsesteenweg 365,2018-09-18,04:00:00,0,0,0,FMN GV 05 Lier
60,Mechelsesteenweg 365,2018-09-18,05:00:00,8,4,4,FMN GV 05 Lier
60,Mechelsesteenweg 365,2018-09-18,06:00:00,26,4,22,FMN GV 05 Lier
60,Mechelsesteenweg 365,2018-09-18,07:00:00,216,140,76,FMN GV 05 Lier
60,Mechelsesteenweg 365,2018-09-18,08:00:00,190,94,96,FMN GV 05 Lier
60,Mechelsesteenweg 365,2018-09-18,09:00:00,100,38,62,FMN GV 05 Lier
60,Mechelsesteenweg 365,2018-09-18,10:00:00,146,56,90,FMN GV 05 Lier
60,Mechelsesteenweg 365,2018-09-18,11:00:00,170,108,62,FMN GV 05 Lier
60,Mechelsesteenweg 365,2018-09-18,12:00:00,162,96,66,FMN GV 05 Lier
60,Mechelsesteenweg 365,2018-09-18,13:00:00,244,96,148,FMN GV 05 Lier
60,Mechelsesteenweg 365,2018-09-18,14:00:00,232,106,126,FMN GV 05 Lier
60,Mechelsesteenweg 365,2018-09-18,15:00:00,224,118,106,FMN GV 05 Lier
60,Mechelsesteenweg 365,2018-09-18,16:00:00,290,102,188,FMN GV 05 Lier
60,Mechelsesteenweg 365,2018-09-18,17:00:00,178,86,92,FMN GV 05 Lier
60,Mechelsesteenweg 365,2018-09-18,18:00:00,110,46,64,FMN GV 05 Lier
60,Mechelsesteenweg 365,2018-09-18,19:00:00,118,46,72,FMN GV 05 Lier
60,Mechelsesteenweg 365,2018-09-18,20:00:00,14,6,8,FMN GV 05 Lier
60,Mechelsesteenweg 365,2018-09-18,21:00:00,10,2,8,FMN GV 05 Lier
60,Mechelsesteenweg 365,2018-09-18,22:00:00,2,0,2,FMN GV 05 Lier
60,Mechelsesteenweg 365,2018-09-18,23:00:00,0,0,0,FMN GV 05 Lier
60,Mechelsesteenweg 365,2018-09-19,00:00:00,2,2,0,FMN GV 05 Lier
60,Mechelsesteenweg 365,2018-09-19,01:00:00,0,0,0,FMN GV 05 Lier
60,Mechelsesteenweg 365,2018-09-19,02:00:00,0,0,0,FMN GV 05 Lier
60,Mechelsesteenweg 365,2018-09-19,03:00:00,0,0,0,FMN GV 05 Lier
60,Mechelsesteenweg 365,2018-09-19,04:00:00,4,2,2,FMN GV 05 Lier
60,Mechelsesteenweg 365,2018-09-19,05:00:00,4,2,2,FMN GV 05 Lier
60,Mechelsesteenweg 365,2018-09-19,06:00:00,18,6,12,FMN GV 05 Lier
60,Mechelsesteenweg 365,2018-09-19,07:00:00,208,130,78,FMN GV 05 Lier
60,Mechelsesteenweg 365,2018-09-19,08:00:00,152,76,76,FMN GV 05 Lier
60,Mechelsesteenweg 365,2018-09-19,09:00:00,74,50,24,FMN GV 05 Lier
60,Mechelsesteenweg 365,2018-09-19,10:00:00,108,48,60,FMN GV 05 Lier
60,Mechelsesteenweg 365,2018-09-19,11:00:00,164,52,112,FMN GV 05 Lier
60,Mechelsesteenweg 365,2018-09-19,12:00:00,254,90,164,FMN GV 05 Lier
60,Mechelsesteenweg 365,2018-09-19,13:00:00,222,104,118,FMN GV 05 Lier
60,Mechelsesteenweg 365,2018-09-19,14:00:00,196,122,74,FMN GV 05 Lier
60,Mechelsesteenweg 365,2018-09-19,15:00:00,234,114,120,FMN GV 05 Lier
60,Mechelsesteenweg 365,2018-09-19,16:00:00,162,82,80,FMN GV 05 Lier
60,Mechelsesteenweg 365,2018-09-19,17:00:00,204,104,100,FMN GV 05 Lier
60,Mechelsesteenweg 365,2018-09-19,18:00:00,94,40,54,FMN GV 05 Lier
60,Mechelsesteenweg 365,2018-09-19,19:00:00,154,104,50,FMN GV 05 Lier
60,Mechelsesteenweg 365,2018-09-19,20:00:00,50,24,26,FMN GV 05 Lier
60,Mechelsesteenweg 365,2018-09-19,21:00:00,4,0,4,FMN GV 05 Lier
60,Mechelsesteenweg 365,2018-09-19,22:00:00,12,6,6,FMN GV 05 Lier
60,Mechelsesteenweg 365,2018-09-19,23:00:00,4,0,4,FMN GV 05 Lier
60,Mechelsesteenweg 365,2018-09-20,00:00:00,0,0,0,FMN GV 05 Lier
60,Mechelsesteenweg 365,2018-09-20,01:00:00,0,0,0,FMN GV 05 Lier
60,Mechelsesteenweg 365,2018-09-20,02:00:00,0,0,0,FMN GV 05 Lier
60,Mechelsesteenweg 365,2018-09-20,03:00:00,0,0,0,FMN GV 05 Lier
60,Mechelsesteenweg 365,2018-09-20,04:00:00,2,2,0,FMN GV 05 Lier
60,Mechelsesteenweg 365,2018-09-20,05:00:00,4,0,4,FMN GV 05 Lier
60,Mechelsesteenweg 365,2018-09-20,06:00:00,6,0,6,FMN GV 05 Lier
60,Mechelsesteenweg 365,2018-09-20,07:00:00,206,138,68,FMN GV 05 Lier
60,Mechelsesteenweg 365,2018-09-20,08:00:00,188,114,74,FMN GV 05 Lier
60,Mechelsesteenweg 365,2018-09-20,09:00:00,34,18,16,FMN GV 05 Lier
60,Mechelsesteenweg 365,2018-09-20,10:00:00,104,42,62,FMN GV 05 Lier
60,Mechelsesteenweg 365,2018-09-20,11:00:00,150,56,94,FMN GV 05 Lier
60,Mechelsesteenweg 365,2018-09-20,12:00:00,124,66,58,FMN GV 05 Lier
60,Mechelsesteenweg 365,2018-09-20,13:00:00,132,78,54,FMN GV 05 Lier
60,Mechelsesteenweg 365,2018-09-20,14:00:00,186,64,122,FMN GV 05 Lier
60,Mechelsesteenweg 365,2018-09-20,15:00:00,210,114,96,FMN GV 05 Lier
60,Mechelsesteenweg 365,2018-09-20,16:00:00,304,78,226,FMN GV 05 Lier
60,Mechelsesteenweg 365,2018-09-20,17:00:00,152,70,82,FMN GV 05 Lier
60,Mechelsesteenweg 365,2018-09-20,18:00:00,88,66,22,FMN GV 05 Lier
60,Mechelsesteenweg 365,2018-09-20,19:00:00,66,40,26,FMN GV 05 Lier
60,Mechelsesteenweg 365,2018-09-20,20:00:00,34,8,26,FMN GV 05 Lier
60,Mechelsesteenweg 365,2018-09-20,21:00:00,10,2,8,FMN GV 05 Lier
60,Mechelsesteenweg 365,2018-09-20,22:00:00,12,4,8,FMN GV 05 Lier
60,Mechelsesteenweg 365,2018-09-20,23:00:00,0,0,0,FMN GV 05 Lier
60,Mechelsesteenweg 365,2018-09-21,00:00:00,0,0,0,FMN GV 05 Lier
60,Mechelsesteenweg 365,2018-09-21,01:00:00,2,2,0,FMN GV 05 Lier
60,Mechelsesteenweg 365,2018-09-21,02:00:00,0,0,0,FMN GV 05 Lier
60,Mechelsesteenweg 365,2018-09-21,03:00:00,2,0,2,FMN GV 05 Lier
60,Mechelsesteenweg 365,2018-09-21,04:00:00,2,0,2,FMN GV 05 Lier
60,Mechelsesteenweg 365,2018-09-21,05:00:00,10,2,8,FMN GV 05 Lier
60,Mechelsesteenweg 365,2018-09-21,06:00:00,4,4,0,FMN GV 05 Lier
60,Mechelsesteenweg 365,2018-09-21,07:00:00,84,54,30,FMN GV 05 Lier
60,Mechelsesteenweg 365,2018-09-21,08:00:00,84,58,26,FMN GV 05 Lier
60,Mechelsesteenweg 365,2018-09-21,09:00:00,10,6,4,FMN GV 05 Lier
60,Mechelsesteenweg 365,2018-09-21,10:00:00,18,12,6,FMN GV 05 Lier
60,Mechelsesteenweg 365,2018-09-21,11:00:00,26,20,6,FMN GV 05 Lier
60,Mechelsesteenweg 365,2018-09-21,12:00:00,46,30,16,FMN GV 05 Lier
60,Mechelsesteenweg 365,2018-09-21,13:00:00,36,22,14,FMN GV 05 Lier
60,Mechelsesteenweg 365,2018-09-21,14:00:00,64,40,24,FMN GV 05 Lier
60,Mechelsesteenweg 365,2018-09-21,15:00:00,74,34,40,FMN GV 05 Lier
60,Mechelsesteenweg 365,2018-09-21,16:00:00,140,46,94,FMN GV 05 Lier
60,Mechelsesteenweg 365,2018-09-21,17:00:00,82,50,32,FMN GV 05 Lier
60,Mechelsesteenweg 365,2018-09-21,18:00:00,40,22,18,FMN GV 05 Lier
60,Mechelsesteenweg 365,2018-09-21,19:00:00,26,8,18,FMN GV 05 Lier
60,Mechelsesteenweg 365,2018-09-21,20:00:00,18,12,6,FMN GV 05 Lier
60,Mechelsesteenweg 365,2018-09-21,21:00:00,10,2,8,FMN GV 05 Lier
60,Mechelsesteenweg 365,2018-09-21,22:00:00,4,0,4,FMN GV 05 Lier
60,Mechelsesteenweg 365,2018-09-21,23:00:00,4,4,0,FMN GV 05 Lier
60,Mechelsesteenweg 365,2018-09-22,00:00:00,0,0,0,FMN GV 05 Lier
60,Mechelsesteenweg 365,2018-09-22,01:00:00,6,2,4,FMN GV 05 Lier
60,Mechelsesteenweg 365,2018-09-22,02:00:00,0,0,0,FMN GV 05 Lier
60,Mechelsesteenweg 365,2018-09-22,03:00:00,2,0,2,FMN GV 05 Lier
60,Mechelsesteenweg 365,2018-09-22,04:00:00,2,0,2,FMN GV 05 Lier
60,Mechelsesteenweg 365,2018-09-22,05:00:00,2,2,0,FMN GV 05 Lier
60,Mechelsesteenweg 365,2018-09-22,06:00:00,2,0,2,FMN GV 05 Lier
60,Mechelsesteenweg 365,2018-09-22,07:00:00,6,0,6,FMN GV 05 Lier
60,Mechelsesteenweg 365,2018-09-22,08:00:00,24,12,12,FMN GV 05 Lier
60,Mechelsesteenweg 365,2018-09-22,09:00:00,70,40,30,FMN GV 05 Lier
60,Mechelsesteenweg 365,2018-09-22,10:00:00,132,74,58,FMN GV 05 Lier
60,Mechelsesteenweg 365,2018-09-22,11:00:00,108,36,72,FMN GV 05 Lier
60,Mechelsesteenweg 365,2018-09-22,12:00:00,132,58,74,FMN GV 05 Lier
60,Mechelsesteenweg 365,2018-09-22,13:00:00,94,74,20,FMN GV 05 Lier
60,Mechelsesteenweg 365,2018-09-22,14:00:00,56,28,28,FMN GV 05 Lier
60,Mechelsesteenweg 365,2018-09-22,15:00:00,66,24,42,FMN GV 05 Lier
60,Mechelsesteenweg 365,2018-09-22,16:00:00,48,40,8,FMN GV 05 Lier
60,Mechelsesteenweg 365,2018-09-22,17:00:00,46,12,34,FMN GV 05 Lier
60,Mechelsesteenweg 365,2018-09-22,18:00:00,12,10,2,FMN GV 05 Lier
60,Mechelsesteenweg 365,2018-09-22,19:00:00,6,2,4,FMN GV 05 Lier
60,Mechelsesteenweg 365,2018-09-22,20:00:00,2,2,0,FMN GV 05 Lier
60,Mechelsesteenweg 365,2018-09-22,21:00:00,0,0,0,FMN GV 05 Lier
60,Mechelsesteenweg 365,2018-09-22,22:00:00,0,0,0,FMN GV 05 Lier
60,Mechelsesteenweg 365,2018-09-22,23:00:00,0,0,0,FMN GV 05 Lier
60,Mechelsesteenweg 365,2018-09-23,00:00:00,4,2,2,FMN GV 05 Lier
60,Mechelsesteenweg 365,2018-09-23,01:00:00,4,2,2,FMN GV 05 Lier
60,Mechelsesteenweg 365,2018-09-23,02:00:00,2,0,2,FMN GV 05 Lier
60,Mechelsesteenweg 365,2018-09-23,03:00:00,0,0,0,FMN GV 05 Lier
60,Mechelsesteenweg 365,2018-09-23,04:00:00,0,0,0,FMN GV 05 Lier
60,Mechelsesteenweg 365,2018-09-23,05:00:00,0,0,0,FMN GV 05 Lier
60,Mechelsesteenweg 365,2018-09-23,06:00:00,2,2,0,FMN GV 05 Lier
60,Mechelsesteenweg 365,2018-09-23,07:00:00,2,0,2,FMN GV 05 Lier
60,Mechelsesteenweg 365,2018-09-23,08:00:00,6,2,4,FMN GV 05 Lier
60,Mechelsesteenweg 365,2018-09-23,09:00:00,22,18,4,FMN GV 05 Lier
60,Mechelsesteenweg 365,2018-09-23,10:00:00,30,12,18,FMN GV 05 Lier
60,Mechelsesteenweg 365,2018-09-23,11:00:00,24,10,14,FMN GV 05 Lier
60,Mechelsesteenweg 365,2018-09-23,12:00:00,8,2,6,FMN GV 05 Lier
60,Mechelsesteenweg 365,2018-09-23,13:00:00,2,2,0,FMN GV 05 Lier
60,Mechelsesteenweg 365,2018-09-23,14:00:00,2,0,2,FMN GV 05 Lier
60,Mechelsesteenweg 365,2018-09-23,15:00:00,2,2,0,FMN GV 05 Lier
60,Mechelsesteenweg 365,2018-09-23,16:00:00,4,2,2,FMN GV 05 Lier
60,Mechelsesteenweg 365,2018-09-23,17:00:00,10,4,6,FMN GV 05 Lier
60,Mechelsesteenweg 365,2018-09-23,18:00:00,6,4,2,FMN GV 05 Lier
60,Mechelsesteenweg 365,2018-09-23,19:00:00,2,2,0,FMN GV 05 Lier
60,Mechelsesteenweg 365,2018-09-23,20:00:00,0,0,0,FMN GV 05 Lier
60,Mechelsesteenweg 365,2018-09-23,21:00:00,0,0,0,FMN GV 05 Lier
60,Mechelsesteenweg 365,2018-09-23,22:00:00,2,2,0,FMN GV 05 Lier
60,Mechelsesteenweg 365,2018-09-23,23:00:00,2,0,2,FMN GV 05 Lier
60,Mechelsesteenweg 365,2018-09-24,00:00:00,0,0,0,FMN GV 05 Lier
60,Mechelsesteenweg 365,2018-09-24,01:00:00,0,0,0,FMN GV 05 Lier
60,Mechelsesteenweg 365,2018-09-24,02:00:00,0,0,0,FMN GV 05 Lier
60,Mechelsesteenweg 365,2018-09-24,03:00:00,0,0,0,FMN GV 05 Lier
60,Mechelsesteenweg 365,2018-09-24,04:00:00,2,0,2,FMN GV 05 Lier
60,Mechelsesteenweg 365,2018-09-24,05:00:00,2,0,2,FMN GV 05 Lier
60,Mechelsesteenweg 365,2018-09-24,06:00:00,14,2,12,FMN GV 05 Lier
60,Mechelsesteenweg 365,2018-09-24,07:00:00,156,100,56,FMN GV 05 Lier
60,Mechelsesteenweg 365,2018-09-24,08:00:00,110,62,48,FMN GV 05 Lier
60,Mechelsesteenweg 365,2018-09-24,09:00:00,118,90,28,FMN GV 05 Lier
60,Mechelsesteenweg 365,2018-09-24,10:00:00,48,26,22,FMN GV 05 Lier
60,Mechelsesteenweg 365,2018-09-24,11:00:00,18,10,8,FMN GV 05 Lier
60,Mechelsesteenweg 365,2018-09-24,12:00:00,28,18,10,FMN GV 05 Lier
60,Mechelsesteenweg 365,2018-09-24,13:00:00,26,12,14,FMN GV 05 Lier
60,Mechelsesteenweg 365,2018-09-24,14:00:00,50,24,26,FMN GV 05 Lier
60,Mechelsesteenweg 365,2018-09-24,15:00:00,52,24,28,FMN GV 05 Lier
60,Mechelsesteenweg 365,2018-09-24,16:00:00,190,68,122,FMN GV 05 Lier
60,Mechelsesteenweg 365,2018-09-24,17:00:00,100,54,46,FMN GV 05 Lier
60,Mechelsesteenweg 365,2018-09-24,18:00:00,58,16,42,FMN GV 05 Lier
60,Mechelsesteenweg 365,2018-09-24,19:00:00,42,24,18,FMN GV 05 Lier
60,Mechelsesteenweg 365,2018-09-24,20:00:00,14,8,6,FMN GV 05 Lier
60,Mechelsesteenweg 365,2018-09-24,21:00:00,4,2,2,FMN GV 05 Lier
60,Mechelsesteenweg 365,2018-09-24,22:00:00,2,2,0,FMN GV 05 Lier
60,Mechelsesteenweg 365,2018-09-24,23:00:00,2,2,0,FMN GV 05 Lier
60,Mechelsesteenweg 365,2018-09-25,00:00:00,0,0,0,FMN GV 05 Lier
60,Mechelsesteenweg 365,2018-09-25,01:00:00,0,0,0,FMN GV 05 Lier
60,Mechelsesteenweg 365,2018-09-25,02:00:00,0,0,0,FMN GV 05 Lier
60,Mechelsesteenweg 365,2018-09-25,03:00:00,2,2,0,FMN GV 05 Lier
60,Mechelsesteenweg 365,2018-09-25,04:00:00,4,0,4,FMN GV 05 Lier
60,Mechelsesteenweg 365,2018-09-25,05:00:00,8,2,6,FMN GV 05 Lier
60,Mechelsesteenweg 365,2018-09-25,06:00:00,12,2,10,FMN GV 05 Lier
60,Mechelsesteenweg 365,2018-09-25,07:00:00,202,114,88,FMN GV 05 Lier
60,Mechelsesteenweg 365,2018-09-25,08:00:00,174,96,78,FMN GV 05 Lier
60,Mechelsesteenweg 365,2018-09-25,09:00:00,202,56,146,FMN GV 05 Lier
60,Mechelsesteenweg 365,2018-09-25,10:00:00,90,48,42,FMN GV 05 Lier
60,Mechelsesteenweg 365,2018-09-25,11:00:00,106,54,52,FMN GV 05 Lier
60,Mechelsesteenweg 365,2018-09-25,12:00:00,96,42,54,FMN GV 05 Lier
60,Mechelsesteenweg 365,2018-09-25,13:00:00,182,68,114,FMN GV 05 Lier
60,Mechelsesteenweg 365,2018-09-25,14:00:00,140,74,66,FMN GV 05 Lier
60,Mechelsesteenweg 365,2018-09-25,15:00:00,254,114,140,FMN GV 05 Lier
60,Mechelsesteenweg 365,2018-09-25,16:00:00,278,80,198,FMN GV 05 Lier
60,Mechelsesteenweg 365,2018-09-25,17:00:00,164,98,66,FMN GV 05 Lier
60,Mechelsesteenweg 365,2018-09-25,18:00:00,108,58,50,FMN GV 05 Lier
60,Mechelsesteenweg 365,2018-09-25,19:00:00,54,24,30,FMN GV 05 Lier
60,Mechelsesteenweg 365,2018-09-25,20:00:00,10,10,0,FMN GV 05 Lier
60,Mechelsesteenweg 365,2018-09-25,21:00:00,6,0,6,FMN GV 05 Lier
60,Mechelsesteenweg 365,2018-09-25,22:00:00,6,2,4,FMN GV 05 Lier
60,Mechelsesteenweg 365,2018-09-25,23:00:00,2,2,0,FMN GV 05 Lier
60,Mechelsesteenweg 365,2018-09-26,00:00:00,0,0,0,FMN GV 05 Lier
60,Mechelsesteenweg 365,2018-09-26,01:00:00,0,0,0,FMN GV 05 Lier
60,Mechelsesteenweg 365,2018-09-26,02:00:00,0,0,0,FMN GV 05 Lier
60,Mechelsesteenweg 365,2018-09-26,03:00:00,0,0,0,FMN GV 05 Lier
60,Mechelsesteenweg 365,2018-09-26,04:00:00,6,0,6,FMN GV 05 Lier
60,Mechelsesteenweg 365,2018-09-26,05:00:00,6,4,2,FMN GV 05 Lier
60,Mechelsesteenweg 365,2018-09-26,06:00:00,12,2,10,FMN GV 05 Lier
60,Mechelsesteenweg 365,2018-09-26,07:00:00,168,98,70,FMN GV 05 Lier
60,Mechelsesteenweg 365,2018-09-26,08:00:00,156,90,66,FMN GV 05 Lier
60,Mechelsesteenweg 365,2018-09-26,09:00:00,126,94,32,FMN GV 05 Lier
60,Mechelsesteenweg 365,2018-09-26,10:00:00,70,22,48,FMN GV 05 Lier
60,Mechelsesteenweg 365,2018-09-26,11:00:00,112,56,56,FMN GV 05 Lier
60,Mechelsesteenweg 365,2018-09-26,12:00:00,302,66,236,FMN GV 05 Lier
60,Mechelsesteenweg 365,2018-09-26,13:00:00,196,76,120,FMN GV 05 Lier
60,Mechelsesteenweg 365,2018-09-26,14:00:00,244,140,104,FMN GV 05 Lier
60,Mechelsesteenweg 365,2018-09-26,15:00:00,210,98,112,FMN GV 05 Lier
60,Mechelsesteenweg 365,2018-09-26,16:00:00,224,104,120,FMN GV 05 Lier
60,Mechelsesteenweg 365,2018-09-26,17:00:00,168,94,74,FMN GV 05 Lier
60,Mechelsesteenweg 365,2018-09-26,18:00:00,96,54,42,FMN GV 05 Lier
60,Mechelsesteenweg 365,2018-09-26,19:00:00,140,96,44,FMN GV 05 Lier
60,Mechelsesteenweg 365,2018-09-26,20:00:00,14,8,6,FMN GV 05 Lier
60,Mechelsesteenweg 365,2018-09-26,21:00:00,2,0,2,FMN GV 05 Lier
60,Mechelsesteenweg 365,2018-09-26,22:00:00,6,4,2,FMN GV 05 Lier
60,Mechelsesteenweg 365,2018-09-26,23:00:00,2,2,0,FMN GV 05 Lier
60,Mechelsesteenweg 365,2018-09-27,00:00:00,0,0,0,FMN GV 05 Lier
60,Mechelsesteenweg 365,2018-09-27,01:00:00,0,0,0,FMN GV 05 Lier
60,Mechelsesteenweg 365,2018-09-27,02:00:00,0,0,0,FMN GV 05 Lier
60,Mechelsesteenweg 365,2018-09-27,03:00:00,0,0,0,FMN GV 05 Lier
60,Mechelsesteenweg 365,2018-09-27,04:00:00,4,0,4,FMN GV 05 Lier
60,Mechelsesteenweg 365,2018-09-27,05:00:00,4,2,2,FMN GV 05 Lier
60,Mechelsesteenweg 365,2018-09-27,06:00:00,4,0,4,FMN GV 05 Lier
60,Mechelsesteenweg 365,2018-09-27,07:00:00,180,110,70,FMN GV 05 Lier
60,Mechelsesteenweg 365,2018-09-27,08:00:00,166,82,84,FMN GV 05 Lier
60,Mechelsesteenweg 365,2018-09-27,09:00:00,112,36,76,FMN GV 05 Lier
60,Mechelsesteenweg 365,2018-09-27,10:00:00,136,48,88,FMN GV 05 Lier
60,Mechelsesteenweg 365,2018-09-27,11:00:00,138,74,64,FMN GV 05 Lier
60,Mechelsesteenweg 365,2018-09-27,12:00:00,150,68,82,FMN GV 05 Lier
60,Mechelsesteenweg 365,2018-09-27,13:00:00,252,122,130,FMN GV 05 Lier
60,Mechelsesteenweg 365,2018-09-27,14:00:00,380,196,184,FMN GV 05 Lier
60,Mechelsesteenweg 365,2018-09-27,15:00:00,308,128,180,FMN GV 05 Lier
60,Mechelsesteenweg 365,2018-09-27,16:00:00,350,124,226,FMN GV 05 Lier
60,Mechelsesteenweg 365,2018-09-27,17:00:00,190,76,114,FMN GV 05 Lier
60,Mechelsesteenweg 365,2018-09-27,18:00:00,86,60,26,FMN GV 05 Lier
60,Mechelsesteenweg 365,2018-09-27,19:00:00,72,40,32,FMN GV 05 Lier
60,Mechelsesteenweg 365,2018-09-27,20:00:00,16,14,2,FMN GV 05 Lier
60,Mechelsesteenweg 365,2018-09-27,21:00:00,14,6,8,FMN GV 05 Lier
60,Mechelsesteenweg 365,2018-09-27,22:00:00,4,2,2,FMN GV 05 Lier
60,Mechelsesteenweg 365,2018-09-27,23:00:00,2,2,0,FMN GV 05 Lier
60,Mechelsesteenweg 365,2018-09-28,00:00:00,0,0,0,FMN GV 05 Lier
60,Mechelsesteenweg 365,2018-09-28,01:00:00,0,0,0,FMN GV 05 Lier
60,Mechelsesteenweg 365,2018-09-28,02:00:00,0,0,0,FMN GV 05 Lier
60,Mechelsesteenweg 365,2018-09-28,03:00:00,0,0,0,FMN GV 05 Lier
60,Mechelsesteenweg 365,2018-09-28,04:00:00,0,0,0,FMN GV 05 Lier
60,Mechelsesteenweg 365,2018-09-28,05:00:00,6,4,2,FMN GV 05 Lier
60,Mechelsesteenweg 365,2018-09-28,06:00:00,8,2,6,FMN GV 05 Lier
60,Mechelsesteenweg 365,2018-09-28,07:00:00,168,108,60,FMN GV 05 Lier
60,Mechelsesteenweg 365,2018-09-28,08:00:00,140,76,64,FMN GV 05 Lier
60,Mechelsesteenweg 365,2018-09-28,09:00:00,66,28,38,FMN GV 05 Lier
60,Mechelsesteenweg 365,2018-09-28,10:00:00,34,6,28,FMN GV 05 Lier
60,Mechelsesteenweg 365,2018-09-28,11:00:00,62,24,38,FMN GV 05 Lier
60,Mechelsesteenweg 365,2018-09-28,12:00:00,36,8,28,FMN GV 05 Lier
60,Mechelsesteenweg 365,2018-09-28,13:00:00,50,20,30,FMN GV 05 Lier
60,Mechelsesteenweg 365,2018-09-28,14:00:00,150,118,32,FMN GV 05 Lier
60,Mechelsesteenweg 365,2018-09-28,15:00:00,116,58,58,FMN GV 05 Lier
60,Mechelsesteenweg 365,2018-09-28,16:00:00,174,60,114,FMN GV 05 Lier
60,Mechelsesteenweg 365,2018-09-28,17:00:00,64,40,24,FMN GV 05 Lier
60,Mechelsesteenweg 365,2018-09-28,18:00:00,52,26,26,FMN GV 05 Lier
60,Mechelsesteenweg 365,2018-09-28,19:00:00,44,24,20,FMN GV 05 Lier
60,Mechelsesteenweg 365,2018-09-28,20:00:00,2,0,2,FMN GV 05 Lier
60,Mechelsesteenweg 365,2018-09-28,21:00:00,10,8,2,FMN GV 05 Lier
60,Mechelsesteenweg 365,2018-09-28,22:00:00,12,8,4,FMN GV 05 Lier
60,Mechelsesteenweg 365,2018-09-28,23:00:00,4,0,4,FMN GV 05 Lier
60,Mechelsesteenweg 365,2018-09-29,00:00:00,0,0,0,FMN GV 05 Lier
60,Mechelsesteenweg 365,2018-09-29,01:00:00,2,2,0,FMN GV 05 Lier
60,Mechelsesteenweg 365,2018-09-29,02:00:00,10,0,10,FMN GV 05 Lier
60,Mechelsesteenweg 365,2018-09-29,03:00:00,2,0,2,FMN GV 05 Lier
60,Mechelsesteenweg 365,2018-09-29,04:00:00,0,0,0,FMN GV 05 Lier
60,Mechelsesteenweg 365,2018-09-29,05:00:00,0,0,0,FMN GV 05 Lier
60,Mechelsesteenweg 365,2018-09-29,06:00:00,0,0,0,FMN GV 05 Lier
60,Mechelsesteenweg 365,2018-09-29,07:00:00,8,4,4,FMN GV 05 Lier
60,Mechelsesteenweg 365,2018-09-29,08:00:00,18,6,12,FMN GV 05 Lier
60,Mechelsesteenweg 365,2018-09-29,09:00:00,76,44,32,FMN GV 05 Lier
60,Mechelsesteenweg 365,2018-09-29,10:00:00,134,56,78,FMN GV 05 Lier
60,Mechelsesteenweg 365,2018-09-29,11:00:00,146,82,64,FMN GV 05 Lier
60,Mechelsesteenweg 365,2018-09-29,12:00:00,124,60,64,FMN GV 05 Lier
60,Mechelsesteenweg 365,2018-09-29,13:00:00,140,70,70,FMN GV 05 Lier
60,Mechelsesteenweg 365,2018-09-29,14:00:00,168,92,76,FMN GV 05 Lier
60,Mechelsesteenweg 365,2018-09-29,15:00:00,244,98,146,FMN GV 05 Lier
60,Mechelsesteenweg 365,2018-09-29,16:00:00,122,46,76,FMN GV 05 Lier
60,Mechelsesteenweg 365,2018-09-29,17:00:00,82,28,54,FMN GV 05 Lier
60,Mechelsesteenweg 365,2018-09-29,18:00:00,34,10,24,FMN GV 05 Lier
60,Mechelsesteenweg 365,2018-09-29,19:00:00,22,2,20,FMN GV 05 Lier
60,Mechelsesteenweg 365,2018-09-29,20:00:00,10,6,4,FMN GV 05 Lier
60,Mechelsesteenweg 365,2018-09-29,21:00:00,2,2,0,FMN GV 05 Lier
60,Mechelsesteenweg 365,2018-09-29,22:00:00,4,0,4,FMN GV 05 Lier
60,Mechelsesteenweg 365,2018-09-29,23:00:00,4,2,2,FMN GV 05 Lier
60,Mechelsesteenweg 365,2018-09-30,00:00:00,0,0,0,FMN GV 05 Lier
60,Mechelsesteenweg 365,2018-09-30,01:00:00,4,4,0,FMN GV 05 Lier
60,Mechelsesteenweg 365,2018-09-30,02:00:00,2,2,0,FMN GV 05 Lier
60,Mechelsesteenweg 365,2018-09-30,03:00:00,4,2,2,FMN GV 05 Lier
60,Mechelsesteenweg 365,2018-09-30,04:00:00,0,0,0,FMN GV 05 Lier
60,Mechelsesteenweg 365,2018-09-30,05:00:00,0,0,0,FMN GV 05 Lier
60,Mechelsesteenweg 365,2018-09-30,06:00:00,2,2,0,FMN GV 05 Lier
60,Mechelsesteenweg 365,2018-09-30,07:00:00,8,2,6,FMN GV 05 Lier
60,Mechelsesteenweg 365,2018-09-30,08:00:00,44,18,26,FMN GV 05 Lier
60,Mechelsesteenweg 365,2018-09-30,09:00:00,100,54,46,FMN GV 05 Lier
60,Mechelsesteenweg 365,2018-09-30,10:00:00,268,160,108,FMN GV 05 Lier
60,Mechelsesteenweg 365,2018-09-30,11:00:00,350,172,178,FMN GV 05 Lier
60,Mechelsesteenweg 365,2018-09-30,12:00:00,160,64,96,FMN GV 05 Lier
60,Mechelsesteenweg 365,2018-09-30,13:00:00,220,100,120,FMN GV 05 Lier
60,Mechelsesteenweg 365,2018-09-30,14:00:00,292,174,118,FMN GV 05 Lier
60,Mechelsesteenweg 365,2018-09-30,15:00:00,320,118,202,FMN GV 05 Lier
60,Mechelsesteenweg 365,2018-09-30,16:00:00,182,48,134,FMN GV 05 Lier
60,Mechelsesteenweg 365,2018-09-30,17:00:00,94,30,64,FMN GV 05 Lier
60,Mechelsesteenweg 365,2018-09-30,18:00:00,34,14,20,FMN GV 05 Lier
60,Mechelsesteenweg 365,2018-09-30,19:00:00,20,4,16,FMN GV 05 Lier
60,Mechelsesteenweg 365,2018-09-30,20:00:00,2,2,0,FMN GV 05 Lier
60,Mechelsesteenweg 365,2018-09-30,21:00:00,4,2,2,FMN GV 05 Lier
60,Mechelsesteenweg 365,2018-09-30,22:00:00,2,0,2,FMN GV 05 Lier
60,Mechelsesteenweg 365,2018-09-30,23:00:00,4,0,4,FMN GV 05 Lier
60,Mechelsesteenweg 365,2018-10-01,00:00:00,0,0,0,FMN GV 05 Lier
60,Mechelsesteenweg 365,2018-10-01,01:00:00,2,0,2,FMN GV 05 Lier
60,Mechelsesteenweg 365,2018-10-01,02:00:00,0,0,0,FMN GV 05 Lier
60,Mechelsesteenweg 365,2018-10-01,03:00:00,0,0,0,FMN GV 05 Lier
60,Mechelsesteenweg 365,2018-10-01,04:00:00,0,0,0,FMN GV 05 Lier
60,Mechelsesteenweg 365,2018-10-01,05:00:00,6,4,2,FMN GV 05 Lier
60,Mechelsesteenweg 365,2018-10-01,06:00:00,4,2,2,FMN GV 05 Lier
60,Mechelsesteenweg 365,2018-10-01,07:00:00,140,90,50,FMN GV 05 Lier
60,Mechelsesteenweg 365,2018-10-01,08:00:00,114,64,50,FMN GV 05 Lier
60,Mechelsesteenweg 365,2018-10-01,09:00:00,80,60,20,FMN GV 05 Lier
60,Mechelsesteenweg 365,2018-10-01,10:00:00,22,12,10,FMN GV 05 Lier
60,Mechelsesteenweg 365,2018-10-01,11:00:00,22,10,12,FMN GV 05 Lier
60,Mechelsesteenweg 365,2018-10-01,12:00:00,26,16,10,FMN GV 05 Lier
60,Mechelsesteenweg 365,2018-10-01,13:00:00,4,0,4,FMN GV 05 Lier
60,Mechelsesteenweg 365,2018-10-01,14:00:00,30,14,16,FMN GV 05 Lier
60,Mechelsesteenweg 365,2018-10-01,15:00:00,38,24,14,FMN GV 05 Lier
60,Mechelsesteenweg 365,2018-10-01,16:00:00,158,50,108,FMN GV 05 Lier
60,Mechelsesteenweg 365,2018-10-01,17:00:00,72,28,44,FMN GV 05 Lier
60,Mechelsesteenweg 365,2018-10-01,18:00:00,46,20,26,FMN GV 05 Lier
60,Mechelsesteenweg 365,2018-10-01,19:00:00,16,10,6,FMN GV 05 Lier
60,Mechelsesteenweg 365,2018-10-01,20:00:00,10,6,4,FMN GV 05 Lier
60,Mechelsesteenweg 365,2018-10-01,21:00:00,0,0,0,FMN GV 05 Lier
60,Mechelsesteenweg 365,2018-10-01,22:00:00,2,2,0,FMN GV 05 Lier
60,Mechelsesteenweg 365,2018-10-01,23:00:00,0,0,0,FMN GV 05 Lier
60,Mechelsesteenweg 365,2018-10-02,00:00:00,0,0,0,FMN GV 05 Lier
60,Mechelsesteenweg 365,2018-10-02,01:00:00,0,0,0,FMN GV 05 Lier
60,Mechelsesteenweg 365,2018-10-02,02:00:00,0,0,0,FMN GV 05 Lier
60,Mechelsesteenweg 365,2018-10-02,03:00:00,2,0,2,FMN GV 05 Lier
60,Mechelsesteenweg 365,2018-10-02,04:00:00,2,2,0,FMN GV 05 Lier
60,Mechelsesteenweg 365,2018-10-02,05:00:00,4,2,2,FMN GV 05 Lier
60,Mechelsesteenweg 365,2018-10-02,06:00:00,12,0,12,FMN GV 05 Lier
60,Mechelsesteenweg 365,2018-10-02,07:00:00,156,104,52,FMN GV 05 Lier
60,Mechelsesteenweg 365,2018-10-02,08:00:00,114,58,56,FMN GV 05 Lier
60,Mechelsesteenweg 365,2018-10-02,09:00:00,30,10,20,FMN GV 05 Lier
60,Mechelsesteenweg 365,2018-10-02,10:00:00,26,20,6,FMN GV 05 Lier
60,Mechelsesteenweg 365,2018-10-02,11:00:00,20,8,12,FMN GV 05 Lier
60,Mechelsesteenweg 365,2018-10-02,12:00:00,32,10,22,FMN GV 05 Lier
60,Mechelsesteenweg 365,2018-10-02,13:00:00,32,14,18,FMN GV 05 Lier
60,Mechelsesteenweg 365,2018-10-02,14:00:00,42,28,14,FMN GV 05 Lier
60,Mechelsesteenweg 365,2018-10-02,15:00:00,54,20,34,FMN GV 05 Lier
60,Mechelsesteenweg 365,2018-10-02,16:00:00,154,54,100,FMN GV 05 Lier
60,Mechelsesteenweg 365,2018-10-02,17:00:00,98,52,46,FMN GV 05 Lier
60,Mechelsesteenweg 365,2018-10-02,18:00:00,38,20,18,FMN GV 05 Lier
60,Mechelsesteenweg 365,2018-10-02,19:00:00,28,12,16,FMN GV 05 Lier
60,Mechelsesteenweg 365,2018-10-02,20:00:00,14,2,12,FMN GV 05 Lier
60,Mechelsesteenweg 365,2018-10-02,21:00:00,6,4,2,FMN GV 05 Lier
60,Mechelsesteenweg 365,2018-10-02,22:00:00,4,2,2,FMN GV 05 Lier
60,Mechelsesteenweg 365,2018-10-02,23:00:00,2,2,0,FMN GV 05 Lier
60,Mechelsesteenweg 365,2018-10-03,00:00:00,0,0,0,FMN GV 05 Lier
60,Mechelsesteenweg 365,2018-10-03,01:00:00,0,0,0,FMN GV 05 Lier
60,Mechelsesteenweg 365,2018-10-03,02:00:00,0,0,0,FMN GV 05 Lier
60,Mechelsesteenweg 365,2018-10-03,03:00:00,2,0,2,FMN GV 05 Lier
60,Mechelsesteenweg 365,2018-10-03,04:00:00,4,2,2,FMN GV 05 Lier
60,Mechelsesteenweg 365,2018-10-03,05:00:00,6,2,4,FMN GV 05 Lier
60,Mechelsesteenweg 365,2018-10-03,06:00:00,14,2,12,FMN GV 05 Lier
60,Mechelsesteenweg 365,2018-10-03,07:00:00,94,22,72,FMN GV 05 Lier
60,Mechelsesteenweg 365,2018-10-03,08:00:00,94,32,62,FMN GV 05 Lier
60,Mechelsesteenweg 365,2018-10-03,09:00:00,38,20,18,FMN GV 05 Lier
60,Mechelsesteenweg 365,2018-10-03,10:00:00,76,40,36,FMN GV 05 Lier
60,Mechelsesteenweg 365,2018-10-03,11:00:00,88,26,62,FMN GV 05 Lier
60,Mechelsesteenweg 365,2018-10-03,12:00:00,92,50,42,FMN GV 05 Lier
60,Mechelsesteenweg 365,2018-10-03,13:00:00,126,48,78,FMN GV 05 Lier
60,Mechelsesteenweg 365,2018-10-03,14:00:00,134,96,38,FMN GV 05 Lier
60,Mechelsesteenweg 365,2018-10-03,15:00:00,158,58,100,FMN GV 05 Lier
60,Mechelsesteenweg 365,2018-10-03,16:00:00,148,82,66,FMN GV 05 Lier
60,Mechelsesteenweg 365,2018-10-03,17:00:00,140,74,66,FMN GV 05 Lier
60,Mechelsesteenweg 365,2018-10-03,18:00:00,74,28,46,FMN GV 05 Lier
60,Mechelsesteenweg 365,2018-10-03,19:00:00,40,24,16,FMN GV 05 Lier
60,Mechelsesteenweg 365,2018-10-03,20:00:00,14,8,6,FMN GV 05 Lier
60,Mechelsesteenweg 365,2018-10-03,21:00:00,4,2,2,FMN GV 05 Lier
60,Mechelsesteenweg 365,2018-10-03,22:00:00,2,2,0,FMN GV 05 Lier
60,Mechelsesteenweg 365,2018-10-03,23:00:00,0,0,0,FMN GV 05 Lier
60,Mechelsesteenweg 365,2018-10-04,00:00:00,0,0,0,FMN GV 05 Lier
60,Mechelsesteenweg 365,2018-10-04,01:00:00,2,2,0,FMN GV 05 Lier
60,Mechelsesteenweg 365,2018-10-04,02:00:00,0,0,0,FMN GV 05 Lier
60,Mechelsesteenweg 365,2018-10-04,03:00:00,2,0,2,FMN GV 05 Lier
60,Mechelsesteenweg 365,2018-10-04,04:00:00,2,0,2,FMN GV 05 Lier
60,Mechelsesteenweg 365,2018-10-04,05:00:00,6,2,4,FMN GV 05 Lier
60,Mechelsesteenweg 365,2018-10-04,06:00:00,8,2,6,FMN GV 05 Lier
60,Mechelsesteenweg 365,2018-10-04,07:00:00,160,94,66,FMN GV 05 Lier
60,Mechelsesteenweg 365,2018-10-04,08:00:00,164,98,66,FMN GV 05 Lier
60,Mechelsesteenweg 365,2018-10-04,09:00:00,50,26,24,FMN GV 05 Lier
60,Mechelsesteenweg 365,2018-10-04,10:00:00,58,22,36,FMN GV 05 Lier
60,Mechelsesteenweg 365,2018-10-04,11:00:00,76,36,40,FMN GV 05 Lier
60,Mechelsesteenweg 365,2018-10-04,12:00:00,116,68,48,FMN GV 05 Lier
60,Mechelsesteenweg 365,2018-10-04,13:00:00,118,62,56,FMN GV 05 Lier
60,Mechelsesteenweg 365,2018-10-04,14:00:00,200,100,100,FMN GV 05 Lier
60,Mechelsesteenweg 365,2018-10-04,15:00:00,176,104,72,FMN GV 05 Lier
60,Mechelsesteenweg 365,2018-10-04,16:00:00,302,96,206,FMN GV 05 Lier
60,Mechelsesteenweg 365,2018-10-04,17:00:00,148,68,80,FMN GV 05 Lier
60,Mechelsesteenweg 365,2018-10-04,18:00:00,100,50,50,FMN GV 05 Lier
60,Mechelsesteenweg 365,2018-10-04,19:00:00,42,20,22,FMN GV 05 Lier
60,Mechelsesteenweg 365,2018-10-04,20:00:00,16,10,6,FMN GV 05 Lier
60,Mechelsesteenweg 365,2018-10-04,21:00:00,6,0,6,FMN GV 05 Lier
60,Mechelsesteenweg 365,2018-10-04,22:00:00,18,10,8,FMN GV 05 Lier
60,Mechelsesteenweg 365,2018-10-04,23:00:00,0,0,0,FMN GV 05 Lier
60,Mechelsesteenweg 365,2018-10-05,00:00:00,0,0,0,FMN GV 05 Lier
60,Mechelsesteenweg 365,2018-10-05,01:00:00,2,0,2,FMN GV 05 Lier
60,Mechelsesteenweg 365,2018-10-05,02:00:00,0,0,0,FMN GV 05 Lier
60,Mechelsesteenweg 365,2018-10-05,03:00:00,4,2,2,FMN GV 05 Lier
60,Mechelsesteenweg 365,2018-10-05,04:00:00,0,0,0,FMN GV 05 Lier
60,Mechelsesteenweg 365,2018-10-05,05:00:00,6,2,4,FMN GV 05 Lier
60,Mechelsesteenweg 365,2018-10-05,06:00:00,12,4,8,FMN GV 05 Lier
60,Mechelsesteenweg 365,2018-10-05,07:00:00,154,90,64,FMN GV 05 Lier
60,Mechelsesteenweg 365,2018-10-05,08:00:00,166,100,66,FMN GV 05 Lier
60,Mechelsesteenweg 365,2018-10-05,09:00:00,98,42,56,FMN GV 05 Lier
60,Mechelsesteenweg 365,2018-10-05,10:00:00,66,24,42,FMN GV 05 Lier
60,Mechelsesteenweg 365,2018-10-05,11:00:00,152,74,78,FMN GV 05 Lier
60,Mechelsesteenweg 365,2018-10-05,12:00:00,144,80,64,FMN GV 05 Lier
60,Mechelsesteenweg 365,2018-10-05,13:00:00,238,120,118,FMN GV 05 Lier
60,Mechelsesteenweg 365,2018-10-05,14:00:00,312,192,120,FMN GV 05 Lier
60,Mechelsesteenweg 365,2018-10-05,15:00:00,346,164,182,FMN GV 05 Lier
60,Mechelsesteenweg 365,2018-10-05,16:00:00,296,88,208,FMN GV 05 Lier
60,Mechelsesteenweg 365,2018-10-05,17:00:00,124,60,64,FMN GV 05 Lier
60,Mechelsesteenweg 365,2018-10-05,18:00:00,92,62,30,FMN GV 05 Lier
60,Mechelsesteenweg 365,2018-10-05,19:00:00,44,18,26,FMN GV 05 Lier
60,Mechelsesteenweg 365,2018-10-05,20:00:00,10,4,6,FMN GV 05 Lier
60,Mechelsesteenweg 365,2018-10-05,21:00:00,10,4,6,FMN GV 05 Lier
60,Mechelsesteenweg 365,2018-10-05,22:00:00,2,2,0,FMN GV 05 Lier
60,Mechelsesteenweg 365,2018-10-05,23:00:00,4,4,0,FMN GV 05 Lier
60,Mechelsesteenweg 365,2018-10-06,00:00:00,4,2,2,FMN GV 05 Lier
60,Mechelsesteenweg 365,2018-10-06,01:00:00,0,0,0,FMN GV 05 Lier
60,Mechelsesteenweg 365,2018-10-06,02:00:00,0,0,0,FMN GV 05 Lier
60,Mechelsesteenweg 365,2018-10-06,03:00:00,0,0,0,FMN GV 05 Lier
60,Mechelsesteenweg 365,2018-10-06,04:00:00,0,0,0,FMN GV 05 Lier
60,Mechelsesteenweg 365,2018-10-06,05:00:00,0,0,0,FMN GV 05 Lier
60,Mechelsesteenweg 365,2018-10-06,06:00:00,2,0,2,FMN GV 05 Lier
60,Mechelsesteenweg 365,2018-10-06,07:00:00,10,4,6,FMN GV 05 Lier
60,Mechelsesteenweg 365,2018-10-06,08:00:00,28,18,10,FMN GV 05 Lier
60,Mechelsesteenweg 365,2018-10-06,09:00:00,90,30,60,FMN GV 05 Lier
60,Mechelsesteenweg 365,2018-10-06,10:00:00,182,114,68,FMN GV 05 Lier
60,Mechelsesteenweg 365,2018-10-06,11:00:00,242,108,134,FMN GV 05 Lier
60,Mechelsesteenweg 365,2018-10-06,12:00:00,224,124,100,FMN GV 05 Lier
60,Mechelsesteenweg 365,2018-10-06,13:00:00,330,156,174,FMN GV 05 Lier
60,Mechelsesteenweg 365,2018-10-06,14:00:00,382,208,174,FMN GV 05 Lier
60,Mechelsesteenweg 365,2018-10-06,15:00:00,396,166,230,FMN GV 05 Lier
60,Mechelsesteenweg 365,2018-10-06,16:00:00,282,90,192,FMN GV 05 Lier
60,Mechelsesteenweg 365,2018-10-06,17:00:00,164,68,96,FMN GV 05 Lier
60,Mechelsesteenweg 365,2018-10-06,18:00:00,86,48,38,FMN GV 05 Lier
60,Mechelsesteenweg 365,2018-10-06,19:00:00,46,20,26,FMN GV 05 Lier
60,Mechelsesteenweg 365,2018-10-06,20:00:00,10,4,6,FMN GV 05 Lier
60,Mechelsesteenweg 365,2018-10-06,21:00:00,8,2,6,FMN GV 05 Lier
60,Mechelsesteenweg 365,2018-10-06,22:00:00,4,4,0,FMN GV 05 Lier
60,Mechelsesteenweg 365,2018-10-06,23:00:00,0,0,0,FMN GV 05 Lier
60,Mechelsesteenweg 365,2018-10-07,00:00:00,0,0,0,FMN GV 05 Lier
60,Mechelsesteenweg 365,2018-10-07,01:00:00,0,0,0,FMN GV 05 Lier
60,Mechelsesteenweg 365,2018-10-07,02:00:00,0,0,0,FMN GV 05 Lier
60,Mechelsesteenweg 365,2018-10-07,03:00:00,0,0,0,FMN GV 05 Lier
60,Mechelsesteenweg 365,2018-10-07,04:00:00,10,2,8,FMN GV 05 Lier
60,Mechelsesteenweg 365,2018-10-07,05:00:00,0,0,0,FMN GV 05 Lier
60,Mechelsesteenweg 365,2018-10-07,06:00:00,0,0,0,FMN GV 05 Lier
60,Mechelsesteenweg 365,2018-10-07,07:00:00,4,4,0,FMN GV 05 Lier
60,Mechelsesteenweg 365,2018-10-07,08:00:00,20,14,6,FMN GV 05 Lier
60,Mechelsesteenweg 365,2018-10-07,09:00:00,104,78,26,FMN GV 05 Lier
60,Mechelsesteenweg 365,2018-10-07,10:00:00,148,72,76,FMN GV 05 Lier
60,Mechelsesteenweg 365,2018-10-07,11:00:00,140,70,70,FMN GV 05 Lier
60,Mechelsesteenweg 365,2018-10-07,12:00:00,96,44,52,FMN GV 05 Lier
60,Mechelsesteenweg 365,2018-10-07,13:00:00,92,52,40,FMN GV 05 Lier
60,Mechelsesteenweg 365,2018-10-07,14:00:00,140,54,86,FMN GV 05 Lier
60,Mechelsesteenweg 365,2018-10-07,15:00:00,128,76,52,FMN GV 05 Lier
60,Mechelsesteenweg 365,2018-10-07,16:00:00,138,66,72,FMN GV 05 Lier
60,Mechelsesteenweg 365,2018-10-07,17:00:00,58,24,34,FMN GV 05 Lier
60,Mechelsesteenweg 365,2018-10-07,18:00:00,60,6,54,FMN GV 05 Lier
60,Mechelsesteenweg 365,2018-10-07,19:00:00,18,2,16,FMN GV 05 Lier
60,Mechelsesteenweg 365,2018-10-07,20:00:00,2,2,0,FMN GV 05 Lier
60,Mechelsesteenweg 365,2018-10-07,21:00:00,4,2,2,FMN GV 05 Lier
60,Mechelsesteenweg 365,2018-10-07,22:00:00,2,0,2,FMN GV 05 Lier
60,Mechelsesteenweg 365,2018-10-07,23:00:00,0,0,0,FMN GV 05 Lier
60,Mechelsesteenweg 365,2018-10-08,00:00:00,0,0,0,FMN GV 05 Lier
60,Mechelsesteenweg 365,2018-10-08,01:00:00,0,0,0,FMN GV 05 Lier
60,Mechelsesteenweg 365,2018-10-08,02:00:00,0,0,0,FMN GV 05 Lier
60,Mechelsesteenweg 365,2018-10-08,03:00:00,2,0,2,FMN GV 05 Lier
60,Mechelsesteenweg 365,2018-10-08,04:00:00,0,0,0,FMN GV 05 Lier
60,Mechelsesteenweg 365,2018-10-08,05:00:00,4,0,4,FMN GV 05 Lier
60,Mechelsesteenweg 365,2018-10-08,06:00:00,16,2,14,FMN GV 05 Lier
60,Mechelsesteenweg 365,2018-10-08,07:00:00,176,96,80,FMN GV 05 Lier
60,Mechelsesteenweg 365,2018-10-08,08:00:00,156,90,66,FMN GV 05 Lier
60,Mechelsesteenweg 365,2018-10-08,09:00:00,46,28,18,FMN GV 05 Lier
60,Mechelsesteenweg 365,2018-10-08,10:00:00,62,32,30,FMN GV 05 Lier
60,Mechelsesteenweg 365,2018-10-08,11:00:00,60,24,36,FMN GV 05 Lier
60,Mechelsesteenweg 365,2018-10-08,12:00:00,84,42,42,FMN GV 05 Lier
60,Mechelsesteenweg 365,2018-10-08,13:00:00,100,42,58,FMN GV 05 Lier
60,Mechelsesteenweg 365,2018-10-08,14:00:00,184,98,86,FMN GV 05 Lier
60,Mechelsesteenweg 365,2018-10-08,15:00:00,172,94,78,FMN GV 05 Lier
60,Mechelsesteenweg 365,2018-10-08,16:00:00,232,58,174,FMN GV 05 Lier
60,Mechelsesteenweg 365,2018-10-08,17:00:00,110,58,52,FMN GV 05 Lier
60,Mechelsesteenweg 365,2018-10-08,18:00:00,78,40,38,FMN GV 05 Lier
60,Mechelsesteenweg 365,2018-10-08,19:00:00,26,16,10,FMN GV 05 Lier
60,Mechelsesteenweg 365,2018-10-08,20:00:00,4,2,2,FMN GV 05 Lier
60,Mechelsesteenweg 365,2018-10-08,21:00:00,8,2,6,FMN GV 05 Lier
60,Mechelsesteenweg 365,2018-10-08,22:00:00,0,0,0,FMN GV 05 Lier
60,Mechelsesteenweg 365,2018-10-08,23:00:00,0,0,0,FMN GV 05 Lier
60,Mechelsesteenweg 365,2018-10-09,00:00:00,0,0,0,FMN GV 05 Lier
60,Mechelsesteenweg 365,2018-10-09,01:00:00,0,0,0,FMN GV 05 Lier
60,Mechelsesteenweg 365,2018-10-09,02:00:00,0,0,0,FMN GV 05 Lier
60,Mechelsesteenweg 365,2018-10-09,03:00:00,2,0,2,FMN GV 05 Lier
60,Mechelsesteenweg 365,2018-10-09,04:00:00,2,0,2,FMN GV 05 Lier
60,Mechelsesteenweg 365,2018-10-09,05:00:00,6,4,2,FMN GV 05 Lier
60,Mechelsesteenweg 365,2018-10-09,06:00:00,10,4,6,FMN GV 05 Lier
60,Mechelsesteenweg 365,2018-10-09,07:00:00,196,112,84,FMN GV 05 Lier
60,Mechelsesteenweg 365,2018-10-09,08:00:00,180,106,74,FMN GV 05 Lier
60,Mechelsesteenweg 365,2018-10-09,09:00:00,54,22,32,FMN GV 05 Lier
60,Mechelsesteenweg 365,2018-10-09,10:00:00,102,38,64,FMN GV 05 Lier
60,Mechelsesteenweg 365,2018-10-09,11:00:00,124,74,50,FMN GV 05 Lier
60,Mechelsesteenweg 365,2018-10-09,12:00:00,110,64,46,FMN GV 05 Lier
60,Mechelsesteenweg 365,2018-10-09,13:00:00,158,74,84,FMN GV 05 Lier
60,Mechelsesteenweg 365,2018-10-09,14:00:00,222,120,102,FMN GV 05 Lier
60,Mechelsesteenweg 365,2018-10-09,15:00:00,234,98,136,FMN GV 05 Lier
60,Mechelsesteenweg 365,2018-10-09,16:00:00,284,104,180,FMN GV 05 Lier
60,Mechelsesteenweg 365,2018-10-09,17:00:00,174,86,88,FMN GV 05 Lier
60,Mechelsesteenweg 365,2018-10-09,18:00:00,122,80,42,FMN GV 05 Lier
60,Mechelsesteenweg 365,2018-10-09,19:00:00,42,16,26,FMN GV 05 Lier
60,Mechelsesteenweg 365,2018-10-09,20:00:00,18,6,12,FMN GV 05 Lier
60,Mechelsesteenweg 365,2018-10-09,21:00:00,2,0,2,FMN GV 05 Lier
60,Mechelsesteenweg 365,2018-10-09,22:00:00,2,2,0,FMN GV 05 Lier
60,Mechelsesteenweg 365,2018-10-09,23:00:00,0,0,0,FMN GV 05 Lier
60,Mechelsesteenweg 365,2018-10-10,00:00:00,2,2,0,FMN GV 05 Lier
60,Mechelsesteenweg 365,2018-10-10,01:00:00,2,0,2,FMN GV 05 Lier
60,Mechelsesteenweg 365,2018-10-10,02:00:00,0,0,0,FMN GV 05 Lier
60,Mechelsesteenweg 365,2018-10-10,03:00:00,2,0,2,FMN GV 05 Lier
60,Mechelsesteenweg 365,2018-10-10,04:00:00,0,0,0,FMN GV 05 Lier
60,Mechelsesteenweg 365,2018-10-10,05:00:00,0,0,0,FMN GV 05 Lier
60,Mechelsesteenweg 365,2018-10-10,06:00:00,20,2,18,FMN GV 05 Lier
60,Mechelsesteenweg 365,2018-10-10,07:00:00,192,120,72,FMN GV 05 Lier
60,Mechelsesteenweg 365,2018-10-10,08:00:00,180,102,78,FMN GV 05 Lier
60,Mechelsesteenweg 365,2018-10-10,09:00:00,52,24,28,FMN GV 05 Lier
60,Mechelsesteenweg 365,2018-10-10,10:00:00,88,34,54,FMN GV 05 Lier
60,Mechelsesteenweg 365,2018-10-10,11:00:00,136,72,64,FMN GV 05 Lier
60,Mechelsesteenweg 365,2018-10-10,12:00:00,264,84,180,FMN GV 05 Lier
60,Mechelsesteenweg 365,2018-10-10,13:00:00,276,122,154,FMN GV 05 Lier
60,Mechelsesteenweg 365,2018-10-10,14:00:00,318,178,140,FMN GV 05 Lier
60,Mechelsesteenweg 365,2018-10-10,15:00:00,306,128,178,FMN GV 05 Lier
60,Mechelsesteenweg 365,2018-10-10,16:00:00,236,114,122,FMN GV 05 Lier
60,Mechelsesteenweg 365,2018-10-10,17:00:00,220,104,116,FMN GV 05 Lier
60,Mechelsesteenweg 365,2018-10-10,18:00:00,130,56,74,FMN GV 05 Lier
60,Mechelsesteenweg 365,2018-10-10,19:00:00,62,26,36,FMN GV 05 Lier
60,Mechelsesteenweg 365,2018-10-10,20:00:00,20,4,16,FMN GV 05 Lier
60,Mechelsesteenweg 365,2018-10-10,21:00:00,8,2,6,FMN GV 05 Lier
60,Mechelsesteenweg 365,2018-10-10,22:00:00,2,0,2,FMN GV 05 Lier
60,Mechelsesteenweg 365,2018-10-10,23:00:00,0,0,0,FMN GV 05 Lier
60,Mechelsesteenweg 365,2018-10-11,00:00:00,0,0,0,FMN GV 05 Lier
60,Mechelsesteenweg 365,2018-10-11,01:00:00,0,0,0,FMN GV 05 Lier
60,Mechelsesteenweg 365,2018-10-11,02:00:00,0,0,0,FMN GV 05 Lier
60,Mechelsesteenweg 365,2018-10-11,03:00:00,4,0,4,FMN GV 05 Lier
60,Mechelsesteenweg 365,2018-10-11,04:00:00,0,0,0,FMN GV 05 Lier
60,Mechelsesteenweg 365,2018-10-11,05:00:00,4,2,2,FMN GV 05 Lier
60,Mechelsesteenweg 365,2018-10-11,06:00:00,14,4,10,FMN GV 05 Lier
60,Mechelsesteenweg 365,2018-10-11,07:00:00,164,102,62,FMN GV 05 Lier
60,Mechelsesteenweg 365,2018-10-11,08:00:00,154,100,54,FMN GV 05 Lier
60,Mechelsesteenweg 365,2018-10-11,09:00:00,42,18,24,FMN GV 05 Lier
60,Mechelsesteenweg 365,2018-10-11,10:00:00,30,14,16,FMN GV 05 Lier
60,Mechelsesteenweg 365,2018-10-11,11:00:00,26,14,12,FMN GV 05 Lier
60,Mechelsesteenweg 365,2018-10-11,12:00:00,64,36,28,FMN GV 05 Lier
60,Mechelsesteenweg 365,2018-10-11,13:00:00,184,126,58,FMN GV 05 Lier
60,Mechelsesteenweg 365,2018-10-11,14:00:00,202,106,96,FMN GV 05 Lier
60,Mechelsesteenweg 365,2018-10-11,15:00:00,196,102,94,FMN GV 05 Lier
60,Mechelsesteenweg 365,2018-10-11,16:00:00,316,106,210,FMN GV 05 Lier
60,Mechelsesteenweg 365,2018-10-11,17:00:00,162,80,82,FMN GV 05 Lier
60,Mechelsesteenweg 365,2018-10-11,18:00:00,94,42,52,FMN GV 05 Lier
60,Mechelsesteenweg 365,2018-10-11,19:00:00,58,26,32,FMN GV 05 Lier
60,Mechelsesteenweg 365,2018-10-11,20:00:00,12,8,4,FMN GV 05 Lier
60,Mechelsesteenweg 365,2018-10-11,21:00:00,14,10,4,FMN GV 05 Lier
60,Mechelsesteenweg 365,2018-10-11,22:00:00,6,2,4,FMN GV 05 Lier
60,Mechelsesteenweg 365,2018-10-11,23:00:00,6,0,6,FMN GV 05 Lier
60,Mechelsesteenweg 365,2018-10-12,00:00:00,0,0,0,FMN GV 05 Lier
60,Mechelsesteenweg 365,2018-10-12,01:00:00,0,0,0,FMN GV 05 Lier
60,Mechelsesteenweg 365,2018-10-12,02:00:00,0,0,0,FMN GV 05 Lier
60,Mechelsesteenweg 365,2018-10-12,03:00:00,0,0,0,FMN GV 05 Lier
60,Mechelsesteenweg 365,2018-10-12,04:00:00,2,0,2,FMN GV 05 Lier
60,Mechelsesteenweg 365,2018-10-12,05:00:00,6,2,4,FMN GV 05 Lier
60,Mechelsesteenweg 365,2018-10-12,06:00:00,8,0,8,FMN GV 05 Lier
60,Mechelsesteenweg 365,2018-10-12,07:00:00,150,98,52,FMN GV 05 Lier
60,Mechelsesteenweg 365,2018-10-12,08:00:00,172,106,66,FMN GV 05 Lier
60,Mechelsesteenweg 365,2018-10-12,09:00:00,44,24,20,FMN GV 05 Lier
60,Mechelsesteenweg 365,2018-10-12,10:00:00,66,38,28,FMN GV 05 Lier
60,Mechelsesteenweg 365,2018-10-12,11:00:00,100,44,56,FMN GV 05 Lier
60,Mechelsesteenweg 365,2018-10-12,12:00:00,128,64,64,FMN GV 05 Lier
60,Mechelsesteenweg 365,2018-10-12,13:00:00,136,62,74,FMN GV 05 Lier
60,Mechelsesteenweg 365,2018-10-12,14:00:00,188,106,82,FMN GV 05 Lier
60,Mechelsesteenweg 365,2018-10-12,15:00:00,220,76,144,FMN GV 05 Lier
60,Mechelsesteenweg 365,2018-10-12,16:00:00,258,94,164,FMN GV 05 Lier
60,Mechelsesteenweg 365,2018-10-12,17:00:00,140,64,76,FMN GV 05 Lier
60,Mechelsesteenweg 365,2018-10-12,18:00:00,56,30,26,FMN GV 05 Lier
60,Mechelsesteenweg 365,2018-10-12,19:00:00,20,14,6,FMN GV 05 Lier
60,Mechelsesteenweg 365,2018-10-12,20:00:00,14,0,14,FMN GV 05 Lier
60,Mechelsesteenweg 365,2018-10-12,21:00:00,16,8,8,FMN GV 05 Lier
60,Mechelsesteenweg 365,2018-10-12,22:00:00,4,0,4,FMN GV 05 Lier
60,Mechelsesteenweg 365,2018-10-12,23:00:00,2,2,0,FMN GV 05 Lier
60,Mechelsesteenweg 365,2018-10-13,00:00:00,0,0,0,FMN GV 05 Lier
60,Mechelsesteenweg 365,2018-10-13,01:00:00,4,2,2,FMN GV 05 Lier
60,Mechelsesteenweg 365,2018-10-13,02:00:00,0,0,0,FMN GV 05 Lier
60,Mechelsesteenweg 365,2018-10-13,03:00:00,0,0,0,FMN GV 05 Lier
60,Mechelsesteenweg 365,2018-10-13,04:00:00,0,0,0,FMN GV 05 Lier
60,Mechelsesteenweg 365,2018-10-13,05:00:00,2,2,0,FMN GV 05 Lier
60,Mechelsesteenweg 365,2018-10-13,06:00:00,4,2,2,FMN GV 05 Lier
60,Mechelsesteenweg 365,2018-10-13,07:00:00,14,10,4,FMN GV 05 Lier
60,Mechelsesteenweg 365,2018-10-13,08:00:00,18,4,14,FMN GV 05 Lier
60,Mechelsesteenweg 365,2018-10-13,09:00:00,98,56,42,FMN GV 05 Lier
60,Mechelsesteenweg 365,2018-10-13,10:00:00,242,120,122,FMN GV 05 Lier
60,Mechelsesteenweg 365,2018-10-13,11:00:00,304,158,146,FMN GV 05 Lier
60,Mechelsesteenweg 365,2018-10-13,12:00:00,244,108,136,FMN GV 05 Lier
60,Mechelsesteenweg 365,2018-10-13,13:00:00,332,174,158,FMN GV 05 Lier
60,Mechelsesteenweg 365,2018-10-13,14:00:00,570,348,222,FMN GV 05 Lier
60,Mechelsesteenweg 365,2018-10-13,15:00:00,500,208,292,FMN GV 05 Lier
60,Mechelsesteenweg 365,2018-10-13,16:00:00,408,148,260,FMN GV 05 Lier
60,Mechelsesteenweg 365,2018-10-13,17:00:00,240,86,154,FMN GV 05 Lier
60,Mechelsesteenweg 365,2018-10-13,18:00:00,144,46,98,FMN GV 05 Lier
60,Mechelsesteenweg 365,2018-10-13,19:00:00,42,12,30,FMN GV 05 Lier
60,Mechelsesteenweg 365,2018-10-13,20:00:00,22,8,14,FMN GV 05 Lier
60,Mechelsesteenweg 365,2018-10-13,21:00:00,2,0,2,FMN GV 05 Lier
60,Mechelsesteenweg 365,2018-10-13,22:00:00,6,0,6,FMN GV 05 Lier
60,Mechelsesteenweg 365,2018-10-13,23:00:00,24,2,22,FMN GV 05 Lier
60,Mechelsesteenweg 365,2018-10-14,00:00:00,0,0,0,FMN GV 05 Lier
60,Mechelsesteenweg 365,2018-10-14,01:00:00,0,0,0,FMN GV 05 Lier
60,Mechelsesteenweg 365,2018-10-14,02:00:00,0,0,0,FMN GV 05 Lier
60,Mechelsesteenweg 365,2018-10-14,03:00:00,0,0,0,FMN GV 05 Lier
60,Mechelsesteenweg 365,2018-10-14,04:00:00,0,0,0,FMN GV 05 Lier
60,Mechelsesteenweg 365,2018-10-14,05:00:00,0,0,0,FMN GV 05 Lier
60,Mechelsesteenweg 365,2018-10-14,06:00:00,2,2,0,FMN GV 05 Lier
60,Mechelsesteenweg 365,2018-10-14,07:00:00,10,6,4,FMN GV 05 Lier
60,Mechelsesteenweg 365,2018-10-14,08:00:00,38,18,20,FMN GV 05 Lier
60,Mechelsesteenweg 365,2018-10-14,09:00:00,142,84,58,FMN GV 05 Lier
60,Mechelsesteenweg 365,2018-10-14,10:00:00,228,132,96,FMN GV 05 Lier
60,Mechelsesteenweg 365,2018-10-14,11:00:00,308,134,174,FMN GV 05 Lier
60,Mechelsesteenweg 365,2018-10-14,12:00:00,192,70,122,FMN GV 05 Lier
60,Mechelsesteenweg 365,2018-10-14,13:00:00,226,112,114,FMN GV 05 Lier
60,Mechelsesteenweg 365,2018-10-14,14:00:00,376,212,164,FMN GV 05 Lier
60,Mechelsesteenweg 365,2018-10-14,15:00:00,346,124,222,FMN GV 05 Lier
60,Mechelsesteenweg 365,2018-10-14,16:00:00,276,108,168,FMN GV 05 Lier
60,Mechelsesteenweg 365,2018-10-14,17:00:00,186,60,126,FMN GV 05 Lier
60,Mechelsesteenweg 365,2018-10-14,18:00:00,58,18,40,FMN GV 05 Lier
60,Mechelsesteenweg 365,2018-10-14,19:00:00,40,10,30,FMN GV 05 Lier
60,Mechelsesteenweg 365,2018-10-14,20:00:00,4,0,4,FMN GV 05 Lier
60,Mechelsesteenweg 365,2018-10-14,21:00:00,6,2,4,FMN GV 05 Lier
60,Mechelsesteenweg 365,2018-10-14,22:00:00,6,2,4,FMN GV 05 Lier
60,Mechelsesteenweg 365,2018-10-14,23:00:00,2,0,2,FMN GV 05 Lier
60,Mechelsesteenweg 365,2018-10-15,00:00:00,0,0,0,FMN GV 05 Lier
60,Mechelsesteenweg 365,2018-10-15,01:00:00,2,0,2,FMN GV 05 Lier
60,Mechelsesteenweg 365,2018-10-15,02:00:00,0,0,0,FMN GV 05 Lier
60,Mechelsesteenweg 365,2018-10-15,03:00:00,0,0,0,FMN GV 05 Lier
60,Mechelsesteenweg 365,2018-10-15,04:00:00,2,2,0,FMN GV 05 Lier
60,Mechelsesteenweg 365,2018-10-15,05:00:00,4,2,2,FMN GV 05 Lier
60,Mechelsesteenweg 365,2018-10-15,06:00:00,16,2,14,FMN GV 05 Lier
60,Mechelsesteenweg 365,2018-10-15,07:00:00,148,76,72,FMN GV 05 Lier
60,Mechelsesteenweg 365,2018-10-15,08:00:00,164,106,58,FMN GV 05 Lier
60,Mechelsesteenweg 365,2018-10-15,09:00:00,64,40,24,FMN GV 05 Lier
60,Mechelsesteenweg 365,2018-10-15,10:00:00,58,20,38,FMN GV 05 Lier
60,Mechelsesteenweg 365,2018-10-15,11:00:00,40,24,16,FMN GV 05 Lier
60,Mechelsesteenweg 365,2018-10-15,12:00:00,48,20,28,FMN GV 05 Lier
60,Mechelsesteenweg 365,2018-10-15,13:00:00,120,48,72,FMN GV 05 Lier
60,Mechelsesteenweg 365,2018-10-15,14:00:00,166,76,90,FMN GV 05 Lier
60,Mechelsesteenweg 365,2018-10-15,15:00:00,138,66,72,FMN GV 05 Lier
60,Mechelsesteenweg 365,2018-10-15,16:00:00,282,90,192,FMN GV 05 Lier
60,Mechelsesteenweg 365,2018-10-15,17:00:00,124,66,58,FMN GV 05 Lier
60,Mechelsesteenweg 365,2018-10-15,18:00:00,82,38,44,FMN GV 05 Lier
60,Mechelsesteenweg 365,2018-10-15,19:00:00,16,10,6,FMN GV 05 Lier
60,Mechelsesteenweg 365,2018-10-15,20:00:00,6,6,0,FMN GV 05 Lier
60,Mechelsesteenweg 365,2018-10-15,21:00:00,6,2,4,FMN GV 05 Lier
60,Mechelsesteenweg 365,2018-10-15,22:00:00,2,0,2,FMN GV 05 Lier
60,Mechelsesteenweg 365,2018-10-15,23:00:00,2,2,0,FMN GV 05 Lier
60,Mechelsesteenweg 365,2018-10-16,00:00:00,0,0,0,FMN GV 05 Lier
60,Mechelsesteenweg 365,2018-10-16,01:00:00,0,0,0,FMN GV 05 Lier
60,Mechelsesteenweg 365,2018-10-16,02:00:00,0,0,0,FMN GV 05 Lier
60,Mechelsesteenweg 365,2018-10-16,03:00:00,0,0,0,FMN GV 05 Lier
60,Mechelsesteenweg 365,2018-10-16,04:00:00,4,2,2,FMN GV 05 Lier
60,Mechelsesteenweg 365,2018-10-16,05:00:00,4,2,2,FMN GV 05 Lier
60,Mechelsesteenweg 365,2018-10-16,06:00:00,18,2,16,FMN GV 05 Lier
60,Mechelsesteenweg 365,2018-10-16,07:00:00,184,100,84,FMN GV 05 Lier
60,Mechelsesteenweg 365,2018-10-16,08:00:00,174,102,72,FMN GV 05 Lier
60,Mechelsesteenweg 365,2018-10-16,09:00:00,68,32,36,FMN GV 05 Lier
60,Mechelsesteenweg 365,2018-10-16,10:00:00,124,64,60,FMN GV 05 Lier
60,Mechelsesteenweg 365,2018-10-16,11:00:00,124,60,64,FMN GV 05 Lier
60,Mechelsesteenweg 365,2018-10-16,12:00:00,130,82,48,FMN GV 05 Lier
60,Mechelsesteenweg 365,2018-10-16,13:00:00,296,156,140,FMN GV 05 Lier
60,Mechelsesteenweg 365,2018-10-16,14:00:00,256,144,112,FMN GV 05 Lier
60,Mechelsesteenweg 365,2018-10-16,15:00:00,306,126,180,FMN GV 05 Lier
60,Mechelsesteenweg 365,2018-10-16,16:00:00,356,116,240,FMN GV 05 Lier
60,Mechelsesteenweg 365,2018-10-16,17:00:00,200,92,108,FMN GV 05 Lier
60,Mechelsesteenweg 365,2018-10-16,18:00:00,110,40,70,FMN GV 05 Lier
60,Mechelsesteenweg 365,2018-10-16,19:00:00,22,6,16,FMN GV 05 Lier
60,Mechelsesteenweg 365,2018-10-16,20:00:00,16,4,12,FMN GV 05 Lier
60,Mechelsesteenweg 365,2018-10-16,21:00:00,8,2,6,FMN GV 05 Lier
60,Mechelsesteenweg 365,2018-10-16,22:00:00,14,8,6,FMN GV 05 Lier
60,Mechelsesteenweg 365,2018-10-16,23:00:00,0,0,0,FMN GV 05 Lier
60,Mechelsesteenweg 365,2018-10-17,00:00:00,0,0,0,FMN GV 05 Lier
60,Mechelsesteenweg 365,2018-10-17,01:00:00,0,0,0,FMN GV 05 Lier
60,Mechelsesteenweg 365,2018-10-17,02:00:00,0,0,0,FMN GV 05 Lier
60,Mechelsesteenweg 365,2018-10-17,03:00:00,0,0,0,FMN GV 05 Lier
60,Mechelsesteenweg 365,2018-10-17,04:00:00,4,2,2,FMN GV 05 Lier
60,Mechelsesteenweg 365,2018-10-17,05:00:00,4,2,2,FMN GV 05 Lier
60,Mechelsesteenweg 365,2018-10-17,06:00:00,18,2,16,FMN GV 05 Lier
60,Mechelsesteenweg 365,2018-10-17,07:00:00,196,114,82,FMN GV 05 Lier
60,Mechelsesteenweg 365,2018-10-17,08:00:00,168,84,84,FMN GV 05 Lier
60,Mechelsesteenweg 365,2018-10-17,09:00:00,66,42,24,FMN GV 05 Lier
60,Mechelsesteenweg 365,2018-10-17,10:00:00,74,32,42,FMN GV 05 Lier
60,Mechelsesteenweg 365,2018-10-17,11:00:00,102,36,66,FMN GV 05 Lier
60,Mechelsesteenweg 365,2018-10-17,12:00:00,214,74,140,FMN GV 05 Lier
60,Mechelsesteenweg 365,2018-10-17,13:00:00,202,96,106,FMN GV 05 Lier
60,Mechelsesteenweg 365,2018-10-17,14:00:00,192,110,82,FMN GV 05 Lier
60,Mechelsesteenweg 365,2018-10-17,15:00:00,198,104,94,FMN GV 05 Lier
60,Mechelsesteenweg 365,2018-10-17,16:00:00,214,92,122,FMN GV 05 Lier
60,Mechelsesteenweg 365,2018-10-17,17:00:00,156,88,68,FMN GV 05 Lier
60,Mechelsesteenweg 365,2018-10-17,18:00:00,98,36,62,FMN GV 05 Lier
60,Mechelsesteenweg 365,2018-10-17,19:00:00,44,20,24,FMN GV 05 Lier
60,Mechelsesteenweg 365,2018-10-17,20:00:00,22,16,6,FMN GV 05 Lier
60,Mechelsesteenweg 365,2018-10-17,21:00:00,6,0,6,FMN GV 05 Lier
60,Mechelsesteenweg 365,2018-10-17,22:00:00,4,4,0,FMN GV 05 Lier
60,Mechelsesteenweg 365,2018-10-17,23:00:00,6,2,4,FMN GV 05 Lier
60,Mechelsesteenweg 365,2018-10-18,00:00:00,0,0,0,FMN GV 05 Lier
60,Mechelsesteenweg 365,2018-10-18,01:00:00,0,0,0,FMN GV 05 Lier
60,Mechelsesteenweg 365,2018-10-18,02:00:00,0,0,0,FMN GV 05 Lier
60,Mechelsesteenweg 365,2018-10-18,03:00:00,0,0,0,FMN GV 05 Lier
60,Mechelsesteenweg 365,2018-10-18,04:00:00,2,0,2,FMN GV 05 Lier
60,Mechelsesteenweg 365,2018-10-18,05:00:00,2,2,0,FMN GV 05 Lier
60,Mechelsesteenweg 365,2018-10-18,06:00:00,10,0,10,FMN GV 05 Lier
60,Mechelsesteenweg 365,2018-10-18,07:00:00,168,96,72,FMN GV 05 Lier
60,Mechelsesteenweg 365,2018-10-18,08:00:00,174,120,54,FMN GV 05 Lier
60,Mechelsesteenweg 365,2018-10-18,09:00:00,58,26,32,FMN GV 05 Lier
60,Mechelsesteenweg 365,2018-10-18,10:00:00,76,26,50,FMN GV 05 Lier
60,Mechelsesteenweg 365,2018-10-18,11:00:00,64,34,30,FMN GV 05 Lier
60,Mechelsesteenweg 365,2018-10-18,12:00:00,68,26,42,FMN GV 05 Lier
60,Mechelsesteenweg 365,2018-10-18,13:00:00,86,46,40,FMN GV 05 Lier
60,Mechelsesteenweg 365,2018-10-18,14:00:00,126,50,76,FMN GV 05 Lier
60,Mechelsesteenweg 365,2018-10-18,15:00:00,182,82,100,FMN GV 05 Lier
60,Mechelsesteenweg 365,2018-10-18,16:00:00,330,126,204,FMN GV 05 Lier
60,Mechelsesteenweg 365,2018-10-18,17:00:00,118,52,66,FMN GV 05 Lier
60,Mechelsesteenweg 365,2018-10-18,18:00:00,70,42,28,FMN GV 05 Lier
60,Mechelsesteenweg 365,2018-10-18,19:00:00,32,16,16,FMN GV 05 Lier
60,Mechelsesteenweg 365,2018-10-18,20:00:00,8,6,2,FMN GV 05 Lier
60,Mechelsesteenweg 365,2018-10-18,21:00:00,2,0,2,FMN GV 05 Lier
60,Mechelsesteenweg 365,2018-10-18,22:00:00,8,2,6,FMN GV 05 Lier
60,Mechelsesteenweg 365,2018-10-18,23:00:00,0,0,0,FMN GV 05 Lier
60,Mechelsesteenweg 365,2018-10-19,00:00:00,2,0,2,FMN GV 05 Lier
60,Mechelsesteenweg 365,2018-10-19,01:00:00,0,0,0,FMN GV 05 Lier
60,Mechelsesteenweg 365,2018-10-19,02:00:00,0,0,0,FMN GV 05 Lier
60,Mechelsesteenweg 365,2018-10-19,03:00:00,0,0,0,FMN GV 05 Lier
60,Mechelsesteenweg 365,2018-10-19,04:00:00,2,0,2,FMN GV 05 Lier
60,Mechelsesteenweg 365,2018-10-19,05:00:00,4,2,2,FMN GV 05 Lier
60,Mechelsesteenweg 365,2018-10-19,06:00:00,18,8,10,FMN GV 05 Lier
60,Mechelsesteenweg 365,2018-10-19,07:00:00,174,108,66,FMN GV 05 Lier
60,Mechelsesteenweg 365,2018-10-19,08:00:00,144,82,62,FMN GV 05 Lier
60,Mechelsesteenweg 365,2018-10-19,09:00:00,56,18,38,FMN GV 05 Lier
60,Mechelsesteenweg 365,2018-10-19,10:00:00,70,28,42,FMN GV 05 Lier
60,Mechelsesteenweg 365,2018-10-19,11:00:00,84,30,54,FMN GV 05 Lier
60,Mechelsesteenweg 365,2018-10-19,12:00:00,76,34,42,FMN GV 05 Lier
60,Mechelsesteenweg 365,2018-10-19,13:00:00,116,46,70,FMN GV 05 Lier
60,Mechelsesteenweg 365,2018-10-19,14:00:00,182,108,74,FMN GV 05 Lier
60,Mechelsesteenweg 365,2018-10-19,15:00:00,240,58,182,FMN GV 05 Lier
60,Mechelsesteenweg 365,2018-10-19,16:00:00,242,104,138,FMN GV 05 Lier
60,Mechelsesteenweg 365,2018-10-19,17:00:00,106,48,58,FMN GV 05 Lier
60,Mechelsesteenweg 365,2018-10-19,18:00:00,48,26,22,FMN GV 05 Lier
60,Mechelsesteenweg 365,2018-10-19,19:00:00,10,10,0,FMN GV 05 Lier
60,Mechelsesteenweg 365,2018-10-19,20:00:00,28,16,12,FMN GV 05 Lier
60,Mechelsesteenweg 365,2018-10-19,21:00:00,6,6,0,FMN GV 05 Lier
60,Mechelsesteenweg 365,2018-10-19,22:00:00,38,34,4,FMN GV 05 Lier
60,Mechelsesteenweg 365,2018-10-19,23:00:00,0,0,0,FMN GV 05 Lier
60,Mechelsesteenweg 365,2018-10-20,00:00:00,12,0,12,FMN GV 05 Lier
60,Mechelsesteenweg 365,2018-10-20,01:00:00,8,0,8,FMN GV 05 Lier
60,Mechelsesteenweg 365,2018-10-20,02:00:00,8,0,8,FMN GV 05 Lier
60,Mechelsesteenweg 365,2018-10-20,03:00:00,0,0,0,FMN GV 05 Lier
60,Mechelsesteenweg 365,2018-10-20,04:00:00,2,0,2,FMN GV 05 Lier
60,Mechelsesteenweg 365,2018-10-20,05:00:00,0,0,0,FMN GV 05 Lier
60,Mechelsesteenweg 365,2018-10-20,06:00:00,2,2,0,FMN GV 05 Lier
60,Mechelsesteenweg 365,2018-10-20,07:00:00,12,8,4,FMN GV 05 Lier
60,Mechelsesteenweg 365,2018-10-20,08:00:00,20,6,14,FMN GV 05 Lier
60,Mechelsesteenweg 365,2018-10-20,09:00:00,76,48,28,FMN GV 05 Lier
60,Mechelsesteenweg 365,2018-10-20,10:00:00,140,76,64,FMN GV 05 Lier
60,Mechelsesteenweg 365,2018-10-20,11:00:00,210,74,136,FMN GV 05 Lier
60,Mechelsesteenweg 365,2018-10-20,12:00:00,144,42,102,FMN GV 05 Lier
60,Mechelsesteenweg 365,2018-10-20,13:00:00,236,62,174,FMN GV 05 Lier
60,Mechelsesteenweg 365,2018-10-20,14:00:00,252,96,156,FMN GV 05 Lier
60,Mechelsesteenweg 365,2018-10-20,15:00:00,198,82,116,FMN GV 05 Lier
60,Mechelsesteenweg 365,2018-10-20,16:00:00,176,74,102,FMN GV 05 Lier
60,Mechelsesteenweg 365,2018-10-20,17:00:00,114,34,80,FMN GV 05 Lier
60,Mechelsesteenweg 365,2018-10-20,18:00:00,36,18,18,FMN GV 05 Lier
60,Mechelsesteenweg 365,2018-10-20,19:00:00,10,4,6,FMN GV 05 Lier
60,Mechelsesteenweg 365,2018-10-20,20:00:00,6,0,6,FMN GV 05 Lier
60,Mechelsesteenweg 365,2018-10-20,21:00:00,2,0,2,FMN GV 05 Lier
60,Mechelsesteenweg 365,2018-10-20,22:00:00,10,8,2,FMN GV 05 Lier
60,Mechelsesteenweg 365,2018-10-20,23:00:00,12,0,12,FMN GV 05 Lier
60,Mechelsesteenweg 365,2018-10-21,00:00:00,2,0,2,FMN GV 05 Lier
60,Mechelsesteenweg 365,2018-10-21,01:00:00,0,0,0,FMN GV 05 Lier
60,Mechelsesteenweg 365,2018-10-21,02:00:00,2,2,0,FMN GV 05 Lier
60,Mechelsesteenweg 365,2018-10-21,03:00:00,0,0,0,FMN GV 05 Lier
60,Mechelsesteenweg 365,2018-10-21,04:00:00,0,0,0,FMN GV 05 Lier
60,Mechelsesteenweg 365,2018-10-21,05:00:00,0,0,0,FMN GV 05 Lier
60,Mechelsesteenweg 365,2018-10-21,06:00:00,0,0,0,FMN GV 05 Lier
60,Mechelsesteenweg 365,2018-10-21,07:00:00,6,4,2,FMN GV 05 Lier
60,Mechelsesteenweg 365,2018-10-21,08:00:00,26,16,10,FMN GV 05 Lier
60,Mechelsesteenweg 365,2018-10-21,09:00:00,142,98,44,FMN GV 05 Lier
60,Mechelsesteenweg 365,2018-10-21,10:00:00,328,220,108,FMN GV 05 Lier
60,Mechelsesteenweg 365,2018-10-21,11:00:00,250,132,118,FMN GV 05 Lier
60,Mechelsesteenweg 365,2018-10-21,12:00:00,214,78,136,FMN GV 05 Lier
60,Mechelsesteenweg 365,2018-10-21,13:00:00,244,114,130,FMN GV 05 Lier
60,Mechelsesteenweg 365,2018-10-21,14:00:00,282,140,142,FMN GV 05 Lier
60,Mechelsesteenweg 365,2018-10-21,15:00:00,318,148,170,FMN GV 05 Lier
60,Mechelsesteenweg 365,2018-10-21,16:00:00,266,110,156,FMN GV 05 Lier
60,Mechelsesteenweg 365,2018-10-21,17:00:00,130,36,94,FMN GV 05 Lier
60,Mechelsesteenweg 365,2018-10-21,18:00:00,32,10,22,FMN GV 05 Lier
60,Mechelsesteenweg 365,2018-10-21,19:00:00,26,12,14,FMN GV 05 Lier
60,Mechelsesteenweg 365,2018-10-21,20:00:00,14,0,14,FMN GV 05 Lier
60,Mechelsesteenweg 365,2018-10-21,21:00:00,2,0,2,FMN GV 05 Lier
60,Mechelsesteenweg 365,2018-10-21,22:00:00,0,0,0,FMN GV 05 Lier
60,Mechelsesteenweg 365,2018-10-21,23:00:00,0,0,0,FMN GV 05 Lier
60,Mechelsesteenweg 365,2018-10-22,00:00:00,2,0,2,FMN GV 05 Lier
60,Mechelsesteenweg 365,2018-10-22,01:00:00,0,0,0,FMN GV 05 Lier
60,Mechelsesteenweg 365,2018-10-22,02:00:00,0,0,0,FMN GV 05 Lier
60,Mechelsesteenweg 365,2018-10-22,03:00:00,0,0,0,FMN GV 05 Lier
60,Mechelsesteenweg 365,2018-10-22,04:00:00,6,0,6,FMN GV 05 Lier
60,Mechelsesteenweg 365,2018-10-22,05:00:00,4,0,4,FMN GV 05 Lier
60,Mechelsesteenweg 365,2018-10-22,06:00:00,6,0,6,FMN GV 05 Lier
60,Mechelsesteenweg 365,2018-10-22,07:00:00,124,74,50,FMN GV 05 Lier
60,Mechelsesteenweg 365,2018-10-22,08:00:00,100,50,50,FMN GV 05 Lier
60,Mechelsesteenweg 365,2018-10-22,09:00:00,96,72,24,FMN GV 05 Lier
60,Mechelsesteenweg 365,2018-10-22,10:00:00,60,30,30,FMN GV 05 Lier
60,Mechelsesteenweg 365,2018-10-22,11:00:00,30,8,22,FMN GV 05 Lier
60,Mechelsesteenweg 365,2018-10-22,12:00:00,34,16,18,FMN GV 05 Lier
60,Mechelsesteenweg 365,2018-10-22,13:00:00,52,26,26,FMN GV 05 Lier
60,Mechelsesteenweg 365,2018-10-22,14:00:00,116,86,30,FMN GV 05 Lier
60,Mechelsesteenweg 365,2018-10-22,15:00:00,96,46,50,FMN GV 05 Lier
60,Mechelsesteenweg 365,2018-10-22,16:00:00,212,52,160,FMN GV 05 Lier
60,Mechelsesteenweg 365,2018-10-22,17:00:00,120,50,70,FMN GV 05 Lier
60,Mechelsesteenweg 365,2018-10-22,18:00:00,56,24,32,FMN GV 05 Lier
60,Mechelsesteenweg 365,2018-10-22,19:00:00,6,6,0,FMN GV 05 Lier
60,Mechelsesteenweg 365,2018-10-22,20:00:00,4,4,0,FMN GV 05 Lier
60,Mechelsesteenweg 365,2018-10-22,21:00:00,6,0,6,FMN GV 05 Lier
60,Mechelsesteenweg 365,2018-10-22,22:00:00,0,0,0,FMN GV 05 Lier
60,Mechelsesteenweg 365,2018-10-22,23:00:00,0,0,0,FMN GV 05 Lier
60,Mechelsesteenweg 365,2018-10-23,00:00:00,2,0,2,FMN GV 05 Lier
60,Mechelsesteenweg 365,2018-10-23,01:00:00,0,0,0,FMN GV 05 Lier
60,Mechelsesteenweg 365,2018-10-23,02:00:00,2,0,2,FMN GV 05 Lier
60,Mechelsesteenweg 365,2018-10-23,03:00:00,0,0,0,FMN GV 05 Lier
60,Mechelsesteenweg 365,2018-10-23,04:00:00,2,0,2,FMN GV 05 Lier
60,Mechelsesteenweg 365,2018-10-23,05:00:00,4,2,2,FMN GV 05 Lier
60,Mechelsesteenweg 365,2018-10-23,06:00:00,16,0,16,FMN GV 05 Lier
60,Mechelsesteenweg 365,2018-10-23,07:00:00,180,106,74,FMN GV 05 Lier
60,Mechelsesteenweg 365,2018-10-23,08:00:00,160,102,58,FMN GV 05 Lier
60,Mechelsesteenweg 365,2018-10-23,09:00:00,44,12,32,FMN GV 05 Lier
60,Mechelsesteenweg 365,2018-10-23,10:00:00,50,34,16,FMN GV 05 Lier
60,Mechelsesteenweg 365,2018-10-23,11:00:00,72,40,32,FMN GV 05 Lier
60,Mechelsesteenweg 365,2018-10-23,12:00:00,68,30,38,FMN GV 05 Lier
60,Mechelsesteenweg 365,2018-10-23,13:00:00,138,78,60,FMN GV 05 Lier
60,Mechelsesteenweg 365,2018-10-23,14:00:00,76,54,22,FMN GV 05 Lier
60,Mechelsesteenweg 365,2018-10-23,15:00:00,108,44,64,FMN GV 05 Lier
60,Mechelsesteenweg 365,2018-10-23,16:00:00,226,74,152,FMN GV 05 Lier
60,Mechelsesteenweg 365,2018-10-23,17:00:00,100,48,52,FMN GV 05 Lier
60,Mechelsesteenweg 365,2018-10-23,18:00:00,52,28,24,FMN GV 05 Lier
60,Mechelsesteenweg 365,2018-10-23,19:00:00,30,12,18,FMN GV 05 Lier
60,Mechelsesteenweg 365,2018-10-23,20:00:00,10,8,2,FMN GV 05 Lier
60,Mechelsesteenweg 365,2018-10-23,21:00:00,4,0,4,FMN GV 05 Lier
60,Mechelsesteenweg 365,2018-10-23,22:00:00,6,2,4,FMN GV 05 Lier
60,Mechelsesteenweg 365,2018-10-23,23:00:00,0,0,0,FMN GV 05 Lier
60,Mechelsesteenweg 365,2018-10-24,00:00:00,0,0,0,FMN GV 05 Lier
60,Mechelsesteenweg 365,2018-10-24,01:00:00,0,0,0,FMN GV 05 Lier
60,Mechelsesteenweg 365,2018-10-24,02:00:00,0,0,0,FMN GV 05 Lier
60,Mechelsesteenweg 365,2018-10-24,03:00:00,0,0,0,FMN GV 05 Lier
60,Mechelsesteenweg 365,2018-10-24,04:00:00,6,0,6,FMN GV 05 Lier
60,Mechelsesteenweg 365,2018-10-24,05:00:00,6,2,4,FMN GV 05 Lier
60,Mechelsesteenweg 365,2018-10-24,06:00:00,20,2,18,FMN GV 05 Lier
60,Mechelsesteenweg 365,2018-10-24,07:00:00,170,98,72,FMN GV 05 Lier
60,Mechelsesteenweg 365,2018-10-24,08:00:00,152,110,42,FMN GV 05 Lier
60,Mechelsesteenweg 365,2018-10-24,09:00:00,32,12,20,FMN GV 05 Lier
60,Mechelsesteenweg 365,2018-10-24,10:00:00,30,16,14,FMN GV 05 Lier
60,Mechelsesteenweg 365,2018-10-24,11:00:00,52,22,30,FMN GV 05 Lier
60,Mechelsesteenweg 365,2018-10-24,12:00:00,210,50,160,FMN GV 05 Lier
60,Mechelsesteenweg 365,2018-10-24,13:00:00,98,54,44,FMN GV 05 Lier
60,Mechelsesteenweg 365,2018-10-24,14:00:00,60,36,24,FMN GV 05 Lier
60,Mechelsesteenweg 365,2018-10-24,15:00:00,72,42,30,FMN GV 05 Lier
60,Mechelsesteenweg 365,2018-10-24,16:00:00,66,36,30,FMN GV 05 Lier
60,Mechelsesteenweg 365,2018-10-24,17:00:00,96,50,46,FMN GV 05 Lier
60,Mechelsesteenweg 365,2018-10-24,18:00:00,42,24,18,FMN GV 05 Lier
60,Mechelsesteenweg 365,2018-10-24,19:00:00,18,6,12,FMN GV 05 Lier
60,Mechelsesteenweg 365,2018-10-24,20:00:00,4,4,0,FMN GV 05 Lier
60,Mechelsesteenweg 365,2018-10-24,21:00:00,8,2,6,FMN GV 05 Lier
60,Mechelsesteenweg 365,2018-10-24,22:00:00,0,0,0,FMN GV 05 Lier
60,Mechelsesteenweg 365,2018-10-24,23:00:00,0,0,0,FMN GV 05 Lier
60,Mechelsesteenweg 365,2018-10-25,00:00:00,2,2,0,FMN GV 05 Lier
60,Mechelsesteenweg 365,2018-10-25,01:00:00,0,0,0,FMN GV 05 Lier
60,Mechelsesteenweg 365,2018-10-25,02:00:00,0,0,0,FMN GV 05 Lier
60,Mechelsesteenweg 365,2018-10-25,03:00:00,0,0,0,FMN GV 05 Lier
60,Mechelsesteenweg 365,2018-10-25,04:00:00,6,0,6,FMN GV 05 Lier
60,Mechelsesteenweg 365,2018-10-25,05:00:00,6,0,6,FMN GV 05 Lier
60,Mechelsesteenweg 365,2018-10-25,06:00:00,18,4,14,FMN GV 05 Lier
60,Mechelsesteenweg 365,2018-10-25,07:00:00,112,66,46,FMN GV 05 Lier
60,Mechelsesteenweg 365,2018-10-25,08:00:00,162,100,62,FMN GV 05 Lier
60,Mechelsesteenweg 365,2018-10-25,09:00:00,36,12,24,FMN GV 05 Lier
60,Mechelsesteenweg 365,2018-10-25,10:00:00,36,10,26,FMN GV 05 Lier
60,Mechelsesteenweg 365,2018-10-25,11:00:00,34,8,26,FMN GV 05 Lier
60,Mechelsesteenweg 365,2018-10-25,12:00:00,48,24,24,FMN GV 05 Lier
60,Mechelsesteenweg 365,2018-10-25,13:00:00,60,44,16,FMN GV 05 Lier
60,Mechelsesteenweg 365,2018-10-25,14:00:00,126,56,70,FMN GV 05 Lier
60,Mechelsesteenweg 365,2018-10-25,15:00:00,120,66,54,FMN GV 05 Lier
60,Mechelsesteenweg 365,2018-10-25,16:00:00,214,68,146,FMN GV 05 Lier
60,Mechelsesteenweg 365,2018-10-25,17:00:00,106,60,46,FMN GV 05 Lier
60,Mechelsesteenweg 365,2018-10-25,18:00:00,60,36,24,FMN GV 05 Lier
60,Mechelsesteenweg 365,2018-10-25,19:00:00,18,8,10,FMN GV 05 Lier
60,Mechelsesteenweg 365,2018-10-25,20:00:00,10,8,2,FMN GV 05 Lier
60,Mechelsesteenweg 365,2018-10-25,21:00:00,4,2,2,FMN GV 05 Lier
60,Mechelsesteenweg 365,2018-10-25,22:00:00,0,0,0,FMN GV 05 Lier
60,Mechelsesteenweg 365,2018-10-25,23:00:00,2,2,0,FMN GV 05 Lier
60,Mechelsesteenweg 365,2018-10-26,00:00:00,0,0,0,FMN GV 05 Lier
60,Mechelsesteenweg 365,2018-10-26,01:00:00,0,0,0,FMN GV 05 Lier
60,Mechelsesteenweg 365,2018-10-26,02:00:00,0,0,0,FMN GV 05 Lier
60,Mechelsesteenweg 365,2018-10-26,03:00:00,0,0,0,FMN GV 05 Lier
60,Mechelsesteenweg 365,2018-10-26,04:00:00,4,0,4,FMN GV 05 Lier
60,Mechelsesteenweg 365,2018-10-26,05:00:00,8,0,8,FMN GV 05 Lier
60,Mechelsesteenweg 365,2018-10-26,06:00:00,14,4,10,FMN GV 05 Lier
60,Mechelsesteenweg 365,2018-10-26,07:00:00,128,74,54,FMN GV 05 Lier
60,Mechelsesteenweg 365,2018-10-26,08:00:00,148,102,46,FMN GV 05 Lier
60,Mechelsesteenweg 365,2018-10-26,09:00:00,32,20,12,FMN GV 05 Lier
60,Mechelsesteenweg 365,2018-10-26,10:00:00,38,28,10,FMN GV 05 Lier
60,Mechelsesteenweg 365,2018-10-26,11:00:00,60,26,34,FMN GV 05 Lier
60,Mechelsesteenweg 365,2018-10-26,12:00:00,38,16,22,FMN GV 05 Lier
60,Mechelsesteenweg 365,2018-10-26,13:00:00,42,14,28,FMN GV 05 Lier
60,Mechelsesteenweg 365,2018-10-26,14:00:00,160,130,30,FMN GV 05 Lier
60,Mechelsesteenweg 365,2018-10-26,15:00:00,74,36,38,FMN GV 05 Lier
60,Mechelsesteenweg 365,2018-10-26,16:00:00,156,42,114,FMN GV 05 Lier
60,Mechelsesteenweg 365,2018-10-26,17:00:00,34,18,16,FMN GV 05 Lier
60,Mechelsesteenweg 365,2018-10-26,18:00:00,34,16,18,FMN GV 05 Lier
60,Mechelsesteenweg 365,2018-10-26,19:00:00,2,2,0,FMN GV 05 Lier
60,Mechelsesteenweg 365,2018-10-26,20:00:00,4,0,4,FMN GV 05 Lier
60,Mechelsesteenweg 365,2018-10-26,21:00:00,2,2,0,FMN GV 05 Lier
60,Mechelsesteenweg 365,2018-10-26,22:00:00,0,0,0,FMN GV 05 Lier
60,Mechelsesteenweg 365,2018-10-26,23:00:00,4,2,2,FMN GV 05 Lier
60,Mechelsesteenweg 365,2018-10-27,00:00:00,4,0,4,FMN GV 05 Lier
60,Mechelsesteenweg 365,2018-10-27,01:00:00,4,4,0,FMN GV 05 Lier
60,Mechelsesteenweg 365,2018-10-27,02:00:00,0,0,0,FMN GV 05 Lier
60,Mechelsesteenweg 365,2018-10-27,03:00:00,2,2,0,FMN GV 05 Lier
60,Mechelsesteenweg 365,2018-10-27,04:00:00,4,0,4,FMN GV 05 Lier
60,Mechelsesteenweg 365,2018-10-27,05:00:00,0,0,0,FMN GV 05 Lier
60,Mechelsesteenweg 365,2018-10-27,06:00:00,6,2,4,FMN GV 05 Lier
60,Mechelsesteenweg 365,2018-10-27,07:00:00,12,6,6,FMN GV 05 Lier
60,Mechelsesteenweg 365,2018-10-27,08:00:00,8,2,6,FMN GV 05 Lier
60,Mechelsesteenweg 365,2018-10-27,09:00:00,24,14,10,FMN GV 05 Lier
60,Mechelsesteenweg 365,2018-10-27,10:00:00,32,24,8,FMN GV 05 Lier
60,Mechelsesteenweg 365,2018-10-27,11:00:00,42,14,28,FMN GV 05 Lier
60,Mechelsesteenweg 365,2018-10-27,12:00:00,34,20,14,FMN GV 05 Lier
60,Mechelsesteenweg 365,2018-10-27,13:00:00,54,38,16,FMN GV 05 Lier
60,Mechelsesteenweg 365,2018-10-27,14:00:00,90,56,34,FMN GV 05 Lier
60,Mechelsesteenweg 365,2018-10-27,15:00:00,116,66,50,FMN GV 05 Lier
60,Mechelsesteenweg 365,2018-10-27,16:00:00,68,26,42,FMN GV 05 Lier
60,Mechelsesteenweg 365,2018-10-27,17:00:00,32,14,18,FMN GV 05 Lier
60,Mechelsesteenweg 365,2018-10-27,18:00:00,8,2,6,FMN GV 05 Lier
60,Mechelsesteenweg 365,2018-10-27,19:00:00,2,0,2,FMN GV 05 Lier
60,Mechelsesteenweg 365,2018-10-27,20:00:00,2,2,0,FMN GV 05 Lier
60,Mechelsesteenweg 365,2018-10-27,21:00:00,6,2,4,FMN GV 05 Lier
60,Mechelsesteenweg 365,2018-10-27,22:00:00,4,0,4,FMN GV 05 Lier
60,Mechelsesteenweg 365,2018-10-27,23:00:00,20,2,18,FMN GV 05 Lier
60,Mechelsesteenweg 365,2018-10-28,00:00:00,14,2,12,FMN GV 05 Lier
60,Mechelsesteenweg 365,2018-10-28,01:00:00,16,10,6,FMN GV 05 Lier
60,Mechelsesteenweg 365,2018-10-28,02:00:00,6,6,0,FMN GV 05 Lier
60,Mechelsesteenweg 365,2018-10-28,03:00:00,10,8,2,FMN GV 05 Lier
60,Mechelsesteenweg 365,2018-10-28,04:00:00,0,0,0,FMN GV 05 Lier
60,Mechelsesteenweg 365,2018-10-28,05:00:00,0,0,0,FMN GV 05 Lier
60,Mechelsesteenweg 365,2018-10-28,06:00:00,6,4,2,FMN GV 05 Lier
60,Mechelsesteenweg 365,2018-10-28,07:00:00,8,6,2,FMN GV 05 Lier
60,Mechelsesteenweg 365,2018-10-28,08:00:00,50,26,24,FMN GV 05 Lier
60,Mechelsesteenweg 365,2018-10-28,09:00:00,122,68,54,FMN GV 05 Lier
60,Mechelsesteenweg 365,2018-10-28,10:00:00,226,104,122,FMN GV 05 Lier
60,Mechelsesteenweg 365,2018-10-28,11:00:00,170,28,142,FMN GV 05 Lier
60,Mechelsesteenweg 365,2018-10-28,12:00:00,100,56,44,FMN GV 05 Lier
60,Mechelsesteenweg 365,2018-10-28,13:00:00,92,40,52,FMN GV 05 Lier
60,Mechelsesteenweg 365,2018-10-28,14:00:00,78,38,40,FMN GV 05 Lier
60,Mechelsesteenweg 365,2018-10-28,15:00:00,70,20,50,FMN GV 05 Lier
60,Mechelsesteenweg 365,2018-10-28,16:00:00,50,18,32,FMN GV 05 Lier
60,Mechelsesteenweg 365,2018-10-28,17:00:00,24,6,18,FMN GV 05 Lier
60,Mechelsesteenweg 365,2018-10-28,18:00:00,10,2,8,FMN GV 05 Lier
60,Mechelsesteenweg 365,2018-10-28,19:00:00,4,0,4,FMN GV 05 Lier
60,Mechelsesteenweg 365,2018-10-28,20:00:00,0,0,0,FMN GV 05 Lier
60,Mechelsesteenweg 365,2018-10-28,21:00:00,4,2,2,FMN GV 05 Lier
60,Mechelsesteenweg 365,2018-10-28,22:00:00,2,2,0,FMN GV 05 Lier
60,Mechelsesteenweg 365,2018-10-28,23:00:00,0,0,0,FMN GV 05 Lier
60,Mechelsesteenweg 365,2018-10-29,00:00:00,0,0,0,FMN GV 05 Lier
60,Mechelsesteenweg 365,2018-10-29,01:00:00,0,0,0,FMN GV 05 Lier
60,Mechelsesteenweg 365,2018-10-29,02:00:00,0,0,0,FMN GV 05 Lier
60,Mechelsesteenweg 365,2018-10-29,03:00:00,2,0,2,FMN GV 05 Lier
60,Mechelsesteenweg 365,2018-10-29,04:00:00,2,2,0,FMN GV 05 Lier
60,Mechelsesteenweg 365,2018-10-29,05:00:00,4,0,4,FMN GV 05 Lier
60,Mechelsesteenweg 365,2018-10-29,06:00:00,14,2,12,FMN GV 05 Lier
60,Mechelsesteenweg 365,2018-10-29,07:00:00,64,26,38,FMN GV 05 Lier
60,Mechelsesteenweg 365,2018-10-29,08:00:00,54,22,32,FMN GV 05 Lier
60,Mechelsesteenweg 365,2018-10-29,09:00:00,24,8,16,FMN GV 05 Lier
60,Mechelsesteenweg 365,2018-10-29,10:00:00,52,24,28,FMN GV 05 Lier
60,Mechelsesteenweg 365,2018-10-29,11:00:00,36,14,22,FMN GV 05 Lier
60,Mechelsesteenweg 365,2018-10-29,12:00:00,26,14,12,FMN GV 05 Lier
60,Mechelsesteenweg 365,2018-10-29,13:00:00,56,30,26,FMN GV 05 Lier
60,Mechelsesteenweg 365,2018-10-29,14:00:00,28,12,16,FMN GV 05 Lier
60,Mechelsesteenweg 365,2018-10-29,15:00:00,38,24,14,FMN GV 05 Lier
60,Mechelsesteenweg 365,2018-10-29,16:00:00,46,30,16,FMN GV 05 Lier
60,Mechelsesteenweg 365,2018-10-29,17:00:00,58,40,18,FMN GV 05 Lier
60,Mechelsesteenweg 365,2018-10-29,18:00:00,24,14,10,FMN GV 05 Lier
60,Mechelsesteenweg 365,2018-10-29,19:00:00,2,2,0,FMN GV 05 Lier
60,Mechelsesteenweg 365,2018-10-29,20:00:00,2,0,2,FMN GV 05 Lier
60,Mechelsesteenweg 365,2018-10-29,21:00:00,0,0,0,FMN GV 05 Lier
60,Mechelsesteenweg 365,2018-10-29,22:00:00,4,0,4,FMN GV 05 Lier
60,Mechelsesteenweg 365,2018-10-29,23:00:00,2,2,0,FMN GV 05 Lier
60,Mechelsesteenweg 365,2018-10-30,00:00:00,0,0,0,FMN GV 05 Lier
60,Mechelsesteenweg 365,2018-10-30,01:00:00,0,0,0,FMN GV 05 Lier
60,Mechelsesteenweg 365,2018-10-30,02:00:00,0,0,0,FMN GV 05 Lier
60,Mechelsesteenweg 365,2018-10-30,03:00:00,2,0,2,FMN GV 05 Lier
60,Mechelsesteenweg 365,2018-10-30,04:00:00,0,0,0,FMN GV 05 Lier
60,Mechelsesteenweg 365,2018-10-30,05:00:00,4,2,2,FMN GV 05 Lier
60,Mechelsesteenweg 365,2018-10-30,06:00:00,2,2,0,FMN GV 05 Lier
60,Mechelsesteenweg 365,2018-10-30,07:00:00,26,8,18,FMN GV 05 Lier
60,Mechelsesteenweg 365,2018-10-30,08:00:00,26,8,18,FMN GV 05 Lier
60,Mechelsesteenweg 365,2018-10-30,09:00:00,4,2,2,FMN GV 05 Lier
60,Mechelsesteenweg 365,2018-10-30,10:00:00,2,2,0,FMN GV 05 Lier
60,Mechelsesteenweg 365,2018-10-30,11:00:00,24,12,12,FMN GV 05 Lier
60,Mechelsesteenweg 365,2018-10-30,12:00:00,18,10,8,FMN GV 05 Lier
60,Mechelsesteenweg 365,2018-10-30,13:00:00,16,12,4,FMN GV 05 Lier
60,Mechelsesteenweg 365,2018-10-30,14:00:00,4,4,0,FMN GV 05 Lier
60,Mechelsesteenweg 365,2018-10-30,15:00:00,6,0,6,FMN GV 05 Lier
60,Mechelsesteenweg 365,2018-10-30,16:00:00,24,8,16,FMN GV 05 Lier
60,Mechelsesteenweg 365,2018-10-30,17:00:00,26,18,8,FMN GV 05 Lier
60,Mechelsesteenweg 365,2018-10-30,18:00:00,12,8,4,FMN GV 05 Lier
60,Mechelsesteenweg 365,2018-10-30,19:00:00,0,0,0,FMN GV 05 Lier
60,Mechelsesteenweg 365,2018-10-30,20:00:00,4,4,0,FMN GV 05 Lier
60,Mechelsesteenweg 365,2018-10-30,21:00:00,2,2,0,FMN GV 05 Lier
60,Mechelsesteenweg 365,2018-10-30,22:00:00,6,2,4,FMN GV 05 Lier
60,Mechelsesteenweg 365,2018-10-30,23:00:00,2,2,0,FMN GV 05 Lier
60,Mechelsesteenweg 365,2018-10-31,00:00:00,2,0,2,FMN GV 05 Lier
60,Mechelsesteenweg 365,2018-10-31,01:00:00,0,0,0,FMN GV 05 Lier
60,Mechelsesteenweg 365,2018-10-31,02:00:00,0,0,0,FMN GV 05 Lier
60,Mechelsesteenweg 365,2018-10-31,03:00:00,2,0,2,FMN GV 05 Lier
60,Mechelsesteenweg 365,2018-10-31,04:00:00,0,0,0,FMN GV 05 Lier
60,Mechelsesteenweg 365,2018-10-31,05:00:00,6,0,6,FMN GV 05 Lier
60,Mechelsesteenweg 365,2018-10-31,06:00:00,12,0,12,FMN GV 05 Lier
60,Mechelsesteenweg 365,2018-10-31,07:00:00,48,16,32,FMN GV 05 Lier
60,Mechelsesteenweg 365,2018-10-31,08:00:00,38,10,28,FMN GV 05 Lier
60,Mechelsesteenweg 365,2018-10-31,09:00:00,26,12,14,FMN GV 05 Lier
60,Mechelsesteenweg 365,2018-10-31,10:00:00,38,14,24,FMN GV 05 Lier
60,Mechelsesteenweg 365,2018-10-31,11:00:00,76,50,26,FMN GV 05 Lier
60,Mechelsesteenweg 365,2018-10-31,12:00:00,72,32,40,FMN GV 05 Lier
60,Mechelsesteenweg 365,2018-10-31,13:00:00,72,36,36,FMN GV 05 Lier
60,Mechelsesteenweg 365,2018-10-31,14:00:00,110,64,46,FMN GV 05 Lier
60,Mechelsesteenweg 365,2018-10-31,15:00:00,78,42,36,FMN GV 05 Lier
60,Mechelsesteenweg 365,2018-10-31,16:00:00,58,26,32,FMN GV 05 Lier
60,Mechelsesteenweg 365,2018-10-31,17:00:00,62,32,30,FMN GV 05 Lier
60,Mechelsesteenweg 365,2018-10-31,18:00:00,32,18,14,FMN GV 05 Lier
60,Mechelsesteenweg 365,2018-10-31,19:00:00,8,6,2,FMN GV 05 Lier
60,Mechelsesteenweg 365,2018-10-31,20:00:00,4,2,2,FMN GV 05 Lier
60,Mechelsesteenweg 365,2018-10-31,21:00:00,14,6,8,FMN GV 05 Lier
60,Mechelsesteenweg 365,2018-10-31,22:00:00,16,12,4,FMN GV 05 Lier
60,Mechelsesteenweg 365,2018-10-31,23:00:00,6,4,2,FMN GV 05 Lier
60,Mechelsesteenweg 365,2018-11-01,00:00:00,4,2,2,FMN GV 05 Lier
60,Mechelsesteenweg 365,2018-11-01,01:00:00,6,6,0,FMN GV 05 Lier
60,Mechelsesteenweg 365,2018-11-01,02:00:00,6,4,2,FMN GV 05 Lier
60,Mechelsesteenweg 365,2018-11-01,03:00:00,16,0,16,FMN GV 05 Lier
60,Mechelsesteenweg 365,2018-11-01,04:00:00,2,0,2,FMN GV 05 Lier
60,Mechelsesteenweg 365,2018-11-01,05:00:00,0,0,0,FMN GV 05 Lier
60,Mechelsesteenweg 365,2018-11-01,06:00:00,0,0,0,FMN GV 05 Lier
60,Mechelsesteenweg 365,2018-11-01,07:00:00,10,8,2,FMN GV 05 Lier
60,Mechelsesteenweg 365,2018-11-01,08:00:00,16,12,4,FMN GV 05 Lier
60,Mechelsesteenweg 365,2018-11-01,09:00:00,92,48,44,FMN GV 05 Lier
60,Mechelsesteenweg 365,2018-11-01,10:00:00,132,64,68,FMN GV 05 Lier
60,Mechelsesteenweg 365,2018-11-01,11:00:00,106,58,48,FMN GV 05 Lier
60,Mechelsesteenweg 365,2018-11-01,12:00:00,82,44,38,FMN GV 05 Lier
60,Mechelsesteenweg 365,2018-11-01,13:00:00,58,22,36,FMN GV 05 Lier
60,Mechelsesteenweg 365,2018-11-01,14:00:00,32,14,18,FMN GV 05 Lier
60,Mechelsesteenweg 365,2018-11-01,15:00:00,6,4,2,FMN GV 05 Lier
60,Mechelsesteenweg 365,2018-11-01,16:00:00,8,6,2,FMN GV 05 Lier
60,Mechelsesteenweg 365,2018-11-01,17:00:00,8,2,6,FMN GV 05 Lier
60,Mechelsesteenweg 365,2018-11-01,18:00:00,8,4,4,FMN GV 05 Lier
60,Mechelsesteenweg 365,2018-11-01,19:00:00,2,2,0,FMN GV 05 Lier
60,Mechelsesteenweg 365,2018-11-01,20:00:00,2,0,2,FMN GV 05 Lier
60,Mechelsesteenweg 365,2018-11-01,21:00:00,4,0,4,FMN GV 05 Lier
60,Mechelsesteenweg 365,2018-11-01,22:00:00,0,0,0,FMN GV 05 Lier
60,Mechelsesteenweg 365,2018-11-01,23:00:00,0,0,0,FMN GV 05 Lier
60,Mechelsesteenweg 365,2018-11-02,00:00:00,0,0,0,FMN GV 05 Lier
60,Mechelsesteenweg 365,2018-11-02,01:00:00,0,0,0,FMN GV 05 Lier
60,Mechelsesteenweg 365,2018-11-02,02:00:00,0,0,0,FMN GV 05 Lier
60,Mechelsesteenweg 365,2018-11-02,03:00:00,0,0,0,FMN GV 05 Lier
60,Mechelsesteenweg 365,2018-11-02,04:00:00,0,0,0,FMN GV 05 Lier
60,Mechelsesteenweg 365,2018-11-02,05:00:00,0,0,0,FMN GV 05 Lier
60,Mechelsesteenweg 365,2018-11-02,06:00:00,4,4,0,FMN GV 05 Lier
60,Mechelsesteenweg 365,2018-11-02,07:00:00,20,6,14,FMN GV 05 Lier
60,Mechelsesteenweg 365,2018-11-02,08:00:00,18,8,10,FMN GV 05 Lier
60,Mechelsesteenweg 365,2018-11-02,09:00:00,32,20,12,FMN GV 05 Lier
60,Mechelsesteenweg 365,2018-11-02,10:00:00,70,28,42,FMN GV 05 Lier
60,Mechelsesteenweg 365,2018-11-02,11:00:00,96,58,38,FMN GV 05 Lier
60,Mechelsesteenweg 365,2018-11-02,12:00:00,100,54,46,FMN GV 05 Lier
60,Mechelsesteenweg 365,2018-11-02,13:00:00,112,56,56,FMN GV 05 Lier
60,Mechelsesteenweg 365,2018-11-02,14:00:00,176,98,78,FMN GV 05 Lier
60,Mechelsesteenweg 365,2018-11-02,15:00:00,150,70,80,FMN GV 05 Lier
60,Mechelsesteenweg 365,2018-11-02,16:00:00,76,40,36,FMN GV 05 Lier
60,Mechelsesteenweg 365,2018-11-02,17:00:00,52,22,30,FMN GV 05 Lier
60,Mechelsesteenweg 365,2018-11-02,18:00:00,14,4,10,FMN GV 05 Lier
60,Mechelsesteenweg 365,2018-11-02,19:00:00,12,10,2,FMN GV 05 Lier
60,Mechelsesteenweg 365,2018-11-02,20:00:00,10,4,6,FMN GV 05 Lier
60,Mechelsesteenweg 365,2018-11-02,21:00:00,8,2,6,FMN GV 05 Lier
60,Mechelsesteenweg 365,2018-11-02,22:00:00,6,4,2,FMN GV 05 Lier
60,Mechelsesteenweg 365,2018-11-02,23:00:00,2,2,0,FMN GV 05 Lier
60,Mechelsesteenweg 365,2018-11-03,00:00:00,0,0,0,FMN GV 05 Lier
60,Mechelsesteenweg 365,2018-11-03,01:00:00,6,4,2,FMN GV 05 Lier
60,Mechelsesteenweg 365,2018-11-03,02:00:00,2,2,0,FMN GV 05 Lier
60,Mechelsesteenweg 365,2018-11-03,03:00:00,0,0,0,FMN GV 05 Lier
60,Mechelsesteenweg 365,2018-11-03,04:00:00,0,0,0,FMN GV 05 Lier
60,Mechelsesteenweg 365,2018-11-03,05:00:00,0,0,0,FMN GV 05 Lier
60,Mechelsesteenweg 365,2018-11-03,06:00:00,4,2,2,FMN GV 05 Lier
60,Mechelsesteenweg 365,2018-11-03,07:00:00,8,2,6,FMN GV 05 Lier
60,Mechelsesteenweg 365,2018-11-03,08:00:00,12,8,4,FMN GV 05 Lier
60,Mechelsesteenweg 365,2018-11-03,09:00:00,36,14,22,FMN GV 05 Lier
60,Mechelsesteenweg 365,2018-11-03,10:00:00,64,32,32,FMN GV 05 Lier
60,Mechelsesteenweg 365,2018-11-03,11:00:00,96,62,34,FMN GV 05 Lier
60,Mechelsesteenweg 365,2018-11-03,12:00:00,74,38,36,FMN GV 05 Lier
60,Mechelsesteenweg 365,2018-11-03,13:00:00,156,108,48,FMN GV 05 Lier
60,Mechelsesteenweg 365,2018-11-03,14:00:00,136,66,70,FMN GV 05 Lier
60,Mechelsesteenweg 365,2018-11-03,15:00:00,160,74,86,FMN GV 05 Lier
60,Mechelsesteenweg 365,2018-11-03,16:00:00,108,38,70,FMN GV 05 Lier
60,Mechelsesteenweg 365,2018-11-03,17:00:00,40,18,22,FMN GV 05 Lier
60,Mechelsesteenweg 365,2018-11-03,18:00:00,6,0,6,FMN GV 05 Lier
60,Mechelsesteenweg 365,2018-11-03,19:00:00,2,0,2,FMN GV 05 Lier
60,Mechelsesteenweg 365,2018-11-03,20:00:00,2,2,0,FMN GV 05 Lier
60,Mechelsesteenweg 365,2018-11-03,21:00:00,0,0,0,FMN GV 05 Lier
60,Mechelsesteenweg 365,2018-11-03,22:00:00,2,2,0,FMN GV 05 Lier
60,Mechelsesteenweg 365,2018-11-03,23:00:00,0,0,0,FMN GV 05 Lier
60,Mechelsesteenweg 365,2018-11-04,00:00:00,0,0,0,FMN GV 05 Lier
60,Mechelsesteenweg 365,2018-11-04,01:00:00,2,0,2,FMN GV 05 Lier
60,Mechelsesteenweg 365,2018-11-04,02:00:00,0,0,0,FMN GV 05 Lier
60,Mechelsesteenweg 365,2018-11-04,03:00:00,0,0,0,FMN GV 05 Lier
60,Mechelsesteenweg 365,2018-11-04,04:00:00,0,0,0,FMN GV 05 Lier
60,Mechelsesteenweg 365,2018-11-04,05:00:00,0,0,0,FMN GV 05 Lier
60,Mechelsesteenweg 365,2018-11-04,06:00:00,0,0,0,FMN GV 05 Lier
60,Mechelsesteenweg 365,2018-11-04,07:00:00,2,2,0,FMN GV 05 Lier
60,Mechelsesteenweg 365,2018-11-04,08:00:00,32,16,16,FMN GV 05 Lier
60,Mechelsesteenweg 365,2018-11-04,09:00:00,120,78,42,FMN GV 05 Lier
60,Mechelsesteenweg 365,2018-11-04,10:00:00,196,114,82,FMN GV 05 Lier
60,Mechelsesteenweg 365,2018-11-04,11:00:00,302,130,172,FMN GV 05 Lier
60,Mechelsesteenweg 365,2018-11-04,12:00:00,176,60,116,FMN GV 05 Lier
60,Mechelsesteenweg 365,2018-11-04,13:00:00,220,116,104,FMN GV 05 Lier
60,Mechelsesteenweg 365,2018-11-04,14:00:00,262,154,108,FMN GV 05 Lier
60,Mechelsesteenweg 365,2018-11-04,15:00:00,280,130,150,FMN GV 05 Lier
60,Mechelsesteenweg 365,2018-11-04,16:00:00,178,30,148,FMN GV 05 Lier
60,Mechelsesteenweg 365,2018-11-04,17:00:00,60,22,38,FMN GV 05 Lier
60,Mechelsesteenweg 365,2018-11-04,18:00:00,10,4,6,FMN GV 05 Lier
60,Mechelsesteenweg 365,2018-11-04,19:00:00,8,6,2,FMN GV 05 Lier
60,Mechelsesteenweg 365,2018-11-04,20:00:00,4,0,4,FMN GV 05 Lier
60,Mechelsesteenweg 365,2018-11-04,21:00:00,0,0,0,FMN GV 05 Lier
60,Mechelsesteenweg 365,2018-11-04,22:00:00,2,2,0,FMN GV 05 Lier
60,Mechelsesteenweg 365,2018-11-04,23:00:00,0,0,0,FMN GV 05 Lier
60,Mechelsesteenweg 365,2018-11-05,00:00:00,0,0,0,FMN GV 05 Lier
60,Mechelsesteenweg 365,2018-11-05,01:00:00,0,0,0,FMN GV 05 Lier
60,Mechelsesteenweg 365,2018-11-05,02:00:00,0,0,0,FMN GV 05 Lier
60,Mechelsesteenweg 365,2018-11-05,03:00:00,0,0,0,FMN GV 05 Lier
60,Mechelsesteenweg 365,2018-11-05,04:00:00,2,0,2,FMN GV 05 Lier
60,Mechelsesteenweg 365,2018-11-05,05:00:00,10,2,8,FMN GV 05 Lier
60,Mechelsesteenweg 365,2018-11-05,06:00:00,10,0,10,FMN GV 05 Lier
60,Mechelsesteenweg 365,2018-11-05,07:00:00,174,102,72,FMN GV 05 Lier
60,Mechelsesteenweg 365,2018-11-05,08:00:00,128,84,44,FMN GV 05 Lier
60,Mechelsesteenweg 365,2018-11-05,09:00:00,54,30,24,FMN GV 05 Lier
60,Mechelsesteenweg 365,2018-11-05,10:00:00,30,14,16,FMN GV 05 Lier
60,Mechelsesteenweg 365,2018-11-05,11:00:00,60,24,36,FMN GV 05 Lier
60,Mechelsesteenweg 365,2018-11-05,12:00:00,52,26,26,FMN GV 05 Lier
60,Mechelsesteenweg 365,2018-11-05,13:00:00,130,84,46,FMN GV 05 Lier
60,Mechelsesteenweg 365,2018-11-05,14:00:00,152,78,74,FMN GV 05 Lier
60,Mechelsesteenweg 365,2018-11-05,15:00:00,184,64,120,FMN GV 05 Lier
60,Mechelsesteenweg 365,2018-11-05,16:00:00,234,86,148,FMN GV 05 Lier
60,Mechelsesteenweg 365,2018-11-05,17:00:00,108,62,46,FMN GV 05 Lier
60,Mechelsesteenweg 365,2018-11-05,18:00:00,36,24,12,FMN GV 05 Lier
60,Mechelsesteenweg 365,2018-11-05,19:00:00,12,6,6,FMN GV 05 Lier
60,Mechelsesteenweg 365,2018-11-05,20:00:00,4,0,4,FMN GV 05 Lier
60,Mechelsesteenweg 365,2018-11-05,21:00:00,8,2,6,FMN GV 05 Lier
60,Mechelsesteenweg 365,2018-11-05,22:00:00,4,2,2,FMN GV 05 Lier
60,Mechelsesteenweg 365,2018-11-05,23:00:00,0,0,0,FMN GV 05 Lier
60,Mechelsesteenweg 365,2018-11-06,00:00:00,0,0,0,FMN GV 05 Lier
60,Mechelsesteenweg 365,2018-11-06,01:00:00,0,0,0,FMN GV 05 Lier
60,Mechelsesteenweg 365,2018-11-06,02:00:00,0,0,0,FMN GV 05 Lier
60,Mechelsesteenweg 365,2018-11-06,03:00:00,0,0,0,FMN GV 05 Lier
60,Mechelsesteenweg 365,2018-11-06,04:00:00,4,0,4,FMN GV 05 Lier
60,Mechelsesteenweg 365,2018-11-06,05:00:00,6,2,4,FMN GV 05 Lier
60,Mechelsesteenweg 365,2018-11-06,06:00:00,4,0,4,FMN GV 05 Lier
60,Mechelsesteenweg 365,2018-11-06,07:00:00,20,4,16,FMN GV 05 Lier
60,Mechelsesteenweg 365,2018-11-06,08:00:00,16,8,8,FMN GV 05 Lier
60,Mechelsesteenweg 365,2018-11-06,09:00:00,10,4,6,FMN GV 05 Lier
60,Mechelsesteenweg 365,2018-11-06,10:00:00,16,4,12,FMN GV 05 Lier
60,Mechelsesteenweg 365,2018-11-06,11:00:00,44,14,30,FMN GV 05 Lier
60,Mechelsesteenweg 365,2018-11-06,12:00:00,56,14,42,FMN GV 05 Lier
60,Mechelsesteenweg 365,2018-11-06,13:00:00,56,30,26,FMN GV 05 Lier
60,Mechelsesteenweg 365,2018-11-06,14:00:00,76,30,46,FMN GV 05 Lier
60,Mechelsesteenweg 365,2018-11-06,15:00:00,72,28,44,FMN GV 05 Lier
60,Mechelsesteenweg 365,2018-11-06,16:00:00,62,16,46,FMN GV 05 Lier
60,Mechelsesteenweg 365,2018-11-06,17:00:00,18,8,10,FMN GV 05 Lier
60,Mechelsesteenweg 365,2018-11-06,18:00:00,8,4,4,FMN GV 05 Lier
60,Mechelsesteenweg 365,2018-11-06,19:00:00,0,0,0,FMN GV 05 Lier
60,Mechelsesteenweg 365,2018-11-06,20:00:00,4,0,4,FMN GV 05 Lier
60,Mechelsesteenweg 365,2018-11-06,21:00:00,14,0,14,FMN GV 05 Lier
60,Mechelsesteenweg 365,2018-11-06,22:00:00,0,0,0,FMN GV 05 Lier
60,Mechelsesteenweg 365,2018-11-06,23:00:00,0,0,0,FMN GV 05 Lier
60,Mechelsesteenweg 365,2018-11-07,00:00:00,0,0,0,FMN GV 05 Lier
60,Mechelsesteenweg 365,2018-11-07,01:00:00,0,0,0,FMN GV 05 Lier
60,Mechelsesteenweg 365,2018-11-07,02:00:00,0,0,0,FMN GV 05 Lier
60,Mechelsesteenweg 365,2018-11-07,03:00:00,0,0,0,FMN GV 05 Lier
60,Mechelsesteenweg 365,2018-11-07,04:00:00,2,0,2,FMN GV 05 Lier
60,Mechelsesteenweg 365,2018-11-07,05:00:00,2,2,0,FMN GV 05 Lier
60,Mechelsesteenweg 365,2018-11-07,06:00:00,8,2,6,FMN GV 05 Lier
60,Mechelsesteenweg 365,2018-11-07,07:00:00,40,28,12,FMN GV 05 Lier
60,Mechelsesteenweg 365,2018-11-07,08:00:00,54,36,18,FMN GV 05 Lier
60,Mechelsesteenweg 365,2018-11-07,09:00:00,12,10,2,FMN GV 05 Lier
60,Mechelsesteenweg 365,2018-11-07,10:00:00,18,12,6,FMN GV 05 Lier
60,Mechelsesteenweg 365,2018-11-07,11:00:00,16,10,6,FMN GV 05 Lier
60,Mechelsesteenweg 365,2018-11-07,12:00:00,70,16,54,FMN GV 05 Lier
60,Mechelsesteenweg 365,2018-11-07,13:00:00,16,12,4,FMN GV 05 Lier
60,Mechelsesteenweg 365,2018-11-07,14:00:00,10,8,2,FMN GV 05 Lier
60,Mechelsesteenweg 365,2018-11-07,15:00:00,24,6,18,FMN GV 05 Lier
60,Mechelsesteenweg 365,2018-11-07,16:00:00,14,6,8,FMN GV 05 Lier
60,Mechelsesteenweg 365,2018-11-07,17:00:00,12,6,6,FMN GV 05 Lier
60,Mechelsesteenweg 365,2018-11-07,18:00:00,4,2,2,FMN GV 05 Lier
60,Mechelsesteenweg 365,2018-11-07,19:00:00,8,2,6,FMN GV 05 Lier
60,Mechelsesteenweg 365,2018-11-07,20:00:00,2,0,2,FMN GV 05 Lier
60,Mechelsesteenweg 365,2018-11-07,21:00:00,4,0,4,FMN GV 05 Lier
60,Mechelsesteenweg 365,2018-11-07,22:00:00,2,0,2,FMN GV 05 Lier
60,Mechelsesteenweg 365,2018-11-07,23:00:00,0,0,0,FMN GV 05 Lier
60,Mechelsesteenweg 365,2018-11-08,00:00:00,0,0,0,FMN GV 05 Lier
60,Mechelsesteenweg 365,2018-11-08,01:00:00,0,0,0,FMN GV 05 Lier
60,Mechelsesteenweg 365,2018-11-08,02:00:00,0,0,0,FMN GV 05 Lier
60,Mechelsesteenweg 365,2018-11-08,03:00:00,0,0,0,FMN GV 05 Lier
60,Mechelsesteenweg 365,2018-11-08,04:00:00,0,0,0,FMN GV 05 Lier
60,Mechelsesteenweg 365,2018-11-08,05:00:00,0,0,0,FMN GV 05 Lier
60,Mechelsesteenweg 365,2018-11-08,06:00:00,6,0,6,FMN GV 05 Lier
60,Mechelsesteenweg 365,2018-11-08,07:00:00,32,26,6,FMN GV 05 Lier
60,Mechelsesteenweg 365,2018-11-08,08:00:00,52,32,20,FMN GV 05 Lier
60,Mechelsesteenweg 365,2018-11-08,09:00:00,24,12,12,FMN GV 05 Lier
60,Mechelsesteenweg 365,2018-11-08,10:00:00,26,22,4,FMN GV 05 Lier
60,Mechelsesteenweg 365,2018-11-08,11:00:00,32,14,18,FMN GV 05 Lier
60,Mechelsesteenweg 365,2018-11-08,12:00:00,28,10,18,FMN GV 05 Lier
60,Mechelsesteenweg 365,2018-11-08,13:00:00,48,26,22,FMN GV 05 Lier
60,Mechelsesteenweg 365,2018-11-08,14:00:00,144,84,60,FMN GV 05 Lier
60,Mechelsesteenweg 365,2018-11-08,15:00:00,126,66,60,FMN GV 05 Lier
60,Mechelsesteenweg 365,2018-11-08,16:00:00,186,56,130,FMN GV 05 Lier
60,Mechelsesteenweg 365,2018-11-08,17:00:00,86,46,40,FMN GV 05 Lier
60,Mechelsesteenweg 365,2018-11-08,18:00:00,24,14,10,FMN GV 05 Lier
60,Mechelsesteenweg 365,2018-11-08,19:00:00,24,16,8,FMN GV 05 Lier
60,Mechelsesteenweg 365,2018-11-08,20:00:00,4,0,4,FMN GV 05 Lier
60,Mechelsesteenweg 365,2018-11-08,21:00:00,6,4,2,FMN GV 05 Lier
60,Mechelsesteenweg 365,2018-11-08,22:00:00,4,0,4,FMN GV 05 Lier
60,Mechelsesteenweg 365,2018-11-08,23:00:00,0,0,0,FMN GV 05 Lier
60,Mechelsesteenweg 365,2018-11-09,00:00:00,2,0,2,FMN GV 05 Lier
60,Mechelsesteenweg 365,2018-11-09,01:00:00,0,0,0,FMN GV 05 Lier
60,Mechelsesteenweg 365,2018-11-09,02:00:00,0,0,0,FMN GV 05 Lier
60,Mechelsesteenweg 365,2018-11-09,03:00:00,0,0,0,FMN GV 05 Lier
60,Mechelsesteenweg 365,2018-11-09,04:00:00,4,0,4,FMN GV 05 Lier
60,Mechelsesteenweg 365,2018-11-09,05:00:00,4,2,2,FMN GV 05 Lier
60,Mechelsesteenweg 365,2018-11-09,06:00:00,12,4,8,FMN GV 05 Lier
60,Mechelsesteenweg 365,2018-11-09,07:00:00,116,70,46,FMN GV 05 Lier
60,Mechelsesteenweg 365,2018-11-09,08:00:00,112,88,24,FMN GV 05 Lier
60,Mechelsesteenweg 365,2018-11-09,09:00:00,46,22,24,FMN GV 05 Lier
60,Mechelsesteenweg 365,2018-11-09,10:00:00,76,44,32,FMN GV 05 Lier
60,Mechelsesteenweg 365,2018-11-09,11:00:00,82,52,30,FMN GV 05 Lier
60,Mechelsesteenweg 365,2018-11-09,12:00:00,80,40,40,FMN GV 05 Lier
60,Mechelsesteenweg 365,2018-11-09,13:00:00,98,48,50,FMN GV 05 Lier
60,Mechelsesteenweg 365,2018-11-09,14:00:00,94,52,42,FMN GV 05 Lier
60,Mechelsesteenweg 365,2018-11-09,15:00:00,122,36,86,FMN GV 05 Lier
60,Mechelsesteenweg 365,2018-11-09,16:00:00,180,44,136,FMN GV 05 Lier
60,Mechelsesteenweg 365,2018-11-09,17:00:00,58,38,20,FMN GV 05 Lier
60,Mechelsesteenweg 365,2018-11-09,18:00:00,34,20,14,FMN GV 05 Lier
60,Mechelsesteenweg 365,2018-11-09,19:00:00,42,36,6,FMN GV 05 Lier
60,Mechelsesteenweg 365,2018-11-09,20:00:00,6,0,6,FMN GV 05 Lier
60,Mechelsesteenweg 365,2018-11-09,21:00:00,6,0,6,FMN GV 05 Lier
60,Mechelsesteenweg 365,2018-11-09,22:00:00,2,0,2,FMN GV 05 Lier
60,Mechelsesteenweg 365,2018-11-09,23:00:00,4,4,0,FMN GV 05 Lier
60,Mechelsesteenweg 365,2018-11-10,00:00:00,2,2,0,FMN GV 05 Lier
60,Mechelsesteenweg 365,2018-11-10,01:00:00,0,0,0,FMN GV 05 Lier
60,Mechelsesteenweg 365,2018-11-10,02:00:00,0,0,0,FMN GV 05 Lier
60,Mechelsesteenweg 365,2018-11-10,03:00:00,0,0,0,FMN GV 05 Lier
60,Mechelsesteenweg 365,2018-11-10,04:00:00,2,0,2,FMN GV 05 Lier
60,Mechelsesteenweg 365,2018-11-10,05:00:00,2,0,2,FMN GV 05 Lier
60,Mechelsesteenweg 365,2018-11-10,06:00:00,2,0,2,FMN GV 05 Lier
60,Mechelsesteenweg 365,2018-11-10,07:00:00,8,4,4,FMN GV 05 Lier
60,Mechelsesteenweg 365,2018-11-10,08:00:00,6,2,4,FMN GV 05 Lier
60,Mechelsesteenweg 365,2018-11-10,09:00:00,44,18,26,FMN GV 05 Lier
60,Mechelsesteenweg 365,2018-11-10,10:00:00,52,28,24,FMN GV 05 Lier
60,Mechelsesteenweg 365,2018-11-10,11:00:00,40,22,18,FMN GV 05 Lier
60,Mechelsesteenweg 365,2018-11-10,12:00:00,66,42,24,FMN GV 05 Lier
60,Mechelsesteenweg 365,2018-11-10,13:00:00,26,20,6,FMN GV 05 Lier
60,Mechelsesteenweg 365,2018-11-10,14:00:00,12,6,6,FMN GV 05 Lier
60,Mechelsesteenweg 365,2018-11-10,15:00:00,46,10,36,FMN GV 05 Lier
60,Mechelsesteenweg 365,2018-11-10,16:00:00,54,34,20,FMN GV 05 Lier
60,Mechelsesteenweg 365,2018-11-10,17:00:00,12,6,6,FMN GV 05 Lier
60,Mechelsesteenweg 365,2018-11-10,18:00:00,12,4,8,FMN GV 05 Lier
60,Mechelsesteenweg 365,2018-11-10,19:00:00,0,0,0,FMN GV 05 Lier
60,Mechelsesteenweg 365,2018-11-10,20:00:00,2,0,2,FMN GV 05 Lier
60,Mechelsesteenweg 365,2018-11-10,21:00:00,0,0,0,FMN GV 05 Lier
60,Mechelsesteenweg 365,2018-11-10,22:00:00,8,6,2,FMN GV 05 Lier
60,Mechelsesteenweg 365,2018-11-10,23:00:00,8,8,0,FMN GV 05 Lier
60,Mechelsesteenweg 365,2018-11-11,00:00:00,0,0,0,FMN GV 05 Lier
60,Mechelsesteenweg 365,2018-11-11,01:00:00,0,0,0,FMN GV 05 Lier
60,Mechelsesteenweg 365,2018-11-11,02:00:00,0,0,0,FMN GV 05 Lier
60,Mechelsesteenweg 365,2018-11-11,03:00:00,10,8,2,FMN GV 05 Lier
60,Mechelsesteenweg 365,2018-11-11,04:00:00,0,0,0,FMN GV 05 Lier
60,Mechelsesteenweg 365,2018-11-11,05:00:00,12,4,8,FMN GV 05 Lier
60,Mechelsesteenweg 365,2018-11-11,06:00:00,2,2,0,FMN GV 05 Lier
60,Mechelsesteenweg 365,2018-11-11,07:00:00,6,2,4,FMN GV 05 Lier
60,Mechelsesteenweg 365,2018-11-11,08:00:00,6,2,4,FMN GV 05 Lier
60,Mechelsesteenweg 365,2018-11-11,09:00:00,84,30,54,FMN GV 05 Lier
60,Mechelsesteenweg 365,2018-11-11,10:00:00,148,98,50,FMN GV 05 Lier
60,Mechelsesteenweg 365,2018-11-11,11:00:00,114,54,60,FMN GV 05 Lier
60,Mechelsesteenweg 365,2018-11-11,12:00:00,84,24,60,FMN GV 05 Lier
60,Mechelsesteenweg 365,2018-11-11,13:00:00,24,14,10,FMN GV 05 Lier
60,Mechelsesteenweg 365,2018-11-11,14:00:00,26,16,10,FMN GV 05 Lier
60,Mechelsesteenweg 365,2018-11-11,15:00:00,42,16,26,FMN GV 05 Lier
60,Mechelsesteenweg 365,2018-11-11,16:00:00,38,16,22,FMN GV 05 Lier
60,Mechelsesteenweg 365,2018-11-11,17:00:00,20,14,6,FMN GV 05 Lier
60,Mechelsesteenweg 365,2018-11-11,18:00:00,4,4,0,FMN GV 05 Lier
60,Mechelsesteenweg 365,2018-11-11,19:00:00,8,6,2,FMN GV 05 Lier
60,Mechelsesteenweg 365,2018-11-11,20:00:00,2,0,2,FMN GV 05 Lier
60,Mechelsesteenweg 365,2018-11-11,21:00:00,0,0,0,FMN GV 05 Lier
60,Mechelsesteenweg 365,2018-11-11,22:00:00,8,6,2,FMN GV 05 Lier
60,Mechelsesteenweg 365,2018-11-11,23:00:00,2,2,0,FMN GV 05 Lier
60,Mechelsesteenweg 365,2018-11-12,00:00:00,0,0,0,FMN GV 05 Lier
60,Mechelsesteenweg 365,2018-11-12,01:00:00,0,0,0,FMN GV 05 Lier
60,Mechelsesteenweg 365,2018-11-12,02:00:00,0,0,0,FMN GV 05 Lier
60,Mechelsesteenweg 365,2018-11-12,03:00:00,0,0,0,FMN GV 05 Lier
60,Mechelsesteenweg 365,2018-11-12,04:00:00,0,0,0,FMN GV 05 Lier
60,Mechelsesteenweg 365,2018-11-12,05:00:00,2,0,2,FMN GV 05 Lier
60,Mechelsesteenweg 365,2018-11-12,06:00:00,2,0,2,FMN GV 05 Lier
60,Mechelsesteenweg 365,2018-11-12,07:00:00,88,56,32,FMN GV 05 Lier
60,Mechelsesteenweg 365,2018-11-12,08:00:00,86,66,20,FMN GV 05 Lier
60,Mechelsesteenweg 365,2018-11-12,09:00:00,22,12,10,FMN GV 05 Lier
60,Mechelsesteenweg 365,2018-11-12,10:00:00,12,6,6,FMN GV 05 Lier
60,Mechelsesteenweg 365,2018-11-12,11:00:00,10,4,6,FMN GV 05 Lier
60,Mechelsesteenweg 365,2018-11-12,12:00:00,20,8,12,FMN GV 05 Lier
60,Mechelsesteenweg 365,2018-11-12,13:00:00,12,6,6,FMN GV 05 Lier
60,Mechelsesteenweg 365,2018-11-12,14:00:00,24,10,14,FMN GV 05 Lier
60,Mechelsesteenweg 365,2018-11-12,15:00:00,36,16,20,FMN GV 05 Lier
60,Mechelsesteenweg 365,2018-11-12,16:00:00,138,34,104,FMN GV 05 Lier
60,Mechelsesteenweg 365,2018-11-12,17:00:00,62,28,34,FMN GV 05 Lier
60,Mechelsesteenweg 365,2018-11-12,18:00:00,16,8,8,FMN GV 05 Lier
60,Mechelsesteenweg 365,2018-11-12,19:00:00,12,8,4,FMN GV 05 Lier
60,Mechelsesteenweg 365,2018-11-12,20:00:00,12,8,4,FMN GV 05 Lier
60,Mechelsesteenweg 365,2018-11-12,21:00:00,10,0,10,FMN GV 05 Lier
60,Mechelsesteenweg 365,2018-11-12,22:00:00,2,2,0,FMN GV 05 Lier
60,Mechelsesteenweg 365,2018-11-12,23:00:00,0,0,0,FMN GV 05 Lier
60,Mechelsesteenweg 365,2018-11-13,00:00:00,0,0,0,FMN GV 05 Lier
60,Mechelsesteenweg 365,2018-11-13,01:00:00,0,0,0,FMN GV 05 Lier
60,Mechelsesteenweg 365,2018-11-13,02:00:00,0,0,0,FMN GV 05 Lier
60,Mechelsesteenweg 365,2018-11-13,03:00:00,0,0,0,FMN GV 05 Lier
60,Mechelsesteenweg 365,2018-11-13,04:00:00,2,0,2,FMN GV 05 Lier
60,Mechelsesteenweg 365,2018-11-13,05:00:00,8,4,4,FMN GV 05 Lier
60,Mechelsesteenweg 365,2018-11-13,06:00:00,14,4,10,FMN GV 05 Lier
60,Mechelsesteenweg 365,2018-11-13,07:00:00,152,88,64,FMN GV 05 Lier
60,Mechelsesteenweg 365,2018-11-13,08:00:00,142,90,52,FMN GV 05 Lier
60,Mechelsesteenweg 365,2018-11-13,09:00:00,42,20,22,FMN GV 05 Lier
60,Mechelsesteenweg 365,2018-11-13,10:00:00,50,32,18,FMN GV 05 Lier
60,Mechelsesteenweg 365,2018-11-13,11:00:00,28,18,10,FMN GV 05 Lier
60,Mechelsesteenweg 365,2018-11-13,12:00:00,48,24,24,FMN GV 05 Lier
60,Mechelsesteenweg 365,2018-11-13,13:00:00,94,42,52,FMN GV 05 Lier
60,Mechelsesteenweg 365,2018-11-13,14:00:00,58,32,26,FMN GV 05 Lier
60,Mechelsesteenweg 365,2018-11-13,15:00:00,154,50,104,FMN GV 05 Lier
60,Mechelsesteenweg 365,2018-11-13,16:00:00,192,82,110,FMN GV 05 Lier
60,Mechelsesteenweg 365,2018-11-13,17:00:00,84,48,36,FMN GV 05 Lier
60,Mechelsesteenweg 365,2018-11-13,18:00:00,26,16,10,FMN GV 05 Lier
60,Mechelsesteenweg 365,2018-11-13,19:00:00,4,0,4,FMN GV 05 Lier
60,Mechelsesteenweg 365,2018-11-13,20:00:00,10,8,2,FMN GV 05 Lier
60,Mechelsesteenweg 365,2018-11-13,21:00:00,6,2,4,FMN GV 05 Lier
60,Mechelsesteenweg 365,2018-11-13,22:00:00,6,2,4,FMN GV 05 Lier
60,Mechelsesteenweg 365,2018-11-13,23:00:00,0,0,0,FMN GV 05 Lier
60,Mechelsesteenweg 365,2018-11-14,00:00:00,2,0,2,FMN GV 05 Lier
60,Mechelsesteenweg 365,2018-11-14,01:00:00,0,0,0,FMN GV 05 Lier
60,Mechelsesteenweg 365,2018-11-14,02:00:00,0,0,0,FMN GV 05 Lier
60,Mechelsesteenweg 365,2018-11-14,03:00:00,0,0,0,FMN GV 05 Lier
60,Mechelsesteenweg 365,2018-11-14,04:00:00,2,0,2,FMN GV 05 Lier
60,Mechelsesteenweg 365,2018-11-14,05:00:00,6,4,2,FMN GV 05 Lier
60,Mechelsesteenweg 365,2018-11-14,06:00:00,6,0,6,FMN GV 05 Lier
60,Mechelsesteenweg 365,2018-11-14,07:00:00,166,94,72,FMN GV 05 Lier
60,Mechelsesteenweg 365,2018-11-14,08:00:00,132,84,48,FMN GV 05 Lier
60,Mechelsesteenweg 365,2018-11-14,09:00:00,38,30,8,FMN GV 05 Lier
60,Mechelsesteenweg 365,2018-11-14,10:00:00,70,30,40,FMN GV 05 Lier
60,Mechelsesteenweg 365,2018-11-14,11:00:00,70,28,42,FMN GV 05 Lier
60,Mechelsesteenweg 365,2018-11-14,12:00:00,208,50,158,FMN GV 05 Lier
60,Mechelsesteenweg 365,2018-11-14,13:00:00,154,88,66,FMN GV 05 Lier
60,Mechelsesteenweg 365,2018-11-14,14:00:00,204,116,88,FMN GV 05 Lier
60,Mechelsesteenweg 365,2018-11-14,15:00:00,144,66,78,FMN GV 05 Lier
60,Mechelsesteenweg 365,2018-11-14,16:00:00,110,48,62,FMN GV 05 Lier
60,Mechelsesteenweg 365,2018-11-14,17:00:00,84,42,42,FMN GV 05 Lier
60,Mechelsesteenweg 365,2018-11-14,18:00:00,26,16,10,FMN GV 05 Lier
60,Mechelsesteenweg 365,2018-11-14,19:00:00,14,10,4,FMN GV 05 Lier
60,Mechelsesteenweg 365,2018-11-14,20:00:00,10,6,4,FMN GV 05 Lier
60,Mechelsesteenweg 365,2018-11-14,21:00:00,6,0,6,FMN GV 05 Lier
60,Mechelsesteenweg 365,2018-11-14,22:00:00,8,8,0,FMN GV 05 Lier
60,Mechelsesteenweg 365,2018-11-14,23:00:00,0,0,0,FMN GV 05 Lier
60,Mechelsesteenweg 365,2018-11-15,00:00:00,2,0,2,FMN GV 05 Lier
60,Mechelsesteenweg 365,2018-11-15,01:00:00,0,0,0,FMN GV 05 Lier
60,Mechelsesteenweg 365,2018-11-15,02:00:00,0,0,0,FMN GV 05 Lier
60,Mechelsesteenweg 365,2018-11-15,03:00:00,0,0,0,FMN GV 05 Lier
60,Mechelsesteenweg 365,2018-11-15,04:00:00,2,0,2,FMN GV 05 Lier
60,Mechelsesteenweg 365,2018-11-15,05:00:00,2,0,2,FMN GV 05 Lier
60,Mechelsesteenweg 365,2018-11-15,06:00:00,14,2,12,FMN GV 05 Lier
60,Mechelsesteenweg 365,2018-11-15,07:00:00,148,84,64,FMN GV 05 Lier
60,Mechelsesteenweg 365,2018-11-15,08:00:00,128,74,54,FMN GV 05 Lier
60,Mechelsesteenweg 365,2018-11-15,09:00:00,52,26,26,FMN GV 05 Lier
60,Mechelsesteenweg 365,2018-11-15,10:00:00,82,28,54,FMN GV 05 Lier
60,Mechelsesteenweg 365,2018-11-15,11:00:00,78,38,40,FMN GV 05 Lier
60,Mechelsesteenweg 365,2018-11-15,12:00:00,98,56,42,FMN GV 05 Lier
60,Mechelsesteenweg 365,2018-11-15,13:00:00,218,120,98,FMN GV 05 Lier
60,Mechelsesteenweg 365,2018-11-15,14:00:00,232,86,146,FMN GV 05 Lier
60,Mechelsesteenweg 365,2018-11-15,15:00:00,210,76,134,FMN GV 05 Lier
60,Mechelsesteenweg 365,2018-11-15,16:00:00,258,82,176,FMN GV 05 Lier
60,Mechelsesteenweg 365,2018-11-15,17:00:00,82,46,36,FMN GV 05 Lier
60,Mechelsesteenweg 365,2018-11-15,18:00:00,22,14,8,FMN GV 05 Lier
60,Mechelsesteenweg 365,2018-11-15,19:00:00,22,16,6,FMN GV 05 Lier
60,Mechelsesteenweg 365,2018-11-15,20:00:00,10,10,0,FMN GV 05 Lier
60,Mechelsesteenweg 365,2018-11-15,21:00:00,4,2,2,FMN GV 05 Lier
60,Mechelsesteenweg 365,2018-11-15,22:00:00,2,2,0,FMN GV 05 Lier
60,Mechelsesteenweg 365,2018-11-15,23:00:00,0,0,0,FMN GV 05 Lier
60,Mechelsesteenweg 365,2018-11-16,00:00:00,0,0,0,FMN GV 05 Lier
60,Mechelsesteenweg 365,2018-11-16,01:00:00,0,0,0,FMN GV 05 Lier
60,Mechelsesteenweg 365,2018-11-16,02:00:00,0,0,0,FMN GV 05 Lier
60,Mechelsesteenweg 365,2018-11-16,03:00:00,0,0,0,FMN GV 05 Lier
60,Mechelsesteenweg 365,2018-11-16,04:00:00,4,0,4,FMN GV 05 Lier
60,Mechelsesteenweg 365,2018-11-16,05:00:00,6,0,6,FMN GV 05 Lier
60,Mechelsesteenweg 365,2018-11-16,06:00:00,6,0,6,FMN GV 05 Lier
60,Mechelsesteenweg 365,2018-11-16,07:00:00,120,78,42,FMN GV 05 Lier
60,Mechelsesteenweg 365,2018-11-16,08:00:00,128,86,42,FMN GV 05 Lier
60,Mechelsesteenweg 365,2018-11-16,09:00:00,26,12,14,FMN GV 05 Lier
60,Mechelsesteenweg 365,2018-11-16,10:00:00,34,22,12,FMN GV 05 Lier
60,Mechelsesteenweg 365,2018-11-16,11:00:00,34,16,18,FMN GV 05 Lier
60,Mechelsesteenweg 365,2018-11-16,12:00:00,36,22,14,FMN GV 05 Lier
60,Mechelsesteenweg 365,2018-11-16,13:00:00,66,32,34,FMN GV 05 Lier
60,Mechelsesteenweg 365,2018-11-16,14:00:00,46,26,20,FMN GV 05 Lier
60,Mechelsesteenweg 365,2018-11-16,15:00:00,92,34,58,FMN GV 05 Lier
60,Mechelsesteenweg 365,2018-11-16,16:00:00,142,42,100,FMN GV 05 Lier
60,Mechelsesteenweg 365,2018-11-16,17:00:00,36,20,16,FMN GV 05 Lier
60,Mechelsesteenweg 365,2018-11-16,18:00:00,14,6,8,FMN GV 05 Lier
60,Mechelsesteenweg 365,2018-11-16,19:00:00,4,2,2,FMN GV 05 Lier
60,Mechelsesteenweg 365,2018-11-16,20:00:00,6,4,2,FMN GV 05 Lier
60,Mechelsesteenweg 365,2018-11-16,21:00:00,6,2,4,FMN GV 05 Lier
60,Mechelsesteenweg 365,2018-11-16,22:00:00,2,2,0,FMN GV 05 Lier
60,Mechelsesteenweg 365,2018-11-16,23:00:00,2,2,0,FMN GV 05 Lier
60,Mechelsesteenweg 365,2018-11-17,00:00:00,2,0,2,FMN GV 05 Lier
60,Mechelsesteenweg 365,2018-11-17,01:00:00,2,2,0,FMN GV 05 Lier
60,Mechelsesteenweg 365,2018-11-17,02:00:00,4,2,2,FMN GV 05 Lier
60,Mechelsesteenweg 365,2018-11-17,03:00:00,0,0,0,FMN GV 05 Lier
60,Mechelsesteenweg 365,2018-11-17,04:00:00,0,0,0,FMN GV 05 Lier
60,Mechelsesteenweg 365,2018-11-17,05:00:00,0,0,0,FMN GV 05 Lier
60,Mechelsesteenweg 365,2018-11-17,06:00:00,2,0,2,FMN GV 05 Lier
60,Mechelsesteenweg 365,2018-11-17,07:00:00,14,8,6,FMN GV 05 Lier
60,Mechelsesteenweg 365,2018-11-17,08:00:00,16,4,12,FMN GV 05 Lier
60,Mechelsesteenweg 365,2018-11-17,09:00:00,48,24,24,FMN GV 05 Lier
60,Mechelsesteenweg 365,2018-11-17,10:00:00,106,78,28,FMN GV 05 Lier
60,Mechelsesteenweg 365,2018-11-17,11:00:00,118,40,78,FMN GV 05 Lier
60,Mechelsesteenweg 365,2018-11-17,12:00:00,74,14,60,FMN GV 05 Lier
60,Mechelsesteenweg 365,2018-11-17,13:00:00,146,62,84,FMN GV 05 Lier
60,Mechelsesteenweg 365,2018-11-17,14:00:00,168,108,60,FMN GV 05 Lier
60,Mechelsesteenweg 365,2018-11-17,15:00:00,100,26,74,FMN GV 05 Lier
60,Mechelsesteenweg 365,2018-11-17,16:00:00,48,12,36,FMN GV 05 Lier
60,Mechelsesteenweg 365,2018-11-17,17:00:00,32,20,12,FMN GV 05 Lier
60,Mechelsesteenweg 365,2018-11-17,18:00:00,4,0,4,FMN GV 05 Lier
60,Mechelsesteenweg 365,2018-11-17,19:00:00,4,0,4,FMN GV 05 Lier
60,Mechelsesteenweg 365,2018-11-17,20:00:00,0,0,0,FMN GV 05 Lier
60,Mechelsesteenweg 365,2018-11-17,21:00:00,6,0,6,FMN GV 05 Lier
60,Mechelsesteenweg 365,2018-11-17,22:00:00,6,2,4,FMN GV 05 Lier
60,Mechelsesteenweg 365,2018-11-17,23:00:00,2,2,0,FMN GV 05 Lier
60,Mechelsesteenweg 365,2018-11-18,00:00:00,8,4,4,FMN GV 05 Lier
60,Mechelsesteenweg 365,2018-11-18,01:00:00,2,2,0,FMN GV 05 Lier
60,Mechelsesteenweg 365,2018-11-18,02:00:00,2,2,0,FMN GV 05 Lier
60,Mechelsesteenweg 365,2018-11-18,03:00:00,0,0,0,FMN GV 05 Lier
60,Mechelsesteenweg 365,2018-11-18,04:00:00,0,0,0,FMN GV 05 Lier
60,Mechelsesteenweg 365,2018-11-18,05:00:00,0,0,0,FMN GV 05 Lier
60,Mechelsesteenweg 365,2018-11-18,06:00:00,2,2,0,FMN GV 05 Lier
60,Mechelsesteenweg 365,2018-11-18,07:00:00,8,4,4,FMN GV 05 Lier
60,Mechelsesteenweg 365,2018-11-18,08:00:00,32,20,12,FMN GV 05 Lier
60,Mechelsesteenweg 365,2018-11-18,09:00:00,66,48,18,FMN GV 05 Lier
60,Mechelsesteenweg 365,2018-11-18,10:00:00,210,72,138,FMN GV 05 Lier
60,Mechelsesteenweg 365,2018-11-18,11:00:00,216,92,124,FMN GV 05 Lier
60,Mechelsesteenweg 365,2018-11-18,12:00:00,164,60,104,FMN GV 05 Lier
60,Mechelsesteenweg 365,2018-11-18,13:00:00,122,66,56,FMN GV 05 Lier
60,Mechelsesteenweg 365,2018-11-18,14:00:00,134,78,56,FMN GV 05 Lier
60,Mechelsesteenweg 365,2018-11-18,15:00:00,146,64,82,FMN GV 05 Lier
60,Mechelsesteenweg 365,2018-11-18,16:00:00,86,36,50,FMN GV 05 Lier
60,Mechelsesteenweg 365,2018-11-18,17:00:00,46,8,38,FMN GV 05 Lier
60,Mechelsesteenweg 365,2018-11-18,18:00:00,6,4,2,FMN GV 05 Lier
60,Mechelsesteenweg 365,2018-11-18,19:00:00,4,2,2,FMN GV 05 Lier
60,Mechelsesteenweg 365,2018-11-18,20:00:00,8,0,8,FMN GV 05 Lier
60,Mechelsesteenweg 365,2018-11-18,21:00:00,0,0,0,FMN GV 05 Lier
60,Mechelsesteenweg 365,2018-11-18,22:00:00,0,0,0,FMN GV 05 Lier
60,Mechelsesteenweg 365,2018-11-18,23:00:00,2,0,2,FMN GV 05 Lier
60,Mechelsesteenweg 365,2018-11-19,00:00:00,0,0,0,FMN GV 05 Lier
60,Mechelsesteenweg 365,2018-11-19,01:00:00,0,0,0,FMN GV 05 Lier
60,Mechelsesteenweg 365,2018-11-19,02:00:00,0,0,0,FMN GV 05 Lier
60,Mechelsesteenweg 365,2018-11-19,03:00:00,2,0,2,FMN GV 05 Lier
60,Mechelsesteenweg 365,2018-11-19,04:00:00,2,0,2,FMN GV 05 Lier
60,Mechelsesteenweg 365,2018-11-19,05:00:00,10,2,8,FMN GV 05 Lier
60,Mechelsesteenweg 365,2018-11-19,06:00:00,10,2,8,FMN GV 05 Lier
60,Mechelsesteenweg 365,2018-11-19,07:00:00,154,88,66,FMN GV 05 Lier
60,Mechelsesteenweg 365,2018-11-19,08:00:00,136,86,50,FMN GV 05 Lier
60,Mechelsesteenweg 365,2018-11-19,09:00:00,44,32,12,FMN GV 05 Lier
60,Mechelsesteenweg 365,2018-11-19,10:00:00,28,10,18,FMN GV 05 Lier
60,Mechelsesteenweg 365,2018-11-19,11:00:00,28,18,10,FMN GV 05 Lier
60,Mechelsesteenweg 365,2018-11-19,12:00:00,30,12,18,FMN GV 05 Lier
60,Mechelsesteenweg 365,2018-11-19,13:00:00,32,18,14,FMN GV 05 Lier
60,Mechelsesteenweg 365,2018-11-19,14:00:00,48,22,26,FMN GV 05 Lier
60,Mechelsesteenweg 365,2018-11-19,15:00:00,56,16,40,FMN GV 05 Lier
60,Mechelsesteenweg 365,2018-11-19,16:00:00,158,46,112,FMN GV 05 Lier
60,Mechelsesteenweg 365,2018-11-19,17:00:00,68,38,30,FMN GV 05 Lier
60,Mechelsesteenweg 365,2018-11-19,18:00:00,16,12,4,FMN GV 05 Lier
60,Mechelsesteenweg 365,2018-11-19,19:00:00,4,2,2,FMN GV 05 Lier
60,Mechelsesteenweg 365,2018-11-19,20:00:00,6,2,4,FMN GV 05 Lier
60,Mechelsesteenweg 365,2018-11-19,21:00:00,2,0,2,FMN GV 05 Lier
60,Mechelsesteenweg 365,2018-11-19,22:00:00,4,0,4,FMN GV 05 Lier
60,Mechelsesteenweg 365,2018-11-19,23:00:00,0,0,0,FMN GV 05 Lier
60,Mechelsesteenweg 365,2018-11-20,00:00:00,0,0,0,FMN GV 05 Lier
60,Mechelsesteenweg 365,2018-11-20,01:00:00,0,0,0,FMN GV 05 Lier
60,Mechelsesteenweg 365,2018-11-20,02:00:00,0,0,0,FMN GV 05 Lier
60,Mechelsesteenweg 365,2018-11-20,03:00:00,2,0,2,FMN GV 05 Lier
60,Mechelsesteenweg 365,2018-11-20,04:00:00,2,0,2,FMN GV 05 Lier
60,Mechelsesteenweg 365,2018-11-20,05:00:00,8,0,8,FMN GV 05 Lier
60,Mechelsesteenweg 365,2018-11-20,06:00:00,14,8,6,FMN GV 05 Lier
60,Mechelsesteenweg 365,2018-11-20,07:00:00,104,64,40,FMN GV 05 Lier
60,Mechelsesteenweg 365,2018-11-20,08:00:00,144,96,48,FMN GV 05 Lier
60,Mechelsesteenweg 365,2018-11-20,09:00:00,30,20,10,FMN GV 05 Lier
60,Mechelsesteenweg 365,2018-11-20,10:00:00,24,8,16,FMN GV 05 Lier
60,Mechelsesteenweg 365,2018-11-20,11:00:00,28,16,12,FMN GV 05 Lier
60,Mechelsesteenweg 365,2018-11-20,12:00:00,26,14,12,FMN GV 05 Lier
60,Mechelsesteenweg 365,2018-11-20,13:00:00,46,14,32,FMN GV 05 Lier
60,Mechelsesteenweg 365,2018-11-20,14:00:00,38,26,12,FMN GV 05 Lier
60,Mechelsesteenweg 365,2018-11-20,15:00:00,98,22,76,FMN GV 05 Lier
60,Mechelsesteenweg 365,2018-11-20,16:00:00,144,36,108,FMN GV 05 Lier
60,Mechelsesteenweg 365,2018-11-20,17:00:00,68,36,32,FMN GV 05 Lier
60,Mechelsesteenweg 365,2018-11-20,18:00:00,24,16,8,FMN GV 05 Lier
60,Mechelsesteenweg 365,2018-11-20,19:00:00,4,4,0,FMN GV 05 Lier
60,Mechelsesteenweg 365,2018-11-20,20:00:00,2,2,0,FMN GV 05 Lier
60,Mechelsesteenweg 365,2018-11-20,21:00:00,6,2,4,FMN GV 05 Lier
60,Mechelsesteenweg 365,2018-11-20,22:00:00,0,0,0,FMN GV 05 Lier
60,Mechelsesteenweg 365,2018-11-20,23:00:00,0,0,0,FMN GV 05 Lier
60,Mechelsesteenweg 365,2018-11-21,00:00:00,0,0,0,FMN GV 05 Lier
60,Mechelsesteenweg 365,2018-11-21,01:00:00,0,0,0,FMN GV 05 Lier
60,Mechelsesteenweg 365,2018-11-21,02:00:00,0,0,0,FMN GV 05 Lier
60,Mechelsesteenweg 365,2018-11-21,03:00:00,2,0,2,FMN GV 05 Lier
60,Mechelsesteenweg 365,2018-11-21,04:00:00,4,0,4,FMN GV 05 Lier
60,Mechelsesteenweg 365,2018-11-21,05:00:00,2,0,2,FMN GV 05 Lier
60,Mechelsesteenweg 365,2018-11-21,06:00:00,12,2,10,FMN GV 05 Lier
60,Mechelsesteenweg 365,2018-11-21,07:00:00,114,68,46,FMN GV 05 Lier
60,Mechelsesteenweg 365,2018-11-21,08:00:00,116,82,34,FMN GV 05 Lier
60,Mechelsesteenweg 365,2018-11-21,09:00:00,26,12,14,FMN GV 05 Lier
60,Mechelsesteenweg 365,2018-11-21,10:00:00,20,8,12,FMN GV 05 Lier
60,Mechelsesteenweg 365,2018-11-21,11:00:00,46,18,28,FMN GV 05 Lier
60,Mechelsesteenweg 365,2018-11-21,12:00:00,186,48,138,FMN GV 05 Lier
60,Mechelsesteenweg 365,2018-11-21,13:00:00,78,38,40,FMN GV 05 Lier
60,Mechelsesteenweg 365,2018-11-21,14:00:00,90,46,44,FMN GV 05 Lier
60,Mechelsesteenweg 365,2018-11-21,15:00:00,76,30,46,FMN GV 05 Lier
60,Mechelsesteenweg 365,2018-11-21,16:00:00,70,48,22,FMN GV 05 Lier
60,Mechelsesteenweg 365,2018-11-21,17:00:00,46,34,12,FMN GV 05 Lier
60,Mechelsesteenweg 365,2018-11-21,18:00:00,20,8,12,FMN GV 05 Lier
60,Mechelsesteenweg 365,2018-11-21,19:00:00,12,6,6,FMN GV 05 Lier
60,Mechelsesteenweg 365,2018-11-21,20:00:00,10,2,8,FMN GV 05 Lier
60,Mechelsesteenweg 365,2018-11-21,21:00:00,2,0,2,FMN GV 05 Lier
60,Mechelsesteenweg 365,2018-11-21,22:00:00,2,0,2,FMN GV 05 Lier
60,Mechelsesteenweg 365,2018-11-21,23:00:00,0,0,0,FMN GV 05 Lier
60,Mechelsesteenweg 365,2018-11-22,00:00:00,0,0,0,FMN GV 05 Lier
60,Mechelsesteenweg 365,2018-11-22,01:00:00,0,0,0,FMN GV 05 Lier
60,Mechelsesteenweg 365,2018-11-22,02:00:00,0,0,0,FMN GV 05 Lier
60,Mechelsesteenweg 365,2018-11-22,03:00:00,2,0,2,FMN GV 05 Lier
60,Mechelsesteenweg 365,2018-11-22,04:00:00,2,0,2,FMN GV 05 Lier
60,Mechelsesteenweg 365,2018-11-22,05:00:00,8,2,6,FMN GV 05 Lier
60,Mechelsesteenweg 365,2018-11-22,06:00:00,14,4,10,FMN GV 05 Lier
60,Mechelsesteenweg 365,2018-11-22,07:00:00,90,46,44,FMN GV 05 Lier
60,Mechelsesteenweg 365,2018-11-22,08:00:00,134,80,54,FMN GV 05 Lier
60,Mechelsesteenweg 365,2018-11-22,09:00:00,40,24,16,FMN GV 05 Lier
60,Mechelsesteenweg 365,2018-11-22,10:00:00,42,28,14,FMN GV 05 Lier
60,Mechelsesteenweg 365,2018-11-22,11:00:00,46,20,26,FMN GV 05 Lier
60,Mechelsesteenweg 365,2018-11-22,12:00:00,48,24,24,FMN GV 05 Lier
60,Mechelsesteenweg 365,2018-11-22,13:00:00,106,54,52,FMN GV 05 Lier
60,Mechelsesteenweg 365,2018-11-22,14:00:00,128,82,46,FMN GV 05 Lier
60,Mechelsesteenweg 365,2018-11-22,15:00:00,90,42,48,FMN GV 05 Lier
60,Mechelsesteenweg 365,2018-11-22,16:00:00,204,68,136,FMN GV 05 Lier
60,Mechelsesteenweg 365,2018-11-22,17:00:00,76,42,34,FMN GV 05 Lier
60,Mechelsesteenweg 365,2018-11-22,18:00:00,14,12,2,FMN GV 05 Lier
60,Mechelsesteenweg 365,2018-11-22,19:00:00,26,12,14,FMN GV 05 Lier
60,Mechelsesteenweg 365,2018-11-22,20:00:00,2,2,0,FMN GV 05 Lier
60,Mechelsesteenweg 365,2018-11-22,21:00:00,2,2,0,FMN GV 05 Lier
60,Mechelsesteenweg 365,2018-11-22,22:00:00,2,0,2,FMN GV 05 Lier
60,Mechelsesteenweg 365,2018-11-22,23:00:00,8,6,2,FMN GV 05 Lier
60,Mechelsesteenweg 365,2018-11-23,00:00:00,0,0,0,FMN GV 05 Lier
60,Mechelsesteenweg 365,2018-11-23,01:00:00,0,0,0,FMN GV 05 Lier
60,Mechelsesteenweg 365,2018-11-23,02:00:00,0,0,0,FMN GV 05 Lier
60,Mechelsesteenweg 365,2018-11-23,03:00:00,2,0,2,FMN GV 05 Lier
60,Mechelsesteenweg 365,2018-11-23,04:00:00,2,0,2,FMN GV 05 Lier
60,Mechelsesteenweg 365,2018-11-23,05:00:00,8,0,8,FMN GV 05 Lier
60,Mechelsesteenweg 365,2018-11-23,06:00:00,10,2,8,FMN GV 05 Lier
60,Mechelsesteenweg 365,2018-11-23,07:00:00,106,66,40,FMN GV 05 Lier
60,Mechelsesteenweg 365,2018-11-23,08:00:00,156,110,46,FMN GV 05 Lier
60,Mechelsesteenweg 365,2018-11-23,09:00:00,28,20,8,FMN GV 05 Lier
60,Mechelsesteenweg 365,2018-11-23,10:00:00,50,26,24,FMN GV 05 Lier
60,Mechelsesteenweg 365,2018-11-23,11:00:00,58,24,34,FMN GV 05 Lier
60,Mechelsesteenweg 365,2018-11-23,12:00:00,66,40,26,FMN GV 05 Lier
60,Mechelsesteenweg 365,2018-11-23,13:00:00,118,48,70,FMN GV 05 Lier
60,Mechelsesteenweg 365,2018-11-23,14:00:00,146,84,62,FMN GV 05 Lier
60,Mechelsesteenweg 365,2018-11-23,15:00:00,194,78,116,FMN GV 05 Lier
60,Mechelsesteenweg 365,2018-11-23,16:00:00,170,48,122,FMN GV 05 Lier
60,Mechelsesteenweg 365,2018-11-23,17:00:00,68,46,22,FMN GV 05 Lier
60,Mechelsesteenweg 365,2018-11-23,18:00:00,46,14,32,FMN GV 05 Lier
60,Mechelsesteenweg 365,2018-11-23,19:00:00,12,4,8,FMN GV 05 Lier
60,Mechelsesteenweg 365,2018-11-23,20:00:00,4,2,2,FMN GV 05 Lier
60,Mechelsesteenweg 365,2018-11-23,21:00:00,10,6,4,FMN GV 05 Lier
60,Mechelsesteenweg 365,2018-11-23,22:00:00,4,4,0,FMN GV 05 Lier
60,Mechelsesteenweg 365,2018-11-23,23:00:00,2,2,0,FMN GV 05 Lier
60,Mechelsesteenweg 365,2018-11-24,00:00:00,12,6,6,FMN GV 05 Lier
60,Mechelsesteenweg 365,2018-11-24,01:00:00,0,0,0,FMN GV 05 Lier
60,Mechelsesteenweg 365,2018-11-24,02:00:00,2,0,2,FMN GV 05 Lier
60,Mechelsesteenweg 365,2018-11-24,03:00:00,6,6,0,FMN GV 05 Lier
60,Mechelsesteenweg 365,2018-11-24,04:00:00,4,2,2,FMN GV 05 Lier
60,Mechelsesteenweg 365,2018-11-24,05:00:00,2,0,2,FMN GV 05 Lier
60,Mechelsesteenweg 365,2018-11-24,06:00:00,6,0,6,FMN GV 05 Lier
60,Mechelsesteenweg 365,2018-11-24,07:00:00,10,6,4,FMN GV 05 Lier
60,Mechelsesteenweg 365,2018-11-24,08:00:00,6,6,0,FMN GV 05 Lier
60,Mechelsesteenweg 365,2018-11-24,09:00:00,36,8,28,FMN GV 05 Lier
60,Mechelsesteenweg 365,2018-11-24,10:00:00,22,10,12,FMN GV 05 Lier
60,Mechelsesteenweg 365,2018-11-24,11:00:00,18,8,10,FMN GV 05 Lier
60,Mechelsesteenweg 365,2018-11-24,12:00:00,28,10,18,FMN GV 05 Lier
60,Mechelsesteenweg 365,2018-11-24,13:00:00,12,6,6,FMN GV 05 Lier
60,Mechelsesteenweg 365,2018-11-24,14:00:00,48,38,10,FMN GV 05 Lier
60,Mechelsesteenweg 365,2018-11-24,15:00:00,26,16,10,FMN GV 05 Lier
60,Mechelsesteenweg 365,2018-11-24,16:00:00,16,8,8,FMN GV 05 Lier
60,Mechelsesteenweg 365,2018-11-24,17:00:00,6,0,6,FMN GV 05 Lier
60,Mechelsesteenweg 365,2018-11-24,18:00:00,2,2,0,FMN GV 05 Lier
60,Mechelsesteenweg 365,2018-11-24,19:00:00,0,0,0,FMN GV 05 Lier
60,Mechelsesteenweg 365,2018-11-24,20:00:00,0,0,0,FMN GV 05 Lier
60,Mechelsesteenweg 365,2018-11-24,21:00:00,0,0,0,FMN GV 05 Lier
60,Mechelsesteenweg 365,2018-11-24,22:00:00,0,0,0,FMN GV 05 Lier
60,Mechelsesteenweg 365,2018-11-24,23:00:00,0,0,0,FMN GV 05 Lier
60,Mechelsesteenweg 365,2018-11-25,00:00:00,0,0,0,FMN GV 05 Lier
60,Mechelsesteenweg 365,2018-11-25,01:00:00,0,0,0,FMN GV 05 Lier
60,Mechelsesteenweg 365,2018-11-25,02:00:00,0,0,0,FMN GV 05 Lier
60,Mechelsesteenweg 365,2018-11-25,03:00:00,0,0,0,FMN GV 05 Lier
60,Mechelsesteenweg 365,2018-11-25,04:00:00,2,2,0,FMN GV 05 Lier
60,Mechelsesteenweg 365,2018-11-25,05:00:00,2,0,2,FMN GV 05 Lier
60,Mechelsesteenweg 365,2018-11-25,06:00:00,4,2,2,FMN GV 05 Lier
60,Mechelsesteenweg 365,2018-11-25,07:00:00,8,4,4,FMN GV 05 Lier
60,Mechelsesteenweg 365,2018-11-25,08:00:00,24,18,6,FMN GV 05 Lier
60,Mechelsesteenweg 365,2018-11-25,09:00:00,44,30,14,FMN GV 05 Lier
60,Mechelsesteenweg 365,2018-11-25,10:00:00,124,60,64,FMN GV 05 Lier
60,Mechelsesteenweg 365,2018-11-25,11:00:00,128,36,92,FMN GV 05 Lier
60,Mechelsesteenweg 365,2018-11-25,12:00:00,70,28,42,FMN GV 05 Lier
60,Mechelsesteenweg 365,2018-11-25,13:00:00,56,22,34,FMN GV 05 Lier
60,Mechelsesteenweg 365,2018-11-25,14:00:00,66,34,32,FMN GV 05 Lier
60,Mechelsesteenweg 365,2018-11-25,15:00:00,44,30,14,FMN GV 05 Lier
60,Mechelsesteenweg 365,2018-11-25,16:00:00,36,12,24,FMN GV 05 Lier
60,Mechelsesteenweg 365,2018-11-25,17:00:00,24,20,4,FMN GV 05 Lier
60,Mechelsesteenweg 365,2018-11-25,18:00:00,4,2,2,FMN GV 05 Lier
60,Mechelsesteenweg 365,2018-11-25,19:00:00,0,0,0,FMN GV 05 Lier
60,Mechelsesteenweg 365,2018-11-25,20:00:00,2,0,2,FMN GV 05 Lier
60,Mechelsesteenweg 365,2018-11-25,21:00:00,0,0,0,FMN GV 05 Lier
60,Mechelsesteenweg 365,2018-11-25,22:00:00,0,0,0,FMN GV 05 Lier
60,Mechelsesteenweg 365,2018-11-25,23:00:00,2,0,2,FMN GV 05 Lier
60,Mechelsesteenweg 365,2018-11-26,00:00:00,0,0,0,FMN GV 05 Lier
60,Mechelsesteenweg 365,2018-11-26,01:00:00,0,0,0,FMN GV 05 Lier
60,Mechelsesteenweg 365,2018-11-26,02:00:00,0,0,0,FMN GV 05 Lier
60,Mechelsesteenweg 365,2018-11-26,03:00:00,0,0,0,FMN GV 05 Lier
60,Mechelsesteenweg 365,2018-11-26,04:00:00,0,0,0,FMN GV 05 Lier
60,Mechelsesteenweg 365,2018-11-26,05:00:00,4,2,2,FMN GV 05 Lier
60,Mechelsesteenweg 365,2018-11-26,06:00:00,4,2,2,FMN GV 05 Lier
60,Mechelsesteenweg 365,2018-11-26,07:00:00,96,58,38,FMN GV 05 Lier
60,Mechelsesteenweg 365,2018-11-26,08:00:00,98,62,36,FMN GV 05 Lier
60,Mechelsesteenweg 365,2018-11-26,09:00:00,34,22,12,FMN GV 05 Lier
60,Mechelsesteenweg 365,2018-11-26,10:00:00,8,4,4,FMN GV 05 Lier
60,Mechelsesteenweg 365,2018-11-26,11:00:00,4,4,0,FMN GV 05 Lier
60,Mechelsesteenweg 365,2018-11-26,12:00:00,10,6,4,FMN GV 05 Lier
60,Mechelsesteenweg 365,2018-11-26,13:00:00,8,4,4,FMN GV 05 Lier
60,Mechelsesteenweg 365,2018-11-26,14:00:00,22,12,10,FMN GV 05 Lier
60,Mechelsesteenweg 365,2018-11-26,15:00:00,42,16,26,FMN GV 05 Lier
60,Mechelsesteenweg 365,2018-11-26,16:00:00,106,30,76,FMN GV 05 Lier
60,Mechelsesteenweg 365,2018-11-26,17:00:00,70,38,32,FMN GV 05 Lier
60,Mechelsesteenweg 365,2018-11-26,18:00:00,12,8,4,FMN GV 05 Lier
60,Mechelsesteenweg 365,2018-11-26,19:00:00,8,4,4,FMN GV 05 Lier
60,Mechelsesteenweg 365,2018-11-26,20:00:00,4,2,2,FMN GV 05 Lier
60,Mechelsesteenweg 365,2018-11-26,21:00:00,8,0,8,FMN GV 05 Lier
60,Mechelsesteenweg 365,2018-11-26,22:00:00,2,2,0,FMN GV 05 Lier
60,Mechelsesteenweg 365,2018-11-26,23:00:00,0,0,0,FMN GV 05 Lier
60,Mechelsesteenweg 365,2018-11-27,00:00:00,0,0,0,FMN GV 05 Lier
60,Mechelsesteenweg 365,2018-11-27,01:00:00,0,0,0,FMN GV 05 Lier
60,Mechelsesteenweg 365,2018-11-27,02:00:00,0,0,0,FMN GV 05 Lier
60,Mechelsesteenweg 365,2018-11-27,03:00:00,2,0,2,FMN GV 05 Lier
60,Mechelsesteenweg 365,2018-11-27,04:00:00,0,0,0,FMN GV 05 Lier
60,Mechelsesteenweg 365,2018-11-27,05:00:00,8,4,4,FMN GV 05 Lier
60,Mechelsesteenweg 365,2018-11-27,06:00:00,8,0,8,FMN GV 05 Lier
60,Mechelsesteenweg 365,2018-11-27,07:00:00,110,60,50,FMN GV 05 Lier
60,Mechelsesteenweg 365,2018-11-27,08:00:00,122,78,44,FMN GV 05 Lier
60,Mechelsesteenweg 365,2018-11-27,09:00:00,40,22,18,FMN GV 05 Lier
60,Mechelsesteenweg 365,2018-11-27,10:00:00,30,14,16,FMN GV 05 Lier
60,Mechelsesteenweg 365,2018-11-27,11:00:00,38,8,30,FMN GV 05 Lier
60,Mechelsesteenweg 365,2018-11-27,12:00:00,66,32,34,FMN GV 05 Lier
60,Mechelsesteenweg 365,2018-11-27,13:00:00,70,32,38,FMN GV 05 Lier
60,Mechelsesteenweg 365,2018-11-27,14:00:00,78,40,38,FMN GV 05 Lier
60,Mechelsesteenweg 365,2018-11-27,15:00:00,116,66,50,FMN GV 05 Lier
60,Mechelsesteenweg 365,2018-11-27,16:00:00,160,46,114,FMN GV 05 Lier
60,Mechelsesteenweg 365,2018-11-27,17:00:00,54,32,22,FMN GV 05 Lier
60,Mechelsesteenweg 365,2018-11-27,18:00:00,24,12,12,FMN GV 05 Lier
60,Mechelsesteenweg 365,2018-11-27,19:00:00,10,4,6,FMN GV 05 Lier
60,Mechelsesteenweg 365,2018-11-27,20:00:00,14,6,8,FMN GV 05 Lier
60,Mechelsesteenweg 365,2018-11-27,21:00:00,6,2,4,FMN GV 05 Lier
60,Mechelsesteenweg 365,2018-11-27,22:00:00,4,2,2,FMN GV 05 Lier
60,Mechelsesteenweg 365,2018-11-27,23:00:00,0,0,0,FMN GV 05 Lier
60,Mechelsesteenweg 365,2018-11-28,00:00:00,0,0,0,FMN GV 05 Lier
60,Mechelsesteenweg 365,2018-11-28,01:00:00,0,0,0,FMN GV 05 Lier
60,Mechelsesteenweg 365,2018-11-28,02:00:00,0,0,0,FMN GV 05 Lier
60,Mechelsesteenweg 365,2018-11-28,03:00:00,2,0,2,FMN GV 05 Lier
60,Mechelsesteenweg 365,2018-11-28,04:00:00,0,0,0,FMN GV 05 Lier
60,Mechelsesteenweg 365,2018-11-28,05:00:00,4,2,2,FMN GV 05 Lier
60,Mechelsesteenweg 365,2018-11-28,06:00:00,12,0,12,FMN GV 05 Lier
60,Mechelsesteenweg 365,2018-11-28,07:00:00,92,54,38,FMN GV 05 Lier
60,Mechelsesteenweg 365,2018-11-28,08:00:00,96,70,26,FMN GV 05 Lier
60,Mechelsesteenweg 365,2018-11-28,09:00:00,14,6,8,FMN GV 05 Lier
60,Mechelsesteenweg 365,2018-11-28,10:00:00,10,4,6,FMN GV 05 Lier
60,Mechelsesteenweg 365,2018-11-28,11:00:00,18,4,14,FMN GV 05 Lier
60,Mechelsesteenweg 365,2018-11-28,12:00:00,136,24,112,FMN GV 05 Lier
60,Mechelsesteenweg 365,2018-11-28,13:00:00,20,10,10,FMN GV 05 Lier
60,Mechelsesteenweg 365,2018-11-28,14:00:00,16,12,4,FMN GV 05 Lier
60,Mechelsesteenweg 365,2018-11-28,15:00:00,20,12,8,FMN GV 05 Lier
60,Mechelsesteenweg 365,2018-11-28,16:00:00,38,14,24,FMN GV 05 Lier
60,Mechelsesteenweg 365,2018-11-28,17:00:00,30,24,6,FMN GV 05 Lier
60,Mechelsesteenweg 365,2018-11-28,18:00:00,12,12,0,FMN GV 05 Lier
60,Mechelsesteenweg 365,2018-11-28,19:00:00,12,8,4,FMN GV 05 Lier
60,Mechelsesteenweg 365,2018-11-28,20:00:00,10,10,0,FMN GV 05 Lier
60,Mechelsesteenweg 365,2018-11-28,21:00:00,2,0,2,FMN GV 05 Lier
60,Mechelsesteenweg 365,2018-11-28,22:00:00,12,4,8,FMN GV 05 Lier
60,Mechelsesteenweg 365,2018-11-28,23:00:00,4,2,2,FMN GV 05 Lier
60,Mechelsesteenweg 365,2018-11-29,00:00:00,0,0,0,FMN GV 05 Lier
60,Mechelsesteenweg 365,2018-11-29,01:00:00,0,0,0,FMN GV 05 Lier
60,Mechelsesteenweg 365,2018-11-29,02:00:00,0,0,0,FMN GV 05 Lier
60,Mechelsesteenweg 365,2018-11-29,03:00:00,0,0,0,FMN GV 05 Lier
60,Mechelsesteenweg 365,2018-11-29,04:00:00,2,0,2,FMN GV 05 Lier
60,Mechelsesteenweg 365,2018-11-29,05:00:00,2,0,2,FMN GV 05 Lier
60,Mechelsesteenweg 365,2018-11-29,06:00:00,4,2,2,FMN GV 05 Lier
60,Mechelsesteenweg 365,2018-11-29,07:00:00,78,50,28,FMN GV 05 Lier
60,Mechelsesteenweg 365,2018-11-29,08:00:00,110,72,38,FMN GV 05 Lier
60,Mechelsesteenweg 365,2018-11-29,09:00:00,16,12,4,FMN GV 05 Lier
60,Mechelsesteenweg 365,2018-11-29,10:00:00,12,4,8,FMN GV 05 Lier
60,Mechelsesteenweg 365,2018-11-29,11:00:00,12,8,4,FMN GV 05 Lier
60,Mechelsesteenweg 365,2018-11-29,12:00:00,22,10,12,FMN GV 05 Lier
60,Mechelsesteenweg 365,2018-11-29,13:00:00,20,14,6,FMN GV 05 Lier
60,Mechelsesteenweg 365,2018-11-29,14:00:00,40,20,20,FMN GV 05 Lier
60,Mechelsesteenweg 365,2018-11-29,15:00:00,52,30,22,FMN GV 05 Lier
60,Mechelsesteenweg 365,2018-11-29,16:00:00,154,38,116,FMN GV 05 Lier
60,Mechelsesteenweg 365,2018-11-29,17:00:00,36,22,14,FMN GV 05 Lier
60,Mechelsesteenweg 365,2018-11-29,18:00:00,18,14,4,FMN GV 05 Lier
60,Mechelsesteenweg 365,2018-11-29,19:00:00,18,16,2,FMN GV 05 Lier
60,Mechelsesteenweg 365,2018-11-29,20:00:00,6,4,2,FMN GV 05 Lier
60,Mechelsesteenweg 365,2018-11-29,21:00:00,0,0,0,FMN GV 05 Lier
60,Mechelsesteenweg 365,2018-11-29,22:00:00,4,2,2,FMN GV 05 Lier
60,Mechelsesteenweg 365,2018-11-29,23:00:00,4,4,0,FMN GV 05 Lier
60,Mechelsesteenweg 365,2018-11-30,00:00:00,0,0,0,FMN GV 05 Lier
60,Mechelsesteenweg 365,2018-11-30,01:00:00,0,0,0,FMN GV 05 Lier
60,Mechelsesteenweg 365,2018-11-30,02:00:00,0,0,0,FMN GV 05 Lier
60,Mechelsesteenweg 365,2018-11-30,03:00:00,0,0,0,FMN GV 05 Lier
60,Mechelsesteenweg 365,2018-11-30,04:00:00,0,0,0,FMN GV 05 Lier
60,Mechelsesteenweg 365,2018-11-30,05:00:00,4,2,2,FMN GV 05 Lier
60,Mechelsesteenweg 365,2018-11-30,06:00:00,8,2,6,FMN GV 05 Lier
60,Mechelsesteenweg 365,2018-11-30,07:00:00,90,54,36,FMN GV 05 Lier
60,Mechelsesteenweg 365,2018-11-30,08:00:00,128,80,48,FMN GV 05 Lier
60,Mechelsesteenweg 365,2018-11-30,09:00:00,48,22,26,FMN GV 05 Lier
60,Mechelsesteenweg 365,2018-11-30,10:00:00,68,48,20,FMN GV 05 Lier
60,Mechelsesteenweg 365,2018-11-30,11:00:00,72,34,38,FMN GV 05 Lier
60,Mechelsesteenweg 365,2018-11-30,12:00:00,58,32,26,FMN GV 05 Lier
60,Mechelsesteenweg 365,2018-11-30,13:00:00,66,42,24,FMN GV 05 Lier
60,Mechelsesteenweg 365,2018-11-30,14:00:00,88,48,40,FMN GV 05 Lier
60,Mechelsesteenweg 365,2018-11-30,15:00:00,124,52,72,FMN GV 05 Lier
60,Mechelsesteenweg 365,2018-11-30,16:00:00,158,50,108,FMN GV 05 Lier
60,Mechelsesteenweg 365,2018-11-30,17:00:00,52,24,28,FMN GV 05 Lier
60,Mechelsesteenweg 365,2018-11-30,18:00:00,42,24,18,FMN GV 05 Lier
60,Mechelsesteenweg 365,2018-11-30,19:00:00,6,6,0,FMN GV 05 Lier
60,Mechelsesteenweg 365,2018-11-30,20:00:00,6,6,0,FMN GV 05 Lier
60,Mechelsesteenweg 365,2018-11-30,21:00:00,6,0,6,FMN GV 05 Lier
60,Mechelsesteenweg 365,2018-11-30,22:00:00,4,4,0,FMN GV 05 Lier
60,Mechelsesteenweg 365,2018-11-30,23:00:00,4,2,2,FMN GV 05 Lier
60,Mechelsesteenweg 365,2018-12-01,00:00:00,0,0,0,FMN GV 05 Lier
60,Mechelsesteenweg 365,2018-12-01,01:00:00,2,2,0,FMN GV 05 Lier
60,Mechelsesteenweg 365,2018-12-01,02:00:00,0,0,0,FMN GV 05 Lier
60,Mechelsesteenweg 365,2018-12-01,03:00:00,0,0,0,FMN GV 05 Lier
60,Mechelsesteenweg 365,2018-12-01,04:00:00,0,0,0,FMN GV 05 Lier
60,Mechelsesteenweg 365,2018-12-01,05:00:00,2,0,2,FMN GV 05 Lier
60,Mechelsesteenweg 365,2018-12-01,06:00:00,0,0,0,FMN GV 05 Lier
60,Mechelsesteenweg 365,2018-12-01,07:00:00,6,4,2,FMN GV 05 Lier
60,Mechelsesteenweg 365,2018-12-01,08:00:00,16,8,8,FMN GV 05 Lier
60,Mechelsesteenweg 365,2018-12-01,09:00:00,46,20,26,FMN GV 05 Lier
60,Mechelsesteenweg 365,2018-12-01,10:00:00,90,54,36,FMN GV 05 Lier
60,Mechelsesteenweg 365,2018-12-01,11:00:00,78,42,36,FMN GV 05 Lier
60,Mechelsesteenweg 365,2018-12-01,12:00:00,58,24,34,FMN GV 05 Lier
60,Mechelsesteenweg 365,2018-12-01,13:00:00,28,10,18,FMN GV 05 Lier
60,Mechelsesteenweg 365,2018-12-01,14:00:00,18,12,6,FMN GV 05 Lier
60,Mechelsesteenweg 365,2018-12-01,15:00:00,16,6,10,FMN GV 05 Lier
60,Mechelsesteenweg 365,2018-12-01,16:00:00,14,2,12,FMN GV 05 Lier
60,Mechelsesteenweg 365,2018-12-01,17:00:00,6,4,2,FMN GV 05 Lier
60,Mechelsesteenweg 365,2018-12-01,18:00:00,4,2,2,FMN GV 05 Lier
60,Mechelsesteenweg 365,2018-12-01,19:00:00,0,0,0,FMN GV 05 Lier
60,Mechelsesteenweg 365,2018-12-01,20:00:00,18,10,8,FMN GV 05 Lier
60,Mechelsesteenweg 365,2018-12-01,21:00:00,0,0,0,FMN GV 05 Lier
60,Mechelsesteenweg 365,2018-12-01,22:00:00,8,6,2,FMN GV 05 Lier
60,Mechelsesteenweg 365,2018-12-01,23:00:00,2,0,2,FMN GV 05 Lier
60,Mechelsesteenweg 365,2018-12-02,00:00:00,0,0,0,FMN GV 05 Lier
60,Mechelsesteenweg 365,2018-12-02,01:00:00,6,2,4,FMN GV 05 Lier
60,Mechelsesteenweg 365,2018-12-02,02:00:00,0,0,0,FMN GV 05 Lier
60,Mechelsesteenweg 365,2018-12-02,03:00:00,8,8,0,FMN GV 05 Lier
60,Mechelsesteenweg 365,2018-12-02,04:00:00,0,0,0,FMN GV 05 Lier
60,Mechelsesteenweg 365,2018-12-02,05:00:00,0,0,0,FMN GV 05 Lier
60,Mechelsesteenweg 365,2018-12-02,06:00:00,0,0,0,FMN GV 05 Lier
60,Mechelsesteenweg 365,2018-12-02,07:00:00,4,4,0,FMN GV 05 Lier
60,Mechelsesteenweg 365,2018-12-02,08:00:00,8,6,2,FMN GV 05 Lier
60,Mechelsesteenweg 365,2018-12-02,09:00:00,68,24,44,FMN GV 05 Lier
60,Mechelsesteenweg 365,2018-12-02,10:00:00,38,14,24,FMN GV 05 Lier
60,Mechelsesteenweg 365,2018-12-02,11:00:00,58,18,40,FMN GV 05 Lier
60,Mechelsesteenweg 365,2018-12-02,12:00:00,22,16,6,FMN GV 05 Lier
60,Mechelsesteenweg 365,2018-12-02,13:00:00,44,24,20,FMN GV 05 Lier
60,Mechelsesteenweg 365,2018-12-02,14:00:00,52,24,28,FMN GV 05 Lier
60,Mechelsesteenweg 365,2018-12-02,15:00:00,38,24,14,FMN GV 05 Lier
60,Mechelsesteenweg 365,2018-12-02,16:00:00,34,12,22,FMN GV 05 Lier
60,Mechelsesteenweg 365,2018-12-02,17:00:00,10,6,4,FMN GV 05 Lier
60,Mechelsesteenweg 365,2018-12-02,18:00:00,8,4,4,FMN GV 05 Lier
60,Mechelsesteenweg 365,2018-12-02,19:00:00,22,22,0,FMN GV 05 Lier
60,Mechelsesteenweg 365,2018-12-02,20:00:00,14,6,8,FMN GV 05 Lier
60,Mechelsesteenweg 365,2018-12-02,21:00:00,2,0,2,FMN GV 05 Lier
60,Mechelsesteenweg 365,2018-12-02,22:00:00,0,0,0,FMN GV 05 Lier
60,Mechelsesteenweg 365,2018-12-02,23:00:00,0,0,0,FMN GV 05 Lier
60,Mechelsesteenweg 365,2018-12-03,00:00:00,0,0,0,FMN GV 05 Lier
60,Mechelsesteenweg 365,2018-12-03,01:00:00,0,0,0,FMN GV 05 Lier
60,Mechelsesteenweg 365,2018-12-03,02:00:00,0,0,0,FMN GV 05 Lier
60,Mechelsesteenweg 365,2018-12-03,03:00:00,0,0,0,FMN GV 05 Lier
60,Mechelsesteenweg 365,2018-12-03,04:00:00,0,0,0,FMN GV 05 Lier
60,Mechelsesteenweg 365,2018-12-03,05:00:00,4,0,4,FMN GV 05 Lier
60,Mechelsesteenweg 365,2018-12-03,06:00:00,6,2,4,FMN GV 05 Lier
60,Mechelsesteenweg 365,2018-12-03,07:00:00,98,56,42,FMN GV 05 Lier
60,Mechelsesteenweg 365,2018-12-03,08:00:00,96,70,26,FMN GV 05 Lier
60,Mechelsesteenweg 365,2018-12-03,09:00:00,30,20,10,FMN GV 05 Lier
60,Mechelsesteenweg 365,2018-12-03,10:00:00,12,4,8,FMN GV 05 Lier
60,Mechelsesteenweg 365,2018-12-03,11:00:00,6,2,4,FMN GV 05 Lier
60,Mechelsesteenweg 365,2018-12-03,12:00:00,20,12,8,FMN GV 05 Lier
60,Mechelsesteenweg 365,2018-12-03,13:00:00,28,10,18,FMN GV 05 Lier
60,Mechelsesteenweg 365,2018-12-03,14:00:00,18,14,4,FMN GV 05 Lier
60,Mechelsesteenweg 365,2018-12-03,15:00:00,64,26,38,FMN GV 05 Lier
60,Mechelsesteenweg 365,2018-12-03,16:00:00,116,34,82,FMN GV 05 Lier
60,Mechelsesteenweg 365,2018-12-03,17:00:00,72,32,40,FMN GV 05 Lier
60,Mechelsesteenweg 365,2018-12-03,18:00:00,16,10,6,FMN GV 05 Lier
60,Mechelsesteenweg 365,2018-12-03,19:00:00,8,4,4,FMN GV 05 Lier
60,Mechelsesteenweg 365,2018-12-03,20:00:00,4,2,2,FMN GV 05 Lier
60,Mechelsesteenweg 365,2018-12-03,21:00:00,4,0,4,FMN GV 05 Lier
60,Mechelsesteenweg 365,2018-12-03,22:00:00,4,2,2,FMN GV 05 Lier
60,Mechelsesteenweg 365,2018-12-03,23:00:00,2,0,2,FMN GV 05 Lier
60,Mechelsesteenweg 365,2018-12-04,00:00:00,0,0,0,FMN GV 05 Lier
60,Mechelsesteenweg 365,2018-12-04,01:00:00,0,0,0,FMN GV 05 Lier
60,Mechelsesteenweg 365,2018-12-04,02:00:00,0,0,0,FMN GV 05 Lier
60,Mechelsesteenweg 365,2018-12-04,03:00:00,0,0,0,FMN GV 05 Lier
60,Mechelsesteenweg 365,2018-12-04,04:00:00,2,0,2,FMN GV 05 Lier
60,Mechelsesteenweg 365,2018-12-04,05:00:00,6,0,6,FMN GV 05 Lier
60,Mechelsesteenweg 365,2018-12-04,06:00:00,8,2,6,FMN GV 05 Lier
60,Mechelsesteenweg 365,2018-12-04,07:00:00,144,80,64,FMN GV 05 Lier
60,Mechelsesteenweg 365,2018-12-04,08:00:00,132,90,42,FMN GV 05 Lier
60,Mechelsesteenweg 365,2018-12-04,09:00:00,50,30,20,FMN GV 05 Lier
60,Mechelsesteenweg 365,2018-12-04,10:00:00,64,36,28,FMN GV 05 Lier
60,Mechelsesteenweg 365,2018-12-04,11:00:00,78,38,40,FMN GV 05 Lier
60,Mechelsesteenweg 365,2018-12-04,12:00:00,92,36,56,FMN GV 05 Lier
60,Mechelsesteenweg 365,2018-12-04,13:00:00,170,76,94,FMN GV 05 Lier
60,Mechelsesteenweg 365,2018-12-04,14:00:00,134,78,56,FMN GV 05 Lier
60,Mechelsesteenweg 365,2018-12-04,15:00:00,118,48,70,FMN GV 05 Lier
60,Mechelsesteenweg 365,2018-12-04,16:00:00,136,36,100,FMN GV 05 Lier
60,Mechelsesteenweg 365,2018-12-04,17:00:00,68,38,30,FMN GV 05 Lier
60,Mechelsesteenweg 365,2018-12-04,18:00:00,22,12,10,FMN GV 05 Lier
60,Mechelsesteenweg 365,2018-12-04,19:00:00,12,12,0,FMN GV 05 Lier
60,Mechelsesteenweg 365,2018-12-04,20:00:00,10,6,4,FMN GV 05 Lier
60,Mechelsesteenweg 365,2018-12-04,21:00:00,6,4,2,FMN GV 05 Lier
60,Mechelsesteenweg 365,2018-12-04,22:00:00,8,4,4,FMN GV 05 Lier
60,Mechelsesteenweg 365,2018-12-04,23:00:00,0,0,0,FMN GV 05 Lier
60,Mechelsesteenweg 365,2018-12-05,00:00:00,0,0,0,FMN GV 05 Lier
60,Mechelsesteenweg 365,2018-12-05,01:00:00,0,0,0,FMN GV 05 Lier
60,Mechelsesteenweg 365,2018-12-05,02:00:00,0,0,0,FMN GV 05 Lier
60,Mechelsesteenweg 365,2018-12-05,03:00:00,0,0,0,FMN GV 05 Lier
60,Mechelsesteenweg 365,2018-12-05,04:00:00,4,0,4,FMN GV 05 Lier
60,Mechelsesteenweg 365,2018-12-05,05:00:00,2,0,2,FMN GV 05 Lier
60,Mechelsesteenweg 365,2018-12-05,06:00:00,12,2,10,FMN GV 05 Lier
60,Mechelsesteenweg 365,2018-12-05,07:00:00,128,82,46,FMN GV 05 Lier
60,Mechelsesteenweg 365,2018-12-05,08:00:00,92,60,32,FMN GV 05 Lier
60,Mechelsesteenweg 365,2018-12-05,09:00:00,30,14,16,FMN GV 05 Lier
60,Mechelsesteenweg 365,2018-12-05,10:00:00,54,16,38,FMN GV 05 Lier
60,Mechelsesteenweg 365,2018-12-05,11:00:00,36,12,24,FMN GV 05 Lier
60,Mechelsesteenweg 365,2018-12-05,12:00:00,146,30,116,FMN GV 05 Lier
60,Mechelsesteenweg 365,2018-12-05,13:00:00,48,22,26,FMN GV 05 Lier
60,Mechelsesteenweg 365,2018-12-05,14:00:00,86,52,34,FMN GV 05 Lier
60,Mechelsesteenweg 365,2018-12-05,15:00:00,60,36,24,FMN GV 05 Lier
60,Mechelsesteenweg 365,2018-12-05,16:00:00,50,20,30,FMN GV 05 Lier
60,Mechelsesteenweg 365,2018-12-05,17:00:00,46,24,22,FMN GV 05 Lier
60,Mechelsesteenweg 365,2018-12-05,18:00:00,28,16,12,FMN GV 05 Lier
60,Mechelsesteenweg 365,2018-12-05,19:00:00,6,6,0,FMN GV 05 Lier
60,Mechelsesteenweg 365,2018-12-05,20:00:00,4,2,2,FMN GV 05 Lier
60,Mechelsesteenweg 365,2018-12-05,21:00:00,8,0,8,FMN GV 05 Lier
60,Mechelsesteenweg 365,2018-12-05,22:00:00,4,2,2,FMN GV 05 Lier
60,Mechelsesteenweg 365,2018-12-05,23:00:00,2,2,0,FMN GV 05 Lier
60,Mechelsesteenweg 365,2018-12-06,00:00:00,0,0,0,FMN GV 05 Lier
60,Mechelsesteenweg 365,2018-12-06,01:00:00,0,0,0,FMN GV 05 Lier
60,Mechelsesteenweg 365,2018-12-06,02:00:00,0,0,0,FMN GV 05 Lier
60,Mechelsesteenweg 365,2018-12-06,03:00:00,0,0,0,FMN GV 05 Lier
60,Mechelsesteenweg 365,2018-12-06,04:00:00,6,0,6,FMN GV 05 Lier
60,Mechelsesteenweg 365,2018-12-06,05:00:00,4,0,4,FMN GV 05 Lier
60,Mechelsesteenweg 365,2018-12-06,06:00:00,12,4,8,FMN GV 05 Lier
60,Mechelsesteenweg 365,2018-12-06,07:00:00,112,70,42,FMN GV 05 Lier
60,Mechelsesteenweg 365,2018-12-06,08:00:00,104,62,42,FMN GV 05 Lier
60,Mechelsesteenweg 365,2018-12-06,09:00:00,38,20,18,FMN GV 05 Lier
60,Mechelsesteenweg 365,2018-12-06,10:00:00,38,12,26,FMN GV 05 Lier
60,Mechelsesteenweg 365,2018-12-06,11:00:00,54,26,28,FMN GV 05 Lier
60,Mechelsesteenweg 365,2018-12-06,12:00:00,74,14,60,FMN GV 05 Lier
60,Mechelsesteenweg 365,2018-12-06,13:00:00,54,40,14,FMN GV 05 Lier
60,Mechelsesteenweg 365,2018-12-06,14:00:00,46,24,22,FMN GV 05 Lier
60,Mechelsesteenweg 365,2018-12-06,15:00:00,68,44,24,FMN GV 05 Lier
60,Mechelsesteenweg 365,2018-12-06,16:00:00,68,26,42,FMN GV 05 Lier
60,Mechelsesteenweg 365,2018-12-06,17:00:00,52,30,22,FMN GV 05 Lier
60,Mechelsesteenweg 365,2018-12-06,18:00:00,20,12,8,FMN GV 05 Lier
60,Mechelsesteenweg 365,2018-12-06,19:00:00,12,10,2,FMN GV 05 Lier
60,Mechelsesteenweg 365,2018-12-06,20:00:00,4,4,0,FMN GV 05 Lier
60,Mechelsesteenweg 365,2018-12-06,21:00:00,6,4,2,FMN GV 05 Lier
60,Mechelsesteenweg 365,2018-12-06,22:00:00,2,0,2,FMN GV 05 Lier
60,Mechelsesteenweg 365,2018-12-06,23:00:00,2,0,2,FMN GV 05 Lier
60,Mechelsesteenweg 365,2018-12-07,00:00:00,0,0,0,FMN GV 05 Lier
60,Mechelsesteenweg 365,2018-12-07,01:00:00,0,0,0,FMN GV 05 Lier
60,Mechelsesteenweg 365,2018-12-07,02:00:00,0,0,0,FMN GV 05 Lier
60,Mechelsesteenweg 365,2018-12-07,03:00:00,0,0,0,FMN GV 05 Lier
60,Mechelsesteenweg 365,2018-12-07,04:00:00,2,0,2,FMN GV 05 Lier
60,Mechelsesteenweg 365,2018-12-07,05:00:00,6,2,4,FMN GV 05 Lier
60,Mechelsesteenweg 365,2018-12-07,06:00:00,4,0,4,FMN GV 05 Lier
60,Mechelsesteenweg 365,2018-12-07,07:00:00,82,56,26,FMN GV 05 Lier
60,Mechelsesteenweg 365,2018-12-07,08:00:00,76,48,28,FMN GV 05 Lier
60,Mechelsesteenweg 365,2018-12-07,09:00:00,74,60,14,FMN GV 05 Lier
60,Mechelsesteenweg 365,2018-12-07,10:00:00,56,16,40,FMN GV 05 Lier
60,Mechelsesteenweg 365,2018-12-07,11:00:00,26,14,12,FMN GV 05 Lier
60,Mechelsesteenweg 365,2018-12-07,12:00:00,96,24,72,FMN GV 05 Lier
60,Mechelsesteenweg 365,2018-12-07,13:00:00,16,8,8,FMN GV 05 Lier
60,Mechelsesteenweg 365,2018-12-07,14:00:00,10,4,6,FMN GV 05 Lier
60,Mechelsesteenweg 365,2018-12-07,15:00:00,30,20,10,FMN GV 05 Lier
60,Mechelsesteenweg 365,2018-12-07,16:00:00,40,20,20,FMN GV 05 Lier
60,Mechelsesteenweg 365,2018-12-07,17:00:00,28,18,10,FMN GV 05 Lier
60,Mechelsesteenweg 365,2018-12-07,18:00:00,8,6,2,FMN GV 05 Lier
60,Mechelsesteenweg 365,2018-12-07,19:00:00,6,0,6,FMN GV 05 Lier
60,Mechelsesteenweg 365,2018-12-07,20:00:00,2,2,0,FMN GV 05 Lier
60,Mechelsesteenweg 365,2018-12-07,21:00:00,0,0,0,FMN GV 05 Lier
60,Mechelsesteenweg 365,2018-12-07,22:00:00,8,4,4,FMN GV 05 Lier
60,Mechelsesteenweg 365,2018-12-07,23:00:00,0,0,0,FMN GV 05 Lier
60,Mechelsesteenweg 365,2018-12-08,00:00:00,0,0,0,FMN GV 05 Lier
60,Mechelsesteenweg 365,2018-12-08,01:00:00,0,0,0,FMN GV 05 Lier
60,Mechelsesteenweg 365,2018-12-08,02:00:00,0,0,0,FMN GV 05 Lier
60,Mechelsesteenweg 365,2018-12-08,03:00:00,0,0,0,FMN GV 05 Lier
60,Mechelsesteenweg 365,2018-12-08,04:00:00,2,0,2,FMN GV 05 Lier
60,Mechelsesteenweg 365,2018-12-08,05:00:00,0,0,0,FMN GV 05 Lier
60,Mechelsesteenweg 365,2018-12-08,06:00:00,2,0,2,FMN GV 05 Lier
60,Mechelsesteenweg 365,2018-12-08,07:00:00,8,4,4,FMN GV 05 Lier
60,Mechelsesteenweg 365,2018-12-08,08:00:00,12,8,4,FMN GV 05 Lier
60,Mechelsesteenweg 365,2018-12-08,09:00:00,44,18,26,FMN GV 05 Lier
60,Mechelsesteenweg 365,2018-12-08,10:00:00,50,28,22,FMN GV 05 Lier
60,Mechelsesteenweg 365,2018-12-08,11:00:00,52,28,24,FMN GV 05 Lier
60,Mechelsesteenweg 365,2018-12-08,12:00:00,26,10,16,FMN GV 05 Lier
60,Mechelsesteenweg 365,2018-12-08,13:00:00,68,40,28,FMN GV 05 Lier
60,Mechelsesteenweg 365,2018-12-08,14:00:00,46,30,16,FMN GV 05 Lier
60,Mechelsesteenweg 365,2018-12-08,15:00:00,58,22,36,FMN GV 05 Lier
60,Mechelsesteenweg 365,2018-12-08,16:00:00,34,14,20,FMN GV 05 Lier
60,Mechelsesteenweg 365,2018-12-08,17:00:00,10,2,8,FMN GV 05 Lier
60,Mechelsesteenweg 365,2018-12-08,18:00:00,2,2,0,FMN GV 05 Lier
60,Mechelsesteenweg 365,2018-12-08,19:00:00,0,0,0,FMN GV 05 Lier
60,Mechelsesteenweg 365,2018-12-08,20:00:00,6,4,2,FMN GV 05 Lier
60,Mechelsesteenweg 365,2018-12-08,21:00:00,0,0,0,FMN GV 05 Lier
60,Mechelsesteenweg 365,2018-12-08,22:00:00,14,0,14,FMN GV 05 Lier
60,Mechelsesteenweg 365,2018-12-08,23:00:00,0,0,0,FMN GV 05 Lier
60,Mechelsesteenweg 365,2018-12-09,00:00:00,0,0,0,FMN GV 05 Lier
60,Mechelsesteenweg 365,2018-12-09,01:00:00,2,2,0,FMN GV 05 Lier
60,Mechelsesteenweg 365,2018-12-09,02:00:00,0,0,0,FMN GV 05 Lier
60,Mechelsesteenweg 365,2018-12-09,03:00:00,0,0,0,FMN GV 05 Lier
60,Mechelsesteenweg 365,2018-12-09,04:00:00,0,0,0,FMN GV 05 Lier
60,Mechelsesteenweg 365,2018-12-09,05:00:00,2,0,2,FMN GV 05 Lier
60,Mechelsesteenweg 365,2018-12-09,06:00:00,0,0,0,FMN GV 05 Lier
60,Mechelsesteenweg 365,2018-12-09,07:00:00,4,0,4,FMN GV 05 Lier
60,Mechelsesteenweg 365,2018-12-09,08:00:00,0,0,0,FMN GV 05 Lier
60,Mechelsesteenweg 365,2018-12-09,09:00:00,2,2,0,FMN GV 05 Lier
60,Mechelsesteenweg 365,2018-12-09,10:00:00,18,8,10,FMN GV 05 Lier
60,Mechelsesteenweg 365,2018-12-09,11:00:00,14,4,10,FMN GV 05 Lier
60,Mechelsesteenweg 365,2018-12-09,12:00:00,10,4,6,FMN GV 05 Lier
60,Mechelsesteenweg 365,2018-12-09,13:00:00,18,8,10,FMN GV 05 Lier
60,Mechelsesteenweg 365,2018-12-09,14:00:00,38,20,18,FMN GV 05 Lier
60,Mechelsesteenweg 365,2018-12-09,15:00:00,22,8,14,FMN GV 05 Lier
60,Mechelsesteenweg 365,2018-12-09,16:00:00,20,8,12,FMN GV 05 Lier
60,Mechelsesteenweg 365,2018-12-09,17:00:00,10,2,8,FMN GV 05 Lier
60,Mechelsesteenweg 365,2018-12-09,18:00:00,6,6,0,FMN GV 05 Lier
60,Mechelsesteenweg 365,2018-12-09,19:00:00,0,0,0,FMN GV 05 Lier
60,Mechelsesteenweg 365,2018-12-09,20:00:00,2,2,0,FMN GV 05 Lier
60,Mechelsesteenweg 365,2018-12-09,21:00:00,0,0,0,FMN GV 05 Lier
60,Mechelsesteenweg 365,2018-12-09,22:00:00,0,0,0,FMN GV 05 Lier
60,Mechelsesteenweg 365,2018-12-09,23:00:00,4,0,4,FMN GV 05 Lier
60,Mechelsesteenweg 365,2018-12-10,00:00:00,0,0,0,FMN GV 05 Lier
60,Mechelsesteenweg 365,2018-12-10,01:00:00,0,0,0,FMN GV 05 Lier
60,Mechelsesteenweg 365,2018-12-10,02:00:00,0,0,0,FMN GV 05 Lier
60,Mechelsesteenweg 365,2018-12-10,03:00:00,0,0,0,FMN GV 05 Lier
60,Mechelsesteenweg 365,2018-12-10,04:00:00,0,0,0,FMN GV 05 Lier
60,Mechelsesteenweg 365,2018-12-10,05:00:00,2,2,0,FMN GV 05 Lier
60,Mechelsesteenweg 365,2018-12-10,06:00:00,8,0,8,FMN GV 05 Lier
60,Mechelsesteenweg 365,2018-12-10,07:00:00,136,96,40,FMN GV 05 Lier
60,Mechelsesteenweg 365,2018-12-10,08:00:00,100,66,34,FMN GV 05 Lier
60,Mechelsesteenweg 365,2018-12-10,09:00:00,30,14,16,FMN GV 05 Lier
60,Mechelsesteenweg 365,2018-12-10,10:00:00,48,28,20,FMN GV 05 Lier
60,Mechelsesteenweg 365,2018-12-10,11:00:00,76,30,46,FMN GV 05 Lier
60,Mechelsesteenweg 365,2018-12-10,12:00:00,126,24,102,FMN GV 05 Lier
60,Mechelsesteenweg 365,2018-12-10,13:00:00,94,50,44,FMN GV 05 Lier
60,Mechelsesteenweg 365,2018-12-10,14:00:00,84,60,24,FMN GV 05 Lier
60,Mechelsesteenweg 365,2018-12-10,15:00:00,48,22,26,FMN GV 05 Lier
60,Mechelsesteenweg 365,2018-12-10,16:00:00,68,28,40,FMN GV 05 Lier
60,Mechelsesteenweg 365,2018-12-10,17:00:00,70,50,20,FMN GV 05 Lier
60,Mechelsesteenweg 365,2018-12-10,18:00:00,14,8,6,FMN GV 05 Lier
60,Mechelsesteenweg 365,2018-12-10,19:00:00,4,2,2,FMN GV 05 Lier
60,Mechelsesteenweg 365,2018-12-10,20:00:00,4,4,0,FMN GV 05 Lier
60,Mechelsesteenweg 365,2018-12-10,21:00:00,4,2,2,FMN GV 05 Lier
60,Mechelsesteenweg 365,2018-12-10,22:00:00,0,0,0,FMN GV 05 Lier
60,Mechelsesteenweg 365,2018-12-10,23:00:00,0,0,0,FMN GV 05 Lier
60,Mechelsesteenweg 365,2018-12-11,00:00:00,2,2,0,FMN GV 05 Lier
60,Mechelsesteenweg 365,2018-12-11,01:00:00,0,0,0,FMN GV 05 Lier
60,Mechelsesteenweg 365,2018-12-11,02:00:00,0,0,0,FMN GV 05 Lier
60,Mechelsesteenweg 365,2018-12-11,03:00:00,2,0,2,FMN GV 05 Lier
60,Mechelsesteenweg 365,2018-12-11,04:00:00,0,0,0,FMN GV 05 Lier
60,Mechelsesteenweg 365,2018-12-11,05:00:00,6,0,6,FMN GV 05 Lier
60,Mechelsesteenweg 365,2018-12-11,06:00:00,8,0,8,FMN GV 05 Lier
60,Mechelsesteenweg 365,2018-12-11,07:00:00,148,88,60,FMN GV 05 Lier
60,Mechelsesteenweg 365,2018-12-11,08:00:00,82,64,18,FMN GV 05 Lier
60,Mechelsesteenweg 365,2018-12-11,09:00:00,38,26,12,FMN GV 05 Lier
60,Mechelsesteenweg 365,2018-12-11,10:00:00,90,20,70,FMN GV 05 Lier
60,Mechelsesteenweg 365,2018-12-11,11:00:00,60,18,42,FMN GV 05 Lier
60,Mechelsesteenweg 365,2018-12-11,12:00:00,64,22,42,FMN GV 05 Lier
60,Mechelsesteenweg 365,2018-12-11,13:00:00,140,68,72,FMN GV 05 Lier
60,Mechelsesteenweg 365,2018-12-11,14:00:00,104,46,58,FMN GV 05 Lier
60,Mechelsesteenweg 365,2018-12-11,15:00:00,84,42,42,FMN GV 05 Lier
60,Mechelsesteenweg 365,2018-12-11,16:00:00,68,42,26,FMN GV 05 Lier
60,Mechelsesteenweg 365,2018-12-11,17:00:00,60,34,26,FMN GV 05 Lier
60,Mechelsesteenweg 365,2018-12-11,18:00:00,24,16,8,FMN GV 05 Lier
60,Mechelsesteenweg 365,2018-12-11,19:00:00,4,2,2,FMN GV 05 Lier
60,Mechelsesteenweg 365,2018-12-11,20:00:00,10,6,4,FMN GV 05 Lier
60,Mechelsesteenweg 365,2018-12-11,21:00:00,6,2,4,FMN GV 05 Lier
60,Mechelsesteenweg 365,2018-12-11,22:00:00,2,2,0,FMN GV 05 Lier
60,Mechelsesteenweg 365,2018-12-11,23:00:00,4,0,4,FMN GV 05 Lier
60,Mechelsesteenweg 365,2018-12-12,00:00:00,0,0,0,FMN GV 05 Lier
60,Mechelsesteenweg 365,2018-12-12,01:00:00,0,0,0,FMN GV 05 Lier
60,Mechelsesteenweg 365,2018-12-12,02:00:00,0,0,0,FMN GV 05 Lier
60,Mechelsesteenweg 365,2018-12-12,03:00:00,0,0,0,FMN GV 05 Lier
60,Mechelsesteenweg 365,2018-12-12,04:00:00,0,0,0,FMN GV 05 Lier
60,Mechelsesteenweg 365,2018-12-12,05:00:00,2,0,2,FMN GV 05 Lier
60,Mechelsesteenweg 365,2018-12-12,06:00:00,14,2,12,FMN GV 05 Lier
60,Mechelsesteenweg 365,2018-12-12,07:00:00,100,66,34,FMN GV 05 Lier
60,Mechelsesteenweg 365,2018-12-12,08:00:00,94,52,42,FMN GV 05 Lier
60,Mechelsesteenweg 365,2018-12-12,09:00:00,20,14,6,FMN GV 05 Lier
60,Mechelsesteenweg 365,2018-12-12,10:00:00,76,24,52,FMN GV 05 Lier
60,Mechelsesteenweg 365,2018-12-12,11:00:00,58,22,36,FMN GV 05 Lier
60,Mechelsesteenweg 365,2018-12-12,12:00:00,102,22,80,FMN GV 05 Lier
60,Mechelsesteenweg 365,2018-12-12,13:00:00,98,34,64,FMN GV 05 Lier
60,Mechelsesteenweg 365,2018-12-12,14:00:00,94,70,24,FMN GV 05 Lier
60,Mechelsesteenweg 365,2018-12-12,15:00:00,68,34,34,FMN GV 05 Lier
60,Mechelsesteenweg 365,2018-12-12,16:00:00,76,56,20,FMN GV 05 Lier
60,Mechelsesteenweg 365,2018-12-12,17:00:00,42,32,10,FMN GV 05 Lier
60,Mechelsesteenweg 365,2018-12-12,18:00:00,10,6,4,FMN GV 05 Lier
60,Mechelsesteenweg 365,2018-12-12,19:00:00,0,0,0,FMN GV 05 Lier
60,Mechelsesteenweg 365,2018-12-12,20:00:00,16,10,6,FMN GV 05 Lier
60,Mechelsesteenweg 365,2018-12-12,21:00:00,2,0,2,FMN GV 05 Lier
60,Mechelsesteenweg 365,2018-12-12,22:00:00,4,2,2,FMN GV 05 Lier
60,Mechelsesteenweg 365,2018-12-12,23:00:00,0,0,0,FMN GV 05 Lier
60,Mechelsesteenweg 365,2018-12-13,00:00:00,0,0,0,FMN GV 05 Lier
60,Mechelsesteenweg 365,2018-12-13,01:00:00,4,0,4,FMN GV 05 Lier
60,Mechelsesteenweg 365,2018-12-13,02:00:00,0,0,0,FMN GV 05 Lier
60,Mechelsesteenweg 365,2018-12-13,03:00:00,2,0,2,FMN GV 05 Lier
60,Mechelsesteenweg 365,2018-12-13,04:00:00,0,0,0,FMN GV 05 Lier
60,Mechelsesteenweg 365,2018-12-13,05:00:00,4,0,4,FMN GV 05 Lier
60,Mechelsesteenweg 365,2018-12-13,06:00:00,4,0,4,FMN GV 05 Lier
60,Mechelsesteenweg 365,2018-12-13,07:00:00,108,64,44,FMN GV 05 Lier
60,Mechelsesteenweg 365,2018-12-13,08:00:00,68,42,26,FMN GV 05 Lier
60,Mechelsesteenweg 365,2018-12-13,09:00:00,28,20,8,FMN GV 05 Lier
60,Mechelsesteenweg 365,2018-12-13,10:00:00,74,20,54,FMN GV 05 Lier
60,Mechelsesteenweg 365,2018-12-13,11:00:00,36,16,20,FMN GV 05 Lier
60,Mechelsesteenweg 365,2018-12-13,12:00:00,84,18,66,FMN GV 05 Lier
60,Mechelsesteenweg 365,2018-12-13,13:00:00,48,26,22,FMN GV 05 Lier
60,Mechelsesteenweg 365,2018-12-13,14:00:00,68,30,38,FMN GV 05 Lier
60,Mechelsesteenweg 365,2018-12-13,15:00:00,58,22,36,FMN GV 05 Lier
60,Mechelsesteenweg 365,2018-12-13,16:00:00,36,24,12,FMN GV 05 Lier
60,Mechelsesteenweg 365,2018-12-13,17:00:00,56,40,16,FMN GV 05 Lier
60,Mechelsesteenweg 365,2018-12-13,18:00:00,10,6,4,FMN GV 05 Lier
60,Mechelsesteenweg 365,2018-12-13,19:00:00,2,2,0,FMN GV 05 Lier
60,Mechelsesteenweg 365,2018-12-13,20:00:00,10,4,6,FMN GV 05 Lier
60,Mechelsesteenweg 365,2018-12-13,21:00:00,4,2,2,FMN GV 05 Lier
60,Mechelsesteenweg 365,2018-12-13,22:00:00,0,0,0,FMN GV 05 Lier
60,Mechelsesteenweg 365,2018-12-13,23:00:00,0,0,0,FMN GV 05 Lier
60,Mechelsesteenweg 365,2018-12-14,00:00:00,0,0,0,FMN GV 05 Lier
60,Mechelsesteenweg 365,2018-12-14,01:00:00,0,0,0,FMN GV 05 Lier
60,Mechelsesteenweg 365,2018-12-14,02:00:00,0,0,0,FMN GV 05 Lier
60,Mechelsesteenweg 365,2018-12-14,03:00:00,2,0,2,FMN GV 05 Lier
60,Mechelsesteenweg 365,2018-12-14,04:00:00,0,0,0,FMN GV 05 Lier
60,Mechelsesteenweg 365,2018-12-14,05:00:00,2,0,2,FMN GV 05 Lier
60,Mechelsesteenweg 365,2018-12-14,06:00:00,8,0,8,FMN GV 05 Lier
60,Mechelsesteenweg 365,2018-12-14,07:00:00,94,64,30,FMN GV 05 Lier
60,Mechelsesteenweg 365,2018-12-14,08:00:00,76,52,24,FMN GV 05 Lier
60,Mechelsesteenweg 365,2018-12-14,09:00:00,26,12,14,FMN GV 05 Lier
60,Mechelsesteenweg 365,2018-12-14,10:00:00,80,14,66,FMN GV 05 Lier
60,Mechelsesteenweg 365,2018-12-14,11:00:00,34,4,30,FMN GV 05 Lier
60,Mechelsesteenweg 365,2018-12-14,12:00:00,56,20,36,FMN GV 05 Lier
60,Mechelsesteenweg 365,2018-12-14,13:00:00,66,34,32,FMN GV 05 Lier
60,Mechelsesteenweg 365,2018-12-14,14:00:00,48,14,34,FMN GV 05 Lier
60,Mechelsesteenweg 365,2018-12-14,15:00:00,48,18,30,FMN GV 05 Lier
60,Mechelsesteenweg 365,2018-12-14,16:00:00,50,34,16,FMN GV 05 Lier
60,Mechelsesteenweg 365,2018-12-14,17:00:00,26,16,10,FMN GV 05 Lier
60,Mechelsesteenweg 365,2018-12-14,18:00:00,16,8,8,FMN GV 05 Lier
60,Mechelsesteenweg 365,2018-12-14,19:00:00,10,4,6,FMN GV 05 Lier
60,Mechelsesteenweg 365,2018-12-14,20:00:00,6,6,0,FMN GV 05 Lier
60,Mechelsesteenweg 365,2018-12-14,21:00:00,2,2,0,FMN GV 05 Lier
60,Mechelsesteenweg 365,2018-12-14,22:00:00,2,2,0,FMN GV 05 Lier
60,Mechelsesteenweg 365,2018-12-14,23:00:00,4,2,2,FMN GV 05 Lier
60,Mechelsesteenweg 365,2018-12-15,00:00:00,0,0,0,FMN GV 05 Lier
60,Mechelsesteenweg 365,2018-12-15,01:00:00,2,0,2,FMN GV 05 Lier
60,Mechelsesteenweg 365,2018-12-15,02:00:00,0,0,0,FMN GV 05 Lier
60,Mechelsesteenweg 365,2018-12-15,03:00:00,0,0,0,FMN GV 05 Lier
60,Mechelsesteenweg 365,2018-12-15,04:00:00,0,0,0,FMN GV 05 Lier
60,Mechelsesteenweg 365,2018-12-15,05:00:00,4,2,2,FMN GV 05 Lier
60,Mechelsesteenweg 365,2018-12-15,06:00:00,2,2,0,FMN GV 05 Lier
60,Mechelsesteenweg 365,2018-12-15,07:00:00,12,8,4,FMN GV 05 Lier
60,Mechelsesteenweg 365,2018-12-15,08:00:00,8,6,2,FMN GV 05 Lier
60,Mechelsesteenweg 365,2018-12-15,09:00:00,28,8,20,FMN GV 05 Lier
60,Mechelsesteenweg 365,2018-12-15,10:00:00,50,24,26,FMN GV 05 Lier
60,Mechelsesteenweg 365,2018-12-15,11:00:00,40,24,16,FMN GV 05 Lier
60,Mechelsesteenweg 365,2018-12-15,12:00:00,56,34,22,FMN GV 05 Lier
60,Mechelsesteenweg 365,2018-12-15,13:00:00,52,16,36,FMN GV 05 Lier
60,Mechelsesteenweg 365,2018-12-15,14:00:00,82,44,38,FMN GV 05 Lier
60,Mechelsesteenweg 365,2018-12-15,15:00:00,44,18,26,FMN GV 05 Lier
60,Mechelsesteenweg 365,2018-12-15,16:00:00,30,12,18,FMN GV 05 Lier
60,Mechelsesteenweg 365,2018-12-15,17:00:00,8,4,4,FMN GV 05 Lier
60,Mechelsesteenweg 365,2018-12-15,18:00:00,4,2,2,FMN GV 05 Lier
60,Mechelsesteenweg 365,2018-12-15,19:00:00,2,0,2,FMN GV 05 Lier
60,Mechelsesteenweg 365,2018-12-15,20:00:00,0,0,0,FMN GV 05 Lier
60,Mechelsesteenweg 365,2018-12-15,21:00:00,0,0,0,FMN GV 05 Lier
60,Mechelsesteenweg 365,2018-12-15,22:00:00,2,2,0,FMN GV 05 Lier
60,Mechelsesteenweg 365,2018-12-15,23:00:00,0,0,0,FMN GV 05 Lier
60,Mechelsesteenweg 365,2018-12-16,00:00:00,0,0,0,FMN GV 05 Lier
60,Mechelsesteenweg 365,2018-12-16,01:00:00,0,0,0,FMN GV 05 Lier
60,Mechelsesteenweg 365,2018-12-16,02:00:00,4,4,0,FMN GV 05 Lier
60,Mechelsesteenweg 365,2018-12-16,03:00:00,0,0,0,FMN GV 05 Lier
60,Mechelsesteenweg 365,2018-12-16,04:00:00,0,0,0,FMN GV 05 Lier
60,Mechelsesteenweg 365,2018-12-16,05:00:00,0,0,0,FMN GV 05 Lier
60,Mechelsesteenweg 365,2018-12-16,06:00:00,0,0,0,FMN GV 05 Lier
60,Mechelsesteenweg 365,2018-12-16,07:00:00,0,0,0,FMN GV 05 Lier
60,Mechelsesteenweg 365,2018-12-16,08:00:00,4,4,0,FMN GV 05 Lier
60,Mechelsesteenweg 365,2018-12-16,09:00:00,14,10,4,FMN GV 05 Lier
60,Mechelsesteenweg 365,2018-12-16,10:00:00,50,24,26,FMN GV 05 Lier
60,Mechelsesteenweg 365,2018-12-16,11:00:00,44,16,28,FMN GV 05 Lier
60,Mechelsesteenweg 365,2018-12-16,12:00:00,28,16,12,FMN GV 05 Lier
60,Mechelsesteenweg 365,2018-12-16,13:00:00,44,22,22,FMN GV 05 Lier
60,Mechelsesteenweg 365,2018-12-16,14:00:00,40,18,22,FMN GV 05 Lier
60,Mechelsesteenweg 365,2018-12-16,15:00:00,50,22,28,FMN GV 05 Lier
60,Mechelsesteenweg 365,2018-12-16,16:00:00,24,10,14,FMN GV 05 Lier
60,Mechelsesteenweg 365,2018-12-16,17:00:00,14,6,8,FMN GV 05 Lier
60,Mechelsesteenweg 365,2018-12-16,18:00:00,4,2,2,FMN GV 05 Lier
60,Mechelsesteenweg 365,2018-12-16,19:00:00,4,0,4,FMN GV 05 Lier
60,Mechelsesteenweg 365,2018-12-16,20:00:00,4,0,4,FMN GV 05 Lier
60,Mechelsesteenweg 365,2018-12-16,21:00:00,6,2,4,FMN GV 05 Lier
60,Mechelsesteenweg 365,2018-12-16,22:00:00,0,0,0,FMN GV 05 Lier
60,Mechelsesteenweg 365,2018-12-16,23:00:00,2,0,2,FMN GV 05 Lier
60,Mechelsesteenweg 365,2018-12-17,00:00:00,0,0,0,FMN GV 05 Lier
60,Mechelsesteenweg 365,2018-12-17,01:00:00,0,0,0,FMN GV 05 Lier
60,Mechelsesteenweg 365,2018-12-17,02:00:00,0,0,0,FMN GV 05 Lier
60,Mechelsesteenweg 365,2018-12-17,03:00:00,2,0,2,FMN GV 05 Lier
60,Mechelsesteenweg 365,2018-12-17,04:00:00,2,0,2,FMN GV 05 Lier
60,Mechelsesteenweg 365,2018-12-17,05:00:00,2,0,2,FMN GV 05 Lier
60,Mechelsesteenweg 365,2018-12-17,06:00:00,4,0,4,FMN GV 05 Lier
60,Mechelsesteenweg 365,2018-12-17,07:00:00,92,50,42,FMN GV 05 Lier
60,Mechelsesteenweg 365,2018-12-17,08:00:00,86,54,32,FMN GV 05 Lier
60,Mechelsesteenweg 365,2018-12-17,09:00:00,38,24,14,FMN GV 05 Lier
60,Mechelsesteenweg 365,2018-12-17,10:00:00,66,14,52,FMN GV 05 Lier
60,Mechelsesteenweg 365,2018-12-17,11:00:00,68,28,40,FMN GV 05 Lier
60,Mechelsesteenweg 365,2018-12-17,12:00:00,76,14,62,FMN GV 05 Lier
60,Mechelsesteenweg 365,2018-12-17,13:00:00,68,30,38,FMN GV 05 Lier
60,Mechelsesteenweg 365,2018-12-17,14:00:00,118,72,46,FMN GV 05 Lier
60,Mechelsesteenweg 365,2018-12-17,15:00:00,54,22,32,FMN GV 05 Lier
60,Mechelsesteenweg 365,2018-12-17,16:00:00,64,30,34,FMN GV 05 Lier
60,Mechelsesteenweg 365,2018-12-17,17:00:00,50,34,16,FMN GV 05 Lier
60,Mechelsesteenweg 365,2018-12-17,18:00:00,20,14,6,FMN GV 05 Lier
60,Mechelsesteenweg 365,2018-12-17,19:00:00,2,2,0,FMN GV 05 Lier
60,Mechelsesteenweg 365,2018-12-17,20:00:00,2,2,0,FMN GV 05 Lier
60,Mechelsesteenweg 365,2018-12-17,21:00:00,4,2,2,FMN GV 05 Lier
60,Mechelsesteenweg 365,2018-12-17,22:00:00,0,0,0,FMN GV 05 Lier
60,Mechelsesteenweg 365,2018-12-17,23:00:00,4,2,2,FMN GV 05 Lier
60,Mechelsesteenweg 365,2018-12-18,00:00:00,0,0,0,FMN GV 05 Lier
60,Mechelsesteenweg 365,2018-12-18,01:00:00,0,0,0,FMN GV 05 Lier
60,Mechelsesteenweg 365,2018-12-18,02:00:00,0,0,0,FMN GV 05 Lier
60,Mechelsesteenweg 365,2018-12-18,03:00:00,0,0,0,FMN GV 05 Lier
60,Mechelsesteenweg 365,2018-12-18,04:00:00,2,0,2,FMN GV 05 Lier
60,Mechelsesteenweg 365,2018-12-18,05:00:00,2,0,2,FMN GV 05 Lier
60,Mechelsesteenweg 365,2018-12-18,06:00:00,6,0,6,FMN GV 05 Lier
60,Mechelsesteenweg 365,2018-12-18,07:00:00,120,76,44,FMN GV 05 Lier
60,Mechelsesteenweg 365,2018-12-18,08:00:00,86,60,26,FMN GV 05 Lier
60,Mechelsesteenweg 365,2018-12-18,09:00:00,36,8,28,FMN GV 05 Lier
60,Mechelsesteenweg 365,2018-12-18,10:00:00,106,34,72,FMN GV 05 Lier
60,Mechelsesteenweg 365,2018-12-18,11:00:00,58,28,30,FMN GV 05 Lier
60,Mechelsesteenweg 365,2018-12-18,12:00:00,60,18,42,FMN GV 05 Lier
60,Mechelsesteenweg 365,2018-12-18,13:00:00,122,52,70,FMN GV 05 Lier
60,Mechelsesteenweg 365,2018-12-18,14:00:00,110,58,52,FMN GV 05 Lier
60,Mechelsesteenweg 365,2018-12-18,15:00:00,110,54,56,FMN GV 05 Lier
60,Mechelsesteenweg 365,2018-12-18,16:00:00,72,42,30,FMN GV 05 Lier
60,Mechelsesteenweg 365,2018-12-18,17:00:00,58,26,32,FMN GV 05 Lier
60,Mechelsesteenweg 365,2018-12-18,18:00:00,32,20,12,FMN GV 05 Lier
60,Mechelsesteenweg 365,2018-12-18,19:00:00,2,2,0,FMN GV 05 Lier
60,Mechelsesteenweg 365,2018-12-18,20:00:00,2,2,0,FMN GV 05 Lier
60,Mechelsesteenweg 365,2018-12-18,21:00:00,4,2,2,FMN GV 05 Lier
60,Mechelsesteenweg 365,2018-12-18,22:00:00,2,0,2,FMN GV 05 Lier
60,Mechelsesteenweg 365,2018-12-18,23:00:00,2,2,0,FMN GV 05 Lier
60,Mechelsesteenweg 365,2018-12-19,00:00:00,0,0,0,FMN GV 05 Lier
60,Mechelsesteenweg 365,2018-12-19,01:00:00,0,0,0,FMN GV 05 Lier
60,Mechelsesteenweg 365,2018-12-19,02:00:00,0,0,0,FMN GV 05 Lier
60,Mechelsesteenweg 365,2018-12-19,03:00:00,0,0,0,FMN GV 05 Lier
60,Mechelsesteenweg 365,2018-12-19,04:00:00,2,0,2,FMN GV 05 Lier
60,Mechelsesteenweg 365,2018-12-19,05:00:00,2,0,2,FMN GV 05 Lier
60,Mechelsesteenweg 365,2018-12-19,06:00:00,6,2,4,FMN GV 05 Lier
60,Mechelsesteenweg 365,2018-12-19,07:00:00,76,48,28,FMN GV 05 Lier
60,Mechelsesteenweg 365,2018-12-19,08:00:00,78,42,36,FMN GV 05 Lier
60,Mechelsesteenweg 365,2018-12-19,09:00:00,56,40,16,FMN GV 05 Lier
60,Mechelsesteenweg 365,2018-12-19,10:00:00,56,12,44,FMN GV 05 Lier
60,Mechelsesteenweg 365,2018-12-19,11:00:00,42,10,32,FMN GV 05 Lier
60,Mechelsesteenweg 365,2018-12-19,12:00:00,96,30,66,FMN GV 05 Lier
60,Mechelsesteenweg 365,2018-12-19,13:00:00,76,30,46,FMN GV 05 Lier
60,Mechelsesteenweg 365,2018-12-19,14:00:00,64,38,26,FMN GV 05 Lier
60,Mechelsesteenweg 365,2018-12-19,15:00:00,68,32,36,FMN GV 05 Lier
60,Mechelsesteenweg 365,2018-12-19,16:00:00,58,28,30,FMN GV 05 Lier
60,Mechelsesteenweg 365,2018-12-19,17:00:00,52,32,20,FMN GV 05 Lier
60,Mechelsesteenweg 365,2018-12-19,18:00:00,20,14,6,FMN GV 05 Lier
60,Mechelsesteenweg 365,2018-12-19,19:00:00,8,6,2,FMN GV 05 Lier
60,Mechelsesteenweg 365,2018-12-19,20:00:00,6,2,4,FMN GV 05 Lier
60,Mechelsesteenweg 365,2018-12-19,21:00:00,2,0,2,FMN GV 05 Lier
60,Mechelsesteenweg 365,2018-12-19,22:00:00,2,0,2,FMN GV 05 Lier
60,Mechelsesteenweg 365,2018-12-19,23:00:00,0,0,0,FMN GV 05 Lier
60,Mechelsesteenweg 365,2018-12-20,00:00:00,0,0,0,FMN GV 05 Lier
60,Mechelsesteenweg 365,2018-12-20,01:00:00,0,0,0,FMN GV 05 Lier
60,Mechelsesteenweg 365,2018-12-20,02:00:00,0,0,0,FMN GV 05 Lier
60,Mechelsesteenweg 365,2018-12-20,03:00:00,0,0,0,FMN GV 05 Lier
60,Mechelsesteenweg 365,2018-12-20,04:00:00,0,0,0,FMN GV 05 Lier
60,Mechelsesteenweg 365,2018-12-20,05:00:00,2,0,2,FMN GV 05 Lier
60,Mechelsesteenweg 365,2018-12-20,06:00:00,4,2,2,FMN GV 05 Lier
60,Mechelsesteenweg 365,2018-12-20,07:00:00,46,14,32,FMN GV 05 Lier
60,Mechelsesteenweg 365,2018-12-20,08:00:00,60,42,18,FMN GV 05 Lier
60,Mechelsesteenweg 365,2018-12-20,09:00:00,40,28,12,FMN GV 05 Lier
60,Mechelsesteenweg 365,2018-12-20,10:00:00,36,12,24,FMN GV 05 Lier
60,Mechelsesteenweg 365,2018-12-20,11:00:00,34,16,18,FMN GV 05 Lier
60,Mechelsesteenweg 365,2018-12-20,12:00:00,54,10,44,FMN GV 05 Lier
60,Mechelsesteenweg 365,2018-12-20,13:00:00,40,24,16,FMN GV 05 Lier
60,Mechelsesteenweg 365,2018-12-20,14:00:00,34,16,18,FMN GV 05 Lier
60,Mechelsesteenweg 365,2018-12-20,15:00:00,34,20,14,FMN GV 05 Lier
60,Mechelsesteenweg 365,2018-12-20,16:00:00,52,20,32,FMN GV 05 Lier
60,Mechelsesteenweg 365,2018-12-20,17:00:00,36,26,10,FMN GV 05 Lier
60,Mechelsesteenweg 365,2018-12-20,18:00:00,24,18,6,FMN GV 05 Lier
60,Mechelsesteenweg 365,2018-12-20,19:00:00,10,4,6,FMN GV 05 Lier
60,Mechelsesteenweg 365,2018-12-20,20:00:00,4,2,2,FMN GV 05 Lier
60,Mechelsesteenweg 365,2018-12-20,21:00:00,6,2,4,FMN GV 05 Lier
60,Mechelsesteenweg 365,2018-12-20,22:00:00,4,2,2,FMN GV 05 Lier
60,Mechelsesteenweg 365,2018-12-20,23:00:00,0,0,0,FMN GV 05 Lier
60,Mechelsesteenweg 365,2018-12-21,00:00:00,0,0,0,FMN GV 05 Lier
60,Mechelsesteenweg 365,2018-12-21,01:00:00,2,2,0,FMN GV 05 Lier
60,Mechelsesteenweg 365,2018-12-21,02:00:00,2,0,2,FMN GV 05 Lier
60,Mechelsesteenweg 365,2018-12-21,03:00:00,0,0,0,FMN GV 05 Lier
60,Mechelsesteenweg 365,2018-12-21,04:00:00,0,0,0,FMN GV 05 Lier
60,Mechelsesteenweg 365,2018-12-21,05:00:00,0,0,0,FMN GV 05 Lier
60,Mechelsesteenweg 365,2018-12-21,06:00:00,4,0,4,FMN GV 05 Lier
60,Mechelsesteenweg 365,2018-12-21,07:00:00,34,18,16,FMN GV 05 Lier
60,Mechelsesteenweg 365,2018-12-21,08:00:00,68,46,22,FMN GV 05 Lier
60,Mechelsesteenweg 365,2018-12-21,09:00:00,26,20,6,FMN GV 05 Lier
60,Mechelsesteenweg 365,2018-12-21,10:00:00,12,6,6,FMN GV 05 Lier
60,Mechelsesteenweg 365,2018-12-21,11:00:00,14,4,10,FMN GV 05 Lier
60,Mechelsesteenweg 365,2018-12-21,12:00:00,64,14,50,FMN GV 05 Lier
60,Mechelsesteenweg 365,2018-12-21,13:00:00,20,10,10,FMN GV 05 Lier
60,Mechelsesteenweg 365,2018-12-21,14:00:00,28,12,16,FMN GV 05 Lier
60,Mechelsesteenweg 365,2018-12-21,15:00:00,26,14,12,FMN GV 05 Lier
60,Mechelsesteenweg 365,2018-12-21,16:00:00,24,14,10,FMN GV 05 Lier
60,Mechelsesteenweg 365,2018-12-21,17:00:00,18,8,10,FMN GV 05 Lier
60,Mechelsesteenweg 365,2018-12-21,18:00:00,16,12,4,FMN GV 05 Lier
60,Mechelsesteenweg 365,2018-12-21,19:00:00,10,6,4,FMN GV 05 Lier
60,Mechelsesteenweg 365,2018-12-21,20:00:00,0,0,0,FMN GV 05 Lier
60,Mechelsesteenweg 365,2018-12-21,21:00:00,4,0,4,FMN GV 05 Lier
60,Mechelsesteenweg 365,2018-12-21,22:00:00,18,0,18,FMN GV 05 Lier
60,Mechelsesteenweg 365,2018-12-21,23:00:00,6,6,0,FMN GV 05 Lier
60,Mechelsesteenweg 365,2018-12-22,00:00:00,0,0,0,FMN GV 05 Lier
60,Mechelsesteenweg 365,2018-12-22,01:00:00,8,8,0,FMN GV 05 Lier
60,Mechelsesteenweg 365,2018-12-22,02:00:00,16,12,4,FMN GV 05 Lier
60,Mechelsesteenweg 365,2018-12-22,03:00:00,0,0,0,FMN GV 05 Lier
60,Mechelsesteenweg 365,2018-12-22,04:00:00,0,0,0,FMN GV 05 Lier
60,Mechelsesteenweg 365,2018-12-22,05:00:00,0,0,0,FMN GV 05 Lier
60,Mechelsesteenweg 365,2018-12-22,06:00:00,2,0,2,FMN GV 05 Lier
60,Mechelsesteenweg 365,2018-12-22,07:00:00,2,0,2,FMN GV 05 Lier
60,Mechelsesteenweg 365,2018-12-22,08:00:00,0,0,0,FMN GV 05 Lier
60,Mechelsesteenweg 365,2018-12-22,09:00:00,20,10,10,FMN GV 05 Lier
60,Mechelsesteenweg 365,2018-12-22,10:00:00,36,24,12,FMN GV 05 Lier
60,Mechelsesteenweg 365,2018-12-22,11:00:00,82,40,42,FMN GV 05 Lier
60,Mechelsesteenweg 365,2018-12-22,12:00:00,72,38,34,FMN GV 05 Lier
60,Mechelsesteenweg 365,2018-12-22,13:00:00,84,34,50,FMN GV 05 Lier
60,Mechelsesteenweg 365,2018-12-22,14:00:00,152,100,52,FMN GV 05 Lier
60,Mechelsesteenweg 365,2018-12-22,15:00:00,98,56,42,FMN GV 05 Lier
60,Mechelsesteenweg 365,2018-12-22,16:00:00,48,20,28,FMN GV 05 Lier
60,Mechelsesteenweg 365,2018-12-22,17:00:00,12,8,4,FMN GV 05 Lier
60,Mechelsesteenweg 365,2018-12-22,18:00:00,2,0,2,FMN GV 05 Lier
60,Mechelsesteenweg 365,2018-12-22,19:00:00,4,4,0,FMN GV 05 Lier
60,Mechelsesteenweg 365,2018-12-22,20:00:00,4,0,4,FMN GV 05 Lier
60,Mechelsesteenweg 365,2018-12-22,21:00:00,0,0,0,FMN GV 05 Lier
60,Mechelsesteenweg 365,2018-12-22,22:00:00,2,0,2,FMN GV 05 Lier
60,Mechelsesteenweg 365,2018-12-22,23:00:00,0,0,0,FMN GV 05 Lier
60,Mechelsesteenweg 365,2018-12-23,00:00:00,0,0,0,FMN GV 05 Lier
60,Mechelsesteenweg 365,2018-12-23,01:00:00,0,0,0,FMN GV 05 Lier
60,Mechelsesteenweg 365,2018-12-23,02:00:00,6,2,4,FMN GV 05 Lier
60,Mechelsesteenweg 365,2018-12-23,03:00:00,0,0,0,FMN GV 05 Lier
60,Mechelsesteenweg 365,2018-12-23,04:00:00,0,0,0,FMN GV 05 Lier
60,Mechelsesteenweg 365,2018-12-23,05:00:00,0,0,0,FMN GV 05 Lier
60,Mechelsesteenweg 365,2018-12-23,06:00:00,2,0,2,FMN GV 05 Lier
60,Mechelsesteenweg 365,2018-12-23,07:00:00,0,0,0,FMN GV 05 Lier
60,Mechelsesteenweg 365,2018-12-23,08:00:00,16,14,2,FMN GV 05 Lier
60,Mechelsesteenweg 365,2018-12-23,09:00:00,74,48,26,FMN GV 05 Lier
60,Mechelsesteenweg 365,2018-12-23,10:00:00,82,48,34,FMN GV 05 Lier
60,Mechelsesteenweg 365,2018-12-23,11:00:00,56,14,42,FMN GV 05 Lier
60,Mechelsesteenweg 365,2018-12-23,12:00:00,16,6,10,FMN GV 05 Lier
60,Mechelsesteenweg 365,2018-12-23,13:00:00,4,2,2,FMN GV 05 Lier
60,Mechelsesteenweg 365,2018-12-23,14:00:00,12,8,4,FMN GV 05 Lier
60,Mechelsesteenweg 365,2018-12-23,15:00:00,8,0,8,FMN GV 05 Lier
60,Mechelsesteenweg 365,2018-12-23,16:00:00,8,2,6,FMN GV 05 Lier
60,Mechelsesteenweg 365,2018-12-23,17:00:00,12,8,4,FMN GV 05 Lier
60,Mechelsesteenweg 365,2018-12-23,18:00:00,2,2,0,FMN GV 05 Lier
60,Mechelsesteenweg 365,2018-12-23,19:00:00,0,0,0,FMN GV 05 Lier
60,Mechelsesteenweg 365,2018-12-23,20:00:00,0,0,0,FMN GV 05 Lier
60,Mechelsesteenweg 365,2018-12-23,21:00:00,2,2,0,FMN GV 05 Lier
60,Mechelsesteenweg 365,2018-12-23,22:00:00,0,0,0,FMN GV 05 Lier
60,Mechelsesteenweg 365,2018-12-23,23:00:00,2,0,2,FMN GV 05 Lier
60,Mechelsesteenweg 365,2018-12-24,00:00:00,0,0,0,FMN GV 05 Lier
60,Mechelsesteenweg 365,2018-12-24,01:00:00,0,0,0,FMN GV 05 Lier
60,Mechelsesteenweg 365,2018-12-24,02:00:00,0,0,0,FMN GV 05 Lier
60,Mechelsesteenweg 365,2018-12-24,03:00:00,0,0,0,FMN GV 05 Lier
60,Mechelsesteenweg 365,2018-12-24,04:00:00,0,0,0,FMN GV 05 Lier
60,Mechelsesteenweg 365,2018-12-24,05:00:00,2,0,2,FMN GV 05 Lier
60,Mechelsesteenweg 365,2018-12-24,06:00:00,4,2,2,FMN GV 05 Lier
60,Mechelsesteenweg 365,2018-12-24,07:00:00,6,4,2,FMN GV 05 Lier
60,Mechelsesteenweg 365,2018-12-24,08:00:00,14,6,8,FMN GV 05 Lier
60,Mechelsesteenweg 365,2018-12-24,09:00:00,30,16,14,FMN GV 05 Lier
60,Mechelsesteenweg 365,2018-12-24,10:00:00,80,32,48,FMN GV 05 Lier
60,Mechelsesteenweg 365,2018-12-24,11:00:00,72,34,38,FMN GV 05 Lier
60,Mechelsesteenweg 365,2018-12-24,12:00:00,98,46,52,FMN GV 05 Lier
60,Mechelsesteenweg 365,2018-12-24,13:00:00,94,46,48,FMN GV 05 Lier
60,Mechelsesteenweg 365,2018-12-24,14:00:00,122,62,60,FMN GV 05 Lier
60,Mechelsesteenweg 365,2018-12-24,15:00:00,74,42,32,FMN GV 05 Lier
60,Mechelsesteenweg 365,2018-12-24,16:00:00,44,26,18,FMN GV 05 Lier
60,Mechelsesteenweg 365,2018-12-24,17:00:00,8,6,2,FMN GV 05 Lier
60,Mechelsesteenweg 365,2018-12-24,18:00:00,2,0,2,FMN GV 05 Lier
60,Mechelsesteenweg 365,2018-12-24,19:00:00,0,0,0,FMN GV 05 Lier
60,Mechelsesteenweg 365,2018-12-24,20:00:00,2,2,0,FMN GV 05 Lier
60,Mechelsesteenweg 365,2018-12-24,21:00:00,0,0,0,FMN GV 05 Lier
60,Mechelsesteenweg 365,2018-12-24,22:00:00,0,0,0,FMN GV 05 Lier
60,Mechelsesteenweg 365,2018-12-24,23:00:00,0,0,0,FMN GV 05 Lier
60,Mechelsesteenweg 365,2018-12-25,00:00:00,0,0,0,FMN GV 05 Lier
60,Mechelsesteenweg 365,2018-12-25,01:00:00,0,0,0,FMN GV 05 Lier
60,Mechelsesteenweg 365,2018-12-25,02:00:00,0,0,0,FMN GV 05 Lier
60,Mechelsesteenweg 365,2018-12-25,03:00:00,0,0,0,FMN GV 05 Lier
60,Mechelsesteenweg 365,2018-12-25,04:00:00,0,0,0,FMN GV 05 Lier
60,Mechelsesteenweg 365,2018-12-25,05:00:00,0,0,0,FMN GV 05 Lier
60,Mechelsesteenweg 365,2018-12-25,06:00:00,2,0,2,FMN GV 05 Lier
60,Mechelsesteenweg 365,2018-12-25,07:00:00,2,0,2,FMN GV 05 Lier
60,Mechelsesteenweg 365,2018-12-25,08:00:00,4,4,0,FMN GV 05 Lier
60,Mechelsesteenweg 365,2018-12-25,09:00:00,22,12,10,FMN GV 05 Lier
60,Mechelsesteenweg 365,2018-12-25,10:00:00,62,32,30,FMN GV 05 Lier
60,Mechelsesteenweg 365,2018-12-25,11:00:00,88,46,42,FMN GV 05 Lier
60,Mechelsesteenweg 365,2018-12-25,12:00:00,100,54,46,FMN GV 05 Lier
60,Mechelsesteenweg 365,2018-12-25,13:00:00,112,62,50,FMN GV 05 Lier
60,Mechelsesteenweg 365,2018-12-25,14:00:00,138,80,58,FMN GV 05 Lier
60,Mechelsesteenweg 365,2018-12-25,15:00:00,70,28,42,FMN GV 05 Lier
60,Mechelsesteenweg 365,2018-12-25,16:00:00,36,10,26,FMN GV 05 Lier
60,Mechelsesteenweg 365,2018-12-25,17:00:00,4,4,0,FMN GV 05 Lier
60,Mechelsesteenweg 365,2018-12-25,18:00:00,2,2,0,FMN GV 05 Lier
60,Mechelsesteenweg 365,2018-12-25,19:00:00,0,0,0,FMN GV 05 Lier
60,Mechelsesteenweg 365,2018-12-25,20:00:00,0,0,0,FMN GV 05 Lier
60,Mechelsesteenweg 365,2018-12-25,21:00:00,0,0,0,FMN GV 05 Lier
60,Mechelsesteenweg 365,2018-12-25,22:00:00,4,0,4,FMN GV 05 Lier
60,Mechelsesteenweg 365,2018-12-25,23:00:00,0,0,0,FMN GV 05 Lier
60,Mechelsesteenweg 365,2018-12-26,00:00:00,0,0,0,FMN GV 05 Lier
60,Mechelsesteenweg 365,2018-12-26,01:00:00,0,0,0,FMN GV 05 Lier
60,Mechelsesteenweg 365,2018-12-26,02:00:00,0,0,0,FMN GV 05 Lier
60,Mechelsesteenweg 365,2018-12-26,03:00:00,0,0,0,FMN GV 05 Lier
60,Mechelsesteenweg 365,2018-12-26,04:00:00,0,0,0,FMN GV 05 Lier
60,Mechelsesteenweg 365,2018-12-26,05:00:00,2,0,2,FMN GV 05 Lier
60,Mechelsesteenweg 365,2018-12-26,06:00:00,2,0,2,FMN GV 05 Lier
60,Mechelsesteenweg 365,2018-12-26,07:00:00,12,4,8,FMN GV 05 Lier
60,Mechelsesteenweg 365,2018-12-26,08:00:00,14,6,8,FMN GV 05 Lier
60,Mechelsesteenweg 365,2018-12-26,09:00:00,16,8,8,FMN GV 05 Lier
60,Mechelsesteenweg 365,2018-12-26,10:00:00,34,12,22,FMN GV 05 Lier
60,Mechelsesteenweg 365,2018-12-26,11:00:00,82,42,40,FMN GV 05 Lier
60,Mechelsesteenweg 365,2018-12-26,12:00:00,92,62,30,FMN GV 05 Lier
60,Mechelsesteenweg 365,2018-12-26,13:00:00,96,46,50,FMN GV 05 Lier
60,Mechelsesteenweg 365,2018-12-26,14:00:00,124,50,74,FMN GV 05 Lier
60,Mechelsesteenweg 365,2018-12-26,15:00:00,122,62,60,FMN GV 05 Lier
60,Mechelsesteenweg 365,2018-12-26,16:00:00,40,22,18,FMN GV 05 Lier
60,Mechelsesteenweg 365,2018-12-26,17:00:00,20,10,10,FMN GV 05 Lier
60,Mechelsesteenweg 365,2018-12-26,18:00:00,8,4,4,FMN GV 05 Lier
60,Mechelsesteenweg 365,2018-12-26,19:00:00,10,10,0,FMN GV 05 Lier
60,Mechelsesteenweg 365,2018-12-26,20:00:00,6,4,2,FMN GV 05 Lier
60,Mechelsesteenweg 365,2018-12-26,21:00:00,6,4,2,FMN GV 05 Lier
60,Mechelsesteenweg 365,2018-12-26,22:00:00,2,2,0,FMN GV 05 Lier
60,Mechelsesteenweg 365,2018-12-26,23:00:00,0,0,0,FMN GV 05 Lier
60,Mechelsesteenweg 365,2018-12-27,00:00:00,0,0,0,FMN GV 05 Lier
60,Mechelsesteenweg 365,2018-12-27,01:00:00,2,2,0,FMN GV 05 Lier
60,Mechelsesteenweg 365,2018-12-27,02:00:00,0,0,0,FMN GV 05 Lier
60,Mechelsesteenweg 365,2018-12-27,03:00:00,0,0,0,FMN GV 05 Lier
60,Mechelsesteenweg 365,2018-12-27,04:00:00,0,0,0,FMN GV 05 Lier
60,Mechelsesteenweg 365,2018-12-27,05:00:00,2,0,2,FMN GV 05 Lier
60,Mechelsesteenweg 365,2018-12-27,06:00:00,0,0,0,FMN GV 05 Lier
60,Mechelsesteenweg 365,2018-12-27,07:00:00,10,2,8,FMN GV 05 Lier
60,Mechelsesteenweg 365,2018-12-27,08:00:00,22,6,16,FMN GV 05 Lier
60,Mechelsesteenweg 365,2018-12-27,09:00:00,16,8,8,FMN GV 05 Lier
60,Mechelsesteenweg 365,2018-12-27,10:00:00,32,16,16,FMN GV 05 Lier
60,Mechelsesteenweg 365,2018-12-27,11:00:00,74,30,44,FMN GV 05 Lier
60,Mechelsesteenweg 365,2018-12-27,12:00:00,70,34,36,FMN GV 05 Lier
60,Mechelsesteenweg 365,2018-12-27,13:00:00,102,42,60,FMN GV 05 Lier
60,Mechelsesteenweg 365,2018-12-27,14:00:00,134,60,74,FMN GV 05 Lier
60,Mechelsesteenweg 365,2018-12-27,15:00:00,82,32,50,FMN GV 05 Lier
60,Mechelsesteenweg 365,2018-12-27,16:00:00,44,26,18,FMN GV 05 Lier
60,Mechelsesteenweg 365,2018-12-27,17:00:00,30,18,12,FMN GV 05 Lier
60,Mechelsesteenweg 365,2018-12-27,18:00:00,16,14,2,FMN GV 05 Lier
60,Mechelsesteenweg 365,2018-12-27,19:00:00,10,4,6,FMN GV 05 Lier
60,Mechelsesteenweg 365,2018-12-27,20:00:00,2,2,0,FMN GV 05 Lier
60,Mechelsesteenweg 365,2018-12-27,21:00:00,2,2,0,FMN GV 05 Lier
60,Mechelsesteenweg 365,2018-12-27,22:00:00,6,0,6,FMN GV 05 Lier
60,Mechelsesteenweg 365,2018-12-27,23:00:00,0,0,0,FMN GV 05 Lier
60,Mechelsesteenweg 365,2018-12-28,00:00:00,0,0,0,FMN GV 05 Lier
60,Mechelsesteenweg 365,2018-12-28,01:00:00,0,0,0,FMN GV 05 Lier
60,Mechelsesteenweg 365,2018-12-28,02:00:00,0,0,0,FMN GV 05 Lier
60,Mechelsesteenweg 365,2018-12-28,03:00:00,0,0,0,FMN GV 05 Lier
60,Mechelsesteenweg 365,2018-12-28,04:00:00,0,0,0,FMN GV 05 Lier
60,Mechelsesteenweg 365,2018-12-28,05:00:00,0,0,0,FMN GV 05 Lier
60,Mechelsesteenweg 365,2018-12-28,06:00:00,6,2,4,FMN GV 05 Lier
60,Mechelsesteenweg 365,2018-12-28,07:00:00,12,4,8,FMN GV 05 Lier
60,Mechelsesteenweg 365,2018-12-28,08:00:00,16,6,10,FMN GV 05 Lier
60,Mechelsesteenweg 365,2018-12-28,09:00:00,16,6,10,FMN GV 05 Lier
60,Mechelsesteenweg 365,2018-12-28,10:00:00,92,72,20,FMN GV 05 Lier
60,Mechelsesteenweg 365,2018-12-28,11:00:00,56,46,10,FMN GV 05 Lier
60,Mechelsesteenweg 365,2018-12-28,12:00:00,20,4,16,FMN GV 05 Lier
60,Mechelsesteenweg 365,2018-12-28,13:00:00,32,22,10,FMN GV 05 Lier
60,Mechelsesteenweg 365,2018-12-28,14:00:00,40,24,16,FMN GV 05 Lier
60,Mechelsesteenweg 365,2018-12-28,15:00:00,32,6,26,FMN GV 05 Lier
60,Mechelsesteenweg 365,2018-12-28,16:00:00,28,22,6,FMN GV 05 Lier
60,Mechelsesteenweg 365,2018-12-28,17:00:00,20,12,8,FMN GV 05 Lier
60,Mechelsesteenweg 365,2018-12-28,18:00:00,6,4,2,FMN GV 05 Lier
60,Mechelsesteenweg 365,2018-12-28,19:00:00,4,0,4,FMN GV 05 Lier
60,Mechelsesteenweg 365,2018-12-28,20:00:00,8,6,2,FMN GV 05 Lier
60,Mechelsesteenweg 365,2018-12-28,21:00:00,2,2,0,FMN GV 05 Lier
60,Mechelsesteenweg 365,2018-12-28,22:00:00,0,0,0,FMN GV 05 Lier
60,Mechelsesteenweg 365,2018-12-28,23:00:00,0,0,0,FMN GV 05 Lier
60,Mechelsesteenweg 365,2018-12-29,00:00:00,0,0,0,FMN GV 05 Lier
60,Mechelsesteenweg 365,2018-12-29,01:00:00,0,0,0,FMN GV 05 Lier
60,Mechelsesteenweg 365,2018-12-29,02:00:00,0,0,0,FMN GV 05 Lier
60,Mechelsesteenweg 365,2018-12-29,03:00:00,0,0,0,FMN GV 05 Lier
60,Mechelsesteenweg 365,2018-12-29,04:00:00,0,0,0,FMN GV 05 Lier
60,Mechelsesteenweg 365,2018-12-29,05:00:00,0,0,0,FMN GV 05 Lier
60,Mechelsesteenweg 365,2018-12-29,06:00:00,2,2,0,FMN GV 05 Lier
60,Mechelsesteenweg 365,2018-12-29,07:00:00,6,4,2,FMN GV 05 Lier
60,Mechelsesteenweg 365,2018-12-29,08:00:00,10,6,4,FMN GV 05 Lier
60,Mechelsesteenweg 365,2018-12-29,09:00:00,28,8,20,FMN GV 05 Lier
60,Mechelsesteenweg 365,2018-12-29,10:00:00,84,48,36,FMN GV 05 Lier
60,Mechelsesteenweg 365,2018-12-29,11:00:00,80,44,36,FMN GV 05 Lier
60,Mechelsesteenweg 365,2018-12-29,12:00:00,72,50,22,FMN GV 05 Lier
60,Mechelsesteenweg 365,2018-12-29,13:00:00,58,32,26,FMN GV 05 Lier
60,Mechelsesteenweg 365,2018-12-29,14:00:00,56,32,24,FMN GV 05 Lier
60,Mechelsesteenweg 365,2018-12-29,15:00:00,26,6,20,FMN GV 05 Lier
60,Mechelsesteenweg 365,2018-12-29,16:00:00,10,2,8,FMN GV 05 Lier
60,Mechelsesteenweg 365,2018-12-29,17:00:00,8,2,6,FMN GV 05 Lier
60,Mechelsesteenweg 365,2018-12-29,18:00:00,4,2,2,FMN GV 05 Lier
60,Mechelsesteenweg 365,2018-12-29,19:00:00,2,0,2,FMN GV 05 Lier
60,Mechelsesteenweg 365,2018-12-29,20:00:00,4,0,4,FMN GV 05 Lier
60,Mechelsesteenweg 365,2018-12-29,21:00:00,2,0,2,FMN GV 05 Lier
60,Mechelsesteenweg 365,2018-12-29,22:00:00,0,0,0,FMN GV 05 Lier
60,Mechelsesteenweg 365,2018-12-29,23:00:00,0,0,0,FMN GV 05 Lier
60,Mechelsesteenweg 365,2018-12-30,00:00:00,2,2,0,FMN GV 05 Lier
60,Mechelsesteenweg 365,2018-12-30,01:00:00,0,0,0,FMN GV 05 Lier
60,Mechelsesteenweg 365,2018-12-30,02:00:00,0,0,0,FMN GV 05 Lier
60,Mechelsesteenweg 365,2018-12-30,03:00:00,0,0,0,FMN GV 05 Lier
60,Mechelsesteenweg 365,2018-12-30,04:00:00,2,2,0,FMN GV 05 Lier
60,Mechelsesteenweg 365,2018-12-30,05:00:00,0,0,0,FMN GV 05 Lier
60,Mechelsesteenweg 365,2018-12-30,06:00:00,0,0,0,FMN GV 05 Lier
60,Mechelsesteenweg 365,2018-12-30,07:00:00,4,0,4,FMN GV 05 Lier
60,Mechelsesteenweg 365,2018-12-30,08:00:00,20,12,8,FMN GV 05 Lier
60,Mechelsesteenweg 365,2018-12-30,09:00:00,54,32,22,FMN GV 05 Lier
60,Mechelsesteenweg 365,2018-12-30,10:00:00,122,64,58,FMN GV 05 Lier
60,Mechelsesteenweg 365,2018-12-30,11:00:00,200,100,100,FMN GV 05 Lier
60,Mechelsesteenweg 365,2018-12-30,12:00:00,104,64,40,FMN GV 05 Lier
60,Mechelsesteenweg 365,2018-12-30,13:00:00,82,48,34,FMN GV 05 Lier
60,Mechelsesteenweg 365,2018-12-30,14:00:00,84,30,54,FMN GV 05 Lier
60,Mechelsesteenweg 365,2018-12-30,15:00:00,78,40,38,FMN GV 05 Lier
60,Mechelsesteenweg 365,2018-12-30,16:00:00,36,12,24,FMN GV 05 Lier
60,Mechelsesteenweg 365,2018-12-30,17:00:00,24,6,18,FMN GV 05 Lier
60,Mechelsesteenweg 365,2018-12-30,18:00:00,2,0,2,FMN GV 05 Lier
60,Mechelsesteenweg 365,2018-12-30,19:00:00,4,0,4,FMN GV 05 Lier
60,Mechelsesteenweg 365,2018-12-30,20:00:00,2,2,0,FMN GV 05 Lier
60,Mechelsesteenweg 365,2018-12-30,21:00:00,4,0,4,FMN GV 05 Lier
60,Mechelsesteenweg 365,2018-12-30,22:00:00,0,0,0,FMN GV 05 Lier
60,Mechelsesteenweg 365,2018-12-30,23:00:00,2,2,0,FMN GV 05 Lier
60,Mechelsesteenweg 365,2018-12-31,00:00:00,0,0,0,FMN GV 05 Lier
60,Mechelsesteenweg 365,2018-12-31,01:00:00,0,0,0,FMN GV 05 Lier
60,Mechelsesteenweg 365,2018-12-31,02:00:00,2,0,2,FMN GV 05 Lier
60,Mechelsesteenweg 365,2018-12-31,03:00:00,0,0,0,FMN GV 05 Lier
60,Mechelsesteenweg 365,2018-12-31,04:00:00,0,0,0,FMN GV 05 Lier
60,Mechelsesteenweg 365,2018-12-31,05:00:00,2,0,2,FMN GV 05 Lier
60,Mechelsesteenweg 365,2018-12-31,06:00:00,4,4,0,FMN GV 05 Lier
60,Mechelsesteenweg 365,2018-12-31,07:00:00,6,0,6,FMN GV 05 Lier
60,Mechelsesteenweg 365,2018-12-31,08:00:00,14,10,4,FMN GV 05 Lier
60,Mechelsesteenweg 365,2018-12-31,09:00:00,24,16,8,FMN GV 05 Lier
60,Mechelsesteenweg 365,2018-12-31,10:00:00,36,8,28,FMN GV 05 Lier
60,Mechelsesteenweg 365,2018-12-31,11:00:00,54,30,24,FMN GV 05 Lier
60,Mechelsesteenweg 365,2018-12-31,12:00:00,32,18,14,FMN GV 05 Lier
60,Mechelsesteenweg 365,2018-12-31,13:00:00,80,46,34,FMN GV 05 Lier
60,Mechelsesteenweg 365,2018-12-31,14:00:00,104,58,46,FMN GV 05 Lier
60,Mechelsesteenweg 365,2018-12-31,15:00:00,72,24,48,FMN GV 05 Lier
60,Mechelsesteenweg 365,2018-12-31,16:00:00,44,18,26,FMN GV 05 Lier
60,Mechelsesteenweg 365,2018-12-31,17:00:00,8,8,0,FMN GV 05 Lier
60,Mechelsesteenweg 365,2018-12-31,18:00:00,22,6,16,FMN GV 05 Lier
60,Mechelsesteenweg 365,2018-12-31,19:00:00,6,4,2,FMN GV 05 Lier
60,Mechelsesteenweg 365,2018-12-31,20:00:00,2,0,2,FMN GV 05 Lier
60,Mechelsesteenweg 365,2018-12-31,21:00:00,0,0,0,FMN GV 05 Lier
60,Mechelsesteenweg 365,2018-12-31,22:00:00,0,0,0,FMN GV 05 Lier
60,Mechelsesteenweg 365,2018-12-31,23:00:00,0,0,0,FMN GV 05 Lier
60,Mechelsesteenweg 365,2019-01-01,00:00:00,10,4,6,FMN GV 05 Lier
60,Mechelsesteenweg 365,2019-01-01,01:00:00,0,0,0,FMN GV 05 Lier
60,Mechelsesteenweg 365,2019-01-01,02:00:00,0,0,0,FMN GV 05 Lier
60,Mechelsesteenweg 365,2019-01-01,03:00:00,0,0,0,FMN GV 05 Lier
60,Mechelsesteenweg 365,2019-01-01,04:00:00,10,4,6,FMN GV 05 Lier
60,Mechelsesteenweg 365,2019-01-01,05:00:00,0,0,0,FMN GV 05 Lier
60,Mechelsesteenweg 365,2019-01-01,06:00:00,4,4,0,FMN GV 05 Lier
60,Mechelsesteenweg 365,2019-01-01,07:00:00,2,2,0,FMN GV 05 Lier
60,Mechelsesteenweg 365,2019-01-01,08:00:00,2,2,0,FMN GV 05 Lier
60,Mechelsesteenweg 365,2019-01-01,09:00:00,36,20,16,FMN GV 05 Lier
60,Mechelsesteenweg 365,2019-01-01,10:00:00,42,30,12,FMN GV 05 Lier
60,Mechelsesteenweg 365,2019-01-01,11:00:00,30,14,16,FMN GV 05 Lier
60,Mechelsesteenweg 365,2019-01-01,12:00:00,36,8,28,FMN GV 05 Lier
60,Mechelsesteenweg 365,2019-01-01,13:00:00,40,24,16,FMN GV 05 Lier
60,Mechelsesteenweg 365,2019-01-01,14:00:00,16,6,10,FMN GV 05 Lier
60,Mechelsesteenweg 365,2019-01-01,15:00:00,28,12,16,FMN GV 05 Lier
60,Mechelsesteenweg 365,2019-01-01,16:00:00,14,6,8,FMN GV 05 Lier
60,Mechelsesteenweg 365,2019-01-01,17:00:00,8,6,2,FMN GV 05 Lier
60,Mechelsesteenweg 365,2019-01-01,18:00:00,2,2,0,FMN GV 05 Lier
60,Mechelsesteenweg 365,2019-01-01,19:00:00,0,0,0,FMN GV 05 Lier
60,Mechelsesteenweg 365,2019-01-01,20:00:00,0,0,0,FMN GV 05 Lier
60,Mechelsesteenweg 365,2019-01-01,21:00:00,0,0,0,FMN GV 05 Lier
60,Mechelsesteenweg 365,2019-01-01,22:00:00,0,0,0,FMN GV 05 Lier
60,Mechelsesteenweg 365,2019-01-01,23:00:00,2,0,2,FMN GV 05 Lier
60,Mechelsesteenweg 365,2019-01-02,00:00:00,0,0,0,FMN GV 05 Lier
60,Mechelsesteenweg 365,2019-01-02,01:00:00,0,0,0,FMN GV 05 Lier
60,Mechelsesteenweg 365,2019-01-02,02:00:00,0,0,0,FMN GV 05 Lier
60,Mechelsesteenweg 365,2019-01-02,03:00:00,0,0,0,FMN GV 05 Lier
60,Mechelsesteenweg 365,2019-01-02,04:00:00,0,0,0,FMN GV 05 Lier
60,Mechelsesteenweg 365,2019-01-02,05:00:00,6,0,6,FMN GV 05 Lier
60,Mechelsesteenweg 365,2019-01-02,06:00:00,4,0,4,FMN GV 05 Lier
60,Mechelsesteenweg 365,2019-01-02,07:00:00,32,14,18,FMN GV 05 Lier
60,Mechelsesteenweg 365,2019-01-02,08:00:00,14,10,4,FMN GV 05 Lier
60,Mechelsesteenweg 365,2019-01-02,09:00:00,28,10,18,FMN GV 05 Lier
60,Mechelsesteenweg 365,2019-01-02,10:00:00,28,12,16,FMN GV 05 Lier
60,Mechelsesteenweg 365,2019-01-02,11:00:00,60,22,38,FMN GV 05 Lier
60,Mechelsesteenweg 365,2019-01-02,12:00:00,34,12,22,FMN GV 05 Lier
60,Mechelsesteenweg 365,2019-01-02,13:00:00,78,40,38,FMN GV 05 Lier
60,Mechelsesteenweg 365,2019-01-02,14:00:00,64,24,40,FMN GV 05 Lier
60,Mechelsesteenweg 365,2019-01-02,15:00:00,74,38,36,FMN GV 05 Lier
60,Mechelsesteenweg 365,2019-01-02,16:00:00,60,32,28,FMN GV 05 Lier
60,Mechelsesteenweg 365,2019-01-02,17:00:00,42,26,16,FMN GV 05 Lier
60,Mechelsesteenweg 365,2019-01-02,18:00:00,6,6,0,FMN GV 05 Lier
60,Mechelsesteenweg 365,2019-01-02,19:00:00,4,2,2,FMN GV 05 Lier
60,Mechelsesteenweg 365,2019-01-02,20:00:00,8,6,2,FMN GV 05 Lier
60,Mechelsesteenweg 365,2019-01-02,21:00:00,10,0,10,FMN GV 05 Lier
60,Mechelsesteenweg 365,2019-01-02,22:00:00,2,0,2,FMN GV 05 Lier
60,Mechelsesteenweg 365,2019-01-02,23:00:00,0,0,0,FMN GV 05 Lier
60,Mechelsesteenweg 365,2019-01-03,00:00:00,0,0,0,FMN GV 05 Lier
60,Mechelsesteenweg 365,2019-01-03,01:00:00,2,2,0,FMN GV 05 Lier
60,Mechelsesteenweg 365,2019-01-03,02:00:00,0,0,0,FMN GV 05 Lier
60,Mechelsesteenweg 365,2019-01-03,03:00:00,0,0,0,FMN GV 05 Lier
60,Mechelsesteenweg 365,2019-01-03,04:00:00,0,0,0,FMN GV 05 Lier
60,Mechelsesteenweg 365,2019-01-03,05:00:00,8,0,8,FMN GV 05 Lier
60,Mechelsesteenweg 365,2019-01-03,06:00:00,8,2,6,FMN GV 05 Lier
60,Mechelsesteenweg 365,2019-01-03,07:00:00,26,4,22,FMN GV 05 Lier
60,Mechelsesteenweg 365,2019-01-03,08:00:00,22,12,10,FMN GV 05 Lier
60,Mechelsesteenweg 365,2019-01-03,09:00:00,42,24,18,FMN GV 05 Lier
60,Mechelsesteenweg 365,2019-01-03,10:00:00,56,30,26,FMN GV 05 Lier
60,Mechelsesteenweg 365,2019-01-03,11:00:00,48,18,30,FMN GV 05 Lier
60,Mechelsesteenweg 365,2019-01-03,12:00:00,52,30,22,FMN GV 05 Lier
60,Mechelsesteenweg 365,2019-01-03,13:00:00,56,30,26,FMN GV 05 Lier
60,Mechelsesteenweg 365,2019-01-03,14:00:00,110,54,56,FMN GV 05 Lier
60,Mechelsesteenweg 365,2019-01-03,15:00:00,64,26,38,FMN GV 05 Lier
60,Mechelsesteenweg 365,2019-01-03,16:00:00,34,12,22,FMN GV 05 Lier
60,Mechelsesteenweg 365,2019-01-03,17:00:00,34,26,8,FMN GV 05 Lier
60,Mechelsesteenweg 365,2019-01-03,18:00:00,16,8,8,FMN GV 05 Lier
60,Mechelsesteenweg 365,2019-01-03,19:00:00,16,8,8,FMN GV 05 Lier
60,Mechelsesteenweg 365,2019-01-03,20:00:00,4,2,2,FMN GV 05 Lier
60,Mechelsesteenweg 365,2019-01-03,21:00:00,6,4,2,FMN GV 05 Lier
60,Mechelsesteenweg 365,2019-01-03,22:00:00,2,0,2,FMN GV 05 Lier
60,Mechelsesteenweg 365,2019-01-03,23:00:00,0,0,0,FMN GV 05 Lier
60,Mechelsesteenweg 365,2019-01-04,00:00:00,0,0,0,FMN GV 05 Lier
60,Mechelsesteenweg 365,2019-01-04,01:00:00,0,0,0,FMN GV 05 Lier
60,Mechelsesteenweg 365,2019-01-04,02:00:00,0,0,0,FMN GV 05 Lier
60,Mechelsesteenweg 365,2019-01-04,03:00:00,0,0,0,FMN GV 05 Lier
60,Mechelsesteenweg 365,2019-01-04,04:00:00,0,0,0,FMN GV 05 Lier
60,Mechelsesteenweg 365,2019-01-04,05:00:00,6,0,6,FMN GV 05 Lier
60,Mechelsesteenweg 365,2019-01-04,06:00:00,4,2,2,FMN GV 05 Lier
60,Mechelsesteenweg 365,2019-01-04,07:00:00,34,16,18,FMN GV 05 Lier
60,Mechelsesteenweg 365,2019-01-04,08:00:00,24,14,10,FMN GV 05 Lier
60,Mechelsesteenweg 365,2019-01-04,09:00:00,30,18,12,FMN GV 05 Lier
60,Mechelsesteenweg 365,2019-01-04,10:00:00,22,18,4,FMN GV 05 Lier
60,Mechelsesteenweg 365,2019-01-04,11:00:00,56,22,34,FMN GV 05 Lier
60,Mechelsesteenweg 365,2019-01-04,12:00:00,48,22,26,FMN GV 05 Lier
60,Mechelsesteenweg 365,2019-01-04,13:00:00,76,32,44,FMN GV 05 Lier
60,Mechelsesteenweg 365,2019-01-04,14:00:00,54,28,26,FMN GV 05 Lier
60,Mechelsesteenweg 365,2019-01-04,15:00:00,56,18,38,FMN GV 05 Lier
60,Mechelsesteenweg 365,2019-01-04,16:00:00,30,18,12,FMN GV 05 Lier
60,Mechelsesteenweg 365,2019-01-04,17:00:00,32,22,10,FMN GV 05 Lier
60,Mechelsesteenweg 365,2019-01-04,18:00:00,16,8,8,FMN GV 05 Lier
60,Mechelsesteenweg 365,2019-01-04,19:00:00,2,2,0,FMN GV 05 Lier
60,Mechelsesteenweg 365,2019-01-04,20:00:00,2,0,2,FMN GV 05 Lier
60,Mechelsesteenweg 365,2019-01-04,21:00:00,4,0,4,FMN GV 05 Lier
60,Mechelsesteenweg 365,2019-01-04,22:00:00,2,0,2,FMN GV 05 Lier
60,Mechelsesteenweg 365,2019-01-04,23:00:00,0,0,0,FMN GV 05 Lier
60,Mechelsesteenweg 365,2019-01-05,00:00:00,0,0,0,FMN GV 05 Lier
60,Mechelsesteenweg 365,2019-01-05,01:00:00,0,0,0,FMN GV 05 Lier
60,Mechelsesteenweg 365,2019-01-05,02:00:00,0,0,0,FMN GV 05 Lier
60,Mechelsesteenweg 365,2019-01-05,03:00:00,0,0,0,FMN GV 05 Lier
60,Mechelsesteenweg 365,2019-01-05,04:00:00,2,0,2,FMN GV 05 Lier
60,Mechelsesteenweg 365,2019-01-05,05:00:00,0,0,0,FMN GV 05 Lier
60,Mechelsesteenweg 365,2019-01-05,06:00:00,2,2,0,FMN GV 05 Lier
60,Mechelsesteenweg 365,2019-01-05,07:00:00,4,2,2,FMN GV 05 Lier
60,Mechelsesteenweg 365,2019-01-05,08:00:00,8,4,4,FMN GV 05 Lier
60,Mechelsesteenweg 365,2019-01-05,09:00:00,50,16,34,FMN GV 05 Lier
60,Mechelsesteenweg 365,2019-01-05,10:00:00,50,28,22,FMN GV 05 Lier
60,Mechelsesteenweg 365,2019-01-05,11:00:00,74,22,52,FMN GV 05 Lier
60,Mechelsesteenweg 365,2019-01-05,12:00:00,72,30,42,FMN GV 05 Lier
60,Mechelsesteenweg 365,2019-01-05,13:00:00,34,24,10,FMN GV 05 Lier
60,Mechelsesteenweg 365,2019-01-05,14:00:00,88,62,26,FMN GV 05 Lier
60,Mechelsesteenweg 365,2019-01-05,15:00:00,60,14,46,FMN GV 05 Lier
60,Mechelsesteenweg 365,2019-01-05,16:00:00,26,14,12,FMN GV 05 Lier
60,Mechelsesteenweg 365,2019-01-05,17:00:00,16,8,8,FMN GV 05 Lier
60,Mechelsesteenweg 365,2019-01-05,18:00:00,2,0,2,FMN GV 05 Lier
60,Mechelsesteenweg 365,2019-01-05,19:00:00,4,4,0,FMN GV 05 Lier
60,Mechelsesteenweg 365,2019-01-05,20:00:00,0,0,0,FMN GV 05 Lier
60,Mechelsesteenweg 365,2019-01-05,21:00:00,0,0,0,FMN GV 05 Lier
60,Mechelsesteenweg 365,2019-01-05,22:00:00,4,2,2,FMN GV 05 Lier
60,Mechelsesteenweg 365,2019-01-05,23:00:00,2,0,2,FMN GV 05 Lier
60,Mechelsesteenweg 365,2019-01-06,00:00:00,0,0,0,FMN GV 05 Lier
60,Mechelsesteenweg 365,2019-01-06,01:00:00,0,0,0,FMN GV 05 Lier
60,Mechelsesteenweg 365,2019-01-06,02:00:00,0,0,0,FMN GV 05 Lier
60,Mechelsesteenweg 365,2019-01-06,03:00:00,0,0,0,FMN GV 05 Lier
60,Mechelsesteenweg 365,2019-01-06,04:00:00,0,0,0,FMN GV 05 Lier
60,Mechelsesteenweg 365,2019-01-06,05:00:00,0,0,0,FMN GV 05 Lier
60,Mechelsesteenweg 365,2019-01-06,06:00:00,0,0,0,FMN GV 05 Lier
60,Mechelsesteenweg 365,2019-01-06,07:00:00,0,0,0,FMN GV 05 Lier
60,Mechelsesteenweg 365,2019-01-06,08:00:00,14,14,0,FMN GV 05 Lier
60,Mechelsesteenweg 365,2019-01-06,09:00:00,100,42,58,FMN GV 05 Lier
60,Mechelsesteenweg 365,2019-01-06,10:00:00,182,102,80,FMN GV 05 Lier
60,Mechelsesteenweg 365,2019-01-06,11:00:00,132,54,78,FMN GV 05 Lier
60,Mechelsesteenweg 365,2019-01-06,12:00:00,94,48,46,FMN GV 05 Lier
60,Mechelsesteenweg 365,2019-01-06,13:00:00,68,32,36,FMN GV 05 Lier
60,Mechelsesteenweg 365,2019-01-06,14:00:00,62,34,28,FMN GV 05 Lier
60,Mechelsesteenweg 365,2019-01-06,15:00:00,50,24,26,FMN GV 05 Lier
60,Mechelsesteenweg 365,2019-01-06,16:00:00,24,10,14,FMN GV 05 Lier
60,Mechelsesteenweg 365,2019-01-06,17:00:00,16,10,6,FMN GV 05 Lier
60,Mechelsesteenweg 365,2019-01-06,18:00:00,4,2,2,FMN GV 05 Lier
60,Mechelsesteenweg 365,2019-01-06,19:00:00,0,0,0,FMN GV 05 Lier
60,Mechelsesteenweg 365,2019-01-06,20:00:00,2,0,2,FMN GV 05 Lier
60,Mechelsesteenweg 365,2019-01-06,21:00:00,0,0,0,FMN GV 05 Lier
60,Mechelsesteenweg 365,2019-01-06,22:00:00,2,0,2,FMN GV 05 Lier
60,Mechelsesteenweg 365,2019-01-06,23:00:00,2,0,2,FMN GV 05 Lier
60,Mechelsesteenweg 365,2019-01-07,00:00:00,0,0,0,FMN GV 05 Lier
60,Mechelsesteenweg 365,2019-01-07,01:00:00,0,0,0,FMN GV 05 Lier
60,Mechelsesteenweg 365,2019-01-07,02:00:00,0,0,0,FMN GV 05 Lier
60,Mechelsesteenweg 365,2019-01-07,03:00:00,2,0,2,FMN GV 05 Lier
60,Mechelsesteenweg 365,2019-01-07,04:00:00,2,0,2,FMN GV 05 Lier
60,Mechelsesteenweg 365,2019-01-07,05:00:00,4,0,4,FMN GV 05 Lier
60,Mechelsesteenweg 365,2019-01-07,06:00:00,6,2,4,FMN GV 05 Lier
60,Mechelsesteenweg 365,2019-01-07,07:00:00,118,74,44,FMN GV 05 Lier
60,Mechelsesteenweg 365,2019-01-07,08:00:00,100,64,36,FMN GV 05 Lier
60,Mechelsesteenweg 365,2019-01-07,09:00:00,42,26,16,FMN GV 05 Lier
60,Mechelsesteenweg 365,2019-01-07,10:00:00,44,24,20,FMN GV 05 Lier
60,Mechelsesteenweg 365,2019-01-07,11:00:00,66,26,40,FMN GV 05 Lier
60,Mechelsesteenweg 365,2019-01-07,12:00:00,36,20,16,FMN GV 05 Lier
60,Mechelsesteenweg 365,2019-01-07,13:00:00,44,22,22,FMN GV 05 Lier
60,Mechelsesteenweg 365,2019-01-07,14:00:00,66,44,22,FMN GV 05 Lier
60,Mechelsesteenweg 365,2019-01-07,15:00:00,66,46,20,FMN GV 05 Lier
60,Mechelsesteenweg 365,2019-01-07,16:00:00,146,30,116,FMN GV 05 Lier
60,Mechelsesteenweg 365,2019-01-07,17:00:00,66,38,28,FMN GV 05 Lier
60,Mechelsesteenweg 365,2019-01-07,18:00:00,26,16,10,FMN GV 05 Lier
60,Mechelsesteenweg 365,2019-01-07,19:00:00,12,10,2,FMN GV 05 Lier
60,Mechelsesteenweg 365,2019-01-07,20:00:00,2,0,2,FMN GV 05 Lier
60,Mechelsesteenweg 365,2019-01-07,21:00:00,6,0,6,FMN GV 05 Lier
60,Mechelsesteenweg 365,2019-01-07,22:00:00,2,0,2,FMN GV 05 Lier
60,Mechelsesteenweg 365,2019-01-07,23:00:00,2,2,0,FMN GV 05 Lier
60,Mechelsesteenweg 365,2019-01-08,00:00:00,0,0,0,FMN GV 05 Lier
60,Mechelsesteenweg 365,2019-01-08,01:00:00,0,0,0,FMN GV 05 Lier
60,Mechelsesteenweg 365,2019-01-08,02:00:00,0,0,0,FMN GV 05 Lier
60,Mechelsesteenweg 365,2019-01-08,03:00:00,0,0,0,FMN GV 05 Lier
60,Mechelsesteenweg 365,2019-01-08,04:00:00,4,0,4,FMN GV 05 Lier
60,Mechelsesteenweg 365,2019-01-08,05:00:00,2,2,0,FMN GV 05 Lier
60,Mechelsesteenweg 365,2019-01-08,06:00:00,16,6,10,FMN GV 05 Lier
60,Mechelsesteenweg 365,2019-01-08,07:00:00,124,76,48,FMN GV 05 Lier
60,Mechelsesteenweg 365,2019-01-08,08:00:00,100,66,34,FMN GV 05 Lier
60,Mechelsesteenweg 365,2019-01-08,09:00:00,26,16,10,FMN GV 05 Lier
60,Mechelsesteenweg 365,2019-01-08,10:00:00,28,10,18,FMN GV 05 Lier
60,Mechelsesteenweg 365,2019-01-08,11:00:00,22,6,16,FMN GV 05 Lier
60,Mechelsesteenweg 365,2019-01-08,12:00:00,16,10,6,FMN GV 05 Lier
60,Mechelsesteenweg 365,2019-01-08,13:00:00,38,26,12,FMN GV 05 Lier
60,Mechelsesteenweg 365,2019-01-08,14:00:00,22,10,12,FMN GV 05 Lier
60,Mechelsesteenweg 365,2019-01-08,15:00:00,24,4,20,FMN GV 05 Lier
60,Mechelsesteenweg 365,2019-01-08,16:00:00,126,42,84,FMN GV 05 Lier
60,Mechelsesteenweg 365,2019-01-08,17:00:00,52,24,28,FMN GV 05 Lier
60,Mechelsesteenweg 365,2019-01-08,18:00:00,22,14,8,FMN GV 05 Lier
60,Mechelsesteenweg 365,2019-01-08,19:00:00,6,2,4,FMN GV 05 Lier
60,Mechelsesteenweg 365,2019-01-08,20:00:00,2,2,0,FMN GV 05 Lier
60,Mechelsesteenweg 365,2019-01-08,21:00:00,4,2,2,FMN GV 05 Lier
60,Mechelsesteenweg 365,2019-01-08,22:00:00,4,4,0,FMN GV 05 Lier
60,Mechelsesteenweg 365,2019-01-08,23:00:00,8,4,4,FMN GV 05 Lier
60,Mechelsesteenweg 365,2019-01-09,00:00:00,0,0,0,FMN GV 05 Lier
60,Mechelsesteenweg 365,2019-01-09,01:00:00,0,0,0,FMN GV 05 Lier
60,Mechelsesteenweg 365,2019-01-09,02:00:00,0,0,0,FMN GV 05 Lier
60,Mechelsesteenweg 365,2019-01-09,03:00:00,0,0,0,FMN GV 05 Lier
60,Mechelsesteenweg 365,2019-01-09,04:00:00,6,4,2,FMN GV 05 Lier
60,Mechelsesteenweg 365,2019-01-09,05:00:00,4,2,2,FMN GV 05 Lier
60,Mechelsesteenweg 365,2019-01-09,06:00:00,8,4,4,FMN GV 05 Lier
60,Mechelsesteenweg 365,2019-01-09,07:00:00,104,58,46,FMN GV 05 Lier
60,Mechelsesteenweg 365,2019-01-09,08:00:00,108,84,24,FMN GV 05 Lier
60,Mechelsesteenweg 365,2019-01-09,09:00:00,18,6,12,FMN GV 05 Lier
60,Mechelsesteenweg 365,2019-01-09,10:00:00,20,6,14,FMN GV 05 Lier
60,Mechelsesteenweg 365,2019-01-09,11:00:00,34,12,22,FMN GV 05 Lier
60,Mechelsesteenweg 365,2019-01-09,12:00:00,134,26,108,FMN GV 05 Lier
60,Mechelsesteenweg 365,2019-01-09,13:00:00,76,34,42,FMN GV 05 Lier
60,Mechelsesteenweg 365,2019-01-09,14:00:00,108,70,38,FMN GV 05 Lier
60,Mechelsesteenweg 365,2019-01-09,15:00:00,86,32,54,FMN GV 05 Lier
60,Mechelsesteenweg 365,2019-01-09,16:00:00,62,36,26,FMN GV 05 Lier
60,Mechelsesteenweg 365,2019-01-09,17:00:00,60,46,14,FMN GV 05 Lier
60,Mechelsesteenweg 365,2019-01-09,18:00:00,20,10,10,FMN GV 05 Lier
60,Mechelsesteenweg 365,2019-01-09,19:00:00,2,2,0,FMN GV 05 Lier
60,Mechelsesteenweg 365,2019-01-09,20:00:00,2,2,0,FMN GV 05 Lier
60,Mechelsesteenweg 365,2019-01-09,21:00:00,12,10,2,FMN GV 05 Lier
60,Mechelsesteenweg 365,2019-01-09,22:00:00,6,6,0,FMN GV 05 Lier
60,Mechelsesteenweg 365,2019-01-09,23:00:00,2,2,0,FMN GV 05 Lier
60,Mechelsesteenweg 365,2019-01-10,00:00:00,0,0,0,FMN GV 05 Lier
60,Mechelsesteenweg 365,2019-01-10,01:00:00,0,0,0,FMN GV 05 Lier
60,Mechelsesteenweg 365,2019-01-10,02:00:00,0,0,0,FMN GV 05 Lier
60,Mechelsesteenweg 365,2019-01-10,03:00:00,0,0,0,FMN GV 05 Lier
60,Mechelsesteenweg 365,2019-01-10,04:00:00,2,0,2,FMN GV 05 Lier
60,Mechelsesteenweg 365,2019-01-10,05:00:00,2,0,2,FMN GV 05 Lier
60,Mechelsesteenweg 365,2019-01-10,06:00:00,8,0,8,FMN GV 05 Lier
60,Mechelsesteenweg 365,2019-01-10,07:00:00,86,48,38,FMN GV 05 Lier
60,Mechelsesteenweg 365,2019-01-10,08:00:00,132,82,50,FMN GV 05 Lier
60,Mechelsesteenweg 365,2019-01-10,09:00:00,32,18,14,FMN GV 05 Lier
60,Mechelsesteenweg 365,2019-01-10,10:00:00,60,40,20,FMN GV 05 Lier
60,Mechelsesteenweg 365,2019-01-10,11:00:00,60,30,30,FMN GV 05 Lier
60,Mechelsesteenweg 365,2019-01-10,12:00:00,40,22,18,FMN GV 05 Lier
60,Mechelsesteenweg 365,2019-01-10,13:00:00,48,22,26,FMN GV 05 Lier
60,Mechelsesteenweg 365,2019-01-10,14:00:00,58,40,18,FMN GV 05 Lier
60,Mechelsesteenweg 365,2019-01-10,15:00:00,68,26,42,FMN GV 05 Lier
60,Mechelsesteenweg 365,2019-01-10,16:00:00,144,44,100,FMN GV 05 Lier
60,Mechelsesteenweg 365,2019-01-10,17:00:00,70,38,32,FMN GV 05 Lier
60,Mechelsesteenweg 365,2019-01-10,18:00:00,10,8,2,FMN GV 05 Lier
60,Mechelsesteenweg 365,2019-01-10,19:00:00,24,14,10,FMN GV 05 Lier
60,Mechelsesteenweg 365,2019-01-10,20:00:00,14,8,6,FMN GV 05 Lier
60,Mechelsesteenweg 365,2019-01-10,21:00:00,4,0,4,FMN GV 05 Lier
60,Mechelsesteenweg 365,2019-01-10,22:00:00,4,2,2,FMN GV 05 Lier
60,Mechelsesteenweg 365,2019-01-10,23:00:00,0,0,0,FMN GV 05 Lier
60,Mechelsesteenweg 365,2019-01-11,00:00:00,0,0,0,FMN GV 05 Lier
60,Mechelsesteenweg 365,2019-01-11,01:00:00,0,0,0,FMN GV 05 Lier
60,Mechelsesteenweg 365,2019-01-11,02:00:00,0,0,0,FMN GV 05 Lier
60,Mechelsesteenweg 365,2019-01-11,03:00:00,0,0,0,FMN GV 05 Lier
60,Mechelsesteenweg 365,2019-01-11,04:00:00,2,0,2,FMN GV 05 Lier
60,Mechelsesteenweg 365,2019-01-11,05:00:00,2,0,2,FMN GV 05 Lier
60,Mechelsesteenweg 365,2019-01-11,06:00:00,16,4,12,FMN GV 05 Lier
60,Mechelsesteenweg 365,2019-01-11,07:00:00,76,50,26,FMN GV 05 Lier
60,Mechelsesteenweg 365,2019-01-11,08:00:00,110,64,46,FMN GV 05 Lier
60,Mechelsesteenweg 365,2019-01-11,09:00:00,50,42,8,FMN GV 05 Lier
60,Mechelsesteenweg 365,2019-01-11,10:00:00,38,20,18,FMN GV 05 Lier
60,Mechelsesteenweg 365,2019-01-11,11:00:00,34,18,16,FMN GV 05 Lier
60,Mechelsesteenweg 365,2019-01-11,12:00:00,24,10,14,FMN GV 05 Lier
60,Mechelsesteenweg 365,2019-01-11,13:00:00,32,14,18,FMN GV 05 Lier
60,Mechelsesteenweg 365,2019-01-11,14:00:00,30,20,10,FMN GV 05 Lier
60,Mechelsesteenweg 365,2019-01-11,15:00:00,72,30,42,FMN GV 05 Lier
60,Mechelsesteenweg 365,2019-01-11,16:00:00,108,38,70,FMN GV 05 Lier
60,Mechelsesteenweg 365,2019-01-11,17:00:00,48,28,20,FMN GV 05 Lier
60,Mechelsesteenweg 365,2019-01-11,18:00:00,20,12,8,FMN GV 05 Lier
60,Mechelsesteenweg 365,2019-01-11,19:00:00,4,4,0,FMN GV 05 Lier
60,Mechelsesteenweg 365,2019-01-11,20:00:00,4,4,0,FMN GV 05 Lier
60,Mechelsesteenweg 365,2019-01-11,21:00:00,8,2,6,FMN GV 05 Lier
60,Mechelsesteenweg 365,2019-01-11,22:00:00,6,2,4,FMN GV 05 Lier
60,Mechelsesteenweg 365,2019-01-11,23:00:00,4,0,4,FMN GV 05 Lier
60,Mechelsesteenweg 365,2019-01-12,00:00:00,0,0,0,FMN GV 05 Lier
60,Mechelsesteenweg 365,2019-01-12,01:00:00,0,0,0,FMN GV 05 Lier
60,Mechelsesteenweg 365,2019-01-12,02:00:00,2,0,2,FMN GV 05 Lier
60,Mechelsesteenweg 365,2019-01-12,03:00:00,0,0,0,FMN GV 05 Lier
60,Mechelsesteenweg 365,2019-01-12,04:00:00,0,0,0,FMN GV 05 Lier
60,Mechelsesteenweg 365,2019-01-12,05:00:00,0,0,0,FMN GV 05 Lier
60,Mechelsesteenweg 365,2019-01-12,06:00:00,0,0,0,FMN GV 05 Lier
60,Mechelsesteenweg 365,2019-01-12,07:00:00,4,2,2,FMN GV 05 Lier
60,Mechelsesteenweg 365,2019-01-12,08:00:00,14,8,6,FMN GV 05 Lier
60,Mechelsesteenweg 365,2019-01-12,09:00:00,72,36,36,FMN GV 05 Lier
60,Mechelsesteenweg 365,2019-01-12,10:00:00,96,44,52,FMN GV 05 Lier
60,Mechelsesteenweg 365,2019-01-12,11:00:00,104,56,48,FMN GV 05 Lier
60,Mechelsesteenweg 365,2019-01-12,12:00:00,54,30,24,FMN GV 05 Lier
60,Mechelsesteenweg 365,2019-01-12,13:00:00,22,8,14,FMN GV 05 Lier
60,Mechelsesteenweg 365,2019-01-12,14:00:00,20,12,8,FMN GV 05 Lier
60,Mechelsesteenweg 365,2019-01-12,15:00:00,20,12,8,FMN GV 05 Lier
60,Mechelsesteenweg 365,2019-01-12,16:00:00,22,4,18,FMN GV 05 Lier
60,Mechelsesteenweg 365,2019-01-12,17:00:00,6,2,4,FMN GV 05 Lier
60,Mechelsesteenweg 365,2019-01-12,18:00:00,2,2,0,FMN GV 05 Lier
60,Mechelsesteenweg 365,2019-01-12,19:00:00,2,2,0,FMN GV 05 Lier
60,Mechelsesteenweg 365,2019-01-12,20:00:00,4,0,4,FMN GV 05 Lier
60,Mechelsesteenweg 365,2019-01-12,21:00:00,0,0,0,FMN GV 05 Lier
60,Mechelsesteenweg 365,2019-01-12,22:00:00,4,4,0,FMN GV 05 Lier
60,Mechelsesteenweg 365,2019-01-12,23:00:00,2,2,0,FMN GV 05 Lier
60,Mechelsesteenweg 365,2019-01-13,00:00:00,2,2,0,FMN GV 05 Lier
60,Mechelsesteenweg 365,2019-01-13,01:00:00,0,0,0,FMN GV 05 Lier
60,Mechelsesteenweg 365,2019-01-13,02:00:00,0,0,0,FMN GV 05 Lier
60,Mechelsesteenweg 365,2019-01-13,03:00:00,0,0,0,FMN GV 05 Lier
60,Mechelsesteenweg 365,2019-01-13,04:00:00,0,0,0,FMN GV 05 Lier
60,Mechelsesteenweg 365,2019-01-13,05:00:00,0,0,0,FMN GV 05 Lier
60,Mechelsesteenweg 365,2019-01-13,06:00:00,0,0,0,FMN GV 05 Lier
60,Mechelsesteenweg 365,2019-01-13,07:00:00,0,0,0,FMN GV 05 Lier
60,Mechelsesteenweg 365,2019-01-13,08:00:00,14,14,0,FMN GV 05 Lier
60,Mechelsesteenweg 365,2019-01-13,09:00:00,52,28,24,FMN GV 05 Lier
60,Mechelsesteenweg 365,2019-01-13,10:00:00,90,46,44,FMN GV 05 Lier
60,Mechelsesteenweg 365,2019-01-13,11:00:00,92,52,40,FMN GV 05 Lier
60,Mechelsesteenweg 365,2019-01-13,12:00:00,34,16,18,FMN GV 05 Lier
60,Mechelsesteenweg 365,2019-01-13,13:00:00,18,6,12,FMN GV 05 Lier
60,Mechelsesteenweg 365,2019-01-13,14:00:00,60,58,2,FMN GV 05 Lier
60,Mechelsesteenweg 365,2019-01-13,15:00:00,8,2,6,FMN GV 05 Lier
60,Mechelsesteenweg 365,2019-01-13,16:00:00,8,4,4,FMN GV 05 Lier
60,Mechelsesteenweg 365,2019-01-13,17:00:00,6,4,2,FMN GV 05 Lier
60,Mechelsesteenweg 365,2019-01-13,18:00:00,2,2,0,FMN GV 05 Lier
60,Mechelsesteenweg 365,2019-01-13,19:00:00,2,2,0,FMN GV 05 Lier
60,Mechelsesteenweg 365,2019-01-13,20:00:00,2,0,2,FMN GV 05 Lier
60,Mechelsesteenweg 365,2019-01-13,21:00:00,2,2,0,FMN GV 05 Lier
60,Mechelsesteenweg 365,2019-01-13,22:00:00,0,0,0,FMN GV 05 Lier
60,Mechelsesteenweg 365,2019-01-13,23:00:00,2,0,2,FMN GV 05 Lier
60,Mechelsesteenweg 365,2019-01-14,00:00:00,0,0,0,FMN GV 05 Lier
60,Mechelsesteenweg 365,2019-01-14,01:00:00,0,0,0,FMN GV 05 Lier
60,Mechelsesteenweg 365,2019-01-14,02:00:00,0,0,0,FMN GV 05 Lier
60,Mechelsesteenweg 365,2019-01-14,03:00:00,0,0,0,FMN GV 05 Lier
60,Mechelsesteenweg 365,2019-01-14,04:00:00,2,0,2,FMN GV 05 Lier
60,Mechelsesteenweg 365,2019-01-14,05:00:00,6,2,4,FMN GV 05 Lier
60,Mechelsesteenweg 365,2019-01-14,06:00:00,8,0,8,FMN GV 05 Lier
60,Mechelsesteenweg 365,2019-01-14,07:00:00,84,48,36,FMN GV 05 Lier
60,Mechelsesteenweg 365,2019-01-14,08:00:00,78,52,26,FMN GV 05 Lier
60,Mechelsesteenweg 365,2019-01-14,09:00:00,28,18,10,FMN GV 05 Lier
60,Mechelsesteenweg 365,2019-01-14,10:00:00,18,8,10,FMN GV 05 Lier
60,Mechelsesteenweg 365,2019-01-14,11:00:00,40,12,28,FMN GV 05 Lier
60,Mechelsesteenweg 365,2019-01-14,12:00:00,30,16,14,FMN GV 05 Lier
60,Mechelsesteenweg 365,2019-01-14,13:00:00,64,32,32,FMN GV 05 Lier
60,Mechelsesteenweg 365,2019-01-14,14:00:00,34,22,12,FMN GV 05 Lier
60,Mechelsesteenweg 365,2019-01-14,15:00:00,70,40,30,FMN GV 05 Lier
60,Mechelsesteenweg 365,2019-01-14,16:00:00,132,34,98,FMN GV 05 Lier
60,Mechelsesteenweg 365,2019-01-14,17:00:00,70,38,32,FMN GV 05 Lier
60,Mechelsesteenweg 365,2019-01-14,18:00:00,20,12,8,FMN GV 05 Lier
60,Mechelsesteenweg 365,2019-01-14,19:00:00,8,2,6,FMN GV 05 Lier
60,Mechelsesteenweg 365,2019-01-14,20:00:00,8,4,4,FMN GV 05 Lier
60,Mechelsesteenweg 365,2019-01-14,21:00:00,0,0,0,FMN GV 05 Lier
60,Mechelsesteenweg 365,2019-01-14,22:00:00,4,2,2,FMN GV 05 Lier
60,Mechelsesteenweg 365,2019-01-14,23:00:00,0,0,0,FMN GV 05 Lier
60,Mechelsesteenweg 365,2019-01-15,00:00:00,0,0,0,FMN GV 05 Lier
60,Mechelsesteenweg 365,2019-01-15,01:00:00,0,0,0,FMN GV 05 Lier
60,Mechelsesteenweg 365,2019-01-15,02:00:00,0,0,0,FMN GV 05 Lier
60,Mechelsesteenweg 365,2019-01-15,03:00:00,0,0,0,FMN GV 05 Lier
60,Mechelsesteenweg 365,2019-01-15,04:00:00,4,0,4,FMN GV 05 Lier
60,Mechelsesteenweg 365,2019-01-15,05:00:00,8,2,6,FMN GV 05 Lier
60,Mechelsesteenweg 365,2019-01-15,06:00:00,8,2,6,FMN GV 05 Lier
60,Mechelsesteenweg 365,2019-01-15,07:00:00,114,72,42,FMN GV 05 Lier
60,Mechelsesteenweg 365,2019-01-15,08:00:00,114,62,52,FMN GV 05 Lier
60,Mechelsesteenweg 365,2019-01-15,09:00:00,36,28,8,FMN GV 05 Lier
60,Mechelsesteenweg 365,2019-01-15,10:00:00,60,24,36,FMN GV 05 Lier
60,Mechelsesteenweg 365,2019-01-15,11:00:00,68,28,40,FMN GV 05 Lier
60,Mechelsesteenweg 365,2019-01-15,12:00:00,68,38,30,FMN GV 05 Lier
60,Mechelsesteenweg 365,2019-01-15,13:00:00,112,52,60,FMN GV 05 Lier
60,Mechelsesteenweg 365,2019-01-15,14:00:00,74,40,34,FMN GV 05 Lier
60,Mechelsesteenweg 365,2019-01-15,15:00:00,76,38,38,FMN GV 05 Lier
60,Mechelsesteenweg 365,2019-01-15,16:00:00,170,58,112,FMN GV 05 Lier
60,Mechelsesteenweg 365,2019-01-15,17:00:00,82,48,34,FMN GV 05 Lier
60,Mechelsesteenweg 365,2019-01-15,18:00:00,30,22,8,FMN GV 05 Lier
60,Mechelsesteenweg 365,2019-01-15,19:00:00,6,2,4,FMN GV 05 Lier
60,Mechelsesteenweg 365,2019-01-15,20:00:00,8,4,4,FMN GV 05 Lier
60,Mechelsesteenweg 365,2019-01-15,21:00:00,10,0,10,FMN GV 05 Lier
60,Mechelsesteenweg 365,2019-01-15,22:00:00,4,2,2,FMN GV 05 Lier
60,Mechelsesteenweg 365,2019-01-15,23:00:00,2,2,0,FMN GV 05 Lier
60,Mechelsesteenweg 365,2019-01-16,00:00:00,0,0,0,FMN GV 05 Lier
60,Mechelsesteenweg 365,2019-01-16,01:00:00,0,0,0,FMN GV 05 Lier
60,Mechelsesteenweg 365,2019-01-16,02:00:00,0,0,0,FMN GV 05 Lier
60,Mechelsesteenweg 365,2019-01-16,03:00:00,0,0,0,FMN GV 05 Lier
60,Mechelsesteenweg 365,2019-01-16,04:00:00,6,0,6,FMN GV 05 Lier
60,Mechelsesteenweg 365,2019-01-16,05:00:00,8,0,8,FMN GV 05 Lier
60,Mechelsesteenweg 365,2019-01-16,06:00:00,10,2,8,FMN GV 05 Lier
60,Mechelsesteenweg 365,2019-01-16,07:00:00,96,62,34,FMN GV 05 Lier
60,Mechelsesteenweg 365,2019-01-16,08:00:00,114,76,38,FMN GV 05 Lier
60,Mechelsesteenweg 365,2019-01-16,09:00:00,16,6,10,FMN GV 05 Lier
60,Mechelsesteenweg 365,2019-01-16,10:00:00,50,24,26,FMN GV 05 Lier
60,Mechelsesteenweg 365,2019-01-16,11:00:00,36,20,16,FMN GV 05 Lier
60,Mechelsesteenweg 365,2019-01-16,12:00:00,126,36,90,FMN GV 05 Lier
60,Mechelsesteenweg 365,2019-01-16,13:00:00,70,34,36,FMN GV 05 Lier
60,Mechelsesteenweg 365,2019-01-16,14:00:00,80,54,26,FMN GV 05 Lier
60,Mechelsesteenweg 365,2019-01-16,15:00:00,78,32,46,FMN GV 05 Lier
60,Mechelsesteenweg 365,2019-01-16,16:00:00,38,22,16,FMN GV 05 Lier
60,Mechelsesteenweg 365,2019-01-16,17:00:00,66,46,20,FMN GV 05 Lier
60,Mechelsesteenweg 365,2019-01-16,18:00:00,26,20,6,FMN GV 05 Lier
60,Mechelsesteenweg 365,2019-01-16,19:00:00,14,10,4,FMN GV 05 Lier
60,Mechelsesteenweg 365,2019-01-16,20:00:00,6,4,2,FMN GV 05 Lier
60,Mechelsesteenweg 365,2019-01-16,21:00:00,8,4,4,FMN GV 05 Lier
60,Mechelsesteenweg 365,2019-01-16,22:00:00,4,4,0,FMN GV 05 Lier
60,Mechelsesteenweg 365,2019-01-16,23:00:00,0,0,0,FMN GV 05 Lier
60,Mechelsesteenweg 365,2019-01-17,00:00:00,2,0,2,FMN GV 05 Lier
60,Mechelsesteenweg 365,2019-01-17,01:00:00,0,0,0,FMN GV 05 Lier
60,Mechelsesteenweg 365,2019-01-17,02:00:00,0,0,0,FMN GV 05 Lier
60,Mechelsesteenweg 365,2019-01-17,03:00:00,0,0,0,FMN GV 05 Lier
60,Mechelsesteenweg 365,2019-01-17,04:00:00,4,0,4,FMN GV 05 Lier
60,Mechelsesteenweg 365,2019-01-17,05:00:00,4,0,4,FMN GV 05 Lier
60,Mechelsesteenweg 365,2019-01-17,06:00:00,12,4,8,FMN GV 05 Lier
60,Mechelsesteenweg 365,2019-01-17,07:00:00,76,50,26,FMN GV 05 Lier
60,Mechelsesteenweg 365,2019-01-17,08:00:00,76,48,28,FMN GV 05 Lier
60,Mechelsesteenweg 365,2019-01-17,09:00:00,8,8,0,FMN GV 05 Lier
60,Mechelsesteenweg 365,2019-01-17,10:00:00,10,0,10,FMN GV 05 Lier
60,Mechelsesteenweg 365,2019-01-17,11:00:00,2,0,2,FMN GV 05 Lier
60,Mechelsesteenweg 365,2019-01-17,12:00:00,12,6,6,FMN GV 05 Lier
60,Mechelsesteenweg 365,2019-01-17,13:00:00,14,4,10,FMN GV 05 Lier
60,Mechelsesteenweg 365,2019-01-17,14:00:00,18,16,2,FMN GV 05 Lier
60,Mechelsesteenweg 365,2019-01-17,15:00:00,24,4,20,FMN GV 05 Lier
60,Mechelsesteenweg 365,2019-01-17,16:00:00,122,34,88,FMN GV 05 Lier
60,Mechelsesteenweg 365,2019-01-17,17:00:00,50,30,20,FMN GV 05 Lier
60,Mechelsesteenweg 365,2019-01-17,18:00:00,6,6,0,FMN GV 05 Lier
60,Mechelsesteenweg 365,2019-01-17,19:00:00,12,8,4,FMN GV 05 Lier
60,Mechelsesteenweg 365,2019-01-17,20:00:00,2,2,0,FMN GV 05 Lier
60,Mechelsesteenweg 365,2019-01-17,21:00:00,0,0,0,FMN GV 05 Lier
60,Mechelsesteenweg 365,2019-01-17,22:00:00,2,2,0,FMN GV 05 Lier
60,Mechelsesteenweg 365,2019-01-17,23:00:00,4,0,4,FMN GV 05 Lier
60,Mechelsesteenweg 365,2019-01-18,00:00:00,0,0,0,FMN GV 05 Lier
60,Mechelsesteenweg 365,2019-01-18,01:00:00,2,0,2,FMN GV 05 Lier
60,Mechelsesteenweg 365,2019-01-18,02:00:00,0,0,0,FMN GV 05 Lier
60,Mechelsesteenweg 365,2019-01-18,03:00:00,0,0,0,FMN GV 05 Lier
60,Mechelsesteenweg 365,2019-01-18,04:00:00,0,0,0,FMN GV 05 Lier
60,Mechelsesteenweg 365,2019-01-18,05:00:00,4,0,4,FMN GV 05 Lier
60,Mechelsesteenweg 365,2019-01-18,06:00:00,10,4,6,FMN GV 05 Lier
60,Mechelsesteenweg 365,2019-01-18,07:00:00,60,38,22,FMN GV 05 Lier
60,Mechelsesteenweg 365,2019-01-18,08:00:00,112,64,48,FMN GV 05 Lier
60,Mechelsesteenweg 365,2019-01-18,09:00:00,42,32,10,FMN GV 05 Lier
60,Mechelsesteenweg 365,2019-01-18,10:00:00,18,10,8,FMN GV 05 Lier
60,Mechelsesteenweg 365,2019-01-18,11:00:00,24,14,10,FMN GV 05 Lier
60,Mechelsesteenweg 365,2019-01-18,12:00:00,44,16,28,FMN GV 05 Lier
60,Mechelsesteenweg 365,2019-01-18,13:00:00,38,16,22,FMN GV 05 Lier
60,Mechelsesteenweg 365,2019-01-18,14:00:00,66,42,24,FMN GV 05 Lier
60,Mechelsesteenweg 365,2019-01-18,15:00:00,70,32,38,FMN GV 05 Lier
60,Mechelsesteenweg 365,2019-01-18,16:00:00,142,42,100,FMN GV 05 Lier
60,Mechelsesteenweg 365,2019-01-18,17:00:00,32,18,14,FMN GV 05 Lier
60,Mechelsesteenweg 365,2019-01-18,18:00:00,12,8,4,FMN GV 05 Lier
60,Mechelsesteenweg 365,2019-01-18,19:00:00,6,0,6,FMN GV 05 Lier
60,Mechelsesteenweg 365,2019-01-18,20:00:00,0,0,0,FMN GV 05 Lier
60,Mechelsesteenweg 365,2019-01-18,21:00:00,6,2,4,FMN GV 05 Lier
60,Mechelsesteenweg 365,2019-01-18,22:00:00,6,2,4,FMN GV 05 Lier
60,Mechelsesteenweg 365,2019-01-18,23:00:00,2,2,0,FMN GV 05 Lier
60,Mechelsesteenweg 365,2019-01-19,00:00:00,0,0,0,FMN GV 05 Lier
60,Mechelsesteenweg 365,2019-01-19,01:00:00,0,0,0,FMN GV 05 Lier
60,Mechelsesteenweg 365,2019-01-19,02:00:00,0,0,0,FMN GV 05 Lier
60,Mechelsesteenweg 365,2019-01-19,03:00:00,0,0,0,FMN GV 05 Lier
60,Mechelsesteenweg 365,2019-01-19,04:00:00,0,0,0,FMN GV 05 Lier
60,Mechelsesteenweg 365,2019-01-19,05:00:00,4,4,0,FMN GV 05 Lier
60,Mechelsesteenweg 365,2019-01-19,06:00:00,2,0,2,FMN GV 05 Lier
60,Mechelsesteenweg 365,2019-01-19,07:00:00,8,6,2,FMN GV 05 Lier
60,Mechelsesteenweg 365,2019-01-19,08:00:00,10,10,0,FMN GV 05 Lier
60,Mechelsesteenweg 365,2019-01-19,09:00:00,20,8,12,FMN GV 05 Lier
60,Mechelsesteenweg 365,2019-01-19,10:00:00,34,22,12,FMN GV 05 Lier
60,Mechelsesteenweg 365,2019-01-19,11:00:00,46,20,26,FMN GV 05 Lier
60,Mechelsesteenweg 365,2019-01-19,12:00:00,38,12,26,FMN GV 05 Lier
60,Mechelsesteenweg 365,2019-01-19,13:00:00,114,66,48,FMN GV 05 Lier
60,Mechelsesteenweg 365,2019-01-19,14:00:00,144,70,74,FMN GV 05 Lier
60,Mechelsesteenweg 365,2019-01-19,15:00:00,110,50,60,FMN GV 05 Lier
60,Mechelsesteenweg 365,2019-01-19,16:00:00,78,24,54,FMN GV 05 Lier
60,Mechelsesteenweg 365,2019-01-19,17:00:00,20,10,10,FMN GV 05 Lier
60,Mechelsesteenweg 365,2019-01-19,18:00:00,4,2,2,FMN GV 05 Lier
60,Mechelsesteenweg 365,2019-01-19,19:00:00,0,0,0,FMN GV 05 Lier
60,Mechelsesteenweg 365,2019-01-19,20:00:00,0,0,0,FMN GV 05 Lier
60,Mechelsesteenweg 365,2019-01-19,21:00:00,0,0,0,FMN GV 05 Lier
60,Mechelsesteenweg 365,2019-01-19,22:00:00,4,2,2,FMN GV 05 Lier
60,Mechelsesteenweg 365,2019-01-19,23:00:00,4,0,4,FMN GV 05 Lier
60,Mechelsesteenweg 365,2019-01-20,00:00:00,2,0,2,FMN GV 05 Lier
60,Mechelsesteenweg 365,2019-01-20,01:00:00,0,0,0,FMN GV 05 Lier
60,Mechelsesteenweg 365,2019-01-20,02:00:00,0,0,0,FMN GV 05 Lier
60,Mechelsesteenweg 365,2019-01-20,03:00:00,0,0,0,FMN GV 05 Lier
60,Mechelsesteenweg 365,2019-01-20,04:00:00,0,0,0,FMN GV 05 Lier
60,Mechelsesteenweg 365,2019-01-20,05:00:00,2,2,0,FMN GV 05 Lier
60,Mechelsesteenweg 365,2019-01-20,06:00:00,2,0,2,FMN GV 05 Lier
60,Mechelsesteenweg 365,2019-01-20,07:00:00,0,0,0,FMN GV 05 Lier
60,Mechelsesteenweg 365,2019-01-20,08:00:00,8,6,2,FMN GV 05 Lier
60,Mechelsesteenweg 365,2019-01-20,09:00:00,42,18,24,FMN GV 05 Lier
60,Mechelsesteenweg 365,2019-01-20,10:00:00,108,70,38,FMN GV 05 Lier
60,Mechelsesteenweg 365,2019-01-20,11:00:00,96,46,50,FMN GV 05 Lier
60,Mechelsesteenweg 365,2019-01-20,12:00:00,86,36,50,FMN GV 05 Lier
60,Mechelsesteenweg 365,2019-01-20,13:00:00,124,72,52,FMN GV 05 Lier
60,Mechelsesteenweg 365,2019-01-20,14:00:00,108,48,60,FMN GV 05 Lier
60,Mechelsesteenweg 365,2019-01-20,15:00:00,92,38,54,FMN GV 05 Lier
60,Mechelsesteenweg 365,2019-01-20,16:00:00,74,18,56,FMN GV 05 Lier
60,Mechelsesteenweg 365,2019-01-20,17:00:00,24,10,14,FMN GV 05 Lier
60,Mechelsesteenweg 365,2019-01-20,18:00:00,2,2,0,FMN GV 05 Lier
60,Mechelsesteenweg 365,2019-01-20,19:00:00,2,2,0,FMN GV 05 Lier
60,Mechelsesteenweg 365,2019-01-20,20:00:00,0,0,0,FMN GV 05 Lier
60,Mechelsesteenweg 365,2019-01-20,21:00:00,0,0,0,FMN GV 05 Lier
60,Mechelsesteenweg 365,2019-01-20,22:00:00,0,0,0,FMN GV 05 Lier
60,Mechelsesteenweg 365,2019-01-20,23:00:00,2,0,2,FMN GV 05 Lier
60,Mechelsesteenweg 365,2019-01-21,00:00:00,0,0,0,FMN GV 05 Lier
60,Mechelsesteenweg 365,2019-01-21,01:00:00,0,0,0,FMN GV 05 Lier
60,Mechelsesteenweg 365,2019-01-21,02:00:00,0,0,0,FMN GV 05 Lier
60,Mechelsesteenweg 365,2019-01-21,03:00:00,0,0,0,FMN GV 05 Lier
60,Mechelsesteenweg 365,2019-01-21,04:00:00,0,0,0,FMN GV 05 Lier
60,Mechelsesteenweg 365,2019-01-21,05:00:00,6,2,4,FMN GV 05 Lier
60,Mechelsesteenweg 365,2019-01-21,06:00:00,0,0,0,FMN GV 05 Lier
60,Mechelsesteenweg 365,2019-01-21,07:00:00,80,52,28,FMN GV 05 Lier
60,Mechelsesteenweg 365,2019-01-21,08:00:00,90,58,32,FMN GV 05 Lier
60,Mechelsesteenweg 365,2019-01-21,09:00:00,24,16,8,FMN GV 05 Lier
60,Mechelsesteenweg 365,2019-01-21,10:00:00,10,2,8,FMN GV 05 Lier
60,Mechelsesteenweg 365,2019-01-21,11:00:00,18,8,10,FMN GV 05 Lier
60,Mechelsesteenweg 365,2019-01-21,12:00:00,38,18,20,FMN GV 05 Lier
60,Mechelsesteenweg 365,2019-01-21,13:00:00,50,24,26,FMN GV 05 Lier
60,Mechelsesteenweg 365,2019-01-21,14:00:00,94,56,38,FMN GV 05 Lier
60,Mechelsesteenweg 365,2019-01-21,15:00:00,76,42,34,FMN GV 05 Lier
60,Mechelsesteenweg 365,2019-01-21,16:00:00,148,46,102,FMN GV 05 Lier
60,Mechelsesteenweg 365,2019-01-21,17:00:00,50,24,26,FMN GV 05 Lier
60,Mechelsesteenweg 365,2019-01-21,18:00:00,32,18,14,FMN GV 05 Lier
60,Mechelsesteenweg 365,2019-01-21,19:00:00,4,2,2,FMN GV 05 Lier
60,Mechelsesteenweg 365,2019-01-21,20:00:00,0,0,0,FMN GV 05 Lier
60,Mechelsesteenweg 365,2019-01-21,21:00:00,4,0,4,FMN GV 05 Lier
60,Mechelsesteenweg 365,2019-01-21,22:00:00,2,0,2,FMN GV 05 Lier
60,Mechelsesteenweg 365,2019-01-21,23:00:00,4,4,0,FMN GV 05 Lier
60,Mechelsesteenweg 365,2019-01-22,00:00:00,0,0,0,FMN GV 05 Lier
60,Mechelsesteenweg 365,2019-01-22,01:00:00,0,0,0,FMN GV 05 Lier
60,Mechelsesteenweg 365,2019-01-22,02:00:00,0,0,0,FMN GV 05 Lier
60,Mechelsesteenweg 365,2019-01-22,03:00:00,0,0,0,FMN GV 05 Lier
60,Mechelsesteenweg 365,2019-01-22,04:00:00,4,0,4,FMN GV 05 Lier
60,Mechelsesteenweg 365,2019-01-22,05:00:00,4,2,2,FMN GV 05 Lier
60,Mechelsesteenweg 365,2019-01-22,06:00:00,2,0,2,FMN GV 05 Lier
60,Mechelsesteenweg 365,2019-01-22,07:00:00,80,54,26,FMN GV 05 Lier
60,Mechelsesteenweg 365,2019-01-22,08:00:00,66,42,24,FMN GV 05 Lier
60,Mechelsesteenweg 365,2019-01-22,09:00:00,16,6,10,FMN GV 05 Lier
60,Mechelsesteenweg 365,2019-01-22,10:00:00,4,0,4,FMN GV 05 Lier
60,Mechelsesteenweg 365,2019-01-22,11:00:00,2,2,0,FMN GV 05 Lier
60,Mechelsesteenweg 365,2019-01-22,12:00:00,4,4,0,FMN GV 05 Lier
60,Mechelsesteenweg 365,2019-01-22,13:00:00,4,4,0,FMN GV 05 Lier
60,Mechelsesteenweg 365,2019-01-22,14:00:00,10,10,0,FMN GV 05 Lier
60,Mechelsesteenweg 365,2019-01-22,15:00:00,16,0,16,FMN GV 05 Lier
60,Mechelsesteenweg 365,2019-01-22,16:00:00,54,14,40,FMN GV 05 Lier
60,Mechelsesteenweg 365,2019-01-22,17:00:00,32,16,16,FMN GV 05 Lier
60,Mechelsesteenweg 365,2019-01-22,18:00:00,8,8,0,FMN GV 05 Lier
60,Mechelsesteenweg 365,2019-01-22,19:00:00,10,6,4,FMN GV 05 Lier
60,Mechelsesteenweg 365,2019-01-22,20:00:00,0,0,0,FMN GV 05 Lier
60,Mechelsesteenweg 365,2019-01-22,21:00:00,4,0,4,FMN GV 05 Lier
60,Mechelsesteenweg 365,2019-01-22,22:00:00,6,4,2,FMN GV 05 Lier
60,Mechelsesteenweg 365,2019-01-22,23:00:00,0,0,0,FMN GV 05 Lier
60,Mechelsesteenweg 365,2019-01-23,00:00:00,0,0,0,FMN GV 05 Lier
60,Mechelsesteenweg 365,2019-01-23,01:00:00,0,0,0,FMN GV 05 Lier
60,Mechelsesteenweg 365,2019-01-23,02:00:00,0,0,0,FMN GV 05 Lier
60,Mechelsesteenweg 365,2019-01-23,03:00:00,0,0,0,FMN GV 05 Lier
60,Mechelsesteenweg 365,2019-01-23,04:00:00,0,0,0,FMN GV 05 Lier
60,Mechelsesteenweg 365,2019-01-23,05:00:00,4,0,4,FMN GV 05 Lier
60,Mechelsesteenweg 365,2019-01-23,06:00:00,0,0,0,FMN GV 05 Lier
60,Mechelsesteenweg 365,2019-01-23,07:00:00,10,2,8,FMN GV 05 Lier
60,Mechelsesteenweg 365,2019-01-23,08:00:00,10,4,6,FMN GV 05 Lier
60,Mechelsesteenweg 365,2019-01-23,09:00:00,6,2,4,FMN GV 05 Lier
60,Mechelsesteenweg 365,2019-01-23,10:00:00,4,4,0,FMN GV 05 Lier
60,Mechelsesteenweg 365,2019-01-23,11:00:00,4,4,0,FMN GV 05 Lier
60,Mechelsesteenweg 365,2019-01-23,12:00:00,8,8,0,FMN GV 05 Lier
60,Mechelsesteenweg 365,2019-01-23,13:00:00,16,10,6,FMN GV 05 Lier
60,Mechelsesteenweg 365,2019-01-23,14:00:00,8,2,6,FMN GV 05 Lier
60,Mechelsesteenweg 365,2019-01-23,15:00:00,6,4,2,FMN GV 05 Lier
60,Mechelsesteenweg 365,2019-01-23,16:00:00,6,2,4,FMN GV 05 Lier
60,Mechelsesteenweg 365,2019-01-23,17:00:00,10,8,2,FMN GV 05 Lier
60,Mechelsesteenweg 365,2019-01-23,18:00:00,8,8,0,FMN GV 05 Lier
60,Mechelsesteenweg 365,2019-01-23,19:00:00,2,0,2,FMN GV 05 Lier
60,Mechelsesteenweg 365,2019-01-23,20:00:00,4,2,2,FMN GV 05 Lier
60,Mechelsesteenweg 365,2019-01-23,21:00:00,6,2,4,FMN GV 05 Lier
60,Mechelsesteenweg 365,2019-01-23,22:00:00,0,0,0,FMN GV 05 Lier
60,Mechelsesteenweg 365,2019-01-23,23:00:00,2,2,0,FMN GV 05 Lier
60,Mechelsesteenweg 365,2019-01-24,00:00:00,0,0,0,FMN GV 05 Lier
60,Mechelsesteenweg 365,2019-01-24,01:00:00,0,0,0,FMN GV 05 Lier
60,Mechelsesteenweg 365,2019-01-24,02:00:00,0,0,0,FMN GV 05 Lier
60,Mechelsesteenweg 365,2019-01-24,03:00:00,0,0,0,FMN GV 05 Lier
60,Mechelsesteenweg 365,2019-01-24,04:00:00,2,0,2,FMN GV 05 Lier
60,Mechelsesteenweg 365,2019-01-24,05:00:00,2,0,2,FMN GV 05 Lier
60,Mechelsesteenweg 365,2019-01-24,06:00:00,2,0,2,FMN GV 05 Lier
60,Mechelsesteenweg 365,2019-01-24,07:00:00,28,10,18,FMN GV 05 Lier
60,Mechelsesteenweg 365,2019-01-24,08:00:00,26,18,8,FMN GV 05 Lier
60,Mechelsesteenweg 365,2019-01-24,09:00:00,4,2,2,FMN GV 05 Lier
60,Mechelsesteenweg 365,2019-01-24,10:00:00,4,4,0,FMN GV 05 Lier
60,Mechelsesteenweg 365,2019-01-24,11:00:00,2,0,2,FMN GV 05 Lier
60,Mechelsesteenweg 365,2019-01-24,12:00:00,6,0,6,FMN GV 05 Lier
60,Mechelsesteenweg 365,2019-01-24,13:00:00,6,4,2,FMN GV 05 Lier
60,Mechelsesteenweg 365,2019-01-24,14:00:00,4,2,2,FMN GV 05 Lier
60,Mechelsesteenweg 365,2019-01-24,15:00:00,14,2,12,FMN GV 05 Lier
60,Mechelsesteenweg 365,2019-01-24,16:00:00,56,8,48,FMN GV 05 Lier
60,Mechelsesteenweg 365,2019-01-24,17:00:00,16,8,8,FMN GV 05 Lier
60,Mechelsesteenweg 365,2019-01-24,18:00:00,4,2,2,FMN GV 05 Lier
60,Mechelsesteenweg 365,2019-01-24,19:00:00,2,2,0,FMN GV 05 Lier
60,Mechelsesteenweg 365,2019-01-24,20:00:00,0,0,0,FMN GV 05 Lier
60,Mechelsesteenweg 365,2019-01-24,21:00:00,0,0,0,FMN GV 05 Lier
60,Mechelsesteenweg 365,2019-01-24,22:00:00,0,0,0,FMN GV 05 Lier
60,Mechelsesteenweg 365,2019-01-24,23:00:00,0,0,0,FMN GV 05 Lier
60,Mechelsesteenweg 365,2019-01-25,00:00:00,0,0,0,FMN GV 05 Lier
60,Mechelsesteenweg 365,2019-01-25,01:00:00,0,0,0,FMN GV 05 Lier
60,Mechelsesteenweg 365,2019-01-25,02:00:00,0,0,0,FMN GV 05 Lier
60,Mechelsesteenweg 365,2019-01-25,03:00:00,0,0,0,FMN GV 05 Lier
60,Mechelsesteenweg 365,2019-01-25,04:00:00,0,0,0,FMN GV 05 Lier
60,Mechelsesteenweg 365,2019-01-25,05:00:00,0,0,0,FMN GV 05 Lier
60,Mechelsesteenweg 365,2019-01-25,06:00:00,0,0,0,FMN GV 05 Lier
60,Mechelsesteenweg 365,2019-01-25,07:00:00,32,22,10,FMN GV 05 Lier
60,Mechelsesteenweg 365,2019-01-25,08:00:00,52,30,22,FMN GV 05 Lier
60,Mechelsesteenweg 365,2019-01-25,09:00:00,20,10,10,FMN GV 05 Lier
60,Mechelsesteenweg 365,2019-01-25,10:00:00,6,0,6,FMN GV 05 Lier
60,Mechelsesteenweg 365,2019-01-25,11:00:00,10,6,4,FMN GV 05 Lier
60,Mechelsesteenweg 365,2019-01-25,12:00:00,10,6,4,FMN GV 05 Lier
60,Mechelsesteenweg 365,2019-01-25,13:00:00,10,10,0,FMN GV 05 Lier
60,Mechelsesteenweg 365,2019-01-25,14:00:00,20,10,10,FMN GV 05 Lier
60,Mechelsesteenweg 365,2019-01-25,15:00:00,42,16,26,FMN GV 05 Lier
60,Mechelsesteenweg 365,2019-01-25,16:00:00,70,18,52,FMN GV 05 Lier
60,Mechelsesteenweg 365,2019-01-25,17:00:00,20,16,4,FMN GV 05 Lier
60,Mechelsesteenweg 365,2019-01-25,18:00:00,12,6,6,FMN GV 05 Lier
60,Mechelsesteenweg 365,2019-01-25,19:00:00,0,0,0,FMN GV 05 Lier
60,Mechelsesteenweg 365,2019-01-25,20:00:00,2,2,0,FMN GV 05 Lier
60,Mechelsesteenweg 365,2019-01-25,21:00:00,0,0,0,FMN GV 05 Lier
60,Mechelsesteenweg 365,2019-01-25,22:00:00,6,0,6,FMN GV 05 Lier
60,Mechelsesteenweg 365,2019-01-25,23:00:00,0,0,0,FMN GV 05 Lier
60,Mechelsesteenweg 365,2019-01-26,00:00:00,0,0,0,FMN GV 05 Lier
60,Mechelsesteenweg 365,2019-01-26,01:00:00,0,0,0,FMN GV 05 Lier
60,Mechelsesteenweg 365,2019-01-26,02:00:00,0,0,0,FMN GV 05 Lier
60,Mechelsesteenweg 365,2019-01-26,03:00:00,0,0,0,FMN GV 05 Lier
60,Mechelsesteenweg 365,2019-01-26,04:00:00,0,0,0,FMN GV 05 Lier
60,Mechelsesteenweg 365,2019-01-26,05:00:00,0,0,0,FMN GV 05 Lier
60,Mechelsesteenweg 365,2019-01-26,06:00:00,2,2,0,FMN GV 05 Lier
60,Mechelsesteenweg 365,2019-01-26,07:00:00,4,2,2,FMN GV 05 Lier
60,Mechelsesteenweg 365,2019-01-26,08:00:00,18,12,6,FMN GV 05 Lier
60,Mechelsesteenweg 365,2019-01-26,09:00:00,32,10,22,FMN GV 05 Lier
60,Mechelsesteenweg 365,2019-01-26,10:00:00,80,52,28,FMN GV 05 Lier
60,Mechelsesteenweg 365,2019-01-26,11:00:00,68,36,32,FMN GV 05 Lier
60,Mechelsesteenweg 365,2019-01-26,12:00:00,52,26,26,FMN GV 05 Lier
60,Mechelsesteenweg 365,2019-01-26,13:00:00,46,14,32,FMN GV 05 Lier
60,Mechelsesteenweg 365,2019-01-26,14:00:00,88,56,32,FMN GV 05 Lier
60,Mechelsesteenweg 365,2019-01-26,15:00:00,68,22,46,FMN GV 05 Lier
60,Mechelsesteenweg 365,2019-01-26,16:00:00,34,14,20,FMN GV 05 Lier
60,Mechelsesteenweg 365,2019-01-26,17:00:00,8,2,6,FMN GV 05 Lier
60,Mechelsesteenweg 365,2019-01-26,18:00:00,4,0,4,FMN GV 05 Lier
60,Mechelsesteenweg 365,2019-01-26,19:00:00,4,0,4,FMN GV 05 Lier
60,Mechelsesteenweg 365,2019-01-26,20:00:00,0,0,0,FMN GV 05 Lier
60,Mechelsesteenweg 365,2019-01-26,21:00:00,0,0,0,FMN GV 05 Lier
60,Mechelsesteenweg 365,2019-01-26,22:00:00,6,2,4,FMN GV 05 Lier
60,Mechelsesteenweg 365,2019-01-26,23:00:00,0,0,0,FMN GV 05 Lier
60,Mechelsesteenweg 365,2019-01-27,00:00:00,0,0,0,FMN GV 05 Lier
60,Mechelsesteenweg 365,2019-01-27,01:00:00,0,0,0,FMN GV 05 Lier
60,Mechelsesteenweg 365,2019-01-27,02:00:00,0,0,0,FMN GV 05 Lier
60,Mechelsesteenweg 365,2019-01-27,03:00:00,0,0,0,FMN GV 05 Lier
60,Mechelsesteenweg 365,2019-01-27,04:00:00,0,0,0,FMN GV 05 Lier
60,Mechelsesteenweg 365,2019-01-27,05:00:00,0,0,0,FMN GV 05 Lier
60,Mechelsesteenweg 365,2019-01-27,06:00:00,0,0,0,FMN GV 05 Lier
60,Mechelsesteenweg 365,2019-01-27,07:00:00,0,0,0,FMN GV 05 Lier
60,Mechelsesteenweg 365,2019-01-27,08:00:00,0,0,0,FMN GV 05 Lier
60,Mechelsesteenweg 365,2019-01-27,09:00:00,8,2,6,FMN GV 05 Lier
60,Mechelsesteenweg 365,2019-01-27,10:00:00,44,18,26,FMN GV 05 Lier
60,Mechelsesteenweg 365,2019-01-27,11:00:00,32,14,18,FMN GV 05 Lier
60,Mechelsesteenweg 365,2019-01-27,12:00:00,22,10,12,FMN GV 05 Lier
60,Mechelsesteenweg 365,2019-01-27,13:00:00,16,8,8,FMN GV 05 Lier
60,Mechelsesteenweg 365,2019-01-27,14:00:00,22,14,8,FMN GV 05 Lier
60,Mechelsesteenweg 365,2019-01-27,15:00:00,12,10,2,FMN GV 05 Lier
60,Mechelsesteenweg 365,2019-01-27,16:00:00,20,10,10,FMN GV 05 Lier
60,Mechelsesteenweg 365,2019-01-27,17:00:00,16,6,10,FMN GV 05 Lier
60,Mechelsesteenweg 365,2019-01-27,18:00:00,6,4,2,FMN GV 05 Lier
60,Mechelsesteenweg 365,2019-01-27,19:00:00,2,0,2,FMN GV 05 Lier
60,Mechelsesteenweg 365,2019-01-27,20:00:00,0,0,0,FMN GV 05 Lier
60,Mechelsesteenweg 365,2019-01-27,21:00:00,2,2,0,FMN GV 05 Lier
60,Mechelsesteenweg 365,2019-01-27,22:00:00,0,0,0,FMN GV 05 Lier
60,Mechelsesteenweg 365,2019-01-27,23:00:00,2,0,2,FMN GV 05 Lier
60,Mechelsesteenweg 365,2019-01-28,00:00:00,0,0,0,FMN GV 05 Lier
60,Mechelsesteenweg 365,2019-01-28,01:00:00,0,0,0,FMN GV 05 Lier
60,Mechelsesteenweg 365,2019-01-28,02:00:00,0,0,0,FMN GV 05 Lier
60,Mechelsesteenweg 365,2019-01-28,03:00:00,0,0,0,FMN GV 05 Lier
60,Mechelsesteenweg 365,2019-01-28,04:00:00,2,0,2,FMN GV 05 Lier
60,Mechelsesteenweg 365,2019-01-28,05:00:00,4,2,2,FMN GV 05 Lier
60,Mechelsesteenweg 365,2019-01-28,06:00:00,6,0,6,FMN GV 05 Lier
60,Mechelsesteenweg 365,2019-01-28,07:00:00,48,30,18,FMN GV 05 Lier
60,Mechelsesteenweg 365,2019-01-28,08:00:00,52,38,14,FMN GV 05 Lier
60,Mechelsesteenweg 365,2019-01-28,09:00:00,26,12,14,FMN GV 05 Lier
60,Mechelsesteenweg 365,2019-01-28,10:00:00,12,4,8,FMN GV 05 Lier
60,Mechelsesteenweg 365,2019-01-28,11:00:00,8,4,4,FMN GV 05 Lier
60,Mechelsesteenweg 365,2019-01-28,12:00:00,10,6,4,FMN GV 05 Lier
60,Mechelsesteenweg 365,2019-01-28,13:00:00,18,6,12,FMN GV 05 Lier
60,Mechelsesteenweg 365,2019-01-28,14:00:00,18,10,8,FMN GV 05 Lier
60,Mechelsesteenweg 365,2019-01-28,15:00:00,28,8,20,FMN GV 05 Lier
60,Mechelsesteenweg 365,2019-01-28,16:00:00,102,22,80,FMN GV 05 Lier
60,Mechelsesteenweg 365,2019-01-28,17:00:00,52,32,20,FMN GV 05 Lier
60,Mechelsesteenweg 365,2019-01-28,18:00:00,16,4,12,FMN GV 05 Lier
60,Mechelsesteenweg 365,2019-01-28,19:00:00,2,2,0,FMN GV 05 Lier
60,Mechelsesteenweg 365,2019-01-28,20:00:00,0,0,0,FMN GV 05 Lier
60,Mechelsesteenweg 365,2019-01-28,21:00:00,2,2,0,FMN GV 05 Lier
60,Mechelsesteenweg 365,2019-01-28,22:00:00,2,0,2,FMN GV 05 Lier
60,Mechelsesteenweg 365,2019-01-28,23:00:00,0,0,0,FMN GV 05 Lier
60,Mechelsesteenweg 365,2019-01-29,00:00:00,0,0,0,FMN GV 05 Lier
60,Mechelsesteenweg 365,2019-01-29,01:00:00,0,0,0,FMN GV 05 Lier
60,Mechelsesteenweg 365,2019-01-29,02:00:00,0,0,0,FMN GV 05 Lier
60,Mechelsesteenweg 365,2019-01-29,03:00:00,0,0,0,FMN GV 05 Lier
60,Mechelsesteenweg 365,2019-01-29,04:00:00,2,0,2,FMN GV 05 Lier
60,Mechelsesteenweg 365,2019-01-29,05:00:00,2,0,2,FMN GV 05 Lier
60,Mechelsesteenweg 365,2019-01-29,06:00:00,2,0,2,FMN GV 05 Lier
60,Mechelsesteenweg 365,2019-01-29,07:00:00,76,52,24,FMN GV 05 Lier
60,Mechelsesteenweg 365,2019-01-29,08:00:00,100,66,34,FMN GV 05 Lier
60,Mechelsesteenweg 365,2019-01-29,09:00:00,38,26,12,FMN GV 05 Lier
60,Mechelsesteenweg 365,2019-01-29,10:00:00,30,14,16,FMN GV 05 Lier
60,Mechelsesteenweg 365,2019-01-29,11:00:00,38,18,20,FMN GV 05 Lier
60,Mechelsesteenweg 365,2019-01-29,12:00:00,56,36,20,FMN GV 05 Lier
60,Mechelsesteenweg 365,2019-01-29,13:00:00,112,44,68,FMN GV 05 Lier
60,Mechelsesteenweg 365,2019-01-29,14:00:00,78,38,40,FMN GV 05 Lier
60,Mechelsesteenweg 365,2019-01-29,15:00:00,102,36,66,FMN GV 05 Lier
60,Mechelsesteenweg 365,2019-01-29,16:00:00,142,38,104,FMN GV 05 Lier
60,Mechelsesteenweg 365,2019-01-29,17:00:00,66,34,32,FMN GV 05 Lier
60,Mechelsesteenweg 365,2019-01-29,18:00:00,10,6,4,FMN GV 05 Lier
60,Mechelsesteenweg 365,2019-01-29,19:00:00,2,0,2,FMN GV 05 Lier
60,Mechelsesteenweg 365,2019-01-29,20:00:00,6,2,4,FMN GV 05 Lier
60,Mechelsesteenweg 365,2019-01-29,21:00:00,0,0,0,FMN GV 05 Lier
60,Mechelsesteenweg 365,2019-01-29,22:00:00,0,0,0,FMN GV 05 Lier
60,Mechelsesteenweg 365,2019-01-29,23:00:00,4,4,0,FMN GV 05 Lier
60,Mechelsesteenweg 365,2019-01-30,00:00:00,0,0,0,FMN GV 05 Lier
60,Mechelsesteenweg 365,2019-01-30,01:00:00,0,0,0,FMN GV 05 Lier
60,Mechelsesteenweg 365,2019-01-30,02:00:00,0,0,0,FMN GV 05 Lier
60,Mechelsesteenweg 365,2019-01-30,03:00:00,0,0,0,FMN GV 05 Lier
60,Mechelsesteenweg 365,2019-01-30,04:00:00,2,0,2,FMN GV 05 Lier
60,Mechelsesteenweg 365,2019-01-30,05:00:00,4,0,4,FMN GV 05 Lier
60,Mechelsesteenweg 365,2019-01-30,06:00:00,6,2,4,FMN GV 05 Lier
60,Mechelsesteenweg 365,2019-01-30,07:00:00,58,36,22,FMN GV 05 Lier
60,Mechelsesteenweg 365,2019-01-30,08:00:00,58,44,14,FMN GV 05 Lier
60,Mechelsesteenweg 365,2019-01-30,09:00:00,6,2,4,FMN GV 05 Lier
60,Mechelsesteenweg 365,2019-01-30,10:00:00,4,2,2,FMN GV 05 Lier
60,Mechelsesteenweg 365,2019-01-30,11:00:00,8,2,6,FMN GV 05 Lier
60,Mechelsesteenweg 365,2019-01-30,12:00:00,62,6,56,FMN GV 05 Lier
60,Mechelsesteenweg 365,2019-01-30,13:00:00,24,6,18,FMN GV 05 Lier
60,Mechelsesteenweg 365,2019-01-30,14:00:00,14,12,2,FMN GV 05 Lier
60,Mechelsesteenweg 365,2019-01-30,15:00:00,14,4,10,FMN GV 05 Lier
60,Mechelsesteenweg 365,2019-01-30,16:00:00,24,14,10,FMN GV 05 Lier
60,Mechelsesteenweg 365,2019-01-30,17:00:00,26,18,8,FMN GV 05 Lier
60,Mechelsesteenweg 365,2019-01-30,18:00:00,12,6,6,FMN GV 05 Lier
60,Mechelsesteenweg 365,2019-01-30,19:00:00,2,2,0,FMN GV 05 Lier
60,Mechelsesteenweg 365,2019-01-30,20:00:00,2,0,2,FMN GV 05 Lier
60,Mechelsesteenweg 365,2019-01-30,21:00:00,6,2,4,FMN GV 05 Lier
60,Mechelsesteenweg 365,2019-01-30,22:00:00,0,0,0,FMN GV 05 Lier
60,Mechelsesteenweg 365,2019-01-30,23:00:00,2,2,0,FMN GV 05 Lier
60,Mechelsesteenweg 365,2019-01-31,00:00:00,0,0,0,FMN GV 05 Lier
60,Mechelsesteenweg 365,2019-01-31,01:00:00,0,0,0,FMN GV 05 Lier
60,Mechelsesteenweg 365,2019-01-31,02:00:00,0,0,0,FMN GV 05 Lier
60,Mechelsesteenweg 365,2019-01-31,03:00:00,0,0,0,FMN GV 05 Lier
60,Mechelsesteenweg 365,2019-01-31,04:00:00,4,0,4,FMN GV 05 Lier
60,Mechelsesteenweg 365,2019-01-31,05:00:00,0,0,0,FMN GV 05 Lier
60,Mechelsesteenweg 365,2019-01-31,06:00:00,2,0,2,FMN GV 05 Lier
60,Mechelsesteenweg 365,2019-01-31,07:00:00,62,42,20,FMN GV 05 Lier
60,Mechelsesteenweg 365,2019-01-31,08:00:00,70,44,26,FMN GV 05 Lier
60,Mechelsesteenweg 365,2019-01-31,09:00:00,10,10,0,FMN GV 05 Lier
60,Mechelsesteenweg 365,2019-01-31,10:00:00,12,6,6,FMN GV 05 Lier
60,Mechelsesteenweg 365,2019-01-31,11:00:00,16,10,6,FMN GV 05 Lier
60,Mechelsesteenweg 365,2019-01-31,12:00:00,24,14,10,FMN GV 05 Lier
60,Mechelsesteenweg 365,2019-01-31,13:00:00,18,10,8,FMN GV 05 Lier
60,Mechelsesteenweg 365,2019-01-31,14:00:00,28,14,14,FMN GV 05 Lier
60,Mechelsesteenweg 365,2019-01-31,15:00:00,60,30,30,FMN GV 05 Lier
60,Mechelsesteenweg 365,2019-01-31,16:00:00,108,18,90,FMN GV 05 Lier
60,Mechelsesteenweg 365,2019-01-31,17:00:00,44,28,16,FMN GV 05 Lier
60,Mechelsesteenweg 365,2019-01-31,18:00:00,8,4,4,FMN GV 05 Lier
60,Mechelsesteenweg 365,2019-01-31,19:00:00,8,6,2,FMN GV 05 Lier
60,Mechelsesteenweg 365,2019-01-31,20:00:00,4,2,2,FMN GV 05 Lier
60,Mechelsesteenweg 365,2019-01-31,21:00:00,0,0,0,FMN GV 05 Lier
60,Mechelsesteenweg 365,2019-01-31,22:00:00,2,0,2,FMN GV 05 Lier
60,Mechelsesteenweg 365,2019-01-31,23:00:00,2,2,0,FMN GV 05 Lier
60,Mechelsesteenweg 365,2019-02-01,00:00:00,0,0,0,FMN GV 05 Lier
60,Mechelsesteenweg 365,2019-02-01,01:00:00,0,0,0,FMN GV 05 Lier
60,Mechelsesteenweg 365,2019-02-01,02:00:00,0,0,0,FMN GV 05 Lier
60,Mechelsesteenweg 365,2019-02-01,03:00:00,0,0,0,FMN GV 05 Lier
60,Mechelsesteenweg 365,2019-02-01,04:00:00,0,0,0,FMN GV 05 Lier
60,Mechelsesteenweg 365,2019-02-01,05:00:00,0,0,0,FMN GV 05 Lier
60,Mechelsesteenweg 365,2019-02-01,06:00:00,2,0,2,FMN GV 05 Lier
60,Mechelsesteenweg 365,2019-02-01,07:00:00,32,20,12,FMN GV 05 Lier
60,Mechelsesteenweg 365,2019-02-01,08:00:00,54,32,22,FMN GV 05 Lier
60,Mechelsesteenweg 365,2019-02-01,09:00:00,0,0,0,FMN GV 05 Lier
60,Mechelsesteenweg 365,2019-02-01,10:00:00,2,2,0,FMN GV 05 Lier
60,Mechelsesteenweg 365,2019-02-01,11:00:00,0,0,0,FMN GV 05 Lier
60,Mechelsesteenweg 365,2019-02-01,12:00:00,12,6,6,FMN GV 05 Lier
60,Mechelsesteenweg 365,2019-02-01,13:00:00,20,8,12,FMN GV 05 Lier
60,Mechelsesteenweg 365,2019-02-01,14:00:00,20,8,12,FMN GV 05 Lier
60,Mechelsesteenweg 365,2019-02-01,15:00:00,40,16,24,FMN GV 05 Lier
60,Mechelsesteenweg 365,2019-02-01,16:00:00,118,40,78,FMN GV 05 Lier
60,Mechelsesteenweg 365,2019-02-01,17:00:00,28,14,14,FMN GV 05 Lier
60,Mechelsesteenweg 365,2019-02-01,18:00:00,6,4,2,FMN GV 05 Lier
60,Mechelsesteenweg 365,2019-02-01,19:00:00,8,4,4,FMN GV 05 Lier
60,Mechelsesteenweg 365,2019-02-01,20:00:00,0,0,0,FMN GV 05 Lier
60,Mechelsesteenweg 365,2019-02-01,21:00:00,8,6,2,FMN GV 05 Lier
60,Mechelsesteenweg 365,2019-02-01,22:00:00,8,6,2,FMN GV 05 Lier
60,Mechelsesteenweg 365,2019-02-01,23:00:00,20,12,8,FMN GV 05 Lier
60,Mechelsesteenweg 365,2019-02-02,00:00:00,10,6,4,FMN GV 05 Lier
60,Mechelsesteenweg 365,2019-02-02,01:00:00,4,0,4,FMN GV 05 Lier
60,Mechelsesteenweg 365,2019-02-02,02:00:00,2,0,2,FMN GV 05 Lier
60,Mechelsesteenweg 365,2019-02-02,03:00:00,6,0,6,FMN GV 05 Lier
60,Mechelsesteenweg 365,2019-02-02,04:00:00,0,0,0,FMN GV 05 Lier
60,Mechelsesteenweg 365,2019-02-02,05:00:00,2,0,2,FMN GV 05 Lier
60,Mechelsesteenweg 365,2019-02-02,06:00:00,0,0,0,FMN GV 05 Lier
60,Mechelsesteenweg 365,2019-02-02,07:00:00,2,0,2,FMN GV 05 Lier
60,Mechelsesteenweg 365,2019-02-02,08:00:00,4,4,0,FMN GV 05 Lier
60,Mechelsesteenweg 365,2019-02-02,09:00:00,6,2,4,FMN GV 05 Lier
60,Mechelsesteenweg 365,2019-02-02,10:00:00,4,2,2,FMN GV 05 Lier
60,Mechelsesteenweg 365,2019-02-02,11:00:00,10,2,8,FMN GV 05 Lier
60,Mechelsesteenweg 365,2019-02-02,12:00:00,12,8,4,FMN GV 05 Lier
60,Mechelsesteenweg 365,2019-02-02,13:00:00,14,8,6,FMN GV 05 Lier
60,Mechelsesteenweg 365,2019-02-02,14:00:00,10,10,0,FMN GV 05 Lier
60,Mechelsesteenweg 365,2019-02-02,15:00:00,4,4,0,FMN GV 05 Lier
60,Mechelsesteenweg 365,2019-02-02,16:00:00,8,2,6,FMN GV 05 Lier
60,Mechelsesteenweg 365,2019-02-02,17:00:00,8,6,2,FMN GV 05 Lier
60,Mechelsesteenweg 365,2019-02-02,18:00:00,2,2,0,FMN GV 05 Lier
60,Mechelsesteenweg 365,2019-02-02,19:00:00,2,0,2,FMN GV 05 Lier
60,Mechelsesteenweg 365,2019-02-02,20:00:00,8,2,6,FMN GV 05 Lier
60,Mechelsesteenweg 365,2019-02-02,21:00:00,0,0,0,FMN GV 05 Lier
60,Mechelsesteenweg 365,2019-02-02,22:00:00,0,0,0,FMN GV 05 Lier
60,Mechelsesteenweg 365,2019-02-02,23:00:00,0,0,0,FMN GV 05 Lier
60,Mechelsesteenweg 365,2019-02-03,00:00:00,0,0,0,FMN GV 05 Lier
60,Mechelsesteenweg 365,2019-02-03,01:00:00,0,0,0,FMN GV 05 Lier
60,Mechelsesteenweg 365,2019-02-03,02:00:00,0,0,0,FMN GV 05 Lier
60,Mechelsesteenweg 365,2019-02-03,03:00:00,0,0,0,FMN GV 05 Lier
60,Mechelsesteenweg 365,2019-02-03,04:00:00,0,0,0,FMN GV 05 Lier
60,Mechelsesteenweg 365,2019-02-03,05:00:00,0,0,0,FMN GV 05 Lier
60,Mechelsesteenweg 365,2019-02-03,06:00:00,0,0,0,FMN GV 05 Lier
60,Mechelsesteenweg 365,2019-02-03,07:00:00,4,2,2,FMN GV 05 Lier
60,Mechelsesteenweg 365,2019-02-03,08:00:00,18,8,10,FMN GV 05 Lier
60,Mechelsesteenweg 365,2019-02-03,09:00:00,104,70,34,FMN GV 05 Lier
60,Mechelsesteenweg 365,2019-02-03,10:00:00,174,120,54,FMN GV 05 Lier
60,Mechelsesteenweg 365,2019-02-03,11:00:00,218,90,128,FMN GV 05 Lier
60,Mechelsesteenweg 365,2019-02-03,12:00:00,124,56,68,FMN GV 05 Lier
60,Mechelsesteenweg 365,2019-02-03,13:00:00,126,60,66,FMN GV 05 Lier
60,Mechelsesteenweg 365,2019-02-03,14:00:00,148,64,84,FMN GV 05 Lier
60,Mechelsesteenweg 365,2019-02-03,15:00:00,108,48,60,FMN GV 05 Lier
60,Mechelsesteenweg 365,2019-02-03,16:00:00,46,16,30,FMN GV 05 Lier
60,Mechelsesteenweg 365,2019-02-03,17:00:00,36,22,14,FMN GV 05 Lier
60,Mechelsesteenweg 365,2019-02-03,18:00:00,2,0,2,FMN GV 05 Lier
60,Mechelsesteenweg 365,2019-02-03,19:00:00,0,0,0,FMN GV 05 Lier
60,Mechelsesteenweg 365,2019-02-03,20:00:00,0,0,0,FMN GV 05 Lier
60,Mechelsesteenweg 365,2019-02-03,21:00:00,2,2,0,FMN GV 05 Lier
60,Mechelsesteenweg 365,2019-02-03,22:00:00,2,0,2,FMN GV 05 Lier
60,Mechelsesteenweg 365,2019-02-03,23:00:00,0,0,0,FMN GV 05 Lier
60,Mechelsesteenweg 365,2019-02-04,00:00:00,0,0,0,FMN GV 05 Lier
60,Mechelsesteenweg 365,2019-02-04,01:00:00,0,0,0,FMN GV 05 Lier
60,Mechelsesteenweg 365,2019-02-04,02:00:00,0,0,0,FMN GV 05 Lier
60,Mechelsesteenweg 365,2019-02-04,03:00:00,0,0,0,FMN GV 05 Lier
60,Mechelsesteenweg 365,2019-02-04,04:00:00,4,0,4,FMN GV 05 Lier
60,Mechelsesteenweg 365,2019-02-04,05:00:00,2,0,2,FMN GV 05 Lier
60,Mechelsesteenweg 365,2019-02-04,06:00:00,8,4,4,FMN GV 05 Lier
60,Mechelsesteenweg 365,2019-02-04,07:00:00,72,48,24,FMN GV 05 Lier
60,Mechelsesteenweg 365,2019-02-04,08:00:00,96,62,34,FMN GV 05 Lier
60,Mechelsesteenweg 365,2019-02-04,09:00:00,44,32,12,FMN GV 05 Lier
60,Mechelsesteenweg 365,2019-02-04,10:00:00,24,10,14,FMN GV 05 Lier
60,Mechelsesteenweg 365,2019-02-04,11:00:00,20,12,8,FMN GV 05 Lier
60,Mechelsesteenweg 365,2019-02-04,12:00:00,20,8,12,FMN GV 05 Lier
60,Mechelsesteenweg 365,2019-02-04,13:00:00,26,14,12,FMN GV 05 Lier
60,Mechelsesteenweg 365,2019-02-04,14:00:00,26,16,10,FMN GV 05 Lier
60,Mechelsesteenweg 365,2019-02-04,15:00:00,22,10,12,FMN GV 05 Lier
60,Mechelsesteenweg 365,2019-02-04,16:00:00,118,24,94,FMN GV 05 Lier
60,Mechelsesteenweg 365,2019-02-04,17:00:00,42,26,16,FMN GV 05 Lier
60,Mechelsesteenweg 365,2019-02-04,18:00:00,14,8,6,FMN GV 05 Lier
60,Mechelsesteenweg 365,2019-02-04,19:00:00,10,4,6,FMN GV 05 Lier
60,Mechelsesteenweg 365,2019-02-04,20:00:00,4,4,0,FMN GV 05 Lier
60,Mechelsesteenweg 365,2019-02-04,21:00:00,0,0,0,FMN GV 05 Lier
60,Mechelsesteenweg 365,2019-02-04,22:00:00,4,2,2,FMN GV 05 Lier
60,Mechelsesteenweg 365,2019-02-04,23:00:00,0,0,0,FMN GV 05 Lier
60,Mechelsesteenweg 365,2019-02-05,00:00:00,0,0,0,FMN GV 05 Lier
60,Mechelsesteenweg 365,2019-02-05,01:00:00,0,0,0,FMN GV 05 Lier
60,Mechelsesteenweg 365,2019-02-05,02:00:00,0,0,0,FMN GV 05 Lier
60,Mechelsesteenweg 365,2019-02-05,03:00:00,2,0,2,FMN GV 05 Lier
60,Mechelsesteenweg 365,2019-02-05,04:00:00,4,0,4,FMN GV 05 Lier
60,Mechelsesteenweg 365,2019-02-05,05:00:00,0,0,0,FMN GV 05 Lier
60,Mechelsesteenweg 365,2019-02-05,06:00:00,8,4,4,FMN GV 05 Lier
60,Mechelsesteenweg 365,2019-02-05,07:00:00,126,72,54,FMN GV 05 Lier
60,Mechelsesteenweg 365,2019-02-05,08:00:00,112,68,44,FMN GV 05 Lier
60,Mechelsesteenweg 365,2019-02-05,09:00:00,106,84,22,FMN GV 05 Lier
60,Mechelsesteenweg 365,2019-02-05,10:00:00,90,60,30,FMN GV 05 Lier
60,Mechelsesteenweg 365,2019-02-05,11:00:00,146,40,106,FMN GV 05 Lier
60,Mechelsesteenweg 365,2019-02-05,12:00:00,54,32,22,FMN GV 05 Lier
60,Mechelsesteenweg 365,2019-02-05,13:00:00,86,40,46,FMN GV 05 Lier
60,Mechelsesteenweg 365,2019-02-05,14:00:00,90,58,32,FMN GV 05 Lier
60,Mechelsesteenweg 365,2019-02-05,15:00:00,110,52,58,FMN GV 05 Lier
60,Mechelsesteenweg 365,2019-02-05,16:00:00,184,56,128,FMN GV 05 Lier
60,Mechelsesteenweg 365,2019-02-05,17:00:00,102,70,32,FMN GV 05 Lier
60,Mechelsesteenweg 365,2019-02-05,18:00:00,28,20,8,FMN GV 05 Lier
60,Mechelsesteenweg 365,2019-02-05,19:00:00,2,0,2,FMN GV 05 Lier
60,Mechelsesteenweg 365,2019-02-05,20:00:00,6,2,4,FMN GV 05 Lier
60,Mechelsesteenweg 365,2019-02-05,21:00:00,0,0,0,FMN GV 05 Lier
60,Mechelsesteenweg 365,2019-02-05,22:00:00,2,2,0,FMN GV 05 Lier
60,Mechelsesteenweg 365,2019-02-05,23:00:00,4,2,2,FMN GV 05 Lier
60,Mechelsesteenweg 365,2019-02-06,00:00:00,0,0,0,FMN GV 05 Lier
60,Mechelsesteenweg 365,2019-02-06,01:00:00,0,0,0,FMN GV 05 Lier
60,Mechelsesteenweg 365,2019-02-06,02:00:00,0,0,0,FMN GV 05 Lier
60,Mechelsesteenweg 365,2019-02-06,03:00:00,2,0,2,FMN GV 05 Lier
60,Mechelsesteenweg 365,2019-02-06,04:00:00,4,0,4,FMN GV 05 Lier
60,Mechelsesteenweg 365,2019-02-06,05:00:00,4,0,4,FMN GV 05 Lier
60,Mechelsesteenweg 365,2019-02-06,06:00:00,12,2,10,FMN GV 05 Lier
60,Mechelsesteenweg 365,2019-02-06,07:00:00,90,52,38,FMN GV 05 Lier
60,Mechelsesteenweg 365,2019-02-06,08:00:00,94,60,34,FMN GV 05 Lier
60,Mechelsesteenweg 365,2019-02-06,09:00:00,36,20,16,FMN GV 05 Lier
60,Mechelsesteenweg 365,2019-02-06,10:00:00,30,18,12,FMN GV 05 Lier
60,Mechelsesteenweg 365,2019-02-06,11:00:00,28,12,16,FMN GV 05 Lier
60,Mechelsesteenweg 365,2019-02-06,12:00:00,126,30,96,FMN GV 05 Lier
60,Mechelsesteenweg 365,2019-02-06,13:00:00,34,10,24,FMN GV 05 Lier
60,Mechelsesteenweg 365,2019-02-06,14:00:00,48,20,28,FMN GV 05 Lier
60,Mechelsesteenweg 365,2019-02-06,15:00:00,40,20,20,FMN GV 05 Lier
60,Mechelsesteenweg 365,2019-02-06,16:00:00,44,34,10,FMN GV 05 Lier
60,Mechelsesteenweg 365,2019-02-06,17:00:00,64,32,32,FMN GV 05 Lier
60,Mechelsesteenweg 365,2019-02-06,18:00:00,24,22,2,FMN GV 05 Lier
60,Mechelsesteenweg 365,2019-02-06,19:00:00,8,2,6,FMN GV 05 Lier
60,Mechelsesteenweg 365,2019-02-06,20:00:00,4,2,2,FMN GV 05 Lier
60,Mechelsesteenweg 365,2019-02-06,21:00:00,8,4,4,FMN GV 05 Lier
60,Mechelsesteenweg 365,2019-02-06,22:00:00,4,2,2,FMN GV 05 Lier
60,Mechelsesteenweg 365,2019-02-06,23:00:00,2,2,0,FMN GV 05 Lier
60,Mechelsesteenweg 365,2019-02-07,00:00:00,0,0,0,FMN GV 05 Lier
60,Mechelsesteenweg 365,2019-02-07,01:00:00,0,0,0,FMN GV 05 Lier
60,Mechelsesteenweg 365,2019-02-07,02:00:00,0,0,0,FMN GV 05 Lier
60,Mechelsesteenweg 365,2019-02-07,03:00:00,2,0,2,FMN GV 05 Lier
60,Mechelsesteenweg 365,2019-02-07,04:00:00,0,0,0,FMN GV 05 Lier
60,Mechelsesteenweg 365,2019-02-07,05:00:00,0,0,0,FMN GV 05 Lier
60,Mechelsesteenweg 365,2019-02-07,06:00:00,0,0,0,FMN GV 05 Lier
60,Mechelsesteenweg 365,2019-02-07,07:00:00,88,54,34,FMN GV 05 Lier
60,Mechelsesteenweg 365,2019-02-07,08:00:00,96,62,34,FMN GV 05 Lier
60,Mechelsesteenweg 365,2019-02-07,09:00:00,32,20,12,FMN GV 05 Lier
60,Mechelsesteenweg 365,2019-02-07,10:00:00,32,18,14,FMN GV 05 Lier
60,Mechelsesteenweg 365,2019-02-07,11:00:00,32,24,8,FMN GV 05 Lier
60,Mechelsesteenweg 365,2019-02-07,12:00:00,40,18,22,FMN GV 05 Lier
60,Mechelsesteenweg 365,2019-02-07,13:00:00,24,6,18,FMN GV 05 Lier
60,Mechelsesteenweg 365,2019-02-07,14:00:00,48,26,22,FMN GV 05 Lier
60,Mechelsesteenweg 365,2019-02-07,15:00:00,54,30,24,FMN GV 05 Lier
60,Mechelsesteenweg 365,2019-02-07,16:00:00,108,36,72,FMN GV 05 Lier
60,Mechelsesteenweg 365,2019-02-07,17:00:00,70,38,32,FMN GV 05 Lier
60,Mechelsesteenweg 365,2019-02-07,18:00:00,22,14,8,FMN GV 05 Lier
60,Mechelsesteenweg 365,2019-02-07,19:00:00,18,14,4,FMN GV 05 Lier
60,Mechelsesteenweg 365,2019-02-07,20:00:00,2,2,0,FMN GV 05 Lier
60,Mechelsesteenweg 365,2019-02-07,21:00:00,8,2,6,FMN GV 05 Lier
60,Mechelsesteenweg 365,2019-02-07,22:00:00,6,4,2,FMN GV 05 Lier
60,Mechelsesteenweg 365,2019-02-07,23:00:00,0,0,0,FMN GV 05 Lier
60,Mechelsesteenweg 365,2019-02-08,00:00:00,0,0,0,FMN GV 05 Lier
60,Mechelsesteenweg 365,2019-02-08,01:00:00,0,0,0,FMN GV 05 Lier
60,Mechelsesteenweg 365,2019-02-08,02:00:00,0,0,0,FMN GV 05 Lier
60,Mechelsesteenweg 365,2019-02-08,03:00:00,0,0,0,FMN GV 05 Lier
60,Mechelsesteenweg 365,2019-02-08,04:00:00,0,0,0,FMN GV 05 Lier
60,Mechelsesteenweg 365,2019-02-08,05:00:00,0,0,0,FMN GV 05 Lier
60,Mechelsesteenweg 365,2019-02-08,06:00:00,8,4,4,FMN GV 05 Lier
60,Mechelsesteenweg 365,2019-02-08,07:00:00,46,22,24,FMN GV 05 Lier
60,Mechelsesteenweg 365,2019-02-08,08:00:00,34,12,22,FMN GV 05 Lier
60,Mechelsesteenweg 365,2019-02-08,09:00:00,4,2,2,FMN GV 05 Lier
60,Mechelsesteenweg 365,2019-02-08,10:00:00,10,6,4,FMN GV 05 Lier
60,Mechelsesteenweg 365,2019-02-08,11:00:00,32,16,16,FMN GV 05 Lier
60,Mechelsesteenweg 365,2019-02-08,12:00:00,48,34,14,FMN GV 05 Lier
60,Mechelsesteenweg 365,2019-02-08,13:00:00,34,12,22,FMN GV 05 Lier
60,Mechelsesteenweg 365,2019-02-08,14:00:00,30,12,18,FMN GV 05 Lier
60,Mechelsesteenweg 365,2019-02-08,15:00:00,34,24,10,FMN GV 05 Lier
60,Mechelsesteenweg 365,2019-02-08,16:00:00,50,30,20,FMN GV 05 Lier
60,Mechelsesteenweg 365,2019-02-08,17:00:00,46,28,18,FMN GV 05 Lier
60,Mechelsesteenweg 365,2019-02-08,18:00:00,6,0,6,FMN GV 05 Lier
60,Mechelsesteenweg 365,2019-02-08,19:00:00,10,4,6,FMN GV 05 Lier
60,Mechelsesteenweg 365,2019-02-08,20:00:00,0,0,0,FMN GV 05 Lier
60,Mechelsesteenweg 365,2019-02-08,21:00:00,2,0,2,FMN GV 05 Lier
60,Mechelsesteenweg 365,2019-02-08,22:00:00,4,4,0,FMN GV 05 Lier
60,Mechelsesteenweg 365,2019-02-08,23:00:00,0,0,0,FMN GV 05 Lier
60,Mechelsesteenweg 365,2019-02-09,00:00:00,0,0,0,FMN GV 05 Lier
60,Mechelsesteenweg 365,2019-02-09,01:00:00,0,0,0,FMN GV 05 Lier
60,Mechelsesteenweg 365,2019-02-09,02:00:00,0,0,0,FMN GV 05 Lier
60,Mechelsesteenweg 365,2019-02-09,03:00:00,0,0,0,FMN GV 05 Lier
60,Mechelsesteenweg 365,2019-02-09,04:00:00,0,0,0,FMN GV 05 Lier
60,Mechelsesteenweg 365,2019-02-09,05:00:00,0,0,0,FMN GV 05 Lier
60,Mechelsesteenweg 365,2019-02-09,06:00:00,4,0,4,FMN GV 05 Lier
60,Mechelsesteenweg 365,2019-02-09,07:00:00,10,4,6,FMN GV 05 Lier
60,Mechelsesteenweg 365,2019-02-09,08:00:00,12,8,4,FMN GV 05 Lier
60,Mechelsesteenweg 365,2019-02-09,09:00:00,24,8,16,FMN GV 05 Lier
60,Mechelsesteenweg 365,2019-02-09,10:00:00,34,14,20,FMN GV 05 Lier
60,Mechelsesteenweg 365,2019-02-09,11:00:00,42,28,14,FMN GV 05 Lier
60,Mechelsesteenweg 365,2019-02-09,12:00:00,72,52,20,FMN GV 05 Lier
60,Mechelsesteenweg 365,2019-02-09,13:00:00,44,18,26,FMN GV 05 Lier
60,Mechelsesteenweg 365,2019-02-09,14:00:00,122,92,30,FMN GV 05 Lier
60,Mechelsesteenweg 365,2019-02-09,15:00:00,54,30,24,FMN GV 05 Lier
60,Mechelsesteenweg 365,2019-02-09,16:00:00,42,16,26,FMN GV 05 Lier
60,Mechelsesteenweg 365,2019-02-09,17:00:00,24,14,10,FMN GV 05 Lier
60,Mechelsesteenweg 365,2019-02-09,18:00:00,8,4,4,FMN GV 05 Lier
60,Mechelsesteenweg 365,2019-02-09,19:00:00,4,2,2,FMN GV 05 Lier
60,Mechelsesteenweg 365,2019-02-09,20:00:00,2,0,2,FMN GV 05 Lier
60,Mechelsesteenweg 365,2019-02-09,21:00:00,2,0,2,FMN GV 05 Lier
60,Mechelsesteenweg 365,2019-02-09,22:00:00,4,4,0,FMN GV 05 Lier
60,Mechelsesteenweg 365,2019-02-09,23:00:00,0,0,0,FMN GV 05 Lier
60,Mechelsesteenweg 365,2019-02-10,00:00:00,2,0,2,FMN GV 05 Lier
60,Mechelsesteenweg 365,2019-02-10,01:00:00,2,0,2,FMN GV 05 Lier
60,Mechelsesteenweg 365,2019-02-10,02:00:00,0,0,0,FMN GV 05 Lier
60,Mechelsesteenweg 365,2019-02-10,03:00:00,0,0,0,FMN GV 05 Lier
60,Mechelsesteenweg 365,2019-02-10,04:00:00,0,0,0,FMN GV 05 Lier
60,Mechelsesteenweg 365,2019-02-10,05:00:00,0,0,0,FMN GV 05 Lier
60,Mechelsesteenweg 365,2019-02-10,06:00:00,0,0,0,FMN GV 05 Lier
60,Mechelsesteenweg 365,2019-02-10,07:00:00,2,0,2,FMN GV 05 Lier
60,Mechelsesteenweg 365,2019-02-10,08:00:00,2,2,0,FMN GV 05 Lier
60,Mechelsesteenweg 365,2019-02-10,09:00:00,24,12,12,FMN GV 05 Lier
60,Mechelsesteenweg 365,2019-02-10,10:00:00,38,10,28,FMN GV 05 Lier
60,Mechelsesteenweg 365,2019-02-10,11:00:00,40,14,26,FMN GV 05 Lier
60,Mechelsesteenweg 365,2019-02-10,12:00:00,14,8,6,FMN GV 05 Lier
60,Mechelsesteenweg 365,2019-02-10,13:00:00,18,10,8,FMN GV 05 Lier
60,Mechelsesteenweg 365,2019-02-10,14:00:00,6,2,4,FMN GV 05 Lier
60,Mechelsesteenweg 365,2019-02-10,15:00:00,10,6,4,FMN GV 05 Lier
60,Mechelsesteenweg 365,2019-02-10,16:00:00,18,8,10,FMN GV 05 Lier
60,Mechelsesteenweg 365,2019-02-10,17:00:00,12,6,6,FMN GV 05 Lier
60,Mechelsesteenweg 365,2019-02-10,18:00:00,8,2,6,FMN GV 05 Lier
60,Mechelsesteenweg 365,2019-02-10,19:00:00,0,0,0,FMN GV 05 Lier
60,Mechelsesteenweg 365,2019-02-10,20:00:00,2,2,0,FMN GV 05 Lier
60,Mechelsesteenweg 365,2019-02-10,21:00:00,0,0,0,FMN GV 05 Lier
60,Mechelsesteenweg 365,2019-02-10,22:00:00,2,0,2,FMN GV 05 Lier
60,Mechelsesteenweg 365,2019-02-10,23:00:00,0,0,0,FMN GV 05 Lier
60,Mechelsesteenweg 365,2019-02-11,00:00:00,0,0,0,FMN GV 05 Lier
60,Mechelsesteenweg 365,2019-02-11,01:00:00,0,0,0,FMN GV 05 Lier
60,Mechelsesteenweg 365,2019-02-11,02:00:00,0,0,0,FMN GV 05 Lier
60,Mechelsesteenweg 365,2019-02-11,03:00:00,0,0,0,FMN GV 05 Lier
60,Mechelsesteenweg 365,2019-02-11,04:00:00,2,0,2,FMN GV 05 Lier
60,Mechelsesteenweg 365,2019-02-11,05:00:00,4,2,2,FMN GV 05 Lier
60,Mechelsesteenweg 365,2019-02-11,06:00:00,12,0,12,FMN GV 05 Lier
60,Mechelsesteenweg 365,2019-02-11,07:00:00,78,40,38,FMN GV 05 Lier
60,Mechelsesteenweg 365,2019-02-11,08:00:00,100,64,36,FMN GV 05 Lier
60,Mechelsesteenweg 365,2019-02-11,09:00:00,52,28,24,FMN GV 05 Lier
60,Mechelsesteenweg 365,2019-02-11,10:00:00,42,24,18,FMN GV 05 Lier
60,Mechelsesteenweg 365,2019-02-11,11:00:00,44,28,16,FMN GV 05 Lier
60,Mechelsesteenweg 365,2019-02-11,12:00:00,44,22,22,FMN GV 05 Lier
60,Mechelsesteenweg 365,2019-02-11,13:00:00,82,36,46,FMN GV 05 Lier
60,Mechelsesteenweg 365,2019-02-11,14:00:00,54,30,24,FMN GV 05 Lier
60,Mechelsesteenweg 365,2019-02-11,15:00:00,62,28,34,FMN GV 05 Lier
60,Mechelsesteenweg 365,2019-02-11,16:00:00,110,24,86,FMN GV 05 Lier
60,Mechelsesteenweg 365,2019-02-11,17:00:00,92,62,30,FMN GV 05 Lier
60,Mechelsesteenweg 365,2019-02-11,18:00:00,22,20,2,FMN GV 05 Lier
60,Mechelsesteenweg 365,2019-02-11,19:00:00,14,6,8,FMN GV 05 Lier
60,Mechelsesteenweg 365,2019-02-11,20:00:00,2,0,2,FMN GV 05 Lier
60,Mechelsesteenweg 365,2019-02-11,21:00:00,8,4,4,FMN GV 05 Lier
60,Mechelsesteenweg 365,2019-02-11,22:00:00,4,2,2,FMN GV 05 Lier
60,Mechelsesteenweg 365,2019-02-11,23:00:00,0,0,0,FMN GV 05 Lier
60,Mechelsesteenweg 365,2019-02-12,00:00:00,0,0,0,FMN GV 05 Lier
60,Mechelsesteenweg 365,2019-02-12,01:00:00,0,0,0,FMN GV 05 Lier
60,Mechelsesteenweg 365,2019-02-12,02:00:00,0,0,0,FMN GV 05 Lier
60,Mechelsesteenweg 365,2019-02-12,03:00:00,0,0,0,FMN GV 05 Lier
60,Mechelsesteenweg 365,2019-02-12,04:00:00,0,0,0,FMN GV 05 Lier
60,Mechelsesteenweg 365,2019-02-12,05:00:00,8,2,6,FMN GV 05 Lier
60,Mechelsesteenweg 365,2019-02-12,06:00:00,16,6,10,FMN GV 05 Lier
60,Mechelsesteenweg 365,2019-02-12,07:00:00,112,68,44,FMN GV 05 Lier
60,Mechelsesteenweg 365,2019-02-12,08:00:00,118,74,44,FMN GV 05 Lier
60,Mechelsesteenweg 365,2019-02-12,09:00:00,34,24,10,FMN GV 05 Lier
60,Mechelsesteenweg 365,2019-02-12,10:00:00,54,24,30,FMN GV 05 Lier
60,Mechelsesteenweg 365,2019-02-12,11:00:00,46,30,16,FMN GV 05 Lier
60,Mechelsesteenweg 365,2019-02-12,12:00:00,66,20,46,FMN GV 05 Lier
60,Mechelsesteenweg 365,2019-02-12,13:00:00,118,36,82,FMN GV 05 Lier
60,Mechelsesteenweg 365,2019-02-12,14:00:00,88,60,28,FMN GV 05 Lier
60,Mechelsesteenweg 365,2019-02-12,15:00:00,124,82,42,FMN GV 05 Lier
60,Mechelsesteenweg 365,2019-02-12,16:00:00,176,54,122,FMN GV 05 Lier
60,Mechelsesteenweg 365,2019-02-12,17:00:00,132,68,64,FMN GV 05 Lier
60,Mechelsesteenweg 365,2019-02-12,18:00:00,32,18,14,FMN GV 05 Lier
60,Mechelsesteenweg 365,2019-02-12,19:00:00,20,8,12,FMN GV 05 Lier
60,Mechelsesteenweg 365,2019-02-12,20:00:00,8,4,4,FMN GV 05 Lier
60,Mechelsesteenweg 365,2019-02-12,21:00:00,12,2,10,FMN GV 05 Lier
60,Mechelsesteenweg 365,2019-02-12,22:00:00,0,0,0,FMN GV 05 Lier
60,Mechelsesteenweg 365,2019-02-12,23:00:00,2,2,0,FMN GV 05 Lier
60,Mechelsesteenweg 365,2019-02-13,00:00:00,0,0,0,FMN GV 05 Lier
60,Mechelsesteenweg 365,2019-02-13,01:00:00,0,0,0,FMN GV 05 Lier
60,Mechelsesteenweg 365,2019-02-13,02:00:00,0,0,0,FMN GV 05 Lier
60,Mechelsesteenweg 365,2019-02-13,03:00:00,2,0,2,FMN GV 05 Lier
60,Mechelsesteenweg 365,2019-02-13,04:00:00,0,0,0,FMN GV 05 Lier
60,Mechelsesteenweg 365,2019-02-13,05:00:00,8,0,8,FMN GV 05 Lier
60,Mechelsesteenweg 365,2019-02-13,06:00:00,12,8,4,FMN GV 05 Lier
60,Mechelsesteenweg 365,2019-02-13,07:00:00,130,66,64,FMN GV 05 Lier
60,Mechelsesteenweg 365,2019-02-13,08:00:00,112,68,44,FMN GV 05 Lier
60,Mechelsesteenweg 365,2019-02-13,09:00:00,36,26,10,FMN GV 05 Lier
60,Mechelsesteenweg 365,2019-02-13,10:00:00,38,26,12,FMN GV 05 Lier
60,Mechelsesteenweg 365,2019-02-13,11:00:00,42,20,22,FMN GV 05 Lier
60,Mechelsesteenweg 365,2019-02-13,12:00:00,164,50,114,FMN GV 05 Lier
60,Mechelsesteenweg 365,2019-02-13,13:00:00,128,76,52,FMN GV 05 Lier
60,Mechelsesteenweg 365,2019-02-13,14:00:00,178,104,74,FMN GV 05 Lier
60,Mechelsesteenweg 365,2019-02-13,15:00:00,192,94,98,FMN GV 05 Lier
60,Mechelsesteenweg 365,2019-02-13,16:00:00,118,54,64,FMN GV 05 Lier
60,Mechelsesteenweg 365,2019-02-13,17:00:00,98,54,44,FMN GV 05 Lier
60,Mechelsesteenweg 365,2019-02-13,18:00:00,62,34,28,FMN GV 05 Lier
60,Mechelsesteenweg 365,2019-02-13,19:00:00,20,16,4,FMN GV 05 Lier
60,Mechelsesteenweg 365,2019-02-13,20:00:00,10,2,8,FMN GV 05 Lier
60,Mechelsesteenweg 365,2019-02-13,21:00:00,10,6,4,FMN GV 05 Lier
60,Mechelsesteenweg 365,2019-02-13,22:00:00,0,0,0,FMN GV 05 Lier
60,Mechelsesteenweg 365,2019-02-13,23:00:00,2,0,2,FMN GV 05 Lier
60,Mechelsesteenweg 365,2019-02-14,00:00:00,2,0,2,FMN GV 05 Lier
60,Mechelsesteenweg 365,2019-02-14,01:00:00,0,0,0,FMN GV 05 Lier
60,Mechelsesteenweg 365,2019-02-14,02:00:00,0,0,0,FMN GV 05 Lier
60,Mechelsesteenweg 365,2019-02-14,03:00:00,0,0,0,FMN GV 05 Lier
60,Mechelsesteenweg 365,2019-02-14,04:00:00,2,0,2,FMN GV 05 Lier
60,Mechelsesteenweg 365,2019-02-14,05:00:00,8,0,8,FMN GV 05 Lier
60,Mechelsesteenweg 365,2019-02-14,06:00:00,16,6,10,FMN GV 05 Lier
60,Mechelsesteenweg 365,2019-02-14,07:00:00,120,68,52,FMN GV 05 Lier
60,Mechelsesteenweg 365,2019-02-14,08:00:00,108,68,40,FMN GV 05 Lier
60,Mechelsesteenweg 365,2019-02-14,09:00:00,48,20,28,FMN GV 05 Lier
60,Mechelsesteenweg 365,2019-02-14,10:00:00,28,20,8,FMN GV 05 Lier
60,Mechelsesteenweg 365,2019-02-14,11:00:00,60,22,38,FMN GV 05 Lier
60,Mechelsesteenweg 365,2019-02-14,12:00:00,98,50,48,FMN GV 05 Lier
60,Mechelsesteenweg 365,2019-02-14,13:00:00,148,88,60,FMN GV 05 Lier
60,Mechelsesteenweg 365,2019-02-14,14:00:00,298,170,128,FMN GV 05 Lier
60,Mechelsesteenweg 365,2019-02-14,15:00:00,232,120,112,FMN GV 05 Lier
60,Mechelsesteenweg 365,2019-02-14,16:00:00,260,102,158,FMN GV 05 Lier
60,Mechelsesteenweg 365,2019-02-14,17:00:00,114,58,56,FMN GV 05 Lier
60,Mechelsesteenweg 365,2019-02-14,18:00:00,40,24,16,FMN GV 05 Lier
60,Mechelsesteenweg 365,2019-02-14,19:00:00,30,20,10,FMN GV 05 Lier
60,Mechelsesteenweg 365,2019-02-14,20:00:00,8,2,6,FMN GV 05 Lier
60,Mechelsesteenweg 365,2019-02-14,21:00:00,0,0,0,FMN GV 05 Lier
60,Mechelsesteenweg 365,2019-02-14,22:00:00,0,0,0,FMN GV 05 Lier
60,Mechelsesteenweg 365,2019-02-14,23:00:00,0,0,0,FMN GV 05 Lier
60,Mechelsesteenweg 365,2019-02-15,00:00:00,0,0,0,FMN GV 05 Lier
60,Mechelsesteenweg 365,2019-02-15,01:00:00,0,0,0,FMN GV 05 Lier
60,Mechelsesteenweg 365,2019-02-15,02:00:00,0,0,0,FMN GV 05 Lier
60,Mechelsesteenweg 365,2019-02-15,03:00:00,2,2,0,FMN GV 05 Lier
60,Mechelsesteenweg 365,2019-02-15,04:00:00,2,0,2,FMN GV 05 Lier
60,Mechelsesteenweg 365,2019-02-15,05:00:00,8,0,8,FMN GV 05 Lier
60,Mechelsesteenweg 365,2019-02-15,06:00:00,14,0,14,FMN GV 05 Lier
60,Mechelsesteenweg 365,2019-02-15,07:00:00,112,60,52,FMN GV 05 Lier
60,Mechelsesteenweg 365,2019-02-15,08:00:00,154,96,58,FMN GV 05 Lier
60,Mechelsesteenweg 365,2019-02-15,09:00:00,30,14,16,FMN GV 05 Lier
60,Mechelsesteenweg 365,2019-02-15,10:00:00,62,44,18,FMN GV 05 Lier
60,Mechelsesteenweg 365,2019-02-15,11:00:00,94,46,48,FMN GV 05 Lier
60,Mechelsesteenweg 365,2019-02-15,12:00:00,140,66,74,FMN GV 05 Lier
60,Mechelsesteenweg 365,2019-02-15,13:00:00,184,100,84,FMN GV 05 Lier
60,Mechelsesteenweg 365,2019-02-15,14:00:00,326,168,158,FMN GV 05 Lier
60,Mechelsesteenweg 365,2019-02-15,15:00:00,348,132,216,FMN GV 05 Lier
60,Mechelsesteenweg 365,2019-02-15,16:00:00,304,120,184,FMN GV 05 Lier
60,Mechelsesteenweg 365,2019-02-15,17:00:00,88,48,40,FMN GV 05 Lier
60,Mechelsesteenweg 365,2019-02-15,18:00:00,52,40,12,FMN GV 05 Lier
60,Mechelsesteenweg 365,2019-02-15,19:00:00,0,0,0,FMN GV 05 Lier
60,Mechelsesteenweg 365,2019-02-15,20:00:00,6,2,4,FMN GV 05 Lier
60,Mechelsesteenweg 365,2019-02-15,21:00:00,18,4,14,FMN GV 05 Lier
60,Mechelsesteenweg 365,2019-02-15,22:00:00,24,8,16,FMN GV 05 Lier
60,Mechelsesteenweg 365,2019-02-15,23:00:00,0,0,0,FMN GV 05 Lier
60,Mechelsesteenweg 365,2019-02-16,00:00:00,0,0,0,FMN GV 05 Lier
60,Mechelsesteenweg 365,2019-02-16,01:00:00,0,0,0,FMN GV 05 Lier
60,Mechelsesteenweg 365,2019-02-16,02:00:00,8,8,0,FMN GV 05 Lier
60,Mechelsesteenweg 365,2019-02-16,03:00:00,0,0,0,FMN GV 05 Lier
60,Mechelsesteenweg 365,2019-02-16,04:00:00,0,0,0,FMN GV 05 Lier
60,Mechelsesteenweg 365,2019-02-16,05:00:00,2,0,2,FMN GV 05 Lier
60,Mechelsesteenweg 365,2019-02-16,06:00:00,2,0,2,FMN GV 05 Lier
60,Mechelsesteenweg 365,2019-02-16,07:00:00,4,0,4,FMN GV 05 Lier
60,Mechelsesteenweg 365,2019-02-16,08:00:00,22,12,10,FMN GV 05 Lier
60,Mechelsesteenweg 365,2019-02-16,09:00:00,44,24,20,FMN GV 05 Lier
60,Mechelsesteenweg 365,2019-02-16,10:00:00,140,72,68,FMN GV 05 Lier
60,Mechelsesteenweg 365,2019-02-16,11:00:00,152,74,78,FMN GV 05 Lier
60,Mechelsesteenweg 365,2019-02-16,12:00:00,198,94,104,FMN GV 05 Lier
60,Mechelsesteenweg 365,2019-02-16,13:00:00,306,166,140,FMN GV 05 Lier
60,Mechelsesteenweg 365,2019-02-16,14:00:00,472,258,214,FMN GV 05 Lier
60,Mechelsesteenweg 365,2019-02-16,15:00:00,330,180,150,FMN GV 05 Lier
60,Mechelsesteenweg 365,2019-02-16,16:00:00,302,112,190,FMN GV 05 Lier
60,Mechelsesteenweg 365,2019-02-16,17:00:00,64,30,34,FMN GV 05 Lier
60,Mechelsesteenweg 365,2019-02-16,18:00:00,20,6,14,FMN GV 05 Lier
60,Mechelsesteenweg 365,2019-02-16,19:00:00,2,0,2,FMN GV 05 Lier
60,Mechelsesteenweg 365,2019-02-16,20:00:00,0,0,0,FMN GV 05 Lier
60,Mechelsesteenweg 365,2019-02-16,21:00:00,0,0,0,FMN GV 05 Lier
60,Mechelsesteenweg 365,2019-02-16,22:00:00,2,0,2,FMN GV 05 Lier
60,Mechelsesteenweg 365,2019-02-16,23:00:00,4,0,4,FMN GV 05 Lier
60,Mechelsesteenweg 365,2019-02-17,00:00:00,0,0,0,FMN GV 05 Lier
60,Mechelsesteenweg 365,2019-02-17,01:00:00,0,0,0,FMN GV 05 Lier
60,Mechelsesteenweg 365,2019-02-17,02:00:00,0,0,0,FMN GV 05 Lier
60,Mechelsesteenweg 365,2019-02-17,03:00:00,0,0,0,FMN GV 05 Lier
60,Mechelsesteenweg 365,2019-02-17,04:00:00,0,0,0,FMN GV 05 Lier
60,Mechelsesteenweg 365,2019-02-17,05:00:00,0,0,0,FMN GV 05 Lier
60,Mechelsesteenweg 365,2019-02-17,06:00:00,2,0,2,FMN GV 05 Lier
60,Mechelsesteenweg 365,2019-02-17,07:00:00,2,0,2,FMN GV 05 Lier
60,Mechelsesteenweg 365,2019-02-17,08:00:00,16,10,6,FMN GV 05 Lier
60,Mechelsesteenweg 365,2019-02-17,09:00:00,146,80,66,FMN GV 05 Lier
60,Mechelsesteenweg 365,2019-02-17,10:00:00,276,168,108,FMN GV 05 Lier
60,Mechelsesteenweg 365,2019-02-17,11:00:00,434,176,258,FMN GV 05 Lier
60,Mechelsesteenweg 365,2019-02-17,12:00:00,378,202,176,FMN GV 05 Lier
60,Mechelsesteenweg 365,2019-02-17,13:00:00,538,258,280,FMN GV 05 Lier
60,Mechelsesteenweg 365,2019-02-17,14:00:00,650,338,312,FMN GV 05 Lier
60,Mechelsesteenweg 365,2019-02-17,15:00:00,432,174,258,FMN GV 05 Lier
60,Mechelsesteenweg 365,2019-02-17,16:00:00,288,84,204,FMN GV 05 Lier
60,Mechelsesteenweg 365,2019-02-17,17:00:00,164,60,104,FMN GV 05 Lier
60,Mechelsesteenweg 365,2019-02-17,18:00:00,22,6,16,FMN GV 05 Lier
60,Mechelsesteenweg 365,2019-02-17,19:00:00,0,0,0,FMN GV 05 Lier
60,Mechelsesteenweg 365,2019-02-17,20:00:00,0,0,0,FMN GV 05 Lier
60,Mechelsesteenweg 365,2019-02-17,21:00:00,0,0,0,FMN GV 05 Lier
60,Mechelsesteenweg 365,2019-02-17,22:00:00,4,0,4,FMN GV 05 Lier
60,Mechelsesteenweg 365,2019-02-17,23:00:00,2,2,0,FMN GV 05 Lier
60,Mechelsesteenweg 365,2019-02-18,00:00:00,2,0,2,FMN GV 05 Lier
60,Mechelsesteenweg 365,2019-02-18,01:00:00,0,0,0,FMN GV 05 Lier
60,Mechelsesteenweg 365,2019-02-18,02:00:00,0,0,0,FMN GV 05 Lier
60,Mechelsesteenweg 365,2019-02-18,03:00:00,0,0,0,FMN GV 05 Lier
60,Mechelsesteenweg 365,2019-02-18,04:00:00,6,0,6,FMN GV 05 Lier
60,Mechelsesteenweg 365,2019-02-18,05:00:00,4,0,4,FMN GV 05 Lier
60,Mechelsesteenweg 365,2019-02-18,06:00:00,14,8,6,FMN GV 05 Lier
60,Mechelsesteenweg 365,2019-02-18,07:00:00,138,76,62,FMN GV 05 Lier
60,Mechelsesteenweg 365,2019-02-18,08:00:00,130,86,44,FMN GV 05 Lier
60,Mechelsesteenweg 365,2019-02-18,09:00:00,76,46,30,FMN GV 05 Lier
60,Mechelsesteenweg 365,2019-02-18,10:00:00,62,34,28,FMN GV 05 Lier
60,Mechelsesteenweg 365,2019-02-18,11:00:00,76,30,46,FMN GV 05 Lier
60,Mechelsesteenweg 365,2019-02-18,12:00:00,92,42,50,FMN GV 05 Lier
60,Mechelsesteenweg 365,2019-02-18,13:00:00,194,98,96,FMN GV 05 Lier
60,Mechelsesteenweg 365,2019-02-18,14:00:00,298,192,106,FMN GV 05 Lier
60,Mechelsesteenweg 365,2019-02-18,15:00:00,248,104,144,FMN GV 05 Lier
60,Mechelsesteenweg 365,2019-02-18,16:00:00,254,84,170,FMN GV 05 Lier
60,Mechelsesteenweg 365,2019-02-18,17:00:00,148,82,66,FMN GV 05 Lier
60,Mechelsesteenweg 365,2019-02-18,18:00:00,52,28,24,FMN GV 05 Lier
60,Mechelsesteenweg 365,2019-02-18,19:00:00,24,14,10,FMN GV 05 Lier
60,Mechelsesteenweg 365,2019-02-18,20:00:00,10,0,10,FMN GV 05 Lier
60,Mechelsesteenweg 365,2019-02-18,21:00:00,10,6,4,FMN GV 05 Lier
60,Mechelsesteenweg 365,2019-02-18,22:00:00,8,6,2,FMN GV 05 Lier
60,Mechelsesteenweg 365,2019-02-18,23:00:00,2,2,0,FMN GV 05 Lier
60,Mechelsesteenweg 365,2019-02-19,00:00:00,0,0,0,FMN GV 05 Lier
60,Mechelsesteenweg 365,2019-02-19,01:00:00,0,0,0,FMN GV 05 Lier
60,Mechelsesteenweg 365,2019-02-19,02:00:00,0,0,0,FMN GV 05 Lier
60,Mechelsesteenweg 365,2019-02-19,03:00:00,0,0,0,FMN GV 05 Lier
60,Mechelsesteenweg 365,2019-02-19,04:00:00,6,0,6,FMN GV 05 Lier
60,Mechelsesteenweg 365,2019-02-19,05:00:00,2,0,2,FMN GV 05 Lier
60,Mechelsesteenweg 365,2019-02-19,06:00:00,24,14,10,FMN GV 05 Lier
60,Mechelsesteenweg 365,2019-02-19,07:00:00,180,104,76,FMN GV 05 Lier
60,Mechelsesteenweg 365,2019-02-19,08:00:00,138,80,58,FMN GV 05 Lier
60,Mechelsesteenweg 365,2019-02-19,09:00:00,48,16,32,FMN GV 05 Lier
60,Mechelsesteenweg 365,2019-02-19,10:00:00,44,22,22,FMN GV 05 Lier
60,Mechelsesteenweg 365,2019-02-19,11:00:00,88,58,30,FMN GV 05 Lier
60,Mechelsesteenweg 365,2019-02-19,12:00:00,84,36,48,FMN GV 05 Lier
60,Mechelsesteenweg 365,2019-02-19,13:00:00,100,52,48,FMN GV 05 Lier
60,Mechelsesteenweg 365,2019-02-19,14:00:00,86,54,32,FMN GV 05 Lier
60,Mechelsesteenweg 365,2019-02-19,15:00:00,130,52,78,FMN GV 05 Lier
60,Mechelsesteenweg 365,2019-02-19,16:00:00,178,74,104,FMN GV 05 Lier
60,Mechelsesteenweg 365,2019-02-19,17:00:00,118,72,46,FMN GV 05 Lier
60,Mechelsesteenweg 365,2019-02-19,18:00:00,48,28,20,FMN GV 05 Lier
60,Mechelsesteenweg 365,2019-02-19,19:00:00,22,16,6,FMN GV 05 Lier
60,Mechelsesteenweg 365,2019-02-19,20:00:00,6,2,4,FMN GV 05 Lier
60,Mechelsesteenweg 365,2019-02-19,21:00:00,4,0,4,FMN GV 05 Lier
60,Mechelsesteenweg 365,2019-02-19,22:00:00,4,2,2,FMN GV 05 Lier
60,Mechelsesteenweg 365,2019-02-19,23:00:00,8,8,0,FMN GV 05 Lier
60,Mechelsesteenweg 365,2019-02-20,00:00:00,0,0,0,FMN GV 05 Lier
60,Mechelsesteenweg 365,2019-02-20,01:00:00,0,0,0,FMN GV 05 Lier
60,Mechelsesteenweg 365,2019-02-20,02:00:00,0,0,0,FMN GV 05 Lier
60,Mechelsesteenweg 365,2019-02-20,03:00:00,2,0,2,FMN GV 05 Lier
60,Mechelsesteenweg 365,2019-02-20,04:00:00,4,0,4,FMN GV 05 Lier
60,Mechelsesteenweg 365,2019-02-20,05:00:00,4,2,2,FMN GV 05 Lier
60,Mechelsesteenweg 365,2019-02-20,06:00:00,18,10,8,FMN GV 05 Lier
60,Mechelsesteenweg 365,2019-02-20,07:00:00,152,90,62,FMN GV 05 Lier
60,Mechelsesteenweg 365,2019-02-20,08:00:00,144,86,58,FMN GV 05 Lier
60,Mechelsesteenweg 365,2019-02-20,09:00:00,50,34,16,FMN GV 05 Lier
60,Mechelsesteenweg 365,2019-02-20,10:00:00,54,28,26,FMN GV 05 Lier
60,Mechelsesteenweg 365,2019-02-20,11:00:00,82,38,44,FMN GV 05 Lier
60,Mechelsesteenweg 365,2019-02-20,12:00:00,164,38,126,FMN GV 05 Lier
60,Mechelsesteenweg 365,2019-02-20,13:00:00,138,92,46,FMN GV 05 Lier
60,Mechelsesteenweg 365,2019-02-20,14:00:00,166,86,80,FMN GV 05 Lier
60,Mechelsesteenweg 365,2019-02-20,15:00:00,206,110,96,FMN GV 05 Lier
60,Mechelsesteenweg 365,2019-02-20,16:00:00,174,94,80,FMN GV 05 Lier
60,Mechelsesteenweg 365,2019-02-20,17:00:00,142,90,52,FMN GV 05 Lier
60,Mechelsesteenweg 365,2019-02-20,18:00:00,56,30,26,FMN GV 05 Lier
60,Mechelsesteenweg 365,2019-02-20,19:00:00,18,14,4,FMN GV 05 Lier
60,Mechelsesteenweg 365,2019-02-20,20:00:00,18,6,12,FMN GV 05 Lier
60,Mechelsesteenweg 365,2019-02-20,21:00:00,16,4,12,FMN GV 05 Lier
60,Mechelsesteenweg 365,2019-02-20,22:00:00,8,2,6,FMN GV 05 Lier
60,Mechelsesteenweg 365,2019-02-20,23:00:00,2,2,0,FMN GV 05 Lier
60,Mechelsesteenweg 365,2019-02-21,00:00:00,2,0,2,FMN GV 05 Lier
60,Mechelsesteenweg 365,2019-02-21,01:00:00,0,0,0,FMN GV 05 Lier
60,Mechelsesteenweg 365,2019-02-21,02:00:00,0,0,0,FMN GV 05 Lier
60,Mechelsesteenweg 365,2019-02-21,03:00:00,2,0,2,FMN GV 05 Lier
60,Mechelsesteenweg 365,2019-02-21,04:00:00,4,2,2,FMN GV 05 Lier
60,Mechelsesteenweg 365,2019-02-21,05:00:00,10,0,10,FMN GV 05 Lier
60,Mechelsesteenweg 365,2019-02-21,06:00:00,16,4,12,FMN GV 05 Lier
60,Mechelsesteenweg 365,2019-02-21,07:00:00,146,78,68,FMN GV 05 Lier
60,Mechelsesteenweg 365,2019-02-21,08:00:00,130,76,54,FMN GV 05 Lier
60,Mechelsesteenweg 365,2019-02-21,09:00:00,34,20,14,FMN GV 05 Lier
60,Mechelsesteenweg 365,2019-02-21,10:00:00,64,28,36,FMN GV 05 Lier
60,Mechelsesteenweg 365,2019-02-21,11:00:00,66,36,30,FMN GV 05 Lier
60,Mechelsesteenweg 365,2019-02-21,12:00:00,78,46,32,FMN GV 05 Lier
60,Mechelsesteenweg 365,2019-02-21,13:00:00,120,70,50,FMN GV 05 Lier
60,Mechelsesteenweg 365,2019-02-21,14:00:00,150,52,98,FMN GV 05 Lier
60,Mechelsesteenweg 365,2019-02-21,15:00:00,160,84,76,FMN GV 05 Lier
60,Mechelsesteenweg 365,2019-02-21,16:00:00,200,72,128,FMN GV 05 Lier
60,Mechelsesteenweg 365,2019-02-21,17:00:00,128,74,54,FMN GV 05 Lier
60,Mechelsesteenweg 365,2019-02-21,18:00:00,64,42,22,FMN GV 05 Lier
60,Mechelsesteenweg 365,2019-02-21,19:00:00,36,24,12,FMN GV 05 Lier
60,Mechelsesteenweg 365,2019-02-21,20:00:00,12,8,4,FMN GV 05 Lier
60,Mechelsesteenweg 365,2019-02-21,21:00:00,12,4,8,FMN GV 05 Lier
60,Mechelsesteenweg 365,2019-02-21,22:00:00,12,8,4,FMN GV 05 Lier
60,Mechelsesteenweg 365,2019-02-21,23:00:00,0,0,0,FMN GV 05 Lier
60,Mechelsesteenweg 365,2019-02-22,00:00:00,0,0,0,FMN GV 05 Lier
60,Mechelsesteenweg 365,2019-02-22,01:00:00,0,0,0,FMN GV 05 Lier
60,Mechelsesteenweg 365,2019-02-22,02:00:00,0,0,0,FMN GV 05 Lier
60,Mechelsesteenweg 365,2019-02-22,03:00:00,2,0,2,FMN GV 05 Lier
60,Mechelsesteenweg 365,2019-02-22,04:00:00,2,0,2,FMN GV 05 Lier
60,Mechelsesteenweg 365,2019-02-22,05:00:00,6,0,6,FMN GV 05 Lier
60,Mechelsesteenweg 365,2019-02-22,06:00:00,16,2,14,FMN GV 05 Lier
60,Mechelsesteenweg 365,2019-02-22,07:00:00,140,96,44,FMN GV 05 Lier
60,Mechelsesteenweg 365,2019-02-22,08:00:00,134,82,52,FMN GV 05 Lier
60,Mechelsesteenweg 365,2019-02-22,09:00:00,48,24,24,FMN GV 05 Lier
60,Mechelsesteenweg 365,2019-02-22,10:00:00,52,44,8,FMN GV 05 Lier
60,Mechelsesteenweg 365,2019-02-22,11:00:00,52,14,38,FMN GV 05 Lier
60,Mechelsesteenweg 365,2019-02-22,12:00:00,92,50,42,FMN GV 05 Lier
60,Mechelsesteenweg 365,2019-02-22,13:00:00,98,52,46,FMN GV 05 Lier
60,Mechelsesteenweg 365,2019-02-22,14:00:00,260,132,128,FMN GV 05 Lier
60,Mechelsesteenweg 365,2019-02-22,15:00:00,220,122,98,FMN GV 05 Lier
60,Mechelsesteenweg 365,2019-02-22,16:00:00,196,58,138,FMN GV 05 Lier
60,Mechelsesteenweg 365,2019-02-22,17:00:00,110,58,52,FMN GV 05 Lier
60,Mechelsesteenweg 365,2019-02-22,18:00:00,16,14,2,FMN GV 05 Lier
60,Mechelsesteenweg 365,2019-02-22,19:00:00,14,6,8,FMN GV 05 Lier
60,Mechelsesteenweg 365,2019-02-22,20:00:00,10,6,4,FMN GV 05 Lier
60,Mechelsesteenweg 365,2019-02-22,21:00:00,20,6,14,FMN GV 05 Lier
60,Mechelsesteenweg 365,2019-02-22,22:00:00,4,2,2,FMN GV 05 Lier
60,Mechelsesteenweg 365,2019-02-22,23:00:00,10,2,8,FMN GV 05 Lier
60,Mechelsesteenweg 365,2019-02-23,00:00:00,0,0,0,FMN GV 05 Lier
60,Mechelsesteenweg 365,2019-02-23,01:00:00,0,0,0,FMN GV 05 Lier
60,Mechelsesteenweg 365,2019-02-23,02:00:00,0,0,0,FMN GV 05 Lier
60,Mechelsesteenweg 365,2019-02-23,03:00:00,0,0,0,FMN GV 05 Lier
60,Mechelsesteenweg 365,2019-02-23,04:00:00,0,0,0,FMN GV 05 Lier
60,Mechelsesteenweg 365,2019-02-23,05:00:00,0,0,0,FMN GV 05 Lier
60,Mechelsesteenweg 365,2019-02-23,06:00:00,6,0,6,FMN GV 05 Lier
60,Mechelsesteenweg 365,2019-02-23,07:00:00,10,8,2,FMN GV 05 Lier
60,Mechelsesteenweg 365,2019-02-23,08:00:00,32,24,8,FMN GV 05 Lier
60,Mechelsesteenweg 365,2019-02-23,09:00:00,76,56,20,FMN GV 05 Lier
60,Mechelsesteenweg 365,2019-02-23,10:00:00,180,96,84,FMN GV 05 Lier
60,Mechelsesteenweg 365,2019-02-23,11:00:00,240,98,142,FMN GV 05 Lier
60,Mechelsesteenweg 365,2019-02-23,12:00:00,224,104,120,FMN GV 05 Lier
60,Mechelsesteenweg 365,2019-02-23,13:00:00,282,138,144,FMN GV 05 Lier
60,Mechelsesteenweg 365,2019-02-23,14:00:00,376,204,172,FMN GV 05 Lier
60,Mechelsesteenweg 365,2019-02-23,15:00:00,402,176,226,FMN GV 05 Lier
60,Mechelsesteenweg 365,2019-02-23,16:00:00,264,82,182,FMN GV 05 Lier
60,Mechelsesteenweg 365,2019-02-23,17:00:00,134,50,84,FMN GV 05 Lier
60,Mechelsesteenweg 365,2019-02-23,18:00:00,22,8,14,FMN GV 05 Lier
60,Mechelsesteenweg 365,2019-02-23,19:00:00,4,4,0,FMN GV 05 Lier
60,Mechelsesteenweg 365,2019-02-23,20:00:00,2,0,2,FMN GV 05 Lier
60,Mechelsesteenweg 365,2019-02-23,21:00:00,14,2,12,FMN GV 05 Lier
60,Mechelsesteenweg 365,2019-02-23,22:00:00,6,4,2,FMN GV 05 Lier
60,Mechelsesteenweg 365,2019-02-23,23:00:00,0,0,0,FMN GV 05 Lier
60,Mechelsesteenweg 365,2019-02-24,00:00:00,14,12,2,FMN GV 05 Lier
60,Mechelsesteenweg 365,2019-02-24,01:00:00,0,0,0,FMN GV 05 Lier
60,Mechelsesteenweg 365,2019-02-24,02:00:00,0,0,0,FMN GV 05 Lier
60,Mechelsesteenweg 365,2019-02-24,03:00:00,0,0,0,FMN GV 05 Lier
60,Mechelsesteenweg 365,2019-02-24,04:00:00,10,0,10,FMN GV 05 Lier
60,Mechelsesteenweg 365,2019-02-24,05:00:00,0,0,0,FMN GV 05 Lier
60,Mechelsesteenweg 365,2019-02-24,06:00:00,0,0,0,FMN GV 05 Lier
60,Mechelsesteenweg 365,2019-02-24,07:00:00,8,4,4,FMN GV 05 Lier
60,Mechelsesteenweg 365,2019-02-24,08:00:00,36,22,14,FMN GV 05 Lier
60,Mechelsesteenweg 365,2019-02-24,09:00:00,170,112,58,FMN GV 05 Lier
60,Mechelsesteenweg 365,2019-02-24,10:00:00,300,152,148,FMN GV 05 Lier
60,Mechelsesteenweg 365,2019-02-24,11:00:00,470,244,226,FMN GV 05 Lier
60,Mechelsesteenweg 365,2019-02-24,12:00:00,360,180,180,FMN GV 05 Lier
60,Mechelsesteenweg 365,2019-02-24,13:00:00,464,214,250,FMN GV 05 Lier
60,Mechelsesteenweg 365,2019-02-24,14:00:00,562,294,268,FMN GV 05 Lier
60,Mechelsesteenweg 365,2019-02-24,15:00:00,564,274,290,FMN GV 05 Lier
60,Mechelsesteenweg 365,2019-02-24,16:00:00,322,90,232,FMN GV 05 Lier
60,Mechelsesteenweg 365,2019-02-24,17:00:00,194,68,126,FMN GV 05 Lier
60,Mechelsesteenweg 365,2019-02-24,18:00:00,42,30,12,FMN GV 05 Lier
60,Mechelsesteenweg 365,2019-02-24,19:00:00,24,6,18,FMN GV 05 Lier
60,Mechelsesteenweg 365,2019-02-24,20:00:00,0,0,0,FMN GV 05 Lier
60,Mechelsesteenweg 365,2019-02-24,21:00:00,2,0,2,FMN GV 05 Lier
60,Mechelsesteenweg 365,2019-02-24,22:00:00,0,0,0,FMN GV 05 Lier
60,Mechelsesteenweg 365,2019-02-24,23:00:00,2,0,2,FMN GV 05 Lier
60,Mechelsesteenweg 365,2019-02-25,00:00:00,2,2,0,FMN GV 05 Lier
60,Mechelsesteenweg 365,2019-02-25,01:00:00,2,2,0,FMN GV 05 Lier
60,Mechelsesteenweg 365,2019-02-25,02:00:00,0,0,0,FMN GV 05 Lier
60,Mechelsesteenweg 365,2019-02-25,03:00:00,2,0,2,FMN GV 05 Lier
60,Mechelsesteenweg 365,2019-02-25,04:00:00,8,4,4,FMN GV 05 Lier
60,Mechelsesteenweg 365,2019-02-25,05:00:00,6,2,4,FMN GV 05 Lier
60,Mechelsesteenweg 365,2019-02-25,06:00:00,8,2,6,FMN GV 05 Lier
60,Mechelsesteenweg 365,2019-02-25,07:00:00,166,96,70,FMN GV 05 Lier
60,Mechelsesteenweg 365,2019-02-25,08:00:00,170,106,64,FMN GV 05 Lier
60,Mechelsesteenweg 365,2019-02-25,09:00:00,106,68,38,FMN GV 05 Lier
60,Mechelsesteenweg 365,2019-02-25,10:00:00,92,52,40,FMN GV 05 Lier
60,Mechelsesteenweg 365,2019-02-25,11:00:00,118,64,54,FMN GV 05 Lier
60,Mechelsesteenweg 365,2019-02-25,12:00:00,130,64,66,FMN GV 05 Lier
60,Mechelsesteenweg 365,2019-02-25,13:00:00,222,116,106,FMN GV 05 Lier
60,Mechelsesteenweg 365,2019-02-25,14:00:00,280,136,144,FMN GV 05 Lier
60,Mechelsesteenweg 365,2019-02-25,15:00:00,282,108,174,FMN GV 05 Lier
60,Mechelsesteenweg 365,2019-02-25,16:00:00,300,102,198,FMN GV 05 Lier
60,Mechelsesteenweg 365,2019-02-25,17:00:00,176,96,80,FMN GV 05 Lier
60,Mechelsesteenweg 365,2019-02-25,18:00:00,54,32,22,FMN GV 05 Lier
60,Mechelsesteenweg 365,2019-02-25,19:00:00,8,6,2,FMN GV 05 Lier
60,Mechelsesteenweg 365,2019-02-25,20:00:00,12,2,10,FMN GV 05 Lier
60,Mechelsesteenweg 365,2019-02-25,21:00:00,0,0,0,FMN GV 05 Lier
60,Mechelsesteenweg 365,2019-02-25,22:00:00,2,2,0,FMN GV 05 Lier
60,Mechelsesteenweg 365,2019-02-25,23:00:00,0,0,0,FMN GV 05 Lier
60,Mechelsesteenweg 365,2019-02-26,00:00:00,0,0,0,FMN GV 05 Lier
60,Mechelsesteenweg 365,2019-02-26,01:00:00,0,0,0,FMN GV 05 Lier
60,Mechelsesteenweg 365,2019-02-26,02:00:00,0,0,0,FMN GV 05 Lier
60,Mechelsesteenweg 365,2019-02-26,03:00:00,0,0,0,FMN GV 05 Lier
60,Mechelsesteenweg 365,2019-02-26,04:00:00,10,0,10,FMN GV 05 Lier
60,Mechelsesteenweg 365,2019-02-26,05:00:00,2,2,0,FMN GV 05 Lier
60,Mechelsesteenweg 365,2019-02-26,06:00:00,20,8,12,FMN GV 05 Lier
60,Mechelsesteenweg 365,2019-02-26,07:00:00,188,108,80,FMN GV 05 Lier
60,Mechelsesteenweg 365,2019-02-26,08:00:00,150,70,80,FMN GV 05 Lier
60,Mechelsesteenweg 365,2019-02-26,09:00:00,70,32,38,FMN GV 05 Lier
60,Mechelsesteenweg 365,2019-02-26,10:00:00,98,58,40,FMN GV 05 Lier
60,Mechelsesteenweg 365,2019-02-26,11:00:00,138,74,64,FMN GV 05 Lier
60,Mechelsesteenweg 365,2019-02-26,12:00:00,190,112,78,FMN GV 05 Lier
60,Mechelsesteenweg 365,2019-02-26,13:00:00,266,138,128,FMN GV 05 Lier
60,Mechelsesteenweg 365,2019-02-26,14:00:00,334,122,212,FMN GV 05 Lier
60,Mechelsesteenweg 365,2019-02-26,15:00:00,328,130,198,FMN GV 05 Lier
60,Mechelsesteenweg 365,2019-02-26,16:00:00,390,118,272,FMN GV 05 Lier
60,Mechelsesteenweg 365,2019-02-26,17:00:00,234,112,122,FMN GV 05 Lier
60,Mechelsesteenweg 365,2019-02-26,18:00:00,78,38,40,FMN GV 05 Lier
60,Mechelsesteenweg 365,2019-02-26,19:00:00,14,8,6,FMN GV 05 Lier
60,Mechelsesteenweg 365,2019-02-26,20:00:00,8,4,4,FMN GV 05 Lier
60,Mechelsesteenweg 365,2019-02-26,21:00:00,6,0,6,FMN GV 05 Lier
60,Mechelsesteenweg 365,2019-02-26,22:00:00,8,8,0,FMN GV 05 Lier
60,Mechelsesteenweg 365,2019-02-26,23:00:00,4,4,0,FMN GV 05 Lier
60,Mechelsesteenweg 365,2019-02-27,00:00:00,0,0,0,FMN GV 05 Lier
60,Mechelsesteenweg 365,2019-02-27,01:00:00,0,0,0,FMN GV 05 Lier
60,Mechelsesteenweg 365,2019-02-27,02:00:00,0,0,0,FMN GV 05 Lier
60,Mechelsesteenweg 365,2019-02-27,03:00:00,2,0,2,FMN GV 05 Lier
60,Mechelsesteenweg 365,2019-02-27,04:00:00,4,0,4,FMN GV 05 Lier
60,Mechelsesteenweg 365,2019-02-27,05:00:00,6,0,6,FMN GV 05 Lier
60,Mechelsesteenweg 365,2019-02-27,06:00:00,14,4,10,FMN GV 05 Lier
60,Mechelsesteenweg 365,2019-02-27,07:00:00,198,102,96,FMN GV 05 Lier
60,Mechelsesteenweg 365,2019-02-27,08:00:00,140,88,52,FMN GV 05 Lier
60,Mechelsesteenweg 365,2019-02-27,09:00:00,64,38,26,FMN GV 05 Lier
60,Mechelsesteenweg 365,2019-02-27,10:00:00,124,68,56,FMN GV 05 Lier
60,Mechelsesteenweg 365,2019-02-27,11:00:00,112,40,72,FMN GV 05 Lier
60,Mechelsesteenweg 365,2019-02-27,12:00:00,280,96,184,FMN GV 05 Lier
60,Mechelsesteenweg 365,2019-02-27,13:00:00,308,148,160,FMN GV 05 Lier
60,Mechelsesteenweg 365,2019-02-27,14:00:00,484,272,212,FMN GV 05 Lier
60,Mechelsesteenweg 365,2019-02-27,15:00:00,412,172,240,FMN GV 05 Lier
60,Mechelsesteenweg 365,2019-02-27,16:00:00,298,110,188,FMN GV 05 Lier
60,Mechelsesteenweg 365,2019-02-27,17:00:00,242,148,94,FMN GV 05 Lier
60,Mechelsesteenweg 365,2019-02-27,18:00:00,84,38,46,FMN GV 05 Lier
60,Mechelsesteenweg 365,2019-02-27,19:00:00,32,12,20,FMN GV 05 Lier
60,Mechelsesteenweg 365,2019-02-27,20:00:00,8,6,2,FMN GV 05 Lier
60,Mechelsesteenweg 365,2019-02-27,21:00:00,10,2,8,FMN GV 05 Lier
60,Mechelsesteenweg 365,2019-02-27,22:00:00,6,6,0,FMN GV 05 Lier
60,Mechelsesteenweg 365,2019-02-27,23:00:00,2,2,0,FMN GV 05 Lier
60,Mechelsesteenweg 365,2019-02-28,00:00:00,0,0,0,FMN GV 05 Lier
60,Mechelsesteenweg 365,2019-02-28,01:00:00,0,0,0,FMN GV 05 Lier
60,Mechelsesteenweg 365,2019-02-28,02:00:00,0,0,0,FMN GV 05 Lier
60,Mechelsesteenweg 365,2019-02-28,03:00:00,2,0,2,FMN GV 05 Lier
60,Mechelsesteenweg 365,2019-02-28,04:00:00,2,0,2,FMN GV 05 Lier
60,Mechelsesteenweg 365,2019-02-28,05:00:00,8,0,8,FMN GV 05 Lier
60,Mechelsesteenweg 365,2019-02-28,06:00:00,16,2,14,FMN GV 05 Lier
60,Mechelsesteenweg 365,2019-02-28,07:00:00,170,86,84,FMN GV 05 Lier
60,Mechelsesteenweg 365,2019-02-28,08:00:00,120,74,46,FMN GV 05 Lier
60,Mechelsesteenweg 365,2019-02-28,09:00:00,40,24,16,FMN GV 05 Lier
60,Mechelsesteenweg 365,2019-02-28,10:00:00,82,58,24,FMN GV 05 Lier
60,Mechelsesteenweg 365,2019-02-28,11:00:00,64,32,32,FMN GV 05 Lier
60,Mechelsesteenweg 365,2019-02-28,12:00:00,34,22,12,FMN GV 05 Lier
60,Mechelsesteenweg 365,2019-02-28,13:00:00,90,68,22,FMN GV 05 Lier
60,Mechelsesteenweg 365,2019-02-28,14:00:00,50,26,24,FMN GV 05 Lier
60,Mechelsesteenweg 365,2019-02-28,15:00:00,72,30,42,FMN GV 05 Lier
60,Mechelsesteenweg 365,2019-02-28,16:00:00,178,42,136,FMN GV 05 Lier
60,Mechelsesteenweg 365,2019-02-28,17:00:00,90,56,34,FMN GV 05 Lier
60,Mechelsesteenweg 365,2019-02-28,18:00:00,36,28,8,FMN GV 05 Lier
60,Mechelsesteenweg 365,2019-02-28,19:00:00,24,16,8,FMN GV 05 Lier
60,Mechelsesteenweg 365,2019-02-28,20:00:00,4,2,2,FMN GV 05 Lier
60,Mechelsesteenweg 365,2019-02-28,21:00:00,10,4,6,FMN GV 05 Lier
60,Mechelsesteenweg 365,2019-02-28,22:00:00,2,2,0,FMN GV 05 Lier
60,Mechelsesteenweg 365,2019-02-28,23:00:00,0,0,0,FMN GV 05 Lier
60,Mechelsesteenweg 365,2019-03-01,00:00:00,2,2,0,FMN GV 05 Lier
60,Mechelsesteenweg 365,2019-03-01,01:00:00,0,0,0,FMN GV 05 Lier
60,Mechelsesteenweg 365,2019-03-01,02:00:00,0,0,0,FMN GV 05 Lier
60,Mechelsesteenweg 365,2019-03-01,03:00:00,0,0,0,FMN GV 05 Lier
60,Mechelsesteenweg 365,2019-03-01,04:00:00,0,0,0,FMN GV 05 Lier
60,Mechelsesteenweg 365,2019-03-01,05:00:00,4,0,4,FMN GV 05 Lier
60,Mechelsesteenweg 365,2019-03-01,06:00:00,6,2,4,FMN GV 05 Lier
60,Mechelsesteenweg 365,2019-03-01,07:00:00,114,64,50,FMN GV 05 Lier
60,Mechelsesteenweg 365,2019-03-01,08:00:00,98,64,34,FMN GV 05 Lier
60,Mechelsesteenweg 365,2019-03-01,09:00:00,18,8,10,FMN GV 05 Lier
60,Mechelsesteenweg 365,2019-03-01,10:00:00,10,2,8,FMN GV 05 Lier
60,Mechelsesteenweg 365,2019-03-01,11:00:00,20,10,10,FMN GV 05 Lier
60,Mechelsesteenweg 365,2019-03-01,12:00:00,46,22,24,FMN GV 05 Lier
60,Mechelsesteenweg 365,2019-03-01,13:00:00,52,42,10,FMN GV 05 Lier
60,Mechelsesteenweg 365,2019-03-01,14:00:00,30,18,12,FMN GV 05 Lier
60,Mechelsesteenweg 365,2019-03-01,15:00:00,82,32,50,FMN GV 05 Lier
60,Mechelsesteenweg 365,2019-03-01,16:00:00,128,54,74,FMN GV 05 Lier
60,Mechelsesteenweg 365,2019-03-01,17:00:00,62,34,28,FMN GV 05 Lier
60,Mechelsesteenweg 365,2019-03-01,18:00:00,32,18,14,FMN GV 05 Lier
60,Mechelsesteenweg 365,2019-03-01,19:00:00,14,8,6,FMN GV 05 Lier
60,Mechelsesteenweg 365,2019-03-01,20:00:00,8,6,2,FMN GV 05 Lier
60,Mechelsesteenweg 365,2019-03-01,21:00:00,2,2,0,FMN GV 05 Lier
60,Mechelsesteenweg 365,2019-03-01,22:00:00,4,2,2,FMN GV 05 Lier
60,Mechelsesteenweg 365,2019-03-01,23:00:00,2,0,2,FMN GV 05 Lier
60,Mechelsesteenweg 365,2019-03-02,00:00:00,0,0,0,FMN GV 05 Lier
60,Mechelsesteenweg 365,2019-03-02,01:00:00,2,0,2,FMN GV 05 Lier
60,Mechelsesteenweg 365,2019-03-02,02:00:00,0,0,0,FMN GV 05 Lier
60,Mechelsesteenweg 365,2019-03-02,03:00:00,0,0,0,FMN GV 05 Lier
60,Mechelsesteenweg 365,2019-03-02,04:00:00,0,0,0,FMN GV 05 Lier
60,Mechelsesteenweg 365,2019-03-02,05:00:00,2,0,2,FMN GV 05 Lier
60,Mechelsesteenweg 365,2019-03-02,06:00:00,2,2,0,FMN GV 05 Lier
60,Mechelsesteenweg 365,2019-03-02,07:00:00,10,4,6,FMN GV 05 Lier
60,Mechelsesteenweg 365,2019-03-02,08:00:00,34,14,20,FMN GV 05 Lier
60,Mechelsesteenweg 365,2019-03-02,09:00:00,90,44,46,FMN GV 05 Lier
60,Mechelsesteenweg 365,2019-03-02,10:00:00,114,66,48,FMN GV 05 Lier
60,Mechelsesteenweg 365,2019-03-02,11:00:00,162,88,74,FMN GV 05 Lier
60,Mechelsesteenweg 365,2019-03-02,12:00:00,114,40,74,FMN GV 05 Lier
60,Mechelsesteenweg 365,2019-03-02,13:00:00,36,20,16,FMN GV 05 Lier
60,Mechelsesteenweg 365,2019-03-02,14:00:00,58,42,16,FMN GV 05 Lier
60,Mechelsesteenweg 365,2019-03-02,15:00:00,52,42,10,FMN GV 05 Lier
60,Mechelsesteenweg 365,2019-03-02,16:00:00,28,14,14,FMN GV 05 Lier
60,Mechelsesteenweg 365,2019-03-02,17:00:00,22,8,14,FMN GV 05 Lier
60,Mechelsesteenweg 365,2019-03-02,18:00:00,10,4,6,FMN GV 05 Lier
60,Mechelsesteenweg 365,2019-03-02,19:00:00,4,0,4,FMN GV 05 Lier
60,Mechelsesteenweg 365,2019-03-02,20:00:00,2,2,0,FMN GV 05 Lier
60,Mechelsesteenweg 365,2019-03-02,21:00:00,2,0,2,FMN GV 05 Lier
60,Mechelsesteenweg 365,2019-03-02,22:00:00,0,0,0,FMN GV 05 Lier
60,Mechelsesteenweg 365,2019-03-02,23:00:00,0,0,0,FMN GV 05 Lier
60,Mechelsesteenweg 365,2019-03-03,00:00:00,0,0,0,FMN GV 05 Lier
60,Mechelsesteenweg 365,2019-03-03,01:00:00,0,0,0,FMN GV 05 Lier
60,Mechelsesteenweg 365,2019-03-03,02:00:00,0,0,0,FMN GV 05 Lier
60,Mechelsesteenweg 365,2019-03-03,03:00:00,0,0,0,FMN GV 05 Lier
60,Mechelsesteenweg 365,2019-03-03,04:00:00,0,0,0,FMN GV 05 Lier
60,Mechelsesteenweg 365,2019-03-03,05:00:00,0,0,0,FMN GV 05 Lier
60,Mechelsesteenweg 365,2019-03-03,06:00:00,0,0,0,FMN GV 05 Lier
60,Mechelsesteenweg 365,2019-03-03,07:00:00,4,0,4,FMN GV 05 Lier
60,Mechelsesteenweg 365,2019-03-03,08:00:00,6,2,4,FMN GV 05 Lier
60,Mechelsesteenweg 365,2019-03-03,09:00:00,2,2,0,FMN GV 05 Lier
60,Mechelsesteenweg 365,2019-03-03,10:00:00,50,26,24,FMN GV 05 Lier
60,Mechelsesteenweg 365,2019-03-03,11:00:00,38,24,14,FMN GV 05 Lier
60,Mechelsesteenweg 365,2019-03-03,12:00:00,24,14,10,FMN GV 05 Lier
60,Mechelsesteenweg 365,2019-03-03,13:00:00,24,8,16,FMN GV 05 Lier
60,Mechelsesteenweg 365,2019-03-03,14:00:00,24,16,8,FMN GV 05 Lier
60,Mechelsesteenweg 365,2019-03-03,15:00:00,34,16,18,FMN GV 05 Lier
60,Mechelsesteenweg 365,2019-03-03,16:00:00,36,26,10,FMN GV 05 Lier
60,Mechelsesteenweg 365,2019-03-03,17:00:00,26,16,10,FMN GV 05 Lier
60,Mechelsesteenweg 365,2019-03-03,18:00:00,16,6,10,FMN GV 05 Lier
60,Mechelsesteenweg 365,2019-03-03,19:00:00,0,0,0,FMN GV 05 Lier
60,Mechelsesteenweg 365,2019-03-03,20:00:00,2,2,0,FMN GV 05 Lier
60,Mechelsesteenweg 365,2019-03-03,21:00:00,12,6,6,FMN GV 05 Lier
60,Mechelsesteenweg 365,2019-03-03,22:00:00,12,2,10,FMN GV 05 Lier
60,Mechelsesteenweg 365,2019-03-03,23:00:00,0,0,0,FMN GV 05 Lier
60,Mechelsesteenweg 365,2019-03-04,00:00:00,0,0,0,FMN GV 05 Lier
60,Mechelsesteenweg 365,2019-03-04,01:00:00,0,0,0,FMN GV 05 Lier
60,Mechelsesteenweg 365,2019-03-04,02:00:00,0,0,0,FMN GV 05 Lier
60,Mechelsesteenweg 365,2019-03-04,03:00:00,2,0,2,FMN GV 05 Lier
60,Mechelsesteenweg 365,2019-03-04,04:00:00,0,0,0,FMN GV 05 Lier
60,Mechelsesteenweg 365,2019-03-04,05:00:00,6,0,6,FMN GV 05 Lier
60,Mechelsesteenweg 365,2019-03-04,06:00:00,2,0,2,FMN GV 05 Lier
60,Mechelsesteenweg 365,2019-03-04,07:00:00,20,4,16,FMN GV 05 Lier
60,Mechelsesteenweg 365,2019-03-04,08:00:00,24,12,12,FMN GV 05 Lier
60,Mechelsesteenweg 365,2019-03-04,09:00:00,24,8,16,FMN GV 05 Lier
60,Mechelsesteenweg 365,2019-03-04,10:00:00,2,2,0,FMN GV 05 Lier
60,Mechelsesteenweg 365,2019-03-04,11:00:00,10,6,4,FMN GV 05 Lier
60,Mechelsesteenweg 365,2019-03-04,12:00:00,20,10,10,FMN GV 05 Lier
60,Mechelsesteenweg 365,2019-03-04,13:00:00,32,8,24,FMN GV 05 Lier
60,Mechelsesteenweg 365,2019-03-04,14:00:00,52,36,16,FMN GV 05 Lier
60,Mechelsesteenweg 365,2019-03-04,15:00:00,34,20,14,FMN GV 05 Lier
60,Mechelsesteenweg 365,2019-03-04,16:00:00,48,28,20,FMN GV 05 Lier
60,Mechelsesteenweg 365,2019-03-04,17:00:00,60,40,20,FMN GV 05 Lier
60,Mechelsesteenweg 365,2019-03-04,18:00:00,26,20,6,FMN GV 05 Lier
60,Mechelsesteenweg 365,2019-03-04,19:00:00,4,2,2,FMN GV 05 Lier
60,Mechelsesteenweg 365,2019-03-04,20:00:00,2,0,2,FMN GV 05 Lier
60,Mechelsesteenweg 365,2019-03-04,21:00:00,8,0,8,FMN GV 05 Lier
60,Mechelsesteenweg 365,2019-03-04,22:00:00,2,2,0,FMN GV 05 Lier
60,Mechelsesteenweg 365,2019-03-04,23:00:00,0,0,0,FMN GV 05 Lier
60,Mechelsesteenweg 365,2019-03-05,00:00:00,0,0,0,FMN GV 05 Lier
60,Mechelsesteenweg 365,2019-03-05,01:00:00,2,0,2,FMN GV 05 Lier
60,Mechelsesteenweg 365,2019-03-05,02:00:00,0,0,0,FMN GV 05 Lier
60,Mechelsesteenweg 365,2019-03-05,03:00:00,2,0,2,FMN GV 05 Lier
60,Mechelsesteenweg 365,2019-03-05,04:00:00,0,0,0,FMN GV 05 Lier
60,Mechelsesteenweg 365,2019-03-05,05:00:00,6,2,4,FMN GV 05 Lier
60,Mechelsesteenweg 365,2019-03-05,06:00:00,12,2,10,FMN GV 05 Lier
60,Mechelsesteenweg 365,2019-03-05,07:00:00,54,18,36,FMN GV 05 Lier
60,Mechelsesteenweg 365,2019-03-05,08:00:00,42,18,24,FMN GV 05 Lier
60,Mechelsesteenweg 365,2019-03-05,09:00:00,28,14,14,FMN GV 05 Lier
60,Mechelsesteenweg 365,2019-03-05,10:00:00,40,22,18,FMN GV 05 Lier
60,Mechelsesteenweg 365,2019-03-05,11:00:00,52,24,28,FMN GV 05 Lier
60,Mechelsesteenweg 365,2019-03-05,12:00:00,50,34,16,FMN GV 05 Lier
60,Mechelsesteenweg 365,2019-03-05,13:00:00,98,46,52,FMN GV 05 Lier
60,Mechelsesteenweg 365,2019-03-05,14:00:00,100,44,56,FMN GV 05 Lier
60,Mechelsesteenweg 365,2019-03-05,15:00:00,80,56,24,FMN GV 05 Lier
60,Mechelsesteenweg 365,2019-03-05,16:00:00,90,52,38,FMN GV 05 Lier
60,Mechelsesteenweg 365,2019-03-05,17:00:00,96,56,40,FMN GV 05 Lier
60,Mechelsesteenweg 365,2019-03-05,18:00:00,44,16,28,FMN GV 05 Lier
60,Mechelsesteenweg 365,2019-03-05,19:00:00,12,6,6,FMN GV 05 Lier
60,Mechelsesteenweg 365,2019-03-05,20:00:00,10,4,6,FMN GV 05 Lier
60,Mechelsesteenweg 365,2019-03-05,21:00:00,14,8,6,FMN GV 05 Lier
60,Mechelsesteenweg 365,2019-03-05,22:00:00,4,4,0,FMN GV 05 Lier
60,Mechelsesteenweg 365,2019-03-05,23:00:00,2,2,0,FMN GV 05 Lier
60,Mechelsesteenweg 365,2019-03-06,00:00:00,2,0,2,FMN GV 05 Lier
60,Mechelsesteenweg 365,2019-03-06,01:00:00,2,0,2,FMN GV 05 Lier
60,Mechelsesteenweg 365,2019-03-06,02:00:00,0,0,0,FMN GV 05 Lier
60,Mechelsesteenweg 365,2019-03-06,03:00:00,0,0,0,FMN GV 05 Lier
60,Mechelsesteenweg 365,2019-03-06,04:00:00,0,0,0,FMN GV 05 Lier
60,Mechelsesteenweg 365,2019-03-06,05:00:00,4,0,4,FMN GV 05 Lier
60,Mechelsesteenweg 365,2019-03-06,06:00:00,18,0,18,FMN GV 05 Lier
60,Mechelsesteenweg 365,2019-03-06,07:00:00,50,16,34,FMN GV 05 Lier
60,Mechelsesteenweg 365,2019-03-06,08:00:00,30,10,20,FMN GV 05 Lier
60,Mechelsesteenweg 365,2019-03-06,09:00:00,20,12,8,FMN GV 05 Lier
60,Mechelsesteenweg 365,2019-03-06,10:00:00,10,2,8,FMN GV 05 Lier
60,Mechelsesteenweg 365,2019-03-06,11:00:00,32,18,14,FMN GV 05 Lier
60,Mechelsesteenweg 365,2019-03-06,12:00:00,24,8,16,FMN GV 05 Lier
60,Mechelsesteenweg 365,2019-03-06,13:00:00,18,6,12,FMN GV 05 Lier
60,Mechelsesteenweg 365,2019-03-06,14:00:00,32,18,14,FMN GV 05 Lier
60,Mechelsesteenweg 365,2019-03-06,15:00:00,32,20,12,FMN GV 05 Lier
60,Mechelsesteenweg 365,2019-03-06,16:00:00,38,20,18,FMN GV 05 Lier
60,Mechelsesteenweg 365,2019-03-06,17:00:00,48,36,12,FMN GV 05 Lier
60,Mechelsesteenweg 365,2019-03-06,18:00:00,20,14,6,FMN GV 05 Lier
60,Mechelsesteenweg 365,2019-03-06,19:00:00,14,12,2,FMN GV 05 Lier
60,Mechelsesteenweg 365,2019-03-06,20:00:00,6,2,4,FMN GV 05 Lier
60,Mechelsesteenweg 365,2019-03-06,21:00:00,0,0,0,FMN GV 05 Lier
60,Mechelsesteenweg 365,2019-03-06,22:00:00,4,4,0,FMN GV 05 Lier
60,Mechelsesteenweg 365,2019-03-06,23:00:00,2,2,0,FMN GV 05 Lier
60,Mechelsesteenweg 365,2019-03-07,00:00:00,0,0,0,FMN GV 05 Lier
60,Mechelsesteenweg 365,2019-03-07,01:00:00,0,0,0,FMN GV 05 Lier
60,Mechelsesteenweg 365,2019-03-07,02:00:00,0,0,0,FMN GV 05 Lier
60,Mechelsesteenweg 365,2019-03-07,03:00:00,0,0,0,FMN GV 05 Lier
60,Mechelsesteenweg 365,2019-03-07,04:00:00,0,0,0,FMN GV 05 Lier
60,Mechelsesteenweg 365,2019-03-07,05:00:00,4,0,4,FMN GV 05 Lier
60,Mechelsesteenweg 365,2019-03-07,06:00:00,6,0,6,FMN GV 05 Lier
60,Mechelsesteenweg 365,2019-03-07,07:00:00,30,6,24,FMN GV 05 Lier
60,Mechelsesteenweg 365,2019-03-07,08:00:00,26,12,14,FMN GV 05 Lier
60,Mechelsesteenweg 365,2019-03-07,09:00:00,20,14,6,FMN GV 05 Lier
60,Mechelsesteenweg 365,2019-03-07,10:00:00,42,30,12,FMN GV 05 Lier
60,Mechelsesteenweg 365,2019-03-07,11:00:00,16,6,10,FMN GV 05 Lier
60,Mechelsesteenweg 365,2019-03-07,12:00:00,22,6,16,FMN GV 05 Lier
60,Mechelsesteenweg 365,2019-03-07,13:00:00,44,22,22,FMN GV 05 Lier
60,Mechelsesteenweg 365,2019-03-07,14:00:00,14,10,4,FMN GV 05 Lier
60,Mechelsesteenweg 365,2019-03-07,15:00:00,22,12,10,FMN GV 05 Lier
60,Mechelsesteenweg 365,2019-03-07,16:00:00,30,16,14,FMN GV 05 Lier
60,Mechelsesteenweg 365,2019-03-07,17:00:00,40,30,10,FMN GV 05 Lier
60,Mechelsesteenweg 365,2019-03-07,18:00:00,10,6,4,FMN GV 05 Lier
60,Mechelsesteenweg 365,2019-03-07,19:00:00,16,6,10,FMN GV 05 Lier
60,Mechelsesteenweg 365,2019-03-07,20:00:00,6,6,0,FMN GV 05 Lier
60,Mechelsesteenweg 365,2019-03-07,21:00:00,2,0,2,FMN GV 05 Lier
60,Mechelsesteenweg 365,2019-03-07,22:00:00,4,4,0,FMN GV 05 Lier
60,Mechelsesteenweg 365,2019-03-07,23:00:00,4,4,0,FMN GV 05 Lier
60,Mechelsesteenweg 365,2019-03-08,00:00:00,2,0,2,FMN GV 05 Lier
60,Mechelsesteenweg 365,2019-03-08,01:00:00,0,0,0,FMN GV 05 Lier
60,Mechelsesteenweg 365,2019-03-08,02:00:00,0,0,0,FMN GV 05 Lier
60,Mechelsesteenweg 365,2019-03-08,03:00:00,2,0,2,FMN GV 05 Lier
60,Mechelsesteenweg 365,2019-03-08,04:00:00,2,0,2,FMN GV 05 Lier
60,Mechelsesteenweg 365,2019-03-08,05:00:00,4,0,4,FMN GV 05 Lier
60,Mechelsesteenweg 365,2019-03-08,06:00:00,14,4,10,FMN GV 05 Lier
60,Mechelsesteenweg 365,2019-03-08,07:00:00,40,14,26,FMN GV 05 Lier
60,Mechelsesteenweg 365,2019-03-08,08:00:00,46,18,28,FMN GV 05 Lier
60,Mechelsesteenweg 365,2019-03-08,09:00:00,50,22,28,FMN GV 05 Lier
60,Mechelsesteenweg 365,2019-03-08,10:00:00,90,68,22,FMN GV 05 Lier
60,Mechelsesteenweg 365,2019-03-08,11:00:00,88,50,38,FMN GV 05 Lier
60,Mechelsesteenweg 365,2019-03-08,12:00:00,90,32,58,FMN GV 05 Lier
60,Mechelsesteenweg 365,2019-03-08,13:00:00,110,50,60,FMN GV 05 Lier
60,Mechelsesteenweg 365,2019-03-08,14:00:00,144,78,66,FMN GV 05 Lier
60,Mechelsesteenweg 365,2019-03-08,15:00:00,158,78,80,FMN GV 05 Lier
60,Mechelsesteenweg 365,2019-03-08,16:00:00,96,50,46,FMN GV 05 Lier
60,Mechelsesteenweg 365,2019-03-08,17:00:00,74,48,26,FMN GV 05 Lier
60,Mechelsesteenweg 365,2019-03-08,18:00:00,40,20,20,FMN GV 05 Lier
60,Mechelsesteenweg 365,2019-03-08,19:00:00,12,8,4,FMN GV 05 Lier
60,Mechelsesteenweg 365,2019-03-08,20:00:00,4,4,0,FMN GV 05 Lier
60,Mechelsesteenweg 365,2019-03-08,21:00:00,8,0,8,FMN GV 05 Lier
60,Mechelsesteenweg 365,2019-03-08,22:00:00,10,10,0,FMN GV 05 Lier
60,Mechelsesteenweg 365,2019-03-08,23:00:00,0,0,0,FMN GV 05 Lier
60,Mechelsesteenweg 365,2019-03-09,00:00:00,2,2,0,FMN GV 05 Lier
60,Mechelsesteenweg 365,2019-03-09,01:00:00,0,0,0,FMN GV 05 Lier
60,Mechelsesteenweg 365,2019-03-09,02:00:00,0,0,0,FMN GV 05 Lier
60,Mechelsesteenweg 365,2019-03-09,03:00:00,0,0,0,FMN GV 05 Lier
60,Mechelsesteenweg 365,2019-03-09,04:00:00,0,0,0,FMN GV 05 Lier
60,Mechelsesteenweg 365,2019-03-09,05:00:00,0,0,0,FMN GV 05 Lier
60,Mechelsesteenweg 365,2019-03-09,06:00:00,4,2,2,FMN GV 05 Lier
60,Mechelsesteenweg 365,2019-03-09,07:00:00,2,0,2,FMN GV 05 Lier
60,Mechelsesteenweg 365,2019-03-09,08:00:00,20,8,12,FMN GV 05 Lier
60,Mechelsesteenweg 365,2019-03-09,09:00:00,54,22,32,FMN GV 05 Lier
60,Mechelsesteenweg 365,2019-03-09,10:00:00,100,50,50,FMN GV 05 Lier
60,Mechelsesteenweg 365,2019-03-09,11:00:00,94,42,52,FMN GV 05 Lier
60,Mechelsesteenweg 365,2019-03-09,12:00:00,50,28,22,FMN GV 05 Lier
60,Mechelsesteenweg 365,2019-03-09,13:00:00,40,18,22,FMN GV 05 Lier
60,Mechelsesteenweg 365,2019-03-09,14:00:00,48,28,20,FMN GV 05 Lier
60,Mechelsesteenweg 365,2019-03-09,15:00:00,40,20,20,FMN GV 05 Lier
60,Mechelsesteenweg 365,2019-03-09,16:00:00,28,14,14,FMN GV 05 Lier
60,Mechelsesteenweg 365,2019-03-09,17:00:00,24,12,12,FMN GV 05 Lier
60,Mechelsesteenweg 365,2019-03-09,18:00:00,6,2,4,FMN GV 05 Lier
60,Mechelsesteenweg 365,2019-03-09,19:00:00,6,0,6,FMN GV 05 Lier
60,Mechelsesteenweg 365,2019-03-09,20:00:00,2,0,2,FMN GV 05 Lier
60,Mechelsesteenweg 365,2019-03-09,21:00:00,2,2,0,FMN GV 05 Lier
60,Mechelsesteenweg 365,2019-03-09,22:00:00,2,2,0,FMN GV 05 Lier
60,Mechelsesteenweg 365,2019-03-09,23:00:00,4,2,2,FMN GV 05 Lier
60,Mechelsesteenweg 365,2019-03-10,00:00:00,4,2,2,FMN GV 05 Lier
60,Mechelsesteenweg 365,2019-03-10,01:00:00,0,0,0,FMN GV 05 Lier
60,Mechelsesteenweg 365,2019-03-10,02:00:00,0,0,0,FMN GV 05 Lier
60,Mechelsesteenweg 365,2019-03-10,03:00:00,0,0,0,FMN GV 05 Lier
60,Mechelsesteenweg 365,2019-03-10,04:00:00,0,0,0,FMN GV 05 Lier
60,Mechelsesteenweg 365,2019-03-10,05:00:00,2,0,2,FMN GV 05 Lier
60,Mechelsesteenweg 365,2019-03-10,06:00:00,0,0,0,FMN GV 05 Lier
60,Mechelsesteenweg 365,2019-03-10,07:00:00,2,2,0,FMN GV 05 Lier
60,Mechelsesteenweg 365,2019-03-10,08:00:00,0,0,0,FMN GV 05 Lier
60,Mechelsesteenweg 365,2019-03-10,09:00:00,46,32,14,FMN GV 05 Lier
60,Mechelsesteenweg 365,2019-03-10,10:00:00,44,20,24,FMN GV 05 Lier
60,Mechelsesteenweg 365,2019-03-10,11:00:00,50,28,22,FMN GV 05 Lier
60,Mechelsesteenweg 365,2019-03-10,12:00:00,10,4,6,FMN GV 05 Lier
60,Mechelsesteenweg 365,2019-03-10,13:00:00,4,0,4,FMN GV 05 Lier
60,Mechelsesteenweg 365,2019-03-10,14:00:00,4,2,2,FMN GV 05 Lier
60,Mechelsesteenweg 365,2019-03-10,15:00:00,10,6,4,FMN GV 05 Lier
60,Mechelsesteenweg 365,2019-03-10,16:00:00,0,0,0,FMN GV 05 Lier
60,Mechelsesteenweg 365,2019-03-10,17:00:00,0,0,0,FMN GV 05 Lier
60,Mechelsesteenweg 365,2019-03-10,18:00:00,2,2,0,FMN GV 05 Lier
60,Mechelsesteenweg 365,2019-03-10,19:00:00,2,2,0,FMN GV 05 Lier
60,Mechelsesteenweg 365,2019-03-10,20:00:00,0,0,0,FMN GV 05 Lier
60,Mechelsesteenweg 365,2019-03-10,21:00:00,0,0,0,FMN GV 05 Lier
60,Mechelsesteenweg 365,2019-03-10,22:00:00,0,0,0,FMN GV 05 Lier
60,Mechelsesteenweg 365,2019-03-10,23:00:00,2,0,2,FMN GV 05 Lier
60,Mechelsesteenweg 365,2019-03-11,00:00:00,0,0,0,FMN GV 05 Lier
60,Mechelsesteenweg 365,2019-03-11,01:00:00,0,0,0,FMN GV 05 Lier
60,Mechelsesteenweg 365,2019-03-11,02:00:00,0,0,0,FMN GV 05 Lier
60,Mechelsesteenweg 365,2019-03-11,03:00:00,4,0,4,FMN GV 05 Lier
60,Mechelsesteenweg 365,2019-03-11,04:00:00,2,0,2,FMN GV 05 Lier
60,Mechelsesteenweg 365,2019-03-11,05:00:00,0,0,0,FMN GV 05 Lier
60,Mechelsesteenweg 365,2019-03-11,06:00:00,2,0,2,FMN GV 05 Lier
60,Mechelsesteenweg 365,2019-03-11,07:00:00,92,64,28,FMN GV 05 Lier
60,Mechelsesteenweg 365,2019-03-11,08:00:00,54,32,22,FMN GV 05 Lier
60,Mechelsesteenweg 365,2019-03-11,09:00:00,14,12,2,FMN GV 05 Lier
60,Mechelsesteenweg 365,2019-03-11,10:00:00,6,2,4,FMN GV 05 Lier
60,Mechelsesteenweg 365,2019-03-11,11:00:00,6,2,4,FMN GV 05 Lier
60,Mechelsesteenweg 365,2019-03-11,12:00:00,12,4,8,FMN GV 05 Lier
60,Mechelsesteenweg 365,2019-03-11,13:00:00,20,6,14,FMN GV 05 Lier
60,Mechelsesteenweg 365,2019-03-11,14:00:00,34,12,22,FMN GV 05 Lier
60,Mechelsesteenweg 365,2019-03-11,15:00:00,40,32,8,FMN GV 05 Lier
60,Mechelsesteenweg 365,2019-03-11,16:00:00,100,26,74,FMN GV 05 Lier
60,Mechelsesteenweg 365,2019-03-11,17:00:00,50,24,26,FMN GV 05 Lier
60,Mechelsesteenweg 365,2019-03-11,18:00:00,30,16,14,FMN GV 05 Lier
60,Mechelsesteenweg 365,2019-03-11,19:00:00,8,4,4,FMN GV 05 Lier
60,Mechelsesteenweg 365,2019-03-11,20:00:00,0,0,0,FMN GV 05 Lier
60,Mechelsesteenweg 365,2019-03-11,21:00:00,2,0,2,FMN GV 05 Lier
60,Mechelsesteenweg 365,2019-03-11,22:00:00,2,0,2,FMN GV 05 Lier
60,Mechelsesteenweg 365,2019-03-11,23:00:00,2,0,2,FMN GV 05 Lier
60,Mechelsesteenweg 365,2019-03-12,00:00:00,0,0,0,FMN GV 05 Lier
60,Mechelsesteenweg 365,2019-03-12,01:00:00,0,0,0,FMN GV 05 Lier
60,Mechelsesteenweg 365,2019-03-12,02:00:00,0,0,0,FMN GV 05 Lier
60,Mechelsesteenweg 365,2019-03-12,03:00:00,4,0,4,FMN GV 05 Lier
60,Mechelsesteenweg 365,2019-03-12,04:00:00,0,0,0,FMN GV 05 Lier
60,Mechelsesteenweg 365,2019-03-12,05:00:00,6,0,6,FMN GV 05 Lier
60,Mechelsesteenweg 365,2019-03-12,06:00:00,16,6,10,FMN GV 05 Lier
60,Mechelsesteenweg 365,2019-03-12,07:00:00,100,58,42,FMN GV 05 Lier
60,Mechelsesteenweg 365,2019-03-12,08:00:00,108,66,42,FMN GV 05 Lier
60,Mechelsesteenweg 365,2019-03-12,09:00:00,50,36,14,FMN GV 05 Lier
60,Mechelsesteenweg 365,2019-03-12,10:00:00,48,32,16,FMN GV 05 Lier
60,Mechelsesteenweg 365,2019-03-12,11:00:00,56,20,36,FMN GV 05 Lier
60,Mechelsesteenweg 365,2019-03-12,12:00:00,26,8,18,FMN GV 05 Lier
60,Mechelsesteenweg 365,2019-03-12,13:00:00,38,24,14,FMN GV 05 Lier
60,Mechelsesteenweg 365,2019-03-12,14:00:00,36,30,6,FMN GV 05 Lier
60,Mechelsesteenweg 365,2019-03-12,15:00:00,40,18,22,FMN GV 05 Lier
60,Mechelsesteenweg 365,2019-03-12,16:00:00,118,32,86,FMN GV 05 Lier
60,Mechelsesteenweg 365,2019-03-12,17:00:00,80,42,38,FMN GV 05 Lier
60,Mechelsesteenweg 365,2019-03-12,18:00:00,18,16,2,FMN GV 05 Lier
60,Mechelsesteenweg 365,2019-03-12,19:00:00,2,2,0,FMN GV 05 Lier
60,Mechelsesteenweg 365,2019-03-12,20:00:00,4,2,2,FMN GV 05 Lier
60,Mechelsesteenweg 365,2019-03-12,21:00:00,2,0,2,FMN GV 05 Lier
60,Mechelsesteenweg 365,2019-03-12,22:00:00,0,0,0,FMN GV 05 Lier
60,Mechelsesteenweg 365,2019-03-12,23:00:00,2,2,0,FMN GV 05 Lier
60,Mechelsesteenweg 365,2019-03-13,00:00:00,0,0,0,FMN GV 05 Lier
60,Mechelsesteenweg 365,2019-03-13,01:00:00,0,0,0,FMN GV 05 Lier
60,Mechelsesteenweg 365,2019-03-13,02:00:00,0,0,0,FMN GV 05 Lier
60,Mechelsesteenweg 365,2019-03-13,03:00:00,2,0,2,FMN GV 05 Lier
60,Mechelsesteenweg 365,2019-03-13,04:00:00,4,0,4,FMN GV 05 Lier
60,Mechelsesteenweg 365,2019-03-13,05:00:00,0,0,0,FMN GV 05 Lier
60,Mechelsesteenweg 365,2019-03-13,06:00:00,4,2,2,FMN GV 05 Lier
60,Mechelsesteenweg 365,2019-03-13,07:00:00,98,64,34,FMN GV 05 Lier
60,Mechelsesteenweg 365,2019-03-13,08:00:00,74,50,24,FMN GV 05 Lier
60,Mechelsesteenweg 365,2019-03-13,09:00:00,6,2,4,FMN GV 05 Lier
60,Mechelsesteenweg 365,2019-03-13,10:00:00,4,2,2,FMN GV 05 Lier
60,Mechelsesteenweg 365,2019-03-13,11:00:00,24,6,18,FMN GV 05 Lier
60,Mechelsesteenweg 365,2019-03-13,12:00:00,66,18,48,FMN GV 05 Lier
60,Mechelsesteenweg 365,2019-03-13,13:00:00,18,10,8,FMN GV 05 Lier
60,Mechelsesteenweg 365,2019-03-13,14:00:00,14,4,10,FMN GV 05 Lier
60,Mechelsesteenweg 365,2019-03-13,15:00:00,8,8,0,FMN GV 05 Lier
60,Mechelsesteenweg 365,2019-03-13,16:00:00,20,6,14,FMN GV 05 Lier
60,Mechelsesteenweg 365,2019-03-13,17:00:00,52,42,10,FMN GV 05 Lier
60,Mechelsesteenweg 365,2019-03-13,18:00:00,22,8,14,FMN GV 05 Lier
60,Mechelsesteenweg 365,2019-03-13,19:00:00,18,14,4,FMN GV 05 Lier
60,Mechelsesteenweg 365,2019-03-13,20:00:00,6,4,2,FMN GV 05 Lier
60,Mechelsesteenweg 365,2019-03-13,21:00:00,4,0,4,FMN GV 05 Lier
60,Mechelsesteenweg 365,2019-03-13,22:00:00,0,0,0,FMN GV 05 Lier
60,Mechelsesteenweg 365,2019-03-13,23:00:00,0,0,0,FMN GV 05 Lier
60,Mechelsesteenweg 365,2019-03-14,00:00:00,0,0,0,FMN GV 05 Lier
60,Mechelsesteenweg 365,2019-03-14,01:00:00,0,0,0,FMN GV 05 Lier
60,Mechelsesteenweg 365,2019-03-14,02:00:00,0,0,0,FMN GV 05 Lier
60,Mechelsesteenweg 365,2019-03-14,03:00:00,2,0,2,FMN GV 05 Lier
60,Mechelsesteenweg 365,2019-03-14,04:00:00,4,0,4,FMN GV 05 Lier
60,Mechelsesteenweg 365,2019-03-14,05:00:00,4,2,2,FMN GV 05 Lier
60,Mechelsesteenweg 365,2019-03-14,06:00:00,8,2,6,FMN GV 05 Lier
60,Mechelsesteenweg 365,2019-03-14,07:00:00,64,30,34,FMN GV 05 Lier
60,Mechelsesteenweg 365,2019-03-14,08:00:00,60,36,24,FMN GV 05 Lier
60,Mechelsesteenweg 365,2019-03-14,09:00:00,6,4,2,FMN GV 05 Lier
60,Mechelsesteenweg 365,2019-03-14,10:00:00,2,2,0,FMN GV 05 Lier
60,Mechelsesteenweg 365,2019-03-14,11:00:00,0,0,0,FMN GV 05 Lier
60,Mechelsesteenweg 365,2019-03-14,12:00:00,10,4,6,FMN GV 05 Lier
60,Mechelsesteenweg 365,2019-03-14,13:00:00,0,0,0,FMN GV 05 Lier
60,Mechelsesteenweg 365,2019-03-14,14:00:00,16,10,6,FMN GV 05 Lier
60,Mechelsesteenweg 365,2019-03-14,15:00:00,32,20,12,FMN GV 05 Lier
60,Mechelsesteenweg 365,2019-03-14,16:00:00,88,26,62,FMN GV 05 Lier
60,Mechelsesteenweg 365,2019-03-14,17:00:00,78,48,30,FMN GV 05 Lier
60,Mechelsesteenweg 365,2019-03-14,18:00:00,10,4,6,FMN GV 05 Lier
60,Mechelsesteenweg 365,2019-03-14,19:00:00,10,8,2,FMN GV 05 Lier
60,Mechelsesteenweg 365,2019-03-14,20:00:00,2,0,2,FMN GV 05 Lier
60,Mechelsesteenweg 365,2019-03-14,21:00:00,2,2,0,FMN GV 05 Lier
60,Mechelsesteenweg 365,2019-03-14,22:00:00,4,0,4,FMN GV 05 Lier
60,Mechelsesteenweg 365,2019-03-14,23:00:00,0,0,0,FMN GV 05 Lier
60,Mechelsesteenweg 365,2019-03-15,00:00:00,0,0,0,FMN GV 05 Lier
60,Mechelsesteenweg 365,2019-03-15,01:00:00,0,0,0,FMN GV 05 Lier
60,Mechelsesteenweg 365,2019-03-15,02:00:00,0,0,0,FMN GV 05 Lier
60,Mechelsesteenweg 365,2019-03-15,03:00:00,2,0,2,FMN GV 05 Lier
60,Mechelsesteenweg 365,2019-03-15,04:00:00,2,0,2,FMN GV 05 Lier
60,Mechelsesteenweg 365,2019-03-15,05:00:00,0,0,0,FMN GV 05 Lier
60,Mechelsesteenweg 365,2019-03-15,06:00:00,4,0,4,FMN GV 05 Lier
60,Mechelsesteenweg 365,2019-03-15,07:00:00,68,32,36,FMN GV 05 Lier
60,Mechelsesteenweg 365,2019-03-15,08:00:00,76,46,30,FMN GV 05 Lier
60,Mechelsesteenweg 365,2019-03-15,09:00:00,26,8,18,FMN GV 05 Lier
60,Mechelsesteenweg 365,2019-03-15,10:00:00,30,26,4,FMN GV 05 Lier
60,Mechelsesteenweg 365,2019-03-15,11:00:00,18,10,8,FMN GV 05 Lier
60,Mechelsesteenweg 365,2019-03-15,12:00:00,28,16,12,FMN GV 05 Lier
60,Mechelsesteenweg 365,2019-03-15,13:00:00,6,4,2,FMN GV 05 Lier
60,Mechelsesteenweg 365,2019-03-15,14:00:00,44,26,18,FMN GV 05 Lier
60,Mechelsesteenweg 365,2019-03-15,15:00:00,54,22,32,FMN GV 05 Lier
60,Mechelsesteenweg 365,2019-03-15,16:00:00,94,22,72,FMN GV 05 Lier
60,Mechelsesteenweg 365,2019-03-15,17:00:00,30,24,6,FMN GV 05 Lier
60,Mechelsesteenweg 365,2019-03-15,18:00:00,18,8,10,FMN GV 05 Lier
60,Mechelsesteenweg 365,2019-03-15,19:00:00,10,8,2,FMN GV 05 Lier
60,Mechelsesteenweg 365,2019-03-15,20:00:00,6,6,0,FMN GV 05 Lier
60,Mechelsesteenweg 365,2019-03-15,21:00:00,0,0,0,FMN GV 05 Lier
60,Mechelsesteenweg 365,2019-03-15,22:00:00,2,2,0,FMN GV 05 Lier
60,Mechelsesteenweg 365,2019-03-15,23:00:00,0,0,0,FMN GV 05 Lier
60,Mechelsesteenweg 365,2019-03-16,00:00:00,4,0,4,FMN GV 05 Lier
60,Mechelsesteenweg 365,2019-03-16,01:00:00,2,0,2,FMN GV 05 Lier
60,Mechelsesteenweg 365,2019-03-16,02:00:00,0,0,0,FMN GV 05 Lier
60,Mechelsesteenweg 365,2019-03-16,03:00:00,0,0,0,FMN GV 05 Lier
60,Mechelsesteenweg 365,2019-03-16,04:00:00,4,4,0,FMN GV 05 Lier
60,Mechelsesteenweg 365,2019-03-16,05:00:00,0,0,0,FMN GV 05 Lier
60,Mechelsesteenweg 365,2019-03-16,06:00:00,0,0,0,FMN GV 05 Lier
60,Mechelsesteenweg 365,2019-03-16,07:00:00,2,0,2,FMN GV 05 Lier
60,Mechelsesteenweg 365,2019-03-16,08:00:00,4,2,2,FMN GV 05 Lier
60,Mechelsesteenweg 365,2019-03-16,09:00:00,58,40,18,FMN GV 05 Lier
60,Mechelsesteenweg 365,2019-03-16,10:00:00,60,26,34,FMN GV 05 Lier
60,Mechelsesteenweg 365,2019-03-16,11:00:00,64,30,34,FMN GV 05 Lier
60,Mechelsesteenweg 365,2019-03-16,12:00:00,62,36,26,FMN GV 05 Lier
60,Mechelsesteenweg 365,2019-03-16,13:00:00,90,48,42,FMN GV 05 Lier
60,Mechelsesteenweg 365,2019-03-16,14:00:00,84,44,40,FMN GV 05 Lier
60,Mechelsesteenweg 365,2019-03-16,15:00:00,84,44,40,FMN GV 05 Lier
60,Mechelsesteenweg 365,2019-03-16,16:00:00,32,10,22,FMN GV 05 Lier
60,Mechelsesteenweg 365,2019-03-16,17:00:00,52,18,34,FMN GV 05 Lier
60,Mechelsesteenweg 365,2019-03-16,18:00:00,22,14,8,FMN GV 05 Lier
60,Mechelsesteenweg 365,2019-03-16,19:00:00,14,4,10,FMN GV 05 Lier
60,Mechelsesteenweg 365,2019-03-16,20:00:00,6,2,4,FMN GV 05 Lier
60,Mechelsesteenweg 365,2019-03-16,21:00:00,0,0,0,FMN GV 05 Lier
60,Mechelsesteenweg 365,2019-03-16,22:00:00,6,4,2,FMN GV 05 Lier
60,Mechelsesteenweg 365,2019-03-16,23:00:00,2,0,2,FMN GV 05 Lier
60,Mechelsesteenweg 365,2019-03-17,00:00:00,6,4,2,FMN GV 05 Lier
60,Mechelsesteenweg 365,2019-03-17,01:00:00,0,0,0,FMN GV 05 Lier
60,Mechelsesteenweg 365,2019-03-17,02:00:00,2,0,2,FMN GV 05 Lier
60,Mechelsesteenweg 365,2019-03-17,03:00:00,0,0,0,FMN GV 05 Lier
60,Mechelsesteenweg 365,2019-03-17,04:00:00,0,0,0,FMN GV 05 Lier
60,Mechelsesteenweg 365,2019-03-17,05:00:00,0,0,0,FMN GV 05 Lier
60,Mechelsesteenweg 365,2019-03-17,06:00:00,2,2,0,FMN GV 05 Lier
60,Mechelsesteenweg 365,2019-03-17,07:00:00,6,0,6,FMN GV 05 Lier
60,Mechelsesteenweg 365,2019-03-17,08:00:00,18,8,10,FMN GV 05 Lier
60,Mechelsesteenweg 365,2019-03-17,09:00:00,94,56,38,FMN GV 05 Lier
60,Mechelsesteenweg 365,2019-03-17,10:00:00,116,70,46,FMN GV 05 Lier
60,Mechelsesteenweg 365,2019-03-17,11:00:00,150,66,84,FMN GV 05 Lier
60,Mechelsesteenweg 365,2019-03-17,12:00:00,52,18,34,FMN GV 05 Lier
60,Mechelsesteenweg 365,2019-03-17,13:00:00,36,20,16,FMN GV 05 Lier
60,Mechelsesteenweg 365,2019-03-17,14:00:00,54,36,18,FMN GV 05 Lier
60,Mechelsesteenweg 365,2019-03-17,15:00:00,40,18,22,FMN GV 05 Lier
60,Mechelsesteenweg 365,2019-03-17,16:00:00,32,10,22,FMN GV 05 Lier
60,Mechelsesteenweg 365,2019-03-17,17:00:00,16,2,14,FMN GV 05 Lier
60,Mechelsesteenweg 365,2019-03-17,18:00:00,10,8,2,FMN GV 05 Lier
60,Mechelsesteenweg 365,2019-03-17,19:00:00,10,4,6,FMN GV 05 Lier
60,Mechelsesteenweg 365,2019-03-17,20:00:00,4,4,0,FMN GV 05 Lier
60,Mechelsesteenweg 365,2019-03-17,21:00:00,2,0,2,FMN GV 05 Lier
60,Mechelsesteenweg 365,2019-03-17,22:00:00,0,0,0,FMN GV 05 Lier
60,Mechelsesteenweg 365,2019-03-17,23:00:00,0,0,0,FMN GV 05 Lier
60,Mechelsesteenweg 365,2019-03-18,00:00:00,0,0,0,FMN GV 05 Lier
60,Mechelsesteenweg 365,2019-03-18,01:00:00,0,0,0,FMN GV 05 Lier
60,Mechelsesteenweg 365,2019-03-18,02:00:00,0,0,0,FMN GV 05 Lier
60,Mechelsesteenweg 365,2019-03-18,03:00:00,2,0,2,FMN GV 05 Lier
60,Mechelsesteenweg 365,2019-03-18,04:00:00,2,0,2,FMN GV 05 Lier
60,Mechelsesteenweg 365,2019-03-18,05:00:00,2,0,2,FMN GV 05 Lier
60,Mechelsesteenweg 365,2019-03-18,06:00:00,18,0,18,FMN GV 05 Lier
60,Mechelsesteenweg 365,2019-03-18,07:00:00,146,68,78,FMN GV 05 Lier
60,Mechelsesteenweg 365,2019-03-18,08:00:00,108,64,44,FMN GV 05 Lier
60,Mechelsesteenweg 365,2019-03-18,09:00:00,52,28,24,FMN GV 05 Lier
60,Mechelsesteenweg 365,2019-03-18,10:00:00,54,34,20,FMN GV 05 Lier
60,Mechelsesteenweg 365,2019-03-18,11:00:00,44,16,28,FMN GV 05 Lier
60,Mechelsesteenweg 365,2019-03-18,12:00:00,36,20,16,FMN GV 05 Lier
60,Mechelsesteenweg 365,2019-03-18,13:00:00,38,24,14,FMN GV 05 Lier
60,Mechelsesteenweg 365,2019-03-18,14:00:00,90,52,38,FMN GV 05 Lier
60,Mechelsesteenweg 365,2019-03-18,15:00:00,70,44,26,FMN GV 05 Lier
60,Mechelsesteenweg 365,2019-03-18,16:00:00,218,72,146,FMN GV 05 Lier
60,Mechelsesteenweg 365,2019-03-18,17:00:00,110,76,34,FMN GV 05 Lier
60,Mechelsesteenweg 365,2019-03-18,18:00:00,46,22,24,FMN GV 05 Lier
60,Mechelsesteenweg 365,2019-03-18,19:00:00,20,10,10,FMN GV 05 Lier
60,Mechelsesteenweg 365,2019-03-18,20:00:00,4,0,4,FMN GV 05 Lier
60,Mechelsesteenweg 365,2019-03-18,21:00:00,2,0,2,FMN GV 05 Lier
60,Mechelsesteenweg 365,2019-03-18,22:00:00,4,0,4,FMN GV 05 Lier
60,Mechelsesteenweg 365,2019-03-18,23:00:00,0,0,0,FMN GV 05 Lier
60,Mechelsesteenweg 365,2019-03-19,00:00:00,0,0,0,FMN GV 05 Lier
60,Mechelsesteenweg 365,2019-03-19,01:00:00,0,0,0,FMN GV 05 Lier
60,Mechelsesteenweg 365,2019-03-19,02:00:00,0,0,0,FMN GV 05 Lier
60,Mechelsesteenweg 365,2019-03-19,03:00:00,2,0,2,FMN GV 05 Lier
60,Mechelsesteenweg 365,2019-03-19,04:00:00,2,0,2,FMN GV 05 Lier
60,Mechelsesteenweg 365,2019-03-19,05:00:00,6,2,4,FMN GV 05 Lier
60,Mechelsesteenweg 365,2019-03-19,06:00:00,26,12,14,FMN GV 05 Lier
60,Mechelsesteenweg 365,2019-03-19,07:00:00,160,80,80,FMN GV 05 Lier
60,Mechelsesteenweg 365,2019-03-19,08:00:00,120,66,54,FMN GV 05 Lier
60,Mechelsesteenweg 365,2019-03-19,09:00:00,62,30,32,FMN GV 05 Lier
60,Mechelsesteenweg 365,2019-03-19,10:00:00,98,48,50,FMN GV 05 Lier
60,Mechelsesteenweg 365,2019-03-19,11:00:00,86,46,40,FMN GV 05 Lier
60,Mechelsesteenweg 365,2019-03-19,12:00:00,76,36,40,FMN GV 05 Lier
60,Mechelsesteenweg 365,2019-03-19,13:00:00,188,96,92,FMN GV 05 Lier
60,Mechelsesteenweg 365,2019-03-19,14:00:00,128,70,58,FMN GV 05 Lier
60,Mechelsesteenweg 365,2019-03-19,15:00:00,146,70,76,FMN GV 05 Lier
60,Mechelsesteenweg 365,2019-03-19,16:00:00,192,76,116,FMN GV 05 Lier
60,Mechelsesteenweg 365,2019-03-19,17:00:00,136,90,46,FMN GV 05 Lier
60,Mechelsesteenweg 365,2019-03-19,18:00:00,78,34,44,FMN GV 05 Lier
60,Mechelsesteenweg 365,2019-03-19,19:00:00,28,18,10,FMN GV 05 Lier
60,Mechelsesteenweg 365,2019-03-19,20:00:00,12,4,8,FMN GV 05 Lier
60,Mechelsesteenweg 365,2019-03-19,21:00:00,10,6,4,FMN GV 05 Lier
60,Mechelsesteenweg 365,2019-03-19,22:00:00,8,4,4,FMN GV 05 Lier
60,Mechelsesteenweg 365,2019-03-19,23:00:00,2,2,0,FMN GV 05 Lier
60,Mechelsesteenweg 365,2019-03-20,00:00:00,0,0,0,FMN GV 05 Lier
60,Mechelsesteenweg 365,2019-03-20,01:00:00,0,0,0,FMN GV 05 Lier
60,Mechelsesteenweg 365,2019-03-20,02:00:00,0,0,0,FMN GV 05 Lier
60,Mechelsesteenweg 365,2019-03-20,03:00:00,0,0,0,FMN GV 05 Lier
60,Mechelsesteenweg 365,2019-03-20,04:00:00,4,0,4,FMN GV 05 Lier
60,Mechelsesteenweg 365,2019-03-20,05:00:00,4,0,4,FMN GV 05 Lier
60,Mechelsesteenweg 365,2019-03-20,06:00:00,16,0,16,FMN GV 05 Lier
60,Mechelsesteenweg 365,2019-03-20,07:00:00,108,58,50,FMN GV 05 Lier
60,Mechelsesteenweg 365,2019-03-20,08:00:00,98,60,38,FMN GV 05 Lier
60,Mechelsesteenweg 365,2019-03-20,09:00:00,66,36,30,FMN GV 05 Lier
60,Mechelsesteenweg 365,2019-03-20,10:00:00,64,12,52,FMN GV 05 Lier
60,Mechelsesteenweg 365,2019-03-20,11:00:00,78,16,62,FMN GV 05 Lier
60,Mechelsesteenweg 365,2019-03-20,12:00:00,106,36,70,FMN GV 05 Lier
60,Mechelsesteenweg 365,2019-03-20,13:00:00,122,56,66,FMN GV 05 Lier
60,Mechelsesteenweg 365,2019-03-20,14:00:00,140,58,82,FMN GV 05 Lier
60,Mechelsesteenweg 365,2019-03-20,15:00:00,128,64,64,FMN GV 05 Lier
60,Mechelsesteenweg 365,2019-03-20,16:00:00,134,70,64,FMN GV 05 Lier
60,Mechelsesteenweg 365,2019-03-20,17:00:00,142,92,50,FMN GV 05 Lier
60,Mechelsesteenweg 365,2019-03-20,18:00:00,72,38,34,FMN GV 05 Lier
60,Mechelsesteenweg 365,2019-03-20,19:00:00,34,20,14,FMN GV 05 Lier
60,Mechelsesteenweg 365,2019-03-20,20:00:00,18,10,8,FMN GV 05 Lier
60,Mechelsesteenweg 365,2019-03-20,21:00:00,8,4,4,FMN GV 05 Lier
60,Mechelsesteenweg 365,2019-03-20,22:00:00,4,4,0,FMN GV 05 Lier
60,Mechelsesteenweg 365,2019-03-20,23:00:00,0,0,0,FMN GV 05 Lier
60,Mechelsesteenweg 365,2019-03-21,00:00:00,0,0,0,FMN GV 05 Lier
60,Mechelsesteenweg 365,2019-03-21,01:00:00,0,0,0,FMN GV 05 Lier
60,Mechelsesteenweg 365,2019-03-21,02:00:00,0,0,0,FMN GV 05 Lier
60,Mechelsesteenweg 365,2019-03-21,03:00:00,0,0,0,FMN GV 05 Lier
60,Mechelsesteenweg 365,2019-03-21,04:00:00,6,2,4,FMN GV 05 Lier
60,Mechelsesteenweg 365,2019-03-21,05:00:00,10,2,8,FMN GV 05 Lier
60,Mechelsesteenweg 365,2019-03-21,06:00:00,24,10,14,FMN GV 05 Lier
60,Mechelsesteenweg 365,2019-03-21,07:00:00,154,80,74,FMN GV 05 Lier
60,Mechelsesteenweg 365,2019-03-21,08:00:00,122,72,50,FMN GV 05 Lier
60,Mechelsesteenweg 365,2019-03-21,09:00:00,60,26,34,FMN GV 05 Lier
60,Mechelsesteenweg 365,2019-03-21,10:00:00,90,56,34,FMN GV 05 Lier
60,Mechelsesteenweg 365,2019-03-21,11:00:00,96,48,48,FMN GV 05 Lier
60,Mechelsesteenweg 365,2019-03-21,12:00:00,108,46,62,FMN GV 05 Lier
60,Mechelsesteenweg 365,2019-03-21,13:00:00,198,112,86,FMN GV 05 Lier
60,Mechelsesteenweg 365,2019-03-21,14:00:00,218,88,130,FMN GV 05 Lier
60,Mechelsesteenweg 365,2019-03-21,15:00:00,238,132,106,FMN GV 05 Lier
60,Mechelsesteenweg 365,2019-03-21,16:00:00,290,110,180,FMN GV 05 Lier
60,Mechelsesteenweg 365,2019-03-21,17:00:00,190,106,84,FMN GV 05 Lier
60,Mechelsesteenweg 365,2019-03-21,18:00:00,114,58,56,FMN GV 05 Lier
60,Mechelsesteenweg 365,2019-03-21,19:00:00,48,28,20,FMN GV 05 Lier
60,Mechelsesteenweg 365,2019-03-21,20:00:00,18,8,10,FMN GV 05 Lier
60,Mechelsesteenweg 365,2019-03-21,21:00:00,8,8,0,FMN GV 05 Lier
60,Mechelsesteenweg 365,2019-03-21,22:00:00,6,4,2,FMN GV 05 Lier
60,Mechelsesteenweg 365,2019-03-21,23:00:00,4,0,4,FMN GV 05 Lier
60,Mechelsesteenweg 365,2019-03-22,00:00:00,0,0,0,FMN GV 05 Lier
60,Mechelsesteenweg 365,2019-03-22,01:00:00,0,0,0,FMN GV 05 Lier
60,Mechelsesteenweg 365,2019-03-22,02:00:00,0,0,0,FMN GV 05 Lier
60,Mechelsesteenweg 365,2019-03-22,03:00:00,0,0,0,FMN GV 05 Lier
60,Mechelsesteenweg 365,2019-03-22,04:00:00,6,2,4,FMN GV 05 Lier
60,Mechelsesteenweg 365,2019-03-22,05:00:00,4,2,2,FMN GV 05 Lier
60,Mechelsesteenweg 365,2019-03-22,06:00:00,10,4,6,FMN GV 05 Lier
60,Mechelsesteenweg 365,2019-03-22,07:00:00,140,72,68,FMN GV 05 Lier
60,Mechelsesteenweg 365,2019-03-22,08:00:00,144,92,52,FMN GV 05 Lier
60,Mechelsesteenweg 365,2019-03-22,09:00:00,46,28,18,FMN GV 05 Lier
60,Mechelsesteenweg 365,2019-03-22,10:00:00,76,48,28,FMN GV 05 Lier
60,Mechelsesteenweg 365,2019-03-22,11:00:00,146,86,60,FMN GV 05 Lier
60,Mechelsesteenweg 365,2019-03-22,12:00:00,190,108,82,FMN GV 05 Lier
60,Mechelsesteenweg 365,2019-03-22,13:00:00,278,156,122,FMN GV 05 Lier
60,Mechelsesteenweg 365,2019-03-22,14:00:00,368,190,178,FMN GV 05 Lier
60,Mechelsesteenweg 365,2019-03-22,15:00:00,402,190,212,FMN GV 05 Lier
60,Mechelsesteenweg 365,2019-03-22,16:00:00,362,126,236,FMN GV 05 Lier
60,Mechelsesteenweg 365,2019-03-22,17:00:00,208,96,112,FMN GV 05 Lier
60,Mechelsesteenweg 365,2019-03-22,18:00:00,104,38,66,FMN GV 05 Lier
60,Mechelsesteenweg 365,2019-03-22,19:00:00,26,10,16,FMN GV 05 Lier
60,Mechelsesteenweg 365,2019-03-22,20:00:00,6,4,2,FMN GV 05 Lier
60,Mechelsesteenweg 365,2019-03-22,21:00:00,10,4,6,FMN GV 05 Lier
60,Mechelsesteenweg 365,2019-03-22,22:00:00,4,4,0,FMN GV 05 Lier
60,Mechelsesteenweg 365,2019-03-22,23:00:00,12,2,10,FMN GV 05 Lier
60,Mechelsesteenweg 365,2019-03-23,00:00:00,0,0,0,FMN GV 05 Lier
60,Mechelsesteenweg 365,2019-03-23,01:00:00,2,0,2,FMN GV 05 Lier
60,Mechelsesteenweg 365,2019-03-23,02:00:00,2,2,0,FMN GV 05 Lier
60,Mechelsesteenweg 365,2019-03-23,03:00:00,0,0,0,FMN GV 05 Lier
60,Mechelsesteenweg 365,2019-03-23,04:00:00,0,0,0,FMN GV 05 Lier
60,Mechelsesteenweg 365,2019-03-23,05:00:00,0,0,0,FMN GV 05 Lier
60,Mechelsesteenweg 365,2019-03-23,06:00:00,4,2,2,FMN GV 05 Lier
60,Mechelsesteenweg 365,2019-03-23,07:00:00,14,4,10,FMN GV 05 Lier
60,Mechelsesteenweg 365,2019-03-23,08:00:00,26,12,14,FMN GV 05 Lier
60,Mechelsesteenweg 365,2019-03-23,09:00:00,114,68,46,FMN GV 05 Lier
60,Mechelsesteenweg 365,2019-03-23,10:00:00,138,76,62,FMN GV 05 Lier
60,Mechelsesteenweg 365,2019-03-23,11:00:00,108,50,58,FMN GV 05 Lier
60,Mechelsesteenweg 365,2019-03-23,12:00:00,70,24,46,FMN GV 05 Lier
60,Mechelsesteenweg 365,2019-03-23,13:00:00,96,38,58,FMN GV 05 Lier
60,Mechelsesteenweg 365,2019-03-23,14:00:00,160,80,80,FMN GV 05 Lier
60,Mechelsesteenweg 365,2019-03-23,15:00:00,162,66,96,FMN GV 05 Lier
60,Mechelsesteenweg 365,2019-03-23,16:00:00,84,42,42,FMN GV 05 Lier
60,Mechelsesteenweg 365,2019-03-23,17:00:00,36,18,18,FMN GV 05 Lier
60,Mechelsesteenweg 365,2019-03-23,18:00:00,18,6,12,FMN GV 05 Lier
60,Mechelsesteenweg 365,2019-03-23,19:00:00,14,4,10,FMN GV 05 Lier
60,Mechelsesteenweg 365,2019-03-23,20:00:00,6,0,6,FMN GV 05 Lier
60,Mechelsesteenweg 365,2019-03-23,21:00:00,0,0,0,FMN GV 05 Lier
60,Mechelsesteenweg 365,2019-03-23,22:00:00,10,2,8,FMN GV 05 Lier
60,Mechelsesteenweg 365,2019-03-23,23:00:00,2,0,2,FMN GV 05 Lier
60,Mechelsesteenweg 365,2019-03-24,00:00:00,0,0,0,FMN GV 05 Lier
60,Mechelsesteenweg 365,2019-03-24,01:00:00,0,0,0,FMN GV 05 Lier
60,Mechelsesteenweg 365,2019-03-24,02:00:00,0,0,0,FMN GV 05 Lier
60,Mechelsesteenweg 365,2019-03-24,03:00:00,0,0,0,FMN GV 05 Lier
60,Mechelsesteenweg 365,2019-03-24,04:00:00,0,0,0,FMN GV 05 Lier
60,Mechelsesteenweg 365,2019-03-24,05:00:00,0,0,0,FMN GV 05 Lier
60,Mechelsesteenweg 365,2019-03-24,06:00:00,4,0,4,FMN GV 05 Lier
60,Mechelsesteenweg 365,2019-03-24,07:00:00,16,8,8,FMN GV 05 Lier
60,Mechelsesteenweg 365,2019-03-24,08:00:00,40,24,16,FMN GV 05 Lier
60,Mechelsesteenweg 365,2019-03-24,09:00:00,158,88,70,FMN GV 05 Lier
60,Mechelsesteenweg 365,2019-03-24,10:00:00,332,162,170,FMN GV 05 Lier
60,Mechelsesteenweg 365,2019-03-24,11:00:00,350,146,204,FMN GV 05 Lier
60,Mechelsesteenweg 365,2019-03-24,12:00:00,212,82,130,FMN GV 05 Lier
60,Mechelsesteenweg 365,2019-03-24,13:00:00,240,124,116,FMN GV 05 Lier
60,Mechelsesteenweg 365,2019-03-24,14:00:00,370,214,156,FMN GV 05 Lier
60,Mechelsesteenweg 365,2019-03-24,15:00:00,378,180,198,FMN GV 05 Lier
60,Mechelsesteenweg 365,2019-03-24,16:00:00,258,84,174,FMN GV 05 Lier
60,Mechelsesteenweg 365,2019-03-24,17:00:00,174,58,116,FMN GV 05 Lier
60,Mechelsesteenweg 365,2019-03-24,18:00:00,36,10,26,FMN GV 05 Lier
60,Mechelsesteenweg 365,2019-03-24,19:00:00,10,6,4,FMN GV 05 Lier
60,Mechelsesteenweg 365,2019-03-24,20:00:00,6,2,4,FMN GV 05 Lier
60,Mechelsesteenweg 365,2019-03-24,21:00:00,4,0,4,FMN GV 05 Lier
60,Mechelsesteenweg 365,2019-03-24,22:00:00,2,2,0,FMN GV 05 Lier
60,Mechelsesteenweg 365,2019-03-24,23:00:00,2,0,2,FMN GV 05 Lier
60,Mechelsesteenweg 365,2019-03-25,00:00:00,0,0,0,FMN GV 05 Lier
60,Mechelsesteenweg 365,2019-03-25,01:00:00,0,0,0,FMN GV 05 Lier
60,Mechelsesteenweg 365,2019-03-25,02:00:00,0,0,0,FMN GV 05 Lier
60,Mechelsesteenweg 365,2019-03-25,03:00:00,0,0,0,FMN GV 05 Lier
60,Mechelsesteenweg 365,2019-03-25,04:00:00,6,0,6,FMN GV 05 Lier
60,Mechelsesteenweg 365,2019-03-25,05:00:00,2,0,2,FMN GV 05 Lier
60,Mechelsesteenweg 365,2019-03-25,06:00:00,18,4,14,FMN GV 05 Lier
60,Mechelsesteenweg 365,2019-03-25,07:00:00,152,86,66,FMN GV 05 Lier
60,Mechelsesteenweg 365,2019-03-25,08:00:00,104,76,28,FMN GV 05 Lier
60,Mechelsesteenweg 365,2019-03-25,09:00:00,44,14,30,FMN GV 05 Lier
60,Mechelsesteenweg 365,2019-03-25,10:00:00,24,10,14,FMN GV 05 Lier
60,Mechelsesteenweg 365,2019-03-25,11:00:00,22,12,10,FMN GV 05 Lier
60,Mechelsesteenweg 365,2019-03-25,12:00:00,32,14,18,FMN GV 05 Lier
60,Mechelsesteenweg 365,2019-03-25,13:00:00,18,4,14,FMN GV 05 Lier
60,Mechelsesteenweg 365,2019-03-25,14:00:00,22,12,10,FMN GV 05 Lier
60,Mechelsesteenweg 365,2019-03-25,15:00:00,44,30,14,FMN GV 05 Lier
60,Mechelsesteenweg 365,2019-03-25,16:00:00,140,48,92,FMN GV 05 Lier
60,Mechelsesteenweg 365,2019-03-25,17:00:00,88,48,40,FMN GV 05 Lier
60,Mechelsesteenweg 365,2019-03-25,18:00:00,34,16,18,FMN GV 05 Lier
60,Mechelsesteenweg 365,2019-03-25,19:00:00,6,6,0,FMN GV 05 Lier
60,Mechelsesteenweg 365,2019-03-25,20:00:00,10,4,6,FMN GV 05 Lier
60,Mechelsesteenweg 365,2019-03-25,21:00:00,0,0,0,FMN GV 05 Lier
60,Mechelsesteenweg 365,2019-03-25,22:00:00,6,4,2,FMN GV 05 Lier
60,Mechelsesteenweg 365,2019-03-25,23:00:00,2,0,2,FMN GV 05 Lier
60,Mechelsesteenweg 365,2019-03-26,00:00:00,0,0,0,FMN GV 05 Lier
60,Mechelsesteenweg 365,2019-03-26,01:00:00,0,0,0,FMN GV 05 Lier
60,Mechelsesteenweg 365,2019-03-26,02:00:00,0,0,0,FMN GV 05 Lier
60,Mechelsesteenweg 365,2019-03-26,03:00:00,2,0,2,FMN GV 05 Lier
60,Mechelsesteenweg 365,2019-03-26,04:00:00,4,0,4,FMN GV 05 Lier
60,Mechelsesteenweg 365,2019-03-26,05:00:00,6,4,2,FMN GV 05 Lier
60,Mechelsesteenweg 365,2019-03-26,06:00:00,14,4,10,FMN GV 05 Lier
60,Mechelsesteenweg 365,2019-03-26,07:00:00,172,84,88,FMN GV 05 Lier
60,Mechelsesteenweg 365,2019-03-26,08:00:00,134,86,48,FMN GV 05 Lier
60,Mechelsesteenweg 365,2019-03-26,09:00:00,64,32,32,FMN GV 05 Lier
60,Mechelsesteenweg 365,2019-03-26,10:00:00,76,42,34,FMN GV 05 Lier
60,Mechelsesteenweg 365,2019-03-26,11:00:00,96,18,78,FMN GV 05 Lier
60,Mechelsesteenweg 365,2019-03-26,12:00:00,108,34,74,FMN GV 05 Lier
60,Mechelsesteenweg 365,2019-03-26,13:00:00,102,64,38,FMN GV 05 Lier
60,Mechelsesteenweg 365,2019-03-26,14:00:00,98,58,40,FMN GV 05 Lier
60,Mechelsesteenweg 365,2019-03-26,15:00:00,114,58,56,FMN GV 05 Lier
60,Mechelsesteenweg 365,2019-03-26,16:00:00,218,78,140,FMN GV 05 Lier
60,Mechelsesteenweg 365,2019-03-26,17:00:00,174,112,62,FMN GV 05 Lier
60,Mechelsesteenweg 365,2019-03-26,18:00:00,68,42,26,FMN GV 05 Lier
60,Mechelsesteenweg 365,2019-03-26,19:00:00,26,6,20,FMN GV 05 Lier
60,Mechelsesteenweg 365,2019-03-26,20:00:00,12,8,4,FMN GV 05 Lier
60,Mechelsesteenweg 365,2019-03-26,21:00:00,4,2,2,FMN GV 05 Lier
60,Mechelsesteenweg 365,2019-03-26,22:00:00,0,0,0,FMN GV 05 Lier
60,Mechelsesteenweg 365,2019-03-26,23:00:00,2,2,0,FMN GV 05 Lier
60,Mechelsesteenweg 365,2019-03-27,00:00:00,0,0,0,FMN GV 05 Lier
60,Mechelsesteenweg 365,2019-03-27,01:00:00,0,0,0,FMN GV 05 Lier
60,Mechelsesteenweg 365,2019-03-27,02:00:00,0,0,0,FMN GV 05 Lier
60,Mechelsesteenweg 365,2019-03-27,03:00:00,2,0,2,FMN GV 05 Lier
60,Mechelsesteenweg 365,2019-03-27,04:00:00,4,0,4,FMN GV 05 Lier
60,Mechelsesteenweg 365,2019-03-27,05:00:00,6,2,4,FMN GV 05 Lier
60,Mechelsesteenweg 365,2019-03-27,06:00:00,22,6,16,FMN GV 05 Lier
60,Mechelsesteenweg 365,2019-03-27,07:00:00,168,82,86,FMN GV 05 Lier
60,Mechelsesteenweg 365,2019-03-27,08:00:00,140,84,56,FMN GV 05 Lier
60,Mechelsesteenweg 365,2019-03-27,09:00:00,56,18,38,FMN GV 05 Lier
60,Mechelsesteenweg 365,2019-03-27,10:00:00,88,32,56,FMN GV 05 Lier
60,Mechelsesteenweg 365,2019-03-27,11:00:00,78,42,36,FMN GV 05 Lier
60,Mechelsesteenweg 365,2019-03-27,12:00:00,152,52,100,FMN GV 05 Lier
60,Mechelsesteenweg 365,2019-03-27,13:00:00,106,46,60,FMN GV 05 Lier
60,Mechelsesteenweg 365,2019-03-27,14:00:00,126,74,52,FMN GV 05 Lier
60,Mechelsesteenweg 365,2019-03-27,15:00:00,130,64,66,FMN GV 05 Lier
60,Mechelsesteenweg 365,2019-03-27,16:00:00,168,82,86,FMN GV 05 Lier
60,Mechelsesteenweg 365,2019-03-27,17:00:00,152,92,60,FMN GV 05 Lier
60,Mechelsesteenweg 365,2019-03-27,18:00:00,88,62,26,FMN GV 05 Lier
60,Mechelsesteenweg 365,2019-03-27,19:00:00,62,44,18,FMN GV 05 Lier
60,Mechelsesteenweg 365,2019-03-27,20:00:00,4,4,0,FMN GV 05 Lier
60,Mechelsesteenweg 365,2019-03-27,21:00:00,16,4,12,FMN GV 05 Lier
60,Mechelsesteenweg 365,2019-03-27,22:00:00,4,2,2,FMN GV 05 Lier
60,Mechelsesteenweg 365,2019-03-27,23:00:00,4,2,2,FMN GV 05 Lier
60,Mechelsesteenweg 365,2019-03-28,00:00:00,0,0,0,FMN GV 05 Lier
60,Mechelsesteenweg 365,2019-03-28,01:00:00,0,0,0,FMN GV 05 Lier
60,Mechelsesteenweg 365,2019-03-28,02:00:00,0,0,0,FMN GV 05 Lier
60,Mechelsesteenweg 365,2019-03-28,03:00:00,2,0,2,FMN GV 05 Lier
60,Mechelsesteenweg 365,2019-03-28,04:00:00,6,2,4,FMN GV 05 Lier
60,Mechelsesteenweg 365,2019-03-28,05:00:00,10,4,6,FMN GV 05 Lier
60,Mechelsesteenweg 365,2019-03-28,06:00:00,32,10,22,FMN GV 05 Lier
60,Mechelsesteenweg 365,2019-03-28,07:00:00,152,78,74,FMN GV 05 Lier
60,Mechelsesteenweg 365,2019-03-28,08:00:00,110,58,52,FMN GV 05 Lier
60,Mechelsesteenweg 365,2019-03-28,09:00:00,62,22,40,FMN GV 05 Lier
60,Mechelsesteenweg 365,2019-03-28,10:00:00,90,36,54,FMN GV 05 Lier
60,Mechelsesteenweg 365,2019-03-28,11:00:00,90,42,48,FMN GV 05 Lier
60,Mechelsesteenweg 365,2019-03-28,12:00:00,130,54,76,FMN GV 05 Lier
60,Mechelsesteenweg 365,2019-03-28,13:00:00,90,46,44,FMN GV 05 Lier
60,Mechelsesteenweg 365,2019-03-28,14:00:00,142,70,72,FMN GV 05 Lier
60,Mechelsesteenweg 365,2019-03-28,15:00:00,162,72,90,FMN GV 05 Lier
60,Mechelsesteenweg 365,2019-03-28,16:00:00,130,52,78,FMN GV 05 Lier
60,Mechelsesteenweg 365,2019-03-28,17:00:00,150,94,56,FMN GV 05 Lier
60,Mechelsesteenweg 365,2019-03-28,18:00:00,74,42,32,FMN GV 05 Lier
60,Mechelsesteenweg 365,2019-03-28,19:00:00,50,34,16,FMN GV 05 Lier
60,Mechelsesteenweg 365,2019-03-28,20:00:00,14,6,8,FMN GV 05 Lier
60,Mechelsesteenweg 365,2019-03-28,21:00:00,4,2,2,FMN GV 05 Lier
60,Mechelsesteenweg 365,2019-03-28,22:00:00,8,2,6,FMN GV 05 Lier
60,Mechelsesteenweg 365,2019-03-28,23:00:00,0,0,0,FMN GV 05 Lier
60,Mechelsesteenweg 365,2019-03-29,00:00:00,0,0,0,FMN GV 05 Lier
60,Mechelsesteenweg 365,2019-03-29,01:00:00,0,0,0,FMN GV 05 Lier
60,Mechelsesteenweg 365,2019-03-29,02:00:00,0,0,0,FMN GV 05 Lier
60,Mechelsesteenweg 365,2019-03-29,03:00:00,4,0,4,FMN GV 05 Lier
60,Mechelsesteenweg 365,2019-03-29,04:00:00,2,2,0,FMN GV 05 Lier
60,Mechelsesteenweg 365,2019-03-29,05:00:00,8,2,6,FMN GV 05 Lier
60,Mechelsesteenweg 365,2019-03-29,06:00:00,28,8,20,FMN GV 05 Lier
60,Mechelsesteenweg 365,2019-03-29,07:00:00,156,92,64,FMN GV 05 Lier
60,Mechelsesteenweg 365,2019-03-29,08:00:00,116,60,56,FMN GV 05 Lier
60,Mechelsesteenweg 365,2019-03-29,09:00:00,98,40,58,FMN GV 05 Lier
60,Mechelsesteenweg 365,2019-03-29,10:00:00,178,86,92,FMN GV 05 Lier
60,Mechelsesteenweg 365,2019-03-29,11:00:00,210,118,92,FMN GV 05 Lier
60,Mechelsesteenweg 365,2019-03-29,12:00:00,174,50,124,FMN GV 05 Lier
60,Mechelsesteenweg 365,2019-03-29,13:00:00,256,108,148,FMN GV 05 Lier
60,Mechelsesteenweg 365,2019-03-29,14:00:00,298,146,152,FMN GV 05 Lier
60,Mechelsesteenweg 365,2019-03-29,15:00:00,292,126,166,FMN GV 05 Lier
60,Mechelsesteenweg 365,2019-03-29,16:00:00,282,140,142,FMN GV 05 Lier
60,Mechelsesteenweg 365,2019-03-29,17:00:00,176,76,100,FMN GV 05 Lier
60,Mechelsesteenweg 365,2019-03-29,18:00:00,78,54,24,FMN GV 05 Lier
60,Mechelsesteenweg 365,2019-03-29,19:00:00,42,10,32,FMN GV 05 Lier
60,Mechelsesteenweg 365,2019-03-29,20:00:00,14,2,12,FMN GV 05 Lier
60,Mechelsesteenweg 365,2019-03-29,21:00:00,10,0,10,FMN GV 05 Lier
60,Mechelsesteenweg 365,2019-03-29,22:00:00,10,6,4,FMN GV 05 Lier
60,Mechelsesteenweg 365,2019-03-29,23:00:00,0,0,0,FMN GV 05 Lier
60,Mechelsesteenweg 365,2019-03-30,00:00:00,8,2,6,FMN GV 05 Lier
60,Mechelsesteenweg 365,2019-03-30,01:00:00,2,2,0,FMN GV 05 Lier
60,Mechelsesteenweg 365,2019-03-30,02:00:00,0,0,0,FMN GV 05 Lier
60,Mechelsesteenweg 365,2019-03-30,03:00:00,0,0,0,FMN GV 05 Lier
60,Mechelsesteenweg 365,2019-03-30,04:00:00,4,0,4,FMN GV 05 Lier
60,Mechelsesteenweg 365,2019-03-30,05:00:00,0,0,0,FMN GV 05 Lier
60,Mechelsesteenweg 365,2019-03-30,06:00:00,8,4,4,FMN GV 05 Lier
60,Mechelsesteenweg 365,2019-03-30,07:00:00,8,4,4,FMN GV 05 Lier
60,Mechelsesteenweg 365,2019-03-30,08:00:00,42,20,22,FMN GV 05 Lier
60,Mechelsesteenweg 365,2019-03-30,09:00:00,126,74,52,FMN GV 05 Lier
60,Mechelsesteenweg 365,2019-03-30,10:00:00,234,130,104,FMN GV 05 Lier
60,Mechelsesteenweg 365,2019-03-30,11:00:00,228,110,118,FMN GV 05 Lier
60,Mechelsesteenweg 365,2019-03-30,12:00:00,278,158,120,FMN GV 05 Lier
60,Mechelsesteenweg 365,2019-03-30,13:00:00,418,234,184,FMN GV 05 Lier
60,Mechelsesteenweg 365,2019-03-30,14:00:00,558,262,296,FMN GV 05 Lier
60,Mechelsesteenweg 365,2019-03-30,15:00:00,452,186,266,FMN GV 05 Lier
60,Mechelsesteenweg 365,2019-03-30,16:00:00,420,140,280,FMN GV 05 Lier
60,Mechelsesteenweg 365,2019-03-30,17:00:00,182,38,144,FMN GV 05 Lier
60,Mechelsesteenweg 365,2019-03-30,18:00:00,50,28,22,FMN GV 05 Lier
60,Mechelsesteenweg 365,2019-03-30,19:00:00,42,12,30,FMN GV 05 Lier
60,Mechelsesteenweg 365,2019-03-30,20:00:00,10,2,8,FMN GV 05 Lier
60,Mechelsesteenweg 365,2019-03-30,21:00:00,6,6,0,FMN GV 05 Lier
60,Mechelsesteenweg 365,2019-03-30,22:00:00,24,14,10,FMN GV 05 Lier
60,Mechelsesteenweg 365,2019-03-30,23:00:00,4,2,2,FMN GV 05 Lier
60,Mechelsesteenweg 365,2019-03-31,00:00:00,2,2,0,FMN GV 05 Lier
60,Mechelsesteenweg 365,2019-03-31,01:00:00,0,0,0,FMN GV 05 Lier
60,Mechelsesteenweg 365,2019-03-31,02:00:00,0,0,0,FMN GV 05 Lier
60,Mechelsesteenweg 365,2019-03-31,03:00:00,22,0,22,FMN GV 05 Lier
60,Mechelsesteenweg 365,2019-03-31,04:00:00,0,0,0,FMN GV 05 Lier
60,Mechelsesteenweg 365,2019-03-31,05:00:00,0,0,0,FMN GV 05 Lier
60,Mechelsesteenweg 365,2019-03-31,06:00:00,0,0,0,FMN GV 05 Lier
60,Mechelsesteenweg 365,2019-03-31,07:00:00,6,2,4,FMN GV 05 Lier
60,Mechelsesteenweg 365,2019-03-31,08:00:00,6,4,2,FMN GV 05 Lier
60,Mechelsesteenweg 365,2019-03-31,09:00:00,78,30,48,FMN GV 05 Lier
60,Mechelsesteenweg 365,2019-03-31,10:00:00,252,126,126,FMN GV 05 Lier
60,Mechelsesteenweg 365,2019-03-31,11:00:00,272,122,150,FMN GV 05 Lier
60,Mechelsesteenweg 365,2019-03-31,12:00:00,140,38,102,FMN GV 05 Lier
60,Mechelsesteenweg 365,2019-03-31,13:00:00,130,60,70,FMN GV 05 Lier
60,Mechelsesteenweg 365,2019-03-31,14:00:00,198,90,108,FMN GV 05 Lier
60,Mechelsesteenweg 365,2019-03-31,15:00:00,140,50,90,FMN GV 05 Lier
60,Mechelsesteenweg 365,2019-03-31,16:00:00,168,60,108,FMN GV 05 Lier
60,Mechelsesteenweg 365,2019-03-31,17:00:00,84,40,44,FMN GV 05 Lier
60,Mechelsesteenweg 365,2019-03-31,18:00:00,54,24,30,FMN GV 05 Lier
60,Mechelsesteenweg 365,2019-03-31,19:00:00,18,12,6,FMN GV 05 Lier
60,Mechelsesteenweg 365,2019-03-31,20:00:00,4,4,0,FMN GV 05 Lier
60,Mechelsesteenweg 365,2019-03-31,21:00:00,4,0,4,FMN GV 05 Lier
60,Mechelsesteenweg 365,2019-03-31,22:00:00,4,0,4,FMN GV 05 Lier
60,Mechelsesteenweg 365,2019-03-31,23:00:00,2,0,2,FMN GV 05 Lier
60,Mechelsesteenweg 365,2019-04-01,00:00:00,0,0,0,FMN GV 05 Lier
60,Mechelsesteenweg 365,2019-04-01,01:00:00,0,0,0,FMN GV 05 Lier
60,Mechelsesteenweg 365,2019-04-01,02:00:00,0,0,0,FMN GV 05 Lier
60,Mechelsesteenweg 365,2019-04-01,03:00:00,0,0,0,FMN GV 05 Lier
60,Mechelsesteenweg 365,2019-04-01,04:00:00,4,2,2,FMN GV 05 Lier
60,Mechelsesteenweg 365,2019-04-01,05:00:00,6,0,6,FMN GV 05 Lier
60,Mechelsesteenweg 365,2019-04-01,06:00:00,16,2,14,FMN GV 05 Lier
60,Mechelsesteenweg 365,2019-04-01,07:00:00,136,62,74,FMN GV 05 Lier
60,Mechelsesteenweg 365,2019-04-01,08:00:00,138,82,56,FMN GV 05 Lier
60,Mechelsesteenweg 365,2019-04-01,09:00:00,60,36,24,FMN GV 05 Lier
60,Mechelsesteenweg 365,2019-04-01,10:00:00,60,20,40,FMN GV 05 Lier
60,Mechelsesteenweg 365,2019-04-01,11:00:00,92,36,56,FMN GV 05 Lier
60,Mechelsesteenweg 365,2019-04-01,12:00:00,104,34,70,FMN GV 05 Lier
60,Mechelsesteenweg 365,2019-04-01,13:00:00,150,88,62,FMN GV 05 Lier
60,Mechelsesteenweg 365,2019-04-01,14:00:00,200,84,116,FMN GV 05 Lier
60,Mechelsesteenweg 365,2019-04-01,15:00:00,182,64,118,FMN GV 05 Lier
60,Mechelsesteenweg 365,2019-04-01,16:00:00,242,118,124,FMN GV 05 Lier
60,Mechelsesteenweg 365,2019-04-01,17:00:00,190,116,74,FMN GV 05 Lier
60,Mechelsesteenweg 365,2019-04-01,18:00:00,130,50,80,FMN GV 05 Lier
60,Mechelsesteenweg 365,2019-04-01,19:00:00,84,26,58,FMN GV 05 Lier
60,Mechelsesteenweg 365,2019-04-01,20:00:00,26,14,12,FMN GV 05 Lier
60,Mechelsesteenweg 365,2019-04-01,21:00:00,2,0,2,FMN GV 05 Lier
60,Mechelsesteenweg 365,2019-04-01,22:00:00,8,0,8,FMN GV 05 Lier
60,Mechelsesteenweg 365,2019-04-01,23:00:00,10,6,4,FMN GV 05 Lier
60,Mechelsesteenweg 365,2019-04-02,00:00:00,0,0,0,FMN GV 05 Lier
60,Mechelsesteenweg 365,2019-04-02,01:00:00,0,0,0,FMN GV 05 Lier
60,Mechelsesteenweg 365,2019-04-02,02:00:00,0,0,0,FMN GV 05 Lier
60,Mechelsesteenweg 365,2019-04-02,03:00:00,0,0,0,FMN GV 05 Lier
60,Mechelsesteenweg 365,2019-04-02,04:00:00,2,0,2,FMN GV 05 Lier
60,Mechelsesteenweg 365,2019-04-02,05:00:00,12,0,12,FMN GV 05 Lier
60,Mechelsesteenweg 365,2019-04-02,06:00:00,22,4,18,FMN GV 05 Lier
60,Mechelsesteenweg 365,2019-04-02,07:00:00,96,40,56,FMN GV 05 Lier
60,Mechelsesteenweg 365,2019-04-02,08:00:00,94,52,42,FMN GV 05 Lier
60,Mechelsesteenweg 365,2019-04-02,09:00:00,80,40,40,FMN GV 05 Lier
60,Mechelsesteenweg 365,2019-04-02,10:00:00,58,38,20,FMN GV 05 Lier
60,Mechelsesteenweg 365,2019-04-02,11:00:00,72,30,42,FMN GV 05 Lier
60,Mechelsesteenweg 365,2019-04-02,12:00:00,64,22,42,FMN GV 05 Lier
60,Mechelsesteenweg 365,2019-04-02,13:00:00,98,62,36,FMN GV 05 Lier
60,Mechelsesteenweg 365,2019-04-02,14:00:00,46,18,28,FMN GV 05 Lier
60,Mechelsesteenweg 365,2019-04-02,15:00:00,82,42,40,FMN GV 05 Lier
60,Mechelsesteenweg 365,2019-04-02,16:00:00,108,36,72,FMN GV 05 Lier
60,Mechelsesteenweg 365,2019-04-02,17:00:00,62,34,28,FMN GV 05 Lier
60,Mechelsesteenweg 365,2019-04-02,18:00:00,26,18,8,FMN GV 05 Lier
60,Mechelsesteenweg 365,2019-04-02,19:00:00,12,6,6,FMN GV 05 Lier
60,Mechelsesteenweg 365,2019-04-02,20:00:00,14,8,6,FMN GV 05 Lier
60,Mechelsesteenweg 365,2019-04-02,21:00:00,8,6,2,FMN GV 05 Lier
60,Mechelsesteenweg 365,2019-04-02,22:00:00,2,2,0,FMN GV 05 Lier
60,Mechelsesteenweg 365,2019-04-02,23:00:00,2,0,2,FMN GV 05 Lier
60,Mechelsesteenweg 365,2019-04-03,00:00:00,0,0,0,FMN GV 05 Lier
60,Mechelsesteenweg 365,2019-04-03,01:00:00,0,0,0,FMN GV 05 Lier
60,Mechelsesteenweg 365,2019-04-03,02:00:00,0,0,0,FMN GV 05 Lier
60,Mechelsesteenweg 365,2019-04-03,03:00:00,0,0,0,FMN GV 05 Lier
60,Mechelsesteenweg 365,2019-04-03,04:00:00,2,0,2,FMN GV 05 Lier
60,Mechelsesteenweg 365,2019-04-03,05:00:00,2,0,2,FMN GV 05 Lier
60,Mechelsesteenweg 365,2019-04-03,06:00:00,24,6,18,FMN GV 05 Lier
60,Mechelsesteenweg 365,2019-04-03,07:00:00,84,40,44,FMN GV 05 Lier
60,Mechelsesteenweg 365,2019-04-03,08:00:00,66,38,28,FMN GV 05 Lier
60,Mechelsesteenweg 365,2019-04-03,09:00:00,38,18,20,FMN GV 05 Lier
60,Mechelsesteenweg 365,2019-04-03,10:00:00,38,16,22,FMN GV 05 Lier
60,Mechelsesteenweg 365,2019-04-03,11:00:00,38,12,26,FMN GV 05 Lier
60,Mechelsesteenweg 365,2019-04-03,12:00:00,32,12,20,FMN GV 05 Lier
60,Mechelsesteenweg 365,2019-04-03,13:00:00,30,12,18,FMN GV 05 Lier
60,Mechelsesteenweg 365,2019-04-03,14:00:00,40,12,28,FMN GV 05 Lier
60,Mechelsesteenweg 365,2019-04-03,15:00:00,34,18,16,FMN GV 05 Lier
60,Mechelsesteenweg 365,2019-04-03,16:00:00,42,24,18,FMN GV 05 Lier
60,Mechelsesteenweg 365,2019-04-03,17:00:00,64,40,24,FMN GV 05 Lier
60,Mechelsesteenweg 365,2019-04-03,18:00:00,38,20,18,FMN GV 05 Lier
60,Mechelsesteenweg 365,2019-04-03,19:00:00,14,8,6,FMN GV 05 Lier
60,Mechelsesteenweg 365,2019-04-03,20:00:00,26,12,14,FMN GV 05 Lier
60,Mechelsesteenweg 365,2019-04-03,21:00:00,8,8,0,FMN GV 05 Lier
60,Mechelsesteenweg 365,2019-04-03,22:00:00,6,2,4,FMN GV 05 Lier
60,Mechelsesteenweg 365,2019-04-03,23:00:00,0,0,0,FMN GV 05 Lier
60,Mechelsesteenweg 365,2019-04-04,00:00:00,2,2,0,FMN GV 05 Lier
60,Mechelsesteenweg 365,2019-04-04,01:00:00,2,0,2,FMN GV 05 Lier
60,Mechelsesteenweg 365,2019-04-04,02:00:00,0,0,0,FMN GV 05 Lier
60,Mechelsesteenweg 365,2019-04-04,03:00:00,2,2,0,FMN GV 05 Lier
60,Mechelsesteenweg 365,2019-04-04,04:00:00,4,2,2,FMN GV 05 Lier
60,Mechelsesteenweg 365,2019-04-04,05:00:00,6,4,2,FMN GV 05 Lier
60,Mechelsesteenweg 365,2019-04-04,06:00:00,18,8,10,FMN GV 05 Lier
60,Mechelsesteenweg 365,2019-04-04,07:00:00,88,36,52,FMN GV 05 Lier
60,Mechelsesteenweg 365,2019-04-04,08:00:00,114,40,74,FMN GV 05 Lier
60,Mechelsesteenweg 365,2019-04-04,09:00:00,58,32,26,FMN GV 05 Lier
60,Mechelsesteenweg 365,2019-04-04,10:00:00,44,16,28,FMN GV 05 Lier
60,Mechelsesteenweg 365,2019-04-04,11:00:00,86,22,64,FMN GV 05 Lier
60,Mechelsesteenweg 365,2019-04-04,12:00:00,84,44,40,FMN GV 05 Lier
60,Mechelsesteenweg 365,2019-04-04,13:00:00,92,62,30,FMN GV 05 Lier
60,Mechelsesteenweg 365,2019-04-04,14:00:00,142,56,86,FMN GV 05 Lier
60,Mechelsesteenweg 365,2019-04-04,15:00:00,104,60,44,FMN GV 05 Lier
60,Mechelsesteenweg 365,2019-04-04,16:00:00,128,76,52,FMN GV 05 Lier
60,Mechelsesteenweg 365,2019-04-04,17:00:00,126,76,50,FMN GV 05 Lier
60,Mechelsesteenweg 365,2019-04-04,18:00:00,80,42,38,FMN GV 05 Lier
60,Mechelsesteenweg 365,2019-04-04,19:00:00,98,46,52,FMN GV 05 Lier
60,Mechelsesteenweg 365,2019-04-04,20:00:00,58,16,42,FMN GV 05 Lier
60,Mechelsesteenweg 365,2019-04-04,21:00:00,4,2,2,FMN GV 05 Lier
60,Mechelsesteenweg 365,2019-04-04,22:00:00,6,4,2,FMN GV 05 Lier
60,Mechelsesteenweg 365,2019-04-04,23:00:00,4,2,2,FMN GV 05 Lier
60,Mechelsesteenweg 365,2019-04-05,00:00:00,0,0,0,FMN GV 05 Lier
60,Mechelsesteenweg 365,2019-04-05,01:00:00,0,0,0,FMN GV 05 Lier
60,Mechelsesteenweg 365,2019-04-05,02:00:00,0,0,0,FMN GV 05 Lier
60,Mechelsesteenweg 365,2019-04-05,03:00:00,0,0,0,FMN GV 05 Lier
60,Mechelsesteenweg 365,2019-04-05,04:00:00,2,2,0,FMN GV 05 Lier
60,Mechelsesteenweg 365,2019-04-05,05:00:00,2,0,2,FMN GV 05 Lier
60,Mechelsesteenweg 365,2019-04-05,06:00:00,20,10,10,FMN GV 05 Lier
60,Mechelsesteenweg 365,2019-04-05,07:00:00,118,58,60,FMN GV 05 Lier
60,Mechelsesteenweg 365,2019-04-05,08:00:00,114,76,38,FMN GV 05 Lier
60,Mechelsesteenweg 365,2019-04-05,09:00:00,76,42,34,FMN GV 05 Lier
60,Mechelsesteenweg 365,2019-04-05,10:00:00,114,50,64,FMN GV 05 Lier
60,Mechelsesteenweg 365,2019-04-05,11:00:00,94,32,62,FMN GV 05 Lier
60,Mechelsesteenweg 365,2019-04-05,12:00:00,160,48,112,FMN GV 05 Lier
60,Mechelsesteenweg 365,2019-04-05,13:00:00,166,78,88,FMN GV 05 Lier
60,Mechelsesteenweg 365,2019-04-05,14:00:00,208,102,106,FMN GV 05 Lier
60,Mechelsesteenweg 365,2019-04-05,15:00:00,296,110,186,FMN GV 05 Lier
60,Mechelsesteenweg 365,2019-04-05,16:00:00,160,72,88,FMN GV 05 Lier
60,Mechelsesteenweg 365,2019-04-05,17:00:00,128,66,62,FMN GV 05 Lier
60,Mechelsesteenweg 365,2019-04-05,18:00:00,74,46,28,FMN GV 05 Lier
60,Mechelsesteenweg 365,2019-04-05,19:00:00,32,16,16,FMN GV 05 Lier
60,Mechelsesteenweg 365,2019-04-05,20:00:00,4,0,4,FMN GV 05 Lier
60,Mechelsesteenweg 365,2019-04-05,21:00:00,20,2,18,FMN GV 05 Lier
60,Mechelsesteenweg 365,2019-04-05,22:00:00,16,10,6,FMN GV 05 Lier
60,Mechelsesteenweg 365,2019-04-05,23:00:00,6,0,6,FMN GV 05 Lier
60,Mechelsesteenweg 365,2019-04-06,00:00:00,2,2,0,FMN GV 05 Lier
60,Mechelsesteenweg 365,2019-04-06,01:00:00,0,0,0,FMN GV 05 Lier
60,Mechelsesteenweg 365,2019-04-06,02:00:00,0,0,0,FMN GV 05 Lier
60,Mechelsesteenweg 365,2019-04-06,03:00:00,0,0,0,FMN GV 05 Lier
60,Mechelsesteenweg 365,2019-04-06,04:00:00,0,0,0,FMN GV 05 Lier
60,Mechelsesteenweg 365,2019-04-06,05:00:00,0,0,0,FMN GV 05 Lier
60,Mechelsesteenweg 365,2019-04-06,06:00:00,4,0,4,FMN GV 05 Lier
60,Mechelsesteenweg 365,2019-04-06,07:00:00,12,4,8,FMN GV 05 Lier
60,Mechelsesteenweg 365,2019-04-06,08:00:00,30,18,12,FMN GV 05 Lier
60,Mechelsesteenweg 365,2019-04-06,09:00:00,72,34,38,FMN GV 05 Lier
60,Mechelsesteenweg 365,2019-04-06,10:00:00,144,64,80,FMN GV 05 Lier
60,Mechelsesteenweg 365,2019-04-06,11:00:00,160,82,78,FMN GV 05 Lier
60,Mechelsesteenweg 365,2019-04-06,12:00:00,154,70,84,FMN GV 05 Lier
60,Mechelsesteenweg 365,2019-04-06,13:00:00,176,92,84,FMN GV 05 Lier
60,Mechelsesteenweg 365,2019-04-06,14:00:00,236,144,92,FMN GV 05 Lier
60,Mechelsesteenweg 365,2019-04-06,15:00:00,204,82,122,FMN GV 05 Lier
60,Mechelsesteenweg 365,2019-04-06,16:00:00,178,66,112,FMN GV 05 Lier
60,Mechelsesteenweg 365,2019-04-06,17:00:00,114,62,52,FMN GV 05 Lier
60,Mechelsesteenweg 365,2019-04-06,18:00:00,62,16,46,FMN GV 05 Lier
60,Mechelsesteenweg 365,2019-04-06,19:00:00,36,14,22,FMN GV 05 Lier
60,Mechelsesteenweg 365,2019-04-06,20:00:00,14,4,10,FMN GV 05 Lier
60,Mechelsesteenweg 365,2019-04-06,21:00:00,6,4,2,FMN GV 05 Lier
60,Mechelsesteenweg 365,2019-04-06,22:00:00,10,4,6,FMN GV 05 Lier
60,Mechelsesteenweg 365,2019-04-06,23:00:00,2,2,0,FMN GV 05 Lier
60,Mechelsesteenweg 365,2019-04-07,00:00:00,2,2,0,FMN GV 05 Lier
60,Mechelsesteenweg 365,2019-04-07,01:00:00,0,0,0,FMN GV 05 Lier
60,Mechelsesteenweg 365,2019-04-07,02:00:00,2,0,2,FMN GV 05 Lier
60,Mechelsesteenweg 365,2019-04-07,03:00:00,2,0,2,FMN GV 05 Lier
60,Mechelsesteenweg 365,2019-04-07,04:00:00,2,0,2,FMN GV 05 Lier
60,Mechelsesteenweg 365,2019-04-07,05:00:00,0,0,0,FMN GV 05 Lier
60,Mechelsesteenweg 365,2019-04-07,06:00:00,0,0,0,FMN GV 05 Lier
60,Mechelsesteenweg 365,2019-04-07,07:00:00,14,6,8,FMN GV 05 Lier
60,Mechelsesteenweg 365,2019-04-07,08:00:00,34,20,14,FMN GV 05 Lier
60,Mechelsesteenweg 365,2019-04-07,09:00:00,184,122,62,FMN GV 05 Lier
60,Mechelsesteenweg 365,2019-04-07,10:00:00,348,188,160,FMN GV 05 Lier
60,Mechelsesteenweg 365,2019-04-07,11:00:00,438,234,204,FMN GV 05 Lier
60,Mechelsesteenweg 365,2019-04-07,12:00:00,316,156,160,FMN GV 05 Lier
60,Mechelsesteenweg 365,2019-04-07,13:00:00,318,158,160,FMN GV 05 Lier
60,Mechelsesteenweg 365,2019-04-07,14:00:00,372,204,168,FMN GV 05 Lier
60,Mechelsesteenweg 365,2019-04-07,15:00:00,304,118,186,FMN GV 05 Lier
60,Mechelsesteenweg 365,2019-04-07,16:00:00,252,82,170,FMN GV 05 Lier
60,Mechelsesteenweg 365,2019-04-07,17:00:00,126,46,80,FMN GV 05 Lier
60,Mechelsesteenweg 365,2019-04-07,18:00:00,86,38,48,FMN GV 05 Lier
60,Mechelsesteenweg 365,2019-04-07,19:00:00,50,24,26,FMN GV 05 Lier
60,Mechelsesteenweg 365,2019-04-07,20:00:00,14,4,10,FMN GV 05 Lier
60,Mechelsesteenweg 365,2019-04-07,21:00:00,0,0,0,FMN GV 05 Lier
60,Mechelsesteenweg 365,2019-04-07,22:00:00,6,2,4,FMN GV 05 Lier
60,Mechelsesteenweg 365,2019-04-07,23:00:00,0,0,0,FMN GV 05 Lier
60,Mechelsesteenweg 365,2019-04-08,00:00:00,0,0,0,FMN GV 05 Lier
60,Mechelsesteenweg 365,2019-04-08,01:00:00,2,2,0,FMN GV 05 Lier
60,Mechelsesteenweg 365,2019-04-08,02:00:00,0,0,0,FMN GV 05 Lier
60,Mechelsesteenweg 365,2019-04-08,03:00:00,0,0,0,FMN GV 05 Lier
60,Mechelsesteenweg 365,2019-04-08,04:00:00,4,0,4,FMN GV 05 Lier
60,Mechelsesteenweg 365,2019-04-08,05:00:00,6,0,6,FMN GV 05 Lier
60,Mechelsesteenweg 365,2019-04-08,06:00:00,24,6,18,FMN GV 05 Lier
60,Mechelsesteenweg 365,2019-04-08,07:00:00,68,22,46,FMN GV 05 Lier
60,Mechelsesteenweg 365,2019-04-08,08:00:00,48,26,22,FMN GV 05 Lier
60,Mechelsesteenweg 365,2019-04-08,09:00:00,26,14,12,FMN GV 05 Lier
60,Mechelsesteenweg 365,2019-04-08,10:00:00,34,16,18,FMN GV 05 Lier
60,Mechelsesteenweg 365,2019-04-08,11:00:00,74,36,38,FMN GV 05 Lier
60,Mechelsesteenweg 365,2019-04-08,12:00:00,50,14,36,FMN GV 05 Lier
60,Mechelsesteenweg 365,2019-04-08,13:00:00,88,30,58,FMN GV 05 Lier
60,Mechelsesteenweg 365,2019-04-08,14:00:00,56,30,26,FMN GV 05 Lier
60,Mechelsesteenweg 365,2019-04-08,15:00:00,86,34,52,FMN GV 05 Lier
60,Mechelsesteenweg 365,2019-04-08,16:00:00,106,58,48,FMN GV 05 Lier
60,Mechelsesteenweg 365,2019-04-08,17:00:00,102,74,28,FMN GV 05 Lier
60,Mechelsesteenweg 365,2019-04-08,18:00:00,48,24,24,FMN GV 05 Lier
60,Mechelsesteenweg 365,2019-04-08,19:00:00,32,16,16,FMN GV 05 Lier
60,Mechelsesteenweg 365,2019-04-08,20:00:00,22,8,14,FMN GV 05 Lier
60,Mechelsesteenweg 365,2019-04-08,21:00:00,2,2,0,FMN GV 05 Lier
60,Mechelsesteenweg 365,2019-04-08,22:00:00,4,2,2,FMN GV 05 Lier
60,Mechelsesteenweg 365,2019-04-08,23:00:00,4,2,2,FMN GV 05 Lier
60,Mechelsesteenweg 365,2019-04-09,00:00:00,0,0,0,FMN GV 05 Lier
60,Mechelsesteenweg 365,2019-04-09,01:00:00,0,0,0,FMN GV 05 Lier
60,Mechelsesteenweg 365,2019-04-09,02:00:00,0,0,0,FMN GV 05 Lier
60,Mechelsesteenweg 365,2019-04-09,03:00:00,4,0,4,FMN GV 05 Lier
60,Mechelsesteenweg 365,2019-04-09,04:00:00,2,0,2,FMN GV 05 Lier
60,Mechelsesteenweg 365,2019-04-09,05:00:00,4,0,4,FMN GV 05 Lier
60,Mechelsesteenweg 365,2019-04-09,06:00:00,8,2,6,FMN GV 05 Lier
60,Mechelsesteenweg 365,2019-04-09,07:00:00,36,10,26,FMN GV 05 Lier
60,Mechelsesteenweg 365,2019-04-09,08:00:00,26,12,14,FMN GV 05 Lier
60,Mechelsesteenweg 365,2019-04-09,09:00:00,40,12,28,FMN GV 05 Lier
60,Mechelsesteenweg 365,2019-04-09,10:00:00,18,4,14,FMN GV 05 Lier
60,Mechelsesteenweg 365,2019-04-09,11:00:00,30,10,20,FMN GV 05 Lier
60,Mechelsesteenweg 365,2019-04-09,12:00:00,28,20,8,FMN GV 05 Lier
60,Mechelsesteenweg 365,2019-04-09,13:00:00,78,32,46,FMN GV 05 Lier
60,Mechelsesteenweg 365,2019-04-09,14:00:00,50,36,14,FMN GV 05 Lier
60,Mechelsesteenweg 365,2019-04-09,15:00:00,86,40,46,FMN GV 05 Lier
60,Mechelsesteenweg 365,2019-04-09,16:00:00,96,50,46,FMN GV 05 Lier
60,Mechelsesteenweg 365,2019-04-09,17:00:00,114,54,60,FMN GV 05 Lier
60,Mechelsesteenweg 365,2019-04-09,18:00:00,52,32,20,FMN GV 05 Lier
60,Mechelsesteenweg 365,2019-04-09,19:00:00,62,28,34,FMN GV 05 Lier
60,Mechelsesteenweg 365,2019-04-09,20:00:00,30,10,20,FMN GV 05 Lier
60,Mechelsesteenweg 365,2019-04-09,21:00:00,10,4,6,FMN GV 05 Lier
60,Mechelsesteenweg 365,2019-04-09,22:00:00,16,8,8,FMN GV 05 Lier
60,Mechelsesteenweg 365,2019-04-09,23:00:00,4,4,0,FMN GV 05 Lier
60,Mechelsesteenweg 365,2019-04-10,00:00:00,0,0,0,FMN GV 05 Lier
60,Mechelsesteenweg 365,2019-04-10,01:00:00,2,0,2,FMN GV 05 Lier
60,Mechelsesteenweg 365,2019-04-10,02:00:00,0,0,0,FMN GV 05 Lier
60,Mechelsesteenweg 365,2019-04-10,03:00:00,4,0,4,FMN GV 05 Lier
60,Mechelsesteenweg 365,2019-04-10,04:00:00,6,4,2,FMN GV 05 Lier
60,Mechelsesteenweg 365,2019-04-10,05:00:00,8,0,8,FMN GV 05 Lier
60,Mechelsesteenweg 365,2019-04-10,06:00:00,18,0,18,FMN GV 05 Lier
60,Mechelsesteenweg 365,2019-04-10,07:00:00,88,26,62,FMN GV 05 Lier
60,Mechelsesteenweg 365,2019-04-10,08:00:00,54,24,30,FMN GV 05 Lier
60,Mechelsesteenweg 365,2019-04-10,09:00:00,36,16,20,FMN GV 05 Lier
60,Mechelsesteenweg 365,2019-04-10,10:00:00,74,34,40,FMN GV 05 Lier
60,Mechelsesteenweg 365,2019-04-10,11:00:00,86,38,48,FMN GV 05 Lier
60,Mechelsesteenweg 365,2019-04-10,12:00:00,94,42,52,FMN GV 05 Lier
60,Mechelsesteenweg 365,2019-04-10,13:00:00,112,56,56,FMN GV 05 Lier
60,Mechelsesteenweg 365,2019-04-10,14:00:00,148,86,62,FMN GV 05 Lier
60,Mechelsesteenweg 365,2019-04-10,15:00:00,146,62,84,FMN GV 05 Lier
60,Mechelsesteenweg 365,2019-04-10,16:00:00,126,48,78,FMN GV 05 Lier
60,Mechelsesteenweg 365,2019-04-10,17:00:00,186,94,92,FMN GV 05 Lier
60,Mechelsesteenweg 365,2019-04-10,18:00:00,110,54,56,FMN GV 05 Lier
60,Mechelsesteenweg 365,2019-04-10,19:00:00,106,64,42,FMN GV 05 Lier
60,Mechelsesteenweg 365,2019-04-10,20:00:00,24,8,16,FMN GV 05 Lier
60,Mechelsesteenweg 365,2019-04-10,21:00:00,14,6,8,FMN GV 05 Lier
60,Mechelsesteenweg 365,2019-04-10,22:00:00,6,2,4,FMN GV 05 Lier
60,Mechelsesteenweg 365,2019-04-10,23:00:00,2,0,2,FMN GV 05 Lier
60,Mechelsesteenweg 365,2019-04-11,00:00:00,4,2,2,FMN GV 05 Lier
60,Mechelsesteenweg 365,2019-04-11,01:00:00,2,0,2,FMN GV 05 Lier
60,Mechelsesteenweg 365,2019-04-11,02:00:00,0,0,0,FMN GV 05 Lier
60,Mechelsesteenweg 365,2019-04-11,03:00:00,2,0,2,FMN GV 05 Lier
60,Mechelsesteenweg 365,2019-04-11,04:00:00,6,2,4,FMN GV 05 Lier
60,Mechelsesteenweg 365,2019-04-11,05:00:00,8,2,6,FMN GV 05 Lier
60,Mechelsesteenweg 365,2019-04-11,06:00:00,8,4,4,FMN GV 05 Lier
60,Mechelsesteenweg 365,2019-04-11,07:00:00,66,22,44,FMN GV 05 Lier
60,Mechelsesteenweg 365,2019-04-11,08:00:00,62,26,36,FMN GV 05 Lier
60,Mechelsesteenweg 365,2019-04-11,09:00:00,36,20,16,FMN GV 05 Lier
60,Mechelsesteenweg 365,2019-04-11,10:00:00,54,26,28,FMN GV 05 Lier
60,Mechelsesteenweg 365,2019-04-11,11:00:00,80,28,52,FMN GV 05 Lier
60,Mechelsesteenweg 365,2019-04-11,12:00:00,92,58,34,FMN GV 05 Lier
60,Mechelsesteenweg 365,2019-04-11,13:00:00,174,128,46,FMN GV 05 Lier
60,Mechelsesteenweg 365,2019-04-11,14:00:00,160,80,80,FMN GV 05 Lier
60,Mechelsesteenweg 365,2019-04-11,15:00:00,160,56,104,FMN GV 05 Lier
60,Mechelsesteenweg 365,2019-04-11,16:00:00,136,58,78,FMN GV 05 Lier
60,Mechelsesteenweg 365,2019-04-11,17:00:00,136,64,72,FMN GV 05 Lier
60,Mechelsesteenweg 365,2019-04-11,18:00:00,84,44,40,FMN GV 05 Lier
60,Mechelsesteenweg 365,2019-04-11,19:00:00,120,72,48,FMN GV 05 Lier
60,Mechelsesteenweg 365,2019-04-11,20:00:00,76,12,64,FMN GV 05 Lier
60,Mechelsesteenweg 365,2019-04-11,21:00:00,8,4,4,FMN GV 05 Lier
60,Mechelsesteenweg 365,2019-04-11,22:00:00,4,2,2,FMN GV 05 Lier
60,Mechelsesteenweg 365,2019-04-11,23:00:00,0,0,0,FMN GV 05 Lier
60,Mechelsesteenweg 365,2019-04-12,00:00:00,4,2,2,FMN GV 05 Lier
60,Mechelsesteenweg 365,2019-04-12,01:00:00,0,0,0,FMN GV 05 Lier
60,Mechelsesteenweg 365,2019-04-12,02:00:00,0,0,0,FMN GV 05 Lier
60,Mechelsesteenweg 365,2019-04-12,03:00:00,2,0,2,FMN GV 05 Lier
60,Mechelsesteenweg 365,2019-04-12,04:00:00,4,0,4,FMN GV 05 Lier
60,Mechelsesteenweg 365,2019-04-12,05:00:00,4,0,4,FMN GV 05 Lier
60,Mechelsesteenweg 365,2019-04-12,06:00:00,22,10,12,FMN GV 05 Lier
60,Mechelsesteenweg 365,2019-04-12,07:00:00,76,24,52,FMN GV 05 Lier
60,Mechelsesteenweg 365,2019-04-12,08:00:00,48,14,34,FMN GV 05 Lier
60,Mechelsesteenweg 365,2019-04-12,09:00:00,32,14,18,FMN GV 05 Lier
60,Mechelsesteenweg 365,2019-04-12,10:00:00,62,30,32,FMN GV 05 Lier
60,Mechelsesteenweg 365,2019-04-12,11:00:00,60,20,40,FMN GV 05 Lier
60,Mechelsesteenweg 365,2019-04-12,12:00:00,52,26,26,FMN GV 05 Lier
60,Mechelsesteenweg 365,2019-04-12,13:00:00,84,40,44,FMN GV 05 Lier
60,Mechelsesteenweg 365,2019-04-12,14:00:00,78,42,36,FMN GV 05 Lier
60,Mechelsesteenweg 365,2019-04-12,15:00:00,84,30,54,FMN GV 05 Lier
60,Mechelsesteenweg 365,2019-04-12,16:00:00,76,46,30,FMN GV 05 Lier
60,Mechelsesteenweg 365,2019-04-12,17:00:00,92,50,42,FMN GV 05 Lier
60,Mechelsesteenweg 365,2019-04-12,18:00:00,72,50,22,FMN GV 05 Lier
60,Mechelsesteenweg 365,2019-04-12,19:00:00,28,16,12,FMN GV 05 Lier
60,Mechelsesteenweg 365,2019-04-12,20:00:00,14,6,8,FMN GV 05 Lier
60,Mechelsesteenweg 365,2019-04-12,21:00:00,14,6,8,FMN GV 05 Lier
60,Mechelsesteenweg 365,2019-04-12,22:00:00,6,2,4,FMN GV 05 Lier
60,Mechelsesteenweg 365,2019-04-12,23:00:00,0,0,0,FMN GV 05 Lier
60,Mechelsesteenweg 365,2019-04-13,00:00:00,0,0,0,FMN GV 05 Lier
60,Mechelsesteenweg 365,2019-04-13,01:00:00,0,0,0,FMN GV 05 Lier
60,Mechelsesteenweg 365,2019-04-13,02:00:00,0,0,0,FMN GV 05 Lier
60,Mechelsesteenweg 365,2019-04-13,03:00:00,0,0,0,FMN GV 05 Lier
60,Mechelsesteenweg 365,2019-04-13,04:00:00,0,0,0,FMN GV 05 Lier
60,Mechelsesteenweg 365,2019-04-13,05:00:00,0,0,0,FMN GV 05 Lier
60,Mechelsesteenweg 365,2019-04-13,06:00:00,4,2,2,FMN GV 05 Lier
60,Mechelsesteenweg 365,2019-04-13,07:00:00,14,8,6,FMN GV 05 Lier
60,Mechelsesteenweg 365,2019-04-13,08:00:00,18,4,14,FMN GV 05 Lier
60,Mechelsesteenweg 365,2019-04-13,09:00:00,50,32,18,FMN GV 05 Lier
60,Mechelsesteenweg 365,2019-04-13,10:00:00,62,24,38,FMN GV 05 Lier
60,Mechelsesteenweg 365,2019-04-13,11:00:00,84,30,54,FMN GV 05 Lier
60,Mechelsesteenweg 365,2019-04-13,12:00:00,88,56,32,FMN GV 05 Lier
60,Mechelsesteenweg 365,2019-04-13,13:00:00,114,54,60,FMN GV 05 Lier
60,Mechelsesteenweg 365,2019-04-13,14:00:00,116,46,70,FMN GV 05 Lier
60,Mechelsesteenweg 365,2019-04-13,15:00:00,90,22,68,FMN GV 05 Lier
60,Mechelsesteenweg 365,2019-04-13,16:00:00,82,46,36,FMN GV 05 Lier
60,Mechelsesteenweg 365,2019-04-13,17:00:00,50,14,36,FMN GV 05 Lier
60,Mechelsesteenweg 365,2019-04-13,18:00:00,12,4,8,FMN GV 05 Lier
60,Mechelsesteenweg 365,2019-04-13,19:00:00,10,4,6,FMN GV 05 Lier
60,Mechelsesteenweg 365,2019-04-13,20:00:00,18,8,10,FMN GV 05 Lier
60,Mechelsesteenweg 365,2019-04-13,21:00:00,14,8,6,FMN GV 05 Lier
60,Mechelsesteenweg 365,2019-04-13,22:00:00,6,0,6,FMN GV 05 Lier
60,Mechelsesteenweg 365,2019-04-13,23:00:00,0,0,0,FMN GV 05 Lier
60,Mechelsesteenweg 365,2019-04-14,00:00:00,0,0,0,FMN GV 05 Lier
60,Mechelsesteenweg 365,2019-04-14,01:00:00,0,0,0,FMN GV 05 Lier
60,Mechelsesteenweg 365,2019-04-14,02:00:00,0,0,0,FMN GV 05 Lier
60,Mechelsesteenweg 365,2019-04-14,03:00:00,0,0,0,FMN GV 05 Lier
60,Mechelsesteenweg 365,2019-04-14,04:00:00,0,0,0,FMN GV 05 Lier
60,Mechelsesteenweg 365,2019-04-14,05:00:00,2,2,0,FMN GV 05 Lier
60,Mechelsesteenweg 365,2019-04-14,06:00:00,6,2,4,FMN GV 05 Lier
60,Mechelsesteenweg 365,2019-04-14,07:00:00,2,2,0,FMN GV 05 Lier
60,Mechelsesteenweg 365,2019-04-14,08:00:00,26,16,10,FMN GV 05 Lier
60,Mechelsesteenweg 365,2019-04-14,09:00:00,118,48,70,FMN GV 05 Lier
60,Mechelsesteenweg 365,2019-04-14,10:00:00,230,114,116,FMN GV 05 Lier
60,Mechelsesteenweg 365,2019-04-14,11:00:00,196,84,112,FMN GV 05 Lier
60,Mechelsesteenweg 365,2019-04-14,12:00:00,90,42,48,FMN GV 05 Lier
60,Mechelsesteenweg 365,2019-04-14,13:00:00,128,64,64,FMN GV 05 Lier
60,Mechelsesteenweg 365,2019-04-14,14:00:00,94,46,48,FMN GV 05 Lier
60,Mechelsesteenweg 365,2019-04-14,15:00:00,68,18,50,FMN GV 05 Lier
60,Mechelsesteenweg 365,2019-04-14,16:00:00,50,22,28,FMN GV 05 Lier
60,Mechelsesteenweg 365,2019-04-14,17:00:00,60,28,32,FMN GV 05 Lier
60,Mechelsesteenweg 365,2019-04-14,18:00:00,34,12,22,FMN GV 05 Lier
60,Mechelsesteenweg 365,2019-04-14,19:00:00,16,6,10,FMN GV 05 Lier
60,Mechelsesteenweg 365,2019-04-14,20:00:00,14,4,10,FMN GV 05 Lier
60,Mechelsesteenweg 365,2019-04-14,21:00:00,4,2,2,FMN GV 05 Lier
60,Mechelsesteenweg 365,2019-04-14,22:00:00,4,2,2,FMN GV 05 Lier
60,Mechelsesteenweg 365,2019-04-14,23:00:00,0,0,0,FMN GV 05 Lier
60,Mechelsesteenweg 365,2019-04-15,00:00:00,0,0,0,FMN GV 05 Lier
60,Mechelsesteenweg 365,2019-04-15,01:00:00,0,0,0,FMN GV 05 Lier
60,Mechelsesteenweg 365,2019-04-15,02:00:00,0,0,0,FMN GV 05 Lier
60,Mechelsesteenweg 365,2019-04-15,03:00:00,0,0,0,FMN GV 05 Lier
60,Mechelsesteenweg 365,2019-04-15,04:00:00,2,2,0,FMN GV 05 Lier
60,Mechelsesteenweg 365,2019-04-15,05:00:00,2,0,2,FMN GV 05 Lier
60,Mechelsesteenweg 365,2019-04-15,06:00:00,8,2,6,FMN GV 05 Lier
60,Mechelsesteenweg 365,2019-04-15,07:00:00,86,30,56,FMN GV 05 Lier
60,Mechelsesteenweg 365,2019-04-15,08:00:00,46,16,30,FMN GV 05 Lier
60,Mechelsesteenweg 365,2019-04-15,09:00:00,38,16,22,FMN GV 05 Lier
60,Mechelsesteenweg 365,2019-04-15,10:00:00,48,26,22,FMN GV 05 Lier
60,Mechelsesteenweg 365,2019-04-15,11:00:00,90,36,54,FMN GV 05 Lier
60,Mechelsesteenweg 365,2019-04-15,12:00:00,56,26,30,FMN GV 05 Lier
60,Mechelsesteenweg 365,2019-04-15,13:00:00,122,60,62,FMN GV 05 Lier
60,Mechelsesteenweg 365,2019-04-15,14:00:00,114,46,68,FMN GV 05 Lier
60,Mechelsesteenweg 365,2019-04-15,15:00:00,198,68,130,FMN GV 05 Lier
60,Mechelsesteenweg 365,2019-04-15,16:00:00,188,108,80,FMN GV 05 Lier
60,Mechelsesteenweg 365,2019-04-15,17:00:00,178,88,90,FMN GV 05 Lier
60,Mechelsesteenweg 365,2019-04-15,18:00:00,88,44,44,FMN GV 05 Lier
60,Mechelsesteenweg 365,2019-04-15,19:00:00,48,14,34,FMN GV 05 Lier
60,Mechelsesteenweg 365,2019-04-15,20:00:00,22,12,10,FMN GV 05 Lier
60,Mechelsesteenweg 365,2019-04-15,21:00:00,14,0,14,FMN GV 05 Lier
60,Mechelsesteenweg 365,2019-04-15,22:00:00,10,6,4,FMN GV 05 Lier
60,Mechelsesteenweg 365,2019-04-15,23:00:00,4,4,0,FMN GV 05 Lier
60,Mechelsesteenweg 365,2019-04-16,00:00:00,2,0,2,FMN GV 05 Lier
60,Mechelsesteenweg 365,2019-04-16,01:00:00,0,0,0,FMN GV 05 Lier
60,Mechelsesteenweg 365,2019-04-16,02:00:00,0,0,0,FMN GV 05 Lier
60,Mechelsesteenweg 365,2019-04-16,03:00:00,2,0,2,FMN GV 05 Lier
60,Mechelsesteenweg 365,2019-04-16,04:00:00,4,0,4,FMN GV 05 Lier
60,Mechelsesteenweg 365,2019-04-16,05:00:00,4,0,4,FMN GV 05 Lier
60,Mechelsesteenweg 365,2019-04-16,06:00:00,24,8,16,FMN GV 05 Lier
60,Mechelsesteenweg 365,2019-04-16,07:00:00,80,32,48,FMN GV 05 Lier
60,Mechelsesteenweg 365,2019-04-16,08:00:00,64,24,40,FMN GV 05 Lier
60,Mechelsesteenweg 365,2019-04-16,09:00:00,32,18,14,FMN GV 05 Lier
60,Mechelsesteenweg 365,2019-04-16,10:00:00,102,40,62,FMN GV 05 Lier
60,Mechelsesteenweg 365,2019-04-16,11:00:00,96,60,36,FMN GV 05 Lier
60,Mechelsesteenweg 365,2019-04-16,12:00:00,110,72,38,FMN GV 05 Lier
60,Mechelsesteenweg 365,2019-04-16,13:00:00,170,96,74,FMN GV 05 Lier
60,Mechelsesteenweg 365,2019-04-16,14:00:00,208,100,108,FMN GV 05 Lier
60,Mechelsesteenweg 365,2019-04-16,15:00:00,206,88,118,FMN GV 05 Lier
60,Mechelsesteenweg 365,2019-04-16,16:00:00,170,70,100,FMN GV 05 Lier
60,Mechelsesteenweg 365,2019-04-16,17:00:00,152,76,76,FMN GV 05 Lier
60,Mechelsesteenweg 365,2019-04-16,18:00:00,100,40,60,FMN GV 05 Lier
60,Mechelsesteenweg 365,2019-04-16,19:00:00,90,42,48,FMN GV 05 Lier
60,Mechelsesteenweg 365,2019-04-16,20:00:00,50,26,24,FMN GV 05 Lier
60,Mechelsesteenweg 365,2019-04-16,21:00:00,10,6,4,FMN GV 05 Lier
60,Mechelsesteenweg 365,2019-04-16,22:00:00,16,4,12,FMN GV 05 Lier
60,Mechelsesteenweg 365,2019-04-16,23:00:00,4,0,4,FMN GV 05 Lier
60,Mechelsesteenweg 365,2019-04-17,00:00:00,0,0,0,FMN GV 05 Lier
60,Mechelsesteenweg 365,2019-04-17,01:00:00,0,0,0,FMN GV 05 Lier
60,Mechelsesteenweg 365,2019-04-17,02:00:00,0,0,0,FMN GV 05 Lier
60,Mechelsesteenweg 365,2019-04-17,03:00:00,0,0,0,FMN GV 05 Lier
60,Mechelsesteenweg 365,2019-04-17,04:00:00,4,2,2,FMN GV 05 Lier
60,Mechelsesteenweg 365,2019-04-17,05:00:00,4,0,4,FMN GV 05 Lier
60,Mechelsesteenweg 365,2019-04-17,06:00:00,22,6,16,FMN GV 05 Lier
60,Mechelsesteenweg 365,2019-04-17,07:00:00,88,34,54,FMN GV 05 Lier
60,Mechelsesteenweg 365,2019-04-17,08:00:00,38,10,28,FMN GV 05 Lier
60,Mechelsesteenweg 365,2019-04-17,09:00:00,40,20,20,FMN GV 05 Lier
60,Mechelsesteenweg 365,2019-04-17,10:00:00,40,20,20,FMN GV 05 Lier
60,Mechelsesteenweg 365,2019-04-17,11:00:00,48,22,26,FMN GV 05 Lier
60,Mechelsesteenweg 365,2019-04-17,12:00:00,68,30,38,FMN GV 05 Lier
60,Mechelsesteenweg 365,2019-04-17,13:00:00,144,54,90,FMN GV 05 Lier
60,Mechelsesteenweg 365,2019-04-17,14:00:00,136,68,68,FMN GV 05 Lier
60,Mechelsesteenweg 365,2019-04-17,15:00:00,128,72,56,FMN GV 05 Lier
60,Mechelsesteenweg 365,2019-04-17,16:00:00,128,70,58,FMN GV 05 Lier
60,Mechelsesteenweg 365,2019-04-17,17:00:00,106,62,44,FMN GV 05 Lier
60,Mechelsesteenweg 365,2019-04-17,18:00:00,92,44,48,FMN GV 05 Lier
60,Mechelsesteenweg 365,2019-04-17,19:00:00,98,70,28,FMN GV 05 Lier
60,Mechelsesteenweg 365,2019-04-17,20:00:00,66,24,42,FMN GV 05 Lier
60,Mechelsesteenweg 365,2019-04-17,21:00:00,16,6,10,FMN GV 05 Lier
60,Mechelsesteenweg 365,2019-04-17,22:00:00,12,8,4,FMN GV 05 Lier
60,Mechelsesteenweg 365,2019-04-17,23:00:00,2,0,2,FMN GV 05 Lier
60,Mechelsesteenweg 365,2019-04-18,00:00:00,0,0,0,FMN GV 05 Lier
60,Mechelsesteenweg 365,2019-04-18,01:00:00,0,0,0,FMN GV 05 Lier
60,Mechelsesteenweg 365,2019-04-18,02:00:00,0,0,0,FMN GV 05 Lier
60,Mechelsesteenweg 365,2019-04-18,03:00:00,2,0,2,FMN GV 05 Lier
60,Mechelsesteenweg 365,2019-04-18,04:00:00,2,0,2,FMN GV 05 Lier
60,Mechelsesteenweg 365,2019-04-18,05:00:00,6,0,6,FMN GV 05 Lier
60,Mechelsesteenweg 365,2019-04-18,06:00:00,26,12,14,FMN GV 05 Lier
60,Mechelsesteenweg 365,2019-04-18,07:00:00,92,20,72,FMN GV 05 Lier
60,Mechelsesteenweg 365,2019-04-18,08:00:00,90,28,62,FMN GV 05 Lier
60,Mechelsesteenweg 365,2019-04-18,09:00:00,60,46,14,FMN GV 05 Lier
60,Mechelsesteenweg 365,2019-04-18,10:00:00,112,34,78,FMN GV 05 Lier
60,Mechelsesteenweg 365,2019-04-18,11:00:00,148,72,76,FMN GV 05 Lier
60,Mechelsesteenweg 365,2019-04-18,12:00:00,120,42,78,FMN GV 05 Lier
60,Mechelsesteenweg 365,2019-04-18,13:00:00,264,154,110,FMN GV 05 Lier
60,Mechelsesteenweg 365,2019-04-18,14:00:00,236,94,142,FMN GV 05 Lier
60,Mechelsesteenweg 365,2019-04-18,15:00:00,286,150,136,FMN GV 05 Lier
60,Mechelsesteenweg 365,2019-04-18,16:00:00,264,128,136,FMN GV 05 Lier
60,Mechelsesteenweg 365,2019-04-18,17:00:00,222,126,96,FMN GV 05 Lier
60,Mechelsesteenweg 365,2019-04-18,18:00:00,178,62,116,FMN GV 05 Lier
60,Mechelsesteenweg 365,2019-04-18,19:00:00,172,78,94,FMN GV 05 Lier
60,Mechelsesteenweg 365,2019-04-18,20:00:00,138,44,94,FMN GV 05 Lier
60,Mechelsesteenweg 365,2019-04-18,21:00:00,10,4,6,FMN GV 05 Lier
60,Mechelsesteenweg 365,2019-04-18,22:00:00,8,6,2,FMN GV 05 Lier
60,Mechelsesteenweg 365,2019-04-18,23:00:00,8,4,4,FMN GV 05 Lier
60,Mechelsesteenweg 365,2019-04-19,00:00:00,0,0,0,FMN GV 05 Lier
60,Mechelsesteenweg 365,2019-04-19,01:00:00,0,0,0,FMN GV 05 Lier
60,Mechelsesteenweg 365,2019-04-19,02:00:00,2,2,0,FMN GV 05 Lier
60,Mechelsesteenweg 365,2019-04-19,03:00:00,0,0,0,FMN GV 05 Lier
60,Mechelsesteenweg 365,2019-04-19,04:00:00,6,0,6,FMN GV 05 Lier
60,Mechelsesteenweg 365,2019-04-19,05:00:00,2,0,2,FMN GV 05 Lier
60,Mechelsesteenweg 365,2019-04-19,06:00:00,34,14,20,FMN GV 05 Lier
60,Mechelsesteenweg 365,2019-04-19,07:00:00,90,24,66,FMN GV 05 Lier
60,Mechelsesteenweg 365,2019-04-19,08:00:00,54,18,36,FMN GV 05 Lier
60,Mechelsesteenweg 365,2019-04-19,09:00:00,72,46,26,FMN GV 05 Lier
60,Mechelsesteenweg 365,2019-04-19,10:00:00,158,72,86,FMN GV 05 Lier
60,Mechelsesteenweg 365,2019-04-19,11:00:00,250,126,124,FMN GV 05 Lier
60,Mechelsesteenweg 365,2019-04-19,12:00:00,176,114,62,FMN GV 05 Lier
60,Mechelsesteenweg 365,2019-04-19,13:00:00,322,188,134,FMN GV 05 Lier
60,Mechelsesteenweg 365,2019-04-19,14:00:00,412,212,200,FMN GV 05 Lier
60,Mechelsesteenweg 365,2019-04-19,15:00:00,304,102,202,FMN GV 05 Lier
60,Mechelsesteenweg 365,2019-04-19,16:00:00,348,130,218,FMN GV 05 Lier
60,Mechelsesteenweg 365,2019-04-19,17:00:00,220,118,102,FMN GV 05 Lier
60,Mechelsesteenweg 365,2019-04-19,18:00:00,164,70,94,FMN GV 05 Lier
60,Mechelsesteenweg 365,2019-04-19,19:00:00,76,46,30,FMN GV 05 Lier
60,Mechelsesteenweg 365,2019-04-19,20:00:00,68,20,48,FMN GV 05 Lier
60,Mechelsesteenweg 365,2019-04-19,21:00:00,16,8,8,FMN GV 05 Lier
60,Mechelsesteenweg 365,2019-04-19,22:00:00,14,12,2,FMN GV 05 Lier
60,Mechelsesteenweg 365,2019-04-19,23:00:00,6,0,6,FMN GV 05 Lier
60,Mechelsesteenweg 365,2019-04-20,00:00:00,0,0,0,FMN GV 05 Lier
60,Mechelsesteenweg 365,2019-04-20,01:00:00,4,0,4,FMN GV 05 Lier
60,Mechelsesteenweg 365,2019-04-20,02:00:00,0,0,0,FMN GV 05 Lier
60,Mechelsesteenweg 365,2019-04-20,03:00:00,0,0,0,FMN GV 05 Lier
60,Mechelsesteenweg 365,2019-04-20,04:00:00,0,0,0,FMN GV 05 Lier
60,Mechelsesteenweg 365,2019-04-20,05:00:00,0,0,0,FMN GV 05 Lier
60,Mechelsesteenweg 365,2019-04-20,06:00:00,10,2,8,FMN GV 05 Lier
60,Mechelsesteenweg 365,2019-04-20,07:00:00,18,8,10,FMN GV 05 Lier
60,Mechelsesteenweg 365,2019-04-20,08:00:00,32,14,18,FMN GV 05 Lier
60,Mechelsesteenweg 365,2019-04-20,09:00:00,110,70,40,FMN GV 05 Lier
60,Mechelsesteenweg 365,2019-04-20,10:00:00,248,122,126,FMN GV 05 Lier
60,Mechelsesteenweg 365,2019-04-20,11:00:00,300,132,168,FMN GV 05 Lier
60,Mechelsesteenweg 365,2019-04-20,12:00:00,214,96,118,FMN GV 05 Lier
60,Mechelsesteenweg 365,2019-04-20,13:00:00,300,160,140,FMN GV 05 Lier
60,Mechelsesteenweg 365,2019-04-20,14:00:00,520,270,250,FMN GV 05 Lier
60,Mechelsesteenweg 365,2019-04-20,15:00:00,466,214,252,FMN GV 05 Lier
60,Mechelsesteenweg 365,2019-04-20,16:00:00,338,124,214,FMN GV 05 Lier
60,Mechelsesteenweg 365,2019-04-20,17:00:00,264,110,154,FMN GV 05 Lier
60,Mechelsesteenweg 365,2019-04-20,18:00:00,130,48,82,FMN GV 05 Lier
60,Mechelsesteenweg 365,2019-04-20,19:00:00,72,26,46,FMN GV 05 Lier
60,Mechelsesteenweg 365,2019-04-20,20:00:00,64,18,46,FMN GV 05 Lier
60,Mechelsesteenweg 365,2019-04-20,21:00:00,14,4,10,FMN GV 05 Lier
60,Mechelsesteenweg 365,2019-04-20,22:00:00,10,6,4,FMN GV 05 Lier
60,Mechelsesteenweg 365,2019-04-20,23:00:00,18,2,16,FMN GV 05 Lier
60,Mechelsesteenweg 365,2019-04-21,00:00:00,6,4,2,FMN GV 05 Lier
60,Mechelsesteenweg 365,2019-04-21,01:00:00,4,2,2,FMN GV 05 Lier
60,Mechelsesteenweg 365,2019-04-21,02:00:00,0,0,0,FMN GV 05 Lier
60,Mechelsesteenweg 365,2019-04-21,03:00:00,0,0,0,FMN GV 05 Lier
60,Mechelsesteenweg 365,2019-04-21,04:00:00,0,0,0,FMN GV 05 Lier
60,Mechelsesteenweg 365,2019-04-21,05:00:00,0,0,0,FMN GV 05 Lier
60,Mechelsesteenweg 365,2019-04-21,06:00:00,4,4,0,FMN GV 05 Lier
60,Mechelsesteenweg 365,2019-04-21,07:00:00,14,6,8,FMN GV 05 Lier
60,Mechelsesteenweg 365,2019-04-21,08:00:00,66,36,30,FMN GV 05 Lier
60,Mechelsesteenweg 365,2019-04-21,09:00:00,262,140,122,FMN GV 05 Lier
60,Mechelsesteenweg 365,2019-04-21,10:00:00,384,168,216,FMN GV 05 Lier
60,Mechelsesteenweg 365,2019-04-21,11:00:00,382,202,180,FMN GV 05 Lier
60,Mechelsesteenweg 365,2019-04-21,12:00:00,408,230,178,FMN GV 05 Lier
60,Mechelsesteenweg 365,2019-04-21,13:00:00,388,184,204,FMN GV 05 Lier
60,Mechelsesteenweg 365,2019-04-21,14:00:00,562,290,272,FMN GV 05 Lier
60,Mechelsesteenweg 365,2019-04-21,15:00:00,486,212,274,FMN GV 05 Lier
60,Mechelsesteenweg 365,2019-04-21,16:00:00,384,154,230,FMN GV 05 Lier
60,Mechelsesteenweg 365,2019-04-21,17:00:00,274,86,188,FMN GV 05 Lier
60,Mechelsesteenweg 365,2019-04-21,18:00:00,150,50,100,FMN GV 05 Lier
60,Mechelsesteenweg 365,2019-04-21,19:00:00,158,48,110,FMN GV 05 Lier
60,Mechelsesteenweg 365,2019-04-21,20:00:00,54,18,36,FMN GV 05 Lier
60,Mechelsesteenweg 365,2019-04-21,21:00:00,26,6,20,FMN GV 05 Lier
60,Mechelsesteenweg 365,2019-04-21,22:00:00,10,4,6,FMN GV 05 Lier
60,Mechelsesteenweg 365,2019-04-21,23:00:00,0,0,0,FMN GV 05 Lier
60,Mechelsesteenweg 365,2019-04-22,00:00:00,0,0,0,FMN GV 05 Lier
60,Mechelsesteenweg 365,2019-04-22,01:00:00,0,0,0,FMN GV 05 Lier
60,Mechelsesteenweg 365,2019-04-22,02:00:00,4,2,2,FMN GV 05 Lier
60,Mechelsesteenweg 365,2019-04-22,03:00:00,4,0,4,FMN GV 05 Lier
60,Mechelsesteenweg 365,2019-04-22,04:00:00,10,0,10,FMN GV 05 Lier
60,Mechelsesteenweg 365,2019-04-22,05:00:00,0,0,0,FMN GV 05 Lier
60,Mechelsesteenweg 365,2019-04-22,06:00:00,10,6,4,FMN GV 05 Lier
60,Mechelsesteenweg 365,2019-04-22,07:00:00,18,12,6,FMN GV 05 Lier
60,Mechelsesteenweg 365,2019-04-22,08:00:00,26,18,8,FMN GV 05 Lier
60,Mechelsesteenweg 365,2019-04-22,09:00:00,156,90,66,FMN GV 05 Lier
60,Mechelsesteenweg 365,2019-04-22,10:00:00,452,222,230,FMN GV 05 Lier
60,Mechelsesteenweg 365,2019-04-22,11:00:00,494,226,268,FMN GV 05 Lier
60,Mechelsesteenweg 365,2019-04-22,12:00:00,486,200,286,FMN GV 05 Lier
60,Mechelsesteenweg 365,2019-04-22,13:00:00,384,176,208,FMN GV 05 Lier
60,Mechelsesteenweg 365,2019-04-22,14:00:00,676,342,334,FMN GV 05 Lier
60,Mechelsesteenweg 365,2019-04-22,15:00:00,600,222,378,FMN GV 05 Lier
60,Mechelsesteenweg 365,2019-04-22,16:00:00,476,152,324,FMN GV 05 Lier
60,Mechelsesteenweg 365,2019-04-22,17:00:00,310,98,212,FMN GV 05 Lier
60,Mechelsesteenweg 365,2019-04-22,18:00:00,132,48,84,FMN GV 05 Lier
60,Mechelsesteenweg 365,2019-04-22,19:00:00,90,22,68,FMN GV 05 Lier
60,Mechelsesteenweg 365,2019-04-22,20:00:00,88,22,66,FMN GV 05 Lier
60,Mechelsesteenweg 365,2019-04-22,21:00:00,12,4,8,FMN GV 05 Lier
60,Mechelsesteenweg 365,2019-04-22,22:00:00,10,4,6,FMN GV 05 Lier
60,Mechelsesteenweg 365,2019-04-22,23:00:00,0,0,0,FMN GV 05 Lier
60,Mechelsesteenweg 365,2019-04-23,00:00:00,0,0,0,FMN GV 05 Lier
60,Mechelsesteenweg 365,2019-04-23,01:00:00,0,0,0,FMN GV 05 Lier
60,Mechelsesteenweg 365,2019-04-23,02:00:00,0,0,0,FMN GV 05 Lier
60,Mechelsesteenweg 365,2019-04-23,03:00:00,0,0,0,FMN GV 05 Lier
60,Mechelsesteenweg 365,2019-04-23,04:00:00,2,0,2,FMN GV 05 Lier
60,Mechelsesteenweg 365,2019-04-23,05:00:00,6,2,4,FMN GV 05 Lier
60,Mechelsesteenweg 365,2019-04-23,06:00:00,24,6,18,FMN GV 05 Lier
60,Mechelsesteenweg 365,2019-04-23,07:00:00,212,108,104,FMN GV 05 Lier
60,Mechelsesteenweg 365,2019-04-23,08:00:00,170,90,80,FMN GV 05 Lier
60,Mechelsesteenweg 365,2019-04-23,09:00:00,102,38,64,FMN GV 05 Lier
60,Mechelsesteenweg 365,2019-04-23,10:00:00,112,78,34,FMN GV 05 Lier
60,Mechelsesteenweg 365,2019-04-23,11:00:00,84,48,36,FMN GV 05 Lier
60,Mechelsesteenweg 365,2019-04-23,12:00:00,68,30,38,FMN GV 05 Lier
60,Mechelsesteenweg 365,2019-04-23,13:00:00,150,70,80,FMN GV 05 Lier
60,Mechelsesteenweg 365,2019-04-23,14:00:00,208,100,108,FMN GV 05 Lier
60,Mechelsesteenweg 365,2019-04-23,15:00:00,184,74,110,FMN GV 05 Lier
60,Mechelsesteenweg 365,2019-04-23,16:00:00,340,120,220,FMN GV 05 Lier
60,Mechelsesteenweg 365,2019-04-23,17:00:00,268,132,136,FMN GV 05 Lier
60,Mechelsesteenweg 365,2019-04-23,18:00:00,132,58,74,FMN GV 05 Lier
60,Mechelsesteenweg 365,2019-04-23,19:00:00,150,74,76,FMN GV 05 Lier
60,Mechelsesteenweg 365,2019-04-23,20:00:00,102,34,68,FMN GV 05 Lier
60,Mechelsesteenweg 365,2019-04-23,21:00:00,18,6,12,FMN GV 05 Lier
60,Mechelsesteenweg 365,2019-04-23,22:00:00,10,8,2,FMN GV 05 Lier
60,Mechelsesteenweg 365,2019-04-23,23:00:00,0,0,0,FMN GV 05 Lier
60,Mechelsesteenweg 365,2019-04-24,00:00:00,2,0,2,FMN GV 05 Lier
60,Mechelsesteenweg 365,2019-04-24,01:00:00,0,0,0,FMN GV 05 Lier
60,Mechelsesteenweg 365,2019-04-24,02:00:00,0,0,0,FMN GV 05 Lier
60,Mechelsesteenweg 365,2019-04-24,03:00:00,0,0,0,FMN GV 05 Lier
60,Mechelsesteenweg 365,2019-04-24,04:00:00,4,0,4,FMN GV 05 Lier
60,Mechelsesteenweg 365,2019-04-24,05:00:00,10,6,4,FMN GV 05 Lier
60,Mechelsesteenweg 365,2019-04-24,06:00:00,30,8,22,FMN GV 05 Lier
60,Mechelsesteenweg 365,2019-04-24,07:00:00,206,114,92,FMN GV 05 Lier
60,Mechelsesteenweg 365,2019-04-24,08:00:00,130,68,62,FMN GV 05 Lier
60,Mechelsesteenweg 365,2019-04-24,09:00:00,58,30,28,FMN GV 05 Lier
60,Mechelsesteenweg 365,2019-04-24,10:00:00,80,36,44,FMN GV 05 Lier
60,Mechelsesteenweg 365,2019-04-24,11:00:00,108,60,48,FMN GV 05 Lier
60,Mechelsesteenweg 365,2019-04-24,12:00:00,220,48,172,FMN GV 05 Lier
60,Mechelsesteenweg 365,2019-04-24,13:00:00,108,44,64,FMN GV 05 Lier
60,Mechelsesteenweg 365,2019-04-24,14:00:00,100,60,40,FMN GV 05 Lier
60,Mechelsesteenweg 365,2019-04-24,15:00:00,134,26,108,FMN GV 05 Lier
60,Mechelsesteenweg 365,2019-04-24,16:00:00,106,68,38,FMN GV 05 Lier
60,Mechelsesteenweg 365,2019-04-24,17:00:00,124,74,50,FMN GV 05 Lier
60,Mechelsesteenweg 365,2019-04-24,18:00:00,66,32,34,FMN GV 05 Lier
60,Mechelsesteenweg 365,2019-04-24,19:00:00,64,40,24,FMN GV 05 Lier
60,Mechelsesteenweg 365,2019-04-24,20:00:00,16,8,8,FMN GV 05 Lier
60,Mechelsesteenweg 365,2019-04-24,21:00:00,2,0,2,FMN GV 05 Lier
60,Mechelsesteenweg 365,2019-04-24,22:00:00,6,6,0,FMN GV 05 Lier
60,Mechelsesteenweg 365,2019-04-24,23:00:00,4,2,2,FMN GV 05 Lier
60,Mechelsesteenweg 365,2019-04-25,00:00:00,2,0,2,FMN GV 05 Lier
60,Mechelsesteenweg 365,2019-04-25,01:00:00,0,0,0,FMN GV 05 Lier
60,Mechelsesteenweg 365,2019-04-25,02:00:00,0,0,0,FMN GV 05 Lier
60,Mechelsesteenweg 365,2019-04-25,03:00:00,0,0,0,FMN GV 05 Lier
60,Mechelsesteenweg 365,2019-04-25,04:00:00,2,0,2,FMN GV 05 Lier
60,Mechelsesteenweg 365,2019-04-25,05:00:00,4,0,4,FMN GV 05 Lier
60,Mechelsesteenweg 365,2019-04-25,06:00:00,12,6,6,FMN GV 05 Lier
60,Mechelsesteenweg 365,2019-04-25,07:00:00,150,72,78,FMN GV 05 Lier
60,Mechelsesteenweg 365,2019-04-25,08:00:00,134,82,52,FMN GV 05 Lier
60,Mechelsesteenweg 365,2019-04-25,09:00:00,168,118,50,FMN GV 05 Lier
60,Mechelsesteenweg 365,2019-04-25,10:00:00,92,52,40,FMN GV 05 Lier
60,Mechelsesteenweg 365,2019-04-25,11:00:00,108,76,32,FMN GV 05 Lier
60,Mechelsesteenweg 365,2019-04-25,12:00:00,64,26,38,FMN GV 05 Lier
60,Mechelsesteenweg 365,2019-04-25,13:00:00,56,24,32,FMN GV 05 Lier
60,Mechelsesteenweg 365,2019-04-25,14:00:00,164,20,144,FMN GV 05 Lier
60,Mechelsesteenweg 365,2019-04-25,15:00:00,38,16,22,FMN GV 05 Lier
60,Mechelsesteenweg 365,2019-04-25,16:00:00,154,50,104,FMN GV 05 Lier
60,Mechelsesteenweg 365,2019-04-25,17:00:00,108,60,48,FMN GV 05 Lier
60,Mechelsesteenweg 365,2019-04-25,18:00:00,32,22,10,FMN GV 05 Lier
60,Mechelsesteenweg 365,2019-04-25,19:00:00,18,4,14,FMN GV 05 Lier
60,Mechelsesteenweg 365,2019-04-25,20:00:00,28,6,22,FMN GV 05 Lier
60,Mechelsesteenweg 365,2019-04-25,21:00:00,4,2,2,FMN GV 05 Lier
60,Mechelsesteenweg 365,2019-04-25,22:00:00,6,2,4,FMN GV 05 Lier
60,Mechelsesteenweg 365,2019-04-25,23:00:00,2,2,0,FMN GV 05 Lier
60,Mechelsesteenweg 365,2019-04-26,00:00:00,0,0,0,FMN GV 05 Lier
60,Mechelsesteenweg 365,2019-04-26,01:00:00,0,0,0,FMN GV 05 Lier
60,Mechelsesteenweg 365,2019-04-26,02:00:00,0,0,0,FMN GV 05 Lier
60,Mechelsesteenweg 365,2019-04-26,03:00:00,0,0,0,FMN GV 05 Lier
60,Mechelsesteenweg 365,2019-04-26,04:00:00,4,0,4,FMN GV 05 Lier
60,Mechelsesteenweg 365,2019-04-26,05:00:00,6,0,6,FMN GV 05 Lier
60,Mechelsesteenweg 365,2019-04-26,06:00:00,20,4,16,FMN GV 05 Lier
60,Mechelsesteenweg 365,2019-04-26,07:00:00,154,92,62,FMN GV 05 Lier
60,Mechelsesteenweg 365,2019-04-26,08:00:00,136,76,60,FMN GV 05 Lier
60,Mechelsesteenweg 365,2019-04-26,09:00:00,46,30,16,FMN GV 05 Lier
60,Mechelsesteenweg 365,2019-04-26,10:00:00,130,66,64,FMN GV 05 Lier
60,Mechelsesteenweg 365,2019-04-26,11:00:00,74,32,42,FMN GV 05 Lier
60,Mechelsesteenweg 365,2019-04-26,12:00:00,90,30,60,FMN GV 05 Lier
60,Mechelsesteenweg 365,2019-04-26,13:00:00,102,44,58,FMN GV 05 Lier
60,Mechelsesteenweg 365,2019-04-26,14:00:00,152,74,78,FMN GV 05 Lier
60,Mechelsesteenweg 365,2019-04-26,15:00:00,136,70,66,FMN GV 05 Lier
60,Mechelsesteenweg 365,2019-04-26,16:00:00,236,106,130,FMN GV 05 Lier
60,Mechelsesteenweg 365,2019-04-26,17:00:00,180,96,84,FMN GV 05 Lier
60,Mechelsesteenweg 365,2019-04-26,18:00:00,112,58,54,FMN GV 05 Lier
60,Mechelsesteenweg 365,2019-04-26,19:00:00,80,34,46,FMN GV 05 Lier
60,Mechelsesteenweg 365,2019-04-26,20:00:00,34,12,22,FMN GV 05 Lier
60,Mechelsesteenweg 365,2019-04-26,21:00:00,28,12,16,FMN GV 05 Lier
60,Mechelsesteenweg 365,2019-04-26,22:00:00,2,0,2,FMN GV 05 Lier
60,Mechelsesteenweg 365,2019-04-26,23:00:00,12,6,6,FMN GV 05 Lier
60,Mechelsesteenweg 365,2019-04-27,00:00:00,6,0,6,FMN GV 05 Lier
60,Mechelsesteenweg 365,2019-04-27,01:00:00,4,0,4,FMN GV 05 Lier
60,Mechelsesteenweg 365,2019-04-27,02:00:00,6,2,4,FMN GV 05 Lier
60,Mechelsesteenweg 365,2019-04-27,03:00:00,0,0,0,FMN GV 05 Lier
60,Mechelsesteenweg 365,2019-04-27,04:00:00,2,2,0,FMN GV 05 Lier
60,Mechelsesteenweg 365,2019-04-27,05:00:00,0,0,0,FMN GV 05 Lier
60,Mechelsesteenweg 365,2019-04-27,06:00:00,2,2,0,FMN GV 05 Lier
60,Mechelsesteenweg 365,2019-04-27,07:00:00,4,0,4,FMN GV 05 Lier
60,Mechelsesteenweg 365,2019-04-27,08:00:00,14,6,8,FMN GV 05 Lier
60,Mechelsesteenweg 365,2019-04-27,09:00:00,30,16,14,FMN GV 05 Lier
60,Mechelsesteenweg 365,2019-04-27,10:00:00,26,12,14,FMN GV 05 Lier
60,Mechelsesteenweg 365,2019-04-27,11:00:00,32,22,10,FMN GV 05 Lier
60,Mechelsesteenweg 365,2019-04-27,12:00:00,60,20,40,FMN GV 05 Lier
60,Mechelsesteenweg 365,2019-04-27,13:00:00,56,36,20,FMN GV 05 Lier
60,Mechelsesteenweg 365,2019-04-27,14:00:00,62,44,18,FMN GV 05 Lier
60,Mechelsesteenweg 365,2019-04-27,15:00:00,72,52,20,FMN GV 05 Lier
60,Mechelsesteenweg 365,2019-04-27,16:00:00,72,44,28,FMN GV 05 Lier
60,Mechelsesteenweg 365,2019-04-27,17:00:00,26,14,12,FMN GV 05 Lier
60,Mechelsesteenweg 365,2019-04-27,18:00:00,16,8,8,FMN GV 05 Lier
60,Mechelsesteenweg 365,2019-04-27,19:00:00,6,2,4,FMN GV 05 Lier
60,Mechelsesteenweg 365,2019-04-27,20:00:00,8,2,6,FMN GV 05 Lier
60,Mechelsesteenweg 365,2019-04-27,21:00:00,14,6,8,FMN GV 05 Lier
60,Mechelsesteenweg 365,2019-04-27,22:00:00,4,2,2,FMN GV 05 Lier
60,Mechelsesteenweg 365,2019-04-27,23:00:00,0,0,0,FMN GV 05 Lier
60,Mechelsesteenweg 365,2019-04-28,00:00:00,2,2,0,FMN GV 05 Lier
60,Mechelsesteenweg 365,2019-04-28,01:00:00,0,0,0,FMN GV 05 Lier
60,Mechelsesteenweg 365,2019-04-28,02:00:00,0,0,0,FMN GV 05 Lier
60,Mechelsesteenweg 365,2019-04-28,03:00:00,0,0,0,FMN GV 05 Lier
60,Mechelsesteenweg 365,2019-04-28,04:00:00,0,0,0,FMN GV 05 Lier
60,Mechelsesteenweg 365,2019-04-28,05:00:00,0,0,0,FMN GV 05 Lier
60,Mechelsesteenweg 365,2019-04-28,06:00:00,0,0,0,FMN GV 05 Lier
60,Mechelsesteenweg 365,2019-04-28,07:00:00,0,0,0,FMN GV 05 Lier
60,Mechelsesteenweg 365,2019-04-28,08:00:00,8,6,2,FMN GV 05 Lier
60,Mechelsesteenweg 365,2019-04-28,09:00:00,38,18,20,FMN GV 05 Lier
60,Mechelsesteenweg 365,2019-04-28,10:00:00,52,32,20,FMN GV 05 Lier
60,Mechelsesteenweg 365,2019-04-28,11:00:00,116,52,64,FMN GV 05 Lier
60,Mechelsesteenweg 365,2019-04-28,12:00:00,42,20,22,FMN GV 05 Lier
60,Mechelsesteenweg 365,2019-04-28,13:00:00,36,14,22,FMN GV 05 Lier
60,Mechelsesteenweg 365,2019-04-28,14:00:00,38,20,18,FMN GV 05 Lier
60,Mechelsesteenweg 365,2019-04-28,15:00:00,44,14,30,FMN GV 05 Lier
60,Mechelsesteenweg 365,2019-04-28,16:00:00,40,14,26,FMN GV 05 Lier
60,Mechelsesteenweg 365,2019-04-28,17:00:00,20,10,10,FMN GV 05 Lier
60,Mechelsesteenweg 365,2019-04-28,18:00:00,12,10,2,FMN GV 05 Lier
60,Mechelsesteenweg 365,2019-04-28,19:00:00,16,8,8,FMN GV 05 Lier
60,Mechelsesteenweg 365,2019-04-28,20:00:00,6,0,6,FMN GV 05 Lier
60,Mechelsesteenweg 365,2019-04-28,21:00:00,12,4,8,FMN GV 05 Lier
60,Mechelsesteenweg 365,2019-04-28,22:00:00,4,0,4,FMN GV 05 Lier
60,Mechelsesteenweg 365,2019-04-28,23:00:00,0,0,0,FMN GV 05 Lier
60,Mechelsesteenweg 365,2019-04-29,00:00:00,0,0,0,FMN GV 05 Lier
60,Mechelsesteenweg 365,2019-04-29,01:00:00,0,0,0,FMN GV 05 Lier
60,Mechelsesteenweg 365,2019-04-29,02:00:00,0,0,0,FMN GV 05 Lier
60,Mechelsesteenweg 365,2019-04-29,03:00:00,0,0,0,FMN GV 05 Lier
60,Mechelsesteenweg 365,2019-04-29,04:00:00,4,0,4,FMN GV 05 Lier
60,Mechelsesteenweg 365,2019-04-29,05:00:00,10,2,8,FMN GV 05 Lier
60,Mechelsesteenweg 365,2019-04-29,06:00:00,22,2,20,FMN GV 05 Lier
60,Mechelsesteenweg 365,2019-04-29,07:00:00,160,84,76,FMN GV 05 Lier
60,Mechelsesteenweg 365,2019-04-29,08:00:00,126,68,58,FMN GV 05 Lier
60,Mechelsesteenweg 365,2019-04-29,09:00:00,78,48,30,FMN GV 05 Lier
60,Mechelsesteenweg 365,2019-04-29,10:00:00,68,40,28,FMN GV 05 Lier
60,Mechelsesteenweg 365,2019-04-29,11:00:00,78,26,52,FMN GV 05 Lier
60,Mechelsesteenweg 365,2019-04-29,12:00:00,86,46,40,FMN GV 05 Lier
60,Mechelsesteenweg 365,2019-04-29,13:00:00,124,50,74,FMN GV 05 Lier
60,Mechelsesteenweg 365,2019-04-29,14:00:00,182,78,104,FMN GV 05 Lier
60,Mechelsesteenweg 365,2019-04-29,15:00:00,178,84,94,FMN GV 05 Lier
60,Mechelsesteenweg 365,2019-04-29,16:00:00,226,94,132,FMN GV 05 Lier
60,Mechelsesteenweg 365,2019-04-29,17:00:00,140,84,56,FMN GV 05 Lier
60,Mechelsesteenweg 365,2019-04-29,18:00:00,146,72,74,FMN GV 05 Lier
60,Mechelsesteenweg 365,2019-04-29,19:00:00,102,56,46,FMN GV 05 Lier
60,Mechelsesteenweg 365,2019-04-29,20:00:00,54,14,40,FMN GV 05 Lier
60,Mechelsesteenweg 365,2019-04-29,21:00:00,24,6,18,FMN GV 05 Lier
60,Mechelsesteenweg 365,2019-04-29,22:00:00,10,2,8,FMN GV 05 Lier
60,Mechelsesteenweg 365,2019-04-29,23:00:00,0,0,0,FMN GV 05 Lier
60,Mechelsesteenweg 365,2019-04-30,00:00:00,0,0,0,FMN GV 05 Lier
60,Mechelsesteenweg 365,2019-04-30,01:00:00,0,0,0,FMN GV 05 Lier
60,Mechelsesteenweg 365,2019-04-30,02:00:00,0,0,0,FMN GV 05 Lier
60,Mechelsesteenweg 365,2019-04-30,03:00:00,0,0,0,FMN GV 05 Lier
60,Mechelsesteenweg 365,2019-04-30,04:00:00,6,0,6,FMN GV 05 Lier
60,Mechelsesteenweg 365,2019-04-30,05:00:00,6,0,6,FMN GV 05 Lier
60,Mechelsesteenweg 365,2019-04-30,06:00:00,34,10,24,FMN GV 05 Lier
60,Mechelsesteenweg 365,2019-04-30,07:00:00,166,72,94,FMN GV 05 Lier
60,Mechelsesteenweg 365,2019-04-30,08:00:00,194,126,68,FMN GV 05 Lier
60,Mechelsesteenweg 365,2019-04-30,09:00:00,82,46,36,FMN GV 05 Lier
60,Mechelsesteenweg 365,2019-04-30,10:00:00,82,32,50,FMN GV 05 Lier
60,Mechelsesteenweg 365,2019-04-30,11:00:00,70,30,40,FMN GV 05 Lier
60,Mechelsesteenweg 365,2019-04-30,12:00:00,80,32,48,FMN GV 05 Lier
60,Mechelsesteenweg 365,2019-04-30,13:00:00,118,66,52,FMN GV 05 Lier
60,Mechelsesteenweg 365,2019-04-30,14:00:00,128,60,68,FMN GV 05 Lier
60,Mechelsesteenweg 365,2019-04-30,15:00:00,180,74,106,FMN GV 05 Lier
60,Mechelsesteenweg 365,2019-04-30,16:00:00,194,88,106,FMN GV 05 Lier
60,Mechelsesteenweg 365,2019-04-30,17:00:00,192,92,100,FMN GV 05 Lier
60,Mechelsesteenweg 365,2019-04-30,18:00:00,58,36,22,FMN GV 05 Lier
60,Mechelsesteenweg 365,2019-04-30,19:00:00,64,44,20,FMN GV 05 Lier
60,Mechelsesteenweg 365,2019-04-30,20:00:00,72,36,36,FMN GV 05 Lier
60,Mechelsesteenweg 365,2019-04-30,21:00:00,16,6,10,FMN GV 05 Lier
60,Mechelsesteenweg 365,2019-04-30,22:00:00,8,6,2,FMN GV 05 Lier
60,Mechelsesteenweg 365,2019-04-30,23:00:00,8,4,4,FMN GV 05 Lier
60,Mechelsesteenweg 365,2019-05-01,00:00:00,2,0,2,FMN GV 05 Lier
60,Mechelsesteenweg 365,2019-05-01,01:00:00,0,0,0,FMN GV 05 Lier
60,Mechelsesteenweg 365,2019-05-01,02:00:00,0,0,0,FMN GV 05 Lier
60,Mechelsesteenweg 365,2019-05-01,03:00:00,2,2,0,FMN GV 05 Lier
60,Mechelsesteenweg 365,2019-05-01,04:00:00,2,0,2,FMN GV 05 Lier
60,Mechelsesteenweg 365,2019-05-01,05:00:00,0,0,0,FMN GV 05 Lier
60,Mechelsesteenweg 365,2019-05-01,06:00:00,10,2,8,FMN GV 05 Lier
60,Mechelsesteenweg 365,2019-05-01,07:00:00,22,8,14,FMN GV 05 Lier
60,Mechelsesteenweg 365,2019-05-01,08:00:00,54,22,32,FMN GV 05 Lier
60,Mechelsesteenweg 365,2019-05-01,09:00:00,164,80,84,FMN GV 05 Lier
60,Mechelsesteenweg 365,2019-05-01,10:00:00,300,156,144,FMN GV 05 Lier
60,Mechelsesteenweg 365,2019-05-01,11:00:00,360,150,210,FMN GV 05 Lier
60,Mechelsesteenweg 365,2019-05-01,12:00:00,232,124,108,FMN GV 05 Lier
60,Mechelsesteenweg 365,2019-05-01,13:00:00,352,198,154,FMN GV 05 Lier
60,Mechelsesteenweg 365,2019-05-01,14:00:00,488,274,214,FMN GV 05 Lier
60,Mechelsesteenweg 365,2019-05-01,15:00:00,434,184,250,FMN GV 05 Lier
60,Mechelsesteenweg 365,2019-05-01,16:00:00,336,120,216,FMN GV 05 Lier
60,Mechelsesteenweg 365,2019-05-01,17:00:00,244,120,124,FMN GV 05 Lier
60,Mechelsesteenweg 365,2019-05-01,18:00:00,88,40,48,FMN GV 05 Lier
60,Mechelsesteenweg 365,2019-05-01,19:00:00,102,54,48,FMN GV 05 Lier
60,Mechelsesteenweg 365,2019-05-01,20:00:00,98,50,48,FMN GV 05 Lier
60,Mechelsesteenweg 365,2019-05-01,21:00:00,26,10,16,FMN GV 05 Lier
60,Mechelsesteenweg 365,2019-05-01,22:00:00,2,0,2,FMN GV 05 Lier
60,Mechelsesteenweg 365,2019-05-01,23:00:00,4,4,0,FMN GV 05 Lier
60,Mechelsesteenweg 365,2019-05-02,00:00:00,0,0,0,FMN GV 05 Lier
60,Mechelsesteenweg 365,2019-05-02,01:00:00,0,0,0,FMN GV 05 Lier
60,Mechelsesteenweg 365,2019-05-02,02:00:00,0,0,0,FMN GV 05 Lier
60,Mechelsesteenweg 365,2019-05-02,03:00:00,2,0,2,FMN GV 05 Lier
60,Mechelsesteenweg 365,2019-05-02,04:00:00,2,0,2,FMN GV 05 Lier
60,Mechelsesteenweg 365,2019-05-02,05:00:00,6,0,6,FMN GV 05 Lier
60,Mechelsesteenweg 365,2019-05-02,06:00:00,20,4,16,FMN GV 05 Lier
60,Mechelsesteenweg 365,2019-05-02,07:00:00,146,76,70,FMN GV 05 Lier
60,Mechelsesteenweg 365,2019-05-02,08:00:00,98,58,40,FMN GV 05 Lier
60,Mechelsesteenweg 365,2019-05-02,09:00:00,60,38,22,FMN GV 05 Lier
60,Mechelsesteenweg 365,2019-05-02,10:00:00,50,30,20,FMN GV 05 Lier
60,Mechelsesteenweg 365,2019-05-02,11:00:00,64,28,36,FMN GV 05 Lier
60,Mechelsesteenweg 365,2019-05-02,12:00:00,48,18,30,FMN GV 05 Lier
60,Mechelsesteenweg 365,2019-05-02,13:00:00,24,8,16,FMN GV 05 Lier
60,Mechelsesteenweg 365,2019-05-02,14:00:00,50,6,44,FMN GV 05 Lier
60,Mechelsesteenweg 365,2019-05-02,15:00:00,54,28,26,FMN GV 05 Lier
60,Mechelsesteenweg 365,2019-05-02,16:00:00,112,42,70,FMN GV 05 Lier
60,Mechelsesteenweg 365,2019-05-02,17:00:00,68,46,22,FMN GV 05 Lier
60,Mechelsesteenweg 365,2019-05-02,18:00:00,54,28,26,FMN GV 05 Lier
60,Mechelsesteenweg 365,2019-05-02,19:00:00,44,26,18,FMN GV 05 Lier
60,Mechelsesteenweg 365,2019-05-02,20:00:00,110,42,68,FMN GV 05 Lier
60,Mechelsesteenweg 365,2019-05-02,21:00:00,16,8,8,FMN GV 05 Lier
60,Mechelsesteenweg 365,2019-05-02,22:00:00,4,0,4,FMN GV 05 Lier
60,Mechelsesteenweg 365,2019-05-02,23:00:00,2,0,2,FMN GV 05 Lier
60,Mechelsesteenweg 365,2019-05-03,00:00:00,0,0,0,FMN GV 05 Lier
60,Mechelsesteenweg 365,2019-05-03,01:00:00,0,0,0,FMN GV 05 Lier
60,Mechelsesteenweg 365,2019-05-03,02:00:00,0,0,0,FMN GV 05 Lier
60,Mechelsesteenweg 365,2019-05-03,03:00:00,2,0,2,FMN GV 05 Lier
60,Mechelsesteenweg 365,2019-05-03,04:00:00,2,0,2,FMN GV 05 Lier
60,Mechelsesteenweg 365,2019-05-03,05:00:00,2,0,2,FMN GV 05 Lier
60,Mechelsesteenweg 365,2019-05-03,06:00:00,14,6,8,FMN GV 05 Lier
60,Mechelsesteenweg 365,2019-05-03,07:00:00,148,90,58,FMN GV 05 Lier
60,Mechelsesteenweg 365,2019-05-03,08:00:00,80,48,32,FMN GV 05 Lier
60,Mechelsesteenweg 365,2019-05-03,09:00:00,30,12,18,FMN GV 05 Lier
60,Mechelsesteenweg 365,2019-05-03,10:00:00,116,60,56,FMN GV 05 Lier
60,Mechelsesteenweg 365,2019-05-03,11:00:00,78,40,38,FMN GV 05 Lier
60,Mechelsesteenweg 365,2019-05-03,12:00:00,72,24,48,FMN GV 05 Lier
60,Mechelsesteenweg 365,2019-05-03,13:00:00,84,48,36,FMN GV 05 Lier
60,Mechelsesteenweg 365,2019-05-03,14:00:00,156,52,104,FMN GV 05 Lier
60,Mechelsesteenweg 365,2019-05-03,15:00:00,116,52,64,FMN GV 05 Lier
60,Mechelsesteenweg 365,2019-05-03,16:00:00,166,66,100,FMN GV 05 Lier
60,Mechelsesteenweg 365,2019-05-03,17:00:00,94,54,40,FMN GV 05 Lier
60,Mechelsesteenweg 365,2019-05-03,18:00:00,44,24,20,FMN GV 05 Lier
60,Mechelsesteenweg 365,2019-05-03,19:00:00,24,6,18,FMN GV 05 Lier
60,Mechelsesteenweg 365,2019-05-03,20:00:00,20,6,14,FMN GV 05 Lier
60,Mechelsesteenweg 365,2019-05-03,21:00:00,22,10,12,FMN GV 05 Lier
60,Mechelsesteenweg 365,2019-05-03,22:00:00,14,4,10,FMN GV 05 Lier
60,Mechelsesteenweg 365,2019-05-03,23:00:00,0,0,0,FMN GV 05 Lier
60,Mechelsesteenweg 365,2019-05-04,00:00:00,0,0,0,FMN GV 05 Lier
60,Mechelsesteenweg 365,2019-05-04,01:00:00,0,0,0,FMN GV 05 Lier
60,Mechelsesteenweg 365,2019-05-04,02:00:00,0,0,0,FMN GV 05 Lier
60,Mechelsesteenweg 365,2019-05-04,03:00:00,0,0,0,FMN GV 05 Lier
60,Mechelsesteenweg 365,2019-05-04,04:00:00,0,0,0,FMN GV 05 Lier
60,Mechelsesteenweg 365,2019-05-04,05:00:00,0,0,0,FMN GV 05 Lier
60,Mechelsesteenweg 365,2019-05-04,06:00:00,4,2,2,FMN GV 05 Lier
60,Mechelsesteenweg 365,2019-05-04,07:00:00,2,0,2,FMN GV 05 Lier
60,Mechelsesteenweg 365,2019-05-04,08:00:00,14,10,4,FMN GV 05 Lier
60,Mechelsesteenweg 365,2019-05-04,09:00:00,64,30,34,FMN GV 05 Lier
60,Mechelsesteenweg 365,2019-05-04,10:00:00,50,18,32,FMN GV 05 Lier
60,Mechelsesteenweg 365,2019-05-04,11:00:00,34,14,20,FMN GV 05 Lier
60,Mechelsesteenweg 365,2019-05-04,12:00:00,30,16,14,FMN GV 05 Lier
60,Mechelsesteenweg 365,2019-05-04,13:00:00,42,26,16,FMN GV 05 Lier
60,Mechelsesteenweg 365,2019-05-04,14:00:00,46,36,10,FMN GV 05 Lier
60,Mechelsesteenweg 365,2019-05-04,15:00:00,52,18,34,FMN GV 05 Lier
60,Mechelsesteenweg 365,2019-05-04,16:00:00,30,12,18,FMN GV 05 Lier
60,Mechelsesteenweg 365,2019-05-04,17:00:00,34,20,14,FMN GV 05 Lier
60,Mechelsesteenweg 365,2019-05-04,18:00:00,42,10,32,FMN GV 05 Lier
60,Mechelsesteenweg 365,2019-05-04,19:00:00,18,8,10,FMN GV 05 Lier
60,Mechelsesteenweg 365,2019-05-04,20:00:00,6,4,2,FMN GV 05 Lier
60,Mechelsesteenweg 365,2019-05-04,21:00:00,28,10,18,FMN GV 05 Lier
60,Mechelsesteenweg 365,2019-05-04,22:00:00,6,2,4,FMN GV 05 Lier
60,Mechelsesteenweg 365,2019-05-04,23:00:00,4,2,2,FMN GV 05 Lier
60,Mechelsesteenweg 365,2019-05-05,00:00:00,6,6,0,FMN GV 05 Lier
60,Mechelsesteenweg 365,2019-05-05,01:00:00,2,0,2,FMN GV 05 Lier
60,Mechelsesteenweg 365,2019-05-05,02:00:00,2,0,2,FMN GV 05 Lier
60,Mechelsesteenweg 365,2019-05-05,03:00:00,4,0,4,FMN GV 05 Lier
60,Mechelsesteenweg 365,2019-05-05,04:00:00,8,0,8,FMN GV 05 Lier
60,Mechelsesteenweg 365,2019-05-05,05:00:00,2,0,2,FMN GV 05 Lier
60,Mechelsesteenweg 365,2019-05-05,06:00:00,6,4,2,FMN GV 05 Lier
60,Mechelsesteenweg 365,2019-05-05,07:00:00,14,8,6,FMN GV 05 Lier
60,Mechelsesteenweg 365,2019-05-05,08:00:00,16,6,10,FMN GV 05 Lier
60,Mechelsesteenweg 365,2019-05-05,09:00:00,106,66,40,FMN GV 05 Lier
60,Mechelsesteenweg 365,2019-05-05,10:00:00,188,70,118,FMN GV 05 Lier
60,Mechelsesteenweg 365,2019-05-05,11:00:00,172,72,100,FMN GV 05 Lier
60,Mechelsesteenweg 365,2019-05-05,12:00:00,460,46,414,FMN GV 05 Lier
60,Mechelsesteenweg 365,2019-05-05,13:00:00,116,12,104,FMN GV 05 Lier
60,Mechelsesteenweg 365,2019-05-05,14:00:00,108,14,94,FMN GV 05 Lier
60,Mechelsesteenweg 365,2019-05-05,15:00:00,540,70,470,FMN GV 05 Lier
60,Mechelsesteenweg 365,2019-05-05,16:00:00,126,12,114,FMN GV 05 Lier
60,Mechelsesteenweg 365,2019-05-05,17:00:00,24,12,12,FMN GV 05 Lier
60,Mechelsesteenweg 365,2019-05-05,18:00:00,40,18,22,FMN GV 05 Lier
60,Mechelsesteenweg 365,2019-05-05,19:00:00,12,10,2,FMN GV 05 Lier
60,Mechelsesteenweg 365,2019-05-05,20:00:00,28,10,18,FMN GV 05 Lier
60,Mechelsesteenweg 365,2019-05-05,21:00:00,2,2,0,FMN GV 05 Lier
60,Mechelsesteenweg 365,2019-05-05,22:00:00,0,0,0,FMN GV 05 Lier
60,Mechelsesteenweg 365,2019-05-05,23:00:00,0,0,0,FMN GV 05 Lier
60,Mechelsesteenweg 365,2019-05-06,00:00:00,0,0,0,FMN GV 05 Lier
60,Mechelsesteenweg 365,2019-05-06,01:00:00,0,0,0,FMN GV 05 Lier
60,Mechelsesteenweg 365,2019-05-06,02:00:00,0,0,0,FMN GV 05 Lier
60,Mechelsesteenweg 365,2019-05-06,03:00:00,2,0,2,FMN GV 05 Lier
60,Mechelsesteenweg 365,2019-05-06,04:00:00,2,0,2,FMN GV 05 Lier
60,Mechelsesteenweg 365,2019-05-06,05:00:00,10,2,8,FMN GV 05 Lier
60,Mechelsesteenweg 365,2019-05-06,06:00:00,28,10,18,FMN GV 05 Lier
60,Mechelsesteenweg 365,2019-05-06,07:00:00,132,78,54,FMN GV 05 Lier
60,Mechelsesteenweg 365,2019-05-06,08:00:00,134,86,48,FMN GV 05 Lier
60,Mechelsesteenweg 365,2019-05-06,09:00:00,54,24,30,FMN GV 05 Lier
60,Mechelsesteenweg 365,2019-05-06,10:00:00,20,8,12,FMN GV 05 Lier
60,Mechelsesteenweg 365,2019-05-06,11:00:00,48,14,34,FMN GV 05 Lier
60,Mechelsesteenweg 365,2019-05-06,12:00:00,44,14,30,FMN GV 05 Lier
60,Mechelsesteenweg 365,2019-05-06,13:00:00,40,22,18,FMN GV 05 Lier
60,Mechelsesteenweg 365,2019-05-06,14:00:00,26,14,12,FMN GV 05 Lier
60,Mechelsesteenweg 365,2019-05-06,15:00:00,60,44,16,FMN GV 05 Lier
60,Mechelsesteenweg 365,2019-05-06,16:00:00,178,50,128,FMN GV 05 Lier
60,Mechelsesteenweg 365,2019-05-06,17:00:00,102,60,42,FMN GV 05 Lier
60,Mechelsesteenweg 365,2019-05-06,18:00:00,58,28,30,FMN GV 05 Lier
60,Mechelsesteenweg 365,2019-05-06,19:00:00,36,8,28,FMN GV 05 Lier
60,Mechelsesteenweg 365,2019-05-06,20:00:00,32,14,18,FMN GV 05 Lier
60,Mechelsesteenweg 365,2019-05-06,21:00:00,4,0,4,FMN GV 05 Lier
60,Mechelsesteenweg 365,2019-05-06,22:00:00,0,0,0,FMN GV 05 Lier
60,Mechelsesteenweg 365,2019-05-06,23:00:00,0,0,0,FMN GV 05 Lier
60,Mechelsesteenweg 365,2019-05-07,00:00:00,0,0,0,FMN GV 05 Lier
60,Mechelsesteenweg 365,2019-05-07,01:00:00,0,0,0,FMN GV 05 Lier
60,Mechelsesteenweg 365,2019-05-07,02:00:00,0,0,0,FMN GV 05 Lier
60,Mechelsesteenweg 365,2019-05-07,03:00:00,4,0,4,FMN GV 05 Lier
60,Mechelsesteenweg 365,2019-05-07,04:00:00,0,0,0,FMN GV 05 Lier
60,Mechelsesteenweg 365,2019-05-07,05:00:00,14,4,10,FMN GV 05 Lier
60,Mechelsesteenweg 365,2019-05-07,06:00:00,16,4,12,FMN GV 05 Lier
60,Mechelsesteenweg 365,2019-05-07,07:00:00,182,98,84,FMN GV 05 Lier
60,Mechelsesteenweg 365,2019-05-07,08:00:00,136,86,50,FMN GV 05 Lier
60,Mechelsesteenweg 365,2019-05-07,09:00:00,86,48,38,FMN GV 05 Lier
60,Mechelsesteenweg 365,2019-05-07,10:00:00,140,70,70,FMN GV 05 Lier
60,Mechelsesteenweg 365,2019-05-07,11:00:00,92,58,34,FMN GV 05 Lier
60,Mechelsesteenweg 365,2019-05-07,12:00:00,86,42,44,FMN GV 05 Lier
60,Mechelsesteenweg 365,2019-05-07,13:00:00,152,52,100,FMN GV 05 Lier
60,Mechelsesteenweg 365,2019-05-07,14:00:00,198,84,114,FMN GV 05 Lier
60,Mechelsesteenweg 365,2019-05-07,15:00:00,144,66,78,FMN GV 05 Lier
60,Mechelsesteenweg 365,2019-05-07,16:00:00,256,88,168,FMN GV 05 Lier
60,Mechelsesteenweg 365,2019-05-07,17:00:00,130,74,56,FMN GV 05 Lier
60,Mechelsesteenweg 365,2019-05-07,18:00:00,112,64,48,FMN GV 05 Lier
60,Mechelsesteenweg 365,2019-05-07,19:00:00,96,58,38,FMN GV 05 Lier
60,Mechelsesteenweg 365,2019-05-07,20:00:00,68,18,50,FMN GV 05 Lier
60,Mechelsesteenweg 365,2019-05-07,21:00:00,12,6,6,FMN GV 05 Lier
60,Mechelsesteenweg 365,2019-05-07,22:00:00,2,0,2,FMN GV 05 Lier
60,Mechelsesteenweg 365,2019-05-07,23:00:00,0,0,0,FMN GV 05 Lier
60,Mechelsesteenweg 365,2019-05-08,00:00:00,0,0,0,FMN GV 05 Lier
60,Mechelsesteenweg 365,2019-05-08,01:00:00,0,0,0,FMN GV 05 Lier
60,Mechelsesteenweg 365,2019-05-08,02:00:00,0,0,0,FMN GV 05 Lier
60,Mechelsesteenweg 365,2019-05-08,03:00:00,4,0,4,FMN GV 05 Lier
60,Mechelsesteenweg 365,2019-05-08,04:00:00,2,0,2,FMN GV 05 Lier
60,Mechelsesteenweg 365,2019-05-08,05:00:00,2,0,2,FMN GV 05 Lier
60,Mechelsesteenweg 365,2019-05-08,06:00:00,12,4,8,FMN GV 05 Lier
60,Mechelsesteenweg 365,2019-05-08,07:00:00,132,78,54,FMN GV 05 Lier
60,Mechelsesteenweg 365,2019-05-08,08:00:00,114,76,38,FMN GV 05 Lier
60,Mechelsesteenweg 365,2019-05-08,09:00:00,34,20,14,FMN GV 05 Lier
60,Mechelsesteenweg 365,2019-05-08,10:00:00,28,22,6,FMN GV 05 Lier
60,Mechelsesteenweg 365,2019-05-08,11:00:00,28,6,22,FMN GV 05 Lier
60,Mechelsesteenweg 365,2019-05-08,12:00:00,130,22,108,FMN GV 05 Lier
60,Mechelsesteenweg 365,2019-05-08,13:00:00,34,10,24,FMN GV 05 Lier
60,Mechelsesteenweg 365,2019-05-08,14:00:00,26,12,14,FMN GV 05 Lier
60,Mechelsesteenweg 365,2019-05-08,15:00:00,24,12,12,FMN GV 05 Lier
60,Mechelsesteenweg 365,2019-05-08,16:00:00,36,18,18,FMN GV 05 Lier
60,Mechelsesteenweg 365,2019-05-08,17:00:00,72,54,18,FMN GV 05 Lier
60,Mechelsesteenweg 365,2019-05-08,18:00:00,44,22,22,FMN GV 05 Lier
60,Mechelsesteenweg 365,2019-05-08,19:00:00,86,74,12,FMN GV 05 Lier
60,Mechelsesteenweg 365,2019-05-08,20:00:00,62,38,24,FMN GV 05 Lier
60,Mechelsesteenweg 365,2019-05-08,21:00:00,8,2,6,FMN GV 05 Lier
60,Mechelsesteenweg 365,2019-05-08,22:00:00,0,0,0,FMN GV 05 Lier
60,Mechelsesteenweg 365,2019-05-08,23:00:00,0,0,0,FMN GV 05 Lier
60,Mechelsesteenweg 365,2019-05-09,00:00:00,0,0,0,FMN GV 05 Lier
60,Mechelsesteenweg 365,2019-05-09,01:00:00,0,0,0,FMN GV 05 Lier
60,Mechelsesteenweg 365,2019-05-09,02:00:00,0,0,0,FMN GV 05 Lier
60,Mechelsesteenweg 365,2019-05-09,03:00:00,4,0,4,FMN GV 05 Lier
60,Mechelsesteenweg 365,2019-05-09,04:00:00,0,0,0,FMN GV 05 Lier
60,Mechelsesteenweg 365,2019-05-09,05:00:00,6,0,6,FMN GV 05 Lier
60,Mechelsesteenweg 365,2019-05-09,06:00:00,8,4,4,FMN GV 05 Lier
60,Mechelsesteenweg 365,2019-05-09,07:00:00,128,70,58,FMN GV 05 Lier
60,Mechelsesteenweg 365,2019-05-09,08:00:00,134,70,64,FMN GV 05 Lier
60,Mechelsesteenweg 365,2019-05-09,09:00:00,56,38,18,FMN GV 05 Lier
60,Mechelsesteenweg 365,2019-05-09,10:00:00,94,38,56,FMN GV 05 Lier
60,Mechelsesteenweg 365,2019-05-09,11:00:00,84,44,40,FMN GV 05 Lier
60,Mechelsesteenweg 365,2019-05-09,12:00:00,56,24,32,FMN GV 05 Lier
60,Mechelsesteenweg 365,2019-05-09,13:00:00,64,38,26,FMN GV 05 Lier
60,Mechelsesteenweg 365,2019-05-09,14:00:00,100,30,70,FMN GV 05 Lier
60,Mechelsesteenweg 365,2019-05-09,15:00:00,102,46,56,FMN GV 05 Lier
60,Mechelsesteenweg 365,2019-05-09,16:00:00,164,64,100,FMN GV 05 Lier
60,Mechelsesteenweg 365,2019-05-09,17:00:00,68,38,30,FMN GV 05 Lier
60,Mechelsesteenweg 365,2019-05-09,18:00:00,28,14,14,FMN GV 05 Lier
60,Mechelsesteenweg 365,2019-05-09,19:00:00,34,18,16,FMN GV 05 Lier
60,Mechelsesteenweg 365,2019-05-09,20:00:00,86,26,60,FMN GV 05 Lier
60,Mechelsesteenweg 365,2019-05-09,21:00:00,8,2,6,FMN GV 05 Lier
60,Mechelsesteenweg 365,2019-05-09,22:00:00,8,4,4,FMN GV 05 Lier
60,Mechelsesteenweg 365,2019-05-09,23:00:00,6,0,6,FMN GV 05 Lier
60,Mechelsesteenweg 365,2019-05-10,00:00:00,0,0,0,FMN GV 05 Lier
60,Mechelsesteenweg 365,2019-05-10,01:00:00,0,0,0,FMN GV 05 Lier
60,Mechelsesteenweg 365,2019-05-10,02:00:00,0,0,0,FMN GV 05 Lier
60,Mechelsesteenweg 365,2019-05-10,03:00:00,4,0,4,FMN GV 05 Lier
60,Mechelsesteenweg 365,2019-05-10,04:00:00,0,0,0,FMN GV 05 Lier
60,Mechelsesteenweg 365,2019-05-10,05:00:00,6,0,6,FMN GV 05 Lier
60,Mechelsesteenweg 365,2019-05-10,06:00:00,20,6,14,FMN GV 05 Lier
60,Mechelsesteenweg 365,2019-05-10,07:00:00,70,38,32,FMN GV 05 Lier
60,Mechelsesteenweg 365,2019-05-10,08:00:00,94,52,42,FMN GV 05 Lier
60,Mechelsesteenweg 365,2019-05-10,09:00:00,52,24,28,FMN GV 05 Lier
60,Mechelsesteenweg 365,2019-05-10,10:00:00,32,14,18,FMN GV 05 Lier
60,Mechelsesteenweg 365,2019-05-10,11:00:00,28,18,10,FMN GV 05 Lier
60,Mechelsesteenweg 365,2019-05-10,12:00:00,30,14,16,FMN GV 05 Lier
60,Mechelsesteenweg 365,2019-05-10,13:00:00,18,12,6,FMN GV 05 Lier
60,Mechelsesteenweg 365,2019-05-10,14:00:00,56,28,28,FMN GV 05 Lier
60,Mechelsesteenweg 365,2019-05-10,15:00:00,80,40,40,FMN GV 05 Lier
60,Mechelsesteenweg 365,2019-05-10,16:00:00,138,48,90,FMN GV 05 Lier
60,Mechelsesteenweg 365,2019-05-10,17:00:00,70,28,42,FMN GV 05 Lier
60,Mechelsesteenweg 365,2019-05-10,18:00:00,56,24,32,FMN GV 05 Lier
60,Mechelsesteenweg 365,2019-05-10,19:00:00,54,36,18,FMN GV 05 Lier
60,Mechelsesteenweg 365,2019-05-10,20:00:00,26,10,16,FMN GV 05 Lier
60,Mechelsesteenweg 365,2019-05-10,21:00:00,12,8,4,FMN GV 05 Lier
60,Mechelsesteenweg 365,2019-05-10,22:00:00,14,0,14,FMN GV 05 Lier
60,Mechelsesteenweg 365,2019-05-10,23:00:00,4,2,2,FMN GV 05 Lier
60,Mechelsesteenweg 365,2019-05-11,00:00:00,2,2,0,FMN GV 05 Lier
60,Mechelsesteenweg 365,2019-05-11,01:00:00,4,0,4,FMN GV 05 Lier
60,Mechelsesteenweg 365,2019-05-11,02:00:00,2,2,0,FMN GV 05 Lier
60,Mechelsesteenweg 365,2019-05-11,03:00:00,0,0,0,FMN GV 05 Lier
60,Mechelsesteenweg 365,2019-05-11,04:00:00,2,0,2,FMN GV 05 Lier
60,Mechelsesteenweg 365,2019-05-11,05:00:00,2,0,2,FMN GV 05 Lier
60,Mechelsesteenweg 365,2019-05-11,06:00:00,2,0,2,FMN GV 05 Lier
60,Mechelsesteenweg 365,2019-05-11,07:00:00,8,4,4,FMN GV 05 Lier
60,Mechelsesteenweg 365,2019-05-11,08:00:00,12,8,4,FMN GV 05 Lier
60,Mechelsesteenweg 365,2019-05-11,09:00:00,52,24,28,FMN GV 05 Lier
60,Mechelsesteenweg 365,2019-05-11,10:00:00,138,72,66,FMN GV 05 Lier
60,Mechelsesteenweg 365,2019-05-11,11:00:00,98,44,54,FMN GV 05 Lier
60,Mechelsesteenweg 365,2019-05-11,12:00:00,102,48,54,FMN GV 05 Lier
60,Mechelsesteenweg 365,2019-05-11,13:00:00,96,38,58,FMN GV 05 Lier
60,Mechelsesteenweg 365,2019-05-11,14:00:00,150,92,58,FMN GV 05 Lier
60,Mechelsesteenweg 365,2019-05-11,15:00:00,148,52,96,FMN GV 05 Lier
60,Mechelsesteenweg 365,2019-05-11,16:00:00,146,60,86,FMN GV 05 Lier
60,Mechelsesteenweg 365,2019-05-11,17:00:00,72,28,44,FMN GV 05 Lier
60,Mechelsesteenweg 365,2019-05-11,18:00:00,24,10,14,FMN GV 05 Lier
60,Mechelsesteenweg 365,2019-05-11,19:00:00,28,8,20,FMN GV 05 Lier
60,Mechelsesteenweg 365,2019-05-11,20:00:00,30,6,24,FMN GV 05 Lier
60,Mechelsesteenweg 365,2019-05-11,21:00:00,16,8,8,FMN GV 05 Lier
60,Mechelsesteenweg 365,2019-05-11,22:00:00,6,6,0,FMN GV 05 Lier
60,Mechelsesteenweg 365,2019-05-11,23:00:00,2,0,2,FMN GV 05 Lier
60,Mechelsesteenweg 365,2019-05-12,00:00:00,2,0,2,FMN GV 05 Lier
60,Mechelsesteenweg 365,2019-05-12,01:00:00,0,0,0,FMN GV 05 Lier
60,Mechelsesteenweg 365,2019-05-12,02:00:00,0,0,0,FMN GV 05 Lier
60,Mechelsesteenweg 365,2019-05-12,03:00:00,0,0,0,FMN GV 05 Lier
60,Mechelsesteenweg 365,2019-05-12,04:00:00,0,0,0,FMN GV 05 Lier
60,Mechelsesteenweg 365,2019-05-12,05:00:00,6,4,2,FMN GV 05 Lier
60,Mechelsesteenweg 365,2019-05-12,06:00:00,2,0,2,FMN GV 05 Lier
60,Mechelsesteenweg 365,2019-05-12,07:00:00,6,4,2,FMN GV 05 Lier
60,Mechelsesteenweg 365,2019-05-12,08:00:00,54,30,24,FMN GV 05 Lier
60,Mechelsesteenweg 365,2019-05-12,09:00:00,180,102,78,FMN GV 05 Lier
60,Mechelsesteenweg 365,2019-05-12,10:00:00,282,132,150,FMN GV 05 Lier
60,Mechelsesteenweg 365,2019-05-12,11:00:00,272,106,166,FMN GV 05 Lier
60,Mechelsesteenweg 365,2019-05-12,12:00:00,148,70,78,FMN GV 05 Lier
60,Mechelsesteenweg 365,2019-05-12,13:00:00,144,54,90,FMN GV 05 Lier
60,Mechelsesteenweg 365,2019-05-12,14:00:00,258,148,110,FMN GV 05 Lier
60,Mechelsesteenweg 365,2019-05-12,15:00:00,234,100,134,FMN GV 05 Lier
60,Mechelsesteenweg 365,2019-05-12,16:00:00,182,62,120,FMN GV 05 Lier
60,Mechelsesteenweg 365,2019-05-12,17:00:00,126,44,82,FMN GV 05 Lier
60,Mechelsesteenweg 365,2019-05-12,18:00:00,42,24,18,FMN GV 05 Lier
60,Mechelsesteenweg 365,2019-05-12,19:00:00,34,10,24,FMN GV 05 Lier
60,Mechelsesteenweg 365,2019-05-12,20:00:00,16,10,6,FMN GV 05 Lier
60,Mechelsesteenweg 365,2019-05-12,21:00:00,4,2,2,FMN GV 05 Lier
60,Mechelsesteenweg 365,2019-05-12,22:00:00,4,2,2,FMN GV 05 Lier
60,Mechelsesteenweg 365,2019-05-12,23:00:00,0,0,0,FMN GV 05 Lier
60,Mechelsesteenweg 365,2019-05-13,00:00:00,2,0,2,FMN GV 05 Lier
60,Mechelsesteenweg 365,2019-05-13,01:00:00,2,0,2,FMN GV 05 Lier
60,Mechelsesteenweg 365,2019-05-13,02:00:00,0,0,0,FMN GV 05 Lier
60,Mechelsesteenweg 365,2019-05-13,03:00:00,0,0,0,FMN GV 05 Lier
60,Mechelsesteenweg 365,2019-05-13,04:00:00,6,0,6,FMN GV 05 Lier
60,Mechelsesteenweg 365,2019-05-13,05:00:00,4,2,2,FMN GV 05 Lier
60,Mechelsesteenweg 365,2019-05-13,06:00:00,20,2,18,FMN GV 05 Lier
60,Mechelsesteenweg 365,2019-05-13,07:00:00,170,88,82,FMN GV 05 Lier
60,Mechelsesteenweg 365,2019-05-13,08:00:00,172,114,58,FMN GV 05 Lier
60,Mechelsesteenweg 365,2019-05-13,09:00:00,44,22,22,FMN GV 05 Lier
60,Mechelsesteenweg 365,2019-05-13,10:00:00,126,80,46,FMN GV 05 Lier
60,Mechelsesteenweg 365,2019-05-13,11:00:00,96,48,48,FMN GV 05 Lier
60,Mechelsesteenweg 365,2019-05-13,12:00:00,100,40,60,FMN GV 05 Lier
60,Mechelsesteenweg 365,2019-05-13,13:00:00,166,56,110,FMN GV 05 Lier
60,Mechelsesteenweg 365,2019-05-13,14:00:00,198,114,84,FMN GV 05 Lier
60,Mechelsesteenweg 365,2019-05-13,15:00:00,154,68,86,FMN GV 05 Lier
60,Mechelsesteenweg 365,2019-05-13,16:00:00,256,70,186,FMN GV 05 Lier
60,Mechelsesteenweg 365,2019-05-13,17:00:00,182,110,72,FMN GV 05 Lier
60,Mechelsesteenweg 365,2019-05-13,18:00:00,90,46,44,FMN GV 05 Lier
60,Mechelsesteenweg 365,2019-05-13,19:00:00,74,32,42,FMN GV 05 Lier
60,Mechelsesteenweg 365,2019-05-13,20:00:00,44,18,26,FMN GV 05 Lier
60,Mechelsesteenweg 365,2019-05-13,21:00:00,28,10,18,FMN GV 05 Lier
60,Mechelsesteenweg 365,2019-05-13,22:00:00,16,14,2,FMN GV 05 Lier
60,Mechelsesteenweg 365,2019-05-13,23:00:00,0,0,0,FMN GV 05 Lier
60,Mechelsesteenweg 365,2019-05-14,00:00:00,0,0,0,FMN GV 05 Lier
60,Mechelsesteenweg 365,2019-05-14,01:00:00,0,0,0,FMN GV 05 Lier
60,Mechelsesteenweg 365,2019-05-14,02:00:00,0,0,0,FMN GV 05 Lier
60,Mechelsesteenweg 365,2019-05-14,03:00:00,2,0,2,FMN GV 05 Lier
60,Mechelsesteenweg 365,2019-05-14,04:00:00,2,0,2,FMN GV 05 Lier
60,Mechelsesteenweg 365,2019-05-14,05:00:00,10,2,8,FMN GV 05 Lier
60,Mechelsesteenweg 365,2019-05-14,06:00:00,36,6,30,FMN GV 05 Lier
60,Mechelsesteenweg 365,2019-05-14,07:00:00,208,118,90,FMN GV 05 Lier
60,Mechelsesteenweg 365,2019-05-14,08:00:00,166,88,78,FMN GV 05 Lier
60,Mechelsesteenweg 365,2019-05-14,09:00:00,66,50,16,FMN GV 05 Lier
60,Mechelsesteenweg 365,2019-05-14,10:00:00,80,30,50,FMN GV 05 Lier
60,Mechelsesteenweg 365,2019-05-14,11:00:00,142,80,62,FMN GV 05 Lier
60,Mechelsesteenweg 365,2019-05-14,12:00:00,114,50,64,FMN GV 05 Lier
60,Mechelsesteenweg 365,2019-05-14,13:00:00,164,66,98,FMN GV 05 Lier
60,Mechelsesteenweg 365,2019-05-14,14:00:00,192,92,100,FMN GV 05 Lier
60,Mechelsesteenweg 365,2019-05-14,15:00:00,204,78,126,FMN GV 05 Lier
60,Mechelsesteenweg 365,2019-05-14,16:00:00,340,116,224,FMN GV 05 Lier
60,Mechelsesteenweg 365,2019-05-14,17:00:00,192,100,92,FMN GV 05 Lier
60,Mechelsesteenweg 365,2019-05-14,18:00:00,110,54,56,FMN GV 05 Lier
60,Mechelsesteenweg 365,2019-05-14,19:00:00,196,96,100,FMN GV 05 Lier
60,Mechelsesteenweg 365,2019-05-14,20:00:00,104,38,66,FMN GV 05 Lier
60,Mechelsesteenweg 365,2019-05-14,21:00:00,28,14,14,FMN GV 05 Lier
60,Mechelsesteenweg 365,2019-05-14,22:00:00,12,4,8,FMN GV 05 Lier
60,Mechelsesteenweg 365,2019-05-14,23:00:00,2,2,0,FMN GV 05 Lier
60,Mechelsesteenweg 365,2019-05-15,00:00:00,0,0,0,FMN GV 05 Lier
60,Mechelsesteenweg 365,2019-05-15,01:00:00,0,0,0,FMN GV 05 Lier
60,Mechelsesteenweg 365,2019-05-15,02:00:00,0,0,0,FMN GV 05 Lier
60,Mechelsesteenweg 365,2019-05-15,03:00:00,2,0,2,FMN GV 05 Lier
60,Mechelsesteenweg 365,2019-05-15,04:00:00,4,0,4,FMN GV 05 Lier
60,Mechelsesteenweg 365,2019-05-15,05:00:00,2,0,2,FMN GV 05 Lier
60,Mechelsesteenweg 365,2019-05-15,06:00:00,32,2,30,FMN GV 05 Lier
60,Mechelsesteenweg 365,2019-05-15,07:00:00,206,98,108,FMN GV 05 Lier
60,Mechelsesteenweg 365,2019-05-15,08:00:00,172,100,72,FMN GV 05 Lier
60,Mechelsesteenweg 365,2019-05-15,09:00:00,66,34,32,FMN GV 05 Lier
60,Mechelsesteenweg 365,2019-05-15,10:00:00,96,52,44,FMN GV 05 Lier
60,Mechelsesteenweg 365,2019-05-15,11:00:00,142,58,84,FMN GV 05 Lier
60,Mechelsesteenweg 365,2019-05-15,12:00:00,210,66,144,FMN GV 05 Lier
60,Mechelsesteenweg 365,2019-05-15,13:00:00,168,92,76,FMN GV 05 Lier
60,Mechelsesteenweg 365,2019-05-15,14:00:00,252,126,126,FMN GV 05 Lier
60,Mechelsesteenweg 365,2019-05-15,15:00:00,226,120,106,FMN GV 05 Lier
60,Mechelsesteenweg 365,2019-05-15,16:00:00,214,120,94,FMN GV 05 Lier
60,Mechelsesteenweg 365,2019-05-15,17:00:00,172,110,62,FMN GV 05 Lier
60,Mechelsesteenweg 365,2019-05-15,18:00:00,176,100,76,FMN GV 05 Lier
60,Mechelsesteenweg 365,2019-05-15,19:00:00,200,124,76,FMN GV 05 Lier
60,Mechelsesteenweg 365,2019-05-15,20:00:00,138,52,86,FMN GV 05 Lier
60,Mechelsesteenweg 365,2019-05-15,21:00:00,28,12,16,FMN GV 05 Lier
60,Mechelsesteenweg 365,2019-05-15,22:00:00,10,4,6,FMN GV 05 Lier
60,Mechelsesteenweg 365,2019-05-15,23:00:00,4,4,0,FMN GV 05 Lier
60,Mechelsesteenweg 365,2019-05-16,00:00:00,0,0,0,FMN GV 05 Lier
60,Mechelsesteenweg 365,2019-05-16,01:00:00,0,0,0,FMN GV 05 Lier
60,Mechelsesteenweg 365,2019-05-16,02:00:00,0,0,0,FMN GV 05 Lier
60,Mechelsesteenweg 365,2019-05-16,03:00:00,0,0,0,FMN GV 05 Lier
60,Mechelsesteenweg 365,2019-05-16,04:00:00,2,0,2,FMN GV 05 Lier
60,Mechelsesteenweg 365,2019-05-16,05:00:00,4,0,4,FMN GV 05 Lier
60,Mechelsesteenweg 365,2019-05-16,06:00:00,30,8,22,FMN GV 05 Lier
60,Mechelsesteenweg 365,2019-05-16,07:00:00,172,84,88,FMN GV 05 Lier
60,Mechelsesteenweg 365,2019-05-16,08:00:00,172,106,66,FMN GV 05 Lier
60,Mechelsesteenweg 365,2019-05-16,09:00:00,58,44,14,FMN GV 05 Lier
60,Mechelsesteenweg 365,2019-05-16,10:00:00,96,32,64,FMN GV 05 Lier
60,Mechelsesteenweg 365,2019-05-16,11:00:00,136,52,84,FMN GV 05 Lier
60,Mechelsesteenweg 365,2019-05-16,12:00:00,148,76,72,FMN GV 05 Lier
60,Mechelsesteenweg 365,2019-05-16,13:00:00,144,60,84,FMN GV 05 Lier
60,Mechelsesteenweg 365,2019-05-16,14:00:00,214,138,76,FMN GV 05 Lier
60,Mechelsesteenweg 365,2019-05-16,15:00:00,192,76,116,FMN GV 05 Lier
60,Mechelsesteenweg 365,2019-05-16,16:00:00,250,74,176,FMN GV 05 Lier
60,Mechelsesteenweg 365,2019-05-16,17:00:00,168,84,84,FMN GV 05 Lier
60,Mechelsesteenweg 365,2019-05-16,18:00:00,162,76,86,FMN GV 05 Lier
60,Mechelsesteenweg 365,2019-05-16,19:00:00,154,72,82,FMN GV 05 Lier
60,Mechelsesteenweg 365,2019-05-16,20:00:00,132,48,84,FMN GV 05 Lier
60,Mechelsesteenweg 365,2019-05-16,21:00:00,40,6,34,FMN GV 05 Lier
60,Mechelsesteenweg 365,2019-05-16,22:00:00,10,4,6,FMN GV 05 Lier
60,Mechelsesteenweg 365,2019-05-16,23:00:00,12,2,10,FMN GV 05 Lier
60,Mechelsesteenweg 365,2019-05-17,00:00:00,0,0,0,FMN GV 05 Lier
60,Mechelsesteenweg 365,2019-05-17,01:00:00,0,0,0,FMN GV 05 Lier
60,Mechelsesteenweg 365,2019-05-17,02:00:00,0,0,0,FMN GV 05 Lier
60,Mechelsesteenweg 365,2019-05-17,03:00:00,2,0,2,FMN GV 05 Lier
60,Mechelsesteenweg 365,2019-05-17,04:00:00,0,0,0,FMN GV 05 Lier
60,Mechelsesteenweg 365,2019-05-17,05:00:00,6,2,4,FMN GV 05 Lier
60,Mechelsesteenweg 365,2019-05-17,06:00:00,20,6,14,FMN GV 05 Lier
60,Mechelsesteenweg 365,2019-05-17,07:00:00,144,86,58,FMN GV 05 Lier
60,Mechelsesteenweg 365,2019-05-17,08:00:00,132,86,46,FMN GV 05 Lier
60,Mechelsesteenweg 365,2019-05-17,09:00:00,36,20,16,FMN GV 05 Lier
60,Mechelsesteenweg 365,2019-05-17,10:00:00,170,126,44,FMN GV 05 Lier
60,Mechelsesteenweg 365,2019-05-17,11:00:00,112,64,48,FMN GV 05 Lier
60,Mechelsesteenweg 365,2019-05-17,12:00:00,48,16,32,FMN GV 05 Lier
60,Mechelsesteenweg 365,2019-05-17,13:00:00,176,42,134,FMN GV 05 Lier
60,Mechelsesteenweg 365,2019-05-17,14:00:00,74,44,30,FMN GV 05 Lier
60,Mechelsesteenweg 365,2019-05-17,15:00:00,152,56,96,FMN GV 05 Lier
60,Mechelsesteenweg 365,2019-05-17,16:00:00,178,70,108,FMN GV 05 Lier
60,Mechelsesteenweg 365,2019-05-17,17:00:00,74,38,36,FMN GV 05 Lier
60,Mechelsesteenweg 365,2019-05-17,18:00:00,60,28,32,FMN GV 05 Lier
60,Mechelsesteenweg 365,2019-05-17,19:00:00,66,44,22,FMN GV 05 Lier
60,Mechelsesteenweg 365,2019-05-17,20:00:00,34,14,20,FMN GV 05 Lier
60,Mechelsesteenweg 365,2019-05-17,21:00:00,16,10,6,FMN GV 05 Lier
60,Mechelsesteenweg 365,2019-05-17,22:00:00,26,12,14,FMN GV 05 Lier
60,Mechelsesteenweg 365,2019-05-17,23:00:00,4,0,4,FMN GV 05 Lier
60,Mechelsesteenweg 365,2019-05-18,00:00:00,4,2,2,FMN GV 05 Lier
60,Mechelsesteenweg 365,2019-05-18,01:00:00,8,0,8,FMN GV 05 Lier
60,Mechelsesteenweg 365,2019-05-18,02:00:00,0,0,0,FMN GV 05 Lier
60,Mechelsesteenweg 365,2019-05-18,03:00:00,0,0,0,FMN GV 05 Lier
60,Mechelsesteenweg 365,2019-05-18,04:00:00,2,0,2,FMN GV 05 Lier
60,Mechelsesteenweg 365,2019-05-18,05:00:00,0,0,0,FMN GV 05 Lier
60,Mechelsesteenweg 365,2019-05-18,06:00:00,4,2,2,FMN GV 05 Lier
60,Mechelsesteenweg 365,2019-05-18,07:00:00,22,10,12,FMN GV 05 Lier
60,Mechelsesteenweg 365,2019-05-18,08:00:00,50,24,26,FMN GV 05 Lier
60,Mechelsesteenweg 365,2019-05-18,09:00:00,128,82,46,FMN GV 05 Lier
60,Mechelsesteenweg 365,2019-05-18,10:00:00,210,104,106,FMN GV 05 Lier
60,Mechelsesteenweg 365,2019-05-18,11:00:00,214,96,118,FMN GV 05 Lier
60,Mechelsesteenweg 365,2019-05-18,12:00:00,138,76,62,FMN GV 05 Lier
60,Mechelsesteenweg 365,2019-05-18,13:00:00,192,94,98,FMN GV 05 Lier
60,Mechelsesteenweg 365,2019-05-18,14:00:00,254,148,106,FMN GV 05 Lier
60,Mechelsesteenweg 365,2019-05-18,15:00:00,300,148,152,FMN GV 05 Lier
60,Mechelsesteenweg 365,2019-05-18,16:00:00,152,64,88,FMN GV 05 Lier
60,Mechelsesteenweg 365,2019-05-18,17:00:00,122,48,74,FMN GV 05 Lier
60,Mechelsesteenweg 365,2019-05-18,18:00:00,54,24,30,FMN GV 05 Lier
60,Mechelsesteenweg 365,2019-05-18,19:00:00,40,28,12,FMN GV 05 Lier
60,Mechelsesteenweg 365,2019-05-18,20:00:00,10,6,4,FMN GV 05 Lier
60,Mechelsesteenweg 365,2019-05-18,21:00:00,14,8,6,FMN GV 05 Lier
60,Mechelsesteenweg 365,2019-05-18,22:00:00,6,4,2,FMN GV 05 Lier
60,Mechelsesteenweg 365,2019-05-18,23:00:00,2,2,0,FMN GV 05 Lier
60,Mechelsesteenweg 365,2019-05-19,00:00:00,6,2,4,FMN GV 05 Lier
60,Mechelsesteenweg 365,2019-05-19,01:00:00,2,0,2,FMN GV 05 Lier
60,Mechelsesteenweg 365,2019-05-19,02:00:00,0,0,0,FMN GV 05 Lier
60,Mechelsesteenweg 365,2019-05-19,03:00:00,0,0,0,FMN GV 05 Lier
60,Mechelsesteenweg 365,2019-05-19,04:00:00,0,0,0,FMN GV 05 Lier
60,Mechelsesteenweg 365,2019-05-19,05:00:00,0,0,0,FMN GV 05 Lier
60,Mechelsesteenweg 365,2019-05-19,06:00:00,0,0,0,FMN GV 05 Lier
60,Mechelsesteenweg 365,2019-05-19,07:00:00,10,4,6,FMN GV 05 Lier
60,Mechelsesteenweg 365,2019-05-19,08:00:00,26,14,12,FMN GV 05 Lier
60,Mechelsesteenweg 365,2019-05-19,09:00:00,146,118,28,FMN GV 05 Lier
60,Mechelsesteenweg 365,2019-05-19,10:00:00,198,118,80,FMN GV 05 Lier
60,Mechelsesteenweg 365,2019-05-19,11:00:00,196,72,124,FMN GV 05 Lier
60,Mechelsesteenweg 365,2019-05-19,12:00:00,120,24,96,FMN GV 05 Lier
60,Mechelsesteenweg 365,2019-05-19,13:00:00,144,64,80,FMN GV 05 Lier
60,Mechelsesteenweg 365,2019-05-19,14:00:00,240,102,138,FMN GV 05 Lier
60,Mechelsesteenweg 365,2019-05-19,15:00:00,240,128,112,FMN GV 05 Lier
60,Mechelsesteenweg 365,2019-05-19,16:00:00,200,100,100,FMN GV 05 Lier
60,Mechelsesteenweg 365,2019-05-19,17:00:00,126,46,80,FMN GV 05 Lier
60,Mechelsesteenweg 365,2019-05-19,18:00:00,42,26,16,FMN GV 05 Lier
60,Mechelsesteenweg 365,2019-05-19,19:00:00,2,2,0,FMN GV 05 Lier
60,Mechelsesteenweg 365,2019-05-19,20:00:00,6,2,4,FMN GV 05 Lier
60,Mechelsesteenweg 365,2019-05-19,21:00:00,6,2,4,FMN GV 05 Lier
60,Mechelsesteenweg 365,2019-05-19,22:00:00,0,0,0,FMN GV 05 Lier
60,Mechelsesteenweg 365,2019-05-19,23:00:00,2,0,2,FMN GV 05 Lier
60,Mechelsesteenweg 365,2019-05-20,00:00:00,0,0,0,FMN GV 05 Lier
60,Mechelsesteenweg 365,2019-05-20,01:00:00,2,2,0,FMN GV 05 Lier
60,Mechelsesteenweg 365,2019-05-20,02:00:00,0,0,0,FMN GV 05 Lier
60,Mechelsesteenweg 365,2019-05-20,03:00:00,2,0,2,FMN GV 05 Lier
60,Mechelsesteenweg 365,2019-05-20,04:00:00,6,0,6,FMN GV 05 Lier
60,Mechelsesteenweg 365,2019-05-20,05:00:00,6,2,4,FMN GV 05 Lier
60,Mechelsesteenweg 365,2019-05-20,06:00:00,10,2,8,FMN GV 05 Lier
60,Mechelsesteenweg 365,2019-05-20,07:00:00,160,70,90,FMN GV 05 Lier
60,Mechelsesteenweg 365,2019-05-20,08:00:00,136,76,60,FMN GV 05 Lier
60,Mechelsesteenweg 365,2019-05-20,09:00:00,78,14,64,FMN GV 05 Lier
60,Mechelsesteenweg 365,2019-05-20,10:00:00,54,14,40,FMN GV 05 Lier
60,Mechelsesteenweg 365,2019-05-20,11:00:00,66,46,20,FMN GV 05 Lier
60,Mechelsesteenweg 365,2019-05-20,12:00:00,44,20,24,FMN GV 05 Lier
60,Mechelsesteenweg 365,2019-05-20,13:00:00,56,30,26,FMN GV 05 Lier
60,Mechelsesteenweg 365,2019-05-20,14:00:00,50,24,26,FMN GV 05 Lier
60,Mechelsesteenweg 365,2019-05-20,15:00:00,90,36,54,FMN GV 05 Lier
60,Mechelsesteenweg 365,2019-05-20,16:00:00,214,82,132,FMN GV 05 Lier
60,Mechelsesteenweg 365,2019-05-20,17:00:00,114,70,44,FMN GV 05 Lier
60,Mechelsesteenweg 365,2019-05-20,18:00:00,52,40,12,FMN GV 05 Lier
60,Mechelsesteenweg 365,2019-05-20,19:00:00,36,18,18,FMN GV 05 Lier
60,Mechelsesteenweg 365,2019-05-20,20:00:00,12,10,2,FMN GV 05 Lier
60,Mechelsesteenweg 365,2019-05-20,21:00:00,10,2,8,FMN GV 05 Lier
60,Mechelsesteenweg 365,2019-05-20,22:00:00,6,2,4,FMN GV 05 Lier
60,Mechelsesteenweg 365,2019-05-20,23:00:00,0,0,0,FMN GV 05 Lier
60,Mechelsesteenweg 365,2019-05-21,00:00:00,0,0,0,FMN GV 05 Lier
60,Mechelsesteenweg 365,2019-05-21,01:00:00,0,0,0,FMN GV 05 Lier
60,Mechelsesteenweg 365,2019-05-21,02:00:00,0,0,0,FMN GV 05 Lier
60,Mechelsesteenweg 365,2019-05-21,03:00:00,0,0,0,FMN GV 05 Lier
60,Mechelsesteenweg 365,2019-05-21,04:00:00,4,0,4,FMN GV 05 Lier
60,Mechelsesteenweg 365,2019-05-21,05:00:00,10,2,8,FMN GV 05 Lier
60,Mechelsesteenweg 365,2019-05-21,06:00:00,30,14,16,FMN GV 05 Lier
60,Mechelsesteenweg 365,2019-05-21,07:00:00,150,68,82,FMN GV 05 Lier
60,Mechelsesteenweg 365,2019-05-21,08:00:00,132,72,60,FMN GV 05 Lier
60,Mechelsesteenweg 365,2019-05-21,09:00:00,44,20,24,FMN GV 05 Lier
60,Mechelsesteenweg 365,2019-05-21,10:00:00,68,26,42,FMN GV 05 Lier
60,Mechelsesteenweg 365,2019-05-21,11:00:00,82,48,34,FMN GV 05 Lier
60,Mechelsesteenweg 365,2019-05-21,12:00:00,54,16,38,FMN GV 05 Lier
60,Mechelsesteenweg 365,2019-05-21,13:00:00,106,36,70,FMN GV 05 Lier
60,Mechelsesteenweg 365,2019-05-21,14:00:00,128,62,66,FMN GV 05 Lier
60,Mechelsesteenweg 365,2019-05-21,15:00:00,144,48,96,FMN GV 05 Lier
60,Mechelsesteenweg 365,2019-05-21,16:00:00,198,72,126,FMN GV 05 Lier
60,Mechelsesteenweg 365,2019-05-21,17:00:00,150,90,60,FMN GV 05 Lier
60,Mechelsesteenweg 365,2019-05-21,18:00:00,78,32,46,FMN GV 05 Lier
60,Mechelsesteenweg 365,2019-05-21,19:00:00,52,28,24,FMN GV 05 Lier
60,Mechelsesteenweg 365,2019-05-21,20:00:00,74,24,50,FMN GV 05 Lier
60,Mechelsesteenweg 365,2019-05-21,21:00:00,18,12,6,FMN GV 05 Lier
60,Mechelsesteenweg 365,2019-05-21,22:00:00,2,2,0,FMN GV 05 Lier
60,Mechelsesteenweg 365,2019-05-21,23:00:00,0,0,0,FMN GV 05 Lier
60,Mechelsesteenweg 365,2019-05-22,00:00:00,0,0,0,FMN GV 05 Lier
60,Mechelsesteenweg 365,2019-05-22,01:00:00,0,0,0,FMN GV 05 Lier
60,Mechelsesteenweg 365,2019-05-22,02:00:00,0,0,0,FMN GV 05 Lier
60,Mechelsesteenweg 365,2019-05-22,03:00:00,0,0,0,FMN GV 05 Lier
60,Mechelsesteenweg 365,2019-05-22,04:00:00,4,0,4,FMN GV 05 Lier
60,Mechelsesteenweg 365,2019-05-22,05:00:00,4,2,2,FMN GV 05 Lier
60,Mechelsesteenweg 365,2019-05-22,06:00:00,30,12,18,FMN GV 05 Lier
60,Mechelsesteenweg 365,2019-05-22,07:00:00,178,92,86,FMN GV 05 Lier
60,Mechelsesteenweg 365,2019-05-22,08:00:00,194,82,112,FMN GV 05 Lier
60,Mechelsesteenweg 365,2019-05-22,09:00:00,70,46,24,FMN GV 05 Lier
60,Mechelsesteenweg 365,2019-05-22,10:00:00,80,46,34,FMN GV 05 Lier
60,Mechelsesteenweg 365,2019-05-22,11:00:00,186,126,60,FMN GV 05 Lier
60,Mechelsesteenweg 365,2019-05-22,12:00:00,218,64,154,FMN GV 05 Lier
60,Mechelsesteenweg 365,2019-05-22,13:00:00,214,122,92,FMN GV 05 Lier
60,Mechelsesteenweg 365,2019-05-22,14:00:00,204,106,98,FMN GV 05 Lier
60,Mechelsesteenweg 365,2019-05-22,15:00:00,234,98,136,FMN GV 05 Lier
60,Mechelsesteenweg 365,2019-05-22,16:00:00,182,80,102,FMN GV 05 Lier
60,Mechelsesteenweg 365,2019-05-22,17:00:00,200,132,68,FMN GV 05 Lier
60,Mechelsesteenweg 365,2019-05-22,18:00:00,116,58,58,FMN GV 05 Lier
60,Mechelsesteenweg 365,2019-05-22,19:00:00,192,112,80,FMN GV 05 Lier
60,Mechelsesteenweg 365,2019-05-22,20:00:00,118,30,88,FMN GV 05 Lier
60,Mechelsesteenweg 365,2019-05-22,21:00:00,42,16,26,FMN GV 05 Lier
60,Mechelsesteenweg 365,2019-05-22,22:00:00,6,2,4,FMN GV 05 Lier
60,Mechelsesteenweg 365,2019-05-22,23:00:00,2,2,0,FMN GV 05 Lier
60,Mechelsesteenweg 365,2019-05-23,00:00:00,0,0,0,FMN GV 05 Lier
60,Mechelsesteenweg 365,2019-05-23,01:00:00,0,0,0,FMN GV 05 Lier
60,Mechelsesteenweg 365,2019-05-23,02:00:00,0,0,0,FMN GV 05 Lier
60,Mechelsesteenweg 365,2019-05-23,03:00:00,2,0,2,FMN GV 05 Lier
60,Mechelsesteenweg 365,2019-05-23,04:00:00,8,2,6,FMN GV 05 Lier
60,Mechelsesteenweg 365,2019-05-23,05:00:00,2,0,2,FMN GV 05 Lier
60,Mechelsesteenweg 365,2019-05-23,06:00:00,40,14,26,FMN GV 05 Lier
60,Mechelsesteenweg 365,2019-05-23,07:00:00,180,98,82,FMN GV 05 Lier
60,Mechelsesteenweg 365,2019-05-23,08:00:00,170,88,82,FMN GV 05 Lier
60,Mechelsesteenweg 365,2019-05-23,09:00:00,68,36,32,FMN GV 05 Lier
60,Mechelsesteenweg 365,2019-05-23,10:00:00,142,64,78,FMN GV 05 Lier
60,Mechelsesteenweg 365,2019-05-23,11:00:00,114,62,52,FMN GV 05 Lier
60,Mechelsesteenweg 365,2019-05-23,12:00:00,146,80,66,FMN GV 05 Lier
60,Mechelsesteenweg 365,2019-05-23,13:00:00,186,100,86,FMN GV 05 Lier
60,Mechelsesteenweg 365,2019-05-23,14:00:00,264,104,160,FMN GV 05 Lier
60,Mechelsesteenweg 365,2019-05-23,15:00:00,252,128,124,FMN GV 05 Lier
60,Mechelsesteenweg 365,2019-05-23,16:00:00,298,122,176,FMN GV 05 Lier
60,Mechelsesteenweg 365,2019-05-23,17:00:00,188,90,98,FMN GV 05 Lier
60,Mechelsesteenweg 365,2019-05-23,18:00:00,112,62,50,FMN GV 05 Lier
60,Mechelsesteenweg 365,2019-05-23,19:00:00,164,102,62,FMN GV 05 Lier
60,Mechelsesteenweg 365,2019-05-23,20:00:00,146,58,88,FMN GV 05 Lier
60,Mechelsesteenweg 365,2019-05-23,21:00:00,46,30,16,FMN GV 05 Lier
60,Mechelsesteenweg 365,2019-05-23,22:00:00,16,6,10,FMN GV 05 Lier
60,Mechelsesteenweg 365,2019-05-23,23:00:00,10,2,8,FMN GV 05 Lier
60,Mechelsesteenweg 365,2019-05-24,00:00:00,2,0,2,FMN GV 05 Lier
60,Mechelsesteenweg 365,2019-05-24,01:00:00,0,0,0,FMN GV 05 Lier
60,Mechelsesteenweg 365,2019-05-24,02:00:00,0,0,0,FMN GV 05 Lier
60,Mechelsesteenweg 365,2019-05-24,03:00:00,2,0,2,FMN GV 05 Lier
60,Mechelsesteenweg 365,2019-05-24,04:00:00,6,2,4,FMN GV 05 Lier
60,Mechelsesteenweg 365,2019-05-24,05:00:00,8,4,4,FMN GV 05 Lier
60,Mechelsesteenweg 365,2019-05-24,06:00:00,36,10,26,FMN GV 05 Lier
60,Mechelsesteenweg 365,2019-05-24,07:00:00,166,90,76,FMN GV 05 Lier
60,Mechelsesteenweg 365,2019-05-24,08:00:00,160,102,58,FMN GV 05 Lier
60,Mechelsesteenweg 365,2019-05-24,09:00:00,120,78,42,FMN GV 05 Lier
60,Mechelsesteenweg 365,2019-05-24,10:00:00,114,52,62,FMN GV 05 Lier
60,Mechelsesteenweg 365,2019-05-24,11:00:00,140,70,70,FMN GV 05 Lier
60,Mechelsesteenweg 365,2019-05-24,12:00:00,96,50,46,FMN GV 05 Lier
60,Mechelsesteenweg 365,2019-05-24,13:00:00,228,132,96,FMN GV 05 Lier
60,Mechelsesteenweg 365,2019-05-24,14:00:00,302,184,118,FMN GV 05 Lier
60,Mechelsesteenweg 365,2019-05-24,15:00:00,326,96,230,FMN GV 05 Lier
60,Mechelsesteenweg 365,2019-05-24,16:00:00,370,140,230,FMN GV 05 Lier
60,Mechelsesteenweg 365,2019-05-24,17:00:00,160,84,76,FMN GV 05 Lier
60,Mechelsesteenweg 365,2019-05-24,18:00:00,84,56,28,FMN GV 05 Lier
60,Mechelsesteenweg 365,2019-05-24,19:00:00,68,22,46,FMN GV 05 Lier
60,Mechelsesteenweg 365,2019-05-24,20:00:00,64,36,28,FMN GV 05 Lier
60,Mechelsesteenweg 365,2019-05-24,21:00:00,28,4,24,FMN GV 05 Lier
60,Mechelsesteenweg 365,2019-05-24,22:00:00,18,10,8,FMN GV 05 Lier
60,Mechelsesteenweg 365,2019-05-24,23:00:00,4,4,0,FMN GV 05 Lier
60,Mechelsesteenweg 365,2019-05-25,00:00:00,4,0,4,FMN GV 05 Lier
60,Mechelsesteenweg 365,2019-05-25,01:00:00,8,4,4,FMN GV 05 Lier
60,Mechelsesteenweg 365,2019-05-25,02:00:00,12,0,12,FMN GV 05 Lier
60,Mechelsesteenweg 365,2019-05-25,03:00:00,0,0,0,FMN GV 05 Lier
60,Mechelsesteenweg 365,2019-05-25,04:00:00,4,4,0,FMN GV 05 Lier
60,Mechelsesteenweg 365,2019-05-25,05:00:00,2,0,2,FMN GV 05 Lier
60,Mechelsesteenweg 365,2019-05-25,06:00:00,22,20,2,FMN GV 05 Lier
60,Mechelsesteenweg 365,2019-05-25,07:00:00,22,10,12,FMN GV 05 Lier
60,Mechelsesteenweg 365,2019-05-25,08:00:00,68,42,26,FMN GV 05 Lier
60,Mechelsesteenweg 365,2019-05-25,09:00:00,66,34,32,FMN GV 05 Lier
60,Mechelsesteenweg 365,2019-05-25,10:00:00,122,64,58,FMN GV 05 Lier
60,Mechelsesteenweg 365,2019-05-25,11:00:00,58,30,28,FMN GV 05 Lier
60,Mechelsesteenweg 365,2019-05-25,12:00:00,70,28,42,FMN GV 05 Lier
60,Mechelsesteenweg 365,2019-05-25,13:00:00,136,60,76,FMN GV 05 Lier
60,Mechelsesteenweg 365,2019-05-25,14:00:00,170,72,98,FMN GV 05 Lier
60,Mechelsesteenweg 365,2019-05-25,15:00:00,174,80,94,FMN GV 05 Lier
60,Mechelsesteenweg 365,2019-05-25,16:00:00,146,46,100,FMN GV 05 Lier
60,Mechelsesteenweg 365,2019-05-25,17:00:00,72,36,36,FMN GV 05 Lier
60,Mechelsesteenweg 365,2019-05-25,18:00:00,54,24,30,FMN GV 05 Lier
60,Mechelsesteenweg 365,2019-05-25,19:00:00,28,20,8,FMN GV 05 Lier
60,Mechelsesteenweg 365,2019-05-25,20:00:00,38,10,28,FMN GV 05 Lier
60,Mechelsesteenweg 365,2019-05-25,21:00:00,22,14,8,FMN GV 05 Lier
60,Mechelsesteenweg 365,2019-05-25,22:00:00,4,2,2,FMN GV 05 Lier
60,Mechelsesteenweg 365,2019-05-25,23:00:00,6,4,2,FMN GV 05 Lier
60,Mechelsesteenweg 365,2019-05-26,00:00:00,8,6,2,FMN GV 05 Lier
60,Mechelsesteenweg 365,2019-05-26,01:00:00,4,2,2,FMN GV 05 Lier
60,Mechelsesteenweg 365,2019-05-26,02:00:00,2,0,2,FMN GV 05 Lier
60,Mechelsesteenweg 365,2019-05-26,03:00:00,8,0,8,FMN GV 05 Lier
60,Mechelsesteenweg 365,2019-05-26,04:00:00,0,0,0,FMN GV 05 Lier
60,Mechelsesteenweg 365,2019-05-26,05:00:00,2,2,0,FMN GV 05 Lier
60,Mechelsesteenweg 365,2019-05-26,06:00:00,6,4,2,FMN GV 05 Lier
60,Mechelsesteenweg 365,2019-05-26,07:00:00,16,10,6,FMN GV 05 Lier
60,Mechelsesteenweg 365,2019-05-26,08:00:00,38,22,16,FMN GV 05 Lier
60,Mechelsesteenweg 365,2019-05-26,09:00:00,210,114,96,FMN GV 05 Lier
60,Mechelsesteenweg 365,2019-05-26,10:00:00,360,158,202,FMN GV 05 Lier
60,Mechelsesteenweg 365,2019-05-26,11:00:00,266,134,132,FMN GV 05 Lier
60,Mechelsesteenweg 365,2019-05-26,12:00:00,196,88,108,FMN GV 05 Lier
60,Mechelsesteenweg 365,2019-05-26,13:00:00,192,84,108,FMN GV 05 Lier
60,Mechelsesteenweg 365,2019-05-26,14:00:00,236,142,94,FMN GV 05 Lier
60,Mechelsesteenweg 365,2019-05-26,15:00:00,264,112,152,FMN GV 05 Lier
60,Mechelsesteenweg 365,2019-05-26,16:00:00,208,92,116,FMN GV 05 Lier
60,Mechelsesteenweg 365,2019-05-26,17:00:00,114,46,68,FMN GV 05 Lier
60,Mechelsesteenweg 365,2019-05-26,18:00:00,66,14,52,FMN GV 05 Lier
60,Mechelsesteenweg 365,2019-05-26,19:00:00,24,12,12,FMN GV 05 Lier
60,Mechelsesteenweg 365,2019-05-26,20:00:00,16,6,10,FMN GV 05 Lier
60,Mechelsesteenweg 365,2019-05-26,21:00:00,14,4,10,FMN GV 05 Lier
60,Mechelsesteenweg 365,2019-05-26,22:00:00,4,2,2,FMN GV 05 Lier
60,Mechelsesteenweg 365,2019-05-26,23:00:00,2,0,2,FMN GV 05 Lier
60,Mechelsesteenweg 365,2019-05-27,00:00:00,0,0,0,FMN GV 05 Lier
60,Mechelsesteenweg 365,2019-05-27,01:00:00,0,0,0,FMN GV 05 Lier
60,Mechelsesteenweg 365,2019-05-27,02:00:00,0,0,0,FMN GV 05 Lier
60,Mechelsesteenweg 365,2019-05-27,03:00:00,0,0,0,FMN GV 05 Lier
60,Mechelsesteenweg 365,2019-05-27,04:00:00,6,0,6,FMN GV 05 Lier
60,Mechelsesteenweg 365,2019-05-27,05:00:00,6,2,4,FMN GV 05 Lier
60,Mechelsesteenweg 365,2019-05-27,06:00:00,18,4,14,FMN GV 05 Lier
60,Mechelsesteenweg 365,2019-05-27,07:00:00,180,94,86,FMN GV 05 Lier
60,Mechelsesteenweg 365,2019-05-27,08:00:00,158,86,72,FMN GV 05 Lier
60,Mechelsesteenweg 365,2019-05-27,09:00:00,202,124,78,FMN GV 05 Lier
60,Mechelsesteenweg 365,2019-05-27,10:00:00,118,58,60,FMN GV 05 Lier
60,Mechelsesteenweg 365,2019-05-27,11:00:00,122,72,50,FMN GV 05 Lier
60,Mechelsesteenweg 365,2019-05-27,12:00:00,168,74,94,FMN GV 05 Lier
60,Mechelsesteenweg 365,2019-05-27,13:00:00,134,84,50,FMN GV 05 Lier
60,Mechelsesteenweg 365,2019-05-27,14:00:00,202,78,124,FMN GV 05 Lier
60,Mechelsesteenweg 365,2019-05-27,15:00:00,162,76,86,FMN GV 05 Lier
60,Mechelsesteenweg 365,2019-05-27,16:00:00,264,100,164,FMN GV 05 Lier
60,Mechelsesteenweg 365,2019-05-27,17:00:00,98,60,38,FMN GV 05 Lier
60,Mechelsesteenweg 365,2019-05-27,18:00:00,94,56,38,FMN GV 05 Lier
60,Mechelsesteenweg 365,2019-05-27,19:00:00,68,30,38,FMN GV 05 Lier
60,Mechelsesteenweg 365,2019-05-27,20:00:00,66,36,30,FMN GV 05 Lier
60,Mechelsesteenweg 365,2019-05-27,21:00:00,28,6,22,FMN GV 05 Lier
60,Mechelsesteenweg 365,2019-05-27,22:00:00,18,14,4,FMN GV 05 Lier
60,Mechelsesteenweg 365,2019-05-27,23:00:00,2,0,2,FMN GV 05 Lier
60,Mechelsesteenweg 365,2019-05-28,00:00:00,0,0,0,FMN GV 05 Lier
60,Mechelsesteenweg 365,2019-05-28,01:00:00,0,0,0,FMN GV 05 Lier
60,Mechelsesteenweg 365,2019-05-28,02:00:00,0,0,0,FMN GV 05 Lier
60,Mechelsesteenweg 365,2019-05-28,03:00:00,2,0,2,FMN GV 05 Lier
60,Mechelsesteenweg 365,2019-05-28,04:00:00,2,0,2,FMN GV 05 Lier
60,Mechelsesteenweg 365,2019-05-28,05:00:00,4,0,4,FMN GV 05 Lier
60,Mechelsesteenweg 365,2019-05-28,06:00:00,16,2,14,FMN GV 05 Lier
60,Mechelsesteenweg 365,2019-05-28,07:00:00,132,62,70,FMN GV 05 Lier
60,Mechelsesteenweg 365,2019-05-28,08:00:00,104,62,42,FMN GV 05 Lier
60,Mechelsesteenweg 365,2019-05-28,09:00:00,38,24,14,FMN GV 05 Lier
60,Mechelsesteenweg 365,2019-05-28,10:00:00,30,12,18,FMN GV 05 Lier
60,Mechelsesteenweg 365,2019-05-28,11:00:00,16,10,6,FMN GV 05 Lier
60,Mechelsesteenweg 365,2019-05-28,12:00:00,14,8,6,FMN GV 05 Lier
60,Mechelsesteenweg 365,2019-05-28,13:00:00,24,8,16,FMN GV 05 Lier
60,Mechelsesteenweg 365,2019-05-28,14:00:00,78,22,56,FMN GV 05 Lier
60,Mechelsesteenweg 365,2019-05-28,15:00:00,50,20,30,FMN GV 05 Lier
60,Mechelsesteenweg 365,2019-05-28,16:00:00,164,50,114,FMN GV 05 Lier
60,Mechelsesteenweg 365,2019-05-28,17:00:00,92,46,46,FMN GV 05 Lier
60,Mechelsesteenweg 365,2019-05-28,18:00:00,60,36,24,FMN GV 05 Lier
60,Mechelsesteenweg 365,2019-05-28,19:00:00,30,24,6,FMN GV 05 Lier
60,Mechelsesteenweg 365,2019-05-28,20:00:00,46,12,34,FMN GV 05 Lier
60,Mechelsesteenweg 365,2019-05-28,21:00:00,8,2,6,FMN GV 05 Lier
60,Mechelsesteenweg 365,2019-05-28,22:00:00,8,4,4,FMN GV 05 Lier
60,Mechelsesteenweg 365,2019-05-28,23:00:00,2,0,2,FMN GV 05 Lier
60,Mechelsesteenweg 365,2019-05-29,00:00:00,0,0,0,FMN GV 05 Lier
60,Mechelsesteenweg 365,2019-05-29,01:00:00,0,0,0,FMN GV 05 Lier
60,Mechelsesteenweg 365,2019-05-29,02:00:00,0,0,0,FMN GV 05 Lier
60,Mechelsesteenweg 365,2019-05-29,03:00:00,2,0,2,FMN GV 05 Lier
60,Mechelsesteenweg 365,2019-05-29,04:00:00,2,0,2,FMN GV 05 Lier
60,Mechelsesteenweg 365,2019-05-29,05:00:00,8,2,6,FMN GV 05 Lier
60,Mechelsesteenweg 365,2019-05-29,06:00:00,26,4,22,FMN GV 05 Lier
60,Mechelsesteenweg 365,2019-05-29,07:00:00,204,116,88,FMN GV 05 Lier
60,Mechelsesteenweg 365,2019-05-29,08:00:00,130,78,52,FMN GV 05 Lier
60,Mechelsesteenweg 365,2019-05-29,09:00:00,148,108,40,FMN GV 05 Lier
60,Mechelsesteenweg 365,2019-05-29,10:00:00,98,50,48,FMN GV 05 Lier
60,Mechelsesteenweg 365,2019-05-29,11:00:00,192,72,120,FMN GV 05 Lier
60,Mechelsesteenweg 365,2019-05-29,12:00:00,270,108,162,FMN GV 05 Lier
60,Mechelsesteenweg 365,2019-05-29,13:00:00,238,78,160,FMN GV 05 Lier
60,Mechelsesteenweg 365,2019-05-29,14:00:00,210,110,100,FMN GV 05 Lier
60,Mechelsesteenweg 365,2019-05-29,15:00:00,210,90,120,FMN GV 05 Lier
60,Mechelsesteenweg 365,2019-05-29,16:00:00,188,108,80,FMN GV 05 Lier
60,Mechelsesteenweg 365,2019-05-29,17:00:00,138,70,68,FMN GV 05 Lier
60,Mechelsesteenweg 365,2019-05-29,18:00:00,94,66,28,FMN GV 05 Lier
60,Mechelsesteenweg 365,2019-05-29,19:00:00,156,118,38,FMN GV 05 Lier
60,Mechelsesteenweg 365,2019-05-29,20:00:00,100,38,62,FMN GV 05 Lier
60,Mechelsesteenweg 365,2019-05-29,21:00:00,12,6,6,FMN GV 05 Lier
60,Mechelsesteenweg 365,2019-05-29,22:00:00,12,4,8,FMN GV 05 Lier
60,Mechelsesteenweg 365,2019-05-29,23:00:00,4,0,4,FMN GV 05 Lier
60,Mechelsesteenweg 365,2019-05-30,00:00:00,2,0,2,FMN GV 05 Lier
60,Mechelsesteenweg 365,2019-05-30,01:00:00,0,0,0,FMN GV 05 Lier
60,Mechelsesteenweg 365,2019-05-30,02:00:00,0,0,0,FMN GV 05 Lier
60,Mechelsesteenweg 365,2019-05-30,03:00:00,0,0,0,FMN GV 05 Lier
60,Mechelsesteenweg 365,2019-05-30,04:00:00,0,0,0,FMN GV 05 Lier
60,Mechelsesteenweg 365,2019-05-30,05:00:00,4,0,4,FMN GV 05 Lier
60,Mechelsesteenweg 365,2019-05-30,06:00:00,6,4,2,FMN GV 05 Lier
60,Mechelsesteenweg 365,2019-05-30,07:00:00,10,6,4,FMN GV 05 Lier
60,Mechelsesteenweg 365,2019-05-30,08:00:00,40,22,18,FMN GV 05 Lier
60,Mechelsesteenweg 365,2019-05-30,09:00:00,100,54,46,FMN GV 05 Lier
60,Mechelsesteenweg 365,2019-05-30,10:00:00,114,62,52,FMN GV 05 Lier
60,Mechelsesteenweg 365,2019-05-30,11:00:00,128,60,68,FMN GV 05 Lier
60,Mechelsesteenweg 365,2019-05-30,12:00:00,116,48,68,FMN GV 05 Lier
60,Mechelsesteenweg 365,2019-05-30,13:00:00,176,106,70,FMN GV 05 Lier
60,Mechelsesteenweg 365,2019-05-30,14:00:00,216,134,82,FMN GV 05 Lier
60,Mechelsesteenweg 365,2019-05-30,15:00:00,194,98,96,FMN GV 05 Lier
60,Mechelsesteenweg 365,2019-05-30,16:00:00,250,112,138,FMN GV 05 Lier
60,Mechelsesteenweg 365,2019-05-30,17:00:00,76,40,36,FMN GV 05 Lier
60,Mechelsesteenweg 365,2019-05-30,18:00:00,50,18,32,FMN GV 05 Lier
60,Mechelsesteenweg 365,2019-05-30,19:00:00,60,26,34,FMN GV 05 Lier
60,Mechelsesteenweg 365,2019-05-30,20:00:00,56,20,36,FMN GV 05 Lier
60,Mechelsesteenweg 365,2019-05-30,21:00:00,26,10,16,FMN GV 05 Lier
60,Mechelsesteenweg 365,2019-05-30,22:00:00,12,10,2,FMN GV 05 Lier
60,Mechelsesteenweg 365,2019-05-30,23:00:00,0,0,0,FMN GV 05 Lier
60,Mechelsesteenweg 365,2019-05-31,00:00:00,0,0,0,FMN GV 05 Lier
60,Mechelsesteenweg 365,2019-05-31,01:00:00,0,0,0,FMN GV 05 Lier
60,Mechelsesteenweg 365,2019-05-31,02:00:00,0,0,0,FMN GV 05 Lier
60,Mechelsesteenweg 365,2019-05-31,03:00:00,2,0,2,FMN GV 05 Lier
60,Mechelsesteenweg 365,2019-05-31,04:00:00,2,0,2,FMN GV 05 Lier
60,Mechelsesteenweg 365,2019-05-31,05:00:00,0,0,0,FMN GV 05 Lier
60,Mechelsesteenweg 365,2019-05-31,06:00:00,16,10,6,FMN GV 05 Lier
60,Mechelsesteenweg 365,2019-05-31,07:00:00,30,10,20,FMN GV 05 Lier
60,Mechelsesteenweg 365,2019-05-31,08:00:00,70,30,40,FMN GV 05 Lier
60,Mechelsesteenweg 365,2019-05-31,09:00:00,72,38,34,FMN GV 05 Lier
60,Mechelsesteenweg 365,2019-05-31,10:00:00,178,80,98,FMN GV 05 Lier
60,Mechelsesteenweg 365,2019-05-31,11:00:00,266,140,126,FMN GV 05 Lier
60,Mechelsesteenweg 365,2019-05-31,12:00:00,190,80,110,FMN GV 05 Lier
60,Mechelsesteenweg 365,2019-05-31,13:00:00,184,88,96,FMN GV 05 Lier
60,Mechelsesteenweg 365,2019-05-31,14:00:00,252,144,108,FMN GV 05 Lier
60,Mechelsesteenweg 365,2019-05-31,15:00:00,198,68,130,FMN GV 05 Lier
60,Mechelsesteenweg 365,2019-05-31,16:00:00,266,92,174,FMN GV 05 Lier
60,Mechelsesteenweg 365,2019-05-31,17:00:00,108,48,60,FMN GV 05 Lier
60,Mechelsesteenweg 365,2019-05-31,18:00:00,78,22,56,FMN GV 05 Lier
60,Mechelsesteenweg 365,2019-05-31,19:00:00,66,34,32,FMN GV 05 Lier
60,Mechelsesteenweg 365,2019-05-31,20:00:00,50,18,32,FMN GV 05 Lier
60,Mechelsesteenweg 365,2019-05-31,21:00:00,26,8,18,FMN GV 05 Lier
60,Mechelsesteenweg 365,2019-05-31,22:00:00,20,14,6,FMN GV 05 Lier
60,Mechelsesteenweg 365,2019-05-31,23:00:00,0,0,0,FMN GV 05 Lier
60,Mechelsesteenweg 365,2019-06-01,00:00:00,8,0,8,FMN GV 05 Lier
60,Mechelsesteenweg 365,2019-06-01,01:00:00,4,0,4,FMN GV 05 Lier
60,Mechelsesteenweg 365,2019-06-01,02:00:00,0,0,0,FMN GV 05 Lier
60,Mechelsesteenweg 365,2019-06-01,03:00:00,0,0,0,FMN GV 05 Lier
60,Mechelsesteenweg 365,2019-06-01,04:00:00,0,0,0,FMN GV 05 Lier
60,Mechelsesteenweg 365,2019-06-01,05:00:00,0,0,0,FMN GV 05 Lier
60,Mechelsesteenweg 365,2019-06-01,06:00:00,4,0,4,FMN GV 05 Lier
60,Mechelsesteenweg 365,2019-06-01,07:00:00,18,6,12,FMN GV 05 Lier
60,Mechelsesteenweg 365,2019-06-01,08:00:00,56,38,18,FMN GV 05 Lier
60,Mechelsesteenweg 365,2019-06-01,09:00:00,168,74,94,FMN GV 05 Lier
60,Mechelsesteenweg 365,2019-06-01,10:00:00,286,160,126,FMN GV 05 Lier
60,Mechelsesteenweg 365,2019-06-01,11:00:00,326,158,168,FMN GV 05 Lier
60,Mechelsesteenweg 365,2019-06-01,12:00:00,292,152,140,FMN GV 05 Lier
60,Mechelsesteenweg 365,2019-06-01,13:00:00,374,204,170,FMN GV 05 Lier
60,Mechelsesteenweg 365,2019-06-01,14:00:00,462,248,214,FMN GV 05 Lier
60,Mechelsesteenweg 365,2019-06-01,15:00:00,426,204,222,FMN GV 05 Lier
60,Mechelsesteenweg 365,2019-06-01,16:00:00,226,74,152,FMN GV 05 Lier
60,Mechelsesteenweg 365,2019-06-01,17:00:00,210,64,146,FMN GV 05 Lier
60,Mechelsesteenweg 365,2019-06-01,18:00:00,168,78,90,FMN GV 05 Lier
60,Mechelsesteenweg 365,2019-06-01,19:00:00,104,66,38,FMN GV 05 Lier
60,Mechelsesteenweg 365,2019-06-01,20:00:00,98,50,48,FMN GV 05 Lier
60,Mechelsesteenweg 365,2019-06-01,21:00:00,40,20,20,FMN GV 05 Lier
60,Mechelsesteenweg 365,2019-06-01,22:00:00,22,10,12,FMN GV 05 Lier
60,Mechelsesteenweg 365,2019-06-01,23:00:00,2,0,2,FMN GV 05 Lier
60,Mechelsesteenweg 365,2019-06-02,00:00:00,2,0,2,FMN GV 05 Lier
60,Mechelsesteenweg 365,2019-06-02,01:00:00,12,6,6,FMN GV 05 Lier
60,Mechelsesteenweg 365,2019-06-02,02:00:00,2,2,0,FMN GV 05 Lier
60,Mechelsesteenweg 365,2019-06-02,03:00:00,0,0,0,FMN GV 05 Lier
60,Mechelsesteenweg 365,2019-06-02,04:00:00,0,0,0,FMN GV 05 Lier
60,Mechelsesteenweg 365,2019-06-02,05:00:00,0,0,0,FMN GV 05 Lier
60,Mechelsesteenweg 365,2019-06-02,06:00:00,10,4,6,FMN GV 05 Lier
60,Mechelsesteenweg 365,2019-06-02,07:00:00,28,14,14,FMN GV 05 Lier
60,Mechelsesteenweg 365,2019-06-02,08:00:00,114,72,42,FMN GV 05 Lier
60,Mechelsesteenweg 365,2019-06-02,09:00:00,266,150,116,FMN GV 05 Lier
60,Mechelsesteenweg 365,2019-06-02,10:00:00,424,186,238,FMN GV 05 Lier
60,Mechelsesteenweg 365,2019-06-02,11:00:00,474,232,242,FMN GV 05 Lier
60,Mechelsesteenweg 365,2019-06-02,12:00:00,344,178,166,FMN GV 05 Lier
60,Mechelsesteenweg 365,2019-06-02,13:00:00,390,156,234,FMN GV 05 Lier
60,Mechelsesteenweg 365,2019-06-02,14:00:00,538,258,280,FMN GV 05 Lier
60,Mechelsesteenweg 365,2019-06-02,15:00:00,362,158,204,FMN GV 05 Lier
60,Mechelsesteenweg 365,2019-06-02,16:00:00,310,138,172,FMN GV 05 Lier
60,Mechelsesteenweg 365,2019-06-02,17:00:00,194,74,120,FMN GV 05 Lier
60,Mechelsesteenweg 365,2019-06-02,18:00:00,110,48,62,FMN GV 05 Lier
60,Mechelsesteenweg 365,2019-06-02,19:00:00,86,38,48,FMN GV 05 Lier
60,Mechelsesteenweg 365,2019-06-02,20:00:00,74,40,34,FMN GV 05 Lier
60,Mechelsesteenweg 365,2019-06-02,21:00:00,24,8,16,FMN GV 05 Lier
60,Mechelsesteenweg 365,2019-06-02,22:00:00,12,10,2,FMN GV 05 Lier
60,Mechelsesteenweg 365,2019-06-02,23:00:00,6,2,4,FMN GV 05 Lier
60,Mechelsesteenweg 365,2019-06-03,00:00:00,2,0,2,FMN GV 05 Lier
60,Mechelsesteenweg 365,2019-06-03,01:00:00,0,0,0,FMN GV 05 Lier
60,Mechelsesteenweg 365,2019-06-03,02:00:00,0,0,0,FMN GV 05 Lier
60,Mechelsesteenweg 365,2019-06-03,03:00:00,4,0,4,FMN GV 05 Lier
60,Mechelsesteenweg 365,2019-06-03,04:00:00,6,0,6,FMN GV 05 Lier
60,Mechelsesteenweg 365,2019-06-03,05:00:00,8,4,4,FMN GV 05 Lier
60,Mechelsesteenweg 365,2019-06-03,06:00:00,20,6,14,FMN GV 05 Lier
60,Mechelsesteenweg 365,2019-06-03,07:00:00,164,96,68,FMN GV 05 Lier
60,Mechelsesteenweg 365,2019-06-03,08:00:00,146,82,64,FMN GV 05 Lier
60,Mechelsesteenweg 365,2019-06-03,09:00:00,50,34,16,FMN GV 05 Lier
60,Mechelsesteenweg 365,2019-06-03,10:00:00,58,30,28,FMN GV 05 Lier
60,Mechelsesteenweg 365,2019-06-03,11:00:00,86,60,26,FMN GV 05 Lier
60,Mechelsesteenweg 365,2019-06-03,12:00:00,42,16,26,FMN GV 05 Lier
60,Mechelsesteenweg 365,2019-06-03,13:00:00,98,40,58,FMN GV 05 Lier
60,Mechelsesteenweg 365,2019-06-03,14:00:00,106,64,42,FMN GV 05 Lier
60,Mechelsesteenweg 365,2019-06-03,15:00:00,80,36,44,FMN GV 05 Lier
60,Mechelsesteenweg 365,2019-06-03,16:00:00,224,66,158,FMN GV 05 Lier
60,Mechelsesteenweg 365,2019-06-03,17:00:00,124,76,48,FMN GV 05 Lier
60,Mechelsesteenweg 365,2019-06-03,18:00:00,72,40,32,FMN GV 05 Lier
60,Mechelsesteenweg 365,2019-06-03,19:00:00,78,50,28,FMN GV 05 Lier
60,Mechelsesteenweg 365,2019-06-03,20:00:00,50,28,22,FMN GV 05 Lier
60,Mechelsesteenweg 365,2019-06-03,21:00:00,22,12,10,FMN GV 05 Lier
60,Mechelsesteenweg 365,2019-06-03,22:00:00,6,2,4,FMN GV 05 Lier
60,Mechelsesteenweg 365,2019-06-03,23:00:00,2,2,0,FMN GV 05 Lier
60,Mechelsesteenweg 365,2019-06-04,00:00:00,2,0,2,FMN GV 05 Lier
60,Mechelsesteenweg 365,2019-06-04,01:00:00,0,0,0,FMN GV 05 Lier
60,Mechelsesteenweg 365,2019-06-04,02:00:00,0,0,0,FMN GV 05 Lier
60,Mechelsesteenweg 365,2019-06-04,03:00:00,2,0,2,FMN GV 05 Lier
60,Mechelsesteenweg 365,2019-06-04,04:00:00,4,0,4,FMN GV 05 Lier
60,Mechelsesteenweg 365,2019-06-04,05:00:00,8,2,6,FMN GV 05 Lier
60,Mechelsesteenweg 365,2019-06-04,06:00:00,24,10,14,FMN GV 05 Lier
60,Mechelsesteenweg 365,2019-06-04,07:00:00,180,94,86,FMN GV 05 Lier
60,Mechelsesteenweg 365,2019-06-04,08:00:00,180,112,68,FMN GV 05 Lier
60,Mechelsesteenweg 365,2019-06-04,09:00:00,198,122,76,FMN GV 05 Lier
60,Mechelsesteenweg 365,2019-06-04,10:00:00,154,54,100,FMN GV 05 Lier
60,Mechelsesteenweg 365,2019-06-04,11:00:00,152,110,42,FMN GV 05 Lier
60,Mechelsesteenweg 365,2019-06-04,12:00:00,76,40,36,FMN GV 05 Lier
60,Mechelsesteenweg 365,2019-06-04,13:00:00,66,12,54,FMN GV 05 Lier
60,Mechelsesteenweg 365,2019-06-04,14:00:00,106,44,62,FMN GV 05 Lier
60,Mechelsesteenweg 365,2019-06-04,15:00:00,138,40,98,FMN GV 05 Lier
60,Mechelsesteenweg 365,2019-06-04,16:00:00,190,60,130,FMN GV 05 Lier
60,Mechelsesteenweg 365,2019-06-04,17:00:00,122,76,46,FMN GV 05 Lier
60,Mechelsesteenweg 365,2019-06-04,18:00:00,70,38,32,FMN GV 05 Lier
60,Mechelsesteenweg 365,2019-06-04,19:00:00,96,54,42,FMN GV 05 Lier
60,Mechelsesteenweg 365,2019-06-04,20:00:00,40,32,8,FMN GV 05 Lier
60,Mechelsesteenweg 365,2019-06-04,21:00:00,0,0,0,FMN GV 05 Lier
60,Mechelsesteenweg 365,2019-06-04,22:00:00,8,6,2,FMN GV 05 Lier
60,Mechelsesteenweg 365,2019-06-04,23:00:00,4,0,4,FMN GV 05 Lier
60,Mechelsesteenweg 365,2019-06-05,00:00:00,0,0,0,FMN GV 05 Lier
60,Mechelsesteenweg 365,2019-06-05,01:00:00,0,0,0,FMN GV 05 Lier
60,Mechelsesteenweg 365,2019-06-05,02:00:00,0,0,0,FMN GV 05 Lier
60,Mechelsesteenweg 365,2019-06-05,03:00:00,2,0,2,FMN GV 05 Lier
60,Mechelsesteenweg 365,2019-06-05,04:00:00,4,0,4,FMN GV 05 Lier
60,Mechelsesteenweg 365,2019-06-05,05:00:00,12,2,10,FMN GV 05 Lier
60,Mechelsesteenweg 365,2019-06-05,06:00:00,14,4,10,FMN GV 05 Lier
60,Mechelsesteenweg 365,2019-06-05,07:00:00,122,80,42,FMN GV 05 Lier
60,Mechelsesteenweg 365,2019-06-05,08:00:00,92,64,28,FMN GV 05 Lier
60,Mechelsesteenweg 365,2019-06-05,09:00:00,8,4,4,FMN GV 05 Lier
60,Mechelsesteenweg 365,2019-06-05,10:00:00,16,8,8,FMN GV 05 Lier
60,Mechelsesteenweg 365,2019-06-05,11:00:00,32,12,20,FMN GV 05 Lier
60,Mechelsesteenweg 365,2019-06-05,12:00:00,144,44,100,FMN GV 05 Lier
60,Mechelsesteenweg 365,2019-06-05,13:00:00,48,22,26,FMN GV 05 Lier
60,Mechelsesteenweg 365,2019-06-05,14:00:00,68,52,16,FMN GV 05 Lier
60,Mechelsesteenweg 365,2019-06-05,15:00:00,62,30,32,FMN GV 05 Lier
60,Mechelsesteenweg 365,2019-06-05,16:00:00,82,32,50,FMN GV 05 Lier
60,Mechelsesteenweg 365,2019-06-05,17:00:00,62,42,20,FMN GV 05 Lier
60,Mechelsesteenweg 365,2019-06-05,18:00:00,64,24,40,FMN GV 05 Lier
60,Mechelsesteenweg 365,2019-06-05,19:00:00,156,112,44,FMN GV 05 Lier
60,Mechelsesteenweg 365,2019-06-05,20:00:00,90,64,26,FMN GV 05 Lier
60,Mechelsesteenweg 365,2019-06-05,21:00:00,40,20,20,FMN GV 05 Lier
60,Mechelsesteenweg 365,2019-06-05,22:00:00,6,6,0,FMN GV 05 Lier
60,Mechelsesteenweg 365,2019-06-05,23:00:00,0,0,0,FMN GV 05 Lier
60,Mechelsesteenweg 365,2019-06-06,00:00:00,2,2,0,FMN GV 05 Lier
60,Mechelsesteenweg 365,2019-06-06,01:00:00,0,0,0,FMN GV 05 Lier
60,Mechelsesteenweg 365,2019-06-06,02:00:00,2,0,2,FMN GV 05 Lier
60,Mechelsesteenweg 365,2019-06-06,03:00:00,4,2,2,FMN GV 05 Lier
60,Mechelsesteenweg 365,2019-06-06,04:00:00,2,0,2,FMN GV 05 Lier
60,Mechelsesteenweg 365,2019-06-06,05:00:00,6,0,6,FMN GV 05 Lier
60,Mechelsesteenweg 365,2019-06-06,06:00:00,26,8,18,FMN GV 05 Lier
60,Mechelsesteenweg 365,2019-06-06,07:00:00,142,76,66,FMN GV 05 Lier
60,Mechelsesteenweg 365,2019-06-06,08:00:00,154,94,60,FMN GV 05 Lier
60,Mechelsesteenweg 365,2019-06-06,09:00:00,50,36,14,FMN GV 05 Lier
60,Mechelsesteenweg 365,2019-06-06,10:00:00,138,66,72,FMN GV 05 Lier
60,Mechelsesteenweg 365,2019-06-06,11:00:00,108,52,56,FMN GV 05 Lier
60,Mechelsesteenweg 365,2019-06-06,12:00:00,142,70,72,FMN GV 05 Lier
60,Mechelsesteenweg 365,2019-06-06,13:00:00,160,74,86,FMN GV 05 Lier
60,Mechelsesteenweg 365,2019-06-06,14:00:00,162,86,76,FMN GV 05 Lier
60,Mechelsesteenweg 365,2019-06-06,15:00:00,210,104,106,FMN GV 05 Lier
60,Mechelsesteenweg 365,2019-06-06,16:00:00,186,74,112,FMN GV 05 Lier
60,Mechelsesteenweg 365,2019-06-06,17:00:00,140,80,60,FMN GV 05 Lier
60,Mechelsesteenweg 365,2019-06-06,18:00:00,52,26,26,FMN GV 05 Lier
60,Mechelsesteenweg 365,2019-06-06,19:00:00,52,26,26,FMN GV 05 Lier
60,Mechelsesteenweg 365,2019-06-06,20:00:00,68,52,16,FMN GV 05 Lier
60,Mechelsesteenweg 365,2019-06-06,21:00:00,42,22,20,FMN GV 05 Lier
60,Mechelsesteenweg 365,2019-06-06,22:00:00,10,4,6,FMN GV 05 Lier
60,Mechelsesteenweg 365,2019-06-06,23:00:00,0,0,0,FMN GV 05 Lier
60,Mechelsesteenweg 365,2019-06-07,00:00:00,0,0,0,FMN GV 05 Lier
60,Mechelsesteenweg 365,2019-06-07,01:00:00,0,0,0,FMN GV 05 Lier
60,Mechelsesteenweg 365,2019-06-07,02:00:00,0,0,0,FMN GV 05 Lier
60,Mechelsesteenweg 365,2019-06-07,03:00:00,2,0,2,FMN GV 05 Lier
60,Mechelsesteenweg 365,2019-06-07,04:00:00,2,0,2,FMN GV 05 Lier
60,Mechelsesteenweg 365,2019-06-07,05:00:00,6,0,6,FMN GV 05 Lier
60,Mechelsesteenweg 365,2019-06-07,06:00:00,20,8,12,FMN GV 05 Lier
60,Mechelsesteenweg 365,2019-06-07,07:00:00,130,68,62,FMN GV 05 Lier
60,Mechelsesteenweg 365,2019-06-07,08:00:00,152,96,56,FMN GV 05 Lier
60,Mechelsesteenweg 365,2019-06-07,09:00:00,84,58,26,FMN GV 05 Lier
60,Mechelsesteenweg 365,2019-06-07,10:00:00,116,58,58,FMN GV 05 Lier
60,Mechelsesteenweg 365,2019-06-07,11:00:00,146,44,102,FMN GV 05 Lier
60,Mechelsesteenweg 365,2019-06-07,12:00:00,100,40,60,FMN GV 05 Lier
60,Mechelsesteenweg 365,2019-06-07,13:00:00,98,46,52,FMN GV 05 Lier
60,Mechelsesteenweg 365,2019-06-07,14:00:00,108,50,58,FMN GV 05 Lier
60,Mechelsesteenweg 365,2019-06-07,15:00:00,124,60,64,FMN GV 05 Lier
60,Mechelsesteenweg 365,2019-06-07,16:00:00,92,28,64,FMN GV 05 Lier
60,Mechelsesteenweg 365,2019-06-07,17:00:00,52,26,26,FMN GV 05 Lier
60,Mechelsesteenweg 365,2019-06-07,18:00:00,26,20,6,FMN GV 05 Lier
60,Mechelsesteenweg 365,2019-06-07,19:00:00,26,18,8,FMN GV 05 Lier
60,Mechelsesteenweg 365,2019-06-07,20:00:00,20,8,12,FMN GV 05 Lier
60,Mechelsesteenweg 365,2019-06-07,21:00:00,8,4,4,FMN GV 05 Lier
60,Mechelsesteenweg 365,2019-06-07,22:00:00,8,6,2,FMN GV 05 Lier
60,Mechelsesteenweg 365,2019-06-07,23:00:00,2,2,0,FMN GV 05 Lier
60,Mechelsesteenweg 365,2019-06-08,00:00:00,0,0,0,FMN GV 05 Lier
60,Mechelsesteenweg 365,2019-06-08,01:00:00,0,0,0,FMN GV 05 Lier
60,Mechelsesteenweg 365,2019-06-08,02:00:00,0,0,0,FMN GV 05 Lier
60,Mechelsesteenweg 365,2019-06-08,03:00:00,0,0,0,FMN GV 05 Lier
60,Mechelsesteenweg 365,2019-06-08,04:00:00,0,0,0,FMN GV 05 Lier
60,Mechelsesteenweg 365,2019-06-08,05:00:00,0,0,0,FMN GV 05 Lier
60,Mechelsesteenweg 365,2019-06-08,06:00:00,2,2,0,FMN GV 05 Lier
60,Mechelsesteenweg 365,2019-06-08,07:00:00,2,0,2,FMN GV 05 Lier
60,Mechelsesteenweg 365,2019-06-08,08:00:00,4,0,4,FMN GV 05 Lier
60,Mechelsesteenweg 365,2019-06-08,09:00:00,18,12,6,FMN GV 05 Lier
60,Mechelsesteenweg 365,2019-06-08,10:00:00,44,26,18,FMN GV 05 Lier
60,Mechelsesteenweg 365,2019-06-08,11:00:00,26,10,16,FMN GV 05 Lier
60,Mechelsesteenweg 365,2019-06-08,12:00:00,24,12,12,FMN GV 05 Lier
60,Mechelsesteenweg 365,2019-06-08,13:00:00,20,12,8,FMN GV 05 Lier
60,Mechelsesteenweg 365,2019-06-08,14:00:00,46,26,20,FMN GV 05 Lier
60,Mechelsesteenweg 365,2019-06-08,15:00:00,32,14,18,FMN GV 05 Lier
60,Mechelsesteenweg 365,2019-06-08,16:00:00,40,12,28,FMN GV 05 Lier
60,Mechelsesteenweg 365,2019-06-08,17:00:00,30,20,10,FMN GV 05 Lier
60,Mechelsesteenweg 365,2019-06-08,18:00:00,30,14,16,FMN GV 05 Lier
60,Mechelsesteenweg 365,2019-06-08,19:00:00,34,20,14,FMN GV 05 Lier
60,Mechelsesteenweg 365,2019-06-08,20:00:00,26,12,14,FMN GV 05 Lier
60,Mechelsesteenweg 365,2019-06-08,21:00:00,10,4,6,FMN GV 05 Lier
60,Mechelsesteenweg 365,2019-06-08,22:00:00,6,0,6,FMN GV 05 Lier
60,Mechelsesteenweg 365,2019-06-08,23:00:00,2,0,2,FMN GV 05 Lier
60,Mechelsesteenweg 365,2019-06-09,00:00:00,4,2,2,FMN GV 05 Lier
60,Mechelsesteenweg 365,2019-06-09,01:00:00,0,0,0,FMN GV 05 Lier
60,Mechelsesteenweg 365,2019-06-09,02:00:00,0,0,0,FMN GV 05 Lier
60,Mechelsesteenweg 365,2019-06-09,03:00:00,0,0,0,FMN GV 05 Lier
60,Mechelsesteenweg 365,2019-06-09,04:00:00,0,0,0,FMN GV 05 Lier
60,Mechelsesteenweg 365,2019-06-09,05:00:00,2,0,2,FMN GV 05 Lier
60,Mechelsesteenweg 365,2019-06-09,06:00:00,12,4,8,FMN GV 05 Lier
60,Mechelsesteenweg 365,2019-06-09,07:00:00,18,8,10,FMN GV 05 Lier
60,Mechelsesteenweg 365,2019-06-09,08:00:00,90,64,26,FMN GV 05 Lier
60,Mechelsesteenweg 365,2019-06-09,09:00:00,234,140,94,FMN GV 05 Lier
60,Mechelsesteenweg 365,2019-06-09,10:00:00,452,242,210,FMN GV 05 Lier
60,Mechelsesteenweg 365,2019-06-09,11:00:00,544,306,238,FMN GV 05 Lier
60,Mechelsesteenweg 365,2019-06-09,12:00:00,386,172,214,FMN GV 05 Lier
60,Mechelsesteenweg 365,2019-06-09,13:00:00,340,180,160,FMN GV 05 Lier
60,Mechelsesteenweg 365,2019-06-09,14:00:00,376,176,200,FMN GV 05 Lier
60,Mechelsesteenweg 365,2019-06-09,15:00:00,442,244,198,FMN GV 05 Lier
60,Mechelsesteenweg 365,2019-06-09,16:00:00,248,88,160,FMN GV 05 Lier
60,Mechelsesteenweg 365,2019-06-09,17:00:00,118,58,60,FMN GV 05 Lier
60,Mechelsesteenweg 365,2019-06-09,18:00:00,70,22,48,FMN GV 05 Lier
60,Mechelsesteenweg 365,2019-06-09,19:00:00,40,18,22,FMN GV 05 Lier
60,Mechelsesteenweg 365,2019-06-09,20:00:00,30,12,18,FMN GV 05 Lier
60,Mechelsesteenweg 365,2019-06-09,21:00:00,6,0,6,FMN GV 05 Lier
60,Mechelsesteenweg 365,2019-06-09,22:00:00,14,2,12,FMN GV 05 Lier
60,Mechelsesteenweg 365,2019-06-09,23:00:00,6,4,2,FMN GV 05 Lier
60,Mechelsesteenweg 365,2019-06-10,00:00:00,6,6,0,FMN GV 05 Lier
60,Mechelsesteenweg 365,2019-06-10,01:00:00,2,2,0,FMN GV 05 Lier
60,Mechelsesteenweg 365,2019-06-10,02:00:00,0,0,0,FMN GV 05 Lier
60,Mechelsesteenweg 365,2019-06-10,03:00:00,0,0,0,FMN GV 05 Lier
60,Mechelsesteenweg 365,2019-06-10,04:00:00,0,0,0,FMN GV 05 Lier
60,Mechelsesteenweg 365,2019-06-10,05:00:00,0,0,0,FMN GV 05 Lier
60,Mechelsesteenweg 365,2019-06-10,06:00:00,16,6,10,FMN GV 05 Lier
60,Mechelsesteenweg 365,2019-06-10,07:00:00,10,8,2,FMN GV 05 Lier
60,Mechelsesteenweg 365,2019-06-10,08:00:00,48,30,18,FMN GV 05 Lier
60,Mechelsesteenweg 365,2019-06-10,09:00:00,180,102,78,FMN GV 05 Lier
60,Mechelsesteenweg 365,2019-06-10,10:00:00,392,264,128,FMN GV 05 Lier
60,Mechelsesteenweg 365,2019-06-10,11:00:00,352,160,192,FMN GV 05 Lier
60,Mechelsesteenweg 365,2019-06-10,12:00:00,190,84,106,FMN GV 05 Lier
60,Mechelsesteenweg 365,2019-06-10,13:00:00,184,76,108,FMN GV 05 Lier
60,Mechelsesteenweg 365,2019-06-10,14:00:00,226,108,118,FMN GV 05 Lier
60,Mechelsesteenweg 365,2019-06-10,15:00:00,106,52,54,FMN GV 05 Lier
60,Mechelsesteenweg 365,2019-06-10,16:00:00,168,100,68,FMN GV 05 Lier
60,Mechelsesteenweg 365,2019-06-10,17:00:00,98,42,56,FMN GV 05 Lier
60,Mechelsesteenweg 365,2019-06-10,18:00:00,20,8,12,FMN GV 05 Lier
60,Mechelsesteenweg 365,2019-06-10,19:00:00,18,6,12,FMN GV 05 Lier
60,Mechelsesteenweg 365,2019-06-10,20:00:00,2,0,2,FMN GV 05 Lier
60,Mechelsesteenweg 365,2019-06-10,21:00:00,4,4,0,FMN GV 05 Lier
60,Mechelsesteenweg 365,2019-06-10,22:00:00,6,4,2,FMN GV 05 Lier
60,Mechelsesteenweg 365,2019-06-10,23:00:00,0,0,0,FMN GV 05 Lier
60,Mechelsesteenweg 365,2019-06-11,00:00:00,0,0,0,FMN GV 05 Lier
60,Mechelsesteenweg 365,2019-06-11,01:00:00,0,0,0,FMN GV 05 Lier
60,Mechelsesteenweg 365,2019-06-11,02:00:00,0,0,0,FMN GV 05 Lier
60,Mechelsesteenweg 365,2019-06-11,03:00:00,2,0,2,FMN GV 05 Lier
60,Mechelsesteenweg 365,2019-06-11,04:00:00,6,0,6,FMN GV 05 Lier
60,Mechelsesteenweg 365,2019-06-11,05:00:00,8,2,6,FMN GV 05 Lier
60,Mechelsesteenweg 365,2019-06-11,06:00:00,22,6,16,FMN GV 05 Lier
60,Mechelsesteenweg 365,2019-06-11,07:00:00,178,92,86,FMN GV 05 Lier
60,Mechelsesteenweg 365,2019-06-11,08:00:00,138,80,58,FMN GV 05 Lier
60,Mechelsesteenweg 365,2019-06-11,09:00:00,112,58,54,FMN GV 05 Lier
60,Mechelsesteenweg 365,2019-06-11,10:00:00,136,52,84,FMN GV 05 Lier
60,Mechelsesteenweg 365,2019-06-11,11:00:00,150,66,84,FMN GV 05 Lier
60,Mechelsesteenweg 365,2019-06-11,12:00:00,126,42,84,FMN GV 05 Lier
60,Mechelsesteenweg 365,2019-06-11,13:00:00,118,46,72,FMN GV 05 Lier
60,Mechelsesteenweg 365,2019-06-11,14:00:00,100,58,42,FMN GV 05 Lier
60,Mechelsesteenweg 365,2019-06-11,15:00:00,148,74,74,FMN GV 05 Lier
60,Mechelsesteenweg 365,2019-06-11,16:00:00,160,62,98,FMN GV 05 Lier
60,Mechelsesteenweg 365,2019-06-11,17:00:00,150,94,56,FMN GV 05 Lier
60,Mechelsesteenweg 365,2019-06-11,18:00:00,94,70,24,FMN GV 05 Lier
60,Mechelsesteenweg 365,2019-06-11,19:00:00,72,38,34,FMN GV 05 Lier
60,Mechelsesteenweg 365,2019-06-11,20:00:00,66,36,30,FMN GV 05 Lier
60,Mechelsesteenweg 365,2019-06-11,21:00:00,10,6,4,FMN GV 05 Lier
60,Mechelsesteenweg 365,2019-06-11,22:00:00,18,10,8,FMN GV 05 Lier
60,Mechelsesteenweg 365,2019-06-11,23:00:00,2,0,2,FMN GV 05 Lier
60,Mechelsesteenweg 365,2019-06-12,00:00:00,0,0,0,FMN GV 05 Lier
60,Mechelsesteenweg 365,2019-06-12,01:00:00,0,0,0,FMN GV 05 Lier
60,Mechelsesteenweg 365,2019-06-12,02:00:00,0,0,0,FMN GV 05 Lier
60,Mechelsesteenweg 365,2019-06-12,03:00:00,2,0,2,FMN GV 05 Lier
60,Mechelsesteenweg 365,2019-06-12,04:00:00,4,0,4,FMN GV 05 Lier
60,Mechelsesteenweg 365,2019-06-12,05:00:00,6,2,4,FMN GV 05 Lier
60,Mechelsesteenweg 365,2019-06-12,06:00:00,22,4,18,FMN GV 05 Lier
60,Mechelsesteenweg 365,2019-06-12,07:00:00,126,78,48,FMN GV 05 Lier
60,Mechelsesteenweg 365,2019-06-12,08:00:00,60,40,20,FMN GV 05 Lier
60,Mechelsesteenweg 365,2019-06-12,09:00:00,14,8,6,FMN GV 05 Lier
60,Mechelsesteenweg 365,2019-06-12,10:00:00,36,10,26,FMN GV 05 Lier
60,Mechelsesteenweg 365,2019-06-12,11:00:00,40,4,36,FMN GV 05 Lier
60,Mechelsesteenweg 365,2019-06-12,12:00:00,76,28,48,FMN GV 05 Lier
60,Mechelsesteenweg 365,2019-06-12,13:00:00,18,4,14,FMN GV 05 Lier
60,Mechelsesteenweg 365,2019-06-12,14:00:00,20,14,6,FMN GV 05 Lier
60,Mechelsesteenweg 365,2019-06-12,15:00:00,34,20,14,FMN GV 05 Lier
60,Mechelsesteenweg 365,2019-06-12,16:00:00,48,24,24,FMN GV 05 Lier
60,Mechelsesteenweg 365,2019-06-12,17:00:00,86,50,36,FMN GV 05 Lier
60,Mechelsesteenweg 365,2019-06-12,18:00:00,42,24,18,FMN GV 05 Lier
60,Mechelsesteenweg 365,2019-06-12,19:00:00,84,50,34,FMN GV 05 Lier
60,Mechelsesteenweg 365,2019-06-12,20:00:00,82,50,32,FMN GV 05 Lier
60,Mechelsesteenweg 365,2019-06-12,21:00:00,22,4,18,FMN GV 05 Lier
60,Mechelsesteenweg 365,2019-06-12,22:00:00,4,2,2,FMN GV 05 Lier
60,Mechelsesteenweg 365,2019-06-12,23:00:00,0,0,0,FMN GV 05 Lier
60,Mechelsesteenweg 365,2019-06-13,00:00:00,0,0,0,FMN GV 05 Lier
60,Mechelsesteenweg 365,2019-06-13,01:00:00,0,0,0,FMN GV 05 Lier
60,Mechelsesteenweg 365,2019-06-13,02:00:00,0,0,0,FMN GV 05 Lier
60,Mechelsesteenweg 365,2019-06-13,03:00:00,2,0,2,FMN GV 05 Lier
60,Mechelsesteenweg 365,2019-06-13,04:00:00,4,0,4,FMN GV 05 Lier
60,Mechelsesteenweg 365,2019-06-13,05:00:00,4,0,4,FMN GV 05 Lier
60,Mechelsesteenweg 365,2019-06-13,06:00:00,16,4,12,FMN GV 05 Lier
60,Mechelsesteenweg 365,2019-06-13,07:00:00,170,88,82,FMN GV 05 Lier
60,Mechelsesteenweg 365,2019-06-13,08:00:00,122,68,54,FMN GV 05 Lier
60,Mechelsesteenweg 365,2019-06-13,09:00:00,64,40,24,FMN GV 05 Lier
60,Mechelsesteenweg 365,2019-06-13,10:00:00,98,30,68,FMN GV 05 Lier
60,Mechelsesteenweg 365,2019-06-13,11:00:00,88,48,40,FMN GV 05 Lier
60,Mechelsesteenweg 365,2019-06-13,12:00:00,76,14,62,FMN GV 05 Lier
60,Mechelsesteenweg 365,2019-06-13,13:00:00,54,18,36,FMN GV 05 Lier
60,Mechelsesteenweg 365,2019-06-13,14:00:00,34,22,12,FMN GV 05 Lier
60,Mechelsesteenweg 365,2019-06-13,15:00:00,42,20,22,FMN GV 05 Lier
60,Mechelsesteenweg 365,2019-06-13,16:00:00,102,56,46,FMN GV 05 Lier
60,Mechelsesteenweg 365,2019-06-13,17:00:00,76,46,30,FMN GV 05 Lier
60,Mechelsesteenweg 365,2019-06-13,18:00:00,42,28,14,FMN GV 05 Lier
60,Mechelsesteenweg 365,2019-06-13,19:00:00,30,22,8,FMN GV 05 Lier
60,Mechelsesteenweg 365,2019-06-13,20:00:00,100,50,50,FMN GV 05 Lier
60,Mechelsesteenweg 365,2019-06-13,21:00:00,24,4,20,FMN GV 05 Lier
60,Mechelsesteenweg 365,2019-06-13,22:00:00,4,0,4,FMN GV 05 Lier
60,Mechelsesteenweg 365,2019-06-13,23:00:00,8,4,4,FMN GV 05 Lier
60,Mechelsesteenweg 365,2019-06-14,00:00:00,0,0,0,FMN GV 05 Lier
60,Mechelsesteenweg 365,2019-06-14,01:00:00,2,0,2,FMN GV 05 Lier
60,Mechelsesteenweg 365,2019-06-14,02:00:00,0,0,0,FMN GV 05 Lier
60,Mechelsesteenweg 365,2019-06-14,03:00:00,2,0,2,FMN GV 05 Lier
60,Mechelsesteenweg 365,2019-06-14,04:00:00,2,0,2,FMN GV 05 Lier
60,Mechelsesteenweg 365,2019-06-14,05:00:00,8,2,6,FMN GV 05 Lier
60,Mechelsesteenweg 365,2019-06-14,06:00:00,20,2,18,FMN GV 05 Lier
60,Mechelsesteenweg 365,2019-06-14,07:00:00,132,64,68,FMN GV 05 Lier
60,Mechelsesteenweg 365,2019-06-14,08:00:00,90,62,28,FMN GV 05 Lier
60,Mechelsesteenweg 365,2019-06-14,09:00:00,54,24,30,FMN GV 05 Lier
60,Mechelsesteenweg 365,2019-06-14,10:00:00,104,40,64,FMN GV 05 Lier
60,Mechelsesteenweg 365,2019-06-14,11:00:00,110,52,58,FMN GV 05 Lier
60,Mechelsesteenweg 365,2019-06-14,12:00:00,140,52,88,FMN GV 05 Lier
60,Mechelsesteenweg 365,2019-06-14,13:00:00,122,84,38,FMN GV 05 Lier
60,Mechelsesteenweg 365,2019-06-14,14:00:00,174,86,88,FMN GV 05 Lier
60,Mechelsesteenweg 365,2019-06-14,15:00:00,184,108,76,FMN GV 05 Lier
60,Mechelsesteenweg 365,2019-06-14,16:00:00,170,80,90,FMN GV 05 Lier
60,Mechelsesteenweg 365,2019-06-14,17:00:00,142,64,78,FMN GV 05 Lier
60,Mechelsesteenweg 365,2019-06-14,18:00:00,114,52,62,FMN GV 05 Lier
60,Mechelsesteenweg 365,2019-06-14,19:00:00,110,58,52,FMN GV 05 Lier
60,Mechelsesteenweg 365,2019-06-14,20:00:00,118,44,74,FMN GV 05 Lier
60,Mechelsesteenweg 365,2019-06-14,21:00:00,40,10,30,FMN GV 05 Lier
60,Mechelsesteenweg 365,2019-06-14,22:00:00,32,14,18,FMN GV 05 Lier
60,Mechelsesteenweg 365,2019-06-14,23:00:00,10,6,4,FMN GV 05 Lier
60,Mechelsesteenweg 365,2019-06-15,00:00:00,4,2,2,FMN GV 05 Lier
60,Mechelsesteenweg 365,2019-06-15,01:00:00,0,0,0,FMN GV 05 Lier
60,Mechelsesteenweg 365,2019-06-15,02:00:00,0,0,0,FMN GV 05 Lier
60,Mechelsesteenweg 365,2019-06-15,03:00:00,0,0,0,FMN GV 05 Lier
60,Mechelsesteenweg 365,2019-06-15,04:00:00,0,0,0,FMN GV 05 Lier
60,Mechelsesteenweg 365,2019-06-15,05:00:00,0,0,0,FMN GV 05 Lier
60,Mechelsesteenweg 365,2019-06-15,06:00:00,4,2,2,FMN GV 05 Lier
60,Mechelsesteenweg 365,2019-06-15,07:00:00,6,0,6,FMN GV 05 Lier
60,Mechelsesteenweg 365,2019-06-15,08:00:00,10,2,8,FMN GV 05 Lier
60,Mechelsesteenweg 365,2019-06-15,09:00:00,44,14,30,FMN GV 05 Lier
60,Mechelsesteenweg 365,2019-06-15,10:00:00,40,28,12,FMN GV 05 Lier
60,Mechelsesteenweg 365,2019-06-15,11:00:00,54,16,38,FMN GV 05 Lier
60,Mechelsesteenweg 365,2019-06-15,12:00:00,82,46,36,FMN GV 05 Lier
60,Mechelsesteenweg 365,2019-06-15,13:00:00,30,20,10,FMN GV 05 Lier
60,Mechelsesteenweg 365,2019-06-15,14:00:00,112,66,46,FMN GV 05 Lier
60,Mechelsesteenweg 365,2019-06-15,15:00:00,154,104,50,FMN GV 05 Lier
60,Mechelsesteenweg 365,2019-06-15,16:00:00,186,82,104,FMN GV 05 Lier
60,Mechelsesteenweg 365,2019-06-15,17:00:00,118,48,70,FMN GV 05 Lier
60,Mechelsesteenweg 365,2019-06-15,18:00:00,84,44,40,FMN GV 05 Lier
60,Mechelsesteenweg 365,2019-06-15,19:00:00,48,28,20,FMN GV 05 Lier
60,Mechelsesteenweg 365,2019-06-15,20:00:00,54,14,40,FMN GV 05 Lier
60,Mechelsesteenweg 365,2019-06-15,21:00:00,20,12,8,FMN GV 05 Lier
60,Mechelsesteenweg 365,2019-06-15,22:00:00,6,4,2,FMN GV 05 Lier
60,Mechelsesteenweg 365,2019-06-15,23:00:00,4,0,4,FMN GV 05 Lier
60,Mechelsesteenweg 365,2019-06-16,00:00:00,0,0,0,FMN GV 05 Lier
60,Mechelsesteenweg 365,2019-06-16,01:00:00,0,0,0,FMN GV 05 Lier
60,Mechelsesteenweg 365,2019-06-16,02:00:00,0,0,0,FMN GV 05 Lier
60,Mechelsesteenweg 365,2019-06-16,03:00:00,0,0,0,FMN GV 05 Lier
60,Mechelsesteenweg 365,2019-06-16,04:00:00,2,2,0,FMN GV 05 Lier
60,Mechelsesteenweg 365,2019-06-16,05:00:00,0,0,0,FMN GV 05 Lier
60,Mechelsesteenweg 365,2019-06-16,06:00:00,6,4,2,FMN GV 05 Lier
60,Mechelsesteenweg 365,2019-06-16,07:00:00,22,14,8,FMN GV 05 Lier
60,Mechelsesteenweg 365,2019-06-16,08:00:00,52,30,22,FMN GV 05 Lier
60,Mechelsesteenweg 365,2019-06-16,09:00:00,230,146,84,FMN GV 05 Lier
60,Mechelsesteenweg 365,2019-06-16,10:00:00,418,210,208,FMN GV 05 Lier
60,Mechelsesteenweg 365,2019-06-16,11:00:00,308,96,212,FMN GV 05 Lier
60,Mechelsesteenweg 365,2019-06-16,12:00:00,244,122,122,FMN GV 05 Lier
60,Mechelsesteenweg 365,2019-06-16,13:00:00,208,98,110,FMN GV 05 Lier
60,Mechelsesteenweg 365,2019-06-16,14:00:00,264,118,146,FMN GV 05 Lier
60,Mechelsesteenweg 365,2019-06-16,15:00:00,304,152,152,FMN GV 05 Lier
60,Mechelsesteenweg 365,2019-06-16,16:00:00,230,86,144,FMN GV 05 Lier
60,Mechelsesteenweg 365,2019-06-16,17:00:00,192,86,106,FMN GV 05 Lier
60,Mechelsesteenweg 365,2019-06-16,18:00:00,110,46,64,FMN GV 05 Lier
60,Mechelsesteenweg 365,2019-06-16,19:00:00,60,30,30,FMN GV 05 Lier
60,Mechelsesteenweg 365,2019-06-16,20:00:00,36,16,20,FMN GV 05 Lier
60,Mechelsesteenweg 365,2019-06-16,21:00:00,24,14,10,FMN GV 05 Lier
60,Mechelsesteenweg 365,2019-06-16,22:00:00,10,2,8,FMN GV 05 Lier
60,Mechelsesteenweg 365,2019-06-16,23:00:00,4,0,4,FMN GV 05 Lier
60,Mechelsesteenweg 365,2019-06-17,00:00:00,2,2,0,FMN GV 05 Lier
60,Mechelsesteenweg 365,2019-06-17,01:00:00,0,0,0,FMN GV 05 Lier
60,Mechelsesteenweg 365,2019-06-17,02:00:00,0,0,0,FMN GV 05 Lier
60,Mechelsesteenweg 365,2019-06-17,03:00:00,2,0,2,FMN GV 05 Lier
60,Mechelsesteenweg 365,2019-06-17,04:00:00,4,2,2,FMN GV 05 Lier
60,Mechelsesteenweg 365,2019-06-17,05:00:00,10,0,10,FMN GV 05 Lier
60,Mechelsesteenweg 365,2019-06-17,06:00:00,32,10,22,FMN GV 05 Lier
60,Mechelsesteenweg 365,2019-06-17,07:00:00,180,100,80,FMN GV 05 Lier
60,Mechelsesteenweg 365,2019-06-17,08:00:00,152,76,76,FMN GV 05 Lier
60,Mechelsesteenweg 365,2019-06-17,09:00:00,126,78,48,FMN GV 05 Lier
60,Mechelsesteenweg 365,2019-06-17,10:00:00,172,74,98,FMN GV 05 Lier
60,Mechelsesteenweg 365,2019-06-17,11:00:00,184,110,74,FMN GV 05 Lier
60,Mechelsesteenweg 365,2019-06-17,12:00:00,236,94,142,FMN GV 05 Lier
60,Mechelsesteenweg 365,2019-06-17,13:00:00,266,140,126,FMN GV 05 Lier
60,Mechelsesteenweg 365,2019-06-17,14:00:00,294,162,132,FMN GV 05 Lier
60,Mechelsesteenweg 365,2019-06-17,15:00:00,184,88,96,FMN GV 05 Lier
60,Mechelsesteenweg 365,2019-06-17,16:00:00,270,140,130,FMN GV 05 Lier
60,Mechelsesteenweg 365,2019-06-17,17:00:00,226,140,86,FMN GV 05 Lier
60,Mechelsesteenweg 365,2019-06-17,18:00:00,126,66,60,FMN GV 05 Lier
60,Mechelsesteenweg 365,2019-06-17,19:00:00,156,98,58,FMN GV 05 Lier
60,Mechelsesteenweg 365,2019-06-17,20:00:00,142,58,84,FMN GV 05 Lier
60,Mechelsesteenweg 365,2019-06-17,21:00:00,106,24,82,FMN GV 05 Lier
60,Mechelsesteenweg 365,2019-06-17,22:00:00,12,8,4,FMN GV 05 Lier
60,Mechelsesteenweg 365,2019-06-17,23:00:00,2,0,2,FMN GV 05 Lier
60,Mechelsesteenweg 365,2019-06-18,00:00:00,0,0,0,FMN GV 05 Lier
60,Mechelsesteenweg 365,2019-06-18,01:00:00,0,0,0,FMN GV 05 Lier
60,Mechelsesteenweg 365,2019-06-18,02:00:00,0,0,0,FMN GV 05 Lier
60,Mechelsesteenweg 365,2019-06-18,03:00:00,2,0,2,FMN GV 05 Lier
60,Mechelsesteenweg 365,2019-06-18,04:00:00,2,0,2,FMN GV 05 Lier
60,Mechelsesteenweg 365,2019-06-18,05:00:00,12,4,8,FMN GV 05 Lier
60,Mechelsesteenweg 365,2019-06-18,06:00:00,50,4,46,FMN GV 05 Lier
60,Mechelsesteenweg 365,2019-06-18,07:00:00,218,94,124,FMN GV 05 Lier
60,Mechelsesteenweg 365,2019-06-18,08:00:00,172,84,88,FMN GV 05 Lier
60,Mechelsesteenweg 365,2019-06-18,09:00:00,164,94,70,FMN GV 05 Lier
60,Mechelsesteenweg 365,2019-06-18,10:00:00,330,146,184,FMN GV 05 Lier
60,Mechelsesteenweg 365,2019-06-18,11:00:00,206,86,120,FMN GV 05 Lier
60,Mechelsesteenweg 365,2019-06-18,12:00:00,190,76,114,FMN GV 05 Lier
60,Mechelsesteenweg 365,2019-06-18,13:00:00,292,130,162,FMN GV 05 Lier
60,Mechelsesteenweg 365,2019-06-18,14:00:00,264,124,140,FMN GV 05 Lier
60,Mechelsesteenweg 365,2019-06-18,15:00:00,258,148,110,FMN GV 05 Lier
60,Mechelsesteenweg 365,2019-06-18,16:00:00,268,134,134,FMN GV 05 Lier
60,Mechelsesteenweg 365,2019-06-18,17:00:00,232,154,78,FMN GV 05 Lier
60,Mechelsesteenweg 365,2019-06-18,18:00:00,202,144,58,FMN GV 05 Lier
60,Mechelsesteenweg 365,2019-06-18,19:00:00,242,144,98,FMN GV 05 Lier
60,Mechelsesteenweg 365,2019-06-18,20:00:00,166,84,82,FMN GV 05 Lier
60,Mechelsesteenweg 365,2019-06-18,21:00:00,78,26,52,FMN GV 05 Lier
60,Mechelsesteenweg 365,2019-06-18,22:00:00,52,30,22,FMN GV 05 Lier
60,Mechelsesteenweg 365,2019-06-18,23:00:00,12,0,12,FMN GV 05 Lier
60,Mechelsesteenweg 365,2019-06-19,00:00:00,0,0,0,FMN GV 05 Lier
60,Mechelsesteenweg 365,2019-06-19,01:00:00,2,2,0,FMN GV 05 Lier
60,Mechelsesteenweg 365,2019-06-19,02:00:00,0,0,0,FMN GV 05 Lier
60,Mechelsesteenweg 365,2019-06-19,03:00:00,2,0,2,FMN GV 05 Lier
60,Mechelsesteenweg 365,2019-06-19,04:00:00,4,0,4,FMN GV 05 Lier
60,Mechelsesteenweg 365,2019-06-19,05:00:00,10,0,10,FMN GV 05 Lier
60,Mechelsesteenweg 365,2019-06-19,06:00:00,40,8,32,FMN GV 05 Lier
60,Mechelsesteenweg 365,2019-06-19,07:00:00,178,102,76,FMN GV 05 Lier
60,Mechelsesteenweg 365,2019-06-19,08:00:00,118,74,44,FMN GV 05 Lier
60,Mechelsesteenweg 365,2019-06-19,09:00:00,52,14,38,FMN GV 05 Lier
60,Mechelsesteenweg 365,2019-06-19,10:00:00,100,22,78,FMN GV 05 Lier
60,Mechelsesteenweg 365,2019-06-19,11:00:00,68,40,28,FMN GV 05 Lier
60,Mechelsesteenweg 365,2019-06-19,12:00:00,106,30,76,FMN GV 05 Lier
60,Mechelsesteenweg 365,2019-06-19,13:00:00,54,22,32,FMN GV 05 Lier
60,Mechelsesteenweg 365,2019-06-19,14:00:00,170,46,124,FMN GV 05 Lier
60,Mechelsesteenweg 365,2019-06-19,15:00:00,110,70,40,FMN GV 05 Lier
60,Mechelsesteenweg 365,2019-06-19,16:00:00,160,114,46,FMN GV 05 Lier
60,Mechelsesteenweg 365,2019-06-19,17:00:00,76,44,32,FMN GV 05 Lier
60,Mechelsesteenweg 365,2019-06-19,18:00:00,34,24,10,FMN GV 05 Lier
60,Mechelsesteenweg 365,2019-06-19,19:00:00,44,24,20,FMN GV 05 Lier
60,Mechelsesteenweg 365,2019-06-19,20:00:00,42,16,26,FMN GV 05 Lier
60,Mechelsesteenweg 365,2019-06-19,21:00:00,18,12,6,FMN GV 05 Lier
60,Mechelsesteenweg 365,2019-06-19,22:00:00,10,4,6,FMN GV 05 Lier
60,Mechelsesteenweg 365,2019-06-19,23:00:00,2,0,2,FMN GV 05 Lier
60,Mechelsesteenweg 365,2019-06-20,00:00:00,0,0,0,FMN GV 05 Lier
60,Mechelsesteenweg 365,2019-06-20,01:00:00,0,0,0,FMN GV 05 Lier
60,Mechelsesteenweg 365,2019-06-20,02:00:00,0,0,0,FMN GV 05 Lier
60,Mechelsesteenweg 365,2019-06-20,03:00:00,2,0,2,FMN GV 05 Lier
60,Mechelsesteenweg 365,2019-06-20,04:00:00,0,0,0,FMN GV 05 Lier
60,Mechelsesteenweg 365,2019-06-20,05:00:00,10,0,10,FMN GV 05 Lier
60,Mechelsesteenweg 365,2019-06-20,06:00:00,26,8,18,FMN GV 05 Lier
60,Mechelsesteenweg 365,2019-06-20,07:00:00,174,94,80,FMN GV 05 Lier
60,Mechelsesteenweg 365,2019-06-20,08:00:00,138,90,48,FMN GV 05 Lier
60,Mechelsesteenweg 365,2019-06-20,09:00:00,164,114,50,FMN GV 05 Lier
60,Mechelsesteenweg 365,2019-06-20,10:00:00,220,110,110,FMN GV 05 Lier
60,Mechelsesteenweg 365,2019-06-20,11:00:00,50,28,22,FMN GV 05 Lier
60,Mechelsesteenweg 365,2019-06-20,12:00:00,94,40,54,FMN GV 05 Lier
60,Mechelsesteenweg 365,2019-06-20,13:00:00,162,88,74,FMN GV 05 Lier
60,Mechelsesteenweg 365,2019-06-20,14:00:00,230,72,158,FMN GV 05 Lier
60,Mechelsesteenweg 365,2019-06-20,15:00:00,232,68,164,FMN GV 05 Lier
60,Mechelsesteenweg 365,2019-06-20,16:00:00,180,104,76,FMN GV 05 Lier
60,Mechelsesteenweg 365,2019-06-20,17:00:00,124,54,70,FMN GV 05 Lier
60,Mechelsesteenweg 365,2019-06-20,18:00:00,110,54,56,FMN GV 05 Lier
60,Mechelsesteenweg 365,2019-06-20,19:00:00,82,46,36,FMN GV 05 Lier
60,Mechelsesteenweg 365,2019-06-20,20:00:00,98,50,48,FMN GV 05 Lier
60,Mechelsesteenweg 365,2019-06-20,21:00:00,44,16,28,FMN GV 05 Lier
60,Mechelsesteenweg 365,2019-06-20,22:00:00,10,6,4,FMN GV 05 Lier
60,Mechelsesteenweg 365,2019-06-20,23:00:00,2,2,0,FMN GV 05 Lier
60,Mechelsesteenweg 365,2019-06-21,00:00:00,8,0,8,FMN GV 05 Lier
60,Mechelsesteenweg 365,2019-06-21,01:00:00,0,0,0,FMN GV 05 Lier
60,Mechelsesteenweg 365,2019-06-21,02:00:00,0,0,0,FMN GV 05 Lier
60,Mechelsesteenweg 365,2019-06-21,03:00:00,2,0,2,FMN GV 05 Lier
60,Mechelsesteenweg 365,2019-06-21,04:00:00,4,0,4,FMN GV 05 Lier
60,Mechelsesteenweg 365,2019-06-21,05:00:00,8,0,8,FMN GV 05 Lier
60,Mechelsesteenweg 365,2019-06-21,06:00:00,28,8,20,FMN GV 05 Lier
60,Mechelsesteenweg 365,2019-06-21,07:00:00,148,84,64,FMN GV 05 Lier
60,Mechelsesteenweg 365,2019-06-21,08:00:00,154,72,82,FMN GV 05 Lier
60,Mechelsesteenweg 365,2019-06-21,09:00:00,122,84,38,FMN GV 05 Lier
60,Mechelsesteenweg 365,2019-06-21,10:00:00,154,80,74,FMN GV 05 Lier
60,Mechelsesteenweg 365,2019-06-21,11:00:00,156,82,74,FMN GV 05 Lier
60,Mechelsesteenweg 365,2019-06-21,12:00:00,128,52,76,FMN GV 05 Lier
60,Mechelsesteenweg 365,2019-06-21,13:00:00,134,62,72,FMN GV 05 Lier
60,Mechelsesteenweg 365,2019-06-21,14:00:00,266,132,134,FMN GV 05 Lier
60,Mechelsesteenweg 365,2019-06-21,15:00:00,236,108,128,FMN GV 05 Lier
60,Mechelsesteenweg 365,2019-06-21,16:00:00,190,88,102,FMN GV 05 Lier
60,Mechelsesteenweg 365,2019-06-21,17:00:00,136,60,76,FMN GV 05 Lier
60,Mechelsesteenweg 365,2019-06-21,18:00:00,100,56,44,FMN GV 05 Lier
60,Mechelsesteenweg 365,2019-06-21,19:00:00,108,66,42,FMN GV 05 Lier
60,Mechelsesteenweg 365,2019-06-21,20:00:00,102,56,46,FMN GV 05 Lier
60,Mechelsesteenweg 365,2019-06-21,21:00:00,48,14,34,FMN GV 05 Lier
60,Mechelsesteenweg 365,2019-06-21,22:00:00,32,8,24,FMN GV 05 Lier
60,Mechelsesteenweg 365,2019-06-21,23:00:00,8,6,2,FMN GV 05 Lier
60,Mechelsesteenweg 365,2019-06-22,00:00:00,0,0,0,FMN GV 05 Lier
60,Mechelsesteenweg 365,2019-06-22,01:00:00,0,0,0,FMN GV 05 Lier
60,Mechelsesteenweg 365,2019-06-22,02:00:00,0,0,0,FMN GV 05 Lier
60,Mechelsesteenweg 365,2019-06-22,03:00:00,0,0,0,FMN GV 05 Lier
60,Mechelsesteenweg 365,2019-06-22,04:00:00,6,2,4,FMN GV 05 Lier
60,Mechelsesteenweg 365,2019-06-22,05:00:00,2,0,2,FMN GV 05 Lier
60,Mechelsesteenweg 365,2019-06-22,06:00:00,6,6,0,FMN GV 05 Lier
60,Mechelsesteenweg 365,2019-06-22,07:00:00,20,8,12,FMN GV 05 Lier
60,Mechelsesteenweg 365,2019-06-22,08:00:00,52,22,30,FMN GV 05 Lier
60,Mechelsesteenweg 365,2019-06-22,09:00:00,120,88,32,FMN GV 05 Lier
60,Mechelsesteenweg 365,2019-06-22,10:00:00,220,106,114,FMN GV 05 Lier
60,Mechelsesteenweg 365,2019-06-22,11:00:00,258,98,160,FMN GV 05 Lier
60,Mechelsesteenweg 365,2019-06-22,12:00:00,210,104,106,FMN GV 05 Lier
60,Mechelsesteenweg 365,2019-06-22,13:00:00,208,128,80,FMN GV 05 Lier
60,Mechelsesteenweg 365,2019-06-22,14:00:00,302,140,162,FMN GV 05 Lier
60,Mechelsesteenweg 365,2019-06-22,15:00:00,270,110,160,FMN GV 05 Lier
60,Mechelsesteenweg 365,2019-06-22,16:00:00,308,132,176,FMN GV 05 Lier
60,Mechelsesteenweg 365,2019-06-22,17:00:00,132,50,82,FMN GV 05 Lier
60,Mechelsesteenweg 365,2019-06-22,18:00:00,138,62,76,FMN GV 05 Lier
60,Mechelsesteenweg 365,2019-06-22,19:00:00,130,66,64,FMN GV 05 Lier
60,Mechelsesteenweg 365,2019-06-22,20:00:00,86,30,56,FMN GV 05 Lier
60,Mechelsesteenweg 365,2019-06-22,21:00:00,30,12,18,FMN GV 05 Lier
60,Mechelsesteenweg 365,2019-06-22,22:00:00,68,20,48,FMN GV 05 Lier
60,Mechelsesteenweg 365,2019-06-22,23:00:00,4,2,2,FMN GV 05 Lier
60,Mechelsesteenweg 365,2019-06-23,00:00:00,16,6,10,FMN GV 05 Lier
60,Mechelsesteenweg 365,2019-06-23,01:00:00,2,2,0,FMN GV 05 Lier
60,Mechelsesteenweg 365,2019-06-23,02:00:00,8,0,8,FMN GV 05 Lier
60,Mechelsesteenweg 365,2019-06-23,03:00:00,4,2,2,FMN GV 05 Lier
60,Mechelsesteenweg 365,2019-06-23,04:00:00,0,0,0,FMN GV 05 Lier
60,Mechelsesteenweg 365,2019-06-23,05:00:00,2,0,2,FMN GV 05 Lier
60,Mechelsesteenweg 365,2019-06-23,06:00:00,6,2,4,FMN GV 05 Lier
60,Mechelsesteenweg 365,2019-06-23,07:00:00,14,8,6,FMN GV 05 Lier
60,Mechelsesteenweg 365,2019-06-23,08:00:00,88,58,30,FMN GV 05 Lier
60,Mechelsesteenweg 365,2019-06-23,09:00:00,314,190,124,FMN GV 05 Lier
60,Mechelsesteenweg 365,2019-06-23,10:00:00,442,208,234,FMN GV 05 Lier
60,Mechelsesteenweg 365,2019-06-23,11:00:00,544,248,296,FMN GV 05 Lier
60,Mechelsesteenweg 365,2019-06-23,12:00:00,432,250,182,FMN GV 05 Lier
60,Mechelsesteenweg 365,2019-06-23,13:00:00,410,206,204,FMN GV 05 Lier
60,Mechelsesteenweg 365,2019-06-23,14:00:00,462,266,196,FMN GV 05 Lier
60,Mechelsesteenweg 365,2019-06-23,15:00:00,564,300,264,FMN GV 05 Lier
60,Mechelsesteenweg 365,2019-06-23,16:00:00,372,114,258,FMN GV 05 Lier
60,Mechelsesteenweg 365,2019-06-23,17:00:00,268,54,214,FMN GV 05 Lier
60,Mechelsesteenweg 365,2019-06-23,18:00:00,154,52,102,FMN GV 05 Lier
60,Mechelsesteenweg 365,2019-06-23,19:00:00,120,64,56,FMN GV 05 Lier
60,Mechelsesteenweg 365,2019-06-23,20:00:00,114,64,50,FMN GV 05 Lier
60,Mechelsesteenweg 365,2019-06-23,21:00:00,66,28,38,FMN GV 05 Lier
60,Mechelsesteenweg 365,2019-06-23,22:00:00,14,8,6,FMN GV 05 Lier
60,Mechelsesteenweg 365,2019-06-23,23:00:00,8,4,4,FMN GV 05 Lier
60,Mechelsesteenweg 365,2019-06-24,00:00:00,0,0,0,FMN GV 05 Lier
60,Mechelsesteenweg 365,2019-06-24,01:00:00,0,0,0,FMN GV 05 Lier
60,Mechelsesteenweg 365,2019-06-24,02:00:00,0,0,0,FMN GV 05 Lier
60,Mechelsesteenweg 365,2019-06-24,03:00:00,0,0,0,FMN GV 05 Lier
60,Mechelsesteenweg 365,2019-06-24,04:00:00,4,0,4,FMN GV 05 Lier
60,Mechelsesteenweg 365,2019-06-24,05:00:00,14,4,10,FMN GV 05 Lier
60,Mechelsesteenweg 365,2019-06-24,06:00:00,42,16,26,FMN GV 05 Lier
60,Mechelsesteenweg 365,2019-06-24,07:00:00,136,44,92,FMN GV 05 Lier
60,Mechelsesteenweg 365,2019-06-24,08:00:00,146,66,80,FMN GV 05 Lier
60,Mechelsesteenweg 365,2019-06-24,09:00:00,236,154,82,FMN GV 05 Lier
60,Mechelsesteenweg 365,2019-06-24,10:00:00,158,64,94,FMN GV 05 Lier
60,Mechelsesteenweg 365,2019-06-24,11:00:00,162,80,82,FMN GV 05 Lier
60,Mechelsesteenweg 365,2019-06-24,12:00:00,118,76,42,FMN GV 05 Lier
60,Mechelsesteenweg 365,2019-06-24,13:00:00,124,66,58,FMN GV 05 Lier
60,Mechelsesteenweg 365,2019-06-24,14:00:00,238,72,166,FMN GV 05 Lier
60,Mechelsesteenweg 365,2019-06-24,15:00:00,116,60,56,FMN GV 05 Lier
60,Mechelsesteenweg 365,2019-06-24,16:00:00,160,92,68,FMN GV 05 Lier
60,Mechelsesteenweg 365,2019-06-24,17:00:00,134,86,48,FMN GV 05 Lier
60,Mechelsesteenweg 365,2019-06-24,18:00:00,126,62,64,FMN GV 05 Lier
60,Mechelsesteenweg 365,2019-06-24,19:00:00,146,68,78,FMN GV 05 Lier
60,Mechelsesteenweg 365,2019-06-24,20:00:00,90,36,54,FMN GV 05 Lier
60,Mechelsesteenweg 365,2019-06-24,21:00:00,52,22,30,FMN GV 05 Lier
60,Mechelsesteenweg 365,2019-06-24,22:00:00,26,8,18,FMN GV 05 Lier
60,Mechelsesteenweg 365,2019-06-24,23:00:00,4,2,2,FMN GV 05 Lier
60,Mechelsesteenweg 365,2019-06-25,00:00:00,0,0,0,FMN GV 05 Lier
60,Mechelsesteenweg 365,2019-06-25,01:00:00,0,0,0,FMN GV 05 Lier
60,Mechelsesteenweg 365,2019-06-25,02:00:00,0,0,0,FMN GV 05 Lier
60,Mechelsesteenweg 365,2019-06-25,03:00:00,4,0,4,FMN GV 05 Lier
60,Mechelsesteenweg 365,2019-06-25,04:00:00,2,0,2,FMN GV 05 Lier
60,Mechelsesteenweg 365,2019-06-25,05:00:00,12,2,10,FMN GV 05 Lier
60,Mechelsesteenweg 365,2019-06-25,06:00:00,56,20,36,FMN GV 05 Lier
60,Mechelsesteenweg 365,2019-06-25,07:00:00,134,52,82,FMN GV 05 Lier
60,Mechelsesteenweg 365,2019-06-25,08:00:00,160,64,96,FMN GV 05 Lier
60,Mechelsesteenweg 365,2019-06-25,09:00:00,288,202,86,FMN GV 05 Lier
60,Mechelsesteenweg 365,2019-06-25,10:00:00,284,192,92,FMN GV 05 Lier
60,Mechelsesteenweg 365,2019-06-25,11:00:00,140,80,60,FMN GV 05 Lier
60,Mechelsesteenweg 365,2019-06-25,12:00:00,110,50,60,FMN GV 05 Lier
60,Mechelsesteenweg 365,2019-06-25,13:00:00,198,54,144,FMN GV 05 Lier
60,Mechelsesteenweg 365,2019-06-25,14:00:00,228,66,162,FMN GV 05 Lier
60,Mechelsesteenweg 365,2019-06-25,15:00:00,284,62,222,FMN GV 05 Lier
60,Mechelsesteenweg 365,2019-06-25,16:00:00,124,68,56,FMN GV 05 Lier
60,Mechelsesteenweg 365,2019-06-25,17:00:00,136,76,60,FMN GV 05 Lier
60,Mechelsesteenweg 365,2019-06-25,18:00:00,106,58,48,FMN GV 05 Lier
60,Mechelsesteenweg 365,2019-06-25,19:00:00,138,58,80,FMN GV 05 Lier
60,Mechelsesteenweg 365,2019-06-25,20:00:00,136,72,64,FMN GV 05 Lier
60,Mechelsesteenweg 365,2019-06-25,21:00:00,78,40,38,FMN GV 05 Lier
60,Mechelsesteenweg 365,2019-06-25,22:00:00,22,8,14,FMN GV 05 Lier
60,Mechelsesteenweg 365,2019-06-25,23:00:00,10,4,6,FMN GV 05 Lier
60,Mechelsesteenweg 365,2019-06-26,00:00:00,4,0,4,FMN GV 05 Lier
60,Mechelsesteenweg 365,2019-06-26,01:00:00,0,0,0,FMN GV 05 Lier
60,Mechelsesteenweg 365,2019-06-26,02:00:00,0,0,0,FMN GV 05 Lier
60,Mechelsesteenweg 365,2019-06-26,03:00:00,2,0,2,FMN GV 05 Lier
60,Mechelsesteenweg 365,2019-06-26,04:00:00,6,2,4,FMN GV 05 Lier
60,Mechelsesteenweg 365,2019-06-26,05:00:00,10,0,10,FMN GV 05 Lier
60,Mechelsesteenweg 365,2019-06-26,06:00:00,40,16,24,FMN GV 05 Lier
60,Mechelsesteenweg 365,2019-06-26,07:00:00,138,38,100,FMN GV 05 Lier
60,Mechelsesteenweg 365,2019-06-26,08:00:00,126,60,66,FMN GV 05 Lier
60,Mechelsesteenweg 365,2019-06-26,09:00:00,96,52,44,FMN GV 05 Lier
60,Mechelsesteenweg 365,2019-06-26,10:00:00,112,66,46,FMN GV 05 Lier
60,Mechelsesteenweg 365,2019-06-26,11:00:00,144,66,78,FMN GV 05 Lier
60,Mechelsesteenweg 365,2019-06-26,12:00:00,96,40,56,FMN GV 05 Lier
60,Mechelsesteenweg 365,2019-06-26,13:00:00,164,72,92,FMN GV 05 Lier
60,Mechelsesteenweg 365,2019-06-26,14:00:00,170,114,56,FMN GV 05 Lier
60,Mechelsesteenweg 365,2019-06-26,15:00:00,244,98,146,FMN GV 05 Lier
60,Mechelsesteenweg 365,2019-06-26,16:00:00,200,92,108,FMN GV 05 Lier
60,Mechelsesteenweg 365,2019-06-26,17:00:00,158,96,62,FMN GV 05 Lier
60,Mechelsesteenweg 365,2019-06-26,18:00:00,100,46,54,FMN GV 05 Lier
60,Mechelsesteenweg 365,2019-06-26,19:00:00,206,122,84,FMN GV 05 Lier
60,Mechelsesteenweg 365,2019-06-26,20:00:00,178,110,68,FMN GV 05 Lier
60,Mechelsesteenweg 365,2019-06-26,21:00:00,48,20,28,FMN GV 05 Lier
60,Mechelsesteenweg 365,2019-06-26,22:00:00,36,10,26,FMN GV 05 Lier
60,Mechelsesteenweg 365,2019-06-26,23:00:00,6,4,2,FMN GV 05 Lier
60,Mechelsesteenweg 365,2019-06-27,00:00:00,4,2,2,FMN GV 05 Lier
60,Mechelsesteenweg 365,2019-06-27,01:00:00,0,0,0,FMN GV 05 Lier
60,Mechelsesteenweg 365,2019-06-27,02:00:00,0,0,0,FMN GV 05 Lier
60,Mechelsesteenweg 365,2019-06-27,03:00:00,2,0,2,FMN GV 05 Lier
60,Mechelsesteenweg 365,2019-06-27,04:00:00,2,0,2,FMN GV 05 Lier
60,Mechelsesteenweg 365,2019-06-27,05:00:00,20,6,14,FMN GV 05 Lier
60,Mechelsesteenweg 365,2019-06-27,06:00:00,38,10,28,FMN GV 05 Lier
60,Mechelsesteenweg 365,2019-06-27,07:00:00,132,56,76,FMN GV 05 Lier
60,Mechelsesteenweg 365,2019-06-27,08:00:00,160,80,80,FMN GV 05 Lier
60,Mechelsesteenweg 365,2019-06-27,09:00:00,142,88,54,FMN GV 05 Lier
60,Mechelsesteenweg 365,2019-06-27,10:00:00,160,84,76,FMN GV 05 Lier
60,Mechelsesteenweg 365,2019-06-27,11:00:00,190,74,116,FMN GV 05 Lier
60,Mechelsesteenweg 365,2019-06-27,12:00:00,160,78,82,FMN GV 05 Lier
60,Mechelsesteenweg 365,2019-06-27,13:00:00,194,88,106,FMN GV 05 Lier
60,Mechelsesteenweg 365,2019-06-27,14:00:00,278,126,152,FMN GV 05 Lier
60,Mechelsesteenweg 365,2019-06-27,15:00:00,230,100,130,FMN GV 05 Lier
60,Mechelsesteenweg 365,2019-06-27,16:00:00,166,78,88,FMN GV 05 Lier
60,Mechelsesteenweg 365,2019-06-27,17:00:00,196,110,86,FMN GV 05 Lier
60,Mechelsesteenweg 365,2019-06-27,18:00:00,158,80,78,FMN GV 05 Lier
60,Mechelsesteenweg 365,2019-06-27,19:00:00,142,64,78,FMN GV 05 Lier
60,Mechelsesteenweg 365,2019-06-27,20:00:00,160,66,94,FMN GV 05 Lier
60,Mechelsesteenweg 365,2019-06-27,21:00:00,92,20,72,FMN GV 05 Lier
60,Mechelsesteenweg 365,2019-06-27,22:00:00,40,20,20,FMN GV 05 Lier
60,Mechelsesteenweg 365,2019-06-27,23:00:00,10,2,8,FMN GV 05 Lier
60,Mechelsesteenweg 365,2019-06-28,00:00:00,4,4,0,FMN GV 05 Lier
60,Mechelsesteenweg 365,2019-06-28,01:00:00,0,0,0,FMN GV 05 Lier
60,Mechelsesteenweg 365,2019-06-28,02:00:00,0,0,0,FMN GV 05 Lier
60,Mechelsesteenweg 365,2019-06-28,03:00:00,2,0,2,FMN GV 05 Lier
60,Mechelsesteenweg 365,2019-06-28,04:00:00,2,0,2,FMN GV 05 Lier
60,Mechelsesteenweg 365,2019-06-28,05:00:00,4,0,4,FMN GV 05 Lier
60,Mechelsesteenweg 365,2019-06-28,06:00:00,20,8,12,FMN GV 05 Lier
60,Mechelsesteenweg 365,2019-06-28,07:00:00,96,40,56,FMN GV 05 Lier
60,Mechelsesteenweg 365,2019-06-28,08:00:00,116,56,60,FMN GV 05 Lier
60,Mechelsesteenweg 365,2019-06-28,09:00:00,130,78,52,FMN GV 05 Lier
60,Mechelsesteenweg 365,2019-06-28,10:00:00,154,72,82,FMN GV 05 Lier
60,Mechelsesteenweg 365,2019-06-28,11:00:00,172,78,94,FMN GV 05 Lier
60,Mechelsesteenweg 365,2019-06-28,12:00:00,152,66,86,FMN GV 05 Lier
60,Mechelsesteenweg 365,2019-06-28,13:00:00,138,66,72,FMN GV 05 Lier
60,Mechelsesteenweg 365,2019-06-28,14:00:00,194,70,124,FMN GV 05 Lier
60,Mechelsesteenweg 365,2019-06-28,15:00:00,184,88,96,FMN GV 05 Lier
60,Mechelsesteenweg 365,2019-06-28,16:00:00,214,102,112,FMN GV 05 Lier
60,Mechelsesteenweg 365,2019-06-28,17:00:00,186,102,84,FMN GV 05 Lier
60,Mechelsesteenweg 365,2019-06-28,18:00:00,120,64,56,FMN GV 05 Lier
60,Mechelsesteenweg 365,2019-06-28,19:00:00,108,54,54,FMN GV 05 Lier
60,Mechelsesteenweg 365,2019-06-28,20:00:00,104,46,58,FMN GV 05 Lier
60,Mechelsesteenweg 365,2019-06-28,21:00:00,66,28,38,FMN GV 05 Lier
60,Mechelsesteenweg 365,2019-06-28,22:00:00,50,20,30,FMN GV 05 Lier
60,Mechelsesteenweg 365,2019-06-28,23:00:00,16,6,10,FMN GV 05 Lier
60,Mechelsesteenweg 365,2019-06-29,00:00:00,20,4,16,FMN GV 05 Lier
60,Mechelsesteenweg 365,2019-06-29,01:00:00,12,6,6,FMN GV 05 Lier
60,Mechelsesteenweg 365,2019-06-29,02:00:00,12,4,8,FMN GV 05 Lier
60,Mechelsesteenweg 365,2019-06-29,03:00:00,2,2,0,FMN GV 05 Lier
60,Mechelsesteenweg 365,2019-06-29,04:00:00,4,2,2,FMN GV 05 Lier
60,Mechelsesteenweg 365,2019-06-29,05:00:00,0,0,0,FMN GV 05 Lier
60,Mechelsesteenweg 365,2019-06-29,06:00:00,6,4,2,FMN GV 05 Lier
60,Mechelsesteenweg 365,2019-06-29,07:00:00,36,22,14,FMN GV 05 Lier
60,Mechelsesteenweg 365,2019-06-29,08:00:00,64,34,30,FMN GV 05 Lier
60,Mechelsesteenweg 365,2019-06-29,09:00:00,146,74,72,FMN GV 05 Lier
60,Mechelsesteenweg 365,2019-06-29,10:00:00,244,132,112,FMN GV 05 Lier
60,Mechelsesteenweg 365,2019-06-29,11:00:00,198,100,98,FMN GV 05 Lier
60,Mechelsesteenweg 365,2019-06-29,12:00:00,156,56,100,FMN GV 05 Lier
60,Mechelsesteenweg 365,2019-06-29,13:00:00,116,38,78,FMN GV 05 Lier
60,Mechelsesteenweg 365,2019-06-29,14:00:00,128,62,66,FMN GV 05 Lier
60,Mechelsesteenweg 365,2019-06-29,15:00:00,122,60,62,FMN GV 05 Lier
60,Mechelsesteenweg 365,2019-06-29,16:00:00,94,34,60,FMN GV 05 Lier
60,Mechelsesteenweg 365,2019-06-29,17:00:00,60,22,38,FMN GV 05 Lier
60,Mechelsesteenweg 365,2019-06-29,18:00:00,48,28,20,FMN GV 05 Lier
60,Mechelsesteenweg 365,2019-06-29,19:00:00,52,30,22,FMN GV 05 Lier
60,Mechelsesteenweg 365,2019-06-29,20:00:00,72,38,34,FMN GV 05 Lier
60,Mechelsesteenweg 365,2019-06-29,21:00:00,32,12,20,FMN GV 05 Lier
60,Mechelsesteenweg 365,2019-06-29,22:00:00,36,4,32,FMN GV 05 Lier
60,Mechelsesteenweg 365,2019-06-29,23:00:00,12,2,10,FMN GV 05 Lier
60,Mechelsesteenweg 365,2019-06-30,00:00:00,12,2,10,FMN GV 05 Lier
60,Mechelsesteenweg 365,2019-06-30,01:00:00,0,0,0,FMN GV 05 Lier
60,Mechelsesteenweg 365,2019-06-30,02:00:00,2,0,2,FMN GV 05 Lier
60,Mechelsesteenweg 365,2019-06-30,03:00:00,2,0,2,FMN GV 05 Lier
60,Mechelsesteenweg 365,2019-06-30,04:00:00,0,0,0,FMN GV 05 Lier
60,Mechelsesteenweg 365,2019-06-30,05:00:00,0,0,0,FMN GV 05 Lier
60,Mechelsesteenweg 365,2019-06-30,06:00:00,12,4,8,FMN GV 05 Lier
60,Mechelsesteenweg 365,2019-06-30,07:00:00,12,4,8,FMN GV 05 Lier
60,Mechelsesteenweg 365,2019-06-30,08:00:00,120,56,64,FMN GV 05 Lier
60,Mechelsesteenweg 365,2019-06-30,09:00:00,336,178,158,FMN GV 05 Lier
60,Mechelsesteenweg 365,2019-06-30,10:00:00,446,214,232,FMN GV 05 Lier
60,Mechelsesteenweg 365,2019-06-30,11:00:00,432,184,248,FMN GV 05 Lier
60,Mechelsesteenweg 365,2019-06-30,12:00:00,362,218,144,FMN GV 05 Lier
60,Mechelsesteenweg 365,2019-06-30,13:00:00,256,146,110,FMN GV 05 Lier
60,Mechelsesteenweg 365,2019-06-30,14:00:00,334,206,128,FMN GV 05 Lier
60,Mechelsesteenweg 365,2019-06-30,15:00:00,260,120,140,FMN GV 05 Lier
60,Mechelsesteenweg 365,2019-06-30,16:00:00,232,96,136,FMN GV 05 Lier
60,Mechelsesteenweg 365,2019-06-30,17:00:00,240,78,162,FMN GV 05 Lier
60,Mechelsesteenweg 365,2019-06-30,18:00:00,180,92,88,FMN GV 05 Lier
60,Mechelsesteenweg 365,2019-06-30,19:00:00,112,36,76,FMN GV 05 Lier
60,Mechelsesteenweg 365,2019-06-30,20:00:00,118,52,66,FMN GV 05 Lier
60,Mechelsesteenweg 365,2019-06-30,21:00:00,64,36,28,FMN GV 05 Lier
60,Mechelsesteenweg 365,2019-06-30,22:00:00,32,12,20,FMN GV 05 Lier
60,Mechelsesteenweg 365,2019-06-30,23:00:00,4,2,2,FMN GV 05 Lier
60,Mechelsesteenweg 365,2019-07-01,00:00:00,4,0,4,FMN GV 05 Lier
60,Mechelsesteenweg 365,2019-07-01,01:00:00,0,0,0,FMN GV 05 Lier
60,Mechelsesteenweg 365,2019-07-01,02:00:00,0,0,0,FMN GV 05 Lier
60,Mechelsesteenweg 365,2019-07-01,03:00:00,2,0,2,FMN GV 05 Lier
60,Mechelsesteenweg 365,2019-07-01,04:00:00,4,0,4,FMN GV 05 Lier
60,Mechelsesteenweg 365,2019-07-01,05:00:00,30,20,10,FMN GV 05 Lier
60,Mechelsesteenweg 365,2019-07-01,06:00:00,30,12,18,FMN GV 05 Lier
60,Mechelsesteenweg 365,2019-07-01,07:00:00,132,46,86,FMN GV 05 Lier
60,Mechelsesteenweg 365,2019-07-01,08:00:00,92,44,48,FMN GV 05 Lier
60,Mechelsesteenweg 365,2019-07-01,09:00:00,120,72,48,FMN GV 05 Lier
60,Mechelsesteenweg 365,2019-07-01,10:00:00,118,62,56,FMN GV 05 Lier
60,Mechelsesteenweg 365,2019-07-01,11:00:00,112,54,58,FMN GV 05 Lier
60,Mechelsesteenweg 365,2019-07-01,12:00:00,86,50,36,FMN GV 05 Lier
60,Mechelsesteenweg 365,2019-07-01,13:00:00,184,88,96,FMN GV 05 Lier
60,Mechelsesteenweg 365,2019-07-01,14:00:00,242,124,118,FMN GV 05 Lier
60,Mechelsesteenweg 365,2019-07-01,15:00:00,242,126,116,FMN GV 05 Lier
60,Mechelsesteenweg 365,2019-07-01,16:00:00,212,96,116,FMN GV 05 Lier
60,Mechelsesteenweg 365,2019-07-01,17:00:00,186,106,80,FMN GV 05 Lier
60,Mechelsesteenweg 365,2019-07-01,18:00:00,154,66,88,FMN GV 05 Lier
60,Mechelsesteenweg 365,2019-07-01,19:00:00,100,46,54,FMN GV 05 Lier
60,Mechelsesteenweg 365,2019-07-01,20:00:00,98,48,50,FMN GV 05 Lier
60,Mechelsesteenweg 365,2019-07-01,21:00:00,42,18,24,FMN GV 05 Lier
60,Mechelsesteenweg 365,2019-07-01,22:00:00,12,10,2,FMN GV 05 Lier
60,Mechelsesteenweg 365,2019-07-01,23:00:00,10,0,10,FMN GV 05 Lier
60,Mechelsesteenweg 365,2019-07-02,00:00:00,0,0,0,FMN GV 05 Lier
60,Mechelsesteenweg 365,2019-07-02,01:00:00,0,0,0,FMN GV 05 Lier
60,Mechelsesteenweg 365,2019-07-02,02:00:00,0,0,0,FMN GV 05 Lier
60,Mechelsesteenweg 365,2019-07-02,03:00:00,2,0,2,FMN GV 05 Lier
60,Mechelsesteenweg 365,2019-07-02,04:00:00,6,0,6,FMN GV 05 Lier
60,Mechelsesteenweg 365,2019-07-02,05:00:00,12,0,12,FMN GV 05 Lier
60,Mechelsesteenweg 365,2019-07-02,06:00:00,54,20,34,FMN GV 05 Lier
60,Mechelsesteenweg 365,2019-07-02,07:00:00,144,46,98,FMN GV 05 Lier
60,Mechelsesteenweg 365,2019-07-02,08:00:00,108,46,62,FMN GV 05 Lier
60,Mechelsesteenweg 365,2019-07-02,09:00:00,148,90,58,FMN GV 05 Lier
60,Mechelsesteenweg 365,2019-07-02,10:00:00,182,92,90,FMN GV 05 Lier
60,Mechelsesteenweg 365,2019-07-02,11:00:00,180,112,68,FMN GV 05 Lier
60,Mechelsesteenweg 365,2019-07-02,12:00:00,134,64,70,FMN GV 05 Lier
60,Mechelsesteenweg 365,2019-07-02,13:00:00,200,104,96,FMN GV 05 Lier
60,Mechelsesteenweg 365,2019-07-02,14:00:00,236,124,112,FMN GV 05 Lier
60,Mechelsesteenweg 365,2019-07-02,15:00:00,224,112,112,FMN GV 05 Lier
60,Mechelsesteenweg 365,2019-07-02,16:00:00,236,142,94,FMN GV 05 Lier
60,Mechelsesteenweg 365,2019-07-02,17:00:00,230,144,86,FMN GV 05 Lier
60,Mechelsesteenweg 365,2019-07-02,18:00:00,136,84,52,FMN GV 05 Lier
60,Mechelsesteenweg 365,2019-07-02,19:00:00,136,64,72,FMN GV 05 Lier
60,Mechelsesteenweg 365,2019-07-02,20:00:00,178,98,80,FMN GV 05 Lier
60,Mechelsesteenweg 365,2019-07-02,21:00:00,52,16,36,FMN GV 05 Lier
60,Mechelsesteenweg 365,2019-07-02,22:00:00,18,6,12,FMN GV 05 Lier
60,Mechelsesteenweg 365,2019-07-02,23:00:00,4,4,0,FMN GV 05 Lier
60,Mechelsesteenweg 365,2019-07-03,00:00:00,4,2,2,FMN GV 05 Lier
60,Mechelsesteenweg 365,2019-07-03,01:00:00,0,0,0,FMN GV 05 Lier
60,Mechelsesteenweg 365,2019-07-03,02:00:00,0,0,0,FMN GV 05 Lier
60,Mechelsesteenweg 365,2019-07-03,03:00:00,0,0,0,FMN GV 05 Lier
60,Mechelsesteenweg 365,2019-07-03,04:00:00,4,0,4,FMN GV 05 Lier
60,Mechelsesteenweg 365,2019-07-03,05:00:00,12,0,12,FMN GV 05 Lier
60,Mechelsesteenweg 365,2019-07-03,06:00:00,28,8,20,FMN GV 05 Lier
60,Mechelsesteenweg 365,2019-07-03,07:00:00,106,34,72,FMN GV 05 Lier
60,Mechelsesteenweg 365,2019-07-03,08:00:00,110,58,52,FMN GV 05 Lier
60,Mechelsesteenweg 365,2019-07-03,09:00:00,78,40,38,FMN GV 05 Lier
60,Mechelsesteenweg 365,2019-07-03,10:00:00,162,92,70,FMN GV 05 Lier
60,Mechelsesteenweg 365,2019-07-03,11:00:00,114,56,58,FMN GV 05 Lier
60,Mechelsesteenweg 365,2019-07-03,12:00:00,114,40,74,FMN GV 05 Lier
60,Mechelsesteenweg 365,2019-07-03,13:00:00,192,90,102,FMN GV 05 Lier
60,Mechelsesteenweg 365,2019-07-03,14:00:00,194,124,70,FMN GV 05 Lier
60,Mechelsesteenweg 365,2019-07-03,15:00:00,206,108,98,FMN GV 05 Lier
60,Mechelsesteenweg 365,2019-07-03,16:00:00,188,78,110,FMN GV 05 Lier
60,Mechelsesteenweg 365,2019-07-03,17:00:00,186,114,72,FMN GV 05 Lier
60,Mechelsesteenweg 365,2019-07-03,18:00:00,166,78,88,FMN GV 05 Lier
60,Mechelsesteenweg 365,2019-07-03,19:00:00,244,154,90,FMN GV 05 Lier
60,Mechelsesteenweg 365,2019-07-03,20:00:00,150,76,74,FMN GV 05 Lier
60,Mechelsesteenweg 365,2019-07-03,21:00:00,34,2,32,FMN GV 05 Lier
60,Mechelsesteenweg 365,2019-07-03,22:00:00,40,22,18,FMN GV 05 Lier
60,Mechelsesteenweg 365,2019-07-03,23:00:00,2,0,2,FMN GV 05 Lier
60,Mechelsesteenweg 365,2019-07-04,00:00:00,0,0,0,FMN GV 05 Lier
60,Mechelsesteenweg 365,2019-07-04,01:00:00,0,0,0,FMN GV 05 Lier
60,Mechelsesteenweg 365,2019-07-04,02:00:00,0,0,0,FMN GV 05 Lier
60,Mechelsesteenweg 365,2019-07-04,03:00:00,0,0,0,FMN GV 05 Lier
60,Mechelsesteenweg 365,2019-07-04,04:00:00,8,0,8,FMN GV 05 Lier
60,Mechelsesteenweg 365,2019-07-04,05:00:00,12,0,12,FMN GV 05 Lier
60,Mechelsesteenweg 365,2019-07-04,06:00:00,24,16,8,FMN GV 05 Lier
60,Mechelsesteenweg 365,2019-07-04,07:00:00,114,30,84,FMN GV 05 Lier
60,Mechelsesteenweg 365,2019-07-04,08:00:00,76,26,50,FMN GV 05 Lier
60,Mechelsesteenweg 365,2019-07-04,09:00:00,76,36,40,FMN GV 05 Lier
60,Mechelsesteenweg 365,2019-07-04,10:00:00,158,74,84,FMN GV 05 Lier
60,Mechelsesteenweg 365,2019-07-04,11:00:00,174,90,84,FMN GV 05 Lier
60,Mechelsesteenweg 365,2019-07-04,12:00:00,202,148,54,FMN GV 05 Lier
60,Mechelsesteenweg 365,2019-07-04,13:00:00,228,102,126,FMN GV 05 Lier
60,Mechelsesteenweg 365,2019-07-04,14:00:00,298,148,150,FMN GV 05 Lier
60,Mechelsesteenweg 365,2019-07-04,15:00:00,304,128,176,FMN GV 05 Lier
60,Mechelsesteenweg 365,2019-07-04,16:00:00,244,122,122,FMN GV 05 Lier
60,Mechelsesteenweg 365,2019-07-04,17:00:00,212,114,98,FMN GV 05 Lier
60,Mechelsesteenweg 365,2019-07-04,18:00:00,160,82,78,FMN GV 05 Lier
60,Mechelsesteenweg 365,2019-07-04,19:00:00,172,96,76,FMN GV 05 Lier
60,Mechelsesteenweg 365,2019-07-04,20:00:00,164,62,102,FMN GV 05 Lier
60,Mechelsesteenweg 365,2019-07-04,21:00:00,50,20,30,FMN GV 05 Lier
60,Mechelsesteenweg 365,2019-07-04,22:00:00,10,0,10,FMN GV 05 Lier
60,Mechelsesteenweg 365,2019-07-04,23:00:00,2,0,2,FMN GV 05 Lier
60,Mechelsesteenweg 365,2019-07-05,00:00:00,2,2,0,FMN GV 05 Lier
60,Mechelsesteenweg 365,2019-07-05,01:00:00,0,0,0,FMN GV 05 Lier
60,Mechelsesteenweg 365,2019-07-05,02:00:00,0,0,0,FMN GV 05 Lier
60,Mechelsesteenweg 365,2019-07-05,03:00:00,2,0,2,FMN GV 05 Lier
60,Mechelsesteenweg 365,2019-07-05,04:00:00,8,0,8,FMN GV 05 Lier
60,Mechelsesteenweg 365,2019-07-05,05:00:00,8,0,8,FMN GV 05 Lier
60,Mechelsesteenweg 365,2019-07-05,06:00:00,26,18,8,FMN GV 05 Lier
60,Mechelsesteenweg 365,2019-07-05,07:00:00,108,26,82,FMN GV 05 Lier
60,Mechelsesteenweg 365,2019-07-05,08:00:00,94,36,58,FMN GV 05 Lier
60,Mechelsesteenweg 365,2019-07-05,09:00:00,54,24,30,FMN GV 05 Lier
60,Mechelsesteenweg 365,2019-07-05,10:00:00,124,62,62,FMN GV 05 Lier
60,Mechelsesteenweg 365,2019-07-05,11:00:00,102,50,52,FMN GV 05 Lier
60,Mechelsesteenweg 365,2019-07-05,12:00:00,130,66,64,FMN GV 05 Lier
60,Mechelsesteenweg 365,2019-07-05,13:00:00,202,96,106,FMN GV 05 Lier
60,Mechelsesteenweg 365,2019-07-05,14:00:00,214,126,88,FMN GV 05 Lier
60,Mechelsesteenweg 365,2019-07-05,15:00:00,226,118,108,FMN GV 05 Lier
60,Mechelsesteenweg 365,2019-07-05,16:00:00,262,126,136,FMN GV 05 Lier
60,Mechelsesteenweg 365,2019-07-05,17:00:00,214,120,94,FMN GV 05 Lier
60,Mechelsesteenweg 365,2019-07-05,18:00:00,132,60,72,FMN GV 05 Lier
60,Mechelsesteenweg 365,2019-07-05,19:00:00,52,26,26,FMN GV 05 Lier
60,Mechelsesteenweg 365,2019-07-05,20:00:00,60,24,36,FMN GV 05 Lier
60,Mechelsesteenweg 365,2019-07-05,21:00:00,52,18,34,FMN GV 05 Lier
60,Mechelsesteenweg 365,2019-07-05,22:00:00,20,14,6,FMN GV 05 Lier
60,Mechelsesteenweg 365,2019-07-05,23:00:00,14,8,6,FMN GV 05 Lier
60,Mechelsesteenweg 365,2019-07-06,00:00:00,2,0,2,FMN GV 05 Lier
60,Mechelsesteenweg 365,2019-07-06,01:00:00,2,0,2,FMN GV 05 Lier
60,Mechelsesteenweg 365,2019-07-06,02:00:00,0,0,0,FMN GV 05 Lier
60,Mechelsesteenweg 365,2019-07-06,03:00:00,0,0,0,FMN GV 05 Lier
60,Mechelsesteenweg 365,2019-07-06,04:00:00,4,0,4,FMN GV 05 Lier
60,Mechelsesteenweg 365,2019-07-06,05:00:00,2,2,0,FMN GV 05 Lier
60,Mechelsesteenweg 365,2019-07-06,06:00:00,8,4,4,FMN GV 05 Lier
60,Mechelsesteenweg 365,2019-07-06,07:00:00,18,10,8,FMN GV 05 Lier
60,Mechelsesteenweg 365,2019-07-06,08:00:00,84,48,36,FMN GV 05 Lier
60,Mechelsesteenweg 365,2019-07-06,09:00:00,138,70,68,FMN GV 05 Lier
60,Mechelsesteenweg 365,2019-07-06,10:00:00,256,160,96,FMN GV 05 Lier
60,Mechelsesteenweg 365,2019-07-06,11:00:00,216,80,136,FMN GV 05 Lier
60,Mechelsesteenweg 365,2019-07-06,12:00:00,146,76,70,FMN GV 05 Lier
60,Mechelsesteenweg 365,2019-07-06,13:00:00,190,98,92,FMN GV 05 Lier
60,Mechelsesteenweg 365,2019-07-06,14:00:00,208,106,102,FMN GV 05 Lier
60,Mechelsesteenweg 365,2019-07-06,15:00:00,206,104,102,FMN GV 05 Lier
60,Mechelsesteenweg 365,2019-07-06,16:00:00,172,60,112,FMN GV 05 Lier
60,Mechelsesteenweg 365,2019-07-06,17:00:00,102,28,74,FMN GV 05 Lier
60,Mechelsesteenweg 365,2019-07-06,18:00:00,84,30,54,FMN GV 05 Lier
60,Mechelsesteenweg 365,2019-07-06,19:00:00,60,38,22,FMN GV 05 Lier
60,Mechelsesteenweg 365,2019-07-06,20:00:00,44,14,30,FMN GV 05 Lier
60,Mechelsesteenweg 365,2019-07-06,21:00:00,18,6,12,FMN GV 05 Lier
60,Mechelsesteenweg 365,2019-07-06,22:00:00,2,2,0,FMN GV 05 Lier
60,Mechelsesteenweg 365,2019-07-06,23:00:00,0,0,0,FMN GV 05 Lier
60,Mechelsesteenweg 365,2019-07-07,00:00:00,8,8,0,FMN GV 05 Lier
60,Mechelsesteenweg 365,2019-07-07,01:00:00,0,0,0,FMN GV 05 Lier
60,Mechelsesteenweg 365,2019-07-07,02:00:00,0,0,0,FMN GV 05 Lier
60,Mechelsesteenweg 365,2019-07-07,03:00:00,2,0,2,FMN GV 05 Lier
60,Mechelsesteenweg 365,2019-07-07,04:00:00,0,0,0,FMN GV 05 Lier
60,Mechelsesteenweg 365,2019-07-07,05:00:00,0,0,0,FMN GV 05 Lier
60,Mechelsesteenweg 365,2019-07-07,06:00:00,0,0,0,FMN GV 05 Lier
60,Mechelsesteenweg 365,2019-07-07,07:00:00,8,4,4,FMN GV 05 Lier
60,Mechelsesteenweg 365,2019-07-07,08:00:00,70,36,34,FMN GV 05 Lier
60,Mechelsesteenweg 365,2019-07-07,09:00:00,234,136,98,FMN GV 05 Lier
60,Mechelsesteenweg 365,2019-07-07,10:00:00,292,144,148,FMN GV 05 Lier
60,Mechelsesteenweg 365,2019-07-07,11:00:00,440,132,308,FMN GV 05 Lier
60,Mechelsesteenweg 365,2019-07-07,12:00:00,226,118,108,FMN GV 05 Lier
60,Mechelsesteenweg 365,2019-07-07,13:00:00,258,96,162,FMN GV 05 Lier
60,Mechelsesteenweg 365,2019-07-07,14:00:00,380,188,192,FMN GV 05 Lier
60,Mechelsesteenweg 365,2019-07-07,15:00:00,304,132,172,FMN GV 05 Lier
60,Mechelsesteenweg 365,2019-07-07,16:00:00,236,92,144,FMN GV 05 Lier
60,Mechelsesteenweg 365,2019-07-07,17:00:00,192,96,96,FMN GV 05 Lier
60,Mechelsesteenweg 365,2019-07-07,18:00:00,146,66,80,FMN GV 05 Lier
60,Mechelsesteenweg 365,2019-07-07,19:00:00,68,26,42,FMN GV 05 Lier
60,Mechelsesteenweg 365,2019-07-07,20:00:00,34,14,20,FMN GV 05 Lier
60,Mechelsesteenweg 365,2019-07-07,21:00:00,14,6,8,FMN GV 05 Lier
60,Mechelsesteenweg 365,2019-07-07,22:00:00,4,2,2,FMN GV 05 Lier
60,Mechelsesteenweg 365,2019-07-07,23:00:00,0,0,0,FMN GV 05 Lier
60,Mechelsesteenweg 365,2019-07-08,00:00:00,0,0,0,FMN GV 05 Lier
60,Mechelsesteenweg 365,2019-07-08,01:00:00,0,0,0,FMN GV 05 Lier
60,Mechelsesteenweg 365,2019-07-08,02:00:00,0,0,0,FMN GV 05 Lier
60,Mechelsesteenweg 365,2019-07-08,03:00:00,0,0,0,FMN GV 05 Lier
60,Mechelsesteenweg 365,2019-07-08,04:00:00,6,0,6,FMN GV 05 Lier
60,Mechelsesteenweg 365,2019-07-08,05:00:00,14,2,12,FMN GV 05 Lier
60,Mechelsesteenweg 365,2019-07-08,06:00:00,26,10,16,FMN GV 05 Lier
60,Mechelsesteenweg 365,2019-07-08,07:00:00,72,18,54,FMN GV 05 Lier
60,Mechelsesteenweg 365,2019-07-08,08:00:00,80,26,54,FMN GV 05 Lier
60,Mechelsesteenweg 365,2019-07-08,09:00:00,22,8,14,FMN GV 05 Lier
60,Mechelsesteenweg 365,2019-07-08,10:00:00,74,32,42,FMN GV 05 Lier
60,Mechelsesteenweg 365,2019-07-08,11:00:00,100,42,58,FMN GV 05 Lier
60,Mechelsesteenweg 365,2019-07-08,12:00:00,74,50,24,FMN GV 05 Lier
60,Mechelsesteenweg 365,2019-07-08,13:00:00,76,30,46,FMN GV 05 Lier
60,Mechelsesteenweg 365,2019-07-08,14:00:00,124,72,52,FMN GV 05 Lier
60,Mechelsesteenweg 365,2019-07-08,15:00:00,98,54,44,FMN GV 05 Lier
60,Mechelsesteenweg 365,2019-07-08,16:00:00,148,90,58,FMN GV 05 Lier
60,Mechelsesteenweg 365,2019-07-08,17:00:00,136,82,54,FMN GV 05 Lier
60,Mechelsesteenweg 365,2019-07-08,18:00:00,114,66,48,FMN GV 05 Lier
60,Mechelsesteenweg 365,2019-07-08,19:00:00,44,22,22,FMN GV 05 Lier
60,Mechelsesteenweg 365,2019-07-08,20:00:00,44,16,28,FMN GV 05 Lier
60,Mechelsesteenweg 365,2019-07-08,21:00:00,30,12,18,FMN GV 05 Lier
60,Mechelsesteenweg 365,2019-07-08,22:00:00,12,10,2,FMN GV 05 Lier
60,Mechelsesteenweg 365,2019-07-08,23:00:00,2,2,0,FMN GV 05 Lier
60,Mechelsesteenweg 365,2019-07-09,00:00:00,2,2,0,FMN GV 05 Lier
60,Mechelsesteenweg 365,2019-07-09,01:00:00,0,0,0,FMN GV 05 Lier
60,Mechelsesteenweg 365,2019-07-09,02:00:00,0,0,0,FMN GV 05 Lier
60,Mechelsesteenweg 365,2019-07-09,03:00:00,0,0,0,FMN GV 05 Lier
60,Mechelsesteenweg 365,2019-07-09,04:00:00,4,0,4,FMN GV 05 Lier
60,Mechelsesteenweg 365,2019-07-09,05:00:00,6,2,4,FMN GV 05 Lier
60,Mechelsesteenweg 365,2019-07-09,06:00:00,32,10,22,FMN GV 05 Lier
60,Mechelsesteenweg 365,2019-07-09,07:00:00,98,24,74,FMN GV 05 Lier
60,Mechelsesteenweg 365,2019-07-09,08:00:00,82,26,56,FMN GV 05 Lier
60,Mechelsesteenweg 365,2019-07-09,09:00:00,102,34,68,FMN GV 05 Lier
60,Mechelsesteenweg 365,2019-07-09,10:00:00,178,90,88,FMN GV 05 Lier
60,Mechelsesteenweg 365,2019-07-09,11:00:00,220,126,94,FMN GV 05 Lier
60,Mechelsesteenweg 365,2019-07-09,12:00:00,132,82,50,FMN GV 05 Lier
60,Mechelsesteenweg 365,2019-07-09,13:00:00,262,122,140,FMN GV 05 Lier
60,Mechelsesteenweg 365,2019-07-09,14:00:00,264,120,144,FMN GV 05 Lier
60,Mechelsesteenweg 365,2019-07-09,15:00:00,230,114,116,FMN GV 05 Lier
60,Mechelsesteenweg 365,2019-07-09,16:00:00,224,88,136,FMN GV 05 Lier
60,Mechelsesteenweg 365,2019-07-09,17:00:00,204,118,86,FMN GV 05 Lier
60,Mechelsesteenweg 365,2019-07-09,18:00:00,134,94,40,FMN GV 05 Lier
60,Mechelsesteenweg 365,2019-07-09,19:00:00,170,114,56,FMN GV 05 Lier
60,Mechelsesteenweg 365,2019-07-09,20:00:00,122,60,62,FMN GV 05 Lier
60,Mechelsesteenweg 365,2019-07-09,21:00:00,64,14,50,FMN GV 05 Lier
60,Mechelsesteenweg 365,2019-07-09,22:00:00,22,14,8,FMN GV 05 Lier
60,Mechelsesteenweg 365,2019-07-09,23:00:00,0,0,0,FMN GV 05 Lier
60,Mechelsesteenweg 365,2019-07-10,00:00:00,2,0,2,FMN GV 05 Lier
60,Mechelsesteenweg 365,2019-07-10,01:00:00,2,2,0,FMN GV 05 Lier
60,Mechelsesteenweg 365,2019-07-10,02:00:00,0,0,0,FMN GV 05 Lier
60,Mechelsesteenweg 365,2019-07-10,03:00:00,4,0,4,FMN GV 05 Lier
60,Mechelsesteenweg 365,2019-07-10,04:00:00,2,0,2,FMN GV 05 Lier
60,Mechelsesteenweg 365,2019-07-10,05:00:00,8,2,6,FMN GV 05 Lier
60,Mechelsesteenweg 365,2019-07-10,06:00:00,16,6,10,FMN GV 05 Lier
60,Mechelsesteenweg 365,2019-07-10,07:00:00,74,22,52,FMN GV 05 Lier
60,Mechelsesteenweg 365,2019-07-10,08:00:00,54,20,34,FMN GV 05 Lier
60,Mechelsesteenweg 365,2019-07-10,09:00:00,114,76,38,FMN GV 05 Lier
60,Mechelsesteenweg 365,2019-07-10,10:00:00,162,82,80,FMN GV 05 Lier
60,Mechelsesteenweg 365,2019-07-10,11:00:00,186,106,80,FMN GV 05 Lier
60,Mechelsesteenweg 365,2019-07-10,12:00:00,210,122,88,FMN GV 05 Lier
60,Mechelsesteenweg 365,2019-07-10,13:00:00,150,60,90,FMN GV 05 Lier
60,Mechelsesteenweg 365,2019-07-10,14:00:00,124,84,40,FMN GV 05 Lier
60,Mechelsesteenweg 365,2019-07-10,15:00:00,126,74,52,FMN GV 05 Lier
60,Mechelsesteenweg 365,2019-07-10,16:00:00,104,58,46,FMN GV 05 Lier
60,Mechelsesteenweg 365,2019-07-10,17:00:00,128,62,66,FMN GV 05 Lier
60,Mechelsesteenweg 365,2019-07-10,18:00:00,154,108,46,FMN GV 05 Lier
60,Mechelsesteenweg 365,2019-07-10,19:00:00,126,80,46,FMN GV 05 Lier
60,Mechelsesteenweg 365,2019-07-10,20:00:00,68,40,28,FMN GV 05 Lier
60,Mechelsesteenweg 365,2019-07-10,21:00:00,16,2,14,FMN GV 05 Lier
60,Mechelsesteenweg 365,2019-07-10,22:00:00,8,8,0,FMN GV 05 Lier
60,Mechelsesteenweg 365,2019-07-10,23:00:00,4,0,4,FMN GV 05 Lier
60,Mechelsesteenweg 365,2019-07-11,00:00:00,0,0,0,FMN GV 05 Lier
60,Mechelsesteenweg 365,2019-07-11,01:00:00,0,0,0,FMN GV 05 Lier
60,Mechelsesteenweg 365,2019-07-11,02:00:00,0,0,0,FMN GV 05 Lier
60,Mechelsesteenweg 365,2019-07-11,03:00:00,2,0,2,FMN GV 05 Lier
60,Mechelsesteenweg 365,2019-07-11,04:00:00,0,0,0,FMN GV 05 Lier
60,Mechelsesteenweg 365,2019-07-11,05:00:00,6,2,4,FMN GV 05 Lier
60,Mechelsesteenweg 365,2019-07-11,06:00:00,18,8,10,FMN GV 05 Lier
60,Mechelsesteenweg 365,2019-07-11,07:00:00,76,12,64,FMN GV 05 Lier
60,Mechelsesteenweg 365,2019-07-11,08:00:00,64,26,38,FMN GV 05 Lier
60,Mechelsesteenweg 365,2019-07-11,09:00:00,44,20,24,FMN GV 05 Lier
60,Mechelsesteenweg 365,2019-07-11,10:00:00,128,62,66,FMN GV 05 Lier
60,Mechelsesteenweg 365,2019-07-11,11:00:00,140,86,54,FMN GV 05 Lier
60,Mechelsesteenweg 365,2019-07-11,12:00:00,118,74,44,FMN GV 05 Lier
60,Mechelsesteenweg 365,2019-07-11,13:00:00,150,64,86,FMN GV 05 Lier
60,Mechelsesteenweg 365,2019-07-11,14:00:00,204,96,108,FMN GV 05 Lier
60,Mechelsesteenweg 365,2019-07-11,15:00:00,156,88,68,FMN GV 05 Lier
60,Mechelsesteenweg 365,2019-07-11,16:00:00,118,68,50,FMN GV 05 Lier
60,Mechelsesteenweg 365,2019-07-11,17:00:00,160,84,76,FMN GV 05 Lier
60,Mechelsesteenweg 365,2019-07-11,18:00:00,98,56,42,FMN GV 05 Lier
60,Mechelsesteenweg 365,2019-07-11,19:00:00,150,84,66,FMN GV 05 Lier
60,Mechelsesteenweg 365,2019-07-11,20:00:00,158,82,76,FMN GV 05 Lier
60,Mechelsesteenweg 365,2019-07-11,21:00:00,74,28,46,FMN GV 05 Lier
60,Mechelsesteenweg 365,2019-07-11,22:00:00,18,14,4,FMN GV 05 Lier
60,Mechelsesteenweg 365,2019-07-11,23:00:00,12,2,10,FMN GV 05 Lier
60,Mechelsesteenweg 365,2019-07-12,00:00:00,6,6,0,FMN GV 05 Lier
60,Mechelsesteenweg 365,2019-07-12,01:00:00,4,0,4,FMN GV 05 Lier
60,Mechelsesteenweg 365,2019-07-12,02:00:00,0,0,0,FMN GV 05 Lier
60,Mechelsesteenweg 365,2019-07-12,03:00:00,4,0,4,FMN GV 05 Lier
60,Mechelsesteenweg 365,2019-07-12,04:00:00,4,0,4,FMN GV 05 Lier
60,Mechelsesteenweg 365,2019-07-12,05:00:00,8,4,4,FMN GV 05 Lier
60,Mechelsesteenweg 365,2019-07-12,06:00:00,12,6,6,FMN GV 05 Lier
60,Mechelsesteenweg 365,2019-07-12,07:00:00,66,22,44,FMN GV 05 Lier
60,Mechelsesteenweg 365,2019-07-12,08:00:00,52,18,34,FMN GV 05 Lier
60,Mechelsesteenweg 365,2019-07-12,09:00:00,60,26,34,FMN GV 05 Lier
60,Mechelsesteenweg 365,2019-07-12,10:00:00,106,48,58,FMN GV 05 Lier
60,Mechelsesteenweg 365,2019-07-12,11:00:00,82,36,46,FMN GV 05 Lier
60,Mechelsesteenweg 365,2019-07-12,12:00:00,22,10,12,FMN GV 05 Lier
60,Mechelsesteenweg 365,2019-07-12,13:00:00,20,10,10,FMN GV 05 Lier
60,Mechelsesteenweg 365,2019-07-12,14:00:00,68,20,48,FMN GV 05 Lier
60,Mechelsesteenweg 365,2019-07-12,15:00:00,52,22,30,FMN GV 05 Lier
60,Mechelsesteenweg 365,2019-07-12,16:00:00,90,46,44,FMN GV 05 Lier
60,Mechelsesteenweg 365,2019-07-12,17:00:00,72,48,24,FMN GV 05 Lier
60,Mechelsesteenweg 365,2019-07-12,18:00:00,72,42,30,FMN GV 05 Lier
60,Mechelsesteenweg 365,2019-07-12,19:00:00,46,26,20,FMN GV 05 Lier
60,Mechelsesteenweg 365,2019-07-12,20:00:00,76,28,48,FMN GV 05 Lier
60,Mechelsesteenweg 365,2019-07-12,21:00:00,38,14,24,FMN GV 05 Lier
60,Mechelsesteenweg 365,2019-07-12,22:00:00,12,2,10,FMN GV 05 Lier
60,Mechelsesteenweg 365,2019-07-12,23:00:00,2,2,0,FMN GV 05 Lier
60,Mechelsesteenweg 365,2019-07-13,00:00:00,4,0,4,FMN GV 05 Lier
60,Mechelsesteenweg 365,2019-07-13,01:00:00,2,0,2,FMN GV 05 Lier
60,Mechelsesteenweg 365,2019-07-13,02:00:00,2,2,0,FMN GV 05 Lier
60,Mechelsesteenweg 365,2019-07-13,03:00:00,0,0,0,FMN GV 05 Lier
60,Mechelsesteenweg 365,2019-07-13,04:00:00,0,0,0,FMN GV 05 Lier
60,Mechelsesteenweg 365,2019-07-13,05:00:00,4,2,2,FMN GV 05 Lier
60,Mechelsesteenweg 365,2019-07-13,06:00:00,2,2,0,FMN GV 05 Lier
60,Mechelsesteenweg 365,2019-07-13,07:00:00,6,2,4,FMN GV 05 Lier
60,Mechelsesteenweg 365,2019-07-13,08:00:00,20,12,8,FMN GV 05 Lier
60,Mechelsesteenweg 365,2019-07-13,09:00:00,26,6,20,FMN GV 05 Lier
60,Mechelsesteenweg 365,2019-07-13,10:00:00,62,26,36,FMN GV 05 Lier
60,Mechelsesteenweg 365,2019-07-13,11:00:00,56,24,32,FMN GV 05 Lier
60,Mechelsesteenweg 365,2019-07-13,12:00:00,74,46,28,FMN GV 05 Lier
60,Mechelsesteenweg 365,2019-07-13,13:00:00,80,56,24,FMN GV 05 Lier
60,Mechelsesteenweg 365,2019-07-13,14:00:00,132,70,62,FMN GV 05 Lier
60,Mechelsesteenweg 365,2019-07-13,15:00:00,110,42,68,FMN GV 05 Lier
60,Mechelsesteenweg 365,2019-07-13,16:00:00,126,46,80,FMN GV 05 Lier
60,Mechelsesteenweg 365,2019-07-13,17:00:00,62,22,40,FMN GV 05 Lier
60,Mechelsesteenweg 365,2019-07-13,18:00:00,64,30,34,FMN GV 05 Lier
60,Mechelsesteenweg 365,2019-07-13,19:00:00,54,32,22,FMN GV 05 Lier
60,Mechelsesteenweg 365,2019-07-13,20:00:00,34,12,22,FMN GV 05 Lier
60,Mechelsesteenweg 365,2019-07-13,21:00:00,24,14,10,FMN GV 05 Lier
60,Mechelsesteenweg 365,2019-07-13,22:00:00,12,6,6,FMN GV 05 Lier
60,Mechelsesteenweg 365,2019-07-13,23:00:00,6,0,6,FMN GV 05 Lier
60,Mechelsesteenweg 365,2019-07-14,00:00:00,0,0,0,FMN GV 05 Lier
60,Mechelsesteenweg 365,2019-07-14,01:00:00,0,0,0,FMN GV 05 Lier
60,Mechelsesteenweg 365,2019-07-14,02:00:00,0,0,0,FMN GV 05 Lier
60,Mechelsesteenweg 365,2019-07-14,03:00:00,0,0,0,FMN GV 05 Lier
60,Mechelsesteenweg 365,2019-07-14,04:00:00,0,0,0,FMN GV 05 Lier
60,Mechelsesteenweg 365,2019-07-14,05:00:00,0,0,0,FMN GV 05 Lier
60,Mechelsesteenweg 365,2019-07-14,06:00:00,8,4,4,FMN GV 05 Lier
60,Mechelsesteenweg 365,2019-07-14,07:00:00,18,14,4,FMN GV 05 Lier
60,Mechelsesteenweg 365,2019-07-14,08:00:00,64,46,18,FMN GV 05 Lier
60,Mechelsesteenweg 365,2019-07-14,09:00:00,242,160,82,FMN GV 05 Lier
60,Mechelsesteenweg 365,2019-07-14,10:00:00,332,98,234,FMN GV 05 Lier
60,Mechelsesteenweg 365,2019-07-14,11:00:00,368,126,242,FMN GV 05 Lier
60,Mechelsesteenweg 365,2019-07-14,12:00:00,184,62,122,FMN GV 05 Lier
60,Mechelsesteenweg 365,2019-07-14,13:00:00,204,98,106,FMN GV 05 Lier
60,Mechelsesteenweg 365,2019-07-14,14:00:00,226,108,118,FMN GV 05 Lier
60,Mechelsesteenweg 365,2019-07-14,15:00:00,260,138,122,FMN GV 05 Lier
60,Mechelsesteenweg 365,2019-07-14,16:00:00,224,110,114,FMN GV 05 Lier
60,Mechelsesteenweg 365,2019-07-14,17:00:00,216,48,168,FMN GV 05 Lier
60,Mechelsesteenweg 365,2019-07-14,18:00:00,58,24,34,FMN GV 05 Lier
60,Mechelsesteenweg 365,2019-07-14,19:00:00,52,16,36,FMN GV 05 Lier
60,Mechelsesteenweg 365,2019-07-14,20:00:00,18,10,8,FMN GV 05 Lier
60,Mechelsesteenweg 365,2019-07-14,21:00:00,18,4,14,FMN GV 05 Lier
60,Mechelsesteenweg 365,2019-07-14,22:00:00,12,4,8,FMN GV 05 Lier
60,Mechelsesteenweg 365,2019-07-14,23:00:00,0,0,0,FMN GV 05 Lier
60,Mechelsesteenweg 365,2019-07-15,00:00:00,0,0,0,FMN GV 05 Lier
60,Mechelsesteenweg 365,2019-07-15,01:00:00,0,0,0,FMN GV 05 Lier
60,Mechelsesteenweg 365,2019-07-15,02:00:00,0,0,0,FMN GV 05 Lier
60,Mechelsesteenweg 365,2019-07-15,03:00:00,2,0,2,FMN GV 05 Lier
60,Mechelsesteenweg 365,2019-07-15,04:00:00,2,0,2,FMN GV 05 Lier
60,Mechelsesteenweg 365,2019-07-15,05:00:00,8,2,6,FMN GV 05 Lier
60,Mechelsesteenweg 365,2019-07-15,06:00:00,18,0,18,FMN GV 05 Lier
60,Mechelsesteenweg 365,2019-07-15,07:00:00,88,38,50,FMN GV 05 Lier
60,Mechelsesteenweg 365,2019-07-15,08:00:00,72,32,40,FMN GV 05 Lier
60,Mechelsesteenweg 365,2019-07-15,09:00:00,54,30,24,FMN GV 05 Lier
60,Mechelsesteenweg 365,2019-07-15,10:00:00,72,28,44,FMN GV 05 Lier
60,Mechelsesteenweg 365,2019-07-15,11:00:00,64,32,32,FMN GV 05 Lier
60,Mechelsesteenweg 365,2019-07-15,12:00:00,88,54,34,FMN GV 05 Lier
60,Mechelsesteenweg 365,2019-07-15,13:00:00,82,40,42,FMN GV 05 Lier
60,Mechelsesteenweg 365,2019-07-15,14:00:00,124,74,50,FMN GV 05 Lier
60,Mechelsesteenweg 365,2019-07-15,15:00:00,174,74,100,FMN GV 05 Lier
60,Mechelsesteenweg 365,2019-07-15,16:00:00,154,58,96,FMN GV 05 Lier
60,Mechelsesteenweg 365,2019-07-15,17:00:00,142,86,56,FMN GV 05 Lier
60,Mechelsesteenweg 365,2019-07-15,18:00:00,86,42,44,FMN GV 05 Lier
60,Mechelsesteenweg 365,2019-07-15,19:00:00,58,26,32,FMN GV 05 Lier
60,Mechelsesteenweg 365,2019-07-15,20:00:00,70,24,46,FMN GV 05 Lier
60,Mechelsesteenweg 365,2019-07-15,21:00:00,18,0,18,FMN GV 05 Lier
60,Mechelsesteenweg 365,2019-07-15,22:00:00,8,2,6,FMN GV 05 Lier
60,Mechelsesteenweg 365,2019-07-15,23:00:00,0,0,0,FMN GV 05 Lier
60,Mechelsesteenweg 365,2019-07-16,00:00:00,6,2,4,FMN GV 05 Lier
60,Mechelsesteenweg 365,2019-07-16,01:00:00,0,0,0,FMN GV 05 Lier
60,Mechelsesteenweg 365,2019-07-16,02:00:00,0,0,0,FMN GV 05 Lier
60,Mechelsesteenweg 365,2019-07-16,03:00:00,2,0,2,FMN GV 05 Lier
60,Mechelsesteenweg 365,2019-07-16,04:00:00,4,0,4,FMN GV 05 Lier
60,Mechelsesteenweg 365,2019-07-16,05:00:00,12,2,10,FMN GV 05 Lier
60,Mechelsesteenweg 365,2019-07-16,06:00:00,24,6,18,FMN GV 05 Lier
60,Mechelsesteenweg 365,2019-07-16,07:00:00,102,40,62,FMN GV 05 Lier
60,Mechelsesteenweg 365,2019-07-16,08:00:00,88,36,52,FMN GV 05 Lier
60,Mechelsesteenweg 365,2019-07-16,09:00:00,60,24,36,FMN GV 05 Lier
60,Mechelsesteenweg 365,2019-07-16,10:00:00,212,94,118,FMN GV 05 Lier
60,Mechelsesteenweg 365,2019-07-16,11:00:00,154,86,68,FMN GV 05 Lier
60,Mechelsesteenweg 365,2019-07-16,12:00:00,106,62,44,FMN GV 05 Lier
60,Mechelsesteenweg 365,2019-07-16,13:00:00,186,84,102,FMN GV 05 Lier
60,Mechelsesteenweg 365,2019-07-16,14:00:00,290,158,132,FMN GV 05 Lier
60,Mechelsesteenweg 365,2019-07-16,15:00:00,206,104,102,FMN GV 05 Lier
60,Mechelsesteenweg 365,2019-07-16,16:00:00,196,88,108,FMN GV 05 Lier
60,Mechelsesteenweg 365,2019-07-16,17:00:00,150,84,66,FMN GV 05 Lier
60,Mechelsesteenweg 365,2019-07-16,18:00:00,156,72,84,FMN GV 05 Lier
60,Mechelsesteenweg 365,2019-07-16,19:00:00,124,78,46,FMN GV 05 Lier
60,Mechelsesteenweg 365,2019-07-16,20:00:00,172,70,102,FMN GV 05 Lier
60,Mechelsesteenweg 365,2019-07-16,21:00:00,54,16,38,FMN GV 05 Lier
60,Mechelsesteenweg 365,2019-07-16,22:00:00,12,0,12,FMN GV 05 Lier
60,Mechelsesteenweg 365,2019-07-16,23:00:00,12,0,12,FMN GV 05 Lier
60,Mechelsesteenweg 365,2019-07-17,00:00:00,8,2,6,FMN GV 05 Lier
60,Mechelsesteenweg 365,2019-07-17,01:00:00,4,4,0,FMN GV 05 Lier
60,Mechelsesteenweg 365,2019-07-17,02:00:00,4,2,2,FMN GV 05 Lier
60,Mechelsesteenweg 365,2019-07-17,03:00:00,2,0,2,FMN GV 05 Lier
60,Mechelsesteenweg 365,2019-07-17,04:00:00,6,0,6,FMN GV 05 Lier
60,Mechelsesteenweg 365,2019-07-17,05:00:00,12,2,10,FMN GV 05 Lier
60,Mechelsesteenweg 365,2019-07-17,06:00:00,30,6,24,FMN GV 05 Lier
60,Mechelsesteenweg 365,2019-07-17,07:00:00,80,34,46,FMN GV 05 Lier
60,Mechelsesteenweg 365,2019-07-17,08:00:00,76,22,54,FMN GV 05 Lier
60,Mechelsesteenweg 365,2019-07-17,09:00:00,104,72,32,FMN GV 05 Lier
60,Mechelsesteenweg 365,2019-07-17,10:00:00,194,86,108,FMN GV 05 Lier
60,Mechelsesteenweg 365,2019-07-17,11:00:00,208,88,120,FMN GV 05 Lier
60,Mechelsesteenweg 365,2019-07-17,12:00:00,186,68,118,FMN GV 05 Lier
60,Mechelsesteenweg 365,2019-07-17,13:00:00,282,144,138,FMN GV 05 Lier
60,Mechelsesteenweg 365,2019-07-17,14:00:00,412,194,218,FMN GV 05 Lier
60,Mechelsesteenweg 365,2019-07-17,15:00:00,402,166,236,FMN GV 05 Lier
60,Mechelsesteenweg 365,2019-07-17,16:00:00,302,152,150,FMN GV 05 Lier
60,Mechelsesteenweg 365,2019-07-17,17:00:00,208,106,102,FMN GV 05 Lier
60,Mechelsesteenweg 365,2019-07-17,18:00:00,176,82,94,FMN GV 05 Lier
60,Mechelsesteenweg 365,2019-07-17,19:00:00,248,140,108,FMN GV 05 Lier
60,Mechelsesteenweg 365,2019-07-17,20:00:00,314,216,98,FMN GV 05 Lier
60,Mechelsesteenweg 365,2019-07-17,21:00:00,54,24,30,FMN GV 05 Lier
60,Mechelsesteenweg 365,2019-07-17,22:00:00,10,8,2,FMN GV 05 Lier
60,Mechelsesteenweg 365,2019-07-17,23:00:00,16,12,4,FMN GV 05 Lier
60,Mechelsesteenweg 365,2019-07-18,00:00:00,0,0,0,FMN GV 05 Lier
60,Mechelsesteenweg 365,2019-07-18,01:00:00,0,0,0,FMN GV 05 Lier
60,Mechelsesteenweg 365,2019-07-18,02:00:00,0,0,0,FMN GV 05 Lier
60,Mechelsesteenweg 365,2019-07-18,03:00:00,4,0,4,FMN GV 05 Lier
60,Mechelsesteenweg 365,2019-07-18,04:00:00,4,0,4,FMN GV 05 Lier
60,Mechelsesteenweg 365,2019-07-18,05:00:00,10,2,8,FMN GV 05 Lier
60,Mechelsesteenweg 365,2019-07-18,06:00:00,28,6,22,FMN GV 05 Lier
60,Mechelsesteenweg 365,2019-07-18,07:00:00,68,32,36,FMN GV 05 Lier
60,Mechelsesteenweg 365,2019-07-18,08:00:00,92,24,68,FMN GV 05 Lier
60,Mechelsesteenweg 365,2019-07-18,09:00:00,96,38,58,FMN GV 05 Lier
60,Mechelsesteenweg 365,2019-07-18,10:00:00,116,66,50,FMN GV 05 Lier
60,Mechelsesteenweg 365,2019-07-18,11:00:00,172,116,56,FMN GV 05 Lier
60,Mechelsesteenweg 365,2019-07-18,12:00:00,118,56,62,FMN GV 05 Lier
60,Mechelsesteenweg 365,2019-07-18,13:00:00,148,60,88,FMN GV 05 Lier
60,Mechelsesteenweg 365,2019-07-18,14:00:00,160,86,74,FMN GV 05 Lier
60,Mechelsesteenweg 365,2019-07-18,15:00:00,126,72,54,FMN GV 05 Lier
60,Mechelsesteenweg 365,2019-07-18,16:00:00,130,56,74,FMN GV 05 Lier
60,Mechelsesteenweg 365,2019-07-18,17:00:00,136,82,54,FMN GV 05 Lier
60,Mechelsesteenweg 365,2019-07-18,18:00:00,78,48,30,FMN GV 05 Lier
60,Mechelsesteenweg 365,2019-07-18,19:00:00,104,56,48,FMN GV 05 Lier
60,Mechelsesteenweg 365,2019-07-18,20:00:00,94,38,56,FMN GV 05 Lier
60,Mechelsesteenweg 365,2019-07-18,21:00:00,30,10,20,FMN GV 05 Lier
60,Mechelsesteenweg 365,2019-07-18,22:00:00,14,4,10,FMN GV 05 Lier
60,Mechelsesteenweg 365,2019-07-18,23:00:00,2,0,2,FMN GV 05 Lier
60,Mechelsesteenweg 365,2019-07-19,00:00:00,0,0,0,FMN GV 05 Lier
60,Mechelsesteenweg 365,2019-07-19,01:00:00,4,0,4,FMN GV 05 Lier
60,Mechelsesteenweg 365,2019-07-19,02:00:00,0,0,0,FMN GV 05 Lier
60,Mechelsesteenweg 365,2019-07-19,03:00:00,4,0,4,FMN GV 05 Lier
60,Mechelsesteenweg 365,2019-07-19,04:00:00,2,0,2,FMN GV 05 Lier
60,Mechelsesteenweg 365,2019-07-19,05:00:00,8,0,8,FMN GV 05 Lier
60,Mechelsesteenweg 365,2019-07-19,06:00:00,20,4,16,FMN GV 05 Lier
60,Mechelsesteenweg 365,2019-07-19,07:00:00,88,32,56,FMN GV 05 Lier
60,Mechelsesteenweg 365,2019-07-19,08:00:00,70,28,42,FMN GV 05 Lier
60,Mechelsesteenweg 365,2019-07-19,09:00:00,94,52,42,FMN GV 05 Lier
60,Mechelsesteenweg 365,2019-07-19,10:00:00,220,118,102,FMN GV 05 Lier
60,Mechelsesteenweg 365,2019-07-19,11:00:00,144,64,80,FMN GV 05 Lier
60,Mechelsesteenweg 365,2019-07-19,12:00:00,212,132,80,FMN GV 05 Lier
60,Mechelsesteenweg 365,2019-07-19,13:00:00,336,222,114,FMN GV 05 Lier
60,Mechelsesteenweg 365,2019-07-19,14:00:00,250,136,114,FMN GV 05 Lier
60,Mechelsesteenweg 365,2019-07-19,15:00:00,256,118,138,FMN GV 05 Lier
60,Mechelsesteenweg 365,2019-07-19,16:00:00,270,134,136,FMN GV 05 Lier
60,Mechelsesteenweg 365,2019-07-19,17:00:00,210,126,84,FMN GV 05 Lier
60,Mechelsesteenweg 365,2019-07-19,18:00:00,134,54,80,FMN GV 05 Lier
60,Mechelsesteenweg 365,2019-07-19,19:00:00,92,64,28,FMN GV 05 Lier
60,Mechelsesteenweg 365,2019-07-19,20:00:00,80,26,54,FMN GV 05 Lier
60,Mechelsesteenweg 365,2019-07-19,21:00:00,34,12,22,FMN GV 05 Lier
60,Mechelsesteenweg 365,2019-07-19,22:00:00,26,6,20,FMN GV 05 Lier
60,Mechelsesteenweg 365,2019-07-19,23:00:00,10,4,6,FMN GV 05 Lier
60,Mechelsesteenweg 365,2019-07-20,00:00:00,0,0,0,FMN GV 05 Lier
60,Mechelsesteenweg 365,2019-07-20,01:00:00,0,0,0,FMN GV 05 Lier
60,Mechelsesteenweg 365,2019-07-20,02:00:00,0,0,0,FMN GV 05 Lier
60,Mechelsesteenweg 365,2019-07-20,03:00:00,0,0,0,FMN GV 05 Lier
60,Mechelsesteenweg 365,2019-07-20,04:00:00,0,0,0,FMN GV 05 Lier
60,Mechelsesteenweg 365,2019-07-20,05:00:00,10,4,6,FMN GV 05 Lier
60,Mechelsesteenweg 365,2019-07-20,06:00:00,8,4,4,FMN GV 05 Lier
60,Mechelsesteenweg 365,2019-07-20,07:00:00,10,6,4,FMN GV 05 Lier
60,Mechelsesteenweg 365,2019-07-20,08:00:00,16,2,14,FMN GV 05 Lier
60,Mechelsesteenweg 365,2019-07-20,09:00:00,160,110,50,FMN GV 05 Lier
60,Mechelsesteenweg 365,2019-07-20,10:00:00,132,86,46,FMN GV 05 Lier
60,Mechelsesteenweg 365,2019-07-20,11:00:00,160,122,38,FMN GV 05 Lier
60,Mechelsesteenweg 365,2019-07-20,12:00:00,146,84,62,FMN GV 05 Lier
60,Mechelsesteenweg 365,2019-07-20,13:00:00,182,114,68,FMN GV 05 Lier
60,Mechelsesteenweg 365,2019-07-20,14:00:00,118,58,60,FMN GV 05 Lier
60,Mechelsesteenweg 365,2019-07-20,15:00:00,58,34,24,FMN GV 05 Lier
60,Mechelsesteenweg 365,2019-07-20,16:00:00,94,54,40,FMN GV 05 Lier
60,Mechelsesteenweg 365,2019-07-20,17:00:00,62,22,40,FMN GV 05 Lier
60,Mechelsesteenweg 365,2019-07-20,18:00:00,66,36,30,FMN GV 05 Lier
60,Mechelsesteenweg 365,2019-07-20,19:00:00,54,24,30,FMN GV 05 Lier
60,Mechelsesteenweg 365,2019-07-20,20:00:00,26,12,14,FMN GV 05 Lier
60,Mechelsesteenweg 365,2019-07-20,21:00:00,18,6,12,FMN GV 05 Lier
60,Mechelsesteenweg 365,2019-07-20,22:00:00,14,10,4,FMN GV 05 Lier
60,Mechelsesteenweg 365,2019-07-20,23:00:00,2,2,0,FMN GV 05 Lier
60,Mechelsesteenweg 365,2019-07-21,00:00:00,0,0,0,FMN GV 05 Lier
60,Mechelsesteenweg 365,2019-07-21,01:00:00,4,4,0,FMN GV 05 Lier
60,Mechelsesteenweg 365,2019-07-21,02:00:00,16,16,0,FMN GV 05 Lier
60,Mechelsesteenweg 365,2019-07-21,03:00:00,8,6,2,FMN GV 05 Lier
60,Mechelsesteenweg 365,2019-07-21,04:00:00,6,2,4,FMN GV 05 Lier
60,Mechelsesteenweg 365,2019-07-21,05:00:00,4,2,2,FMN GV 05 Lier
60,Mechelsesteenweg 365,2019-07-21,06:00:00,6,2,4,FMN GV 05 Lier
60,Mechelsesteenweg 365,2019-07-21,07:00:00,38,22,16,FMN GV 05 Lier
60,Mechelsesteenweg 365,2019-07-21,08:00:00,62,26,36,FMN GV 05 Lier
60,Mechelsesteenweg 365,2019-07-21,09:00:00,266,164,102,FMN GV 05 Lier
60,Mechelsesteenweg 365,2019-07-21,10:00:00,518,288,230,FMN GV 05 Lier
60,Mechelsesteenweg 365,2019-07-21,11:00:00,452,248,204,FMN GV 05 Lier
60,Mechelsesteenweg 365,2019-07-21,12:00:00,356,180,176,FMN GV 05 Lier
60,Mechelsesteenweg 365,2019-07-21,13:00:00,400,206,194,FMN GV 05 Lier
60,Mechelsesteenweg 365,2019-07-21,14:00:00,454,262,192,FMN GV 05 Lier
60,Mechelsesteenweg 365,2019-07-21,15:00:00,452,188,264,FMN GV 05 Lier
60,Mechelsesteenweg 365,2019-07-21,16:00:00,368,138,230,FMN GV 05 Lier
60,Mechelsesteenweg 365,2019-07-21,17:00:00,250,76,174,FMN GV 05 Lier
60,Mechelsesteenweg 365,2019-07-21,18:00:00,168,52,116,FMN GV 05 Lier
60,Mechelsesteenweg 365,2019-07-21,19:00:00,88,28,60,FMN GV 05 Lier
60,Mechelsesteenweg 365,2019-07-21,20:00:00,100,36,64,FMN GV 05 Lier
60,Mechelsesteenweg 365,2019-07-21,21:00:00,44,14,30,FMN GV 05 Lier
60,Mechelsesteenweg 365,2019-07-21,22:00:00,10,4,6,FMN GV 05 Lier
60,Mechelsesteenweg 365,2019-07-21,23:00:00,6,2,4,FMN GV 05 Lier
60,Mechelsesteenweg 365,2019-07-22,00:00:00,0,0,0,FMN GV 05 Lier
60,Mechelsesteenweg 365,2019-07-22,01:00:00,0,0,0,FMN GV 05 Lier
60,Mechelsesteenweg 365,2019-07-22,02:00:00,8,6,2,FMN GV 05 Lier
60,Mechelsesteenweg 365,2019-07-22,03:00:00,6,4,2,FMN GV 05 Lier
60,Mechelsesteenweg 365,2019-07-22,04:00:00,4,0,4,FMN GV 05 Lier
60,Mechelsesteenweg 365,2019-07-22,05:00:00,8,4,4,FMN GV 05 Lier
60,Mechelsesteenweg 365,2019-07-22,06:00:00,18,4,14,FMN GV 05 Lier
60,Mechelsesteenweg 365,2019-07-22,07:00:00,104,32,72,FMN GV 05 Lier
60,Mechelsesteenweg 365,2019-07-22,08:00:00,82,30,52,FMN GV 05 Lier
60,Mechelsesteenweg 365,2019-07-22,09:00:00,106,52,54,FMN GV 05 Lier
60,Mechelsesteenweg 365,2019-07-22,10:00:00,208,96,112,FMN GV 05 Lier
60,Mechelsesteenweg 365,2019-07-22,11:00:00,186,102,84,FMN GV 05 Lier
60,Mechelsesteenweg 365,2019-07-22,12:00:00,176,92,84,FMN GV 05 Lier
60,Mechelsesteenweg 365,2019-07-22,13:00:00,206,100,106,FMN GV 05 Lier
60,Mechelsesteenweg 365,2019-07-22,14:00:00,262,142,120,FMN GV 05 Lier
60,Mechelsesteenweg 365,2019-07-22,15:00:00,252,126,126,FMN GV 05 Lier
60,Mechelsesteenweg 365,2019-07-22,16:00:00,242,114,128,FMN GV 05 Lier
60,Mechelsesteenweg 365,2019-07-22,17:00:00,222,150,72,FMN GV 05 Lier
60,Mechelsesteenweg 365,2019-07-22,18:00:00,116,50,66,FMN GV 05 Lier
60,Mechelsesteenweg 365,2019-07-22,19:00:00,144,72,72,FMN GV 05 Lier
60,Mechelsesteenweg 365,2019-07-22,20:00:00,154,46,108,FMN GV 05 Lier
60,Mechelsesteenweg 365,2019-07-22,21:00:00,88,24,64,FMN GV 05 Lier
60,Mechelsesteenweg 365,2019-07-22,22:00:00,14,8,6,FMN GV 05 Lier
60,Mechelsesteenweg 365,2019-07-22,23:00:00,0,0,0,FMN GV 05 Lier
60,Mechelsesteenweg 365,2019-07-23,00:00:00,0,0,0,FMN GV 05 Lier
60,Mechelsesteenweg 365,2019-07-23,01:00:00,0,0,0,FMN GV 05 Lier
60,Mechelsesteenweg 365,2019-07-23,02:00:00,0,0,0,FMN GV 05 Lier
60,Mechelsesteenweg 365,2019-07-23,03:00:00,4,0,4,FMN GV 05 Lier
60,Mechelsesteenweg 365,2019-07-23,04:00:00,2,0,2,FMN GV 05 Lier
60,Mechelsesteenweg 365,2019-07-23,05:00:00,10,4,6,FMN GV 05 Lier
60,Mechelsesteenweg 365,2019-07-23,06:00:00,46,6,40,FMN GV 05 Lier
60,Mechelsesteenweg 365,2019-07-23,07:00:00,118,40,78,FMN GV 05 Lier
60,Mechelsesteenweg 365,2019-07-23,08:00:00,122,62,60,FMN GV 05 Lier
60,Mechelsesteenweg 365,2019-07-23,09:00:00,198,96,102,FMN GV 05 Lier
60,Mechelsesteenweg 365,2019-07-23,10:00:00,194,90,104,FMN GV 05 Lier
60,Mechelsesteenweg 365,2019-07-23,11:00:00,198,98,100,FMN GV 05 Lier
60,Mechelsesteenweg 365,2019-07-23,12:00:00,138,74,64,FMN GV 05 Lier
60,Mechelsesteenweg 365,2019-07-23,13:00:00,120,46,74,FMN GV 05 Lier
60,Mechelsesteenweg 365,2019-07-23,14:00:00,140,62,78,FMN GV 05 Lier
60,Mechelsesteenweg 365,2019-07-23,15:00:00,122,72,50,FMN GV 05 Lier
60,Mechelsesteenweg 365,2019-07-23,16:00:00,108,50,58,FMN GV 05 Lier
60,Mechelsesteenweg 365,2019-07-23,17:00:00,124,66,58,FMN GV 05 Lier
60,Mechelsesteenweg 365,2019-07-23,18:00:00,84,52,32,FMN GV 05 Lier
60,Mechelsesteenweg 365,2019-07-23,19:00:00,132,88,44,FMN GV 05 Lier
60,Mechelsesteenweg 365,2019-07-23,20:00:00,108,42,66,FMN GV 05 Lier
60,Mechelsesteenweg 365,2019-07-23,21:00:00,60,30,30,FMN GV 05 Lier
60,Mechelsesteenweg 365,2019-07-23,22:00:00,26,10,16,FMN GV 05 Lier
60,Mechelsesteenweg 365,2019-07-23,23:00:00,2,2,0,FMN GV 05 Lier
60,Mechelsesteenweg 365,2019-07-24,00:00:00,0,0,0,FMN GV 05 Lier
60,Mechelsesteenweg 365,2019-07-24,01:00:00,0,0,0,FMN GV 05 Lier
60,Mechelsesteenweg 365,2019-07-24,02:00:00,4,4,0,FMN GV 05 Lier
60,Mechelsesteenweg 365,2019-07-24,03:00:00,4,0,4,FMN GV 05 Lier
60,Mechelsesteenweg 365,2019-07-24,04:00:00,4,2,2,FMN GV 05 Lier
60,Mechelsesteenweg 365,2019-07-24,05:00:00,4,2,2,FMN GV 05 Lier
60,Mechelsesteenweg 365,2019-07-24,06:00:00,28,10,18,FMN GV 05 Lier
60,Mechelsesteenweg 365,2019-07-24,07:00:00,146,66,80,FMN GV 05 Lier
60,Mechelsesteenweg 365,2019-07-24,08:00:00,154,78,76,FMN GV 05 Lier
60,Mechelsesteenweg 365,2019-07-24,09:00:00,122,62,60,FMN GV 05 Lier
60,Mechelsesteenweg 365,2019-07-24,10:00:00,142,52,90,FMN GV 05 Lier
60,Mechelsesteenweg 365,2019-07-24,11:00:00,66,42,24,FMN GV 05 Lier
60,Mechelsesteenweg 365,2019-07-24,12:00:00,42,14,28,FMN GV 05 Lier
60,Mechelsesteenweg 365,2019-07-24,13:00:00,56,26,30,FMN GV 05 Lier
60,Mechelsesteenweg 365,2019-07-24,14:00:00,70,34,36,FMN GV 05 Lier
60,Mechelsesteenweg 365,2019-07-24,15:00:00,44,28,16,FMN GV 05 Lier
60,Mechelsesteenweg 365,2019-07-24,16:00:00,62,34,28,FMN GV 05 Lier
60,Mechelsesteenweg 365,2019-07-24,17:00:00,64,38,26,FMN GV 05 Lier
60,Mechelsesteenweg 365,2019-07-24,18:00:00,80,32,48,FMN GV 05 Lier
60,Mechelsesteenweg 365,2019-07-24,19:00:00,80,58,22,FMN GV 05 Lier
60,Mechelsesteenweg 365,2019-07-24,20:00:00,154,100,54,FMN GV 05 Lier
60,Mechelsesteenweg 365,2019-07-24,21:00:00,92,34,58,FMN GV 05 Lier
60,Mechelsesteenweg 365,2019-07-24,22:00:00,38,18,20,FMN GV 05 Lier
60,Mechelsesteenweg 365,2019-07-24,23:00:00,8,0,8,FMN GV 05 Lier
60,Mechelsesteenweg 365,2019-07-25,00:00:00,4,2,2,FMN GV 05 Lier
60,Mechelsesteenweg 365,2019-07-25,01:00:00,0,0,0,FMN GV 05 Lier
60,Mechelsesteenweg 365,2019-07-25,02:00:00,0,0,0,FMN GV 05 Lier
60,Mechelsesteenweg 365,2019-07-25,03:00:00,2,0,2,FMN GV 05 Lier
60,Mechelsesteenweg 365,2019-07-25,04:00:00,2,0,2,FMN GV 05 Lier
60,Mechelsesteenweg 365,2019-07-25,05:00:00,6,4,2,FMN GV 05 Lier
60,Mechelsesteenweg 365,2019-07-25,06:00:00,30,14,16,FMN GV 05 Lier
60,Mechelsesteenweg 365,2019-07-25,07:00:00,84,32,52,FMN GV 05 Lier
60,Mechelsesteenweg 365,2019-07-25,08:00:00,108,42,66,FMN GV 05 Lier
60,Mechelsesteenweg 365,2019-07-25,09:00:00,112,68,44,FMN GV 05 Lier
60,Mechelsesteenweg 365,2019-07-25,10:00:00,86,52,34,FMN GV 05 Lier
60,Mechelsesteenweg 365,2019-07-25,11:00:00,50,18,32,FMN GV 05 Lier
60,Mechelsesteenweg 365,2019-07-25,12:00:00,42,12,30,FMN GV 05 Lier
60,Mechelsesteenweg 365,2019-07-25,13:00:00,30,14,16,FMN GV 05 Lier
60,Mechelsesteenweg 365,2019-07-25,14:00:00,38,22,16,FMN GV 05 Lier
60,Mechelsesteenweg 365,2019-07-25,15:00:00,32,20,12,FMN GV 05 Lier
60,Mechelsesteenweg 365,2019-07-25,16:00:00,42,22,20,FMN GV 05 Lier
60,Mechelsesteenweg 365,2019-07-25,17:00:00,48,32,16,FMN GV 05 Lier
60,Mechelsesteenweg 365,2019-07-25,18:00:00,54,42,12,FMN GV 05 Lier
60,Mechelsesteenweg 365,2019-07-25,19:00:00,14,0,14,FMN GV 05 Lier
60,Mechelsesteenweg 365,2019-07-25,20:00:00,40,20,20,FMN GV 05 Lier
60,Mechelsesteenweg 365,2019-07-25,21:00:00,32,6,26,FMN GV 05 Lier
60,Mechelsesteenweg 365,2019-07-25,22:00:00,16,8,8,FMN GV 05 Lier
60,Mechelsesteenweg 365,2019-07-25,23:00:00,10,2,8,FMN GV 05 Lier
60,Mechelsesteenweg 365,2019-07-26,00:00:00,2,0,2,FMN GV 05 Lier
60,Mechelsesteenweg 365,2019-07-26,01:00:00,4,0,4,FMN GV 05 Lier
60,Mechelsesteenweg 365,2019-07-26,02:00:00,0,0,0,FMN GV 05 Lier
60,Mechelsesteenweg 365,2019-07-26,03:00:00,2,0,2,FMN GV 05 Lier
60,Mechelsesteenweg 365,2019-07-26,04:00:00,2,0,2,FMN GV 05 Lier
60,Mechelsesteenweg 365,2019-07-26,05:00:00,4,2,2,FMN GV 05 Lier
60,Mechelsesteenweg 365,2019-07-26,06:00:00,30,10,20,FMN GV 05 Lier
60,Mechelsesteenweg 365,2019-07-26,07:00:00,82,46,36,FMN GV 05 Lier
60,Mechelsesteenweg 365,2019-07-26,08:00:00,100,42,58,FMN GV 05 Lier
60,Mechelsesteenweg 365,2019-07-26,09:00:00,98,52,46,FMN GV 05 Lier
60,Mechelsesteenweg 365,2019-07-26,10:00:00,100,42,58,FMN GV 05 Lier
60,Mechelsesteenweg 365,2019-07-26,11:00:00,66,34,32,FMN GV 05 Lier
60,Mechelsesteenweg 365,2019-07-26,12:00:00,50,36,14,FMN GV 05 Lier
60,Mechelsesteenweg 365,2019-07-26,13:00:00,58,36,22,FMN GV 05 Lier
60,Mechelsesteenweg 365,2019-07-26,14:00:00,84,50,34,FMN GV 05 Lier
60,Mechelsesteenweg 365,2019-07-26,15:00:00,56,12,44,FMN GV 05 Lier
60,Mechelsesteenweg 365,2019-07-26,16:00:00,54,28,26,FMN GV 05 Lier
60,Mechelsesteenweg 365,2019-07-26,17:00:00,68,36,32,FMN GV 05 Lier
60,Mechelsesteenweg 365,2019-07-26,18:00:00,40,24,16,FMN GV 05 Lier
60,Mechelsesteenweg 365,2019-07-26,19:00:00,34,14,20,FMN GV 05 Lier
60,Mechelsesteenweg 365,2019-07-26,20:00:00,40,30,10,FMN GV 05 Lier
60,Mechelsesteenweg 365,2019-07-26,21:00:00,24,8,16,FMN GV 05 Lier
60,Mechelsesteenweg 365,2019-07-26,22:00:00,8,6,2,FMN GV 05 Lier
60,Mechelsesteenweg 365,2019-07-26,23:00:00,2,2,0,FMN GV 05 Lier
60,Mechelsesteenweg 365,2019-07-27,00:00:00,2,0,2,FMN GV 05 Lier
60,Mechelsesteenweg 365,2019-07-27,01:00:00,2,2,0,FMN GV 05 Lier
60,Mechelsesteenweg 365,2019-07-27,02:00:00,4,4,0,FMN GV 05 Lier
60,Mechelsesteenweg 365,2019-07-27,03:00:00,0,0,0,FMN GV 05 Lier
60,Mechelsesteenweg 365,2019-07-27,04:00:00,2,0,2,FMN GV 05 Lier
60,Mechelsesteenweg 365,2019-07-27,05:00:00,2,2,0,FMN GV 05 Lier
60,Mechelsesteenweg 365,2019-07-27,06:00:00,4,4,0,FMN GV 05 Lier
60,Mechelsesteenweg 365,2019-07-27,07:00:00,2,0,2,FMN GV 05 Lier
60,Mechelsesteenweg 365,2019-07-27,08:00:00,22,10,12,FMN GV 05 Lier
60,Mechelsesteenweg 365,2019-07-27,09:00:00,62,40,22,FMN GV 05 Lier
60,Mechelsesteenweg 365,2019-07-27,10:00:00,162,108,54,FMN GV 05 Lier
60,Mechelsesteenweg 365,2019-07-27,11:00:00,120,60,60,FMN GV 05 Lier
60,Mechelsesteenweg 365,2019-07-27,12:00:00,84,58,26,FMN GV 05 Lier
60,Mechelsesteenweg 365,2019-07-27,13:00:00,18,2,16,FMN GV 05 Lier
60,Mechelsesteenweg 365,2019-07-27,14:00:00,20,12,8,FMN GV 05 Lier
60,Mechelsesteenweg 365,2019-07-27,15:00:00,16,10,6,FMN GV 05 Lier
60,Mechelsesteenweg 365,2019-07-27,16:00:00,44,38,6,FMN GV 05 Lier
60,Mechelsesteenweg 365,2019-07-27,17:00:00,38,20,18,FMN GV 05 Lier
60,Mechelsesteenweg 365,2019-07-27,18:00:00,14,8,6,FMN GV 05 Lier
60,Mechelsesteenweg 365,2019-07-27,19:00:00,12,2,10,FMN GV 05 Lier
60,Mechelsesteenweg 365,2019-07-27,20:00:00,4,2,2,FMN GV 05 Lier
60,Mechelsesteenweg 365,2019-07-27,21:00:00,2,2,0,FMN GV 05 Lier
60,Mechelsesteenweg 365,2019-07-27,22:00:00,0,0,0,FMN GV 05 Lier
60,Mechelsesteenweg 365,2019-07-27,23:00:00,0,0,0,FMN GV 05 Lier
60,Mechelsesteenweg 365,2019-07-28,00:00:00,0,0,0,FMN GV 05 Lier
60,Mechelsesteenweg 365,2019-07-28,01:00:00,4,4,0,FMN GV 05 Lier
60,Mechelsesteenweg 365,2019-07-28,02:00:00,0,0,0,FMN GV 05 Lier
60,Mechelsesteenweg 365,2019-07-28,03:00:00,0,0,0,FMN GV 05 Lier
60,Mechelsesteenweg 365,2019-07-28,04:00:00,0,0,0,FMN GV 05 Lier
60,Mechelsesteenweg 365,2019-07-28,05:00:00,0,0,0,FMN GV 05 Lier
60,Mechelsesteenweg 365,2019-07-28,06:00:00,0,0,0,FMN GV 05 Lier
60,Mechelsesteenweg 365,2019-07-28,07:00:00,0,0,0,FMN GV 05 Lier
60,Mechelsesteenweg 365,2019-07-28,08:00:00,10,4,6,FMN GV 05 Lier
60,Mechelsesteenweg 365,2019-07-28,09:00:00,42,8,34,FMN GV 05 Lier
60,Mechelsesteenweg 365,2019-07-28,10:00:00,52,26,26,FMN GV 05 Lier
60,Mechelsesteenweg 365,2019-07-28,11:00:00,66,32,34,FMN GV 05 Lier
60,Mechelsesteenweg 365,2019-07-28,12:00:00,34,16,18,FMN GV 05 Lier
60,Mechelsesteenweg 365,2019-07-28,13:00:00,16,4,12,FMN GV 05 Lier
60,Mechelsesteenweg 365,2019-07-28,14:00:00,40,16,24,FMN GV 05 Lier
60,Mechelsesteenweg 365,2019-07-28,15:00:00,38,24,14,FMN GV 05 Lier
60,Mechelsesteenweg 365,2019-07-28,16:00:00,44,20,24,FMN GV 05 Lier
60,Mechelsesteenweg 365,2019-07-28,17:00:00,46,16,30,FMN GV 05 Lier
60,Mechelsesteenweg 365,2019-07-28,18:00:00,26,14,12,FMN GV 05 Lier
60,Mechelsesteenweg 365,2019-07-28,19:00:00,42,28,14,FMN GV 05 Lier
60,Mechelsesteenweg 365,2019-07-28,20:00:00,24,14,10,FMN GV 05 Lier
60,Mechelsesteenweg 365,2019-07-28,21:00:00,8,2,6,FMN GV 05 Lier
60,Mechelsesteenweg 365,2019-07-28,22:00:00,6,2,4,FMN GV 05 Lier
60,Mechelsesteenweg 365,2019-07-28,23:00:00,4,2,2,FMN GV 05 Lier
60,Mechelsesteenweg 365,2019-07-29,00:00:00,0,0,0,FMN GV 05 Lier
60,Mechelsesteenweg 365,2019-07-29,01:00:00,4,2,2,FMN GV 05 Lier
60,Mechelsesteenweg 365,2019-07-29,02:00:00,0,0,0,FMN GV 05 Lier
60,Mechelsesteenweg 365,2019-07-29,03:00:00,0,0,0,FMN GV 05 Lier
60,Mechelsesteenweg 365,2019-07-29,04:00:00,6,0,6,FMN GV 05 Lier
60,Mechelsesteenweg 365,2019-07-29,05:00:00,12,4,8,FMN GV 05 Lier
60,Mechelsesteenweg 365,2019-07-29,06:00:00,20,8,12,FMN GV 05 Lier
60,Mechelsesteenweg 365,2019-07-29,07:00:00,76,24,52,FMN GV 05 Lier
60,Mechelsesteenweg 365,2019-07-29,08:00:00,70,20,50,FMN GV 05 Lier
60,Mechelsesteenweg 365,2019-07-29,09:00:00,110,52,58,FMN GV 05 Lier
60,Mechelsesteenweg 365,2019-07-29,10:00:00,218,126,92,FMN GV 05 Lier
60,Mechelsesteenweg 365,2019-07-29,11:00:00,236,122,114,FMN GV 05 Lier
60,Mechelsesteenweg 365,2019-07-29,12:00:00,270,182,88,FMN GV 05 Lier
60,Mechelsesteenweg 365,2019-07-29,13:00:00,254,122,132,FMN GV 05 Lier
60,Mechelsesteenweg 365,2019-07-29,14:00:00,426,260,166,FMN GV 05 Lier
60,Mechelsesteenweg 365,2019-07-29,15:00:00,474,230,244,FMN GV 05 Lier
60,Mechelsesteenweg 365,2019-07-29,16:00:00,366,184,182,FMN GV 05 Lier
60,Mechelsesteenweg 365,2019-07-29,17:00:00,258,116,142,FMN GV 05 Lier
60,Mechelsesteenweg 365,2019-07-29,18:00:00,196,94,102,FMN GV 05 Lier
60,Mechelsesteenweg 365,2019-07-29,19:00:00,140,68,72,FMN GV 05 Lier
60,Mechelsesteenweg 365,2019-07-29,20:00:00,168,54,114,FMN GV 05 Lier
60,Mechelsesteenweg 365,2019-07-29,21:00:00,50,14,36,FMN GV 05 Lier
60,Mechelsesteenweg 365,2019-07-29,22:00:00,16,8,8,FMN GV 05 Lier
60,Mechelsesteenweg 365,2019-07-29,23:00:00,10,8,2,FMN GV 05 Lier
60,Mechelsesteenweg 365,2019-07-30,00:00:00,0,0,0,FMN GV 05 Lier
60,Mechelsesteenweg 365,2019-07-30,01:00:00,0,0,0,FMN GV 05 Lier
60,Mechelsesteenweg 365,2019-07-30,02:00:00,0,0,0,FMN GV 05 Lier
60,Mechelsesteenweg 365,2019-07-30,03:00:00,4,0,4,FMN GV 05 Lier
60,Mechelsesteenweg 365,2019-07-30,04:00:00,4,0,4,FMN GV 05 Lier
60,Mechelsesteenweg 365,2019-07-30,05:00:00,8,2,6,FMN GV 05 Lier
60,Mechelsesteenweg 365,2019-07-30,06:00:00,30,6,24,FMN GV 05 Lier
60,Mechelsesteenweg 365,2019-07-30,07:00:00,110,40,70,FMN GV 05 Lier
60,Mechelsesteenweg 365,2019-07-30,08:00:00,94,44,50,FMN GV 05 Lier
60,Mechelsesteenweg 365,2019-07-30,09:00:00,114,32,82,FMN GV 05 Lier
60,Mechelsesteenweg 365,2019-07-30,10:00:00,316,112,204,FMN GV 05 Lier
60,Mechelsesteenweg 365,2019-07-30,11:00:00,292,212,80,FMN GV 05 Lier
60,Mechelsesteenweg 365,2019-07-30,12:00:00,238,144,94,FMN GV 05 Lier
60,Mechelsesteenweg 365,2019-07-30,13:00:00,270,132,138,FMN GV 05 Lier
60,Mechelsesteenweg 365,2019-07-30,14:00:00,234,114,120,FMN GV 05 Lier
60,Mechelsesteenweg 365,2019-07-30,15:00:00,286,188,98,FMN GV 05 Lier
60,Mechelsesteenweg 365,2019-07-30,16:00:00,218,92,126,FMN GV 05 Lier
60,Mechelsesteenweg 365,2019-07-30,17:00:00,178,98,80,FMN GV 05 Lier
60,Mechelsesteenweg 365,2019-07-30,18:00:00,198,112,86,FMN GV 05 Lier
60,Mechelsesteenweg 365,2019-07-30,19:00:00,156,76,80,FMN GV 05 Lier
60,Mechelsesteenweg 365,2019-07-30,20:00:00,174,98,76,FMN GV 05 Lier
60,Mechelsesteenweg 365,2019-07-30,21:00:00,38,14,24,FMN GV 05 Lier
60,Mechelsesteenweg 365,2019-07-30,22:00:00,22,2,20,FMN GV 05 Lier
60,Mechelsesteenweg 365,2019-07-30,23:00:00,4,4,0,FMN GV 05 Lier
60,Mechelsesteenweg 365,2019-07-31,00:00:00,4,4,0,FMN GV 05 Lier
60,Mechelsesteenweg 365,2019-07-31,01:00:00,0,0,0,FMN GV 05 Lier
60,Mechelsesteenweg 365,2019-07-31,02:00:00,6,0,6,FMN GV 05 Lier
60,Mechelsesteenweg 365,2019-07-31,03:00:00,4,0,4,FMN GV 05 Lier
60,Mechelsesteenweg 365,2019-07-31,04:00:00,2,0,2,FMN GV 05 Lier
60,Mechelsesteenweg 365,2019-07-31,05:00:00,8,2,6,FMN GV 05 Lier
60,Mechelsesteenweg 365,2019-07-31,06:00:00,24,8,16,FMN GV 05 Lier
60,Mechelsesteenweg 365,2019-07-31,07:00:00,82,26,56,FMN GV 05 Lier
60,Mechelsesteenweg 365,2019-07-31,08:00:00,58,26,32,FMN GV 05 Lier
60,Mechelsesteenweg 365,2019-07-31,09:00:00,32,12,20,FMN GV 05 Lier
60,Mechelsesteenweg 365,2019-07-31,10:00:00,102,38,64,FMN GV 05 Lier
60,Mechelsesteenweg 365,2019-07-31,11:00:00,140,56,84,FMN GV 05 Lier
60,Mechelsesteenweg 365,2019-07-31,12:00:00,62,30,32,FMN GV 05 Lier
60,Mechelsesteenweg 365,2019-07-31,13:00:00,94,44,50,FMN GV 05 Lier
60,Mechelsesteenweg 365,2019-07-31,14:00:00,96,62,34,FMN GV 05 Lier
60,Mechelsesteenweg 365,2019-07-31,15:00:00,128,68,60,FMN GV 05 Lier
60,Mechelsesteenweg 365,2019-07-31,16:00:00,106,48,58,FMN GV 05 Lier
60,Mechelsesteenweg 365,2019-07-31,17:00:00,148,80,68,FMN GV 05 Lier
60,Mechelsesteenweg 365,2019-07-31,18:00:00,114,62,52,FMN GV 05 Lier
60,Mechelsesteenweg 365,2019-07-31,19:00:00,208,116,92,FMN GV 05 Lier
60,Mechelsesteenweg 365,2019-07-31,20:00:00,70,44,26,FMN GV 05 Lier
60,Mechelsesteenweg 365,2019-07-31,21:00:00,50,26,24,FMN GV 05 Lier
60,Mechelsesteenweg 365,2019-07-31,22:00:00,18,6,12,FMN GV 05 Lier
60,Mechelsesteenweg 365,2019-07-31,23:00:00,6,2,4,FMN GV 05 Lier
60,Mechelsesteenweg 365,2019-08-01,00:00:00,0,0,0,FMN GV 05 Lier
60,Mechelsesteenweg 365,2019-08-01,01:00:00,0,0,0,FMN GV 05 Lier
60,Mechelsesteenweg 365,2019-08-01,02:00:00,0,0,0,FMN GV 05 Lier
60,Mechelsesteenweg 365,2019-08-01,03:00:00,4,0,4,FMN GV 05 Lier
60,Mechelsesteenweg 365,2019-08-01,04:00:00,2,0,2,FMN GV 05 Lier
60,Mechelsesteenweg 365,2019-08-01,05:00:00,4,0,4,FMN GV 05 Lier
60,Mechelsesteenweg 365,2019-08-01,06:00:00,26,4,22,FMN GV 05 Lier
60,Mechelsesteenweg 365,2019-08-01,07:00:00,104,44,60,FMN GV 05 Lier
60,Mechelsesteenweg 365,2019-08-01,08:00:00,84,34,50,FMN GV 05 Lier
60,Mechelsesteenweg 365,2019-08-01,09:00:00,58,36,22,FMN GV 05 Lier
60,Mechelsesteenweg 365,2019-08-01,10:00:00,196,98,98,FMN GV 05 Lier
60,Mechelsesteenweg 365,2019-08-01,11:00:00,192,70,122,FMN GV 05 Lier
60,Mechelsesteenweg 365,2019-08-01,12:00:00,190,104,86,FMN GV 05 Lier
60,Mechelsesteenweg 365,2019-08-01,13:00:00,192,92,100,FMN GV 05 Lier
60,Mechelsesteenweg 365,2019-08-01,14:00:00,306,168,138,FMN GV 05 Lier
60,Mechelsesteenweg 365,2019-08-01,15:00:00,240,104,136,FMN GV 05 Lier
60,Mechelsesteenweg 365,2019-08-01,16:00:00,228,130,98,FMN GV 05 Lier
60,Mechelsesteenweg 365,2019-08-01,17:00:00,184,98,86,FMN GV 05 Lier
60,Mechelsesteenweg 365,2019-08-01,18:00:00,124,64,60,FMN GV 05 Lier
60,Mechelsesteenweg 365,2019-08-01,19:00:00,140,70,70,FMN GV 05 Lier
60,Mechelsesteenweg 365,2019-08-01,20:00:00,144,38,106,FMN GV 05 Lier
60,Mechelsesteenweg 365,2019-08-01,21:00:00,52,26,26,FMN GV 05 Lier
60,Mechelsesteenweg 365,2019-08-01,22:00:00,14,2,12,FMN GV 05 Lier
60,Mechelsesteenweg 365,2019-08-01,23:00:00,4,2,2,FMN GV 05 Lier
60,Mechelsesteenweg 365,2019-08-02,00:00:00,2,2,0,FMN GV 05 Lier
60,Mechelsesteenweg 365,2019-08-02,01:00:00,2,2,0,FMN GV 05 Lier
60,Mechelsesteenweg 365,2019-08-02,02:00:00,0,0,0,FMN GV 05 Lier
60,Mechelsesteenweg 365,2019-08-02,03:00:00,4,0,4,FMN GV 05 Lier
60,Mechelsesteenweg 365,2019-08-02,04:00:00,0,0,0,FMN GV 05 Lier
60,Mechelsesteenweg 365,2019-08-02,05:00:00,10,2,8,FMN GV 05 Lier
60,Mechelsesteenweg 365,2019-08-02,06:00:00,22,10,12,FMN GV 05 Lier
60,Mechelsesteenweg 365,2019-08-02,07:00:00,64,30,34,FMN GV 05 Lier
60,Mechelsesteenweg 365,2019-08-02,08:00:00,42,12,30,FMN GV 05 Lier
60,Mechelsesteenweg 365,2019-08-02,09:00:00,84,56,28,FMN GV 05 Lier
60,Mechelsesteenweg 365,2019-08-02,10:00:00,70,40,30,FMN GV 05 Lier
60,Mechelsesteenweg 365,2019-08-02,11:00:00,76,36,40,FMN GV 05 Lier
60,Mechelsesteenweg 365,2019-08-02,12:00:00,72,30,42,FMN GV 05 Lier
60,Mechelsesteenweg 365,2019-08-02,13:00:00,90,38,52,FMN GV 05 Lier
60,Mechelsesteenweg 365,2019-08-02,14:00:00,72,40,32,FMN GV 05 Lier
60,Mechelsesteenweg 365,2019-08-02,15:00:00,104,56,48,FMN GV 05 Lier
60,Mechelsesteenweg 365,2019-08-02,16:00:00,110,60,50,FMN GV 05 Lier
60,Mechelsesteenweg 365,2019-08-02,17:00:00,94,42,52,FMN GV 05 Lier
60,Mechelsesteenweg 365,2019-08-02,18:00:00,86,48,38,FMN GV 05 Lier
60,Mechelsesteenweg 365,2019-08-02,19:00:00,44,30,14,FMN GV 05 Lier
60,Mechelsesteenweg 365,2019-08-02,20:00:00,28,10,18,FMN GV 05 Lier
60,Mechelsesteenweg 365,2019-08-02,21:00:00,30,12,18,FMN GV 05 Lier
60,Mechelsesteenweg 365,2019-08-02,22:00:00,46,8,38,FMN GV 05 Lier
60,Mechelsesteenweg 365,2019-08-02,23:00:00,14,12,2,FMN GV 05 Lier
60,Mechelsesteenweg 365,2019-08-03,00:00:00,4,4,0,FMN GV 05 Lier
60,Mechelsesteenweg 365,2019-08-03,01:00:00,4,4,0,FMN GV 05 Lier
60,Mechelsesteenweg 365,2019-08-03,02:00:00,0,0,0,FMN GV 05 Lier
60,Mechelsesteenweg 365,2019-08-03,03:00:00,0,0,0,FMN GV 05 Lier
60,Mechelsesteenweg 365,2019-08-03,04:00:00,6,0,6,FMN GV 05 Lier
60,Mechelsesteenweg 365,2019-08-03,05:00:00,0,0,0,FMN GV 05 Lier
60,Mechelsesteenweg 365,2019-08-03,06:00:00,8,6,2,FMN GV 05 Lier
60,Mechelsesteenweg 365,2019-08-03,07:00:00,24,12,12,FMN GV 05 Lier
60,Mechelsesteenweg 365,2019-08-03,08:00:00,40,30,10,FMN GV 05 Lier
60,Mechelsesteenweg 365,2019-08-03,09:00:00,58,42,16,FMN GV 05 Lier
60,Mechelsesteenweg 365,2019-08-03,10:00:00,212,144,68,FMN GV 05 Lier
60,Mechelsesteenweg 365,2019-08-03,11:00:00,212,94,118,FMN GV 05 Lier
60,Mechelsesteenweg 365,2019-08-03,12:00:00,214,84,130,FMN GV 05 Lier
60,Mechelsesteenweg 365,2019-08-03,13:00:00,190,88,102,FMN GV 05 Lier
60,Mechelsesteenweg 365,2019-08-03,14:00:00,218,74,144,FMN GV 05 Lier
60,Mechelsesteenweg 365,2019-08-03,15:00:00,240,112,128,FMN GV 05 Lier
60,Mechelsesteenweg 365,2019-08-03,16:00:00,178,52,126,FMN GV 05 Lier
60,Mechelsesteenweg 365,2019-08-03,17:00:00,110,36,74,FMN GV 05 Lier
60,Mechelsesteenweg 365,2019-08-03,18:00:00,96,24,72,FMN GV 05 Lier
60,Mechelsesteenweg 365,2019-08-03,19:00:00,52,26,26,FMN GV 05 Lier
60,Mechelsesteenweg 365,2019-08-03,20:00:00,78,20,58,FMN GV 05 Lier
60,Mechelsesteenweg 365,2019-08-03,21:00:00,38,10,28,FMN GV 05 Lier
60,Mechelsesteenweg 365,2019-08-03,22:00:00,4,2,2,FMN GV 05 Lier
60,Mechelsesteenweg 365,2019-08-03,23:00:00,22,6,16,FMN GV 05 Lier
60,Mechelsesteenweg 365,2019-08-04,00:00:00,8,8,0,FMN GV 05 Lier
60,Mechelsesteenweg 365,2019-08-04,01:00:00,32,32,0,FMN GV 05 Lier
60,Mechelsesteenweg 365,2019-08-04,02:00:00,2,0,2,FMN GV 05 Lier
60,Mechelsesteenweg 365,2019-08-04,03:00:00,2,2,0,FMN GV 05 Lier
60,Mechelsesteenweg 365,2019-08-04,04:00:00,0,0,0,FMN GV 05 Lier
60,Mechelsesteenweg 365,2019-08-04,05:00:00,2,2,0,FMN GV 05 Lier
60,Mechelsesteenweg 365,2019-08-04,06:00:00,6,4,2,FMN GV 05 Lier
60,Mechelsesteenweg 365,2019-08-04,07:00:00,8,0,8,FMN GV 05 Lier
60,Mechelsesteenweg 365,2019-08-04,08:00:00,66,32,34,FMN GV 05 Lier
60,Mechelsesteenweg 365,2019-08-04,09:00:00,198,116,82,FMN GV 05 Lier
60,Mechelsesteenweg 365,2019-08-04,10:00:00,484,208,276,FMN GV 05 Lier
60,Mechelsesteenweg 365,2019-08-04,11:00:00,532,260,272,FMN GV 05 Lier
60,Mechelsesteenweg 365,2019-08-04,12:00:00,548,326,222,FMN GV 05 Lier
60,Mechelsesteenweg 365,2019-08-04,13:00:00,456,194,262,FMN GV 05 Lier
60,Mechelsesteenweg 365,2019-08-04,14:00:00,694,308,386,FMN GV 05 Lier
60,Mechelsesteenweg 365,2019-08-04,15:00:00,554,222,332,FMN GV 05 Lier
60,Mechelsesteenweg 365,2019-08-04,16:00:00,436,194,242,FMN GV 05 Lier
60,Mechelsesteenweg 365,2019-08-04,17:00:00,244,80,164,FMN GV 05 Lier
60,Mechelsesteenweg 365,2019-08-04,18:00:00,170,66,104,FMN GV 05 Lier
60,Mechelsesteenweg 365,2019-08-04,19:00:00,60,34,26,FMN GV 05 Lier
60,Mechelsesteenweg 365,2019-08-04,20:00:00,86,32,54,FMN GV 05 Lier
60,Mechelsesteenweg 365,2019-08-04,21:00:00,24,10,14,FMN GV 05 Lier
60,Mechelsesteenweg 365,2019-08-04,22:00:00,14,8,6,FMN GV 05 Lier
60,Mechelsesteenweg 365,2019-08-04,23:00:00,0,0,0,FMN GV 05 Lier
60,Mechelsesteenweg 365,2019-08-05,00:00:00,0,0,0,FMN GV 05 Lier
60,Mechelsesteenweg 365,2019-08-05,01:00:00,0,0,0,FMN GV 05 Lier
60,Mechelsesteenweg 365,2019-08-05,02:00:00,0,0,0,FMN GV 05 Lier
60,Mechelsesteenweg 365,2019-08-05,03:00:00,0,0,0,FMN GV 05 Lier
60,Mechelsesteenweg 365,2019-08-05,04:00:00,2,0,2,FMN GV 05 Lier
60,Mechelsesteenweg 365,2019-08-05,05:00:00,6,4,2,FMN GV 05 Lier
60,Mechelsesteenweg 365,2019-08-05,06:00:00,26,10,16,FMN GV 05 Lier
60,Mechelsesteenweg 365,2019-08-05,07:00:00,88,18,70,FMN GV 05 Lier
60,Mechelsesteenweg 365,2019-08-05,08:00:00,62,26,36,FMN GV 05 Lier
60,Mechelsesteenweg 365,2019-08-05,09:00:00,50,18,32,FMN GV 05 Lier
60,Mechelsesteenweg 365,2019-08-05,10:00:00,76,46,30,FMN GV 05 Lier
60,Mechelsesteenweg 365,2019-08-05,11:00:00,142,84,58,FMN GV 05 Lier
60,Mechelsesteenweg 365,2019-08-05,12:00:00,112,68,44,FMN GV 05 Lier
60,Mechelsesteenweg 365,2019-08-05,13:00:00,182,70,112,FMN GV 05 Lier
60,Mechelsesteenweg 365,2019-08-05,14:00:00,254,134,120,FMN GV 05 Lier
60,Mechelsesteenweg 365,2019-08-05,15:00:00,242,114,128,FMN GV 05 Lier
60,Mechelsesteenweg 365,2019-08-05,16:00:00,210,108,102,FMN GV 05 Lier
60,Mechelsesteenweg 365,2019-08-05,17:00:00,180,94,86,FMN GV 05 Lier
60,Mechelsesteenweg 365,2019-08-05,18:00:00,108,52,56,FMN GV 05 Lier
60,Mechelsesteenweg 365,2019-08-05,19:00:00,86,38,48,FMN GV 05 Lier
60,Mechelsesteenweg 365,2019-08-05,20:00:00,72,24,48,FMN GV 05 Lier
60,Mechelsesteenweg 365,2019-08-05,21:00:00,40,18,22,FMN GV 05 Lier
60,Mechelsesteenweg 365,2019-08-05,22:00:00,18,6,12,FMN GV 05 Lier
60,Mechelsesteenweg 365,2019-08-05,23:00:00,4,4,0,FMN GV 05 Lier
60,Mechelsesteenweg 365,2019-08-06,00:00:00,4,2,2,FMN GV 05 Lier
60,Mechelsesteenweg 365,2019-08-06,01:00:00,0,0,0,FMN GV 05 Lier
60,Mechelsesteenweg 365,2019-08-06,02:00:00,0,0,0,FMN GV 05 Lier
60,Mechelsesteenweg 365,2019-08-06,03:00:00,2,0,2,FMN GV 05 Lier
60,Mechelsesteenweg 365,2019-08-06,04:00:00,4,2,2,FMN GV 05 Lier
60,Mechelsesteenweg 365,2019-08-06,05:00:00,8,4,4,FMN GV 05 Lier
60,Mechelsesteenweg 365,2019-08-06,06:00:00,30,2,28,FMN GV 05 Lier
60,Mechelsesteenweg 365,2019-08-06,07:00:00,92,32,60,FMN GV 05 Lier
60,Mechelsesteenweg 365,2019-08-06,08:00:00,92,26,66,FMN GV 05 Lier
60,Mechelsesteenweg 365,2019-08-06,09:00:00,92,32,60,FMN GV 05 Lier
60,Mechelsesteenweg 365,2019-08-06,10:00:00,176,76,100,FMN GV 05 Lier
60,Mechelsesteenweg 365,2019-08-06,11:00:00,162,76,86,FMN GV 05 Lier
60,Mechelsesteenweg 365,2019-08-06,12:00:00,130,76,54,FMN GV 05 Lier
60,Mechelsesteenweg 365,2019-08-06,13:00:00,198,78,120,FMN GV 05 Lier
60,Mechelsesteenweg 365,2019-08-06,14:00:00,232,114,118,FMN GV 05 Lier
60,Mechelsesteenweg 365,2019-08-06,15:00:00,240,120,120,FMN GV 05 Lier
60,Mechelsesteenweg 365,2019-08-06,16:00:00,208,86,122,FMN GV 05 Lier
60,Mechelsesteenweg 365,2019-08-06,17:00:00,202,104,98,FMN GV 05 Lier
60,Mechelsesteenweg 365,2019-08-06,18:00:00,86,44,42,FMN GV 05 Lier
60,Mechelsesteenweg 365,2019-08-06,19:00:00,122,46,76,FMN GV 05 Lier
60,Mechelsesteenweg 365,2019-08-06,20:00:00,130,70,60,FMN GV 05 Lier
60,Mechelsesteenweg 365,2019-08-06,21:00:00,34,6,28,FMN GV 05 Lier
60,Mechelsesteenweg 365,2019-08-06,22:00:00,8,6,2,FMN GV 05 Lier
60,Mechelsesteenweg 365,2019-08-06,23:00:00,6,2,4,FMN GV 05 Lier
60,Mechelsesteenweg 365,2019-08-07,00:00:00,2,0,2,FMN GV 05 Lier
60,Mechelsesteenweg 365,2019-08-07,01:00:00,0,0,0,FMN GV 05 Lier
60,Mechelsesteenweg 365,2019-08-07,02:00:00,2,2,0,FMN GV 05 Lier
60,Mechelsesteenweg 365,2019-08-07,03:00:00,2,0,2,FMN GV 05 Lier
60,Mechelsesteenweg 365,2019-08-07,04:00:00,0,0,0,FMN GV 05 Lier
60,Mechelsesteenweg 365,2019-08-07,05:00:00,0,0,0,FMN GV 05 Lier
60,Mechelsesteenweg 365,2019-08-07,06:00:00,24,8,16,FMN GV 05 Lier
60,Mechelsesteenweg 365,2019-08-07,07:00:00,68,28,40,FMN GV 05 Lier
60,Mechelsesteenweg 365,2019-08-07,08:00:00,52,12,40,FMN GV 05 Lier
60,Mechelsesteenweg 365,2019-08-07,09:00:00,42,26,16,FMN GV 05 Lier
60,Mechelsesteenweg 365,2019-08-07,10:00:00,102,72,30,FMN GV 05 Lier
60,Mechelsesteenweg 365,2019-08-07,11:00:00,110,64,46,FMN GV 05 Lier
60,Mechelsesteenweg 365,2019-08-07,12:00:00,114,52,62,FMN GV 05 Lier
60,Mechelsesteenweg 365,2019-08-07,13:00:00,134,72,62,FMN GV 05 Lier
60,Mechelsesteenweg 365,2019-08-07,14:00:00,160,76,84,FMN GV 05 Lier
60,Mechelsesteenweg 365,2019-08-07,15:00:00,150,66,84,FMN GV 05 Lier
60,Mechelsesteenweg 365,2019-08-07,16:00:00,118,68,50,FMN GV 05 Lier
60,Mechelsesteenweg 365,2019-08-07,17:00:00,162,70,92,FMN GV 05 Lier
60,Mechelsesteenweg 365,2019-08-07,18:00:00,144,72,72,FMN GV 05 Lier
60,Mechelsesteenweg 365,2019-08-07,19:00:00,162,86,76,FMN GV 05 Lier
60,Mechelsesteenweg 365,2019-08-07,20:00:00,112,46,66,FMN GV 05 Lier
60,Mechelsesteenweg 365,2019-08-07,21:00:00,38,10,28,FMN GV 05 Lier
60,Mechelsesteenweg 365,2019-08-07,22:00:00,16,8,8,FMN GV 05 Lier
60,Mechelsesteenweg 365,2019-08-07,23:00:00,8,2,6,FMN GV 05 Lier
60,Mechelsesteenweg 365,2019-08-08,00:00:00,2,2,0,FMN GV 05 Lier
60,Mechelsesteenweg 365,2019-08-08,01:00:00,0,0,0,FMN GV 05 Lier
60,Mechelsesteenweg 365,2019-08-08,02:00:00,0,0,0,FMN GV 05 Lier
60,Mechelsesteenweg 365,2019-08-08,03:00:00,2,0,2,FMN GV 05 Lier
60,Mechelsesteenweg 365,2019-08-08,04:00:00,0,0,0,FMN GV 05 Lier
60,Mechelsesteenweg 365,2019-08-08,05:00:00,6,4,2,FMN GV 05 Lier
60,Mechelsesteenweg 365,2019-08-08,06:00:00,28,8,20,FMN GV 05 Lier
60,Mechelsesteenweg 365,2019-08-08,07:00:00,86,26,60,FMN GV 05 Lier
60,Mechelsesteenweg 365,2019-08-08,08:00:00,84,30,54,FMN GV 05 Lier
60,Mechelsesteenweg 365,2019-08-08,09:00:00,90,56,34,FMN GV 05 Lier
60,Mechelsesteenweg 365,2019-08-08,10:00:00,156,86,70,FMN GV 05 Lier
60,Mechelsesteenweg 365,2019-08-08,11:00:00,294,140,154,FMN GV 05 Lier
60,Mechelsesteenweg 365,2019-08-08,12:00:00,110,60,50,FMN GV 05 Lier
60,Mechelsesteenweg 365,2019-08-08,13:00:00,282,150,132,FMN GV 05 Lier
60,Mechelsesteenweg 365,2019-08-08,14:00:00,302,134,168,FMN GV 05 Lier
60,Mechelsesteenweg 365,2019-08-08,15:00:00,254,96,158,FMN GV 05 Lier
60,Mechelsesteenweg 365,2019-08-08,16:00:00,216,102,114,FMN GV 05 Lier
60,Mechelsesteenweg 365,2019-08-08,17:00:00,214,124,90,FMN GV 05 Lier
60,Mechelsesteenweg 365,2019-08-08,18:00:00,152,88,64,FMN GV 05 Lier
60,Mechelsesteenweg 365,2019-08-08,19:00:00,148,88,60,FMN GV 05 Lier
60,Mechelsesteenweg 365,2019-08-08,20:00:00,98,42,56,FMN GV 05 Lier
60,Mechelsesteenweg 365,2019-08-08,21:00:00,40,10,30,FMN GV 05 Lier
60,Mechelsesteenweg 365,2019-08-08,22:00:00,16,12,4,FMN GV 05 Lier
60,Mechelsesteenweg 365,2019-08-08,23:00:00,16,4,12,FMN GV 05 Lier
60,Mechelsesteenweg 365,2019-08-09,00:00:00,10,0,10,FMN GV 05 Lier
60,Mechelsesteenweg 365,2019-08-09,01:00:00,4,0,4,FMN GV 05 Lier
60,Mechelsesteenweg 365,2019-08-09,02:00:00,0,0,0,FMN GV 05 Lier
60,Mechelsesteenweg 365,2019-08-09,03:00:00,2,0,2,FMN GV 05 Lier
60,Mechelsesteenweg 365,2019-08-09,04:00:00,0,0,0,FMN GV 05 Lier
60,Mechelsesteenweg 365,2019-08-09,05:00:00,0,0,0,FMN GV 05 Lier
60,Mechelsesteenweg 365,2019-08-09,06:00:00,18,2,16,FMN GV 05 Lier
60,Mechelsesteenweg 365,2019-08-09,07:00:00,48,20,28,FMN GV 05 Lier
60,Mechelsesteenweg 365,2019-08-09,08:00:00,22,10,12,FMN GV 05 Lier
60,Mechelsesteenweg 365,2019-08-09,09:00:00,28,16,12,FMN GV 05 Lier
60,Mechelsesteenweg 365,2019-08-09,10:00:00,54,32,22,FMN GV 05 Lier
60,Mechelsesteenweg 365,2019-08-09,11:00:00,32,12,20,FMN GV 05 Lier
60,Mechelsesteenweg 365,2019-08-09,12:00:00,22,12,10,FMN GV 05 Lier
60,Mechelsesteenweg 365,2019-08-09,13:00:00,42,24,18,FMN GV 05 Lier
60,Mechelsesteenweg 365,2019-08-09,14:00:00,44,38,6,FMN GV 05 Lier
60,Mechelsesteenweg 365,2019-08-09,15:00:00,70,30,40,FMN GV 05 Lier
60,Mechelsesteenweg 365,2019-08-09,16:00:00,76,46,30,FMN GV 05 Lier
60,Mechelsesteenweg 365,2019-08-09,17:00:00,78,26,52,FMN GV 05 Lier
60,Mechelsesteenweg 365,2019-08-09,18:00:00,42,26,16,FMN GV 05 Lier
60,Mechelsesteenweg 365,2019-08-09,19:00:00,30,16,14,FMN GV 05 Lier
60,Mechelsesteenweg 365,2019-08-09,20:00:00,30,16,14,FMN GV 05 Lier
60,Mechelsesteenweg 365,2019-08-09,21:00:00,32,18,14,FMN GV 05 Lier
60,Mechelsesteenweg 365,2019-08-09,22:00:00,8,6,2,FMN GV 05 Lier
60,Mechelsesteenweg 365,2019-08-09,23:00:00,0,0,0,FMN GV 05 Lier
60,Mechelsesteenweg 365,2019-08-10,00:00:00,6,2,4,FMN GV 05 Lier
60,Mechelsesteenweg 365,2019-08-10,01:00:00,6,6,0,FMN GV 05 Lier
60,Mechelsesteenweg 365,2019-08-10,02:00:00,0,0,0,FMN GV 05 Lier
60,Mechelsesteenweg 365,2019-08-10,03:00:00,4,0,4,FMN GV 05 Lier
60,Mechelsesteenweg 365,2019-08-10,04:00:00,2,0,2,FMN GV 05 Lier
60,Mechelsesteenweg 365,2019-08-10,05:00:00,0,0,0,FMN GV 05 Lier
60,Mechelsesteenweg 365,2019-08-10,06:00:00,0,0,0,FMN GV 05 Lier
60,Mechelsesteenweg 365,2019-08-10,07:00:00,30,8,22,FMN GV 05 Lier
60,Mechelsesteenweg 365,2019-08-10,08:00:00,16,10,6,FMN GV 05 Lier
60,Mechelsesteenweg 365,2019-08-10,09:00:00,28,14,14,FMN GV 05 Lier
60,Mechelsesteenweg 365,2019-08-10,10:00:00,128,50,78,FMN GV 05 Lier
60,Mechelsesteenweg 365,2019-08-10,11:00:00,64,28,36,FMN GV 05 Lier
60,Mechelsesteenweg 365,2019-08-10,12:00:00,74,28,46,FMN GV 05 Lier
60,Mechelsesteenweg 365,2019-08-10,13:00:00,46,30,16,FMN GV 05 Lier
60,Mechelsesteenweg 365,2019-08-10,14:00:00,114,58,56,FMN GV 05 Lier
60,Mechelsesteenweg 365,2019-08-10,15:00:00,78,50,28,FMN GV 05 Lier
60,Mechelsesteenweg 365,2019-08-10,16:00:00,62,30,32,FMN GV 05 Lier
60,Mechelsesteenweg 365,2019-08-10,17:00:00,50,12,38,FMN GV 05 Lier
60,Mechelsesteenweg 365,2019-08-10,18:00:00,38,20,18,FMN GV 05 Lier
60,Mechelsesteenweg 365,2019-08-10,19:00:00,30,4,26,FMN GV 05 Lier
60,Mechelsesteenweg 365,2019-08-10,20:00:00,48,26,22,FMN GV 05 Lier
60,Mechelsesteenweg 365,2019-08-10,21:00:00,12,8,4,FMN GV 05 Lier
60,Mechelsesteenweg 365,2019-08-10,22:00:00,2,0,2,FMN GV 05 Lier
60,Mechelsesteenweg 365,2019-08-10,23:00:00,6,4,2,FMN GV 05 Lier
60,Mechelsesteenweg 365,2019-08-11,00:00:00,8,8,0,FMN GV 05 Lier
60,Mechelsesteenweg 365,2019-08-11,01:00:00,2,2,0,FMN GV 05 Lier
60,Mechelsesteenweg 365,2019-08-11,02:00:00,0,0,0,FMN GV 05 Lier
60,Mechelsesteenweg 365,2019-08-11,03:00:00,0,0,0,FMN GV 05 Lier
60,Mechelsesteenweg 365,2019-08-11,04:00:00,10,0,10,FMN GV 05 Lier
60,Mechelsesteenweg 365,2019-08-11,05:00:00,0,0,0,FMN GV 05 Lier
60,Mechelsesteenweg 365,2019-08-11,06:00:00,2,2,0,FMN GV 05 Lier
60,Mechelsesteenweg 365,2019-08-11,07:00:00,20,16,4,FMN GV 05 Lier
60,Mechelsesteenweg 365,2019-08-11,08:00:00,62,30,32,FMN GV 05 Lier
60,Mechelsesteenweg 365,2019-08-11,09:00:00,206,156,50,FMN GV 05 Lier
60,Mechelsesteenweg 365,2019-08-11,10:00:00,376,158,218,FMN GV 05 Lier
60,Mechelsesteenweg 365,2019-08-11,11:00:00,466,220,246,FMN GV 05 Lier
60,Mechelsesteenweg 365,2019-08-11,12:00:00,338,182,156,FMN GV 05 Lier
60,Mechelsesteenweg 365,2019-08-11,13:00:00,330,144,186,FMN GV 05 Lier
60,Mechelsesteenweg 365,2019-08-11,14:00:00,366,170,196,FMN GV 05 Lier
60,Mechelsesteenweg 365,2019-08-11,15:00:00,316,162,154,FMN GV 05 Lier
60,Mechelsesteenweg 365,2019-08-11,16:00:00,234,70,164,FMN GV 05 Lier
60,Mechelsesteenweg 365,2019-08-11,17:00:00,146,76,70,FMN GV 05 Lier
60,Mechelsesteenweg 365,2019-08-11,18:00:00,108,52,56,FMN GV 05 Lier
60,Mechelsesteenweg 365,2019-08-11,19:00:00,56,10,46,FMN GV 05 Lier
60,Mechelsesteenweg 365,2019-08-11,20:00:00,60,18,42,FMN GV 05 Lier
60,Mechelsesteenweg 365,2019-08-11,21:00:00,14,6,8,FMN GV 05 Lier
60,Mechelsesteenweg 365,2019-08-11,22:00:00,8,0,8,FMN GV 05 Lier
60,Mechelsesteenweg 365,2019-08-11,23:00:00,2,2,0,FMN GV 05 Lier
60,Mechelsesteenweg 365,2019-08-12,00:00:00,2,0,2,FMN GV 05 Lier
60,Mechelsesteenweg 365,2019-08-12,01:00:00,0,0,0,FMN GV 05 Lier
60,Mechelsesteenweg 365,2019-08-12,02:00:00,0,0,0,FMN GV 05 Lier
60,Mechelsesteenweg 365,2019-08-12,03:00:00,4,2,2,FMN GV 05 Lier
60,Mechelsesteenweg 365,2019-08-12,04:00:00,4,0,4,FMN GV 05 Lier
60,Mechelsesteenweg 365,2019-08-12,05:00:00,8,2,6,FMN GV 05 Lier
60,Mechelsesteenweg 365,2019-08-12,06:00:00,14,0,14,FMN GV 05 Lier
60,Mechelsesteenweg 365,2019-08-12,07:00:00,64,22,42,FMN GV 05 Lier
60,Mechelsesteenweg 365,2019-08-12,08:00:00,60,18,42,FMN GV 05 Lier
60,Mechelsesteenweg 365,2019-08-12,09:00:00,64,22,42,FMN GV 05 Lier
60,Mechelsesteenweg 365,2019-08-12,10:00:00,166,104,62,FMN GV 05 Lier
60,Mechelsesteenweg 365,2019-08-12,11:00:00,184,98,86,FMN GV 05 Lier
60,Mechelsesteenweg 365,2019-08-12,12:00:00,110,72,38,FMN GV 05 Lier
60,Mechelsesteenweg 365,2019-08-12,13:00:00,88,40,48,FMN GV 05 Lier
60,Mechelsesteenweg 365,2019-08-12,14:00:00,94,56,38,FMN GV 05 Lier
60,Mechelsesteenweg 365,2019-08-12,15:00:00,64,28,36,FMN GV 05 Lier
60,Mechelsesteenweg 365,2019-08-12,16:00:00,40,24,16,FMN GV 05 Lier
60,Mechelsesteenweg 365,2019-08-12,17:00:00,84,66,18,FMN GV 05 Lier
60,Mechelsesteenweg 365,2019-08-12,18:00:00,54,30,24,FMN GV 05 Lier
60,Mechelsesteenweg 365,2019-08-12,19:00:00,40,26,14,FMN GV 05 Lier
60,Mechelsesteenweg 365,2019-08-12,20:00:00,18,6,12,FMN GV 05 Lier
60,Mechelsesteenweg 365,2019-08-12,21:00:00,2,0,2,FMN GV 05 Lier
60,Mechelsesteenweg 365,2019-08-12,22:00:00,4,4,0,FMN GV 05 Lier
60,Mechelsesteenweg 365,2019-08-12,23:00:00,0,0,0,FMN GV 05 Lier
60,Mechelsesteenweg 365,2019-08-13,00:00:00,0,0,0,FMN GV 05 Lier
60,Mechelsesteenweg 365,2019-08-13,01:00:00,0,0,0,FMN GV 05 Lier
60,Mechelsesteenweg 365,2019-08-13,02:00:00,4,0,4,FMN GV 05 Lier
60,Mechelsesteenweg 365,2019-08-13,03:00:00,2,0,2,FMN GV 05 Lier
60,Mechelsesteenweg 365,2019-08-13,04:00:00,4,0,4,FMN GV 05 Lier
60,Mechelsesteenweg 365,2019-08-13,05:00:00,4,0,4,FMN GV 05 Lier
60,Mechelsesteenweg 365,2019-08-13,06:00:00,26,6,20,FMN GV 05 Lier
60,Mechelsesteenweg 365,2019-08-13,07:00:00,76,24,52,FMN GV 05 Lier
60,Mechelsesteenweg 365,2019-08-13,08:00:00,46,18,28,FMN GV 05 Lier
60,Mechelsesteenweg 365,2019-08-13,09:00:00,104,54,50,FMN GV 05 Lier
60,Mechelsesteenweg 365,2019-08-13,10:00:00,196,96,100,FMN GV 05 Lier
60,Mechelsesteenweg 365,2019-08-13,11:00:00,186,116,70,FMN GV 05 Lier
60,Mechelsesteenweg 365,2019-08-13,12:00:00,80,40,40,FMN GV 05 Lier
60,Mechelsesteenweg 365,2019-08-13,13:00:00,86,42,44,FMN GV 05 Lier
60,Mechelsesteenweg 365,2019-08-13,14:00:00,30,16,14,FMN GV 05 Lier
60,Mechelsesteenweg 365,2019-08-13,15:00:00,42,20,22,FMN GV 05 Lier
60,Mechelsesteenweg 365,2019-08-13,16:00:00,88,42,46,FMN GV 05 Lier
60,Mechelsesteenweg 365,2019-08-13,17:00:00,110,70,40,FMN GV 05 Lier
60,Mechelsesteenweg 365,2019-08-13,18:00:00,48,24,24,FMN GV 05 Lier
60,Mechelsesteenweg 365,2019-08-13,19:00:00,36,28,8,FMN GV 05 Lier
60,Mechelsesteenweg 365,2019-08-13,20:00:00,36,10,26,FMN GV 05 Lier
60,Mechelsesteenweg 365,2019-08-13,21:00:00,8,2,6,FMN GV 05 Lier
60,Mechelsesteenweg 365,2019-08-13,22:00:00,2,2,0,FMN GV 05 Lier
60,Mechelsesteenweg 365,2019-08-13,23:00:00,6,2,4,FMN GV 05 Lier
60,Mechelsesteenweg 365,2019-08-14,00:00:00,0,0,0,FMN GV 05 Lier
60,Mechelsesteenweg 365,2019-08-14,01:00:00,2,0,2,FMN GV 05 Lier
60,Mechelsesteenweg 365,2019-08-14,02:00:00,0,0,0,FMN GV 05 Lier
60,Mechelsesteenweg 365,2019-08-14,03:00:00,0,0,0,FMN GV 05 Lier
60,Mechelsesteenweg 365,2019-08-14,04:00:00,4,0,4,FMN GV 05 Lier
60,Mechelsesteenweg 365,2019-08-14,05:00:00,6,0,6,FMN GV 05 Lier
60,Mechelsesteenweg 365,2019-08-14,06:00:00,14,4,10,FMN GV 05 Lier
60,Mechelsesteenweg 365,2019-08-14,07:00:00,58,20,38,FMN GV 05 Lier
60,Mechelsesteenweg 365,2019-08-14,08:00:00,68,28,40,FMN GV 05 Lier
60,Mechelsesteenweg 365,2019-08-14,09:00:00,60,36,24,FMN GV 05 Lier
60,Mechelsesteenweg 365,2019-08-14,10:00:00,180,80,100,FMN GV 05 Lier
60,Mechelsesteenweg 365,2019-08-14,11:00:00,108,44,64,FMN GV 05 Lier
60,Mechelsesteenweg 365,2019-08-14,12:00:00,120,54,66,FMN GV 05 Lier
60,Mechelsesteenweg 365,2019-08-14,13:00:00,128,90,38,FMN GV 05 Lier
60,Mechelsesteenweg 365,2019-08-14,14:00:00,146,74,72,FMN GV 05 Lier
60,Mechelsesteenweg 365,2019-08-14,15:00:00,108,62,46,FMN GV 05 Lier
60,Mechelsesteenweg 365,2019-08-14,16:00:00,96,42,54,FMN GV 05 Lier
60,Mechelsesteenweg 365,2019-08-14,17:00:00,84,42,42,FMN GV 05 Lier
60,Mechelsesteenweg 365,2019-08-14,18:00:00,48,30,18,FMN GV 05 Lier
60,Mechelsesteenweg 365,2019-08-14,19:00:00,46,32,14,FMN GV 05 Lier
60,Mechelsesteenweg 365,2019-08-14,20:00:00,46,32,14,FMN GV 05 Lier
60,Mechelsesteenweg 365,2019-08-14,21:00:00,0,0,0,FMN GV 05 Lier
60,Mechelsesteenweg 365,2019-08-14,22:00:00,8,4,4,FMN GV 05 Lier
60,Mechelsesteenweg 365,2019-08-14,23:00:00,6,4,2,FMN GV 05 Lier
60,Mechelsesteenweg 365,2019-08-15,00:00:00,0,0,0,FMN GV 05 Lier
60,Mechelsesteenweg 365,2019-08-15,01:00:00,0,0,0,FMN GV 05 Lier
60,Mechelsesteenweg 365,2019-08-15,02:00:00,4,0,4,FMN GV 05 Lier
60,Mechelsesteenweg 365,2019-08-15,03:00:00,0,0,0,FMN GV 05 Lier
60,Mechelsesteenweg 365,2019-08-15,04:00:00,0,0,0,FMN GV 05 Lier
60,Mechelsesteenweg 365,2019-08-15,05:00:00,0,0,0,FMN GV 05 Lier
60,Mechelsesteenweg 365,2019-08-15,06:00:00,4,0,4,FMN GV 05 Lier
60,Mechelsesteenweg 365,2019-08-15,07:00:00,4,2,2,FMN GV 05 Lier
60,Mechelsesteenweg 365,2019-08-15,08:00:00,38,16,22,FMN GV 05 Lier
60,Mechelsesteenweg 365,2019-08-15,09:00:00,50,20,30,FMN GV 05 Lier
60,Mechelsesteenweg 365,2019-08-15,10:00:00,58,30,28,FMN GV 05 Lier
60,Mechelsesteenweg 365,2019-08-15,11:00:00,60,42,18,FMN GV 05 Lier
60,Mechelsesteenweg 365,2019-08-15,12:00:00,54,30,24,FMN GV 05 Lier
60,Mechelsesteenweg 365,2019-08-15,13:00:00,98,50,48,FMN GV 05 Lier
60,Mechelsesteenweg 365,2019-08-15,14:00:00,108,60,48,FMN GV 05 Lier
60,Mechelsesteenweg 365,2019-08-15,15:00:00,98,56,42,FMN GV 05 Lier
60,Mechelsesteenweg 365,2019-08-15,16:00:00,84,56,28,FMN GV 05 Lier
60,Mechelsesteenweg 365,2019-08-15,17:00:00,56,26,30,FMN GV 05 Lier
60,Mechelsesteenweg 365,2019-08-15,18:00:00,82,52,30,FMN GV 05 Lier
60,Mechelsesteenweg 365,2019-08-15,19:00:00,38,14,24,FMN GV 05 Lier
60,Mechelsesteenweg 365,2019-08-15,20:00:00,28,6,22,FMN GV 05 Lier
60,Mechelsesteenweg 365,2019-08-15,21:00:00,4,2,2,FMN GV 05 Lier
60,Mechelsesteenweg 365,2019-08-15,22:00:00,4,0,4,FMN GV 05 Lier
60,Mechelsesteenweg 365,2019-08-15,23:00:00,0,0,0,FMN GV 05 Lier
60,Mechelsesteenweg 365,2019-08-16,00:00:00,0,0,0,FMN GV 05 Lier
60,Mechelsesteenweg 365,2019-08-16,01:00:00,0,0,0,FMN GV 05 Lier
60,Mechelsesteenweg 365,2019-08-16,02:00:00,2,0,2,FMN GV 05 Lier
60,Mechelsesteenweg 365,2019-08-16,03:00:00,6,4,2,FMN GV 05 Lier
60,Mechelsesteenweg 365,2019-08-16,04:00:00,2,0,2,FMN GV 05 Lier
60,Mechelsesteenweg 365,2019-08-16,05:00:00,6,2,4,FMN GV 05 Lier
60,Mechelsesteenweg 365,2019-08-16,06:00:00,4,0,4,FMN GV 05 Lier
60,Mechelsesteenweg 365,2019-08-16,07:00:00,36,10,26,FMN GV 05 Lier
60,Mechelsesteenweg 365,2019-08-16,08:00:00,86,48,38,FMN GV 05 Lier
60,Mechelsesteenweg 365,2019-08-16,09:00:00,116,48,68,FMN GV 05 Lier
60,Mechelsesteenweg 365,2019-08-16,10:00:00,266,116,150,FMN GV 05 Lier
60,Mechelsesteenweg 365,2019-08-16,11:00:00,266,118,148,FMN GV 05 Lier
60,Mechelsesteenweg 365,2019-08-16,12:00:00,156,72,84,FMN GV 05 Lier
60,Mechelsesteenweg 365,2019-08-16,13:00:00,234,120,114,FMN GV 05 Lier
60,Mechelsesteenweg 365,2019-08-16,14:00:00,380,208,172,FMN GV 05 Lier
60,Mechelsesteenweg 365,2019-08-16,15:00:00,314,142,172,FMN GV 05 Lier
60,Mechelsesteenweg 365,2019-08-16,16:00:00,208,122,86,FMN GV 05 Lier
60,Mechelsesteenweg 365,2019-08-16,17:00:00,198,96,102,FMN GV 05 Lier
60,Mechelsesteenweg 365,2019-08-16,18:00:00,138,58,80,FMN GV 05 Lier
60,Mechelsesteenweg 365,2019-08-16,19:00:00,82,18,64,FMN GV 05 Lier
60,Mechelsesteenweg 365,2019-08-16,20:00:00,38,20,18,FMN GV 05 Lier
60,Mechelsesteenweg 365,2019-08-16,21:00:00,16,4,12,FMN GV 05 Lier
60,Mechelsesteenweg 365,2019-08-16,22:00:00,8,2,6,FMN GV 05 Lier
60,Mechelsesteenweg 365,2019-08-16,23:00:00,4,4,0,FMN GV 05 Lier
60,Mechelsesteenweg 365,2019-08-17,00:00:00,4,2,2,FMN GV 05 Lier
60,Mechelsesteenweg 365,2019-08-17,01:00:00,2,2,0,FMN GV 05 Lier
60,Mechelsesteenweg 365,2019-08-17,02:00:00,0,0,0,FMN GV 05 Lier
60,Mechelsesteenweg 365,2019-08-17,03:00:00,0,0,0,FMN GV 05 Lier
60,Mechelsesteenweg 365,2019-08-17,04:00:00,2,0,2,FMN GV 05 Lier
60,Mechelsesteenweg 365,2019-08-17,05:00:00,4,4,0,FMN GV 05 Lier
60,Mechelsesteenweg 365,2019-08-17,06:00:00,10,4,6,FMN GV 05 Lier
60,Mechelsesteenweg 365,2019-08-17,07:00:00,14,2,12,FMN GV 05 Lier
60,Mechelsesteenweg 365,2019-08-17,08:00:00,16,8,8,FMN GV 05 Lier
60,Mechelsesteenweg 365,2019-08-17,09:00:00,24,6,18,FMN GV 05 Lier
60,Mechelsesteenweg 365,2019-08-17,10:00:00,98,56,42,FMN GV 05 Lier
60,Mechelsesteenweg 365,2019-08-17,11:00:00,38,12,26,FMN GV 05 Lier
60,Mechelsesteenweg 365,2019-08-17,12:00:00,26,14,12,FMN GV 05 Lier
60,Mechelsesteenweg 365,2019-08-17,13:00:00,72,52,20,FMN GV 05 Lier
60,Mechelsesteenweg 365,2019-08-17,14:00:00,94,60,34,FMN GV 05 Lier
60,Mechelsesteenweg 365,2019-08-17,15:00:00,90,44,46,FMN GV 05 Lier
60,Mechelsesteenweg 365,2019-08-17,16:00:00,32,12,20,FMN GV 05 Lier
60,Mechelsesteenweg 365,2019-08-17,17:00:00,38,10,28,FMN GV 05 Lier
60,Mechelsesteenweg 365,2019-08-17,18:00:00,24,12,12,FMN GV 05 Lier
60,Mechelsesteenweg 365,2019-08-17,19:00:00,10,2,8,FMN GV 05 Lier
60,Mechelsesteenweg 365,2019-08-17,20:00:00,12,4,8,FMN GV 05 Lier
60,Mechelsesteenweg 365,2019-08-17,21:00:00,6,0,6,FMN GV 05 Lier
60,Mechelsesteenweg 365,2019-08-17,22:00:00,8,4,4,FMN GV 05 Lier
60,Mechelsesteenweg 365,2019-08-17,23:00:00,8,2,6,FMN GV 05 Lier
60,Mechelsesteenweg 365,2019-08-18,00:00:00,2,2,0,FMN GV 05 Lier
60,Mechelsesteenweg 365,2019-08-18,01:00:00,0,0,0,FMN GV 05 Lier
60,Mechelsesteenweg 365,2019-08-18,02:00:00,0,0,0,FMN GV 05 Lier
60,Mechelsesteenweg 365,2019-08-18,03:00:00,0,0,0,FMN GV 05 Lier
60,Mechelsesteenweg 365,2019-08-18,04:00:00,0,0,0,FMN GV 05 Lier
60,Mechelsesteenweg 365,2019-08-18,05:00:00,2,2,0,FMN GV 05 Lier
60,Mechelsesteenweg 365,2019-08-18,06:00:00,0,0,0,FMN GV 05 Lier
60,Mechelsesteenweg 365,2019-08-18,07:00:00,2,0,2,FMN GV 05 Lier
60,Mechelsesteenweg 365,2019-08-18,08:00:00,6,0,6,FMN GV 05 Lier
60,Mechelsesteenweg 365,2019-08-18,09:00:00,20,20,0,FMN GV 05 Lier
60,Mechelsesteenweg 365,2019-08-18,10:00:00,10,2,8,FMN GV 05 Lier
60,Mechelsesteenweg 365,2019-08-18,11:00:00,48,32,16,FMN GV 05 Lier
60,Mechelsesteenweg 365,2019-08-18,12:00:00,30,14,16,FMN GV 05 Lier
60,Mechelsesteenweg 365,2019-08-18,13:00:00,108,84,24,FMN GV 05 Lier
60,Mechelsesteenweg 365,2019-08-18,14:00:00,96,40,56,FMN GV 05 Lier
60,Mechelsesteenweg 365,2019-08-18,15:00:00,132,46,86,FMN GV 05 Lier
60,Mechelsesteenweg 365,2019-08-18,16:00:00,126,66,60,FMN GV 05 Lier
60,Mechelsesteenweg 365,2019-08-18,17:00:00,90,36,54,FMN GV 05 Lier
60,Mechelsesteenweg 365,2019-08-18,18:00:00,84,42,42,FMN GV 05 Lier
60,Mechelsesteenweg 365,2019-08-18,19:00:00,46,28,18,FMN GV 05 Lier
60,Mechelsesteenweg 365,2019-08-18,20:00:00,14,2,12,FMN GV 05 Lier
60,Mechelsesteenweg 365,2019-08-18,21:00:00,8,2,6,FMN GV 05 Lier
60,Mechelsesteenweg 365,2019-08-18,22:00:00,2,0,2,FMN GV 05 Lier
60,Mechelsesteenweg 365,2019-08-18,23:00:00,4,2,2,FMN GV 05 Lier
60,Mechelsesteenweg 365,2019-08-19,00:00:00,2,2,0,FMN GV 05 Lier
60,Mechelsesteenweg 365,2019-08-19,01:00:00,0,0,0,FMN GV 05 Lier
60,Mechelsesteenweg 365,2019-08-19,02:00:00,0,0,0,FMN GV 05 Lier
60,Mechelsesteenweg 365,2019-08-19,03:00:00,2,0,2,FMN GV 05 Lier
60,Mechelsesteenweg 365,2019-08-19,04:00:00,4,0,4,FMN GV 05 Lier
60,Mechelsesteenweg 365,2019-08-19,05:00:00,4,0,4,FMN GV 05 Lier
60,Mechelsesteenweg 365,2019-08-19,06:00:00,26,8,18,FMN GV 05 Lier
60,Mechelsesteenweg 365,2019-08-19,07:00:00,88,18,70,FMN GV 05 Lier
60,Mechelsesteenweg 365,2019-08-19,08:00:00,58,24,34,FMN GV 05 Lier
60,Mechelsesteenweg 365,2019-08-19,09:00:00,66,38,28,FMN GV 05 Lier
60,Mechelsesteenweg 365,2019-08-19,10:00:00,90,56,34,FMN GV 05 Lier
60,Mechelsesteenweg 365,2019-08-19,11:00:00,92,34,58,FMN GV 05 Lier
60,Mechelsesteenweg 365,2019-08-19,12:00:00,92,44,48,FMN GV 05 Lier
60,Mechelsesteenweg 365,2019-08-19,13:00:00,88,50,38,FMN GV 05 Lier
60,Mechelsesteenweg 365,2019-08-19,14:00:00,152,74,78,FMN GV 05 Lier
60,Mechelsesteenweg 365,2019-08-19,15:00:00,178,102,76,FMN GV 05 Lier
60,Mechelsesteenweg 365,2019-08-19,16:00:00,110,72,38,FMN GV 05 Lier
60,Mechelsesteenweg 365,2019-08-19,17:00:00,154,100,54,FMN GV 05 Lier
60,Mechelsesteenweg 365,2019-08-19,18:00:00,100,56,44,FMN GV 05 Lier
60,Mechelsesteenweg 365,2019-08-19,19:00:00,88,58,30,FMN GV 05 Lier
60,Mechelsesteenweg 365,2019-08-19,20:00:00,64,24,40,FMN GV 05 Lier
60,Mechelsesteenweg 365,2019-08-19,21:00:00,24,8,16,FMN GV 05 Lier
60,Mechelsesteenweg 365,2019-08-19,22:00:00,2,0,2,FMN GV 05 Lier
60,Mechelsesteenweg 365,2019-08-19,23:00:00,2,0,2,FMN GV 05 Lier
60,Mechelsesteenweg 365,2019-08-20,00:00:00,22,18,4,FMN GV 05 Lier
60,Mechelsesteenweg 365,2019-08-20,01:00:00,0,0,0,FMN GV 05 Lier
60,Mechelsesteenweg 365,2019-08-20,02:00:00,0,0,0,FMN GV 05 Lier
60,Mechelsesteenweg 365,2019-08-20,03:00:00,2,0,2,FMN GV 05 Lier
60,Mechelsesteenweg 365,2019-08-20,04:00:00,4,2,2,FMN GV 05 Lier
60,Mechelsesteenweg 365,2019-08-20,05:00:00,8,2,6,FMN GV 05 Lier
60,Mechelsesteenweg 365,2019-08-20,06:00:00,50,10,40,FMN GV 05 Lier
60,Mechelsesteenweg 365,2019-08-20,07:00:00,102,38,64,FMN GV 05 Lier
60,Mechelsesteenweg 365,2019-08-20,08:00:00,98,42,56,FMN GV 05 Lier
60,Mechelsesteenweg 365,2019-08-20,09:00:00,84,34,50,FMN GV 05 Lier
60,Mechelsesteenweg 365,2019-08-20,10:00:00,178,80,98,FMN GV 05 Lier
60,Mechelsesteenweg 365,2019-08-20,11:00:00,162,96,66,FMN GV 05 Lier
60,Mechelsesteenweg 365,2019-08-20,12:00:00,170,100,70,FMN GV 05 Lier
60,Mechelsesteenweg 365,2019-08-20,13:00:00,202,104,98,FMN GV 05 Lier
60,Mechelsesteenweg 365,2019-08-20,14:00:00,252,164,88,FMN GV 05 Lier
60,Mechelsesteenweg 365,2019-08-20,15:00:00,198,66,132,FMN GV 05 Lier
60,Mechelsesteenweg 365,2019-08-20,16:00:00,266,172,94,FMN GV 05 Lier
60,Mechelsesteenweg 365,2019-08-20,17:00:00,212,104,108,FMN GV 05 Lier
60,Mechelsesteenweg 365,2019-08-20,18:00:00,136,86,50,FMN GV 05 Lier
60,Mechelsesteenweg 365,2019-08-20,19:00:00,144,72,72,FMN GV 05 Lier
60,Mechelsesteenweg 365,2019-08-20,20:00:00,108,26,82,FMN GV 05 Lier
60,Mechelsesteenweg 365,2019-08-20,21:00:00,12,4,8,FMN GV 05 Lier
60,Mechelsesteenweg 365,2019-08-20,22:00:00,10,8,2,FMN GV 05 Lier
60,Mechelsesteenweg 365,2019-08-20,23:00:00,4,0,4,FMN GV 05 Lier
60,Mechelsesteenweg 365,2019-08-21,00:00:00,4,0,4,FMN GV 05 Lier
60,Mechelsesteenweg 365,2019-08-21,01:00:00,0,0,0,FMN GV 05 Lier
60,Mechelsesteenweg 365,2019-08-21,02:00:00,0,0,0,FMN GV 05 Lier
60,Mechelsesteenweg 365,2019-08-21,03:00:00,2,0,2,FMN GV 05 Lier
60,Mechelsesteenweg 365,2019-08-21,04:00:00,2,0,2,FMN GV 05 Lier
60,Mechelsesteenweg 365,2019-08-21,05:00:00,6,2,4,FMN GV 05 Lier
60,Mechelsesteenweg 365,2019-08-21,06:00:00,38,10,28,FMN GV 05 Lier
60,Mechelsesteenweg 365,2019-08-21,07:00:00,102,32,70,FMN GV 05 Lier
60,Mechelsesteenweg 365,2019-08-21,08:00:00,70,18,52,FMN GV 05 Lier
60,Mechelsesteenweg 365,2019-08-21,09:00:00,86,46,40,FMN GV 05 Lier
60,Mechelsesteenweg 365,2019-08-21,10:00:00,136,84,52,FMN GV 05 Lier
60,Mechelsesteenweg 365,2019-08-21,11:00:00,146,90,56,FMN GV 05 Lier
60,Mechelsesteenweg 365,2019-08-21,12:00:00,150,70,80,FMN GV 05 Lier
60,Mechelsesteenweg 365,2019-08-21,13:00:00,310,172,138,FMN GV 05 Lier
60,Mechelsesteenweg 365,2019-08-21,14:00:00,344,176,168,FMN GV 05 Lier
60,Mechelsesteenweg 365,2019-08-21,15:00:00,270,144,126,FMN GV 05 Lier
60,Mechelsesteenweg 365,2019-08-21,16:00:00,354,154,200,FMN GV 05 Lier
60,Mechelsesteenweg 365,2019-08-21,17:00:00,264,102,162,FMN GV 05 Lier
60,Mechelsesteenweg 365,2019-08-21,18:00:00,170,90,80,FMN GV 05 Lier
60,Mechelsesteenweg 365,2019-08-21,19:00:00,194,134,60,FMN GV 05 Lier
60,Mechelsesteenweg 365,2019-08-21,20:00:00,140,84,56,FMN GV 05 Lier
60,Mechelsesteenweg 365,2019-08-21,21:00:00,38,12,26,FMN GV 05 Lier
60,Mechelsesteenweg 365,2019-08-21,22:00:00,14,6,8,FMN GV 05 Lier
60,Mechelsesteenweg 365,2019-08-21,23:00:00,2,2,0,FMN GV 05 Lier
60,Mechelsesteenweg 365,2019-08-22,00:00:00,2,2,0,FMN GV 05 Lier
60,Mechelsesteenweg 365,2019-08-22,01:00:00,0,0,0,FMN GV 05 Lier
60,Mechelsesteenweg 365,2019-08-22,02:00:00,0,0,0,FMN GV 05 Lier
60,Mechelsesteenweg 365,2019-08-22,03:00:00,2,0,2,FMN GV 05 Lier
60,Mechelsesteenweg 365,2019-08-22,04:00:00,0,0,0,FMN GV 05 Lier
60,Mechelsesteenweg 365,2019-08-22,05:00:00,8,2,6,FMN GV 05 Lier
60,Mechelsesteenweg 365,2019-08-22,06:00:00,44,12,32,FMN GV 05 Lier
60,Mechelsesteenweg 365,2019-08-22,07:00:00,104,28,76,FMN GV 05 Lier
60,Mechelsesteenweg 365,2019-08-22,08:00:00,92,28,64,FMN GV 05 Lier
60,Mechelsesteenweg 365,2019-08-22,09:00:00,72,46,26,FMN GV 05 Lier
60,Mechelsesteenweg 365,2019-08-22,10:00:00,166,90,76,FMN GV 05 Lier
60,Mechelsesteenweg 365,2019-08-22,11:00:00,244,84,160,FMN GV 05 Lier
60,Mechelsesteenweg 365,2019-08-22,12:00:00,196,94,102,FMN GV 05 Lier
60,Mechelsesteenweg 365,2019-08-22,13:00:00,346,208,138,FMN GV 05 Lier
60,Mechelsesteenweg 365,2019-08-22,14:00:00,350,174,176,FMN GV 05 Lier
60,Mechelsesteenweg 365,2019-08-22,15:00:00,430,216,214,FMN GV 05 Lier
60,Mechelsesteenweg 365,2019-08-22,16:00:00,298,136,162,FMN GV 05 Lier
60,Mechelsesteenweg 365,2019-08-22,17:00:00,286,136,150,FMN GV 05 Lier
60,Mechelsesteenweg 365,2019-08-22,18:00:00,182,92,90,FMN GV 05 Lier
60,Mechelsesteenweg 365,2019-08-22,19:00:00,222,106,116,FMN GV 05 Lier
60,Mechelsesteenweg 365,2019-08-22,20:00:00,126,48,78,FMN GV 05 Lier
60,Mechelsesteenweg 365,2019-08-22,21:00:00,36,6,30,FMN GV 05 Lier
60,Mechelsesteenweg 365,2019-08-22,22:00:00,30,12,18,FMN GV 05 Lier
60,Mechelsesteenweg 365,2019-08-22,23:00:00,4,2,2,FMN GV 05 Lier
60,Mechelsesteenweg 365,2019-08-23,00:00:00,10,6,4,FMN GV 05 Lier
60,Mechelsesteenweg 365,2019-08-23,01:00:00,4,4,0,FMN GV 05 Lier
60,Mechelsesteenweg 365,2019-08-23,02:00:00,0,0,0,FMN GV 05 Lier
60,Mechelsesteenweg 365,2019-08-23,03:00:00,2,0,2,FMN GV 05 Lier
60,Mechelsesteenweg 365,2019-08-23,04:00:00,0,0,0,FMN GV 05 Lier
60,Mechelsesteenweg 365,2019-08-23,05:00:00,8,2,6,FMN GV 05 Lier
60,Mechelsesteenweg 365,2019-08-23,06:00:00,16,6,10,FMN GV 05 Lier
60,Mechelsesteenweg 365,2019-08-23,07:00:00,110,36,74,FMN GV 05 Lier
60,Mechelsesteenweg 365,2019-08-23,08:00:00,86,28,58,FMN GV 05 Lier
60,Mechelsesteenweg 365,2019-08-23,09:00:00,158,122,36,FMN GV 05 Lier
60,Mechelsesteenweg 365,2019-08-23,10:00:00,216,98,118,FMN GV 05 Lier
60,Mechelsesteenweg 365,2019-08-23,11:00:00,208,112,96,FMN GV 05 Lier
60,Mechelsesteenweg 365,2019-08-23,12:00:00,210,80,130,FMN GV 05 Lier
60,Mechelsesteenweg 365,2019-08-23,13:00:00,220,124,96,FMN GV 05 Lier
60,Mechelsesteenweg 365,2019-08-23,14:00:00,318,154,164,FMN GV 05 Lier
60,Mechelsesteenweg 365,2019-08-23,15:00:00,302,144,158,FMN GV 05 Lier
60,Mechelsesteenweg 365,2019-08-23,16:00:00,306,134,172,FMN GV 05 Lier
60,Mechelsesteenweg 365,2019-08-23,17:00:00,224,130,94,FMN GV 05 Lier
60,Mechelsesteenweg 365,2019-08-23,18:00:00,180,90,90,FMN GV 05 Lier
60,Mechelsesteenweg 365,2019-08-23,19:00:00,116,52,64,FMN GV 05 Lier
60,Mechelsesteenweg 365,2019-08-23,20:00:00,88,24,64,FMN GV 05 Lier
60,Mechelsesteenweg 365,2019-08-23,21:00:00,56,16,40,FMN GV 05 Lier
60,Mechelsesteenweg 365,2019-08-23,22:00:00,14,8,6,FMN GV 05 Lier
60,Mechelsesteenweg 365,2019-08-23,23:00:00,8,8,0,FMN GV 05 Lier
60,Mechelsesteenweg 365,2019-08-24,00:00:00,10,2,8,FMN GV 05 Lier
60,Mechelsesteenweg 365,2019-08-24,01:00:00,6,4,2,FMN GV 05 Lier
60,Mechelsesteenweg 365,2019-08-24,02:00:00,0,0,0,FMN GV 05 Lier
60,Mechelsesteenweg 365,2019-08-24,03:00:00,4,4,0,FMN GV 05 Lier
60,Mechelsesteenweg 365,2019-08-24,04:00:00,0,0,0,FMN GV 05 Lier
60,Mechelsesteenweg 365,2019-08-24,05:00:00,0,0,0,FMN GV 05 Lier
60,Mechelsesteenweg 365,2019-08-24,06:00:00,6,4,2,FMN GV 05 Lier
60,Mechelsesteenweg 365,2019-08-24,07:00:00,24,8,16,FMN GV 05 Lier
60,Mechelsesteenweg 365,2019-08-24,08:00:00,60,28,32,FMN GV 05 Lier
60,Mechelsesteenweg 365,2019-08-24,09:00:00,132,74,58,FMN GV 05 Lier
60,Mechelsesteenweg 365,2019-08-24,10:00:00,302,152,150,FMN GV 05 Lier
60,Mechelsesteenweg 365,2019-08-24,11:00:00,330,134,196,FMN GV 05 Lier
60,Mechelsesteenweg 365,2019-08-24,12:00:00,246,118,128,FMN GV 05 Lier
60,Mechelsesteenweg 365,2019-08-24,13:00:00,276,110,166,FMN GV 05 Lier
60,Mechelsesteenweg 365,2019-08-24,14:00:00,394,228,166,FMN GV 05 Lier
60,Mechelsesteenweg 365,2019-08-24,15:00:00,368,160,208,FMN GV 05 Lier
60,Mechelsesteenweg 365,2019-08-24,16:00:00,244,70,174,FMN GV 05 Lier
60,Mechelsesteenweg 365,2019-08-24,17:00:00,202,96,106,FMN GV 05 Lier
60,Mechelsesteenweg 365,2019-08-24,18:00:00,132,64,68,FMN GV 05 Lier
60,Mechelsesteenweg 365,2019-08-24,19:00:00,116,52,64,FMN GV 05 Lier
60,Mechelsesteenweg 365,2019-08-24,20:00:00,78,34,44,FMN GV 05 Lier
60,Mechelsesteenweg 365,2019-08-24,21:00:00,30,14,16,FMN GV 05 Lier
60,Mechelsesteenweg 365,2019-08-24,22:00:00,12,2,10,FMN GV 05 Lier
60,Mechelsesteenweg 365,2019-08-24,23:00:00,4,2,2,FMN GV 05 Lier
60,Mechelsesteenweg 365,2019-08-25,00:00:00,6,0,6,FMN GV 05 Lier
60,Mechelsesteenweg 365,2019-08-25,01:00:00,2,2,0,FMN GV 05 Lier
60,Mechelsesteenweg 365,2019-08-25,02:00:00,10,8,2,FMN GV 05 Lier
60,Mechelsesteenweg 365,2019-08-25,03:00:00,6,6,0,FMN GV 05 Lier
60,Mechelsesteenweg 365,2019-08-25,04:00:00,6,0,6,FMN GV 05 Lier
60,Mechelsesteenweg 365,2019-08-25,05:00:00,2,0,2,FMN GV 05 Lier
60,Mechelsesteenweg 365,2019-08-25,06:00:00,0,0,0,FMN GV 05 Lier
60,Mechelsesteenweg 365,2019-08-25,07:00:00,20,8,12,FMN GV 05 Lier
60,Mechelsesteenweg 365,2019-08-25,08:00:00,98,62,36,FMN GV 05 Lier
60,Mechelsesteenweg 365,2019-08-25,09:00:00,238,126,112,FMN GV 05 Lier
60,Mechelsesteenweg 365,2019-08-25,10:00:00,456,186,270,FMN GV 05 Lier
60,Mechelsesteenweg 365,2019-08-25,11:00:00,486,178,308,FMN GV 05 Lier
60,Mechelsesteenweg 365,2019-08-25,12:00:00,406,202,204,FMN GV 05 Lier
60,Mechelsesteenweg 365,2019-08-25,13:00:00,352,176,176,FMN GV 05 Lier
60,Mechelsesteenweg 365,2019-08-25,14:00:00,368,162,206,FMN GV 05 Lier
60,Mechelsesteenweg 365,2019-08-25,15:00:00,474,198,276,FMN GV 05 Lier
60,Mechelsesteenweg 365,2019-08-25,16:00:00,262,106,156,FMN GV 05 Lier
60,Mechelsesteenweg 365,2019-08-25,17:00:00,236,120,116,FMN GV 05 Lier
60,Mechelsesteenweg 365,2019-08-25,18:00:00,138,50,88,FMN GV 05 Lier
60,Mechelsesteenweg 365,2019-08-25,19:00:00,174,62,112,FMN GV 05 Lier
60,Mechelsesteenweg 365,2019-08-25,20:00:00,116,42,74,FMN GV 05 Lier
60,Mechelsesteenweg 365,2019-08-25,21:00:00,44,10,34,FMN GV 05 Lier
60,Mechelsesteenweg 365,2019-08-25,22:00:00,12,6,6,FMN GV 05 Lier
60,Mechelsesteenweg 365,2019-08-25,23:00:00,8,4,4,FMN GV 05 Lier
60,Mechelsesteenweg 365,2019-08-26,00:00:00,12,4,8,FMN GV 05 Lier
60,Mechelsesteenweg 365,2019-08-26,01:00:00,0,0,0,FMN GV 05 Lier
60,Mechelsesteenweg 365,2019-08-26,02:00:00,0,0,0,FMN GV 05 Lier
60,Mechelsesteenweg 365,2019-08-26,03:00:00,2,0,2,FMN GV 05 Lier
60,Mechelsesteenweg 365,2019-08-26,04:00:00,0,0,0,FMN GV 05 Lier
60,Mechelsesteenweg 365,2019-08-26,05:00:00,2,0,2,FMN GV 05 Lier
60,Mechelsesteenweg 365,2019-08-26,06:00:00,18,4,14,FMN GV 05 Lier
60,Mechelsesteenweg 365,2019-08-26,07:00:00,116,24,92,FMN GV 05 Lier
60,Mechelsesteenweg 365,2019-08-26,08:00:00,100,42,58,FMN GV 05 Lier
60,Mechelsesteenweg 365,2019-08-26,09:00:00,108,48,60,FMN GV 05 Lier
60,Mechelsesteenweg 365,2019-08-26,10:00:00,112,58,54,FMN GV 05 Lier
60,Mechelsesteenweg 365,2019-08-26,11:00:00,202,92,110,FMN GV 05 Lier
60,Mechelsesteenweg 365,2019-08-26,12:00:00,154,80,74,FMN GV 05 Lier
60,Mechelsesteenweg 365,2019-08-26,13:00:00,174,88,86,FMN GV 05 Lier
60,Mechelsesteenweg 365,2019-08-26,14:00:00,178,94,84,FMN GV 05 Lier
60,Mechelsesteenweg 365,2019-08-26,15:00:00,160,74,86,FMN GV 05 Lier
60,Mechelsesteenweg 365,2019-08-26,16:00:00,202,84,118,FMN GV 05 Lier
60,Mechelsesteenweg 365,2019-08-26,17:00:00,184,104,80,FMN GV 05 Lier
60,Mechelsesteenweg 365,2019-08-26,18:00:00,140,80,60,FMN GV 05 Lier
60,Mechelsesteenweg 365,2019-08-26,19:00:00,118,60,58,FMN GV 05 Lier
60,Mechelsesteenweg 365,2019-08-26,20:00:00,108,28,80,FMN GV 05 Lier
60,Mechelsesteenweg 365,2019-08-26,21:00:00,40,12,28,FMN GV 05 Lier
60,Mechelsesteenweg 365,2019-08-26,22:00:00,16,8,8,FMN GV 05 Lier
60,Mechelsesteenweg 365,2019-08-26,23:00:00,2,0,2,FMN GV 05 Lier
60,Mechelsesteenweg 365,2019-08-27,00:00:00,2,0,2,FMN GV 05 Lier
60,Mechelsesteenweg 365,2019-08-27,01:00:00,0,0,0,FMN GV 05 Lier
60,Mechelsesteenweg 365,2019-08-27,02:00:00,0,0,0,FMN GV 05 Lier
60,Mechelsesteenweg 365,2019-08-27,03:00:00,2,0,2,FMN GV 05 Lier
60,Mechelsesteenweg 365,2019-08-27,04:00:00,0,0,0,FMN GV 05 Lier
60,Mechelsesteenweg 365,2019-08-27,05:00:00,10,4,6,FMN GV 05 Lier
60,Mechelsesteenweg 365,2019-08-27,06:00:00,38,8,30,FMN GV 05 Lier
60,Mechelsesteenweg 365,2019-08-27,07:00:00,138,52,86,FMN GV 05 Lier
60,Mechelsesteenweg 365,2019-08-27,08:00:00,164,56,108,FMN GV 05 Lier
60,Mechelsesteenweg 365,2019-08-27,09:00:00,166,78,88,FMN GV 05 Lier
60,Mechelsesteenweg 365,2019-08-27,10:00:00,200,96,104,FMN GV 05 Lier
60,Mechelsesteenweg 365,2019-08-27,11:00:00,154,82,72,FMN GV 05 Lier
60,Mechelsesteenweg 365,2019-08-27,12:00:00,132,68,64,FMN GV 05 Lier
60,Mechelsesteenweg 365,2019-08-27,13:00:00,164,72,92,FMN GV 05 Lier
60,Mechelsesteenweg 365,2019-08-27,14:00:00,106,68,38,FMN GV 05 Lier
60,Mechelsesteenweg 365,2019-08-27,15:00:00,148,76,72,FMN GV 05 Lier
60,Mechelsesteenweg 365,2019-08-27,16:00:00,170,78,92,FMN GV 05 Lier
60,Mechelsesteenweg 365,2019-08-27,17:00:00,232,142,90,FMN GV 05 Lier
60,Mechelsesteenweg 365,2019-08-27,18:00:00,124,68,56,FMN GV 05 Lier
60,Mechelsesteenweg 365,2019-08-27,19:00:00,172,72,100,FMN GV 05 Lier
60,Mechelsesteenweg 365,2019-08-27,20:00:00,116,58,58,FMN GV 05 Lier
60,Mechelsesteenweg 365,2019-08-27,21:00:00,60,22,38,FMN GV 05 Lier
60,Mechelsesteenweg 365,2019-08-27,22:00:00,30,14,16,FMN GV 05 Lier
60,Mechelsesteenweg 365,2019-08-27,23:00:00,0,0,0,FMN GV 05 Lier
60,Mechelsesteenweg 365,2019-08-28,00:00:00,0,0,0,FMN GV 05 Lier
60,Mechelsesteenweg 365,2019-08-28,01:00:00,0,0,0,FMN GV 05 Lier
60,Mechelsesteenweg 365,2019-08-28,02:00:00,0,0,0,FMN GV 05 Lier
60,Mechelsesteenweg 365,2019-08-28,03:00:00,8,4,4,FMN GV 05 Lier
60,Mechelsesteenweg 365,2019-08-28,04:00:00,0,0,0,FMN GV 05 Lier
60,Mechelsesteenweg 365,2019-08-28,05:00:00,8,4,4,FMN GV 05 Lier
60,Mechelsesteenweg 365,2019-08-28,06:00:00,36,12,24,FMN GV 05 Lier
60,Mechelsesteenweg 365,2019-08-28,07:00:00,126,42,84,FMN GV 05 Lier
60,Mechelsesteenweg 365,2019-08-28,08:00:00,68,38,30,FMN GV 05 Lier
60,Mechelsesteenweg 365,2019-08-28,09:00:00,48,26,22,FMN GV 05 Lier
60,Mechelsesteenweg 365,2019-08-28,10:00:00,76,50,26,FMN GV 05 Lier
60,Mechelsesteenweg 365,2019-08-28,11:00:00,98,50,48,FMN GV 05 Lier
60,Mechelsesteenweg 365,2019-08-28,12:00:00,84,24,60,FMN GV 05 Lier
60,Mechelsesteenweg 365,2019-08-28,13:00:00,136,70,66,FMN GV 05 Lier
60,Mechelsesteenweg 365,2019-08-28,14:00:00,140,96,44,FMN GV 05 Lier
60,Mechelsesteenweg 365,2019-08-28,15:00:00,166,98,68,FMN GV 05 Lier
60,Mechelsesteenweg 365,2019-08-28,16:00:00,224,112,112,FMN GV 05 Lier
60,Mechelsesteenweg 365,2019-08-28,17:00:00,138,66,72,FMN GV 05 Lier
60,Mechelsesteenweg 365,2019-08-28,18:00:00,106,52,54,FMN GV 05 Lier
60,Mechelsesteenweg 365,2019-08-28,19:00:00,118,70,48,FMN GV 05 Lier
60,Mechelsesteenweg 365,2019-08-28,20:00:00,160,82,78,FMN GV 05 Lier
60,Mechelsesteenweg 365,2019-08-28,21:00:00,16,8,8,FMN GV 05 Lier
60,Mechelsesteenweg 365,2019-08-28,22:00:00,8,2,6,FMN GV 05 Lier
60,Mechelsesteenweg 365,2019-08-28,23:00:00,4,2,2,FMN GV 05 Lier
60,Mechelsesteenweg 365,2019-08-29,00:00:00,8,0,8,FMN GV 05 Lier
60,Mechelsesteenweg 365,2019-08-29,01:00:00,2,0,2,FMN GV 05 Lier
60,Mechelsesteenweg 365,2019-08-29,02:00:00,0,0,0,FMN GV 05 Lier
60,Mechelsesteenweg 365,2019-08-29,03:00:00,2,0,2,FMN GV 05 Lier
60,Mechelsesteenweg 365,2019-08-29,04:00:00,2,0,2,FMN GV 05 Lier
60,Mechelsesteenweg 365,2019-08-29,05:00:00,0,0,0,FMN GV 05 Lier
60,Mechelsesteenweg 365,2019-08-29,06:00:00,22,4,18,FMN GV 05 Lier
60,Mechelsesteenweg 365,2019-08-29,07:00:00,106,36,70,FMN GV 05 Lier
60,Mechelsesteenweg 365,2019-08-29,08:00:00,112,42,70,FMN GV 05 Lier
60,Mechelsesteenweg 365,2019-08-29,09:00:00,100,54,46,FMN GV 05 Lier
60,Mechelsesteenweg 365,2019-08-29,10:00:00,140,84,56,FMN GV 05 Lier
60,Mechelsesteenweg 365,2019-08-29,11:00:00,98,44,54,FMN GV 05 Lier
60,Mechelsesteenweg 365,2019-08-29,12:00:00,98,52,46,FMN GV 05 Lier
60,Mechelsesteenweg 365,2019-08-29,13:00:00,138,58,80,FMN GV 05 Lier
60,Mechelsesteenweg 365,2019-08-29,14:00:00,156,102,54,FMN GV 05 Lier
60,Mechelsesteenweg 365,2019-08-29,15:00:00,152,60,92,FMN GV 05 Lier
60,Mechelsesteenweg 365,2019-08-29,16:00:00,166,104,62,FMN GV 05 Lier
60,Mechelsesteenweg 365,2019-08-29,17:00:00,162,90,72,FMN GV 05 Lier
60,Mechelsesteenweg 365,2019-08-29,18:00:00,134,68,66,FMN GV 05 Lier
60,Mechelsesteenweg 365,2019-08-29,19:00:00,126,48,78,FMN GV 05 Lier
60,Mechelsesteenweg 365,2019-08-29,20:00:00,152,52,100,FMN GV 05 Lier
60,Mechelsesteenweg 365,2019-08-29,21:00:00,8,6,2,FMN GV 05 Lier
60,Mechelsesteenweg 365,2019-08-29,22:00:00,16,8,8,FMN GV 05 Lier
60,Mechelsesteenweg 365,2019-08-29,23:00:00,2,2,0,FMN GV 05 Lier
60,Mechelsesteenweg 365,2019-08-30,00:00:00,0,0,0,FMN GV 05 Lier
60,Mechelsesteenweg 365,2019-08-30,01:00:00,0,0,0,FMN GV 05 Lier
60,Mechelsesteenweg 365,2019-08-30,02:00:00,0,0,0,FMN GV 05 Lier
60,Mechelsesteenweg 365,2019-08-30,03:00:00,2,0,2,FMN GV 05 Lier
60,Mechelsesteenweg 365,2019-08-30,04:00:00,2,0,2,FMN GV 05 Lier
60,Mechelsesteenweg 365,2019-08-30,05:00:00,4,0,4,FMN GV 05 Lier
60,Mechelsesteenweg 365,2019-08-30,06:00:00,24,10,14,FMN GV 05 Lier
60,Mechelsesteenweg 365,2019-08-30,07:00:00,86,30,56,FMN GV 05 Lier
60,Mechelsesteenweg 365,2019-08-30,08:00:00,94,46,48,FMN GV 05 Lier
60,Mechelsesteenweg 365,2019-08-30,09:00:00,60,26,34,FMN GV 05 Lier
60,Mechelsesteenweg 365,2019-08-30,10:00:00,150,78,72,FMN GV 05 Lier
60,Mechelsesteenweg 365,2019-08-30,11:00:00,214,92,122,FMN GV 05 Lier
60,Mechelsesteenweg 365,2019-08-30,12:00:00,142,68,74,FMN GV 05 Lier
60,Mechelsesteenweg 365,2019-08-30,13:00:00,212,104,108,FMN GV 05 Lier
60,Mechelsesteenweg 365,2019-08-30,14:00:00,298,184,114,FMN GV 05 Lier
60,Mechelsesteenweg 365,2019-08-30,15:00:00,292,138,154,FMN GV 05 Lier
60,Mechelsesteenweg 365,2019-08-30,16:00:00,264,128,136,FMN GV 05 Lier
60,Mechelsesteenweg 365,2019-08-30,17:00:00,208,98,110,FMN GV 05 Lier
60,Mechelsesteenweg 365,2019-08-30,18:00:00,136,58,78,FMN GV 05 Lier
60,Mechelsesteenweg 365,2019-08-30,19:00:00,86,46,40,FMN GV 05 Lier
60,Mechelsesteenweg 365,2019-08-30,20:00:00,90,26,64,FMN GV 05 Lier
60,Mechelsesteenweg 365,2019-08-30,21:00:00,40,18,22,FMN GV 05 Lier
60,Mechelsesteenweg 365,2019-08-30,22:00:00,10,0,10,FMN GV 05 Lier
60,Mechelsesteenweg 365,2019-08-30,23:00:00,8,6,2,FMN GV 05 Lier
60,Mechelsesteenweg 365,2019-08-31,00:00:00,0,0,0,FMN GV 05 Lier
60,Mechelsesteenweg 365,2019-08-31,01:00:00,4,0,4,FMN GV 05 Lier
60,Mechelsesteenweg 365,2019-08-31,02:00:00,2,0,2,FMN GV 05 Lier
60,Mechelsesteenweg 365,2019-08-31,03:00:00,0,0,0,FMN GV 05 Lier
60,Mechelsesteenweg 365,2019-08-31,04:00:00,0,0,0,FMN GV 05 Lier
60,Mechelsesteenweg 365,2019-08-31,05:00:00,0,0,0,FMN GV 05 Lier
60,Mechelsesteenweg 365,2019-08-31,06:00:00,6,2,4,FMN GV 05 Lier
60,Mechelsesteenweg 365,2019-08-31,07:00:00,16,8,8,FMN GV 05 Lier
60,Mechelsesteenweg 365,2019-08-31,08:00:00,58,34,24,FMN GV 05 Lier
60,Mechelsesteenweg 365,2019-08-31,09:00:00,164,102,62,FMN GV 05 Lier
60,Mechelsesteenweg 365,2019-08-31,10:00:00,286,134,152,FMN GV 05 Lier
60,Mechelsesteenweg 365,2019-08-31,11:00:00,274,122,152,FMN GV 05 Lier
60,Mechelsesteenweg 365,2019-08-31,12:00:00,274,126,148,FMN GV 05 Lier
60,Mechelsesteenweg 365,2019-08-31,13:00:00,252,130,122,FMN GV 05 Lier
60,Mechelsesteenweg 365,2019-08-31,14:00:00,326,152,174,FMN GV 05 Lier
60,Mechelsesteenweg 365,2019-08-31,15:00:00,282,158,124,FMN GV 05 Lier
60,Mechelsesteenweg 365,2019-08-31,16:00:00,344,94,250,FMN GV 05 Lier
60,Mechelsesteenweg 365,2019-08-31,17:00:00,170,78,92,FMN GV 05 Lier
60,Mechelsesteenweg 365,2019-08-31,18:00:00,142,48,94,FMN GV 05 Lier
60,Mechelsesteenweg 365,2019-08-31,19:00:00,78,20,58,FMN GV 05 Lier
60,Mechelsesteenweg 365,2019-08-31,20:00:00,44,18,26,FMN GV 05 Lier
60,Mechelsesteenweg 365,2019-08-31,21:00:00,28,2,26,FMN GV 05 Lier
60,Mechelsesteenweg 365,2019-08-31,22:00:00,4,0,4,FMN GV 05 Lier
60,Mechelsesteenweg 365,2019-08-31,23:00:00,6,0,6,FMN GV 05 Lier
60,Mechelsesteenweg 365,2019-09-01,00:00:00,4,2,2,FMN GV 05 Lier
60,Mechelsesteenweg 365,2019-09-01,01:00:00,0,0,0,FMN GV 05 Lier
60,Mechelsesteenweg 365,2019-09-01,02:00:00,0,0,0,FMN GV 05 Lier
60,Mechelsesteenweg 365,2019-09-01,03:00:00,2,0,2,FMN GV 05 Lier
60,Mechelsesteenweg 365,2019-09-01,04:00:00,0,0,0,FMN GV 05 Lier
60,Mechelsesteenweg 365,2019-09-01,05:00:00,0,0,0,FMN GV 05 Lier
60,Mechelsesteenweg 365,2019-09-01,06:00:00,2,0,2,FMN GV 05 Lier
60,Mechelsesteenweg 365,2019-09-01,07:00:00,6,6,0,FMN GV 05 Lier
60,Mechelsesteenweg 365,2019-09-01,08:00:00,28,10,18,FMN GV 05 Lier
60,Mechelsesteenweg 365,2019-09-01,09:00:00,146,84,62,FMN GV 05 Lier
60,Mechelsesteenweg 365,2019-09-01,10:00:00,304,130,174,FMN GV 05 Lier
60,Mechelsesteenweg 365,2019-09-01,11:00:00,294,136,158,FMN GV 05 Lier
60,Mechelsesteenweg 365,2019-09-01,12:00:00,142,72,70,FMN GV 05 Lier
60,Mechelsesteenweg 365,2019-09-01,13:00:00,214,130,84,FMN GV 05 Lier
60,Mechelsesteenweg 365,2019-09-01,14:00:00,368,180,188,FMN GV 05 Lier
60,Mechelsesteenweg 365,2019-09-01,15:00:00,312,170,142,FMN GV 05 Lier
60,Mechelsesteenweg 365,2019-09-01,16:00:00,272,86,186,FMN GV 05 Lier
60,Mechelsesteenweg 365,2019-09-01,17:00:00,188,92,96,FMN GV 05 Lier
60,Mechelsesteenweg 365,2019-09-01,18:00:00,142,44,98,FMN GV 05 Lier
60,Mechelsesteenweg 365,2019-09-01,19:00:00,66,16,50,FMN GV 05 Lier
60,Mechelsesteenweg 365,2019-09-01,20:00:00,30,16,14,FMN GV 05 Lier
60,Mechelsesteenweg 365,2019-09-01,21:00:00,6,0,6,FMN GV 05 Lier
60,Mechelsesteenweg 365,2019-09-01,22:00:00,6,2,4,FMN GV 05 Lier
60,Mechelsesteenweg 365,2019-09-01,23:00:00,0,0,0,FMN GV 05 Lier
60,Mechelsesteenweg 365,2019-09-02,00:00:00,0,0,0,FMN GV 05 Lier
60,Mechelsesteenweg 365,2019-09-02,01:00:00,0,0,0,FMN GV 05 Lier
60,Mechelsesteenweg 365,2019-09-02,02:00:00,0,0,0,FMN GV 05 Lier
60,Mechelsesteenweg 365,2019-09-02,03:00:00,0,0,0,FMN GV 05 Lier
60,Mechelsesteenweg 365,2019-09-02,04:00:00,2,0,2,FMN GV 05 Lier
60,Mechelsesteenweg 365,2019-09-02,05:00:00,4,4,0,FMN GV 05 Lier
60,Mechelsesteenweg 365,2019-09-02,06:00:00,28,8,20,FMN GV 05 Lier
60,Mechelsesteenweg 365,2019-09-02,07:00:00,172,86,86,FMN GV 05 Lier
60,Mechelsesteenweg 365,2019-09-02,08:00:00,214,138,76,FMN GV 05 Lier
60,Mechelsesteenweg 365,2019-09-02,09:00:00,110,86,24,FMN GV 05 Lier
60,Mechelsesteenweg 365,2019-09-02,10:00:00,116,36,80,FMN GV 05 Lier
60,Mechelsesteenweg 365,2019-09-02,11:00:00,142,46,96,FMN GV 05 Lier
60,Mechelsesteenweg 365,2019-09-02,12:00:00,160,56,104,FMN GV 05 Lier
60,Mechelsesteenweg 365,2019-09-02,13:00:00,216,110,106,FMN GV 05 Lier
60,Mechelsesteenweg 365,2019-09-02,14:00:00,200,108,92,FMN GV 05 Lier
60,Mechelsesteenweg 365,2019-09-02,15:00:00,228,100,128,FMN GV 05 Lier
60,Mechelsesteenweg 365,2019-09-02,16:00:00,236,76,160,FMN GV 05 Lier
60,Mechelsesteenweg 365,2019-09-02,17:00:00,234,132,102,FMN GV 05 Lier
60,Mechelsesteenweg 365,2019-09-02,18:00:00,122,66,56,FMN GV 05 Lier
60,Mechelsesteenweg 365,2019-09-02,19:00:00,102,40,62,FMN GV 05 Lier
60,Mechelsesteenweg 365,2019-09-02,20:00:00,42,22,20,FMN GV 05 Lier
60,Mechelsesteenweg 365,2019-09-02,21:00:00,16,0,16,FMN GV 05 Lier
60,Mechelsesteenweg 365,2019-09-02,22:00:00,20,4,16,FMN GV 05 Lier
60,Mechelsesteenweg 365,2019-09-02,23:00:00,2,2,0,FMN GV 05 Lier
60,Mechelsesteenweg 365,2019-09-03,00:00:00,2,0,2,FMN GV 05 Lier
60,Mechelsesteenweg 365,2019-09-03,01:00:00,0,0,0,FMN GV 05 Lier
60,Mechelsesteenweg 365,2019-09-03,02:00:00,0,0,0,FMN GV 05 Lier
60,Mechelsesteenweg 365,2019-09-03,03:00:00,0,0,0,FMN GV 05 Lier
60,Mechelsesteenweg 365,2019-09-03,04:00:00,4,0,4,FMN GV 05 Lier
60,Mechelsesteenweg 365,2019-09-03,05:00:00,6,2,4,FMN GV 05 Lier
60,Mechelsesteenweg 365,2019-09-03,06:00:00,36,16,20,FMN GV 05 Lier
60,Mechelsesteenweg 365,2019-09-03,07:00:00,270,160,110,FMN GV 05 Lier
60,Mechelsesteenweg 365,2019-09-03,08:00:00,180,96,84,FMN GV 05 Lier
60,Mechelsesteenweg 365,2019-09-03,09:00:00,76,34,42,FMN GV 05 Lier
60,Mechelsesteenweg 365,2019-09-03,10:00:00,122,58,64,FMN GV 05 Lier
60,Mechelsesteenweg 365,2019-09-03,11:00:00,126,74,52,FMN GV 05 Lier
60,Mechelsesteenweg 365,2019-09-03,12:00:00,118,64,54,FMN GV 05 Lier
60,Mechelsesteenweg 365,2019-09-03,13:00:00,140,48,92,FMN GV 05 Lier
60,Mechelsesteenweg 365,2019-09-03,14:00:00,122,62,60,FMN GV 05 Lier
60,Mechelsesteenweg 365,2019-09-03,15:00:00,150,78,72,FMN GV 05 Lier
60,Mechelsesteenweg 365,2019-09-03,16:00:00,310,102,208,FMN GV 05 Lier
60,Mechelsesteenweg 365,2019-09-03,17:00:00,200,126,74,FMN GV 05 Lier
60,Mechelsesteenweg 365,2019-09-03,18:00:00,104,62,42,FMN GV 05 Lier
60,Mechelsesteenweg 365,2019-09-03,19:00:00,64,36,28,FMN GV 05 Lier
60,Mechelsesteenweg 365,2019-09-03,20:00:00,56,10,46,FMN GV 05 Lier
60,Mechelsesteenweg 365,2019-09-03,21:00:00,8,2,6,FMN GV 05 Lier
60,Mechelsesteenweg 365,2019-09-03,22:00:00,4,4,0,FMN GV 05 Lier
60,Mechelsesteenweg 365,2019-09-03,23:00:00,0,0,0,FMN GV 05 Lier
60,Mechelsesteenweg 365,2019-09-04,00:00:00,0,0,0,FMN GV 05 Lier
60,Mechelsesteenweg 365,2019-09-04,01:00:00,0,0,0,FMN GV 05 Lier
60,Mechelsesteenweg 365,2019-09-04,02:00:00,10,6,4,FMN GV 05 Lier
60,Mechelsesteenweg 365,2019-09-04,03:00:00,8,2,6,FMN GV 05 Lier
60,Mechelsesteenweg 365,2019-09-04,04:00:00,6,2,4,FMN GV 05 Lier
60,Mechelsesteenweg 365,2019-09-04,05:00:00,6,0,6,FMN GV 05 Lier
60,Mechelsesteenweg 365,2019-09-04,06:00:00,28,8,20,FMN GV 05 Lier
60,Mechelsesteenweg 365,2019-09-04,07:00:00,204,126,78,FMN GV 05 Lier
60,Mechelsesteenweg 365,2019-09-04,08:00:00,140,98,42,FMN GV 05 Lier
60,Mechelsesteenweg 365,2019-09-04,09:00:00,170,48,122,FMN GV 05 Lier
60,Mechelsesteenweg 365,2019-09-04,10:00:00,98,70,28,FMN GV 05 Lier
60,Mechelsesteenweg 365,2019-09-04,11:00:00,160,114,46,FMN GV 05 Lier
60,Mechelsesteenweg 365,2019-09-04,12:00:00,204,50,154,FMN GV 05 Lier
60,Mechelsesteenweg 365,2019-09-04,13:00:00,102,56,46,FMN GV 05 Lier
60,Mechelsesteenweg 365,2019-09-04,14:00:00,58,36,22,FMN GV 05 Lier
60,Mechelsesteenweg 365,2019-09-04,15:00:00,68,28,40,FMN GV 05 Lier
60,Mechelsesteenweg 365,2019-09-04,16:00:00,48,32,16,FMN GV 05 Lier
60,Mechelsesteenweg 365,2019-09-04,17:00:00,70,40,30,FMN GV 05 Lier
60,Mechelsesteenweg 365,2019-09-04,18:00:00,74,54,20,FMN GV 05 Lier
60,Mechelsesteenweg 365,2019-09-04,19:00:00,82,64,18,FMN GV 05 Lier
60,Mechelsesteenweg 365,2019-09-04,20:00:00,54,24,30,FMN GV 05 Lier
60,Mechelsesteenweg 365,2019-09-04,21:00:00,12,0,12,FMN GV 05 Lier
60,Mechelsesteenweg 365,2019-09-04,22:00:00,6,4,2,FMN GV 05 Lier
60,Mechelsesteenweg 365,2019-09-04,23:00:00,0,0,0,FMN GV 05 Lier
60,Mechelsesteenweg 365,2019-09-05,00:00:00,0,0,0,FMN GV 05 Lier
60,Mechelsesteenweg 365,2019-09-05,01:00:00,0,0,0,FMN GV 05 Lier
60,Mechelsesteenweg 365,2019-09-05,02:00:00,0,0,0,FMN GV 05 Lier
60,Mechelsesteenweg 365,2019-09-05,03:00:00,0,0,0,FMN GV 05 Lier
60,Mechelsesteenweg 365,2019-09-05,04:00:00,2,0,2,FMN GV 05 Lier
60,Mechelsesteenweg 365,2019-09-05,05:00:00,4,0,4,FMN GV 05 Lier
60,Mechelsesteenweg 365,2019-09-05,06:00:00,24,8,16,FMN GV 05 Lier
60,Mechelsesteenweg 365,2019-09-05,07:00:00,204,136,68,FMN GV 05 Lier
60,Mechelsesteenweg 365,2019-09-05,08:00:00,158,102,56,FMN GV 05 Lier
60,Mechelsesteenweg 365,2019-09-05,09:00:00,28,22,6,FMN GV 05 Lier
60,Mechelsesteenweg 365,2019-09-05,10:00:00,52,12,40,FMN GV 05 Lier
60,Mechelsesteenweg 365,2019-09-05,11:00:00,34,12,22,FMN GV 05 Lier
60,Mechelsesteenweg 365,2019-09-05,12:00:00,26,14,12,FMN GV 05 Lier
60,Mechelsesteenweg 365,2019-09-05,13:00:00,40,12,28,FMN GV 05 Lier
60,Mechelsesteenweg 365,2019-09-05,14:00:00,88,32,56,FMN GV 05 Lier
60,Mechelsesteenweg 365,2019-09-05,15:00:00,94,46,48,FMN GV 05 Lier
60,Mechelsesteenweg 365,2019-09-05,16:00:00,232,54,178,FMN GV 05 Lier
60,Mechelsesteenweg 365,2019-09-05,17:00:00,100,62,38,FMN GV 05 Lier
60,Mechelsesteenweg 365,2019-09-05,18:00:00,62,28,34,FMN GV 05 Lier
60,Mechelsesteenweg 365,2019-09-05,19:00:00,94,52,42,FMN GV 05 Lier
60,Mechelsesteenweg 365,2019-09-05,20:00:00,50,26,24,FMN GV 05 Lier
60,Mechelsesteenweg 365,2019-09-05,21:00:00,6,0,6,FMN GV 05 Lier
60,Mechelsesteenweg 365,2019-09-05,22:00:00,10,6,4,FMN GV 05 Lier
60,Mechelsesteenweg 365,2019-09-05,23:00:00,2,0,2,FMN GV 05 Lier
60,Mechelsesteenweg 365,2019-09-06,00:00:00,0,0,0,FMN GV 05 Lier
60,Mechelsesteenweg 365,2019-09-06,01:00:00,0,0,0,FMN GV 05 Lier
60,Mechelsesteenweg 365,2019-09-06,02:00:00,4,0,4,FMN GV 05 Lier
60,Mechelsesteenweg 365,2019-09-06,03:00:00,0,0,0,FMN GV 05 Lier
60,Mechelsesteenweg 365,2019-09-06,04:00:00,0,0,0,FMN GV 05 Lier
60,Mechelsesteenweg 365,2019-09-06,05:00:00,6,0,6,FMN GV 05 Lier
60,Mechelsesteenweg 365,2019-09-06,06:00:00,28,12,16,FMN GV 05 Lier
60,Mechelsesteenweg 365,2019-09-06,07:00:00,194,128,66,FMN GV 05 Lier
60,Mechelsesteenweg 365,2019-09-06,08:00:00,154,92,62,FMN GV 05 Lier
60,Mechelsesteenweg 365,2019-09-06,09:00:00,72,50,22,FMN GV 05 Lier
60,Mechelsesteenweg 365,2019-09-06,10:00:00,142,62,80,FMN GV 05 Lier
60,Mechelsesteenweg 365,2019-09-06,11:00:00,206,124,82,FMN GV 05 Lier
60,Mechelsesteenweg 365,2019-09-06,12:00:00,134,58,76,FMN GV 05 Lier
60,Mechelsesteenweg 365,2019-09-06,13:00:00,178,106,72,FMN GV 05 Lier
60,Mechelsesteenweg 365,2019-09-06,14:00:00,166,94,72,FMN GV 05 Lier
60,Mechelsesteenweg 365,2019-09-06,15:00:00,200,108,92,FMN GV 05 Lier
60,Mechelsesteenweg 365,2019-09-06,16:00:00,262,78,184,FMN GV 05 Lier
60,Mechelsesteenweg 365,2019-09-06,17:00:00,164,70,94,FMN GV 05 Lier
60,Mechelsesteenweg 365,2019-09-06,18:00:00,56,28,28,FMN GV 05 Lier
60,Mechelsesteenweg 365,2019-09-06,19:00:00,52,24,28,FMN GV 05 Lier
60,Mechelsesteenweg 365,2019-09-06,20:00:00,30,14,16,FMN GV 05 Lier
60,Mechelsesteenweg 365,2019-09-06,21:00:00,16,8,8,FMN GV 05 Lier
60,Mechelsesteenweg 365,2019-09-06,22:00:00,14,8,6,FMN GV 05 Lier
60,Mechelsesteenweg 365,2019-09-06,23:00:00,2,2,0,FMN GV 05 Lier
60,Mechelsesteenweg 365,2019-09-07,00:00:00,0,0,0,FMN GV 05 Lier
60,Mechelsesteenweg 365,2019-09-07,01:00:00,6,4,2,FMN GV 05 Lier
60,Mechelsesteenweg 365,2019-09-07,02:00:00,2,2,0,FMN GV 05 Lier
60,Mechelsesteenweg 365,2019-09-07,03:00:00,8,2,6,FMN GV 05 Lier
60,Mechelsesteenweg 365,2019-09-07,04:00:00,0,0,0,FMN GV 05 Lier
60,Mechelsesteenweg 365,2019-09-07,05:00:00,0,0,0,FMN GV 05 Lier
60,Mechelsesteenweg 365,2019-09-07,06:00:00,2,2,0,FMN GV 05 Lier
60,Mechelsesteenweg 365,2019-09-07,07:00:00,10,4,6,FMN GV 05 Lier
60,Mechelsesteenweg 365,2019-09-07,08:00:00,28,16,12,FMN GV 05 Lier
60,Mechelsesteenweg 365,2019-09-07,09:00:00,72,50,22,FMN GV 05 Lier
60,Mechelsesteenweg 365,2019-09-07,10:00:00,170,84,86,FMN GV 05 Lier
60,Mechelsesteenweg 365,2019-09-07,11:00:00,110,52,58,FMN GV 05 Lier
60,Mechelsesteenweg 365,2019-09-07,12:00:00,48,22,26,FMN GV 05 Lier
60,Mechelsesteenweg 365,2019-09-07,13:00:00,60,36,24,FMN GV 05 Lier
60,Mechelsesteenweg 365,2019-09-07,14:00:00,76,28,48,FMN GV 05 Lier
60,Mechelsesteenweg 365,2019-09-07,15:00:00,40,20,20,FMN GV 05 Lier
60,Mechelsesteenweg 365,2019-09-07,16:00:00,82,30,52,FMN GV 05 Lier
60,Mechelsesteenweg 365,2019-09-07,17:00:00,50,14,36,FMN GV 05 Lier
60,Mechelsesteenweg 365,2019-09-07,18:00:00,22,2,20,FMN GV 05 Lier
60,Mechelsesteenweg 365,2019-09-07,19:00:00,8,4,4,FMN GV 05 Lier
60,Mechelsesteenweg 365,2019-09-07,20:00:00,16,8,8,FMN GV 05 Lier
60,Mechelsesteenweg 365,2019-09-07,21:00:00,10,2,8,FMN GV 05 Lier
60,Mechelsesteenweg 365,2019-09-07,22:00:00,2,0,2,FMN GV 05 Lier
60,Mechelsesteenweg 365,2019-09-07,23:00:00,0,0,0,FMN GV 05 Lier
60,Mechelsesteenweg 365,2019-09-08,00:00:00,4,4,0,FMN GV 05 Lier
60,Mechelsesteenweg 365,2019-09-08,01:00:00,2,2,0,FMN GV 05 Lier
60,Mechelsesteenweg 365,2019-09-08,02:00:00,0,0,0,FMN GV 05 Lier
60,Mechelsesteenweg 365,2019-09-08,03:00:00,0,0,0,FMN GV 05 Lier
60,Mechelsesteenweg 365,2019-09-08,04:00:00,0,0,0,FMN GV 05 Lier
60,Mechelsesteenweg 365,2019-09-08,05:00:00,0,0,0,FMN GV 05 Lier
60,Mechelsesteenweg 365,2019-09-08,06:00:00,0,0,0,FMN GV 05 Lier
60,Mechelsesteenweg 365,2019-09-08,07:00:00,10,6,4,FMN GV 05 Lier
60,Mechelsesteenweg 365,2019-09-08,08:00:00,36,18,18,FMN GV 05 Lier
60,Mechelsesteenweg 365,2019-09-08,09:00:00,242,154,88,FMN GV 05 Lier
60,Mechelsesteenweg 365,2019-09-08,10:00:00,272,108,164,FMN GV 05 Lier
60,Mechelsesteenweg 365,2019-09-08,11:00:00,406,192,214,FMN GV 05 Lier
60,Mechelsesteenweg 365,2019-09-08,12:00:00,212,82,130,FMN GV 05 Lier
60,Mechelsesteenweg 365,2019-09-08,13:00:00,278,122,156,FMN GV 05 Lier
60,Mechelsesteenweg 365,2019-09-08,14:00:00,272,124,148,FMN GV 05 Lier
60,Mechelsesteenweg 365,2019-09-08,15:00:00,310,120,190,FMN GV 05 Lier
60,Mechelsesteenweg 365,2019-09-08,16:00:00,200,72,128,FMN GV 05 Lier
60,Mechelsesteenweg 365,2019-09-08,17:00:00,136,52,84,FMN GV 05 Lier
60,Mechelsesteenweg 365,2019-09-08,18:00:00,90,44,46,FMN GV 05 Lier
60,Mechelsesteenweg 365,2019-09-08,19:00:00,42,22,20,FMN GV 05 Lier
60,Mechelsesteenweg 365,2019-09-08,20:00:00,36,10,26,FMN GV 05 Lier
60,Mechelsesteenweg 365,2019-09-08,21:00:00,6,2,4,FMN GV 05 Lier
60,Mechelsesteenweg 365,2019-09-08,22:00:00,0,0,0,FMN GV 05 Lier
60,Mechelsesteenweg 365,2019-09-08,23:00:00,6,0,6,FMN GV 05 Lier
60,Mechelsesteenweg 365,2019-09-09,00:00:00,0,0,0,FMN GV 05 Lier
60,Mechelsesteenweg 365,2019-09-09,01:00:00,0,0,0,FMN GV 05 Lier
60,Mechelsesteenweg 365,2019-09-09,02:00:00,0,0,0,FMN GV 05 Lier
60,Mechelsesteenweg 365,2019-09-09,03:00:00,4,0,4,FMN GV 05 Lier
60,Mechelsesteenweg 365,2019-09-09,04:00:00,2,0,2,FMN GV 05 Lier
60,Mechelsesteenweg 365,2019-09-09,05:00:00,4,2,2,FMN GV 05 Lier
60,Mechelsesteenweg 365,2019-09-09,06:00:00,22,10,12,FMN GV 05 Lier
60,Mechelsesteenweg 365,2019-09-09,07:00:00,212,118,94,FMN GV 05 Lier
60,Mechelsesteenweg 365,2019-09-09,08:00:00,178,110,68,FMN GV 05 Lier
60,Mechelsesteenweg 365,2019-09-09,09:00:00,106,40,66,FMN GV 05 Lier
60,Mechelsesteenweg 365,2019-09-09,10:00:00,102,58,44,FMN GV 05 Lier
60,Mechelsesteenweg 365,2019-09-09,11:00:00,186,120,66,FMN GV 05 Lier
60,Mechelsesteenweg 365,2019-09-09,12:00:00,118,62,56,FMN GV 05 Lier
60,Mechelsesteenweg 365,2019-09-09,13:00:00,122,52,70,FMN GV 05 Lier
60,Mechelsesteenweg 365,2019-09-09,14:00:00,154,62,92,FMN GV 05 Lier
60,Mechelsesteenweg 365,2019-09-09,15:00:00,190,86,104,FMN GV 05 Lier
60,Mechelsesteenweg 365,2019-09-09,16:00:00,352,118,234,FMN GV 05 Lier
60,Mechelsesteenweg 365,2019-09-09,17:00:00,178,96,82,FMN GV 05 Lier
60,Mechelsesteenweg 365,2019-09-09,18:00:00,88,46,42,FMN GV 05 Lier
60,Mechelsesteenweg 365,2019-09-09,19:00:00,42,18,24,FMN GV 05 Lier
60,Mechelsesteenweg 365,2019-09-09,20:00:00,28,8,20,FMN GV 05 Lier
60,Mechelsesteenweg 365,2019-09-09,21:00:00,10,2,8,FMN GV 05 Lier
60,Mechelsesteenweg 365,2019-09-09,22:00:00,6,0,6,FMN GV 05 Lier
60,Mechelsesteenweg 365,2019-09-09,23:00:00,0,0,0,FMN GV 05 Lier
60,Mechelsesteenweg 365,2019-09-10,00:00:00,0,0,0,FMN GV 05 Lier
60,Mechelsesteenweg 365,2019-09-10,01:00:00,0,0,0,FMN GV 05 Lier
60,Mechelsesteenweg 365,2019-09-10,02:00:00,0,0,0,FMN GV 05 Lier
60,Mechelsesteenweg 365,2019-09-10,03:00:00,0,0,0,FMN GV 05 Lier
60,Mechelsesteenweg 365,2019-09-10,04:00:00,2,0,2,FMN GV 05 Lier
60,Mechelsesteenweg 365,2019-09-10,05:00:00,4,0,4,FMN GV 05 Lier
60,Mechelsesteenweg 365,2019-09-10,06:00:00,40,14,26,FMN GV 05 Lier
60,Mechelsesteenweg 365,2019-09-10,07:00:00,278,164,114,FMN GV 05 Lier
60,Mechelsesteenweg 365,2019-09-10,08:00:00,194,122,72,FMN GV 05 Lier
60,Mechelsesteenweg 365,2019-09-10,09:00:00,72,44,28,FMN GV 05 Lier
60,Mechelsesteenweg 365,2019-09-10,10:00:00,160,86,74,FMN GV 05 Lier
60,Mechelsesteenweg 365,2019-09-10,11:00:00,148,58,90,FMN GV 05 Lier
60,Mechelsesteenweg 365,2019-09-10,12:00:00,158,100,58,FMN GV 05 Lier
60,Mechelsesteenweg 365,2019-09-10,13:00:00,224,92,132,FMN GV 05 Lier
60,Mechelsesteenweg 365,2019-09-10,14:00:00,260,102,158,FMN GV 05 Lier
60,Mechelsesteenweg 365,2019-09-10,15:00:00,286,128,158,FMN GV 05 Lier
60,Mechelsesteenweg 365,2019-09-10,16:00:00,432,164,268,FMN GV 05 Lier
60,Mechelsesteenweg 365,2019-09-10,17:00:00,246,110,136,FMN GV 05 Lier
60,Mechelsesteenweg 365,2019-09-10,18:00:00,122,80,42,FMN GV 05 Lier
60,Mechelsesteenweg 365,2019-09-10,19:00:00,70,32,38,FMN GV 05 Lier
60,Mechelsesteenweg 365,2019-09-10,20:00:00,56,26,30,FMN GV 05 Lier
60,Mechelsesteenweg 365,2019-09-10,21:00:00,12,8,4,FMN GV 05 Lier
60,Mechelsesteenweg 365,2019-09-10,22:00:00,10,2,8,FMN GV 05 Lier
60,Mechelsesteenweg 365,2019-09-10,23:00:00,0,0,0,FMN GV 05 Lier
60,Mechelsesteenweg 365,2019-09-11,00:00:00,0,0,0,FMN GV 05 Lier
60,Mechelsesteenweg 365,2019-09-11,01:00:00,0,0,0,FMN GV 05 Lier
60,Mechelsesteenweg 365,2019-09-11,02:00:00,0,0,0,FMN GV 05 Lier
60,Mechelsesteenweg 365,2019-09-11,03:00:00,0,0,0,FMN GV 05 Lier
60,Mechelsesteenweg 365,2019-09-11,04:00:00,0,0,0,FMN GV 05 Lier
60,Mechelsesteenweg 365,2019-09-11,05:00:00,6,0,6,FMN GV 05 Lier
60,Mechelsesteenweg 365,2019-09-11,06:00:00,20,2,18,FMN GV 05 Lier
60,Mechelsesteenweg 365,2019-09-11,07:00:00,210,146,64,FMN GV 05 Lier
60,Mechelsesteenweg 365,2019-09-11,08:00:00,126,88,38,FMN GV 05 Lier
60,Mechelsesteenweg 365,2019-09-11,09:00:00,30,16,14,FMN GV 05 Lier
60,Mechelsesteenweg 365,2019-09-11,10:00:00,26,20,6,FMN GV 05 Lier
60,Mechelsesteenweg 365,2019-09-11,11:00:00,22,8,14,FMN GV 05 Lier
60,Mechelsesteenweg 365,2019-09-11,12:00:00,160,46,114,FMN GV 05 Lier
60,Mechelsesteenweg 365,2019-09-11,13:00:00,64,18,46,FMN GV 05 Lier
60,Mechelsesteenweg 365,2019-09-11,14:00:00,26,12,14,FMN GV 05 Lier
60,Mechelsesteenweg 365,2019-09-11,15:00:00,30,10,20,FMN GV 05 Lier
60,Mechelsesteenweg 365,2019-09-11,16:00:00,82,44,38,FMN GV 05 Lier
60,Mechelsesteenweg 365,2019-09-11,17:00:00,88,40,48,FMN GV 05 Lier
60,Mechelsesteenweg 365,2019-09-11,18:00:00,44,26,18,FMN GV 05 Lier
60,Mechelsesteenweg 365,2019-09-11,19:00:00,72,46,26,FMN GV 05 Lier
60,Mechelsesteenweg 365,2019-09-11,20:00:00,12,2,10,FMN GV 05 Lier
60,Mechelsesteenweg 365,2019-09-11,21:00:00,18,6,12,FMN GV 05 Lier
60,Mechelsesteenweg 365,2019-09-11,22:00:00,0,0,0,FMN GV 05 Lier
60,Mechelsesteenweg 365,2019-09-11,23:00:00,4,2,2,FMN GV 05 Lier
60,Mechelsesteenweg 365,2019-09-12,00:00:00,0,0,0,FMN GV 05 Lier
60,Mechelsesteenweg 365,2019-09-12,01:00:00,0,0,0,FMN GV 05 Lier
60,Mechelsesteenweg 365,2019-09-12,02:00:00,0,0,0,FMN GV 05 Lier
60,Mechelsesteenweg 365,2019-09-12,03:00:00,0,0,0,FMN GV 05 Lier
60,Mechelsesteenweg 365,2019-09-12,04:00:00,0,0,0,FMN GV 05 Lier
60,Mechelsesteenweg 365,2019-09-12,05:00:00,8,2,6,FMN GV 05 Lier
60,Mechelsesteenweg 365,2019-09-12,06:00:00,30,12,18,FMN GV 05 Lier
60,Mechelsesteenweg 365,2019-09-12,07:00:00,210,124,86,FMN GV 05 Lier
60,Mechelsesteenweg 365,2019-09-12,08:00:00,198,130,68,FMN GV 05 Lier
60,Mechelsesteenweg 365,2019-09-12,09:00:00,74,54,20,FMN GV 05 Lier
60,Mechelsesteenweg 365,2019-09-12,10:00:00,148,58,90,FMN GV 05 Lier
60,Mechelsesteenweg 365,2019-09-12,11:00:00,128,46,82,FMN GV 05 Lier
60,Mechelsesteenweg 365,2019-09-12,12:00:00,146,50,96,FMN GV 05 Lier
60,Mechelsesteenweg 365,2019-09-12,13:00:00,224,122,102,FMN GV 05 Lier
60,Mechelsesteenweg 365,2019-09-12,14:00:00,214,96,118,FMN GV 05 Lier
60,Mechelsesteenweg 365,2019-09-12,15:00:00,290,134,156,FMN GV 05 Lier
60,Mechelsesteenweg 365,2019-09-12,16:00:00,272,114,158,FMN GV 05 Lier
60,Mechelsesteenweg 365,2019-09-12,17:00:00,212,122,90,FMN GV 05 Lier
60,Mechelsesteenweg 365,2019-09-12,18:00:00,130,78,52,FMN GV 05 Lier
60,Mechelsesteenweg 365,2019-09-12,19:00:00,72,38,34,FMN GV 05 Lier
60,Mechelsesteenweg 365,2019-09-12,20:00:00,34,16,18,FMN GV 05 Lier
60,Mechelsesteenweg 365,2019-09-12,21:00:00,14,4,10,FMN GV 05 Lier
60,Mechelsesteenweg 365,2019-09-12,22:00:00,8,4,4,FMN GV 05 Lier
60,Mechelsesteenweg 365,2019-09-12,23:00:00,4,0,4,FMN GV 05 Lier
60,Mechelsesteenweg 365,2019-09-13,00:00:00,4,2,2,FMN GV 05 Lier
60,Mechelsesteenweg 365,2019-09-13,01:00:00,0,0,0,FMN GV 05 Lier
60,Mechelsesteenweg 365,2019-09-13,02:00:00,0,0,0,FMN GV 05 Lier
60,Mechelsesteenweg 365,2019-09-13,03:00:00,0,0,0,FMN GV 05 Lier
60,Mechelsesteenweg 365,2019-09-13,04:00:00,2,0,2,FMN GV 05 Lier
60,Mechelsesteenweg 365,2019-09-13,05:00:00,4,0,4,FMN GV 05 Lier
60,Mechelsesteenweg 365,2019-09-13,06:00:00,20,4,16,FMN GV 05 Lier
60,Mechelsesteenweg 365,2019-09-13,07:00:00,206,122,84,FMN GV 05 Lier
60,Mechelsesteenweg 365,2019-09-13,08:00:00,248,80,168,FMN GV 05 Lier
60,Mechelsesteenweg 365,2019-09-13,09:00:00,152,28,124,FMN GV 05 Lier
60,Mechelsesteenweg 365,2019-09-13,10:00:00,54,22,32,FMN GV 05 Lier
60,Mechelsesteenweg 365,2019-09-13,11:00:00,62,22,40,FMN GV 05 Lier
60,Mechelsesteenweg 365,2019-09-13,12:00:00,60,28,32,FMN GV 05 Lier
60,Mechelsesteenweg 365,2019-09-13,13:00:00,102,62,40,FMN GV 05 Lier
60,Mechelsesteenweg 365,2019-09-13,14:00:00,130,70,60,FMN GV 05 Lier
60,Mechelsesteenweg 365,2019-09-13,15:00:00,384,250,134,FMN GV 05 Lier
60,Mechelsesteenweg 365,2019-09-13,16:00:00,274,104,170,FMN GV 05 Lier
60,Mechelsesteenweg 365,2019-09-13,17:00:00,138,62,76,FMN GV 05 Lier
60,Mechelsesteenweg 365,2019-09-13,18:00:00,84,42,42,FMN GV 05 Lier
60,Mechelsesteenweg 365,2019-09-13,19:00:00,46,18,28,FMN GV 05 Lier
60,Mechelsesteenweg 365,2019-09-13,20:00:00,20,14,6,FMN GV 05 Lier
60,Mechelsesteenweg 365,2019-09-13,21:00:00,4,0,4,FMN GV 05 Lier
60,Mechelsesteenweg 365,2019-09-13,22:00:00,4,2,2,FMN GV 05 Lier
60,Mechelsesteenweg 365,2019-09-13,23:00:00,6,4,2,FMN GV 05 Lier
60,Mechelsesteenweg 365,2019-09-14,00:00:00,2,2,0,FMN GV 05 Lier
60,Mechelsesteenweg 365,2019-09-14,01:00:00,6,2,4,FMN GV 05 Lier
60,Mechelsesteenweg 365,2019-09-14,02:00:00,0,0,0,FMN GV 05 Lier
60,Mechelsesteenweg 365,2019-09-14,03:00:00,0,0,0,FMN GV 05 Lier
60,Mechelsesteenweg 365,2019-09-14,04:00:00,0,0,0,FMN GV 05 Lier
60,Mechelsesteenweg 365,2019-09-14,05:00:00,0,0,0,FMN GV 05 Lier
60,Mechelsesteenweg 365,2019-09-14,06:00:00,4,4,0,FMN GV 05 Lier
60,Mechelsesteenweg 365,2019-09-14,07:00:00,8,4,4,FMN GV 05 Lier
60,Mechelsesteenweg 365,2019-09-14,08:00:00,56,32,24,FMN GV 05 Lier
60,Mechelsesteenweg 365,2019-09-14,09:00:00,118,58,60,FMN GV 05 Lier
60,Mechelsesteenweg 365,2019-09-14,10:00:00,178,110,68,FMN GV 05 Lier
60,Mechelsesteenweg 365,2019-09-14,11:00:00,190,70,120,FMN GV 05 Lier
60,Mechelsesteenweg 365,2019-09-14,12:00:00,258,114,144,FMN GV 05 Lier
60,Mechelsesteenweg 365,2019-09-14,13:00:00,260,144,116,FMN GV 05 Lier
60,Mechelsesteenweg 365,2019-09-14,14:00:00,400,226,174,FMN GV 05 Lier
60,Mechelsesteenweg 365,2019-09-14,15:00:00,382,132,250,FMN GV 05 Lier
60,Mechelsesteenweg 365,2019-09-14,16:00:00,282,116,166,FMN GV 05 Lier
60,Mechelsesteenweg 365,2019-09-14,17:00:00,214,58,156,FMN GV 05 Lier
60,Mechelsesteenweg 365,2019-09-14,18:00:00,86,40,46,FMN GV 05 Lier
60,Mechelsesteenweg 365,2019-09-14,19:00:00,36,18,18,FMN GV 05 Lier
60,Mechelsesteenweg 365,2019-09-14,20:00:00,32,22,10,FMN GV 05 Lier
60,Mechelsesteenweg 365,2019-09-14,21:00:00,6,4,2,FMN GV 05 Lier
60,Mechelsesteenweg 365,2019-09-14,22:00:00,0,0,0,FMN GV 05 Lier
60,Mechelsesteenweg 365,2019-09-14,23:00:00,4,0,4,FMN GV 05 Lier
60,Mechelsesteenweg 365,2019-09-15,00:00:00,2,2,0,FMN GV 05 Lier
60,Mechelsesteenweg 365,2019-09-15,01:00:00,2,2,0,FMN GV 05 Lier
60,Mechelsesteenweg 365,2019-09-15,02:00:00,0,0,0,FMN GV 05 Lier
60,Mechelsesteenweg 365,2019-09-15,03:00:00,4,2,2,FMN GV 05 Lier
60,Mechelsesteenweg 365,2019-09-15,04:00:00,4,4,0,FMN GV 05 Lier
60,Mechelsesteenweg 365,2019-09-15,05:00:00,0,0,0,FMN GV 05 Lier
60,Mechelsesteenweg 365,2019-09-15,06:00:00,0,0,0,FMN GV 05 Lier
60,Mechelsesteenweg 365,2019-09-15,07:00:00,6,4,2,FMN GV 05 Lier
60,Mechelsesteenweg 365,2019-09-15,08:00:00,86,50,36,FMN GV 05 Lier
60,Mechelsesteenweg 365,2019-09-15,09:00:00,262,176,86,FMN GV 05 Lier
60,Mechelsesteenweg 365,2019-09-15,10:00:00,416,186,230,FMN GV 05 Lier
60,Mechelsesteenweg 365,2019-09-15,11:00:00,508,226,282,FMN GV 05 Lier
60,Mechelsesteenweg 365,2019-09-15,12:00:00,386,226,160,FMN GV 05 Lier
60,Mechelsesteenweg 365,2019-09-15,13:00:00,432,220,212,FMN GV 05 Lier
60,Mechelsesteenweg 365,2019-09-15,14:00:00,582,304,278,FMN GV 05 Lier
60,Mechelsesteenweg 365,2019-09-15,15:00:00,582,272,310,FMN GV 05 Lier
60,Mechelsesteenweg 365,2019-09-15,16:00:00,460,208,252,FMN GV 05 Lier
60,Mechelsesteenweg 365,2019-09-15,17:00:00,288,86,202,FMN GV 05 Lier
60,Mechelsesteenweg 365,2019-09-15,18:00:00,110,44,66,FMN GV 05 Lier
60,Mechelsesteenweg 365,2019-09-15,19:00:00,70,36,34,FMN GV 05 Lier
60,Mechelsesteenweg 365,2019-09-15,20:00:00,10,6,4,FMN GV 05 Lier
60,Mechelsesteenweg 365,2019-09-15,21:00:00,4,2,2,FMN GV 05 Lier
60,Mechelsesteenweg 365,2019-09-15,22:00:00,4,4,0,FMN GV 05 Lier
60,Mechelsesteenweg 365,2019-09-15,23:00:00,6,0,6,FMN GV 05 Lier
60,Mechelsesteenweg 365,2019-09-16,00:00:00,0,0,0,FMN GV 05 Lier
60,Mechelsesteenweg 365,2019-09-16,01:00:00,0,0,0,FMN GV 05 Lier
60,Mechelsesteenweg 365,2019-09-16,02:00:00,0,0,0,FMN GV 05 Lier
60,Mechelsesteenweg 365,2019-09-16,03:00:00,0,0,0,FMN GV 05 Lier
60,Mechelsesteenweg 365,2019-09-16,04:00:00,2,0,2,FMN GV 05 Lier
60,Mechelsesteenweg 365,2019-09-16,05:00:00,4,0,4,FMN GV 05 Lier
60,Mechelsesteenweg 365,2019-09-16,06:00:00,24,8,16,FMN GV 05 Lier
60,Mechelsesteenweg 365,2019-09-16,07:00:00,220,138,82,FMN GV 05 Lier
60,Mechelsesteenweg 365,2019-09-16,08:00:00,172,110,62,FMN GV 05 Lier
60,Mechelsesteenweg 365,2019-09-16,09:00:00,122,44,78,FMN GV 05 Lier
60,Mechelsesteenweg 365,2019-09-16,10:00:00,46,18,28,FMN GV 05 Lier
60,Mechelsesteenweg 365,2019-09-16,11:00:00,62,22,40,FMN GV 05 Lier
60,Mechelsesteenweg 365,2019-09-16,12:00:00,68,28,40,FMN GV 05 Lier
60,Mechelsesteenweg 365,2019-09-16,13:00:00,124,38,86,FMN GV 05 Lier
60,Mechelsesteenweg 365,2019-09-16,14:00:00,130,70,60,FMN GV 05 Lier
60,Mechelsesteenweg 365,2019-09-16,15:00:00,70,48,22,FMN GV 05 Lier
60,Mechelsesteenweg 365,2019-09-16,16:00:00,282,70,212,FMN GV 05 Lier
60,Mechelsesteenweg 365,2019-09-16,17:00:00,112,72,40,FMN GV 05 Lier
60,Mechelsesteenweg 365,2019-09-16,18:00:00,70,40,30,FMN GV 05 Lier
60,Mechelsesteenweg 365,2019-09-16,19:00:00,42,26,16,FMN GV 05 Lier
60,Mechelsesteenweg 365,2019-09-16,20:00:00,16,6,10,FMN GV 05 Lier
60,Mechelsesteenweg 365,2019-09-16,21:00:00,22,4,18,FMN GV 05 Lier
60,Mechelsesteenweg 365,2019-09-16,22:00:00,2,2,0,FMN GV 05 Lier
60,Mechelsesteenweg 365,2019-09-16,23:00:00,0,0,0,FMN GV 05 Lier
60,Mechelsesteenweg 365,2019-09-17,00:00:00,0,0,0,FMN GV 05 Lier
60,Mechelsesteenweg 365,2019-09-17,01:00:00,0,0,0,FMN GV 05 Lier
60,Mechelsesteenweg 365,2019-09-17,02:00:00,2,0,2,FMN GV 05 Lier
60,Mechelsesteenweg 365,2019-09-17,03:00:00,0,0,0,FMN GV 05 Lier
60,Mechelsesteenweg 365,2019-09-17,04:00:00,2,0,2,FMN GV 05 Lier
60,Mechelsesteenweg 365,2019-09-17,05:00:00,4,2,2,FMN GV 05 Lier
60,Mechelsesteenweg 365,2019-09-17,06:00:00,40,12,28,FMN GV 05 Lier
60,Mechelsesteenweg 365,2019-09-17,07:00:00,228,114,114,FMN GV 05 Lier
60,Mechelsesteenweg 365,2019-09-17,08:00:00,168,92,76,FMN GV 05 Lier
60,Mechelsesteenweg 365,2019-09-17,09:00:00,108,46,62,FMN GV 05 Lier
60,Mechelsesteenweg 365,2019-09-17,10:00:00,138,72,66,FMN GV 05 Lier
60,Mechelsesteenweg 365,2019-09-17,11:00:00,110,78,32,FMN GV 05 Lier
60,Mechelsesteenweg 365,2019-09-17,12:00:00,126,62,64,FMN GV 05 Lier
60,Mechelsesteenweg 365,2019-09-17,13:00:00,144,86,58,FMN GV 05 Lier
60,Mechelsesteenweg 365,2019-09-17,14:00:00,284,148,136,FMN GV 05 Lier
60,Mechelsesteenweg 365,2019-09-17,15:00:00,174,86,88,FMN GV 05 Lier
60,Mechelsesteenweg 365,2019-09-17,16:00:00,346,122,224,FMN GV 05 Lier
60,Mechelsesteenweg 365,2019-09-17,17:00:00,160,82,78,FMN GV 05 Lier
60,Mechelsesteenweg 365,2019-09-17,18:00:00,82,60,22,FMN GV 05 Lier
60,Mechelsesteenweg 365,2019-09-17,19:00:00,44,22,22,FMN GV 05 Lier
60,Mechelsesteenweg 365,2019-09-17,20:00:00,40,18,22,FMN GV 05 Lier
60,Mechelsesteenweg 365,2019-09-17,21:00:00,16,6,10,FMN GV 05 Lier
60,Mechelsesteenweg 365,2019-09-17,22:00:00,2,0,2,FMN GV 05 Lier
60,Mechelsesteenweg 365,2019-09-17,23:00:00,4,0,4,FMN GV 05 Lier
60,Mechelsesteenweg 365,2019-09-18,00:00:00,0,0,0,FMN GV 05 Lier
60,Mechelsesteenweg 365,2019-09-18,01:00:00,0,0,0,FMN GV 05 Lier
60,Mechelsesteenweg 365,2019-09-18,02:00:00,0,0,0,FMN GV 05 Lier
60,Mechelsesteenweg 365,2019-09-18,03:00:00,0,0,0,FMN GV 05 Lier
60,Mechelsesteenweg 365,2019-09-18,04:00:00,2,0,2,FMN GV 05 Lier
60,Mechelsesteenweg 365,2019-09-18,05:00:00,2,2,0,FMN GV 05 Lier
60,Mechelsesteenweg 365,2019-09-18,06:00:00,34,10,24,FMN GV 05 Lier
60,Mechelsesteenweg 365,2019-09-18,07:00:00,222,112,110,FMN GV 05 Lier
60,Mechelsesteenweg 365,2019-09-18,08:00:00,136,84,52,FMN GV 05 Lier
60,Mechelsesteenweg 365,2019-09-18,09:00:00,58,26,32,FMN GV 05 Lier
60,Mechelsesteenweg 365,2019-09-18,10:00:00,96,52,44,FMN GV 05 Lier
60,Mechelsesteenweg 365,2019-09-18,11:00:00,142,58,84,FMN GV 05 Lier
60,Mechelsesteenweg 365,2019-09-18,12:00:00,224,64,160,FMN GV 05 Lier
60,Mechelsesteenweg 365,2019-09-18,13:00:00,196,78,118,FMN GV 05 Lier
60,Mechelsesteenweg 365,2019-09-18,14:00:00,178,96,82,FMN GV 05 Lier
60,Mechelsesteenweg 365,2019-09-18,15:00:00,174,96,78,FMN GV 05 Lier
60,Mechelsesteenweg 365,2019-09-18,16:00:00,162,80,82,FMN GV 05 Lier
60,Mechelsesteenweg 365,2019-09-18,17:00:00,140,92,48,FMN GV 05 Lier
60,Mechelsesteenweg 365,2019-09-18,18:00:00,88,58,30,FMN GV 05 Lier
60,Mechelsesteenweg 365,2019-09-18,19:00:00,74,50,24,FMN GV 05 Lier
60,Mechelsesteenweg 365,2019-09-18,20:00:00,18,14,4,FMN GV 05 Lier
60,Mechelsesteenweg 365,2019-09-18,21:00:00,10,6,4,FMN GV 05 Lier
60,Mechelsesteenweg 365,2019-09-18,22:00:00,6,4,2,FMN GV 05 Lier
60,Mechelsesteenweg 365,2019-09-18,23:00:00,4,0,4,FMN GV 05 Lier
60,Mechelsesteenweg 365,2019-09-19,00:00:00,2,0,2,FMN GV 05 Lier
60,Mechelsesteenweg 365,2019-09-19,01:00:00,4,2,2,FMN GV 05 Lier
60,Mechelsesteenweg 365,2019-09-19,02:00:00,2,2,0,FMN GV 05 Lier
60,Mechelsesteenweg 365,2019-09-19,03:00:00,2,0,2,FMN GV 05 Lier
60,Mechelsesteenweg 365,2019-09-19,04:00:00,0,0,0,FMN GV 05 Lier
60,Mechelsesteenweg 365,2019-09-19,05:00:00,4,2,2,FMN GV 05 Lier
60,Mechelsesteenweg 365,2019-09-19,06:00:00,52,20,32,FMN GV 05 Lier
60,Mechelsesteenweg 365,2019-09-19,07:00:00,210,122,88,FMN GV 05 Lier
60,Mechelsesteenweg 365,2019-09-19,08:00:00,164,100,64,FMN GV 05 Lier
60,Mechelsesteenweg 365,2019-09-19,09:00:00,146,100,46,FMN GV 05 Lier
60,Mechelsesteenweg 365,2019-09-19,10:00:00,128,52,76,FMN GV 05 Lier
60,Mechelsesteenweg 365,2019-09-19,11:00:00,96,32,64,FMN GV 05 Lier
60,Mechelsesteenweg 365,2019-09-19,12:00:00,118,46,72,FMN GV 05 Lier
60,Mechelsesteenweg 365,2019-09-19,13:00:00,160,92,68,FMN GV 05 Lier
60,Mechelsesteenweg 365,2019-09-19,14:00:00,140,68,72,FMN GV 05 Lier
60,Mechelsesteenweg 365,2019-09-19,15:00:00,212,50,162,FMN GV 05 Lier
60,Mechelsesteenweg 365,2019-09-19,16:00:00,314,86,228,FMN GV 05 Lier
60,Mechelsesteenweg 365,2019-09-19,17:00:00,178,112,66,FMN GV 05 Lier
60,Mechelsesteenweg 365,2019-09-19,18:00:00,102,50,52,FMN GV 05 Lier
60,Mechelsesteenweg 365,2019-09-19,19:00:00,84,54,30,FMN GV 05 Lier
60,Mechelsesteenweg 365,2019-09-19,20:00:00,46,16,30,FMN GV 05 Lier
60,Mechelsesteenweg 365,2019-09-19,21:00:00,10,4,6,FMN GV 05 Lier
60,Mechelsesteenweg 365,2019-09-19,22:00:00,18,10,8,FMN GV 05 Lier
60,Mechelsesteenweg 365,2019-09-19,23:00:00,2,0,2,FMN GV 05 Lier
60,Mechelsesteenweg 365,2019-09-20,00:00:00,0,0,0,FMN GV 05 Lier
60,Mechelsesteenweg 365,2019-09-20,01:00:00,0,0,0,FMN GV 05 Lier
60,Mechelsesteenweg 365,2019-09-20,02:00:00,0,0,0,FMN GV 05 Lier
60,Mechelsesteenweg 365,2019-09-20,03:00:00,2,0,2,FMN GV 05 Lier
60,Mechelsesteenweg 365,2019-09-20,04:00:00,0,0,0,FMN GV 05 Lier
60,Mechelsesteenweg 365,2019-09-20,05:00:00,2,0,2,FMN GV 05 Lier
60,Mechelsesteenweg 365,2019-09-20,06:00:00,16,0,16,FMN GV 05 Lier
60,Mechelsesteenweg 365,2019-09-20,07:00:00,182,98,84,FMN GV 05 Lier
60,Mechelsesteenweg 365,2019-09-20,08:00:00,152,94,58,FMN GV 05 Lier
60,Mechelsesteenweg 365,2019-09-20,09:00:00,94,54,40,FMN GV 05 Lier
60,Mechelsesteenweg 365,2019-09-20,10:00:00,120,50,70,FMN GV 05 Lier
60,Mechelsesteenweg 365,2019-09-20,11:00:00,124,70,54,FMN GV 05 Lier
60,Mechelsesteenweg 365,2019-09-20,12:00:00,146,76,70,FMN GV 05 Lier
60,Mechelsesteenweg 365,2019-09-20,13:00:00,166,66,100,FMN GV 05 Lier
60,Mechelsesteenweg 365,2019-09-20,14:00:00,448,116,332,FMN GV 05 Lier
60,Mechelsesteenweg 365,2019-09-20,15:00:00,232,102,130,FMN GV 05 Lier
60,Mechelsesteenweg 365,2019-09-20,16:00:00,314,120,194,FMN GV 05 Lier
60,Mechelsesteenweg 365,2019-09-20,17:00:00,148,82,66,FMN GV 05 Lier
60,Mechelsesteenweg 365,2019-09-20,18:00:00,72,46,26,FMN GV 05 Lier
60,Mechelsesteenweg 365,2019-09-20,19:00:00,42,12,30,FMN GV 05 Lier
60,Mechelsesteenweg 365,2019-09-20,20:00:00,16,2,14,FMN GV 05 Lier
60,Mechelsesteenweg 365,2019-09-20,21:00:00,8,2,6,FMN GV 05 Lier
60,Mechelsesteenweg 365,2019-09-20,22:00:00,4,2,2,FMN GV 05 Lier
60,Mechelsesteenweg 365,2019-09-20,23:00:00,2,0,2,FMN GV 05 Lier
60,Mechelsesteenweg 365,2019-09-21,00:00:00,0,0,0,FMN GV 05 Lier
60,Mechelsesteenweg 365,2019-09-21,01:00:00,0,0,0,FMN GV 05 Lier
60,Mechelsesteenweg 365,2019-09-21,02:00:00,0,0,0,FMN GV 05 Lier
60,Mechelsesteenweg 365,2019-09-21,03:00:00,2,0,2,FMN GV 05 Lier
60,Mechelsesteenweg 365,2019-09-21,04:00:00,0,0,0,FMN GV 05 Lier
60,Mechelsesteenweg 365,2019-09-21,05:00:00,0,0,0,FMN GV 05 Lier
60,Mechelsesteenweg 365,2019-09-21,06:00:00,6,6,0,FMN GV 05 Lier
60,Mechelsesteenweg 365,2019-09-21,07:00:00,6,2,4,FMN GV 05 Lier
60,Mechelsesteenweg 365,2019-09-21,08:00:00,36,20,16,FMN GV 05 Lier
60,Mechelsesteenweg 365,2019-09-21,09:00:00,102,48,54,FMN GV 05 Lier
60,Mechelsesteenweg 365,2019-09-21,10:00:00,192,82,110,FMN GV 05 Lier
60,Mechelsesteenweg 365,2019-09-21,11:00:00,236,108,128,FMN GV 05 Lier
60,Mechelsesteenweg 365,2019-09-21,12:00:00,166,54,112,FMN GV 05 Lier
60,Mechelsesteenweg 365,2019-09-21,13:00:00,296,162,134,FMN GV 05 Lier
60,Mechelsesteenweg 365,2019-09-21,14:00:00,484,284,200,FMN GV 05 Lier
60,Mechelsesteenweg 365,2019-09-21,15:00:00,474,266,208,FMN GV 05 Lier
60,Mechelsesteenweg 365,2019-09-21,16:00:00,366,140,226,FMN GV 05 Lier
60,Mechelsesteenweg 365,2019-09-21,17:00:00,230,68,162,FMN GV 05 Lier
60,Mechelsesteenweg 365,2019-09-21,18:00:00,102,46,56,FMN GV 05 Lier
60,Mechelsesteenweg 365,2019-09-21,19:00:00,62,20,42,FMN GV 05 Lier
60,Mechelsesteenweg 365,2019-09-21,20:00:00,14,4,10,FMN GV 05 Lier
60,Mechelsesteenweg 365,2019-09-21,21:00:00,10,4,6,FMN GV 05 Lier
60,Mechelsesteenweg 365,2019-09-21,22:00:00,4,2,2,FMN GV 05 Lier
60,Mechelsesteenweg 365,2019-09-21,23:00:00,6,2,4,FMN GV 05 Lier
60,Mechelsesteenweg 365,2019-09-22,00:00:00,6,4,2,FMN GV 05 Lier
60,Mechelsesteenweg 365,2019-09-22,01:00:00,8,6,2,FMN GV 05 Lier
60,Mechelsesteenweg 365,2019-09-22,02:00:00,0,0,0,FMN GV 05 Lier
60,Mechelsesteenweg 365,2019-09-22,03:00:00,2,2,0,FMN GV 05 Lier
60,Mechelsesteenweg 365,2019-09-22,04:00:00,0,0,0,FMN GV 05 Lier
60,Mechelsesteenweg 365,2019-09-22,05:00:00,0,0,0,FMN GV 05 Lier
60,Mechelsesteenweg 365,2019-09-22,06:00:00,2,0,2,FMN GV 05 Lier
60,Mechelsesteenweg 365,2019-09-22,07:00:00,2,0,2,FMN GV 05 Lier
60,Mechelsesteenweg 365,2019-09-22,08:00:00,42,26,16,FMN GV 05 Lier
60,Mechelsesteenweg 365,2019-09-22,09:00:00,144,76,68,FMN GV 05 Lier
60,Mechelsesteenweg 365,2019-09-22,10:00:00,418,198,220,FMN GV 05 Lier
60,Mechelsesteenweg 365,2019-09-22,11:00:00,454,220,234,FMN GV 05 Lier
60,Mechelsesteenweg 365,2019-09-22,12:00:00,284,136,148,FMN GV 05 Lier
60,Mechelsesteenweg 365,2019-09-22,13:00:00,404,200,204,FMN GV 05 Lier
60,Mechelsesteenweg 365,2019-09-22,14:00:00,522,282,240,FMN GV 05 Lier
60,Mechelsesteenweg 365,2019-09-22,15:00:00,416,148,268,FMN GV 05 Lier
60,Mechelsesteenweg 365,2019-09-22,16:00:00,258,92,166,FMN GV 05 Lier
60,Mechelsesteenweg 365,2019-09-22,17:00:00,206,60,146,FMN GV 05 Lier
60,Mechelsesteenweg 365,2019-09-22,18:00:00,46,14,32,FMN GV 05 Lier
60,Mechelsesteenweg 365,2019-09-22,19:00:00,4,2,2,FMN GV 05 Lier
60,Mechelsesteenweg 365,2019-09-22,20:00:00,8,0,8,FMN GV 05 Lier
60,Mechelsesteenweg 365,2019-09-22,21:00:00,0,0,0,FMN GV 05 Lier
60,Mechelsesteenweg 365,2019-09-22,22:00:00,6,2,4,FMN GV 05 Lier
60,Mechelsesteenweg 365,2019-09-22,23:00:00,0,0,0,FMN GV 05 Lier
60,Mechelsesteenweg 365,2019-09-23,00:00:00,0,0,0,FMN GV 05 Lier
60,Mechelsesteenweg 365,2019-09-23,01:00:00,0,0,0,FMN GV 05 Lier
60,Mechelsesteenweg 365,2019-09-23,02:00:00,0,0,0,FMN GV 05 Lier
60,Mechelsesteenweg 365,2019-09-23,03:00:00,0,0,0,FMN GV 05 Lier
60,Mechelsesteenweg 365,2019-09-23,04:00:00,6,0,6,FMN GV 05 Lier
60,Mechelsesteenweg 365,2019-09-23,05:00:00,4,2,2,FMN GV 05 Lier
60,Mechelsesteenweg 365,2019-09-23,06:00:00,18,4,14,FMN GV 05 Lier
60,Mechelsesteenweg 365,2019-09-23,07:00:00,196,100,96,FMN GV 05 Lier
60,Mechelsesteenweg 365,2019-09-23,08:00:00,124,74,50,FMN GV 05 Lier
60,Mechelsesteenweg 365,2019-09-23,09:00:00,170,126,44,FMN GV 05 Lier
60,Mechelsesteenweg 365,2019-09-23,10:00:00,56,26,30,FMN GV 05 Lier
60,Mechelsesteenweg 365,2019-09-23,11:00:00,58,26,32,FMN GV 05 Lier
60,Mechelsesteenweg 365,2019-09-23,12:00:00,82,32,50,FMN GV 05 Lier
60,Mechelsesteenweg 365,2019-09-23,13:00:00,68,44,24,FMN GV 05 Lier
60,Mechelsesteenweg 365,2019-09-23,14:00:00,140,74,66,FMN GV 05 Lier
60,Mechelsesteenweg 365,2019-09-23,15:00:00,230,64,166,FMN GV 05 Lier
60,Mechelsesteenweg 365,2019-09-23,16:00:00,328,122,206,FMN GV 05 Lier
60,Mechelsesteenweg 365,2019-09-23,17:00:00,150,80,70,FMN GV 05 Lier
60,Mechelsesteenweg 365,2019-09-23,18:00:00,96,50,46,FMN GV 05 Lier
60,Mechelsesteenweg 365,2019-09-23,19:00:00,60,38,22,FMN GV 05 Lier
60,Mechelsesteenweg 365,2019-09-23,20:00:00,8,4,4,FMN GV 05 Lier
60,Mechelsesteenweg 365,2019-09-23,21:00:00,8,2,6,FMN GV 05 Lier
60,Mechelsesteenweg 365,2019-09-23,22:00:00,10,4,6,FMN GV 05 Lier
60,Mechelsesteenweg 365,2019-09-23,23:00:00,0,0,0,FMN GV 05 Lier
60,Mechelsesteenweg 365,2019-09-24,00:00:00,0,0,0,FMN GV 05 Lier
60,Mechelsesteenweg 365,2019-09-24,01:00:00,0,0,0,FMN GV 05 Lier
60,Mechelsesteenweg 365,2019-09-24,02:00:00,0,0,0,FMN GV 05 Lier
60,Mechelsesteenweg 365,2019-09-24,03:00:00,0,0,0,FMN GV 05 Lier
60,Mechelsesteenweg 365,2019-09-24,04:00:00,8,0,8,FMN GV 05 Lier
60,Mechelsesteenweg 365,2019-09-24,05:00:00,2,0,2,FMN GV 05 Lier
60,Mechelsesteenweg 365,2019-09-24,06:00:00,22,10,12,FMN GV 05 Lier
60,Mechelsesteenweg 365,2019-09-24,07:00:00,196,122,74,FMN GV 05 Lier
60,Mechelsesteenweg 365,2019-09-24,08:00:00,168,104,64,FMN GV 05 Lier
60,Mechelsesteenweg 365,2019-09-24,09:00:00,38,16,22,FMN GV 05 Lier
60,Mechelsesteenweg 365,2019-09-24,10:00:00,60,36,24,FMN GV 05 Lier
60,Mechelsesteenweg 365,2019-09-24,11:00:00,48,26,22,FMN GV 05 Lier
60,Mechelsesteenweg 365,2019-09-24,12:00:00,46,34,12,FMN GV 05 Lier
60,Mechelsesteenweg 365,2019-09-24,13:00:00,26,8,18,FMN GV 05 Lier
60,Mechelsesteenweg 365,2019-09-24,14:00:00,28,12,16,FMN GV 05 Lier
60,Mechelsesteenweg 365,2019-09-24,15:00:00,92,30,62,FMN GV 05 Lier
60,Mechelsesteenweg 365,2019-09-24,16:00:00,208,62,146,FMN GV 05 Lier
60,Mechelsesteenweg 365,2019-09-24,17:00:00,80,58,22,FMN GV 05 Lier
60,Mechelsesteenweg 365,2019-09-24,18:00:00,42,22,20,FMN GV 05 Lier
60,Mechelsesteenweg 365,2019-09-24,19:00:00,12,8,4,FMN GV 05 Lier
60,Mechelsesteenweg 365,2019-09-24,20:00:00,2,2,0,FMN GV 05 Lier
60,Mechelsesteenweg 365,2019-09-24,21:00:00,2,2,0,FMN GV 05 Lier
60,Mechelsesteenweg 365,2019-09-24,22:00:00,6,2,4,FMN GV 05 Lier
60,Mechelsesteenweg 365,2019-09-24,23:00:00,0,0,0,FMN GV 05 Lier
60,Mechelsesteenweg 365,2019-09-25,00:00:00,0,0,0,FMN GV 05 Lier
60,Mechelsesteenweg 365,2019-09-25,01:00:00,0,0,0,FMN GV 05 Lier
60,Mechelsesteenweg 365,2019-09-25,02:00:00,0,0,0,FMN GV 05 Lier
60,Mechelsesteenweg 365,2019-09-25,03:00:00,0,0,0,FMN GV 05 Lier
60,Mechelsesteenweg 365,2019-09-25,04:00:00,6,0,6,FMN GV 05 Lier
60,Mechelsesteenweg 365,2019-09-25,05:00:00,6,2,4,FMN GV 05 Lier
60,Mechelsesteenweg 365,2019-09-25,06:00:00,12,2,10,FMN GV 05 Lier
60,Mechelsesteenweg 365,2019-09-25,07:00:00,130,62,68,FMN GV 05 Lier
60,Mechelsesteenweg 365,2019-09-25,08:00:00,110,78,32,FMN GV 05 Lier
60,Mechelsesteenweg 365,2019-09-25,09:00:00,42,30,12,FMN GV 05 Lier
60,Mechelsesteenweg 365,2019-09-25,10:00:00,38,16,22,FMN GV 05 Lier
60,Mechelsesteenweg 365,2019-09-25,11:00:00,52,18,34,FMN GV 05 Lier
60,Mechelsesteenweg 365,2019-09-25,12:00:00,154,36,118,FMN GV 05 Lier
60,Mechelsesteenweg 365,2019-09-25,13:00:00,58,18,40,FMN GV 05 Lier
60,Mechelsesteenweg 365,2019-09-25,14:00:00,52,28,24,FMN GV 05 Lier
60,Mechelsesteenweg 365,2019-09-25,15:00:00,34,22,12,FMN GV 05 Lier
60,Mechelsesteenweg 365,2019-09-25,16:00:00,66,40,26,FMN GV 05 Lier
60,Mechelsesteenweg 365,2019-09-25,17:00:00,58,30,28,FMN GV 05 Lier
60,Mechelsesteenweg 365,2019-09-25,18:00:00,38,22,16,FMN GV 05 Lier
60,Mechelsesteenweg 365,2019-09-25,19:00:00,32,16,16,FMN GV 05 Lier
60,Mechelsesteenweg 365,2019-09-25,20:00:00,8,2,6,FMN GV 05 Lier
60,Mechelsesteenweg 365,2019-09-25,21:00:00,2,2,0,FMN GV 05 Lier
60,Mechelsesteenweg 365,2019-09-25,22:00:00,8,4,4,FMN GV 05 Lier
60,Mechelsesteenweg 365,2019-09-25,23:00:00,0,0,0,FMN GV 05 Lier
60,Mechelsesteenweg 365,2019-09-26,00:00:00,0,0,0,FMN GV 05 Lier
60,Mechelsesteenweg 365,2019-09-26,01:00:00,0,0,0,FMN GV 05 Lier
60,Mechelsesteenweg 365,2019-09-26,02:00:00,0,0,0,FMN GV 05 Lier
60,Mechelsesteenweg 365,2019-09-26,03:00:00,2,0,2,FMN GV 05 Lier
60,Mechelsesteenweg 365,2019-09-26,04:00:00,2,0,2,FMN GV 05 Lier
60,Mechelsesteenweg 365,2019-09-26,05:00:00,4,2,2,FMN GV 05 Lier
60,Mechelsesteenweg 365,2019-09-26,06:00:00,8,2,6,FMN GV 05 Lier
60,Mechelsesteenweg 365,2019-09-26,07:00:00,132,80,52,FMN GV 05 Lier
60,Mechelsesteenweg 365,2019-09-26,08:00:00,146,106,40,FMN GV 05 Lier
60,Mechelsesteenweg 365,2019-09-26,09:00:00,12,2,10,FMN GV 05 Lier
60,Mechelsesteenweg 365,2019-09-26,10:00:00,26,14,12,FMN GV 05 Lier
60,Mechelsesteenweg 365,2019-09-26,11:00:00,30,14,16,FMN GV 05 Lier
60,Mechelsesteenweg 365,2019-09-26,12:00:00,26,12,14,FMN GV 05 Lier
60,Mechelsesteenweg 365,2019-09-26,13:00:00,28,8,20,FMN GV 05 Lier
60,Mechelsesteenweg 365,2019-09-26,14:00:00,58,34,24,FMN GV 05 Lier
60,Mechelsesteenweg 365,2019-09-26,15:00:00,50,20,30,FMN GV 05 Lier
60,Mechelsesteenweg 365,2019-09-26,16:00:00,158,40,118,FMN GV 05 Lier
60,Mechelsesteenweg 365,2019-09-26,17:00:00,72,38,34,FMN GV 05 Lier
60,Mechelsesteenweg 365,2019-09-26,18:00:00,46,26,20,FMN GV 05 Lier
60,Mechelsesteenweg 365,2019-09-26,19:00:00,16,14,2,FMN GV 05 Lier
60,Mechelsesteenweg 365,2019-09-26,20:00:00,12,2,10,FMN GV 05 Lier
60,Mechelsesteenweg 365,2019-09-26,21:00:00,6,2,4,FMN GV 05 Lier
60,Mechelsesteenweg 365,2019-09-26,22:00:00,6,4,2,FMN GV 05 Lier
60,Mechelsesteenweg 365,2019-09-26,23:00:00,0,0,0,FMN GV 05 Lier
60,Mechelsesteenweg 365,2019-09-27,00:00:00,4,2,2,FMN GV 05 Lier
60,Mechelsesteenweg 365,2019-09-27,01:00:00,0,0,0,FMN GV 05 Lier
60,Mechelsesteenweg 365,2019-09-27,02:00:00,0,0,0,FMN GV 05 Lier
60,Mechelsesteenweg 365,2019-09-27,03:00:00,0,0,0,FMN GV 05 Lier
60,Mechelsesteenweg 365,2019-09-27,04:00:00,4,0,4,FMN GV 05 Lier
60,Mechelsesteenweg 365,2019-09-27,05:00:00,0,0,0,FMN GV 05 Lier
60,Mechelsesteenweg 365,2019-09-27,06:00:00,12,2,10,FMN GV 05 Lier
60,Mechelsesteenweg 365,2019-09-27,07:00:00,136,82,54,FMN GV 05 Lier
60,Mechelsesteenweg 365,2019-09-27,08:00:00,92,54,38,FMN GV 05 Lier
60,Mechelsesteenweg 365,2019-09-27,09:00:00,58,26,32,FMN GV 05 Lier
60,Mechelsesteenweg 365,2019-09-27,10:00:00,100,42,58,FMN GV 05 Lier
60,Mechelsesteenweg 365,2019-09-27,11:00:00,108,52,56,FMN GV 05 Lier
60,Mechelsesteenweg 365,2019-09-27,12:00:00,72,22,50,FMN GV 05 Lier
60,Mechelsesteenweg 365,2019-09-27,13:00:00,80,28,52,FMN GV 05 Lier
60,Mechelsesteenweg 365,2019-09-27,14:00:00,108,60,48,FMN GV 05 Lier
60,Mechelsesteenweg 365,2019-09-27,15:00:00,94,54,40,FMN GV 05 Lier
60,Mechelsesteenweg 365,2019-09-27,16:00:00,144,62,82,FMN GV 05 Lier
60,Mechelsesteenweg 365,2019-09-27,17:00:00,70,46,24,FMN GV 05 Lier
60,Mechelsesteenweg 365,2019-09-27,18:00:00,52,26,26,FMN GV 05 Lier
60,Mechelsesteenweg 365,2019-09-27,19:00:00,28,20,8,FMN GV 05 Lier
60,Mechelsesteenweg 365,2019-09-27,20:00:00,4,0,4,FMN GV 05 Lier
60,Mechelsesteenweg 365,2019-09-27,21:00:00,18,10,8,FMN GV 05 Lier
60,Mechelsesteenweg 365,2019-09-27,22:00:00,12,4,8,FMN GV 05 Lier
60,Mechelsesteenweg 365,2019-09-27,23:00:00,6,6,0,FMN GV 05 Lier
60,Mechelsesteenweg 365,2019-09-28,00:00:00,0,0,0,FMN GV 05 Lier
60,Mechelsesteenweg 365,2019-09-28,01:00:00,4,0,4,FMN GV 05 Lier
60,Mechelsesteenweg 365,2019-09-28,02:00:00,0,0,0,FMN GV 05 Lier
60,Mechelsesteenweg 365,2019-09-28,03:00:00,8,0,8,FMN GV 05 Lier
60,Mechelsesteenweg 365,2019-09-28,04:00:00,4,0,4,FMN GV 05 Lier
60,Mechelsesteenweg 365,2019-09-28,05:00:00,0,0,0,FMN GV 05 Lier
60,Mechelsesteenweg 365,2019-09-28,06:00:00,0,0,0,FMN GV 05 Lier
60,Mechelsesteenweg 365,2019-09-28,07:00:00,4,2,2,FMN GV 05 Lier
60,Mechelsesteenweg 365,2019-09-28,08:00:00,10,8,2,FMN GV 05 Lier
60,Mechelsesteenweg 365,2019-09-28,09:00:00,52,24,28,FMN GV 05 Lier
60,Mechelsesteenweg 365,2019-09-28,10:00:00,68,30,38,FMN GV 05 Lier
60,Mechelsesteenweg 365,2019-09-28,11:00:00,80,28,52,FMN GV 05 Lier
60,Mechelsesteenweg 365,2019-09-28,12:00:00,38,16,22,FMN GV 05 Lier
60,Mechelsesteenweg 365,2019-09-28,13:00:00,34,28,6,FMN GV 05 Lier
60,Mechelsesteenweg 365,2019-09-28,14:00:00,52,22,30,FMN GV 05 Lier
60,Mechelsesteenweg 365,2019-09-28,15:00:00,56,18,38,FMN GV 05 Lier
60,Mechelsesteenweg 365,2019-09-28,16:00:00,50,34,16,FMN GV 05 Lier
60,Mechelsesteenweg 365,2019-09-28,17:00:00,32,12,20,FMN GV 05 Lier
60,Mechelsesteenweg 365,2019-09-28,18:00:00,16,8,8,FMN GV 05 Lier
60,Mechelsesteenweg 365,2019-09-28,19:00:00,18,6,12,FMN GV 05 Lier
60,Mechelsesteenweg 365,2019-09-28,20:00:00,4,0,4,FMN GV 05 Lier
60,Mechelsesteenweg 365,2019-09-28,21:00:00,2,2,0,FMN GV 05 Lier
60,Mechelsesteenweg 365,2019-09-28,22:00:00,12,4,8,FMN GV 05 Lier
60,Mechelsesteenweg 365,2019-09-28,23:00:00,4,2,2,FMN GV 05 Lier
60,Mechelsesteenweg 365,2019-09-29,00:00:00,2,2,0,FMN GV 05 Lier
60,Mechelsesteenweg 365,2019-09-29,01:00:00,10,6,4,FMN GV 05 Lier
60,Mechelsesteenweg 365,2019-09-29,02:00:00,2,2,0,FMN GV 05 Lier
60,Mechelsesteenweg 365,2019-09-29,03:00:00,0,0,0,FMN GV 05 Lier
60,Mechelsesteenweg 365,2019-09-29,04:00:00,0,0,0,FMN GV 05 Lier
60,Mechelsesteenweg 365,2019-09-29,05:00:00,0,0,0,FMN GV 05 Lier
60,Mechelsesteenweg 365,2019-09-29,06:00:00,0,0,0,FMN GV 05 Lier
60,Mechelsesteenweg 365,2019-09-29,07:00:00,0,0,0,FMN GV 05 Lier
60,Mechelsesteenweg 365,2019-09-29,08:00:00,2,2,0,FMN GV 05 Lier
60,Mechelsesteenweg 365,2019-09-29,09:00:00,30,18,12,FMN GV 05 Lier
60,Mechelsesteenweg 365,2019-09-29,10:00:00,90,48,42,FMN GV 05 Lier
60,Mechelsesteenweg 365,2019-09-29,11:00:00,28,10,18,FMN GV 05 Lier
60,Mechelsesteenweg 365,2019-09-29,12:00:00,30,18,12,FMN GV 05 Lier
60,Mechelsesteenweg 365,2019-09-29,13:00:00,18,8,10,FMN GV 05 Lier
60,Mechelsesteenweg 365,2019-09-29,14:00:00,22,12,10,FMN GV 05 Lier
60,Mechelsesteenweg 365,2019-09-29,15:00:00,20,10,10,FMN GV 05 Lier
60,Mechelsesteenweg 365,2019-09-29,16:00:00,8,0,8,FMN GV 05 Lier
60,Mechelsesteenweg 365,2019-09-29,17:00:00,8,6,2,FMN GV 05 Lier
60,Mechelsesteenweg 365,2019-09-29,18:00:00,8,8,0,FMN GV 05 Lier
60,Mechelsesteenweg 365,2019-09-29,19:00:00,2,2,0,FMN GV 05 Lier
60,Mechelsesteenweg 365,2019-09-29,20:00:00,2,0,2,FMN GV 05 Lier
60,Mechelsesteenweg 365,2019-09-29,21:00:00,2,0,2,FMN GV 05 Lier
60,Mechelsesteenweg 365,2019-09-29,22:00:00,2,0,2,FMN GV 05 Lier
60,Mechelsesteenweg 365,2019-09-29,23:00:00,0,0,0,FMN GV 05 Lier
60,Mechelsesteenweg 365,2019-09-30,00:00:00,4,0,4,FMN GV 05 Lier
60,Mechelsesteenweg 365,2019-09-30,01:00:00,0,0,0,FMN GV 05 Lier
60,Mechelsesteenweg 365,2019-09-30,02:00:00,0,0,0,FMN GV 05 Lier
60,Mechelsesteenweg 365,2019-09-30,03:00:00,0,0,0,FMN GV 05 Lier
60,Mechelsesteenweg 365,2019-09-30,04:00:00,2,0,2,FMN GV 05 Lier
60,Mechelsesteenweg 365,2019-09-30,05:00:00,4,0,4,FMN GV 05 Lier
60,Mechelsesteenweg 365,2019-09-30,06:00:00,24,10,14,FMN GV 05 Lier
60,Mechelsesteenweg 365,2019-09-30,07:00:00,184,110,74,FMN GV 05 Lier
60,Mechelsesteenweg 365,2019-09-30,08:00:00,146,92,54,FMN GV 05 Lier
60,Mechelsesteenweg 365,2019-09-30,09:00:00,44,20,24,FMN GV 05 Lier
60,Mechelsesteenweg 365,2019-09-30,10:00:00,70,46,24,FMN GV 05 Lier
60,Mechelsesteenweg 365,2019-09-30,11:00:00,64,26,38,FMN GV 05 Lier
60,Mechelsesteenweg 365,2019-09-30,12:00:00,92,56,36,FMN GV 05 Lier
60,Mechelsesteenweg 365,2019-09-30,13:00:00,112,64,48,FMN GV 05 Lier
60,Mechelsesteenweg 365,2019-09-30,14:00:00,132,76,56,FMN GV 05 Lier
60,Mechelsesteenweg 365,2019-09-30,15:00:00,186,84,102,FMN GV 05 Lier
60,Mechelsesteenweg 365,2019-09-30,16:00:00,308,112,196,FMN GV 05 Lier
60,Mechelsesteenweg 365,2019-09-30,17:00:00,134,92,42,FMN GV 05 Lier
60,Mechelsesteenweg 365,2019-09-30,18:00:00,70,40,30,FMN GV 05 Lier
60,Mechelsesteenweg 365,2019-09-30,19:00:00,38,16,22,FMN GV 05 Lier
60,Mechelsesteenweg 365,2019-09-30,20:00:00,8,4,4,FMN GV 05 Lier
60,Mechelsesteenweg 365,2019-09-30,21:00:00,6,2,4,FMN GV 05 Lier
60,Mechelsesteenweg 365,2019-09-30,22:00:00,2,2,0,FMN GV 05 Lier
60,Mechelsesteenweg 365,2019-09-30,23:00:00,0,0,0,FMN GV 05 Lier
60,Mechelsesteenweg 365,2019-10-01,00:00:00,0,0,0,FMN GV 05 Lier
60,Mechelsesteenweg 365,2019-10-01,01:00:00,0,0,0,FMN GV 05 Lier
60,Mechelsesteenweg 365,2019-10-01,02:00:00,0,0,0,FMN GV 05 Lier
60,Mechelsesteenweg 365,2019-10-01,03:00:00,0,0,0,FMN GV 05 Lier
60,Mechelsesteenweg 365,2019-10-01,04:00:00,2,0,2,FMN GV 05 Lier
60,Mechelsesteenweg 365,2019-10-01,05:00:00,4,0,4,FMN GV 05 Lier
60,Mechelsesteenweg 365,2019-10-01,06:00:00,24,2,22,FMN GV 05 Lier
60,Mechelsesteenweg 365,2019-10-01,07:00:00,128,80,48,FMN GV 05 Lier
60,Mechelsesteenweg 365,2019-10-01,08:00:00,76,56,20,FMN GV 05 Lier
60,Mechelsesteenweg 365,2019-10-01,09:00:00,24,14,10,FMN GV 05 Lier
60,Mechelsesteenweg 365,2019-10-01,10:00:00,16,8,8,FMN GV 05 Lier
60,Mechelsesteenweg 365,2019-10-01,11:00:00,12,8,4,FMN GV 05 Lier
60,Mechelsesteenweg 365,2019-10-01,12:00:00,22,8,14,FMN GV 05 Lier
60,Mechelsesteenweg 365,2019-10-01,13:00:00,52,18,34,FMN GV 05 Lier
60,Mechelsesteenweg 365,2019-10-01,14:00:00,36,14,22,FMN GV 05 Lier
60,Mechelsesteenweg 365,2019-10-01,15:00:00,40,22,18,FMN GV 05 Lier
60,Mechelsesteenweg 365,2019-10-01,16:00:00,196,66,130,FMN GV 05 Lier
60,Mechelsesteenweg 365,2019-10-01,17:00:00,72,42,30,FMN GV 05 Lier
60,Mechelsesteenweg 365,2019-10-01,18:00:00,32,18,14,FMN GV 05 Lier
60,Mechelsesteenweg 365,2019-10-01,19:00:00,28,20,8,FMN GV 05 Lier
60,Mechelsesteenweg 365,2019-10-01,20:00:00,2,0,2,FMN GV 05 Lier
60,Mechelsesteenweg 365,2019-10-01,21:00:00,14,6,8,FMN GV 05 Lier
60,Mechelsesteenweg 365,2019-10-01,22:00:00,2,2,0,FMN GV 05 Lier
60,Mechelsesteenweg 365,2019-10-01,23:00:00,0,0,0,FMN GV 05 Lier
60,Mechelsesteenweg 365,2019-10-02,00:00:00,0,0,0,FMN GV 05 Lier
60,Mechelsesteenweg 365,2019-10-02,01:00:00,0,0,0,FMN GV 05 Lier
60,Mechelsesteenweg 365,2019-10-02,02:00:00,0,0,0,FMN GV 05 Lier
60,Mechelsesteenweg 365,2019-10-02,03:00:00,2,0,2,FMN GV 05 Lier
60,Mechelsesteenweg 365,2019-10-02,04:00:00,0,0,0,FMN GV 05 Lier
60,Mechelsesteenweg 365,2019-10-02,05:00:00,6,0,6,FMN GV 05 Lier
60,Mechelsesteenweg 365,2019-10-02,06:00:00,22,2,20,FMN GV 05 Lier
60,Mechelsesteenweg 365,2019-10-02,07:00:00,182,106,76,FMN GV 05 Lier
60,Mechelsesteenweg 365,2019-10-02,08:00:00,130,76,54,FMN GV 05 Lier
60,Mechelsesteenweg 365,2019-10-02,09:00:00,116,94,22,FMN GV 05 Lier
60,Mechelsesteenweg 365,2019-10-02,10:00:00,66,42,24,FMN GV 05 Lier
60,Mechelsesteenweg 365,2019-10-02,11:00:00,66,16,50,FMN GV 05 Lier
60,Mechelsesteenweg 365,2019-10-02,12:00:00,244,32,212,FMN GV 05 Lier
60,Mechelsesteenweg 365,2019-10-02,13:00:00,84,34,50,FMN GV 05 Lier
60,Mechelsesteenweg 365,2019-10-02,14:00:00,58,18,40,FMN GV 05 Lier
60,Mechelsesteenweg 365,2019-10-02,15:00:00,28,16,12,FMN GV 05 Lier
60,Mechelsesteenweg 365,2019-10-02,16:00:00,94,56,38,FMN GV 05 Lier
60,Mechelsesteenweg 365,2019-10-02,17:00:00,82,62,20,FMN GV 05 Lier
60,Mechelsesteenweg 365,2019-10-02,18:00:00,58,30,28,FMN GV 05 Lier
60,Mechelsesteenweg 365,2019-10-02,19:00:00,16,14,2,FMN GV 05 Lier
60,Mechelsesteenweg 365,2019-10-02,20:00:00,12,0,12,FMN GV 05 Lier
60,Mechelsesteenweg 365,2019-10-02,21:00:00,2,0,2,FMN GV 05 Lier
60,Mechelsesteenweg 365,2019-10-02,22:00:00,4,4,0,FMN GV 05 Lier
60,Mechelsesteenweg 365,2019-10-02,23:00:00,0,0,0,FMN GV 05 Lier
60,Mechelsesteenweg 365,2019-10-03,00:00:00,0,0,0,FMN GV 05 Lier
60,Mechelsesteenweg 365,2019-10-03,01:00:00,0,0,0,FMN GV 05 Lier
60,Mechelsesteenweg 365,2019-10-03,02:00:00,0,0,0,FMN GV 05 Lier
60,Mechelsesteenweg 365,2019-10-03,03:00:00,0,0,0,FMN GV 05 Lier
60,Mechelsesteenweg 365,2019-10-03,04:00:00,2,0,2,FMN GV 05 Lier
60,Mechelsesteenweg 365,2019-10-03,05:00:00,2,0,2,FMN GV 05 Lier
60,Mechelsesteenweg 365,2019-10-03,06:00:00,20,4,16,FMN GV 05 Lier
60,Mechelsesteenweg 365,2019-10-03,07:00:00,178,98,80,FMN GV 05 Lier
60,Mechelsesteenweg 365,2019-10-03,08:00:00,158,98,60,FMN GV 05 Lier
60,Mechelsesteenweg 365,2019-10-03,09:00:00,34,18,16,FMN GV 05 Lier
60,Mechelsesteenweg 365,2019-10-03,10:00:00,28,22,6,FMN GV 05 Lier
60,Mechelsesteenweg 365,2019-10-03,11:00:00,26,8,18,FMN GV 05 Lier
60,Mechelsesteenweg 365,2019-10-03,12:00:00,92,70,22,FMN GV 05 Lier
60,Mechelsesteenweg 365,2019-10-03,13:00:00,98,50,48,FMN GV 05 Lier
60,Mechelsesteenweg 365,2019-10-03,14:00:00,116,64,52,FMN GV 05 Lier
60,Mechelsesteenweg 365,2019-10-03,15:00:00,114,46,68,FMN GV 05 Lier
60,Mechelsesteenweg 365,2019-10-03,16:00:00,234,72,162,FMN GV 05 Lier
60,Mechelsesteenweg 365,2019-10-03,17:00:00,120,80,40,FMN GV 05 Lier
60,Mechelsesteenweg 365,2019-10-03,18:00:00,84,42,42,FMN GV 05 Lier
60,Mechelsesteenweg 365,2019-10-03,19:00:00,24,12,12,FMN GV 05 Lier
60,Mechelsesteenweg 365,2019-10-03,20:00:00,2,2,0,FMN GV 05 Lier
60,Mechelsesteenweg 365,2019-10-03,21:00:00,2,2,0,FMN GV 05 Lier
60,Mechelsesteenweg 365,2019-10-03,22:00:00,6,2,4,FMN GV 05 Lier
60,Mechelsesteenweg 365,2019-10-03,23:00:00,0,0,0,FMN GV 05 Lier
60,Mechelsesteenweg 365,2019-10-04,00:00:00,0,0,0,FMN GV 05 Lier
60,Mechelsesteenweg 365,2019-10-04,01:00:00,2,0,2,FMN GV 05 Lier
60,Mechelsesteenweg 365,2019-10-04,02:00:00,0,0,0,FMN GV 05 Lier
60,Mechelsesteenweg 365,2019-10-04,03:00:00,0,0,0,FMN GV 05 Lier
60,Mechelsesteenweg 365,2019-10-04,04:00:00,0,0,0,FMN GV 05 Lier
60,Mechelsesteenweg 365,2019-10-04,05:00:00,2,0,2,FMN GV 05 Lier
60,Mechelsesteenweg 365,2019-10-04,06:00:00,10,4,6,FMN GV 05 Lier
60,Mechelsesteenweg 365,2019-10-04,07:00:00,90,52,38,FMN GV 05 Lier
60,Mechelsesteenweg 365,2019-10-04,08:00:00,104,70,34,FMN GV 05 Lier
60,Mechelsesteenweg 365,2019-10-04,09:00:00,70,60,10,FMN GV 05 Lier
60,Mechelsesteenweg 365,2019-10-04,10:00:00,50,24,26,FMN GV 05 Lier
60,Mechelsesteenweg 365,2019-10-04,11:00:00,16,8,8,FMN GV 05 Lier
60,Mechelsesteenweg 365,2019-10-04,12:00:00,26,12,14,FMN GV 05 Lier
60,Mechelsesteenweg 365,2019-10-04,13:00:00,20,8,12,FMN GV 05 Lier
60,Mechelsesteenweg 365,2019-10-04,14:00:00,70,16,54,FMN GV 05 Lier
60,Mechelsesteenweg 365,2019-10-04,15:00:00,56,20,36,FMN GV 05 Lier
60,Mechelsesteenweg 365,2019-10-04,16:00:00,130,42,88,FMN GV 05 Lier
60,Mechelsesteenweg 365,2019-10-04,17:00:00,42,26,16,FMN GV 05 Lier
60,Mechelsesteenweg 365,2019-10-04,18:00:00,30,14,16,FMN GV 05 Lier
60,Mechelsesteenweg 365,2019-10-04,19:00:00,16,8,8,FMN GV 05 Lier
60,Mechelsesteenweg 365,2019-10-04,20:00:00,8,6,2,FMN GV 05 Lier
60,Mechelsesteenweg 365,2019-10-04,21:00:00,6,0,6,FMN GV 05 Lier
60,Mechelsesteenweg 365,2019-10-04,22:00:00,4,4,0,FMN GV 05 Lier
60,Mechelsesteenweg 365,2019-10-04,23:00:00,2,0,2,FMN GV 05 Lier
60,Mechelsesteenweg 365,2019-10-05,00:00:00,0,0,0,FMN GV 05 Lier
60,Mechelsesteenweg 365,2019-10-05,01:00:00,0,0,0,FMN GV 05 Lier
60,Mechelsesteenweg 365,2019-10-05,02:00:00,0,0,0,FMN GV 05 Lier
60,Mechelsesteenweg 365,2019-10-05,03:00:00,0,0,0,FMN GV 05 Lier
60,Mechelsesteenweg 365,2019-10-05,04:00:00,2,0,2,FMN GV 05 Lier
60,Mechelsesteenweg 365,2019-10-05,05:00:00,2,0,2,FMN GV 05 Lier
60,Mechelsesteenweg 365,2019-10-05,06:00:00,4,2,2,FMN GV 05 Lier
60,Mechelsesteenweg 365,2019-10-05,07:00:00,4,2,2,FMN GV 05 Lier
60,Mechelsesteenweg 365,2019-10-05,08:00:00,38,24,14,FMN GV 05 Lier
60,Mechelsesteenweg 365,2019-10-05,09:00:00,60,46,14,FMN GV 05 Lier
60,Mechelsesteenweg 365,2019-10-05,10:00:00,182,92,90,FMN GV 05 Lier
60,Mechelsesteenweg 365,2019-10-05,11:00:00,164,58,106,FMN GV 05 Lier
60,Mechelsesteenweg 365,2019-10-05,12:00:00,126,52,74,FMN GV 05 Lier
60,Mechelsesteenweg 365,2019-10-05,13:00:00,162,110,52,FMN GV 05 Lier
60,Mechelsesteenweg 365,2019-10-05,14:00:00,174,92,82,FMN GV 05 Lier
60,Mechelsesteenweg 365,2019-10-05,15:00:00,178,92,86,FMN GV 05 Lier
60,Mechelsesteenweg 365,2019-10-05,16:00:00,166,70,96,FMN GV 05 Lier
60,Mechelsesteenweg 365,2019-10-05,17:00:00,76,30,46,FMN GV 05 Lier
60,Mechelsesteenweg 365,2019-10-05,18:00:00,40,16,24,FMN GV 05 Lier
60,Mechelsesteenweg 365,2019-10-05,19:00:00,28,12,16,FMN GV 05 Lier
60,Mechelsesteenweg 365,2019-10-05,20:00:00,8,0,8,FMN GV 05 Lier
60,Mechelsesteenweg 365,2019-10-05,21:00:00,8,4,4,FMN GV 05 Lier
60,Mechelsesteenweg 365,2019-10-05,22:00:00,6,4,2,FMN GV 05 Lier
60,Mechelsesteenweg 365,2019-10-05,23:00:00,10,2,8,FMN GV 05 Lier
60,Mechelsesteenweg 365,2019-10-06,00:00:00,2,0,2,FMN GV 05 Lier
60,Mechelsesteenweg 365,2019-10-06,01:00:00,0,0,0,FMN GV 05 Lier
60,Mechelsesteenweg 365,2019-10-06,02:00:00,0,0,0,FMN GV 05 Lier
60,Mechelsesteenweg 365,2019-10-06,03:00:00,0,0,0,FMN GV 05 Lier
60,Mechelsesteenweg 365,2019-10-06,04:00:00,0,0,0,FMN GV 05 Lier
60,Mechelsesteenweg 365,2019-10-06,05:00:00,0,0,0,FMN GV 05 Lier
60,Mechelsesteenweg 365,2019-10-06,06:00:00,0,0,0,FMN GV 05 Lier
60,Mechelsesteenweg 365,2019-10-06,07:00:00,2,2,0,FMN GV 05 Lier
60,Mechelsesteenweg 365,2019-10-06,08:00:00,2,0,2,FMN GV 05 Lier
60,Mechelsesteenweg 365,2019-10-06,09:00:00,18,18,0,FMN GV 05 Lier
60,Mechelsesteenweg 365,2019-10-06,10:00:00,30,10,20,FMN GV 05 Lier
60,Mechelsesteenweg 365,2019-10-06,11:00:00,30,8,22,FMN GV 05 Lier
60,Mechelsesteenweg 365,2019-10-06,12:00:00,22,14,8,FMN GV 05 Lier
60,Mechelsesteenweg 365,2019-10-06,13:00:00,20,8,12,FMN GV 05 Lier
60,Mechelsesteenweg 365,2019-10-06,14:00:00,0,0,0,FMN GV 05 Lier
60,Mechelsesteenweg 365,2019-10-06,15:00:00,10,6,4,FMN GV 05 Lier
60,Mechelsesteenweg 365,2019-10-06,16:00:00,14,10,4,FMN GV 05 Lier
60,Mechelsesteenweg 365,2019-10-06,17:00:00,18,10,8,FMN GV 05 Lier
60,Mechelsesteenweg 365,2019-10-06,18:00:00,10,8,2,FMN GV 05 Lier
60,Mechelsesteenweg 365,2019-10-06,19:00:00,4,2,2,FMN GV 05 Lier
60,Mechelsesteenweg 365,2019-10-06,20:00:00,0,0,0,FMN GV 05 Lier
60,Mechelsesteenweg 365,2019-10-06,21:00:00,2,0,2,FMN GV 05 Lier
60,Mechelsesteenweg 365,2019-10-06,22:00:00,0,0,0,FMN GV 05 Lier
60,Mechelsesteenweg 365,2019-10-06,23:00:00,0,0,0,FMN GV 05 Lier
60,Mechelsesteenweg 365,2019-10-07,00:00:00,0,0,0,FMN GV 05 Lier
60,Mechelsesteenweg 365,2019-10-07,01:00:00,0,0,0,FMN GV 05 Lier
60,Mechelsesteenweg 365,2019-10-07,02:00:00,0,0,0,FMN GV 05 Lier
60,Mechelsesteenweg 365,2019-10-07,03:00:00,0,0,0,FMN GV 05 Lier
60,Mechelsesteenweg 365,2019-10-07,04:00:00,2,0,2,FMN GV 05 Lier
60,Mechelsesteenweg 365,2019-10-07,05:00:00,10,2,8,FMN GV 05 Lier
60,Mechelsesteenweg 365,2019-10-07,06:00:00,12,2,10,FMN GV 05 Lier
60,Mechelsesteenweg 365,2019-10-07,07:00:00,118,36,82,FMN GV 05 Lier
60,Mechelsesteenweg 365,2019-10-07,08:00:00,104,46,58,FMN GV 05 Lier
60,Mechelsesteenweg 365,2019-10-07,09:00:00,52,14,38,FMN GV 05 Lier
60,Mechelsesteenweg 365,2019-10-07,10:00:00,78,44,34,FMN GV 05 Lier
60,Mechelsesteenweg 365,2019-10-07,11:00:00,70,20,50,FMN GV 05 Lier
60,Mechelsesteenweg 365,2019-10-07,12:00:00,74,22,52,FMN GV 05 Lier
60,Mechelsesteenweg 365,2019-10-07,13:00:00,106,60,46,FMN GV 05 Lier
60,Mechelsesteenweg 365,2019-10-07,14:00:00,108,72,36,FMN GV 05 Lier
60,Mechelsesteenweg 365,2019-10-07,15:00:00,114,60,54,FMN GV 05 Lier
60,Mechelsesteenweg 365,2019-10-07,16:00:00,142,78,64,FMN GV 05 Lier
60,Mechelsesteenweg 365,2019-10-07,17:00:00,114,72,42,FMN GV 05 Lier
60,Mechelsesteenweg 365,2019-10-07,18:00:00,84,46,38,FMN GV 05 Lier
60,Mechelsesteenweg 365,2019-10-07,19:00:00,30,22,8,FMN GV 05 Lier
60,Mechelsesteenweg 365,2019-10-07,20:00:00,8,4,4,FMN GV 05 Lier
60,Mechelsesteenweg 365,2019-10-07,21:00:00,2,0,2,FMN GV 05 Lier
60,Mechelsesteenweg 365,2019-10-07,22:00:00,8,4,4,FMN GV 05 Lier
60,Mechelsesteenweg 365,2019-10-07,23:00:00,2,2,0,FMN GV 05 Lier
60,Mechelsesteenweg 365,2019-10-08,00:00:00,0,0,0,FMN GV 05 Lier
60,Mechelsesteenweg 365,2019-10-08,01:00:00,0,0,0,FMN GV 05 Lier
60,Mechelsesteenweg 365,2019-10-08,02:00:00,0,0,0,FMN GV 05 Lier
60,Mechelsesteenweg 365,2019-10-08,03:00:00,2,0,2,FMN GV 05 Lier
60,Mechelsesteenweg 365,2019-10-08,04:00:00,0,0,0,FMN GV 05 Lier
60,Mechelsesteenweg 365,2019-10-08,05:00:00,6,0,6,FMN GV 05 Lier
60,Mechelsesteenweg 365,2019-10-08,06:00:00,18,4,14,FMN GV 05 Lier
60,Mechelsesteenweg 365,2019-10-08,07:00:00,138,90,48,FMN GV 05 Lier
60,Mechelsesteenweg 365,2019-10-08,08:00:00,118,76,42,FMN GV 05 Lier
60,Mechelsesteenweg 365,2019-10-08,09:00:00,26,18,8,FMN GV 05 Lier
60,Mechelsesteenweg 365,2019-10-08,10:00:00,20,8,12,FMN GV 05 Lier
60,Mechelsesteenweg 365,2019-10-08,11:00:00,32,16,16,FMN GV 05 Lier
60,Mechelsesteenweg 365,2019-10-08,12:00:00,46,24,22,FMN GV 05 Lier
60,Mechelsesteenweg 365,2019-10-08,13:00:00,70,28,42,FMN GV 05 Lier
60,Mechelsesteenweg 365,2019-10-08,14:00:00,100,64,36,FMN GV 05 Lier
60,Mechelsesteenweg 365,2019-10-08,15:00:00,114,44,70,FMN GV 05 Lier
60,Mechelsesteenweg 365,2019-10-08,16:00:00,206,56,150,FMN GV 05 Lier
60,Mechelsesteenweg 365,2019-10-08,17:00:00,114,64,50,FMN GV 05 Lier
60,Mechelsesteenweg 365,2019-10-08,18:00:00,68,34,34,FMN GV 05 Lier
60,Mechelsesteenweg 365,2019-10-08,19:00:00,36,16,20,FMN GV 05 Lier
60,Mechelsesteenweg 365,2019-10-08,20:00:00,14,6,8,FMN GV 05 Lier
60,Mechelsesteenweg 365,2019-10-08,21:00:00,4,4,0,FMN GV 05 Lier
60,Mechelsesteenweg 365,2019-10-08,22:00:00,4,4,0,FMN GV 05 Lier
60,Mechelsesteenweg 365,2019-10-08,23:00:00,0,0,0,FMN GV 05 Lier
60,Mechelsesteenweg 365,2019-10-09,00:00:00,2,2,0,FMN GV 05 Lier
60,Mechelsesteenweg 365,2019-10-09,01:00:00,2,0,2,FMN GV 05 Lier
60,Mechelsesteenweg 365,2019-10-09,02:00:00,0,0,0,FMN GV 05 Lier
60,Mechelsesteenweg 365,2019-10-09,03:00:00,0,0,0,FMN GV 05 Lier
60,Mechelsesteenweg 365,2019-10-09,04:00:00,4,0,4,FMN GV 05 Lier
60,Mechelsesteenweg 365,2019-10-09,05:00:00,10,2,8,FMN GV 05 Lier
60,Mechelsesteenweg 365,2019-10-09,06:00:00,16,2,14,FMN GV 05 Lier
60,Mechelsesteenweg 365,2019-10-09,07:00:00,174,108,66,FMN GV 05 Lier
60,Mechelsesteenweg 365,2019-10-09,08:00:00,104,64,40,FMN GV 05 Lier
60,Mechelsesteenweg 365,2019-10-09,09:00:00,26,18,8,FMN GV 05 Lier
60,Mechelsesteenweg 365,2019-10-09,10:00:00,12,8,4,FMN GV 05 Lier
60,Mechelsesteenweg 365,2019-10-09,11:00:00,34,10,24,FMN GV 05 Lier
60,Mechelsesteenweg 365,2019-10-09,12:00:00,150,24,126,FMN GV 05 Lier
60,Mechelsesteenweg 365,2019-10-09,13:00:00,44,14,30,FMN GV 05 Lier
60,Mechelsesteenweg 365,2019-10-09,14:00:00,28,14,14,FMN GV 05 Lier
60,Mechelsesteenweg 365,2019-10-09,15:00:00,58,34,24,FMN GV 05 Lier
60,Mechelsesteenweg 365,2019-10-09,16:00:00,68,40,28,FMN GV 05 Lier
60,Mechelsesteenweg 365,2019-10-09,17:00:00,72,44,28,FMN GV 05 Lier
60,Mechelsesteenweg 365,2019-10-09,18:00:00,44,22,22,FMN GV 05 Lier
60,Mechelsesteenweg 365,2019-10-09,19:00:00,18,4,14,FMN GV 05 Lier
60,Mechelsesteenweg 365,2019-10-09,20:00:00,14,10,4,FMN GV 05 Lier
60,Mechelsesteenweg 365,2019-10-09,21:00:00,4,2,2,FMN GV 05 Lier
60,Mechelsesteenweg 365,2019-10-09,22:00:00,8,2,6,FMN GV 05 Lier
60,Mechelsesteenweg 365,2019-10-09,23:00:00,4,2,2,FMN GV 05 Lier
60,Mechelsesteenweg 365,2019-10-10,00:00:00,0,0,0,FMN GV 05 Lier
60,Mechelsesteenweg 365,2019-10-10,01:00:00,0,0,0,FMN GV 05 Lier
60,Mechelsesteenweg 365,2019-10-10,02:00:00,0,0,0,FMN GV 05 Lier
60,Mechelsesteenweg 365,2019-10-10,03:00:00,0,0,0,FMN GV 05 Lier
60,Mechelsesteenweg 365,2019-10-10,04:00:00,4,0,4,FMN GV 05 Lier
60,Mechelsesteenweg 365,2019-10-10,05:00:00,8,2,6,FMN GV 05 Lier
60,Mechelsesteenweg 365,2019-10-10,06:00:00,20,2,18,FMN GV 05 Lier
60,Mechelsesteenweg 365,2019-10-10,07:00:00,188,110,78,FMN GV 05 Lier
60,Mechelsesteenweg 365,2019-10-10,08:00:00,226,86,140,FMN GV 05 Lier
60,Mechelsesteenweg 365,2019-10-10,09:00:00,42,28,14,FMN GV 05 Lier
60,Mechelsesteenweg 365,2019-10-10,10:00:00,68,46,22,FMN GV 05 Lier
60,Mechelsesteenweg 365,2019-10-10,11:00:00,88,40,48,FMN GV 05 Lier
60,Mechelsesteenweg 365,2019-10-10,12:00:00,54,24,30,FMN GV 05 Lier
60,Mechelsesteenweg 365,2019-10-10,13:00:00,108,44,64,FMN GV 05 Lier
60,Mechelsesteenweg 365,2019-10-10,14:00:00,120,58,62,FMN GV 05 Lier
60,Mechelsesteenweg 365,2019-10-10,15:00:00,136,78,58,FMN GV 05 Lier
60,Mechelsesteenweg 365,2019-10-10,16:00:00,250,80,170,FMN GV 05 Lier
60,Mechelsesteenweg 365,2019-10-10,17:00:00,148,94,54,FMN GV 05 Lier
60,Mechelsesteenweg 365,2019-10-10,18:00:00,74,36,38,FMN GV 05 Lier
60,Mechelsesteenweg 365,2019-10-10,19:00:00,44,14,30,FMN GV 05 Lier
60,Mechelsesteenweg 365,2019-10-10,20:00:00,6,6,0,FMN GV 05 Lier
60,Mechelsesteenweg 365,2019-10-10,21:00:00,6,2,4,FMN GV 05 Lier
60,Mechelsesteenweg 365,2019-10-10,22:00:00,6,6,0,FMN GV 05 Lier
60,Mechelsesteenweg 365,2019-10-10,23:00:00,4,2,2,FMN GV 05 Lier
60,Mechelsesteenweg 365,2019-10-11,00:00:00,0,0,0,FMN GV 05 Lier
60,Mechelsesteenweg 365,2019-10-11,01:00:00,0,0,0,FMN GV 05 Lier
60,Mechelsesteenweg 365,2019-10-11,02:00:00,4,4,0,FMN GV 05 Lier
60,Mechelsesteenweg 365,2019-10-11,03:00:00,0,0,0,FMN GV 05 Lier
60,Mechelsesteenweg 365,2019-10-11,04:00:00,0,0,0,FMN GV 05 Lier
60,Mechelsesteenweg 365,2019-10-11,05:00:00,14,4,10,FMN GV 05 Lier
60,Mechelsesteenweg 365,2019-10-11,06:00:00,16,4,12,FMN GV 05 Lier
60,Mechelsesteenweg 365,2019-10-11,07:00:00,170,110,60,FMN GV 05 Lier
60,Mechelsesteenweg 365,2019-10-11,08:00:00,108,62,46,FMN GV 05 Lier
60,Mechelsesteenweg 365,2019-10-11,09:00:00,24,6,18,FMN GV 05 Lier
60,Mechelsesteenweg 365,2019-10-11,10:00:00,30,18,12,FMN GV 05 Lier
60,Mechelsesteenweg 365,2019-10-11,11:00:00,32,18,14,FMN GV 05 Lier
60,Mechelsesteenweg 365,2019-10-11,12:00:00,38,18,20,FMN GV 05 Lier
60,Mechelsesteenweg 365,2019-10-11,13:00:00,46,20,26,FMN GV 05 Lier
60,Mechelsesteenweg 365,2019-10-11,14:00:00,60,36,24,FMN GV 05 Lier
60,Mechelsesteenweg 365,2019-10-11,15:00:00,84,34,50,FMN GV 05 Lier
60,Mechelsesteenweg 365,2019-10-11,16:00:00,150,40,110,FMN GV 05 Lier
60,Mechelsesteenweg 365,2019-10-11,17:00:00,90,44,46,FMN GV 05 Lier
60,Mechelsesteenweg 365,2019-10-11,18:00:00,42,26,16,FMN GV 05 Lier
60,Mechelsesteenweg 365,2019-10-11,19:00:00,14,8,6,FMN GV 05 Lier
60,Mechelsesteenweg 365,2019-10-11,20:00:00,6,6,0,FMN GV 05 Lier
60,Mechelsesteenweg 365,2019-10-11,21:00:00,10,4,6,FMN GV 05 Lier
60,Mechelsesteenweg 365,2019-10-11,22:00:00,6,2,4,FMN GV 05 Lier
60,Mechelsesteenweg 365,2019-10-11,23:00:00,0,0,0,FMN GV 05 Lier
60,Mechelsesteenweg 365,2019-10-12,00:00:00,0,0,0,FMN GV 05 Lier
60,Mechelsesteenweg 365,2019-10-12,01:00:00,0,0,0,FMN GV 05 Lier
60,Mechelsesteenweg 365,2019-10-12,02:00:00,2,0,2,FMN GV 05 Lier
60,Mechelsesteenweg 365,2019-10-12,03:00:00,2,2,0,FMN GV 05 Lier
60,Mechelsesteenweg 365,2019-10-12,04:00:00,0,0,0,FMN GV 05 Lier
60,Mechelsesteenweg 365,2019-10-12,05:00:00,0,0,0,FMN GV 05 Lier
60,Mechelsesteenweg 365,2019-10-12,06:00:00,4,4,0,FMN GV 05 Lier
60,Mechelsesteenweg 365,2019-10-12,07:00:00,8,4,4,FMN GV 05 Lier
60,Mechelsesteenweg 365,2019-10-12,08:00:00,32,8,24,FMN GV 05 Lier
60,Mechelsesteenweg 365,2019-10-12,09:00:00,96,50,46,FMN GV 05 Lier
60,Mechelsesteenweg 365,2019-10-12,10:00:00,126,62,64,FMN GV 05 Lier
60,Mechelsesteenweg 365,2019-10-12,11:00:00,150,68,82,FMN GV 05 Lier
60,Mechelsesteenweg 365,2019-10-12,12:00:00,102,44,58,FMN GV 05 Lier
60,Mechelsesteenweg 365,2019-10-12,13:00:00,136,72,64,FMN GV 05 Lier
60,Mechelsesteenweg 365,2019-10-12,14:00:00,190,112,78,FMN GV 05 Lier
60,Mechelsesteenweg 365,2019-10-12,15:00:00,172,80,92,FMN GV 05 Lier
60,Mechelsesteenweg 365,2019-10-12,16:00:00,124,62,62,FMN GV 05 Lier
60,Mechelsesteenweg 365,2019-10-12,17:00:00,72,32,40,FMN GV 05 Lier
60,Mechelsesteenweg 365,2019-10-12,18:00:00,72,46,26,FMN GV 05 Lier
60,Mechelsesteenweg 365,2019-10-12,19:00:00,22,8,14,FMN GV 05 Lier
60,Mechelsesteenweg 365,2019-10-12,20:00:00,16,2,14,FMN GV 05 Lier
60,Mechelsesteenweg 365,2019-10-12,21:00:00,16,4,12,FMN GV 05 Lier
60,Mechelsesteenweg 365,2019-10-12,22:00:00,12,2,10,FMN GV 05 Lier
60,Mechelsesteenweg 365,2019-10-12,23:00:00,0,0,0,FMN GV 05 Lier
60,Mechelsesteenweg 365,2019-10-13,00:00:00,2,0,2,FMN GV 05 Lier
60,Mechelsesteenweg 365,2019-10-13,01:00:00,10,4,6,FMN GV 05 Lier
60,Mechelsesteenweg 365,2019-10-13,02:00:00,0,0,0,FMN GV 05 Lier
60,Mechelsesteenweg 365,2019-10-13,03:00:00,2,0,2,FMN GV 05 Lier
60,Mechelsesteenweg 365,2019-10-13,04:00:00,2,2,0,FMN GV 05 Lier
60,Mechelsesteenweg 365,2019-10-13,05:00:00,0,0,0,FMN GV 05 Lier
60,Mechelsesteenweg 365,2019-10-13,06:00:00,0,0,0,FMN GV 05 Lier
60,Mechelsesteenweg 365,2019-10-13,07:00:00,10,6,4,FMN GV 05 Lier
60,Mechelsesteenweg 365,2019-10-13,08:00:00,40,30,10,FMN GV 05 Lier
60,Mechelsesteenweg 365,2019-10-13,09:00:00,86,56,30,FMN GV 05 Lier
60,Mechelsesteenweg 365,2019-10-13,10:00:00,260,138,122,FMN GV 05 Lier
60,Mechelsesteenweg 365,2019-10-13,11:00:00,224,112,112,FMN GV 05 Lier
60,Mechelsesteenweg 365,2019-10-13,12:00:00,194,66,128,FMN GV 05 Lier
60,Mechelsesteenweg 365,2019-10-13,13:00:00,276,152,124,FMN GV 05 Lier
60,Mechelsesteenweg 365,2019-10-13,14:00:00,344,182,162,FMN GV 05 Lier
60,Mechelsesteenweg 365,2019-10-13,15:00:00,286,122,164,FMN GV 05 Lier
60,Mechelsesteenweg 365,2019-10-13,16:00:00,178,66,112,FMN GV 05 Lier
60,Mechelsesteenweg 365,2019-10-13,17:00:00,100,48,52,FMN GV 05 Lier
60,Mechelsesteenweg 365,2019-10-13,18:00:00,48,18,30,FMN GV 05 Lier
60,Mechelsesteenweg 365,2019-10-13,19:00:00,4,0,4,FMN GV 05 Lier
60,Mechelsesteenweg 365,2019-10-13,20:00:00,6,6,0,FMN GV 05 Lier
60,Mechelsesteenweg 365,2019-10-13,21:00:00,6,0,6,FMN GV 05 Lier
60,Mechelsesteenweg 365,2019-10-13,22:00:00,6,0,6,FMN GV 05 Lier
60,Mechelsesteenweg 365,2019-10-13,23:00:00,4,4,0,FMN GV 05 Lier
60,Mechelsesteenweg 365,2019-10-14,00:00:00,2,0,2,FMN GV 05 Lier
60,Mechelsesteenweg 365,2019-10-14,01:00:00,0,0,0,FMN GV 05 Lier
60,Mechelsesteenweg 365,2019-10-14,02:00:00,0,0,0,FMN GV 05 Lier
60,Mechelsesteenweg 365,2019-10-14,03:00:00,0,0,0,FMN GV 05 Lier
60,Mechelsesteenweg 365,2019-10-14,04:00:00,0,0,0,FMN GV 05 Lier
60,Mechelsesteenweg 365,2019-10-14,05:00:00,8,2,6,FMN GV 05 Lier
60,Mechelsesteenweg 365,2019-10-14,06:00:00,16,2,14,FMN GV 05 Lier
60,Mechelsesteenweg 365,2019-10-14,07:00:00,144,70,74,FMN GV 05 Lier
60,Mechelsesteenweg 365,2019-10-14,08:00:00,92,46,46,FMN GV 05 Lier
60,Mechelsesteenweg 365,2019-10-14,09:00:00,106,70,36,FMN GV 05 Lier
60,Mechelsesteenweg 365,2019-10-14,10:00:00,78,60,18,FMN GV 05 Lier
60,Mechelsesteenweg 365,2019-10-14,11:00:00,64,28,36,FMN GV 05 Lier
60,Mechelsesteenweg 365,2019-10-14,12:00:00,44,14,30,FMN GV 05 Lier
60,Mechelsesteenweg 365,2019-10-14,13:00:00,90,46,44,FMN GV 05 Lier
60,Mechelsesteenweg 365,2019-10-14,14:00:00,158,66,92,FMN GV 05 Lier
60,Mechelsesteenweg 365,2019-10-14,15:00:00,202,88,114,FMN GV 05 Lier
60,Mechelsesteenweg 365,2019-10-14,16:00:00,256,78,178,FMN GV 05 Lier
60,Mechelsesteenweg 365,2019-10-14,17:00:00,156,100,56,FMN GV 05 Lier
60,Mechelsesteenweg 365,2019-10-14,18:00:00,74,36,38,FMN GV 05 Lier
60,Mechelsesteenweg 365,2019-10-14,19:00:00,30,16,14,FMN GV 05 Lier
60,Mechelsesteenweg 365,2019-10-14,20:00:00,10,8,2,FMN GV 05 Lier
60,Mechelsesteenweg 365,2019-10-14,21:00:00,6,0,6,FMN GV 05 Lier
60,Mechelsesteenweg 365,2019-10-14,22:00:00,4,2,2,FMN GV 05 Lier
60,Mechelsesteenweg 365,2019-10-14,23:00:00,0,0,0,FMN GV 05 Lier
60,Mechelsesteenweg 365,2019-10-15,00:00:00,0,0,0,FMN GV 05 Lier
60,Mechelsesteenweg 365,2019-10-15,01:00:00,0,0,0,FMN GV 05 Lier
60,Mechelsesteenweg 365,2019-10-15,02:00:00,0,0,0,FMN GV 05 Lier
60,Mechelsesteenweg 365,2019-10-15,03:00:00,0,0,0,FMN GV 05 Lier
60,Mechelsesteenweg 365,2019-10-15,04:00:00,0,0,0,FMN GV 05 Lier
60,Mechelsesteenweg 365,2019-10-15,05:00:00,2,0,2,FMN GV 05 Lier
60,Mechelsesteenweg 365,2019-10-15,06:00:00,24,10,14,FMN GV 05 Lier
60,Mechelsesteenweg 365,2019-10-15,07:00:00,144,98,46,FMN GV 05 Lier
60,Mechelsesteenweg 365,2019-10-15,08:00:00,116,68,48,FMN GV 05 Lier
60,Mechelsesteenweg 365,2019-10-15,09:00:00,44,22,22,FMN GV 05 Lier
60,Mechelsesteenweg 365,2019-10-15,10:00:00,18,10,8,FMN GV 05 Lier
60,Mechelsesteenweg 365,2019-10-15,11:00:00,36,26,10,FMN GV 05 Lier
60,Mechelsesteenweg 365,2019-10-15,12:00:00,48,20,28,FMN GV 05 Lier
60,Mechelsesteenweg 365,2019-10-15,13:00:00,140,86,54,FMN GV 05 Lier
60,Mechelsesteenweg 365,2019-10-15,14:00:00,58,32,26,FMN GV 05 Lier
60,Mechelsesteenweg 365,2019-10-15,15:00:00,76,22,54,FMN GV 05 Lier
60,Mechelsesteenweg 365,2019-10-15,16:00:00,202,56,146,FMN GV 05 Lier
60,Mechelsesteenweg 365,2019-10-15,17:00:00,80,58,22,FMN GV 05 Lier
60,Mechelsesteenweg 365,2019-10-15,18:00:00,38,26,12,FMN GV 05 Lier
60,Mechelsesteenweg 365,2019-10-15,19:00:00,14,8,6,FMN GV 05 Lier
60,Mechelsesteenweg 365,2019-10-15,20:00:00,16,8,8,FMN GV 05 Lier
60,Mechelsesteenweg 365,2019-10-15,21:00:00,2,0,2,FMN GV 05 Lier
60,Mechelsesteenweg 365,2019-10-15,22:00:00,10,8,2,FMN GV 05 Lier
60,Mechelsesteenweg 365,2019-10-15,23:00:00,2,2,0,FMN GV 05 Lier
60,Mechelsesteenweg 365,2019-10-16,00:00:00,0,0,0,FMN GV 05 Lier
60,Mechelsesteenweg 365,2019-10-16,01:00:00,0,0,0,FMN GV 05 Lier
60,Mechelsesteenweg 365,2019-10-16,02:00:00,0,0,0,FMN GV 05 Lier
60,Mechelsesteenweg 365,2019-10-16,03:00:00,0,0,0,FMN GV 05 Lier
60,Mechelsesteenweg 365,2019-10-16,04:00:00,2,0,2,FMN GV 05 Lier
60,Mechelsesteenweg 365,2019-10-16,05:00:00,8,4,4,FMN GV 05 Lier
60,Mechelsesteenweg 365,2019-10-16,06:00:00,30,10,20,FMN GV 05 Lier
60,Mechelsesteenweg 365,2019-10-16,07:00:00,164,88,76,FMN GV 05 Lier
60,Mechelsesteenweg 365,2019-10-16,08:00:00,122,80,42,FMN GV 05 Lier
60,Mechelsesteenweg 365,2019-10-16,09:00:00,62,32,30,FMN GV 05 Lier
60,Mechelsesteenweg 365,2019-10-16,10:00:00,28,16,12,FMN GV 05 Lier
60,Mechelsesteenweg 365,2019-10-16,11:00:00,94,24,70,FMN GV 05 Lier
60,Mechelsesteenweg 365,2019-10-16,12:00:00,120,32,88,FMN GV 05 Lier
60,Mechelsesteenweg 365,2019-10-16,13:00:00,48,20,28,FMN GV 05 Lier
60,Mechelsesteenweg 365,2019-10-16,14:00:00,26,20,6,FMN GV 05 Lier
60,Mechelsesteenweg 365,2019-10-16,15:00:00,36,26,10,FMN GV 05 Lier
60,Mechelsesteenweg 365,2019-10-16,16:00:00,66,38,28,FMN GV 05 Lier
60,Mechelsesteenweg 365,2019-10-16,17:00:00,58,40,18,FMN GV 05 Lier
60,Mechelsesteenweg 365,2019-10-16,18:00:00,34,22,12,FMN GV 05 Lier
60,Mechelsesteenweg 365,2019-10-16,19:00:00,12,12,0,FMN GV 05 Lier
60,Mechelsesteenweg 365,2019-10-16,20:00:00,6,6,0,FMN GV 05 Lier
60,Mechelsesteenweg 365,2019-10-16,21:00:00,6,4,2,FMN GV 05 Lier
60,Mechelsesteenweg 365,2019-10-16,22:00:00,8,8,0,FMN GV 05 Lier
60,Mechelsesteenweg 365,2019-10-16,23:00:00,0,0,0,FMN GV 05 Lier
60,Mechelsesteenweg 365,2019-10-17,00:00:00,0,0,0,FMN GV 05 Lier
60,Mechelsesteenweg 365,2019-10-17,01:00:00,0,0,0,FMN GV 05 Lier
60,Mechelsesteenweg 365,2019-10-17,02:00:00,0,0,0,FMN GV 05 Lier
60,Mechelsesteenweg 365,2019-10-17,03:00:00,2,0,2,FMN GV 05 Lier
60,Mechelsesteenweg 365,2019-10-17,04:00:00,0,0,0,FMN GV 05 Lier
60,Mechelsesteenweg 365,2019-10-17,05:00:00,4,0,4,FMN GV 05 Lier
60,Mechelsesteenweg 365,2019-10-17,06:00:00,16,6,10,FMN GV 05 Lier
60,Mechelsesteenweg 365,2019-10-17,07:00:00,164,100,64,FMN GV 05 Lier
60,Mechelsesteenweg 365,2019-10-17,08:00:00,138,82,56,FMN GV 05 Lier
60,Mechelsesteenweg 365,2019-10-17,09:00:00,34,16,18,FMN GV 05 Lier
60,Mechelsesteenweg 365,2019-10-17,10:00:00,78,42,36,FMN GV 05 Lier
60,Mechelsesteenweg 365,2019-10-17,11:00:00,76,38,38,FMN GV 05 Lier
60,Mechelsesteenweg 365,2019-10-17,12:00:00,80,38,42,FMN GV 05 Lier
60,Mechelsesteenweg 365,2019-10-17,13:00:00,112,46,66,FMN GV 05 Lier
60,Mechelsesteenweg 365,2019-10-17,14:00:00,136,62,74,FMN GV 05 Lier
60,Mechelsesteenweg 365,2019-10-17,15:00:00,156,72,84,FMN GV 05 Lier
60,Mechelsesteenweg 365,2019-10-17,16:00:00,226,80,146,FMN GV 05 Lier
60,Mechelsesteenweg 365,2019-10-17,17:00:00,104,78,26,FMN GV 05 Lier
60,Mechelsesteenweg 365,2019-10-17,18:00:00,104,44,60,FMN GV 05 Lier
60,Mechelsesteenweg 365,2019-10-17,19:00:00,20,14,6,FMN GV 05 Lier
60,Mechelsesteenweg 365,2019-10-17,20:00:00,14,6,8,FMN GV 05 Lier
60,Mechelsesteenweg 365,2019-10-17,21:00:00,8,2,6,FMN GV 05 Lier
60,Mechelsesteenweg 365,2019-10-17,22:00:00,12,10,2,FMN GV 05 Lier
60,Mechelsesteenweg 365,2019-10-17,23:00:00,0,0,0,FMN GV 05 Lier
60,Mechelsesteenweg 365,2019-10-18,00:00:00,0,0,0,FMN GV 05 Lier
60,Mechelsesteenweg 365,2019-10-18,01:00:00,0,0,0,FMN GV 05 Lier
60,Mechelsesteenweg 365,2019-10-18,02:00:00,0,0,0,FMN GV 05 Lier
60,Mechelsesteenweg 365,2019-10-18,03:00:00,2,0,2,FMN GV 05 Lier
60,Mechelsesteenweg 365,2019-10-18,04:00:00,2,0,2,FMN GV 05 Lier
60,Mechelsesteenweg 365,2019-10-18,05:00:00,2,0,2,FMN GV 05 Lier
60,Mechelsesteenweg 365,2019-10-18,06:00:00,46,32,14,FMN GV 05 Lier
60,Mechelsesteenweg 365,2019-10-18,07:00:00,138,86,52,FMN GV 05 Lier
60,Mechelsesteenweg 365,2019-10-18,08:00:00,120,72,48,FMN GV 05 Lier
60,Mechelsesteenweg 365,2019-10-18,09:00:00,24,6,18,FMN GV 05 Lier
60,Mechelsesteenweg 365,2019-10-18,10:00:00,32,8,24,FMN GV 05 Lier
60,Mechelsesteenweg 365,2019-10-18,11:00:00,34,20,14,FMN GV 05 Lier
60,Mechelsesteenweg 365,2019-10-18,12:00:00,36,18,18,FMN GV 05 Lier
60,Mechelsesteenweg 365,2019-10-18,13:00:00,42,28,14,FMN GV 05 Lier
60,Mechelsesteenweg 365,2019-10-18,14:00:00,76,40,36,FMN GV 05 Lier
60,Mechelsesteenweg 365,2019-10-18,15:00:00,66,20,46,FMN GV 05 Lier
60,Mechelsesteenweg 365,2019-10-18,16:00:00,174,40,134,FMN GV 05 Lier
60,Mechelsesteenweg 365,2019-10-18,17:00:00,82,48,34,FMN GV 05 Lier
60,Mechelsesteenweg 365,2019-10-18,18:00:00,26,14,12,FMN GV 05 Lier
60,Mechelsesteenweg 365,2019-10-18,19:00:00,14,6,8,FMN GV 05 Lier
60,Mechelsesteenweg 365,2019-10-18,20:00:00,8,8,0,FMN GV 05 Lier
60,Mechelsesteenweg 365,2019-10-18,21:00:00,4,2,2,FMN GV 05 Lier
60,Mechelsesteenweg 365,2019-10-18,22:00:00,8,8,0,FMN GV 05 Lier
60,Mechelsesteenweg 365,2019-10-18,23:00:00,2,0,2,FMN GV 05 Lier
60,Mechelsesteenweg 365,2019-10-19,00:00:00,0,0,0,FMN GV 05 Lier
60,Mechelsesteenweg 365,2019-10-19,01:00:00,2,0,2,FMN GV 05 Lier
60,Mechelsesteenweg 365,2019-10-19,02:00:00,6,6,0,FMN GV 05 Lier
60,Mechelsesteenweg 365,2019-10-19,03:00:00,0,0,0,FMN GV 05 Lier
60,Mechelsesteenweg 365,2019-10-19,04:00:00,6,0,6,FMN GV 05 Lier
60,Mechelsesteenweg 365,2019-10-19,05:00:00,0,0,0,FMN GV 05 Lier
60,Mechelsesteenweg 365,2019-10-19,06:00:00,4,2,2,FMN GV 05 Lier
60,Mechelsesteenweg 365,2019-10-19,07:00:00,6,4,2,FMN GV 05 Lier
60,Mechelsesteenweg 365,2019-10-19,08:00:00,8,4,4,FMN GV 05 Lier
60,Mechelsesteenweg 365,2019-10-19,09:00:00,16,10,6,FMN GV 05 Lier
60,Mechelsesteenweg 365,2019-10-19,10:00:00,10,4,6,FMN GV 05 Lier
60,Mechelsesteenweg 365,2019-10-19,11:00:00,30,10,20,FMN GV 05 Lier
60,Mechelsesteenweg 365,2019-10-19,12:00:00,60,28,32,FMN GV 05 Lier
60,Mechelsesteenweg 365,2019-10-19,13:00:00,102,42,60,FMN GV 05 Lier
60,Mechelsesteenweg 365,2019-10-19,14:00:00,126,64,62,FMN GV 05 Lier
60,Mechelsesteenweg 365,2019-10-19,15:00:00,102,42,60,FMN GV 05 Lier
60,Mechelsesteenweg 365,2019-10-19,16:00:00,116,58,58,FMN GV 05 Lier
60,Mechelsesteenweg 365,2019-10-19,17:00:00,64,26,38,FMN GV 05 Lier
60,Mechelsesteenweg 365,2019-10-19,18:00:00,32,6,26,FMN GV 05 Lier
60,Mechelsesteenweg 365,2019-10-19,19:00:00,18,4,14,FMN GV 05 Lier
60,Mechelsesteenweg 365,2019-10-19,20:00:00,0,0,0,FMN GV 05 Lier
60,Mechelsesteenweg 365,2019-10-19,21:00:00,0,0,0,FMN GV 05 Lier
60,Mechelsesteenweg 365,2019-10-19,22:00:00,4,4,0,FMN GV 05 Lier
60,Mechelsesteenweg 365,2019-10-19,23:00:00,0,0,0,FMN GV 05 Lier
60,Mechelsesteenweg 365,2019-10-20,00:00:00,2,0,2,FMN GV 05 Lier
60,Mechelsesteenweg 365,2019-10-20,01:00:00,0,0,0,FMN GV 05 Lier
60,Mechelsesteenweg 365,2019-10-20,02:00:00,2,0,2,FMN GV 05 Lier
60,Mechelsesteenweg 365,2019-10-20,03:00:00,0,0,0,FMN GV 05 Lier
60,Mechelsesteenweg 365,2019-10-20,04:00:00,0,0,0,FMN GV 05 Lier
60,Mechelsesteenweg 365,2019-10-20,05:00:00,0,0,0,FMN GV 05 Lier
60,Mechelsesteenweg 365,2019-10-20,06:00:00,2,2,0,FMN GV 05 Lier
60,Mechelsesteenweg 365,2019-10-20,07:00:00,0,0,0,FMN GV 05 Lier
60,Mechelsesteenweg 365,2019-10-20,08:00:00,20,6,14,FMN GV 05 Lier
60,Mechelsesteenweg 365,2019-10-20,09:00:00,110,84,26,FMN GV 05 Lier
60,Mechelsesteenweg 365,2019-10-20,10:00:00,150,80,70,FMN GV 05 Lier
60,Mechelsesteenweg 365,2019-10-20,11:00:00,134,56,78,FMN GV 05 Lier
60,Mechelsesteenweg 365,2019-10-20,12:00:00,40,20,20,FMN GV 05 Lier
60,Mechelsesteenweg 365,2019-10-20,13:00:00,58,12,46,FMN GV 05 Lier
60,Mechelsesteenweg 365,2019-10-20,14:00:00,30,16,14,FMN GV 05 Lier
60,Mechelsesteenweg 365,2019-10-20,15:00:00,38,6,32,FMN GV 05 Lier
60,Mechelsesteenweg 365,2019-10-20,16:00:00,34,20,14,FMN GV 05 Lier
60,Mechelsesteenweg 365,2019-10-20,17:00:00,42,18,24,FMN GV 05 Lier
60,Mechelsesteenweg 365,2019-10-20,18:00:00,18,10,8,FMN GV 05 Lier
60,Mechelsesteenweg 365,2019-10-20,19:00:00,4,2,2,FMN GV 05 Lier
60,Mechelsesteenweg 365,2019-10-20,20:00:00,6,2,4,FMN GV 05 Lier
60,Mechelsesteenweg 365,2019-10-20,21:00:00,6,0,6,FMN GV 05 Lier
60,Mechelsesteenweg 365,2019-10-20,22:00:00,6,0,6,FMN GV 05 Lier
60,Mechelsesteenweg 365,2019-10-20,23:00:00,4,4,0,FMN GV 05 Lier
60,Mechelsesteenweg 365,2019-10-21,00:00:00,0,0,0,FMN GV 05 Lier
60,Mechelsesteenweg 365,2019-10-21,01:00:00,0,0,0,FMN GV 05 Lier
60,Mechelsesteenweg 365,2019-10-21,02:00:00,2,2,0,FMN GV 05 Lier
60,Mechelsesteenweg 365,2019-10-21,03:00:00,2,0,2,FMN GV 05 Lier
60,Mechelsesteenweg 365,2019-10-21,04:00:00,2,0,2,FMN GV 05 Lier
60,Mechelsesteenweg 365,2019-10-21,05:00:00,4,0,4,FMN GV 05 Lier
60,Mechelsesteenweg 365,2019-10-21,06:00:00,6,2,4,FMN GV 05 Lier
60,Mechelsesteenweg 365,2019-10-21,07:00:00,150,96,54,FMN GV 05 Lier
60,Mechelsesteenweg 365,2019-10-21,08:00:00,106,80,26,FMN GV 05 Lier
60,Mechelsesteenweg 365,2019-10-21,09:00:00,44,30,14,FMN GV 05 Lier
60,Mechelsesteenweg 365,2019-10-21,10:00:00,28,20,8,FMN GV 05 Lier
60,Mechelsesteenweg 365,2019-10-21,11:00:00,34,16,18,FMN GV 05 Lier
60,Mechelsesteenweg 365,2019-10-21,12:00:00,34,18,16,FMN GV 05 Lier
60,Mechelsesteenweg 365,2019-10-21,13:00:00,58,22,36,FMN GV 05 Lier
60,Mechelsesteenweg 365,2019-10-21,14:00:00,80,36,44,FMN GV 05 Lier
60,Mechelsesteenweg 365,2019-10-21,15:00:00,62,20,42,FMN GV 05 Lier
60,Mechelsesteenweg 365,2019-10-21,16:00:00,212,42,170,FMN GV 05 Lier
60,Mechelsesteenweg 365,2019-10-21,17:00:00,98,60,38,FMN GV 05 Lier
60,Mechelsesteenweg 365,2019-10-21,18:00:00,36,12,24,FMN GV 05 Lier
60,Mechelsesteenweg 365,2019-10-21,19:00:00,22,10,12,FMN GV 05 Lier
60,Mechelsesteenweg 365,2019-10-21,20:00:00,16,8,8,FMN GV 05 Lier
60,Mechelsesteenweg 365,2019-10-21,21:00:00,8,6,2,FMN GV 05 Lier
60,Mechelsesteenweg 365,2019-10-21,22:00:00,12,6,6,FMN GV 05 Lier
60,Mechelsesteenweg 365,2019-10-21,23:00:00,0,0,0,FMN GV 05 Lier
60,Mechelsesteenweg 365,2019-10-22,00:00:00,0,0,0,FMN GV 05 Lier
60,Mechelsesteenweg 365,2019-10-22,01:00:00,0,0,0,FMN GV 05 Lier
60,Mechelsesteenweg 365,2019-10-22,02:00:00,0,0,0,FMN GV 05 Lier
60,Mechelsesteenweg 365,2019-10-22,03:00:00,2,0,2,FMN GV 05 Lier
60,Mechelsesteenweg 365,2019-10-22,04:00:00,2,0,2,FMN GV 05 Lier
60,Mechelsesteenweg 365,2019-10-22,05:00:00,10,0,10,FMN GV 05 Lier
60,Mechelsesteenweg 365,2019-10-22,06:00:00,18,4,14,FMN GV 05 Lier
60,Mechelsesteenweg 365,2019-10-22,07:00:00,206,132,74,FMN GV 05 Lier
60,Mechelsesteenweg 365,2019-10-22,08:00:00,138,72,66,FMN GV 05 Lier
60,Mechelsesteenweg 365,2019-10-22,09:00:00,120,76,44,FMN GV 05 Lier
60,Mechelsesteenweg 365,2019-10-22,10:00:00,96,54,42,FMN GV 05 Lier
60,Mechelsesteenweg 365,2019-10-22,11:00:00,102,48,54,FMN GV 05 Lier
60,Mechelsesteenweg 365,2019-10-22,12:00:00,72,34,38,FMN GV 05 Lier
60,Mechelsesteenweg 365,2019-10-22,13:00:00,146,86,60,FMN GV 05 Lier
60,Mechelsesteenweg 365,2019-10-22,14:00:00,138,86,52,FMN GV 05 Lier
60,Mechelsesteenweg 365,2019-10-22,15:00:00,200,74,126,FMN GV 05 Lier
60,Mechelsesteenweg 365,2019-10-22,16:00:00,264,100,164,FMN GV 05 Lier
60,Mechelsesteenweg 365,2019-10-22,17:00:00,172,90,82,FMN GV 05 Lier
60,Mechelsesteenweg 365,2019-10-22,18:00:00,64,36,28,FMN GV 05 Lier
60,Mechelsesteenweg 365,2019-10-22,19:00:00,28,16,12,FMN GV 05 Lier
60,Mechelsesteenweg 365,2019-10-22,20:00:00,26,10,16,FMN GV 05 Lier
60,Mechelsesteenweg 365,2019-10-22,21:00:00,2,0,2,FMN GV 05 Lier
60,Mechelsesteenweg 365,2019-10-22,22:00:00,6,4,2,FMN GV 05 Lier
60,Mechelsesteenweg 365,2019-10-22,23:00:00,0,0,0,FMN GV 05 Lier
60,Mechelsesteenweg 365,2019-10-23,00:00:00,2,0,2,FMN GV 05 Lier
60,Mechelsesteenweg 365,2019-10-23,01:00:00,0,0,0,FMN GV 05 Lier
60,Mechelsesteenweg 365,2019-10-23,02:00:00,0,0,0,FMN GV 05 Lier
60,Mechelsesteenweg 365,2019-10-23,03:00:00,2,0,2,FMN GV 05 Lier
60,Mechelsesteenweg 365,2019-10-23,04:00:00,2,0,2,FMN GV 05 Lier
60,Mechelsesteenweg 365,2019-10-23,05:00:00,6,0,6,FMN GV 05 Lier
60,Mechelsesteenweg 365,2019-10-23,06:00:00,36,4,32,FMN GV 05 Lier
60,Mechelsesteenweg 365,2019-10-23,07:00:00,170,98,72,FMN GV 05 Lier
60,Mechelsesteenweg 365,2019-10-23,08:00:00,122,96,26,FMN GV 05 Lier
60,Mechelsesteenweg 365,2019-10-23,09:00:00,56,30,26,FMN GV 05 Lier
60,Mechelsesteenweg 365,2019-10-23,10:00:00,74,26,48,FMN GV 05 Lier
60,Mechelsesteenweg 365,2019-10-23,11:00:00,68,24,44,FMN GV 05 Lier
60,Mechelsesteenweg 365,2019-10-23,12:00:00,186,40,146,FMN GV 05 Lier
60,Mechelsesteenweg 365,2019-10-23,13:00:00,194,98,96,FMN GV 05 Lier
60,Mechelsesteenweg 365,2019-10-23,14:00:00,206,126,80,FMN GV 05 Lier
60,Mechelsesteenweg 365,2019-10-23,15:00:00,226,118,108,FMN GV 05 Lier
60,Mechelsesteenweg 365,2019-10-23,16:00:00,244,114,130,FMN GV 05 Lier
60,Mechelsesteenweg 365,2019-10-23,17:00:00,156,88,68,FMN GV 05 Lier
60,Mechelsesteenweg 365,2019-10-23,18:00:00,86,32,54,FMN GV 05 Lier
60,Mechelsesteenweg 365,2019-10-23,19:00:00,56,30,26,FMN GV 05 Lier
60,Mechelsesteenweg 365,2019-10-23,20:00:00,14,8,6,FMN GV 05 Lier
60,Mechelsesteenweg 365,2019-10-23,21:00:00,10,6,4,FMN GV 05 Lier
60,Mechelsesteenweg 365,2019-10-23,22:00:00,4,4,0,FMN GV 05 Lier
60,Mechelsesteenweg 365,2019-10-23,23:00:00,2,0,2,FMN GV 05 Lier
60,Mechelsesteenweg 365,2019-10-24,00:00:00,0,0,0,FMN GV 05 Lier
60,Mechelsesteenweg 365,2019-10-24,01:00:00,0,0,0,FMN GV 05 Lier
60,Mechelsesteenweg 365,2019-10-24,02:00:00,0,0,0,FMN GV 05 Lier
60,Mechelsesteenweg 365,2019-10-24,03:00:00,2,0,2,FMN GV 05 Lier
60,Mechelsesteenweg 365,2019-10-24,04:00:00,2,0,2,FMN GV 05 Lier
60,Mechelsesteenweg 365,2019-10-24,05:00:00,8,0,8,FMN GV 05 Lier
60,Mechelsesteenweg 365,2019-10-24,06:00:00,30,14,16,FMN GV 05 Lier
60,Mechelsesteenweg 365,2019-10-24,07:00:00,200,102,98,FMN GV 05 Lier
60,Mechelsesteenweg 365,2019-10-24,08:00:00,148,78,70,FMN GV 05 Lier
60,Mechelsesteenweg 365,2019-10-24,09:00:00,118,90,28,FMN GV 05 Lier
60,Mechelsesteenweg 365,2019-10-24,10:00:00,74,42,32,FMN GV 05 Lier
60,Mechelsesteenweg 365,2019-10-24,11:00:00,70,36,34,FMN GV 05 Lier
60,Mechelsesteenweg 365,2019-10-24,12:00:00,80,36,44,FMN GV 05 Lier
60,Mechelsesteenweg 365,2019-10-24,13:00:00,166,94,72,FMN GV 05 Lier
60,Mechelsesteenweg 365,2019-10-24,14:00:00,220,102,118,FMN GV 05 Lier
60,Mechelsesteenweg 365,2019-10-24,15:00:00,262,112,150,FMN GV 05 Lier
60,Mechelsesteenweg 365,2019-10-24,16:00:00,300,112,188,FMN GV 05 Lier
60,Mechelsesteenweg 365,2019-10-24,17:00:00,148,102,46,FMN GV 05 Lier
60,Mechelsesteenweg 365,2019-10-24,18:00:00,66,48,18,FMN GV 05 Lier
60,Mechelsesteenweg 365,2019-10-24,19:00:00,40,22,18,FMN GV 05 Lier
60,Mechelsesteenweg 365,2019-10-24,20:00:00,14,2,12,FMN GV 05 Lier
60,Mechelsesteenweg 365,2019-10-24,21:00:00,8,2,6,FMN GV 05 Lier
60,Mechelsesteenweg 365,2019-10-24,22:00:00,10,6,4,FMN GV 05 Lier
60,Mechelsesteenweg 365,2019-10-24,23:00:00,0,0,0,FMN GV 05 Lier
60,Mechelsesteenweg 365,2019-10-25,00:00:00,0,0,0,FMN GV 05 Lier
60,Mechelsesteenweg 365,2019-10-25,01:00:00,0,0,0,FMN GV 05 Lier
60,Mechelsesteenweg 365,2019-10-25,02:00:00,0,0,0,FMN GV 05 Lier
60,Mechelsesteenweg 365,2019-10-25,03:00:00,2,0,2,FMN GV 05 Lier
60,Mechelsesteenweg 365,2019-10-25,04:00:00,2,0,2,FMN GV 05 Lier
60,Mechelsesteenweg 365,2019-10-25,05:00:00,4,0,4,FMN GV 05 Lier
60,Mechelsesteenweg 365,2019-10-25,06:00:00,20,6,14,FMN GV 05 Lier
60,Mechelsesteenweg 365,2019-10-25,07:00:00,164,102,62,FMN GV 05 Lier
60,Mechelsesteenweg 365,2019-10-25,08:00:00,172,92,80,FMN GV 05 Lier
60,Mechelsesteenweg 365,2019-10-25,09:00:00,38,22,16,FMN GV 05 Lier
60,Mechelsesteenweg 365,2019-10-25,10:00:00,60,30,30,FMN GV 05 Lier
60,Mechelsesteenweg 365,2019-10-25,11:00:00,68,32,36,FMN GV 05 Lier
60,Mechelsesteenweg 365,2019-10-25,12:00:00,82,46,36,FMN GV 05 Lier
60,Mechelsesteenweg 365,2019-10-25,13:00:00,112,68,44,FMN GV 05 Lier
60,Mechelsesteenweg 365,2019-10-25,14:00:00,152,92,60,FMN GV 05 Lier
60,Mechelsesteenweg 365,2019-10-25,15:00:00,148,60,88,FMN GV 05 Lier
60,Mechelsesteenweg 365,2019-10-25,16:00:00,218,82,136,FMN GV 05 Lier
60,Mechelsesteenweg 365,2019-10-25,17:00:00,98,60,38,FMN GV 05 Lier
60,Mechelsesteenweg 365,2019-10-25,18:00:00,54,28,26,FMN GV 05 Lier
60,Mechelsesteenweg 365,2019-10-25,19:00:00,26,22,4,FMN GV 05 Lier
60,Mechelsesteenweg 365,2019-10-25,20:00:00,16,8,8,FMN GV 05 Lier
60,Mechelsesteenweg 365,2019-10-25,21:00:00,8,6,2,FMN GV 05 Lier
60,Mechelsesteenweg 365,2019-10-25,22:00:00,8,4,4,FMN GV 05 Lier
60,Mechelsesteenweg 365,2019-10-25,23:00:00,4,0,4,FMN GV 05 Lier
60,Mechelsesteenweg 365,2019-10-26,00:00:00,4,2,2,FMN GV 05 Lier
60,Mechelsesteenweg 365,2019-10-26,01:00:00,6,2,4,FMN GV 05 Lier
60,Mechelsesteenweg 365,2019-10-26,02:00:00,0,0,0,FMN GV 05 Lier
60,Mechelsesteenweg 365,2019-10-26,03:00:00,0,0,0,FMN GV 05 Lier
60,Mechelsesteenweg 365,2019-10-26,04:00:00,2,0,2,FMN GV 05 Lier
60,Mechelsesteenweg 365,2019-10-26,05:00:00,0,0,0,FMN GV 05 Lier
60,Mechelsesteenweg 365,2019-10-26,06:00:00,2,2,0,FMN GV 05 Lier
60,Mechelsesteenweg 365,2019-10-26,07:00:00,2,0,2,FMN GV 05 Lier
60,Mechelsesteenweg 365,2019-10-26,08:00:00,8,0,8,FMN GV 05 Lier
60,Mechelsesteenweg 365,2019-10-26,09:00:00,58,40,18,FMN GV 05 Lier
60,Mechelsesteenweg 365,2019-10-26,10:00:00,162,100,62,FMN GV 05 Lier
60,Mechelsesteenweg 365,2019-10-26,11:00:00,154,64,90,FMN GV 05 Lier
60,Mechelsesteenweg 365,2019-10-26,12:00:00,148,74,74,FMN GV 05 Lier
60,Mechelsesteenweg 365,2019-10-26,13:00:00,172,106,66,FMN GV 05 Lier
60,Mechelsesteenweg 365,2019-10-26,14:00:00,302,144,158,FMN GV 05 Lier
60,Mechelsesteenweg 365,2019-10-26,15:00:00,230,118,112,FMN GV 05 Lier
60,Mechelsesteenweg 365,2019-10-26,16:00:00,172,60,112,FMN GV 05 Lier
60,Mechelsesteenweg 365,2019-10-26,17:00:00,94,44,50,FMN GV 05 Lier
60,Mechelsesteenweg 365,2019-10-26,18:00:00,26,20,6,FMN GV 05 Lier
60,Mechelsesteenweg 365,2019-10-26,19:00:00,26,12,14,FMN GV 05 Lier
60,Mechelsesteenweg 365,2019-10-26,20:00:00,4,0,4,FMN GV 05 Lier
60,Mechelsesteenweg 365,2019-10-26,21:00:00,0,0,0,FMN GV 05 Lier
60,Mechelsesteenweg 365,2019-10-26,22:00:00,10,2,8,FMN GV 05 Lier
60,Mechelsesteenweg 365,2019-10-26,23:00:00,8,2,6,FMN GV 05 Lier
60,Mechelsesteenweg 365,2019-10-27,00:00:00,36,0,36,FMN GV 05 Lier
60,Mechelsesteenweg 365,2019-10-27,01:00:00,4,4,0,FMN GV 05 Lier
60,Mechelsesteenweg 365,2019-10-27,02:00:00,8,8,0,FMN GV 05 Lier
60,Mechelsesteenweg 365,2019-10-27,03:00:00,12,8,4,FMN GV 05 Lier
60,Mechelsesteenweg 365,2019-10-27,04:00:00,0,0,0,FMN GV 05 Lier
60,Mechelsesteenweg 365,2019-10-27,05:00:00,0,0,0,FMN GV 05 Lier
60,Mechelsesteenweg 365,2019-10-27,06:00:00,4,2,2,FMN GV 05 Lier
60,Mechelsesteenweg 365,2019-10-27,07:00:00,2,2,0,FMN GV 05 Lier
60,Mechelsesteenweg 365,2019-10-27,08:00:00,38,22,16,FMN GV 05 Lier
60,Mechelsesteenweg 365,2019-10-27,09:00:00,118,68,50,FMN GV 05 Lier
60,Mechelsesteenweg 365,2019-10-27,10:00:00,144,72,72,FMN GV 05 Lier
60,Mechelsesteenweg 365,2019-10-27,11:00:00,172,100,72,FMN GV 05 Lier
60,Mechelsesteenweg 365,2019-10-27,12:00:00,98,44,54,FMN GV 05 Lier
60,Mechelsesteenweg 365,2019-10-27,13:00:00,78,54,24,FMN GV 05 Lier
60,Mechelsesteenweg 365,2019-10-27,14:00:00,148,74,74,FMN GV 05 Lier
60,Mechelsesteenweg 365,2019-10-27,15:00:00,134,54,80,FMN GV 05 Lier
60,Mechelsesteenweg 365,2019-10-27,16:00:00,110,46,64,FMN GV 05 Lier
60,Mechelsesteenweg 365,2019-10-27,17:00:00,50,14,36,FMN GV 05 Lier
60,Mechelsesteenweg 365,2019-10-27,18:00:00,8,2,6,FMN GV 05 Lier
60,Mechelsesteenweg 365,2019-10-27,19:00:00,0,0,0,FMN GV 05 Lier
60,Mechelsesteenweg 365,2019-10-27,20:00:00,0,0,0,FMN GV 05 Lier
60,Mechelsesteenweg 365,2019-10-27,21:00:00,0,0,0,FMN GV 05 Lier
60,Mechelsesteenweg 365,2019-10-27,22:00:00,2,2,0,FMN GV 05 Lier
60,Mechelsesteenweg 365,2019-10-27,23:00:00,0,0,0,FMN GV 05 Lier
60,Mechelsesteenweg 365,2019-10-28,00:00:00,0,0,0,FMN GV 05 Lier
60,Mechelsesteenweg 365,2019-10-28,01:00:00,0,0,0,FMN GV 05 Lier
60,Mechelsesteenweg 365,2019-10-28,02:00:00,0,0,0,FMN GV 05 Lier
60,Mechelsesteenweg 365,2019-10-28,03:00:00,0,0,0,FMN GV 05 Lier
60,Mechelsesteenweg 365,2019-10-28,04:00:00,2,0,2,FMN GV 05 Lier
60,Mechelsesteenweg 365,2019-10-28,05:00:00,8,2,6,FMN GV 05 Lier
60,Mechelsesteenweg 365,2019-10-28,06:00:00,32,6,26,FMN GV 05 Lier
60,Mechelsesteenweg 365,2019-10-28,07:00:00,90,26,64,FMN GV 05 Lier
60,Mechelsesteenweg 365,2019-10-28,08:00:00,54,20,34,FMN GV 05 Lier
60,Mechelsesteenweg 365,2019-10-28,09:00:00,42,24,18,FMN GV 05 Lier
60,Mechelsesteenweg 365,2019-10-28,10:00:00,64,38,26,FMN GV 05 Lier
60,Mechelsesteenweg 365,2019-10-28,11:00:00,62,36,26,FMN GV 05 Lier
60,Mechelsesteenweg 365,2019-10-28,12:00:00,60,32,28,FMN GV 05 Lier
60,Mechelsesteenweg 365,2019-10-28,13:00:00,94,44,50,FMN GV 05 Lier
60,Mechelsesteenweg 365,2019-10-28,14:00:00,164,108,56,FMN GV 05 Lier
60,Mechelsesteenweg 365,2019-10-28,15:00:00,140,70,70,FMN GV 05 Lier
60,Mechelsesteenweg 365,2019-10-28,16:00:00,152,82,70,FMN GV 05 Lier
60,Mechelsesteenweg 365,2019-10-28,17:00:00,100,74,26,FMN GV 05 Lier
60,Mechelsesteenweg 365,2019-10-28,18:00:00,30,16,14,FMN GV 05 Lier
60,Mechelsesteenweg 365,2019-10-28,19:00:00,6,4,2,FMN GV 05 Lier
60,Mechelsesteenweg 365,2019-10-28,20:00:00,4,2,2,FMN GV 05 Lier
60,Mechelsesteenweg 365,2019-10-28,21:00:00,0,0,0,FMN GV 05 Lier
60,Mechelsesteenweg 365,2019-10-28,22:00:00,4,4,0,FMN GV 05 Lier
60,Mechelsesteenweg 365,2019-10-28,23:00:00,2,0,2,FMN GV 05 Lier
60,Mechelsesteenweg 365,2019-10-29,00:00:00,2,2,0,FMN GV 05 Lier
60,Mechelsesteenweg 365,2019-10-29,01:00:00,0,0,0,FMN GV 05 Lier
60,Mechelsesteenweg 365,2019-10-29,02:00:00,0,0,0,FMN GV 05 Lier
60,Mechelsesteenweg 365,2019-10-29,03:00:00,0,0,0,FMN GV 05 Lier
60,Mechelsesteenweg 365,2019-10-29,04:00:00,2,0,2,FMN GV 05 Lier
60,Mechelsesteenweg 365,2019-10-29,05:00:00,2,0,2,FMN GV 05 Lier
60,Mechelsesteenweg 365,2019-10-29,06:00:00,36,2,34,FMN GV 05 Lier
60,Mechelsesteenweg 365,2019-10-29,07:00:00,84,36,48,FMN GV 05 Lier
60,Mechelsesteenweg 365,2019-10-29,08:00:00,66,20,46,FMN GV 05 Lier
60,Mechelsesteenweg 365,2019-10-29,09:00:00,56,26,30,FMN GV 05 Lier
60,Mechelsesteenweg 365,2019-10-29,10:00:00,82,42,40,FMN GV 05 Lier
60,Mechelsesteenweg 365,2019-10-29,11:00:00,88,48,40,FMN GV 05 Lier
60,Mechelsesteenweg 365,2019-10-29,12:00:00,102,56,46,FMN GV 05 Lier
60,Mechelsesteenweg 365,2019-10-29,13:00:00,184,66,118,FMN GV 05 Lier
60,Mechelsesteenweg 365,2019-10-29,14:00:00,150,72,78,FMN GV 05 Lier
60,Mechelsesteenweg 365,2019-10-29,15:00:00,136,86,50,FMN GV 05 Lier
60,Mechelsesteenweg 365,2019-10-29,16:00:00,132,58,74,FMN GV 05 Lier
60,Mechelsesteenweg 365,2019-10-29,17:00:00,108,74,34,FMN GV 05 Lier
60,Mechelsesteenweg 365,2019-10-29,18:00:00,32,14,18,FMN GV 05 Lier
60,Mechelsesteenweg 365,2019-10-29,19:00:00,30,8,22,FMN GV 05 Lier
60,Mechelsesteenweg 365,2019-10-29,20:00:00,6,6,0,FMN GV 05 Lier
60,Mechelsesteenweg 365,2019-10-29,21:00:00,0,0,0,FMN GV 05 Lier
60,Mechelsesteenweg 365,2019-10-29,22:00:00,10,10,0,FMN GV 05 Lier
60,Mechelsesteenweg 365,2019-10-29,23:00:00,4,0,4,FMN GV 05 Lier
60,Mechelsesteenweg 365,2019-10-30,00:00:00,0,0,0,FMN GV 05 Lier
60,Mechelsesteenweg 365,2019-10-30,01:00:00,0,0,0,FMN GV 05 Lier
60,Mechelsesteenweg 365,2019-10-30,02:00:00,4,4,0,FMN GV 05 Lier
60,Mechelsesteenweg 365,2019-10-30,03:00:00,0,0,0,FMN GV 05 Lier
60,Mechelsesteenweg 365,2019-10-30,04:00:00,2,0,2,FMN GV 05 Lier
60,Mechelsesteenweg 365,2019-10-30,05:00:00,4,2,2,FMN GV 05 Lier
60,Mechelsesteenweg 365,2019-10-30,06:00:00,20,2,18,FMN GV 05 Lier
60,Mechelsesteenweg 365,2019-10-30,07:00:00,70,28,42,FMN GV 05 Lier
60,Mechelsesteenweg 365,2019-10-30,08:00:00,48,14,34,FMN GV 05 Lier
60,Mechelsesteenweg 365,2019-10-30,09:00:00,38,28,10,FMN GV 05 Lier
60,Mechelsesteenweg 365,2019-10-30,10:00:00,76,36,40,FMN GV 05 Lier
60,Mechelsesteenweg 365,2019-10-30,11:00:00,64,22,42,FMN GV 05 Lier
60,Mechelsesteenweg 365,2019-10-30,12:00:00,42,16,26,FMN GV 05 Lier
60,Mechelsesteenweg 365,2019-10-30,13:00:00,102,44,58,FMN GV 05 Lier
60,Mechelsesteenweg 365,2019-10-30,14:00:00,116,90,26,FMN GV 05 Lier
60,Mechelsesteenweg 365,2019-10-30,15:00:00,130,58,72,FMN GV 05 Lier
60,Mechelsesteenweg 365,2019-10-30,16:00:00,98,42,56,FMN GV 05 Lier
60,Mechelsesteenweg 365,2019-10-30,17:00:00,94,48,46,FMN GV 05 Lier
60,Mechelsesteenweg 365,2019-10-30,18:00:00,44,18,26,FMN GV 05 Lier
60,Mechelsesteenweg 365,2019-10-30,19:00:00,8,8,0,FMN GV 05 Lier
60,Mechelsesteenweg 365,2019-10-30,20:00:00,14,10,4,FMN GV 05 Lier
60,Mechelsesteenweg 365,2019-10-30,21:00:00,2,0,2,FMN GV 05 Lier
60,Mechelsesteenweg 365,2019-10-30,22:00:00,8,4,4,FMN GV 05 Lier
60,Mechelsesteenweg 365,2019-10-30,23:00:00,0,0,0,FMN GV 05 Lier
60,Mechelsesteenweg 365,2019-10-31,00:00:00,0,0,0,FMN GV 05 Lier
60,Mechelsesteenweg 365,2019-10-31,01:00:00,0,0,0,FMN GV 05 Lier
60,Mechelsesteenweg 365,2019-10-31,02:00:00,0,0,0,FMN GV 05 Lier
60,Mechelsesteenweg 365,2019-10-31,03:00:00,0,0,0,FMN GV 05 Lier
60,Mechelsesteenweg 365,2019-10-31,04:00:00,0,0,0,FMN GV 05 Lier
60,Mechelsesteenweg 365,2019-10-31,05:00:00,6,0,6,FMN GV 05 Lier
60,Mechelsesteenweg 365,2019-10-31,06:00:00,20,2,18,FMN GV 05 Lier
60,Mechelsesteenweg 365,2019-10-31,07:00:00,56,20,36,FMN GV 05 Lier
60,Mechelsesteenweg 365,2019-10-31,08:00:00,38,14,24,FMN GV 05 Lier
60,Mechelsesteenweg 365,2019-10-31,09:00:00,34,20,14,FMN GV 05 Lier
60,Mechelsesteenweg 365,2019-10-31,10:00:00,40,22,18,FMN GV 05 Lier
60,Mechelsesteenweg 365,2019-10-31,11:00:00,30,12,18,FMN GV 05 Lier
60,Mechelsesteenweg 365,2019-10-31,12:00:00,74,24,50,FMN GV 05 Lier
60,Mechelsesteenweg 365,2019-10-31,13:00:00,118,74,44,FMN GV 05 Lier
60,Mechelsesteenweg 365,2019-10-31,14:00:00,144,82,62,FMN GV 05 Lier
60,Mechelsesteenweg 365,2019-10-31,15:00:00,128,62,66,FMN GV 05 Lier
60,Mechelsesteenweg 365,2019-10-31,16:00:00,106,46,60,FMN GV 05 Lier
60,Mechelsesteenweg 365,2019-10-31,17:00:00,58,40,18,FMN GV 05 Lier
60,Mechelsesteenweg 365,2019-10-31,18:00:00,26,18,8,FMN GV 05 Lier
60,Mechelsesteenweg 365,2019-10-31,19:00:00,28,16,12,FMN GV 05 Lier
60,Mechelsesteenweg 365,2019-10-31,20:00:00,2,0,2,FMN GV 05 Lier
60,Mechelsesteenweg 365,2019-10-31,21:00:00,4,0,4,FMN GV 05 Lier
60,Mechelsesteenweg 365,2019-10-31,22:00:00,14,12,2,FMN GV 05 Lier
60,Mechelsesteenweg 365,2019-10-31,23:00:00,0,0,0,FMN GV 05 Lier
60,Mechelsesteenweg 365,2019-11-01,00:00:00,0,0,0,FMN GV 05 Lier
60,Mechelsesteenweg 365,2019-11-01,01:00:00,0,0,0,FMN GV 05 Lier
60,Mechelsesteenweg 365,2019-11-01,02:00:00,0,0,0,FMN GV 05 Lier
60,Mechelsesteenweg 365,2019-11-01,03:00:00,0,0,0,FMN GV 05 Lier
60,Mechelsesteenweg 365,2019-11-01,04:00:00,0,0,0,FMN GV 05 Lier
60,Mechelsesteenweg 365,2019-11-01,05:00:00,0,0,0,FMN GV 05 Lier
60,Mechelsesteenweg 365,2019-11-01,06:00:00,0,0,0,FMN GV 05 Lier
60,Mechelsesteenweg 365,2019-11-01,07:00:00,12,12,0,FMN GV 05 Lier
60,Mechelsesteenweg 365,2019-11-01,08:00:00,12,4,8,FMN GV 05 Lier
60,Mechelsesteenweg 365,2019-11-01,09:00:00,22,6,16,FMN GV 05 Lier
60,Mechelsesteenweg 365,2019-11-01,10:00:00,16,10,6,FMN GV 05 Lier
60,Mechelsesteenweg 365,2019-11-01,11:00:00,18,8,10,FMN GV 05 Lier
60,Mechelsesteenweg 365,2019-11-01,12:00:00,8,6,2,FMN GV 05 Lier
60,Mechelsesteenweg 365,2019-11-01,13:00:00,14,10,4,FMN GV 05 Lier
60,Mechelsesteenweg 365,2019-11-01,14:00:00,12,6,6,FMN GV 05 Lier
60,Mechelsesteenweg 365,2019-11-01,15:00:00,10,8,2,FMN GV 05 Lier
60,Mechelsesteenweg 365,2019-11-01,16:00:00,16,10,6,FMN GV 05 Lier
60,Mechelsesteenweg 365,2019-11-01,17:00:00,16,6,10,FMN GV 05 Lier
60,Mechelsesteenweg 365,2019-11-01,18:00:00,6,4,2,FMN GV 05 Lier
60,Mechelsesteenweg 365,2019-11-01,19:00:00,4,2,2,FMN GV 05 Lier
60,Mechelsesteenweg 365,2019-11-01,20:00:00,14,12,2,FMN GV 05 Lier
60,Mechelsesteenweg 365,2019-11-01,21:00:00,4,4,0,FMN GV 05 Lier
60,Mechelsesteenweg 365,2019-11-01,22:00:00,2,0,2,FMN GV 05 Lier
60,Mechelsesteenweg 365,2019-11-01,23:00:00,0,0,0,FMN GV 05 Lier
60,Mechelsesteenweg 365,2019-11-02,00:00:00,0,0,0,FMN GV 05 Lier
60,Mechelsesteenweg 365,2019-11-02,01:00:00,0,0,0,FMN GV 05 Lier
60,Mechelsesteenweg 365,2019-11-02,02:00:00,0,0,0,FMN GV 05 Lier
60,Mechelsesteenweg 365,2019-11-02,03:00:00,0,0,0,FMN GV 05 Lier
60,Mechelsesteenweg 365,2019-11-02,04:00:00,0,0,0,FMN GV 05 Lier
60,Mechelsesteenweg 365,2019-11-02,05:00:00,0,0,0,FMN GV 05 Lier
60,Mechelsesteenweg 365,2019-11-02,06:00:00,2,2,0,FMN GV 05 Lier
60,Mechelsesteenweg 365,2019-11-02,07:00:00,2,0,2,FMN GV 05 Lier
60,Mechelsesteenweg 365,2019-11-02,08:00:00,6,2,4,FMN GV 05 Lier
60,Mechelsesteenweg 365,2019-11-02,09:00:00,38,26,12,FMN GV 05 Lier
60,Mechelsesteenweg 365,2019-11-02,10:00:00,20,8,12,FMN GV 05 Lier
60,Mechelsesteenweg 365,2019-11-02,11:00:00,30,20,10,FMN GV 05 Lier
60,Mechelsesteenweg 365,2019-11-02,12:00:00,30,12,18,FMN GV 05 Lier
60,Mechelsesteenweg 365,2019-11-02,13:00:00,52,38,14,FMN GV 05 Lier
60,Mechelsesteenweg 365,2019-11-02,14:00:00,120,52,68,FMN GV 05 Lier
60,Mechelsesteenweg 365,2019-11-02,15:00:00,76,36,40,FMN GV 05 Lier
60,Mechelsesteenweg 365,2019-11-02,16:00:00,34,18,16,FMN GV 05 Lier
60,Mechelsesteenweg 365,2019-11-02,17:00:00,20,12,8,FMN GV 05 Lier
60,Mechelsesteenweg 365,2019-11-02,18:00:00,2,0,2,FMN GV 05 Lier
60,Mechelsesteenweg 365,2019-11-02,19:00:00,0,0,0,FMN GV 05 Lier
60,Mechelsesteenweg 365,2019-11-02,20:00:00,22,18,4,FMN GV 05 Lier
60,Mechelsesteenweg 365,2019-11-02,21:00:00,0,0,0,FMN GV 05 Lier
60,Mechelsesteenweg 365,2019-11-02,22:00:00,2,0,2,FMN GV 05 Lier
60,Mechelsesteenweg 365,2019-11-02,23:00:00,0,0,0,FMN GV 05 Lier
60,Mechelsesteenweg 365,2019-11-03,00:00:00,16,0,16,FMN GV 05 Lier
60,Mechelsesteenweg 365,2019-11-03,01:00:00,0,0,0,FMN GV 05 Lier
60,Mechelsesteenweg 365,2019-11-03,02:00:00,0,0,0,FMN GV 05 Lier
60,Mechelsesteenweg 365,2019-11-03,03:00:00,0,0,0,FMN GV 05 Lier
60,Mechelsesteenweg 365,2019-11-03,04:00:00,0,0,0,FMN GV 05 Lier
60,Mechelsesteenweg 365,2019-11-03,05:00:00,0,0,0,FMN GV 05 Lier
60,Mechelsesteenweg 365,2019-11-03,06:00:00,0,0,0,FMN GV 05 Lier
60,Mechelsesteenweg 365,2019-11-03,07:00:00,2,2,0,FMN GV 05 Lier
60,Mechelsesteenweg 365,2019-11-03,08:00:00,38,30,8,FMN GV 05 Lier
60,Mechelsesteenweg 365,2019-11-03,09:00:00,102,74,28,FMN GV 05 Lier
60,Mechelsesteenweg 365,2019-11-03,10:00:00,188,122,66,FMN GV 05 Lier
60,Mechelsesteenweg 365,2019-11-03,11:00:00,104,46,58,FMN GV 05 Lier
60,Mechelsesteenweg 365,2019-11-03,12:00:00,36,14,22,FMN GV 05 Lier
60,Mechelsesteenweg 365,2019-11-03,13:00:00,22,6,16,FMN GV 05 Lier
60,Mechelsesteenweg 365,2019-11-03,14:00:00,16,8,8,FMN GV 05 Lier
60,Mechelsesteenweg 365,2019-11-03,15:00:00,22,8,14,FMN GV 05 Lier
60,Mechelsesteenweg 365,2019-11-03,16:00:00,16,10,6,FMN GV 05 Lier
60,Mechelsesteenweg 365,2019-11-03,17:00:00,32,6,26,FMN GV 05 Lier
60,Mechelsesteenweg 365,2019-11-03,18:00:00,8,2,6,FMN GV 05 Lier
60,Mechelsesteenweg 365,2019-11-03,19:00:00,4,4,0,FMN GV 05 Lier
60,Mechelsesteenweg 365,2019-11-03,20:00:00,4,0,4,FMN GV 05 Lier
60,Mechelsesteenweg 365,2019-11-03,21:00:00,4,2,2,FMN GV 05 Lier
60,Mechelsesteenweg 365,2019-11-03,22:00:00,2,0,2,FMN GV 05 Lier
60,Mechelsesteenweg 365,2019-11-03,23:00:00,6,2,4,FMN GV 05 Lier
60,Mechelsesteenweg 365,2019-11-04,00:00:00,0,0,0,FMN GV 05 Lier
60,Mechelsesteenweg 365,2019-11-04,01:00:00,0,0,0,FMN GV 05 Lier
60,Mechelsesteenweg 365,2019-11-04,02:00:00,0,0,0,FMN GV 05 Lier
60,Mechelsesteenweg 365,2019-11-04,03:00:00,0,0,0,FMN GV 05 Lier
60,Mechelsesteenweg 365,2019-11-04,04:00:00,4,0,4,FMN GV 05 Lier
60,Mechelsesteenweg 365,2019-11-04,05:00:00,2,0,2,FMN GV 05 Lier
60,Mechelsesteenweg 365,2019-11-04,06:00:00,24,10,14,FMN GV 05 Lier
60,Mechelsesteenweg 365,2019-11-04,07:00:00,160,102,58,FMN GV 05 Lier
60,Mechelsesteenweg 365,2019-11-04,08:00:00,130,102,28,FMN GV 05 Lier
60,Mechelsesteenweg 365,2019-11-04,09:00:00,50,26,24,FMN GV 05 Lier
60,Mechelsesteenweg 365,2019-11-04,10:00:00,28,14,14,FMN GV 05 Lier
60,Mechelsesteenweg 365,2019-11-04,11:00:00,32,12,20,FMN GV 05 Lier
60,Mechelsesteenweg 365,2019-11-04,12:00:00,26,20,6,FMN GV 05 Lier
60,Mechelsesteenweg 365,2019-11-04,13:00:00,50,30,20,FMN GV 05 Lier
60,Mechelsesteenweg 365,2019-11-04,14:00:00,88,54,34,FMN GV 05 Lier
60,Mechelsesteenweg 365,2019-11-04,15:00:00,80,36,44,FMN GV 05 Lier
60,Mechelsesteenweg 365,2019-11-04,16:00:00,222,60,162,FMN GV 05 Lier
60,Mechelsesteenweg 365,2019-11-04,17:00:00,102,70,32,FMN GV 05 Lier
60,Mechelsesteenweg 365,2019-11-04,18:00:00,24,12,12,FMN GV 05 Lier
60,Mechelsesteenweg 365,2019-11-04,19:00:00,6,2,4,FMN GV 05 Lier
60,Mechelsesteenweg 365,2019-11-04,20:00:00,4,2,2,FMN GV 05 Lier
60,Mechelsesteenweg 365,2019-11-04,21:00:00,4,0,4,FMN GV 05 Lier
60,Mechelsesteenweg 365,2019-11-04,22:00:00,4,0,4,FMN GV 05 Lier
60,Mechelsesteenweg 365,2019-11-04,23:00:00,0,0,0,FMN GV 05 Lier
60,Mechelsesteenweg 365,2019-11-05,00:00:00,2,0,2,FMN GV 05 Lier
60,Mechelsesteenweg 365,2019-11-05,01:00:00,0,0,0,FMN GV 05 Lier
60,Mechelsesteenweg 365,2019-11-05,02:00:00,0,0,0,FMN GV 05 Lier
60,Mechelsesteenweg 365,2019-11-05,03:00:00,0,0,0,FMN GV 05 Lier
60,Mechelsesteenweg 365,2019-11-05,04:00:00,2,0,2,FMN GV 05 Lier
60,Mechelsesteenweg 365,2019-11-05,05:00:00,10,2,8,FMN GV 05 Lier
60,Mechelsesteenweg 365,2019-11-05,06:00:00,18,2,16,FMN GV 05 Lier
60,Mechelsesteenweg 365,2019-11-05,07:00:00,210,124,86,FMN GV 05 Lier
60,Mechelsesteenweg 365,2019-11-05,08:00:00,102,68,34,FMN GV 05 Lier
60,Mechelsesteenweg 365,2019-11-05,09:00:00,64,36,28,FMN GV 05 Lier
60,Mechelsesteenweg 365,2019-11-05,10:00:00,90,52,38,FMN GV 05 Lier
60,Mechelsesteenweg 365,2019-11-05,11:00:00,54,26,28,FMN GV 05 Lier
60,Mechelsesteenweg 365,2019-11-05,12:00:00,72,42,30,FMN GV 05 Lier
60,Mechelsesteenweg 365,2019-11-05,13:00:00,152,70,82,FMN GV 05 Lier
60,Mechelsesteenweg 365,2019-11-05,14:00:00,126,70,56,FMN GV 05 Lier
60,Mechelsesteenweg 365,2019-11-05,15:00:00,88,36,52,FMN GV 05 Lier
60,Mechelsesteenweg 365,2019-11-05,16:00:00,278,78,200,FMN GV 05 Lier
60,Mechelsesteenweg 365,2019-11-05,17:00:00,102,66,36,FMN GV 05 Lier
60,Mechelsesteenweg 365,2019-11-05,18:00:00,36,22,14,FMN GV 05 Lier
60,Mechelsesteenweg 365,2019-11-05,19:00:00,36,18,18,FMN GV 05 Lier
60,Mechelsesteenweg 365,2019-11-05,20:00:00,12,2,10,FMN GV 05 Lier
60,Mechelsesteenweg 365,2019-11-05,21:00:00,14,8,6,FMN GV 05 Lier
60,Mechelsesteenweg 365,2019-11-05,22:00:00,4,4,0,FMN GV 05 Lier
60,Mechelsesteenweg 365,2019-11-05,23:00:00,0,0,0,FMN GV 05 Lier
60,Mechelsesteenweg 365,2019-11-06,00:00:00,0,0,0,FMN GV 05 Lier
60,Mechelsesteenweg 365,2019-11-06,01:00:00,0,0,0,FMN GV 05 Lier
60,Mechelsesteenweg 365,2019-11-06,02:00:00,0,0,0,FMN GV 05 Lier
60,Mechelsesteenweg 365,2019-11-06,03:00:00,0,0,0,FMN GV 05 Lier
60,Mechelsesteenweg 365,2019-11-06,04:00:00,2,0,2,FMN GV 05 Lier
60,Mechelsesteenweg 365,2019-11-06,05:00:00,10,2,8,FMN GV 05 Lier
60,Mechelsesteenweg 365,2019-11-06,06:00:00,32,8,24,FMN GV 05 Lier
60,Mechelsesteenweg 365,2019-11-06,07:00:00,170,114,56,FMN GV 05 Lier
60,Mechelsesteenweg 365,2019-11-06,08:00:00,120,82,38,FMN GV 05 Lier
60,Mechelsesteenweg 365,2019-11-06,09:00:00,56,40,16,FMN GV 05 Lier
60,Mechelsesteenweg 365,2019-11-06,10:00:00,32,22,10,FMN GV 05 Lier
60,Mechelsesteenweg 365,2019-11-06,11:00:00,70,30,40,FMN GV 05 Lier
60,Mechelsesteenweg 365,2019-11-06,12:00:00,176,28,148,FMN GV 05 Lier
60,Mechelsesteenweg 365,2019-11-06,13:00:00,90,42,48,FMN GV 05 Lier
60,Mechelsesteenweg 365,2019-11-06,14:00:00,96,76,20,FMN GV 05 Lier
60,Mechelsesteenweg 365,2019-11-06,15:00:00,114,60,54,FMN GV 05 Lier
60,Mechelsesteenweg 365,2019-11-06,16:00:00,120,56,64,FMN GV 05 Lier
60,Mechelsesteenweg 365,2019-11-06,17:00:00,62,42,20,FMN GV 05 Lier
60,Mechelsesteenweg 365,2019-11-06,18:00:00,38,20,18,FMN GV 05 Lier
60,Mechelsesteenweg 365,2019-11-06,19:00:00,16,8,8,FMN GV 05 Lier
60,Mechelsesteenweg 365,2019-11-06,20:00:00,10,4,6,FMN GV 05 Lier
60,Mechelsesteenweg 365,2019-11-06,21:00:00,4,2,2,FMN GV 05 Lier
60,Mechelsesteenweg 365,2019-11-06,22:00:00,6,2,4,FMN GV 05 Lier
60,Mechelsesteenweg 365,2019-11-06,23:00:00,0,0,0,FMN GV 05 Lier
60,Mechelsesteenweg 365,2019-11-07,00:00:00,2,2,0,FMN GV 05 Lier
60,Mechelsesteenweg 365,2019-11-07,01:00:00,0,0,0,FMN GV 05 Lier
60,Mechelsesteenweg 365,2019-11-07,02:00:00,0,0,0,FMN GV 05 Lier
60,Mechelsesteenweg 365,2019-11-07,03:00:00,0,0,0,FMN GV 05 Lier
60,Mechelsesteenweg 365,2019-11-07,04:00:00,2,0,2,FMN GV 05 Lier
60,Mechelsesteenweg 365,2019-11-07,05:00:00,6,0,6,FMN GV 05 Lier
60,Mechelsesteenweg 365,2019-11-07,06:00:00,16,2,14,FMN GV 05 Lier
60,Mechelsesteenweg 365,2019-11-07,07:00:00,160,92,68,FMN GV 05 Lier
60,Mechelsesteenweg 365,2019-11-07,08:00:00,120,74,46,FMN GV 05 Lier
60,Mechelsesteenweg 365,2019-11-07,09:00:00,28,22,6,FMN GV 05 Lier
60,Mechelsesteenweg 365,2019-11-07,10:00:00,10,6,4,FMN GV 05 Lier
60,Mechelsesteenweg 365,2019-11-07,11:00:00,6,2,4,FMN GV 05 Lier
60,Mechelsesteenweg 365,2019-11-07,12:00:00,14,4,10,FMN GV 05 Lier
60,Mechelsesteenweg 365,2019-11-07,13:00:00,24,10,14,FMN GV 05 Lier
60,Mechelsesteenweg 365,2019-11-07,14:00:00,50,28,22,FMN GV 05 Lier
60,Mechelsesteenweg 365,2019-11-07,15:00:00,66,38,28,FMN GV 05 Lier
60,Mechelsesteenweg 365,2019-11-07,16:00:00,194,50,144,FMN GV 05 Lier
60,Mechelsesteenweg 365,2019-11-07,17:00:00,90,54,36,FMN GV 05 Lier
60,Mechelsesteenweg 365,2019-11-07,18:00:00,32,20,12,FMN GV 05 Lier
60,Mechelsesteenweg 365,2019-11-07,19:00:00,10,8,2,FMN GV 05 Lier
60,Mechelsesteenweg 365,2019-11-07,20:00:00,10,8,2,FMN GV 05 Lier
60,Mechelsesteenweg 365,2019-11-07,21:00:00,2,2,0,FMN GV 05 Lier
60,Mechelsesteenweg 365,2019-11-07,22:00:00,6,4,2,FMN GV 05 Lier
60,Mechelsesteenweg 365,2019-11-07,23:00:00,0,0,0,FMN GV 05 Lier
60,Mechelsesteenweg 365,2019-11-08,00:00:00,0,0,0,FMN GV 05 Lier
60,Mechelsesteenweg 365,2019-11-08,01:00:00,2,2,0,FMN GV 05 Lier
60,Mechelsesteenweg 365,2019-11-08,02:00:00,0,0,0,FMN GV 05 Lier
60,Mechelsesteenweg 365,2019-11-08,03:00:00,0,0,0,FMN GV 05 Lier
60,Mechelsesteenweg 365,2019-11-08,04:00:00,0,0,0,FMN GV 05 Lier
60,Mechelsesteenweg 365,2019-11-08,05:00:00,6,0,6,FMN GV 05 Lier
60,Mechelsesteenweg 365,2019-11-08,06:00:00,20,4,16,FMN GV 05 Lier
60,Mechelsesteenweg 365,2019-11-08,07:00:00,144,90,54,FMN GV 05 Lier
60,Mechelsesteenweg 365,2019-11-08,08:00:00,116,84,32,FMN GV 05 Lier
60,Mechelsesteenweg 365,2019-11-08,09:00:00,46,24,22,FMN GV 05 Lier
60,Mechelsesteenweg 365,2019-11-08,10:00:00,94,38,56,FMN GV 05 Lier
60,Mechelsesteenweg 365,2019-11-08,11:00:00,80,30,50,FMN GV 05 Lier
60,Mechelsesteenweg 365,2019-11-08,12:00:00,120,74,46,FMN GV 05 Lier
60,Mechelsesteenweg 365,2019-11-08,13:00:00,194,116,78,FMN GV 05 Lier
60,Mechelsesteenweg 365,2019-11-08,14:00:00,218,118,100,FMN GV 05 Lier
60,Mechelsesteenweg 365,2019-11-08,15:00:00,192,88,104,FMN GV 05 Lier
60,Mechelsesteenweg 365,2019-11-08,16:00:00,236,86,150,FMN GV 05 Lier
60,Mechelsesteenweg 365,2019-11-08,17:00:00,72,50,22,FMN GV 05 Lier
60,Mechelsesteenweg 365,2019-11-08,18:00:00,40,24,16,FMN GV 05 Lier
60,Mechelsesteenweg 365,2019-11-08,19:00:00,4,2,2,FMN GV 05 Lier
60,Mechelsesteenweg 365,2019-11-08,20:00:00,20,18,2,FMN GV 05 Lier
60,Mechelsesteenweg 365,2019-11-08,21:00:00,10,6,4,FMN GV 05 Lier
60,Mechelsesteenweg 365,2019-11-08,22:00:00,2,0,2,FMN GV 05 Lier
60,Mechelsesteenweg 365,2019-11-08,23:00:00,0,0,0,FMN GV 05 Lier
60,Mechelsesteenweg 365,2019-11-09,00:00:00,0,0,0,FMN GV 05 Lier
60,Mechelsesteenweg 365,2019-11-09,01:00:00,2,0,2,FMN GV 05 Lier
60,Mechelsesteenweg 365,2019-11-09,02:00:00,0,0,0,FMN GV 05 Lier
60,Mechelsesteenweg 365,2019-11-09,03:00:00,0,0,0,FMN GV 05 Lier
60,Mechelsesteenweg 365,2019-11-09,04:00:00,0,0,0,FMN GV 05 Lier
60,Mechelsesteenweg 365,2019-11-09,05:00:00,0,0,0,FMN GV 05 Lier
60,Mechelsesteenweg 365,2019-11-09,06:00:00,2,0,2,FMN GV 05 Lier
60,Mechelsesteenweg 365,2019-11-09,07:00:00,8,4,4,FMN GV 05 Lier
60,Mechelsesteenweg 365,2019-11-09,08:00:00,14,6,8,FMN GV 05 Lier
60,Mechelsesteenweg 365,2019-11-09,09:00:00,60,30,30,FMN GV 05 Lier
60,Mechelsesteenweg 365,2019-11-09,10:00:00,104,70,34,FMN GV 05 Lier
60,Mechelsesteenweg 365,2019-11-09,11:00:00,98,42,56,FMN GV 05 Lier
60,Mechelsesteenweg 365,2019-11-09,12:00:00,84,52,32,FMN GV 05 Lier
60,Mechelsesteenweg 365,2019-11-09,13:00:00,86,52,34,FMN GV 05 Lier
60,Mechelsesteenweg 365,2019-11-09,14:00:00,130,66,64,FMN GV 05 Lier
60,Mechelsesteenweg 365,2019-11-09,15:00:00,90,50,40,FMN GV 05 Lier
60,Mechelsesteenweg 365,2019-11-09,16:00:00,54,20,34,FMN GV 05 Lier
60,Mechelsesteenweg 365,2019-11-09,17:00:00,26,14,12,FMN GV 05 Lier
60,Mechelsesteenweg 365,2019-11-09,18:00:00,20,16,4,FMN GV 05 Lier
60,Mechelsesteenweg 365,2019-11-09,19:00:00,8,8,0,FMN GV 05 Lier
60,Mechelsesteenweg 365,2019-11-09,20:00:00,6,4,2,FMN GV 05 Lier
60,Mechelsesteenweg 365,2019-11-09,21:00:00,2,2,0,FMN GV 05 Lier
60,Mechelsesteenweg 365,2019-11-09,22:00:00,0,0,0,FMN GV 05 Lier
60,Mechelsesteenweg 365,2019-11-09,23:00:00,6,0,6,FMN GV 05 Lier
60,Mechelsesteenweg 365,2019-11-10,00:00:00,4,0,4,FMN GV 05 Lier
60,Mechelsesteenweg 365,2019-11-10,01:00:00,0,0,0,FMN GV 05 Lier
60,Mechelsesteenweg 365,2019-11-10,02:00:00,0,0,0,FMN GV 05 Lier
60,Mechelsesteenweg 365,2019-11-10,03:00:00,0,0,0,FMN GV 05 Lier
60,Mechelsesteenweg 365,2019-11-10,04:00:00,2,0,2,FMN GV 05 Lier
60,Mechelsesteenweg 365,2019-11-10,05:00:00,2,0,2,FMN GV 05 Lier
60,Mechelsesteenweg 365,2019-11-10,06:00:00,0,0,0,FMN GV 05 Lier
60,Mechelsesteenweg 365,2019-11-10,07:00:00,4,0,4,FMN GV 05 Lier
60,Mechelsesteenweg 365,2019-11-10,08:00:00,24,18,6,FMN GV 05 Lier
60,Mechelsesteenweg 365,2019-11-10,09:00:00,92,58,34,FMN GV 05 Lier
60,Mechelsesteenweg 365,2019-11-10,10:00:00,166,78,88,FMN GV 05 Lier
60,Mechelsesteenweg 365,2019-11-10,11:00:00,248,122,126,FMN GV 05 Lier
60,Mechelsesteenweg 365,2019-11-10,12:00:00,240,132,108,FMN GV 05 Lier
60,Mechelsesteenweg 365,2019-11-10,13:00:00,230,134,96,FMN GV 05 Lier
60,Mechelsesteenweg 365,2019-11-10,14:00:00,322,170,152,FMN GV 05 Lier
60,Mechelsesteenweg 365,2019-11-10,15:00:00,232,106,126,FMN GV 05 Lier
60,Mechelsesteenweg 365,2019-11-10,16:00:00,160,52,108,FMN GV 05 Lier
60,Mechelsesteenweg 365,2019-11-10,17:00:00,40,20,20,FMN GV 05 Lier
60,Mechelsesteenweg 365,2019-11-10,18:00:00,20,4,16,FMN GV 05 Lier
60,Mechelsesteenweg 365,2019-11-10,19:00:00,2,2,0,FMN GV 05 Lier
60,Mechelsesteenweg 365,2019-11-10,20:00:00,10,10,0,FMN GV 05 Lier
60,Mechelsesteenweg 365,2019-11-10,21:00:00,0,0,0,FMN GV 05 Lier
60,Mechelsesteenweg 365,2019-11-10,22:00:00,2,2,0,FMN GV 05 Lier
60,Mechelsesteenweg 365,2019-11-10,23:00:00,14,0,14,FMN GV 05 Lier
60,Mechelsesteenweg 365,2019-11-11,00:00:00,2,2,0,FMN GV 05 Lier
60,Mechelsesteenweg 365,2019-11-11,01:00:00,2,0,2,FMN GV 05 Lier
60,Mechelsesteenweg 365,2019-11-11,02:00:00,0,0,0,FMN GV 05 Lier
60,Mechelsesteenweg 365,2019-11-11,03:00:00,0,0,0,FMN GV 05 Lier
60,Mechelsesteenweg 365,2019-11-11,04:00:00,0,0,0,FMN GV 05 Lier
60,Mechelsesteenweg 365,2019-11-11,05:00:00,0,0,0,FMN GV 05 Lier
60,Mechelsesteenweg 365,2019-11-11,06:00:00,2,2,0,FMN GV 05 Lier
60,Mechelsesteenweg 365,2019-11-11,07:00:00,8,6,2,FMN GV 05 Lier
60,Mechelsesteenweg 365,2019-11-11,08:00:00,12,8,4,FMN GV 05 Lier
60,Mechelsesteenweg 365,2019-11-11,09:00:00,86,54,32,FMN GV 05 Lier
60,Mechelsesteenweg 365,2019-11-11,10:00:00,100,62,38,FMN GV 05 Lier
60,Mechelsesteenweg 365,2019-11-11,11:00:00,56,30,26,FMN GV 05 Lier
60,Mechelsesteenweg 365,2019-11-11,12:00:00,24,6,18,FMN GV 05 Lier
60,Mechelsesteenweg 365,2019-11-11,13:00:00,18,10,8,FMN GV 05 Lier
60,Mechelsesteenweg 365,2019-11-11,14:00:00,12,10,2,FMN GV 05 Lier
60,Mechelsesteenweg 365,2019-11-11,15:00:00,12,6,6,FMN GV 05 Lier
60,Mechelsesteenweg 365,2019-11-11,16:00:00,8,2,6,FMN GV 05 Lier
60,Mechelsesteenweg 365,2019-11-11,17:00:00,8,8,0,FMN GV 05 Lier
60,Mechelsesteenweg 365,2019-11-11,18:00:00,2,2,0,FMN GV 05 Lier
60,Mechelsesteenweg 365,2019-11-11,19:00:00,6,2,4,FMN GV 05 Lier
60,Mechelsesteenweg 365,2019-11-11,20:00:00,4,2,2,FMN GV 05 Lier
60,Mechelsesteenweg 365,2019-11-11,21:00:00,2,0,2,FMN GV 05 Lier
60,Mechelsesteenweg 365,2019-11-11,22:00:00,4,4,0,FMN GV 05 Lier
60,Mechelsesteenweg 365,2019-11-11,23:00:00,0,0,0,FMN GV 05 Lier
60,Mechelsesteenweg 365,2019-11-12,00:00:00,0,0,0,FMN GV 05 Lier
60,Mechelsesteenweg 365,2019-11-12,01:00:00,0,0,0,FMN GV 05 Lier
60,Mechelsesteenweg 365,2019-11-12,02:00:00,0,0,0,FMN GV 05 Lier
60,Mechelsesteenweg 365,2019-11-12,03:00:00,0,0,0,FMN GV 05 Lier
60,Mechelsesteenweg 365,2019-11-12,04:00:00,0,0,0,FMN GV 05 Lier
60,Mechelsesteenweg 365,2019-11-12,05:00:00,6,0,6,FMN GV 05 Lier
60,Mechelsesteenweg 365,2019-11-12,06:00:00,14,4,10,FMN GV 05 Lier
60,Mechelsesteenweg 365,2019-11-12,07:00:00,168,96,72,FMN GV 05 Lier
60,Mechelsesteenweg 365,2019-11-12,08:00:00,104,70,34,FMN GV 05 Lier
60,Mechelsesteenweg 365,2019-11-12,09:00:00,32,14,18,FMN GV 05 Lier
60,Mechelsesteenweg 365,2019-11-12,10:00:00,56,32,24,FMN GV 05 Lier
60,Mechelsesteenweg 365,2019-11-12,11:00:00,38,20,18,FMN GV 05 Lier
60,Mechelsesteenweg 365,2019-11-12,12:00:00,48,24,24,FMN GV 05 Lier
60,Mechelsesteenweg 365,2019-11-12,13:00:00,72,28,44,FMN GV 05 Lier
60,Mechelsesteenweg 365,2019-11-12,14:00:00,72,46,26,FMN GV 05 Lier
60,Mechelsesteenweg 365,2019-11-12,15:00:00,54,24,30,FMN GV 05 Lier
60,Mechelsesteenweg 365,2019-11-12,16:00:00,208,52,156,FMN GV 05 Lier
60,Mechelsesteenweg 365,2019-11-12,17:00:00,84,58,26,FMN GV 05 Lier
60,Mechelsesteenweg 365,2019-11-12,18:00:00,20,12,8,FMN GV 05 Lier
60,Mechelsesteenweg 365,2019-11-12,19:00:00,22,8,14,FMN GV 05 Lier
60,Mechelsesteenweg 365,2019-11-12,20:00:00,8,2,6,FMN GV 05 Lier
60,Mechelsesteenweg 365,2019-11-12,21:00:00,2,0,2,FMN GV 05 Lier
60,Mechelsesteenweg 365,2019-11-12,22:00:00,8,8,0,FMN GV 05 Lier
60,Mechelsesteenweg 365,2019-11-12,23:00:00,2,2,0,FMN GV 05 Lier
60,Mechelsesteenweg 365,2019-11-13,00:00:00,0,0,0,FMN GV 05 Lier
60,Mechelsesteenweg 365,2019-11-13,01:00:00,0,0,0,FMN GV 05 Lier
60,Mechelsesteenweg 365,2019-11-13,02:00:00,0,0,0,FMN GV 05 Lier
60,Mechelsesteenweg 365,2019-11-13,03:00:00,0,0,0,FMN GV 05 Lier
60,Mechelsesteenweg 365,2019-11-13,04:00:00,0,0,0,FMN GV 05 Lier
60,Mechelsesteenweg 365,2019-11-13,05:00:00,6,2,4,FMN GV 05 Lier
60,Mechelsesteenweg 365,2019-11-13,06:00:00,24,2,22,FMN GV 05 Lier
60,Mechelsesteenweg 365,2019-11-13,07:00:00,156,94,62,FMN GV 05 Lier
60,Mechelsesteenweg 365,2019-11-13,08:00:00,96,44,52,FMN GV 05 Lier
60,Mechelsesteenweg 365,2019-11-13,09:00:00,34,24,10,FMN GV 05 Lier
60,Mechelsesteenweg 365,2019-11-13,10:00:00,42,20,22,FMN GV 05 Lier
60,Mechelsesteenweg 365,2019-11-13,11:00:00,40,8,32,FMN GV 05 Lier
60,Mechelsesteenweg 365,2019-11-13,12:00:00,162,28,134,FMN GV 05 Lier
60,Mechelsesteenweg 365,2019-11-13,13:00:00,82,38,44,FMN GV 05 Lier
60,Mechelsesteenweg 365,2019-11-13,14:00:00,34,16,18,FMN GV 05 Lier
60,Mechelsesteenweg 365,2019-11-13,15:00:00,50,26,24,FMN GV 05 Lier
60,Mechelsesteenweg 365,2019-11-13,16:00:00,88,52,36,FMN GV 05 Lier
60,Mechelsesteenweg 365,2019-11-13,17:00:00,74,50,24,FMN GV 05 Lier
60,Mechelsesteenweg 365,2019-11-13,18:00:00,22,12,10,FMN GV 05 Lier
60,Mechelsesteenweg 365,2019-11-13,19:00:00,24,18,6,FMN GV 05 Lier
60,Mechelsesteenweg 365,2019-11-13,20:00:00,14,14,0,FMN GV 05 Lier
60,Mechelsesteenweg 365,2019-11-13,21:00:00,2,2,0,FMN GV 05 Lier
60,Mechelsesteenweg 365,2019-11-13,22:00:00,6,6,0,FMN GV 05 Lier
60,Mechelsesteenweg 365,2019-11-13,23:00:00,2,0,2,FMN GV 05 Lier
60,Mechelsesteenweg 365,2019-11-14,00:00:00,0,0,0,FMN GV 05 Lier
60,Mechelsesteenweg 365,2019-11-14,01:00:00,0,0,0,FMN GV 05 Lier
60,Mechelsesteenweg 365,2019-11-14,02:00:00,0,0,0,FMN GV 05 Lier
60,Mechelsesteenweg 365,2019-11-14,03:00:00,0,0,0,FMN GV 05 Lier
60,Mechelsesteenweg 365,2019-11-14,04:00:00,2,0,2,FMN GV 05 Lier
60,Mechelsesteenweg 365,2019-11-14,05:00:00,6,0,6,FMN GV 05 Lier
60,Mechelsesteenweg 365,2019-11-14,06:00:00,20,2,18,FMN GV 05 Lier
60,Mechelsesteenweg 365,2019-11-14,07:00:00,156,82,74,FMN GV 05 Lier
60,Mechelsesteenweg 365,2019-11-14,08:00:00,88,68,20,FMN GV 05 Lier
60,Mechelsesteenweg 365,2019-11-14,09:00:00,28,18,10,FMN GV 05 Lier
60,Mechelsesteenweg 365,2019-11-14,10:00:00,24,10,14,FMN GV 05 Lier
60,Mechelsesteenweg 365,2019-11-14,11:00:00,24,16,8,FMN GV 05 Lier
60,Mechelsesteenweg 365,2019-11-14,12:00:00,44,22,22,FMN GV 05 Lier
60,Mechelsesteenweg 365,2019-11-14,13:00:00,64,42,22,FMN GV 05 Lier
60,Mechelsesteenweg 365,2019-11-14,14:00:00,66,30,36,FMN GV 05 Lier
60,Mechelsesteenweg 365,2019-11-14,15:00:00,84,36,48,FMN GV 05 Lier
60,Mechelsesteenweg 365,2019-11-14,16:00:00,192,62,130,FMN GV 05 Lier
60,Mechelsesteenweg 365,2019-11-14,17:00:00,72,40,32,FMN GV 05 Lier
60,Mechelsesteenweg 365,2019-11-14,18:00:00,36,22,14,FMN GV 05 Lier
60,Mechelsesteenweg 365,2019-11-14,19:00:00,16,14,2,FMN GV 05 Lier
60,Mechelsesteenweg 365,2019-11-14,20:00:00,10,6,4,FMN GV 05 Lier
60,Mechelsesteenweg 365,2019-11-14,21:00:00,0,0,0,FMN GV 05 Lier
60,Mechelsesteenweg 365,2019-11-14,22:00:00,12,8,4,FMN GV 05 Lier
60,Mechelsesteenweg 365,2019-11-14,23:00:00,2,0,2,FMN GV 05 Lier
60,Mechelsesteenweg 365,2019-11-15,00:00:00,0,0,0,FMN GV 05 Lier
60,Mechelsesteenweg 365,2019-11-15,01:00:00,0,0,0,FMN GV 05 Lier
60,Mechelsesteenweg 365,2019-11-15,02:00:00,2,2,0,FMN GV 05 Lier
60,Mechelsesteenweg 365,2019-11-15,03:00:00,0,0,0,FMN GV 05 Lier
60,Mechelsesteenweg 365,2019-11-15,04:00:00,2,0,2,FMN GV 05 Lier
60,Mechelsesteenweg 365,2019-11-15,05:00:00,0,0,0,FMN GV 05 Lier
60,Mechelsesteenweg 365,2019-11-15,06:00:00,12,2,10,FMN GV 05 Lier
60,Mechelsesteenweg 365,2019-11-15,07:00:00,158,90,68,FMN GV 05 Lier
60,Mechelsesteenweg 365,2019-11-15,08:00:00,86,54,32,FMN GV 05 Lier
60,Mechelsesteenweg 365,2019-11-15,09:00:00,32,22,10,FMN GV 05 Lier
60,Mechelsesteenweg 365,2019-11-15,10:00:00,20,8,12,FMN GV 05 Lier
60,Mechelsesteenweg 365,2019-11-15,11:00:00,32,10,22,FMN GV 05 Lier
60,Mechelsesteenweg 365,2019-11-15,12:00:00,78,32,46,FMN GV 05 Lier
60,Mechelsesteenweg 365,2019-11-15,13:00:00,58,44,14,FMN GV 05 Lier
60,Mechelsesteenweg 365,2019-11-15,14:00:00,50,22,28,FMN GV 05 Lier
60,Mechelsesteenweg 365,2019-11-15,15:00:00,70,20,50,FMN GV 05 Lier
60,Mechelsesteenweg 365,2019-11-15,16:00:00,160,46,114,FMN GV 05 Lier
60,Mechelsesteenweg 365,2019-11-15,17:00:00,46,22,24,FMN GV 05 Lier
60,Mechelsesteenweg 365,2019-11-15,18:00:00,14,14,0,FMN GV 05 Lier
60,Mechelsesteenweg 365,2019-11-15,19:00:00,20,16,4,FMN GV 05 Lier
60,Mechelsesteenweg 365,2019-11-15,20:00:00,2,2,0,FMN GV 05 Lier
60,Mechelsesteenweg 365,2019-11-15,21:00:00,10,2,8,FMN GV 05 Lier
60,Mechelsesteenweg 365,2019-11-15,22:00:00,2,2,0,FMN GV 05 Lier
60,Mechelsesteenweg 365,2019-11-15,23:00:00,4,2,2,FMN GV 05 Lier
60,Mechelsesteenweg 365,2019-11-16,00:00:00,2,2,0,FMN GV 05 Lier
60,Mechelsesteenweg 365,2019-11-16,01:00:00,0,0,0,FMN GV 05 Lier
60,Mechelsesteenweg 365,2019-11-16,02:00:00,0,0,0,FMN GV 05 Lier
60,Mechelsesteenweg 365,2019-11-16,03:00:00,0,0,0,FMN GV 05 Lier
60,Mechelsesteenweg 365,2019-11-16,04:00:00,2,0,2,FMN GV 05 Lier
60,Mechelsesteenweg 365,2019-11-16,05:00:00,0,0,0,FMN GV 05 Lier
60,Mechelsesteenweg 365,2019-11-16,06:00:00,2,0,2,FMN GV 05 Lier
60,Mechelsesteenweg 365,2019-11-16,07:00:00,8,4,4,FMN GV 05 Lier
60,Mechelsesteenweg 365,2019-11-16,08:00:00,14,8,6,FMN GV 05 Lier
60,Mechelsesteenweg 365,2019-11-16,09:00:00,42,18,24,FMN GV 05 Lier
60,Mechelsesteenweg 365,2019-11-16,10:00:00,92,50,42,FMN GV 05 Lier
60,Mechelsesteenweg 365,2019-11-16,11:00:00,104,42,62,FMN GV 05 Lier
60,Mechelsesteenweg 365,2019-11-16,12:00:00,80,36,44,FMN GV 05 Lier
60,Mechelsesteenweg 365,2019-11-16,13:00:00,134,70,64,FMN GV 05 Lier
60,Mechelsesteenweg 365,2019-11-16,14:00:00,198,116,82,FMN GV 05 Lier
60,Mechelsesteenweg 365,2019-11-16,15:00:00,134,62,72,FMN GV 05 Lier
60,Mechelsesteenweg 365,2019-11-16,16:00:00,82,22,60,FMN GV 05 Lier
60,Mechelsesteenweg 365,2019-11-16,17:00:00,16,8,8,FMN GV 05 Lier
60,Mechelsesteenweg 365,2019-11-16,18:00:00,12,8,4,FMN GV 05 Lier
60,Mechelsesteenweg 365,2019-11-16,19:00:00,4,2,2,FMN GV 05 Lier
60,Mechelsesteenweg 365,2019-11-16,20:00:00,6,4,2,FMN GV 05 Lier
60,Mechelsesteenweg 365,2019-11-16,21:00:00,2,0,2,FMN GV 05 Lier
60,Mechelsesteenweg 365,2019-11-16,22:00:00,4,4,0,FMN GV 05 Lier
60,Mechelsesteenweg 365,2019-11-16,23:00:00,12,6,6,FMN GV 05 Lier
60,Mechelsesteenweg 365,2019-11-17,00:00:00,0,0,0,FMN GV 05 Lier
60,Mechelsesteenweg 365,2019-11-17,01:00:00,0,0,0,FMN GV 05 Lier
60,Mechelsesteenweg 365,2019-11-17,02:00:00,0,0,0,FMN GV 05 Lier
60,Mechelsesteenweg 365,2019-11-17,03:00:00,2,2,0,FMN GV 05 Lier
60,Mechelsesteenweg 365,2019-11-17,04:00:00,0,0,0,FMN GV 05 Lier
60,Mechelsesteenweg 365,2019-11-17,05:00:00,0,0,0,FMN GV 05 Lier
60,Mechelsesteenweg 365,2019-11-17,06:00:00,0,0,0,FMN GV 05 Lier
60,Mechelsesteenweg 365,2019-11-17,07:00:00,0,0,0,FMN GV 05 Lier
60,Mechelsesteenweg 365,2019-11-17,08:00:00,16,10,6,FMN GV 05 Lier
60,Mechelsesteenweg 365,2019-11-17,09:00:00,50,40,10,FMN GV 05 Lier
60,Mechelsesteenweg 365,2019-11-17,10:00:00,214,120,94,FMN GV 05 Lier
60,Mechelsesteenweg 365,2019-11-17,11:00:00,218,114,104,FMN GV 05 Lier
60,Mechelsesteenweg 365,2019-11-17,12:00:00,190,76,114,FMN GV 05 Lier
60,Mechelsesteenweg 365,2019-11-17,13:00:00,186,86,100,FMN GV 05 Lier
60,Mechelsesteenweg 365,2019-11-17,14:00:00,184,100,84,FMN GV 05 Lier
60,Mechelsesteenweg 365,2019-11-17,15:00:00,114,48,66,FMN GV 05 Lier
60,Mechelsesteenweg 365,2019-11-17,16:00:00,58,30,28,FMN GV 05 Lier
60,Mechelsesteenweg 365,2019-11-17,17:00:00,30,18,12,FMN GV 05 Lier
60,Mechelsesteenweg 365,2019-11-17,18:00:00,6,4,2,FMN GV 05 Lier
60,Mechelsesteenweg 365,2019-11-17,19:00:00,2,0,2,FMN GV 05 Lier
60,Mechelsesteenweg 365,2019-11-17,20:00:00,8,4,4,FMN GV 05 Lier
60,Mechelsesteenweg 365,2019-11-17,21:00:00,0,0,0,FMN GV 05 Lier
60,Mechelsesteenweg 365,2019-11-17,22:00:00,0,0,0,FMN GV 05 Lier
60,Mechelsesteenweg 365,2019-11-17,23:00:00,4,0,4,FMN GV 05 Lier
60,Mechelsesteenweg 365,2019-11-18,00:00:00,0,0,0,FMN GV 05 Lier
60,Mechelsesteenweg 365,2019-11-18,01:00:00,0,0,0,FMN GV 05 Lier
60,Mechelsesteenweg 365,2019-11-18,02:00:00,2,0,2,FMN GV 05 Lier
60,Mechelsesteenweg 365,2019-11-18,03:00:00,0,0,0,FMN GV 05 Lier
60,Mechelsesteenweg 365,2019-11-18,04:00:00,0,0,0,FMN GV 05 Lier
60,Mechelsesteenweg 365,2019-11-18,05:00:00,6,0,6,FMN GV 05 Lier
60,Mechelsesteenweg 365,2019-11-18,06:00:00,12,0,12,FMN GV 05 Lier
60,Mechelsesteenweg 365,2019-11-18,07:00:00,128,84,44,FMN GV 05 Lier
60,Mechelsesteenweg 365,2019-11-18,08:00:00,134,90,44,FMN GV 05 Lier
60,Mechelsesteenweg 365,2019-11-18,09:00:00,28,14,14,FMN GV 05 Lier
60,Mechelsesteenweg 365,2019-11-18,10:00:00,24,10,14,FMN GV 05 Lier
60,Mechelsesteenweg 365,2019-11-18,11:00:00,12,2,10,FMN GV 05 Lier
60,Mechelsesteenweg 365,2019-11-18,12:00:00,20,12,8,FMN GV 05 Lier
60,Mechelsesteenweg 365,2019-11-18,13:00:00,10,4,6,FMN GV 05 Lier
60,Mechelsesteenweg 365,2019-11-18,14:00:00,38,22,16,FMN GV 05 Lier
60,Mechelsesteenweg 365,2019-11-18,15:00:00,46,20,26,FMN GV 05 Lier
60,Mechelsesteenweg 365,2019-11-18,16:00:00,154,40,114,FMN GV 05 Lier
60,Mechelsesteenweg 365,2019-11-18,17:00:00,52,42,10,FMN GV 05 Lier
60,Mechelsesteenweg 365,2019-11-18,18:00:00,24,16,8,FMN GV 05 Lier
60,Mechelsesteenweg 365,2019-11-18,19:00:00,4,4,0,FMN GV 05 Lier
60,Mechelsesteenweg 365,2019-11-18,20:00:00,8,8,0,FMN GV 05 Lier
60,Mechelsesteenweg 365,2019-11-18,21:00:00,0,0,0,FMN GV 05 Lier
60,Mechelsesteenweg 365,2019-11-18,22:00:00,0,0,0,FMN GV 05 Lier
60,Mechelsesteenweg 365,2019-11-18,23:00:00,0,0,0,FMN GV 05 Lier
60,Mechelsesteenweg 365,2019-11-19,00:00:00,0,0,0,FMN GV 05 Lier
60,Mechelsesteenweg 365,2019-11-19,01:00:00,0,0,0,FMN GV 05 Lier
60,Mechelsesteenweg 365,2019-11-19,02:00:00,0,0,0,FMN GV 05 Lier
60,Mechelsesteenweg 365,2019-11-19,03:00:00,2,0,2,FMN GV 05 Lier
60,Mechelsesteenweg 365,2019-11-19,04:00:00,2,0,2,FMN GV 05 Lier
60,Mechelsesteenweg 365,2019-11-19,05:00:00,10,0,10,FMN GV 05 Lier
60,Mechelsesteenweg 365,2019-11-19,06:00:00,16,2,14,FMN GV 05 Lier
60,Mechelsesteenweg 365,2019-11-19,07:00:00,170,102,68,FMN GV 05 Lier
60,Mechelsesteenweg 365,2019-11-19,08:00:00,104,74,30,FMN GV 05 Lier
60,Mechelsesteenweg 365,2019-11-19,09:00:00,46,22,24,FMN GV 05 Lier
60,Mechelsesteenweg 365,2019-11-19,10:00:00,54,10,44,FMN GV 05 Lier
60,Mechelsesteenweg 365,2019-11-19,11:00:00,68,28,40,FMN GV 05 Lier
60,Mechelsesteenweg 365,2019-11-19,12:00:00,56,36,20,FMN GV 05 Lier
60,Mechelsesteenweg 365,2019-11-19,13:00:00,112,60,52,FMN GV 05 Lier
60,Mechelsesteenweg 365,2019-11-19,14:00:00,132,76,56,FMN GV 05 Lier
60,Mechelsesteenweg 365,2019-11-19,15:00:00,142,84,58,FMN GV 05 Lier
60,Mechelsesteenweg 365,2019-11-19,16:00:00,222,74,148,FMN GV 05 Lier
60,Mechelsesteenweg 365,2019-11-19,17:00:00,84,44,40,FMN GV 05 Lier
60,Mechelsesteenweg 365,2019-11-19,18:00:00,24,14,10,FMN GV 05 Lier
60,Mechelsesteenweg 365,2019-11-19,19:00:00,38,16,22,FMN GV 05 Lier
60,Mechelsesteenweg 365,2019-11-19,20:00:00,10,6,4,FMN GV 05 Lier
60,Mechelsesteenweg 365,2019-11-19,21:00:00,6,2,4,FMN GV 05 Lier
60,Mechelsesteenweg 365,2019-11-19,22:00:00,4,2,2,FMN GV 05 Lier
60,Mechelsesteenweg 365,2019-11-19,23:00:00,2,2,0,FMN GV 05 Lier
60,Mechelsesteenweg 365,2019-11-20,00:00:00,0,0,0,FMN GV 05 Lier
60,Mechelsesteenweg 365,2019-11-20,01:00:00,0,0,0,FMN GV 05 Lier
60,Mechelsesteenweg 365,2019-11-20,02:00:00,0,0,0,FMN GV 05 Lier
60,Mechelsesteenweg 365,2019-11-20,03:00:00,0,0,0,FMN GV 05 Lier
60,Mechelsesteenweg 365,2019-11-20,04:00:00,4,0,4,FMN GV 05 Lier
60,Mechelsesteenweg 365,2019-11-20,05:00:00,8,2,6,FMN GV 05 Lier
60,Mechelsesteenweg 365,2019-11-20,06:00:00,18,2,16,FMN GV 05 Lier
60,Mechelsesteenweg 365,2019-11-20,07:00:00,136,72,64,FMN GV 05 Lier
60,Mechelsesteenweg 365,2019-11-20,08:00:00,118,80,38,FMN GV 05 Lier
60,Mechelsesteenweg 365,2019-11-20,09:00:00,26,20,6,FMN GV 05 Lier
60,Mechelsesteenweg 365,2019-11-20,10:00:00,54,20,34,FMN GV 05 Lier
60,Mechelsesteenweg 365,2019-11-20,11:00:00,56,26,30,FMN GV 05 Lier
60,Mechelsesteenweg 365,2019-11-20,12:00:00,150,34,116,FMN GV 05 Lier
60,Mechelsesteenweg 365,2019-11-20,13:00:00,130,68,62,FMN GV 05 Lier
60,Mechelsesteenweg 365,2019-11-20,14:00:00,128,70,58,FMN GV 05 Lier
60,Mechelsesteenweg 365,2019-11-20,15:00:00,130,62,68,FMN GV 05 Lier
60,Mechelsesteenweg 365,2019-11-20,16:00:00,106,54,52,FMN GV 05 Lier
60,Mechelsesteenweg 365,2019-11-20,17:00:00,82,54,28,FMN GV 05 Lier
60,Mechelsesteenweg 365,2019-11-20,18:00:00,30,26,4,FMN GV 05 Lier
60,Mechelsesteenweg 365,2019-11-20,19:00:00,12,6,6,FMN GV 05 Lier
60,Mechelsesteenweg 365,2019-11-20,20:00:00,16,8,8,FMN GV 05 Lier
60,Mechelsesteenweg 365,2019-11-20,21:00:00,0,0,0,FMN GV 05 Lier
60,Mechelsesteenweg 365,2019-11-20,22:00:00,0,0,0,FMN GV 05 Lier
60,Mechelsesteenweg 365,2019-11-20,23:00:00,2,2,0,FMN GV 05 Lier
60,Mechelsesteenweg 365,2019-11-21,00:00:00,0,0,0,FMN GV 05 Lier
60,Mechelsesteenweg 365,2019-11-21,01:00:00,0,0,0,FMN GV 05 Lier
60,Mechelsesteenweg 365,2019-11-21,02:00:00,0,0,0,FMN GV 05 Lier
60,Mechelsesteenweg 365,2019-11-21,03:00:00,0,0,0,FMN GV 05 Lier
60,Mechelsesteenweg 365,2019-11-21,04:00:00,4,0,4,FMN GV 05 Lier
60,Mechelsesteenweg 365,2019-11-21,05:00:00,8,0,8,FMN GV 05 Lier
60,Mechelsesteenweg 365,2019-11-21,06:00:00,10,0,10,FMN GV 05 Lier
60,Mechelsesteenweg 365,2019-11-21,07:00:00,132,80,52,FMN GV 05 Lier
60,Mechelsesteenweg 365,2019-11-21,08:00:00,120,82,38,FMN GV 05 Lier
60,Mechelsesteenweg 365,2019-11-21,09:00:00,34,24,10,FMN GV 05 Lier
60,Mechelsesteenweg 365,2019-11-21,10:00:00,26,16,10,FMN GV 05 Lier
60,Mechelsesteenweg 365,2019-11-21,11:00:00,40,22,18,FMN GV 05 Lier
60,Mechelsesteenweg 365,2019-11-21,12:00:00,40,24,16,FMN GV 05 Lier
60,Mechelsesteenweg 365,2019-11-21,13:00:00,48,32,16,FMN GV 05 Lier
60,Mechelsesteenweg 365,2019-11-21,14:00:00,86,34,52,FMN GV 05 Lier
60,Mechelsesteenweg 365,2019-11-21,15:00:00,88,40,48,FMN GV 05 Lier
60,Mechelsesteenweg 365,2019-11-21,16:00:00,160,40,120,FMN GV 05 Lier
60,Mechelsesteenweg 365,2019-11-21,17:00:00,102,50,52,FMN GV 05 Lier
60,Mechelsesteenweg 365,2019-11-21,18:00:00,32,22,10,FMN GV 05 Lier
60,Mechelsesteenweg 365,2019-11-21,19:00:00,20,12,8,FMN GV 05 Lier
60,Mechelsesteenweg 365,2019-11-21,20:00:00,12,8,4,FMN GV 05 Lier
60,Mechelsesteenweg 365,2019-11-21,21:00:00,2,2,0,FMN GV 05 Lier
60,Mechelsesteenweg 365,2019-11-21,22:00:00,4,2,2,FMN GV 05 Lier
60,Mechelsesteenweg 365,2019-11-21,23:00:00,0,0,0,FMN GV 05 Lier
60,Mechelsesteenweg 365,2019-11-22,00:00:00,0,0,0,FMN GV 05 Lier
60,Mechelsesteenweg 365,2019-11-22,01:00:00,0,0,0,FMN GV 05 Lier
60,Mechelsesteenweg 365,2019-11-22,02:00:00,0,0,0,FMN GV 05 Lier
60,Mechelsesteenweg 365,2019-11-22,03:00:00,0,0,0,FMN GV 05 Lier
60,Mechelsesteenweg 365,2019-11-22,04:00:00,4,0,4,FMN GV 05 Lier
60,Mechelsesteenweg 365,2019-11-22,05:00:00,4,0,4,FMN GV 05 Lier
60,Mechelsesteenweg 365,2019-11-22,06:00:00,24,6,18,FMN GV 05 Lier
60,Mechelsesteenweg 365,2019-11-22,07:00:00,138,94,44,FMN GV 05 Lier
60,Mechelsesteenweg 365,2019-11-22,08:00:00,162,98,64,FMN GV 05 Lier
60,Mechelsesteenweg 365,2019-11-22,09:00:00,46,20,26,FMN GV 05 Lier
60,Mechelsesteenweg 365,2019-11-22,10:00:00,68,42,26,FMN GV 05 Lier
60,Mechelsesteenweg 365,2019-11-22,11:00:00,54,26,28,FMN GV 05 Lier
60,Mechelsesteenweg 365,2019-11-22,12:00:00,50,26,24,FMN GV 05 Lier
60,Mechelsesteenweg 365,2019-11-22,13:00:00,114,58,56,FMN GV 05 Lier
60,Mechelsesteenweg 365,2019-11-22,14:00:00,94,46,48,FMN GV 05 Lier
60,Mechelsesteenweg 365,2019-11-22,15:00:00,138,52,86,FMN GV 05 Lier
60,Mechelsesteenweg 365,2019-11-22,16:00:00,212,66,146,FMN GV 05 Lier
60,Mechelsesteenweg 365,2019-11-22,17:00:00,62,44,18,FMN GV 05 Lier
60,Mechelsesteenweg 365,2019-11-22,18:00:00,32,20,12,FMN GV 05 Lier
60,Mechelsesteenweg 365,2019-11-22,19:00:00,4,2,2,FMN GV 05 Lier
60,Mechelsesteenweg 365,2019-11-22,20:00:00,8,2,6,FMN GV 05 Lier
60,Mechelsesteenweg 365,2019-11-22,21:00:00,4,2,2,FMN GV 05 Lier
60,Mechelsesteenweg 365,2019-11-22,22:00:00,2,2,0,FMN GV 05 Lier
60,Mechelsesteenweg 365,2019-11-22,23:00:00,6,0,6,FMN GV 05 Lier
60,Mechelsesteenweg 365,2019-11-23,00:00:00,2,2,0,FMN GV 05 Lier
60,Mechelsesteenweg 365,2019-11-23,01:00:00,2,2,0,FMN GV 05 Lier
60,Mechelsesteenweg 365,2019-11-23,02:00:00,2,2,0,FMN GV 05 Lier
60,Mechelsesteenweg 365,2019-11-23,03:00:00,0,0,0,FMN GV 05 Lier
60,Mechelsesteenweg 365,2019-11-23,04:00:00,0,0,0,FMN GV 05 Lier
60,Mechelsesteenweg 365,2019-11-23,05:00:00,2,0,2,FMN GV 05 Lier
60,Mechelsesteenweg 365,2019-11-23,06:00:00,2,0,2,FMN GV 05 Lier
60,Mechelsesteenweg 365,2019-11-23,07:00:00,6,2,4,FMN GV 05 Lier
60,Mechelsesteenweg 365,2019-11-23,08:00:00,10,8,2,FMN GV 05 Lier
60,Mechelsesteenweg 365,2019-11-23,09:00:00,54,36,18,FMN GV 05 Lier
60,Mechelsesteenweg 365,2019-11-23,10:00:00,40,26,14,FMN GV 05 Lier
60,Mechelsesteenweg 365,2019-11-23,11:00:00,78,42,36,FMN GV 05 Lier
60,Mechelsesteenweg 365,2019-11-23,12:00:00,80,48,32,FMN GV 05 Lier
60,Mechelsesteenweg 365,2019-11-23,13:00:00,66,24,42,FMN GV 05 Lier
60,Mechelsesteenweg 365,2019-11-23,14:00:00,76,54,22,FMN GV 05 Lier
60,Mechelsesteenweg 365,2019-11-23,15:00:00,70,28,42,FMN GV 05 Lier
60,Mechelsesteenweg 365,2019-11-23,16:00:00,46,12,34,FMN GV 05 Lier
60,Mechelsesteenweg 365,2019-11-23,17:00:00,22,8,14,FMN GV 05 Lier
60,Mechelsesteenweg 365,2019-11-23,18:00:00,8,6,2,FMN GV 05 Lier
60,Mechelsesteenweg 365,2019-11-23,19:00:00,8,4,4,FMN GV 05 Lier
60,Mechelsesteenweg 365,2019-11-23,20:00:00,4,0,4,FMN GV 05 Lier
60,Mechelsesteenweg 365,2019-11-23,21:00:00,4,0,4,FMN GV 05 Lier
60,Mechelsesteenweg 365,2019-11-23,22:00:00,2,0,2,FMN GV 05 Lier
60,Mechelsesteenweg 365,2019-11-23,23:00:00,0,0,0,FMN GV 05 Lier
60,Mechelsesteenweg 365,2019-11-24,00:00:00,2,0,2,FMN GV 05 Lier
60,Mechelsesteenweg 365,2019-11-24,01:00:00,2,2,0,FMN GV 05 Lier
60,Mechelsesteenweg 365,2019-11-24,02:00:00,0,0,0,FMN GV 05 Lier
60,Mechelsesteenweg 365,2019-11-24,03:00:00,4,4,0,FMN GV 05 Lier
60,Mechelsesteenweg 365,2019-11-24,04:00:00,0,0,0,FMN GV 05 Lier
60,Mechelsesteenweg 365,2019-11-24,05:00:00,0,0,0,FMN GV 05 Lier
60,Mechelsesteenweg 365,2019-11-24,06:00:00,2,0,2,FMN GV 05 Lier
60,Mechelsesteenweg 365,2019-11-24,07:00:00,2,0,2,FMN GV 05 Lier
60,Mechelsesteenweg 365,2019-11-24,08:00:00,40,24,16,FMN GV 05 Lier
60,Mechelsesteenweg 365,2019-11-24,09:00:00,86,48,38,FMN GV 05 Lier
60,Mechelsesteenweg 365,2019-11-24,10:00:00,184,108,76,FMN GV 05 Lier
60,Mechelsesteenweg 365,2019-11-24,11:00:00,336,152,184,FMN GV 05 Lier
60,Mechelsesteenweg 365,2019-11-24,12:00:00,210,122,88,FMN GV 05 Lier
60,Mechelsesteenweg 365,2019-11-24,13:00:00,138,68,70,FMN GV 05 Lier
60,Mechelsesteenweg 365,2019-11-24,14:00:00,224,116,108,FMN GV 05 Lier
60,Mechelsesteenweg 365,2019-11-24,15:00:00,136,48,88,FMN GV 05 Lier
60,Mechelsesteenweg 365,2019-11-24,16:00:00,108,50,58,FMN GV 05 Lier
60,Mechelsesteenweg 365,2019-11-24,17:00:00,22,8,14,FMN GV 05 Lier
60,Mechelsesteenweg 365,2019-11-24,18:00:00,14,8,6,FMN GV 05 Lier
60,Mechelsesteenweg 365,2019-11-24,19:00:00,2,2,0,FMN GV 05 Lier
60,Mechelsesteenweg 365,2019-11-24,20:00:00,4,2,2,FMN GV 05 Lier
60,Mechelsesteenweg 365,2019-11-24,21:00:00,4,2,2,FMN GV 05 Lier
60,Mechelsesteenweg 365,2019-11-24,22:00:00,2,0,2,FMN GV 05 Lier
60,Mechelsesteenweg 365,2019-11-24,23:00:00,6,6,0,FMN GV 05 Lier
60,Mechelsesteenweg 365,2019-11-25,00:00:00,0,0,0,FMN GV 05 Lier
60,Mechelsesteenweg 365,2019-11-25,01:00:00,0,0,0,FMN GV 05 Lier
60,Mechelsesteenweg 365,2019-11-25,02:00:00,0,0,0,FMN GV 05 Lier
60,Mechelsesteenweg 365,2019-11-25,03:00:00,0,0,0,FMN GV 05 Lier
60,Mechelsesteenweg 365,2019-11-25,04:00:00,0,0,0,FMN GV 05 Lier
60,Mechelsesteenweg 365,2019-11-25,05:00:00,2,0,2,FMN GV 05 Lier
60,Mechelsesteenweg 365,2019-11-25,06:00:00,28,4,24,FMN GV 05 Lier
60,Mechelsesteenweg 365,2019-11-25,07:00:00,160,88,72,FMN GV 05 Lier
60,Mechelsesteenweg 365,2019-11-25,08:00:00,146,102,44,FMN GV 05 Lier
60,Mechelsesteenweg 365,2019-11-25,09:00:00,46,28,18,FMN GV 05 Lier
60,Mechelsesteenweg 365,2019-11-25,10:00:00,44,30,14,FMN GV 05 Lier
60,Mechelsesteenweg 365,2019-11-25,11:00:00,82,32,50,FMN GV 05 Lier
60,Mechelsesteenweg 365,2019-11-25,12:00:00,56,38,18,FMN GV 05 Lier
60,Mechelsesteenweg 365,2019-11-25,13:00:00,130,54,76,FMN GV 05 Lier
60,Mechelsesteenweg 365,2019-11-25,14:00:00,140,70,70,FMN GV 05 Lier
60,Mechelsesteenweg 365,2019-11-25,15:00:00,116,54,62,FMN GV 05 Lier
60,Mechelsesteenweg 365,2019-11-25,16:00:00,232,70,162,FMN GV 05 Lier
60,Mechelsesteenweg 365,2019-11-25,17:00:00,78,62,16,FMN GV 05 Lier
60,Mechelsesteenweg 365,2019-11-25,18:00:00,40,22,18,FMN GV 05 Lier
60,Mechelsesteenweg 365,2019-11-25,19:00:00,12,10,2,FMN GV 05 Lier
60,Mechelsesteenweg 365,2019-11-25,20:00:00,2,0,2,FMN GV 05 Lier
60,Mechelsesteenweg 365,2019-11-25,21:00:00,4,0,4,FMN GV 05 Lier
60,Mechelsesteenweg 365,2019-11-25,22:00:00,2,2,0,FMN GV 05 Lier
60,Mechelsesteenweg 365,2019-11-25,23:00:00,0,0,0,FMN GV 05 Lier
60,Mechelsesteenweg 365,2019-11-26,00:00:00,0,0,0,FMN GV 05 Lier
60,Mechelsesteenweg 365,2019-11-26,01:00:00,0,0,0,FMN GV 05 Lier
60,Mechelsesteenweg 365,2019-11-26,02:00:00,0,0,0,FMN GV 05 Lier
60,Mechelsesteenweg 365,2019-11-26,03:00:00,0,0,0,FMN GV 05 Lier
60,Mechelsesteenweg 365,2019-11-26,04:00:00,4,0,4,FMN GV 05 Lier
60,Mechelsesteenweg 365,2019-11-26,05:00:00,2,0,2,FMN GV 05 Lier
60,Mechelsesteenweg 365,2019-11-26,06:00:00,22,2,20,FMN GV 05 Lier
60,Mechelsesteenweg 365,2019-11-26,07:00:00,170,96,74,FMN GV 05 Lier
60,Mechelsesteenweg 365,2019-11-26,08:00:00,136,80,56,FMN GV 05 Lier
60,Mechelsesteenweg 365,2019-11-26,09:00:00,56,34,22,FMN GV 05 Lier
60,Mechelsesteenweg 365,2019-11-26,10:00:00,68,38,30,FMN GV 05 Lier
60,Mechelsesteenweg 365,2019-11-26,11:00:00,80,28,52,FMN GV 05 Lier
60,Mechelsesteenweg 365,2019-11-26,12:00:00,60,32,28,FMN GV 05 Lier
60,Mechelsesteenweg 365,2019-11-26,13:00:00,70,32,38,FMN GV 05 Lier
60,Mechelsesteenweg 365,2019-11-26,14:00:00,44,24,20,FMN GV 05 Lier
60,Mechelsesteenweg 365,2019-11-26,15:00:00,70,38,32,FMN GV 05 Lier
60,Mechelsesteenweg 365,2019-11-26,16:00:00,204,50,154,FMN GV 05 Lier
60,Mechelsesteenweg 365,2019-11-26,17:00:00,66,42,24,FMN GV 05 Lier
60,Mechelsesteenweg 365,2019-11-26,18:00:00,26,18,8,FMN GV 05 Lier
60,Mechelsesteenweg 365,2019-11-26,19:00:00,18,6,12,FMN GV 05 Lier
60,Mechelsesteenweg 365,2019-11-26,20:00:00,10,8,2,FMN GV 05 Lier
60,Mechelsesteenweg 365,2019-11-26,21:00:00,0,0,0,FMN GV 05 Lier
60,Mechelsesteenweg 365,2019-11-26,22:00:00,8,4,4,FMN GV 05 Lier
60,Mechelsesteenweg 365,2019-11-26,23:00:00,4,2,2,FMN GV 05 Lier
60,Mechelsesteenweg 365,2019-11-27,00:00:00,2,0,2,FMN GV 05 Lier
60,Mechelsesteenweg 365,2019-11-27,01:00:00,0,0,0,FMN GV 05 Lier
60,Mechelsesteenweg 365,2019-11-27,02:00:00,0,0,0,FMN GV 05 Lier
60,Mechelsesteenweg 365,2019-11-27,03:00:00,0,0,0,FMN GV 05 Lier
60,Mechelsesteenweg 365,2019-11-27,04:00:00,2,0,2,FMN GV 05 Lier
60,Mechelsesteenweg 365,2019-11-27,05:00:00,2,2,0,FMN GV 05 Lier
60,Mechelsesteenweg 365,2019-11-27,06:00:00,10,0,10,FMN GV 05 Lier
60,Mechelsesteenweg 365,2019-11-27,07:00:00,126,82,44,FMN GV 05 Lier
60,Mechelsesteenweg 365,2019-11-27,08:00:00,102,72,30,FMN GV 05 Lier
60,Mechelsesteenweg 365,2019-11-27,09:00:00,32,18,14,FMN GV 05 Lier
60,Mechelsesteenweg 365,2019-11-27,10:00:00,28,14,14,FMN GV 05 Lier
60,Mechelsesteenweg 365,2019-11-27,11:00:00,34,4,30,FMN GV 05 Lier
60,Mechelsesteenweg 365,2019-11-27,12:00:00,122,12,110,FMN GV 05 Lier
60,Mechelsesteenweg 365,2019-11-27,13:00:00,50,12,38,FMN GV 05 Lier
60,Mechelsesteenweg 365,2019-11-27,14:00:00,14,12,2,FMN GV 05 Lier
60,Mechelsesteenweg 365,2019-11-27,15:00:00,22,14,8,FMN GV 05 Lier
60,Mechelsesteenweg 365,2019-11-27,16:00:00,42,24,18,FMN GV 05 Lier
60,Mechelsesteenweg 365,2019-11-27,17:00:00,32,26,6,FMN GV 05 Lier
60,Mechelsesteenweg 365,2019-11-27,18:00:00,14,10,4,FMN GV 05 Lier
60,Mechelsesteenweg 365,2019-11-27,19:00:00,6,6,0,FMN GV 05 Lier
60,Mechelsesteenweg 365,2019-11-27,20:00:00,8,2,6,FMN GV 05 Lier
60,Mechelsesteenweg 365,2019-11-27,21:00:00,0,0,0,FMN GV 05 Lier
60,Mechelsesteenweg 365,2019-11-27,22:00:00,6,6,0,FMN GV 05 Lier
60,Mechelsesteenweg 365,2019-11-27,23:00:00,2,2,0,FMN GV 05 Lier
60,Mechelsesteenweg 365,2019-11-28,00:00:00,0,0,0,FMN GV 05 Lier
60,Mechelsesteenweg 365,2019-11-28,01:00:00,0,0,0,FMN GV 05 Lier
60,Mechelsesteenweg 365,2019-11-28,02:00:00,0,0,0,FMN GV 05 Lier
60,Mechelsesteenweg 365,2019-11-28,03:00:00,0,0,0,FMN GV 05 Lier
60,Mechelsesteenweg 365,2019-11-28,04:00:00,0,0,0,FMN GV 05 Lier
60,Mechelsesteenweg 365,2019-11-28,05:00:00,6,2,4,FMN GV 05 Lier
60,Mechelsesteenweg 365,2019-11-28,06:00:00,12,0,12,FMN GV 05 Lier
60,Mechelsesteenweg 365,2019-11-28,07:00:00,104,60,44,FMN GV 05 Lier
60,Mechelsesteenweg 365,2019-11-28,08:00:00,116,94,22,FMN GV 05 Lier
60,Mechelsesteenweg 365,2019-11-28,09:00:00,16,10,6,FMN GV 05 Lier
60,Mechelsesteenweg 365,2019-11-28,10:00:00,16,10,6,FMN GV 05 Lier
60,Mechelsesteenweg 365,2019-11-28,11:00:00,20,10,10,FMN GV 05 Lier
60,Mechelsesteenweg 365,2019-11-28,12:00:00,10,2,8,FMN GV 05 Lier
60,Mechelsesteenweg 365,2019-11-28,13:00:00,30,14,16,FMN GV 05 Lier
60,Mechelsesteenweg 365,2019-11-28,14:00:00,16,0,16,FMN GV 05 Lier
60,Mechelsesteenweg 365,2019-11-28,15:00:00,24,16,8,FMN GV 05 Lier
60,Mechelsesteenweg 365,2019-11-28,16:00:00,124,32,92,FMN GV 05 Lier
60,Mechelsesteenweg 365,2019-11-28,17:00:00,44,26,18,FMN GV 05 Lier
60,Mechelsesteenweg 365,2019-11-28,18:00:00,32,16,16,FMN GV 05 Lier
60,Mechelsesteenweg 365,2019-11-28,19:00:00,8,8,0,FMN GV 05 Lier
60,Mechelsesteenweg 365,2019-11-28,20:00:00,4,2,2,FMN GV 05 Lier
60,Mechelsesteenweg 365,2019-11-28,21:00:00,4,2,2,FMN GV 05 Lier
60,Mechelsesteenweg 365,2019-11-28,22:00:00,6,6,0,FMN GV 05 Lier
60,Mechelsesteenweg 365,2019-11-28,23:00:00,0,0,0,FMN GV 05 Lier
60,Mechelsesteenweg 365,2019-11-29,00:00:00,2,2,0,FMN GV 05 Lier
60,Mechelsesteenweg 365,2019-11-29,01:00:00,0,0,0,FMN GV 05 Lier
60,Mechelsesteenweg 365,2019-11-29,02:00:00,0,0,0,FMN GV 05 Lier
60,Mechelsesteenweg 365,2019-11-29,03:00:00,0,0,0,FMN GV 05 Lier
60,Mechelsesteenweg 365,2019-11-29,04:00:00,0,0,0,FMN GV 05 Lier
60,Mechelsesteenweg 365,2019-11-29,05:00:00,6,0,6,FMN GV 05 Lier
60,Mechelsesteenweg 365,2019-11-29,06:00:00,18,4,14,FMN GV 05 Lier
60,Mechelsesteenweg 365,2019-11-29,07:00:00,136,70,66,FMN GV 05 Lier
60,Mechelsesteenweg 365,2019-11-29,08:00:00,104,64,40,FMN GV 05 Lier
60,Mechelsesteenweg 365,2019-11-29,09:00:00,48,26,22,FMN GV 05 Lier
60,Mechelsesteenweg 365,2019-11-29,10:00:00,56,36,20,FMN GV 05 Lier
60,Mechelsesteenweg 365,2019-11-29,11:00:00,68,24,44,FMN GV 05 Lier
60,Mechelsesteenweg 365,2019-11-29,12:00:00,52,20,32,FMN GV 05 Lier
60,Mechelsesteenweg 365,2019-11-29,13:00:00,68,44,24,FMN GV 05 Lier
60,Mechelsesteenweg 365,2019-11-29,14:00:00,104,56,48,FMN GV 05 Lier
60,Mechelsesteenweg 365,2019-11-29,15:00:00,108,50,58,FMN GV 05 Lier
60,Mechelsesteenweg 365,2019-11-29,16:00:00,172,66,106,FMN GV 05 Lier
60,Mechelsesteenweg 365,2019-11-29,17:00:00,56,38,18,FMN GV 05 Lier
60,Mechelsesteenweg 365,2019-11-29,18:00:00,18,12,6,FMN GV 05 Lier
60,Mechelsesteenweg 365,2019-11-29,19:00:00,10,6,4,FMN GV 05 Lier
60,Mechelsesteenweg 365,2019-11-29,20:00:00,6,4,2,FMN GV 05 Lier
60,Mechelsesteenweg 365,2019-11-29,21:00:00,10,4,6,FMN GV 05 Lier
60,Mechelsesteenweg 365,2019-11-29,22:00:00,2,2,0,FMN GV 05 Lier
60,Mechelsesteenweg 365,2019-11-29,23:00:00,2,2,0,FMN GV 05 Lier
60,Mechelsesteenweg 365,2019-11-30,00:00:00,6,2,4,FMN GV 05 Lier
60,Mechelsesteenweg 365,2019-11-30,01:00:00,0,0,0,FMN GV 05 Lier
60,Mechelsesteenweg 365,2019-11-30,02:00:00,0,0,0,FMN GV 05 Lier
60,Mechelsesteenweg 365,2019-11-30,03:00:00,2,0,2,FMN GV 05 Lier
60,Mechelsesteenweg 365,2019-11-30,04:00:00,0,0,0,FMN GV 05 Lier
60,Mechelsesteenweg 365,2019-11-30,05:00:00,0,0,0,FMN GV 05 Lier
60,Mechelsesteenweg 365,2019-11-30,06:00:00,2,0,2,FMN GV 05 Lier
60,Mechelsesteenweg 365,2019-11-30,07:00:00,4,2,2,FMN GV 05 Lier
60,Mechelsesteenweg 365,2019-11-30,08:00:00,10,4,6,FMN GV 05 Lier
60,Mechelsesteenweg 365,2019-11-30,09:00:00,66,40,26,FMN GV 05 Lier
60,Mechelsesteenweg 365,2019-11-30,10:00:00,82,42,40,FMN GV 05 Lier
60,Mechelsesteenweg 365,2019-11-30,11:00:00,116,60,56,FMN GV 05 Lier
60,Mechelsesteenweg 365,2019-11-30,12:00:00,84,38,46,FMN GV 05 Lier
60,Mechelsesteenweg 365,2019-11-30,13:00:00,196,106,90,FMN GV 05 Lier
60,Mechelsesteenweg 365,2019-11-30,14:00:00,174,90,84,FMN GV 05 Lier
60,Mechelsesteenweg 365,2019-11-30,15:00:00,152,74,78,FMN GV 05 Lier
60,Mechelsesteenweg 365,2019-11-30,16:00:00,58,24,34,FMN GV 05 Lier
60,Mechelsesteenweg 365,2019-11-30,17:00:00,26,12,14,FMN GV 05 Lier
60,Mechelsesteenweg 365,2019-11-30,18:00:00,12,4,8,FMN GV 05 Lier
60,Mechelsesteenweg 365,2019-11-30,19:00:00,6,2,4,FMN GV 05 Lier
60,Mechelsesteenweg 365,2019-11-30,20:00:00,2,2,0,FMN GV 05 Lier
60,Mechelsesteenweg 365,2019-11-30,21:00:00,0,0,0,FMN GV 05 Lier
60,Mechelsesteenweg 365,2019-11-30,22:00:00,2,0,2,FMN GV 05 Lier
60,Mechelsesteenweg 365,2019-11-30,23:00:00,2,0,2,FMN GV 05 Lier
60,Mechelsesteenweg 365,2019-12-01,00:00:00,0,0,0,FMN GV 05 Lier
60,Mechelsesteenweg 365,2019-12-01,01:00:00,2,2,0,FMN GV 05 Lier
60,Mechelsesteenweg 365,2019-12-01,02:00:00,0,0,0,FMN GV 05 Lier
60,Mechelsesteenweg 365,2019-12-01,03:00:00,0,0,0,FMN GV 05 Lier
60,Mechelsesteenweg 365,2019-12-01,04:00:00,0,0,0,FMN GV 05 Lier
60,Mechelsesteenweg 365,2019-12-01,05:00:00,0,0,0,FMN GV 05 Lier
60,Mechelsesteenweg 365,2019-12-01,06:00:00,2,0,2,FMN GV 05 Lier
60,Mechelsesteenweg 365,2019-12-01,07:00:00,0,0,0,FMN GV 05 Lier
60,Mechelsesteenweg 365,2019-12-01,08:00:00,10,4,6,FMN GV 05 Lier
60,Mechelsesteenweg 365,2019-12-01,09:00:00,64,32,32,FMN GV 05 Lier
60,Mechelsesteenweg 365,2019-12-01,10:00:00,86,40,46,FMN GV 05 Lier
60,Mechelsesteenweg 365,2019-12-01,11:00:00,182,82,100,FMN GV 05 Lier
60,Mechelsesteenweg 365,2019-12-01,12:00:00,64,40,24,FMN GV 05 Lier
60,Mechelsesteenweg 365,2019-12-01,13:00:00,42,18,24,FMN GV 05 Lier
60,Mechelsesteenweg 365,2019-12-01,14:00:00,62,30,32,FMN GV 05 Lier
60,Mechelsesteenweg 365,2019-12-01,15:00:00,44,18,26,FMN GV 05 Lier
60,Mechelsesteenweg 365,2019-12-01,16:00:00,52,14,38,FMN GV 05 Lier
60,Mechelsesteenweg 365,2019-12-01,17:00:00,14,12,2,FMN GV 05 Lier
60,Mechelsesteenweg 365,2019-12-01,18:00:00,12,8,4,FMN GV 05 Lier
60,Mechelsesteenweg 365,2019-12-01,19:00:00,4,0,4,FMN GV 05 Lier
60,Mechelsesteenweg 365,2019-12-01,20:00:00,0,0,0,FMN GV 05 Lier
60,Mechelsesteenweg 365,2019-12-01,21:00:00,0,0,0,FMN GV 05 Lier
60,Mechelsesteenweg 365,2019-12-01,22:00:00,0,0,0,FMN GV 05 Lier
60,Mechelsesteenweg 365,2019-12-01,23:00:00,4,0,4,FMN GV 05 Lier
60,Mechelsesteenweg 365,2019-12-02,00:00:00,0,0,0,FMN GV 05 Lier
60,Mechelsesteenweg 365,2019-12-02,01:00:00,2,0,2,FMN GV 05 Lier
60,Mechelsesteenweg 365,2019-12-02,02:00:00,0,0,0,FMN GV 05 Lier
60,Mechelsesteenweg 365,2019-12-02,03:00:00,0,0,0,FMN GV 05 Lier
60,Mechelsesteenweg 365,2019-12-02,04:00:00,0,0,0,FMN GV 05 Lier
60,Mechelsesteenweg 365,2019-12-02,05:00:00,4,0,4,FMN GV 05 Lier
60,Mechelsesteenweg 365,2019-12-02,06:00:00,16,2,14,FMN GV 05 Lier
60,Mechelsesteenweg 365,2019-12-02,07:00:00,124,74,50,FMN GV 05 Lier
60,Mechelsesteenweg 365,2019-12-02,08:00:00,146,94,52,FMN GV 05 Lier
60,Mechelsesteenweg 365,2019-12-02,09:00:00,36,24,12,FMN GV 05 Lier
60,Mechelsesteenweg 365,2019-12-02,10:00:00,32,14,18,FMN GV 05 Lier
60,Mechelsesteenweg 365,2019-12-02,11:00:00,32,14,18,FMN GV 05 Lier
60,Mechelsesteenweg 365,2019-12-02,12:00:00,56,16,40,FMN GV 05 Lier
60,Mechelsesteenweg 365,2019-12-02,13:00:00,88,36,52,FMN GV 05 Lier
60,Mechelsesteenweg 365,2019-12-02,14:00:00,74,24,50,FMN GV 05 Lier
60,Mechelsesteenweg 365,2019-12-02,15:00:00,66,38,28,FMN GV 05 Lier
60,Mechelsesteenweg 365,2019-12-02,16:00:00,176,46,130,FMN GV 05 Lier
60,Mechelsesteenweg 365,2019-12-02,17:00:00,82,62,20,FMN GV 05 Lier
60,Mechelsesteenweg 365,2019-12-02,18:00:00,28,18,10,FMN GV 05 Lier
60,Mechelsesteenweg 365,2019-12-02,19:00:00,22,14,8,FMN GV 05 Lier
60,Mechelsesteenweg 365,2019-12-02,20:00:00,6,2,4,FMN GV 05 Lier
60,Mechelsesteenweg 365,2019-12-02,21:00:00,2,2,0,FMN GV 05 Lier
60,Mechelsesteenweg 365,2019-12-02,22:00:00,4,0,4,FMN GV 05 Lier
60,Mechelsesteenweg 365,2019-12-02,23:00:00,0,0,0,FMN GV 05 Lier
60,Mechelsesteenweg 365,2019-12-03,00:00:00,0,0,0,FMN GV 05 Lier
60,Mechelsesteenweg 365,2019-12-03,01:00:00,2,2,0,FMN GV 05 Lier
60,Mechelsesteenweg 365,2019-12-03,02:00:00,2,0,2,FMN GV 05 Lier
60,Mechelsesteenweg 365,2019-12-03,03:00:00,0,0,0,FMN GV 05 Lier
60,Mechelsesteenweg 365,2019-12-03,04:00:00,2,0,2,FMN GV 05 Lier
60,Mechelsesteenweg 365,2019-12-03,05:00:00,8,2,6,FMN GV 05 Lier
60,Mechelsesteenweg 365,2019-12-03,06:00:00,20,2,18,FMN GV 05 Lier
60,Mechelsesteenweg 365,2019-12-03,07:00:00,154,88,66,FMN GV 05 Lier
60,Mechelsesteenweg 365,2019-12-03,08:00:00,108,62,46,FMN GV 05 Lier
60,Mechelsesteenweg 365,2019-12-03,09:00:00,34,22,12,FMN GV 05 Lier
60,Mechelsesteenweg 365,2019-12-03,10:00:00,56,30,26,FMN GV 05 Lier
60,Mechelsesteenweg 365,2019-12-03,11:00:00,60,16,44,FMN GV 05 Lier
60,Mechelsesteenweg 365,2019-12-03,12:00:00,74,22,52,FMN GV 05 Lier
60,Mechelsesteenweg 365,2019-12-03,13:00:00,78,36,42,FMN GV 05 Lier
60,Mechelsesteenweg 365,2019-12-03,14:00:00,124,52,72,FMN GV 05 Lier
60,Mechelsesteenweg 365,2019-12-03,15:00:00,104,48,56,FMN GV 05 Lier
60,Mechelsesteenweg 365,2019-12-03,16:00:00,202,60,142,FMN GV 05 Lier
60,Mechelsesteenweg 365,2019-12-03,17:00:00,84,68,16,FMN GV 05 Lier
60,Mechelsesteenweg 365,2019-12-03,18:00:00,38,22,16,FMN GV 05 Lier
60,Mechelsesteenweg 365,2019-12-03,19:00:00,24,10,14,FMN GV 05 Lier
60,Mechelsesteenweg 365,2019-12-03,20:00:00,8,4,4,FMN GV 05 Lier
60,Mechelsesteenweg 365,2019-12-03,21:00:00,14,0,14,FMN GV 05 Lier
60,Mechelsesteenweg 365,2019-12-03,22:00:00,2,0,2,FMN GV 05 Lier
60,Mechelsesteenweg 365,2019-12-03,23:00:00,0,0,0,FMN GV 05 Lier
60,Mechelsesteenweg 365,2019-12-04,00:00:00,0,0,0,FMN GV 05 Lier
60,Mechelsesteenweg 365,2019-12-04,01:00:00,0,0,0,FMN GV 05 Lier
60,Mechelsesteenweg 365,2019-12-04,02:00:00,0,0,0,FMN GV 05 Lier
60,Mechelsesteenweg 365,2019-12-04,03:00:00,0,0,0,FMN GV 05 Lier
60,Mechelsesteenweg 365,2019-12-04,04:00:00,0,0,0,FMN GV 05 Lier
60,Mechelsesteenweg 365,2019-12-04,05:00:00,2,0,2,FMN GV 05 Lier
60,Mechelsesteenweg 365,2019-12-04,06:00:00,20,2,18,FMN GV 05 Lier
60,Mechelsesteenweg 365,2019-12-04,07:00:00,142,72,70,FMN GV 05 Lier
60,Mechelsesteenweg 365,2019-12-04,08:00:00,128,86,42,FMN GV 05 Lier
60,Mechelsesteenweg 365,2019-12-04,09:00:00,32,14,18,FMN GV 05 Lier
60,Mechelsesteenweg 365,2019-12-04,10:00:00,54,18,36,FMN GV 05 Lier
60,Mechelsesteenweg 365,2019-12-04,11:00:00,70,28,42,FMN GV 05 Lier
60,Mechelsesteenweg 365,2019-12-04,12:00:00,186,50,136,FMN GV 05 Lier
60,Mechelsesteenweg 365,2019-12-04,13:00:00,144,60,84,FMN GV 05 Lier
60,Mechelsesteenweg 365,2019-12-04,14:00:00,120,52,68,FMN GV 05 Lier
60,Mechelsesteenweg 365,2019-12-04,15:00:00,112,64,48,FMN GV 05 Lier
60,Mechelsesteenweg 365,2019-12-04,16:00:00,88,52,36,FMN GV 05 Lier
60,Mechelsesteenweg 365,2019-12-04,17:00:00,86,64,22,FMN GV 05 Lier
60,Mechelsesteenweg 365,2019-12-04,18:00:00,26,14,12,FMN GV 05 Lier
60,Mechelsesteenweg 365,2019-12-04,19:00:00,14,10,4,FMN GV 05 Lier
60,Mechelsesteenweg 365,2019-12-04,20:00:00,12,6,6,FMN GV 05 Lier
60,Mechelsesteenweg 365,2019-12-04,21:00:00,0,0,0,FMN GV 05 Lier
60,Mechelsesteenweg 365,2019-12-04,22:00:00,0,0,0,FMN GV 05 Lier
60,Mechelsesteenweg 365,2019-12-04,23:00:00,0,0,0,FMN GV 05 Lier
60,Mechelsesteenweg 365,2019-12-05,00:00:00,0,0,0,FMN GV 05 Lier
60,Mechelsesteenweg 365,2019-12-05,01:00:00,0,0,0,FMN GV 05 Lier
60,Mechelsesteenweg 365,2019-12-05,02:00:00,0,0,0,FMN GV 05 Lier
60,Mechelsesteenweg 365,2019-12-05,03:00:00,0,0,0,FMN GV 05 Lier
60,Mechelsesteenweg 365,2019-12-05,04:00:00,0,0,0,FMN GV 05 Lier
60,Mechelsesteenweg 365,2019-12-05,05:00:00,0,0,0,FMN GV 05 Lier
60,Mechelsesteenweg 365,2019-12-05,06:00:00,12,2,10,FMN GV 05 Lier
60,Mechelsesteenweg 365,2019-12-05,07:00:00,120,62,58,FMN GV 05 Lier
60,Mechelsesteenweg 365,2019-12-05,08:00:00,118,86,32,FMN GV 05 Lier
60,Mechelsesteenweg 365,2019-12-05,09:00:00,28,14,14,FMN GV 05 Lier
60,Mechelsesteenweg 365,2019-12-05,10:00:00,36,10,26,FMN GV 05 Lier
60,Mechelsesteenweg 365,2019-12-05,11:00:00,56,18,38,FMN GV 05 Lier
60,Mechelsesteenweg 365,2019-12-05,12:00:00,70,22,48,FMN GV 05 Lier
60,Mechelsesteenweg 365,2019-12-05,13:00:00,42,22,20,FMN GV 05 Lier
60,Mechelsesteenweg 365,2019-12-05,14:00:00,68,38,30,FMN GV 05 Lier
60,Mechelsesteenweg 365,2019-12-05,15:00:00,68,36,32,FMN GV 05 Lier
60,Mechelsesteenweg 365,2019-12-05,16:00:00,128,48,80,FMN GV 05 Lier
60,Mechelsesteenweg 365,2019-12-05,17:00:00,58,36,22,FMN GV 05 Lier
60,Mechelsesteenweg 365,2019-12-05,18:00:00,30,22,8,FMN GV 05 Lier
60,Mechelsesteenweg 365,2019-12-05,19:00:00,4,0,4,FMN GV 05 Lier
60,Mechelsesteenweg 365,2019-12-05,20:00:00,6,2,4,FMN GV 05 Lier
60,Mechelsesteenweg 365,2019-12-05,21:00:00,8,2,6,FMN GV 05 Lier
60,Mechelsesteenweg 365,2019-12-05,22:00:00,6,4,2,FMN GV 05 Lier
60,Mechelsesteenweg 365,2019-12-05,23:00:00,0,0,0,FMN GV 05 Lier
60,Mechelsesteenweg 365,2019-12-06,00:00:00,0,0,0,FMN GV 05 Lier
60,Mechelsesteenweg 365,2019-12-06,01:00:00,0,0,0,FMN GV 05 Lier
60,Mechelsesteenweg 365,2019-12-06,02:00:00,0,0,0,FMN GV 05 Lier
60,Mechelsesteenweg 365,2019-12-06,03:00:00,0,0,0,FMN GV 05 Lier
60,Mechelsesteenweg 365,2019-12-06,04:00:00,0,0,0,FMN GV 05 Lier
60,Mechelsesteenweg 365,2019-12-06,05:00:00,0,0,0,FMN GV 05 Lier
60,Mechelsesteenweg 365,2019-12-06,06:00:00,16,2,14,FMN GV 05 Lier
60,Mechelsesteenweg 365,2019-12-06,07:00:00,86,54,32,FMN GV 05 Lier
60,Mechelsesteenweg 365,2019-12-06,08:00:00,76,54,22,FMN GV 05 Lier
60,Mechelsesteenweg 365,2019-12-06,09:00:00,10,4,6,FMN GV 05 Lier
60,Mechelsesteenweg 365,2019-12-06,10:00:00,22,2,20,FMN GV 05 Lier
60,Mechelsesteenweg 365,2019-12-06,11:00:00,24,10,14,FMN GV 05 Lier
60,Mechelsesteenweg 365,2019-12-06,12:00:00,34,10,24,FMN GV 05 Lier
60,Mechelsesteenweg 365,2019-12-06,13:00:00,18,12,6,FMN GV 05 Lier
60,Mechelsesteenweg 365,2019-12-06,14:00:00,22,10,12,FMN GV 05 Lier
60,Mechelsesteenweg 365,2019-12-06,15:00:00,12,6,6,FMN GV 05 Lier
60,Mechelsesteenweg 365,2019-12-06,16:00:00,90,40,50,FMN GV 05 Lier
60,Mechelsesteenweg 365,2019-12-06,17:00:00,30,26,4,FMN GV 05 Lier
60,Mechelsesteenweg 365,2019-12-06,18:00:00,10,6,4,FMN GV 05 Lier
60,Mechelsesteenweg 365,2019-12-06,19:00:00,4,2,2,FMN GV 05 Lier
60,Mechelsesteenweg 365,2019-12-06,20:00:00,2,2,0,FMN GV 05 Lier
60,Mechelsesteenweg 365,2019-12-06,21:00:00,0,0,0,FMN GV 05 Lier
60,Mechelsesteenweg 365,2019-12-06,22:00:00,4,0,4,FMN GV 05 Lier
60,Mechelsesteenweg 365,2019-12-06,23:00:00,0,0,0,FMN GV 05 Lier
60,Mechelsesteenweg 365,2019-12-07,00:00:00,0,0,0,FMN GV 05 Lier
60,Mechelsesteenweg 365,2019-12-07,01:00:00,0,0,0,FMN GV 05 Lier
60,Mechelsesteenweg 365,2019-12-07,02:00:00,0,0,0,FMN GV 05 Lier
60,Mechelsesteenweg 365,2019-12-07,03:00:00,0,0,0,FMN GV 05 Lier
60,Mechelsesteenweg 365,2019-12-07,04:00:00,0,0,0,FMN GV 05 Lier
60,Mechelsesteenweg 365,2019-12-07,05:00:00,0,0,0,FMN GV 05 Lier
60,Mechelsesteenweg 365,2019-12-07,06:00:00,4,2,2,FMN GV 05 Lier
60,Mechelsesteenweg 365,2019-12-07,07:00:00,2,0,2,FMN GV 05 Lier
60,Mechelsesteenweg 365,2019-12-07,08:00:00,12,6,6,FMN GV 05 Lier
60,Mechelsesteenweg 365,2019-12-07,09:00:00,80,56,24,FMN GV 05 Lier
60,Mechelsesteenweg 365,2019-12-07,10:00:00,98,60,38,FMN GV 05 Lier
60,Mechelsesteenweg 365,2019-12-07,11:00:00,78,28,50,FMN GV 05 Lier
60,Mechelsesteenweg 365,2019-12-07,12:00:00,124,66,58,FMN GV 05 Lier
60,Mechelsesteenweg 365,2019-12-07,13:00:00,116,62,54,FMN GV 05 Lier
60,Mechelsesteenweg 365,2019-12-07,14:00:00,126,66,60,FMN GV 05 Lier
60,Mechelsesteenweg 365,2019-12-07,15:00:00,90,42,48,FMN GV 05 Lier
60,Mechelsesteenweg 365,2019-12-07,16:00:00,46,18,28,FMN GV 05 Lier
60,Mechelsesteenweg 365,2019-12-07,17:00:00,18,6,12,FMN GV 05 Lier
60,Mechelsesteenweg 365,2019-12-07,18:00:00,12,0,12,FMN GV 05 Lier
60,Mechelsesteenweg 365,2019-12-07,19:00:00,14,4,10,FMN GV 05 Lier
60,Mechelsesteenweg 365,2019-12-07,20:00:00,2,0,2,FMN GV 05 Lier
60,Mechelsesteenweg 365,2019-12-07,21:00:00,2,0,2,FMN GV 05 Lier
60,Mechelsesteenweg 365,2019-12-07,22:00:00,4,2,2,FMN GV 05 Lier
60,Mechelsesteenweg 365,2019-12-07,23:00:00,0,0,0,FMN GV 05 Lier
60,Mechelsesteenweg 365,2019-12-08,00:00:00,0,0,0,FMN GV 05 Lier
60,Mechelsesteenweg 365,2019-12-08,01:00:00,2,0,2,FMN GV 05 Lier
60,Mechelsesteenweg 365,2019-12-08,02:00:00,0,0,0,FMN GV 05 Lier
60,Mechelsesteenweg 365,2019-12-08,03:00:00,0,0,0,FMN GV 05 Lier
60,Mechelsesteenweg 365,2019-12-08,04:00:00,0,0,0,FMN GV 05 Lier
60,Mechelsesteenweg 365,2019-12-08,05:00:00,0,0,0,FMN GV 05 Lier
60,Mechelsesteenweg 365,2019-12-08,06:00:00,0,0,0,FMN GV 05 Lier
60,Mechelsesteenweg 365,2019-12-08,07:00:00,2,0,2,FMN GV 05 Lier
60,Mechelsesteenweg 365,2019-12-08,08:00:00,2,2,0,FMN GV 05 Lier
60,Mechelsesteenweg 365,2019-12-08,09:00:00,14,12,2,FMN GV 05 Lier
60,Mechelsesteenweg 365,2019-12-08,10:00:00,46,28,18,FMN GV 05 Lier
60,Mechelsesteenweg 365,2019-12-08,11:00:00,20,10,10,FMN GV 05 Lier
60,Mechelsesteenweg 365,2019-12-08,12:00:00,32,16,16,FMN GV 05 Lier
60,Mechelsesteenweg 365,2019-12-08,13:00:00,48,24,24,FMN GV 05 Lier
60,Mechelsesteenweg 365,2019-12-08,14:00:00,82,38,44,FMN GV 05 Lier
60,Mechelsesteenweg 365,2019-12-08,15:00:00,90,46,44,FMN GV 05 Lier
60,Mechelsesteenweg 365,2019-12-08,16:00:00,56,18,38,FMN GV 05 Lier
60,Mechelsesteenweg 365,2019-12-08,17:00:00,22,12,10,FMN GV 05 Lier
60,Mechelsesteenweg 365,2019-12-08,18:00:00,14,8,6,FMN GV 05 Lier
60,Mechelsesteenweg 365,2019-12-08,19:00:00,4,4,0,FMN GV 05 Lier
60,Mechelsesteenweg 365,2019-12-08,20:00:00,6,0,6,FMN GV 05 Lier
60,Mechelsesteenweg 365,2019-12-08,21:00:00,0,0,0,FMN GV 05 Lier
60,Mechelsesteenweg 365,2019-12-08,22:00:00,2,2,0,FMN GV 05 Lier
60,Mechelsesteenweg 365,2019-12-08,23:00:00,4,0,4,FMN GV 05 Lier
60,Mechelsesteenweg 365,2019-12-09,00:00:00,0,0,0,FMN GV 05 Lier
60,Mechelsesteenweg 365,2019-12-09,01:00:00,0,0,0,FMN GV 05 Lier
60,Mechelsesteenweg 365,2019-12-09,02:00:00,0,0,0,FMN GV 05 Lier
60,Mechelsesteenweg 365,2019-12-09,03:00:00,0,0,0,FMN GV 05 Lier
60,Mechelsesteenweg 365,2019-12-09,04:00:00,0,0,0,FMN GV 05 Lier
60,Mechelsesteenweg 365,2019-12-09,05:00:00,2,0,2,FMN GV 05 Lier
60,Mechelsesteenweg 365,2019-12-09,06:00:00,12,2,10,FMN GV 05 Lier
60,Mechelsesteenweg 365,2019-12-09,07:00:00,106,74,32,FMN GV 05 Lier
60,Mechelsesteenweg 365,2019-12-09,08:00:00,82,48,34,FMN GV 05 Lier
60,Mechelsesteenweg 365,2019-12-09,09:00:00,10,2,8,FMN GV 05 Lier
60,Mechelsesteenweg 365,2019-12-09,10:00:00,20,2,18,FMN GV 05 Lier
60,Mechelsesteenweg 365,2019-12-09,11:00:00,16,2,14,FMN GV 05 Lier
60,Mechelsesteenweg 365,2019-12-09,12:00:00,68,18,50,FMN GV 05 Lier
60,Mechelsesteenweg 365,2019-12-09,13:00:00,30,14,16,FMN GV 05 Lier
60,Mechelsesteenweg 365,2019-12-09,14:00:00,12,2,10,FMN GV 05 Lier
60,Mechelsesteenweg 365,2019-12-09,15:00:00,8,4,4,FMN GV 05 Lier
60,Mechelsesteenweg 365,2019-12-09,16:00:00,42,14,28,FMN GV 05 Lier
60,Mechelsesteenweg 365,2019-12-09,17:00:00,44,36,8,FMN GV 05 Lier
60,Mechelsesteenweg 365,2019-12-09,18:00:00,20,14,6,FMN GV 05 Lier
60,Mechelsesteenweg 365,2019-12-09,19:00:00,2,2,0,FMN GV 05 Lier
60,Mechelsesteenweg 365,2019-12-09,20:00:00,0,0,0,FMN GV 05 Lier
60,Mechelsesteenweg 365,2019-12-09,21:00:00,0,0,0,FMN GV 05 Lier
60,Mechelsesteenweg 365,2019-12-09,22:00:00,4,4,0,FMN GV 05 Lier
60,Mechelsesteenweg 365,2019-12-09,23:00:00,0,0,0,FMN GV 05 Lier
60,Mechelsesteenweg 365,2019-12-10,00:00:00,0,0,0,FMN GV 05 Lier
60,Mechelsesteenweg 365,2019-12-10,01:00:00,0,0,0,FMN GV 05 Lier
60,Mechelsesteenweg 365,2019-12-10,02:00:00,0,0,0,FMN GV 05 Lier
60,Mechelsesteenweg 365,2019-12-10,03:00:00,0,0,0,FMN GV 05 Lier
60,Mechelsesteenweg 365,2019-12-10,04:00:00,2,0,2,FMN GV 05 Lier
60,Mechelsesteenweg 365,2019-12-10,05:00:00,2,0,2,FMN GV 05 Lier
60,Mechelsesteenweg 365,2019-12-10,06:00:00,18,0,18,FMN GV 05 Lier
60,Mechelsesteenweg 365,2019-12-10,07:00:00,152,82,70,FMN GV 05 Lier
60,Mechelsesteenweg 365,2019-12-10,08:00:00,98,62,36,FMN GV 05 Lier
60,Mechelsesteenweg 365,2019-12-10,09:00:00,48,28,20,FMN GV 05 Lier
60,Mechelsesteenweg 365,2019-12-10,10:00:00,94,28,66,FMN GV 05 Lier
60,Mechelsesteenweg 365,2019-12-10,11:00:00,80,22,58,FMN GV 05 Lier
60,Mechelsesteenweg 365,2019-12-10,12:00:00,106,38,68,FMN GV 05 Lier
60,Mechelsesteenweg 365,2019-12-10,13:00:00,112,38,74,FMN GV 05 Lier
60,Mechelsesteenweg 365,2019-12-10,14:00:00,92,52,40,FMN GV 05 Lier
60,Mechelsesteenweg 365,2019-12-10,15:00:00,140,80,60,FMN GV 05 Lier
60,Mechelsesteenweg 365,2019-12-10,16:00:00,106,58,48,FMN GV 05 Lier
60,Mechelsesteenweg 365,2019-12-10,17:00:00,58,48,10,FMN GV 05 Lier
60,Mechelsesteenweg 365,2019-12-10,18:00:00,40,30,10,FMN GV 05 Lier
60,Mechelsesteenweg 365,2019-12-10,19:00:00,20,16,4,FMN GV 05 Lier
60,Mechelsesteenweg 365,2019-12-10,20:00:00,8,4,4,FMN GV 05 Lier
60,Mechelsesteenweg 365,2019-12-10,21:00:00,4,2,2,FMN GV 05 Lier
60,Mechelsesteenweg 365,2019-12-10,22:00:00,10,6,4,FMN GV 05 Lier
60,Mechelsesteenweg 365,2019-12-10,23:00:00,2,2,0,FMN GV 05 Lier
60,Mechelsesteenweg 365,2019-12-11,00:00:00,0,0,0,FMN GV 05 Lier
60,Mechelsesteenweg 365,2019-12-11,01:00:00,0,0,0,FMN GV 05 Lier
60,Mechelsesteenweg 365,2019-12-11,02:00:00,0,0,0,FMN GV 05 Lier
60,Mechelsesteenweg 365,2019-12-11,03:00:00,0,0,0,FMN GV 05 Lier
60,Mechelsesteenweg 365,2019-12-11,04:00:00,2,0,2,FMN GV 05 Lier
60,Mechelsesteenweg 365,2019-12-11,05:00:00,2,2,0,FMN GV 05 Lier
60,Mechelsesteenweg 365,2019-12-11,06:00:00,2,0,2,FMN GV 05 Lier
60,Mechelsesteenweg 365,2019-12-11,07:00:00,120,72,48,FMN GV 05 Lier
60,Mechelsesteenweg 365,2019-12-11,08:00:00,62,40,22,FMN GV 05 Lier
60,Mechelsesteenweg 365,2019-12-11,09:00:00,34,16,18,FMN GV 05 Lier
60,Mechelsesteenweg 365,2019-12-11,10:00:00,88,26,62,FMN GV 05 Lier
60,Mechelsesteenweg 365,2019-12-11,11:00:00,58,16,42,FMN GV 05 Lier
60,Mechelsesteenweg 365,2019-12-11,12:00:00,90,16,74,FMN GV 05 Lier
60,Mechelsesteenweg 365,2019-12-11,13:00:00,50,26,24,FMN GV 05 Lier
60,Mechelsesteenweg 365,2019-12-11,14:00:00,72,48,24,FMN GV 05 Lier
60,Mechelsesteenweg 365,2019-12-11,15:00:00,52,26,26,FMN GV 05 Lier
60,Mechelsesteenweg 365,2019-12-11,16:00:00,52,28,24,FMN GV 05 Lier
60,Mechelsesteenweg 365,2019-12-11,17:00:00,48,36,12,FMN GV 05 Lier
60,Mechelsesteenweg 365,2019-12-11,18:00:00,30,20,10,FMN GV 05 Lier
60,Mechelsesteenweg 365,2019-12-11,19:00:00,6,2,4,FMN GV 05 Lier
60,Mechelsesteenweg 365,2019-12-11,20:00:00,8,8,0,FMN GV 05 Lier
60,Mechelsesteenweg 365,2019-12-11,21:00:00,6,6,0,FMN GV 05 Lier
60,Mechelsesteenweg 365,2019-12-11,22:00:00,8,4,4,FMN GV 05 Lier
60,Mechelsesteenweg 365,2019-12-11,23:00:00,6,2,4,FMN GV 05 Lier
60,Mechelsesteenweg 365,2019-12-12,00:00:00,2,0,2,FMN GV 05 Lier
60,Mechelsesteenweg 365,2019-12-12,01:00:00,0,0,0,FMN GV 05 Lier
60,Mechelsesteenweg 365,2019-12-12,02:00:00,0,0,0,FMN GV 05 Lier
60,Mechelsesteenweg 365,2019-12-12,03:00:00,0,0,0,FMN GV 05 Lier
60,Mechelsesteenweg 365,2019-12-12,04:00:00,2,0,2,FMN GV 05 Lier
60,Mechelsesteenweg 365,2019-12-12,05:00:00,0,0,0,FMN GV 05 Lier
60,Mechelsesteenweg 365,2019-12-12,06:00:00,6,0,6,FMN GV 05 Lier
60,Mechelsesteenweg 365,2019-12-12,07:00:00,148,92,56,FMN GV 05 Lier
60,Mechelsesteenweg 365,2019-12-12,08:00:00,110,62,48,FMN GV 05 Lier
60,Mechelsesteenweg 365,2019-12-12,09:00:00,38,18,20,FMN GV 05 Lier
60,Mechelsesteenweg 365,2019-12-12,10:00:00,106,36,70,FMN GV 05 Lier
60,Mechelsesteenweg 365,2019-12-12,11:00:00,84,24,60,FMN GV 05 Lier
60,Mechelsesteenweg 365,2019-12-12,12:00:00,92,42,50,FMN GV 05 Lier
60,Mechelsesteenweg 365,2019-12-12,13:00:00,66,36,30,FMN GV 05 Lier
60,Mechelsesteenweg 365,2019-12-12,14:00:00,76,38,38,FMN GV 05 Lier
60,Mechelsesteenweg 365,2019-12-12,15:00:00,56,32,24,FMN GV 05 Lier
60,Mechelsesteenweg 365,2019-12-12,16:00:00,66,34,32,FMN GV 05 Lier
60,Mechelsesteenweg 365,2019-12-12,17:00:00,52,32,20,FMN GV 05 Lier
60,Mechelsesteenweg 365,2019-12-12,18:00:00,16,12,4,FMN GV 05 Lier
60,Mechelsesteenweg 365,2019-12-12,19:00:00,8,8,0,FMN GV 05 Lier
60,Mechelsesteenweg 365,2019-12-12,20:00:00,2,0,2,FMN GV 05 Lier
60,Mechelsesteenweg 365,2019-12-12,21:00:00,4,2,2,FMN GV 05 Lier
60,Mechelsesteenweg 365,2019-12-12,22:00:00,12,8,4,FMN GV 05 Lier
60,Mechelsesteenweg 365,2019-12-12,23:00:00,2,2,0,FMN GV 05 Lier
60,Mechelsesteenweg 365,2019-12-13,00:00:00,0,0,0,FMN GV 05 Lier
60,Mechelsesteenweg 365,2019-12-13,01:00:00,0,0,0,FMN GV 05 Lier
60,Mechelsesteenweg 365,2019-12-13,02:00:00,0,0,0,FMN GV 05 Lier
60,Mechelsesteenweg 365,2019-12-13,03:00:00,2,0,2,FMN GV 05 Lier
60,Mechelsesteenweg 365,2019-12-13,04:00:00,0,0,0,FMN GV 05 Lier
60,Mechelsesteenweg 365,2019-12-13,05:00:00,0,0,0,FMN GV 05 Lier
60,Mechelsesteenweg 365,2019-12-13,06:00:00,6,0,6,FMN GV 05 Lier
60,Mechelsesteenweg 365,2019-12-13,07:00:00,96,58,38,FMN GV 05 Lier
60,Mechelsesteenweg 365,2019-12-13,08:00:00,70,34,36,FMN GV 05 Lier
60,Mechelsesteenweg 365,2019-12-13,09:00:00,28,14,14,FMN GV 05 Lier
60,Mechelsesteenweg 365,2019-12-13,10:00:00,48,14,34,FMN GV 05 Lier
60,Mechelsesteenweg 365,2019-12-13,11:00:00,26,4,22,FMN GV 05 Lier
60,Mechelsesteenweg 365,2019-12-13,12:00:00,68,26,42,FMN GV 05 Lier
60,Mechelsesteenweg 365,2019-12-13,13:00:00,30,10,20,FMN GV 05 Lier
60,Mechelsesteenweg 365,2019-12-13,14:00:00,16,12,4,FMN GV 05 Lier
60,Mechelsesteenweg 365,2019-12-13,15:00:00,30,12,18,FMN GV 05 Lier
60,Mechelsesteenweg 365,2019-12-13,16:00:00,28,16,12,FMN GV 05 Lier
60,Mechelsesteenweg 365,2019-12-13,17:00:00,40,26,14,FMN GV 05 Lier
60,Mechelsesteenweg 365,2019-12-13,18:00:00,16,12,4,FMN GV 05 Lier
60,Mechelsesteenweg 365,2019-12-13,19:00:00,4,0,4,FMN GV 05 Lier
60,Mechelsesteenweg 365,2019-12-13,20:00:00,16,12,4,FMN GV 05 Lier
60,Mechelsesteenweg 365,2019-12-13,21:00:00,8,8,0,FMN GV 05 Lier
60,Mechelsesteenweg 365,2019-12-13,22:00:00,10,6,4,FMN GV 05 Lier
60,Mechelsesteenweg 365,2019-12-13,23:00:00,2,2,0,FMN GV 05 Lier
60,Mechelsesteenweg 365,2019-12-14,00:00:00,0,0,0,FMN GV 05 Lier
60,Mechelsesteenweg 365,2019-12-14,01:00:00,0,0,0,FMN GV 05 Lier
60,Mechelsesteenweg 365,2019-12-14,02:00:00,2,0,2,FMN GV 05 Lier
60,Mechelsesteenweg 365,2019-12-14,03:00:00,0,0,0,FMN GV 05 Lier
60,Mechelsesteenweg 365,2019-12-14,04:00:00,0,0,0,FMN GV 05 Lier
60,Mechelsesteenweg 365,2019-12-14,05:00:00,2,0,2,FMN GV 05 Lier
60,Mechelsesteenweg 365,2019-12-14,06:00:00,2,0,2,FMN GV 05 Lier
60,Mechelsesteenweg 365,2019-12-14,07:00:00,2,0,2,FMN GV 05 Lier
60,Mechelsesteenweg 365,2019-12-14,08:00:00,22,14,8,FMN GV 05 Lier
60,Mechelsesteenweg 365,2019-12-14,09:00:00,18,12,6,FMN GV 05 Lier
60,Mechelsesteenweg 365,2019-12-14,10:00:00,16,6,10,FMN GV 05 Lier
60,Mechelsesteenweg 365,2019-12-14,11:00:00,50,26,24,FMN GV 05 Lier
60,Mechelsesteenweg 365,2019-12-14,12:00:00,32,12,20,FMN GV 05 Lier
60,Mechelsesteenweg 365,2019-12-14,13:00:00,34,18,16,FMN GV 05 Lier
60,Mechelsesteenweg 365,2019-12-14,14:00:00,40,20,20,FMN GV 05 Lier
60,Mechelsesteenweg 365,2019-12-14,15:00:00,20,10,10,FMN GV 05 Lier
60,Mechelsesteenweg 365,2019-12-14,16:00:00,4,2,2,FMN GV 05 Lier
60,Mechelsesteenweg 365,2019-12-14,17:00:00,12,8,4,FMN GV 05 Lier
60,Mechelsesteenweg 365,2019-12-14,18:00:00,0,0,0,FMN GV 05 Lier
60,Mechelsesteenweg 365,2019-12-14,19:00:00,4,0,4,FMN GV 05 Lier
60,Mechelsesteenweg 365,2019-12-14,20:00:00,6,4,2,FMN GV 05 Lier
60,Mechelsesteenweg 365,2019-12-14,21:00:00,4,0,4,FMN GV 05 Lier
60,Mechelsesteenweg 365,2019-12-14,22:00:00,0,0,0,FMN GV 05 Lier
60,Mechelsesteenweg 365,2019-12-14,23:00:00,4,4,0,FMN GV 05 Lier
60,Mechelsesteenweg 365,2019-12-15,00:00:00,2,0,2,FMN GV 05 Lier
60,Mechelsesteenweg 365,2019-12-15,01:00:00,4,0,4,FMN GV 05 Lier
60,Mechelsesteenweg 365,2019-12-15,02:00:00,0,0,0,FMN GV 05 Lier
60,Mechelsesteenweg 365,2019-12-15,03:00:00,0,0,0,FMN GV 05 Lier
60,Mechelsesteenweg 365,2019-12-15,04:00:00,0,0,0,FMN GV 05 Lier
60,Mechelsesteenweg 365,2019-12-15,05:00:00,0,0,0,FMN GV 05 Lier
60,Mechelsesteenweg 365,2019-12-15,06:00:00,0,0,0,FMN GV 05 Lier
60,Mechelsesteenweg 365,2019-12-15,07:00:00,0,0,0,FMN GV 05 Lier
60,Mechelsesteenweg 365,2019-12-15,08:00:00,8,6,2,FMN GV 05 Lier
60,Mechelsesteenweg 365,2019-12-15,09:00:00,52,22,30,FMN GV 05 Lier
60,Mechelsesteenweg 365,2019-12-15,10:00:00,172,100,72,FMN GV 05 Lier
60,Mechelsesteenweg 365,2019-12-15,11:00:00,206,118,88,FMN GV 05 Lier
60,Mechelsesteenweg 365,2019-12-15,12:00:00,120,78,42,FMN GV 05 Lier
60,Mechelsesteenweg 365,2019-12-15,13:00:00,110,74,36,FMN GV 05 Lier
60,Mechelsesteenweg 365,2019-12-15,14:00:00,100,56,44,FMN GV 05 Lier
60,Mechelsesteenweg 365,2019-12-15,15:00:00,112,36,76,FMN GV 05 Lier
60,Mechelsesteenweg 365,2019-12-15,16:00:00,48,18,30,FMN GV 05 Lier
60,Mechelsesteenweg 365,2019-12-15,17:00:00,18,6,12,FMN GV 05 Lier
60,Mechelsesteenweg 365,2019-12-15,18:00:00,6,4,2,FMN GV 05 Lier
60,Mechelsesteenweg 365,2019-12-15,19:00:00,6,2,4,FMN GV 05 Lier
60,Mechelsesteenweg 365,2019-12-15,20:00:00,6,0,6,FMN GV 05 Lier
60,Mechelsesteenweg 365,2019-12-15,21:00:00,6,0,6,FMN GV 05 Lier
60,Mechelsesteenweg 365,2019-12-15,22:00:00,2,0,2,FMN GV 05 Lier
60,Mechelsesteenweg 365,2019-12-15,23:00:00,6,2,4,FMN GV 05 Lier
60,Mechelsesteenweg 365,2019-12-16,00:00:00,0,0,0,FMN GV 05 Lier
60,Mechelsesteenweg 365,2019-12-16,01:00:00,0,0,0,FMN GV 05 Lier
60,Mechelsesteenweg 365,2019-12-16,02:00:00,0,0,0,FMN GV 05 Lier
60,Mechelsesteenweg 365,2019-12-16,03:00:00,2,0,2,FMN GV 05 Lier
60,Mechelsesteenweg 365,2019-12-16,04:00:00,6,0,6,FMN GV 05 Lier
60,Mechelsesteenweg 365,2019-12-16,05:00:00,4,2,2,FMN GV 05 Lier
60,Mechelsesteenweg 365,2019-12-16,06:00:00,16,4,12,FMN GV 05 Lier
60,Mechelsesteenweg 365,2019-12-16,07:00:00,136,86,50,FMN GV 05 Lier
60,Mechelsesteenweg 365,2019-12-16,08:00:00,118,72,46,FMN GV 05 Lier
60,Mechelsesteenweg 365,2019-12-16,09:00:00,26,18,8,FMN GV 05 Lier
60,Mechelsesteenweg 365,2019-12-16,10:00:00,52,16,36,FMN GV 05 Lier
60,Mechelsesteenweg 365,2019-12-16,11:00:00,26,6,20,FMN GV 05 Lier
60,Mechelsesteenweg 365,2019-12-16,12:00:00,64,16,48,FMN GV 05 Lier
60,Mechelsesteenweg 365,2019-12-16,13:00:00,34,12,22,FMN GV 05 Lier
60,Mechelsesteenweg 365,2019-12-16,14:00:00,28,12,16,FMN GV 05 Lier
60,Mechelsesteenweg 365,2019-12-16,15:00:00,42,24,18,FMN GV 05 Lier
60,Mechelsesteenweg 365,2019-12-16,16:00:00,84,40,44,FMN GV 05 Lier
60,Mechelsesteenweg 365,2019-12-16,17:00:00,50,40,10,FMN GV 05 Lier
60,Mechelsesteenweg 365,2019-12-16,18:00:00,26,14,12,FMN GV 05 Lier
60,Mechelsesteenweg 365,2019-12-16,19:00:00,12,6,6,FMN GV 05 Lier
60,Mechelsesteenweg 365,2019-12-16,20:00:00,0,0,0,FMN GV 05 Lier
60,Mechelsesteenweg 365,2019-12-16,21:00:00,4,4,0,FMN GV 05 Lier
60,Mechelsesteenweg 365,2019-12-16,22:00:00,4,2,2,FMN GV 05 Lier
60,Mechelsesteenweg 365,2019-12-16,23:00:00,0,0,0,FMN GV 05 Lier
60,Mechelsesteenweg 365,2019-12-17,00:00:00,0,0,0,FMN GV 05 Lier
60,Mechelsesteenweg 365,2019-12-17,01:00:00,0,0,0,FMN GV 05 Lier
60,Mechelsesteenweg 365,2019-12-17,02:00:00,0,0,0,FMN GV 05 Lier
60,Mechelsesteenweg 365,2019-12-17,03:00:00,2,0,2,FMN GV 05 Lier
60,Mechelsesteenweg 365,2019-12-17,04:00:00,4,0,4,FMN GV 05 Lier
60,Mechelsesteenweg 365,2019-12-17,05:00:00,6,0,6,FMN GV 05 Lier
60,Mechelsesteenweg 365,2019-12-17,06:00:00,18,2,16,FMN GV 05 Lier
60,Mechelsesteenweg 365,2019-12-17,07:00:00,92,40,52,FMN GV 05 Lier
60,Mechelsesteenweg 365,2019-12-17,08:00:00,110,48,62,FMN GV 05 Lier
60,Mechelsesteenweg 365,2019-12-17,09:00:00,40,16,24,FMN GV 05 Lier
60,Mechelsesteenweg 365,2019-12-17,10:00:00,70,24,46,FMN GV 05 Lier
60,Mechelsesteenweg 365,2019-12-17,11:00:00,84,38,46,FMN GV 05 Lier
60,Mechelsesteenweg 365,2019-12-17,12:00:00,90,40,50,FMN GV 05 Lier
60,Mechelsesteenweg 365,2019-12-17,13:00:00,142,84,58,FMN GV 05 Lier
60,Mechelsesteenweg 365,2019-12-17,14:00:00,216,110,106,FMN GV 05 Lier
60,Mechelsesteenweg 365,2019-12-17,15:00:00,126,58,68,FMN GV 05 Lier
60,Mechelsesteenweg 365,2019-12-17,16:00:00,82,44,38,FMN GV 05 Lier
60,Mechelsesteenweg 365,2019-12-17,17:00:00,62,52,10,FMN GV 05 Lier
60,Mechelsesteenweg 365,2019-12-17,18:00:00,44,36,8,FMN GV 05 Lier
60,Mechelsesteenweg 365,2019-12-17,19:00:00,8,6,2,FMN GV 05 Lier
60,Mechelsesteenweg 365,2019-12-17,20:00:00,10,4,6,FMN GV 05 Lier
60,Mechelsesteenweg 365,2019-12-17,21:00:00,4,2,2,FMN GV 05 Lier
60,Mechelsesteenweg 365,2019-12-17,22:00:00,8,4,4,FMN GV 05 Lier
60,Mechelsesteenweg 365,2019-12-17,23:00:00,2,0,2,FMN GV 05 Lier
60,Mechelsesteenweg 365,2019-12-18,00:00:00,0,0,0,FMN GV 05 Lier
60,Mechelsesteenweg 365,2019-12-18,01:00:00,0,0,0,FMN GV 05 Lier
60,Mechelsesteenweg 365,2019-12-18,02:00:00,0,0,0,FMN GV 05 Lier
60,Mechelsesteenweg 365,2019-12-18,03:00:00,0,0,0,FMN GV 05 Lier
60,Mechelsesteenweg 365,2019-12-18,04:00:00,4,0,4,FMN GV 05 Lier
60,Mechelsesteenweg 365,2019-12-18,05:00:00,8,4,4,FMN GV 05 Lier
60,Mechelsesteenweg 365,2019-12-18,06:00:00,8,0,8,FMN GV 05 Lier
60,Mechelsesteenweg 365,2019-12-18,07:00:00,88,28,60,FMN GV 05 Lier
60,Mechelsesteenweg 365,2019-12-18,08:00:00,78,44,34,FMN GV 05 Lier
60,Mechelsesteenweg 365,2019-12-18,09:00:00,44,18,26,FMN GV 05 Lier
60,Mechelsesteenweg 365,2019-12-18,10:00:00,40,20,20,FMN GV 05 Lier
60,Mechelsesteenweg 365,2019-12-18,11:00:00,48,24,24,FMN GV 05 Lier
60,Mechelsesteenweg 365,2019-12-18,12:00:00,66,30,36,FMN GV 05 Lier
60,Mechelsesteenweg 365,2019-12-18,13:00:00,126,72,54,FMN GV 05 Lier
60,Mechelsesteenweg 365,2019-12-18,14:00:00,150,88,62,FMN GV 05 Lier
60,Mechelsesteenweg 365,2019-12-18,15:00:00,116,56,60,FMN GV 05 Lier
60,Mechelsesteenweg 365,2019-12-18,16:00:00,84,32,52,FMN GV 05 Lier
60,Mechelsesteenweg 365,2019-12-18,17:00:00,64,44,20,FMN GV 05 Lier
60,Mechelsesteenweg 365,2019-12-18,18:00:00,38,34,4,FMN GV 05 Lier
60,Mechelsesteenweg 365,2019-12-18,19:00:00,26,14,12,FMN GV 05 Lier
60,Mechelsesteenweg 365,2019-12-18,20:00:00,20,10,10,FMN GV 05 Lier
60,Mechelsesteenweg 365,2019-12-18,21:00:00,4,2,2,FMN GV 05 Lier
60,Mechelsesteenweg 365,2019-12-18,22:00:00,10,2,8,FMN GV 05 Lier
60,Mechelsesteenweg 365,2019-12-18,23:00:00,0,0,0,FMN GV 05 Lier
60,Mechelsesteenweg 365,2019-12-19,00:00:00,0,0,0,FMN GV 05 Lier
60,Mechelsesteenweg 365,2019-12-19,01:00:00,0,0,0,FMN GV 05 Lier
60,Mechelsesteenweg 365,2019-12-19,02:00:00,0,0,0,FMN GV 05 Lier
60,Mechelsesteenweg 365,2019-12-19,03:00:00,0,0,0,FMN GV 05 Lier
60,Mechelsesteenweg 365,2019-12-19,04:00:00,2,0,2,FMN GV 05 Lier
60,Mechelsesteenweg 365,2019-12-19,05:00:00,2,0,2,FMN GV 05 Lier
60,Mechelsesteenweg 365,2019-12-19,06:00:00,18,0,18,FMN GV 05 Lier
60,Mechelsesteenweg 365,2019-12-19,07:00:00,80,22,58,FMN GV 05 Lier
60,Mechelsesteenweg 365,2019-12-19,08:00:00,94,42,52,FMN GV 05 Lier
60,Mechelsesteenweg 365,2019-12-19,09:00:00,122,82,40,FMN GV 05 Lier
60,Mechelsesteenweg 365,2019-12-19,10:00:00,74,56,18,FMN GV 05 Lier
60,Mechelsesteenweg 365,2019-12-19,11:00:00,90,32,58,FMN GV 05 Lier
60,Mechelsesteenweg 365,2019-12-19,12:00:00,154,48,106,FMN GV 05 Lier
60,Mechelsesteenweg 365,2019-12-19,13:00:00,160,104,56,FMN GV 05 Lier
60,Mechelsesteenweg 365,2019-12-19,14:00:00,158,74,84,FMN GV 05 Lier
60,Mechelsesteenweg 365,2019-12-19,15:00:00,120,72,48,FMN GV 05 Lier
60,Mechelsesteenweg 365,2019-12-19,16:00:00,108,66,42,FMN GV 05 Lier
60,Mechelsesteenweg 365,2019-12-19,17:00:00,66,42,24,FMN GV 05 Lier
60,Mechelsesteenweg 365,2019-12-19,18:00:00,38,26,12,FMN GV 05 Lier
60,Mechelsesteenweg 365,2019-12-19,19:00:00,30,14,16,FMN GV 05 Lier
60,Mechelsesteenweg 365,2019-12-19,20:00:00,8,4,4,FMN GV 05 Lier
60,Mechelsesteenweg 365,2019-12-19,21:00:00,14,2,12,FMN GV 05 Lier
60,Mechelsesteenweg 365,2019-12-19,22:00:00,12,6,6,FMN GV 05 Lier
60,Mechelsesteenweg 365,2019-12-19,23:00:00,4,4,0,FMN GV 05 Lier
60,Mechelsesteenweg 365,2019-12-20,00:00:00,4,4,0,FMN GV 05 Lier
60,Mechelsesteenweg 365,2019-12-20,01:00:00,0,0,0,FMN GV 05 Lier
60,Mechelsesteenweg 365,2019-12-20,02:00:00,0,0,0,FMN GV 05 Lier
60,Mechelsesteenweg 365,2019-12-20,03:00:00,0,0,0,FMN GV 05 Lier
60,Mechelsesteenweg 365,2019-12-20,04:00:00,2,0,2,FMN GV 05 Lier
60,Mechelsesteenweg 365,2019-12-20,05:00:00,4,0,4,FMN GV 05 Lier
60,Mechelsesteenweg 365,2019-12-20,06:00:00,12,0,12,FMN GV 05 Lier
60,Mechelsesteenweg 365,2019-12-20,07:00:00,56,16,40,FMN GV 05 Lier
60,Mechelsesteenweg 365,2019-12-20,08:00:00,138,114,24,FMN GV 05 Lier
60,Mechelsesteenweg 365,2019-12-20,09:00:00,24,16,8,FMN GV 05 Lier
60,Mechelsesteenweg 365,2019-12-20,10:00:00,14,8,6,FMN GV 05 Lier
60,Mechelsesteenweg 365,2019-12-20,11:00:00,36,4,32,FMN GV 05 Lier
60,Mechelsesteenweg 365,2019-12-20,12:00:00,104,18,86,FMN GV 05 Lier
60,Mechelsesteenweg 365,2019-12-20,13:00:00,26,10,16,FMN GV 05 Lier
60,Mechelsesteenweg 365,2019-12-20,14:00:00,44,20,24,FMN GV 05 Lier
60,Mechelsesteenweg 365,2019-12-20,15:00:00,40,24,16,FMN GV 05 Lier
60,Mechelsesteenweg 365,2019-12-20,16:00:00,62,32,30,FMN GV 05 Lier
60,Mechelsesteenweg 365,2019-12-20,17:00:00,56,44,12,FMN GV 05 Lier
60,Mechelsesteenweg 365,2019-12-20,18:00:00,12,6,6,FMN GV 05 Lier
60,Mechelsesteenweg 365,2019-12-20,19:00:00,8,6,2,FMN GV 05 Lier
60,Mechelsesteenweg 365,2019-12-20,20:00:00,6,2,4,FMN GV 05 Lier
60,Mechelsesteenweg 365,2019-12-20,21:00:00,8,0,8,FMN GV 05 Lier
60,Mechelsesteenweg 365,2019-12-20,22:00:00,4,2,2,FMN GV 05 Lier
60,Mechelsesteenweg 365,2019-12-20,23:00:00,12,6,6,FMN GV 05 Lier
60,Mechelsesteenweg 365,2019-12-21,00:00:00,0,0,0,FMN GV 05 Lier
60,Mechelsesteenweg 365,2019-12-21,01:00:00,4,4,0,FMN GV 05 Lier
60,Mechelsesteenweg 365,2019-12-21,02:00:00,4,2,2,FMN GV 05 Lier
60,Mechelsesteenweg 365,2019-12-21,03:00:00,0,0,0,FMN GV 05 Lier
60,Mechelsesteenweg 365,2019-12-21,04:00:00,0,0,0,FMN GV 05 Lier
60,Mechelsesteenweg 365,2019-12-21,05:00:00,0,0,0,FMN GV 05 Lier
60,Mechelsesteenweg 365,2019-12-21,06:00:00,0,0,0,FMN GV 05 Lier
60,Mechelsesteenweg 365,2019-12-21,07:00:00,10,6,4,FMN GV 05 Lier
60,Mechelsesteenweg 365,2019-12-21,08:00:00,18,8,10,FMN GV 05 Lier
60,Mechelsesteenweg 365,2019-12-21,09:00:00,38,10,28,FMN GV 05 Lier
60,Mechelsesteenweg 365,2019-12-21,10:00:00,76,42,34,FMN GV 05 Lier
60,Mechelsesteenweg 365,2019-12-21,11:00:00,106,52,54,FMN GV 05 Lier
60,Mechelsesteenweg 365,2019-12-21,12:00:00,82,36,46,FMN GV 05 Lier
60,Mechelsesteenweg 365,2019-12-21,13:00:00,80,50,30,FMN GV 05 Lier
60,Mechelsesteenweg 365,2019-12-21,14:00:00,82,38,44,FMN GV 05 Lier
60,Mechelsesteenweg 365,2019-12-21,15:00:00,86,46,40,FMN GV 05 Lier
60,Mechelsesteenweg 365,2019-12-21,16:00:00,38,16,22,FMN GV 05 Lier
60,Mechelsesteenweg 365,2019-12-21,17:00:00,10,6,4,FMN GV 05 Lier
60,Mechelsesteenweg 365,2019-12-21,18:00:00,12,2,10,FMN GV 05 Lier
60,Mechelsesteenweg 365,2019-12-21,19:00:00,4,4,0,FMN GV 05 Lier
60,Mechelsesteenweg 365,2019-12-21,20:00:00,10,6,4,FMN GV 05 Lier
60,Mechelsesteenweg 365,2019-12-21,21:00:00,4,2,2,FMN GV 05 Lier
60,Mechelsesteenweg 365,2019-12-21,22:00:00,2,2,0,FMN GV 05 Lier
60,Mechelsesteenweg 365,2019-12-21,23:00:00,0,0,0,FMN GV 05 Lier
60,Mechelsesteenweg 365,2019-12-22,00:00:00,4,2,2,FMN GV 05 Lier
60,Mechelsesteenweg 365,2019-12-22,01:00:00,0,0,0,FMN GV 05 Lier
60,Mechelsesteenweg 365,2019-12-22,02:00:00,0,0,0,FMN GV 05 Lier
60,Mechelsesteenweg 365,2019-12-22,03:00:00,0,0,0,FMN GV 05 Lier
60,Mechelsesteenweg 365,2019-12-22,04:00:00,0,0,0,FMN GV 05 Lier
60,Mechelsesteenweg 365,2019-12-22,05:00:00,0,0,0,FMN GV 05 Lier
60,Mechelsesteenweg 365,2019-12-22,06:00:00,0,0,0,FMN GV 05 Lier
60,Mechelsesteenweg 365,2019-12-22,07:00:00,0,0,0,FMN GV 05 Lier
60,Mechelsesteenweg 365,2019-12-22,08:00:00,4,0,4,FMN GV 05 Lier
60,Mechelsesteenweg 365,2019-12-22,09:00:00,22,14,8,FMN GV 05 Lier
60,Mechelsesteenweg 365,2019-12-22,10:00:00,70,36,34,FMN GV 05 Lier
60,Mechelsesteenweg 365,2019-12-22,11:00:00,58,24,34,FMN GV 05 Lier
60,Mechelsesteenweg 365,2019-12-22,12:00:00,60,18,42,FMN GV 05 Lier
60,Mechelsesteenweg 365,2019-12-22,13:00:00,20,8,12,FMN GV 05 Lier
60,Mechelsesteenweg 365,2019-12-22,14:00:00,10,6,4,FMN GV 05 Lier
60,Mechelsesteenweg 365,2019-12-22,15:00:00,4,0,4,FMN GV 05 Lier
60,Mechelsesteenweg 365,2019-12-22,16:00:00,8,2,6,FMN GV 05 Lier
60,Mechelsesteenweg 365,2019-12-22,17:00:00,6,2,4,FMN GV 05 Lier
60,Mechelsesteenweg 365,2019-12-22,18:00:00,2,2,0,FMN GV 05 Lier
60,Mechelsesteenweg 365,2019-12-22,19:00:00,2,0,2,FMN GV 05 Lier
60,Mechelsesteenweg 365,2019-12-22,20:00:00,2,2,0,FMN GV 05 Lier
60,Mechelsesteenweg 365,2019-12-22,21:00:00,2,0,2,FMN GV 05 Lier
60,Mechelsesteenweg 365,2019-12-22,22:00:00,0,0,0,FMN GV 05 Lier
60,Mechelsesteenweg 365,2019-12-22,23:00:00,6,2,4,FMN GV 05 Lier
60,Mechelsesteenweg 365,2019-12-23,00:00:00,0,0,0,FMN GV 05 Lier
60,Mechelsesteenweg 365,2019-12-23,01:00:00,6,0,6,FMN GV 05 Lier
60,Mechelsesteenweg 365,2019-12-23,02:00:00,0,0,0,FMN GV 05 Lier
60,Mechelsesteenweg 365,2019-12-23,03:00:00,0,0,0,FMN GV 05 Lier
60,Mechelsesteenweg 365,2019-12-23,04:00:00,2,0,2,FMN GV 05 Lier
60,Mechelsesteenweg 365,2019-12-23,05:00:00,6,0,6,FMN GV 05 Lier
60,Mechelsesteenweg 365,2019-12-23,06:00:00,8,2,6,FMN GV 05 Lier
60,Mechelsesteenweg 365,2019-12-23,07:00:00,34,18,16,FMN GV 05 Lier
60,Mechelsesteenweg 365,2019-12-23,08:00:00,28,6,22,FMN GV 05 Lier
60,Mechelsesteenweg 365,2019-12-23,09:00:00,24,16,8,FMN GV 05 Lier
60,Mechelsesteenweg 365,2019-12-23,10:00:00,52,28,24,FMN GV 05 Lier
60,Mechelsesteenweg 365,2019-12-23,11:00:00,58,30,28,FMN GV 05 Lier
60,Mechelsesteenweg 365,2019-12-23,12:00:00,44,24,20,FMN GV 05 Lier
60,Mechelsesteenweg 365,2019-12-23,13:00:00,40,14,26,FMN GV 05 Lier
60,Mechelsesteenweg 365,2019-12-23,14:00:00,64,46,18,FMN GV 05 Lier
60,Mechelsesteenweg 365,2019-12-23,15:00:00,60,32,28,FMN GV 05 Lier
60,Mechelsesteenweg 365,2019-12-23,16:00:00,60,32,28,FMN GV 05 Lier
60,Mechelsesteenweg 365,2019-12-23,17:00:00,36,34,2,FMN GV 05 Lier
60,Mechelsesteenweg 365,2019-12-23,18:00:00,10,6,4,FMN GV 05 Lier
60,Mechelsesteenweg 365,2019-12-23,19:00:00,2,2,0,FMN GV 05 Lier
60,Mechelsesteenweg 365,2019-12-23,20:00:00,4,0,4,FMN GV 05 Lier
60,Mechelsesteenweg 365,2019-12-23,21:00:00,10,10,0,FMN GV 05 Lier
60,Mechelsesteenweg 365,2019-12-23,22:00:00,2,0,2,FMN GV 05 Lier
60,Mechelsesteenweg 365,2019-12-23,23:00:00,4,0,4,FMN GV 05 Lier
60,Mechelsesteenweg 365,2019-12-24,00:00:00,0,0,0,FMN GV 05 Lier
60,Mechelsesteenweg 365,2019-12-24,01:00:00,0,0,0,FMN GV 05 Lier
60,Mechelsesteenweg 365,2019-12-24,02:00:00,0,0,0,FMN GV 05 Lier
60,Mechelsesteenweg 365,2019-12-24,03:00:00,0,0,0,FMN GV 05 Lier
60,Mechelsesteenweg 365,2019-12-24,04:00:00,0,0,0,FMN GV 05 Lier
60,Mechelsesteenweg 365,2019-12-24,05:00:00,6,0,6,FMN GV 05 Lier
60,Mechelsesteenweg 365,2019-12-24,06:00:00,0,0,0,FMN GV 05 Lier
60,Mechelsesteenweg 365,2019-12-24,07:00:00,14,4,10,FMN GV 05 Lier
60,Mechelsesteenweg 365,2019-12-24,08:00:00,16,6,10,FMN GV 05 Lier
60,Mechelsesteenweg 365,2019-12-24,09:00:00,18,8,10,FMN GV 05 Lier
60,Mechelsesteenweg 365,2019-12-24,10:00:00,30,22,8,FMN GV 05 Lier
60,Mechelsesteenweg 365,2019-12-24,11:00:00,42,22,20,FMN GV 05 Lier
60,Mechelsesteenweg 365,2019-12-24,12:00:00,22,10,12,FMN GV 05 Lier
60,Mechelsesteenweg 365,2019-12-24,13:00:00,78,50,28,FMN GV 05 Lier
60,Mechelsesteenweg 365,2019-12-24,14:00:00,78,50,28,FMN GV 05 Lier
60,Mechelsesteenweg 365,2019-12-24,15:00:00,32,22,10,FMN GV 05 Lier
60,Mechelsesteenweg 365,2019-12-24,16:00:00,36,18,18,FMN GV 05 Lier
60,Mechelsesteenweg 365,2019-12-24,17:00:00,14,4,10,FMN GV 05 Lier
60,Mechelsesteenweg 365,2019-12-24,18:00:00,0,0,0,FMN GV 05 Lier
60,Mechelsesteenweg 365,2019-12-24,19:00:00,2,0,2,FMN GV 05 Lier
60,Mechelsesteenweg 365,2019-12-24,20:00:00,2,0,2,FMN GV 05 Lier
60,Mechelsesteenweg 365,2019-12-24,21:00:00,0,0,0,FMN GV 05 Lier
60,Mechelsesteenweg 365,2019-12-24,22:00:00,4,2,2,FMN GV 05 Lier
60,Mechelsesteenweg 365,2019-12-24,23:00:00,2,2,0,FMN GV 05 Lier
60,Mechelsesteenweg 365,2019-12-25,00:00:00,0,0,0,FMN GV 05 Lier
60,Mechelsesteenweg 365,2019-12-25,01:00:00,2,0,2,FMN GV 05 Lier
60,Mechelsesteenweg 365,2019-12-25,02:00:00,0,0,0,FMN GV 05 Lier
60,Mechelsesteenweg 365,2019-12-25,03:00:00,2,2,0,FMN GV 05 Lier
60,Mechelsesteenweg 365,2019-12-25,04:00:00,0,0,0,FMN GV 05 Lier
60,Mechelsesteenweg 365,2019-12-25,05:00:00,0,0,0,FMN GV 05 Lier
60,Mechelsesteenweg 365,2019-12-25,06:00:00,0,0,0,FMN GV 05 Lier
60,Mechelsesteenweg 365,2019-12-25,07:00:00,2,2,0,FMN GV 05 Lier
60,Mechelsesteenweg 365,2019-12-25,08:00:00,6,4,2,FMN GV 05 Lier
60,Mechelsesteenweg 365,2019-12-25,09:00:00,18,2,16,FMN GV 05 Lier
60,Mechelsesteenweg 365,2019-12-25,10:00:00,32,14,18,FMN GV 05 Lier
60,Mechelsesteenweg 365,2019-12-25,11:00:00,82,34,48,FMN GV 05 Lier
60,Mechelsesteenweg 365,2019-12-25,12:00:00,68,34,34,FMN GV 05 Lier
60,Mechelsesteenweg 365,2019-12-25,13:00:00,90,32,58,FMN GV 05 Lier
60,Mechelsesteenweg 365,2019-12-25,14:00:00,76,34,42,FMN GV 05 Lier
60,Mechelsesteenweg 365,2019-12-25,15:00:00,54,22,32,FMN GV 05 Lier
60,Mechelsesteenweg 365,2019-12-25,16:00:00,40,20,20,FMN GV 05 Lier
60,Mechelsesteenweg 365,2019-12-25,17:00:00,4,2,2,FMN GV 05 Lier
60,Mechelsesteenweg 365,2019-12-25,18:00:00,2,2,0,FMN GV 05 Lier
60,Mechelsesteenweg 365,2019-12-25,19:00:00,0,0,0,FMN GV 05 Lier
60,Mechelsesteenweg 365,2019-12-25,20:00:00,12,2,10,FMN GV 05 Lier
60,Mechelsesteenweg 365,2019-12-25,21:00:00,0,0,0,FMN GV 05 Lier
60,Mechelsesteenweg 365,2019-12-25,22:00:00,2,0,2,FMN GV 05 Lier
60,Mechelsesteenweg 365,2019-12-25,23:00:00,0,0,0,FMN GV 05 Lier
60,Mechelsesteenweg 365,2019-12-26,00:00:00,0,0,0,FMN GV 05 Lier
60,Mechelsesteenweg 365,2019-12-26,01:00:00,0,0,0,FMN GV 05 Lier
60,Mechelsesteenweg 365,2019-12-26,02:00:00,0,0,0,FMN GV 05 Lier
60,Mechelsesteenweg 365,2019-12-26,03:00:00,0,0,0,FMN GV 05 Lier
60,Mechelsesteenweg 365,2019-12-26,04:00:00,0,0,0,FMN GV 05 Lier
60,Mechelsesteenweg 365,2019-12-26,05:00:00,2,0,2,FMN GV 05 Lier
60,Mechelsesteenweg 365,2019-12-26,06:00:00,2,2,0,FMN GV 05 Lier
60,Mechelsesteenweg 365,2019-12-26,07:00:00,8,4,4,FMN GV 05 Lier
60,Mechelsesteenweg 365,2019-12-26,08:00:00,18,10,8,FMN GV 05 Lier
60,Mechelsesteenweg 365,2019-12-26,09:00:00,64,46,18,FMN GV 05 Lier
60,Mechelsesteenweg 365,2019-12-26,10:00:00,94,54,40,FMN GV 05 Lier
60,Mechelsesteenweg 365,2019-12-26,11:00:00,78,38,40,FMN GV 05 Lier
60,Mechelsesteenweg 365,2019-12-26,12:00:00,90,44,46,FMN GV 05 Lier
60,Mechelsesteenweg 365,2019-12-26,13:00:00,78,42,36,FMN GV 05 Lier
60,Mechelsesteenweg 365,2019-12-26,14:00:00,72,40,32,FMN GV 05 Lier
60,Mechelsesteenweg 365,2019-12-26,15:00:00,40,18,22,FMN GV 05 Lier
60,Mechelsesteenweg 365,2019-12-26,16:00:00,42,16,26,FMN GV 05 Lier
60,Mechelsesteenweg 365,2019-12-26,17:00:00,10,4,6,FMN GV 05 Lier
60,Mechelsesteenweg 365,2019-12-26,18:00:00,10,4,6,FMN GV 05 Lier
60,Mechelsesteenweg 365,2019-12-26,19:00:00,4,2,2,FMN GV 05 Lier
60,Mechelsesteenweg 365,2019-12-26,20:00:00,2,0,2,FMN GV 05 Lier
60,Mechelsesteenweg 365,2019-12-26,21:00:00,6,0,6,FMN GV 05 Lier
60,Mechelsesteenweg 365,2019-12-26,22:00:00,6,2,4,FMN GV 05 Lier
60,Mechelsesteenweg 365,2019-12-26,23:00:00,2,2,0,FMN GV 05 Lier
60,Mechelsesteenweg 365,2019-12-27,00:00:00,0,0,0,FMN GV 05 Lier
60,Mechelsesteenweg 365,2019-12-27,01:00:00,0,0,0,FMN GV 05 Lier
60,Mechelsesteenweg 365,2019-12-27,02:00:00,0,0,0,FMN GV 05 Lier
60,Mechelsesteenweg 365,2019-12-27,03:00:00,0,0,0,FMN GV 05 Lier
60,Mechelsesteenweg 365,2019-12-27,04:00:00,4,0,4,FMN GV 05 Lier
60,Mechelsesteenweg 365,2019-12-27,05:00:00,8,2,6,FMN GV 05 Lier
60,Mechelsesteenweg 365,2019-12-27,06:00:00,4,0,4,FMN GV 05 Lier
60,Mechelsesteenweg 365,2019-12-27,07:00:00,16,8,8,FMN GV 05 Lier
60,Mechelsesteenweg 365,2019-12-27,08:00:00,16,2,14,FMN GV 05 Lier
60,Mechelsesteenweg 365,2019-12-27,09:00:00,34,14,20,FMN GV 05 Lier
60,Mechelsesteenweg 365,2019-12-27,10:00:00,170,140,30,FMN GV 05 Lier
60,Mechelsesteenweg 365,2019-12-27,11:00:00,52,30,22,FMN GV 05 Lier
60,Mechelsesteenweg 365,2019-12-27,12:00:00,50,16,34,FMN GV 05 Lier
60,Mechelsesteenweg 365,2019-12-27,13:00:00,60,24,36,FMN GV 05 Lier
60,Mechelsesteenweg 365,2019-12-27,14:00:00,80,52,28,FMN GV 05 Lier
60,Mechelsesteenweg 365,2019-12-27,15:00:00,58,28,30,FMN GV 05 Lier
60,Mechelsesteenweg 365,2019-12-27,16:00:00,44,24,20,FMN GV 05 Lier
60,Mechelsesteenweg 365,2019-12-27,17:00:00,32,14,18,FMN GV 05 Lier
60,Mechelsesteenweg 365,2019-12-27,18:00:00,24,10,14,FMN GV 05 Lier
60,Mechelsesteenweg 365,2019-12-27,19:00:00,8,2,6,FMN GV 05 Lier
60,Mechelsesteenweg 365,2019-12-27,20:00:00,8,2,6,FMN GV 05 Lier
60,Mechelsesteenweg 365,2019-12-27,21:00:00,2,2,0,FMN GV 05 Lier
60,Mechelsesteenweg 365,2019-12-27,22:00:00,4,0,4,FMN GV 05 Lier
60,Mechelsesteenweg 365,2019-12-27,23:00:00,0,0,0,FMN GV 05 Lier
60,Mechelsesteenweg 365,2019-12-28,00:00:00,0,0,0,FMN GV 05 Lier
60,Mechelsesteenweg 365,2019-12-28,01:00:00,2,0,2,FMN GV 05 Lier
60,Mechelsesteenweg 365,2019-12-28,02:00:00,4,2,2,FMN GV 05 Lier
60,Mechelsesteenweg 365,2019-12-28,03:00:00,0,0,0,FMN GV 05 Lier
60,Mechelsesteenweg 365,2019-12-28,04:00:00,0,0,0,FMN GV 05 Lier
60,Mechelsesteenweg 365,2019-12-28,05:00:00,0,0,0,FMN GV 05 Lier
60,Mechelsesteenweg 365,2019-12-28,06:00:00,0,0,0,FMN GV 05 Lier
60,Mechelsesteenweg 365,2019-12-28,07:00:00,6,2,4,FMN GV 05 Lier
60,Mechelsesteenweg 365,2019-12-28,08:00:00,8,6,2,FMN GV 05 Lier
60,Mechelsesteenweg 365,2019-12-28,09:00:00,26,8,18,FMN GV 05 Lier
60,Mechelsesteenweg 365,2019-12-28,10:00:00,96,42,54,FMN GV 05 Lier
60,Mechelsesteenweg 365,2019-12-28,11:00:00,128,70,58,FMN GV 05 Lier
60,Mechelsesteenweg 365,2019-12-28,12:00:00,116,60,56,FMN GV 05 Lier
60,Mechelsesteenweg 365,2019-12-28,13:00:00,196,136,60,FMN GV 05 Lier
60,Mechelsesteenweg 365,2019-12-28,14:00:00,244,136,108,FMN GV 05 Lier
60,Mechelsesteenweg 365,2019-12-28,15:00:00,146,60,86,FMN GV 05 Lier
60,Mechelsesteenweg 365,2019-12-28,16:00:00,72,24,48,FMN GV 05 Lier
60,Mechelsesteenweg 365,2019-12-28,17:00:00,12,8,4,FMN GV 05 Lier
60,Mechelsesteenweg 365,2019-12-28,18:00:00,12,6,6,FMN GV 05 Lier
60,Mechelsesteenweg 365,2019-12-28,19:00:00,8,4,4,FMN GV 05 Lier
60,Mechelsesteenweg 365,2019-12-28,20:00:00,4,2,2,FMN GV 05 Lier
60,Mechelsesteenweg 365,2019-12-28,21:00:00,0,0,0,FMN GV 05 Lier
60,Mechelsesteenweg 365,2019-12-28,22:00:00,6,2,4,FMN GV 05 Lier
60,Mechelsesteenweg 365,2019-12-28,23:00:00,4,0,4,FMN GV 05 Lier
60,Mechelsesteenweg 365,2019-12-29,00:00:00,2,2,0,FMN GV 05 Lier
60,Mechelsesteenweg 365,2019-12-29,01:00:00,0,0,0,FMN GV 05 Lier
60,Mechelsesteenweg 365,2019-12-29,02:00:00,0,0,0,FMN GV 05 Lier
60,Mechelsesteenweg 365,2019-12-29,03:00:00,0,0,0,FMN GV 05 Lier
60,Mechelsesteenweg 365,2019-12-29,04:00:00,0,0,0,FMN GV 05 Lier
60,Mechelsesteenweg 365,2019-12-29,05:00:00,0,0,0,FMN GV 05 Lier
60,Mechelsesteenweg 365,2019-12-29,06:00:00,2,0,2,FMN GV 05 Lier
60,Mechelsesteenweg 365,2019-12-29,07:00:00,2,2,0,FMN GV 05 Lier
60,Mechelsesteenweg 365,2019-12-29,08:00:00,22,12,10,FMN GV 05 Lier
60,Mechelsesteenweg 365,2019-12-29,09:00:00,66,54,12,FMN GV 05 Lier
60,Mechelsesteenweg 365,2019-12-29,10:00:00,490,404,86,FMN GV 05 Lier
60,Mechelsesteenweg 365,2019-12-29,11:00:00,720,606,114,FMN GV 05 Lier
60,Mechelsesteenweg 365,2019-12-29,12:00:00,388,338,50,FMN GV 05 Lier
60,Mechelsesteenweg 365,2019-12-29,13:00:00,160,94,66,FMN GV 05 Lier
60,Mechelsesteenweg 365,2019-12-29,14:00:00,156,98,58,FMN GV 05 Lier
60,Mechelsesteenweg 365,2019-12-29,15:00:00,94,44,50,FMN GV 05 Lier
60,Mechelsesteenweg 365,2019-12-29,16:00:00,70,34,36,FMN GV 05 Lier
60,Mechelsesteenweg 365,2019-12-29,17:00:00,16,14,2,FMN GV 05 Lier
60,Mechelsesteenweg 365,2019-12-29,18:00:00,4,2,2,FMN GV 05 Lier
60,Mechelsesteenweg 365,2019-12-29,19:00:00,2,2,0,FMN GV 05 Lier
60,Mechelsesteenweg 365,2019-12-29,20:00:00,8,2,6,FMN GV 05 Lier
60,Mechelsesteenweg 365,2019-12-29,21:00:00,0,0,0,FMN GV 05 Lier
60,Mechelsesteenweg 365,2019-12-29,22:00:00,6,2,4,FMN GV 05 Lier
60,Mechelsesteenweg 365,2019-12-29,23:00:00,0,0,0,FMN GV 05 Lier
60,Mechelsesteenweg 365,2019-12-30,00:00:00,2,0,2,FMN GV 05 Lier
60,Mechelsesteenweg 365,2019-12-30,01:00:00,2,2,0,FMN GV 05 Lier
60,Mechelsesteenweg 365,2019-12-30,02:00:00,0,0,0,FMN GV 05 Lier
60,Mechelsesteenweg 365,2019-12-30,03:00:00,0,0,0,FMN GV 05 Lier
60,Mechelsesteenweg 365,2019-12-30,04:00:00,2,0,2,FMN GV 05 Lier
60,Mechelsesteenweg 365,2019-12-30,05:00:00,2,2,0,FMN GV 05 Lier
60,Mechelsesteenweg 365,2019-12-30,06:00:00,0,0,0,FMN GV 05 Lier
60,Mechelsesteenweg 365,2019-12-30,07:00:00,20,6,14,FMN GV 05 Lier
60,Mechelsesteenweg 365,2019-12-30,08:00:00,16,4,12,FMN GV 05 Lier
60,Mechelsesteenweg 365,2019-12-30,09:00:00,16,8,8,FMN GV 05 Lier
60,Mechelsesteenweg 365,2019-12-30,10:00:00,52,32,20,FMN GV 05 Lier
60,Mechelsesteenweg 365,2019-12-30,11:00:00,94,38,56,FMN GV 05 Lier
60,Mechelsesteenweg 365,2019-12-30,12:00:00,108,58,50,FMN GV 05 Lier
60,Mechelsesteenweg 365,2019-12-30,13:00:00,150,76,74,FMN GV 05 Lier
60,Mechelsesteenweg 365,2019-12-30,14:00:00,222,120,102,FMN GV 05 Lier
60,Mechelsesteenweg 365,2019-12-30,15:00:00,148,64,84,FMN GV 05 Lier
60,Mechelsesteenweg 365,2019-12-30,16:00:00,84,36,48,FMN GV 05 Lier
60,Mechelsesteenweg 365,2019-12-30,17:00:00,38,22,16,FMN GV 05 Lier
60,Mechelsesteenweg 365,2019-12-30,18:00:00,8,8,0,FMN GV 05 Lier
60,Mechelsesteenweg 365,2019-12-30,19:00:00,10,8,2,FMN GV 05 Lier
60,Mechelsesteenweg 365,2019-12-30,20:00:00,4,0,4,FMN GV 05 Lier
60,Mechelsesteenweg 365,2019-12-30,21:00:00,4,2,2,FMN GV 05 Lier
60,Mechelsesteenweg 365,2019-12-30,22:00:00,2,0,2,FMN GV 05 Lier
60,Mechelsesteenweg 365,2019-12-30,23:00:00,2,0,2,FMN GV 05 Lier
60,Mechelsesteenweg 365,2019-12-31,00:00:00,0,0,0,FMN GV 05 Lier
60,Mechelsesteenweg 365,2019-12-31,01:00:00,0,0,0,FMN GV 05 Lier
60,Mechelsesteenweg 365,2019-12-31,02:00:00,0,0,0,FMN GV 05 Lier
60,Mechelsesteenweg 365,2019-12-31,03:00:00,0,0,0,FMN GV 05 Lier
60,Mechelsesteenweg 365,2019-12-31,04:00:00,0,0,0,FMN GV 05 Lier
60,Mechelsesteenweg 365,2019-12-31,05:00:00,4,2,2,FMN GV 05 Lier
60,Mechelsesteenweg 365,2019-12-31,06:00:00,2,0,2,FMN GV 05 Lier
60,Mechelsesteenweg 365,2019-12-31,07:00:00,20,10,10,FMN GV 05 Lier
60,Mechelsesteenweg 365,2019-12-31,08:00:00,10,4,6,FMN GV 05 Lier
60,Mechelsesteenweg 365,2019-12-31,09:00:00,34,12,22,FMN GV 05 Lier
60,Mechelsesteenweg 365,2019-12-31,10:00:00,66,32,34,FMN GV 05 Lier
60,Mechelsesteenweg 365,2019-12-31,11:00:00,88,42,46,FMN GV 05 Lier
60,Mechelsesteenweg 365,2019-12-31,12:00:00,52,22,30,FMN GV 05 Lier
60,Mechelsesteenweg 365,2019-12-31,13:00:00,70,28,42,FMN GV 05 Lier
60,Mechelsesteenweg 365,2019-12-31,14:00:00,82,60,22,FMN GV 05 Lier
60,Mechelsesteenweg 365,2019-12-31,15:00:00,68,38,30,FMN GV 05 Lier
60,Mechelsesteenweg 365,2019-12-31,16:00:00,22,10,12,FMN GV 05 Lier
60,Mechelsesteenweg 365,2019-12-31,17:00:00,22,8,14,FMN GV 05 Lier
60,Mechelsesteenweg 365,2019-12-31,18:00:00,18,4,14,FMN GV 05 Lier
60,Mechelsesteenweg 365,2019-12-31,19:00:00,2,0,2,FMN GV 05 Lier
60,Mechelsesteenweg 365,2019-12-31,20:00:00,2,2,0,FMN GV 05 Lier
60,Mechelsesteenweg 365,2019-12-31,21:00:00,0,0,0,FMN GV 05 Lier
60,Mechelsesteenweg 365,2019-12-31,22:00:00,0,0,0,FMN GV 05 Lier
60,Mechelsesteenweg 365,2019-12-31,23:00:00,2,2,0,FMN GV 05 Lier
60,Mechelsesteenweg 365,2020-01-01,00:00:00,0,0,0,FMN GV 05 Lier
60,Mechelsesteenweg 365,2020-01-01,01:00:00,6,6,0,FMN GV 05 Lier
60,Mechelsesteenweg 365,2020-01-01,02:00:00,0,0,0,FMN GV 05 Lier
60,Mechelsesteenweg 365,2020-01-01,03:00:00,2,2,0,FMN GV 05 Lier
60,Mechelsesteenweg 365,2020-01-01,04:00:00,4,0,4,FMN GV 05 Lier
60,Mechelsesteenweg 365,2020-01-01,05:00:00,2,2,0,FMN GV 05 Lier
60,Mechelsesteenweg 365,2020-01-01,06:00:00,0,0,0,FMN GV 05 Lier
60,Mechelsesteenweg 365,2020-01-01,07:00:00,2,0,2,FMN GV 05 Lier
60,Mechelsesteenweg 365,2020-01-01,08:00:00,0,0,0,FMN GV 05 Lier
60,Mechelsesteenweg 365,2020-01-01,09:00:00,36,12,24,FMN GV 05 Lier
60,Mechelsesteenweg 365,2020-01-01,10:00:00,34,20,14,FMN GV 05 Lier
60,Mechelsesteenweg 365,2020-01-01,11:00:00,52,28,24,FMN GV 05 Lier
60,Mechelsesteenweg 365,2020-01-01,12:00:00,64,18,46,FMN GV 05 Lier
60,Mechelsesteenweg 365,2020-01-01,13:00:00,74,44,30,FMN GV 05 Lier
60,Mechelsesteenweg 365,2020-01-01,14:00:00,62,32,30,FMN GV 05 Lier
60,Mechelsesteenweg 365,2020-01-01,15:00:00,62,30,32,FMN GV 05 Lier
60,Mechelsesteenweg 365,2020-01-01,16:00:00,16,10,6,FMN GV 05 Lier
60,Mechelsesteenweg 365,2020-01-01,17:00:00,4,2,2,FMN GV 05 Lier
60,Mechelsesteenweg 365,2020-01-01,18:00:00,2,2,0,FMN GV 05 Lier
60,Mechelsesteenweg 365,2020-01-01,19:00:00,0,0,0,FMN GV 05 Lier
60,Mechelsesteenweg 365,2020-01-01,20:00:00,2,2,0,FMN GV 05 Lier
60,Mechelsesteenweg 365,2020-01-01,21:00:00,0,0,0,FMN GV 05 Lier
60,Mechelsesteenweg 365,2020-01-01,22:00:00,0,0,0,FMN GV 05 Lier
60,Mechelsesteenweg 365,2020-01-01,23:00:00,2,2,0,FMN GV 05 Lier
60,Mechelsesteenweg 365,2020-01-02,00:00:00,0,0,0,FMN GV 05 Lier
60,Mechelsesteenweg 365,2020-01-02,01:00:00,0,0,0,FMN GV 05 Lier
60,Mechelsesteenweg 365,2020-01-02,02:00:00,0,0,0,FMN GV 05 Lier
60,Mechelsesteenweg 365,2020-01-02,03:00:00,0,0,0,FMN GV 05 Lier
60,Mechelsesteenweg 365,2020-01-02,04:00:00,2,0,2,FMN GV 05 Lier
60,Mechelsesteenweg 365,2020-01-02,05:00:00,2,0,2,FMN GV 05 Lier
60,Mechelsesteenweg 365,2020-01-02,06:00:00,14,0,14,FMN GV 05 Lier
60,Mechelsesteenweg 365,2020-01-02,07:00:00,34,10,24,FMN GV 05 Lier
60,Mechelsesteenweg 365,2020-01-02,08:00:00,12,4,8,FMN GV 05 Lier
60,Mechelsesteenweg 365,2020-01-02,09:00:00,26,12,14,FMN GV 05 Lier
60,Mechelsesteenweg 365,2020-01-02,10:00:00,46,26,20,FMN GV 05 Lier
60,Mechelsesteenweg 365,2020-01-02,11:00:00,60,26,34,FMN GV 05 Lier
60,Mechelsesteenweg 365,2020-01-02,12:00:00,46,28,18,FMN GV 05 Lier
60,Mechelsesteenweg 365,2020-01-02,13:00:00,76,50,26,FMN GV 05 Lier
60,Mechelsesteenweg 365,2020-01-02,14:00:00,120,66,54,FMN GV 05 Lier
60,Mechelsesteenweg 365,2020-01-02,15:00:00,84,44,40,FMN GV 05 Lier
60,Mechelsesteenweg 365,2020-01-02,16:00:00,60,38,22,FMN GV 05 Lier
60,Mechelsesteenweg 365,2020-01-02,17:00:00,36,28,8,FMN GV 05 Lier
60,Mechelsesteenweg 365,2020-01-02,18:00:00,12,8,4,FMN GV 05 Lier
60,Mechelsesteenweg 365,2020-01-02,19:00:00,10,4,6,FMN GV 05 Lier
60,Mechelsesteenweg 365,2020-01-02,20:00:00,2,0,2,FMN GV 05 Lier
60,Mechelsesteenweg 365,2020-01-02,21:00:00,0,0,0,FMN GV 05 Lier
60,Mechelsesteenweg 365,2020-01-02,22:00:00,4,2,2,FMN GV 05 Lier
60,Mechelsesteenweg 365,2020-01-02,23:00:00,0,0,0,FMN GV 05 Lier
60,Mechelsesteenweg 365,2020-01-03,00:00:00,0,0,0,FMN GV 05 Lier
60,Mechelsesteenweg 365,2020-01-03,01:00:00,0,0,0,FMN GV 05 Lier
60,Mechelsesteenweg 365,2020-01-03,02:00:00,0,0,0,FMN GV 05 Lier
60,Mechelsesteenweg 365,2020-01-03,03:00:00,0,0,0,FMN GV 05 Lier
60,Mechelsesteenweg 365,2020-01-03,04:00:00,0,0,0,FMN GV 05 Lier
60,Mechelsesteenweg 365,2020-01-03,05:00:00,8,0,8,FMN GV 05 Lier
60,Mechelsesteenweg 365,2020-01-03,06:00:00,4,0,4,FMN GV 05 Lier
60,Mechelsesteenweg 365,2020-01-03,07:00:00,32,10,22,FMN GV 05 Lier
60,Mechelsesteenweg 365,2020-01-03,08:00:00,18,8,10,FMN GV 05 Lier
60,Mechelsesteenweg 365,2020-01-03,09:00:00,28,16,12,FMN GV 05 Lier
60,Mechelsesteenweg 365,2020-01-03,10:00:00,26,12,14,FMN GV 05 Lier
60,Mechelsesteenweg 365,2020-01-03,11:00:00,20,8,12,FMN GV 05 Lier
60,Mechelsesteenweg 365,2020-01-03,12:00:00,28,18,10,FMN GV 05 Lier
60,Mechelsesteenweg 365,2020-01-03,13:00:00,10,4,6,FMN GV 05 Lier
60,Mechelsesteenweg 365,2020-01-03,14:00:00,18,12,6,FMN GV 05 Lier
60,Mechelsesteenweg 365,2020-01-03,15:00:00,30,16,14,FMN GV 05 Lier
60,Mechelsesteenweg 365,2020-01-03,16:00:00,46,22,24,FMN GV 05 Lier
60,Mechelsesteenweg 365,2020-01-03,17:00:00,28,20,8,FMN GV 05 Lier
60,Mechelsesteenweg 365,2020-01-03,18:00:00,22,16,6,FMN GV 05 Lier
60,Mechelsesteenweg 365,2020-01-03,19:00:00,2,0,2,FMN GV 05 Lier
60,Mechelsesteenweg 365,2020-01-03,20:00:00,4,0,4,FMN GV 05 Lier
60,Mechelsesteenweg 365,2020-01-03,21:00:00,2,0,2,FMN GV 05 Lier
60,Mechelsesteenweg 365,2020-01-03,22:00:00,0,0,0,FMN GV 05 Lier
60,Mechelsesteenweg 365,2020-01-03,23:00:00,4,4,0,FMN GV 05 Lier
60,Mechelsesteenweg 365,2020-01-04,00:00:00,2,2,0,FMN GV 05 Lier
60,Mechelsesteenweg 365,2020-01-04,01:00:00,4,0,4,FMN GV 05 Lier
60,Mechelsesteenweg 365,2020-01-04,02:00:00,0,0,0,FMN GV 05 Lier
60,Mechelsesteenweg 365,2020-01-04,03:00:00,2,0,2,FMN GV 05 Lier
60,Mechelsesteenweg 365,2020-01-04,04:00:00,0,0,0,FMN GV 05 Lier
60,Mechelsesteenweg 365,2020-01-04,05:00:00,0,0,0,FMN GV 05 Lier
60,Mechelsesteenweg 365,2020-01-04,06:00:00,2,2,0,FMN GV 05 Lier
60,Mechelsesteenweg 365,2020-01-04,07:00:00,4,4,0,FMN GV 05 Lier
60,Mechelsesteenweg 365,2020-01-04,08:00:00,12,0,12,FMN GV 05 Lier
60,Mechelsesteenweg 365,2020-01-04,09:00:00,52,20,32,FMN GV 05 Lier
60,Mechelsesteenweg 365,2020-01-04,10:00:00,106,74,32,FMN GV 05 Lier
60,Mechelsesteenweg 365,2020-01-04,11:00:00,124,64,60,FMN GV 05 Lier
60,Mechelsesteenweg 365,2020-01-04,12:00:00,124,54,70,FMN GV 05 Lier
60,Mechelsesteenweg 365,2020-01-04,13:00:00,136,72,64,FMN GV 05 Lier
60,Mechelsesteenweg 365,2020-01-04,14:00:00,104,64,40,FMN GV 05 Lier
60,Mechelsesteenweg 365,2020-01-04,15:00:00,134,64,70,FMN GV 05 Lier
60,Mechelsesteenweg 365,2020-01-04,16:00:00,44,14,30,FMN GV 05 Lier
60,Mechelsesteenweg 365,2020-01-04,17:00:00,12,4,8,FMN GV 05 Lier
60,Mechelsesteenweg 365,2020-01-04,18:00:00,4,2,2,FMN GV 05 Lier
60,Mechelsesteenweg 365,2020-01-04,19:00:00,4,2,2,FMN GV 05 Lier
60,Mechelsesteenweg 365,2020-01-04,20:00:00,2,2,0,FMN GV 05 Lier
60,Mechelsesteenweg 365,2020-01-04,21:00:00,2,0,2,FMN GV 05 Lier
60,Mechelsesteenweg 365,2020-01-04,22:00:00,2,2,0,FMN GV 05 Lier
60,Mechelsesteenweg 365,2020-01-04,23:00:00,0,0,0,FMN GV 05 Lier
60,Mechelsesteenweg 365,2020-01-05,00:00:00,2,0,2,FMN GV 05 Lier
60,Mechelsesteenweg 365,2020-01-05,01:00:00,0,0,0,FMN GV 05 Lier
60,Mechelsesteenweg 365,2020-01-05,02:00:00,0,0,0,FMN GV 05 Lier
60,Mechelsesteenweg 365,2020-01-05,03:00:00,0,0,0,FMN GV 05 Lier
60,Mechelsesteenweg 365,2020-01-05,04:00:00,0,0,0,FMN GV 05 Lier
60,Mechelsesteenweg 365,2020-01-05,05:00:00,0,0,0,FMN GV 05 Lier
60,Mechelsesteenweg 365,2020-01-05,06:00:00,0,0,0,FMN GV 05 Lier
60,Mechelsesteenweg 365,2020-01-05,07:00:00,2,0,2,FMN GV 05 Lier
60,Mechelsesteenweg 365,2020-01-05,08:00:00,24,12,12,FMN GV 05 Lier
60,Mechelsesteenweg 365,2020-01-05,09:00:00,104,56,48,FMN GV 05 Lier
60,Mechelsesteenweg 365,2020-01-05,10:00:00,252,144,108,FMN GV 05 Lier
60,Mechelsesteenweg 365,2020-01-05,11:00:00,258,128,130,FMN GV 05 Lier
60,Mechelsesteenweg 365,2020-01-05,12:00:00,154,102,52,FMN GV 05 Lier
60,Mechelsesteenweg 365,2020-01-05,13:00:00,142,70,72,FMN GV 05 Lier
60,Mechelsesteenweg 365,2020-01-05,14:00:00,114,50,64,FMN GV 05 Lier
60,Mechelsesteenweg 365,2020-01-05,15:00:00,112,50,62,FMN GV 05 Lier
60,Mechelsesteenweg 365,2020-01-05,16:00:00,44,12,32,FMN GV 05 Lier
60,Mechelsesteenweg 365,2020-01-05,17:00:00,8,0,8,FMN GV 05 Lier
60,Mechelsesteenweg 365,2020-01-05,18:00:00,12,6,6,FMN GV 05 Lier
60,Mechelsesteenweg 365,2020-01-05,19:00:00,6,2,4,FMN GV 05 Lier
60,Mechelsesteenweg 365,2020-01-05,20:00:00,4,0,4,FMN GV 05 Lier
60,Mechelsesteenweg 365,2020-01-05,21:00:00,0,0,0,FMN GV 05 Lier
60,Mechelsesteenweg 365,2020-01-05,22:00:00,0,0,0,FMN GV 05 Lier
60,Mechelsesteenweg 365,2020-01-05,23:00:00,4,0,4,FMN GV 05 Lier
60,Mechelsesteenweg 365,2020-01-06,00:00:00,0,0,0,FMN GV 05 Lier
60,Mechelsesteenweg 365,2020-01-06,01:00:00,0,0,0,FMN GV 05 Lier
60,Mechelsesteenweg 365,2020-01-06,02:00:00,0,0,0,FMN GV 05 Lier
60,Mechelsesteenweg 365,2020-01-06,03:00:00,0,0,0,FMN GV 05 Lier
60,Mechelsesteenweg 365,2020-01-06,04:00:00,4,0,4,FMN GV 05 Lier
60,Mechelsesteenweg 365,2020-01-06,05:00:00,8,2,6,FMN GV 05 Lier
60,Mechelsesteenweg 365,2020-01-06,06:00:00,34,4,30,FMN GV 05 Lier
60,Mechelsesteenweg 365,2020-01-06,07:00:00,156,82,74,FMN GV 05 Lier
60,Mechelsesteenweg 365,2020-01-06,08:00:00,138,94,44,FMN GV 05 Lier
60,Mechelsesteenweg 365,2020-01-06,09:00:00,34,16,18,FMN GV 05 Lier
60,Mechelsesteenweg 365,2020-01-06,10:00:00,46,26,20,FMN GV 05 Lier
60,Mechelsesteenweg 365,2020-01-06,11:00:00,48,22,26,FMN GV 05 Lier
60,Mechelsesteenweg 365,2020-01-06,12:00:00,62,34,28,FMN GV 05 Lier
60,Mechelsesteenweg 365,2020-01-06,13:00:00,100,54,46,FMN GV 05 Lier
60,Mechelsesteenweg 365,2020-01-06,14:00:00,144,86,58,FMN GV 05 Lier
60,Mechelsesteenweg 365,2020-01-06,15:00:00,132,74,58,FMN GV 05 Lier
60,Mechelsesteenweg 365,2020-01-06,16:00:00,258,90,168,FMN GV 05 Lier
60,Mechelsesteenweg 365,2020-01-06,17:00:00,122,74,48,FMN GV 05 Lier
60,Mechelsesteenweg 365,2020-01-06,18:00:00,36,22,14,FMN GV 05 Lier
60,Mechelsesteenweg 365,2020-01-06,19:00:00,16,14,2,FMN GV 05 Lier
60,Mechelsesteenweg 365,2020-01-06,20:00:00,6,2,4,FMN GV 05 Lier
60,Mechelsesteenweg 365,2020-01-06,21:00:00,0,0,0,FMN GV 05 Lier
60,Mechelsesteenweg 365,2020-01-06,22:00:00,6,4,2,FMN GV 05 Lier
60,Mechelsesteenweg 365,2020-01-06,23:00:00,0,0,0,FMN GV 05 Lier
60,Mechelsesteenweg 365,2020-01-07,00:00:00,0,0,0,FMN GV 05 Lier
60,Mechelsesteenweg 365,2020-01-07,01:00:00,2,2,0,FMN GV 05 Lier
60,Mechelsesteenweg 365,2020-01-07,02:00:00,0,0,0,FMN GV 05 Lier
60,Mechelsesteenweg 365,2020-01-07,03:00:00,0,0,0,FMN GV 05 Lier
60,Mechelsesteenweg 365,2020-01-07,04:00:00,2,0,2,FMN GV 05 Lier
60,Mechelsesteenweg 365,2020-01-07,05:00:00,8,2,6,FMN GV 05 Lier
60,Mechelsesteenweg 365,2020-01-07,06:00:00,28,4,24,FMN GV 05 Lier
60,Mechelsesteenweg 365,2020-01-07,07:00:00,184,106,78,FMN GV 05 Lier
60,Mechelsesteenweg 365,2020-01-07,08:00:00,122,74,48,FMN GV 05 Lier
60,Mechelsesteenweg 365,2020-01-07,09:00:00,40,20,20,FMN GV 05 Lier
60,Mechelsesteenweg 365,2020-01-07,10:00:00,66,24,42,FMN GV 05 Lier
60,Mechelsesteenweg 365,2020-01-07,11:00:00,76,38,38,FMN GV 05 Lier
60,Mechelsesteenweg 365,2020-01-07,12:00:00,56,24,32,FMN GV 05 Lier
60,Mechelsesteenweg 365,2020-01-07,13:00:00,104,62,42,FMN GV 05 Lier
60,Mechelsesteenweg 365,2020-01-07,14:00:00,116,86,30,FMN GV 05 Lier
60,Mechelsesteenweg 365,2020-01-07,15:00:00,98,58,40,FMN GV 05 Lier
60,Mechelsesteenweg 365,2020-01-07,16:00:00,210,50,160,FMN GV 05 Lier
60,Mechelsesteenweg 365,2020-01-07,17:00:00,112,72,40,FMN GV 05 Lier
60,Mechelsesteenweg 365,2020-01-07,18:00:00,60,32,28,FMN GV 05 Lier
60,Mechelsesteenweg 365,2020-01-07,19:00:00,20,10,10,FMN GV 05 Lier
60,Mechelsesteenweg 365,2020-01-07,20:00:00,4,2,2,FMN GV 05 Lier
60,Mechelsesteenweg 365,2020-01-07,21:00:00,2,2,0,FMN GV 05 Lier
60,Mechelsesteenweg 365,2020-01-07,22:00:00,6,6,0,FMN GV 05 Lier
60,Mechelsesteenweg 365,2020-01-07,23:00:00,2,2,0,FMN GV 05 Lier
60,Mechelsesteenweg 365,2020-01-08,00:00:00,0,0,0,FMN GV 05 Lier
60,Mechelsesteenweg 365,2020-01-08,01:00:00,0,0,0,FMN GV 05 Lier
60,Mechelsesteenweg 365,2020-01-08,02:00:00,0,0,0,FMN GV 05 Lier
60,Mechelsesteenweg 365,2020-01-08,03:00:00,0,0,0,FMN GV 05 Lier
60,Mechelsesteenweg 365,2020-01-08,04:00:00,0,0,0,FMN GV 05 Lier
60,Mechelsesteenweg 365,2020-01-08,05:00:00,8,2,6,FMN GV 05 Lier
60,Mechelsesteenweg 365,2020-01-08,06:00:00,18,4,14,FMN GV 05 Lier
60,Mechelsesteenweg 365,2020-01-08,07:00:00,162,98,64,FMN GV 05 Lier
60,Mechelsesteenweg 365,2020-01-08,08:00:00,96,70,26,FMN GV 05 Lier
60,Mechelsesteenweg 365,2020-01-08,09:00:00,36,20,16,FMN GV 05 Lier
60,Mechelsesteenweg 365,2020-01-08,10:00:00,16,8,8,FMN GV 05 Lier
60,Mechelsesteenweg 365,2020-01-08,11:00:00,38,16,22,FMN GV 05 Lier
60,Mechelsesteenweg 365,2020-01-08,12:00:00,130,26,104,FMN GV 05 Lier
60,Mechelsesteenweg 365,2020-01-08,13:00:00,74,30,44,FMN GV 05 Lier
60,Mechelsesteenweg 365,2020-01-08,14:00:00,50,24,26,FMN GV 05 Lier
60,Mechelsesteenweg 365,2020-01-08,15:00:00,44,24,20,FMN GV 05 Lier
60,Mechelsesteenweg 365,2020-01-08,16:00:00,60,34,26,FMN GV 05 Lier
60,Mechelsesteenweg 365,2020-01-08,17:00:00,58,48,10,FMN GV 05 Lier
60,Mechelsesteenweg 365,2020-01-08,18:00:00,36,26,10,FMN GV 05 Lier
60,Mechelsesteenweg 365,2020-01-08,19:00:00,14,12,2,FMN GV 05 Lier
60,Mechelsesteenweg 365,2020-01-08,20:00:00,10,2,8,FMN GV 05 Lier
60,Mechelsesteenweg 365,2020-01-08,21:00:00,6,2,4,FMN GV 05 Lier
60,Mechelsesteenweg 365,2020-01-08,22:00:00,6,2,4,FMN GV 05 Lier
60,Mechelsesteenweg 365,2020-01-08,23:00:00,2,2,0,FMN GV 05 Lier
60,Mechelsesteenweg 365,2020-01-09,00:00:00,0,0,0,FMN GV 05 Lier
60,Mechelsesteenweg 365,2020-01-09,01:00:00,0,0,0,FMN GV 05 Lier
60,Mechelsesteenweg 365,2020-01-09,02:00:00,0,0,0,FMN GV 05 Lier
60,Mechelsesteenweg 365,2020-01-09,03:00:00,0,0,0,FMN GV 05 Lier
60,Mechelsesteenweg 365,2020-01-09,04:00:00,2,0,2,FMN GV 05 Lier
60,Mechelsesteenweg 365,2020-01-09,05:00:00,6,0,6,FMN GV 05 Lier
60,Mechelsesteenweg 365,2020-01-09,06:00:00,14,2,12,FMN GV 05 Lier
60,Mechelsesteenweg 365,2020-01-09,07:00:00,148,90,58,FMN GV 05 Lier
60,Mechelsesteenweg 365,2020-01-09,08:00:00,108,86,22,FMN GV 05 Lier
60,Mechelsesteenweg 365,2020-01-09,09:00:00,20,14,6,FMN GV 05 Lier
60,Mechelsesteenweg 365,2020-01-09,10:00:00,16,12,4,FMN GV 05 Lier
60,Mechelsesteenweg 365,2020-01-09,11:00:00,10,4,6,FMN GV 05 Lier
60,Mechelsesteenweg 365,2020-01-09,12:00:00,16,4,12,FMN GV 05 Lier
60,Mechelsesteenweg 365,2020-01-09,13:00:00,38,10,28,FMN GV 05 Lier
60,Mechelsesteenweg 365,2020-01-09,14:00:00,38,26,12,FMN GV 05 Lier
60,Mechelsesteenweg 365,2020-01-09,15:00:00,60,30,30,FMN GV 05 Lier
60,Mechelsesteenweg 365,2020-01-09,16:00:00,186,60,126,FMN GV 05 Lier
60,Mechelsesteenweg 365,2020-01-09,17:00:00,78,48,30,FMN GV 05 Lier
60,Mechelsesteenweg 365,2020-01-09,18:00:00,16,10,6,FMN GV 05 Lier
60,Mechelsesteenweg 365,2020-01-09,19:00:00,8,4,4,FMN GV 05 Lier
60,Mechelsesteenweg 365,2020-01-09,20:00:00,6,4,2,FMN GV 05 Lier
60,Mechelsesteenweg 365,2020-01-09,21:00:00,6,6,0,FMN GV 05 Lier
60,Mechelsesteenweg 365,2020-01-09,22:00:00,4,2,2,FMN GV 05 Lier
60,Mechelsesteenweg 365,2020-01-09,23:00:00,2,2,0,FMN GV 05 Lier
60,Mechelsesteenweg 365,2020-01-10,00:00:00,0,0,0,FMN GV 05 Lier
60,Mechelsesteenweg 365,2020-01-10,01:00:00,0,0,0,FMN GV 05 Lier
60,Mechelsesteenweg 365,2020-01-10,02:00:00,0,0,0,FMN GV 05 Lier
60,Mechelsesteenweg 365,2020-01-10,03:00:00,0,0,0,FMN GV 05 Lier
60,Mechelsesteenweg 365,2020-01-10,04:00:00,2,0,2,FMN GV 05 Lier
60,Mechelsesteenweg 365,2020-01-10,05:00:00,4,0,4,FMN GV 05 Lier
60,Mechelsesteenweg 365,2020-01-10,06:00:00,8,0,8,FMN GV 05 Lier
60,Mechelsesteenweg 365,2020-01-10,07:00:00,116,72,44,FMN GV 05 Lier
60,Mechelsesteenweg 365,2020-01-10,08:00:00,122,90,32,FMN GV 05 Lier
60,Mechelsesteenweg 365,2020-01-10,09:00:00,60,24,36,FMN GV 05 Lier
60,Mechelsesteenweg 365,2020-01-10,10:00:00,20,12,8,FMN GV 05 Lier
60,Mechelsesteenweg 365,2020-01-10,11:00:00,34,12,22,FMN GV 05 Lier
60,Mechelsesteenweg 365,2020-01-10,12:00:00,32,16,16,FMN GV 05 Lier
60,Mechelsesteenweg 365,2020-01-10,13:00:00,54,30,24,FMN GV 05 Lier
60,Mechelsesteenweg 365,2020-01-10,14:00:00,56,32,24,FMN GV 05 Lier
60,Mechelsesteenweg 365,2020-01-10,15:00:00,82,50,32,FMN GV 05 Lier
60,Mechelsesteenweg 365,2020-01-10,16:00:00,168,60,108,FMN GV 05 Lier
60,Mechelsesteenweg 365,2020-01-10,17:00:00,62,40,22,FMN GV 05 Lier
60,Mechelsesteenweg 365,2020-01-10,18:00:00,22,16,6,FMN GV 05 Lier
60,Mechelsesteenweg 365,2020-01-10,19:00:00,10,8,2,FMN GV 05 Lier
60,Mechelsesteenweg 365,2020-01-10,20:00:00,8,4,4,FMN GV 05 Lier
60,Mechelsesteenweg 365,2020-01-10,21:00:00,12,4,8,FMN GV 05 Lier
60,Mechelsesteenweg 365,2020-01-10,22:00:00,12,2,10,FMN GV 05 Lier
60,Mechelsesteenweg 365,2020-01-10,23:00:00,8,6,2,FMN GV 05 Lier
60,Mechelsesteenweg 365,2020-01-11,00:00:00,0,0,0,FMN GV 05 Lier
60,Mechelsesteenweg 365,2020-01-11,01:00:00,0,0,0,FMN GV 05 Lier
60,Mechelsesteenweg 365,2020-01-11,02:00:00,0,0,0,FMN GV 05 Lier
60,Mechelsesteenweg 365,2020-01-11,03:00:00,0,0,0,FMN GV 05 Lier
60,Mechelsesteenweg 365,2020-01-11,04:00:00,0,0,0,FMN GV 05 Lier
60,Mechelsesteenweg 365,2020-01-11,05:00:00,0,0,0,FMN GV 05 Lier
60,Mechelsesteenweg 365,2020-01-11,06:00:00,4,0,4,FMN GV 05 Lier
60,Mechelsesteenweg 365,2020-01-11,07:00:00,4,2,2,FMN GV 05 Lier
60,Mechelsesteenweg 365,2020-01-11,08:00:00,12,4,8,FMN GV 05 Lier
60,Mechelsesteenweg 365,2020-01-11,09:00:00,68,42,26,FMN GV 05 Lier
60,Mechelsesteenweg 365,2020-01-11,10:00:00,98,70,28,FMN GV 05 Lier
60,Mechelsesteenweg 365,2020-01-11,11:00:00,186,98,88,FMN GV 05 Lier
60,Mechelsesteenweg 365,2020-01-11,12:00:00,126,62,64,FMN GV 05 Lier
60,Mechelsesteenweg 365,2020-01-11,13:00:00,156,102,54,FMN GV 05 Lier
60,Mechelsesteenweg 365,2020-01-11,14:00:00,134,78,56,FMN GV 05 Lier
60,Mechelsesteenweg 365,2020-01-11,15:00:00,120,80,40,FMN GV 05 Lier
60,Mechelsesteenweg 365,2020-01-11,16:00:00,82,36,46,FMN GV 05 Lier
60,Mechelsesteenweg 365,2020-01-11,17:00:00,30,10,20,FMN GV 05 Lier
60,Mechelsesteenweg 365,2020-01-11,18:00:00,4,0,4,FMN GV 05 Lier
60,Mechelsesteenweg 365,2020-01-11,19:00:00,6,4,2,FMN GV 05 Lier
60,Mechelsesteenweg 365,2020-01-11,20:00:00,6,4,2,FMN GV 05 Lier
60,Mechelsesteenweg 365,2020-01-11,21:00:00,8,4,4,FMN GV 05 Lier
60,Mechelsesteenweg 365,2020-01-11,22:00:00,2,2,0,FMN GV 05 Lier
60,Mechelsesteenweg 365,2020-01-11,23:00:00,0,0,0,FMN GV 05 Lier
60,Mechelsesteenweg 365,2020-01-12,00:00:00,0,0,0,FMN GV 05 Lier
60,Mechelsesteenweg 365,2020-01-12,01:00:00,6,2,4,FMN GV 05 Lier
60,Mechelsesteenweg 365,2020-01-12,02:00:00,0,0,0,FMN GV 05 Lier
60,Mechelsesteenweg 365,2020-01-12,03:00:00,0,0,0,FMN GV 05 Lier
60,Mechelsesteenweg 365,2020-01-12,04:00:00,0,0,0,FMN GV 05 Lier
60,Mechelsesteenweg 365,2020-01-12,05:00:00,0,0,0,FMN GV 05 Lier
60,Mechelsesteenweg 365,2020-01-12,06:00:00,0,0,0,FMN GV 05 Lier
60,Mechelsesteenweg 365,2020-01-12,07:00:00,0,0,0,FMN GV 05 Lier
60,Mechelsesteenweg 365,2020-01-12,08:00:00,18,10,8,FMN GV 05 Lier
60,Mechelsesteenweg 365,2020-01-12,09:00:00,66,30,36,FMN GV 05 Lier
60,Mechelsesteenweg 365,2020-01-12,10:00:00,174,88,86,FMN GV 05 Lier
60,Mechelsesteenweg 365,2020-01-12,11:00:00,112,72,40,FMN GV 05 Lier
60,Mechelsesteenweg 365,2020-01-12,12:00:00,52,30,22,FMN GV 05 Lier
60,Mechelsesteenweg 365,2020-01-12,13:00:00,30,16,14,FMN GV 05 Lier
60,Mechelsesteenweg 365,2020-01-12,14:00:00,52,24,28,FMN GV 05 Lier
60,Mechelsesteenweg 365,2020-01-12,15:00:00,30,16,14,FMN GV 05 Lier
60,Mechelsesteenweg 365,2020-01-12,16:00:00,42,18,24,FMN GV 05 Lier
60,Mechelsesteenweg 365,2020-01-12,17:00:00,26,6,20,FMN GV 05 Lier
60,Mechelsesteenweg 365,2020-01-12,18:00:00,8,4,4,FMN GV 05 Lier
60,Mechelsesteenweg 365,2020-01-12,19:00:00,10,2,8,FMN GV 05 Lier
60,Mechelsesteenweg 365,2020-01-12,20:00:00,2,2,0,FMN GV 05 Lier
60,Mechelsesteenweg 365,2020-01-12,21:00:00,6,2,4,FMN GV 05 Lier
60,Mechelsesteenweg 365,2020-01-12,22:00:00,6,2,4,FMN GV 05 Lier
60,Mechelsesteenweg 365,2020-01-12,23:00:00,0,0,0,FMN GV 05 Lier
60,Mechelsesteenweg 365,2020-01-13,00:00:00,0,0,0,FMN GV 05 Lier
60,Mechelsesteenweg 365,2020-01-13,01:00:00,0,0,0,FMN GV 05 Lier
60,Mechelsesteenweg 365,2020-01-13,02:00:00,0,0,0,FMN GV 05 Lier
60,Mechelsesteenweg 365,2020-01-13,03:00:00,4,4,0,FMN GV 05 Lier
60,Mechelsesteenweg 365,2020-01-13,04:00:00,2,0,2,FMN GV 05 Lier
60,Mechelsesteenweg 365,2020-01-13,05:00:00,6,0,6,FMN GV 05 Lier
60,Mechelsesteenweg 365,2020-01-13,06:00:00,26,4,22,FMN GV 05 Lier
60,Mechelsesteenweg 365,2020-01-13,07:00:00,152,76,76,FMN GV 05 Lier
60,Mechelsesteenweg 365,2020-01-13,08:00:00,128,74,54,FMN GV 05 Lier
60,Mechelsesteenweg 365,2020-01-13,09:00:00,64,32,32,FMN GV 05 Lier
60,Mechelsesteenweg 365,2020-01-13,10:00:00,48,30,18,FMN GV 05 Lier
60,Mechelsesteenweg 365,2020-01-13,11:00:00,68,40,28,FMN GV 05 Lier
60,Mechelsesteenweg 365,2020-01-13,12:00:00,74,36,38,FMN GV 05 Lier
60,Mechelsesteenweg 365,2020-01-13,13:00:00,66,30,36,FMN GV 05 Lier
60,Mechelsesteenweg 365,2020-01-13,14:00:00,100,66,34,FMN GV 05 Lier
60,Mechelsesteenweg 365,2020-01-13,15:00:00,82,38,44,FMN GV 05 Lier
60,Mechelsesteenweg 365,2020-01-13,16:00:00,226,72,154,FMN GV 05 Lier
60,Mechelsesteenweg 365,2020-01-13,17:00:00,106,82,24,FMN GV 05 Lier
60,Mechelsesteenweg 365,2020-01-13,18:00:00,30,18,12,FMN GV 05 Lier
60,Mechelsesteenweg 365,2020-01-13,19:00:00,8,4,4,FMN GV 05 Lier
60,Mechelsesteenweg 365,2020-01-13,20:00:00,0,0,0,FMN GV 05 Lier
60,Mechelsesteenweg 365,2020-01-13,21:00:00,4,0,4,FMN GV 05 Lier
60,Mechelsesteenweg 365,2020-01-13,22:00:00,6,2,4,FMN GV 05 Lier
60,Mechelsesteenweg 365,2020-01-13,23:00:00,0,0,0,FMN GV 05 Lier
60,Mechelsesteenweg 365,2020-01-14,00:00:00,0,0,0,FMN GV 05 Lier
60,Mechelsesteenweg 365,2020-01-14,01:00:00,0,0,0,FMN GV 05 Lier
60,Mechelsesteenweg 365,2020-01-14,02:00:00,0,0,0,FMN GV 05 Lier
60,Mechelsesteenweg 365,2020-01-14,03:00:00,0,0,0,FMN GV 05 Lier
60,Mechelsesteenweg 365,2020-01-14,04:00:00,0,0,0,FMN GV 05 Lier
60,Mechelsesteenweg 365,2020-01-14,05:00:00,2,0,2,FMN GV 05 Lier
60,Mechelsesteenweg 365,2020-01-14,06:00:00,20,2,18,FMN GV 05 Lier
60,Mechelsesteenweg 365,2020-01-14,07:00:00,116,72,44,FMN GV 05 Lier
60,Mechelsesteenweg 365,2020-01-14,08:00:00,96,62,34,FMN GV 05 Lier
60,Mechelsesteenweg 365,2020-01-14,09:00:00,46,32,14,FMN GV 05 Lier
60,Mechelsesteenweg 365,2020-01-14,10:00:00,26,12,14,FMN GV 05 Lier
60,Mechelsesteenweg 365,2020-01-14,11:00:00,30,14,16,FMN GV 05 Lier
60,Mechelsesteenweg 365,2020-01-14,12:00:00,24,8,16,FMN GV 05 Lier
60,Mechelsesteenweg 365,2020-01-14,13:00:00,38,18,20,FMN GV 05 Lier
60,Mechelsesteenweg 365,2020-01-14,14:00:00,50,30,20,FMN GV 05 Lier
60,Mechelsesteenweg 365,2020-01-14,15:00:00,52,24,28,FMN GV 05 Lier
60,Mechelsesteenweg 365,2020-01-14,16:00:00,138,44,94,FMN GV 05 Lier
60,Mechelsesteenweg 365,2020-01-14,17:00:00,88,50,38,FMN GV 05 Lier
60,Mechelsesteenweg 365,2020-01-14,18:00:00,32,26,6,FMN GV 05 Lier
60,Mechelsesteenweg 365,2020-01-14,19:00:00,14,10,4,FMN GV 05 Lier
60,Mechelsesteenweg 365,2020-01-14,20:00:00,2,2,0,FMN GV 05 Lier
60,Mechelsesteenweg 365,2020-01-14,21:00:00,2,0,2,FMN GV 05 Lier
60,Mechelsesteenweg 365,2020-01-14,22:00:00,2,0,2,FMN GV 05 Lier
60,Mechelsesteenweg 365,2020-01-14,23:00:00,0,0,0,FMN GV 05 Lier
60,Mechelsesteenweg 365,2020-01-15,00:00:00,0,0,0,FMN GV 05 Lier
60,Mechelsesteenweg 365,2020-01-15,01:00:00,0,0,0,FMN GV 05 Lier
60,Mechelsesteenweg 365,2020-01-15,02:00:00,0,0,0,FMN GV 05 Lier
60,Mechelsesteenweg 365,2020-01-15,03:00:00,0,0,0,FMN GV 05 Lier
60,Mechelsesteenweg 365,2020-01-15,04:00:00,0,0,0,FMN GV 05 Lier
60,Mechelsesteenweg 365,2020-01-15,05:00:00,2,0,2,FMN GV 05 Lier
60,Mechelsesteenweg 365,2020-01-15,06:00:00,10,0,10,FMN GV 05 Lier
60,Mechelsesteenweg 365,2020-01-15,07:00:00,108,62,46,FMN GV 05 Lier
60,Mechelsesteenweg 365,2020-01-15,08:00:00,112,80,32,FMN GV 05 Lier
60,Mechelsesteenweg 365,2020-01-15,09:00:00,30,20,10,FMN GV 05 Lier
60,Mechelsesteenweg 365,2020-01-15,10:00:00,30,18,12,FMN GV 05 Lier
60,Mechelsesteenweg 365,2020-01-15,11:00:00,38,16,22,FMN GV 05 Lier
60,Mechelsesteenweg 365,2020-01-15,12:00:00,128,34,94,FMN GV 05 Lier
60,Mechelsesteenweg 365,2020-01-15,13:00:00,58,26,32,FMN GV 05 Lier
60,Mechelsesteenweg 365,2020-01-15,14:00:00,30,26,4,FMN GV 05 Lier
60,Mechelsesteenweg 365,2020-01-15,15:00:00,30,12,18,FMN GV 05 Lier
60,Mechelsesteenweg 365,2020-01-15,16:00:00,46,20,26,FMN GV 05 Lier
60,Mechelsesteenweg 365,2020-01-15,17:00:00,50,42,8,FMN GV 05 Lier
60,Mechelsesteenweg 365,2020-01-15,18:00:00,20,14,6,FMN GV 05 Lier
60,Mechelsesteenweg 365,2020-01-15,19:00:00,4,2,2,FMN GV 05 Lier
60,Mechelsesteenweg 365,2020-01-15,20:00:00,8,6,2,FMN GV 05 Lier
60,Mechelsesteenweg 365,2020-01-15,21:00:00,4,0,4,FMN GV 05 Lier
60,Mechelsesteenweg 365,2020-01-15,22:00:00,2,0,2,FMN GV 05 Lier
60,Mechelsesteenweg 365,2020-01-15,23:00:00,0,0,0,FMN GV 05 Lier
60,Mechelsesteenweg 365,2020-01-16,00:00:00,0,0,0,FMN GV 05 Lier
60,Mechelsesteenweg 365,2020-01-16,01:00:00,0,0,0,FMN GV 05 Lier
60,Mechelsesteenweg 365,2020-01-16,02:00:00,0,0,0,FMN GV 05 Lier
60,Mechelsesteenweg 365,2020-01-16,03:00:00,0,0,0,FMN GV 05 Lier
60,Mechelsesteenweg 365,2020-01-16,04:00:00,0,0,0,FMN GV 05 Lier
60,Mechelsesteenweg 365,2020-01-16,05:00:00,6,0,6,FMN GV 05 Lier
60,Mechelsesteenweg 365,2020-01-16,06:00:00,24,0,24,FMN GV 05 Lier
60,Mechelsesteenweg 365,2020-01-16,07:00:00,142,66,76,FMN GV 05 Lier
60,Mechelsesteenweg 365,2020-01-16,08:00:00,150,110,40,FMN GV 05 Lier
60,Mechelsesteenweg 365,2020-01-16,09:00:00,48,30,18,FMN GV 05 Lier
60,Mechelsesteenweg 365,2020-01-16,10:00:00,60,36,24,FMN GV 05 Lier
60,Mechelsesteenweg 365,2020-01-16,11:00:00,108,48,60,FMN GV 05 Lier
60,Mechelsesteenweg 365,2020-01-16,12:00:00,76,38,38,FMN GV 05 Lier
60,Mechelsesteenweg 365,2020-01-16,13:00:00,172,98,74,FMN GV 05 Lier
60,Mechelsesteenweg 365,2020-01-16,14:00:00,206,106,100,FMN GV 05 Lier
60,Mechelsesteenweg 365,2020-01-16,15:00:00,224,82,142,FMN GV 05 Lier
60,Mechelsesteenweg 365,2020-01-16,16:00:00,224,94,130,FMN GV 05 Lier
60,Mechelsesteenweg 365,2020-01-16,17:00:00,108,62,46,FMN GV 05 Lier
60,Mechelsesteenweg 365,2020-01-16,18:00:00,36,26,10,FMN GV 05 Lier
60,Mechelsesteenweg 365,2020-01-16,19:00:00,32,18,14,FMN GV 05 Lier
60,Mechelsesteenweg 365,2020-01-16,20:00:00,4,2,2,FMN GV 05 Lier
60,Mechelsesteenweg 365,2020-01-16,21:00:00,8,4,4,FMN GV 05 Lier
60,Mechelsesteenweg 365,2020-01-16,22:00:00,10,6,4,FMN GV 05 Lier
60,Mechelsesteenweg 365,2020-01-16,23:00:00,0,0,0,FMN GV 05 Lier
60,Mechelsesteenweg 365,2020-01-17,00:00:00,0,0,0,FMN GV 05 Lier
60,Mechelsesteenweg 365,2020-01-17,01:00:00,0,0,0,FMN GV 05 Lier
60,Mechelsesteenweg 365,2020-01-17,02:00:00,0,0,0,FMN GV 05 Lier
60,Mechelsesteenweg 365,2020-01-17,03:00:00,0,0,0,FMN GV 05 Lier
60,Mechelsesteenweg 365,2020-01-17,04:00:00,0,0,0,FMN GV 05 Lier
60,Mechelsesteenweg 365,2020-01-17,05:00:00,10,0,10,FMN GV 05 Lier
60,Mechelsesteenweg 365,2020-01-17,06:00:00,8,0,8,FMN GV 05 Lier
60,Mechelsesteenweg 365,2020-01-17,07:00:00,150,100,50,FMN GV 05 Lier
60,Mechelsesteenweg 365,2020-01-17,08:00:00,104,60,44,FMN GV 05 Lier
60,Mechelsesteenweg 365,2020-01-17,09:00:00,32,20,12,FMN GV 05 Lier
60,Mechelsesteenweg 365,2020-01-17,10:00:00,12,6,6,FMN GV 05 Lier
60,Mechelsesteenweg 365,2020-01-17,11:00:00,22,4,18,FMN GV 05 Lier
60,Mechelsesteenweg 365,2020-01-17,12:00:00,30,14,16,FMN GV 05 Lier
60,Mechelsesteenweg 365,2020-01-17,13:00:00,52,34,18,FMN GV 05 Lier
60,Mechelsesteenweg 365,2020-01-17,14:00:00,38,22,16,FMN GV 05 Lier
60,Mechelsesteenweg 365,2020-01-17,15:00:00,84,44,40,FMN GV 05 Lier
60,Mechelsesteenweg 365,2020-01-17,16:00:00,172,54,118,FMN GV 05 Lier
60,Mechelsesteenweg 365,2020-01-17,17:00:00,60,42,18,FMN GV 05 Lier
60,Mechelsesteenweg 365,2020-01-17,18:00:00,24,16,8,FMN GV 05 Lier
60,Mechelsesteenweg 365,2020-01-17,19:00:00,18,14,4,FMN GV 05 Lier
60,Mechelsesteenweg 365,2020-01-17,20:00:00,14,6,8,FMN GV 05 Lier
60,Mechelsesteenweg 365,2020-01-17,21:00:00,8,2,6,FMN GV 05 Lier
60,Mechelsesteenweg 365,2020-01-17,22:00:00,4,2,2,FMN GV 05 Lier
60,Mechelsesteenweg 365,2020-01-17,23:00:00,4,0,4,FMN GV 05 Lier
60,Mechelsesteenweg 365,2020-01-18,00:00:00,0,0,0,FMN GV 05 Lier
60,Mechelsesteenweg 365,2020-01-18,01:00:00,0,0,0,FMN GV 05 Lier
60,Mechelsesteenweg 365,2020-01-18,02:00:00,0,0,0,FMN GV 05 Lier
60,Mechelsesteenweg 365,2020-01-18,03:00:00,0,0,0,FMN GV 05 Lier
60,Mechelsesteenweg 365,2020-01-18,04:00:00,0,0,0,FMN GV 05 Lier
60,Mechelsesteenweg 365,2020-01-18,05:00:00,0,0,0,FMN GV 05 Lier
60,Mechelsesteenweg 365,2020-01-18,06:00:00,2,0,2,FMN GV 05 Lier
60,Mechelsesteenweg 365,2020-01-18,07:00:00,6,4,2,FMN GV 05 Lier
60,Mechelsesteenweg 365,2020-01-18,08:00:00,10,4,6,FMN GV 05 Lier
60,Mechelsesteenweg 365,2020-01-18,09:00:00,80,54,26,FMN GV 05 Lier
60,Mechelsesteenweg 365,2020-01-18,10:00:00,132,66,66,FMN GV 05 Lier
60,Mechelsesteenweg 365,2020-01-18,11:00:00,124,54,70,FMN GV 05 Lier
60,Mechelsesteenweg 365,2020-01-18,12:00:00,146,64,82,FMN GV 05 Lier
60,Mechelsesteenweg 365,2020-01-18,13:00:00,172,96,76,FMN GV 05 Lier
60,Mechelsesteenweg 365,2020-01-18,14:00:00,240,136,104,FMN GV 05 Lier
60,Mechelsesteenweg 365,2020-01-18,15:00:00,146,76,70,FMN GV 05 Lier
60,Mechelsesteenweg 365,2020-01-18,16:00:00,70,24,46,FMN GV 05 Lier
60,Mechelsesteenweg 365,2020-01-18,17:00:00,40,26,14,FMN GV 05 Lier
60,Mechelsesteenweg 365,2020-01-18,18:00:00,24,14,10,FMN GV 05 Lier
60,Mechelsesteenweg 365,2020-01-18,19:00:00,4,2,2,FMN GV 05 Lier
60,Mechelsesteenweg 365,2020-01-18,20:00:00,0,0,0,FMN GV 05 Lier
60,Mechelsesteenweg 365,2020-01-18,21:00:00,4,4,0,FMN GV 05 Lier
60,Mechelsesteenweg 365,2020-01-18,22:00:00,6,2,4,FMN GV 05 Lier
60,Mechelsesteenweg 365,2020-01-18,23:00:00,0,0,0,FMN GV 05 Lier
60,Mechelsesteenweg 365,2020-01-19,00:00:00,0,0,0,FMN GV 05 Lier
60,Mechelsesteenweg 365,2020-01-19,01:00:00,0,0,0,FMN GV 05 Lier
60,Mechelsesteenweg 365,2020-01-19,02:00:00,0,0,0,FMN GV 05 Lier
60,Mechelsesteenweg 365,2020-01-19,03:00:00,0,0,0,FMN GV 05 Lier
60,Mechelsesteenweg 365,2020-01-19,04:00:00,0,0,0,FMN GV 05 Lier
60,Mechelsesteenweg 365,2020-01-19,05:00:00,0,0,0,FMN GV 05 Lier
60,Mechelsesteenweg 365,2020-01-19,06:00:00,0,0,0,FMN GV 05 Lier
60,Mechelsesteenweg 365,2020-01-19,07:00:00,4,2,2,FMN GV 05 Lier
60,Mechelsesteenweg 365,2020-01-19,08:00:00,20,14,6,FMN GV 05 Lier
60,Mechelsesteenweg 365,2020-01-19,09:00:00,42,26,16,FMN GV 05 Lier
60,Mechelsesteenweg 365,2020-01-19,10:00:00,184,130,54,FMN GV 05 Lier
60,Mechelsesteenweg 365,2020-01-19,11:00:00,212,108,104,FMN GV 05 Lier
60,Mechelsesteenweg 365,2020-01-19,12:00:00,204,116,88,FMN GV 05 Lier
60,Mechelsesteenweg 365,2020-01-19,13:00:00,194,100,94,FMN GV 05 Lier
60,Mechelsesteenweg 365,2020-01-19,14:00:00,232,130,102,FMN GV 05 Lier
60,Mechelsesteenweg 365,2020-01-19,15:00:00,174,84,90,FMN GV 05 Lier
60,Mechelsesteenweg 365,2020-01-19,16:00:00,114,38,76,FMN GV 05 Lier
60,Mechelsesteenweg 365,2020-01-19,17:00:00,36,6,30,FMN GV 05 Lier
60,Mechelsesteenweg 365,2020-01-19,18:00:00,4,2,2,FMN GV 05 Lier
60,Mechelsesteenweg 365,2020-01-19,19:00:00,6,6,0,FMN GV 05 Lier
60,Mechelsesteenweg 365,2020-01-19,20:00:00,0,0,0,FMN GV 05 Lier
60,Mechelsesteenweg 365,2020-01-19,21:00:00,2,2,0,FMN GV 05 Lier
60,Mechelsesteenweg 365,2020-01-19,22:00:00,2,2,0,FMN GV 05 Lier
60,Mechelsesteenweg 365,2020-01-19,23:00:00,6,0,6,FMN GV 05 Lier
60,Mechelsesteenweg 365,2020-01-20,00:00:00,0,0,0,FMN GV 05 Lier
60,Mechelsesteenweg 365,2020-01-20,01:00:00,0,0,0,FMN GV 05 Lier
60,Mechelsesteenweg 365,2020-01-20,02:00:00,0,0,0,FMN GV 05 Lier
60,Mechelsesteenweg 365,2020-01-20,03:00:00,0,0,0,FMN GV 05 Lier
60,Mechelsesteenweg 365,2020-01-20,04:00:00,0,0,0,FMN GV 05 Lier
60,Mechelsesteenweg 365,2020-01-20,05:00:00,4,0,4,FMN GV 05 Lier
60,Mechelsesteenweg 365,2020-01-20,06:00:00,22,4,18,FMN GV 05 Lier
60,Mechelsesteenweg 365,2020-01-20,07:00:00,126,70,56,FMN GV 05 Lier
60,Mechelsesteenweg 365,2020-01-20,08:00:00,120,78,42,FMN GV 05 Lier
60,Mechelsesteenweg 365,2020-01-20,09:00:00,56,36,20,FMN GV 05 Lier
60,Mechelsesteenweg 365,2020-01-20,10:00:00,20,12,8,FMN GV 05 Lier
60,Mechelsesteenweg 365,2020-01-20,11:00:00,40,20,20,FMN GV 05 Lier
60,Mechelsesteenweg 365,2020-01-20,12:00:00,48,24,24,FMN GV 05 Lier
60,Mechelsesteenweg 365,2020-01-20,13:00:00,68,40,28,FMN GV 05 Lier
60,Mechelsesteenweg 365,2020-01-20,14:00:00,58,26,32,FMN GV 05 Lier
60,Mechelsesteenweg 365,2020-01-20,15:00:00,90,34,56,FMN GV 05 Lier
60,Mechelsesteenweg 365,2020-01-20,16:00:00,188,52,136,FMN GV 05 Lier
60,Mechelsesteenweg 365,2020-01-20,17:00:00,100,74,26,FMN GV 05 Lier
60,Mechelsesteenweg 365,2020-01-20,18:00:00,30,16,14,FMN GV 05 Lier
60,Mechelsesteenweg 365,2020-01-20,19:00:00,14,10,4,FMN GV 05 Lier
60,Mechelsesteenweg 365,2020-01-20,20:00:00,4,0,4,FMN GV 05 Lier
60,Mechelsesteenweg 365,2020-01-20,21:00:00,4,2,2,FMN GV 05 Lier
60,Mechelsesteenweg 365,2020-01-20,22:00:00,6,4,2,FMN GV 05 Lier
60,Mechelsesteenweg 365,2020-01-20,23:00:00,0,0,0,FMN GV 05 Lier
60,Mechelsesteenweg 365,2020-01-21,00:00:00,0,0,0,FMN GV 05 Lier
60,Mechelsesteenweg 365,2020-01-21,01:00:00,0,0,0,FMN GV 05 Lier
60,Mechelsesteenweg 365,2020-01-21,02:00:00,0,0,0,FMN GV 05 Lier
60,Mechelsesteenweg 365,2020-01-21,03:00:00,0,0,0,FMN GV 05 Lier
60,Mechelsesteenweg 365,2020-01-21,04:00:00,0,0,0,FMN GV 05 Lier
60,Mechelsesteenweg 365,2020-01-21,05:00:00,6,0,6,FMN GV 05 Lier
60,Mechelsesteenweg 365,2020-01-21,06:00:00,24,2,22,FMN GV 05 Lier
60,Mechelsesteenweg 365,2020-01-21,07:00:00,140,86,54,FMN GV 05 Lier
60,Mechelsesteenweg 365,2020-01-21,08:00:00,108,78,30,FMN GV 05 Lier
60,Mechelsesteenweg 365,2020-01-21,09:00:00,34,14,20,FMN GV 05 Lier
60,Mechelsesteenweg 365,2020-01-21,10:00:00,24,12,12,FMN GV 05 Lier
60,Mechelsesteenweg 365,2020-01-21,11:00:00,32,18,14,FMN GV 05 Lier
60,Mechelsesteenweg 365,2020-01-21,12:00:00,36,6,30,FMN GV 05 Lier
60,Mechelsesteenweg 365,2020-01-21,13:00:00,52,18,34,FMN GV 05 Lier
60,Mechelsesteenweg 365,2020-01-21,14:00:00,68,42,26,FMN GV 05 Lier
60,Mechelsesteenweg 365,2020-01-21,15:00:00,94,48,46,FMN GV 05 Lier
60,Mechelsesteenweg 365,2020-01-21,16:00:00,198,56,142,FMN GV 05 Lier
60,Mechelsesteenweg 365,2020-01-21,17:00:00,78,54,24,FMN GV 05 Lier
60,Mechelsesteenweg 365,2020-01-21,18:00:00,32,18,14,FMN GV 05 Lier
60,Mechelsesteenweg 365,2020-01-21,19:00:00,10,4,6,FMN GV 05 Lier
60,Mechelsesteenweg 365,2020-01-21,20:00:00,4,2,2,FMN GV 05 Lier
60,Mechelsesteenweg 365,2020-01-21,21:00:00,0,0,0,FMN GV 05 Lier
60,Mechelsesteenweg 365,2020-01-21,22:00:00,4,2,2,FMN GV 05 Lier
60,Mechelsesteenweg 365,2020-01-21,23:00:00,0,0,0,FMN GV 05 Lier
60,Mechelsesteenweg 365,2020-01-22,00:00:00,0,0,0,FMN GV 05 Lier
60,Mechelsesteenweg 365,2020-01-22,01:00:00,0,0,0,FMN GV 05 Lier
60,Mechelsesteenweg 365,2020-01-22,02:00:00,0,0,0,FMN GV 05 Lier
60,Mechelsesteenweg 365,2020-01-22,03:00:00,0,0,0,FMN GV 05 Lier
60,Mechelsesteenweg 365,2020-01-22,04:00:00,2,0,2,FMN GV 05 Lier
60,Mechelsesteenweg 365,2020-01-22,05:00:00,4,0,4,FMN GV 05 Lier
60,Mechelsesteenweg 365,2020-01-22,06:00:00,16,0,16,FMN GV 05 Lier
60,Mechelsesteenweg 365,2020-01-22,07:00:00,104,56,48,FMN GV 05 Lier
60,Mechelsesteenweg 365,2020-01-22,08:00:00,94,64,30,FMN GV 05 Lier
60,Mechelsesteenweg 365,2020-01-22,09:00:00,24,10,14,FMN GV 05 Lier
60,Mechelsesteenweg 365,2020-01-22,10:00:00,28,14,14,FMN GV 05 Lier
60,Mechelsesteenweg 365,2020-01-22,11:00:00,34,6,28,FMN GV 05 Lier
60,Mechelsesteenweg 365,2020-01-22,12:00:00,132,28,104,FMN GV 05 Lier
60,Mechelsesteenweg 365,2020-01-22,13:00:00,54,14,40,FMN GV 05 Lier
60,Mechelsesteenweg 365,2020-01-22,14:00:00,74,46,28,FMN GV 05 Lier
60,Mechelsesteenweg 365,2020-01-22,15:00:00,56,36,20,FMN GV 05 Lier
60,Mechelsesteenweg 365,2020-01-22,16:00:00,76,42,34,FMN GV 05 Lier
60,Mechelsesteenweg 365,2020-01-22,17:00:00,52,42,10,FMN GV 05 Lier
60,Mechelsesteenweg 365,2020-01-22,18:00:00,16,8,8,FMN GV 05 Lier
60,Mechelsesteenweg 365,2020-01-22,19:00:00,12,4,8,FMN GV 05 Lier
60,Mechelsesteenweg 365,2020-01-22,20:00:00,4,2,2,FMN GV 05 Lier
60,Mechelsesteenweg 365,2020-01-22,21:00:00,0,0,0,FMN GV 05 Lier
60,Mechelsesteenweg 365,2020-01-22,22:00:00,4,4,0,FMN GV 05 Lier
60,Mechelsesteenweg 365,2020-01-22,23:00:00,0,0,0,FMN GV 05 Lier
60,Mechelsesteenweg 365,2020-01-23,00:00:00,0,0,0,FMN GV 05 Lier
60,Mechelsesteenweg 365,2020-01-23,01:00:00,0,0,0,FMN GV 05 Lier
60,Mechelsesteenweg 365,2020-01-23,02:00:00,0,0,0,FMN GV 05 Lier
60,Mechelsesteenweg 365,2020-01-23,03:00:00,0,0,0,FMN GV 05 Lier
60,Mechelsesteenweg 365,2020-01-23,04:00:00,2,0,2,FMN GV 05 Lier
60,Mechelsesteenweg 365,2020-01-23,05:00:00,6,0,6,FMN GV 05 Lier
60,Mechelsesteenweg 365,2020-01-23,06:00:00,18,0,18,FMN GV 05 Lier
60,Mechelsesteenweg 365,2020-01-23,07:00:00,138,80,58,FMN GV 05 Lier
60,Mechelsesteenweg 365,2020-01-23,08:00:00,116,80,36,FMN GV 05 Lier
60,Mechelsesteenweg 365,2020-01-23,09:00:00,32,22,10,FMN GV 05 Lier
60,Mechelsesteenweg 365,2020-01-23,10:00:00,54,36,18,FMN GV 05 Lier
60,Mechelsesteenweg 365,2020-01-23,11:00:00,68,28,40,FMN GV 05 Lier
60,Mechelsesteenweg 365,2020-01-23,12:00:00,72,32,40,FMN GV 05 Lier
60,Mechelsesteenweg 365,2020-01-23,13:00:00,84,36,48,FMN GV 05 Lier
60,Mechelsesteenweg 365,2020-01-23,14:00:00,140,36,104,FMN GV 05 Lier
60,Mechelsesteenweg 365,2020-01-23,15:00:00,88,42,46,FMN GV 05 Lier
60,Mechelsesteenweg 365,2020-01-23,16:00:00,198,66,132,FMN GV 05 Lier
60,Mechelsesteenweg 365,2020-01-23,17:00:00,94,64,30,FMN GV 05 Lier
60,Mechelsesteenweg 365,2020-01-23,18:00:00,32,18,14,FMN GV 05 Lier
60,Mechelsesteenweg 365,2020-01-23,19:00:00,10,8,2,FMN GV 05 Lier
60,Mechelsesteenweg 365,2020-01-23,20:00:00,12,10,2,FMN GV 05 Lier
60,Mechelsesteenweg 365,2020-01-23,21:00:00,4,0,4,FMN GV 05 Lier
60,Mechelsesteenweg 365,2020-01-23,22:00:00,12,4,8,FMN GV 05 Lier
60,Mechelsesteenweg 365,2020-01-23,23:00:00,2,2,0,FMN GV 05 Lier
60,Mechelsesteenweg 365,2020-01-24,00:00:00,0,0,0,FMN GV 05 Lier
60,Mechelsesteenweg 365,2020-01-24,01:00:00,0,0,0,FMN GV 05 Lier
60,Mechelsesteenweg 365,2020-01-24,02:00:00,0,0,0,FMN GV 05 Lier
60,Mechelsesteenweg 365,2020-01-24,03:00:00,0,0,0,FMN GV 05 Lier
60,Mechelsesteenweg 365,2020-01-24,04:00:00,0,0,0,FMN GV 05 Lier
60,Mechelsesteenweg 365,2020-01-24,05:00:00,4,0,4,FMN GV 05 Lier
60,Mechelsesteenweg 365,2020-01-24,06:00:00,10,0,10,FMN GV 05 Lier
60,Mechelsesteenweg 365,2020-01-24,07:00:00,98,56,42,FMN GV 05 Lier
60,Mechelsesteenweg 365,2020-01-24,08:00:00,132,84,48,FMN GV 05 Lier
60,Mechelsesteenweg 365,2020-01-24,09:00:00,34,26,8,FMN GV 05 Lier
60,Mechelsesteenweg 365,2020-01-24,10:00:00,28,8,20,FMN GV 05 Lier
60,Mechelsesteenweg 365,2020-01-24,11:00:00,34,14,20,FMN GV 05 Lier
60,Mechelsesteenweg 365,2020-01-24,12:00:00,34,20,14,FMN GV 05 Lier
60,Mechelsesteenweg 365,2020-01-24,13:00:00,132,34,98,FMN GV 05 Lier
60,Mechelsesteenweg 365,2020-01-24,14:00:00,162,130,32,FMN GV 05 Lier
60,Mechelsesteenweg 365,2020-01-24,15:00:00,100,48,52,FMN GV 05 Lier
60,Mechelsesteenweg 365,2020-01-24,16:00:00,126,34,92,FMN GV 05 Lier
60,Mechelsesteenweg 365,2020-01-24,17:00:00,68,42,26,FMN GV 05 Lier
60,Mechelsesteenweg 365,2020-01-24,18:00:00,10,4,6,FMN GV 05 Lier
60,Mechelsesteenweg 365,2020-01-24,19:00:00,8,4,4,FMN GV 05 Lier
60,Mechelsesteenweg 365,2020-01-24,20:00:00,12,10,2,FMN GV 05 Lier
60,Mechelsesteenweg 365,2020-01-24,21:00:00,4,4,0,FMN GV 05 Lier
60,Mechelsesteenweg 365,2020-01-24,22:00:00,6,0,6,FMN GV 05 Lier
60,Mechelsesteenweg 365,2020-01-24,23:00:00,4,4,0,FMN GV 05 Lier
60,Mechelsesteenweg 365,2020-01-25,00:00:00,2,0,2,FMN GV 05 Lier
60,Mechelsesteenweg 365,2020-01-25,01:00:00,0,0,0,FMN GV 05 Lier
60,Mechelsesteenweg 365,2020-01-25,02:00:00,0,0,0,FMN GV 05 Lier
60,Mechelsesteenweg 365,2020-01-25,03:00:00,0,0,0,FMN GV 05 Lier
60,Mechelsesteenweg 365,2020-01-25,04:00:00,0,0,0,FMN GV 05 Lier
60,Mechelsesteenweg 365,2020-01-25,05:00:00,2,0,2,FMN GV 05 Lier
60,Mechelsesteenweg 365,2020-01-25,06:00:00,2,0,2,FMN GV 05 Lier
60,Mechelsesteenweg 365,2020-01-25,07:00:00,2,0,2,FMN GV 05 Lier
60,Mechelsesteenweg 365,2020-01-25,08:00:00,12,4,8,FMN GV 05 Lier
60,Mechelsesteenweg 365,2020-01-25,09:00:00,50,30,20,FMN GV 05 Lier
60,Mechelsesteenweg 365,2020-01-25,10:00:00,100,82,18,FMN GV 05 Lier
60,Mechelsesteenweg 365,2020-01-25,11:00:00,108,68,40,FMN GV 05 Lier
60,Mechelsesteenweg 365,2020-01-25,12:00:00,94,38,56,FMN GV 05 Lier
60,Mechelsesteenweg 365,2020-01-25,13:00:00,88,56,32,FMN GV 05 Lier
60,Mechelsesteenweg 365,2020-01-25,14:00:00,100,50,50,FMN GV 05 Lier
60,Mechelsesteenweg 365,2020-01-25,15:00:00,80,38,42,FMN GV 05 Lier
60,Mechelsesteenweg 365,2020-01-25,16:00:00,60,24,36,FMN GV 05 Lier
60,Mechelsesteenweg 365,2020-01-25,17:00:00,36,14,22,FMN GV 05 Lier
60,Mechelsesteenweg 365,2020-01-25,18:00:00,6,2,4,FMN GV 05 Lier
60,Mechelsesteenweg 365,2020-01-25,19:00:00,4,0,4,FMN GV 05 Lier
60,Mechelsesteenweg 365,2020-01-25,20:00:00,4,0,4,FMN GV 05 Lier
60,Mechelsesteenweg 365,2020-01-25,21:00:00,2,2,0,FMN GV 05 Lier
60,Mechelsesteenweg 365,2020-01-25,22:00:00,0,0,0,FMN GV 05 Lier
60,Mechelsesteenweg 365,2020-01-25,23:00:00,0,0,0,FMN GV 05 Lier
60,Mechelsesteenweg 365,2020-01-26,00:00:00,0,0,0,FMN GV 05 Lier
60,Mechelsesteenweg 365,2020-01-26,01:00:00,0,0,0,FMN GV 05 Lier
60,Mechelsesteenweg 365,2020-01-26,02:00:00,4,0,4,FMN GV 05 Lier
60,Mechelsesteenweg 365,2020-01-26,03:00:00,0,0,0,FMN GV 05 Lier
60,Mechelsesteenweg 365,2020-01-26,04:00:00,0,0,0,FMN GV 05 Lier
60,Mechelsesteenweg 365,2020-01-26,05:00:00,0,0,0,FMN GV 05 Lier
60,Mechelsesteenweg 365,2020-01-26,06:00:00,2,0,2,FMN GV 05 Lier
60,Mechelsesteenweg 365,2020-01-26,07:00:00,2,0,2,FMN GV 05 Lier
60,Mechelsesteenweg 365,2020-01-26,08:00:00,20,8,12,FMN GV 05 Lier
60,Mechelsesteenweg 365,2020-01-26,09:00:00,70,40,30,FMN GV 05 Lier
60,Mechelsesteenweg 365,2020-01-26,10:00:00,244,156,88,FMN GV 05 Lier
60,Mechelsesteenweg 365,2020-01-26,11:00:00,278,134,144,FMN GV 05 Lier
60,Mechelsesteenweg 365,2020-01-26,12:00:00,180,90,90,FMN GV 05 Lier
60,Mechelsesteenweg 365,2020-01-26,13:00:00,160,76,84,FMN GV 05 Lier
60,Mechelsesteenweg 365,2020-01-26,14:00:00,198,108,90,FMN GV 05 Lier
60,Mechelsesteenweg 365,2020-01-26,15:00:00,178,88,90,FMN GV 05 Lier
60,Mechelsesteenweg 365,2020-01-26,16:00:00,94,38,56,FMN GV 05 Lier
60,Mechelsesteenweg 365,2020-01-26,17:00:00,38,14,24,FMN GV 05 Lier
60,Mechelsesteenweg 365,2020-01-26,18:00:00,18,8,10,FMN GV 05 Lier
60,Mechelsesteenweg 365,2020-01-26,19:00:00,6,0,6,FMN GV 05 Lier
60,Mechelsesteenweg 365,2020-01-26,20:00:00,4,2,2,FMN GV 05 Lier
60,Mechelsesteenweg 365,2020-01-26,21:00:00,0,0,0,FMN GV 05 Lier
60,Mechelsesteenweg 365,2020-01-26,22:00:00,4,0,4,FMN GV 05 Lier
60,Mechelsesteenweg 365,2020-01-26,23:00:00,4,2,2,FMN GV 05 Lier
60,Mechelsesteenweg 365,2020-01-27,00:00:00,0,0,0,FMN GV 05 Lier
60,Mechelsesteenweg 365,2020-01-27,01:00:00,0,0,0,FMN GV 05 Lier
60,Mechelsesteenweg 365,2020-01-27,02:00:00,0,0,0,FMN GV 05 Lier
60,Mechelsesteenweg 365,2020-01-27,03:00:00,2,0,2,FMN GV 05 Lier
60,Mechelsesteenweg 365,2020-01-27,04:00:00,2,0,2,FMN GV 05 Lier
60,Mechelsesteenweg 365,2020-01-27,05:00:00,10,2,8,FMN GV 05 Lier
60,Mechelsesteenweg 365,2020-01-27,06:00:00,22,4,18,FMN GV 05 Lier
60,Mechelsesteenweg 365,2020-01-27,07:00:00,132,88,44,FMN GV 05 Lier
60,Mechelsesteenweg 365,2020-01-27,08:00:00,118,82,36,FMN GV 05 Lier
60,Mechelsesteenweg 365,2020-01-27,09:00:00,42,30,12,FMN GV 05 Lier
60,Mechelsesteenweg 365,2020-01-27,10:00:00,38,18,20,FMN GV 05 Lier
60,Mechelsesteenweg 365,2020-01-27,11:00:00,42,22,20,FMN GV 05 Lier
60,Mechelsesteenweg 365,2020-01-27,12:00:00,36,12,24,FMN GV 05 Lier
60,Mechelsesteenweg 365,2020-01-27,13:00:00,70,42,28,FMN GV 05 Lier
60,Mechelsesteenweg 365,2020-01-27,14:00:00,56,28,28,FMN GV 05 Lier
60,Mechelsesteenweg 365,2020-01-27,15:00:00,80,50,30,FMN GV 05 Lier
60,Mechelsesteenweg 365,2020-01-27,16:00:00,170,40,130,FMN GV 05 Lier
60,Mechelsesteenweg 365,2020-01-27,17:00:00,110,58,52,FMN GV 05 Lier
60,Mechelsesteenweg 365,2020-01-27,18:00:00,28,22,6,FMN GV 05 Lier
60,Mechelsesteenweg 365,2020-01-27,19:00:00,2,0,2,FMN GV 05 Lier
60,Mechelsesteenweg 365,2020-01-27,20:00:00,4,4,0,FMN GV 05 Lier
60,Mechelsesteenweg 365,2020-01-27,21:00:00,2,0,2,FMN GV 05 Lier
60,Mechelsesteenweg 365,2020-01-27,22:00:00,2,2,0,FMN GV 05 Lier
60,Mechelsesteenweg 365,2020-01-27,23:00:00,0,0,0,FMN GV 05 Lier
60,Mechelsesteenweg 365,2020-01-28,00:00:00,0,0,0,FMN GV 05 Lier
60,Mechelsesteenweg 365,2020-01-28,01:00:00,0,0,0,FMN GV 05 Lier
60,Mechelsesteenweg 365,2020-01-28,02:00:00,0,0,0,FMN GV 05 Lier
60,Mechelsesteenweg 365,2020-01-28,03:00:00,2,0,2,FMN GV 05 Lier
60,Mechelsesteenweg 365,2020-01-28,04:00:00,2,0,2,FMN GV 05 Lier
60,Mechelsesteenweg 365,2020-01-28,05:00:00,10,2,8,FMN GV 05 Lier
60,Mechelsesteenweg 365,2020-01-28,06:00:00,14,0,14,FMN GV 05 Lier
60,Mechelsesteenweg 365,2020-01-28,07:00:00,130,84,46,FMN GV 05 Lier
60,Mechelsesteenweg 365,2020-01-28,08:00:00,96,60,36,FMN GV 05 Lier
60,Mechelsesteenweg 365,2020-01-28,09:00:00,24,16,8,FMN GV 05 Lier
60,Mechelsesteenweg 365,2020-01-28,10:00:00,24,10,14,FMN GV 05 Lier
60,Mechelsesteenweg 365,2020-01-28,11:00:00,26,16,10,FMN GV 05 Lier
60,Mechelsesteenweg 365,2020-01-28,12:00:00,22,8,14,FMN GV 05 Lier
60,Mechelsesteenweg 365,2020-01-28,13:00:00,40,18,22,FMN GV 05 Lier
60,Mechelsesteenweg 365,2020-01-28,14:00:00,48,30,18,FMN GV 05 Lier
60,Mechelsesteenweg 365,2020-01-28,15:00:00,76,38,38,FMN GV 05 Lier
60,Mechelsesteenweg 365,2020-01-28,16:00:00,126,32,94,FMN GV 05 Lier
60,Mechelsesteenweg 365,2020-01-28,17:00:00,84,46,38,FMN GV 05 Lier
60,Mechelsesteenweg 365,2020-01-28,18:00:00,30,20,10,FMN GV 05 Lier
60,Mechelsesteenweg 365,2020-01-28,19:00:00,24,6,18,FMN GV 05 Lier
60,Mechelsesteenweg 365,2020-01-28,20:00:00,12,10,2,FMN GV 05 Lier
60,Mechelsesteenweg 365,2020-01-28,21:00:00,10,2,8,FMN GV 05 Lier
60,Mechelsesteenweg 365,2020-01-28,22:00:00,4,4,0,FMN GV 05 Lier
60,Mechelsesteenweg 365,2020-01-28,23:00:00,0,0,0,FMN GV 05 Lier
60,Mechelsesteenweg 365,2020-01-29,00:00:00,0,0,0,FMN GV 05 Lier
60,Mechelsesteenweg 365,2020-01-29,01:00:00,0,0,0,FMN GV 05 Lier
60,Mechelsesteenweg 365,2020-01-29,02:00:00,0,0,0,FMN GV 05 Lier
60,Mechelsesteenweg 365,2020-01-29,03:00:00,2,0,2,FMN GV 05 Lier
60,Mechelsesteenweg 365,2020-01-29,04:00:00,2,0,2,FMN GV 05 Lier
60,Mechelsesteenweg 365,2020-01-29,05:00:00,8,0,8,FMN GV 05 Lier
60,Mechelsesteenweg 365,2020-01-29,06:00:00,20,2,18,FMN GV 05 Lier
60,Mechelsesteenweg 365,2020-01-29,07:00:00,178,94,84,FMN GV 05 Lier
60,Mechelsesteenweg 365,2020-01-29,08:00:00,88,68,20,FMN GV 05 Lier
60,Mechelsesteenweg 365,2020-01-29,09:00:00,48,18,30,FMN GV 05 Lier
60,Mechelsesteenweg 365,2020-01-29,10:00:00,66,36,30,FMN GV 05 Lier
60,Mechelsesteenweg 365,2020-01-29,11:00:00,48,24,24,FMN GV 05 Lier
60,Mechelsesteenweg 365,2020-01-29,12:00:00,168,36,132,FMN GV 05 Lier
60,Mechelsesteenweg 365,2020-01-29,13:00:00,82,26,56,FMN GV 05 Lier
60,Mechelsesteenweg 365,2020-01-29,14:00:00,120,96,24,FMN GV 05 Lier
60,Mechelsesteenweg 365,2020-01-29,15:00:00,88,52,36,FMN GV 05 Lier
60,Mechelsesteenweg 365,2020-01-29,16:00:00,104,72,32,FMN GV 05 Lier
60,Mechelsesteenweg 365,2020-01-29,17:00:00,78,58,20,FMN GV 05 Lier
60,Mechelsesteenweg 365,2020-01-29,18:00:00,38,24,14,FMN GV 05 Lier
60,Mechelsesteenweg 365,2020-01-29,19:00:00,16,12,4,FMN GV 05 Lier
60,Mechelsesteenweg 365,2020-01-29,20:00:00,6,4,2,FMN GV 05 Lier
60,Mechelsesteenweg 365,2020-01-29,21:00:00,8,2,6,FMN GV 05 Lier
60,Mechelsesteenweg 365,2020-01-29,22:00:00,2,2,0,FMN GV 05 Lier
60,Mechelsesteenweg 365,2020-01-29,23:00:00,0,0,0,FMN GV 05 Lier
60,Mechelsesteenweg 365,2020-01-30,00:00:00,0,0,0,FMN GV 05 Lier
60,Mechelsesteenweg 365,2020-01-30,01:00:00,2,2,0,FMN GV 05 Lier
60,Mechelsesteenweg 365,2020-01-30,02:00:00,0,0,0,FMN GV 05 Lier
60,Mechelsesteenweg 365,2020-01-30,03:00:00,2,0,2,FMN GV 05 Lier
60,Mechelsesteenweg 365,2020-01-30,04:00:00,0,0,0,FMN GV 05 Lier
60,Mechelsesteenweg 365,2020-01-30,05:00:00,8,0,8,FMN GV 05 Lier
60,Mechelsesteenweg 365,2020-01-30,06:00:00,18,2,16,FMN GV 05 Lier
60,Mechelsesteenweg 365,2020-01-30,07:00:00,140,78,62,FMN GV 05 Lier
60,Mechelsesteenweg 365,2020-01-30,08:00:00,130,92,38,FMN GV 05 Lier
60,Mechelsesteenweg 365,2020-01-30,09:00:00,28,22,6,FMN GV 05 Lier
60,Mechelsesteenweg 365,2020-01-30,10:00:00,54,28,26,FMN GV 05 Lier
60,Mechelsesteenweg 365,2020-01-30,11:00:00,70,46,24,FMN GV 05 Lier
60,Mechelsesteenweg 365,2020-01-30,12:00:00,50,32,18,FMN GV 05 Lier
60,Mechelsesteenweg 365,2020-01-30,13:00:00,44,24,20,FMN GV 05 Lier
60,Mechelsesteenweg 365,2020-01-30,14:00:00,76,58,18,FMN GV 05 Lier
60,Mechelsesteenweg 365,2020-01-30,15:00:00,70,42,28,FMN GV 05 Lier
60,Mechelsesteenweg 365,2020-01-30,16:00:00,164,46,118,FMN GV 05 Lier
60,Mechelsesteenweg 365,2020-01-30,17:00:00,84,50,34,FMN GV 05 Lier
60,Mechelsesteenweg 365,2020-01-30,18:00:00,24,20,4,FMN GV 05 Lier
60,Mechelsesteenweg 365,2020-01-30,19:00:00,10,10,0,FMN GV 05 Lier
60,Mechelsesteenweg 365,2020-01-30,20:00:00,6,4,2,FMN GV 05 Lier
60,Mechelsesteenweg 365,2020-01-30,21:00:00,4,2,2,FMN GV 05 Lier
60,Mechelsesteenweg 365,2020-01-30,22:00:00,2,0,2,FMN GV 05 Lier
60,Mechelsesteenweg 365,2020-01-30,23:00:00,0,0,0,FMN GV 05 Lier
60,Mechelsesteenweg 365,2020-01-31,00:00:00,0,0,0,FMN GV 05 Lier
60,Mechelsesteenweg 365,2020-01-31,01:00:00,0,0,0,FMN GV 05 Lier
60,Mechelsesteenweg 365,2020-01-31,02:00:00,0,0,0,FMN GV 05 Lier
60,Mechelsesteenweg 365,2020-01-31,03:00:00,0,0,0,FMN GV 05 Lier
60,Mechelsesteenweg 365,2020-01-31,04:00:00,2,0,2,FMN GV 05 Lier
60,Mechelsesteenweg 365,2020-01-31,05:00:00,10,0,10,FMN GV 05 Lier
60,Mechelsesteenweg 365,2020-01-31,06:00:00,14,0,14,FMN GV 05 Lier
60,Mechelsesteenweg 365,2020-01-31,07:00:00,148,86,62,FMN GV 05 Lier
60,Mechelsesteenweg 365,2020-01-31,08:00:00,112,82,30,FMN GV 05 Lier
60,Mechelsesteenweg 365,2020-01-31,09:00:00,40,16,24,FMN GV 05 Lier
60,Mechelsesteenweg 365,2020-01-31,10:00:00,58,36,22,FMN GV 05 Lier
60,Mechelsesteenweg 365,2020-01-31,11:00:00,38,18,20,FMN GV 05 Lier
60,Mechelsesteenweg 365,2020-01-31,12:00:00,54,26,28,FMN GV 05 Lier
60,Mechelsesteenweg 365,2020-01-31,13:00:00,68,46,22,FMN GV 05 Lier
60,Mechelsesteenweg 365,2020-01-31,14:00:00,74,58,16,FMN GV 05 Lier
60,Mechelsesteenweg 365,2020-01-31,15:00:00,138,58,80,FMN GV 05 Lier
60,Mechelsesteenweg 365,2020-01-31,16:00:00,136,42,94,FMN GV 05 Lier
60,Mechelsesteenweg 365,2020-01-31,17:00:00,62,42,20,FMN GV 05 Lier
60,Mechelsesteenweg 365,2020-01-31,18:00:00,28,14,14,FMN GV 05 Lier
60,Mechelsesteenweg 365,2020-01-31,19:00:00,8,4,4,FMN GV 05 Lier
60,Mechelsesteenweg 365,2020-01-31,20:00:00,12,6,6,FMN GV 05 Lier
60,Mechelsesteenweg 365,2020-01-31,21:00:00,0,0,0,FMN GV 05 Lier
60,Mechelsesteenweg 365,2020-01-31,22:00:00,0,0,0,FMN GV 05 Lier
60,Mechelsesteenweg 365,2020-01-31,23:00:00,4,0,4,FMN GV 05 Lier
60,Mechelsesteenweg 365,2020-02-01,00:00:00,2,0,2,FMN GV 05 Lier
60,Mechelsesteenweg 365,2020-02-01,01:00:00,4,2,2,FMN GV 05 Lier
60,Mechelsesteenweg 365,2020-02-01,02:00:00,0,0,0,FMN GV 05 Lier
60,Mechelsesteenweg 365,2020-02-01,03:00:00,0,0,0,FMN GV 05 Lier
60,Mechelsesteenweg 365,2020-02-01,04:00:00,0,0,0,FMN GV 05 Lier
60,Mechelsesteenweg 365,2020-02-01,05:00:00,0,0,0,FMN GV 05 Lier
60,Mechelsesteenweg 365,2020-02-01,06:00:00,4,2,2,FMN GV 05 Lier
60,Mechelsesteenweg 365,2020-02-01,07:00:00,2,0,2,FMN GV 05 Lier
60,Mechelsesteenweg 365,2020-02-01,08:00:00,4,2,2,FMN GV 05 Lier
60,Mechelsesteenweg 365,2020-02-01,09:00:00,24,18,6,FMN GV 05 Lier
60,Mechelsesteenweg 365,2020-02-01,10:00:00,40,26,14,FMN GV 05 Lier
60,Mechelsesteenweg 365,2020-02-01,11:00:00,36,14,22,FMN GV 05 Lier
60,Mechelsesteenweg 365,2020-02-01,12:00:00,58,26,32,FMN GV 05 Lier
60,Mechelsesteenweg 365,2020-02-01,13:00:00,82,58,24,FMN GV 05 Lier
60,Mechelsesteenweg 365,2020-02-01,14:00:00,56,34,22,FMN GV 05 Lier
60,Mechelsesteenweg 365,2020-02-01,15:00:00,60,32,28,FMN GV 05 Lier
60,Mechelsesteenweg 365,2020-02-01,16:00:00,66,26,40,FMN GV 05 Lier
60,Mechelsesteenweg 365,2020-02-01,17:00:00,36,14,22,FMN GV 05 Lier
60,Mechelsesteenweg 365,2020-02-01,18:00:00,4,4,0,FMN GV 05 Lier
60,Mechelsesteenweg 365,2020-02-01,19:00:00,24,14,10,FMN GV 05 Lier
60,Mechelsesteenweg 365,2020-02-01,20:00:00,4,2,2,FMN GV 05 Lier
60,Mechelsesteenweg 365,2020-02-01,21:00:00,2,0,2,FMN GV 05 Lier
60,Mechelsesteenweg 365,2020-02-01,22:00:00,6,4,2,FMN GV 05 Lier
60,Mechelsesteenweg 365,2020-02-01,23:00:00,2,0,2,FMN GV 05 Lier
60,Mechelsesteenweg 365,2020-02-02,00:00:00,4,2,2,FMN GV 05 Lier
60,Mechelsesteenweg 365,2020-02-02,01:00:00,0,0,0,FMN GV 05 Lier
60,Mechelsesteenweg 365,2020-02-02,02:00:00,0,0,0,FMN GV 05 Lier
60,Mechelsesteenweg 365,2020-02-02,03:00:00,0,0,0,FMN GV 05 Lier
60,Mechelsesteenweg 365,2020-02-02,04:00:00,0,0,0,FMN GV 05 Lier
60,Mechelsesteenweg 365,2020-02-02,05:00:00,0,0,0,FMN GV 05 Lier
60,Mechelsesteenweg 365,2020-02-02,06:00:00,0,0,0,FMN GV 05 Lier
60,Mechelsesteenweg 365,2020-02-02,07:00:00,6,2,4,FMN GV 05 Lier
60,Mechelsesteenweg 365,2020-02-02,08:00:00,4,2,2,FMN GV 05 Lier
60,Mechelsesteenweg 365,2020-02-02,09:00:00,10,2,8,FMN GV 05 Lier
60,Mechelsesteenweg 365,2020-02-02,10:00:00,52,20,32,FMN GV 05 Lier
60,Mechelsesteenweg 365,2020-02-02,11:00:00,24,14,10,FMN GV 05 Lier
60,Mechelsesteenweg 365,2020-02-02,12:00:00,22,2,20,FMN GV 05 Lier
60,Mechelsesteenweg 365,2020-02-02,13:00:00,62,40,22,FMN GV 05 Lier
60,Mechelsesteenweg 365,2020-02-02,14:00:00,46,24,22,FMN GV 05 Lier
60,Mechelsesteenweg 365,2020-02-02,15:00:00,50,28,22,FMN GV 05 Lier
60,Mechelsesteenweg 365,2020-02-02,16:00:00,56,22,34,FMN GV 05 Lier
60,Mechelsesteenweg 365,2020-02-02,17:00:00,24,12,12,FMN GV 05 Lier
60,Mechelsesteenweg 365,2020-02-02,18:00:00,10,4,6,FMN GV 05 Lier
60,Mechelsesteenweg 365,2020-02-02,19:00:00,0,0,0,FMN GV 05 Lier
60,Mechelsesteenweg 365,2020-02-02,20:00:00,4,4,0,FMN GV 05 Lier
60,Mechelsesteenweg 365,2020-02-02,21:00:00,2,0,2,FMN GV 05 Lier
60,Mechelsesteenweg 365,2020-02-02,22:00:00,0,0,0,FMN GV 05 Lier
60,Mechelsesteenweg 365,2020-02-02,23:00:00,2,0,2,FMN GV 05 Lier
60,Mechelsesteenweg 365,2020-02-03,00:00:00,0,0,0,FMN GV 05 Lier
60,Mechelsesteenweg 365,2020-02-03,01:00:00,0,0,0,FMN GV 05 Lier
60,Mechelsesteenweg 365,2020-02-03,02:00:00,0,0,0,FMN GV 05 Lier
60,Mechelsesteenweg 365,2020-02-03,03:00:00,0,0,0,FMN GV 05 Lier
60,Mechelsesteenweg 365,2020-02-03,04:00:00,2,0,2,FMN GV 05 Lier
60,Mechelsesteenweg 365,2020-02-03,05:00:00,8,2,6,FMN GV 05 Lier
60,Mechelsesteenweg 365,2020-02-03,06:00:00,20,8,12,FMN GV 05 Lier
60,Mechelsesteenweg 365,2020-02-03,07:00:00,140,78,62,FMN GV 05 Lier
60,Mechelsesteenweg 365,2020-02-03,08:00:00,112,66,46,FMN GV 05 Lier
60,Mechelsesteenweg 365,2020-02-03,09:00:00,52,32,20,FMN GV 05 Lier
60,Mechelsesteenweg 365,2020-02-03,10:00:00,56,30,26,FMN GV 05 Lier
60,Mechelsesteenweg 365,2020-02-03,11:00:00,36,18,18,FMN GV 05 Lier
60,Mechelsesteenweg 365,2020-02-03,12:00:00,44,24,20,FMN GV 05 Lier
60,Mechelsesteenweg 365,2020-02-03,13:00:00,42,22,20,FMN GV 05 Lier
60,Mechelsesteenweg 365,2020-02-03,14:00:00,70,44,26,FMN GV 05 Lier
60,Mechelsesteenweg 365,2020-02-03,15:00:00,88,48,40,FMN GV 05 Lier
60,Mechelsesteenweg 365,2020-02-03,16:00:00,194,58,136,FMN GV 05 Lier
60,Mechelsesteenweg 365,2020-02-03,17:00:00,100,58,42,FMN GV 05 Lier
60,Mechelsesteenweg 365,2020-02-03,18:00:00,32,22,10,FMN GV 05 Lier
60,Mechelsesteenweg 365,2020-02-03,19:00:00,8,6,2,FMN GV 05 Lier
60,Mechelsesteenweg 365,2020-02-03,20:00:00,2,2,0,FMN GV 05 Lier
60,Mechelsesteenweg 365,2020-02-03,21:00:00,6,2,4,FMN GV 05 Lier
60,Mechelsesteenweg 365,2020-02-03,22:00:00,2,2,0,FMN GV 05 Lier
60,Mechelsesteenweg 365,2020-02-03,23:00:00,0,0,0,FMN GV 05 Lier
60,Mechelsesteenweg 365,2020-02-04,00:00:00,0,0,0,FMN GV 05 Lier
60,Mechelsesteenweg 365,2020-02-04,01:00:00,0,0,0,FMN GV 05 Lier
60,Mechelsesteenweg 365,2020-02-04,02:00:00,0,0,0,FMN GV 05 Lier
60,Mechelsesteenweg 365,2020-02-04,03:00:00,0,0,0,FMN GV 05 Lier
60,Mechelsesteenweg 365,2020-02-04,04:00:00,0,0,0,FMN GV 05 Lier
60,Mechelsesteenweg 365,2020-02-04,05:00:00,8,2,6,FMN GV 05 Lier
60,Mechelsesteenweg 365,2020-02-04,06:00:00,12,0,12,FMN GV 05 Lier
60,Mechelsesteenweg 365,2020-02-04,07:00:00,134,84,50,FMN GV 05 Lier
60,Mechelsesteenweg 365,2020-02-04,08:00:00,96,64,32,FMN GV 05 Lier
60,Mechelsesteenweg 365,2020-02-04,09:00:00,14,6,8,FMN GV 05 Lier
60,Mechelsesteenweg 365,2020-02-04,10:00:00,16,4,12,FMN GV 05 Lier
60,Mechelsesteenweg 365,2020-02-04,11:00:00,32,20,12,FMN GV 05 Lier
60,Mechelsesteenweg 365,2020-02-04,12:00:00,48,20,28,FMN GV 05 Lier
60,Mechelsesteenweg 365,2020-02-04,13:00:00,226,194,32,FMN GV 05 Lier
60,Mechelsesteenweg 365,2020-02-04,14:00:00,22,14,8,FMN GV 05 Lier
60,Mechelsesteenweg 365,2020-02-04,15:00:00,220,22,198,FMN GV 05 Lier
60,Mechelsesteenweg 365,2020-02-04,16:00:00,138,38,100,FMN GV 05 Lier
60,Mechelsesteenweg 365,2020-02-04,17:00:00,84,54,30,FMN GV 05 Lier
60,Mechelsesteenweg 365,2020-02-04,18:00:00,22,16,6,FMN GV 05 Lier
60,Mechelsesteenweg 365,2020-02-04,19:00:00,8,4,4,FMN GV 05 Lier
60,Mechelsesteenweg 365,2020-02-04,20:00:00,4,2,2,FMN GV 05 Lier
60,Mechelsesteenweg 365,2020-02-04,21:00:00,2,0,2,FMN GV 05 Lier
60,Mechelsesteenweg 365,2020-02-04,22:00:00,4,4,0,FMN GV 05 Lier
60,Mechelsesteenweg 365,2020-02-04,23:00:00,0,0,0,FMN GV 05 Lier
60,Mechelsesteenweg 365,2020-02-05,00:00:00,0,0,0,FMN GV 05 Lier
60,Mechelsesteenweg 365,2020-02-05,01:00:00,0,0,0,FMN GV 05 Lier
60,Mechelsesteenweg 365,2020-02-05,02:00:00,0,0,0,FMN GV 05 Lier
60,Mechelsesteenweg 365,2020-02-05,03:00:00,0,0,0,FMN GV 05 Lier
60,Mechelsesteenweg 365,2020-02-05,04:00:00,2,0,2,FMN GV 05 Lier
60,Mechelsesteenweg 365,2020-02-05,05:00:00,6,0,6,FMN GV 05 Lier
60,Mechelsesteenweg 365,2020-02-05,06:00:00,14,6,8,FMN GV 05 Lier
60,Mechelsesteenweg 365,2020-02-05,07:00:00,150,88,62,FMN GV 05 Lier
60,Mechelsesteenweg 365,2020-02-05,08:00:00,138,106,32,FMN GV 05 Lier
60,Mechelsesteenweg 365,2020-02-05,09:00:00,42,18,24,FMN GV 05 Lier
60,Mechelsesteenweg 365,2020-02-05,10:00:00,84,50,34,FMN GV 05 Lier
60,Mechelsesteenweg 365,2020-02-05,11:00:00,80,36,44,FMN GV 05 Lier
60,Mechelsesteenweg 365,2020-02-05,12:00:00,196,50,146,FMN GV 05 Lier
60,Mechelsesteenweg 365,2020-02-05,13:00:00,152,54,98,FMN GV 05 Lier
60,Mechelsesteenweg 365,2020-02-05,14:00:00,156,84,72,FMN GV 05 Lier
60,Mechelsesteenweg 365,2020-02-05,15:00:00,142,60,82,FMN GV 05 Lier
60,Mechelsesteenweg 365,2020-02-05,16:00:00,84,46,38,FMN GV 05 Lier
60,Mechelsesteenweg 365,2020-02-05,17:00:00,90,64,26,FMN GV 05 Lier
60,Mechelsesteenweg 365,2020-02-05,18:00:00,26,22,4,FMN GV 05 Lier
60,Mechelsesteenweg 365,2020-02-05,19:00:00,22,12,10,FMN GV 05 Lier
60,Mechelsesteenweg 365,2020-02-05,20:00:00,14,6,8,FMN GV 05 Lier
60,Mechelsesteenweg 365,2020-02-05,21:00:00,6,0,6,FMN GV 05 Lier
60,Mechelsesteenweg 365,2020-02-05,22:00:00,4,4,0,FMN GV 05 Lier
60,Mechelsesteenweg 365,2020-02-05,23:00:00,6,4,2,FMN GV 05 Lier
60,Mechelsesteenweg 365,2020-02-06,00:00:00,0,0,0,FMN GV 05 Lier
60,Mechelsesteenweg 365,2020-02-06,01:00:00,0,0,0,FMN GV 05 Lier
60,Mechelsesteenweg 365,2020-02-06,02:00:00,0,0,0,FMN GV 05 Lier
60,Mechelsesteenweg 365,2020-02-06,03:00:00,0,0,0,FMN GV 05 Lier
60,Mechelsesteenweg 365,2020-02-06,04:00:00,4,0,4,FMN GV 05 Lier
60,Mechelsesteenweg 365,2020-02-06,05:00:00,4,0,4,FMN GV 05 Lier
60,Mechelsesteenweg 365,2020-02-06,06:00:00,20,4,16,FMN GV 05 Lier
60,Mechelsesteenweg 365,2020-02-06,07:00:00,134,76,58,FMN GV 05 Lier
60,Mechelsesteenweg 365,2020-02-06,08:00:00,150,108,42,FMN GV 05 Lier
60,Mechelsesteenweg 365,2020-02-06,09:00:00,62,50,12,FMN GV 05 Lier
60,Mechelsesteenweg 365,2020-02-06,10:00:00,62,32,30,FMN GV 05 Lier
60,Mechelsesteenweg 365,2020-02-06,11:00:00,82,26,56,FMN GV 05 Lier
60,Mechelsesteenweg 365,2020-02-06,12:00:00,114,52,62,FMN GV 05 Lier
60,Mechelsesteenweg 365,2020-02-06,13:00:00,150,82,68,FMN GV 05 Lier
60,Mechelsesteenweg 365,2020-02-06,14:00:00,198,102,96,FMN GV 05 Lier
60,Mechelsesteenweg 365,2020-02-06,15:00:00,168,68,100,FMN GV 05 Lier
60,Mechelsesteenweg 365,2020-02-06,16:00:00,228,74,154,FMN GV 05 Lier
60,Mechelsesteenweg 365,2020-02-06,17:00:00,114,74,40,FMN GV 05 Lier
60,Mechelsesteenweg 365,2020-02-06,18:00:00,40,28,12,FMN GV 05 Lier
60,Mechelsesteenweg 365,2020-02-06,19:00:00,20,10,10,FMN GV 05 Lier
60,Mechelsesteenweg 365,2020-02-06,20:00:00,10,10,0,FMN GV 05 Lier
60,Mechelsesteenweg 365,2020-02-06,21:00:00,12,2,10,FMN GV 05 Lier
60,Mechelsesteenweg 365,2020-02-06,22:00:00,12,8,4,FMN GV 05 Lier
60,Mechelsesteenweg 365,2020-02-06,23:00:00,2,0,2,FMN GV 05 Lier
60,Mechelsesteenweg 365,2020-02-07,00:00:00,0,0,0,FMN GV 05 Lier
60,Mechelsesteenweg 365,2020-02-07,01:00:00,0,0,0,FMN GV 05 Lier
60,Mechelsesteenweg 365,2020-02-07,02:00:00,0,0,0,FMN GV 05 Lier
60,Mechelsesteenweg 365,2020-02-07,03:00:00,2,0,2,FMN GV 05 Lier
60,Mechelsesteenweg 365,2020-02-07,04:00:00,0,0,0,FMN GV 05 Lier
60,Mechelsesteenweg 365,2020-02-07,05:00:00,6,0,6,FMN GV 05 Lier
60,Mechelsesteenweg 365,2020-02-07,06:00:00,18,6,12,FMN GV 05 Lier
60,Mechelsesteenweg 365,2020-02-07,07:00:00,60,20,40,FMN GV 05 Lier
60,Mechelsesteenweg 365,2020-02-07,08:00:00,70,18,52,FMN GV 05 Lier
60,Mechelsesteenweg 365,2020-02-07,09:00:00,36,20,16,FMN GV 05 Lier
60,Mechelsesteenweg 365,2020-02-07,10:00:00,86,54,32,FMN GV 05 Lier
60,Mechelsesteenweg 365,2020-02-07,11:00:00,90,50,40,FMN GV 05 Lier
60,Mechelsesteenweg 365,2020-02-07,12:00:00,108,50,58,FMN GV 05 Lier
60,Mechelsesteenweg 365,2020-02-07,13:00:00,188,98,90,FMN GV 05 Lier
60,Mechelsesteenweg 365,2020-02-07,14:00:00,326,190,136,FMN GV 05 Lier
60,Mechelsesteenweg 365,2020-02-07,15:00:00,260,134,126,FMN GV 05 Lier
60,Mechelsesteenweg 365,2020-02-07,16:00:00,186,90,96,FMN GV 05 Lier
60,Mechelsesteenweg 365,2020-02-07,17:00:00,110,60,50,FMN GV 05 Lier
60,Mechelsesteenweg 365,2020-02-07,18:00:00,46,32,14,FMN GV 05 Lier
60,Mechelsesteenweg 365,2020-02-07,19:00:00,6,0,6,FMN GV 05 Lier
60,Mechelsesteenweg 365,2020-02-07,20:00:00,4,2,2,FMN GV 05 Lier
60,Mechelsesteenweg 365,2020-02-07,21:00:00,8,2,6,FMN GV 05 Lier
60,Mechelsesteenweg 365,2020-02-07,22:00:00,2,2,0,FMN GV 05 Lier
60,Mechelsesteenweg 365,2020-02-07,23:00:00,4,0,4,FMN GV 05 Lier
60,Mechelsesteenweg 365,2020-02-08,00:00:00,0,0,0,FMN GV 05 Lier
60,Mechelsesteenweg 365,2020-02-08,01:00:00,2,2,0,FMN GV 05 Lier
60,Mechelsesteenweg 365,2020-02-08,02:00:00,0,0,0,FMN GV 05 Lier
60,Mechelsesteenweg 365,2020-02-08,03:00:00,0,0,0,FMN GV 05 Lier
60,Mechelsesteenweg 365,2020-02-08,04:00:00,0,0,0,FMN GV 05 Lier
60,Mechelsesteenweg 365,2020-02-08,05:00:00,4,0,4,FMN GV 05 Lier
60,Mechelsesteenweg 365,2020-02-08,06:00:00,2,0,2,FMN GV 05 Lier
60,Mechelsesteenweg 365,2020-02-08,07:00:00,4,0,4,FMN GV 05 Lier
60,Mechelsesteenweg 365,2020-02-08,08:00:00,24,4,20,FMN GV 05 Lier
60,Mechelsesteenweg 365,2020-02-08,09:00:00,100,50,50,FMN GV 05 Lier
60,Mechelsesteenweg 365,2020-02-08,10:00:00,206,122,84,FMN GV 05 Lier
60,Mechelsesteenweg 365,2020-02-08,11:00:00,200,92,108,FMN GV 05 Lier
60,Mechelsesteenweg 365,2020-02-08,12:00:00,138,58,80,FMN GV 05 Lier
60,Mechelsesteenweg 365,2020-02-08,13:00:00,86,60,26,FMN GV 05 Lier
60,Mechelsesteenweg 365,2020-02-08,14:00:00,40,30,10,FMN GV 05 Lier
60,Mechelsesteenweg 365,2020-02-08,15:00:00,28,24,4,FMN GV 05 Lier
60,Mechelsesteenweg 365,2020-02-08,16:00:00,18,4,14,FMN GV 05 Lier
60,Mechelsesteenweg 365,2020-02-08,17:00:00,14,8,6,FMN GV 05 Lier
60,Mechelsesteenweg 365,2020-02-08,18:00:00,10,6,4,FMN GV 05 Lier
60,Mechelsesteenweg 365,2020-02-08,19:00:00,0,0,0,FMN GV 05 Lier
60,Mechelsesteenweg 365,2020-02-08,20:00:00,4,0,4,FMN GV 05 Lier
60,Mechelsesteenweg 365,2020-02-08,21:00:00,10,0,10,FMN GV 05 Lier
60,Mechelsesteenweg 365,2020-02-08,22:00:00,0,0,0,FMN GV 05 Lier
60,Mechelsesteenweg 365,2020-02-08,23:00:00,10,8,2,FMN GV 05 Lier
60,Mechelsesteenweg 365,2020-02-09,00:00:00,0,0,0,FMN GV 05 Lier
60,Mechelsesteenweg 365,2020-02-09,01:00:00,4,0,4,FMN GV 05 Lier
60,Mechelsesteenweg 365,2020-02-09,02:00:00,0,0,0,FMN GV 05 Lier
60,Mechelsesteenweg 365,2020-02-09,03:00:00,2,2,0,FMN GV 05 Lier
60,Mechelsesteenweg 365,2020-02-09,04:00:00,0,0,0,FMN GV 05 Lier
60,Mechelsesteenweg 365,2020-02-09,05:00:00,0,0,0,FMN GV 05 Lier
60,Mechelsesteenweg 365,2020-02-09,06:00:00,0,0,0,FMN GV 05 Lier
60,Mechelsesteenweg 365,2020-02-09,07:00:00,0,0,0,FMN GV 05 Lier
60,Mechelsesteenweg 365,2020-02-09,08:00:00,0,0,0,FMN GV 05 Lier
60,Mechelsesteenweg 365,2020-02-09,09:00:00,18,16,2,FMN GV 05 Lier
60,Mechelsesteenweg 365,2020-02-09,10:00:00,36,20,16,FMN GV 05 Lier
60,Mechelsesteenweg 365,2020-02-09,11:00:00,14,6,8,FMN GV 05 Lier
60,Mechelsesteenweg 365,2020-02-09,12:00:00,10,6,4,FMN GV 05 Lier
60,Mechelsesteenweg 365,2020-02-09,13:00:00,0,0,0,FMN GV 05 Lier
60,Mechelsesteenweg 365,2020-02-09,14:00:00,0,0,0,FMN GV 05 Lier
60,Mechelsesteenweg 365,2020-02-09,15:00:00,4,2,2,FMN GV 05 Lier
60,Mechelsesteenweg 365,2020-02-09,16:00:00,2,0,2,FMN GV 05 Lier
60,Mechelsesteenweg 365,2020-02-09,17:00:00,2,2,0,FMN GV 05 Lier
60,Mechelsesteenweg 365,2020-02-09,18:00:00,0,0,0,FMN GV 05 Lier
60,Mechelsesteenweg 365,2020-02-09,19:00:00,0,0,0,FMN GV 05 Lier
60,Mechelsesteenweg 365,2020-02-09,20:00:00,0,0,0,FMN GV 05 Lier
60,Mechelsesteenweg 365,2020-02-09,21:00:00,0,0,0,FMN GV 05 Lier
60,Mechelsesteenweg 365,2020-02-09,22:00:00,0,0,0,FMN GV 05 Lier
60,Mechelsesteenweg 365,2020-02-09,23:00:00,0,0,0,FMN GV 05 Lier
60,Mechelsesteenweg 365,2020-02-10,00:00:00,0,0,0,FMN GV 05 Lier
60,Mechelsesteenweg 365,2020-02-10,01:00:00,0,0,0,FMN GV 05 Lier
60,Mechelsesteenweg 365,2020-02-10,02:00:00,0,0,0,FMN GV 05 Lier
60,Mechelsesteenweg 365,2020-02-10,03:00:00,0,0,0,FMN GV 05 Lier
60,Mechelsesteenweg 365,2020-02-10,04:00:00,0,0,0,FMN GV 05 Lier
60,Mechelsesteenweg 365,2020-02-10,05:00:00,4,0,4,FMN GV 05 Lier
60,Mechelsesteenweg 365,2020-02-10,06:00:00,4,2,2,FMN GV 05 Lier
60,Mechelsesteenweg 365,2020-02-10,07:00:00,40,20,20,FMN GV 05 Lier
60,Mechelsesteenweg 365,2020-02-10,08:00:00,44,32,12,FMN GV 05 Lier
60,Mechelsesteenweg 365,2020-02-10,09:00:00,12,10,2,FMN GV 05 Lier
60,Mechelsesteenweg 365,2020-02-10,10:00:00,8,8,0,FMN GV 05 Lier
60,Mechelsesteenweg 365,2020-02-10,11:00:00,12,6,6,FMN GV 05 Lier
60,Mechelsesteenweg 365,2020-02-10,12:00:00,6,0,6,FMN GV 05 Lier
60,Mechelsesteenweg 365,2020-02-10,13:00:00,12,6,6,FMN GV 05 Lier
60,Mechelsesteenweg 365,2020-02-10,14:00:00,18,12,6,FMN GV 05 Lier
60,Mechelsesteenweg 365,2020-02-10,15:00:00,12,6,6,FMN GV 05 Lier
60,Mechelsesteenweg 365,2020-02-10,16:00:00,44,14,30,FMN GV 05 Lier
60,Mechelsesteenweg 365,2020-02-10,17:00:00,48,40,8,FMN GV 05 Lier
60,Mechelsesteenweg 365,2020-02-10,18:00:00,6,2,4,FMN GV 05 Lier
60,Mechelsesteenweg 365,2020-02-10,19:00:00,8,4,4,FMN GV 05 Lier
60,Mechelsesteenweg 365,2020-02-10,20:00:00,0,0,0,FMN GV 05 Lier
60,Mechelsesteenweg 365,2020-02-10,21:00:00,0,0,0,FMN GV 05 Lier
60,Mechelsesteenweg 365,2020-02-10,22:00:00,6,2,4,FMN GV 05 Lier
60,Mechelsesteenweg 365,2020-02-10,23:00:00,0,0,0,FMN GV 05 Lier
60,Mechelsesteenweg 365,2020-02-11,00:00:00,0,0,0,FMN GV 05 Lier
60,Mechelsesteenweg 365,2020-02-11,01:00:00,0,0,0,FMN GV 05 Lier
60,Mechelsesteenweg 365,2020-02-11,02:00:00,0,0,0,FMN GV 05 Lier
60,Mechelsesteenweg 365,2020-02-11,03:00:00,0,0,0,FMN GV 05 Lier
60,Mechelsesteenweg 365,2020-02-11,04:00:00,0,0,0,FMN GV 05 Lier
60,Mechelsesteenweg 365,2020-02-11,05:00:00,2,0,2,FMN GV 05 Lier
60,Mechelsesteenweg 365,2020-02-11,06:00:00,12,0,12,FMN GV 05 Lier
60,Mechelsesteenweg 365,2020-02-11,07:00:00,86,54,32,FMN GV 05 Lier
60,Mechelsesteenweg 365,2020-02-11,08:00:00,116,70,46,FMN GV 05 Lier
60,Mechelsesteenweg 365,2020-02-11,09:00:00,34,22,12,FMN GV 05 Lier
60,Mechelsesteenweg 365,2020-02-11,10:00:00,36,22,14,FMN GV 05 Lier
60,Mechelsesteenweg 365,2020-02-11,11:00:00,22,12,10,FMN GV 05 Lier
60,Mechelsesteenweg 365,2020-02-11,12:00:00,40,24,16,FMN GV 05 Lier
60,Mechelsesteenweg 365,2020-02-11,13:00:00,48,16,32,FMN GV 05 Lier
60,Mechelsesteenweg 365,2020-02-11,14:00:00,72,34,38,FMN GV 05 Lier
60,Mechelsesteenweg 365,2020-02-11,15:00:00,70,30,40,FMN GV 05 Lier
60,Mechelsesteenweg 365,2020-02-11,16:00:00,118,52,66,FMN GV 05 Lier
60,Mechelsesteenweg 365,2020-02-11,17:00:00,80,56,24,FMN GV 05 Lier
60,Mechelsesteenweg 365,2020-02-11,18:00:00,22,16,6,FMN GV 05 Lier
60,Mechelsesteenweg 365,2020-02-11,19:00:00,16,2,14,FMN GV 05 Lier
60,Mechelsesteenweg 365,2020-02-11,20:00:00,2,0,2,FMN GV 05 Lier
60,Mechelsesteenweg 365,2020-02-11,21:00:00,4,2,2,FMN GV 05 Lier
60,Mechelsesteenweg 365,2020-02-11,22:00:00,4,4,0,FMN GV 05 Lier
60,Mechelsesteenweg 365,2020-02-11,23:00:00,0,0,0,FMN GV 05 Lier
60,Mechelsesteenweg 365,2020-02-12,00:00:00,0,0,0,FMN GV 05 Lier
60,Mechelsesteenweg 365,2020-02-12,01:00:00,0,0,0,FMN GV 05 Lier
60,Mechelsesteenweg 365,2020-02-12,02:00:00,0,0,0,FMN GV 05 Lier
60,Mechelsesteenweg 365,2020-02-12,03:00:00,0,0,0,FMN GV 05 Lier
60,Mechelsesteenweg 365,2020-02-12,04:00:00,0,0,0,FMN GV 05 Lier
60,Mechelsesteenweg 365,2020-02-12,05:00:00,6,0,6,FMN GV 05 Lier
60,Mechelsesteenweg 365,2020-02-12,06:00:00,10,2,8,FMN GV 05 Lier
60,Mechelsesteenweg 365,2020-02-12,07:00:00,138,74,64,FMN GV 05 Lier
60,Mechelsesteenweg 365,2020-02-12,08:00:00,120,76,44,FMN GV 05 Lier
60,Mechelsesteenweg 365,2020-02-12,09:00:00,40,32,8,FMN GV 05 Lier
60,Mechelsesteenweg 365,2020-02-12,10:00:00,54,30,24,FMN GV 05 Lier
60,Mechelsesteenweg 365,2020-02-12,11:00:00,58,28,30,FMN GV 05 Lier
60,Mechelsesteenweg 365,2020-02-12,12:00:00,122,28,94,FMN GV 05 Lier
60,Mechelsesteenweg 365,2020-02-12,13:00:00,108,58,50,FMN GV 05 Lier
60,Mechelsesteenweg 365,2020-02-12,14:00:00,96,66,30,FMN GV 05 Lier
60,Mechelsesteenweg 365,2020-02-12,15:00:00,88,56,32,FMN GV 05 Lier
60,Mechelsesteenweg 365,2020-02-12,16:00:00,116,86,30,FMN GV 05 Lier
60,Mechelsesteenweg 365,2020-02-12,17:00:00,76,52,24,FMN GV 05 Lier
60,Mechelsesteenweg 365,2020-02-12,18:00:00,44,24,20,FMN GV 05 Lier
60,Mechelsesteenweg 365,2020-02-12,19:00:00,14,12,2,FMN GV 05 Lier
60,Mechelsesteenweg 365,2020-02-12,20:00:00,18,12,6,FMN GV 05 Lier
60,Mechelsesteenweg 365,2020-02-12,21:00:00,2,0,2,FMN GV 05 Lier
60,Mechelsesteenweg 365,2020-02-12,22:00:00,2,0,2,FMN GV 05 Lier
60,Mechelsesteenweg 365,2020-02-12,23:00:00,0,0,0,FMN GV 05 Lier
60,Mechelsesteenweg 365,2020-02-13,00:00:00,0,0,0,FMN GV 05 Lier
60,Mechelsesteenweg 365,2020-02-13,01:00:00,0,0,0,FMN GV 05 Lier
60,Mechelsesteenweg 365,2020-02-13,02:00:00,0,0,0,FMN GV 05 Lier
60,Mechelsesteenweg 365,2020-02-13,03:00:00,0,0,0,FMN GV 05 Lier
60,Mechelsesteenweg 365,2020-02-13,04:00:00,0,0,0,FMN GV 05 Lier
60,Mechelsesteenweg 365,2020-02-13,05:00:00,6,0,6,FMN GV 05 Lier
60,Mechelsesteenweg 365,2020-02-13,06:00:00,8,0,8,FMN GV 05 Lier
60,Mechelsesteenweg 365,2020-02-13,07:00:00,88,40,48,FMN GV 05 Lier
60,Mechelsesteenweg 365,2020-02-13,08:00:00,74,52,22,FMN GV 05 Lier
60,Mechelsesteenweg 365,2020-02-13,09:00:00,22,20,2,FMN GV 05 Lier
60,Mechelsesteenweg 365,2020-02-13,10:00:00,8,4,4,FMN GV 05 Lier
60,Mechelsesteenweg 365,2020-02-13,11:00:00,10,6,4,FMN GV 05 Lier
60,Mechelsesteenweg 365,2020-02-13,12:00:00,28,16,12,FMN GV 05 Lier
60,Mechelsesteenweg 365,2020-02-13,13:00:00,12,6,6,FMN GV 05 Lier
60,Mechelsesteenweg 365,2020-02-13,14:00:00,20,16,4,FMN GV 05 Lier
60,Mechelsesteenweg 365,2020-02-13,15:00:00,22,4,18,FMN GV 05 Lier
60,Mechelsesteenweg 365,2020-02-13,16:00:00,94,40,54,FMN GV 05 Lier
60,Mechelsesteenweg 365,2020-02-13,17:00:00,60,34,26,FMN GV 05 Lier
60,Mechelsesteenweg 365,2020-02-13,18:00:00,26,12,14,FMN GV 05 Lier
60,Mechelsesteenweg 365,2020-02-13,19:00:00,6,4,2,FMN GV 05 Lier
60,Mechelsesteenweg 365,2020-02-13,20:00:00,4,2,2,FMN GV 05 Lier
60,Mechelsesteenweg 365,2020-02-13,21:00:00,4,0,4,FMN GV 05 Lier
60,Mechelsesteenweg 365,2020-02-13,22:00:00,8,4,4,FMN GV 05 Lier
60,Mechelsesteenweg 365,2020-02-13,23:00:00,2,2,0,FMN GV 05 Lier
60,Mechelsesteenweg 365,2020-02-14,00:00:00,0,0,0,FMN GV 05 Lier
60,Mechelsesteenweg 365,2020-02-14,01:00:00,0,0,0,FMN GV 05 Lier
60,Mechelsesteenweg 365,2020-02-14,02:00:00,0,0,0,FMN GV 05 Lier
60,Mechelsesteenweg 365,2020-02-14,03:00:00,0,0,0,FMN GV 05 Lier
60,Mechelsesteenweg 365,2020-02-14,04:00:00,0,0,0,FMN GV 05 Lier
60,Mechelsesteenweg 365,2020-02-14,05:00:00,2,0,2,FMN GV 05 Lier
60,Mechelsesteenweg 365,2020-02-14,06:00:00,16,6,10,FMN GV 05 Lier
60,Mechelsesteenweg 365,2020-02-14,07:00:00,134,72,62,FMN GV 05 Lier
60,Mechelsesteenweg 365,2020-02-14,08:00:00,138,84,54,FMN GV 05 Lier
60,Mechelsesteenweg 365,2020-02-14,09:00:00,54,36,18,FMN GV 05 Lier
60,Mechelsesteenweg 365,2020-02-14,10:00:00,68,44,24,FMN GV 05 Lier
60,Mechelsesteenweg 365,2020-02-14,11:00:00,78,44,34,FMN GV 05 Lier
60,Mechelsesteenweg 365,2020-02-14,12:00:00,76,34,42,FMN GV 05 Lier
60,Mechelsesteenweg 365,2020-02-14,13:00:00,128,54,74,FMN GV 05 Lier
60,Mechelsesteenweg 365,2020-02-14,14:00:00,152,80,72,FMN GV 05 Lier
60,Mechelsesteenweg 365,2020-02-14,15:00:00,158,88,70,FMN GV 05 Lier
60,Mechelsesteenweg 365,2020-02-14,16:00:00,190,56,134,FMN GV 05 Lier
60,Mechelsesteenweg 365,2020-02-14,17:00:00,112,74,38,FMN GV 05 Lier
60,Mechelsesteenweg 365,2020-02-14,18:00:00,30,18,12,FMN GV 05 Lier
60,Mechelsesteenweg 365,2020-02-14,19:00:00,12,8,4,FMN GV 05 Lier
60,Mechelsesteenweg 365,2020-02-14,20:00:00,10,4,6,FMN GV 05 Lier
60,Mechelsesteenweg 365,2020-02-14,21:00:00,12,0,12,FMN GV 05 Lier
60,Mechelsesteenweg 365,2020-02-14,22:00:00,14,8,6,FMN GV 05 Lier
60,Mechelsesteenweg 365,2020-02-14,23:00:00,2,2,0,FMN GV 05 Lier
60,Mechelsesteenweg 365,2020-02-15,00:00:00,2,2,0,FMN GV 05 Lier
60,Mechelsesteenweg 365,2020-02-15,01:00:00,8,8,0,FMN GV 05 Lier
60,Mechelsesteenweg 365,2020-02-15,02:00:00,6,6,0,FMN GV 05 Lier
60,Mechelsesteenweg 365,2020-02-15,03:00:00,4,4,0,FMN GV 05 Lier
60,Mechelsesteenweg 365,2020-02-15,04:00:00,2,2,0,FMN GV 05 Lier
60,Mechelsesteenweg 365,2020-02-15,05:00:00,4,0,4,FMN GV 05 Lier
60,Mechelsesteenweg 365,2020-02-15,06:00:00,0,0,0,FMN GV 05 Lier
60,Mechelsesteenweg 365,2020-02-15,07:00:00,12,2,10,FMN GV 05 Lier
60,Mechelsesteenweg 365,2020-02-15,08:00:00,24,6,18,FMN GV 05 Lier
60,Mechelsesteenweg 365,2020-02-15,09:00:00,84,46,38,FMN GV 05 Lier
60,Mechelsesteenweg 365,2020-02-15,10:00:00,140,68,72,FMN GV 05 Lier
60,Mechelsesteenweg 365,2020-02-15,11:00:00,172,86,86,FMN GV 05 Lier
60,Mechelsesteenweg 365,2020-02-15,12:00:00,110,52,58,FMN GV 05 Lier
60,Mechelsesteenweg 365,2020-02-15,13:00:00,132,84,48,FMN GV 05 Lier
60,Mechelsesteenweg 365,2020-02-15,14:00:00,108,72,36,FMN GV 05 Lier
60,Mechelsesteenweg 365,2020-02-15,15:00:00,88,38,50,FMN GV 05 Lier
60,Mechelsesteenweg 365,2020-02-15,16:00:00,56,26,30,FMN GV 05 Lier
60,Mechelsesteenweg 365,2020-02-15,17:00:00,54,34,20,FMN GV 05 Lier
60,Mechelsesteenweg 365,2020-02-15,18:00:00,18,10,8,FMN GV 05 Lier
60,Mechelsesteenweg 365,2020-02-15,19:00:00,4,4,0,FMN GV 05 Lier
60,Mechelsesteenweg 365,2020-02-15,20:00:00,4,2,2,FMN GV 05 Lier
60,Mechelsesteenweg 365,2020-02-15,21:00:00,6,4,2,FMN GV 05 Lier
60,Mechelsesteenweg 365,2020-02-15,22:00:00,2,2,0,FMN GV 05 Lier
60,Mechelsesteenweg 365,2020-02-15,23:00:00,4,0,4,FMN GV 05 Lier
60,Mechelsesteenweg 365,2020-02-16,00:00:00,2,2,0,FMN GV 05 Lier
60,Mechelsesteenweg 365,2020-02-16,01:00:00,0,0,0,FMN GV 05 Lier
60,Mechelsesteenweg 365,2020-02-16,02:00:00,2,0,2,FMN GV 05 Lier
60,Mechelsesteenweg 365,2020-02-16,03:00:00,2,2,0,FMN GV 05 Lier
60,Mechelsesteenweg 365,2020-02-16,04:00:00,0,0,0,FMN GV 05 Lier
60,Mechelsesteenweg 365,2020-02-16,05:00:00,0,0,0,FMN GV 05 Lier
60,Mechelsesteenweg 365,2020-02-16,06:00:00,2,2,0,FMN GV 05 Lier
60,Mechelsesteenweg 365,2020-02-16,07:00:00,0,0,0,FMN GV 05 Lier
60,Mechelsesteenweg 365,2020-02-16,08:00:00,0,0,0,FMN GV 05 Lier
60,Mechelsesteenweg 365,2020-02-16,09:00:00,4,2,2,FMN GV 05 Lier
60,Mechelsesteenweg 365,2020-02-16,10:00:00,28,14,14,FMN GV 05 Lier
60,Mechelsesteenweg 365,2020-02-16,11:00:00,16,10,6,FMN GV 05 Lier
60,Mechelsesteenweg 365,2020-02-16,12:00:00,22,14,8,FMN GV 05 Lier
60,Mechelsesteenweg 365,2020-02-16,13:00:00,12,8,4,FMN GV 05 Lier
60,Mechelsesteenweg 365,2020-02-16,14:00:00,8,0,8,FMN GV 05 Lier
60,Mechelsesteenweg 365,2020-02-16,15:00:00,16,10,6,FMN GV 05 Lier
60,Mechelsesteenweg 365,2020-02-16,16:00:00,6,6,0,FMN GV 05 Lier
60,Mechelsesteenweg 365,2020-02-16,17:00:00,10,8,2,FMN GV 05 Lier
60,Mechelsesteenweg 365,2020-02-16,18:00:00,2,2,0,FMN GV 05 Lier
60,Mechelsesteenweg 365,2020-02-16,19:00:00,2,2,0,FMN GV 05 Lier
60,Mechelsesteenweg 365,2020-02-16,20:00:00,0,0,0,FMN GV 05 Lier
60,Mechelsesteenweg 365,2020-02-16,21:00:00,0,0,0,FMN GV 05 Lier
60,Mechelsesteenweg 365,2020-02-16,22:00:00,4,2,2,FMN GV 05 Lier
60,Mechelsesteenweg 365,2020-02-16,23:00:00,0,0,0,FMN GV 05 Lier
60,Mechelsesteenweg 365,2020-02-17,00:00:00,0,0,0,FMN GV 05 Lier
60,Mechelsesteenweg 365,2020-02-17,01:00:00,0,0,0,FMN GV 05 Lier
60,Mechelsesteenweg 365,2020-02-17,02:00:00,0,0,0,FMN GV 05 Lier
60,Mechelsesteenweg 365,2020-02-17,03:00:00,0,0,0,FMN GV 05 Lier
60,Mechelsesteenweg 365,2020-02-17,04:00:00,0,0,0,FMN GV 05 Lier
60,Mechelsesteenweg 365,2020-02-17,05:00:00,8,0,8,FMN GV 05 Lier
60,Mechelsesteenweg 365,2020-02-17,06:00:00,14,4,10,FMN GV 05 Lier
60,Mechelsesteenweg 365,2020-02-17,07:00:00,132,70,62,FMN GV 05 Lier
60,Mechelsesteenweg 365,2020-02-17,08:00:00,94,58,36,FMN GV 05 Lier
60,Mechelsesteenweg 365,2020-02-17,09:00:00,44,32,12,FMN GV 05 Lier
60,Mechelsesteenweg 365,2020-02-17,10:00:00,32,26,6,FMN GV 05 Lier
60,Mechelsesteenweg 365,2020-02-17,11:00:00,54,26,28,FMN GV 05 Lier
60,Mechelsesteenweg 365,2020-02-17,12:00:00,50,24,26,FMN GV 05 Lier
60,Mechelsesteenweg 365,2020-02-17,13:00:00,28,14,14,FMN GV 05 Lier
60,Mechelsesteenweg 365,2020-02-17,14:00:00,28,12,16,FMN GV 05 Lier
60,Mechelsesteenweg 365,2020-02-17,15:00:00,50,30,20,FMN GV 05 Lier
60,Mechelsesteenweg 365,2020-02-17,16:00:00,174,52,122,FMN GV 05 Lier
60,Mechelsesteenweg 365,2020-02-17,17:00:00,90,56,34,FMN GV 05 Lier
60,Mechelsesteenweg 365,2020-02-17,18:00:00,32,22,10,FMN GV 05 Lier
60,Mechelsesteenweg 365,2020-02-17,19:00:00,6,6,0,FMN GV 05 Lier
60,Mechelsesteenweg 365,2020-02-17,20:00:00,4,4,0,FMN GV 05 Lier
60,Mechelsesteenweg 365,2020-02-17,21:00:00,4,0,4,FMN GV 05 Lier
60,Mechelsesteenweg 365,2020-02-17,22:00:00,4,2,2,FMN GV 05 Lier
60,Mechelsesteenweg 365,2020-02-17,23:00:00,2,2,0,FMN GV 05 Lier
60,Mechelsesteenweg 365,2020-02-18,00:00:00,0,0,0,FMN GV 05 Lier
60,Mechelsesteenweg 365,2020-02-18,01:00:00,0,0,0,FMN GV 05 Lier
60,Mechelsesteenweg 365,2020-02-18,02:00:00,0,0,0,FMN GV 05 Lier
60,Mechelsesteenweg 365,2020-02-18,03:00:00,0,0,0,FMN GV 05 Lier
60,Mechelsesteenweg 365,2020-02-18,04:00:00,0,0,0,FMN GV 05 Lier
60,Mechelsesteenweg 365,2020-02-18,05:00:00,6,0,6,FMN GV 05 Lier
60,Mechelsesteenweg 365,2020-02-18,06:00:00,26,4,22,FMN GV 05 Lier
60,Mechelsesteenweg 365,2020-02-18,07:00:00,154,78,76,FMN GV 05 Lier
60,Mechelsesteenweg 365,2020-02-18,08:00:00,110,70,40,FMN GV 05 Lier
60,Mechelsesteenweg 365,2020-02-18,09:00:00,58,32,26,FMN GV 05 Lier
60,Mechelsesteenweg 365,2020-02-18,10:00:00,82,46,36,FMN GV 05 Lier
60,Mechelsesteenweg 365,2020-02-18,11:00:00,58,30,28,FMN GV 05 Lier
60,Mechelsesteenweg 365,2020-02-18,12:00:00,46,24,22,FMN GV 05 Lier
60,Mechelsesteenweg 365,2020-02-18,13:00:00,50,22,28,FMN GV 05 Lier
60,Mechelsesteenweg 365,2020-02-18,14:00:00,48,34,14,FMN GV 05 Lier
60,Mechelsesteenweg 365,2020-02-18,15:00:00,74,36,38,FMN GV 05 Lier
60,Mechelsesteenweg 365,2020-02-18,16:00:00,180,58,122,FMN GV 05 Lier
60,Mechelsesteenweg 365,2020-02-18,17:00:00,132,76,56,FMN GV 05 Lier
60,Mechelsesteenweg 365,2020-02-18,18:00:00,64,38,26,FMN GV 05 Lier
60,Mechelsesteenweg 365,2020-02-18,19:00:00,14,4,10,FMN GV 05 Lier
60,Mechelsesteenweg 365,2020-02-18,20:00:00,6,4,2,FMN GV 05 Lier
60,Mechelsesteenweg 365,2020-02-18,21:00:00,10,6,4,FMN GV 05 Lier
60,Mechelsesteenweg 365,2020-02-18,22:00:00,2,2,0,FMN GV 05 Lier
60,Mechelsesteenweg 365,2020-02-18,23:00:00,0,0,0,FMN GV 05 Lier
60,Mechelsesteenweg 365,2020-02-19,00:00:00,0,0,0,FMN GV 05 Lier
60,Mechelsesteenweg 365,2020-02-19,01:00:00,0,0,0,FMN GV 05 Lier
60,Mechelsesteenweg 365,2020-02-19,02:00:00,0,0,0,FMN GV 05 Lier
60,Mechelsesteenweg 365,2020-02-19,03:00:00,0,0,0,FMN GV 05 Lier
60,Mechelsesteenweg 365,2020-02-19,04:00:00,0,0,0,FMN GV 05 Lier
60,Mechelsesteenweg 365,2020-02-19,05:00:00,6,0,6,FMN GV 05 Lier
60,Mechelsesteenweg 365,2020-02-19,06:00:00,16,4,12,FMN GV 05 Lier
60,Mechelsesteenweg 365,2020-02-19,07:00:00,146,74,72,FMN GV 05 Lier
60,Mechelsesteenweg 365,2020-02-19,08:00:00,110,78,32,FMN GV 05 Lier
60,Mechelsesteenweg 365,2020-02-19,09:00:00,44,28,16,FMN GV 05 Lier
60,Mechelsesteenweg 365,2020-02-19,10:00:00,46,32,14,FMN GV 05 Lier
60,Mechelsesteenweg 365,2020-02-19,11:00:00,64,14,50,FMN GV 05 Lier
60,Mechelsesteenweg 365,2020-02-19,12:00:00,146,30,116,FMN GV 05 Lier
60,Mechelsesteenweg 365,2020-02-19,13:00:00,80,32,48,FMN GV 05 Lier
60,Mechelsesteenweg 365,2020-02-19,14:00:00,64,30,34,FMN GV 05 Lier
60,Mechelsesteenweg 365,2020-02-19,15:00:00,128,86,42,FMN GV 05 Lier
60,Mechelsesteenweg 365,2020-02-19,16:00:00,88,52,36,FMN GV 05 Lier
60,Mechelsesteenweg 365,2020-02-19,17:00:00,102,64,38,FMN GV 05 Lier
60,Mechelsesteenweg 365,2020-02-19,18:00:00,46,28,18,FMN GV 05 Lier
60,Mechelsesteenweg 365,2020-02-19,19:00:00,18,10,8,FMN GV 05 Lier
60,Mechelsesteenweg 365,2020-02-19,20:00:00,10,6,4,FMN GV 05 Lier
60,Mechelsesteenweg 365,2020-02-19,21:00:00,12,2,10,FMN GV 05 Lier
60,Mechelsesteenweg 365,2020-02-19,22:00:00,2,2,0,FMN GV 05 Lier
60,Mechelsesteenweg 365,2020-02-19,23:00:00,0,0,0,FMN GV 05 Lier
60,Mechelsesteenweg 365,2020-02-20,00:00:00,2,2,0,FMN GV 05 Lier
60,Mechelsesteenweg 365,2020-02-20,01:00:00,0,0,0,FMN GV 05 Lier
60,Mechelsesteenweg 365,2020-02-20,02:00:00,0,0,0,FMN GV 05 Lier
60,Mechelsesteenweg 365,2020-02-20,03:00:00,0,0,0,FMN GV 05 Lier
60,Mechelsesteenweg 365,2020-02-20,04:00:00,0,0,0,FMN GV 05 Lier
60,Mechelsesteenweg 365,2020-02-20,05:00:00,4,0,4,FMN GV 05 Lier
60,Mechelsesteenweg 365,2020-02-20,06:00:00,22,2,20,FMN GV 05 Lier
60,Mechelsesteenweg 365,2020-02-20,07:00:00,148,82,66,FMN GV 05 Lier
60,Mechelsesteenweg 365,2020-02-20,08:00:00,110,72,38,FMN GV 05 Lier
60,Mechelsesteenweg 365,2020-02-20,09:00:00,60,42,18,FMN GV 05 Lier
60,Mechelsesteenweg 365,2020-02-20,10:00:00,42,26,16,FMN GV 05 Lier
60,Mechelsesteenweg 365,2020-02-20,11:00:00,28,12,16,FMN GV 05 Lier
60,Mechelsesteenweg 365,2020-02-20,12:00:00,30,14,16,FMN GV 05 Lier
60,Mechelsesteenweg 365,2020-02-20,13:00:00,30,20,10,FMN GV 05 Lier
60,Mechelsesteenweg 365,2020-02-20,14:00:00,82,44,38,FMN GV 05 Lier
60,Mechelsesteenweg 365,2020-02-20,15:00:00,60,38,22,FMN GV 05 Lier
60,Mechelsesteenweg 365,2020-02-20,16:00:00,176,58,118,FMN GV 05 Lier
60,Mechelsesteenweg 365,2020-02-20,17:00:00,88,58,30,FMN GV 05 Lier
60,Mechelsesteenweg 365,2020-02-20,18:00:00,34,16,18,FMN GV 05 Lier
60,Mechelsesteenweg 365,2020-02-20,19:00:00,4,4,0,FMN GV 05 Lier
60,Mechelsesteenweg 365,2020-02-20,20:00:00,8,2,6,FMN GV 05 Lier
60,Mechelsesteenweg 365,2020-02-20,21:00:00,6,4,2,FMN GV 05 Lier
60,Mechelsesteenweg 365,2020-02-20,22:00:00,4,4,0,FMN GV 05 Lier
60,Mechelsesteenweg 365,2020-02-20,23:00:00,0,0,0,FMN GV 05 Lier
60,Mechelsesteenweg 365,2020-02-21,00:00:00,0,0,0,FMN GV 05 Lier
60,Mechelsesteenweg 365,2020-02-21,01:00:00,0,0,0,FMN GV 05 Lier
60,Mechelsesteenweg 365,2020-02-21,02:00:00,0,0,0,FMN GV 05 Lier
60,Mechelsesteenweg 365,2020-02-21,03:00:00,0,0,0,FMN GV 05 Lier
60,Mechelsesteenweg 365,2020-02-21,04:00:00,0,0,0,FMN GV 05 Lier
60,Mechelsesteenweg 365,2020-02-21,05:00:00,0,0,0,FMN GV 05 Lier
60,Mechelsesteenweg 365,2020-02-21,06:00:00,14,0,14,FMN GV 05 Lier
60,Mechelsesteenweg 365,2020-02-21,07:00:00,136,70,66,FMN GV 05 Lier
60,Mechelsesteenweg 365,2020-02-21,08:00:00,120,78,42,FMN GV 05 Lier
60,Mechelsesteenweg 365,2020-02-21,09:00:00,60,38,22,FMN GV 05 Lier
60,Mechelsesteenweg 365,2020-02-21,10:00:00,78,48,30,FMN GV 05 Lier
60,Mechelsesteenweg 365,2020-02-21,11:00:00,106,56,50,FMN GV 05 Lier
60,Mechelsesteenweg 365,2020-02-21,12:00:00,64,24,40,FMN GV 05 Lier
60,Mechelsesteenweg 365,2020-02-21,13:00:00,104,66,38,FMN GV 05 Lier
60,Mechelsesteenweg 365,2020-02-21,14:00:00,102,56,46,FMN GV 05 Lier
60,Mechelsesteenweg 365,2020-02-21,15:00:00,124,60,64,FMN GV 05 Lier
60,Mechelsesteenweg 365,2020-02-21,16:00:00,194,76,118,FMN GV 05 Lier
60,Mechelsesteenweg 365,2020-02-21,17:00:00,86,52,34,FMN GV 05 Lier
60,Mechelsesteenweg 365,2020-02-21,18:00:00,36,22,14,FMN GV 05 Lier
60,Mechelsesteenweg 365,2020-02-21,19:00:00,10,4,6,FMN GV 05 Lier
60,Mechelsesteenweg 365,2020-02-21,20:00:00,8,4,4,FMN GV 05 Lier
60,Mechelsesteenweg 365,2020-02-21,21:00:00,8,2,6,FMN GV 05 Lier
60,Mechelsesteenweg 365,2020-02-21,22:00:00,6,4,2,FMN GV 05 Lier
60,Mechelsesteenweg 365,2020-02-21,23:00:00,10,2,8,FMN GV 05 Lier
60,Mechelsesteenweg 365,2020-02-22,00:00:00,8,0,8,FMN GV 05 Lier
60,Mechelsesteenweg 365,2020-02-22,01:00:00,6,4,2,FMN GV 05 Lier
60,Mechelsesteenweg 365,2020-02-22,02:00:00,2,0,2,FMN GV 05 Lier
60,Mechelsesteenweg 365,2020-02-22,03:00:00,0,0,0,FMN GV 05 Lier
60,Mechelsesteenweg 365,2020-02-22,04:00:00,0,0,0,FMN GV 05 Lier
60,Mechelsesteenweg 365,2020-02-22,05:00:00,0,0,0,FMN GV 05 Lier
60,Mechelsesteenweg 365,2020-02-22,06:00:00,14,2,12,FMN GV 05 Lier
60,Mechelsesteenweg 365,2020-02-22,07:00:00,10,8,2,FMN GV 05 Lier
60,Mechelsesteenweg 365,2020-02-22,08:00:00,12,2,10,FMN GV 05 Lier
60,Mechelsesteenweg 365,2020-02-22,09:00:00,54,26,28,FMN GV 05 Lier
60,Mechelsesteenweg 365,2020-02-22,10:00:00,80,40,40,FMN GV 05 Lier
60,Mechelsesteenweg 365,2020-02-22,11:00:00,92,46,46,FMN GV 05 Lier
60,Mechelsesteenweg 365,2020-02-22,12:00:00,74,48,26,FMN GV 05 Lier
60,Mechelsesteenweg 365,2020-02-22,13:00:00,48,26,22,FMN GV 05 Lier
60,Mechelsesteenweg 365,2020-02-22,14:00:00,58,28,30,FMN GV 05 Lier
60,Mechelsesteenweg 365,2020-02-22,15:00:00,28,26,2,FMN GV 05 Lier
60,Mechelsesteenweg 365,2020-02-22,16:00:00,30,8,22,FMN GV 05 Lier
60,Mechelsesteenweg 365,2020-02-22,17:00:00,14,6,8,FMN GV 05 Lier
60,Mechelsesteenweg 365,2020-02-22,18:00:00,6,2,4,FMN GV 05 Lier
60,Mechelsesteenweg 365,2020-02-22,19:00:00,8,6,2,FMN GV 05 Lier
60,Mechelsesteenweg 365,2020-02-22,20:00:00,4,4,0,FMN GV 05 Lier
60,Mechelsesteenweg 365,2020-02-22,21:00:00,0,0,0,FMN GV 05 Lier
60,Mechelsesteenweg 365,2020-02-22,22:00:00,4,2,2,FMN GV 05 Lier
60,Mechelsesteenweg 365,2020-02-22,23:00:00,0,0,0,FMN GV 05 Lier
60,Mechelsesteenweg 365,2020-02-23,00:00:00,4,0,4,FMN GV 05 Lier
60,Mechelsesteenweg 365,2020-02-23,01:00:00,0,0,0,FMN GV 05 Lier
60,Mechelsesteenweg 365,2020-02-23,02:00:00,0,0,0,FMN GV 05 Lier
60,Mechelsesteenweg 365,2020-02-23,03:00:00,0,0,0,FMN GV 05 Lier
60,Mechelsesteenweg 365,2020-02-23,04:00:00,0,0,0,FMN GV 05 Lier
60,Mechelsesteenweg 365,2020-02-23,05:00:00,0,0,0,FMN GV 05 Lier
60,Mechelsesteenweg 365,2020-02-23,06:00:00,0,0,0,FMN GV 05 Lier
60,Mechelsesteenweg 365,2020-02-23,07:00:00,0,0,0,FMN GV 05 Lier
60,Mechelsesteenweg 365,2020-02-23,08:00:00,0,0,0,FMN GV 05 Lier
60,Mechelsesteenweg 365,2020-02-23,09:00:00,12,4,8,FMN GV 05 Lier
60,Mechelsesteenweg 365,2020-02-23,10:00:00,42,24,18,FMN GV 05 Lier
60,Mechelsesteenweg 365,2020-02-23,11:00:00,8,4,4,FMN GV 05 Lier
60,Mechelsesteenweg 365,2020-02-23,12:00:00,16,12,4,FMN GV 05 Lier
60,Mechelsesteenweg 365,2020-02-23,13:00:00,6,6,0,FMN GV 05 Lier
60,Mechelsesteenweg 365,2020-02-23,14:00:00,6,2,4,FMN GV 05 Lier
60,Mechelsesteenweg 365,2020-02-23,15:00:00,8,4,4,FMN GV 05 Lier
60,Mechelsesteenweg 365,2020-02-23,16:00:00,4,0,4,FMN GV 05 Lier
60,Mechelsesteenweg 365,2020-02-23,17:00:00,4,2,2,FMN GV 05 Lier
60,Mechelsesteenweg 365,2020-02-23,18:00:00,4,2,2,FMN GV 05 Lier
60,Mechelsesteenweg 365,2020-02-23,19:00:00,2,2,0,FMN GV 05 Lier
60,Mechelsesteenweg 365,2020-02-23,20:00:00,0,0,0,FMN GV 05 Lier
60,Mechelsesteenweg 365,2020-02-23,21:00:00,0,0,0,FMN GV 05 Lier
60,Mechelsesteenweg 365,2020-02-23,22:00:00,4,2,2,FMN GV 05 Lier
60,Mechelsesteenweg 365,2020-02-23,23:00:00,0,0,0,FMN GV 05 Lier
60,Mechelsesteenweg 365,2020-02-24,00:00:00,0,0,0,FMN GV 05 Lier
60,Mechelsesteenweg 365,2020-02-24,01:00:00,0,0,0,FMN GV 05 Lier
60,Mechelsesteenweg 365,2020-02-24,02:00:00,0,0,0,FMN GV 05 Lier
60,Mechelsesteenweg 365,2020-02-24,03:00:00,0,0,0,FMN GV 05 Lier
60,Mechelsesteenweg 365,2020-02-24,04:00:00,0,0,0,FMN GV 05 Lier
60,Mechelsesteenweg 365,2020-02-24,05:00:00,2,0,2,FMN GV 05 Lier
60,Mechelsesteenweg 365,2020-02-24,06:00:00,10,0,10,FMN GV 05 Lier
60,Mechelsesteenweg 365,2020-02-24,07:00:00,48,8,40,FMN GV 05 Lier
60,Mechelsesteenweg 365,2020-02-24,08:00:00,34,16,18,FMN GV 05 Lier
60,Mechelsesteenweg 365,2020-02-24,09:00:00,12,4,8,FMN GV 05 Lier
60,Mechelsesteenweg 365,2020-02-24,10:00:00,10,2,8,FMN GV 05 Lier
60,Mechelsesteenweg 365,2020-02-24,11:00:00,18,8,10,FMN GV 05 Lier
60,Mechelsesteenweg 365,2020-02-24,12:00:00,16,8,8,FMN GV 05 Lier
60,Mechelsesteenweg 365,2020-02-24,13:00:00,20,14,6,FMN GV 05 Lier
60,Mechelsesteenweg 365,2020-02-24,14:00:00,20,14,6,FMN GV 05 Lier
60,Mechelsesteenweg 365,2020-02-24,15:00:00,26,16,10,FMN GV 05 Lier
60,Mechelsesteenweg 365,2020-02-24,16:00:00,40,30,10,FMN GV 05 Lier
60,Mechelsesteenweg 365,2020-02-24,17:00:00,58,34,24,FMN GV 05 Lier
60,Mechelsesteenweg 365,2020-02-24,18:00:00,12,8,4,FMN GV 05 Lier
60,Mechelsesteenweg 365,2020-02-24,19:00:00,14,8,6,FMN GV 05 Lier
60,Mechelsesteenweg 365,2020-02-24,20:00:00,4,4,0,FMN GV 05 Lier
60,Mechelsesteenweg 365,2020-02-24,21:00:00,6,2,4,FMN GV 05 Lier
60,Mechelsesteenweg 365,2020-02-24,22:00:00,0,0,0,FMN GV 05 Lier
60,Mechelsesteenweg 365,2020-02-24,23:00:00,0,0,0,FMN GV 05 Lier
60,Mechelsesteenweg 365,2020-02-25,00:00:00,0,0,0,FMN GV 05 Lier
60,Mechelsesteenweg 365,2020-02-25,01:00:00,0,0,0,FMN GV 05 Lier
60,Mechelsesteenweg 365,2020-02-25,02:00:00,0,0,0,FMN GV 05 Lier
60,Mechelsesteenweg 365,2020-02-25,03:00:00,0,0,0,FMN GV 05 Lier
60,Mechelsesteenweg 365,2020-02-25,04:00:00,0,0,0,FMN GV 05 Lier
60,Mechelsesteenweg 365,2020-02-25,05:00:00,6,0,6,FMN GV 05 Lier
60,Mechelsesteenweg 365,2020-02-25,06:00:00,16,2,14,FMN GV 05 Lier
60,Mechelsesteenweg 365,2020-02-25,07:00:00,64,20,44,FMN GV 05 Lier
60,Mechelsesteenweg 365,2020-02-25,08:00:00,54,22,32,FMN GV 05 Lier
60,Mechelsesteenweg 365,2020-02-25,09:00:00,58,28,30,FMN GV 05 Lier
60,Mechelsesteenweg 365,2020-02-25,10:00:00,138,72,66,FMN GV 05 Lier
60,Mechelsesteenweg 365,2020-02-25,11:00:00,94,48,46,FMN GV 05 Lier
60,Mechelsesteenweg 365,2020-02-25,12:00:00,62,32,30,FMN GV 05 Lier
60,Mechelsesteenweg 365,2020-02-25,13:00:00,54,36,18,FMN GV 05 Lier
60,Mechelsesteenweg 365,2020-02-25,14:00:00,32,20,12,FMN GV 05 Lier
60,Mechelsesteenweg 365,2020-02-25,15:00:00,28,18,10,FMN GV 05 Lier
60,Mechelsesteenweg 365,2020-02-25,16:00:00,30,18,12,FMN GV 05 Lier
60,Mechelsesteenweg 365,2020-02-25,17:00:00,64,48,16,FMN GV 05 Lier
60,Mechelsesteenweg 365,2020-02-25,18:00:00,26,20,6,FMN GV 05 Lier
60,Mechelsesteenweg 365,2020-02-25,19:00:00,6,4,2,FMN GV 05 Lier
60,Mechelsesteenweg 365,2020-02-25,20:00:00,10,4,6,FMN GV 05 Lier
60,Mechelsesteenweg 365,2020-02-25,21:00:00,6,2,4,FMN GV 05 Lier
60,Mechelsesteenweg 365,2020-02-25,22:00:00,4,4,0,FMN GV 05 Lier
60,Mechelsesteenweg 365,2020-02-25,23:00:00,2,2,0,FMN GV 05 Lier
60,Mechelsesteenweg 365,2020-02-26,00:00:00,0,0,0,FMN GV 05 Lier
60,Mechelsesteenweg 365,2020-02-26,01:00:00,0,0,0,FMN GV 05 Lier
60,Mechelsesteenweg 365,2020-02-26,02:00:00,0,0,0,FMN GV 05 Lier
60,Mechelsesteenweg 365,2020-02-26,03:00:00,0,0,0,FMN GV 05 Lier
60,Mechelsesteenweg 365,2020-02-26,04:00:00,0,0,0,FMN GV 05 Lier
60,Mechelsesteenweg 365,2020-02-26,05:00:00,2,0,2,FMN GV 05 Lier
60,Mechelsesteenweg 365,2020-02-26,06:00:00,8,2,6,FMN GV 05 Lier
60,Mechelsesteenweg 365,2020-02-26,07:00:00,46,10,36,FMN GV 05 Lier
60,Mechelsesteenweg 365,2020-02-26,08:00:00,22,4,18,FMN GV 05 Lier
60,Mechelsesteenweg 365,2020-02-26,09:00:00,10,8,2,FMN GV 05 Lier
60,Mechelsesteenweg 365,2020-02-26,10:00:00,2,2,0,FMN GV 05 Lier
60,Mechelsesteenweg 365,2020-02-26,11:00:00,22,8,14,FMN GV 05 Lier
60,Mechelsesteenweg 365,2020-02-26,12:00:00,4,2,2,FMN GV 05 Lier
60,Mechelsesteenweg 365,2020-02-26,13:00:00,16,10,6,FMN GV 05 Lier
60,Mechelsesteenweg 365,2020-02-26,14:00:00,18,14,4,FMN GV 05 Lier
60,Mechelsesteenweg 365,2020-02-26,15:00:00,20,14,6,FMN GV 05 Lier
60,Mechelsesteenweg 365,2020-02-26,16:00:00,34,18,16,FMN GV 05 Lier
60,Mechelsesteenweg 365,2020-02-26,17:00:00,52,32,20,FMN GV 05 Lier
60,Mechelsesteenweg 365,2020-02-26,18:00:00,20,16,4,FMN GV 05 Lier
60,Mechelsesteenweg 365,2020-02-26,19:00:00,2,2,0,FMN GV 05 Lier
60,Mechelsesteenweg 365,2020-02-26,20:00:00,8,8,0,FMN GV 05 Lier
60,Mechelsesteenweg 365,2020-02-26,21:00:00,14,6,8,FMN GV 05 Lier
60,Mechelsesteenweg 365,2020-02-26,22:00:00,0,0,0,FMN GV 05 Lier
60,Mechelsesteenweg 365,2020-02-26,23:00:00,0,0,0,FMN GV 05 Lier
60,Mechelsesteenweg 365,2020-02-27,00:00:00,0,0,0,FMN GV 05 Lier
60,Mechelsesteenweg 365,2020-02-27,01:00:00,0,0,0,FMN GV 05 Lier
60,Mechelsesteenweg 365,2020-02-27,02:00:00,0,0,0,FMN GV 05 Lier
60,Mechelsesteenweg 365,2020-02-27,03:00:00,0,0,0,FMN GV 05 Lier
60,Mechelsesteenweg 365,2020-02-27,04:00:00,0,0,0,FMN GV 05 Lier
60,Mechelsesteenweg 365,2020-02-27,05:00:00,0,0,0,FMN GV 05 Lier
60,Mechelsesteenweg 365,2020-02-27,06:00:00,12,2,10,FMN GV 05 Lier
60,Mechelsesteenweg 365,2020-02-27,07:00:00,44,6,38,FMN GV 05 Lier
60,Mechelsesteenweg 365,2020-02-27,08:00:00,16,4,12,FMN GV 05 Lier
60,Mechelsesteenweg 365,2020-02-27,09:00:00,8,8,0,FMN GV 05 Lier
60,Mechelsesteenweg 365,2020-02-27,10:00:00,8,2,6,FMN GV 05 Lier
60,Mechelsesteenweg 365,2020-02-27,11:00:00,10,6,4,FMN GV 05 Lier
60,Mechelsesteenweg 365,2020-02-27,12:00:00,10,10,0,FMN GV 05 Lier
60,Mechelsesteenweg 365,2020-02-27,13:00:00,6,2,4,FMN GV 05 Lier
60,Mechelsesteenweg 365,2020-02-27,14:00:00,4,2,2,FMN GV 05 Lier
60,Mechelsesteenweg 365,2020-02-27,15:00:00,6,6,0,FMN GV 05 Lier
60,Mechelsesteenweg 365,2020-02-27,16:00:00,20,12,8,FMN GV 05 Lier
60,Mechelsesteenweg 365,2020-02-27,17:00:00,38,28,10,FMN GV 05 Lier
60,Mechelsesteenweg 365,2020-02-27,18:00:00,16,14,2,FMN GV 05 Lier
60,Mechelsesteenweg 365,2020-02-27,19:00:00,8,4,4,FMN GV 05 Lier
60,Mechelsesteenweg 365,2020-02-27,20:00:00,4,4,0,FMN GV 05 Lier
60,Mechelsesteenweg 365,2020-02-27,21:00:00,2,0,2,FMN GV 05 Lier
60,Mechelsesteenweg 365,2020-02-27,22:00:00,4,2,2,FMN GV 05 Lier
60,Mechelsesteenweg 365,2020-02-27,23:00:00,2,0,2,FMN GV 05 Lier
60,Mechelsesteenweg 365,2020-02-28,00:00:00,0,0,0,FMN GV 05 Lier
60,Mechelsesteenweg 365,2020-02-28,01:00:00,0,0,0,FMN GV 05 Lier
60,Mechelsesteenweg 365,2020-02-28,02:00:00,0,0,0,FMN GV 05 Lier
60,Mechelsesteenweg 365,2020-02-28,03:00:00,0,0,0,FMN GV 05 Lier
60,Mechelsesteenweg 365,2020-02-28,04:00:00,0,0,0,FMN GV 05 Lier
60,Mechelsesteenweg 365,2020-02-28,05:00:00,2,0,2,FMN GV 05 Lier
60,Mechelsesteenweg 365,2020-02-28,06:00:00,6,2,4,FMN GV 05 Lier
60,Mechelsesteenweg 365,2020-02-28,07:00:00,24,6,18,FMN GV 05 Lier
60,Mechelsesteenweg 365,2020-02-28,08:00:00,32,12,20,FMN GV 05 Lier
60,Mechelsesteenweg 365,2020-02-28,09:00:00,48,20,28,FMN GV 05 Lier
60,Mechelsesteenweg 365,2020-02-28,10:00:00,68,42,26,FMN GV 05 Lier
60,Mechelsesteenweg 365,2020-02-28,11:00:00,66,22,44,FMN GV 05 Lier
60,Mechelsesteenweg 365,2020-02-28,12:00:00,74,40,34,FMN GV 05 Lier
60,Mechelsesteenweg 365,2020-02-28,13:00:00,80,50,30,FMN GV 05 Lier
60,Mechelsesteenweg 365,2020-02-28,14:00:00,68,34,34,FMN GV 05 Lier
60,Mechelsesteenweg 365,2020-02-28,15:00:00,52,32,20,FMN GV 05 Lier
60,Mechelsesteenweg 365,2020-02-28,16:00:00,30,20,10,FMN GV 05 Lier
60,Mechelsesteenweg 365,2020-02-28,17:00:00,16,12,4,FMN GV 05 Lier
60,Mechelsesteenweg 365,2020-02-28,18:00:00,6,6,0,FMN GV 05 Lier
60,Mechelsesteenweg 365,2020-02-28,19:00:00,44,40,4,FMN GV 05 Lier
60,Mechelsesteenweg 365,2020-02-28,20:00:00,6,4,2,FMN GV 05 Lier
60,Mechelsesteenweg 365,2020-02-28,21:00:00,12,8,4,FMN GV 05 Lier
60,Mechelsesteenweg 365,2020-02-28,22:00:00,8,6,2,FMN GV 05 Lier
60,Mechelsesteenweg 365,2020-02-28,23:00:00,12,10,2,FMN GV 05 Lier
60,Mechelsesteenweg 365,2020-02-29,00:00:00,0,0,0,FMN GV 05 Lier
60,Mechelsesteenweg 365,2020-02-29,01:00:00,0,0,0,FMN GV 05 Lier
60,Mechelsesteenweg 365,2020-02-29,02:00:00,2,0,2,FMN GV 05 Lier
60,Mechelsesteenweg 365,2020-02-29,03:00:00,8,0,8,FMN GV 05 Lier
60,Mechelsesteenweg 365,2020-02-29,04:00:00,2,0,2,FMN GV 05 Lier
60,Mechelsesteenweg 365,2020-02-29,05:00:00,0,0,0,FMN GV 05 Lier
60,Mechelsesteenweg 365,2020-02-29,06:00:00,2,0,2,FMN GV 05 Lier
60,Mechelsesteenweg 365,2020-02-29,07:00:00,8,6,2,FMN GV 05 Lier
60,Mechelsesteenweg 365,2020-02-29,08:00:00,14,4,10,FMN GV 05 Lier
60,Mechelsesteenweg 365,2020-02-29,09:00:00,92,38,54,FMN GV 05 Lier
60,Mechelsesteenweg 365,2020-02-29,10:00:00,144,88,56,FMN GV 05 Lier
60,Mechelsesteenweg 365,2020-02-29,11:00:00,126,66,60,FMN GV 05 Lier
60,Mechelsesteenweg 365,2020-02-29,12:00:00,38,28,10,FMN GV 05 Lier
60,Mechelsesteenweg 365,2020-02-29,13:00:00,32,28,4,FMN GV 05 Lier
60,Mechelsesteenweg 365,2020-02-29,14:00:00,4,4,0,FMN GV 05 Lier
60,Mechelsesteenweg 365,2020-02-29,15:00:00,6,4,2,FMN GV 05 Lier
60,Mechelsesteenweg 365,2020-02-29,16:00:00,14,10,4,FMN GV 05 Lier
60,Mechelsesteenweg 365,2020-02-29,17:00:00,28,16,12,FMN GV 05 Lier
60,Mechelsesteenweg 365,2020-02-29,18:00:00,14,6,8,FMN GV 05 Lier
60,Mechelsesteenweg 365,2020-02-29,19:00:00,8,4,4,FMN GV 05 Lier
60,Mechelsesteenweg 365,2020-02-29,20:00:00,2,0,2,FMN GV 05 Lier
60,Mechelsesteenweg 365,2020-02-29,21:00:00,0,0,0,FMN GV 05 Lier
60,Mechelsesteenweg 365,2020-02-29,22:00:00,4,0,4,FMN GV 05 Lier
60,Mechelsesteenweg 365,2020-02-29,23:00:00,4,2,2,FMN GV 05 Lier
60,Mechelsesteenweg 365,2020-03-01,00:00:00,0,0,0,FMN GV 05 Lier
60,Mechelsesteenweg 365,2020-03-01,01:00:00,0,0,0,FMN GV 05 Lier
60,Mechelsesteenweg 365,2020-03-01,02:00:00,0,0,0,FMN GV 05 Lier
60,Mechelsesteenweg 365,2020-03-01,03:00:00,0,0,0,FMN GV 05 Lier
60,Mechelsesteenweg 365,2020-03-01,04:00:00,0,0,0,FMN GV 05 Lier
60,Mechelsesteenweg 365,2020-03-01,05:00:00,0,0,0,FMN GV 05 Lier
60,Mechelsesteenweg 365,2020-03-01,06:00:00,0,0,0,FMN GV 05 Lier
60,Mechelsesteenweg 365,2020-03-01,07:00:00,4,2,2,FMN GV 05 Lier
60,Mechelsesteenweg 365,2020-03-01,08:00:00,22,4,18,FMN GV 05 Lier
60,Mechelsesteenweg 365,2020-03-01,09:00:00,82,34,48,FMN GV 05 Lier
60,Mechelsesteenweg 365,2020-03-01,10:00:00,120,62,58,FMN GV 05 Lier
60,Mechelsesteenweg 365,2020-03-01,11:00:00,130,52,78,FMN GV 05 Lier
60,Mechelsesteenweg 365,2020-03-01,12:00:00,112,44,68,FMN GV 05 Lier
60,Mechelsesteenweg 365,2020-03-01,13:00:00,56,24,32,FMN GV 05 Lier
60,Mechelsesteenweg 365,2020-03-01,14:00:00,94,48,46,FMN GV 05 Lier
60,Mechelsesteenweg 365,2020-03-01,15:00:00,40,20,20,FMN GV 05 Lier
60,Mechelsesteenweg 365,2020-03-01,16:00:00,34,20,14,FMN GV 05 Lier
60,Mechelsesteenweg 365,2020-03-01,17:00:00,44,22,22,FMN GV 05 Lier
60,Mechelsesteenweg 365,2020-03-01,18:00:00,34,22,12,FMN GV 05 Lier
60,Mechelsesteenweg 365,2020-03-01,19:00:00,2,2,0,FMN GV 05 Lier
60,Mechelsesteenweg 365,2020-03-01,20:00:00,4,2,2,FMN GV 05 Lier
60,Mechelsesteenweg 365,2020-03-01,21:00:00,2,0,2,FMN GV 05 Lier
60,Mechelsesteenweg 365,2020-03-01,22:00:00,0,0,0,FMN GV 05 Lier
60,Mechelsesteenweg 365,2020-03-01,23:00:00,6,0,6,FMN GV 05 Lier
60,Mechelsesteenweg 365,2020-03-02,00:00:00,0,0,0,FMN GV 05 Lier
60,Mechelsesteenweg 365,2020-03-02,01:00:00,0,0,0,FMN GV 05 Lier
60,Mechelsesteenweg 365,2020-03-02,02:00:00,0,0,0,FMN GV 05 Lier
60,Mechelsesteenweg 365,2020-03-02,03:00:00,0,0,0,FMN GV 05 Lier
60,Mechelsesteenweg 365,2020-03-02,04:00:00,2,0,2,FMN GV 05 Lier
60,Mechelsesteenweg 365,2020-03-02,05:00:00,8,2,6,FMN GV 05 Lier
60,Mechelsesteenweg 365,2020-03-02,06:00:00,12,2,10,FMN GV 05 Lier
60,Mechelsesteenweg 365,2020-03-02,07:00:00,128,70,58,FMN GV 05 Lier
60,Mechelsesteenweg 365,2020-03-02,08:00:00,110,82,28,FMN GV 05 Lier
60,Mechelsesteenweg 365,2020-03-02,09:00:00,38,22,16,FMN GV 05 Lier
60,Mechelsesteenweg 365,2020-03-02,10:00:00,16,6,10,FMN GV 05 Lier
60,Mechelsesteenweg 365,2020-03-02,11:00:00,16,2,14,FMN GV 05 Lier
60,Mechelsesteenweg 365,2020-03-02,12:00:00,26,12,14,FMN GV 05 Lier
60,Mechelsesteenweg 365,2020-03-02,13:00:00,22,8,14,FMN GV 05 Lier
60,Mechelsesteenweg 365,2020-03-02,14:00:00,14,4,10,FMN GV 05 Lier
60,Mechelsesteenweg 365,2020-03-02,15:00:00,38,24,14,FMN GV 05 Lier
60,Mechelsesteenweg 365,2020-03-02,16:00:00,152,36,116,FMN GV 05 Lier
60,Mechelsesteenweg 365,2020-03-02,17:00:00,80,56,24,FMN GV 05 Lier
60,Mechelsesteenweg 365,2020-03-02,18:00:00,26,18,8,FMN GV 05 Lier
60,Mechelsesteenweg 365,2020-03-02,19:00:00,4,2,2,FMN GV 05 Lier
60,Mechelsesteenweg 365,2020-03-02,20:00:00,6,4,2,FMN GV 05 Lier
60,Mechelsesteenweg 365,2020-03-02,21:00:00,0,0,0,FMN GV 05 Lier
60,Mechelsesteenweg 365,2020-03-02,22:00:00,8,4,4,FMN GV 05 Lier
60,Mechelsesteenweg 365,2020-03-02,23:00:00,0,0,0,FMN GV 05 Lier
60,Mechelsesteenweg 365,2020-03-03,00:00:00,2,2,0,FMN GV 05 Lier
60,Mechelsesteenweg 365,2020-03-03,01:00:00,0,0,0,FMN GV 05 Lier
60,Mechelsesteenweg 365,2020-03-03,02:00:00,0,0,0,FMN GV 05 Lier
60,Mechelsesteenweg 365,2020-03-03,03:00:00,0,0,0,FMN GV 05 Lier
60,Mechelsesteenweg 365,2020-03-03,04:00:00,0,0,0,FMN GV 05 Lier
60,Mechelsesteenweg 365,2020-03-03,05:00:00,10,2,8,FMN GV 05 Lier
60,Mechelsesteenweg 365,2020-03-03,06:00:00,18,4,14,FMN GV 05 Lier
60,Mechelsesteenweg 365,2020-03-03,07:00:00,162,96,66,FMN GV 05 Lier
60,Mechelsesteenweg 365,2020-03-03,08:00:00,102,60,42,FMN GV 05 Lier
60,Mechelsesteenweg 365,2020-03-03,09:00:00,110,88,22,FMN GV 05 Lier
60,Mechelsesteenweg 365,2020-03-03,10:00:00,110,78,32,FMN GV 05 Lier
60,Mechelsesteenweg 365,2020-03-03,11:00:00,102,50,52,FMN GV 05 Lier
60,Mechelsesteenweg 365,2020-03-03,12:00:00,92,48,44,FMN GV 05 Lier
60,Mechelsesteenweg 365,2020-03-03,13:00:00,114,42,72,FMN GV 05 Lier
60,Mechelsesteenweg 365,2020-03-03,14:00:00,116,58,58,FMN GV 05 Lier
60,Mechelsesteenweg 365,2020-03-03,15:00:00,88,42,46,FMN GV 05 Lier
60,Mechelsesteenweg 365,2020-03-03,16:00:00,180,48,132,FMN GV 05 Lier
60,Mechelsesteenweg 365,2020-03-03,17:00:00,92,60,32,FMN GV 05 Lier
60,Mechelsesteenweg 365,2020-03-03,18:00:00,44,32,12,FMN GV 05 Lier
60,Mechelsesteenweg 365,2020-03-03,19:00:00,18,6,12,FMN GV 05 Lier
60,Mechelsesteenweg 365,2020-03-03,20:00:00,6,0,6,FMN GV 05 Lier
60,Mechelsesteenweg 365,2020-03-03,21:00:00,4,4,0,FMN GV 05 Lier
60,Mechelsesteenweg 365,2020-03-03,22:00:00,8,8,0,FMN GV 05 Lier
60,Mechelsesteenweg 365,2020-03-03,23:00:00,0,0,0,FMN GV 05 Lier
60,Mechelsesteenweg 365,2020-03-04,00:00:00,0,0,0,FMN GV 05 Lier
60,Mechelsesteenweg 365,2020-03-04,01:00:00,2,0,2,FMN GV 05 Lier
60,Mechelsesteenweg 365,2020-03-04,02:00:00,0,0,0,FMN GV 05 Lier
60,Mechelsesteenweg 365,2020-03-04,03:00:00,0,0,0,FMN GV 05 Lier
60,Mechelsesteenweg 365,2020-03-04,04:00:00,0,0,0,FMN GV 05 Lier
60,Mechelsesteenweg 365,2020-03-04,05:00:00,6,2,4,FMN GV 05 Lier
60,Mechelsesteenweg 365,2020-03-04,06:00:00,32,14,18,FMN GV 05 Lier
60,Mechelsesteenweg 365,2020-03-04,07:00:00,118,86,32,FMN GV 05 Lier
60,Mechelsesteenweg 365,2020-03-04,08:00:00,60,38,22,FMN GV 05 Lier
60,Mechelsesteenweg 365,2020-03-04,09:00:00,38,30,8,FMN GV 05 Lier
60,Mechelsesteenweg 365,2020-03-04,10:00:00,28,18,10,FMN GV 05 Lier
60,Mechelsesteenweg 365,2020-03-04,11:00:00,46,22,24,FMN GV 05 Lier
60,Mechelsesteenweg 365,2020-03-04,12:00:00,118,16,102,FMN GV 05 Lier
60,Mechelsesteenweg 365,2020-03-04,13:00:00,58,26,32,FMN GV 05 Lier
60,Mechelsesteenweg 365,2020-03-04,14:00:00,80,50,30,FMN GV 05 Lier
60,Mechelsesteenweg 365,2020-03-04,15:00:00,78,42,36,FMN GV 05 Lier
60,Mechelsesteenweg 365,2020-03-04,16:00:00,58,38,20,FMN GV 05 Lier
60,Mechelsesteenweg 365,2020-03-04,17:00:00,88,62,26,FMN GV 05 Lier
60,Mechelsesteenweg 365,2020-03-04,18:00:00,48,34,14,FMN GV 05 Lier
60,Mechelsesteenweg 365,2020-03-04,19:00:00,16,10,6,FMN GV 05 Lier
60,Mechelsesteenweg 365,2020-03-04,20:00:00,0,0,0,FMN GV 05 Lier
60,Mechelsesteenweg 365,2020-03-04,21:00:00,2,2,0,FMN GV 05 Lier
60,Mechelsesteenweg 365,2020-03-04,22:00:00,6,6,0,FMN GV 05 Lier
60,Mechelsesteenweg 365,2020-03-04,23:00:00,0,0,0,FMN GV 05 Lier
60,Mechelsesteenweg 365,2020-03-05,00:00:00,0,0,0,FMN GV 05 Lier
60,Mechelsesteenweg 365,2020-03-05,01:00:00,0,0,0,FMN GV 05 Lier
60,Mechelsesteenweg 365,2020-03-05,02:00:00,0,0,0,FMN GV 05 Lier
60,Mechelsesteenweg 365,2020-03-05,03:00:00,0,0,0,FMN GV 05 Lier
60,Mechelsesteenweg 365,2020-03-05,04:00:00,0,0,0,FMN GV 05 Lier
60,Mechelsesteenweg 365,2020-03-05,05:00:00,8,2,6,FMN GV 05 Lier
60,Mechelsesteenweg 365,2020-03-05,06:00:00,16,12,4,FMN GV 05 Lier
60,Mechelsesteenweg 365,2020-03-05,07:00:00,68,46,22,FMN GV 05 Lier
60,Mechelsesteenweg 365,2020-03-05,08:00:00,80,58,22,FMN GV 05 Lier
60,Mechelsesteenweg 365,2020-03-05,09:00:00,12,12,0,FMN GV 05 Lier
60,Mechelsesteenweg 365,2020-03-05,10:00:00,10,2,8,FMN GV 05 Lier
60,Mechelsesteenweg 365,2020-03-05,11:00:00,20,12,8,FMN GV 05 Lier
60,Mechelsesteenweg 365,2020-03-05,12:00:00,12,10,2,FMN GV 05 Lier
60,Mechelsesteenweg 365,2020-03-05,13:00:00,18,16,2,FMN GV 05 Lier
60,Mechelsesteenweg 365,2020-03-05,14:00:00,4,4,0,FMN GV 05 Lier
60,Mechelsesteenweg 365,2020-03-05,15:00:00,16,10,6,FMN GV 05 Lier
60,Mechelsesteenweg 365,2020-03-05,16:00:00,78,24,54,FMN GV 05 Lier
60,Mechelsesteenweg 365,2020-03-05,17:00:00,38,32,6,FMN GV 05 Lier
60,Mechelsesteenweg 365,2020-03-05,18:00:00,18,8,10,FMN GV 05 Lier
60,Mechelsesteenweg 365,2020-03-05,19:00:00,6,4,2,FMN GV 05 Lier
60,Mechelsesteenweg 365,2020-03-05,20:00:00,2,2,0,FMN GV 05 Lier
60,Mechelsesteenweg 365,2020-03-05,21:00:00,12,6,6,FMN GV 05 Lier
60,Mechelsesteenweg 365,2020-03-05,22:00:00,6,6,0,FMN GV 05 Lier
60,Mechelsesteenweg 365,2020-03-05,23:00:00,2,2,0,FMN GV 05 Lier
60,Mechelsesteenweg 365,2020-03-06,00:00:00,0,0,0,FMN GV 05 Lier
60,Mechelsesteenweg 365,2020-03-06,01:00:00,0,0,0,FMN GV 05 Lier
60,Mechelsesteenweg 365,2020-03-06,02:00:00,0,0,0,FMN GV 05 Lier
60,Mechelsesteenweg 365,2020-03-06,03:00:00,0,0,0,FMN GV 05 Lier
60,Mechelsesteenweg 365,2020-03-06,04:00:00,0,0,0,FMN GV 05 Lier
60,Mechelsesteenweg 365,2020-03-06,05:00:00,2,0,2,FMN GV 05 Lier
60,Mechelsesteenweg 365,2020-03-06,06:00:00,6,0,6,FMN GV 05 Lier
60,Mechelsesteenweg 365,2020-03-06,07:00:00,44,30,14,FMN GV 05 Lier
60,Mechelsesteenweg 365,2020-03-06,08:00:00,70,54,16,FMN GV 05 Lier
60,Mechelsesteenweg 365,2020-03-06,09:00:00,32,14,18,FMN GV 05 Lier
60,Mechelsesteenweg 365,2020-03-06,10:00:00,26,8,18,FMN GV 05 Lier
60,Mechelsesteenweg 365,2020-03-06,11:00:00,24,4,20,FMN GV 05 Lier
60,Mechelsesteenweg 365,2020-03-06,12:00:00,20,6,14,FMN GV 05 Lier
60,Mechelsesteenweg 365,2020-03-06,13:00:00,30,6,24,FMN GV 05 Lier
60,Mechelsesteenweg 365,2020-03-06,14:00:00,20,10,10,FMN GV 05 Lier
60,Mechelsesteenweg 365,2020-03-06,15:00:00,62,20,42,FMN GV 05 Lier
60,Mechelsesteenweg 365,2020-03-06,16:00:00,116,46,70,FMN GV 05 Lier
60,Mechelsesteenweg 365,2020-03-06,17:00:00,46,30,16,FMN GV 05 Lier
60,Mechelsesteenweg 365,2020-03-06,18:00:00,26,18,8,FMN GV 05 Lier
60,Mechelsesteenweg 365,2020-03-06,19:00:00,8,8,0,FMN GV 05 Lier
60,Mechelsesteenweg 365,2020-03-06,20:00:00,12,10,2,FMN GV 05 Lier
60,Mechelsesteenweg 365,2020-03-06,21:00:00,4,0,4,FMN GV 05 Lier
60,Mechelsesteenweg 365,2020-03-06,22:00:00,4,4,0,FMN GV 05 Lier
60,Mechelsesteenweg 365,2020-03-06,23:00:00,8,8,0,FMN GV 05 Lier
60,Mechelsesteenweg 365,2020-03-07,00:00:00,0,0,0,FMN GV 05 Lier
60,Mechelsesteenweg 365,2020-03-07,01:00:00,0,0,0,FMN GV 05 Lier
60,Mechelsesteenweg 365,2020-03-07,02:00:00,0,0,0,FMN GV 05 Lier
60,Mechelsesteenweg 365,2020-03-07,03:00:00,0,0,0,FMN GV 05 Lier
60,Mechelsesteenweg 365,2020-03-07,04:00:00,0,0,0,FMN GV 05 Lier
60,Mechelsesteenweg 365,2020-03-07,05:00:00,0,0,0,FMN GV 05 Lier
60,Mechelsesteenweg 365,2020-03-07,06:00:00,0,0,0,FMN GV 05 Lier
60,Mechelsesteenweg 365,2020-03-07,07:00:00,24,12,12,FMN GV 05 Lier
60,Mechelsesteenweg 365,2020-03-07,08:00:00,46,24,22,FMN GV 05 Lier
60,Mechelsesteenweg 365,2020-03-07,09:00:00,92,60,32,FMN GV 05 Lier
60,Mechelsesteenweg 365,2020-03-07,10:00:00,174,96,78,FMN GV 05 Lier
60,Mechelsesteenweg 365,2020-03-07,11:00:00,298,170,128,FMN GV 05 Lier
60,Mechelsesteenweg 365,2020-03-07,12:00:00,248,106,142,FMN GV 05 Lier
60,Mechelsesteenweg 365,2020-03-07,13:00:00,302,160,142,FMN GV 05 Lier
60,Mechelsesteenweg 365,2020-03-07,14:00:00,370,194,176,FMN GV 05 Lier
60,Mechelsesteenweg 365,2020-03-07,15:00:00,314,158,156,FMN GV 05 Lier
60,Mechelsesteenweg 365,2020-03-07,16:00:00,140,58,82,FMN GV 05 Lier
60,Mechelsesteenweg 365,2020-03-07,17:00:00,60,36,24,FMN GV 05 Lier
60,Mechelsesteenweg 365,2020-03-07,18:00:00,22,4,18,FMN GV 05 Lier
60,Mechelsesteenweg 365,2020-03-07,19:00:00,6,6,0,FMN GV 05 Lier
60,Mechelsesteenweg 365,2020-03-07,20:00:00,8,2,6,FMN GV 05 Lier
60,Mechelsesteenweg 365,2020-03-07,21:00:00,2,0,2,FMN GV 05 Lier
60,Mechelsesteenweg 365,2020-03-07,22:00:00,4,0,4,FMN GV 05 Lier
60,Mechelsesteenweg 365,2020-03-07,23:00:00,2,0,2,FMN GV 05 Lier
60,Mechelsesteenweg 365,2020-03-08,00:00:00,4,4,0,FMN GV 05 Lier
60,Mechelsesteenweg 365,2020-03-08,01:00:00,2,0,2,FMN GV 05 Lier
60,Mechelsesteenweg 365,2020-03-08,02:00:00,0,0,0,FMN GV 05 Lier
60,Mechelsesteenweg 365,2020-03-08,03:00:00,2,0,2,FMN GV 05 Lier
60,Mechelsesteenweg 365,2020-03-08,04:00:00,2,2,0,FMN GV 05 Lier
60,Mechelsesteenweg 365,2020-03-08,05:00:00,0,0,0,FMN GV 05 Lier
60,Mechelsesteenweg 365,2020-03-08,06:00:00,0,0,0,FMN GV 05 Lier
60,Mechelsesteenweg 365,2020-03-08,07:00:00,6,2,4,FMN GV 05 Lier
60,Mechelsesteenweg 365,2020-03-08,08:00:00,18,12,6,FMN GV 05 Lier
60,Mechelsesteenweg 365,2020-03-08,09:00:00,114,76,38,FMN GV 05 Lier
60,Mechelsesteenweg 365,2020-03-08,10:00:00,122,62,60,FMN GV 05 Lier
60,Mechelsesteenweg 365,2020-03-08,11:00:00,46,28,18,FMN GV 05 Lier
60,Mechelsesteenweg 365,2020-03-08,12:00:00,10,8,2,FMN GV 05 Lier
60,Mechelsesteenweg 365,2020-03-08,13:00:00,16,6,10,FMN GV 05 Lier
60,Mechelsesteenweg 365,2020-03-08,14:00:00,28,20,8,FMN GV 05 Lier
60,Mechelsesteenweg 365,2020-03-08,15:00:00,26,18,8,FMN GV 05 Lier
60,Mechelsesteenweg 365,2020-03-08,16:00:00,24,8,16,FMN GV 05 Lier
60,Mechelsesteenweg 365,2020-03-08,17:00:00,18,14,4,FMN GV 05 Lier
60,Mechelsesteenweg 365,2020-03-08,18:00:00,8,6,2,FMN GV 05 Lier
60,Mechelsesteenweg 365,2020-03-08,19:00:00,0,0,0,FMN GV 05 Lier
60,Mechelsesteenweg 365,2020-03-08,20:00:00,0,0,0,FMN GV 05 Lier
60,Mechelsesteenweg 365,2020-03-08,21:00:00,2,2,0,FMN GV 05 Lier
60,Mechelsesteenweg 365,2020-03-08,22:00:00,0,0,0,FMN GV 05 Lier
60,Mechelsesteenweg 365,2020-03-08,23:00:00,4,0,4,FMN GV 05 Lier
60,Mechelsesteenweg 365,2020-03-09,00:00:00,0,0,0,FMN GV 05 Lier
60,Mechelsesteenweg 365,2020-03-09,01:00:00,0,0,0,FMN GV 05 Lier
60,Mechelsesteenweg 365,2020-03-09,02:00:00,0,0,0,FMN GV 05 Lier
60,Mechelsesteenweg 365,2020-03-09,03:00:00,0,0,0,FMN GV 05 Lier
60,Mechelsesteenweg 365,2020-03-09,04:00:00,2,0,2,FMN GV 05 Lier
60,Mechelsesteenweg 365,2020-03-09,05:00:00,8,2,6,FMN GV 05 Lier
60,Mechelsesteenweg 365,2020-03-09,06:00:00,18,4,14,FMN GV 05 Lier
60,Mechelsesteenweg 365,2020-03-09,07:00:00,72,52,20,FMN GV 05 Lier
60,Mechelsesteenweg 365,2020-03-09,08:00:00,54,38,16,FMN GV 05 Lier
60,Mechelsesteenweg 365,2020-03-09,09:00:00,20,14,6,FMN GV 05 Lier
60,Mechelsesteenweg 365,2020-03-09,10:00:00,18,12,6,FMN GV 05 Lier
60,Mechelsesteenweg 365,2020-03-09,11:00:00,24,14,10,FMN GV 05 Lier
60,Mechelsesteenweg 365,2020-03-09,12:00:00,10,6,4,FMN GV 05 Lier
60,Mechelsesteenweg 365,2020-03-09,13:00:00,14,2,12,FMN GV 05 Lier
60,Mechelsesteenweg 365,2020-03-09,14:00:00,24,12,12,FMN GV 05 Lier
60,Mechelsesteenweg 365,2020-03-09,15:00:00,28,20,8,FMN GV 05 Lier
60,Mechelsesteenweg 365,2020-03-09,16:00:00,160,42,118,FMN GV 05 Lier
60,Mechelsesteenweg 365,2020-03-09,17:00:00,126,66,60,FMN GV 05 Lier
60,Mechelsesteenweg 365,2020-03-09,18:00:00,42,20,22,FMN GV 05 Lier
60,Mechelsesteenweg 365,2020-03-09,19:00:00,12,10,2,FMN GV 05 Lier
60,Mechelsesteenweg 365,2020-03-09,20:00:00,2,2,0,FMN GV 05 Lier
60,Mechelsesteenweg 365,2020-03-09,21:00:00,2,2,0,FMN GV 05 Lier
60,Mechelsesteenweg 365,2020-03-09,22:00:00,6,0,6,FMN GV 05 Lier
60,Mechelsesteenweg 365,2020-03-09,23:00:00,2,0,2,FMN GV 05 Lier
60,Mechelsesteenweg 365,2020-03-10,00:00:00,0,0,0,FMN GV 05 Lier
60,Mechelsesteenweg 365,2020-03-10,01:00:00,2,0,2,FMN GV 05 Lier
60,Mechelsesteenweg 365,2020-03-10,02:00:00,0,0,0,FMN GV 05 Lier
60,Mechelsesteenweg 365,2020-03-10,03:00:00,0,0,0,FMN GV 05 Lier
60,Mechelsesteenweg 365,2020-03-10,04:00:00,2,0,2,FMN GV 05 Lier
60,Mechelsesteenweg 365,2020-03-10,05:00:00,8,2,6,FMN GV 05 Lier
60,Mechelsesteenweg 365,2020-03-10,06:00:00,4,0,4,FMN GV 05 Lier
60,Mechelsesteenweg 365,2020-03-10,07:00:00,34,32,2,FMN GV 05 Lier
60,Mechelsesteenweg 365,2020-03-10,08:00:00,38,38,0,FMN GV 05 Lier
60,Mechelsesteenweg 365,2020-03-10,09:00:00,12,10,2,FMN GV 05 Lier
60,Mechelsesteenweg 365,2020-03-10,10:00:00,8,4,4,FMN GV 05 Lier
60,Mechelsesteenweg 365,2020-03-10,11:00:00,2,2,0,FMN GV 05 Lier
60,Mechelsesteenweg 365,2020-03-10,12:00:00,16,14,2,FMN GV 05 Lier
60,Mechelsesteenweg 365,2020-03-10,13:00:00,2,0,2,FMN GV 05 Lier
60,Mechelsesteenweg 365,2020-03-10,14:00:00,24,24,0,FMN GV 05 Lier
60,Mechelsesteenweg 365,2020-03-10,15:00:00,12,8,4,FMN GV 05 Lier
60,Mechelsesteenweg 365,2020-03-10,16:00:00,56,18,38,FMN GV 05 Lier
60,Mechelsesteenweg 365,2020-03-10,17:00:00,44,22,22,FMN GV 05 Lier
60,Mechelsesteenweg 365,2020-03-10,18:00:00,14,6,8,FMN GV 05 Lier
60,Mechelsesteenweg 365,2020-03-10,19:00:00,10,10,0,FMN GV 05 Lier
60,Mechelsesteenweg 365,2020-03-10,20:00:00,8,2,6,FMN GV 05 Lier
60,Mechelsesteenweg 365,2020-03-10,21:00:00,2,2,0,FMN GV 05 Lier
60,Mechelsesteenweg 365,2020-03-10,22:00:00,4,4,0,FMN GV 05 Lier
60,Mechelsesteenweg 365,2020-03-10,23:00:00,0,0,0,FMN GV 05 Lier
60,Mechelsesteenweg 365,2020-03-11,00:00:00,2,0,2,FMN GV 05 Lier
60,Mechelsesteenweg 365,2020-03-11,01:00:00,0,0,0,FMN GV 05 Lier
60,Mechelsesteenweg 365,2020-03-11,02:00:00,0,0,0,FMN GV 05 Lier
60,Mechelsesteenweg 365,2020-03-11,03:00:00,0,0,0,FMN GV 05 Lier
60,Mechelsesteenweg 365,2020-03-11,04:00:00,2,0,2,FMN GV 05 Lier
60,Mechelsesteenweg 365,2020-03-11,05:00:00,0,0,0,FMN GV 05 Lier
60,Mechelsesteenweg 365,2020-03-11,06:00:00,8,0,8,FMN GV 05 Lier
60,Mechelsesteenweg 365,2020-03-11,07:00:00,50,40,10,FMN GV 05 Lier
60,Mechelsesteenweg 365,2020-03-11,08:00:00,44,38,6,FMN GV 05 Lier
60,Mechelsesteenweg 365,2020-03-11,09:00:00,6,0,6,FMN GV 05 Lier
60,Mechelsesteenweg 365,2020-03-11,10:00:00,6,2,4,FMN GV 05 Lier
60,Mechelsesteenweg 365,2020-03-11,11:00:00,2,0,2,FMN GV 05 Lier
60,Mechelsesteenweg 365,2020-03-11,12:00:00,46,4,42,FMN GV 05 Lier
60,Mechelsesteenweg 365,2020-03-11,13:00:00,20,10,10,FMN GV 05 Lier
60,Mechelsesteenweg 365,2020-03-11,14:00:00,20,12,8,FMN GV 05 Lier
60,Mechelsesteenweg 365,2020-03-11,15:00:00,40,24,16,FMN GV 05 Lier
60,Mechelsesteenweg 365,2020-03-11,16:00:00,42,30,12,FMN GV 05 Lier
60,Mechelsesteenweg 365,2020-03-11,17:00:00,76,52,24,FMN GV 05 Lier
60,Mechelsesteenweg 365,2020-03-11,18:00:00,32,20,12,FMN GV 05 Lier
60,Mechelsesteenweg 365,2020-03-11,19:00:00,4,4,0,FMN GV 05 Lier
60,Mechelsesteenweg 365,2020-03-11,20:00:00,4,0,4,FMN GV 05 Lier
60,Mechelsesteenweg 365,2020-03-11,21:00:00,2,2,0,FMN GV 05 Lier
60,Mechelsesteenweg 365,2020-03-11,22:00:00,2,0,2,FMN GV 05 Lier
60,Mechelsesteenweg 365,2020-03-11,23:00:00,0,0,0,FMN GV 05 Lier
60,Mechelsesteenweg 365,2020-03-12,00:00:00,0,0,0,FMN GV 05 Lier
60,Mechelsesteenweg 365,2020-03-12,01:00:00,0,0,0,FMN GV 05 Lier
60,Mechelsesteenweg 365,2020-03-12,02:00:00,0,0,0,FMN GV 05 Lier
60,Mechelsesteenweg 365,2020-03-12,03:00:00,0,0,0,FMN GV 05 Lier
60,Mechelsesteenweg 365,2020-03-12,04:00:00,2,0,2,FMN GV 05 Lier
60,Mechelsesteenweg 365,2020-03-12,05:00:00,6,0,6,FMN GV 05 Lier
60,Mechelsesteenweg 365,2020-03-12,06:00:00,6,0,6,FMN GV 05 Lier
60,Mechelsesteenweg 365,2020-03-12,07:00:00,48,26,22,FMN GV 05 Lier
60,Mechelsesteenweg 365,2020-03-12,08:00:00,38,28,10,FMN GV 05 Lier
60,Mechelsesteenweg 365,2020-03-12,09:00:00,14,8,6,FMN GV 05 Lier
60,Mechelsesteenweg 365,2020-03-12,10:00:00,26,16,10,FMN GV 05 Lier
60,Mechelsesteenweg 365,2020-03-12,11:00:00,18,10,8,FMN GV 05 Lier
60,Mechelsesteenweg 365,2020-03-12,12:00:00,40,24,16,FMN GV 05 Lier
60,Mechelsesteenweg 365,2020-03-12,13:00:00,42,30,12,FMN GV 05 Lier
60,Mechelsesteenweg 365,2020-03-12,14:00:00,66,30,36,FMN GV 05 Lier
60,Mechelsesteenweg 365,2020-03-12,15:00:00,30,14,16,FMN GV 05 Lier
60,Mechelsesteenweg 365,2020-03-12,16:00:00,60,20,40,FMN GV 05 Lier
60,Mechelsesteenweg 365,2020-03-12,17:00:00,92,44,48,FMN GV 05 Lier
60,Mechelsesteenweg 365,2020-03-12,18:00:00,28,22,6,FMN GV 05 Lier
60,Mechelsesteenweg 365,2020-03-12,19:00:00,18,10,8,FMN GV 05 Lier
60,Mechelsesteenweg 365,2020-03-12,20:00:00,4,4,0,FMN GV 05 Lier
60,Mechelsesteenweg 365,2020-03-12,21:00:00,2,0,2,FMN GV 05 Lier
60,Mechelsesteenweg 365,2020-03-12,22:00:00,4,2,2,FMN GV 05 Lier
60,Mechelsesteenweg 365,2020-03-12,23:00:00,2,0,2,FMN GV 05 Lier
60,Mechelsesteenweg 365,2020-03-13,00:00:00,0,0,0,FMN GV 05 Lier
60,Mechelsesteenweg 365,2020-03-13,01:00:00,0,0,0,FMN GV 05 Lier
60,Mechelsesteenweg 365,2020-03-13,02:00:00,0,0,0,FMN GV 05 Lier
60,Mechelsesteenweg 365,2020-03-13,03:00:00,0,0,0,FMN GV 05 Lier
60,Mechelsesteenweg 365,2020-03-13,04:00:00,4,0,4,FMN GV 05 Lier
60,Mechelsesteenweg 365,2020-03-13,05:00:00,4,2,2,FMN GV 05 Lier
60,Mechelsesteenweg 365,2020-03-13,06:00:00,8,6,2,FMN GV 05 Lier
60,Mechelsesteenweg 365,2020-03-13,07:00:00,88,54,34,FMN GV 05 Lier
60,Mechelsesteenweg 365,2020-03-13,08:00:00,96,70,26,FMN GV 05 Lier
60,Mechelsesteenweg 365,2020-03-13,09:00:00,40,24,16,FMN GV 05 Lier
60,Mechelsesteenweg 365,2020-03-13,10:00:00,48,30,18,FMN GV 05 Lier
60,Mechelsesteenweg 365,2020-03-13,11:00:00,52,32,20,FMN GV 05 Lier
60,Mechelsesteenweg 365,2020-03-13,12:00:00,42,26,16,FMN GV 05 Lier
60,Mechelsesteenweg 365,2020-03-13,13:00:00,50,26,24,FMN GV 05 Lier
60,Mechelsesteenweg 365,2020-03-13,14:00:00,38,20,18,FMN GV 05 Lier
60,Mechelsesteenweg 365,2020-03-13,15:00:00,68,34,34,FMN GV 05 Lier
60,Mechelsesteenweg 365,2020-03-13,16:00:00,156,44,112,FMN GV 05 Lier
60,Mechelsesteenweg 365,2020-03-13,17:00:00,70,52,18,FMN GV 05 Lier
60,Mechelsesteenweg 365,2020-03-13,18:00:00,32,16,16,FMN GV 05 Lier
60,Mechelsesteenweg 365,2020-03-13,19:00:00,14,8,6,FMN GV 05 Lier
60,Mechelsesteenweg 365,2020-03-13,20:00:00,6,4,2,FMN GV 05 Lier
60,Mechelsesteenweg 365,2020-03-13,21:00:00,6,0,6,FMN GV 05 Lier
60,Mechelsesteenweg 365,2020-03-13,22:00:00,0,0,0,FMN GV 05 Lier
60,Mechelsesteenweg 365,2020-03-13,23:00:00,0,0,0,FMN GV 05 Lier
60,Mechelsesteenweg 365,2020-03-14,00:00:00,2,2,0,FMN GV 05 Lier
60,Mechelsesteenweg 365,2020-03-14,01:00:00,8,2,6,FMN GV 05 Lier
60,Mechelsesteenweg 365,2020-03-14,02:00:00,0,0,0,FMN GV 05 Lier
60,Mechelsesteenweg 365,2020-03-14,03:00:00,0,0,0,FMN GV 05 Lier
60,Mechelsesteenweg 365,2020-03-14,04:00:00,0,0,0,FMN GV 05 Lier
60,Mechelsesteenweg 365,2020-03-14,05:00:00,0,0,0,FMN GV 05 Lier
60,Mechelsesteenweg 365,2020-03-14,06:00:00,2,2,0,FMN GV 05 Lier
60,Mechelsesteenweg 365,2020-03-14,07:00:00,12,2,10,FMN GV 05 Lier
60,Mechelsesteenweg 365,2020-03-14,08:00:00,22,14,8,FMN GV 05 Lier
60,Mechelsesteenweg 365,2020-03-14,09:00:00,88,58,30,FMN GV 05 Lier
60,Mechelsesteenweg 365,2020-03-14,10:00:00,212,114,98,FMN GV 05 Lier
60,Mechelsesteenweg 365,2020-03-14,11:00:00,296,124,172,FMN GV 05 Lier
60,Mechelsesteenweg 365,2020-03-14,12:00:00,266,122,144,FMN GV 05 Lier
60,Mechelsesteenweg 365,2020-03-14,13:00:00,200,128,72,FMN GV 05 Lier
60,Mechelsesteenweg 365,2020-03-14,14:00:00,258,122,136,FMN GV 05 Lier
60,Mechelsesteenweg 365,2020-03-14,15:00:00,252,100,152,FMN GV 05 Lier
60,Mechelsesteenweg 365,2020-03-14,16:00:00,130,56,74,FMN GV 05 Lier
60,Mechelsesteenweg 365,2020-03-14,17:00:00,48,16,32,FMN GV 05 Lier
60,Mechelsesteenweg 365,2020-03-14,18:00:00,18,6,12,FMN GV 05 Lier
60,Mechelsesteenweg 365,2020-03-14,19:00:00,2,2,0,FMN GV 05 Lier
60,Mechelsesteenweg 365,2020-03-14,20:00:00,8,8,0,FMN GV 05 Lier
60,Mechelsesteenweg 365,2020-03-14,21:00:00,2,0,2,FMN GV 05 Lier
60,Mechelsesteenweg 365,2020-03-14,22:00:00,2,0,2,FMN GV 05 Lier
60,Mechelsesteenweg 365,2020-03-14,23:00:00,4,0,4,FMN GV 05 Lier
60,Mechelsesteenweg 365,2020-03-15,00:00:00,4,0,4,FMN GV 05 Lier
60,Mechelsesteenweg 365,2020-03-15,01:00:00,0,0,0,FMN GV 05 Lier
60,Mechelsesteenweg 365,2020-03-15,02:00:00,0,0,0,FMN GV 05 Lier
60,Mechelsesteenweg 365,2020-03-15,03:00:00,0,0,0,FMN GV 05 Lier
60,Mechelsesteenweg 365,2020-03-15,04:00:00,0,0,0,FMN GV 05 Lier
60,Mechelsesteenweg 365,2020-03-15,05:00:00,0,0,0,FMN GV 05 Lier
60,Mechelsesteenweg 365,2020-03-15,06:00:00,0,0,0,FMN GV 05 Lier
60,Mechelsesteenweg 365,2020-03-15,07:00:00,6,0,6,FMN GV 05 Lier
60,Mechelsesteenweg 365,2020-03-15,08:00:00,44,20,24,FMN GV 05 Lier
60,Mechelsesteenweg 365,2020-03-15,09:00:00,182,94,88,FMN GV 05 Lier
60,Mechelsesteenweg 365,2020-03-15,10:00:00,462,282,180,FMN GV 05 Lier
60,Mechelsesteenweg 365,2020-03-15,11:00:00,456,204,252,FMN GV 05 Lier
60,Mechelsesteenweg 365,2020-03-15,12:00:00,216,120,96,FMN GV 05 Lier
60,Mechelsesteenweg 365,2020-03-15,13:00:00,150,54,96,FMN GV 05 Lier
60,Mechelsesteenweg 365,2020-03-15,14:00:00,288,150,138,FMN GV 05 Lier
60,Mechelsesteenweg 365,2020-03-15,15:00:00,292,140,152,FMN GV 05 Lier
60,Mechelsesteenweg 365,2020-03-15,16:00:00,248,130,118,FMN GV 05 Lier
60,Mechelsesteenweg 365,2020-03-15,17:00:00,118,46,72,FMN GV 05 Lier
60,Mechelsesteenweg 365,2020-03-15,18:00:00,14,4,10,FMN GV 05 Lier
60,Mechelsesteenweg 365,2020-03-15,19:00:00,2,2,0,FMN GV 05 Lier
60,Mechelsesteenweg 365,2020-03-15,20:00:00,2,2,0,FMN GV 05 Lier
60,Mechelsesteenweg 365,2020-03-15,21:00:00,4,2,2,FMN GV 05 Lier
60,Mechelsesteenweg 365,2020-03-15,22:00:00,0,0,0,FMN GV 05 Lier
60,Mechelsesteenweg 365,2020-03-15,23:00:00,0,0,0,FMN GV 05 Lier
60,Mechelsesteenweg 365,2020-03-16,00:00:00,0,0,0,FMN GV 05 Lier
60,Mechelsesteenweg 365,2020-03-16,01:00:00,0,0,0,FMN GV 05 Lier
60,Mechelsesteenweg 365,2020-03-16,02:00:00,0,0,0,FMN GV 05 Lier
60,Mechelsesteenweg 365,2020-03-16,03:00:00,0,0,0,FMN GV 05 Lier
60,Mechelsesteenweg 365,2020-03-16,04:00:00,0,0,0,FMN GV 05 Lier
60,Mechelsesteenweg 365,2020-03-16,05:00:00,8,0,8,FMN GV 05 Lier
60,Mechelsesteenweg 365,2020-03-16,06:00:00,32,12,20,FMN GV 05 Lier
60,Mechelsesteenweg 365,2020-03-16,07:00:00,98,36,62,FMN GV 05 Lier
60,Mechelsesteenweg 365,2020-03-16,08:00:00,40,18,22,FMN GV 05 Lier
60,Mechelsesteenweg 365,2020-03-16,09:00:00,50,16,34,FMN GV 05 Lier
60,Mechelsesteenweg 365,2020-03-16,10:00:00,70,34,36,FMN GV 05 Lier
60,Mechelsesteenweg 365,2020-03-16,11:00:00,136,84,52,FMN GV 05 Lier
60,Mechelsesteenweg 365,2020-03-16,12:00:00,100,54,46,FMN GV 05 Lier
60,Mechelsesteenweg 365,2020-03-16,13:00:00,112,60,52,FMN GV 05 Lier
60,Mechelsesteenweg 365,2020-03-16,14:00:00,186,94,92,FMN GV 05 Lier
60,Mechelsesteenweg 365,2020-03-16,15:00:00,188,82,106,FMN GV 05 Lier
60,Mechelsesteenweg 365,2020-03-16,16:00:00,180,100,80,FMN GV 05 Lier
60,Mechelsesteenweg 365,2020-03-16,17:00:00,164,86,78,FMN GV 05 Lier
60,Mechelsesteenweg 365,2020-03-16,18:00:00,44,28,16,FMN GV 05 Lier
60,Mechelsesteenweg 365,2020-03-16,19:00:00,16,10,6,FMN GV 05 Lier
60,Mechelsesteenweg 365,2020-03-16,20:00:00,4,4,0,FMN GV 05 Lier
60,Mechelsesteenweg 365,2020-03-16,21:00:00,4,2,2,FMN GV 05 Lier
60,Mechelsesteenweg 365,2020-03-16,22:00:00,4,4,0,FMN GV 05 Lier
60,Mechelsesteenweg 365,2020-03-16,23:00:00,0,0,0,FMN GV 05 Lier
60,Mechelsesteenweg 365,2020-03-17,00:00:00,0,0,0,FMN GV 05 Lier
60,Mechelsesteenweg 365,2020-03-17,01:00:00,0,0,0,FMN GV 05 Lier
60,Mechelsesteenweg 365,2020-03-17,02:00:00,0,0,0,FMN GV 05 Lier
60,Mechelsesteenweg 365,2020-03-17,03:00:00,2,0,2,FMN GV 05 Lier
60,Mechelsesteenweg 365,2020-03-17,04:00:00,0,0,0,FMN GV 05 Lier
60,Mechelsesteenweg 365,2020-03-17,05:00:00,2,0,2,FMN GV 05 Lier
60,Mechelsesteenweg 365,2020-03-17,06:00:00,32,12,20,FMN GV 05 Lier
60,Mechelsesteenweg 365,2020-03-17,07:00:00,100,34,66,FMN GV 05 Lier
60,Mechelsesteenweg 365,2020-03-17,08:00:00,56,26,30,FMN GV 05 Lier
60,Mechelsesteenweg 365,2020-03-17,09:00:00,82,44,38,FMN GV 05 Lier
60,Mechelsesteenweg 365,2020-03-17,10:00:00,126,66,60,FMN GV 05 Lier
60,Mechelsesteenweg 365,2020-03-17,11:00:00,162,68,94,FMN GV 05 Lier
60,Mechelsesteenweg 365,2020-03-17,12:00:00,124,64,60,FMN GV 05 Lier
60,Mechelsesteenweg 365,2020-03-17,13:00:00,256,138,118,FMN GV 05 Lier
60,Mechelsesteenweg 365,2020-03-17,14:00:00,392,218,174,FMN GV 05 Lier
60,Mechelsesteenweg 365,2020-03-17,15:00:00,390,180,210,FMN GV 05 Lier
60,Mechelsesteenweg 365,2020-03-17,16:00:00,296,158,138,FMN GV 05 Lier
60,Mechelsesteenweg 365,2020-03-17,17:00:00,254,128,126,FMN GV 05 Lier
60,Mechelsesteenweg 365,2020-03-17,18:00:00,76,34,42,FMN GV 05 Lier
60,Mechelsesteenweg 365,2020-03-17,19:00:00,28,8,20,FMN GV 05 Lier
60,Mechelsesteenweg 365,2020-03-17,20:00:00,6,4,2,FMN GV 05 Lier
60,Mechelsesteenweg 365,2020-03-17,21:00:00,8,4,4,FMN GV 05 Lier
60,Mechelsesteenweg 365,2020-03-17,22:00:00,4,2,2,FMN GV 05 Lier
60,Mechelsesteenweg 365,2020-03-17,23:00:00,0,0,0,FMN GV 05 Lier
60,Mechelsesteenweg 365,2020-03-18,00:00:00,0,0,0,FMN GV 05 Lier
60,Mechelsesteenweg 365,2020-03-18,01:00:00,0,0,0,FMN GV 05 Lier
60,Mechelsesteenweg 365,2020-03-18,02:00:00,0,0,0,FMN GV 05 Lier
60,Mechelsesteenweg 365,2020-03-18,03:00:00,2,0,2,FMN GV 05 Lier
60,Mechelsesteenweg 365,2020-03-18,04:00:00,2,0,2,FMN GV 05 Lier
60,Mechelsesteenweg 365,2020-03-18,05:00:00,12,4,8,FMN GV 05 Lier
60,Mechelsesteenweg 365,2020-03-18,06:00:00,22,10,12,FMN GV 05 Lier
60,Mechelsesteenweg 365,2020-03-18,07:00:00,80,22,58,FMN GV 05 Lier
60,Mechelsesteenweg 365,2020-03-18,08:00:00,30,12,18,FMN GV 05 Lier
60,Mechelsesteenweg 365,2020-03-18,09:00:00,80,54,26,FMN GV 05 Lier
60,Mechelsesteenweg 365,2020-03-18,10:00:00,110,58,52,FMN GV 05 Lier
60,Mechelsesteenweg 365,2020-03-18,11:00:00,168,80,88,FMN GV 05 Lier
60,Mechelsesteenweg 365,2020-03-18,12:00:00,200,96,104,FMN GV 05 Lier
60,Mechelsesteenweg 365,2020-03-18,13:00:00,304,178,126,FMN GV 05 Lier
60,Mechelsesteenweg 365,2020-03-18,14:00:00,524,308,216,FMN GV 05 Lier
60,Mechelsesteenweg 365,2020-03-18,15:00:00,478,252,226,FMN GV 05 Lier
60,Mechelsesteenweg 365,2020-03-18,16:00:00,394,208,186,FMN GV 05 Lier
60,Mechelsesteenweg 365,2020-03-18,17:00:00,288,146,142,FMN GV 05 Lier
60,Mechelsesteenweg 365,2020-03-18,18:00:00,136,72,64,FMN GV 05 Lier
60,Mechelsesteenweg 365,2020-03-18,19:00:00,32,10,22,FMN GV 05 Lier
60,Mechelsesteenweg 365,2020-03-18,20:00:00,4,2,2,FMN GV 05 Lier
60,Mechelsesteenweg 365,2020-03-18,21:00:00,4,0,4,FMN GV 05 Lier
60,Mechelsesteenweg 365,2020-03-18,22:00:00,2,2,0,FMN GV 05 Lier
60,Mechelsesteenweg 365,2020-03-18,23:00:00,0,0,0,FMN GV 05 Lier
60,Mechelsesteenweg 365,2020-03-19,00:00:00,0,0,0,FMN GV 05 Lier
60,Mechelsesteenweg 365,2020-03-19,01:00:00,0,0,0,FMN GV 05 Lier
60,Mechelsesteenweg 365,2020-03-19,02:00:00,0,0,0,FMN GV 05 Lier
60,Mechelsesteenweg 365,2020-03-19,03:00:00,2,0,2,FMN GV 05 Lier
60,Mechelsesteenweg 365,2020-03-19,04:00:00,2,0,2,FMN GV 05 Lier
60,Mechelsesteenweg 365,2020-03-19,05:00:00,4,0,4,FMN GV 05 Lier
60,Mechelsesteenweg 365,2020-03-19,06:00:00,26,10,16,FMN GV 05 Lier
60,Mechelsesteenweg 365,2020-03-19,07:00:00,62,28,34,FMN GV 05 Lier
60,Mechelsesteenweg 365,2020-03-19,08:00:00,56,22,34,FMN GV 05 Lier
60,Mechelsesteenweg 365,2020-03-19,09:00:00,48,30,18,FMN GV 05 Lier
60,Mechelsesteenweg 365,2020-03-19,10:00:00,60,28,32,FMN GV 05 Lier
60,Mechelsesteenweg 365,2020-03-19,11:00:00,88,40,48,FMN GV 05 Lier
60,Mechelsesteenweg 365,2020-03-19,12:00:00,112,72,40,FMN GV 05 Lier
60,Mechelsesteenweg 365,2020-03-19,13:00:00,254,120,134,FMN GV 05 Lier
60,Mechelsesteenweg 365,2020-03-19,14:00:00,438,234,204,FMN GV 05 Lier
60,Mechelsesteenweg 365,2020-03-19,15:00:00,386,160,226,FMN GV 05 Lier
60,Mechelsesteenweg 365,2020-03-19,16:00:00,210,100,110,FMN GV 05 Lier
60,Mechelsesteenweg 365,2020-03-19,17:00:00,192,94,98,FMN GV 05 Lier
60,Mechelsesteenweg 365,2020-03-19,18:00:00,84,40,44,FMN GV 05 Lier
60,Mechelsesteenweg 365,2020-03-19,19:00:00,46,36,10,FMN GV 05 Lier
60,Mechelsesteenweg 365,2020-03-19,20:00:00,12,4,8,FMN GV 05 Lier
60,Mechelsesteenweg 365,2020-03-19,21:00:00,4,4,0,FMN GV 05 Lier
60,Mechelsesteenweg 365,2020-03-19,22:00:00,6,4,2,FMN GV 05 Lier
60,Mechelsesteenweg 365,2020-03-19,23:00:00,4,0,4,FMN GV 05 Lier
60,Mechelsesteenweg 365,2020-03-20,00:00:00,0,0,0,FMN GV 05 Lier
60,Mechelsesteenweg 365,2020-03-20,01:00:00,0,0,0,FMN GV 05 Lier
60,Mechelsesteenweg 365,2020-03-20,02:00:00,0,0,0,FMN GV 05 Lier
60,Mechelsesteenweg 365,2020-03-20,03:00:00,0,0,0,FMN GV 05 Lier
60,Mechelsesteenweg 365,2020-03-20,04:00:00,2,0,2,FMN GV 05 Lier
60,Mechelsesteenweg 365,2020-03-20,05:00:00,0,0,0,FMN GV 05 Lier
60,Mechelsesteenweg 365,2020-03-20,06:00:00,18,8,10,FMN GV 05 Lier
60,Mechelsesteenweg 365,2020-03-20,07:00:00,26,8,18,FMN GV 05 Lier
60,Mechelsesteenweg 365,2020-03-20,08:00:00,38,14,24,FMN GV 05 Lier
60,Mechelsesteenweg 365,2020-03-20,09:00:00,22,10,12,FMN GV 05 Lier
60,Mechelsesteenweg 365,2020-03-20,10:00:00,56,28,28,FMN GV 05 Lier
60,Mechelsesteenweg 365,2020-03-20,11:00:00,62,32,30,FMN GV 05 Lier
60,Mechelsesteenweg 365,2020-03-20,12:00:00,72,28,44,FMN GV 05 Lier
60,Mechelsesteenweg 365,2020-03-20,13:00:00,78,40,38,FMN GV 05 Lier
60,Mechelsesteenweg 365,2020-03-20,14:00:00,106,40,66,FMN GV 05 Lier
60,Mechelsesteenweg 365,2020-03-20,15:00:00,90,48,42,FMN GV 05 Lier
60,Mechelsesteenweg 365,2020-03-20,16:00:00,58,32,26,FMN GV 05 Lier
60,Mechelsesteenweg 365,2020-03-20,17:00:00,58,30,28,FMN GV 05 Lier
60,Mechelsesteenweg 365,2020-03-20,18:00:00,24,10,14,FMN GV 05 Lier
60,Mechelsesteenweg 365,2020-03-20,19:00:00,10,6,4,FMN GV 05 Lier
60,Mechelsesteenweg 365,2020-03-20,20:00:00,2,0,2,FMN GV 05 Lier
60,Mechelsesteenweg 365,2020-03-20,21:00:00,0,0,0,FMN GV 05 Lier
60,Mechelsesteenweg 365,2020-03-20,22:00:00,0,0,0,FMN GV 05 Lier
60,Mechelsesteenweg 365,2020-03-20,23:00:00,2,0,2,FMN GV 05 Lier
60,Mechelsesteenweg 365,2020-03-21,00:00:00,0,0,0,FMN GV 05 Lier
60,Mechelsesteenweg 365,2020-03-21,01:00:00,0,0,0,FMN GV 05 Lier
60,Mechelsesteenweg 365,2020-03-21,02:00:00,0,0,0,FMN GV 05 Lier
60,Mechelsesteenweg 365,2020-03-21,03:00:00,2,0,2,FMN GV 05 Lier
60,Mechelsesteenweg 365,2020-03-21,04:00:00,0,0,0,FMN GV 05 Lier
60,Mechelsesteenweg 365,2020-03-21,05:00:00,2,2,0,FMN GV 05 Lier
60,Mechelsesteenweg 365,2020-03-21,06:00:00,2,2,0,FMN GV 05 Lier
60,Mechelsesteenweg 365,2020-03-21,07:00:00,4,0,4,FMN GV 05 Lier
60,Mechelsesteenweg 365,2020-03-21,08:00:00,16,8,8,FMN GV 05 Lier
60,Mechelsesteenweg 365,2020-03-21,09:00:00,108,66,42,FMN GV 05 Lier
60,Mechelsesteenweg 365,2020-03-21,10:00:00,284,174,110,FMN GV 05 Lier
60,Mechelsesteenweg 365,2020-03-21,11:00:00,306,166,140,FMN GV 05 Lier
60,Mechelsesteenweg 365,2020-03-21,12:00:00,264,100,164,FMN GV 05 Lier
60,Mechelsesteenweg 365,2020-03-21,13:00:00,348,146,202,FMN GV 05 Lier
60,Mechelsesteenweg 365,2020-03-21,14:00:00,446,212,234,FMN GV 05 Lier
60,Mechelsesteenweg 365,2020-03-21,15:00:00,428,178,250,FMN GV 05 Lier
60,Mechelsesteenweg 365,2020-03-21,16:00:00,256,72,184,FMN GV 05 Lier
60,Mechelsesteenweg 365,2020-03-21,17:00:00,134,44,90,FMN GV 05 Lier
60,Mechelsesteenweg 365,2020-03-21,18:00:00,24,4,20,FMN GV 05 Lier
60,Mechelsesteenweg 365,2020-03-21,19:00:00,14,10,4,FMN GV 05 Lier
60,Mechelsesteenweg 365,2020-03-21,20:00:00,10,2,8,FMN GV 05 Lier
60,Mechelsesteenweg 365,2020-03-21,21:00:00,0,0,0,FMN GV 05 Lier
60,Mechelsesteenweg 365,2020-03-21,22:00:00,0,0,0,FMN GV 05 Lier
60,Mechelsesteenweg 365,2020-03-21,23:00:00,0,0,0,FMN GV 05 Lier
60,Mechelsesteenweg 365,2020-03-22,00:00:00,0,0,0,FMN GV 05 Lier
60,Mechelsesteenweg 365,2020-03-22,01:00:00,0,0,0,FMN GV 05 Lier
60,Mechelsesteenweg 365,2020-03-22,02:00:00,0,0,0,FMN GV 05 Lier
60,Mechelsesteenweg 365,2020-03-22,03:00:00,0,0,0,FMN GV 05 Lier
60,Mechelsesteenweg 365,2020-03-22,04:00:00,0,0,0,FMN GV 05 Lier
60,Mechelsesteenweg 365,2020-03-22,05:00:00,0,0,0,FMN GV 05 Lier
60,Mechelsesteenweg 365,2020-03-22,06:00:00,2,2,0,FMN GV 05 Lier
60,Mechelsesteenweg 365,2020-03-22,07:00:00,8,2,6,FMN GV 05 Lier
60,Mechelsesteenweg 365,2020-03-22,08:00:00,30,22,8,FMN GV 05 Lier
60,Mechelsesteenweg 365,2020-03-22,09:00:00,168,108,60,FMN GV 05 Lier
60,Mechelsesteenweg 365,2020-03-22,10:00:00,332,152,180,FMN GV 05 Lier
60,Mechelsesteenweg 365,2020-03-22,11:00:00,422,192,230,FMN GV 05 Lier
60,Mechelsesteenweg 365,2020-03-22,12:00:00,334,134,200,FMN GV 05 Lier
60,Mechelsesteenweg 365,2020-03-22,13:00:00,402,206,196,FMN GV 05 Lier
60,Mechelsesteenweg 365,2020-03-22,14:00:00,570,236,334,FMN GV 05 Lier
60,Mechelsesteenweg 365,2020-03-22,15:00:00,566,210,356,FMN GV 05 Lier
60,Mechelsesteenweg 365,2020-03-22,16:00:00,386,124,262,FMN GV 05 Lier
60,Mechelsesteenweg 365,2020-03-22,17:00:00,128,38,90,FMN GV 05 Lier
60,Mechelsesteenweg 365,2020-03-22,18:00:00,24,10,14,FMN GV 05 Lier
60,Mechelsesteenweg 365,2020-03-22,19:00:00,4,2,2,FMN GV 05 Lier
60,Mechelsesteenweg 365,2020-03-22,20:00:00,2,0,2,FMN GV 05 Lier
60,Mechelsesteenweg 365,2020-03-22,21:00:00,2,0,2,FMN GV 05 Lier
60,Mechelsesteenweg 365,2020-03-22,22:00:00,2,2,0,FMN GV 05 Lier
60,Mechelsesteenweg 365,2020-03-22,23:00:00,0,0,0,FMN GV 05 Lier
60,Mechelsesteenweg 365,2020-03-23,00:00:00,0,0,0,FMN GV 05 Lier
60,Mechelsesteenweg 365,2020-03-23,01:00:00,0,0,0,FMN GV 05 Lier
60,Mechelsesteenweg 365,2020-03-23,02:00:00,0,0,0,FMN GV 05 Lier
60,Mechelsesteenweg 365,2020-03-23,03:00:00,2,0,2,FMN GV 05 Lier
60,Mechelsesteenweg 365,2020-03-23,04:00:00,0,0,0,FMN GV 05 Lier
60,Mechelsesteenweg 365,2020-03-23,05:00:00,4,2,2,FMN GV 05 Lier
60,Mechelsesteenweg 365,2020-03-23,06:00:00,24,4,20,FMN GV 05 Lier
60,Mechelsesteenweg 365,2020-03-23,07:00:00,54,22,32,FMN GV 05 Lier
60,Mechelsesteenweg 365,2020-03-23,08:00:00,38,14,24,FMN GV 05 Lier
60,Mechelsesteenweg 365,2020-03-23,09:00:00,44,18,26,FMN GV 05 Lier
60,Mechelsesteenweg 365,2020-03-23,10:00:00,58,28,30,FMN GV 05 Lier
60,Mechelsesteenweg 365,2020-03-23,11:00:00,68,28,40,FMN GV 05 Lier
60,Mechelsesteenweg 365,2020-03-23,12:00:00,92,44,48,FMN GV 05 Lier
60,Mechelsesteenweg 365,2020-03-23,13:00:00,116,62,54,FMN GV 05 Lier
60,Mechelsesteenweg 365,2020-03-23,14:00:00,320,156,164,FMN GV 05 Lier
60,Mechelsesteenweg 365,2020-03-23,15:00:00,276,96,180,FMN GV 05 Lier
60,Mechelsesteenweg 365,2020-03-23,16:00:00,186,68,118,FMN GV 05 Lier
60,Mechelsesteenweg 365,2020-03-23,17:00:00,204,104,100,FMN GV 05 Lier
60,Mechelsesteenweg 365,2020-03-23,18:00:00,110,56,54,FMN GV 05 Lier
60,Mechelsesteenweg 365,2020-03-23,19:00:00,32,16,16,FMN GV 05 Lier
60,Mechelsesteenweg 365,2020-03-23,20:00:00,12,6,6,FMN GV 05 Lier
60,Mechelsesteenweg 365,2020-03-23,21:00:00,8,2,6,FMN GV 05 Lier
60,Mechelsesteenweg 365,2020-03-23,22:00:00,0,0,0,FMN GV 05 Lier
60,Mechelsesteenweg 365,2020-03-23,23:00:00,0,0,0,FMN GV 05 Lier
60,Mechelsesteenweg 365,2020-03-24,00:00:00,0,0,0,FMN GV 05 Lier
60,Mechelsesteenweg 365,2020-03-24,01:00:00,0,0,0,FMN GV 05 Lier
60,Mechelsesteenweg 365,2020-03-24,02:00:00,0,0,0,FMN GV 05 Lier
60,Mechelsesteenweg 365,2020-03-24,03:00:00,0,0,0,FMN GV 05 Lier
60,Mechelsesteenweg 365,2020-03-24,04:00:00,2,0,2,FMN GV 05 Lier
60,Mechelsesteenweg 365,2020-03-24,05:00:00,4,2,2,FMN GV 05 Lier
60,Mechelsesteenweg 365,2020-03-24,06:00:00,38,14,24,FMN GV 05 Lier
60,Mechelsesteenweg 365,2020-03-24,07:00:00,62,24,38,FMN GV 05 Lier
60,Mechelsesteenweg 365,2020-03-24,08:00:00,46,22,24,FMN GV 05 Lier
60,Mechelsesteenweg 365,2020-03-24,09:00:00,38,32,6,FMN GV 05 Lier
60,Mechelsesteenweg 365,2020-03-24,10:00:00,94,40,54,FMN GV 05 Lier
60,Mechelsesteenweg 365,2020-03-24,11:00:00,158,82,76,FMN GV 05 Lier
60,Mechelsesteenweg 365,2020-03-24,12:00:00,164,76,88,FMN GV 05 Lier
60,Mechelsesteenweg 365,2020-03-24,13:00:00,264,132,132,FMN GV 05 Lier
60,Mechelsesteenweg 365,2020-03-24,14:00:00,548,260,288,FMN GV 05 Lier
60,Mechelsesteenweg 365,2020-03-24,15:00:00,498,180,318,FMN GV 05 Lier
60,Mechelsesteenweg 365,2020-03-24,16:00:00,400,164,236,FMN GV 05 Lier
60,Mechelsesteenweg 365,2020-03-24,17:00:00,370,152,218,FMN GV 05 Lier
60,Mechelsesteenweg 365,2020-03-24,18:00:00,130,52,78,FMN GV 05 Lier
60,Mechelsesteenweg 365,2020-03-24,19:00:00,26,14,12,FMN GV 05 Lier
60,Mechelsesteenweg 365,2020-03-24,20:00:00,10,4,6,FMN GV 05 Lier
60,Mechelsesteenweg 365,2020-03-24,21:00:00,2,2,0,FMN GV 05 Lier
60,Mechelsesteenweg 365,2020-03-24,22:00:00,4,2,2,FMN GV 05 Lier
60,Mechelsesteenweg 365,2020-03-24,23:00:00,0,0,0,FMN GV 05 Lier
60,Mechelsesteenweg 365,2020-03-25,00:00:00,0,0,0,FMN GV 05 Lier
60,Mechelsesteenweg 365,2020-03-25,01:00:00,0,0,0,FMN GV 05 Lier
60,Mechelsesteenweg 365,2020-03-25,02:00:00,0,0,0,FMN GV 05 Lier
60,Mechelsesteenweg 365,2020-03-25,03:00:00,2,0,2,FMN GV 05 Lier
60,Mechelsesteenweg 365,2020-03-25,04:00:00,2,0,2,FMN GV 05 Lier
60,Mechelsesteenweg 365,2020-03-25,05:00:00,4,2,2,FMN GV 05 Lier
60,Mechelsesteenweg 365,2020-03-25,06:00:00,24,4,20,FMN GV 05 Lier
60,Mechelsesteenweg 365,2020-03-25,07:00:00,44,8,36,FMN GV 05 Lier
60,Mechelsesteenweg 365,2020-03-25,08:00:00,34,12,22,FMN GV 05 Lier
60,Mechelsesteenweg 365,2020-03-25,09:00:00,42,24,18,FMN GV 05 Lier
60,Mechelsesteenweg 365,2020-03-25,10:00:00,90,30,60,FMN GV 05 Lier
60,Mechelsesteenweg 365,2020-03-25,11:00:00,118,62,56,FMN GV 05 Lier
60,Mechelsesteenweg 365,2020-03-25,12:00:00,186,96,90,FMN GV 05 Lier
60,Mechelsesteenweg 365,2020-03-25,13:00:00,306,134,172,FMN GV 05 Lier
60,Mechelsesteenweg 365,2020-03-25,14:00:00,466,214,252,FMN GV 05 Lier
60,Mechelsesteenweg 365,2020-03-25,15:00:00,618,268,350,FMN GV 05 Lier
60,Mechelsesteenweg 365,2020-03-25,16:00:00,336,148,188,FMN GV 05 Lier
60,Mechelsesteenweg 365,2020-03-25,17:00:00,294,140,154,FMN GV 05 Lier
60,Mechelsesteenweg 365,2020-03-25,18:00:00,164,50,114,FMN GV 05 Lier
60,Mechelsesteenweg 365,2020-03-25,19:00:00,40,24,16,FMN GV 05 Lier
60,Mechelsesteenweg 365,2020-03-25,20:00:00,4,4,0,FMN GV 05 Lier
60,Mechelsesteenweg 365,2020-03-25,21:00:00,14,8,6,FMN GV 05 Lier
60,Mechelsesteenweg 365,2020-03-25,22:00:00,4,0,4,FMN GV 05 Lier
60,Mechelsesteenweg 365,2020-03-25,23:00:00,6,0,6,FMN GV 05 Lier
60,Mechelsesteenweg 365,2020-03-26,00:00:00,0,0,0,FMN GV 05 Lier
60,Mechelsesteenweg 365,2020-03-26,01:00:00,0,0,0,FMN GV 05 Lier
60,Mechelsesteenweg 365,2020-03-26,02:00:00,0,0,0,FMN GV 05 Lier
60,Mechelsesteenweg 365,2020-03-26,03:00:00,2,0,2,FMN GV 05 Lier
60,Mechelsesteenweg 365,2020-03-26,04:00:00,0,0,0,FMN GV 05 Lier
60,Mechelsesteenweg 365,2020-03-26,05:00:00,6,2,4,FMN GV 05 Lier
60,Mechelsesteenweg 365,2020-03-26,06:00:00,24,8,16,FMN GV 05 Lier
60,Mechelsesteenweg 365,2020-03-26,07:00:00,50,14,36,FMN GV 05 Lier
60,Mechelsesteenweg 365,2020-03-26,08:00:00,56,22,34,FMN GV 05 Lier
60,Mechelsesteenweg 365,2020-03-26,09:00:00,44,16,28,FMN GV 05 Lier
60,Mechelsesteenweg 365,2020-03-26,10:00:00,114,66,48,FMN GV 05 Lier
60,Mechelsesteenweg 365,2020-03-26,11:00:00,134,60,74,FMN GV 05 Lier
60,Mechelsesteenweg 365,2020-03-26,12:00:00,124,50,74,FMN GV 05 Lier
60,Mechelsesteenweg 365,2020-03-26,13:00:00,236,108,128,FMN GV 05 Lier
60,Mechelsesteenweg 365,2020-03-26,14:00:00,328,156,172,FMN GV 05 Lier
60,Mechelsesteenweg 365,2020-03-26,15:00:00,376,162,214,FMN GV 05 Lier
60,Mechelsesteenweg 365,2020-03-26,16:00:00,288,120,168,FMN GV 05 Lier
60,Mechelsesteenweg 365,2020-03-26,17:00:00,288,120,168,FMN GV 05 Lier
60,Mechelsesteenweg 365,2020-03-26,18:00:00,108,54,54,FMN GV 05 Lier
60,Mechelsesteenweg 365,2020-03-26,19:00:00,10,2,8,FMN GV 05 Lier
60,Mechelsesteenweg 365,2020-03-26,20:00:00,4,4,0,FMN GV 05 Lier
60,Mechelsesteenweg 365,2020-03-26,21:00:00,0,0,0,FMN GV 05 Lier
60,Mechelsesteenweg 365,2020-03-26,22:00:00,0,0,0,FMN GV 05 Lier
60,Mechelsesteenweg 365,2020-03-26,23:00:00,0,0,0,FMN GV 05 Lier
60,Mechelsesteenweg 365,2020-03-27,00:00:00,0,0,0,FMN GV 05 Lier
60,Mechelsesteenweg 365,2020-03-27,01:00:00,0,0,0,FMN GV 05 Lier
60,Mechelsesteenweg 365,2020-03-27,02:00:00,0,0,0,FMN GV 05 Lier
60,Mechelsesteenweg 365,2020-03-27,03:00:00,2,0,2,FMN GV 05 Lier
60,Mechelsesteenweg 365,2020-03-27,04:00:00,0,0,0,FMN GV 05 Lier
60,Mechelsesteenweg 365,2020-03-27,05:00:00,2,0,2,FMN GV 05 Lier
60,Mechelsesteenweg 365,2020-03-27,06:00:00,12,4,8,FMN GV 05 Lier
60,Mechelsesteenweg 365,2020-03-27,07:00:00,58,24,34,FMN GV 05 Lier
60,Mechelsesteenweg 365,2020-03-27,08:00:00,44,20,24,FMN GV 05 Lier
60,Mechelsesteenweg 365,2020-03-27,09:00:00,48,16,32,FMN GV 05 Lier
60,Mechelsesteenweg 365,2020-03-27,10:00:00,96,44,52,FMN GV 05 Lier
60,Mechelsesteenweg 365,2020-03-27,11:00:00,140,60,80,FMN GV 05 Lier
60,Mechelsesteenweg 365,2020-03-27,12:00:00,192,90,102,FMN GV 05 Lier
60,Mechelsesteenweg 365,2020-03-27,13:00:00,254,142,112,FMN GV 05 Lier
60,Mechelsesteenweg 365,2020-03-27,14:00:00,522,258,264,FMN GV 05 Lier
60,Mechelsesteenweg 365,2020-03-27,15:00:00,570,228,342,FMN GV 05 Lier
60,Mechelsesteenweg 365,2020-03-27,16:00:00,358,146,212,FMN GV 05 Lier
60,Mechelsesteenweg 365,2020-03-27,17:00:00,234,102,132,FMN GV 05 Lier
60,Mechelsesteenweg 365,2020-03-27,18:00:00,118,60,58,FMN GV 05 Lier
60,Mechelsesteenweg 365,2020-03-27,19:00:00,28,14,14,FMN GV 05 Lier
60,Mechelsesteenweg 365,2020-03-27,20:00:00,16,4,12,FMN GV 05 Lier
60,Mechelsesteenweg 365,2020-03-27,21:00:00,2,2,0,FMN GV 05 Lier
60,Mechelsesteenweg 365,2020-03-27,22:00:00,8,2,6,FMN GV 05 Lier
60,Mechelsesteenweg 365,2020-03-27,23:00:00,4,4,0,FMN GV 05 Lier
60,Mechelsesteenweg 365,2020-03-28,00:00:00,0,0,0,FMN GV 05 Lier
60,Mechelsesteenweg 365,2020-03-28,01:00:00,4,2,2,FMN GV 05 Lier
60,Mechelsesteenweg 365,2020-03-28,02:00:00,0,0,0,FMN GV 05 Lier
60,Mechelsesteenweg 365,2020-03-28,03:00:00,0,0,0,FMN GV 05 Lier
60,Mechelsesteenweg 365,2020-03-28,04:00:00,0,0,0,FMN GV 05 Lier
60,Mechelsesteenweg 365,2020-03-28,05:00:00,0,0,0,FMN GV 05 Lier
60,Mechelsesteenweg 365,2020-03-28,06:00:00,6,4,2,FMN GV 05 Lier
60,Mechelsesteenweg 365,2020-03-28,07:00:00,8,2,6,FMN GV 05 Lier
60,Mechelsesteenweg 365,2020-03-28,08:00:00,38,16,22,FMN GV 05 Lier
60,Mechelsesteenweg 365,2020-03-28,09:00:00,110,70,40,FMN GV 05 Lier
60,Mechelsesteenweg 365,2020-03-28,10:00:00,284,150,134,FMN GV 05 Lier
60,Mechelsesteenweg 365,2020-03-28,11:00:00,426,194,232,FMN GV 05 Lier
60,Mechelsesteenweg 365,2020-03-28,12:00:00,360,146,214,FMN GV 05 Lier
60,Mechelsesteenweg 365,2020-03-28,13:00:00,456,222,234,FMN GV 05 Lier
60,Mechelsesteenweg 365,2020-03-28,14:00:00,752,318,434,FMN GV 05 Lier
60,Mechelsesteenweg 365,2020-03-28,15:00:00,774,318,456,FMN GV 05 Lier
60,Mechelsesteenweg 365,2020-03-28,16:00:00,548,218,330,FMN GV 05 Lier
60,Mechelsesteenweg 365,2020-03-28,17:00:00,206,62,144,FMN GV 05 Lier
60,Mechelsesteenweg 365,2020-03-28,18:00:00,72,22,50,FMN GV 05 Lier
60,Mechelsesteenweg 365,2020-03-28,19:00:00,18,12,6,FMN GV 05 Lier
60,Mechelsesteenweg 365,2020-03-28,20:00:00,10,6,4,FMN GV 05 Lier
60,Mechelsesteenweg 365,2020-03-28,21:00:00,6,2,4,FMN GV 05 Lier
60,Mechelsesteenweg 365,2020-03-28,22:00:00,6,0,6,FMN GV 05 Lier
60,Mechelsesteenweg 365,2020-03-28,23:00:00,4,0,4,FMN GV 05 Lier
60,Mechelsesteenweg 365,2020-03-29,00:00:00,0,0,0,FMN GV 05 Lier
60,Mechelsesteenweg 365,2020-03-29,01:00:00,0,0,0,FMN GV 05 Lier
60,Mechelsesteenweg 365,2020-03-29,02:00:00,0,0,0,FMN GV 05 Lier
60,Mechelsesteenweg 365,2020-03-29,03:00:00,0,0,0,FMN GV 05 Lier
60,Mechelsesteenweg 365,2020-03-29,04:00:00,0,0,0,FMN GV 05 Lier
60,Mechelsesteenweg 365,2020-03-29,05:00:00,0,0,0,FMN GV 05 Lier
60,Mechelsesteenweg 365,2020-03-29,06:00:00,0,0,0,FMN GV 05 Lier
60,Mechelsesteenweg 365,2020-03-29,07:00:00,12,4,8,FMN GV 05 Lier
60,Mechelsesteenweg 365,2020-03-29,08:00:00,14,4,10,FMN GV 05 Lier
60,Mechelsesteenweg 365,2020-03-29,09:00:00,54,26,28,FMN GV 05 Lier
60,Mechelsesteenweg 365,2020-03-29,10:00:00,162,86,76,FMN GV 05 Lier
60,Mechelsesteenweg 365,2020-03-29,11:00:00,226,82,144,FMN GV 05 Lier
60,Mechelsesteenweg 365,2020-03-29,12:00:00,152,44,108,FMN GV 05 Lier
60,Mechelsesteenweg 365,2020-03-29,13:00:00,86,36,50,FMN GV 05 Lier
60,Mechelsesteenweg 365,2020-03-29,14:00:00,60,24,36,FMN GV 05 Lier
60,Mechelsesteenweg 365,2020-03-29,15:00:00,42,12,30,FMN GV 05 Lier
60,Mechelsesteenweg 365,2020-03-29,16:00:00,74,30,44,FMN GV 05 Lier
60,Mechelsesteenweg 365,2020-03-29,17:00:00,30,14,16,FMN GV 05 Lier
60,Mechelsesteenweg 365,2020-03-29,18:00:00,26,12,14,FMN GV 05 Lier
60,Mechelsesteenweg 365,2020-03-29,19:00:00,8,2,6,FMN GV 05 Lier
60,Mechelsesteenweg 365,2020-03-29,20:00:00,2,2,0,FMN GV 05 Lier
60,Mechelsesteenweg 365,2020-03-29,21:00:00,0,0,0,FMN GV 05 Lier
60,Mechelsesteenweg 365,2020-03-29,22:00:00,2,0,2,FMN GV 05 Lier
60,Mechelsesteenweg 365,2020-03-29,23:00:00,0,0,0,FMN GV 05 Lier
60,Mechelsesteenweg 365,2020-03-30,00:00:00,0,0,0,FMN GV 05 Lier
60,Mechelsesteenweg 365,2020-03-30,01:00:00,0,0,0,FMN GV 05 Lier
60,Mechelsesteenweg 365,2020-03-30,02:00:00,0,0,0,FMN GV 05 Lier
60,Mechelsesteenweg 365,2020-03-30,03:00:00,0,0,0,FMN GV 05 Lier
60,Mechelsesteenweg 365,2020-03-30,04:00:00,2,0,2,FMN GV 05 Lier
60,Mechelsesteenweg 365,2020-03-30,05:00:00,6,0,6,FMN GV 05 Lier
60,Mechelsesteenweg 365,2020-03-30,06:00:00,10,4,6,FMN GV 05 Lier
60,Mechelsesteenweg 365,2020-03-30,07:00:00,42,14,28,FMN GV 05 Lier
60,Mechelsesteenweg 365,2020-03-30,08:00:00,36,10,26,FMN GV 05 Lier
60,Mechelsesteenweg 365,2020-03-30,09:00:00,44,22,22,FMN GV 05 Lier
60,Mechelsesteenweg 365,2020-03-30,10:00:00,70,34,36,FMN GV 05 Lier
60,Mechelsesteenweg 365,2020-03-30,11:00:00,160,90,70,FMN GV 05 Lier
60,Mechelsesteenweg 365,2020-03-30,12:00:00,136,60,76,FMN GV 05 Lier
60,Mechelsesteenweg 365,2020-03-30,13:00:00,182,86,96,FMN GV 05 Lier
60,Mechelsesteenweg 365,2020-03-30,14:00:00,198,92,106,FMN GV 05 Lier
60,Mechelsesteenweg 365,2020-03-30,15:00:00,146,62,84,FMN GV 05 Lier
60,Mechelsesteenweg 365,2020-03-30,16:00:00,120,64,56,FMN GV 05 Lier
60,Mechelsesteenweg 365,2020-03-30,17:00:00,80,44,36,FMN GV 05 Lier
60,Mechelsesteenweg 365,2020-03-30,18:00:00,68,34,34,FMN GV 05 Lier
60,Mechelsesteenweg 365,2020-03-30,19:00:00,20,8,12,FMN GV 05 Lier
60,Mechelsesteenweg 365,2020-03-30,20:00:00,14,8,6,FMN GV 05 Lier
60,Mechelsesteenweg 365,2020-03-30,21:00:00,0,0,0,FMN GV 05 Lier
60,Mechelsesteenweg 365,2020-03-30,22:00:00,2,0,2,FMN GV 05 Lier
60,Mechelsesteenweg 365,2020-03-30,23:00:00,0,0,0,FMN GV 05 Lier
60,Mechelsesteenweg 365,2020-03-31,00:00:00,0,0,0,FMN GV 05 Lier
60,Mechelsesteenweg 365,2020-03-31,01:00:00,0,0,0,FMN GV 05 Lier
60,Mechelsesteenweg 365,2020-03-31,02:00:00,0,0,0,FMN GV 05 Lier
60,Mechelsesteenweg 365,2020-03-31,03:00:00,0,0,0,FMN GV 05 Lier
60,Mechelsesteenweg 365,2020-03-31,04:00:00,2,0,2,FMN GV 05 Lier
60,Mechelsesteenweg 365,2020-03-31,05:00:00,4,2,2,FMN GV 05 Lier
60,Mechelsesteenweg 365,2020-03-31,06:00:00,14,6,8,FMN GV 05 Lier
60,Mechelsesteenweg 365,2020-03-31,07:00:00,50,18,32,FMN GV 05 Lier
60,Mechelsesteenweg 365,2020-03-31,08:00:00,24,4,20,FMN GV 05 Lier
60,Mechelsesteenweg 365,2020-03-31,09:00:00,22,16,6,FMN GV 05 Lier
60,Mechelsesteenweg 365,2020-03-31,10:00:00,74,32,42,FMN GV 05 Lier
60,Mechelsesteenweg 365,2020-03-31,11:00:00,108,46,62,FMN GV 05 Lier
60,Mechelsesteenweg 365,2020-03-31,12:00:00,120,46,74,FMN GV 05 Lier
60,Mechelsesteenweg 365,2020-03-31,13:00:00,144,78,66,FMN GV 05 Lier
60,Mechelsesteenweg 365,2020-03-31,14:00:00,356,184,172,FMN GV 05 Lier
60,Mechelsesteenweg 365,2020-03-31,15:00:00,372,160,212,FMN GV 05 Lier
60,Mechelsesteenweg 365,2020-03-31,16:00:00,366,148,218,FMN GV 05 Lier
60,Mechelsesteenweg 365,2020-03-31,17:00:00,272,144,128,FMN GV 05 Lier
60,Mechelsesteenweg 365,2020-03-31,18:00:00,208,98,110,FMN GV 05 Lier
60,Mechelsesteenweg 365,2020-03-31,19:00:00,82,26,56,FMN GV 05 Lier
60,Mechelsesteenweg 365,2020-03-31,20:00:00,42,12,30,FMN GV 05 Lier
60,Mechelsesteenweg 365,2020-03-31,21:00:00,6,2,4,FMN GV 05 Lier
60,Mechelsesteenweg 365,2020-03-31,22:00:00,2,0,2,FMN GV 05 Lier
60,Mechelsesteenweg 365,2020-03-31,23:00:00,2,0,2,FMN GV 05 Lier
60,Mechelsesteenweg 365,2020-04-01,00:00:00,0,0,0,FMN GV 05 Lier
60,Mechelsesteenweg 365,2020-04-01,01:00:00,2,2,0,FMN GV 05 Lier
60,Mechelsesteenweg 365,2020-04-01,02:00:00,2,0,2,FMN GV 05 Lier
60,Mechelsesteenweg 365,2020-04-01,03:00:00,0,0,0,FMN GV 05 Lier
60,Mechelsesteenweg 365,2020-04-01,04:00:00,2,0,2,FMN GV 05 Lier
60,Mechelsesteenweg 365,2020-04-01,05:00:00,4,0,4,FMN GV 05 Lier
60,Mechelsesteenweg 365,2020-04-01,06:00:00,20,6,14,FMN GV 05 Lier
60,Mechelsesteenweg 365,2020-04-01,07:00:00,66,22,44,FMN GV 05 Lier
60,Mechelsesteenweg 365,2020-04-01,08:00:00,24,14,10,FMN GV 05 Lier
60,Mechelsesteenweg 365,2020-04-01,09:00:00,34,16,18,FMN GV 05 Lier
60,Mechelsesteenweg 365,2020-04-01,10:00:00,86,48,38,FMN GV 05 Lier
60,Mechelsesteenweg 365,2020-04-01,11:00:00,114,72,42,FMN GV 05 Lier
60,Mechelsesteenweg 365,2020-04-01,12:00:00,160,70,90,FMN GV 05 Lier
60,Mechelsesteenweg 365,2020-04-01,13:00:00,258,140,118,FMN GV 05 Lier
60,Mechelsesteenweg 365,2020-04-01,14:00:00,478,242,236,FMN GV 05 Lier
60,Mechelsesteenweg 365,2020-04-01,15:00:00,554,226,328,FMN GV 05 Lier
60,Mechelsesteenweg 365,2020-04-01,16:00:00,404,170,234,FMN GV 05 Lier
60,Mechelsesteenweg 365,2020-04-01,17:00:00,318,146,172,FMN GV 05 Lier
60,Mechelsesteenweg 365,2020-04-01,18:00:00,160,70,90,FMN GV 05 Lier
60,Mechelsesteenweg 365,2020-04-01,19:00:00,98,42,56,FMN GV 05 Lier
60,Mechelsesteenweg 365,2020-04-01,20:00:00,16,2,14,FMN GV 05 Lier
60,Mechelsesteenweg 365,2020-04-01,21:00:00,10,8,2,FMN GV 05 Lier
60,Mechelsesteenweg 365,2020-04-01,22:00:00,4,2,2,FMN GV 05 Lier
60,Mechelsesteenweg 365,2020-04-01,23:00:00,0,0,0,FMN GV 05 Lier
60,Mechelsesteenweg 365,2020-04-02,00:00:00,0,0,0,FMN GV 05 Lier
60,Mechelsesteenweg 365,2020-04-02,01:00:00,0,0,0,FMN GV 05 Lier
60,Mechelsesteenweg 365,2020-04-02,02:00:00,0,0,0,FMN GV 05 Lier
60,Mechelsesteenweg 365,2020-04-02,03:00:00,0,0,0,FMN GV 05 Lier
60,Mechelsesteenweg 365,2020-04-02,04:00:00,2,0,2,FMN GV 05 Lier
60,Mechelsesteenweg 365,2020-04-02,05:00:00,8,2,6,FMN GV 05 Lier
60,Mechelsesteenweg 365,2020-04-02,06:00:00,8,2,6,FMN GV 05 Lier
60,Mechelsesteenweg 365,2020-04-02,07:00:00,30,8,22,FMN GV 05 Lier
60,Mechelsesteenweg 365,2020-04-02,08:00:00,46,22,24,FMN GV 05 Lier
60,Mechelsesteenweg 365,2020-04-02,09:00:00,42,22,20,FMN GV 05 Lier
60,Mechelsesteenweg 365,2020-04-02,10:00:00,82,34,48,FMN GV 05 Lier
60,Mechelsesteenweg 365,2020-04-02,11:00:00,112,52,60,FMN GV 05 Lier
60,Mechelsesteenweg 365,2020-04-02,12:00:00,128,54,74,FMN GV 05 Lier
60,Mechelsesteenweg 365,2020-04-02,13:00:00,164,90,74,FMN GV 05 Lier
60,Mechelsesteenweg 365,2020-04-02,14:00:00,198,90,108,FMN GV 05 Lier
60,Mechelsesteenweg 365,2020-04-02,15:00:00,240,130,110,FMN GV 05 Lier
60,Mechelsesteenweg 365,2020-04-02,16:00:00,146,72,74,FMN GV 05 Lier
60,Mechelsesteenweg 365,2020-04-02,17:00:00,146,68,78,FMN GV 05 Lier
60,Mechelsesteenweg 365,2020-04-02,18:00:00,88,54,34,FMN GV 05 Lier
60,Mechelsesteenweg 365,2020-04-02,19:00:00,46,28,18,FMN GV 05 Lier
60,Mechelsesteenweg 365,2020-04-02,20:00:00,26,6,20,FMN GV 05 Lier
60,Mechelsesteenweg 365,2020-04-02,21:00:00,6,2,4,FMN GV 05 Lier
60,Mechelsesteenweg 365,2020-04-02,22:00:00,12,6,6,FMN GV 05 Lier
60,Mechelsesteenweg 365,2020-04-02,23:00:00,0,0,0,FMN GV 05 Lier
60,Mechelsesteenweg 365,2020-04-03,00:00:00,0,0,0,FMN GV 05 Lier
60,Mechelsesteenweg 365,2020-04-03,01:00:00,0,0,0,FMN GV 05 Lier
60,Mechelsesteenweg 365,2020-04-03,02:00:00,0,0,0,FMN GV 05 Lier
60,Mechelsesteenweg 365,2020-04-03,03:00:00,0,0,0,FMN GV 05 Lier
60,Mechelsesteenweg 365,2020-04-03,04:00:00,0,0,0,FMN GV 05 Lier
60,Mechelsesteenweg 365,2020-04-03,05:00:00,4,0,4,FMN GV 05 Lier
60,Mechelsesteenweg 365,2020-04-03,06:00:00,10,4,6,FMN GV 05 Lier
60,Mechelsesteenweg 365,2020-04-03,07:00:00,32,8,24,FMN GV 05 Lier
60,Mechelsesteenweg 365,2020-04-03,08:00:00,36,10,26,FMN GV 05 Lier
60,Mechelsesteenweg 365,2020-04-03,09:00:00,60,30,30,FMN GV 05 Lier
60,Mechelsesteenweg 365,2020-04-03,10:00:00,70,36,34,FMN GV 05 Lier
60,Mechelsesteenweg 365,2020-04-03,11:00:00,108,60,48,FMN GV 05 Lier
60,Mechelsesteenweg 365,2020-04-03,12:00:00,74,54,20,FMN GV 05 Lier
60,Mechelsesteenweg 365,2020-04-03,13:00:00,128,62,66,FMN GV 05 Lier
60,Mechelsesteenweg 365,2020-04-03,14:00:00,188,110,78,FMN GV 05 Lier
60,Mechelsesteenweg 365,2020-04-03,15:00:00,240,116,124,FMN GV 05 Lier
60,Mechelsesteenweg 365,2020-04-03,16:00:00,176,88,88,FMN GV 05 Lier
60,Mechelsesteenweg 365,2020-04-03,17:00:00,140,72,68,FMN GV 05 Lier
60,Mechelsesteenweg 365,2020-04-03,18:00:00,76,36,40,FMN GV 05 Lier
60,Mechelsesteenweg 365,2020-04-03,19:00:00,36,16,20,FMN GV 05 Lier
60,Mechelsesteenweg 365,2020-04-03,20:00:00,20,14,6,FMN GV 05 Lier
60,Mechelsesteenweg 365,2020-04-03,21:00:00,4,0,4,FMN GV 05 Lier
60,Mechelsesteenweg 365,2020-04-03,22:00:00,2,2,0,FMN GV 05 Lier
60,Mechelsesteenweg 365,2020-04-03,23:00:00,0,0,0,FMN GV 05 Lier
60,Mechelsesteenweg 365,2020-04-04,00:00:00,0,0,0,FMN GV 05 Lier
60,Mechelsesteenweg 365,2020-04-04,01:00:00,0,0,0,FMN GV 05 Lier
60,Mechelsesteenweg 365,2020-04-04,02:00:00,0,0,0,FMN GV 05 Lier
60,Mechelsesteenweg 365,2020-04-04,03:00:00,0,0,0,FMN GV 05 Lier
60,Mechelsesteenweg 365,2020-04-04,04:00:00,0,0,0,FMN GV 05 Lier
60,Mechelsesteenweg 365,2020-04-04,05:00:00,0,0,0,FMN GV 05 Lier
60,Mechelsesteenweg 365,2020-04-04,06:00:00,2,0,2,FMN GV 05 Lier
60,Mechelsesteenweg 365,2020-04-04,07:00:00,10,4,6,FMN GV 05 Lier
60,Mechelsesteenweg 365,2020-04-04,08:00:00,32,14,18,FMN GV 05 Lier
60,Mechelsesteenweg 365,2020-04-04,09:00:00,80,32,48,FMN GV 05 Lier
60,Mechelsesteenweg 365,2020-04-04,10:00:00,260,152,108,FMN GV 05 Lier
60,Mechelsesteenweg 365,2020-04-04,11:00:00,396,202,194,FMN GV 05 Lier
60,Mechelsesteenweg 365,2020-04-04,12:00:00,356,180,176,FMN GV 05 Lier
60,Mechelsesteenweg 365,2020-04-04,13:00:00,398,162,236,FMN GV 05 Lier
60,Mechelsesteenweg 365,2020-04-04,14:00:00,642,338,304,FMN GV 05 Lier
60,Mechelsesteenweg 365,2020-04-04,15:00:00,792,382,410,FMN GV 05 Lier
60,Mechelsesteenweg 365,2020-04-04,16:00:00,540,238,302,FMN GV 05 Lier
60,Mechelsesteenweg 365,2020-04-04,17:00:00,270,128,142,FMN GV 05 Lier
60,Mechelsesteenweg 365,2020-04-04,18:00:00,100,42,58,FMN GV 05 Lier
60,Mechelsesteenweg 365,2020-04-04,19:00:00,64,32,32,FMN GV 05 Lier
60,Mechelsesteenweg 365,2020-04-04,20:00:00,28,6,22,FMN GV 05 Lier
60,Mechelsesteenweg 365,2020-04-04,21:00:00,0,0,0,FMN GV 05 Lier
60,Mechelsesteenweg 365,2020-04-04,22:00:00,2,0,2,FMN GV 05 Lier
60,Mechelsesteenweg 365,2020-04-04,23:00:00,2,2,0,FMN GV 05 Lier
60,Mechelsesteenweg 365,2020-04-05,00:00:00,0,0,0,FMN GV 05 Lier
60,Mechelsesteenweg 365,2020-04-05,01:00:00,0,0,0,FMN GV 05 Lier
60,Mechelsesteenweg 365,2020-04-05,02:00:00,0,0,0,FMN GV 05 Lier
60,Mechelsesteenweg 365,2020-04-05,03:00:00,0,0,0,FMN GV 05 Lier
60,Mechelsesteenweg 365,2020-04-05,04:00:00,0,0,0,FMN GV 05 Lier
60,Mechelsesteenweg 365,2020-04-05,05:00:00,0,0,0,FMN GV 05 Lier
60,Mechelsesteenweg 365,2020-04-05,06:00:00,2,2,0,FMN GV 05 Lier
60,Mechelsesteenweg 365,2020-04-05,07:00:00,8,2,6,FMN GV 05 Lier
60,Mechelsesteenweg 365,2020-04-05,08:00:00,58,36,22,FMN GV 05 Lier
60,Mechelsesteenweg 365,2020-04-05,09:00:00,260,144,116,FMN GV 05 Lier
60,Mechelsesteenweg 365,2020-04-05,10:00:00,620,314,306,FMN GV 05 Lier
60,Mechelsesteenweg 365,2020-04-05,11:00:00,850,384,466,FMN GV 05 Lier
60,Mechelsesteenweg 365,2020-04-05,12:00:00,666,302,364,FMN GV 05 Lier
60,Mechelsesteenweg 365,2020-04-05,13:00:00,838,398,440,FMN GV 05 Lier
60,Mechelsesteenweg 365,2020-04-05,14:00:00,1124,522,602,FMN GV 05 Lier
60,Mechelsesteenweg 365,2020-04-05,15:00:00,992,422,570,FMN GV 05 Lier
60,Mechelsesteenweg 365,2020-04-05,16:00:00,732,272,460,FMN GV 05 Lier
60,Mechelsesteenweg 365,2020-04-05,17:00:00,360,132,228,FMN GV 05 Lier
60,Mechelsesteenweg 365,2020-04-05,18:00:00,194,82,112,FMN GV 05 Lier
60,Mechelsesteenweg 365,2020-04-05,19:00:00,58,22,36,FMN GV 05 Lier
60,Mechelsesteenweg 365,2020-04-05,20:00:00,32,10,22,FMN GV 05 Lier
60,Mechelsesteenweg 365,2020-04-05,21:00:00,6,4,2,FMN GV 05 Lier
60,Mechelsesteenweg 365,2020-04-05,22:00:00,4,0,4,FMN GV 05 Lier
60,Mechelsesteenweg 365,2020-04-05,23:00:00,2,2,0,FMN GV 05 Lier
60,Mechelsesteenweg 365,2020-04-06,00:00:00,0,0,0,FMN GV 05 Lier
60,Mechelsesteenweg 365,2020-04-06,01:00:00,0,0,0,FMN GV 05 Lier
60,Mechelsesteenweg 365,2020-04-06,02:00:00,0,0,0,FMN GV 05 Lier
60,Mechelsesteenweg 365,2020-04-06,03:00:00,0,0,0,FMN GV 05 Lier
60,Mechelsesteenweg 365,2020-04-06,04:00:00,0,0,0,FMN GV 05 Lier
60,Mechelsesteenweg 365,2020-04-06,05:00:00,6,0,6,FMN GV 05 Lier
60,Mechelsesteenweg 365,2020-04-06,06:00:00,18,8,10,FMN GV 05 Lier
60,Mechelsesteenweg 365,2020-04-06,07:00:00,64,24,40,FMN GV 05 Lier
60,Mechelsesteenweg 365,2020-04-06,08:00:00,46,18,28,FMN GV 05 Lier
60,Mechelsesteenweg 365,2020-04-06,09:00:00,40,18,22,FMN GV 05 Lier
60,Mechelsesteenweg 365,2020-04-06,10:00:00,142,78,64,FMN GV 05 Lier
60,Mechelsesteenweg 365,2020-04-06,11:00:00,204,88,116,FMN GV 05 Lier
60,Mechelsesteenweg 365,2020-04-06,12:00:00,226,114,112,FMN GV 05 Lier
60,Mechelsesteenweg 365,2020-04-06,13:00:00,252,114,138,FMN GV 05 Lier
60,Mechelsesteenweg 365,2020-04-06,14:00:00,478,268,210,FMN GV 05 Lier
60,Mechelsesteenweg 365,2020-04-06,15:00:00,466,220,246,FMN GV 05 Lier
60,Mechelsesteenweg 365,2020-04-06,16:00:00,292,128,164,FMN GV 05 Lier
60,Mechelsesteenweg 365,2020-04-06,17:00:00,206,110,96,FMN GV 05 Lier
60,Mechelsesteenweg 365,2020-04-06,18:00:00,106,50,56,FMN GV 05 Lier
60,Mechelsesteenweg 365,2020-04-06,19:00:00,36,18,18,FMN GV 05 Lier
60,Mechelsesteenweg 365,2020-04-06,20:00:00,16,6,10,FMN GV 05 Lier
60,Mechelsesteenweg 365,2020-04-06,21:00:00,8,2,6,FMN GV 05 Lier
60,Mechelsesteenweg 365,2020-04-06,22:00:00,2,0,2,FMN GV 05 Lier
60,Mechelsesteenweg 365,2020-04-06,23:00:00,0,0,0,FMN GV 05 Lier
60,Mechelsesteenweg 365,2020-04-07,00:00:00,8,8,0,FMN GV 05 Lier
60,Mechelsesteenweg 365,2020-04-07,01:00:00,8,0,8,FMN GV 05 Lier
60,Mechelsesteenweg 365,2020-04-07,02:00:00,0,0,0,FMN GV 05 Lier
60,Mechelsesteenweg 365,2020-04-07,03:00:00,0,0,0,FMN GV 05 Lier
60,Mechelsesteenweg 365,2020-04-07,04:00:00,4,0,4,FMN GV 05 Lier
60,Mechelsesteenweg 365,2020-04-07,05:00:00,10,4,6,FMN GV 05 Lier
60,Mechelsesteenweg 365,2020-04-07,06:00:00,38,16,22,FMN GV 05 Lier
60,Mechelsesteenweg 365,2020-04-07,07:00:00,74,32,42,FMN GV 05 Lier
60,Mechelsesteenweg 365,2020-04-07,08:00:00,66,28,38,FMN GV 05 Lier
60,Mechelsesteenweg 365,2020-04-07,09:00:00,90,52,38,FMN GV 05 Lier
60,Mechelsesteenweg 365,2020-04-07,10:00:00,152,88,64,FMN GV 05 Lier
60,Mechelsesteenweg 365,2020-04-07,11:00:00,260,146,114,FMN GV 05 Lier
60,Mechelsesteenweg 365,2020-04-07,12:00:00,310,166,144,FMN GV 05 Lier
60,Mechelsesteenweg 365,2020-04-07,13:00:00,420,202,218,FMN GV 05 Lier
60,Mechelsesteenweg 365,2020-04-07,14:00:00,690,334,356,FMN GV 05 Lier
60,Mechelsesteenweg 365,2020-04-07,15:00:00,604,246,358,FMN GV 05 Lier
60,Mechelsesteenweg 365,2020-04-07,16:00:00,544,212,332,FMN GV 05 Lier
60,Mechelsesteenweg 365,2020-04-07,17:00:00,436,190,246,FMN GV 05 Lier
60,Mechelsesteenweg 365,2020-04-07,18:00:00,258,98,160,FMN GV 05 Lier
60,Mechelsesteenweg 365,2020-04-07,19:00:00,178,72,106,FMN GV 05 Lier
60,Mechelsesteenweg 365,2020-04-07,20:00:00,54,12,42,FMN GV 05 Lier
60,Mechelsesteenweg 365,2020-04-07,21:00:00,12,4,8,FMN GV 05 Lier
60,Mechelsesteenweg 365,2020-04-07,22:00:00,16,10,6,FMN GV 05 Lier
60,Mechelsesteenweg 365,2020-04-07,23:00:00,0,0,0,FMN GV 05 Lier
60,Mechelsesteenweg 365,2020-04-08,00:00:00,0,0,0,FMN GV 05 Lier
60,Mechelsesteenweg 365,2020-04-08,01:00:00,0,0,0,FMN GV 05 Lier
60,Mechelsesteenweg 365,2020-04-08,02:00:00,0,0,0,FMN GV 05 Lier
60,Mechelsesteenweg 365,2020-04-08,03:00:00,0,0,0,FMN GV 05 Lier
60,Mechelsesteenweg 365,2020-04-08,04:00:00,2,0,2,FMN GV 05 Lier
60,Mechelsesteenweg 365,2020-04-08,05:00:00,10,2,8,FMN GV 05 Lier
60,Mechelsesteenweg 365,2020-04-08,06:00:00,32,16,16,FMN GV 05 Lier
60,Mechelsesteenweg 365,2020-04-08,07:00:00,70,28,42,FMN GV 05 Lier
60,Mechelsesteenweg 365,2020-04-08,08:00:00,64,36,28,FMN GV 05 Lier
60,Mechelsesteenweg 365,2020-04-08,09:00:00,104,66,38,FMN GV 05 Lier
60,Mechelsesteenweg 365,2020-04-08,10:00:00,280,156,124,FMN GV 05 Lier
60,Mechelsesteenweg 365,2020-04-08,11:00:00,370,154,216,FMN GV 05 Lier
60,Mechelsesteenweg 365,2020-04-08,12:00:00,318,122,196,FMN GV 05 Lier
60,Mechelsesteenweg 365,2020-04-08,13:00:00,512,268,244,FMN GV 05 Lier
60,Mechelsesteenweg 365,2020-04-08,14:00:00,870,398,472,FMN GV 05 Lier
60,Mechelsesteenweg 365,2020-04-08,15:00:00,784,346,438,FMN GV 05 Lier
60,Mechelsesteenweg 365,2020-04-08,16:00:00,698,298,400,FMN GV 05 Lier
60,Mechelsesteenweg 365,2020-04-08,17:00:00,524,210,314,FMN GV 05 Lier
60,Mechelsesteenweg 365,2020-04-08,18:00:00,302,146,156,FMN GV 05 Lier
60,Mechelsesteenweg 365,2020-04-08,19:00:00,250,102,148,FMN GV 05 Lier
60,Mechelsesteenweg 365,2020-04-08,20:00:00,90,40,50,FMN GV 05 Lier
60,Mechelsesteenweg 365,2020-04-08,21:00:00,24,6,18,FMN GV 05 Lier
60,Mechelsesteenweg 365,2020-04-08,22:00:00,8,6,2,FMN GV 05 Lier
60,Mechelsesteenweg 365,2020-04-08,23:00:00,2,0,2,FMN GV 05 Lier
60,Mechelsesteenweg 365,2020-04-09,00:00:00,0,0,0,FMN GV 05 Lier
60,Mechelsesteenweg 365,2020-04-09,01:00:00,0,0,0,FMN GV 05 Lier
60,Mechelsesteenweg 365,2020-04-09,02:00:00,0,0,0,FMN GV 05 Lier
60,Mechelsesteenweg 365,2020-04-09,03:00:00,0,0,0,FMN GV 05 Lier
60,Mechelsesteenweg 365,2020-04-09,04:00:00,4,0,4,FMN GV 05 Lier
60,Mechelsesteenweg 365,2020-04-09,05:00:00,12,4,8,FMN GV 05 Lier
60,Mechelsesteenweg 365,2020-04-09,06:00:00,22,12,10,FMN GV 05 Lier
60,Mechelsesteenweg 365,2020-04-09,07:00:00,54,18,36,FMN GV 05 Lier
60,Mechelsesteenweg 365,2020-04-09,08:00:00,54,16,38,FMN GV 05 Lier
60,Mechelsesteenweg 365,2020-04-09,09:00:00,82,54,28,FMN GV 05 Lier
60,Mechelsesteenweg 365,2020-04-09,10:00:00,244,116,128,FMN GV 05 Lier
60,Mechelsesteenweg 365,2020-04-09,11:00:00,300,142,158,FMN GV 05 Lier
60,Mechelsesteenweg 365,2020-04-09,12:00:00,198,88,110,FMN GV 05 Lier
60,Mechelsesteenweg 365,2020-04-09,13:00:00,386,180,206,FMN GV 05 Lier
60,Mechelsesteenweg 365,2020-04-09,14:00:00,540,274,266,FMN GV 05 Lier
60,Mechelsesteenweg 365,2020-04-09,15:00:00,646,260,386,FMN GV 05 Lier
60,Mechelsesteenweg 365,2020-04-09,16:00:00,660,294,366,FMN GV 05 Lier
60,Mechelsesteenweg 365,2020-04-09,17:00:00,412,180,232,FMN GV 05 Lier
60,Mechelsesteenweg 365,2020-04-09,18:00:00,268,114,154,FMN GV 05 Lier
60,Mechelsesteenweg 365,2020-04-09,19:00:00,160,66,94,FMN GV 05 Lier
60,Mechelsesteenweg 365,2020-04-09,20:00:00,52,18,34,FMN GV 05 Lier
60,Mechelsesteenweg 365,2020-04-09,21:00:00,16,8,8,FMN GV 05 Lier
60,Mechelsesteenweg 365,2020-04-09,22:00:00,0,0,0,FMN GV 05 Lier
60,Mechelsesteenweg 365,2020-04-09,23:00:00,2,0,2,FMN GV 05 Lier
60,Mechelsesteenweg 365,2020-04-10,00:00:00,0,0,0,FMN GV 05 Lier
60,Mechelsesteenweg 365,2020-04-10,01:00:00,0,0,0,FMN GV 05 Lier
60,Mechelsesteenweg 365,2020-04-10,02:00:00,0,0,0,FMN GV 05 Lier
60,Mechelsesteenweg 365,2020-04-10,03:00:00,0,0,0,FMN GV 05 Lier
60,Mechelsesteenweg 365,2020-04-10,04:00:00,0,0,0,FMN GV 05 Lier
60,Mechelsesteenweg 365,2020-04-10,05:00:00,12,0,12,FMN GV 05 Lier
60,Mechelsesteenweg 365,2020-04-10,06:00:00,18,6,12,FMN GV 05 Lier
60,Mechelsesteenweg 365,2020-04-10,07:00:00,38,14,24,FMN GV 05 Lier
60,Mechelsesteenweg 365,2020-04-10,08:00:00,58,22,36,FMN GV 05 Lier
60,Mechelsesteenweg 365,2020-04-10,09:00:00,108,66,42,FMN GV 05 Lier
60,Mechelsesteenweg 365,2020-04-10,10:00:00,200,102,98,FMN GV 05 Lier
60,Mechelsesteenweg 365,2020-04-10,11:00:00,316,134,182,FMN GV 05 Lier
60,Mechelsesteenweg 365,2020-04-10,12:00:00,336,142,194,FMN GV 05 Lier
60,Mechelsesteenweg 365,2020-04-10,13:00:00,436,238,198,FMN GV 05 Lier
60,Mechelsesteenweg 365,2020-04-10,14:00:00,760,396,364,FMN GV 05 Lier
60,Mechelsesteenweg 365,2020-04-10,15:00:00,820,352,468,FMN GV 05 Lier
60,Mechelsesteenweg 365,2020-04-10,16:00:00,676,272,404,FMN GV 05 Lier
60,Mechelsesteenweg 365,2020-04-10,17:00:00,370,172,198,FMN GV 05 Lier
60,Mechelsesteenweg 365,2020-04-10,18:00:00,216,84,132,FMN GV 05 Lier
60,Mechelsesteenweg 365,2020-04-10,19:00:00,144,58,86,FMN GV 05 Lier
60,Mechelsesteenweg 365,2020-04-10,20:00:00,60,20,40,FMN GV 05 Lier
60,Mechelsesteenweg 365,2020-04-10,21:00:00,24,12,12,FMN GV 05 Lier
60,Mechelsesteenweg 365,2020-04-10,22:00:00,4,2,2,FMN GV 05 Lier
60,Mechelsesteenweg 365,2020-04-10,23:00:00,6,0,6,FMN GV 05 Lier
60,Mechelsesteenweg 365,2020-04-11,00:00:00,2,0,2,FMN GV 05 Lier
60,Mechelsesteenweg 365,2020-04-11,01:00:00,0,0,0,FMN GV 05 Lier
60,Mechelsesteenweg 365,2020-04-11,02:00:00,0,0,0,FMN GV 05 Lier
60,Mechelsesteenweg 365,2020-04-11,03:00:00,0,0,0,FMN GV 05 Lier
60,Mechelsesteenweg 365,2020-04-11,04:00:00,0,0,0,FMN GV 05 Lier
60,Mechelsesteenweg 365,2020-04-11,05:00:00,4,0,4,FMN GV 05 Lier
60,Mechelsesteenweg 365,2020-04-11,06:00:00,8,6,2,FMN GV 05 Lier
60,Mechelsesteenweg 365,2020-04-11,07:00:00,14,6,8,FMN GV 05 Lier
60,Mechelsesteenweg 365,2020-04-11,08:00:00,60,36,24,FMN GV 05 Lier
60,Mechelsesteenweg 365,2020-04-11,09:00:00,164,80,84,FMN GV 05 Lier
60,Mechelsesteenweg 365,2020-04-11,10:00:00,432,206,226,FMN GV 05 Lier
60,Mechelsesteenweg 365,2020-04-11,11:00:00,610,212,398,FMN GV 05 Lier
60,Mechelsesteenweg 365,2020-04-11,12:00:00,510,232,278,FMN GV 05 Lier
60,Mechelsesteenweg 365,2020-04-11,13:00:00,704,348,356,FMN GV 05 Lier
60,Mechelsesteenweg 365,2020-04-11,14:00:00,924,468,456,FMN GV 05 Lier
60,Mechelsesteenweg 365,2020-04-11,15:00:00,1112,480,632,FMN GV 05 Lier
60,Mechelsesteenweg 365,2020-04-11,16:00:00,822,352,470,FMN GV 05 Lier
60,Mechelsesteenweg 365,2020-04-11,17:00:00,542,226,316,FMN GV 05 Lier
60,Mechelsesteenweg 365,2020-04-11,18:00:00,198,46,152,FMN GV 05 Lier
60,Mechelsesteenweg 365,2020-04-11,19:00:00,128,48,80,FMN GV 05 Lier
60,Mechelsesteenweg 365,2020-04-11,20:00:00,56,20,36,FMN GV 05 Lier
60,Mechelsesteenweg 365,2020-04-11,21:00:00,14,10,4,FMN GV 05 Lier
60,Mechelsesteenweg 365,2020-04-11,22:00:00,16,4,12,FMN GV 05 Lier
60,Mechelsesteenweg 365,2020-04-11,23:00:00,4,0,4,FMN GV 05 Lier
60,Mechelsesteenweg 365,2020-04-12,00:00:00,4,4,0,FMN GV 05 Lier
60,Mechelsesteenweg 365,2020-04-12,01:00:00,2,0,2,FMN GV 05 Lier
60,Mechelsesteenweg 365,2020-04-12,02:00:00,0,0,0,FMN GV 05 Lier
60,Mechelsesteenweg 365,2020-04-12,03:00:00,0,0,0,FMN GV 05 Lier
60,Mechelsesteenweg 365,2020-04-12,04:00:00,0,0,0,FMN GV 05 Lier
60,Mechelsesteenweg 365,2020-04-12,05:00:00,0,0,0,FMN GV 05 Lier
60,Mechelsesteenweg 365,2020-04-12,06:00:00,2,2,0,FMN GV 05 Lier
60,Mechelsesteenweg 365,2020-04-12,07:00:00,8,8,0,FMN GV 05 Lier
60,Mechelsesteenweg 365,2020-04-12,08:00:00,88,42,46,FMN GV 05 Lier
60,Mechelsesteenweg 365,2020-04-12,09:00:00,274,152,122,FMN GV 05 Lier
60,Mechelsesteenweg 365,2020-04-12,10:00:00,614,326,288,FMN GV 05 Lier
60,Mechelsesteenweg 365,2020-04-12,11:00:00,688,322,366,FMN GV 05 Lier
60,Mechelsesteenweg 365,2020-04-12,12:00:00,716,324,392,FMN GV 05 Lier
60,Mechelsesteenweg 365,2020-04-12,13:00:00,526,252,274,FMN GV 05 Lier
60,Mechelsesteenweg 365,2020-04-12,14:00:00,672,296,376,FMN GV 05 Lier
60,Mechelsesteenweg 365,2020-04-12,15:00:00,608,278,330,FMN GV 05 Lier
60,Mechelsesteenweg 365,2020-04-12,16:00:00,492,232,260,FMN GV 05 Lier
60,Mechelsesteenweg 365,2020-04-12,17:00:00,304,128,176,FMN GV 05 Lier
60,Mechelsesteenweg 365,2020-04-12,18:00:00,158,74,84,FMN GV 05 Lier
60,Mechelsesteenweg 365,2020-04-12,19:00:00,108,54,54,FMN GV 05 Lier
60,Mechelsesteenweg 365,2020-04-12,20:00:00,82,32,50,FMN GV 05 Lier
60,Mechelsesteenweg 365,2020-04-12,21:00:00,10,6,4,FMN GV 05 Lier
60,Mechelsesteenweg 365,2020-04-12,22:00:00,2,0,2,FMN GV 05 Lier
60,Mechelsesteenweg 365,2020-04-12,23:00:00,0,0,0,FMN GV 05 Lier
60,Mechelsesteenweg 365,2020-04-13,00:00:00,0,0,0,FMN GV 05 Lier
60,Mechelsesteenweg 365,2020-04-13,01:00:00,0,0,0,FMN GV 05 Lier
60,Mechelsesteenweg 365,2020-04-13,02:00:00,0,0,0,FMN GV 05 Lier
60,Mechelsesteenweg 365,2020-04-13,03:00:00,0,0,0,FMN GV 05 Lier
60,Mechelsesteenweg 365,2020-04-13,04:00:00,0,0,0,FMN GV 05 Lier
60,Mechelsesteenweg 365,2020-04-13,05:00:00,0,0,0,FMN GV 05 Lier
60,Mechelsesteenweg 365,2020-04-13,06:00:00,2,2,0,FMN GV 05 Lier
60,Mechelsesteenweg 365,2020-04-13,07:00:00,8,6,2,FMN GV 05 Lier
60,Mechelsesteenweg 365,2020-04-13,08:00:00,22,14,8,FMN GV 05 Lier
60,Mechelsesteenweg 365,2020-04-13,09:00:00,20,10,10,FMN GV 05 Lier
60,Mechelsesteenweg 365,2020-04-13,10:00:00,52,26,26,FMN GV 05 Lier
60,Mechelsesteenweg 365,2020-04-13,11:00:00,64,26,38,FMN GV 05 Lier
60,Mechelsesteenweg 365,2020-04-13,12:00:00,62,28,34,FMN GV 05 Lier
60,Mechelsesteenweg 365,2020-04-13,13:00:00,150,72,78,FMN GV 05 Lier
60,Mechelsesteenweg 365,2020-04-13,14:00:00,246,136,110,FMN GV 05 Lier
60,Mechelsesteenweg 365,2020-04-13,15:00:00,322,154,168,FMN GV 05 Lier
60,Mechelsesteenweg 365,2020-04-13,16:00:00,218,80,138,FMN GV 05 Lier
60,Mechelsesteenweg 365,2020-04-13,17:00:00,112,50,62,FMN GV 05 Lier
60,Mechelsesteenweg 365,2020-04-13,18:00:00,50,16,34,FMN GV 05 Lier
60,Mechelsesteenweg 365,2020-04-13,19:00:00,38,6,32,FMN GV 05 Lier
60,Mechelsesteenweg 365,2020-04-13,20:00:00,22,10,12,FMN GV 05 Lier
60,Mechelsesteenweg 365,2020-04-13,21:00:00,8,0,8,FMN GV 05 Lier
60,Mechelsesteenweg 365,2020-04-13,22:00:00,2,2,0,FMN GV 05 Lier
60,Mechelsesteenweg 365,2020-04-13,23:00:00,0,0,0,FMN GV 05 Lier
60,Mechelsesteenweg 365,2020-04-14,00:00:00,0,0,0,FMN GV 05 Lier
60,Mechelsesteenweg 365,2020-04-14,01:00:00,0,0,0,FMN GV 05 Lier
60,Mechelsesteenweg 365,2020-04-14,02:00:00,0,0,0,FMN GV 05 Lier
60,Mechelsesteenweg 365,2020-04-14,03:00:00,0,0,0,FMN GV 05 Lier
60,Mechelsesteenweg 365,2020-04-14,04:00:00,4,0,4,FMN GV 05 Lier
60,Mechelsesteenweg 365,2020-04-14,05:00:00,6,2,4,FMN GV 05 Lier
60,Mechelsesteenweg 365,2020-04-14,06:00:00,20,8,12,FMN GV 05 Lier
60,Mechelsesteenweg 365,2020-04-14,07:00:00,50,20,30,FMN GV 05 Lier
60,Mechelsesteenweg 365,2020-04-14,08:00:00,52,32,20,FMN GV 05 Lier
60,Mechelsesteenweg 365,2020-04-14,09:00:00,52,30,22,FMN GV 05 Lier
60,Mechelsesteenweg 365,2020-04-14,10:00:00,82,22,60,FMN GV 05 Lier
60,Mechelsesteenweg 365,2020-04-14,11:00:00,114,48,66,FMN GV 05 Lier
60,Mechelsesteenweg 365,2020-04-14,12:00:00,84,34,50,FMN GV 05 Lier
60,Mechelsesteenweg 365,2020-04-14,13:00:00,122,58,64,FMN GV 05 Lier
60,Mechelsesteenweg 365,2020-04-14,14:00:00,180,96,84,FMN GV 05 Lier
60,Mechelsesteenweg 365,2020-04-14,15:00:00,226,84,142,FMN GV 05 Lier
60,Mechelsesteenweg 365,2020-04-14,16:00:00,174,88,86,FMN GV 05 Lier
60,Mechelsesteenweg 365,2020-04-14,17:00:00,160,74,86,FMN GV 05 Lier
60,Mechelsesteenweg 365,2020-04-14,18:00:00,152,76,76,FMN GV 05 Lier
60,Mechelsesteenweg 365,2020-04-14,19:00:00,70,38,32,FMN GV 05 Lier
60,Mechelsesteenweg 365,2020-04-14,20:00:00,42,26,16,FMN GV 05 Lier
60,Mechelsesteenweg 365,2020-04-14,21:00:00,20,10,10,FMN GV 05 Lier
60,Mechelsesteenweg 365,2020-04-14,22:00:00,6,2,4,FMN GV 05 Lier
60,Mechelsesteenweg 365,2020-04-14,23:00:00,2,2,0,FMN GV 05 Lier
60,Mechelsesteenweg 365,2020-04-15,00:00:00,0,0,0,FMN GV 05 Lier
60,Mechelsesteenweg 365,2020-04-15,01:00:00,0,0,0,FMN GV 05 Lier
60,Mechelsesteenweg 365,2020-04-15,02:00:00,0,0,0,FMN GV 05 Lier
60,Mechelsesteenweg 365,2020-04-15,03:00:00,0,0,0,FMN GV 05 Lier
60,Mechelsesteenweg 365,2020-04-15,04:00:00,4,0,4,FMN GV 05 Lier
60,Mechelsesteenweg 365,2020-04-15,05:00:00,8,0,8,FMN GV 05 Lier
60,Mechelsesteenweg 365,2020-04-15,06:00:00,20,8,12,FMN GV 05 Lier
60,Mechelsesteenweg 365,2020-04-15,07:00:00,80,40,40,FMN GV 05 Lier
60,Mechelsesteenweg 365,2020-04-15,08:00:00,56,26,30,FMN GV 05 Lier
60,Mechelsesteenweg 365,2020-04-15,09:00:00,36,20,16,FMN GV 05 Lier
60,Mechelsesteenweg 365,2020-04-15,10:00:00,162,100,62,FMN GV 05 Lier
60,Mechelsesteenweg 365,2020-04-15,11:00:00,194,70,124,FMN GV 05 Lier
60,Mechelsesteenweg 365,2020-04-15,12:00:00,218,78,140,FMN GV 05 Lier
60,Mechelsesteenweg 365,2020-04-15,13:00:00,328,170,158,FMN GV 05 Lier
60,Mechelsesteenweg 365,2020-04-15,14:00:00,578,266,312,FMN GV 05 Lier
60,Mechelsesteenweg 365,2020-04-15,15:00:00,576,270,306,FMN GV 05 Lier
60,Mechelsesteenweg 365,2020-04-15,16:00:00,488,250,238,FMN GV 05 Lier
60,Mechelsesteenweg 365,2020-04-15,17:00:00,404,206,198,FMN GV 05 Lier
60,Mechelsesteenweg 365,2020-04-15,18:00:00,290,102,188,FMN GV 05 Lier
60,Mechelsesteenweg 365,2020-04-15,19:00:00,168,76,92,FMN GV 05 Lier
60,Mechelsesteenweg 365,2020-04-15,20:00:00,60,30,30,FMN GV 05 Lier
60,Mechelsesteenweg 365,2020-04-15,21:00:00,20,4,16,FMN GV 05 Lier
60,Mechelsesteenweg 365,2020-04-15,22:00:00,2,0,2,FMN GV 05 Lier
60,Mechelsesteenweg 365,2020-04-15,23:00:00,4,0,4,FMN GV 05 Lier
60,Mechelsesteenweg 365,2020-04-16,00:00:00,0,0,0,FMN GV 05 Lier
60,Mechelsesteenweg 365,2020-04-16,01:00:00,0,0,0,FMN GV 05 Lier
60,Mechelsesteenweg 365,2020-04-16,02:00:00,0,0,0,FMN GV 05 Lier
60,Mechelsesteenweg 365,2020-04-16,03:00:00,0,0,0,FMN GV 05 Lier
60,Mechelsesteenweg 365,2020-04-16,04:00:00,2,0,2,FMN GV 05 Lier
60,Mechelsesteenweg 365,2020-04-16,05:00:00,8,0,8,FMN GV 05 Lier
60,Mechelsesteenweg 365,2020-04-16,06:00:00,20,10,10,FMN GV 05 Lier
60,Mechelsesteenweg 365,2020-04-16,07:00:00,76,22,54,FMN GV 05 Lier
60,Mechelsesteenweg 365,2020-04-16,08:00:00,78,30,48,FMN GV 05 Lier
60,Mechelsesteenweg 365,2020-04-16,09:00:00,88,56,32,FMN GV 05 Lier
60,Mechelsesteenweg 365,2020-04-16,10:00:00,208,112,96,FMN GV 05 Lier
60,Mechelsesteenweg 365,2020-04-16,11:00:00,266,126,140,FMN GV 05 Lier
60,Mechelsesteenweg 365,2020-04-16,12:00:00,278,138,140,FMN GV 05 Lier
60,Mechelsesteenweg 365,2020-04-16,13:00:00,450,224,226,FMN GV 05 Lier
60,Mechelsesteenweg 365,2020-04-16,14:00:00,822,384,438,FMN GV 05 Lier
60,Mechelsesteenweg 365,2020-04-16,15:00:00,878,392,486,FMN GV 05 Lier
60,Mechelsesteenweg 365,2020-04-16,16:00:00,644,282,362,FMN GV 05 Lier
60,Mechelsesteenweg 365,2020-04-16,17:00:00,408,168,240,FMN GV 05 Lier
60,Mechelsesteenweg 365,2020-04-16,18:00:00,312,142,170,FMN GV 05 Lier
60,Mechelsesteenweg 365,2020-04-16,19:00:00,186,62,124,FMN GV 05 Lier
60,Mechelsesteenweg 365,2020-04-16,20:00:00,114,48,66,FMN GV 05 Lier
60,Mechelsesteenweg 365,2020-04-16,21:00:00,20,6,14,FMN GV 05 Lier
60,Mechelsesteenweg 365,2020-04-16,22:00:00,2,0,2,FMN GV 05 Lier
60,Mechelsesteenweg 365,2020-04-16,23:00:00,0,0,0,FMN GV 05 Lier
60,Mechelsesteenweg 365,2020-04-17,00:00:00,0,0,0,FMN GV 05 Lier
60,Mechelsesteenweg 365,2020-04-17,01:00:00,0,0,0,FMN GV 05 Lier
60,Mechelsesteenweg 365,2020-04-17,02:00:00,0,0,0,FMN GV 05 Lier
60,Mechelsesteenweg 365,2020-04-17,03:00:00,0,0,0,FMN GV 05 Lier
60,Mechelsesteenweg 365,2020-04-17,04:00:00,2,0,2,FMN GV 05 Lier
60,Mechelsesteenweg 365,2020-04-17,05:00:00,8,2,6,FMN GV 05 Lier
60,Mechelsesteenweg 365,2020-04-17,06:00:00,16,12,4,FMN GV 05 Lier
60,Mechelsesteenweg 365,2020-04-17,07:00:00,50,24,26,FMN GV 05 Lier
60,Mechelsesteenweg 365,2020-04-17,08:00:00,70,26,44,FMN GV 05 Lier
60,Mechelsesteenweg 365,2020-04-17,09:00:00,78,38,40,FMN GV 05 Lier
60,Mechelsesteenweg 365,2020-04-17,10:00:00,184,84,100,FMN GV 05 Lier
60,Mechelsesteenweg 365,2020-04-17,11:00:00,256,108,148,FMN GV 05 Lier
60,Mechelsesteenweg 365,2020-04-17,12:00:00,270,96,174,FMN GV 05 Lier
60,Mechelsesteenweg 365,2020-04-17,13:00:00,300,156,144,FMN GV 05 Lier
60,Mechelsesteenweg 365,2020-04-17,14:00:00,652,344,308,FMN GV 05 Lier
60,Mechelsesteenweg 365,2020-04-17,15:00:00,592,284,308,FMN GV 05 Lier
60,Mechelsesteenweg 365,2020-04-17,16:00:00,596,222,374,FMN GV 05 Lier
60,Mechelsesteenweg 365,2020-04-17,17:00:00,436,152,284,FMN GV 05 Lier
60,Mechelsesteenweg 365,2020-04-17,18:00:00,230,108,122,FMN GV 05 Lier
60,Mechelsesteenweg 365,2020-04-17,19:00:00,132,54,78,FMN GV 05 Lier
60,Mechelsesteenweg 365,2020-04-17,20:00:00,78,36,42,FMN GV 05 Lier
60,Mechelsesteenweg 365,2020-04-17,21:00:00,28,16,12,FMN GV 05 Lier
60,Mechelsesteenweg 365,2020-04-17,22:00:00,0,0,0,FMN GV 05 Lier
60,Mechelsesteenweg 365,2020-04-17,23:00:00,0,0,0,FMN GV 05 Lier
60,Mechelsesteenweg 365,2020-04-18,00:00:00,4,0,4,FMN GV 05 Lier
60,Mechelsesteenweg 365,2020-04-18,01:00:00,0,0,0,FMN GV 05 Lier
60,Mechelsesteenweg 365,2020-04-18,02:00:00,2,0,2,FMN GV 05 Lier
60,Mechelsesteenweg 365,2020-04-18,03:00:00,0,0,0,FMN GV 05 Lier
60,Mechelsesteenweg 365,2020-04-18,04:00:00,0,0,0,FMN GV 05 Lier
60,Mechelsesteenweg 365,2020-04-18,05:00:00,0,0,0,FMN GV 05 Lier
60,Mechelsesteenweg 365,2020-04-18,06:00:00,6,4,2,FMN GV 05 Lier
60,Mechelsesteenweg 365,2020-04-18,07:00:00,2,0,2,FMN GV 05 Lier
60,Mechelsesteenweg 365,2020-04-18,08:00:00,34,28,6,FMN GV 05 Lier
60,Mechelsesteenweg 365,2020-04-18,09:00:00,60,26,34,FMN GV 05 Lier
60,Mechelsesteenweg 365,2020-04-18,10:00:00,132,56,76,FMN GV 05 Lier
60,Mechelsesteenweg 365,2020-04-18,11:00:00,162,68,94,FMN GV 05 Lier
60,Mechelsesteenweg 365,2020-04-18,12:00:00,28,18,10,FMN GV 05 Lier
60,Mechelsesteenweg 365,2020-04-18,13:00:00,20,8,12,FMN GV 05 Lier
60,Mechelsesteenweg 365,2020-04-18,14:00:00,58,34,24,FMN GV 05 Lier
60,Mechelsesteenweg 365,2020-04-18,15:00:00,104,66,38,FMN GV 05 Lier
60,Mechelsesteenweg 365,2020-04-18,16:00:00,196,86,110,FMN GV 05 Lier
60,Mechelsesteenweg 365,2020-04-18,17:00:00,130,58,72,FMN GV 05 Lier
60,Mechelsesteenweg 365,2020-04-18,18:00:00,100,34,66,FMN GV 05 Lier
60,Mechelsesteenweg 365,2020-04-18,19:00:00,28,10,18,FMN GV 05 Lier
60,Mechelsesteenweg 365,2020-04-18,20:00:00,20,10,10,FMN GV 05 Lier
60,Mechelsesteenweg 365,2020-04-18,21:00:00,10,8,2,FMN GV 05 Lier
60,Mechelsesteenweg 365,2020-04-18,22:00:00,10,6,4,FMN GV 05 Lier
60,Mechelsesteenweg 365,2020-04-18,23:00:00,0,0,0,FMN GV 05 Lier
60,Mechelsesteenweg 365,2020-04-19,00:00:00,4,0,4,FMN GV 05 Lier
60,Mechelsesteenweg 365,2020-04-19,01:00:00,2,2,0,FMN GV 05 Lier
60,Mechelsesteenweg 365,2020-04-19,02:00:00,0,0,0,FMN GV 05 Lier
60,Mechelsesteenweg 365,2020-04-19,03:00:00,0,0,0,FMN GV 05 Lier
60,Mechelsesteenweg 365,2020-04-19,04:00:00,0,0,0,FMN GV 05 Lier
60,Mechelsesteenweg 365,2020-04-19,05:00:00,2,2,0,FMN GV 05 Lier
60,Mechelsesteenweg 365,2020-04-19,06:00:00,4,2,2,FMN GV 05 Lier
60,Mechelsesteenweg 365,2020-04-19,07:00:00,6,2,4,FMN GV 05 Lier
60,Mechelsesteenweg 365,2020-04-19,08:00:00,52,22,30,FMN GV 05 Lier
60,Mechelsesteenweg 365,2020-04-19,09:00:00,266,124,142,FMN GV 05 Lier
60,Mechelsesteenweg 365,2020-04-19,10:00:00,580,304,276,FMN GV 05 Lier
60,Mechelsesteenweg 365,2020-04-19,11:00:00,666,266,400,FMN GV 05 Lier
60,Mechelsesteenweg 365,2020-04-19,12:00:00,584,248,336,FMN GV 05 Lier
60,Mechelsesteenweg 365,2020-04-19,13:00:00,556,236,320,FMN GV 05 Lier
60,Mechelsesteenweg 365,2020-04-19,14:00:00,592,288,304,FMN GV 05 Lier
60,Mechelsesteenweg 365,2020-04-19,15:00:00,754,328,426,FMN GV 05 Lier
60,Mechelsesteenweg 365,2020-04-19,16:00:00,588,212,376,FMN GV 05 Lier
60,Mechelsesteenweg 365,2020-04-19,17:00:00,434,180,254,FMN GV 05 Lier
60,Mechelsesteenweg 365,2020-04-19,18:00:00,152,70,82,FMN GV 05 Lier
60,Mechelsesteenweg 365,2020-04-19,19:00:00,132,40,92,FMN GV 05 Lier
60,Mechelsesteenweg 365,2020-04-19,20:00:00,26,10,16,FMN GV 05 Lier
60,Mechelsesteenweg 365,2020-04-19,21:00:00,8,4,4,FMN GV 05 Lier
60,Mechelsesteenweg 365,2020-04-19,22:00:00,0,0,0,FMN GV 05 Lier
60,Mechelsesteenweg 365,2020-04-19,23:00:00,0,0,0,FMN GV 05 Lier
60,Mechelsesteenweg 365,2020-04-20,00:00:00,0,0,0,FMN GV 05 Lier
60,Mechelsesteenweg 365,2020-04-20,01:00:00,0,0,0,FMN GV 05 Lier
60,Mechelsesteenweg 365,2020-04-20,02:00:00,0,0,0,FMN GV 05 Lier
60,Mechelsesteenweg 365,2020-04-20,03:00:00,0,0,0,FMN GV 05 Lier
60,Mechelsesteenweg 365,2020-04-20,04:00:00,2,0,2,FMN GV 05 Lier
60,Mechelsesteenweg 365,2020-04-20,05:00:00,14,2,12,FMN GV 05 Lier
60,Mechelsesteenweg 365,2020-04-20,06:00:00,30,12,18,FMN GV 05 Lier
60,Mechelsesteenweg 365,2020-04-20,07:00:00,56,26,30,FMN GV 05 Lier
60,Mechelsesteenweg 365,2020-04-20,08:00:00,54,18,36,FMN GV 05 Lier
60,Mechelsesteenweg 365,2020-04-20,09:00:00,50,28,22,FMN GV 05 Lier
60,Mechelsesteenweg 365,2020-04-20,10:00:00,100,38,62,FMN GV 05 Lier
60,Mechelsesteenweg 365,2020-04-20,11:00:00,72,30,42,FMN GV 05 Lier
60,Mechelsesteenweg 365,2020-04-20,12:00:00,86,38,48,FMN GV 05 Lier
60,Mechelsesteenweg 365,2020-04-20,13:00:00,152,64,88,FMN GV 05 Lier
60,Mechelsesteenweg 365,2020-04-20,14:00:00,202,94,108,FMN GV 05 Lier
60,Mechelsesteenweg 365,2020-04-20,15:00:00,238,90,148,FMN GV 05 Lier
60,Mechelsesteenweg 365,2020-04-20,16:00:00,206,106,100,FMN GV 05 Lier
60,Mechelsesteenweg 365,2020-04-20,17:00:00,148,74,74,FMN GV 05 Lier
60,Mechelsesteenweg 365,2020-04-20,18:00:00,90,42,48,FMN GV 05 Lier
60,Mechelsesteenweg 365,2020-04-20,19:00:00,58,14,44,FMN GV 05 Lier
60,Mechelsesteenweg 365,2020-04-20,20:00:00,28,10,18,FMN GV 05 Lier
60,Mechelsesteenweg 365,2020-04-20,21:00:00,14,2,12,FMN GV 05 Lier
60,Mechelsesteenweg 365,2020-04-20,22:00:00,0,0,0,FMN GV 05 Lier
60,Mechelsesteenweg 365,2020-04-20,23:00:00,0,0,0,FMN GV 05 Lier
60,Mechelsesteenweg 365,2020-04-21,00:00:00,0,0,0,FMN GV 05 Lier
60,Mechelsesteenweg 365,2020-04-21,01:00:00,0,0,0,FMN GV 05 Lier
60,Mechelsesteenweg 365,2020-04-21,02:00:00,0,0,0,FMN GV 05 Lier
60,Mechelsesteenweg 365,2020-04-21,03:00:00,0,0,0,FMN GV 05 Lier
60,Mechelsesteenweg 365,2020-04-21,04:00:00,4,0,4,FMN GV 05 Lier
60,Mechelsesteenweg 365,2020-04-21,05:00:00,10,2,8,FMN GV 05 Lier
60,Mechelsesteenweg 365,2020-04-21,06:00:00,24,8,16,FMN GV 05 Lier
60,Mechelsesteenweg 365,2020-04-21,07:00:00,62,24,38,FMN GV 05 Lier
60,Mechelsesteenweg 365,2020-04-21,08:00:00,34,18,16,FMN GV 05 Lier
60,Mechelsesteenweg 365,2020-04-21,09:00:00,56,30,26,FMN GV 05 Lier
60,Mechelsesteenweg 365,2020-04-21,10:00:00,82,42,40,FMN GV 05 Lier
60,Mechelsesteenweg 365,2020-04-21,11:00:00,122,48,74,FMN GV 05 Lier
60,Mechelsesteenweg 365,2020-04-21,12:00:00,100,48,52,FMN GV 05 Lier
60,Mechelsesteenweg 365,2020-04-21,13:00:00,112,52,60,FMN GV 05 Lier
60,Mechelsesteenweg 365,2020-04-21,14:00:00,264,108,156,FMN GV 05 Lier
60,Mechelsesteenweg 365,2020-04-21,15:00:00,264,84,180,FMN GV 05 Lier
60,Mechelsesteenweg 365,2020-04-21,16:00:00,228,104,124,FMN GV 05 Lier
60,Mechelsesteenweg 365,2020-04-21,17:00:00,248,104,144,FMN GV 05 Lier
60,Mechelsesteenweg 365,2020-04-21,18:00:00,194,68,126,FMN GV 05 Lier
60,Mechelsesteenweg 365,2020-04-21,19:00:00,134,52,82,FMN GV 05 Lier
60,Mechelsesteenweg 365,2020-04-21,20:00:00,58,26,32,FMN GV 05 Lier
60,Mechelsesteenweg 365,2020-04-21,21:00:00,20,4,16,FMN GV 05 Lier
60,Mechelsesteenweg 365,2020-04-21,22:00:00,10,6,4,FMN GV 05 Lier
60,Mechelsesteenweg 365,2020-04-21,23:00:00,0,0,0,FMN GV 05 Lier
60,Mechelsesteenweg 365,2020-04-22,00:00:00,0,0,0,FMN GV 05 Lier
60,Mechelsesteenweg 365,2020-04-22,01:00:00,0,0,0,FMN GV 05 Lier
60,Mechelsesteenweg 365,2020-04-22,02:00:00,0,0,0,FMN GV 05 Lier
60,Mechelsesteenweg 365,2020-04-22,03:00:00,0,0,0,FMN GV 05 Lier
60,Mechelsesteenweg 365,2020-04-22,04:00:00,2,0,2,FMN GV 05 Lier
60,Mechelsesteenweg 365,2020-04-22,05:00:00,6,2,4,FMN GV 05 Lier
60,Mechelsesteenweg 365,2020-04-22,06:00:00,32,12,20,FMN GV 05 Lier
60,Mechelsesteenweg 365,2020-04-22,07:00:00,60,12,48,FMN GV 05 Lier
60,Mechelsesteenweg 365,2020-04-22,08:00:00,40,16,24,FMN GV 05 Lier
60,Mechelsesteenweg 365,2020-04-22,09:00:00,54,38,16,FMN GV 05 Lier
60,Mechelsesteenweg 365,2020-04-22,10:00:00,122,62,60,FMN GV 05 Lier
60,Mechelsesteenweg 365,2020-04-22,11:00:00,122,48,74,FMN GV 05 Lier
60,Mechelsesteenweg 365,2020-04-22,12:00:00,138,44,94,FMN GV 05 Lier
60,Mechelsesteenweg 365,2020-04-22,13:00:00,172,70,102,FMN GV 05 Lier
60,Mechelsesteenweg 365,2020-04-22,14:00:00,326,132,194,FMN GV 05 Lier
60,Mechelsesteenweg 365,2020-04-22,15:00:00,428,152,276,FMN GV 05 Lier
60,Mechelsesteenweg 365,2020-04-22,16:00:00,372,140,232,FMN GV 05 Lier
60,Mechelsesteenweg 365,2020-04-22,17:00:00,340,148,192,FMN GV 05 Lier
60,Mechelsesteenweg 365,2020-04-22,18:00:00,266,118,148,FMN GV 05 Lier
60,Mechelsesteenweg 365,2020-04-22,19:00:00,134,50,84,FMN GV 05 Lier
60,Mechelsesteenweg 365,2020-04-22,20:00:00,68,18,50,FMN GV 05 Lier
60,Mechelsesteenweg 365,2020-04-22,21:00:00,32,6,26,FMN GV 05 Lier
60,Mechelsesteenweg 365,2020-04-22,22:00:00,2,0,2,FMN GV 05 Lier
60,Mechelsesteenweg 365,2020-04-22,23:00:00,0,0,0,FMN GV 05 Lier
60,Mechelsesteenweg 365,2020-04-23,00:00:00,0,0,0,FMN GV 05 Lier
60,Mechelsesteenweg 365,2020-04-23,01:00:00,0,0,0,FMN GV 05 Lier
60,Mechelsesteenweg 365,2020-04-23,02:00:00,0,0,0,FMN GV 05 Lier
60,Mechelsesteenweg 365,2020-04-23,03:00:00,0,0,0,FMN GV 05 Lier
60,Mechelsesteenweg 365,2020-04-23,04:00:00,2,0,2,FMN GV 05 Lier
60,Mechelsesteenweg 365,2020-04-23,05:00:00,8,2,6,FMN GV 05 Lier
60,Mechelsesteenweg 365,2020-04-23,06:00:00,26,12,14,FMN GV 05 Lier
60,Mechelsesteenweg 365,2020-04-23,07:00:00,62,24,38,FMN GV 05 Lier
60,Mechelsesteenweg 365,2020-04-23,08:00:00,64,24,40,FMN GV 05 Lier
60,Mechelsesteenweg 365,2020-04-23,09:00:00,110,58,52,FMN GV 05 Lier
60,Mechelsesteenweg 365,2020-04-23,10:00:00,214,112,102,FMN GV 05 Lier
60,Mechelsesteenweg 365,2020-04-23,11:00:00,284,126,158,FMN GV 05 Lier
60,Mechelsesteenweg 365,2020-04-23,12:00:00,268,112,156,FMN GV 05 Lier
60,Mechelsesteenweg 365,2020-04-23,13:00:00,404,150,254,FMN GV 05 Lier
60,Mechelsesteenweg 365,2020-04-23,14:00:00,694,352,342,FMN GV 05 Lier
60,Mechelsesteenweg 365,2020-04-23,15:00:00,566,244,322,FMN GV 05 Lier
60,Mechelsesteenweg 365,2020-04-23,16:00:00,512,212,300,FMN GV 05 Lier
60,Mechelsesteenweg 365,2020-04-23,17:00:00,426,158,268,FMN GV 05 Lier
60,Mechelsesteenweg 365,2020-04-23,18:00:00,298,102,196,FMN GV 05 Lier
60,Mechelsesteenweg 365,2020-04-23,19:00:00,226,116,110,FMN GV 05 Lier
60,Mechelsesteenweg 365,2020-04-23,20:00:00,114,42,72,FMN GV 05 Lier
60,Mechelsesteenweg 365,2020-04-23,21:00:00,32,16,16,FMN GV 05 Lier
60,Mechelsesteenweg 365,2020-04-23,22:00:00,2,0,2,FMN GV 05 Lier
60,Mechelsesteenweg 365,2020-04-23,23:00:00,2,0,2,FMN GV 05 Lier
60,Mechelsesteenweg 365,2020-04-24,00:00:00,6,2,4,FMN GV 05 Lier
60,Mechelsesteenweg 365,2020-04-24,01:00:00,0,0,0,FMN GV 05 Lier
60,Mechelsesteenweg 365,2020-04-24,02:00:00,0,0,0,FMN GV 05 Lier
60,Mechelsesteenweg 365,2020-04-24,03:00:00,0,0,0,FMN GV 05 Lier
60,Mechelsesteenweg 365,2020-04-24,04:00:00,0,0,0,FMN GV 05 Lier
60,Mechelsesteenweg 365,2020-04-24,05:00:00,6,0,6,FMN GV 05 Lier
60,Mechelsesteenweg 365,2020-04-24,06:00:00,22,14,8,FMN GV 05 Lier
60,Mechelsesteenweg 365,2020-04-24,07:00:00,52,18,34,FMN GV 05 Lier
60,Mechelsesteenweg 365,2020-04-24,08:00:00,50,14,36,FMN GV 05 Lier
60,Mechelsesteenweg 365,2020-04-24,09:00:00,46,32,14,FMN GV 05 Lier
60,Mechelsesteenweg 365,2020-04-24,10:00:00,72,30,42,FMN GV 05 Lier
60,Mechelsesteenweg 365,2020-04-24,11:00:00,130,42,88,FMN GV 05 Lier
60,Mechelsesteenweg 365,2020-04-24,12:00:00,118,64,54,FMN GV 05 Lier
60,Mechelsesteenweg 365,2020-04-24,13:00:00,250,90,160,FMN GV 05 Lier
60,Mechelsesteenweg 365,2020-04-24,14:00:00,464,220,244,FMN GV 05 Lier
60,Mechelsesteenweg 365,2020-04-24,15:00:00,458,206,252,FMN GV 05 Lier
60,Mechelsesteenweg 365,2020-04-24,16:00:00,412,184,228,FMN GV 05 Lier
60,Mechelsesteenweg 365,2020-04-24,17:00:00,248,92,156,FMN GV 05 Lier
60,Mechelsesteenweg 365,2020-04-24,18:00:00,130,42,88,FMN GV 05 Lier
60,Mechelsesteenweg 365,2020-04-24,19:00:00,112,40,72,FMN GV 05 Lier
60,Mechelsesteenweg 365,2020-04-24,20:00:00,60,24,36,FMN GV 05 Lier
60,Mechelsesteenweg 365,2020-04-24,21:00:00,14,2,12,FMN GV 05 Lier
60,Mechelsesteenweg 365,2020-04-24,22:00:00,0,0,0,FMN GV 05 Lier
60,Mechelsesteenweg 365,2020-04-24,23:00:00,2,0,2,FMN GV 05 Lier
60,Mechelsesteenweg 365,2020-04-25,00:00:00,0,0,0,FMN GV 05 Lier
60,Mechelsesteenweg 365,2020-04-25,01:00:00,0,0,0,FMN GV 05 Lier
60,Mechelsesteenweg 365,2020-04-25,02:00:00,0,0,0,FMN GV 05 Lier
60,Mechelsesteenweg 365,2020-04-25,03:00:00,0,0,0,FMN GV 05 Lier
60,Mechelsesteenweg 365,2020-04-25,04:00:00,0,0,0,FMN GV 05 Lier
60,Mechelsesteenweg 365,2020-04-25,05:00:00,0,0,0,FMN GV 05 Lier
60,Mechelsesteenweg 365,2020-04-25,06:00:00,6,6,0,FMN GV 05 Lier
60,Mechelsesteenweg 365,2020-04-25,07:00:00,18,4,14,FMN GV 05 Lier
60,Mechelsesteenweg 365,2020-04-25,08:00:00,28,20,8,FMN GV 05 Lier
60,Mechelsesteenweg 365,2020-04-25,09:00:00,80,48,32,FMN GV 05 Lier
60,Mechelsesteenweg 365,2020-04-25,10:00:00,134,38,96,FMN GV 05 Lier
60,Mechelsesteenweg 365,2020-04-25,11:00:00,216,86,130,FMN GV 05 Lier
60,Mechelsesteenweg 365,2020-04-25,12:00:00,192,82,110,FMN GV 05 Lier
60,Mechelsesteenweg 365,2020-04-25,13:00:00,304,128,176,FMN GV 05 Lier
60,Mechelsesteenweg 365,2020-04-25,14:00:00,534,234,300,FMN GV 05 Lier
60,Mechelsesteenweg 365,2020-04-25,15:00:00,582,252,330,FMN GV 05 Lier
60,Mechelsesteenweg 365,2020-04-25,16:00:00,460,176,284,FMN GV 05 Lier
60,Mechelsesteenweg 365,2020-04-25,17:00:00,308,100,208,FMN GV 05 Lier
60,Mechelsesteenweg 365,2020-04-25,18:00:00,166,64,102,FMN GV 05 Lier
60,Mechelsesteenweg 365,2020-04-25,19:00:00,84,40,44,FMN GV 05 Lier
60,Mechelsesteenweg 365,2020-04-25,20:00:00,38,16,22,FMN GV 05 Lier
60,Mechelsesteenweg 365,2020-04-25,21:00:00,20,4,16,FMN GV 05 Lier
60,Mechelsesteenweg 365,2020-04-25,22:00:00,2,0,2,FMN GV 05 Lier
60,Mechelsesteenweg 365,2020-04-25,23:00:00,0,0,0,FMN GV 05 Lier
60,Mechelsesteenweg 365,2020-04-26,00:00:00,4,2,2,FMN GV 05 Lier
60,Mechelsesteenweg 365,2020-04-26,01:00:00,0,0,0,FMN GV 05 Lier
60,Mechelsesteenweg 365,2020-04-26,02:00:00,0,0,0,FMN GV 05 Lier
60,Mechelsesteenweg 365,2020-04-26,03:00:00,0,0,0,FMN GV 05 Lier
60,Mechelsesteenweg 365,2020-04-26,04:00:00,0,0,0,FMN GV 05 Lier
60,Mechelsesteenweg 365,2020-04-26,05:00:00,0,0,0,FMN GV 05 Lier
60,Mechelsesteenweg 365,2020-04-26,06:00:00,4,4,0,FMN GV 05 Lier
60,Mechelsesteenweg 365,2020-04-26,07:00:00,14,10,4,FMN GV 05 Lier
60,Mechelsesteenweg 365,2020-04-26,08:00:00,66,38,28,FMN GV 05 Lier
60,Mechelsesteenweg 365,2020-04-26,09:00:00,192,112,80,FMN GV 05 Lier
60,Mechelsesteenweg 365,2020-04-26,10:00:00,514,226,288,FMN GV 05 Lier
60,Mechelsesteenweg 365,2020-04-26,11:00:00,578,256,322,FMN GV 05 Lier
60,Mechelsesteenweg 365,2020-04-26,12:00:00,510,212,298,FMN GV 05 Lier
60,Mechelsesteenweg 365,2020-04-26,13:00:00,644,260,384,FMN GV 05 Lier
60,Mechelsesteenweg 365,2020-04-26,14:00:00,876,340,536,FMN GV 05 Lier
60,Mechelsesteenweg 365,2020-04-26,15:00:00,864,366,498,FMN GV 05 Lier
60,Mechelsesteenweg 365,2020-04-26,16:00:00,598,256,342,FMN GV 05 Lier
60,Mechelsesteenweg 365,2020-04-26,17:00:00,376,104,272,FMN GV 05 Lier
60,Mechelsesteenweg 365,2020-04-26,18:00:00,200,70,130,FMN GV 05 Lier
60,Mechelsesteenweg 365,2020-04-26,19:00:00,122,44,78,FMN GV 05 Lier
60,Mechelsesteenweg 365,2020-04-26,20:00:00,36,12,24,FMN GV 05 Lier
60,Mechelsesteenweg 365,2020-04-26,21:00:00,12,2,10,FMN GV 05 Lier
60,Mechelsesteenweg 365,2020-04-26,22:00:00,2,0,2,FMN GV 05 Lier
60,Mechelsesteenweg 365,2020-04-26,23:00:00,0,0,0,FMN GV 05 Lier
60,Mechelsesteenweg 365,2020-04-27,00:00:00,0,0,0,FMN GV 05 Lier
60,Mechelsesteenweg 365,2020-04-27,01:00:00,0,0,0,FMN GV 05 Lier
60,Mechelsesteenweg 365,2020-04-27,02:00:00,0,0,0,FMN GV 05 Lier
60,Mechelsesteenweg 365,2020-04-27,03:00:00,0,0,0,FMN GV 05 Lier
60,Mechelsesteenweg 365,2020-04-27,04:00:00,2,0,2,FMN GV 05 Lier
60,Mechelsesteenweg 365,2020-04-27,05:00:00,6,2,4,FMN GV 05 Lier
60,Mechelsesteenweg 365,2020-04-27,06:00:00,12,8,4,FMN GV 05 Lier
60,Mechelsesteenweg 365,2020-04-27,07:00:00,66,16,50,FMN GV 05 Lier
60,Mechelsesteenweg 365,2020-04-27,08:00:00,62,30,32,FMN GV 05 Lier
60,Mechelsesteenweg 365,2020-04-27,09:00:00,82,40,42,FMN GV 05 Lier
60,Mechelsesteenweg 365,2020-04-27,10:00:00,116,52,64,FMN GV 05 Lier
60,Mechelsesteenweg 365,2020-04-27,11:00:00,154,68,86,FMN GV 05 Lier
60,Mechelsesteenweg 365,2020-04-27,12:00:00,180,58,122,FMN GV 05 Lier
60,Mechelsesteenweg 365,2020-04-27,13:00:00,248,104,144,FMN GV 05 Lier
60,Mechelsesteenweg 365,2020-04-27,14:00:00,410,186,224,FMN GV 05 Lier
60,Mechelsesteenweg 365,2020-04-27,15:00:00,442,192,250,FMN GV 05 Lier
60,Mechelsesteenweg 365,2020-04-27,16:00:00,422,174,248,FMN GV 05 Lier
60,Mechelsesteenweg 365,2020-04-27,17:00:00,328,148,180,FMN GV 05 Lier
60,Mechelsesteenweg 365,2020-04-27,18:00:00,178,76,102,FMN GV 05 Lier
60,Mechelsesteenweg 365,2020-04-27,19:00:00,108,64,44,FMN GV 05 Lier
60,Mechelsesteenweg 365,2020-04-27,20:00:00,88,34,54,FMN GV 05 Lier
60,Mechelsesteenweg 365,2020-04-27,21:00:00,14,4,10,FMN GV 05 Lier
60,Mechelsesteenweg 365,2020-04-27,22:00:00,2,2,0,FMN GV 05 Lier
60,Mechelsesteenweg 365,2020-04-27,23:00:00,0,0,0,FMN GV 05 Lier
60,Mechelsesteenweg 365,2020-04-28,00:00:00,0,0,0,FMN GV 05 Lier
60,Mechelsesteenweg 365,2020-04-28,01:00:00,0,0,0,FMN GV 05 Lier
60,Mechelsesteenweg 365,2020-04-28,02:00:00,0,0,0,FMN GV 05 Lier
60,Mechelsesteenweg 365,2020-04-28,03:00:00,0,0,0,FMN GV 05 Lier
60,Mechelsesteenweg 365,2020-04-28,04:00:00,0,0,0,FMN GV 05 Lier
60,Mechelsesteenweg 365,2020-04-28,05:00:00,4,0,4,FMN GV 05 Lier
60,Mechelsesteenweg 365,2020-04-28,06:00:00,16,8,8,FMN GV 05 Lier
60,Mechelsesteenweg 365,2020-04-28,07:00:00,38,8,30,FMN GV 05 Lier
60,Mechelsesteenweg 365,2020-04-28,08:00:00,28,8,20,FMN GV 05 Lier
60,Mechelsesteenweg 365,2020-04-28,09:00:00,18,12,6,FMN GV 05 Lier
60,Mechelsesteenweg 365,2020-04-28,10:00:00,6,0,6,FMN GV 05 Lier
60,Mechelsesteenweg 365,2020-04-28,11:00:00,20,2,18,FMN GV 05 Lier
60,Mechelsesteenweg 365,2020-04-28,12:00:00,14,2,12,FMN GV 05 Lier
60,Mechelsesteenweg 365,2020-04-28,13:00:00,18,12,6,FMN GV 05 Lier
60,Mechelsesteenweg 365,2020-04-28,14:00:00,26,16,10,FMN GV 05 Lier
60,Mechelsesteenweg 365,2020-04-28,15:00:00,22,8,14,FMN GV 05 Lier
60,Mechelsesteenweg 365,2020-04-28,16:00:00,32,24,8,FMN GV 05 Lier
60,Mechelsesteenweg 365,2020-04-28,17:00:00,64,30,34,FMN GV 05 Lier
60,Mechelsesteenweg 365,2020-04-28,18:00:00,54,18,36,FMN GV 05 Lier
60,Mechelsesteenweg 365,2020-04-28,19:00:00,20,10,10,FMN GV 05 Lier
60,Mechelsesteenweg 365,2020-04-28,20:00:00,16,6,10,FMN GV 05 Lier
60,Mechelsesteenweg 365,2020-04-28,21:00:00,12,6,6,FMN GV 05 Lier
60,Mechelsesteenweg 365,2020-04-28,22:00:00,4,2,2,FMN GV 05 Lier
60,Mechelsesteenweg 365,2020-04-28,23:00:00,0,0,0,FMN GV 05 Lier
60,Mechelsesteenweg 365,2020-04-29,00:00:00,0,0,0,FMN GV 05 Lier
60,Mechelsesteenweg 365,2020-04-29,01:00:00,0,0,0,FMN GV 05 Lier
60,Mechelsesteenweg 365,2020-04-29,02:00:00,0,0,0,FMN GV 05 Lier
60,Mechelsesteenweg 365,2020-04-29,03:00:00,0,0,0,FMN GV 05 Lier
60,Mechelsesteenweg 365,2020-04-29,04:00:00,0,0,0,FMN GV 05 Lier
60,Mechelsesteenweg 365,2020-04-29,05:00:00,6,0,6,FMN GV 05 Lier
60,Mechelsesteenweg 365,2020-04-29,06:00:00,22,12,10,FMN GV 05 Lier
60,Mechelsesteenweg 365,2020-04-29,07:00:00,38,10,28,FMN GV 05 Lier
60,Mechelsesteenweg 365,2020-04-29,08:00:00,32,12,20,FMN GV 05 Lier
60,Mechelsesteenweg 365,2020-04-29,09:00:00,36,26,10,FMN GV 05 Lier
60,Mechelsesteenweg 365,2020-04-29,10:00:00,50,32,18,FMN GV 05 Lier
60,Mechelsesteenweg 365,2020-04-29,11:00:00,56,30,26,FMN GV 05 Lier
60,Mechelsesteenweg 365,2020-04-29,12:00:00,58,26,32,FMN GV 05 Lier
60,Mechelsesteenweg 365,2020-04-29,13:00:00,84,32,52,FMN GV 05 Lier
60,Mechelsesteenweg 365,2020-04-29,14:00:00,144,80,64,FMN GV 05 Lier
60,Mechelsesteenweg 365,2020-04-29,15:00:00,176,80,96,FMN GV 05 Lier
60,Mechelsesteenweg 365,2020-04-29,16:00:00,156,76,80,FMN GV 05 Lier
60,Mechelsesteenweg 365,2020-04-29,17:00:00,112,54,58,FMN GV 05 Lier
60,Mechelsesteenweg 365,2020-04-29,18:00:00,64,26,38,FMN GV 05 Lier
60,Mechelsesteenweg 365,2020-04-29,19:00:00,30,16,14,FMN GV 05 Lier
60,Mechelsesteenweg 365,2020-04-29,20:00:00,6,4,2,FMN GV 05 Lier
60,Mechelsesteenweg 365,2020-04-29,21:00:00,8,0,8,FMN GV 05 Lier
60,Mechelsesteenweg 365,2020-04-29,22:00:00,2,2,0,FMN GV 05 Lier
60,Mechelsesteenweg 365,2020-04-29,23:00:00,4,0,4,FMN GV 05 Lier
60,Mechelsesteenweg 365,2020-04-30,00:00:00,0,0,0,FMN GV 05 Lier
60,Mechelsesteenweg 365,2020-04-30,01:00:00,0,0,0,FMN GV 05 Lier
60,Mechelsesteenweg 365,2020-04-30,02:00:00,0,0,0,FMN GV 05 Lier
60,Mechelsesteenweg 365,2020-04-30,03:00:00,0,0,0,FMN GV 05 Lier
60,Mechelsesteenweg 365,2020-04-30,04:00:00,2,0,2,FMN GV 05 Lier
60,Mechelsesteenweg 365,2020-04-30,05:00:00,0,0,0,FMN GV 05 Lier
60,Mechelsesteenweg 365,2020-04-30,06:00:00,20,8,12,FMN GV 05 Lier
60,Mechelsesteenweg 365,2020-04-30,07:00:00,26,4,22,FMN GV 05 Lier
60,Mechelsesteenweg 365,2020-04-30,08:00:00,24,8,16,FMN GV 05 Lier
60,Mechelsesteenweg 365,2020-04-30,09:00:00,16,8,8,FMN GV 05 Lier
60,Mechelsesteenweg 365,2020-04-30,10:00:00,54,22,32,FMN GV 05 Lier
60,Mechelsesteenweg 365,2020-04-30,11:00:00,64,28,36,FMN GV 05 Lier
60,Mechelsesteenweg 365,2020-04-30,12:00:00,60,36,24,FMN GV 05 Lier
60,Mechelsesteenweg 365,2020-04-30,13:00:00,86,26,60,FMN GV 05 Lier
60,Mechelsesteenweg 365,2020-04-30,14:00:00,116,66,50,FMN GV 05 Lier
60,Mechelsesteenweg 365,2020-04-30,15:00:00,130,54,76,FMN GV 05 Lier
60,Mechelsesteenweg 365,2020-04-30,16:00:00,94,40,54,FMN GV 05 Lier
60,Mechelsesteenweg 365,2020-04-30,17:00:00,66,30,36,FMN GV 05 Lier
60,Mechelsesteenweg 365,2020-04-30,18:00:00,70,46,24,FMN GV 05 Lier
60,Mechelsesteenweg 365,2020-04-30,19:00:00,28,18,10,FMN GV 05 Lier
60,Mechelsesteenweg 365,2020-04-30,20:00:00,14,6,8,FMN GV 05 Lier
60,Mechelsesteenweg 365,2020-04-30,21:00:00,4,2,2,FMN GV 05 Lier
60,Mechelsesteenweg 365,2020-04-30,22:00:00,2,2,0,FMN GV 05 Lier
60,Mechelsesteenweg 365,2020-04-30,23:00:00,0,0,0,FMN GV 05 Lier
60,Mechelsesteenweg 365,2020-05-01,00:00:00,4,0,4,FMN GV 05 Lier
60,Mechelsesteenweg 365,2020-05-01,01:00:00,0,0,0,FMN GV 05 Lier
60,Mechelsesteenweg 365,2020-05-01,02:00:00,0,0,0,FMN GV 05 Lier
60,Mechelsesteenweg 365,2020-05-01,03:00:00,0,0,0,FMN GV 05 Lier
60,Mechelsesteenweg 365,2020-05-01,04:00:00,0,0,0,FMN GV 05 Lier
60,Mechelsesteenweg 365,2020-05-01,05:00:00,2,0,2,FMN GV 05 Lier
60,Mechelsesteenweg 365,2020-05-01,06:00:00,2,2,0,FMN GV 05 Lier
60,Mechelsesteenweg 365,2020-05-01,07:00:00,8,4,4,FMN GV 05 Lier
60,Mechelsesteenweg 365,2020-05-01,08:00:00,22,2,20,FMN GV 05 Lier
60,Mechelsesteenweg 365,2020-05-01,09:00:00,62,32,30,FMN GV 05 Lier
60,Mechelsesteenweg 365,2020-05-01,10:00:00,116,56,60,FMN GV 05 Lier
60,Mechelsesteenweg 365,2020-05-01,11:00:00,110,34,76,FMN GV 05 Lier
60,Mechelsesteenweg 365,2020-05-01,12:00:00,116,58,58,FMN GV 05 Lier
60,Mechelsesteenweg 365,2020-05-01,13:00:00,68,32,36,FMN GV 05 Lier
60,Mechelsesteenweg 365,2020-05-01,14:00:00,56,36,20,FMN GV 05 Lier
60,Mechelsesteenweg 365,2020-05-01,15:00:00,60,38,22,FMN GV 05 Lier
60,Mechelsesteenweg 365,2020-05-01,16:00:00,72,44,28,FMN GV 05 Lier
60,Mechelsesteenweg 365,2020-05-01,17:00:00,70,36,34,FMN GV 05 Lier
60,Mechelsesteenweg 365,2020-05-01,18:00:00,32,10,22,FMN GV 05 Lier
60,Mechelsesteenweg 365,2020-05-01,19:00:00,22,8,14,FMN GV 05 Lier
60,Mechelsesteenweg 365,2020-05-01,20:00:00,14,4,10,FMN GV 05 Lier
60,Mechelsesteenweg 365,2020-05-01,21:00:00,4,0,4,FMN GV 05 Lier
60,Mechelsesteenweg 365,2020-05-01,22:00:00,0,0,0,FMN GV 05 Lier
60,Mechelsesteenweg 365,2020-05-01,23:00:00,0,0,0,FMN GV 05 Lier
60,Mechelsesteenweg 365,2020-05-02,00:00:00,0,0,0,FMN GV 05 Lier
60,Mechelsesteenweg 365,2020-05-02,01:00:00,6,6,0,FMN GV 05 Lier
60,Mechelsesteenweg 365,2020-05-02,02:00:00,0,0,0,FMN GV 05 Lier
60,Mechelsesteenweg 365,2020-05-02,03:00:00,0,0,0,FMN GV 05 Lier
60,Mechelsesteenweg 365,2020-05-02,04:00:00,0,0,0,FMN GV 05 Lier
60,Mechelsesteenweg 365,2020-05-02,05:00:00,2,0,2,FMN GV 05 Lier
60,Mechelsesteenweg 365,2020-05-02,06:00:00,4,2,2,FMN GV 05 Lier
60,Mechelsesteenweg 365,2020-05-02,07:00:00,2,0,2,FMN GV 05 Lier
60,Mechelsesteenweg 365,2020-05-02,08:00:00,2,0,2,FMN GV 05 Lier
60,Mechelsesteenweg 365,2020-05-02,09:00:00,4,2,2,FMN GV 05 Lier
60,Mechelsesteenweg 365,2020-05-02,10:00:00,36,10,26,FMN GV 05 Lier
60,Mechelsesteenweg 365,2020-05-02,11:00:00,30,24,6,FMN GV 05 Lier
60,Mechelsesteenweg 365,2020-05-02,12:00:00,26,14,12,FMN GV 05 Lier
60,Mechelsesteenweg 365,2020-05-02,13:00:00,56,28,28,FMN GV 05 Lier
60,Mechelsesteenweg 365,2020-05-02,14:00:00,180,72,108,FMN GV 05 Lier
60,Mechelsesteenweg 365,2020-05-02,15:00:00,228,120,108,FMN GV 05 Lier
60,Mechelsesteenweg 365,2020-05-02,16:00:00,274,122,152,FMN GV 05 Lier
60,Mechelsesteenweg 365,2020-05-02,17:00:00,140,44,96,FMN GV 05 Lier
60,Mechelsesteenweg 365,2020-05-02,18:00:00,56,28,28,FMN GV 05 Lier
60,Mechelsesteenweg 365,2020-05-02,19:00:00,40,20,20,FMN GV 05 Lier
60,Mechelsesteenweg 365,2020-05-02,20:00:00,32,12,20,FMN GV 05 Lier
60,Mechelsesteenweg 365,2020-05-02,21:00:00,12,8,4,FMN GV 05 Lier
60,Mechelsesteenweg 365,2020-05-02,22:00:00,2,2,0,FMN GV 05 Lier
60,Mechelsesteenweg 365,2020-05-02,23:00:00,2,0,2,FMN GV 05 Lier
60,Mechelsesteenweg 365,2020-05-03,00:00:00,2,0,2,FMN GV 05 Lier
60,Mechelsesteenweg 365,2020-05-03,01:00:00,0,0,0,FMN GV 05 Lier
60,Mechelsesteenweg 365,2020-05-03,02:00:00,0,0,0,FMN GV 05 Lier
60,Mechelsesteenweg 365,2020-05-03,03:00:00,0,0,0,FMN GV 05 Lier
60,Mechelsesteenweg 365,2020-05-03,04:00:00,0,0,0,FMN GV 05 Lier
60,Mechelsesteenweg 365,2020-05-03,05:00:00,0,0,0,FMN GV 05 Lier
60,Mechelsesteenweg 365,2020-05-03,06:00:00,4,2,2,FMN GV 05 Lier
60,Mechelsesteenweg 365,2020-05-03,07:00:00,12,6,6,FMN GV 05 Lier
60,Mechelsesteenweg 365,2020-05-03,08:00:00,80,26,54,FMN GV 05 Lier
60,Mechelsesteenweg 365,2020-05-03,09:00:00,236,90,146,FMN GV 05 Lier
60,Mechelsesteenweg 365,2020-05-03,10:00:00,598,264,334,FMN GV 05 Lier
60,Mechelsesteenweg 365,2020-05-03,11:00:00,762,308,454,FMN GV 05 Lier
60,Mechelsesteenweg 365,2020-05-03,12:00:00,522,216,306,FMN GV 05 Lier
60,Mechelsesteenweg 365,2020-05-03,13:00:00,510,222,288,FMN GV 05 Lier
60,Mechelsesteenweg 365,2020-05-03,14:00:00,522,196,326,FMN GV 05 Lier
60,Mechelsesteenweg 365,2020-05-03,15:00:00,622,276,346,FMN GV 05 Lier
60,Mechelsesteenweg 365,2020-05-03,16:00:00,374,132,242,FMN GV 05 Lier
60,Mechelsesteenweg 365,2020-05-03,17:00:00,256,104,152,FMN GV 05 Lier
60,Mechelsesteenweg 365,2020-05-03,18:00:00,112,42,70,FMN GV 05 Lier
60,Mechelsesteenweg 365,2020-05-03,19:00:00,42,14,28,FMN GV 05 Lier
60,Mechelsesteenweg 365,2020-05-03,20:00:00,14,4,10,FMN GV 05 Lier
60,Mechelsesteenweg 365,2020-05-03,21:00:00,18,8,10,FMN GV 05 Lier
60,Mechelsesteenweg 365,2020-05-03,22:00:00,2,0,2,FMN GV 05 Lier
60,Mechelsesteenweg 365,2020-05-03,23:00:00,0,0,0,FMN GV 05 Lier
60,Mechelsesteenweg 365,2020-05-04,00:00:00,0,0,0,FMN GV 05 Lier
60,Mechelsesteenweg 365,2020-05-04,01:00:00,0,0,0,FMN GV 05 Lier
60,Mechelsesteenweg 365,2020-05-04,02:00:00,0,0,0,FMN GV 05 Lier
60,Mechelsesteenweg 365,2020-05-04,03:00:00,0,0,0,FMN GV 05 Lier
60,Mechelsesteenweg 365,2020-05-04,04:00:00,4,0,4,FMN GV 05 Lier
60,Mechelsesteenweg 365,2020-05-04,05:00:00,6,2,4,FMN GV 05 Lier
60,Mechelsesteenweg 365,2020-05-04,06:00:00,22,8,14,FMN GV 05 Lier
60,Mechelsesteenweg 365,2020-05-04,07:00:00,40,4,36,FMN GV 05 Lier
60,Mechelsesteenweg 365,2020-05-04,08:00:00,26,12,14,FMN GV 05 Lier
60,Mechelsesteenweg 365,2020-05-04,09:00:00,26,10,16,FMN GV 05 Lier
60,Mechelsesteenweg 365,2020-05-04,10:00:00,14,8,6,FMN GV 05 Lier
60,Mechelsesteenweg 365,2020-05-04,11:00:00,22,10,12,FMN GV 05 Lier
60,Mechelsesteenweg 365,2020-05-04,12:00:00,36,12,24,FMN GV 05 Lier
60,Mechelsesteenweg 365,2020-05-04,13:00:00,94,42,52,FMN GV 05 Lier
60,Mechelsesteenweg 365,2020-05-04,14:00:00,112,40,72,FMN GV 05 Lier
60,Mechelsesteenweg 365,2020-05-04,15:00:00,196,74,122,FMN GV 05 Lier
60,Mechelsesteenweg 365,2020-05-04,16:00:00,160,62,98,FMN GV 05 Lier
60,Mechelsesteenweg 365,2020-05-04,17:00:00,154,78,76,FMN GV 05 Lier
60,Mechelsesteenweg 365,2020-05-04,18:00:00,98,32,66,FMN GV 05 Lier
60,Mechelsesteenweg 365,2020-05-04,19:00:00,96,42,54,FMN GV 05 Lier
60,Mechelsesteenweg 365,2020-05-04,20:00:00,60,26,34,FMN GV 05 Lier
60,Mechelsesteenweg 365,2020-05-04,21:00:00,18,2,16,FMN GV 05 Lier
60,Mechelsesteenweg 365,2020-05-04,22:00:00,10,2,8,FMN GV 05 Lier
60,Mechelsesteenweg 365,2020-05-04,23:00:00,0,0,0,FMN GV 05 Lier
60,Mechelsesteenweg 365,2020-05-05,00:00:00,0,0,0,FMN GV 05 Lier
60,Mechelsesteenweg 365,2020-05-05,01:00:00,0,0,0,FMN GV 05 Lier
60,Mechelsesteenweg 365,2020-05-05,02:00:00,0,0,0,FMN GV 05 Lier
60,Mechelsesteenweg 365,2020-05-05,03:00:00,0,0,0,FMN GV 05 Lier
60,Mechelsesteenweg 365,2020-05-05,04:00:00,2,0,2,FMN GV 05 Lier
60,Mechelsesteenweg 365,2020-05-05,05:00:00,2,0,2,FMN GV 05 Lier
60,Mechelsesteenweg 365,2020-05-05,06:00:00,10,8,2,FMN GV 05 Lier
60,Mechelsesteenweg 365,2020-05-05,07:00:00,70,22,48,FMN GV 05 Lier
60,Mechelsesteenweg 365,2020-05-05,08:00:00,40,18,22,FMN GV 05 Lier
60,Mechelsesteenweg 365,2020-05-05,09:00:00,56,38,18,FMN GV 05 Lier
60,Mechelsesteenweg 365,2020-05-05,10:00:00,44,18,26,FMN GV 05 Lier
60,Mechelsesteenweg 365,2020-05-05,11:00:00,70,26,44,FMN GV 05 Lier
60,Mechelsesteenweg 365,2020-05-05,12:00:00,110,50,60,FMN GV 05 Lier
60,Mechelsesteenweg 365,2020-05-05,13:00:00,164,62,102,FMN GV 05 Lier
60,Mechelsesteenweg 365,2020-05-05,14:00:00,236,96,140,FMN GV 05 Lier
60,Mechelsesteenweg 365,2020-05-05,15:00:00,198,62,136,FMN GV 05 Lier
60,Mechelsesteenweg 365,2020-05-05,16:00:00,172,92,80,FMN GV 05 Lier
60,Mechelsesteenweg 365,2020-05-05,17:00:00,190,90,100,FMN GV 05 Lier
60,Mechelsesteenweg 365,2020-05-05,18:00:00,174,70,104,FMN GV 05 Lier
60,Mechelsesteenweg 365,2020-05-05,19:00:00,148,68,80,FMN GV 05 Lier
60,Mechelsesteenweg 365,2020-05-05,20:00:00,76,26,50,FMN GV 05 Lier
60,Mechelsesteenweg 365,2020-05-05,21:00:00,12,2,10,FMN GV 05 Lier
60,Mechelsesteenweg 365,2020-05-05,22:00:00,6,2,4,FMN GV 05 Lier
60,Mechelsesteenweg 365,2020-05-05,23:00:00,6,0,6,FMN GV 05 Lier
60,Mechelsesteenweg 365,2020-05-06,00:00:00,0,0,0,FMN GV 05 Lier
60,Mechelsesteenweg 365,2020-05-06,01:00:00,0,0,0,FMN GV 05 Lier
60,Mechelsesteenweg 365,2020-05-06,02:00:00,0,0,0,FMN GV 05 Lier
60,Mechelsesteenweg 365,2020-05-06,03:00:00,0,0,0,FMN GV 05 Lier
60,Mechelsesteenweg 365,2020-05-06,04:00:00,2,0,2,FMN GV 05 Lier
60,Mechelsesteenweg 365,2020-05-06,05:00:00,4,0,4,FMN GV 05 Lier
60,Mechelsesteenweg 365,2020-05-06,06:00:00,24,10,14,FMN GV 05 Lier
60,Mechelsesteenweg 365,2020-05-06,07:00:00,76,30,46,FMN GV 05 Lier
60,Mechelsesteenweg 365,2020-05-06,08:00:00,36,22,14,FMN GV 05 Lier
60,Mechelsesteenweg 365,2020-05-06,09:00:00,50,18,32,FMN GV 05 Lier
60,Mechelsesteenweg 365,2020-05-06,10:00:00,102,52,50,FMN GV 05 Lier
60,Mechelsesteenweg 365,2020-05-06,11:00:00,142,68,74,FMN GV 05 Lier
60,Mechelsesteenweg 365,2020-05-06,12:00:00,94,40,54,FMN GV 05 Lier
60,Mechelsesteenweg 365,2020-05-06,13:00:00,242,106,136,FMN GV 05 Lier
60,Mechelsesteenweg 365,2020-05-06,14:00:00,362,166,196,FMN GV 05 Lier
60,Mechelsesteenweg 365,2020-05-06,15:00:00,414,174,240,FMN GV 05 Lier
60,Mechelsesteenweg 365,2020-05-06,16:00:00,322,150,172,FMN GV 05 Lier
60,Mechelsesteenweg 365,2020-05-06,17:00:00,380,180,200,FMN GV 05 Lier
60,Mechelsesteenweg 365,2020-05-06,18:00:00,268,90,178,FMN GV 05 Lier
60,Mechelsesteenweg 365,2020-05-06,19:00:00,218,90,128,FMN GV 05 Lier
60,Mechelsesteenweg 365,2020-05-06,20:00:00,80,24,56,FMN GV 05 Lier
60,Mechelsesteenweg 365,2020-05-06,21:00:00,38,18,20,FMN GV 05 Lier
60,Mechelsesteenweg 365,2020-05-06,22:00:00,8,4,4,FMN GV 05 Lier
60,Mechelsesteenweg 365,2020-05-06,23:00:00,0,0,0,FMN GV 05 Lier
60,Mechelsesteenweg 365,2020-05-07,00:00:00,0,0,0,FMN GV 05 Lier
60,Mechelsesteenweg 365,2020-05-07,01:00:00,0,0,0,FMN GV 05 Lier
60,Mechelsesteenweg 365,2020-05-07,02:00:00,0,0,0,FMN GV 05 Lier
60,Mechelsesteenweg 365,2020-05-07,03:00:00,0,0,0,FMN GV 05 Lier
60,Mechelsesteenweg 365,2020-05-07,04:00:00,0,0,0,FMN GV 05 Lier
60,Mechelsesteenweg 365,2020-05-07,05:00:00,4,0,4,FMN GV 05 Lier
60,Mechelsesteenweg 365,2020-05-07,06:00:00,20,8,12,FMN GV 05 Lier
60,Mechelsesteenweg 365,2020-05-07,07:00:00,62,28,34,FMN GV 05 Lier
60,Mechelsesteenweg 365,2020-05-07,08:00:00,52,20,32,FMN GV 05 Lier
60,Mechelsesteenweg 365,2020-05-07,09:00:00,62,28,34,FMN GV 05 Lier
60,Mechelsesteenweg 365,2020-05-07,10:00:00,98,42,56,FMN GV 05 Lier
60,Mechelsesteenweg 365,2020-05-07,11:00:00,156,78,78,FMN GV 05 Lier
60,Mechelsesteenweg 365,2020-05-07,12:00:00,206,88,118,FMN GV 05 Lier
60,Mechelsesteenweg 365,2020-05-07,13:00:00,274,108,166,FMN GV 05 Lier
60,Mechelsesteenweg 365,2020-05-07,14:00:00,534,268,266,FMN GV 05 Lier
60,Mechelsesteenweg 365,2020-05-07,15:00:00,416,172,244,FMN GV 05 Lier
60,Mechelsesteenweg 365,2020-05-07,16:00:00,408,182,226,FMN GV 05 Lier
60,Mechelsesteenweg 365,2020-05-07,17:00:00,248,114,134,FMN GV 05 Lier
60,Mechelsesteenweg 365,2020-05-07,18:00:00,148,68,80,FMN GV 05 Lier
60,Mechelsesteenweg 365,2020-05-07,19:00:00,212,76,136,FMN GV 05 Lier
60,Mechelsesteenweg 365,2020-05-07,20:00:00,120,44,76,FMN GV 05 Lier
60,Mechelsesteenweg 365,2020-05-07,21:00:00,30,6,24,FMN GV 05 Lier
60,Mechelsesteenweg 365,2020-05-07,22:00:00,2,2,0,FMN GV 05 Lier
60,Mechelsesteenweg 365,2020-05-07,23:00:00,0,0,0,FMN GV 05 Lier
60,Mechelsesteenweg 365,2020-05-08,00:00:00,0,0,0,FMN GV 05 Lier
60,Mechelsesteenweg 365,2020-05-08,01:00:00,0,0,0,FMN GV 05 Lier
60,Mechelsesteenweg 365,2020-05-08,02:00:00,2,0,2,FMN GV 05 Lier
60,Mechelsesteenweg 365,2020-05-08,03:00:00,0,0,0,FMN GV 05 Lier
60,Mechelsesteenweg 365,2020-05-08,04:00:00,4,0,4,FMN GV 05 Lier
60,Mechelsesteenweg 365,2020-05-08,05:00:00,0,0,0,FMN GV 05 Lier
60,Mechelsesteenweg 365,2020-05-08,06:00:00,14,10,4,FMN GV 05 Lier
60,Mechelsesteenweg 365,2020-05-08,07:00:00,42,12,30,FMN GV 05 Lier
60,Mechelsesteenweg 365,2020-05-08,08:00:00,46,20,26,FMN GV 05 Lier
60,Mechelsesteenweg 365,2020-05-08,09:00:00,74,38,36,FMN GV 05 Lier
60,Mechelsesteenweg 365,2020-05-08,10:00:00,162,72,90,FMN GV 05 Lier
60,Mechelsesteenweg 365,2020-05-08,11:00:00,210,84,126,FMN GV 05 Lier
60,Mechelsesteenweg 365,2020-05-08,12:00:00,174,78,96,FMN GV 05 Lier
60,Mechelsesteenweg 365,2020-05-08,13:00:00,262,124,138,FMN GV 05 Lier
60,Mechelsesteenweg 365,2020-05-08,14:00:00,452,204,248,FMN GV 05 Lier
60,Mechelsesteenweg 365,2020-05-08,15:00:00,400,136,264,FMN GV 05 Lier
60,Mechelsesteenweg 365,2020-05-08,16:00:00,286,86,200,FMN GV 05 Lier
60,Mechelsesteenweg 365,2020-05-08,17:00:00,220,80,140,FMN GV 05 Lier
60,Mechelsesteenweg 365,2020-05-08,18:00:00,148,58,90,FMN GV 05 Lier
60,Mechelsesteenweg 365,2020-05-08,19:00:00,102,48,54,FMN GV 05 Lier
60,Mechelsesteenweg 365,2020-05-08,20:00:00,52,28,24,FMN GV 05 Lier
60,Mechelsesteenweg 365,2020-05-08,21:00:00,30,4,26,FMN GV 05 Lier
60,Mechelsesteenweg 365,2020-05-08,22:00:00,4,2,2,FMN GV 05 Lier
60,Mechelsesteenweg 365,2020-05-08,23:00:00,2,2,0,FMN GV 05 Lier
60,Mechelsesteenweg 365,2020-05-09,00:00:00,4,4,0,FMN GV 05 Lier
60,Mechelsesteenweg 365,2020-05-09,01:00:00,0,0,0,FMN GV 05 Lier
60,Mechelsesteenweg 365,2020-05-09,02:00:00,0,0,0,FMN GV 05 Lier
60,Mechelsesteenweg 365,2020-05-09,03:00:00,0,0,0,FMN GV 05 Lier
60,Mechelsesteenweg 365,2020-05-09,04:00:00,0,0,0,FMN GV 05 Lier
60,Mechelsesteenweg 365,2020-05-09,05:00:00,0,0,0,FMN GV 05 Lier
60,Mechelsesteenweg 365,2020-05-09,06:00:00,2,0,2,FMN GV 05 Lier
60,Mechelsesteenweg 365,2020-05-09,07:00:00,20,10,10,FMN GV 05 Lier
60,Mechelsesteenweg 365,2020-05-09,08:00:00,52,22,30,FMN GV 05 Lier
60,Mechelsesteenweg 365,2020-05-09,09:00:00,184,88,96,FMN GV 05 Lier
60,Mechelsesteenweg 365,2020-05-09,10:00:00,388,170,218,FMN GV 05 Lier
60,Mechelsesteenweg 365,2020-05-09,11:00:00,486,176,310,FMN GV 05 Lier
60,Mechelsesteenweg 365,2020-05-09,12:00:00,468,190,278,FMN GV 05 Lier
60,Mechelsesteenweg 365,2020-05-09,13:00:00,448,172,276,FMN GV 05 Lier
60,Mechelsesteenweg 365,2020-05-09,14:00:00,656,294,362,FMN GV 05 Lier
60,Mechelsesteenweg 365,2020-05-09,15:00:00,734,250,484,FMN GV 05 Lier
60,Mechelsesteenweg 365,2020-05-09,16:00:00,646,274,372,FMN GV 05 Lier
60,Mechelsesteenweg 365,2020-05-09,17:00:00,338,120,218,FMN GV 05 Lier
60,Mechelsesteenweg 365,2020-05-09,18:00:00,224,62,162,FMN GV 05 Lier
60,Mechelsesteenweg 365,2020-05-09,19:00:00,94,48,46,FMN GV 05 Lier
60,Mechelsesteenweg 365,2020-05-09,20:00:00,82,36,46,FMN GV 05 Lier
60,Mechelsesteenweg 365,2020-05-09,21:00:00,36,16,20,FMN GV 05 Lier
60,Mechelsesteenweg 365,2020-05-09,22:00:00,12,2,10,FMN GV 05 Lier
60,Mechelsesteenweg 365,2020-05-09,23:00:00,4,2,2,FMN GV 05 Lier
60,Mechelsesteenweg 365,2020-05-10,00:00:00,8,2,6,FMN GV 05 Lier
60,Mechelsesteenweg 365,2020-05-10,01:00:00,0,0,0,FMN GV 05 Lier
60,Mechelsesteenweg 365,2020-05-10,02:00:00,0,0,0,FMN GV 05 Lier
60,Mechelsesteenweg 365,2020-05-10,03:00:00,0,0,0,FMN GV 05 Lier
60,Mechelsesteenweg 365,2020-05-10,04:00:00,0,0,0,FMN GV 05 Lier
60,Mechelsesteenweg 365,2020-05-10,05:00:00,2,2,0,FMN GV 05 Lier
60,Mechelsesteenweg 365,2020-05-10,06:00:00,4,2,2,FMN GV 05 Lier
60,Mechelsesteenweg 365,2020-05-10,07:00:00,10,6,4,FMN GV 05 Lier
60,Mechelsesteenweg 365,2020-05-10,08:00:00,30,14,16,FMN GV 05 Lier
60,Mechelsesteenweg 365,2020-05-10,09:00:00,82,34,48,FMN GV 05 Lier
60,Mechelsesteenweg 365,2020-05-10,10:00:00,208,86,122,FMN GV 05 Lier
60,Mechelsesteenweg 365,2020-05-10,11:00:00,188,62,126,FMN GV 05 Lier
60,Mechelsesteenweg 365,2020-05-10,12:00:00,148,64,84,FMN GV 05 Lier
60,Mechelsesteenweg 365,2020-05-10,13:00:00,156,52,104,FMN GV 05 Lier
60,Mechelsesteenweg 365,2020-05-10,14:00:00,222,90,132,FMN GV 05 Lier
60,Mechelsesteenweg 365,2020-05-10,15:00:00,214,60,154,FMN GV 05 Lier
60,Mechelsesteenweg 365,2020-05-10,16:00:00,76,28,48,FMN GV 05 Lier
60,Mechelsesteenweg 365,2020-05-10,17:00:00,20,10,10,FMN GV 05 Lier
60,Mechelsesteenweg 365,2020-05-10,18:00:00,24,4,20,FMN GV 05 Lier
60,Mechelsesteenweg 365,2020-05-10,19:00:00,18,12,6,FMN GV 05 Lier
60,Mechelsesteenweg 365,2020-05-10,20:00:00,18,12,6,FMN GV 05 Lier
60,Mechelsesteenweg 365,2020-05-10,21:00:00,4,0,4,FMN GV 05 Lier
60,Mechelsesteenweg 365,2020-05-10,22:00:00,2,0,2,FMN GV 05 Lier
60,Mechelsesteenweg 365,2020-05-10,23:00:00,0,0,0,FMN GV 05 Lier
60,Mechelsesteenweg 365,2020-05-11,00:00:00,0,0,0,FMN GV 05 Lier
60,Mechelsesteenweg 365,2020-05-11,01:00:00,2,0,2,FMN GV 05 Lier
60,Mechelsesteenweg 365,2020-05-11,02:00:00,0,0,0,FMN GV 05 Lier
60,Mechelsesteenweg 365,2020-05-11,03:00:00,0,0,0,FMN GV 05 Lier
60,Mechelsesteenweg 365,2020-05-11,04:00:00,2,0,2,FMN GV 05 Lier
60,Mechelsesteenweg 365,2020-05-11,05:00:00,6,2,4,FMN GV 05 Lier
60,Mechelsesteenweg 365,2020-05-11,06:00:00,14,6,8,FMN GV 05 Lier
60,Mechelsesteenweg 365,2020-05-11,07:00:00,28,10,18,FMN GV 05 Lier
60,Mechelsesteenweg 365,2020-05-11,08:00:00,16,6,10,FMN GV 05 Lier
60,Mechelsesteenweg 365,2020-05-11,09:00:00,20,16,4,FMN GV 05 Lier
60,Mechelsesteenweg 365,2020-05-11,10:00:00,18,6,12,FMN GV 05 Lier
60,Mechelsesteenweg 365,2020-05-11,11:00:00,36,16,20,FMN GV 05 Lier
60,Mechelsesteenweg 365,2020-05-11,12:00:00,16,2,14,FMN GV 05 Lier
60,Mechelsesteenweg 365,2020-05-11,13:00:00,34,8,26,FMN GV 05 Lier
60,Mechelsesteenweg 365,2020-05-11,14:00:00,32,18,14,FMN GV 05 Lier
60,Mechelsesteenweg 365,2020-05-11,15:00:00,8,4,4,FMN GV 05 Lier
60,Mechelsesteenweg 365,2020-05-11,16:00:00,6,2,4,FMN GV 05 Lier
60,Mechelsesteenweg 365,2020-05-11,17:00:00,2,0,2,FMN GV 05 Lier
60,Mechelsesteenweg 365,2020-05-11,18:00:00,4,4,0,FMN GV 05 Lier
60,Mechelsesteenweg 365,2020-05-11,19:00:00,6,4,2,FMN GV 05 Lier
60,Mechelsesteenweg 365,2020-05-11,20:00:00,0,0,0,FMN GV 05 Lier
60,Mechelsesteenweg 365,2020-05-11,21:00:00,0,0,0,FMN GV 05 Lier
60,Mechelsesteenweg 365,2020-05-11,22:00:00,0,0,0,FMN GV 05 Lier
60,Mechelsesteenweg 365,2020-05-11,23:00:00,0,0,0,FMN GV 05 Lier
60,Mechelsesteenweg 365,2020-05-12,00:00:00,0,0,0,FMN GV 05 Lier
60,Mechelsesteenweg 365,2020-05-12,01:00:00,0,0,0,FMN GV 05 Lier
60,Mechelsesteenweg 365,2020-05-12,02:00:00,0,0,0,FMN GV 05 Lier
60,Mechelsesteenweg 365,2020-05-12,03:00:00,0,0,0,FMN GV 05 Lier
60,Mechelsesteenweg 365,2020-05-12,04:00:00,0,0,0,FMN GV 05 Lier
60,Mechelsesteenweg 365,2020-05-12,05:00:00,0,0,0,FMN GV 05 Lier
60,Mechelsesteenweg 365,2020-05-12,06:00:00,6,6,0,FMN GV 05 Lier
60,Mechelsesteenweg 365,2020-05-12,07:00:00,8,8,0,FMN GV 05 Lier
60,Mechelsesteenweg 365,2020-05-12,08:00:00,14,14,0,FMN GV 05 Lier
60,Mechelsesteenweg 365,2020-05-12,09:00:00,10,8,2,FMN GV 05 Lier
60,Mechelsesteenweg 365,2020-05-12,10:00:00,22,14,8,FMN GV 05 Lier
60,Mechelsesteenweg 365,2020-05-12,11:00:00,16,12,4,FMN GV 05 Lier
60,Mechelsesteenweg 365,2020-05-12,12:00:00,12,8,4,FMN GV 05 Lier
60,Mechelsesteenweg 365,2020-05-12,13:00:00,24,14,10,FMN GV 05 Lier
60,Mechelsesteenweg 365,2020-05-12,14:00:00,34,28,6,FMN GV 05 Lier
60,Mechelsesteenweg 365,2020-05-12,15:00:00,10,6,4,FMN GV 05 Lier
60,Mechelsesteenweg 365,2020-05-12,16:00:00,6,2,4,FMN GV 05 Lier
60,Mechelsesteenweg 365,2020-05-12,17:00:00,2,2,0,FMN GV 05 Lier
60,Mechelsesteenweg 365,2020-05-12,18:00:00,4,4,0,FMN GV 05 Lier
60,Mechelsesteenweg 365,2020-05-12,19:00:00,4,4,0,FMN GV 05 Lier
60,Mechelsesteenweg 365,2020-05-12,20:00:00,0,0,0,FMN GV 05 Lier
60,Mechelsesteenweg 365,2020-05-12,21:00:00,4,2,2,FMN GV 05 Lier
60,Mechelsesteenweg 365,2020-05-12,22:00:00,2,2,0,FMN GV 05 Lier
60,Mechelsesteenweg 365,2020-05-12,23:00:00,0,0,0,FMN GV 05 Lier
60,Mechelsesteenweg 365,2020-05-13,00:00:00,0,0,0,FMN GV 05 Lier
60,Mechelsesteenweg 365,2020-05-13,01:00:00,0,0,0,FMN GV 05 Lier
60,Mechelsesteenweg 365,2020-05-13,02:00:00,0,0,0,FMN GV 05 Lier
60,Mechelsesteenweg 365,2020-05-13,03:00:00,0,0,0,FMN GV 05 Lier
60,Mechelsesteenweg 365,2020-05-13,04:00:00,0,0,0,FMN GV 05 Lier
60,Mechelsesteenweg 365,2020-05-13,05:00:00,0,0,0,FMN GV 05 Lier
60,Mechelsesteenweg 365,2020-05-13,06:00:00,0,0,0,FMN GV 05 Lier
60,Mechelsesteenweg 365,2020-05-13,07:00:00,26,24,2,FMN GV 05 Lier
60,Mechelsesteenweg 365,2020-05-13,08:00:00,50,32,18,FMN GV 05 Lier
60,Mechelsesteenweg 365,2020-05-13,09:00:00,0,0,0,FMN GV 05 Lier
60,Mechelsesteenweg 365,2020-05-13,10:00:00,0,0,0,FMN GV 05 Lier
60,Mechelsesteenweg 365,2020-05-13,11:00:00,0,0,0,FMN GV 05 Lier
60,Mechelsesteenweg 365,2020-05-13,12:00:00,0,0,0,FMN GV 05 Lier
60,Mechelsesteenweg 365,2020-05-13,13:00:00,0,0,0,FMN GV 05 Lier
60,Mechelsesteenweg 365,2020-05-13,14:00:00,0,0,0,FMN GV 05 Lier
60,Mechelsesteenweg 365,2020-05-13,15:00:00,0,0,0,FMN GV 05 Lier
60,Mechelsesteenweg 365,2020-05-13,16:00:00,0,0,0,FMN GV 05 Lier
60,Mechelsesteenweg 365,2020-05-13,17:00:00,0,0,0,FMN GV 05 Lier
60,Mechelsesteenweg 365,2020-05-13,18:00:00,0,0,0,FMN GV 05 Lier
60,Mechelsesteenweg 365,2020-05-13,19:00:00,0,0,0,FMN GV 05 Lier
60,Mechelsesteenweg 365,2020-05-13,20:00:00,0,0,0,FMN GV 05 Lier
60,Mechelsesteenweg 365,2020-05-13,21:00:00,0,0,0,FMN GV 05 Lier
60,Mechelsesteenweg 365,2020-05-13,22:00:00,0,0,0,FMN GV 05 Lier
60,Mechelsesteenweg 365,2020-05-13,23:00:00,0,0,0,FMN GV 05 Lier
60,Mechelsesteenweg 365,2021-03-01,00:00:00,0,0,0,FMN GV 05 Lier
60,Mechelsesteenweg 365,2021-03-01,01:00:00,2,0,2,FMN GV 05 Lier
60,Mechelsesteenweg 365,2021-03-01,02:00:00,0,0,0,FMN GV 05 Lier
60,Mechelsesteenweg 365,2021-03-01,03:00:00,0,0,0,FMN GV 05 Lier
60,Mechelsesteenweg 365,2021-03-01,04:00:00,2,0,2,FMN GV 05 Lier
60,Mechelsesteenweg 365,2021-03-01,05:00:00,6,2,4,FMN GV 05 Lier
60,Mechelsesteenweg 365,2021-03-01,06:00:00,16,10,6,FMN GV 05 Lier
60,Mechelsesteenweg 365,2021-03-01,07:00:00,106,58,48,FMN GV 05 Lier
60,Mechelsesteenweg 365,2021-03-01,08:00:00,90,50,40,FMN GV 05 Lier
60,Mechelsesteenweg 365,2021-03-01,09:00:00,58,30,28,FMN GV 05 Lier
60,Mechelsesteenweg 365,2021-03-01,10:00:00,70,38,32,FMN GV 05 Lier
60,Mechelsesteenweg 365,2021-03-01,11:00:00,74,34,40,FMN GV 05 Lier
60,Mechelsesteenweg 365,2021-03-01,12:00:00,76,28,48,FMN GV 05 Lier
60,Mechelsesteenweg 365,2021-03-01,13:00:00,92,48,44,FMN GV 05 Lier
60,Mechelsesteenweg 365,2021-03-01,14:00:00,128,64,64,FMN GV 05 Lier
60,Mechelsesteenweg 365,2021-03-01,15:00:00,130,58,72,FMN GV 05 Lier
60,Mechelsesteenweg 365,2021-03-01,16:00:00,168,60,108,FMN GV 05 Lier
60,Mechelsesteenweg 365,2021-03-01,17:00:00,110,64,46,FMN GV 05 Lier
60,Mechelsesteenweg 365,2021-03-01,18:00:00,62,32,30,FMN GV 05 Lier
60,Mechelsesteenweg 365,2021-03-01,19:00:00,38,18,20,FMN GV 05 Lier
60,Mechelsesteenweg 365,2021-03-01,20:00:00,28,16,12,FMN GV 05 Lier
60,Mechelsesteenweg 365,2021-03-01,21:00:00,16,6,10,FMN GV 05 Lier
60,Mechelsesteenweg 365,2021-03-01,22:00:00,6,4,2,FMN GV 05 Lier
60,Mechelsesteenweg 365,2021-03-01,23:00:00,0,0,0,FMN GV 05 Lier
60,Mechelsesteenweg 365,2021-03-02,00:00:00,2,2,0,FMN GV 05 Lier
60,Mechelsesteenweg 365,2021-03-02,01:00:00,0,0,0,FMN GV 05 Lier
60,Mechelsesteenweg 365,2021-03-02,02:00:00,0,0,0,FMN GV 05 Lier
60,Mechelsesteenweg 365,2021-03-02,03:00:00,2,0,2,FMN GV 05 Lier
60,Mechelsesteenweg 365,2021-03-02,04:00:00,2,0,2,FMN GV 05 Lier
60,Mechelsesteenweg 365,2021-03-02,05:00:00,10,0,10,FMN GV 05 Lier
60,Mechelsesteenweg 365,2021-03-02,06:00:00,34,10,24,FMN GV 05 Lier
60,Mechelsesteenweg 365,2021-03-02,07:00:00,188,98,90,FMN GV 05 Lier
60,Mechelsesteenweg 365,2021-03-02,08:00:00,154,86,68,FMN GV 05 Lier
60,Mechelsesteenweg 365,2021-03-02,09:00:00,104,50,54,FMN GV 05 Lier
60,Mechelsesteenweg 365,2021-03-02,10:00:00,142,68,74,FMN GV 05 Lier
60,Mechelsesteenweg 365,2021-03-02,11:00:00,144,78,66,FMN GV 05 Lier
60,Mechelsesteenweg 365,2021-03-02,12:00:00,130,68,62,FMN GV 05 Lier
60,Mechelsesteenweg 365,2021-03-02,13:00:00,184,84,100,FMN GV 05 Lier
60,Mechelsesteenweg 365,2021-03-02,14:00:00,214,114,100,FMN GV 05 Lier
60,Mechelsesteenweg 365,2021-03-02,15:00:00,224,100,124,FMN GV 05 Lier
60,Mechelsesteenweg 365,2021-03-02,16:00:00,278,106,172,FMN GV 05 Lier
60,Mechelsesteenweg 365,2021-03-02,17:00:00,194,112,82,FMN GV 05 Lier
60,Mechelsesteenweg 365,2021-03-02,18:00:00,112,62,50,FMN GV 05 Lier
60,Mechelsesteenweg 365,2021-03-02,19:00:00,90,42,48,FMN GV 05 Lier
60,Mechelsesteenweg 365,2021-03-02,20:00:00,66,28,38,FMN GV 05 Lier
60,Mechelsesteenweg 365,2021-03-02,21:00:00,24,6,18,FMN GV 05 Lier
60,Mechelsesteenweg 365,2021-03-02,22:00:00,12,4,8,FMN GV 05 Lier
60,Mechelsesteenweg 365,2021-03-02,23:00:00,4,2,2,FMN GV 05 Lier
60,Mechelsesteenweg 365,2021-03-03,00:00:00,0,0,0,FMN GV 05 Lier
60,Mechelsesteenweg 365,2021-03-03,01:00:00,0,0,0,FMN GV 05 Lier
60,Mechelsesteenweg 365,2021-03-03,02:00:00,0,0,0,FMN GV 05 Lier
60,Mechelsesteenweg 365,2021-03-03,03:00:00,0,0,0,FMN GV 05 Lier
60,Mechelsesteenweg 365,2021-03-03,04:00:00,0,0,0,FMN GV 05 Lier
60,Mechelsesteenweg 365,2021-03-03,05:00:00,0,0,0,FMN GV 05 Lier
60,Mechelsesteenweg 365,2021-03-03,06:00:00,0,0,0,FMN GV 05 Lier
60,Mechelsesteenweg 365,2021-03-03,07:00:00,0,0,0,FMN GV 05 Lier
60,Mechelsesteenweg 365,2021-03-03,08:00:00,0,0,0,FMN GV 05 Lier
60,Mechelsesteenweg 365,2021-03-03,09:00:00,0,0,0,FMN GV 05 Lier
60,Mechelsesteenweg 365,2021-03-03,10:00:00,0,0,0,FMN GV 05 Lier
60,Mechelsesteenweg 365,2021-03-03,11:00:00,0,0,0,FMN GV 05 Lier
60,Mechelsesteenweg 365,2021-03-03,12:00:00,0,0,0,FMN GV 05 Lier
60,Mechelsesteenweg 365,2021-03-03,13:00:00,0,0,0,FMN GV 05 Lier
60,Mechelsesteenweg 365,2021-03-03,14:00:00,0,0,0,FMN GV 05 Lier
60,Mechelsesteenweg 365,2021-03-03,15:00:00,24,6,18,FMN GV 05 Lier
60,Mechelsesteenweg 365,2021-03-03,16:00:00,276,156,120,FMN GV 05 Lier
60,Mechelsesteenweg 365,2021-03-03,17:00:00,222,114,108,FMN GV 05 Lier
60,Mechelsesteenweg 365,2021-03-03,18:00:00,112,60,52,FMN GV 05 Lier
60,Mechelsesteenweg 365,2021-03-03,19:00:00,24,14,10,FMN GV 05 Lier
60,Mechelsesteenweg 365,2021-03-03,20:00:00,12,10,2,FMN GV 05 Lier
60,Mechelsesteenweg 365,2021-03-03,21:00:00,4,0,4,FMN GV 05 Lier
60,Mechelsesteenweg 365,2021-03-03,22:00:00,2,2,0,FMN GV 05 Lier
60,Mechelsesteenweg 365,2021-03-03,23:00:00,0,0,0,FMN GV 05 Lier
60,Mechelsesteenweg 365,2021-03-04,00:00:00,0,0,0,FMN GV 05 Lier
60,Mechelsesteenweg 365,2021-03-04,01:00:00,0,0,0,FMN GV 05 Lier
60,Mechelsesteenweg 365,2021-03-04,02:00:00,0,0,0,FMN GV 05 Lier
60,Mechelsesteenweg 365,2021-03-04,03:00:00,0,0,0,FMN GV 05 Lier
60,Mechelsesteenweg 365,2021-03-04,04:00:00,4,0,4,FMN GV 05 Lier
60,Mechelsesteenweg 365,2021-03-04,05:00:00,10,2,8,FMN GV 05 Lier
60,Mechelsesteenweg 365,2021-03-04,06:00:00,14,4,10,FMN GV 05 Lier
60,Mechelsesteenweg 365,2021-03-04,07:00:00,108,68,40,FMN GV 05 Lier
60,Mechelsesteenweg 365,2021-03-04,08:00:00,88,64,24,FMN GV 05 Lier
60,Mechelsesteenweg 365,2021-03-04,09:00:00,16,8,8,FMN GV 05 Lier
60,Mechelsesteenweg 365,2021-03-04,10:00:00,6,6,0,FMN GV 05 Lier
60,Mechelsesteenweg 365,2021-03-04,11:00:00,8,2,6,FMN GV 05 Lier
60,Mechelsesteenweg 365,2021-03-04,12:00:00,10,6,4,FMN GV 05 Lier
60,Mechelsesteenweg 365,2021-03-04,13:00:00,22,8,14,FMN GV 05 Lier
60,Mechelsesteenweg 365,2021-03-04,14:00:00,24,16,8,FMN GV 05 Lier
60,Mechelsesteenweg 365,2021-03-04,15:00:00,50,24,26,FMN GV 05 Lier
60,Mechelsesteenweg 365,2021-03-04,16:00:00,124,26,98,FMN GV 05 Lier
60,Mechelsesteenweg 365,2021-03-04,17:00:00,50,26,24,FMN GV 05 Lier
60,Mechelsesteenweg 365,2021-03-04,18:00:00,26,16,10,FMN GV 05 Lier
60,Mechelsesteenweg 365,2021-03-04,19:00:00,4,0,4,FMN GV 05 Lier
60,Mechelsesteenweg 365,2021-03-04,20:00:00,0,0,0,FMN GV 05 Lier
60,Mechelsesteenweg 365,2021-03-04,21:00:00,4,0,4,FMN GV 05 Lier
60,Mechelsesteenweg 365,2021-03-04,22:00:00,2,2,0,FMN GV 05 Lier
60,Mechelsesteenweg 365,2021-03-04,23:00:00,2,2,0,FMN GV 05 Lier
60,Mechelsesteenweg 365,2021-03-05,00:00:00,0,0,0,FMN GV 05 Lier
60,Mechelsesteenweg 365,2021-03-05,01:00:00,0,0,0,FMN GV 05 Lier
60,Mechelsesteenweg 365,2021-03-05,02:00:00,0,0,0,FMN GV 05 Lier
60,Mechelsesteenweg 365,2021-03-05,03:00:00,0,0,0,FMN GV 05 Lier
60,Mechelsesteenweg 365,2021-03-05,04:00:00,2,0,2,FMN GV 05 Lier
60,Mechelsesteenweg 365,2021-03-05,05:00:00,8,4,4,FMN GV 05 Lier
60,Mechelsesteenweg 365,2021-03-05,06:00:00,0,0,0,FMN GV 05 Lier
60,Mechelsesteenweg 365,2021-03-05,07:00:00,0,0,0,FMN GV 05 Lier
60,Mechelsesteenweg 365,2021-03-05,08:00:00,48,26,22,FMN GV 05 Lier
60,Mechelsesteenweg 365,2021-03-05,09:00:00,50,26,24,FMN GV 05 Lier
60,Mechelsesteenweg 365,2021-03-05,10:00:00,74,32,42,FMN GV 05 Lier
60,Mechelsesteenweg 365,2021-03-05,11:00:00,80,52,28,FMN GV 05 Lier
60,Mechelsesteenweg 365,2021-03-05,12:00:00,100,52,48,FMN GV 05 Lier
60,Mechelsesteenweg 365,2021-03-05,13:00:00,146,70,76,FMN GV 05 Lier
60,Mechelsesteenweg 365,2021-03-05,14:00:00,272,176,96,FMN GV 05 Lier
60,Mechelsesteenweg 365,2021-03-05,15:00:00,200,88,112,FMN GV 05 Lier
60,Mechelsesteenweg 365,2021-03-05,16:00:00,282,80,202,FMN GV 05 Lier
60,Mechelsesteenweg 365,2021-03-05,17:00:00,132,64,68,FMN GV 05 Lier
60,Mechelsesteenweg 365,2021-03-05,18:00:00,64,32,32,FMN GV 05 Lier
60,Mechelsesteenweg 365,2021-03-05,19:00:00,14,10,4,FMN GV 05 Lier
60,Mechelsesteenweg 365,2021-03-05,20:00:00,4,4,0,FMN GV 05 Lier
60,Mechelsesteenweg 365,2021-03-05,21:00:00,0,0,0,FMN GV 05 Lier
60,Mechelsesteenweg 365,2021-03-05,22:00:00,0,0,0,FMN GV 05 Lier
60,Mechelsesteenweg 365,2021-03-05,23:00:00,0,0,0,FMN GV 05 Lier
60,Mechelsesteenweg 365,2021-03-06,00:00:00,0,0,0,FMN GV 05 Lier
60,Mechelsesteenweg 365,2021-03-06,01:00:00,0,0,0,FMN GV 05 Lier
60,Mechelsesteenweg 365,2021-03-06,02:00:00,0,0,0,FMN GV 05 Lier
60,Mechelsesteenweg 365,2021-03-06,03:00:00,0,0,0,FMN GV 05 Lier
60,Mechelsesteenweg 365,2021-03-06,04:00:00,0,0,0,FMN GV 05 Lier
60,Mechelsesteenweg 365,2021-03-06,05:00:00,0,0,0,FMN GV 05 Lier
60,Mechelsesteenweg 365,2021-03-06,06:00:00,0,0,0,FMN GV 05 Lier
60,Mechelsesteenweg 365,2021-03-06,07:00:00,0,0,0,FMN GV 05 Lier
60,Mechelsesteenweg 365,2021-03-06,08:00:00,10,8,2,FMN GV 05 Lier
60,Mechelsesteenweg 365,2021-03-06,09:00:00,56,34,22,FMN GV 05 Lier
60,Mechelsesteenweg 365,2021-03-06,10:00:00,178,112,66,FMN GV 05 Lier
60,Mechelsesteenweg 365,2021-03-06,11:00:00,232,86,146,FMN GV 05 Lier
60,Mechelsesteenweg 365,2021-03-06,12:00:00,182,92,90,FMN GV 05 Lier
60,Mechelsesteenweg 365,2021-03-06,13:00:00,250,144,106,FMN GV 05 Lier
60,Mechelsesteenweg 365,2021-03-06,14:00:00,306,136,170,FMN GV 05 Lier
60,Mechelsesteenweg 365,2021-03-06,15:00:00,240,82,158,FMN GV 05 Lier
60,Mechelsesteenweg 365,2021-03-06,16:00:00,200,80,120,FMN GV 05 Lier
60,Mechelsesteenweg 365,2021-03-06,17:00:00,40,14,26,FMN GV 05 Lier
60,Mechelsesteenweg 365,2021-03-06,18:00:00,40,14,26,FMN GV 05 Lier
60,Mechelsesteenweg 365,2021-03-06,19:00:00,8,2,6,FMN GV 05 Lier
60,Mechelsesteenweg 365,2021-03-06,20:00:00,0,0,0,FMN GV 05 Lier
60,Mechelsesteenweg 365,2021-03-06,21:00:00,0,0,0,FMN GV 05 Lier
60,Mechelsesteenweg 365,2021-03-06,22:00:00,2,0,2,FMN GV 05 Lier
60,Mechelsesteenweg 365,2021-03-06,23:00:00,0,0,0,FMN GV 05 Lier
60,Mechelsesteenweg 365,2021-03-07,00:00:00,0,0,0,FMN GV 05 Lier
60,Mechelsesteenweg 365,2021-03-07,01:00:00,0,0,0,FMN GV 05 Lier
60,Mechelsesteenweg 365,2021-03-07,02:00:00,0,0,0,FMN GV 05 Lier
60,Mechelsesteenweg 365,2021-03-07,03:00:00,0,0,0,FMN GV 05 Lier
60,Mechelsesteenweg 365,2021-03-07,04:00:00,0,0,0,FMN GV 05 Lier
60,Mechelsesteenweg 365,2021-03-07,05:00:00,0,0,0,FMN GV 05 Lier
60,Mechelsesteenweg 365,2021-03-07,06:00:00,0,0,0,FMN GV 05 Lier
60,Mechelsesteenweg 365,2021-03-07,07:00:00,0,0,0,FMN GV 05 Lier
60,Mechelsesteenweg 365,2021-03-07,08:00:00,18,6,12,FMN GV 05 Lier
60,Mechelsesteenweg 365,2021-03-07,09:00:00,128,80,48,FMN GV 05 Lier
60,Mechelsesteenweg 365,2021-03-07,10:00:00,364,194,170,FMN GV 05 Lier
60,Mechelsesteenweg 365,2021-03-07,11:00:00,378,168,210,FMN GV 05 Lier
60,Mechelsesteenweg 365,2021-03-07,12:00:00,260,96,164,FMN GV 05 Lier
60,Mechelsesteenweg 365,2021-03-07,13:00:00,260,144,116,FMN GV 05 Lier
60,Mechelsesteenweg 365,2021-03-07,14:00:00,312,146,166,FMN GV 05 Lier
60,Mechelsesteenweg 365,2021-03-07,15:00:00,288,110,178,FMN GV 05 Lier
60,Mechelsesteenweg 365,2021-03-07,16:00:00,256,102,154,FMN GV 05 Lier
60,Mechelsesteenweg 365,2021-03-07,17:00:00,66,28,38,FMN GV 05 Lier
60,Mechelsesteenweg 365,2021-03-07,18:00:00,16,6,10,FMN GV 05 Lier
60,Mechelsesteenweg 365,2021-03-07,19:00:00,10,6,4,FMN GV 05 Lier
60,Mechelsesteenweg 365,2021-03-07,20:00:00,6,4,2,FMN GV 05 Lier
60,Mechelsesteenweg 365,2021-03-07,21:00:00,0,0,0,FMN GV 05 Lier
60,Mechelsesteenweg 365,2021-03-07,22:00:00,0,0,0,FMN GV 05 Lier
60,Mechelsesteenweg 365,2021-03-07,23:00:00,2,2,0,FMN GV 05 Lier
60,Mechelsesteenweg 365,2021-03-08,00:00:00,2,2,0,FMN GV 05 Lier
60,Mechelsesteenweg 365,2021-03-08,01:00:00,0,0,0,FMN GV 05 Lier
60,Mechelsesteenweg 365,2021-03-08,02:00:00,0,0,0,FMN GV 05 Lier
60,Mechelsesteenweg 365,2021-03-08,03:00:00,0,0,0,FMN GV 05 Lier
60,Mechelsesteenweg 365,2021-03-08,04:00:00,2,0,2,FMN GV 05 Lier
60,Mechelsesteenweg 365,2021-03-08,05:00:00,4,0,4,FMN GV 05 Lier
60,Mechelsesteenweg 365,2021-03-08,06:00:00,28,12,16,FMN GV 05 Lier
60,Mechelsesteenweg 365,2021-03-08,07:00:00,154,100,54,FMN GV 05 Lier
60,Mechelsesteenweg 365,2021-03-08,08:00:00,76,48,28,FMN GV 05 Lier
60,Mechelsesteenweg 365,2021-03-08,09:00:00,50,24,26,FMN GV 05 Lier
60,Mechelsesteenweg 365,2021-03-08,10:00:00,62,42,20,FMN GV 05 Lier
60,Mechelsesteenweg 365,2021-03-08,11:00:00,86,46,40,FMN GV 05 Lier
60,Mechelsesteenweg 365,2021-03-08,12:00:00,148,82,66,FMN GV 05 Lier
60,Mechelsesteenweg 365,2021-03-08,13:00:00,166,94,72,FMN GV 05 Lier
60,Mechelsesteenweg 365,2021-03-08,14:00:00,238,100,138,FMN GV 05 Lier
60,Mechelsesteenweg 365,2021-03-08,15:00:00,252,128,124,FMN GV 05 Lier
60,Mechelsesteenweg 365,2021-03-08,16:00:00,230,78,152,FMN GV 05 Lier
60,Mechelsesteenweg 365,2021-03-08,17:00:00,130,78,52,FMN GV 05 Lier
60,Mechelsesteenweg 365,2021-03-08,18:00:00,78,30,48,FMN GV 05 Lier
60,Mechelsesteenweg 365,2021-03-08,19:00:00,4,2,2,FMN GV 05 Lier
60,Mechelsesteenweg 365,2021-03-08,20:00:00,8,6,2,FMN GV 05 Lier
60,Mechelsesteenweg 365,2021-03-08,21:00:00,10,4,6,FMN GV 05 Lier
60,Mechelsesteenweg 365,2021-03-08,22:00:00,2,2,0,FMN GV 05 Lier
60,Mechelsesteenweg 365,2021-03-08,23:00:00,4,4,0,FMN GV 05 Lier
60,Mechelsesteenweg 365,2021-03-09,00:00:00,0,0,0,FMN GV 05 Lier
60,Mechelsesteenweg 365,2021-03-09,01:00:00,0,0,0,FMN GV 05 Lier
60,Mechelsesteenweg 365,2021-03-09,02:00:00,0,0,0,FMN GV 05 Lier
60,Mechelsesteenweg 365,2021-03-09,03:00:00,0,0,0,FMN GV 05 Lier
60,Mechelsesteenweg 365,2021-03-09,04:00:00,2,0,2,FMN GV 05 Lier
60,Mechelsesteenweg 365,2021-03-09,05:00:00,4,2,2,FMN GV 05 Lier
60,Mechelsesteenweg 365,2021-03-09,06:00:00,24,8,16,FMN GV 05 Lier
60,Mechelsesteenweg 365,2021-03-09,07:00:00,128,88,40,FMN GV 05 Lier
60,Mechelsesteenweg 365,2021-03-09,08:00:00,82,62,20,FMN GV 05 Lier
60,Mechelsesteenweg 365,2021-03-09,09:00:00,28,24,4,FMN GV 05 Lier
60,Mechelsesteenweg 365,2021-03-09,10:00:00,36,28,8,FMN GV 05 Lier
60,Mechelsesteenweg 365,2021-03-09,11:00:00,50,20,30,FMN GV 05 Lier
60,Mechelsesteenweg 365,2021-03-09,12:00:00,52,32,20,FMN GV 05 Lier
60,Mechelsesteenweg 365,2021-03-09,13:00:00,56,16,40,FMN GV 05 Lier
60,Mechelsesteenweg 365,2021-03-09,14:00:00,42,26,16,FMN GV 05 Lier
60,Mechelsesteenweg 365,2021-03-09,15:00:00,90,42,48,FMN GV 05 Lier
60,Mechelsesteenweg 365,2021-03-09,16:00:00,150,40,110,FMN GV 05 Lier
60,Mechelsesteenweg 365,2021-03-09,17:00:00,78,42,36,FMN GV 05 Lier
60,Mechelsesteenweg 365,2021-03-09,18:00:00,40,24,16,FMN GV 05 Lier
60,Mechelsesteenweg 365,2021-03-09,19:00:00,6,2,4,FMN GV 05 Lier
60,Mechelsesteenweg 365,2021-03-09,20:00:00,2,0,2,FMN GV 05 Lier
60,Mechelsesteenweg 365,2021-03-09,21:00:00,4,0,4,FMN GV 05 Lier
60,Mechelsesteenweg 365,2021-03-09,22:00:00,4,0,4,FMN GV 05 Lier
60,Mechelsesteenweg 365,2021-03-09,23:00:00,4,4,0,FMN GV 05 Lier
60,Mechelsesteenweg 365,2021-03-10,00:00:00,0,0,0,FMN GV 05 Lier
60,Mechelsesteenweg 365,2021-03-10,01:00:00,0,0,0,FMN GV 05 Lier
60,Mechelsesteenweg 365,2021-03-10,02:00:00,0,0,0,FMN GV 05 Lier
60,Mechelsesteenweg 365,2021-03-10,03:00:00,0,0,0,FMN GV 05 Lier
60,Mechelsesteenweg 365,2021-03-10,04:00:00,2,0,2,FMN GV 05 Lier
60,Mechelsesteenweg 365,2021-03-10,05:00:00,4,0,4,FMN GV 05 Lier
60,Mechelsesteenweg 365,2021-03-10,06:00:00,20,12,8,FMN GV 05 Lier
60,Mechelsesteenweg 365,2021-03-10,07:00:00,130,74,56,FMN GV 05 Lier
60,Mechelsesteenweg 365,2021-03-10,08:00:00,92,64,28,FMN GV 05 Lier
60,Mechelsesteenweg 365,2021-03-10,09:00:00,54,28,26,FMN GV 05 Lier
60,Mechelsesteenweg 365,2021-03-10,10:00:00,68,38,30,FMN GV 05 Lier
60,Mechelsesteenweg 365,2021-03-10,11:00:00,122,52,70,FMN GV 05 Lier
60,Mechelsesteenweg 365,2021-03-10,12:00:00,132,42,90,FMN GV 05 Lier
60,Mechelsesteenweg 365,2021-03-10,13:00:00,88,64,24,FMN GV 05 Lier
60,Mechelsesteenweg 365,2021-03-10,14:00:00,74,34,40,FMN GV 05 Lier
60,Mechelsesteenweg 365,2021-03-10,15:00:00,50,30,20,FMN GV 05 Lier
60,Mechelsesteenweg 365,2021-03-10,16:00:00,84,54,30,FMN GV 05 Lier
60,Mechelsesteenweg 365,2021-03-10,17:00:00,68,44,24,FMN GV 05 Lier
60,Mechelsesteenweg 365,2021-03-10,18:00:00,16,6,10,FMN GV 05 Lier
60,Mechelsesteenweg 365,2021-03-10,19:00:00,6,0,6,FMN GV 05 Lier
60,Mechelsesteenweg 365,2021-03-10,20:00:00,6,2,4,FMN GV 05 Lier
60,Mechelsesteenweg 365,2021-03-10,21:00:00,0,0,0,FMN GV 05 Lier
60,Mechelsesteenweg 365,2021-03-10,22:00:00,0,0,0,FMN GV 05 Lier
60,Mechelsesteenweg 365,2021-03-10,23:00:00,2,2,0,FMN GV 05 Lier
60,Mechelsesteenweg 365,2021-03-11,00:00:00,0,0,0,FMN GV 05 Lier
60,Mechelsesteenweg 365,2021-03-11,01:00:00,0,0,0,FMN GV 05 Lier
60,Mechelsesteenweg 365,2021-03-11,02:00:00,0,0,0,FMN GV 05 Lier
60,Mechelsesteenweg 365,2021-03-11,03:00:00,2,0,2,FMN GV 05 Lier
60,Mechelsesteenweg 365,2021-03-11,04:00:00,0,0,0,FMN GV 05 Lier
60,Mechelsesteenweg 365,2021-03-11,05:00:00,4,4,0,FMN GV 05 Lier
60,Mechelsesteenweg 365,2021-03-11,06:00:00,10,4,6,FMN GV 05 Lier
60,Mechelsesteenweg 365,2021-03-11,07:00:00,60,42,18,FMN GV 05 Lier
60,Mechelsesteenweg 365,2021-03-11,08:00:00,64,44,20,FMN GV 05 Lier
60,Mechelsesteenweg 365,2021-03-11,09:00:00,8,4,4,FMN GV 05 Lier
60,Mechelsesteenweg 365,2021-03-11,10:00:00,10,10,0,FMN GV 05 Lier
60,Mechelsesteenweg 365,2021-03-11,11:00:00,12,8,4,FMN GV 05 Lier
60,Mechelsesteenweg 365,2021-03-11,12:00:00,14,10,4,FMN GV 05 Lier
60,Mechelsesteenweg 365,2021-03-11,13:00:00,16,6,10,FMN GV 05 Lier
60,Mechelsesteenweg 365,2021-03-11,14:00:00,14,6,8,FMN GV 05 Lier
60,Mechelsesteenweg 365,2021-03-11,15:00:00,26,6,20,FMN GV 05 Lier
60,Mechelsesteenweg 365,2021-03-11,16:00:00,62,24,38,FMN GV 05 Lier
60,Mechelsesteenweg 365,2021-03-11,17:00:00,42,34,8,FMN GV 05 Lier
60,Mechelsesteenweg 365,2021-03-11,18:00:00,16,6,10,FMN GV 05 Lier
60,Mechelsesteenweg 365,2021-03-11,19:00:00,4,2,2,FMN GV 05 Lier
60,Mechelsesteenweg 365,2021-03-11,20:00:00,12,8,4,FMN GV 05 Lier
60,Mechelsesteenweg 365,2021-03-11,21:00:00,2,0,2,FMN GV 05 Lier
60,Mechelsesteenweg 365,2021-03-11,22:00:00,0,0,0,FMN GV 05 Lier
60,Mechelsesteenweg 365,2021-03-11,23:00:00,4,4,0,FMN GV 05 Lier
60,Mechelsesteenweg 365,2021-03-12,00:00:00,0,0,0,FMN GV 05 Lier
60,Mechelsesteenweg 365,2021-03-12,01:00:00,0,0,0,FMN GV 05 Lier
60,Mechelsesteenweg 365,2021-03-12,02:00:00,0,0,0,FMN GV 05 Lier
60,Mechelsesteenweg 365,2021-03-12,03:00:00,2,0,2,FMN GV 05 Lier
60,Mechelsesteenweg 365,2021-03-12,04:00:00,0,0,0,FMN GV 05 Lier
60,Mechelsesteenweg 365,2021-03-12,05:00:00,4,2,2,FMN GV 05 Lier
60,Mechelsesteenweg 365,2021-03-12,06:00:00,12,6,6,FMN GV 05 Lier
60,Mechelsesteenweg 365,2021-03-12,07:00:00,110,78,32,FMN GV 05 Lier
60,Mechelsesteenweg 365,2021-03-12,08:00:00,66,42,24,FMN GV 05 Lier
60,Mechelsesteenweg 365,2021-03-12,09:00:00,28,10,18,FMN GV 05 Lier
60,Mechelsesteenweg 365,2021-03-12,10:00:00,66,42,24,FMN GV 05 Lier
60,Mechelsesteenweg 365,2021-03-12,11:00:00,42,24,18,FMN GV 05 Lier
60,Mechelsesteenweg 365,2021-03-12,12:00:00,34,14,20,FMN GV 05 Lier
60,Mechelsesteenweg 365,2021-03-12,13:00:00,34,18,16,FMN GV 05 Lier
60,Mechelsesteenweg 365,2021-03-12,14:00:00,26,16,10,FMN GV 05 Lier
60,Mechelsesteenweg 365,2021-03-12,15:00:00,58,30,28,FMN GV 05 Lier
60,Mechelsesteenweg 365,2021-03-12,16:00:00,86,22,64,FMN GV 05 Lier
60,Mechelsesteenweg 365,2021-03-12,17:00:00,66,48,18,FMN GV 05 Lier
60,Mechelsesteenweg 365,2021-03-12,18:00:00,24,16,8,FMN GV 05 Lier
60,Mechelsesteenweg 365,2021-03-12,19:00:00,10,8,2,FMN GV 05 Lier
60,Mechelsesteenweg 365,2021-03-12,20:00:00,10,4,6,FMN GV 05 Lier
60,Mechelsesteenweg 365,2021-03-12,21:00:00,0,0,0,FMN GV 05 Lier
60,Mechelsesteenweg 365,2021-03-12,22:00:00,0,0,0,FMN GV 05 Lier
60,Mechelsesteenweg 365,2021-03-12,23:00:00,4,2,2,FMN GV 05 Lier
60,Mechelsesteenweg 365,2021-03-13,00:00:00,0,0,0,FMN GV 05 Lier
60,Mechelsesteenweg 365,2021-03-13,01:00:00,0,0,0,FMN GV 05 Lier
60,Mechelsesteenweg 365,2021-03-13,02:00:00,0,0,0,FMN GV 05 Lier
60,Mechelsesteenweg 365,2021-03-13,03:00:00,0,0,0,FMN GV 05 Lier
60,Mechelsesteenweg 365,2021-03-13,04:00:00,0,0,0,FMN GV 05 Lier
60,Mechelsesteenweg 365,2021-03-13,05:00:00,0,0,0,FMN GV 05 Lier
60,Mechelsesteenweg 365,2021-03-13,06:00:00,2,0,2,FMN GV 05 Lier
60,Mechelsesteenweg 365,2021-03-13,07:00:00,4,2,2,FMN GV 05 Lier
60,Mechelsesteenweg 365,2021-03-13,08:00:00,24,14,10,FMN GV 05 Lier
60,Mechelsesteenweg 365,2021-03-13,09:00:00,26,16,10,FMN GV 05 Lier
60,Mechelsesteenweg 365,2021-03-13,10:00:00,66,26,40,FMN GV 05 Lier
60,Mechelsesteenweg 365,2021-03-13,11:00:00,46,30,16,FMN GV 05 Lier
60,Mechelsesteenweg 365,2021-03-13,12:00:00,28,18,10,FMN GV 05 Lier
60,Mechelsesteenweg 365,2021-03-13,13:00:00,24,12,12,FMN GV 05 Lier
60,Mechelsesteenweg 365,2021-03-13,14:00:00,14,10,4,FMN GV 05 Lier
60,Mechelsesteenweg 365,2021-03-13,15:00:00,18,10,8,FMN GV 05 Lier
60,Mechelsesteenweg 365,2021-03-13,16:00:00,16,12,4,FMN GV 05 Lier
60,Mechelsesteenweg 365,2021-03-13,17:00:00,16,6,10,FMN GV 05 Lier
60,Mechelsesteenweg 365,2021-03-13,18:00:00,12,2,10,FMN GV 05 Lier
60,Mechelsesteenweg 365,2021-03-13,19:00:00,0,0,0,FMN GV 05 Lier
60,Mechelsesteenweg 365,2021-03-13,20:00:00,2,0,2,FMN GV 05 Lier
60,Mechelsesteenweg 365,2021-03-13,21:00:00,0,0,0,FMN GV 05 Lier
60,Mechelsesteenweg 365,2021-03-13,22:00:00,0,0,0,FMN GV 05 Lier
60,Mechelsesteenweg 365,2021-03-13,23:00:00,0,0,0,FMN GV 05 Lier
60,Mechelsesteenweg 365,2021-03-14,00:00:00,0,0,0,FMN GV 05 Lier
60,Mechelsesteenweg 365,2021-03-14,01:00:00,4,2,2,FMN GV 05 Lier
60,Mechelsesteenweg 365,2021-03-14,02:00:00,0,0,0,FMN GV 05 Lier
60,Mechelsesteenweg 365,2021-03-14,03:00:00,0,0,0,FMN GV 05 Lier
60,Mechelsesteenweg 365,2021-03-14,04:00:00,0,0,0,FMN GV 05 Lier
60,Mechelsesteenweg 365,2021-03-14,05:00:00,2,0,2,FMN GV 05 Lier
60,Mechelsesteenweg 365,2021-03-14,06:00:00,0,0,0,FMN GV 05 Lier
60,Mechelsesteenweg 365,2021-03-14,07:00:00,4,2,2,FMN GV 05 Lier
60,Mechelsesteenweg 365,2021-03-14,08:00:00,12,8,4,FMN GV 05 Lier
60,Mechelsesteenweg 365,2021-03-14,09:00:00,56,20,36,FMN GV 05 Lier
60,Mechelsesteenweg 365,2021-03-14,10:00:00,204,90,114,FMN GV 05 Lier
60,Mechelsesteenweg 365,2021-03-14,11:00:00,172,66,106,FMN GV 05 Lier
60,Mechelsesteenweg 365,2021-03-14,12:00:00,100,42,58,FMN GV 05 Lier
60,Mechelsesteenweg 365,2021-03-14,13:00:00,108,68,40,FMN GV 05 Lier
60,Mechelsesteenweg 365,2021-03-14,14:00:00,158,122,36,FMN GV 05 Lier
60,Mechelsesteenweg 365,2021-03-14,15:00:00,150,62,88,FMN GV 05 Lier
60,Mechelsesteenweg 365,2021-03-14,16:00:00,104,58,46,FMN GV 05 Lier
60,Mechelsesteenweg 365,2021-03-14,17:00:00,30,14,16,FMN GV 05 Lier
60,Mechelsesteenweg 365,2021-03-14,18:00:00,12,8,4,FMN GV 05 Lier
60,Mechelsesteenweg 365,2021-03-14,19:00:00,0,0,0,FMN GV 05 Lier
60,Mechelsesteenweg 365,2021-03-14,20:00:00,4,0,4,FMN GV 05 Lier
60,Mechelsesteenweg 365,2021-03-14,21:00:00,0,0,0,FMN GV 05 Lier
60,Mechelsesteenweg 365,2021-03-14,22:00:00,0,0,0,FMN GV 05 Lier
60,Mechelsesteenweg 365,2021-03-14,23:00:00,0,0,0,FMN GV 05 Lier
60,Mechelsesteenweg 365,2021-03-15,00:00:00,0,0,0,FMN GV 05 Lier
60,Mechelsesteenweg 365,2021-03-15,01:00:00,0,0,0,FMN GV 05 Lier
60,Mechelsesteenweg 365,2021-03-15,02:00:00,0,0,0,FMN GV 05 Lier
60,Mechelsesteenweg 365,2021-03-15,03:00:00,2,0,2,FMN GV 05 Lier
60,Mechelsesteenweg 365,2021-03-15,04:00:00,0,0,0,FMN GV 05 Lier
60,Mechelsesteenweg 365,2021-03-15,05:00:00,0,0,0,FMN GV 05 Lier
60,Mechelsesteenweg 365,2021-03-15,06:00:00,14,4,10,FMN GV 05 Lier
60,Mechelsesteenweg 365,2021-03-15,07:00:00,134,96,38,FMN GV 05 Lier
60,Mechelsesteenweg 365,2021-03-15,08:00:00,88,70,18,FMN GV 05 Lier
60,Mechelsesteenweg 365,2021-03-15,09:00:00,22,18,4,FMN GV 05 Lier
60,Mechelsesteenweg 365,2021-03-15,10:00:00,18,12,6,FMN GV 05 Lier
60,Mechelsesteenweg 365,2021-03-15,11:00:00,16,8,8,FMN GV 05 Lier
60,Mechelsesteenweg 365,2021-03-15,12:00:00,44,8,36,FMN GV 05 Lier
60,Mechelsesteenweg 365,2021-03-15,13:00:00,50,22,28,FMN GV 05 Lier
60,Mechelsesteenweg 365,2021-03-15,14:00:00,38,18,20,FMN GV 05 Lier
60,Mechelsesteenweg 365,2021-03-15,15:00:00,64,22,42,FMN GV 05 Lier
60,Mechelsesteenweg 365,2021-03-15,16:00:00,144,32,112,FMN GV 05 Lier
60,Mechelsesteenweg 365,2021-03-15,17:00:00,66,42,24,FMN GV 05 Lier
60,Mechelsesteenweg 365,2021-03-15,18:00:00,28,16,12,FMN GV 05 Lier
60,Mechelsesteenweg 365,2021-03-15,19:00:00,6,4,2,FMN GV 05 Lier
60,Mechelsesteenweg 365,2021-03-15,20:00:00,2,2,0,FMN GV 05 Lier
60,Mechelsesteenweg 365,2021-03-15,21:00:00,4,0,4,FMN GV 05 Lier
60,Mechelsesteenweg 365,2021-03-15,22:00:00,6,6,0,FMN GV 05 Lier
60,Mechelsesteenweg 365,2021-03-15,23:00:00,0,0,0,FMN GV 05 Lier
60,Mechelsesteenweg 365,2021-03-16,00:00:00,0,0,0,FMN GV 05 Lier
60,Mechelsesteenweg 365,2021-03-16,01:00:00,0,0,0,FMN GV 05 Lier
60,Mechelsesteenweg 365,2021-03-16,02:00:00,0,0,0,FMN GV 05 Lier
60,Mechelsesteenweg 365,2021-03-16,03:00:00,2,0,2,FMN GV 05 Lier
60,Mechelsesteenweg 365,2021-03-16,04:00:00,2,0,2,FMN GV 05 Lier
60,Mechelsesteenweg 365,2021-03-16,05:00:00,2,2,0,FMN GV 05 Lier
60,Mechelsesteenweg 365,2021-03-16,06:00:00,20,12,8,FMN GV 05 Lier
60,Mechelsesteenweg 365,2021-03-16,07:00:00,118,78,40,FMN GV 05 Lier
60,Mechelsesteenweg 365,2021-03-16,08:00:00,88,58,30,FMN GV 05 Lier
60,Mechelsesteenweg 365,2021-03-16,09:00:00,18,10,8,FMN GV 05 Lier
60,Mechelsesteenweg 365,2021-03-16,10:00:00,14,12,2,FMN GV 05 Lier
60,Mechelsesteenweg 365,2021-03-16,11:00:00,14,6,8,FMN GV 05 Lier
60,Mechelsesteenweg 365,2021-03-16,12:00:00,34,20,14,FMN GV 05 Lier
60,Mechelsesteenweg 365,2021-03-16,13:00:00,22,8,14,FMN GV 05 Lier
60,Mechelsesteenweg 365,2021-03-16,14:00:00,20,6,14,FMN GV 05 Lier
60,Mechelsesteenweg 365,2021-03-16,15:00:00,60,22,38,FMN GV 05 Lier
60,Mechelsesteenweg 365,2021-03-16,16:00:00,106,36,70,FMN GV 05 Lier
60,Mechelsesteenweg 365,2021-03-16,17:00:00,48,30,18,FMN GV 05 Lier
60,Mechelsesteenweg 365,2021-03-16,18:00:00,28,16,12,FMN GV 05 Lier
60,Mechelsesteenweg 365,2021-03-16,19:00:00,6,4,2,FMN GV 05 Lier
60,Mechelsesteenweg 365,2021-03-16,20:00:00,2,2,0,FMN GV 05 Lier
60,Mechelsesteenweg 365,2021-03-16,21:00:00,2,2,0,FMN GV 05 Lier
60,Mechelsesteenweg 365,2021-03-16,22:00:00,2,2,0,FMN GV 05 Lier
60,Mechelsesteenweg 365,2021-03-16,23:00:00,0,0,0,FMN GV 05 Lier
60,Mechelsesteenweg 365,2021-03-17,00:00:00,0,0,0,FMN GV 05 Lier
60,Mechelsesteenweg 365,2021-03-17,01:00:00,0,0,0,FMN GV 05 Lier
60,Mechelsesteenweg 365,2021-03-17,02:00:00,0,0,0,FMN GV 05 Lier
60,Mechelsesteenweg 365,2021-03-17,03:00:00,2,0,2,FMN GV 05 Lier
60,Mechelsesteenweg 365,2021-03-17,04:00:00,2,0,2,FMN GV 05 Lier
60,Mechelsesteenweg 365,2021-03-17,05:00:00,6,2,4,FMN GV 05 Lier
60,Mechelsesteenweg 365,2021-03-17,06:00:00,22,8,14,FMN GV 05 Lier
60,Mechelsesteenweg 365,2021-03-17,07:00:00,134,84,50,FMN GV 05 Lier
60,Mechelsesteenweg 365,2021-03-17,08:00:00,88,70,18,FMN GV 05 Lier
60,Mechelsesteenweg 365,2021-03-17,09:00:00,56,38,18,FMN GV 05 Lier
60,Mechelsesteenweg 365,2021-03-17,10:00:00,46,22,24,FMN GV 05 Lier
60,Mechelsesteenweg 365,2021-03-17,11:00:00,56,26,30,FMN GV 05 Lier
60,Mechelsesteenweg 365,2021-03-17,12:00:00,178,22,156,FMN GV 05 Lier
60,Mechelsesteenweg 365,2021-03-17,13:00:00,62,22,40,FMN GV 05 Lier
60,Mechelsesteenweg 365,2021-03-17,14:00:00,38,16,22,FMN GV 05 Lier
60,Mechelsesteenweg 365,2021-03-17,15:00:00,88,54,34,FMN GV 05 Lier
60,Mechelsesteenweg 365,2021-03-17,16:00:00,116,68,48,FMN GV 05 Lier
60,Mechelsesteenweg 365,2021-03-17,17:00:00,88,50,38,FMN GV 05 Lier
60,Mechelsesteenweg 365,2021-03-17,18:00:00,26,14,12,FMN GV 05 Lier
60,Mechelsesteenweg 365,2021-03-17,19:00:00,6,2,4,FMN GV 05 Lier
60,Mechelsesteenweg 365,2021-03-17,20:00:00,10,10,0,FMN GV 05 Lier
60,Mechelsesteenweg 365,2021-03-17,21:00:00,8,6,2,FMN GV 05 Lier
60,Mechelsesteenweg 365,2021-03-17,22:00:00,4,4,0,FMN GV 05 Lier
60,Mechelsesteenweg 365,2021-03-17,23:00:00,2,2,0,FMN GV 05 Lier
60,Mechelsesteenweg 365,2021-03-18,00:00:00,0,0,0,FMN GV 05 Lier
60,Mechelsesteenweg 365,2021-03-18,01:00:00,0,0,0,FMN GV 05 Lier
60,Mechelsesteenweg 365,2021-03-18,02:00:00,0,0,0,FMN GV 05 Lier
60,Mechelsesteenweg 365,2021-03-18,03:00:00,2,0,2,FMN GV 05 Lier
60,Mechelsesteenweg 365,2021-03-18,04:00:00,2,0,2,FMN GV 05 Lier
60,Mechelsesteenweg 365,2021-03-18,05:00:00,2,0,2,FMN GV 05 Lier
60,Mechelsesteenweg 365,2021-03-18,06:00:00,14,8,6,FMN GV 05 Lier
60,Mechelsesteenweg 365,2021-03-18,07:00:00,120,70,50,FMN GV 05 Lier
60,Mechelsesteenweg 365,2021-03-18,08:00:00,62,42,20,FMN GV 05 Lier
60,Mechelsesteenweg 365,2021-03-18,09:00:00,36,16,20,FMN GV 05 Lier
60,Mechelsesteenweg 365,2021-03-18,10:00:00,46,34,12,FMN GV 05 Lier
60,Mechelsesteenweg 365,2021-03-18,11:00:00,42,26,16,FMN GV 05 Lier
60,Mechelsesteenweg 365,2021-03-18,12:00:00,44,18,26,FMN GV 05 Lier
60,Mechelsesteenweg 365,2021-03-18,13:00:00,62,20,42,FMN GV 05 Lier
60,Mechelsesteenweg 365,2021-03-18,14:00:00,82,50,32,FMN GV 05 Lier
60,Mechelsesteenweg 365,2021-03-18,15:00:00,82,38,44,FMN GV 05 Lier
60,Mechelsesteenweg 365,2021-03-18,16:00:00,124,34,90,FMN GV 05 Lier
60,Mechelsesteenweg 365,2021-03-18,17:00:00,52,40,12,FMN GV 05 Lier
60,Mechelsesteenweg 365,2021-03-18,18:00:00,36,24,12,FMN GV 05 Lier
60,Mechelsesteenweg 365,2021-03-18,19:00:00,18,8,10,FMN GV 05 Lier
60,Mechelsesteenweg 365,2021-03-18,20:00:00,2,0,2,FMN GV 05 Lier
60,Mechelsesteenweg 365,2021-03-18,21:00:00,2,0,2,FMN GV 05 Lier
60,Mechelsesteenweg 365,2021-03-18,22:00:00,2,2,0,FMN GV 05 Lier
60,Mechelsesteenweg 365,2021-03-18,23:00:00,0,0,0,FMN GV 05 Lier
60,Mechelsesteenweg 365,2021-03-19,00:00:00,0,0,0,FMN GV 05 Lier
60,Mechelsesteenweg 365,2021-03-19,01:00:00,0,0,0,FMN GV 05 Lier
60,Mechelsesteenweg 365,2021-03-19,02:00:00,0,0,0,FMN GV 05 Lier
60,Mechelsesteenweg 365,2021-03-19,03:00:00,0,0,0,FMN GV 05 Lier
60,Mechelsesteenweg 365,2021-03-19,04:00:00,4,0,4,FMN GV 05 Lier
60,Mechelsesteenweg 365,2021-03-19,05:00:00,4,0,4,FMN GV 05 Lier
60,Mechelsesteenweg 365,2021-03-19,06:00:00,0,0,0,FMN GV 05 Lier
60,Mechelsesteenweg 365,2021-03-19,07:00:00,118,86,32,FMN GV 05 Lier
60,Mechelsesteenweg 365,2021-03-19,08:00:00,110,92,18,FMN GV 05 Lier
60,Mechelsesteenweg 365,2021-03-19,09:00:00,52,28,24,FMN GV 05 Lier
60,Mechelsesteenweg 365,2021-03-19,10:00:00,102,56,46,FMN GV 05 Lier
60,Mechelsesteenweg 365,2021-03-19,11:00:00,90,50,40,FMN GV 05 Lier
60,Mechelsesteenweg 365,2021-03-19,12:00:00,124,50,74,FMN GV 05 Lier
60,Mechelsesteenweg 365,2021-03-19,13:00:00,166,86,80,FMN GV 05 Lier
60,Mechelsesteenweg 365,2021-03-19,14:00:00,198,90,108,FMN GV 05 Lier
60,Mechelsesteenweg 365,2021-03-19,15:00:00,198,66,132,FMN GV 05 Lier
60,Mechelsesteenweg 365,2021-03-19,16:00:00,272,74,198,FMN GV 05 Lier
60,Mechelsesteenweg 365,2021-03-19,17:00:00,130,74,56,FMN GV 05 Lier
60,Mechelsesteenweg 365,2021-03-19,18:00:00,60,28,32,FMN GV 05 Lier
60,Mechelsesteenweg 365,2021-03-19,19:00:00,6,4,2,FMN GV 05 Lier
60,Mechelsesteenweg 365,2021-03-19,20:00:00,12,12,0,FMN GV 05 Lier
60,Mechelsesteenweg 365,2021-03-19,21:00:00,4,2,2,FMN GV 05 Lier
60,Mechelsesteenweg 365,2021-03-19,22:00:00,6,6,0,FMN GV 05 Lier
60,Mechelsesteenweg 365,2021-03-19,23:00:00,8,2,6,FMN GV 05 Lier
60,Mechelsesteenweg 365,2021-03-20,00:00:00,0,0,0,FMN GV 05 Lier
60,Mechelsesteenweg 365,2021-03-20,01:00:00,0,0,0,FMN GV 05 Lier
60,Mechelsesteenweg 365,2021-03-20,02:00:00,0,0,0,FMN GV 05 Lier
60,Mechelsesteenweg 365,2021-03-20,03:00:00,2,0,2,FMN GV 05 Lier
60,Mechelsesteenweg 365,2021-03-20,04:00:00,0,0,0,FMN GV 05 Lier
60,Mechelsesteenweg 365,2021-03-20,05:00:00,2,0,2,FMN GV 05 Lier
60,Mechelsesteenweg 365,2021-03-20,06:00:00,0,0,0,FMN GV 05 Lier
60,Mechelsesteenweg 365,2021-03-20,07:00:00,16,2,14,FMN GV 05 Lier
60,Mechelsesteenweg 365,2021-03-20,08:00:00,44,32,12,FMN GV 05 Lier
60,Mechelsesteenweg 365,2021-03-20,09:00:00,94,56,38,FMN GV 05 Lier
60,Mechelsesteenweg 365,2021-03-20,10:00:00,134,98,36,FMN GV 05 Lier
60,Mechelsesteenweg 365,2021-03-20,11:00:00,300,142,158,FMN GV 05 Lier
60,Mechelsesteenweg 365,2021-03-20,12:00:00,238,90,148,FMN GV 05 Lier
60,Mechelsesteenweg 365,2021-03-20,13:00:00,310,170,140,FMN GV 05 Lier
60,Mechelsesteenweg 365,2021-03-20,14:00:00,386,166,220,FMN GV 05 Lier
60,Mechelsesteenweg 365,2021-03-20,15:00:00,342,142,200,FMN GV 05 Lier
60,Mechelsesteenweg 365,2021-03-20,16:00:00,196,86,110,FMN GV 05 Lier
60,Mechelsesteenweg 365,2021-03-20,17:00:00,146,64,82,FMN GV 05 Lier
60,Mechelsesteenweg 365,2021-03-20,18:00:00,28,20,8,FMN GV 05 Lier
60,Mechelsesteenweg 365,2021-03-20,19:00:00,20,14,6,FMN GV 05 Lier
60,Mechelsesteenweg 365,2021-03-20,20:00:00,4,4,0,FMN GV 05 Lier
60,Mechelsesteenweg 365,2021-03-20,21:00:00,6,4,2,FMN GV 05 Lier
60,Mechelsesteenweg 365,2021-03-20,22:00:00,2,2,0,FMN GV 05 Lier
60,Mechelsesteenweg 365,2021-03-20,23:00:00,14,10,4,FMN GV 05 Lier
60,Mechelsesteenweg 365,2021-03-21,00:00:00,0,0,0,FMN GV 05 Lier
60,Mechelsesteenweg 365,2021-03-21,01:00:00,0,0,0,FMN GV 05 Lier
60,Mechelsesteenweg 365,2021-03-21,02:00:00,0,0,0,FMN GV 05 Lier
60,Mechelsesteenweg 365,2021-03-21,03:00:00,0,0,0,FMN GV 05 Lier
60,Mechelsesteenweg 365,2021-03-21,04:00:00,0,0,0,FMN GV 05 Lier
60,Mechelsesteenweg 365,2021-03-21,05:00:00,2,0,2,FMN GV 05 Lier
60,Mechelsesteenweg 365,2021-03-21,06:00:00,6,6,0,FMN GV 05 Lier
60,Mechelsesteenweg 365,2021-03-21,07:00:00,10,0,10,FMN GV 05 Lier
60,Mechelsesteenweg 365,2021-03-21,08:00:00,36,14,22,FMN GV 05 Lier
60,Mechelsesteenweg 365,2021-03-21,09:00:00,118,42,76,FMN GV 05 Lier
60,Mechelsesteenweg 365,2021-03-21,10:00:00,226,94,132,FMN GV 05 Lier
60,Mechelsesteenweg 365,2021-03-21,11:00:00,284,140,144,FMN GV 05 Lier
60,Mechelsesteenweg 365,2021-03-21,12:00:00,184,102,82,FMN GV 05 Lier
60,Mechelsesteenweg 365,2021-03-21,13:00:00,162,86,76,FMN GV 05 Lier
60,Mechelsesteenweg 365,2021-03-21,14:00:00,268,142,126,FMN GV 05 Lier
60,Mechelsesteenweg 365,2021-03-21,15:00:00,182,90,92,FMN GV 05 Lier
60,Mechelsesteenweg 365,2021-03-21,16:00:00,150,64,86,FMN GV 05 Lier
60,Mechelsesteenweg 365,2021-03-21,17:00:00,78,28,50,FMN GV 05 Lier
60,Mechelsesteenweg 365,2021-03-21,18:00:00,8,4,4,FMN GV 05 Lier
60,Mechelsesteenweg 365,2021-03-21,19:00:00,10,4,6,FMN GV 05 Lier
60,Mechelsesteenweg 365,2021-03-21,20:00:00,10,8,2,FMN GV 05 Lier
60,Mechelsesteenweg 365,2021-03-21,21:00:00,0,0,0,FMN GV 05 Lier
60,Mechelsesteenweg 365,2021-03-21,22:00:00,0,0,0,FMN GV 05 Lier
60,Mechelsesteenweg 365,2021-03-21,23:00:00,0,0,0,FMN GV 05 Lier
60,Mechelsesteenweg 365,2021-03-22,00:00:00,0,0,0,FMN GV 05 Lier
60,Mechelsesteenweg 365,2021-03-22,01:00:00,0,0,0,FMN GV 05 Lier
60,Mechelsesteenweg 365,2021-03-22,02:00:00,0,0,0,FMN GV 05 Lier
60,Mechelsesteenweg 365,2021-03-22,03:00:00,0,0,0,FMN GV 05 Lier
60,Mechelsesteenweg 365,2021-03-22,04:00:00,4,0,4,FMN GV 05 Lier
60,Mechelsesteenweg 365,2021-03-22,05:00:00,12,2,10,FMN GV 05 Lier
60,Mechelsesteenweg 365,2021-03-22,06:00:00,28,18,10,FMN GV 05 Lier
60,Mechelsesteenweg 365,2021-03-22,07:00:00,130,74,56,FMN GV 05 Lier
60,Mechelsesteenweg 365,2021-03-22,08:00:00,78,42,36,FMN GV 05 Lier
60,Mechelsesteenweg 365,2021-03-22,09:00:00,40,18,22,FMN GV 05 Lier
60,Mechelsesteenweg 365,2021-03-22,10:00:00,52,20,32,FMN GV 05 Lier
60,Mechelsesteenweg 365,2021-03-22,11:00:00,56,18,38,FMN GV 05 Lier
60,Mechelsesteenweg 365,2021-03-22,12:00:00,76,26,50,FMN GV 05 Lier
60,Mechelsesteenweg 365,2021-03-22,13:00:00,88,40,48,FMN GV 05 Lier
60,Mechelsesteenweg 365,2021-03-22,14:00:00,116,60,56,FMN GV 05 Lier
60,Mechelsesteenweg 365,2021-03-22,15:00:00,132,66,66,FMN GV 05 Lier
60,Mechelsesteenweg 365,2021-03-22,16:00:00,128,62,66,FMN GV 05 Lier
60,Mechelsesteenweg 365,2021-03-22,17:00:00,136,80,56,FMN GV 05 Lier
60,Mechelsesteenweg 365,2021-03-22,18:00:00,48,28,20,FMN GV 05 Lier
60,Mechelsesteenweg 365,2021-03-22,19:00:00,18,4,14,FMN GV 05 Lier
60,Mechelsesteenweg 365,2021-03-22,20:00:00,10,8,2,FMN GV 05 Lier
60,Mechelsesteenweg 365,2021-03-22,21:00:00,0,0,0,FMN GV 05 Lier
60,Mechelsesteenweg 365,2021-03-22,22:00:00,6,6,0,FMN GV 05 Lier
60,Mechelsesteenweg 365,2021-03-22,23:00:00,0,0,0,FMN GV 05 Lier
60,Mechelsesteenweg 365,2021-03-23,00:00:00,0,0,0,FMN GV 05 Lier
60,Mechelsesteenweg 365,2021-03-23,01:00:00,0,0,0,FMN GV 05 Lier
60,Mechelsesteenweg 365,2021-03-23,02:00:00,0,0,0,FMN GV 05 Lier
60,Mechelsesteenweg 365,2021-03-23,03:00:00,2,0,2,FMN GV 05 Lier
60,Mechelsesteenweg 365,2021-03-23,04:00:00,4,0,4,FMN GV 05 Lier
60,Mechelsesteenweg 365,2021-03-23,05:00:00,12,4,8,FMN GV 05 Lier
60,Mechelsesteenweg 365,2021-03-23,06:00:00,40,18,22,FMN GV 05 Lier
60,Mechelsesteenweg 365,2021-03-23,07:00:00,162,90,72,FMN GV 05 Lier
60,Mechelsesteenweg 365,2021-03-23,08:00:00,118,80,38,FMN GV 05 Lier
60,Mechelsesteenweg 365,2021-03-23,09:00:00,56,46,10,FMN GV 05 Lier
60,Mechelsesteenweg 365,2021-03-23,10:00:00,104,72,32,FMN GV 05 Lier
60,Mechelsesteenweg 365,2021-03-23,11:00:00,122,62,60,FMN GV 05 Lier
60,Mechelsesteenweg 365,2021-03-23,12:00:00,218,84,134,FMN GV 05 Lier
60,Mechelsesteenweg 365,2021-03-23,13:00:00,272,138,134,FMN GV 05 Lier
60,Mechelsesteenweg 365,2021-03-23,14:00:00,312,196,116,FMN GV 05 Lier
60,Mechelsesteenweg 365,2021-03-23,15:00:00,242,120,122,FMN GV 05 Lier
60,Mechelsesteenweg 365,2021-03-23,16:00:00,202,106,96,FMN GV 05 Lier
60,Mechelsesteenweg 365,2021-03-23,17:00:00,182,80,102,FMN GV 05 Lier
60,Mechelsesteenweg 365,2021-03-23,18:00:00,92,52,40,FMN GV 05 Lier
60,Mechelsesteenweg 365,2021-03-23,19:00:00,36,16,20,FMN GV 05 Lier
60,Mechelsesteenweg 365,2021-03-23,20:00:00,24,10,14,FMN GV 05 Lier
60,Mechelsesteenweg 365,2021-03-23,21:00:00,8,6,2,FMN GV 05 Lier
60,Mechelsesteenweg 365,2021-03-23,22:00:00,6,4,2,FMN GV 05 Lier
60,Mechelsesteenweg 365,2021-03-23,23:00:00,2,2,0,FMN GV 05 Lier
60,Mechelsesteenweg 365,2021-03-24,00:00:00,0,0,0,FMN GV 05 Lier
60,Mechelsesteenweg 365,2021-03-24,01:00:00,0,0,0,FMN GV 05 Lier
60,Mechelsesteenweg 365,2021-03-24,02:00:00,0,0,0,FMN GV 05 Lier
60,Mechelsesteenweg 365,2021-03-24,03:00:00,2,0,2,FMN GV 05 Lier
60,Mechelsesteenweg 365,2021-03-24,04:00:00,2,0,2,FMN GV 05 Lier
60,Mechelsesteenweg 365,2021-03-24,05:00:00,8,0,8,FMN GV 05 Lier
60,Mechelsesteenweg 365,2021-03-24,06:00:00,28,12,16,FMN GV 05 Lier
60,Mechelsesteenweg 365,2021-03-24,07:00:00,176,116,60,FMN GV 05 Lier
60,Mechelsesteenweg 365,2021-03-24,08:00:00,92,58,34,FMN GV 05 Lier
60,Mechelsesteenweg 365,2021-03-24,09:00:00,86,46,40,FMN GV 05 Lier
60,Mechelsesteenweg 365,2021-03-24,10:00:00,128,62,66,FMN GV 05 Lier
60,Mechelsesteenweg 365,2021-03-24,11:00:00,182,96,86,FMN GV 05 Lier
60,Mechelsesteenweg 365,2021-03-24,12:00:00,214,102,112,FMN GV 05 Lier
60,Mechelsesteenweg 365,2021-03-24,13:00:00,252,162,90,FMN GV 05 Lier
60,Mechelsesteenweg 365,2021-03-24,14:00:00,442,248,194,FMN GV 05 Lier
60,Mechelsesteenweg 365,2021-03-24,15:00:00,382,194,188,FMN GV 05 Lier
60,Mechelsesteenweg 365,2021-03-24,16:00:00,252,136,116,FMN GV 05 Lier
60,Mechelsesteenweg 365,2021-03-24,17:00:00,212,118,94,FMN GV 05 Lier
60,Mechelsesteenweg 365,2021-03-24,18:00:00,142,70,72,FMN GV 05 Lier
60,Mechelsesteenweg 365,2021-03-24,19:00:00,30,12,18,FMN GV 05 Lier
60,Mechelsesteenweg 365,2021-03-24,20:00:00,18,8,10,FMN GV 05 Lier
60,Mechelsesteenweg 365,2021-03-24,21:00:00,10,6,4,FMN GV 05 Lier
60,Mechelsesteenweg 365,2021-03-24,22:00:00,4,4,0,FMN GV 05 Lier
60,Mechelsesteenweg 365,2021-03-24,23:00:00,2,0,2,FMN GV 05 Lier
60,Mechelsesteenweg 365,2021-03-25,00:00:00,0,0,0,FMN GV 05 Lier
60,Mechelsesteenweg 365,2021-03-25,01:00:00,0,0,0,FMN GV 05 Lier
60,Mechelsesteenweg 365,2021-03-25,02:00:00,0,0,0,FMN GV 05 Lier
60,Mechelsesteenweg 365,2021-03-25,03:00:00,0,0,0,FMN GV 05 Lier
60,Mechelsesteenweg 365,2021-03-25,04:00:00,6,0,6,FMN GV 05 Lier
60,Mechelsesteenweg 365,2021-03-25,05:00:00,14,2,12,FMN GV 05 Lier
60,Mechelsesteenweg 365,2021-03-25,06:00:00,30,6,24,FMN GV 05 Lier
60,Mechelsesteenweg 365,2021-03-25,07:00:00,212,140,72,FMN GV 05 Lier
60,Mechelsesteenweg 365,2021-03-25,08:00:00,104,68,36,FMN GV 05 Lier
60,Mechelsesteenweg 365,2021-03-25,09:00:00,66,22,44,FMN GV 05 Lier
60,Mechelsesteenweg 365,2021-03-25,10:00:00,98,20,78,FMN GV 05 Lier
60,Mechelsesteenweg 365,2021-03-25,11:00:00,54,32,22,FMN GV 05 Lier
60,Mechelsesteenweg 365,2021-03-25,12:00:00,82,34,48,FMN GV 05 Lier
60,Mechelsesteenweg 365,2021-03-25,13:00:00,106,48,58,FMN GV 05 Lier
60,Mechelsesteenweg 365,2021-03-25,14:00:00,134,82,52,FMN GV 05 Lier
60,Mechelsesteenweg 365,2021-03-25,15:00:00,132,64,68,FMN GV 05 Lier
60,Mechelsesteenweg 365,2021-03-25,16:00:00,166,100,66,FMN GV 05 Lier
60,Mechelsesteenweg 365,2021-03-25,17:00:00,122,82,40,FMN GV 05 Lier
60,Mechelsesteenweg 365,2021-03-25,18:00:00,70,36,34,FMN GV 05 Lier
60,Mechelsesteenweg 365,2021-03-25,19:00:00,30,14,16,FMN GV 05 Lier
60,Mechelsesteenweg 365,2021-03-25,20:00:00,14,8,6,FMN GV 05 Lier
60,Mechelsesteenweg 365,2021-03-25,21:00:00,16,4,12,FMN GV 05 Lier
60,Mechelsesteenweg 365,2021-03-25,22:00:00,14,12,2,FMN GV 05 Lier
60,Mechelsesteenweg 365,2021-03-25,23:00:00,6,4,2,FMN GV 05 Lier
60,Mechelsesteenweg 365,2021-03-26,00:00:00,0,0,0,FMN GV 05 Lier
60,Mechelsesteenweg 365,2021-03-26,01:00:00,0,0,0,FMN GV 05 Lier
60,Mechelsesteenweg 365,2021-03-26,02:00:00,0,0,0,FMN GV 05 Lier
60,Mechelsesteenweg 365,2021-03-26,03:00:00,2,0,2,FMN GV 05 Lier
60,Mechelsesteenweg 365,2021-03-26,04:00:00,4,0,4,FMN GV 05 Lier
60,Mechelsesteenweg 365,2021-03-26,05:00:00,8,0,8,FMN GV 05 Lier
60,Mechelsesteenweg 365,2021-03-26,06:00:00,28,16,12,FMN GV 05 Lier
60,Mechelsesteenweg 365,2021-03-26,07:00:00,146,100,46,FMN GV 05 Lier
60,Mechelsesteenweg 365,2021-03-26,08:00:00,88,42,46,FMN GV 05 Lier
60,Mechelsesteenweg 365,2021-03-26,09:00:00,58,28,30,FMN GV 05 Lier
60,Mechelsesteenweg 365,2021-03-26,10:00:00,148,60,88,FMN GV 05 Lier
60,Mechelsesteenweg 365,2021-03-26,11:00:00,122,54,68,FMN GV 05 Lier
60,Mechelsesteenweg 365,2021-03-26,12:00:00,94,42,52,FMN GV 05 Lier
60,Mechelsesteenweg 365,2021-03-26,13:00:00,114,64,50,FMN GV 05 Lier
60,Mechelsesteenweg 365,2021-03-26,14:00:00,124,92,32,FMN GV 05 Lier
60,Mechelsesteenweg 365,2021-03-26,15:00:00,128,74,54,FMN GV 05 Lier
60,Mechelsesteenweg 365,2021-03-26,16:00:00,118,66,52,FMN GV 05 Lier
60,Mechelsesteenweg 365,2021-03-26,17:00:00,130,78,52,FMN GV 05 Lier
60,Mechelsesteenweg 365,2021-03-26,18:00:00,58,30,28,FMN GV 05 Lier
60,Mechelsesteenweg 365,2021-03-26,19:00:00,16,8,8,FMN GV 05 Lier
60,Mechelsesteenweg 365,2021-03-26,20:00:00,16,6,10,FMN GV 05 Lier
60,Mechelsesteenweg 365,2021-03-26,21:00:00,4,2,2,FMN GV 05 Lier
60,Mechelsesteenweg 365,2021-03-26,22:00:00,6,2,4,FMN GV 05 Lier
60,Mechelsesteenweg 365,2021-03-26,23:00:00,6,6,0,FMN GV 05 Lier
60,Mechelsesteenweg 365,2021-03-27,00:00:00,0,0,0,FMN GV 05 Lier
60,Mechelsesteenweg 365,2021-03-27,01:00:00,2,2,0,FMN GV 05 Lier
60,Mechelsesteenweg 365,2021-03-27,02:00:00,0,0,0,FMN GV 05 Lier
60,Mechelsesteenweg 365,2021-03-27,03:00:00,4,0,4,FMN GV 05 Lier
60,Mechelsesteenweg 365,2021-03-27,04:00:00,0,0,0,FMN GV 05 Lier
60,Mechelsesteenweg 365,2021-03-27,05:00:00,0,0,0,FMN GV 05 Lier
60,Mechelsesteenweg 365,2021-03-27,06:00:00,8,6,2,FMN GV 05 Lier
60,Mechelsesteenweg 365,2021-03-27,07:00:00,6,4,2,FMN GV 05 Lier
60,Mechelsesteenweg 365,2021-03-27,08:00:00,12,8,4,FMN GV 05 Lier
60,Mechelsesteenweg 365,2021-03-27,09:00:00,42,20,22,FMN GV 05 Lier
60,Mechelsesteenweg 365,2021-03-27,10:00:00,70,44,26,FMN GV 05 Lier
60,Mechelsesteenweg 365,2021-03-27,11:00:00,98,46,52,FMN GV 05 Lier
60,Mechelsesteenweg 365,2021-03-27,12:00:00,74,22,52,FMN GV 05 Lier
60,Mechelsesteenweg 365,2021-03-27,13:00:00,118,66,52,FMN GV 05 Lier
60,Mechelsesteenweg 365,2021-03-27,14:00:00,132,78,54,FMN GV 05 Lier
60,Mechelsesteenweg 365,2021-03-27,15:00:00,196,110,86,FMN GV 05 Lier
60,Mechelsesteenweg 365,2021-03-27,16:00:00,142,88,54,FMN GV 05 Lier
60,Mechelsesteenweg 365,2021-03-27,17:00:00,50,24,26,FMN GV 05 Lier
60,Mechelsesteenweg 365,2021-03-27,18:00:00,50,30,20,FMN GV 05 Lier
60,Mechelsesteenweg 365,2021-03-27,19:00:00,10,0,10,FMN GV 05 Lier
60,Mechelsesteenweg 365,2021-03-27,20:00:00,16,12,4,FMN GV 05 Lier
60,Mechelsesteenweg 365,2021-03-27,21:00:00,10,2,8,FMN GV 05 Lier
60,Mechelsesteenweg 365,2021-03-27,22:00:00,0,0,0,FMN GV 05 Lier
60,Mechelsesteenweg 365,2021-03-27,23:00:00,4,4,0,FMN GV 05 Lier
60,Mechelsesteenweg 365,2021-03-28,00:00:00,0,0,0,FMN GV 05 Lier
60,Mechelsesteenweg 365,2021-03-28,01:00:00,0,0,0,FMN GV 05 Lier
60,Mechelsesteenweg 365,2021-03-28,02:00:00,0,0,0,FMN GV 05 Lier
60,Mechelsesteenweg 365,2021-03-28,03:00:00,0,0,0,FMN GV 05 Lier
60,Mechelsesteenweg 365,2021-03-28,04:00:00,0,0,0,FMN GV 05 Lier
60,Mechelsesteenweg 365,2021-03-28,05:00:00,0,0,0,FMN GV 05 Lier
60,Mechelsesteenweg 365,2021-03-28,06:00:00,2,2,0,FMN GV 05 Lier
60,Mechelsesteenweg 365,2021-03-28,07:00:00,8,2,6,FMN GV 05 Lier
60,Mechelsesteenweg 365,2021-03-28,08:00:00,64,22,42,FMN GV 05 Lier
60,Mechelsesteenweg 365,2021-03-28,09:00:00,168,56,112,FMN GV 05 Lier
60,Mechelsesteenweg 365,2021-03-28,10:00:00,416,204,212,FMN GV 05 Lier
60,Mechelsesteenweg 365,2021-03-28,11:00:00,530,340,190,FMN GV 05 Lier
60,Mechelsesteenweg 365,2021-03-28,12:00:00,394,234,160,FMN GV 05 Lier
60,Mechelsesteenweg 365,2021-03-28,13:00:00,246,140,106,FMN GV 05 Lier
60,Mechelsesteenweg 365,2021-03-28,14:00:00,316,156,160,FMN GV 05 Lier
60,Mechelsesteenweg 365,2021-03-28,15:00:00,254,156,98,FMN GV 05 Lier
60,Mechelsesteenweg 365,2021-03-28,16:00:00,214,130,84,FMN GV 05 Lier
60,Mechelsesteenweg 365,2021-03-28,17:00:00,82,44,38,FMN GV 05 Lier
60,Mechelsesteenweg 365,2021-03-28,18:00:00,42,22,20,FMN GV 05 Lier
60,Mechelsesteenweg 365,2021-03-28,19:00:00,18,8,10,FMN GV 05 Lier
60,Mechelsesteenweg 365,2021-03-28,20:00:00,6,0,6,FMN GV 05 Lier
60,Mechelsesteenweg 365,2021-03-28,21:00:00,4,2,2,FMN GV 05 Lier
60,Mechelsesteenweg 365,2021-03-28,22:00:00,0,0,0,FMN GV 05 Lier
60,Mechelsesteenweg 365,2021-03-28,23:00:00,2,2,0,FMN GV 05 Lier
60,Mechelsesteenweg 365,2021-03-29,00:00:00,0,0,0,FMN GV 05 Lier
60,Mechelsesteenweg 365,2021-03-29,01:00:00,0,0,0,FMN GV 05 Lier
60,Mechelsesteenweg 365,2021-03-29,02:00:00,0,0,0,FMN GV 05 Lier
60,Mechelsesteenweg 365,2021-03-29,03:00:00,2,0,2,FMN GV 05 Lier
60,Mechelsesteenweg 365,2021-03-29,04:00:00,4,0,4,FMN GV 05 Lier
60,Mechelsesteenweg 365,2021-03-29,05:00:00,8,0,8,FMN GV 05 Lier
60,Mechelsesteenweg 365,2021-03-29,06:00:00,32,16,16,FMN GV 05 Lier
60,Mechelsesteenweg 365,2021-03-29,07:00:00,154,120,34,FMN GV 05 Lier
60,Mechelsesteenweg 365,2021-03-29,08:00:00,78,42,36,FMN GV 05 Lier
60,Mechelsesteenweg 365,2021-03-29,09:00:00,80,38,42,FMN GV 05 Lier
60,Mechelsesteenweg 365,2021-03-29,10:00:00,130,60,70,FMN GV 05 Lier
60,Mechelsesteenweg 365,2021-03-29,11:00:00,142,62,80,FMN GV 05 Lier
60,Mechelsesteenweg 365,2021-03-29,12:00:00,186,88,98,FMN GV 05 Lier
60,Mechelsesteenweg 365,2021-03-29,13:00:00,304,174,130,FMN GV 05 Lier
60,Mechelsesteenweg 365,2021-03-29,14:00:00,440,226,214,FMN GV 05 Lier
60,Mechelsesteenweg 365,2021-03-29,15:00:00,410,206,204,FMN GV 05 Lier
60,Mechelsesteenweg 365,2021-03-29,16:00:00,336,188,148,FMN GV 05 Lier
60,Mechelsesteenweg 365,2021-03-29,17:00:00,242,130,112,FMN GV 05 Lier
60,Mechelsesteenweg 365,2021-03-29,18:00:00,180,98,82,FMN GV 05 Lier
60,Mechelsesteenweg 365,2021-03-29,19:00:00,120,64,56,FMN GV 05 Lier
60,Mechelsesteenweg 365,2021-03-29,20:00:00,26,14,12,FMN GV 05 Lier
60,Mechelsesteenweg 365,2021-03-29,21:00:00,8,0,8,FMN GV 05 Lier
60,Mechelsesteenweg 365,2021-03-29,22:00:00,12,10,2,FMN GV 05 Lier
60,Mechelsesteenweg 365,2021-03-29,23:00:00,4,2,2,FMN GV 05 Lier
60,Mechelsesteenweg 365,2021-03-30,00:00:00,0,0,0,FMN GV 05 Lier
60,Mechelsesteenweg 365,2021-03-30,01:00:00,0,0,0,FMN GV 05 Lier
60,Mechelsesteenweg 365,2021-03-30,02:00:00,0,0,0,FMN GV 05 Lier
60,Mechelsesteenweg 365,2021-03-30,03:00:00,2,0,2,FMN GV 05 Lier
60,Mechelsesteenweg 365,2021-03-30,04:00:00,4,0,4,FMN GV 05 Lier
60,Mechelsesteenweg 365,2021-03-30,05:00:00,10,0,10,FMN GV 05 Lier
60,Mechelsesteenweg 365,2021-03-30,06:00:00,40,18,22,FMN GV 05 Lier
60,Mechelsesteenweg 365,2021-03-30,07:00:00,66,30,36,FMN GV 05 Lier
60,Mechelsesteenweg 365,2021-03-30,08:00:00,84,48,36,FMN GV 05 Lier
60,Mechelsesteenweg 365,2021-03-30,09:00:00,94,48,46,FMN GV 05 Lier
60,Mechelsesteenweg 365,2021-03-30,10:00:00,188,88,100,FMN GV 05 Lier
60,Mechelsesteenweg 365,2021-03-30,11:00:00,278,156,122,FMN GV 05 Lier
60,Mechelsesteenweg 365,2021-03-30,12:00:00,326,178,148,FMN GV 05 Lier
60,Mechelsesteenweg 365,2021-03-30,13:00:00,472,252,220,FMN GV 05 Lier
60,Mechelsesteenweg 365,2021-03-30,14:00:00,696,376,320,FMN GV 05 Lier
60,Mechelsesteenweg 365,2021-03-30,15:00:00,624,270,354,FMN GV 05 Lier
60,Mechelsesteenweg 365,2021-03-30,16:00:00,490,202,288,FMN GV 05 Lier
60,Mechelsesteenweg 365,2021-03-30,17:00:00,418,218,200,FMN GV 05 Lier
60,Mechelsesteenweg 365,2021-03-30,18:00:00,274,124,150,FMN GV 05 Lier
60,Mechelsesteenweg 365,2021-03-30,19:00:00,140,64,76,FMN GV 05 Lier
60,Mechelsesteenweg 365,2021-03-30,20:00:00,76,32,44,FMN GV 05 Lier
60,Mechelsesteenweg 365,2021-03-30,21:00:00,20,10,10,FMN GV 05 Lier
60,Mechelsesteenweg 365,2021-03-30,22:00:00,12,12,0,FMN GV 05 Lier
60,Mechelsesteenweg 365,2021-03-30,23:00:00,6,2,4,FMN GV 05 Lier
60,Mechelsesteenweg 365,2021-03-31,00:00:00,0,0,0,FMN GV 05 Lier
60,Mechelsesteenweg 365,2021-03-31,01:00:00,0,0,0,FMN GV 05 Lier
60,Mechelsesteenweg 365,2021-03-31,02:00:00,0,0,0,FMN GV 05 Lier
60,Mechelsesteenweg 365,2021-03-31,03:00:00,0,0,0,FMN GV 05 Lier
60,Mechelsesteenweg 365,2021-03-31,04:00:00,4,0,4,FMN GV 05 Lier
60,Mechelsesteenweg 365,2021-03-31,05:00:00,12,4,8,FMN GV 05 Lier
60,Mechelsesteenweg 365,2021-03-31,06:00:00,42,16,26,FMN GV 05 Lier
60,Mechelsesteenweg 365,2021-03-31,07:00:00,68,26,42,FMN GV 05 Lier
60,Mechelsesteenweg 365,2021-03-31,08:00:00,70,32,38,FMN GV 05 Lier
60,Mechelsesteenweg 365,2021-03-31,09:00:00,68,26,42,FMN GV 05 Lier
60,Mechelsesteenweg 365,2021-03-31,10:00:00,196,128,68,FMN GV 05 Lier
60,Mechelsesteenweg 365,2021-03-31,11:00:00,248,136,112,FMN GV 05 Lier
60,Mechelsesteenweg 365,2021-03-31,12:00:00,246,126,120,FMN GV 05 Lier
60,Mechelsesteenweg 365,2021-03-31,13:00:00,470,244,226,FMN GV 05 Lier
60,Mechelsesteenweg 365,2021-03-31,14:00:00,654,362,292,FMN GV 05 Lier
60,Mechelsesteenweg 365,2021-03-31,15:00:00,552,288,264,FMN GV 05 Lier
60,Mechelsesteenweg 365,2021-03-31,16:00:00,378,154,224,FMN GV 05 Lier
60,Mechelsesteenweg 365,2021-03-31,17:00:00,432,198,234,FMN GV 05 Lier
60,Mechelsesteenweg 365,2021-03-31,18:00:00,342,200,142,FMN GV 05 Lier
60,Mechelsesteenweg 365,2021-03-31,19:00:00,270,128,142,FMN GV 05 Lier
60,Mechelsesteenweg 365,2021-03-31,20:00:00,88,30,58,FMN GV 05 Lier
60,Mechelsesteenweg 365,2021-03-31,21:00:00,22,8,14,FMN GV 05 Lier
60,Mechelsesteenweg 365,2021-03-31,22:00:00,20,4,16,FMN GV 05 Lier
60,Mechelsesteenweg 365,2021-03-31,23:00:00,16,16,0,FMN GV 05 Lier
60,Mechelsesteenweg 365,2021-04-01,00:00:00,2,2,0,FMN GV 05 Lier
60,Mechelsesteenweg 365,2021-04-01,01:00:00,0,0,0,FMN GV 05 Lier
60,Mechelsesteenweg 365,2021-04-01,02:00:00,0,0,0,FMN GV 05 Lier
60,Mechelsesteenweg 365,2021-04-01,03:00:00,2,0,2,FMN GV 05 Lier
60,Mechelsesteenweg 365,2021-04-01,04:00:00,2,0,2,FMN GV 05 Lier
60,Mechelsesteenweg 365,2021-04-01,05:00:00,10,2,8,FMN GV 05 Lier
60,Mechelsesteenweg 365,2021-04-01,06:00:00,34,10,24,FMN GV 05 Lier
60,Mechelsesteenweg 365,2021-04-01,07:00:00,86,30,56,FMN GV 05 Lier
60,Mechelsesteenweg 365,2021-04-01,08:00:00,70,26,44,FMN GV 05 Lier
60,Mechelsesteenweg 365,2021-04-01,09:00:00,80,60,20,FMN GV 05 Lier
60,Mechelsesteenweg 365,2021-04-01,10:00:00,130,72,58,FMN GV 05 Lier
60,Mechelsesteenweg 365,2021-04-01,11:00:00,148,74,74,FMN GV 05 Lier
60,Mechelsesteenweg 365,2021-04-01,12:00:00,202,100,102,FMN GV 05 Lier
60,Mechelsesteenweg 365,2021-04-01,13:00:00,332,196,136,FMN GV 05 Lier
60,Mechelsesteenweg 365,2021-04-01,14:00:00,320,150,170,FMN GV 05 Lier
60,Mechelsesteenweg 365,2021-04-01,15:00:00,380,172,208,FMN GV 05 Lier
60,Mechelsesteenweg 365,2021-04-01,16:00:00,304,152,152,FMN GV 05 Lier
60,Mechelsesteenweg 365,2021-04-01,17:00:00,250,120,130,FMN GV 05 Lier
60,Mechelsesteenweg 365,2021-04-01,18:00:00,162,68,94,FMN GV 05 Lier
60,Mechelsesteenweg 365,2021-04-01,19:00:00,148,98,50,FMN GV 05 Lier
60,Mechelsesteenweg 365,2021-04-01,20:00:00,40,12,28,FMN GV 05 Lier
60,Mechelsesteenweg 365,2021-04-01,21:00:00,6,6,0,FMN GV 05 Lier
60,Mechelsesteenweg 365,2021-04-01,22:00:00,16,10,6,FMN GV 05 Lier
60,Mechelsesteenweg 365,2021-04-01,23:00:00,2,0,2,FMN GV 05 Lier
60,Mechelsesteenweg 365,2021-04-02,00:00:00,0,0,0,FMN GV 05 Lier
60,Mechelsesteenweg 365,2021-04-02,01:00:00,0,0,0,FMN GV 05 Lier
60,Mechelsesteenweg 365,2021-04-02,02:00:00,0,0,0,FMN GV 05 Lier
60,Mechelsesteenweg 365,2021-04-02,03:00:00,2,0,2,FMN GV 05 Lier
60,Mechelsesteenweg 365,2021-04-02,04:00:00,0,0,0,FMN GV 05 Lier
60,Mechelsesteenweg 365,2021-04-02,05:00:00,4,0,4,FMN GV 05 Lier
60,Mechelsesteenweg 365,2021-04-02,06:00:00,18,6,12,FMN GV 05 Lier
60,Mechelsesteenweg 365,2021-04-02,07:00:00,58,22,36,FMN GV 05 Lier
60,Mechelsesteenweg 365,2021-04-02,08:00:00,44,26,18,FMN GV 05 Lier
60,Mechelsesteenweg 365,2021-04-02,09:00:00,32,16,16,FMN GV 05 Lier
60,Mechelsesteenweg 365,2021-04-02,10:00:00,86,32,54,FMN GV 05 Lier
60,Mechelsesteenweg 365,2021-04-02,11:00:00,56,32,24,FMN GV 05 Lier
60,Mechelsesteenweg 365,2021-04-02,12:00:00,128,56,72,FMN GV 05 Lier
60,Mechelsesteenweg 365,2021-04-02,13:00:00,130,66,64,FMN GV 05 Lier
60,Mechelsesteenweg 365,2021-04-02,14:00:00,138,78,60,FMN GV 05 Lier
60,Mechelsesteenweg 365,2021-04-02,15:00:00,176,82,94,FMN GV 05 Lier
60,Mechelsesteenweg 365,2021-04-02,16:00:00,144,76,68,FMN GV 05 Lier
60,Mechelsesteenweg 365,2021-04-02,17:00:00,96,54,42,FMN GV 05 Lier
60,Mechelsesteenweg 365,2021-04-02,18:00:00,74,48,26,FMN GV 05 Lier
60,Mechelsesteenweg 365,2021-04-02,19:00:00,48,16,32,FMN GV 05 Lier
60,Mechelsesteenweg 365,2021-04-02,20:00:00,24,10,14,FMN GV 05 Lier
60,Mechelsesteenweg 365,2021-04-02,21:00:00,4,2,2,FMN GV 05 Lier
60,Mechelsesteenweg 365,2021-04-02,22:00:00,16,8,8,FMN GV 05 Lier
60,Mechelsesteenweg 365,2021-04-02,23:00:00,2,0,2,FMN GV 05 Lier
60,Mechelsesteenweg 365,2021-04-03,00:00:00,0,0,0,FMN GV 05 Lier
60,Mechelsesteenweg 365,2021-04-03,01:00:00,0,0,0,FMN GV 05 Lier
60,Mechelsesteenweg 365,2021-04-03,02:00:00,0,0,0,FMN GV 05 Lier
60,Mechelsesteenweg 365,2021-04-03,03:00:00,0,0,0,FMN GV 05 Lier
60,Mechelsesteenweg 365,2021-04-03,04:00:00,0,0,0,FMN GV 05 Lier
60,Mechelsesteenweg 365,2021-04-03,05:00:00,4,2,2,FMN GV 05 Lier
60,Mechelsesteenweg 365,2021-04-03,06:00:00,4,2,2,FMN GV 05 Lier
60,Mechelsesteenweg 365,2021-04-03,07:00:00,8,4,4,FMN GV 05 Lier
60,Mechelsesteenweg 365,2021-04-03,08:00:00,22,6,16,FMN GV 05 Lier
60,Mechelsesteenweg 365,2021-04-03,09:00:00,108,46,62,FMN GV 05 Lier
60,Mechelsesteenweg 365,2021-04-03,10:00:00,158,102,56,FMN GV 05 Lier
60,Mechelsesteenweg 365,2021-04-03,11:00:00,156,70,86,FMN GV 05 Lier
60,Mechelsesteenweg 365,2021-04-03,12:00:00,100,50,50,FMN GV 05 Lier
60,Mechelsesteenweg 365,2021-04-03,13:00:00,176,84,92,FMN GV 05 Lier
60,Mechelsesteenweg 365,2021-04-03,14:00:00,234,114,120,FMN GV 05 Lier
60,Mechelsesteenweg 365,2021-04-03,15:00:00,284,138,146,FMN GV 05 Lier
60,Mechelsesteenweg 365,2021-04-03,16:00:00,174,86,88,FMN GV 05 Lier
60,Mechelsesteenweg 365,2021-04-03,17:00:00,138,66,72,FMN GV 05 Lier
60,Mechelsesteenweg 365,2021-04-03,18:00:00,54,26,28,FMN GV 05 Lier
60,Mechelsesteenweg 365,2021-04-03,19:00:00,38,20,18,FMN GV 05 Lier
60,Mechelsesteenweg 365,2021-04-03,20:00:00,6,2,4,FMN GV 05 Lier
60,Mechelsesteenweg 365,2021-04-03,21:00:00,4,2,2,FMN GV 05 Lier
60,Mechelsesteenweg 365,2021-04-03,22:00:00,2,2,0,FMN GV 05 Lier
60,Mechelsesteenweg 365,2021-04-03,23:00:00,2,0,2,FMN GV 05 Lier
60,Mechelsesteenweg 365,2021-04-04,00:00:00,0,0,0,FMN GV 05 Lier
60,Mechelsesteenweg 365,2021-04-04,01:00:00,0,0,0,FMN GV 05 Lier
60,Mechelsesteenweg 365,2021-04-04,02:00:00,0,0,0,FMN GV 05 Lier
60,Mechelsesteenweg 365,2021-04-04,03:00:00,0,0,0,FMN GV 05 Lier
60,Mechelsesteenweg 365,2021-04-04,04:00:00,0,0,0,FMN GV 05 Lier
60,Mechelsesteenweg 365,2021-04-04,05:00:00,0,0,0,FMN GV 05 Lier
60,Mechelsesteenweg 365,2021-04-04,06:00:00,0,0,0,FMN GV 05 Lier
60,Mechelsesteenweg 365,2021-04-04,07:00:00,10,6,4,FMN GV 05 Lier
60,Mechelsesteenweg 365,2021-04-04,08:00:00,20,12,8,FMN GV 05 Lier
60,Mechelsesteenweg 365,2021-04-04,09:00:00,140,90,50,FMN GV 05 Lier
60,Mechelsesteenweg 365,2021-04-04,10:00:00,278,156,122,FMN GV 05 Lier
60,Mechelsesteenweg 365,2021-04-04,11:00:00,396,216,180,FMN GV 05 Lier
60,Mechelsesteenweg 365,2021-04-04,12:00:00,188,58,130,FMN GV 05 Lier
60,Mechelsesteenweg 365,2021-04-04,13:00:00,150,92,58,FMN GV 05 Lier
60,Mechelsesteenweg 365,2021-04-04,14:00:00,204,108,96,FMN GV 05 Lier
60,Mechelsesteenweg 365,2021-04-04,15:00:00,112,44,68,FMN GV 05 Lier
60,Mechelsesteenweg 365,2021-04-04,16:00:00,70,36,34,FMN GV 05 Lier
60,Mechelsesteenweg 365,2021-04-04,17:00:00,162,90,72,FMN GV 05 Lier
60,Mechelsesteenweg 365,2021-04-04,18:00:00,78,18,60,FMN GV 05 Lier
60,Mechelsesteenweg 365,2021-04-04,19:00:00,20,12,8,FMN GV 05 Lier
60,Mechelsesteenweg 365,2021-04-04,20:00:00,20,10,10,FMN GV 05 Lier
60,Mechelsesteenweg 365,2021-04-04,21:00:00,12,8,4,FMN GV 05 Lier
60,Mechelsesteenweg 365,2021-04-04,22:00:00,6,2,4,FMN GV 05 Lier
60,Mechelsesteenweg 365,2021-04-04,23:00:00,2,2,0,FMN GV 05 Lier
60,Mechelsesteenweg 365,2021-04-05,00:00:00,0,0,0,FMN GV 05 Lier
60,Mechelsesteenweg 365,2021-04-05,01:00:00,0,0,0,FMN GV 05 Lier
60,Mechelsesteenweg 365,2021-04-05,02:00:00,0,0,0,FMN GV 05 Lier
60,Mechelsesteenweg 365,2021-04-05,03:00:00,0,0,0,FMN GV 05 Lier
60,Mechelsesteenweg 365,2021-04-05,04:00:00,4,0,4,FMN GV 05 Lier
60,Mechelsesteenweg 365,2021-04-05,05:00:00,2,2,0,FMN GV 05 Lier
60,Mechelsesteenweg 365,2021-04-05,06:00:00,2,2,0,FMN GV 05 Lier
60,Mechelsesteenweg 365,2021-04-05,07:00:00,4,2,2,FMN GV 05 Lier
60,Mechelsesteenweg 365,2021-04-05,08:00:00,10,6,4,FMN GV 05 Lier
60,Mechelsesteenweg 365,2021-04-05,09:00:00,18,4,14,FMN GV 05 Lier
60,Mechelsesteenweg 365,2021-04-05,10:00:00,6,0,6,FMN GV 05 Lier
60,Mechelsesteenweg 365,2021-04-05,11:00:00,30,12,18,FMN GV 05 Lier
60,Mechelsesteenweg 365,2021-04-05,12:00:00,10,2,8,FMN GV 05 Lier
60,Mechelsesteenweg 365,2021-04-05,13:00:00,40,12,28,FMN GV 05 Lier
60,Mechelsesteenweg 365,2021-04-05,14:00:00,64,60,4,FMN GV 05 Lier
60,Mechelsesteenweg 365,2021-04-05,15:00:00,58,42,16,FMN GV 05 Lier
60,Mechelsesteenweg 365,2021-04-05,16:00:00,42,14,28,FMN GV 05 Lier
60,Mechelsesteenweg 365,2021-04-05,17:00:00,22,8,14,FMN GV 05 Lier
60,Mechelsesteenweg 365,2021-04-05,18:00:00,12,6,6,FMN GV 05 Lier
60,Mechelsesteenweg 365,2021-04-05,19:00:00,4,4,0,FMN GV 05 Lier
60,Mechelsesteenweg 365,2021-04-05,20:00:00,0,0,0,FMN GV 05 Lier
60,Mechelsesteenweg 365,2021-04-05,21:00:00,0,0,0,FMN GV 05 Lier
60,Mechelsesteenweg 365,2021-04-05,22:00:00,0,0,0,FMN GV 05 Lier
60,Mechelsesteenweg 365,2021-04-05,23:00:00,2,2,0,FMN GV 05 Lier
60,Mechelsesteenweg 365,2021-04-06,00:00:00,0,0,0,FMN GV 05 Lier
60,Mechelsesteenweg 365,2021-04-06,01:00:00,0,0,0,FMN GV 05 Lier
60,Mechelsesteenweg 365,2021-04-06,02:00:00,0,0,0,FMN GV 05 Lier
60,Mechelsesteenweg 365,2021-04-06,03:00:00,2,0,2,FMN GV 05 Lier
60,Mechelsesteenweg 365,2021-04-06,04:00:00,0,0,0,FMN GV 05 Lier
60,Mechelsesteenweg 365,2021-04-06,05:00:00,0,0,0,FMN GV 05 Lier
60,Mechelsesteenweg 365,2021-04-06,06:00:00,10,4,6,FMN GV 05 Lier
60,Mechelsesteenweg 365,2021-04-06,07:00:00,24,12,12,FMN GV 05 Lier
60,Mechelsesteenweg 365,2021-04-06,08:00:00,14,2,12,FMN GV 05 Lier
60,Mechelsesteenweg 365,2021-04-06,09:00:00,14,6,8,FMN GV 05 Lier
60,Mechelsesteenweg 365,2021-04-06,10:00:00,6,6,0,FMN GV 05 Lier
60,Mechelsesteenweg 365,2021-04-06,11:00:00,12,4,8,FMN GV 05 Lier
60,Mechelsesteenweg 365,2021-04-06,12:00:00,22,14,8,FMN GV 05 Lier
60,Mechelsesteenweg 365,2021-04-06,13:00:00,14,10,4,FMN GV 05 Lier
60,Mechelsesteenweg 365,2021-04-06,14:00:00,8,4,4,FMN GV 05 Lier
60,Mechelsesteenweg 365,2021-04-06,15:00:00,20,8,12,FMN GV 05 Lier
60,Mechelsesteenweg 365,2021-04-06,16:00:00,16,10,6,FMN GV 05 Lier
60,Mechelsesteenweg 365,2021-04-06,17:00:00,26,22,4,FMN GV 05 Lier
60,Mechelsesteenweg 365,2021-04-06,18:00:00,6,2,4,FMN GV 05 Lier
60,Mechelsesteenweg 365,2021-04-06,19:00:00,4,0,4,FMN GV 05 Lier
60,Mechelsesteenweg 365,2021-04-06,20:00:00,6,4,2,FMN GV 05 Lier
60,Mechelsesteenweg 365,2021-04-06,21:00:00,2,2,0,FMN GV 05 Lier
60,Mechelsesteenweg 365,2021-04-06,22:00:00,2,0,2,FMN GV 05 Lier
60,Mechelsesteenweg 365,2021-04-06,23:00:00,0,0,0,FMN GV 05 Lier
60,Mechelsesteenweg 365,2021-04-07,00:00:00,0,0,0,FMN GV 05 Lier
60,Mechelsesteenweg 365,2021-04-07,01:00:00,0,0,0,FMN GV 05 Lier
60,Mechelsesteenweg 365,2021-04-07,02:00:00,0,0,0,FMN GV 05 Lier
60,Mechelsesteenweg 365,2021-04-07,03:00:00,2,0,2,FMN GV 05 Lier
60,Mechelsesteenweg 365,2021-04-07,04:00:00,0,0,0,FMN GV 05 Lier
60,Mechelsesteenweg 365,2021-04-07,05:00:00,2,2,0,FMN GV 05 Lier
60,Mechelsesteenweg 365,2021-04-07,06:00:00,6,2,4,FMN GV 05 Lier
60,Mechelsesteenweg 365,2021-04-07,07:00:00,16,4,12,FMN GV 05 Lier
60,Mechelsesteenweg 365,2021-04-07,08:00:00,10,6,4,FMN GV 05 Lier
60,Mechelsesteenweg 365,2021-04-07,09:00:00,2,2,0,FMN GV 05 Lier
60,Mechelsesteenweg 365,2021-04-07,10:00:00,16,6,10,FMN GV 05 Lier
60,Mechelsesteenweg 365,2021-04-07,11:00:00,26,10,16,FMN GV 05 Lier
60,Mechelsesteenweg 365,2021-04-07,12:00:00,0,0,0,FMN GV 05 Lier
60,Mechelsesteenweg 365,2021-04-07,13:00:00,0,0,0,FMN GV 05 Lier
60,Mechelsesteenweg 365,2021-04-07,14:00:00,0,0,0,FMN GV 05 Lier
60,Mechelsesteenweg 365,2021-04-07,15:00:00,0,0,0,FMN GV 05 Lier
60,Mechelsesteenweg 365,2021-04-07,16:00:00,0,0,0,FMN GV 05 Lier
60,Mechelsesteenweg 365,2021-04-07,17:00:00,2,0,2,FMN GV 05 Lier
60,Mechelsesteenweg 365,2021-04-07,18:00:00,24,10,14,FMN GV 05 Lier
60,Mechelsesteenweg 365,2021-04-07,19:00:00,20,16,4,FMN GV 05 Lier
60,Mechelsesteenweg 365,2021-04-07,20:00:00,12,2,10,FMN GV 05 Lier
60,Mechelsesteenweg 365,2021-04-07,21:00:00,0,0,0,FMN GV 05 Lier
60,Mechelsesteenweg 365,2021-04-07,22:00:00,4,0,4,FMN GV 05 Lier
60,Mechelsesteenweg 365,2021-04-07,23:00:00,4,4,0,FMN GV 05 Lier
60,Mechelsesteenweg 365,2021-04-08,00:00:00,0,0,0,FMN GV 05 Lier
60,Mechelsesteenweg 365,2021-04-08,01:00:00,0,0,0,FMN GV 05 Lier
60,Mechelsesteenweg 365,2021-04-08,02:00:00,0,0,0,FMN GV 05 Lier
60,Mechelsesteenweg 365,2021-04-08,03:00:00,2,0,2,FMN GV 05 Lier
60,Mechelsesteenweg 365,2021-04-08,04:00:00,0,0,0,FMN GV 05 Lier
60,Mechelsesteenweg 365,2021-04-08,05:00:00,2,0,2,FMN GV 05 Lier
60,Mechelsesteenweg 365,2021-04-08,06:00:00,20,8,12,FMN GV 05 Lier
60,Mechelsesteenweg 365,2021-04-08,07:00:00,44,12,32,FMN GV 05 Lier
60,Mechelsesteenweg 365,2021-04-08,08:00:00,28,10,18,FMN GV 05 Lier
60,Mechelsesteenweg 365,2021-04-08,09:00:00,52,24,28,FMN GV 05 Lier
60,Mechelsesteenweg 365,2021-04-08,10:00:00,90,54,36,FMN GV 05 Lier
60,Mechelsesteenweg 365,2021-04-08,11:00:00,78,46,32,FMN GV 05 Lier
60,Mechelsesteenweg 365,2021-04-08,12:00:00,126,72,54,FMN GV 05 Lier
60,Mechelsesteenweg 365,2021-04-08,13:00:00,140,70,70,FMN GV 05 Lier
60,Mechelsesteenweg 365,2021-04-08,14:00:00,180,132,48,FMN GV 05 Lier
60,Mechelsesteenweg 365,2021-04-08,15:00:00,196,112,84,FMN GV 05 Lier
60,Mechelsesteenweg 365,2021-04-08,16:00:00,196,118,78,FMN GV 05 Lier
60,Mechelsesteenweg 365,2021-04-08,17:00:00,128,76,52,FMN GV 05 Lier
60,Mechelsesteenweg 365,2021-04-08,18:00:00,132,74,58,FMN GV 05 Lier
60,Mechelsesteenweg 365,2021-04-08,19:00:00,150,102,48,FMN GV 05 Lier
60,Mechelsesteenweg 365,2021-04-08,20:00:00,62,20,42,FMN GV 05 Lier
60,Mechelsesteenweg 365,2021-04-08,21:00:00,12,12,0,FMN GV 05 Lier
60,Mechelsesteenweg 365,2021-04-08,22:00:00,6,2,4,FMN GV 05 Lier
60,Mechelsesteenweg 365,2021-04-08,23:00:00,10,2,8,FMN GV 05 Lier
60,Mechelsesteenweg 365,2021-04-09,00:00:00,2,0,2,FMN GV 05 Lier
60,Mechelsesteenweg 365,2021-04-09,01:00:00,0,0,0,FMN GV 05 Lier
60,Mechelsesteenweg 365,2021-04-09,02:00:00,0,0,0,FMN GV 05 Lier
60,Mechelsesteenweg 365,2021-04-09,03:00:00,2,0,2,FMN GV 05 Lier
60,Mechelsesteenweg 365,2021-04-09,04:00:00,0,0,0,FMN GV 05 Lier
60,Mechelsesteenweg 365,2021-04-09,05:00:00,2,0,2,FMN GV 05 Lier
60,Mechelsesteenweg 365,2021-04-09,06:00:00,16,8,8,FMN GV 05 Lier
60,Mechelsesteenweg 365,2021-04-09,07:00:00,48,16,32,FMN GV 05 Lier
60,Mechelsesteenweg 365,2021-04-09,08:00:00,32,10,22,FMN GV 05 Lier
60,Mechelsesteenweg 365,2021-04-09,09:00:00,60,32,28,FMN GV 05 Lier
60,Mechelsesteenweg 365,2021-04-09,10:00:00,76,18,58,FMN GV 05 Lier
60,Mechelsesteenweg 365,2021-04-09,11:00:00,130,72,58,FMN GV 05 Lier
60,Mechelsesteenweg 365,2021-04-09,12:00:00,176,84,92,FMN GV 05 Lier
60,Mechelsesteenweg 365,2021-04-09,13:00:00,248,126,122,FMN GV 05 Lier
60,Mechelsesteenweg 365,2021-04-09,14:00:00,286,142,144,FMN GV 05 Lier
60,Mechelsesteenweg 365,2021-04-09,15:00:00,284,168,116,FMN GV 05 Lier
60,Mechelsesteenweg 365,2021-04-09,16:00:00,282,144,138,FMN GV 05 Lier
60,Mechelsesteenweg 365,2021-04-09,17:00:00,164,94,70,FMN GV 05 Lier
60,Mechelsesteenweg 365,2021-04-09,18:00:00,122,64,58,FMN GV 05 Lier
60,Mechelsesteenweg 365,2021-04-09,19:00:00,62,30,32,FMN GV 05 Lier
60,Mechelsesteenweg 365,2021-04-09,20:00:00,24,14,10,FMN GV 05 Lier
60,Mechelsesteenweg 365,2021-04-09,21:00:00,16,12,4,FMN GV 05 Lier
60,Mechelsesteenweg 365,2021-04-09,22:00:00,6,0,6,FMN GV 05 Lier
60,Mechelsesteenweg 365,2021-04-09,23:00:00,8,4,4,FMN GV 05 Lier
60,Mechelsesteenweg 365,2021-04-10,00:00:00,2,0,2,FMN GV 05 Lier
60,Mechelsesteenweg 365,2021-04-10,01:00:00,0,0,0,FMN GV 05 Lier
60,Mechelsesteenweg 365,2021-04-10,02:00:00,0,0,0,FMN GV 05 Lier
60,Mechelsesteenweg 365,2021-04-10,03:00:00,0,0,0,FMN GV 05 Lier
60,Mechelsesteenweg 365,2021-04-10,04:00:00,0,0,0,FMN GV 05 Lier
60,Mechelsesteenweg 365,2021-04-10,05:00:00,0,0,0,FMN GV 05 Lier
60,Mechelsesteenweg 365,2021-04-10,06:00:00,2,0,2,FMN GV 05 Lier
60,Mechelsesteenweg 365,2021-04-10,07:00:00,14,6,8,FMN GV 05 Lier
60,Mechelsesteenweg 365,2021-04-10,08:00:00,34,18,16,FMN GV 05 Lier
60,Mechelsesteenweg 365,2021-04-10,09:00:00,22,8,14,FMN GV 05 Lier
60,Mechelsesteenweg 365,2021-04-10,10:00:00,22,16,6,FMN GV 05 Lier
60,Mechelsesteenweg 365,2021-04-10,11:00:00,24,8,16,FMN GV 05 Lier
60,Mechelsesteenweg 365,2021-04-10,12:00:00,18,2,16,FMN GV 05 Lier
60,Mechelsesteenweg 365,2021-04-10,13:00:00,22,12,10,FMN GV 05 Lier
60,Mechelsesteenweg 365,2021-04-10,14:00:00,12,6,6,FMN GV 05 Lier
60,Mechelsesteenweg 365,2021-04-10,15:00:00,10,4,6,FMN GV 05 Lier
60,Mechelsesteenweg 365,2021-04-10,16:00:00,26,20,6,FMN GV 05 Lier
60,Mechelsesteenweg 365,2021-04-10,17:00:00,16,2,14,FMN GV 05 Lier
60,Mechelsesteenweg 365,2021-04-10,18:00:00,6,4,2,FMN GV 05 Lier
60,Mechelsesteenweg 365,2021-04-10,19:00:00,0,0,0,FMN GV 05 Lier
60,Mechelsesteenweg 365,2021-04-10,20:00:00,4,2,2,FMN GV 05 Lier
60,Mechelsesteenweg 365,2021-04-10,21:00:00,4,0,4,FMN GV 05 Lier
60,Mechelsesteenweg 365,2021-04-10,22:00:00,0,0,0,FMN GV 05 Lier
60,Mechelsesteenweg 365,2021-04-10,23:00:00,2,2,0,FMN GV 05 Lier
60,Mechelsesteenweg 365,2021-04-11,00:00:00,0,0,0,FMN GV 05 Lier
60,Mechelsesteenweg 365,2021-04-11,01:00:00,0,0,0,FMN GV 05 Lier
60,Mechelsesteenweg 365,2021-04-11,02:00:00,0,0,0,FMN GV 05 Lier
60,Mechelsesteenweg 365,2021-04-11,03:00:00,0,0,0,FMN GV 05 Lier
60,Mechelsesteenweg 365,2021-04-11,04:00:00,0,0,0,FMN GV 05 Lier
60,Mechelsesteenweg 365,2021-04-11,05:00:00,0,0,0,FMN GV 05 Lier
60,Mechelsesteenweg 365,2021-04-11,06:00:00,0,0,0,FMN GV 05 Lier
60,Mechelsesteenweg 365,2021-04-11,07:00:00,0,0,0,FMN GV 05 Lier
60,Mechelsesteenweg 365,2021-04-11,08:00:00,8,4,4,FMN GV 05 Lier
60,Mechelsesteenweg 365,2021-04-11,09:00:00,66,20,46,FMN GV 05 Lier
60,Mechelsesteenweg 365,2021-04-11,10:00:00,170,86,84,FMN GV 05 Lier
60,Mechelsesteenweg 365,2021-04-11,11:00:00,198,84,114,FMN GV 05 Lier
60,Mechelsesteenweg 365,2021-04-11,12:00:00,156,58,98,FMN GV 05 Lier
60,Mechelsesteenweg 365,2021-04-11,13:00:00,104,58,46,FMN GV 05 Lier
60,Mechelsesteenweg 365,2021-04-11,14:00:00,164,72,92,FMN GV 05 Lier
60,Mechelsesteenweg 365,2021-04-11,15:00:00,176,74,102,FMN GV 05 Lier
60,Mechelsesteenweg 365,2021-04-11,16:00:00,126,56,70,FMN GV 05 Lier
60,Mechelsesteenweg 365,2021-04-11,17:00:00,88,42,46,FMN GV 05 Lier
60,Mechelsesteenweg 365,2021-04-11,18:00:00,34,24,10,FMN GV 05 Lier
60,Mechelsesteenweg 365,2021-04-11,19:00:00,28,10,18,FMN GV 05 Lier
60,Mechelsesteenweg 365,2021-04-11,20:00:00,20,12,8,FMN GV 05 Lier
60,Mechelsesteenweg 365,2021-04-11,21:00:00,8,2,6,FMN GV 05 Lier
60,Mechelsesteenweg 365,2021-04-11,22:00:00,0,0,0,FMN GV 05 Lier
60,Mechelsesteenweg 365,2021-04-11,23:00:00,0,0,0,FMN GV 05 Lier
60,Mechelsesteenweg 365,2021-04-12,00:00:00,0,0,0,FMN GV 05 Lier
60,Mechelsesteenweg 365,2021-04-12,01:00:00,0,0,0,FMN GV 05 Lier
60,Mechelsesteenweg 365,2021-04-12,02:00:00,0,0,0,FMN GV 05 Lier
60,Mechelsesteenweg 365,2021-04-12,03:00:00,2,0,2,FMN GV 05 Lier
60,Mechelsesteenweg 365,2021-04-12,04:00:00,2,0,2,FMN GV 05 Lier
60,Mechelsesteenweg 365,2021-04-12,05:00:00,6,2,4,FMN GV 05 Lier
60,Mechelsesteenweg 365,2021-04-12,06:00:00,22,6,16,FMN GV 05 Lier
60,Mechelsesteenweg 365,2021-04-12,07:00:00,30,10,20,FMN GV 05 Lier
60,Mechelsesteenweg 365,2021-04-12,08:00:00,26,8,18,FMN GV 05 Lier
60,Mechelsesteenweg 365,2021-04-12,09:00:00,20,6,14,FMN GV 05 Lier
60,Mechelsesteenweg 365,2021-04-12,10:00:00,18,8,10,FMN GV 05 Lier
60,Mechelsesteenweg 365,2021-04-12,11:00:00,12,6,6,FMN GV 05 Lier
60,Mechelsesteenweg 365,2021-04-12,12:00:00,38,16,22,FMN GV 05 Lier
60,Mechelsesteenweg 365,2021-04-12,13:00:00,12,6,6,FMN GV 05 Lier
60,Mechelsesteenweg 365,2021-04-12,14:00:00,42,20,22,FMN GV 05 Lier
60,Mechelsesteenweg 365,2021-04-12,15:00:00,64,30,34,FMN GV 05 Lier
60,Mechelsesteenweg 365,2021-04-12,16:00:00,56,32,24,FMN GV 05 Lier
60,Mechelsesteenweg 365,2021-04-12,17:00:00,84,56,28,FMN GV 05 Lier
60,Mechelsesteenweg 365,2021-04-12,18:00:00,60,34,26,FMN GV 05 Lier
60,Mechelsesteenweg 365,2021-04-12,19:00:00,48,24,24,FMN GV 05 Lier
60,Mechelsesteenweg 365,2021-04-12,20:00:00,14,6,8,FMN GV 05 Lier
60,Mechelsesteenweg 365,2021-04-12,21:00:00,16,10,6,FMN GV 05 Lier
60,Mechelsesteenweg 365,2021-04-12,22:00:00,2,0,2,FMN GV 05 Lier
60,Mechelsesteenweg 365,2021-04-12,23:00:00,2,2,0,FMN GV 05 Lier
60,Mechelsesteenweg 365,2021-04-13,00:00:00,0,0,0,FMN GV 05 Lier
60,Mechelsesteenweg 365,2021-04-13,01:00:00,0,0,0,FMN GV 05 Lier
60,Mechelsesteenweg 365,2021-04-13,02:00:00,0,0,0,FMN GV 05 Lier
60,Mechelsesteenweg 365,2021-04-13,03:00:00,2,0,2,FMN GV 05 Lier
60,Mechelsesteenweg 365,2021-04-13,04:00:00,4,0,4,FMN GV 05 Lier
60,Mechelsesteenweg 365,2021-04-13,05:00:00,8,2,6,FMN GV 05 Lier
60,Mechelsesteenweg 365,2021-04-13,06:00:00,22,12,10,FMN GV 05 Lier
60,Mechelsesteenweg 365,2021-04-13,07:00:00,62,26,36,FMN GV 05 Lier
60,Mechelsesteenweg 365,2021-04-13,08:00:00,26,4,22,FMN GV 05 Lier
60,Mechelsesteenweg 365,2021-04-13,09:00:00,0,0,0,FMN GV 05 Lier
60,Mechelsesteenweg 365,2021-04-13,10:00:00,0,0,0,FMN GV 05 Lier
60,Mechelsesteenweg 365,2021-04-13,11:00:00,0,0,0,FMN GV 05 Lier
60,Mechelsesteenweg 365,2021-04-13,12:00:00,0,0,0,FMN GV 05 Lier
60,Mechelsesteenweg 365,2021-04-13,13:00:00,0,0,0,FMN GV 05 Lier
60,Mechelsesteenweg 365,2021-04-13,14:00:00,0,0,0,FMN GV 05 Lier
60,Mechelsesteenweg 365,2021-04-13,15:00:00,0,0,0,FMN GV 05 Lier
60,Mechelsesteenweg 365,2021-04-13,16:00:00,0,0,0,FMN GV 05 Lier
60,Mechelsesteenweg 365,2021-04-13,17:00:00,0,0,0,FMN GV 05 Lier
60,Mechelsesteenweg 365,2021-04-13,18:00:00,0,0,0,FMN GV 05 Lier
60,Mechelsesteenweg 365,2021-04-13,19:00:00,0,0,0,FMN GV 05 Lier
60,Mechelsesteenweg 365,2021-04-13,20:00:00,26,18,8,FMN GV 05 Lier
60,Mechelsesteenweg 365,2021-04-13,21:00:00,4,2,2,FMN GV 05 Lier
60,Mechelsesteenweg 365,2021-04-13,22:00:00,12,12,0,FMN GV 05 Lier
60,Mechelsesteenweg 365,2021-04-13,23:00:00,4,2,2,FMN GV 05 Lier
60,Mechelsesteenweg 365,2021-04-14,00:00:00,0,0,0,FMN GV 05 Lier
60,Mechelsesteenweg 365,2021-04-14,01:00:00,0,0,0,FMN GV 05 Lier
60,Mechelsesteenweg 365,2021-04-14,02:00:00,0,0,0,FMN GV 05 Lier
60,Mechelsesteenweg 365,2021-04-14,03:00:00,2,0,2,FMN GV 05 Lier
60,Mechelsesteenweg 365,2021-04-14,04:00:00,4,0,4,FMN GV 05 Lier
60,Mechelsesteenweg 365,2021-04-14,05:00:00,8,0,8,FMN GV 05 Lier
60,Mechelsesteenweg 365,2021-04-14,06:00:00,38,14,24,FMN GV 05 Lier
60,Mechelsesteenweg 365,2021-04-14,07:00:00,44,18,26,FMN GV 05 Lier
60,Mechelsesteenweg 365,2021-04-14,08:00:00,40,18,22,FMN GV 05 Lier
60,Mechelsesteenweg 365,2021-04-14,09:00:00,48,24,24,FMN GV 05 Lier
60,Mechelsesteenweg 365,2021-04-14,10:00:00,70,46,24,FMN GV 05 Lier
60,Mechelsesteenweg 365,2021-04-14,11:00:00,94,28,66,FMN GV 05 Lier
60,Mechelsesteenweg 365,2021-04-14,12:00:00,116,56,60,FMN GV 05 Lier
60,Mechelsesteenweg 365,2021-04-14,13:00:00,122,68,54,FMN GV 05 Lier
60,Mechelsesteenweg 365,2021-04-14,14:00:00,140,82,58,FMN GV 05 Lier
60,Mechelsesteenweg 365,2021-04-14,15:00:00,132,58,74,FMN GV 05 Lier
60,Mechelsesteenweg 365,2021-04-14,16:00:00,108,42,66,FMN GV 05 Lier
60,Mechelsesteenweg 365,2021-04-14,17:00:00,122,68,54,FMN GV 05 Lier
60,Mechelsesteenweg 365,2021-04-14,18:00:00,98,52,46,FMN GV 05 Lier
60,Mechelsesteenweg 365,2021-04-14,19:00:00,68,48,20,FMN GV 05 Lier
60,Mechelsesteenweg 365,2021-04-14,20:00:00,18,10,8,FMN GV 05 Lier
60,Mechelsesteenweg 365,2021-04-14,21:00:00,14,4,10,FMN GV 05 Lier
60,Mechelsesteenweg 365,2021-04-14,22:00:00,10,8,2,FMN GV 05 Lier
60,Mechelsesteenweg 365,2021-04-14,23:00:00,4,4,0,FMN GV 05 Lier
60,Mechelsesteenweg 365,2021-04-15,00:00:00,2,0,2,FMN GV 05 Lier
60,Mechelsesteenweg 365,2021-04-15,01:00:00,0,0,0,FMN GV 05 Lier
60,Mechelsesteenweg 365,2021-04-15,02:00:00,0,0,0,FMN GV 05 Lier
60,Mechelsesteenweg 365,2021-04-15,03:00:00,2,0,2,FMN GV 05 Lier
60,Mechelsesteenweg 365,2021-04-15,04:00:00,4,0,4,FMN GV 05 Lier
60,Mechelsesteenweg 365,2021-04-15,05:00:00,6,0,6,FMN GV 05 Lier
60,Mechelsesteenweg 365,2021-04-15,06:00:00,10,8,2,FMN GV 05 Lier
60,Mechelsesteenweg 365,2021-04-15,07:00:00,48,16,32,FMN GV 05 Lier
60,Mechelsesteenweg 365,2021-04-15,08:00:00,66,26,40,FMN GV 05 Lier
60,Mechelsesteenweg 365,2021-04-15,09:00:00,52,40,12,FMN GV 05 Lier
60,Mechelsesteenweg 365,2021-04-15,10:00:00,78,44,34,FMN GV 05 Lier
60,Mechelsesteenweg 365,2021-04-15,11:00:00,76,38,38,FMN GV 05 Lier
60,Mechelsesteenweg 365,2021-04-15,12:00:00,92,34,58,FMN GV 05 Lier
60,Mechelsesteenweg 365,2021-04-15,13:00:00,130,60,70,FMN GV 05 Lier
60,Mechelsesteenweg 365,2021-04-15,14:00:00,178,82,96,FMN GV 05 Lier
60,Mechelsesteenweg 365,2021-04-15,15:00:00,152,78,74,FMN GV 05 Lier
60,Mechelsesteenweg 365,2021-04-15,16:00:00,156,80,76,FMN GV 05 Lier
60,Mechelsesteenweg 365,2021-04-15,17:00:00,118,66,52,FMN GV 05 Lier
60,Mechelsesteenweg 365,2021-04-15,18:00:00,100,42,58,FMN GV 05 Lier
60,Mechelsesteenweg 365,2021-04-15,19:00:00,82,52,30,FMN GV 05 Lier
60,Mechelsesteenweg 365,2021-04-15,20:00:00,18,4,14,FMN GV 05 Lier
60,Mechelsesteenweg 365,2021-04-15,21:00:00,12,4,8,FMN GV 05 Lier
60,Mechelsesteenweg 365,2021-04-15,22:00:00,8,6,2,FMN GV 05 Lier
60,Mechelsesteenweg 365,2021-04-15,23:00:00,0,0,0,FMN GV 05 Lier
60,Mechelsesteenweg 365,2021-04-16,00:00:00,0,0,0,FMN GV 05 Lier
60,Mechelsesteenweg 365,2021-04-16,01:00:00,0,0,0,FMN GV 05 Lier
60,Mechelsesteenweg 365,2021-04-16,02:00:00,0,0,0,FMN GV 05 Lier
60,Mechelsesteenweg 365,2021-04-16,03:00:00,2,0,2,FMN GV 05 Lier
60,Mechelsesteenweg 365,2021-04-16,04:00:00,0,0,0,FMN GV 05 Lier
60,Mechelsesteenweg 365,2021-04-16,05:00:00,10,2,8,FMN GV 05 Lier
60,Mechelsesteenweg 365,2021-04-16,06:00:00,22,8,14,FMN GV 05 Lier
60,Mechelsesteenweg 365,2021-04-16,07:00:00,50,18,32,FMN GV 05 Lier
60,Mechelsesteenweg 365,2021-04-16,08:00:00,36,20,16,FMN GV 05 Lier
60,Mechelsesteenweg 365,2021-04-16,09:00:00,136,54,82,FMN GV 05 Lier
60,Mechelsesteenweg 365,2021-04-16,10:00:00,94,52,42,FMN GV 05 Lier
60,Mechelsesteenweg 365,2021-04-16,11:00:00,136,76,60,FMN GV 05 Lier
60,Mechelsesteenweg 365,2021-04-16,12:00:00,116,44,72,FMN GV 05 Lier
60,Mechelsesteenweg 365,2021-04-16,13:00:00,218,134,84,FMN GV 05 Lier
60,Mechelsesteenweg 365,2021-04-16,14:00:00,274,120,154,FMN GV 05 Lier
60,Mechelsesteenweg 365,2021-04-16,15:00:00,288,140,148,FMN GV 05 Lier
60,Mechelsesteenweg 365,2021-04-16,16:00:00,198,74,124,FMN GV 05 Lier
60,Mechelsesteenweg 365,2021-04-16,17:00:00,138,80,58,FMN GV 05 Lier
60,Mechelsesteenweg 365,2021-04-16,18:00:00,100,46,54,FMN GV 05 Lier
60,Mechelsesteenweg 365,2021-04-16,19:00:00,60,30,30,FMN GV 05 Lier
60,Mechelsesteenweg 365,2021-04-16,20:00:00,42,18,24,FMN GV 05 Lier
60,Mechelsesteenweg 365,2021-04-16,21:00:00,10,2,8,FMN GV 05 Lier
60,Mechelsesteenweg 365,2021-04-16,22:00:00,18,14,4,FMN GV 05 Lier
60,Mechelsesteenweg 365,2021-04-16,23:00:00,2,0,2,FMN GV 05 Lier
60,Mechelsesteenweg 365,2021-04-17,00:00:00,2,0,2,FMN GV 05 Lier
60,Mechelsesteenweg 365,2021-04-17,01:00:00,0,0,0,FMN GV 05 Lier
60,Mechelsesteenweg 365,2021-04-17,02:00:00,0,0,0,FMN GV 05 Lier
60,Mechelsesteenweg 365,2021-04-17,03:00:00,0,0,0,FMN GV 05 Lier
60,Mechelsesteenweg 365,2021-04-17,04:00:00,0,0,0,FMN GV 05 Lier
60,Mechelsesteenweg 365,2021-04-17,05:00:00,2,2,0,FMN GV 05 Lier
60,Mechelsesteenweg 365,2021-04-17,06:00:00,6,6,0,FMN GV 05 Lier
60,Mechelsesteenweg 365,2021-04-17,07:00:00,6,2,4,FMN GV 05 Lier
60,Mechelsesteenweg 365,2021-04-17,08:00:00,52,36,16,FMN GV 05 Lier
60,Mechelsesteenweg 365,2021-04-17,09:00:00,134,44,90,FMN GV 05 Lier
60,Mechelsesteenweg 365,2021-04-17,10:00:00,246,128,118,FMN GV 05 Lier
60,Mechelsesteenweg 365,2021-04-17,11:00:00,258,104,154,FMN GV 05 Lier
60,Mechelsesteenweg 365,2021-04-17,12:00:00,256,144,112,FMN GV 05 Lier
60,Mechelsesteenweg 365,2021-04-17,13:00:00,360,216,144,FMN GV 05 Lier
60,Mechelsesteenweg 365,2021-04-17,14:00:00,372,230,142,FMN GV 05 Lier
60,Mechelsesteenweg 365,2021-04-17,15:00:00,486,180,306,FMN GV 05 Lier
60,Mechelsesteenweg 365,2021-04-17,16:00:00,290,136,154,FMN GV 05 Lier
60,Mechelsesteenweg 365,2021-04-17,17:00:00,152,62,90,FMN GV 05 Lier
60,Mechelsesteenweg 365,2021-04-17,18:00:00,114,26,88,FMN GV 05 Lier
60,Mechelsesteenweg 365,2021-04-17,19:00:00,60,26,34,FMN GV 05 Lier
60,Mechelsesteenweg 365,2021-04-17,20:00:00,42,24,18,FMN GV 05 Lier
60,Mechelsesteenweg 365,2021-04-17,21:00:00,26,8,18,FMN GV 05 Lier
60,Mechelsesteenweg 365,2021-04-17,22:00:00,12,8,4,FMN GV 05 Lier
60,Mechelsesteenweg 365,2021-04-17,23:00:00,14,2,12,FMN GV 05 Lier
60,Mechelsesteenweg 365,2021-04-18,00:00:00,0,0,0,FMN GV 05 Lier
60,Mechelsesteenweg 365,2021-04-18,01:00:00,0,0,0,FMN GV 05 Lier
60,Mechelsesteenweg 365,2021-04-18,02:00:00,0,0,0,FMN GV 05 Lier
60,Mechelsesteenweg 365,2021-04-18,03:00:00,0,0,0,FMN GV 05 Lier
60,Mechelsesteenweg 365,2021-04-18,04:00:00,0,0,0,FMN GV 05 Lier
60,Mechelsesteenweg 365,2021-04-18,05:00:00,2,2,0,FMN GV 05 Lier
60,Mechelsesteenweg 365,2021-04-18,06:00:00,4,0,4,FMN GV 05 Lier
60,Mechelsesteenweg 365,2021-04-18,07:00:00,10,8,2,FMN GV 05 Lier
60,Mechelsesteenweg 365,2021-04-18,08:00:00,44,22,22,FMN GV 05 Lier
60,Mechelsesteenweg 365,2021-04-18,09:00:00,216,120,96,FMN GV 05 Lier
60,Mechelsesteenweg 365,2021-04-18,10:00:00,518,278,240,FMN GV 05 Lier
60,Mechelsesteenweg 365,2021-04-18,11:00:00,614,238,376,FMN GV 05 Lier
60,Mechelsesteenweg 365,2021-04-18,12:00:00,434,216,218,FMN GV 05 Lier
60,Mechelsesteenweg 365,2021-04-18,13:00:00,496,250,246,FMN GV 05 Lier
60,Mechelsesteenweg 365,2021-04-18,14:00:00,594,300,294,FMN GV 05 Lier
60,Mechelsesteenweg 365,2021-04-18,15:00:00,526,190,336,FMN GV 05 Lier
60,Mechelsesteenweg 365,2021-04-18,16:00:00,408,160,248,FMN GV 05 Lier
60,Mechelsesteenweg 365,2021-04-18,17:00:00,204,104,100,FMN GV 05 Lier
60,Mechelsesteenweg 365,2021-04-18,18:00:00,104,46,58,FMN GV 05 Lier
60,Mechelsesteenweg 365,2021-04-18,19:00:00,42,18,24,FMN GV 05 Lier
60,Mechelsesteenweg 365,2021-04-18,20:00:00,22,10,12,FMN GV 05 Lier
60,Mechelsesteenweg 365,2021-04-18,21:00:00,6,6,0,FMN GV 05 Lier
60,Mechelsesteenweg 365,2021-04-18,22:00:00,6,6,0,FMN GV 05 Lier
60,Mechelsesteenweg 365,2021-04-18,23:00:00,0,0,0,FMN GV 05 Lier
60,Mechelsesteenweg 365,2021-04-19,00:00:00,2,2,0,FMN GV 05 Lier
60,Mechelsesteenweg 365,2021-04-19,01:00:00,0,0,0,FMN GV 05 Lier
60,Mechelsesteenweg 365,2021-04-19,02:00:00,0,0,0,FMN GV 05 Lier
60,Mechelsesteenweg 365,2021-04-19,03:00:00,0,0,0,FMN GV 05 Lier
60,Mechelsesteenweg 365,2021-04-19,04:00:00,0,0,0,FMN GV 05 Lier
60,Mechelsesteenweg 365,2021-04-19,05:00:00,4,2,2,FMN GV 05 Lier
60,Mechelsesteenweg 365,2021-04-19,06:00:00,22,6,16,FMN GV 05 Lier
60,Mechelsesteenweg 365,2021-04-19,07:00:00,172,118,54,FMN GV 05 Lier
60,Mechelsesteenweg 365,2021-04-19,08:00:00,78,46,32,FMN GV 05 Lier
60,Mechelsesteenweg 365,2021-04-19,09:00:00,56,18,38,FMN GV 05 Lier
60,Mechelsesteenweg 365,2021-04-19,10:00:00,104,70,34,FMN GV 05 Lier
60,Mechelsesteenweg 365,2021-04-19,11:00:00,92,48,44,FMN GV 05 Lier
60,Mechelsesteenweg 365,2021-04-19,12:00:00,128,44,84,FMN GV 05 Lier
60,Mechelsesteenweg 365,2021-04-19,13:00:00,34,22,12,FMN GV 05 Lier
60,Mechelsesteenweg 365,2021-04-19,14:00:00,52,26,26,FMN GV 05 Lier
60,Mechelsesteenweg 365,2021-04-19,15:00:00,86,38,48,FMN GV 05 Lier
60,Mechelsesteenweg 365,2021-04-19,16:00:00,196,52,144,FMN GV 05 Lier
60,Mechelsesteenweg 365,2021-04-19,17:00:00,84,46,38,FMN GV 05 Lier
60,Mechelsesteenweg 365,2021-04-19,18:00:00,72,32,40,FMN GV 05 Lier
60,Mechelsesteenweg 365,2021-04-19,19:00:00,32,10,22,FMN GV 05 Lier
60,Mechelsesteenweg 365,2021-04-19,20:00:00,48,16,32,FMN GV 05 Lier
60,Mechelsesteenweg 365,2021-04-19,21:00:00,12,6,6,FMN GV 05 Lier
60,Mechelsesteenweg 365,2021-04-19,22:00:00,4,4,0,FMN GV 05 Lier
60,Mechelsesteenweg 365,2021-04-19,23:00:00,2,2,0,FMN GV 05 Lier
60,Mechelsesteenweg 365,2021-04-20,00:00:00,0,0,0,FMN GV 05 Lier
60,Mechelsesteenweg 365,2021-04-20,01:00:00,0,0,0,FMN GV 05 Lier
60,Mechelsesteenweg 365,2021-04-20,02:00:00,0,0,0,FMN GV 05 Lier
60,Mechelsesteenweg 365,2021-04-20,03:00:00,2,0,2,FMN GV 05 Lier
60,Mechelsesteenweg 365,2021-04-20,04:00:00,2,0,2,FMN GV 05 Lier
60,Mechelsesteenweg 365,2021-04-20,05:00:00,2,0,2,FMN GV 05 Lier
60,Mechelsesteenweg 365,2021-04-20,06:00:00,28,16,12,FMN GV 05 Lier
60,Mechelsesteenweg 365,2021-04-20,07:00:00,190,116,74,FMN GV 05 Lier
60,Mechelsesteenweg 365,2021-04-20,08:00:00,148,86,62,FMN GV 05 Lier
60,Mechelsesteenweg 365,2021-04-20,09:00:00,76,44,32,FMN GV 05 Lier
60,Mechelsesteenweg 365,2021-04-20,10:00:00,146,64,82,FMN GV 05 Lier
60,Mechelsesteenweg 365,2021-04-20,11:00:00,186,102,84,FMN GV 05 Lier
60,Mechelsesteenweg 365,2021-04-20,12:00:00,200,98,102,FMN GV 05 Lier
60,Mechelsesteenweg 365,2021-04-20,13:00:00,272,132,140,FMN GV 05 Lier
60,Mechelsesteenweg 365,2021-04-20,14:00:00,374,200,174,FMN GV 05 Lier
60,Mechelsesteenweg 365,2021-04-20,15:00:00,356,166,190,FMN GV 05 Lier
60,Mechelsesteenweg 365,2021-04-20,16:00:00,348,116,232,FMN GV 05 Lier
60,Mechelsesteenweg 365,2021-04-20,17:00:00,254,134,120,FMN GV 05 Lier
60,Mechelsesteenweg 365,2021-04-20,18:00:00,186,64,122,FMN GV 05 Lier
60,Mechelsesteenweg 365,2021-04-20,19:00:00,96,44,52,FMN GV 05 Lier
60,Mechelsesteenweg 365,2021-04-20,20:00:00,60,30,30,FMN GV 05 Lier
60,Mechelsesteenweg 365,2021-04-20,21:00:00,26,12,14,FMN GV 05 Lier
60,Mechelsesteenweg 365,2021-04-20,22:00:00,4,4,0,FMN GV 05 Lier
60,Mechelsesteenweg 365,2021-04-20,23:00:00,0,0,0,FMN GV 05 Lier
60,Mechelsesteenweg 365,2021-04-21,00:00:00,0,0,0,FMN GV 05 Lier
60,Mechelsesteenweg 365,2021-04-21,01:00:00,2,0,2,FMN GV 05 Lier
60,Mechelsesteenweg 365,2021-04-21,02:00:00,0,0,0,FMN GV 05 Lier
60,Mechelsesteenweg 365,2021-04-21,03:00:00,0,0,0,FMN GV 05 Lier
60,Mechelsesteenweg 365,2021-04-21,04:00:00,6,2,4,FMN GV 05 Lier
60,Mechelsesteenweg 365,2021-04-21,05:00:00,8,0,8,FMN GV 05 Lier
60,Mechelsesteenweg 365,2021-04-21,06:00:00,32,18,14,FMN GV 05 Lier
60,Mechelsesteenweg 365,2021-04-21,07:00:00,164,96,68,FMN GV 05 Lier
60,Mechelsesteenweg 365,2021-04-21,08:00:00,112,82,30,FMN GV 05 Lier
60,Mechelsesteenweg 365,2021-04-21,09:00:00,92,50,42,FMN GV 05 Lier
60,Mechelsesteenweg 365,2021-04-21,10:00:00,94,66,28,FMN GV 05 Lier
60,Mechelsesteenweg 365,2021-04-21,11:00:00,116,48,68,FMN GV 05 Lier
60,Mechelsesteenweg 365,2021-04-21,12:00:00,252,66,186,FMN GV 05 Lier
60,Mechelsesteenweg 365,2021-04-21,13:00:00,172,70,102,FMN GV 05 Lier
60,Mechelsesteenweg 365,2021-04-21,14:00:00,232,96,136,FMN GV 05 Lier
60,Mechelsesteenweg 365,2021-04-21,15:00:00,306,116,190,FMN GV 05 Lier
60,Mechelsesteenweg 365,2021-04-21,16:00:00,222,146,76,FMN GV 05 Lier
60,Mechelsesteenweg 365,2021-04-21,17:00:00,154,88,66,FMN GV 05 Lier
60,Mechelsesteenweg 365,2021-04-21,18:00:00,210,112,98,FMN GV 05 Lier
60,Mechelsesteenweg 365,2021-04-21,19:00:00,138,82,56,FMN GV 05 Lier
60,Mechelsesteenweg 365,2021-04-21,20:00:00,78,50,28,FMN GV 05 Lier
60,Mechelsesteenweg 365,2021-04-21,21:00:00,34,12,22,FMN GV 05 Lier
60,Mechelsesteenweg 365,2021-04-21,22:00:00,6,4,2,FMN GV 05 Lier
60,Mechelsesteenweg 365,2021-04-21,23:00:00,0,0,0,FMN GV 05 Lier
60,Mechelsesteenweg 365,2021-04-22,00:00:00,0,0,0,FMN GV 05 Lier
60,Mechelsesteenweg 365,2021-04-22,01:00:00,0,0,0,FMN GV 05 Lier
60,Mechelsesteenweg 365,2021-04-22,02:00:00,0,0,0,FMN GV 05 Lier
60,Mechelsesteenweg 365,2021-04-22,03:00:00,2,0,2,FMN GV 05 Lier
60,Mechelsesteenweg 365,2021-04-22,04:00:00,4,0,4,FMN GV 05 Lier
60,Mechelsesteenweg 365,2021-04-22,05:00:00,10,2,8,FMN GV 05 Lier
60,Mechelsesteenweg 365,2021-04-22,06:00:00,38,22,16,FMN GV 05 Lier
60,Mechelsesteenweg 365,2021-04-22,07:00:00,168,92,76,FMN GV 05 Lier
60,Mechelsesteenweg 365,2021-04-22,08:00:00,138,88,50,FMN GV 05 Lier
60,Mechelsesteenweg 365,2021-04-22,09:00:00,74,50,24,FMN GV 05 Lier
60,Mechelsesteenweg 365,2021-04-22,10:00:00,116,56,60,FMN GV 05 Lier
60,Mechelsesteenweg 365,2021-04-22,11:00:00,120,54,66,FMN GV 05 Lier
60,Mechelsesteenweg 365,2021-04-22,12:00:00,108,40,68,FMN GV 05 Lier
60,Mechelsesteenweg 365,2021-04-22,13:00:00,176,94,82,FMN GV 05 Lier
60,Mechelsesteenweg 365,2021-04-22,14:00:00,298,164,134,FMN GV 05 Lier
60,Mechelsesteenweg 365,2021-04-22,15:00:00,266,116,150,FMN GV 05 Lier
60,Mechelsesteenweg 365,2021-04-22,16:00:00,296,112,184,FMN GV 05 Lier
60,Mechelsesteenweg 365,2021-04-22,17:00:00,212,104,108,FMN GV 05 Lier
60,Mechelsesteenweg 365,2021-04-22,18:00:00,186,106,80,FMN GV 05 Lier
60,Mechelsesteenweg 365,2021-04-22,19:00:00,158,112,46,FMN GV 05 Lier
60,Mechelsesteenweg 365,2021-04-22,20:00:00,80,24,56,FMN GV 05 Lier
60,Mechelsesteenweg 365,2021-04-22,21:00:00,14,4,10,FMN GV 05 Lier
60,Mechelsesteenweg 365,2021-04-22,22:00:00,2,0,2,FMN GV 05 Lier
60,Mechelsesteenweg 365,2021-04-22,23:00:00,2,0,2,FMN GV 05 Lier
60,Mechelsesteenweg 365,2021-04-23,00:00:00,0,0,0,FMN GV 05 Lier
60,Mechelsesteenweg 365,2021-04-23,01:00:00,0,0,0,FMN GV 05 Lier
60,Mechelsesteenweg 365,2021-04-23,02:00:00,0,0,0,FMN GV 05 Lier
60,Mechelsesteenweg 365,2021-04-23,03:00:00,2,0,2,FMN GV 05 Lier
60,Mechelsesteenweg 365,2021-04-23,04:00:00,2,0,2,FMN GV 05 Lier
60,Mechelsesteenweg 365,2021-04-23,05:00:00,4,2,2,FMN GV 05 Lier
60,Mechelsesteenweg 365,2021-04-23,06:00:00,50,20,30,FMN GV 05 Lier
60,Mechelsesteenweg 365,2021-04-23,07:00:00,164,108,56,FMN GV 05 Lier
60,Mechelsesteenweg 365,2021-04-23,08:00:00,126,82,44,FMN GV 05 Lier
60,Mechelsesteenweg 365,2021-04-23,09:00:00,72,44,28,FMN GV 05 Lier
60,Mechelsesteenweg 365,2021-04-23,10:00:00,78,30,48,FMN GV 05 Lier
60,Mechelsesteenweg 365,2021-04-23,11:00:00,126,64,62,FMN GV 05 Lier
60,Mechelsesteenweg 365,2021-04-23,12:00:00,146,68,78,FMN GV 05 Lier
60,Mechelsesteenweg 365,2021-04-23,13:00:00,214,110,104,FMN GV 05 Lier
60,Mechelsesteenweg 365,2021-04-23,14:00:00,286,166,120,FMN GV 05 Lier
60,Mechelsesteenweg 365,2021-04-23,15:00:00,374,148,226,FMN GV 05 Lier
60,Mechelsesteenweg 365,2021-04-23,16:00:00,390,136,254,FMN GV 05 Lier
60,Mechelsesteenweg 365,2021-04-23,17:00:00,200,122,78,FMN GV 05 Lier
60,Mechelsesteenweg 365,2021-04-23,18:00:00,136,62,74,FMN GV 05 Lier
60,Mechelsesteenweg 365,2021-04-23,19:00:00,90,56,34,FMN GV 05 Lier
60,Mechelsesteenweg 365,2021-04-23,20:00:00,64,30,34,FMN GV 05 Lier
60,Mechelsesteenweg 365,2021-04-23,21:00:00,30,10,20,FMN GV 05 Lier
60,Mechelsesteenweg 365,2021-04-23,22:00:00,4,2,2,FMN GV 05 Lier
60,Mechelsesteenweg 365,2021-04-23,23:00:00,10,6,4,FMN GV 05 Lier
60,Mechelsesteenweg 365,2021-04-24,00:00:00,2,0,2,FMN GV 05 Lier
60,Mechelsesteenweg 365,2021-04-24,01:00:00,0,0,0,FMN GV 05 Lier
60,Mechelsesteenweg 365,2021-04-24,02:00:00,0,0,0,FMN GV 05 Lier
60,Mechelsesteenweg 365,2021-04-24,03:00:00,0,0,0,FMN GV 05 Lier
60,Mechelsesteenweg 365,2021-04-24,04:00:00,4,0,4,FMN GV 05 Lier
60,Mechelsesteenweg 365,2021-04-24,05:00:00,2,2,0,FMN GV 05 Lier
60,Mechelsesteenweg 365,2021-04-24,06:00:00,10,4,6,FMN GV 05 Lier
60,Mechelsesteenweg 365,2021-04-24,07:00:00,18,10,8,FMN GV 05 Lier
60,Mechelsesteenweg 365,2021-04-24,08:00:00,28,22,6,FMN GV 05 Lier
60,Mechelsesteenweg 365,2021-04-24,09:00:00,76,36,40,FMN GV 05 Lier
60,Mechelsesteenweg 365,2021-04-24,10:00:00,160,92,68,FMN GV 05 Lier
60,Mechelsesteenweg 365,2021-04-24,11:00:00,320,156,164,FMN GV 05 Lier
60,Mechelsesteenweg 365,2021-04-24,12:00:00,262,90,172,FMN GV 05 Lier
60,Mechelsesteenweg 365,2021-04-24,13:00:00,298,124,174,FMN GV 05 Lier
60,Mechelsesteenweg 365,2021-04-24,14:00:00,408,188,220,FMN GV 05 Lier
60,Mechelsesteenweg 365,2021-04-24,15:00:00,500,238,262,FMN GV 05 Lier
60,Mechelsesteenweg 365,2021-04-24,16:00:00,302,98,204,FMN GV 05 Lier
60,Mechelsesteenweg 365,2021-04-24,17:00:00,194,84,110,FMN GV 05 Lier
60,Mechelsesteenweg 365,2021-04-24,18:00:00,84,24,60,FMN GV 05 Lier
60,Mechelsesteenweg 365,2021-04-24,19:00:00,40,16,24,FMN GV 05 Lier
60,Mechelsesteenweg 365,2021-04-24,20:00:00,52,14,38,FMN GV 05 Lier
60,Mechelsesteenweg 365,2021-04-24,21:00:00,4,4,0,FMN GV 05 Lier
60,Mechelsesteenweg 365,2021-04-24,22:00:00,12,6,6,FMN GV 05 Lier
60,Mechelsesteenweg 365,2021-04-24,23:00:00,4,2,2,FMN GV 05 Lier
60,Mechelsesteenweg 365,2021-04-25,00:00:00,0,0,0,FMN GV 05 Lier
60,Mechelsesteenweg 365,2021-04-25,01:00:00,0,0,0,FMN GV 05 Lier
60,Mechelsesteenweg 365,2021-04-25,02:00:00,0,0,0,FMN GV 05 Lier
60,Mechelsesteenweg 365,2021-04-25,03:00:00,0,0,0,FMN GV 05 Lier
60,Mechelsesteenweg 365,2021-04-25,04:00:00,0,0,0,FMN GV 05 Lier
60,Mechelsesteenweg 365,2021-04-25,05:00:00,6,2,4,FMN GV 05 Lier
60,Mechelsesteenweg 365,2021-04-25,06:00:00,14,8,6,FMN GV 05 Lier
60,Mechelsesteenweg 365,2021-04-25,07:00:00,8,4,4,FMN GV 05 Lier
60,Mechelsesteenweg 365,2021-04-25,08:00:00,54,26,28,FMN GV 05 Lier
60,Mechelsesteenweg 365,2021-04-25,09:00:00,230,132,98,FMN GV 05 Lier
60,Mechelsesteenweg 365,2021-04-25,10:00:00,506,248,258,FMN GV 05 Lier
60,Mechelsesteenweg 365,2021-04-25,11:00:00,508,156,352,FMN GV 05 Lier
60,Mechelsesteenweg 365,2021-04-25,12:00:00,286,122,164,FMN GV 05 Lier
60,Mechelsesteenweg 365,2021-04-25,13:00:00,332,134,198,FMN GV 05 Lier
60,Mechelsesteenweg 365,2021-04-25,14:00:00,424,240,184,FMN GV 05 Lier
60,Mechelsesteenweg 365,2021-04-25,15:00:00,402,174,228,FMN GV 05 Lier
60,Mechelsesteenweg 365,2021-04-25,16:00:00,278,112,166,FMN GV 05 Lier
60,Mechelsesteenweg 365,2021-04-25,17:00:00,206,110,96,FMN GV 05 Lier
60,Mechelsesteenweg 365,2021-04-25,18:00:00,82,28,54,FMN GV 05 Lier
60,Mechelsesteenweg 365,2021-04-25,19:00:00,62,30,32,FMN GV 05 Lier
60,Mechelsesteenweg 365,2021-04-25,20:00:00,14,4,10,FMN GV 05 Lier
60,Mechelsesteenweg 365,2021-04-25,21:00:00,12,2,10,FMN GV 05 Lier
60,Mechelsesteenweg 365,2021-04-25,22:00:00,0,0,0,FMN GV 05 Lier
60,Mechelsesteenweg 365,2021-04-25,23:00:00,0,0,0,FMN GV 05 Lier
60,Mechelsesteenweg 365,2021-04-26,00:00:00,0,0,0,FMN GV 05 Lier
60,Mechelsesteenweg 365,2021-04-26,01:00:00,0,0,0,FMN GV 05 Lier
60,Mechelsesteenweg 365,2021-04-26,02:00:00,0,0,0,FMN GV 05 Lier
60,Mechelsesteenweg 365,2021-04-26,03:00:00,2,0,2,FMN GV 05 Lier
60,Mechelsesteenweg 365,2021-04-26,04:00:00,0,0,0,FMN GV 05 Lier
60,Mechelsesteenweg 365,2021-04-26,05:00:00,14,0,14,FMN GV 05 Lier
60,Mechelsesteenweg 365,2021-04-26,06:00:00,20,10,10,FMN GV 05 Lier
60,Mechelsesteenweg 365,2021-04-26,07:00:00,154,88,66,FMN GV 05 Lier
60,Mechelsesteenweg 365,2021-04-26,08:00:00,118,80,38,FMN GV 05 Lier
60,Mechelsesteenweg 365,2021-04-26,09:00:00,40,16,24,FMN GV 05 Lier
60,Mechelsesteenweg 365,2021-04-26,10:00:00,74,38,36,FMN GV 05 Lier
60,Mechelsesteenweg 365,2021-04-26,11:00:00,96,40,56,FMN GV 05 Lier
60,Mechelsesteenweg 365,2021-04-26,12:00:00,130,60,70,FMN GV 05 Lier
60,Mechelsesteenweg 365,2021-04-26,13:00:00,172,90,82,FMN GV 05 Lier
60,Mechelsesteenweg 365,2021-04-26,14:00:00,262,130,132,FMN GV 05 Lier
60,Mechelsesteenweg 365,2021-04-26,15:00:00,240,88,152,FMN GV 05 Lier
60,Mechelsesteenweg 365,2021-04-26,16:00:00,280,98,182,FMN GV 05 Lier
60,Mechelsesteenweg 365,2021-04-26,17:00:00,144,76,68,FMN GV 05 Lier
60,Mechelsesteenweg 365,2021-04-26,18:00:00,140,78,62,FMN GV 05 Lier
60,Mechelsesteenweg 365,2021-04-26,19:00:00,72,28,44,FMN GV 05 Lier
60,Mechelsesteenweg 365,2021-04-26,20:00:00,46,24,22,FMN GV 05 Lier
60,Mechelsesteenweg 365,2021-04-26,21:00:00,18,6,12,FMN GV 05 Lier
60,Mechelsesteenweg 365,2021-04-26,22:00:00,4,4,0,FMN GV 05 Lier
60,Mechelsesteenweg 365,2021-04-26,23:00:00,4,4,0,FMN GV 05 Lier
60,Mechelsesteenweg 365,2021-04-27,00:00:00,0,0,0,FMN GV 05 Lier
60,Mechelsesteenweg 365,2021-04-27,01:00:00,0,0,0,FMN GV 05 Lier
60,Mechelsesteenweg 365,2021-04-27,02:00:00,0,0,0,FMN GV 05 Lier
60,Mechelsesteenweg 365,2021-04-27,03:00:00,2,0,2,FMN GV 05 Lier
60,Mechelsesteenweg 365,2021-04-27,04:00:00,2,0,2,FMN GV 05 Lier
60,Mechelsesteenweg 365,2021-04-27,05:00:00,12,2,10,FMN GV 05 Lier
60,Mechelsesteenweg 365,2021-04-27,06:00:00,34,16,18,FMN GV 05 Lier
60,Mechelsesteenweg 365,2021-04-27,07:00:00,196,96,100,FMN GV 05 Lier
60,Mechelsesteenweg 365,2021-04-27,08:00:00,126,100,26,FMN GV 05 Lier
60,Mechelsesteenweg 365,2021-04-27,09:00:00,84,38,46,FMN GV 05 Lier
60,Mechelsesteenweg 365,2021-04-27,10:00:00,146,80,66,FMN GV 05 Lier
60,Mechelsesteenweg 365,2021-04-27,11:00:00,174,88,86,FMN GV 05 Lier
60,Mechelsesteenweg 365,2021-04-27,12:00:00,170,94,76,FMN GV 05 Lier
60,Mechelsesteenweg 365,2021-04-27,13:00:00,270,128,142,FMN GV 05 Lier
60,Mechelsesteenweg 365,2021-04-27,14:00:00,374,204,170,FMN GV 05 Lier
60,Mechelsesteenweg 365,2021-04-27,15:00:00,358,168,190,FMN GV 05 Lier
60,Mechelsesteenweg 365,2021-04-27,16:00:00,404,134,270,FMN GV 05 Lier
60,Mechelsesteenweg 365,2021-04-27,17:00:00,212,106,106,FMN GV 05 Lier
60,Mechelsesteenweg 365,2021-04-27,18:00:00,158,58,100,FMN GV 05 Lier
60,Mechelsesteenweg 365,2021-04-27,19:00:00,160,78,82,FMN GV 05 Lier
60,Mechelsesteenweg 365,2021-04-27,20:00:00,118,48,70,FMN GV 05 Lier
60,Mechelsesteenweg 365,2021-04-27,21:00:00,28,16,12,FMN GV 05 Lier
60,Mechelsesteenweg 365,2021-04-27,22:00:00,10,10,0,FMN GV 05 Lier
60,Mechelsesteenweg 365,2021-04-27,23:00:00,0,0,0,FMN GV 05 Lier
60,Mechelsesteenweg 365,2021-04-28,00:00:00,0,0,0,FMN GV 05 Lier
60,Mechelsesteenweg 365,2021-04-28,01:00:00,0,0,0,FMN GV 05 Lier
60,Mechelsesteenweg 365,2021-04-28,02:00:00,0,0,0,FMN GV 05 Lier
60,Mechelsesteenweg 365,2021-04-28,03:00:00,2,0,2,FMN GV 05 Lier
60,Mechelsesteenweg 365,2021-04-28,04:00:00,0,0,0,FMN GV 05 Lier
60,Mechelsesteenweg 365,2021-04-28,05:00:00,16,0,16,FMN GV 05 Lier
60,Mechelsesteenweg 365,2021-04-28,06:00:00,22,10,12,FMN GV 05 Lier
60,Mechelsesteenweg 365,2021-04-28,07:00:00,202,114,88,FMN GV 05 Lier
60,Mechelsesteenweg 365,2021-04-28,08:00:00,154,104,50,FMN GV 05 Lier
60,Mechelsesteenweg 365,2021-04-28,09:00:00,100,60,40,FMN GV 05 Lier
60,Mechelsesteenweg 365,2021-04-28,10:00:00,180,72,108,FMN GV 05 Lier
60,Mechelsesteenweg 365,2021-04-28,11:00:00,140,60,80,FMN GV 05 Lier
60,Mechelsesteenweg 365,2021-04-28,12:00:00,298,102,196,FMN GV 05 Lier
60,Mechelsesteenweg 365,2021-04-28,13:00:00,260,134,126,FMN GV 05 Lier
60,Mechelsesteenweg 365,2021-04-28,14:00:00,384,214,170,FMN GV 05 Lier
60,Mechelsesteenweg 365,2021-04-28,15:00:00,428,188,240,FMN GV 05 Lier
60,Mechelsesteenweg 365,2021-04-28,16:00:00,376,164,212,FMN GV 05 Lier
60,Mechelsesteenweg 365,2021-04-28,17:00:00,274,164,110,FMN GV 05 Lier
60,Mechelsesteenweg 365,2021-04-28,18:00:00,218,96,122,FMN GV 05 Lier
60,Mechelsesteenweg 365,2021-04-28,19:00:00,150,60,90,FMN GV 05 Lier
60,Mechelsesteenweg 365,2021-04-28,20:00:00,128,66,62,FMN GV 05 Lier
60,Mechelsesteenweg 365,2021-04-28,21:00:00,20,14,6,FMN GV 05 Lier
60,Mechelsesteenweg 365,2021-04-28,22:00:00,12,6,6,FMN GV 05 Lier
60,Mechelsesteenweg 365,2021-04-28,23:00:00,4,2,2,FMN GV 05 Lier
60,Mechelsesteenweg 365,2021-04-29,00:00:00,0,0,0,FMN GV 05 Lier
60,Mechelsesteenweg 365,2021-04-29,01:00:00,0,0,0,FMN GV 05 Lier
60,Mechelsesteenweg 365,2021-04-29,02:00:00,0,0,0,FMN GV 05 Lier
60,Mechelsesteenweg 365,2021-04-29,03:00:00,2,0,2,FMN GV 05 Lier
60,Mechelsesteenweg 365,2021-04-29,04:00:00,0,0,0,FMN GV 05 Lier
60,Mechelsesteenweg 365,2021-04-29,05:00:00,8,0,8,FMN GV 05 Lier
60,Mechelsesteenweg 365,2021-04-29,06:00:00,14,8,6,FMN GV 05 Lier
60,Mechelsesteenweg 365,2021-04-29,07:00:00,154,102,52,FMN GV 05 Lier
60,Mechelsesteenweg 365,2021-04-29,08:00:00,102,76,26,FMN GV 05 Lier
60,Mechelsesteenweg 365,2021-04-29,09:00:00,12,8,4,FMN GV 05 Lier
60,Mechelsesteenweg 365,2021-04-29,10:00:00,10,4,6,FMN GV 05 Lier
60,Mechelsesteenweg 365,2021-04-29,11:00:00,12,8,4,FMN GV 05 Lier
60,Mechelsesteenweg 365,2021-04-29,12:00:00,34,22,12,FMN GV 05 Lier
60,Mechelsesteenweg 365,2021-04-29,13:00:00,20,10,10,FMN GV 05 Lier
60,Mechelsesteenweg 365,2021-04-29,14:00:00,40,20,20,FMN GV 05 Lier
60,Mechelsesteenweg 365,2021-04-29,15:00:00,54,20,34,FMN GV 05 Lier
60,Mechelsesteenweg 365,2021-04-29,16:00:00,166,46,120,FMN GV 05 Lier
60,Mechelsesteenweg 365,2021-04-29,17:00:00,92,56,36,FMN GV 05 Lier
60,Mechelsesteenweg 365,2021-04-29,18:00:00,58,36,22,FMN GV 05 Lier
60,Mechelsesteenweg 365,2021-04-29,19:00:00,120,50,70,FMN GV 05 Lier
60,Mechelsesteenweg 365,2021-04-29,20:00:00,76,42,34,FMN GV 05 Lier
60,Mechelsesteenweg 365,2021-04-29,21:00:00,12,8,4,FMN GV 05 Lier
60,Mechelsesteenweg 365,2021-04-29,22:00:00,0,0,0,FMN GV 05 Lier
60,Mechelsesteenweg 365,2021-04-29,23:00:00,0,0,0,FMN GV 05 Lier
60,Mechelsesteenweg 365,2021-04-30,00:00:00,0,0,0,FMN GV 05 Lier
60,Mechelsesteenweg 365,2021-04-30,01:00:00,0,0,0,FMN GV 05 Lier
60,Mechelsesteenweg 365,2021-04-30,02:00:00,0,0,0,FMN GV 05 Lier
60,Mechelsesteenweg 365,2021-04-30,03:00:00,2,0,2,FMN GV 05 Lier
60,Mechelsesteenweg 365,2021-04-30,04:00:00,0,0,0,FMN GV 05 Lier
60,Mechelsesteenweg 365,2021-04-30,05:00:00,6,0,6,FMN GV 05 Lier
60,Mechelsesteenweg 365,2021-04-30,06:00:00,22,6,16,FMN GV 05 Lier
60,Mechelsesteenweg 365,2021-04-30,07:00:00,156,96,60,FMN GV 05 Lier
60,Mechelsesteenweg 365,2021-04-30,08:00:00,192,70,122,FMN GV 05 Lier
60,Mechelsesteenweg 365,2021-04-30,09:00:00,260,44,216,FMN GV 05 Lier
60,Mechelsesteenweg 365,2021-04-30,10:00:00,212,130,82,FMN GV 05 Lier
60,Mechelsesteenweg 365,2021-04-30,11:00:00,132,114,18,FMN GV 05 Lier
60,Mechelsesteenweg 365,2021-04-30,12:00:00,98,62,36,FMN GV 05 Lier
60,Mechelsesteenweg 365,2021-04-30,13:00:00,124,66,58,FMN GV 05 Lier
60,Mechelsesteenweg 365,2021-04-30,14:00:00,180,106,74,FMN GV 05 Lier
60,Mechelsesteenweg 365,2021-04-30,15:00:00,302,196,106,FMN GV 05 Lier
60,Mechelsesteenweg 365,2021-04-30,16:00:00,268,106,162,FMN GV 05 Lier
60,Mechelsesteenweg 365,2021-04-30,17:00:00,116,64,52,FMN GV 05 Lier
60,Mechelsesteenweg 365,2021-04-30,18:00:00,90,40,50,FMN GV 05 Lier
60,Mechelsesteenweg 365,2021-04-30,19:00:00,28,16,12,FMN GV 05 Lier
60,Mechelsesteenweg 365,2021-04-30,20:00:00,44,26,18,FMN GV 05 Lier
60,Mechelsesteenweg 365,2021-04-30,21:00:00,18,6,12,FMN GV 05 Lier
60,Mechelsesteenweg 365,2021-04-30,22:00:00,6,2,4,FMN GV 05 Lier
60,Mechelsesteenweg 365,2021-04-30,23:00:00,10,4,6,FMN GV 05 Lier
60,Mechelsesteenweg 365,2021-05-01,00:00:00,0,0,0,FMN GV 05 Lier
60,Mechelsesteenweg 365,2021-05-01,01:00:00,0,0,0,FMN GV 05 Lier
60,Mechelsesteenweg 365,2021-05-01,02:00:00,0,0,0,FMN GV 05 Lier
60,Mechelsesteenweg 365,2021-05-01,03:00:00,0,0,0,FMN GV 05 Lier
60,Mechelsesteenweg 365,2021-05-01,04:00:00,0,0,0,FMN GV 05 Lier
60,Mechelsesteenweg 365,2021-05-01,05:00:00,2,2,0,FMN GV 05 Lier
60,Mechelsesteenweg 365,2021-05-01,06:00:00,12,6,6,FMN GV 05 Lier
60,Mechelsesteenweg 365,2021-05-01,07:00:00,2,2,0,FMN GV 05 Lier
60,Mechelsesteenweg 365,2021-05-01,08:00:00,22,14,8,FMN GV 05 Lier
60,Mechelsesteenweg 365,2021-05-01,09:00:00,90,48,42,FMN GV 05 Lier
60,Mechelsesteenweg 365,2021-05-01,10:00:00,220,116,104,FMN GV 05 Lier
60,Mechelsesteenweg 365,2021-05-01,11:00:00,312,118,194,FMN GV 05 Lier
60,Mechelsesteenweg 365,2021-05-01,12:00:00,218,84,134,FMN GV 05 Lier
60,Mechelsesteenweg 365,2021-05-01,13:00:00,226,128,98,FMN GV 05 Lier
60,Mechelsesteenweg 365,2021-05-01,14:00:00,370,198,172,FMN GV 05 Lier
60,Mechelsesteenweg 365,2021-05-01,15:00:00,280,158,122,FMN GV 05 Lier
60,Mechelsesteenweg 365,2021-05-01,16:00:00,206,104,102,FMN GV 05 Lier
60,Mechelsesteenweg 365,2021-05-01,17:00:00,162,74,88,FMN GV 05 Lier
60,Mechelsesteenweg 365,2021-05-01,18:00:00,62,24,38,FMN GV 05 Lier
60,Mechelsesteenweg 365,2021-05-01,19:00:00,44,14,30,FMN GV 05 Lier
60,Mechelsesteenweg 365,2021-05-01,20:00:00,44,26,18,FMN GV 05 Lier
60,Mechelsesteenweg 365,2021-05-01,21:00:00,6,2,4,FMN GV 05 Lier
60,Mechelsesteenweg 365,2021-05-01,22:00:00,2,2,0,FMN GV 05 Lier
60,Mechelsesteenweg 365,2021-05-01,23:00:00,6,4,2,FMN GV 05 Lier
60,Mechelsesteenweg 365,2021-05-02,00:00:00,2,2,0,FMN GV 05 Lier
60,Mechelsesteenweg 365,2021-05-02,01:00:00,0,0,0,FMN GV 05 Lier
60,Mechelsesteenweg 365,2021-05-02,02:00:00,0,0,0,FMN GV 05 Lier
60,Mechelsesteenweg 365,2021-05-02,03:00:00,0,0,0,FMN GV 05 Lier
60,Mechelsesteenweg 365,2021-05-02,04:00:00,0,0,0,FMN GV 05 Lier
60,Mechelsesteenweg 365,2021-05-02,05:00:00,0,0,0,FMN GV 05 Lier
60,Mechelsesteenweg 365,2021-05-02,06:00:00,2,2,0,FMN GV 05 Lier
60,Mechelsesteenweg 365,2021-05-02,07:00:00,2,2,0,FMN GV 05 Lier
60,Mechelsesteenweg 365,2021-05-02,08:00:00,80,42,38,FMN GV 05 Lier
60,Mechelsesteenweg 365,2021-05-02,09:00:00,218,90,128,FMN GV 05 Lier
60,Mechelsesteenweg 365,2021-05-02,10:00:00,482,204,278,FMN GV 05 Lier
60,Mechelsesteenweg 365,2021-05-02,11:00:00,404,230,174,FMN GV 05 Lier
60,Mechelsesteenweg 365,2021-05-02,12:00:00,288,168,120,FMN GV 05 Lier
60,Mechelsesteenweg 365,2021-05-02,13:00:00,210,134,76,FMN GV 05 Lier
60,Mechelsesteenweg 365,2021-05-02,14:00:00,328,178,150,FMN GV 05 Lier
60,Mechelsesteenweg 365,2021-05-02,15:00:00,254,100,154,FMN GV 05 Lier
60,Mechelsesteenweg 365,2021-05-02,16:00:00,168,42,126,FMN GV 05 Lier
60,Mechelsesteenweg 365,2021-05-02,17:00:00,112,56,56,FMN GV 05 Lier
60,Mechelsesteenweg 365,2021-05-02,18:00:00,42,12,30,FMN GV 05 Lier
60,Mechelsesteenweg 365,2021-05-02,19:00:00,36,10,26,FMN GV 05 Lier
60,Mechelsesteenweg 365,2021-05-02,20:00:00,8,8,0,FMN GV 05 Lier
60,Mechelsesteenweg 365,2021-05-02,21:00:00,2,0,2,FMN GV 05 Lier
60,Mechelsesteenweg 365,2021-05-02,22:00:00,0,0,0,FMN GV 05 Lier
60,Mechelsesteenweg 365,2021-05-02,23:00:00,2,2,0,FMN GV 05 Lier
60,Mechelsesteenweg 365,2021-05-03,00:00:00,0,0,0,FMN GV 05 Lier
60,Mechelsesteenweg 365,2021-05-03,01:00:00,0,0,0,FMN GV 05 Lier
60,Mechelsesteenweg 365,2021-05-03,02:00:00,0,0,0,FMN GV 05 Lier
60,Mechelsesteenweg 365,2021-05-03,03:00:00,2,0,2,FMN GV 05 Lier
60,Mechelsesteenweg 365,2021-05-03,04:00:00,2,0,2,FMN GV 05 Lier
60,Mechelsesteenweg 365,2021-05-03,05:00:00,8,2,6,FMN GV 05 Lier
60,Mechelsesteenweg 365,2021-05-03,06:00:00,22,10,12,FMN GV 05 Lier
60,Mechelsesteenweg 365,2021-05-03,07:00:00,174,112,62,FMN GV 05 Lier
60,Mechelsesteenweg 365,2021-05-03,08:00:00,98,52,46,FMN GV 05 Lier
60,Mechelsesteenweg 365,2021-05-03,09:00:00,52,26,26,FMN GV 05 Lier
60,Mechelsesteenweg 365,2021-05-03,10:00:00,60,28,32,FMN GV 05 Lier
60,Mechelsesteenweg 365,2021-05-03,11:00:00,68,34,34,FMN GV 05 Lier
60,Mechelsesteenweg 365,2021-05-03,12:00:00,132,74,58,FMN GV 05 Lier
60,Mechelsesteenweg 365,2021-05-03,13:00:00,114,60,54,FMN GV 05 Lier
60,Mechelsesteenweg 365,2021-05-03,14:00:00,166,116,50,FMN GV 05 Lier
60,Mechelsesteenweg 365,2021-05-03,15:00:00,232,112,120,FMN GV 05 Lier
60,Mechelsesteenweg 365,2021-05-03,16:00:00,234,90,144,FMN GV 05 Lier
60,Mechelsesteenweg 365,2021-05-03,17:00:00,150,86,64,FMN GV 05 Lier
60,Mechelsesteenweg 365,2021-05-03,18:00:00,70,44,26,FMN GV 05 Lier
60,Mechelsesteenweg 365,2021-05-03,19:00:00,40,24,16,FMN GV 05 Lier
60,Mechelsesteenweg 365,2021-05-03,20:00:00,44,20,24,FMN GV 05 Lier
60,Mechelsesteenweg 365,2021-05-03,21:00:00,16,8,8,FMN GV 05 Lier
60,Mechelsesteenweg 365,2021-05-03,22:00:00,6,2,4,FMN GV 05 Lier
60,Mechelsesteenweg 365,2021-05-03,23:00:00,0,0,0,FMN GV 05 Lier
60,Mechelsesteenweg 365,2021-05-04,00:00:00,0,0,0,FMN GV 05 Lier
60,Mechelsesteenweg 365,2021-05-04,01:00:00,0,0,0,FMN GV 05 Lier
60,Mechelsesteenweg 365,2021-05-04,02:00:00,0,0,0,FMN GV 05 Lier
60,Mechelsesteenweg 365,2021-05-04,03:00:00,2,0,2,FMN GV 05 Lier
60,Mechelsesteenweg 365,2021-05-04,04:00:00,2,0,2,FMN GV 05 Lier
60,Mechelsesteenweg 365,2021-05-04,05:00:00,2,2,0,FMN GV 05 Lier
60,Mechelsesteenweg 365,2021-05-04,06:00:00,8,4,4,FMN GV 05 Lier
60,Mechelsesteenweg 365,2021-05-04,07:00:00,86,60,26,FMN GV 05 Lier
60,Mechelsesteenweg 365,2021-05-04,08:00:00,56,40,16,FMN GV 05 Lier
60,Mechelsesteenweg 365,2021-05-04,09:00:00,6,2,4,FMN GV 05 Lier
60,Mechelsesteenweg 365,2021-05-04,10:00:00,30,28,2,FMN GV 05 Lier
60,Mechelsesteenweg 365,2021-05-04,11:00:00,14,10,4,FMN GV 05 Lier
60,Mechelsesteenweg 365,2021-05-04,12:00:00,24,10,14,FMN GV 05 Lier
60,Mechelsesteenweg 365,2021-05-04,13:00:00,22,16,6,FMN GV 05 Lier
60,Mechelsesteenweg 365,2021-05-04,14:00:00,42,40,2,FMN GV 05 Lier
60,Mechelsesteenweg 365,2021-05-04,15:00:00,50,20,30,FMN GV 05 Lier
60,Mechelsesteenweg 365,2021-05-04,16:00:00,70,18,52,FMN GV 05 Lier
60,Mechelsesteenweg 365,2021-05-04,17:00:00,46,36,10,FMN GV 05 Lier
60,Mechelsesteenweg 365,2021-05-04,18:00:00,12,2,10,FMN GV 05 Lier
60,Mechelsesteenweg 365,2021-05-04,19:00:00,14,0,14,FMN GV 05 Lier
60,Mechelsesteenweg 365,2021-05-04,20:00:00,2,0,2,FMN GV 05 Lier
60,Mechelsesteenweg 365,2021-05-04,21:00:00,6,0,6,FMN GV 05 Lier
60,Mechelsesteenweg 365,2021-05-04,22:00:00,4,2,2,FMN GV 05 Lier
60,Mechelsesteenweg 365,2021-05-04,23:00:00,0,0,0,FMN GV 05 Lier
60,Mechelsesteenweg 365,2021-05-05,00:00:00,0,0,0,FMN GV 05 Lier
60,Mechelsesteenweg 365,2021-05-05,01:00:00,0,0,0,FMN GV 05 Lier
60,Mechelsesteenweg 365,2021-05-05,02:00:00,0,0,0,FMN GV 05 Lier
60,Mechelsesteenweg 365,2021-05-05,03:00:00,2,0,2,FMN GV 05 Lier
60,Mechelsesteenweg 365,2021-05-05,04:00:00,2,0,2,FMN GV 05 Lier
60,Mechelsesteenweg 365,2021-05-05,05:00:00,8,4,4,FMN GV 05 Lier
60,Mechelsesteenweg 365,2021-05-05,06:00:00,14,4,10,FMN GV 05 Lier
60,Mechelsesteenweg 365,2021-05-05,07:00:00,114,60,54,FMN GV 05 Lier
60,Mechelsesteenweg 365,2021-05-05,08:00:00,58,44,14,FMN GV 05 Lier
60,Mechelsesteenweg 365,2021-05-05,09:00:00,6,2,4,FMN GV 05 Lier
60,Mechelsesteenweg 365,2021-05-05,10:00:00,10,6,4,FMN GV 05 Lier
60,Mechelsesteenweg 365,2021-05-05,11:00:00,38,20,18,FMN GV 05 Lier
60,Mechelsesteenweg 365,2021-05-05,12:00:00,100,20,80,FMN GV 05 Lier
60,Mechelsesteenweg 365,2021-05-05,13:00:00,48,20,28,FMN GV 05 Lier
60,Mechelsesteenweg 365,2021-05-05,14:00:00,64,34,30,FMN GV 05 Lier
60,Mechelsesteenweg 365,2021-05-05,15:00:00,94,56,38,FMN GV 05 Lier
60,Mechelsesteenweg 365,2021-05-05,16:00:00,76,48,28,FMN GV 05 Lier
60,Mechelsesteenweg 365,2021-05-05,17:00:00,98,66,32,FMN GV 05 Lier
60,Mechelsesteenweg 365,2021-05-05,18:00:00,54,30,24,FMN GV 05 Lier
60,Mechelsesteenweg 365,2021-05-05,19:00:00,78,50,28,FMN GV 05 Lier
60,Mechelsesteenweg 365,2021-05-05,20:00:00,74,66,8,FMN GV 05 Lier
60,Mechelsesteenweg 365,2021-05-05,21:00:00,12,4,8,FMN GV 05 Lier
60,Mechelsesteenweg 365,2021-05-05,22:00:00,2,0,2,FMN GV 05 Lier
60,Mechelsesteenweg 365,2021-05-05,23:00:00,2,2,0,FMN GV 05 Lier
60,Mechelsesteenweg 365,2021-05-06,00:00:00,0,0,0,FMN GV 05 Lier
60,Mechelsesteenweg 365,2021-05-06,01:00:00,0,0,0,FMN GV 05 Lier
60,Mechelsesteenweg 365,2021-05-06,02:00:00,0,0,0,FMN GV 05 Lier
60,Mechelsesteenweg 365,2021-05-06,03:00:00,2,0,2,FMN GV 05 Lier
60,Mechelsesteenweg 365,2021-05-06,04:00:00,2,0,2,FMN GV 05 Lier
60,Mechelsesteenweg 365,2021-05-06,05:00:00,10,4,6,FMN GV 05 Lier
60,Mechelsesteenweg 365,2021-05-06,06:00:00,14,4,10,FMN GV 05 Lier
60,Mechelsesteenweg 365,2021-05-06,07:00:00,136,92,44,FMN GV 05 Lier
60,Mechelsesteenweg 365,2021-05-06,08:00:00,130,72,58,FMN GV 05 Lier
60,Mechelsesteenweg 365,2021-05-06,09:00:00,76,36,40,FMN GV 05 Lier
60,Mechelsesteenweg 365,2021-05-06,10:00:00,152,90,62,FMN GV 05 Lier
60,Mechelsesteenweg 365,2021-05-06,11:00:00,124,60,64,FMN GV 05 Lier
60,Mechelsesteenweg 365,2021-05-06,12:00:00,84,42,42,FMN GV 05 Lier
60,Mechelsesteenweg 365,2021-05-06,13:00:00,80,36,44,FMN GV 05 Lier
60,Mechelsesteenweg 365,2021-05-06,14:00:00,96,72,24,FMN GV 05 Lier
60,Mechelsesteenweg 365,2021-05-06,15:00:00,120,64,56,FMN GV 05 Lier
60,Mechelsesteenweg 365,2021-05-06,16:00:00,178,68,110,FMN GV 05 Lier
60,Mechelsesteenweg 365,2021-05-06,17:00:00,86,48,38,FMN GV 05 Lier
60,Mechelsesteenweg 365,2021-05-06,18:00:00,30,14,16,FMN GV 05 Lier
60,Mechelsesteenweg 365,2021-05-06,19:00:00,42,26,16,FMN GV 05 Lier
60,Mechelsesteenweg 365,2021-05-06,20:00:00,18,8,10,FMN GV 05 Lier
60,Mechelsesteenweg 365,2021-05-06,21:00:00,6,4,2,FMN GV 05 Lier
60,Mechelsesteenweg 365,2021-05-06,22:00:00,6,4,2,FMN GV 05 Lier
60,Mechelsesteenweg 365,2021-05-06,23:00:00,0,0,0,FMN GV 05 Lier
60,Mechelsesteenweg 365,2021-05-07,00:00:00,0,0,0,FMN GV 05 Lier
60,Mechelsesteenweg 365,2021-05-07,01:00:00,0,0,0,FMN GV 05 Lier
60,Mechelsesteenweg 365,2021-05-07,02:00:00,2,0,2,FMN GV 05 Lier
60,Mechelsesteenweg 365,2021-05-07,03:00:00,2,0,2,FMN GV 05 Lier
60,Mechelsesteenweg 365,2021-05-07,04:00:00,2,0,2,FMN GV 05 Lier
60,Mechelsesteenweg 365,2021-05-07,05:00:00,10,2,8,FMN GV 05 Lier
60,Mechelsesteenweg 365,2021-05-07,06:00:00,14,6,8,FMN GV 05 Lier
60,Mechelsesteenweg 365,2021-05-07,07:00:00,132,88,44,FMN GV 05 Lier
60,Mechelsesteenweg 365,2021-05-07,08:00:00,92,60,32,FMN GV 05 Lier
60,Mechelsesteenweg 365,2021-05-07,09:00:00,48,22,26,FMN GV 05 Lier
60,Mechelsesteenweg 365,2021-05-07,10:00:00,76,48,28,FMN GV 05 Lier
60,Mechelsesteenweg 365,2021-05-07,11:00:00,94,40,54,FMN GV 05 Lier
60,Mechelsesteenweg 365,2021-05-07,12:00:00,82,46,36,FMN GV 05 Lier
60,Mechelsesteenweg 365,2021-05-07,13:00:00,104,44,60,FMN GV 05 Lier
60,Mechelsesteenweg 365,2021-05-07,14:00:00,230,150,80,FMN GV 05 Lier
60,Mechelsesteenweg 365,2021-05-07,15:00:00,244,96,148,FMN GV 05 Lier
60,Mechelsesteenweg 365,2021-05-07,16:00:00,226,86,140,FMN GV 05 Lier
60,Mechelsesteenweg 365,2021-05-07,17:00:00,150,94,56,FMN GV 05 Lier
60,Mechelsesteenweg 365,2021-05-07,18:00:00,138,64,74,FMN GV 05 Lier
60,Mechelsesteenweg 365,2021-05-07,19:00:00,84,36,48,FMN GV 05 Lier
60,Mechelsesteenweg 365,2021-05-07,20:00:00,88,58,30,FMN GV 05 Lier
60,Mechelsesteenweg 365,2021-05-07,21:00:00,28,18,10,FMN GV 05 Lier
60,Mechelsesteenweg 365,2021-05-07,22:00:00,22,14,8,FMN GV 05 Lier
60,Mechelsesteenweg 365,2021-05-07,23:00:00,28,0,28,FMN GV 05 Lier
60,Mechelsesteenweg 365,2021-05-08,00:00:00,8,2,6,FMN GV 05 Lier
60,Mechelsesteenweg 365,2021-05-08,01:00:00,0,0,0,FMN GV 05 Lier
60,Mechelsesteenweg 365,2021-05-08,02:00:00,2,0,2,FMN GV 05 Lier
60,Mechelsesteenweg 365,2021-05-08,03:00:00,0,0,0,FMN GV 05 Lier
60,Mechelsesteenweg 365,2021-05-08,04:00:00,0,0,0,FMN GV 05 Lier
60,Mechelsesteenweg 365,2021-05-08,05:00:00,4,2,2,FMN GV 05 Lier
60,Mechelsesteenweg 365,2021-05-08,06:00:00,14,8,6,FMN GV 05 Lier
60,Mechelsesteenweg 365,2021-05-08,07:00:00,22,12,10,FMN GV 05 Lier
60,Mechelsesteenweg 365,2021-05-08,08:00:00,38,28,10,FMN GV 05 Lier
60,Mechelsesteenweg 365,2021-05-08,09:00:00,74,30,44,FMN GV 05 Lier
60,Mechelsesteenweg 365,2021-05-08,10:00:00,44,18,26,FMN GV 05 Lier
60,Mechelsesteenweg 365,2021-05-08,11:00:00,102,48,54,FMN GV 05 Lier
60,Mechelsesteenweg 365,2021-05-08,12:00:00,50,10,40,FMN GV 05 Lier
60,Mechelsesteenweg 365,2021-05-08,13:00:00,54,26,28,FMN GV 05 Lier
60,Mechelsesteenweg 365,2021-05-08,14:00:00,84,50,34,FMN GV 05 Lier
60,Mechelsesteenweg 365,2021-05-08,15:00:00,120,80,40,FMN GV 05 Lier
60,Mechelsesteenweg 365,2021-05-08,16:00:00,74,44,30,FMN GV 05 Lier
60,Mechelsesteenweg 365,2021-05-08,17:00:00,90,54,36,FMN GV 05 Lier
60,Mechelsesteenweg 365,2021-05-08,18:00:00,26,14,12,FMN GV 05 Lier
60,Mechelsesteenweg 365,2021-05-08,19:00:00,44,30,14,FMN GV 05 Lier
60,Mechelsesteenweg 365,2021-05-08,20:00:00,32,16,16,FMN GV 05 Lier
60,Mechelsesteenweg 365,2021-05-08,21:00:00,24,8,16,FMN GV 05 Lier
60,Mechelsesteenweg 365,2021-05-08,22:00:00,6,6,0,FMN GV 05 Lier
60,Mechelsesteenweg 365,2021-05-08,23:00:00,10,4,6,FMN GV 05 Lier
60,Mechelsesteenweg 365,2021-05-09,00:00:00,4,2,2,FMN GV 05 Lier
60,Mechelsesteenweg 365,2021-05-09,01:00:00,10,0,10,FMN GV 05 Lier
60,Mechelsesteenweg 365,2021-05-09,02:00:00,2,0,2,FMN GV 05 Lier
60,Mechelsesteenweg 365,2021-05-09,03:00:00,0,0,0,FMN GV 05 Lier
60,Mechelsesteenweg 365,2021-05-09,04:00:00,0,0,0,FMN GV 05 Lier
60,Mechelsesteenweg 365,2021-05-09,05:00:00,4,2,2,FMN GV 05 Lier
60,Mechelsesteenweg 365,2021-05-09,06:00:00,4,2,2,FMN GV 05 Lier
60,Mechelsesteenweg 365,2021-05-09,07:00:00,10,4,6,FMN GV 05 Lier
60,Mechelsesteenweg 365,2021-05-09,08:00:00,114,80,34,FMN GV 05 Lier
60,Mechelsesteenweg 365,2021-05-09,09:00:00,200,114,86,FMN GV 05 Lier
60,Mechelsesteenweg 365,2021-05-09,10:00:00,502,272,230,FMN GV 05 Lier
60,Mechelsesteenweg 365,2021-05-09,11:00:00,482,222,260,FMN GV 05 Lier
60,Mechelsesteenweg 365,2021-05-09,12:00:00,372,198,174,FMN GV 05 Lier
60,Mechelsesteenweg 365,2021-05-09,13:00:00,162,76,86,FMN GV 05 Lier
60,Mechelsesteenweg 365,2021-05-09,14:00:00,436,224,212,FMN GV 05 Lier
60,Mechelsesteenweg 365,2021-05-09,15:00:00,496,294,202,FMN GV 05 Lier
60,Mechelsesteenweg 365,2021-05-09,16:00:00,314,140,174,FMN GV 05 Lier
60,Mechelsesteenweg 365,2021-05-09,17:00:00,202,86,116,FMN GV 05 Lier
60,Mechelsesteenweg 365,2021-05-09,18:00:00,62,30,32,FMN GV 05 Lier
60,Mechelsesteenweg 365,2021-05-09,19:00:00,56,20,36,FMN GV 05 Lier
60,Mechelsesteenweg 365,2021-05-09,20:00:00,50,20,30,FMN GV 05 Lier
60,Mechelsesteenweg 365,2021-05-09,21:00:00,12,4,8,FMN GV 05 Lier
60,Mechelsesteenweg 365,2021-05-09,22:00:00,4,2,2,FMN GV 05 Lier
60,Mechelsesteenweg 365,2021-05-09,23:00:00,0,0,0,FMN GV 05 Lier
60,Mechelsesteenweg 365,2021-05-10,00:00:00,0,0,0,FMN GV 05 Lier
60,Mechelsesteenweg 365,2021-05-10,01:00:00,0,0,0,FMN GV 05 Lier
60,Mechelsesteenweg 365,2021-05-10,02:00:00,0,0,0,FMN GV 05 Lier
60,Mechelsesteenweg 365,2021-05-10,03:00:00,2,0,2,FMN GV 05 Lier
60,Mechelsesteenweg 365,2021-05-10,04:00:00,2,0,2,FMN GV 05 Lier
60,Mechelsesteenweg 365,2021-05-10,05:00:00,0,0,0,FMN GV 05 Lier
60,Mechelsesteenweg 365,2021-05-10,06:00:00,16,6,10,FMN GV 05 Lier
60,Mechelsesteenweg 365,2021-05-10,07:00:00,146,100,46,FMN GV 05 Lier
60,Mechelsesteenweg 365,2021-05-10,08:00:00,104,68,36,FMN GV 05 Lier
60,Mechelsesteenweg 365,2021-05-10,09:00:00,26,18,8,FMN GV 05 Lier
60,Mechelsesteenweg 365,2021-05-10,10:00:00,50,26,24,FMN GV 05 Lier
60,Mechelsesteenweg 365,2021-05-10,11:00:00,34,18,16,FMN GV 05 Lier
60,Mechelsesteenweg 365,2021-05-10,12:00:00,50,32,18,FMN GV 05 Lier
60,Mechelsesteenweg 365,2021-05-10,13:00:00,80,28,52,FMN GV 05 Lier
60,Mechelsesteenweg 365,2021-05-10,14:00:00,128,68,60,FMN GV 05 Lier
60,Mechelsesteenweg 365,2021-05-10,15:00:00,150,96,54,FMN GV 05 Lier
60,Mechelsesteenweg 365,2021-05-10,16:00:00,230,92,138,FMN GV 05 Lier
60,Mechelsesteenweg 365,2021-05-10,17:00:00,120,74,46,FMN GV 05 Lier
60,Mechelsesteenweg 365,2021-05-10,18:00:00,90,56,34,FMN GV 05 Lier
60,Mechelsesteenweg 365,2021-05-10,19:00:00,106,50,56,FMN GV 05 Lier
60,Mechelsesteenweg 365,2021-05-10,20:00:00,68,44,24,FMN GV 05 Lier
60,Mechelsesteenweg 365,2021-05-10,21:00:00,24,8,16,FMN GV 05 Lier
60,Mechelsesteenweg 365,2021-05-10,22:00:00,10,8,2,FMN GV 05 Lier
60,Mechelsesteenweg 365,2021-05-10,23:00:00,2,2,0,FMN GV 05 Lier
60,Mechelsesteenweg 365,2021-05-11,00:00:00,0,0,0,FMN GV 05 Lier
60,Mechelsesteenweg 365,2021-05-11,01:00:00,0,0,0,FMN GV 05 Lier
60,Mechelsesteenweg 365,2021-05-11,02:00:00,0,0,0,FMN GV 05 Lier
60,Mechelsesteenweg 365,2021-05-11,03:00:00,2,0,2,FMN GV 05 Lier
60,Mechelsesteenweg 365,2021-05-11,04:00:00,2,0,2,FMN GV 05 Lier
60,Mechelsesteenweg 365,2021-05-11,05:00:00,4,2,2,FMN GV 05 Lier
60,Mechelsesteenweg 365,2021-05-11,06:00:00,36,14,22,FMN GV 05 Lier
60,Mechelsesteenweg 365,2021-05-11,07:00:00,198,112,86,FMN GV 05 Lier
60,Mechelsesteenweg 365,2021-05-11,08:00:00,158,104,54,FMN GV 05 Lier
60,Mechelsesteenweg 365,2021-05-11,09:00:00,128,64,64,FMN GV 05 Lier
60,Mechelsesteenweg 365,2021-05-11,10:00:00,202,108,94,FMN GV 05 Lier
60,Mechelsesteenweg 365,2021-05-11,11:00:00,182,104,78,FMN GV 05 Lier
60,Mechelsesteenweg 365,2021-05-11,12:00:00,154,98,56,FMN GV 05 Lier
60,Mechelsesteenweg 365,2021-05-11,13:00:00,102,36,66,FMN GV 05 Lier
60,Mechelsesteenweg 365,2021-05-11,14:00:00,152,96,56,FMN GV 05 Lier
60,Mechelsesteenweg 365,2021-05-11,15:00:00,124,40,84,FMN GV 05 Lier
60,Mechelsesteenweg 365,2021-05-11,16:00:00,176,46,130,FMN GV 05 Lier
60,Mechelsesteenweg 365,2021-05-11,17:00:00,74,56,18,FMN GV 05 Lier
60,Mechelsesteenweg 365,2021-05-11,18:00:00,44,32,12,FMN GV 05 Lier
60,Mechelsesteenweg 365,2021-05-11,19:00:00,48,26,22,FMN GV 05 Lier
60,Mechelsesteenweg 365,2021-05-11,20:00:00,22,8,14,FMN GV 05 Lier
60,Mechelsesteenweg 365,2021-05-11,21:00:00,10,10,0,FMN GV 05 Lier
60,Mechelsesteenweg 365,2021-05-11,22:00:00,6,4,2,FMN GV 05 Lier
60,Mechelsesteenweg 365,2021-05-11,23:00:00,0,0,0,FMN GV 05 Lier
60,Mechelsesteenweg 365,2021-05-12,00:00:00,0,0,0,FMN GV 05 Lier
60,Mechelsesteenweg 365,2021-05-12,01:00:00,0,0,0,FMN GV 05 Lier
60,Mechelsesteenweg 365,2021-05-12,02:00:00,0,0,0,FMN GV 05 Lier
60,Mechelsesteenweg 365,2021-05-12,03:00:00,2,0,2,FMN GV 05 Lier
60,Mechelsesteenweg 365,2021-05-12,04:00:00,4,0,4,FMN GV 05 Lier
60,Mechelsesteenweg 365,2021-05-12,05:00:00,6,0,6,FMN GV 05 Lier
60,Mechelsesteenweg 365,2021-05-12,06:00:00,18,6,12,FMN GV 05 Lier
60,Mechelsesteenweg 365,2021-05-12,07:00:00,152,80,72,FMN GV 05 Lier
60,Mechelsesteenweg 365,2021-05-12,08:00:00,134,100,34,FMN GV 05 Lier
60,Mechelsesteenweg 365,2021-05-12,09:00:00,108,72,36,FMN GV 05 Lier
60,Mechelsesteenweg 365,2021-05-12,10:00:00,142,68,74,FMN GV 05 Lier
60,Mechelsesteenweg 365,2021-05-12,11:00:00,158,84,74,FMN GV 05 Lier
60,Mechelsesteenweg 365,2021-05-12,12:00:00,276,116,160,FMN GV 05 Lier
60,Mechelsesteenweg 365,2021-05-12,13:00:00,180,68,112,FMN GV 05 Lier
60,Mechelsesteenweg 365,2021-05-12,14:00:00,128,68,60,FMN GV 05 Lier
60,Mechelsesteenweg 365,2021-05-12,15:00:00,136,56,80,FMN GV 05 Lier
60,Mechelsesteenweg 365,2021-05-12,16:00:00,126,76,50,FMN GV 05 Lier
60,Mechelsesteenweg 365,2021-05-12,17:00:00,134,76,58,FMN GV 05 Lier
60,Mechelsesteenweg 365,2021-05-12,18:00:00,98,54,44,FMN GV 05 Lier
60,Mechelsesteenweg 365,2021-05-12,19:00:00,122,74,48,FMN GV 05 Lier
60,Mechelsesteenweg 365,2021-05-12,20:00:00,98,66,32,FMN GV 05 Lier
60,Mechelsesteenweg 365,2021-05-12,21:00:00,20,14,6,FMN GV 05 Lier
60,Mechelsesteenweg 365,2021-05-12,22:00:00,14,4,10,FMN GV 05 Lier
60,Mechelsesteenweg 365,2021-05-12,23:00:00,2,0,2,FMN GV 05 Lier
60,Mechelsesteenweg 365,2021-05-13,00:00:00,0,0,0,FMN GV 05 Lier
60,Mechelsesteenweg 365,2021-05-13,01:00:00,0,0,0,FMN GV 05 Lier
60,Mechelsesteenweg 365,2021-05-13,02:00:00,0,0,0,FMN GV 05 Lier
60,Mechelsesteenweg 365,2021-05-13,03:00:00,0,0,0,FMN GV 05 Lier
60,Mechelsesteenweg 365,2021-05-13,04:00:00,0,0,0,FMN GV 05 Lier
60,Mechelsesteenweg 365,2021-05-13,05:00:00,2,0,2,FMN GV 05 Lier
60,Mechelsesteenweg 365,2021-05-13,06:00:00,10,4,6,FMN GV 05 Lier
60,Mechelsesteenweg 365,2021-05-13,07:00:00,22,10,12,FMN GV 05 Lier
60,Mechelsesteenweg 365,2021-05-13,08:00:00,44,14,30,FMN GV 05 Lier
60,Mechelsesteenweg 365,2021-05-13,09:00:00,154,90,64,FMN GV 05 Lier
60,Mechelsesteenweg 365,2021-05-13,10:00:00,248,112,136,FMN GV 05 Lier
60,Mechelsesteenweg 365,2021-05-13,11:00:00,496,266,230,FMN GV 05 Lier
60,Mechelsesteenweg 365,2021-05-13,12:00:00,276,102,174,FMN GV 05 Lier
60,Mechelsesteenweg 365,2021-05-13,13:00:00,262,140,122,FMN GV 05 Lier
60,Mechelsesteenweg 365,2021-05-13,14:00:00,370,236,134,FMN GV 05 Lier
60,Mechelsesteenweg 365,2021-05-13,15:00:00,146,46,100,FMN GV 05 Lier
60,Mechelsesteenweg 365,2021-05-13,16:00:00,180,90,90,FMN GV 05 Lier
60,Mechelsesteenweg 365,2021-05-13,17:00:00,118,46,72,FMN GV 05 Lier
60,Mechelsesteenweg 365,2021-05-13,18:00:00,54,26,28,FMN GV 05 Lier
60,Mechelsesteenweg 365,2021-05-13,19:00:00,76,44,32,FMN GV 05 Lier
60,Mechelsesteenweg 365,2021-05-13,20:00:00,50,22,28,FMN GV 05 Lier
60,Mechelsesteenweg 365,2021-05-13,21:00:00,26,10,16,FMN GV 05 Lier
60,Mechelsesteenweg 365,2021-05-13,22:00:00,8,4,4,FMN GV 05 Lier
60,Mechelsesteenweg 365,2021-05-13,23:00:00,4,2,2,FMN GV 05 Lier
60,Mechelsesteenweg 365,2021-05-14,00:00:00,2,0,2,FMN GV 05 Lier
60,Mechelsesteenweg 365,2021-05-14,01:00:00,0,0,0,FMN GV 05 Lier
60,Mechelsesteenweg 365,2021-05-14,02:00:00,0,0,0,FMN GV 05 Lier
60,Mechelsesteenweg 365,2021-05-14,03:00:00,4,2,2,FMN GV 05 Lier
60,Mechelsesteenweg 365,2021-05-14,04:00:00,0,0,0,FMN GV 05 Lier
60,Mechelsesteenweg 365,2021-05-14,05:00:00,6,0,6,FMN GV 05 Lier
60,Mechelsesteenweg 365,2021-05-14,06:00:00,20,12,8,FMN GV 05 Lier
60,Mechelsesteenweg 365,2021-05-14,07:00:00,36,12,24,FMN GV 05 Lier
60,Mechelsesteenweg 365,2021-05-14,08:00:00,46,28,18,FMN GV 05 Lier
60,Mechelsesteenweg 365,2021-05-14,09:00:00,152,82,70,FMN GV 05 Lier
60,Mechelsesteenweg 365,2021-05-14,10:00:00,270,136,134,FMN GV 05 Lier
60,Mechelsesteenweg 365,2021-05-14,11:00:00,296,164,132,FMN GV 05 Lier
60,Mechelsesteenweg 365,2021-05-14,12:00:00,146,66,80,FMN GV 05 Lier
60,Mechelsesteenweg 365,2021-05-14,13:00:00,92,38,54,FMN GV 05 Lier
60,Mechelsesteenweg 365,2021-05-14,14:00:00,136,80,56,FMN GV 05 Lier
60,Mechelsesteenweg 365,2021-05-14,15:00:00,80,52,28,FMN GV 05 Lier
60,Mechelsesteenweg 365,2021-05-14,16:00:00,96,48,48,FMN GV 05 Lier
60,Mechelsesteenweg 365,2021-05-14,17:00:00,62,28,34,FMN GV 05 Lier
60,Mechelsesteenweg 365,2021-05-14,18:00:00,28,14,14,FMN GV 05 Lier
60,Mechelsesteenweg 365,2021-05-14,19:00:00,40,18,22,FMN GV 05 Lier
60,Mechelsesteenweg 365,2021-05-14,20:00:00,46,26,20,FMN GV 05 Lier
60,Mechelsesteenweg 365,2021-05-14,21:00:00,18,12,6,FMN GV 05 Lier
60,Mechelsesteenweg 365,2021-05-14,22:00:00,6,2,4,FMN GV 05 Lier
60,Mechelsesteenweg 365,2021-05-14,23:00:00,4,0,4,FMN GV 05 Lier
60,Mechelsesteenweg 365,2021-05-15,00:00:00,0,0,0,FMN GV 05 Lier
60,Mechelsesteenweg 365,2021-05-15,01:00:00,0,0,0,FMN GV 05 Lier
60,Mechelsesteenweg 365,2021-05-15,02:00:00,2,0,2,FMN GV 05 Lier
60,Mechelsesteenweg 365,2021-05-15,03:00:00,2,2,0,FMN GV 05 Lier
60,Mechelsesteenweg 365,2021-05-15,04:00:00,0,0,0,FMN GV 05 Lier
60,Mechelsesteenweg 365,2021-05-15,05:00:00,2,0,2,FMN GV 05 Lier
60,Mechelsesteenweg 365,2021-05-15,06:00:00,8,4,4,FMN GV 05 Lier
60,Mechelsesteenweg 365,2021-05-15,07:00:00,14,6,8,FMN GV 05 Lier
60,Mechelsesteenweg 365,2021-05-15,08:00:00,52,28,24,FMN GV 05 Lier
60,Mechelsesteenweg 365,2021-05-15,09:00:00,88,50,38,FMN GV 05 Lier
60,Mechelsesteenweg 365,2021-05-15,10:00:00,106,62,44,FMN GV 05 Lier
60,Mechelsesteenweg 365,2021-05-15,11:00:00,150,76,74,FMN GV 05 Lier
60,Mechelsesteenweg 365,2021-05-15,12:00:00,60,16,44,FMN GV 05 Lier
60,Mechelsesteenweg 365,2021-05-15,13:00:00,34,18,16,FMN GV 05 Lier
60,Mechelsesteenweg 365,2021-05-15,14:00:00,30,20,10,FMN GV 05 Lier
60,Mechelsesteenweg 365,2021-05-15,15:00:00,66,26,40,FMN GV 05 Lier
60,Mechelsesteenweg 365,2021-05-15,16:00:00,46,28,18,FMN GV 05 Lier
60,Mechelsesteenweg 365,2021-05-15,17:00:00,40,18,22,FMN GV 05 Lier
60,Mechelsesteenweg 365,2021-05-15,18:00:00,32,10,22,FMN GV 05 Lier
60,Mechelsesteenweg 365,2021-05-15,19:00:00,54,26,28,FMN GV 05 Lier
60,Mechelsesteenweg 365,2021-05-15,20:00:00,64,30,34,FMN GV 05 Lier
60,Mechelsesteenweg 365,2021-05-15,21:00:00,12,6,6,FMN GV 05 Lier
60,Mechelsesteenweg 365,2021-05-15,22:00:00,12,6,6,FMN GV 05 Lier
60,Mechelsesteenweg 365,2021-05-15,23:00:00,2,0,2,FMN GV 05 Lier
60,Mechelsesteenweg 365,2021-05-16,00:00:00,2,2,0,FMN GV 05 Lier
60,Mechelsesteenweg 365,2021-05-16,01:00:00,0,0,0,FMN GV 05 Lier
60,Mechelsesteenweg 365,2021-05-16,02:00:00,0,0,0,FMN GV 05 Lier
60,Mechelsesteenweg 365,2021-05-16,03:00:00,0,0,0,FMN GV 05 Lier
60,Mechelsesteenweg 365,2021-05-16,04:00:00,0,0,0,FMN GV 05 Lier
60,Mechelsesteenweg 365,2021-05-16,05:00:00,0,0,0,FMN GV 05 Lier
60,Mechelsesteenweg 365,2021-05-16,06:00:00,4,0,4,FMN GV 05 Lier
60,Mechelsesteenweg 365,2021-05-16,07:00:00,12,6,6,FMN GV 05 Lier
60,Mechelsesteenweg 365,2021-05-16,08:00:00,88,42,46,FMN GV 05 Lier
60,Mechelsesteenweg 365,2021-05-16,09:00:00,222,156,66,FMN GV 05 Lier
60,Mechelsesteenweg 365,2021-05-16,10:00:00,372,208,164,FMN GV 05 Lier
60,Mechelsesteenweg 365,2021-05-16,11:00:00,330,170,160,FMN GV 05 Lier
60,Mechelsesteenweg 365,2021-05-16,12:00:00,120,56,64,FMN GV 05 Lier
60,Mechelsesteenweg 365,2021-05-16,13:00:00,80,46,34,FMN GV 05 Lier
60,Mechelsesteenweg 365,2021-05-16,14:00:00,244,176,68,FMN GV 05 Lier
60,Mechelsesteenweg 365,2021-05-16,15:00:00,46,22,24,FMN GV 05 Lier
60,Mechelsesteenweg 365,2021-05-16,16:00:00,58,36,22,FMN GV 05 Lier
60,Mechelsesteenweg 365,2021-05-16,17:00:00,86,20,66,FMN GV 05 Lier
60,Mechelsesteenweg 365,2021-05-16,18:00:00,38,18,20,FMN GV 05 Lier
60,Mechelsesteenweg 365,2021-05-16,19:00:00,32,20,12,FMN GV 05 Lier
60,Mechelsesteenweg 365,2021-05-16,20:00:00,30,16,14,FMN GV 05 Lier
60,Mechelsesteenweg 365,2021-05-16,21:00:00,12,2,10,FMN GV 05 Lier
60,Mechelsesteenweg 365,2021-05-16,22:00:00,0,0,0,FMN GV 05 Lier
60,Mechelsesteenweg 365,2021-05-16,23:00:00,0,0,0,FMN GV 05 Lier
60,Mechelsesteenweg 365,2021-05-17,00:00:00,0,0,0,FMN GV 05 Lier
60,Mechelsesteenweg 365,2021-05-17,01:00:00,0,0,0,FMN GV 05 Lier
60,Mechelsesteenweg 365,2021-05-17,02:00:00,0,0,0,FMN GV 05 Lier
60,Mechelsesteenweg 365,2021-05-17,03:00:00,0,0,0,FMN GV 05 Lier
60,Mechelsesteenweg 365,2021-05-17,04:00:00,0,0,0,FMN GV 05 Lier
60,Mechelsesteenweg 365,2021-05-17,05:00:00,2,0,2,FMN GV 05 Lier
60,Mechelsesteenweg 365,2021-05-17,06:00:00,10,2,8,FMN GV 05 Lier
60,Mechelsesteenweg 365,2021-05-17,07:00:00,106,74,32,FMN GV 05 Lier
60,Mechelsesteenweg 365,2021-05-17,08:00:00,114,74,40,FMN GV 05 Lier
60,Mechelsesteenweg 365,2021-05-17,09:00:00,14,10,4,FMN GV 05 Lier
60,Mechelsesteenweg 365,2021-05-17,10:00:00,14,12,2,FMN GV 05 Lier
60,Mechelsesteenweg 365,2021-05-17,11:00:00,12,10,2,FMN GV 05 Lier
60,Mechelsesteenweg 365,2021-05-17,12:00:00,26,10,16,FMN GV 05 Lier
60,Mechelsesteenweg 365,2021-05-17,13:00:00,22,12,10,FMN GV 05 Lier
60,Mechelsesteenweg 365,2021-05-17,14:00:00,40,20,20,FMN GV 05 Lier
60,Mechelsesteenweg 365,2021-05-17,15:00:00,112,62,50,FMN GV 05 Lier
60,Mechelsesteenweg 365,2021-05-17,16:00:00,158,44,114,FMN GV 05 Lier
60,Mechelsesteenweg 365,2021-05-17,17:00:00,90,50,40,FMN GV 05 Lier
60,Mechelsesteenweg 365,2021-05-17,18:00:00,74,34,40,FMN GV 05 Lier
60,Mechelsesteenweg 365,2021-05-17,19:00:00,48,22,26,FMN GV 05 Lier
60,Mechelsesteenweg 365,2021-05-17,20:00:00,46,20,26,FMN GV 05 Lier
60,Mechelsesteenweg 365,2021-05-17,21:00:00,36,16,20,FMN GV 05 Lier
60,Mechelsesteenweg 365,2021-05-17,22:00:00,16,14,2,FMN GV 05 Lier
60,Mechelsesteenweg 365,2021-05-17,23:00:00,0,0,0,FMN GV 05 Lier
60,Mechelsesteenweg 365,2021-05-18,00:00:00,0,0,0,FMN GV 05 Lier
60,Mechelsesteenweg 365,2021-05-18,01:00:00,0,0,0,FMN GV 05 Lier
60,Mechelsesteenweg 365,2021-05-18,02:00:00,0,0,0,FMN GV 05 Lier
60,Mechelsesteenweg 365,2021-05-18,03:00:00,0,0,0,FMN GV 05 Lier
60,Mechelsesteenweg 365,2021-05-18,04:00:00,0,0,0,FMN GV 05 Lier
60,Mechelsesteenweg 365,2021-05-18,05:00:00,4,2,2,FMN GV 05 Lier
60,Mechelsesteenweg 365,2021-05-18,06:00:00,30,12,18,FMN GV 05 Lier
60,Mechelsesteenweg 365,2021-05-18,07:00:00,150,100,50,FMN GV 05 Lier
60,Mechelsesteenweg 365,2021-05-18,08:00:00,144,90,54,FMN GV 05 Lier
60,Mechelsesteenweg 365,2021-05-18,09:00:00,72,50,22,FMN GV 05 Lier
60,Mechelsesteenweg 365,2021-05-18,10:00:00,96,48,48,FMN GV 05 Lier
60,Mechelsesteenweg 365,2021-05-18,11:00:00,90,50,40,FMN GV 05 Lier
60,Mechelsesteenweg 365,2021-05-18,12:00:00,86,34,52,FMN GV 05 Lier
60,Mechelsesteenweg 365,2021-05-18,13:00:00,148,88,60,FMN GV 05 Lier
60,Mechelsesteenweg 365,2021-05-18,14:00:00,210,114,96,FMN GV 05 Lier
60,Mechelsesteenweg 365,2021-05-18,15:00:00,204,102,102,FMN GV 05 Lier
60,Mechelsesteenweg 365,2021-05-18,16:00:00,264,102,162,FMN GV 05 Lier
60,Mechelsesteenweg 365,2021-05-18,17:00:00,174,88,86,FMN GV 05 Lier
60,Mechelsesteenweg 365,2021-05-18,18:00:00,130,58,72,FMN GV 05 Lier
60,Mechelsesteenweg 365,2021-05-18,19:00:00,186,76,110,FMN GV 05 Lier
60,Mechelsesteenweg 365,2021-05-18,20:00:00,106,44,62,FMN GV 05 Lier
60,Mechelsesteenweg 365,2021-05-18,21:00:00,42,16,26,FMN GV 05 Lier
60,Mechelsesteenweg 365,2021-05-18,22:00:00,12,10,2,FMN GV 05 Lier
60,Mechelsesteenweg 365,2021-05-18,23:00:00,0,0,0,FMN GV 05 Lier
60,Mechelsesteenweg 365,2021-05-19,00:00:00,2,2,0,FMN GV 05 Lier
60,Mechelsesteenweg 365,2021-05-19,01:00:00,0,0,0,FMN GV 05 Lier
60,Mechelsesteenweg 365,2021-05-19,02:00:00,0,0,0,FMN GV 05 Lier
60,Mechelsesteenweg 365,2021-05-19,03:00:00,2,0,2,FMN GV 05 Lier
60,Mechelsesteenweg 365,2021-05-19,04:00:00,4,0,4,FMN GV 05 Lier
60,Mechelsesteenweg 365,2021-05-19,05:00:00,2,2,0,FMN GV 05 Lier
60,Mechelsesteenweg 365,2021-05-19,06:00:00,34,14,20,FMN GV 05 Lier
60,Mechelsesteenweg 365,2021-05-19,07:00:00,146,98,48,FMN GV 05 Lier
60,Mechelsesteenweg 365,2021-05-19,08:00:00,152,104,48,FMN GV 05 Lier
60,Mechelsesteenweg 365,2021-05-19,09:00:00,86,64,22,FMN GV 05 Lier
60,Mechelsesteenweg 365,2021-05-19,10:00:00,58,32,26,FMN GV 05 Lier
60,Mechelsesteenweg 365,2021-05-19,11:00:00,88,40,48,FMN GV 05 Lier
60,Mechelsesteenweg 365,2021-05-19,12:00:00,200,50,150,FMN GV 05 Lier
60,Mechelsesteenweg 365,2021-05-19,13:00:00,80,32,48,FMN GV 05 Lier
60,Mechelsesteenweg 365,2021-05-19,14:00:00,82,46,36,FMN GV 05 Lier
60,Mechelsesteenweg 365,2021-05-19,15:00:00,68,52,16,FMN GV 05 Lier
60,Mechelsesteenweg 365,2021-05-19,16:00:00,70,40,30,FMN GV 05 Lier
60,Mechelsesteenweg 365,2021-05-19,17:00:00,60,44,16,FMN GV 05 Lier
60,Mechelsesteenweg 365,2021-05-19,18:00:00,66,32,34,FMN GV 05 Lier
60,Mechelsesteenweg 365,2021-05-19,19:00:00,84,48,36,FMN GV 05 Lier
60,Mechelsesteenweg 365,2021-05-19,20:00:00,160,102,58,FMN GV 05 Lier
60,Mechelsesteenweg 365,2021-05-19,21:00:00,30,16,14,FMN GV 05 Lier
60,Mechelsesteenweg 365,2021-05-19,22:00:00,8,6,2,FMN GV 05 Lier
60,Mechelsesteenweg 365,2021-05-19,23:00:00,0,0,0,FMN GV 05 Lier
60,Mechelsesteenweg 365,2021-05-20,00:00:00,0,0,0,FMN GV 05 Lier
60,Mechelsesteenweg 365,2021-05-20,01:00:00,0,0,0,FMN GV 05 Lier
60,Mechelsesteenweg 365,2021-05-20,02:00:00,0,0,0,FMN GV 05 Lier
60,Mechelsesteenweg 365,2021-05-20,03:00:00,2,0,2,FMN GV 05 Lier
60,Mechelsesteenweg 365,2021-05-20,04:00:00,4,0,4,FMN GV 05 Lier
60,Mechelsesteenweg 365,2021-05-20,05:00:00,8,2,6,FMN GV 05 Lier
60,Mechelsesteenweg 365,2021-05-20,06:00:00,40,22,18,FMN GV 05 Lier
60,Mechelsesteenweg 365,2021-05-20,07:00:00,194,120,74,FMN GV 05 Lier
60,Mechelsesteenweg 365,2021-05-20,08:00:00,176,116,60,FMN GV 05 Lier
60,Mechelsesteenweg 365,2021-05-20,09:00:00,166,70,96,FMN GV 05 Lier
60,Mechelsesteenweg 365,2021-05-20,10:00:00,188,102,86,FMN GV 05 Lier
60,Mechelsesteenweg 365,2021-05-20,11:00:00,260,150,110,FMN GV 05 Lier
60,Mechelsesteenweg 365,2021-05-20,12:00:00,288,88,200,FMN GV 05 Lier
60,Mechelsesteenweg 365,2021-05-20,13:00:00,214,142,72,FMN GV 05 Lier
60,Mechelsesteenweg 365,2021-05-20,14:00:00,338,186,152,FMN GV 05 Lier
60,Mechelsesteenweg 365,2021-05-20,15:00:00,338,172,166,FMN GV 05 Lier
60,Mechelsesteenweg 365,2021-05-20,16:00:00,276,92,184,FMN GV 05 Lier
60,Mechelsesteenweg 365,2021-05-20,17:00:00,162,92,70,FMN GV 05 Lier
60,Mechelsesteenweg 365,2021-05-20,18:00:00,134,76,58,FMN GV 05 Lier
60,Mechelsesteenweg 365,2021-05-20,19:00:00,200,126,74,FMN GV 05 Lier
60,Mechelsesteenweg 365,2021-05-20,20:00:00,144,48,96,FMN GV 05 Lier
60,Mechelsesteenweg 365,2021-05-20,21:00:00,54,36,18,FMN GV 05 Lier
60,Mechelsesteenweg 365,2021-05-20,22:00:00,10,2,8,FMN GV 05 Lier
60,Mechelsesteenweg 365,2021-05-20,23:00:00,0,0,0,FMN GV 05 Lier
60,Mechelsesteenweg 365,2021-05-21,00:00:00,0,0,0,FMN GV 05 Lier
60,Mechelsesteenweg 365,2021-05-21,01:00:00,0,0,0,FMN GV 05 Lier
60,Mechelsesteenweg 365,2021-05-21,02:00:00,0,0,0,FMN GV 05 Lier
60,Mechelsesteenweg 365,2021-05-21,03:00:00,2,0,2,FMN GV 05 Lier
60,Mechelsesteenweg 365,2021-05-21,04:00:00,2,0,2,FMN GV 05 Lier
60,Mechelsesteenweg 365,2021-05-21,05:00:00,4,0,4,FMN GV 05 Lier
60,Mechelsesteenweg 365,2021-05-21,06:00:00,18,12,6,FMN GV 05 Lier
60,Mechelsesteenweg 365,2021-05-21,07:00:00,142,94,48,FMN GV 05 Lier
60,Mechelsesteenweg 365,2021-05-21,08:00:00,116,92,24,FMN GV 05 Lier
60,Mechelsesteenweg 365,2021-05-21,09:00:00,34,24,10,FMN GV 05 Lier
60,Mechelsesteenweg 365,2021-05-21,10:00:00,26,14,12,FMN GV 05 Lier
60,Mechelsesteenweg 365,2021-05-21,11:00:00,40,30,10,FMN GV 05 Lier
60,Mechelsesteenweg 365,2021-05-21,12:00:00,58,22,36,FMN GV 05 Lier
60,Mechelsesteenweg 365,2021-05-21,13:00:00,32,16,16,FMN GV 05 Lier
60,Mechelsesteenweg 365,2021-05-21,14:00:00,50,30,20,FMN GV 05 Lier
60,Mechelsesteenweg 365,2021-05-21,15:00:00,120,28,92,FMN GV 05 Lier
60,Mechelsesteenweg 365,2021-05-21,16:00:00,160,66,94,FMN GV 05 Lier
60,Mechelsesteenweg 365,2021-05-21,17:00:00,60,42,18,FMN GV 05 Lier
60,Mechelsesteenweg 365,2021-05-21,18:00:00,36,16,20,FMN GV 05 Lier
60,Mechelsesteenweg 365,2021-05-21,19:00:00,34,8,26,FMN GV 05 Lier
60,Mechelsesteenweg 365,2021-05-21,20:00:00,14,12,2,FMN GV 05 Lier
60,Mechelsesteenweg 365,2021-05-21,21:00:00,48,34,14,FMN GV 05 Lier
60,Mechelsesteenweg 365,2021-05-21,22:00:00,6,0,6,FMN GV 05 Lier
60,Mechelsesteenweg 365,2021-05-21,23:00:00,14,4,10,FMN GV 05 Lier
60,Mechelsesteenweg 365,2021-05-22,00:00:00,2,0,2,FMN GV 05 Lier
60,Mechelsesteenweg 365,2021-05-22,01:00:00,0,0,0,FMN GV 05 Lier
60,Mechelsesteenweg 365,2021-05-22,02:00:00,2,0,2,FMN GV 05 Lier
60,Mechelsesteenweg 365,2021-05-22,03:00:00,0,0,0,FMN GV 05 Lier
60,Mechelsesteenweg 365,2021-05-22,04:00:00,0,0,0,FMN GV 05 Lier
60,Mechelsesteenweg 365,2021-05-22,05:00:00,0,0,0,FMN GV 05 Lier
60,Mechelsesteenweg 365,2021-05-22,06:00:00,8,4,4,FMN GV 05 Lier
60,Mechelsesteenweg 365,2021-05-22,07:00:00,8,4,4,FMN GV 05 Lier
60,Mechelsesteenweg 365,2021-05-22,08:00:00,6,2,4,FMN GV 05 Lier
60,Mechelsesteenweg 365,2021-05-22,09:00:00,22,16,6,FMN GV 05 Lier
60,Mechelsesteenweg 365,2021-05-22,10:00:00,8,4,4,FMN GV 05 Lier
60,Mechelsesteenweg 365,2021-05-22,11:00:00,18,10,8,FMN GV 05 Lier
60,Mechelsesteenweg 365,2021-05-22,12:00:00,14,0,14,FMN GV 05 Lier
60,Mechelsesteenweg 365,2021-05-22,13:00:00,30,12,18,FMN GV 05 Lier
60,Mechelsesteenweg 365,2021-05-22,14:00:00,30,14,16,FMN GV 05 Lier
60,Mechelsesteenweg 365,2021-05-22,15:00:00,30,18,12,FMN GV 05 Lier
60,Mechelsesteenweg 365,2021-05-22,16:00:00,16,6,10,FMN GV 05 Lier
60,Mechelsesteenweg 365,2021-05-22,17:00:00,4,2,2,FMN GV 05 Lier
60,Mechelsesteenweg 365,2021-05-22,18:00:00,8,4,4,FMN GV 05 Lier
60,Mechelsesteenweg 365,2021-05-22,19:00:00,6,2,4,FMN GV 05 Lier
60,Mechelsesteenweg 365,2021-05-22,20:00:00,14,6,8,FMN GV 05 Lier
60,Mechelsesteenweg 365,2021-05-22,21:00:00,6,4,2,FMN GV 05 Lier
60,Mechelsesteenweg 365,2021-05-22,22:00:00,2,0,2,FMN GV 05 Lier
60,Mechelsesteenweg 365,2021-05-22,23:00:00,0,0,0,FMN GV 05 Lier
60,Mechelsesteenweg 365,2021-05-23,00:00:00,0,0,0,FMN GV 05 Lier
60,Mechelsesteenweg 365,2021-05-23,01:00:00,2,0,2,FMN GV 05 Lier
60,Mechelsesteenweg 365,2021-05-23,02:00:00,0,0,0,FMN GV 05 Lier
60,Mechelsesteenweg 365,2021-05-23,03:00:00,0,0,0,FMN GV 05 Lier
60,Mechelsesteenweg 365,2021-05-23,04:00:00,0,0,0,FMN GV 05 Lier
60,Mechelsesteenweg 365,2021-05-23,05:00:00,0,0,0,FMN GV 05 Lier
60,Mechelsesteenweg 365,2021-05-23,06:00:00,2,2,0,FMN GV 05 Lier
60,Mechelsesteenweg 365,2021-05-23,07:00:00,20,6,14,FMN GV 05 Lier
60,Mechelsesteenweg 365,2021-05-23,08:00:00,74,28,46,FMN GV 05 Lier
60,Mechelsesteenweg 365,2021-05-23,09:00:00,152,88,64,FMN GV 05 Lier
60,Mechelsesteenweg 365,2021-05-23,10:00:00,408,206,202,FMN GV 05 Lier
60,Mechelsesteenweg 365,2021-05-23,11:00:00,416,242,174,FMN GV 05 Lier
60,Mechelsesteenweg 365,2021-05-23,12:00:00,306,170,136,FMN GV 05 Lier
60,Mechelsesteenweg 365,2021-05-23,13:00:00,180,112,68,FMN GV 05 Lier
60,Mechelsesteenweg 365,2021-05-23,14:00:00,238,130,108,FMN GV 05 Lier
60,Mechelsesteenweg 365,2021-05-23,15:00:00,264,128,136,FMN GV 05 Lier
60,Mechelsesteenweg 365,2021-05-23,16:00:00,336,160,176,FMN GV 05 Lier
60,Mechelsesteenweg 365,2021-05-23,17:00:00,98,38,60,FMN GV 05 Lier
60,Mechelsesteenweg 365,2021-05-23,18:00:00,62,30,32,FMN GV 05 Lier
60,Mechelsesteenweg 365,2021-05-23,19:00:00,18,8,10,FMN GV 05 Lier
60,Mechelsesteenweg 365,2021-05-23,20:00:00,40,14,26,FMN GV 05 Lier
60,Mechelsesteenweg 365,2021-05-23,21:00:00,14,6,8,FMN GV 05 Lier
60,Mechelsesteenweg 365,2021-05-23,22:00:00,14,6,8,FMN GV 05 Lier
60,Mechelsesteenweg 365,2021-05-23,23:00:00,0,0,0,FMN GV 05 Lier
60,Mechelsesteenweg 365,2021-05-24,00:00:00,2,0,2,FMN GV 05 Lier
60,Mechelsesteenweg 365,2021-05-24,01:00:00,2,0,2,FMN GV 05 Lier
60,Mechelsesteenweg 365,2021-05-24,02:00:00,0,0,0,FMN GV 05 Lier
60,Mechelsesteenweg 365,2021-05-24,03:00:00,0,0,0,FMN GV 05 Lier
60,Mechelsesteenweg 365,2021-05-24,04:00:00,2,2,0,FMN GV 05 Lier
60,Mechelsesteenweg 365,2021-05-24,05:00:00,0,0,0,FMN GV 05 Lier
60,Mechelsesteenweg 365,2021-05-24,06:00:00,0,0,0,FMN GV 05 Lier
60,Mechelsesteenweg 365,2021-05-24,07:00:00,6,0,6,FMN GV 05 Lier
60,Mechelsesteenweg 365,2021-05-24,08:00:00,18,18,0,FMN GV 05 Lier
60,Mechelsesteenweg 365,2021-05-24,09:00:00,62,14,48,FMN GV 05 Lier
60,Mechelsesteenweg 365,2021-05-24,10:00:00,6,2,4,FMN GV 05 Lier
60,Mechelsesteenweg 365,2021-05-24,11:00:00,54,52,2,FMN GV 05 Lier
60,Mechelsesteenweg 365,2021-05-24,12:00:00,20,10,10,FMN GV 05 Lier
60,Mechelsesteenweg 365,2021-05-24,13:00:00,48,22,26,FMN GV 05 Lier
60,Mechelsesteenweg 365,2021-05-24,14:00:00,56,10,46,FMN GV 05 Lier
60,Mechelsesteenweg 365,2021-05-24,15:00:00,114,68,46,FMN GV 05 Lier
60,Mechelsesteenweg 365,2021-05-24,16:00:00,120,68,52,FMN GV 05 Lier
60,Mechelsesteenweg 365,2021-05-24,17:00:00,56,24,32,FMN GV 05 Lier
60,Mechelsesteenweg 365,2021-05-24,18:00:00,32,8,24,FMN GV 05 Lier
60,Mechelsesteenweg 365,2021-05-24,19:00:00,12,8,4,FMN GV 05 Lier
60,Mechelsesteenweg 365,2021-05-24,20:00:00,14,6,8,FMN GV 05 Lier
60,Mechelsesteenweg 365,2021-05-24,21:00:00,4,0,4,FMN GV 05 Lier
60,Mechelsesteenweg 365,2021-05-24,22:00:00,4,4,0,FMN GV 05 Lier
60,Mechelsesteenweg 365,2021-05-24,23:00:00,0,0,0,FMN GV 05 Lier
60,Mechelsesteenweg 365,2021-05-25,00:00:00,0,0,0,FMN GV 05 Lier
60,Mechelsesteenweg 365,2021-05-25,01:00:00,0,0,0,FMN GV 05 Lier
60,Mechelsesteenweg 365,2021-05-25,02:00:00,0,0,0,FMN GV 05 Lier
60,Mechelsesteenweg 365,2021-05-25,03:00:00,2,0,2,FMN GV 05 Lier
60,Mechelsesteenweg 365,2021-05-25,04:00:00,2,0,2,FMN GV 05 Lier
60,Mechelsesteenweg 365,2021-05-25,05:00:00,4,0,4,FMN GV 05 Lier
60,Mechelsesteenweg 365,2021-05-25,06:00:00,10,6,4,FMN GV 05 Lier
60,Mechelsesteenweg 365,2021-05-25,07:00:00,38,10,28,FMN GV 05 Lier
60,Mechelsesteenweg 365,2021-05-25,08:00:00,50,36,14,FMN GV 05 Lier
60,Mechelsesteenweg 365,2021-05-25,09:00:00,106,22,84,FMN GV 05 Lier
60,Mechelsesteenweg 365,2021-05-25,10:00:00,12,6,6,FMN GV 05 Lier
60,Mechelsesteenweg 365,2021-05-25,11:00:00,58,16,42,FMN GV 05 Lier
60,Mechelsesteenweg 365,2021-05-25,12:00:00,38,10,28,FMN GV 05 Lier
60,Mechelsesteenweg 365,2021-05-25,13:00:00,18,8,10,FMN GV 05 Lier
60,Mechelsesteenweg 365,2021-05-25,14:00:00,80,62,18,FMN GV 05 Lier
60,Mechelsesteenweg 365,2021-05-25,15:00:00,58,32,26,FMN GV 05 Lier
60,Mechelsesteenweg 365,2021-05-25,16:00:00,42,18,24,FMN GV 05 Lier
60,Mechelsesteenweg 365,2021-05-25,17:00:00,40,30,10,FMN GV 05 Lier
60,Mechelsesteenweg 365,2021-05-25,18:00:00,14,4,10,FMN GV 05 Lier
60,Mechelsesteenweg 365,2021-05-25,19:00:00,10,4,6,FMN GV 05 Lier
60,Mechelsesteenweg 365,2021-05-25,20:00:00,14,0,14,FMN GV 05 Lier
60,Mechelsesteenweg 365,2021-05-25,21:00:00,8,2,6,FMN GV 05 Lier
60,Mechelsesteenweg 365,2021-05-25,22:00:00,4,4,0,FMN GV 05 Lier
60,Mechelsesteenweg 365,2021-05-25,23:00:00,0,0,0,FMN GV 05 Lier
60,Mechelsesteenweg 365,2021-05-26,00:00:00,0,0,0,FMN GV 05 Lier
60,Mechelsesteenweg 365,2021-05-26,01:00:00,0,0,0,FMN GV 05 Lier
60,Mechelsesteenweg 365,2021-05-26,02:00:00,0,0,0,FMN GV 05 Lier
60,Mechelsesteenweg 365,2021-05-26,03:00:00,2,0,2,FMN GV 05 Lier
60,Mechelsesteenweg 365,2021-05-26,04:00:00,2,0,2,FMN GV 05 Lier
60,Mechelsesteenweg 365,2021-05-26,05:00:00,14,4,10,FMN GV 05 Lier
60,Mechelsesteenweg 365,2021-05-26,06:00:00,22,10,12,FMN GV 05 Lier
60,Mechelsesteenweg 365,2021-05-26,07:00:00,142,86,56,FMN GV 05 Lier
60,Mechelsesteenweg 365,2021-05-26,08:00:00,134,104,30,FMN GV 05 Lier
60,Mechelsesteenweg 365,2021-05-26,09:00:00,88,46,42,FMN GV 05 Lier
60,Mechelsesteenweg 365,2021-05-26,10:00:00,110,62,48,FMN GV 05 Lier
60,Mechelsesteenweg 365,2021-05-26,11:00:00,64,32,32,FMN GV 05 Lier
60,Mechelsesteenweg 365,2021-05-26,12:00:00,214,58,156,FMN GV 05 Lier
60,Mechelsesteenweg 365,2021-05-26,13:00:00,98,36,62,FMN GV 05 Lier
60,Mechelsesteenweg 365,2021-05-26,14:00:00,66,36,30,FMN GV 05 Lier
60,Mechelsesteenweg 365,2021-05-26,15:00:00,64,28,36,FMN GV 05 Lier
60,Mechelsesteenweg 365,2021-05-26,16:00:00,78,48,30,FMN GV 05 Lier
60,Mechelsesteenweg 365,2021-05-26,17:00:00,88,62,26,FMN GV 05 Lier
60,Mechelsesteenweg 365,2021-05-26,18:00:00,72,34,38,FMN GV 05 Lier
60,Mechelsesteenweg 365,2021-05-26,19:00:00,76,36,40,FMN GV 05 Lier
60,Mechelsesteenweg 365,2021-05-26,20:00:00,120,72,48,FMN GV 05 Lier
60,Mechelsesteenweg 365,2021-05-26,21:00:00,26,10,16,FMN GV 05 Lier
60,Mechelsesteenweg 365,2021-05-26,22:00:00,4,4,0,FMN GV 05 Lier
60,Mechelsesteenweg 365,2021-05-26,23:00:00,0,0,0,FMN GV 05 Lier
60,Mechelsesteenweg 365,2021-05-27,00:00:00,0,0,0,FMN GV 05 Lier
60,Mechelsesteenweg 365,2021-05-27,01:00:00,0,0,0,FMN GV 05 Lier
60,Mechelsesteenweg 365,2021-05-27,02:00:00,0,0,0,FMN GV 05 Lier
60,Mechelsesteenweg 365,2021-05-27,03:00:00,2,0,2,FMN GV 05 Lier
60,Mechelsesteenweg 365,2021-05-27,04:00:00,2,0,2,FMN GV 05 Lier
60,Mechelsesteenweg 365,2021-05-27,05:00:00,12,2,10,FMN GV 05 Lier
60,Mechelsesteenweg 365,2021-05-27,06:00:00,24,8,16,FMN GV 05 Lier
60,Mechelsesteenweg 365,2021-05-27,07:00:00,198,116,82,FMN GV 05 Lier
60,Mechelsesteenweg 365,2021-05-27,08:00:00,146,106,40,FMN GV 05 Lier
60,Mechelsesteenweg 365,2021-05-27,09:00:00,68,44,24,FMN GV 05 Lier
60,Mechelsesteenweg 365,2021-05-27,10:00:00,72,30,42,FMN GV 05 Lier
60,Mechelsesteenweg 365,2021-05-27,11:00:00,62,40,22,FMN GV 05 Lier
60,Mechelsesteenweg 365,2021-05-27,12:00:00,78,30,48,FMN GV 05 Lier
60,Mechelsesteenweg 365,2021-05-27,13:00:00,104,62,42,FMN GV 05 Lier
60,Mechelsesteenweg 365,2021-05-27,14:00:00,142,94,48,FMN GV 05 Lier
60,Mechelsesteenweg 365,2021-05-27,15:00:00,162,62,100,FMN GV 05 Lier
60,Mechelsesteenweg 365,2021-05-27,16:00:00,224,66,158,FMN GV 05 Lier
60,Mechelsesteenweg 365,2021-05-27,17:00:00,118,76,42,FMN GV 05 Lier
60,Mechelsesteenweg 365,2021-05-27,18:00:00,90,62,28,FMN GV 05 Lier
60,Mechelsesteenweg 365,2021-05-27,19:00:00,98,48,50,FMN GV 05 Lier
60,Mechelsesteenweg 365,2021-05-27,20:00:00,194,82,112,FMN GV 05 Lier
60,Mechelsesteenweg 365,2021-05-27,21:00:00,42,10,32,FMN GV 05 Lier
60,Mechelsesteenweg 365,2021-05-27,22:00:00,12,8,4,FMN GV 05 Lier
60,Mechelsesteenweg 365,2021-05-27,23:00:00,0,0,0,FMN GV 05 Lier
60,Mechelsesteenweg 365,2021-05-28,00:00:00,2,0,2,FMN GV 05 Lier
60,Mechelsesteenweg 365,2021-05-28,01:00:00,0,0,0,FMN GV 05 Lier
60,Mechelsesteenweg 365,2021-05-28,02:00:00,0,0,0,FMN GV 05 Lier
60,Mechelsesteenweg 365,2021-05-28,03:00:00,6,4,2,FMN GV 05 Lier
60,Mechelsesteenweg 365,2021-05-28,04:00:00,0,0,0,FMN GV 05 Lier
60,Mechelsesteenweg 365,2021-05-28,05:00:00,10,2,8,FMN GV 05 Lier
60,Mechelsesteenweg 365,2021-05-28,06:00:00,22,6,16,FMN GV 05 Lier
60,Mechelsesteenweg 365,2021-05-28,07:00:00,190,118,72,FMN GV 05 Lier
60,Mechelsesteenweg 365,2021-05-28,08:00:00,144,98,46,FMN GV 05 Lier
60,Mechelsesteenweg 365,2021-05-28,09:00:00,118,48,70,FMN GV 05 Lier
60,Mechelsesteenweg 365,2021-05-28,10:00:00,116,50,66,FMN GV 05 Lier
60,Mechelsesteenweg 365,2021-05-28,11:00:00,162,84,78,FMN GV 05 Lier
60,Mechelsesteenweg 365,2021-05-28,12:00:00,150,80,70,FMN GV 05 Lier
60,Mechelsesteenweg 365,2021-05-28,13:00:00,222,110,112,FMN GV 05 Lier
60,Mechelsesteenweg 365,2021-05-28,14:00:00,308,170,138,FMN GV 05 Lier
60,Mechelsesteenweg 365,2021-05-28,15:00:00,364,156,208,FMN GV 05 Lier
60,Mechelsesteenweg 365,2021-05-28,16:00:00,362,136,226,FMN GV 05 Lier
60,Mechelsesteenweg 365,2021-05-28,17:00:00,202,98,104,FMN GV 05 Lier
60,Mechelsesteenweg 365,2021-05-28,18:00:00,160,72,88,FMN GV 05 Lier
60,Mechelsesteenweg 365,2021-05-28,19:00:00,114,52,62,FMN GV 05 Lier
60,Mechelsesteenweg 365,2021-05-28,20:00:00,134,62,72,FMN GV 05 Lier
60,Mechelsesteenweg 365,2021-05-28,21:00:00,52,24,28,FMN GV 05 Lier
60,Mechelsesteenweg 365,2021-05-28,22:00:00,18,14,4,FMN GV 05 Lier
60,Mechelsesteenweg 365,2021-05-28,23:00:00,10,2,8,FMN GV 05 Lier
60,Mechelsesteenweg 365,2021-05-29,00:00:00,10,4,6,FMN GV 05 Lier
60,Mechelsesteenweg 365,2021-05-29,01:00:00,0,0,0,FMN GV 05 Lier
60,Mechelsesteenweg 365,2021-05-29,02:00:00,2,2,0,FMN GV 05 Lier
60,Mechelsesteenweg 365,2021-05-29,03:00:00,0,0,0,FMN GV 05 Lier
60,Mechelsesteenweg 365,2021-05-29,04:00:00,2,0,2,FMN GV 05 Lier
60,Mechelsesteenweg 365,2021-05-29,05:00:00,4,2,2,FMN GV 05 Lier
60,Mechelsesteenweg 365,2021-05-29,06:00:00,10,6,4,FMN GV 05 Lier
60,Mechelsesteenweg 365,2021-05-29,07:00:00,30,16,14,FMN GV 05 Lier
60,Mechelsesteenweg 365,2021-05-29,08:00:00,62,36,26,FMN GV 05 Lier
60,Mechelsesteenweg 365,2021-05-29,09:00:00,112,76,36,FMN GV 05 Lier
60,Mechelsesteenweg 365,2021-05-29,10:00:00,312,156,156,FMN GV 05 Lier
60,Mechelsesteenweg 365,2021-05-29,11:00:00,370,162,208,FMN GV 05 Lier
60,Mechelsesteenweg 365,2021-05-29,12:00:00,342,184,158,FMN GV 05 Lier
60,Mechelsesteenweg 365,2021-05-29,13:00:00,382,180,202,FMN GV 05 Lier
60,Mechelsesteenweg 365,2021-05-29,14:00:00,510,226,284,FMN GV 05 Lier
60,Mechelsesteenweg 365,2021-05-29,15:00:00,538,246,292,FMN GV 05 Lier
60,Mechelsesteenweg 365,2021-05-29,16:00:00,374,136,238,FMN GV 05 Lier
60,Mechelsesteenweg 365,2021-05-29,17:00:00,240,68,172,FMN GV 05 Lier
60,Mechelsesteenweg 365,2021-05-29,18:00:00,126,56,70,FMN GV 05 Lier
60,Mechelsesteenweg 365,2021-05-29,19:00:00,106,50,56,FMN GV 05 Lier
60,Mechelsesteenweg 365,2021-05-29,20:00:00,90,38,52,FMN GV 05 Lier
60,Mechelsesteenweg 365,2021-05-29,21:00:00,38,16,22,FMN GV 05 Lier
60,Mechelsesteenweg 365,2021-05-29,22:00:00,24,14,10,FMN GV 05 Lier
60,Mechelsesteenweg 365,2021-05-29,23:00:00,2,0,2,FMN GV 05 Lier
60,Mechelsesteenweg 365,2021-05-30,00:00:00,0,0,0,FMN GV 05 Lier
60,Mechelsesteenweg 365,2021-05-30,01:00:00,6,6,0,FMN GV 05 Lier
60,Mechelsesteenweg 365,2021-05-30,02:00:00,4,4,0,FMN GV 05 Lier
60,Mechelsesteenweg 365,2021-05-30,03:00:00,4,0,4,FMN GV 05 Lier
60,Mechelsesteenweg 365,2021-05-30,04:00:00,0,0,0,FMN GV 05 Lier
60,Mechelsesteenweg 365,2021-05-30,05:00:00,0,0,0,FMN GV 05 Lier
60,Mechelsesteenweg 365,2021-05-30,06:00:00,12,8,4,FMN GV 05 Lier
60,Mechelsesteenweg 365,2021-05-30,07:00:00,18,8,10,FMN GV 05 Lier
60,Mechelsesteenweg 365,2021-05-30,08:00:00,44,26,18,FMN GV 05 Lier
60,Mechelsesteenweg 365,2021-05-30,09:00:00,350,202,148,FMN GV 05 Lier
60,Mechelsesteenweg 365,2021-05-30,10:00:00,642,280,362,FMN GV 05 Lier
60,Mechelsesteenweg 365,2021-05-30,11:00:00,758,308,450,FMN GV 05 Lier
60,Mechelsesteenweg 365,2021-05-30,12:00:00,580,260,320,FMN GV 05 Lier
60,Mechelsesteenweg 365,2021-05-30,13:00:00,560,274,286,FMN GV 05 Lier
60,Mechelsesteenweg 365,2021-05-30,14:00:00,826,420,406,FMN GV 05 Lier
60,Mechelsesteenweg 365,2021-05-30,15:00:00,698,322,376,FMN GV 05 Lier
60,Mechelsesteenweg 365,2021-05-30,16:00:00,550,226,324,FMN GV 05 Lier
60,Mechelsesteenweg 365,2021-05-30,17:00:00,316,120,196,FMN GV 05 Lier
60,Mechelsesteenweg 365,2021-05-30,18:00:00,186,54,132,FMN GV 05 Lier
60,Mechelsesteenweg 365,2021-05-30,19:00:00,82,30,52,FMN GV 05 Lier
60,Mechelsesteenweg 365,2021-05-30,20:00:00,64,24,40,FMN GV 05 Lier
60,Mechelsesteenweg 365,2021-05-30,21:00:00,38,14,24,FMN GV 05 Lier
60,Mechelsesteenweg 365,2021-05-30,22:00:00,18,6,12,FMN GV 05 Lier
60,Mechelsesteenweg 365,2021-05-30,23:00:00,4,0,4,FMN GV 05 Lier
60,Mechelsesteenweg 365,2021-05-31,00:00:00,2,2,0,FMN GV 05 Lier
60,Mechelsesteenweg 365,2021-05-31,01:00:00,0,0,0,FMN GV 05 Lier
60,Mechelsesteenweg 365,2021-05-31,02:00:00,0,0,0,FMN GV 05 Lier
60,Mechelsesteenweg 365,2021-05-31,03:00:00,2,0,2,FMN GV 05 Lier
60,Mechelsesteenweg 365,2021-05-31,04:00:00,2,0,2,FMN GV 05 Lier
60,Mechelsesteenweg 365,2021-05-31,05:00:00,12,2,10,FMN GV 05 Lier
60,Mechelsesteenweg 365,2021-05-31,06:00:00,40,12,28,FMN GV 05 Lier
60,Mechelsesteenweg 365,2021-05-31,07:00:00,208,136,72,FMN GV 05 Lier
60,Mechelsesteenweg 365,2021-05-31,08:00:00,176,110,66,FMN GV 05 Lier
60,Mechelsesteenweg 365,2021-05-31,09:00:00,96,60,36,FMN GV 05 Lier
60,Mechelsesteenweg 365,2021-05-31,10:00:00,228,76,152,FMN GV 05 Lier
60,Mechelsesteenweg 365,2021-05-31,11:00:00,142,86,56,FMN GV 05 Lier
60,Mechelsesteenweg 365,2021-05-31,12:00:00,150,68,82,FMN GV 05 Lier
60,Mechelsesteenweg 365,2021-05-31,13:00:00,232,122,110,FMN GV 05 Lier
60,Mechelsesteenweg 365,2021-05-31,14:00:00,286,144,142,FMN GV 05 Lier
60,Mechelsesteenweg 365,2021-05-31,15:00:00,432,206,226,FMN GV 05 Lier
60,Mechelsesteenweg 365,2021-05-31,16:00:00,412,118,294,FMN GV 05 Lier
60,Mechelsesteenweg 365,2021-05-31,17:00:00,282,132,150,FMN GV 05 Lier
60,Mechelsesteenweg 365,2021-05-31,18:00:00,180,90,90,FMN GV 05 Lier
60,Mechelsesteenweg 365,2021-05-31,19:00:00,210,94,116,FMN GV 05 Lier
60,Mechelsesteenweg 365,2021-05-31,20:00:00,124,58,66,FMN GV 05 Lier
60,Mechelsesteenweg 365,2021-05-31,21:00:00,84,28,56,FMN GV 05 Lier
60,Mechelsesteenweg 365,2021-05-31,22:00:00,24,12,12,FMN GV 05 Lier
60,Mechelsesteenweg 365,2021-05-31,23:00:00,8,4,4,FMN GV 05 Lier
60,Mechelsesteenweg 365,2021-06-01,00:00:00,4,0,4,FMN GV 05 Lier
60,Mechelsesteenweg 365,2021-06-01,01:00:00,0,0,0,FMN GV 05 Lier
60,Mechelsesteenweg 365,2021-06-01,02:00:00,8,4,4,FMN GV 05 Lier
60,Mechelsesteenweg 365,2021-06-01,03:00:00,4,2,2,FMN GV 05 Lier
60,Mechelsesteenweg 365,2021-06-01,04:00:00,0,0,0,FMN GV 05 Lier
60,Mechelsesteenweg 365,2021-06-01,05:00:00,14,0,14,FMN GV 05 Lier
60,Mechelsesteenweg 365,2021-06-01,06:00:00,56,22,34,FMN GV 05 Lier
60,Mechelsesteenweg 365,2021-06-01,07:00:00,244,136,108,FMN GV 05 Lier
60,Mechelsesteenweg 365,2021-06-01,08:00:00,182,136,46,FMN GV 05 Lier
60,Mechelsesteenweg 365,2021-06-01,09:00:00,310,148,162,FMN GV 05 Lier
60,Mechelsesteenweg 365,2021-06-01,10:00:00,240,96,144,FMN GV 05 Lier
60,Mechelsesteenweg 365,2021-06-01,11:00:00,282,134,148,FMN GV 05 Lier
60,Mechelsesteenweg 365,2021-06-01,12:00:00,102,34,68,FMN GV 05 Lier
60,Mechelsesteenweg 365,2021-06-01,13:00:00,0,0,0,FMN GV 05 Lier
60,Mechelsesteenweg 365,2021-06-01,14:00:00,0,0,0,FMN GV 05 Lier
60,Mechelsesteenweg 365,2021-06-01,15:00:00,126,52,74,FMN GV 05 Lier
60,Mechelsesteenweg 365,2021-06-01,16:00:00,374,176,198,FMN GV 05 Lier
60,Mechelsesteenweg 365,2021-06-01,17:00:00,274,148,126,FMN GV 05 Lier
60,Mechelsesteenweg 365,2021-06-01,18:00:00,248,142,106,FMN GV 05 Lier
60,Mechelsesteenweg 365,2021-06-01,19:00:00,198,96,102,FMN GV 05 Lier
60,Mechelsesteenweg 365,2021-06-01,20:00:00,248,82,166,FMN GV 05 Lier
60,Mechelsesteenweg 365,2021-06-01,21:00:00,102,48,54,FMN GV 05 Lier
60,Mechelsesteenweg 365,2021-06-01,22:00:00,68,30,38,FMN GV 05 Lier
60,Mechelsesteenweg 365,2021-06-01,23:00:00,2,0,2,FMN GV 05 Lier
60,Mechelsesteenweg 365,2021-06-02,00:00:00,0,0,0,FMN GV 05 Lier
60,Mechelsesteenweg 365,2021-06-02,01:00:00,0,0,0,FMN GV 05 Lier
60,Mechelsesteenweg 365,2021-06-02,02:00:00,0,0,0,FMN GV 05 Lier
60,Mechelsesteenweg 365,2021-06-02,03:00:00,2,0,2,FMN GV 05 Lier
60,Mechelsesteenweg 365,2021-06-02,04:00:00,0,0,0,FMN GV 05 Lier
60,Mechelsesteenweg 365,2021-06-02,05:00:00,22,2,20,FMN GV 05 Lier
60,Mechelsesteenweg 365,2021-06-02,06:00:00,54,24,30,FMN GV 05 Lier
60,Mechelsesteenweg 365,2021-06-02,07:00:00,236,138,98,FMN GV 05 Lier
60,Mechelsesteenweg 365,2021-06-02,08:00:00,228,152,76,FMN GV 05 Lier
60,Mechelsesteenweg 365,2021-06-02,09:00:00,158,100,58,FMN GV 05 Lier
60,Mechelsesteenweg 365,2021-06-02,10:00:00,282,134,148,FMN GV 05 Lier
60,Mechelsesteenweg 365,2021-06-02,11:00:00,234,98,136,FMN GV 05 Lier
60,Mechelsesteenweg 365,2021-06-02,12:00:00,390,172,218,FMN GV 05 Lier
60,Mechelsesteenweg 365,2021-06-02,13:00:00,44,8,36,FMN GV 05 Lier
60,Mechelsesteenweg 365,2021-06-02,14:00:00,138,54,84,FMN GV 05 Lier
60,Mechelsesteenweg 365,2021-06-02,15:00:00,362,156,206,FMN GV 05 Lier
60,Mechelsesteenweg 365,2021-06-02,16:00:00,344,152,192,FMN GV 05 Lier
60,Mechelsesteenweg 365,2021-06-02,17:00:00,294,156,138,FMN GV 05 Lier
60,Mechelsesteenweg 365,2021-06-02,18:00:00,254,142,112,FMN GV 05 Lier
60,Mechelsesteenweg 365,2021-06-02,19:00:00,248,140,108,FMN GV 05 Lier
60,Mechelsesteenweg 365,2021-06-02,20:00:00,274,172,102,FMN GV 05 Lier
60,Mechelsesteenweg 365,2021-06-02,21:00:00,118,62,56,FMN GV 05 Lier
60,Mechelsesteenweg 365,2021-06-02,22:00:00,18,10,8,FMN GV 05 Lier
60,Mechelsesteenweg 365,2021-06-02,23:00:00,0,0,0,FMN GV 05 Lier
60,Mechelsesteenweg 365,2021-06-03,00:00:00,2,0,2,FMN GV 05 Lier
60,Mechelsesteenweg 365,2021-06-03,01:00:00,0,0,0,FMN GV 05 Lier
60,Mechelsesteenweg 365,2021-06-03,02:00:00,0,0,0,FMN GV 05 Lier
60,Mechelsesteenweg 365,2021-06-03,03:00:00,2,0,2,FMN GV 05 Lier
60,Mechelsesteenweg 365,2021-06-03,04:00:00,0,0,0,FMN GV 05 Lier
60,Mechelsesteenweg 365,2021-06-03,05:00:00,12,2,10,FMN GV 05 Lier
60,Mechelsesteenweg 365,2021-06-03,06:00:00,42,20,22,FMN GV 05 Lier
60,Mechelsesteenweg 365,2021-06-03,07:00:00,198,114,84,FMN GV 05 Lier
60,Mechelsesteenweg 365,2021-06-03,08:00:00,172,128,44,FMN GV 05 Lier
60,Mechelsesteenweg 365,2021-06-03,09:00:00,94,54,40,FMN GV 05 Lier
60,Mechelsesteenweg 365,2021-06-03,10:00:00,100,46,54,FMN GV 05 Lier
60,Mechelsesteenweg 365,2021-06-03,11:00:00,44,14,30,FMN GV 05 Lier
60,Mechelsesteenweg 365,2021-06-03,12:00:00,16,8,8,FMN GV 05 Lier
60,Mechelsesteenweg 365,2021-06-03,13:00:00,18,6,12,FMN GV 05 Lier
60,Mechelsesteenweg 365,2021-06-03,14:00:00,24,6,18,FMN GV 05 Lier
60,Mechelsesteenweg 365,2021-06-03,15:00:00,0,0,0,FMN GV 05 Lier
60,Mechelsesteenweg 365,2021-06-03,16:00:00,0,0,0,FMN GV 05 Lier
60,Mechelsesteenweg 365,2021-06-03,17:00:00,6,2,4,FMN GV 05 Lier
60,Mechelsesteenweg 365,2021-06-03,18:00:00,18,14,4,FMN GV 05 Lier
60,Mechelsesteenweg 365,2021-06-03,19:00:00,22,6,16,FMN GV 05 Lier
60,Mechelsesteenweg 365,2021-06-03,20:00:00,204,98,106,FMN GV 05 Lier
60,Mechelsesteenweg 365,2021-06-03,21:00:00,76,26,50,FMN GV 05 Lier
60,Mechelsesteenweg 365,2021-06-03,22:00:00,32,10,22,FMN GV 05 Lier
60,Mechelsesteenweg 365,2021-06-03,23:00:00,4,4,0,FMN GV 05 Lier
60,Mechelsesteenweg 365,2021-06-04,00:00:00,0,0,0,FMN GV 05 Lier
60,Mechelsesteenweg 365,2021-06-04,01:00:00,2,2,0,FMN GV 05 Lier
60,Mechelsesteenweg 365,2021-06-04,02:00:00,0,0,0,FMN GV 05 Lier
60,Mechelsesteenweg 365,2021-06-04,03:00:00,2,0,2,FMN GV 05 Lier
60,Mechelsesteenweg 365,2021-06-04,04:00:00,0,0,0,FMN GV 05 Lier
60,Mechelsesteenweg 365,2021-06-04,05:00:00,18,6,12,FMN GV 05 Lier
60,Mechelsesteenweg 365,2021-06-04,06:00:00,38,20,18,FMN GV 05 Lier
60,Mechelsesteenweg 365,2021-06-04,07:00:00,182,122,60,FMN GV 05 Lier
60,Mechelsesteenweg 365,2021-06-04,08:00:00,192,134,58,FMN GV 05 Lier
60,Mechelsesteenweg 365,2021-06-04,09:00:00,88,46,42,FMN GV 05 Lier
60,Mechelsesteenweg 365,2021-06-04,10:00:00,0,0,0,FMN GV 05 Lier
60,Mechelsesteenweg 365,2021-06-04,11:00:00,0,0,0,FMN GV 05 Lier
60,Mechelsesteenweg 365,2021-06-04,12:00:00,0,0,0,FMN GV 05 Lier
60,Mechelsesteenweg 365,2021-06-04,13:00:00,0,0,0,FMN GV 05 Lier
60,Mechelsesteenweg 365,2021-06-04,14:00:00,0,0,0,FMN GV 05 Lier
60,Mechelsesteenweg 365,2021-06-04,15:00:00,128,40,88,FMN GV 05 Lier
60,Mechelsesteenweg 365,2021-06-04,16:00:00,130,24,106,FMN GV 05 Lier
60,Mechelsesteenweg 365,2021-06-04,17:00:00,36,22,14,FMN GV 05 Lier
60,Mechelsesteenweg 365,2021-06-04,18:00:00,30,8,22,FMN GV 05 Lier
60,Mechelsesteenweg 365,2021-06-04,19:00:00,16,10,6,FMN GV 05 Lier
60,Mechelsesteenweg 365,2021-06-04,20:00:00,12,2,10,FMN GV 05 Lier
60,Mechelsesteenweg 365,2021-06-04,21:00:00,8,4,4,FMN GV 05 Lier
60,Mechelsesteenweg 365,2021-06-04,22:00:00,4,0,4,FMN GV 05 Lier
60,Mechelsesteenweg 365,2021-06-04,23:00:00,4,4,0,FMN GV 05 Lier
60,Mechelsesteenweg 365,2021-06-05,00:00:00,2,2,0,FMN GV 05 Lier
60,Mechelsesteenweg 365,2021-06-05,01:00:00,0,0,0,FMN GV 05 Lier
60,Mechelsesteenweg 365,2021-06-05,02:00:00,0,0,0,FMN GV 05 Lier
60,Mechelsesteenweg 365,2021-06-05,03:00:00,2,2,0,FMN GV 05 Lier
60,Mechelsesteenweg 365,2021-06-05,04:00:00,2,0,2,FMN GV 05 Lier
60,Mechelsesteenweg 365,2021-06-05,05:00:00,0,0,0,FMN GV 05 Lier
60,Mechelsesteenweg 365,2021-06-05,06:00:00,8,4,4,FMN GV 05 Lier
60,Mechelsesteenweg 365,2021-06-05,07:00:00,26,10,16,FMN GV 05 Lier
60,Mechelsesteenweg 365,2021-06-05,08:00:00,22,6,16,FMN GV 05 Lier
60,Mechelsesteenweg 365,2021-06-05,09:00:00,50,22,28,FMN GV 05 Lier
60,Mechelsesteenweg 365,2021-06-05,10:00:00,100,54,46,FMN GV 05 Lier
60,Mechelsesteenweg 365,2021-06-05,11:00:00,138,62,76,FMN GV 05 Lier
60,Mechelsesteenweg 365,2021-06-05,12:00:00,74,18,56,FMN GV 05 Lier
60,Mechelsesteenweg 365,2021-06-05,13:00:00,144,102,42,FMN GV 05 Lier
60,Mechelsesteenweg 365,2021-06-05,14:00:00,122,58,64,FMN GV 05 Lier
60,Mechelsesteenweg 365,2021-06-05,15:00:00,138,56,82,FMN GV 05 Lier
60,Mechelsesteenweg 365,2021-06-05,16:00:00,140,78,62,FMN GV 05 Lier
60,Mechelsesteenweg 365,2021-06-05,17:00:00,56,18,38,FMN GV 05 Lier
60,Mechelsesteenweg 365,2021-06-05,18:00:00,46,30,16,FMN GV 05 Lier
60,Mechelsesteenweg 365,2021-06-05,19:00:00,36,10,26,FMN GV 05 Lier
60,Mechelsesteenweg 365,2021-06-05,20:00:00,62,24,38,FMN GV 05 Lier
60,Mechelsesteenweg 365,2021-06-05,21:00:00,26,16,10,FMN GV 05 Lier
60,Mechelsesteenweg 365,2021-06-05,22:00:00,12,2,10,FMN GV 05 Lier
60,Mechelsesteenweg 365,2021-06-05,23:00:00,4,4,0,FMN GV 05 Lier
60,Mechelsesteenweg 365,2021-06-06,00:00:00,0,0,0,FMN GV 05 Lier
60,Mechelsesteenweg 365,2021-06-06,01:00:00,0,0,0,FMN GV 05 Lier
60,Mechelsesteenweg 365,2021-06-06,02:00:00,0,0,0,FMN GV 05 Lier
60,Mechelsesteenweg 365,2021-06-06,03:00:00,0,0,0,FMN GV 05 Lier
60,Mechelsesteenweg 365,2021-06-06,04:00:00,0,0,0,FMN GV 05 Lier
60,Mechelsesteenweg 365,2021-06-06,05:00:00,4,0,4,FMN GV 05 Lier
60,Mechelsesteenweg 365,2021-06-06,06:00:00,12,8,4,FMN GV 05 Lier
60,Mechelsesteenweg 365,2021-06-06,07:00:00,46,24,22,FMN GV 05 Lier
60,Mechelsesteenweg 365,2021-06-06,08:00:00,90,40,50,FMN GV 05 Lier
60,Mechelsesteenweg 365,2021-06-06,09:00:00,280,176,104,FMN GV 05 Lier
60,Mechelsesteenweg 365,2021-06-06,10:00:00,180,104,76,FMN GV 05 Lier
60,Mechelsesteenweg 365,2021-06-06,11:00:00,0,0,0,FMN GV 05 Lier
60,Mechelsesteenweg 365,2021-06-06,12:00:00,0,0,0,FMN GV 05 Lier
60,Mechelsesteenweg 365,2021-06-06,13:00:00,0,0,0,FMN GV 05 Lier
60,Mechelsesteenweg 365,2021-06-06,14:00:00,0,0,0,FMN GV 05 Lier
60,Mechelsesteenweg 365,2021-06-06,15:00:00,0,0,0,FMN GV 05 Lier
60,Mechelsesteenweg 365,2021-06-06,16:00:00,0,0,0,FMN GV 05 Lier
60,Mechelsesteenweg 365,2021-06-06,17:00:00,0,0,0,FMN GV 05 Lier
60,Mechelsesteenweg 365,2021-06-06,18:00:00,0,0,0,FMN GV 05 Lier
60,Mechelsesteenweg 365,2021-06-06,19:00:00,26,10,16,FMN GV 05 Lier
60,Mechelsesteenweg 365,2021-06-06,20:00:00,100,56,44,FMN GV 05 Lier
60,Mechelsesteenweg 365,2021-06-06,21:00:00,56,30,26,FMN GV 05 Lier
60,Mechelsesteenweg 365,2021-06-06,22:00:00,22,8,14,FMN GV 05 Lier
60,Mechelsesteenweg 365,2021-06-06,23:00:00,6,4,2,FMN GV 05 Lier
60,Mechelsesteenweg 365,2021-06-07,00:00:00,4,0,4,FMN GV 05 Lier
60,Mechelsesteenweg 365,2021-06-07,01:00:00,0,0,0,FMN GV 05 Lier
60,Mechelsesteenweg 365,2021-06-07,02:00:00,0,0,0,FMN GV 05 Lier
60,Mechelsesteenweg 365,2021-06-07,03:00:00,0,0,0,FMN GV 05 Lier
60,Mechelsesteenweg 365,2021-06-07,04:00:00,2,0,2,FMN GV 05 Lier
60,Mechelsesteenweg 365,2021-06-07,05:00:00,8,0,8,FMN GV 05 Lier
60,Mechelsesteenweg 365,2021-06-07,06:00:00,46,18,28,FMN GV 05 Lier
60,Mechelsesteenweg 365,2021-06-07,07:00:00,88,28,60,FMN GV 05 Lier
60,Mechelsesteenweg 365,2021-06-07,08:00:00,8,2,6,FMN GV 05 Lier
60,Mechelsesteenweg 365,2021-06-07,09:00:00,0,0,0,FMN GV 05 Lier
60,Mechelsesteenweg 365,2021-06-07,10:00:00,6,4,2,FMN GV 05 Lier
60,Mechelsesteenweg 365,2021-06-07,11:00:00,0,0,0,FMN GV 05 Lier
60,Mechelsesteenweg 365,2021-06-07,12:00:00,0,0,0,FMN GV 05 Lier
60,Mechelsesteenweg 365,2021-06-07,13:00:00,0,0,0,FMN GV 05 Lier
60,Mechelsesteenweg 365,2021-06-07,14:00:00,0,0,0,FMN GV 05 Lier
60,Mechelsesteenweg 365,2021-06-07,15:00:00,0,0,0,FMN GV 05 Lier
60,Mechelsesteenweg 365,2021-06-07,16:00:00,0,0,0,FMN GV 05 Lier
60,Mechelsesteenweg 365,2021-06-07,17:00:00,0,0,0,FMN GV 05 Lier
60,Mechelsesteenweg 365,2021-06-07,18:00:00,0,0,0,FMN GV 05 Lier
60,Mechelsesteenweg 365,2021-06-07,19:00:00,10,0,10,FMN GV 05 Lier
60,Mechelsesteenweg 365,2021-06-07,20:00:00,52,14,38,FMN GV 05 Lier
60,Mechelsesteenweg 365,2021-06-07,21:00:00,22,6,16,FMN GV 05 Lier
60,Mechelsesteenweg 365,2021-06-07,22:00:00,2,2,0,FMN GV 05 Lier
60,Mechelsesteenweg 365,2021-06-07,23:00:00,4,4,0,FMN GV 05 Lier
60,Mechelsesteenweg 365,2021-06-08,00:00:00,0,0,0,FMN GV 05 Lier
60,Mechelsesteenweg 365,2021-06-08,01:00:00,0,0,0,FMN GV 05 Lier
60,Mechelsesteenweg 365,2021-06-08,02:00:00,0,0,0,FMN GV 05 Lier
60,Mechelsesteenweg 365,2021-06-08,03:00:00,0,0,0,FMN GV 05 Lier
60,Mechelsesteenweg 365,2021-06-08,04:00:00,2,0,2,FMN GV 05 Lier
60,Mechelsesteenweg 365,2021-06-08,05:00:00,8,0,8,FMN GV 05 Lier
60,Mechelsesteenweg 365,2021-06-08,06:00:00,6,2,4,FMN GV 05 Lier
60,Mechelsesteenweg 365,2021-06-08,07:00:00,8,8,0,FMN GV 05 Lier
60,Mechelsesteenweg 365,2021-06-08,08:00:00,6,0,6,FMN GV 05 Lier
60,Mechelsesteenweg 365,2021-06-08,09:00:00,0,0,0,FMN GV 05 Lier
60,Mechelsesteenweg 365,2021-06-08,10:00:00,0,0,0,FMN GV 05 Lier
60,Mechelsesteenweg 365,2021-06-08,11:00:00,0,0,0,FMN GV 05 Lier
60,Mechelsesteenweg 365,2021-06-08,12:00:00,0,0,0,FMN GV 05 Lier
60,Mechelsesteenweg 365,2021-06-08,13:00:00,0,0,0,FMN GV 05 Lier
60,Mechelsesteenweg 365,2021-06-08,14:00:00,0,0,0,FMN GV 05 Lier
60,Mechelsesteenweg 365,2021-06-08,15:00:00,0,0,0,FMN GV 05 Lier
60,Mechelsesteenweg 365,2021-06-08,16:00:00,0,0,0,FMN GV 05 Lier
60,Mechelsesteenweg 365,2021-06-08,17:00:00,8,0,8,FMN GV 05 Lier
60,Mechelsesteenweg 365,2021-06-08,18:00:00,38,18,20,FMN GV 05 Lier
60,Mechelsesteenweg 365,2021-06-08,19:00:00,24,4,20,FMN GV 05 Lier
60,Mechelsesteenweg 365,2021-06-08,20:00:00,24,8,16,FMN GV 05 Lier
60,Mechelsesteenweg 365,2021-06-08,21:00:00,24,2,22,FMN GV 05 Lier
60,Mechelsesteenweg 365,2021-06-08,22:00:00,8,6,2,FMN GV 05 Lier
60,Mechelsesteenweg 365,2021-06-08,23:00:00,2,2,0,FMN GV 05 Lier
60,Mechelsesteenweg 365,2021-06-09,00:00:00,2,0,2,FMN GV 05 Lier
60,Mechelsesteenweg 365,2021-06-09,01:00:00,0,0,0,FMN GV 05 Lier
60,Mechelsesteenweg 365,2021-06-09,02:00:00,0,0,0,FMN GV 05 Lier
60,Mechelsesteenweg 365,2021-06-09,03:00:00,0,0,0,FMN GV 05 Lier
60,Mechelsesteenweg 365,2021-06-09,04:00:00,2,0,2,FMN GV 05 Lier
60,Mechelsesteenweg 365,2021-06-09,05:00:00,12,2,10,FMN GV 05 Lier
60,Mechelsesteenweg 365,2021-06-09,06:00:00,12,4,8,FMN GV 05 Lier
60,Mechelsesteenweg 365,2021-06-09,07:00:00,18,6,12,FMN GV 05 Lier
60,Mechelsesteenweg 365,2021-06-09,08:00:00,2,0,2,FMN GV 05 Lier
60,Mechelsesteenweg 365,2021-06-09,09:00:00,0,0,0,FMN GV 05 Lier
60,Mechelsesteenweg 365,2021-06-09,10:00:00,2,2,0,FMN GV 05 Lier
60,Mechelsesteenweg 365,2021-06-09,11:00:00,0,0,0,FMN GV 05 Lier
60,Mechelsesteenweg 365,2021-06-09,12:00:00,0,0,0,FMN GV 05 Lier
60,Mechelsesteenweg 365,2021-06-09,13:00:00,0,0,0,FMN GV 05 Lier
60,Mechelsesteenweg 365,2021-06-09,14:00:00,0,0,0,FMN GV 05 Lier
60,Mechelsesteenweg 365,2021-06-09,15:00:00,0,0,0,FMN GV 05 Lier
60,Mechelsesteenweg 365,2021-06-09,16:00:00,0,0,0,FMN GV 05 Lier
60,Mechelsesteenweg 365,2021-06-09,17:00:00,0,0,0,FMN GV 05 Lier
60,Mechelsesteenweg 365,2021-06-09,18:00:00,26,8,18,FMN GV 05 Lier
60,Mechelsesteenweg 365,2021-06-09,19:00:00,58,18,40,FMN GV 05 Lier
60,Mechelsesteenweg 365,2021-06-09,20:00:00,74,4,70,FMN GV 05 Lier
60,Mechelsesteenweg 365,2021-06-09,21:00:00,36,14,22,FMN GV 05 Lier
60,Mechelsesteenweg 365,2021-06-09,22:00:00,10,10,0,FMN GV 05 Lier
60,Mechelsesteenweg 365,2021-06-09,23:00:00,4,0,4,FMN GV 05 Lier
60,Mechelsesteenweg 365,2021-06-10,00:00:00,2,0,2,FMN GV 05 Lier
60,Mechelsesteenweg 365,2021-06-10,01:00:00,0,0,0,FMN GV 05 Lier
60,Mechelsesteenweg 365,2021-06-10,02:00:00,0,0,0,FMN GV 05 Lier
60,Mechelsesteenweg 365,2021-06-10,03:00:00,0,0,0,FMN GV 05 Lier
60,Mechelsesteenweg 365,2021-06-10,04:00:00,2,0,2,FMN GV 05 Lier
60,Mechelsesteenweg 365,2021-06-10,05:00:00,4,0,4,FMN GV 05 Lier
60,Mechelsesteenweg 365,2021-06-10,06:00:00,6,0,6,FMN GV 05 Lier
60,Mechelsesteenweg 365,2021-06-10,07:00:00,12,4,8,FMN GV 05 Lier
60,Mechelsesteenweg 365,2021-06-10,08:00:00,4,2,2,FMN GV 05 Lier
60,Mechelsesteenweg 365,2021-06-10,09:00:00,10,2,8,FMN GV 05 Lier
60,Mechelsesteenweg 365,2021-06-10,10:00:00,14,8,6,FMN GV 05 Lier
60,Mechelsesteenweg 365,2021-06-10,11:00:00,0,0,0,FMN GV 05 Lier
60,Mechelsesteenweg 365,2021-06-10,12:00:00,0,0,0,FMN GV 05 Lier
60,Mechelsesteenweg 365,2021-06-10,13:00:00,0,0,0,FMN GV 05 Lier
60,Mechelsesteenweg 365,2021-06-10,14:00:00,0,0,0,FMN GV 05 Lier
60,Mechelsesteenweg 365,2021-06-10,15:00:00,0,0,0,FMN GV 05 Lier
60,Mechelsesteenweg 365,2021-06-10,16:00:00,0,0,0,FMN GV 05 Lier
60,Mechelsesteenweg 365,2021-06-10,17:00:00,14,2,12,FMN GV 05 Lier
60,Mechelsesteenweg 365,2021-06-10,18:00:00,48,34,14,FMN GV 05 Lier
60,Mechelsesteenweg 365,2021-06-10,19:00:00,124,52,72,FMN GV 05 Lier
60,Mechelsesteenweg 365,2021-06-10,20:00:00,116,42,74,FMN GV 05 Lier
60,Mechelsesteenweg 365,2021-06-10,21:00:00,40,12,28,FMN GV 05 Lier
60,Mechelsesteenweg 365,2021-06-10,22:00:00,14,8,6,FMN GV 05 Lier
60,Mechelsesteenweg 365,2021-06-10,23:00:00,2,0,2,FMN GV 05 Lier
60,Mechelsesteenweg 365,2021-06-11,00:00:00,2,2,0,FMN GV 05 Lier
60,Mechelsesteenweg 365,2021-06-11,01:00:00,0,0,0,FMN GV 05 Lier
60,Mechelsesteenweg 365,2021-06-11,02:00:00,0,0,0,FMN GV 05 Lier
60,Mechelsesteenweg 365,2021-06-11,03:00:00,0,0,0,FMN GV 05 Lier
60,Mechelsesteenweg 365,2021-06-11,04:00:00,0,0,0,FMN GV 05 Lier
60,Mechelsesteenweg 365,2021-06-11,05:00:00,6,0,6,FMN GV 05 Lier
60,Mechelsesteenweg 365,2021-06-11,06:00:00,12,2,10,FMN GV 05 Lier
60,Mechelsesteenweg 365,2021-06-11,07:00:00,64,46,18,FMN GV 05 Lier
60,Mechelsesteenweg 365,2021-06-11,08:00:00,40,22,18,FMN GV 05 Lier
60,Mechelsesteenweg 365,2021-06-11,09:00:00,136,108,28,FMN GV 05 Lier
60,Mechelsesteenweg 365,2021-06-11,10:00:00,78,36,42,FMN GV 05 Lier
60,Mechelsesteenweg 365,2021-06-11,11:00:00,12,4,8,FMN GV 05 Lier
60,Mechelsesteenweg 365,2021-06-11,12:00:00,0,0,0,FMN GV 05 Lier
60,Mechelsesteenweg 365,2021-06-11,13:00:00,0,0,0,FMN GV 05 Lier
60,Mechelsesteenweg 365,2021-06-11,14:00:00,0,0,0,FMN GV 05 Lier
60,Mechelsesteenweg 365,2021-06-11,15:00:00,0,0,0,FMN GV 05 Lier
60,Mechelsesteenweg 365,2021-06-11,16:00:00,12,6,6,FMN GV 05 Lier
60,Mechelsesteenweg 365,2021-06-11,17:00:00,26,20,6,FMN GV 05 Lier
60,Mechelsesteenweg 365,2021-06-11,18:00:00,106,58,48,FMN GV 05 Lier
60,Mechelsesteenweg 365,2021-06-11,19:00:00,92,38,54,FMN GV 05 Lier
60,Mechelsesteenweg 365,2021-06-11,20:00:00,112,58,54,FMN GV 05 Lier
60,Mechelsesteenweg 365,2021-06-11,21:00:00,36,22,14,FMN GV 05 Lier
60,Mechelsesteenweg 365,2021-06-11,22:00:00,32,20,12,FMN GV 05 Lier
60,Mechelsesteenweg 365,2021-06-11,23:00:00,14,6,8,FMN GV 05 Lier
60,Mechelsesteenweg 365,2021-06-12,00:00:00,8,6,2,FMN GV 05 Lier
60,Mechelsesteenweg 365,2021-06-12,01:00:00,0,0,0,FMN GV 05 Lier
60,Mechelsesteenweg 365,2021-06-12,02:00:00,2,0,2,FMN GV 05 Lier
60,Mechelsesteenweg 365,2021-06-12,03:00:00,4,2,2,FMN GV 05 Lier
60,Mechelsesteenweg 365,2021-06-12,04:00:00,0,0,0,FMN GV 05 Lier
60,Mechelsesteenweg 365,2021-06-12,05:00:00,2,0,2,FMN GV 05 Lier
60,Mechelsesteenweg 365,2021-06-12,06:00:00,12,4,8,FMN GV 05 Lier
60,Mechelsesteenweg 365,2021-06-12,07:00:00,30,18,12,FMN GV 05 Lier
60,Mechelsesteenweg 365,2021-06-12,08:00:00,32,10,22,FMN GV 05 Lier
60,Mechelsesteenweg 365,2021-06-12,09:00:00,86,36,50,FMN GV 05 Lier
60,Mechelsesteenweg 365,2021-06-12,10:00:00,186,80,106,FMN GV 05 Lier
60,Mechelsesteenweg 365,2021-06-12,11:00:00,176,98,78,FMN GV 05 Lier
60,Mechelsesteenweg 365,2021-06-12,12:00:00,140,60,80,FMN GV 05 Lier
60,Mechelsesteenweg 365,2021-06-12,13:00:00,170,90,80,FMN GV 05 Lier
60,Mechelsesteenweg 365,2021-06-12,14:00:00,94,54,40,FMN GV 05 Lier
60,Mechelsesteenweg 365,2021-06-12,15:00:00,80,28,52,FMN GV 05 Lier
60,Mechelsesteenweg 365,2021-06-12,16:00:00,140,68,72,FMN GV 05 Lier
60,Mechelsesteenweg 365,2021-06-12,17:00:00,116,50,66,FMN GV 05 Lier
60,Mechelsesteenweg 365,2021-06-12,18:00:00,96,50,46,FMN GV 05 Lier
60,Mechelsesteenweg 365,2021-06-12,19:00:00,70,24,46,FMN GV 05 Lier
60,Mechelsesteenweg 365,2021-06-12,20:00:00,52,28,24,FMN GV 05 Lier
60,Mechelsesteenweg 365,2021-06-12,21:00:00,26,24,2,FMN GV 05 Lier
60,Mechelsesteenweg 365,2021-06-12,22:00:00,12,6,6,FMN GV 05 Lier
60,Mechelsesteenweg 365,2021-06-12,23:00:00,42,18,24,FMN GV 05 Lier
60,Mechelsesteenweg 365,2021-06-13,00:00:00,20,16,4,FMN GV 05 Lier
60,Mechelsesteenweg 365,2021-06-13,01:00:00,2,0,2,FMN GV 05 Lier
60,Mechelsesteenweg 365,2021-06-13,02:00:00,2,2,0,FMN GV 05 Lier
60,Mechelsesteenweg 365,2021-06-13,03:00:00,0,0,0,FMN GV 05 Lier
60,Mechelsesteenweg 365,2021-06-13,04:00:00,0,0,0,FMN GV 05 Lier
60,Mechelsesteenweg 365,2021-06-13,05:00:00,2,2,0,FMN GV 05 Lier
60,Mechelsesteenweg 365,2021-06-13,06:00:00,8,6,2,FMN GV 05 Lier
60,Mechelsesteenweg 365,2021-06-13,07:00:00,14,12,2,FMN GV 05 Lier
60,Mechelsesteenweg 365,2021-06-13,08:00:00,102,54,48,FMN GV 05 Lier
60,Mechelsesteenweg 365,2021-06-13,09:00:00,254,148,106,FMN GV 05 Lier
60,Mechelsesteenweg 365,2021-06-13,10:00:00,406,196,210,FMN GV 05 Lier
60,Mechelsesteenweg 365,2021-06-13,11:00:00,234,124,110,FMN GV 05 Lier
60,Mechelsesteenweg 365,2021-06-13,12:00:00,0,0,0,FMN GV 05 Lier
60,Mechelsesteenweg 365,2021-06-13,13:00:00,0,0,0,FMN GV 05 Lier
60,Mechelsesteenweg 365,2021-06-13,14:00:00,0,0,0,FMN GV 05 Lier
60,Mechelsesteenweg 365,2021-06-13,15:00:00,0,0,0,FMN GV 05 Lier
60,Mechelsesteenweg 365,2021-06-13,16:00:00,0,0,0,FMN GV 05 Lier
60,Mechelsesteenweg 365,2021-06-13,17:00:00,6,4,2,FMN GV 05 Lier
60,Mechelsesteenweg 365,2021-06-13,18:00:00,78,36,42,FMN GV 05 Lier
60,Mechelsesteenweg 365,2021-06-13,19:00:00,124,50,74,FMN GV 05 Lier
60,Mechelsesteenweg 365,2021-06-13,20:00:00,126,42,84,FMN GV 05 Lier
60,Mechelsesteenweg 365,2021-06-13,21:00:00,56,28,28,FMN GV 05 Lier
60,Mechelsesteenweg 365,2021-06-13,22:00:00,10,4,6,FMN GV 05 Lier
60,Mechelsesteenweg 365,2021-06-13,23:00:00,6,2,4,FMN GV 05 Lier
60,Mechelsesteenweg 365,2021-06-14,00:00:00,0,0,0,FMN GV 05 Lier
60,Mechelsesteenweg 365,2021-06-14,01:00:00,0,0,0,FMN GV 05 Lier
60,Mechelsesteenweg 365,2021-06-14,02:00:00,0,0,0,FMN GV 05 Lier
60,Mechelsesteenweg 365,2021-06-14,03:00:00,2,0,2,FMN GV 05 Lier
60,Mechelsesteenweg 365,2021-06-14,04:00:00,0,0,0,FMN GV 05 Lier
60,Mechelsesteenweg 365,2021-06-14,05:00:00,4,0,4,FMN GV 05 Lier
60,Mechelsesteenweg 365,2021-06-14,06:00:00,48,22,26,FMN GV 05 Lier
60,Mechelsesteenweg 365,2021-06-14,07:00:00,208,130,78,FMN GV 05 Lier
60,Mechelsesteenweg 365,2021-06-14,08:00:00,118,82,36,FMN GV 05 Lier
60,Mechelsesteenweg 365,2021-06-14,09:00:00,126,70,56,FMN GV 05 Lier
60,Mechelsesteenweg 365,2021-06-14,10:00:00,148,78,70,FMN GV 05 Lier
60,Mechelsesteenweg 365,2021-06-14,11:00:00,52,28,24,FMN GV 05 Lier
60,Mechelsesteenweg 365,2021-06-14,12:00:00,0,0,0,FMN GV 05 Lier
60,Mechelsesteenweg 365,2021-06-14,13:00:00,0,0,0,FMN GV 05 Lier
60,Mechelsesteenweg 365,2021-06-14,14:00:00,0,0,0,FMN GV 05 Lier
60,Mechelsesteenweg 365,2021-06-14,15:00:00,0,0,0,FMN GV 05 Lier
60,Mechelsesteenweg 365,2021-06-14,16:00:00,0,0,0,FMN GV 05 Lier
60,Mechelsesteenweg 365,2021-06-14,17:00:00,0,0,0,FMN GV 05 Lier
60,Mechelsesteenweg 365,2021-06-14,18:00:00,122,66,56,FMN GV 05 Lier
60,Mechelsesteenweg 365,2021-06-14,19:00:00,130,66,64,FMN GV 05 Lier
60,Mechelsesteenweg 365,2021-06-14,20:00:00,182,100,82,FMN GV 05 Lier
60,Mechelsesteenweg 365,2021-06-14,21:00:00,152,88,64,FMN GV 05 Lier
60,Mechelsesteenweg 365,2021-06-14,22:00:00,24,6,18,FMN GV 05 Lier
60,Mechelsesteenweg 365,2021-06-14,23:00:00,10,2,8,FMN GV 05 Lier
60,Mechelsesteenweg 365,2021-06-15,00:00:00,0,0,0,FMN GV 05 Lier
60,Mechelsesteenweg 365,2021-06-15,01:00:00,0,0,0,FMN GV 05 Lier
60,Mechelsesteenweg 365,2021-06-15,02:00:00,0,0,0,FMN GV 05 Lier
60,Mechelsesteenweg 365,2021-06-15,03:00:00,2,0,2,FMN GV 05 Lier
60,Mechelsesteenweg 365,2021-06-15,04:00:00,4,0,4,FMN GV 05 Lier
60,Mechelsesteenweg 365,2021-06-15,05:00:00,20,8,12,FMN GV 05 Lier
60,Mechelsesteenweg 365,2021-06-15,06:00:00,60,30,30,FMN GV 05 Lier
60,Mechelsesteenweg 365,2021-06-15,07:00:00,224,124,100,FMN GV 05 Lier
60,Mechelsesteenweg 365,2021-06-15,08:00:00,176,104,72,FMN GV 05 Lier
60,Mechelsesteenweg 365,2021-06-15,09:00:00,148,62,86,FMN GV 05 Lier
60,Mechelsesteenweg 365,2021-06-15,10:00:00,190,100,90,FMN GV 05 Lier
60,Mechelsesteenweg 365,2021-06-15,11:00:00,188,122,66,FMN GV 05 Lier
60,Mechelsesteenweg 365,2021-06-15,12:00:00,84,32,52,FMN GV 05 Lier
60,Mechelsesteenweg 365,2021-06-15,13:00:00,0,0,0,FMN GV 05 Lier
60,Mechelsesteenweg 365,2021-06-15,14:00:00,6,0,6,FMN GV 05 Lier
60,Mechelsesteenweg 365,2021-06-15,15:00:00,0,0,0,FMN GV 05 Lier
60,Mechelsesteenweg 365,2021-06-15,16:00:00,0,0,0,FMN GV 05 Lier
60,Mechelsesteenweg 365,2021-06-15,17:00:00,82,46,36,FMN GV 05 Lier
60,Mechelsesteenweg 365,2021-06-15,18:00:00,126,56,70,FMN GV 05 Lier
60,Mechelsesteenweg 365,2021-06-15,19:00:00,164,82,82,FMN GV 05 Lier
60,Mechelsesteenweg 365,2021-06-15,20:00:00,214,86,128,FMN GV 05 Lier
60,Mechelsesteenweg 365,2021-06-15,21:00:00,92,30,62,FMN GV 05 Lier
60,Mechelsesteenweg 365,2021-06-15,22:00:00,24,4,20,FMN GV 05 Lier
60,Mechelsesteenweg 365,2021-06-15,23:00:00,6,0,6,FMN GV 05 Lier
60,Mechelsesteenweg 365,2021-06-16,00:00:00,2,0,2,FMN GV 05 Lier
60,Mechelsesteenweg 365,2021-06-16,01:00:00,0,0,0,FMN GV 05 Lier
60,Mechelsesteenweg 365,2021-06-16,02:00:00,0,0,0,FMN GV 05 Lier
60,Mechelsesteenweg 365,2021-06-16,03:00:00,2,0,2,FMN GV 05 Lier
60,Mechelsesteenweg 365,2021-06-16,04:00:00,6,0,6,FMN GV 05 Lier
60,Mechelsesteenweg 365,2021-06-16,05:00:00,12,6,6,FMN GV 05 Lier
60,Mechelsesteenweg 365,2021-06-16,06:00:00,60,30,30,FMN GV 05 Lier
60,Mechelsesteenweg 365,2021-06-16,07:00:00,238,156,82,FMN GV 05 Lier
60,Mechelsesteenweg 365,2021-06-16,08:00:00,152,98,54,FMN GV 05 Lier
60,Mechelsesteenweg 365,2021-06-16,09:00:00,212,82,130,FMN GV 05 Lier
60,Mechelsesteenweg 365,2021-06-16,10:00:00,216,86,130,FMN GV 05 Lier
60,Mechelsesteenweg 365,2021-06-16,11:00:00,80,28,52,FMN GV 05 Lier
60,Mechelsesteenweg 365,2021-06-16,12:00:00,0,0,0,FMN GV 05 Lier
60,Mechelsesteenweg 365,2021-06-16,13:00:00,0,0,0,FMN GV 05 Lier
60,Mechelsesteenweg 365,2021-06-16,14:00:00,2,0,2,FMN GV 05 Lier
60,Mechelsesteenweg 365,2021-06-16,15:00:00,0,0,0,FMN GV 05 Lier
60,Mechelsesteenweg 365,2021-06-16,16:00:00,0,0,0,FMN GV 05 Lier
60,Mechelsesteenweg 365,2021-06-16,17:00:00,0,0,0,FMN GV 05 Lier
60,Mechelsesteenweg 365,2021-06-16,18:00:00,88,42,46,FMN GV 05 Lier
60,Mechelsesteenweg 365,2021-06-16,19:00:00,258,176,82,FMN GV 05 Lier
60,Mechelsesteenweg 365,2021-06-16,20:00:00,322,188,134,FMN GV 05 Lier
60,Mechelsesteenweg 365,2021-06-16,21:00:00,158,70,88,FMN GV 05 Lier
60,Mechelsesteenweg 365,2021-06-16,22:00:00,24,4,20,FMN GV 05 Lier
60,Mechelsesteenweg 365,2021-06-16,23:00:00,14,4,10,FMN GV 05 Lier
60,Mechelsesteenweg 365,2021-06-17,00:00:00,4,0,4,FMN GV 05 Lier
60,Mechelsesteenweg 365,2021-06-17,01:00:00,8,4,4,FMN GV 05 Lier
60,Mechelsesteenweg 365,2021-06-17,02:00:00,0,0,0,FMN GV 05 Lier
60,Mechelsesteenweg 365,2021-06-17,03:00:00,2,0,2,FMN GV 05 Lier
60,Mechelsesteenweg 365,2021-06-17,04:00:00,4,0,4,FMN GV 05 Lier
60,Mechelsesteenweg 365,2021-06-17,05:00:00,16,4,12,FMN GV 05 Lier
60,Mechelsesteenweg 365,2021-06-17,06:00:00,44,20,24,FMN GV 05 Lier
60,Mechelsesteenweg 365,2021-06-17,07:00:00,202,114,88,FMN GV 05 Lier
60,Mechelsesteenweg 365,2021-06-17,08:00:00,144,86,58,FMN GV 05 Lier
60,Mechelsesteenweg 365,2021-06-17,09:00:00,102,60,42,FMN GV 05 Lier
60,Mechelsesteenweg 365,2021-06-17,10:00:00,204,76,128,FMN GV 05 Lier
60,Mechelsesteenweg 365,2021-06-17,11:00:00,124,42,82,FMN GV 05 Lier
60,Mechelsesteenweg 365,2021-06-17,12:00:00,82,24,58,FMN GV 05 Lier
60,Mechelsesteenweg 365,2021-06-17,13:00:00,0,0,0,FMN GV 05 Lier
60,Mechelsesteenweg 365,2021-06-17,14:00:00,0,0,0,FMN GV 05 Lier
60,Mechelsesteenweg 365,2021-06-17,15:00:00,0,0,0,FMN GV 05 Lier
60,Mechelsesteenweg 365,2021-06-17,16:00:00,0,0,0,FMN GV 05 Lier
60,Mechelsesteenweg 365,2021-06-17,17:00:00,14,6,8,FMN GV 05 Lier
60,Mechelsesteenweg 365,2021-06-17,18:00:00,56,32,24,FMN GV 05 Lier
60,Mechelsesteenweg 365,2021-06-17,19:00:00,62,36,26,FMN GV 05 Lier
60,Mechelsesteenweg 365,2021-06-17,20:00:00,102,52,50,FMN GV 05 Lier
60,Mechelsesteenweg 365,2021-06-17,21:00:00,70,24,46,FMN GV 05 Lier
60,Mechelsesteenweg 365,2021-06-17,22:00:00,26,14,12,FMN GV 05 Lier
60,Mechelsesteenweg 365,2021-06-17,23:00:00,2,2,0,FMN GV 05 Lier
60,Mechelsesteenweg 365,2021-06-18,00:00:00,4,0,4,FMN GV 05 Lier
60,Mechelsesteenweg 365,2021-06-18,01:00:00,0,0,0,FMN GV 05 Lier
60,Mechelsesteenweg 365,2021-06-18,02:00:00,2,0,2,FMN GV 05 Lier
60,Mechelsesteenweg 365,2021-06-18,03:00:00,2,0,2,FMN GV 05 Lier
60,Mechelsesteenweg 365,2021-06-18,04:00:00,2,0,2,FMN GV 05 Lier
60,Mechelsesteenweg 365,2021-06-18,05:00:00,6,0,6,FMN GV 05 Lier
60,Mechelsesteenweg 365,2021-06-18,06:00:00,16,8,8,FMN GV 05 Lier
60,Mechelsesteenweg 365,2021-06-18,07:00:00,136,84,52,FMN GV 05 Lier
60,Mechelsesteenweg 365,2021-06-18,08:00:00,112,82,30,FMN GV 05 Lier
60,Mechelsesteenweg 365,2021-06-18,09:00:00,138,94,44,FMN GV 05 Lier
60,Mechelsesteenweg 365,2021-06-18,10:00:00,232,112,120,FMN GV 05 Lier
60,Mechelsesteenweg 365,2021-06-18,11:00:00,152,66,86,FMN GV 05 Lier
60,Mechelsesteenweg 365,2021-06-18,12:00:00,16,6,10,FMN GV 05 Lier
60,Mechelsesteenweg 365,2021-06-18,13:00:00,0,0,0,FMN GV 05 Lier
60,Mechelsesteenweg 365,2021-06-18,14:00:00,2,0,2,FMN GV 05 Lier
60,Mechelsesteenweg 365,2021-06-18,15:00:00,6,0,6,FMN GV 05 Lier
60,Mechelsesteenweg 365,2021-06-18,16:00:00,44,26,18,FMN GV 05 Lier
60,Mechelsesteenweg 365,2021-06-18,17:00:00,76,46,30,FMN GV 05 Lier
60,Mechelsesteenweg 365,2021-06-18,18:00:00,70,42,28,FMN GV 05 Lier
60,Mechelsesteenweg 365,2021-06-18,19:00:00,64,22,42,FMN GV 05 Lier
60,Mechelsesteenweg 365,2021-06-18,20:00:00,106,74,32,FMN GV 05 Lier
60,Mechelsesteenweg 365,2021-06-18,21:00:00,52,24,28,FMN GV 05 Lier
60,Mechelsesteenweg 365,2021-06-18,22:00:00,34,16,18,FMN GV 05 Lier
60,Mechelsesteenweg 365,2021-06-18,23:00:00,30,10,20,FMN GV 05 Lier
60,Mechelsesteenweg 365,2021-06-19,00:00:00,2,2,0,FMN GV 05 Lier
60,Mechelsesteenweg 365,2021-06-19,01:00:00,4,2,2,FMN GV 05 Lier
60,Mechelsesteenweg 365,2021-06-19,02:00:00,0,0,0,FMN GV 05 Lier
60,Mechelsesteenweg 365,2021-06-19,03:00:00,0,0,0,FMN GV 05 Lier
60,Mechelsesteenweg 365,2021-06-19,04:00:00,0,0,0,FMN GV 05 Lier
60,Mechelsesteenweg 365,2021-06-19,05:00:00,6,4,2,FMN GV 05 Lier
60,Mechelsesteenweg 365,2021-06-19,06:00:00,10,4,6,FMN GV 05 Lier
60,Mechelsesteenweg 365,2021-06-19,07:00:00,22,14,8,FMN GV 05 Lier
60,Mechelsesteenweg 365,2021-06-19,08:00:00,52,28,24,FMN GV 05 Lier
60,Mechelsesteenweg 365,2021-06-19,09:00:00,100,30,70,FMN GV 05 Lier
60,Mechelsesteenweg 365,2021-06-19,10:00:00,240,130,110,FMN GV 05 Lier
60,Mechelsesteenweg 365,2021-06-19,11:00:00,270,128,142,FMN GV 05 Lier
60,Mechelsesteenweg 365,2021-06-19,12:00:00,144,58,86,FMN GV 05 Lier
60,Mechelsesteenweg 365,2021-06-19,13:00:00,222,128,94,FMN GV 05 Lier
60,Mechelsesteenweg 365,2021-06-19,14:00:00,280,178,102,FMN GV 05 Lier
60,Mechelsesteenweg 365,2021-06-19,15:00:00,218,120,98,FMN GV 05 Lier
60,Mechelsesteenweg 365,2021-06-19,16:00:00,294,144,150,FMN GV 05 Lier
60,Mechelsesteenweg 365,2021-06-19,17:00:00,176,88,88,FMN GV 05 Lier
60,Mechelsesteenweg 365,2021-06-19,18:00:00,72,30,42,FMN GV 05 Lier
60,Mechelsesteenweg 365,2021-06-19,19:00:00,82,38,44,FMN GV 05 Lier
60,Mechelsesteenweg 365,2021-06-19,20:00:00,54,26,28,FMN GV 05 Lier
60,Mechelsesteenweg 365,2021-06-19,21:00:00,24,10,14,FMN GV 05 Lier
60,Mechelsesteenweg 365,2021-06-19,22:00:00,16,2,14,FMN GV 05 Lier
60,Mechelsesteenweg 365,2021-06-19,23:00:00,2,2,0,FMN GV 05 Lier
60,Mechelsesteenweg 365,2021-06-20,00:00:00,4,0,4,FMN GV 05 Lier
60,Mechelsesteenweg 365,2021-06-20,01:00:00,0,0,0,FMN GV 05 Lier
60,Mechelsesteenweg 365,2021-06-20,02:00:00,0,0,0,FMN GV 05 Lier
60,Mechelsesteenweg 365,2021-06-20,03:00:00,0,0,0,FMN GV 05 Lier
60,Mechelsesteenweg 365,2021-06-20,04:00:00,0,0,0,FMN GV 05 Lier
60,Mechelsesteenweg 365,2021-06-20,05:00:00,4,2,2,FMN GV 05 Lier
60,Mechelsesteenweg 365,2021-06-20,06:00:00,4,4,0,FMN GV 05 Lier
60,Mechelsesteenweg 365,2021-06-20,07:00:00,8,8,0,FMN GV 05 Lier
60,Mechelsesteenweg 365,2021-06-20,08:00:00,74,48,26,FMN GV 05 Lier
60,Mechelsesteenweg 365,2021-06-20,09:00:00,244,104,140,FMN GV 05 Lier
60,Mechelsesteenweg 365,2021-06-20,10:00:00,440,182,258,FMN GV 05 Lier
60,Mechelsesteenweg 365,2021-06-20,11:00:00,336,144,192,FMN GV 05 Lier
60,Mechelsesteenweg 365,2021-06-20,12:00:00,290,166,124,FMN GV 05 Lier
60,Mechelsesteenweg 365,2021-06-20,13:00:00,130,68,62,FMN GV 05 Lier
60,Mechelsesteenweg 365,2021-06-20,14:00:00,156,84,72,FMN GV 05 Lier
60,Mechelsesteenweg 365,2021-06-20,15:00:00,218,78,140,FMN GV 05 Lier
60,Mechelsesteenweg 365,2021-06-20,16:00:00,144,60,84,FMN GV 05 Lier
60,Mechelsesteenweg 365,2021-06-20,17:00:00,160,74,86,FMN GV 05 Lier
60,Mechelsesteenweg 365,2021-06-20,18:00:00,144,46,98,FMN GV 05 Lier
60,Mechelsesteenweg 365,2021-06-20,19:00:00,72,30,42,FMN GV 05 Lier
60,Mechelsesteenweg 365,2021-06-20,20:00:00,76,28,48,FMN GV 05 Lier
60,Mechelsesteenweg 365,2021-06-20,21:00:00,58,22,36,FMN GV 05 Lier
60,Mechelsesteenweg 365,2021-06-20,22:00:00,6,2,4,FMN GV 05 Lier
60,Mechelsesteenweg 365,2021-06-20,23:00:00,4,2,2,FMN GV 05 Lier
60,Mechelsesteenweg 365,2021-06-21,00:00:00,0,0,0,FMN GV 05 Lier
60,Mechelsesteenweg 365,2021-06-21,01:00:00,0,0,0,FMN GV 05 Lier
60,Mechelsesteenweg 365,2021-06-21,02:00:00,0,0,0,FMN GV 05 Lier
60,Mechelsesteenweg 365,2021-06-21,03:00:00,2,0,2,FMN GV 05 Lier
60,Mechelsesteenweg 365,2021-06-21,04:00:00,0,0,0,FMN GV 05 Lier
60,Mechelsesteenweg 365,2021-06-21,05:00:00,2,0,2,FMN GV 05 Lier
60,Mechelsesteenweg 365,2021-06-21,06:00:00,8,4,4,FMN GV 05 Lier
60,Mechelsesteenweg 365,2021-06-21,07:00:00,112,78,34,FMN GV 05 Lier
60,Mechelsesteenweg 365,2021-06-21,08:00:00,66,54,12,FMN GV 05 Lier
60,Mechelsesteenweg 365,2021-06-21,09:00:00,140,116,24,FMN GV 05 Lier
60,Mechelsesteenweg 365,2021-06-21,10:00:00,36,8,28,FMN GV 05 Lier
60,Mechelsesteenweg 365,2021-06-21,11:00:00,34,18,16,FMN GV 05 Lier
60,Mechelsesteenweg 365,2021-06-21,12:00:00,72,16,56,FMN GV 05 Lier
60,Mechelsesteenweg 365,2021-06-21,13:00:00,46,24,22,FMN GV 05 Lier
60,Mechelsesteenweg 365,2021-06-21,14:00:00,140,24,116,FMN GV 05 Lier
60,Mechelsesteenweg 365,2021-06-21,15:00:00,200,46,154,FMN GV 05 Lier
60,Mechelsesteenweg 365,2021-06-21,16:00:00,116,58,58,FMN GV 05 Lier
60,Mechelsesteenweg 365,2021-06-21,17:00:00,80,48,32,FMN GV 05 Lier
60,Mechelsesteenweg 365,2021-06-21,18:00:00,38,22,16,FMN GV 05 Lier
60,Mechelsesteenweg 365,2021-06-21,19:00:00,30,8,22,FMN GV 05 Lier
60,Mechelsesteenweg 365,2021-06-21,20:00:00,48,10,38,FMN GV 05 Lier
60,Mechelsesteenweg 365,2021-06-21,21:00:00,14,8,6,FMN GV 05 Lier
60,Mechelsesteenweg 365,2021-06-21,22:00:00,16,8,8,FMN GV 05 Lier
60,Mechelsesteenweg 365,2021-06-21,23:00:00,4,4,0,FMN GV 05 Lier
60,Mechelsesteenweg 365,2021-06-22,00:00:00,0,0,0,FMN GV 05 Lier
60,Mechelsesteenweg 365,2021-06-22,01:00:00,0,0,0,FMN GV 05 Lier
60,Mechelsesteenweg 365,2021-06-22,02:00:00,0,0,0,FMN GV 05 Lier
60,Mechelsesteenweg 365,2021-06-22,03:00:00,2,0,2,FMN GV 05 Lier
60,Mechelsesteenweg 365,2021-06-22,04:00:00,2,0,2,FMN GV 05 Lier
60,Mechelsesteenweg 365,2021-06-22,05:00:00,6,0,6,FMN GV 05 Lier
60,Mechelsesteenweg 365,2021-06-22,06:00:00,26,14,12,FMN GV 05 Lier
60,Mechelsesteenweg 365,2021-06-22,07:00:00,114,70,44,FMN GV 05 Lier
60,Mechelsesteenweg 365,2021-06-22,08:00:00,70,48,22,FMN GV 05 Lier
60,Mechelsesteenweg 365,2021-06-22,09:00:00,188,160,28,FMN GV 05 Lier
60,Mechelsesteenweg 365,2021-06-22,10:00:00,88,16,72,FMN GV 05 Lier
60,Mechelsesteenweg 365,2021-06-22,11:00:00,42,22,20,FMN GV 05 Lier
60,Mechelsesteenweg 365,2021-06-22,12:00:00,40,18,22,FMN GV 05 Lier
60,Mechelsesteenweg 365,2021-06-22,13:00:00,144,18,126,FMN GV 05 Lier
60,Mechelsesteenweg 365,2021-06-22,14:00:00,114,86,28,FMN GV 05 Lier
60,Mechelsesteenweg 365,2021-06-22,15:00:00,44,22,22,FMN GV 05 Lier
60,Mechelsesteenweg 365,2021-06-22,16:00:00,74,56,18,FMN GV 05 Lier
60,Mechelsesteenweg 365,2021-06-22,17:00:00,88,48,40,FMN GV 05 Lier
60,Mechelsesteenweg 365,2021-06-22,18:00:00,46,16,30,FMN GV 05 Lier
60,Mechelsesteenweg 365,2021-06-22,19:00:00,52,14,38,FMN GV 05 Lier
60,Mechelsesteenweg 365,2021-06-22,20:00:00,18,6,12,FMN GV 05 Lier
60,Mechelsesteenweg 365,2021-06-22,21:00:00,16,4,12,FMN GV 05 Lier
60,Mechelsesteenweg 365,2021-06-22,22:00:00,0,0,0,FMN GV 05 Lier
60,Mechelsesteenweg 365,2021-06-22,23:00:00,2,2,0,FMN GV 05 Lier
60,Mechelsesteenweg 365,2021-06-23,00:00:00,2,0,2,FMN GV 05 Lier
60,Mechelsesteenweg 365,2021-06-23,01:00:00,2,0,2,FMN GV 05 Lier
60,Mechelsesteenweg 365,2021-06-23,02:00:00,0,0,0,FMN GV 05 Lier
60,Mechelsesteenweg 365,2021-06-23,03:00:00,2,0,2,FMN GV 05 Lier
60,Mechelsesteenweg 365,2021-06-23,04:00:00,2,0,2,FMN GV 05 Lier
60,Mechelsesteenweg 365,2021-06-23,05:00:00,6,0,6,FMN GV 05 Lier
60,Mechelsesteenweg 365,2021-06-23,06:00:00,30,16,14,FMN GV 05 Lier
60,Mechelsesteenweg 365,2021-06-23,07:00:00,128,66,62,FMN GV 05 Lier
60,Mechelsesteenweg 365,2021-06-23,08:00:00,116,74,42,FMN GV 05 Lier
60,Mechelsesteenweg 365,2021-06-23,09:00:00,62,32,30,FMN GV 05 Lier
60,Mechelsesteenweg 365,2021-06-23,10:00:00,128,60,68,FMN GV 05 Lier
60,Mechelsesteenweg 365,2021-06-23,11:00:00,102,54,48,FMN GV 05 Lier
60,Mechelsesteenweg 365,2021-06-23,12:00:00,156,62,94,FMN GV 05 Lier
60,Mechelsesteenweg 365,2021-06-23,13:00:00,148,92,56,FMN GV 05 Lier
60,Mechelsesteenweg 365,2021-06-23,14:00:00,182,84,98,FMN GV 05 Lier
60,Mechelsesteenweg 365,2021-06-23,15:00:00,198,88,110,FMN GV 05 Lier
60,Mechelsesteenweg 365,2021-06-23,16:00:00,170,78,92,FMN GV 05 Lier
60,Mechelsesteenweg 365,2021-06-23,17:00:00,172,98,74,FMN GV 05 Lier
60,Mechelsesteenweg 365,2021-06-23,18:00:00,132,66,66,FMN GV 05 Lier
60,Mechelsesteenweg 365,2021-06-23,19:00:00,148,86,62,FMN GV 05 Lier
60,Mechelsesteenweg 365,2021-06-23,20:00:00,210,128,82,FMN GV 05 Lier
60,Mechelsesteenweg 365,2021-06-23,21:00:00,36,8,28,FMN GV 05 Lier
60,Mechelsesteenweg 365,2021-06-23,22:00:00,24,12,12,FMN GV 05 Lier
60,Mechelsesteenweg 365,2021-06-23,23:00:00,2,2,0,FMN GV 05 Lier
60,Mechelsesteenweg 365,2021-06-24,00:00:00,2,0,2,FMN GV 05 Lier
60,Mechelsesteenweg 365,2021-06-24,01:00:00,0,0,0,FMN GV 05 Lier
60,Mechelsesteenweg 365,2021-06-24,02:00:00,2,2,0,FMN GV 05 Lier
60,Mechelsesteenweg 365,2021-06-24,03:00:00,2,0,2,FMN GV 05 Lier
60,Mechelsesteenweg 365,2021-06-24,04:00:00,4,2,2,FMN GV 05 Lier
60,Mechelsesteenweg 365,2021-06-24,05:00:00,18,6,12,FMN GV 05 Lier
60,Mechelsesteenweg 365,2021-06-24,06:00:00,46,28,18,FMN GV 05 Lier
60,Mechelsesteenweg 365,2021-06-24,07:00:00,100,30,70,FMN GV 05 Lier
60,Mechelsesteenweg 365,2021-06-24,08:00:00,96,50,46,FMN GV 05 Lier
60,Mechelsesteenweg 365,2021-06-24,09:00:00,70,36,34,FMN GV 05 Lier
60,Mechelsesteenweg 365,2021-06-24,10:00:00,120,58,62,FMN GV 05 Lier
60,Mechelsesteenweg 365,2021-06-24,11:00:00,132,56,76,FMN GV 05 Lier
60,Mechelsesteenweg 365,2021-06-24,12:00:00,132,72,60,FMN GV 05 Lier
60,Mechelsesteenweg 365,2021-06-24,13:00:00,200,80,120,FMN GV 05 Lier
60,Mechelsesteenweg 365,2021-06-24,14:00:00,232,112,120,FMN GV 05 Lier
60,Mechelsesteenweg 365,2021-06-24,15:00:00,230,110,120,FMN GV 05 Lier
60,Mechelsesteenweg 365,2021-06-24,16:00:00,240,154,86,FMN GV 05 Lier
60,Mechelsesteenweg 365,2021-06-24,17:00:00,166,106,60,FMN GV 05 Lier
60,Mechelsesteenweg 365,2021-06-24,18:00:00,108,54,54,FMN GV 05 Lier
60,Mechelsesteenweg 365,2021-06-24,19:00:00,88,38,50,FMN GV 05 Lier
60,Mechelsesteenweg 365,2021-06-24,20:00:00,178,78,100,FMN GV 05 Lier
60,Mechelsesteenweg 365,2021-06-24,21:00:00,44,12,32,FMN GV 05 Lier
60,Mechelsesteenweg 365,2021-06-24,22:00:00,8,2,6,FMN GV 05 Lier
60,Mechelsesteenweg 365,2021-06-24,23:00:00,12,2,10,FMN GV 05 Lier
60,Mechelsesteenweg 365,2021-06-25,00:00:00,4,0,4,FMN GV 05 Lier
60,Mechelsesteenweg 365,2021-06-25,01:00:00,0,0,0,FMN GV 05 Lier
60,Mechelsesteenweg 365,2021-06-25,02:00:00,2,0,2,FMN GV 05 Lier
60,Mechelsesteenweg 365,2021-06-25,03:00:00,2,0,2,FMN GV 05 Lier
60,Mechelsesteenweg 365,2021-06-25,04:00:00,2,2,0,FMN GV 05 Lier
60,Mechelsesteenweg 365,2021-06-25,05:00:00,6,2,4,FMN GV 05 Lier
60,Mechelsesteenweg 365,2021-06-25,06:00:00,24,10,14,FMN GV 05 Lier
60,Mechelsesteenweg 365,2021-06-25,07:00:00,76,34,42,FMN GV 05 Lier
60,Mechelsesteenweg 365,2021-06-25,08:00:00,78,30,48,FMN GV 05 Lier
60,Mechelsesteenweg 365,2021-06-25,09:00:00,196,152,44,FMN GV 05 Lier
60,Mechelsesteenweg 365,2021-06-25,10:00:00,104,56,48,FMN GV 05 Lier
60,Mechelsesteenweg 365,2021-06-25,11:00:00,148,94,54,FMN GV 05 Lier
60,Mechelsesteenweg 365,2021-06-25,12:00:00,168,74,94,FMN GV 05 Lier
60,Mechelsesteenweg 365,2021-06-25,13:00:00,122,54,68,FMN GV 05 Lier
60,Mechelsesteenweg 365,2021-06-25,14:00:00,168,96,72,FMN GV 05 Lier
60,Mechelsesteenweg 365,2021-06-25,15:00:00,246,74,172,FMN GV 05 Lier
60,Mechelsesteenweg 365,2021-06-25,16:00:00,128,68,60,FMN GV 05 Lier
60,Mechelsesteenweg 365,2021-06-25,17:00:00,106,56,50,FMN GV 05 Lier
60,Mechelsesteenweg 365,2021-06-25,18:00:00,64,38,26,FMN GV 05 Lier
60,Mechelsesteenweg 365,2021-06-25,19:00:00,48,20,28,FMN GV 05 Lier
60,Mechelsesteenweg 365,2021-06-25,20:00:00,22,2,20,FMN GV 05 Lier
60,Mechelsesteenweg 365,2021-06-25,21:00:00,14,12,2,FMN GV 05 Lier
60,Mechelsesteenweg 365,2021-06-25,22:00:00,16,12,4,FMN GV 05 Lier
60,Mechelsesteenweg 365,2021-06-25,23:00:00,0,0,0,FMN GV 05 Lier
60,Mechelsesteenweg 365,2021-06-26,00:00:00,0,0,0,FMN GV 05 Lier
60,Mechelsesteenweg 365,2021-06-26,01:00:00,2,2,0,FMN GV 05 Lier
60,Mechelsesteenweg 365,2021-06-26,02:00:00,0,0,0,FMN GV 05 Lier
60,Mechelsesteenweg 365,2021-06-26,03:00:00,2,0,2,FMN GV 05 Lier
60,Mechelsesteenweg 365,2021-06-26,04:00:00,0,0,0,FMN GV 05 Lier
60,Mechelsesteenweg 365,2021-06-26,05:00:00,0,0,0,FMN GV 05 Lier
60,Mechelsesteenweg 365,2021-06-26,06:00:00,12,8,4,FMN GV 05 Lier
60,Mechelsesteenweg 365,2021-06-26,07:00:00,24,18,6,FMN GV 05 Lier
60,Mechelsesteenweg 365,2021-06-26,08:00:00,48,24,24,FMN GV 05 Lier
60,Mechelsesteenweg 365,2021-06-26,09:00:00,114,76,38,FMN GV 05 Lier
60,Mechelsesteenweg 365,2021-06-26,10:00:00,134,72,62,FMN GV 05 Lier
60,Mechelsesteenweg 365,2021-06-26,11:00:00,206,92,114,FMN GV 05 Lier
60,Mechelsesteenweg 365,2021-06-26,12:00:00,142,68,74,FMN GV 05 Lier
60,Mechelsesteenweg 365,2021-06-26,13:00:00,178,80,98,FMN GV 05 Lier
60,Mechelsesteenweg 365,2021-06-26,14:00:00,280,152,128,FMN GV 05 Lier
60,Mechelsesteenweg 365,2021-06-26,15:00:00,288,150,138,FMN GV 05 Lier
60,Mechelsesteenweg 365,2021-06-26,16:00:00,196,110,86,FMN GV 05 Lier
60,Mechelsesteenweg 365,2021-06-26,17:00:00,108,40,68,FMN GV 05 Lier
60,Mechelsesteenweg 365,2021-06-26,18:00:00,80,44,36,FMN GV 05 Lier
60,Mechelsesteenweg 365,2021-06-26,19:00:00,70,42,28,FMN GV 05 Lier
60,Mechelsesteenweg 365,2021-06-26,20:00:00,78,28,50,FMN GV 05 Lier
60,Mechelsesteenweg 365,2021-06-26,21:00:00,30,6,24,FMN GV 05 Lier
60,Mechelsesteenweg 365,2021-06-26,22:00:00,14,2,12,FMN GV 05 Lier
60,Mechelsesteenweg 365,2021-06-26,23:00:00,8,8,0,FMN GV 05 Lier
60,Mechelsesteenweg 365,2021-06-27,00:00:00,4,0,4,FMN GV 05 Lier
60,Mechelsesteenweg 365,2021-06-27,01:00:00,4,0,4,FMN GV 05 Lier
60,Mechelsesteenweg 365,2021-06-27,02:00:00,0,0,0,FMN GV 05 Lier
60,Mechelsesteenweg 365,2021-06-27,03:00:00,0,0,0,FMN GV 05 Lier
60,Mechelsesteenweg 365,2021-06-27,04:00:00,0,0,0,FMN GV 05 Lier
60,Mechelsesteenweg 365,2021-06-27,05:00:00,4,2,2,FMN GV 05 Lier
60,Mechelsesteenweg 365,2021-06-27,06:00:00,8,6,2,FMN GV 05 Lier
60,Mechelsesteenweg 365,2021-06-27,07:00:00,26,12,14,FMN GV 05 Lier
60,Mechelsesteenweg 365,2021-06-27,08:00:00,94,52,42,FMN GV 05 Lier
60,Mechelsesteenweg 365,2021-06-27,09:00:00,294,170,124,FMN GV 05 Lier
60,Mechelsesteenweg 365,2021-06-27,10:00:00,566,258,308,FMN GV 05 Lier
60,Mechelsesteenweg 365,2021-06-27,11:00:00,576,264,312,FMN GV 05 Lier
60,Mechelsesteenweg 365,2021-06-27,12:00:00,358,166,192,FMN GV 05 Lier
60,Mechelsesteenweg 365,2021-06-27,13:00:00,330,124,206,FMN GV 05 Lier
60,Mechelsesteenweg 365,2021-06-27,14:00:00,486,226,260,FMN GV 05 Lier
60,Mechelsesteenweg 365,2021-06-27,15:00:00,334,128,206,FMN GV 05 Lier
60,Mechelsesteenweg 365,2021-06-27,16:00:00,146,50,96,FMN GV 05 Lier
60,Mechelsesteenweg 365,2021-06-27,17:00:00,70,26,44,FMN GV 05 Lier
60,Mechelsesteenweg 365,2021-06-27,18:00:00,28,6,22,FMN GV 05 Lier
60,Mechelsesteenweg 365,2021-06-27,19:00:00,24,4,20,FMN GV 05 Lier
60,Mechelsesteenweg 365,2021-06-27,20:00:00,30,24,6,FMN GV 05 Lier
60,Mechelsesteenweg 365,2021-06-27,21:00:00,8,0,8,FMN GV 05 Lier
60,Mechelsesteenweg 365,2021-06-27,22:00:00,4,4,0,FMN GV 05 Lier
60,Mechelsesteenweg 365,2021-06-27,23:00:00,6,4,2,FMN GV 05 Lier
60,Mechelsesteenweg 365,2021-06-28,00:00:00,4,2,2,FMN GV 05 Lier
60,Mechelsesteenweg 365,2021-06-28,01:00:00,0,0,0,FMN GV 05 Lier
60,Mechelsesteenweg 365,2021-06-28,02:00:00,4,4,0,FMN GV 05 Lier
60,Mechelsesteenweg 365,2021-06-28,03:00:00,2,0,2,FMN GV 05 Lier
60,Mechelsesteenweg 365,2021-06-28,04:00:00,0,0,0,FMN GV 05 Lier
60,Mechelsesteenweg 365,2021-06-28,05:00:00,4,0,4,FMN GV 05 Lier
60,Mechelsesteenweg 365,2021-06-28,06:00:00,30,10,20,FMN GV 05 Lier
60,Mechelsesteenweg 365,2021-06-28,07:00:00,72,28,44,FMN GV 05 Lier
60,Mechelsesteenweg 365,2021-06-28,08:00:00,78,42,36,FMN GV 05 Lier
60,Mechelsesteenweg 365,2021-06-28,09:00:00,64,26,38,FMN GV 05 Lier
60,Mechelsesteenweg 365,2021-06-28,10:00:00,40,26,14,FMN GV 05 Lier
60,Mechelsesteenweg 365,2021-06-28,11:00:00,72,34,38,FMN GV 05 Lier
60,Mechelsesteenweg 365,2021-06-28,12:00:00,76,38,38,FMN GV 05 Lier
60,Mechelsesteenweg 365,2021-06-28,13:00:00,90,24,66,FMN GV 05 Lier
60,Mechelsesteenweg 365,2021-06-28,14:00:00,98,58,40,FMN GV 05 Lier
60,Mechelsesteenweg 365,2021-06-28,15:00:00,116,56,60,FMN GV 05 Lier
60,Mechelsesteenweg 365,2021-06-28,16:00:00,132,76,56,FMN GV 05 Lier
60,Mechelsesteenweg 365,2021-06-28,17:00:00,134,80,54,FMN GV 05 Lier
60,Mechelsesteenweg 365,2021-06-28,18:00:00,90,38,52,FMN GV 05 Lier
60,Mechelsesteenweg 365,2021-06-28,19:00:00,112,68,44,FMN GV 05 Lier
60,Mechelsesteenweg 365,2021-06-28,20:00:00,100,44,56,FMN GV 05 Lier
60,Mechelsesteenweg 365,2021-06-28,21:00:00,54,20,34,FMN GV 05 Lier
60,Mechelsesteenweg 365,2021-06-28,22:00:00,30,14,16,FMN GV 05 Lier
60,Mechelsesteenweg 365,2021-06-28,23:00:00,2,0,2,FMN GV 05 Lier
60,Mechelsesteenweg 365,2021-06-29,00:00:00,2,0,2,FMN GV 05 Lier
60,Mechelsesteenweg 365,2021-06-29,01:00:00,8,0,8,FMN GV 05 Lier
60,Mechelsesteenweg 365,2021-06-29,02:00:00,2,2,0,FMN GV 05 Lier
60,Mechelsesteenweg 365,2021-06-29,03:00:00,0,0,0,FMN GV 05 Lier
60,Mechelsesteenweg 365,2021-06-29,04:00:00,2,0,2,FMN GV 05 Lier
60,Mechelsesteenweg 365,2021-06-29,05:00:00,8,0,8,FMN GV 05 Lier
60,Mechelsesteenweg 365,2021-06-29,06:00:00,38,14,24,FMN GV 05 Lier
60,Mechelsesteenweg 365,2021-06-29,07:00:00,78,34,44,FMN GV 05 Lier
60,Mechelsesteenweg 365,2021-06-29,08:00:00,100,62,38,FMN GV 05 Lier
60,Mechelsesteenweg 365,2021-06-29,09:00:00,108,72,36,FMN GV 05 Lier
60,Mechelsesteenweg 365,2021-06-29,10:00:00,168,88,80,FMN GV 05 Lier
60,Mechelsesteenweg 365,2021-06-29,11:00:00,124,62,62,FMN GV 05 Lier
60,Mechelsesteenweg 365,2021-06-29,12:00:00,108,46,62,FMN GV 05 Lier
60,Mechelsesteenweg 365,2021-06-29,13:00:00,150,58,92,FMN GV 05 Lier
60,Mechelsesteenweg 365,2021-06-29,14:00:00,196,80,116,FMN GV 05 Lier
60,Mechelsesteenweg 365,2021-06-29,15:00:00,182,88,94,FMN GV 05 Lier
60,Mechelsesteenweg 365,2021-06-29,16:00:00,156,74,82,FMN GV 05 Lier
60,Mechelsesteenweg 365,2021-06-29,17:00:00,152,88,64,FMN GV 05 Lier
60,Mechelsesteenweg 365,2021-06-29,18:00:00,92,32,60,FMN GV 05 Lier
60,Mechelsesteenweg 365,2021-06-29,19:00:00,90,42,48,FMN GV 05 Lier
60,Mechelsesteenweg 365,2021-06-29,20:00:00,76,32,44,FMN GV 05 Lier
60,Mechelsesteenweg 365,2021-06-29,21:00:00,20,4,16,FMN GV 05 Lier
60,Mechelsesteenweg 365,2021-06-29,22:00:00,8,2,6,FMN GV 05 Lier
60,Mechelsesteenweg 365,2021-06-29,23:00:00,0,0,0,FMN GV 05 Lier
60,Mechelsesteenweg 365,2021-06-30,00:00:00,0,0,0,FMN GV 05 Lier
60,Mechelsesteenweg 365,2021-06-30,01:00:00,0,0,0,FMN GV 05 Lier
60,Mechelsesteenweg 365,2021-06-30,02:00:00,0,0,0,FMN GV 05 Lier
60,Mechelsesteenweg 365,2021-06-30,03:00:00,2,0,2,FMN GV 05 Lier
60,Mechelsesteenweg 365,2021-06-30,04:00:00,0,0,0,FMN GV 05 Lier
60,Mechelsesteenweg 365,2021-06-30,05:00:00,2,0,2,FMN GV 05 Lier
60,Mechelsesteenweg 365,2021-06-30,06:00:00,22,12,10,FMN GV 05 Lier
60,Mechelsesteenweg 365,2021-06-30,07:00:00,42,24,18,FMN GV 05 Lier
60,Mechelsesteenweg 365,2021-06-30,08:00:00,42,24,18,FMN GV 05 Lier
60,Mechelsesteenweg 365,2021-06-30,09:00:00,60,42,18,FMN GV 05 Lier
60,Mechelsesteenweg 365,2021-06-30,10:00:00,42,26,16,FMN GV 05 Lier
60,Mechelsesteenweg 365,2021-06-30,11:00:00,54,22,32,FMN GV 05 Lier
60,Mechelsesteenweg 365,2021-06-30,12:00:00,166,12,154,FMN GV 05 Lier
60,Mechelsesteenweg 365,2021-06-30,13:00:00,34,20,14,FMN GV 05 Lier
60,Mechelsesteenweg 365,2021-06-30,14:00:00,32,18,14,FMN GV 05 Lier
60,Mechelsesteenweg 365,2021-06-30,15:00:00,102,68,34,FMN GV 05 Lier
60,Mechelsesteenweg 365,2021-06-30,16:00:00,44,26,18,FMN GV 05 Lier
60,Mechelsesteenweg 365,2021-06-30,17:00:00,48,24,24,FMN GV 05 Lier
60,Mechelsesteenweg 365,2021-06-30,18:00:00,40,28,12,FMN GV 05 Lier
60,Mechelsesteenweg 365,2021-06-30,19:00:00,48,24,24,FMN GV 05 Lier
60,Mechelsesteenweg 365,2021-06-30,20:00:00,36,18,18,FMN GV 05 Lier
60,Mechelsesteenweg 365,2021-06-30,21:00:00,22,8,14,FMN GV 05 Lier
60,Mechelsesteenweg 365,2021-06-30,22:00:00,12,10,2,FMN GV 05 Lier
60,Mechelsesteenweg 365,2021-06-30,23:00:00,2,0,2,FMN GV 05 Lier
60,Mechelsesteenweg 365,2021-07-01,00:00:00,2,0,2,FMN GV 05 Lier
60,Mechelsesteenweg 365,2021-07-01,01:00:00,0,0,0,FMN GV 05 Lier
60,Mechelsesteenweg 365,2021-07-01,02:00:00,0,0,0,FMN GV 05 Lier
60,Mechelsesteenweg 365,2021-07-01,03:00:00,0,0,0,FMN GV 05 Lier
60,Mechelsesteenweg 365,2021-07-01,04:00:00,2,0,2,FMN GV 05 Lier
60,Mechelsesteenweg 365,2021-07-01,05:00:00,6,0,6,FMN GV 05 Lier
60,Mechelsesteenweg 365,2021-07-01,06:00:00,38,8,30,FMN GV 05 Lier
60,Mechelsesteenweg 365,2021-07-01,07:00:00,76,28,48,FMN GV 05 Lier
60,Mechelsesteenweg 365,2021-07-01,08:00:00,64,42,22,FMN GV 05 Lier
60,Mechelsesteenweg 365,2021-07-01,09:00:00,94,32,62,FMN GV 05 Lier
60,Mechelsesteenweg 365,2021-07-01,10:00:00,148,108,40,FMN GV 05 Lier
60,Mechelsesteenweg 365,2021-07-01,11:00:00,118,52,66,FMN GV 05 Lier
60,Mechelsesteenweg 365,2021-07-01,12:00:00,134,90,44,FMN GV 05 Lier
60,Mechelsesteenweg 365,2021-07-01,13:00:00,298,108,190,FMN GV 05 Lier
60,Mechelsesteenweg 365,2021-07-01,14:00:00,152,70,82,FMN GV 05 Lier
60,Mechelsesteenweg 365,2021-07-01,15:00:00,128,68,60,FMN GV 05 Lier
60,Mechelsesteenweg 365,2021-07-01,16:00:00,180,108,72,FMN GV 05 Lier
60,Mechelsesteenweg 365,2021-07-01,17:00:00,160,92,68,FMN GV 05 Lier
60,Mechelsesteenweg 365,2021-07-01,18:00:00,94,56,38,FMN GV 05 Lier
60,Mechelsesteenweg 365,2021-07-01,19:00:00,122,68,54,FMN GV 05 Lier
60,Mechelsesteenweg 365,2021-07-01,20:00:00,150,86,64,FMN GV 05 Lier
60,Mechelsesteenweg 365,2021-07-01,21:00:00,64,36,28,FMN GV 05 Lier
60,Mechelsesteenweg 365,2021-07-01,22:00:00,20,8,12,FMN GV 05 Lier
60,Mechelsesteenweg 365,2021-07-01,23:00:00,4,4,0,FMN GV 05 Lier
60,Mechelsesteenweg 365,2021-07-02,00:00:00,0,0,0,FMN GV 05 Lier
60,Mechelsesteenweg 365,2021-07-02,01:00:00,0,0,0,FMN GV 05 Lier
60,Mechelsesteenweg 365,2021-07-02,02:00:00,0,0,0,FMN GV 05 Lier
60,Mechelsesteenweg 365,2021-07-02,03:00:00,2,0,2,FMN GV 05 Lier
60,Mechelsesteenweg 365,2021-07-02,04:00:00,0,0,0,FMN GV 05 Lier
60,Mechelsesteenweg 365,2021-07-02,05:00:00,10,2,8,FMN GV 05 Lier
60,Mechelsesteenweg 365,2021-07-02,06:00:00,20,6,14,FMN GV 05 Lier
60,Mechelsesteenweg 365,2021-07-02,07:00:00,50,16,34,FMN GV 05 Lier
60,Mechelsesteenweg 365,2021-07-02,08:00:00,56,20,36,FMN GV 05 Lier
60,Mechelsesteenweg 365,2021-07-02,09:00:00,88,50,38,FMN GV 05 Lier
60,Mechelsesteenweg 365,2021-07-02,10:00:00,208,142,66,FMN GV 05 Lier
60,Mechelsesteenweg 365,2021-07-02,11:00:00,194,102,92,FMN GV 05 Lier
60,Mechelsesteenweg 365,2021-07-02,12:00:00,158,68,90,FMN GV 05 Lier
60,Mechelsesteenweg 365,2021-07-02,13:00:00,224,110,114,FMN GV 05 Lier
60,Mechelsesteenweg 365,2021-07-02,14:00:00,266,160,106,FMN GV 05 Lier
60,Mechelsesteenweg 365,2021-07-02,15:00:00,96,56,40,FMN GV 05 Lier
60,Mechelsesteenweg 365,2021-07-02,16:00:00,198,102,96,FMN GV 05 Lier
60,Mechelsesteenweg 365,2021-07-02,17:00:00,206,132,74,FMN GV 05 Lier
60,Mechelsesteenweg 365,2021-07-02,18:00:00,124,56,68,FMN GV 05 Lier
60,Mechelsesteenweg 365,2021-07-02,19:00:00,92,32,60,FMN GV 05 Lier
60,Mechelsesteenweg 365,2021-07-02,20:00:00,72,26,46,FMN GV 05 Lier
60,Mechelsesteenweg 365,2021-07-02,21:00:00,20,10,10,FMN GV 05 Lier
60,Mechelsesteenweg 365,2021-07-02,22:00:00,18,10,8,FMN GV 05 Lier
60,Mechelsesteenweg 365,2021-07-02,23:00:00,8,4,4,FMN GV 05 Lier
60,Mechelsesteenweg 365,2021-07-03,00:00:00,26,12,14,FMN GV 05 Lier
60,Mechelsesteenweg 365,2021-07-03,01:00:00,10,2,8,FMN GV 05 Lier
60,Mechelsesteenweg 365,2021-07-03,02:00:00,4,0,4,FMN GV 05 Lier
60,Mechelsesteenweg 365,2021-07-03,03:00:00,0,0,0,FMN GV 05 Lier
60,Mechelsesteenweg 365,2021-07-03,04:00:00,2,0,2,FMN GV 05 Lier
60,Mechelsesteenweg 365,2021-07-03,05:00:00,8,2,6,FMN GV 05 Lier
60,Mechelsesteenweg 365,2021-07-03,06:00:00,4,4,0,FMN GV 05 Lier
60,Mechelsesteenweg 365,2021-07-03,07:00:00,20,8,12,FMN GV 05 Lier
60,Mechelsesteenweg 365,2021-07-03,08:00:00,54,26,28,FMN GV 05 Lier
60,Mechelsesteenweg 365,2021-07-03,09:00:00,82,46,36,FMN GV 05 Lier
60,Mechelsesteenweg 365,2021-07-03,10:00:00,164,112,52,FMN GV 05 Lier
60,Mechelsesteenweg 365,2021-07-03,11:00:00,214,98,116,FMN GV 05 Lier
60,Mechelsesteenweg 365,2021-07-03,12:00:00,180,92,88,FMN GV 05 Lier
60,Mechelsesteenweg 365,2021-07-03,13:00:00,220,134,86,FMN GV 05 Lier
60,Mechelsesteenweg 365,2021-07-03,14:00:00,180,90,90,FMN GV 05 Lier
60,Mechelsesteenweg 365,2021-07-03,15:00:00,210,86,124,FMN GV 05 Lier
60,Mechelsesteenweg 365,2021-07-03,16:00:00,112,66,46,FMN GV 05 Lier
60,Mechelsesteenweg 365,2021-07-03,17:00:00,84,44,40,FMN GV 05 Lier
60,Mechelsesteenweg 365,2021-07-03,18:00:00,34,8,26,FMN GV 05 Lier
60,Mechelsesteenweg 365,2021-07-03,19:00:00,12,10,2,FMN GV 05 Lier
60,Mechelsesteenweg 365,2021-07-03,20:00:00,16,8,8,FMN GV 05 Lier
60,Mechelsesteenweg 365,2021-07-03,21:00:00,6,4,2,FMN GV 05 Lier
60,Mechelsesteenweg 365,2021-07-03,22:00:00,8,0,8,FMN GV 05 Lier
60,Mechelsesteenweg 365,2021-07-03,23:00:00,4,2,2,FMN GV 05 Lier
60,Mechelsesteenweg 365,2021-07-04,00:00:00,0,0,0,FMN GV 05 Lier
60,Mechelsesteenweg 365,2021-07-04,01:00:00,0,0,0,FMN GV 05 Lier
60,Mechelsesteenweg 365,2021-07-04,02:00:00,0,0,0,FMN GV 05 Lier
60,Mechelsesteenweg 365,2021-07-04,03:00:00,0,0,0,FMN GV 05 Lier
60,Mechelsesteenweg 365,2021-07-04,04:00:00,0,0,0,FMN GV 05 Lier
60,Mechelsesteenweg 365,2021-07-04,05:00:00,8,2,6,FMN GV 05 Lier
60,Mechelsesteenweg 365,2021-07-04,06:00:00,6,2,4,FMN GV 05 Lier
60,Mechelsesteenweg 365,2021-07-04,07:00:00,6,4,2,FMN GV 05 Lier
60,Mechelsesteenweg 365,2021-07-04,08:00:00,50,34,16,FMN GV 05 Lier
60,Mechelsesteenweg 365,2021-07-04,09:00:00,246,136,110,FMN GV 05 Lier
60,Mechelsesteenweg 365,2021-07-04,10:00:00,458,250,208,FMN GV 05 Lier
60,Mechelsesteenweg 365,2021-07-04,11:00:00,468,230,238,FMN GV 05 Lier
60,Mechelsesteenweg 365,2021-07-04,12:00:00,104,44,60,FMN GV 05 Lier
60,Mechelsesteenweg 365,2021-07-04,13:00:00,40,10,30,FMN GV 05 Lier
60,Mechelsesteenweg 365,2021-07-04,14:00:00,32,24,8,FMN GV 05 Lier
60,Mechelsesteenweg 365,2021-07-04,15:00:00,30,14,16,FMN GV 05 Lier
60,Mechelsesteenweg 365,2021-07-04,16:00:00,72,18,54,FMN GV 05 Lier
60,Mechelsesteenweg 365,2021-07-04,17:00:00,74,26,48,FMN GV 05 Lier
60,Mechelsesteenweg 365,2021-07-04,18:00:00,124,88,36,FMN GV 05 Lier
60,Mechelsesteenweg 365,2021-07-04,19:00:00,72,38,34,FMN GV 05 Lier
60,Mechelsesteenweg 365,2021-07-04,20:00:00,64,32,32,FMN GV 05 Lier
60,Mechelsesteenweg 365,2021-07-04,21:00:00,30,18,12,FMN GV 05 Lier
60,Mechelsesteenweg 365,2021-07-04,22:00:00,18,6,12,FMN GV 05 Lier
60,Mechelsesteenweg 365,2021-07-04,23:00:00,8,4,4,FMN GV 05 Lier
60,Mechelsesteenweg 365,2021-07-05,00:00:00,4,2,2,FMN GV 05 Lier
60,Mechelsesteenweg 365,2021-07-05,01:00:00,0,0,0,FMN GV 05 Lier
60,Mechelsesteenweg 365,2021-07-05,02:00:00,0,0,0,FMN GV 05 Lier
60,Mechelsesteenweg 365,2021-07-05,03:00:00,2,0,2,FMN GV 05 Lier
60,Mechelsesteenweg 365,2021-07-05,04:00:00,4,0,4,FMN GV 05 Lier
60,Mechelsesteenweg 365,2021-07-05,05:00:00,10,0,10,FMN GV 05 Lier
60,Mechelsesteenweg 365,2021-07-05,06:00:00,22,14,8,FMN GV 05 Lier
60,Mechelsesteenweg 365,2021-07-05,07:00:00,32,14,18,FMN GV 05 Lier
60,Mechelsesteenweg 365,2021-07-05,08:00:00,36,10,26,FMN GV 05 Lier
60,Mechelsesteenweg 365,2021-07-05,09:00:00,32,24,8,FMN GV 05 Lier
60,Mechelsesteenweg 365,2021-07-05,10:00:00,36,16,20,FMN GV 05 Lier
60,Mechelsesteenweg 365,2021-07-05,11:00:00,42,24,18,FMN GV 05 Lier
60,Mechelsesteenweg 365,2021-07-05,12:00:00,38,22,16,FMN GV 05 Lier
60,Mechelsesteenweg 365,2021-07-05,13:00:00,96,58,38,FMN GV 05 Lier
60,Mechelsesteenweg 365,2021-07-05,14:00:00,84,46,38,FMN GV 05 Lier
60,Mechelsesteenweg 365,2021-07-05,15:00:00,106,48,58,FMN GV 05 Lier
60,Mechelsesteenweg 365,2021-07-05,16:00:00,106,68,38,FMN GV 05 Lier
60,Mechelsesteenweg 365,2021-07-05,17:00:00,112,66,46,FMN GV 05 Lier
60,Mechelsesteenweg 365,2021-07-05,18:00:00,96,46,50,FMN GV 05 Lier
60,Mechelsesteenweg 365,2021-07-05,19:00:00,60,32,28,FMN GV 05 Lier
60,Mechelsesteenweg 365,2021-07-05,20:00:00,58,32,26,FMN GV 05 Lier
60,Mechelsesteenweg 365,2021-07-05,21:00:00,36,18,18,FMN GV 05 Lier
60,Mechelsesteenweg 365,2021-07-05,22:00:00,8,8,0,FMN GV 05 Lier
60,Mechelsesteenweg 365,2021-07-05,23:00:00,0,0,0,FMN GV 05 Lier
60,Mechelsesteenweg 365,2021-07-06,00:00:00,0,0,0,FMN GV 05 Lier
60,Mechelsesteenweg 365,2021-07-06,01:00:00,0,0,0,FMN GV 05 Lier
60,Mechelsesteenweg 365,2021-07-06,02:00:00,0,0,0,FMN GV 05 Lier
60,Mechelsesteenweg 365,2021-07-06,03:00:00,2,0,2,FMN GV 05 Lier
60,Mechelsesteenweg 365,2021-07-06,04:00:00,2,0,2,FMN GV 05 Lier
60,Mechelsesteenweg 365,2021-07-06,05:00:00,4,0,4,FMN GV 05 Lier
60,Mechelsesteenweg 365,2021-07-06,06:00:00,30,14,16,FMN GV 05 Lier
60,Mechelsesteenweg 365,2021-07-06,07:00:00,48,16,32,FMN GV 05 Lier
60,Mechelsesteenweg 365,2021-07-06,08:00:00,32,16,16,FMN GV 05 Lier
60,Mechelsesteenweg 365,2021-07-06,09:00:00,36,26,10,FMN GV 05 Lier
60,Mechelsesteenweg 365,2021-07-06,10:00:00,74,48,26,FMN GV 05 Lier
60,Mechelsesteenweg 365,2021-07-06,11:00:00,100,58,42,FMN GV 05 Lier
60,Mechelsesteenweg 365,2021-07-06,12:00:00,34,14,20,FMN GV 05 Lier
60,Mechelsesteenweg 365,2021-07-06,13:00:00,58,44,14,FMN GV 05 Lier
60,Mechelsesteenweg 365,2021-07-06,14:00:00,98,60,38,FMN GV 05 Lier
60,Mechelsesteenweg 365,2021-07-06,15:00:00,40,24,16,FMN GV 05 Lier
60,Mechelsesteenweg 365,2021-07-06,16:00:00,88,58,30,FMN GV 05 Lier
60,Mechelsesteenweg 365,2021-07-06,17:00:00,44,30,14,FMN GV 05 Lier
60,Mechelsesteenweg 365,2021-07-06,18:00:00,36,26,10,FMN GV 05 Lier
60,Mechelsesteenweg 365,2021-07-06,19:00:00,112,36,76,FMN GV 05 Lier
60,Mechelsesteenweg 365,2021-07-06,20:00:00,56,20,36,FMN GV 05 Lier
60,Mechelsesteenweg 365,2021-07-06,21:00:00,28,16,12,FMN GV 05 Lier
60,Mechelsesteenweg 365,2021-07-06,22:00:00,10,8,2,FMN GV 05 Lier
60,Mechelsesteenweg 365,2021-07-06,23:00:00,0,0,0,FMN GV 05 Lier
60,Mechelsesteenweg 365,2021-07-07,00:00:00,2,0,2,FMN GV 05 Lier
60,Mechelsesteenweg 365,2021-07-07,01:00:00,2,0,2,FMN GV 05 Lier
60,Mechelsesteenweg 365,2021-07-07,02:00:00,0,0,0,FMN GV 05 Lier
60,Mechelsesteenweg 365,2021-07-07,03:00:00,2,0,2,FMN GV 05 Lier
60,Mechelsesteenweg 365,2021-07-07,04:00:00,2,0,2,FMN GV 05 Lier
60,Mechelsesteenweg 365,2021-07-07,05:00:00,10,6,4,FMN GV 05 Lier
60,Mechelsesteenweg 365,2021-07-07,06:00:00,44,22,22,FMN GV 05 Lier
60,Mechelsesteenweg 365,2021-07-07,07:00:00,64,22,42,FMN GV 05 Lier
60,Mechelsesteenweg 365,2021-07-07,08:00:00,58,24,34,FMN GV 05 Lier
60,Mechelsesteenweg 365,2021-07-07,09:00:00,104,50,54,FMN GV 05 Lier
60,Mechelsesteenweg 365,2021-07-07,10:00:00,176,88,88,FMN GV 05 Lier
60,Mechelsesteenweg 365,2021-07-07,11:00:00,146,72,74,FMN GV 05 Lier
60,Mechelsesteenweg 365,2021-07-07,12:00:00,120,50,70,FMN GV 05 Lier
60,Mechelsesteenweg 365,2021-07-07,13:00:00,178,88,90,FMN GV 05 Lier
60,Mechelsesteenweg 365,2021-07-07,14:00:00,260,124,136,FMN GV 05 Lier
60,Mechelsesteenweg 365,2021-07-07,15:00:00,186,98,88,FMN GV 05 Lier
60,Mechelsesteenweg 365,2021-07-07,16:00:00,180,112,68,FMN GV 05 Lier
60,Mechelsesteenweg 365,2021-07-07,17:00:00,158,100,58,FMN GV 05 Lier
60,Mechelsesteenweg 365,2021-07-07,18:00:00,194,98,96,FMN GV 05 Lier
60,Mechelsesteenweg 365,2021-07-07,19:00:00,106,58,48,FMN GV 05 Lier
60,Mechelsesteenweg 365,2021-07-07,20:00:00,276,170,106,FMN GV 05 Lier
60,Mechelsesteenweg 365,2021-07-07,21:00:00,74,20,54,FMN GV 05 Lier
60,Mechelsesteenweg 365,2021-07-07,22:00:00,26,8,18,FMN GV 05 Lier
60,Mechelsesteenweg 365,2021-07-07,23:00:00,6,4,2,FMN GV 05 Lier
60,Mechelsesteenweg 365,2021-07-08,00:00:00,12,6,6,FMN GV 05 Lier
60,Mechelsesteenweg 365,2021-07-08,01:00:00,0,0,0,FMN GV 05 Lier
60,Mechelsesteenweg 365,2021-07-08,02:00:00,0,0,0,FMN GV 05 Lier
60,Mechelsesteenweg 365,2021-07-08,03:00:00,2,0,2,FMN GV 05 Lier
60,Mechelsesteenweg 365,2021-07-08,04:00:00,2,0,2,FMN GV 05 Lier
60,Mechelsesteenweg 365,2021-07-08,05:00:00,6,2,4,FMN GV 05 Lier
60,Mechelsesteenweg 365,2021-07-08,06:00:00,40,20,20,FMN GV 05 Lier
60,Mechelsesteenweg 365,2021-07-08,07:00:00,64,20,44,FMN GV 05 Lier
60,Mechelsesteenweg 365,2021-07-08,08:00:00,66,34,32,FMN GV 05 Lier
60,Mechelsesteenweg 365,2021-07-08,09:00:00,90,58,32,FMN GV 05 Lier
60,Mechelsesteenweg 365,2021-07-08,10:00:00,176,84,92,FMN GV 05 Lier
60,Mechelsesteenweg 365,2021-07-08,11:00:00,160,70,90,FMN GV 05 Lier
60,Mechelsesteenweg 365,2021-07-08,12:00:00,134,74,60,FMN GV 05 Lier
60,Mechelsesteenweg 365,2021-07-08,13:00:00,106,60,46,FMN GV 05 Lier
60,Mechelsesteenweg 365,2021-07-08,14:00:00,174,72,102,FMN GV 05 Lier
60,Mechelsesteenweg 365,2021-07-08,15:00:00,120,44,76,FMN GV 05 Lier
60,Mechelsesteenweg 365,2021-07-08,16:00:00,140,78,62,FMN GV 05 Lier
60,Mechelsesteenweg 365,2021-07-08,17:00:00,142,92,50,FMN GV 05 Lier
60,Mechelsesteenweg 365,2021-07-08,18:00:00,96,52,44,FMN GV 05 Lier
60,Mechelsesteenweg 365,2021-07-08,19:00:00,132,50,82,FMN GV 05 Lier
60,Mechelsesteenweg 365,2021-07-08,20:00:00,188,72,116,FMN GV 05 Lier
60,Mechelsesteenweg 365,2021-07-08,21:00:00,72,16,56,FMN GV 05 Lier
60,Mechelsesteenweg 365,2021-07-08,22:00:00,10,6,4,FMN GV 05 Lier
60,Mechelsesteenweg 365,2021-07-08,23:00:00,2,0,2,FMN GV 05 Lier
60,Mechelsesteenweg 365,2021-07-09,00:00:00,0,0,0,FMN GV 05 Lier
60,Mechelsesteenweg 365,2021-07-09,01:00:00,2,2,0,FMN GV 05 Lier
60,Mechelsesteenweg 365,2021-07-09,02:00:00,0,0,0,FMN GV 05 Lier
60,Mechelsesteenweg 365,2021-07-09,03:00:00,2,0,2,FMN GV 05 Lier
60,Mechelsesteenweg 365,2021-07-09,04:00:00,0,0,0,FMN GV 05 Lier
60,Mechelsesteenweg 365,2021-07-09,05:00:00,4,0,4,FMN GV 05 Lier
60,Mechelsesteenweg 365,2021-07-09,06:00:00,30,8,22,FMN GV 05 Lier
60,Mechelsesteenweg 365,2021-07-09,07:00:00,74,28,46,FMN GV 05 Lier
60,Mechelsesteenweg 365,2021-07-09,08:00:00,68,50,18,FMN GV 05 Lier
60,Mechelsesteenweg 365,2021-07-09,09:00:00,64,44,20,FMN GV 05 Lier
60,Mechelsesteenweg 365,2021-07-09,10:00:00,176,126,50,FMN GV 05 Lier
60,Mechelsesteenweg 365,2021-07-09,11:00:00,238,146,92,FMN GV 05 Lier
60,Mechelsesteenweg 365,2021-07-09,12:00:00,164,82,82,FMN GV 05 Lier
60,Mechelsesteenweg 365,2021-07-09,13:00:00,244,118,126,FMN GV 05 Lier
60,Mechelsesteenweg 365,2021-07-09,14:00:00,320,122,198,FMN GV 05 Lier
60,Mechelsesteenweg 365,2021-07-09,15:00:00,228,110,118,FMN GV 05 Lier
60,Mechelsesteenweg 365,2021-07-09,16:00:00,200,120,80,FMN GV 05 Lier
60,Mechelsesteenweg 365,2021-07-09,17:00:00,152,76,76,FMN GV 05 Lier
60,Mechelsesteenweg 365,2021-07-09,18:00:00,130,72,58,FMN GV 05 Lier
60,Mechelsesteenweg 365,2021-07-09,19:00:00,124,54,70,FMN GV 05 Lier
60,Mechelsesteenweg 365,2021-07-09,20:00:00,84,42,42,FMN GV 05 Lier
60,Mechelsesteenweg 365,2021-07-09,21:00:00,52,6,46,FMN GV 05 Lier
60,Mechelsesteenweg 365,2021-07-09,22:00:00,48,24,24,FMN GV 05 Lier
60,Mechelsesteenweg 365,2021-07-09,23:00:00,4,2,2,FMN GV 05 Lier
60,Mechelsesteenweg 365,2021-07-10,00:00:00,6,0,6,FMN GV 05 Lier
60,Mechelsesteenweg 365,2021-07-10,01:00:00,2,2,0,FMN GV 05 Lier
60,Mechelsesteenweg 365,2021-07-10,02:00:00,0,0,0,FMN GV 05 Lier
60,Mechelsesteenweg 365,2021-07-10,03:00:00,0,0,0,FMN GV 05 Lier
60,Mechelsesteenweg 365,2021-07-10,04:00:00,0,0,0,FMN GV 05 Lier
60,Mechelsesteenweg 365,2021-07-10,05:00:00,4,2,2,FMN GV 05 Lier
60,Mechelsesteenweg 365,2021-07-10,06:00:00,10,6,4,FMN GV 05 Lier
60,Mechelsesteenweg 365,2021-07-10,07:00:00,22,12,10,FMN GV 05 Lier
60,Mechelsesteenweg 365,2021-07-10,08:00:00,54,36,18,FMN GV 05 Lier
60,Mechelsesteenweg 365,2021-07-10,09:00:00,76,58,18,FMN GV 05 Lier
60,Mechelsesteenweg 365,2021-07-10,10:00:00,240,122,118,FMN GV 05 Lier
60,Mechelsesteenweg 365,2021-07-10,11:00:00,204,108,96,FMN GV 05 Lier
60,Mechelsesteenweg 365,2021-07-10,12:00:00,170,100,70,FMN GV 05 Lier
60,Mechelsesteenweg 365,2021-07-10,13:00:00,162,102,60,FMN GV 05 Lier
60,Mechelsesteenweg 365,2021-07-10,14:00:00,194,88,106,FMN GV 05 Lier
60,Mechelsesteenweg 365,2021-07-10,15:00:00,120,62,58,FMN GV 05 Lier
60,Mechelsesteenweg 365,2021-07-10,16:00:00,28,6,22,FMN GV 05 Lier
60,Mechelsesteenweg 365,2021-07-10,17:00:00,12,4,8,FMN GV 05 Lier
60,Mechelsesteenweg 365,2021-07-10,18:00:00,4,2,2,FMN GV 05 Lier
60,Mechelsesteenweg 365,2021-07-10,19:00:00,4,2,2,FMN GV 05 Lier
60,Mechelsesteenweg 365,2021-07-10,20:00:00,8,4,4,FMN GV 05 Lier
60,Mechelsesteenweg 365,2021-07-10,21:00:00,4,0,4,FMN GV 05 Lier
60,Mechelsesteenweg 365,2021-07-10,22:00:00,2,0,2,FMN GV 05 Lier
60,Mechelsesteenweg 365,2021-07-10,23:00:00,4,0,4,FMN GV 05 Lier
60,Mechelsesteenweg 365,2021-07-11,00:00:00,0,0,0,FMN GV 05 Lier
60,Mechelsesteenweg 365,2021-07-11,01:00:00,0,0,0,FMN GV 05 Lier
60,Mechelsesteenweg 365,2021-07-11,02:00:00,0,0,0,FMN GV 05 Lier
60,Mechelsesteenweg 365,2021-07-11,03:00:00,0,0,0,FMN GV 05 Lier
60,Mechelsesteenweg 365,2021-07-11,04:00:00,2,0,2,FMN GV 05 Lier
60,Mechelsesteenweg 365,2021-07-11,05:00:00,2,0,2,FMN GV 05 Lier
60,Mechelsesteenweg 365,2021-07-11,06:00:00,12,8,4,FMN GV 05 Lier
60,Mechelsesteenweg 365,2021-07-11,07:00:00,22,8,14,FMN GV 05 Lier
60,Mechelsesteenweg 365,2021-07-11,08:00:00,120,86,34,FMN GV 05 Lier
60,Mechelsesteenweg 365,2021-07-11,09:00:00,272,162,110,FMN GV 05 Lier
60,Mechelsesteenweg 365,2021-07-11,10:00:00,504,266,238,FMN GV 05 Lier
60,Mechelsesteenweg 365,2021-07-11,11:00:00,542,248,294,FMN GV 05 Lier
60,Mechelsesteenweg 365,2021-07-11,12:00:00,554,360,194,FMN GV 05 Lier
60,Mechelsesteenweg 365,2021-07-11,13:00:00,478,284,194,FMN GV 05 Lier
60,Mechelsesteenweg 365,2021-07-11,14:00:00,548,290,258,FMN GV 05 Lier
60,Mechelsesteenweg 365,2021-07-11,15:00:00,514,194,320,FMN GV 05 Lier
60,Mechelsesteenweg 365,2021-07-11,16:00:00,368,148,220,FMN GV 05 Lier
60,Mechelsesteenweg 365,2021-07-11,17:00:00,196,92,104,FMN GV 05 Lier
60,Mechelsesteenweg 365,2021-07-11,18:00:00,124,40,84,FMN GV 05 Lier
60,Mechelsesteenweg 365,2021-07-11,19:00:00,104,48,56,FMN GV 05 Lier
60,Mechelsesteenweg 365,2021-07-11,20:00:00,56,20,36,FMN GV 05 Lier
60,Mechelsesteenweg 365,2021-07-11,21:00:00,44,8,36,FMN GV 05 Lier
60,Mechelsesteenweg 365,2021-07-11,22:00:00,22,8,14,FMN GV 05 Lier
60,Mechelsesteenweg 365,2021-07-11,23:00:00,2,0,2,FMN GV 05 Lier
60,Mechelsesteenweg 365,2021-07-12,00:00:00,0,0,0,FMN GV 05 Lier
60,Mechelsesteenweg 365,2021-07-12,01:00:00,2,0,2,FMN GV 05 Lier
60,Mechelsesteenweg 365,2021-07-12,02:00:00,4,2,2,FMN GV 05 Lier
60,Mechelsesteenweg 365,2021-07-12,03:00:00,2,0,2,FMN GV 05 Lier
60,Mechelsesteenweg 365,2021-07-12,04:00:00,2,0,2,FMN GV 05 Lier
60,Mechelsesteenweg 365,2021-07-12,05:00:00,8,0,8,FMN GV 05 Lier
60,Mechelsesteenweg 365,2021-07-12,06:00:00,20,12,8,FMN GV 05 Lier
60,Mechelsesteenweg 365,2021-07-12,07:00:00,48,18,30,FMN GV 05 Lier
60,Mechelsesteenweg 365,2021-07-12,08:00:00,58,14,44,FMN GV 05 Lier
60,Mechelsesteenweg 365,2021-07-12,09:00:00,52,30,22,FMN GV 05 Lier
60,Mechelsesteenweg 365,2021-07-12,10:00:00,154,90,64,FMN GV 05 Lier
60,Mechelsesteenweg 365,2021-07-12,11:00:00,178,86,92,FMN GV 05 Lier
60,Mechelsesteenweg 365,2021-07-12,12:00:00,108,40,68,FMN GV 05 Lier
60,Mechelsesteenweg 365,2021-07-12,13:00:00,244,104,140,FMN GV 05 Lier
60,Mechelsesteenweg 365,2021-07-12,14:00:00,158,62,96,FMN GV 05 Lier
60,Mechelsesteenweg 365,2021-07-12,15:00:00,102,42,60,FMN GV 05 Lier
60,Mechelsesteenweg 365,2021-07-12,16:00:00,62,34,28,FMN GV 05 Lier
60,Mechelsesteenweg 365,2021-07-12,17:00:00,72,48,24,FMN GV 05 Lier
60,Mechelsesteenweg 365,2021-07-12,18:00:00,54,28,26,FMN GV 05 Lier
60,Mechelsesteenweg 365,2021-07-12,19:00:00,74,32,42,FMN GV 05 Lier
60,Mechelsesteenweg 365,2021-07-12,20:00:00,34,14,20,FMN GV 05 Lier
60,Mechelsesteenweg 365,2021-07-12,21:00:00,52,12,40,FMN GV 05 Lier
60,Mechelsesteenweg 365,2021-07-12,22:00:00,18,10,8,FMN GV 05 Lier
60,Mechelsesteenweg 365,2021-07-12,23:00:00,0,0,0,FMN GV 05 Lier
60,Mechelsesteenweg 365,2021-07-13,00:00:00,2,2,0,FMN GV 05 Lier
60,Mechelsesteenweg 365,2021-07-13,01:00:00,0,0,0,FMN GV 05 Lier
60,Mechelsesteenweg 365,2021-07-13,02:00:00,0,0,0,FMN GV 05 Lier
60,Mechelsesteenweg 365,2021-07-13,03:00:00,2,0,2,FMN GV 05 Lier
60,Mechelsesteenweg 365,2021-07-13,04:00:00,2,0,2,FMN GV 05 Lier
60,Mechelsesteenweg 365,2021-07-13,05:00:00,0,0,0,FMN GV 05 Lier
60,Mechelsesteenweg 365,2021-07-13,06:00:00,26,12,14,FMN GV 05 Lier
60,Mechelsesteenweg 365,2021-07-13,07:00:00,50,18,32,FMN GV 05 Lier
60,Mechelsesteenweg 365,2021-07-13,08:00:00,38,20,18,FMN GV 05 Lier
60,Mechelsesteenweg 365,2021-07-13,09:00:00,54,28,26,FMN GV 05 Lier
60,Mechelsesteenweg 365,2021-07-13,10:00:00,80,36,44,FMN GV 05 Lier
60,Mechelsesteenweg 365,2021-07-13,11:00:00,56,28,28,FMN GV 05 Lier
60,Mechelsesteenweg 365,2021-07-13,12:00:00,76,48,28,FMN GV 05 Lier
60,Mechelsesteenweg 365,2021-07-13,13:00:00,66,36,30,FMN GV 05 Lier
60,Mechelsesteenweg 365,2021-07-13,14:00:00,38,22,16,FMN GV 05 Lier
60,Mechelsesteenweg 365,2021-07-13,15:00:00,34,12,22,FMN GV 05 Lier
60,Mechelsesteenweg 365,2021-07-13,16:00:00,38,28,10,FMN GV 05 Lier
60,Mechelsesteenweg 365,2021-07-13,17:00:00,48,32,16,FMN GV 05 Lier
60,Mechelsesteenweg 365,2021-07-13,18:00:00,38,26,12,FMN GV 05 Lier
60,Mechelsesteenweg 365,2021-07-13,19:00:00,40,26,14,FMN GV 05 Lier
60,Mechelsesteenweg 365,2021-07-13,20:00:00,48,22,26,FMN GV 05 Lier
60,Mechelsesteenweg 365,2021-07-13,21:00:00,8,2,6,FMN GV 05 Lier
60,Mechelsesteenweg 365,2021-07-13,22:00:00,2,2,0,FMN GV 05 Lier
60,Mechelsesteenweg 365,2021-07-13,23:00:00,8,6,2,FMN GV 05 Lier
60,Mechelsesteenweg 365,2021-07-14,00:00:00,2,0,2,FMN GV 05 Lier
60,Mechelsesteenweg 365,2021-07-14,01:00:00,0,0,0,FMN GV 05 Lier
60,Mechelsesteenweg 365,2021-07-14,02:00:00,0,0,0,FMN GV 05 Lier
60,Mechelsesteenweg 365,2021-07-14,03:00:00,2,0,2,FMN GV 05 Lier
60,Mechelsesteenweg 365,2021-07-14,04:00:00,2,0,2,FMN GV 05 Lier
60,Mechelsesteenweg 365,2021-07-14,05:00:00,2,0,2,FMN GV 05 Lier
60,Mechelsesteenweg 365,2021-07-14,06:00:00,18,8,10,FMN GV 05 Lier
60,Mechelsesteenweg 365,2021-07-14,07:00:00,38,12,26,FMN GV 05 Lier
60,Mechelsesteenweg 365,2021-07-14,08:00:00,30,12,18,FMN GV 05 Lier
60,Mechelsesteenweg 365,2021-07-14,09:00:00,32,8,24,FMN GV 05 Lier
60,Mechelsesteenweg 365,2021-07-14,10:00:00,34,20,14,FMN GV 05 Lier
60,Mechelsesteenweg 365,2021-07-14,11:00:00,80,50,30,FMN GV 05 Lier
60,Mechelsesteenweg 365,2021-07-14,12:00:00,42,16,26,FMN GV 05 Lier
60,Mechelsesteenweg 365,2021-07-14,13:00:00,48,32,16,FMN GV 05 Lier
60,Mechelsesteenweg 365,2021-07-14,14:00:00,88,60,28,FMN GV 05 Lier
60,Mechelsesteenweg 365,2021-07-14,15:00:00,84,56,28,FMN GV 05 Lier
60,Mechelsesteenweg 365,2021-07-14,16:00:00,56,32,24,FMN GV 05 Lier
60,Mechelsesteenweg 365,2021-07-14,17:00:00,62,28,34,FMN GV 05 Lier
60,Mechelsesteenweg 365,2021-07-14,18:00:00,60,24,36,FMN GV 05 Lier
60,Mechelsesteenweg 365,2021-07-14,19:00:00,40,14,26,FMN GV 05 Lier
60,Mechelsesteenweg 365,2021-07-14,20:00:00,86,50,36,FMN GV 05 Lier
60,Mechelsesteenweg 365,2021-07-14,21:00:00,14,10,4,FMN GV 05 Lier
60,Mechelsesteenweg 365,2021-07-14,22:00:00,14,6,8,FMN GV 05 Lier
60,Mechelsesteenweg 365,2021-07-14,23:00:00,0,0,0,FMN GV 05 Lier
60,Mechelsesteenweg 365,2021-07-15,00:00:00,0,0,0,FMN GV 05 Lier
60,Mechelsesteenweg 365,2021-07-15,01:00:00,0,0,0,FMN GV 05 Lier
60,Mechelsesteenweg 365,2021-07-15,02:00:00,0,0,0,FMN GV 05 Lier
60,Mechelsesteenweg 365,2021-07-15,03:00:00,2,0,2,FMN GV 05 Lier
60,Mechelsesteenweg 365,2021-07-15,04:00:00,0,0,0,FMN GV 05 Lier
60,Mechelsesteenweg 365,2021-07-15,05:00:00,2,0,2,FMN GV 05 Lier
60,Mechelsesteenweg 365,2021-07-15,06:00:00,12,8,4,FMN GV 05 Lier
60,Mechelsesteenweg 365,2021-07-15,07:00:00,24,4,20,FMN GV 05 Lier
60,Mechelsesteenweg 365,2021-07-15,08:00:00,18,14,4,FMN GV 05 Lier
60,Mechelsesteenweg 365,2021-07-15,09:00:00,4,2,2,FMN GV 05 Lier
60,Mechelsesteenweg 365,2021-07-15,10:00:00,34,10,24,FMN GV 05 Lier
60,Mechelsesteenweg 365,2021-07-15,11:00:00,10,0,10,FMN GV 05 Lier
60,Mechelsesteenweg 365,2021-07-15,12:00:00,26,18,8,FMN GV 05 Lier
60,Mechelsesteenweg 365,2021-07-15,13:00:00,8,6,2,FMN GV 05 Lier
60,Mechelsesteenweg 365,2021-07-15,14:00:00,8,8,0,FMN GV 05 Lier
60,Mechelsesteenweg 365,2021-07-15,15:00:00,30,22,8,FMN GV 05 Lier
60,Mechelsesteenweg 365,2021-07-15,16:00:00,38,26,12,FMN GV 05 Lier
60,Mechelsesteenweg 365,2021-07-15,17:00:00,12,10,2,FMN GV 05 Lier
60,Mechelsesteenweg 365,2021-07-15,18:00:00,8,4,4,FMN GV 05 Lier
60,Mechelsesteenweg 365,2021-07-15,19:00:00,12,2,10,FMN GV 05 Lier
60,Mechelsesteenweg 365,2021-07-15,20:00:00,10,8,2,FMN GV 05 Lier
60,Mechelsesteenweg 365,2021-07-15,21:00:00,14,2,12,FMN GV 05 Lier
60,Mechelsesteenweg 365,2021-07-15,22:00:00,2,2,0,FMN GV 05 Lier
60,Mechelsesteenweg 365,2021-07-15,23:00:00,4,0,4,FMN GV 05 Lier
60,Mechelsesteenweg 365,2021-07-16,00:00:00,0,0,0,FMN GV 05 Lier
60,Mechelsesteenweg 365,2021-07-16,01:00:00,0,0,0,FMN GV 05 Lier
60,Mechelsesteenweg 365,2021-07-16,02:00:00,0,0,0,FMN GV 05 Lier
60,Mechelsesteenweg 365,2021-07-16,03:00:00,2,0,2,FMN GV 05 Lier
60,Mechelsesteenweg 365,2021-07-16,04:00:00,4,2,2,FMN GV 05 Lier
60,Mechelsesteenweg 365,2021-07-16,05:00:00,4,0,4,FMN GV 05 Lier
60,Mechelsesteenweg 365,2021-07-16,06:00:00,18,8,10,FMN GV 05 Lier
60,Mechelsesteenweg 365,2021-07-16,07:00:00,44,16,28,FMN GV 05 Lier
60,Mechelsesteenweg 365,2021-07-16,08:00:00,38,20,18,FMN GV 05 Lier
60,Mechelsesteenweg 365,2021-07-16,09:00:00,64,34,30,FMN GV 05 Lier
60,Mechelsesteenweg 365,2021-07-16,10:00:00,128,70,58,FMN GV 05 Lier
60,Mechelsesteenweg 365,2021-07-16,11:00:00,158,92,66,FMN GV 05 Lier
60,Mechelsesteenweg 365,2021-07-16,12:00:00,86,46,40,FMN GV 05 Lier
60,Mechelsesteenweg 365,2021-07-16,13:00:00,148,80,68,FMN GV 05 Lier
60,Mechelsesteenweg 365,2021-07-16,14:00:00,250,134,116,FMN GV 05 Lier
60,Mechelsesteenweg 365,2021-07-16,15:00:00,196,100,96,FMN GV 05 Lier
60,Mechelsesteenweg 365,2021-07-16,16:00:00,128,66,62,FMN GV 05 Lier
60,Mechelsesteenweg 365,2021-07-16,17:00:00,126,70,56,FMN GV 05 Lier
60,Mechelsesteenweg 365,2021-07-16,18:00:00,144,62,82,FMN GV 05 Lier
60,Mechelsesteenweg 365,2021-07-16,19:00:00,82,46,36,FMN GV 05 Lier
60,Mechelsesteenweg 365,2021-07-16,20:00:00,74,20,54,FMN GV 05 Lier
60,Mechelsesteenweg 365,2021-07-16,21:00:00,76,24,52,FMN GV 05 Lier
60,Mechelsesteenweg 365,2021-07-16,22:00:00,24,10,14,FMN GV 05 Lier
60,Mechelsesteenweg 365,2021-07-16,23:00:00,12,6,6,FMN GV 05 Lier
60,Mechelsesteenweg 365,2021-07-17,00:00:00,2,0,2,FMN GV 05 Lier
60,Mechelsesteenweg 365,2021-07-17,01:00:00,10,10,0,FMN GV 05 Lier
60,Mechelsesteenweg 365,2021-07-17,02:00:00,6,2,4,FMN GV 05 Lier
60,Mechelsesteenweg 365,2021-07-17,03:00:00,0,0,0,FMN GV 05 Lier
60,Mechelsesteenweg 365,2021-07-17,04:00:00,0,0,0,FMN GV 05 Lier
60,Mechelsesteenweg 365,2021-07-17,05:00:00,4,2,2,FMN GV 05 Lier
60,Mechelsesteenweg 365,2021-07-17,06:00:00,16,10,6,FMN GV 05 Lier
60,Mechelsesteenweg 365,2021-07-17,07:00:00,22,12,10,FMN GV 05 Lier
60,Mechelsesteenweg 365,2021-07-17,08:00:00,54,34,20,FMN GV 05 Lier
60,Mechelsesteenweg 365,2021-07-17,09:00:00,194,82,112,FMN GV 05 Lier
60,Mechelsesteenweg 365,2021-07-17,10:00:00,286,114,172,FMN GV 05 Lier
60,Mechelsesteenweg 365,2021-07-17,11:00:00,290,144,146,FMN GV 05 Lier
60,Mechelsesteenweg 365,2021-07-17,12:00:00,362,154,208,FMN GV 05 Lier
60,Mechelsesteenweg 365,2021-07-17,13:00:00,314,172,142,FMN GV 05 Lier
60,Mechelsesteenweg 365,2021-07-17,14:00:00,430,206,224,FMN GV 05 Lier
60,Mechelsesteenweg 365,2021-07-17,15:00:00,454,210,244,FMN GV 05 Lier
60,Mechelsesteenweg 365,2021-07-17,16:00:00,386,164,222,FMN GV 05 Lier
60,Mechelsesteenweg 365,2021-07-17,17:00:00,234,118,116,FMN GV 05 Lier
60,Mechelsesteenweg 365,2021-07-17,18:00:00,156,64,92,FMN GV 05 Lier
60,Mechelsesteenweg 365,2021-07-17,19:00:00,114,46,68,FMN GV 05 Lier
60,Mechelsesteenweg 365,2021-07-17,20:00:00,122,56,66,FMN GV 05 Lier
60,Mechelsesteenweg 365,2021-07-17,21:00:00,54,24,30,FMN GV 05 Lier
60,Mechelsesteenweg 365,2021-07-17,22:00:00,46,6,40,FMN GV 05 Lier
60,Mechelsesteenweg 365,2021-07-17,23:00:00,18,10,8,FMN GV 05 Lier
60,Mechelsesteenweg 365,2021-07-18,00:00:00,2,0,2,FMN GV 05 Lier
60,Mechelsesteenweg 365,2021-07-18,01:00:00,4,0,4,FMN GV 05 Lier
60,Mechelsesteenweg 365,2021-07-18,02:00:00,4,2,2,FMN GV 05 Lier
60,Mechelsesteenweg 365,2021-07-18,03:00:00,0,0,0,FMN GV 05 Lier
60,Mechelsesteenweg 365,2021-07-18,04:00:00,0,0,0,FMN GV 05 Lier
60,Mechelsesteenweg 365,2021-07-18,05:00:00,0,0,0,FMN GV 05 Lier
60,Mechelsesteenweg 365,2021-07-18,06:00:00,14,12,2,FMN GV 05 Lier
60,Mechelsesteenweg 365,2021-07-18,07:00:00,22,14,8,FMN GV 05 Lier
60,Mechelsesteenweg 365,2021-07-18,08:00:00,112,34,78,FMN GV 05 Lier
60,Mechelsesteenweg 365,2021-07-18,09:00:00,320,134,186,FMN GV 05 Lier
60,Mechelsesteenweg 365,2021-07-18,10:00:00,558,262,296,FMN GV 05 Lier
60,Mechelsesteenweg 365,2021-07-18,11:00:00,704,340,364,FMN GV 05 Lier
60,Mechelsesteenweg 365,2021-07-18,12:00:00,556,254,302,FMN GV 05 Lier
60,Mechelsesteenweg 365,2021-07-18,13:00:00,334,176,158,FMN GV 05 Lier
60,Mechelsesteenweg 365,2021-07-18,14:00:00,342,130,212,FMN GV 05 Lier
60,Mechelsesteenweg 365,2021-07-18,15:00:00,362,132,230,FMN GV 05 Lier
60,Mechelsesteenweg 365,2021-07-18,16:00:00,496,218,278,FMN GV 05 Lier
60,Mechelsesteenweg 365,2021-07-18,17:00:00,292,116,176,FMN GV 05 Lier
60,Mechelsesteenweg 365,2021-07-18,18:00:00,274,110,164,FMN GV 05 Lier
60,Mechelsesteenweg 365,2021-07-18,19:00:00,98,28,70,FMN GV 05 Lier
60,Mechelsesteenweg 365,2021-07-18,20:00:00,114,34,80,FMN GV 05 Lier
60,Mechelsesteenweg 365,2021-07-18,21:00:00,62,22,40,FMN GV 05 Lier
60,Mechelsesteenweg 365,2021-07-18,22:00:00,22,10,12,FMN GV 05 Lier
60,Mechelsesteenweg 365,2021-07-18,23:00:00,8,6,2,FMN GV 05 Lier
60,Mechelsesteenweg 365,2021-07-19,00:00:00,0,0,0,FMN GV 05 Lier
60,Mechelsesteenweg 365,2021-07-19,01:00:00,2,2,0,FMN GV 05 Lier
60,Mechelsesteenweg 365,2021-07-19,02:00:00,0,0,0,FMN GV 05 Lier
60,Mechelsesteenweg 365,2021-07-19,03:00:00,2,0,2,FMN GV 05 Lier
60,Mechelsesteenweg 365,2021-07-19,04:00:00,4,0,4,FMN GV 05 Lier
60,Mechelsesteenweg 365,2021-07-19,05:00:00,6,0,6,FMN GV 05 Lier
60,Mechelsesteenweg 365,2021-07-19,06:00:00,30,20,10,FMN GV 05 Lier
60,Mechelsesteenweg 365,2021-07-19,07:00:00,56,20,36,FMN GV 05 Lier
60,Mechelsesteenweg 365,2021-07-19,08:00:00,42,16,26,FMN GV 05 Lier
60,Mechelsesteenweg 365,2021-07-19,09:00:00,108,68,40,FMN GV 05 Lier
60,Mechelsesteenweg 365,2021-07-19,10:00:00,254,154,100,FMN GV 05 Lier
60,Mechelsesteenweg 365,2021-07-19,11:00:00,296,176,120,FMN GV 05 Lier
60,Mechelsesteenweg 365,2021-07-19,12:00:00,200,116,84,FMN GV 05 Lier
60,Mechelsesteenweg 365,2021-07-19,13:00:00,166,70,96,FMN GV 05 Lier
60,Mechelsesteenweg 365,2021-07-19,14:00:00,106,40,66,FMN GV 05 Lier
60,Mechelsesteenweg 365,2021-07-19,15:00:00,230,110,120,FMN GV 05 Lier
60,Mechelsesteenweg 365,2021-07-19,16:00:00,228,102,126,FMN GV 05 Lier
60,Mechelsesteenweg 365,2021-07-19,17:00:00,228,130,98,FMN GV 05 Lier
60,Mechelsesteenweg 365,2021-07-19,18:00:00,182,84,98,FMN GV 05 Lier
60,Mechelsesteenweg 365,2021-07-19,19:00:00,140,76,64,FMN GV 05 Lier
60,Mechelsesteenweg 365,2021-07-19,20:00:00,102,26,76,FMN GV 05 Lier
60,Mechelsesteenweg 365,2021-07-19,21:00:00,102,46,56,FMN GV 05 Lier
60,Mechelsesteenweg 365,2021-07-19,22:00:00,26,12,14,FMN GV 05 Lier
60,Mechelsesteenweg 365,2021-07-19,23:00:00,14,6,8,FMN GV 05 Lier
60,Mechelsesteenweg 365,2021-07-20,00:00:00,2,0,2,FMN GV 05 Lier
60,Mechelsesteenweg 365,2021-07-20,01:00:00,0,0,0,FMN GV 05 Lier
60,Mechelsesteenweg 365,2021-07-20,02:00:00,0,0,0,FMN GV 05 Lier
60,Mechelsesteenweg 365,2021-07-20,03:00:00,2,0,2,FMN GV 05 Lier
60,Mechelsesteenweg 365,2021-07-20,04:00:00,4,0,4,FMN GV 05 Lier
60,Mechelsesteenweg 365,2021-07-20,05:00:00,6,0,6,FMN GV 05 Lier
60,Mechelsesteenweg 365,2021-07-20,06:00:00,32,16,16,FMN GV 05 Lier
60,Mechelsesteenweg 365,2021-07-20,07:00:00,64,28,36,FMN GV 05 Lier
60,Mechelsesteenweg 365,2021-07-20,08:00:00,72,36,36,FMN GV 05 Lier
60,Mechelsesteenweg 365,2021-07-20,09:00:00,180,98,82,FMN GV 05 Lier
60,Mechelsesteenweg 365,2021-07-20,10:00:00,282,126,156,FMN GV 05 Lier
60,Mechelsesteenweg 365,2021-07-20,11:00:00,330,182,148,FMN GV 05 Lier
60,Mechelsesteenweg 365,2021-07-20,12:00:00,280,166,114,FMN GV 05 Lier
60,Mechelsesteenweg 365,2021-07-20,13:00:00,228,106,122,FMN GV 05 Lier
60,Mechelsesteenweg 365,2021-07-20,14:00:00,52,32,20,FMN GV 05 Lier
60,Mechelsesteenweg 365,2021-07-20,15:00:00,146,64,82,FMN GV 05 Lier
60,Mechelsesteenweg 365,2021-07-20,16:00:00,314,118,196,FMN GV 05 Lier
60,Mechelsesteenweg 365,2021-07-20,17:00:00,246,122,124,FMN GV 05 Lier
60,Mechelsesteenweg 365,2021-07-20,18:00:00,180,80,100,FMN GV 05 Lier
60,Mechelsesteenweg 365,2021-07-20,19:00:00,166,94,72,FMN GV 05 Lier
60,Mechelsesteenweg 365,2021-07-20,20:00:00,156,46,110,FMN GV 05 Lier
60,Mechelsesteenweg 365,2021-07-20,21:00:00,72,48,24,FMN GV 05 Lier
60,Mechelsesteenweg 365,2021-07-20,22:00:00,28,10,18,FMN GV 05 Lier
60,Mechelsesteenweg 365,2021-07-20,23:00:00,6,2,4,FMN GV 05 Lier
60,Mechelsesteenweg 365,2021-07-21,00:00:00,10,0,10,FMN GV 05 Lier
60,Mechelsesteenweg 365,2021-07-21,01:00:00,4,2,2,FMN GV 05 Lier
60,Mechelsesteenweg 365,2021-07-21,02:00:00,0,0,0,FMN GV 05 Lier
60,Mechelsesteenweg 365,2021-07-21,03:00:00,0,0,0,FMN GV 05 Lier
60,Mechelsesteenweg 365,2021-07-21,04:00:00,10,0,10,FMN GV 05 Lier
60,Mechelsesteenweg 365,2021-07-21,05:00:00,2,2,0,FMN GV 05 Lier
60,Mechelsesteenweg 365,2021-07-21,06:00:00,14,10,4,FMN GV 05 Lier
60,Mechelsesteenweg 365,2021-07-21,07:00:00,32,20,12,FMN GV 05 Lier
60,Mechelsesteenweg 365,2021-07-21,08:00:00,60,32,28,FMN GV 05 Lier
60,Mechelsesteenweg 365,2021-07-21,09:00:00,276,208,68,FMN GV 05 Lier
60,Mechelsesteenweg 365,2021-07-21,10:00:00,654,394,260,FMN GV 05 Lier
60,Mechelsesteenweg 365,2021-07-21,11:00:00,630,324,306,FMN GV 05 Lier
60,Mechelsesteenweg 365,2021-07-21,12:00:00,482,232,250,FMN GV 05 Lier
60,Mechelsesteenweg 365,2021-07-21,13:00:00,208,104,104,FMN GV 05 Lier
60,Mechelsesteenweg 365,2021-07-21,14:00:00,4,0,4,FMN GV 05 Lier
60,Mechelsesteenweg 365,2021-07-21,15:00:00,260,136,124,FMN GV 05 Lier
60,Mechelsesteenweg 365,2021-07-21,16:00:00,486,198,288,FMN GV 05 Lier
60,Mechelsesteenweg 365,2021-07-21,17:00:00,362,104,258,FMN GV 05 Lier
60,Mechelsesteenweg 365,2021-07-21,18:00:00,210,80,130,FMN GV 05 Lier
60,Mechelsesteenweg 365,2021-07-21,19:00:00,122,50,72,FMN GV 05 Lier
60,Mechelsesteenweg 365,2021-07-21,20:00:00,148,62,86,FMN GV 05 Lier
60,Mechelsesteenweg 365,2021-07-21,21:00:00,92,34,58,FMN GV 05 Lier
60,Mechelsesteenweg 365,2021-07-21,22:00:00,38,12,26,FMN GV 05 Lier
60,Mechelsesteenweg 365,2021-07-21,23:00:00,16,0,16,FMN GV 05 Lier
60,Mechelsesteenweg 365,2021-07-22,00:00:00,2,2,0,FMN GV 05 Lier
60,Mechelsesteenweg 365,2021-07-22,01:00:00,0,0,0,FMN GV 05 Lier
60,Mechelsesteenweg 365,2021-07-22,02:00:00,0,0,0,FMN GV 05 Lier
60,Mechelsesteenweg 365,2021-07-22,03:00:00,2,0,2,FMN GV 05 Lier
60,Mechelsesteenweg 365,2021-07-22,04:00:00,4,0,4,FMN GV 05 Lier
60,Mechelsesteenweg 365,2021-07-22,05:00:00,10,4,6,FMN GV 05 Lier
60,Mechelsesteenweg 365,2021-07-22,06:00:00,36,18,18,FMN GV 05 Lier
60,Mechelsesteenweg 365,2021-07-22,07:00:00,54,22,32,FMN GV 05 Lier
60,Mechelsesteenweg 365,2021-07-22,08:00:00,90,52,38,FMN GV 05 Lier
60,Mechelsesteenweg 365,2021-07-22,09:00:00,108,66,42,FMN GV 05 Lier
60,Mechelsesteenweg 365,2021-07-22,10:00:00,292,114,178,FMN GV 05 Lier
60,Mechelsesteenweg 365,2021-07-22,11:00:00,248,150,98,FMN GV 05 Lier
60,Mechelsesteenweg 365,2021-07-22,12:00:00,298,166,132,FMN GV 05 Lier
60,Mechelsesteenweg 365,2021-07-22,13:00:00,282,158,124,FMN GV 05 Lier
60,Mechelsesteenweg 365,2021-07-22,14:00:00,248,108,140,FMN GV 05 Lier
60,Mechelsesteenweg 365,2021-07-22,15:00:00,154,56,98,FMN GV 05 Lier
60,Mechelsesteenweg 365,2021-07-22,16:00:00,240,96,144,FMN GV 05 Lier
60,Mechelsesteenweg 365,2021-07-22,17:00:00,268,128,140,FMN GV 05 Lier
60,Mechelsesteenweg 365,2021-07-22,18:00:00,166,68,98,FMN GV 05 Lier
60,Mechelsesteenweg 365,2021-07-22,19:00:00,176,116,60,FMN GV 05 Lier
60,Mechelsesteenweg 365,2021-07-22,20:00:00,184,84,100,FMN GV 05 Lier
60,Mechelsesteenweg 365,2021-07-22,21:00:00,96,28,68,FMN GV 05 Lier
60,Mechelsesteenweg 365,2021-07-22,22:00:00,20,14,6,FMN GV 05 Lier
60,Mechelsesteenweg 365,2021-07-22,23:00:00,6,2,4,FMN GV 05 Lier
60,Mechelsesteenweg 365,2021-07-23,00:00:00,4,0,4,FMN GV 05 Lier
60,Mechelsesteenweg 365,2021-07-23,01:00:00,0,0,0,FMN GV 05 Lier
60,Mechelsesteenweg 365,2021-07-23,02:00:00,0,0,0,FMN GV 05 Lier
60,Mechelsesteenweg 365,2021-07-23,03:00:00,2,0,2,FMN GV 05 Lier
60,Mechelsesteenweg 365,2021-07-23,04:00:00,2,0,2,FMN GV 05 Lier
60,Mechelsesteenweg 365,2021-07-23,05:00:00,10,2,8,FMN GV 05 Lier
60,Mechelsesteenweg 365,2021-07-23,06:00:00,16,12,4,FMN GV 05 Lier
60,Mechelsesteenweg 365,2021-07-23,07:00:00,76,42,34,FMN GV 05 Lier
60,Mechelsesteenweg 365,2021-07-23,08:00:00,66,24,42,FMN GV 05 Lier
60,Mechelsesteenweg 365,2021-07-23,09:00:00,146,88,58,FMN GV 05 Lier
60,Mechelsesteenweg 365,2021-07-23,10:00:00,284,136,148,FMN GV 05 Lier
60,Mechelsesteenweg 365,2021-07-23,11:00:00,308,190,118,FMN GV 05 Lier
60,Mechelsesteenweg 365,2021-07-23,12:00:00,220,112,108,FMN GV 05 Lier
60,Mechelsesteenweg 365,2021-07-23,13:00:00,242,122,120,FMN GV 05 Lier
60,Mechelsesteenweg 365,2021-07-23,14:00:00,206,86,120,FMN GV 05 Lier
60,Mechelsesteenweg 365,2021-07-23,15:00:00,178,60,118,FMN GV 05 Lier
60,Mechelsesteenweg 365,2021-07-23,16:00:00,290,110,180,FMN GV 05 Lier
60,Mechelsesteenweg 365,2021-07-23,17:00:00,308,146,162,FMN GV 05 Lier
60,Mechelsesteenweg 365,2021-07-23,18:00:00,174,60,114,FMN GV 05 Lier
60,Mechelsesteenweg 365,2021-07-23,19:00:00,138,64,74,FMN GV 05 Lier
60,Mechelsesteenweg 365,2021-07-23,20:00:00,94,48,46,FMN GV 05 Lier
60,Mechelsesteenweg 365,2021-07-23,21:00:00,60,22,38,FMN GV 05 Lier
60,Mechelsesteenweg 365,2021-07-23,22:00:00,36,10,26,FMN GV 05 Lier
60,Mechelsesteenweg 365,2021-07-23,23:00:00,6,4,2,FMN GV 05 Lier
60,Mechelsesteenweg 365,2021-07-24,00:00:00,0,0,0,FMN GV 05 Lier
60,Mechelsesteenweg 365,2021-07-24,01:00:00,2,2,0,FMN GV 05 Lier
60,Mechelsesteenweg 365,2021-07-24,02:00:00,6,6,0,FMN GV 05 Lier
60,Mechelsesteenweg 365,2021-07-24,03:00:00,2,0,2,FMN GV 05 Lier
60,Mechelsesteenweg 365,2021-07-24,04:00:00,0,0,0,FMN GV 05 Lier
60,Mechelsesteenweg 365,2021-07-24,05:00:00,4,2,2,FMN GV 05 Lier
60,Mechelsesteenweg 365,2021-07-24,06:00:00,12,6,6,FMN GV 05 Lier
60,Mechelsesteenweg 365,2021-07-24,07:00:00,26,18,8,FMN GV 05 Lier
60,Mechelsesteenweg 365,2021-07-24,08:00:00,44,30,14,FMN GV 05 Lier
60,Mechelsesteenweg 365,2021-07-24,09:00:00,66,36,30,FMN GV 05 Lier
60,Mechelsesteenweg 365,2021-07-24,10:00:00,134,70,64,FMN GV 05 Lier
60,Mechelsesteenweg 365,2021-07-24,11:00:00,152,62,90,FMN GV 05 Lier
60,Mechelsesteenweg 365,2021-07-24,12:00:00,92,38,54,FMN GV 05 Lier
60,Mechelsesteenweg 365,2021-07-24,13:00:00,128,64,64,FMN GV 05 Lier
60,Mechelsesteenweg 365,2021-07-24,14:00:00,96,44,52,FMN GV 05 Lier
60,Mechelsesteenweg 365,2021-07-24,15:00:00,112,58,54,FMN GV 05 Lier
60,Mechelsesteenweg 365,2021-07-24,16:00:00,58,24,34,FMN GV 05 Lier
60,Mechelsesteenweg 365,2021-07-24,17:00:00,64,30,34,FMN GV 05 Lier
60,Mechelsesteenweg 365,2021-07-24,18:00:00,44,12,32,FMN GV 05 Lier
60,Mechelsesteenweg 365,2021-07-24,19:00:00,8,6,2,FMN GV 05 Lier
60,Mechelsesteenweg 365,2021-07-24,20:00:00,0,0,0,FMN GV 05 Lier
60,Mechelsesteenweg 365,2021-07-24,21:00:00,6,2,4,FMN GV 05 Lier
60,Mechelsesteenweg 365,2021-07-24,22:00:00,4,2,2,FMN GV 05 Lier
60,Mechelsesteenweg 365,2021-07-24,23:00:00,0,0,0,FMN GV 05 Lier
60,Mechelsesteenweg 365,2021-07-25,00:00:00,0,0,0,FMN GV 05 Lier
60,Mechelsesteenweg 365,2021-07-25,01:00:00,0,0,0,FMN GV 05 Lier
60,Mechelsesteenweg 365,2021-07-25,02:00:00,0,0,0,FMN GV 05 Lier
60,Mechelsesteenweg 365,2021-07-25,03:00:00,0,0,0,FMN GV 05 Lier
60,Mechelsesteenweg 365,2021-07-25,04:00:00,0,0,0,FMN GV 05 Lier
60,Mechelsesteenweg 365,2021-07-25,05:00:00,0,0,0,FMN GV 05 Lier
60,Mechelsesteenweg 365,2021-07-25,06:00:00,2,0,2,FMN GV 05 Lier
60,Mechelsesteenweg 365,2021-07-25,07:00:00,16,10,6,FMN GV 05 Lier
60,Mechelsesteenweg 365,2021-07-25,08:00:00,62,28,34,FMN GV 05 Lier
60,Mechelsesteenweg 365,2021-07-25,09:00:00,272,164,108,FMN GV 05 Lier
60,Mechelsesteenweg 365,2021-07-25,10:00:00,286,136,150,FMN GV 05 Lier
60,Mechelsesteenweg 365,2021-07-25,11:00:00,404,148,256,FMN GV 05 Lier
60,Mechelsesteenweg 365,2021-07-25,12:00:00,68,22,46,FMN GV 05 Lier
60,Mechelsesteenweg 365,2021-07-25,13:00:00,10,4,6,FMN GV 05 Lier
60,Mechelsesteenweg 365,2021-07-25,14:00:00,124,48,76,FMN GV 05 Lier
60,Mechelsesteenweg 365,2021-07-25,15:00:00,30,20,10,FMN GV 05 Lier
60,Mechelsesteenweg 365,2021-07-25,16:00:00,30,24,6,FMN GV 05 Lier
60,Mechelsesteenweg 365,2021-07-25,17:00:00,32,16,16,FMN GV 05 Lier
60,Mechelsesteenweg 365,2021-07-25,18:00:00,24,14,10,FMN GV 05 Lier
60,Mechelsesteenweg 365,2021-07-25,19:00:00,6,6,0,FMN GV 05 Lier
60,Mechelsesteenweg 365,2021-07-25,20:00:00,30,8,22,FMN GV 05 Lier
60,Mechelsesteenweg 365,2021-07-25,21:00:00,10,2,8,FMN GV 05 Lier
60,Mechelsesteenweg 365,2021-07-25,22:00:00,6,2,4,FMN GV 05 Lier
60,Mechelsesteenweg 365,2021-07-25,23:00:00,4,2,2,FMN GV 05 Lier
60,Mechelsesteenweg 365,2021-07-26,00:00:00,2,0,2,FMN GV 05 Lier
60,Mechelsesteenweg 365,2021-07-26,01:00:00,2,0,2,FMN GV 05 Lier
60,Mechelsesteenweg 365,2021-07-26,02:00:00,0,0,0,FMN GV 05 Lier
60,Mechelsesteenweg 365,2021-07-26,03:00:00,2,0,2,FMN GV 05 Lier
60,Mechelsesteenweg 365,2021-07-26,04:00:00,2,0,2,FMN GV 05 Lier
60,Mechelsesteenweg 365,2021-07-26,05:00:00,2,0,2,FMN GV 05 Lier
60,Mechelsesteenweg 365,2021-07-26,06:00:00,28,14,14,FMN GV 05 Lier
60,Mechelsesteenweg 365,2021-07-26,07:00:00,52,22,30,FMN GV 05 Lier
60,Mechelsesteenweg 365,2021-07-26,08:00:00,26,12,14,FMN GV 05 Lier
60,Mechelsesteenweg 365,2021-07-26,09:00:00,54,28,26,FMN GV 05 Lier
60,Mechelsesteenweg 365,2021-07-26,10:00:00,84,50,34,FMN GV 05 Lier
60,Mechelsesteenweg 365,2021-07-26,11:00:00,76,16,60,FMN GV 05 Lier
60,Mechelsesteenweg 365,2021-07-26,12:00:00,46,20,26,FMN GV 05 Lier
60,Mechelsesteenweg 365,2021-07-26,13:00:00,62,20,42,FMN GV 05 Lier
60,Mechelsesteenweg 365,2021-07-26,14:00:00,64,34,30,FMN GV 05 Lier
60,Mechelsesteenweg 365,2021-07-26,15:00:00,60,32,28,FMN GV 05 Lier
60,Mechelsesteenweg 365,2021-07-26,16:00:00,58,38,20,FMN GV 05 Lier
60,Mechelsesteenweg 365,2021-07-26,17:00:00,64,34,30,FMN GV 05 Lier
60,Mechelsesteenweg 365,2021-07-26,18:00:00,22,10,12,FMN GV 05 Lier
60,Mechelsesteenweg 365,2021-07-26,19:00:00,12,10,2,FMN GV 05 Lier
60,Mechelsesteenweg 365,2021-07-26,20:00:00,46,16,30,FMN GV 05 Lier
60,Mechelsesteenweg 365,2021-07-26,21:00:00,16,6,10,FMN GV 05 Lier
60,Mechelsesteenweg 365,2021-07-26,22:00:00,6,2,4,FMN GV 05 Lier
60,Mechelsesteenweg 365,2021-07-26,23:00:00,16,2,14,FMN GV 05 Lier
60,Mechelsesteenweg 365,2021-07-27,00:00:00,0,0,0,FMN GV 05 Lier
60,Mechelsesteenweg 365,2021-07-27,01:00:00,0,0,0,FMN GV 05 Lier
60,Mechelsesteenweg 365,2021-07-27,02:00:00,0,0,0,FMN GV 05 Lier
60,Mechelsesteenweg 365,2021-07-27,03:00:00,2,0,2,FMN GV 05 Lier
60,Mechelsesteenweg 365,2021-07-27,04:00:00,2,0,2,FMN GV 05 Lier
60,Mechelsesteenweg 365,2021-07-27,05:00:00,4,2,2,FMN GV 05 Lier
60,Mechelsesteenweg 365,2021-07-27,06:00:00,28,16,12,FMN GV 05 Lier
60,Mechelsesteenweg 365,2021-07-27,07:00:00,50,22,28,FMN GV 05 Lier
60,Mechelsesteenweg 365,2021-07-27,08:00:00,56,28,28,FMN GV 05 Lier
60,Mechelsesteenweg 365,2021-07-27,09:00:00,98,38,60,FMN GV 05 Lier
60,Mechelsesteenweg 365,2021-07-27,10:00:00,166,80,86,FMN GV 05 Lier
60,Mechelsesteenweg 365,2021-07-27,11:00:00,108,78,30,FMN GV 05 Lier
60,Mechelsesteenweg 365,2021-07-27,12:00:00,78,28,50,FMN GV 05 Lier
60,Mechelsesteenweg 365,2021-07-27,13:00:00,136,72,64,FMN GV 05 Lier
60,Mechelsesteenweg 365,2021-07-27,14:00:00,116,54,62,FMN GV 05 Lier
60,Mechelsesteenweg 365,2021-07-27,15:00:00,62,40,22,FMN GV 05 Lier
60,Mechelsesteenweg 365,2021-07-27,16:00:00,128,54,74,FMN GV 05 Lier
60,Mechelsesteenweg 365,2021-07-27,17:00:00,92,56,36,FMN GV 05 Lier
60,Mechelsesteenweg 365,2021-07-27,18:00:00,64,30,34,FMN GV 05 Lier
60,Mechelsesteenweg 365,2021-07-27,19:00:00,66,38,28,FMN GV 05 Lier
60,Mechelsesteenweg 365,2021-07-27,20:00:00,48,20,28,FMN GV 05 Lier
60,Mechelsesteenweg 365,2021-07-27,21:00:00,20,8,12,FMN GV 05 Lier
60,Mechelsesteenweg 365,2021-07-27,22:00:00,4,0,4,FMN GV 05 Lier
60,Mechelsesteenweg 365,2021-07-27,23:00:00,0,0,0,FMN GV 05 Lier
60,Mechelsesteenweg 365,2021-07-28,00:00:00,8,2,6,FMN GV 05 Lier
60,Mechelsesteenweg 365,2021-07-28,01:00:00,4,0,4,FMN GV 05 Lier
60,Mechelsesteenweg 365,2021-07-28,02:00:00,0,0,0,FMN GV 05 Lier
60,Mechelsesteenweg 365,2021-07-28,03:00:00,2,0,2,FMN GV 05 Lier
60,Mechelsesteenweg 365,2021-07-28,04:00:00,2,0,2,FMN GV 05 Lier
60,Mechelsesteenweg 365,2021-07-28,05:00:00,10,6,4,FMN GV 05 Lier
60,Mechelsesteenweg 365,2021-07-28,06:00:00,44,24,20,FMN GV 05 Lier
60,Mechelsesteenweg 365,2021-07-28,07:00:00,60,24,36,FMN GV 05 Lier
60,Mechelsesteenweg 365,2021-07-28,08:00:00,58,28,30,FMN GV 05 Lier
60,Mechelsesteenweg 365,2021-07-28,09:00:00,86,52,34,FMN GV 05 Lier
60,Mechelsesteenweg 365,2021-07-28,10:00:00,114,52,62,FMN GV 05 Lier
60,Mechelsesteenweg 365,2021-07-28,11:00:00,104,52,52,FMN GV 05 Lier
60,Mechelsesteenweg 365,2021-07-28,12:00:00,146,68,78,FMN GV 05 Lier
60,Mechelsesteenweg 365,2021-07-28,13:00:00,100,26,74,FMN GV 05 Lier
60,Mechelsesteenweg 365,2021-07-28,14:00:00,96,48,48,FMN GV 05 Lier
60,Mechelsesteenweg 365,2021-07-28,15:00:00,104,56,48,FMN GV 05 Lier
60,Mechelsesteenweg 365,2021-07-28,16:00:00,128,66,62,FMN GV 05 Lier
60,Mechelsesteenweg 365,2021-07-28,17:00:00,132,70,62,FMN GV 05 Lier
60,Mechelsesteenweg 365,2021-07-28,18:00:00,104,64,40,FMN GV 05 Lier
60,Mechelsesteenweg 365,2021-07-28,19:00:00,88,62,26,FMN GV 05 Lier
60,Mechelsesteenweg 365,2021-07-28,20:00:00,116,78,38,FMN GV 05 Lier
60,Mechelsesteenweg 365,2021-07-28,21:00:00,22,4,18,FMN GV 05 Lier
60,Mechelsesteenweg 365,2021-07-28,22:00:00,6,0,6,FMN GV 05 Lier
60,Mechelsesteenweg 365,2021-07-28,23:00:00,0,0,0,FMN GV 05 Lier
60,Mechelsesteenweg 365,2021-07-29,00:00:00,2,0,2,FMN GV 05 Lier
60,Mechelsesteenweg 365,2021-07-29,01:00:00,0,0,0,FMN GV 05 Lier
60,Mechelsesteenweg 365,2021-07-29,02:00:00,0,0,0,FMN GV 05 Lier
60,Mechelsesteenweg 365,2021-07-29,03:00:00,2,0,2,FMN GV 05 Lier
60,Mechelsesteenweg 365,2021-07-29,04:00:00,2,0,2,FMN GV 05 Lier
60,Mechelsesteenweg 365,2021-07-29,05:00:00,14,4,10,FMN GV 05 Lier
60,Mechelsesteenweg 365,2021-07-29,06:00:00,24,14,10,FMN GV 05 Lier
60,Mechelsesteenweg 365,2021-07-29,07:00:00,70,38,32,FMN GV 05 Lier
60,Mechelsesteenweg 365,2021-07-29,08:00:00,60,36,24,FMN GV 05 Lier
60,Mechelsesteenweg 365,2021-07-29,09:00:00,96,40,56,FMN GV 05 Lier
60,Mechelsesteenweg 365,2021-07-29,10:00:00,140,68,72,FMN GV 05 Lier
60,Mechelsesteenweg 365,2021-07-29,11:00:00,242,146,96,FMN GV 05 Lier
60,Mechelsesteenweg 365,2021-07-29,12:00:00,198,106,92,FMN GV 05 Lier
60,Mechelsesteenweg 365,2021-07-29,13:00:00,202,106,96,FMN GV 05 Lier
60,Mechelsesteenweg 365,2021-07-29,14:00:00,344,172,172,FMN GV 05 Lier
60,Mechelsesteenweg 365,2021-07-29,15:00:00,224,128,96,FMN GV 05 Lier
60,Mechelsesteenweg 365,2021-07-29,16:00:00,264,142,122,FMN GV 05 Lier
60,Mechelsesteenweg 365,2021-07-29,17:00:00,186,76,110,FMN GV 05 Lier
60,Mechelsesteenweg 365,2021-07-29,18:00:00,140,68,72,FMN GV 05 Lier
60,Mechelsesteenweg 365,2021-07-29,19:00:00,110,58,52,FMN GV 05 Lier
60,Mechelsesteenweg 365,2021-07-29,20:00:00,174,80,94,FMN GV 05 Lier
60,Mechelsesteenweg 365,2021-07-29,21:00:00,44,14,30,FMN GV 05 Lier
60,Mechelsesteenweg 365,2021-07-29,22:00:00,12,2,10,FMN GV 05 Lier
60,Mechelsesteenweg 365,2021-07-29,23:00:00,14,4,10,FMN GV 05 Lier
60,Mechelsesteenweg 365,2021-07-30,00:00:00,0,0,0,FMN GV 05 Lier
60,Mechelsesteenweg 365,2021-07-30,01:00:00,0,0,0,FMN GV 05 Lier
60,Mechelsesteenweg 365,2021-07-30,02:00:00,0,0,0,FMN GV 05 Lier
60,Mechelsesteenweg 365,2021-07-30,03:00:00,2,0,2,FMN GV 05 Lier
60,Mechelsesteenweg 365,2021-07-30,04:00:00,0,0,0,FMN GV 05 Lier
60,Mechelsesteenweg 365,2021-07-30,05:00:00,10,4,6,FMN GV 05 Lier
60,Mechelsesteenweg 365,2021-07-30,06:00:00,20,10,10,FMN GV 05 Lier
60,Mechelsesteenweg 365,2021-07-30,07:00:00,46,16,30,FMN GV 05 Lier
60,Mechelsesteenweg 365,2021-07-30,08:00:00,42,22,20,FMN GV 05 Lier
60,Mechelsesteenweg 365,2021-07-30,09:00:00,98,46,52,FMN GV 05 Lier
60,Mechelsesteenweg 365,2021-07-30,10:00:00,182,102,80,FMN GV 05 Lier
60,Mechelsesteenweg 365,2021-07-30,11:00:00,166,70,96,FMN GV 05 Lier
60,Mechelsesteenweg 365,2021-07-30,12:00:00,182,74,108,FMN GV 05 Lier
60,Mechelsesteenweg 365,2021-07-30,13:00:00,148,76,72,FMN GV 05 Lier
60,Mechelsesteenweg 365,2021-07-30,14:00:00,210,128,82,FMN GV 05 Lier
60,Mechelsesteenweg 365,2021-07-30,15:00:00,138,82,56,FMN GV 05 Lier
60,Mechelsesteenweg 365,2021-07-30,16:00:00,126,72,54,FMN GV 05 Lier
60,Mechelsesteenweg 365,2021-07-30,17:00:00,94,46,48,FMN GV 05 Lier
60,Mechelsesteenweg 365,2021-07-30,18:00:00,78,48,30,FMN GV 05 Lier
60,Mechelsesteenweg 365,2021-07-30,19:00:00,34,14,20,FMN GV 05 Lier
60,Mechelsesteenweg 365,2021-07-30,20:00:00,42,16,26,FMN GV 05 Lier
60,Mechelsesteenweg 365,2021-07-30,21:00:00,16,8,8,FMN GV 05 Lier
60,Mechelsesteenweg 365,2021-07-30,22:00:00,10,2,8,FMN GV 05 Lier
60,Mechelsesteenweg 365,2021-07-30,23:00:00,4,2,2,FMN GV 05 Lier
60,Mechelsesteenweg 365,2021-07-31,00:00:00,0,0,0,FMN GV 05 Lier
60,Mechelsesteenweg 365,2021-07-31,01:00:00,4,0,4,FMN GV 05 Lier
60,Mechelsesteenweg 365,2021-07-31,02:00:00,0,0,0,FMN GV 05 Lier
60,Mechelsesteenweg 365,2021-07-31,03:00:00,2,0,2,FMN GV 05 Lier
60,Mechelsesteenweg 365,2021-07-31,04:00:00,0,0,0,FMN GV 05 Lier
60,Mechelsesteenweg 365,2021-07-31,05:00:00,0,0,0,FMN GV 05 Lier
60,Mechelsesteenweg 365,2021-07-31,06:00:00,14,14,0,FMN GV 05 Lier
60,Mechelsesteenweg 365,2021-07-31,07:00:00,12,4,8,FMN GV 05 Lier
60,Mechelsesteenweg 365,2021-07-31,08:00:00,90,66,24,FMN GV 05 Lier
60,Mechelsesteenweg 365,2021-07-31,09:00:00,122,78,44,FMN GV 05 Lier
60,Mechelsesteenweg 365,2021-07-31,10:00:00,158,98,60,FMN GV 05 Lier
60,Mechelsesteenweg 365,2021-07-31,11:00:00,234,140,94,FMN GV 05 Lier
60,Mechelsesteenweg 365,2021-07-31,12:00:00,144,66,78,FMN GV 05 Lier
60,Mechelsesteenweg 365,2021-07-31,13:00:00,132,84,48,FMN GV 05 Lier
60,Mechelsesteenweg 365,2021-07-31,14:00:00,176,70,106,FMN GV 05 Lier
60,Mechelsesteenweg 365,2021-07-31,15:00:00,136,68,68,FMN GV 05 Lier
60,Mechelsesteenweg 365,2021-07-31,16:00:00,118,54,64,FMN GV 05 Lier
60,Mechelsesteenweg 365,2021-07-31,17:00:00,144,72,72,FMN GV 05 Lier
60,Mechelsesteenweg 365,2021-07-31,18:00:00,68,28,40,FMN GV 05 Lier
60,Mechelsesteenweg 365,2021-07-31,19:00:00,46,24,22,FMN GV 05 Lier
60,Mechelsesteenweg 365,2021-07-31,20:00:00,44,22,22,FMN GV 05 Lier
60,Mechelsesteenweg 365,2021-07-31,21:00:00,6,0,6,FMN GV 05 Lier
60,Mechelsesteenweg 365,2021-07-31,22:00:00,4,0,4,FMN GV 05 Lier
60,Mechelsesteenweg 365,2021-07-31,23:00:00,2,0,2,FMN GV 05 Lier
60,Mechelsesteenweg 365,2021-08-01,00:00:00,0,0,0,FMN GV 05 Lier
60,Mechelsesteenweg 365,2021-08-01,01:00:00,0,0,0,FMN GV 05 Lier
60,Mechelsesteenweg 365,2021-08-01,02:00:00,2,2,0,FMN GV 05 Lier
60,Mechelsesteenweg 365,2021-08-01,03:00:00,4,2,2,FMN GV 05 Lier
60,Mechelsesteenweg 365,2021-08-01,04:00:00,0,0,0,FMN GV 05 Lier
60,Mechelsesteenweg 365,2021-08-01,05:00:00,0,0,0,FMN GV 05 Lier
60,Mechelsesteenweg 365,2021-08-01,06:00:00,2,0,2,FMN GV 05 Lier
60,Mechelsesteenweg 365,2021-08-01,07:00:00,8,6,2,FMN GV 05 Lier
60,Mechelsesteenweg 365,2021-08-01,08:00:00,54,40,14,FMN GV 05 Lier
60,Mechelsesteenweg 365,2021-08-01,09:00:00,186,92,94,FMN GV 05 Lier
60,Mechelsesteenweg 365,2021-08-01,10:00:00,214,92,122,FMN GV 05 Lier
60,Mechelsesteenweg 365,2021-08-01,11:00:00,232,138,94,FMN GV 05 Lier
60,Mechelsesteenweg 365,2021-08-01,12:00:00,106,78,28,FMN GV 05 Lier
60,Mechelsesteenweg 365,2021-08-01,13:00:00,78,28,50,FMN GV 05 Lier
60,Mechelsesteenweg 365,2021-08-01,14:00:00,72,42,30,FMN GV 05 Lier
60,Mechelsesteenweg 365,2021-08-01,15:00:00,68,30,38,FMN GV 05 Lier
60,Mechelsesteenweg 365,2021-08-01,16:00:00,46,12,34,FMN GV 05 Lier
60,Mechelsesteenweg 365,2021-08-01,17:00:00,22,6,16,FMN GV 05 Lier
60,Mechelsesteenweg 365,2021-08-01,18:00:00,14,10,4,FMN GV 05 Lier
60,Mechelsesteenweg 365,2021-08-01,19:00:00,14,6,8,FMN GV 05 Lier
60,Mechelsesteenweg 365,2021-08-01,20:00:00,10,8,2,FMN GV 05 Lier
60,Mechelsesteenweg 365,2021-08-01,21:00:00,8,2,6,FMN GV 05 Lier
60,Mechelsesteenweg 365,2021-08-01,22:00:00,2,0,2,FMN GV 05 Lier
60,Mechelsesteenweg 365,2021-08-01,23:00:00,2,0,2,FMN GV 05 Lier
60,Mechelsesteenweg 365,2021-08-02,00:00:00,2,0,2,FMN GV 05 Lier
60,Mechelsesteenweg 365,2021-08-02,01:00:00,0,0,0,FMN GV 05 Lier
60,Mechelsesteenweg 365,2021-08-02,02:00:00,0,0,0,FMN GV 05 Lier
60,Mechelsesteenweg 365,2021-08-02,03:00:00,2,0,2,FMN GV 05 Lier
60,Mechelsesteenweg 365,2021-08-02,04:00:00,4,0,4,FMN GV 05 Lier
60,Mechelsesteenweg 365,2021-08-02,05:00:00,2,0,2,FMN GV 05 Lier
60,Mechelsesteenweg 365,2021-08-02,06:00:00,16,6,10,FMN GV 05 Lier
60,Mechelsesteenweg 365,2021-08-02,07:00:00,44,18,26,FMN GV 05 Lier
60,Mechelsesteenweg 365,2021-08-02,08:00:00,38,22,16,FMN GV 05 Lier
60,Mechelsesteenweg 365,2021-08-02,09:00:00,38,24,14,FMN GV 05 Lier
60,Mechelsesteenweg 365,2021-08-02,10:00:00,56,26,30,FMN GV 05 Lier
60,Mechelsesteenweg 365,2021-08-02,11:00:00,52,32,20,FMN GV 05 Lier
60,Mechelsesteenweg 365,2021-08-02,12:00:00,78,32,46,FMN GV 05 Lier
60,Mechelsesteenweg 365,2021-08-02,13:00:00,148,86,62,FMN GV 05 Lier
60,Mechelsesteenweg 365,2021-08-02,14:00:00,202,96,106,FMN GV 05 Lier
60,Mechelsesteenweg 365,2021-08-02,15:00:00,206,82,124,FMN GV 05 Lier
60,Mechelsesteenweg 365,2021-08-02,16:00:00,194,118,76,FMN GV 05 Lier
60,Mechelsesteenweg 365,2021-08-02,17:00:00,114,60,54,FMN GV 05 Lier
60,Mechelsesteenweg 365,2021-08-02,18:00:00,88,50,38,FMN GV 05 Lier
60,Mechelsesteenweg 365,2021-08-02,19:00:00,118,72,46,FMN GV 05 Lier
60,Mechelsesteenweg 365,2021-08-02,20:00:00,120,46,74,FMN GV 05 Lier
60,Mechelsesteenweg 365,2021-08-02,21:00:00,22,8,14,FMN GV 05 Lier
60,Mechelsesteenweg 365,2021-08-02,22:00:00,28,16,12,FMN GV 05 Lier
60,Mechelsesteenweg 365,2021-08-02,23:00:00,2,2,0,FMN GV 05 Lier
60,Mechelsesteenweg 365,2021-08-03,00:00:00,6,4,2,FMN GV 05 Lier
60,Mechelsesteenweg 365,2021-08-03,01:00:00,6,6,0,FMN GV 05 Lier
60,Mechelsesteenweg 365,2021-08-03,02:00:00,0,0,0,FMN GV 05 Lier
60,Mechelsesteenweg 365,2021-08-03,03:00:00,2,0,2,FMN GV 05 Lier
60,Mechelsesteenweg 365,2021-08-03,04:00:00,2,0,2,FMN GV 05 Lier
60,Mechelsesteenweg 365,2021-08-03,05:00:00,4,0,4,FMN GV 05 Lier
60,Mechelsesteenweg 365,2021-08-03,06:00:00,26,8,18,FMN GV 05 Lier
60,Mechelsesteenweg 365,2021-08-03,07:00:00,54,30,24,FMN GV 05 Lier
60,Mechelsesteenweg 365,2021-08-03,08:00:00,44,24,20,FMN GV 05 Lier
60,Mechelsesteenweg 365,2021-08-03,09:00:00,106,76,30,FMN GV 05 Lier
60,Mechelsesteenweg 365,2021-08-03,10:00:00,112,54,58,FMN GV 05 Lier
60,Mechelsesteenweg 365,2021-08-03,11:00:00,182,114,68,FMN GV 05 Lier
60,Mechelsesteenweg 365,2021-08-03,12:00:00,144,54,90,FMN GV 05 Lier
60,Mechelsesteenweg 365,2021-08-03,13:00:00,198,100,98,FMN GV 05 Lier
60,Mechelsesteenweg 365,2021-08-03,14:00:00,252,122,130,FMN GV 05 Lier
60,Mechelsesteenweg 365,2021-08-03,15:00:00,314,140,174,FMN GV 05 Lier
60,Mechelsesteenweg 365,2021-08-03,16:00:00,302,144,158,FMN GV 05 Lier
60,Mechelsesteenweg 365,2021-08-03,17:00:00,240,98,142,FMN GV 05 Lier
60,Mechelsesteenweg 365,2021-08-03,18:00:00,98,56,42,FMN GV 05 Lier
60,Mechelsesteenweg 365,2021-08-03,19:00:00,110,68,42,FMN GV 05 Lier
60,Mechelsesteenweg 365,2021-08-03,20:00:00,80,40,40,FMN GV 05 Lier
60,Mechelsesteenweg 365,2021-08-03,21:00:00,72,26,46,FMN GV 05 Lier
60,Mechelsesteenweg 365,2021-08-03,22:00:00,12,6,6,FMN GV 05 Lier
60,Mechelsesteenweg 365,2021-08-03,23:00:00,6,0,6,FMN GV 05 Lier
60,Mechelsesteenweg 365,2021-08-04,00:00:00,0,0,0,FMN GV 05 Lier
60,Mechelsesteenweg 365,2021-08-04,01:00:00,6,6,0,FMN GV 05 Lier
60,Mechelsesteenweg 365,2021-08-04,02:00:00,0,0,0,FMN GV 05 Lier
60,Mechelsesteenweg 365,2021-08-04,03:00:00,2,0,2,FMN GV 05 Lier
60,Mechelsesteenweg 365,2021-08-04,04:00:00,2,0,2,FMN GV 05 Lier
60,Mechelsesteenweg 365,2021-08-04,05:00:00,4,2,2,FMN GV 05 Lier
60,Mechelsesteenweg 365,2021-08-04,06:00:00,32,10,22,FMN GV 05 Lier
60,Mechelsesteenweg 365,2021-08-04,07:00:00,56,16,40,FMN GV 05 Lier
60,Mechelsesteenweg 365,2021-08-04,08:00:00,50,24,26,FMN GV 05 Lier
60,Mechelsesteenweg 365,2021-08-04,09:00:00,68,30,38,FMN GV 05 Lier
60,Mechelsesteenweg 365,2021-08-04,10:00:00,140,88,52,FMN GV 05 Lier
60,Mechelsesteenweg 365,2021-08-04,11:00:00,270,120,150,FMN GV 05 Lier
60,Mechelsesteenweg 365,2021-08-04,12:00:00,180,92,88,FMN GV 05 Lier
60,Mechelsesteenweg 365,2021-08-04,13:00:00,222,120,102,FMN GV 05 Lier
60,Mechelsesteenweg 365,2021-08-04,14:00:00,204,100,104,FMN GV 05 Lier
60,Mechelsesteenweg 365,2021-08-04,15:00:00,162,86,76,FMN GV 05 Lier
60,Mechelsesteenweg 365,2021-08-04,16:00:00,138,58,80,FMN GV 05 Lier
60,Mechelsesteenweg 365,2021-08-04,17:00:00,126,64,62,FMN GV 05 Lier
60,Mechelsesteenweg 365,2021-08-04,18:00:00,82,44,38,FMN GV 05 Lier
60,Mechelsesteenweg 365,2021-08-04,19:00:00,96,46,50,FMN GV 05 Lier
60,Mechelsesteenweg 365,2021-08-04,20:00:00,158,94,64,FMN GV 05 Lier
60,Mechelsesteenweg 365,2021-08-04,21:00:00,28,14,14,FMN GV 05 Lier
60,Mechelsesteenweg 365,2021-08-04,22:00:00,6,2,4,FMN GV 05 Lier
60,Mechelsesteenweg 365,2021-08-04,23:00:00,0,0,0,FMN GV 05 Lier
60,Mechelsesteenweg 365,2021-08-05,00:00:00,6,2,4,FMN GV 05 Lier
60,Mechelsesteenweg 365,2021-08-05,01:00:00,0,0,0,FMN GV 05 Lier
60,Mechelsesteenweg 365,2021-08-05,02:00:00,0,0,0,FMN GV 05 Lier
60,Mechelsesteenweg 365,2021-08-05,03:00:00,4,2,2,FMN GV 05 Lier
60,Mechelsesteenweg 365,2021-08-05,04:00:00,2,0,2,FMN GV 05 Lier
60,Mechelsesteenweg 365,2021-08-05,05:00:00,4,0,4,FMN GV 05 Lier
60,Mechelsesteenweg 365,2021-08-05,06:00:00,34,12,22,FMN GV 05 Lier
60,Mechelsesteenweg 365,2021-08-05,07:00:00,46,16,30,FMN GV 05 Lier
60,Mechelsesteenweg 365,2021-08-05,08:00:00,54,26,28,FMN GV 05 Lier
60,Mechelsesteenweg 365,2021-08-05,09:00:00,116,68,48,FMN GV 05 Lier
60,Mechelsesteenweg 365,2021-08-05,10:00:00,188,108,80,FMN GV 05 Lier
60,Mechelsesteenweg 365,2021-08-05,11:00:00,258,124,134,FMN GV 05 Lier
60,Mechelsesteenweg 365,2021-08-05,12:00:00,218,128,90,FMN GV 05 Lier
60,Mechelsesteenweg 365,2021-08-05,13:00:00,196,74,122,FMN GV 05 Lier
60,Mechelsesteenweg 365,2021-08-05,14:00:00,286,174,112,FMN GV 05 Lier
60,Mechelsesteenweg 365,2021-08-05,15:00:00,320,168,152,FMN GV 05 Lier
60,Mechelsesteenweg 365,2021-08-05,16:00:00,236,118,118,FMN GV 05 Lier
60,Mechelsesteenweg 365,2021-08-05,17:00:00,218,122,96,FMN GV 05 Lier
60,Mechelsesteenweg 365,2021-08-05,18:00:00,184,84,100,FMN GV 05 Lier
60,Mechelsesteenweg 365,2021-08-05,19:00:00,124,68,56,FMN GV 05 Lier
60,Mechelsesteenweg 365,2021-08-05,20:00:00,174,94,80,FMN GV 05 Lier
60,Mechelsesteenweg 365,2021-08-05,21:00:00,44,20,24,FMN GV 05 Lier
60,Mechelsesteenweg 365,2021-08-05,22:00:00,10,4,6,FMN GV 05 Lier
60,Mechelsesteenweg 365,2021-08-05,23:00:00,10,8,2,FMN GV 05 Lier
60,Mechelsesteenweg 365,2021-08-06,00:00:00,4,0,4,FMN GV 05 Lier
60,Mechelsesteenweg 365,2021-08-06,01:00:00,0,0,0,FMN GV 05 Lier
60,Mechelsesteenweg 365,2021-08-06,02:00:00,0,0,0,FMN GV 05 Lier
60,Mechelsesteenweg 365,2021-08-06,03:00:00,2,0,2,FMN GV 05 Lier
60,Mechelsesteenweg 365,2021-08-06,04:00:00,2,0,2,FMN GV 05 Lier
60,Mechelsesteenweg 365,2021-08-06,05:00:00,2,0,2,FMN GV 05 Lier
60,Mechelsesteenweg 365,2021-08-06,06:00:00,14,10,4,FMN GV 05 Lier
60,Mechelsesteenweg 365,2021-08-06,07:00:00,42,24,18,FMN GV 05 Lier
60,Mechelsesteenweg 365,2021-08-06,08:00:00,40,22,18,FMN GV 05 Lier
60,Mechelsesteenweg 365,2021-08-06,09:00:00,62,32,30,FMN GV 05 Lier
60,Mechelsesteenweg 365,2021-08-06,10:00:00,124,66,58,FMN GV 05 Lier
60,Mechelsesteenweg 365,2021-08-06,11:00:00,106,54,52,FMN GV 05 Lier
60,Mechelsesteenweg 365,2021-08-06,12:00:00,78,28,50,FMN GV 05 Lier
60,Mechelsesteenweg 365,2021-08-06,13:00:00,82,40,42,FMN GV 05 Lier
60,Mechelsesteenweg 365,2021-08-06,14:00:00,80,30,50,FMN GV 05 Lier
60,Mechelsesteenweg 365,2021-08-06,15:00:00,92,58,34,FMN GV 05 Lier
60,Mechelsesteenweg 365,2021-08-06,16:00:00,86,56,30,FMN GV 05 Lier
60,Mechelsesteenweg 365,2021-08-06,17:00:00,80,38,42,FMN GV 05 Lier
60,Mechelsesteenweg 365,2021-08-06,18:00:00,100,42,58,FMN GV 05 Lier
60,Mechelsesteenweg 365,2021-08-06,19:00:00,54,28,26,FMN GV 05 Lier
60,Mechelsesteenweg 365,2021-08-06,20:00:00,54,20,34,FMN GV 05 Lier
60,Mechelsesteenweg 365,2021-08-06,21:00:00,24,6,18,FMN GV 05 Lier
60,Mechelsesteenweg 365,2021-08-06,22:00:00,6,2,4,FMN GV 05 Lier
60,Mechelsesteenweg 365,2021-08-06,23:00:00,0,0,0,FMN GV 05 Lier
60,Mechelsesteenweg 365,2021-08-07,00:00:00,4,0,4,FMN GV 05 Lier
60,Mechelsesteenweg 365,2021-08-07,01:00:00,6,4,2,FMN GV 05 Lier
60,Mechelsesteenweg 365,2021-08-07,02:00:00,0,0,0,FMN GV 05 Lier
60,Mechelsesteenweg 365,2021-08-07,03:00:00,0,0,0,FMN GV 05 Lier
60,Mechelsesteenweg 365,2021-08-07,04:00:00,0,0,0,FMN GV 05 Lier
60,Mechelsesteenweg 365,2021-08-07,05:00:00,2,0,2,FMN GV 05 Lier
60,Mechelsesteenweg 365,2021-08-07,06:00:00,8,4,4,FMN GV 05 Lier
60,Mechelsesteenweg 365,2021-08-07,07:00:00,14,10,4,FMN GV 05 Lier
60,Mechelsesteenweg 365,2021-08-07,08:00:00,32,8,24,FMN GV 05 Lier
60,Mechelsesteenweg 365,2021-08-07,09:00:00,86,40,46,FMN GV 05 Lier
60,Mechelsesteenweg 365,2021-08-07,10:00:00,198,132,66,FMN GV 05 Lier
60,Mechelsesteenweg 365,2021-08-07,11:00:00,302,144,158,FMN GV 05 Lier
60,Mechelsesteenweg 365,2021-08-07,12:00:00,292,164,128,FMN GV 05 Lier
60,Mechelsesteenweg 365,2021-08-07,13:00:00,140,58,82,FMN GV 05 Lier
60,Mechelsesteenweg 365,2021-08-07,14:00:00,192,96,96,FMN GV 05 Lier
60,Mechelsesteenweg 365,2021-08-07,15:00:00,142,46,96,FMN GV 05 Lier
60,Mechelsesteenweg 365,2021-08-07,16:00:00,122,46,76,FMN GV 05 Lier
60,Mechelsesteenweg 365,2021-08-07,17:00:00,58,30,28,FMN GV 05 Lier
60,Mechelsesteenweg 365,2021-08-07,18:00:00,22,12,10,FMN GV 05 Lier
60,Mechelsesteenweg 365,2021-08-07,19:00:00,30,12,18,FMN GV 05 Lier
60,Mechelsesteenweg 365,2021-08-07,20:00:00,20,6,14,FMN GV 05 Lier
60,Mechelsesteenweg 365,2021-08-07,21:00:00,6,2,4,FMN GV 05 Lier
60,Mechelsesteenweg 365,2021-08-07,22:00:00,4,2,2,FMN GV 05 Lier
60,Mechelsesteenweg 365,2021-08-07,23:00:00,4,2,2,FMN GV 05 Lier
60,Mechelsesteenweg 365,2021-08-08,00:00:00,8,8,0,FMN GV 05 Lier
60,Mechelsesteenweg 365,2021-08-08,01:00:00,14,12,2,FMN GV 05 Lier
60,Mechelsesteenweg 365,2021-08-08,02:00:00,0,0,0,FMN GV 05 Lier
60,Mechelsesteenweg 365,2021-08-08,03:00:00,4,0,4,FMN GV 05 Lier
60,Mechelsesteenweg 365,2021-08-08,04:00:00,0,0,0,FMN GV 05 Lier
60,Mechelsesteenweg 365,2021-08-08,05:00:00,2,0,2,FMN GV 05 Lier
60,Mechelsesteenweg 365,2021-08-08,06:00:00,8,4,4,FMN GV 05 Lier
60,Mechelsesteenweg 365,2021-08-08,07:00:00,10,2,8,FMN GV 05 Lier
60,Mechelsesteenweg 365,2021-08-08,08:00:00,18,8,10,FMN GV 05 Lier
60,Mechelsesteenweg 365,2021-08-08,09:00:00,216,130,86,FMN GV 05 Lier
60,Mechelsesteenweg 365,2021-08-08,10:00:00,324,154,170,FMN GV 05 Lier
60,Mechelsesteenweg 365,2021-08-08,11:00:00,290,144,146,FMN GV 05 Lier
60,Mechelsesteenweg 365,2021-08-08,12:00:00,206,126,80,FMN GV 05 Lier
60,Mechelsesteenweg 365,2021-08-08,13:00:00,128,56,72,FMN GV 05 Lier
60,Mechelsesteenweg 365,2021-08-08,14:00:00,90,30,60,FMN GV 05 Lier
60,Mechelsesteenweg 365,2021-08-08,15:00:00,76,20,56,FMN GV 05 Lier
60,Mechelsesteenweg 365,2021-08-08,16:00:00,48,30,18,FMN GV 05 Lier
60,Mechelsesteenweg 365,2021-08-08,17:00:00,70,22,48,FMN GV 05 Lier
60,Mechelsesteenweg 365,2021-08-08,18:00:00,32,22,10,FMN GV 05 Lier
60,Mechelsesteenweg 365,2021-08-08,19:00:00,22,8,14,FMN GV 05 Lier
60,Mechelsesteenweg 365,2021-08-08,20:00:00,22,16,6,FMN GV 05 Lier
60,Mechelsesteenweg 365,2021-08-08,21:00:00,14,4,10,FMN GV 05 Lier
60,Mechelsesteenweg 365,2021-08-08,22:00:00,12,10,2,FMN GV 05 Lier
60,Mechelsesteenweg 365,2021-08-08,23:00:00,2,0,2,FMN GV 05 Lier
60,Mechelsesteenweg 365,2021-08-09,00:00:00,2,2,0,FMN GV 05 Lier
60,Mechelsesteenweg 365,2021-08-09,01:00:00,0,0,0,FMN GV 05 Lier
60,Mechelsesteenweg 365,2021-08-09,02:00:00,0,0,0,FMN GV 05 Lier
60,Mechelsesteenweg 365,2021-08-09,03:00:00,2,0,2,FMN GV 05 Lier
60,Mechelsesteenweg 365,2021-08-09,04:00:00,0,0,0,FMN GV 05 Lier
60,Mechelsesteenweg 365,2021-08-09,05:00:00,8,0,8,FMN GV 05 Lier
60,Mechelsesteenweg 365,2021-08-09,06:00:00,34,18,16,FMN GV 05 Lier
60,Mechelsesteenweg 365,2021-08-09,07:00:00,46,12,34,FMN GV 05 Lier
60,Mechelsesteenweg 365,2021-08-09,08:00:00,48,22,26,FMN GV 05 Lier
60,Mechelsesteenweg 365,2021-08-09,09:00:00,60,38,22,FMN GV 05 Lier
60,Mechelsesteenweg 365,2021-08-09,10:00:00,78,48,30,FMN GV 05 Lier
60,Mechelsesteenweg 365,2021-08-09,11:00:00,60,38,22,FMN GV 05 Lier
60,Mechelsesteenweg 365,2021-08-09,12:00:00,52,28,24,FMN GV 05 Lier
60,Mechelsesteenweg 365,2021-08-09,13:00:00,60,36,24,FMN GV 05 Lier
60,Mechelsesteenweg 365,2021-08-09,14:00:00,46,16,30,FMN GV 05 Lier
60,Mechelsesteenweg 365,2021-08-09,15:00:00,52,36,16,FMN GV 05 Lier
60,Mechelsesteenweg 365,2021-08-09,16:00:00,138,86,52,FMN GV 05 Lier
60,Mechelsesteenweg 365,2021-08-09,17:00:00,120,86,34,FMN GV 05 Lier
60,Mechelsesteenweg 365,2021-08-09,18:00:00,76,38,38,FMN GV 05 Lier
60,Mechelsesteenweg 365,2021-08-09,19:00:00,90,42,48,FMN GV 05 Lier
60,Mechelsesteenweg 365,2021-08-09,20:00:00,72,26,46,FMN GV 05 Lier
60,Mechelsesteenweg 365,2021-08-09,21:00:00,20,8,12,FMN GV 05 Lier
60,Mechelsesteenweg 365,2021-08-09,22:00:00,8,4,4,FMN GV 05 Lier
60,Mechelsesteenweg 365,2021-08-09,23:00:00,0,0,0,FMN GV 05 Lier
60,Mechelsesteenweg 365,2021-08-10,00:00:00,0,0,0,FMN GV 05 Lier
60,Mechelsesteenweg 365,2021-08-10,01:00:00,0,0,0,FMN GV 05 Lier
60,Mechelsesteenweg 365,2021-08-10,02:00:00,0,0,0,FMN GV 05 Lier
60,Mechelsesteenweg 365,2021-08-10,03:00:00,2,0,2,FMN GV 05 Lier
60,Mechelsesteenweg 365,2021-08-10,04:00:00,0,0,0,FMN GV 05 Lier
60,Mechelsesteenweg 365,2021-08-10,05:00:00,6,0,6,FMN GV 05 Lier
60,Mechelsesteenweg 365,2021-08-10,06:00:00,30,10,20,FMN GV 05 Lier
60,Mechelsesteenweg 365,2021-08-10,07:00:00,50,18,32,FMN GV 05 Lier
60,Mechelsesteenweg 365,2021-08-10,08:00:00,36,16,20,FMN GV 05 Lier
60,Mechelsesteenweg 365,2021-08-10,09:00:00,80,44,36,FMN GV 05 Lier
60,Mechelsesteenweg 365,2021-08-10,10:00:00,150,74,76,FMN GV 05 Lier
60,Mechelsesteenweg 365,2021-08-10,11:00:00,106,64,42,FMN GV 05 Lier
60,Mechelsesteenweg 365,2021-08-10,12:00:00,100,60,40,FMN GV 05 Lier
60,Mechelsesteenweg 365,2021-08-10,13:00:00,264,130,134,FMN GV 05 Lier
60,Mechelsesteenweg 365,2021-08-10,14:00:00,94,36,58,FMN GV 05 Lier
60,Mechelsesteenweg 365,2021-08-10,15:00:00,104,56,48,FMN GV 05 Lier
60,Mechelsesteenweg 365,2021-08-10,16:00:00,144,58,86,FMN GV 05 Lier
60,Mechelsesteenweg 365,2021-08-10,17:00:00,98,66,32,FMN GV 05 Lier
60,Mechelsesteenweg 365,2021-08-10,18:00:00,64,38,26,FMN GV 05 Lier
60,Mechelsesteenweg 365,2021-08-10,19:00:00,106,42,64,FMN GV 05 Lier
60,Mechelsesteenweg 365,2021-08-10,20:00:00,86,54,32,FMN GV 05 Lier
60,Mechelsesteenweg 365,2021-08-10,21:00:00,32,14,18,FMN GV 05 Lier
60,Mechelsesteenweg 365,2021-08-10,22:00:00,8,2,6,FMN GV 05 Lier
60,Mechelsesteenweg 365,2021-08-10,23:00:00,8,4,4,FMN GV 05 Lier
60,Mechelsesteenweg 365,2021-08-11,00:00:00,4,0,4,FMN GV 05 Lier
60,Mechelsesteenweg 365,2021-08-11,01:00:00,0,0,0,FMN GV 05 Lier
60,Mechelsesteenweg 365,2021-08-11,02:00:00,0,0,0,FMN GV 05 Lier
60,Mechelsesteenweg 365,2021-08-11,03:00:00,2,0,2,FMN GV 05 Lier
60,Mechelsesteenweg 365,2021-08-11,04:00:00,2,0,2,FMN GV 05 Lier
60,Mechelsesteenweg 365,2021-08-11,05:00:00,8,6,2,FMN GV 05 Lier
60,Mechelsesteenweg 365,2021-08-11,06:00:00,40,18,22,FMN GV 05 Lier
60,Mechelsesteenweg 365,2021-08-11,07:00:00,86,36,50,FMN GV 05 Lier
60,Mechelsesteenweg 365,2021-08-11,08:00:00,84,34,50,FMN GV 05 Lier
60,Mechelsesteenweg 365,2021-08-11,09:00:00,96,58,38,FMN GV 05 Lier
60,Mechelsesteenweg 365,2021-08-11,10:00:00,234,114,120,FMN GV 05 Lier
60,Mechelsesteenweg 365,2021-08-11,11:00:00,312,180,132,FMN GV 05 Lier
60,Mechelsesteenweg 365,2021-08-11,12:00:00,298,134,164,FMN GV 05 Lier
60,Mechelsesteenweg 365,2021-08-11,13:00:00,352,184,168,FMN GV 05 Lier
60,Mechelsesteenweg 365,2021-08-11,14:00:00,444,214,230,FMN GV 05 Lier
60,Mechelsesteenweg 365,2021-08-11,15:00:00,456,248,208,FMN GV 05 Lier
60,Mechelsesteenweg 365,2021-08-11,16:00:00,400,188,212,FMN GV 05 Lier
60,Mechelsesteenweg 365,2021-08-11,17:00:00,286,148,138,FMN GV 05 Lier
60,Mechelsesteenweg 365,2021-08-11,18:00:00,176,100,76,FMN GV 05 Lier
60,Mechelsesteenweg 365,2021-08-11,19:00:00,170,94,76,FMN GV 05 Lier
60,Mechelsesteenweg 365,2021-08-11,20:00:00,210,126,84,FMN GV 05 Lier
60,Mechelsesteenweg 365,2021-08-11,21:00:00,78,28,50,FMN GV 05 Lier
60,Mechelsesteenweg 365,2021-08-11,22:00:00,14,6,8,FMN GV 05 Lier
60,Mechelsesteenweg 365,2021-08-11,23:00:00,4,0,4,FMN GV 05 Lier
60,Mechelsesteenweg 365,2021-08-12,00:00:00,2,0,2,FMN GV 05 Lier
60,Mechelsesteenweg 365,2021-08-12,01:00:00,10,0,10,FMN GV 05 Lier
60,Mechelsesteenweg 365,2021-08-12,02:00:00,0,0,0,FMN GV 05 Lier
60,Mechelsesteenweg 365,2021-08-12,03:00:00,4,0,4,FMN GV 05 Lier
60,Mechelsesteenweg 365,2021-08-12,04:00:00,2,0,2,FMN GV 05 Lier
60,Mechelsesteenweg 365,2021-08-12,05:00:00,4,0,4,FMN GV 05 Lier
60,Mechelsesteenweg 365,2021-08-12,06:00:00,34,18,16,FMN GV 05 Lier
60,Mechelsesteenweg 365,2021-08-12,07:00:00,92,30,62,FMN GV 05 Lier
60,Mechelsesteenweg 365,2021-08-12,08:00:00,66,26,40,FMN GV 05 Lier
60,Mechelsesteenweg 365,2021-08-12,09:00:00,152,108,44,FMN GV 05 Lier
60,Mechelsesteenweg 365,2021-08-12,10:00:00,266,120,146,FMN GV 05 Lier
60,Mechelsesteenweg 365,2021-08-12,11:00:00,304,152,152,FMN GV 05 Lier
60,Mechelsesteenweg 365,2021-08-12,12:00:00,278,154,124,FMN GV 05 Lier
60,Mechelsesteenweg 365,2021-08-12,13:00:00,438,236,202,FMN GV 05 Lier
60,Mechelsesteenweg 365,2021-08-12,14:00:00,476,268,208,FMN GV 05 Lier
60,Mechelsesteenweg 365,2021-08-12,15:00:00,454,208,246,FMN GV 05 Lier
60,Mechelsesteenweg 365,2021-08-12,16:00:00,358,184,174,FMN GV 05 Lier
60,Mechelsesteenweg 365,2021-08-12,17:00:00,282,146,136,FMN GV 05 Lier
60,Mechelsesteenweg 365,2021-08-12,18:00:00,192,70,122,FMN GV 05 Lier
60,Mechelsesteenweg 365,2021-08-12,19:00:00,132,58,74,FMN GV 05 Lier
60,Mechelsesteenweg 365,2021-08-12,20:00:00,138,100,38,FMN GV 05 Lier
60,Mechelsesteenweg 365,2021-08-12,21:00:00,78,32,46,FMN GV 05 Lier
60,Mechelsesteenweg 365,2021-08-12,22:00:00,28,12,16,FMN GV 05 Lier
60,Mechelsesteenweg 365,2021-08-12,23:00:00,10,0,10,FMN GV 05 Lier
60,Mechelsesteenweg 365,2021-08-13,00:00:00,4,0,4,FMN GV 05 Lier
60,Mechelsesteenweg 365,2021-08-13,01:00:00,6,2,4,FMN GV 05 Lier
60,Mechelsesteenweg 365,2021-08-13,02:00:00,0,0,0,FMN GV 05 Lier
60,Mechelsesteenweg 365,2021-08-13,03:00:00,2,0,2,FMN GV 05 Lier
60,Mechelsesteenweg 365,2021-08-13,04:00:00,0,0,0,FMN GV 05 Lier
60,Mechelsesteenweg 365,2021-08-13,05:00:00,2,0,2,FMN GV 05 Lier
60,Mechelsesteenweg 365,2021-08-13,06:00:00,40,14,26,FMN GV 05 Lier
60,Mechelsesteenweg 365,2021-08-13,07:00:00,72,16,56,FMN GV 05 Lier
60,Mechelsesteenweg 365,2021-08-13,08:00:00,88,34,54,FMN GV 05 Lier
60,Mechelsesteenweg 365,2021-08-13,09:00:00,98,58,40,FMN GV 05 Lier
60,Mechelsesteenweg 365,2021-08-13,10:00:00,172,74,98,FMN GV 05 Lier
60,Mechelsesteenweg 365,2021-08-13,11:00:00,288,154,134,FMN GV 05 Lier
60,Mechelsesteenweg 365,2021-08-13,12:00:00,238,138,100,FMN GV 05 Lier
60,Mechelsesteenweg 365,2021-08-13,13:00:00,324,126,198,FMN GV 05 Lier
60,Mechelsesteenweg 365,2021-08-13,14:00:00,358,170,188,FMN GV 05 Lier
60,Mechelsesteenweg 365,2021-08-13,15:00:00,366,170,196,FMN GV 05 Lier
60,Mechelsesteenweg 365,2021-08-13,16:00:00,344,164,180,FMN GV 05 Lier
60,Mechelsesteenweg 365,2021-08-13,17:00:00,210,140,70,FMN GV 05 Lier
60,Mechelsesteenweg 365,2021-08-13,18:00:00,112,62,50,FMN GV 05 Lier
60,Mechelsesteenweg 365,2021-08-13,19:00:00,108,36,72,FMN GV 05 Lier
60,Mechelsesteenweg 365,2021-08-13,20:00:00,84,36,48,FMN GV 05 Lier
60,Mechelsesteenweg 365,2021-08-13,21:00:00,52,20,32,FMN GV 05 Lier
60,Mechelsesteenweg 365,2021-08-13,22:00:00,10,4,6,FMN GV 05 Lier
60,Mechelsesteenweg 365,2021-08-13,23:00:00,10,4,6,FMN GV 05 Lier
60,Mechelsesteenweg 365,2021-08-14,00:00:00,2,0,2,FMN GV 05 Lier
60,Mechelsesteenweg 365,2021-08-14,01:00:00,4,4,0,FMN GV 05 Lier
60,Mechelsesteenweg 365,2021-08-14,02:00:00,0,0,0,FMN GV 05 Lier
60,Mechelsesteenweg 365,2021-08-14,03:00:00,0,0,0,FMN GV 05 Lier
60,Mechelsesteenweg 365,2021-08-14,04:00:00,0,0,0,FMN GV 05 Lier
60,Mechelsesteenweg 365,2021-08-14,05:00:00,2,0,2,FMN GV 05 Lier
60,Mechelsesteenweg 365,2021-08-14,06:00:00,12,10,2,FMN GV 05 Lier
60,Mechelsesteenweg 365,2021-08-14,07:00:00,22,10,12,FMN GV 05 Lier
60,Mechelsesteenweg 365,2021-08-14,08:00:00,64,42,22,FMN GV 05 Lier
60,Mechelsesteenweg 365,2021-08-14,09:00:00,140,88,52,FMN GV 05 Lier
60,Mechelsesteenweg 365,2021-08-14,10:00:00,258,138,120,FMN GV 05 Lier
60,Mechelsesteenweg 365,2021-08-14,11:00:00,364,198,166,FMN GV 05 Lier
60,Mechelsesteenweg 365,2021-08-14,12:00:00,334,142,192,FMN GV 05 Lier
60,Mechelsesteenweg 365,2021-08-14,13:00:00,296,158,138,FMN GV 05 Lier
60,Mechelsesteenweg 365,2021-08-14,14:00:00,310,128,182,FMN GV 05 Lier
60,Mechelsesteenweg 365,2021-08-14,15:00:00,112,56,56,FMN GV 05 Lier
60,Mechelsesteenweg 365,2021-08-14,16:00:00,248,110,138,FMN GV 05 Lier
60,Mechelsesteenweg 365,2021-08-14,17:00:00,272,114,158,FMN GV 05 Lier
60,Mechelsesteenweg 365,2021-08-14,18:00:00,134,50,84,FMN GV 05 Lier
60,Mechelsesteenweg 365,2021-08-14,19:00:00,116,38,78,FMN GV 05 Lier
60,Mechelsesteenweg 365,2021-08-14,20:00:00,80,34,46,FMN GV 05 Lier
60,Mechelsesteenweg 365,2021-08-14,21:00:00,56,22,34,FMN GV 05 Lier
60,Mechelsesteenweg 365,2021-08-14,22:00:00,22,6,16,FMN GV 05 Lier
60,Mechelsesteenweg 365,2021-08-14,23:00:00,14,4,10,FMN GV 05 Lier
60,Mechelsesteenweg 365,2021-08-15,00:00:00,8,0,8,FMN GV 05 Lier
60,Mechelsesteenweg 365,2021-08-15,01:00:00,0,0,0,FMN GV 05 Lier
60,Mechelsesteenweg 365,2021-08-15,02:00:00,0,0,0,FMN GV 05 Lier
60,Mechelsesteenweg 365,2021-08-15,03:00:00,0,0,0,FMN GV 05 Lier
60,Mechelsesteenweg 365,2021-08-15,04:00:00,0,0,0,FMN GV 05 Lier
60,Mechelsesteenweg 365,2021-08-15,05:00:00,2,0,2,FMN GV 05 Lier
60,Mechelsesteenweg 365,2021-08-15,06:00:00,8,8,0,FMN GV 05 Lier
60,Mechelsesteenweg 365,2021-08-15,07:00:00,16,6,10,FMN GV 05 Lier
60,Mechelsesteenweg 365,2021-08-15,08:00:00,46,28,18,FMN GV 05 Lier
60,Mechelsesteenweg 365,2021-08-15,09:00:00,228,114,114,FMN GV 05 Lier
60,Mechelsesteenweg 365,2021-08-15,10:00:00,478,258,220,FMN GV 05 Lier
60,Mechelsesteenweg 365,2021-08-15,11:00:00,510,268,242,FMN GV 05 Lier
60,Mechelsesteenweg 365,2021-08-15,12:00:00,358,186,172,FMN GV 05 Lier
60,Mechelsesteenweg 365,2021-08-15,13:00:00,384,208,176,FMN GV 05 Lier
60,Mechelsesteenweg 365,2021-08-15,14:00:00,142,70,72,FMN GV 05 Lier
60,Mechelsesteenweg 365,2021-08-15,15:00:00,362,170,192,FMN GV 05 Lier
60,Mechelsesteenweg 365,2021-08-15,16:00:00,432,194,238,FMN GV 05 Lier
60,Mechelsesteenweg 365,2021-08-15,17:00:00,274,102,172,FMN GV 05 Lier
60,Mechelsesteenweg 365,2021-08-15,18:00:00,170,82,88,FMN GV 05 Lier
60,Mechelsesteenweg 365,2021-08-15,19:00:00,88,32,56,FMN GV 05 Lier
60,Mechelsesteenweg 365,2021-08-15,20:00:00,58,38,20,FMN GV 05 Lier
60,Mechelsesteenweg 365,2021-08-15,21:00:00,46,18,28,FMN GV 05 Lier
60,Mechelsesteenweg 365,2021-08-15,22:00:00,18,2,16,FMN GV 05 Lier
60,Mechelsesteenweg 365,2021-08-15,23:00:00,6,2,4,FMN GV 05 Lier
60,Mechelsesteenweg 365,2021-08-16,00:00:00,0,0,0,FMN GV 05 Lier
60,Mechelsesteenweg 365,2021-08-16,01:00:00,0,0,0,FMN GV 05 Lier
60,Mechelsesteenweg 365,2021-08-16,02:00:00,0,0,0,FMN GV 05 Lier
60,Mechelsesteenweg 365,2021-08-16,03:00:00,2,0,2,FMN GV 05 Lier
60,Mechelsesteenweg 365,2021-08-16,04:00:00,0,0,0,FMN GV 05 Lier
60,Mechelsesteenweg 365,2021-08-16,05:00:00,2,0,2,FMN GV 05 Lier
60,Mechelsesteenweg 365,2021-08-16,06:00:00,18,10,8,FMN GV 05 Lier
60,Mechelsesteenweg 365,2021-08-16,07:00:00,52,24,28,FMN GV 05 Lier
60,Mechelsesteenweg 365,2021-08-16,08:00:00,34,16,18,FMN GV 05 Lier
60,Mechelsesteenweg 365,2021-08-16,09:00:00,44,18,26,FMN GV 05 Lier
60,Mechelsesteenweg 365,2021-08-16,10:00:00,24,14,10,FMN GV 05 Lier
60,Mechelsesteenweg 365,2021-08-16,11:00:00,40,16,24,FMN GV 05 Lier
60,Mechelsesteenweg 365,2021-08-16,12:00:00,62,34,28,FMN GV 05 Lier
60,Mechelsesteenweg 365,2021-08-16,13:00:00,94,52,42,FMN GV 05 Lier
60,Mechelsesteenweg 365,2021-08-16,14:00:00,70,30,40,FMN GV 05 Lier
60,Mechelsesteenweg 365,2021-08-16,15:00:00,48,30,18,FMN GV 05 Lier
60,Mechelsesteenweg 365,2021-08-16,16:00:00,36,28,8,FMN GV 05 Lier
60,Mechelsesteenweg 365,2021-08-16,17:00:00,62,50,12,FMN GV 05 Lier
60,Mechelsesteenweg 365,2021-08-16,18:00:00,28,10,18,FMN GV 05 Lier
60,Mechelsesteenweg 365,2021-08-16,19:00:00,46,26,20,FMN GV 05 Lier
60,Mechelsesteenweg 365,2021-08-16,20:00:00,44,18,26,FMN GV 05 Lier
60,Mechelsesteenweg 365,2021-08-16,21:00:00,14,4,10,FMN GV 05 Lier
60,Mechelsesteenweg 365,2021-08-16,22:00:00,8,4,4,FMN GV 05 Lier
60,Mechelsesteenweg 365,2021-08-16,23:00:00,2,0,2,FMN GV 05 Lier
60,Mechelsesteenweg 365,2021-08-17,00:00:00,0,0,0,FMN GV 05 Lier
60,Mechelsesteenweg 365,2021-08-17,01:00:00,2,0,2,FMN GV 05 Lier
60,Mechelsesteenweg 365,2021-08-17,02:00:00,0,0,0,FMN GV 05 Lier
60,Mechelsesteenweg 365,2021-08-17,03:00:00,2,0,2,FMN GV 05 Lier
60,Mechelsesteenweg 365,2021-08-17,04:00:00,2,0,2,FMN GV 05 Lier
60,Mechelsesteenweg 365,2021-08-17,05:00:00,4,0,4,FMN GV 05 Lier
60,Mechelsesteenweg 365,2021-08-17,06:00:00,38,12,26,FMN GV 05 Lier
60,Mechelsesteenweg 365,2021-08-17,07:00:00,64,16,48,FMN GV 05 Lier
60,Mechelsesteenweg 365,2021-08-17,08:00:00,56,22,34,FMN GV 05 Lier
60,Mechelsesteenweg 365,2021-08-17,09:00:00,90,36,54,FMN GV 05 Lier
60,Mechelsesteenweg 365,2021-08-17,10:00:00,124,74,50,FMN GV 05 Lier
60,Mechelsesteenweg 365,2021-08-17,11:00:00,134,72,62,FMN GV 05 Lier
60,Mechelsesteenweg 365,2021-08-17,12:00:00,74,42,32,FMN GV 05 Lier
60,Mechelsesteenweg 365,2021-08-17,13:00:00,42,14,28,FMN GV 05 Lier
60,Mechelsesteenweg 365,2021-08-17,14:00:00,42,20,22,FMN GV 05 Lier
60,Mechelsesteenweg 365,2021-08-17,15:00:00,30,18,12,FMN GV 05 Lier
60,Mechelsesteenweg 365,2021-08-17,16:00:00,58,38,20,FMN GV 05 Lier
60,Mechelsesteenweg 365,2021-08-17,17:00:00,60,40,20,FMN GV 05 Lier
60,Mechelsesteenweg 365,2021-08-17,18:00:00,30,20,10,FMN GV 05 Lier
60,Mechelsesteenweg 365,2021-08-17,19:00:00,14,6,8,FMN GV 05 Lier
60,Mechelsesteenweg 365,2021-08-17,20:00:00,36,14,22,FMN GV 05 Lier
60,Mechelsesteenweg 365,2021-08-17,21:00:00,16,2,14,FMN GV 05 Lier
60,Mechelsesteenweg 365,2021-08-17,22:00:00,14,12,2,FMN GV 05 Lier
60,Mechelsesteenweg 365,2021-08-17,23:00:00,2,0,2,FMN GV 05 Lier
60,Mechelsesteenweg 365,2021-08-18,00:00:00,0,0,0,FMN GV 05 Lier
60,Mechelsesteenweg 365,2021-08-18,01:00:00,2,2,0,FMN GV 05 Lier
60,Mechelsesteenweg 365,2021-08-18,02:00:00,0,0,0,FMN GV 05 Lier
60,Mechelsesteenweg 365,2021-08-18,03:00:00,2,0,2,FMN GV 05 Lier
60,Mechelsesteenweg 365,2021-08-18,04:00:00,2,0,2,FMN GV 05 Lier
60,Mechelsesteenweg 365,2021-08-18,05:00:00,4,0,4,FMN GV 05 Lier
60,Mechelsesteenweg 365,2021-08-18,06:00:00,22,10,12,FMN GV 05 Lier
60,Mechelsesteenweg 365,2021-08-18,07:00:00,54,18,36,FMN GV 05 Lier
60,Mechelsesteenweg 365,2021-08-18,08:00:00,50,22,28,FMN GV 05 Lier
60,Mechelsesteenweg 365,2021-08-18,09:00:00,44,26,18,FMN GV 05 Lier
60,Mechelsesteenweg 365,2021-08-18,10:00:00,74,48,26,FMN GV 05 Lier
60,Mechelsesteenweg 365,2021-08-18,11:00:00,112,58,54,FMN GV 05 Lier
60,Mechelsesteenweg 365,2021-08-18,12:00:00,72,40,32,FMN GV 05 Lier
60,Mechelsesteenweg 365,2021-08-18,13:00:00,174,92,82,FMN GV 05 Lier
60,Mechelsesteenweg 365,2021-08-18,14:00:00,172,88,84,FMN GV 05 Lier
60,Mechelsesteenweg 365,2021-08-18,15:00:00,152,62,90,FMN GV 05 Lier
60,Mechelsesteenweg 365,2021-08-18,16:00:00,156,76,80,FMN GV 05 Lier
60,Mechelsesteenweg 365,2021-08-18,17:00:00,102,68,34,FMN GV 05 Lier
60,Mechelsesteenweg 365,2021-08-18,18:00:00,74,38,36,FMN GV 05 Lier
60,Mechelsesteenweg 365,2021-08-18,19:00:00,132,82,50,FMN GV 05 Lier
60,Mechelsesteenweg 365,2021-08-18,20:00:00,162,100,62,FMN GV 05 Lier
60,Mechelsesteenweg 365,2021-08-18,21:00:00,14,2,12,FMN GV 05 Lier
60,Mechelsesteenweg 365,2021-08-18,22:00:00,12,4,8,FMN GV 05 Lier
60,Mechelsesteenweg 365,2021-08-18,23:00:00,10,2,8,FMN GV 05 Lier
60,Mechelsesteenweg 365,2021-08-19,00:00:00,2,0,2,FMN GV 05 Lier
60,Mechelsesteenweg 365,2021-08-19,01:00:00,0,0,0,FMN GV 05 Lier
60,Mechelsesteenweg 365,2021-08-19,02:00:00,2,0,2,FMN GV 05 Lier
60,Mechelsesteenweg 365,2021-08-19,03:00:00,2,0,2,FMN GV 05 Lier
60,Mechelsesteenweg 365,2021-08-19,04:00:00,2,0,2,FMN GV 05 Lier
60,Mechelsesteenweg 365,2021-08-19,05:00:00,2,0,2,FMN GV 05 Lier
60,Mechelsesteenweg 365,2021-08-19,06:00:00,30,12,18,FMN GV 05 Lier
60,Mechelsesteenweg 365,2021-08-19,07:00:00,64,18,46,FMN GV 05 Lier
60,Mechelsesteenweg 365,2021-08-19,08:00:00,64,16,48,FMN GV 05 Lier
60,Mechelsesteenweg 365,2021-08-19,09:00:00,70,54,16,FMN GV 05 Lier
60,Mechelsesteenweg 365,2021-08-19,10:00:00,88,46,42,FMN GV 05 Lier
60,Mechelsesteenweg 365,2021-08-19,11:00:00,98,44,54,FMN GV 05 Lier
60,Mechelsesteenweg 365,2021-08-19,12:00:00,100,64,36,FMN GV 05 Lier
60,Mechelsesteenweg 365,2021-08-19,13:00:00,128,48,80,FMN GV 05 Lier
60,Mechelsesteenweg 365,2021-08-19,14:00:00,244,138,106,FMN GV 05 Lier
60,Mechelsesteenweg 365,2021-08-19,15:00:00,148,92,56,FMN GV 05 Lier
60,Mechelsesteenweg 365,2021-08-19,16:00:00,154,92,62,FMN GV 05 Lier
60,Mechelsesteenweg 365,2021-08-19,17:00:00,124,64,60,FMN GV 05 Lier
60,Mechelsesteenweg 365,2021-08-19,18:00:00,94,48,46,FMN GV 05 Lier
60,Mechelsesteenweg 365,2021-08-19,19:00:00,132,72,60,FMN GV 05 Lier
60,Mechelsesteenweg 365,2021-08-19,20:00:00,110,40,70,FMN GV 05 Lier
60,Mechelsesteenweg 365,2021-08-19,21:00:00,18,6,12,FMN GV 05 Lier
60,Mechelsesteenweg 365,2021-08-19,22:00:00,10,8,2,FMN GV 05 Lier
60,Mechelsesteenweg 365,2021-08-19,23:00:00,4,2,2,FMN GV 05 Lier
60,Mechelsesteenweg 365,2021-08-20,00:00:00,0,0,0,FMN GV 05 Lier
60,Mechelsesteenweg 365,2021-08-20,01:00:00,2,0,2,FMN GV 05 Lier
60,Mechelsesteenweg 365,2021-08-20,02:00:00,0,0,0,FMN GV 05 Lier
60,Mechelsesteenweg 365,2021-08-20,03:00:00,2,0,2,FMN GV 05 Lier
60,Mechelsesteenweg 365,2021-08-20,04:00:00,2,0,2,FMN GV 05 Lier
60,Mechelsesteenweg 365,2021-08-20,05:00:00,8,2,6,FMN GV 05 Lier
60,Mechelsesteenweg 365,2021-08-20,06:00:00,28,14,14,FMN GV 05 Lier
60,Mechelsesteenweg 365,2021-08-20,07:00:00,60,24,36,FMN GV 05 Lier
60,Mechelsesteenweg 365,2021-08-20,08:00:00,52,24,28,FMN GV 05 Lier
60,Mechelsesteenweg 365,2021-08-20,09:00:00,42,20,22,FMN GV 05 Lier
60,Mechelsesteenweg 365,2021-08-20,10:00:00,78,38,40,FMN GV 05 Lier
60,Mechelsesteenweg 365,2021-08-20,11:00:00,140,78,62,FMN GV 05 Lier
60,Mechelsesteenweg 365,2021-08-20,12:00:00,114,54,60,FMN GV 05 Lier
60,Mechelsesteenweg 365,2021-08-20,13:00:00,178,98,80,FMN GV 05 Lier
60,Mechelsesteenweg 365,2021-08-20,14:00:00,194,104,90,FMN GV 05 Lier
60,Mechelsesteenweg 365,2021-08-20,15:00:00,264,168,96,FMN GV 05 Lier
60,Mechelsesteenweg 365,2021-08-20,16:00:00,232,104,128,FMN GV 05 Lier
60,Mechelsesteenweg 365,2021-08-20,17:00:00,212,126,86,FMN GV 05 Lier
60,Mechelsesteenweg 365,2021-08-20,18:00:00,76,46,30,FMN GV 05 Lier
60,Mechelsesteenweg 365,2021-08-20,19:00:00,110,66,44,FMN GV 05 Lier
60,Mechelsesteenweg 365,2021-08-20,20:00:00,64,24,40,FMN GV 05 Lier
60,Mechelsesteenweg 365,2021-08-20,21:00:00,26,14,12,FMN GV 05 Lier
60,Mechelsesteenweg 365,2021-08-20,22:00:00,8,2,6,FMN GV 05 Lier
60,Mechelsesteenweg 365,2021-08-20,23:00:00,8,0,8,FMN GV 05 Lier
60,Mechelsesteenweg 365,2021-08-21,00:00:00,2,0,2,FMN GV 05 Lier
60,Mechelsesteenweg 365,2021-08-21,01:00:00,0,0,0,FMN GV 05 Lier
60,Mechelsesteenweg 365,2021-08-21,02:00:00,2,0,2,FMN GV 05 Lier
60,Mechelsesteenweg 365,2021-08-21,03:00:00,0,0,0,FMN GV 05 Lier
60,Mechelsesteenweg 365,2021-08-21,04:00:00,0,0,0,FMN GV 05 Lier
60,Mechelsesteenweg 365,2021-08-21,05:00:00,4,0,4,FMN GV 05 Lier
60,Mechelsesteenweg 365,2021-08-21,06:00:00,8,6,2,FMN GV 05 Lier
60,Mechelsesteenweg 365,2021-08-21,07:00:00,34,16,18,FMN GV 05 Lier
60,Mechelsesteenweg 365,2021-08-21,08:00:00,58,18,40,FMN GV 05 Lier
60,Mechelsesteenweg 365,2021-08-21,09:00:00,204,104,100,FMN GV 05 Lier
60,Mechelsesteenweg 365,2021-08-21,10:00:00,352,204,148,FMN GV 05 Lier
60,Mechelsesteenweg 365,2021-08-21,11:00:00,508,254,254,FMN GV 05 Lier
60,Mechelsesteenweg 365,2021-08-21,12:00:00,448,210,238,FMN GV 05 Lier
60,Mechelsesteenweg 365,2021-08-21,13:00:00,542,300,242,FMN GV 05 Lier
60,Mechelsesteenweg 365,2021-08-21,14:00:00,758,350,408,FMN GV 05 Lier
60,Mechelsesteenweg 365,2021-08-21,15:00:00,584,304,280,FMN GV 05 Lier
60,Mechelsesteenweg 365,2021-08-21,16:00:00,528,210,318,FMN GV 05 Lier
60,Mechelsesteenweg 365,2021-08-21,17:00:00,274,92,182,FMN GV 05 Lier
60,Mechelsesteenweg 365,2021-08-21,18:00:00,130,64,66,FMN GV 05 Lier
60,Mechelsesteenweg 365,2021-08-21,19:00:00,82,34,48,FMN GV 05 Lier
60,Mechelsesteenweg 365,2021-08-21,20:00:00,28,12,16,FMN GV 05 Lier
60,Mechelsesteenweg 365,2021-08-21,21:00:00,6,0,6,FMN GV 05 Lier
60,Mechelsesteenweg 365,2021-08-21,22:00:00,0,0,0,FMN GV 05 Lier
60,Mechelsesteenweg 365,2021-08-21,23:00:00,10,2,8,FMN GV 05 Lier
60,Mechelsesteenweg 365,2021-08-22,00:00:00,8,0,8,FMN GV 05 Lier
60,Mechelsesteenweg 365,2021-08-22,01:00:00,2,2,0,FMN GV 05 Lier
60,Mechelsesteenweg 365,2021-08-22,02:00:00,4,2,2,FMN GV 05 Lier
60,Mechelsesteenweg 365,2021-08-22,03:00:00,0,0,0,FMN GV 05 Lier
60,Mechelsesteenweg 365,2021-08-22,04:00:00,0,0,0,FMN GV 05 Lier
60,Mechelsesteenweg 365,2021-08-22,05:00:00,2,0,2,FMN GV 05 Lier
60,Mechelsesteenweg 365,2021-08-22,06:00:00,4,4,0,FMN GV 05 Lier
60,Mechelsesteenweg 365,2021-08-22,07:00:00,4,4,0,FMN GV 05 Lier
60,Mechelsesteenweg 365,2021-08-22,08:00:00,12,12,0,FMN GV 05 Lier
60,Mechelsesteenweg 365,2021-08-22,09:00:00,134,92,42,FMN GV 05 Lier
60,Mechelsesteenweg 365,2021-08-22,10:00:00,138,88,50,FMN GV 05 Lier
60,Mechelsesteenweg 365,2021-08-22,11:00:00,200,98,102,FMN GV 05 Lier
60,Mechelsesteenweg 365,2021-08-22,12:00:00,162,114,48,FMN GV 05 Lier
60,Mechelsesteenweg 365,2021-08-22,13:00:00,108,64,44,FMN GV 05 Lier
60,Mechelsesteenweg 365,2021-08-22,14:00:00,56,36,20,FMN GV 05 Lier
60,Mechelsesteenweg 365,2021-08-22,15:00:00,62,18,44,FMN GV 05 Lier
60,Mechelsesteenweg 365,2021-08-22,16:00:00,30,18,12,FMN GV 05 Lier
60,Mechelsesteenweg 365,2021-08-22,17:00:00,48,16,32,FMN GV 05 Lier
60,Mechelsesteenweg 365,2021-08-22,18:00:00,26,16,10,FMN GV 05 Lier
60,Mechelsesteenweg 365,2021-08-22,19:00:00,14,4,10,FMN GV 05 Lier
60,Mechelsesteenweg 365,2021-08-22,20:00:00,28,12,16,FMN GV 05 Lier
60,Mechelsesteenweg 365,2021-08-22,21:00:00,8,4,4,FMN GV 05 Lier
60,Mechelsesteenweg 365,2021-08-22,22:00:00,0,0,0,FMN GV 05 Lier
60,Mechelsesteenweg 365,2021-08-22,23:00:00,8,2,6,FMN GV 05 Lier
60,Mechelsesteenweg 365,2021-08-23,00:00:00,0,0,0,FMN GV 05 Lier
60,Mechelsesteenweg 365,2021-08-23,01:00:00,0,0,0,FMN GV 05 Lier
60,Mechelsesteenweg 365,2021-08-23,02:00:00,0,0,0,FMN GV 05 Lier
60,Mechelsesteenweg 365,2021-08-23,03:00:00,2,0,2,FMN GV 05 Lier
60,Mechelsesteenweg 365,2021-08-23,04:00:00,2,0,2,FMN GV 05 Lier
60,Mechelsesteenweg 365,2021-08-23,05:00:00,8,0,8,FMN GV 05 Lier
60,Mechelsesteenweg 365,2021-08-23,06:00:00,24,10,14,FMN GV 05 Lier
60,Mechelsesteenweg 365,2021-08-23,07:00:00,50,18,32,FMN GV 05 Lier
60,Mechelsesteenweg 365,2021-08-23,08:00:00,72,30,42,FMN GV 05 Lier
60,Mechelsesteenweg 365,2021-08-23,09:00:00,26,14,12,FMN GV 05 Lier
60,Mechelsesteenweg 365,2021-08-23,10:00:00,68,22,46,FMN GV 05 Lier
60,Mechelsesteenweg 365,2021-08-23,11:00:00,80,56,24,FMN GV 05 Lier
60,Mechelsesteenweg 365,2021-08-23,12:00:00,68,28,40,FMN GV 05 Lier
60,Mechelsesteenweg 365,2021-08-23,13:00:00,104,58,46,FMN GV 05 Lier
60,Mechelsesteenweg 365,2021-08-23,14:00:00,128,78,50,FMN GV 05 Lier
60,Mechelsesteenweg 365,2021-08-23,15:00:00,184,96,88,FMN GV 05 Lier
60,Mechelsesteenweg 365,2021-08-23,16:00:00,144,94,50,FMN GV 05 Lier
60,Mechelsesteenweg 365,2021-08-23,17:00:00,164,76,88,FMN GV 05 Lier
60,Mechelsesteenweg 365,2021-08-23,18:00:00,90,48,42,FMN GV 05 Lier
60,Mechelsesteenweg 365,2021-08-23,19:00:00,102,32,70,FMN GV 05 Lier
60,Mechelsesteenweg 365,2021-08-23,20:00:00,60,22,38,FMN GV 05 Lier
60,Mechelsesteenweg 365,2021-08-23,21:00:00,12,6,6,FMN GV 05 Lier
60,Mechelsesteenweg 365,2021-08-23,22:00:00,0,0,0,FMN GV 05 Lier
60,Mechelsesteenweg 365,2021-08-23,23:00:00,2,2,0,FMN GV 05 Lier
60,Mechelsesteenweg 365,2021-08-24,00:00:00,2,2,0,FMN GV 05 Lier
60,Mechelsesteenweg 365,2021-08-24,01:00:00,4,4,0,FMN GV 05 Lier
60,Mechelsesteenweg 365,2021-08-24,02:00:00,0,0,0,FMN GV 05 Lier
60,Mechelsesteenweg 365,2021-08-24,03:00:00,2,0,2,FMN GV 05 Lier
60,Mechelsesteenweg 365,2021-08-24,04:00:00,2,0,2,FMN GV 05 Lier
60,Mechelsesteenweg 365,2021-08-24,05:00:00,10,0,10,FMN GV 05 Lier
60,Mechelsesteenweg 365,2021-08-24,06:00:00,42,16,26,FMN GV 05 Lier
60,Mechelsesteenweg 365,2021-08-24,07:00:00,100,38,62,FMN GV 05 Lier
60,Mechelsesteenweg 365,2021-08-24,08:00:00,84,30,54,FMN GV 05 Lier
60,Mechelsesteenweg 365,2021-08-24,09:00:00,148,78,70,FMN GV 05 Lier
60,Mechelsesteenweg 365,2021-08-24,10:00:00,294,140,154,FMN GV 05 Lier
60,Mechelsesteenweg 365,2021-08-24,11:00:00,200,110,90,FMN GV 05 Lier
60,Mechelsesteenweg 365,2021-08-24,12:00:00,200,120,80,FMN GV 05 Lier
60,Mechelsesteenweg 365,2021-08-24,13:00:00,330,134,196,FMN GV 05 Lier
60,Mechelsesteenweg 365,2021-08-24,14:00:00,352,192,160,FMN GV 05 Lier
60,Mechelsesteenweg 365,2021-08-24,15:00:00,350,142,208,FMN GV 05 Lier
60,Mechelsesteenweg 365,2021-08-24,16:00:00,318,158,160,FMN GV 05 Lier
60,Mechelsesteenweg 365,2021-08-24,17:00:00,206,100,106,FMN GV 05 Lier
60,Mechelsesteenweg 365,2021-08-24,18:00:00,224,96,128,FMN GV 05 Lier
60,Mechelsesteenweg 365,2021-08-24,19:00:00,182,102,80,FMN GV 05 Lier
60,Mechelsesteenweg 365,2021-08-24,20:00:00,106,54,52,FMN GV 05 Lier
60,Mechelsesteenweg 365,2021-08-24,21:00:00,20,8,12,FMN GV 05 Lier
60,Mechelsesteenweg 365,2021-08-24,22:00:00,6,2,4,FMN GV 05 Lier
60,Mechelsesteenweg 365,2021-08-24,23:00:00,8,2,6,FMN GV 05 Lier
60,Mechelsesteenweg 365,2021-08-25,00:00:00,0,0,0,FMN GV 05 Lier
60,Mechelsesteenweg 365,2021-08-25,01:00:00,4,4,0,FMN GV 05 Lier
60,Mechelsesteenweg 365,2021-08-25,02:00:00,2,2,0,FMN GV 05 Lier
60,Mechelsesteenweg 365,2021-08-25,03:00:00,2,0,2,FMN GV 05 Lier
60,Mechelsesteenweg 365,2021-08-25,04:00:00,2,0,2,FMN GV 05 Lier
60,Mechelsesteenweg 365,2021-08-25,05:00:00,6,0,6,FMN GV 05 Lier
60,Mechelsesteenweg 365,2021-08-25,06:00:00,44,10,34,FMN GV 05 Lier
60,Mechelsesteenweg 365,2021-08-25,07:00:00,94,28,66,FMN GV 05 Lier
60,Mechelsesteenweg 365,2021-08-25,08:00:00,88,40,48,FMN GV 05 Lier
60,Mechelsesteenweg 365,2021-08-25,09:00:00,124,64,60,FMN GV 05 Lier
60,Mechelsesteenweg 365,2021-08-25,10:00:00,180,96,84,FMN GV 05 Lier
60,Mechelsesteenweg 365,2021-08-25,11:00:00,284,168,116,FMN GV 05 Lier
60,Mechelsesteenweg 365,2021-08-25,12:00:00,260,140,120,FMN GV 05 Lier
60,Mechelsesteenweg 365,2021-08-25,13:00:00,326,176,150,FMN GV 05 Lier
60,Mechelsesteenweg 365,2021-08-25,14:00:00,476,246,230,FMN GV 05 Lier
60,Mechelsesteenweg 365,2021-08-25,15:00:00,508,258,250,FMN GV 05 Lier
60,Mechelsesteenweg 365,2021-08-25,16:00:00,440,192,248,FMN GV 05 Lier
60,Mechelsesteenweg 365,2021-08-25,17:00:00,334,192,142,FMN GV 05 Lier
60,Mechelsesteenweg 365,2021-08-25,18:00:00,256,114,142,FMN GV 05 Lier
60,Mechelsesteenweg 365,2021-08-25,19:00:00,180,72,108,FMN GV 05 Lier
60,Mechelsesteenweg 365,2021-08-25,20:00:00,210,142,68,FMN GV 05 Lier
60,Mechelsesteenweg 365,2021-08-25,21:00:00,36,12,24,FMN GV 05 Lier
60,Mechelsesteenweg 365,2021-08-25,22:00:00,2,2,0,FMN GV 05 Lier
60,Mechelsesteenweg 365,2021-08-25,23:00:00,4,2,2,FMN GV 05 Lier
60,Mechelsesteenweg 365,2021-08-26,00:00:00,8,2,6,FMN GV 05 Lier
60,Mechelsesteenweg 365,2021-08-26,01:00:00,0,0,0,FMN GV 05 Lier
60,Mechelsesteenweg 365,2021-08-26,02:00:00,0,0,0,FMN GV 05 Lier
60,Mechelsesteenweg 365,2021-08-26,03:00:00,2,0,2,FMN GV 05 Lier
60,Mechelsesteenweg 365,2021-08-26,04:00:00,2,0,2,FMN GV 05 Lier
60,Mechelsesteenweg 365,2021-08-26,05:00:00,10,0,10,FMN GV 05 Lier
60,Mechelsesteenweg 365,2021-08-26,06:00:00,28,8,20,FMN GV 05 Lier
60,Mechelsesteenweg 365,2021-08-26,07:00:00,66,18,48,FMN GV 05 Lier
60,Mechelsesteenweg 365,2021-08-26,08:00:00,74,26,48,FMN GV 05 Lier
60,Mechelsesteenweg 365,2021-08-26,09:00:00,90,56,34,FMN GV 05 Lier
60,Mechelsesteenweg 365,2021-08-26,10:00:00,94,48,46,FMN GV 05 Lier
60,Mechelsesteenweg 365,2021-08-26,11:00:00,136,94,42,FMN GV 05 Lier
60,Mechelsesteenweg 365,2021-08-26,12:00:00,84,46,38,FMN GV 05 Lier
60,Mechelsesteenweg 365,2021-08-26,13:00:00,100,46,54,FMN GV 05 Lier
60,Mechelsesteenweg 365,2021-08-26,14:00:00,114,50,64,FMN GV 05 Lier
60,Mechelsesteenweg 365,2021-08-26,15:00:00,132,96,36,FMN GV 05 Lier
60,Mechelsesteenweg 365,2021-08-26,16:00:00,174,94,80,FMN GV 05 Lier
60,Mechelsesteenweg 365,2021-08-26,17:00:00,100,56,44,FMN GV 05 Lier
60,Mechelsesteenweg 365,2021-08-26,18:00:00,92,52,40,FMN GV 05 Lier
60,Mechelsesteenweg 365,2021-08-26,19:00:00,78,48,30,FMN GV 05 Lier
60,Mechelsesteenweg 365,2021-08-26,20:00:00,98,58,40,FMN GV 05 Lier
60,Mechelsesteenweg 365,2021-08-26,21:00:00,26,12,14,FMN GV 05 Lier
60,Mechelsesteenweg 365,2021-08-26,22:00:00,10,6,4,FMN GV 05 Lier
60,Mechelsesteenweg 365,2021-08-26,23:00:00,28,2,26,FMN GV 05 Lier
60,Mechelsesteenweg 365,2021-08-27,00:00:00,4,0,4,FMN GV 05 Lier
60,Mechelsesteenweg 365,2021-08-27,01:00:00,0,0,0,FMN GV 05 Lier
60,Mechelsesteenweg 365,2021-08-27,02:00:00,4,0,4,FMN GV 05 Lier
60,Mechelsesteenweg 365,2021-08-27,03:00:00,2,0,2,FMN GV 05 Lier
60,Mechelsesteenweg 365,2021-08-27,04:00:00,0,0,0,FMN GV 05 Lier
60,Mechelsesteenweg 365,2021-08-27,05:00:00,4,0,4,FMN GV 05 Lier
60,Mechelsesteenweg 365,2021-08-27,06:00:00,12,2,10,FMN GV 05 Lier
60,Mechelsesteenweg 365,2021-08-27,07:00:00,54,14,40,FMN GV 05 Lier
60,Mechelsesteenweg 365,2021-08-27,08:00:00,74,30,44,FMN GV 05 Lier
60,Mechelsesteenweg 365,2021-08-27,09:00:00,60,44,16,FMN GV 05 Lier
60,Mechelsesteenweg 365,2021-08-27,10:00:00,168,110,58,FMN GV 05 Lier
60,Mechelsesteenweg 365,2021-08-27,11:00:00,140,74,66,FMN GV 05 Lier
60,Mechelsesteenweg 365,2021-08-27,12:00:00,132,64,68,FMN GV 05 Lier
60,Mechelsesteenweg 365,2021-08-27,13:00:00,154,76,78,FMN GV 05 Lier
60,Mechelsesteenweg 365,2021-08-27,14:00:00,194,110,84,FMN GV 05 Lier
60,Mechelsesteenweg 365,2021-08-27,15:00:00,242,136,106,FMN GV 05 Lier
60,Mechelsesteenweg 365,2021-08-27,16:00:00,136,66,70,FMN GV 05 Lier
60,Mechelsesteenweg 365,2021-08-27,17:00:00,136,72,64,FMN GV 05 Lier
60,Mechelsesteenweg 365,2021-08-27,18:00:00,72,40,32,FMN GV 05 Lier
60,Mechelsesteenweg 365,2021-08-27,19:00:00,46,28,18,FMN GV 05 Lier
60,Mechelsesteenweg 365,2021-08-27,20:00:00,38,16,22,FMN GV 05 Lier
60,Mechelsesteenweg 365,2021-08-27,21:00:00,20,10,10,FMN GV 05 Lier
60,Mechelsesteenweg 365,2021-08-27,22:00:00,0,0,0,FMN GV 05 Lier
60,Mechelsesteenweg 365,2021-08-27,23:00:00,12,0,12,FMN GV 05 Lier
60,Mechelsesteenweg 365,2021-08-28,00:00:00,2,2,0,FMN GV 05 Lier
60,Mechelsesteenweg 365,2021-08-28,01:00:00,10,4,6,FMN GV 05 Lier
60,Mechelsesteenweg 365,2021-08-28,02:00:00,8,6,2,FMN GV 05 Lier
60,Mechelsesteenweg 365,2021-08-28,03:00:00,0,0,0,FMN GV 05 Lier
60,Mechelsesteenweg 365,2021-08-28,04:00:00,0,0,0,FMN GV 05 Lier
60,Mechelsesteenweg 365,2021-08-28,05:00:00,2,0,2,FMN GV 05 Lier
60,Mechelsesteenweg 365,2021-08-28,06:00:00,0,0,0,FMN GV 05 Lier
60,Mechelsesteenweg 365,2021-08-28,07:00:00,16,10,6,FMN GV 05 Lier
60,Mechelsesteenweg 365,2021-08-28,08:00:00,122,92,30,FMN GV 05 Lier
60,Mechelsesteenweg 365,2021-08-28,09:00:00,396,364,32,FMN GV 05 Lier
60,Mechelsesteenweg 365,2021-08-28,10:00:00,648,514,134,FMN GV 05 Lier
60,Mechelsesteenweg 365,2021-08-28,11:00:00,598,504,94,FMN GV 05 Lier
60,Mechelsesteenweg 365,2021-08-28,12:00:00,478,420,58,FMN GV 05 Lier
60,Mechelsesteenweg 365,2021-08-28,13:00:00,226,170,56,FMN GV 05 Lier
60,Mechelsesteenweg 365,2021-08-28,14:00:00,242,170,72,FMN GV 05 Lier
60,Mechelsesteenweg 365,2021-08-28,15:00:00,182,94,88,FMN GV 05 Lier
60,Mechelsesteenweg 365,2021-08-28,16:00:00,134,68,66,FMN GV 05 Lier
60,Mechelsesteenweg 365,2021-08-28,17:00:00,82,28,54,FMN GV 05 Lier
60,Mechelsesteenweg 365,2021-08-28,18:00:00,70,44,26,FMN GV 05 Lier
60,Mechelsesteenweg 365,2021-08-28,19:00:00,36,24,12,FMN GV 05 Lier
60,Mechelsesteenweg 365,2021-08-28,20:00:00,30,10,20,FMN GV 05 Lier
60,Mechelsesteenweg 365,2021-08-28,21:00:00,12,4,8,FMN GV 05 Lier
60,Mechelsesteenweg 365,2021-08-28,22:00:00,16,4,12,FMN GV 05 Lier
60,Mechelsesteenweg 365,2021-08-28,23:00:00,2,0,2,FMN GV 05 Lier
60,Mechelsesteenweg 365,2021-08-29,00:00:00,2,2,0,FMN GV 05 Lier
60,Mechelsesteenweg 365,2021-08-29,01:00:00,2,0,2,FMN GV 05 Lier
60,Mechelsesteenweg 365,2021-08-29,02:00:00,0,0,0,FMN GV 05 Lier
60,Mechelsesteenweg 365,2021-08-29,03:00:00,2,2,0,FMN GV 05 Lier
60,Mechelsesteenweg 365,2021-08-29,04:00:00,0,0,0,FMN GV 05 Lier
60,Mechelsesteenweg 365,2021-08-29,05:00:00,0,0,0,FMN GV 05 Lier
60,Mechelsesteenweg 365,2021-08-29,06:00:00,4,2,2,FMN GV 05 Lier
60,Mechelsesteenweg 365,2021-08-29,07:00:00,14,8,6,FMN GV 05 Lier
60,Mechelsesteenweg 365,2021-08-29,08:00:00,30,16,14,FMN GV 05 Lier
60,Mechelsesteenweg 365,2021-08-29,09:00:00,138,80,58,FMN GV 05 Lier
60,Mechelsesteenweg 365,2021-08-29,10:00:00,242,120,122,FMN GV 05 Lier
60,Mechelsesteenweg 365,2021-08-29,11:00:00,280,124,156,FMN GV 05 Lier
60,Mechelsesteenweg 365,2021-08-29,12:00:00,164,74,90,FMN GV 05 Lier
60,Mechelsesteenweg 365,2021-08-29,13:00:00,118,72,46,FMN GV 05 Lier
60,Mechelsesteenweg 365,2021-08-29,14:00:00,78,44,34,FMN GV 05 Lier
60,Mechelsesteenweg 365,2021-08-29,15:00:00,88,48,40,FMN GV 05 Lier
60,Mechelsesteenweg 365,2021-08-29,16:00:00,68,26,42,FMN GV 05 Lier
60,Mechelsesteenweg 365,2021-08-29,17:00:00,60,28,32,FMN GV 05 Lier
60,Mechelsesteenweg 365,2021-08-29,18:00:00,26,12,14,FMN GV 05 Lier
60,Mechelsesteenweg 365,2021-08-29,19:00:00,24,12,12,FMN GV 05 Lier
60,Mechelsesteenweg 365,2021-08-29,20:00:00,16,6,10,FMN GV 05 Lier
60,Mechelsesteenweg 365,2021-08-29,21:00:00,6,0,6,FMN GV 05 Lier
60,Mechelsesteenweg 365,2021-08-29,22:00:00,4,4,0,FMN GV 05 Lier
60,Mechelsesteenweg 365,2021-08-29,23:00:00,8,2,6,FMN GV 05 Lier
60,Mechelsesteenweg 365,2021-08-30,00:00:00,0,0,0,FMN GV 05 Lier
60,Mechelsesteenweg 365,2021-08-30,01:00:00,2,2,0,FMN GV 05 Lier
60,Mechelsesteenweg 365,2021-08-30,02:00:00,0,0,0,FMN GV 05 Lier
60,Mechelsesteenweg 365,2021-08-30,03:00:00,2,2,0,FMN GV 05 Lier
60,Mechelsesteenweg 365,2021-08-30,04:00:00,0,0,0,FMN GV 05 Lier
60,Mechelsesteenweg 365,2021-08-30,05:00:00,4,0,4,FMN GV 05 Lier
60,Mechelsesteenweg 365,2021-08-30,06:00:00,26,8,18,FMN GV 05 Lier
60,Mechelsesteenweg 365,2021-08-30,07:00:00,64,24,40,FMN GV 05 Lier
60,Mechelsesteenweg 365,2021-08-30,08:00:00,114,62,52,FMN GV 05 Lier
60,Mechelsesteenweg 365,2021-08-30,09:00:00,62,28,34,FMN GV 05 Lier
60,Mechelsesteenweg 365,2021-08-30,10:00:00,78,28,50,FMN GV 05 Lier
60,Mechelsesteenweg 365,2021-08-30,11:00:00,86,30,56,FMN GV 05 Lier
60,Mechelsesteenweg 365,2021-08-30,12:00:00,76,40,36,FMN GV 05 Lier
60,Mechelsesteenweg 365,2021-08-30,13:00:00,112,52,60,FMN GV 05 Lier
60,Mechelsesteenweg 365,2021-08-30,14:00:00,148,92,56,FMN GV 05 Lier
60,Mechelsesteenweg 365,2021-08-30,15:00:00,248,112,136,FMN GV 05 Lier
60,Mechelsesteenweg 365,2021-08-30,16:00:00,188,96,92,FMN GV 05 Lier
60,Mechelsesteenweg 365,2021-08-30,17:00:00,162,92,70,FMN GV 05 Lier
60,Mechelsesteenweg 365,2021-08-30,18:00:00,104,58,46,FMN GV 05 Lier
60,Mechelsesteenweg 365,2021-08-30,19:00:00,92,42,50,FMN GV 05 Lier
60,Mechelsesteenweg 365,2021-08-30,20:00:00,62,18,44,FMN GV 05 Lier
60,Mechelsesteenweg 365,2021-08-30,21:00:00,18,2,16,FMN GV 05 Lier
60,Mechelsesteenweg 365,2021-08-30,22:00:00,4,4,0,FMN GV 05 Lier
60,Mechelsesteenweg 365,2021-08-30,23:00:00,10,6,4,FMN GV 05 Lier
60,Mechelsesteenweg 365,2021-08-31,00:00:00,4,4,0,FMN GV 05 Lier
60,Mechelsesteenweg 365,2021-08-31,01:00:00,2,2,0,FMN GV 05 Lier
60,Mechelsesteenweg 365,2021-08-31,02:00:00,2,2,0,FMN GV 05 Lier
60,Mechelsesteenweg 365,2021-08-31,03:00:00,0,0,0,FMN GV 05 Lier
60,Mechelsesteenweg 365,2021-08-31,04:00:00,2,0,2,FMN GV 05 Lier
60,Mechelsesteenweg 365,2021-08-31,05:00:00,14,0,14,FMN GV 05 Lier
60,Mechelsesteenweg 365,2021-08-31,06:00:00,30,14,16,FMN GV 05 Lier
60,Mechelsesteenweg 365,2021-08-31,07:00:00,100,30,70,FMN GV 05 Lier
60,Mechelsesteenweg 365,2021-08-31,08:00:00,104,60,44,FMN GV 05 Lier
60,Mechelsesteenweg 365,2021-08-31,09:00:00,100,48,52,FMN GV 05 Lier
60,Mechelsesteenweg 365,2021-08-31,10:00:00,134,62,72,FMN GV 05 Lier
60,Mechelsesteenweg 365,2021-08-31,11:00:00,138,56,82,FMN GV 05 Lier
60,Mechelsesteenweg 365,2021-08-31,12:00:00,158,94,64,FMN GV 05 Lier
60,Mechelsesteenweg 365,2021-08-31,13:00:00,246,102,144,FMN GV 05 Lier
60,Mechelsesteenweg 365,2021-08-31,14:00:00,266,148,118,FMN GV 05 Lier
60,Mechelsesteenweg 365,2021-08-31,15:00:00,306,138,168,FMN GV 05 Lier
60,Mechelsesteenweg 365,2021-08-31,16:00:00,274,132,142,FMN GV 05 Lier
60,Mechelsesteenweg 365,2021-08-31,17:00:00,198,84,114,FMN GV 05 Lier
60,Mechelsesteenweg 365,2021-08-31,18:00:00,178,98,80,FMN GV 05 Lier
60,Mechelsesteenweg 365,2021-08-31,19:00:00,182,68,114,FMN GV 05 Lier
60,Mechelsesteenweg 365,2021-08-31,20:00:00,98,42,56,FMN GV 05 Lier
60,Mechelsesteenweg 365,2021-08-31,21:00:00,26,12,14,FMN GV 05 Lier
60,Mechelsesteenweg 365,2021-08-31,22:00:00,8,6,2,FMN GV 05 Lier
60,Mechelsesteenweg 365,2021-08-31,23:00:00,2,0,2,FMN GV 05 Lier
60,Mechelsesteenweg 365,2021-09-01,00:00:00,0,0,0,FMN GV 05 Lier
60,Mechelsesteenweg 365,2021-09-01,01:00:00,0,0,0,FMN GV 05 Lier
60,Mechelsesteenweg 365,2021-09-01,02:00:00,0,0,0,FMN GV 05 Lier
60,Mechelsesteenweg 365,2021-09-01,03:00:00,0,0,0,FMN GV 05 Lier
60,Mechelsesteenweg 365,2021-09-01,04:00:00,2,0,2,FMN GV 05 Lier
60,Mechelsesteenweg 365,2021-09-01,05:00:00,6,0,6,FMN GV 05 Lier
60,Mechelsesteenweg 365,2021-09-01,06:00:00,28,12,16,FMN GV 05 Lier
60,Mechelsesteenweg 365,2021-09-01,07:00:00,224,140,84,FMN GV 05 Lier
60,Mechelsesteenweg 365,2021-09-01,08:00:00,186,128,58,FMN GV 05 Lier
60,Mechelsesteenweg 365,2021-09-01,09:00:00,140,96,44,FMN GV 05 Lier
60,Mechelsesteenweg 365,2021-09-01,10:00:00,114,76,38,FMN GV 05 Lier
60,Mechelsesteenweg 365,2021-09-01,11:00:00,108,46,62,FMN GV 05 Lier
60,Mechelsesteenweg 365,2021-09-01,12:00:00,418,112,306,FMN GV 05 Lier
60,Mechelsesteenweg 365,2021-09-01,13:00:00,154,78,76,FMN GV 05 Lier
60,Mechelsesteenweg 365,2021-09-01,14:00:00,234,116,118,FMN GV 05 Lier
60,Mechelsesteenweg 365,2021-09-01,15:00:00,192,88,104,FMN GV 05 Lier
60,Mechelsesteenweg 365,2021-09-01,16:00:00,232,94,138,FMN GV 05 Lier
60,Mechelsesteenweg 365,2021-09-01,17:00:00,166,96,70,FMN GV 05 Lier
60,Mechelsesteenweg 365,2021-09-01,18:00:00,104,52,52,FMN GV 05 Lier
60,Mechelsesteenweg 365,2021-09-01,19:00:00,140,82,58,FMN GV 05 Lier
60,Mechelsesteenweg 365,2021-09-01,20:00:00,138,106,32,FMN GV 05 Lier
60,Mechelsesteenweg 365,2021-09-01,21:00:00,20,4,16,FMN GV 05 Lier
60,Mechelsesteenweg 365,2021-09-01,22:00:00,10,4,6,FMN GV 05 Lier
60,Mechelsesteenweg 365,2021-09-01,23:00:00,0,0,0,FMN GV 05 Lier
60,Mechelsesteenweg 365,2021-09-02,00:00:00,8,4,4,FMN GV 05 Lier
60,Mechelsesteenweg 365,2021-09-02,01:00:00,2,2,0,FMN GV 05 Lier
60,Mechelsesteenweg 365,2021-09-02,02:00:00,0,0,0,FMN GV 05 Lier
60,Mechelsesteenweg 365,2021-09-02,03:00:00,0,0,0,FMN GV 05 Lier
60,Mechelsesteenweg 365,2021-09-02,04:00:00,2,0,2,FMN GV 05 Lier
60,Mechelsesteenweg 365,2021-09-02,05:00:00,14,2,12,FMN GV 05 Lier
60,Mechelsesteenweg 365,2021-09-02,06:00:00,44,28,16,FMN GV 05 Lier
60,Mechelsesteenweg 365,2021-09-02,07:00:00,286,190,96,FMN GV 05 Lier
60,Mechelsesteenweg 365,2021-09-02,08:00:00,176,116,60,FMN GV 05 Lier
60,Mechelsesteenweg 365,2021-09-02,09:00:00,118,76,42,FMN GV 05 Lier
60,Mechelsesteenweg 365,2021-09-02,10:00:00,128,54,74,FMN GV 05 Lier
60,Mechelsesteenweg 365,2021-09-02,11:00:00,222,128,94,FMN GV 05 Lier
60,Mechelsesteenweg 365,2021-09-02,12:00:00,162,88,74,FMN GV 05 Lier
60,Mechelsesteenweg 365,2021-09-02,13:00:00,224,114,110,FMN GV 05 Lier
60,Mechelsesteenweg 365,2021-09-02,14:00:00,300,118,182,FMN GV 05 Lier
60,Mechelsesteenweg 365,2021-09-02,15:00:00,274,160,114,FMN GV 05 Lier
60,Mechelsesteenweg 365,2021-09-02,16:00:00,442,150,292,FMN GV 05 Lier
60,Mechelsesteenweg 365,2021-09-02,17:00:00,232,136,96,FMN GV 05 Lier
60,Mechelsesteenweg 365,2021-09-02,18:00:00,156,86,70,FMN GV 05 Lier
60,Mechelsesteenweg 365,2021-09-02,19:00:00,136,58,78,FMN GV 05 Lier
60,Mechelsesteenweg 365,2021-09-02,20:00:00,174,54,120,FMN GV 05 Lier
60,Mechelsesteenweg 365,2021-09-02,21:00:00,10,2,8,FMN GV 05 Lier
60,Mechelsesteenweg 365,2021-09-02,22:00:00,2,2,0,FMN GV 05 Lier
60,Mechelsesteenweg 365,2021-09-02,23:00:00,12,0,12,FMN GV 05 Lier
60,Mechelsesteenweg 365,2021-09-03,00:00:00,2,0,2,FMN GV 05 Lier
60,Mechelsesteenweg 365,2021-09-03,01:00:00,2,2,0,FMN GV 05 Lier
60,Mechelsesteenweg 365,2021-09-03,02:00:00,0,0,0,FMN GV 05 Lier
60,Mechelsesteenweg 365,2021-09-03,03:00:00,4,0,4,FMN GV 05 Lier
60,Mechelsesteenweg 365,2021-09-03,04:00:00,0,0,0,FMN GV 05 Lier
60,Mechelsesteenweg 365,2021-09-03,05:00:00,8,2,6,FMN GV 05 Lier
60,Mechelsesteenweg 365,2021-09-03,06:00:00,26,12,14,FMN GV 05 Lier
60,Mechelsesteenweg 365,2021-09-03,07:00:00,272,188,84,FMN GV 05 Lier
60,Mechelsesteenweg 365,2021-09-03,08:00:00,172,114,58,FMN GV 05 Lier
60,Mechelsesteenweg 365,2021-09-03,09:00:00,88,46,42,FMN GV 05 Lier
60,Mechelsesteenweg 365,2021-09-03,10:00:00,182,82,100,FMN GV 05 Lier
60,Mechelsesteenweg 365,2021-09-03,11:00:00,228,112,116,FMN GV 05 Lier
60,Mechelsesteenweg 365,2021-09-03,12:00:00,226,134,92,FMN GV 05 Lier
60,Mechelsesteenweg 365,2021-09-03,13:00:00,304,160,144,FMN GV 05 Lier
60,Mechelsesteenweg 365,2021-09-03,14:00:00,466,250,216,FMN GV 05 Lier
60,Mechelsesteenweg 365,2021-09-03,15:00:00,384,182,202,FMN GV 05 Lier
60,Mechelsesteenweg 365,2021-09-03,16:00:00,510,144,366,FMN GV 05 Lier
60,Mechelsesteenweg 365,2021-09-03,17:00:00,294,142,152,FMN GV 05 Lier
60,Mechelsesteenweg 365,2021-09-03,18:00:00,180,90,90,FMN GV 05 Lier
60,Mechelsesteenweg 365,2021-09-03,19:00:00,110,56,54,FMN GV 05 Lier
60,Mechelsesteenweg 365,2021-09-03,20:00:00,102,48,54,FMN GV 05 Lier
60,Mechelsesteenweg 365,2021-09-03,21:00:00,48,18,30,FMN GV 05 Lier
60,Mechelsesteenweg 365,2021-09-03,22:00:00,12,8,4,FMN GV 05 Lier
60,Mechelsesteenweg 365,2021-09-03,23:00:00,8,4,4,FMN GV 05 Lier
60,Mechelsesteenweg 365,2021-09-04,00:00:00,0,0,0,FMN GV 05 Lier
60,Mechelsesteenweg 365,2021-09-04,01:00:00,6,2,4,FMN GV 05 Lier
60,Mechelsesteenweg 365,2021-09-04,02:00:00,8,2,6,FMN GV 05 Lier
60,Mechelsesteenweg 365,2021-09-04,03:00:00,0,0,0,FMN GV 05 Lier
60,Mechelsesteenweg 365,2021-09-04,04:00:00,0,0,0,FMN GV 05 Lier
60,Mechelsesteenweg 365,2021-09-04,05:00:00,2,0,2,FMN GV 05 Lier
60,Mechelsesteenweg 365,2021-09-04,06:00:00,8,4,4,FMN GV 05 Lier
60,Mechelsesteenweg 365,2021-09-04,07:00:00,8,6,2,FMN GV 05 Lier
60,Mechelsesteenweg 365,2021-09-04,08:00:00,38,16,22,FMN GV 05 Lier
60,Mechelsesteenweg 365,2021-09-04,09:00:00,126,64,62,FMN GV 05 Lier
60,Mechelsesteenweg 365,2021-09-04,10:00:00,218,90,128,FMN GV 05 Lier
60,Mechelsesteenweg 365,2021-09-04,11:00:00,172,80,92,FMN GV 05 Lier
60,Mechelsesteenweg 365,2021-09-04,12:00:00,202,108,94,FMN GV 05 Lier
60,Mechelsesteenweg 365,2021-09-04,13:00:00,146,68,78,FMN GV 05 Lier
60,Mechelsesteenweg 365,2021-09-04,14:00:00,270,132,138,FMN GV 05 Lier
60,Mechelsesteenweg 365,2021-09-04,15:00:00,282,104,178,FMN GV 05 Lier
60,Mechelsesteenweg 365,2021-09-04,16:00:00,242,78,164,FMN GV 05 Lier
60,Mechelsesteenweg 365,2021-09-04,17:00:00,222,84,138,FMN GV 05 Lier
60,Mechelsesteenweg 365,2021-09-04,18:00:00,102,52,50,FMN GV 05 Lier
60,Mechelsesteenweg 365,2021-09-04,19:00:00,110,42,68,FMN GV 05 Lier
60,Mechelsesteenweg 365,2021-09-04,20:00:00,56,18,38,FMN GV 05 Lier
60,Mechelsesteenweg 365,2021-09-04,21:00:00,18,6,12,FMN GV 05 Lier
60,Mechelsesteenweg 365,2021-09-04,22:00:00,18,2,16,FMN GV 05 Lier
60,Mechelsesteenweg 365,2021-09-04,23:00:00,14,0,14,FMN GV 05 Lier
60,Mechelsesteenweg 365,2021-09-05,00:00:00,2,2,0,FMN GV 05 Lier
60,Mechelsesteenweg 365,2021-09-05,01:00:00,8,8,0,FMN GV 05 Lier
60,Mechelsesteenweg 365,2021-09-05,02:00:00,10,8,2,FMN GV 05 Lier
60,Mechelsesteenweg 365,2021-09-05,03:00:00,6,4,2,FMN GV 05 Lier
60,Mechelsesteenweg 365,2021-09-05,04:00:00,0,0,0,FMN GV 05 Lier
60,Mechelsesteenweg 365,2021-09-05,05:00:00,4,2,2,FMN GV 05 Lier
60,Mechelsesteenweg 365,2021-09-05,06:00:00,6,6,0,FMN GV 05 Lier
60,Mechelsesteenweg 365,2021-09-05,07:00:00,16,6,10,FMN GV 05 Lier
60,Mechelsesteenweg 365,2021-09-05,08:00:00,38,16,22,FMN GV 05 Lier
60,Mechelsesteenweg 365,2021-09-05,09:00:00,208,140,68,FMN GV 05 Lier
60,Mechelsesteenweg 365,2021-09-05,10:00:00,356,192,164,FMN GV 05 Lier
60,Mechelsesteenweg 365,2021-09-05,11:00:00,622,272,350,FMN GV 05 Lier
60,Mechelsesteenweg 365,2021-09-05,12:00:00,398,196,202,FMN GV 05 Lier
60,Mechelsesteenweg 365,2021-09-05,13:00:00,440,238,202,FMN GV 05 Lier
60,Mechelsesteenweg 365,2021-09-05,14:00:00,690,354,336,FMN GV 05 Lier
60,Mechelsesteenweg 365,2021-09-05,15:00:00,676,324,352,FMN GV 05 Lier
60,Mechelsesteenweg 365,2021-09-05,16:00:00,498,192,306,FMN GV 05 Lier
60,Mechelsesteenweg 365,2021-09-05,17:00:00,358,130,228,FMN GV 05 Lier
60,Mechelsesteenweg 365,2021-09-05,18:00:00,270,70,200,FMN GV 05 Lier
60,Mechelsesteenweg 365,2021-09-05,19:00:00,102,44,58,FMN GV 05 Lier
60,Mechelsesteenweg 365,2021-09-05,20:00:00,52,24,28,FMN GV 05 Lier
60,Mechelsesteenweg 365,2021-09-05,21:00:00,22,2,20,FMN GV 05 Lier
60,Mechelsesteenweg 365,2021-09-05,22:00:00,0,0,0,FMN GV 05 Lier
60,Mechelsesteenweg 365,2021-09-05,23:00:00,0,0,0,FMN GV 05 Lier
60,Mechelsesteenweg 365,2021-09-06,00:00:00,2,0,2,FMN GV 05 Lier
60,Mechelsesteenweg 365,2021-09-06,01:00:00,0,0,0,FMN GV 05 Lier
60,Mechelsesteenweg 365,2021-09-06,02:00:00,0,0,0,FMN GV 05 Lier
60,Mechelsesteenweg 365,2021-09-06,03:00:00,0,0,0,FMN GV 05 Lier
60,Mechelsesteenweg 365,2021-09-06,04:00:00,0,0,0,FMN GV 05 Lier
60,Mechelsesteenweg 365,2021-09-06,05:00:00,18,2,16,FMN GV 05 Lier
60,Mechelsesteenweg 365,2021-09-06,06:00:00,30,12,18,FMN GV 05 Lier
60,Mechelsesteenweg 365,2021-09-06,07:00:00,274,174,100,FMN GV 05 Lier
60,Mechelsesteenweg 365,2021-09-06,08:00:00,214,128,86,FMN GV 05 Lier
60,Mechelsesteenweg 365,2021-09-06,09:00:00,86,42,44,FMN GV 05 Lier
60,Mechelsesteenweg 365,2021-09-06,10:00:00,116,58,58,FMN GV 05 Lier
60,Mechelsesteenweg 365,2021-09-06,11:00:00,182,82,100,FMN GV 05 Lier
60,Mechelsesteenweg 365,2021-09-06,12:00:00,192,106,86,FMN GV 05 Lier
60,Mechelsesteenweg 365,2021-09-06,13:00:00,236,112,124,FMN GV 05 Lier
60,Mechelsesteenweg 365,2021-09-06,14:00:00,356,186,170,FMN GV 05 Lier
60,Mechelsesteenweg 365,2021-09-06,15:00:00,382,160,222,FMN GV 05 Lier
60,Mechelsesteenweg 365,2021-09-06,16:00:00,546,176,370,FMN GV 05 Lier
60,Mechelsesteenweg 365,2021-09-06,17:00:00,246,126,120,FMN GV 05 Lier
60,Mechelsesteenweg 365,2021-09-06,18:00:00,134,62,72,FMN GV 05 Lier
60,Mechelsesteenweg 365,2021-09-06,19:00:00,102,56,46,FMN GV 05 Lier
60,Mechelsesteenweg 365,2021-09-06,20:00:00,94,26,68,FMN GV 05 Lier
60,Mechelsesteenweg 365,2021-09-06,21:00:00,32,18,14,FMN GV 05 Lier
60,Mechelsesteenweg 365,2021-09-06,22:00:00,16,2,14,FMN GV 05 Lier
60,Mechelsesteenweg 365,2021-09-06,23:00:00,6,2,4,FMN GV 05 Lier
60,Mechelsesteenweg 365,2021-09-07,00:00:00,2,2,0,FMN GV 05 Lier
60,Mechelsesteenweg 365,2021-09-07,01:00:00,0,0,0,FMN GV 05 Lier
60,Mechelsesteenweg 365,2021-09-07,02:00:00,0,0,0,FMN GV 05 Lier
60,Mechelsesteenweg 365,2021-09-07,03:00:00,0,0,0,FMN GV 05 Lier
60,Mechelsesteenweg 365,2021-09-07,04:00:00,0,0,0,FMN GV 05 Lier
60,Mechelsesteenweg 365,2021-09-07,05:00:00,10,0,10,FMN GV 05 Lier
60,Mechelsesteenweg 365,2021-09-07,06:00:00,50,20,30,FMN GV 05 Lier
60,Mechelsesteenweg 365,2021-09-07,07:00:00,296,180,116,FMN GV 05 Lier
60,Mechelsesteenweg 365,2021-09-07,08:00:00,238,168,70,FMN GV 05 Lier
60,Mechelsesteenweg 365,2021-09-07,09:00:00,142,64,78,FMN GV 05 Lier
60,Mechelsesteenweg 365,2021-09-07,10:00:00,316,138,178,FMN GV 05 Lier
60,Mechelsesteenweg 365,2021-09-07,11:00:00,300,138,162,FMN GV 05 Lier
60,Mechelsesteenweg 365,2021-09-07,12:00:00,228,120,108,FMN GV 05 Lier
60,Mechelsesteenweg 365,2021-09-07,13:00:00,302,142,160,FMN GV 05 Lier
60,Mechelsesteenweg 365,2021-09-07,14:00:00,332,176,156,FMN GV 05 Lier
60,Mechelsesteenweg 365,2021-09-07,15:00:00,376,168,208,FMN GV 05 Lier
60,Mechelsesteenweg 365,2021-09-07,16:00:00,616,190,426,FMN GV 05 Lier
60,Mechelsesteenweg 365,2021-09-07,17:00:00,300,154,146,FMN GV 05 Lier
60,Mechelsesteenweg 365,2021-09-07,18:00:00,204,94,110,FMN GV 05 Lier
60,Mechelsesteenweg 365,2021-09-07,19:00:00,290,140,150,FMN GV 05 Lier
60,Mechelsesteenweg 365,2021-09-07,20:00:00,112,34,78,FMN GV 05 Lier
60,Mechelsesteenweg 365,2021-09-07,21:00:00,20,10,10,FMN GV 05 Lier
60,Mechelsesteenweg 365,2021-09-07,22:00:00,16,4,12,FMN GV 05 Lier
60,Mechelsesteenweg 365,2021-09-07,23:00:00,6,4,2,FMN GV 05 Lier
60,Mechelsesteenweg 365,2021-09-08,00:00:00,2,0,2,FMN GV 05 Lier
60,Mechelsesteenweg 365,2021-09-08,01:00:00,0,0,0,FMN GV 05 Lier
60,Mechelsesteenweg 365,2021-09-08,02:00:00,4,4,0,FMN GV 05 Lier
60,Mechelsesteenweg 365,2021-09-08,03:00:00,0,0,0,FMN GV 05 Lier
60,Mechelsesteenweg 365,2021-09-08,04:00:00,2,2,0,FMN GV 05 Lier
60,Mechelsesteenweg 365,2021-09-08,05:00:00,10,0,10,FMN GV 05 Lier
60,Mechelsesteenweg 365,2021-09-08,06:00:00,38,18,20,FMN GV 05 Lier
60,Mechelsesteenweg 365,2021-09-08,07:00:00,274,174,100,FMN GV 05 Lier
60,Mechelsesteenweg 365,2021-09-08,08:00:00,214,158,56,FMN GV 05 Lier
60,Mechelsesteenweg 365,2021-09-08,09:00:00,122,76,46,FMN GV 05 Lier
60,Mechelsesteenweg 365,2021-09-08,10:00:00,260,114,146,FMN GV 05 Lier
60,Mechelsesteenweg 365,2021-09-08,11:00:00,272,120,152,FMN GV 05 Lier
60,Mechelsesteenweg 365,2021-09-08,12:00:00,500,174,326,FMN GV 05 Lier
60,Mechelsesteenweg 365,2021-09-08,13:00:00,288,116,172,FMN GV 05 Lier
60,Mechelsesteenweg 365,2021-09-08,14:00:00,438,212,226,FMN GV 05 Lier
60,Mechelsesteenweg 365,2021-09-08,15:00:00,390,164,226,FMN GV 05 Lier
60,Mechelsesteenweg 365,2021-09-08,16:00:00,290,150,140,FMN GV 05 Lier
60,Mechelsesteenweg 365,2021-09-08,17:00:00,320,180,140,FMN GV 05 Lier
60,Mechelsesteenweg 365,2021-09-08,18:00:00,220,126,94,FMN GV 05 Lier
60,Mechelsesteenweg 365,2021-09-08,19:00:00,302,122,180,FMN GV 05 Lier
60,Mechelsesteenweg 365,2021-09-08,20:00:00,182,122,60,FMN GV 05 Lier
60,Mechelsesteenweg 365,2021-09-08,21:00:00,26,12,14,FMN GV 05 Lier
60,Mechelsesteenweg 365,2021-09-08,22:00:00,8,8,0,FMN GV 05 Lier
60,Mechelsesteenweg 365,2021-09-08,23:00:00,8,0,8,FMN GV 05 Lier
60,Mechelsesteenweg 365,2021-09-09,00:00:00,0,0,0,FMN GV 05 Lier
60,Mechelsesteenweg 365,2021-09-09,01:00:00,2,0,2,FMN GV 05 Lier
60,Mechelsesteenweg 365,2021-09-09,02:00:00,2,0,2,FMN GV 05 Lier
60,Mechelsesteenweg 365,2021-09-09,03:00:00,0,0,0,FMN GV 05 Lier
60,Mechelsesteenweg 365,2021-09-09,04:00:00,4,0,4,FMN GV 05 Lier
60,Mechelsesteenweg 365,2021-09-09,05:00:00,10,0,10,FMN GV 05 Lier
60,Mechelsesteenweg 365,2021-09-09,06:00:00,28,14,14,FMN GV 05 Lier
60,Mechelsesteenweg 365,2021-09-09,07:00:00,214,142,72,FMN GV 05 Lier
60,Mechelsesteenweg 365,2021-09-09,08:00:00,214,152,62,FMN GV 05 Lier
60,Mechelsesteenweg 365,2021-09-09,09:00:00,80,44,36,FMN GV 05 Lier
60,Mechelsesteenweg 365,2021-09-09,10:00:00,148,84,64,FMN GV 05 Lier
60,Mechelsesteenweg 365,2021-09-09,11:00:00,104,46,58,FMN GV 05 Lier
60,Mechelsesteenweg 365,2021-09-09,12:00:00,228,74,154,FMN GV 05 Lier
60,Mechelsesteenweg 365,2021-09-09,13:00:00,196,76,120,FMN GV 05 Lier
60,Mechelsesteenweg 365,2021-09-09,14:00:00,270,188,82,FMN GV 05 Lier
60,Mechelsesteenweg 365,2021-09-09,15:00:00,248,128,120,FMN GV 05 Lier
60,Mechelsesteenweg 365,2021-09-09,16:00:00,330,132,198,FMN GV 05 Lier
60,Mechelsesteenweg 365,2021-09-09,17:00:00,144,98,46,FMN GV 05 Lier
60,Mechelsesteenweg 365,2021-09-09,18:00:00,98,52,46,FMN GV 05 Lier
60,Mechelsesteenweg 365,2021-09-09,19:00:00,94,42,52,FMN GV 05 Lier
60,Mechelsesteenweg 365,2021-09-09,20:00:00,16,10,6,FMN GV 05 Lier
60,Mechelsesteenweg 365,2021-09-09,21:00:00,10,2,8,FMN GV 05 Lier
60,Mechelsesteenweg 365,2021-09-09,22:00:00,12,8,4,FMN GV 05 Lier
60,Mechelsesteenweg 365,2021-09-09,23:00:00,2,0,2,FMN GV 05 Lier
60,Mechelsesteenweg 365,2021-09-10,00:00:00,2,0,2,FMN GV 05 Lier
60,Mechelsesteenweg 365,2021-09-10,01:00:00,2,0,2,FMN GV 05 Lier
60,Mechelsesteenweg 365,2021-09-10,02:00:00,2,2,0,FMN GV 05 Lier
60,Mechelsesteenweg 365,2021-09-10,03:00:00,0,0,0,FMN GV 05 Lier
60,Mechelsesteenweg 365,2021-09-10,04:00:00,2,0,2,FMN GV 05 Lier
60,Mechelsesteenweg 365,2021-09-10,05:00:00,8,0,8,FMN GV 05 Lier
60,Mechelsesteenweg 365,2021-09-10,06:00:00,26,6,20,FMN GV 05 Lier
60,Mechelsesteenweg 365,2021-09-10,07:00:00,208,150,58,FMN GV 05 Lier
60,Mechelsesteenweg 365,2021-09-10,08:00:00,422,134,288,FMN GV 05 Lier
60,Mechelsesteenweg 365,2021-09-10,09:00:00,86,52,34,FMN GV 05 Lier
60,Mechelsesteenweg 365,2021-09-10,10:00:00,100,48,52,FMN GV 05 Lier
60,Mechelsesteenweg 365,2021-09-10,11:00:00,94,68,26,FMN GV 05 Lier
60,Mechelsesteenweg 365,2021-09-10,12:00:00,80,34,46,FMN GV 05 Lier
60,Mechelsesteenweg 365,2021-09-10,13:00:00,88,62,26,FMN GV 05 Lier
60,Mechelsesteenweg 365,2021-09-10,14:00:00,66,32,34,FMN GV 05 Lier
60,Mechelsesteenweg 365,2021-09-10,15:00:00,340,222,118,FMN GV 05 Lier
60,Mechelsesteenweg 365,2021-09-10,16:00:00,304,92,212,FMN GV 05 Lier
60,Mechelsesteenweg 365,2021-09-10,17:00:00,104,52,52,FMN GV 05 Lier
60,Mechelsesteenweg 365,2021-09-10,18:00:00,76,32,44,FMN GV 05 Lier
60,Mechelsesteenweg 365,2021-09-10,19:00:00,54,32,22,FMN GV 05 Lier
60,Mechelsesteenweg 365,2021-09-10,20:00:00,32,16,16,FMN GV 05 Lier
60,Mechelsesteenweg 365,2021-09-10,21:00:00,4,0,4,FMN GV 05 Lier
60,Mechelsesteenweg 365,2021-09-10,22:00:00,4,2,2,FMN GV 05 Lier
60,Mechelsesteenweg 365,2021-09-10,23:00:00,4,2,2,FMN GV 05 Lier
60,Mechelsesteenweg 365,2021-09-11,00:00:00,18,2,16,FMN GV 05 Lier
60,Mechelsesteenweg 365,2021-09-11,01:00:00,8,2,6,FMN GV 05 Lier
60,Mechelsesteenweg 365,2021-09-11,02:00:00,0,0,0,FMN GV 05 Lier
60,Mechelsesteenweg 365,2021-09-11,03:00:00,0,0,0,FMN GV 05 Lier
60,Mechelsesteenweg 365,2021-09-11,04:00:00,2,0,2,FMN GV 05 Lier
60,Mechelsesteenweg 365,2021-09-11,05:00:00,0,0,0,FMN GV 05 Lier
60,Mechelsesteenweg 365,2021-09-11,06:00:00,6,4,2,FMN GV 05 Lier
60,Mechelsesteenweg 365,2021-09-11,07:00:00,18,14,4,FMN GV 05 Lier
60,Mechelsesteenweg 365,2021-09-11,08:00:00,24,14,10,FMN GV 05 Lier
60,Mechelsesteenweg 365,2021-09-11,09:00:00,98,50,48,FMN GV 05 Lier
60,Mechelsesteenweg 365,2021-09-11,10:00:00,154,84,70,FMN GV 05 Lier
60,Mechelsesteenweg 365,2021-09-11,11:00:00,122,40,82,FMN GV 05 Lier
60,Mechelsesteenweg 365,2021-09-11,12:00:00,102,64,38,FMN GV 05 Lier
60,Mechelsesteenweg 365,2021-09-11,13:00:00,114,66,48,FMN GV 05 Lier
60,Mechelsesteenweg 365,2021-09-11,14:00:00,64,42,22,FMN GV 05 Lier
60,Mechelsesteenweg 365,2021-09-11,15:00:00,114,56,58,FMN GV 05 Lier
60,Mechelsesteenweg 365,2021-09-11,16:00:00,178,120,58,FMN GV 05 Lier
60,Mechelsesteenweg 365,2021-09-11,17:00:00,82,48,34,FMN GV 05 Lier
60,Mechelsesteenweg 365,2021-09-11,18:00:00,54,30,24,FMN GV 05 Lier
60,Mechelsesteenweg 365,2021-09-11,19:00:00,60,38,22,FMN GV 05 Lier
60,Mechelsesteenweg 365,2021-09-11,20:00:00,8,2,6,FMN GV 05 Lier
60,Mechelsesteenweg 365,2021-09-11,21:00:00,2,2,0,FMN GV 05 Lier
60,Mechelsesteenweg 365,2021-09-11,22:00:00,4,0,4,FMN GV 05 Lier
60,Mechelsesteenweg 365,2021-09-11,23:00:00,2,0,2,FMN GV 05 Lier
60,Mechelsesteenweg 365,2021-09-12,00:00:00,4,2,2,FMN GV 05 Lier
60,Mechelsesteenweg 365,2021-09-12,01:00:00,4,2,2,FMN GV 05 Lier
60,Mechelsesteenweg 365,2021-09-12,02:00:00,2,0,2,FMN GV 05 Lier
60,Mechelsesteenweg 365,2021-09-12,03:00:00,2,0,2,FMN GV 05 Lier
60,Mechelsesteenweg 365,2021-09-12,04:00:00,0,0,0,FMN GV 05 Lier
60,Mechelsesteenweg 365,2021-09-12,05:00:00,2,0,2,FMN GV 05 Lier
60,Mechelsesteenweg 365,2021-09-12,06:00:00,6,4,2,FMN GV 05 Lier
60,Mechelsesteenweg 365,2021-09-12,07:00:00,6,4,2,FMN GV 05 Lier
60,Mechelsesteenweg 365,2021-09-12,08:00:00,56,26,30,FMN GV 05 Lier
60,Mechelsesteenweg 365,2021-09-12,09:00:00,234,130,104,FMN GV 05 Lier
60,Mechelsesteenweg 365,2021-09-12,10:00:00,370,194,176,FMN GV 05 Lier
60,Mechelsesteenweg 365,2021-09-12,11:00:00,426,200,226,FMN GV 05 Lier
60,Mechelsesteenweg 365,2021-09-12,12:00:00,274,142,132,FMN GV 05 Lier
60,Mechelsesteenweg 365,2021-09-12,13:00:00,280,158,122,FMN GV 05 Lier
60,Mechelsesteenweg 365,2021-09-12,14:00:00,398,194,204,FMN GV 05 Lier
60,Mechelsesteenweg 365,2021-09-12,15:00:00,440,234,206,FMN GV 05 Lier
60,Mechelsesteenweg 365,2021-09-12,16:00:00,326,170,156,FMN GV 05 Lier
60,Mechelsesteenweg 365,2021-09-12,17:00:00,220,92,128,FMN GV 05 Lier
60,Mechelsesteenweg 365,2021-09-12,18:00:00,106,52,54,FMN GV 05 Lier
60,Mechelsesteenweg 365,2021-09-12,19:00:00,42,20,22,FMN GV 05 Lier
60,Mechelsesteenweg 365,2021-09-12,20:00:00,28,10,18,FMN GV 05 Lier
60,Mechelsesteenweg 365,2021-09-12,21:00:00,2,2,0,FMN GV 05 Lier
60,Mechelsesteenweg 365,2021-09-12,22:00:00,6,0,6,FMN GV 05 Lier
60,Mechelsesteenweg 365,2021-09-12,23:00:00,2,0,2,FMN GV 05 Lier
60,Mechelsesteenweg 365,2021-09-13,00:00:00,0,0,0,FMN GV 05 Lier
60,Mechelsesteenweg 365,2021-09-13,01:00:00,0,0,0,FMN GV 05 Lier
60,Mechelsesteenweg 365,2021-09-13,02:00:00,0,0,0,FMN GV 05 Lier
60,Mechelsesteenweg 365,2021-09-13,03:00:00,2,0,2,FMN GV 05 Lier
60,Mechelsesteenweg 365,2021-09-13,04:00:00,2,0,2,FMN GV 05 Lier
60,Mechelsesteenweg 365,2021-09-13,05:00:00,10,0,10,FMN GV 05 Lier
60,Mechelsesteenweg 365,2021-09-13,06:00:00,30,12,18,FMN GV 05 Lier
60,Mechelsesteenweg 365,2021-09-13,07:00:00,226,142,84,FMN GV 05 Lier
60,Mechelsesteenweg 365,2021-09-13,08:00:00,224,160,64,FMN GV 05 Lier
60,Mechelsesteenweg 365,2021-09-13,09:00:00,88,40,48,FMN GV 05 Lier
60,Mechelsesteenweg 365,2021-09-13,10:00:00,102,68,34,FMN GV 05 Lier
60,Mechelsesteenweg 365,2021-09-13,11:00:00,168,88,80,FMN GV 05 Lier
60,Mechelsesteenweg 365,2021-09-13,12:00:00,118,72,46,FMN GV 05 Lier
60,Mechelsesteenweg 365,2021-09-13,13:00:00,206,88,118,FMN GV 05 Lier
60,Mechelsesteenweg 365,2021-09-13,14:00:00,388,180,208,FMN GV 05 Lier
60,Mechelsesteenweg 365,2021-09-13,15:00:00,338,132,206,FMN GV 05 Lier
60,Mechelsesteenweg 365,2021-09-13,16:00:00,522,152,370,FMN GV 05 Lier
60,Mechelsesteenweg 365,2021-09-13,17:00:00,216,116,100,FMN GV 05 Lier
60,Mechelsesteenweg 365,2021-09-13,18:00:00,144,72,72,FMN GV 05 Lier
60,Mechelsesteenweg 365,2021-09-13,19:00:00,84,36,48,FMN GV 05 Lier
60,Mechelsesteenweg 365,2021-09-13,20:00:00,26,18,8,FMN GV 05 Lier
60,Mechelsesteenweg 365,2021-09-13,21:00:00,16,12,4,FMN GV 05 Lier
60,Mechelsesteenweg 365,2021-09-13,22:00:00,8,4,4,FMN GV 05 Lier
60,Mechelsesteenweg 365,2021-09-13,23:00:00,6,4,2,FMN GV 05 Lier
60,Mechelsesteenweg 365,2021-09-14,00:00:00,0,0,0,FMN GV 05 Lier
60,Mechelsesteenweg 365,2021-09-14,01:00:00,0,0,0,FMN GV 05 Lier
60,Mechelsesteenweg 365,2021-09-14,02:00:00,2,2,0,FMN GV 05 Lier
60,Mechelsesteenweg 365,2021-09-14,03:00:00,2,0,2,FMN GV 05 Lier
60,Mechelsesteenweg 365,2021-09-14,04:00:00,2,0,2,FMN GV 05 Lier
60,Mechelsesteenweg 365,2021-09-14,05:00:00,12,0,12,FMN GV 05 Lier
60,Mechelsesteenweg 365,2021-09-14,06:00:00,30,10,20,FMN GV 05 Lier
60,Mechelsesteenweg 365,2021-09-14,07:00:00,248,156,92,FMN GV 05 Lier
60,Mechelsesteenweg 365,2021-09-14,08:00:00,174,124,50,FMN GV 05 Lier
60,Mechelsesteenweg 365,2021-09-14,09:00:00,112,66,46,FMN GV 05 Lier
60,Mechelsesteenweg 365,2021-09-14,10:00:00,122,44,78,FMN GV 05 Lier
60,Mechelsesteenweg 365,2021-09-14,11:00:00,244,120,124,FMN GV 05 Lier
60,Mechelsesteenweg 365,2021-09-14,12:00:00,162,94,68,FMN GV 05 Lier
60,Mechelsesteenweg 365,2021-09-14,13:00:00,188,56,132,FMN GV 05 Lier
60,Mechelsesteenweg 365,2021-09-14,14:00:00,134,76,58,FMN GV 05 Lier
60,Mechelsesteenweg 365,2021-09-14,15:00:00,112,54,58,FMN GV 05 Lier
60,Mechelsesteenweg 365,2021-09-14,16:00:00,352,100,252,FMN GV 05 Lier
60,Mechelsesteenweg 365,2021-09-14,17:00:00,140,92,48,FMN GV 05 Lier
60,Mechelsesteenweg 365,2021-09-14,18:00:00,68,38,30,FMN GV 05 Lier
60,Mechelsesteenweg 365,2021-09-14,19:00:00,76,28,48,FMN GV 05 Lier
60,Mechelsesteenweg 365,2021-09-14,20:00:00,34,10,24,FMN GV 05 Lier
60,Mechelsesteenweg 365,2021-09-14,21:00:00,14,8,6,FMN GV 05 Lier
60,Mechelsesteenweg 365,2021-09-14,22:00:00,6,4,2,FMN GV 05 Lier
60,Mechelsesteenweg 365,2021-09-14,23:00:00,6,2,4,FMN GV 05 Lier
60,Mechelsesteenweg 365,2021-09-15,00:00:00,0,0,0,FMN GV 05 Lier
60,Mechelsesteenweg 365,2021-09-15,01:00:00,0,0,0,FMN GV 05 Lier
60,Mechelsesteenweg 365,2021-09-15,02:00:00,2,2,0,FMN GV 05 Lier
60,Mechelsesteenweg 365,2021-09-15,03:00:00,2,0,2,FMN GV 05 Lier
60,Mechelsesteenweg 365,2021-09-15,04:00:00,2,0,2,FMN GV 05 Lier
60,Mechelsesteenweg 365,2021-09-15,05:00:00,12,2,10,FMN GV 05 Lier
60,Mechelsesteenweg 365,2021-09-15,06:00:00,24,6,18,FMN GV 05 Lier
60,Mechelsesteenweg 365,2021-09-15,07:00:00,214,148,66,FMN GV 05 Lier
60,Mechelsesteenweg 365,2021-09-15,08:00:00,158,124,34,FMN GV 05 Lier
60,Mechelsesteenweg 365,2021-09-15,09:00:00,140,124,16,FMN GV 05 Lier
60,Mechelsesteenweg 365,2021-09-15,10:00:00,42,20,22,FMN GV 05 Lier
60,Mechelsesteenweg 365,2021-09-15,11:00:00,236,42,194,FMN GV 05 Lier
60,Mechelsesteenweg 365,2021-09-15,12:00:00,262,46,216,FMN GV 05 Lier
60,Mechelsesteenweg 365,2021-09-15,13:00:00,134,62,72,FMN GV 05 Lier
60,Mechelsesteenweg 365,2021-09-15,14:00:00,206,112,94,FMN GV 05 Lier
60,Mechelsesteenweg 365,2021-09-15,15:00:00,182,76,106,FMN GV 05 Lier
60,Mechelsesteenweg 365,2021-09-15,16:00:00,148,74,74,FMN GV 05 Lier
60,Mechelsesteenweg 365,2021-09-15,17:00:00,130,64,66,FMN GV 05 Lier
60,Mechelsesteenweg 365,2021-09-15,18:00:00,80,38,42,FMN GV 05 Lier
60,Mechelsesteenweg 365,2021-09-15,19:00:00,134,100,34,FMN GV 05 Lier
60,Mechelsesteenweg 365,2021-09-15,20:00:00,16,6,10,FMN GV 05 Lier
60,Mechelsesteenweg 365,2021-09-15,21:00:00,14,10,4,FMN GV 05 Lier
60,Mechelsesteenweg 365,2021-09-15,22:00:00,16,8,8,FMN GV 05 Lier
60,Mechelsesteenweg 365,2021-09-15,23:00:00,4,2,2,FMN GV 05 Lier
60,Mechelsesteenweg 365,2021-09-16,00:00:00,2,2,0,FMN GV 05 Lier
60,Mechelsesteenweg 365,2021-09-16,01:00:00,0,0,0,FMN GV 05 Lier
60,Mechelsesteenweg 365,2021-09-16,02:00:00,0,0,0,FMN GV 05 Lier
60,Mechelsesteenweg 365,2021-09-16,03:00:00,2,0,2,FMN GV 05 Lier
60,Mechelsesteenweg 365,2021-09-16,04:00:00,4,0,4,FMN GV 05 Lier
60,Mechelsesteenweg 365,2021-09-16,05:00:00,12,2,10,FMN GV 05 Lier
60,Mechelsesteenweg 365,2021-09-16,06:00:00,26,8,18,FMN GV 05 Lier
60,Mechelsesteenweg 365,2021-09-16,07:00:00,258,174,84,FMN GV 05 Lier
60,Mechelsesteenweg 365,2021-09-16,08:00:00,182,124,58,FMN GV 05 Lier
60,Mechelsesteenweg 365,2021-09-16,09:00:00,156,106,50,FMN GV 05 Lier
60,Mechelsesteenweg 365,2021-09-16,10:00:00,124,64,60,FMN GV 05 Lier
60,Mechelsesteenweg 365,2021-09-16,11:00:00,162,92,70,FMN GV 05 Lier
60,Mechelsesteenweg 365,2021-09-16,12:00:00,202,62,140,FMN GV 05 Lier
60,Mechelsesteenweg 365,2021-09-16,13:00:00,236,126,110,FMN GV 05 Lier
60,Mechelsesteenweg 365,2021-09-16,14:00:00,300,152,148,FMN GV 05 Lier
60,Mechelsesteenweg 365,2021-09-16,15:00:00,284,136,148,FMN GV 05 Lier
60,Mechelsesteenweg 365,2021-09-16,16:00:00,442,136,306,FMN GV 05 Lier
60,Mechelsesteenweg 365,2021-09-16,17:00:00,220,130,90,FMN GV 05 Lier
60,Mechelsesteenweg 365,2021-09-16,18:00:00,116,62,54,FMN GV 05 Lier
60,Mechelsesteenweg 365,2021-09-16,19:00:00,130,66,64,FMN GV 05 Lier
60,Mechelsesteenweg 365,2021-09-16,20:00:00,48,24,24,FMN GV 05 Lier
60,Mechelsesteenweg 365,2021-09-16,21:00:00,20,10,10,FMN GV 05 Lier
60,Mechelsesteenweg 365,2021-09-16,22:00:00,16,10,6,FMN GV 05 Lier
60,Mechelsesteenweg 365,2021-09-16,23:00:00,4,4,0,FMN GV 05 Lier
60,Mechelsesteenweg 365,2021-09-17,00:00:00,2,2,0,FMN GV 05 Lier
60,Mechelsesteenweg 365,2021-09-17,01:00:00,0,0,0,FMN GV 05 Lier
60,Mechelsesteenweg 365,2021-09-17,02:00:00,0,0,0,FMN GV 05 Lier
60,Mechelsesteenweg 365,2021-09-17,03:00:00,2,0,2,FMN GV 05 Lier
60,Mechelsesteenweg 365,2021-09-17,04:00:00,0,0,0,FMN GV 05 Lier
60,Mechelsesteenweg 365,2021-09-17,05:00:00,8,2,6,FMN GV 05 Lier
60,Mechelsesteenweg 365,2021-09-17,06:00:00,22,6,16,FMN GV 05 Lier
60,Mechelsesteenweg 365,2021-09-17,07:00:00,244,168,76,FMN GV 05 Lier
60,Mechelsesteenweg 365,2021-09-17,08:00:00,190,124,66,FMN GV 05 Lier
60,Mechelsesteenweg 365,2021-09-17,09:00:00,70,30,40,FMN GV 05 Lier
60,Mechelsesteenweg 365,2021-09-17,10:00:00,124,54,70,FMN GV 05 Lier
60,Mechelsesteenweg 365,2021-09-17,11:00:00,358,292,66,FMN GV 05 Lier
60,Mechelsesteenweg 365,2021-09-17,12:00:00,202,106,96,FMN GV 05 Lier
60,Mechelsesteenweg 365,2021-09-17,13:00:00,224,130,94,FMN GV 05 Lier
60,Mechelsesteenweg 365,2021-09-17,14:00:00,532,214,318,FMN GV 05 Lier
60,Mechelsesteenweg 365,2021-09-17,15:00:00,356,180,176,FMN GV 05 Lier
60,Mechelsesteenweg 365,2021-09-17,16:00:00,452,128,324,FMN GV 05 Lier
60,Mechelsesteenweg 365,2021-09-17,17:00:00,214,108,106,FMN GV 05 Lier
60,Mechelsesteenweg 365,2021-09-17,18:00:00,106,56,50,FMN GV 05 Lier
60,Mechelsesteenweg 365,2021-09-17,19:00:00,96,36,60,FMN GV 05 Lier
60,Mechelsesteenweg 365,2021-09-17,20:00:00,76,18,58,FMN GV 05 Lier
60,Mechelsesteenweg 365,2021-09-17,21:00:00,18,8,10,FMN GV 05 Lier
60,Mechelsesteenweg 365,2021-09-17,22:00:00,10,2,8,FMN GV 05 Lier
60,Mechelsesteenweg 365,2021-09-17,23:00:00,8,0,8,FMN GV 05 Lier
60,Mechelsesteenweg 365,2021-09-18,00:00:00,12,10,2,FMN GV 05 Lier
60,Mechelsesteenweg 365,2021-09-18,01:00:00,24,4,20,FMN GV 05 Lier
60,Mechelsesteenweg 365,2021-09-18,02:00:00,6,4,2,FMN GV 05 Lier
60,Mechelsesteenweg 365,2021-09-18,03:00:00,6,6,0,FMN GV 05 Lier
60,Mechelsesteenweg 365,2021-09-18,04:00:00,0,0,0,FMN GV 05 Lier
60,Mechelsesteenweg 365,2021-09-18,05:00:00,2,0,2,FMN GV 05 Lier
60,Mechelsesteenweg 365,2021-09-18,06:00:00,4,4,0,FMN GV 05 Lier
60,Mechelsesteenweg 365,2021-09-18,07:00:00,12,6,6,FMN GV 05 Lier
60,Mechelsesteenweg 365,2021-09-18,08:00:00,42,20,22,FMN GV 05 Lier
60,Mechelsesteenweg 365,2021-09-18,09:00:00,124,80,44,FMN GV 05 Lier
60,Mechelsesteenweg 365,2021-09-18,10:00:00,210,126,84,FMN GV 05 Lier
60,Mechelsesteenweg 365,2021-09-18,11:00:00,258,142,116,FMN GV 05 Lier
60,Mechelsesteenweg 365,2021-09-18,12:00:00,234,86,148,FMN GV 05 Lier
60,Mechelsesteenweg 365,2021-09-18,13:00:00,288,138,150,FMN GV 05 Lier
60,Mechelsesteenweg 365,2021-09-18,14:00:00,438,270,168,FMN GV 05 Lier
60,Mechelsesteenweg 365,2021-09-18,15:00:00,378,156,222,FMN GV 05 Lier
60,Mechelsesteenweg 365,2021-09-18,16:00:00,456,208,248,FMN GV 05 Lier
60,Mechelsesteenweg 365,2021-09-18,17:00:00,210,104,106,FMN GV 05 Lier
60,Mechelsesteenweg 365,2021-09-18,18:00:00,138,50,88,FMN GV 05 Lier
60,Mechelsesteenweg 365,2021-09-18,19:00:00,58,18,40,FMN GV 05 Lier
60,Mechelsesteenweg 365,2021-09-18,20:00:00,32,10,22,FMN GV 05 Lier
60,Mechelsesteenweg 365,2021-09-18,21:00:00,6,2,4,FMN GV 05 Lier
60,Mechelsesteenweg 365,2021-09-18,22:00:00,4,2,2,FMN GV 05 Lier
60,Mechelsesteenweg 365,2021-09-18,23:00:00,6,6,0,FMN GV 05 Lier
60,Mechelsesteenweg 365,2021-09-19,00:00:00,4,2,2,FMN GV 05 Lier
60,Mechelsesteenweg 365,2021-09-19,01:00:00,8,0,8,FMN GV 05 Lier
60,Mechelsesteenweg 365,2021-09-19,02:00:00,2,2,0,FMN GV 05 Lier
60,Mechelsesteenweg 365,2021-09-19,03:00:00,0,0,0,FMN GV 05 Lier
60,Mechelsesteenweg 365,2021-09-19,04:00:00,6,0,6,FMN GV 05 Lier
60,Mechelsesteenweg 365,2021-09-19,05:00:00,0,0,0,FMN GV 05 Lier
60,Mechelsesteenweg 365,2021-09-19,06:00:00,2,2,0,FMN GV 05 Lier
60,Mechelsesteenweg 365,2021-09-19,07:00:00,12,6,6,FMN GV 05 Lier
60,Mechelsesteenweg 365,2021-09-19,08:00:00,48,26,22,FMN GV 05 Lier
60,Mechelsesteenweg 365,2021-09-19,09:00:00,222,124,98,FMN GV 05 Lier
60,Mechelsesteenweg 365,2021-09-19,10:00:00,386,224,162,FMN GV 05 Lier
60,Mechelsesteenweg 365,2021-09-19,11:00:00,454,230,224,FMN GV 05 Lier
60,Mechelsesteenweg 365,2021-09-19,12:00:00,346,150,196,FMN GV 05 Lier
60,Mechelsesteenweg 365,2021-09-19,13:00:00,340,204,136,FMN GV 05 Lier
60,Mechelsesteenweg 365,2021-09-19,14:00:00,608,340,268,FMN GV 05 Lier
60,Mechelsesteenweg 365,2021-09-19,15:00:00,400,170,230,FMN GV 05 Lier
60,Mechelsesteenweg 365,2021-09-19,16:00:00,380,126,254,FMN GV 05 Lier
60,Mechelsesteenweg 365,2021-09-19,17:00:00,252,86,166,FMN GV 05 Lier
60,Mechelsesteenweg 365,2021-09-19,18:00:00,100,32,68,FMN GV 05 Lier
60,Mechelsesteenweg 365,2021-09-19,19:00:00,60,8,52,FMN GV 05 Lier
60,Mechelsesteenweg 365,2021-09-19,20:00:00,22,8,14,FMN GV 05 Lier
60,Mechelsesteenweg 365,2021-09-19,21:00:00,2,2,0,FMN GV 05 Lier
60,Mechelsesteenweg 365,2021-09-19,22:00:00,4,0,4,FMN GV 05 Lier
60,Mechelsesteenweg 365,2021-09-19,23:00:00,4,0,4,FMN GV 05 Lier
60,Mechelsesteenweg 365,2021-09-20,00:00:00,2,2,0,FMN GV 05 Lier
60,Mechelsesteenweg 365,2021-09-20,01:00:00,0,0,0,FMN GV 05 Lier
60,Mechelsesteenweg 365,2021-09-20,02:00:00,0,0,0,FMN GV 05 Lier
60,Mechelsesteenweg 365,2021-09-20,03:00:00,2,0,2,FMN GV 05 Lier
60,Mechelsesteenweg 365,2021-09-20,04:00:00,2,0,2,FMN GV 05 Lier
60,Mechelsesteenweg 365,2021-09-20,05:00:00,12,0,12,FMN GV 05 Lier
60,Mechelsesteenweg 365,2021-09-20,06:00:00,24,10,14,FMN GV 05 Lier
60,Mechelsesteenweg 365,2021-09-20,07:00:00,238,152,86,FMN GV 05 Lier
60,Mechelsesteenweg 365,2021-09-20,08:00:00,206,114,92,FMN GV 05 Lier
60,Mechelsesteenweg 365,2021-09-20,09:00:00,154,68,86,FMN GV 05 Lier
60,Mechelsesteenweg 365,2021-09-20,10:00:00,60,34,26,FMN GV 05 Lier
60,Mechelsesteenweg 365,2021-09-20,11:00:00,128,60,68,FMN GV 05 Lier
60,Mechelsesteenweg 365,2021-09-20,12:00:00,88,42,46,FMN GV 05 Lier
60,Mechelsesteenweg 365,2021-09-20,13:00:00,136,72,64,FMN GV 05 Lier
60,Mechelsesteenweg 365,2021-09-20,14:00:00,240,128,112,FMN GV 05 Lier
60,Mechelsesteenweg 365,2021-09-20,15:00:00,240,126,114,FMN GV 05 Lier
60,Mechelsesteenweg 365,2021-09-20,16:00:00,360,106,254,FMN GV 05 Lier
60,Mechelsesteenweg 365,2021-09-20,17:00:00,192,110,82,FMN GV 05 Lier
60,Mechelsesteenweg 365,2021-09-20,18:00:00,96,56,40,FMN GV 05 Lier
60,Mechelsesteenweg 365,2021-09-20,19:00:00,68,32,36,FMN GV 05 Lier
60,Mechelsesteenweg 365,2021-09-20,20:00:00,20,4,16,FMN GV 05 Lier
60,Mechelsesteenweg 365,2021-09-20,21:00:00,12,2,10,FMN GV 05 Lier
60,Mechelsesteenweg 365,2021-09-20,22:00:00,6,0,6,FMN GV 05 Lier
60,Mechelsesteenweg 365,2021-09-20,23:00:00,0,0,0,FMN GV 05 Lier
60,Mechelsesteenweg 365,2021-09-21,00:00:00,0,0,0,FMN GV 05 Lier
60,Mechelsesteenweg 365,2021-09-21,01:00:00,0,0,0,FMN GV 05 Lier
60,Mechelsesteenweg 365,2021-09-21,02:00:00,0,0,0,FMN GV 05 Lier
60,Mechelsesteenweg 365,2021-09-21,03:00:00,2,0,2,FMN GV 05 Lier
60,Mechelsesteenweg 365,2021-09-21,04:00:00,2,0,2,FMN GV 05 Lier
60,Mechelsesteenweg 365,2021-09-21,05:00:00,8,0,8,FMN GV 05 Lier
60,Mechelsesteenweg 365,2021-09-21,06:00:00,40,16,24,FMN GV 05 Lier
60,Mechelsesteenweg 365,2021-09-21,07:00:00,228,142,86,FMN GV 05 Lier
60,Mechelsesteenweg 365,2021-09-21,08:00:00,252,158,94,FMN GV 05 Lier
60,Mechelsesteenweg 365,2021-09-21,09:00:00,216,166,50,FMN GV 05 Lier
60,Mechelsesteenweg 365,2021-09-21,10:00:00,174,72,102,FMN GV 05 Lier
60,Mechelsesteenweg 365,2021-09-21,11:00:00,154,84,70,FMN GV 05 Lier
60,Mechelsesteenweg 365,2021-09-21,12:00:00,186,116,70,FMN GV 05 Lier
60,Mechelsesteenweg 365,2021-09-21,13:00:00,262,116,146,FMN GV 05 Lier
60,Mechelsesteenweg 365,2021-09-21,14:00:00,476,188,288,FMN GV 05 Lier
60,Mechelsesteenweg 365,2021-09-21,15:00:00,326,148,178,FMN GV 05 Lier
60,Mechelsesteenweg 365,2021-09-21,16:00:00,522,178,344,FMN GV 05 Lier
60,Mechelsesteenweg 365,2021-09-21,17:00:00,252,136,116,FMN GV 05 Lier
60,Mechelsesteenweg 365,2021-09-21,18:00:00,130,76,54,FMN GV 05 Lier
60,Mechelsesteenweg 365,2021-09-21,19:00:00,72,36,36,FMN GV 05 Lier
60,Mechelsesteenweg 365,2021-09-21,20:00:00,36,16,20,FMN GV 05 Lier
60,Mechelsesteenweg 365,2021-09-21,21:00:00,18,2,16,FMN GV 05 Lier
60,Mechelsesteenweg 365,2021-09-21,22:00:00,10,6,4,FMN GV 05 Lier
60,Mechelsesteenweg 365,2021-09-21,23:00:00,4,2,2,FMN GV 05 Lier
60,Mechelsesteenweg 365,2021-09-22,00:00:00,0,0,0,FMN GV 05 Lier
60,Mechelsesteenweg 365,2021-09-22,01:00:00,2,2,0,FMN GV 05 Lier
60,Mechelsesteenweg 365,2021-09-22,02:00:00,0,0,0,FMN GV 05 Lier
60,Mechelsesteenweg 365,2021-09-22,03:00:00,2,0,2,FMN GV 05 Lier
60,Mechelsesteenweg 365,2021-09-22,04:00:00,4,0,4,FMN GV 05 Lier
60,Mechelsesteenweg 365,2021-09-22,05:00:00,6,0,6,FMN GV 05 Lier
60,Mechelsesteenweg 365,2021-09-22,06:00:00,26,4,22,FMN GV 05 Lier
60,Mechelsesteenweg 365,2021-09-22,07:00:00,238,162,76,FMN GV 05 Lier
60,Mechelsesteenweg 365,2021-09-22,08:00:00,192,134,58,FMN GV 05 Lier
60,Mechelsesteenweg 365,2021-09-22,09:00:00,176,152,24,FMN GV 05 Lier
60,Mechelsesteenweg 365,2021-09-22,10:00:00,138,58,80,FMN GV 05 Lier
60,Mechelsesteenweg 365,2021-09-22,11:00:00,194,84,110,FMN GV 05 Lier
60,Mechelsesteenweg 365,2021-09-22,12:00:00,504,112,392,FMN GV 05 Lier
60,Mechelsesteenweg 365,2021-09-22,13:00:00,256,146,110,FMN GV 05 Lier
60,Mechelsesteenweg 365,2021-09-22,14:00:00,356,182,174,FMN GV 05 Lier
60,Mechelsesteenweg 365,2021-09-22,15:00:00,364,182,182,FMN GV 05 Lier
60,Mechelsesteenweg 365,2021-09-22,16:00:00,290,114,176,FMN GV 05 Lier
60,Mechelsesteenweg 365,2021-09-22,17:00:00,298,164,134,FMN GV 05 Lier
60,Mechelsesteenweg 365,2021-09-22,18:00:00,160,82,78,FMN GV 05 Lier
60,Mechelsesteenweg 365,2021-09-22,19:00:00,166,114,52,FMN GV 05 Lier
60,Mechelsesteenweg 365,2021-09-22,20:00:00,58,40,18,FMN GV 05 Lier
60,Mechelsesteenweg 365,2021-09-22,21:00:00,14,10,4,FMN GV 05 Lier
60,Mechelsesteenweg 365,2021-09-22,22:00:00,16,12,4,FMN GV 05 Lier
60,Mechelsesteenweg 365,2021-09-22,23:00:00,0,0,0,FMN GV 05 Lier
60,Mechelsesteenweg 365,2021-09-23,00:00:00,0,0,0,FMN GV 05 Lier
60,Mechelsesteenweg 365,2021-09-23,01:00:00,0,0,0,FMN GV 05 Lier
60,Mechelsesteenweg 365,2021-09-23,02:00:00,2,2,0,FMN GV 05 Lier
60,Mechelsesteenweg 365,2021-09-23,03:00:00,0,0,0,FMN GV 05 Lier
60,Mechelsesteenweg 365,2021-09-23,04:00:00,6,0,6,FMN GV 05 Lier
60,Mechelsesteenweg 365,2021-09-23,05:00:00,4,0,4,FMN GV 05 Lier
60,Mechelsesteenweg 365,2021-09-23,06:00:00,26,6,20,FMN GV 05 Lier
60,Mechelsesteenweg 365,2021-09-23,07:00:00,230,156,74,FMN GV 05 Lier
60,Mechelsesteenweg 365,2021-09-23,08:00:00,204,126,78,FMN GV 05 Lier
60,Mechelsesteenweg 365,2021-09-23,09:00:00,94,50,44,FMN GV 05 Lier
60,Mechelsesteenweg 365,2021-09-23,10:00:00,94,58,36,FMN GV 05 Lier
60,Mechelsesteenweg 365,2021-09-23,11:00:00,116,62,54,FMN GV 05 Lier
60,Mechelsesteenweg 365,2021-09-23,12:00:00,132,74,58,FMN GV 05 Lier
60,Mechelsesteenweg 365,2021-09-23,13:00:00,128,64,64,FMN GV 05 Lier
60,Mechelsesteenweg 365,2021-09-23,14:00:00,234,84,150,FMN GV 05 Lier
60,Mechelsesteenweg 365,2021-09-23,15:00:00,238,104,134,FMN GV 05 Lier
60,Mechelsesteenweg 365,2021-09-23,16:00:00,346,126,220,FMN GV 05 Lier
60,Mechelsesteenweg 365,2021-09-23,17:00:00,206,106,100,FMN GV 05 Lier
60,Mechelsesteenweg 365,2021-09-23,18:00:00,128,64,64,FMN GV 05 Lier
60,Mechelsesteenweg 365,2021-09-23,19:00:00,76,48,28,FMN GV 05 Lier
60,Mechelsesteenweg 365,2021-09-23,20:00:00,50,32,18,FMN GV 05 Lier
60,Mechelsesteenweg 365,2021-09-23,21:00:00,22,4,18,FMN GV 05 Lier
60,Mechelsesteenweg 365,2021-09-23,22:00:00,14,12,2,FMN GV 05 Lier
60,Mechelsesteenweg 365,2021-09-23,23:00:00,0,0,0,FMN GV 05 Lier
60,Mechelsesteenweg 365,2021-09-24,00:00:00,0,0,0,FMN GV 05 Lier
60,Mechelsesteenweg 365,2021-09-24,01:00:00,0,0,0,FMN GV 05 Lier
60,Mechelsesteenweg 365,2021-09-24,02:00:00,0,0,0,FMN GV 05 Lier
60,Mechelsesteenweg 365,2021-09-24,03:00:00,2,0,2,FMN GV 05 Lier
60,Mechelsesteenweg 365,2021-09-24,04:00:00,2,0,2,FMN GV 05 Lier
60,Mechelsesteenweg 365,2021-09-24,05:00:00,4,0,4,FMN GV 05 Lier
60,Mechelsesteenweg 365,2021-09-24,06:00:00,30,12,18,FMN GV 05 Lier
60,Mechelsesteenweg 365,2021-09-24,07:00:00,252,146,106,FMN GV 05 Lier
60,Mechelsesteenweg 365,2021-09-24,08:00:00,214,134,80,FMN GV 05 Lier
60,Mechelsesteenweg 365,2021-09-24,09:00:00,152,116,36,FMN GV 05 Lier
60,Mechelsesteenweg 365,2021-09-24,10:00:00,88,46,42,FMN GV 05 Lier
60,Mechelsesteenweg 365,2021-09-24,11:00:00,132,62,70,FMN GV 05 Lier
60,Mechelsesteenweg 365,2021-09-24,12:00:00,98,46,52,FMN GV 05 Lier
60,Mechelsesteenweg 365,2021-09-24,13:00:00,122,44,78,FMN GV 05 Lier
60,Mechelsesteenweg 365,2021-09-24,14:00:00,196,108,88,FMN GV 05 Lier
60,Mechelsesteenweg 365,2021-09-24,15:00:00,326,128,198,FMN GV 05 Lier
60,Mechelsesteenweg 365,2021-09-24,16:00:00,366,126,240,FMN GV 05 Lier
60,Mechelsesteenweg 365,2021-09-24,17:00:00,140,80,60,FMN GV 05 Lier
60,Mechelsesteenweg 365,2021-09-24,18:00:00,90,48,42,FMN GV 05 Lier
60,Mechelsesteenweg 365,2021-09-24,19:00:00,88,56,32,FMN GV 05 Lier
60,Mechelsesteenweg 365,2021-09-24,20:00:00,24,14,10,FMN GV 05 Lier
60,Mechelsesteenweg 365,2021-09-24,21:00:00,10,2,8,FMN GV 05 Lier
60,Mechelsesteenweg 365,2021-09-24,22:00:00,12,4,8,FMN GV 05 Lier
60,Mechelsesteenweg 365,2021-09-24,23:00:00,6,2,4,FMN GV 05 Lier
60,Mechelsesteenweg 365,2021-09-25,00:00:00,4,2,2,FMN GV 05 Lier
60,Mechelsesteenweg 365,2021-09-25,01:00:00,8,4,4,FMN GV 05 Lier
60,Mechelsesteenweg 365,2021-09-25,02:00:00,2,0,2,FMN GV 05 Lier
60,Mechelsesteenweg 365,2021-09-25,03:00:00,0,0,0,FMN GV 05 Lier
60,Mechelsesteenweg 365,2021-09-25,04:00:00,0,0,0,FMN GV 05 Lier
60,Mechelsesteenweg 365,2021-09-25,05:00:00,2,2,0,FMN GV 05 Lier
60,Mechelsesteenweg 365,2021-09-25,06:00:00,2,0,2,FMN GV 05 Lier
60,Mechelsesteenweg 365,2021-09-25,07:00:00,20,14,6,FMN GV 05 Lier
60,Mechelsesteenweg 365,2021-09-25,08:00:00,38,20,18,FMN GV 05 Lier
60,Mechelsesteenweg 365,2021-09-25,09:00:00,94,48,46,FMN GV 05 Lier
60,Mechelsesteenweg 365,2021-09-25,10:00:00,244,146,98,FMN GV 05 Lier
60,Mechelsesteenweg 365,2021-09-25,11:00:00,350,164,186,FMN GV 05 Lier
60,Mechelsesteenweg 365,2021-09-25,12:00:00,234,122,112,FMN GV 05 Lier
60,Mechelsesteenweg 365,2021-09-25,13:00:00,286,146,140,FMN GV 05 Lier
60,Mechelsesteenweg 365,2021-09-25,14:00:00,484,248,236,FMN GV 05 Lier
60,Mechelsesteenweg 365,2021-09-25,15:00:00,460,222,238,FMN GV 05 Lier
60,Mechelsesteenweg 365,2021-09-25,16:00:00,388,144,244,FMN GV 05 Lier
60,Mechelsesteenweg 365,2021-09-25,17:00:00,226,92,134,FMN GV 05 Lier
60,Mechelsesteenweg 365,2021-09-25,18:00:00,148,36,112,FMN GV 05 Lier
60,Mechelsesteenweg 365,2021-09-25,19:00:00,44,12,32,FMN GV 05 Lier
60,Mechelsesteenweg 365,2021-09-25,20:00:00,28,10,18,FMN GV 05 Lier
60,Mechelsesteenweg 365,2021-09-25,21:00:00,20,14,6,FMN GV 05 Lier
60,Mechelsesteenweg 365,2021-09-25,22:00:00,20,16,4,FMN GV 05 Lier
60,Mechelsesteenweg 365,2021-09-25,23:00:00,28,8,20,FMN GV 05 Lier
60,Mechelsesteenweg 365,2021-09-26,00:00:00,6,0,6,FMN GV 05 Lier
60,Mechelsesteenweg 365,2021-09-26,01:00:00,10,2,8,FMN GV 05 Lier
60,Mechelsesteenweg 365,2021-09-26,02:00:00,0,0,0,FMN GV 05 Lier
60,Mechelsesteenweg 365,2021-09-26,03:00:00,6,6,0,FMN GV 05 Lier
60,Mechelsesteenweg 365,2021-09-26,04:00:00,0,0,0,FMN GV 05 Lier
60,Mechelsesteenweg 365,2021-09-26,05:00:00,2,2,0,FMN GV 05 Lier
60,Mechelsesteenweg 365,2021-09-26,06:00:00,2,2,0,FMN GV 05 Lier
60,Mechelsesteenweg 365,2021-09-26,07:00:00,18,4,14,FMN GV 05 Lier
60,Mechelsesteenweg 365,2021-09-26,08:00:00,46,24,22,FMN GV 05 Lier
60,Mechelsesteenweg 365,2021-09-26,09:00:00,254,104,150,FMN GV 05 Lier
60,Mechelsesteenweg 365,2021-09-26,10:00:00,456,184,272,FMN GV 05 Lier
60,Mechelsesteenweg 365,2021-09-26,11:00:00,460,352,108,FMN GV 05 Lier
60,Mechelsesteenweg 365,2021-09-26,12:00:00,352,218,134,FMN GV 05 Lier
60,Mechelsesteenweg 365,2021-09-26,13:00:00,286,150,136,FMN GV 05 Lier
60,Mechelsesteenweg 365,2021-09-26,14:00:00,322,160,162,FMN GV 05 Lier
60,Mechelsesteenweg 365,2021-09-26,15:00:00,240,118,122,FMN GV 05 Lier
60,Mechelsesteenweg 365,2021-09-26,16:00:00,242,100,142,FMN GV 05 Lier
60,Mechelsesteenweg 365,2021-09-26,17:00:00,118,46,72,FMN GV 05 Lier
60,Mechelsesteenweg 365,2021-09-26,18:00:00,86,44,42,FMN GV 05 Lier
60,Mechelsesteenweg 365,2021-09-26,19:00:00,40,30,10,FMN GV 05 Lier
60,Mechelsesteenweg 365,2021-09-26,20:00:00,16,4,12,FMN GV 05 Lier
60,Mechelsesteenweg 365,2021-09-26,21:00:00,14,0,14,FMN GV 05 Lier
60,Mechelsesteenweg 365,2021-09-26,22:00:00,2,2,0,FMN GV 05 Lier
60,Mechelsesteenweg 365,2021-09-26,23:00:00,4,0,4,FMN GV 05 Lier
60,Mechelsesteenweg 365,2021-09-27,00:00:00,4,2,2,FMN GV 05 Lier
60,Mechelsesteenweg 365,2021-09-27,01:00:00,0,0,0,FMN GV 05 Lier
60,Mechelsesteenweg 365,2021-09-27,02:00:00,2,0,2,FMN GV 05 Lier
60,Mechelsesteenweg 365,2021-09-27,03:00:00,2,0,2,FMN GV 05 Lier
60,Mechelsesteenweg 365,2021-09-27,04:00:00,2,0,2,FMN GV 05 Lier
60,Mechelsesteenweg 365,2021-09-27,05:00:00,6,2,4,FMN GV 05 Lier
60,Mechelsesteenweg 365,2021-09-27,06:00:00,26,4,22,FMN GV 05 Lier
60,Mechelsesteenweg 365,2021-09-27,07:00:00,250,166,84,FMN GV 05 Lier
60,Mechelsesteenweg 365,2021-09-27,08:00:00,172,116,56,FMN GV 05 Lier
60,Mechelsesteenweg 365,2021-09-27,09:00:00,42,22,20,FMN GV 05 Lier
60,Mechelsesteenweg 365,2021-09-27,10:00:00,66,30,36,FMN GV 05 Lier
60,Mechelsesteenweg 365,2021-09-27,11:00:00,50,28,22,FMN GV 05 Lier
60,Mechelsesteenweg 365,2021-09-27,12:00:00,60,42,18,FMN GV 05 Lier
60,Mechelsesteenweg 365,2021-09-27,13:00:00,44,30,14,FMN GV 05 Lier
60,Mechelsesteenweg 365,2021-09-27,14:00:00,46,24,22,FMN GV 05 Lier
60,Mechelsesteenweg 365,2021-09-27,15:00:00,66,30,36,FMN GV 05 Lier
60,Mechelsesteenweg 365,2021-09-27,16:00:00,290,78,212,FMN GV 05 Lier
60,Mechelsesteenweg 365,2021-09-27,17:00:00,114,62,52,FMN GV 05 Lier
60,Mechelsesteenweg 365,2021-09-27,18:00:00,62,38,24,FMN GV 05 Lier
60,Mechelsesteenweg 365,2021-09-27,19:00:00,32,16,16,FMN GV 05 Lier
60,Mechelsesteenweg 365,2021-09-27,20:00:00,14,6,8,FMN GV 05 Lier
60,Mechelsesteenweg 365,2021-09-27,21:00:00,8,2,6,FMN GV 05 Lier
60,Mechelsesteenweg 365,2021-09-27,22:00:00,6,4,2,FMN GV 05 Lier
60,Mechelsesteenweg 365,2021-09-27,23:00:00,0,0,0,FMN GV 05 Lier
60,Mechelsesteenweg 365,2021-09-28,00:00:00,2,0,2,FMN GV 05 Lier
60,Mechelsesteenweg 365,2021-09-28,01:00:00,0,0,0,FMN GV 05 Lier
60,Mechelsesteenweg 365,2021-09-28,02:00:00,0,0,0,FMN GV 05 Lier
60,Mechelsesteenweg 365,2021-09-28,03:00:00,2,0,2,FMN GV 05 Lier
60,Mechelsesteenweg 365,2021-09-28,04:00:00,0,0,0,FMN GV 05 Lier
60,Mechelsesteenweg 365,2021-09-28,05:00:00,6,0,6,FMN GV 05 Lier
60,Mechelsesteenweg 365,2021-09-28,06:00:00,30,4,26,FMN GV 05 Lier
60,Mechelsesteenweg 365,2021-09-28,07:00:00,256,164,92,FMN GV 05 Lier
60,Mechelsesteenweg 365,2021-09-28,08:00:00,196,130,66,FMN GV 05 Lier
60,Mechelsesteenweg 365,2021-09-28,09:00:00,106,46,60,FMN GV 05 Lier
60,Mechelsesteenweg 365,2021-09-28,10:00:00,188,86,102,FMN GV 05 Lier
60,Mechelsesteenweg 365,2021-09-28,11:00:00,176,94,82,FMN GV 05 Lier
60,Mechelsesteenweg 365,2021-09-28,12:00:00,188,122,66,FMN GV 05 Lier
60,Mechelsesteenweg 365,2021-09-28,13:00:00,270,122,148,FMN GV 05 Lier
60,Mechelsesteenweg 365,2021-09-28,14:00:00,328,204,124,FMN GV 05 Lier
60,Mechelsesteenweg 365,2021-09-28,15:00:00,264,126,138,FMN GV 05 Lier
60,Mechelsesteenweg 365,2021-09-28,16:00:00,500,162,338,FMN GV 05 Lier
60,Mechelsesteenweg 365,2021-09-28,17:00:00,192,104,88,FMN GV 05 Lier
60,Mechelsesteenweg 365,2021-09-28,18:00:00,146,82,64,FMN GV 05 Lier
60,Mechelsesteenweg 365,2021-09-28,19:00:00,102,32,70,FMN GV 05 Lier
60,Mechelsesteenweg 365,2021-09-28,20:00:00,44,26,18,FMN GV 05 Lier
60,Mechelsesteenweg 365,2021-09-28,21:00:00,14,8,6,FMN GV 05 Lier
60,Mechelsesteenweg 365,2021-09-28,22:00:00,12,8,4,FMN GV 05 Lier
60,Mechelsesteenweg 365,2021-09-28,23:00:00,4,2,2,FMN GV 05 Lier
60,Mechelsesteenweg 365,2021-09-29,00:00:00,0,0,0,FMN GV 05 Lier
60,Mechelsesteenweg 365,2021-09-29,01:00:00,0,0,0,FMN GV 05 Lier
60,Mechelsesteenweg 365,2021-09-29,02:00:00,0,0,0,FMN GV 05 Lier
60,Mechelsesteenweg 365,2021-09-29,03:00:00,2,0,2,FMN GV 05 Lier
60,Mechelsesteenweg 365,2021-09-29,04:00:00,0,0,0,FMN GV 05 Lier
60,Mechelsesteenweg 365,2021-09-29,05:00:00,4,2,2,FMN GV 05 Lier
60,Mechelsesteenweg 365,2021-09-29,06:00:00,20,4,16,FMN GV 05 Lier
60,Mechelsesteenweg 365,2021-09-29,07:00:00,176,128,48,FMN GV 05 Lier
60,Mechelsesteenweg 365,2021-09-29,08:00:00,112,80,32,FMN GV 05 Lier
60,Mechelsesteenweg 365,2021-09-29,09:00:00,16,10,6,FMN GV 05 Lier
60,Mechelsesteenweg 365,2021-09-29,10:00:00,52,18,34,FMN GV 05 Lier
60,Mechelsesteenweg 365,2021-09-29,11:00:00,32,14,18,FMN GV 05 Lier
60,Mechelsesteenweg 365,2021-09-29,12:00:00,184,32,152,FMN GV 05 Lier
60,Mechelsesteenweg 365,2021-09-29,13:00:00,48,12,36,FMN GV 05 Lier
60,Mechelsesteenweg 365,2021-09-29,14:00:00,44,34,10,FMN GV 05 Lier
60,Mechelsesteenweg 365,2021-09-29,15:00:00,50,24,26,FMN GV 05 Lier
60,Mechelsesteenweg 365,2021-09-29,16:00:00,76,50,26,FMN GV 05 Lier
60,Mechelsesteenweg 365,2021-09-29,17:00:00,66,44,22,FMN GV 05 Lier
60,Mechelsesteenweg 365,2021-09-29,18:00:00,40,24,16,FMN GV 05 Lier
60,Mechelsesteenweg 365,2021-09-29,19:00:00,8,2,6,FMN GV 05 Lier
60,Mechelsesteenweg 365,2021-09-29,20:00:00,12,6,6,FMN GV 05 Lier
60,Mechelsesteenweg 365,2021-09-29,21:00:00,22,12,10,FMN GV 05 Lier
60,Mechelsesteenweg 365,2021-09-29,22:00:00,2,2,0,FMN GV 05 Lier
60,Mechelsesteenweg 365,2021-09-29,23:00:00,0,0,0,FMN GV 05 Lier
60,Mechelsesteenweg 365,2021-09-30,00:00:00,0,0,0,FMN GV 05 Lier
60,Mechelsesteenweg 365,2021-09-30,01:00:00,0,0,0,FMN GV 05 Lier
60,Mechelsesteenweg 365,2021-09-30,02:00:00,0,0,0,FMN GV 05 Lier
60,Mechelsesteenweg 365,2021-09-30,03:00:00,4,0,4,FMN GV 05 Lier
60,Mechelsesteenweg 365,2021-09-30,04:00:00,0,0,0,FMN GV 05 Lier
60,Mechelsesteenweg 365,2021-09-30,05:00:00,8,4,4,FMN GV 05 Lier
60,Mechelsesteenweg 365,2021-09-30,06:00:00,24,4,20,FMN GV 05 Lier
60,Mechelsesteenweg 365,2021-09-30,07:00:00,212,138,74,FMN GV 05 Lier
60,Mechelsesteenweg 365,2021-09-30,08:00:00,214,152,62,FMN GV 05 Lier
60,Mechelsesteenweg 365,2021-09-30,09:00:00,84,56,28,FMN GV 05 Lier
60,Mechelsesteenweg 365,2021-09-30,10:00:00,180,126,54,FMN GV 05 Lier
60,Mechelsesteenweg 365,2021-09-30,11:00:00,120,60,60,FMN GV 05 Lier
60,Mechelsesteenweg 365,2021-09-30,12:00:00,92,64,28,FMN GV 05 Lier
60,Mechelsesteenweg 365,2021-09-30,13:00:00,138,102,36,FMN GV 05 Lier
60,Mechelsesteenweg 365,2021-09-30,14:00:00,174,78,96,FMN GV 05 Lier
60,Mechelsesteenweg 365,2021-09-30,15:00:00,160,82,78,FMN GV 05 Lier
60,Mechelsesteenweg 365,2021-09-30,16:00:00,358,96,262,FMN GV 05 Lier
60,Mechelsesteenweg 365,2021-09-30,17:00:00,108,62,46,FMN GV 05 Lier
60,Mechelsesteenweg 365,2021-09-30,18:00:00,130,80,50,FMN GV 05 Lier
60,Mechelsesteenweg 365,2021-09-30,19:00:00,36,26,10,FMN GV 05 Lier
60,Mechelsesteenweg 365,2021-09-30,20:00:00,8,2,6,FMN GV 05 Lier
60,Mechelsesteenweg 365,2021-09-30,21:00:00,22,8,14,FMN GV 05 Lier
60,Mechelsesteenweg 365,2021-09-30,22:00:00,4,4,0,FMN GV 05 Lier
60,Mechelsesteenweg 365,2021-09-30,23:00:00,2,0,2,FMN GV 05 Lier
60,Mechelsesteenweg 365,2021-10-01,00:00:00,0,0,0,FMN GV 05 Lier
60,Mechelsesteenweg 365,2021-10-01,01:00:00,0,0,0,FMN GV 05 Lier
60,Mechelsesteenweg 365,2021-10-01,02:00:00,0,0,0,FMN GV 05 Lier
60,Mechelsesteenweg 365,2021-10-01,03:00:00,2,0,2,FMN GV 05 Lier
60,Mechelsesteenweg 365,2021-10-01,04:00:00,0,0,0,FMN GV 05 Lier
60,Mechelsesteenweg 365,2021-10-01,05:00:00,4,0,4,FMN GV 05 Lier
60,Mechelsesteenweg 365,2021-10-01,06:00:00,18,8,10,FMN GV 05 Lier
60,Mechelsesteenweg 365,2021-10-01,07:00:00,188,122,66,FMN GV 05 Lier
60,Mechelsesteenweg 365,2021-10-01,08:00:00,302,134,168,FMN GV 05 Lier
60,Mechelsesteenweg 365,2021-10-01,09:00:00,60,32,28,FMN GV 05 Lier
60,Mechelsesteenweg 365,2021-10-01,10:00:00,56,30,26,FMN GV 05 Lier
60,Mechelsesteenweg 365,2021-10-01,11:00:00,40,26,14,FMN GV 05 Lier
60,Mechelsesteenweg 365,2021-10-01,12:00:00,114,78,36,FMN GV 05 Lier
60,Mechelsesteenweg 365,2021-10-01,13:00:00,74,42,32,FMN GV 05 Lier
60,Mechelsesteenweg 365,2021-10-01,14:00:00,66,46,20,FMN GV 05 Lier
60,Mechelsesteenweg 365,2021-10-01,15:00:00,248,142,106,FMN GV 05 Lier
60,Mechelsesteenweg 365,2021-10-01,16:00:00,242,68,174,FMN GV 05 Lier
60,Mechelsesteenweg 365,2021-10-01,17:00:00,104,64,40,FMN GV 05 Lier
60,Mechelsesteenweg 365,2021-10-01,18:00:00,26,10,16,FMN GV 05 Lier
60,Mechelsesteenweg 365,2021-10-01,19:00:00,16,8,8,FMN GV 05 Lier
60,Mechelsesteenweg 365,2021-10-01,20:00:00,12,12,0,FMN GV 05 Lier
60,Mechelsesteenweg 365,2021-10-01,21:00:00,2,0,2,FMN GV 05 Lier
60,Mechelsesteenweg 365,2021-10-01,22:00:00,20,12,8,FMN GV 05 Lier
60,Mechelsesteenweg 365,2021-10-01,23:00:00,0,0,0,FMN GV 05 Lier
60,Mechelsesteenweg 365,2021-10-02,00:00:00,2,0,2,FMN GV 05 Lier
60,Mechelsesteenweg 365,2021-10-02,01:00:00,0,0,0,FMN GV 05 Lier
60,Mechelsesteenweg 365,2021-10-02,02:00:00,0,0,0,FMN GV 05 Lier
60,Mechelsesteenweg 365,2021-10-02,03:00:00,0,0,0,FMN GV 05 Lier
60,Mechelsesteenweg 365,2021-10-02,04:00:00,0,0,0,FMN GV 05 Lier
60,Mechelsesteenweg 365,2021-10-02,05:00:00,0,0,0,FMN GV 05 Lier
60,Mechelsesteenweg 365,2021-10-02,06:00:00,6,4,2,FMN GV 05 Lier
60,Mechelsesteenweg 365,2021-10-02,07:00:00,12,8,4,FMN GV 05 Lier
60,Mechelsesteenweg 365,2021-10-02,08:00:00,24,8,16,FMN GV 05 Lier
60,Mechelsesteenweg 365,2021-10-02,09:00:00,74,34,40,FMN GV 05 Lier
60,Mechelsesteenweg 365,2021-10-02,10:00:00,154,68,86,FMN GV 05 Lier
60,Mechelsesteenweg 365,2021-10-02,11:00:00,194,98,96,FMN GV 05 Lier
60,Mechelsesteenweg 365,2021-10-02,12:00:00,122,64,58,FMN GV 05 Lier
60,Mechelsesteenweg 365,2021-10-02,13:00:00,126,68,58,FMN GV 05 Lier
60,Mechelsesteenweg 365,2021-10-02,14:00:00,118,70,48,FMN GV 05 Lier
60,Mechelsesteenweg 365,2021-10-02,15:00:00,120,48,72,FMN GV 05 Lier
60,Mechelsesteenweg 365,2021-10-02,16:00:00,72,36,36,FMN GV 05 Lier
60,Mechelsesteenweg 365,2021-10-02,17:00:00,38,20,18,FMN GV 05 Lier
60,Mechelsesteenweg 365,2021-10-02,18:00:00,18,16,2,FMN GV 05 Lier
60,Mechelsesteenweg 365,2021-10-02,19:00:00,8,6,2,FMN GV 05 Lier
60,Mechelsesteenweg 365,2021-10-02,20:00:00,12,4,8,FMN GV 05 Lier
60,Mechelsesteenweg 365,2021-10-02,21:00:00,0,0,0,FMN GV 05 Lier
60,Mechelsesteenweg 365,2021-10-02,22:00:00,4,0,4,FMN GV 05 Lier
60,Mechelsesteenweg 365,2021-10-02,23:00:00,4,2,2,FMN GV 05 Lier
60,Mechelsesteenweg 365,2021-10-03,00:00:00,0,0,0,FMN GV 05 Lier
60,Mechelsesteenweg 365,2021-10-03,01:00:00,2,0,2,FMN GV 05 Lier
60,Mechelsesteenweg 365,2021-10-03,02:00:00,2,0,2,FMN GV 05 Lier
60,Mechelsesteenweg 365,2021-10-03,03:00:00,2,0,2,FMN GV 05 Lier
60,Mechelsesteenweg 365,2021-10-03,04:00:00,0,0,0,FMN GV 05 Lier
60,Mechelsesteenweg 365,2021-10-03,05:00:00,2,0,2,FMN GV 05 Lier
60,Mechelsesteenweg 365,2021-10-03,06:00:00,4,2,2,FMN GV 05 Lier
60,Mechelsesteenweg 365,2021-10-03,07:00:00,2,0,2,FMN GV 05 Lier
60,Mechelsesteenweg 365,2021-10-03,08:00:00,4,2,2,FMN GV 05 Lier
60,Mechelsesteenweg 365,2021-10-03,09:00:00,10,8,2,FMN GV 05 Lier
60,Mechelsesteenweg 365,2021-10-03,10:00:00,12,6,6,FMN GV 05 Lier
60,Mechelsesteenweg 365,2021-10-03,11:00:00,50,14,36,FMN GV 05 Lier
60,Mechelsesteenweg 365,2021-10-03,12:00:00,20,12,8,FMN GV 05 Lier
60,Mechelsesteenweg 365,2021-10-03,13:00:00,14,8,6,FMN GV 05 Lier
60,Mechelsesteenweg 365,2021-10-03,14:00:00,6,6,0,FMN GV 05 Lier
60,Mechelsesteenweg 365,2021-10-03,15:00:00,10,6,4,FMN GV 05 Lier
60,Mechelsesteenweg 365,2021-10-03,16:00:00,30,18,12,FMN GV 05 Lier
60,Mechelsesteenweg 365,2021-10-03,17:00:00,20,4,16,FMN GV 05 Lier
60,Mechelsesteenweg 365,2021-10-03,18:00:00,32,16,16,FMN GV 05 Lier
60,Mechelsesteenweg 365,2021-10-03,19:00:00,12,8,4,FMN GV 05 Lier
60,Mechelsesteenweg 365,2021-10-03,20:00:00,8,0,8,FMN GV 05 Lier
60,Mechelsesteenweg 365,2021-10-03,21:00:00,2,0,2,FMN GV 05 Lier
60,Mechelsesteenweg 365,2021-10-03,22:00:00,0,0,0,FMN GV 05 Lier
60,Mechelsesteenweg 365,2021-10-03,23:00:00,0,0,0,FMN GV 05 Lier
60,Mechelsesteenweg 365,2021-10-04,00:00:00,0,0,0,FMN GV 05 Lier
60,Mechelsesteenweg 365,2021-10-04,01:00:00,0,0,0,FMN GV 05 Lier
60,Mechelsesteenweg 365,2021-10-04,02:00:00,0,0,0,FMN GV 05 Lier
60,Mechelsesteenweg 365,2021-10-04,03:00:00,2,0,2,FMN GV 05 Lier
60,Mechelsesteenweg 365,2021-10-04,04:00:00,2,0,2,FMN GV 05 Lier
60,Mechelsesteenweg 365,2021-10-04,05:00:00,6,0,6,FMN GV 05 Lier
60,Mechelsesteenweg 365,2021-10-04,06:00:00,30,10,20,FMN GV 05 Lier
60,Mechelsesteenweg 365,2021-10-04,07:00:00,120,44,76,FMN GV 05 Lier
60,Mechelsesteenweg 365,2021-10-04,08:00:00,82,40,42,FMN GV 05 Lier
60,Mechelsesteenweg 365,2021-10-04,09:00:00,66,18,48,FMN GV 05 Lier
60,Mechelsesteenweg 365,2021-10-04,10:00:00,112,56,56,FMN GV 05 Lier
60,Mechelsesteenweg 365,2021-10-04,11:00:00,122,78,44,FMN GV 05 Lier
60,Mechelsesteenweg 365,2021-10-04,12:00:00,134,64,70,FMN GV 05 Lier
60,Mechelsesteenweg 365,2021-10-04,13:00:00,170,94,76,FMN GV 05 Lier
60,Mechelsesteenweg 365,2021-10-04,14:00:00,212,116,96,FMN GV 05 Lier
60,Mechelsesteenweg 365,2021-10-04,15:00:00,172,96,76,FMN GV 05 Lier
60,Mechelsesteenweg 365,2021-10-04,16:00:00,180,112,68,FMN GV 05 Lier
60,Mechelsesteenweg 365,2021-10-04,17:00:00,176,112,64,FMN GV 05 Lier
60,Mechelsesteenweg 365,2021-10-04,18:00:00,68,34,34,FMN GV 05 Lier
60,Mechelsesteenweg 365,2021-10-04,19:00:00,26,20,6,FMN GV 05 Lier
60,Mechelsesteenweg 365,2021-10-04,20:00:00,12,4,8,FMN GV 05 Lier
60,Mechelsesteenweg 365,2021-10-04,21:00:00,16,6,10,FMN GV 05 Lier
60,Mechelsesteenweg 365,2021-10-04,22:00:00,4,2,2,FMN GV 05 Lier
60,Mechelsesteenweg 365,2021-10-04,23:00:00,4,2,2,FMN GV 05 Lier
60,Mechelsesteenweg 365,2021-10-05,00:00:00,0,0,0,FMN GV 05 Lier
60,Mechelsesteenweg 365,2021-10-05,01:00:00,2,2,0,FMN GV 05 Lier
60,Mechelsesteenweg 365,2021-10-05,02:00:00,0,0,0,FMN GV 05 Lier
60,Mechelsesteenweg 365,2021-10-05,03:00:00,2,0,2,FMN GV 05 Lier
60,Mechelsesteenweg 365,2021-10-05,04:00:00,2,0,2,FMN GV 05 Lier
60,Mechelsesteenweg 365,2021-10-05,05:00:00,8,0,8,FMN GV 05 Lier
60,Mechelsesteenweg 365,2021-10-05,06:00:00,24,10,14,FMN GV 05 Lier
60,Mechelsesteenweg 365,2021-10-05,07:00:00,194,132,62,FMN GV 05 Lier
60,Mechelsesteenweg 365,2021-10-05,08:00:00,232,150,82,FMN GV 05 Lier
60,Mechelsesteenweg 365,2021-10-05,09:00:00,88,50,38,FMN GV 05 Lier
60,Mechelsesteenweg 365,2021-10-05,10:00:00,108,68,40,FMN GV 05 Lier
60,Mechelsesteenweg 365,2021-10-05,11:00:00,56,38,18,FMN GV 05 Lier
60,Mechelsesteenweg 365,2021-10-05,12:00:00,46,26,20,FMN GV 05 Lier
60,Mechelsesteenweg 365,2021-10-05,13:00:00,28,18,10,FMN GV 05 Lier
60,Mechelsesteenweg 365,2021-10-05,14:00:00,18,12,6,FMN GV 05 Lier
60,Mechelsesteenweg 365,2021-10-05,15:00:00,70,28,42,FMN GV 05 Lier
60,Mechelsesteenweg 365,2021-10-05,16:00:00,308,80,228,FMN GV 05 Lier
60,Mechelsesteenweg 365,2021-10-05,17:00:00,100,58,42,FMN GV 05 Lier
60,Mechelsesteenweg 365,2021-10-05,18:00:00,64,48,16,FMN GV 05 Lier
60,Mechelsesteenweg 365,2021-10-05,19:00:00,22,10,12,FMN GV 05 Lier
60,Mechelsesteenweg 365,2021-10-05,20:00:00,12,2,10,FMN GV 05 Lier
60,Mechelsesteenweg 365,2021-10-05,21:00:00,10,2,8,FMN GV 05 Lier
60,Mechelsesteenweg 365,2021-10-05,22:00:00,10,4,6,FMN GV 05 Lier
60,Mechelsesteenweg 365,2021-10-05,23:00:00,4,0,4,FMN GV 05 Lier
60,Mechelsesteenweg 365,2021-10-06,00:00:00,0,0,0,FMN GV 05 Lier
60,Mechelsesteenweg 365,2021-10-06,01:00:00,2,2,0,FMN GV 05 Lier
60,Mechelsesteenweg 365,2021-10-06,02:00:00,0,0,0,FMN GV 05 Lier
60,Mechelsesteenweg 365,2021-10-06,03:00:00,0,0,0,FMN GV 05 Lier
60,Mechelsesteenweg 365,2021-10-06,04:00:00,2,0,2,FMN GV 05 Lier
60,Mechelsesteenweg 365,2021-10-06,05:00:00,6,0,6,FMN GV 05 Lier
60,Mechelsesteenweg 365,2021-10-06,06:00:00,12,6,6,FMN GV 05 Lier
60,Mechelsesteenweg 365,2021-10-06,07:00:00,148,112,36,FMN GV 05 Lier
60,Mechelsesteenweg 365,2021-10-06,08:00:00,100,62,38,FMN GV 05 Lier
60,Mechelsesteenweg 365,2021-10-06,09:00:00,22,8,14,FMN GV 05 Lier
60,Mechelsesteenweg 365,2021-10-06,10:00:00,18,6,12,FMN GV 05 Lier
60,Mechelsesteenweg 365,2021-10-06,11:00:00,10,0,10,FMN GV 05 Lier
60,Mechelsesteenweg 365,2021-10-06,12:00:00,188,38,150,FMN GV 05 Lier
60,Mechelsesteenweg 365,2021-10-06,13:00:00,42,16,26,FMN GV 05 Lier
60,Mechelsesteenweg 365,2021-10-06,14:00:00,54,26,28,FMN GV 05 Lier
60,Mechelsesteenweg 365,2021-10-06,15:00:00,36,26,10,FMN GV 05 Lier
60,Mechelsesteenweg 365,2021-10-06,16:00:00,58,38,20,FMN GV 05 Lier
60,Mechelsesteenweg 365,2021-10-06,17:00:00,76,46,30,FMN GV 05 Lier
60,Mechelsesteenweg 365,2021-10-06,18:00:00,56,26,30,FMN GV 05 Lier
60,Mechelsesteenweg 365,2021-10-06,19:00:00,16,12,4,FMN GV 05 Lier
60,Mechelsesteenweg 365,2021-10-06,20:00:00,10,6,4,FMN GV 05 Lier
60,Mechelsesteenweg 365,2021-10-06,21:00:00,18,2,16,FMN GV 05 Lier
60,Mechelsesteenweg 365,2021-10-06,22:00:00,2,0,2,FMN GV 05 Lier
60,Mechelsesteenweg 365,2021-10-06,23:00:00,0,0,0,FMN GV 05 Lier
60,Mechelsesteenweg 365,2021-10-07,00:00:00,0,0,0,FMN GV 05 Lier
60,Mechelsesteenweg 365,2021-10-07,01:00:00,0,0,0,FMN GV 05 Lier
60,Mechelsesteenweg 365,2021-10-07,02:00:00,2,2,0,FMN GV 05 Lier
60,Mechelsesteenweg 365,2021-10-07,03:00:00,4,2,2,FMN GV 05 Lier
60,Mechelsesteenweg 365,2021-10-07,04:00:00,2,0,2,FMN GV 05 Lier
60,Mechelsesteenweg 365,2021-10-07,05:00:00,4,0,4,FMN GV 05 Lier
60,Mechelsesteenweg 365,2021-10-07,06:00:00,34,12,22,FMN GV 05 Lier
60,Mechelsesteenweg 365,2021-10-07,07:00:00,216,144,72,FMN GV 05 Lier
60,Mechelsesteenweg 365,2021-10-07,08:00:00,232,154,78,FMN GV 05 Lier
60,Mechelsesteenweg 365,2021-10-07,09:00:00,84,62,22,FMN GV 05 Lier
60,Mechelsesteenweg 365,2021-10-07,10:00:00,114,58,56,FMN GV 05 Lier
60,Mechelsesteenweg 365,2021-10-07,11:00:00,96,46,50,FMN GV 05 Lier
60,Mechelsesteenweg 365,2021-10-07,12:00:00,94,44,50,FMN GV 05 Lier
60,Mechelsesteenweg 365,2021-10-07,13:00:00,172,106,66,FMN GV 05 Lier
60,Mechelsesteenweg 365,2021-10-07,14:00:00,292,128,164,FMN GV 05 Lier
60,Mechelsesteenweg 365,2021-10-07,15:00:00,224,90,134,FMN GV 05 Lier
60,Mechelsesteenweg 365,2021-10-07,16:00:00,402,124,278,FMN GV 05 Lier
60,Mechelsesteenweg 365,2021-10-07,17:00:00,218,140,78,FMN GV 05 Lier
60,Mechelsesteenweg 365,2021-10-07,18:00:00,114,56,58,FMN GV 05 Lier
60,Mechelsesteenweg 365,2021-10-07,19:00:00,74,40,34,FMN GV 05 Lier
60,Mechelsesteenweg 365,2021-10-07,20:00:00,22,8,14,FMN GV 05 Lier
60,Mechelsesteenweg 365,2021-10-07,21:00:00,18,4,14,FMN GV 05 Lier
60,Mechelsesteenweg 365,2021-10-07,22:00:00,6,4,2,FMN GV 05 Lier
60,Mechelsesteenweg 365,2021-10-07,23:00:00,6,4,2,FMN GV 05 Lier
60,Mechelsesteenweg 365,2021-10-08,00:00:00,2,2,0,FMN GV 05 Lier
60,Mechelsesteenweg 365,2021-10-08,01:00:00,2,0,2,FMN GV 05 Lier
60,Mechelsesteenweg 365,2021-10-08,02:00:00,0,0,0,FMN GV 05 Lier
60,Mechelsesteenweg 365,2021-10-08,03:00:00,2,0,2,FMN GV 05 Lier
60,Mechelsesteenweg 365,2021-10-08,04:00:00,2,0,2,FMN GV 05 Lier
60,Mechelsesteenweg 365,2021-10-08,05:00:00,6,2,4,FMN GV 05 Lier
60,Mechelsesteenweg 365,2021-10-08,06:00:00,14,4,10,FMN GV 05 Lier
60,Mechelsesteenweg 365,2021-10-08,07:00:00,226,150,76,FMN GV 05 Lier
60,Mechelsesteenweg 365,2021-10-08,08:00:00,156,104,52,FMN GV 05 Lier
60,Mechelsesteenweg 365,2021-10-08,09:00:00,70,32,38,FMN GV 05 Lier
60,Mechelsesteenweg 365,2021-10-08,10:00:00,64,36,28,FMN GV 05 Lier
60,Mechelsesteenweg 365,2021-10-08,11:00:00,110,80,30,FMN GV 05 Lier
60,Mechelsesteenweg 365,2021-10-08,12:00:00,124,52,72,FMN GV 05 Lier
60,Mechelsesteenweg 365,2021-10-08,13:00:00,234,128,106,FMN GV 05 Lier
60,Mechelsesteenweg 365,2021-10-08,14:00:00,350,182,168,FMN GV 05 Lier
60,Mechelsesteenweg 365,2021-10-08,15:00:00,384,184,200,FMN GV 05 Lier
60,Mechelsesteenweg 365,2021-10-08,16:00:00,412,130,282,FMN GV 05 Lier
60,Mechelsesteenweg 365,2021-10-08,17:00:00,188,94,94,FMN GV 05 Lier
60,Mechelsesteenweg 365,2021-10-08,18:00:00,92,56,36,FMN GV 05 Lier
60,Mechelsesteenweg 365,2021-10-08,19:00:00,44,16,28,FMN GV 05 Lier
60,Mechelsesteenweg 365,2021-10-08,20:00:00,18,14,4,FMN GV 05 Lier
60,Mechelsesteenweg 365,2021-10-08,21:00:00,20,6,14,FMN GV 05 Lier
60,Mechelsesteenweg 365,2021-10-08,22:00:00,4,2,2,FMN GV 05 Lier
60,Mechelsesteenweg 365,2021-10-08,23:00:00,6,2,4,FMN GV 05 Lier
60,Mechelsesteenweg 365,2021-10-09,00:00:00,4,4,0,FMN GV 05 Lier
60,Mechelsesteenweg 365,2021-10-09,01:00:00,0,0,0,FMN GV 05 Lier
60,Mechelsesteenweg 365,2021-10-09,02:00:00,4,4,0,FMN GV 05 Lier
60,Mechelsesteenweg 365,2021-10-09,03:00:00,0,0,0,FMN GV 05 Lier
60,Mechelsesteenweg 365,2021-10-09,04:00:00,0,0,0,FMN GV 05 Lier
60,Mechelsesteenweg 365,2021-10-09,05:00:00,0,0,0,FMN GV 05 Lier
60,Mechelsesteenweg 365,2021-10-09,06:00:00,2,0,2,FMN GV 05 Lier
60,Mechelsesteenweg 365,2021-10-09,07:00:00,14,4,10,FMN GV 05 Lier
60,Mechelsesteenweg 365,2021-10-09,08:00:00,32,22,10,FMN GV 05 Lier
60,Mechelsesteenweg 365,2021-10-09,09:00:00,120,52,68,FMN GV 05 Lier
60,Mechelsesteenweg 365,2021-10-09,10:00:00,178,96,82,FMN GV 05 Lier
60,Mechelsesteenweg 365,2021-10-09,11:00:00,232,116,116,FMN GV 05 Lier
60,Mechelsesteenweg 365,2021-10-09,12:00:00,190,80,110,FMN GV 05 Lier
60,Mechelsesteenweg 365,2021-10-09,13:00:00,306,146,160,FMN GV 05 Lier
60,Mechelsesteenweg 365,2021-10-09,14:00:00,564,312,252,FMN GV 05 Lier
60,Mechelsesteenweg 365,2021-10-09,15:00:00,442,158,284,FMN GV 05 Lier
60,Mechelsesteenweg 365,2021-10-09,16:00:00,262,104,158,FMN GV 05 Lier
60,Mechelsesteenweg 365,2021-10-09,17:00:00,188,62,126,FMN GV 05 Lier
60,Mechelsesteenweg 365,2021-10-09,18:00:00,98,46,52,FMN GV 05 Lier
60,Mechelsesteenweg 365,2021-10-09,19:00:00,50,20,30,FMN GV 05 Lier
60,Mechelsesteenweg 365,2021-10-09,20:00:00,20,0,20,FMN GV 05 Lier
60,Mechelsesteenweg 365,2021-10-09,21:00:00,8,2,6,FMN GV 05 Lier
60,Mechelsesteenweg 365,2021-10-09,22:00:00,10,4,6,FMN GV 05 Lier
60,Mechelsesteenweg 365,2021-10-09,23:00:00,4,2,2,FMN GV 05 Lier
60,Mechelsesteenweg 365,2021-10-10,00:00:00,12,4,8,FMN GV 05 Lier
60,Mechelsesteenweg 365,2021-10-10,01:00:00,0,0,0,FMN GV 05 Lier
60,Mechelsesteenweg 365,2021-10-10,02:00:00,0,0,0,FMN GV 05 Lier
60,Mechelsesteenweg 365,2021-10-10,03:00:00,10,10,0,FMN GV 05 Lier
60,Mechelsesteenweg 365,2021-10-10,04:00:00,0,0,0,FMN GV 05 Lier
60,Mechelsesteenweg 365,2021-10-10,05:00:00,2,0,2,FMN GV 05 Lier
60,Mechelsesteenweg 365,2021-10-10,06:00:00,2,2,0,FMN GV 05 Lier
60,Mechelsesteenweg 365,2021-10-10,07:00:00,8,2,6,FMN GV 05 Lier
60,Mechelsesteenweg 365,2021-10-10,08:00:00,28,24,4,FMN GV 05 Lier
60,Mechelsesteenweg 365,2021-10-10,09:00:00,94,70,24,FMN GV 05 Lier
60,Mechelsesteenweg 365,2021-10-10,10:00:00,220,104,116,FMN GV 05 Lier
60,Mechelsesteenweg 365,2021-10-10,11:00:00,316,134,182,FMN GV 05 Lier
60,Mechelsesteenweg 365,2021-10-10,12:00:00,202,118,84,FMN GV 05 Lier
60,Mechelsesteenweg 365,2021-10-10,13:00:00,270,146,124,FMN GV 05 Lier
60,Mechelsesteenweg 365,2021-10-10,14:00:00,382,196,186,FMN GV 05 Lier
60,Mechelsesteenweg 365,2021-10-10,15:00:00,380,172,208,FMN GV 05 Lier
60,Mechelsesteenweg 365,2021-10-10,16:00:00,246,78,168,FMN GV 05 Lier
60,Mechelsesteenweg 365,2021-10-10,17:00:00,152,68,84,FMN GV 05 Lier
60,Mechelsesteenweg 365,2021-10-10,18:00:00,46,20,26,FMN GV 05 Lier
60,Mechelsesteenweg 365,2021-10-10,19:00:00,48,24,24,FMN GV 05 Lier
60,Mechelsesteenweg 365,2021-10-10,20:00:00,6,0,6,FMN GV 05 Lier
60,Mechelsesteenweg 365,2021-10-10,21:00:00,4,2,2,FMN GV 05 Lier
60,Mechelsesteenweg 365,2021-10-10,22:00:00,4,4,0,FMN GV 05 Lier
60,Mechelsesteenweg 365,2021-10-10,23:00:00,2,0,2,FMN GV 05 Lier
60,Mechelsesteenweg 365,2021-10-11,00:00:00,0,0,0,FMN GV 05 Lier
60,Mechelsesteenweg 365,2021-10-11,01:00:00,0,0,0,FMN GV 05 Lier
60,Mechelsesteenweg 365,2021-10-11,02:00:00,0,0,0,FMN GV 05 Lier
60,Mechelsesteenweg 365,2021-10-11,03:00:00,4,0,4,FMN GV 05 Lier
60,Mechelsesteenweg 365,2021-10-11,04:00:00,0,0,0,FMN GV 05 Lier
60,Mechelsesteenweg 365,2021-10-11,05:00:00,4,2,2,FMN GV 05 Lier
60,Mechelsesteenweg 365,2021-10-11,06:00:00,40,4,36,FMN GV 05 Lier
60,Mechelsesteenweg 365,2021-10-11,07:00:00,228,146,82,FMN GV 05 Lier
60,Mechelsesteenweg 365,2021-10-11,08:00:00,182,142,40,FMN GV 05 Lier
60,Mechelsesteenweg 365,2021-10-11,09:00:00,70,36,34,FMN GV 05 Lier
60,Mechelsesteenweg 365,2021-10-11,10:00:00,84,46,38,FMN GV 05 Lier
60,Mechelsesteenweg 365,2021-10-11,11:00:00,58,24,34,FMN GV 05 Lier
60,Mechelsesteenweg 365,2021-10-11,12:00:00,114,50,64,FMN GV 05 Lier
60,Mechelsesteenweg 365,2021-10-11,13:00:00,122,70,52,FMN GV 05 Lier
60,Mechelsesteenweg 365,2021-10-11,14:00:00,132,60,72,FMN GV 05 Lier
60,Mechelsesteenweg 365,2021-10-11,15:00:00,172,82,90,FMN GV 05 Lier
60,Mechelsesteenweg 365,2021-10-11,16:00:00,314,80,234,FMN GV 05 Lier
60,Mechelsesteenweg 365,2021-10-11,17:00:00,204,116,88,FMN GV 05 Lier
60,Mechelsesteenweg 365,2021-10-11,18:00:00,54,26,28,FMN GV 05 Lier
60,Mechelsesteenweg 365,2021-10-11,19:00:00,28,16,12,FMN GV 05 Lier
60,Mechelsesteenweg 365,2021-10-11,20:00:00,12,2,10,FMN GV 05 Lier
60,Mechelsesteenweg 365,2021-10-11,21:00:00,10,6,4,FMN GV 05 Lier
60,Mechelsesteenweg 365,2021-10-11,22:00:00,6,4,2,FMN GV 05 Lier
60,Mechelsesteenweg 365,2021-10-11,23:00:00,0,0,0,FMN GV 05 Lier
60,Mechelsesteenweg 365,2021-10-12,00:00:00,0,0,0,FMN GV 05 Lier
60,Mechelsesteenweg 365,2021-10-12,01:00:00,0,0,0,FMN GV 05 Lier
60,Mechelsesteenweg 365,2021-10-12,02:00:00,0,0,0,FMN GV 05 Lier
60,Mechelsesteenweg 365,2021-10-12,03:00:00,2,0,2,FMN GV 05 Lier
60,Mechelsesteenweg 365,2021-10-12,04:00:00,2,0,2,FMN GV 05 Lier
60,Mechelsesteenweg 365,2021-10-12,05:00:00,2,2,0,FMN GV 05 Lier
60,Mechelsesteenweg 365,2021-10-12,06:00:00,38,4,34,FMN GV 05 Lier
60,Mechelsesteenweg 365,2021-10-12,07:00:00,182,104,78,FMN GV 05 Lier
60,Mechelsesteenweg 365,2021-10-12,08:00:00,164,126,38,FMN GV 05 Lier
60,Mechelsesteenweg 365,2021-10-12,09:00:00,40,18,22,FMN GV 05 Lier
60,Mechelsesteenweg 365,2021-10-12,10:00:00,56,20,36,FMN GV 05 Lier
60,Mechelsesteenweg 365,2021-10-12,11:00:00,42,26,16,FMN GV 05 Lier
60,Mechelsesteenweg 365,2021-10-12,12:00:00,52,20,32,FMN GV 05 Lier
60,Mechelsesteenweg 365,2021-10-12,13:00:00,34,18,16,FMN GV 05 Lier
60,Mechelsesteenweg 365,2021-10-12,14:00:00,36,14,22,FMN GV 05 Lier
60,Mechelsesteenweg 365,2021-10-12,15:00:00,44,6,38,FMN GV 05 Lier
60,Mechelsesteenweg 365,2021-10-12,16:00:00,218,78,140,FMN GV 05 Lier
60,Mechelsesteenweg 365,2021-10-12,17:00:00,116,52,64,FMN GV 05 Lier
60,Mechelsesteenweg 365,2021-10-12,18:00:00,62,34,28,FMN GV 05 Lier
60,Mechelsesteenweg 365,2021-10-12,19:00:00,22,14,8,FMN GV 05 Lier
60,Mechelsesteenweg 365,2021-10-12,20:00:00,2,0,2,FMN GV 05 Lier
60,Mechelsesteenweg 365,2021-10-12,21:00:00,10,6,4,FMN GV 05 Lier
60,Mechelsesteenweg 365,2021-10-12,22:00:00,0,0,0,FMN GV 05 Lier
60,Mechelsesteenweg 365,2021-10-12,23:00:00,0,0,0,FMN GV 05 Lier
60,Mechelsesteenweg 365,2021-10-13,00:00:00,0,0,0,FMN GV 05 Lier
60,Mechelsesteenweg 365,2021-10-13,01:00:00,0,0,0,FMN GV 05 Lier
60,Mechelsesteenweg 365,2021-10-13,02:00:00,0,0,0,FMN GV 05 Lier
60,Mechelsesteenweg 365,2021-10-13,03:00:00,2,0,2,FMN GV 05 Lier
60,Mechelsesteenweg 365,2021-10-13,04:00:00,4,0,4,FMN GV 05 Lier
60,Mechelsesteenweg 365,2021-10-13,05:00:00,2,0,2,FMN GV 05 Lier
60,Mechelsesteenweg 365,2021-10-13,06:00:00,28,6,22,FMN GV 05 Lier
60,Mechelsesteenweg 365,2021-10-13,07:00:00,218,134,84,FMN GV 05 Lier
60,Mechelsesteenweg 365,2021-10-13,08:00:00,202,128,74,FMN GV 05 Lier
60,Mechelsesteenweg 365,2021-10-13,09:00:00,60,42,18,FMN GV 05 Lier
60,Mechelsesteenweg 365,2021-10-13,10:00:00,60,30,30,FMN GV 05 Lier
60,Mechelsesteenweg 365,2021-10-13,11:00:00,80,32,48,FMN GV 05 Lier
60,Mechelsesteenweg 365,2021-10-13,12:00:00,276,42,234,FMN GV 05 Lier
60,Mechelsesteenweg 365,2021-10-13,13:00:00,158,72,86,FMN GV 05 Lier
60,Mechelsesteenweg 365,2021-10-13,14:00:00,154,90,64,FMN GV 05 Lier
60,Mechelsesteenweg 365,2021-10-13,15:00:00,164,102,62,FMN GV 05 Lier
60,Mechelsesteenweg 365,2021-10-13,16:00:00,150,86,64,FMN GV 05 Lier
60,Mechelsesteenweg 365,2021-10-13,17:00:00,144,92,52,FMN GV 05 Lier
60,Mechelsesteenweg 365,2021-10-13,18:00:00,110,60,50,FMN GV 05 Lier
60,Mechelsesteenweg 365,2021-10-13,19:00:00,44,30,14,FMN GV 05 Lier
60,Mechelsesteenweg 365,2021-10-13,20:00:00,4,2,2,FMN GV 05 Lier
60,Mechelsesteenweg 365,2021-10-13,21:00:00,16,6,10,FMN GV 05 Lier
60,Mechelsesteenweg 365,2021-10-13,22:00:00,8,8,0,FMN GV 05 Lier
60,Mechelsesteenweg 365,2021-10-13,23:00:00,2,2,0,FMN GV 05 Lier
60,Mechelsesteenweg 365,2021-10-14,00:00:00,0,0,0,FMN GV 05 Lier
60,Mechelsesteenweg 365,2021-10-14,01:00:00,0,0,0,FMN GV 05 Lier
60,Mechelsesteenweg 365,2021-10-14,02:00:00,0,0,0,FMN GV 05 Lier
60,Mechelsesteenweg 365,2021-10-14,03:00:00,2,0,2,FMN GV 05 Lier
60,Mechelsesteenweg 365,2021-10-14,04:00:00,4,0,4,FMN GV 05 Lier
60,Mechelsesteenweg 365,2021-10-14,05:00:00,8,0,8,FMN GV 05 Lier
60,Mechelsesteenweg 365,2021-10-14,06:00:00,32,8,24,FMN GV 05 Lier
60,Mechelsesteenweg 365,2021-10-14,07:00:00,166,92,74,FMN GV 05 Lier
60,Mechelsesteenweg 365,2021-10-14,08:00:00,198,124,74,FMN GV 05 Lier
60,Mechelsesteenweg 365,2021-10-14,09:00:00,232,196,36,FMN GV 05 Lier
60,Mechelsesteenweg 365,2021-10-14,10:00:00,86,52,34,FMN GV 05 Lier
60,Mechelsesteenweg 365,2021-10-14,11:00:00,88,56,32,FMN GV 05 Lier
60,Mechelsesteenweg 365,2021-10-14,12:00:00,84,38,46,FMN GV 05 Lier
60,Mechelsesteenweg 365,2021-10-14,13:00:00,118,60,58,FMN GV 05 Lier
60,Mechelsesteenweg 365,2021-10-14,14:00:00,186,86,100,FMN GV 05 Lier
60,Mechelsesteenweg 365,2021-10-14,15:00:00,298,88,210,FMN GV 05 Lier
60,Mechelsesteenweg 365,2021-10-14,16:00:00,320,108,212,FMN GV 05 Lier
60,Mechelsesteenweg 365,2021-10-14,17:00:00,156,96,60,FMN GV 05 Lier
60,Mechelsesteenweg 365,2021-10-14,18:00:00,80,50,30,FMN GV 05 Lier
60,Mechelsesteenweg 365,2021-10-14,19:00:00,48,24,24,FMN GV 05 Lier
60,Mechelsesteenweg 365,2021-10-14,20:00:00,16,4,12,FMN GV 05 Lier
60,Mechelsesteenweg 365,2021-10-14,21:00:00,20,8,12,FMN GV 05 Lier
60,Mechelsesteenweg 365,2021-10-14,22:00:00,8,6,2,FMN GV 05 Lier
60,Mechelsesteenweg 365,2021-10-14,23:00:00,2,2,0,FMN GV 05 Lier
60,Mechelsesteenweg 365,2021-10-15,00:00:00,0,0,0,FMN GV 05 Lier
60,Mechelsesteenweg 365,2021-10-15,01:00:00,0,0,0,FMN GV 05 Lier
60,Mechelsesteenweg 365,2021-10-15,02:00:00,2,2,0,FMN GV 05 Lier
60,Mechelsesteenweg 365,2021-10-15,03:00:00,2,0,2,FMN GV 05 Lier
60,Mechelsesteenweg 365,2021-10-15,04:00:00,4,0,4,FMN GV 05 Lier
60,Mechelsesteenweg 365,2021-10-15,05:00:00,6,2,4,FMN GV 05 Lier
60,Mechelsesteenweg 365,2021-10-15,06:00:00,32,8,24,FMN GV 05 Lier
60,Mechelsesteenweg 365,2021-10-15,07:00:00,212,154,58,FMN GV 05 Lier
60,Mechelsesteenweg 365,2021-10-15,08:00:00,162,118,44,FMN GV 05 Lier
60,Mechelsesteenweg 365,2021-10-15,09:00:00,38,18,20,FMN GV 05 Lier
60,Mechelsesteenweg 365,2021-10-15,10:00:00,58,24,34,FMN GV 05 Lier
60,Mechelsesteenweg 365,2021-10-15,11:00:00,64,52,12,FMN GV 05 Lier
60,Mechelsesteenweg 365,2021-10-15,12:00:00,46,20,26,FMN GV 05 Lier
60,Mechelsesteenweg 365,2021-10-15,13:00:00,38,24,14,FMN GV 05 Lier
60,Mechelsesteenweg 365,2021-10-15,14:00:00,64,38,26,FMN GV 05 Lier
60,Mechelsesteenweg 365,2021-10-15,15:00:00,194,92,102,FMN GV 05 Lier
60,Mechelsesteenweg 365,2021-10-15,16:00:00,308,84,224,FMN GV 05 Lier
60,Mechelsesteenweg 365,2021-10-15,17:00:00,140,70,70,FMN GV 05 Lier
60,Mechelsesteenweg 365,2021-10-15,18:00:00,66,40,26,FMN GV 05 Lier
60,Mechelsesteenweg 365,2021-10-15,19:00:00,24,14,10,FMN GV 05 Lier
60,Mechelsesteenweg 365,2021-10-15,20:00:00,12,10,2,FMN GV 05 Lier
60,Mechelsesteenweg 365,2021-10-15,21:00:00,6,2,4,FMN GV 05 Lier
60,Mechelsesteenweg 365,2021-10-15,22:00:00,10,0,10,FMN GV 05 Lier
60,Mechelsesteenweg 365,2021-10-15,23:00:00,2,2,0,FMN GV 05 Lier
60,Mechelsesteenweg 365,2021-10-16,00:00:00,2,0,2,FMN GV 05 Lier
60,Mechelsesteenweg 365,2021-10-16,01:00:00,4,2,2,FMN GV 05 Lier
60,Mechelsesteenweg 365,2021-10-16,02:00:00,4,2,2,FMN GV 05 Lier
60,Mechelsesteenweg 365,2021-10-16,03:00:00,0,0,0,FMN GV 05 Lier
60,Mechelsesteenweg 365,2021-10-16,04:00:00,0,0,0,FMN GV 05 Lier
60,Mechelsesteenweg 365,2021-10-16,05:00:00,4,0,4,FMN GV 05 Lier
60,Mechelsesteenweg 365,2021-10-16,06:00:00,6,2,4,FMN GV 05 Lier
60,Mechelsesteenweg 365,2021-10-16,07:00:00,8,8,0,FMN GV 05 Lier
60,Mechelsesteenweg 365,2021-10-16,08:00:00,26,12,14,FMN GV 05 Lier
60,Mechelsesteenweg 365,2021-10-16,09:00:00,62,28,34,FMN GV 05 Lier
60,Mechelsesteenweg 365,2021-10-16,10:00:00,142,88,54,FMN GV 05 Lier
60,Mechelsesteenweg 365,2021-10-16,11:00:00,170,90,80,FMN GV 05 Lier
60,Mechelsesteenweg 365,2021-10-16,12:00:00,182,66,116,FMN GV 05 Lier
60,Mechelsesteenweg 365,2021-10-16,13:00:00,178,86,92,FMN GV 05 Lier
60,Mechelsesteenweg 365,2021-10-16,14:00:00,332,164,168,FMN GV 05 Lier
60,Mechelsesteenweg 365,2021-10-16,15:00:00,318,156,162,FMN GV 05 Lier
60,Mechelsesteenweg 365,2021-10-16,16:00:00,200,108,92,FMN GV 05 Lier
60,Mechelsesteenweg 365,2021-10-16,17:00:00,142,60,82,FMN GV 05 Lier
60,Mechelsesteenweg 365,2021-10-16,18:00:00,46,26,20,FMN GV 05 Lier
60,Mechelsesteenweg 365,2021-10-16,19:00:00,36,16,20,FMN GV 05 Lier
60,Mechelsesteenweg 365,2021-10-16,20:00:00,12,2,10,FMN GV 05 Lier
60,Mechelsesteenweg 365,2021-10-16,21:00:00,0,0,0,FMN GV 05 Lier
60,Mechelsesteenweg 365,2021-10-16,22:00:00,12,6,6,FMN GV 05 Lier
60,Mechelsesteenweg 365,2021-10-16,23:00:00,16,8,8,FMN GV 05 Lier
60,Mechelsesteenweg 365,2021-10-17,00:00:00,4,0,4,FMN GV 05 Lier
60,Mechelsesteenweg 365,2021-10-17,01:00:00,4,2,2,FMN GV 05 Lier
60,Mechelsesteenweg 365,2021-10-17,02:00:00,0,0,0,FMN GV 05 Lier
60,Mechelsesteenweg 365,2021-10-17,03:00:00,0,0,0,FMN GV 05 Lier
60,Mechelsesteenweg 365,2021-10-17,04:00:00,4,2,2,FMN GV 05 Lier
60,Mechelsesteenweg 365,2021-10-17,05:00:00,4,0,4,FMN GV 05 Lier
60,Mechelsesteenweg 365,2021-10-17,06:00:00,4,2,2,FMN GV 05 Lier
60,Mechelsesteenweg 365,2021-10-17,07:00:00,6,2,4,FMN GV 05 Lier
60,Mechelsesteenweg 365,2021-10-17,08:00:00,30,14,16,FMN GV 05 Lier
60,Mechelsesteenweg 365,2021-10-17,09:00:00,128,86,42,FMN GV 05 Lier
60,Mechelsesteenweg 365,2021-10-17,10:00:00,318,166,152,FMN GV 05 Lier
60,Mechelsesteenweg 365,2021-10-17,11:00:00,344,172,172,FMN GV 05 Lier
60,Mechelsesteenweg 365,2021-10-17,12:00:00,226,94,132,FMN GV 05 Lier
60,Mechelsesteenweg 365,2021-10-17,13:00:00,258,110,148,FMN GV 05 Lier
60,Mechelsesteenweg 365,2021-10-17,14:00:00,370,196,174,FMN GV 05 Lier
60,Mechelsesteenweg 365,2021-10-17,15:00:00,334,152,182,FMN GV 05 Lier
60,Mechelsesteenweg 365,2021-10-17,16:00:00,266,98,168,FMN GV 05 Lier
60,Mechelsesteenweg 365,2021-10-17,17:00:00,128,62,66,FMN GV 05 Lier
60,Mechelsesteenweg 365,2021-10-17,18:00:00,22,12,10,FMN GV 05 Lier
60,Mechelsesteenweg 365,2021-10-17,19:00:00,24,8,16,FMN GV 05 Lier
60,Mechelsesteenweg 365,2021-10-17,20:00:00,10,2,8,FMN GV 05 Lier
60,Mechelsesteenweg 365,2021-10-17,21:00:00,6,0,6,FMN GV 05 Lier
60,Mechelsesteenweg 365,2021-10-17,22:00:00,2,0,2,FMN GV 05 Lier
60,Mechelsesteenweg 365,2021-10-17,23:00:00,8,4,4,FMN GV 05 Lier
60,Mechelsesteenweg 365,2021-10-18,00:00:00,0,0,0,FMN GV 05 Lier
60,Mechelsesteenweg 365,2021-10-18,01:00:00,0,0,0,FMN GV 05 Lier
60,Mechelsesteenweg 365,2021-10-18,02:00:00,0,0,0,FMN GV 05 Lier
60,Mechelsesteenweg 365,2021-10-18,03:00:00,2,0,2,FMN GV 05 Lier
60,Mechelsesteenweg 365,2021-10-18,04:00:00,2,0,2,FMN GV 05 Lier
60,Mechelsesteenweg 365,2021-10-18,05:00:00,6,0,6,FMN GV 05 Lier
60,Mechelsesteenweg 365,2021-10-18,06:00:00,46,12,34,FMN GV 05 Lier
60,Mechelsesteenweg 365,2021-10-18,07:00:00,168,100,68,FMN GV 05 Lier
60,Mechelsesteenweg 365,2021-10-18,08:00:00,116,82,34,FMN GV 05 Lier
60,Mechelsesteenweg 365,2021-10-18,09:00:00,96,62,34,FMN GV 05 Lier
60,Mechelsesteenweg 365,2021-10-18,10:00:00,136,88,48,FMN GV 05 Lier
60,Mechelsesteenweg 365,2021-10-18,11:00:00,106,52,54,FMN GV 05 Lier
60,Mechelsesteenweg 365,2021-10-18,12:00:00,122,68,54,FMN GV 05 Lier
60,Mechelsesteenweg 365,2021-10-18,13:00:00,176,90,86,FMN GV 05 Lier
60,Mechelsesteenweg 365,2021-10-18,14:00:00,274,158,116,FMN GV 05 Lier
60,Mechelsesteenweg 365,2021-10-18,15:00:00,238,120,118,FMN GV 05 Lier
60,Mechelsesteenweg 365,2021-10-18,16:00:00,388,102,286,FMN GV 05 Lier
60,Mechelsesteenweg 365,2021-10-18,17:00:00,174,104,70,FMN GV 05 Lier
60,Mechelsesteenweg 365,2021-10-18,18:00:00,72,42,30,FMN GV 05 Lier
60,Mechelsesteenweg 365,2021-10-18,19:00:00,24,14,10,FMN GV 05 Lier
60,Mechelsesteenweg 365,2021-10-18,20:00:00,28,12,16,FMN GV 05 Lier
60,Mechelsesteenweg 365,2021-10-18,21:00:00,6,0,6,FMN GV 05 Lier
60,Mechelsesteenweg 365,2021-10-18,22:00:00,2,0,2,FMN GV 05 Lier
60,Mechelsesteenweg 365,2021-10-18,23:00:00,2,0,2,FMN GV 05 Lier
60,Mechelsesteenweg 365,2021-10-19,00:00:00,0,0,0,FMN GV 05 Lier
60,Mechelsesteenweg 365,2021-10-19,01:00:00,0,0,0,FMN GV 05 Lier
60,Mechelsesteenweg 365,2021-10-19,02:00:00,0,0,0,FMN GV 05 Lier
60,Mechelsesteenweg 365,2021-10-19,03:00:00,2,0,2,FMN GV 05 Lier
60,Mechelsesteenweg 365,2021-10-19,04:00:00,0,0,0,FMN GV 05 Lier
60,Mechelsesteenweg 365,2021-10-19,05:00:00,4,0,4,FMN GV 05 Lier
60,Mechelsesteenweg 365,2021-10-19,06:00:00,38,8,30,FMN GV 05 Lier
60,Mechelsesteenweg 365,2021-10-19,07:00:00,214,138,76,FMN GV 05 Lier
60,Mechelsesteenweg 365,2021-10-19,08:00:00,182,124,58,FMN GV 05 Lier
60,Mechelsesteenweg 365,2021-10-19,09:00:00,56,28,28,FMN GV 05 Lier
60,Mechelsesteenweg 365,2021-10-19,10:00:00,50,20,30,FMN GV 05 Lier
60,Mechelsesteenweg 365,2021-10-19,11:00:00,40,22,18,FMN GV 05 Lier
60,Mechelsesteenweg 365,2021-10-19,12:00:00,64,44,20,FMN GV 05 Lier
60,Mechelsesteenweg 365,2021-10-19,13:00:00,86,42,44,FMN GV 05 Lier
60,Mechelsesteenweg 365,2021-10-19,14:00:00,166,66,100,FMN GV 05 Lier
60,Mechelsesteenweg 365,2021-10-19,15:00:00,148,74,74,FMN GV 05 Lier
60,Mechelsesteenweg 365,2021-10-19,16:00:00,336,100,236,FMN GV 05 Lier
60,Mechelsesteenweg 365,2021-10-19,17:00:00,154,86,68,FMN GV 05 Lier
60,Mechelsesteenweg 365,2021-10-19,18:00:00,78,42,36,FMN GV 05 Lier
60,Mechelsesteenweg 365,2021-10-19,19:00:00,34,16,18,FMN GV 05 Lier
60,Mechelsesteenweg 365,2021-10-19,20:00:00,16,4,12,FMN GV 05 Lier
60,Mechelsesteenweg 365,2021-10-19,21:00:00,6,4,2,FMN GV 05 Lier
60,Mechelsesteenweg 365,2021-10-19,22:00:00,6,2,4,FMN GV 05 Lier
60,Mechelsesteenweg 365,2021-10-19,23:00:00,2,2,0,FMN GV 05 Lier
60,Mechelsesteenweg 365,2021-10-20,00:00:00,2,2,0,FMN GV 05 Lier
60,Mechelsesteenweg 365,2021-10-20,01:00:00,2,0,2,FMN GV 05 Lier
60,Mechelsesteenweg 365,2021-10-20,02:00:00,0,0,0,FMN GV 05 Lier
60,Mechelsesteenweg 365,2021-10-20,03:00:00,2,0,2,FMN GV 05 Lier
60,Mechelsesteenweg 365,2021-10-20,04:00:00,2,0,2,FMN GV 05 Lier
60,Mechelsesteenweg 365,2021-10-20,05:00:00,4,0,4,FMN GV 05 Lier
60,Mechelsesteenweg 365,2021-10-20,06:00:00,14,2,12,FMN GV 05 Lier
60,Mechelsesteenweg 365,2021-10-20,07:00:00,200,146,54,FMN GV 05 Lier
60,Mechelsesteenweg 365,2021-10-20,08:00:00,184,138,46,FMN GV 05 Lier
60,Mechelsesteenweg 365,2021-10-20,09:00:00,22,10,12,FMN GV 05 Lier
60,Mechelsesteenweg 365,2021-10-20,10:00:00,32,16,16,FMN GV 05 Lier
60,Mechelsesteenweg 365,2021-10-20,11:00:00,50,8,42,FMN GV 05 Lier
60,Mechelsesteenweg 365,2021-10-20,12:00:00,210,32,178,FMN GV 05 Lier
60,Mechelsesteenweg 365,2021-10-20,13:00:00,72,38,34,FMN GV 05 Lier
60,Mechelsesteenweg 365,2021-10-20,14:00:00,56,28,28,FMN GV 05 Lier
60,Mechelsesteenweg 365,2021-10-20,15:00:00,88,54,34,FMN GV 05 Lier
60,Mechelsesteenweg 365,2021-10-20,16:00:00,96,54,42,FMN GV 05 Lier
60,Mechelsesteenweg 365,2021-10-20,17:00:00,76,56,20,FMN GV 05 Lier
60,Mechelsesteenweg 365,2021-10-20,18:00:00,48,28,20,FMN GV 05 Lier
60,Mechelsesteenweg 365,2021-10-20,19:00:00,8,8,0,FMN GV 05 Lier
60,Mechelsesteenweg 365,2021-10-20,20:00:00,8,2,6,FMN GV 05 Lier
60,Mechelsesteenweg 365,2021-10-20,21:00:00,8,2,6,FMN GV 05 Lier
60,Mechelsesteenweg 365,2021-10-20,22:00:00,4,4,0,FMN GV 05 Lier
60,Mechelsesteenweg 365,2021-10-20,23:00:00,2,0,2,FMN GV 05 Lier
60,Mechelsesteenweg 365,2021-10-21,00:00:00,0,0,0,FMN GV 05 Lier
60,Mechelsesteenweg 365,2021-10-21,01:00:00,0,0,0,FMN GV 05 Lier
60,Mechelsesteenweg 365,2021-10-21,02:00:00,0,0,0,FMN GV 05 Lier
60,Mechelsesteenweg 365,2021-10-21,03:00:00,2,0,2,FMN GV 05 Lier
60,Mechelsesteenweg 365,2021-10-21,04:00:00,2,0,2,FMN GV 05 Lier
60,Mechelsesteenweg 365,2021-10-21,05:00:00,4,0,4,FMN GV 05 Lier
60,Mechelsesteenweg 365,2021-10-21,06:00:00,8,4,4,FMN GV 05 Lier
60,Mechelsesteenweg 365,2021-10-21,07:00:00,44,26,18,FMN GV 05 Lier
60,Mechelsesteenweg 365,2021-10-21,08:00:00,90,68,22,FMN GV 05 Lier
60,Mechelsesteenweg 365,2021-10-21,09:00:00,18,14,4,FMN GV 05 Lier
60,Mechelsesteenweg 365,2021-10-21,10:00:00,16,6,10,FMN GV 05 Lier
60,Mechelsesteenweg 365,2021-10-21,11:00:00,14,6,8,FMN GV 05 Lier
60,Mechelsesteenweg 365,2021-10-21,12:00:00,8,8,0,FMN GV 05 Lier
60,Mechelsesteenweg 365,2021-10-21,13:00:00,24,16,8,FMN GV 05 Lier
60,Mechelsesteenweg 365,2021-10-21,14:00:00,24,10,14,FMN GV 05 Lier
60,Mechelsesteenweg 365,2021-10-21,15:00:00,18,4,14,FMN GV 05 Lier
60,Mechelsesteenweg 365,2021-10-21,16:00:00,88,40,48,FMN GV 05 Lier
60,Mechelsesteenweg 365,2021-10-21,17:00:00,72,24,48,FMN GV 05 Lier
60,Mechelsesteenweg 365,2021-10-21,18:00:00,42,22,20,FMN GV 05 Lier
60,Mechelsesteenweg 365,2021-10-21,19:00:00,16,6,10,FMN GV 05 Lier
60,Mechelsesteenweg 365,2021-10-21,20:00:00,12,8,4,FMN GV 05 Lier
60,Mechelsesteenweg 365,2021-10-21,21:00:00,12,6,6,FMN GV 05 Lier
60,Mechelsesteenweg 365,2021-10-21,22:00:00,2,0,2,FMN GV 05 Lier
60,Mechelsesteenweg 365,2021-10-21,23:00:00,0,0,0,FMN GV 05 Lier
60,Mechelsesteenweg 365,2021-10-22,00:00:00,0,0,0,FMN GV 05 Lier
60,Mechelsesteenweg 365,2021-10-22,01:00:00,0,0,0,FMN GV 05 Lier
60,Mechelsesteenweg 365,2021-10-22,02:00:00,0,0,0,FMN GV 05 Lier
60,Mechelsesteenweg 365,2021-10-22,03:00:00,2,0,2,FMN GV 05 Lier
60,Mechelsesteenweg 365,2021-10-22,04:00:00,0,0,0,FMN GV 05 Lier
60,Mechelsesteenweg 365,2021-10-22,05:00:00,10,4,6,FMN GV 05 Lier
60,Mechelsesteenweg 365,2021-10-22,06:00:00,38,24,14,FMN GV 05 Lier
60,Mechelsesteenweg 365,2021-10-22,07:00:00,164,118,46,FMN GV 05 Lier
60,Mechelsesteenweg 365,2021-10-22,08:00:00,132,86,46,FMN GV 05 Lier
60,Mechelsesteenweg 365,2021-10-22,09:00:00,56,24,32,FMN GV 05 Lier
60,Mechelsesteenweg 365,2021-10-22,10:00:00,38,22,16,FMN GV 05 Lier
60,Mechelsesteenweg 365,2021-10-22,11:00:00,68,32,36,FMN GV 05 Lier
60,Mechelsesteenweg 365,2021-10-22,12:00:00,66,36,30,FMN GV 05 Lier
60,Mechelsesteenweg 365,2021-10-22,13:00:00,54,28,26,FMN GV 05 Lier
60,Mechelsesteenweg 365,2021-10-22,14:00:00,50,30,20,FMN GV 05 Lier
60,Mechelsesteenweg 365,2021-10-22,15:00:00,62,38,24,FMN GV 05 Lier
60,Mechelsesteenweg 365,2021-10-22,16:00:00,224,64,160,FMN GV 05 Lier
60,Mechelsesteenweg 365,2021-10-22,17:00:00,86,36,50,FMN GV 05 Lier
60,Mechelsesteenweg 365,2021-10-22,18:00:00,38,12,26,FMN GV 05 Lier
60,Mechelsesteenweg 365,2021-10-22,19:00:00,4,4,0,FMN GV 05 Lier
60,Mechelsesteenweg 365,2021-10-22,20:00:00,2,0,2,FMN GV 05 Lier
60,Mechelsesteenweg 365,2021-10-22,21:00:00,8,2,6,FMN GV 05 Lier
60,Mechelsesteenweg 365,2021-10-22,22:00:00,4,2,2,FMN GV 05 Lier
60,Mechelsesteenweg 365,2021-10-22,23:00:00,34,32,2,FMN GV 05 Lier
60,Mechelsesteenweg 365,2021-10-23,00:00:00,0,0,0,FMN GV 05 Lier
60,Mechelsesteenweg 365,2021-10-23,01:00:00,0,0,0,FMN GV 05 Lier
60,Mechelsesteenweg 365,2021-10-23,02:00:00,0,0,0,FMN GV 05 Lier
60,Mechelsesteenweg 365,2021-10-23,03:00:00,0,0,0,FMN GV 05 Lier
60,Mechelsesteenweg 365,2021-10-23,04:00:00,0,0,0,FMN GV 05 Lier
60,Mechelsesteenweg 365,2021-10-23,05:00:00,2,0,2,FMN GV 05 Lier
60,Mechelsesteenweg 365,2021-10-23,06:00:00,6,0,6,FMN GV 05 Lier
60,Mechelsesteenweg 365,2021-10-23,07:00:00,8,2,6,FMN GV 05 Lier
60,Mechelsesteenweg 365,2021-10-23,08:00:00,16,2,14,FMN GV 05 Lier
60,Mechelsesteenweg 365,2021-10-23,09:00:00,82,40,42,FMN GV 05 Lier
60,Mechelsesteenweg 365,2021-10-23,10:00:00,158,86,72,FMN GV 05 Lier
60,Mechelsesteenweg 365,2021-10-23,11:00:00,118,64,54,FMN GV 05 Lier
60,Mechelsesteenweg 365,2021-10-23,12:00:00,116,52,64,FMN GV 05 Lier
60,Mechelsesteenweg 365,2021-10-23,13:00:00,236,124,112,FMN GV 05 Lier
60,Mechelsesteenweg 365,2021-10-23,14:00:00,282,188,94,FMN GV 05 Lier
60,Mechelsesteenweg 365,2021-10-23,15:00:00,298,154,144,FMN GV 05 Lier
60,Mechelsesteenweg 365,2021-10-23,16:00:00,164,74,90,FMN GV 05 Lier
60,Mechelsesteenweg 365,2021-10-23,17:00:00,82,34,48,FMN GV 05 Lier
60,Mechelsesteenweg 365,2021-10-23,18:00:00,28,16,12,FMN GV 05 Lier
60,Mechelsesteenweg 365,2021-10-23,19:00:00,30,10,20,FMN GV 05 Lier
60,Mechelsesteenweg 365,2021-10-23,20:00:00,8,0,8,FMN GV 05 Lier
60,Mechelsesteenweg 365,2021-10-23,21:00:00,4,0,4,FMN GV 05 Lier
60,Mechelsesteenweg 365,2021-10-23,22:00:00,8,4,4,FMN GV 05 Lier
60,Mechelsesteenweg 365,2021-10-23,23:00:00,14,4,10,FMN GV 05 Lier
60,Mechelsesteenweg 365,2021-10-24,00:00:00,4,0,4,FMN GV 05 Lier
60,Mechelsesteenweg 365,2021-10-24,01:00:00,0,0,0,FMN GV 05 Lier
60,Mechelsesteenweg 365,2021-10-24,02:00:00,0,0,0,FMN GV 05 Lier
60,Mechelsesteenweg 365,2021-10-24,03:00:00,0,0,0,FMN GV 05 Lier
60,Mechelsesteenweg 365,2021-10-24,04:00:00,0,0,0,FMN GV 05 Lier
60,Mechelsesteenweg 365,2021-10-24,05:00:00,0,0,0,FMN GV 05 Lier
60,Mechelsesteenweg 365,2021-10-24,06:00:00,2,0,2,FMN GV 05 Lier
60,Mechelsesteenweg 365,2021-10-24,07:00:00,12,2,10,FMN GV 05 Lier
60,Mechelsesteenweg 365,2021-10-24,08:00:00,20,4,16,FMN GV 05 Lier
60,Mechelsesteenweg 365,2021-10-24,09:00:00,88,38,50,FMN GV 05 Lier
60,Mechelsesteenweg 365,2021-10-24,10:00:00,314,172,142,FMN GV 05 Lier
60,Mechelsesteenweg 365,2021-10-24,11:00:00,362,162,200,FMN GV 05 Lier
60,Mechelsesteenweg 365,2021-10-24,12:00:00,274,122,152,FMN GV 05 Lier
60,Mechelsesteenweg 365,2021-10-24,13:00:00,294,150,144,FMN GV 05 Lier
60,Mechelsesteenweg 365,2021-10-24,14:00:00,536,314,222,FMN GV 05 Lier
60,Mechelsesteenweg 365,2021-10-24,15:00:00,396,190,206,FMN GV 05 Lier
60,Mechelsesteenweg 365,2021-10-24,16:00:00,302,114,188,FMN GV 05 Lier
60,Mechelsesteenweg 365,2021-10-24,17:00:00,160,58,102,FMN GV 05 Lier
60,Mechelsesteenweg 365,2021-10-24,18:00:00,56,24,32,FMN GV 05 Lier
60,Mechelsesteenweg 365,2021-10-24,19:00:00,12,10,2,FMN GV 05 Lier
60,Mechelsesteenweg 365,2021-10-24,20:00:00,4,4,0,FMN GV 05 Lier
60,Mechelsesteenweg 365,2021-10-24,21:00:00,2,0,2,FMN GV 05 Lier
60,Mechelsesteenweg 365,2021-10-24,22:00:00,2,0,2,FMN GV 05 Lier
60,Mechelsesteenweg 365,2021-10-24,23:00:00,4,4,0,FMN GV 05 Lier
60,Mechelsesteenweg 365,2021-10-25,00:00:00,0,0,0,FMN GV 05 Lier
60,Mechelsesteenweg 365,2021-10-25,01:00:00,0,0,0,FMN GV 05 Lier
60,Mechelsesteenweg 365,2021-10-25,02:00:00,0,0,0,FMN GV 05 Lier
60,Mechelsesteenweg 365,2021-10-25,03:00:00,0,0,0,FMN GV 05 Lier
60,Mechelsesteenweg 365,2021-10-25,04:00:00,2,0,2,FMN GV 05 Lier
60,Mechelsesteenweg 365,2021-10-25,05:00:00,12,4,8,FMN GV 05 Lier
60,Mechelsesteenweg 365,2021-10-25,06:00:00,28,4,24,FMN GV 05 Lier
60,Mechelsesteenweg 365,2021-10-25,07:00:00,208,140,68,FMN GV 05 Lier
60,Mechelsesteenweg 365,2021-10-25,08:00:00,162,118,44,FMN GV 05 Lier
60,Mechelsesteenweg 365,2021-10-25,09:00:00,46,28,18,FMN GV 05 Lier
60,Mechelsesteenweg 365,2021-10-25,10:00:00,40,34,6,FMN GV 05 Lier
60,Mechelsesteenweg 365,2021-10-25,11:00:00,54,28,26,FMN GV 05 Lier
60,Mechelsesteenweg 365,2021-10-25,12:00:00,72,24,48,FMN GV 05 Lier
60,Mechelsesteenweg 365,2021-10-25,13:00:00,82,42,40,FMN GV 05 Lier
60,Mechelsesteenweg 365,2021-10-25,14:00:00,114,52,62,FMN GV 05 Lier
60,Mechelsesteenweg 365,2021-10-25,15:00:00,118,52,66,FMN GV 05 Lier
60,Mechelsesteenweg 365,2021-10-25,16:00:00,320,88,232,FMN GV 05 Lier
60,Mechelsesteenweg 365,2021-10-25,17:00:00,104,62,42,FMN GV 05 Lier
60,Mechelsesteenweg 365,2021-10-25,18:00:00,48,26,22,FMN GV 05 Lier
60,Mechelsesteenweg 365,2021-10-25,19:00:00,18,12,6,FMN GV 05 Lier
60,Mechelsesteenweg 365,2021-10-25,20:00:00,4,2,2,FMN GV 05 Lier
60,Mechelsesteenweg 365,2021-10-25,21:00:00,0,0,0,FMN GV 05 Lier
60,Mechelsesteenweg 365,2021-10-25,22:00:00,4,4,0,FMN GV 05 Lier
60,Mechelsesteenweg 365,2021-10-25,23:00:00,2,2,0,FMN GV 05 Lier
60,Mechelsesteenweg 365,2021-10-26,00:00:00,0,0,0,FMN GV 05 Lier
60,Mechelsesteenweg 365,2021-10-26,01:00:00,0,0,0,FMN GV 05 Lier
60,Mechelsesteenweg 365,2021-10-26,02:00:00,0,0,0,FMN GV 05 Lier
60,Mechelsesteenweg 365,2021-10-26,03:00:00,2,0,2,FMN GV 05 Lier
60,Mechelsesteenweg 365,2021-10-26,04:00:00,2,0,2,FMN GV 05 Lier
60,Mechelsesteenweg 365,2021-10-26,05:00:00,8,4,4,FMN GV 05 Lier
60,Mechelsesteenweg 365,2021-10-26,06:00:00,40,4,36,FMN GV 05 Lier
60,Mechelsesteenweg 365,2021-10-26,07:00:00,204,122,82,FMN GV 05 Lier
60,Mechelsesteenweg 365,2021-10-26,08:00:00,176,118,58,FMN GV 05 Lier
60,Mechelsesteenweg 365,2021-10-26,09:00:00,130,94,36,FMN GV 05 Lier
60,Mechelsesteenweg 365,2021-10-26,10:00:00,96,60,36,FMN GV 05 Lier
60,Mechelsesteenweg 365,2021-10-26,11:00:00,80,36,44,FMN GV 05 Lier
60,Mechelsesteenweg 365,2021-10-26,12:00:00,72,44,28,FMN GV 05 Lier
60,Mechelsesteenweg 365,2021-10-26,13:00:00,168,62,106,FMN GV 05 Lier
60,Mechelsesteenweg 365,2021-10-26,14:00:00,138,72,66,FMN GV 05 Lier
60,Mechelsesteenweg 365,2021-10-26,15:00:00,180,82,98,FMN GV 05 Lier
60,Mechelsesteenweg 365,2021-10-26,16:00:00,374,98,276,FMN GV 05 Lier
60,Mechelsesteenweg 365,2021-10-26,17:00:00,118,76,42,FMN GV 05 Lier
60,Mechelsesteenweg 365,2021-10-26,18:00:00,68,36,32,FMN GV 05 Lier
60,Mechelsesteenweg 365,2021-10-26,19:00:00,30,20,10,FMN GV 05 Lier
60,Mechelsesteenweg 365,2021-10-26,20:00:00,20,10,10,FMN GV 05 Lier
60,Mechelsesteenweg 365,2021-10-26,21:00:00,14,6,8,FMN GV 05 Lier
60,Mechelsesteenweg 365,2021-10-26,22:00:00,6,4,2,FMN GV 05 Lier
60,Mechelsesteenweg 365,2021-10-26,23:00:00,4,4,0,FMN GV 05 Lier
60,Mechelsesteenweg 365,2021-10-27,00:00:00,2,2,0,FMN GV 05 Lier
60,Mechelsesteenweg 365,2021-10-27,01:00:00,2,0,2,FMN GV 05 Lier
60,Mechelsesteenweg 365,2021-10-27,02:00:00,0,0,0,FMN GV 05 Lier
60,Mechelsesteenweg 365,2021-10-27,03:00:00,2,0,2,FMN GV 05 Lier
60,Mechelsesteenweg 365,2021-10-27,04:00:00,2,0,2,FMN GV 05 Lier
60,Mechelsesteenweg 365,2021-10-27,05:00:00,6,2,4,FMN GV 05 Lier
60,Mechelsesteenweg 365,2021-10-27,06:00:00,32,10,22,FMN GV 05 Lier
60,Mechelsesteenweg 365,2021-10-27,07:00:00,206,136,70,FMN GV 05 Lier
60,Mechelsesteenweg 365,2021-10-27,08:00:00,180,120,60,FMN GV 05 Lier
60,Mechelsesteenweg 365,2021-10-27,09:00:00,58,36,22,FMN GV 05 Lier
60,Mechelsesteenweg 365,2021-10-27,10:00:00,88,42,46,FMN GV 05 Lier
60,Mechelsesteenweg 365,2021-10-27,11:00:00,102,50,52,FMN GV 05 Lier
60,Mechelsesteenweg 365,2021-10-27,12:00:00,260,52,208,FMN GV 05 Lier
60,Mechelsesteenweg 365,2021-10-27,13:00:00,152,76,76,FMN GV 05 Lier
60,Mechelsesteenweg 365,2021-10-27,14:00:00,222,126,96,FMN GV 05 Lier
60,Mechelsesteenweg 365,2021-10-27,15:00:00,220,94,126,FMN GV 05 Lier
60,Mechelsesteenweg 365,2021-10-27,16:00:00,158,84,74,FMN GV 05 Lier
60,Mechelsesteenweg 365,2021-10-27,17:00:00,196,118,78,FMN GV 05 Lier
60,Mechelsesteenweg 365,2021-10-27,18:00:00,92,58,34,FMN GV 05 Lier
60,Mechelsesteenweg 365,2021-10-27,19:00:00,18,8,10,FMN GV 05 Lier
60,Mechelsesteenweg 365,2021-10-27,20:00:00,20,12,8,FMN GV 05 Lier
60,Mechelsesteenweg 365,2021-10-27,21:00:00,14,2,12,FMN GV 05 Lier
60,Mechelsesteenweg 365,2021-10-27,22:00:00,6,6,0,FMN GV 05 Lier
60,Mechelsesteenweg 365,2021-10-27,23:00:00,2,2,0,FMN GV 05 Lier
60,Mechelsesteenweg 365,2021-10-28,00:00:00,0,0,0,FMN GV 05 Lier
60,Mechelsesteenweg 365,2021-10-28,01:00:00,0,0,0,FMN GV 05 Lier
60,Mechelsesteenweg 365,2021-10-28,02:00:00,0,0,0,FMN GV 05 Lier
60,Mechelsesteenweg 365,2021-10-28,03:00:00,2,0,2,FMN GV 05 Lier
60,Mechelsesteenweg 365,2021-10-28,04:00:00,2,0,2,FMN GV 05 Lier
60,Mechelsesteenweg 365,2021-10-28,05:00:00,12,4,8,FMN GV 05 Lier
60,Mechelsesteenweg 365,2021-10-28,06:00:00,28,6,22,FMN GV 05 Lier
60,Mechelsesteenweg 365,2021-10-28,07:00:00,176,114,62,FMN GV 05 Lier
60,Mechelsesteenweg 365,2021-10-28,08:00:00,210,148,62,FMN GV 05 Lier
60,Mechelsesteenweg 365,2021-10-28,09:00:00,116,92,24,FMN GV 05 Lier
60,Mechelsesteenweg 365,2021-10-28,10:00:00,136,88,48,FMN GV 05 Lier
60,Mechelsesteenweg 365,2021-10-28,11:00:00,142,70,72,FMN GV 05 Lier
60,Mechelsesteenweg 365,2021-10-28,12:00:00,160,82,78,FMN GV 05 Lier
60,Mechelsesteenweg 365,2021-10-28,13:00:00,232,124,108,FMN GV 05 Lier
60,Mechelsesteenweg 365,2021-10-28,14:00:00,330,180,150,FMN GV 05 Lier
60,Mechelsesteenweg 365,2021-10-28,15:00:00,338,156,182,FMN GV 05 Lier
60,Mechelsesteenweg 365,2021-10-28,16:00:00,378,150,228,FMN GV 05 Lier
60,Mechelsesteenweg 365,2021-10-28,17:00:00,202,116,86,FMN GV 05 Lier
60,Mechelsesteenweg 365,2021-10-28,18:00:00,122,70,52,FMN GV 05 Lier
60,Mechelsesteenweg 365,2021-10-28,19:00:00,32,24,8,FMN GV 05 Lier
60,Mechelsesteenweg 365,2021-10-28,20:00:00,24,14,10,FMN GV 05 Lier
60,Mechelsesteenweg 365,2021-10-28,21:00:00,12,10,2,FMN GV 05 Lier
60,Mechelsesteenweg 365,2021-10-28,22:00:00,16,10,6,FMN GV 05 Lier
60,Mechelsesteenweg 365,2021-10-28,23:00:00,10,6,4,FMN GV 05 Lier
60,Mechelsesteenweg 365,2021-10-29,00:00:00,2,2,0,FMN GV 05 Lier
60,Mechelsesteenweg 365,2021-10-29,01:00:00,2,2,0,FMN GV 05 Lier
60,Mechelsesteenweg 365,2021-10-29,02:00:00,0,0,0,FMN GV 05 Lier
60,Mechelsesteenweg 365,2021-10-29,03:00:00,2,0,2,FMN GV 05 Lier
60,Mechelsesteenweg 365,2021-10-29,04:00:00,2,0,2,FMN GV 05 Lier
60,Mechelsesteenweg 365,2021-10-29,05:00:00,8,2,6,FMN GV 05 Lier
60,Mechelsesteenweg 365,2021-10-29,06:00:00,22,2,20,FMN GV 05 Lier
60,Mechelsesteenweg 365,2021-10-29,07:00:00,198,138,60,FMN GV 05 Lier
60,Mechelsesteenweg 365,2021-10-29,08:00:00,160,116,44,FMN GV 05 Lier
60,Mechelsesteenweg 365,2021-10-29,09:00:00,66,26,40,FMN GV 05 Lier
60,Mechelsesteenweg 365,2021-10-29,10:00:00,92,44,48,FMN GV 05 Lier
60,Mechelsesteenweg 365,2021-10-29,11:00:00,114,72,42,FMN GV 05 Lier
60,Mechelsesteenweg 365,2021-10-29,12:00:00,124,58,66,FMN GV 05 Lier
60,Mechelsesteenweg 365,2021-10-29,13:00:00,154,76,78,FMN GV 05 Lier
60,Mechelsesteenweg 365,2021-10-29,14:00:00,206,122,84,FMN GV 05 Lier
60,Mechelsesteenweg 365,2021-10-29,15:00:00,154,72,82,FMN GV 05 Lier
60,Mechelsesteenweg 365,2021-10-29,16:00:00,268,78,190,FMN GV 05 Lier
60,Mechelsesteenweg 365,2021-10-29,17:00:00,68,34,34,FMN GV 05 Lier
60,Mechelsesteenweg 365,2021-10-29,18:00:00,32,18,14,FMN GV 05 Lier
60,Mechelsesteenweg 365,2021-10-29,19:00:00,20,6,14,FMN GV 05 Lier
60,Mechelsesteenweg 365,2021-10-29,20:00:00,0,0,0,FMN GV 05 Lier
60,Mechelsesteenweg 365,2021-10-29,21:00:00,10,2,8,FMN GV 05 Lier
60,Mechelsesteenweg 365,2021-10-29,22:00:00,4,2,2,FMN GV 05 Lier
60,Mechelsesteenweg 365,2021-10-29,23:00:00,16,14,2,FMN GV 05 Lier
60,Mechelsesteenweg 365,2021-10-30,00:00:00,6,2,4,FMN GV 05 Lier
60,Mechelsesteenweg 365,2021-10-30,01:00:00,2,2,0,FMN GV 05 Lier
60,Mechelsesteenweg 365,2021-10-30,02:00:00,2,2,0,FMN GV 05 Lier
60,Mechelsesteenweg 365,2021-10-30,03:00:00,0,0,0,FMN GV 05 Lier
60,Mechelsesteenweg 365,2021-10-30,04:00:00,0,0,0,FMN GV 05 Lier
60,Mechelsesteenweg 365,2021-10-30,05:00:00,2,0,2,FMN GV 05 Lier
60,Mechelsesteenweg 365,2021-10-30,06:00:00,2,2,0,FMN GV 05 Lier
60,Mechelsesteenweg 365,2021-10-30,07:00:00,4,2,2,FMN GV 05 Lier
60,Mechelsesteenweg 365,2021-10-30,08:00:00,4,2,2,FMN GV 05 Lier
60,Mechelsesteenweg 365,2021-10-30,09:00:00,16,10,6,FMN GV 05 Lier
60,Mechelsesteenweg 365,2021-10-30,10:00:00,24,8,16,FMN GV 05 Lier
60,Mechelsesteenweg 365,2021-10-30,11:00:00,42,24,18,FMN GV 05 Lier
60,Mechelsesteenweg 365,2021-10-30,12:00:00,22,16,6,FMN GV 05 Lier
60,Mechelsesteenweg 365,2021-10-30,13:00:00,24,16,8,FMN GV 05 Lier
60,Mechelsesteenweg 365,2021-10-30,14:00:00,32,12,20,FMN GV 05 Lier
60,Mechelsesteenweg 365,2021-10-30,15:00:00,40,26,14,FMN GV 05 Lier
60,Mechelsesteenweg 365,2021-10-30,16:00:00,50,24,26,FMN GV 05 Lier
60,Mechelsesteenweg 365,2021-10-30,17:00:00,38,22,16,FMN GV 05 Lier
60,Mechelsesteenweg 365,2021-10-30,18:00:00,4,4,0,FMN GV 05 Lier
60,Mechelsesteenweg 365,2021-10-30,19:00:00,4,2,2,FMN GV 05 Lier
60,Mechelsesteenweg 365,2021-10-30,20:00:00,38,10,28,FMN GV 05 Lier
60,Mechelsesteenweg 365,2021-10-30,21:00:00,14,4,10,FMN GV 05 Lier
60,Mechelsesteenweg 365,2021-10-30,22:00:00,8,2,6,FMN GV 05 Lier
60,Mechelsesteenweg 365,2021-10-30,23:00:00,16,2,14,FMN GV 05 Lier
60,Mechelsesteenweg 365,2021-10-31,00:00:00,22,4,18,FMN GV 05 Lier
60,Mechelsesteenweg 365,2021-10-31,01:00:00,6,6,0,FMN GV 05 Lier
60,Mechelsesteenweg 365,2021-10-31,02:00:00,32,32,0,FMN GV 05 Lier
60,Mechelsesteenweg 365,2021-10-31,03:00:00,10,8,2,FMN GV 05 Lier
60,Mechelsesteenweg 365,2021-10-31,04:00:00,0,0,0,FMN GV 05 Lier
60,Mechelsesteenweg 365,2021-10-31,05:00:00,10,10,0,FMN GV 05 Lier
60,Mechelsesteenweg 365,2021-10-31,06:00:00,2,2,0,FMN GV 05 Lier
60,Mechelsesteenweg 365,2021-10-31,07:00:00,4,0,4,FMN GV 05 Lier
60,Mechelsesteenweg 365,2021-10-31,08:00:00,40,20,20,FMN GV 05 Lier
60,Mechelsesteenweg 365,2021-10-31,09:00:00,146,88,58,FMN GV 05 Lier
60,Mechelsesteenweg 365,2021-10-31,10:00:00,238,126,112,FMN GV 05 Lier
60,Mechelsesteenweg 365,2021-10-31,11:00:00,218,108,110,FMN GV 05 Lier
60,Mechelsesteenweg 365,2021-10-31,12:00:00,148,78,70,FMN GV 05 Lier
60,Mechelsesteenweg 365,2021-10-31,13:00:00,62,24,38,FMN GV 05 Lier
60,Mechelsesteenweg 365,2021-10-31,14:00:00,64,28,36,FMN GV 05 Lier
60,Mechelsesteenweg 365,2021-10-31,15:00:00,14,6,8,FMN GV 05 Lier
60,Mechelsesteenweg 365,2021-10-31,16:00:00,14,4,10,FMN GV 05 Lier
60,Mechelsesteenweg 365,2021-10-31,17:00:00,12,4,8,FMN GV 05 Lier
60,Mechelsesteenweg 365,2021-10-31,18:00:00,0,0,0,FMN GV 05 Lier
60,Mechelsesteenweg 365,2021-10-31,19:00:00,0,0,0,FMN GV 05 Lier
60,Mechelsesteenweg 365,2021-10-31,20:00:00,0,0,0,FMN GV 05 Lier
60,Mechelsesteenweg 365,2021-10-31,21:00:00,4,2,2,FMN GV 05 Lier
60,Mechelsesteenweg 365,2021-10-31,22:00:00,2,0,2,FMN GV 05 Lier
60,Mechelsesteenweg 365,2021-10-31,23:00:00,0,0,0,FMN GV 05 Lier
60,Mechelsesteenweg 365,2021-11-01,00:00:00,0,0,0,FMN GV 05 Lier
60,Mechelsesteenweg 365,2021-11-01,01:00:00,0,0,0,FMN GV 05 Lier
60,Mechelsesteenweg 365,2021-11-01,02:00:00,0,0,0,FMN GV 05 Lier
60,Mechelsesteenweg 365,2021-11-01,03:00:00,0,0,0,FMN GV 05 Lier
60,Mechelsesteenweg 365,2021-11-01,04:00:00,0,0,0,FMN GV 05 Lier
60,Mechelsesteenweg 365,2021-11-01,05:00:00,2,0,2,FMN GV 05 Lier
60,Mechelsesteenweg 365,2021-11-01,06:00:00,6,6,0,FMN GV 05 Lier
60,Mechelsesteenweg 365,2021-11-01,07:00:00,4,0,4,FMN GV 05 Lier
60,Mechelsesteenweg 365,2021-11-01,08:00:00,18,10,8,FMN GV 05 Lier
60,Mechelsesteenweg 365,2021-11-01,09:00:00,54,24,30,FMN GV 05 Lier
60,Mechelsesteenweg 365,2021-11-01,10:00:00,100,74,26,FMN GV 05 Lier
60,Mechelsesteenweg 365,2021-11-01,11:00:00,138,72,66,FMN GV 05 Lier
60,Mechelsesteenweg 365,2021-11-01,12:00:00,90,40,50,FMN GV 05 Lier
60,Mechelsesteenweg 365,2021-11-01,13:00:00,58,34,24,FMN GV 05 Lier
60,Mechelsesteenweg 365,2021-11-01,14:00:00,76,48,28,FMN GV 05 Lier
60,Mechelsesteenweg 365,2021-11-01,15:00:00,86,56,30,FMN GV 05 Lier
60,Mechelsesteenweg 365,2021-11-01,16:00:00,42,20,22,FMN GV 05 Lier
60,Mechelsesteenweg 365,2021-11-01,17:00:00,8,4,4,FMN GV 05 Lier
60,Mechelsesteenweg 365,2021-11-01,18:00:00,6,6,0,FMN GV 05 Lier
60,Mechelsesteenweg 365,2021-11-01,19:00:00,6,2,4,FMN GV 05 Lier
60,Mechelsesteenweg 365,2021-11-01,20:00:00,2,2,0,FMN GV 05 Lier
60,Mechelsesteenweg 365,2021-11-01,21:00:00,4,0,4,FMN GV 05 Lier
60,Mechelsesteenweg 365,2021-11-01,22:00:00,2,0,2,FMN GV 05 Lier
60,Mechelsesteenweg 365,2021-11-01,23:00:00,4,0,4,FMN GV 05 Lier
60,Mechelsesteenweg 365,2021-11-02,00:00:00,0,0,0,FMN GV 05 Lier
60,Mechelsesteenweg 365,2021-11-02,01:00:00,0,0,0,FMN GV 05 Lier
60,Mechelsesteenweg 365,2021-11-02,02:00:00,0,0,0,FMN GV 05 Lier
60,Mechelsesteenweg 365,2021-11-02,03:00:00,2,0,2,FMN GV 05 Lier
60,Mechelsesteenweg 365,2021-11-02,04:00:00,2,0,2,FMN GV 05 Lier
60,Mechelsesteenweg 365,2021-11-02,05:00:00,0,0,0,FMN GV 05 Lier
60,Mechelsesteenweg 365,2021-11-02,06:00:00,18,2,16,FMN GV 05 Lier
60,Mechelsesteenweg 365,2021-11-02,07:00:00,42,16,26,FMN GV 05 Lier
60,Mechelsesteenweg 365,2021-11-02,08:00:00,16,6,10,FMN GV 05 Lier
60,Mechelsesteenweg 365,2021-11-02,09:00:00,22,8,14,FMN GV 05 Lier
60,Mechelsesteenweg 365,2021-11-02,10:00:00,38,14,24,FMN GV 05 Lier
60,Mechelsesteenweg 365,2021-11-02,11:00:00,24,18,6,FMN GV 05 Lier
60,Mechelsesteenweg 365,2021-11-02,12:00:00,16,8,8,FMN GV 05 Lier
60,Mechelsesteenweg 365,2021-11-02,13:00:00,28,18,10,FMN GV 05 Lier
60,Mechelsesteenweg 365,2021-11-02,14:00:00,64,40,24,FMN GV 05 Lier
60,Mechelsesteenweg 365,2021-11-02,15:00:00,70,34,36,FMN GV 05 Lier
60,Mechelsesteenweg 365,2021-11-02,16:00:00,62,24,38,FMN GV 05 Lier
60,Mechelsesteenweg 365,2021-11-02,17:00:00,64,38,26,FMN GV 05 Lier
60,Mechelsesteenweg 365,2021-11-02,18:00:00,16,12,4,FMN GV 05 Lier
60,Mechelsesteenweg 365,2021-11-02,19:00:00,4,2,2,FMN GV 05 Lier
60,Mechelsesteenweg 365,2021-11-02,20:00:00,6,2,4,FMN GV 05 Lier
60,Mechelsesteenweg 365,2021-11-02,21:00:00,12,8,4,FMN GV 05 Lier
60,Mechelsesteenweg 365,2021-11-02,22:00:00,2,0,2,FMN GV 05 Lier
60,Mechelsesteenweg 365,2021-11-02,23:00:00,2,0,2,FMN GV 05 Lier
60,Mechelsesteenweg 365,2021-11-03,00:00:00,4,0,4,FMN GV 05 Lier
60,Mechelsesteenweg 365,2021-11-03,01:00:00,0,0,0,FMN GV 05 Lier
60,Mechelsesteenweg 365,2021-11-03,02:00:00,0,0,0,FMN GV 05 Lier
60,Mechelsesteenweg 365,2021-11-03,03:00:00,2,0,2,FMN GV 05 Lier
60,Mechelsesteenweg 365,2021-11-03,04:00:00,0,0,0,FMN GV 05 Lier
60,Mechelsesteenweg 365,2021-11-03,05:00:00,4,2,2,FMN GV 05 Lier
60,Mechelsesteenweg 365,2021-11-03,06:00:00,22,8,14,FMN GV 05 Lier
60,Mechelsesteenweg 365,2021-11-03,07:00:00,58,20,38,FMN GV 05 Lier
60,Mechelsesteenweg 365,2021-11-03,08:00:00,24,12,12,FMN GV 05 Lier
60,Mechelsesteenweg 365,2021-11-03,09:00:00,38,26,12,FMN GV 05 Lier
60,Mechelsesteenweg 365,2021-11-03,10:00:00,58,24,34,FMN GV 05 Lier
60,Mechelsesteenweg 365,2021-11-03,11:00:00,92,40,52,FMN GV 05 Lier
60,Mechelsesteenweg 365,2021-11-03,12:00:00,92,56,36,FMN GV 05 Lier
60,Mechelsesteenweg 365,2021-11-03,13:00:00,118,60,58,FMN GV 05 Lier
60,Mechelsesteenweg 365,2021-11-03,14:00:00,140,76,64,FMN GV 05 Lier
60,Mechelsesteenweg 365,2021-11-03,15:00:00,144,58,86,FMN GV 05 Lier
60,Mechelsesteenweg 365,2021-11-03,16:00:00,104,56,48,FMN GV 05 Lier
60,Mechelsesteenweg 365,2021-11-03,17:00:00,62,38,24,FMN GV 05 Lier
60,Mechelsesteenweg 365,2021-11-03,18:00:00,32,20,12,FMN GV 05 Lier
60,Mechelsesteenweg 365,2021-11-03,19:00:00,4,2,2,FMN GV 05 Lier
60,Mechelsesteenweg 365,2021-11-03,20:00:00,4,2,2,FMN GV 05 Lier
60,Mechelsesteenweg 365,2021-11-03,21:00:00,12,6,6,FMN GV 05 Lier
60,Mechelsesteenweg 365,2021-11-03,22:00:00,0,0,0,FMN GV 05 Lier
60,Mechelsesteenweg 365,2021-11-03,23:00:00,2,2,0,FMN GV 05 Lier
60,Mechelsesteenweg 365,2021-11-04,00:00:00,0,0,0,FMN GV 05 Lier
60,Mechelsesteenweg 365,2021-11-04,01:00:00,0,0,0,FMN GV 05 Lier
60,Mechelsesteenweg 365,2021-11-04,02:00:00,0,0,0,FMN GV 05 Lier
60,Mechelsesteenweg 365,2021-11-04,03:00:00,0,0,0,FMN GV 05 Lier
60,Mechelsesteenweg 365,2021-11-04,04:00:00,2,0,2,FMN GV 05 Lier
60,Mechelsesteenweg 365,2021-11-04,05:00:00,8,2,6,FMN GV 05 Lier
60,Mechelsesteenweg 365,2021-11-04,06:00:00,24,4,20,FMN GV 05 Lier
60,Mechelsesteenweg 365,2021-11-04,07:00:00,48,14,34,FMN GV 05 Lier
60,Mechelsesteenweg 365,2021-11-04,08:00:00,30,10,20,FMN GV 05 Lier
60,Mechelsesteenweg 365,2021-11-04,09:00:00,20,14,6,FMN GV 05 Lier
60,Mechelsesteenweg 365,2021-11-04,10:00:00,44,20,24,FMN GV 05 Lier
60,Mechelsesteenweg 365,2021-11-04,11:00:00,30,14,16,FMN GV 05 Lier
60,Mechelsesteenweg 365,2021-11-04,12:00:00,38,20,18,FMN GV 05 Lier
60,Mechelsesteenweg 365,2021-11-04,13:00:00,18,10,8,FMN GV 05 Lier
60,Mechelsesteenweg 365,2021-11-04,14:00:00,24,14,10,FMN GV 05 Lier
60,Mechelsesteenweg 365,2021-11-04,15:00:00,62,34,28,FMN GV 05 Lier
60,Mechelsesteenweg 365,2021-11-04,16:00:00,54,30,24,FMN GV 05 Lier
60,Mechelsesteenweg 365,2021-11-04,17:00:00,56,28,28,FMN GV 05 Lier
60,Mechelsesteenweg 365,2021-11-04,18:00:00,24,12,12,FMN GV 05 Lier
60,Mechelsesteenweg 365,2021-11-04,19:00:00,18,14,4,FMN GV 05 Lier
60,Mechelsesteenweg 365,2021-11-04,20:00:00,2,0,2,FMN GV 05 Lier
60,Mechelsesteenweg 365,2021-11-04,21:00:00,14,4,10,FMN GV 05 Lier
60,Mechelsesteenweg 365,2021-11-04,22:00:00,6,2,4,FMN GV 05 Lier
60,Mechelsesteenweg 365,2021-11-04,23:00:00,4,4,0,FMN GV 05 Lier
60,Mechelsesteenweg 365,2021-11-05,00:00:00,4,0,4,FMN GV 05 Lier
60,Mechelsesteenweg 365,2021-11-05,01:00:00,0,0,0,FMN GV 05 Lier
60,Mechelsesteenweg 365,2021-11-05,02:00:00,0,0,0,FMN GV 05 Lier
60,Mechelsesteenweg 365,2021-11-05,03:00:00,2,0,2,FMN GV 05 Lier
60,Mechelsesteenweg 365,2021-11-05,04:00:00,0,0,0,FMN GV 05 Lier
60,Mechelsesteenweg 365,2021-11-05,05:00:00,8,4,4,FMN GV 05 Lier
60,Mechelsesteenweg 365,2021-11-05,06:00:00,18,10,8,FMN GV 05 Lier
60,Mechelsesteenweg 365,2021-11-05,07:00:00,50,26,24,FMN GV 05 Lier
60,Mechelsesteenweg 365,2021-11-05,08:00:00,48,22,26,FMN GV 05 Lier
60,Mechelsesteenweg 365,2021-11-05,09:00:00,38,24,14,FMN GV 05 Lier
60,Mechelsesteenweg 365,2021-11-05,10:00:00,88,60,28,FMN GV 05 Lier
60,Mechelsesteenweg 365,2021-11-05,11:00:00,96,58,38,FMN GV 05 Lier
60,Mechelsesteenweg 365,2021-11-05,12:00:00,88,42,46,FMN GV 05 Lier
60,Mechelsesteenweg 365,2021-11-05,13:00:00,78,36,42,FMN GV 05 Lier
60,Mechelsesteenweg 365,2021-11-05,14:00:00,72,48,24,FMN GV 05 Lier
60,Mechelsesteenweg 365,2021-11-05,15:00:00,68,48,20,FMN GV 05 Lier
60,Mechelsesteenweg 365,2021-11-05,16:00:00,74,36,38,FMN GV 05 Lier
60,Mechelsesteenweg 365,2021-11-05,17:00:00,54,28,26,FMN GV 05 Lier
60,Mechelsesteenweg 365,2021-11-05,18:00:00,26,16,10,FMN GV 05 Lier
60,Mechelsesteenweg 365,2021-11-05,19:00:00,12,8,4,FMN GV 05 Lier
60,Mechelsesteenweg 365,2021-11-05,20:00:00,8,2,6,FMN GV 05 Lier
60,Mechelsesteenweg 365,2021-11-05,21:00:00,0,0,0,FMN GV 05 Lier
60,Mechelsesteenweg 365,2021-11-05,22:00:00,8,2,6,FMN GV 05 Lier
60,Mechelsesteenweg 365,2021-11-05,23:00:00,0,0,0,FMN GV 05 Lier
60,Mechelsesteenweg 365,2021-11-06,00:00:00,6,0,6,FMN GV 05 Lier
60,Mechelsesteenweg 365,2021-11-06,01:00:00,2,0,2,FMN GV 05 Lier
60,Mechelsesteenweg 365,2021-11-06,02:00:00,6,6,0,FMN GV 05 Lier
60,Mechelsesteenweg 365,2021-11-06,03:00:00,4,0,4,FMN GV 05 Lier
60,Mechelsesteenweg 365,2021-11-06,04:00:00,0,0,0,FMN GV 05 Lier
60,Mechelsesteenweg 365,2021-11-06,05:00:00,2,0,2,FMN GV 05 Lier
60,Mechelsesteenweg 365,2021-11-06,06:00:00,4,2,2,FMN GV 05 Lier
60,Mechelsesteenweg 365,2021-11-06,07:00:00,10,4,6,FMN GV 05 Lier
60,Mechelsesteenweg 365,2021-11-06,08:00:00,24,6,18,FMN GV 05 Lier
60,Mechelsesteenweg 365,2021-11-06,09:00:00,62,26,36,FMN GV 05 Lier
60,Mechelsesteenweg 365,2021-11-06,10:00:00,94,64,30,FMN GV 05 Lier
60,Mechelsesteenweg 365,2021-11-06,11:00:00,130,66,64,FMN GV 05 Lier
60,Mechelsesteenweg 365,2021-11-06,12:00:00,118,66,52,FMN GV 05 Lier
60,Mechelsesteenweg 365,2021-11-06,13:00:00,122,70,52,FMN GV 05 Lier
60,Mechelsesteenweg 365,2021-11-06,14:00:00,106,68,38,FMN GV 05 Lier
60,Mechelsesteenweg 365,2021-11-06,15:00:00,104,56,48,FMN GV 05 Lier
60,Mechelsesteenweg 365,2021-11-06,16:00:00,48,32,16,FMN GV 05 Lier
60,Mechelsesteenweg 365,2021-11-06,17:00:00,18,8,10,FMN GV 05 Lier
60,Mechelsesteenweg 365,2021-11-06,18:00:00,12,8,4,FMN GV 05 Lier
60,Mechelsesteenweg 365,2021-11-06,19:00:00,2,2,0,FMN GV 05 Lier
60,Mechelsesteenweg 365,2021-11-06,20:00:00,6,0,6,FMN GV 05 Lier
60,Mechelsesteenweg 365,2021-11-06,21:00:00,12,4,8,FMN GV 05 Lier
60,Mechelsesteenweg 365,2021-11-06,22:00:00,2,2,0,FMN GV 05 Lier
60,Mechelsesteenweg 365,2021-11-06,23:00:00,6,6,0,FMN GV 05 Lier
60,Mechelsesteenweg 365,2021-11-07,00:00:00,0,0,0,FMN GV 05 Lier
60,Mechelsesteenweg 365,2021-11-07,01:00:00,6,0,6,FMN GV 05 Lier
60,Mechelsesteenweg 365,2021-11-07,02:00:00,0,0,0,FMN GV 05 Lier
60,Mechelsesteenweg 365,2021-11-07,03:00:00,2,0,2,FMN GV 05 Lier
60,Mechelsesteenweg 365,2021-11-07,04:00:00,0,0,0,FMN GV 05 Lier
60,Mechelsesteenweg 365,2021-11-07,05:00:00,2,0,2,FMN GV 05 Lier
60,Mechelsesteenweg 365,2021-11-07,06:00:00,2,2,0,FMN GV 05 Lier
60,Mechelsesteenweg 365,2021-11-07,07:00:00,12,4,8,FMN GV 05 Lier
60,Mechelsesteenweg 365,2021-11-07,08:00:00,30,18,12,FMN GV 05 Lier
60,Mechelsesteenweg 365,2021-11-07,09:00:00,104,80,24,FMN GV 05 Lier
60,Mechelsesteenweg 365,2021-11-07,10:00:00,174,110,64,FMN GV 05 Lier
60,Mechelsesteenweg 365,2021-11-07,11:00:00,222,146,76,FMN GV 05 Lier
60,Mechelsesteenweg 365,2021-11-07,12:00:00,150,88,62,FMN GV 05 Lier
60,Mechelsesteenweg 365,2021-11-07,13:00:00,118,56,62,FMN GV 05 Lier
60,Mechelsesteenweg 365,2021-11-07,14:00:00,122,88,34,FMN GV 05 Lier
60,Mechelsesteenweg 365,2021-11-07,15:00:00,96,44,52,FMN GV 05 Lier
60,Mechelsesteenweg 365,2021-11-07,16:00:00,52,20,32,FMN GV 05 Lier
60,Mechelsesteenweg 365,2021-11-07,17:00:00,24,8,16,FMN GV 05 Lier
60,Mechelsesteenweg 365,2021-11-07,18:00:00,2,2,0,FMN GV 05 Lier
60,Mechelsesteenweg 365,2021-11-07,19:00:00,2,0,2,FMN GV 05 Lier
60,Mechelsesteenweg 365,2021-11-07,20:00:00,0,0,0,FMN GV 05 Lier
60,Mechelsesteenweg 365,2021-11-07,21:00:00,0,0,0,FMN GV 05 Lier
60,Mechelsesteenweg 365,2021-11-07,22:00:00,4,2,2,FMN GV 05 Lier
60,Mechelsesteenweg 365,2021-11-07,23:00:00,0,0,0,FMN GV 05 Lier
60,Mechelsesteenweg 365,2021-11-08,00:00:00,0,0,0,FMN GV 05 Lier
60,Mechelsesteenweg 365,2021-11-08,01:00:00,0,0,0,FMN GV 05 Lier
60,Mechelsesteenweg 365,2021-11-08,02:00:00,2,0,2,FMN GV 05 Lier
60,Mechelsesteenweg 365,2021-11-08,03:00:00,4,0,4,FMN GV 05 Lier
60,Mechelsesteenweg 365,2021-11-08,04:00:00,2,0,2,FMN GV 05 Lier
60,Mechelsesteenweg 365,2021-11-08,05:00:00,8,0,8,FMN GV 05 Lier
60,Mechelsesteenweg 365,2021-11-08,06:00:00,24,6,18,FMN GV 05 Lier
60,Mechelsesteenweg 365,2021-11-08,07:00:00,198,140,58,FMN GV 05 Lier
60,Mechelsesteenweg 365,2021-11-08,08:00:00,170,122,48,FMN GV 05 Lier
60,Mechelsesteenweg 365,2021-11-08,09:00:00,36,18,18,FMN GV 05 Lier
60,Mechelsesteenweg 365,2021-11-08,10:00:00,54,22,32,FMN GV 05 Lier
60,Mechelsesteenweg 365,2021-11-08,11:00:00,86,46,40,FMN GV 05 Lier
60,Mechelsesteenweg 365,2021-11-08,12:00:00,112,54,58,FMN GV 05 Lier
60,Mechelsesteenweg 365,2021-11-08,13:00:00,166,92,74,FMN GV 05 Lier
60,Mechelsesteenweg 365,2021-11-08,14:00:00,236,134,102,FMN GV 05 Lier
60,Mechelsesteenweg 365,2021-11-08,15:00:00,186,70,116,FMN GV 05 Lier
60,Mechelsesteenweg 365,2021-11-08,16:00:00,292,84,208,FMN GV 05 Lier
60,Mechelsesteenweg 365,2021-11-08,17:00:00,112,78,34,FMN GV 05 Lier
60,Mechelsesteenweg 365,2021-11-08,18:00:00,48,32,16,FMN GV 05 Lier
60,Mechelsesteenweg 365,2021-11-08,19:00:00,8,2,6,FMN GV 05 Lier
60,Mechelsesteenweg 365,2021-11-08,20:00:00,6,6,0,FMN GV 05 Lier
60,Mechelsesteenweg 365,2021-11-08,21:00:00,16,4,12,FMN GV 05 Lier
60,Mechelsesteenweg 365,2021-11-08,22:00:00,2,2,0,FMN GV 05 Lier
60,Mechelsesteenweg 365,2021-11-08,23:00:00,0,0,0,FMN GV 05 Lier
60,Mechelsesteenweg 365,2021-11-09,00:00:00,0,0,0,FMN GV 05 Lier
60,Mechelsesteenweg 365,2021-11-09,01:00:00,2,2,0,FMN GV 05 Lier
60,Mechelsesteenweg 365,2021-11-09,02:00:00,2,2,0,FMN GV 05 Lier
60,Mechelsesteenweg 365,2021-11-09,03:00:00,0,0,0,FMN GV 05 Lier
60,Mechelsesteenweg 365,2021-11-09,04:00:00,2,0,2,FMN GV 05 Lier
60,Mechelsesteenweg 365,2021-11-09,05:00:00,8,2,6,FMN GV 05 Lier
60,Mechelsesteenweg 365,2021-11-09,06:00:00,30,12,18,FMN GV 05 Lier
60,Mechelsesteenweg 365,2021-11-09,07:00:00,200,120,80,FMN GV 05 Lier
60,Mechelsesteenweg 365,2021-11-09,08:00:00,200,136,64,FMN GV 05 Lier
60,Mechelsesteenweg 365,2021-11-09,09:00:00,84,28,56,FMN GV 05 Lier
60,Mechelsesteenweg 365,2021-11-09,10:00:00,88,48,40,FMN GV 05 Lier
60,Mechelsesteenweg 365,2021-11-09,11:00:00,166,88,78,FMN GV 05 Lier
60,Mechelsesteenweg 365,2021-11-09,12:00:00,126,68,58,FMN GV 05 Lier
60,Mechelsesteenweg 365,2021-11-09,13:00:00,156,94,62,FMN GV 05 Lier
60,Mechelsesteenweg 365,2021-11-09,14:00:00,212,134,78,FMN GV 05 Lier
60,Mechelsesteenweg 365,2021-11-09,15:00:00,274,136,138,FMN GV 05 Lier
60,Mechelsesteenweg 365,2021-11-09,16:00:00,310,100,210,FMN GV 05 Lier
60,Mechelsesteenweg 365,2021-11-09,17:00:00,112,70,42,FMN GV 05 Lier
60,Mechelsesteenweg 365,2021-11-09,18:00:00,42,34,8,FMN GV 05 Lier
60,Mechelsesteenweg 365,2021-11-09,19:00:00,24,14,10,FMN GV 05 Lier
60,Mechelsesteenweg 365,2021-11-09,20:00:00,8,2,6,FMN GV 05 Lier
60,Mechelsesteenweg 365,2021-11-09,21:00:00,0,0,0,FMN GV 05 Lier
60,Mechelsesteenweg 365,2021-11-09,22:00:00,6,4,2,FMN GV 05 Lier
60,Mechelsesteenweg 365,2021-11-09,23:00:00,4,4,0,FMN GV 05 Lier
60,Mechelsesteenweg 365,2021-11-10,00:00:00,0,0,0,FMN GV 05 Lier
60,Mechelsesteenweg 365,2021-11-10,01:00:00,0,0,0,FMN GV 05 Lier
60,Mechelsesteenweg 365,2021-11-10,02:00:00,2,2,0,FMN GV 05 Lier
60,Mechelsesteenweg 365,2021-11-10,03:00:00,2,0,2,FMN GV 05 Lier
60,Mechelsesteenweg 365,2021-11-10,04:00:00,2,0,2,FMN GV 05 Lier
60,Mechelsesteenweg 365,2021-11-10,05:00:00,6,4,2,FMN GV 05 Lier
60,Mechelsesteenweg 365,2021-11-10,06:00:00,16,2,14,FMN GV 05 Lier
60,Mechelsesteenweg 365,2021-11-10,07:00:00,200,134,66,FMN GV 05 Lier
60,Mechelsesteenweg 365,2021-11-10,08:00:00,160,118,42,FMN GV 05 Lier
60,Mechelsesteenweg 365,2021-11-10,09:00:00,44,22,22,FMN GV 05 Lier
60,Mechelsesteenweg 365,2021-11-10,10:00:00,72,38,34,FMN GV 05 Lier
60,Mechelsesteenweg 365,2021-11-10,11:00:00,82,38,44,FMN GV 05 Lier
60,Mechelsesteenweg 365,2021-11-10,12:00:00,288,74,214,FMN GV 05 Lier
60,Mechelsesteenweg 365,2021-11-10,13:00:00,164,84,80,FMN GV 05 Lier
60,Mechelsesteenweg 365,2021-11-10,14:00:00,274,136,138,FMN GV 05 Lier
60,Mechelsesteenweg 365,2021-11-10,15:00:00,214,88,126,FMN GV 05 Lier
60,Mechelsesteenweg 365,2021-11-10,16:00:00,132,66,66,FMN GV 05 Lier
60,Mechelsesteenweg 365,2021-11-10,17:00:00,76,46,30,FMN GV 05 Lier
60,Mechelsesteenweg 365,2021-11-10,18:00:00,28,22,6,FMN GV 05 Lier
60,Mechelsesteenweg 365,2021-11-10,19:00:00,16,8,8,FMN GV 05 Lier
60,Mechelsesteenweg 365,2021-11-10,20:00:00,8,4,4,FMN GV 05 Lier
60,Mechelsesteenweg 365,2021-11-10,21:00:00,8,0,8,FMN GV 05 Lier
60,Mechelsesteenweg 365,2021-11-10,22:00:00,10,8,2,FMN GV 05 Lier
60,Mechelsesteenweg 365,2021-11-10,23:00:00,2,2,0,FMN GV 05 Lier
60,Mechelsesteenweg 365,2021-11-11,00:00:00,2,0,2,FMN GV 05 Lier
60,Mechelsesteenweg 365,2021-11-11,01:00:00,0,0,0,FMN GV 05 Lier
60,Mechelsesteenweg 365,2021-11-11,02:00:00,2,2,0,FMN GV 05 Lier
60,Mechelsesteenweg 365,2021-11-11,03:00:00,0,0,0,FMN GV 05 Lier
60,Mechelsesteenweg 365,2021-11-11,04:00:00,2,0,2,FMN GV 05 Lier
60,Mechelsesteenweg 365,2021-11-11,05:00:00,2,0,2,FMN GV 05 Lier
60,Mechelsesteenweg 365,2021-11-11,06:00:00,6,0,6,FMN GV 05 Lier
60,Mechelsesteenweg 365,2021-11-11,07:00:00,4,4,0,FMN GV 05 Lier
60,Mechelsesteenweg 365,2021-11-11,08:00:00,10,2,8,FMN GV 05 Lier
60,Mechelsesteenweg 365,2021-11-11,09:00:00,76,60,16,FMN GV 05 Lier
60,Mechelsesteenweg 365,2021-11-11,10:00:00,178,98,80,FMN GV 05 Lier
60,Mechelsesteenweg 365,2021-11-11,11:00:00,174,70,104,FMN GV 05 Lier
60,Mechelsesteenweg 365,2021-11-11,12:00:00,124,50,74,FMN GV 05 Lier
60,Mechelsesteenweg 365,2021-11-11,13:00:00,144,72,72,FMN GV 05 Lier
60,Mechelsesteenweg 365,2021-11-11,14:00:00,214,158,56,FMN GV 05 Lier
60,Mechelsesteenweg 365,2021-11-11,15:00:00,158,86,72,FMN GV 05 Lier
60,Mechelsesteenweg 365,2021-11-11,16:00:00,138,42,96,FMN GV 05 Lier
60,Mechelsesteenweg 365,2021-11-11,17:00:00,40,22,18,FMN GV 05 Lier
60,Mechelsesteenweg 365,2021-11-11,18:00:00,16,10,6,FMN GV 05 Lier
60,Mechelsesteenweg 365,2021-11-11,19:00:00,20,8,12,FMN GV 05 Lier
60,Mechelsesteenweg 365,2021-11-11,20:00:00,4,4,0,FMN GV 05 Lier
60,Mechelsesteenweg 365,2021-11-11,21:00:00,4,0,4,FMN GV 05 Lier
60,Mechelsesteenweg 365,2021-11-11,22:00:00,0,0,0,FMN GV 05 Lier
60,Mechelsesteenweg 365,2021-11-11,23:00:00,2,0,2,FMN GV 05 Lier
60,Mechelsesteenweg 365,2021-11-12,00:00:00,2,0,2,FMN GV 05 Lier
60,Mechelsesteenweg 365,2021-11-12,01:00:00,4,4,0,FMN GV 05 Lier
60,Mechelsesteenweg 365,2021-11-12,02:00:00,0,0,0,FMN GV 05 Lier
60,Mechelsesteenweg 365,2021-11-12,03:00:00,2,0,2,FMN GV 05 Lier
60,Mechelsesteenweg 365,2021-11-12,04:00:00,0,0,0,FMN GV 05 Lier
60,Mechelsesteenweg 365,2021-11-12,05:00:00,2,2,0,FMN GV 05 Lier
60,Mechelsesteenweg 365,2021-11-12,06:00:00,6,0,6,FMN GV 05 Lier
60,Mechelsesteenweg 365,2021-11-12,07:00:00,158,120,38,FMN GV 05 Lier
60,Mechelsesteenweg 365,2021-11-12,08:00:00,142,90,52,FMN GV 05 Lier
60,Mechelsesteenweg 365,2021-11-12,09:00:00,74,48,26,FMN GV 05 Lier
60,Mechelsesteenweg 365,2021-11-12,10:00:00,122,60,62,FMN GV 05 Lier
60,Mechelsesteenweg 365,2021-11-12,11:00:00,122,72,50,FMN GV 05 Lier
60,Mechelsesteenweg 365,2021-11-12,12:00:00,124,50,74,FMN GV 05 Lier
60,Mechelsesteenweg 365,2021-11-12,13:00:00,182,104,78,FMN GV 05 Lier
60,Mechelsesteenweg 365,2021-11-12,14:00:00,256,128,128,FMN GV 05 Lier
60,Mechelsesteenweg 365,2021-11-12,15:00:00,206,104,102,FMN GV 05 Lier
60,Mechelsesteenweg 365,2021-11-12,16:00:00,252,78,174,FMN GV 05 Lier
60,Mechelsesteenweg 365,2021-11-12,17:00:00,66,28,38,FMN GV 05 Lier
60,Mechelsesteenweg 365,2021-11-12,18:00:00,26,12,14,FMN GV 05 Lier
60,Mechelsesteenweg 365,2021-11-12,19:00:00,18,8,10,FMN GV 05 Lier
60,Mechelsesteenweg 365,2021-11-12,20:00:00,4,2,2,FMN GV 05 Lier
60,Mechelsesteenweg 365,2021-11-12,21:00:00,10,0,10,FMN GV 05 Lier
60,Mechelsesteenweg 365,2021-11-12,22:00:00,16,8,8,FMN GV 05 Lier
60,Mechelsesteenweg 365,2021-11-12,23:00:00,2,0,2,FMN GV 05 Lier
60,Mechelsesteenweg 365,2021-11-13,00:00:00,0,0,0,FMN GV 05 Lier
60,Mechelsesteenweg 365,2021-11-13,01:00:00,2,2,0,FMN GV 05 Lier
60,Mechelsesteenweg 365,2021-11-13,02:00:00,0,0,0,FMN GV 05 Lier
60,Mechelsesteenweg 365,2021-11-13,03:00:00,0,0,0,FMN GV 05 Lier
60,Mechelsesteenweg 365,2021-11-13,04:00:00,0,0,0,FMN GV 05 Lier
60,Mechelsesteenweg 365,2021-11-13,05:00:00,2,0,2,FMN GV 05 Lier
60,Mechelsesteenweg 365,2021-11-13,06:00:00,2,0,2,FMN GV 05 Lier
60,Mechelsesteenweg 365,2021-11-13,07:00:00,6,0,6,FMN GV 05 Lier
60,Mechelsesteenweg 365,2021-11-13,08:00:00,10,8,2,FMN GV 05 Lier
60,Mechelsesteenweg 365,2021-11-13,09:00:00,22,12,10,FMN GV 05 Lier
60,Mechelsesteenweg 365,2021-11-13,10:00:00,30,16,14,FMN GV 05 Lier
60,Mechelsesteenweg 365,2021-11-13,11:00:00,36,10,26,FMN GV 05 Lier
60,Mechelsesteenweg 365,2021-11-13,12:00:00,32,14,18,FMN GV 05 Lier
60,Mechelsesteenweg 365,2021-11-13,13:00:00,34,14,20,FMN GV 05 Lier
60,Mechelsesteenweg 365,2021-11-13,14:00:00,66,16,50,FMN GV 05 Lier
60,Mechelsesteenweg 365,2021-11-13,15:00:00,58,38,20,FMN GV 05 Lier
60,Mechelsesteenweg 365,2021-11-13,16:00:00,26,18,8,FMN GV 05 Lier
60,Mechelsesteenweg 365,2021-11-13,17:00:00,20,10,10,FMN GV 05 Lier
60,Mechelsesteenweg 365,2021-11-13,18:00:00,4,2,2,FMN GV 05 Lier
60,Mechelsesteenweg 365,2021-11-13,19:00:00,4,2,2,FMN GV 05 Lier
60,Mechelsesteenweg 365,2021-11-13,20:00:00,4,2,2,FMN GV 05 Lier
60,Mechelsesteenweg 365,2021-11-13,21:00:00,2,0,2,FMN GV 05 Lier
60,Mechelsesteenweg 365,2021-11-13,22:00:00,12,2,10,FMN GV 05 Lier
60,Mechelsesteenweg 365,2021-11-13,23:00:00,2,0,2,FMN GV 05 Lier
60,Mechelsesteenweg 365,2021-11-14,00:00:00,8,6,2,FMN GV 05 Lier
60,Mechelsesteenweg 365,2021-11-14,01:00:00,0,0,0,FMN GV 05 Lier
60,Mechelsesteenweg 365,2021-11-14,02:00:00,2,0,2,FMN GV 05 Lier
60,Mechelsesteenweg 365,2021-11-14,03:00:00,0,0,0,FMN GV 05 Lier
60,Mechelsesteenweg 365,2021-11-14,04:00:00,2,0,2,FMN GV 05 Lier
60,Mechelsesteenweg 365,2021-11-14,05:00:00,0,0,0,FMN GV 05 Lier
60,Mechelsesteenweg 365,2021-11-14,06:00:00,0,0,0,FMN GV 05 Lier
60,Mechelsesteenweg 365,2021-11-14,07:00:00,6,2,4,FMN GV 05 Lier
60,Mechelsesteenweg 365,2021-11-14,08:00:00,18,12,6,FMN GV 05 Lier
60,Mechelsesteenweg 365,2021-11-14,09:00:00,112,68,44,FMN GV 05 Lier
60,Mechelsesteenweg 365,2021-11-14,10:00:00,254,118,136,FMN GV 05 Lier
60,Mechelsesteenweg 365,2021-11-14,11:00:00,284,104,180,FMN GV 05 Lier
60,Mechelsesteenweg 365,2021-11-14,12:00:00,148,54,94,FMN GV 05 Lier
60,Mechelsesteenweg 365,2021-11-14,13:00:00,76,54,22,FMN GV 05 Lier
60,Mechelsesteenweg 365,2021-11-14,14:00:00,130,66,64,FMN GV 05 Lier
60,Mechelsesteenweg 365,2021-11-14,15:00:00,164,60,104,FMN GV 05 Lier
60,Mechelsesteenweg 365,2021-11-14,16:00:00,88,36,52,FMN GV 05 Lier
60,Mechelsesteenweg 365,2021-11-14,17:00:00,48,16,32,FMN GV 05 Lier
60,Mechelsesteenweg 365,2021-11-14,18:00:00,14,2,12,FMN GV 05 Lier
60,Mechelsesteenweg 365,2021-11-14,19:00:00,0,0,0,FMN GV 05 Lier
60,Mechelsesteenweg 365,2021-11-14,20:00:00,4,2,2,FMN GV 05 Lier
60,Mechelsesteenweg 365,2021-11-14,21:00:00,2,2,0,FMN GV 05 Lier
60,Mechelsesteenweg 365,2021-11-14,22:00:00,4,2,2,FMN GV 05 Lier
60,Mechelsesteenweg 365,2021-11-14,23:00:00,0,0,0,FMN GV 05 Lier
60,Mechelsesteenweg 365,2021-11-15,00:00:00,2,2,0,FMN GV 05 Lier
60,Mechelsesteenweg 365,2021-11-15,01:00:00,2,0,2,FMN GV 05 Lier
60,Mechelsesteenweg 365,2021-11-15,02:00:00,0,0,0,FMN GV 05 Lier
60,Mechelsesteenweg 365,2021-11-15,03:00:00,2,0,2,FMN GV 05 Lier
60,Mechelsesteenweg 365,2021-11-15,04:00:00,2,0,2,FMN GV 05 Lier
60,Mechelsesteenweg 365,2021-11-15,05:00:00,6,2,4,FMN GV 05 Lier
60,Mechelsesteenweg 365,2021-11-15,06:00:00,20,10,10,FMN GV 05 Lier
60,Mechelsesteenweg 365,2021-11-15,07:00:00,194,110,84,FMN GV 05 Lier
60,Mechelsesteenweg 365,2021-11-15,08:00:00,146,86,60,FMN GV 05 Lier
60,Mechelsesteenweg 365,2021-11-15,09:00:00,82,54,28,FMN GV 05 Lier
60,Mechelsesteenweg 365,2021-11-15,10:00:00,68,34,34,FMN GV 05 Lier
60,Mechelsesteenweg 365,2021-11-15,11:00:00,54,14,40,FMN GV 05 Lier
60,Mechelsesteenweg 365,2021-11-15,12:00:00,74,36,38,FMN GV 05 Lier
60,Mechelsesteenweg 365,2021-11-15,13:00:00,72,34,38,FMN GV 05 Lier
60,Mechelsesteenweg 365,2021-11-15,14:00:00,72,40,32,FMN GV 05 Lier
60,Mechelsesteenweg 365,2021-11-15,15:00:00,96,48,48,FMN GV 05 Lier
60,Mechelsesteenweg 365,2021-11-15,16:00:00,242,78,164,FMN GV 05 Lier
60,Mechelsesteenweg 365,2021-11-15,17:00:00,118,70,48,FMN GV 05 Lier
60,Mechelsesteenweg 365,2021-11-15,18:00:00,20,10,10,FMN GV 05 Lier
60,Mechelsesteenweg 365,2021-11-15,19:00:00,8,6,2,FMN GV 05 Lier
60,Mechelsesteenweg 365,2021-11-15,20:00:00,14,10,4,FMN GV 05 Lier
60,Mechelsesteenweg 365,2021-11-15,21:00:00,2,0,2,FMN GV 05 Lier
60,Mechelsesteenweg 365,2021-11-15,22:00:00,0,0,0,FMN GV 05 Lier
60,Mechelsesteenweg 365,2021-11-15,23:00:00,2,2,0,FMN GV 05 Lier
60,Mechelsesteenweg 365,2021-11-16,00:00:00,0,0,0,FMN GV 05 Lier
60,Mechelsesteenweg 365,2021-11-16,01:00:00,0,0,0,FMN GV 05 Lier
60,Mechelsesteenweg 365,2021-11-16,02:00:00,2,0,2,FMN GV 05 Lier
60,Mechelsesteenweg 365,2021-11-16,03:00:00,0,0,0,FMN GV 05 Lier
60,Mechelsesteenweg 365,2021-11-16,04:00:00,2,0,2,FMN GV 05 Lier
60,Mechelsesteenweg 365,2021-11-16,05:00:00,6,0,6,FMN GV 05 Lier
60,Mechelsesteenweg 365,2021-11-16,06:00:00,30,10,20,FMN GV 05 Lier
60,Mechelsesteenweg 365,2021-11-16,07:00:00,160,104,56,FMN GV 05 Lier
60,Mechelsesteenweg 365,2021-11-16,08:00:00,192,130,62,FMN GV 05 Lier
60,Mechelsesteenweg 365,2021-11-16,09:00:00,54,30,24,FMN GV 05 Lier
60,Mechelsesteenweg 365,2021-11-16,10:00:00,64,20,44,FMN GV 05 Lier
60,Mechelsesteenweg 365,2021-11-16,11:00:00,76,52,24,FMN GV 05 Lier
60,Mechelsesteenweg 365,2021-11-16,12:00:00,82,28,54,FMN GV 05 Lier
60,Mechelsesteenweg 365,2021-11-16,13:00:00,64,28,36,FMN GV 05 Lier
60,Mechelsesteenweg 365,2021-11-16,14:00:00,90,44,46,FMN GV 05 Lier
60,Mechelsesteenweg 365,2021-11-16,15:00:00,126,44,82,FMN GV 05 Lier
60,Mechelsesteenweg 365,2021-11-16,16:00:00,264,86,178,FMN GV 05 Lier
60,Mechelsesteenweg 365,2021-11-16,17:00:00,104,58,46,FMN GV 05 Lier
60,Mechelsesteenweg 365,2021-11-16,18:00:00,36,22,14,FMN GV 05 Lier
60,Mechelsesteenweg 365,2021-11-16,19:00:00,14,6,8,FMN GV 05 Lier
60,Mechelsesteenweg 365,2021-11-16,20:00:00,12,6,6,FMN GV 05 Lier
60,Mechelsesteenweg 365,2021-11-16,21:00:00,14,4,10,FMN GV 05 Lier
60,Mechelsesteenweg 365,2021-11-16,22:00:00,10,8,2,FMN GV 05 Lier
60,Mechelsesteenweg 365,2021-11-16,23:00:00,2,0,2,FMN GV 05 Lier
60,Mechelsesteenweg 365,2021-11-17,00:00:00,0,0,0,FMN GV 05 Lier
60,Mechelsesteenweg 365,2021-11-17,01:00:00,2,2,0,FMN GV 05 Lier
60,Mechelsesteenweg 365,2021-11-17,02:00:00,0,0,0,FMN GV 05 Lier
60,Mechelsesteenweg 365,2021-11-17,03:00:00,2,0,2,FMN GV 05 Lier
60,Mechelsesteenweg 365,2021-11-17,04:00:00,2,0,2,FMN GV 05 Lier
60,Mechelsesteenweg 365,2021-11-17,05:00:00,8,0,8,FMN GV 05 Lier
60,Mechelsesteenweg 365,2021-11-17,06:00:00,24,4,20,FMN GV 05 Lier
60,Mechelsesteenweg 365,2021-11-17,07:00:00,154,102,52,FMN GV 05 Lier
60,Mechelsesteenweg 365,2021-11-17,08:00:00,170,132,38,FMN GV 05 Lier
60,Mechelsesteenweg 365,2021-11-17,09:00:00,30,16,14,FMN GV 05 Lier
60,Mechelsesteenweg 365,2021-11-17,10:00:00,50,26,24,FMN GV 05 Lier
60,Mechelsesteenweg 365,2021-11-17,11:00:00,44,8,36,FMN GV 05 Lier
60,Mechelsesteenweg 365,2021-11-17,12:00:00,210,46,164,FMN GV 05 Lier
60,Mechelsesteenweg 365,2021-11-17,13:00:00,118,60,58,FMN GV 05 Lier
60,Mechelsesteenweg 365,2021-11-17,14:00:00,156,84,72,FMN GV 05 Lier
60,Mechelsesteenweg 365,2021-11-17,15:00:00,132,72,60,FMN GV 05 Lier
60,Mechelsesteenweg 365,2021-11-17,16:00:00,96,52,44,FMN GV 05 Lier
60,Mechelsesteenweg 365,2021-11-17,17:00:00,104,68,36,FMN GV 05 Lier
60,Mechelsesteenweg 365,2021-11-17,18:00:00,28,16,12,FMN GV 05 Lier
60,Mechelsesteenweg 365,2021-11-17,19:00:00,20,8,12,FMN GV 05 Lier
60,Mechelsesteenweg 365,2021-11-17,20:00:00,28,16,12,FMN GV 05 Lier
60,Mechelsesteenweg 365,2021-11-17,21:00:00,18,6,12,FMN GV 05 Lier
60,Mechelsesteenweg 365,2021-11-17,22:00:00,0,0,0,FMN GV 05 Lier
60,Mechelsesteenweg 365,2021-11-17,23:00:00,2,2,0,FMN GV 05 Lier
60,Mechelsesteenweg 365,2021-11-18,00:00:00,6,2,4,FMN GV 05 Lier
60,Mechelsesteenweg 365,2021-11-18,01:00:00,0,0,0,FMN GV 05 Lier
60,Mechelsesteenweg 365,2021-11-18,02:00:00,0,0,0,FMN GV 05 Lier
60,Mechelsesteenweg 365,2021-11-18,03:00:00,2,0,2,FMN GV 05 Lier
60,Mechelsesteenweg 365,2021-11-18,04:00:00,2,0,2,FMN GV 05 Lier
60,Mechelsesteenweg 365,2021-11-18,05:00:00,4,0,4,FMN GV 05 Lier
60,Mechelsesteenweg 365,2021-11-18,06:00:00,18,6,12,FMN GV 05 Lier
60,Mechelsesteenweg 365,2021-11-18,07:00:00,142,88,54,FMN GV 05 Lier
60,Mechelsesteenweg 365,2021-11-18,08:00:00,176,126,50,FMN GV 05 Lier
60,Mechelsesteenweg 365,2021-11-18,09:00:00,70,54,16,FMN GV 05 Lier
60,Mechelsesteenweg 365,2021-11-18,10:00:00,52,28,24,FMN GV 05 Lier
60,Mechelsesteenweg 365,2021-11-18,11:00:00,90,30,60,FMN GV 05 Lier
60,Mechelsesteenweg 365,2021-11-18,12:00:00,108,58,50,FMN GV 05 Lier
60,Mechelsesteenweg 365,2021-11-18,13:00:00,118,68,50,FMN GV 05 Lier
60,Mechelsesteenweg 365,2021-11-18,14:00:00,228,124,104,FMN GV 05 Lier
60,Mechelsesteenweg 365,2021-11-18,15:00:00,224,108,116,FMN GV 05 Lier
60,Mechelsesteenweg 365,2021-11-18,16:00:00,268,78,190,FMN GV 05 Lier
60,Mechelsesteenweg 365,2021-11-18,17:00:00,114,64,50,FMN GV 05 Lier
60,Mechelsesteenweg 365,2021-11-18,18:00:00,42,26,16,FMN GV 05 Lier
60,Mechelsesteenweg 365,2021-11-18,19:00:00,24,18,6,FMN GV 05 Lier
60,Mechelsesteenweg 365,2021-11-18,20:00:00,22,10,12,FMN GV 05 Lier
60,Mechelsesteenweg 365,2021-11-18,21:00:00,10,2,8,FMN GV 05 Lier
60,Mechelsesteenweg 365,2021-11-18,22:00:00,2,2,0,FMN GV 05 Lier
60,Mechelsesteenweg 365,2021-11-18,23:00:00,2,2,0,FMN GV 05 Lier
60,Mechelsesteenweg 365,2021-11-19,00:00:00,0,0,0,FMN GV 05 Lier
60,Mechelsesteenweg 365,2021-11-19,01:00:00,0,0,0,FMN GV 05 Lier
60,Mechelsesteenweg 365,2021-11-19,02:00:00,0,0,0,FMN GV 05 Lier
60,Mechelsesteenweg 365,2021-11-19,03:00:00,4,2,2,FMN GV 05 Lier
60,Mechelsesteenweg 365,2021-11-19,04:00:00,2,0,2,FMN GV 05 Lier
60,Mechelsesteenweg 365,2021-11-19,05:00:00,4,0,4,FMN GV 05 Lier
60,Mechelsesteenweg 365,2021-11-19,06:00:00,22,6,16,FMN GV 05 Lier
60,Mechelsesteenweg 365,2021-11-19,07:00:00,158,106,52,FMN GV 05 Lier
60,Mechelsesteenweg 365,2021-11-19,08:00:00,168,128,40,FMN GV 05 Lier
60,Mechelsesteenweg 365,2021-11-19,09:00:00,70,48,22,FMN GV 05 Lier
60,Mechelsesteenweg 365,2021-11-19,10:00:00,58,24,34,FMN GV 05 Lier
60,Mechelsesteenweg 365,2021-11-19,11:00:00,78,46,32,FMN GV 05 Lier
60,Mechelsesteenweg 365,2021-11-19,12:00:00,66,34,32,FMN GV 05 Lier
60,Mechelsesteenweg 365,2021-11-19,13:00:00,102,52,50,FMN GV 05 Lier
60,Mechelsesteenweg 365,2021-11-19,14:00:00,110,62,48,FMN GV 05 Lier
60,Mechelsesteenweg 365,2021-11-19,15:00:00,136,68,68,FMN GV 05 Lier
60,Mechelsesteenweg 365,2021-11-19,16:00:00,230,80,150,FMN GV 05 Lier
60,Mechelsesteenweg 365,2021-11-19,17:00:00,82,38,44,FMN GV 05 Lier
60,Mechelsesteenweg 365,2021-11-19,18:00:00,28,10,18,FMN GV 05 Lier
60,Mechelsesteenweg 365,2021-11-19,19:00:00,34,18,16,FMN GV 05 Lier
60,Mechelsesteenweg 365,2021-11-19,20:00:00,14,6,8,FMN GV 05 Lier
60,Mechelsesteenweg 365,2021-11-19,21:00:00,4,0,4,FMN GV 05 Lier
60,Mechelsesteenweg 365,2021-11-19,22:00:00,4,0,4,FMN GV 05 Lier
60,Mechelsesteenweg 365,2021-11-19,23:00:00,10,0,10,FMN GV 05 Lier
60,Mechelsesteenweg 365,2021-11-20,00:00:00,2,2,0,FMN GV 05 Lier
60,Mechelsesteenweg 365,2021-11-20,01:00:00,0,0,0,FMN GV 05 Lier
60,Mechelsesteenweg 365,2021-11-20,02:00:00,2,0,2,FMN GV 05 Lier
60,Mechelsesteenweg 365,2021-11-20,03:00:00,0,0,0,FMN GV 05 Lier
60,Mechelsesteenweg 365,2021-11-20,04:00:00,2,2,0,FMN GV 05 Lier
60,Mechelsesteenweg 365,2021-11-20,05:00:00,0,0,0,FMN GV 05 Lier
60,Mechelsesteenweg 365,2021-11-20,06:00:00,0,0,0,FMN GV 05 Lier
60,Mechelsesteenweg 365,2021-11-20,07:00:00,8,4,4,FMN GV 05 Lier
60,Mechelsesteenweg 365,2021-11-20,08:00:00,24,2,22,FMN GV 05 Lier
60,Mechelsesteenweg 365,2021-11-20,09:00:00,42,28,14,FMN GV 05 Lier
60,Mechelsesteenweg 365,2021-11-20,10:00:00,144,74,70,FMN GV 05 Lier
60,Mechelsesteenweg 365,2021-11-20,11:00:00,154,74,80,FMN GV 05 Lier
60,Mechelsesteenweg 365,2021-11-20,12:00:00,124,68,56,FMN GV 05 Lier
60,Mechelsesteenweg 365,2021-11-20,13:00:00,120,70,50,FMN GV 05 Lier
60,Mechelsesteenweg 365,2021-11-20,14:00:00,152,90,62,FMN GV 05 Lier
60,Mechelsesteenweg 365,2021-11-20,15:00:00,128,68,60,FMN GV 05 Lier
60,Mechelsesteenweg 365,2021-11-20,16:00:00,60,36,24,FMN GV 05 Lier
60,Mechelsesteenweg 365,2021-11-20,17:00:00,66,30,36,FMN GV 05 Lier
60,Mechelsesteenweg 365,2021-11-20,18:00:00,20,2,18,FMN GV 05 Lier
60,Mechelsesteenweg 365,2021-11-20,19:00:00,6,4,2,FMN GV 05 Lier
60,Mechelsesteenweg 365,2021-11-20,20:00:00,4,2,2,FMN GV 05 Lier
60,Mechelsesteenweg 365,2021-11-20,21:00:00,0,0,0,FMN GV 05 Lier
60,Mechelsesteenweg 365,2021-11-20,22:00:00,2,0,2,FMN GV 05 Lier
60,Mechelsesteenweg 365,2021-11-20,23:00:00,8,4,4,FMN GV 05 Lier
60,Mechelsesteenweg 365,2021-11-21,00:00:00,6,0,6,FMN GV 05 Lier
60,Mechelsesteenweg 365,2021-11-21,01:00:00,6,0,6,FMN GV 05 Lier
60,Mechelsesteenweg 365,2021-11-21,02:00:00,4,0,4,FMN GV 05 Lier
60,Mechelsesteenweg 365,2021-11-21,03:00:00,0,0,0,FMN GV 05 Lier
60,Mechelsesteenweg 365,2021-11-21,04:00:00,0,0,0,FMN GV 05 Lier
60,Mechelsesteenweg 365,2021-11-21,05:00:00,2,0,2,FMN GV 05 Lier
60,Mechelsesteenweg 365,2021-11-21,06:00:00,2,0,2,FMN GV 05 Lier
60,Mechelsesteenweg 365,2021-11-21,07:00:00,2,0,2,FMN GV 05 Lier
60,Mechelsesteenweg 365,2021-11-21,08:00:00,10,0,10,FMN GV 05 Lier
60,Mechelsesteenweg 365,2021-11-21,09:00:00,16,8,8,FMN GV 05 Lier
60,Mechelsesteenweg 365,2021-11-21,10:00:00,32,12,20,FMN GV 05 Lier
60,Mechelsesteenweg 365,2021-11-21,11:00:00,26,18,8,FMN GV 05 Lier
60,Mechelsesteenweg 365,2021-11-21,12:00:00,50,24,26,FMN GV 05 Lier
60,Mechelsesteenweg 365,2021-11-21,13:00:00,40,8,32,FMN GV 05 Lier
60,Mechelsesteenweg 365,2021-11-21,14:00:00,78,42,36,FMN GV 05 Lier
60,Mechelsesteenweg 365,2021-11-21,15:00:00,96,44,52,FMN GV 05 Lier
60,Mechelsesteenweg 365,2021-11-21,16:00:00,44,24,20,FMN GV 05 Lier
60,Mechelsesteenweg 365,2021-11-21,17:00:00,26,10,16,FMN GV 05 Lier
60,Mechelsesteenweg 365,2021-11-21,18:00:00,12,8,4,FMN GV 05 Lier
60,Mechelsesteenweg 365,2021-11-21,19:00:00,0,0,0,FMN GV 05 Lier
60,Mechelsesteenweg 365,2021-11-21,20:00:00,4,4,0,FMN GV 05 Lier
60,Mechelsesteenweg 365,2021-11-21,21:00:00,8,6,2,FMN GV 05 Lier
60,Mechelsesteenweg 365,2021-11-21,22:00:00,0,0,0,FMN GV 05 Lier
60,Mechelsesteenweg 365,2021-11-21,23:00:00,4,2,2,FMN GV 05 Lier
60,Mechelsesteenweg 365,2021-11-22,00:00:00,0,0,0,FMN GV 05 Lier
60,Mechelsesteenweg 365,2021-11-22,01:00:00,0,0,0,FMN GV 05 Lier
60,Mechelsesteenweg 365,2021-11-22,02:00:00,0,0,0,FMN GV 05 Lier
60,Mechelsesteenweg 365,2021-11-22,03:00:00,2,0,2,FMN GV 05 Lier
60,Mechelsesteenweg 365,2021-11-22,04:00:00,2,0,2,FMN GV 05 Lier
60,Mechelsesteenweg 365,2021-11-22,05:00:00,4,0,4,FMN GV 05 Lier
60,Mechelsesteenweg 365,2021-11-22,06:00:00,16,6,10,FMN GV 05 Lier
60,Mechelsesteenweg 365,2021-11-22,07:00:00,204,118,86,FMN GV 05 Lier
60,Mechelsesteenweg 365,2021-11-22,08:00:00,148,110,38,FMN GV 05 Lier
60,Mechelsesteenweg 365,2021-11-22,09:00:00,58,46,12,FMN GV 05 Lier
60,Mechelsesteenweg 365,2021-11-22,10:00:00,78,30,48,FMN GV 05 Lier
60,Mechelsesteenweg 365,2021-11-22,11:00:00,82,48,34,FMN GV 05 Lier
60,Mechelsesteenweg 365,2021-11-22,12:00:00,90,48,42,FMN GV 05 Lier
60,Mechelsesteenweg 365,2021-11-22,13:00:00,120,78,42,FMN GV 05 Lier
60,Mechelsesteenweg 365,2021-11-22,14:00:00,188,74,114,FMN GV 05 Lier
60,Mechelsesteenweg 365,2021-11-22,15:00:00,168,70,98,FMN GV 05 Lier
60,Mechelsesteenweg 365,2021-11-22,16:00:00,312,96,216,FMN GV 05 Lier
60,Mechelsesteenweg 365,2021-11-22,17:00:00,110,74,36,FMN GV 05 Lier
60,Mechelsesteenweg 365,2021-11-22,18:00:00,32,14,18,FMN GV 05 Lier
60,Mechelsesteenweg 365,2021-11-22,19:00:00,8,4,4,FMN GV 05 Lier
60,Mechelsesteenweg 365,2021-11-22,20:00:00,4,0,4,FMN GV 05 Lier
60,Mechelsesteenweg 365,2021-11-22,21:00:00,4,2,2,FMN GV 05 Lier
60,Mechelsesteenweg 365,2021-11-22,22:00:00,6,4,2,FMN GV 05 Lier
60,Mechelsesteenweg 365,2021-11-22,23:00:00,0,0,0,FMN GV 05 Lier
60,Mechelsesteenweg 365,2021-11-23,00:00:00,2,2,0,FMN GV 05 Lier
60,Mechelsesteenweg 365,2021-11-23,01:00:00,0,0,0,FMN GV 05 Lier
60,Mechelsesteenweg 365,2021-11-23,02:00:00,0,0,0,FMN GV 05 Lier
60,Mechelsesteenweg 365,2021-11-23,03:00:00,2,0,2,FMN GV 05 Lier
60,Mechelsesteenweg 365,2021-11-23,04:00:00,4,0,4,FMN GV 05 Lier
60,Mechelsesteenweg 365,2021-11-23,05:00:00,0,0,0,FMN GV 05 Lier
60,Mechelsesteenweg 365,2021-11-23,06:00:00,20,6,14,FMN GV 05 Lier
60,Mechelsesteenweg 365,2021-11-23,07:00:00,152,88,64,FMN GV 05 Lier
60,Mechelsesteenweg 365,2021-11-23,08:00:00,176,132,44,FMN GV 05 Lier
60,Mechelsesteenweg 365,2021-11-23,09:00:00,34,14,20,FMN GV 05 Lier
60,Mechelsesteenweg 365,2021-11-23,10:00:00,62,18,44,FMN GV 05 Lier
60,Mechelsesteenweg 365,2021-11-23,11:00:00,36,20,16,FMN GV 05 Lier
60,Mechelsesteenweg 365,2021-11-23,12:00:00,58,38,20,FMN GV 05 Lier
60,Mechelsesteenweg 365,2021-11-23,13:00:00,92,42,50,FMN GV 05 Lier
60,Mechelsesteenweg 365,2021-11-23,14:00:00,86,42,44,FMN GV 05 Lier
60,Mechelsesteenweg 365,2021-11-23,15:00:00,92,38,54,FMN GV 05 Lier
60,Mechelsesteenweg 365,2021-11-23,16:00:00,252,56,196,FMN GV 05 Lier
60,Mechelsesteenweg 365,2021-11-23,17:00:00,98,66,32,FMN GV 05 Lier
60,Mechelsesteenweg 365,2021-11-23,18:00:00,22,10,12,FMN GV 05 Lier
60,Mechelsesteenweg 365,2021-11-23,19:00:00,8,6,2,FMN GV 05 Lier
60,Mechelsesteenweg 365,2021-11-23,20:00:00,4,2,2,FMN GV 05 Lier
60,Mechelsesteenweg 365,2021-11-23,21:00:00,12,6,6,FMN GV 05 Lier
60,Mechelsesteenweg 365,2021-11-23,22:00:00,4,2,2,FMN GV 05 Lier
60,Mechelsesteenweg 365,2021-11-23,23:00:00,0,0,0,FMN GV 05 Lier
60,Mechelsesteenweg 365,2021-11-24,00:00:00,0,0,0,FMN GV 05 Lier
60,Mechelsesteenweg 365,2021-11-24,01:00:00,2,2,0,FMN GV 05 Lier
60,Mechelsesteenweg 365,2021-11-24,02:00:00,0,0,0,FMN GV 05 Lier
60,Mechelsesteenweg 365,2021-11-24,03:00:00,2,0,2,FMN GV 05 Lier
60,Mechelsesteenweg 365,2021-11-24,04:00:00,2,0,2,FMN GV 05 Lier
60,Mechelsesteenweg 365,2021-11-24,05:00:00,2,0,2,FMN GV 05 Lier
60,Mechelsesteenweg 365,2021-11-24,06:00:00,26,6,20,FMN GV 05 Lier
60,Mechelsesteenweg 365,2021-11-24,07:00:00,170,102,68,FMN GV 05 Lier
60,Mechelsesteenweg 365,2021-11-24,08:00:00,156,126,30,FMN GV 05 Lier
60,Mechelsesteenweg 365,2021-11-24,09:00:00,30,24,6,FMN GV 05 Lier
60,Mechelsesteenweg 365,2021-11-24,10:00:00,40,12,28,FMN GV 05 Lier
60,Mechelsesteenweg 365,2021-11-24,11:00:00,52,14,38,FMN GV 05 Lier
60,Mechelsesteenweg 365,2021-11-24,12:00:00,212,42,170,FMN GV 05 Lier
60,Mechelsesteenweg 365,2021-11-24,13:00:00,98,50,48,FMN GV 05 Lier
60,Mechelsesteenweg 365,2021-11-24,14:00:00,138,58,80,FMN GV 05 Lier
60,Mechelsesteenweg 365,2021-11-24,15:00:00,88,40,48,FMN GV 05 Lier
60,Mechelsesteenweg 365,2021-11-24,16:00:00,94,58,36,FMN GV 05 Lier
60,Mechelsesteenweg 365,2021-11-24,17:00:00,54,38,16,FMN GV 05 Lier
60,Mechelsesteenweg 365,2021-11-24,18:00:00,24,20,4,FMN GV 05 Lier
60,Mechelsesteenweg 365,2021-11-24,19:00:00,18,10,8,FMN GV 05 Lier
60,Mechelsesteenweg 365,2021-11-24,20:00:00,20,8,12,FMN GV 05 Lier
60,Mechelsesteenweg 365,2021-11-24,21:00:00,6,2,4,FMN GV 05 Lier
60,Mechelsesteenweg 365,2021-11-24,22:00:00,2,2,0,FMN GV 05 Lier
60,Mechelsesteenweg 365,2021-11-24,23:00:00,0,0,0,FMN GV 05 Lier
60,Mechelsesteenweg 365,2021-11-25,00:00:00,0,0,0,FMN GV 05 Lier
60,Mechelsesteenweg 365,2021-11-25,01:00:00,0,0,0,FMN GV 05 Lier
60,Mechelsesteenweg 365,2021-11-25,02:00:00,4,4,0,FMN GV 05 Lier
60,Mechelsesteenweg 365,2021-11-25,03:00:00,2,0,2,FMN GV 05 Lier
60,Mechelsesteenweg 365,2021-11-25,04:00:00,4,0,4,FMN GV 05 Lier
60,Mechelsesteenweg 365,2021-11-25,05:00:00,4,0,4,FMN GV 05 Lier
60,Mechelsesteenweg 365,2021-11-25,06:00:00,24,12,12,FMN GV 05 Lier
60,Mechelsesteenweg 365,2021-11-25,07:00:00,138,92,46,FMN GV 05 Lier
60,Mechelsesteenweg 365,2021-11-25,08:00:00,160,126,34,FMN GV 05 Lier
60,Mechelsesteenweg 365,2021-11-25,09:00:00,42,20,22,FMN GV 05 Lier
60,Mechelsesteenweg 365,2021-11-25,10:00:00,38,14,24,FMN GV 05 Lier
60,Mechelsesteenweg 365,2021-11-25,11:00:00,20,14,6,FMN GV 05 Lier
60,Mechelsesteenweg 365,2021-11-25,12:00:00,12,8,4,FMN GV 05 Lier
60,Mechelsesteenweg 365,2021-11-25,13:00:00,26,20,6,FMN GV 05 Lier
60,Mechelsesteenweg 365,2021-11-25,14:00:00,64,36,28,FMN GV 05 Lier
60,Mechelsesteenweg 365,2021-11-25,15:00:00,68,36,32,FMN GV 05 Lier
60,Mechelsesteenweg 365,2021-11-25,16:00:00,244,46,198,FMN GV 05 Lier
60,Mechelsesteenweg 365,2021-11-25,17:00:00,60,36,24,FMN GV 05 Lier
60,Mechelsesteenweg 365,2021-11-25,18:00:00,26,16,10,FMN GV 05 Lier
60,Mechelsesteenweg 365,2021-11-25,19:00:00,22,4,18,FMN GV 05 Lier
60,Mechelsesteenweg 365,2021-11-25,20:00:00,8,2,6,FMN GV 05 Lier
60,Mechelsesteenweg 365,2021-11-25,21:00:00,4,2,2,FMN GV 05 Lier
60,Mechelsesteenweg 365,2021-11-25,22:00:00,2,2,0,FMN GV 05 Lier
60,Mechelsesteenweg 365,2021-11-25,23:00:00,0,0,0,FMN GV 05 Lier
60,Mechelsesteenweg 365,2021-11-26,00:00:00,0,0,0,FMN GV 05 Lier
60,Mechelsesteenweg 365,2021-11-26,01:00:00,0,0,0,FMN GV 05 Lier
60,Mechelsesteenweg 365,2021-11-26,02:00:00,0,0,0,FMN GV 05 Lier
60,Mechelsesteenweg 365,2021-11-26,03:00:00,2,0,2,FMN GV 05 Lier
60,Mechelsesteenweg 365,2021-11-26,04:00:00,0,0,0,FMN GV 05 Lier
60,Mechelsesteenweg 365,2021-11-26,05:00:00,0,0,0,FMN GV 05 Lier
60,Mechelsesteenweg 365,2021-11-26,06:00:00,16,6,10,FMN GV 05 Lier
60,Mechelsesteenweg 365,2021-11-26,07:00:00,126,88,38,FMN GV 05 Lier
60,Mechelsesteenweg 365,2021-11-26,08:00:00,136,104,32,FMN GV 05 Lier
60,Mechelsesteenweg 365,2021-11-26,09:00:00,48,22,26,FMN GV 05 Lier
60,Mechelsesteenweg 365,2021-11-26,10:00:00,60,26,34,FMN GV 05 Lier
60,Mechelsesteenweg 365,2021-11-26,11:00:00,42,28,14,FMN GV 05 Lier
60,Mechelsesteenweg 365,2021-11-26,12:00:00,30,12,18,FMN GV 05 Lier
60,Mechelsesteenweg 365,2021-11-26,13:00:00,60,54,6,FMN GV 05 Lier
60,Mechelsesteenweg 365,2021-11-26,14:00:00,16,10,6,FMN GV 05 Lier
60,Mechelsesteenweg 365,2021-11-26,15:00:00,98,18,80,FMN GV 05 Lier
60,Mechelsesteenweg 365,2021-11-26,16:00:00,158,36,122,FMN GV 05 Lier
60,Mechelsesteenweg 365,2021-11-26,17:00:00,36,16,20,FMN GV 05 Lier
60,Mechelsesteenweg 365,2021-11-26,18:00:00,10,6,4,FMN GV 05 Lier
60,Mechelsesteenweg 365,2021-11-26,19:00:00,6,0,6,FMN GV 05 Lier
60,Mechelsesteenweg 365,2021-11-26,20:00:00,4,4,0,FMN GV 05 Lier
60,Mechelsesteenweg 365,2021-11-26,21:00:00,4,2,2,FMN GV 05 Lier
60,Mechelsesteenweg 365,2021-11-26,22:00:00,0,0,0,FMN GV 05 Lier
60,Mechelsesteenweg 365,2021-11-26,23:00:00,2,2,0,FMN GV 05 Lier
60,Mechelsesteenweg 365,2021-11-27,00:00:00,4,2,2,FMN GV 05 Lier
60,Mechelsesteenweg 365,2021-11-27,01:00:00,0,0,0,FMN GV 05 Lier
60,Mechelsesteenweg 365,2021-11-27,02:00:00,0,0,0,FMN GV 05 Lier
60,Mechelsesteenweg 365,2021-11-27,03:00:00,0,0,0,FMN GV 05 Lier
60,Mechelsesteenweg 365,2021-11-27,04:00:00,0,0,0,FMN GV 05 Lier
60,Mechelsesteenweg 365,2021-11-27,05:00:00,0,0,0,FMN GV 05 Lier
60,Mechelsesteenweg 365,2021-11-27,06:00:00,0,0,0,FMN GV 05 Lier
60,Mechelsesteenweg 365,2021-11-27,07:00:00,8,4,4,FMN GV 05 Lier
60,Mechelsesteenweg 365,2021-11-27,08:00:00,6,4,2,FMN GV 05 Lier
60,Mechelsesteenweg 365,2021-11-27,09:00:00,20,16,4,FMN GV 05 Lier
60,Mechelsesteenweg 365,2021-11-27,10:00:00,60,44,16,FMN GV 05 Lier
60,Mechelsesteenweg 365,2021-11-27,11:00:00,74,46,28,FMN GV 05 Lier
60,Mechelsesteenweg 365,2021-11-27,12:00:00,94,58,36,FMN GV 05 Lier
60,Mechelsesteenweg 365,2021-11-27,13:00:00,90,42,48,FMN GV 05 Lier
60,Mechelsesteenweg 365,2021-11-27,14:00:00,146,64,82,FMN GV 05 Lier
60,Mechelsesteenweg 365,2021-11-27,15:00:00,74,18,56,FMN GV 05 Lier
60,Mechelsesteenweg 365,2021-11-27,16:00:00,32,14,18,FMN GV 05 Lier
60,Mechelsesteenweg 365,2021-11-27,17:00:00,4,2,2,FMN GV 05 Lier
60,Mechelsesteenweg 365,2021-11-27,18:00:00,14,8,6,FMN GV 05 Lier
60,Mechelsesteenweg 365,2021-11-27,19:00:00,0,0,0,FMN GV 05 Lier
60,Mechelsesteenweg 365,2021-11-27,20:00:00,4,2,2,FMN GV 05 Lier
60,Mechelsesteenweg 365,2021-11-27,21:00:00,2,0,2,FMN GV 05 Lier
60,Mechelsesteenweg 365,2021-11-27,22:00:00,6,0,6,FMN GV 05 Lier
60,Mechelsesteenweg 365,2021-11-27,23:00:00,4,4,0,FMN GV 05 Lier
60,Mechelsesteenweg 365,2021-11-28,00:00:00,0,0,0,FMN GV 05 Lier
60,Mechelsesteenweg 365,2021-11-28,01:00:00,0,0,0,FMN GV 05 Lier
60,Mechelsesteenweg 365,2021-11-28,02:00:00,0,0,0,FMN GV 05 Lier
60,Mechelsesteenweg 365,2021-11-28,03:00:00,0,0,0,FMN GV 05 Lier
60,Mechelsesteenweg 365,2021-11-28,04:00:00,0,0,0,FMN GV 05 Lier
60,Mechelsesteenweg 365,2021-11-28,05:00:00,0,0,0,FMN GV 05 Lier
60,Mechelsesteenweg 365,2021-11-28,06:00:00,0,0,0,FMN GV 05 Lier
60,Mechelsesteenweg 365,2021-11-28,07:00:00,4,0,4,FMN GV 05 Lier
60,Mechelsesteenweg 365,2021-11-28,08:00:00,6,6,0,FMN GV 05 Lier
60,Mechelsesteenweg 365,2021-11-28,09:00:00,40,22,18,FMN GV 05 Lier
60,Mechelsesteenweg 365,2021-11-28,10:00:00,130,48,82,FMN GV 05 Lier
60,Mechelsesteenweg 365,2021-11-28,11:00:00,118,62,56,FMN GV 05 Lier
60,Mechelsesteenweg 365,2021-11-28,12:00:00,58,32,26,FMN GV 05 Lier
60,Mechelsesteenweg 365,2021-11-28,13:00:00,16,6,10,FMN GV 05 Lier
60,Mechelsesteenweg 365,2021-11-28,14:00:00,16,8,8,FMN GV 05 Lier
60,Mechelsesteenweg 365,2021-11-28,15:00:00,8,8,0,FMN GV 05 Lier
60,Mechelsesteenweg 365,2021-11-28,16:00:00,22,14,8,FMN GV 05 Lier
60,Mechelsesteenweg 365,2021-11-28,17:00:00,14,10,4,FMN GV 05 Lier
60,Mechelsesteenweg 365,2021-11-28,18:00:00,4,0,4,FMN GV 05 Lier
60,Mechelsesteenweg 365,2021-11-28,19:00:00,0,0,0,FMN GV 05 Lier
60,Mechelsesteenweg 365,2021-11-28,20:00:00,0,0,0,FMN GV 05 Lier
60,Mechelsesteenweg 365,2021-11-28,21:00:00,4,0,4,FMN GV 05 Lier
60,Mechelsesteenweg 365,2021-11-28,22:00:00,0,0,0,FMN GV 05 Lier
60,Mechelsesteenweg 365,2021-11-28,23:00:00,0,0,0,FMN GV 05 Lier
60,Mechelsesteenweg 365,2021-11-29,00:00:00,0,0,0,FMN GV 05 Lier
60,Mechelsesteenweg 365,2021-11-29,01:00:00,0,0,0,FMN GV 05 Lier
60,Mechelsesteenweg 365,2021-11-29,02:00:00,0,0,0,FMN GV 05 Lier
60,Mechelsesteenweg 365,2021-11-29,03:00:00,0,0,0,FMN GV 05 Lier
60,Mechelsesteenweg 365,2021-11-29,04:00:00,0,0,0,FMN GV 05 Lier
60,Mechelsesteenweg 365,2021-11-29,05:00:00,0,0,0,FMN GV 05 Lier
60,Mechelsesteenweg 365,2021-11-29,06:00:00,4,2,2,FMN GV 05 Lier
60,Mechelsesteenweg 365,2021-11-29,07:00:00,62,34,28,FMN GV 05 Lier
60,Mechelsesteenweg 365,2021-11-29,08:00:00,56,44,12,FMN GV 05 Lier
60,Mechelsesteenweg 365,2021-11-29,09:00:00,24,14,10,FMN GV 05 Lier
60,Mechelsesteenweg 365,2021-11-29,10:00:00,24,8,16,FMN GV 05 Lier
60,Mechelsesteenweg 365,2021-11-29,11:00:00,28,14,14,FMN GV 05 Lier
60,Mechelsesteenweg 365,2021-11-29,12:00:00,50,18,32,FMN GV 05 Lier
60,Mechelsesteenweg 365,2021-11-29,13:00:00,80,50,30,FMN GV 05 Lier
60,Mechelsesteenweg 365,2021-11-29,14:00:00,74,46,28,FMN GV 05 Lier
60,Mechelsesteenweg 365,2021-11-29,15:00:00,70,30,40,FMN GV 05 Lier
60,Mechelsesteenweg 365,2021-11-29,16:00:00,262,52,210,FMN GV 05 Lier
60,Mechelsesteenweg 365,2021-11-29,17:00:00,86,56,30,FMN GV 05 Lier
60,Mechelsesteenweg 365,2021-11-29,18:00:00,20,10,10,FMN GV 05 Lier
60,Mechelsesteenweg 365,2021-11-29,19:00:00,10,6,4,FMN GV 05 Lier
60,Mechelsesteenweg 365,2021-11-29,20:00:00,2,2,0,FMN GV 05 Lier
60,Mechelsesteenweg 365,2021-11-29,21:00:00,4,0,4,FMN GV 05 Lier
60,Mechelsesteenweg 365,2021-11-29,22:00:00,6,6,0,FMN GV 05 Lier
60,Mechelsesteenweg 365,2021-11-29,23:00:00,0,0,0,FMN GV 05 Lier
60,Mechelsesteenweg 365,2021-11-30,00:00:00,2,2,0,FMN GV 05 Lier
60,Mechelsesteenweg 365,2021-11-30,01:00:00,0,0,0,FMN GV 05 Lier
60,Mechelsesteenweg 365,2021-11-30,02:00:00,0,0,0,FMN GV 05 Lier
60,Mechelsesteenweg 365,2021-11-30,03:00:00,0,0,0,FMN GV 05 Lier
60,Mechelsesteenweg 365,2021-11-30,04:00:00,0,0,0,FMN GV 05 Lier
60,Mechelsesteenweg 365,2021-11-30,05:00:00,0,0,0,FMN GV 05 Lier
60,Mechelsesteenweg 365,2021-11-30,06:00:00,12,2,10,FMN GV 05 Lier
60,Mechelsesteenweg 365,2021-11-30,07:00:00,88,58,30,FMN GV 05 Lier
60,Mechelsesteenweg 365,2021-11-30,08:00:00,124,96,28,FMN GV 05 Lier
60,Mechelsesteenweg 365,2021-11-30,09:00:00,24,16,8,FMN GV 05 Lier
60,Mechelsesteenweg 365,2021-11-30,10:00:00,10,4,6,FMN GV 05 Lier
60,Mechelsesteenweg 365,2021-11-30,11:00:00,12,4,8,FMN GV 05 Lier
60,Mechelsesteenweg 365,2021-11-30,12:00:00,24,14,10,FMN GV 05 Lier
60,Mechelsesteenweg 365,2021-11-30,13:00:00,24,6,18,FMN GV 05 Lier
60,Mechelsesteenweg 365,2021-11-30,14:00:00,20,6,14,FMN GV 05 Lier
60,Mechelsesteenweg 365,2021-11-30,15:00:00,30,16,14,FMN GV 05 Lier
60,Mechelsesteenweg 365,2021-11-30,16:00:00,140,28,112,FMN GV 05 Lier
60,Mechelsesteenweg 365,2021-11-30,17:00:00,36,20,16,FMN GV 05 Lier
60,Mechelsesteenweg 365,2021-11-30,18:00:00,22,14,8,FMN GV 05 Lier
60,Mechelsesteenweg 365,2021-11-30,19:00:00,8,4,4,FMN GV 05 Lier
60,Mechelsesteenweg 365,2021-11-30,20:00:00,10,0,10,FMN GV 05 Lier
60,Mechelsesteenweg 365,2021-11-30,21:00:00,2,0,2,FMN GV 05 Lier
60,Mechelsesteenweg 365,2021-11-30,22:00:00,0,0,0,FMN GV 05 Lier
60,Mechelsesteenweg 365,2021-11-30,23:00:00,0,0,0,FMN GV 05 Lier
60,Mechelsesteenweg 365,2021-12-01,00:00:00,0,0,0,FMN GV 05 Lier
60,Mechelsesteenweg 365,2021-12-01,01:00:00,2,0,2,FMN GV 05 Lier
60,Mechelsesteenweg 365,2021-12-01,02:00:00,0,0,0,FMN GV 05 Lier
60,Mechelsesteenweg 365,2021-12-01,03:00:00,0,0,0,FMN GV 05 Lier
60,Mechelsesteenweg 365,2021-12-01,04:00:00,0,0,0,FMN GV 05 Lier
60,Mechelsesteenweg 365,2021-12-01,05:00:00,0,0,0,FMN GV 05 Lier
60,Mechelsesteenweg 365,2021-12-01,06:00:00,8,0,8,FMN GV 05 Lier
60,Mechelsesteenweg 365,2021-12-01,07:00:00,94,68,26,FMN GV 05 Lier
60,Mechelsesteenweg 365,2021-12-01,08:00:00,98,86,12,FMN GV 05 Lier
60,Mechelsesteenweg 365,2021-12-01,09:00:00,16,6,10,FMN GV 05 Lier
60,Mechelsesteenweg 365,2021-12-01,10:00:00,20,10,10,FMN GV 05 Lier
60,Mechelsesteenweg 365,2021-12-01,11:00:00,24,10,14,FMN GV 05 Lier
60,Mechelsesteenweg 365,2021-12-01,12:00:00,130,26,104,FMN GV 05 Lier
60,Mechelsesteenweg 365,2021-12-01,13:00:00,74,26,48,FMN GV 05 Lier
60,Mechelsesteenweg 365,2021-12-01,14:00:00,54,36,18,FMN GV 05 Lier
60,Mechelsesteenweg 365,2021-12-01,15:00:00,24,14,10,FMN GV 05 Lier
60,Mechelsesteenweg 365,2021-12-01,16:00:00,30,18,12,FMN GV 05 Lier
60,Mechelsesteenweg 365,2021-12-01,17:00:00,26,22,4,FMN GV 05 Lier
60,Mechelsesteenweg 365,2021-12-01,18:00:00,16,4,12,FMN GV 05 Lier
60,Mechelsesteenweg 365,2021-12-01,19:00:00,6,4,2,FMN GV 05 Lier
60,Mechelsesteenweg 365,2021-12-01,20:00:00,10,2,8,FMN GV 05 Lier
60,Mechelsesteenweg 365,2021-12-01,21:00:00,4,0,4,FMN GV 05 Lier
60,Mechelsesteenweg 365,2021-12-01,22:00:00,0,0,0,FMN GV 05 Lier
60,Mechelsesteenweg 365,2021-12-01,23:00:00,0,0,0,FMN GV 05 Lier
60,Mechelsesteenweg 365,2021-12-02,00:00:00,2,2,0,FMN GV 05 Lier
60,Mechelsesteenweg 365,2021-12-02,01:00:00,0,0,0,FMN GV 05 Lier
60,Mechelsesteenweg 365,2021-12-02,02:00:00,0,0,0,FMN GV 05 Lier
60,Mechelsesteenweg 365,2021-12-02,03:00:00,0,0,0,FMN GV 05 Lier
60,Mechelsesteenweg 365,2021-12-02,04:00:00,0,0,0,FMN GV 05 Lier
60,Mechelsesteenweg 365,2021-12-02,05:00:00,0,0,0,FMN GV 05 Lier
60,Mechelsesteenweg 365,2021-12-02,06:00:00,12,4,8,FMN GV 05 Lier
60,Mechelsesteenweg 365,2021-12-02,07:00:00,64,40,24,FMN GV 05 Lier
60,Mechelsesteenweg 365,2021-12-02,08:00:00,96,70,26,FMN GV 05 Lier
60,Mechelsesteenweg 365,2021-12-02,09:00:00,22,12,10,FMN GV 05 Lier
60,Mechelsesteenweg 365,2021-12-02,10:00:00,10,4,6,FMN GV 05 Lier
60,Mechelsesteenweg 365,2021-12-02,11:00:00,14,6,8,FMN GV 05 Lier
60,Mechelsesteenweg 365,2021-12-02,12:00:00,16,4,12,FMN GV 05 Lier
60,Mechelsesteenweg 365,2021-12-02,13:00:00,12,4,8,FMN GV 05 Lier
60,Mechelsesteenweg 365,2021-12-02,14:00:00,24,14,10,FMN GV 05 Lier
60,Mechelsesteenweg 365,2021-12-02,15:00:00,42,20,22,FMN GV 05 Lier
60,Mechelsesteenweg 365,2021-12-02,16:00:00,138,36,102,FMN GV 05 Lier
60,Mechelsesteenweg 365,2021-12-02,17:00:00,36,18,18,FMN GV 05 Lier
60,Mechelsesteenweg 365,2021-12-02,18:00:00,16,8,8,FMN GV 05 Lier
60,Mechelsesteenweg 365,2021-12-02,19:00:00,4,2,2,FMN GV 05 Lier
60,Mechelsesteenweg 365,2021-12-02,20:00:00,6,2,4,FMN GV 05 Lier
60,Mechelsesteenweg 365,2021-12-02,21:00:00,4,2,2,FMN GV 05 Lier
60,Mechelsesteenweg 365,2021-12-02,22:00:00,0,0,0,FMN GV 05 Lier
60,Mechelsesteenweg 365,2021-12-02,23:00:00,2,2,0,FMN GV 05 Lier
60,Mechelsesteenweg 365,2021-12-03,00:00:00,0,0,0,FMN GV 05 Lier
60,Mechelsesteenweg 365,2021-12-03,01:00:00,0,0,0,FMN GV 05 Lier
60,Mechelsesteenweg 365,2021-12-03,02:00:00,0,0,0,FMN GV 05 Lier
60,Mechelsesteenweg 365,2021-12-03,03:00:00,0,0,0,FMN GV 05 Lier
60,Mechelsesteenweg 365,2021-12-03,04:00:00,0,0,0,FMN GV 05 Lier
60,Mechelsesteenweg 365,2021-12-03,05:00:00,0,0,0,FMN GV 05 Lier
60,Mechelsesteenweg 365,2021-12-03,06:00:00,10,4,6,FMN GV 05 Lier
60,Mechelsesteenweg 365,2021-12-03,07:00:00,66,42,24,FMN GV 05 Lier
60,Mechelsesteenweg 365,2021-12-03,08:00:00,96,68,28,FMN GV 05 Lier
60,Mechelsesteenweg 365,2021-12-03,09:00:00,38,28,10,FMN GV 05 Lier
60,Mechelsesteenweg 365,2021-12-03,10:00:00,28,20,8,FMN GV 05 Lier
60,Mechelsesteenweg 365,2021-12-03,11:00:00,22,6,16,FMN GV 05 Lier
60,Mechelsesteenweg 365,2021-12-03,12:00:00,20,6,14,FMN GV 05 Lier
60,Mechelsesteenweg 365,2021-12-03,13:00:00,22,16,6,FMN GV 05 Lier
60,Mechelsesteenweg 365,2021-12-03,14:00:00,44,26,18,FMN GV 05 Lier
60,Mechelsesteenweg 365,2021-12-03,15:00:00,56,28,28,FMN GV 05 Lier
60,Mechelsesteenweg 365,2021-12-03,16:00:00,132,42,90,FMN GV 05 Lier
60,Mechelsesteenweg 365,2021-12-03,17:00:00,20,12,8,FMN GV 05 Lier
60,Mechelsesteenweg 365,2021-12-03,18:00:00,22,10,12,FMN GV 05 Lier
60,Mechelsesteenweg 365,2021-12-03,19:00:00,6,0,6,FMN GV 05 Lier
60,Mechelsesteenweg 365,2021-12-03,20:00:00,8,4,4,FMN GV 05 Lier
60,Mechelsesteenweg 365,2021-12-03,21:00:00,30,0,30,FMN GV 05 Lier
60,Mechelsesteenweg 365,2021-12-03,22:00:00,4,2,2,FMN GV 05 Lier
60,Mechelsesteenweg 365,2021-12-03,23:00:00,0,0,0,FMN GV 05 Lier
60,Mechelsesteenweg 365,2021-12-04,00:00:00,0,0,0,FMN GV 05 Lier
60,Mechelsesteenweg 365,2021-12-04,01:00:00,0,0,0,FMN GV 05 Lier
60,Mechelsesteenweg 365,2021-12-04,02:00:00,0,0,0,FMN GV 05 Lier
60,Mechelsesteenweg 365,2021-12-04,03:00:00,2,0,2,FMN GV 05 Lier
60,Mechelsesteenweg 365,2021-12-04,04:00:00,0,0,0,FMN GV 05 Lier
60,Mechelsesteenweg 365,2021-12-04,05:00:00,0,0,0,FMN GV 05 Lier
60,Mechelsesteenweg 365,2021-12-04,06:00:00,4,2,2,FMN GV 05 Lier
60,Mechelsesteenweg 365,2021-12-04,07:00:00,10,4,6,FMN GV 05 Lier
60,Mechelsesteenweg 365,2021-12-04,08:00:00,4,4,0,FMN GV 05 Lier
60,Mechelsesteenweg 365,2021-12-04,09:00:00,50,32,18,FMN GV 05 Lier
60,Mechelsesteenweg 365,2021-12-04,10:00:00,112,72,40,FMN GV 05 Lier
60,Mechelsesteenweg 365,2021-12-04,11:00:00,100,38,62,FMN GV 05 Lier
60,Mechelsesteenweg 365,2021-12-04,12:00:00,18,12,6,FMN GV 05 Lier
60,Mechelsesteenweg 365,2021-12-04,13:00:00,18,6,12,FMN GV 05 Lier
60,Mechelsesteenweg 365,2021-12-04,14:00:00,10,6,4,FMN GV 05 Lier
60,Mechelsesteenweg 365,2021-12-04,15:00:00,12,6,6,FMN GV 05 Lier
60,Mechelsesteenweg 365,2021-12-04,16:00:00,20,10,10,FMN GV 05 Lier
60,Mechelsesteenweg 365,2021-12-04,17:00:00,20,10,10,FMN GV 05 Lier
60,Mechelsesteenweg 365,2021-12-04,18:00:00,6,2,4,FMN GV 05 Lier
60,Mechelsesteenweg 365,2021-12-04,19:00:00,0,0,0,FMN GV 05 Lier
60,Mechelsesteenweg 365,2021-12-04,20:00:00,2,0,2,FMN GV 05 Lier
60,Mechelsesteenweg 365,2021-12-04,21:00:00,4,0,4,FMN GV 05 Lier
60,Mechelsesteenweg 365,2021-12-04,22:00:00,4,2,2,FMN GV 05 Lier
60,Mechelsesteenweg 365,2021-12-04,23:00:00,2,0,2,FMN GV 05 Lier
60,Mechelsesteenweg 365,2021-12-05,00:00:00,0,0,0,FMN GV 05 Lier
60,Mechelsesteenweg 365,2021-12-05,01:00:00,0,0,0,FMN GV 05 Lier
60,Mechelsesteenweg 365,2021-12-05,02:00:00,0,0,0,FMN GV 05 Lier
60,Mechelsesteenweg 365,2021-12-05,03:00:00,0,0,0,FMN GV 05 Lier
60,Mechelsesteenweg 365,2021-12-05,04:00:00,0,0,0,FMN GV 05 Lier
60,Mechelsesteenweg 365,2021-12-05,05:00:00,0,0,0,FMN GV 05 Lier
60,Mechelsesteenweg 365,2021-12-05,06:00:00,4,2,2,FMN GV 05 Lier
60,Mechelsesteenweg 365,2021-12-05,07:00:00,2,0,2,FMN GV 05 Lier
60,Mechelsesteenweg 365,2021-12-05,08:00:00,2,0,2,FMN GV 05 Lier
60,Mechelsesteenweg 365,2021-12-05,09:00:00,20,16,4,FMN GV 05 Lier
60,Mechelsesteenweg 365,2021-12-05,10:00:00,76,48,28,FMN GV 05 Lier
60,Mechelsesteenweg 365,2021-12-05,11:00:00,72,50,22,FMN GV 05 Lier
60,Mechelsesteenweg 365,2021-12-05,12:00:00,72,38,34,FMN GV 05 Lier
60,Mechelsesteenweg 365,2021-12-05,13:00:00,42,24,18,FMN GV 05 Lier
60,Mechelsesteenweg 365,2021-12-05,14:00:00,96,52,44,FMN GV 05 Lier
60,Mechelsesteenweg 365,2021-12-05,15:00:00,90,44,46,FMN GV 05 Lier
60,Mechelsesteenweg 365,2021-12-05,16:00:00,56,22,34,FMN GV 05 Lier
60,Mechelsesteenweg 365,2021-12-05,17:00:00,14,4,10,FMN GV 05 Lier
60,Mechelsesteenweg 365,2021-12-05,18:00:00,2,0,2,FMN GV 05 Lier
60,Mechelsesteenweg 365,2021-12-05,19:00:00,0,0,0,FMN GV 05 Lier
60,Mechelsesteenweg 365,2021-12-05,20:00:00,6,4,2,FMN GV 05 Lier
60,Mechelsesteenweg 365,2021-12-05,21:00:00,2,0,2,FMN GV 05 Lier
60,Mechelsesteenweg 365,2021-12-05,22:00:00,2,0,2,FMN GV 05 Lier
60,Mechelsesteenweg 365,2021-12-05,23:00:00,0,0,0,FMN GV 05 Lier
60,Mechelsesteenweg 365,2021-12-06,00:00:00,4,2,2,FMN GV 05 Lier
60,Mechelsesteenweg 365,2021-12-06,01:00:00,0,0,0,FMN GV 05 Lier
60,Mechelsesteenweg 365,2021-12-06,02:00:00,0,0,0,FMN GV 05 Lier
60,Mechelsesteenweg 365,2021-12-06,03:00:00,0,0,0,FMN GV 05 Lier
60,Mechelsesteenweg 365,2021-12-06,04:00:00,0,0,0,FMN GV 05 Lier
60,Mechelsesteenweg 365,2021-12-06,05:00:00,4,0,4,FMN GV 05 Lier
60,Mechelsesteenweg 365,2021-12-06,06:00:00,10,4,6,FMN GV 05 Lier
60,Mechelsesteenweg 365,2021-12-06,07:00:00,92,74,18,FMN GV 05 Lier
60,Mechelsesteenweg 365,2021-12-06,08:00:00,96,66,30,FMN GV 05 Lier
60,Mechelsesteenweg 365,2021-12-06,09:00:00,16,8,8,FMN GV 05 Lier
60,Mechelsesteenweg 365,2021-12-06,10:00:00,34,10,24,FMN GV 05 Lier
60,Mechelsesteenweg 365,2021-12-06,11:00:00,28,20,8,FMN GV 05 Lier
60,Mechelsesteenweg 365,2021-12-06,12:00:00,72,22,50,FMN GV 05 Lier
60,Mechelsesteenweg 365,2021-12-06,13:00:00,68,38,30,FMN GV 05 Lier
60,Mechelsesteenweg 365,2021-12-06,14:00:00,70,32,38,FMN GV 05 Lier
60,Mechelsesteenweg 365,2021-12-06,15:00:00,58,38,20,FMN GV 05 Lier
60,Mechelsesteenweg 365,2021-12-06,16:00:00,142,24,118,FMN GV 05 Lier
60,Mechelsesteenweg 365,2021-12-06,17:00:00,48,28,20,FMN GV 05 Lier
60,Mechelsesteenweg 365,2021-12-06,18:00:00,10,6,4,FMN GV 05 Lier
60,Mechelsesteenweg 365,2021-12-06,19:00:00,6,2,4,FMN GV 05 Lier
60,Mechelsesteenweg 365,2021-12-06,20:00:00,8,4,4,FMN GV 05 Lier
60,Mechelsesteenweg 365,2021-12-06,21:00:00,0,0,0,FMN GV 05 Lier
60,Mechelsesteenweg 365,2021-12-06,22:00:00,0,0,0,FMN GV 05 Lier
60,Mechelsesteenweg 365,2021-12-06,23:00:00,4,4,0,FMN GV 05 Lier
60,Mechelsesteenweg 365,2021-12-07,00:00:00,0,0,0,FMN GV 05 Lier
60,Mechelsesteenweg 365,2021-12-07,01:00:00,0,0,0,FMN GV 05 Lier
60,Mechelsesteenweg 365,2021-12-07,02:00:00,0,0,0,FMN GV 05 Lier
60,Mechelsesteenweg 365,2021-12-07,03:00:00,0,0,0,FMN GV 05 Lier
60,Mechelsesteenweg 365,2021-12-07,04:00:00,0,0,0,FMN GV 05 Lier
60,Mechelsesteenweg 365,2021-12-07,05:00:00,6,0,6,FMN GV 05 Lier
60,Mechelsesteenweg 365,2021-12-07,06:00:00,16,2,14,FMN GV 05 Lier
60,Mechelsesteenweg 365,2021-12-07,07:00:00,140,102,38,FMN GV 05 Lier
60,Mechelsesteenweg 365,2021-12-07,08:00:00,110,78,32,FMN GV 05 Lier
60,Mechelsesteenweg 365,2021-12-07,09:00:00,42,22,20,FMN GV 05 Lier
60,Mechelsesteenweg 365,2021-12-07,10:00:00,98,44,54,FMN GV 05 Lier
60,Mechelsesteenweg 365,2021-12-07,11:00:00,94,42,52,FMN GV 05 Lier
60,Mechelsesteenweg 365,2021-12-07,12:00:00,116,48,68,FMN GV 05 Lier
60,Mechelsesteenweg 365,2021-12-07,13:00:00,140,78,62,FMN GV 05 Lier
60,Mechelsesteenweg 365,2021-12-07,14:00:00,114,60,54,FMN GV 05 Lier
60,Mechelsesteenweg 365,2021-12-07,15:00:00,84,30,54,FMN GV 05 Lier
60,Mechelsesteenweg 365,2021-12-07,16:00:00,144,56,88,FMN GV 05 Lier
60,Mechelsesteenweg 365,2021-12-07,17:00:00,62,38,24,FMN GV 05 Lier
60,Mechelsesteenweg 365,2021-12-07,18:00:00,26,16,10,FMN GV 05 Lier
60,Mechelsesteenweg 365,2021-12-07,19:00:00,8,2,6,FMN GV 05 Lier
60,Mechelsesteenweg 365,2021-12-07,20:00:00,6,0,6,FMN GV 05 Lier
60,Mechelsesteenweg 365,2021-12-07,21:00:00,0,0,0,FMN GV 05 Lier
60,Mechelsesteenweg 365,2021-12-07,22:00:00,2,2,0,FMN GV 05 Lier
60,Mechelsesteenweg 365,2021-12-07,23:00:00,2,0,2,FMN GV 05 Lier
60,Mechelsesteenweg 365,2021-12-08,00:00:00,0,0,0,FMN GV 05 Lier
60,Mechelsesteenweg 365,2021-12-08,01:00:00,0,0,0,FMN GV 05 Lier
60,Mechelsesteenweg 365,2021-12-08,02:00:00,0,0,0,FMN GV 05 Lier
60,Mechelsesteenweg 365,2021-12-08,03:00:00,0,0,0,FMN GV 05 Lier
60,Mechelsesteenweg 365,2021-12-08,04:00:00,0,0,0,FMN GV 05 Lier
60,Mechelsesteenweg 365,2021-12-08,05:00:00,4,0,4,FMN GV 05 Lier
60,Mechelsesteenweg 365,2021-12-08,06:00:00,12,4,8,FMN GV 05 Lier
60,Mechelsesteenweg 365,2021-12-08,07:00:00,132,96,36,FMN GV 05 Lier
60,Mechelsesteenweg 365,2021-12-08,08:00:00,130,92,38,FMN GV 05 Lier
60,Mechelsesteenweg 365,2021-12-08,09:00:00,44,16,28,FMN GV 05 Lier
60,Mechelsesteenweg 365,2021-12-08,10:00:00,66,16,50,FMN GV 05 Lier
60,Mechelsesteenweg 365,2021-12-08,11:00:00,64,26,38,FMN GV 05 Lier
60,Mechelsesteenweg 365,2021-12-08,12:00:00,134,36,98,FMN GV 05 Lier
60,Mechelsesteenweg 365,2021-12-08,13:00:00,108,42,66,FMN GV 05 Lier
60,Mechelsesteenweg 365,2021-12-08,14:00:00,132,96,36,FMN GV 05 Lier
60,Mechelsesteenweg 365,2021-12-08,15:00:00,66,34,32,FMN GV 05 Lier
60,Mechelsesteenweg 365,2021-12-08,16:00:00,74,52,22,FMN GV 05 Lier
60,Mechelsesteenweg 365,2021-12-08,17:00:00,48,36,12,FMN GV 05 Lier
60,Mechelsesteenweg 365,2021-12-08,18:00:00,40,24,16,FMN GV 05 Lier
60,Mechelsesteenweg 365,2021-12-08,19:00:00,10,4,6,FMN GV 05 Lier
60,Mechelsesteenweg 365,2021-12-08,20:00:00,20,4,16,FMN GV 05 Lier
60,Mechelsesteenweg 365,2021-12-08,21:00:00,6,2,4,FMN GV 05 Lier
60,Mechelsesteenweg 365,2021-12-08,22:00:00,4,4,0,FMN GV 05 Lier
60,Mechelsesteenweg 365,2021-12-08,23:00:00,0,0,0,FMN GV 05 Lier
60,Mechelsesteenweg 365,2021-12-09,00:00:00,4,4,0,FMN GV 05 Lier
60,Mechelsesteenweg 365,2021-12-09,01:00:00,0,0,0,FMN GV 05 Lier
60,Mechelsesteenweg 365,2021-12-09,02:00:00,0,0,0,FMN GV 05 Lier
60,Mechelsesteenweg 365,2021-12-09,03:00:00,0,0,0,FMN GV 05 Lier
60,Mechelsesteenweg 365,2021-12-09,04:00:00,0,0,0,FMN GV 05 Lier
60,Mechelsesteenweg 365,2021-12-09,05:00:00,8,0,8,FMN GV 05 Lier
60,Mechelsesteenweg 365,2021-12-09,06:00:00,20,8,12,FMN GV 05 Lier
60,Mechelsesteenweg 365,2021-12-09,07:00:00,132,88,44,FMN GV 05 Lier
60,Mechelsesteenweg 365,2021-12-09,08:00:00,126,94,32,FMN GV 05 Lier
60,Mechelsesteenweg 365,2021-12-09,09:00:00,42,28,14,FMN GV 05 Lier
60,Mechelsesteenweg 365,2021-12-09,10:00:00,50,16,34,FMN GV 05 Lier
60,Mechelsesteenweg 365,2021-12-09,11:00:00,46,12,34,FMN GV 05 Lier
60,Mechelsesteenweg 365,2021-12-09,12:00:00,98,28,70,FMN GV 05 Lier
60,Mechelsesteenweg 365,2021-12-09,13:00:00,62,26,36,FMN GV 05 Lier
60,Mechelsesteenweg 365,2021-12-09,14:00:00,62,36,26,FMN GV 05 Lier
60,Mechelsesteenweg 365,2021-12-09,15:00:00,66,26,40,FMN GV 05 Lier
60,Mechelsesteenweg 365,2021-12-09,16:00:00,104,46,58,FMN GV 05 Lier
60,Mechelsesteenweg 365,2021-12-09,17:00:00,44,30,14,FMN GV 05 Lier
60,Mechelsesteenweg 365,2021-12-09,18:00:00,30,16,14,FMN GV 05 Lier
60,Mechelsesteenweg 365,2021-12-09,19:00:00,14,6,8,FMN GV 05 Lier
60,Mechelsesteenweg 365,2021-12-09,20:00:00,8,2,6,FMN GV 05 Lier
60,Mechelsesteenweg 365,2021-12-09,21:00:00,2,0,2,FMN GV 05 Lier
60,Mechelsesteenweg 365,2021-12-09,22:00:00,2,2,0,FMN GV 05 Lier
60,Mechelsesteenweg 365,2021-12-09,23:00:00,2,0,2,FMN GV 05 Lier
60,Mechelsesteenweg 365,2021-12-10,00:00:00,0,0,0,FMN GV 05 Lier
60,Mechelsesteenweg 365,2021-12-10,01:00:00,2,2,0,FMN GV 05 Lier
60,Mechelsesteenweg 365,2021-12-10,02:00:00,0,0,0,FMN GV 05 Lier
60,Mechelsesteenweg 365,2021-12-10,03:00:00,0,0,0,FMN GV 05 Lier
60,Mechelsesteenweg 365,2021-12-10,04:00:00,0,0,0,FMN GV 05 Lier
60,Mechelsesteenweg 365,2021-12-10,05:00:00,4,0,4,FMN GV 05 Lier
60,Mechelsesteenweg 365,2021-12-10,06:00:00,10,0,10,FMN GV 05 Lier
60,Mechelsesteenweg 365,2021-12-10,07:00:00,84,64,20,FMN GV 05 Lier
60,Mechelsesteenweg 365,2021-12-10,08:00:00,102,84,18,FMN GV 05 Lier
60,Mechelsesteenweg 365,2021-12-10,09:00:00,6,4,2,FMN GV 05 Lier
60,Mechelsesteenweg 365,2021-12-10,10:00:00,68,10,58,FMN GV 05 Lier
60,Mechelsesteenweg 365,2021-12-10,11:00:00,22,6,16,FMN GV 05 Lier
60,Mechelsesteenweg 365,2021-12-10,12:00:00,64,8,56,FMN GV 05 Lier
60,Mechelsesteenweg 365,2021-12-10,13:00:00,12,6,6,FMN GV 05 Lier
60,Mechelsesteenweg 365,2021-12-10,14:00:00,16,10,6,FMN GV 05 Lier
60,Mechelsesteenweg 365,2021-12-10,15:00:00,12,8,4,FMN GV 05 Lier
60,Mechelsesteenweg 365,2021-12-10,16:00:00,32,18,14,FMN GV 05 Lier
60,Mechelsesteenweg 365,2021-12-10,17:00:00,22,14,8,FMN GV 05 Lier
60,Mechelsesteenweg 365,2021-12-10,18:00:00,10,6,4,FMN GV 05 Lier
60,Mechelsesteenweg 365,2021-12-10,19:00:00,4,2,2,FMN GV 05 Lier
60,Mechelsesteenweg 365,2021-12-10,20:00:00,4,2,2,FMN GV 05 Lier
60,Mechelsesteenweg 365,2021-12-10,21:00:00,4,0,4,FMN GV 05 Lier
60,Mechelsesteenweg 365,2021-12-10,22:00:00,2,2,0,FMN GV 05 Lier
60,Mechelsesteenweg 365,2021-12-10,23:00:00,2,2,0,FMN GV 05 Lier
60,Mechelsesteenweg 365,2021-12-11,00:00:00,0,0,0,FMN GV 05 Lier
60,Mechelsesteenweg 365,2021-12-11,01:00:00,0,0,0,FMN GV 05 Lier
60,Mechelsesteenweg 365,2021-12-11,02:00:00,0,0,0,FMN GV 05 Lier
60,Mechelsesteenweg 365,2021-12-11,03:00:00,0,0,0,FMN GV 05 Lier
60,Mechelsesteenweg 365,2021-12-11,04:00:00,0,0,0,FMN GV 05 Lier
60,Mechelsesteenweg 365,2021-12-11,05:00:00,4,0,4,FMN GV 05 Lier
60,Mechelsesteenweg 365,2021-12-11,06:00:00,2,0,2,FMN GV 05 Lier
60,Mechelsesteenweg 365,2021-12-11,07:00:00,14,6,8,FMN GV 05 Lier
60,Mechelsesteenweg 365,2021-12-11,08:00:00,12,6,6,FMN GV 05 Lier
60,Mechelsesteenweg 365,2021-12-11,09:00:00,52,16,36,FMN GV 05 Lier
60,Mechelsesteenweg 365,2021-12-11,10:00:00,86,52,34,FMN GV 05 Lier
60,Mechelsesteenweg 365,2021-12-11,11:00:00,172,102,70,FMN GV 05 Lier
60,Mechelsesteenweg 365,2021-12-11,12:00:00,166,80,86,FMN GV 05 Lier
60,Mechelsesteenweg 365,2021-12-11,13:00:00,176,80,96,FMN GV 05 Lier
60,Mechelsesteenweg 365,2021-12-11,14:00:00,228,136,92,FMN GV 05 Lier
60,Mechelsesteenweg 365,2021-12-11,15:00:00,176,62,114,FMN GV 05 Lier
60,Mechelsesteenweg 365,2021-12-11,16:00:00,78,28,50,FMN GV 05 Lier
60,Mechelsesteenweg 365,2021-12-11,17:00:00,18,6,12,FMN GV 05 Lier
60,Mechelsesteenweg 365,2021-12-11,18:00:00,12,6,6,FMN GV 05 Lier
60,Mechelsesteenweg 365,2021-12-11,19:00:00,6,6,0,FMN GV 05 Lier
60,Mechelsesteenweg 365,2021-12-11,20:00:00,22,16,6,FMN GV 05 Lier
60,Mechelsesteenweg 365,2021-12-11,21:00:00,2,2,0,FMN GV 05 Lier
60,Mechelsesteenweg 365,2021-12-11,22:00:00,32,4,28,FMN GV 05 Lier
60,Mechelsesteenweg 365,2021-12-11,23:00:00,12,6,6,FMN GV 05 Lier
60,Mechelsesteenweg 365,2021-12-12,00:00:00,0,0,0,FMN GV 05 Lier
60,Mechelsesteenweg 365,2021-12-12,01:00:00,0,0,0,FMN GV 05 Lier
60,Mechelsesteenweg 365,2021-12-12,02:00:00,0,0,0,FMN GV 05 Lier
60,Mechelsesteenweg 365,2021-12-12,03:00:00,0,0,0,FMN GV 05 Lier
60,Mechelsesteenweg 365,2021-12-12,04:00:00,0,0,0,FMN GV 05 Lier
60,Mechelsesteenweg 365,2021-12-12,05:00:00,4,0,4,FMN GV 05 Lier
60,Mechelsesteenweg 365,2021-12-12,06:00:00,0,0,0,FMN GV 05 Lier
60,Mechelsesteenweg 365,2021-12-12,07:00:00,2,0,2,FMN GV 05 Lier
60,Mechelsesteenweg 365,2021-12-12,08:00:00,0,0,0,FMN GV 05 Lier
60,Mechelsesteenweg 365,2021-12-12,09:00:00,48,26,22,FMN GV 05 Lier
60,Mechelsesteenweg 365,2021-12-12,10:00:00,44,24,20,FMN GV 05 Lier
60,Mechelsesteenweg 365,2021-12-12,11:00:00,54,34,20,FMN GV 05 Lier
60,Mechelsesteenweg 365,2021-12-12,12:00:00,40,22,18,FMN GV 05 Lier
60,Mechelsesteenweg 365,2021-12-12,13:00:00,26,16,10,FMN GV 05 Lier
60,Mechelsesteenweg 365,2021-12-12,14:00:00,28,18,10,FMN GV 05 Lier
60,Mechelsesteenweg 365,2021-12-12,15:00:00,24,14,10,FMN GV 05 Lier
60,Mechelsesteenweg 365,2021-12-12,16:00:00,20,10,10,FMN GV 05 Lier
60,Mechelsesteenweg 365,2021-12-12,17:00:00,12,6,6,FMN GV 05 Lier
60,Mechelsesteenweg 365,2021-12-12,18:00:00,2,2,0,FMN GV 05 Lier
60,Mechelsesteenweg 365,2021-12-12,19:00:00,2,0,2,FMN GV 05 Lier
60,Mechelsesteenweg 365,2021-12-12,20:00:00,4,2,2,FMN GV 05 Lier
60,Mechelsesteenweg 365,2021-12-12,21:00:00,0,0,0,FMN GV 05 Lier
60,Mechelsesteenweg 365,2021-12-12,22:00:00,0,0,0,FMN GV 05 Lier
60,Mechelsesteenweg 365,2021-12-12,23:00:00,0,0,0,FMN GV 05 Lier
60,Mechelsesteenweg 365,2021-12-13,00:00:00,0,0,0,FMN GV 05 Lier
60,Mechelsesteenweg 365,2021-12-13,01:00:00,0,0,0,FMN GV 05 Lier
60,Mechelsesteenweg 365,2021-12-13,02:00:00,0,0,0,FMN GV 05 Lier
60,Mechelsesteenweg 365,2021-12-13,03:00:00,0,0,0,FMN GV 05 Lier
60,Mechelsesteenweg 365,2021-12-13,04:00:00,2,0,2,FMN GV 05 Lier
60,Mechelsesteenweg 365,2021-12-13,05:00:00,2,2,0,FMN GV 05 Lier
60,Mechelsesteenweg 365,2021-12-13,06:00:00,20,6,14,FMN GV 05 Lier
60,Mechelsesteenweg 365,2021-12-13,07:00:00,152,96,56,FMN GV 05 Lier
60,Mechelsesteenweg 365,2021-12-13,08:00:00,100,74,26,FMN GV 05 Lier
60,Mechelsesteenweg 365,2021-12-13,09:00:00,34,18,16,FMN GV 05 Lier
60,Mechelsesteenweg 365,2021-12-13,10:00:00,136,44,92,FMN GV 05 Lier
60,Mechelsesteenweg 365,2021-12-13,11:00:00,76,38,38,FMN GV 05 Lier
60,Mechelsesteenweg 365,2021-12-13,12:00:00,154,44,110,FMN GV 05 Lier
60,Mechelsesteenweg 365,2021-12-13,13:00:00,104,42,62,FMN GV 05 Lier
60,Mechelsesteenweg 365,2021-12-13,14:00:00,154,92,62,FMN GV 05 Lier
60,Mechelsesteenweg 365,2021-12-13,15:00:00,106,56,50,FMN GV 05 Lier
60,Mechelsesteenweg 365,2021-12-13,16:00:00,90,52,38,FMN GV 05 Lier
60,Mechelsesteenweg 365,2021-12-13,17:00:00,54,32,22,FMN GV 05 Lier
60,Mechelsesteenweg 365,2021-12-13,18:00:00,16,12,4,FMN GV 05 Lier
60,Mechelsesteenweg 365,2021-12-13,19:00:00,8,6,2,FMN GV 05 Lier
60,Mechelsesteenweg 365,2021-12-13,20:00:00,10,2,8,FMN GV 05 Lier
60,Mechelsesteenweg 365,2021-12-13,21:00:00,6,2,4,FMN GV 05 Lier
60,Mechelsesteenweg 365,2021-12-13,22:00:00,2,2,0,FMN GV 05 Lier
60,Mechelsesteenweg 365,2021-12-13,23:00:00,2,0,2,FMN GV 05 Lier
60,Mechelsesteenweg 365,2021-12-14,00:00:00,0,0,0,FMN GV 05 Lier
60,Mechelsesteenweg 365,2021-12-14,01:00:00,0,0,0,FMN GV 05 Lier
60,Mechelsesteenweg 365,2021-12-14,02:00:00,0,0,0,FMN GV 05 Lier
60,Mechelsesteenweg 365,2021-12-14,03:00:00,2,0,2,FMN GV 05 Lier
60,Mechelsesteenweg 365,2021-12-14,04:00:00,2,0,2,FMN GV 05 Lier
60,Mechelsesteenweg 365,2021-12-14,05:00:00,6,0,6,FMN GV 05 Lier
60,Mechelsesteenweg 365,2021-12-14,06:00:00,32,12,20,FMN GV 05 Lier
60,Mechelsesteenweg 365,2021-12-14,07:00:00,192,136,56,FMN GV 05 Lier
60,Mechelsesteenweg 365,2021-12-14,08:00:00,80,46,34,FMN GV 05 Lier
60,Mechelsesteenweg 365,2021-12-14,09:00:00,42,20,22,FMN GV 05 Lier
60,Mechelsesteenweg 365,2021-12-14,10:00:00,180,44,136,FMN GV 05 Lier
60,Mechelsesteenweg 365,2021-12-14,11:00:00,78,34,44,FMN GV 05 Lier
60,Mechelsesteenweg 365,2021-12-14,12:00:00,124,42,82,FMN GV 05 Lier
60,Mechelsesteenweg 365,2021-12-14,13:00:00,116,54,62,FMN GV 05 Lier
60,Mechelsesteenweg 365,2021-12-14,14:00:00,96,54,42,FMN GV 05 Lier
60,Mechelsesteenweg 365,2021-12-14,15:00:00,98,52,46,FMN GV 05 Lier
60,Mechelsesteenweg 365,2021-12-14,16:00:00,92,58,34,FMN GV 05 Lier
60,Mechelsesteenweg 365,2021-12-14,17:00:00,56,34,22,FMN GV 05 Lier
60,Mechelsesteenweg 365,2021-12-14,18:00:00,26,22,4,FMN GV 05 Lier
60,Mechelsesteenweg 365,2021-12-14,19:00:00,20,8,12,FMN GV 05 Lier
60,Mechelsesteenweg 365,2021-12-14,20:00:00,24,10,14,FMN GV 05 Lier
60,Mechelsesteenweg 365,2021-12-14,21:00:00,6,4,2,FMN GV 05 Lier
60,Mechelsesteenweg 365,2021-12-14,22:00:00,2,0,2,FMN GV 05 Lier
60,Mechelsesteenweg 365,2021-12-14,23:00:00,0,0,0,FMN GV 05 Lier
60,Mechelsesteenweg 365,2021-12-15,00:00:00,2,0,2,FMN GV 05 Lier
60,Mechelsesteenweg 365,2021-12-15,01:00:00,0,0,0,FMN GV 05 Lier
60,Mechelsesteenweg 365,2021-12-15,02:00:00,0,0,0,FMN GV 05 Lier
60,Mechelsesteenweg 365,2021-12-15,03:00:00,2,0,2,FMN GV 05 Lier
60,Mechelsesteenweg 365,2021-12-15,04:00:00,2,0,2,FMN GV 05 Lier
60,Mechelsesteenweg 365,2021-12-15,05:00:00,4,0,4,FMN GV 05 Lier
60,Mechelsesteenweg 365,2021-12-15,06:00:00,22,8,14,FMN GV 05 Lier
60,Mechelsesteenweg 365,2021-12-15,07:00:00,190,138,52,FMN GV 05 Lier
60,Mechelsesteenweg 365,2021-12-15,08:00:00,110,78,32,FMN GV 05 Lier
60,Mechelsesteenweg 365,2021-12-15,09:00:00,42,22,20,FMN GV 05 Lier
60,Mechelsesteenweg 365,2021-12-15,10:00:00,128,20,108,FMN GV 05 Lier
60,Mechelsesteenweg 365,2021-12-15,11:00:00,84,26,58,FMN GV 05 Lier
60,Mechelsesteenweg 365,2021-12-15,12:00:00,118,40,78,FMN GV 05 Lier
60,Mechelsesteenweg 365,2021-12-15,13:00:00,94,50,44,FMN GV 05 Lier
60,Mechelsesteenweg 365,2021-12-15,14:00:00,102,64,38,FMN GV 05 Lier
60,Mechelsesteenweg 365,2021-12-15,15:00:00,86,48,38,FMN GV 05 Lier
60,Mechelsesteenweg 365,2021-12-15,16:00:00,68,48,20,FMN GV 05 Lier
60,Mechelsesteenweg 365,2021-12-15,17:00:00,42,38,4,FMN GV 05 Lier
60,Mechelsesteenweg 365,2021-12-15,18:00:00,40,24,16,FMN GV 05 Lier
60,Mechelsesteenweg 365,2021-12-15,19:00:00,18,10,8,FMN GV 05 Lier
60,Mechelsesteenweg 365,2021-12-15,20:00:00,6,4,2,FMN GV 05 Lier
60,Mechelsesteenweg 365,2021-12-15,21:00:00,2,0,2,FMN GV 05 Lier
60,Mechelsesteenweg 365,2021-12-15,22:00:00,0,0,0,FMN GV 05 Lier
60,Mechelsesteenweg 365,2021-12-15,23:00:00,2,0,2,FMN GV 05 Lier
60,Mechelsesteenweg 365,2021-12-16,00:00:00,0,0,0,FMN GV 05 Lier
60,Mechelsesteenweg 365,2021-12-16,01:00:00,4,4,0,FMN GV 05 Lier
60,Mechelsesteenweg 365,2021-12-16,02:00:00,0,0,0,FMN GV 05 Lier
60,Mechelsesteenweg 365,2021-12-16,03:00:00,2,0,2,FMN GV 05 Lier
60,Mechelsesteenweg 365,2021-12-16,04:00:00,2,0,2,FMN GV 05 Lier
60,Mechelsesteenweg 365,2021-12-16,05:00:00,10,2,8,FMN GV 05 Lier
60,Mechelsesteenweg 365,2021-12-16,06:00:00,24,6,18,FMN GV 05 Lier
60,Mechelsesteenweg 365,2021-12-16,07:00:00,180,118,62,FMN GV 05 Lier
60,Mechelsesteenweg 365,2021-12-16,08:00:00,106,84,22,FMN GV 05 Lier
60,Mechelsesteenweg 365,2021-12-16,09:00:00,62,44,18,FMN GV 05 Lier
60,Mechelsesteenweg 365,2021-12-16,10:00:00,202,26,176,FMN GV 05 Lier
60,Mechelsesteenweg 365,2021-12-16,11:00:00,116,52,64,FMN GV 05 Lier
60,Mechelsesteenweg 365,2021-12-16,12:00:00,142,62,80,FMN GV 05 Lier
60,Mechelsesteenweg 365,2021-12-16,13:00:00,158,90,68,FMN GV 05 Lier
60,Mechelsesteenweg 365,2021-12-16,14:00:00,252,156,96,FMN GV 05 Lier
60,Mechelsesteenweg 365,2021-12-16,15:00:00,206,84,122,FMN GV 05 Lier
60,Mechelsesteenweg 365,2021-12-16,16:00:00,128,70,58,FMN GV 05 Lier
60,Mechelsesteenweg 365,2021-12-16,17:00:00,56,40,16,FMN GV 05 Lier
60,Mechelsesteenweg 365,2021-12-16,18:00:00,30,16,14,FMN GV 05 Lier
60,Mechelsesteenweg 365,2021-12-16,19:00:00,10,8,2,FMN GV 05 Lier
60,Mechelsesteenweg 365,2021-12-16,20:00:00,18,2,16,FMN GV 05 Lier
60,Mechelsesteenweg 365,2021-12-16,21:00:00,6,4,2,FMN GV 05 Lier
60,Mechelsesteenweg 365,2021-12-16,22:00:00,6,0,6,FMN GV 05 Lier
60,Mechelsesteenweg 365,2021-12-16,23:00:00,0,0,0,FMN GV 05 Lier
60,Mechelsesteenweg 365,2021-12-17,00:00:00,0,0,0,FMN GV 05 Lier
60,Mechelsesteenweg 365,2021-12-17,01:00:00,0,0,0,FMN GV 05 Lier
60,Mechelsesteenweg 365,2021-12-17,02:00:00,0,0,0,FMN GV 05 Lier
60,Mechelsesteenweg 365,2021-12-17,03:00:00,2,0,2,FMN GV 05 Lier
60,Mechelsesteenweg 365,2021-12-17,04:00:00,2,0,2,FMN GV 05 Lier
60,Mechelsesteenweg 365,2021-12-17,05:00:00,2,0,2,FMN GV 05 Lier
60,Mechelsesteenweg 365,2021-12-17,06:00:00,18,2,16,FMN GV 05 Lier
60,Mechelsesteenweg 365,2021-12-17,07:00:00,152,110,42,FMN GV 05 Lier
60,Mechelsesteenweg 365,2021-12-17,08:00:00,78,46,32,FMN GV 05 Lier
60,Mechelsesteenweg 365,2021-12-17,09:00:00,42,24,18,FMN GV 05 Lier
60,Mechelsesteenweg 365,2021-12-17,10:00:00,114,32,82,FMN GV 05 Lier
60,Mechelsesteenweg 365,2021-12-17,11:00:00,108,32,76,FMN GV 05 Lier
60,Mechelsesteenweg 365,2021-12-17,12:00:00,102,42,60,FMN GV 05 Lier
60,Mechelsesteenweg 365,2021-12-17,13:00:00,76,36,40,FMN GV 05 Lier
60,Mechelsesteenweg 365,2021-12-17,14:00:00,88,44,44,FMN GV 05 Lier
60,Mechelsesteenweg 365,2021-12-17,15:00:00,76,34,42,FMN GV 05 Lier
60,Mechelsesteenweg 365,2021-12-17,16:00:00,80,46,34,FMN GV 05 Lier
60,Mechelsesteenweg 365,2021-12-17,17:00:00,38,24,14,FMN GV 05 Lier
60,Mechelsesteenweg 365,2021-12-17,18:00:00,16,14,2,FMN GV 05 Lier
60,Mechelsesteenweg 365,2021-12-17,19:00:00,4,2,2,FMN GV 05 Lier
60,Mechelsesteenweg 365,2021-12-17,20:00:00,12,8,4,FMN GV 05 Lier
60,Mechelsesteenweg 365,2021-12-17,21:00:00,8,2,6,FMN GV 05 Lier
60,Mechelsesteenweg 365,2021-12-17,22:00:00,8,2,6,FMN GV 05 Lier
60,Mechelsesteenweg 365,2021-12-17,23:00:00,6,6,0,FMN GV 05 Lier
60,Mechelsesteenweg 365,2021-12-18,00:00:00,0,0,0,FMN GV 05 Lier
60,Mechelsesteenweg 365,2021-12-18,01:00:00,2,0,2,FMN GV 05 Lier
60,Mechelsesteenweg 365,2021-12-18,02:00:00,4,4,0,FMN GV 05 Lier
60,Mechelsesteenweg 365,2021-12-18,03:00:00,0,0,0,FMN GV 05 Lier
60,Mechelsesteenweg 365,2021-12-18,04:00:00,0,0,0,FMN GV 05 Lier
60,Mechelsesteenweg 365,2021-12-18,05:00:00,4,0,4,FMN GV 05 Lier
60,Mechelsesteenweg 365,2021-12-18,06:00:00,0,0,0,FMN GV 05 Lier
60,Mechelsesteenweg 365,2021-12-18,07:00:00,12,6,6,FMN GV 05 Lier
60,Mechelsesteenweg 365,2021-12-18,08:00:00,8,2,6,FMN GV 05 Lier
60,Mechelsesteenweg 365,2021-12-18,09:00:00,52,38,14,FMN GV 05 Lier
60,Mechelsesteenweg 365,2021-12-18,10:00:00,68,46,22,FMN GV 05 Lier
60,Mechelsesteenweg 365,2021-12-18,11:00:00,104,38,66,FMN GV 05 Lier
60,Mechelsesteenweg 365,2021-12-18,12:00:00,80,46,34,FMN GV 05 Lier
60,Mechelsesteenweg 365,2021-12-18,13:00:00,120,72,48,FMN GV 05 Lier
60,Mechelsesteenweg 365,2021-12-18,14:00:00,92,40,52,FMN GV 05 Lier
60,Mechelsesteenweg 365,2021-12-18,15:00:00,104,36,68,FMN GV 05 Lier
60,Mechelsesteenweg 365,2021-12-18,16:00:00,48,18,30,FMN GV 05 Lier
60,Mechelsesteenweg 365,2021-12-18,17:00:00,24,6,18,FMN GV 05 Lier
60,Mechelsesteenweg 365,2021-12-18,18:00:00,6,4,2,FMN GV 05 Lier
60,Mechelsesteenweg 365,2021-12-18,19:00:00,0,0,0,FMN GV 05 Lier
60,Mechelsesteenweg 365,2021-12-18,20:00:00,14,0,14,FMN GV 05 Lier
60,Mechelsesteenweg 365,2021-12-18,21:00:00,2,0,2,FMN GV 05 Lier
60,Mechelsesteenweg 365,2021-12-18,22:00:00,0,0,0,FMN GV 05 Lier
60,Mechelsesteenweg 365,2021-12-18,23:00:00,0,0,0,FMN GV 05 Lier
60,Mechelsesteenweg 365,2021-12-19,00:00:00,4,4,0,FMN GV 05 Lier
60,Mechelsesteenweg 365,2021-12-19,01:00:00,2,2,0,FMN GV 05 Lier
60,Mechelsesteenweg 365,2021-12-19,02:00:00,2,2,0,FMN GV 05 Lier
60,Mechelsesteenweg 365,2021-12-19,03:00:00,0,0,0,FMN GV 05 Lier
60,Mechelsesteenweg 365,2021-12-19,04:00:00,0,0,0,FMN GV 05 Lier
60,Mechelsesteenweg 365,2021-12-19,05:00:00,4,0,4,FMN GV 05 Lier
60,Mechelsesteenweg 365,2021-12-19,06:00:00,2,0,2,FMN GV 05 Lier
60,Mechelsesteenweg 365,2021-12-19,07:00:00,2,0,2,FMN GV 05 Lier
60,Mechelsesteenweg 365,2021-12-19,08:00:00,14,6,8,FMN GV 05 Lier
60,Mechelsesteenweg 365,2021-12-19,09:00:00,84,66,18,FMN GV 05 Lier
60,Mechelsesteenweg 365,2021-12-19,10:00:00,180,92,88,FMN GV 05 Lier
60,Mechelsesteenweg 365,2021-12-19,11:00:00,174,72,102,FMN GV 05 Lier
60,Mechelsesteenweg 365,2021-12-19,12:00:00,62,32,30,FMN GV 05 Lier
60,Mechelsesteenweg 365,2021-12-19,13:00:00,82,52,30,FMN GV 05 Lier
60,Mechelsesteenweg 365,2021-12-19,14:00:00,66,32,34,FMN GV 05 Lier
60,Mechelsesteenweg 365,2021-12-19,15:00:00,58,26,32,FMN GV 05 Lier
60,Mechelsesteenweg 365,2021-12-19,16:00:00,26,8,18,FMN GV 05 Lier
60,Mechelsesteenweg 365,2021-12-19,17:00:00,16,6,10,FMN GV 05 Lier
60,Mechelsesteenweg 365,2021-12-19,18:00:00,4,4,0,FMN GV 05 Lier
60,Mechelsesteenweg 365,2021-12-19,19:00:00,0,0,0,FMN GV 05 Lier
60,Mechelsesteenweg 365,2021-12-19,20:00:00,2,0,2,FMN GV 05 Lier
60,Mechelsesteenweg 365,2021-12-19,21:00:00,0,0,0,FMN GV 05 Lier
60,Mechelsesteenweg 365,2021-12-19,22:00:00,0,0,0,FMN GV 05 Lier
60,Mechelsesteenweg 365,2021-12-19,23:00:00,0,0,0,FMN GV 05 Lier
60,Mechelsesteenweg 365,2021-12-20,00:00:00,0,0,0,FMN GV 05 Lier
60,Mechelsesteenweg 365,2021-12-20,01:00:00,2,0,2,FMN GV 05 Lier
60,Mechelsesteenweg 365,2021-12-20,02:00:00,0,0,0,FMN GV 05 Lier
60,Mechelsesteenweg 365,2021-12-20,03:00:00,2,0,2,FMN GV 05 Lier
60,Mechelsesteenweg 365,2021-12-20,04:00:00,0,0,0,FMN GV 05 Lier
60,Mechelsesteenweg 365,2021-12-20,05:00:00,2,0,2,FMN GV 05 Lier
60,Mechelsesteenweg 365,2021-12-20,06:00:00,16,6,10,FMN GV 05 Lier
60,Mechelsesteenweg 365,2021-12-20,07:00:00,148,104,44,FMN GV 05 Lier
60,Mechelsesteenweg 365,2021-12-20,08:00:00,128,94,34,FMN GV 05 Lier
60,Mechelsesteenweg 365,2021-12-20,09:00:00,46,12,34,FMN GV 05 Lier
60,Mechelsesteenweg 365,2021-12-20,10:00:00,64,34,30,FMN GV 05 Lier
60,Mechelsesteenweg 365,2021-12-20,11:00:00,84,24,60,FMN GV 05 Lier
60,Mechelsesteenweg 365,2021-12-20,12:00:00,140,48,92,FMN GV 05 Lier
60,Mechelsesteenweg 365,2021-12-20,13:00:00,136,46,90,FMN GV 05 Lier
60,Mechelsesteenweg 365,2021-12-20,14:00:00,140,64,76,FMN GV 05 Lier
60,Mechelsesteenweg 365,2021-12-20,15:00:00,104,46,58,FMN GV 05 Lier
60,Mechelsesteenweg 365,2021-12-20,16:00:00,104,42,62,FMN GV 05 Lier
60,Mechelsesteenweg 365,2021-12-20,17:00:00,46,36,10,FMN GV 05 Lier
60,Mechelsesteenweg 365,2021-12-20,18:00:00,16,10,6,FMN GV 05 Lier
60,Mechelsesteenweg 365,2021-12-20,19:00:00,38,30,8,FMN GV 05 Lier
60,Mechelsesteenweg 365,2021-12-20,20:00:00,12,0,12,FMN GV 05 Lier
60,Mechelsesteenweg 365,2021-12-20,21:00:00,16,8,8,FMN GV 05 Lier
60,Mechelsesteenweg 365,2021-12-20,22:00:00,2,2,0,FMN GV 05 Lier
60,Mechelsesteenweg 365,2021-12-20,23:00:00,14,4,10,FMN GV 05 Lier
60,Mechelsesteenweg 365,2021-12-21,00:00:00,2,2,0,FMN GV 05 Lier
60,Mechelsesteenweg 365,2021-12-21,01:00:00,0,0,0,FMN GV 05 Lier
60,Mechelsesteenweg 365,2021-12-21,02:00:00,0,0,0,FMN GV 05 Lier
60,Mechelsesteenweg 365,2021-12-21,03:00:00,0,0,0,FMN GV 05 Lier
60,Mechelsesteenweg 365,2021-12-21,04:00:00,2,0,2,FMN GV 05 Lier
60,Mechelsesteenweg 365,2021-12-21,05:00:00,2,0,2,FMN GV 05 Lier
60,Mechelsesteenweg 365,2021-12-21,06:00:00,14,6,8,FMN GV 05 Lier
60,Mechelsesteenweg 365,2021-12-21,07:00:00,26,6,20,FMN GV 05 Lier
60,Mechelsesteenweg 365,2021-12-21,08:00:00,22,10,12,FMN GV 05 Lier
60,Mechelsesteenweg 365,2021-12-21,09:00:00,16,6,10,FMN GV 05 Lier
60,Mechelsesteenweg 365,2021-12-21,10:00:00,42,18,24,FMN GV 05 Lier
60,Mechelsesteenweg 365,2021-12-21,11:00:00,34,20,14,FMN GV 05 Lier
60,Mechelsesteenweg 365,2021-12-21,12:00:00,60,36,24,FMN GV 05 Lier
60,Mechelsesteenweg 365,2021-12-21,13:00:00,70,44,26,FMN GV 05 Lier
60,Mechelsesteenweg 365,2021-12-21,14:00:00,124,64,60,FMN GV 05 Lier
60,Mechelsesteenweg 365,2021-12-21,15:00:00,90,42,48,FMN GV 05 Lier
60,Mechelsesteenweg 365,2021-12-21,16:00:00,72,28,44,FMN GV 05 Lier
60,Mechelsesteenweg 365,2021-12-21,17:00:00,42,28,14,FMN GV 05 Lier
60,Mechelsesteenweg 365,2021-12-21,18:00:00,24,12,12,FMN GV 05 Lier
60,Mechelsesteenweg 365,2021-12-21,19:00:00,24,22,2,FMN GV 05 Lier
60,Mechelsesteenweg 365,2021-12-21,20:00:00,6,0,6,FMN GV 05 Lier
60,Mechelsesteenweg 365,2021-12-21,21:00:00,8,0,8,FMN GV 05 Lier
60,Mechelsesteenweg 365,2021-12-21,22:00:00,4,2,2,FMN GV 05 Lier
60,Mechelsesteenweg 365,2021-12-21,23:00:00,0,0,0,FMN GV 05 Lier
60,Mechelsesteenweg 365,2021-12-22,00:00:00,2,2,0,FMN GV 05 Lier
60,Mechelsesteenweg 365,2021-12-22,01:00:00,0,0,0,FMN GV 05 Lier
60,Mechelsesteenweg 365,2021-12-22,02:00:00,0,0,0,FMN GV 05 Lier
60,Mechelsesteenweg 365,2021-12-22,03:00:00,2,0,2,FMN GV 05 Lier
60,Mechelsesteenweg 365,2021-12-22,04:00:00,2,0,2,FMN GV 05 Lier
60,Mechelsesteenweg 365,2021-12-22,05:00:00,0,0,0,FMN GV 05 Lier
60,Mechelsesteenweg 365,2021-12-22,06:00:00,14,10,4,FMN GV 05 Lier
60,Mechelsesteenweg 365,2021-12-22,07:00:00,32,10,22,FMN GV 05 Lier
60,Mechelsesteenweg 365,2021-12-22,08:00:00,18,4,14,FMN GV 05 Lier
60,Mechelsesteenweg 365,2021-12-22,09:00:00,24,8,16,FMN GV 05 Lier
60,Mechelsesteenweg 365,2021-12-22,10:00:00,16,6,10,FMN GV 05 Lier
60,Mechelsesteenweg 365,2021-12-22,11:00:00,30,8,22,FMN GV 05 Lier
60,Mechelsesteenweg 365,2021-12-22,12:00:00,60,14,46,FMN GV 05 Lier
60,Mechelsesteenweg 365,2021-12-22,13:00:00,76,36,40,FMN GV 05 Lier
60,Mechelsesteenweg 365,2021-12-22,14:00:00,88,40,48,FMN GV 05 Lier
60,Mechelsesteenweg 365,2021-12-22,15:00:00,86,30,56,FMN GV 05 Lier
60,Mechelsesteenweg 365,2021-12-22,16:00:00,78,46,32,FMN GV 05 Lier
60,Mechelsesteenweg 365,2021-12-22,17:00:00,46,36,10,FMN GV 05 Lier
60,Mechelsesteenweg 365,2021-12-22,18:00:00,18,18,0,FMN GV 05 Lier
60,Mechelsesteenweg 365,2021-12-22,19:00:00,8,2,6,FMN GV 05 Lier
60,Mechelsesteenweg 365,2021-12-22,20:00:00,2,0,2,FMN GV 05 Lier
60,Mechelsesteenweg 365,2021-12-22,21:00:00,8,4,4,FMN GV 05 Lier
60,Mechelsesteenweg 365,2021-12-22,22:00:00,6,4,2,FMN GV 05 Lier
60,Mechelsesteenweg 365,2021-12-22,23:00:00,4,2,2,FMN GV 05 Lier
60,Mechelsesteenweg 365,2021-12-23,00:00:00,2,2,0,FMN GV 05 Lier
60,Mechelsesteenweg 365,2021-12-23,01:00:00,2,2,0,FMN GV 05 Lier
60,Mechelsesteenweg 365,2021-12-23,02:00:00,0,0,0,FMN GV 05 Lier
60,Mechelsesteenweg 365,2021-12-23,03:00:00,4,2,2,FMN GV 05 Lier
60,Mechelsesteenweg 365,2021-12-23,04:00:00,4,2,2,FMN GV 05 Lier
60,Mechelsesteenweg 365,2021-12-23,05:00:00,2,2,0,FMN GV 05 Lier
60,Mechelsesteenweg 365,2021-12-23,06:00:00,8,4,4,FMN GV 05 Lier
60,Mechelsesteenweg 365,2021-12-23,07:00:00,28,12,16,FMN GV 05 Lier
60,Mechelsesteenweg 365,2021-12-23,08:00:00,48,30,18,FMN GV 05 Lier
60,Mechelsesteenweg 365,2021-12-23,09:00:00,30,24,6,FMN GV 05 Lier
60,Mechelsesteenweg 365,2021-12-23,10:00:00,66,32,34,FMN GV 05 Lier
60,Mechelsesteenweg 365,2021-12-23,11:00:00,50,32,18,FMN GV 05 Lier
60,Mechelsesteenweg 365,2021-12-23,12:00:00,92,32,60,FMN GV 05 Lier
60,Mechelsesteenweg 365,2021-12-23,13:00:00,100,52,48,FMN GV 05 Lier
60,Mechelsesteenweg 365,2021-12-23,14:00:00,104,68,36,FMN GV 05 Lier
60,Mechelsesteenweg 365,2021-12-23,15:00:00,70,44,26,FMN GV 05 Lier
60,Mechelsesteenweg 365,2021-12-23,16:00:00,32,20,12,FMN GV 05 Lier
60,Mechelsesteenweg 365,2021-12-23,17:00:00,26,14,12,FMN GV 05 Lier
60,Mechelsesteenweg 365,2021-12-23,18:00:00,12,4,8,FMN GV 05 Lier
60,Mechelsesteenweg 365,2021-12-23,19:00:00,6,0,6,FMN GV 05 Lier
60,Mechelsesteenweg 365,2021-12-23,20:00:00,6,2,4,FMN GV 05 Lier
60,Mechelsesteenweg 365,2021-12-23,21:00:00,10,0,10,FMN GV 05 Lier
60,Mechelsesteenweg 365,2021-12-23,22:00:00,4,2,2,FMN GV 05 Lier
60,Mechelsesteenweg 365,2021-12-23,23:00:00,0,0,0,FMN GV 05 Lier
60,Mechelsesteenweg 365,2021-12-24,00:00:00,6,4,2,FMN GV 05 Lier
60,Mechelsesteenweg 365,2021-12-24,01:00:00,2,2,0,FMN GV 05 Lier
60,Mechelsesteenweg 365,2021-12-24,02:00:00,4,0,4,FMN GV 05 Lier
60,Mechelsesteenweg 365,2021-12-24,03:00:00,2,0,2,FMN GV 05 Lier
60,Mechelsesteenweg 365,2021-12-24,04:00:00,0,0,0,FMN GV 05 Lier
60,Mechelsesteenweg 365,2021-12-24,05:00:00,0,0,0,FMN GV 05 Lier
60,Mechelsesteenweg 365,2021-12-24,06:00:00,10,6,4,FMN GV 05 Lier
60,Mechelsesteenweg 365,2021-12-24,07:00:00,40,22,18,FMN GV 05 Lier
60,Mechelsesteenweg 365,2021-12-24,08:00:00,40,32,8,FMN GV 05 Lier
60,Mechelsesteenweg 365,2021-12-24,09:00:00,68,46,22,FMN GV 05 Lier
60,Mechelsesteenweg 365,2021-12-24,10:00:00,50,12,38,FMN GV 05 Lier
60,Mechelsesteenweg 365,2021-12-24,11:00:00,80,30,50,FMN GV 05 Lier
60,Mechelsesteenweg 365,2021-12-24,12:00:00,80,40,40,FMN GV 05 Lier
60,Mechelsesteenweg 365,2021-12-24,13:00:00,84,42,42,FMN GV 05 Lier
60,Mechelsesteenweg 365,2021-12-24,14:00:00,70,34,36,FMN GV 05 Lier
60,Mechelsesteenweg 365,2021-12-24,15:00:00,54,26,28,FMN GV 05 Lier
60,Mechelsesteenweg 365,2021-12-24,16:00:00,46,24,22,FMN GV 05 Lier
60,Mechelsesteenweg 365,2021-12-24,17:00:00,12,6,6,FMN GV 05 Lier
60,Mechelsesteenweg 365,2021-12-24,18:00:00,4,2,2,FMN GV 05 Lier
60,Mechelsesteenweg 365,2021-12-24,19:00:00,0,0,0,FMN GV 05 Lier
60,Mechelsesteenweg 365,2021-12-24,20:00:00,0,0,0,FMN GV 05 Lier
60,Mechelsesteenweg 365,2021-12-24,21:00:00,2,0,2,FMN GV 05 Lier
60,Mechelsesteenweg 365,2021-12-24,22:00:00,4,2,2,FMN GV 05 Lier
60,Mechelsesteenweg 365,2021-12-24,23:00:00,0,0,0,FMN GV 05 Lier
60,Mechelsesteenweg 365,2021-12-25,00:00:00,0,0,0,FMN GV 05 Lier
60,Mechelsesteenweg 365,2021-12-25,01:00:00,2,2,0,FMN GV 05 Lier
60,Mechelsesteenweg 365,2021-12-25,02:00:00,0,0,0,FMN GV 05 Lier
60,Mechelsesteenweg 365,2021-12-25,03:00:00,0,0,0,FMN GV 05 Lier
60,Mechelsesteenweg 365,2021-12-25,04:00:00,0,0,0,FMN GV 05 Lier
60,Mechelsesteenweg 365,2021-12-25,05:00:00,0,0,0,FMN GV 05 Lier
60,Mechelsesteenweg 365,2021-12-25,06:00:00,0,0,0,FMN GV 05 Lier
60,Mechelsesteenweg 365,2021-12-25,07:00:00,2,2,0,FMN GV 05 Lier
60,Mechelsesteenweg 365,2021-12-25,08:00:00,6,4,2,FMN GV 05 Lier
60,Mechelsesteenweg 365,2021-12-25,09:00:00,4,2,2,FMN GV 05 Lier
60,Mechelsesteenweg 365,2021-12-25,10:00:00,32,18,14,FMN GV 05 Lier
60,Mechelsesteenweg 365,2021-12-25,11:00:00,8,6,2,FMN GV 05 Lier
60,Mechelsesteenweg 365,2021-12-25,12:00:00,6,4,2,FMN GV 05 Lier
60,Mechelsesteenweg 365,2021-12-25,13:00:00,26,10,16,FMN GV 05 Lier
60,Mechelsesteenweg 365,2021-12-25,14:00:00,30,12,18,FMN GV 05 Lier
60,Mechelsesteenweg 365,2021-12-25,15:00:00,32,14,18,FMN GV 05 Lier
60,Mechelsesteenweg 365,2021-12-25,16:00:00,14,6,8,FMN GV 05 Lier
60,Mechelsesteenweg 365,2021-12-25,17:00:00,4,4,0,FMN GV 05 Lier
60,Mechelsesteenweg 365,2021-12-25,18:00:00,4,4,0,FMN GV 05 Lier
60,Mechelsesteenweg 365,2021-12-25,19:00:00,0,0,0,FMN GV 05 Lier
60,Mechelsesteenweg 365,2021-12-25,20:00:00,0,0,0,FMN GV 05 Lier
60,Mechelsesteenweg 365,2021-12-25,21:00:00,4,4,0,FMN GV 05 Lier
60,Mechelsesteenweg 365,2021-12-25,22:00:00,0,0,0,FMN GV 05 Lier
60,Mechelsesteenweg 365,2021-12-25,23:00:00,6,6,0,FMN GV 05 Lier
60,Mechelsesteenweg 365,2021-12-26,00:00:00,0,0,0,FMN GV 05 Lier
60,Mechelsesteenweg 365,2021-12-26,01:00:00,0,0,0,FMN GV 05 Lier
60,Mechelsesteenweg 365,2021-12-26,02:00:00,0,0,0,FMN GV 05 Lier
60,Mechelsesteenweg 365,2021-12-26,03:00:00,0,0,0,FMN GV 05 Lier
60,Mechelsesteenweg 365,2021-12-26,04:00:00,0,0,0,FMN GV 05 Lier
60,Mechelsesteenweg 365,2021-12-26,05:00:00,2,0,2,FMN GV 05 Lier
60,Mechelsesteenweg 365,2021-12-26,06:00:00,0,0,0,FMN GV 05 Lier
60,Mechelsesteenweg 365,2021-12-26,07:00:00,0,0,0,FMN GV 05 Lier
60,Mechelsesteenweg 365,2021-12-26,08:00:00,8,4,4,FMN GV 05 Lier
60,Mechelsesteenweg 365,2021-12-26,09:00:00,36,30,6,FMN GV 05 Lier
60,Mechelsesteenweg 365,2021-12-26,10:00:00,82,58,24,FMN GV 05 Lier
60,Mechelsesteenweg 365,2021-12-26,11:00:00,106,48,58,FMN GV 05 Lier
60,Mechelsesteenweg 365,2021-12-26,12:00:00,100,40,60,FMN GV 05 Lier
60,Mechelsesteenweg 365,2021-12-26,13:00:00,84,44,40,FMN GV 05 Lier
60,Mechelsesteenweg 365,2021-12-26,14:00:00,108,50,58,FMN GV 05 Lier
60,Mechelsesteenweg 365,2021-12-26,15:00:00,62,26,36,FMN GV 05 Lier
60,Mechelsesteenweg 365,2021-12-26,16:00:00,10,4,6,FMN GV 05 Lier
60,Mechelsesteenweg 365,2021-12-26,17:00:00,12,6,6,FMN GV 05 Lier
60,Mechelsesteenweg 365,2021-12-26,18:00:00,0,0,0,FMN GV 05 Lier
60,Mechelsesteenweg 365,2021-12-26,19:00:00,0,0,0,FMN GV 05 Lier
60,Mechelsesteenweg 365,2021-12-26,20:00:00,4,2,2,FMN GV 05 Lier
60,Mechelsesteenweg 365,2021-12-26,21:00:00,4,2,2,FMN GV 05 Lier
60,Mechelsesteenweg 365,2021-12-26,22:00:00,0,0,0,FMN GV 05 Lier
60,Mechelsesteenweg 365,2021-12-26,23:00:00,0,0,0,FMN GV 05 Lier
60,Mechelsesteenweg 365,2021-12-27,00:00:00,0,0,0,FMN GV 05 Lier
60,Mechelsesteenweg 365,2021-12-27,01:00:00,0,0,0,FMN GV 05 Lier
60,Mechelsesteenweg 365,2021-12-27,02:00:00,0,0,0,FMN GV 05 Lier
60,Mechelsesteenweg 365,2021-12-27,03:00:00,0,0,0,FMN GV 05 Lier
60,Mechelsesteenweg 365,2021-12-27,04:00:00,2,0,2,FMN GV 05 Lier
60,Mechelsesteenweg 365,2021-12-27,05:00:00,0,0,0,FMN GV 05 Lier
60,Mechelsesteenweg 365,2021-12-27,06:00:00,12,8,4,FMN GV 05 Lier
60,Mechelsesteenweg 365,2021-12-27,07:00:00,12,8,4,FMN GV 05 Lier
60,Mechelsesteenweg 365,2021-12-27,08:00:00,12,2,10,FMN GV 05 Lier
60,Mechelsesteenweg 365,2021-12-27,09:00:00,32,12,20,FMN GV 05 Lier
60,Mechelsesteenweg 365,2021-12-27,10:00:00,96,40,56,FMN GV 05 Lier
60,Mechelsesteenweg 365,2021-12-27,11:00:00,104,50,54,FMN GV 05 Lier
60,Mechelsesteenweg 365,2021-12-27,12:00:00,84,54,30,FMN GV 05 Lier
60,Mechelsesteenweg 365,2021-12-27,13:00:00,82,48,34,FMN GV 05 Lier
60,Mechelsesteenweg 365,2021-12-27,14:00:00,56,30,26,FMN GV 05 Lier
60,Mechelsesteenweg 365,2021-12-27,15:00:00,70,38,32,FMN GV 05 Lier
60,Mechelsesteenweg 365,2021-12-27,16:00:00,46,14,32,FMN GV 05 Lier
60,Mechelsesteenweg 365,2021-12-27,17:00:00,26,16,10,FMN GV 05 Lier
60,Mechelsesteenweg 365,2021-12-27,18:00:00,6,4,2,FMN GV 05 Lier
60,Mechelsesteenweg 365,2021-12-27,19:00:00,4,2,2,FMN GV 05 Lier
60,Mechelsesteenweg 365,2021-12-27,20:00:00,2,0,2,FMN GV 05 Lier
60,Mechelsesteenweg 365,2021-12-27,21:00:00,6,2,4,FMN GV 05 Lier
60,Mechelsesteenweg 365,2021-12-27,22:00:00,2,0,2,FMN GV 05 Lier
60,Mechelsesteenweg 365,2021-12-27,23:00:00,6,6,0,FMN GV 05 Lier
60,Mechelsesteenweg 365,2021-12-28,00:00:00,2,0,2,FMN GV 05 Lier
60,Mechelsesteenweg 365,2021-12-28,01:00:00,2,2,0,FMN GV 05 Lier
60,Mechelsesteenweg 365,2021-12-28,02:00:00,0,0,0,FMN GV 05 Lier
60,Mechelsesteenweg 365,2021-12-28,03:00:00,0,0,0,FMN GV 05 Lier
60,Mechelsesteenweg 365,2021-12-28,04:00:00,2,0,2,FMN GV 05 Lier
60,Mechelsesteenweg 365,2021-12-28,05:00:00,4,0,4,FMN GV 05 Lier
60,Mechelsesteenweg 365,2021-12-28,06:00:00,8,6,2,FMN GV 05 Lier
60,Mechelsesteenweg 365,2021-12-28,07:00:00,10,0,10,FMN GV 05 Lier
60,Mechelsesteenweg 365,2021-12-28,08:00:00,22,10,12,FMN GV 05 Lier
60,Mechelsesteenweg 365,2021-12-28,09:00:00,12,4,8,FMN GV 05 Lier
60,Mechelsesteenweg 365,2021-12-28,10:00:00,28,20,8,FMN GV 05 Lier
60,Mechelsesteenweg 365,2021-12-28,11:00:00,42,18,24,FMN GV 05 Lier
60,Mechelsesteenweg 365,2021-12-28,12:00:00,32,14,18,FMN GV 05 Lier
60,Mechelsesteenweg 365,2021-12-28,13:00:00,24,12,12,FMN GV 05 Lier
60,Mechelsesteenweg 365,2021-12-28,14:00:00,12,6,6,FMN GV 05 Lier
60,Mechelsesteenweg 365,2021-12-28,15:00:00,10,6,4,FMN GV 05 Lier
60,Mechelsesteenweg 365,2021-12-28,16:00:00,14,8,6,FMN GV 05 Lier
60,Mechelsesteenweg 365,2021-12-28,17:00:00,12,8,4,FMN GV 05 Lier
60,Mechelsesteenweg 365,2021-12-28,18:00:00,2,2,0,FMN GV 05 Lier
60,Mechelsesteenweg 365,2021-12-28,19:00:00,8,4,4,FMN GV 05 Lier
60,Mechelsesteenweg 365,2021-12-28,20:00:00,4,0,4,FMN GV 05 Lier
60,Mechelsesteenweg 365,2021-12-28,21:00:00,2,0,2,FMN GV 05 Lier
60,Mechelsesteenweg 365,2021-12-28,22:00:00,4,2,2,FMN GV 05 Lier
60,Mechelsesteenweg 365,2021-12-28,23:00:00,2,2,0,FMN GV 05 Lier
60,Mechelsesteenweg 365,2021-12-29,00:00:00,2,2,0,FMN GV 05 Lier
60,Mechelsesteenweg 365,2021-12-29,01:00:00,0,0,0,FMN GV 05 Lier
60,Mechelsesteenweg 365,2021-12-29,02:00:00,0,0,0,FMN GV 05 Lier
60,Mechelsesteenweg 365,2021-12-29,03:00:00,0,0,0,FMN GV 05 Lier
60,Mechelsesteenweg 365,2021-12-29,04:00:00,2,0,2,FMN GV 05 Lier
60,Mechelsesteenweg 365,2021-12-29,05:00:00,2,0,2,FMN GV 05 Lier
60,Mechelsesteenweg 365,2021-12-29,06:00:00,8,4,4,FMN GV 05 Lier
60,Mechelsesteenweg 365,2021-12-29,07:00:00,10,4,6,FMN GV 05 Lier
60,Mechelsesteenweg 365,2021-12-29,08:00:00,12,6,6,FMN GV 05 Lier
60,Mechelsesteenweg 365,2021-12-29,09:00:00,40,16,24,FMN GV 05 Lier
60,Mechelsesteenweg 365,2021-12-29,10:00:00,52,22,30,FMN GV 05 Lier
60,Mechelsesteenweg 365,2021-12-29,11:00:00,30,16,14,FMN GV 05 Lier
60,Mechelsesteenweg 365,2021-12-29,12:00:00,56,28,28,FMN GV 05 Lier
60,Mechelsesteenweg 365,2021-12-29,13:00:00,42,30,12,FMN GV 05 Lier
60,Mechelsesteenweg 365,2021-12-29,14:00:00,52,20,32,FMN GV 05 Lier
60,Mechelsesteenweg 365,2021-12-29,15:00:00,22,12,10,FMN GV 05 Lier
60,Mechelsesteenweg 365,2021-12-29,16:00:00,36,18,18,FMN GV 05 Lier
60,Mechelsesteenweg 365,2021-12-29,17:00:00,18,6,12,FMN GV 05 Lier
60,Mechelsesteenweg 365,2021-12-29,18:00:00,14,4,10,FMN GV 05 Lier
60,Mechelsesteenweg 365,2021-12-29,19:00:00,10,6,4,FMN GV 05 Lier
60,Mechelsesteenweg 365,2021-12-29,20:00:00,2,0,2,FMN GV 05 Lier
60,Mechelsesteenweg 365,2021-12-29,21:00:00,8,4,4,FMN GV 05 Lier
60,Mechelsesteenweg 365,2021-12-29,22:00:00,2,2,0,FMN GV 05 Lier
60,Mechelsesteenweg 365,2021-12-29,23:00:00,0,0,0,FMN GV 05 Lier
60,Mechelsesteenweg 365,2021-12-30,00:00:00,0,0,0,FMN GV 05 Lier
60,Mechelsesteenweg 365,2021-12-30,01:00:00,0,0,0,FMN GV 05 Lier
60,Mechelsesteenweg 365,2021-12-30,02:00:00,0,0,0,FMN GV 05 Lier
60,Mechelsesteenweg 365,2021-12-30,03:00:00,0,0,0,FMN GV 05 Lier
60,Mechelsesteenweg 365,2021-12-30,04:00:00,0,0,0,FMN GV 05 Lier
60,Mechelsesteenweg 365,2021-12-30,05:00:00,0,0,0,FMN GV 05 Lier
60,Mechelsesteenweg 365,2021-12-30,06:00:00,6,2,4,FMN GV 05 Lier
60,Mechelsesteenweg 365,2021-12-30,07:00:00,12,4,8,FMN GV 05 Lier
60,Mechelsesteenweg 365,2021-12-30,08:00:00,16,6,10,FMN GV 05 Lier
60,Mechelsesteenweg 365,2021-12-30,09:00:00,52,30,22,FMN GV 05 Lier
60,Mechelsesteenweg 365,2021-12-30,10:00:00,72,32,40,FMN GV 05 Lier
60,Mechelsesteenweg 365,2021-12-30,11:00:00,78,46,32,FMN GV 05 Lier
60,Mechelsesteenweg 365,2021-12-30,12:00:00,62,38,24,FMN GV 05 Lier
60,Mechelsesteenweg 365,2021-12-30,13:00:00,102,66,36,FMN GV 05 Lier
60,Mechelsesteenweg 365,2021-12-30,14:00:00,102,52,50,FMN GV 05 Lier
60,Mechelsesteenweg 365,2021-12-30,15:00:00,88,58,30,FMN GV 05 Lier
60,Mechelsesteenweg 365,2021-12-30,16:00:00,50,26,24,FMN GV 05 Lier
60,Mechelsesteenweg 365,2021-12-30,17:00:00,28,14,14,FMN GV 05 Lier
60,Mechelsesteenweg 365,2021-12-30,18:00:00,6,4,2,FMN GV 05 Lier
60,Mechelsesteenweg 365,2021-12-30,19:00:00,12,12,0,FMN GV 05 Lier
60,Mechelsesteenweg 365,2021-12-30,20:00:00,4,2,2,FMN GV 05 Lier
60,Mechelsesteenweg 365,2021-12-30,21:00:00,4,0,4,FMN GV 05 Lier
60,Mechelsesteenweg 365,2021-12-30,22:00:00,4,2,2,FMN GV 05 Lier
60,Mechelsesteenweg 365,2021-12-30,23:00:00,8,8,0,FMN GV 05 Lier
60,Mechelsesteenweg 365,2021-12-31,00:00:00,2,0,2,FMN GV 05 Lier
60,Mechelsesteenweg 365,2021-12-31,01:00:00,0,0,0,FMN GV 05 Lier
60,Mechelsesteenweg 365,2021-12-31,02:00:00,0,0,0,FMN GV 05 Lier
60,Mechelsesteenweg 365,2021-12-31,03:00:00,2,0,2,FMN GV 05 Lier
60,Mechelsesteenweg 365,2021-12-31,04:00:00,2,0,2,FMN GV 05 Lier
60,Mechelsesteenweg 365,2021-12-31,05:00:00,0,0,0,FMN GV 05 Lier
60,Mechelsesteenweg 365,2021-12-31,06:00:00,6,4,2,FMN GV 05 Lier
60,Mechelsesteenweg 365,2021-12-31,07:00:00,8,2,6,FMN GV 05 Lier
60,Mechelsesteenweg 365,2021-12-31,08:00:00,14,6,8,FMN GV 05 Lier
60,Mechelsesteenweg 365,2021-12-31,09:00:00,42,16,26,FMN GV 05 Lier
60,Mechelsesteenweg 365,2021-12-31,10:00:00,122,56,66,FMN GV 05 Lier
60,Mechelsesteenweg 365,2021-12-31,11:00:00,200,140,60,FMN GV 05 Lier
60,Mechelsesteenweg 365,2021-12-31,12:00:00,122,70,52,FMN GV 05 Lier
60,Mechelsesteenweg 365,2021-12-31,13:00:00,144,84,60,FMN GV 05 Lier
60,Mechelsesteenweg 365,2021-12-31,14:00:00,214,106,108,FMN GV 05 Lier
60,Mechelsesteenweg 365,2021-12-31,15:00:00,112,44,68,FMN GV 05 Lier
60,Mechelsesteenweg 365,2021-12-31,16:00:00,52,26,26,FMN GV 05 Lier
60,Mechelsesteenweg 365,2021-12-31,17:00:00,20,12,8,FMN GV 05 Lier
60,Mechelsesteenweg 365,2021-12-31,18:00:00,14,6,8,FMN GV 05 Lier
60,Mechelsesteenweg 365,2021-12-31,19:00:00,2,2,0,FMN GV 05 Lier
60,Mechelsesteenweg 365,2021-12-31,20:00:00,6,2,4,FMN GV 05 Lier
60,Mechelsesteenweg 365,2021-12-31,21:00:00,0,0,0,FMN GV 05 Lier
60,Mechelsesteenweg 365,2021-12-31,22:00:00,2,2,0,FMN GV 05 Lier
60,Mechelsesteenweg 365,2021-12-31,23:00:00,2,0,2,FMN GV 05 Lier
60,Mechelsesteenweg 365,2022-01-01,00:00:00,0,0,0,FMN GV 05 Lier
60,Mechelsesteenweg 365,2022-01-01,01:00:00,2,0,2,FMN GV 05 Lier
60,Mechelsesteenweg 365,2022-01-01,02:00:00,4,2,2,FMN GV 05 Lier
60,Mechelsesteenweg 365,2022-01-01,03:00:00,8,6,2,FMN GV 05 Lier
60,Mechelsesteenweg 365,2022-01-01,04:00:00,4,4,0,FMN GV 05 Lier
60,Mechelsesteenweg 365,2022-01-01,05:00:00,2,2,0,FMN GV 05 Lier
60,Mechelsesteenweg 365,2022-01-01,06:00:00,4,4,0,FMN GV 05 Lier
60,Mechelsesteenweg 365,2022-01-01,07:00:00,2,0,2,FMN GV 05 Lier
60,Mechelsesteenweg 365,2022-01-01,08:00:00,4,2,2,FMN GV 05 Lier
60,Mechelsesteenweg 365,2022-01-01,09:00:00,36,20,16,FMN GV 05 Lier
60,Mechelsesteenweg 365,2022-01-01,10:00:00,100,64,36,FMN GV 05 Lier
60,Mechelsesteenweg 365,2022-01-01,11:00:00,182,108,74,FMN GV 05 Lier
60,Mechelsesteenweg 365,2022-01-01,12:00:00,180,82,98,FMN GV 05 Lier
60,Mechelsesteenweg 365,2022-01-01,13:00:00,252,144,108,FMN GV 05 Lier
60,Mechelsesteenweg 365,2022-01-01,14:00:00,342,170,172,FMN GV 05 Lier
60,Mechelsesteenweg 365,2022-01-01,15:00:00,218,84,134,FMN GV 05 Lier
60,Mechelsesteenweg 365,2022-01-01,16:00:00,118,36,82,FMN GV 05 Lier
60,Mechelsesteenweg 365,2022-01-01,17:00:00,26,10,16,FMN GV 05 Lier
60,Mechelsesteenweg 365,2022-01-01,18:00:00,10,6,4,FMN GV 05 Lier
60,Mechelsesteenweg 365,2022-01-01,19:00:00,6,6,0,FMN GV 05 Lier
60,Mechelsesteenweg 365,2022-01-01,20:00:00,0,0,0,FMN GV 05 Lier
60,Mechelsesteenweg 365,2022-01-01,21:00:00,0,0,0,FMN GV 05 Lier
60,Mechelsesteenweg 365,2022-01-01,22:00:00,2,0,2,FMN GV 05 Lier
60,Mechelsesteenweg 365,2022-01-01,23:00:00,0,0,0,FMN GV 05 Lier
60,Mechelsesteenweg 365,2022-01-02,00:00:00,2,0,2,FMN GV 05 Lier
60,Mechelsesteenweg 365,2022-01-02,01:00:00,0,0,0,FMN GV 05 Lier
60,Mechelsesteenweg 365,2022-01-02,02:00:00,0,0,0,FMN GV 05 Lier
60,Mechelsesteenweg 365,2022-01-02,03:00:00,0,0,0,FMN GV 05 Lier
60,Mechelsesteenweg 365,2022-01-02,04:00:00,0,0,0,FMN GV 05 Lier
60,Mechelsesteenweg 365,2022-01-02,05:00:00,0,0,0,FMN GV 05 Lier
60,Mechelsesteenweg 365,2022-01-02,06:00:00,2,2,0,FMN GV 05 Lier
60,Mechelsesteenweg 365,2022-01-02,07:00:00,2,2,0,FMN GV 05 Lier
60,Mechelsesteenweg 365,2022-01-02,08:00:00,2,2,0,FMN GV 05 Lier
60,Mechelsesteenweg 365,2022-01-02,09:00:00,74,40,34,FMN GV 05 Lier
60,Mechelsesteenweg 365,2022-01-02,10:00:00,122,64,58,FMN GV 05 Lier
60,Mechelsesteenweg 365,2022-01-02,11:00:00,204,118,86,FMN GV 05 Lier
60,Mechelsesteenweg 365,2022-01-02,12:00:00,178,108,70,FMN GV 05 Lier
60,Mechelsesteenweg 365,2022-01-02,13:00:00,114,60,54,FMN GV 05 Lier
60,Mechelsesteenweg 365,2022-01-02,14:00:00,112,76,36,FMN GV 05 Lier
60,Mechelsesteenweg 365,2022-01-02,15:00:00,96,36,60,FMN GV 05 Lier
60,Mechelsesteenweg 365,2022-01-02,16:00:00,32,10,22,FMN GV 05 Lier
60,Mechelsesteenweg 365,2022-01-02,17:00:00,8,4,4,FMN GV 05 Lier
60,Mechelsesteenweg 365,2022-01-02,18:00:00,6,4,2,FMN GV 05 Lier
60,Mechelsesteenweg 365,2022-01-02,19:00:00,0,0,0,FMN GV 05 Lier
60,Mechelsesteenweg 365,2022-01-02,20:00:00,2,0,2,FMN GV 05 Lier
60,Mechelsesteenweg 365,2022-01-02,21:00:00,8,2,6,FMN GV 05 Lier
60,Mechelsesteenweg 365,2022-01-02,22:00:00,0,0,0,FMN GV 05 Lier
60,Mechelsesteenweg 365,2022-01-02,23:00:00,0,0,0,FMN GV 05 Lier
60,Mechelsesteenweg 365,2022-01-03,00:00:00,0,0,0,FMN GV 05 Lier
60,Mechelsesteenweg 365,2022-01-03,01:00:00,0,0,0,FMN GV 05 Lier
60,Mechelsesteenweg 365,2022-01-03,02:00:00,0,0,0,FMN GV 05 Lier
60,Mechelsesteenweg 365,2022-01-03,03:00:00,2,0,2,FMN GV 05 Lier
60,Mechelsesteenweg 365,2022-01-03,04:00:00,0,0,0,FMN GV 05 Lier
60,Mechelsesteenweg 365,2022-01-03,05:00:00,0,0,0,FMN GV 05 Lier
60,Mechelsesteenweg 365,2022-01-03,06:00:00,10,2,8,FMN GV 05 Lier
60,Mechelsesteenweg 365,2022-01-03,07:00:00,30,14,16,FMN GV 05 Lier
60,Mechelsesteenweg 365,2022-01-03,08:00:00,36,8,28,FMN GV 05 Lier
60,Mechelsesteenweg 365,2022-01-03,09:00:00,38,24,14,FMN GV 05 Lier
60,Mechelsesteenweg 365,2022-01-03,10:00:00,66,40,26,FMN GV 05 Lier
60,Mechelsesteenweg 365,2022-01-03,11:00:00,38,18,20,FMN GV 05 Lier
60,Mechelsesteenweg 365,2022-01-03,12:00:00,34,18,16,FMN GV 05 Lier
60,Mechelsesteenweg 365,2022-01-03,13:00:00,32,22,10,FMN GV 05 Lier
60,Mechelsesteenweg 365,2022-01-03,14:00:00,24,16,8,FMN GV 05 Lier
60,Mechelsesteenweg 365,2022-01-03,15:00:00,22,8,14,FMN GV 05 Lier
60,Mechelsesteenweg 365,2022-01-03,16:00:00,40,28,12,FMN GV 05 Lier
60,Mechelsesteenweg 365,2022-01-03,17:00:00,36,28,8,FMN GV 05 Lier
60,Mechelsesteenweg 365,2022-01-03,18:00:00,8,8,0,FMN GV 05 Lier
60,Mechelsesteenweg 365,2022-01-03,19:00:00,6,2,4,FMN GV 05 Lier
60,Mechelsesteenweg 365,2022-01-03,20:00:00,8,2,6,FMN GV 05 Lier
60,Mechelsesteenweg 365,2022-01-03,21:00:00,4,2,2,FMN GV 05 Lier
60,Mechelsesteenweg 365,2022-01-03,22:00:00,4,4,0,FMN GV 05 Lier
60,Mechelsesteenweg 365,2022-01-03,23:00:00,2,2,0,FMN GV 05 Lier
60,Mechelsesteenweg 365,2022-01-04,00:00:00,0,0,0,FMN GV 05 Lier
60,Mechelsesteenweg 365,2022-01-04,01:00:00,0,0,0,FMN GV 05 Lier
60,Mechelsesteenweg 365,2022-01-04,02:00:00,0,0,0,FMN GV 05 Lier
60,Mechelsesteenweg 365,2022-01-04,03:00:00,0,0,0,FMN GV 05 Lier
60,Mechelsesteenweg 365,2022-01-04,04:00:00,2,0,2,FMN GV 05 Lier
60,Mechelsesteenweg 365,2022-01-04,05:00:00,0,0,0,FMN GV 05 Lier
60,Mechelsesteenweg 365,2022-01-04,06:00:00,8,2,6,FMN GV 05 Lier
60,Mechelsesteenweg 365,2022-01-04,07:00:00,28,12,16,FMN GV 05 Lier
60,Mechelsesteenweg 365,2022-01-04,08:00:00,38,10,28,FMN GV 05 Lier
60,Mechelsesteenweg 365,2022-01-04,09:00:00,38,22,16,FMN GV 05 Lier
60,Mechelsesteenweg 365,2022-01-04,10:00:00,34,14,20,FMN GV 05 Lier
60,Mechelsesteenweg 365,2022-01-04,11:00:00,62,32,30,FMN GV 05 Lier
60,Mechelsesteenweg 365,2022-01-04,12:00:00,38,6,32,FMN GV 05 Lier
60,Mechelsesteenweg 365,2022-01-04,13:00:00,32,18,14,FMN GV 05 Lier
60,Mechelsesteenweg 365,2022-01-04,14:00:00,18,10,8,FMN GV 05 Lier
60,Mechelsesteenweg 365,2022-01-04,15:00:00,16,8,8,FMN GV 05 Lier
60,Mechelsesteenweg 365,2022-01-04,16:00:00,30,26,4,FMN GV 05 Lier
60,Mechelsesteenweg 365,2022-01-04,17:00:00,28,22,6,FMN GV 05 Lier
60,Mechelsesteenweg 365,2022-01-04,18:00:00,4,2,2,FMN GV 05 Lier
60,Mechelsesteenweg 365,2022-01-04,19:00:00,2,0,2,FMN GV 05 Lier
60,Mechelsesteenweg 365,2022-01-04,20:00:00,2,0,2,FMN GV 05 Lier
60,Mechelsesteenweg 365,2022-01-04,21:00:00,4,0,4,FMN GV 05 Lier
60,Mechelsesteenweg 365,2022-01-04,22:00:00,4,4,0,FMN GV 05 Lier
60,Mechelsesteenweg 365,2022-01-04,23:00:00,0,0,0,FMN GV 05 Lier
60,Mechelsesteenweg 365,2022-01-05,00:00:00,0,0,0,FMN GV 05 Lier
60,Mechelsesteenweg 365,2022-01-05,01:00:00,0,0,0,FMN GV 05 Lier
60,Mechelsesteenweg 365,2022-01-05,02:00:00,0,0,0,FMN GV 05 Lier
60,Mechelsesteenweg 365,2022-01-05,03:00:00,0,0,0,FMN GV 05 Lier
60,Mechelsesteenweg 365,2022-01-05,04:00:00,0,0,0,FMN GV 05 Lier
60,Mechelsesteenweg 365,2022-01-05,05:00:00,6,0,6,FMN GV 05 Lier
60,Mechelsesteenweg 365,2022-01-05,06:00:00,12,4,8,FMN GV 05 Lier
60,Mechelsesteenweg 365,2022-01-05,07:00:00,32,14,18,FMN GV 05 Lier
60,Mechelsesteenweg 365,2022-01-05,08:00:00,30,10,20,FMN GV 05 Lier
60,Mechelsesteenweg 365,2022-01-05,09:00:00,22,8,14,FMN GV 05 Lier
60,Mechelsesteenweg 365,2022-01-05,10:00:00,48,30,18,FMN GV 05 Lier
60,Mechelsesteenweg 365,2022-01-05,11:00:00,36,18,18,FMN GV 05 Lier
60,Mechelsesteenweg 365,2022-01-05,12:00:00,50,40,10,FMN GV 05 Lier
60,Mechelsesteenweg 365,2022-01-05,13:00:00,32,22,10,FMN GV 05 Lier
60,Mechelsesteenweg 365,2022-01-05,14:00:00,88,46,42,FMN GV 05 Lier
60,Mechelsesteenweg 365,2022-01-05,15:00:00,80,46,34,FMN GV 05 Lier
60,Mechelsesteenweg 365,2022-01-05,16:00:00,52,26,26,FMN GV 05 Lier
60,Mechelsesteenweg 365,2022-01-05,17:00:00,40,24,16,FMN GV 05 Lier
60,Mechelsesteenweg 365,2022-01-05,18:00:00,22,14,8,FMN GV 05 Lier
60,Mechelsesteenweg 365,2022-01-05,19:00:00,14,10,4,FMN GV 05 Lier
60,Mechelsesteenweg 365,2022-01-05,20:00:00,2,0,2,FMN GV 05 Lier
60,Mechelsesteenweg 365,2022-01-05,21:00:00,0,0,0,FMN GV 05 Lier
60,Mechelsesteenweg 365,2022-01-05,22:00:00,6,2,4,FMN GV 05 Lier
60,Mechelsesteenweg 365,2022-01-05,23:00:00,0,0,0,FMN GV 05 Lier
60,Mechelsesteenweg 365,2022-01-06,00:00:00,2,2,0,FMN GV 05 Lier
60,Mechelsesteenweg 365,2022-01-06,01:00:00,0,0,0,FMN GV 05 Lier
60,Mechelsesteenweg 365,2022-01-06,02:00:00,0,0,0,FMN GV 05 Lier
60,Mechelsesteenweg 365,2022-01-06,03:00:00,2,0,2,FMN GV 05 Lier
60,Mechelsesteenweg 365,2022-01-06,04:00:00,2,0,2,FMN GV 05 Lier
60,Mechelsesteenweg 365,2022-01-06,05:00:00,4,0,4,FMN GV 05 Lier
60,Mechelsesteenweg 365,2022-01-06,06:00:00,10,4,6,FMN GV 05 Lier
60,Mechelsesteenweg 365,2022-01-06,07:00:00,18,8,10,FMN GV 05 Lier
60,Mechelsesteenweg 365,2022-01-06,08:00:00,38,16,22,FMN GV 05 Lier
60,Mechelsesteenweg 365,2022-01-06,09:00:00,34,26,8,FMN GV 05 Lier
60,Mechelsesteenweg 365,2022-01-06,10:00:00,60,32,28,FMN GV 05 Lier
60,Mechelsesteenweg 365,2022-01-06,11:00:00,70,46,24,FMN GV 05 Lier
60,Mechelsesteenweg 365,2022-01-06,12:00:00,108,36,72,FMN GV 05 Lier
60,Mechelsesteenweg 365,2022-01-06,13:00:00,186,108,78,FMN GV 05 Lier
60,Mechelsesteenweg 365,2022-01-06,14:00:00,216,112,104,FMN GV 05 Lier
60,Mechelsesteenweg 365,2022-01-06,15:00:00,146,66,80,FMN GV 05 Lier
60,Mechelsesteenweg 365,2022-01-06,16:00:00,88,48,40,FMN GV 05 Lier
60,Mechelsesteenweg 365,2022-01-06,17:00:00,50,28,22,FMN GV 05 Lier
60,Mechelsesteenweg 365,2022-01-06,18:00:00,34,24,10,FMN GV 05 Lier
60,Mechelsesteenweg 365,2022-01-06,19:00:00,12,8,4,FMN GV 05 Lier
60,Mechelsesteenweg 365,2022-01-06,20:00:00,8,2,6,FMN GV 05 Lier
60,Mechelsesteenweg 365,2022-01-06,21:00:00,10,0,10,FMN GV 05 Lier
60,Mechelsesteenweg 365,2022-01-06,22:00:00,0,0,0,FMN GV 05 Lier
60,Mechelsesteenweg 365,2022-01-06,23:00:00,0,0,0,FMN GV 05 Lier
60,Mechelsesteenweg 365,2022-01-07,00:00:00,0,0,0,FMN GV 05 Lier
60,Mechelsesteenweg 365,2022-01-07,01:00:00,0,0,0,FMN GV 05 Lier
60,Mechelsesteenweg 365,2022-01-07,02:00:00,4,4,0,FMN GV 05 Lier
60,Mechelsesteenweg 365,2022-01-07,03:00:00,2,0,2,FMN GV 05 Lier
60,Mechelsesteenweg 365,2022-01-07,04:00:00,0,0,0,FMN GV 05 Lier
60,Mechelsesteenweg 365,2022-01-07,05:00:00,2,0,2,FMN GV 05 Lier
60,Mechelsesteenweg 365,2022-01-07,06:00:00,6,2,4,FMN GV 05 Lier
60,Mechelsesteenweg 365,2022-01-07,07:00:00,20,12,8,FMN GV 05 Lier
60,Mechelsesteenweg 365,2022-01-07,08:00:00,22,8,14,FMN GV 05 Lier
60,Mechelsesteenweg 365,2022-01-07,09:00:00,14,4,10,FMN GV 05 Lier
60,Mechelsesteenweg 365,2022-01-07,10:00:00,54,26,28,FMN GV 05 Lier
60,Mechelsesteenweg 365,2022-01-07,11:00:00,56,34,22,FMN GV 05 Lier
60,Mechelsesteenweg 365,2022-01-07,12:00:00,38,20,18,FMN GV 05 Lier
60,Mechelsesteenweg 365,2022-01-07,13:00:00,48,36,12,FMN GV 05 Lier
60,Mechelsesteenweg 365,2022-01-07,14:00:00,48,28,20,FMN GV 05 Lier
60,Mechelsesteenweg 365,2022-01-07,15:00:00,78,42,36,FMN GV 05 Lier
60,Mechelsesteenweg 365,2022-01-07,16:00:00,54,20,34,FMN GV 05 Lier
60,Mechelsesteenweg 365,2022-01-07,17:00:00,30,20,10,FMN GV 05 Lier
60,Mechelsesteenweg 365,2022-01-07,18:00:00,12,8,4,FMN GV 05 Lier
60,Mechelsesteenweg 365,2022-01-07,19:00:00,0,0,0,FMN GV 05 Lier
60,Mechelsesteenweg 365,2022-01-07,20:00:00,10,4,6,FMN GV 05 Lier
60,Mechelsesteenweg 365,2022-01-07,21:00:00,2,0,2,FMN GV 05 Lier
60,Mechelsesteenweg 365,2022-01-07,22:00:00,0,0,0,FMN GV 05 Lier
60,Mechelsesteenweg 365,2022-01-07,23:00:00,0,0,0,FMN GV 05 Lier
60,Mechelsesteenweg 365,2022-01-08,00:00:00,0,0,0,FMN GV 05 Lier
60,Mechelsesteenweg 365,2022-01-08,01:00:00,0,0,0,FMN GV 05 Lier
60,Mechelsesteenweg 365,2022-01-08,02:00:00,0,0,0,FMN GV 05 Lier
60,Mechelsesteenweg 365,2022-01-08,03:00:00,0,0,0,FMN GV 05 Lier
60,Mechelsesteenweg 365,2022-01-08,04:00:00,0,0,0,FMN GV 05 Lier
60,Mechelsesteenweg 365,2022-01-08,05:00:00,0,0,0,FMN GV 05 Lier
60,Mechelsesteenweg 365,2022-01-08,06:00:00,2,2,0,FMN GV 05 Lier
60,Mechelsesteenweg 365,2022-01-08,07:00:00,2,0,2,FMN GV 05 Lier
60,Mechelsesteenweg 365,2022-01-08,08:00:00,10,4,6,FMN GV 05 Lier
60,Mechelsesteenweg 365,2022-01-08,09:00:00,38,20,18,FMN GV 05 Lier
60,Mechelsesteenweg 365,2022-01-08,10:00:00,58,34,24,FMN GV 05 Lier
60,Mechelsesteenweg 365,2022-01-08,11:00:00,100,50,50,FMN GV 05 Lier
60,Mechelsesteenweg 365,2022-01-08,12:00:00,34,14,20,FMN GV 05 Lier
60,Mechelsesteenweg 365,2022-01-08,13:00:00,10,6,4,FMN GV 05 Lier
60,Mechelsesteenweg 365,2022-01-08,14:00:00,4,2,2,FMN GV 05 Lier
60,Mechelsesteenweg 365,2022-01-08,15:00:00,12,6,6,FMN GV 05 Lier
60,Mechelsesteenweg 365,2022-01-08,16:00:00,6,0,6,FMN GV 05 Lier
60,Mechelsesteenweg 365,2022-01-08,17:00:00,4,2,2,FMN GV 05 Lier
60,Mechelsesteenweg 365,2022-01-08,18:00:00,4,4,0,FMN GV 05 Lier
60,Mechelsesteenweg 365,2022-01-08,19:00:00,0,0,0,FMN GV 05 Lier
60,Mechelsesteenweg 365,2022-01-08,20:00:00,0,0,0,FMN GV 05 Lier
60,Mechelsesteenweg 365,2022-01-08,21:00:00,2,0,2,FMN GV 05 Lier
60,Mechelsesteenweg 365,2022-01-08,22:00:00,0,0,0,FMN GV 05 Lier
60,Mechelsesteenweg 365,2022-01-08,23:00:00,2,0,2,FMN GV 05 Lier
60,Mechelsesteenweg 365,2022-01-09,00:00:00,0,0,0,FMN GV 05 Lier
60,Mechelsesteenweg 365,2022-01-09,01:00:00,0,0,0,FMN GV 05 Lier
60,Mechelsesteenweg 365,2022-01-09,02:00:00,0,0,0,FMN GV 05 Lier
60,Mechelsesteenweg 365,2022-01-09,03:00:00,0,0,0,FMN GV 05 Lier
60,Mechelsesteenweg 365,2022-01-09,04:00:00,0,0,0,FMN GV 05 Lier
60,Mechelsesteenweg 365,2022-01-09,05:00:00,0,0,0,FMN GV 05 Lier
60,Mechelsesteenweg 365,2022-01-09,06:00:00,0,0,0,FMN GV 05 Lier
60,Mechelsesteenweg 365,2022-01-09,07:00:00,2,0,2,FMN GV 05 Lier
60,Mechelsesteenweg 365,2022-01-09,08:00:00,4,2,2,FMN GV 05 Lier
60,Mechelsesteenweg 365,2022-01-09,09:00:00,48,30,18,FMN GV 05 Lier
60,Mechelsesteenweg 365,2022-01-09,10:00:00,144,70,74,FMN GV 05 Lier
60,Mechelsesteenweg 365,2022-01-09,11:00:00,168,106,62,FMN GV 05 Lier
60,Mechelsesteenweg 365,2022-01-09,12:00:00,102,50,52,FMN GV 05 Lier
60,Mechelsesteenweg 365,2022-01-09,13:00:00,120,64,56,FMN GV 05 Lier
60,Mechelsesteenweg 365,2022-01-09,14:00:00,100,44,56,FMN GV 05 Lier
60,Mechelsesteenweg 365,2022-01-09,15:00:00,116,48,68,FMN GV 05 Lier
60,Mechelsesteenweg 365,2022-01-09,16:00:00,38,22,16,FMN GV 05 Lier
60,Mechelsesteenweg 365,2022-01-09,17:00:00,22,6,16,FMN GV 05 Lier
60,Mechelsesteenweg 365,2022-01-09,18:00:00,0,0,0,FMN GV 05 Lier
60,Mechelsesteenweg 365,2022-01-09,19:00:00,2,0,2,FMN GV 05 Lier
60,Mechelsesteenweg 365,2022-01-09,20:00:00,2,0,2,FMN GV 05 Lier
60,Mechelsesteenweg 365,2022-01-09,21:00:00,2,0,2,FMN GV 05 Lier
60,Mechelsesteenweg 365,2022-01-09,22:00:00,0,0,0,FMN GV 05 Lier
60,Mechelsesteenweg 365,2022-01-09,23:00:00,0,0,0,FMN GV 05 Lier
60,Mechelsesteenweg 365,2022-01-10,00:00:00,0,0,0,FMN GV 05 Lier
60,Mechelsesteenweg 365,2022-01-10,01:00:00,0,0,0,FMN GV 05 Lier
60,Mechelsesteenweg 365,2022-01-10,02:00:00,0,0,0,FMN GV 05 Lier
60,Mechelsesteenweg 365,2022-01-10,03:00:00,0,0,0,FMN GV 05 Lier
60,Mechelsesteenweg 365,2022-01-10,04:00:00,0,0,0,FMN GV 05 Lier
60,Mechelsesteenweg 365,2022-01-10,05:00:00,2,2,0,FMN GV 05 Lier
60,Mechelsesteenweg 365,2022-01-10,06:00:00,20,12,8,FMN GV 05 Lier
60,Mechelsesteenweg 365,2022-01-10,07:00:00,66,42,24,FMN GV 05 Lier
60,Mechelsesteenweg 365,2022-01-10,08:00:00,68,38,30,FMN GV 05 Lier
60,Mechelsesteenweg 365,2022-01-10,09:00:00,16,6,10,FMN GV 05 Lier
60,Mechelsesteenweg 365,2022-01-10,10:00:00,32,14,18,FMN GV 05 Lier
60,Mechelsesteenweg 365,2022-01-10,11:00:00,38,24,14,FMN GV 05 Lier
60,Mechelsesteenweg 365,2022-01-10,12:00:00,44,24,20,FMN GV 05 Lier
60,Mechelsesteenweg 365,2022-01-10,13:00:00,48,26,22,FMN GV 05 Lier
60,Mechelsesteenweg 365,2022-01-10,14:00:00,60,38,22,FMN GV 05 Lier
60,Mechelsesteenweg 365,2022-01-10,15:00:00,80,40,40,FMN GV 05 Lier
60,Mechelsesteenweg 365,2022-01-10,16:00:00,208,78,130,FMN GV 05 Lier
60,Mechelsesteenweg 365,2022-01-10,17:00:00,56,36,20,FMN GV 05 Lier
60,Mechelsesteenweg 365,2022-01-10,18:00:00,18,14,4,FMN GV 05 Lier
60,Mechelsesteenweg 365,2022-01-10,19:00:00,2,2,0,FMN GV 05 Lier
60,Mechelsesteenweg 365,2022-01-10,20:00:00,4,4,0,FMN GV 05 Lier
60,Mechelsesteenweg 365,2022-01-10,21:00:00,8,0,8,FMN GV 05 Lier
60,Mechelsesteenweg 365,2022-01-10,22:00:00,0,0,0,FMN GV 05 Lier
60,Mechelsesteenweg 365,2022-01-10,23:00:00,0,0,0,FMN GV 05 Lier
60,Mechelsesteenweg 365,2022-01-11,00:00:00,4,2,2,FMN GV 05 Lier
60,Mechelsesteenweg 365,2022-01-11,01:00:00,0,0,0,FMN GV 05 Lier
60,Mechelsesteenweg 365,2022-01-11,02:00:00,0,0,0,FMN GV 05 Lier
60,Mechelsesteenweg 365,2022-01-11,03:00:00,0,0,0,FMN GV 05 Lier
60,Mechelsesteenweg 365,2022-01-11,04:00:00,0,0,0,FMN GV 05 Lier
60,Mechelsesteenweg 365,2022-01-11,05:00:00,2,0,2,FMN GV 05 Lier
60,Mechelsesteenweg 365,2022-01-11,06:00:00,14,4,10,FMN GV 05 Lier
60,Mechelsesteenweg 365,2022-01-11,07:00:00,70,38,32,FMN GV 05 Lier
60,Mechelsesteenweg 365,2022-01-11,08:00:00,96,72,24,FMN GV 05 Lier
60,Mechelsesteenweg 365,2022-01-11,09:00:00,32,16,16,FMN GV 05 Lier
60,Mechelsesteenweg 365,2022-01-11,10:00:00,42,20,22,FMN GV 05 Lier
60,Mechelsesteenweg 365,2022-01-11,11:00:00,40,18,22,FMN GV 05 Lier
60,Mechelsesteenweg 365,2022-01-11,12:00:00,154,118,36,FMN GV 05 Lier
60,Mechelsesteenweg 365,2022-01-11,13:00:00,138,72,66,FMN GV 05 Lier
60,Mechelsesteenweg 365,2022-01-11,14:00:00,234,104,130,FMN GV 05 Lier
60,Mechelsesteenweg 365,2022-01-11,15:00:00,188,52,136,FMN GV 05 Lier
60,Mechelsesteenweg 365,2022-01-11,16:00:00,246,72,174,FMN GV 05 Lier
60,Mechelsesteenweg 365,2022-01-11,17:00:00,80,50,30,FMN GV 05 Lier
60,Mechelsesteenweg 365,2022-01-11,18:00:00,12,10,2,FMN GV 05 Lier
60,Mechelsesteenweg 365,2022-01-11,19:00:00,12,6,6,FMN GV 05 Lier
60,Mechelsesteenweg 365,2022-01-11,20:00:00,2,0,2,FMN GV 05 Lier
60,Mechelsesteenweg 365,2022-01-11,21:00:00,8,0,8,FMN GV 05 Lier
60,Mechelsesteenweg 365,2022-01-11,22:00:00,0,0,0,FMN GV 05 Lier
60,Mechelsesteenweg 365,2022-01-11,23:00:00,0,0,0,FMN GV 05 Lier
60,Mechelsesteenweg 365,2022-01-12,00:00:00,2,2,0,FMN GV 05 Lier
60,Mechelsesteenweg 365,2022-01-12,01:00:00,0,0,0,FMN GV 05 Lier
60,Mechelsesteenweg 365,2022-01-12,02:00:00,2,2,0,FMN GV 05 Lier
60,Mechelsesteenweg 365,2022-01-12,03:00:00,0,0,0,FMN GV 05 Lier
60,Mechelsesteenweg 365,2022-01-12,04:00:00,0,0,0,FMN GV 05 Lier
60,Mechelsesteenweg 365,2022-01-12,05:00:00,4,0,4,FMN GV 05 Lier
60,Mechelsesteenweg 365,2022-01-12,06:00:00,12,4,8,FMN GV 05 Lier
60,Mechelsesteenweg 365,2022-01-12,07:00:00,104,64,40,FMN GV 05 Lier
60,Mechelsesteenweg 365,2022-01-12,08:00:00,92,78,14,FMN GV 05 Lier
60,Mechelsesteenweg 365,2022-01-12,09:00:00,32,16,16,FMN GV 05 Lier
60,Mechelsesteenweg 365,2022-01-12,10:00:00,32,10,22,FMN GV 05 Lier
60,Mechelsesteenweg 365,2022-01-12,11:00:00,48,22,26,FMN GV 05 Lier
60,Mechelsesteenweg 365,2022-01-12,12:00:00,212,42,170,FMN GV 05 Lier
60,Mechelsesteenweg 365,2022-01-12,13:00:00,86,36,50,FMN GV 05 Lier
60,Mechelsesteenweg 365,2022-01-12,14:00:00,68,32,36,FMN GV 05 Lier
60,Mechelsesteenweg 365,2022-01-12,15:00:00,88,36,52,FMN GV 05 Lier
60,Mechelsesteenweg 365,2022-01-12,16:00:00,66,36,30,FMN GV 05 Lier
60,Mechelsesteenweg 365,2022-01-12,17:00:00,54,32,22,FMN GV 05 Lier
60,Mechelsesteenweg 365,2022-01-12,18:00:00,34,24,10,FMN GV 05 Lier
60,Mechelsesteenweg 365,2022-01-12,19:00:00,2,0,2,FMN GV 05 Lier
60,Mechelsesteenweg 365,2022-01-12,20:00:00,4,2,2,FMN GV 05 Lier
60,Mechelsesteenweg 365,2022-01-12,21:00:00,26,10,16,FMN GV 05 Lier
60,Mechelsesteenweg 365,2022-01-12,22:00:00,6,2,4,FMN GV 05 Lier
60,Mechelsesteenweg 365,2022-01-12,23:00:00,0,0,0,FMN GV 05 Lier
60,Mechelsesteenweg 365,2022-01-13,00:00:00,2,2,0,FMN GV 05 Lier
60,Mechelsesteenweg 365,2022-01-13,01:00:00,2,0,2,FMN GV 05 Lier
60,Mechelsesteenweg 365,2022-01-13,02:00:00,0,0,0,FMN GV 05 Lier
60,Mechelsesteenweg 365,2022-01-13,03:00:00,2,0,2,FMN GV 05 Lier
60,Mechelsesteenweg 365,2022-01-13,04:00:00,0,0,0,FMN GV 05 Lier
60,Mechelsesteenweg 365,2022-01-13,05:00:00,2,0,2,FMN GV 05 Lier
60,Mechelsesteenweg 365,2022-01-13,06:00:00,6,2,4,FMN GV 05 Lier
60,Mechelsesteenweg 365,2022-01-13,07:00:00,96,56,40,FMN GV 05 Lier
60,Mechelsesteenweg 365,2022-01-13,08:00:00,94,62,32,FMN GV 05 Lier
60,Mechelsesteenweg 365,2022-01-13,09:00:00,46,24,22,FMN GV 05 Lier
60,Mechelsesteenweg 365,2022-01-13,10:00:00,48,22,26,FMN GV 05 Lier
60,Mechelsesteenweg 365,2022-01-13,11:00:00,36,22,14,FMN GV 05 Lier
60,Mechelsesteenweg 365,2022-01-13,12:00:00,42,20,22,FMN GV 05 Lier
60,Mechelsesteenweg 365,2022-01-13,13:00:00,66,30,36,FMN GV 05 Lier
60,Mechelsesteenweg 365,2022-01-13,14:00:00,82,44,38,FMN GV 05 Lier
60,Mechelsesteenweg 365,2022-01-13,15:00:00,80,34,46,FMN GV 05 Lier
60,Mechelsesteenweg 365,2022-01-13,16:00:00,204,60,144,FMN GV 05 Lier
60,Mechelsesteenweg 365,2022-01-13,17:00:00,36,16,20,FMN GV 05 Lier
60,Mechelsesteenweg 365,2022-01-13,18:00:00,30,18,12,FMN GV 05 Lier
60,Mechelsesteenweg 365,2022-01-13,19:00:00,10,10,0,FMN GV 05 Lier
60,Mechelsesteenweg 365,2022-01-13,20:00:00,4,2,2,FMN GV 05 Lier
60,Mechelsesteenweg 365,2022-01-13,21:00:00,6,0,6,FMN GV 05 Lier
60,Mechelsesteenweg 365,2022-01-13,22:00:00,2,2,0,FMN GV 05 Lier
60,Mechelsesteenweg 365,2022-01-13,23:00:00,4,4,0,FMN GV 05 Lier
60,Mechelsesteenweg 365,2022-01-14,00:00:00,0,0,0,FMN GV 05 Lier
60,Mechelsesteenweg 365,2022-01-14,01:00:00,0,0,0,FMN GV 05 Lier
60,Mechelsesteenweg 365,2022-01-14,02:00:00,0,0,0,FMN GV 05 Lier
60,Mechelsesteenweg 365,2022-01-14,03:00:00,2,0,2,FMN GV 05 Lier
60,Mechelsesteenweg 365,2022-01-14,04:00:00,0,0,0,FMN GV 05 Lier
60,Mechelsesteenweg 365,2022-01-14,05:00:00,6,2,4,FMN GV 05 Lier
60,Mechelsesteenweg 365,2022-01-14,06:00:00,14,4,10,FMN GV 05 Lier
60,Mechelsesteenweg 365,2022-01-14,07:00:00,70,38,32,FMN GV 05 Lier
60,Mechelsesteenweg 365,2022-01-14,08:00:00,126,98,28,FMN GV 05 Lier
60,Mechelsesteenweg 365,2022-01-14,09:00:00,26,20,6,FMN GV 05 Lier
60,Mechelsesteenweg 365,2022-01-14,10:00:00,38,18,20,FMN GV 05 Lier
60,Mechelsesteenweg 365,2022-01-14,11:00:00,50,26,24,FMN GV 05 Lier
60,Mechelsesteenweg 365,2022-01-14,12:00:00,62,20,42,FMN GV 05 Lier
60,Mechelsesteenweg 365,2022-01-14,13:00:00,58,32,26,FMN GV 05 Lier
60,Mechelsesteenweg 365,2022-01-14,14:00:00,82,46,36,FMN GV 05 Lier
60,Mechelsesteenweg 365,2022-01-14,15:00:00,100,48,52,FMN GV 05 Lier
60,Mechelsesteenweg 365,2022-01-14,16:00:00,242,76,166,FMN GV 05 Lier
60,Mechelsesteenweg 365,2022-01-14,17:00:00,46,20,26,FMN GV 05 Lier
60,Mechelsesteenweg 365,2022-01-14,18:00:00,18,6,12,FMN GV 05 Lier
60,Mechelsesteenweg 365,2022-01-14,19:00:00,12,8,4,FMN GV 05 Lier
60,Mechelsesteenweg 365,2022-01-14,20:00:00,8,6,2,FMN GV 05 Lier
60,Mechelsesteenweg 365,2022-01-14,21:00:00,6,2,4,FMN GV 05 Lier
60,Mechelsesteenweg 365,2022-01-14,22:00:00,8,4,4,FMN GV 05 Lier
60,Mechelsesteenweg 365,2022-01-14,23:00:00,6,2,4,FMN GV 05 Lier
60,Mechelsesteenweg 365,2022-01-15,00:00:00,2,0,2,FMN GV 05 Lier
60,Mechelsesteenweg 365,2022-01-15,01:00:00,0,0,0,FMN GV 05 Lier
60,Mechelsesteenweg 365,2022-01-15,02:00:00,0,0,0,FMN GV 05 Lier
60,Mechelsesteenweg 365,2022-01-15,03:00:00,0,0,0,FMN GV 05 Lier
60,Mechelsesteenweg 365,2022-01-15,04:00:00,0,0,0,FMN GV 05 Lier
60,Mechelsesteenweg 365,2022-01-15,05:00:00,4,2,2,FMN GV 05 Lier
60,Mechelsesteenweg 365,2022-01-15,06:00:00,2,2,0,FMN GV 05 Lier
60,Mechelsesteenweg 365,2022-01-15,07:00:00,8,2,6,FMN GV 05 Lier
60,Mechelsesteenweg 365,2022-01-15,08:00:00,10,8,2,FMN GV 05 Lier
60,Mechelsesteenweg 365,2022-01-15,09:00:00,34,16,18,FMN GV 05 Lier
60,Mechelsesteenweg 365,2022-01-15,10:00:00,64,32,32,FMN GV 05 Lier
60,Mechelsesteenweg 365,2022-01-15,11:00:00,132,56,76,FMN GV 05 Lier
60,Mechelsesteenweg 365,2022-01-15,12:00:00,142,66,76,FMN GV 05 Lier
60,Mechelsesteenweg 365,2022-01-15,13:00:00,190,116,74,FMN GV 05 Lier
60,Mechelsesteenweg 365,2022-01-15,14:00:00,362,210,152,FMN GV 05 Lier
60,Mechelsesteenweg 365,2022-01-15,15:00:00,286,104,182,FMN GV 05 Lier
60,Mechelsesteenweg 365,2022-01-15,16:00:00,140,64,76,FMN GV 05 Lier
60,Mechelsesteenweg 365,2022-01-15,17:00:00,36,10,26,FMN GV 05 Lier
60,Mechelsesteenweg 365,2022-01-15,18:00:00,20,8,12,FMN GV 05 Lier
60,Mechelsesteenweg 365,2022-01-15,19:00:00,2,2,0,FMN GV 05 Lier
60,Mechelsesteenweg 365,2022-01-15,20:00:00,6,4,2,FMN GV 05 Lier
60,Mechelsesteenweg 365,2022-01-15,21:00:00,2,0,2,FMN GV 05 Lier
60,Mechelsesteenweg 365,2022-01-15,22:00:00,8,8,0,FMN GV 05 Lier
60,Mechelsesteenweg 365,2022-01-15,23:00:00,0,0,0,FMN GV 05 Lier
60,Mechelsesteenweg 365,2022-01-16,00:00:00,2,0,2,FMN GV 05 Lier
60,Mechelsesteenweg 365,2022-01-16,01:00:00,0,0,0,FMN GV 05 Lier
60,Mechelsesteenweg 365,2022-01-16,02:00:00,0,0,0,FMN GV 05 Lier
60,Mechelsesteenweg 365,2022-01-16,03:00:00,0,0,0,FMN GV 05 Lier
60,Mechelsesteenweg 365,2022-01-16,04:00:00,2,0,2,FMN GV 05 Lier
60,Mechelsesteenweg 365,2022-01-16,05:00:00,0,0,0,FMN GV 05 Lier
60,Mechelsesteenweg 365,2022-01-16,06:00:00,2,0,2,FMN GV 05 Lier
60,Mechelsesteenweg 365,2022-01-16,07:00:00,0,0,0,FMN GV 05 Lier
60,Mechelsesteenweg 365,2022-01-16,08:00:00,8,6,2,FMN GV 05 Lier
60,Mechelsesteenweg 365,2022-01-16,09:00:00,50,20,30,FMN GV 05 Lier
60,Mechelsesteenweg 365,2022-01-16,10:00:00,172,80,92,FMN GV 05 Lier
60,Mechelsesteenweg 365,2022-01-16,11:00:00,178,94,84,FMN GV 05 Lier
60,Mechelsesteenweg 365,2022-01-16,12:00:00,92,60,32,FMN GV 05 Lier
60,Mechelsesteenweg 365,2022-01-16,13:00:00,62,36,26,FMN GV 05 Lier
60,Mechelsesteenweg 365,2022-01-16,14:00:00,82,42,40,FMN GV 05 Lier
60,Mechelsesteenweg 365,2022-01-16,15:00:00,66,40,26,FMN GV 05 Lier
60,Mechelsesteenweg 365,2022-01-16,16:00:00,50,26,24,FMN GV 05 Lier
60,Mechelsesteenweg 365,2022-01-16,17:00:00,16,8,8,FMN GV 05 Lier
60,Mechelsesteenweg 365,2022-01-16,18:00:00,8,2,6,FMN GV 05 Lier
60,Mechelsesteenweg 365,2022-01-16,19:00:00,4,4,0,FMN GV 05 Lier
60,Mechelsesteenweg 365,2022-01-16,20:00:00,4,2,2,FMN GV 05 Lier
60,Mechelsesteenweg 365,2022-01-16,21:00:00,0,0,0,FMN GV 05 Lier
60,Mechelsesteenweg 365,2022-01-16,22:00:00,0,0,0,FMN GV 05 Lier
60,Mechelsesteenweg 365,2022-01-16,23:00:00,2,2,0,FMN GV 05 Lier
60,Mechelsesteenweg 365,2022-01-17,00:00:00,0,0,0,FMN GV 05 Lier
60,Mechelsesteenweg 365,2022-01-17,01:00:00,0,0,0,FMN GV 05 Lier
60,Mechelsesteenweg 365,2022-01-17,02:00:00,0,0,0,FMN GV 05 Lier
60,Mechelsesteenweg 365,2022-01-17,03:00:00,0,0,0,FMN GV 05 Lier
60,Mechelsesteenweg 365,2022-01-17,04:00:00,2,0,2,FMN GV 05 Lier
60,Mechelsesteenweg 365,2022-01-17,05:00:00,4,0,4,FMN GV 05 Lier
60,Mechelsesteenweg 365,2022-01-17,06:00:00,16,2,14,FMN GV 05 Lier
60,Mechelsesteenweg 365,2022-01-17,07:00:00,130,82,48,FMN GV 05 Lier
60,Mechelsesteenweg 365,2022-01-17,08:00:00,126,90,36,FMN GV 05 Lier
60,Mechelsesteenweg 365,2022-01-17,09:00:00,40,24,16,FMN GV 05 Lier
60,Mechelsesteenweg 365,2022-01-17,10:00:00,58,34,24,FMN GV 05 Lier
60,Mechelsesteenweg 365,2022-01-17,11:00:00,66,24,42,FMN GV 05 Lier
60,Mechelsesteenweg 365,2022-01-17,12:00:00,56,28,28,FMN GV 05 Lier
60,Mechelsesteenweg 365,2022-01-17,13:00:00,112,70,42,FMN GV 05 Lier
60,Mechelsesteenweg 365,2022-01-17,14:00:00,166,90,76,FMN GV 05 Lier
60,Mechelsesteenweg 365,2022-01-17,15:00:00,134,54,80,FMN GV 05 Lier
60,Mechelsesteenweg 365,2022-01-17,16:00:00,276,90,186,FMN GV 05 Lier
60,Mechelsesteenweg 365,2022-01-17,17:00:00,92,54,38,FMN GV 05 Lier
60,Mechelsesteenweg 365,2022-01-17,18:00:00,30,14,16,FMN GV 05 Lier
60,Mechelsesteenweg 365,2022-01-17,19:00:00,2,2,0,FMN GV 05 Lier
60,Mechelsesteenweg 365,2022-01-17,20:00:00,6,2,4,FMN GV 05 Lier
60,Mechelsesteenweg 365,2022-01-17,21:00:00,2,0,2,FMN GV 05 Lier
60,Mechelsesteenweg 365,2022-01-17,22:00:00,4,4,0,FMN GV 05 Lier
60,Mechelsesteenweg 365,2022-01-17,23:00:00,2,2,0,FMN GV 05 Lier
60,Mechelsesteenweg 365,2022-01-18,00:00:00,0,0,0,FMN GV 05 Lier
60,Mechelsesteenweg 365,2022-01-18,01:00:00,0,0,0,FMN GV 05 Lier
60,Mechelsesteenweg 365,2022-01-18,02:00:00,0,0,0,FMN GV 05 Lier
60,Mechelsesteenweg 365,2022-01-18,03:00:00,0,0,0,FMN GV 05 Lier
60,Mechelsesteenweg 365,2022-01-18,04:00:00,4,0,4,FMN GV 05 Lier
60,Mechelsesteenweg 365,2022-01-18,05:00:00,4,0,4,FMN GV 05 Lier
60,Mechelsesteenweg 365,2022-01-18,06:00:00,20,2,18,FMN GV 05 Lier
60,Mechelsesteenweg 365,2022-01-18,07:00:00,130,84,46,FMN GV 05 Lier
60,Mechelsesteenweg 365,2022-01-18,08:00:00,160,126,34,FMN GV 05 Lier
60,Mechelsesteenweg 365,2022-01-18,09:00:00,26,12,14,FMN GV 05 Lier
60,Mechelsesteenweg 365,2022-01-18,10:00:00,58,26,32,FMN GV 05 Lier
60,Mechelsesteenweg 365,2022-01-18,11:00:00,70,36,34,FMN GV 05 Lier
60,Mechelsesteenweg 365,2022-01-18,12:00:00,74,46,28,FMN GV 05 Lier
60,Mechelsesteenweg 365,2022-01-18,13:00:00,162,86,76,FMN GV 05 Lier
60,Mechelsesteenweg 365,2022-01-18,14:00:00,198,122,76,FMN GV 05 Lier
60,Mechelsesteenweg 365,2022-01-18,15:00:00,246,88,158,FMN GV 05 Lier
60,Mechelsesteenweg 365,2022-01-18,16:00:00,238,72,166,FMN GV 05 Lier
60,Mechelsesteenweg 365,2022-01-18,17:00:00,88,56,32,FMN GV 05 Lier
60,Mechelsesteenweg 365,2022-01-18,18:00:00,26,16,10,FMN GV 05 Lier
60,Mechelsesteenweg 365,2022-01-18,19:00:00,16,10,6,FMN GV 05 Lier
60,Mechelsesteenweg 365,2022-01-18,20:00:00,20,10,10,FMN GV 05 Lier
60,Mechelsesteenweg 365,2022-01-18,21:00:00,8,2,6,FMN GV 05 Lier
60,Mechelsesteenweg 365,2022-01-18,22:00:00,6,6,0,FMN GV 05 Lier
60,Mechelsesteenweg 365,2022-01-18,23:00:00,4,2,2,FMN GV 05 Lier
60,Mechelsesteenweg 365,2022-01-19,00:00:00,0,0,0,FMN GV 05 Lier
60,Mechelsesteenweg 365,2022-01-19,01:00:00,0,0,0,FMN GV 05 Lier
60,Mechelsesteenweg 365,2022-01-19,02:00:00,2,2,0,FMN GV 05 Lier
60,Mechelsesteenweg 365,2022-01-19,03:00:00,0,0,0,FMN GV 05 Lier
60,Mechelsesteenweg 365,2022-01-19,04:00:00,2,0,2,FMN GV 05 Lier
60,Mechelsesteenweg 365,2022-01-19,05:00:00,10,0,10,FMN GV 05 Lier
60,Mechelsesteenweg 365,2022-01-19,06:00:00,10,4,6,FMN GV 05 Lier
60,Mechelsesteenweg 365,2022-01-19,07:00:00,118,68,50,FMN GV 05 Lier
60,Mechelsesteenweg 365,2022-01-19,08:00:00,112,88,24,FMN GV 05 Lier
60,Mechelsesteenweg 365,2022-01-19,09:00:00,62,36,26,FMN GV 05 Lier
60,Mechelsesteenweg 365,2022-01-19,10:00:00,54,30,24,FMN GV 05 Lier
60,Mechelsesteenweg 365,2022-01-19,11:00:00,66,26,40,FMN GV 05 Lier
60,Mechelsesteenweg 365,2022-01-19,12:00:00,188,36,152,FMN GV 05 Lier
60,Mechelsesteenweg 365,2022-01-19,13:00:00,76,30,46,FMN GV 05 Lier
60,Mechelsesteenweg 365,2022-01-19,14:00:00,56,28,28,FMN GV 05 Lier
60,Mechelsesteenweg 365,2022-01-19,15:00:00,110,42,68,FMN GV 05 Lier
60,Mechelsesteenweg 365,2022-01-19,16:00:00,60,32,28,FMN GV 05 Lier
60,Mechelsesteenweg 365,2022-01-19,17:00:00,46,30,16,FMN GV 05 Lier
60,Mechelsesteenweg 365,2022-01-19,18:00:00,10,10,0,FMN GV 05 Lier
60,Mechelsesteenweg 365,2022-01-19,19:00:00,6,4,2,FMN GV 05 Lier
60,Mechelsesteenweg 365,2022-01-19,20:00:00,4,2,2,FMN GV 05 Lier
60,Mechelsesteenweg 365,2022-01-19,21:00:00,2,0,2,FMN GV 05 Lier
60,Mechelsesteenweg 365,2022-01-19,22:00:00,4,4,0,FMN GV 05 Lier
60,Mechelsesteenweg 365,2022-01-19,23:00:00,0,0,0,FMN GV 05 Lier
60,Mechelsesteenweg 365,2022-01-20,00:00:00,2,2,0,FMN GV 05 Lier
60,Mechelsesteenweg 365,2022-01-20,01:00:00,0,0,0,FMN GV 05 Lier
60,Mechelsesteenweg 365,2022-01-20,02:00:00,0,0,0,FMN GV 05 Lier
60,Mechelsesteenweg 365,2022-01-20,03:00:00,0,0,0,FMN GV 05 Lier
60,Mechelsesteenweg 365,2022-01-20,04:00:00,2,0,2,FMN GV 05 Lier
60,Mechelsesteenweg 365,2022-01-20,05:00:00,6,0,6,FMN GV 05 Lier
60,Mechelsesteenweg 365,2022-01-20,06:00:00,14,0,14,FMN GV 05 Lier
60,Mechelsesteenweg 365,2022-01-20,07:00:00,90,58,32,FMN GV 05 Lier
60,Mechelsesteenweg 365,2022-01-20,08:00:00,90,58,32,FMN GV 05 Lier
60,Mechelsesteenweg 365,2022-01-20,09:00:00,32,22,10,FMN GV 05 Lier
60,Mechelsesteenweg 365,2022-01-20,10:00:00,46,26,20,FMN GV 05 Lier
60,Mechelsesteenweg 365,2022-01-20,11:00:00,24,10,14,FMN GV 05 Lier
60,Mechelsesteenweg 365,2022-01-20,12:00:00,36,18,18,FMN GV 05 Lier
60,Mechelsesteenweg 365,2022-01-20,13:00:00,54,24,30,FMN GV 05 Lier
60,Mechelsesteenweg 365,2022-01-20,14:00:00,80,40,40,FMN GV 05 Lier
60,Mechelsesteenweg 365,2022-01-20,15:00:00,98,24,74,FMN GV 05 Lier
60,Mechelsesteenweg 365,2022-01-20,16:00:00,166,44,122,FMN GV 05 Lier
60,Mechelsesteenweg 365,2022-01-20,17:00:00,64,42,22,FMN GV 05 Lier
60,Mechelsesteenweg 365,2022-01-20,18:00:00,22,12,10,FMN GV 05 Lier
60,Mechelsesteenweg 365,2022-01-20,19:00:00,6,2,4,FMN GV 05 Lier
60,Mechelsesteenweg 365,2022-01-20,20:00:00,10,6,4,FMN GV 05 Lier
60,Mechelsesteenweg 365,2022-01-20,21:00:00,6,4,2,FMN GV 05 Lier
60,Mechelsesteenweg 365,2022-01-20,22:00:00,2,2,0,FMN GV 05 Lier
60,Mechelsesteenweg 365,2022-01-20,23:00:00,4,2,2,FMN GV 05 Lier
60,Mechelsesteenweg 365,2022-01-21,00:00:00,2,2,0,FMN GV 05 Lier
60,Mechelsesteenweg 365,2022-01-21,01:00:00,4,2,2,FMN GV 05 Lier
60,Mechelsesteenweg 365,2022-01-21,02:00:00,0,0,0,FMN GV 05 Lier
60,Mechelsesteenweg 365,2022-01-21,03:00:00,0,0,0,FMN GV 05 Lier
60,Mechelsesteenweg 365,2022-01-21,04:00:00,4,0,4,FMN GV 05 Lier
60,Mechelsesteenweg 365,2022-01-21,05:00:00,6,0,6,FMN GV 05 Lier
60,Mechelsesteenweg 365,2022-01-21,06:00:00,8,0,8,FMN GV 05 Lier
60,Mechelsesteenweg 365,2022-01-21,07:00:00,32,12,20,FMN GV 05 Lier
60,Mechelsesteenweg 365,2022-01-21,08:00:00,44,8,36,FMN GV 05 Lier
60,Mechelsesteenweg 365,2022-01-21,09:00:00,10,0,10,FMN GV 05 Lier
60,Mechelsesteenweg 365,2022-01-21,10:00:00,50,24,26,FMN GV 05 Lier
60,Mechelsesteenweg 365,2022-01-21,11:00:00,62,50,12,FMN GV 05 Lier
60,Mechelsesteenweg 365,2022-01-21,12:00:00,68,22,46,FMN GV 05 Lier
60,Mechelsesteenweg 365,2022-01-21,13:00:00,70,48,22,FMN GV 05 Lier
60,Mechelsesteenweg 365,2022-01-21,14:00:00,44,20,24,FMN GV 05 Lier
60,Mechelsesteenweg 365,2022-01-21,15:00:00,66,38,28,FMN GV 05 Lier
60,Mechelsesteenweg 365,2022-01-21,16:00:00,106,32,74,FMN GV 05 Lier
60,Mechelsesteenweg 365,2022-01-21,17:00:00,50,32,18,FMN GV 05 Lier
60,Mechelsesteenweg 365,2022-01-21,18:00:00,14,4,10,FMN GV 05 Lier
60,Mechelsesteenweg 365,2022-01-21,19:00:00,14,4,10,FMN GV 05 Lier
60,Mechelsesteenweg 365,2022-01-21,20:00:00,6,4,2,FMN GV 05 Lier
60,Mechelsesteenweg 365,2022-01-21,21:00:00,2,0,2,FMN GV 05 Lier
60,Mechelsesteenweg 365,2022-01-21,22:00:00,10,8,2,FMN GV 05 Lier
60,Mechelsesteenweg 365,2022-01-21,23:00:00,0,0,0,FMN GV 05 Lier
60,Mechelsesteenweg 365,2022-01-22,00:00:00,0,0,0,FMN GV 05 Lier
60,Mechelsesteenweg 365,2022-01-22,01:00:00,2,0,2,FMN GV 05 Lier
60,Mechelsesteenweg 365,2022-01-22,02:00:00,0,0,0,FMN GV 05 Lier
60,Mechelsesteenweg 365,2022-01-22,03:00:00,2,0,2,FMN GV 05 Lier
60,Mechelsesteenweg 365,2022-01-22,04:00:00,0,0,0,FMN GV 05 Lier
60,Mechelsesteenweg 365,2022-01-22,05:00:00,0,0,0,FMN GV 05 Lier
60,Mechelsesteenweg 365,2022-01-22,06:00:00,4,0,4,FMN GV 05 Lier
60,Mechelsesteenweg 365,2022-01-22,07:00:00,14,10,4,FMN GV 05 Lier
60,Mechelsesteenweg 365,2022-01-22,08:00:00,10,4,6,FMN GV 05 Lier
60,Mechelsesteenweg 365,2022-01-22,09:00:00,60,36,24,FMN GV 05 Lier
60,Mechelsesteenweg 365,2022-01-22,10:00:00,80,46,34,FMN GV 05 Lier
60,Mechelsesteenweg 365,2022-01-22,11:00:00,146,70,76,FMN GV 05 Lier
60,Mechelsesteenweg 365,2022-01-22,12:00:00,112,56,56,FMN GV 05 Lier
60,Mechelsesteenweg 365,2022-01-22,13:00:00,102,74,28,FMN GV 05 Lier
60,Mechelsesteenweg 365,2022-01-22,14:00:00,170,92,78,FMN GV 05 Lier
60,Mechelsesteenweg 365,2022-01-22,15:00:00,172,86,86,FMN GV 05 Lier
60,Mechelsesteenweg 365,2022-01-22,16:00:00,66,22,44,FMN GV 05 Lier
60,Mechelsesteenweg 365,2022-01-22,17:00:00,26,12,14,FMN GV 05 Lier
60,Mechelsesteenweg 365,2022-01-22,18:00:00,8,8,0,FMN GV 05 Lier
60,Mechelsesteenweg 365,2022-01-22,19:00:00,4,2,2,FMN GV 05 Lier
60,Mechelsesteenweg 365,2022-01-22,20:00:00,6,4,2,FMN GV 05 Lier
60,Mechelsesteenweg 365,2022-01-22,21:00:00,0,0,0,FMN GV 05 Lier
60,Mechelsesteenweg 365,2022-01-22,22:00:00,0,0,0,FMN GV 05 Lier
60,Mechelsesteenweg 365,2022-01-22,23:00:00,6,2,4,FMN GV 05 Lier
60,Mechelsesteenweg 365,2022-01-23,00:00:00,4,0,4,FMN GV 05 Lier
60,Mechelsesteenweg 365,2022-01-23,01:00:00,0,0,0,FMN GV 05 Lier
60,Mechelsesteenweg 365,2022-01-23,02:00:00,0,0,0,FMN GV 05 Lier
60,Mechelsesteenweg 365,2022-01-23,03:00:00,0,0,0,FMN GV 05 Lier
60,Mechelsesteenweg 365,2022-01-23,04:00:00,0,0,0,FMN GV 05 Lier
60,Mechelsesteenweg 365,2022-01-23,05:00:00,2,0,2,FMN GV 05 Lier
60,Mechelsesteenweg 365,2022-01-23,06:00:00,4,0,4,FMN GV 05 Lier
60,Mechelsesteenweg 365,2022-01-23,07:00:00,6,4,2,FMN GV 05 Lier
60,Mechelsesteenweg 365,2022-01-23,08:00:00,16,8,8,FMN GV 05 Lier
60,Mechelsesteenweg 365,2022-01-23,09:00:00,104,70,34,FMN GV 05 Lier
60,Mechelsesteenweg 365,2022-01-23,10:00:00,218,114,104,FMN GV 05 Lier
60,Mechelsesteenweg 365,2022-01-23,11:00:00,282,136,146,FMN GV 05 Lier
60,Mechelsesteenweg 365,2022-01-23,12:00:00,146,76,70,FMN GV 05 Lier
60,Mechelsesteenweg 365,2022-01-23,13:00:00,170,90,80,FMN GV 05 Lier
60,Mechelsesteenweg 365,2022-01-23,14:00:00,170,78,92,FMN GV 05 Lier
60,Mechelsesteenweg 365,2022-01-23,15:00:00,142,74,68,FMN GV 05 Lier
60,Mechelsesteenweg 365,2022-01-23,16:00:00,66,28,38,FMN GV 05 Lier
60,Mechelsesteenweg 365,2022-01-23,17:00:00,30,14,16,FMN GV 05 Lier
60,Mechelsesteenweg 365,2022-01-23,18:00:00,4,4,0,FMN GV 05 Lier
60,Mechelsesteenweg 365,2022-01-23,19:00:00,8,6,2,FMN GV 05 Lier
60,Mechelsesteenweg 365,2022-01-23,20:00:00,8,2,6,FMN GV 05 Lier
60,Mechelsesteenweg 365,2022-01-23,21:00:00,0,0,0,FMN GV 05 Lier
60,Mechelsesteenweg 365,2022-01-23,22:00:00,0,0,0,FMN GV 05 Lier
60,Mechelsesteenweg 365,2022-01-23,23:00:00,0,0,0,FMN GV 05 Lier
60,Mechelsesteenweg 365,2022-01-24,00:00:00,0,0,0,FMN GV 05 Lier
60,Mechelsesteenweg 365,2022-01-24,01:00:00,0,0,0,FMN GV 05 Lier
60,Mechelsesteenweg 365,2022-01-24,02:00:00,0,0,0,FMN GV 05 Lier
60,Mechelsesteenweg 365,2022-01-24,03:00:00,0,0,0,FMN GV 05 Lier
60,Mechelsesteenweg 365,2022-01-24,04:00:00,0,0,0,FMN GV 05 Lier
60,Mechelsesteenweg 365,2022-01-24,05:00:00,4,0,4,FMN GV 05 Lier
60,Mechelsesteenweg 365,2022-01-24,06:00:00,14,4,10,FMN GV 05 Lier
60,Mechelsesteenweg 365,2022-01-24,07:00:00,80,40,40,FMN GV 05 Lier
60,Mechelsesteenweg 365,2022-01-24,08:00:00,60,38,22,FMN GV 05 Lier
60,Mechelsesteenweg 365,2022-01-24,09:00:00,50,12,38,FMN GV 05 Lier
60,Mechelsesteenweg 365,2022-01-24,10:00:00,62,28,34,FMN GV 05 Lier
60,Mechelsesteenweg 365,2022-01-24,11:00:00,60,22,38,FMN GV 05 Lier
60,Mechelsesteenweg 365,2022-01-24,12:00:00,96,32,64,FMN GV 05 Lier
60,Mechelsesteenweg 365,2022-01-24,13:00:00,222,138,84,FMN GV 05 Lier
60,Mechelsesteenweg 365,2022-01-24,14:00:00,304,172,132,FMN GV 05 Lier
60,Mechelsesteenweg 365,2022-01-24,15:00:00,228,92,136,FMN GV 05 Lier
60,Mechelsesteenweg 365,2022-01-24,16:00:00,188,82,106,FMN GV 05 Lier
60,Mechelsesteenweg 365,2022-01-24,17:00:00,114,66,48,FMN GV 05 Lier
60,Mechelsesteenweg 365,2022-01-24,18:00:00,10,4,6,FMN GV 05 Lier
60,Mechelsesteenweg 365,2022-01-24,19:00:00,6,6,0,FMN GV 05 Lier
60,Mechelsesteenweg 365,2022-01-24,20:00:00,6,0,6,FMN GV 05 Lier
60,Mechelsesteenweg 365,2022-01-24,21:00:00,4,4,0,FMN GV 05 Lier
60,Mechelsesteenweg 365,2022-01-24,22:00:00,6,2,4,FMN GV 05 Lier
60,Mechelsesteenweg 365,2022-01-24,23:00:00,0,0,0,FMN GV 05 Lier
60,Mechelsesteenweg 365,2022-01-25,00:00:00,0,0,0,FMN GV 05 Lier
60,Mechelsesteenweg 365,2022-01-25,01:00:00,0,0,0,FMN GV 05 Lier
60,Mechelsesteenweg 365,2022-01-25,02:00:00,0,0,0,FMN GV 05 Lier
60,Mechelsesteenweg 365,2022-01-25,03:00:00,0,0,0,FMN GV 05 Lier
60,Mechelsesteenweg 365,2022-01-25,04:00:00,0,0,0,FMN GV 05 Lier
60,Mechelsesteenweg 365,2022-01-25,05:00:00,8,2,6,FMN GV 05 Lier
60,Mechelsesteenweg 365,2022-01-25,06:00:00,22,8,14,FMN GV 05 Lier
60,Mechelsesteenweg 365,2022-01-25,07:00:00,72,32,40,FMN GV 05 Lier
60,Mechelsesteenweg 365,2022-01-25,08:00:00,50,34,16,FMN GV 05 Lier
60,Mechelsesteenweg 365,2022-01-25,09:00:00,26,12,14,FMN GV 05 Lier
60,Mechelsesteenweg 365,2022-01-25,10:00:00,24,8,16,FMN GV 05 Lier
60,Mechelsesteenweg 365,2022-01-25,11:00:00,30,12,18,FMN GV 05 Lier
60,Mechelsesteenweg 365,2022-01-25,12:00:00,80,40,40,FMN GV 05 Lier
60,Mechelsesteenweg 365,2022-01-25,13:00:00,100,44,56,FMN GV 05 Lier
60,Mechelsesteenweg 365,2022-01-25,14:00:00,90,52,38,FMN GV 05 Lier
60,Mechelsesteenweg 365,2022-01-25,15:00:00,72,28,44,FMN GV 05 Lier
60,Mechelsesteenweg 365,2022-01-25,16:00:00,116,46,70,FMN GV 05 Lier
60,Mechelsesteenweg 365,2022-01-25,17:00:00,82,54,28,FMN GV 05 Lier
60,Mechelsesteenweg 365,2022-01-25,18:00:00,24,8,16,FMN GV 05 Lier
60,Mechelsesteenweg 365,2022-01-25,19:00:00,8,2,6,FMN GV 05 Lier
60,Mechelsesteenweg 365,2022-01-25,20:00:00,8,2,6,FMN GV 05 Lier
60,Mechelsesteenweg 365,2022-01-25,21:00:00,8,2,6,FMN GV 05 Lier
60,Mechelsesteenweg 365,2022-01-25,22:00:00,4,0,4,FMN GV 05 Lier
60,Mechelsesteenweg 365,2022-01-25,23:00:00,2,2,0,FMN GV 05 Lier
60,Mechelsesteenweg 365,2022-01-26,00:00:00,0,0,0,FMN GV 05 Lier
60,Mechelsesteenweg 365,2022-01-26,01:00:00,0,0,0,FMN GV 05 Lier
60,Mechelsesteenweg 365,2022-01-26,02:00:00,0,0,0,FMN GV 05 Lier
60,Mechelsesteenweg 365,2022-01-26,03:00:00,0,0,0,FMN GV 05 Lier
60,Mechelsesteenweg 365,2022-01-26,04:00:00,0,0,0,FMN GV 05 Lier
60,Mechelsesteenweg 365,2022-01-26,05:00:00,8,0,8,FMN GV 05 Lier
60,Mechelsesteenweg 365,2022-01-26,06:00:00,10,0,10,FMN GV 05 Lier
60,Mechelsesteenweg 365,2022-01-26,07:00:00,56,26,30,FMN GV 05 Lier
60,Mechelsesteenweg 365,2022-01-26,08:00:00,66,38,28,FMN GV 05 Lier
60,Mechelsesteenweg 365,2022-01-26,09:00:00,26,14,12,FMN GV 05 Lier
60,Mechelsesteenweg 365,2022-01-26,10:00:00,44,18,26,FMN GV 05 Lier
60,Mechelsesteenweg 365,2022-01-26,11:00:00,34,12,22,FMN GV 05 Lier
60,Mechelsesteenweg 365,2022-01-26,12:00:00,120,28,92,FMN GV 05 Lier
60,Mechelsesteenweg 365,2022-01-26,13:00:00,90,60,30,FMN GV 05 Lier
60,Mechelsesteenweg 365,2022-01-26,14:00:00,94,54,40,FMN GV 05 Lier
60,Mechelsesteenweg 365,2022-01-26,15:00:00,74,44,30,FMN GV 05 Lier
60,Mechelsesteenweg 365,2022-01-26,16:00:00,68,44,24,FMN GV 05 Lier
60,Mechelsesteenweg 365,2022-01-26,17:00:00,50,36,14,FMN GV 05 Lier
60,Mechelsesteenweg 365,2022-01-26,18:00:00,22,16,6,FMN GV 05 Lier
60,Mechelsesteenweg 365,2022-01-26,19:00:00,6,4,2,FMN GV 05 Lier
60,Mechelsesteenweg 365,2022-01-26,20:00:00,20,4,16,FMN GV 05 Lier
60,Mechelsesteenweg 365,2022-01-26,21:00:00,0,0,0,FMN GV 05 Lier
60,Mechelsesteenweg 365,2022-01-26,22:00:00,4,2,2,FMN GV 05 Lier
60,Mechelsesteenweg 365,2022-01-26,23:00:00,0,0,0,FMN GV 05 Lier
60,Mechelsesteenweg 365,2022-01-27,00:00:00,0,0,0,FMN GV 05 Lier
60,Mechelsesteenweg 365,2022-01-27,01:00:00,0,0,0,FMN GV 05 Lier
60,Mechelsesteenweg 365,2022-01-27,02:00:00,0,0,0,FMN GV 05 Lier
60,Mechelsesteenweg 365,2022-01-27,03:00:00,0,0,0,FMN GV 05 Lier
60,Mechelsesteenweg 365,2022-01-27,04:00:00,0,0,0,FMN GV 05 Lier
60,Mechelsesteenweg 365,2022-01-27,05:00:00,4,2,2,FMN GV 05 Lier
60,Mechelsesteenweg 365,2022-01-27,06:00:00,14,2,12,FMN GV 05 Lier
60,Mechelsesteenweg 365,2022-01-27,07:00:00,44,14,30,FMN GV 05 Lier
60,Mechelsesteenweg 365,2022-01-27,08:00:00,80,44,36,FMN GV 05 Lier
60,Mechelsesteenweg 365,2022-01-27,09:00:00,28,16,12,FMN GV 05 Lier
60,Mechelsesteenweg 365,2022-01-27,10:00:00,32,16,16,FMN GV 05 Lier
60,Mechelsesteenweg 365,2022-01-27,11:00:00,14,6,8,FMN GV 05 Lier
60,Mechelsesteenweg 365,2022-01-27,12:00:00,12,6,6,FMN GV 05 Lier
60,Mechelsesteenweg 365,2022-01-27,13:00:00,14,8,6,FMN GV 05 Lier
60,Mechelsesteenweg 365,2022-01-27,14:00:00,30,22,8,FMN GV 05 Lier
60,Mechelsesteenweg 365,2022-01-27,15:00:00,32,12,20,FMN GV 05 Lier
60,Mechelsesteenweg 365,2022-01-27,16:00:00,102,44,58,FMN GV 05 Lier
60,Mechelsesteenweg 365,2022-01-27,17:00:00,60,26,34,FMN GV 05 Lier
60,Mechelsesteenweg 365,2022-01-27,18:00:00,18,8,10,FMN GV 05 Lier
60,Mechelsesteenweg 365,2022-01-27,19:00:00,10,8,2,FMN GV 05 Lier
60,Mechelsesteenweg 365,2022-01-27,20:00:00,10,4,6,FMN GV 05 Lier
60,Mechelsesteenweg 365,2022-01-27,21:00:00,20,10,10,FMN GV 05 Lier
60,Mechelsesteenweg 365,2022-01-27,22:00:00,4,2,2,FMN GV 05 Lier
60,Mechelsesteenweg 365,2022-01-27,23:00:00,2,2,0,FMN GV 05 Lier
60,Mechelsesteenweg 365,2022-01-28,00:00:00,0,0,0,FMN GV 05 Lier
60,Mechelsesteenweg 365,2022-01-28,01:00:00,0,0,0,FMN GV 05 Lier
60,Mechelsesteenweg 365,2022-01-28,02:00:00,0,0,0,FMN GV 05 Lier
60,Mechelsesteenweg 365,2022-01-28,03:00:00,2,0,2,FMN GV 05 Lier
60,Mechelsesteenweg 365,2022-01-28,04:00:00,0,0,0,FMN GV 05 Lier
60,Mechelsesteenweg 365,2022-01-28,05:00:00,6,0,6,FMN GV 05 Lier
60,Mechelsesteenweg 365,2022-01-28,06:00:00,10,0,10,FMN GV 05 Lier
60,Mechelsesteenweg 365,2022-01-28,07:00:00,56,28,28,FMN GV 05 Lier
60,Mechelsesteenweg 365,2022-01-28,08:00:00,52,20,32,FMN GV 05 Lier
60,Mechelsesteenweg 365,2022-01-28,09:00:00,32,16,16,FMN GV 05 Lier
60,Mechelsesteenweg 365,2022-01-28,10:00:00,74,48,26,FMN GV 05 Lier
60,Mechelsesteenweg 365,2022-01-28,11:00:00,68,32,36,FMN GV 05 Lier
60,Mechelsesteenweg 365,2022-01-28,12:00:00,98,54,44,FMN GV 05 Lier
60,Mechelsesteenweg 365,2022-01-28,13:00:00,168,88,80,FMN GV 05 Lier
60,Mechelsesteenweg 365,2022-01-28,14:00:00,194,120,74,FMN GV 05 Lier
60,Mechelsesteenweg 365,2022-01-28,15:00:00,120,50,70,FMN GV 05 Lier
60,Mechelsesteenweg 365,2022-01-28,16:00:00,142,58,84,FMN GV 05 Lier
60,Mechelsesteenweg 365,2022-01-28,17:00:00,62,40,22,FMN GV 05 Lier
60,Mechelsesteenweg 365,2022-01-28,18:00:00,32,22,10,FMN GV 05 Lier
60,Mechelsesteenweg 365,2022-01-28,19:00:00,10,6,4,FMN GV 05 Lier
60,Mechelsesteenweg 365,2022-01-28,20:00:00,2,0,2,FMN GV 05 Lier
60,Mechelsesteenweg 365,2022-01-28,21:00:00,4,2,2,FMN GV 05 Lier
60,Mechelsesteenweg 365,2022-01-28,22:00:00,2,2,0,FMN GV 05 Lier
60,Mechelsesteenweg 365,2022-01-28,23:00:00,0,0,0,FMN GV 05 Lier
60,Mechelsesteenweg 365,2022-01-29,00:00:00,0,0,0,FMN GV 05 Lier
60,Mechelsesteenweg 365,2022-01-29,01:00:00,0,0,0,FMN GV 05 Lier
60,Mechelsesteenweg 365,2022-01-29,02:00:00,4,2,2,FMN GV 05 Lier
60,Mechelsesteenweg 365,2022-01-29,03:00:00,0,0,0,FMN GV 05 Lier
60,Mechelsesteenweg 365,2022-01-29,04:00:00,0,0,0,FMN GV 05 Lier
60,Mechelsesteenweg 365,2022-01-29,05:00:00,0,0,0,FMN GV 05 Lier
60,Mechelsesteenweg 365,2022-01-29,06:00:00,4,2,2,FMN GV 05 Lier
60,Mechelsesteenweg 365,2022-01-29,07:00:00,2,0,2,FMN GV 05 Lier
60,Mechelsesteenweg 365,2022-01-29,08:00:00,10,6,4,FMN GV 05 Lier
60,Mechelsesteenweg 365,2022-01-29,09:00:00,36,22,14,FMN GV 05 Lier
60,Mechelsesteenweg 365,2022-01-29,10:00:00,52,30,22,FMN GV 05 Lier
60,Mechelsesteenweg 365,2022-01-29,11:00:00,116,70,46,FMN GV 05 Lier
60,Mechelsesteenweg 365,2022-01-29,12:00:00,86,32,54,FMN GV 05 Lier
60,Mechelsesteenweg 365,2022-01-29,13:00:00,104,68,36,FMN GV 05 Lier
60,Mechelsesteenweg 365,2022-01-29,14:00:00,118,66,52,FMN GV 05 Lier
60,Mechelsesteenweg 365,2022-01-29,15:00:00,92,40,52,FMN GV 05 Lier
60,Mechelsesteenweg 365,2022-01-29,16:00:00,96,68,28,FMN GV 05 Lier
60,Mechelsesteenweg 365,2022-01-29,17:00:00,30,6,24,FMN GV 05 Lier
60,Mechelsesteenweg 365,2022-01-29,18:00:00,14,4,10,FMN GV 05 Lier
60,Mechelsesteenweg 365,2022-01-29,19:00:00,0,0,0,FMN GV 05 Lier
60,Mechelsesteenweg 365,2022-01-29,20:00:00,12,6,6,FMN GV 05 Lier
60,Mechelsesteenweg 365,2022-01-29,21:00:00,6,2,4,FMN GV 05 Lier
60,Mechelsesteenweg 365,2022-01-29,22:00:00,0,0,0,FMN GV 05 Lier
60,Mechelsesteenweg 365,2022-01-29,23:00:00,0,0,0,FMN GV 05 Lier
60,Mechelsesteenweg 365,2022-01-30,00:00:00,2,0,2,FMN GV 05 Lier
60,Mechelsesteenweg 365,2022-01-30,01:00:00,4,2,2,FMN GV 05 Lier
60,Mechelsesteenweg 365,2022-01-30,02:00:00,0,0,0,FMN GV 05 Lier
60,Mechelsesteenweg 365,2022-01-30,03:00:00,0,0,0,FMN GV 05 Lier
60,Mechelsesteenweg 365,2022-01-30,04:00:00,0,0,0,FMN GV 05 Lier
60,Mechelsesteenweg 365,2022-01-30,05:00:00,0,0,0,FMN GV 05 Lier
60,Mechelsesteenweg 365,2022-01-30,06:00:00,6,4,2,FMN GV 05 Lier
60,Mechelsesteenweg 365,2022-01-30,07:00:00,8,0,8,FMN GV 05 Lier
60,Mechelsesteenweg 365,2022-01-30,08:00:00,16,12,4,FMN GV 05 Lier
60,Mechelsesteenweg 365,2022-01-30,09:00:00,82,40,42,FMN GV 05 Lier
60,Mechelsesteenweg 365,2022-01-30,10:00:00,412,256,156,FMN GV 05 Lier
60,Mechelsesteenweg 365,2022-01-30,11:00:00,368,150,218,FMN GV 05 Lier
60,Mechelsesteenweg 365,2022-01-30,12:00:00,312,146,166,FMN GV 05 Lier
60,Mechelsesteenweg 365,2022-01-30,13:00:00,198,96,102,FMN GV 05 Lier
60,Mechelsesteenweg 365,2022-01-30,14:00:00,202,98,104,FMN GV 05 Lier
60,Mechelsesteenweg 365,2022-01-30,15:00:00,190,116,74,FMN GV 05 Lier
60,Mechelsesteenweg 365,2022-01-30,16:00:00,124,36,88,FMN GV 05 Lier
60,Mechelsesteenweg 365,2022-01-30,17:00:00,54,26,28,FMN GV 05 Lier
60,Mechelsesteenweg 365,2022-01-30,18:00:00,6,0,6,FMN GV 05 Lier
60,Mechelsesteenweg 365,2022-01-30,19:00:00,4,0,4,FMN GV 05 Lier
60,Mechelsesteenweg 365,2022-01-30,20:00:00,0,0,0,FMN GV 05 Lier
60,Mechelsesteenweg 365,2022-01-30,21:00:00,2,2,0,FMN GV 05 Lier
60,Mechelsesteenweg 365,2022-01-30,22:00:00,2,0,2,FMN GV 05 Lier
60,Mechelsesteenweg 365,2022-01-30,23:00:00,0,0,0,FMN GV 05 Lier
60,Mechelsesteenweg 365,2022-01-31,00:00:00,0,0,0,FMN GV 05 Lier
60,Mechelsesteenweg 365,2022-01-31,01:00:00,0,0,0,FMN GV 05 Lier
60,Mechelsesteenweg 365,2022-01-31,02:00:00,0,0,0,FMN GV 05 Lier
60,Mechelsesteenweg 365,2022-01-31,03:00:00,0,0,0,FMN GV 05 Lier
60,Mechelsesteenweg 365,2022-01-31,04:00:00,0,0,0,FMN GV 05 Lier
60,Mechelsesteenweg 365,2022-01-31,05:00:00,4,0,4,FMN GV 05 Lier
60,Mechelsesteenweg 365,2022-01-31,06:00:00,6,2,4,FMN GV 05 Lier
60,Mechelsesteenweg 365,2022-01-31,07:00:00,70,42,28,FMN GV 05 Lier
60,Mechelsesteenweg 365,2022-01-31,08:00:00,90,68,22,FMN GV 05 Lier
60,Mechelsesteenweg 365,2022-01-31,09:00:00,12,6,6,FMN GV 05 Lier
60,Mechelsesteenweg 365,2022-01-31,10:00:00,8,2,6,FMN GV 05 Lier
60,Mechelsesteenweg 365,2022-01-31,11:00:00,12,6,6,FMN GV 05 Lier
60,Mechelsesteenweg 365,2022-01-31,12:00:00,28,12,16,FMN GV 05 Lier
60,Mechelsesteenweg 365,2022-01-31,13:00:00,10,2,8,FMN GV 05 Lier
60,Mechelsesteenweg 365,2022-01-31,14:00:00,16,10,6,FMN GV 05 Lier
60,Mechelsesteenweg 365,2022-01-31,15:00:00,28,16,12,FMN GV 05 Lier
60,Mechelsesteenweg 365,2022-01-31,16:00:00,110,28,82,FMN GV 05 Lier
60,Mechelsesteenweg 365,2022-01-31,17:00:00,56,32,24,FMN GV 05 Lier
60,Mechelsesteenweg 365,2022-01-31,18:00:00,18,12,6,FMN GV 05 Lier
60,Mechelsesteenweg 365,2022-01-31,19:00:00,6,4,2,FMN GV 05 Lier
60,Mechelsesteenweg 365,2022-01-31,20:00:00,2,0,2,FMN GV 05 Lier
60,Mechelsesteenweg 365,2022-01-31,21:00:00,2,2,0,FMN GV 05 Lier
60,Mechelsesteenweg 365,2022-01-31,22:00:00,0,0,0,FMN GV 05 Lier
60,Mechelsesteenweg 365,2022-01-31,23:00:00,2,2,0,FMN GV 05 Lier
60,Mechelsesteenweg 365,2022-02-01,00:00:00,2,2,0,FMN GV 05 Lier
60,Mechelsesteenweg 365,2022-02-01,01:00:00,0,0,0,FMN GV 05 Lier
60,Mechelsesteenweg 365,2022-02-01,02:00:00,0,0,0,FMN GV 05 Lier
60,Mechelsesteenweg 365,2022-02-01,03:00:00,2,0,2,FMN GV 05 Lier
60,Mechelsesteenweg 365,2022-02-01,04:00:00,0,0,0,FMN GV 05 Lier
60,Mechelsesteenweg 365,2022-02-01,05:00:00,2,0,2,FMN GV 05 Lier
60,Mechelsesteenweg 365,2022-02-01,06:00:00,12,2,10,FMN GV 05 Lier
60,Mechelsesteenweg 365,2022-02-01,07:00:00,94,64,30,FMN GV 05 Lier
60,Mechelsesteenweg 365,2022-02-01,08:00:00,90,64,26,FMN GV 05 Lier
60,Mechelsesteenweg 365,2022-02-01,09:00:00,18,16,2,FMN GV 05 Lier
60,Mechelsesteenweg 365,2022-02-01,10:00:00,8,0,8,FMN GV 05 Lier
60,Mechelsesteenweg 365,2022-02-01,11:00:00,18,10,8,FMN GV 05 Lier
60,Mechelsesteenweg 365,2022-02-01,12:00:00,24,8,16,FMN GV 05 Lier
60,Mechelsesteenweg 365,2022-02-01,13:00:00,34,22,12,FMN GV 05 Lier
60,Mechelsesteenweg 365,2022-02-01,14:00:00,34,18,16,FMN GV 05 Lier
60,Mechelsesteenweg 365,2022-02-01,15:00:00,82,20,62,FMN GV 05 Lier
60,Mechelsesteenweg 365,2022-02-01,16:00:00,198,76,122,FMN GV 05 Lier
60,Mechelsesteenweg 365,2022-02-01,17:00:00,66,36,30,FMN GV 05 Lier
60,Mechelsesteenweg 365,2022-02-01,18:00:00,28,16,12,FMN GV 05 Lier
60,Mechelsesteenweg 365,2022-02-01,19:00:00,8,0,8,FMN GV 05 Lier
60,Mechelsesteenweg 365,2022-02-01,20:00:00,4,2,2,FMN GV 05 Lier
60,Mechelsesteenweg 365,2022-02-01,21:00:00,0,0,0,FMN GV 05 Lier
60,Mechelsesteenweg 365,2022-02-01,22:00:00,2,2,0,FMN GV 05 Lier
60,Mechelsesteenweg 365,2022-02-01,23:00:00,4,4,0,FMN GV 05 Lier
60,Mechelsesteenweg 365,2022-02-02,00:00:00,2,2,0,FMN GV 05 Lier
60,Mechelsesteenweg 365,2022-02-02,01:00:00,0,0,0,FMN GV 05 Lier
60,Mechelsesteenweg 365,2022-02-02,02:00:00,0,0,0,FMN GV 05 Lier
60,Mechelsesteenweg 365,2022-02-02,03:00:00,2,0,2,FMN GV 05 Lier
60,Mechelsesteenweg 365,2022-02-02,04:00:00,2,0,2,FMN GV 05 Lier
60,Mechelsesteenweg 365,2022-02-02,05:00:00,2,2,0,FMN GV 05 Lier
60,Mechelsesteenweg 365,2022-02-02,06:00:00,20,6,14,FMN GV 05 Lier
60,Mechelsesteenweg 365,2022-02-02,07:00:00,114,84,30,FMN GV 05 Lier
60,Mechelsesteenweg 365,2022-02-02,08:00:00,162,128,34,FMN GV 05 Lier
60,Mechelsesteenweg 365,2022-02-02,09:00:00,50,24,26,FMN GV 05 Lier
60,Mechelsesteenweg 365,2022-02-02,10:00:00,58,26,32,FMN GV 05 Lier
60,Mechelsesteenweg 365,2022-02-02,11:00:00,66,26,40,FMN GV 05 Lier
60,Mechelsesteenweg 365,2022-02-02,12:00:00,190,34,156,FMN GV 05 Lier
60,Mechelsesteenweg 365,2022-02-02,13:00:00,96,52,44,FMN GV 05 Lier
60,Mechelsesteenweg 365,2022-02-02,14:00:00,82,44,38,FMN GV 05 Lier
60,Mechelsesteenweg 365,2022-02-02,15:00:00,60,34,26,FMN GV 05 Lier
60,Mechelsesteenweg 365,2022-02-02,16:00:00,78,52,26,FMN GV 05 Lier
60,Mechelsesteenweg 365,2022-02-02,17:00:00,72,36,36,FMN GV 05 Lier
60,Mechelsesteenweg 365,2022-02-02,18:00:00,18,6,12,FMN GV 05 Lier
60,Mechelsesteenweg 365,2022-02-02,19:00:00,18,18,0,FMN GV 05 Lier
60,Mechelsesteenweg 365,2022-02-02,20:00:00,8,6,2,FMN GV 05 Lier
60,Mechelsesteenweg 365,2022-02-02,21:00:00,2,0,2,FMN GV 05 Lier
60,Mechelsesteenweg 365,2022-02-02,22:00:00,2,0,2,FMN GV 05 Lier
60,Mechelsesteenweg 365,2022-02-02,23:00:00,6,6,0,FMN GV 05 Lier
60,Mechelsesteenweg 365,2022-02-03,00:00:00,0,0,0,FMN GV 05 Lier
60,Mechelsesteenweg 365,2022-02-03,01:00:00,0,0,0,FMN GV 05 Lier
60,Mechelsesteenweg 365,2022-02-03,02:00:00,0,0,0,FMN GV 05 Lier
60,Mechelsesteenweg 365,2022-02-03,03:00:00,0,0,0,FMN GV 05 Lier
60,Mechelsesteenweg 365,2022-02-03,04:00:00,4,0,4,FMN GV 05 Lier
60,Mechelsesteenweg 365,2022-02-03,05:00:00,4,0,4,FMN GV 05 Lier
60,Mechelsesteenweg 365,2022-02-03,06:00:00,8,4,4,FMN GV 05 Lier
60,Mechelsesteenweg 365,2022-02-03,07:00:00,112,76,36,FMN GV 05 Lier
60,Mechelsesteenweg 365,2022-02-03,08:00:00,126,96,30,FMN GV 05 Lier
60,Mechelsesteenweg 365,2022-02-03,09:00:00,38,32,6,FMN GV 05 Lier
60,Mechelsesteenweg 365,2022-02-03,10:00:00,42,26,16,FMN GV 05 Lier
60,Mechelsesteenweg 365,2022-02-03,11:00:00,38,28,10,FMN GV 05 Lier
60,Mechelsesteenweg 365,2022-02-03,12:00:00,78,32,46,FMN GV 05 Lier
60,Mechelsesteenweg 365,2022-02-03,13:00:00,72,24,48,FMN GV 05 Lier
60,Mechelsesteenweg 365,2022-02-03,14:00:00,78,42,36,FMN GV 05 Lier
60,Mechelsesteenweg 365,2022-02-03,15:00:00,102,42,60,FMN GV 05 Lier
60,Mechelsesteenweg 365,2022-02-03,16:00:00,110,32,78,FMN GV 05 Lier
60,Mechelsesteenweg 365,2022-02-03,17:00:00,76,38,38,FMN GV 05 Lier
60,Mechelsesteenweg 365,2022-02-03,18:00:00,38,28,10,FMN GV 05 Lier
60,Mechelsesteenweg 365,2022-02-03,19:00:00,10,4,6,FMN GV 05 Lier
60,Mechelsesteenweg 365,2022-02-03,20:00:00,12,6,6,FMN GV 05 Lier
60,Mechelsesteenweg 365,2022-02-03,21:00:00,4,0,4,FMN GV 05 Lier
60,Mechelsesteenweg 365,2022-02-03,22:00:00,8,0,8,FMN GV 05 Lier
60,Mechelsesteenweg 365,2022-02-03,23:00:00,8,8,0,FMN GV 05 Lier
60,Mechelsesteenweg 365,2022-02-04,00:00:00,6,6,0,FMN GV 05 Lier
60,Mechelsesteenweg 365,2022-02-04,01:00:00,0,0,0,FMN GV 05 Lier
60,Mechelsesteenweg 365,2022-02-04,02:00:00,0,0,0,FMN GV 05 Lier
60,Mechelsesteenweg 365,2022-02-04,03:00:00,2,0,2,FMN GV 05 Lier
60,Mechelsesteenweg 365,2022-02-04,04:00:00,2,0,2,FMN GV 05 Lier
60,Mechelsesteenweg 365,2022-02-04,05:00:00,4,2,2,FMN GV 05 Lier
60,Mechelsesteenweg 365,2022-02-04,06:00:00,10,4,6,FMN GV 05 Lier
60,Mechelsesteenweg 365,2022-02-04,07:00:00,116,76,40,FMN GV 05 Lier
60,Mechelsesteenweg 365,2022-02-04,08:00:00,92,80,12,FMN GV 05 Lier
60,Mechelsesteenweg 365,2022-02-04,09:00:00,30,22,8,FMN GV 05 Lier
60,Mechelsesteenweg 365,2022-02-04,10:00:00,44,18,26,FMN GV 05 Lier
60,Mechelsesteenweg 365,2022-02-04,11:00:00,16,6,10,FMN GV 05 Lier
60,Mechelsesteenweg 365,2022-02-04,12:00:00,44,24,20,FMN GV 05 Lier
60,Mechelsesteenweg 365,2022-02-04,13:00:00,20,10,10,FMN GV 05 Lier
60,Mechelsesteenweg 365,2022-02-04,14:00:00,22,8,14,FMN GV 05 Lier
60,Mechelsesteenweg 365,2022-02-04,15:00:00,48,16,32,FMN GV 05 Lier
60,Mechelsesteenweg 365,2022-02-04,16:00:00,130,44,86,FMN GV 05 Lier
60,Mechelsesteenweg 365,2022-02-04,17:00:00,40,20,20,FMN GV 05 Lier
60,Mechelsesteenweg 365,2022-02-04,18:00:00,22,6,16,FMN GV 05 Lier
60,Mechelsesteenweg 365,2022-02-04,19:00:00,8,2,6,FMN GV 05 Lier
60,Mechelsesteenweg 365,2022-02-04,20:00:00,4,4,0,FMN GV 05 Lier
60,Mechelsesteenweg 365,2022-02-04,21:00:00,8,4,4,FMN GV 05 Lier
60,Mechelsesteenweg 365,2022-02-04,22:00:00,10,2,8,FMN GV 05 Lier
60,Mechelsesteenweg 365,2022-02-04,23:00:00,4,0,4,FMN GV 05 Lier
60,Mechelsesteenweg 365,2022-02-05,00:00:00,2,0,2,FMN GV 05 Lier
60,Mechelsesteenweg 365,2022-02-05,01:00:00,0,0,0,FMN GV 05 Lier
60,Mechelsesteenweg 365,2022-02-05,02:00:00,2,0,2,FMN GV 05 Lier
60,Mechelsesteenweg 365,2022-02-05,03:00:00,0,0,0,FMN GV 05 Lier
60,Mechelsesteenweg 365,2022-02-05,04:00:00,0,0,0,FMN GV 05 Lier
60,Mechelsesteenweg 365,2022-02-05,05:00:00,2,0,2,FMN GV 05 Lier
60,Mechelsesteenweg 365,2022-02-05,06:00:00,2,0,2,FMN GV 05 Lier
60,Mechelsesteenweg 365,2022-02-05,07:00:00,18,0,18,FMN GV 05 Lier
60,Mechelsesteenweg 365,2022-02-05,08:00:00,16,6,10,FMN GV 05 Lier
60,Mechelsesteenweg 365,2022-02-05,09:00:00,62,28,34,FMN GV 05 Lier
60,Mechelsesteenweg 365,2022-02-05,10:00:00,170,96,74,FMN GV 05 Lier
60,Mechelsesteenweg 365,2022-02-05,11:00:00,250,118,132,FMN GV 05 Lier
60,Mechelsesteenweg 365,2022-02-05,12:00:00,238,118,120,FMN GV 05 Lier
60,Mechelsesteenweg 365,2022-02-05,13:00:00,302,160,142,FMN GV 05 Lier
60,Mechelsesteenweg 365,2022-02-05,14:00:00,334,182,152,FMN GV 05 Lier
60,Mechelsesteenweg 365,2022-02-05,15:00:00,292,142,150,FMN GV 05 Lier
60,Mechelsesteenweg 365,2022-02-05,16:00:00,158,92,66,FMN GV 05 Lier
60,Mechelsesteenweg 365,2022-02-05,17:00:00,76,36,40,FMN GV 05 Lier
60,Mechelsesteenweg 365,2022-02-05,18:00:00,18,8,10,FMN GV 05 Lier
60,Mechelsesteenweg 365,2022-02-05,19:00:00,2,2,0,FMN GV 05 Lier
60,Mechelsesteenweg 365,2022-02-05,20:00:00,0,0,0,FMN GV 05 Lier
60,Mechelsesteenweg 365,2022-02-05,21:00:00,2,2,0,FMN GV 05 Lier
60,Mechelsesteenweg 365,2022-02-05,22:00:00,0,0,0,FMN GV 05 Lier
60,Mechelsesteenweg 365,2022-02-05,23:00:00,4,0,4,FMN GV 05 Lier
60,Mechelsesteenweg 365,2022-02-06,00:00:00,0,0,0,FMN GV 05 Lier
60,Mechelsesteenweg 365,2022-02-06,01:00:00,0,0,0,FMN GV 05 Lier
60,Mechelsesteenweg 365,2022-02-06,02:00:00,0,0,0,FMN GV 05 Lier
60,Mechelsesteenweg 365,2022-02-06,03:00:00,0,0,0,FMN GV 05 Lier
60,Mechelsesteenweg 365,2022-02-06,04:00:00,0,0,0,FMN GV 05 Lier
60,Mechelsesteenweg 365,2022-02-06,05:00:00,0,0,0,FMN GV 05 Lier
60,Mechelsesteenweg 365,2022-02-06,06:00:00,4,0,4,FMN GV 05 Lier
60,Mechelsesteenweg 365,2022-02-06,07:00:00,0,0,0,FMN GV 05 Lier
60,Mechelsesteenweg 365,2022-02-06,08:00:00,2,2,0,FMN GV 05 Lier
60,Mechelsesteenweg 365,2022-02-06,09:00:00,6,6,0,FMN GV 05 Lier
60,Mechelsesteenweg 365,2022-02-06,10:00:00,16,2,14,FMN GV 05 Lier
60,Mechelsesteenweg 365,2022-02-06,11:00:00,0,0,0,FMN GV 05 Lier
60,Mechelsesteenweg 365,2022-02-06,12:00:00,10,6,4,FMN GV 05 Lier
60,Mechelsesteenweg 365,2022-02-06,13:00:00,4,0,4,FMN GV 05 Lier
60,Mechelsesteenweg 365,2022-02-06,14:00:00,0,0,0,FMN GV 05 Lier
60,Mechelsesteenweg 365,2022-02-06,15:00:00,2,0,2,FMN GV 05 Lier
60,Mechelsesteenweg 365,2022-02-06,16:00:00,12,12,0,FMN GV 05 Lier
60,Mechelsesteenweg 365,2022-02-06,17:00:00,18,8,10,FMN GV 05 Lier
60,Mechelsesteenweg 365,2022-02-06,18:00:00,4,0,4,FMN GV 05 Lier
60,Mechelsesteenweg 365,2022-02-06,19:00:00,2,2,0,FMN GV 05 Lier
60,Mechelsesteenweg 365,2022-02-06,20:00:00,2,2,0,FMN GV 05 Lier
60,Mechelsesteenweg 365,2022-02-06,21:00:00,0,0,0,FMN GV 05 Lier
60,Mechelsesteenweg 365,2022-02-06,22:00:00,0,0,0,FMN GV 05 Lier
60,Mechelsesteenweg 365,2022-02-06,23:00:00,0,0,0,FMN GV 05 Lier
60,Mechelsesteenweg 365,2022-02-07,00:00:00,0,0,0,FMN GV 05 Lier
60,Mechelsesteenweg 365,2022-02-07,01:00:00,0,0,0,FMN GV 05 Lier
60,Mechelsesteenweg 365,2022-02-07,02:00:00,0,0,0,FMN GV 05 Lier
60,Mechelsesteenweg 365,2022-02-07,03:00:00,0,0,0,FMN GV 05 Lier
60,Mechelsesteenweg 365,2022-02-07,04:00:00,2,0,2,FMN GV 05 Lier
60,Mechelsesteenweg 365,2022-02-07,05:00:00,6,0,6,FMN GV 05 Lier
60,Mechelsesteenweg 365,2022-02-07,06:00:00,10,2,8,FMN GV 05 Lier
60,Mechelsesteenweg 365,2022-02-07,07:00:00,54,14,40,FMN GV 05 Lier
60,Mechelsesteenweg 365,2022-02-07,08:00:00,56,28,28,FMN GV 05 Lier
60,Mechelsesteenweg 365,2022-02-07,09:00:00,36,10,26,FMN GV 05 Lier
60,Mechelsesteenweg 365,2022-02-07,10:00:00,60,24,36,FMN GV 05 Lier
60,Mechelsesteenweg 365,2022-02-07,11:00:00,116,58,58,FMN GV 05 Lier
60,Mechelsesteenweg 365,2022-02-07,12:00:00,116,64,52,FMN GV 05 Lier
60,Mechelsesteenweg 365,2022-02-07,13:00:00,198,106,92,FMN GV 05 Lier
60,Mechelsesteenweg 365,2022-02-07,14:00:00,230,126,104,FMN GV 05 Lier
60,Mechelsesteenweg 365,2022-02-07,15:00:00,210,122,88,FMN GV 05 Lier
60,Mechelsesteenweg 365,2022-02-07,16:00:00,164,114,50,FMN GV 05 Lier
60,Mechelsesteenweg 365,2022-02-07,17:00:00,96,58,38,FMN GV 05 Lier
60,Mechelsesteenweg 365,2022-02-07,18:00:00,44,26,18,FMN GV 05 Lier
60,Mechelsesteenweg 365,2022-02-07,19:00:00,6,6,0,FMN GV 05 Lier
60,Mechelsesteenweg 365,2022-02-07,20:00:00,6,4,2,FMN GV 05 Lier
60,Mechelsesteenweg 365,2022-02-07,21:00:00,8,6,2,FMN GV 05 Lier
60,Mechelsesteenweg 365,2022-02-07,22:00:00,6,2,4,FMN GV 05 Lier
60,Mechelsesteenweg 365,2022-02-07,23:00:00,2,2,0,FMN GV 05 Lier
60,Mechelsesteenweg 365,2022-02-08,00:00:00,0,0,0,FMN GV 05 Lier
60,Mechelsesteenweg 365,2022-02-08,01:00:00,0,0,0,FMN GV 05 Lier
60,Mechelsesteenweg 365,2022-02-08,02:00:00,0,0,0,FMN GV 05 Lier
60,Mechelsesteenweg 365,2022-02-08,03:00:00,0,0,0,FMN GV 05 Lier
60,Mechelsesteenweg 365,2022-02-08,04:00:00,4,0,4,FMN GV 05 Lier
60,Mechelsesteenweg 365,2022-02-08,05:00:00,2,0,2,FMN GV 05 Lier
60,Mechelsesteenweg 365,2022-02-08,06:00:00,16,2,14,FMN GV 05 Lier
60,Mechelsesteenweg 365,2022-02-08,07:00:00,130,84,46,FMN GV 05 Lier
60,Mechelsesteenweg 365,2022-02-08,08:00:00,144,100,44,FMN GV 05 Lier
60,Mechelsesteenweg 365,2022-02-08,09:00:00,52,32,20,FMN GV 05 Lier
60,Mechelsesteenweg 365,2022-02-08,10:00:00,74,52,22,FMN GV 05 Lier
60,Mechelsesteenweg 365,2022-02-08,11:00:00,34,10,24,FMN GV 05 Lier
60,Mechelsesteenweg 365,2022-02-08,12:00:00,68,34,34,FMN GV 05 Lier
60,Mechelsesteenweg 365,2022-02-08,13:00:00,100,62,38,FMN GV 05 Lier
60,Mechelsesteenweg 365,2022-02-08,14:00:00,78,54,24,FMN GV 05 Lier
60,Mechelsesteenweg 365,2022-02-08,15:00:00,170,58,112,FMN GV 05 Lier
60,Mechelsesteenweg 365,2022-02-08,16:00:00,220,64,156,FMN GV 05 Lier
60,Mechelsesteenweg 365,2022-02-08,17:00:00,82,46,36,FMN GV 05 Lier
60,Mechelsesteenweg 365,2022-02-08,18:00:00,36,22,14,FMN GV 05 Lier
60,Mechelsesteenweg 365,2022-02-08,19:00:00,6,6,0,FMN GV 05 Lier
60,Mechelsesteenweg 365,2022-02-08,20:00:00,12,10,2,FMN GV 05 Lier
60,Mechelsesteenweg 365,2022-02-08,21:00:00,6,2,4,FMN GV 05 Lier
60,Mechelsesteenweg 365,2022-02-08,22:00:00,4,2,2,FMN GV 05 Lier
60,Mechelsesteenweg 365,2022-02-08,23:00:00,4,0,4,FMN GV 05 Lier
60,Mechelsesteenweg 365,2022-02-09,00:00:00,0,0,0,FMN GV 05 Lier
60,Mechelsesteenweg 365,2022-02-09,01:00:00,0,0,0,FMN GV 05 Lier
60,Mechelsesteenweg 365,2022-02-09,02:00:00,0,0,0,FMN GV 05 Lier
60,Mechelsesteenweg 365,2022-02-09,03:00:00,2,0,2,FMN GV 05 Lier
60,Mechelsesteenweg 365,2022-02-09,04:00:00,2,0,2,FMN GV 05 Lier
60,Mechelsesteenweg 365,2022-02-09,05:00:00,10,0,10,FMN GV 05 Lier
60,Mechelsesteenweg 365,2022-02-09,06:00:00,12,2,10,FMN GV 05 Lier
60,Mechelsesteenweg 365,2022-02-09,07:00:00,116,68,48,FMN GV 05 Lier
60,Mechelsesteenweg 365,2022-02-09,08:00:00,132,108,24,FMN GV 05 Lier
60,Mechelsesteenweg 365,2022-02-09,09:00:00,42,28,14,FMN GV 05 Lier
60,Mechelsesteenweg 365,2022-02-09,10:00:00,76,46,30,FMN GV 05 Lier
60,Mechelsesteenweg 365,2022-02-09,11:00:00,86,48,38,FMN GV 05 Lier
60,Mechelsesteenweg 365,2022-02-09,12:00:00,178,42,136,FMN GV 05 Lier
60,Mechelsesteenweg 365,2022-02-09,13:00:00,114,44,70,FMN GV 05 Lier
60,Mechelsesteenweg 365,2022-02-09,14:00:00,220,100,120,FMN GV 05 Lier
60,Mechelsesteenweg 365,2022-02-09,15:00:00,172,92,80,FMN GV 05 Lier
60,Mechelsesteenweg 365,2022-02-09,16:00:00,164,84,80,FMN GV 05 Lier
60,Mechelsesteenweg 365,2022-02-09,17:00:00,106,70,36,FMN GV 05 Lier
60,Mechelsesteenweg 365,2022-02-09,18:00:00,22,10,12,FMN GV 05 Lier
60,Mechelsesteenweg 365,2022-02-09,19:00:00,20,16,4,FMN GV 05 Lier
60,Mechelsesteenweg 365,2022-02-09,20:00:00,26,14,12,FMN GV 05 Lier
60,Mechelsesteenweg 365,2022-02-09,21:00:00,6,0,6,FMN GV 05 Lier
60,Mechelsesteenweg 365,2022-02-09,22:00:00,2,2,0,FMN GV 05 Lier
60,Mechelsesteenweg 365,2022-02-09,23:00:00,4,4,0,FMN GV 05 Lier
60,Mechelsesteenweg 365,2022-02-10,00:00:00,0,0,0,FMN GV 05 Lier
60,Mechelsesteenweg 365,2022-02-10,01:00:00,0,0,0,FMN GV 05 Lier
60,Mechelsesteenweg 365,2022-02-10,02:00:00,0,0,0,FMN GV 05 Lier
60,Mechelsesteenweg 365,2022-02-10,03:00:00,2,0,2,FMN GV 05 Lier
60,Mechelsesteenweg 365,2022-02-10,04:00:00,4,0,4,FMN GV 05 Lier
60,Mechelsesteenweg 365,2022-02-10,05:00:00,10,0,10,FMN GV 05 Lier
60,Mechelsesteenweg 365,2022-02-10,06:00:00,18,2,16,FMN GV 05 Lier
60,Mechelsesteenweg 365,2022-02-10,07:00:00,104,66,38,FMN GV 05 Lier
60,Mechelsesteenweg 365,2022-02-10,08:00:00,130,98,32,FMN GV 05 Lier
60,Mechelsesteenweg 365,2022-02-10,09:00:00,8,2,6,FMN GV 05 Lier
60,Mechelsesteenweg 365,2022-02-10,10:00:00,2,0,2,FMN GV 05 Lier
60,Mechelsesteenweg 365,2022-02-10,11:00:00,6,0,6,FMN GV 05 Lier
60,Mechelsesteenweg 365,2022-02-10,12:00:00,6,2,4,FMN GV 05 Lier
60,Mechelsesteenweg 365,2022-02-10,13:00:00,2,0,2,FMN GV 05 Lier
60,Mechelsesteenweg 365,2022-02-10,14:00:00,8,2,6,FMN GV 05 Lier
60,Mechelsesteenweg 365,2022-02-10,15:00:00,20,8,12,FMN GV 05 Lier
60,Mechelsesteenweg 365,2022-02-10,16:00:00,12,2,10,FMN GV 05 Lier
60,Mechelsesteenweg 365,2022-02-10,17:00:00,36,16,20,FMN GV 05 Lier
60,Mechelsesteenweg 365,2022-02-10,18:00:00,18,2,16,FMN GV 05 Lier
60,Mechelsesteenweg 365,2022-02-10,19:00:00,8,6,2,FMN GV 05 Lier
60,Mechelsesteenweg 365,2022-02-10,20:00:00,4,2,2,FMN GV 05 Lier
60,Mechelsesteenweg 365,2022-02-10,21:00:00,2,0,2,FMN GV 05 Lier
60,Mechelsesteenweg 365,2022-02-10,22:00:00,2,0,2,FMN GV 05 Lier
60,Mechelsesteenweg 365,2022-02-10,23:00:00,2,2,0,FMN GV 05 Lier
60,Mechelsesteenweg 365,2022-02-11,00:00:00,4,2,2,FMN GV 05 Lier
60,Mechelsesteenweg 365,2022-02-11,01:00:00,0,0,0,FMN GV 05 Lier
60,Mechelsesteenweg 365,2022-02-11,02:00:00,0,0,0,FMN GV 05 Lier
60,Mechelsesteenweg 365,2022-02-11,03:00:00,2,0,2,FMN GV 05 Lier
60,Mechelsesteenweg 365,2022-02-11,04:00:00,0,0,0,FMN GV 05 Lier
60,Mechelsesteenweg 365,2022-02-11,05:00:00,6,0,6,FMN GV 05 Lier
60,Mechelsesteenweg 365,2022-02-11,06:00:00,16,2,14,FMN GV 05 Lier
60,Mechelsesteenweg 365,2022-02-11,07:00:00,98,58,40,FMN GV 05 Lier
60,Mechelsesteenweg 365,2022-02-11,08:00:00,102,74,28,FMN GV 05 Lier
60,Mechelsesteenweg 365,2022-02-11,09:00:00,36,20,16,FMN GV 05 Lier
60,Mechelsesteenweg 365,2022-02-11,10:00:00,62,36,26,FMN GV 05 Lier
60,Mechelsesteenweg 365,2022-02-11,11:00:00,60,36,24,FMN GV 05 Lier
60,Mechelsesteenweg 365,2022-02-11,12:00:00,72,34,38,FMN GV 05 Lier
60,Mechelsesteenweg 365,2022-02-11,13:00:00,108,58,50,FMN GV 05 Lier
60,Mechelsesteenweg 365,2022-02-11,14:00:00,160,100,60,FMN GV 05 Lier
60,Mechelsesteenweg 365,2022-02-11,15:00:00,208,92,116,FMN GV 05 Lier
60,Mechelsesteenweg 365,2022-02-11,16:00:00,218,82,136,FMN GV 05 Lier
60,Mechelsesteenweg 365,2022-02-11,17:00:00,84,32,52,FMN GV 05 Lier
60,Mechelsesteenweg 365,2022-02-11,18:00:00,28,14,14,FMN GV 05 Lier
60,Mechelsesteenweg 365,2022-02-11,19:00:00,12,10,2,FMN GV 05 Lier
60,Mechelsesteenweg 365,2022-02-11,20:00:00,8,2,6,FMN GV 05 Lier
60,Mechelsesteenweg 365,2022-02-11,21:00:00,12,6,6,FMN GV 05 Lier
60,Mechelsesteenweg 365,2022-02-11,22:00:00,12,8,4,FMN GV 05 Lier
60,Mechelsesteenweg 365,2022-02-11,23:00:00,2,2,0,FMN GV 05 Lier
60,Mechelsesteenweg 365,2022-02-12,00:00:00,16,16,0,FMN GV 05 Lier
60,Mechelsesteenweg 365,2022-02-12,01:00:00,2,2,0,FMN GV 05 Lier
60,Mechelsesteenweg 365,2022-02-12,02:00:00,0,0,0,FMN GV 05 Lier
60,Mechelsesteenweg 365,2022-02-12,03:00:00,0,0,0,FMN GV 05 Lier
60,Mechelsesteenweg 365,2022-02-12,04:00:00,0,0,0,FMN GV 05 Lier
60,Mechelsesteenweg 365,2022-02-12,05:00:00,2,0,2,FMN GV 05 Lier
60,Mechelsesteenweg 365,2022-02-12,06:00:00,2,0,2,FMN GV 05 Lier
60,Mechelsesteenweg 365,2022-02-12,07:00:00,12,6,6,FMN GV 05 Lier
60,Mechelsesteenweg 365,2022-02-12,08:00:00,10,0,10,FMN GV 05 Lier
60,Mechelsesteenweg 365,2022-02-12,09:00:00,42,16,26,FMN GV 05 Lier
60,Mechelsesteenweg 365,2022-02-12,10:00:00,134,80,54,FMN GV 05 Lier
60,Mechelsesteenweg 365,2022-02-12,11:00:00,148,88,60,FMN GV 05 Lier
60,Mechelsesteenweg 365,2022-02-12,12:00:00,198,86,112,FMN GV 05 Lier
60,Mechelsesteenweg 365,2022-02-12,13:00:00,242,150,92,FMN GV 05 Lier
60,Mechelsesteenweg 365,2022-02-12,14:00:00,370,204,166,FMN GV 05 Lier
60,Mechelsesteenweg 365,2022-02-12,15:00:00,278,146,132,FMN GV 05 Lier
60,Mechelsesteenweg 365,2022-02-12,16:00:00,226,100,126,FMN GV 05 Lier
60,Mechelsesteenweg 365,2022-02-12,17:00:00,60,30,30,FMN GV 05 Lier
60,Mechelsesteenweg 365,2022-02-12,18:00:00,14,10,4,FMN GV 05 Lier
60,Mechelsesteenweg 365,2022-02-12,19:00:00,0,0,0,FMN GV 05 Lier
60,Mechelsesteenweg 365,2022-02-12,20:00:00,6,2,4,FMN GV 05 Lier
60,Mechelsesteenweg 365,2022-02-12,21:00:00,0,0,0,FMN GV 05 Lier
60,Mechelsesteenweg 365,2022-02-12,22:00:00,0,0,0,FMN GV 05 Lier
60,Mechelsesteenweg 365,2022-02-12,23:00:00,2,0,2,FMN GV 05 Lier
60,Mechelsesteenweg 365,2022-02-13,00:00:00,4,2,2,FMN GV 05 Lier
60,Mechelsesteenweg 365,2022-02-13,01:00:00,0,0,0,FMN GV 05 Lier
60,Mechelsesteenweg 365,2022-02-13,02:00:00,0,0,0,FMN GV 05 Lier
60,Mechelsesteenweg 365,2022-02-13,03:00:00,0,0,0,FMN GV 05 Lier
60,Mechelsesteenweg 365,2022-02-13,04:00:00,0,0,0,FMN GV 05 Lier
60,Mechelsesteenweg 365,2022-02-13,05:00:00,0,0,0,FMN GV 05 Lier
60,Mechelsesteenweg 365,2022-02-13,06:00:00,4,0,4,FMN GV 05 Lier
60,Mechelsesteenweg 365,2022-02-13,07:00:00,8,6,2,FMN GV 05 Lier
60,Mechelsesteenweg 365,2022-02-13,08:00:00,14,6,8,FMN GV 05 Lier
60,Mechelsesteenweg 365,2022-02-13,09:00:00,120,54,66,FMN GV 05 Lier
60,Mechelsesteenweg 365,2022-02-13,10:00:00,226,94,132,FMN GV 05 Lier
60,Mechelsesteenweg 365,2022-02-13,11:00:00,256,124,132,FMN GV 05 Lier
60,Mechelsesteenweg 365,2022-02-13,12:00:00,154,76,78,FMN GV 05 Lier
60,Mechelsesteenweg 365,2022-02-13,13:00:00,152,80,72,FMN GV 05 Lier
60,Mechelsesteenweg 365,2022-02-13,14:00:00,222,142,80,FMN GV 05 Lier
60,Mechelsesteenweg 365,2022-02-13,15:00:00,150,74,76,FMN GV 05 Lier
60,Mechelsesteenweg 365,2022-02-13,16:00:00,94,46,48,FMN GV 05 Lier
60,Mechelsesteenweg 365,2022-02-13,17:00:00,52,16,36,FMN GV 05 Lier
60,Mechelsesteenweg 365,2022-02-13,18:00:00,8,2,6,FMN GV 05 Lier
60,Mechelsesteenweg 365,2022-02-13,19:00:00,10,8,2,FMN GV 05 Lier
60,Mechelsesteenweg 365,2022-02-13,20:00:00,2,0,2,FMN GV 05 Lier
60,Mechelsesteenweg 365,2022-02-13,21:00:00,2,0,2,FMN GV 05 Lier
60,Mechelsesteenweg 365,2022-02-13,22:00:00,0,0,0,FMN GV 05 Lier
60,Mechelsesteenweg 365,2022-02-13,23:00:00,0,0,0,FMN GV 05 Lier
60,Mechelsesteenweg 365,2022-02-14,00:00:00,0,0,0,FMN GV 05 Lier
60,Mechelsesteenweg 365,2022-02-14,01:00:00,0,0,0,FMN GV 05 Lier
60,Mechelsesteenweg 365,2022-02-14,02:00:00,0,0,0,FMN GV 05 Lier
60,Mechelsesteenweg 365,2022-02-14,03:00:00,0,0,0,FMN GV 05 Lier
60,Mechelsesteenweg 365,2022-02-14,04:00:00,0,0,0,FMN GV 05 Lier
60,Mechelsesteenweg 365,2022-02-14,05:00:00,2,0,2,FMN GV 05 Lier
60,Mechelsesteenweg 365,2022-02-14,06:00:00,6,0,6,FMN GV 05 Lier
60,Mechelsesteenweg 365,2022-02-14,07:00:00,70,52,18,FMN GV 05 Lier
60,Mechelsesteenweg 365,2022-02-14,08:00:00,104,70,34,FMN GV 05 Lier
60,Mechelsesteenweg 365,2022-02-14,09:00:00,24,8,16,FMN GV 05 Lier
60,Mechelsesteenweg 365,2022-02-14,10:00:00,20,8,12,FMN GV 05 Lier
60,Mechelsesteenweg 365,2022-02-14,11:00:00,14,4,10,FMN GV 05 Lier
60,Mechelsesteenweg 365,2022-02-14,12:00:00,44,18,26,FMN GV 05 Lier
60,Mechelsesteenweg 365,2022-02-14,13:00:00,70,40,30,FMN GV 05 Lier
60,Mechelsesteenweg 365,2022-02-14,14:00:00,54,26,28,FMN GV 05 Lier
60,Mechelsesteenweg 365,2022-02-14,15:00:00,66,20,46,FMN GV 05 Lier
60,Mechelsesteenweg 365,2022-02-14,16:00:00,142,44,98,FMN GV 05 Lier
60,Mechelsesteenweg 365,2022-02-14,17:00:00,84,44,40,FMN GV 05 Lier
60,Mechelsesteenweg 365,2022-02-14,18:00:00,32,18,14,FMN GV 05 Lier
60,Mechelsesteenweg 365,2022-02-14,19:00:00,16,6,10,FMN GV 05 Lier
60,Mechelsesteenweg 365,2022-02-14,20:00:00,16,8,8,FMN GV 05 Lier
60,Mechelsesteenweg 365,2022-02-14,21:00:00,4,2,2,FMN GV 05 Lier
60,Mechelsesteenweg 365,2022-02-14,22:00:00,0,0,0,FMN GV 05 Lier
60,Mechelsesteenweg 365,2022-02-14,23:00:00,2,2,0,FMN GV 05 Lier
60,Mechelsesteenweg 365,2022-02-15,00:00:00,2,2,0,FMN GV 05 Lier
60,Mechelsesteenweg 365,2022-02-15,01:00:00,0,0,0,FMN GV 05 Lier
60,Mechelsesteenweg 365,2022-02-15,02:00:00,0,0,0,FMN GV 05 Lier
60,Mechelsesteenweg 365,2022-02-15,03:00:00,0,0,0,FMN GV 05 Lier
60,Mechelsesteenweg 365,2022-02-15,04:00:00,0,0,0,FMN GV 05 Lier
60,Mechelsesteenweg 365,2022-02-15,05:00:00,2,0,2,FMN GV 05 Lier
60,Mechelsesteenweg 365,2022-02-15,06:00:00,24,8,16,FMN GV 05 Lier
60,Mechelsesteenweg 365,2022-02-15,07:00:00,124,70,54,FMN GV 05 Lier
60,Mechelsesteenweg 365,2022-02-15,08:00:00,136,92,44,FMN GV 05 Lier
60,Mechelsesteenweg 365,2022-02-15,09:00:00,76,52,24,FMN GV 05 Lier
60,Mechelsesteenweg 365,2022-02-15,10:00:00,122,68,54,FMN GV 05 Lier
60,Mechelsesteenweg 365,2022-02-15,11:00:00,136,82,54,FMN GV 05 Lier
60,Mechelsesteenweg 365,2022-02-15,12:00:00,98,50,48,FMN GV 05 Lier
60,Mechelsesteenweg 365,2022-02-15,13:00:00,94,58,36,FMN GV 05 Lier
60,Mechelsesteenweg 365,2022-02-15,14:00:00,136,86,50,FMN GV 05 Lier
60,Mechelsesteenweg 365,2022-02-15,15:00:00,92,46,46,FMN GV 05 Lier
60,Mechelsesteenweg 365,2022-02-15,16:00:00,166,58,108,FMN GV 05 Lier
60,Mechelsesteenweg 365,2022-02-15,17:00:00,50,24,26,FMN GV 05 Lier
60,Mechelsesteenweg 365,2022-02-15,18:00:00,40,22,18,FMN GV 05 Lier
60,Mechelsesteenweg 365,2022-02-15,19:00:00,4,4,0,FMN GV 05 Lier
60,Mechelsesteenweg 365,2022-02-15,20:00:00,2,0,2,FMN GV 05 Lier
60,Mechelsesteenweg 365,2022-02-15,21:00:00,0,0,0,FMN GV 05 Lier
60,Mechelsesteenweg 365,2022-02-15,22:00:00,0,0,0,FMN GV 05 Lier
60,Mechelsesteenweg 365,2022-02-15,23:00:00,2,2,0,FMN GV 05 Lier
60,Mechelsesteenweg 365,2022-02-16,00:00:00,0,0,0,FMN GV 05 Lier
60,Mechelsesteenweg 365,2022-02-16,01:00:00,0,0,0,FMN GV 05 Lier
60,Mechelsesteenweg 365,2022-02-16,02:00:00,0,0,0,FMN GV 05 Lier
60,Mechelsesteenweg 365,2022-02-16,03:00:00,0,0,0,FMN GV 05 Lier
60,Mechelsesteenweg 365,2022-02-16,04:00:00,0,0,0,FMN GV 05 Lier
60,Mechelsesteenweg 365,2022-02-16,05:00:00,2,0,2,FMN GV 05 Lier
60,Mechelsesteenweg 365,2022-02-16,06:00:00,12,2,10,FMN GV 05 Lier
60,Mechelsesteenweg 365,2022-02-16,07:00:00,68,44,24,FMN GV 05 Lier
60,Mechelsesteenweg 365,2022-02-16,08:00:00,136,106,30,FMN GV 05 Lier
60,Mechelsesteenweg 365,2022-02-16,09:00:00,14,2,12,FMN GV 05 Lier
60,Mechelsesteenweg 365,2022-02-16,10:00:00,14,8,6,FMN GV 05 Lier
60,Mechelsesteenweg 365,2022-02-16,11:00:00,30,10,20,FMN GV 05 Lier
60,Mechelsesteenweg 365,2022-02-16,12:00:00,132,26,106,FMN GV 05 Lier
60,Mechelsesteenweg 365,2022-02-16,13:00:00,32,4,28,FMN GV 05 Lier
60,Mechelsesteenweg 365,2022-02-16,14:00:00,32,10,22,FMN GV 05 Lier
60,Mechelsesteenweg 365,2022-02-16,15:00:00,48,26,22,FMN GV 05 Lier
60,Mechelsesteenweg 365,2022-02-16,16:00:00,52,36,16,FMN GV 05 Lier
60,Mechelsesteenweg 365,2022-02-16,17:00:00,46,34,12,FMN GV 05 Lier
60,Mechelsesteenweg 365,2022-02-16,18:00:00,26,24,2,FMN GV 05 Lier
60,Mechelsesteenweg 365,2022-02-16,19:00:00,10,10,0,FMN GV 05 Lier
60,Mechelsesteenweg 365,2022-02-16,20:00:00,4,0,4,FMN GV 05 Lier
60,Mechelsesteenweg 365,2022-02-16,21:00:00,6,4,2,FMN GV 05 Lier
60,Mechelsesteenweg 365,2022-02-16,22:00:00,6,2,4,FMN GV 05 Lier
60,Mechelsesteenweg 365,2022-02-16,23:00:00,2,2,0,FMN GV 05 Lier
60,Mechelsesteenweg 365,2022-02-17,00:00:00,2,2,0,FMN GV 05 Lier
60,Mechelsesteenweg 365,2022-02-17,01:00:00,0,0,0,FMN GV 05 Lier
60,Mechelsesteenweg 365,2022-02-17,02:00:00,0,0,0,FMN GV 05 Lier
60,Mechelsesteenweg 365,2022-02-17,03:00:00,2,0,2,FMN GV 05 Lier
60,Mechelsesteenweg 365,2022-02-17,04:00:00,0,0,0,FMN GV 05 Lier
60,Mechelsesteenweg 365,2022-02-17,05:00:00,0,0,0,FMN GV 05 Lier
60,Mechelsesteenweg 365,2022-02-17,06:00:00,10,2,8,FMN GV 05 Lier
60,Mechelsesteenweg 365,2022-02-17,07:00:00,70,42,28,FMN GV 05 Lier
60,Mechelsesteenweg 365,2022-02-17,08:00:00,124,86,38,FMN GV 05 Lier
60,Mechelsesteenweg 365,2022-02-17,09:00:00,58,42,16,FMN GV 05 Lier
60,Mechelsesteenweg 365,2022-02-17,10:00:00,50,34,16,FMN GV 05 Lier
60,Mechelsesteenweg 365,2022-02-17,11:00:00,44,20,24,FMN GV 05 Lier
60,Mechelsesteenweg 365,2022-02-17,12:00:00,34,12,22,FMN GV 05 Lier
60,Mechelsesteenweg 365,2022-02-17,13:00:00,58,40,18,FMN GV 05 Lier
60,Mechelsesteenweg 365,2022-02-17,14:00:00,52,26,26,FMN GV 05 Lier
60,Mechelsesteenweg 365,2022-02-17,15:00:00,78,30,48,FMN GV 05 Lier
60,Mechelsesteenweg 365,2022-02-17,16:00:00,200,78,122,FMN GV 05 Lier
60,Mechelsesteenweg 365,2022-02-17,17:00:00,56,38,18,FMN GV 05 Lier
60,Mechelsesteenweg 365,2022-02-17,18:00:00,34,18,16,FMN GV 05 Lier
60,Mechelsesteenweg 365,2022-02-17,19:00:00,14,10,4,FMN GV 05 Lier
60,Mechelsesteenweg 365,2022-02-17,20:00:00,10,6,4,FMN GV 05 Lier
60,Mechelsesteenweg 365,2022-02-17,21:00:00,6,4,2,FMN GV 05 Lier
60,Mechelsesteenweg 365,2022-02-17,22:00:00,8,6,2,FMN GV 05 Lier
60,Mechelsesteenweg 365,2022-02-17,23:00:00,2,0,2,FMN GV 05 Lier
60,Mechelsesteenweg 365,2022-02-18,00:00:00,4,4,0,FMN GV 05 Lier
60,Mechelsesteenweg 365,2022-02-18,01:00:00,0,0,0,FMN GV 05 Lier
60,Mechelsesteenweg 365,2022-02-18,02:00:00,0,0,0,FMN GV 05 Lier
60,Mechelsesteenweg 365,2022-02-18,03:00:00,0,0,0,FMN GV 05 Lier
60,Mechelsesteenweg 365,2022-02-18,04:00:00,0,0,0,FMN GV 05 Lier
60,Mechelsesteenweg 365,2022-02-18,05:00:00,2,0,2,FMN GV 05 Lier
60,Mechelsesteenweg 365,2022-02-18,06:00:00,8,2,6,FMN GV 05 Lier
60,Mechelsesteenweg 365,2022-02-18,07:00:00,46,28,18,FMN GV 05 Lier
60,Mechelsesteenweg 365,2022-02-18,08:00:00,54,42,12,FMN GV 05 Lier
60,Mechelsesteenweg 365,2022-02-18,09:00:00,28,20,8,FMN GV 05 Lier
60,Mechelsesteenweg 365,2022-02-18,10:00:00,16,8,8,FMN GV 05 Lier
60,Mechelsesteenweg 365,2022-02-18,11:00:00,10,6,4,FMN GV 05 Lier
60,Mechelsesteenweg 365,2022-02-18,12:00:00,32,20,12,FMN GV 05 Lier
60,Mechelsesteenweg 365,2022-02-18,13:00:00,34,12,22,FMN GV 05 Lier
60,Mechelsesteenweg 365,2022-02-18,14:00:00,10,6,4,FMN GV 05 Lier
60,Mechelsesteenweg 365,2022-02-18,15:00:00,10,6,4,FMN GV 05 Lier
60,Mechelsesteenweg 365,2022-02-18,16:00:00,4,2,2,FMN GV 05 Lier
60,Mechelsesteenweg 365,2022-02-18,17:00:00,4,2,2,FMN GV 05 Lier
60,Mechelsesteenweg 365,2022-02-18,18:00:00,0,0,0,FMN GV 05 Lier
60,Mechelsesteenweg 365,2022-02-18,19:00:00,2,2,0,FMN GV 05 Lier
60,Mechelsesteenweg 365,2022-02-18,20:00:00,2,2,0,FMN GV 05 Lier
60,Mechelsesteenweg 365,2022-02-18,21:00:00,0,0,0,FMN GV 05 Lier
60,Mechelsesteenweg 365,2022-02-18,22:00:00,0,0,0,FMN GV 05 Lier
60,Mechelsesteenweg 365,2022-02-18,23:00:00,0,0,0,FMN GV 05 Lier
60,Mechelsesteenweg 365,2022-02-19,00:00:00,0,0,0,FMN GV 05 Lier
60,Mechelsesteenweg 365,2022-02-19,01:00:00,0,0,0,FMN GV 05 Lier
60,Mechelsesteenweg 365,2022-02-19,02:00:00,0,0,0,FMN GV 05 Lier
60,Mechelsesteenweg 365,2022-02-19,03:00:00,0,0,0,FMN GV 05 Lier
60,Mechelsesteenweg 365,2022-02-19,04:00:00,2,0,2,FMN GV 05 Lier
60,Mechelsesteenweg 365,2022-02-19,05:00:00,0,0,0,FMN GV 05 Lier
60,Mechelsesteenweg 365,2022-02-19,06:00:00,0,0,0,FMN GV 05 Lier
60,Mechelsesteenweg 365,2022-02-19,07:00:00,2,0,2,FMN GV 05 Lier
60,Mechelsesteenweg 365,2022-02-19,08:00:00,28,6,22,FMN GV 05 Lier
60,Mechelsesteenweg 365,2022-02-19,09:00:00,80,34,46,FMN GV 05 Lier
60,Mechelsesteenweg 365,2022-02-19,10:00:00,142,82,60,FMN GV 05 Lier
60,Mechelsesteenweg 365,2022-02-19,11:00:00,246,144,102,FMN GV 05 Lier
60,Mechelsesteenweg 365,2022-02-19,12:00:00,146,94,52,FMN GV 05 Lier
60,Mechelsesteenweg 365,2022-02-19,13:00:00,130,80,50,FMN GV 05 Lier
60,Mechelsesteenweg 365,2022-02-19,14:00:00,174,118,56,FMN GV 05 Lier
60,Mechelsesteenweg 365,2022-02-19,15:00:00,110,62,48,FMN GV 05 Lier
60,Mechelsesteenweg 365,2022-02-19,16:00:00,26,24,2,FMN GV 05 Lier
60,Mechelsesteenweg 365,2022-02-19,17:00:00,6,2,4,FMN GV 05 Lier
60,Mechelsesteenweg 365,2022-02-19,18:00:00,2,2,0,FMN GV 05 Lier
60,Mechelsesteenweg 365,2022-02-19,19:00:00,2,0,2,FMN GV 05 Lier
60,Mechelsesteenweg 365,2022-02-19,20:00:00,0,0,0,FMN GV 05 Lier
60,Mechelsesteenweg 365,2022-02-19,21:00:00,2,0,2,FMN GV 05 Lier
60,Mechelsesteenweg 365,2022-02-19,22:00:00,0,0,0,FMN GV 05 Lier
60,Mechelsesteenweg 365,2022-02-19,23:00:00,0,0,0,FMN GV 05 Lier
60,Mechelsesteenweg 365,2022-02-20,00:00:00,0,0,0,FMN GV 05 Lier
60,Mechelsesteenweg 365,2022-02-20,01:00:00,0,0,0,FMN GV 05 Lier
60,Mechelsesteenweg 365,2022-02-20,02:00:00,0,0,0,FMN GV 05 Lier
60,Mechelsesteenweg 365,2022-02-20,03:00:00,0,0,0,FMN GV 05 Lier
60,Mechelsesteenweg 365,2022-02-20,04:00:00,0,0,0,FMN GV 05 Lier
60,Mechelsesteenweg 365,2022-02-20,05:00:00,0,0,0,FMN GV 05 Lier
60,Mechelsesteenweg 365,2022-02-20,06:00:00,2,0,2,FMN GV 05 Lier
60,Mechelsesteenweg 365,2022-02-20,07:00:00,2,2,0,FMN GV 05 Lier
60,Mechelsesteenweg 365,2022-02-20,08:00:00,6,4,2,FMN GV 05 Lier
60,Mechelsesteenweg 365,2022-02-20,09:00:00,16,4,12,FMN GV 05 Lier
60,Mechelsesteenweg 365,2022-02-20,10:00:00,46,12,34,FMN GV 05 Lier
60,Mechelsesteenweg 365,2022-02-20,11:00:00,50,24,26,FMN GV 05 Lier
60,Mechelsesteenweg 365,2022-02-20,12:00:00,14,4,10,FMN GV 05 Lier
60,Mechelsesteenweg 365,2022-02-20,13:00:00,16,2,14,FMN GV 05 Lier
60,Mechelsesteenweg 365,2022-02-20,14:00:00,22,22,0,FMN GV 05 Lier
60,Mechelsesteenweg 365,2022-02-20,15:00:00,6,2,4,FMN GV 05 Lier
60,Mechelsesteenweg 365,2022-02-20,16:00:00,4,2,2,FMN GV 05 Lier
60,Mechelsesteenweg 365,2022-02-20,17:00:00,4,4,0,FMN GV 05 Lier
60,Mechelsesteenweg 365,2022-02-20,18:00:00,0,0,0,FMN GV 05 Lier
60,Mechelsesteenweg 365,2022-02-20,19:00:00,0,0,0,FMN GV 05 Lier
60,Mechelsesteenweg 365,2022-02-20,20:00:00,0,0,0,FMN GV 05 Lier
60,Mechelsesteenweg 365,2022-02-20,21:00:00,0,0,0,FMN GV 05 Lier
60,Mechelsesteenweg 365,2022-02-20,22:00:00,0,0,0,FMN GV 05 Lier
60,Mechelsesteenweg 365,2022-02-20,23:00:00,0,0,0,FMN GV 05 Lier
60,Mechelsesteenweg 365,2022-02-21,00:00:00,0,0,0,FMN GV 05 Lier
60,Mechelsesteenweg 365,2022-02-21,01:00:00,0,0,0,FMN GV 05 Lier
60,Mechelsesteenweg 365,2022-02-21,02:00:00,0,0,0,FMN GV 05 Lier
60,Mechelsesteenweg 365,2022-02-21,03:00:00,2,0,2,FMN GV 05 Lier
60,Mechelsesteenweg 365,2022-02-21,04:00:00,0,0,0,FMN GV 05 Lier
60,Mechelsesteenweg 365,2022-02-21,05:00:00,2,0,2,FMN GV 05 Lier
60,Mechelsesteenweg 365,2022-02-21,06:00:00,2,0,2,FMN GV 05 Lier
60,Mechelsesteenweg 365,2022-02-21,07:00:00,70,52,18,FMN GV 05 Lier
60,Mechelsesteenweg 365,2022-02-21,08:00:00,82,58,24,FMN GV 05 Lier
60,Mechelsesteenweg 365,2022-02-21,09:00:00,14,6,8,FMN GV 05 Lier
60,Mechelsesteenweg 365,2022-02-21,10:00:00,8,4,4,FMN GV 05 Lier
60,Mechelsesteenweg 365,2022-02-21,11:00:00,6,2,4,FMN GV 05 Lier
60,Mechelsesteenweg 365,2022-02-21,12:00:00,6,0,6,FMN GV 05 Lier
60,Mechelsesteenweg 365,2022-02-21,13:00:00,4,4,0,FMN GV 05 Lier
60,Mechelsesteenweg 365,2022-02-21,14:00:00,10,6,4,FMN GV 05 Lier
60,Mechelsesteenweg 365,2022-02-21,15:00:00,20,8,12,FMN GV 05 Lier
60,Mechelsesteenweg 365,2022-02-21,16:00:00,100,26,74,FMN GV 05 Lier
60,Mechelsesteenweg 365,2022-02-21,17:00:00,62,32,30,FMN GV 05 Lier
60,Mechelsesteenweg 365,2022-02-21,18:00:00,22,8,14,FMN GV 05 Lier
60,Mechelsesteenweg 365,2022-02-21,19:00:00,4,2,2,FMN GV 05 Lier
60,Mechelsesteenweg 365,2022-02-21,20:00:00,4,4,0,FMN GV 05 Lier
60,Mechelsesteenweg 365,2022-02-21,21:00:00,12,6,6,FMN GV 05 Lier
60,Mechelsesteenweg 365,2022-02-21,22:00:00,4,4,0,FMN GV 05 Lier
60,Mechelsesteenweg 365,2022-02-21,23:00:00,0,0,0,FMN GV 05 Lier
60,Mechelsesteenweg 365,2022-02-22,00:00:00,2,2,0,FMN GV 05 Lier
60,Mechelsesteenweg 365,2022-02-22,01:00:00,0,0,0,FMN GV 05 Lier
60,Mechelsesteenweg 365,2022-02-22,02:00:00,0,0,0,FMN GV 05 Lier
60,Mechelsesteenweg 365,2022-02-22,03:00:00,0,0,0,FMN GV 05 Lier
60,Mechelsesteenweg 365,2022-02-22,04:00:00,0,0,0,FMN GV 05 Lier
60,Mechelsesteenweg 365,2022-02-22,05:00:00,2,0,2,FMN GV 05 Lier
60,Mechelsesteenweg 365,2022-02-22,06:00:00,14,4,10,FMN GV 05 Lier
60,Mechelsesteenweg 365,2022-02-22,07:00:00,92,42,50,FMN GV 05 Lier
60,Mechelsesteenweg 365,2022-02-22,08:00:00,128,98,30,FMN GV 05 Lier
60,Mechelsesteenweg 365,2022-02-22,09:00:00,68,40,28,FMN GV 05 Lier
60,Mechelsesteenweg 365,2022-02-22,10:00:00,66,26,40,FMN GV 05 Lier
60,Mechelsesteenweg 365,2022-02-22,11:00:00,52,22,30,FMN GV 05 Lier
60,Mechelsesteenweg 365,2022-02-22,12:00:00,32,10,22,FMN GV 05 Lier
60,Mechelsesteenweg 365,2022-02-22,13:00:00,48,18,30,FMN GV 05 Lier
60,Mechelsesteenweg 365,2022-02-22,14:00:00,18,14,4,FMN GV 05 Lier
60,Mechelsesteenweg 365,2022-02-22,15:00:00,44,18,26,FMN GV 05 Lier
60,Mechelsesteenweg 365,2022-02-22,16:00:00,156,42,114,FMN GV 05 Lier
60,Mechelsesteenweg 365,2022-02-22,17:00:00,64,52,12,FMN GV 05 Lier
60,Mechelsesteenweg 365,2022-02-22,18:00:00,36,16,20,FMN GV 05 Lier
60,Mechelsesteenweg 365,2022-02-22,19:00:00,6,4,2,FMN GV 05 Lier
60,Mechelsesteenweg 365,2022-02-22,20:00:00,12,2,10,FMN GV 05 Lier
60,Mechelsesteenweg 365,2022-02-22,21:00:00,10,6,4,FMN GV 05 Lier
60,Mechelsesteenweg 365,2022-02-22,22:00:00,6,4,2,FMN GV 05 Lier
60,Mechelsesteenweg 365,2022-02-22,23:00:00,0,0,0,FMN GV 05 Lier
60,Mechelsesteenweg 365,2022-02-23,00:00:00,4,4,0,FMN GV 05 Lier
60,Mechelsesteenweg 365,2022-02-23,01:00:00,0,0,0,FMN GV 05 Lier
60,Mechelsesteenweg 365,2022-02-23,02:00:00,0,0,0,FMN GV 05 Lier
60,Mechelsesteenweg 365,2022-02-23,03:00:00,0,0,0,FMN GV 05 Lier
60,Mechelsesteenweg 365,2022-02-23,04:00:00,0,0,0,FMN GV 05 Lier
60,Mechelsesteenweg 365,2022-02-23,05:00:00,4,2,2,FMN GV 05 Lier
60,Mechelsesteenweg 365,2022-02-23,06:00:00,22,4,18,FMN GV 05 Lier
60,Mechelsesteenweg 365,2022-02-23,07:00:00,122,66,56,FMN GV 05 Lier
60,Mechelsesteenweg 365,2022-02-23,08:00:00,138,96,42,FMN GV 05 Lier
60,Mechelsesteenweg 365,2022-02-23,09:00:00,66,34,32,FMN GV 05 Lier
60,Mechelsesteenweg 365,2022-02-23,10:00:00,98,48,50,FMN GV 05 Lier
60,Mechelsesteenweg 365,2022-02-23,11:00:00,144,66,78,FMN GV 05 Lier
60,Mechelsesteenweg 365,2022-02-23,12:00:00,240,74,166,FMN GV 05 Lier
60,Mechelsesteenweg 365,2022-02-23,13:00:00,274,164,110,FMN GV 05 Lier
60,Mechelsesteenweg 365,2022-02-23,14:00:00,262,144,118,FMN GV 05 Lier
60,Mechelsesteenweg 365,2022-02-23,15:00:00,256,114,142,FMN GV 05 Lier
60,Mechelsesteenweg 365,2022-02-23,16:00:00,226,130,96,FMN GV 05 Lier
60,Mechelsesteenweg 365,2022-02-23,17:00:00,146,84,62,FMN GV 05 Lier
60,Mechelsesteenweg 365,2022-02-23,18:00:00,88,60,28,FMN GV 05 Lier
60,Mechelsesteenweg 365,2022-02-23,19:00:00,40,28,12,FMN GV 05 Lier
60,Mechelsesteenweg 365,2022-02-23,20:00:00,22,16,6,FMN GV 05 Lier
60,Mechelsesteenweg 365,2022-02-23,21:00:00,14,2,12,FMN GV 05 Lier
60,Mechelsesteenweg 365,2022-02-23,22:00:00,4,4,0,FMN GV 05 Lier
60,Mechelsesteenweg 365,2022-02-23,23:00:00,2,2,0,FMN GV 05 Lier
60,Mechelsesteenweg 365,2022-02-24,00:00:00,0,0,0,FMN GV 05 Lier
60,Mechelsesteenweg 365,2022-02-24,01:00:00,2,2,0,FMN GV 05 Lier
60,Mechelsesteenweg 365,2022-02-24,02:00:00,0,0,0,FMN GV 05 Lier
60,Mechelsesteenweg 365,2022-02-24,03:00:00,0,0,0,FMN GV 05 Lier
60,Mechelsesteenweg 365,2022-02-24,04:00:00,0,0,0,FMN GV 05 Lier
60,Mechelsesteenweg 365,2022-02-24,05:00:00,6,0,6,FMN GV 05 Lier
60,Mechelsesteenweg 365,2022-02-24,06:00:00,10,4,6,FMN GV 05 Lier
60,Mechelsesteenweg 365,2022-02-24,07:00:00,114,70,44,FMN GV 05 Lier
60,Mechelsesteenweg 365,2022-02-24,08:00:00,148,108,40,FMN GV 05 Lier
60,Mechelsesteenweg 365,2022-02-24,09:00:00,40,20,20,FMN GV 05 Lier
60,Mechelsesteenweg 365,2022-02-24,10:00:00,28,16,12,FMN GV 05 Lier
60,Mechelsesteenweg 365,2022-02-24,11:00:00,38,22,16,FMN GV 05 Lier
60,Mechelsesteenweg 365,2022-02-24,12:00:00,28,18,10,FMN GV 05 Lier
60,Mechelsesteenweg 365,2022-02-24,13:00:00,44,20,24,FMN GV 05 Lier
60,Mechelsesteenweg 365,2022-02-24,14:00:00,18,14,4,FMN GV 05 Lier
60,Mechelsesteenweg 365,2022-02-24,15:00:00,28,12,16,FMN GV 05 Lier
60,Mechelsesteenweg 365,2022-02-24,16:00:00,182,44,138,FMN GV 05 Lier
60,Mechelsesteenweg 365,2022-02-24,17:00:00,62,40,22,FMN GV 05 Lier
60,Mechelsesteenweg 365,2022-02-24,18:00:00,26,14,12,FMN GV 05 Lier
60,Mechelsesteenweg 365,2022-02-24,19:00:00,6,4,2,FMN GV 05 Lier
60,Mechelsesteenweg 365,2022-02-24,20:00:00,6,6,0,FMN GV 05 Lier
60,Mechelsesteenweg 365,2022-02-24,21:00:00,4,2,2,FMN GV 05 Lier
60,Mechelsesteenweg 365,2022-02-24,22:00:00,0,0,0,FMN GV 05 Lier
60,Mechelsesteenweg 365,2022-02-24,23:00:00,0,0,0,FMN GV 05 Lier
60,Mechelsesteenweg 365,2022-02-25,00:00:00,2,2,0,FMN GV 05 Lier
60,Mechelsesteenweg 365,2022-02-25,01:00:00,0,0,0,FMN GV 05 Lier
60,Mechelsesteenweg 365,2022-02-25,02:00:00,0,0,0,FMN GV 05 Lier
60,Mechelsesteenweg 365,2022-02-25,03:00:00,0,0,0,FMN GV 05 Lier
60,Mechelsesteenweg 365,2022-02-25,04:00:00,0,0,0,FMN GV 05 Lier
60,Mechelsesteenweg 365,2022-02-25,05:00:00,2,0,2,FMN GV 05 Lier
60,Mechelsesteenweg 365,2022-02-25,06:00:00,14,6,8,FMN GV 05 Lier
60,Mechelsesteenweg 365,2022-02-25,07:00:00,84,50,34,FMN GV 05 Lier
60,Mechelsesteenweg 365,2022-02-25,08:00:00,122,84,38,FMN GV 05 Lier
60,Mechelsesteenweg 365,2022-02-25,09:00:00,46,32,14,FMN GV 05 Lier
60,Mechelsesteenweg 365,2022-02-25,10:00:00,44,28,16,FMN GV 05 Lier
60,Mechelsesteenweg 365,2022-02-25,11:00:00,32,18,14,FMN GV 05 Lier
60,Mechelsesteenweg 365,2022-02-25,12:00:00,26,8,18,FMN GV 05 Lier
60,Mechelsesteenweg 365,2022-02-25,13:00:00,22,10,12,FMN GV 05 Lier
60,Mechelsesteenweg 365,2022-02-25,14:00:00,24,8,16,FMN GV 05 Lier
60,Mechelsesteenweg 365,2022-02-25,15:00:00,72,30,42,FMN GV 05 Lier
60,Mechelsesteenweg 365,2022-02-25,16:00:00,178,50,128,FMN GV 05 Lier
60,Mechelsesteenweg 365,2022-02-25,17:00:00,72,36,36,FMN GV 05 Lier
60,Mechelsesteenweg 365,2022-02-25,18:00:00,38,16,22,FMN GV 05 Lier
60,Mechelsesteenweg 365,2022-02-25,19:00:00,18,12,6,FMN GV 05 Lier
60,Mechelsesteenweg 365,2022-02-25,20:00:00,6,4,2,FMN GV 05 Lier
60,Mechelsesteenweg 365,2022-02-25,21:00:00,4,0,4,FMN GV 05 Lier
60,Mechelsesteenweg 365,2022-02-25,22:00:00,10,2,8,FMN GV 05 Lier
60,Mechelsesteenweg 365,2022-02-25,23:00:00,8,2,6,FMN GV 05 Lier
60,Mechelsesteenweg 365,2022-02-26,00:00:00,58,0,58,FMN GV 05 Lier
60,Mechelsesteenweg 365,2022-02-26,01:00:00,2,2,0,FMN GV 05 Lier
60,Mechelsesteenweg 365,2022-02-26,02:00:00,10,4,6,FMN GV 05 Lier
60,Mechelsesteenweg 365,2022-02-26,03:00:00,8,4,4,FMN GV 05 Lier
60,Mechelsesteenweg 365,2022-02-26,04:00:00,0,0,0,FMN GV 05 Lier
60,Mechelsesteenweg 365,2022-02-26,05:00:00,4,0,4,FMN GV 05 Lier
60,Mechelsesteenweg 365,2022-02-26,06:00:00,2,0,2,FMN GV 05 Lier
60,Mechelsesteenweg 365,2022-02-26,07:00:00,12,8,4,FMN GV 05 Lier
60,Mechelsesteenweg 365,2022-02-26,08:00:00,14,0,14,FMN GV 05 Lier
60,Mechelsesteenweg 365,2022-02-26,09:00:00,56,32,24,FMN GV 05 Lier
60,Mechelsesteenweg 365,2022-02-26,10:00:00,140,78,62,FMN GV 05 Lier
60,Mechelsesteenweg 365,2022-02-26,11:00:00,194,100,94,FMN GV 05 Lier
60,Mechelsesteenweg 365,2022-02-26,12:00:00,188,82,106,FMN GV 05 Lier
60,Mechelsesteenweg 365,2022-02-26,13:00:00,226,128,98,FMN GV 05 Lier
60,Mechelsesteenweg 365,2022-02-26,14:00:00,320,170,150,FMN GV 05 Lier
60,Mechelsesteenweg 365,2022-02-26,15:00:00,276,132,144,FMN GV 05 Lier
60,Mechelsesteenweg 365,2022-02-26,16:00:00,142,42,100,FMN GV 05 Lier
60,Mechelsesteenweg 365,2022-02-26,17:00:00,58,16,42,FMN GV 05 Lier
60,Mechelsesteenweg 365,2022-02-26,18:00:00,20,10,10,FMN GV 05 Lier
60,Mechelsesteenweg 365,2022-02-26,19:00:00,4,4,0,FMN GV 05 Lier
60,Mechelsesteenweg 365,2022-02-26,20:00:00,2,2,0,FMN GV 05 Lier
60,Mechelsesteenweg 365,2022-02-26,21:00:00,0,0,0,FMN GV 05 Lier
60,Mechelsesteenweg 365,2022-02-26,22:00:00,4,2,2,FMN GV 05 Lier
60,Mechelsesteenweg 365,2022-02-26,23:00:00,0,0,0,FMN GV 05 Lier
60,Mechelsesteenweg 365,2022-02-27,00:00:00,2,2,0,FMN GV 05 Lier
60,Mechelsesteenweg 365,2022-02-27,01:00:00,0,0,0,FMN GV 05 Lier
60,Mechelsesteenweg 365,2022-02-27,02:00:00,0,0,0,FMN GV 05 Lier
60,Mechelsesteenweg 365,2022-02-27,03:00:00,0,0,0,FMN GV 05 Lier
60,Mechelsesteenweg 365,2022-02-27,04:00:00,2,0,2,FMN GV 05 Lier
60,Mechelsesteenweg 365,2022-02-27,05:00:00,2,0,2,FMN GV 05 Lier
60,Mechelsesteenweg 365,2022-02-27,06:00:00,0,0,0,FMN GV 05 Lier
60,Mechelsesteenweg 365,2022-02-27,07:00:00,0,0,0,FMN GV 05 Lier
60,Mechelsesteenweg 365,2022-02-27,08:00:00,34,18,16,FMN GV 05 Lier
60,Mechelsesteenweg 365,2022-02-27,09:00:00,112,78,34,FMN GV 05 Lier
60,Mechelsesteenweg 365,2022-02-27,10:00:00,300,162,138,FMN GV 05 Lier
60,Mechelsesteenweg 365,2022-02-27,11:00:00,372,162,210,FMN GV 05 Lier
60,Mechelsesteenweg 365,2022-02-27,12:00:00,248,98,150,FMN GV 05 Lier
60,Mechelsesteenweg 365,2022-02-27,13:00:00,274,146,128,FMN GV 05 Lier
60,Mechelsesteenweg 365,2022-02-27,14:00:00,438,206,232,FMN GV 05 Lier
60,Mechelsesteenweg 365,2022-02-27,15:00:00,390,168,222,FMN GV 05 Lier
60,Mechelsesteenweg 365,2022-02-27,16:00:00,266,104,162,FMN GV 05 Lier
60,Mechelsesteenweg 365,2022-02-27,17:00:00,94,42,52,FMN GV 05 Lier
60,Mechelsesteenweg 365,2022-02-27,18:00:00,38,18,20,FMN GV 05 Lier
60,Mechelsesteenweg 365,2022-02-27,19:00:00,8,8,0,FMN GV 05 Lier
60,Mechelsesteenweg 365,2022-02-27,20:00:00,4,2,2,FMN GV 05 Lier
60,Mechelsesteenweg 365,2022-02-27,21:00:00,4,4,0,FMN GV 05 Lier
60,Mechelsesteenweg 365,2022-02-27,22:00:00,0,0,0,FMN GV 05 Lier
60,Mechelsesteenweg 365,2022-02-27,23:00:00,0,0,0,FMN GV 05 Lier
60,Mechelsesteenweg 365,2022-02-28,00:00:00,0,0,0,FMN GV 05 Lier
60,Mechelsesteenweg 365,2022-02-28,01:00:00,0,0,0,FMN GV 05 Lier
60,Mechelsesteenweg 365,2022-02-28,02:00:00,0,0,0,FMN GV 05 Lier
60,Mechelsesteenweg 365,2022-02-28,03:00:00,0,0,0,FMN GV 05 Lier
60,Mechelsesteenweg 365,2022-02-28,04:00:00,4,0,4,FMN GV 05 Lier
60,Mechelsesteenweg 365,2022-02-28,05:00:00,6,2,4,FMN GV 05 Lier
60,Mechelsesteenweg 365,2022-02-28,06:00:00,14,2,12,FMN GV 05 Lier
60,Mechelsesteenweg 365,2022-02-28,07:00:00,50,12,38,FMN GV 05 Lier
60,Mechelsesteenweg 365,2022-02-28,08:00:00,54,20,34,FMN GV 05 Lier
60,Mechelsesteenweg 365,2022-02-28,09:00:00,32,16,16,FMN GV 05 Lier
60,Mechelsesteenweg 365,2022-02-28,10:00:00,64,32,32,FMN GV 05 Lier
60,Mechelsesteenweg 365,2022-02-28,11:00:00,82,38,44,FMN GV 05 Lier
60,Mechelsesteenweg 365,2022-02-28,12:00:00,98,48,50,FMN GV 05 Lier
60,Mechelsesteenweg 365,2022-02-28,13:00:00,254,130,124,FMN GV 05 Lier
60,Mechelsesteenweg 365,2022-02-28,14:00:00,350,180,170,FMN GV 05 Lier
60,Mechelsesteenweg 365,2022-02-28,15:00:00,348,150,198,FMN GV 05 Lier
60,Mechelsesteenweg 365,2022-02-28,16:00:00,208,88,120,FMN GV 05 Lier
60,Mechelsesteenweg 365,2022-02-28,17:00:00,154,90,64,FMN GV 05 Lier
60,Mechelsesteenweg 365,2022-02-28,18:00:00,62,30,32,FMN GV 05 Lier
60,Mechelsesteenweg 365,2022-02-28,19:00:00,20,18,2,FMN GV 05 Lier
60,Mechelsesteenweg 365,2022-02-28,20:00:00,22,8,14,FMN GV 05 Lier
60,Mechelsesteenweg 365,2022-02-28,21:00:00,6,6,0,FMN GV 05 Lier
60,Mechelsesteenweg 365,2022-02-28,22:00:00,4,4,0,FMN GV 05 Lier
60,Mechelsesteenweg 365,2022-02-28,23:00:00,2,2,0,FMN GV 05 Lier
60,Mechelsesteenweg 365,2022-03-01,00:00:00,0,0,0,FMN GV 05 Lier
60,Mechelsesteenweg 365,2022-03-01,01:00:00,0,0,0,FMN GV 05 Lier
60,Mechelsesteenweg 365,2022-03-01,02:00:00,0,0,0,FMN GV 05 Lier
60,Mechelsesteenweg 365,2022-03-01,03:00:00,0,0,0,FMN GV 05 Lier
60,Mechelsesteenweg 365,2022-03-01,04:00:00,4,0,4,FMN GV 05 Lier
60,Mechelsesteenweg 365,2022-03-01,05:00:00,6,2,4,FMN GV 05 Lier
60,Mechelsesteenweg 365,2022-03-01,06:00:00,28,4,24,FMN GV 05 Lier
60,Mechelsesteenweg 365,2022-03-01,07:00:00,92,28,64,FMN GV 05 Lier
60,Mechelsesteenweg 365,2022-03-01,08:00:00,52,22,30,FMN GV 05 Lier
60,Mechelsesteenweg 365,2022-03-01,09:00:00,42,26,16,FMN GV 05 Lier
60,Mechelsesteenweg 365,2022-03-01,10:00:00,72,34,38,FMN GV 05 Lier
60,Mechelsesteenweg 365,2022-03-01,11:00:00,56,24,32,FMN GV 05 Lier
60,Mechelsesteenweg 365,2022-03-01,12:00:00,80,46,34,FMN GV 05 Lier
60,Mechelsesteenweg 365,2022-03-01,13:00:00,82,42,40,FMN GV 05 Lier
60,Mechelsesteenweg 365,2022-03-01,14:00:00,94,56,38,FMN GV 05 Lier
60,Mechelsesteenweg 365,2022-03-01,15:00:00,114,72,42,FMN GV 05 Lier
60,Mechelsesteenweg 365,2022-03-01,16:00:00,136,70,66,FMN GV 05 Lier
60,Mechelsesteenweg 365,2022-03-01,17:00:00,92,66,26,FMN GV 05 Lier
60,Mechelsesteenweg 365,2022-03-01,18:00:00,64,36,28,FMN GV 05 Lier
60,Mechelsesteenweg 365,2022-03-01,19:00:00,6,4,2,FMN GV 05 Lier
60,Mechelsesteenweg 365,2022-03-01,20:00:00,6,2,4,FMN GV 05 Lier
60,Mechelsesteenweg 365,2022-03-01,21:00:00,4,0,4,FMN GV 05 Lier
60,Mechelsesteenweg 365,2022-03-01,22:00:00,10,6,4,FMN GV 05 Lier
60,Mechelsesteenweg 365,2022-03-01,23:00:00,0,0,0,FMN GV 05 Lier
60,Mechelsesteenweg 365,2022-03-02,00:00:00,4,4,0,FMN GV 05 Lier
60,Mechelsesteenweg 365,2022-03-02,01:00:00,0,0,0,FMN GV 05 Lier
60,Mechelsesteenweg 365,2022-03-02,02:00:00,0,0,0,FMN GV 05 Lier
60,Mechelsesteenweg 365,2022-03-02,03:00:00,2,0,2,FMN GV 05 Lier
60,Mechelsesteenweg 365,2022-03-02,04:00:00,2,0,2,FMN GV 05 Lier
60,Mechelsesteenweg 365,2022-03-02,05:00:00,4,4,0,FMN GV 05 Lier
60,Mechelsesteenweg 365,2022-03-02,06:00:00,30,8,22,FMN GV 05 Lier
60,Mechelsesteenweg 365,2022-03-02,07:00:00,64,22,42,FMN GV 05 Lier
60,Mechelsesteenweg 365,2022-03-02,08:00:00,38,14,24,FMN GV 05 Lier
60,Mechelsesteenweg 365,2022-03-02,09:00:00,36,20,16,FMN GV 05 Lier
60,Mechelsesteenweg 365,2022-03-02,10:00:00,92,50,42,FMN GV 05 Lier
60,Mechelsesteenweg 365,2022-03-02,11:00:00,88,44,44,FMN GV 05 Lier
60,Mechelsesteenweg 365,2022-03-02,12:00:00,92,40,52,FMN GV 05 Lier
60,Mechelsesteenweg 365,2022-03-02,13:00:00,168,72,96,FMN GV 05 Lier
60,Mechelsesteenweg 365,2022-03-02,14:00:00,206,106,100,FMN GV 05 Lier
60,Mechelsesteenweg 365,2022-03-02,15:00:00,194,86,108,FMN GV 05 Lier
60,Mechelsesteenweg 365,2022-03-02,16:00:00,192,94,98,FMN GV 05 Lier
60,Mechelsesteenweg 365,2022-03-02,17:00:00,144,76,68,FMN GV 05 Lier
60,Mechelsesteenweg 365,2022-03-02,18:00:00,68,28,40,FMN GV 05 Lier
60,Mechelsesteenweg 365,2022-03-02,19:00:00,20,8,12,FMN GV 05 Lier
60,Mechelsesteenweg 365,2022-03-02,20:00:00,18,10,8,FMN GV 05 Lier
60,Mechelsesteenweg 365,2022-03-02,21:00:00,4,2,2,FMN GV 05 Lier
60,Mechelsesteenweg 365,2022-03-02,22:00:00,14,14,0,FMN GV 05 Lier
60,Mechelsesteenweg 365,2022-03-02,23:00:00,0,0,0,FMN GV 05 Lier
60,Mechelsesteenweg 365,2022-03-03,00:00:00,0,0,0,FMN GV 05 Lier
60,Mechelsesteenweg 365,2022-03-03,01:00:00,0,0,0,FMN GV 05 Lier
60,Mechelsesteenweg 365,2022-03-03,02:00:00,0,0,0,FMN GV 05 Lier
60,Mechelsesteenweg 365,2022-03-03,03:00:00,2,0,2,FMN GV 05 Lier
60,Mechelsesteenweg 365,2022-03-03,04:00:00,2,0,2,FMN GV 05 Lier
60,Mechelsesteenweg 365,2022-03-03,05:00:00,2,2,0,FMN GV 05 Lier
60,Mechelsesteenweg 365,2022-03-03,06:00:00,28,10,18,FMN GV 05 Lier
60,Mechelsesteenweg 365,2022-03-03,07:00:00,76,24,52,FMN GV 05 Lier
60,Mechelsesteenweg 365,2022-03-03,08:00:00,44,14,30,FMN GV 05 Lier
60,Mechelsesteenweg 365,2022-03-03,09:00:00,58,32,26,FMN GV 05 Lier
60,Mechelsesteenweg 365,2022-03-03,10:00:00,66,28,38,FMN GV 05 Lier
60,Mechelsesteenweg 365,2022-03-03,11:00:00,90,46,44,FMN GV 05 Lier
60,Mechelsesteenweg 365,2022-03-03,12:00:00,138,66,72,FMN GV 05 Lier
60,Mechelsesteenweg 365,2022-03-03,13:00:00,194,116,78,FMN GV 05 Lier
60,Mechelsesteenweg 365,2022-03-03,14:00:00,320,192,128,FMN GV 05 Lier
60,Mechelsesteenweg 365,2022-03-03,15:00:00,304,124,180,FMN GV 05 Lier
60,Mechelsesteenweg 365,2022-03-03,16:00:00,224,112,112,FMN GV 05 Lier
60,Mechelsesteenweg 365,2022-03-03,17:00:00,182,78,104,FMN GV 05 Lier
60,Mechelsesteenweg 365,2022-03-03,18:00:00,56,26,30,FMN GV 05 Lier
60,Mechelsesteenweg 365,2022-03-03,19:00:00,18,10,8,FMN GV 05 Lier
60,Mechelsesteenweg 365,2022-03-03,20:00:00,16,10,6,FMN GV 05 Lier
60,Mechelsesteenweg 365,2022-03-03,21:00:00,6,2,4,FMN GV 05 Lier
60,Mechelsesteenweg 365,2022-03-03,22:00:00,10,6,4,FMN GV 05 Lier
60,Mechelsesteenweg 365,2022-03-03,23:00:00,0,0,0,FMN GV 05 Lier
60,Mechelsesteenweg 365,2022-03-04,00:00:00,4,2,2,FMN GV 05 Lier
60,Mechelsesteenweg 365,2022-03-04,01:00:00,0,0,0,FMN GV 05 Lier
60,Mechelsesteenweg 365,2022-03-04,02:00:00,0,0,0,FMN GV 05 Lier
60,Mechelsesteenweg 365,2022-03-04,03:00:00,2,0,2,FMN GV 05 Lier
60,Mechelsesteenweg 365,2022-03-04,04:00:00,2,0,2,FMN GV 05 Lier
60,Mechelsesteenweg 365,2022-03-04,05:00:00,6,4,2,FMN GV 05 Lier
60,Mechelsesteenweg 365,2022-03-04,06:00:00,22,4,18,FMN GV 05 Lier
60,Mechelsesteenweg 365,2022-03-04,07:00:00,44,16,28,FMN GV 05 Lier
60,Mechelsesteenweg 365,2022-03-04,08:00:00,52,20,32,FMN GV 05 Lier
60,Mechelsesteenweg 365,2022-03-04,09:00:00,30,8,22,FMN GV 05 Lier
60,Mechelsesteenweg 365,2022-03-04,10:00:00,86,38,48,FMN GV 05 Lier
60,Mechelsesteenweg 365,2022-03-04,11:00:00,104,60,44,FMN GV 05 Lier
60,Mechelsesteenweg 365,2022-03-04,12:00:00,148,92,56,FMN GV 05 Lier
60,Mechelsesteenweg 365,2022-03-04,13:00:00,196,114,82,FMN GV 05 Lier
60,Mechelsesteenweg 365,2022-03-04,14:00:00,344,218,126,FMN GV 05 Lier
60,Mechelsesteenweg 365,2022-03-04,15:00:00,332,128,204,FMN GV 05 Lier
60,Mechelsesteenweg 365,2022-03-04,16:00:00,256,124,132,FMN GV 05 Lier
60,Mechelsesteenweg 365,2022-03-04,17:00:00,136,74,62,FMN GV 05 Lier
60,Mechelsesteenweg 365,2022-03-04,18:00:00,70,36,34,FMN GV 05 Lier
60,Mechelsesteenweg 365,2022-03-04,19:00:00,32,18,14,FMN GV 05 Lier
60,Mechelsesteenweg 365,2022-03-04,20:00:00,16,8,8,FMN GV 05 Lier
60,Mechelsesteenweg 365,2022-03-04,21:00:00,10,6,4,FMN GV 05 Lier
60,Mechelsesteenweg 365,2022-03-04,22:00:00,8,4,4,FMN GV 05 Lier
60,Mechelsesteenweg 365,2022-03-04,23:00:00,8,0,8,FMN GV 05 Lier
60,Mechelsesteenweg 365,2022-03-05,00:00:00,4,0,4,FMN GV 05 Lier
60,Mechelsesteenweg 365,2022-03-05,01:00:00,6,2,4,FMN GV 05 Lier
60,Mechelsesteenweg 365,2022-03-05,02:00:00,2,0,2,FMN GV 05 Lier
60,Mechelsesteenweg 365,2022-03-05,03:00:00,0,0,0,FMN GV 05 Lier
60,Mechelsesteenweg 365,2022-03-05,04:00:00,0,0,0,FMN GV 05 Lier
60,Mechelsesteenweg 365,2022-03-05,05:00:00,0,0,0,FMN GV 05 Lier
60,Mechelsesteenweg 365,2022-03-05,06:00:00,4,2,2,FMN GV 05 Lier
60,Mechelsesteenweg 365,2022-03-05,07:00:00,8,4,4,FMN GV 05 Lier
60,Mechelsesteenweg 365,2022-03-05,08:00:00,10,4,6,FMN GV 05 Lier
60,Mechelsesteenweg 365,2022-03-05,09:00:00,112,62,50,FMN GV 05 Lier
60,Mechelsesteenweg 365,2022-03-05,10:00:00,146,98,48,FMN GV 05 Lier
60,Mechelsesteenweg 365,2022-03-05,11:00:00,272,112,160,FMN GV 05 Lier
60,Mechelsesteenweg 365,2022-03-05,12:00:00,242,108,134,FMN GV 05 Lier
60,Mechelsesteenweg 365,2022-03-05,13:00:00,286,128,158,FMN GV 05 Lier
60,Mechelsesteenweg 365,2022-03-05,14:00:00,394,184,210,FMN GV 05 Lier
60,Mechelsesteenweg 365,2022-03-05,15:00:00,352,188,164,FMN GV 05 Lier
60,Mechelsesteenweg 365,2022-03-05,16:00:00,214,66,148,FMN GV 05 Lier
60,Mechelsesteenweg 365,2022-03-05,17:00:00,130,66,64,FMN GV 05 Lier
60,Mechelsesteenweg 365,2022-03-05,18:00:00,52,12,40,FMN GV 05 Lier
60,Mechelsesteenweg 365,2022-03-05,19:00:00,44,22,22,FMN GV 05 Lier
60,Mechelsesteenweg 365,2022-03-05,20:00:00,6,2,4,FMN GV 05 Lier
60,Mechelsesteenweg 365,2022-03-05,21:00:00,2,0,2,FMN GV 05 Lier
60,Mechelsesteenweg 365,2022-03-05,22:00:00,2,0,2,FMN GV 05 Lier
60,Mechelsesteenweg 365,2022-03-05,23:00:00,2,2,0,FMN GV 05 Lier
60,Mechelsesteenweg 365,2022-03-06,00:00:00,12,4,8,FMN GV 05 Lier
60,Mechelsesteenweg 365,2022-03-06,01:00:00,4,0,4,FMN GV 05 Lier
60,Mechelsesteenweg 365,2022-03-06,02:00:00,2,2,0,FMN GV 05 Lier
60,Mechelsesteenweg 365,2022-03-06,03:00:00,0,0,0,FMN GV 05 Lier
60,Mechelsesteenweg 365,2022-03-06,04:00:00,0,0,0,FMN GV 05 Lier
60,Mechelsesteenweg 365,2022-03-06,05:00:00,0,0,0,FMN GV 05 Lier
60,Mechelsesteenweg 365,2022-03-06,06:00:00,4,2,2,FMN GV 05 Lier
60,Mechelsesteenweg 365,2022-03-06,07:00:00,8,4,4,FMN GV 05 Lier
60,Mechelsesteenweg 365,2022-03-06,08:00:00,22,12,10,FMN GV 05 Lier
60,Mechelsesteenweg 365,2022-03-06,09:00:00,118,86,32,FMN GV 05 Lier
60,Mechelsesteenweg 365,2022-03-06,10:00:00,258,108,150,FMN GV 05 Lier
60,Mechelsesteenweg 365,2022-03-06,11:00:00,354,178,176,FMN GV 05 Lier
60,Mechelsesteenweg 365,2022-03-06,12:00:00,202,72,130,FMN GV 05 Lier
60,Mechelsesteenweg 365,2022-03-06,13:00:00,252,126,126,FMN GV 05 Lier
60,Mechelsesteenweg 365,2022-03-06,14:00:00,282,136,146,FMN GV 05 Lier
60,Mechelsesteenweg 365,2022-03-06,15:00:00,250,98,152,FMN GV 05 Lier
60,Mechelsesteenweg 365,2022-03-06,16:00:00,126,44,82,FMN GV 05 Lier
60,Mechelsesteenweg 365,2022-03-06,17:00:00,66,36,30,FMN GV 05 Lier
60,Mechelsesteenweg 365,2022-03-06,18:00:00,18,12,6,FMN GV 05 Lier
60,Mechelsesteenweg 365,2022-03-06,19:00:00,8,2,6,FMN GV 05 Lier
60,Mechelsesteenweg 365,2022-03-06,20:00:00,6,0,6,FMN GV 05 Lier
60,Mechelsesteenweg 365,2022-03-06,21:00:00,4,2,2,FMN GV 05 Lier
60,Mechelsesteenweg 365,2022-03-06,22:00:00,2,2,0,FMN GV 05 Lier
60,Mechelsesteenweg 365,2022-03-06,23:00:00,0,0,0,FMN GV 05 Lier
60,Mechelsesteenweg 365,2022-03-07,00:00:00,0,0,0,FMN GV 05 Lier
60,Mechelsesteenweg 365,2022-03-07,01:00:00,0,0,0,FMN GV 05 Lier
60,Mechelsesteenweg 365,2022-03-07,02:00:00,0,0,0,FMN GV 05 Lier
60,Mechelsesteenweg 365,2022-03-07,03:00:00,2,0,2,FMN GV 05 Lier
60,Mechelsesteenweg 365,2022-03-07,04:00:00,2,0,2,FMN GV 05 Lier
60,Mechelsesteenweg 365,2022-03-07,05:00:00,10,0,10,FMN GV 05 Lier
60,Mechelsesteenweg 365,2022-03-07,06:00:00,20,10,10,FMN GV 05 Lier
60,Mechelsesteenweg 365,2022-03-07,07:00:00,118,62,56,FMN GV 05 Lier
60,Mechelsesteenweg 365,2022-03-07,08:00:00,148,92,56,FMN GV 05 Lier
60,Mechelsesteenweg 365,2022-03-07,09:00:00,48,24,24,FMN GV 05 Lier
60,Mechelsesteenweg 365,2022-03-07,10:00:00,46,18,28,FMN GV 05 Lier
60,Mechelsesteenweg 365,2022-03-07,11:00:00,54,20,34,FMN GV 05 Lier
60,Mechelsesteenweg 365,2022-03-07,12:00:00,50,18,32,FMN GV 05 Lier
60,Mechelsesteenweg 365,2022-03-07,13:00:00,68,26,42,FMN GV 05 Lier
60,Mechelsesteenweg 365,2022-03-07,14:00:00,120,34,86,FMN GV 05 Lier
60,Mechelsesteenweg 365,2022-03-07,15:00:00,110,50,60,FMN GV 05 Lier
60,Mechelsesteenweg 365,2022-03-07,16:00:00,228,66,162,FMN GV 05 Lier
60,Mechelsesteenweg 365,2022-03-07,17:00:00,122,82,40,FMN GV 05 Lier
60,Mechelsesteenweg 365,2022-03-07,18:00:00,72,40,32,FMN GV 05 Lier
60,Mechelsesteenweg 365,2022-03-07,19:00:00,8,6,2,FMN GV 05 Lier
60,Mechelsesteenweg 365,2022-03-07,20:00:00,6,4,2,FMN GV 05 Lier
60,Mechelsesteenweg 365,2022-03-07,21:00:00,2,0,2,FMN GV 05 Lier
60,Mechelsesteenweg 365,2022-03-07,22:00:00,4,0,4,FMN GV 05 Lier
60,Mechelsesteenweg 365,2022-03-07,23:00:00,2,0,2,FMN GV 05 Lier
60,Mechelsesteenweg 365,2022-03-08,00:00:00,0,0,0,FMN GV 05 Lier
60,Mechelsesteenweg 365,2022-03-08,01:00:00,2,2,0,FMN GV 05 Lier
60,Mechelsesteenweg 365,2022-03-08,02:00:00,0,0,0,FMN GV 05 Lier
60,Mechelsesteenweg 365,2022-03-08,03:00:00,0,0,0,FMN GV 05 Lier
60,Mechelsesteenweg 365,2022-03-08,04:00:00,4,0,4,FMN GV 05 Lier
60,Mechelsesteenweg 365,2022-03-08,05:00:00,8,0,8,FMN GV 05 Lier
60,Mechelsesteenweg 365,2022-03-08,06:00:00,24,6,18,FMN GV 05 Lier
60,Mechelsesteenweg 365,2022-03-08,07:00:00,132,46,86,FMN GV 05 Lier
60,Mechelsesteenweg 365,2022-03-08,08:00:00,154,90,64,FMN GV 05 Lier
60,Mechelsesteenweg 365,2022-03-08,09:00:00,82,54,28,FMN GV 05 Lier
60,Mechelsesteenweg 365,2022-03-08,10:00:00,76,32,44,FMN GV 05 Lier
60,Mechelsesteenweg 365,2022-03-08,11:00:00,62,28,34,FMN GV 05 Lier
60,Mechelsesteenweg 365,2022-03-08,12:00:00,90,48,42,FMN GV 05 Lier
60,Mechelsesteenweg 365,2022-03-08,13:00:00,126,64,62,FMN GV 05 Lier
60,Mechelsesteenweg 365,2022-03-08,14:00:00,228,98,130,FMN GV 05 Lier
60,Mechelsesteenweg 365,2022-03-08,15:00:00,178,76,102,FMN GV 05 Lier
60,Mechelsesteenweg 365,2022-03-08,16:00:00,326,112,214,FMN GV 05 Lier
60,Mechelsesteenweg 365,2022-03-08,17:00:00,172,106,66,FMN GV 05 Lier
60,Mechelsesteenweg 365,2022-03-08,18:00:00,72,38,34,FMN GV 05 Lier
60,Mechelsesteenweg 365,2022-03-08,19:00:00,32,12,20,FMN GV 05 Lier
60,Mechelsesteenweg 365,2022-03-08,20:00:00,10,0,10,FMN GV 05 Lier
60,Mechelsesteenweg 365,2022-03-08,21:00:00,4,2,2,FMN GV 05 Lier
60,Mechelsesteenweg 365,2022-03-08,22:00:00,10,4,6,FMN GV 05 Lier
60,Mechelsesteenweg 365,2022-03-08,23:00:00,2,2,0,FMN GV 05 Lier
60,Mechelsesteenweg 365,2022-03-09,00:00:00,0,0,0,FMN GV 05 Lier
60,Mechelsesteenweg 365,2022-03-09,01:00:00,0,0,0,FMN GV 05 Lier
60,Mechelsesteenweg 365,2022-03-09,02:00:00,0,0,0,FMN GV 05 Lier
60,Mechelsesteenweg 365,2022-03-09,03:00:00,2,2,0,FMN GV 05 Lier
60,Mechelsesteenweg 365,2022-03-09,04:00:00,4,0,4,FMN GV 05 Lier
60,Mechelsesteenweg 365,2022-03-09,05:00:00,14,4,10,FMN GV 05 Lier
60,Mechelsesteenweg 365,2022-03-09,06:00:00,20,8,12,FMN GV 05 Lier
60,Mechelsesteenweg 365,2022-03-09,07:00:00,134,62,72,FMN GV 05 Lier
60,Mechelsesteenweg 365,2022-03-09,08:00:00,190,128,62,FMN GV 05 Lier
60,Mechelsesteenweg 365,2022-03-09,09:00:00,84,48,36,FMN GV 05 Lier
60,Mechelsesteenweg 365,2022-03-09,10:00:00,76,40,36,FMN GV 05 Lier
60,Mechelsesteenweg 365,2022-03-09,11:00:00,72,32,40,FMN GV 05 Lier
60,Mechelsesteenweg 365,2022-03-09,12:00:00,254,86,168,FMN GV 05 Lier
60,Mechelsesteenweg 365,2022-03-09,13:00:00,274,126,148,FMN GV 05 Lier
60,Mechelsesteenweg 365,2022-03-09,14:00:00,380,198,182,FMN GV 05 Lier
60,Mechelsesteenweg 365,2022-03-09,15:00:00,398,166,232,FMN GV 05 Lier
60,Mechelsesteenweg 365,2022-03-09,16:00:00,278,166,112,FMN GV 05 Lier
60,Mechelsesteenweg 365,2022-03-09,17:00:00,170,118,52,FMN GV 05 Lier
60,Mechelsesteenweg 365,2022-03-09,18:00:00,106,56,50,FMN GV 05 Lier
60,Mechelsesteenweg 365,2022-03-09,19:00:00,26,12,14,FMN GV 05 Lier
60,Mechelsesteenweg 365,2022-03-09,20:00:00,14,0,14,FMN GV 05 Lier
60,Mechelsesteenweg 365,2022-03-09,21:00:00,18,10,8,FMN GV 05 Lier
60,Mechelsesteenweg 365,2022-03-09,22:00:00,6,6,0,FMN GV 05 Lier
60,Mechelsesteenweg 365,2022-03-09,23:00:00,2,2,0,FMN GV 05 Lier
60,Mechelsesteenweg 365,2022-03-10,00:00:00,0,0,0,FMN GV 05 Lier
60,Mechelsesteenweg 365,2022-03-10,01:00:00,0,0,0,FMN GV 05 Lier
60,Mechelsesteenweg 365,2022-03-10,02:00:00,0,0,0,FMN GV 05 Lier
60,Mechelsesteenweg 365,2022-03-10,03:00:00,0,0,0,FMN GV 05 Lier
60,Mechelsesteenweg 365,2022-03-10,04:00:00,4,0,4,FMN GV 05 Lier
60,Mechelsesteenweg 365,2022-03-10,05:00:00,10,2,8,FMN GV 05 Lier
60,Mechelsesteenweg 365,2022-03-10,06:00:00,24,10,14,FMN GV 05 Lier
60,Mechelsesteenweg 365,2022-03-10,07:00:00,156,68,88,FMN GV 05 Lier
60,Mechelsesteenweg 365,2022-03-10,08:00:00,174,120,54,FMN GV 05 Lier
60,Mechelsesteenweg 365,2022-03-10,09:00:00,56,24,32,FMN GV 05 Lier
60,Mechelsesteenweg 365,2022-03-10,10:00:00,70,44,26,FMN GV 05 Lier
60,Mechelsesteenweg 365,2022-03-10,11:00:00,108,42,66,FMN GV 05 Lier
60,Mechelsesteenweg 365,2022-03-10,12:00:00,150,64,86,FMN GV 05 Lier
60,Mechelsesteenweg 365,2022-03-10,13:00:00,260,120,140,FMN GV 05 Lier
60,Mechelsesteenweg 365,2022-03-10,14:00:00,350,192,158,FMN GV 05 Lier
60,Mechelsesteenweg 365,2022-03-10,15:00:00,352,160,192,FMN GV 05 Lier
60,Mechelsesteenweg 365,2022-03-10,16:00:00,408,156,252,FMN GV 05 Lier
60,Mechelsesteenweg 365,2022-03-10,17:00:00,200,100,100,FMN GV 05 Lier
60,Mechelsesteenweg 365,2022-03-10,18:00:00,124,66,58,FMN GV 05 Lier
60,Mechelsesteenweg 365,2022-03-10,19:00:00,36,18,18,FMN GV 05 Lier
60,Mechelsesteenweg 365,2022-03-10,20:00:00,20,10,10,FMN GV 05 Lier
60,Mechelsesteenweg 365,2022-03-10,21:00:00,4,2,2,FMN GV 05 Lier
60,Mechelsesteenweg 365,2022-03-10,22:00:00,6,2,4,FMN GV 05 Lier
60,Mechelsesteenweg 365,2022-03-10,23:00:00,4,0,4,FMN GV 05 Lier
60,Mechelsesteenweg 365,2022-03-11,00:00:00,0,0,0,FMN GV 05 Lier
60,Mechelsesteenweg 365,2022-03-11,01:00:00,6,6,0,FMN GV 05 Lier
60,Mechelsesteenweg 365,2022-03-11,02:00:00,0,0,0,FMN GV 05 Lier
60,Mechelsesteenweg 365,2022-03-11,03:00:00,2,0,2,FMN GV 05 Lier
60,Mechelsesteenweg 365,2022-03-11,04:00:00,2,0,2,FMN GV 05 Lier
60,Mechelsesteenweg 365,2022-03-11,05:00:00,10,2,8,FMN GV 05 Lier
60,Mechelsesteenweg 365,2022-03-11,06:00:00,20,4,16,FMN GV 05 Lier
60,Mechelsesteenweg 365,2022-03-11,07:00:00,150,80,70,FMN GV 05 Lier
60,Mechelsesteenweg 365,2022-03-11,08:00:00,166,98,68,FMN GV 05 Lier
60,Mechelsesteenweg 365,2022-03-11,09:00:00,80,42,38,FMN GV 05 Lier
60,Mechelsesteenweg 365,2022-03-11,10:00:00,104,40,64,FMN GV 05 Lier
60,Mechelsesteenweg 365,2022-03-11,11:00:00,126,74,52,FMN GV 05 Lier
60,Mechelsesteenweg 365,2022-03-11,12:00:00,148,82,66,FMN GV 05 Lier
60,Mechelsesteenweg 365,2022-03-11,13:00:00,166,92,74,FMN GV 05 Lier
60,Mechelsesteenweg 365,2022-03-11,14:00:00,250,108,142,FMN GV 05 Lier
60,Mechelsesteenweg 365,2022-03-11,15:00:00,230,84,146,FMN GV 05 Lier
60,Mechelsesteenweg 365,2022-03-11,16:00:00,264,100,164,FMN GV 05 Lier
60,Mechelsesteenweg 365,2022-03-11,17:00:00,140,88,52,FMN GV 05 Lier
60,Mechelsesteenweg 365,2022-03-11,18:00:00,62,34,28,FMN GV 05 Lier
60,Mechelsesteenweg 365,2022-03-11,19:00:00,22,8,14,FMN GV 05 Lier
60,Mechelsesteenweg 365,2022-03-11,20:00:00,6,2,4,FMN GV 05 Lier
60,Mechelsesteenweg 365,2022-03-11,21:00:00,6,2,4,FMN GV 05 Lier
60,Mechelsesteenweg 365,2022-03-11,22:00:00,2,2,0,FMN GV 05 Lier
60,Mechelsesteenweg 365,2022-03-11,23:00:00,2,2,0,FMN GV 05 Lier
60,Mechelsesteenweg 365,2022-03-12,00:00:00,2,2,0,FMN GV 05 Lier
60,Mechelsesteenweg 365,2022-03-12,01:00:00,0,0,0,FMN GV 05 Lier
60,Mechelsesteenweg 365,2022-03-12,02:00:00,0,0,0,FMN GV 05 Lier
60,Mechelsesteenweg 365,2022-03-12,03:00:00,2,0,2,FMN GV 05 Lier
60,Mechelsesteenweg 365,2022-03-12,04:00:00,0,0,0,FMN GV 05 Lier
60,Mechelsesteenweg 365,2022-03-12,05:00:00,4,2,2,FMN GV 05 Lier
60,Mechelsesteenweg 365,2022-03-12,06:00:00,6,2,4,FMN GV 05 Lier
60,Mechelsesteenweg 365,2022-03-12,07:00:00,14,6,8,FMN GV 05 Lier
60,Mechelsesteenweg 365,2022-03-12,08:00:00,26,16,10,FMN GV 05 Lier
60,Mechelsesteenweg 365,2022-03-12,09:00:00,96,60,36,FMN GV 05 Lier
60,Mechelsesteenweg 365,2022-03-12,10:00:00,164,74,90,FMN GV 05 Lier
60,Mechelsesteenweg 365,2022-03-12,11:00:00,180,130,50,FMN GV 05 Lier
60,Mechelsesteenweg 365,2022-03-12,12:00:00,178,80,98,FMN GV 05 Lier
60,Mechelsesteenweg 365,2022-03-12,13:00:00,202,114,88,FMN GV 05 Lier
60,Mechelsesteenweg 365,2022-03-12,14:00:00,214,104,110,FMN GV 05 Lier
60,Mechelsesteenweg 365,2022-03-12,15:00:00,204,74,130,FMN GV 05 Lier
60,Mechelsesteenweg 365,2022-03-12,16:00:00,108,48,60,FMN GV 05 Lier
60,Mechelsesteenweg 365,2022-03-12,17:00:00,88,48,40,FMN GV 05 Lier
60,Mechelsesteenweg 365,2022-03-12,18:00:00,14,4,10,FMN GV 05 Lier
60,Mechelsesteenweg 365,2022-03-12,19:00:00,16,4,12,FMN GV 05 Lier
60,Mechelsesteenweg 365,2022-03-12,20:00:00,18,6,12,FMN GV 05 Lier
60,Mechelsesteenweg 365,2022-03-12,21:00:00,6,2,4,FMN GV 05 Lier
60,Mechelsesteenweg 365,2022-03-12,22:00:00,2,2,0,FMN GV 05 Lier
60,Mechelsesteenweg 365,2022-03-12,23:00:00,0,0,0,FMN GV 05 Lier
60,Mechelsesteenweg 365,2022-03-13,00:00:00,0,0,0,FMN GV 05 Lier
60,Mechelsesteenweg 365,2022-03-13,01:00:00,4,2,2,FMN GV 05 Lier
60,Mechelsesteenweg 365,2022-03-13,02:00:00,0,0,0,FMN GV 05 Lier
60,Mechelsesteenweg 365,2022-03-13,03:00:00,0,0,0,FMN GV 05 Lier
60,Mechelsesteenweg 365,2022-03-13,04:00:00,2,2,0,FMN GV 05 Lier
60,Mechelsesteenweg 365,2022-03-13,05:00:00,2,0,2,FMN GV 05 Lier
60,Mechelsesteenweg 365,2022-03-13,06:00:00,4,2,2,FMN GV 05 Lier
60,Mechelsesteenweg 365,2022-03-13,07:00:00,6,2,4,FMN GV 05 Lier
60,Mechelsesteenweg 365,2022-03-13,08:00:00,30,18,12,FMN GV 05 Lier
60,Mechelsesteenweg 365,2022-03-13,09:00:00,182,84,98,FMN GV 05 Lier
60,Mechelsesteenweg 365,2022-03-13,10:00:00,366,182,184,FMN GV 05 Lier
60,Mechelsesteenweg 365,2022-03-13,11:00:00,540,284,256,FMN GV 05 Lier
60,Mechelsesteenweg 365,2022-03-13,12:00:00,282,150,132,FMN GV 05 Lier
60,Mechelsesteenweg 365,2022-03-13,13:00:00,280,156,124,FMN GV 05 Lier
60,Mechelsesteenweg 365,2022-03-13,14:00:00,358,212,146,FMN GV 05 Lier
60,Mechelsesteenweg 365,2022-03-13,15:00:00,328,168,160,FMN GV 05 Lier
60,Mechelsesteenweg 365,2022-03-13,16:00:00,240,96,144,FMN GV 05 Lier
60,Mechelsesteenweg 365,2022-03-13,17:00:00,118,34,84,FMN GV 05 Lier
60,Mechelsesteenweg 365,2022-03-13,18:00:00,26,16,10,FMN GV 05 Lier
60,Mechelsesteenweg 365,2022-03-13,19:00:00,8,4,4,FMN GV 05 Lier
60,Mechelsesteenweg 365,2022-03-13,20:00:00,12,8,4,FMN GV 05 Lier
60,Mechelsesteenweg 365,2022-03-13,21:00:00,0,0,0,FMN GV 05 Lier
60,Mechelsesteenweg 365,2022-03-13,22:00:00,6,0,6,FMN GV 05 Lier
60,Mechelsesteenweg 365,2022-03-13,23:00:00,6,4,2,FMN GV 05 Lier
60,Mechelsesteenweg 365,2022-03-14,00:00:00,0,0,0,FMN GV 05 Lier
60,Mechelsesteenweg 365,2022-03-14,01:00:00,0,0,0,FMN GV 05 Lier
60,Mechelsesteenweg 365,2022-03-14,02:00:00,0,0,0,FMN GV 05 Lier
60,Mechelsesteenweg 365,2022-03-14,03:00:00,2,0,2,FMN GV 05 Lier
60,Mechelsesteenweg 365,2022-03-14,04:00:00,2,0,2,FMN GV 05 Lier
60,Mechelsesteenweg 365,2022-03-14,05:00:00,10,4,6,FMN GV 05 Lier
60,Mechelsesteenweg 365,2022-03-14,06:00:00,40,16,24,FMN GV 05 Lier
60,Mechelsesteenweg 365,2022-03-14,07:00:00,194,112,82,FMN GV 05 Lier
60,Mechelsesteenweg 365,2022-03-14,08:00:00,176,110,66,FMN GV 05 Lier
60,Mechelsesteenweg 365,2022-03-14,09:00:00,82,54,28,FMN GV 05 Lier
60,Mechelsesteenweg 365,2022-03-14,10:00:00,56,24,32,FMN GV 05 Lier
60,Mechelsesteenweg 365,2022-03-14,11:00:00,86,46,40,FMN GV 05 Lier
60,Mechelsesteenweg 365,2022-03-14,12:00:00,44,18,26,FMN GV 05 Lier
60,Mechelsesteenweg 365,2022-03-14,13:00:00,86,42,44,FMN GV 05 Lier
60,Mechelsesteenweg 365,2022-03-14,14:00:00,178,78,100,FMN GV 05 Lier
60,Mechelsesteenweg 365,2022-03-14,15:00:00,194,104,90,FMN GV 05 Lier
60,Mechelsesteenweg 365,2022-03-14,16:00:00,390,122,268,FMN GV 05 Lier
60,Mechelsesteenweg 365,2022-03-14,17:00:00,146,90,56,FMN GV 05 Lier
60,Mechelsesteenweg 365,2022-03-14,18:00:00,74,38,36,FMN GV 05 Lier
60,Mechelsesteenweg 365,2022-03-14,19:00:00,24,12,12,FMN GV 05 Lier
60,Mechelsesteenweg 365,2022-03-14,20:00:00,8,4,4,FMN GV 05 Lier
60,Mechelsesteenweg 365,2022-03-14,21:00:00,10,2,8,FMN GV 05 Lier
60,Mechelsesteenweg 365,2022-03-14,22:00:00,6,6,0,FMN GV 05 Lier
60,Mechelsesteenweg 365,2022-03-14,23:00:00,4,4,0,FMN GV 05 Lier
60,Mechelsesteenweg 365,2022-03-15,00:00:00,2,2,0,FMN GV 05 Lier
60,Mechelsesteenweg 365,2022-03-15,01:00:00,0,0,0,FMN GV 05 Lier
60,Mechelsesteenweg 365,2022-03-15,02:00:00,2,2,0,FMN GV 05 Lier
60,Mechelsesteenweg 365,2022-03-15,03:00:00,2,0,2,FMN GV 05 Lier
60,Mechelsesteenweg 365,2022-03-15,04:00:00,2,0,2,FMN GV 05 Lier
60,Mechelsesteenweg 365,2022-03-15,05:00:00,10,2,8,FMN GV 05 Lier
60,Mechelsesteenweg 365,2022-03-15,06:00:00,32,12,20,FMN GV 05 Lier
60,Mechelsesteenweg 365,2022-03-15,07:00:00,188,106,82,FMN GV 05 Lier
60,Mechelsesteenweg 365,2022-03-15,08:00:00,180,110,70,FMN GV 05 Lier
60,Mechelsesteenweg 365,2022-03-15,09:00:00,58,32,26,FMN GV 05 Lier
60,Mechelsesteenweg 365,2022-03-15,10:00:00,72,48,24,FMN GV 05 Lier
60,Mechelsesteenweg 365,2022-03-15,11:00:00,58,30,28,FMN GV 05 Lier
60,Mechelsesteenweg 365,2022-03-15,12:00:00,66,40,26,FMN GV 05 Lier
60,Mechelsesteenweg 365,2022-03-15,13:00:00,72,30,42,FMN GV 05 Lier
60,Mechelsesteenweg 365,2022-03-15,14:00:00,124,60,64,FMN GV 05 Lier
60,Mechelsesteenweg 365,2022-03-15,15:00:00,160,82,78,FMN GV 05 Lier
60,Mechelsesteenweg 365,2022-03-15,16:00:00,310,98,212,FMN GV 05 Lier
60,Mechelsesteenweg 365,2022-03-15,17:00:00,156,90,66,FMN GV 05 Lier
60,Mechelsesteenweg 365,2022-03-15,18:00:00,58,26,32,FMN GV 05 Lier
60,Mechelsesteenweg 365,2022-03-15,19:00:00,26,6,20,FMN GV 05 Lier
60,Mechelsesteenweg 365,2022-03-15,20:00:00,12,4,8,FMN GV 05 Lier
60,Mechelsesteenweg 365,2022-03-15,21:00:00,16,8,8,FMN GV 05 Lier
60,Mechelsesteenweg 365,2022-03-15,22:00:00,0,0,0,FMN GV 05 Lier
60,Mechelsesteenweg 365,2022-03-15,23:00:00,2,2,0,FMN GV 05 Lier
60,Mechelsesteenweg 365,2022-03-16,00:00:00,2,2,0,FMN GV 05 Lier
60,Mechelsesteenweg 365,2022-03-16,01:00:00,0,0,0,FMN GV 05 Lier
60,Mechelsesteenweg 365,2022-03-16,02:00:00,0,0,0,FMN GV 05 Lier
60,Mechelsesteenweg 365,2022-03-16,03:00:00,2,2,0,FMN GV 05 Lier
60,Mechelsesteenweg 365,2022-03-16,04:00:00,2,0,2,FMN GV 05 Lier
60,Mechelsesteenweg 365,2022-03-16,05:00:00,16,4,12,FMN GV 05 Lier
60,Mechelsesteenweg 365,2022-03-16,06:00:00,46,18,28,FMN GV 05 Lier
60,Mechelsesteenweg 365,2022-03-16,07:00:00,186,100,86,FMN GV 05 Lier
60,Mechelsesteenweg 365,2022-03-16,08:00:00,228,164,64,FMN GV 05 Lier
60,Mechelsesteenweg 365,2022-03-16,09:00:00,94,58,36,FMN GV 05 Lier
60,Mechelsesteenweg 365,2022-03-16,10:00:00,134,66,68,FMN GV 05 Lier
60,Mechelsesteenweg 365,2022-03-16,11:00:00,138,72,66,FMN GV 05 Lier
60,Mechelsesteenweg 365,2022-03-16,12:00:00,334,118,216,FMN GV 05 Lier
60,Mechelsesteenweg 365,2022-03-16,13:00:00,246,122,124,FMN GV 05 Lier
60,Mechelsesteenweg 365,2022-03-16,14:00:00,274,146,128,FMN GV 05 Lier
60,Mechelsesteenweg 365,2022-03-16,15:00:00,316,128,188,FMN GV 05 Lier
60,Mechelsesteenweg 365,2022-03-16,16:00:00,230,98,132,FMN GV 05 Lier
60,Mechelsesteenweg 365,2022-03-16,17:00:00,224,138,86,FMN GV 05 Lier
60,Mechelsesteenweg 365,2022-03-16,18:00:00,104,60,44,FMN GV 05 Lier
60,Mechelsesteenweg 365,2022-03-16,19:00:00,40,22,18,FMN GV 05 Lier
60,Mechelsesteenweg 365,2022-03-16,20:00:00,4,0,4,FMN GV 05 Lier
60,Mechelsesteenweg 365,2022-03-16,21:00:00,10,2,8,FMN GV 05 Lier
60,Mechelsesteenweg 365,2022-03-16,22:00:00,6,0,6,FMN GV 05 Lier
60,Mechelsesteenweg 365,2022-03-16,23:00:00,2,2,0,FMN GV 05 Lier
60,Mechelsesteenweg 365,2022-03-17,00:00:00,4,4,0,FMN GV 05 Lier
60,Mechelsesteenweg 365,2022-03-17,01:00:00,0,0,0,FMN GV 05 Lier
60,Mechelsesteenweg 365,2022-03-17,02:00:00,0,0,0,FMN GV 05 Lier
60,Mechelsesteenweg 365,2022-03-17,03:00:00,2,0,2,FMN GV 05 Lier
60,Mechelsesteenweg 365,2022-03-17,04:00:00,0,0,0,FMN GV 05 Lier
60,Mechelsesteenweg 365,2022-03-17,05:00:00,10,2,8,FMN GV 05 Lier
60,Mechelsesteenweg 365,2022-03-17,06:00:00,44,22,22,FMN GV 05 Lier
60,Mechelsesteenweg 365,2022-03-17,07:00:00,188,100,88,FMN GV 05 Lier
60,Mechelsesteenweg 365,2022-03-17,08:00:00,148,108,40,FMN GV 05 Lier
60,Mechelsesteenweg 365,2022-03-17,09:00:00,88,50,38,FMN GV 05 Lier
60,Mechelsesteenweg 365,2022-03-17,10:00:00,60,34,26,FMN GV 05 Lier
60,Mechelsesteenweg 365,2022-03-17,11:00:00,52,24,28,FMN GV 05 Lier
60,Mechelsesteenweg 365,2022-03-17,12:00:00,60,24,36,FMN GV 05 Lier
60,Mechelsesteenweg 365,2022-03-17,13:00:00,116,78,38,FMN GV 05 Lier
60,Mechelsesteenweg 365,2022-03-17,14:00:00,150,86,64,FMN GV 05 Lier
60,Mechelsesteenweg 365,2022-03-17,15:00:00,158,70,88,FMN GV 05 Lier
60,Mechelsesteenweg 365,2022-03-17,16:00:00,244,88,156,FMN GV 05 Lier
60,Mechelsesteenweg 365,2022-03-17,17:00:00,154,84,70,FMN GV 05 Lier
60,Mechelsesteenweg 365,2022-03-17,18:00:00,88,52,36,FMN GV 05 Lier
60,Mechelsesteenweg 365,2022-03-17,19:00:00,30,24,6,FMN GV 05 Lier
60,Mechelsesteenweg 365,2022-03-17,20:00:00,8,2,6,FMN GV 05 Lier
60,Mechelsesteenweg 365,2022-03-17,21:00:00,12,2,10,FMN GV 05 Lier
60,Mechelsesteenweg 365,2022-03-17,22:00:00,8,6,2,FMN GV 05 Lier
60,Mechelsesteenweg 365,2022-03-17,23:00:00,8,4,4,FMN GV 05 Lier
60,Mechelsesteenweg 365,2022-03-18,00:00:00,2,2,0,FMN GV 05 Lier
60,Mechelsesteenweg 365,2022-03-18,01:00:00,0,0,0,FMN GV 05 Lier
60,Mechelsesteenweg 365,2022-03-18,02:00:00,0,0,0,FMN GV 05 Lier
60,Mechelsesteenweg 365,2022-03-18,03:00:00,2,0,2,FMN GV 05 Lier
60,Mechelsesteenweg 365,2022-03-18,04:00:00,0,0,0,FMN GV 05 Lier
60,Mechelsesteenweg 365,2022-03-18,05:00:00,4,0,4,FMN GV 05 Lier
60,Mechelsesteenweg 365,2022-03-18,06:00:00,28,8,20,FMN GV 05 Lier
60,Mechelsesteenweg 365,2022-03-18,07:00:00,146,98,48,FMN GV 05 Lier
60,Mechelsesteenweg 365,2022-03-18,08:00:00,162,108,54,FMN GV 05 Lier
60,Mechelsesteenweg 365,2022-03-18,09:00:00,70,38,32,FMN GV 05 Lier
60,Mechelsesteenweg 365,2022-03-18,10:00:00,100,42,58,FMN GV 05 Lier
60,Mechelsesteenweg 365,2022-03-18,11:00:00,124,60,64,FMN GV 05 Lier
60,Mechelsesteenweg 365,2022-03-18,12:00:00,140,50,90,FMN GV 05 Lier
60,Mechelsesteenweg 365,2022-03-18,13:00:00,192,118,74,FMN GV 05 Lier
60,Mechelsesteenweg 365,2022-03-18,14:00:00,318,132,186,FMN GV 05 Lier
60,Mechelsesteenweg 365,2022-03-18,15:00:00,266,90,176,FMN GV 05 Lier
60,Mechelsesteenweg 365,2022-03-18,16:00:00,344,142,202,FMN GV 05 Lier
60,Mechelsesteenweg 365,2022-03-18,17:00:00,164,62,102,FMN GV 05 Lier
60,Mechelsesteenweg 365,2022-03-18,18:00:00,78,40,38,FMN GV 05 Lier
60,Mechelsesteenweg 365,2022-03-18,19:00:00,16,8,8,FMN GV 05 Lier
60,Mechelsesteenweg 365,2022-03-18,20:00:00,20,6,14,FMN GV 05 Lier
60,Mechelsesteenweg 365,2022-03-18,21:00:00,10,6,4,FMN GV 05 Lier
60,Mechelsesteenweg 365,2022-03-18,22:00:00,4,2,2,FMN GV 05 Lier
60,Mechelsesteenweg 365,2022-03-18,23:00:00,6,4,2,FMN GV 05 Lier
60,Mechelsesteenweg 365,2022-03-19,00:00:00,10,6,4,FMN GV 05 Lier
60,Mechelsesteenweg 365,2022-03-19,01:00:00,4,2,2,FMN GV 05 Lier
60,Mechelsesteenweg 365,2022-03-19,02:00:00,0,0,0,FMN GV 05 Lier
60,Mechelsesteenweg 365,2022-03-19,03:00:00,12,10,2,FMN GV 05 Lier
60,Mechelsesteenweg 365,2022-03-19,04:00:00,0,0,0,FMN GV 05 Lier
60,Mechelsesteenweg 365,2022-03-19,05:00:00,6,2,4,FMN GV 05 Lier
60,Mechelsesteenweg 365,2022-03-19,06:00:00,6,4,2,FMN GV 05 Lier
60,Mechelsesteenweg 365,2022-03-19,07:00:00,16,12,4,FMN GV 05 Lier
60,Mechelsesteenweg 365,2022-03-19,08:00:00,30,16,14,FMN GV 05 Lier
60,Mechelsesteenweg 365,2022-03-19,09:00:00,92,44,48,FMN GV 05 Lier
60,Mechelsesteenweg 365,2022-03-19,10:00:00,158,96,62,FMN GV 05 Lier
60,Mechelsesteenweg 365,2022-03-19,11:00:00,310,138,172,FMN GV 05 Lier
60,Mechelsesteenweg 365,2022-03-19,12:00:00,184,72,112,FMN GV 05 Lier
60,Mechelsesteenweg 365,2022-03-19,13:00:00,176,80,96,FMN GV 05 Lier
60,Mechelsesteenweg 365,2022-03-19,14:00:00,232,100,132,FMN GV 05 Lier
60,Mechelsesteenweg 365,2022-03-19,15:00:00,184,50,134,FMN GV 05 Lier
60,Mechelsesteenweg 365,2022-03-19,16:00:00,150,62,88,FMN GV 05 Lier
60,Mechelsesteenweg 365,2022-03-19,17:00:00,48,16,32,FMN GV 05 Lier
60,Mechelsesteenweg 365,2022-03-19,18:00:00,48,16,32,FMN GV 05 Lier
60,Mechelsesteenweg 365,2022-03-19,19:00:00,14,12,2,FMN GV 05 Lier
60,Mechelsesteenweg 365,2022-03-19,20:00:00,8,8,0,FMN GV 05 Lier
60,Mechelsesteenweg 365,2022-03-19,21:00:00,8,4,4,FMN GV 05 Lier
60,Mechelsesteenweg 365,2022-03-19,22:00:00,2,0,2,FMN GV 05 Lier
60,Mechelsesteenweg 365,2022-03-19,23:00:00,4,0,4,FMN GV 05 Lier
60,Mechelsesteenweg 365,2022-03-20,00:00:00,2,2,0,FMN GV 05 Lier
60,Mechelsesteenweg 365,2022-03-20,01:00:00,16,4,12,FMN GV 05 Lier
60,Mechelsesteenweg 365,2022-03-20,02:00:00,4,0,4,FMN GV 05 Lier
60,Mechelsesteenweg 365,2022-03-20,03:00:00,0,0,0,FMN GV 05 Lier
60,Mechelsesteenweg 365,2022-03-20,04:00:00,2,2,0,FMN GV 05 Lier
60,Mechelsesteenweg 365,2022-03-20,05:00:00,4,0,4,FMN GV 05 Lier
60,Mechelsesteenweg 365,2022-03-20,06:00:00,4,2,2,FMN GV 05 Lier
60,Mechelsesteenweg 365,2022-03-20,07:00:00,4,2,2,FMN GV 05 Lier
60,Mechelsesteenweg 365,2022-03-20,08:00:00,4,2,2,FMN GV 05 Lier
60,Mechelsesteenweg 365,2022-03-20,09:00:00,92,40,52,FMN GV 05 Lier
60,Mechelsesteenweg 365,2022-03-20,10:00:00,174,84,90,FMN GV 05 Lier
60,Mechelsesteenweg 365,2022-03-20,11:00:00,166,60,106,FMN GV 05 Lier
60,Mechelsesteenweg 365,2022-03-20,12:00:00,142,82,60,FMN GV 05 Lier
60,Mechelsesteenweg 365,2022-03-20,13:00:00,158,78,80,FMN GV 05 Lier
60,Mechelsesteenweg 365,2022-03-20,14:00:00,218,116,102,FMN GV 05 Lier
60,Mechelsesteenweg 365,2022-03-20,15:00:00,158,66,92,FMN GV 05 Lier
60,Mechelsesteenweg 365,2022-03-20,16:00:00,106,34,72,FMN GV 05 Lier
60,Mechelsesteenweg 365,2022-03-20,17:00:00,86,38,48,FMN GV 05 Lier
60,Mechelsesteenweg 365,2022-03-20,18:00:00,32,10,22,FMN GV 05 Lier
60,Mechelsesteenweg 365,2022-03-20,19:00:00,18,6,12,FMN GV 05 Lier
60,Mechelsesteenweg 365,2022-03-20,20:00:00,2,2,0,FMN GV 05 Lier
60,Mechelsesteenweg 365,2022-03-20,21:00:00,2,2,0,FMN GV 05 Lier
60,Mechelsesteenweg 365,2022-03-20,22:00:00,0,0,0,FMN GV 05 Lier
60,Mechelsesteenweg 365,2022-03-20,23:00:00,2,0,2,FMN GV 05 Lier
60,Mechelsesteenweg 365,2022-03-21,00:00:00,4,0,4,FMN GV 05 Lier
60,Mechelsesteenweg 365,2022-03-21,01:00:00,0,0,0,FMN GV 05 Lier
60,Mechelsesteenweg 365,2022-03-21,02:00:00,0,0,0,FMN GV 05 Lier
60,Mechelsesteenweg 365,2022-03-21,03:00:00,2,0,2,FMN GV 05 Lier
60,Mechelsesteenweg 365,2022-03-21,04:00:00,0,0,0,FMN GV 05 Lier
60,Mechelsesteenweg 365,2022-03-21,05:00:00,8,0,8,FMN GV 05 Lier
60,Mechelsesteenweg 365,2022-03-21,06:00:00,36,12,24,FMN GV 05 Lier
60,Mechelsesteenweg 365,2022-03-21,07:00:00,146,74,72,FMN GV 05 Lier
60,Mechelsesteenweg 365,2022-03-21,08:00:00,184,122,62,FMN GV 05 Lier
60,Mechelsesteenweg 365,2022-03-21,09:00:00,64,22,42,FMN GV 05 Lier
60,Mechelsesteenweg 365,2022-03-21,10:00:00,90,40,50,FMN GV 05 Lier
60,Mechelsesteenweg 365,2022-03-21,11:00:00,122,54,68,FMN GV 05 Lier
60,Mechelsesteenweg 365,2022-03-21,12:00:00,166,70,96,FMN GV 05 Lier
60,Mechelsesteenweg 365,2022-03-21,13:00:00,246,122,124,FMN GV 05 Lier
60,Mechelsesteenweg 365,2022-03-21,14:00:00,298,150,148,FMN GV 05 Lier
60,Mechelsesteenweg 365,2022-03-21,15:00:00,282,116,166,FMN GV 05 Lier
60,Mechelsesteenweg 365,2022-03-21,16:00:00,406,152,254,FMN GV 05 Lier
60,Mechelsesteenweg 365,2022-03-21,17:00:00,214,122,92,FMN GV 05 Lier
60,Mechelsesteenweg 365,2022-03-21,18:00:00,122,74,48,FMN GV 05 Lier
60,Mechelsesteenweg 365,2022-03-21,19:00:00,28,16,12,FMN GV 05 Lier
60,Mechelsesteenweg 365,2022-03-21,20:00:00,8,6,2,FMN GV 05 Lier
60,Mechelsesteenweg 365,2022-03-21,21:00:00,6,4,2,FMN GV 05 Lier
60,Mechelsesteenweg 365,2022-03-21,22:00:00,16,12,4,FMN GV 05 Lier
60,Mechelsesteenweg 365,2022-03-21,23:00:00,0,0,0,FMN GV 05 Lier
60,Mechelsesteenweg 365,2022-03-22,00:00:00,0,0,0,FMN GV 05 Lier
60,Mechelsesteenweg 365,2022-03-22,01:00:00,0,0,0,FMN GV 05 Lier
60,Mechelsesteenweg 365,2022-03-22,02:00:00,0,0,0,FMN GV 05 Lier
60,Mechelsesteenweg 365,2022-03-22,03:00:00,0,0,0,FMN GV 05 Lier
60,Mechelsesteenweg 365,2022-03-22,04:00:00,4,0,4,FMN GV 05 Lier
60,Mechelsesteenweg 365,2022-03-22,05:00:00,10,2,8,FMN GV 05 Lier
60,Mechelsesteenweg 365,2022-03-22,06:00:00,54,12,42,FMN GV 05 Lier
60,Mechelsesteenweg 365,2022-03-22,07:00:00,180,104,76,FMN GV 05 Lier
60,Mechelsesteenweg 365,2022-03-22,08:00:00,176,104,72,FMN GV 05 Lier
60,Mechelsesteenweg 365,2022-03-22,09:00:00,100,40,60,FMN GV 05 Lier
60,Mechelsesteenweg 365,2022-03-22,10:00:00,114,48,66,FMN GV 05 Lier
60,Mechelsesteenweg 365,2022-03-22,11:00:00,162,94,68,FMN GV 05 Lier
60,Mechelsesteenweg 365,2022-03-22,12:00:00,212,92,120,FMN GV 05 Lier
60,Mechelsesteenweg 365,2022-03-22,13:00:00,326,172,154,FMN GV 05 Lier
60,Mechelsesteenweg 365,2022-03-22,14:00:00,368,206,162,FMN GV 05 Lier
60,Mechelsesteenweg 365,2022-03-22,15:00:00,396,178,218,FMN GV 05 Lier
60,Mechelsesteenweg 365,2022-03-22,16:00:00,436,190,246,FMN GV 05 Lier
60,Mechelsesteenweg 365,2022-03-22,17:00:00,264,158,106,FMN GV 05 Lier
60,Mechelsesteenweg 365,2022-03-22,18:00:00,118,50,68,FMN GV 05 Lier
60,Mechelsesteenweg 365,2022-03-22,19:00:00,30,14,16,FMN GV 05 Lier
60,Mechelsesteenweg 365,2022-03-22,20:00:00,8,4,4,FMN GV 05 Lier
60,Mechelsesteenweg 365,2022-03-22,21:00:00,6,2,4,FMN GV 05 Lier
60,Mechelsesteenweg 365,2022-03-22,22:00:00,16,8,8,FMN GV 05 Lier
60,Mechelsesteenweg 365,2022-03-22,23:00:00,0,0,0,FMN GV 05 Lier
60,Mechelsesteenweg 365,2022-03-23,00:00:00,0,0,0,FMN GV 05 Lier
60,Mechelsesteenweg 365,2022-03-23,01:00:00,0,0,0,FMN GV 05 Lier
60,Mechelsesteenweg 365,2022-03-23,02:00:00,0,0,0,FMN GV 05 Lier
60,Mechelsesteenweg 365,2022-03-23,03:00:00,2,0,2,FMN GV 05 Lier
60,Mechelsesteenweg 365,2022-03-23,04:00:00,4,0,4,FMN GV 05 Lier
60,Mechelsesteenweg 365,2022-03-23,05:00:00,6,2,4,FMN GV 05 Lier
60,Mechelsesteenweg 365,2022-03-23,06:00:00,38,8,30,FMN GV 05 Lier
60,Mechelsesteenweg 365,2022-03-23,07:00:00,192,104,88,FMN GV 05 Lier
60,Mechelsesteenweg 365,2022-03-23,08:00:00,222,128,94,FMN GV 05 Lier
60,Mechelsesteenweg 365,2022-03-23,09:00:00,126,58,68,FMN GV 05 Lier
60,Mechelsesteenweg 365,2022-03-23,10:00:00,154,74,80,FMN GV 05 Lier
60,Mechelsesteenweg 365,2022-03-23,11:00:00,208,112,96,FMN GV 05 Lier
60,Mechelsesteenweg 365,2022-03-23,12:00:00,330,126,204,FMN GV 05 Lier
60,Mechelsesteenweg 365,2022-03-23,13:00:00,312,200,112,FMN GV 05 Lier
60,Mechelsesteenweg 365,2022-03-23,14:00:00,400,186,214,FMN GV 05 Lier
60,Mechelsesteenweg 365,2022-03-23,15:00:00,400,240,160,FMN GV 05 Lier
60,Mechelsesteenweg 365,2022-03-23,16:00:00,328,144,184,FMN GV 05 Lier
60,Mechelsesteenweg 365,2022-03-23,17:00:00,266,146,120,FMN GV 05 Lier
60,Mechelsesteenweg 365,2022-03-23,18:00:00,224,142,82,FMN GV 05 Lier
60,Mechelsesteenweg 365,2022-03-23,19:00:00,32,12,20,FMN GV 05 Lier
60,Mechelsesteenweg 365,2022-03-23,20:00:00,20,6,14,FMN GV 05 Lier
60,Mechelsesteenweg 365,2022-03-23,21:00:00,10,4,6,FMN GV 05 Lier
60,Mechelsesteenweg 365,2022-03-23,22:00:00,10,6,4,FMN GV 05 Lier
60,Mechelsesteenweg 365,2022-03-23,23:00:00,2,0,2,FMN GV 05 Lier
60,Mechelsesteenweg 365,2022-03-24,00:00:00,0,0,0,FMN GV 05 Lier
60,Mechelsesteenweg 365,2022-03-24,01:00:00,0,0,0,FMN GV 05 Lier
60,Mechelsesteenweg 365,2022-03-24,02:00:00,0,0,0,FMN GV 05 Lier
60,Mechelsesteenweg 365,2022-03-24,03:00:00,2,0,2,FMN GV 05 Lier
60,Mechelsesteenweg 365,2022-03-24,04:00:00,4,0,4,FMN GV 05 Lier
60,Mechelsesteenweg 365,2022-03-24,05:00:00,16,2,14,FMN GV 05 Lier
60,Mechelsesteenweg 365,2022-03-24,06:00:00,34,8,26,FMN GV 05 Lier
60,Mechelsesteenweg 365,2022-03-24,07:00:00,182,94,88,FMN GV 05 Lier
60,Mechelsesteenweg 365,2022-03-24,08:00:00,198,134,64,FMN GV 05 Lier
60,Mechelsesteenweg 365,2022-03-24,09:00:00,104,52,52,FMN GV 05 Lier
60,Mechelsesteenweg 365,2022-03-24,10:00:00,174,56,118,FMN GV 05 Lier
60,Mechelsesteenweg 365,2022-03-24,11:00:00,162,82,80,FMN GV 05 Lier
60,Mechelsesteenweg 365,2022-03-24,12:00:00,180,78,102,FMN GV 05 Lier
60,Mechelsesteenweg 365,2022-03-24,13:00:00,204,108,96,FMN GV 05 Lier
60,Mechelsesteenweg 365,2022-03-24,14:00:00,396,208,188,FMN GV 05 Lier
60,Mechelsesteenweg 365,2022-03-24,15:00:00,358,142,216,FMN GV 05 Lier
60,Mechelsesteenweg 365,2022-03-24,16:00:00,314,152,162,FMN GV 05 Lier
60,Mechelsesteenweg 365,2022-03-24,17:00:00,260,138,122,FMN GV 05 Lier
60,Mechelsesteenweg 365,2022-03-24,18:00:00,150,70,80,FMN GV 05 Lier
60,Mechelsesteenweg 365,2022-03-24,19:00:00,44,34,10,FMN GV 05 Lier
60,Mechelsesteenweg 365,2022-03-24,20:00:00,20,6,14,FMN GV 05 Lier
60,Mechelsesteenweg 365,2022-03-24,21:00:00,6,2,4,FMN GV 05 Lier
60,Mechelsesteenweg 365,2022-03-24,22:00:00,8,8,0,FMN GV 05 Lier
60,Mechelsesteenweg 365,2022-03-24,23:00:00,4,4,0,FMN GV 05 Lier
60,Mechelsesteenweg 365,2022-03-25,00:00:00,0,0,0,FMN GV 05 Lier
60,Mechelsesteenweg 365,2022-03-25,01:00:00,2,0,2,FMN GV 05 Lier
60,Mechelsesteenweg 365,2022-03-25,02:00:00,0,0,0,FMN GV 05 Lier
60,Mechelsesteenweg 365,2022-03-25,03:00:00,4,0,4,FMN GV 05 Lier
60,Mechelsesteenweg 365,2022-03-25,04:00:00,2,0,2,FMN GV 05 Lier
60,Mechelsesteenweg 365,2022-03-25,05:00:00,16,2,14,FMN GV 05 Lier
60,Mechelsesteenweg 365,2022-03-25,06:00:00,22,4,18,FMN GV 05 Lier
60,Mechelsesteenweg 365,2022-03-25,07:00:00,170,104,66,FMN GV 05 Lier
60,Mechelsesteenweg 365,2022-03-25,08:00:00,168,106,62,FMN GV 05 Lier
60,Mechelsesteenweg 365,2022-03-25,09:00:00,72,32,40,FMN GV 05 Lier
60,Mechelsesteenweg 365,2022-03-25,10:00:00,198,66,132,FMN GV 05 Lier
60,Mechelsesteenweg 365,2022-03-25,11:00:00,162,96,66,FMN GV 05 Lier
60,Mechelsesteenweg 365,2022-03-25,12:00:00,184,64,120,FMN GV 05 Lier
60,Mechelsesteenweg 365,2022-03-25,13:00:00,238,124,114,FMN GV 05 Lier
60,Mechelsesteenweg 365,2022-03-25,14:00:00,376,180,196,FMN GV 05 Lier
60,Mechelsesteenweg 365,2022-03-25,15:00:00,324,120,204,FMN GV 05 Lier
60,Mechelsesteenweg 365,2022-03-25,16:00:00,328,150,178,FMN GV 05 Lier
60,Mechelsesteenweg 365,2022-03-25,17:00:00,134,72,62,FMN GV 05 Lier
60,Mechelsesteenweg 365,2022-03-25,18:00:00,120,62,58,FMN GV 05 Lier
60,Mechelsesteenweg 365,2022-03-25,19:00:00,14,10,4,FMN GV 05 Lier
60,Mechelsesteenweg 365,2022-03-25,20:00:00,20,10,10,FMN GV 05 Lier
60,Mechelsesteenweg 365,2022-03-25,21:00:00,10,4,6,FMN GV 05 Lier
60,Mechelsesteenweg 365,2022-03-25,22:00:00,16,4,12,FMN GV 05 Lier
60,Mechelsesteenweg 365,2022-03-25,23:00:00,4,2,2,FMN GV 05 Lier
60,Mechelsesteenweg 365,2022-03-26,00:00:00,12,6,6,FMN GV 05 Lier
60,Mechelsesteenweg 365,2022-03-26,01:00:00,2,0,2,FMN GV 05 Lier
60,Mechelsesteenweg 365,2022-03-26,02:00:00,6,2,4,FMN GV 05 Lier
60,Mechelsesteenweg 365,2022-03-26,03:00:00,4,0,4,FMN GV 05 Lier
60,Mechelsesteenweg 365,2022-03-26,04:00:00,2,0,2,FMN GV 05 Lier
60,Mechelsesteenweg 365,2022-03-26,05:00:00,4,0,4,FMN GV 05 Lier
60,Mechelsesteenweg 365,2022-03-26,06:00:00,4,2,2,FMN GV 05 Lier
60,Mechelsesteenweg 365,2022-03-26,07:00:00,18,2,16,FMN GV 05 Lier
60,Mechelsesteenweg 365,2022-03-26,08:00:00,30,16,14,FMN GV 05 Lier
60,Mechelsesteenweg 365,2022-03-26,09:00:00,92,60,32,FMN GV 05 Lier
60,Mechelsesteenweg 365,2022-03-26,10:00:00,290,162,128,FMN GV 05 Lier
60,Mechelsesteenweg 365,2022-03-26,11:00:00,352,144,208,FMN GV 05 Lier
60,Mechelsesteenweg 365,2022-03-26,12:00:00,284,130,154,FMN GV 05 Lier
60,Mechelsesteenweg 365,2022-03-26,13:00:00,354,156,198,FMN GV 05 Lier
60,Mechelsesteenweg 365,2022-03-26,14:00:00,476,240,236,FMN GV 05 Lier
60,Mechelsesteenweg 365,2022-03-26,15:00:00,510,186,324,FMN GV 05 Lier
60,Mechelsesteenweg 365,2022-03-26,16:00:00,354,102,252,FMN GV 05 Lier
60,Mechelsesteenweg 365,2022-03-26,17:00:00,142,50,92,FMN GV 05 Lier
60,Mechelsesteenweg 365,2022-03-26,18:00:00,78,44,34,FMN GV 05 Lier
60,Mechelsesteenweg 365,2022-03-26,19:00:00,30,12,18,FMN GV 05 Lier
60,Mechelsesteenweg 365,2022-03-26,20:00:00,6,2,4,FMN GV 05 Lier
60,Mechelsesteenweg 365,2022-03-26,21:00:00,4,4,0,FMN GV 05 Lier
60,Mechelsesteenweg 365,2022-03-26,22:00:00,8,0,8,FMN GV 05 Lier
60,Mechelsesteenweg 365,2022-03-26,23:00:00,0,0,0,FMN GV 05 Lier
60,Mechelsesteenweg 365,2022-03-27,00:00:00,2,2,0,FMN GV 05 Lier
60,Mechelsesteenweg 365,2022-03-27,01:00:00,2,0,2,FMN GV 05 Lier
60,Mechelsesteenweg 365,2022-03-27,02:00:00,0,0,0,FMN GV 05 Lier
60,Mechelsesteenweg 365,2022-03-27,03:00:00,0,0,0,FMN GV 05 Lier
60,Mechelsesteenweg 365,2022-03-27,04:00:00,4,4,0,FMN GV 05 Lier
60,Mechelsesteenweg 365,2022-03-27,05:00:00,2,0,2,FMN GV 05 Lier
60,Mechelsesteenweg 365,2022-03-27,06:00:00,0,0,0,FMN GV 05 Lier
60,Mechelsesteenweg 365,2022-03-27,07:00:00,6,6,0,FMN GV 05 Lier
60,Mechelsesteenweg 365,2022-03-27,08:00:00,20,10,10,FMN GV 05 Lier
60,Mechelsesteenweg 365,2022-03-27,09:00:00,100,56,44,FMN GV 05 Lier
60,Mechelsesteenweg 365,2022-03-27,10:00:00,292,158,134,FMN GV 05 Lier
60,Mechelsesteenweg 365,2022-03-27,11:00:00,380,180,200,FMN GV 05 Lier
60,Mechelsesteenweg 365,2022-03-27,12:00:00,180,84,96,FMN GV 05 Lier
60,Mechelsesteenweg 365,2022-03-27,13:00:00,176,66,110,FMN GV 05 Lier
60,Mechelsesteenweg 365,2022-03-27,14:00:00,160,76,84,FMN GV 05 Lier
60,Mechelsesteenweg 365,2022-03-27,15:00:00,210,102,108,FMN GV 05 Lier
60,Mechelsesteenweg 365,2022-03-27,16:00:00,160,68,92,FMN GV 05 Lier
60,Mechelsesteenweg 365,2022-03-27,17:00:00,154,64,90,FMN GV 05 Lier
60,Mechelsesteenweg 365,2022-03-27,18:00:00,112,44,68,FMN GV 05 Lier
60,Mechelsesteenweg 365,2022-03-27,19:00:00,34,14,20,FMN GV 05 Lier
60,Mechelsesteenweg 365,2022-03-27,20:00:00,22,8,14,FMN GV 05 Lier
60,Mechelsesteenweg 365,2022-03-27,21:00:00,4,2,2,FMN GV 05 Lier
60,Mechelsesteenweg 365,2022-03-27,22:00:00,4,2,2,FMN GV 05 Lier
60,Mechelsesteenweg 365,2022-03-27,23:00:00,0,0,0,FMN GV 05 Lier
60,Mechelsesteenweg 365,2022-03-28,00:00:00,0,0,0,FMN GV 05 Lier
60,Mechelsesteenweg 365,2022-03-28,01:00:00,0,0,0,FMN GV 05 Lier
60,Mechelsesteenweg 365,2022-03-28,02:00:00,0,0,0,FMN GV 05 Lier
60,Mechelsesteenweg 365,2022-03-28,03:00:00,2,0,2,FMN GV 05 Lier
60,Mechelsesteenweg 365,2022-03-28,04:00:00,0,0,0,FMN GV 05 Lier
60,Mechelsesteenweg 365,2022-03-28,05:00:00,6,0,6,FMN GV 05 Lier
60,Mechelsesteenweg 365,2022-03-28,06:00:00,36,14,22,FMN GV 05 Lier
60,Mechelsesteenweg 365,2022-03-28,07:00:00,182,90,92,FMN GV 05 Lier
60,Mechelsesteenweg 365,2022-03-28,08:00:00,166,84,82,FMN GV 05 Lier
60,Mechelsesteenweg 365,2022-03-28,09:00:00,60,30,30,FMN GV 05 Lier
60,Mechelsesteenweg 365,2022-03-28,10:00:00,100,50,50,FMN GV 05 Lier
60,Mechelsesteenweg 365,2022-03-28,11:00:00,120,40,80,FMN GV 05 Lier
60,Mechelsesteenweg 365,2022-03-28,12:00:00,226,98,128,FMN GV 05 Lier
60,Mechelsesteenweg 365,2022-03-28,13:00:00,264,140,124,FMN GV 05 Lier
60,Mechelsesteenweg 365,2022-03-28,14:00:00,352,218,134,FMN GV 05 Lier
60,Mechelsesteenweg 365,2022-03-28,15:00:00,390,216,174,FMN GV 05 Lier
60,Mechelsesteenweg 365,2022-03-28,16:00:00,338,172,166,FMN GV 05 Lier
60,Mechelsesteenweg 365,2022-03-28,17:00:00,258,150,108,FMN GV 05 Lier
60,Mechelsesteenweg 365,2022-03-28,18:00:00,170,70,100,FMN GV 05 Lier
60,Mechelsesteenweg 365,2022-03-28,19:00:00,76,34,42,FMN GV 05 Lier
60,Mechelsesteenweg 365,2022-03-28,20:00:00,8,4,4,FMN GV 05 Lier
60,Mechelsesteenweg 365,2022-03-28,21:00:00,20,4,16,FMN GV 05 Lier
60,Mechelsesteenweg 365,2022-03-28,22:00:00,4,4,0,FMN GV 05 Lier
60,Mechelsesteenweg 365,2022-03-28,23:00:00,4,4,0,FMN GV 05 Lier
60,Mechelsesteenweg 365,2022-03-29,00:00:00,0,0,0,FMN GV 05 Lier
60,Mechelsesteenweg 365,2022-03-29,01:00:00,0,0,0,FMN GV 05 Lier
60,Mechelsesteenweg 365,2022-03-29,02:00:00,0,0,0,FMN GV 05 Lier
60,Mechelsesteenweg 365,2022-03-29,03:00:00,2,0,2,FMN GV 05 Lier
60,Mechelsesteenweg 365,2022-03-29,04:00:00,2,2,0,FMN GV 05 Lier
60,Mechelsesteenweg 365,2022-03-29,05:00:00,8,2,6,FMN GV 05 Lier
60,Mechelsesteenweg 365,2022-03-29,06:00:00,58,18,40,FMN GV 05 Lier
60,Mechelsesteenweg 365,2022-03-29,07:00:00,188,94,94,FMN GV 05 Lier
60,Mechelsesteenweg 365,2022-03-29,08:00:00,172,82,90,FMN GV 05 Lier
60,Mechelsesteenweg 365,2022-03-29,09:00:00,70,34,36,FMN GV 05 Lier
60,Mechelsesteenweg 365,2022-03-29,10:00:00,92,42,50,FMN GV 05 Lier
60,Mechelsesteenweg 365,2022-03-29,11:00:00,90,36,54,FMN GV 05 Lier
60,Mechelsesteenweg 365,2022-03-29,12:00:00,108,50,58,FMN GV 05 Lier
60,Mechelsesteenweg 365,2022-03-29,13:00:00,154,66,88,FMN GV 05 Lier
60,Mechelsesteenweg 365,2022-03-29,14:00:00,190,84,106,FMN GV 05 Lier
60,Mechelsesteenweg 365,2022-03-29,15:00:00,218,112,106,FMN GV 05 Lier
60,Mechelsesteenweg 365,2022-03-29,16:00:00,236,118,118,FMN GV 05 Lier
60,Mechelsesteenweg 365,2022-03-29,17:00:00,222,136,86,FMN GV 05 Lier
60,Mechelsesteenweg 365,2022-03-29,18:00:00,94,46,48,FMN GV 05 Lier
60,Mechelsesteenweg 365,2022-03-29,19:00:00,74,48,26,FMN GV 05 Lier
60,Mechelsesteenweg 365,2022-03-29,20:00:00,54,26,28,FMN GV 05 Lier
60,Mechelsesteenweg 365,2022-03-29,21:00:00,6,2,4,FMN GV 05 Lier
60,Mechelsesteenweg 365,2022-03-29,22:00:00,16,14,2,FMN GV 05 Lier
60,Mechelsesteenweg 365,2022-03-29,23:00:00,2,2,0,FMN GV 05 Lier
60,Mechelsesteenweg 365,2022-03-30,00:00:00,2,2,0,FMN GV 05 Lier
60,Mechelsesteenweg 365,2022-03-30,01:00:00,2,2,0,FMN GV 05 Lier
60,Mechelsesteenweg 365,2022-03-30,02:00:00,0,0,0,FMN GV 05 Lier
60,Mechelsesteenweg 365,2022-03-30,03:00:00,2,0,2,FMN GV 05 Lier
60,Mechelsesteenweg 365,2022-03-30,04:00:00,6,2,4,FMN GV 05 Lier
60,Mechelsesteenweg 365,2022-03-30,05:00:00,20,4,16,FMN GV 05 Lier
60,Mechelsesteenweg 365,2022-03-30,06:00:00,60,24,36,FMN GV 05 Lier
60,Mechelsesteenweg 365,2022-03-30,07:00:00,150,74,76,FMN GV 05 Lier
60,Mechelsesteenweg 365,2022-03-30,08:00:00,178,86,92,FMN GV 05 Lier
60,Mechelsesteenweg 365,2022-03-30,09:00:00,110,64,46,FMN GV 05 Lier
60,Mechelsesteenweg 365,2022-03-30,10:00:00,100,48,52,FMN GV 05 Lier
60,Mechelsesteenweg 365,2022-03-30,11:00:00,118,66,52,FMN GV 05 Lier
60,Mechelsesteenweg 365,2022-03-30,12:00:00,182,64,118,FMN GV 05 Lier
60,Mechelsesteenweg 365,2022-03-30,13:00:00,146,86,60,FMN GV 05 Lier
60,Mechelsesteenweg 365,2022-03-30,14:00:00,254,136,118,FMN GV 05 Lier
60,Mechelsesteenweg 365,2022-03-30,15:00:00,160,76,84,FMN GV 05 Lier
60,Mechelsesteenweg 365,2022-03-30,16:00:00,224,120,104,FMN GV 05 Lier
60,Mechelsesteenweg 365,2022-03-30,17:00:00,158,94,64,FMN GV 05 Lier
60,Mechelsesteenweg 365,2022-03-30,18:00:00,144,62,82,FMN GV 05 Lier
60,Mechelsesteenweg 365,2022-03-30,19:00:00,98,62,36,FMN GV 05 Lier
60,Mechelsesteenweg 365,2022-03-30,20:00:00,92,80,12,FMN GV 05 Lier
60,Mechelsesteenweg 365,2022-03-30,21:00:00,18,8,10,FMN GV 05 Lier
60,Mechelsesteenweg 365,2022-03-30,22:00:00,6,6,0,FMN GV 05 Lier
60,Mechelsesteenweg 365,2022-03-30,23:00:00,4,2,2,FMN GV 05 Lier
60,Mechelsesteenweg 365,2022-03-31,00:00:00,0,0,0,FMN GV 05 Lier
60,Mechelsesteenweg 365,2022-03-31,01:00:00,4,2,2,FMN GV 05 Lier
60,Mechelsesteenweg 365,2022-03-31,02:00:00,0,0,0,FMN GV 05 Lier
60,Mechelsesteenweg 365,2022-03-31,03:00:00,2,0,2,FMN GV 05 Lier
60,Mechelsesteenweg 365,2022-03-31,04:00:00,2,0,2,FMN GV 05 Lier
60,Mechelsesteenweg 365,2022-03-31,05:00:00,14,6,8,FMN GV 05 Lier
60,Mechelsesteenweg 365,2022-03-31,06:00:00,40,10,30,FMN GV 05 Lier
60,Mechelsesteenweg 365,2022-03-31,07:00:00,82,38,44,FMN GV 05 Lier
60,Mechelsesteenweg 365,2022-03-31,08:00:00,114,58,56,FMN GV 05 Lier
60,Mechelsesteenweg 365,2022-03-31,09:00:00,78,70,8,FMN GV 05 Lier
60,Mechelsesteenweg 365,2022-03-31,10:00:00,30,12,18,FMN GV 05 Lier
60,Mechelsesteenweg 365,2022-03-31,11:00:00,26,18,8,FMN GV 05 Lier
60,Mechelsesteenweg 365,2022-03-31,12:00:00,90,24,66,FMN GV 05 Lier
60,Mechelsesteenweg 365,2022-03-31,13:00:00,72,26,46,FMN GV 05 Lier
60,Mechelsesteenweg 365,2022-03-31,14:00:00,82,46,36,FMN GV 05 Lier
60,Mechelsesteenweg 365,2022-03-31,15:00:00,114,58,56,FMN GV 05 Lier
60,Mechelsesteenweg 365,2022-03-31,16:00:00,118,72,46,FMN GV 05 Lier
60,Mechelsesteenweg 365,2022-03-31,17:00:00,112,68,44,FMN GV 05 Lier
60,Mechelsesteenweg 365,2022-03-31,18:00:00,52,18,34,FMN GV 05 Lier
60,Mechelsesteenweg 365,2022-03-31,19:00:00,38,18,20,FMN GV 05 Lier
60,Mechelsesteenweg 365,2022-03-31,20:00:00,30,10,20,FMN GV 05 Lier
60,Mechelsesteenweg 365,2022-03-31,21:00:00,2,2,0,FMN GV 05 Lier
60,Mechelsesteenweg 365,2022-03-31,22:00:00,22,10,12,FMN GV 05 Lier
60,Mechelsesteenweg 365,2022-03-31,23:00:00,4,4,0,FMN GV 05 Lier
60,Mechelsesteenweg 365,2022-04-01,00:00:00,0,0,0,FMN GV 05 Lier
60,Mechelsesteenweg 365,2022-04-01,01:00:00,0,0,0,FMN GV 05 Lier
60,Mechelsesteenweg 365,2022-04-01,02:00:00,2,2,0,FMN GV 05 Lier
60,Mechelsesteenweg 365,2022-04-01,03:00:00,0,0,0,FMN GV 05 Lier
60,Mechelsesteenweg 365,2022-04-01,04:00:00,0,0,0,FMN GV 05 Lier
60,Mechelsesteenweg 365,2022-04-01,05:00:00,8,8,0,FMN GV 05 Lier
60,Mechelsesteenweg 365,2022-04-01,06:00:00,24,14,10,FMN GV 05 Lier
60,Mechelsesteenweg 365,2022-04-01,07:00:00,66,20,46,FMN GV 05 Lier
60,Mechelsesteenweg 365,2022-04-01,08:00:00,58,34,24,FMN GV 05 Lier
60,Mechelsesteenweg 365,2022-04-01,09:00:00,72,56,16,FMN GV 05 Lier
60,Mechelsesteenweg 365,2022-04-01,10:00:00,116,84,32,FMN GV 05 Lier
60,Mechelsesteenweg 365,2022-04-01,11:00:00,22,12,10,FMN GV 05 Lier
60,Mechelsesteenweg 365,2022-04-01,12:00:00,70,10,60,FMN GV 05 Lier
60,Mechelsesteenweg 365,2022-04-01,13:00:00,38,26,12,FMN GV 05 Lier
60,Mechelsesteenweg 365,2022-04-01,14:00:00,126,28,98,FMN GV 05 Lier
60,Mechelsesteenweg 365,2022-04-01,15:00:00,72,18,54,FMN GV 05 Lier
60,Mechelsesteenweg 365,2022-04-01,16:00:00,76,52,24,FMN GV 05 Lier
60,Mechelsesteenweg 365,2022-04-01,17:00:00,32,26,6,FMN GV 05 Lier
60,Mechelsesteenweg 365,2022-04-01,18:00:00,20,12,8,FMN GV 05 Lier
60,Mechelsesteenweg 365,2022-04-01,19:00:00,8,4,4,FMN GV 05 Lier
60,Mechelsesteenweg 365,2022-04-01,20:00:00,10,6,4,FMN GV 05 Lier
60,Mechelsesteenweg 365,2022-04-01,21:00:00,10,2,8,FMN GV 05 Lier
60,Mechelsesteenweg 365,2022-04-01,22:00:00,6,4,2,FMN GV 05 Lier
60,Mechelsesteenweg 365,2022-04-01,23:00:00,2,2,0,FMN GV 05 Lier
60,Mechelsesteenweg 365,2022-04-02,00:00:00,2,0,2,FMN GV 05 Lier
60,Mechelsesteenweg 365,2022-04-02,01:00:00,2,0,2,FMN GV 05 Lier
60,Mechelsesteenweg 365,2022-04-02,02:00:00,2,2,0,FMN GV 05 Lier
60,Mechelsesteenweg 365,2022-04-02,03:00:00,0,0,0,FMN GV 05 Lier
60,Mechelsesteenweg 365,2022-04-02,04:00:00,0,0,0,FMN GV 05 Lier
60,Mechelsesteenweg 365,2022-04-02,05:00:00,4,2,2,FMN GV 05 Lier
60,Mechelsesteenweg 365,2022-04-02,06:00:00,8,2,6,FMN GV 05 Lier
60,Mechelsesteenweg 365,2022-04-02,07:00:00,8,4,4,FMN GV 05 Lier
60,Mechelsesteenweg 365,2022-04-02,08:00:00,14,8,6,FMN GV 05 Lier
60,Mechelsesteenweg 365,2022-04-02,09:00:00,34,26,8,FMN GV 05 Lier
60,Mechelsesteenweg 365,2022-04-02,10:00:00,62,32,30,FMN GV 05 Lier
60,Mechelsesteenweg 365,2022-04-02,11:00:00,72,22,50,FMN GV 05 Lier
60,Mechelsesteenweg 365,2022-04-02,12:00:00,98,46,52,FMN GV 05 Lier
60,Mechelsesteenweg 365,2022-04-02,13:00:00,106,36,70,FMN GV 05 Lier
60,Mechelsesteenweg 365,2022-04-02,14:00:00,80,40,40,FMN GV 05 Lier
60,Mechelsesteenweg 365,2022-04-02,15:00:00,100,38,62,FMN GV 05 Lier
60,Mechelsesteenweg 365,2022-04-02,16:00:00,68,32,36,FMN GV 05 Lier
60,Mechelsesteenweg 365,2022-04-02,17:00:00,38,10,28,FMN GV 05 Lier
60,Mechelsesteenweg 365,2022-04-02,18:00:00,42,32,10,FMN GV 05 Lier
60,Mechelsesteenweg 365,2022-04-02,19:00:00,4,0,4,FMN GV 05 Lier
60,Mechelsesteenweg 365,2022-04-02,20:00:00,6,0,6,FMN GV 05 Lier
60,Mechelsesteenweg 365,2022-04-02,21:00:00,10,2,8,FMN GV 05 Lier
60,Mechelsesteenweg 365,2022-04-02,22:00:00,6,4,2,FMN GV 05 Lier
60,Mechelsesteenweg 365,2022-04-02,23:00:00,8,2,6,FMN GV 05 Lier
60,Mechelsesteenweg 365,2022-04-03,00:00:00,2,2,0,FMN GV 05 Lier
60,Mechelsesteenweg 365,2022-04-03,01:00:00,2,2,0,FMN GV 05 Lier
60,Mechelsesteenweg 365,2022-04-03,02:00:00,6,6,0,FMN GV 05 Lier
60,Mechelsesteenweg 365,2022-04-03,03:00:00,0,0,0,FMN GV 05 Lier
60,Mechelsesteenweg 365,2022-04-03,04:00:00,0,0,0,FMN GV 05 Lier
60,Mechelsesteenweg 365,2022-04-03,05:00:00,0,0,0,FMN GV 05 Lier
60,Mechelsesteenweg 365,2022-04-03,06:00:00,6,2,4,FMN GV 05 Lier
60,Mechelsesteenweg 365,2022-04-03,07:00:00,0,0,0,FMN GV 05 Lier
60,Mechelsesteenweg 365,2022-04-03,08:00:00,24,12,12,FMN GV 05 Lier
60,Mechelsesteenweg 365,2022-04-03,09:00:00,120,60,60,FMN GV 05 Lier
60,Mechelsesteenweg 365,2022-04-03,10:00:00,210,96,114,FMN GV 05 Lier
60,Mechelsesteenweg 365,2022-04-03,11:00:00,202,106,96,FMN GV 05 Lier
60,Mechelsesteenweg 365,2022-04-03,12:00:00,216,110,106,FMN GV 05 Lier
60,Mechelsesteenweg 365,2022-04-03,13:00:00,138,74,64,FMN GV 05 Lier
60,Mechelsesteenweg 365,2022-04-03,14:00:00,130,30,100,FMN GV 05 Lier
60,Mechelsesteenweg 365,2022-04-03,15:00:00,82,54,28,FMN GV 05 Lier
60,Mechelsesteenweg 365,2022-04-03,16:00:00,74,34,40,FMN GV 05 Lier
60,Mechelsesteenweg 365,2022-04-03,17:00:00,40,22,18,FMN GV 05 Lier
60,Mechelsesteenweg 365,2022-04-03,18:00:00,50,26,24,FMN GV 05 Lier
60,Mechelsesteenweg 365,2022-04-03,19:00:00,6,2,4,FMN GV 05 Lier
60,Mechelsesteenweg 365,2022-04-03,20:00:00,14,2,12,FMN GV 05 Lier
60,Mechelsesteenweg 365,2022-04-03,21:00:00,6,2,4,FMN GV 05 Lier
60,Mechelsesteenweg 365,2022-04-03,22:00:00,4,2,2,FMN GV 05 Lier
60,Mechelsesteenweg 365,2022-04-03,23:00:00,0,0,0,FMN GV 05 Lier
60,Mechelsesteenweg 365,2022-04-04,00:00:00,0,0,0,FMN GV 05 Lier
60,Mechelsesteenweg 365,2022-04-04,01:00:00,0,0,0,FMN GV 05 Lier
60,Mechelsesteenweg 365,2022-04-04,02:00:00,0,0,0,FMN GV 05 Lier
60,Mechelsesteenweg 365,2022-04-04,03:00:00,2,0,2,FMN GV 05 Lier
60,Mechelsesteenweg 365,2022-04-04,04:00:00,4,4,0,FMN GV 05 Lier
60,Mechelsesteenweg 365,2022-04-04,05:00:00,8,2,6,FMN GV 05 Lier
60,Mechelsesteenweg 365,2022-04-04,06:00:00,50,18,32,FMN GV 05 Lier
60,Mechelsesteenweg 365,2022-04-04,07:00:00,80,28,52,FMN GV 05 Lier
60,Mechelsesteenweg 365,2022-04-04,08:00:00,48,18,30,FMN GV 05 Lier
60,Mechelsesteenweg 365,2022-04-04,09:00:00,24,4,20,FMN GV 05 Lier
60,Mechelsesteenweg 365,2022-04-04,10:00:00,32,14,18,FMN GV 05 Lier
60,Mechelsesteenweg 365,2022-04-04,11:00:00,36,22,14,FMN GV 05 Lier
60,Mechelsesteenweg 365,2022-04-04,12:00:00,18,6,12,FMN GV 05 Lier
60,Mechelsesteenweg 365,2022-04-04,13:00:00,40,26,14,FMN GV 05 Lier
60,Mechelsesteenweg 365,2022-04-04,14:00:00,20,14,6,FMN GV 05 Lier
60,Mechelsesteenweg 365,2022-04-04,15:00:00,38,22,16,FMN GV 05 Lier
60,Mechelsesteenweg 365,2022-04-04,16:00:00,70,40,30,FMN GV 05 Lier
60,Mechelsesteenweg 365,2022-04-04,17:00:00,62,44,18,FMN GV 05 Lier
60,Mechelsesteenweg 365,2022-04-04,18:00:00,18,10,8,FMN GV 05 Lier
60,Mechelsesteenweg 365,2022-04-04,19:00:00,16,16,0,FMN GV 05 Lier
60,Mechelsesteenweg 365,2022-04-04,20:00:00,4,2,2,FMN GV 05 Lier
60,Mechelsesteenweg 365,2022-04-04,21:00:00,4,2,2,FMN GV 05 Lier
60,Mechelsesteenweg 365,2022-04-04,22:00:00,8,2,6,FMN GV 05 Lier
60,Mechelsesteenweg 365,2022-04-04,23:00:00,0,0,0,FMN GV 05 Lier
60,Mechelsesteenweg 365,2022-04-05,00:00:00,2,2,0,FMN GV 05 Lier
60,Mechelsesteenweg 365,2022-04-05,01:00:00,0,0,0,FMN GV 05 Lier
60,Mechelsesteenweg 365,2022-04-05,02:00:00,0,0,0,FMN GV 05 Lier
60,Mechelsesteenweg 365,2022-04-05,03:00:00,0,0,0,FMN GV 05 Lier
60,Mechelsesteenweg 365,2022-04-05,04:00:00,4,2,2,FMN GV 05 Lier
60,Mechelsesteenweg 365,2022-04-05,05:00:00,4,2,2,FMN GV 05 Lier
60,Mechelsesteenweg 365,2022-04-05,06:00:00,36,10,26,FMN GV 05 Lier
60,Mechelsesteenweg 365,2022-04-05,07:00:00,66,30,36,FMN GV 05 Lier
60,Mechelsesteenweg 365,2022-04-05,08:00:00,38,8,30,FMN GV 05 Lier
60,Mechelsesteenweg 365,2022-04-05,09:00:00,28,16,12,FMN GV 05 Lier
60,Mechelsesteenweg 365,2022-04-05,10:00:00,26,4,22,FMN GV 05 Lier
60,Mechelsesteenweg 365,2022-04-05,11:00:00,18,8,10,FMN GV 05 Lier
60,Mechelsesteenweg 365,2022-04-05,12:00:00,42,20,22,FMN GV 05 Lier
60,Mechelsesteenweg 365,2022-04-05,13:00:00,34,22,12,FMN GV 05 Lier
60,Mechelsesteenweg 365,2022-04-05,14:00:00,36,22,14,FMN GV 05 Lier
60,Mechelsesteenweg 365,2022-04-05,15:00:00,82,44,38,FMN GV 05 Lier
60,Mechelsesteenweg 365,2022-04-05,16:00:00,96,52,44,FMN GV 05 Lier
60,Mechelsesteenweg 365,2022-04-05,17:00:00,90,60,30,FMN GV 05 Lier
60,Mechelsesteenweg 365,2022-04-05,18:00:00,46,30,16,FMN GV 05 Lier
60,Mechelsesteenweg 365,2022-04-05,19:00:00,52,32,20,FMN GV 05 Lier
60,Mechelsesteenweg 365,2022-04-05,20:00:00,22,12,10,FMN GV 05 Lier
60,Mechelsesteenweg 365,2022-04-05,21:00:00,14,6,8,FMN GV 05 Lier
60,Mechelsesteenweg 365,2022-04-05,22:00:00,12,4,8,FMN GV 05 Lier
60,Mechelsesteenweg 365,2022-04-05,23:00:00,4,2,2,FMN GV 05 Lier
60,Mechelsesteenweg 365,2022-04-06,00:00:00,4,2,2,FMN GV 05 Lier
60,Mechelsesteenweg 365,2022-04-06,01:00:00,2,2,0,FMN GV 05 Lier
60,Mechelsesteenweg 365,2022-04-06,02:00:00,0,0,0,FMN GV 05 Lier
60,Mechelsesteenweg 365,2022-04-06,03:00:00,2,0,2,FMN GV 05 Lier
60,Mechelsesteenweg 365,2022-04-06,04:00:00,4,2,2,FMN GV 05 Lier
60,Mechelsesteenweg 365,2022-04-06,05:00:00,12,2,10,FMN GV 05 Lier
60,Mechelsesteenweg 365,2022-04-06,06:00:00,34,8,26,FMN GV 05 Lier
60,Mechelsesteenweg 365,2022-04-06,07:00:00,80,44,36,FMN GV 05 Lier
60,Mechelsesteenweg 365,2022-04-06,08:00:00,52,18,34,FMN GV 05 Lier
60,Mechelsesteenweg 365,2022-04-06,09:00:00,52,38,14,FMN GV 05 Lier
60,Mechelsesteenweg 365,2022-04-06,10:00:00,76,42,34,FMN GV 05 Lier
60,Mechelsesteenweg 365,2022-04-06,11:00:00,40,30,10,FMN GV 05 Lier
60,Mechelsesteenweg 365,2022-04-06,12:00:00,32,20,12,FMN GV 05 Lier
60,Mechelsesteenweg 365,2022-04-06,13:00:00,34,24,10,FMN GV 05 Lier
60,Mechelsesteenweg 365,2022-04-06,14:00:00,46,30,16,FMN GV 05 Lier
60,Mechelsesteenweg 365,2022-04-06,15:00:00,54,30,24,FMN GV 05 Lier
60,Mechelsesteenweg 365,2022-04-06,16:00:00,70,40,30,FMN GV 05 Lier
60,Mechelsesteenweg 365,2022-04-06,17:00:00,66,40,26,FMN GV 05 Lier
60,Mechelsesteenweg 365,2022-04-06,18:00:00,64,40,24,FMN GV 05 Lier
60,Mechelsesteenweg 365,2022-04-06,19:00:00,30,22,8,FMN GV 05 Lier
60,Mechelsesteenweg 365,2022-04-06,20:00:00,6,2,4,FMN GV 05 Lier
60,Mechelsesteenweg 365,2022-04-06,21:00:00,14,4,10,FMN GV 05 Lier
60,Mechelsesteenweg 365,2022-04-06,22:00:00,8,4,4,FMN GV 05 Lier
60,Mechelsesteenweg 365,2022-04-06,23:00:00,2,2,0,FMN GV 05 Lier
60,Mechelsesteenweg 365,2022-04-07,00:00:00,0,0,0,FMN GV 05 Lier
60,Mechelsesteenweg 365,2022-04-07,01:00:00,2,0,2,FMN GV 05 Lier
60,Mechelsesteenweg 365,2022-04-07,02:00:00,0,0,0,FMN GV 05 Lier
60,Mechelsesteenweg 365,2022-04-07,03:00:00,2,0,2,FMN GV 05 Lier
60,Mechelsesteenweg 365,2022-04-07,04:00:00,2,0,2,FMN GV 05 Lier
60,Mechelsesteenweg 365,2022-04-07,05:00:00,6,0,6,FMN GV 05 Lier
60,Mechelsesteenweg 365,2022-04-07,06:00:00,22,8,14,FMN GV 05 Lier
60,Mechelsesteenweg 365,2022-04-07,07:00:00,50,18,32,FMN GV 05 Lier
60,Mechelsesteenweg 365,2022-04-07,08:00:00,16,4,12,FMN GV 05 Lier
60,Mechelsesteenweg 365,2022-04-07,09:00:00,10,4,6,FMN GV 05 Lier
60,Mechelsesteenweg 365,2022-04-07,10:00:00,44,4,40,FMN GV 05 Lier
60,Mechelsesteenweg 365,2022-04-07,11:00:00,6,6,0,FMN GV 05 Lier
60,Mechelsesteenweg 365,2022-04-07,12:00:00,26,16,10,FMN GV 05 Lier
60,Mechelsesteenweg 365,2022-04-07,13:00:00,32,18,14,FMN GV 05 Lier
60,Mechelsesteenweg 365,2022-04-07,14:00:00,42,38,4,FMN GV 05 Lier
60,Mechelsesteenweg 365,2022-04-07,15:00:00,50,28,22,FMN GV 05 Lier
60,Mechelsesteenweg 365,2022-04-07,16:00:00,48,30,18,FMN GV 05 Lier
60,Mechelsesteenweg 365,2022-04-07,17:00:00,58,34,24,FMN GV 05 Lier
60,Mechelsesteenweg 365,2022-04-07,18:00:00,34,18,16,FMN GV 05 Lier
60,Mechelsesteenweg 365,2022-04-07,19:00:00,12,10,2,FMN GV 05 Lier
60,Mechelsesteenweg 365,2022-04-07,20:00:00,4,4,0,FMN GV 05 Lier
60,Mechelsesteenweg 365,2022-04-07,21:00:00,4,4,0,FMN GV 05 Lier
60,Mechelsesteenweg 365,2022-04-07,22:00:00,12,6,6,FMN GV 05 Lier
60,Mechelsesteenweg 365,2022-04-07,23:00:00,2,2,0,FMN GV 05 Lier
60,Mechelsesteenweg 365,2022-04-08,00:00:00,0,0,0,FMN GV 05 Lier
60,Mechelsesteenweg 365,2022-04-08,01:00:00,0,0,0,FMN GV 05 Lier
60,Mechelsesteenweg 365,2022-04-08,02:00:00,0,0,0,FMN GV 05 Lier
60,Mechelsesteenweg 365,2022-04-08,03:00:00,2,0,2,FMN GV 05 Lier
60,Mechelsesteenweg 365,2022-04-08,04:00:00,2,2,0,FMN GV 05 Lier
60,Mechelsesteenweg 365,2022-04-08,05:00:00,12,6,6,FMN GV 05 Lier
60,Mechelsesteenweg 365,2022-04-08,06:00:00,40,12,28,FMN GV 05 Lier
60,Mechelsesteenweg 365,2022-04-08,07:00:00,42,14,28,FMN GV 05 Lier
60,Mechelsesteenweg 365,2022-04-08,08:00:00,38,18,20,FMN GV 05 Lier
60,Mechelsesteenweg 365,2022-04-08,09:00:00,56,24,32,FMN GV 05 Lier
60,Mechelsesteenweg 365,2022-04-08,10:00:00,68,50,18,FMN GV 05 Lier
60,Mechelsesteenweg 365,2022-04-08,11:00:00,68,44,24,FMN GV 05 Lier
60,Mechelsesteenweg 365,2022-04-08,12:00:00,88,52,36,FMN GV 05 Lier
60,Mechelsesteenweg 365,2022-04-08,13:00:00,86,48,38,FMN GV 05 Lier
60,Mechelsesteenweg 365,2022-04-08,14:00:00,84,48,36,FMN GV 05 Lier
60,Mechelsesteenweg 365,2022-04-08,15:00:00,98,64,34,FMN GV 05 Lier
60,Mechelsesteenweg 365,2022-04-08,16:00:00,84,50,34,FMN GV 05 Lier
60,Mechelsesteenweg 365,2022-04-08,17:00:00,72,44,28,FMN GV 05 Lier
60,Mechelsesteenweg 365,2022-04-08,18:00:00,36,24,12,FMN GV 05 Lier
60,Mechelsesteenweg 365,2022-04-08,19:00:00,32,18,14,FMN GV 05 Lier
60,Mechelsesteenweg 365,2022-04-08,20:00:00,30,14,16,FMN GV 05 Lier
60,Mechelsesteenweg 365,2022-04-08,21:00:00,10,4,6,FMN GV 05 Lier
60,Mechelsesteenweg 365,2022-04-08,22:00:00,12,4,8,FMN GV 05 Lier
60,Mechelsesteenweg 365,2022-04-08,23:00:00,10,4,6,FMN GV 05 Lier
60,Mechelsesteenweg 365,2022-04-09,00:00:00,2,2,0,FMN GV 05 Lier
60,Mechelsesteenweg 365,2022-04-09,01:00:00,2,2,0,FMN GV 05 Lier
60,Mechelsesteenweg 365,2022-04-09,02:00:00,2,0,2,FMN GV 05 Lier
60,Mechelsesteenweg 365,2022-04-09,03:00:00,2,2,0,FMN GV 05 Lier
60,Mechelsesteenweg 365,2022-04-09,04:00:00,0,0,0,FMN GV 05 Lier
60,Mechelsesteenweg 365,2022-04-09,05:00:00,10,2,8,FMN GV 05 Lier
60,Mechelsesteenweg 365,2022-04-09,06:00:00,2,2,0,FMN GV 05 Lier
60,Mechelsesteenweg 365,2022-04-09,07:00:00,12,8,4,FMN GV 05 Lier
60,Mechelsesteenweg 365,2022-04-09,08:00:00,20,8,12,FMN GV 05 Lier
60,Mechelsesteenweg 365,2022-04-09,09:00:00,46,14,32,FMN GV 05 Lier
60,Mechelsesteenweg 365,2022-04-09,10:00:00,144,74,70,FMN GV 05 Lier
60,Mechelsesteenweg 365,2022-04-09,11:00:00,128,58,70,FMN GV 05 Lier
60,Mechelsesteenweg 365,2022-04-09,12:00:00,148,92,56,FMN GV 05 Lier
60,Mechelsesteenweg 365,2022-04-09,13:00:00,142,98,44,FMN GV 05 Lier
60,Mechelsesteenweg 365,2022-04-09,14:00:00,168,94,74,FMN GV 05 Lier
60,Mechelsesteenweg 365,2022-04-09,15:00:00,114,58,56,FMN GV 05 Lier
60,Mechelsesteenweg 365,2022-04-09,16:00:00,130,66,64,FMN GV 05 Lier
60,Mechelsesteenweg 365,2022-04-09,17:00:00,50,22,28,FMN GV 05 Lier
60,Mechelsesteenweg 365,2022-04-09,18:00:00,34,22,12,FMN GV 05 Lier
60,Mechelsesteenweg 365,2022-04-09,19:00:00,4,4,0,FMN GV 05 Lier
60,Mechelsesteenweg 365,2022-04-09,20:00:00,10,4,6,FMN GV 05 Lier
60,Mechelsesteenweg 365,2022-04-09,21:00:00,10,4,6,FMN GV 05 Lier
60,Mechelsesteenweg 365,2022-04-09,22:00:00,2,0,2,FMN GV 05 Lier
60,Mechelsesteenweg 365,2022-04-09,23:00:00,6,2,4,FMN GV 05 Lier
60,Mechelsesteenweg 365,2022-04-10,00:00:00,6,6,0,FMN GV 05 Lier
60,Mechelsesteenweg 365,2022-04-10,01:00:00,2,0,2,FMN GV 05 Lier
60,Mechelsesteenweg 365,2022-04-10,02:00:00,4,0,4,FMN GV 05 Lier
60,Mechelsesteenweg 365,2022-04-10,03:00:00,0,0,0,FMN GV 05 Lier
60,Mechelsesteenweg 365,2022-04-10,04:00:00,0,0,0,FMN GV 05 Lier
60,Mechelsesteenweg 365,2022-04-10,05:00:00,2,2,0,FMN GV 05 Lier
60,Mechelsesteenweg 365,2022-04-10,06:00:00,0,0,0,FMN GV 05 Lier
60,Mechelsesteenweg 365,2022-04-10,07:00:00,8,6,2,FMN GV 05 Lier
60,Mechelsesteenweg 365,2022-04-10,08:00:00,30,14,16,FMN GV 05 Lier
60,Mechelsesteenweg 365,2022-04-10,09:00:00,116,60,56,FMN GV 05 Lier
60,Mechelsesteenweg 365,2022-04-10,10:00:00,336,192,144,FMN GV 05 Lier
60,Mechelsesteenweg 365,2022-04-10,11:00:00,404,214,190,FMN GV 05 Lier
60,Mechelsesteenweg 365,2022-04-10,12:00:00,274,146,128,FMN GV 05 Lier
60,Mechelsesteenweg 365,2022-04-10,13:00:00,268,144,124,FMN GV 05 Lier
60,Mechelsesteenweg 365,2022-04-10,14:00:00,170,106,64,FMN GV 05 Lier
60,Mechelsesteenweg 365,2022-04-10,15:00:00,248,112,136,FMN GV 05 Lier
60,Mechelsesteenweg 365,2022-04-10,16:00:00,238,82,156,FMN GV 05 Lier
60,Mechelsesteenweg 365,2022-04-10,17:00:00,98,46,52,FMN GV 05 Lier
60,Mechelsesteenweg 365,2022-04-10,18:00:00,92,54,38,FMN GV 05 Lier
60,Mechelsesteenweg 365,2022-04-10,19:00:00,52,26,26,FMN GV 05 Lier
60,Mechelsesteenweg 365,2022-04-10,20:00:00,32,4,28,FMN GV 05 Lier
60,Mechelsesteenweg 365,2022-04-10,21:00:00,16,2,14,FMN GV 05 Lier
60,Mechelsesteenweg 365,2022-04-10,22:00:00,2,2,0,FMN GV 05 Lier
60,Mechelsesteenweg 365,2022-04-10,23:00:00,2,0,2,FMN GV 05 Lier
60,Mechelsesteenweg 365,2022-04-11,00:00:00,2,2,0,FMN GV 05 Lier
60,Mechelsesteenweg 365,2022-04-11,01:00:00,0,0,0,FMN GV 05 Lier
60,Mechelsesteenweg 365,2022-04-11,02:00:00,0,0,0,FMN GV 05 Lier
60,Mechelsesteenweg 365,2022-04-11,03:00:00,2,0,2,FMN GV 05 Lier
60,Mechelsesteenweg 365,2022-04-11,04:00:00,8,2,6,FMN GV 05 Lier
60,Mechelsesteenweg 365,2022-04-11,05:00:00,14,2,12,FMN GV 05 Lier
60,Mechelsesteenweg 365,2022-04-11,06:00:00,52,24,28,FMN GV 05 Lier
60,Mechelsesteenweg 365,2022-04-11,07:00:00,100,28,72,FMN GV 05 Lier
60,Mechelsesteenweg 365,2022-04-11,08:00:00,80,24,56,FMN GV 05 Lier
60,Mechelsesteenweg 365,2022-04-11,09:00:00,74,48,26,FMN GV 05 Lier
60,Mechelsesteenweg 365,2022-04-11,10:00:00,98,40,58,FMN GV 05 Lier
60,Mechelsesteenweg 365,2022-04-11,11:00:00,152,76,76,FMN GV 05 Lier
60,Mechelsesteenweg 365,2022-04-11,12:00:00,106,66,40,FMN GV 05 Lier
60,Mechelsesteenweg 365,2022-04-11,13:00:00,198,96,102,FMN GV 05 Lier
60,Mechelsesteenweg 365,2022-04-11,14:00:00,246,142,104,FMN GV 05 Lier
60,Mechelsesteenweg 365,2022-04-11,15:00:00,272,134,138,FMN GV 05 Lier
60,Mechelsesteenweg 365,2022-04-11,16:00:00,248,110,138,FMN GV 05 Lier
60,Mechelsesteenweg 365,2022-04-11,17:00:00,236,150,86,FMN GV 05 Lier
60,Mechelsesteenweg 365,2022-04-11,18:00:00,150,86,64,FMN GV 05 Lier
60,Mechelsesteenweg 365,2022-04-11,19:00:00,68,36,32,FMN GV 05 Lier
60,Mechelsesteenweg 365,2022-04-11,20:00:00,50,22,28,FMN GV 05 Lier
60,Mechelsesteenweg 365,2022-04-11,21:00:00,6,0,6,FMN GV 05 Lier
60,Mechelsesteenweg 365,2022-04-11,22:00:00,20,12,8,FMN GV 05 Lier
60,Mechelsesteenweg 365,2022-04-11,23:00:00,8,6,2,FMN GV 05 Lier
60,Mechelsesteenweg 365,2022-04-12,00:00:00,0,0,0,FMN GV 05 Lier
60,Mechelsesteenweg 365,2022-04-12,01:00:00,2,2,0,FMN GV 05 Lier
60,Mechelsesteenweg 365,2022-04-12,02:00:00,0,0,0,FMN GV 05 Lier
60,Mechelsesteenweg 365,2022-04-12,03:00:00,2,0,2,FMN GV 05 Lier
60,Mechelsesteenweg 365,2022-04-12,04:00:00,4,2,2,FMN GV 05 Lier
60,Mechelsesteenweg 365,2022-04-12,05:00:00,18,6,12,FMN GV 05 Lier
60,Mechelsesteenweg 365,2022-04-12,06:00:00,68,18,50,FMN GV 05 Lier
60,Mechelsesteenweg 365,2022-04-12,07:00:00,138,56,82,FMN GV 05 Lier
60,Mechelsesteenweg 365,2022-04-12,08:00:00,86,40,46,FMN GV 05 Lier
60,Mechelsesteenweg 365,2022-04-12,09:00:00,100,48,52,FMN GV 05 Lier
60,Mechelsesteenweg 365,2022-04-12,10:00:00,240,92,148,FMN GV 05 Lier
60,Mechelsesteenweg 365,2022-04-12,11:00:00,186,102,84,FMN GV 05 Lier
60,Mechelsesteenweg 365,2022-04-12,12:00:00,238,150,88,FMN GV 05 Lier
60,Mechelsesteenweg 365,2022-04-12,13:00:00,268,128,140,FMN GV 05 Lier
60,Mechelsesteenweg 365,2022-04-12,14:00:00,408,202,206,FMN GV 05 Lier
60,Mechelsesteenweg 365,2022-04-12,15:00:00,396,196,200,FMN GV 05 Lier
60,Mechelsesteenweg 365,2022-04-12,16:00:00,416,188,228,FMN GV 05 Lier
60,Mechelsesteenweg 365,2022-04-12,17:00:00,320,168,152,FMN GV 05 Lier
60,Mechelsesteenweg 365,2022-04-12,18:00:00,204,114,90,FMN GV 05 Lier
60,Mechelsesteenweg 365,2022-04-12,19:00:00,234,144,90,FMN GV 05 Lier
60,Mechelsesteenweg 365,2022-04-12,20:00:00,90,38,52,FMN GV 05 Lier
60,Mechelsesteenweg 365,2022-04-12,21:00:00,34,24,10,FMN GV 05 Lier
60,Mechelsesteenweg 365,2022-04-12,22:00:00,18,12,6,FMN GV 05 Lier
60,Mechelsesteenweg 365,2022-04-12,23:00:00,12,4,8,FMN GV 05 Lier
60,Mechelsesteenweg 365,2022-04-13,00:00:00,2,2,0,FMN GV 05 Lier
60,Mechelsesteenweg 365,2022-04-13,01:00:00,4,0,4,FMN GV 05 Lier
60,Mechelsesteenweg 365,2022-04-13,02:00:00,0,0,0,FMN GV 05 Lier
60,Mechelsesteenweg 365,2022-04-13,03:00:00,2,0,2,FMN GV 05 Lier
60,Mechelsesteenweg 365,2022-04-13,04:00:00,4,0,4,FMN GV 05 Lier
60,Mechelsesteenweg 365,2022-04-13,05:00:00,18,2,16,FMN GV 05 Lier
60,Mechelsesteenweg 365,2022-04-13,06:00:00,62,24,38,FMN GV 05 Lier
60,Mechelsesteenweg 365,2022-04-13,07:00:00,116,42,74,FMN GV 05 Lier
60,Mechelsesteenweg 365,2022-04-13,08:00:00,78,34,44,FMN GV 05 Lier
60,Mechelsesteenweg 365,2022-04-13,09:00:00,34,16,18,FMN GV 05 Lier
60,Mechelsesteenweg 365,2022-04-13,10:00:00,66,22,44,FMN GV 05 Lier
60,Mechelsesteenweg 365,2022-04-13,11:00:00,70,42,28,FMN GV 05 Lier
60,Mechelsesteenweg 365,2022-04-13,12:00:00,62,36,26,FMN GV 05 Lier
60,Mechelsesteenweg 365,2022-04-13,13:00:00,46,16,30,FMN GV 05 Lier
60,Mechelsesteenweg 365,2022-04-13,14:00:00,116,50,66,FMN GV 05 Lier
60,Mechelsesteenweg 365,2022-04-13,15:00:00,106,74,32,FMN GV 05 Lier
60,Mechelsesteenweg 365,2022-04-13,16:00:00,144,76,68,FMN GV 05 Lier
60,Mechelsesteenweg 365,2022-04-13,17:00:00,134,78,56,FMN GV 05 Lier
60,Mechelsesteenweg 365,2022-04-13,18:00:00,98,56,42,FMN GV 05 Lier
60,Mechelsesteenweg 365,2022-04-13,19:00:00,132,108,24,FMN GV 05 Lier
60,Mechelsesteenweg 365,2022-04-13,20:00:00,54,18,36,FMN GV 05 Lier
60,Mechelsesteenweg 365,2022-04-13,21:00:00,22,12,10,FMN GV 05 Lier
60,Mechelsesteenweg 365,2022-04-13,22:00:00,26,16,10,FMN GV 05 Lier
60,Mechelsesteenweg 365,2022-04-13,23:00:00,0,0,0,FMN GV 05 Lier
60,Mechelsesteenweg 365,2022-04-14,00:00:00,0,0,0,FMN GV 05 Lier
60,Mechelsesteenweg 365,2022-04-14,01:00:00,0,0,0,FMN GV 05 Lier
60,Mechelsesteenweg 365,2022-04-14,02:00:00,0,0,0,FMN GV 05 Lier
60,Mechelsesteenweg 365,2022-04-14,03:00:00,2,0,2,FMN GV 05 Lier
60,Mechelsesteenweg 365,2022-04-14,04:00:00,6,2,4,FMN GV 05 Lier
60,Mechelsesteenweg 365,2022-04-14,05:00:00,16,2,14,FMN GV 05 Lier
60,Mechelsesteenweg 365,2022-04-14,06:00:00,44,14,30,FMN GV 05 Lier
60,Mechelsesteenweg 365,2022-04-14,07:00:00,118,44,74,FMN GV 05 Lier
60,Mechelsesteenweg 365,2022-04-14,08:00:00,88,30,58,FMN GV 05 Lier
60,Mechelsesteenweg 365,2022-04-14,09:00:00,48,32,16,FMN GV 05 Lier
60,Mechelsesteenweg 365,2022-04-14,10:00:00,176,66,110,FMN GV 05 Lier
60,Mechelsesteenweg 365,2022-04-14,11:00:00,156,88,68,FMN GV 05 Lier
60,Mechelsesteenweg 365,2022-04-14,12:00:00,162,86,76,FMN GV 05 Lier
60,Mechelsesteenweg 365,2022-04-14,13:00:00,334,122,212,FMN GV 05 Lier
60,Mechelsesteenweg 365,2022-04-14,14:00:00,394,170,224,FMN GV 05 Lier
60,Mechelsesteenweg 365,2022-04-14,15:00:00,280,160,120,FMN GV 05 Lier
60,Mechelsesteenweg 365,2022-04-14,16:00:00,330,200,130,FMN GV 05 Lier
60,Mechelsesteenweg 365,2022-04-14,17:00:00,168,86,82,FMN GV 05 Lier
60,Mechelsesteenweg 365,2022-04-14,18:00:00,188,88,100,FMN GV 05 Lier
60,Mechelsesteenweg 365,2022-04-14,19:00:00,160,104,56,FMN GV 05 Lier
60,Mechelsesteenweg 365,2022-04-14,20:00:00,124,44,80,FMN GV 05 Lier
60,Mechelsesteenweg 365,2022-04-14,21:00:00,18,4,14,FMN GV 05 Lier
60,Mechelsesteenweg 365,2022-04-14,22:00:00,26,14,12,FMN GV 05 Lier
60,Mechelsesteenweg 365,2022-04-14,23:00:00,4,4,0,FMN GV 05 Lier
60,Mechelsesteenweg 365,2022-04-15,00:00:00,2,2,0,FMN GV 05 Lier
60,Mechelsesteenweg 365,2022-04-15,01:00:00,0,0,0,FMN GV 05 Lier
60,Mechelsesteenweg 365,2022-04-15,02:00:00,6,6,0,FMN GV 05 Lier
60,Mechelsesteenweg 365,2022-04-15,03:00:00,4,2,2,FMN GV 05 Lier
60,Mechelsesteenweg 365,2022-04-15,04:00:00,6,2,4,FMN GV 05 Lier
60,Mechelsesteenweg 365,2022-04-15,05:00:00,12,2,10,FMN GV 05 Lier
60,Mechelsesteenweg 365,2022-04-15,06:00:00,42,18,24,FMN GV 05 Lier
60,Mechelsesteenweg 365,2022-04-15,07:00:00,72,26,46,FMN GV 05 Lier
60,Mechelsesteenweg 365,2022-04-15,08:00:00,80,20,60,FMN GV 05 Lier
60,Mechelsesteenweg 365,2022-04-15,09:00:00,84,24,60,FMN GV 05 Lier
60,Mechelsesteenweg 365,2022-04-15,10:00:00,116,58,58,FMN GV 05 Lier
60,Mechelsesteenweg 365,2022-04-15,11:00:00,144,76,68,FMN GV 05 Lier
60,Mechelsesteenweg 365,2022-04-15,12:00:00,100,58,42,FMN GV 05 Lier
60,Mechelsesteenweg 365,2022-04-15,13:00:00,64,32,32,FMN GV 05 Lier
60,Mechelsesteenweg 365,2022-04-15,14:00:00,0,0,0,FMN GV 05 Lier
60,Mechelsesteenweg 365,2022-04-15,15:00:00,30,8,22,FMN GV 05 Lier
60,Mechelsesteenweg 365,2022-04-15,16:00:00,318,136,182,FMN GV 05 Lier
60,Mechelsesteenweg 365,2022-04-15,17:00:00,208,128,80,FMN GV 05 Lier
60,Mechelsesteenweg 365,2022-04-15,18:00:00,140,74,66,FMN GV 05 Lier
60,Mechelsesteenweg 365,2022-04-15,19:00:00,74,26,48,FMN GV 05 Lier
60,Mechelsesteenweg 365,2022-04-15,20:00:00,62,34,28,FMN GV 05 Lier
60,Mechelsesteenweg 365,2022-04-15,21:00:00,24,12,12,FMN GV 05 Lier
60,Mechelsesteenweg 365,2022-04-15,22:00:00,26,16,10,FMN GV 05 Lier
60,Mechelsesteenweg 365,2022-04-15,23:00:00,14,8,6,FMN GV 05 Lier
60,Mechelsesteenweg 365,2022-04-16,00:00:00,6,2,4,FMN GV 05 Lier
60,Mechelsesteenweg 365,2022-04-16,01:00:00,2,2,0,FMN GV 05 Lier
60,Mechelsesteenweg 365,2022-04-16,02:00:00,2,2,0,FMN GV 05 Lier
60,Mechelsesteenweg 365,2022-04-16,03:00:00,6,2,4,FMN GV 05 Lier
60,Mechelsesteenweg 365,2022-04-16,04:00:00,0,0,0,FMN GV 05 Lier
60,Mechelsesteenweg 365,2022-04-16,05:00:00,6,2,4,FMN GV 05 Lier
60,Mechelsesteenweg 365,2022-04-16,06:00:00,18,8,10,FMN GV 05 Lier
60,Mechelsesteenweg 365,2022-04-16,07:00:00,22,12,10,FMN GV 05 Lier
60,Mechelsesteenweg 365,2022-04-16,08:00:00,36,20,16,FMN GV 05 Lier
60,Mechelsesteenweg 365,2022-04-16,09:00:00,170,110,60,FMN GV 05 Lier
60,Mechelsesteenweg 365,2022-04-16,10:00:00,246,132,114,FMN GV 05 Lier
60,Mechelsesteenweg 365,2022-04-16,11:00:00,228,96,132,FMN GV 05 Lier
60,Mechelsesteenweg 365,2022-04-16,12:00:00,254,102,152,FMN GV 05 Lier
60,Mechelsesteenweg 365,2022-04-16,13:00:00,164,64,100,FMN GV 05 Lier
60,Mechelsesteenweg 365,2022-04-16,14:00:00,100,30,70,FMN GV 05 Lier
60,Mechelsesteenweg 365,2022-04-16,15:00:00,218,90,128,FMN GV 05 Lier
60,Mechelsesteenweg 365,2022-04-16,16:00:00,210,84,126,FMN GV 05 Lier
60,Mechelsesteenweg 365,2022-04-16,17:00:00,250,106,144,FMN GV 05 Lier
60,Mechelsesteenweg 365,2022-04-16,18:00:00,120,54,66,FMN GV 05 Lier
60,Mechelsesteenweg 365,2022-04-16,19:00:00,64,14,50,FMN GV 05 Lier
60,Mechelsesteenweg 365,2022-04-16,20:00:00,36,18,18,FMN GV 05 Lier
60,Mechelsesteenweg 365,2022-04-16,21:00:00,26,6,20,FMN GV 05 Lier
60,Mechelsesteenweg 365,2022-04-16,22:00:00,8,0,8,FMN GV 05 Lier
60,Mechelsesteenweg 365,2022-04-16,23:00:00,18,2,16,FMN GV 05 Lier
60,Mechelsesteenweg 365,2022-04-17,00:00:00,6,4,2,FMN GV 05 Lier
60,Mechelsesteenweg 365,2022-04-17,01:00:00,10,8,2,FMN GV 05 Lier
60,Mechelsesteenweg 365,2022-04-17,02:00:00,12,10,2,FMN GV 05 Lier
60,Mechelsesteenweg 365,2022-04-17,03:00:00,22,22,0,FMN GV 05 Lier
60,Mechelsesteenweg 365,2022-04-17,04:00:00,0,0,0,FMN GV 05 Lier
60,Mechelsesteenweg 365,2022-04-17,05:00:00,2,0,2,FMN GV 05 Lier
60,Mechelsesteenweg 365,2022-04-17,06:00:00,12,10,2,FMN GV 05 Lier
60,Mechelsesteenweg 365,2022-04-17,07:00:00,6,2,4,FMN GV 05 Lier
60,Mechelsesteenweg 365,2022-04-17,08:00:00,34,20,14,FMN GV 05 Lier
60,Mechelsesteenweg 365,2022-04-17,09:00:00,182,86,96,FMN GV 05 Lier
60,Mechelsesteenweg 365,2022-04-17,10:00:00,356,184,172,FMN GV 05 Lier
60,Mechelsesteenweg 365,2022-04-17,11:00:00,404,218,186,FMN GV 05 Lier
60,Mechelsesteenweg 365,2022-04-17,12:00:00,258,130,128,FMN GV 05 Lier
60,Mechelsesteenweg 365,2022-04-17,13:00:00,4,0,4,FMN GV 05 Lier
60,Mechelsesteenweg 365,2022-04-17,14:00:00,0,0,0,FMN GV 05 Lier
60,Mechelsesteenweg 365,2022-04-17,15:00:00,0,0,0,FMN GV 05 Lier
60,Mechelsesteenweg 365,2022-04-17,16:00:00,92,36,56,FMN GV 05 Lier
60,Mechelsesteenweg 365,2022-04-17,17:00:00,228,116,112,FMN GV 05 Lier
60,Mechelsesteenweg 365,2022-04-17,18:00:00,80,26,54,FMN GV 05 Lier
60,Mechelsesteenweg 365,2022-04-17,19:00:00,88,38,50,FMN GV 05 Lier
60,Mechelsesteenweg 365,2022-04-17,20:00:00,52,24,28,FMN GV 05 Lier
60,Mechelsesteenweg 365,2022-04-17,21:00:00,24,6,18,FMN GV 05 Lier
60,Mechelsesteenweg 365,2022-04-17,22:00:00,18,14,4,FMN GV 05 Lier
60,Mechelsesteenweg 365,2022-04-17,23:00:00,6,2,4,FMN GV 05 Lier
60,Mechelsesteenweg 365,2022-04-18,00:00:00,8,2,6,FMN GV 05 Lier
60,Mechelsesteenweg 365,2022-04-18,01:00:00,4,4,0,FMN GV 05 Lier
60,Mechelsesteenweg 365,2022-04-18,02:00:00,0,0,0,FMN GV 05 Lier
60,Mechelsesteenweg 365,2022-04-18,03:00:00,0,0,0,FMN GV 05 Lier
60,Mechelsesteenweg 365,2022-04-18,04:00:00,0,0,0,FMN GV 05 Lier
60,Mechelsesteenweg 365,2022-04-18,05:00:00,2,2,0,FMN GV 05 Lier
60,Mechelsesteenweg 365,2022-04-18,06:00:00,10,6,4,FMN GV 05 Lier
60,Mechelsesteenweg 365,2022-04-18,07:00:00,16,10,6,FMN GV 05 Lier
60,Mechelsesteenweg 365,2022-04-18,08:00:00,42,10,32,FMN GV 05 Lier
60,Mechelsesteenweg 365,2022-04-18,09:00:00,156,92,64,FMN GV 05 Lier
60,Mechelsesteenweg 365,2022-04-18,10:00:00,296,142,154,FMN GV 05 Lier
60,Mechelsesteenweg 365,2022-04-18,11:00:00,364,184,180,FMN GV 05 Lier
60,Mechelsesteenweg 365,2022-04-18,12:00:00,282,150,132,FMN GV 05 Lier
60,Mechelsesteenweg 365,2022-04-18,13:00:00,12,2,10,FMN GV 05 Lier
60,Mechelsesteenweg 365,2022-04-18,14:00:00,0,0,0,FMN GV 05 Lier
60,Mechelsesteenweg 365,2022-04-18,15:00:00,50,34,16,FMN GV 05 Lier
60,Mechelsesteenweg 365,2022-04-18,16:00:00,314,100,214,FMN GV 05 Lier
60,Mechelsesteenweg 365,2022-04-18,17:00:00,334,160,174,FMN GV 05 Lier
60,Mechelsesteenweg 365,2022-04-18,18:00:00,160,50,110,FMN GV 05 Lier
60,Mechelsesteenweg 365,2022-04-18,19:00:00,94,42,52,FMN GV 05 Lier
60,Mechelsesteenweg 365,2022-04-18,20:00:00,56,20,36,FMN GV 05 Lier
60,Mechelsesteenweg 365,2022-04-18,21:00:00,20,10,10,FMN GV 05 Lier
60,Mechelsesteenweg 365,2022-04-18,22:00:00,2,0,2,FMN GV 05 Lier
60,Mechelsesteenweg 365,2022-04-18,23:00:00,2,0,2,FMN GV 05 Lier
60,Mechelsesteenweg 365,2022-04-19,00:00:00,0,0,0,FMN GV 05 Lier
60,Mechelsesteenweg 365,2022-04-19,01:00:00,0,0,0,FMN GV 05 Lier
60,Mechelsesteenweg 365,2022-04-19,02:00:00,2,2,0,FMN GV 05 Lier
60,Mechelsesteenweg 365,2022-04-19,03:00:00,2,0,2,FMN GV 05 Lier
60,Mechelsesteenweg 365,2022-04-19,04:00:00,0,0,0,FMN GV 05 Lier
60,Mechelsesteenweg 365,2022-04-19,05:00:00,12,2,10,FMN GV 05 Lier
60,Mechelsesteenweg 365,2022-04-19,06:00:00,78,20,58,FMN GV 05 Lier
60,Mechelsesteenweg 365,2022-04-19,07:00:00,300,156,144,FMN GV 05 Lier
60,Mechelsesteenweg 365,2022-04-19,08:00:00,206,114,92,FMN GV 05 Lier
60,Mechelsesteenweg 365,2022-04-19,09:00:00,94,50,44,FMN GV 05 Lier
60,Mechelsesteenweg 365,2022-04-19,10:00:00,164,76,88,FMN GV 05 Lier
60,Mechelsesteenweg 365,2022-04-19,11:00:00,140,64,76,FMN GV 05 Lier
60,Mechelsesteenweg 365,2022-04-19,12:00:00,160,86,74,FMN GV 05 Lier
60,Mechelsesteenweg 365,2022-04-19,13:00:00,102,58,44,FMN GV 05 Lier
60,Mechelsesteenweg 365,2022-04-19,14:00:00,0,0,0,FMN GV 05 Lier
60,Mechelsesteenweg 365,2022-04-19,15:00:00,84,42,42,FMN GV 05 Lier
60,Mechelsesteenweg 365,2022-04-19,16:00:00,360,114,246,FMN GV 05 Lier
60,Mechelsesteenweg 365,2022-04-19,17:00:00,272,140,132,FMN GV 05 Lier
60,Mechelsesteenweg 365,2022-04-19,18:00:00,156,72,84,FMN GV 05 Lier
60,Mechelsesteenweg 365,2022-04-19,19:00:00,164,98,66,FMN GV 05 Lier
60,Mechelsesteenweg 365,2022-04-19,20:00:00,68,28,40,FMN GV 05 Lier
60,Mechelsesteenweg 365,2022-04-19,21:00:00,20,10,10,FMN GV 05 Lier
60,Mechelsesteenweg 365,2022-04-19,22:00:00,20,8,12,FMN GV 05 Lier
60,Mechelsesteenweg 365,2022-04-19,23:00:00,2,2,0,FMN GV 05 Lier
60,Mechelsesteenweg 365,2022-04-20,00:00:00,0,0,0,FMN GV 05 Lier
60,Mechelsesteenweg 365,2022-04-20,01:00:00,4,4,0,FMN GV 05 Lier
60,Mechelsesteenweg 365,2022-04-20,02:00:00,4,4,0,FMN GV 05 Lier
60,Mechelsesteenweg 365,2022-04-20,03:00:00,0,0,0,FMN GV 05 Lier
60,Mechelsesteenweg 365,2022-04-20,04:00:00,0,0,0,FMN GV 05 Lier
60,Mechelsesteenweg 365,2022-04-20,05:00:00,16,0,16,FMN GV 05 Lier
60,Mechelsesteenweg 365,2022-04-20,06:00:00,72,34,38,FMN GV 05 Lier
60,Mechelsesteenweg 365,2022-04-20,07:00:00,256,124,132,FMN GV 05 Lier
60,Mechelsesteenweg 365,2022-04-20,08:00:00,216,136,80,FMN GV 05 Lier
60,Mechelsesteenweg 365,2022-04-20,09:00:00,102,60,42,FMN GV 05 Lier
60,Mechelsesteenweg 365,2022-04-20,10:00:00,82,34,48,FMN GV 05 Lier
60,Mechelsesteenweg 365,2022-04-20,11:00:00,156,70,86,FMN GV 05 Lier
60,Mechelsesteenweg 365,2022-04-20,12:00:00,368,134,234,FMN GV 05 Lier
60,Mechelsesteenweg 365,2022-04-20,13:00:00,160,74,86,FMN GV 05 Lier
60,Mechelsesteenweg 365,2022-04-20,14:00:00,204,118,86,FMN GV 05 Lier
60,Mechelsesteenweg 365,2022-04-20,15:00:00,244,128,116,FMN GV 05 Lier
60,Mechelsesteenweg 365,2022-04-20,16:00:00,172,74,98,FMN GV 05 Lier
60,Mechelsesteenweg 365,2022-04-20,17:00:00,224,130,94,FMN GV 05 Lier
60,Mechelsesteenweg 365,2022-04-20,18:00:00,156,88,68,FMN GV 05 Lier
60,Mechelsesteenweg 365,2022-04-20,19:00:00,174,118,56,FMN GV 05 Lier
60,Mechelsesteenweg 365,2022-04-20,20:00:00,180,102,78,FMN GV 05 Lier
60,Mechelsesteenweg 365,2022-04-20,21:00:00,18,2,16,FMN GV 05 Lier
60,Mechelsesteenweg 365,2022-04-20,22:00:00,12,8,4,FMN GV 05 Lier
60,Mechelsesteenweg 365,2022-04-20,23:00:00,2,2,0,FMN GV 05 Lier
60,Mechelsesteenweg 365,2022-04-21,00:00:00,2,2,0,FMN GV 05 Lier
60,Mechelsesteenweg 365,2022-04-21,01:00:00,0,0,0,FMN GV 05 Lier
60,Mechelsesteenweg 365,2022-04-21,02:00:00,2,2,0,FMN GV 05 Lier
60,Mechelsesteenweg 365,2022-04-21,03:00:00,0,0,0,FMN GV 05 Lier
60,Mechelsesteenweg 365,2022-04-21,04:00:00,2,2,0,FMN GV 05 Lier
60,Mechelsesteenweg 365,2022-04-21,05:00:00,18,2,16,FMN GV 05 Lier
60,Mechelsesteenweg 365,2022-04-21,06:00:00,70,24,46,FMN GV 05 Lier
60,Mechelsesteenweg 365,2022-04-21,07:00:00,254,118,136,FMN GV 05 Lier
60,Mechelsesteenweg 365,2022-04-21,08:00:00,210,130,80,FMN GV 05 Lier
60,Mechelsesteenweg 365,2022-04-21,09:00:00,108,52,56,FMN GV 05 Lier
60,Mechelsesteenweg 365,2022-04-21,10:00:00,118,56,62,FMN GV 05 Lier
60,Mechelsesteenweg 365,2022-04-21,11:00:00,124,46,78,FMN GV 05 Lier
60,Mechelsesteenweg 365,2022-04-21,12:00:00,156,82,74,FMN GV 05 Lier
60,Mechelsesteenweg 365,2022-04-21,13:00:00,126,62,64,FMN GV 05 Lier
60,Mechelsesteenweg 365,2022-04-21,14:00:00,20,12,8,FMN GV 05 Lier
60,Mechelsesteenweg 365,2022-04-21,15:00:00,112,44,68,FMN GV 05 Lier
60,Mechelsesteenweg 365,2022-04-21,16:00:00,378,146,232,FMN GV 05 Lier
60,Mechelsesteenweg 365,2022-04-21,17:00:00,240,128,112,FMN GV 05 Lier
60,Mechelsesteenweg 365,2022-04-21,18:00:00,232,122,110,FMN GV 05 Lier
60,Mechelsesteenweg 365,2022-04-21,19:00:00,202,112,90,FMN GV 05 Lier
60,Mechelsesteenweg 365,2022-04-21,20:00:00,170,40,130,FMN GV 05 Lier
60,Mechelsesteenweg 365,2022-04-21,21:00:00,28,16,12,FMN GV 05 Lier
60,Mechelsesteenweg 365,2022-04-21,22:00:00,20,10,10,FMN GV 05 Lier
60,Mechelsesteenweg 365,2022-04-21,23:00:00,10,2,8,FMN GV 05 Lier
60,Mechelsesteenweg 365,2022-04-22,00:00:00,2,2,0,FMN GV 05 Lier
60,Mechelsesteenweg 365,2022-04-22,01:00:00,2,0,2,FMN GV 05 Lier
60,Mechelsesteenweg 365,2022-04-22,02:00:00,0,0,0,FMN GV 05 Lier
60,Mechelsesteenweg 365,2022-04-22,03:00:00,2,2,0,FMN GV 05 Lier
60,Mechelsesteenweg 365,2022-04-22,04:00:00,2,2,0,FMN GV 05 Lier
60,Mechelsesteenweg 365,2022-04-22,05:00:00,24,8,16,FMN GV 05 Lier
60,Mechelsesteenweg 365,2022-04-22,06:00:00,58,22,36,FMN GV 05 Lier
60,Mechelsesteenweg 365,2022-04-22,07:00:00,212,102,110,FMN GV 05 Lier
60,Mechelsesteenweg 365,2022-04-22,08:00:00,162,98,64,FMN GV 05 Lier
60,Mechelsesteenweg 365,2022-04-22,09:00:00,68,32,36,FMN GV 05 Lier
60,Mechelsesteenweg 365,2022-04-22,10:00:00,104,36,68,FMN GV 05 Lier
60,Mechelsesteenweg 365,2022-04-22,11:00:00,138,62,76,FMN GV 05 Lier
60,Mechelsesteenweg 365,2022-04-22,12:00:00,104,46,58,FMN GV 05 Lier
60,Mechelsesteenweg 365,2022-04-22,13:00:00,158,60,98,FMN GV 05 Lier
60,Mechelsesteenweg 365,2022-04-22,14:00:00,144,78,66,FMN GV 05 Lier
60,Mechelsesteenweg 365,2022-04-22,15:00:00,174,104,70,FMN GV 05 Lier
60,Mechelsesteenweg 365,2022-04-22,16:00:00,310,106,204,FMN GV 05 Lier
60,Mechelsesteenweg 365,2022-04-22,17:00:00,144,80,64,FMN GV 05 Lier
60,Mechelsesteenweg 365,2022-04-22,18:00:00,130,70,60,FMN GV 05 Lier
60,Mechelsesteenweg 365,2022-04-22,19:00:00,70,42,28,FMN GV 05 Lier
60,Mechelsesteenweg 365,2022-04-22,20:00:00,56,22,34,FMN GV 05 Lier
60,Mechelsesteenweg 365,2022-04-22,21:00:00,26,8,18,FMN GV 05 Lier
60,Mechelsesteenweg 365,2022-04-22,22:00:00,18,8,10,FMN GV 05 Lier
60,Mechelsesteenweg 365,2022-04-22,23:00:00,12,8,4,FMN GV 05 Lier
60,Mechelsesteenweg 365,2022-04-23,00:00:00,8,2,6,FMN GV 05 Lier
60,Mechelsesteenweg 365,2022-04-23,01:00:00,8,4,4,FMN GV 05 Lier
60,Mechelsesteenweg 365,2022-04-23,02:00:00,2,2,0,FMN GV 05 Lier
60,Mechelsesteenweg 365,2022-04-23,03:00:00,0,0,0,FMN GV 05 Lier
60,Mechelsesteenweg 365,2022-04-23,04:00:00,2,0,2,FMN GV 05 Lier
60,Mechelsesteenweg 365,2022-04-23,05:00:00,0,0,0,FMN GV 05 Lier
60,Mechelsesteenweg 365,2022-04-23,06:00:00,8,4,4,FMN GV 05 Lier
60,Mechelsesteenweg 365,2022-04-23,07:00:00,16,6,10,FMN GV 05 Lier
60,Mechelsesteenweg 365,2022-04-23,08:00:00,54,22,32,FMN GV 05 Lier
60,Mechelsesteenweg 365,2022-04-23,09:00:00,76,38,38,FMN GV 05 Lier
60,Mechelsesteenweg 365,2022-04-23,10:00:00,212,114,98,FMN GV 05 Lier
60,Mechelsesteenweg 365,2022-04-23,11:00:00,276,84,192,FMN GV 05 Lier
60,Mechelsesteenweg 365,2022-04-23,12:00:00,220,86,134,FMN GV 05 Lier
60,Mechelsesteenweg 365,2022-04-23,13:00:00,162,88,74,FMN GV 05 Lier
60,Mechelsesteenweg 365,2022-04-23,14:00:00,304,176,128,FMN GV 05 Lier
60,Mechelsesteenweg 365,2022-04-23,15:00:00,214,76,138,FMN GV 05 Lier
60,Mechelsesteenweg 365,2022-04-23,16:00:00,202,56,146,FMN GV 05 Lier
60,Mechelsesteenweg 365,2022-04-23,17:00:00,108,52,56,FMN GV 05 Lier
60,Mechelsesteenweg 365,2022-04-23,18:00:00,82,40,42,FMN GV 05 Lier
60,Mechelsesteenweg 365,2022-04-23,19:00:00,48,34,14,FMN GV 05 Lier
60,Mechelsesteenweg 365,2022-04-23,20:00:00,28,10,18,FMN GV 05 Lier
60,Mechelsesteenweg 365,2022-04-23,21:00:00,12,6,6,FMN GV 05 Lier
60,Mechelsesteenweg 365,2022-04-23,22:00:00,16,6,10,FMN GV 05 Lier
60,Mechelsesteenweg 365,2022-04-23,23:00:00,6,0,6,FMN GV 05 Lier
60,Mechelsesteenweg 365,2022-04-24,00:00:00,20,4,16,FMN GV 05 Lier
60,Mechelsesteenweg 365,2022-04-24,01:00:00,4,0,4,FMN GV 05 Lier
60,Mechelsesteenweg 365,2022-04-24,02:00:00,0,0,0,FMN GV 05 Lier
60,Mechelsesteenweg 365,2022-04-24,03:00:00,0,0,0,FMN GV 05 Lier
60,Mechelsesteenweg 365,2022-04-24,04:00:00,2,2,0,FMN GV 05 Lier
60,Mechelsesteenweg 365,2022-04-24,05:00:00,4,0,4,FMN GV 05 Lier
60,Mechelsesteenweg 365,2022-04-24,06:00:00,10,8,2,FMN GV 05 Lier
60,Mechelsesteenweg 365,2022-04-24,07:00:00,12,6,6,FMN GV 05 Lier
60,Mechelsesteenweg 365,2022-04-24,08:00:00,50,26,24,FMN GV 05 Lier
60,Mechelsesteenweg 365,2022-04-24,09:00:00,250,184,66,FMN GV 05 Lier
60,Mechelsesteenweg 365,2022-04-24,10:00:00,458,194,264,FMN GV 05 Lier
60,Mechelsesteenweg 365,2022-04-24,11:00:00,482,170,312,FMN GV 05 Lier
60,Mechelsesteenweg 365,2022-04-24,12:00:00,230,112,118,FMN GV 05 Lier
60,Mechelsesteenweg 365,2022-04-24,13:00:00,192,76,116,FMN GV 05 Lier
60,Mechelsesteenweg 365,2022-04-24,14:00:00,210,108,102,FMN GV 05 Lier
60,Mechelsesteenweg 365,2022-04-24,15:00:00,72,32,40,FMN GV 05 Lier
60,Mechelsesteenweg 365,2022-04-24,16:00:00,206,82,124,FMN GV 05 Lier
60,Mechelsesteenweg 365,2022-04-24,17:00:00,166,44,122,FMN GV 05 Lier
60,Mechelsesteenweg 365,2022-04-24,18:00:00,66,16,50,FMN GV 05 Lier
60,Mechelsesteenweg 365,2022-04-24,19:00:00,46,16,30,FMN GV 05 Lier
60,Mechelsesteenweg 365,2022-04-24,20:00:00,32,18,14,FMN GV 05 Lier
60,Mechelsesteenweg 365,2022-04-24,21:00:00,10,6,4,FMN GV 05 Lier
60,Mechelsesteenweg 365,2022-04-24,22:00:00,10,0,10,FMN GV 05 Lier
60,Mechelsesteenweg 365,2022-04-24,23:00:00,2,2,0,FMN GV 05 Lier
60,Mechelsesteenweg 365,2022-04-25,00:00:00,0,0,0,FMN GV 05 Lier
60,Mechelsesteenweg 365,2022-04-25,01:00:00,0,0,0,FMN GV 05 Lier
60,Mechelsesteenweg 365,2022-04-25,02:00:00,2,2,0,FMN GV 05 Lier
60,Mechelsesteenweg 365,2022-04-25,03:00:00,2,0,2,FMN GV 05 Lier
60,Mechelsesteenweg 365,2022-04-25,04:00:00,2,2,0,FMN GV 05 Lier
60,Mechelsesteenweg 365,2022-04-25,05:00:00,6,0,6,FMN GV 05 Lier
60,Mechelsesteenweg 365,2022-04-25,06:00:00,48,18,30,FMN GV 05 Lier
60,Mechelsesteenweg 365,2022-04-25,07:00:00,190,98,92,FMN GV 05 Lier
60,Mechelsesteenweg 365,2022-04-25,08:00:00,194,112,82,FMN GV 05 Lier
60,Mechelsesteenweg 365,2022-04-25,09:00:00,60,34,26,FMN GV 05 Lier
60,Mechelsesteenweg 365,2022-04-25,10:00:00,78,26,52,FMN GV 05 Lier
60,Mechelsesteenweg 365,2022-04-25,11:00:00,74,26,48,FMN GV 05 Lier
60,Mechelsesteenweg 365,2022-04-25,12:00:00,86,48,38,FMN GV 05 Lier
60,Mechelsesteenweg 365,2022-04-25,13:00:00,66,38,28,FMN GV 05 Lier
60,Mechelsesteenweg 365,2022-04-25,14:00:00,66,22,44,FMN GV 05 Lier
60,Mechelsesteenweg 365,2022-04-25,15:00:00,138,68,70,FMN GV 05 Lier
60,Mechelsesteenweg 365,2022-04-25,16:00:00,296,100,196,FMN GV 05 Lier
60,Mechelsesteenweg 365,2022-04-25,17:00:00,170,96,74,FMN GV 05 Lier
60,Mechelsesteenweg 365,2022-04-25,18:00:00,84,42,42,FMN GV 05 Lier
60,Mechelsesteenweg 365,2022-04-25,19:00:00,72,44,28,FMN GV 05 Lier
60,Mechelsesteenweg 365,2022-04-25,20:00:00,32,8,24,FMN GV 05 Lier
60,Mechelsesteenweg 365,2022-04-25,21:00:00,20,8,12,FMN GV 05 Lier
60,Mechelsesteenweg 365,2022-04-25,22:00:00,12,6,6,FMN GV 05 Lier
60,Mechelsesteenweg 365,2022-04-25,23:00:00,2,2,0,FMN GV 05 Lier
60,Mechelsesteenweg 365,2022-04-26,00:00:00,0,0,0,FMN GV 05 Lier
60,Mechelsesteenweg 365,2022-04-26,01:00:00,0,0,0,FMN GV 05 Lier
60,Mechelsesteenweg 365,2022-04-26,02:00:00,0,0,0,FMN GV 05 Lier
60,Mechelsesteenweg 365,2022-04-26,03:00:00,2,2,0,FMN GV 05 Lier
60,Mechelsesteenweg 365,2022-04-26,04:00:00,2,2,0,FMN GV 05 Lier
60,Mechelsesteenweg 365,2022-04-26,05:00:00,10,4,6,FMN GV 05 Lier
60,Mechelsesteenweg 365,2022-04-26,06:00:00,76,28,48,FMN GV 05 Lier
60,Mechelsesteenweg 365,2022-04-26,07:00:00,286,138,148,FMN GV 05 Lier
60,Mechelsesteenweg 365,2022-04-26,08:00:00,228,144,84,FMN GV 05 Lier
60,Mechelsesteenweg 365,2022-04-26,09:00:00,76,42,34,FMN GV 05 Lier
60,Mechelsesteenweg 365,2022-04-26,10:00:00,110,44,66,FMN GV 05 Lier
60,Mechelsesteenweg 365,2022-04-26,11:00:00,126,46,80,FMN GV 05 Lier
60,Mechelsesteenweg 365,2022-04-26,12:00:00,184,122,62,FMN GV 05 Lier
60,Mechelsesteenweg 365,2022-04-26,13:00:00,148,88,60,FMN GV 05 Lier
60,Mechelsesteenweg 365,2022-04-26,14:00:00,176,106,70,FMN GV 05 Lier
60,Mechelsesteenweg 365,2022-04-26,15:00:00,228,80,148,FMN GV 05 Lier
60,Mechelsesteenweg 365,2022-04-26,16:00:00,390,158,232,FMN GV 05 Lier
60,Mechelsesteenweg 365,2022-04-26,17:00:00,152,76,76,FMN GV 05 Lier
60,Mechelsesteenweg 365,2022-04-26,18:00:00,124,72,52,FMN GV 05 Lier
60,Mechelsesteenweg 365,2022-04-26,19:00:00,84,36,48,FMN GV 05 Lier
60,Mechelsesteenweg 365,2022-04-26,20:00:00,82,36,46,FMN GV 05 Lier
60,Mechelsesteenweg 365,2022-04-26,21:00:00,24,12,12,FMN GV 05 Lier
60,Mechelsesteenweg 365,2022-04-26,22:00:00,14,8,6,FMN GV 05 Lier
60,Mechelsesteenweg 365,2022-04-26,23:00:00,8,6,2,FMN GV 05 Lier
60,Mechelsesteenweg 365,2022-04-27,00:00:00,0,0,0,FMN GV 05 Lier
60,Mechelsesteenweg 365,2022-04-27,01:00:00,0,0,0,FMN GV 05 Lier
60,Mechelsesteenweg 365,2022-04-27,02:00:00,0,0,0,FMN GV 05 Lier
60,Mechelsesteenweg 365,2022-04-27,03:00:00,4,2,2,FMN GV 05 Lier
60,Mechelsesteenweg 365,2022-04-27,04:00:00,0,0,0,FMN GV 05 Lier
60,Mechelsesteenweg 365,2022-04-27,05:00:00,10,2,8,FMN GV 05 Lier
60,Mechelsesteenweg 365,2022-04-27,06:00:00,66,34,32,FMN GV 05 Lier
60,Mechelsesteenweg 365,2022-04-27,07:00:00,222,122,100,FMN GV 05 Lier
60,Mechelsesteenweg 365,2022-04-27,08:00:00,206,120,86,FMN GV 05 Lier
60,Mechelsesteenweg 365,2022-04-27,09:00:00,90,48,42,FMN GV 05 Lier
60,Mechelsesteenweg 365,2022-04-27,10:00:00,116,76,40,FMN GV 05 Lier
60,Mechelsesteenweg 365,2022-04-27,11:00:00,142,56,86,FMN GV 05 Lier
60,Mechelsesteenweg 365,2022-04-27,12:00:00,118,34,84,FMN GV 05 Lier
60,Mechelsesteenweg 365,2022-04-27,13:00:00,0,0,0,FMN GV 05 Lier
60,Mechelsesteenweg 365,2022-04-27,14:00:00,0,0,0,FMN GV 05 Lier
60,Mechelsesteenweg 365,2022-04-27,15:00:00,32,22,10,FMN GV 05 Lier
60,Mechelsesteenweg 365,2022-04-27,16:00:00,74,20,54,FMN GV 05 Lier
60,Mechelsesteenweg 365,2022-04-27,17:00:00,198,100,98,FMN GV 05 Lier
60,Mechelsesteenweg 365,2022-04-27,18:00:00,202,108,94,FMN GV 05 Lier
60,Mechelsesteenweg 365,2022-04-27,19:00:00,194,90,104,FMN GV 05 Lier
60,Mechelsesteenweg 365,2022-04-27,20:00:00,212,136,76,FMN GV 05 Lier
60,Mechelsesteenweg 365,2022-04-27,21:00:00,22,6,16,FMN GV 05 Lier
60,Mechelsesteenweg 365,2022-04-27,22:00:00,18,16,2,FMN GV 05 Lier
60,Mechelsesteenweg 365,2022-04-27,23:00:00,10,4,6,FMN GV 05 Lier
60,Mechelsesteenweg 365,2022-04-28,00:00:00,2,0,2,FMN GV 05 Lier
60,Mechelsesteenweg 365,2022-04-28,01:00:00,2,0,2,FMN GV 05 Lier
60,Mechelsesteenweg 365,2022-04-28,02:00:00,2,2,0,FMN GV 05 Lier
60,Mechelsesteenweg 365,2022-04-28,03:00:00,2,0,2,FMN GV 05 Lier
60,Mechelsesteenweg 365,2022-04-28,04:00:00,0,0,0,FMN GV 05 Lier
60,Mechelsesteenweg 365,2022-04-28,05:00:00,10,0,10,FMN GV 05 Lier
60,Mechelsesteenweg 365,2022-04-28,06:00:00,70,32,38,FMN GV 05 Lier
60,Mechelsesteenweg 365,2022-04-28,07:00:00,250,118,132,FMN GV 05 Lier
60,Mechelsesteenweg 365,2022-04-28,08:00:00,200,116,84,FMN GV 05 Lier
60,Mechelsesteenweg 365,2022-04-28,09:00:00,100,50,50,FMN GV 05 Lier
60,Mechelsesteenweg 365,2022-04-28,10:00:00,128,82,46,FMN GV 05 Lier
60,Mechelsesteenweg 365,2022-04-28,11:00:00,156,80,76,FMN GV 05 Lier
60,Mechelsesteenweg 365,2022-04-28,12:00:00,68,18,50,FMN GV 05 Lier
60,Mechelsesteenweg 365,2022-04-28,13:00:00,0,0,0,FMN GV 05 Lier
60,Mechelsesteenweg 365,2022-04-28,14:00:00,0,0,0,FMN GV 05 Lier
60,Mechelsesteenweg 365,2022-04-28,15:00:00,0,0,0,FMN GV 05 Lier
60,Mechelsesteenweg 365,2022-04-28,16:00:00,182,70,112,FMN GV 05 Lier
60,Mechelsesteenweg 365,2022-04-28,17:00:00,262,114,148,FMN GV 05 Lier
60,Mechelsesteenweg 365,2022-04-28,18:00:00,180,114,66,FMN GV 05 Lier
60,Mechelsesteenweg 365,2022-04-28,19:00:00,214,86,128,FMN GV 05 Lier
60,Mechelsesteenweg 365,2022-04-28,20:00:00,148,32,116,FMN GV 05 Lier
60,Mechelsesteenweg 365,2022-04-28,21:00:00,26,6,20,FMN GV 05 Lier
60,Mechelsesteenweg 365,2022-04-28,22:00:00,24,16,8,FMN GV 05 Lier
60,Mechelsesteenweg 365,2022-04-28,23:00:00,8,8,0,FMN GV 05 Lier
60,Mechelsesteenweg 365,2022-04-29,00:00:00,4,2,2,FMN GV 05 Lier
60,Mechelsesteenweg 365,2022-04-29,01:00:00,0,0,0,FMN GV 05 Lier
60,Mechelsesteenweg 365,2022-04-29,02:00:00,0,0,0,FMN GV 05 Lier
60,Mechelsesteenweg 365,2022-04-29,03:00:00,4,2,2,FMN GV 05 Lier
60,Mechelsesteenweg 365,2022-04-29,04:00:00,0,0,0,FMN GV 05 Lier
60,Mechelsesteenweg 365,2022-04-29,05:00:00,12,4,8,FMN GV 05 Lier
60,Mechelsesteenweg 365,2022-04-29,06:00:00,50,28,22,FMN GV 05 Lier
60,Mechelsesteenweg 365,2022-04-29,07:00:00,216,106,110,FMN GV 05 Lier
60,Mechelsesteenweg 365,2022-04-29,08:00:00,176,114,62,FMN GV 05 Lier
60,Mechelsesteenweg 365,2022-04-29,09:00:00,92,56,36,FMN GV 05 Lier
60,Mechelsesteenweg 365,2022-04-29,10:00:00,86,34,52,FMN GV 05 Lier
60,Mechelsesteenweg 365,2022-04-29,11:00:00,140,76,64,FMN GV 05 Lier
60,Mechelsesteenweg 365,2022-04-29,12:00:00,126,48,78,FMN GV 05 Lier
60,Mechelsesteenweg 365,2022-04-29,13:00:00,126,58,68,FMN GV 05 Lier
60,Mechelsesteenweg 365,2022-04-29,14:00:00,170,96,74,FMN GV 05 Lier
60,Mechelsesteenweg 365,2022-04-29,15:00:00,242,102,140,FMN GV 05 Lier
60,Mechelsesteenweg 365,2022-04-29,16:00:00,246,106,140,FMN GV 05 Lier
60,Mechelsesteenweg 365,2022-04-29,17:00:00,200,112,88,FMN GV 05 Lier
60,Mechelsesteenweg 365,2022-04-29,18:00:00,118,72,46,FMN GV 05 Lier
60,Mechelsesteenweg 365,2022-04-29,19:00:00,80,40,40,FMN GV 05 Lier
60,Mechelsesteenweg 365,2022-04-29,20:00:00,56,28,28,FMN GV 05 Lier
60,Mechelsesteenweg 365,2022-04-29,21:00:00,20,6,14,FMN GV 05 Lier
60,Mechelsesteenweg 365,2022-04-29,22:00:00,24,14,10,FMN GV 05 Lier
60,Mechelsesteenweg 365,2022-04-29,23:00:00,10,4,6,FMN GV 05 Lier
60,Mechelsesteenweg 365,2022-04-30,00:00:00,8,2,6,FMN GV 05 Lier
60,Mechelsesteenweg 365,2022-04-30,01:00:00,4,2,2,FMN GV 05 Lier
60,Mechelsesteenweg 365,2022-04-30,02:00:00,12,4,8,FMN GV 05 Lier
60,Mechelsesteenweg 365,2022-04-30,03:00:00,6,4,2,FMN GV 05 Lier
60,Mechelsesteenweg 365,2022-04-30,04:00:00,4,2,2,FMN GV 05 Lier
60,Mechelsesteenweg 365,2022-04-30,05:00:00,0,0,0,FMN GV 05 Lier
60,Mechelsesteenweg 365,2022-04-30,06:00:00,14,8,6,FMN GV 05 Lier
60,Mechelsesteenweg 365,2022-04-30,07:00:00,12,0,12,FMN GV 05 Lier
60,Mechelsesteenweg 365,2022-04-30,08:00:00,42,22,20,FMN GV 05 Lier
60,Mechelsesteenweg 365,2022-04-30,09:00:00,112,60,52,FMN GV 05 Lier
60,Mechelsesteenweg 365,2022-04-30,10:00:00,156,90,66,FMN GV 05 Lier
60,Mechelsesteenweg 365,2022-04-30,11:00:00,220,70,150,FMN GV 05 Lier
60,Mechelsesteenweg 365,2022-04-30,12:00:00,190,100,90,FMN GV 05 Lier
60,Mechelsesteenweg 365,2022-04-30,13:00:00,124,78,46,FMN GV 05 Lier
60,Mechelsesteenweg 365,2022-04-30,14:00:00,198,110,88,FMN GV 05 Lier
60,Mechelsesteenweg 365,2022-04-30,15:00:00,152,90,62,FMN GV 05 Lier
60,Mechelsesteenweg 365,2022-04-30,16:00:00,108,42,66,FMN GV 05 Lier
60,Mechelsesteenweg 365,2022-04-30,17:00:00,80,32,48,FMN GV 05 Lier
60,Mechelsesteenweg 365,2022-04-30,18:00:00,34,18,16,FMN GV 05 Lier
60,Mechelsesteenweg 365,2022-04-30,19:00:00,36,12,24,FMN GV 05 Lier
60,Mechelsesteenweg 365,2022-04-30,20:00:00,18,2,16,FMN GV 05 Lier
60,Mechelsesteenweg 365,2022-04-30,21:00:00,18,10,8,FMN GV 05 Lier
60,Mechelsesteenweg 365,2022-04-30,22:00:00,4,4,0,FMN GV 05 Lier
60,Mechelsesteenweg 365,2022-04-30,23:00:00,8,4,4,FMN GV 05 Lier
60,Mechelsesteenweg 365,2022-05-01,00:00:00,2,2,0,FMN GV 05 Lier
60,Mechelsesteenweg 365,2022-05-01,01:00:00,8,2,6,FMN GV 05 Lier
60,Mechelsesteenweg 365,2022-05-01,02:00:00,12,8,4,FMN GV 05 Lier
60,Mechelsesteenweg 365,2022-05-01,03:00:00,0,0,0,FMN GV 05 Lier
60,Mechelsesteenweg 365,2022-05-01,04:00:00,2,2,0,FMN GV 05 Lier
60,Mechelsesteenweg 365,2022-05-01,05:00:00,6,0,6,FMN GV 05 Lier
60,Mechelsesteenweg 365,2022-05-01,06:00:00,6,2,4,FMN GV 05 Lier
60,Mechelsesteenweg 365,2022-05-01,07:00:00,6,2,4,FMN GV 05 Lier
60,Mechelsesteenweg 365,2022-05-01,08:00:00,100,76,24,FMN GV 05 Lier
60,Mechelsesteenweg 365,2022-05-01,09:00:00,502,410,92,FMN GV 05 Lier
60,Mechelsesteenweg 365,2022-05-01,10:00:00,870,664,206,FMN GV 05 Lier
60,Mechelsesteenweg 365,2022-05-01,11:00:00,850,644,206,FMN GV 05 Lier
60,Mechelsesteenweg 365,2022-05-01,12:00:00,536,388,148,FMN GV 05 Lier
60,Mechelsesteenweg 365,2022-05-01,13:00:00,226,162,64,FMN GV 05 Lier
60,Mechelsesteenweg 365,2022-05-01,14:00:00,314,216,98,FMN GV 05 Lier
60,Mechelsesteenweg 365,2022-05-01,15:00:00,424,244,180,FMN GV 05 Lier
60,Mechelsesteenweg 365,2022-05-01,16:00:00,182,62,120,FMN GV 05 Lier
60,Mechelsesteenweg 365,2022-05-01,17:00:00,114,32,82,FMN GV 05 Lier
60,Mechelsesteenweg 365,2022-05-01,18:00:00,72,20,52,FMN GV 05 Lier
60,Mechelsesteenweg 365,2022-05-01,19:00:00,56,16,40,FMN GV 05 Lier
60,Mechelsesteenweg 365,2022-05-01,20:00:00,28,18,10,FMN GV 05 Lier
60,Mechelsesteenweg 365,2022-05-01,21:00:00,18,6,12,FMN GV 05 Lier
60,Mechelsesteenweg 365,2022-05-01,22:00:00,2,0,2,FMN GV 05 Lier
60,Mechelsesteenweg 365,2022-05-01,23:00:00,4,4,0,FMN GV 05 Lier
60,Mechelsesteenweg 365,2022-05-02,00:00:00,2,2,0,FMN GV 05 Lier
60,Mechelsesteenweg 365,2022-05-02,01:00:00,0,0,0,FMN GV 05 Lier
60,Mechelsesteenweg 365,2022-05-02,02:00:00,2,2,0,FMN GV 05 Lier
60,Mechelsesteenweg 365,2022-05-02,03:00:00,2,0,2,FMN GV 05 Lier
60,Mechelsesteenweg 365,2022-05-02,04:00:00,0,0,0,FMN GV 05 Lier
60,Mechelsesteenweg 365,2022-05-02,05:00:00,16,2,14,FMN GV 05 Lier
60,Mechelsesteenweg 365,2022-05-02,06:00:00,66,22,44,FMN GV 05 Lier
60,Mechelsesteenweg 365,2022-05-02,07:00:00,220,118,102,FMN GV 05 Lier
60,Mechelsesteenweg 365,2022-05-02,08:00:00,220,120,100,FMN GV 05 Lier
60,Mechelsesteenweg 365,2022-05-02,09:00:00,76,38,38,FMN GV 05 Lier
60,Mechelsesteenweg 365,2022-05-02,10:00:00,144,84,60,FMN GV 05 Lier
60,Mechelsesteenweg 365,2022-05-02,11:00:00,116,54,62,FMN GV 05 Lier
60,Mechelsesteenweg 365,2022-05-02,12:00:00,12,8,4,FMN GV 05 Lier
60,Mechelsesteenweg 365,2022-05-02,13:00:00,0,0,0,FMN GV 05 Lier
60,Mechelsesteenweg 365,2022-05-02,14:00:00,0,0,0,FMN GV 05 Lier
60,Mechelsesteenweg 365,2022-05-02,15:00:00,0,0,0,FMN GV 05 Lier
60,Mechelsesteenweg 365,2022-05-02,16:00:00,8,2,6,FMN GV 05 Lier
60,Mechelsesteenweg 365,2022-05-02,17:00:00,122,54,68,FMN GV 05 Lier
60,Mechelsesteenweg 365,2022-05-02,18:00:00,184,94,90,FMN GV 05 Lier
60,Mechelsesteenweg 365,2022-05-02,19:00:00,144,74,70,FMN GV 05 Lier
60,Mechelsesteenweg 365,2022-05-02,20:00:00,84,48,36,FMN GV 05 Lier
60,Mechelsesteenweg 365,2022-05-02,21:00:00,32,8,24,FMN GV 05 Lier
60,Mechelsesteenweg 365,2022-05-02,22:00:00,14,10,4,FMN GV 05 Lier
60,Mechelsesteenweg 365,2022-05-02,23:00:00,2,2,0,FMN GV 05 Lier
60,Mechelsesteenweg 365,2022-05-03,00:00:00,0,0,0,FMN GV 05 Lier
60,Mechelsesteenweg 365,2022-05-03,01:00:00,0,0,0,FMN GV 05 Lier
60,Mechelsesteenweg 365,2022-05-03,02:00:00,0,0,0,FMN GV 05 Lier
60,Mechelsesteenweg 365,2022-05-03,03:00:00,2,0,2,FMN GV 05 Lier
60,Mechelsesteenweg 365,2022-05-03,04:00:00,0,0,0,FMN GV 05 Lier
60,Mechelsesteenweg 365,2022-05-03,05:00:00,22,4,18,FMN GV 05 Lier
60,Mechelsesteenweg 365,2022-05-03,06:00:00,94,42,52,FMN GV 05 Lier
60,Mechelsesteenweg 365,2022-05-03,07:00:00,216,90,126,FMN GV 05 Lier
60,Mechelsesteenweg 365,2022-05-03,08:00:00,220,104,116,FMN GV 05 Lier
60,Mechelsesteenweg 365,2022-05-03,09:00:00,110,50,60,FMN GV 05 Lier
60,Mechelsesteenweg 365,2022-05-03,10:00:00,100,48,52,FMN GV 05 Lier
60,Mechelsesteenweg 365,2022-05-03,11:00:00,114,48,66,FMN GV 05 Lier
60,Mechelsesteenweg 365,2022-05-03,12:00:00,8,6,2,FMN GV 05 Lier
60,Mechelsesteenweg 365,2022-05-03,13:00:00,190,112,78,FMN GV 05 Lier
60,Mechelsesteenweg 365,2022-05-03,14:00:00,138,86,52,FMN GV 05 Lier
60,Mechelsesteenweg 365,2022-05-03,15:00:00,316,112,204,FMN GV 05 Lier
60,Mechelsesteenweg 365,2022-05-03,16:00:00,348,146,202,FMN GV 05 Lier
60,Mechelsesteenweg 365,2022-05-03,17:00:00,278,154,124,FMN GV 05 Lier
60,Mechelsesteenweg 365,2022-05-03,18:00:00,168,86,82,FMN GV 05 Lier
60,Mechelsesteenweg 365,2022-05-03,19:00:00,106,52,54,FMN GV 05 Lier
60,Mechelsesteenweg 365,2022-05-03,20:00:00,80,26,54,FMN GV 05 Lier
60,Mechelsesteenweg 365,2022-05-03,21:00:00,22,8,14,FMN GV 05 Lier
60,Mechelsesteenweg 365,2022-05-03,22:00:00,10,10,0,FMN GV 05 Lier
60,Mechelsesteenweg 365,2022-05-03,23:00:00,4,2,2,FMN GV 05 Lier
60,Mechelsesteenweg 365,2022-05-04,00:00:00,2,2,0,FMN GV 05 Lier
60,Mechelsesteenweg 365,2022-05-04,01:00:00,2,2,0,FMN GV 05 Lier
60,Mechelsesteenweg 365,2022-05-04,02:00:00,0,0,0,FMN GV 05 Lier
60,Mechelsesteenweg 365,2022-05-04,03:00:00,0,0,0,FMN GV 05 Lier
60,Mechelsesteenweg 365,2022-05-04,04:00:00,0,0,0,FMN GV 05 Lier
60,Mechelsesteenweg 365,2022-05-04,05:00:00,20,4,16,FMN GV 05 Lier
60,Mechelsesteenweg 365,2022-05-04,06:00:00,66,30,36,FMN GV 05 Lier
60,Mechelsesteenweg 365,2022-05-04,07:00:00,220,108,112,FMN GV 05 Lier
60,Mechelsesteenweg 365,2022-05-04,08:00:00,190,98,92,FMN GV 05 Lier
60,Mechelsesteenweg 365,2022-05-04,09:00:00,176,124,52,FMN GV 05 Lier
60,Mechelsesteenweg 365,2022-05-04,10:00:00,134,54,80,FMN GV 05 Lier
60,Mechelsesteenweg 365,2022-05-04,11:00:00,104,36,68,FMN GV 05 Lier
60,Mechelsesteenweg 365,2022-05-04,12:00:00,0,0,0,FMN GV 05 Lier
60,Mechelsesteenweg 365,2022-05-04,13:00:00,0,0,0,FMN GV 05 Lier
60,Mechelsesteenweg 365,2022-05-04,14:00:00,0,0,0,FMN GV 05 Lier
60,Mechelsesteenweg 365,2022-05-04,15:00:00,30,10,20,FMN GV 05 Lier
60,Mechelsesteenweg 365,2022-05-04,16:00:00,56,18,38,FMN GV 05 Lier
60,Mechelsesteenweg 365,2022-05-04,17:00:00,152,74,78,FMN GV 05 Lier
60,Mechelsesteenweg 365,2022-05-04,18:00:00,172,88,84,FMN GV 05 Lier
60,Mechelsesteenweg 365,2022-05-04,19:00:00,102,56,46,FMN GV 05 Lier
60,Mechelsesteenweg 365,2022-05-04,20:00:00,208,134,74,FMN GV 05 Lier
60,Mechelsesteenweg 365,2022-05-04,21:00:00,72,18,54,FMN GV 05 Lier
60,Mechelsesteenweg 365,2022-05-04,22:00:00,10,2,8,FMN GV 05 Lier
60,Mechelsesteenweg 365,2022-05-04,23:00:00,8,6,2,FMN GV 05 Lier
60,Mechelsesteenweg 365,2022-05-05,00:00:00,0,0,0,FMN GV 05 Lier
60,Mechelsesteenweg 365,2022-05-05,01:00:00,2,2,0,FMN GV 05 Lier
60,Mechelsesteenweg 365,2022-05-05,02:00:00,2,2,0,FMN GV 05 Lier
60,Mechelsesteenweg 365,2022-05-05,03:00:00,2,0,2,FMN GV 05 Lier
60,Mechelsesteenweg 365,2022-05-05,04:00:00,0,0,0,FMN GV 05 Lier
60,Mechelsesteenweg 365,2022-05-05,05:00:00,18,2,16,FMN GV 05 Lier
60,Mechelsesteenweg 365,2022-05-05,06:00:00,50,16,34,FMN GV 05 Lier
60,Mechelsesteenweg 365,2022-05-05,07:00:00,226,108,118,FMN GV 05 Lier
60,Mechelsesteenweg 365,2022-05-05,08:00:00,216,130,86,FMN GV 05 Lier
60,Mechelsesteenweg 365,2022-05-05,09:00:00,174,112,62,FMN GV 05 Lier
60,Mechelsesteenweg 365,2022-05-05,10:00:00,90,44,46,FMN GV 05 Lier
60,Mechelsesteenweg 365,2022-05-05,11:00:00,212,90,122,FMN GV 05 Lier
60,Mechelsesteenweg 365,2022-05-05,12:00:00,136,66,70,FMN GV 05 Lier
60,Mechelsesteenweg 365,2022-05-05,13:00:00,44,18,26,FMN GV 05 Lier
60,Mechelsesteenweg 365,2022-05-05,14:00:00,216,112,104,FMN GV 05 Lier
60,Mechelsesteenweg 365,2022-05-05,15:00:00,242,118,124,FMN GV 05 Lier
60,Mechelsesteenweg 365,2022-05-05,16:00:00,340,124,216,FMN GV 05 Lier
60,Mechelsesteenweg 365,2022-05-05,17:00:00,192,114,78,FMN GV 05 Lier
60,Mechelsesteenweg 365,2022-05-05,18:00:00,152,78,74,FMN GV 05 Lier
60,Mechelsesteenweg 365,2022-05-05,19:00:00,98,54,44,FMN GV 05 Lier
60,Mechelsesteenweg 365,2022-05-05,20:00:00,178,72,106,FMN GV 05 Lier
60,Mechelsesteenweg 365,2022-05-05,21:00:00,32,12,20,FMN GV 05 Lier
60,Mechelsesteenweg 365,2022-05-05,22:00:00,10,4,6,FMN GV 05 Lier
60,Mechelsesteenweg 365,2022-05-05,23:00:00,4,4,0,FMN GV 05 Lier
60,Mechelsesteenweg 365,2022-05-06,00:00:00,2,2,0,FMN GV 05 Lier
60,Mechelsesteenweg 365,2022-05-06,01:00:00,0,0,0,FMN GV 05 Lier
60,Mechelsesteenweg 365,2022-05-06,02:00:00,0,0,0,FMN GV 05 Lier
60,Mechelsesteenweg 365,2022-05-06,03:00:00,0,0,0,FMN GV 05 Lier
60,Mechelsesteenweg 365,2022-05-06,04:00:00,0,0,0,FMN GV 05 Lier
60,Mechelsesteenweg 365,2022-05-06,05:00:00,24,4,20,FMN GV 05 Lier
60,Mechelsesteenweg 365,2022-05-06,06:00:00,40,18,22,FMN GV 05 Lier
60,Mechelsesteenweg 365,2022-05-06,07:00:00,192,88,104,FMN GV 05 Lier
60,Mechelsesteenweg 365,2022-05-06,08:00:00,158,98,60,FMN GV 05 Lier
60,Mechelsesteenweg 365,2022-05-06,09:00:00,96,66,30,FMN GV 05 Lier
60,Mechelsesteenweg 365,2022-05-06,10:00:00,74,30,44,FMN GV 05 Lier
60,Mechelsesteenweg 365,2022-05-06,11:00:00,142,86,56,FMN GV 05 Lier
60,Mechelsesteenweg 365,2022-05-06,12:00:00,6,4,2,FMN GV 05 Lier
60,Mechelsesteenweg 365,2022-05-06,13:00:00,0,0,0,FMN GV 05 Lier
60,Mechelsesteenweg 365,2022-05-06,14:00:00,0,0,0,FMN GV 05 Lier
60,Mechelsesteenweg 365,2022-05-06,15:00:00,0,0,0,FMN GV 05 Lier
60,Mechelsesteenweg 365,2022-05-06,16:00:00,0,0,0,FMN GV 05 Lier
60,Mechelsesteenweg 365,2022-05-06,17:00:00,6,0,6,FMN GV 05 Lier
60,Mechelsesteenweg 365,2022-05-06,18:00:00,126,72,54,FMN GV 05 Lier
60,Mechelsesteenweg 365,2022-05-06,19:00:00,120,52,68,FMN GV 05 Lier
60,Mechelsesteenweg 365,2022-05-06,20:00:00,78,46,32,FMN GV 05 Lier
60,Mechelsesteenweg 365,2022-05-06,21:00:00,42,18,24,FMN GV 05 Lier
60,Mechelsesteenweg 365,2022-05-06,22:00:00,20,12,8,FMN GV 05 Lier
60,Mechelsesteenweg 365,2022-05-06,23:00:00,16,10,6,FMN GV 05 Lier
60,Mechelsesteenweg 365,2022-05-07,00:00:00,8,0,8,FMN GV 05 Lier
60,Mechelsesteenweg 365,2022-05-07,01:00:00,6,4,2,FMN GV 05 Lier
60,Mechelsesteenweg 365,2022-05-07,02:00:00,4,4,0,FMN GV 05 Lier
60,Mechelsesteenweg 365,2022-05-07,03:00:00,0,0,0,FMN GV 05 Lier
60,Mechelsesteenweg 365,2022-05-07,04:00:00,0,0,0,FMN GV 05 Lier
60,Mechelsesteenweg 365,2022-05-07,05:00:00,4,0,4,FMN GV 05 Lier
60,Mechelsesteenweg 365,2022-05-07,06:00:00,10,6,4,FMN GV 05 Lier
60,Mechelsesteenweg 365,2022-05-07,07:00:00,18,6,12,FMN GV 05 Lier
60,Mechelsesteenweg 365,2022-05-07,08:00:00,48,20,28,FMN GV 05 Lier
60,Mechelsesteenweg 365,2022-05-07,09:00:00,118,64,54,FMN GV 05 Lier
60,Mechelsesteenweg 365,2022-05-07,10:00:00,184,78,106,FMN GV 05 Lier
60,Mechelsesteenweg 365,2022-05-07,11:00:00,170,76,94,FMN GV 05 Lier
60,Mechelsesteenweg 365,2022-05-07,12:00:00,120,54,66,FMN GV 05 Lier
60,Mechelsesteenweg 365,2022-05-07,13:00:00,72,38,34,FMN GV 05 Lier
60,Mechelsesteenweg 365,2022-05-07,14:00:00,0,0,0,FMN GV 05 Lier
60,Mechelsesteenweg 365,2022-05-07,15:00:00,0,0,0,FMN GV 05 Lier
60,Mechelsesteenweg 365,2022-05-07,16:00:00,0,0,0,FMN GV 05 Lier
60,Mechelsesteenweg 365,2022-05-07,17:00:00,0,0,0,FMN GV 05 Lier
60,Mechelsesteenweg 365,2022-05-07,18:00:00,90,46,44,FMN GV 05 Lier
60,Mechelsesteenweg 365,2022-05-07,19:00:00,40,16,24,FMN GV 05 Lier
60,Mechelsesteenweg 365,2022-05-07,20:00:00,50,20,30,FMN GV 05 Lier
60,Mechelsesteenweg 365,2022-05-07,21:00:00,24,12,12,FMN GV 05 Lier
60,Mechelsesteenweg 365,2022-05-07,22:00:00,38,8,30,FMN GV 05 Lier
60,Mechelsesteenweg 365,2022-05-07,23:00:00,18,4,14,FMN GV 05 Lier
60,Mechelsesteenweg 365,2022-05-08,00:00:00,4,4,0,FMN GV 05 Lier
60,Mechelsesteenweg 365,2022-05-08,01:00:00,0,0,0,FMN GV 05 Lier
60,Mechelsesteenweg 365,2022-05-08,02:00:00,2,2,0,FMN GV 05 Lier
60,Mechelsesteenweg 365,2022-05-08,03:00:00,6,6,0,FMN GV 05 Lier
60,Mechelsesteenweg 365,2022-05-08,04:00:00,0,0,0,FMN GV 05 Lier
60,Mechelsesteenweg 365,2022-05-08,05:00:00,2,0,2,FMN GV 05 Lier
60,Mechelsesteenweg 365,2022-05-08,06:00:00,12,8,4,FMN GV 05 Lier
60,Mechelsesteenweg 365,2022-05-08,07:00:00,12,6,6,FMN GV 05 Lier
60,Mechelsesteenweg 365,2022-05-08,08:00:00,66,34,32,FMN GV 05 Lier
60,Mechelsesteenweg 365,2022-05-08,09:00:00,214,116,98,FMN GV 05 Lier
60,Mechelsesteenweg 365,2022-05-08,10:00:00,362,148,214,FMN GV 05 Lier
60,Mechelsesteenweg 365,2022-05-08,11:00:00,286,120,166,FMN GV 05 Lier
60,Mechelsesteenweg 365,2022-05-08,12:00:00,0,0,0,FMN GV 05 Lier
60,Mechelsesteenweg 365,2022-05-08,13:00:00,0,0,0,FMN GV 05 Lier
60,Mechelsesteenweg 365,2022-05-08,14:00:00,0,0,0,FMN GV 05 Lier
60,Mechelsesteenweg 365,2022-05-08,15:00:00,0,0,0,FMN GV 05 Lier
60,Mechelsesteenweg 365,2022-05-08,16:00:00,0,0,0,FMN GV 05 Lier
60,Mechelsesteenweg 365,2022-05-08,17:00:00,0,0,0,FMN GV 05 Lier
60,Mechelsesteenweg 365,2022-05-08,18:00:00,52,24,28,FMN GV 05 Lier
60,Mechelsesteenweg 365,2022-05-08,19:00:00,80,38,42,FMN GV 05 Lier
60,Mechelsesteenweg 365,2022-05-08,20:00:00,34,14,20,FMN GV 05 Lier
60,Mechelsesteenweg 365,2022-05-08,21:00:00,20,6,14,FMN GV 05 Lier
60,Mechelsesteenweg 365,2022-05-08,22:00:00,18,12,6,FMN GV 05 Lier
60,Mechelsesteenweg 365,2022-05-08,23:00:00,6,2,4,FMN GV 05 Lier
60,Mechelsesteenweg 365,2022-05-09,00:00:00,0,0,0,FMN GV 05 Lier
60,Mechelsesteenweg 365,2022-05-09,01:00:00,0,0,0,FMN GV 05 Lier
60,Mechelsesteenweg 365,2022-05-09,02:00:00,0,0,0,FMN GV 05 Lier
60,Mechelsesteenweg 365,2022-05-09,03:00:00,2,0,2,FMN GV 05 Lier
60,Mechelsesteenweg 365,2022-05-09,04:00:00,0,0,0,FMN GV 05 Lier
60,Mechelsesteenweg 365,2022-05-09,05:00:00,18,4,14,FMN GV 05 Lier
60,Mechelsesteenweg 365,2022-05-09,06:00:00,62,26,36,FMN GV 05 Lier
60,Mechelsesteenweg 365,2022-05-09,07:00:00,206,112,94,FMN GV 05 Lier
60,Mechelsesteenweg 365,2022-05-09,08:00:00,212,92,120,FMN GV 05 Lier
60,Mechelsesteenweg 365,2022-05-09,09:00:00,106,54,52,FMN GV 05 Lier
60,Mechelsesteenweg 365,2022-05-09,10:00:00,134,78,56,FMN GV 05 Lier
60,Mechelsesteenweg 365,2022-05-09,11:00:00,18,2,16,FMN GV 05 Lier
60,Mechelsesteenweg 365,2022-05-09,12:00:00,0,0,0,FMN GV 05 Lier
60,Mechelsesteenweg 365,2022-05-09,13:00:00,0,0,0,FMN GV 05 Lier
60,Mechelsesteenweg 365,2022-05-09,14:00:00,0,0,0,FMN GV 05 Lier
60,Mechelsesteenweg 365,2022-05-09,15:00:00,0,0,0,FMN GV 05 Lier
60,Mechelsesteenweg 365,2022-05-09,16:00:00,0,0,0,FMN GV 05 Lier
60,Mechelsesteenweg 365,2022-05-09,17:00:00,0,0,0,FMN GV 05 Lier
60,Mechelsesteenweg 365,2022-05-09,18:00:00,102,64,38,FMN GV 05 Lier
60,Mechelsesteenweg 365,2022-05-09,19:00:00,144,84,60,FMN GV 05 Lier
60,Mechelsesteenweg 365,2022-05-09,20:00:00,104,32,72,FMN GV 05 Lier
60,Mechelsesteenweg 365,2022-05-09,21:00:00,60,26,34,FMN GV 05 Lier
60,Mechelsesteenweg 365,2022-05-09,22:00:00,10,8,2,FMN GV 05 Lier
60,Mechelsesteenweg 365,2022-05-09,23:00:00,6,4,2,FMN GV 05 Lier
60,Mechelsesteenweg 365,2022-05-10,00:00:00,0,0,0,FMN GV 05 Lier
60,Mechelsesteenweg 365,2022-05-10,01:00:00,0,0,0,FMN GV 05 Lier
60,Mechelsesteenweg 365,2022-05-10,02:00:00,2,2,0,FMN GV 05 Lier
60,Mechelsesteenweg 365,2022-05-10,03:00:00,0,0,0,FMN GV 05 Lier
60,Mechelsesteenweg 365,2022-05-10,04:00:00,2,0,2,FMN GV 05 Lier
60,Mechelsesteenweg 365,2022-05-10,05:00:00,16,4,12,FMN GV 05 Lier
60,Mechelsesteenweg 365,2022-05-10,06:00:00,78,30,48,FMN GV 05 Lier
60,Mechelsesteenweg 365,2022-05-10,07:00:00,238,104,134,FMN GV 05 Lier
60,Mechelsesteenweg 365,2022-05-10,08:00:00,236,128,108,FMN GV 05 Lier
60,Mechelsesteenweg 365,2022-05-10,09:00:00,128,60,68,FMN GV 05 Lier
60,Mechelsesteenweg 365,2022-05-10,10:00:00,208,76,132,FMN GV 05 Lier
60,Mechelsesteenweg 365,2022-05-10,11:00:00,186,122,64,FMN GV 05 Lier
60,Mechelsesteenweg 365,2022-05-10,12:00:00,90,46,44,FMN GV 05 Lier
60,Mechelsesteenweg 365,2022-05-10,13:00:00,88,46,42,FMN GV 05 Lier
60,Mechelsesteenweg 365,2022-05-10,14:00:00,186,116,70,FMN GV 05 Lier
60,Mechelsesteenweg 365,2022-05-10,15:00:00,8,0,8,FMN GV 05 Lier
60,Mechelsesteenweg 365,2022-05-10,16:00:00,220,92,128,FMN GV 05 Lier
60,Mechelsesteenweg 365,2022-05-10,17:00:00,242,154,88,FMN GV 05 Lier
60,Mechelsesteenweg 365,2022-05-10,18:00:00,148,82,66,FMN GV 05 Lier
60,Mechelsesteenweg 365,2022-05-10,19:00:00,106,62,44,FMN GV 05 Lier
60,Mechelsesteenweg 365,2022-05-10,20:00:00,146,34,112,FMN GV 05 Lier
60,Mechelsesteenweg 365,2022-05-10,21:00:00,32,16,16,FMN GV 05 Lier
60,Mechelsesteenweg 365,2022-05-10,22:00:00,20,14,6,FMN GV 05 Lier
60,Mechelsesteenweg 365,2022-05-10,23:00:00,6,2,4,FMN GV 05 Lier
60,Mechelsesteenweg 365,2022-05-11,00:00:00,4,4,0,FMN GV 05 Lier
60,Mechelsesteenweg 365,2022-05-11,01:00:00,2,2,0,FMN GV 05 Lier
60,Mechelsesteenweg 365,2022-05-11,02:00:00,0,0,0,FMN GV 05 Lier
60,Mechelsesteenweg 365,2022-05-11,03:00:00,0,0,0,FMN GV 05 Lier
60,Mechelsesteenweg 365,2022-05-11,04:00:00,2,0,2,FMN GV 05 Lier
60,Mechelsesteenweg 365,2022-05-11,05:00:00,22,6,16,FMN GV 05 Lier
60,Mechelsesteenweg 365,2022-05-11,06:00:00,80,38,42,FMN GV 05 Lier
60,Mechelsesteenweg 365,2022-05-11,07:00:00,272,134,138,FMN GV 05 Lier
60,Mechelsesteenweg 365,2022-05-11,08:00:00,194,124,70,FMN GV 05 Lier
60,Mechelsesteenweg 365,2022-05-11,09:00:00,86,38,48,FMN GV 05 Lier
60,Mechelsesteenweg 365,2022-05-11,10:00:00,138,64,74,FMN GV 05 Lier
60,Mechelsesteenweg 365,2022-05-11,11:00:00,38,22,16,FMN GV 05 Lier
60,Mechelsesteenweg 365,2022-05-11,12:00:00,0,0,0,FMN GV 05 Lier
60,Mechelsesteenweg 365,2022-05-11,13:00:00,0,0,0,FMN GV 05 Lier
60,Mechelsesteenweg 365,2022-05-11,14:00:00,0,0,0,FMN GV 05 Lier
60,Mechelsesteenweg 365,2022-05-11,15:00:00,0,0,0,FMN GV 05 Lier
60,Mechelsesteenweg 365,2022-05-11,16:00:00,0,0,0,FMN GV 05 Lier
60,Mechelsesteenweg 365,2022-05-11,17:00:00,116,74,42,FMN GV 05 Lier
60,Mechelsesteenweg 365,2022-05-11,18:00:00,184,110,74,FMN GV 05 Lier
60,Mechelsesteenweg 365,2022-05-11,19:00:00,198,120,78,FMN GV 05 Lier
60,Mechelsesteenweg 365,2022-05-11,20:00:00,196,146,50,FMN GV 05 Lier
60,Mechelsesteenweg 365,2022-05-11,21:00:00,54,28,26,FMN GV 05 Lier
60,Mechelsesteenweg 365,2022-05-11,22:00:00,12,8,4,FMN GV 05 Lier
60,Mechelsesteenweg 365,2022-05-11,23:00:00,4,2,2,FMN GV 05 Lier
60,Mechelsesteenweg 365,2022-05-12,00:00:00,0,0,0,FMN GV 05 Lier
60,Mechelsesteenweg 365,2022-05-12,01:00:00,0,0,0,FMN GV 05 Lier
60,Mechelsesteenweg 365,2022-05-12,02:00:00,2,2,0,FMN GV 05 Lier
60,Mechelsesteenweg 365,2022-05-12,03:00:00,0,0,0,FMN GV 05 Lier
60,Mechelsesteenweg 365,2022-05-12,04:00:00,2,0,2,FMN GV 05 Lier
60,Mechelsesteenweg 365,2022-05-12,05:00:00,14,2,12,FMN GV 05 Lier
60,Mechelsesteenweg 365,2022-05-12,06:00:00,82,38,44,FMN GV 05 Lier
60,Mechelsesteenweg 365,2022-05-12,07:00:00,216,112,104,FMN GV 05 Lier
60,Mechelsesteenweg 365,2022-05-12,08:00:00,220,126,94,FMN GV 05 Lier
60,Mechelsesteenweg 365,2022-05-12,09:00:00,116,66,50,FMN GV 05 Lier
60,Mechelsesteenweg 365,2022-05-12,10:00:00,84,40,44,FMN GV 05 Lier
60,Mechelsesteenweg 365,2022-05-12,11:00:00,4,2,2,FMN GV 05 Lier
60,Mechelsesteenweg 365,2022-05-12,12:00:00,44,26,18,FMN GV 05 Lier
60,Mechelsesteenweg 365,2022-05-12,13:00:00,66,38,28,FMN GV 05 Lier
60,Mechelsesteenweg 365,2022-05-12,14:00:00,0,0,0,FMN GV 05 Lier
60,Mechelsesteenweg 365,2022-05-12,15:00:00,24,16,8,FMN GV 05 Lier
60,Mechelsesteenweg 365,2022-05-12,16:00:00,120,46,74,FMN GV 05 Lier
60,Mechelsesteenweg 365,2022-05-12,17:00:00,210,130,80,FMN GV 05 Lier
60,Mechelsesteenweg 365,2022-05-12,18:00:00,112,66,46,FMN GV 05 Lier
60,Mechelsesteenweg 365,2022-05-12,19:00:00,172,90,82,FMN GV 05 Lier
60,Mechelsesteenweg 365,2022-05-12,20:00:00,226,86,140,FMN GV 05 Lier
60,Mechelsesteenweg 365,2022-05-12,21:00:00,40,26,14,FMN GV 05 Lier
60,Mechelsesteenweg 365,2022-05-12,22:00:00,16,14,2,FMN GV 05 Lier
60,Mechelsesteenweg 365,2022-05-12,23:00:00,4,4,0,FMN GV 05 Lier
60,Mechelsesteenweg 365,2022-05-13,00:00:00,2,0,2,FMN GV 05 Lier
60,Mechelsesteenweg 365,2022-05-13,01:00:00,0,0,0,FMN GV 05 Lier
60,Mechelsesteenweg 365,2022-05-13,02:00:00,4,4,0,FMN GV 05 Lier
60,Mechelsesteenweg 365,2022-05-13,03:00:00,0,0,0,FMN GV 05 Lier
60,Mechelsesteenweg 365,2022-05-13,04:00:00,0,0,0,FMN GV 05 Lier
60,Mechelsesteenweg 365,2022-05-13,05:00:00,16,2,14,FMN GV 05 Lier
60,Mechelsesteenweg 365,2022-05-13,06:00:00,52,24,28,FMN GV 05 Lier
60,Mechelsesteenweg 365,2022-05-13,07:00:00,188,102,86,FMN GV 05 Lier
60,Mechelsesteenweg 365,2022-05-13,08:00:00,164,80,84,FMN GV 05 Lier
60,Mechelsesteenweg 365,2022-05-13,09:00:00,68,36,32,FMN GV 05 Lier
60,Mechelsesteenweg 365,2022-05-13,10:00:00,124,58,66,FMN GV 05 Lier
60,Mechelsesteenweg 365,2022-05-13,11:00:00,132,74,58,FMN GV 05 Lier
60,Mechelsesteenweg 365,2022-05-13,12:00:00,168,100,68,FMN GV 05 Lier
60,Mechelsesteenweg 365,2022-05-13,13:00:00,146,76,70,FMN GV 05 Lier
60,Mechelsesteenweg 365,2022-05-13,14:00:00,26,14,12,FMN GV 05 Lier
60,Mechelsesteenweg 365,2022-05-13,15:00:00,24,8,16,FMN GV 05 Lier
60,Mechelsesteenweg 365,2022-05-13,16:00:00,2,0,2,FMN GV 05 Lier
60,Mechelsesteenweg 365,2022-05-13,17:00:00,32,14,18,FMN GV 05 Lier
60,Mechelsesteenweg 365,2022-05-13,18:00:00,96,42,54,FMN GV 05 Lier
60,Mechelsesteenweg 365,2022-05-13,19:00:00,110,54,56,FMN GV 05 Lier
60,Mechelsesteenweg 365,2022-05-13,20:00:00,74,38,36,FMN GV 05 Lier
60,Mechelsesteenweg 365,2022-05-13,21:00:00,18,6,12,FMN GV 05 Lier
60,Mechelsesteenweg 365,2022-05-13,22:00:00,10,8,2,FMN GV 05 Lier
60,Mechelsesteenweg 365,2022-05-13,23:00:00,14,8,6,FMN GV 05 Lier
60,Mechelsesteenweg 365,2022-05-14,00:00:00,12,8,4,FMN GV 05 Lier
60,Mechelsesteenweg 365,2022-05-14,01:00:00,0,0,0,FMN GV 05 Lier
60,Mechelsesteenweg 365,2022-05-14,02:00:00,0,0,0,FMN GV 05 Lier
60,Mechelsesteenweg 365,2022-05-14,03:00:00,0,0,0,FMN GV 05 Lier
60,Mechelsesteenweg 365,2022-05-14,04:00:00,2,0,2,FMN GV 05 Lier
60,Mechelsesteenweg 365,2022-05-14,05:00:00,6,0,6,FMN GV 05 Lier
60,Mechelsesteenweg 365,2022-05-14,06:00:00,12,8,4,FMN GV 05 Lier
60,Mechelsesteenweg 365,2022-05-14,07:00:00,16,6,10,FMN GV 05 Lier
60,Mechelsesteenweg 365,2022-05-14,08:00:00,94,70,24,FMN GV 05 Lier
60,Mechelsesteenweg 365,2022-05-14,09:00:00,128,54,74,FMN GV 05 Lier
60,Mechelsesteenweg 365,2022-05-14,10:00:00,218,112,106,FMN GV 05 Lier
60,Mechelsesteenweg 365,2022-05-14,11:00:00,2,2,0,FMN GV 05 Lier
60,Mechelsesteenweg 365,2022-05-14,12:00:00,0,0,0,FMN GV 05 Lier
60,Mechelsesteenweg 365,2022-05-14,13:00:00,0,0,0,FMN GV 05 Lier
60,Mechelsesteenweg 365,2022-05-14,14:00:00,0,0,0,FMN GV 05 Lier
60,Mechelsesteenweg 365,2022-05-14,15:00:00,0,0,0,FMN GV 05 Lier
60,Mechelsesteenweg 365,2022-05-14,16:00:00,0,0,0,FMN GV 05 Lier
60,Mechelsesteenweg 365,2022-05-14,17:00:00,0,0,0,FMN GV 05 Lier
60,Mechelsesteenweg 365,2022-05-14,18:00:00,38,22,16,FMN GV 05 Lier
60,Mechelsesteenweg 365,2022-05-14,19:00:00,80,46,34,FMN GV 05 Lier
60,Mechelsesteenweg 365,2022-05-14,20:00:00,60,30,30,FMN GV 05 Lier
60,Mechelsesteenweg 365,2022-05-14,21:00:00,20,8,12,FMN GV 05 Lier
60,Mechelsesteenweg 365,2022-05-14,22:00:00,20,6,14,FMN GV 05 Lier
60,Mechelsesteenweg 365,2022-05-14,23:00:00,12,8,4,FMN GV 05 Lier
60,Mechelsesteenweg 365,2022-05-15,00:00:00,2,2,0,FMN GV 05 Lier
60,Mechelsesteenweg 365,2022-05-15,01:00:00,4,4,0,FMN GV 05 Lier
60,Mechelsesteenweg 365,2022-05-15,02:00:00,0,0,0,FMN GV 05 Lier
60,Mechelsesteenweg 365,2022-05-15,03:00:00,4,4,0,FMN GV 05 Lier
60,Mechelsesteenweg 365,2022-05-15,04:00:00,2,0,2,FMN GV 05 Lier
60,Mechelsesteenweg 365,2022-05-15,05:00:00,2,0,2,FMN GV 05 Lier
60,Mechelsesteenweg 365,2022-05-15,06:00:00,10,4,6,FMN GV 05 Lier
60,Mechelsesteenweg 365,2022-05-15,07:00:00,22,10,12,FMN GV 05 Lier
60,Mechelsesteenweg 365,2022-05-15,08:00:00,74,26,48,FMN GV 05 Lier
60,Mechelsesteenweg 365,2022-05-15,09:00:00,216,104,112,FMN GV 05 Lier
60,Mechelsesteenweg 365,2022-05-15,10:00:00,482,240,242,FMN GV 05 Lier
60,Mechelsesteenweg 365,2022-05-15,11:00:00,34,16,18,FMN GV 05 Lier
60,Mechelsesteenweg 365,2022-05-15,12:00:00,0,0,0,FMN GV 05 Lier
60,Mechelsesteenweg 365,2022-05-15,13:00:00,0,0,0,FMN GV 05 Lier
60,Mechelsesteenweg 365,2022-05-15,14:00:00,0,0,0,FMN GV 05 Lier
60,Mechelsesteenweg 365,2022-05-15,15:00:00,0,0,0,FMN GV 05 Lier
60,Mechelsesteenweg 365,2022-05-15,16:00:00,0,0,0,FMN GV 05 Lier
60,Mechelsesteenweg 365,2022-05-15,17:00:00,0,0,0,FMN GV 05 Lier
60,Mechelsesteenweg 365,2022-05-15,18:00:00,2,2,0,FMN GV 05 Lier
60,Mechelsesteenweg 365,2022-05-15,19:00:00,68,32,36,FMN GV 05 Lier
60,Mechelsesteenweg 365,2022-05-15,20:00:00,70,32,38,FMN GV 05 Lier
60,Mechelsesteenweg 365,2022-05-15,21:00:00,30,18,12,FMN GV 05 Lier
60,Mechelsesteenweg 365,2022-05-15,22:00:00,8,6,2,FMN GV 05 Lier
60,Mechelsesteenweg 365,2022-05-15,23:00:00,4,0,4,FMN GV 05 Lier
60,Mechelsesteenweg 365,2022-05-16,00:00:00,0,0,0,FMN GV 05 Lier
60,Mechelsesteenweg 365,2022-05-16,01:00:00,0,0,0,FMN GV 05 Lier
60,Mechelsesteenweg 365,2022-05-16,02:00:00,2,2,0,FMN GV 05 Lier
60,Mechelsesteenweg 365,2022-05-16,03:00:00,4,2,2,FMN GV 05 Lier
60,Mechelsesteenweg 365,2022-05-16,04:00:00,6,2,4,FMN GV 05 Lier
60,Mechelsesteenweg 365,2022-05-16,05:00:00,20,4,16,FMN GV 05 Lier
60,Mechelsesteenweg 365,2022-05-16,06:00:00,46,16,30,FMN GV 05 Lier
60,Mechelsesteenweg 365,2022-05-16,07:00:00,202,98,104,FMN GV 05 Lier
60,Mechelsesteenweg 365,2022-05-16,08:00:00,174,90,84,FMN GV 05 Lier
60,Mechelsesteenweg 365,2022-05-16,09:00:00,88,42,46,FMN GV 05 Lier
60,Mechelsesteenweg 365,2022-05-16,10:00:00,106,62,44,FMN GV 05 Lier
60,Mechelsesteenweg 365,2022-05-16,11:00:00,56,30,26,FMN GV 05 Lier
60,Mechelsesteenweg 365,2022-05-16,12:00:00,90,52,38,FMN GV 05 Lier
60,Mechelsesteenweg 365,2022-05-16,13:00:00,68,36,32,FMN GV 05 Lier
60,Mechelsesteenweg 365,2022-05-16,14:00:00,100,44,56,FMN GV 05 Lier
60,Mechelsesteenweg 365,2022-05-16,15:00:00,100,48,52,FMN GV 05 Lier
60,Mechelsesteenweg 365,2022-05-16,16:00:00,100,44,56,FMN GV 05 Lier
60,Mechelsesteenweg 365,2022-05-16,17:00:00,90,40,50,FMN GV 05 Lier
60,Mechelsesteenweg 365,2022-05-16,18:00:00,110,58,52,FMN GV 05 Lier
60,Mechelsesteenweg 365,2022-05-16,19:00:00,96,54,42,FMN GV 05 Lier
60,Mechelsesteenweg 365,2022-05-16,20:00:00,84,44,40,FMN GV 05 Lier
60,Mechelsesteenweg 365,2022-05-16,21:00:00,58,30,28,FMN GV 05 Lier
60,Mechelsesteenweg 365,2022-05-16,22:00:00,10,10,0,FMN GV 05 Lier
60,Mechelsesteenweg 365,2022-05-16,23:00:00,2,0,2,FMN GV 05 Lier
60,Mechelsesteenweg 365,2022-05-17,00:00:00,4,2,2,FMN GV 05 Lier
60,Mechelsesteenweg 365,2022-05-17,01:00:00,0,0,0,FMN GV 05 Lier
60,Mechelsesteenweg 365,2022-05-17,02:00:00,2,2,0,FMN GV 05 Lier
60,Mechelsesteenweg 365,2022-05-17,03:00:00,0,0,0,FMN GV 05 Lier
60,Mechelsesteenweg 365,2022-05-17,04:00:00,4,0,4,FMN GV 05 Lier
60,Mechelsesteenweg 365,2022-05-17,05:00:00,10,2,8,FMN GV 05 Lier
60,Mechelsesteenweg 365,2022-05-17,06:00:00,74,32,42,FMN GV 05 Lier
60,Mechelsesteenweg 365,2022-05-17,07:00:00,208,86,122,FMN GV 05 Lier
60,Mechelsesteenweg 365,2022-05-17,08:00:00,222,118,104,FMN GV 05 Lier
60,Mechelsesteenweg 365,2022-05-17,09:00:00,100,44,56,FMN GV 05 Lier
60,Mechelsesteenweg 365,2022-05-17,10:00:00,80,44,36,FMN GV 05 Lier
60,Mechelsesteenweg 365,2022-05-17,11:00:00,48,28,20,FMN GV 05 Lier
60,Mechelsesteenweg 365,2022-05-17,12:00:00,0,0,0,FMN GV 05 Lier
60,Mechelsesteenweg 365,2022-05-17,13:00:00,0,0,0,FMN GV 05 Lier
60,Mechelsesteenweg 365,2022-05-17,14:00:00,22,8,14,FMN GV 05 Lier
60,Mechelsesteenweg 365,2022-05-17,15:00:00,0,0,0,FMN GV 05 Lier
60,Mechelsesteenweg 365,2022-05-17,16:00:00,0,0,0,FMN GV 05 Lier
60,Mechelsesteenweg 365,2022-05-17,17:00:00,12,6,6,FMN GV 05 Lier
60,Mechelsesteenweg 365,2022-05-17,18:00:00,10,6,4,FMN GV 05 Lier
60,Mechelsesteenweg 365,2022-05-17,19:00:00,216,140,76,FMN GV 05 Lier
60,Mechelsesteenweg 365,2022-05-17,20:00:00,152,46,106,FMN GV 05 Lier
60,Mechelsesteenweg 365,2022-05-17,21:00:00,54,28,26,FMN GV 05 Lier
60,Mechelsesteenweg 365,2022-05-17,22:00:00,20,12,8,FMN GV 05 Lier
60,Mechelsesteenweg 365,2022-05-17,23:00:00,6,2,4,FMN GV 05 Lier
60,Mechelsesteenweg 365,2022-05-18,00:00:00,2,2,0,FMN GV 05 Lier
60,Mechelsesteenweg 365,2022-05-18,01:00:00,2,2,0,FMN GV 05 Lier
60,Mechelsesteenweg 365,2022-05-18,02:00:00,2,2,0,FMN GV 05 Lier
60,Mechelsesteenweg 365,2022-05-18,03:00:00,0,0,0,FMN GV 05 Lier
60,Mechelsesteenweg 365,2022-05-18,04:00:00,4,0,4,FMN GV 05 Lier
60,Mechelsesteenweg 365,2022-05-18,05:00:00,18,2,16,FMN GV 05 Lier
60,Mechelsesteenweg 365,2022-05-18,06:00:00,50,14,36,FMN GV 05 Lier
60,Mechelsesteenweg 365,2022-05-18,07:00:00,194,94,100,FMN GV 05 Lier
60,Mechelsesteenweg 365,2022-05-18,08:00:00,214,136,78,FMN GV 05 Lier
60,Mechelsesteenweg 365,2022-05-18,09:00:00,160,68,92,FMN GV 05 Lier
60,Mechelsesteenweg 365,2022-05-18,10:00:00,196,130,66,FMN GV 05 Lier
60,Mechelsesteenweg 365,2022-05-18,11:00:00,34,28,6,FMN GV 05 Lier
60,Mechelsesteenweg 365,2022-05-18,12:00:00,0,0,0,FMN GV 05 Lier
60,Mechelsesteenweg 365,2022-05-18,13:00:00,0,0,0,FMN GV 05 Lier
60,Mechelsesteenweg 365,2022-05-18,14:00:00,0,0,0,FMN GV 05 Lier
60,Mechelsesteenweg 365,2022-05-18,15:00:00,0,0,0,FMN GV 05 Lier
60,Mechelsesteenweg 365,2022-05-18,16:00:00,0,0,0,FMN GV 05 Lier
60,Mechelsesteenweg 365,2022-05-18,17:00:00,0,0,0,FMN GV 05 Lier
60,Mechelsesteenweg 365,2022-05-18,18:00:00,0,0,0,FMN GV 05 Lier
60,Mechelsesteenweg 365,2022-05-18,19:00:00,144,74,70,FMN GV 05 Lier
60,Mechelsesteenweg 365,2022-05-18,20:00:00,210,112,98,FMN GV 05 Lier
60,Mechelsesteenweg 365,2022-05-18,21:00:00,48,24,24,FMN GV 05 Lier
60,Mechelsesteenweg 365,2022-05-18,22:00:00,22,14,8,FMN GV 05 Lier
60,Mechelsesteenweg 365,2022-05-18,23:00:00,6,6,0,FMN GV 05 Lier
60,Mechelsesteenweg 365,2022-05-19,00:00:00,4,4,0,FMN GV 05 Lier
60,Mechelsesteenweg 365,2022-05-19,01:00:00,4,4,0,FMN GV 05 Lier
60,Mechelsesteenweg 365,2022-05-19,02:00:00,0,0,0,FMN GV 05 Lier
60,Mechelsesteenweg 365,2022-05-19,03:00:00,0,0,0,FMN GV 05 Lier
60,Mechelsesteenweg 365,2022-05-19,04:00:00,0,0,0,FMN GV 05 Lier
60,Mechelsesteenweg 365,2022-05-19,05:00:00,4,2,2,FMN GV 05 Lier
60,Mechelsesteenweg 365,2022-05-19,06:00:00,16,8,8,FMN GV 05 Lier
60,Mechelsesteenweg 365,2022-05-19,07:00:00,114,52,62,FMN GV 05 Lier
60,Mechelsesteenweg 365,2022-05-19,08:00:00,158,92,66,FMN GV 05 Lier
60,Mechelsesteenweg 365,2022-05-19,09:00:00,146,124,22,FMN GV 05 Lier
60,Mechelsesteenweg 365,2022-05-19,10:00:00,88,48,40,FMN GV 05 Lier
60,Mechelsesteenweg 365,2022-05-19,11:00:00,32,2,30,FMN GV 05 Lier
60,Mechelsesteenweg 365,2022-05-19,12:00:00,28,10,18,FMN GV 05 Lier
60,Mechelsesteenweg 365,2022-05-19,13:00:00,58,18,40,FMN GV 05 Lier
60,Mechelsesteenweg 365,2022-05-19,14:00:00,24,10,14,FMN GV 05 Lier
60,Mechelsesteenweg 365,2022-05-19,15:00:00,92,46,46,FMN GV 05 Lier
60,Mechelsesteenweg 365,2022-05-19,16:00:00,152,52,100,FMN GV 05 Lier
60,Mechelsesteenweg 365,2022-05-19,17:00:00,110,58,52,FMN GV 05 Lier
60,Mechelsesteenweg 365,2022-05-19,18:00:00,70,42,28,FMN GV 05 Lier
60,Mechelsesteenweg 365,2022-05-19,19:00:00,56,36,20,FMN GV 05 Lier
60,Mechelsesteenweg 365,2022-05-19,20:00:00,170,60,110,FMN GV 05 Lier
60,Mechelsesteenweg 365,2022-05-19,21:00:00,48,40,8,FMN GV 05 Lier
60,Mechelsesteenweg 365,2022-05-19,22:00:00,20,12,8,FMN GV 05 Lier
60,Mechelsesteenweg 365,2022-05-19,23:00:00,6,2,4,FMN GV 05 Lier
60,Mechelsesteenweg 365,2022-05-20,00:00:00,4,2,2,FMN GV 05 Lier
60,Mechelsesteenweg 365,2022-05-20,01:00:00,0,0,0,FMN GV 05 Lier
60,Mechelsesteenweg 365,2022-05-20,02:00:00,2,2,0,FMN GV 05 Lier
60,Mechelsesteenweg 365,2022-05-20,03:00:00,2,2,0,FMN GV 05 Lier
60,Mechelsesteenweg 365,2022-05-20,04:00:00,0,0,0,FMN GV 05 Lier
60,Mechelsesteenweg 365,2022-05-20,05:00:00,8,2,6,FMN GV 05 Lier
60,Mechelsesteenweg 365,2022-05-20,06:00:00,18,6,12,FMN GV 05 Lier
60,Mechelsesteenweg 365,2022-05-20,07:00:00,112,50,62,FMN GV 05 Lier
60,Mechelsesteenweg 365,2022-05-20,08:00:00,114,72,42,FMN GV 05 Lier
60,Mechelsesteenweg 365,2022-05-20,09:00:00,130,56,74,FMN GV 05 Lier
60,Mechelsesteenweg 365,2022-05-20,10:00:00,36,8,28,FMN GV 05 Lier
60,Mechelsesteenweg 365,2022-05-20,11:00:00,140,82,58,FMN GV 05 Lier
60,Mechelsesteenweg 365,2022-05-20,12:00:00,44,26,18,FMN GV 05 Lier
60,Mechelsesteenweg 365,2022-05-20,13:00:00,22,16,6,FMN GV 05 Lier
60,Mechelsesteenweg 365,2022-05-20,14:00:00,28,22,6,FMN GV 05 Lier
60,Mechelsesteenweg 365,2022-05-20,15:00:00,52,16,36,FMN GV 05 Lier
60,Mechelsesteenweg 365,2022-05-20,16:00:00,146,48,98,FMN GV 05 Lier
60,Mechelsesteenweg 365,2022-05-20,17:00:00,64,36,28,FMN GV 05 Lier
60,Mechelsesteenweg 365,2022-05-20,18:00:00,32,8,24,FMN GV 05 Lier
60,Mechelsesteenweg 365,2022-05-20,19:00:00,30,16,14,FMN GV 05 Lier
60,Mechelsesteenweg 365,2022-05-20,20:00:00,44,22,22,FMN GV 05 Lier
60,Mechelsesteenweg 365,2022-05-20,21:00:00,18,8,10,FMN GV 05 Lier
60,Mechelsesteenweg 365,2022-05-20,22:00:00,4,4,0,FMN GV 05 Lier
60,Mechelsesteenweg 365,2022-05-20,23:00:00,2,2,0,FMN GV 05 Lier
60,Mechelsesteenweg 365,2022-05-21,00:00:00,6,2,4,FMN GV 05 Lier
60,Mechelsesteenweg 365,2022-05-21,01:00:00,0,0,0,FMN GV 05 Lier
60,Mechelsesteenweg 365,2022-05-21,02:00:00,0,0,0,FMN GV 05 Lier
60,Mechelsesteenweg 365,2022-05-21,03:00:00,2,2,0,FMN GV 05 Lier
60,Mechelsesteenweg 365,2022-05-21,04:00:00,0,0,0,FMN GV 05 Lier
60,Mechelsesteenweg 365,2022-05-21,05:00:00,4,0,4,FMN GV 05 Lier
60,Mechelsesteenweg 365,2022-05-21,06:00:00,4,4,0,FMN GV 05 Lier
60,Mechelsesteenweg 365,2022-05-21,07:00:00,18,6,12,FMN GV 05 Lier
60,Mechelsesteenweg 365,2022-05-21,08:00:00,42,16,26,FMN GV 05 Lier
60,Mechelsesteenweg 365,2022-05-21,09:00:00,76,32,44,FMN GV 05 Lier
60,Mechelsesteenweg 365,2022-05-21,10:00:00,250,152,98,FMN GV 05 Lier
60,Mechelsesteenweg 365,2022-05-21,11:00:00,238,128,110,FMN GV 05 Lier
60,Mechelsesteenweg 365,2022-05-21,12:00:00,106,50,56,FMN GV 05 Lier
60,Mechelsesteenweg 365,2022-05-21,13:00:00,22,8,14,FMN GV 05 Lier
60,Mechelsesteenweg 365,2022-05-21,14:00:00,2,0,2,FMN GV 05 Lier
60,Mechelsesteenweg 365,2022-05-21,15:00:00,34,18,16,FMN GV 05 Lier
60,Mechelsesteenweg 365,2022-05-21,16:00:00,34,18,16,FMN GV 05 Lier
60,Mechelsesteenweg 365,2022-05-21,17:00:00,78,44,34,FMN GV 05 Lier
60,Mechelsesteenweg 365,2022-05-21,18:00:00,70,28,42,FMN GV 05 Lier
60,Mechelsesteenweg 365,2022-05-21,19:00:00,88,38,50,FMN GV 05 Lier
60,Mechelsesteenweg 365,2022-05-21,20:00:00,46,8,38,FMN GV 05 Lier
60,Mechelsesteenweg 365,2022-05-21,21:00:00,26,16,10,FMN GV 05 Lier
60,Mechelsesteenweg 365,2022-05-21,22:00:00,2,2,0,FMN GV 05 Lier
60,Mechelsesteenweg 365,2022-05-21,23:00:00,6,4,2,FMN GV 05 Lier
60,Mechelsesteenweg 365,2022-05-22,00:00:00,0,0,0,FMN GV 05 Lier
60,Mechelsesteenweg 365,2022-05-22,01:00:00,0,0,0,FMN GV 05 Lier
60,Mechelsesteenweg 365,2022-05-22,02:00:00,0,0,0,FMN GV 05 Lier
60,Mechelsesteenweg 365,2022-05-22,03:00:00,0,0,0,FMN GV 05 Lier
60,Mechelsesteenweg 365,2022-05-22,04:00:00,0,0,0,FMN GV 05 Lier
60,Mechelsesteenweg 365,2022-05-22,05:00:00,2,0,2,FMN GV 05 Lier
60,Mechelsesteenweg 365,2022-05-22,06:00:00,8,4,4,FMN GV 05 Lier
60,Mechelsesteenweg 365,2022-05-22,07:00:00,26,8,18,FMN GV 05 Lier
60,Mechelsesteenweg 365,2022-05-22,08:00:00,72,32,40,FMN GV 05 Lier
60,Mechelsesteenweg 365,2022-05-22,09:00:00,302,184,118,FMN GV 05 Lier
60,Mechelsesteenweg 365,2022-05-22,10:00:00,430,270,160,FMN GV 05 Lier
60,Mechelsesteenweg 365,2022-05-22,11:00:00,110,50,60,FMN GV 05 Lier
60,Mechelsesteenweg 365,2022-05-22,12:00:00,0,0,0,FMN GV 05 Lier
60,Mechelsesteenweg 365,2022-05-22,13:00:00,0,0,0,FMN GV 05 Lier
60,Mechelsesteenweg 365,2022-05-22,14:00:00,0,0,0,FMN GV 05 Lier
60,Mechelsesteenweg 365,2022-05-22,15:00:00,0,0,0,FMN GV 05 Lier
60,Mechelsesteenweg 365,2022-05-22,16:00:00,0,0,0,FMN GV 05 Lier
60,Mechelsesteenweg 365,2022-05-22,17:00:00,0,0,0,FMN GV 05 Lier
60,Mechelsesteenweg 365,2022-05-22,18:00:00,12,0,12,FMN GV 05 Lier
60,Mechelsesteenweg 365,2022-05-22,19:00:00,94,28,66,FMN GV 05 Lier
60,Mechelsesteenweg 365,2022-05-22,20:00:00,70,22,48,FMN GV 05 Lier
60,Mechelsesteenweg 365,2022-05-22,21:00:00,22,10,12,FMN GV 05 Lier
60,Mechelsesteenweg 365,2022-05-22,22:00:00,16,8,8,FMN GV 05 Lier
60,Mechelsesteenweg 365,2022-05-22,23:00:00,2,2,0,FMN GV 05 Lier
60,Mechelsesteenweg 365,2022-05-23,00:00:00,0,0,0,FMN GV 05 Lier
60,Mechelsesteenweg 365,2022-05-23,01:00:00,0,0,0,FMN GV 05 Lier
60,Mechelsesteenweg 365,2022-05-23,02:00:00,2,2,0,FMN GV 05 Lier
60,Mechelsesteenweg 365,2022-05-23,03:00:00,0,0,0,FMN GV 05 Lier
60,Mechelsesteenweg 365,2022-05-23,04:00:00,0,0,0,FMN GV 05 Lier
60,Mechelsesteenweg 365,2022-05-23,05:00:00,8,0,8,FMN GV 05 Lier
60,Mechelsesteenweg 365,2022-05-23,06:00:00,34,14,20,FMN GV 05 Lier
60,Mechelsesteenweg 365,2022-05-23,07:00:00,108,54,54,FMN GV 05 Lier
60,Mechelsesteenweg 365,2022-05-23,08:00:00,112,62,50,FMN GV 05 Lier
60,Mechelsesteenweg 365,2022-05-23,09:00:00,82,56,26,FMN GV 05 Lier
60,Mechelsesteenweg 365,2022-05-23,10:00:00,42,18,24,FMN GV 05 Lier
60,Mechelsesteenweg 365,2022-05-23,11:00:00,60,34,26,FMN GV 05 Lier
60,Mechelsesteenweg 365,2022-05-23,12:00:00,60,28,32,FMN GV 05 Lier
60,Mechelsesteenweg 365,2022-05-23,13:00:00,58,26,32,FMN GV 05 Lier
60,Mechelsesteenweg 365,2022-05-23,14:00:00,28,12,16,FMN GV 05 Lier
60,Mechelsesteenweg 365,2022-05-23,15:00:00,50,30,20,FMN GV 05 Lier
60,Mechelsesteenweg 365,2022-05-23,16:00:00,160,38,122,FMN GV 05 Lier
60,Mechelsesteenweg 365,2022-05-23,17:00:00,98,52,46,FMN GV 05 Lier
60,Mechelsesteenweg 365,2022-05-23,18:00:00,30,16,14,FMN GV 05 Lier
60,Mechelsesteenweg 365,2022-05-23,19:00:00,12,12,0,FMN GV 05 Lier
60,Mechelsesteenweg 365,2022-05-23,20:00:00,10,0,10,FMN GV 05 Lier
60,Mechelsesteenweg 365,2022-05-23,21:00:00,14,4,10,FMN GV 05 Lier
60,Mechelsesteenweg 365,2022-05-23,22:00:00,6,6,0,FMN GV 05 Lier
60,Mechelsesteenweg 365,2022-05-23,23:00:00,2,2,0,FMN GV 05 Lier
60,Mechelsesteenweg 365,2022-05-24,00:00:00,0,0,0,FMN GV 05 Lier
60,Mechelsesteenweg 365,2022-05-24,01:00:00,0,0,0,FMN GV 05 Lier
60,Mechelsesteenweg 365,2022-05-24,02:00:00,0,0,0,FMN GV 05 Lier
60,Mechelsesteenweg 365,2022-05-24,03:00:00,0,0,0,FMN GV 05 Lier
60,Mechelsesteenweg 365,2022-05-24,04:00:00,2,2,0,FMN GV 05 Lier
60,Mechelsesteenweg 365,2022-05-24,05:00:00,8,2,6,FMN GV 05 Lier
60,Mechelsesteenweg 365,2022-05-24,06:00:00,42,12,30,FMN GV 05 Lier
60,Mechelsesteenweg 365,2022-05-24,07:00:00,122,40,82,FMN GV 05 Lier
60,Mechelsesteenweg 365,2022-05-24,08:00:00,132,74,58,FMN GV 05 Lier
60,Mechelsesteenweg 365,2022-05-24,09:00:00,92,54,38,FMN GV 05 Lier
60,Mechelsesteenweg 365,2022-05-24,10:00:00,76,42,34,FMN GV 05 Lier
60,Mechelsesteenweg 365,2022-05-24,11:00:00,70,44,26,FMN GV 05 Lier
60,Mechelsesteenweg 365,2022-05-24,12:00:00,80,46,34,FMN GV 05 Lier
60,Mechelsesteenweg 365,2022-05-24,13:00:00,34,10,24,FMN GV 05 Lier
60,Mechelsesteenweg 365,2022-05-24,14:00:00,74,46,28,FMN GV 05 Lier
60,Mechelsesteenweg 365,2022-05-24,15:00:00,88,40,48,FMN GV 05 Lier
60,Mechelsesteenweg 365,2022-05-24,16:00:00,230,94,136,FMN GV 05 Lier
60,Mechelsesteenweg 365,2022-05-24,17:00:00,108,64,44,FMN GV 05 Lier
60,Mechelsesteenweg 365,2022-05-24,18:00:00,58,26,32,FMN GV 05 Lier
60,Mechelsesteenweg 365,2022-05-24,19:00:00,38,18,20,FMN GV 05 Lier
60,Mechelsesteenweg 365,2022-05-24,20:00:00,80,42,38,FMN GV 05 Lier
60,Mechelsesteenweg 365,2022-05-24,21:00:00,22,6,16,FMN GV 05 Lier
60,Mechelsesteenweg 365,2022-05-24,22:00:00,8,4,4,FMN GV 05 Lier
60,Mechelsesteenweg 365,2022-05-24,23:00:00,0,0,0,FMN GV 05 Lier
60,Mechelsesteenweg 365,2022-05-25,00:00:00,0,0,0,FMN GV 05 Lier
60,Mechelsesteenweg 365,2022-05-25,01:00:00,0,0,0,FMN GV 05 Lier
60,Mechelsesteenweg 365,2022-05-25,02:00:00,0,0,0,FMN GV 05 Lier
60,Mechelsesteenweg 365,2022-05-25,03:00:00,0,0,0,FMN GV 05 Lier
60,Mechelsesteenweg 365,2022-05-25,04:00:00,4,0,4,FMN GV 05 Lier
60,Mechelsesteenweg 365,2022-05-25,05:00:00,10,4,6,FMN GV 05 Lier
60,Mechelsesteenweg 365,2022-05-25,06:00:00,38,12,26,FMN GV 05 Lier
60,Mechelsesteenweg 365,2022-05-25,07:00:00,152,72,80,FMN GV 05 Lier
60,Mechelsesteenweg 365,2022-05-25,08:00:00,170,98,72,FMN GV 05 Lier
60,Mechelsesteenweg 365,2022-05-25,09:00:00,112,54,58,FMN GV 05 Lier
60,Mechelsesteenweg 365,2022-05-25,10:00:00,148,74,74,FMN GV 05 Lier
60,Mechelsesteenweg 365,2022-05-25,11:00:00,70,36,34,FMN GV 05 Lier
60,Mechelsesteenweg 365,2022-05-25,12:00:00,214,62,152,FMN GV 05 Lier
60,Mechelsesteenweg 365,2022-05-25,13:00:00,220,92,128,FMN GV 05 Lier
60,Mechelsesteenweg 365,2022-05-25,14:00:00,146,68,78,FMN GV 05 Lier
60,Mechelsesteenweg 365,2022-05-25,15:00:00,150,84,66,FMN GV 05 Lier
60,Mechelsesteenweg 365,2022-05-25,16:00:00,126,76,50,FMN GV 05 Lier
60,Mechelsesteenweg 365,2022-05-25,17:00:00,144,100,44,FMN GV 05 Lier
60,Mechelsesteenweg 365,2022-05-25,18:00:00,88,52,36,FMN GV 05 Lier
60,Mechelsesteenweg 365,2022-05-25,19:00:00,76,58,18,FMN GV 05 Lier
60,Mechelsesteenweg 365,2022-05-25,20:00:00,90,58,32,FMN GV 05 Lier
60,Mechelsesteenweg 365,2022-05-25,21:00:00,24,8,16,FMN GV 05 Lier
60,Mechelsesteenweg 365,2022-05-25,22:00:00,10,6,4,FMN GV 05 Lier
60,Mechelsesteenweg 365,2022-05-25,23:00:00,6,0,6,FMN GV 05 Lier
60,Mechelsesteenweg 365,2022-05-26,00:00:00,2,0,2,FMN GV 05 Lier
60,Mechelsesteenweg 365,2022-05-26,01:00:00,4,0,4,FMN GV 05 Lier
60,Mechelsesteenweg 365,2022-05-26,02:00:00,2,0,2,FMN GV 05 Lier
60,Mechelsesteenweg 365,2022-05-26,03:00:00,0,0,0,FMN GV 05 Lier
60,Mechelsesteenweg 365,2022-05-26,04:00:00,2,0,2,FMN GV 05 Lier
60,Mechelsesteenweg 365,2022-05-26,05:00:00,4,0,4,FMN GV 05 Lier
60,Mechelsesteenweg 365,2022-05-26,06:00:00,12,6,6,FMN GV 05 Lier
60,Mechelsesteenweg 365,2022-05-26,07:00:00,10,2,8,FMN GV 05 Lier
60,Mechelsesteenweg 365,2022-05-26,08:00:00,50,40,10,FMN GV 05 Lier
60,Mechelsesteenweg 365,2022-05-26,09:00:00,154,90,64,FMN GV 05 Lier
60,Mechelsesteenweg 365,2022-05-26,10:00:00,244,142,102,FMN GV 05 Lier
60,Mechelsesteenweg 365,2022-05-26,11:00:00,334,178,156,FMN GV 05 Lier
60,Mechelsesteenweg 365,2022-05-26,12:00:00,178,110,68,FMN GV 05 Lier
60,Mechelsesteenweg 365,2022-05-26,13:00:00,88,58,30,FMN GV 05 Lier
60,Mechelsesteenweg 365,2022-05-26,14:00:00,4,0,4,FMN GV 05 Lier
60,Mechelsesteenweg 365,2022-05-26,15:00:00,194,96,98,FMN GV 05 Lier
60,Mechelsesteenweg 365,2022-05-26,16:00:00,208,102,106,FMN GV 05 Lier
60,Mechelsesteenweg 365,2022-05-26,17:00:00,140,58,82,FMN GV 05 Lier
60,Mechelsesteenweg 365,2022-05-26,18:00:00,76,38,38,FMN GV 05 Lier
60,Mechelsesteenweg 365,2022-05-26,19:00:00,94,52,42,FMN GV 05 Lier
60,Mechelsesteenweg 365,2022-05-26,20:00:00,36,18,18,FMN GV 05 Lier
60,Mechelsesteenweg 365,2022-05-26,21:00:00,18,6,12,FMN GV 05 Lier
60,Mechelsesteenweg 365,2022-05-26,22:00:00,12,4,8,FMN GV 05 Lier
60,Mechelsesteenweg 365,2022-05-26,23:00:00,4,2,2,FMN GV 05 Lier
60,Mechelsesteenweg 365,2022-05-27,00:00:00,0,0,0,FMN GV 05 Lier
60,Mechelsesteenweg 365,2022-05-27,01:00:00,0,0,0,FMN GV 05 Lier
60,Mechelsesteenweg 365,2022-05-27,02:00:00,0,0,0,FMN GV 05 Lier
60,Mechelsesteenweg 365,2022-05-27,03:00:00,2,2,0,FMN GV 05 Lier
60,Mechelsesteenweg 365,2022-05-27,04:00:00,2,0,2,FMN GV 05 Lier
60,Mechelsesteenweg 365,2022-05-27,05:00:00,2,0,2,FMN GV 05 Lier
60,Mechelsesteenweg 365,2022-05-27,06:00:00,6,6,0,FMN GV 05 Lier
60,Mechelsesteenweg 365,2022-05-27,07:00:00,16,8,8,FMN GV 05 Lier
60,Mechelsesteenweg 365,2022-05-27,08:00:00,22,10,12,FMN GV 05 Lier
60,Mechelsesteenweg 365,2022-05-27,09:00:00,58,22,36,FMN GV 05 Lier
60,Mechelsesteenweg 365,2022-05-27,10:00:00,118,66,52,FMN GV 05 Lier
60,Mechelsesteenweg 365,2022-05-27,11:00:00,156,76,80,FMN GV 05 Lier
60,Mechelsesteenweg 365,2022-05-27,12:00:00,86,50,36,FMN GV 05 Lier
60,Mechelsesteenweg 365,2022-05-27,13:00:00,12,6,6,FMN GV 05 Lier
60,Mechelsesteenweg 365,2022-05-27,14:00:00,0,0,0,FMN GV 05 Lier
60,Mechelsesteenweg 365,2022-05-27,15:00:00,0,0,0,FMN GV 05 Lier
60,Mechelsesteenweg 365,2022-05-27,16:00:00,0,0,0,FMN GV 05 Lier
60,Mechelsesteenweg 365,2022-05-27,17:00:00,6,2,4,FMN GV 05 Lier
60,Mechelsesteenweg 365,2022-05-27,18:00:00,46,26,20,FMN GV 05 Lier
60,Mechelsesteenweg 365,2022-05-27,19:00:00,36,18,18,FMN GV 05 Lier
60,Mechelsesteenweg 365,2022-05-27,20:00:00,48,20,28,FMN GV 05 Lier
60,Mechelsesteenweg 365,2022-05-27,21:00:00,26,16,10,FMN GV 05 Lier
60,Mechelsesteenweg 365,2022-05-27,22:00:00,16,10,6,FMN GV 05 Lier
60,Mechelsesteenweg 365,2022-05-27,23:00:00,8,2,6,FMN GV 05 Lier
60,Mechelsesteenweg 365,2022-05-28,00:00:00,6,0,6,FMN GV 05 Lier
60,Mechelsesteenweg 365,2022-05-28,01:00:00,2,2,0,FMN GV 05 Lier
60,Mechelsesteenweg 365,2022-05-28,02:00:00,0,0,0,FMN GV 05 Lier
60,Mechelsesteenweg 365,2022-05-28,03:00:00,0,0,0,FMN GV 05 Lier
60,Mechelsesteenweg 365,2022-05-28,04:00:00,0,0,0,FMN GV 05 Lier
60,Mechelsesteenweg 365,2022-05-28,05:00:00,4,2,2,FMN GV 05 Lier
60,Mechelsesteenweg 365,2022-05-28,06:00:00,10,2,8,FMN GV 05 Lier
60,Mechelsesteenweg 365,2022-05-28,07:00:00,22,12,10,FMN GV 05 Lier
60,Mechelsesteenweg 365,2022-05-28,08:00:00,46,28,18,FMN GV 05 Lier
60,Mechelsesteenweg 365,2022-05-28,09:00:00,104,64,40,FMN GV 05 Lier
60,Mechelsesteenweg 365,2022-05-28,10:00:00,186,98,88,FMN GV 05 Lier
60,Mechelsesteenweg 365,2022-05-28,11:00:00,186,98,88,FMN GV 05 Lier
60,Mechelsesteenweg 365,2022-05-28,12:00:00,110,56,54,FMN GV 05 Lier
60,Mechelsesteenweg 365,2022-05-28,13:00:00,84,46,38,FMN GV 05 Lier
60,Mechelsesteenweg 365,2022-05-28,14:00:00,58,40,18,FMN GV 05 Lier
60,Mechelsesteenweg 365,2022-05-28,15:00:00,2,0,2,FMN GV 05 Lier
60,Mechelsesteenweg 365,2022-05-28,16:00:00,0,0,0,FMN GV 05 Lier
60,Mechelsesteenweg 365,2022-05-28,17:00:00,8,2,6,FMN GV 05 Lier
60,Mechelsesteenweg 365,2022-05-28,18:00:00,50,16,34,FMN GV 05 Lier
60,Mechelsesteenweg 365,2022-05-28,19:00:00,46,14,32,FMN GV 05 Lier
60,Mechelsesteenweg 365,2022-05-28,20:00:00,54,18,36,FMN GV 05 Lier
60,Mechelsesteenweg 365,2022-05-28,21:00:00,20,12,8,FMN GV 05 Lier
60,Mechelsesteenweg 365,2022-05-28,22:00:00,8,4,4,FMN GV 05 Lier
60,Mechelsesteenweg 365,2022-05-28,23:00:00,4,2,2,FMN GV 05 Lier
60,Mechelsesteenweg 365,2022-05-29,00:00:00,2,2,0,FMN GV 05 Lier
60,Mechelsesteenweg 365,2022-05-29,01:00:00,0,0,0,FMN GV 05 Lier
60,Mechelsesteenweg 365,2022-05-29,02:00:00,0,0,0,FMN GV 05 Lier
60,Mechelsesteenweg 365,2022-05-29,03:00:00,0,0,0,FMN GV 05 Lier
60,Mechelsesteenweg 365,2022-05-29,04:00:00,0,0,0,FMN GV 05 Lier
60,Mechelsesteenweg 365,2022-05-29,05:00:00,4,0,4,FMN GV 05 Lier
60,Mechelsesteenweg 365,2022-05-29,06:00:00,6,0,6,FMN GV 05 Lier
60,Mechelsesteenweg 365,2022-05-29,07:00:00,16,6,10,FMN GV 05 Lier
60,Mechelsesteenweg 365,2022-05-29,08:00:00,34,4,30,FMN GV 05 Lier
60,Mechelsesteenweg 365,2022-05-29,09:00:00,134,96,38,FMN GV 05 Lier
60,Mechelsesteenweg 365,2022-05-29,10:00:00,156,60,96,FMN GV 05 Lier
60,Mechelsesteenweg 365,2022-05-29,11:00:00,104,48,56,FMN GV 05 Lier
60,Mechelsesteenweg 365,2022-05-29,12:00:00,52,24,28,FMN GV 05 Lier
60,Mechelsesteenweg 365,2022-05-29,13:00:00,54,22,32,FMN GV 05 Lier
60,Mechelsesteenweg 365,2022-05-29,14:00:00,56,28,28,FMN GV 05 Lier
60,Mechelsesteenweg 365,2022-05-29,15:00:00,28,18,10,FMN GV 05 Lier
60,Mechelsesteenweg 365,2022-05-29,16:00:00,40,6,34,FMN GV 05 Lier
60,Mechelsesteenweg 365,2022-05-29,17:00:00,44,22,22,FMN GV 05 Lier
60,Mechelsesteenweg 365,2022-05-29,18:00:00,34,20,14,FMN GV 05 Lier
60,Mechelsesteenweg 365,2022-05-29,19:00:00,32,18,14,FMN GV 05 Lier
60,Mechelsesteenweg 365,2022-05-29,20:00:00,26,12,14,FMN GV 05 Lier
60,Mechelsesteenweg 365,2022-05-29,21:00:00,8,4,4,FMN GV 05 Lier
60,Mechelsesteenweg 365,2022-05-29,22:00:00,2,2,0,FMN GV 05 Lier
60,Mechelsesteenweg 365,2022-05-29,23:00:00,4,2,2,FMN GV 05 Lier
60,Mechelsesteenweg 365,2022-05-30,00:00:00,0,0,0,FMN GV 05 Lier
60,Mechelsesteenweg 365,2022-05-30,01:00:00,0,0,0,FMN GV 05 Lier
60,Mechelsesteenweg 365,2022-05-30,02:00:00,0,0,0,FMN GV 05 Lier
60,Mechelsesteenweg 365,2022-05-30,03:00:00,0,0,0,FMN GV 05 Lier
60,Mechelsesteenweg 365,2022-05-30,04:00:00,2,0,2,FMN GV 05 Lier
60,Mechelsesteenweg 365,2022-05-30,05:00:00,16,0,16,FMN GV 05 Lier
60,Mechelsesteenweg 365,2022-05-30,06:00:00,24,8,16,FMN GV 05 Lier
60,Mechelsesteenweg 365,2022-05-30,07:00:00,136,64,72,FMN GV 05 Lier
60,Mechelsesteenweg 365,2022-05-30,08:00:00,146,84,62,FMN GV 05 Lier
60,Mechelsesteenweg 365,2022-05-30,09:00:00,72,26,46,FMN GV 05 Lier
60,Mechelsesteenweg 365,2022-05-30,10:00:00,76,42,34,FMN GV 05 Lier
60,Mechelsesteenweg 365,2022-05-30,11:00:00,176,108,68,FMN GV 05 Lier
60,Mechelsesteenweg 365,2022-05-30,12:00:00,70,24,46,FMN GV 05 Lier
60,Mechelsesteenweg 365,2022-05-30,13:00:00,84,48,36,FMN GV 05 Lier
60,Mechelsesteenweg 365,2022-05-30,14:00:00,134,70,64,FMN GV 05 Lier
60,Mechelsesteenweg 365,2022-05-30,15:00:00,2,2,0,FMN GV 05 Lier
60,Mechelsesteenweg 365,2022-05-30,16:00:00,162,66,96,FMN GV 05 Lier
60,Mechelsesteenweg 365,2022-05-30,17:00:00,162,84,78,FMN GV 05 Lier
60,Mechelsesteenweg 365,2022-05-30,18:00:00,116,62,54,FMN GV 05 Lier
60,Mechelsesteenweg 365,2022-05-30,19:00:00,80,50,30,FMN GV 05 Lier
60,Mechelsesteenweg 365,2022-05-30,20:00:00,76,38,38,FMN GV 05 Lier
60,Mechelsesteenweg 365,2022-05-30,21:00:00,22,10,12,FMN GV 05 Lier
60,Mechelsesteenweg 365,2022-05-30,22:00:00,4,2,2,FMN GV 05 Lier
60,Mechelsesteenweg 365,2022-05-30,23:00:00,0,0,0,FMN GV 05 Lier
60,Mechelsesteenweg 365,2022-05-31,00:00:00,0,0,0,FMN GV 05 Lier
60,Mechelsesteenweg 365,2022-05-31,01:00:00,0,0,0,FMN GV 05 Lier
60,Mechelsesteenweg 365,2022-05-31,02:00:00,0,0,0,FMN GV 05 Lier
60,Mechelsesteenweg 365,2022-05-31,03:00:00,0,0,0,FMN GV 05 Lier
60,Mechelsesteenweg 365,2022-05-31,04:00:00,2,0,2,FMN GV 05 Lier
60,Mechelsesteenweg 365,2022-05-31,05:00:00,12,0,12,FMN GV 05 Lier
60,Mechelsesteenweg 365,2022-05-31,06:00:00,48,16,32,FMN GV 05 Lier
60,Mechelsesteenweg 365,2022-05-31,07:00:00,158,66,92,FMN GV 05 Lier
60,Mechelsesteenweg 365,2022-05-31,08:00:00,166,104,62,FMN GV 05 Lier
60,Mechelsesteenweg 365,2022-05-31,09:00:00,90,34,56,FMN GV 05 Lier
60,Mechelsesteenweg 365,2022-05-31,10:00:00,118,72,46,FMN GV 05 Lier
60,Mechelsesteenweg 365,2022-05-31,11:00:00,68,28,40,FMN GV 05 Lier
60,Mechelsesteenweg 365,2022-05-31,12:00:00,0,0,0,FMN GV 05 Lier
60,Mechelsesteenweg 365,2022-05-31,13:00:00,0,0,0,FMN GV 05 Lier
60,Mechelsesteenweg 365,2022-05-31,14:00:00,0,0,0,FMN GV 05 Lier
60,Mechelsesteenweg 365,2022-05-31,15:00:00,0,0,0,FMN GV 05 Lier
60,Mechelsesteenweg 365,2022-05-31,16:00:00,14,4,10,FMN GV 05 Lier
60,Mechelsesteenweg 365,2022-05-31,17:00:00,132,84,48,FMN GV 05 Lier
60,Mechelsesteenweg 365,2022-05-31,18:00:00,76,48,28,FMN GV 05 Lier
60,Mechelsesteenweg 365,2022-05-31,19:00:00,72,34,38,FMN GV 05 Lier
60,Mechelsesteenweg 365,2022-05-31,20:00:00,82,42,40,FMN GV 05 Lier
60,Mechelsesteenweg 365,2022-05-31,21:00:00,34,10,24,FMN GV 05 Lier
60,Mechelsesteenweg 365,2022-05-31,22:00:00,8,2,6,FMN GV 05 Lier
60,Mechelsesteenweg 365,2022-05-31,23:00:00,6,4,2,FMN GV 05 Lier
60,Mechelsesteenweg 365,2022-06-01,00:00:00,0,0,0,FMN GV 05 Lier
60,Mechelsesteenweg 365,2022-06-01,01:00:00,0,0,0,FMN GV 05 Lier
60,Mechelsesteenweg 365,2022-06-01,02:00:00,0,0,0,FMN GV 05 Lier
60,Mechelsesteenweg 365,2022-06-01,03:00:00,0,0,0,FMN GV 05 Lier
60,Mechelsesteenweg 365,2022-06-01,04:00:00,6,2,4,FMN GV 05 Lier
60,Mechelsesteenweg 365,2022-06-01,05:00:00,10,2,8,FMN GV 05 Lier
60,Mechelsesteenweg 365,2022-06-01,06:00:00,38,14,24,FMN GV 05 Lier
60,Mechelsesteenweg 365,2022-06-01,07:00:00,162,80,82,FMN GV 05 Lier
60,Mechelsesteenweg 365,2022-06-01,08:00:00,134,86,48,FMN GV 05 Lier
60,Mechelsesteenweg 365,2022-06-01,09:00:00,66,40,26,FMN GV 05 Lier
60,Mechelsesteenweg 365,2022-06-01,10:00:00,118,50,68,FMN GV 05 Lier
60,Mechelsesteenweg 365,2022-06-01,11:00:00,114,54,60,FMN GV 05 Lier
60,Mechelsesteenweg 365,2022-06-01,12:00:00,98,38,60,FMN GV 05 Lier
60,Mechelsesteenweg 365,2022-06-01,13:00:00,156,84,72,FMN GV 05 Lier
60,Mechelsesteenweg 365,2022-06-01,14:00:00,160,100,60,FMN GV 05 Lier
60,Mechelsesteenweg 365,2022-06-01,15:00:00,116,70,46,FMN GV 05 Lier
60,Mechelsesteenweg 365,2022-06-01,16:00:00,114,62,52,FMN GV 05 Lier
60,Mechelsesteenweg 365,2022-06-01,17:00:00,134,82,52,FMN GV 05 Lier
60,Mechelsesteenweg 365,2022-06-01,18:00:00,158,86,72,FMN GV 05 Lier
60,Mechelsesteenweg 365,2022-06-01,19:00:00,144,50,94,FMN GV 05 Lier
60,Mechelsesteenweg 365,2022-06-01,20:00:00,188,126,62,FMN GV 05 Lier
60,Mechelsesteenweg 365,2022-06-01,21:00:00,32,18,14,FMN GV 05 Lier
60,Mechelsesteenweg 365,2022-06-01,22:00:00,18,6,12,FMN GV 05 Lier
60,Mechelsesteenweg 365,2022-06-01,23:00:00,0,0,0,FMN GV 05 Lier
60,Mechelsesteenweg 365,2022-06-02,00:00:00,2,0,2,FMN GV 05 Lier
60,Mechelsesteenweg 365,2022-06-02,01:00:00,0,0,0,FMN GV 05 Lier
60,Mechelsesteenweg 365,2022-06-02,02:00:00,0,0,0,FMN GV 05 Lier
60,Mechelsesteenweg 365,2022-06-02,03:00:00,0,0,0,FMN GV 05 Lier
60,Mechelsesteenweg 365,2022-06-02,04:00:00,2,2,0,FMN GV 05 Lier
60,Mechelsesteenweg 365,2022-06-02,05:00:00,12,0,12,FMN GV 05 Lier
60,Mechelsesteenweg 365,2022-06-02,06:00:00,36,14,22,FMN GV 05 Lier
60,Mechelsesteenweg 365,2022-06-02,07:00:00,168,78,90,FMN GV 05 Lier
60,Mechelsesteenweg 365,2022-06-02,08:00:00,164,90,74,FMN GV 05 Lier
60,Mechelsesteenweg 365,2022-06-02,09:00:00,102,66,36,FMN GV 05 Lier
60,Mechelsesteenweg 365,2022-06-02,10:00:00,114,74,40,FMN GV 05 Lier
60,Mechelsesteenweg 365,2022-06-02,11:00:00,68,34,34,FMN GV 05 Lier
60,Mechelsesteenweg 365,2022-06-02,12:00:00,14,8,6,FMN GV 05 Lier
60,Mechelsesteenweg 365,2022-06-02,13:00:00,0,0,0,FMN GV 05 Lier
60,Mechelsesteenweg 365,2022-06-02,14:00:00,0,0,0,FMN GV 05 Lier
60,Mechelsesteenweg 365,2022-06-02,15:00:00,0,0,0,FMN GV 05 Lier
60,Mechelsesteenweg 365,2022-06-02,16:00:00,0,0,0,FMN GV 05 Lier
60,Mechelsesteenweg 365,2022-06-02,17:00:00,0,0,0,FMN GV 05 Lier
60,Mechelsesteenweg 365,2022-06-02,18:00:00,42,20,22,FMN GV 05 Lier
60,Mechelsesteenweg 365,2022-06-02,19:00:00,148,90,58,FMN GV 05 Lier
60,Mechelsesteenweg 365,2022-06-02,20:00:00,280,82,198,FMN GV 05 Lier
60,Mechelsesteenweg 365,2022-06-02,21:00:00,64,18,46,FMN GV 05 Lier
60,Mechelsesteenweg 365,2022-06-02,22:00:00,20,6,14,FMN GV 05 Lier
60,Mechelsesteenweg 365,2022-06-02,23:00:00,4,4,0,FMN GV 05 Lier
60,Mechelsesteenweg 365,2022-06-03,00:00:00,0,0,0,FMN GV 05 Lier
60,Mechelsesteenweg 365,2022-06-03,01:00:00,0,0,0,FMN GV 05 Lier
60,Mechelsesteenweg 365,2022-06-03,02:00:00,2,2,0,FMN GV 05 Lier
60,Mechelsesteenweg 365,2022-06-03,03:00:00,2,0,2,FMN GV 05 Lier
60,Mechelsesteenweg 365,2022-06-03,04:00:00,0,0,0,FMN GV 05 Lier
60,Mechelsesteenweg 365,2022-06-03,05:00:00,12,0,12,FMN GV 05 Lier
60,Mechelsesteenweg 365,2022-06-03,06:00:00,30,8,22,FMN GV 05 Lier
60,Mechelsesteenweg 365,2022-06-03,07:00:00,150,70,80,FMN GV 05 Lier
60,Mechelsesteenweg 365,2022-06-03,08:00:00,176,102,74,FMN GV 05 Lier
60,Mechelsesteenweg 365,2022-06-03,09:00:00,132,66,66,FMN GV 05 Lier
60,Mechelsesteenweg 365,2022-06-03,10:00:00,94,44,50,FMN GV 05 Lier
60,Mechelsesteenweg 365,2022-06-03,11:00:00,0,0,0,FMN GV 05 Lier
60,Mechelsesteenweg 365,2022-06-03,12:00:00,0,0,0,FMN GV 05 Lier
60,Mechelsesteenweg 365,2022-06-03,13:00:00,0,0,0,FMN GV 05 Lier
60,Mechelsesteenweg 365,2022-06-03,14:00:00,0,0,0,FMN GV 05 Lier
60,Mechelsesteenweg 365,2022-06-03,15:00:00,0,0,0,FMN GV 05 Lier
60,Mechelsesteenweg 365,2022-06-03,16:00:00,0,0,0,FMN GV 05 Lier
60,Mechelsesteenweg 365,2022-06-03,17:00:00,72,30,42,FMN GV 05 Lier
60,Mechelsesteenweg 365,2022-06-03,18:00:00,130,74,56,FMN GV 05 Lier
60,Mechelsesteenweg 365,2022-06-03,19:00:00,120,60,60,FMN GV 05 Lier
60,Mechelsesteenweg 365,2022-06-03,20:00:00,54,30,24,FMN GV 05 Lier
60,Mechelsesteenweg 365,2022-06-03,21:00:00,22,6,16,FMN GV 05 Lier
60,Mechelsesteenweg 365,2022-06-03,22:00:00,34,12,22,FMN GV 05 Lier
60,Mechelsesteenweg 365,2022-06-03,23:00:00,8,0,8,FMN GV 05 Lier
60,Mechelsesteenweg 365,2022-06-04,00:00:00,4,2,2,FMN GV 05 Lier
60,Mechelsesteenweg 365,2022-06-04,01:00:00,2,0,2,FMN GV 05 Lier
60,Mechelsesteenweg 365,2022-06-04,02:00:00,2,2,0,FMN GV 05 Lier
60,Mechelsesteenweg 365,2022-06-04,03:00:00,0,0,0,FMN GV 05 Lier
60,Mechelsesteenweg 365,2022-06-04,04:00:00,2,0,2,FMN GV 05 Lier
60,Mechelsesteenweg 365,2022-06-04,05:00:00,2,2,0,FMN GV 05 Lier
60,Mechelsesteenweg 365,2022-06-04,06:00:00,6,2,4,FMN GV 05 Lier
60,Mechelsesteenweg 365,2022-06-04,07:00:00,16,4,12,FMN GV 05 Lier
60,Mechelsesteenweg 365,2022-06-04,08:00:00,64,26,38,FMN GV 05 Lier
60,Mechelsesteenweg 365,2022-06-04,09:00:00,84,44,40,FMN GV 05 Lier
60,Mechelsesteenweg 365,2022-06-04,10:00:00,180,98,82,FMN GV 05 Lier
60,Mechelsesteenweg 365,2022-06-04,11:00:00,190,74,116,FMN GV 05 Lier
60,Mechelsesteenweg 365,2022-06-04,12:00:00,144,60,84,FMN GV 05 Lier
60,Mechelsesteenweg 365,2022-06-04,13:00:00,0,0,0,FMN GV 05 Lier
60,Mechelsesteenweg 365,2022-06-04,14:00:00,0,0,0,FMN GV 05 Lier
60,Mechelsesteenweg 365,2022-06-04,15:00:00,0,0,0,FMN GV 05 Lier
60,Mechelsesteenweg 365,2022-06-04,16:00:00,0,0,0,FMN GV 05 Lier
60,Mechelsesteenweg 365,2022-06-04,17:00:00,0,0,0,FMN GV 05 Lier
60,Mechelsesteenweg 365,2022-06-04,18:00:00,0,0,0,FMN GV 05 Lier
60,Mechelsesteenweg 365,2022-06-04,19:00:00,72,20,52,FMN GV 05 Lier
60,Mechelsesteenweg 365,2022-06-04,20:00:00,72,32,40,FMN GV 05 Lier
60,Mechelsesteenweg 365,2022-06-04,21:00:00,20,8,12,FMN GV 05 Lier
60,Mechelsesteenweg 365,2022-06-04,22:00:00,16,8,8,FMN GV 05 Lier
60,Mechelsesteenweg 365,2022-06-04,23:00:00,10,6,4,FMN GV 05 Lier
60,Mechelsesteenweg 365,2022-06-05,00:00:00,6,2,4,FMN GV 05 Lier
60,Mechelsesteenweg 365,2022-06-05,01:00:00,2,0,2,FMN GV 05 Lier
60,Mechelsesteenweg 365,2022-06-05,02:00:00,0,0,0,FMN GV 05 Lier
60,Mechelsesteenweg 365,2022-06-05,03:00:00,6,6,0,FMN GV 05 Lier
60,Mechelsesteenweg 365,2022-06-05,04:00:00,2,0,2,FMN GV 05 Lier
60,Mechelsesteenweg 365,2022-06-05,05:00:00,2,2,0,FMN GV 05 Lier
60,Mechelsesteenweg 365,2022-06-05,06:00:00,8,2,6,FMN GV 05 Lier
60,Mechelsesteenweg 365,2022-06-05,07:00:00,8,4,4,FMN GV 05 Lier
60,Mechelsesteenweg 365,2022-06-05,08:00:00,18,8,10,FMN GV 05 Lier
60,Mechelsesteenweg 365,2022-06-05,09:00:00,106,70,36,FMN GV 05 Lier
60,Mechelsesteenweg 365,2022-06-05,10:00:00,198,82,116,FMN GV 05 Lier
60,Mechelsesteenweg 365,2022-06-05,11:00:00,150,56,94,FMN GV 05 Lier
60,Mechelsesteenweg 365,2022-06-05,12:00:00,48,18,30,FMN GV 05 Lier
60,Mechelsesteenweg 365,2022-06-05,13:00:00,20,12,8,FMN GV 05 Lier
60,Mechelsesteenweg 365,2022-06-05,14:00:00,20,20,0,FMN GV 05 Lier
60,Mechelsesteenweg 365,2022-06-05,15:00:00,4,0,4,FMN GV 05 Lier
60,Mechelsesteenweg 365,2022-06-05,16:00:00,6,2,4,FMN GV 05 Lier
60,Mechelsesteenweg 365,2022-06-05,17:00:00,4,2,2,FMN GV 05 Lier
60,Mechelsesteenweg 365,2022-06-05,18:00:00,14,4,10,FMN GV 05 Lier
60,Mechelsesteenweg 365,2022-06-05,19:00:00,20,20,0,FMN GV 05 Lier
60,Mechelsesteenweg 365,2022-06-05,20:00:00,18,6,12,FMN GV 05 Lier
60,Mechelsesteenweg 365,2022-06-05,21:00:00,6,0,6,FMN GV 05 Lier
60,Mechelsesteenweg 365,2022-06-05,22:00:00,6,0,6,FMN GV 05 Lier
60,Mechelsesteenweg 365,2022-06-05,23:00:00,0,0,0,FMN GV 05 Lier
60,Mechelsesteenweg 365,2022-06-06,00:00:00,0,0,0,FMN GV 05 Lier
60,Mechelsesteenweg 365,2022-06-06,01:00:00,12,12,0,FMN GV 05 Lier
60,Mechelsesteenweg 365,2022-06-06,02:00:00,0,0,0,FMN GV 05 Lier
60,Mechelsesteenweg 365,2022-06-06,03:00:00,0,0,0,FMN GV 05 Lier
60,Mechelsesteenweg 365,2022-06-06,04:00:00,0,0,0,FMN GV 05 Lier
60,Mechelsesteenweg 365,2022-06-06,05:00:00,4,0,4,FMN GV 05 Lier
60,Mechelsesteenweg 365,2022-06-06,06:00:00,6,4,2,FMN GV 05 Lier
60,Mechelsesteenweg 365,2022-06-06,07:00:00,14,6,8,FMN GV 05 Lier
60,Mechelsesteenweg 365,2022-06-06,08:00:00,30,12,18,FMN GV 05 Lier
60,Mechelsesteenweg 365,2022-06-06,09:00:00,126,70,56,FMN GV 05 Lier
60,Mechelsesteenweg 365,2022-06-06,10:00:00,204,124,80,FMN GV 05 Lier
60,Mechelsesteenweg 365,2022-06-06,11:00:00,246,116,130,FMN GV 05 Lier
60,Mechelsesteenweg 365,2022-06-06,12:00:00,122,72,50,FMN GV 05 Lier
60,Mechelsesteenweg 365,2022-06-06,13:00:00,58,36,22,FMN GV 05 Lier
60,Mechelsesteenweg 365,2022-06-06,14:00:00,110,44,66,FMN GV 05 Lier
60,Mechelsesteenweg 365,2022-06-06,15:00:00,124,58,66,FMN GV 05 Lier
60,Mechelsesteenweg 365,2022-06-06,16:00:00,84,46,38,FMN GV 05 Lier
60,Mechelsesteenweg 365,2022-06-06,17:00:00,62,18,44,FMN GV 05 Lier
60,Mechelsesteenweg 365,2022-06-06,18:00:00,52,32,20,FMN GV 05 Lier
60,Mechelsesteenweg 365,2022-06-06,19:00:00,36,14,22,FMN GV 05 Lier
60,Mechelsesteenweg 365,2022-06-06,20:00:00,42,24,18,FMN GV 05 Lier
60,Mechelsesteenweg 365,2022-06-06,21:00:00,14,2,12,FMN GV 05 Lier
60,Mechelsesteenweg 365,2022-06-06,22:00:00,4,2,2,FMN GV 05 Lier
60,Mechelsesteenweg 365,2022-06-06,23:00:00,0,0,0,FMN GV 05 Lier
60,Mechelsesteenweg 365,2022-06-07,00:00:00,0,0,0,FMN GV 05 Lier
60,Mechelsesteenweg 365,2022-06-07,01:00:00,0,0,0,FMN GV 05 Lier
60,Mechelsesteenweg 365,2022-06-07,02:00:00,0,0,0,FMN GV 05 Lier
60,Mechelsesteenweg 365,2022-06-07,03:00:00,0,0,0,FMN GV 05 Lier
60,Mechelsesteenweg 365,2022-06-07,04:00:00,0,0,0,FMN GV 05 Lier
60,Mechelsesteenweg 365,2022-06-07,05:00:00,8,0,8,FMN GV 05 Lier
60,Mechelsesteenweg 365,2022-06-07,06:00:00,34,10,24,FMN GV 05 Lier
60,Mechelsesteenweg 365,2022-06-07,07:00:00,180,86,94,FMN GV 05 Lier
60,Mechelsesteenweg 365,2022-06-07,08:00:00,146,86,60,FMN GV 05 Lier
60,Mechelsesteenweg 365,2022-06-07,09:00:00,90,42,48,FMN GV 05 Lier
60,Mechelsesteenweg 365,2022-06-07,10:00:00,130,62,68,FMN GV 05 Lier
60,Mechelsesteenweg 365,2022-06-07,11:00:00,172,86,86,FMN GV 05 Lier
60,Mechelsesteenweg 365,2022-06-07,12:00:00,96,48,48,FMN GV 05 Lier
60,Mechelsesteenweg 365,2022-06-07,13:00:00,112,68,44,FMN GV 05 Lier
60,Mechelsesteenweg 365,2022-06-07,14:00:00,94,52,42,FMN GV 05 Lier
60,Mechelsesteenweg 365,2022-06-07,15:00:00,116,74,42,FMN GV 05 Lier
60,Mechelsesteenweg 365,2022-06-07,16:00:00,230,100,130,FMN GV 05 Lier
60,Mechelsesteenweg 365,2022-06-07,17:00:00,154,90,64,FMN GV 05 Lier
60,Mechelsesteenweg 365,2022-06-07,18:00:00,80,42,38,FMN GV 05 Lier
60,Mechelsesteenweg 365,2022-06-07,19:00:00,86,40,46,FMN GV 05 Lier
60,Mechelsesteenweg 365,2022-06-07,20:00:00,106,50,56,FMN GV 05 Lier
60,Mechelsesteenweg 365,2022-06-07,21:00:00,30,18,12,FMN GV 05 Lier
60,Mechelsesteenweg 365,2022-06-07,22:00:00,12,10,2,FMN GV 05 Lier
60,Mechelsesteenweg 365,2022-06-07,23:00:00,4,2,2,FMN GV 05 Lier
60,Mechelsesteenweg 365,2022-06-08,00:00:00,0,0,0,FMN GV 05 Lier
60,Mechelsesteenweg 365,2022-06-08,01:00:00,0,0,0,FMN GV 05 Lier
60,Mechelsesteenweg 365,2022-06-08,02:00:00,0,0,0,FMN GV 05 Lier
60,Mechelsesteenweg 365,2022-06-08,03:00:00,0,0,0,FMN GV 05 Lier
60,Mechelsesteenweg 365,2022-06-08,04:00:00,2,2,0,FMN GV 05 Lier
60,Mechelsesteenweg 365,2022-06-08,05:00:00,8,0,8,FMN GV 05 Lier
60,Mechelsesteenweg 365,2022-06-08,06:00:00,24,6,18,FMN GV 05 Lier
60,Mechelsesteenweg 365,2022-06-08,07:00:00,150,86,64,FMN GV 05 Lier
60,Mechelsesteenweg 365,2022-06-08,08:00:00,106,62,44,FMN GV 05 Lier
60,Mechelsesteenweg 365,2022-06-08,09:00:00,30,18,12,FMN GV 05 Lier
60,Mechelsesteenweg 365,2022-06-08,10:00:00,24,0,24,FMN GV 05 Lier
60,Mechelsesteenweg 365,2022-06-08,11:00:00,14,4,10,FMN GV 05 Lier
60,Mechelsesteenweg 365,2022-06-08,12:00:00,108,20,88,FMN GV 05 Lier
60,Mechelsesteenweg 365,2022-06-08,13:00:00,20,4,16,FMN GV 05 Lier
60,Mechelsesteenweg 365,2022-06-08,14:00:00,6,2,4,FMN GV 05 Lier
60,Mechelsesteenweg 365,2022-06-08,15:00:00,32,22,10,FMN GV 05 Lier
60,Mechelsesteenweg 365,2022-06-08,16:00:00,44,24,20,FMN GV 05 Lier
60,Mechelsesteenweg 365,2022-06-08,17:00:00,76,52,24,FMN GV 05 Lier
60,Mechelsesteenweg 365,2022-06-08,18:00:00,52,32,20,FMN GV 05 Lier
60,Mechelsesteenweg 365,2022-06-08,19:00:00,98,58,40,FMN GV 05 Lier
60,Mechelsesteenweg 365,2022-06-08,20:00:00,90,60,30,FMN GV 05 Lier
60,Mechelsesteenweg 365,2022-06-08,21:00:00,20,8,12,FMN GV 05 Lier
60,Mechelsesteenweg 365,2022-06-08,22:00:00,6,4,2,FMN GV 05 Lier
60,Mechelsesteenweg 365,2022-06-08,23:00:00,2,2,0,FMN GV 05 Lier
60,Mechelsesteenweg 365,2022-06-09,00:00:00,0,0,0,FMN GV 05 Lier
60,Mechelsesteenweg 365,2022-06-09,01:00:00,0,0,0,FMN GV 05 Lier
60,Mechelsesteenweg 365,2022-06-09,02:00:00,0,0,0,FMN GV 05 Lier
60,Mechelsesteenweg 365,2022-06-09,03:00:00,0,0,0,FMN GV 05 Lier
60,Mechelsesteenweg 365,2022-06-09,04:00:00,4,2,2,FMN GV 05 Lier
60,Mechelsesteenweg 365,2022-06-09,05:00:00,10,2,8,FMN GV 05 Lier
60,Mechelsesteenweg 365,2022-06-09,06:00:00,42,12,30,FMN GV 05 Lier
60,Mechelsesteenweg 365,2022-06-09,07:00:00,182,96,86,FMN GV 05 Lier
60,Mechelsesteenweg 365,2022-06-09,08:00:00,168,112,56,FMN GV 05 Lier
60,Mechelsesteenweg 365,2022-06-09,09:00:00,90,56,34,FMN GV 05 Lier
60,Mechelsesteenweg 365,2022-06-09,10:00:00,150,78,72,FMN GV 05 Lier
60,Mechelsesteenweg 365,2022-06-09,11:00:00,134,70,64,FMN GV 05 Lier
60,Mechelsesteenweg 365,2022-06-09,12:00:00,104,36,68,FMN GV 05 Lier
60,Mechelsesteenweg 365,2022-06-09,13:00:00,112,60,52,FMN GV 05 Lier
60,Mechelsesteenweg 365,2022-06-09,14:00:00,142,70,72,FMN GV 05 Lier
60,Mechelsesteenweg 365,2022-06-09,15:00:00,78,44,34,FMN GV 05 Lier
60,Mechelsesteenweg 365,2022-06-09,16:00:00,72,24,48,FMN GV 05 Lier
60,Mechelsesteenweg 365,2022-06-09,17:00:00,112,64,48,FMN GV 05 Lier
60,Mechelsesteenweg 365,2022-06-09,18:00:00,176,100,76,FMN GV 05 Lier
60,Mechelsesteenweg 365,2022-06-09,19:00:00,158,104,54,FMN GV 05 Lier
60,Mechelsesteenweg 365,2022-06-09,20:00:00,264,80,184,FMN GV 05 Lier
60,Mechelsesteenweg 365,2022-06-09,21:00:00,72,44,28,FMN GV 05 Lier
60,Mechelsesteenweg 365,2022-06-09,22:00:00,10,8,2,FMN GV 05 Lier
60,Mechelsesteenweg 365,2022-06-09,23:00:00,4,2,2,FMN GV 05 Lier
60,Mechelsesteenweg 365,2022-06-10,00:00:00,4,4,0,FMN GV 05 Lier
60,Mechelsesteenweg 365,2022-06-10,01:00:00,0,0,0,FMN GV 05 Lier
60,Mechelsesteenweg 365,2022-06-10,02:00:00,0,0,0,FMN GV 05 Lier
60,Mechelsesteenweg 365,2022-06-10,03:00:00,0,0,0,FMN GV 05 Lier
60,Mechelsesteenweg 365,2022-06-10,04:00:00,0,0,0,FMN GV 05 Lier
60,Mechelsesteenweg 365,2022-06-10,05:00:00,12,2,10,FMN GV 05 Lier
60,Mechelsesteenweg 365,2022-06-10,06:00:00,48,16,32,FMN GV 05 Lier
60,Mechelsesteenweg 365,2022-06-10,07:00:00,156,74,82,FMN GV 05 Lier
60,Mechelsesteenweg 365,2022-06-10,08:00:00,156,92,64,FMN GV 05 Lier
60,Mechelsesteenweg 365,2022-06-10,09:00:00,68,22,46,FMN GV 05 Lier
60,Mechelsesteenweg 365,2022-06-10,10:00:00,168,102,66,FMN GV 05 Lier
60,Mechelsesteenweg 365,2022-06-10,11:00:00,100,52,48,FMN GV 05 Lier
60,Mechelsesteenweg 365,2022-06-10,12:00:00,48,30,18,FMN GV 05 Lier
60,Mechelsesteenweg 365,2022-06-10,13:00:00,30,14,16,FMN GV 05 Lier
60,Mechelsesteenweg 365,2022-06-10,14:00:00,182,98,84,FMN GV 05 Lier
60,Mechelsesteenweg 365,2022-06-10,15:00:00,164,76,88,FMN GV 05 Lier
60,Mechelsesteenweg 365,2022-06-10,16:00:00,222,88,134,FMN GV 05 Lier
60,Mechelsesteenweg 365,2022-06-10,17:00:00,144,96,48,FMN GV 05 Lier
60,Mechelsesteenweg 365,2022-06-10,18:00:00,82,40,42,FMN GV 05 Lier
60,Mechelsesteenweg 365,2022-06-10,19:00:00,78,62,16,FMN GV 05 Lier
60,Mechelsesteenweg 365,2022-06-10,20:00:00,92,58,34,FMN GV 05 Lier
60,Mechelsesteenweg 365,2022-06-10,21:00:00,32,8,24,FMN GV 05 Lier
60,Mechelsesteenweg 365,2022-06-10,22:00:00,16,14,2,FMN GV 05 Lier
60,Mechelsesteenweg 365,2022-06-10,23:00:00,12,6,6,FMN GV 05 Lier
60,Mechelsesteenweg 365,2022-06-11,00:00:00,6,2,4,FMN GV 05 Lier
60,Mechelsesteenweg 365,2022-06-11,01:00:00,6,4,2,FMN GV 05 Lier
60,Mechelsesteenweg 365,2022-06-11,02:00:00,0,0,0,FMN GV 05 Lier
60,Mechelsesteenweg 365,2022-06-11,03:00:00,8,0,8,FMN GV 05 Lier
60,Mechelsesteenweg 365,2022-06-11,04:00:00,0,0,0,FMN GV 05 Lier
60,Mechelsesteenweg 365,2022-06-11,05:00:00,2,0,2,FMN GV 05 Lier
60,Mechelsesteenweg 365,2022-06-11,06:00:00,8,4,4,FMN GV 05 Lier
60,Mechelsesteenweg 365,2022-06-11,07:00:00,28,8,20,FMN GV 05 Lier
60,Mechelsesteenweg 365,2022-06-11,08:00:00,44,26,18,FMN GV 05 Lier
60,Mechelsesteenweg 365,2022-06-11,09:00:00,136,70,66,FMN GV 05 Lier
60,Mechelsesteenweg 365,2022-06-11,10:00:00,232,118,114,FMN GV 05 Lier
60,Mechelsesteenweg 365,2022-06-11,11:00:00,68,32,36,FMN GV 05 Lier
60,Mechelsesteenweg 365,2022-06-11,12:00:00,0,0,0,FMN GV 05 Lier
60,Mechelsesteenweg 365,2022-06-11,13:00:00,0,0,0,FMN GV 05 Lier
60,Mechelsesteenweg 365,2022-06-11,14:00:00,0,0,0,FMN GV 05 Lier
60,Mechelsesteenweg 365,2022-06-11,15:00:00,0,0,0,FMN GV 05 Lier
60,Mechelsesteenweg 365,2022-06-11,16:00:00,2,0,2,FMN GV 05 Lier
60,Mechelsesteenweg 365,2022-06-11,17:00:00,6,0,6,FMN GV 05 Lier
60,Mechelsesteenweg 365,2022-06-11,18:00:00,48,28,20,FMN GV 05 Lier
60,Mechelsesteenweg 365,2022-06-11,19:00:00,88,46,42,FMN GV 05 Lier
60,Mechelsesteenweg 365,2022-06-11,20:00:00,74,20,54,FMN GV 05 Lier
60,Mechelsesteenweg 365,2022-06-11,21:00:00,36,12,24,FMN GV 05 Lier
60,Mechelsesteenweg 365,2022-06-11,22:00:00,12,2,10,FMN GV 05 Lier
60,Mechelsesteenweg 365,2022-06-11,23:00:00,12,4,8,FMN GV 05 Lier
60,Mechelsesteenweg 365,2022-06-12,00:00:00,8,8,0,FMN GV 05 Lier
60,Mechelsesteenweg 365,2022-06-12,01:00:00,4,4,0,FMN GV 05 Lier
60,Mechelsesteenweg 365,2022-06-12,02:00:00,0,0,0,FMN GV 05 Lier
60,Mechelsesteenweg 365,2022-06-12,03:00:00,0,0,0,FMN GV 05 Lier
60,Mechelsesteenweg 365,2022-06-12,04:00:00,0,0,0,FMN GV 05 Lier
60,Mechelsesteenweg 365,2022-06-12,05:00:00,0,0,0,FMN GV 05 Lier
60,Mechelsesteenweg 365,2022-06-12,06:00:00,10,2,8,FMN GV 05 Lier
60,Mechelsesteenweg 365,2022-06-12,07:00:00,28,8,20,FMN GV 05 Lier
60,Mechelsesteenweg 365,2022-06-12,08:00:00,62,28,34,FMN GV 05 Lier
60,Mechelsesteenweg 365,2022-06-12,09:00:00,276,142,134,FMN GV 05 Lier
60,Mechelsesteenweg 365,2022-06-12,10:00:00,306,168,138,FMN GV 05 Lier
60,Mechelsesteenweg 365,2022-06-12,11:00:00,58,32,26,FMN GV 05 Lier
60,Mechelsesteenweg 365,2022-06-12,12:00:00,12,0,12,FMN GV 05 Lier
60,Mechelsesteenweg 365,2022-06-12,13:00:00,0,0,0,FMN GV 05 Lier
60,Mechelsesteenweg 365,2022-06-12,14:00:00,0,0,0,FMN GV 05 Lier
60,Mechelsesteenweg 365,2022-06-12,15:00:00,0,0,0,FMN GV 05 Lier
60,Mechelsesteenweg 365,2022-06-12,16:00:00,0,0,0,FMN GV 05 Lier
60,Mechelsesteenweg 365,2022-06-12,17:00:00,4,0,4,FMN GV 05 Lier
60,Mechelsesteenweg 365,2022-06-12,18:00:00,16,2,14,FMN GV 05 Lier
60,Mechelsesteenweg 365,2022-06-12,19:00:00,72,28,44,FMN GV 05 Lier
60,Mechelsesteenweg 365,2022-06-12,20:00:00,60,26,34,FMN GV 05 Lier
60,Mechelsesteenweg 365,2022-06-12,21:00:00,28,8,20,FMN GV 05 Lier
60,Mechelsesteenweg 365,2022-06-12,22:00:00,4,2,2,FMN GV 05 Lier
60,Mechelsesteenweg 365,2022-06-12,23:00:00,2,2,0,FMN GV 05 Lier
60,Mechelsesteenweg 365,2022-06-13,00:00:00,0,0,0,FMN GV 05 Lier
60,Mechelsesteenweg 365,2022-06-13,01:00:00,0,0,0,FMN GV 05 Lier
60,Mechelsesteenweg 365,2022-06-13,02:00:00,0,0,0,FMN GV 05 Lier
60,Mechelsesteenweg 365,2022-06-13,03:00:00,0,0,0,FMN GV 05 Lier
60,Mechelsesteenweg 365,2022-06-13,04:00:00,4,0,4,FMN GV 05 Lier
60,Mechelsesteenweg 365,2022-06-13,05:00:00,8,2,6,FMN GV 05 Lier
60,Mechelsesteenweg 365,2022-06-13,06:00:00,42,16,26,FMN GV 05 Lier
60,Mechelsesteenweg 365,2022-06-13,07:00:00,196,100,96,FMN GV 05 Lier
60,Mechelsesteenweg 365,2022-06-13,08:00:00,170,100,70,FMN GV 05 Lier
60,Mechelsesteenweg 365,2022-06-13,09:00:00,74,38,36,FMN GV 05 Lier
60,Mechelsesteenweg 365,2022-06-13,10:00:00,94,44,50,FMN GV 05 Lier
60,Mechelsesteenweg 365,2022-06-13,11:00:00,94,28,66,FMN GV 05 Lier
60,Mechelsesteenweg 365,2022-06-13,12:00:00,76,36,40,FMN GV 05 Lier
60,Mechelsesteenweg 365,2022-06-13,13:00:00,2,0,2,FMN GV 05 Lier
60,Mechelsesteenweg 365,2022-06-13,14:00:00,2,0,2,FMN GV 05 Lier
60,Mechelsesteenweg 365,2022-06-13,15:00:00,0,0,0,FMN GV 05 Lier
60,Mechelsesteenweg 365,2022-06-13,16:00:00,26,8,18,FMN GV 05 Lier
60,Mechelsesteenweg 365,2022-06-13,17:00:00,0,0,0,FMN GV 05 Lier
60,Mechelsesteenweg 365,2022-06-13,18:00:00,44,24,20,FMN GV 05 Lier
60,Mechelsesteenweg 365,2022-06-13,19:00:00,88,54,34,FMN GV 05 Lier
60,Mechelsesteenweg 365,2022-06-13,20:00:00,98,44,54,FMN GV 05 Lier
60,Mechelsesteenweg 365,2022-06-13,21:00:00,42,24,18,FMN GV 05 Lier
60,Mechelsesteenweg 365,2022-06-13,22:00:00,14,10,4,FMN GV 05 Lier
60,Mechelsesteenweg 365,2022-06-13,23:00:00,0,0,0,FMN GV 05 Lier
60,Mechelsesteenweg 365,2022-06-14,00:00:00,0,0,0,FMN GV 05 Lier
60,Mechelsesteenweg 365,2022-06-14,01:00:00,0,0,0,FMN GV 05 Lier
60,Mechelsesteenweg 365,2022-06-14,02:00:00,0,0,0,FMN GV 05 Lier
60,Mechelsesteenweg 365,2022-06-14,03:00:00,0,0,0,FMN GV 05 Lier
60,Mechelsesteenweg 365,2022-06-14,04:00:00,4,0,4,FMN GV 05 Lier
60,Mechelsesteenweg 365,2022-06-14,05:00:00,8,2,6,FMN GV 05 Lier
60,Mechelsesteenweg 365,2022-06-14,06:00:00,42,12,30,FMN GV 05 Lier
60,Mechelsesteenweg 365,2022-06-14,07:00:00,198,88,110,FMN GV 05 Lier
60,Mechelsesteenweg 365,2022-06-14,08:00:00,178,96,82,FMN GV 05 Lier
60,Mechelsesteenweg 365,2022-06-14,09:00:00,144,68,76,FMN GV 05 Lier
60,Mechelsesteenweg 365,2022-06-14,10:00:00,148,44,104,FMN GV 05 Lier
60,Mechelsesteenweg 365,2022-06-14,11:00:00,0,0,0,FMN GV 05 Lier
60,Mechelsesteenweg 365,2022-06-14,12:00:00,0,0,0,FMN GV 05 Lier
60,Mechelsesteenweg 365,2022-06-14,13:00:00,0,0,0,FMN GV 05 Lier
60,Mechelsesteenweg 365,2022-06-14,14:00:00,0,0,0,FMN GV 05 Lier
60,Mechelsesteenweg 365,2022-06-14,15:00:00,0,0,0,FMN GV 05 Lier
60,Mechelsesteenweg 365,2022-06-14,16:00:00,0,0,0,FMN GV 05 Lier
60,Mechelsesteenweg 365,2022-06-14,17:00:00,0,0,0,FMN GV 05 Lier
60,Mechelsesteenweg 365,2022-06-14,18:00:00,0,0,0,FMN GV 05 Lier
60,Mechelsesteenweg 365,2022-06-14,19:00:00,68,30,38,FMN GV 05 Lier
60,Mechelsesteenweg 365,2022-06-14,20:00:00,142,78,64,FMN GV 05 Lier
60,Mechelsesteenweg 365,2022-06-14,21:00:00,58,28,30,FMN GV 05 Lier
60,Mechelsesteenweg 365,2022-06-14,22:00:00,20,8,12,FMN GV 05 Lier
60,Mechelsesteenweg 365,2022-06-14,23:00:00,4,2,2,FMN GV 05 Lier
60,Mechelsesteenweg 365,2022-06-15,00:00:00,0,0,0,FMN GV 05 Lier
60,Mechelsesteenweg 365,2022-06-15,01:00:00,0,0,0,FMN GV 05 Lier
60,Mechelsesteenweg 365,2022-06-15,02:00:00,0,0,0,FMN GV 05 Lier
60,Mechelsesteenweg 365,2022-06-15,03:00:00,0,0,0,FMN GV 05 Lier
60,Mechelsesteenweg 365,2022-06-15,04:00:00,0,0,0,FMN GV 05 Lier
60,Mechelsesteenweg 365,2022-06-15,05:00:00,8,2,6,FMN GV 05 Lier
60,Mechelsesteenweg 365,2022-06-15,06:00:00,50,12,38,FMN GV 05 Lier
60,Mechelsesteenweg 365,2022-06-15,07:00:00,156,92,64,FMN GV 05 Lier
60,Mechelsesteenweg 365,2022-06-15,08:00:00,204,118,86,FMN GV 05 Lier
60,Mechelsesteenweg 365,2022-06-15,09:00:00,100,44,56,FMN GV 05 Lier
60,Mechelsesteenweg 365,2022-06-15,10:00:00,66,28,38,FMN GV 05 Lier
60,Mechelsesteenweg 365,2022-06-15,11:00:00,0,0,0,FMN GV 05 Lier
60,Mechelsesteenweg 365,2022-06-15,12:00:00,0,0,0,FMN GV 05 Lier
60,Mechelsesteenweg 365,2022-06-15,13:00:00,0,0,0,FMN GV 05 Lier
60,Mechelsesteenweg 365,2022-06-15,14:00:00,0,0,0,FMN GV 05 Lier
60,Mechelsesteenweg 365,2022-06-15,15:00:00,0,0,0,FMN GV 05 Lier
60,Mechelsesteenweg 365,2022-06-15,16:00:00,0,0,0,FMN GV 05 Lier
60,Mechelsesteenweg 365,2022-06-15,17:00:00,0,0,0,FMN GV 05 Lier
60,Mechelsesteenweg 365,2022-06-15,18:00:00,16,8,8,FMN GV 05 Lier
60,Mechelsesteenweg 365,2022-06-15,19:00:00,106,38,68,FMN GV 05 Lier
60,Mechelsesteenweg 365,2022-06-15,20:00:00,238,130,108,FMN GV 05 Lier
60,Mechelsesteenweg 365,2022-06-15,21:00:00,78,38,40,FMN GV 05 Lier
60,Mechelsesteenweg 365,2022-06-15,22:00:00,28,20,8,FMN GV 05 Lier
60,Mechelsesteenweg 365,2022-06-15,23:00:00,2,0,2,FMN GV 05 Lier
60,Mechelsesteenweg 365,2022-06-16,00:00:00,0,0,0,FMN GV 05 Lier
60,Mechelsesteenweg 365,2022-06-16,01:00:00,0,0,0,FMN GV 05 Lier
60,Mechelsesteenweg 365,2022-06-16,02:00:00,0,0,0,FMN GV 05 Lier
60,Mechelsesteenweg 365,2022-06-16,03:00:00,0,0,0,FMN GV 05 Lier
60,Mechelsesteenweg 365,2022-06-16,04:00:00,2,2,0,FMN GV 05 Lier
60,Mechelsesteenweg 365,2022-06-16,05:00:00,6,0,6,FMN GV 05 Lier
60,Mechelsesteenweg 365,2022-06-16,06:00:00,52,18,34,FMN GV 05 Lier
60,Mechelsesteenweg 365,2022-06-16,07:00:00,174,88,86,FMN GV 05 Lier
60,Mechelsesteenweg 365,2022-06-16,08:00:00,222,122,100,FMN GV 05 Lier
60,Mechelsesteenweg 365,2022-06-16,09:00:00,174,96,78,FMN GV 05 Lier
60,Mechelsesteenweg 365,2022-06-16,10:00:00,50,20,30,FMN GV 05 Lier
60,Mechelsesteenweg 365,2022-06-16,11:00:00,0,0,0,FMN GV 05 Lier
60,Mechelsesteenweg 365,2022-06-16,12:00:00,0,0,0,FMN GV 05 Lier
60,Mechelsesteenweg 365,2022-06-16,13:00:00,0,0,0,FMN GV 05 Lier
60,Mechelsesteenweg 365,2022-06-16,14:00:00,0,0,0,FMN GV 05 Lier
60,Mechelsesteenweg 365,2022-06-16,15:00:00,0,0,0,FMN GV 05 Lier
60,Mechelsesteenweg 365,2022-06-16,16:00:00,0,0,0,FMN GV 05 Lier
60,Mechelsesteenweg 365,2022-06-16,17:00:00,0,0,0,FMN GV 05 Lier
60,Mechelsesteenweg 365,2022-06-16,18:00:00,0,0,0,FMN GV 05 Lier
60,Mechelsesteenweg 365,2022-06-16,19:00:00,70,22,48,FMN GV 05 Lier
60,Mechelsesteenweg 365,2022-06-16,20:00:00,186,46,140,FMN GV 05 Lier
60,Mechelsesteenweg 365,2022-06-16,21:00:00,136,52,84,FMN GV 05 Lier
60,Mechelsesteenweg 365,2022-06-16,22:00:00,34,22,12,FMN GV 05 Lier
60,Mechelsesteenweg 365,2022-06-16,23:00:00,8,6,2,FMN GV 05 Lier
60,Mechelsesteenweg 365,2022-06-17,00:00:00,0,0,0,FMN GV 05 Lier
60,Mechelsesteenweg 365,2022-06-17,01:00:00,2,2,0,FMN GV 05 Lier
60,Mechelsesteenweg 365,2022-06-17,02:00:00,2,0,2,FMN GV 05 Lier
60,Mechelsesteenweg 365,2022-06-17,03:00:00,0,0,0,FMN GV 05 Lier
60,Mechelsesteenweg 365,2022-06-17,04:00:00,2,2,0,FMN GV 05 Lier
60,Mechelsesteenweg 365,2022-06-17,05:00:00,4,0,4,FMN GV 05 Lier
60,Mechelsesteenweg 365,2022-06-17,06:00:00,42,16,26,FMN GV 05 Lier
60,Mechelsesteenweg 365,2022-06-17,07:00:00,156,90,66,FMN GV 05 Lier
60,Mechelsesteenweg 365,2022-06-17,08:00:00,146,76,70,FMN GV 05 Lier
60,Mechelsesteenweg 365,2022-06-17,09:00:00,136,64,72,FMN GV 05 Lier
60,Mechelsesteenweg 365,2022-06-17,10:00:00,32,10,22,FMN GV 05 Lier
60,Mechelsesteenweg 365,2022-06-17,11:00:00,0,0,0,FMN GV 05 Lier
60,Mechelsesteenweg 365,2022-06-17,12:00:00,0,0,0,FMN GV 05 Lier
60,Mechelsesteenweg 365,2022-06-17,13:00:00,0,0,0,FMN GV 05 Lier
60,Mechelsesteenweg 365,2022-06-17,14:00:00,0,0,0,FMN GV 05 Lier
60,Mechelsesteenweg 365,2022-06-17,15:00:00,0,0,0,FMN GV 05 Lier
60,Mechelsesteenweg 365,2022-06-17,16:00:00,0,0,0,FMN GV 05 Lier
60,Mechelsesteenweg 365,2022-06-17,17:00:00,0,0,0,FMN GV 05 Lier
60,Mechelsesteenweg 365,2022-06-17,18:00:00,0,0,0,FMN GV 05 Lier
60,Mechelsesteenweg 365,2022-06-17,19:00:00,14,6,8,FMN GV 05 Lier
60,Mechelsesteenweg 365,2022-06-17,20:00:00,84,40,44,FMN GV 05 Lier
60,Mechelsesteenweg 365,2022-06-17,21:00:00,82,36,46,FMN GV 05 Lier
60,Mechelsesteenweg 365,2022-06-17,22:00:00,52,24,28,FMN GV 05 Lier
60,Mechelsesteenweg 365,2022-06-17,23:00:00,22,10,12,FMN GV 05 Lier
60,Mechelsesteenweg 365,2022-06-18,00:00:00,16,2,14,FMN GV 05 Lier
60,Mechelsesteenweg 365,2022-06-18,01:00:00,6,2,4,FMN GV 05 Lier
60,Mechelsesteenweg 365,2022-06-18,02:00:00,0,0,0,FMN GV 05 Lier
60,Mechelsesteenweg 365,2022-06-18,03:00:00,0,0,0,FMN GV 05 Lier
60,Mechelsesteenweg 365,2022-06-18,04:00:00,0,0,0,FMN GV 05 Lier
60,Mechelsesteenweg 365,2022-06-18,05:00:00,2,0,2,FMN GV 05 Lier
60,Mechelsesteenweg 365,2022-06-18,06:00:00,22,12,10,FMN GV 05 Lier
60,Mechelsesteenweg 365,2022-06-18,07:00:00,62,34,28,FMN GV 05 Lier
60,Mechelsesteenweg 365,2022-06-18,08:00:00,98,54,44,FMN GV 05 Lier
60,Mechelsesteenweg 365,2022-06-18,09:00:00,152,72,80,FMN GV 05 Lier
60,Mechelsesteenweg 365,2022-06-18,10:00:00,136,68,68,FMN GV 05 Lier
60,Mechelsesteenweg 365,2022-06-18,11:00:00,0,0,0,FMN GV 05 Lier
60,Mechelsesteenweg 365,2022-06-18,12:00:00,0,0,0,FMN GV 05 Lier
60,Mechelsesteenweg 365,2022-06-18,13:00:00,0,0,0,FMN GV 05 Lier
60,Mechelsesteenweg 365,2022-06-18,14:00:00,0,0,0,FMN GV 05 Lier
60,Mechelsesteenweg 365,2022-06-18,15:00:00,0,0,0,FMN GV 05 Lier
60,Mechelsesteenweg 365,2022-06-18,16:00:00,0,0,0,FMN GV 05 Lier
60,Mechelsesteenweg 365,2022-06-18,17:00:00,0,0,0,FMN GV 05 Lier
60,Mechelsesteenweg 365,2022-06-18,18:00:00,0,0,0,FMN GV 05 Lier
60,Mechelsesteenweg 365,2022-06-18,19:00:00,24,18,6,FMN GV 05 Lier
60,Mechelsesteenweg 365,2022-06-18,20:00:00,56,18,38,FMN GV 05 Lier
60,Mechelsesteenweg 365,2022-06-18,21:00:00,32,16,16,FMN GV 05 Lier
60,Mechelsesteenweg 365,2022-06-18,22:00:00,12,10,2,FMN GV 05 Lier
60,Mechelsesteenweg 365,2022-06-18,23:00:00,6,2,4,FMN GV 05 Lier
60,Mechelsesteenweg 365,2022-06-19,00:00:00,2,2,0,FMN GV 05 Lier
60,Mechelsesteenweg 365,2022-06-19,01:00:00,0,0,0,FMN GV 05 Lier
60,Mechelsesteenweg 365,2022-06-19,02:00:00,2,0,2,FMN GV 05 Lier
60,Mechelsesteenweg 365,2022-06-19,03:00:00,0,0,0,FMN GV 05 Lier
60,Mechelsesteenweg 365,2022-06-19,04:00:00,6,0,6,FMN GV 05 Lier
60,Mechelsesteenweg 365,2022-06-19,05:00:00,2,0,2,FMN GV 05 Lier
60,Mechelsesteenweg 365,2022-06-19,06:00:00,2,0,2,FMN GV 05 Lier
60,Mechelsesteenweg 365,2022-06-19,07:00:00,8,6,2,FMN GV 05 Lier
60,Mechelsesteenweg 365,2022-06-19,08:00:00,10,8,2,FMN GV 05 Lier
60,Mechelsesteenweg 365,2022-06-19,09:00:00,18,12,6,FMN GV 05 Lier
60,Mechelsesteenweg 365,2022-06-19,10:00:00,54,16,38,FMN GV 05 Lier
60,Mechelsesteenweg 365,2022-06-19,11:00:00,64,32,32,FMN GV 05 Lier
60,Mechelsesteenweg 365,2022-06-19,12:00:00,104,48,56,FMN GV 05 Lier
60,Mechelsesteenweg 365,2022-06-19,13:00:00,124,62,62,FMN GV 05 Lier
60,Mechelsesteenweg 365,2022-06-19,14:00:00,110,56,54,FMN GV 05 Lier
60,Mechelsesteenweg 365,2022-06-19,15:00:00,122,58,64,FMN GV 05 Lier
60,Mechelsesteenweg 365,2022-06-19,16:00:00,90,46,44,FMN GV 05 Lier
60,Mechelsesteenweg 365,2022-06-19,17:00:00,112,30,82,FMN GV 05 Lier
60,Mechelsesteenweg 365,2022-06-19,18:00:00,32,18,14,FMN GV 05 Lier
60,Mechelsesteenweg 365,2022-06-19,19:00:00,22,4,18,FMN GV 05 Lier
60,Mechelsesteenweg 365,2022-06-19,20:00:00,34,14,20,FMN GV 05 Lier
60,Mechelsesteenweg 365,2022-06-19,21:00:00,6,2,4,FMN GV 05 Lier
60,Mechelsesteenweg 365,2022-06-19,22:00:00,6,4,2,FMN GV 05 Lier
60,Mechelsesteenweg 365,2022-06-19,23:00:00,0,0,0,FMN GV 05 Lier
60,Mechelsesteenweg 365,2022-06-20,00:00:00,0,0,0,FMN GV 05 Lier
60,Mechelsesteenweg 365,2022-06-20,01:00:00,0,0,0,FMN GV 05 Lier
60,Mechelsesteenweg 365,2022-06-20,02:00:00,0,0,0,FMN GV 05 Lier
60,Mechelsesteenweg 365,2022-06-20,03:00:00,0,0,0,FMN GV 05 Lier
60,Mechelsesteenweg 365,2022-06-20,04:00:00,0,0,0,FMN GV 05 Lier
60,Mechelsesteenweg 365,2022-06-20,05:00:00,4,0,4,FMN GV 05 Lier
60,Mechelsesteenweg 365,2022-06-20,06:00:00,40,10,30,FMN GV 05 Lier
60,Mechelsesteenweg 365,2022-06-20,07:00:00,138,72,66,FMN GV 05 Lier
60,Mechelsesteenweg 365,2022-06-20,08:00:00,108,50,58,FMN GV 05 Lier
60,Mechelsesteenweg 365,2022-06-20,09:00:00,102,42,60,FMN GV 05 Lier
60,Mechelsesteenweg 365,2022-06-20,10:00:00,112,50,62,FMN GV 05 Lier
60,Mechelsesteenweg 365,2022-06-20,11:00:00,68,22,46,FMN GV 05 Lier
60,Mechelsesteenweg 365,2022-06-20,12:00:00,64,42,22,FMN GV 05 Lier
60,Mechelsesteenweg 365,2022-06-20,13:00:00,18,8,10,FMN GV 05 Lier
60,Mechelsesteenweg 365,2022-06-20,14:00:00,0,0,0,FMN GV 05 Lier
60,Mechelsesteenweg 365,2022-06-20,15:00:00,0,0,0,FMN GV 05 Lier
60,Mechelsesteenweg 365,2022-06-20,16:00:00,2,0,2,FMN GV 05 Lier
60,Mechelsesteenweg 365,2022-06-20,17:00:00,0,0,0,FMN GV 05 Lier
60,Mechelsesteenweg 365,2022-06-20,18:00:00,8,4,4,FMN GV 05 Lier
60,Mechelsesteenweg 365,2022-06-20,19:00:00,92,52,40,FMN GV 05 Lier
60,Mechelsesteenweg 365,2022-06-20,20:00:00,108,50,58,FMN GV 05 Lier
60,Mechelsesteenweg 365,2022-06-20,21:00:00,58,16,42,FMN GV 05 Lier
60,Mechelsesteenweg 365,2022-06-20,22:00:00,14,6,8,FMN GV 05 Lier
60,Mechelsesteenweg 365,2022-06-20,23:00:00,0,0,0,FMN GV 05 Lier
60,Mechelsesteenweg 365,2022-06-21,00:00:00,0,0,0,FMN GV 05 Lier
60,Mechelsesteenweg 365,2022-06-21,01:00:00,0,0,0,FMN GV 05 Lier
60,Mechelsesteenweg 365,2022-06-21,02:00:00,0,0,0,FMN GV 05 Lier
60,Mechelsesteenweg 365,2022-06-21,03:00:00,0,0,0,FMN GV 05 Lier
60,Mechelsesteenweg 365,2022-06-21,04:00:00,2,0,2,FMN GV 05 Lier
60,Mechelsesteenweg 365,2022-06-21,05:00:00,8,0,8,FMN GV 05 Lier
60,Mechelsesteenweg 365,2022-06-21,06:00:00,50,18,32,FMN GV 05 Lier
60,Mechelsesteenweg 365,2022-06-21,07:00:00,152,70,82,FMN GV 05 Lier
60,Mechelsesteenweg 365,2022-06-21,08:00:00,178,88,90,FMN GV 05 Lier
60,Mechelsesteenweg 365,2022-06-21,09:00:00,128,54,74,FMN GV 05 Lier
60,Mechelsesteenweg 365,2022-06-21,10:00:00,210,76,134,FMN GV 05 Lier
60,Mechelsesteenweg 365,2022-06-21,11:00:00,168,100,68,FMN GV 05 Lier
60,Mechelsesteenweg 365,2022-06-21,12:00:00,150,84,66,FMN GV 05 Lier
60,Mechelsesteenweg 365,2022-06-21,13:00:00,116,48,68,FMN GV 05 Lier
60,Mechelsesteenweg 365,2022-06-21,14:00:00,128,76,52,FMN GV 05 Lier
60,Mechelsesteenweg 365,2022-06-21,15:00:00,152,56,96,FMN GV 05 Lier
60,Mechelsesteenweg 365,2022-06-21,16:00:00,126,74,52,FMN GV 05 Lier
60,Mechelsesteenweg 365,2022-06-21,17:00:00,94,60,34,FMN GV 05 Lier
60,Mechelsesteenweg 365,2022-06-21,18:00:00,144,72,72,FMN GV 05 Lier
60,Mechelsesteenweg 365,2022-06-21,19:00:00,120,66,54,FMN GV 05 Lier
60,Mechelsesteenweg 365,2022-06-21,20:00:00,180,82,98,FMN GV 05 Lier
60,Mechelsesteenweg 365,2022-06-21,21:00:00,60,20,40,FMN GV 05 Lier
60,Mechelsesteenweg 365,2022-06-21,22:00:00,32,24,8,FMN GV 05 Lier
60,Mechelsesteenweg 365,2022-06-21,23:00:00,4,2,2,FMN GV 05 Lier
60,Mechelsesteenweg 365,2022-06-22,00:00:00,0,0,0,FMN GV 05 Lier
60,Mechelsesteenweg 365,2022-06-22,01:00:00,2,2,0,FMN GV 05 Lier
60,Mechelsesteenweg 365,2022-06-22,02:00:00,0,0,0,FMN GV 05 Lier
60,Mechelsesteenweg 365,2022-06-22,03:00:00,0,0,0,FMN GV 05 Lier
60,Mechelsesteenweg 365,2022-06-22,04:00:00,2,0,2,FMN GV 05 Lier
60,Mechelsesteenweg 365,2022-06-22,05:00:00,8,2,6,FMN GV 05 Lier
60,Mechelsesteenweg 365,2022-06-22,06:00:00,36,12,24,FMN GV 05 Lier
60,Mechelsesteenweg 365,2022-06-22,07:00:00,160,74,86,FMN GV 05 Lier
60,Mechelsesteenweg 365,2022-06-22,08:00:00,144,84,60,FMN GV 05 Lier
60,Mechelsesteenweg 365,2022-06-22,09:00:00,110,46,64,FMN GV 05 Lier
60,Mechelsesteenweg 365,2022-06-22,10:00:00,142,64,78,FMN GV 05 Lier
60,Mechelsesteenweg 365,2022-06-22,11:00:00,4,0,4,FMN GV 05 Lier
60,Mechelsesteenweg 365,2022-06-22,12:00:00,0,0,0,FMN GV 05 Lier
60,Mechelsesteenweg 365,2022-06-22,13:00:00,0,0,0,FMN GV 05 Lier
60,Mechelsesteenweg 365,2022-06-22,14:00:00,0,0,0,FMN GV 05 Lier
60,Mechelsesteenweg 365,2022-06-22,15:00:00,0,0,0,FMN GV 05 Lier
60,Mechelsesteenweg 365,2022-06-22,16:00:00,0,0,0,FMN GV 05 Lier
60,Mechelsesteenweg 365,2022-06-22,17:00:00,0,0,0,FMN GV 05 Lier
60,Mechelsesteenweg 365,2022-06-22,18:00:00,0,0,0,FMN GV 05 Lier
60,Mechelsesteenweg 365,2022-06-22,19:00:00,102,52,50,FMN GV 05 Lier
60,Mechelsesteenweg 365,2022-06-22,20:00:00,252,144,108,FMN GV 05 Lier
60,Mechelsesteenweg 365,2022-06-22,21:00:00,126,28,98,FMN GV 05 Lier
60,Mechelsesteenweg 365,2022-06-22,22:00:00,38,8,30,FMN GV 05 Lier
60,Mechelsesteenweg 365,2022-06-22,23:00:00,6,4,2,FMN GV 05 Lier
60,Mechelsesteenweg 365,2022-06-23,00:00:00,4,4,0,FMN GV 05 Lier
60,Mechelsesteenweg 365,2022-06-23,01:00:00,2,0,2,FMN GV 05 Lier
60,Mechelsesteenweg 365,2022-06-23,02:00:00,0,0,0,FMN GV 05 Lier
60,Mechelsesteenweg 365,2022-06-23,03:00:00,4,0,4,FMN GV 05 Lier
60,Mechelsesteenweg 365,2022-06-23,04:00:00,4,0,4,FMN GV 05 Lier
60,Mechelsesteenweg 365,2022-06-23,05:00:00,8,2,6,FMN GV 05 Lier
60,Mechelsesteenweg 365,2022-06-23,06:00:00,38,14,24,FMN GV 05 Lier
60,Mechelsesteenweg 365,2022-06-23,07:00:00,134,68,66,FMN GV 05 Lier
60,Mechelsesteenweg 365,2022-06-23,08:00:00,104,64,40,FMN GV 05 Lier
60,Mechelsesteenweg 365,2022-06-23,09:00:00,122,72,50,FMN GV 05 Lier
60,Mechelsesteenweg 365,2022-06-23,10:00:00,96,44,52,FMN GV 05 Lier
60,Mechelsesteenweg 365,2022-06-23,11:00:00,48,12,36,FMN GV 05 Lier
60,Mechelsesteenweg 365,2022-06-23,12:00:00,0,0,0,FMN GV 05 Lier
60,Mechelsesteenweg 365,2022-06-23,13:00:00,0,0,0,FMN GV 05 Lier
60,Mechelsesteenweg 365,2022-06-23,14:00:00,0,0,0,FMN GV 05 Lier
60,Mechelsesteenweg 365,2022-06-23,15:00:00,0,0,0,FMN GV 05 Lier
60,Mechelsesteenweg 365,2022-06-23,16:00:00,0,0,0,FMN GV 05 Lier
60,Mechelsesteenweg 365,2022-06-23,17:00:00,0,0,0,FMN GV 05 Lier
60,Mechelsesteenweg 365,2022-06-23,18:00:00,0,0,0,FMN GV 05 Lier
60,Mechelsesteenweg 365,2022-06-23,19:00:00,36,18,18,FMN GV 05 Lier
60,Mechelsesteenweg 365,2022-06-23,20:00:00,178,48,130,FMN GV 05 Lier
60,Mechelsesteenweg 365,2022-06-23,21:00:00,52,22,30,FMN GV 05 Lier
60,Mechelsesteenweg 365,2022-06-23,22:00:00,28,14,14,FMN GV 05 Lier
60,Mechelsesteenweg 365,2022-06-23,23:00:00,12,8,4,FMN GV 05 Lier
60,Mechelsesteenweg 365,2022-06-24,00:00:00,2,0,2,FMN GV 05 Lier
60,Mechelsesteenweg 365,2022-06-24,01:00:00,0,0,0,FMN GV 05 Lier
60,Mechelsesteenweg 365,2022-06-24,02:00:00,0,0,0,FMN GV 05 Lier
60,Mechelsesteenweg 365,2022-06-24,03:00:00,0,0,0,FMN GV 05 Lier
60,Mechelsesteenweg 365,2022-06-24,04:00:00,0,0,0,FMN GV 05 Lier
60,Mechelsesteenweg 365,2022-06-24,05:00:00,4,2,2,FMN GV 05 Lier
60,Mechelsesteenweg 365,2022-06-24,06:00:00,16,6,10,FMN GV 05 Lier
60,Mechelsesteenweg 365,2022-06-24,07:00:00,20,6,14,FMN GV 05 Lier
60,Mechelsesteenweg 365,2022-06-24,08:00:00,30,14,16,FMN GV 05 Lier
60,Mechelsesteenweg 365,2022-06-24,09:00:00,26,12,14,FMN GV 05 Lier
60,Mechelsesteenweg 365,2022-06-24,10:00:00,44,18,26,FMN GV 05 Lier
60,Mechelsesteenweg 365,2022-06-24,11:00:00,18,6,12,FMN GV 05 Lier
60,Mechelsesteenweg 365,2022-06-24,12:00:00,40,16,24,FMN GV 05 Lier
60,Mechelsesteenweg 365,2022-06-24,13:00:00,18,4,14,FMN GV 05 Lier
60,Mechelsesteenweg 365,2022-06-24,14:00:00,2,0,2,FMN GV 05 Lier
60,Mechelsesteenweg 365,2022-06-24,15:00:00,24,10,14,FMN GV 05 Lier
60,Mechelsesteenweg 365,2022-06-24,16:00:00,74,44,30,FMN GV 05 Lier
60,Mechelsesteenweg 365,2022-06-24,17:00:00,28,18,10,FMN GV 05 Lier
60,Mechelsesteenweg 365,2022-06-24,18:00:00,38,18,20,FMN GV 05 Lier
60,Mechelsesteenweg 365,2022-06-24,19:00:00,36,18,18,FMN GV 05 Lier
60,Mechelsesteenweg 365,2022-06-24,20:00:00,56,14,42,FMN GV 05 Lier
60,Mechelsesteenweg 365,2022-06-24,21:00:00,32,14,18,FMN GV 05 Lier
60,Mechelsesteenweg 365,2022-06-24,22:00:00,28,6,22,FMN GV 05 Lier
60,Mechelsesteenweg 365,2022-06-24,23:00:00,24,4,20,FMN GV 05 Lier
60,Mechelsesteenweg 365,2022-06-25,00:00:00,2,2,0,FMN GV 05 Lier
60,Mechelsesteenweg 365,2022-06-25,01:00:00,4,4,0,FMN GV 05 Lier
60,Mechelsesteenweg 365,2022-06-25,02:00:00,14,10,4,FMN GV 05 Lier
60,Mechelsesteenweg 365,2022-06-25,03:00:00,6,6,0,FMN GV 05 Lier
60,Mechelsesteenweg 365,2022-06-25,04:00:00,4,4,0,FMN GV 05 Lier
60,Mechelsesteenweg 365,2022-06-25,05:00:00,4,0,4,FMN GV 05 Lier
60,Mechelsesteenweg 365,2022-06-25,06:00:00,10,6,4,FMN GV 05 Lier
60,Mechelsesteenweg 365,2022-06-25,07:00:00,16,2,14,FMN GV 05 Lier
60,Mechelsesteenweg 365,2022-06-25,08:00:00,34,6,28,FMN GV 05 Lier
60,Mechelsesteenweg 365,2022-06-25,09:00:00,72,30,42,FMN GV 05 Lier
60,Mechelsesteenweg 365,2022-06-25,10:00:00,196,82,114,FMN GV 05 Lier
60,Mechelsesteenweg 365,2022-06-25,11:00:00,192,102,90,FMN GV 05 Lier
60,Mechelsesteenweg 365,2022-06-25,12:00:00,66,36,30,FMN GV 05 Lier
60,Mechelsesteenweg 365,2022-06-25,13:00:00,124,56,68,FMN GV 05 Lier
60,Mechelsesteenweg 365,2022-06-25,14:00:00,62,38,24,FMN GV 05 Lier
60,Mechelsesteenweg 365,2022-06-25,15:00:00,148,84,64,FMN GV 05 Lier
60,Mechelsesteenweg 365,2022-06-25,16:00:00,112,72,40,FMN GV 05 Lier
60,Mechelsesteenweg 365,2022-06-25,17:00:00,36,12,24,FMN GV 05 Lier
60,Mechelsesteenweg 365,2022-06-25,18:00:00,18,12,6,FMN GV 05 Lier
60,Mechelsesteenweg 365,2022-06-25,19:00:00,16,8,8,FMN GV 05 Lier
60,Mechelsesteenweg 365,2022-06-25,20:00:00,8,4,4,FMN GV 05 Lier
60,Mechelsesteenweg 365,2022-06-25,21:00:00,12,2,10,FMN GV 05 Lier
60,Mechelsesteenweg 365,2022-06-25,22:00:00,4,0,4,FMN GV 05 Lier
60,Mechelsesteenweg 365,2022-06-25,23:00:00,6,2,4,FMN GV 05 Lier
60,Mechelsesteenweg 365,2022-06-26,00:00:00,0,0,0,FMN GV 05 Lier
60,Mechelsesteenweg 365,2022-06-26,01:00:00,4,4,0,FMN GV 05 Lier
60,Mechelsesteenweg 365,2022-06-26,02:00:00,0,0,0,FMN GV 05 Lier
60,Mechelsesteenweg 365,2022-06-26,03:00:00,0,0,0,FMN GV 05 Lier
60,Mechelsesteenweg 365,2022-06-26,04:00:00,2,0,2,FMN GV 05 Lier
60,Mechelsesteenweg 365,2022-06-26,05:00:00,6,4,2,FMN GV 05 Lier
60,Mechelsesteenweg 365,2022-06-26,06:00:00,4,2,2,FMN GV 05 Lier
60,Mechelsesteenweg 365,2022-06-26,07:00:00,6,2,4,FMN GV 05 Lier
60,Mechelsesteenweg 365,2022-06-26,08:00:00,38,20,18,FMN GV 05 Lier
60,Mechelsesteenweg 365,2022-06-26,09:00:00,124,76,48,FMN GV 05 Lier
60,Mechelsesteenweg 365,2022-06-26,10:00:00,368,192,176,FMN GV 05 Lier
60,Mechelsesteenweg 365,2022-06-26,11:00:00,366,212,154,FMN GV 05 Lier
60,Mechelsesteenweg 365,2022-06-26,12:00:00,318,166,152,FMN GV 05 Lier
60,Mechelsesteenweg 365,2022-06-26,13:00:00,238,126,112,FMN GV 05 Lier
60,Mechelsesteenweg 365,2022-06-26,14:00:00,254,134,120,FMN GV 05 Lier
60,Mechelsesteenweg 365,2022-06-26,15:00:00,228,112,116,FMN GV 05 Lier
60,Mechelsesteenweg 365,2022-06-26,16:00:00,230,118,112,FMN GV 05 Lier
60,Mechelsesteenweg 365,2022-06-26,17:00:00,222,118,104,FMN GV 05 Lier
60,Mechelsesteenweg 365,2022-06-26,18:00:00,98,38,60,FMN GV 05 Lier
60,Mechelsesteenweg 365,2022-06-26,19:00:00,64,26,38,FMN GV 05 Lier
60,Mechelsesteenweg 365,2022-06-26,20:00:00,46,20,26,FMN GV 05 Lier
60,Mechelsesteenweg 365,2022-06-26,21:00:00,28,8,20,FMN GV 05 Lier
60,Mechelsesteenweg 365,2022-06-26,22:00:00,4,4,0,FMN GV 05 Lier
60,Mechelsesteenweg 365,2022-06-26,23:00:00,0,0,0,FMN GV 05 Lier
60,Mechelsesteenweg 365,2022-06-27,00:00:00,0,0,0,FMN GV 05 Lier
60,Mechelsesteenweg 365,2022-06-27,01:00:00,0,0,0,FMN GV 05 Lier
60,Mechelsesteenweg 365,2022-06-27,02:00:00,0,0,0,FMN GV 05 Lier
60,Mechelsesteenweg 365,2022-06-27,03:00:00,0,0,0,FMN GV 05 Lier
60,Mechelsesteenweg 365,2022-06-27,04:00:00,0,0,0,FMN GV 05 Lier
60,Mechelsesteenweg 365,2022-06-27,05:00:00,6,2,4,FMN GV 05 Lier
60,Mechelsesteenweg 365,2022-06-27,06:00:00,48,16,32,FMN GV 05 Lier
60,Mechelsesteenweg 365,2022-06-27,07:00:00,94,36,58,FMN GV 05 Lier
60,Mechelsesteenweg 365,2022-06-27,08:00:00,98,38,60,FMN GV 05 Lier
60,Mechelsesteenweg 365,2022-06-27,09:00:00,60,24,36,FMN GV 05 Lier
60,Mechelsesteenweg 365,2022-06-27,10:00:00,122,96,26,FMN GV 05 Lier
60,Mechelsesteenweg 365,2022-06-27,11:00:00,50,22,28,FMN GV 05 Lier
60,Mechelsesteenweg 365,2022-06-27,12:00:00,26,8,18,FMN GV 05 Lier
60,Mechelsesteenweg 365,2022-06-27,13:00:00,84,14,70,FMN GV 05 Lier
60,Mechelsesteenweg 365,2022-06-27,14:00:00,8,6,2,FMN GV 05 Lier
60,Mechelsesteenweg 365,2022-06-27,15:00:00,38,20,18,FMN GV 05 Lier
60,Mechelsesteenweg 365,2022-06-27,16:00:00,114,56,58,FMN GV 05 Lier
60,Mechelsesteenweg 365,2022-06-27,17:00:00,140,100,40,FMN GV 05 Lier
60,Mechelsesteenweg 365,2022-06-27,18:00:00,108,54,54,FMN GV 05 Lier
60,Mechelsesteenweg 365,2022-06-27,19:00:00,52,18,34,FMN GV 05 Lier
60,Mechelsesteenweg 365,2022-06-27,20:00:00,78,40,38,FMN GV 05 Lier
60,Mechelsesteenweg 365,2022-06-27,21:00:00,36,14,22,FMN GV 05 Lier
60,Mechelsesteenweg 365,2022-06-27,22:00:00,16,6,10,FMN GV 05 Lier
60,Mechelsesteenweg 365,2022-06-27,23:00:00,2,0,2,FMN GV 05 Lier
60,Mechelsesteenweg 365,2022-06-28,00:00:00,2,0,2,FMN GV 05 Lier
60,Mechelsesteenweg 365,2022-06-28,01:00:00,0,0,0,FMN GV 05 Lier
60,Mechelsesteenweg 365,2022-06-28,02:00:00,2,0,2,FMN GV 05 Lier
60,Mechelsesteenweg 365,2022-06-28,03:00:00,2,2,0,FMN GV 05 Lier
60,Mechelsesteenweg 365,2022-06-28,04:00:00,0,0,0,FMN GV 05 Lier
60,Mechelsesteenweg 365,2022-06-28,05:00:00,8,2,6,FMN GV 05 Lier
60,Mechelsesteenweg 365,2022-06-28,06:00:00,46,12,34,FMN GV 05 Lier
60,Mechelsesteenweg 365,2022-06-28,07:00:00,120,42,78,FMN GV 05 Lier
60,Mechelsesteenweg 365,2022-06-28,08:00:00,132,48,84,FMN GV 05 Lier
60,Mechelsesteenweg 365,2022-06-28,09:00:00,132,54,78,FMN GV 05 Lier
60,Mechelsesteenweg 365,2022-06-28,10:00:00,224,128,96,FMN GV 05 Lier
60,Mechelsesteenweg 365,2022-06-28,11:00:00,72,46,26,FMN GV 05 Lier
60,Mechelsesteenweg 365,2022-06-28,12:00:00,0,0,0,FMN GV 05 Lier
60,Mechelsesteenweg 365,2022-06-28,13:00:00,0,0,0,FMN GV 05 Lier
60,Mechelsesteenweg 365,2022-06-28,14:00:00,0,0,0,FMN GV 05 Lier
60,Mechelsesteenweg 365,2022-06-28,15:00:00,0,0,0,FMN GV 05 Lier
60,Mechelsesteenweg 365,2022-06-28,16:00:00,18,8,10,FMN GV 05 Lier
60,Mechelsesteenweg 365,2022-06-28,17:00:00,208,128,80,FMN GV 05 Lier
60,Mechelsesteenweg 365,2022-06-28,18:00:00,206,120,86,FMN GV 05 Lier
60,Mechelsesteenweg 365,2022-06-28,19:00:00,174,92,82,FMN GV 05 Lier
60,Mechelsesteenweg 365,2022-06-28,20:00:00,186,90,96,FMN GV 05 Lier
60,Mechelsesteenweg 365,2022-06-28,21:00:00,54,26,28,FMN GV 05 Lier
60,Mechelsesteenweg 365,2022-06-28,22:00:00,32,16,16,FMN GV 05 Lier
60,Mechelsesteenweg 365,2022-06-28,23:00:00,12,8,4,FMN GV 05 Lier
60,Mechelsesteenweg 365,2022-06-29,00:00:00,2,2,0,FMN GV 05 Lier
60,Mechelsesteenweg 365,2022-06-29,01:00:00,4,2,2,FMN GV 05 Lier
60,Mechelsesteenweg 365,2022-06-29,02:00:00,0,0,0,FMN GV 05 Lier
60,Mechelsesteenweg 365,2022-06-29,03:00:00,2,0,2,FMN GV 05 Lier
60,Mechelsesteenweg 365,2022-06-29,04:00:00,6,2,4,FMN GV 05 Lier
60,Mechelsesteenweg 365,2022-06-29,05:00:00,18,0,18,FMN GV 05 Lier
60,Mechelsesteenweg 365,2022-06-29,06:00:00,38,8,30,FMN GV 05 Lier
60,Mechelsesteenweg 365,2022-06-29,07:00:00,98,40,58,FMN GV 05 Lier
60,Mechelsesteenweg 365,2022-06-29,08:00:00,160,72,88,FMN GV 05 Lier
60,Mechelsesteenweg 365,2022-06-29,09:00:00,206,102,104,FMN GV 05 Lier
60,Mechelsesteenweg 365,2022-06-29,10:00:00,206,100,106,FMN GV 05 Lier
60,Mechelsesteenweg 365,2022-06-29,11:00:00,30,8,22,FMN GV 05 Lier
60,Mechelsesteenweg 365,2022-06-29,12:00:00,0,0,0,FMN GV 05 Lier
60,Mechelsesteenweg 365,2022-06-29,13:00:00,0,0,0,FMN GV 05 Lier
60,Mechelsesteenweg 365,2022-06-29,14:00:00,24,12,12,FMN GV 05 Lier
60,Mechelsesteenweg 365,2022-06-29,15:00:00,0,0,0,FMN GV 05 Lier
60,Mechelsesteenweg 365,2022-06-29,16:00:00,0,0,0,FMN GV 05 Lier
60,Mechelsesteenweg 365,2022-06-29,17:00:00,0,0,0,FMN GV 05 Lier
60,Mechelsesteenweg 365,2022-06-29,18:00:00,20,12,8,FMN GV 05 Lier
60,Mechelsesteenweg 365,2022-06-29,19:00:00,180,90,90,FMN GV 05 Lier
60,Mechelsesteenweg 365,2022-06-29,20:00:00,234,130,104,FMN GV 05 Lier
60,Mechelsesteenweg 365,2022-06-29,21:00:00,90,32,58,FMN GV 05 Lier
60,Mechelsesteenweg 365,2022-06-29,22:00:00,36,12,24,FMN GV 05 Lier
60,Mechelsesteenweg 365,2022-06-29,23:00:00,4,2,2,FMN GV 05 Lier
60,Mechelsesteenweg 365,2022-06-30,00:00:00,10,8,2,FMN GV 05 Lier
60,Mechelsesteenweg 365,2022-06-30,01:00:00,2,2,0,FMN GV 05 Lier
60,Mechelsesteenweg 365,2022-06-30,02:00:00,0,0,0,FMN GV 05 Lier
60,Mechelsesteenweg 365,2022-06-30,03:00:00,0,0,0,FMN GV 05 Lier
60,Mechelsesteenweg 365,2022-06-30,04:00:00,2,0,2,FMN GV 05 Lier
60,Mechelsesteenweg 365,2022-06-30,05:00:00,4,0,4,FMN GV 05 Lier
60,Mechelsesteenweg 365,2022-06-30,06:00:00,28,8,20,FMN GV 05 Lier
60,Mechelsesteenweg 365,2022-06-30,07:00:00,68,24,44,FMN GV 05 Lier
60,Mechelsesteenweg 365,2022-06-30,08:00:00,104,50,54,FMN GV 05 Lier
60,Mechelsesteenweg 365,2022-06-30,09:00:00,94,54,40,FMN GV 05 Lier
60,Mechelsesteenweg 365,2022-06-30,10:00:00,104,74,30,FMN GV 05 Lier
60,Mechelsesteenweg 365,2022-06-30,11:00:00,84,44,40,FMN GV 05 Lier
60,Mechelsesteenweg 365,2022-06-30,12:00:00,68,40,28,FMN GV 05 Lier
60,Mechelsesteenweg 365,2022-06-30,13:00:00,68,28,40,FMN GV 05 Lier
60,Mechelsesteenweg 365,2022-06-30,14:00:00,44,26,18,FMN GV 05 Lier
60,Mechelsesteenweg 365,2022-06-30,15:00:00,62,30,32,FMN GV 05 Lier
60,Mechelsesteenweg 365,2022-06-30,16:00:00,62,26,36,FMN GV 05 Lier
60,Mechelsesteenweg 365,2022-06-30,17:00:00,40,30,10,FMN GV 05 Lier
60,Mechelsesteenweg 365,2022-06-30,18:00:00,30,20,10,FMN GV 05 Lier
60,Mechelsesteenweg 365,2022-06-30,19:00:00,2,2,0,FMN GV 05 Lier
60,Mechelsesteenweg 365,2022-06-30,20:00:00,8,0,8,FMN GV 05 Lier
60,Mechelsesteenweg 365,2022-06-30,21:00:00,10,6,4,FMN GV 05 Lier
60,Mechelsesteenweg 365,2022-06-30,22:00:00,12,8,4,FMN GV 05 Lier
60,Mechelsesteenweg 365,2022-06-30,23:00:00,0,0,0,FMN GV 05 Lier
60,Mechelsesteenweg 365,2022-07-01,00:00:00,0,0,0,FMN GV 05 Lier
60,Mechelsesteenweg 365,2022-07-01,01:00:00,0,0,0,FMN GV 05 Lier
60,Mechelsesteenweg 365,2022-07-01,02:00:00,0,0,0,FMN GV 05 Lier
60,Mechelsesteenweg 365,2022-07-01,03:00:00,2,2,0,FMN GV 05 Lier
60,Mechelsesteenweg 365,2022-07-01,04:00:00,2,0,2,FMN GV 05 Lier
60,Mechelsesteenweg 365,2022-07-01,05:00:00,8,0,8,FMN GV 05 Lier
60,Mechelsesteenweg 365,2022-07-01,06:00:00,20,6,14,FMN GV 05 Lier
60,Mechelsesteenweg 365,2022-07-01,07:00:00,42,18,24,FMN GV 05 Lier
60,Mechelsesteenweg 365,2022-07-01,08:00:00,62,22,40,FMN GV 05 Lier
60,Mechelsesteenweg 365,2022-07-01,09:00:00,58,22,36,FMN GV 05 Lier
60,Mechelsesteenweg 365,2022-07-01,10:00:00,118,52,66,FMN GV 05 Lier
60,Mechelsesteenweg 365,2022-07-01,11:00:00,168,100,68,FMN GV 05 Lier
60,Mechelsesteenweg 365,2022-07-01,12:00:00,116,58,58,FMN GV 05 Lier
60,Mechelsesteenweg 365,2022-07-01,13:00:00,12,6,6,FMN GV 05 Lier
60,Mechelsesteenweg 365,2022-07-01,14:00:00,38,16,22,FMN GV 05 Lier
60,Mechelsesteenweg 365,2022-07-01,15:00:00,310,150,160,FMN GV 05 Lier
60,Mechelsesteenweg 365,2022-07-01,16:00:00,124,72,52,FMN GV 05 Lier
60,Mechelsesteenweg 365,2022-07-01,17:00:00,114,62,52,FMN GV 05 Lier
60,Mechelsesteenweg 365,2022-07-01,18:00:00,90,68,22,FMN GV 05 Lier
60,Mechelsesteenweg 365,2022-07-01,19:00:00,84,24,60,FMN GV 05 Lier
60,Mechelsesteenweg 365,2022-07-01,20:00:00,98,48,50,FMN GV 05 Lier
60,Mechelsesteenweg 365,2022-07-01,21:00:00,36,22,14,FMN GV 05 Lier
60,Mechelsesteenweg 365,2022-07-01,22:00:00,4,2,2,FMN GV 05 Lier
60,Mechelsesteenweg 365,2022-07-01,23:00:00,4,4,0,FMN GV 05 Lier
60,Mechelsesteenweg 365,2022-07-02,00:00:00,8,4,4,FMN GV 05 Lier
60,Mechelsesteenweg 365,2022-07-02,01:00:00,2,2,0,FMN GV 05 Lier
60,Mechelsesteenweg 365,2022-07-02,02:00:00,0,0,0,FMN GV 05 Lier
60,Mechelsesteenweg 365,2022-07-02,03:00:00,0,0,0,FMN GV 05 Lier
60,Mechelsesteenweg 365,2022-07-02,04:00:00,0,0,0,FMN GV 05 Lier
60,Mechelsesteenweg 365,2022-07-02,05:00:00,4,0,4,FMN GV 05 Lier
60,Mechelsesteenweg 365,2022-07-02,06:00:00,8,4,4,FMN GV 05 Lier
60,Mechelsesteenweg 365,2022-07-02,07:00:00,10,6,4,FMN GV 05 Lier
60,Mechelsesteenweg 365,2022-07-02,08:00:00,28,8,20,FMN GV 05 Lier
60,Mechelsesteenweg 365,2022-07-02,09:00:00,166,92,74,FMN GV 05 Lier
60,Mechelsesteenweg 365,2022-07-02,10:00:00,258,130,128,FMN GV 05 Lier
60,Mechelsesteenweg 365,2022-07-02,11:00:00,220,98,122,FMN GV 05 Lier
60,Mechelsesteenweg 365,2022-07-02,12:00:00,316,170,146,FMN GV 05 Lier
60,Mechelsesteenweg 365,2022-07-02,13:00:00,192,92,100,FMN GV 05 Lier
60,Mechelsesteenweg 365,2022-07-02,14:00:00,282,146,136,FMN GV 05 Lier
60,Mechelsesteenweg 365,2022-07-02,15:00:00,230,126,104,FMN GV 05 Lier
60,Mechelsesteenweg 365,2022-07-02,16:00:00,216,102,114,FMN GV 05 Lier
60,Mechelsesteenweg 365,2022-07-02,17:00:00,112,48,64,FMN GV 05 Lier
60,Mechelsesteenweg 365,2022-07-02,18:00:00,64,28,36,FMN GV 05 Lier
60,Mechelsesteenweg 365,2022-07-02,19:00:00,78,28,50,FMN GV 05 Lier
60,Mechelsesteenweg 365,2022-07-02,20:00:00,48,26,22,FMN GV 05 Lier
60,Mechelsesteenweg 365,2022-07-02,21:00:00,28,12,16,FMN GV 05 Lier
60,Mechelsesteenweg 365,2022-07-02,22:00:00,12,4,8,FMN GV 05 Lier
60,Mechelsesteenweg 365,2022-07-02,23:00:00,4,0,4,FMN GV 05 Lier
60,Mechelsesteenweg 365,2022-07-03,00:00:00,2,0,2,FMN GV 05 Lier
60,Mechelsesteenweg 365,2022-07-03,01:00:00,0,0,0,FMN GV 05 Lier
60,Mechelsesteenweg 365,2022-07-03,02:00:00,0,0,0,FMN GV 05 Lier
60,Mechelsesteenweg 365,2022-07-03,03:00:00,0,0,0,FMN GV 05 Lier
60,Mechelsesteenweg 365,2022-07-03,04:00:00,0,0,0,FMN GV 05 Lier
60,Mechelsesteenweg 365,2022-07-03,05:00:00,2,0,2,FMN GV 05 Lier
60,Mechelsesteenweg 365,2022-07-03,06:00:00,6,2,4,FMN GV 05 Lier
60,Mechelsesteenweg 365,2022-07-03,07:00:00,12,0,12,FMN GV 05 Lier
60,Mechelsesteenweg 365,2022-07-03,08:00:00,52,26,26,FMN GV 05 Lier
60,Mechelsesteenweg 365,2022-07-03,09:00:00,252,128,124,FMN GV 05 Lier
60,Mechelsesteenweg 365,2022-07-03,10:00:00,326,150,176,FMN GV 05 Lier
60,Mechelsesteenweg 365,2022-07-03,11:00:00,324,180,144,FMN GV 05 Lier
60,Mechelsesteenweg 365,2022-07-03,12:00:00,270,152,118,FMN GV 05 Lier
60,Mechelsesteenweg 365,2022-07-03,13:00:00,144,68,76,FMN GV 05 Lier
60,Mechelsesteenweg 365,2022-07-03,14:00:00,132,66,66,FMN GV 05 Lier
60,Mechelsesteenweg 365,2022-07-03,15:00:00,236,94,142,FMN GV 05 Lier
60,Mechelsesteenweg 365,2022-07-03,16:00:00,246,124,122,FMN GV 05 Lier
60,Mechelsesteenweg 365,2022-07-03,17:00:00,164,54,110,FMN GV 05 Lier
60,Mechelsesteenweg 365,2022-07-03,18:00:00,106,38,68,FMN GV 05 Lier
60,Mechelsesteenweg 365,2022-07-03,19:00:00,68,22,46,FMN GV 05 Lier
60,Mechelsesteenweg 365,2022-07-03,20:00:00,48,20,28,FMN GV 05 Lier
60,Mechelsesteenweg 365,2022-07-03,21:00:00,24,4,20,FMN GV 05 Lier
60,Mechelsesteenweg 365,2022-07-03,22:00:00,4,4,0,FMN GV 05 Lier
60,Mechelsesteenweg 365,2022-07-03,23:00:00,0,0,0,FMN GV 05 Lier
60,Mechelsesteenweg 365,2022-07-04,00:00:00,0,0,0,FMN GV 05 Lier
60,Mechelsesteenweg 365,2022-07-04,01:00:00,0,0,0,FMN GV 05 Lier
60,Mechelsesteenweg 365,2022-07-04,02:00:00,0,0,0,FMN GV 05 Lier
60,Mechelsesteenweg 365,2022-07-04,03:00:00,0,0,0,FMN GV 05 Lier
60,Mechelsesteenweg 365,2022-07-04,04:00:00,0,0,0,FMN GV 05 Lier
60,Mechelsesteenweg 365,2022-07-04,05:00:00,6,2,4,FMN GV 05 Lier
60,Mechelsesteenweg 365,2022-07-04,06:00:00,34,6,28,FMN GV 05 Lier
60,Mechelsesteenweg 365,2022-07-04,07:00:00,72,26,46,FMN GV 05 Lier
60,Mechelsesteenweg 365,2022-07-04,08:00:00,84,26,58,FMN GV 05 Lier
60,Mechelsesteenweg 365,2022-07-04,09:00:00,74,22,52,FMN GV 05 Lier
60,Mechelsesteenweg 365,2022-07-04,10:00:00,98,46,52,FMN GV 05 Lier
60,Mechelsesteenweg 365,2022-07-04,11:00:00,140,72,68,FMN GV 05 Lier
60,Mechelsesteenweg 365,2022-07-04,12:00:00,132,50,82,FMN GV 05 Lier
60,Mechelsesteenweg 365,2022-07-04,13:00:00,22,4,18,FMN GV 05 Lier
60,Mechelsesteenweg 365,2022-07-04,14:00:00,84,50,34,FMN GV 05 Lier
60,Mechelsesteenweg 365,2022-07-04,15:00:00,26,12,14,FMN GV 05 Lier
60,Mechelsesteenweg 365,2022-07-04,16:00:00,64,38,26,FMN GV 05 Lier
60,Mechelsesteenweg 365,2022-07-04,17:00:00,88,54,34,FMN GV 05 Lier
60,Mechelsesteenweg 365,2022-07-04,18:00:00,90,44,46,FMN GV 05 Lier
60,Mechelsesteenweg 365,2022-07-04,19:00:00,92,60,32,FMN GV 05 Lier
60,Mechelsesteenweg 365,2022-07-04,20:00:00,120,46,74,FMN GV 05 Lier
60,Mechelsesteenweg 365,2022-07-04,21:00:00,58,22,36,FMN GV 05 Lier
60,Mechelsesteenweg 365,2022-07-04,22:00:00,8,2,6,FMN GV 05 Lier
60,Mechelsesteenweg 365,2022-07-04,23:00:00,2,2,0,FMN GV 05 Lier
60,Mechelsesteenweg 365,2022-07-05,00:00:00,0,0,0,FMN GV 05 Lier
60,Mechelsesteenweg 365,2022-07-05,01:00:00,2,2,0,FMN GV 05 Lier
60,Mechelsesteenweg 365,2022-07-05,02:00:00,0,0,0,FMN GV 05 Lier
60,Mechelsesteenweg 365,2022-07-05,03:00:00,0,0,0,FMN GV 05 Lier
60,Mechelsesteenweg 365,2022-07-05,04:00:00,4,0,4,FMN GV 05 Lier
60,Mechelsesteenweg 365,2022-07-05,05:00:00,8,0,8,FMN GV 05 Lier
60,Mechelsesteenweg 365,2022-07-05,06:00:00,22,0,22,FMN GV 05 Lier
60,Mechelsesteenweg 365,2022-07-05,07:00:00,72,22,50,FMN GV 05 Lier
60,Mechelsesteenweg 365,2022-07-05,08:00:00,80,20,60,FMN GV 05 Lier
60,Mechelsesteenweg 365,2022-07-05,09:00:00,120,32,88,FMN GV 05 Lier
60,Mechelsesteenweg 365,2022-07-05,10:00:00,146,74,72,FMN GV 05 Lier
60,Mechelsesteenweg 365,2022-07-05,11:00:00,174,100,74,FMN GV 05 Lier
60,Mechelsesteenweg 365,2022-07-05,12:00:00,138,70,68,FMN GV 05 Lier
60,Mechelsesteenweg 365,2022-07-05,13:00:00,134,62,72,FMN GV 05 Lier
60,Mechelsesteenweg 365,2022-07-05,14:00:00,110,66,44,FMN GV 05 Lier
60,Mechelsesteenweg 365,2022-07-05,15:00:00,50,22,28,FMN GV 05 Lier
60,Mechelsesteenweg 365,2022-07-05,16:00:00,104,54,50,FMN GV 05 Lier
60,Mechelsesteenweg 365,2022-07-05,17:00:00,158,92,66,FMN GV 05 Lier
60,Mechelsesteenweg 365,2022-07-05,18:00:00,112,62,50,FMN GV 05 Lier
60,Mechelsesteenweg 365,2022-07-05,19:00:00,102,54,48,FMN GV 05 Lier
60,Mechelsesteenweg 365,2022-07-05,20:00:00,110,64,46,FMN GV 05 Lier
60,Mechelsesteenweg 365,2022-07-05,21:00:00,46,10,36,FMN GV 05 Lier
60,Mechelsesteenweg 365,2022-07-05,22:00:00,14,4,10,FMN GV 05 Lier
60,Mechelsesteenweg 365,2022-07-05,23:00:00,2,2,0,FMN GV 05 Lier
60,Mechelsesteenweg 365,2022-07-06,00:00:00,2,2,0,FMN GV 05 Lier
60,Mechelsesteenweg 365,2022-07-06,01:00:00,0,0,0,FMN GV 05 Lier
60,Mechelsesteenweg 365,2022-07-06,02:00:00,0,0,0,FMN GV 05 Lier
60,Mechelsesteenweg 365,2022-07-06,03:00:00,0,0,0,FMN GV 05 Lier
60,Mechelsesteenweg 365,2022-07-06,04:00:00,4,0,4,FMN GV 05 Lier
60,Mechelsesteenweg 365,2022-07-06,05:00:00,8,0,8,FMN GV 05 Lier
60,Mechelsesteenweg 365,2022-07-06,06:00:00,28,12,16,FMN GV 05 Lier
60,Mechelsesteenweg 365,2022-07-06,07:00:00,74,20,54,FMN GV 05 Lier
60,Mechelsesteenweg 365,2022-07-06,08:00:00,94,34,60,FMN GV 05 Lier
60,Mechelsesteenweg 365,2022-07-06,09:00:00,90,36,54,FMN GV 05 Lier
60,Mechelsesteenweg 365,2022-07-06,10:00:00,112,64,48,FMN GV 05 Lier
60,Mechelsesteenweg 365,2022-07-06,11:00:00,156,56,100,FMN GV 05 Lier
60,Mechelsesteenweg 365,2022-07-06,12:00:00,162,92,70,FMN GV 05 Lier
60,Mechelsesteenweg 365,2022-07-06,13:00:00,144,62,82,FMN GV 05 Lier
60,Mechelsesteenweg 365,2022-07-06,14:00:00,108,60,48,FMN GV 05 Lier
60,Mechelsesteenweg 365,2022-07-06,15:00:00,108,42,66,FMN GV 05 Lier
60,Mechelsesteenweg 365,2022-07-06,16:00:00,152,70,82,FMN GV 05 Lier
60,Mechelsesteenweg 365,2022-07-06,17:00:00,156,100,56,FMN GV 05 Lier
60,Mechelsesteenweg 365,2022-07-06,18:00:00,134,70,64,FMN GV 05 Lier
60,Mechelsesteenweg 365,2022-07-06,19:00:00,214,122,92,FMN GV 05 Lier
60,Mechelsesteenweg 365,2022-07-06,20:00:00,234,158,76,FMN GV 05 Lier
60,Mechelsesteenweg 365,2022-07-06,21:00:00,64,32,32,FMN GV 05 Lier
60,Mechelsesteenweg 365,2022-07-06,22:00:00,18,8,10,FMN GV 05 Lier
60,Mechelsesteenweg 365,2022-07-06,23:00:00,10,8,2,FMN GV 05 Lier
60,Mechelsesteenweg 365,2022-07-07,00:00:00,0,0,0,FMN GV 05 Lier
60,Mechelsesteenweg 365,2022-07-07,01:00:00,2,0,2,FMN GV 05 Lier
60,Mechelsesteenweg 365,2022-07-07,02:00:00,2,2,0,FMN GV 05 Lier
60,Mechelsesteenweg 365,2022-07-07,03:00:00,0,0,0,FMN GV 05 Lier
60,Mechelsesteenweg 365,2022-07-07,04:00:00,6,0,6,FMN GV 05 Lier
60,Mechelsesteenweg 365,2022-07-07,05:00:00,6,0,6,FMN GV 05 Lier
60,Mechelsesteenweg 365,2022-07-07,06:00:00,26,12,14,FMN GV 05 Lier
60,Mechelsesteenweg 365,2022-07-07,07:00:00,48,20,28,FMN GV 05 Lier
60,Mechelsesteenweg 365,2022-07-07,08:00:00,42,12,30,FMN GV 05 Lier
60,Mechelsesteenweg 365,2022-07-07,09:00:00,40,22,18,FMN GV 05 Lier
60,Mechelsesteenweg 365,2022-07-07,10:00:00,60,30,30,FMN GV 05 Lier
60,Mechelsesteenweg 365,2022-07-07,11:00:00,48,8,40,FMN GV 05 Lier
60,Mechelsesteenweg 365,2022-07-07,12:00:00,80,40,40,FMN GV 05 Lier
60,Mechelsesteenweg 365,2022-07-07,13:00:00,40,10,30,FMN GV 05 Lier
60,Mechelsesteenweg 365,2022-07-07,14:00:00,74,44,30,FMN GV 05 Lier
60,Mechelsesteenweg 365,2022-07-07,15:00:00,68,30,38,FMN GV 05 Lier
60,Mechelsesteenweg 365,2022-07-07,16:00:00,94,62,32,FMN GV 05 Lier
60,Mechelsesteenweg 365,2022-07-07,17:00:00,92,50,42,FMN GV 05 Lier
60,Mechelsesteenweg 365,2022-07-07,18:00:00,62,34,28,FMN GV 05 Lier
60,Mechelsesteenweg 365,2022-07-07,19:00:00,106,36,70,FMN GV 05 Lier
60,Mechelsesteenweg 365,2022-07-07,20:00:00,56,28,28,FMN GV 05 Lier
60,Mechelsesteenweg 365,2022-07-07,21:00:00,24,14,10,FMN GV 05 Lier
60,Mechelsesteenweg 365,2022-07-07,22:00:00,10,6,4,FMN GV 05 Lier
60,Mechelsesteenweg 365,2022-07-07,23:00:00,0,0,0,FMN GV 05 Lier
60,Mechelsesteenweg 365,2022-07-08,00:00:00,2,2,0,FMN GV 05 Lier
60,Mechelsesteenweg 365,2022-07-08,01:00:00,0,0,0,FMN GV 05 Lier
60,Mechelsesteenweg 365,2022-07-08,02:00:00,0,0,0,FMN GV 05 Lier
60,Mechelsesteenweg 365,2022-07-08,03:00:00,0,0,0,FMN GV 05 Lier
60,Mechelsesteenweg 365,2022-07-08,04:00:00,2,0,2,FMN GV 05 Lier
60,Mechelsesteenweg 365,2022-07-08,05:00:00,6,2,4,FMN GV 05 Lier
60,Mechelsesteenweg 365,2022-07-08,06:00:00,20,6,14,FMN GV 05 Lier
60,Mechelsesteenweg 365,2022-07-08,07:00:00,72,20,52,FMN GV 05 Lier
60,Mechelsesteenweg 365,2022-07-08,08:00:00,46,16,30,FMN GV 05 Lier
60,Mechelsesteenweg 365,2022-07-08,09:00:00,88,36,52,FMN GV 05 Lier
60,Mechelsesteenweg 365,2022-07-08,10:00:00,142,70,72,FMN GV 05 Lier
60,Mechelsesteenweg 365,2022-07-08,11:00:00,174,86,88,FMN GV 05 Lier
60,Mechelsesteenweg 365,2022-07-08,12:00:00,32,14,18,FMN GV 05 Lier
60,Mechelsesteenweg 365,2022-07-08,13:00:00,8,2,6,FMN GV 05 Lier
60,Mechelsesteenweg 365,2022-07-08,14:00:00,0,0,0,FMN GV 05 Lier
60,Mechelsesteenweg 365,2022-07-08,15:00:00,10,4,6,FMN GV 05 Lier
60,Mechelsesteenweg 365,2022-07-08,16:00:00,12,6,6,FMN GV 05 Lier
60,Mechelsesteenweg 365,2022-07-08,17:00:00,164,104,60,FMN GV 05 Lier
60,Mechelsesteenweg 365,2022-07-08,18:00:00,106,66,40,FMN GV 05 Lier
60,Mechelsesteenweg 365,2022-07-08,19:00:00,112,64,48,FMN GV 05 Lier
60,Mechelsesteenweg 365,2022-07-08,20:00:00,100,46,54,FMN GV 05 Lier
60,Mechelsesteenweg 365,2022-07-08,21:00:00,52,24,28,FMN GV 05 Lier
60,Mechelsesteenweg 365,2022-07-08,22:00:00,16,6,10,FMN GV 05 Lier
60,Mechelsesteenweg 365,2022-07-08,23:00:00,4,2,2,FMN GV 05 Lier
60,Mechelsesteenweg 365,2022-07-09,00:00:00,4,2,2,FMN GV 05 Lier
60,Mechelsesteenweg 365,2022-07-09,01:00:00,0,0,0,FMN GV 05 Lier
60,Mechelsesteenweg 365,2022-07-09,02:00:00,0,0,0,FMN GV 05 Lier
60,Mechelsesteenweg 365,2022-07-09,03:00:00,0,0,0,FMN GV 05 Lier
60,Mechelsesteenweg 365,2022-07-09,04:00:00,0,0,0,FMN GV 05 Lier
60,Mechelsesteenweg 365,2022-07-09,05:00:00,4,0,4,FMN GV 05 Lier
60,Mechelsesteenweg 365,2022-07-09,06:00:00,6,2,4,FMN GV 05 Lier
60,Mechelsesteenweg 365,2022-07-09,07:00:00,34,12,22,FMN GV 05 Lier
60,Mechelsesteenweg 365,2022-07-09,08:00:00,60,32,28,FMN GV 05 Lier
60,Mechelsesteenweg 365,2022-07-09,09:00:00,96,56,40,FMN GV 05 Lier
60,Mechelsesteenweg 365,2022-07-09,10:00:00,188,88,100,FMN GV 05 Lier
60,Mechelsesteenweg 365,2022-07-09,11:00:00,288,130,158,FMN GV 05 Lier
60,Mechelsesteenweg 365,2022-07-09,12:00:00,182,74,108,FMN GV 05 Lier
60,Mechelsesteenweg 365,2022-07-09,13:00:00,140,68,72,FMN GV 05 Lier
60,Mechelsesteenweg 365,2022-07-09,14:00:00,236,112,124,FMN GV 05 Lier
60,Mechelsesteenweg 365,2022-07-09,15:00:00,34,6,28,FMN GV 05 Lier
60,Mechelsesteenweg 365,2022-07-09,16:00:00,96,42,54,FMN GV 05 Lier
60,Mechelsesteenweg 365,2022-07-09,17:00:00,104,46,58,FMN GV 05 Lier
60,Mechelsesteenweg 365,2022-07-09,18:00:00,84,60,24,FMN GV 05 Lier
60,Mechelsesteenweg 365,2022-07-09,19:00:00,44,12,32,FMN GV 05 Lier
60,Mechelsesteenweg 365,2022-07-09,20:00:00,62,28,34,FMN GV 05 Lier
60,Mechelsesteenweg 365,2022-07-09,21:00:00,12,6,6,FMN GV 05 Lier
60,Mechelsesteenweg 365,2022-07-09,22:00:00,4,2,2,FMN GV 05 Lier
60,Mechelsesteenweg 365,2022-07-09,23:00:00,0,0,0,FMN GV 05 Lier
60,Mechelsesteenweg 365,2022-07-10,00:00:00,2,0,2,FMN GV 05 Lier
60,Mechelsesteenweg 365,2022-07-10,01:00:00,10,10,0,FMN GV 05 Lier
60,Mechelsesteenweg 365,2022-07-10,02:00:00,2,0,2,FMN GV 05 Lier
60,Mechelsesteenweg 365,2022-07-10,03:00:00,0,0,0,FMN GV 05 Lier
60,Mechelsesteenweg 365,2022-07-10,04:00:00,0,0,0,FMN GV 05 Lier
60,Mechelsesteenweg 365,2022-07-10,05:00:00,0,0,0,FMN GV 05 Lier
60,Mechelsesteenweg 365,2022-07-10,06:00:00,12,2,10,FMN GV 05 Lier
60,Mechelsesteenweg 365,2022-07-10,07:00:00,12,8,4,FMN GV 05 Lier
60,Mechelsesteenweg 365,2022-07-10,08:00:00,60,22,38,FMN GV 05 Lier
60,Mechelsesteenweg 365,2022-07-10,09:00:00,176,116,60,FMN GV 05 Lier
60,Mechelsesteenweg 365,2022-07-10,10:00:00,400,274,126,FMN GV 05 Lier
60,Mechelsesteenweg 365,2022-07-10,11:00:00,408,218,190,FMN GV 05 Lier
60,Mechelsesteenweg 365,2022-07-10,12:00:00,354,182,172,FMN GV 05 Lier
60,Mechelsesteenweg 365,2022-07-10,13:00:00,244,120,124,FMN GV 05 Lier
60,Mechelsesteenweg 365,2022-07-10,14:00:00,72,36,36,FMN GV 05 Lier
60,Mechelsesteenweg 365,2022-07-10,15:00:00,58,34,24,FMN GV 05 Lier
60,Mechelsesteenweg 365,2022-07-10,16:00:00,170,54,116,FMN GV 05 Lier
60,Mechelsesteenweg 365,2022-07-10,17:00:00,154,64,90,FMN GV 05 Lier
60,Mechelsesteenweg 365,2022-07-10,18:00:00,86,28,58,FMN GV 05 Lier
60,Mechelsesteenweg 365,2022-07-10,19:00:00,78,50,28,FMN GV 05 Lier
60,Mechelsesteenweg 365,2022-07-10,20:00:00,66,24,42,FMN GV 05 Lier
60,Mechelsesteenweg 365,2022-07-10,21:00:00,40,18,22,FMN GV 05 Lier
60,Mechelsesteenweg 365,2022-07-10,22:00:00,6,2,4,FMN GV 05 Lier
60,Mechelsesteenweg 365,2022-07-10,23:00:00,0,0,0,FMN GV 05 Lier
60,Mechelsesteenweg 365,2022-07-11,00:00:00,0,0,0,FMN GV 05 Lier
60,Mechelsesteenweg 365,2022-07-11,01:00:00,0,0,0,FMN GV 05 Lier
60,Mechelsesteenweg 365,2022-07-11,02:00:00,0,0,0,FMN GV 05 Lier
60,Mechelsesteenweg 365,2022-07-11,03:00:00,0,0,0,FMN GV 05 Lier
60,Mechelsesteenweg 365,2022-07-11,04:00:00,2,0,2,FMN GV 05 Lier
60,Mechelsesteenweg 365,2022-07-11,05:00:00,2,2,0,FMN GV 05 Lier
60,Mechelsesteenweg 365,2022-07-11,06:00:00,20,10,10,FMN GV 05 Lier
60,Mechelsesteenweg 365,2022-07-11,07:00:00,66,18,48,FMN GV 05 Lier
60,Mechelsesteenweg 365,2022-07-11,08:00:00,50,14,36,FMN GV 05 Lier
60,Mechelsesteenweg 365,2022-07-11,09:00:00,84,46,38,FMN GV 05 Lier
60,Mechelsesteenweg 365,2022-07-11,10:00:00,108,58,50,FMN GV 05 Lier
60,Mechelsesteenweg 365,2022-07-11,11:00:00,214,106,108,FMN GV 05 Lier
60,Mechelsesteenweg 365,2022-07-11,12:00:00,130,52,78,FMN GV 05 Lier
60,Mechelsesteenweg 365,2022-07-11,13:00:00,20,6,14,FMN GV 05 Lier
60,Mechelsesteenweg 365,2022-07-11,14:00:00,2,0,2,FMN GV 05 Lier
60,Mechelsesteenweg 365,2022-07-11,15:00:00,0,0,0,FMN GV 05 Lier
60,Mechelsesteenweg 365,2022-07-11,16:00:00,0,0,0,FMN GV 05 Lier
60,Mechelsesteenweg 365,2022-07-11,17:00:00,18,6,12,FMN GV 05 Lier
60,Mechelsesteenweg 365,2022-07-11,18:00:00,64,26,38,FMN GV 05 Lier
60,Mechelsesteenweg 365,2022-07-11,19:00:00,126,74,52,FMN GV 05 Lier
60,Mechelsesteenweg 365,2022-07-11,20:00:00,132,76,56,FMN GV 05 Lier
60,Mechelsesteenweg 365,2022-07-11,21:00:00,48,6,42,FMN GV 05 Lier
60,Mechelsesteenweg 365,2022-07-11,22:00:00,10,6,4,FMN GV 05 Lier
60,Mechelsesteenweg 365,2022-07-11,23:00:00,2,0,2,FMN GV 05 Lier
60,Mechelsesteenweg 365,2022-07-12,00:00:00,0,0,0,FMN GV 05 Lier
60,Mechelsesteenweg 365,2022-07-12,01:00:00,0,0,0,FMN GV 05 Lier
60,Mechelsesteenweg 365,2022-07-12,02:00:00,0,0,0,FMN GV 05 Lier
60,Mechelsesteenweg 365,2022-07-12,03:00:00,0,0,0,FMN GV 05 Lier
60,Mechelsesteenweg 365,2022-07-12,04:00:00,2,0,2,FMN GV 05 Lier
60,Mechelsesteenweg 365,2022-07-12,05:00:00,8,0,8,FMN GV 05 Lier
60,Mechelsesteenweg 365,2022-07-12,06:00:00,32,16,16,FMN GV 05 Lier
60,Mechelsesteenweg 365,2022-07-12,07:00:00,102,38,64,FMN GV 05 Lier
60,Mechelsesteenweg 365,2022-07-12,08:00:00,102,42,60,FMN GV 05 Lier
60,Mechelsesteenweg 365,2022-07-12,09:00:00,136,54,82,FMN GV 05 Lier
60,Mechelsesteenweg 365,2022-07-12,10:00:00,214,98,116,FMN GV 05 Lier
60,Mechelsesteenweg 365,2022-07-12,11:00:00,114,58,56,FMN GV 05 Lier
60,Mechelsesteenweg 365,2022-07-12,12:00:00,26,6,20,FMN GV 05 Lier
60,Mechelsesteenweg 365,2022-07-12,13:00:00,0,0,0,FMN GV 05 Lier
60,Mechelsesteenweg 365,2022-07-12,14:00:00,0,0,0,FMN GV 05 Lier
60,Mechelsesteenweg 365,2022-07-12,15:00:00,0,0,0,FMN GV 05 Lier
60,Mechelsesteenweg 365,2022-07-12,16:00:00,0,0,0,FMN GV 05 Lier
60,Mechelsesteenweg 365,2022-07-12,17:00:00,62,28,34,FMN GV 05 Lier
60,Mechelsesteenweg 365,2022-07-12,18:00:00,86,46,40,FMN GV 05 Lier
60,Mechelsesteenweg 365,2022-07-12,19:00:00,120,66,54,FMN GV 05 Lier
60,Mechelsesteenweg 365,2022-07-12,20:00:00,148,88,60,FMN GV 05 Lier
60,Mechelsesteenweg 365,2022-07-12,21:00:00,80,46,34,FMN GV 05 Lier
60,Mechelsesteenweg 365,2022-07-12,22:00:00,16,8,8,FMN GV 05 Lier
60,Mechelsesteenweg 365,2022-07-12,23:00:00,6,4,2,FMN GV 05 Lier
60,Mechelsesteenweg 365,2022-07-13,00:00:00,0,0,0,FMN GV 05 Lier
60,Mechelsesteenweg 365,2022-07-13,01:00:00,0,0,0,FMN GV 05 Lier
60,Mechelsesteenweg 365,2022-07-13,02:00:00,2,0,2,FMN GV 05 Lier
60,Mechelsesteenweg 365,2022-07-13,03:00:00,0,0,0,FMN GV 05 Lier
60,Mechelsesteenweg 365,2022-07-13,04:00:00,2,0,2,FMN GV 05 Lier
60,Mechelsesteenweg 365,2022-07-13,05:00:00,4,0,4,FMN GV 05 Lier
60,Mechelsesteenweg 365,2022-07-13,06:00:00,46,20,26,FMN GV 05 Lier
60,Mechelsesteenweg 365,2022-07-13,07:00:00,86,28,58,FMN GV 05 Lier
60,Mechelsesteenweg 365,2022-07-13,08:00:00,106,38,68,FMN GV 05 Lier
60,Mechelsesteenweg 365,2022-07-13,09:00:00,132,82,50,FMN GV 05 Lier
60,Mechelsesteenweg 365,2022-07-13,10:00:00,190,116,74,FMN GV 05 Lier
60,Mechelsesteenweg 365,2022-07-13,11:00:00,120,54,66,FMN GV 05 Lier
60,Mechelsesteenweg 365,2022-07-13,12:00:00,24,6,18,FMN GV 05 Lier
60,Mechelsesteenweg 365,2022-07-13,13:00:00,20,8,12,FMN GV 05 Lier
60,Mechelsesteenweg 365,2022-07-13,14:00:00,40,8,32,FMN GV 05 Lier
60,Mechelsesteenweg 365,2022-07-13,15:00:00,54,18,36,FMN GV 05 Lier
60,Mechelsesteenweg 365,2022-07-13,16:00:00,44,34,10,FMN GV 05 Lier
60,Mechelsesteenweg 365,2022-07-13,17:00:00,146,76,70,FMN GV 05 Lier
60,Mechelsesteenweg 365,2022-07-13,18:00:00,174,114,60,FMN GV 05 Lier
60,Mechelsesteenweg 365,2022-07-13,19:00:00,174,86,88,FMN GV 05 Lier
60,Mechelsesteenweg 365,2022-07-13,20:00:00,302,146,156,FMN GV 05 Lier
60,Mechelsesteenweg 365,2022-07-13,21:00:00,54,16,38,FMN GV 05 Lier
60,Mechelsesteenweg 365,2022-07-13,22:00:00,12,2,10,FMN GV 05 Lier
60,Mechelsesteenweg 365,2022-07-13,23:00:00,4,2,2,FMN GV 05 Lier
60,Mechelsesteenweg 365,2022-07-14,00:00:00,0,0,0,FMN GV 05 Lier
60,Mechelsesteenweg 365,2022-07-14,01:00:00,0,0,0,FMN GV 05 Lier
60,Mechelsesteenweg 365,2022-07-14,02:00:00,0,0,0,FMN GV 05 Lier
60,Mechelsesteenweg 365,2022-07-14,03:00:00,0,0,0,FMN GV 05 Lier
60,Mechelsesteenweg 365,2022-07-14,04:00:00,2,0,2,FMN GV 05 Lier
60,Mechelsesteenweg 365,2022-07-14,05:00:00,10,0,10,FMN GV 05 Lier
60,Mechelsesteenweg 365,2022-07-14,06:00:00,38,10,28,FMN GV 05 Lier
60,Mechelsesteenweg 365,2022-07-14,07:00:00,110,28,82,FMN GV 05 Lier
60,Mechelsesteenweg 365,2022-07-14,08:00:00,84,38,46,FMN GV 05 Lier
60,Mechelsesteenweg 365,2022-07-14,09:00:00,124,66,58,FMN GV 05 Lier
60,Mechelsesteenweg 365,2022-07-14,10:00:00,186,102,84,FMN GV 05 Lier
60,Mechelsesteenweg 365,2022-07-14,11:00:00,242,146,96,FMN GV 05 Lier
60,Mechelsesteenweg 365,2022-07-14,12:00:00,104,56,48,FMN GV 05 Lier
60,Mechelsesteenweg 365,2022-07-14,13:00:00,126,54,72,FMN GV 05 Lier
60,Mechelsesteenweg 365,2022-07-14,14:00:00,150,62,88,FMN GV 05 Lier
60,Mechelsesteenweg 365,2022-07-14,15:00:00,150,66,84,FMN GV 05 Lier
60,Mechelsesteenweg 365,2022-07-14,16:00:00,82,22,60,FMN GV 05 Lier
60,Mechelsesteenweg 365,2022-07-14,17:00:00,108,66,42,FMN GV 05 Lier
60,Mechelsesteenweg 365,2022-07-14,18:00:00,96,48,48,FMN GV 05 Lier
60,Mechelsesteenweg 365,2022-07-14,19:00:00,112,60,52,FMN GV 05 Lier
60,Mechelsesteenweg 365,2022-07-14,20:00:00,158,78,80,FMN GV 05 Lier
60,Mechelsesteenweg 365,2022-07-14,21:00:00,38,28,10,FMN GV 05 Lier
60,Mechelsesteenweg 365,2022-07-14,22:00:00,30,8,22,FMN GV 05 Lier
60,Mechelsesteenweg 365,2022-07-14,23:00:00,2,2,0,FMN GV 05 Lier
60,Mechelsesteenweg 365,2022-07-15,00:00:00,0,0,0,FMN GV 05 Lier
60,Mechelsesteenweg 365,2022-07-15,01:00:00,0,0,0,FMN GV 05 Lier
60,Mechelsesteenweg 365,2022-07-15,02:00:00,0,0,0,FMN GV 05 Lier
60,Mechelsesteenweg 365,2022-07-15,03:00:00,0,0,0,FMN GV 05 Lier
60,Mechelsesteenweg 365,2022-07-15,04:00:00,2,0,2,FMN GV 05 Lier
60,Mechelsesteenweg 365,2022-07-15,05:00:00,4,0,4,FMN GV 05 Lier
60,Mechelsesteenweg 365,2022-07-15,06:00:00,24,6,18,FMN GV 05 Lier
60,Mechelsesteenweg 365,2022-07-15,07:00:00,66,18,48,FMN GV 05 Lier
60,Mechelsesteenweg 365,2022-07-15,08:00:00,58,14,44,FMN GV 05 Lier
60,Mechelsesteenweg 365,2022-07-15,09:00:00,74,32,42,FMN GV 05 Lier
60,Mechelsesteenweg 365,2022-07-15,10:00:00,176,94,82,FMN GV 05 Lier
60,Mechelsesteenweg 365,2022-07-15,11:00:00,86,36,50,FMN GV 05 Lier
60,Mechelsesteenweg 365,2022-07-15,12:00:00,32,10,22,FMN GV 05 Lier
60,Mechelsesteenweg 365,2022-07-15,13:00:00,86,32,54,FMN GV 05 Lier
60,Mechelsesteenweg 365,2022-07-15,14:00:00,166,106,60,FMN GV 05 Lier
60,Mechelsesteenweg 365,2022-07-15,15:00:00,78,30,48,FMN GV 05 Lier
60,Mechelsesteenweg 365,2022-07-15,16:00:00,128,50,78,FMN GV 05 Lier
60,Mechelsesteenweg 365,2022-07-15,17:00:00,94,52,42,FMN GV 05 Lier
60,Mechelsesteenweg 365,2022-07-15,18:00:00,90,48,42,FMN GV 05 Lier
60,Mechelsesteenweg 365,2022-07-15,19:00:00,110,64,46,FMN GV 05 Lier
60,Mechelsesteenweg 365,2022-07-15,20:00:00,70,32,38,FMN GV 05 Lier
60,Mechelsesteenweg 365,2022-07-15,21:00:00,30,18,12,FMN GV 05 Lier
60,Mechelsesteenweg 365,2022-07-15,22:00:00,10,4,6,FMN GV 05 Lier
60,Mechelsesteenweg 365,2022-07-15,23:00:00,10,2,8,FMN GV 05 Lier
60,Mechelsesteenweg 365,2022-07-16,00:00:00,0,0,0,FMN GV 05 Lier
60,Mechelsesteenweg 365,2022-07-16,01:00:00,0,0,0,FMN GV 05 Lier
60,Mechelsesteenweg 365,2022-07-16,02:00:00,2,0,2,FMN GV 05 Lier
60,Mechelsesteenweg 365,2022-07-16,03:00:00,0,0,0,FMN GV 05 Lier
60,Mechelsesteenweg 365,2022-07-16,04:00:00,0,0,0,FMN GV 05 Lier
60,Mechelsesteenweg 365,2022-07-16,05:00:00,2,0,2,FMN GV 05 Lier
60,Mechelsesteenweg 365,2022-07-16,06:00:00,8,4,4,FMN GV 05 Lier
60,Mechelsesteenweg 365,2022-07-16,07:00:00,14,12,2,FMN GV 05 Lier
60,Mechelsesteenweg 365,2022-07-16,08:00:00,46,26,20,FMN GV 05 Lier
60,Mechelsesteenweg 365,2022-07-16,09:00:00,172,76,96,FMN GV 05 Lier
60,Mechelsesteenweg 365,2022-07-16,10:00:00,258,142,116,FMN GV 05 Lier
60,Mechelsesteenweg 365,2022-07-16,11:00:00,202,86,116,FMN GV 05 Lier
60,Mechelsesteenweg 365,2022-07-16,12:00:00,6,4,2,FMN GV 05 Lier
60,Mechelsesteenweg 365,2022-07-16,13:00:00,0,0,0,FMN GV 05 Lier
60,Mechelsesteenweg 365,2022-07-16,14:00:00,0,0,0,FMN GV 05 Lier
60,Mechelsesteenweg 365,2022-07-16,15:00:00,0,0,0,FMN GV 05 Lier
60,Mechelsesteenweg 365,2022-07-16,16:00:00,0,0,0,FMN GV 05 Lier
60,Mechelsesteenweg 365,2022-07-16,17:00:00,0,0,0,FMN GV 05 Lier
60,Mechelsesteenweg 365,2022-07-16,18:00:00,46,16,30,FMN GV 05 Lier
60,Mechelsesteenweg 365,2022-07-16,19:00:00,72,34,38,FMN GV 05 Lier
60,Mechelsesteenweg 365,2022-07-16,20:00:00,68,20,48,FMN GV 05 Lier
60,Mechelsesteenweg 365,2022-07-16,21:00:00,28,12,16,FMN GV 05 Lier
60,Mechelsesteenweg 365,2022-07-16,22:00:00,4,2,2,FMN GV 05 Lier
60,Mechelsesteenweg 365,2022-07-16,23:00:00,0,0,0,FMN GV 05 Lier
60,Mechelsesteenweg 365,2022-07-17,00:00:00,2,2,0,FMN GV 05 Lier
60,Mechelsesteenweg 365,2022-07-17,01:00:00,2,0,2,FMN GV 05 Lier
60,Mechelsesteenweg 365,2022-07-17,02:00:00,0,0,0,FMN GV 05 Lier
60,Mechelsesteenweg 365,2022-07-17,03:00:00,8,8,0,FMN GV 05 Lier
60,Mechelsesteenweg 365,2022-07-17,04:00:00,0,0,0,FMN GV 05 Lier
60,Mechelsesteenweg 365,2022-07-17,05:00:00,2,0,2,FMN GV 05 Lier
60,Mechelsesteenweg 365,2022-07-17,06:00:00,8,6,2,FMN GV 05 Lier
60,Mechelsesteenweg 365,2022-07-17,07:00:00,16,12,4,FMN GV 05 Lier
60,Mechelsesteenweg 365,2022-07-17,08:00:00,58,32,26,FMN GV 05 Lier
60,Mechelsesteenweg 365,2022-07-17,09:00:00,214,126,88,FMN GV 05 Lier
60,Mechelsesteenweg 365,2022-07-17,10:00:00,400,208,192,FMN GV 05 Lier
60,Mechelsesteenweg 365,2022-07-17,11:00:00,352,112,240,FMN GV 05 Lier
60,Mechelsesteenweg 365,2022-07-17,12:00:00,0,0,0,FMN GV 05 Lier
60,Mechelsesteenweg 365,2022-07-17,13:00:00,0,0,0,FMN GV 05 Lier
60,Mechelsesteenweg 365,2022-07-17,14:00:00,0,0,0,FMN GV 05 Lier
60,Mechelsesteenweg 365,2022-07-17,15:00:00,0,0,0,FMN GV 05 Lier
60,Mechelsesteenweg 365,2022-07-17,16:00:00,0,0,0,FMN GV 05 Lier
60,Mechelsesteenweg 365,2022-07-17,17:00:00,0,0,0,FMN GV 05 Lier
60,Mechelsesteenweg 365,2022-07-17,18:00:00,14,6,8,FMN GV 05 Lier
60,Mechelsesteenweg 365,2022-07-17,19:00:00,108,32,76,FMN GV 05 Lier
60,Mechelsesteenweg 365,2022-07-17,20:00:00,72,38,34,FMN GV 05 Lier
60,Mechelsesteenweg 365,2022-07-17,21:00:00,48,20,28,FMN GV 05 Lier
60,Mechelsesteenweg 365,2022-07-17,22:00:00,8,2,6,FMN GV 05 Lier
60,Mechelsesteenweg 365,2022-07-17,23:00:00,0,0,0,FMN GV 05 Lier
60,Mechelsesteenweg 365,2022-07-18,00:00:00,0,0,0,FMN GV 05 Lier
60,Mechelsesteenweg 365,2022-07-18,01:00:00,0,0,0,FMN GV 05 Lier
60,Mechelsesteenweg 365,2022-07-18,02:00:00,0,0,0,FMN GV 05 Lier
60,Mechelsesteenweg 365,2022-07-18,03:00:00,0,0,0,FMN GV 05 Lier
60,Mechelsesteenweg 365,2022-07-18,04:00:00,0,0,0,FMN GV 05 Lier
60,Mechelsesteenweg 365,2022-07-18,05:00:00,6,0,6,FMN GV 05 Lier
60,Mechelsesteenweg 365,2022-07-18,06:00:00,32,10,22,FMN GV 05 Lier
60,Mechelsesteenweg 365,2022-07-18,07:00:00,70,30,40,FMN GV 05 Lier
60,Mechelsesteenweg 365,2022-07-18,08:00:00,98,42,56,FMN GV 05 Lier
60,Mechelsesteenweg 365,2022-07-18,09:00:00,106,46,60,FMN GV 05 Lier
60,Mechelsesteenweg 365,2022-07-18,10:00:00,186,84,102,FMN GV 05 Lier
60,Mechelsesteenweg 365,2022-07-18,11:00:00,58,32,26,FMN GV 05 Lier
60,Mechelsesteenweg 365,2022-07-18,12:00:00,0,0,0,FMN GV 05 Lier
60,Mechelsesteenweg 365,2022-07-18,13:00:00,0,0,0,FMN GV 05 Lier
60,Mechelsesteenweg 365,2022-07-18,14:00:00,0,0,0,FMN GV 05 Lier
60,Mechelsesteenweg 365,2022-07-18,15:00:00,0,0,0,FMN GV 05 Lier
60,Mechelsesteenweg 365,2022-07-18,16:00:00,0,0,0,FMN GV 05 Lier
60,Mechelsesteenweg 365,2022-07-18,17:00:00,0,0,0,FMN GV 05 Lier
60,Mechelsesteenweg 365,2022-07-18,18:00:00,2,2,0,FMN GV 05 Lier
60,Mechelsesteenweg 365,2022-07-18,19:00:00,50,30,20,FMN GV 05 Lier
60,Mechelsesteenweg 365,2022-07-18,20:00:00,62,34,28,FMN GV 05 Lier
60,Mechelsesteenweg 365,2022-07-18,21:00:00,40,8,32,FMN GV 05 Lier
60,Mechelsesteenweg 365,2022-07-18,22:00:00,14,4,10,FMN GV 05 Lier
60,Mechelsesteenweg 365,2022-07-18,23:00:00,2,0,2,FMN GV 05 Lier
60,Mechelsesteenweg 365,2022-07-19,00:00:00,6,0,6,FMN GV 05 Lier
60,Mechelsesteenweg 365,2022-07-19,01:00:00,0,0,0,FMN GV 05 Lier
60,Mechelsesteenweg 365,2022-07-19,02:00:00,0,0,0,FMN GV 05 Lier
60,Mechelsesteenweg 365,2022-07-19,03:00:00,0,0,0,FMN GV 05 Lier
60,Mechelsesteenweg 365,2022-07-19,04:00:00,2,0,2,FMN GV 05 Lier
60,Mechelsesteenweg 365,2022-07-19,05:00:00,4,0,4,FMN GV 05 Lier
60,Mechelsesteenweg 365,2022-07-19,06:00:00,22,4,18,FMN GV 05 Lier
60,Mechelsesteenweg 365,2022-07-19,07:00:00,96,38,58,FMN GV 05 Lier
60,Mechelsesteenweg 365,2022-07-19,08:00:00,138,52,86,FMN GV 05 Lier
60,Mechelsesteenweg 365,2022-07-19,09:00:00,192,86,106,FMN GV 05 Lier
60,Mechelsesteenweg 365,2022-07-19,10:00:00,144,52,92,FMN GV 05 Lier
60,Mechelsesteenweg 365,2022-07-19,11:00:00,6,2,4,FMN GV 05 Lier
60,Mechelsesteenweg 365,2022-07-19,12:00:00,0,0,0,FMN GV 05 Lier
60,Mechelsesteenweg 365,2022-07-19,13:00:00,0,0,0,FMN GV 05 Lier
60,Mechelsesteenweg 365,2022-07-19,14:00:00,0,0,0,FMN GV 05 Lier
60,Mechelsesteenweg 365,2022-07-19,15:00:00,0,0,0,FMN GV 05 Lier
60,Mechelsesteenweg 365,2022-07-19,16:00:00,0,0,0,FMN GV 05 Lier
60,Mechelsesteenweg 365,2022-07-19,17:00:00,0,0,0,FMN GV 05 Lier
60,Mechelsesteenweg 365,2022-07-19,18:00:00,0,0,0,FMN GV 05 Lier
60,Mechelsesteenweg 365,2022-07-19,19:00:00,22,8,14,FMN GV 05 Lier
60,Mechelsesteenweg 365,2022-07-19,20:00:00,56,26,30,FMN GV 05 Lier
60,Mechelsesteenweg 365,2022-07-19,21:00:00,68,26,42,FMN GV 05 Lier
60,Mechelsesteenweg 365,2022-07-19,22:00:00,22,4,18,FMN GV 05 Lier
60,Mechelsesteenweg 365,2022-07-19,23:00:00,10,2,8,FMN GV 05 Lier
60,Mechelsesteenweg 365,2022-07-20,00:00:00,0,0,0,FMN GV 05 Lier
60,Mechelsesteenweg 365,2022-07-20,01:00:00,4,2,2,FMN GV 05 Lier
60,Mechelsesteenweg 365,2022-07-20,02:00:00,0,0,0,FMN GV 05 Lier
60,Mechelsesteenweg 365,2022-07-20,03:00:00,0,0,0,FMN GV 05 Lier
60,Mechelsesteenweg 365,2022-07-20,04:00:00,0,0,0,FMN GV 05 Lier
60,Mechelsesteenweg 365,2022-07-20,05:00:00,0,0,0,FMN GV 05 Lier
60,Mechelsesteenweg 365,2022-07-20,06:00:00,26,8,18,FMN GV 05 Lier
60,Mechelsesteenweg 365,2022-07-20,07:00:00,64,22,42,FMN GV 05 Lier
60,Mechelsesteenweg 365,2022-07-20,08:00:00,76,18,58,FMN GV 05 Lier
60,Mechelsesteenweg 365,2022-07-20,09:00:00,76,38,38,FMN GV 05 Lier
60,Mechelsesteenweg 365,2022-07-20,10:00:00,106,56,50,FMN GV 05 Lier
60,Mechelsesteenweg 365,2022-07-20,11:00:00,126,68,58,FMN GV 05 Lier
60,Mechelsesteenweg 365,2022-07-20,12:00:00,64,24,40,FMN GV 05 Lier
60,Mechelsesteenweg 365,2022-07-20,13:00:00,62,22,40,FMN GV 05 Lier
60,Mechelsesteenweg 365,2022-07-20,14:00:00,108,82,26,FMN GV 05 Lier
60,Mechelsesteenweg 365,2022-07-20,15:00:00,78,56,22,FMN GV 05 Lier
60,Mechelsesteenweg 365,2022-07-20,16:00:00,86,52,34,FMN GV 05 Lier
60,Mechelsesteenweg 365,2022-07-20,17:00:00,80,42,38,FMN GV 05 Lier
60,Mechelsesteenweg 365,2022-07-20,18:00:00,48,26,22,FMN GV 05 Lier
60,Mechelsesteenweg 365,2022-07-20,19:00:00,50,22,28,FMN GV 05 Lier
60,Mechelsesteenweg 365,2022-07-20,20:00:00,30,30,0,FMN GV 05 Lier
60,Mechelsesteenweg 365,2022-07-20,21:00:00,6,6,0,FMN GV 05 Lier
60,Mechelsesteenweg 365,2022-07-20,22:00:00,6,2,4,FMN GV 05 Lier
60,Mechelsesteenweg 365,2022-07-20,23:00:00,0,0,0,FMN GV 05 Lier
60,Mechelsesteenweg 365,2022-07-21,00:00:00,2,2,0,FMN GV 05 Lier
60,Mechelsesteenweg 365,2022-07-21,01:00:00,0,0,0,FMN GV 05 Lier
60,Mechelsesteenweg 365,2022-07-21,02:00:00,0,0,0,FMN GV 05 Lier
60,Mechelsesteenweg 365,2022-07-21,03:00:00,0,0,0,FMN GV 05 Lier
60,Mechelsesteenweg 365,2022-07-21,04:00:00,2,0,2,FMN GV 05 Lier
60,Mechelsesteenweg 365,2022-07-21,05:00:00,2,0,2,FMN GV 05 Lier
60,Mechelsesteenweg 365,2022-07-21,06:00:00,12,6,6,FMN GV 05 Lier
60,Mechelsesteenweg 365,2022-07-21,07:00:00,6,4,2,FMN GV 05 Lier
60,Mechelsesteenweg 365,2022-07-21,08:00:00,50,42,8,FMN GV 05 Lier
60,Mechelsesteenweg 365,2022-07-21,09:00:00,44,36,8,FMN GV 05 Lier
60,Mechelsesteenweg 365,2022-07-21,10:00:00,20,8,12,FMN GV 05 Lier
60,Mechelsesteenweg 365,2022-07-21,11:00:00,40,22,18,FMN GV 05 Lier
60,Mechelsesteenweg 365,2022-07-21,12:00:00,104,52,52,FMN GV 05 Lier
60,Mechelsesteenweg 365,2022-07-21,13:00:00,54,32,22,FMN GV 05 Lier
60,Mechelsesteenweg 365,2022-07-21,14:00:00,56,32,24,FMN GV 05 Lier
60,Mechelsesteenweg 365,2022-07-21,15:00:00,60,32,28,FMN GV 05 Lier
60,Mechelsesteenweg 365,2022-07-21,16:00:00,58,36,22,FMN GV 05 Lier
60,Mechelsesteenweg 365,2022-07-21,17:00:00,90,34,56,FMN GV 05 Lier
60,Mechelsesteenweg 365,2022-07-21,18:00:00,28,12,16,FMN GV 05 Lier
60,Mechelsesteenweg 365,2022-07-21,19:00:00,84,16,68,FMN GV 05 Lier
60,Mechelsesteenweg 365,2022-07-21,20:00:00,82,36,46,FMN GV 05 Lier
60,Mechelsesteenweg 365,2022-07-21,21:00:00,14,8,6,FMN GV 05 Lier
60,Mechelsesteenweg 365,2022-07-21,22:00:00,4,0,4,FMN GV 05 Lier
60,Mechelsesteenweg 365,2022-07-21,23:00:00,0,0,0,FMN GV 05 Lier
60,Mechelsesteenweg 365,2022-07-22,00:00:00,0,0,0,FMN GV 05 Lier
60,Mechelsesteenweg 365,2022-07-22,01:00:00,0,0,0,FMN GV 05 Lier
60,Mechelsesteenweg 365,2022-07-22,02:00:00,0,0,0,FMN GV 05 Lier
60,Mechelsesteenweg 365,2022-07-22,03:00:00,0,0,0,FMN GV 05 Lier
60,Mechelsesteenweg 365,2022-07-22,04:00:00,0,0,0,FMN GV 05 Lier
60,Mechelsesteenweg 365,2022-07-22,05:00:00,2,0,2,FMN GV 05 Lier
60,Mechelsesteenweg 365,2022-07-22,06:00:00,14,8,6,FMN GV 05 Lier
60,Mechelsesteenweg 365,2022-07-22,07:00:00,42,14,28,FMN GV 05 Lier
60,Mechelsesteenweg 365,2022-07-22,08:00:00,58,34,24,FMN GV 05 Lier
60,Mechelsesteenweg 365,2022-07-22,09:00:00,112,68,44,FMN GV 05 Lier
60,Mechelsesteenweg 365,2022-07-22,10:00:00,168,68,100,FMN GV 05 Lier
60,Mechelsesteenweg 365,2022-07-22,11:00:00,270,100,170,FMN GV 05 Lier
60,Mechelsesteenweg 365,2022-07-22,12:00:00,222,122,100,FMN GV 05 Lier
60,Mechelsesteenweg 365,2022-07-22,13:00:00,140,66,74,FMN GV 05 Lier
60,Mechelsesteenweg 365,2022-07-22,14:00:00,282,132,150,FMN GV 05 Lier
60,Mechelsesteenweg 365,2022-07-22,15:00:00,242,128,114,FMN GV 05 Lier
60,Mechelsesteenweg 365,2022-07-22,16:00:00,212,84,128,FMN GV 05 Lier
60,Mechelsesteenweg 365,2022-07-22,17:00:00,168,94,74,FMN GV 05 Lier
60,Mechelsesteenweg 365,2022-07-22,18:00:00,54,28,26,FMN GV 05 Lier
60,Mechelsesteenweg 365,2022-07-22,19:00:00,56,34,22,FMN GV 05 Lier
60,Mechelsesteenweg 365,2022-07-22,20:00:00,22,10,12,FMN GV 05 Lier
60,Mechelsesteenweg 365,2022-07-22,21:00:00,8,4,4,FMN GV 05 Lier
60,Mechelsesteenweg 365,2022-07-22,22:00:00,2,0,2,FMN GV 05 Lier
60,Mechelsesteenweg 365,2022-07-22,23:00:00,2,0,2,FMN GV 05 Lier
60,Mechelsesteenweg 365,2022-07-23,00:00:00,8,8,0,FMN GV 05 Lier
60,Mechelsesteenweg 365,2022-07-23,01:00:00,0,0,0,FMN GV 05 Lier
60,Mechelsesteenweg 365,2022-07-23,02:00:00,0,0,0,FMN GV 05 Lier
60,Mechelsesteenweg 365,2022-07-23,03:00:00,0,0,0,FMN GV 05 Lier
60,Mechelsesteenweg 365,2022-07-23,04:00:00,0,0,0,FMN GV 05 Lier
60,Mechelsesteenweg 365,2022-07-23,05:00:00,2,0,2,FMN GV 05 Lier
60,Mechelsesteenweg 365,2022-07-23,06:00:00,4,0,4,FMN GV 05 Lier
60,Mechelsesteenweg 365,2022-07-23,07:00:00,18,10,8,FMN GV 05 Lier
60,Mechelsesteenweg 365,2022-07-23,08:00:00,32,22,10,FMN GV 05 Lier
60,Mechelsesteenweg 365,2022-07-23,09:00:00,82,54,28,FMN GV 05 Lier
60,Mechelsesteenweg 365,2022-07-23,10:00:00,214,106,108,FMN GV 05 Lier
60,Mechelsesteenweg 365,2022-07-23,11:00:00,250,86,164,FMN GV 05 Lier
60,Mechelsesteenweg 365,2022-07-23,12:00:00,12,6,6,FMN GV 05 Lier
60,Mechelsesteenweg 365,2022-07-23,13:00:00,0,0,0,FMN GV 05 Lier
60,Mechelsesteenweg 365,2022-07-23,14:00:00,0,0,0,FMN GV 05 Lier
60,Mechelsesteenweg 365,2022-07-23,15:00:00,0,0,0,FMN GV 05 Lier
60,Mechelsesteenweg 365,2022-07-23,16:00:00,0,0,0,FMN GV 05 Lier
60,Mechelsesteenweg 365,2022-07-23,17:00:00,4,0,4,FMN GV 05 Lier
60,Mechelsesteenweg 365,2022-07-23,18:00:00,96,32,64,FMN GV 05 Lier
60,Mechelsesteenweg 365,2022-07-23,19:00:00,58,22,36,FMN GV 05 Lier
60,Mechelsesteenweg 365,2022-07-23,20:00:00,64,28,36,FMN GV 05 Lier
60,Mechelsesteenweg 365,2022-07-23,21:00:00,34,6,28,FMN GV 05 Lier
60,Mechelsesteenweg 365,2022-07-23,22:00:00,14,8,6,FMN GV 05 Lier
60,Mechelsesteenweg 365,2022-07-23,23:00:00,2,0,2,FMN GV 05 Lier
60,Mechelsesteenweg 365,2022-07-24,00:00:00,0,0,0,FMN GV 05 Lier
60,Mechelsesteenweg 365,2022-07-24,01:00:00,2,2,0,FMN GV 05 Lier
60,Mechelsesteenweg 365,2022-07-24,02:00:00,0,0,0,FMN GV 05 Lier
60,Mechelsesteenweg 365,2022-07-24,03:00:00,0,0,0,FMN GV 05 Lier
60,Mechelsesteenweg 365,2022-07-24,04:00:00,6,6,0,FMN GV 05 Lier
60,Mechelsesteenweg 365,2022-07-24,05:00:00,4,0,4,FMN GV 05 Lier
60,Mechelsesteenweg 365,2022-07-24,06:00:00,8,2,6,FMN GV 05 Lier
60,Mechelsesteenweg 365,2022-07-24,07:00:00,20,10,10,FMN GV 05 Lier
60,Mechelsesteenweg 365,2022-07-24,08:00:00,44,18,26,FMN GV 05 Lier
60,Mechelsesteenweg 365,2022-07-24,09:00:00,310,142,168,FMN GV 05 Lier
60,Mechelsesteenweg 365,2022-07-24,10:00:00,490,250,240,FMN GV 05 Lier
60,Mechelsesteenweg 365,2022-07-24,11:00:00,274,154,120,FMN GV 05 Lier
60,Mechelsesteenweg 365,2022-07-24,12:00:00,0,0,0,FMN GV 05 Lier
60,Mechelsesteenweg 365,2022-07-24,13:00:00,0,0,0,FMN GV 05 Lier
60,Mechelsesteenweg 365,2022-07-24,14:00:00,0,0,0,FMN GV 05 Lier
60,Mechelsesteenweg 365,2022-07-24,15:00:00,0,0,0,FMN GV 05 Lier
60,Mechelsesteenweg 365,2022-07-24,16:00:00,0,0,0,FMN GV 05 Lier
60,Mechelsesteenweg 365,2022-07-24,17:00:00,0,0,0,FMN GV 05 Lier
60,Mechelsesteenweg 365,2022-07-24,18:00:00,20,2,18,FMN GV 05 Lier
60,Mechelsesteenweg 365,2022-07-24,19:00:00,26,10,16,FMN GV 05 Lier
60,Mechelsesteenweg 365,2022-07-24,20:00:00,58,26,32,FMN GV 05 Lier
60,Mechelsesteenweg 365,2022-07-24,21:00:00,74,24,50,FMN GV 05 Lier
60,Mechelsesteenweg 365,2022-07-24,22:00:00,8,4,4,FMN GV 05 Lier
60,Mechelsesteenweg 365,2022-07-24,23:00:00,0,0,0,FMN GV 05 Lier
60,Mechelsesteenweg 365,2022-07-25,00:00:00,4,2,2,FMN GV 05 Lier
60,Mechelsesteenweg 365,2022-07-25,01:00:00,4,4,0,FMN GV 05 Lier
60,Mechelsesteenweg 365,2022-07-25,02:00:00,0,0,0,FMN GV 05 Lier
60,Mechelsesteenweg 365,2022-07-25,03:00:00,0,0,0,FMN GV 05 Lier
60,Mechelsesteenweg 365,2022-07-25,04:00:00,6,0,6,FMN GV 05 Lier
60,Mechelsesteenweg 365,2022-07-25,05:00:00,0,0,0,FMN GV 05 Lier
60,Mechelsesteenweg 365,2022-07-25,06:00:00,30,10,20,FMN GV 05 Lier
60,Mechelsesteenweg 365,2022-07-25,07:00:00,62,22,40,FMN GV 05 Lier
60,Mechelsesteenweg 365,2022-07-25,08:00:00,58,10,48,FMN GV 05 Lier
60,Mechelsesteenweg 365,2022-07-25,09:00:00,80,26,54,FMN GV 05 Lier
60,Mechelsesteenweg 365,2022-07-25,10:00:00,94,38,56,FMN GV 05 Lier
60,Mechelsesteenweg 365,2022-07-25,11:00:00,132,66,66,FMN GV 05 Lier
60,Mechelsesteenweg 365,2022-07-25,12:00:00,114,74,40,FMN GV 05 Lier
60,Mechelsesteenweg 365,2022-07-25,13:00:00,104,50,54,FMN GV 05 Lier
60,Mechelsesteenweg 365,2022-07-25,14:00:00,158,74,84,FMN GV 05 Lier
60,Mechelsesteenweg 365,2022-07-25,15:00:00,116,52,64,FMN GV 05 Lier
60,Mechelsesteenweg 365,2022-07-25,16:00:00,112,62,50,FMN GV 05 Lier
60,Mechelsesteenweg 365,2022-07-25,17:00:00,104,66,38,FMN GV 05 Lier
60,Mechelsesteenweg 365,2022-07-25,18:00:00,98,54,44,FMN GV 05 Lier
60,Mechelsesteenweg 365,2022-07-25,19:00:00,62,24,38,FMN GV 05 Lier
60,Mechelsesteenweg 365,2022-07-25,20:00:00,16,6,10,FMN GV 05 Lier
60,Mechelsesteenweg 365,2022-07-25,21:00:00,20,12,8,FMN GV 05 Lier
60,Mechelsesteenweg 365,2022-07-25,22:00:00,2,2,0,FMN GV 05 Lier
60,Mechelsesteenweg 365,2022-07-25,23:00:00,4,4,0,FMN GV 05 Lier
60,Mechelsesteenweg 365,2022-07-26,00:00:00,0,0,0,FMN GV 05 Lier
60,Mechelsesteenweg 365,2022-07-26,01:00:00,0,0,0,FMN GV 05 Lier
60,Mechelsesteenweg 365,2022-07-26,02:00:00,0,0,0,FMN GV 05 Lier
60,Mechelsesteenweg 365,2022-07-26,03:00:00,0,0,0,FMN GV 05 Lier
60,Mechelsesteenweg 365,2022-07-26,04:00:00,2,0,2,FMN GV 05 Lier
60,Mechelsesteenweg 365,2022-07-26,05:00:00,4,2,2,FMN GV 05 Lier
60,Mechelsesteenweg 365,2022-07-26,06:00:00,32,10,22,FMN GV 05 Lier
60,Mechelsesteenweg 365,2022-07-26,07:00:00,84,22,62,FMN GV 05 Lier
60,Mechelsesteenweg 365,2022-07-26,08:00:00,78,22,56,FMN GV 05 Lier
60,Mechelsesteenweg 365,2022-07-26,09:00:00,78,36,42,FMN GV 05 Lier
60,Mechelsesteenweg 365,2022-07-26,10:00:00,132,60,72,FMN GV 05 Lier
60,Mechelsesteenweg 365,2022-07-26,11:00:00,136,94,42,FMN GV 05 Lier
60,Mechelsesteenweg 365,2022-07-26,12:00:00,72,38,34,FMN GV 05 Lier
60,Mechelsesteenweg 365,2022-07-26,13:00:00,106,60,46,FMN GV 05 Lier
60,Mechelsesteenweg 365,2022-07-26,14:00:00,138,56,82,FMN GV 05 Lier
60,Mechelsesteenweg 365,2022-07-26,15:00:00,52,18,34,FMN GV 05 Lier
60,Mechelsesteenweg 365,2022-07-26,16:00:00,84,52,32,FMN GV 05 Lier
60,Mechelsesteenweg 365,2022-07-26,17:00:00,76,36,40,FMN GV 05 Lier
60,Mechelsesteenweg 365,2022-07-26,18:00:00,56,42,14,FMN GV 05 Lier
60,Mechelsesteenweg 365,2022-07-26,19:00:00,90,42,48,FMN GV 05 Lier
60,Mechelsesteenweg 365,2022-07-26,20:00:00,52,32,20,FMN GV 05 Lier
60,Mechelsesteenweg 365,2022-07-26,21:00:00,22,10,12,FMN GV 05 Lier
60,Mechelsesteenweg 365,2022-07-26,22:00:00,6,2,4,FMN GV 05 Lier
60,Mechelsesteenweg 365,2022-07-26,23:00:00,2,2,0,FMN GV 05 Lier
60,Mechelsesteenweg 365,2022-07-27,00:00:00,0,0,0,FMN GV 05 Lier
60,Mechelsesteenweg 365,2022-07-27,01:00:00,0,0,0,FMN GV 05 Lier
60,Mechelsesteenweg 365,2022-07-27,02:00:00,0,0,0,FMN GV 05 Lier
60,Mechelsesteenweg 365,2022-07-27,03:00:00,0,0,0,FMN GV 05 Lier
60,Mechelsesteenweg 365,2022-07-27,04:00:00,4,0,4,FMN GV 05 Lier
60,Mechelsesteenweg 365,2022-07-27,05:00:00,4,0,4,FMN GV 05 Lier
60,Mechelsesteenweg 365,2022-07-27,06:00:00,28,4,24,FMN GV 05 Lier
60,Mechelsesteenweg 365,2022-07-27,07:00:00,62,12,50,FMN GV 05 Lier
60,Mechelsesteenweg 365,2022-07-27,08:00:00,94,40,54,FMN GV 05 Lier
60,Mechelsesteenweg 365,2022-07-27,09:00:00,104,58,46,FMN GV 05 Lier
60,Mechelsesteenweg 365,2022-07-27,10:00:00,202,80,122,FMN GV 05 Lier
60,Mechelsesteenweg 365,2022-07-27,11:00:00,124,60,64,FMN GV 05 Lier
60,Mechelsesteenweg 365,2022-07-27,12:00:00,138,74,64,FMN GV 05 Lier
60,Mechelsesteenweg 365,2022-07-27,13:00:00,16,8,8,FMN GV 05 Lier
60,Mechelsesteenweg 365,2022-07-27,14:00:00,0,0,0,FMN GV 05 Lier
60,Mechelsesteenweg 365,2022-07-27,15:00:00,142,88,54,FMN GV 05 Lier
60,Mechelsesteenweg 365,2022-07-27,16:00:00,110,44,66,FMN GV 05 Lier
60,Mechelsesteenweg 365,2022-07-27,17:00:00,172,86,86,FMN GV 05 Lier
60,Mechelsesteenweg 365,2022-07-27,18:00:00,142,54,88,FMN GV 05 Lier
60,Mechelsesteenweg 365,2022-07-27,19:00:00,136,80,56,FMN GV 05 Lier
60,Mechelsesteenweg 365,2022-07-27,20:00:00,192,114,78,FMN GV 05 Lier
60,Mechelsesteenweg 365,2022-07-27,21:00:00,42,14,28,FMN GV 05 Lier
60,Mechelsesteenweg 365,2022-07-27,22:00:00,18,10,8,FMN GV 05 Lier
60,Mechelsesteenweg 365,2022-07-27,23:00:00,2,2,0,FMN GV 05 Lier
60,Mechelsesteenweg 365,2022-07-28,00:00:00,0,0,0,FMN GV 05 Lier
60,Mechelsesteenweg 365,2022-07-28,01:00:00,2,0,2,FMN GV 05 Lier
60,Mechelsesteenweg 365,2022-07-28,02:00:00,0,0,0,FMN GV 05 Lier
60,Mechelsesteenweg 365,2022-07-28,03:00:00,0,0,0,FMN GV 05 Lier
60,Mechelsesteenweg 365,2022-07-28,04:00:00,2,0,2,FMN GV 05 Lier
60,Mechelsesteenweg 365,2022-07-28,05:00:00,6,2,4,FMN GV 05 Lier
60,Mechelsesteenweg 365,2022-07-28,06:00:00,26,6,20,FMN GV 05 Lier
60,Mechelsesteenweg 365,2022-07-28,07:00:00,64,20,44,FMN GV 05 Lier
60,Mechelsesteenweg 365,2022-07-28,08:00:00,72,30,42,FMN GV 05 Lier
60,Mechelsesteenweg 365,2022-07-28,09:00:00,70,42,28,FMN GV 05 Lier
60,Mechelsesteenweg 365,2022-07-28,10:00:00,106,52,54,FMN GV 05 Lier
60,Mechelsesteenweg 365,2022-07-28,11:00:00,136,60,76,FMN GV 05 Lier
60,Mechelsesteenweg 365,2022-07-28,12:00:00,126,46,80,FMN GV 05 Lier
60,Mechelsesteenweg 365,2022-07-28,13:00:00,202,98,104,FMN GV 05 Lier
60,Mechelsesteenweg 365,2022-07-28,14:00:00,184,92,92,FMN GV 05 Lier
60,Mechelsesteenweg 365,2022-07-28,15:00:00,184,84,100,FMN GV 05 Lier
60,Mechelsesteenweg 365,2022-07-28,16:00:00,146,66,80,FMN GV 05 Lier
60,Mechelsesteenweg 365,2022-07-28,17:00:00,192,94,98,FMN GV 05 Lier
60,Mechelsesteenweg 365,2022-07-28,18:00:00,144,86,58,FMN GV 05 Lier
60,Mechelsesteenweg 365,2022-07-28,19:00:00,138,74,64,FMN GV 05 Lier
60,Mechelsesteenweg 365,2022-07-28,20:00:00,144,64,80,FMN GV 05 Lier
60,Mechelsesteenweg 365,2022-07-28,21:00:00,26,6,20,FMN GV 05 Lier
60,Mechelsesteenweg 365,2022-07-28,22:00:00,8,4,4,FMN GV 05 Lier
60,Mechelsesteenweg 365,2022-07-28,23:00:00,14,2,12,FMN GV 05 Lier
60,Mechelsesteenweg 365,2022-07-29,00:00:00,2,0,2,FMN GV 05 Lier
60,Mechelsesteenweg 365,2022-07-29,01:00:00,0,0,0,FMN GV 05 Lier
60,Mechelsesteenweg 365,2022-07-29,02:00:00,0,0,0,FMN GV 05 Lier
60,Mechelsesteenweg 365,2022-07-29,03:00:00,0,0,0,FMN GV 05 Lier
60,Mechelsesteenweg 365,2022-07-29,04:00:00,4,0,4,FMN GV 05 Lier
60,Mechelsesteenweg 365,2022-07-29,05:00:00,6,0,6,FMN GV 05 Lier
60,Mechelsesteenweg 365,2022-07-29,06:00:00,14,2,12,FMN GV 05 Lier
60,Mechelsesteenweg 365,2022-07-29,07:00:00,50,18,32,FMN GV 05 Lier
60,Mechelsesteenweg 365,2022-07-29,08:00:00,60,22,38,FMN GV 05 Lier
60,Mechelsesteenweg 365,2022-07-29,09:00:00,92,26,66,FMN GV 05 Lier
60,Mechelsesteenweg 365,2022-07-29,10:00:00,174,82,92,FMN GV 05 Lier
60,Mechelsesteenweg 365,2022-07-29,11:00:00,112,48,64,FMN GV 05 Lier
60,Mechelsesteenweg 365,2022-07-29,12:00:00,8,4,4,FMN GV 05 Lier
60,Mechelsesteenweg 365,2022-07-29,13:00:00,0,0,0,FMN GV 05 Lier
60,Mechelsesteenweg 365,2022-07-29,14:00:00,36,10,26,FMN GV 05 Lier
60,Mechelsesteenweg 365,2022-07-29,15:00:00,78,38,40,FMN GV 05 Lier
60,Mechelsesteenweg 365,2022-07-29,16:00:00,0,0,0,FMN GV 05 Lier
60,Mechelsesteenweg 365,2022-07-29,17:00:00,24,14,10,FMN GV 05 Lier
60,Mechelsesteenweg 365,2022-07-29,18:00:00,100,54,46,FMN GV 05 Lier
60,Mechelsesteenweg 365,2022-07-29,19:00:00,100,50,50,FMN GV 05 Lier
60,Mechelsesteenweg 365,2022-07-29,20:00:00,78,38,40,FMN GV 05 Lier
60,Mechelsesteenweg 365,2022-07-29,21:00:00,48,30,18,FMN GV 05 Lier
60,Mechelsesteenweg 365,2022-07-29,22:00:00,16,6,10,FMN GV 05 Lier
60,Mechelsesteenweg 365,2022-07-29,23:00:00,12,2,10,FMN GV 05 Lier
60,Mechelsesteenweg 365,2022-07-30,00:00:00,4,2,2,FMN GV 05 Lier
60,Mechelsesteenweg 365,2022-07-30,01:00:00,14,6,8,FMN GV 05 Lier
60,Mechelsesteenweg 365,2022-07-30,02:00:00,0,0,0,FMN GV 05 Lier
60,Mechelsesteenweg 365,2022-07-30,03:00:00,0,0,0,FMN GV 05 Lier
60,Mechelsesteenweg 365,2022-07-30,04:00:00,0,0,0,FMN GV 05 Lier
60,Mechelsesteenweg 365,2022-07-30,05:00:00,4,2,2,FMN GV 05 Lier
60,Mechelsesteenweg 365,2022-07-30,06:00:00,4,2,2,FMN GV 05 Lier
60,Mechelsesteenweg 365,2022-07-30,07:00:00,8,4,4,FMN GV 05 Lier
60,Mechelsesteenweg 365,2022-07-30,08:00:00,36,10,26,FMN GV 05 Lier
60,Mechelsesteenweg 365,2022-07-30,09:00:00,154,74,80,FMN GV 05 Lier
60,Mechelsesteenweg 365,2022-07-30,10:00:00,214,108,106,FMN GV 05 Lier
60,Mechelsesteenweg 365,2022-07-30,11:00:00,180,96,84,FMN GV 05 Lier
60,Mechelsesteenweg 365,2022-07-30,12:00:00,148,64,84,FMN GV 05 Lier
60,Mechelsesteenweg 365,2022-07-30,13:00:00,68,24,44,FMN GV 05 Lier
60,Mechelsesteenweg 365,2022-07-30,14:00:00,12,6,6,FMN GV 05 Lier
60,Mechelsesteenweg 365,2022-07-30,15:00:00,68,26,42,FMN GV 05 Lier
60,Mechelsesteenweg 365,2022-07-30,16:00:00,56,18,38,FMN GV 05 Lier
60,Mechelsesteenweg 365,2022-07-30,17:00:00,104,34,70,FMN GV 05 Lier
60,Mechelsesteenweg 365,2022-07-30,18:00:00,78,48,30,FMN GV 05 Lier
60,Mechelsesteenweg 365,2022-07-30,19:00:00,66,28,38,FMN GV 05 Lier
60,Mechelsesteenweg 365,2022-07-30,20:00:00,50,22,28,FMN GV 05 Lier
60,Mechelsesteenweg 365,2022-07-30,21:00:00,26,6,20,FMN GV 05 Lier
60,Mechelsesteenweg 365,2022-07-30,22:00:00,12,0,12,FMN GV 05 Lier
60,Mechelsesteenweg 365,2022-07-30,23:00:00,2,2,0,FMN GV 05 Lier
60,Mechelsesteenweg 365,2022-07-31,00:00:00,10,0,10,FMN GV 05 Lier
60,Mechelsesteenweg 365,2022-07-31,01:00:00,2,2,0,FMN GV 05 Lier
60,Mechelsesteenweg 365,2022-07-31,02:00:00,4,4,0,FMN GV 05 Lier
60,Mechelsesteenweg 365,2022-07-31,03:00:00,0,0,0,FMN GV 05 Lier
60,Mechelsesteenweg 365,2022-07-31,04:00:00,0,0,0,FMN GV 05 Lier
60,Mechelsesteenweg 365,2022-07-31,05:00:00,2,0,2,FMN GV 05 Lier
60,Mechelsesteenweg 365,2022-07-31,06:00:00,4,2,2,FMN GV 05 Lier
60,Mechelsesteenweg 365,2022-07-31,07:00:00,16,8,8,FMN GV 05 Lier
60,Mechelsesteenweg 365,2022-07-31,08:00:00,94,56,38,FMN GV 05 Lier
60,Mechelsesteenweg 365,2022-07-31,09:00:00,212,126,86,FMN GV 05 Lier
60,Mechelsesteenweg 365,2022-07-31,10:00:00,404,232,172,FMN GV 05 Lier
60,Mechelsesteenweg 365,2022-07-31,11:00:00,468,258,210,FMN GV 05 Lier
60,Mechelsesteenweg 365,2022-07-31,12:00:00,218,116,102,FMN GV 05 Lier
60,Mechelsesteenweg 365,2022-07-31,13:00:00,194,92,102,FMN GV 05 Lier
60,Mechelsesteenweg 365,2022-07-31,14:00:00,224,112,112,FMN GV 05 Lier
60,Mechelsesteenweg 365,2022-07-31,15:00:00,204,90,114,FMN GV 05 Lier
60,Mechelsesteenweg 365,2022-07-31,16:00:00,120,66,54,FMN GV 05 Lier
60,Mechelsesteenweg 365,2022-07-31,17:00:00,122,46,76,FMN GV 05 Lier
60,Mechelsesteenweg 365,2022-07-31,18:00:00,52,24,28,FMN GV 05 Lier
60,Mechelsesteenweg 365,2022-07-31,19:00:00,60,16,44,FMN GV 05 Lier
60,Mechelsesteenweg 365,2022-07-31,20:00:00,28,12,16,FMN GV 05 Lier
60,Mechelsesteenweg 365,2022-07-31,21:00:00,22,4,18,FMN GV 05 Lier
60,Mechelsesteenweg 365,2022-07-31,22:00:00,10,2,8,FMN GV 05 Lier
60,Mechelsesteenweg 365,2022-07-31,23:00:00,2,2,0,FMN GV 05 Lier
60,Mechelsesteenweg 365,2022-08-01,00:00:00,2,2,0,FMN GV 05 Lier
60,Mechelsesteenweg 365,2022-08-01,01:00:00,0,0,0,FMN GV 05 Lier
60,Mechelsesteenweg 365,2022-08-01,02:00:00,2,0,2,FMN GV 05 Lier
60,Mechelsesteenweg 365,2022-08-01,03:00:00,0,0,0,FMN GV 05 Lier
60,Mechelsesteenweg 365,2022-08-01,04:00:00,0,0,0,FMN GV 05 Lier
60,Mechelsesteenweg 365,2022-08-01,05:00:00,14,2,12,FMN GV 05 Lier
60,Mechelsesteenweg 365,2022-08-01,06:00:00,44,12,32,FMN GV 05 Lier
60,Mechelsesteenweg 365,2022-08-01,07:00:00,78,14,64,FMN GV 05 Lier
60,Mechelsesteenweg 365,2022-08-01,08:00:00,62,28,34,FMN GV 05 Lier
60,Mechelsesteenweg 365,2022-08-01,09:00:00,52,22,30,FMN GV 05 Lier
60,Mechelsesteenweg 365,2022-08-01,10:00:00,90,32,58,FMN GV 05 Lier
60,Mechelsesteenweg 365,2022-08-01,11:00:00,100,46,54,FMN GV 05 Lier
60,Mechelsesteenweg 365,2022-08-01,12:00:00,68,40,28,FMN GV 05 Lier
60,Mechelsesteenweg 365,2022-08-01,13:00:00,120,60,60,FMN GV 05 Lier
60,Mechelsesteenweg 365,2022-08-01,14:00:00,134,60,74,FMN GV 05 Lier
60,Mechelsesteenweg 365,2022-08-01,15:00:00,16,2,14,FMN GV 05 Lier
60,Mechelsesteenweg 365,2022-08-01,16:00:00,0,0,0,FMN GV 05 Lier
60,Mechelsesteenweg 365,2022-08-01,17:00:00,30,10,20,FMN GV 05 Lier
60,Mechelsesteenweg 365,2022-08-01,18:00:00,84,42,42,FMN GV 05 Lier
60,Mechelsesteenweg 365,2022-08-01,19:00:00,128,76,52,FMN GV 05 Lier
60,Mechelsesteenweg 365,2022-08-01,20:00:00,112,36,76,FMN GV 05 Lier
60,Mechelsesteenweg 365,2022-08-01,21:00:00,56,20,36,FMN GV 05 Lier
60,Mechelsesteenweg 365,2022-08-01,22:00:00,14,4,10,FMN GV 05 Lier
60,Mechelsesteenweg 365,2022-08-01,23:00:00,10,6,4,FMN GV 05 Lier
60,Mechelsesteenweg 365,2022-08-02,00:00:00,0,0,0,FMN GV 05 Lier
60,Mechelsesteenweg 365,2022-08-02,01:00:00,0,0,0,FMN GV 05 Lier
60,Mechelsesteenweg 365,2022-08-02,02:00:00,0,0,0,FMN GV 05 Lier
60,Mechelsesteenweg 365,2022-08-02,03:00:00,0,0,0,FMN GV 05 Lier
60,Mechelsesteenweg 365,2022-08-02,04:00:00,4,0,4,FMN GV 05 Lier
60,Mechelsesteenweg 365,2022-08-02,05:00:00,6,2,4,FMN GV 05 Lier
60,Mechelsesteenweg 365,2022-08-02,06:00:00,48,10,38,FMN GV 05 Lier
60,Mechelsesteenweg 365,2022-08-02,07:00:00,114,28,86,FMN GV 05 Lier
60,Mechelsesteenweg 365,2022-08-02,08:00:00,102,46,56,FMN GV 05 Lier
60,Mechelsesteenweg 365,2022-08-02,09:00:00,142,52,90,FMN GV 05 Lier
60,Mechelsesteenweg 365,2022-08-02,10:00:00,246,110,136,FMN GV 05 Lier
60,Mechelsesteenweg 365,2022-08-02,11:00:00,254,156,98,FMN GV 05 Lier
60,Mechelsesteenweg 365,2022-08-02,12:00:00,72,42,30,FMN GV 05 Lier
60,Mechelsesteenweg 365,2022-08-02,13:00:00,30,8,22,FMN GV 05 Lier
60,Mechelsesteenweg 365,2022-08-02,14:00:00,0,0,0,FMN GV 05 Lier
60,Mechelsesteenweg 365,2022-08-02,15:00:00,0,0,0,FMN GV 05 Lier
60,Mechelsesteenweg 365,2022-08-02,16:00:00,0,0,0,FMN GV 05 Lier
60,Mechelsesteenweg 365,2022-08-02,17:00:00,20,10,10,FMN GV 05 Lier
60,Mechelsesteenweg 365,2022-08-02,18:00:00,110,54,56,FMN GV 05 Lier
60,Mechelsesteenweg 365,2022-08-02,19:00:00,116,68,48,FMN GV 05 Lier
60,Mechelsesteenweg 365,2022-08-02,20:00:00,148,90,58,FMN GV 05 Lier
60,Mechelsesteenweg 365,2022-08-02,21:00:00,80,32,48,FMN GV 05 Lier
60,Mechelsesteenweg 365,2022-08-02,22:00:00,30,0,30,FMN GV 05 Lier
60,Mechelsesteenweg 365,2022-08-02,23:00:00,8,2,6,FMN GV 05 Lier
60,Mechelsesteenweg 365,2022-08-03,00:00:00,0,0,0,FMN GV 05 Lier
60,Mechelsesteenweg 365,2022-08-03,01:00:00,2,0,2,FMN GV 05 Lier
60,Mechelsesteenweg 365,2022-08-03,02:00:00,0,0,0,FMN GV 05 Lier
60,Mechelsesteenweg 365,2022-08-03,03:00:00,0,0,0,FMN GV 05 Lier
60,Mechelsesteenweg 365,2022-08-03,04:00:00,6,0,6,FMN GV 05 Lier
60,Mechelsesteenweg 365,2022-08-03,05:00:00,8,4,4,FMN GV 05 Lier
60,Mechelsesteenweg 365,2022-08-03,06:00:00,46,14,32,FMN GV 05 Lier
60,Mechelsesteenweg 365,2022-08-03,07:00:00,92,32,60,FMN GV 05 Lier
60,Mechelsesteenweg 365,2022-08-03,08:00:00,90,52,38,FMN GV 05 Lier
60,Mechelsesteenweg 365,2022-08-03,09:00:00,124,50,74,FMN GV 05 Lier
60,Mechelsesteenweg 365,2022-08-03,10:00:00,200,128,72,FMN GV 05 Lier
60,Mechelsesteenweg 365,2022-08-03,11:00:00,74,50,24,FMN GV 05 Lier
60,Mechelsesteenweg 365,2022-08-03,12:00:00,0,0,0,FMN GV 05 Lier
60,Mechelsesteenweg 365,2022-08-03,13:00:00,0,0,0,FMN GV 05 Lier
60,Mechelsesteenweg 365,2022-08-03,14:00:00,0,0,0,FMN GV 05 Lier
60,Mechelsesteenweg 365,2022-08-03,15:00:00,0,0,0,FMN GV 05 Lier
60,Mechelsesteenweg 365,2022-08-03,16:00:00,0,0,0,FMN GV 05 Lier
60,Mechelsesteenweg 365,2022-08-03,17:00:00,0,0,0,FMN GV 05 Lier
60,Mechelsesteenweg 365,2022-08-03,18:00:00,36,14,22,FMN GV 05 Lier
60,Mechelsesteenweg 365,2022-08-03,19:00:00,112,48,64,FMN GV 05 Lier
60,Mechelsesteenweg 365,2022-08-03,20:00:00,242,150,92,FMN GV 05 Lier
60,Mechelsesteenweg 365,2022-08-03,21:00:00,82,32,50,FMN GV 05 Lier
60,Mechelsesteenweg 365,2022-08-03,22:00:00,24,12,12,FMN GV 05 Lier
60,Mechelsesteenweg 365,2022-08-03,23:00:00,6,6,0,FMN GV 05 Lier
60,Mechelsesteenweg 365,2022-08-04,00:00:00,2,0,2,FMN GV 05 Lier
60,Mechelsesteenweg 365,2022-08-04,01:00:00,0,0,0,FMN GV 05 Lier
60,Mechelsesteenweg 365,2022-08-04,02:00:00,0,0,0,FMN GV 05 Lier
60,Mechelsesteenweg 365,2022-08-04,03:00:00,0,0,0,FMN GV 05 Lier
60,Mechelsesteenweg 365,2022-08-04,04:00:00,6,0,6,FMN GV 05 Lier
60,Mechelsesteenweg 365,2022-08-04,05:00:00,2,0,2,FMN GV 05 Lier
60,Mechelsesteenweg 365,2022-08-04,06:00:00,52,18,34,FMN GV 05 Lier
60,Mechelsesteenweg 365,2022-08-04,07:00:00,78,20,58,FMN GV 05 Lier
60,Mechelsesteenweg 365,2022-08-04,08:00:00,62,28,34,FMN GV 05 Lier
60,Mechelsesteenweg 365,2022-08-04,09:00:00,160,88,72,FMN GV 05 Lier
60,Mechelsesteenweg 365,2022-08-04,10:00:00,156,82,74,FMN GV 05 Lier
60,Mechelsesteenweg 365,2022-08-04,11:00:00,86,30,56,FMN GV 05 Lier
60,Mechelsesteenweg 365,2022-08-04,12:00:00,98,44,54,FMN GV 05 Lier
60,Mechelsesteenweg 365,2022-08-04,13:00:00,164,100,64,FMN GV 05 Lier
60,Mechelsesteenweg 365,2022-08-04,14:00:00,70,36,34,FMN GV 05 Lier
60,Mechelsesteenweg 365,2022-08-04,15:00:00,0,0,0,FMN GV 05 Lier
60,Mechelsesteenweg 365,2022-08-04,16:00:00,16,4,12,FMN GV 05 Lier
60,Mechelsesteenweg 365,2022-08-04,17:00:00,0,0,0,FMN GV 05 Lier
60,Mechelsesteenweg 365,2022-08-04,18:00:00,80,40,40,FMN GV 05 Lier
60,Mechelsesteenweg 365,2022-08-04,19:00:00,158,84,74,FMN GV 05 Lier
60,Mechelsesteenweg 365,2022-08-04,20:00:00,132,46,86,FMN GV 05 Lier
60,Mechelsesteenweg 365,2022-08-04,21:00:00,42,26,16,FMN GV 05 Lier
60,Mechelsesteenweg 365,2022-08-04,22:00:00,4,2,2,FMN GV 05 Lier
60,Mechelsesteenweg 365,2022-08-04,23:00:00,6,0,6,FMN GV 05 Lier
60,Mechelsesteenweg 365,2022-08-05,00:00:00,0,0,0,FMN GV 05 Lier
60,Mechelsesteenweg 365,2022-08-05,01:00:00,0,0,0,FMN GV 05 Lier
60,Mechelsesteenweg 365,2022-08-05,02:00:00,2,0,2,FMN GV 05 Lier
60,Mechelsesteenweg 365,2022-08-05,03:00:00,0,0,0,FMN GV 05 Lier
60,Mechelsesteenweg 365,2022-08-05,04:00:00,2,0,2,FMN GV 05 Lier
60,Mechelsesteenweg 365,2022-08-05,05:00:00,8,2,6,FMN GV 05 Lier
60,Mechelsesteenweg 365,2022-08-05,06:00:00,28,10,18,FMN GV 05 Lier
60,Mechelsesteenweg 365,2022-08-05,07:00:00,52,10,42,FMN GV 05 Lier
60,Mechelsesteenweg 365,2022-08-05,08:00:00,76,30,46,FMN GV 05 Lier
60,Mechelsesteenweg 365,2022-08-05,09:00:00,64,38,26,FMN GV 05 Lier
60,Mechelsesteenweg 365,2022-08-05,10:00:00,98,50,48,FMN GV 05 Lier
60,Mechelsesteenweg 365,2022-08-05,11:00:00,150,80,70,FMN GV 05 Lier
60,Mechelsesteenweg 365,2022-08-05,12:00:00,104,42,62,FMN GV 05 Lier
60,Mechelsesteenweg 365,2022-08-05,13:00:00,98,48,50,FMN GV 05 Lier
60,Mechelsesteenweg 365,2022-08-05,14:00:00,98,56,42,FMN GV 05 Lier
60,Mechelsesteenweg 365,2022-08-05,15:00:00,64,26,38,FMN GV 05 Lier
60,Mechelsesteenweg 365,2022-08-05,16:00:00,48,26,22,FMN GV 05 Lier
60,Mechelsesteenweg 365,2022-08-05,17:00:00,90,42,48,FMN GV 05 Lier
60,Mechelsesteenweg 365,2022-08-05,18:00:00,100,42,58,FMN GV 05 Lier
60,Mechelsesteenweg 365,2022-08-05,19:00:00,54,30,24,FMN GV 05 Lier
60,Mechelsesteenweg 365,2022-08-05,20:00:00,52,20,32,FMN GV 05 Lier
60,Mechelsesteenweg 365,2022-08-05,21:00:00,30,8,22,FMN GV 05 Lier
60,Mechelsesteenweg 365,2022-08-05,22:00:00,8,4,4,FMN GV 05 Lier
60,Mechelsesteenweg 365,2022-08-05,23:00:00,8,6,2,FMN GV 05 Lier
60,Mechelsesteenweg 365,2022-08-06,00:00:00,8,6,2,FMN GV 05 Lier
60,Mechelsesteenweg 365,2022-08-06,01:00:00,18,18,0,FMN GV 05 Lier
60,Mechelsesteenweg 365,2022-08-06,02:00:00,0,0,0,FMN GV 05 Lier
60,Mechelsesteenweg 365,2022-08-06,03:00:00,0,0,0,FMN GV 05 Lier
60,Mechelsesteenweg 365,2022-08-06,04:00:00,0,0,0,FMN GV 05 Lier
60,Mechelsesteenweg 365,2022-08-06,05:00:00,2,0,2,FMN GV 05 Lier
60,Mechelsesteenweg 365,2022-08-06,06:00:00,10,2,8,FMN GV 05 Lier
60,Mechelsesteenweg 365,2022-08-06,07:00:00,14,4,10,FMN GV 05 Lier
60,Mechelsesteenweg 365,2022-08-06,08:00:00,44,28,16,FMN GV 05 Lier
60,Mechelsesteenweg 365,2022-08-06,09:00:00,130,74,56,FMN GV 05 Lier
60,Mechelsesteenweg 365,2022-08-06,10:00:00,208,116,92,FMN GV 05 Lier
60,Mechelsesteenweg 365,2022-08-06,11:00:00,248,126,122,FMN GV 05 Lier
60,Mechelsesteenweg 365,2022-08-06,12:00:00,8,0,8,FMN GV 05 Lier
60,Mechelsesteenweg 365,2022-08-06,13:00:00,2,0,2,FMN GV 05 Lier
60,Mechelsesteenweg 365,2022-08-06,14:00:00,142,70,72,FMN GV 05 Lier
60,Mechelsesteenweg 365,2022-08-06,15:00:00,118,60,58,FMN GV 05 Lier
60,Mechelsesteenweg 365,2022-08-06,16:00:00,0,0,0,FMN GV 05 Lier
60,Mechelsesteenweg 365,2022-08-06,17:00:00,80,32,48,FMN GV 05 Lier
60,Mechelsesteenweg 365,2022-08-06,18:00:00,78,34,44,FMN GV 05 Lier
60,Mechelsesteenweg 365,2022-08-06,19:00:00,80,38,42,FMN GV 05 Lier
60,Mechelsesteenweg 365,2022-08-06,20:00:00,46,16,30,FMN GV 05 Lier
60,Mechelsesteenweg 365,2022-08-06,21:00:00,22,2,20,FMN GV 05 Lier
60,Mechelsesteenweg 365,2022-08-06,22:00:00,12,4,8,FMN GV 05 Lier
60,Mechelsesteenweg 365,2022-08-06,23:00:00,6,6,0,FMN GV 05 Lier
60,Mechelsesteenweg 365,2022-08-07,00:00:00,2,0,2,FMN GV 05 Lier
60,Mechelsesteenweg 365,2022-08-07,01:00:00,22,22,0,FMN GV 05 Lier
60,Mechelsesteenweg 365,2022-08-07,02:00:00,4,4,0,FMN GV 05 Lier
60,Mechelsesteenweg 365,2022-08-07,03:00:00,0,0,0,FMN GV 05 Lier
60,Mechelsesteenweg 365,2022-08-07,04:00:00,0,0,0,FMN GV 05 Lier
60,Mechelsesteenweg 365,2022-08-07,05:00:00,2,2,0,FMN GV 05 Lier
60,Mechelsesteenweg 365,2022-08-07,06:00:00,12,2,10,FMN GV 05 Lier
60,Mechelsesteenweg 365,2022-08-07,07:00:00,12,4,8,FMN GV 05 Lier
60,Mechelsesteenweg 365,2022-08-07,08:00:00,58,54,4,FMN GV 05 Lier
60,Mechelsesteenweg 365,2022-08-07,09:00:00,248,128,120,FMN GV 05 Lier
60,Mechelsesteenweg 365,2022-08-07,10:00:00,366,174,192,FMN GV 05 Lier
60,Mechelsesteenweg 365,2022-08-07,11:00:00,406,172,234,FMN GV 05 Lier
60,Mechelsesteenweg 365,2022-08-07,12:00:00,8,0,8,FMN GV 05 Lier
60,Mechelsesteenweg 365,2022-08-07,13:00:00,0,0,0,FMN GV 05 Lier
60,Mechelsesteenweg 365,2022-08-07,14:00:00,0,0,0,FMN GV 05 Lier
60,Mechelsesteenweg 365,2022-08-07,15:00:00,0,0,0,FMN GV 05 Lier
60,Mechelsesteenweg 365,2022-08-07,16:00:00,0,0,0,FMN GV 05 Lier
60,Mechelsesteenweg 365,2022-08-07,17:00:00,2,0,2,FMN GV 05 Lier
60,Mechelsesteenweg 365,2022-08-07,18:00:00,72,38,34,FMN GV 05 Lier
60,Mechelsesteenweg 365,2022-08-07,19:00:00,78,50,28,FMN GV 05 Lier
60,Mechelsesteenweg 365,2022-08-07,20:00:00,58,16,42,FMN GV 05 Lier
60,Mechelsesteenweg 365,2022-08-07,21:00:00,34,6,28,FMN GV 05 Lier
60,Mechelsesteenweg 365,2022-08-07,22:00:00,8,0,8,FMN GV 05 Lier
60,Mechelsesteenweg 365,2022-08-07,23:00:00,8,2,6,FMN GV 05 Lier
60,Mechelsesteenweg 365,2022-08-08,00:00:00,0,0,0,FMN GV 05 Lier
60,Mechelsesteenweg 365,2022-08-08,01:00:00,0,0,0,FMN GV 05 Lier
60,Mechelsesteenweg 365,2022-08-08,02:00:00,0,0,0,FMN GV 05 Lier
60,Mechelsesteenweg 365,2022-08-08,03:00:00,0,0,0,FMN GV 05 Lier
60,Mechelsesteenweg 365,2022-08-08,04:00:00,2,0,2,FMN GV 05 Lier
60,Mechelsesteenweg 365,2022-08-08,05:00:00,2,0,2,FMN GV 05 Lier
60,Mechelsesteenweg 365,2022-08-08,06:00:00,38,6,32,FMN GV 05 Lier
60,Mechelsesteenweg 365,2022-08-08,07:00:00,78,16,62,FMN GV 05 Lier
60,Mechelsesteenweg 365,2022-08-08,08:00:00,50,22,28,FMN GV 05 Lier
60,Mechelsesteenweg 365,2022-08-08,09:00:00,80,30,50,FMN GV 05 Lier
60,Mechelsesteenweg 365,2022-08-08,10:00:00,88,38,50,FMN GV 05 Lier
60,Mechelsesteenweg 365,2022-08-08,11:00:00,110,36,74,FMN GV 05 Lier
60,Mechelsesteenweg 365,2022-08-08,12:00:00,8,2,6,FMN GV 05 Lier
60,Mechelsesteenweg 365,2022-08-08,13:00:00,4,2,2,FMN GV 05 Lier
60,Mechelsesteenweg 365,2022-08-08,14:00:00,0,0,0,FMN GV 05 Lier
60,Mechelsesteenweg 365,2022-08-08,15:00:00,2,2,0,FMN GV 05 Lier
60,Mechelsesteenweg 365,2022-08-08,16:00:00,0,0,0,FMN GV 05 Lier
60,Mechelsesteenweg 365,2022-08-08,17:00:00,14,6,8,FMN GV 05 Lier
60,Mechelsesteenweg 365,2022-08-08,18:00:00,94,50,44,FMN GV 05 Lier
60,Mechelsesteenweg 365,2022-08-08,19:00:00,126,72,54,FMN GV 05 Lier
60,Mechelsesteenweg 365,2022-08-08,20:00:00,132,52,80,FMN GV 05 Lier
60,Mechelsesteenweg 365,2022-08-08,21:00:00,38,14,24,FMN GV 05 Lier
60,Mechelsesteenweg 365,2022-08-08,22:00:00,12,8,4,FMN GV 05 Lier
60,Mechelsesteenweg 365,2022-08-08,23:00:00,2,0,2,FMN GV 05 Lier
60,Mechelsesteenweg 365,2022-08-09,00:00:00,2,0,2,FMN GV 05 Lier
60,Mechelsesteenweg 365,2022-08-09,01:00:00,0,0,0,FMN GV 05 Lier
60,Mechelsesteenweg 365,2022-08-09,02:00:00,0,0,0,FMN GV 05 Lier
60,Mechelsesteenweg 365,2022-08-09,03:00:00,0,0,0,FMN GV 05 Lier
60,Mechelsesteenweg 365,2022-08-09,04:00:00,4,0,4,FMN GV 05 Lier
60,Mechelsesteenweg 365,2022-08-09,05:00:00,8,0,8,FMN GV 05 Lier
60,Mechelsesteenweg 365,2022-08-09,06:00:00,48,20,28,FMN GV 05 Lier
60,Mechelsesteenweg 365,2022-08-09,07:00:00,110,36,74,FMN GV 05 Lier
60,Mechelsesteenweg 365,2022-08-09,08:00:00,98,40,58,FMN GV 05 Lier
60,Mechelsesteenweg 365,2022-08-09,09:00:00,166,78,88,FMN GV 05 Lier
60,Mechelsesteenweg 365,2022-08-09,10:00:00,192,82,110,FMN GV 05 Lier
60,Mechelsesteenweg 365,2022-08-09,11:00:00,136,68,68,FMN GV 05 Lier
60,Mechelsesteenweg 365,2022-08-09,12:00:00,4,0,4,FMN GV 05 Lier
60,Mechelsesteenweg 365,2022-08-09,13:00:00,0,0,0,FMN GV 05 Lier
60,Mechelsesteenweg 365,2022-08-09,14:00:00,0,0,0,FMN GV 05 Lier
60,Mechelsesteenweg 365,2022-08-09,15:00:00,0,0,0,FMN GV 05 Lier
60,Mechelsesteenweg 365,2022-08-09,16:00:00,0,0,0,FMN GV 05 Lier
60,Mechelsesteenweg 365,2022-08-09,17:00:00,0,0,0,FMN GV 05 Lier
60,Mechelsesteenweg 365,2022-08-09,18:00:00,62,30,32,FMN GV 05 Lier
60,Mechelsesteenweg 365,2022-08-09,19:00:00,160,70,90,FMN GV 05 Lier
60,Mechelsesteenweg 365,2022-08-09,20:00:00,180,82,98,FMN GV 05 Lier
60,Mechelsesteenweg 365,2022-08-09,21:00:00,58,26,32,FMN GV 05 Lier
60,Mechelsesteenweg 365,2022-08-09,22:00:00,8,2,6,FMN GV 05 Lier
60,Mechelsesteenweg 365,2022-08-09,23:00:00,2,0,2,FMN GV 05 Lier
60,Mechelsesteenweg 365,2022-08-10,00:00:00,2,2,0,FMN GV 05 Lier
60,Mechelsesteenweg 365,2022-08-10,01:00:00,0,0,0,FMN GV 05 Lier
60,Mechelsesteenweg 365,2022-08-10,02:00:00,0,0,0,FMN GV 05 Lier
60,Mechelsesteenweg 365,2022-08-10,03:00:00,0,0,0,FMN GV 05 Lier
60,Mechelsesteenweg 365,2022-08-10,04:00:00,4,0,4,FMN GV 05 Lier
60,Mechelsesteenweg 365,2022-08-10,05:00:00,8,2,6,FMN GV 05 Lier
60,Mechelsesteenweg 365,2022-08-10,06:00:00,34,10,24,FMN GV 05 Lier
60,Mechelsesteenweg 365,2022-08-10,07:00:00,76,24,52,FMN GV 05 Lier
60,Mechelsesteenweg 365,2022-08-10,08:00:00,100,44,56,FMN GV 05 Lier
60,Mechelsesteenweg 365,2022-08-10,09:00:00,148,72,76,FMN GV 05 Lier
60,Mechelsesteenweg 365,2022-08-10,10:00:00,162,82,80,FMN GV 05 Lier
60,Mechelsesteenweg 365,2022-08-10,11:00:00,98,44,54,FMN GV 05 Lier
60,Mechelsesteenweg 365,2022-08-10,12:00:00,0,0,0,FMN GV 05 Lier
60,Mechelsesteenweg 365,2022-08-10,13:00:00,0,0,0,FMN GV 05 Lier
60,Mechelsesteenweg 365,2022-08-10,14:00:00,0,0,0,FMN GV 05 Lier
60,Mechelsesteenweg 365,2022-08-10,15:00:00,0,0,0,FMN GV 05 Lier
60,Mechelsesteenweg 365,2022-08-10,16:00:00,0,0,0,FMN GV 05 Lier
60,Mechelsesteenweg 365,2022-08-10,17:00:00,0,0,0,FMN GV 05 Lier
60,Mechelsesteenweg 365,2022-08-10,18:00:00,54,30,24,FMN GV 05 Lier
60,Mechelsesteenweg 365,2022-08-10,19:00:00,132,64,68,FMN GV 05 Lier
60,Mechelsesteenweg 365,2022-08-10,20:00:00,260,150,110,FMN GV 05 Lier
60,Mechelsesteenweg 365,2022-08-10,21:00:00,44,18,26,FMN GV 05 Lier
60,Mechelsesteenweg 365,2022-08-10,22:00:00,18,0,18,FMN GV 05 Lier
60,Mechelsesteenweg 365,2022-08-10,23:00:00,4,2,2,FMN GV 05 Lier
60,Mechelsesteenweg 365,2022-08-11,00:00:00,4,2,2,FMN GV 05 Lier
60,Mechelsesteenweg 365,2022-08-11,01:00:00,0,0,0,FMN GV 05 Lier
60,Mechelsesteenweg 365,2022-08-11,02:00:00,2,0,2,FMN GV 05 Lier
60,Mechelsesteenweg 365,2022-08-11,03:00:00,0,0,0,FMN GV 05 Lier
60,Mechelsesteenweg 365,2022-08-11,04:00:00,4,0,4,FMN GV 05 Lier
60,Mechelsesteenweg 365,2022-08-11,05:00:00,2,0,2,FMN GV 05 Lier
60,Mechelsesteenweg 365,2022-08-11,06:00:00,38,10,28,FMN GV 05 Lier
60,Mechelsesteenweg 365,2022-08-11,07:00:00,80,26,54,FMN GV 05 Lier
60,Mechelsesteenweg 365,2022-08-11,08:00:00,86,54,32,FMN GV 05 Lier
60,Mechelsesteenweg 365,2022-08-11,09:00:00,180,96,84,FMN GV 05 Lier
60,Mechelsesteenweg 365,2022-08-11,10:00:00,162,72,90,FMN GV 05 Lier
60,Mechelsesteenweg 365,2022-08-11,11:00:00,48,12,36,FMN GV 05 Lier
60,Mechelsesteenweg 365,2022-08-11,12:00:00,0,0,0,FMN GV 05 Lier
60,Mechelsesteenweg 365,2022-08-11,13:00:00,0,0,0,FMN GV 05 Lier
60,Mechelsesteenweg 365,2022-08-11,14:00:00,0,0,0,FMN GV 05 Lier
60,Mechelsesteenweg 365,2022-08-11,15:00:00,0,0,0,FMN GV 05 Lier
60,Mechelsesteenweg 365,2022-08-11,16:00:00,0,0,0,FMN GV 05 Lier
60,Mechelsesteenweg 365,2022-08-11,17:00:00,0,0,0,FMN GV 05 Lier
60,Mechelsesteenweg 365,2022-08-11,18:00:00,48,28,20,FMN GV 05 Lier
60,Mechelsesteenweg 365,2022-08-11,19:00:00,114,46,68,FMN GV 05 Lier
60,Mechelsesteenweg 365,2022-08-11,20:00:00,246,112,134,FMN GV 05 Lier
60,Mechelsesteenweg 365,2022-08-11,21:00:00,72,32,40,FMN GV 05 Lier
60,Mechelsesteenweg 365,2022-08-11,22:00:00,16,4,12,FMN GV 05 Lier
60,Mechelsesteenweg 365,2022-08-11,23:00:00,10,4,6,FMN GV 05 Lier
60,Mechelsesteenweg 365,2022-08-12,00:00:00,2,0,2,FMN GV 05 Lier
60,Mechelsesteenweg 365,2022-08-12,01:00:00,0,0,0,FMN GV 05 Lier
60,Mechelsesteenweg 365,2022-08-12,02:00:00,0,0,0,FMN GV 05 Lier
60,Mechelsesteenweg 365,2022-08-12,03:00:00,2,0,2,FMN GV 05 Lier
60,Mechelsesteenweg 365,2022-08-12,04:00:00,2,0,2,FMN GV 05 Lier
60,Mechelsesteenweg 365,2022-08-12,05:00:00,4,2,2,FMN GV 05 Lier
60,Mechelsesteenweg 365,2022-08-12,06:00:00,22,8,14,FMN GV 05 Lier
60,Mechelsesteenweg 365,2022-08-12,07:00:00,52,12,40,FMN GV 05 Lier
60,Mechelsesteenweg 365,2022-08-12,08:00:00,102,56,46,FMN GV 05 Lier
60,Mechelsesteenweg 365,2022-08-12,09:00:00,158,68,90,FMN GV 05 Lier
60,Mechelsesteenweg 365,2022-08-12,10:00:00,190,116,74,FMN GV 05 Lier
60,Mechelsesteenweg 365,2022-08-12,11:00:00,54,24,30,FMN GV 05 Lier
60,Mechelsesteenweg 365,2022-08-12,12:00:00,0,0,0,FMN GV 05 Lier
60,Mechelsesteenweg 365,2022-08-12,13:00:00,0,0,0,FMN GV 05 Lier
60,Mechelsesteenweg 365,2022-08-12,14:00:00,0,0,0,FMN GV 05 Lier
60,Mechelsesteenweg 365,2022-08-12,15:00:00,0,0,0,FMN GV 05 Lier
60,Mechelsesteenweg 365,2022-08-12,16:00:00,0,0,0,FMN GV 05 Lier
60,Mechelsesteenweg 365,2022-08-12,17:00:00,0,0,0,FMN GV 05 Lier
60,Mechelsesteenweg 365,2022-08-12,18:00:00,30,16,14,FMN GV 05 Lier
60,Mechelsesteenweg 365,2022-08-12,19:00:00,82,58,24,FMN GV 05 Lier
60,Mechelsesteenweg 365,2022-08-12,20:00:00,88,36,52,FMN GV 05 Lier
60,Mechelsesteenweg 365,2022-08-12,21:00:00,28,16,12,FMN GV 05 Lier
60,Mechelsesteenweg 365,2022-08-12,22:00:00,18,8,10,FMN GV 05 Lier
60,Mechelsesteenweg 365,2022-08-12,23:00:00,6,2,4,FMN GV 05 Lier
60,Mechelsesteenweg 365,2022-08-13,00:00:00,14,8,6,FMN GV 05 Lier
60,Mechelsesteenweg 365,2022-08-13,01:00:00,0,0,0,FMN GV 05 Lier
60,Mechelsesteenweg 365,2022-08-13,02:00:00,2,0,2,FMN GV 05 Lier
60,Mechelsesteenweg 365,2022-08-13,03:00:00,0,0,0,FMN GV 05 Lier
60,Mechelsesteenweg 365,2022-08-13,04:00:00,0,0,0,FMN GV 05 Lier
60,Mechelsesteenweg 365,2022-08-13,05:00:00,0,0,0,FMN GV 05 Lier
60,Mechelsesteenweg 365,2022-08-13,06:00:00,8,6,2,FMN GV 05 Lier
60,Mechelsesteenweg 365,2022-08-13,07:00:00,36,10,26,FMN GV 05 Lier
60,Mechelsesteenweg 365,2022-08-13,08:00:00,106,48,58,FMN GV 05 Lier
60,Mechelsesteenweg 365,2022-08-13,09:00:00,232,142,90,FMN GV 05 Lier
60,Mechelsesteenweg 365,2022-08-13,10:00:00,270,110,160,FMN GV 05 Lier
60,Mechelsesteenweg 365,2022-08-13,11:00:00,70,32,38,FMN GV 05 Lier
60,Mechelsesteenweg 365,2022-08-13,12:00:00,0,0,0,FMN GV 05 Lier
60,Mechelsesteenweg 365,2022-08-13,13:00:00,0,0,0,FMN GV 05 Lier
60,Mechelsesteenweg 365,2022-08-13,14:00:00,0,0,0,FMN GV 05 Lier
60,Mechelsesteenweg 365,2022-08-13,15:00:00,0,0,0,FMN GV 05 Lier
60,Mechelsesteenweg 365,2022-08-13,16:00:00,0,0,0,FMN GV 05 Lier
60,Mechelsesteenweg 365,2022-08-13,17:00:00,0,0,0,FMN GV 05 Lier
60,Mechelsesteenweg 365,2022-08-13,18:00:00,8,2,6,FMN GV 05 Lier
60,Mechelsesteenweg 365,2022-08-13,19:00:00,38,26,12,FMN GV 05 Lier
60,Mechelsesteenweg 365,2022-08-13,20:00:00,86,34,52,FMN GV 05 Lier
60,Mechelsesteenweg 365,2022-08-13,21:00:00,64,28,36,FMN GV 05 Lier
60,Mechelsesteenweg 365,2022-08-13,22:00:00,26,2,24,FMN GV 05 Lier
60,Mechelsesteenweg 365,2022-08-13,23:00:00,16,8,8,FMN GV 05 Lier
60,Mechelsesteenweg 365,2022-08-14,00:00:00,2,2,0,FMN GV 05 Lier
60,Mechelsesteenweg 365,2022-08-14,01:00:00,6,6,0,FMN GV 05 Lier
60,Mechelsesteenweg 365,2022-08-14,02:00:00,0,0,0,FMN GV 05 Lier
60,Mechelsesteenweg 365,2022-08-14,03:00:00,0,0,0,FMN GV 05 Lier
60,Mechelsesteenweg 365,2022-08-14,04:00:00,0,0,0,FMN GV 05 Lier
60,Mechelsesteenweg 365,2022-08-14,05:00:00,0,0,0,FMN GV 05 Lier
60,Mechelsesteenweg 365,2022-08-14,06:00:00,2,0,2,FMN GV 05 Lier
60,Mechelsesteenweg 365,2022-08-14,07:00:00,32,20,12,FMN GV 05 Lier
60,Mechelsesteenweg 365,2022-08-14,08:00:00,134,86,48,FMN GV 05 Lier
60,Mechelsesteenweg 365,2022-08-14,09:00:00,276,150,126,FMN GV 05 Lier
60,Mechelsesteenweg 365,2022-08-14,10:00:00,418,186,232,FMN GV 05 Lier
60,Mechelsesteenweg 365,2022-08-14,11:00:00,72,16,56,FMN GV 05 Lier
60,Mechelsesteenweg 365,2022-08-14,12:00:00,0,0,0,FMN GV 05 Lier
60,Mechelsesteenweg 365,2022-08-14,13:00:00,0,0,0,FMN GV 05 Lier
60,Mechelsesteenweg 365,2022-08-14,14:00:00,0,0,0,FMN GV 05 Lier
60,Mechelsesteenweg 365,2022-08-14,15:00:00,0,0,0,FMN GV 05 Lier
60,Mechelsesteenweg 365,2022-08-14,16:00:00,0,0,0,FMN GV 05 Lier
60,Mechelsesteenweg 365,2022-08-14,17:00:00,16,8,8,FMN GV 05 Lier
60,Mechelsesteenweg 365,2022-08-14,18:00:00,26,2,24,FMN GV 05 Lier
60,Mechelsesteenweg 365,2022-08-14,19:00:00,46,16,30,FMN GV 05 Lier
60,Mechelsesteenweg 365,2022-08-14,20:00:00,46,20,26,FMN GV 05 Lier
60,Mechelsesteenweg 365,2022-08-14,21:00:00,44,26,18,FMN GV 05 Lier
60,Mechelsesteenweg 365,2022-08-14,22:00:00,14,8,6,FMN GV 05 Lier
60,Mechelsesteenweg 365,2022-08-14,23:00:00,16,14,2,FMN GV 05 Lier
60,Mechelsesteenweg 365,2022-08-15,00:00:00,8,6,2,FMN GV 05 Lier
60,Mechelsesteenweg 365,2022-08-15,01:00:00,4,0,4,FMN GV 05 Lier
60,Mechelsesteenweg 365,2022-08-15,02:00:00,2,0,2,FMN GV 05 Lier
60,Mechelsesteenweg 365,2022-08-15,03:00:00,0,0,0,FMN GV 05 Lier
60,Mechelsesteenweg 365,2022-08-15,04:00:00,0,0,0,FMN GV 05 Lier
60,Mechelsesteenweg 365,2022-08-15,05:00:00,0,0,0,FMN GV 05 Lier
60,Mechelsesteenweg 365,2022-08-15,06:00:00,2,2,0,FMN GV 05 Lier
60,Mechelsesteenweg 365,2022-08-15,07:00:00,10,6,4,FMN GV 05 Lier
60,Mechelsesteenweg 365,2022-08-15,08:00:00,22,16,6,FMN GV 05 Lier
60,Mechelsesteenweg 365,2022-08-15,09:00:00,106,62,44,FMN GV 05 Lier
60,Mechelsesteenweg 365,2022-08-15,10:00:00,138,74,64,FMN GV 05 Lier
60,Mechelsesteenweg 365,2022-08-15,11:00:00,202,102,100,FMN GV 05 Lier
60,Mechelsesteenweg 365,2022-08-15,12:00:00,114,48,66,FMN GV 05 Lier
60,Mechelsesteenweg 365,2022-08-15,13:00:00,18,16,2,FMN GV 05 Lier
60,Mechelsesteenweg 365,2022-08-15,14:00:00,168,102,66,FMN GV 05 Lier
60,Mechelsesteenweg 365,2022-08-15,15:00:00,204,92,112,FMN GV 05 Lier
60,Mechelsesteenweg 365,2022-08-15,16:00:00,70,22,48,FMN GV 05 Lier
60,Mechelsesteenweg 365,2022-08-15,17:00:00,70,34,36,FMN GV 05 Lier
60,Mechelsesteenweg 365,2022-08-15,18:00:00,48,14,34,FMN GV 05 Lier
60,Mechelsesteenweg 365,2022-08-15,19:00:00,38,12,26,FMN GV 05 Lier
60,Mechelsesteenweg 365,2022-08-15,20:00:00,56,22,34,FMN GV 05 Lier
60,Mechelsesteenweg 365,2022-08-15,21:00:00,22,10,12,FMN GV 05 Lier
60,Mechelsesteenweg 365,2022-08-15,22:00:00,8,4,4,FMN GV 05 Lier
60,Mechelsesteenweg 365,2022-08-15,23:00:00,2,2,0,FMN GV 05 Lier
60,Mechelsesteenweg 365,2022-08-16,00:00:00,0,0,0,FMN GV 05 Lier
60,Mechelsesteenweg 365,2022-08-16,01:00:00,0,0,0,FMN GV 05 Lier
60,Mechelsesteenweg 365,2022-08-16,02:00:00,0,0,0,FMN GV 05 Lier
60,Mechelsesteenweg 365,2022-08-16,03:00:00,0,0,0,FMN GV 05 Lier
60,Mechelsesteenweg 365,2022-08-16,04:00:00,0,0,0,FMN GV 05 Lier
60,Mechelsesteenweg 365,2022-08-16,05:00:00,4,2,2,FMN GV 05 Lier
60,Mechelsesteenweg 365,2022-08-16,06:00:00,36,10,26,FMN GV 05 Lier
60,Mechelsesteenweg 365,2022-08-16,07:00:00,54,14,40,FMN GV 05 Lier
60,Mechelsesteenweg 365,2022-08-16,08:00:00,92,40,52,FMN GV 05 Lier
60,Mechelsesteenweg 365,2022-08-16,09:00:00,112,64,48,FMN GV 05 Lier
60,Mechelsesteenweg 365,2022-08-16,10:00:00,194,92,102,FMN GV 05 Lier
60,Mechelsesteenweg 365,2022-08-16,11:00:00,140,62,78,FMN GV 05 Lier
60,Mechelsesteenweg 365,2022-08-16,12:00:00,26,10,16,FMN GV 05 Lier
60,Mechelsesteenweg 365,2022-08-16,13:00:00,172,108,64,FMN GV 05 Lier
60,Mechelsesteenweg 365,2022-08-16,14:00:00,10,2,8,FMN GV 05 Lier
60,Mechelsesteenweg 365,2022-08-16,15:00:00,0,0,0,FMN GV 05 Lier
60,Mechelsesteenweg 365,2022-08-16,16:00:00,98,54,44,FMN GV 05 Lier
60,Mechelsesteenweg 365,2022-08-16,17:00:00,30,12,18,FMN GV 05 Lier
60,Mechelsesteenweg 365,2022-08-16,18:00:00,124,50,74,FMN GV 05 Lier
60,Mechelsesteenweg 365,2022-08-16,19:00:00,102,48,54,FMN GV 05 Lier
60,Mechelsesteenweg 365,2022-08-16,20:00:00,98,64,34,FMN GV 05 Lier
60,Mechelsesteenweg 365,2022-08-16,21:00:00,56,16,40,FMN GV 05 Lier
60,Mechelsesteenweg 365,2022-08-16,22:00:00,8,4,4,FMN GV 05 Lier
60,Mechelsesteenweg 365,2022-08-16,23:00:00,6,4,2,FMN GV 05 Lier
60,Mechelsesteenweg 365,2022-08-17,00:00:00,2,0,2,FMN GV 05 Lier
60,Mechelsesteenweg 365,2022-08-17,01:00:00,0,0,0,FMN GV 05 Lier
60,Mechelsesteenweg 365,2022-08-17,02:00:00,0,0,0,FMN GV 05 Lier
60,Mechelsesteenweg 365,2022-08-17,03:00:00,0,0,0,FMN GV 05 Lier
60,Mechelsesteenweg 365,2022-08-17,04:00:00,2,0,2,FMN GV 05 Lier
60,Mechelsesteenweg 365,2022-08-17,05:00:00,2,0,2,FMN GV 05 Lier
60,Mechelsesteenweg 365,2022-08-17,06:00:00,22,4,18,FMN GV 05 Lier
60,Mechelsesteenweg 365,2022-08-17,07:00:00,36,6,30,FMN GV 05 Lier
60,Mechelsesteenweg 365,2022-08-17,08:00:00,30,10,20,FMN GV 05 Lier
60,Mechelsesteenweg 365,2022-08-17,09:00:00,18,4,14,FMN GV 05 Lier
60,Mechelsesteenweg 365,2022-08-17,10:00:00,18,12,6,FMN GV 05 Lier
60,Mechelsesteenweg 365,2022-08-17,11:00:00,8,6,2,FMN GV 05 Lier
60,Mechelsesteenweg 365,2022-08-17,12:00:00,20,8,12,FMN GV 05 Lier
60,Mechelsesteenweg 365,2022-08-17,13:00:00,36,16,20,FMN GV 05 Lier
60,Mechelsesteenweg 365,2022-08-17,14:00:00,38,20,18,FMN GV 05 Lier
60,Mechelsesteenweg 365,2022-08-17,15:00:00,62,26,36,FMN GV 05 Lier
60,Mechelsesteenweg 365,2022-08-17,16:00:00,64,34,30,FMN GV 05 Lier
60,Mechelsesteenweg 365,2022-08-17,17:00:00,56,40,16,FMN GV 05 Lier
60,Mechelsesteenweg 365,2022-08-17,18:00:00,68,46,22,FMN GV 05 Lier
60,Mechelsesteenweg 365,2022-08-17,19:00:00,76,46,30,FMN GV 05 Lier
60,Mechelsesteenweg 365,2022-08-17,20:00:00,92,52,40,FMN GV 05 Lier
60,Mechelsesteenweg 365,2022-08-17,21:00:00,28,10,18,FMN GV 05 Lier
60,Mechelsesteenweg 365,2022-08-17,22:00:00,8,0,8,FMN GV 05 Lier
60,Mechelsesteenweg 365,2022-08-17,23:00:00,8,6,2,FMN GV 05 Lier
60,Mechelsesteenweg 365,2022-08-18,00:00:00,2,0,2,FMN GV 05 Lier
60,Mechelsesteenweg 365,2022-08-18,01:00:00,0,0,0,FMN GV 05 Lier
60,Mechelsesteenweg 365,2022-08-18,02:00:00,0,0,0,FMN GV 05 Lier
60,Mechelsesteenweg 365,2022-08-18,03:00:00,4,4,0,FMN GV 05 Lier
60,Mechelsesteenweg 365,2022-08-18,04:00:00,2,0,2,FMN GV 05 Lier
60,Mechelsesteenweg 365,2022-08-18,05:00:00,2,2,0,FMN GV 05 Lier
60,Mechelsesteenweg 365,2022-08-18,06:00:00,36,6,30,FMN GV 05 Lier
60,Mechelsesteenweg 365,2022-08-18,07:00:00,52,4,48,FMN GV 05 Lier
60,Mechelsesteenweg 365,2022-08-18,08:00:00,78,44,34,FMN GV 05 Lier
60,Mechelsesteenweg 365,2022-08-18,09:00:00,116,54,62,FMN GV 05 Lier
60,Mechelsesteenweg 365,2022-08-18,10:00:00,176,90,86,FMN GV 05 Lier
60,Mechelsesteenweg 365,2022-08-18,11:00:00,116,44,72,FMN GV 05 Lier
60,Mechelsesteenweg 365,2022-08-18,12:00:00,96,48,48,FMN GV 05 Lier
60,Mechelsesteenweg 365,2022-08-18,13:00:00,174,80,94,FMN GV 05 Lier
60,Mechelsesteenweg 365,2022-08-18,14:00:00,78,24,54,FMN GV 05 Lier
60,Mechelsesteenweg 365,2022-08-18,15:00:00,0,0,0,FMN GV 05 Lier
60,Mechelsesteenweg 365,2022-08-18,16:00:00,0,0,0,FMN GV 05 Lier
60,Mechelsesteenweg 365,2022-08-18,17:00:00,20,10,10,FMN GV 05 Lier
60,Mechelsesteenweg 365,2022-08-18,18:00:00,126,74,52,FMN GV 05 Lier
60,Mechelsesteenweg 365,2022-08-18,19:00:00,144,76,68,FMN GV 05 Lier
60,Mechelsesteenweg 365,2022-08-18,20:00:00,216,116,100,FMN GV 05 Lier
60,Mechelsesteenweg 365,2022-08-18,21:00:00,38,18,20,FMN GV 05 Lier
60,Mechelsesteenweg 365,2022-08-18,22:00:00,16,2,14,FMN GV 05 Lier
60,Mechelsesteenweg 365,2022-08-18,23:00:00,36,6,30,FMN GV 05 Lier
60,Mechelsesteenweg 365,2022-08-19,00:00:00,12,0,12,FMN GV 05 Lier
60,Mechelsesteenweg 365,2022-08-19,01:00:00,6,0,6,FMN GV 05 Lier
60,Mechelsesteenweg 365,2022-08-19,02:00:00,0,0,0,FMN GV 05 Lier
60,Mechelsesteenweg 365,2022-08-19,03:00:00,0,0,0,FMN GV 05 Lier
60,Mechelsesteenweg 365,2022-08-19,04:00:00,2,0,2,FMN GV 05 Lier
60,Mechelsesteenweg 365,2022-08-19,05:00:00,4,2,2,FMN GV 05 Lier
60,Mechelsesteenweg 365,2022-08-19,06:00:00,22,6,16,FMN GV 05 Lier
60,Mechelsesteenweg 365,2022-08-19,07:00:00,44,14,30,FMN GV 05 Lier
60,Mechelsesteenweg 365,2022-08-19,08:00:00,58,28,30,FMN GV 05 Lier
60,Mechelsesteenweg 365,2022-08-19,09:00:00,80,42,38,FMN GV 05 Lier
60,Mechelsesteenweg 365,2022-08-19,10:00:00,98,36,62,FMN GV 05 Lier
60,Mechelsesteenweg 365,2022-08-19,11:00:00,124,62,62,FMN GV 05 Lier
60,Mechelsesteenweg 365,2022-08-19,12:00:00,78,32,46,FMN GV 05 Lier
60,Mechelsesteenweg 365,2022-08-19,13:00:00,66,34,32,FMN GV 05 Lier
60,Mechelsesteenweg 365,2022-08-19,14:00:00,94,52,42,FMN GV 05 Lier
60,Mechelsesteenweg 365,2022-08-19,15:00:00,86,30,56,FMN GV 05 Lier
60,Mechelsesteenweg 365,2022-08-19,16:00:00,92,56,36,FMN GV 05 Lier
60,Mechelsesteenweg 365,2022-08-19,17:00:00,84,36,48,FMN GV 05 Lier
60,Mechelsesteenweg 365,2022-08-19,18:00:00,56,24,32,FMN GV 05 Lier
60,Mechelsesteenweg 365,2022-08-19,19:00:00,28,22,6,FMN GV 05 Lier
60,Mechelsesteenweg 365,2022-08-19,20:00:00,20,10,10,FMN GV 05 Lier
60,Mechelsesteenweg 365,2022-08-19,21:00:00,4,4,0,FMN GV 05 Lier
60,Mechelsesteenweg 365,2022-08-19,22:00:00,6,0,6,FMN GV 05 Lier
60,Mechelsesteenweg 365,2022-08-19,23:00:00,4,2,2,FMN GV 05 Lier
60,Mechelsesteenweg 365,2022-08-20,00:00:00,0,0,0,FMN GV 05 Lier
60,Mechelsesteenweg 365,2022-08-20,01:00:00,0,0,0,FMN GV 05 Lier
60,Mechelsesteenweg 365,2022-08-20,02:00:00,0,0,0,FMN GV 05 Lier
60,Mechelsesteenweg 365,2022-08-20,03:00:00,0,0,0,FMN GV 05 Lier
60,Mechelsesteenweg 365,2022-08-20,04:00:00,0,0,0,FMN GV 05 Lier
60,Mechelsesteenweg 365,2022-08-20,05:00:00,0,0,0,FMN GV 05 Lier
60,Mechelsesteenweg 365,2022-08-20,06:00:00,6,2,4,FMN GV 05 Lier
60,Mechelsesteenweg 365,2022-08-20,07:00:00,18,12,6,FMN GV 05 Lier
60,Mechelsesteenweg 365,2022-08-20,08:00:00,30,12,18,FMN GV 05 Lier
60,Mechelsesteenweg 365,2022-08-20,09:00:00,98,52,46,FMN GV 05 Lier
60,Mechelsesteenweg 365,2022-08-20,10:00:00,248,154,94,FMN GV 05 Lier
60,Mechelsesteenweg 365,2022-08-20,11:00:00,252,116,136,FMN GV 05 Lier
60,Mechelsesteenweg 365,2022-08-20,12:00:00,152,64,88,FMN GV 05 Lier
60,Mechelsesteenweg 365,2022-08-20,13:00:00,16,10,6,FMN GV 05 Lier
60,Mechelsesteenweg 365,2022-08-20,14:00:00,0,0,0,FMN GV 05 Lier
60,Mechelsesteenweg 365,2022-08-20,15:00:00,0,0,0,FMN GV 05 Lier
60,Mechelsesteenweg 365,2022-08-20,16:00:00,20,8,12,FMN GV 05 Lier
60,Mechelsesteenweg 365,2022-08-20,17:00:00,72,28,44,FMN GV 05 Lier
60,Mechelsesteenweg 365,2022-08-20,18:00:00,64,42,22,FMN GV 05 Lier
60,Mechelsesteenweg 365,2022-08-20,19:00:00,62,20,42,FMN GV 05 Lier
60,Mechelsesteenweg 365,2022-08-20,20:00:00,38,20,18,FMN GV 05 Lier
60,Mechelsesteenweg 365,2022-08-20,21:00:00,28,14,14,FMN GV 05 Lier
60,Mechelsesteenweg 365,2022-08-20,22:00:00,2,2,0,FMN GV 05 Lier
60,Mechelsesteenweg 365,2022-08-20,23:00:00,6,4,2,FMN GV 05 Lier
60,Mechelsesteenweg 365,2022-08-21,00:00:00,4,4,0,FMN GV 05 Lier
60,Mechelsesteenweg 365,2022-08-21,01:00:00,2,2,0,FMN GV 05 Lier
60,Mechelsesteenweg 365,2022-08-21,02:00:00,0,0,0,FMN GV 05 Lier
60,Mechelsesteenweg 365,2022-08-21,03:00:00,2,0,2,FMN GV 05 Lier
60,Mechelsesteenweg 365,2022-08-21,04:00:00,0,0,0,FMN GV 05 Lier
60,Mechelsesteenweg 365,2022-08-21,05:00:00,0,0,0,FMN GV 05 Lier
60,Mechelsesteenweg 365,2022-08-21,06:00:00,2,0,2,FMN GV 05 Lier
60,Mechelsesteenweg 365,2022-08-21,07:00:00,16,6,10,FMN GV 05 Lier
60,Mechelsesteenweg 365,2022-08-21,08:00:00,32,12,20,FMN GV 05 Lier
60,Mechelsesteenweg 365,2022-08-21,09:00:00,270,170,100,FMN GV 05 Lier
60,Mechelsesteenweg 365,2022-08-21,10:00:00,336,166,170,FMN GV 05 Lier
60,Mechelsesteenweg 365,2022-08-21,11:00:00,340,172,168,FMN GV 05 Lier
60,Mechelsesteenweg 365,2022-08-21,12:00:00,262,118,144,FMN GV 05 Lier
60,Mechelsesteenweg 365,2022-08-21,13:00:00,260,140,120,FMN GV 05 Lier
60,Mechelsesteenweg 365,2022-08-21,14:00:00,152,72,80,FMN GV 05 Lier
60,Mechelsesteenweg 365,2022-08-21,15:00:00,270,130,140,FMN GV 05 Lier
60,Mechelsesteenweg 365,2022-08-21,16:00:00,286,94,192,FMN GV 05 Lier
60,Mechelsesteenweg 365,2022-08-21,17:00:00,178,62,116,FMN GV 05 Lier
60,Mechelsesteenweg 365,2022-08-21,18:00:00,94,28,66,FMN GV 05 Lier
60,Mechelsesteenweg 365,2022-08-21,19:00:00,78,42,36,FMN GV 05 Lier
60,Mechelsesteenweg 365,2022-08-21,20:00:00,60,28,32,FMN GV 05 Lier
60,Mechelsesteenweg 365,2022-08-21,21:00:00,24,10,14,FMN GV 05 Lier
60,Mechelsesteenweg 365,2022-08-21,22:00:00,10,6,4,FMN GV 05 Lier
60,Mechelsesteenweg 365,2022-08-21,23:00:00,2,0,2,FMN GV 05 Lier
60,Mechelsesteenweg 365,2022-08-22,00:00:00,0,0,0,FMN GV 05 Lier
60,Mechelsesteenweg 365,2022-08-22,01:00:00,0,0,0,FMN GV 05 Lier
60,Mechelsesteenweg 365,2022-08-22,02:00:00,0,0,0,FMN GV 05 Lier
60,Mechelsesteenweg 365,2022-08-22,03:00:00,2,0,2,FMN GV 05 Lier
60,Mechelsesteenweg 365,2022-08-22,04:00:00,4,0,4,FMN GV 05 Lier
60,Mechelsesteenweg 365,2022-08-22,05:00:00,4,0,4,FMN GV 05 Lier
60,Mechelsesteenweg 365,2022-08-22,06:00:00,44,16,28,FMN GV 05 Lier
60,Mechelsesteenweg 365,2022-08-22,07:00:00,68,14,54,FMN GV 05 Lier
60,Mechelsesteenweg 365,2022-08-22,08:00:00,80,28,52,FMN GV 05 Lier
60,Mechelsesteenweg 365,2022-08-22,09:00:00,44,20,24,FMN GV 05 Lier
60,Mechelsesteenweg 365,2022-08-22,10:00:00,88,40,48,FMN GV 05 Lier
60,Mechelsesteenweg 365,2022-08-22,11:00:00,84,38,46,FMN GV 05 Lier
60,Mechelsesteenweg 365,2022-08-22,12:00:00,36,24,12,FMN GV 05 Lier
60,Mechelsesteenweg 365,2022-08-22,13:00:00,0,0,0,FMN GV 05 Lier
60,Mechelsesteenweg 365,2022-08-22,14:00:00,0,0,0,FMN GV 05 Lier
60,Mechelsesteenweg 365,2022-08-22,15:00:00,18,6,12,FMN GV 05 Lier
60,Mechelsesteenweg 365,2022-08-22,16:00:00,0,0,0,FMN GV 05 Lier
60,Mechelsesteenweg 365,2022-08-22,17:00:00,50,32,18,FMN GV 05 Lier
60,Mechelsesteenweg 365,2022-08-22,18:00:00,114,66,48,FMN GV 05 Lier
60,Mechelsesteenweg 365,2022-08-22,19:00:00,94,44,50,FMN GV 05 Lier
60,Mechelsesteenweg 365,2022-08-22,20:00:00,88,50,38,FMN GV 05 Lier
60,Mechelsesteenweg 365,2022-08-22,21:00:00,36,10,26,FMN GV 05 Lier
60,Mechelsesteenweg 365,2022-08-22,22:00:00,10,0,10,FMN GV 05 Lier
60,Mechelsesteenweg 365,2022-08-22,23:00:00,4,2,2,FMN GV 05 Lier
60,Mechelsesteenweg 365,2022-08-23,00:00:00,0,0,0,FMN GV 05 Lier
60,Mechelsesteenweg 365,2022-08-23,01:00:00,2,0,2,FMN GV 05 Lier
60,Mechelsesteenweg 365,2022-08-23,02:00:00,0,0,0,FMN GV 05 Lier
60,Mechelsesteenweg 365,2022-08-23,03:00:00,2,0,2,FMN GV 05 Lier
60,Mechelsesteenweg 365,2022-08-23,04:00:00,2,0,2,FMN GV 05 Lier
60,Mechelsesteenweg 365,2022-08-23,05:00:00,6,0,6,FMN GV 05 Lier
60,Mechelsesteenweg 365,2022-08-23,06:00:00,58,16,42,FMN GV 05 Lier
60,Mechelsesteenweg 365,2022-08-23,07:00:00,76,8,68,FMN GV 05 Lier
60,Mechelsesteenweg 365,2022-08-23,08:00:00,112,46,66,FMN GV 05 Lier
60,Mechelsesteenweg 365,2022-08-23,09:00:00,148,80,68,FMN GV 05 Lier
60,Mechelsesteenweg 365,2022-08-23,10:00:00,188,68,120,FMN GV 05 Lier
60,Mechelsesteenweg 365,2022-08-23,11:00:00,108,42,66,FMN GV 05 Lier
60,Mechelsesteenweg 365,2022-08-23,12:00:00,0,0,0,FMN GV 05 Lier
60,Mechelsesteenweg 365,2022-08-23,13:00:00,8,0,8,FMN GV 05 Lier
60,Mechelsesteenweg 365,2022-08-23,14:00:00,10,4,6,FMN GV 05 Lier
60,Mechelsesteenweg 365,2022-08-23,15:00:00,0,0,0,FMN GV 05 Lier
60,Mechelsesteenweg 365,2022-08-23,16:00:00,0,0,0,FMN GV 05 Lier
60,Mechelsesteenweg 365,2022-08-23,17:00:00,54,38,16,FMN GV 05 Lier
60,Mechelsesteenweg 365,2022-08-23,18:00:00,148,72,76,FMN GV 05 Lier
60,Mechelsesteenweg 365,2022-08-23,19:00:00,130,64,66,FMN GV 05 Lier
60,Mechelsesteenweg 365,2022-08-23,20:00:00,170,50,120,FMN GV 05 Lier
60,Mechelsesteenweg 365,2022-08-23,21:00:00,60,28,32,FMN GV 05 Lier
60,Mechelsesteenweg 365,2022-08-23,22:00:00,8,2,6,FMN GV 05 Lier
60,Mechelsesteenweg 365,2022-08-23,23:00:00,2,0,2,FMN GV 05 Lier
60,Mechelsesteenweg 365,2022-08-24,00:00:00,0,0,0,FMN GV 05 Lier
60,Mechelsesteenweg 365,2022-08-24,01:00:00,0,0,0,FMN GV 05 Lier
60,Mechelsesteenweg 365,2022-08-24,02:00:00,0,0,0,FMN GV 05 Lier
60,Mechelsesteenweg 365,2022-08-24,03:00:00,0,0,0,FMN GV 05 Lier
60,Mechelsesteenweg 365,2022-08-24,04:00:00,2,0,2,FMN GV 05 Lier
60,Mechelsesteenweg 365,2022-08-24,05:00:00,6,2,4,FMN GV 05 Lier
60,Mechelsesteenweg 365,2022-08-24,06:00:00,54,16,38,FMN GV 05 Lier
60,Mechelsesteenweg 365,2022-08-24,07:00:00,80,16,64,FMN GV 05 Lier
60,Mechelsesteenweg 365,2022-08-24,08:00:00,118,54,64,FMN GV 05 Lier
60,Mechelsesteenweg 365,2022-08-24,09:00:00,142,86,56,FMN GV 05 Lier
60,Mechelsesteenweg 365,2022-08-24,10:00:00,152,68,84,FMN GV 05 Lier
60,Mechelsesteenweg 365,2022-08-24,11:00:00,176,88,88,FMN GV 05 Lier
60,Mechelsesteenweg 365,2022-08-24,12:00:00,32,14,18,FMN GV 05 Lier
60,Mechelsesteenweg 365,2022-08-24,13:00:00,0,0,0,FMN GV 05 Lier
60,Mechelsesteenweg 365,2022-08-24,14:00:00,0,0,0,FMN GV 05 Lier
60,Mechelsesteenweg 365,2022-08-24,15:00:00,0,0,0,FMN GV 05 Lier
60,Mechelsesteenweg 365,2022-08-24,16:00:00,2,0,2,FMN GV 05 Lier
60,Mechelsesteenweg 365,2022-08-24,17:00:00,58,20,38,FMN GV 05 Lier
60,Mechelsesteenweg 365,2022-08-24,18:00:00,148,90,58,FMN GV 05 Lier
60,Mechelsesteenweg 365,2022-08-24,19:00:00,234,144,90,FMN GV 05 Lier
60,Mechelsesteenweg 365,2022-08-24,20:00:00,214,70,144,FMN GV 05 Lier
60,Mechelsesteenweg 365,2022-08-24,21:00:00,28,10,18,FMN GV 05 Lier
60,Mechelsesteenweg 365,2022-08-24,22:00:00,24,12,12,FMN GV 05 Lier
60,Mechelsesteenweg 365,2022-08-24,23:00:00,10,2,8,FMN GV 05 Lier
60,Mechelsesteenweg 365,2022-08-25,00:00:00,6,6,0,FMN GV 05 Lier
60,Mechelsesteenweg 365,2022-08-25,01:00:00,2,0,2,FMN GV 05 Lier
60,Mechelsesteenweg 365,2022-08-25,02:00:00,0,0,0,FMN GV 05 Lier
60,Mechelsesteenweg 365,2022-08-25,03:00:00,0,0,0,FMN GV 05 Lier
60,Mechelsesteenweg 365,2022-08-25,04:00:00,2,0,2,FMN GV 05 Lier
60,Mechelsesteenweg 365,2022-08-25,05:00:00,4,0,4,FMN GV 05 Lier
60,Mechelsesteenweg 365,2022-08-25,06:00:00,38,6,32,FMN GV 05 Lier
60,Mechelsesteenweg 365,2022-08-25,07:00:00,74,16,58,FMN GV 05 Lier
60,Mechelsesteenweg 365,2022-08-25,08:00:00,150,72,78,FMN GV 05 Lier
60,Mechelsesteenweg 365,2022-08-25,09:00:00,142,92,50,FMN GV 05 Lier
60,Mechelsesteenweg 365,2022-08-25,10:00:00,174,64,110,FMN GV 05 Lier
60,Mechelsesteenweg 365,2022-08-25,11:00:00,108,54,54,FMN GV 05 Lier
60,Mechelsesteenweg 365,2022-08-25,12:00:00,0,0,0,FMN GV 05 Lier
60,Mechelsesteenweg 365,2022-08-25,13:00:00,0,0,0,FMN GV 05 Lier
60,Mechelsesteenweg 365,2022-08-25,14:00:00,0,0,0,FMN GV 05 Lier
60,Mechelsesteenweg 365,2022-08-25,15:00:00,0,0,0,FMN GV 05 Lier
60,Mechelsesteenweg 365,2022-08-25,16:00:00,44,28,16,FMN GV 05 Lier
60,Mechelsesteenweg 365,2022-08-25,17:00:00,54,30,24,FMN GV 05 Lier
60,Mechelsesteenweg 365,2022-08-25,18:00:00,110,58,52,FMN GV 05 Lier
60,Mechelsesteenweg 365,2022-08-25,19:00:00,196,86,110,FMN GV 05 Lier
60,Mechelsesteenweg 365,2022-08-25,20:00:00,170,62,108,FMN GV 05 Lier
60,Mechelsesteenweg 365,2022-08-25,21:00:00,46,12,34,FMN GV 05 Lier
60,Mechelsesteenweg 365,2022-08-25,22:00:00,20,10,10,FMN GV 05 Lier
60,Mechelsesteenweg 365,2022-08-25,23:00:00,16,10,6,FMN GV 05 Lier
60,Mechelsesteenweg 365,2022-08-26,00:00:00,26,26,0,FMN GV 05 Lier
60,Mechelsesteenweg 365,2022-08-26,01:00:00,0,0,0,FMN GV 05 Lier
60,Mechelsesteenweg 365,2022-08-26,02:00:00,0,0,0,FMN GV 05 Lier
60,Mechelsesteenweg 365,2022-08-26,03:00:00,0,0,0,FMN GV 05 Lier
60,Mechelsesteenweg 365,2022-08-26,04:00:00,0,0,0,FMN GV 05 Lier
60,Mechelsesteenweg 365,2022-08-26,05:00:00,4,2,2,FMN GV 05 Lier
60,Mechelsesteenweg 365,2022-08-26,06:00:00,40,12,28,FMN GV 05 Lier
60,Mechelsesteenweg 365,2022-08-26,07:00:00,66,18,48,FMN GV 05 Lier
60,Mechelsesteenweg 365,2022-08-26,08:00:00,76,20,56,FMN GV 05 Lier
60,Mechelsesteenweg 365,2022-08-26,09:00:00,90,38,52,FMN GV 05 Lier
60,Mechelsesteenweg 365,2022-08-26,10:00:00,78,32,46,FMN GV 05 Lier
60,Mechelsesteenweg 365,2022-08-26,11:00:00,92,38,54,FMN GV 05 Lier
60,Mechelsesteenweg 365,2022-08-26,12:00:00,108,74,34,FMN GV 05 Lier
60,Mechelsesteenweg 365,2022-08-26,13:00:00,98,60,38,FMN GV 05 Lier
60,Mechelsesteenweg 365,2022-08-26,14:00:00,170,72,98,FMN GV 05 Lier
60,Mechelsesteenweg 365,2022-08-26,15:00:00,128,60,68,FMN GV 05 Lier
60,Mechelsesteenweg 365,2022-08-26,16:00:00,126,82,44,FMN GV 05 Lier
60,Mechelsesteenweg 365,2022-08-26,17:00:00,94,46,48,FMN GV 05 Lier
60,Mechelsesteenweg 365,2022-08-26,18:00:00,102,68,34,FMN GV 05 Lier
60,Mechelsesteenweg 365,2022-08-26,19:00:00,86,30,56,FMN GV 05 Lier
60,Mechelsesteenweg 365,2022-08-26,20:00:00,46,10,36,FMN GV 05 Lier
60,Mechelsesteenweg 365,2022-08-26,21:00:00,10,4,6,FMN GV 05 Lier
60,Mechelsesteenweg 365,2022-08-26,22:00:00,10,6,4,FMN GV 05 Lier
60,Mechelsesteenweg 365,2022-08-26,23:00:00,6,2,4,FMN GV 05 Lier
60,Mechelsesteenweg 365,2022-08-27,00:00:00,4,2,2,FMN GV 05 Lier
60,Mechelsesteenweg 365,2022-08-27,01:00:00,0,0,0,FMN GV 05 Lier
60,Mechelsesteenweg 365,2022-08-27,02:00:00,2,2,0,FMN GV 05 Lier
60,Mechelsesteenweg 365,2022-08-27,03:00:00,0,0,0,FMN GV 05 Lier
60,Mechelsesteenweg 365,2022-08-27,04:00:00,0,0,0,FMN GV 05 Lier
60,Mechelsesteenweg 365,2022-08-27,05:00:00,0,0,0,FMN GV 05 Lier
60,Mechelsesteenweg 365,2022-08-27,06:00:00,4,2,2,FMN GV 05 Lier
60,Mechelsesteenweg 365,2022-08-27,07:00:00,6,0,6,FMN GV 05 Lier
60,Mechelsesteenweg 365,2022-08-27,08:00:00,40,28,12,FMN GV 05 Lier
60,Mechelsesteenweg 365,2022-08-27,09:00:00,124,74,50,FMN GV 05 Lier
60,Mechelsesteenweg 365,2022-08-27,10:00:00,236,102,134,FMN GV 05 Lier
60,Mechelsesteenweg 365,2022-08-27,11:00:00,196,102,94,FMN GV 05 Lier
60,Mechelsesteenweg 365,2022-08-27,12:00:00,58,26,32,FMN GV 05 Lier
60,Mechelsesteenweg 365,2022-08-27,13:00:00,164,58,106,FMN GV 05 Lier
60,Mechelsesteenweg 365,2022-08-27,14:00:00,184,64,120,FMN GV 05 Lier
60,Mechelsesteenweg 365,2022-08-27,15:00:00,290,138,152,FMN GV 05 Lier
60,Mechelsesteenweg 365,2022-08-27,16:00:00,158,38,120,FMN GV 05 Lier
60,Mechelsesteenweg 365,2022-08-27,17:00:00,94,38,56,FMN GV 05 Lier
60,Mechelsesteenweg 365,2022-08-27,18:00:00,64,20,44,FMN GV 05 Lier
60,Mechelsesteenweg 365,2022-08-27,19:00:00,46,12,34,FMN GV 05 Lier
60,Mechelsesteenweg 365,2022-08-27,20:00:00,36,6,30,FMN GV 05 Lier
60,Mechelsesteenweg 365,2022-08-27,21:00:00,24,8,16,FMN GV 05 Lier
60,Mechelsesteenweg 365,2022-08-27,22:00:00,8,6,2,FMN GV 05 Lier
60,Mechelsesteenweg 365,2022-08-27,23:00:00,14,4,10,FMN GV 05 Lier
60,Mechelsesteenweg 365,2022-08-28,00:00:00,12,10,2,FMN GV 05 Lier
60,Mechelsesteenweg 365,2022-08-28,01:00:00,4,4,0,FMN GV 05 Lier
60,Mechelsesteenweg 365,2022-08-28,02:00:00,2,2,0,FMN GV 05 Lier
60,Mechelsesteenweg 365,2022-08-28,03:00:00,4,4,0,FMN GV 05 Lier
60,Mechelsesteenweg 365,2022-08-28,04:00:00,2,2,0,FMN GV 05 Lier
60,Mechelsesteenweg 365,2022-08-28,05:00:00,0,0,0,FMN GV 05 Lier
60,Mechelsesteenweg 365,2022-08-28,06:00:00,10,8,2,FMN GV 05 Lier
60,Mechelsesteenweg 365,2022-08-28,07:00:00,16,2,14,FMN GV 05 Lier
60,Mechelsesteenweg 365,2022-08-28,08:00:00,48,20,28,FMN GV 05 Lier
60,Mechelsesteenweg 365,2022-08-28,09:00:00,148,74,74,FMN GV 05 Lier
60,Mechelsesteenweg 365,2022-08-28,10:00:00,320,166,154,FMN GV 05 Lier
60,Mechelsesteenweg 365,2022-08-28,11:00:00,288,142,146,FMN GV 05 Lier
60,Mechelsesteenweg 365,2022-08-28,12:00:00,28,12,16,FMN GV 05 Lier
60,Mechelsesteenweg 365,2022-08-28,13:00:00,0,0,0,FMN GV 05 Lier
60,Mechelsesteenweg 365,2022-08-28,14:00:00,0,0,0,FMN GV 05 Lier
60,Mechelsesteenweg 365,2022-08-28,15:00:00,0,0,0,FMN GV 05 Lier
60,Mechelsesteenweg 365,2022-08-28,16:00:00,0,0,0,FMN GV 05 Lier
60,Mechelsesteenweg 365,2022-08-28,17:00:00,60,18,42,FMN GV 05 Lier
60,Mechelsesteenweg 365,2022-08-28,18:00:00,104,36,68,FMN GV 05 Lier
60,Mechelsesteenweg 365,2022-08-28,19:00:00,78,34,44,FMN GV 05 Lier
60,Mechelsesteenweg 365,2022-08-28,20:00:00,36,14,22,FMN GV 05 Lier
60,Mechelsesteenweg 365,2022-08-28,21:00:00,14,8,6,FMN GV 05 Lier
60,Mechelsesteenweg 365,2022-08-28,22:00:00,20,10,10,FMN GV 05 Lier
60,Mechelsesteenweg 365,2022-08-28,23:00:00,6,4,2,FMN GV 05 Lier
60,Mechelsesteenweg 365,2022-08-29,00:00:00,6,6,0,FMN GV 05 Lier
60,Mechelsesteenweg 365,2022-08-29,01:00:00,8,8,0,FMN GV 05 Lier
60,Mechelsesteenweg 365,2022-08-29,02:00:00,0,0,0,FMN GV 05 Lier
60,Mechelsesteenweg 365,2022-08-29,03:00:00,0,0,0,FMN GV 05 Lier
60,Mechelsesteenweg 365,2022-08-29,04:00:00,2,0,2,FMN GV 05 Lier
60,Mechelsesteenweg 365,2022-08-29,05:00:00,4,2,2,FMN GV 05 Lier
60,Mechelsesteenweg 365,2022-08-29,06:00:00,32,10,22,FMN GV 05 Lier
60,Mechelsesteenweg 365,2022-08-29,07:00:00,68,10,58,FMN GV 05 Lier
60,Mechelsesteenweg 365,2022-08-29,08:00:00,100,38,62,FMN GV 05 Lier
60,Mechelsesteenweg 365,2022-08-29,09:00:00,64,34,30,FMN GV 05 Lier
60,Mechelsesteenweg 365,2022-08-29,10:00:00,110,66,44,FMN GV 05 Lier
60,Mechelsesteenweg 365,2022-08-29,11:00:00,138,66,72,FMN GV 05 Lier
60,Mechelsesteenweg 365,2022-08-29,12:00:00,28,14,14,FMN GV 05 Lier
60,Mechelsesteenweg 365,2022-08-29,13:00:00,0,0,0,FMN GV 05 Lier
60,Mechelsesteenweg 365,2022-08-29,14:00:00,0,0,0,FMN GV 05 Lier
60,Mechelsesteenweg 365,2022-08-29,15:00:00,0,0,0,FMN GV 05 Lier
60,Mechelsesteenweg 365,2022-08-29,16:00:00,0,0,0,FMN GV 05 Lier
60,Mechelsesteenweg 365,2022-08-29,17:00:00,56,30,26,FMN GV 05 Lier
60,Mechelsesteenweg 365,2022-08-29,18:00:00,110,54,56,FMN GV 05 Lier
60,Mechelsesteenweg 365,2022-08-29,19:00:00,114,42,72,FMN GV 05 Lier
60,Mechelsesteenweg 365,2022-08-29,20:00:00,82,32,50,FMN GV 05 Lier
60,Mechelsesteenweg 365,2022-08-29,21:00:00,22,10,12,FMN GV 05 Lier
60,Mechelsesteenweg 365,2022-08-29,22:00:00,6,4,2,FMN GV 05 Lier
60,Mechelsesteenweg 365,2022-08-29,23:00:00,2,2,0,FMN GV 05 Lier
60,Mechelsesteenweg 365,2022-08-30,00:00:00,0,0,0,FMN GV 05 Lier
60,Mechelsesteenweg 365,2022-08-30,01:00:00,0,0,0,FMN GV 05 Lier
60,Mechelsesteenweg 365,2022-08-30,02:00:00,0,0,0,FMN GV 05 Lier
60,Mechelsesteenweg 365,2022-08-30,03:00:00,2,0,2,FMN GV 05 Lier
60,Mechelsesteenweg 365,2022-08-30,04:00:00,0,0,0,FMN GV 05 Lier
60,Mechelsesteenweg 365,2022-08-30,05:00:00,4,2,2,FMN GV 05 Lier
60,Mechelsesteenweg 365,2022-08-30,06:00:00,52,10,42,FMN GV 05 Lier
60,Mechelsesteenweg 365,2022-08-30,07:00:00,106,20,86,FMN GV 05 Lier
60,Mechelsesteenweg 365,2022-08-30,08:00:00,100,26,74,FMN GV 05 Lier
60,Mechelsesteenweg 365,2022-08-30,09:00:00,112,58,54,FMN GV 05 Lier
60,Mechelsesteenweg 365,2022-08-30,10:00:00,140,68,72,FMN GV 05 Lier
60,Mechelsesteenweg 365,2022-08-30,11:00:00,152,78,74,FMN GV 05 Lier
60,Mechelsesteenweg 365,2022-08-30,12:00:00,96,40,56,FMN GV 05 Lier
60,Mechelsesteenweg 365,2022-08-30,13:00:00,82,34,48,FMN GV 05 Lier
60,Mechelsesteenweg 365,2022-08-30,14:00:00,12,10,2,FMN GV 05 Lier
60,Mechelsesteenweg 365,2022-08-30,15:00:00,6,0,6,FMN GV 05 Lier
60,Mechelsesteenweg 365,2022-08-30,16:00:00,36,22,14,FMN GV 05 Lier
60,Mechelsesteenweg 365,2022-08-30,17:00:00,138,76,62,FMN GV 05 Lier
60,Mechelsesteenweg 365,2022-08-30,18:00:00,174,88,86,FMN GV 05 Lier
60,Mechelsesteenweg 365,2022-08-30,19:00:00,100,52,48,FMN GV 05 Lier
60,Mechelsesteenweg 365,2022-08-30,20:00:00,100,22,78,FMN GV 05 Lier
60,Mechelsesteenweg 365,2022-08-30,21:00:00,14,8,6,FMN GV 05 Lier
60,Mechelsesteenweg 365,2022-08-30,22:00:00,14,4,10,FMN GV 05 Lier
60,Mechelsesteenweg 365,2022-08-30,23:00:00,10,2,8,FMN GV 05 Lier
60,Mechelsesteenweg 365,2022-08-31,00:00:00,0,0,0,FMN GV 05 Lier
60,Mechelsesteenweg 365,2022-08-31,01:00:00,0,0,0,FMN GV 05 Lier
60,Mechelsesteenweg 365,2022-08-31,02:00:00,0,0,0,FMN GV 05 Lier
60,Mechelsesteenweg 365,2022-08-31,03:00:00,2,0,2,FMN GV 05 Lier
60,Mechelsesteenweg 365,2022-08-31,04:00:00,0,0,0,FMN GV 05 Lier
60,Mechelsesteenweg 365,2022-08-31,05:00:00,6,2,4,FMN GV 05 Lier
60,Mechelsesteenweg 365,2022-08-31,06:00:00,54,12,42,FMN GV 05 Lier
60,Mechelsesteenweg 365,2022-08-31,07:00:00,76,16,60,FMN GV 05 Lier
60,Mechelsesteenweg 365,2022-08-31,08:00:00,76,38,38,FMN GV 05 Lier
60,Mechelsesteenweg 365,2022-08-31,09:00:00,70,32,38,FMN GV 05 Lier
60,Mechelsesteenweg 365,2022-08-31,10:00:00,142,82,60,FMN GV 05 Lier
60,Mechelsesteenweg 365,2022-08-31,11:00:00,112,42,70,FMN GV 05 Lier
60,Mechelsesteenweg 365,2022-08-31,12:00:00,14,6,8,FMN GV 05 Lier
60,Mechelsesteenweg 365,2022-08-31,13:00:00,54,30,24,FMN GV 05 Lier
60,Mechelsesteenweg 365,2022-08-31,14:00:00,0,0,0,FMN GV 05 Lier
60,Mechelsesteenweg 365,2022-08-31,15:00:00,0,0,0,FMN GV 05 Lier
60,Mechelsesteenweg 365,2022-08-31,16:00:00,18,2,16,FMN GV 05 Lier
60,Mechelsesteenweg 365,2022-08-31,17:00:00,100,54,46,FMN GV 05 Lier
60,Mechelsesteenweg 365,2022-08-31,18:00:00,144,72,72,FMN GV 05 Lier
60,Mechelsesteenweg 365,2022-08-31,19:00:00,136,62,74,FMN GV 05 Lier
60,Mechelsesteenweg 365,2022-08-31,20:00:00,156,94,62,FMN GV 05 Lier
60,Mechelsesteenweg 365,2022-08-31,21:00:00,26,10,16,FMN GV 05 Lier
60,Mechelsesteenweg 365,2022-08-31,22:00:00,6,4,2,FMN GV 05 Lier
60,Mechelsesteenweg 365,2022-08-31,23:00:00,2,2,0,FMN GV 05 Lier
60,Mechelsesteenweg 365,2022-09-01,00:00:00,0,0,0,FMN GV 05 Lier
60,Mechelsesteenweg 365,2022-09-01,01:00:00,0,0,0,FMN GV 05 Lier
60,Mechelsesteenweg 365,2022-09-01,02:00:00,0,0,0,FMN GV 05 Lier
60,Mechelsesteenweg 365,2022-09-01,03:00:00,2,0,2,FMN GV 05 Lier
60,Mechelsesteenweg 365,2022-09-01,04:00:00,0,0,0,FMN GV 05 Lier
60,Mechelsesteenweg 365,2022-09-01,05:00:00,4,2,2,FMN GV 05 Lier
60,Mechelsesteenweg 365,2022-09-01,06:00:00,34,10,24,FMN GV 05 Lier
60,Mechelsesteenweg 365,2022-09-01,07:00:00,130,62,68,FMN GV 05 Lier
60,Mechelsesteenweg 365,2022-09-01,08:00:00,162,86,76,FMN GV 05 Lier
60,Mechelsesteenweg 365,2022-09-01,09:00:00,124,78,46,FMN GV 05 Lier
60,Mechelsesteenweg 365,2022-09-01,10:00:00,222,74,148,FMN GV 05 Lier
60,Mechelsesteenweg 365,2022-09-01,11:00:00,164,78,86,FMN GV 05 Lier
60,Mechelsesteenweg 365,2022-09-01,12:00:00,0,0,0,FMN GV 05 Lier
60,Mechelsesteenweg 365,2022-09-01,13:00:00,18,4,14,FMN GV 05 Lier
60,Mechelsesteenweg 365,2022-09-01,14:00:00,54,18,36,FMN GV 05 Lier
60,Mechelsesteenweg 365,2022-09-01,15:00:00,0,0,0,FMN GV 05 Lier
60,Mechelsesteenweg 365,2022-09-01,16:00:00,0,0,0,FMN GV 05 Lier
60,Mechelsesteenweg 365,2022-09-01,17:00:00,48,24,24,FMN GV 05 Lier
60,Mechelsesteenweg 365,2022-09-01,18:00:00,120,60,60,FMN GV 05 Lier
60,Mechelsesteenweg 365,2022-09-01,19:00:00,182,92,90,FMN GV 05 Lier
60,Mechelsesteenweg 365,2022-09-01,20:00:00,60,12,48,FMN GV 05 Lier
60,Mechelsesteenweg 365,2022-09-01,21:00:00,12,4,8,FMN GV 05 Lier
60,Mechelsesteenweg 365,2022-09-01,22:00:00,10,6,4,FMN GV 05 Lier
60,Mechelsesteenweg 365,2022-09-01,23:00:00,6,4,2,FMN GV 05 Lier
60,Mechelsesteenweg 365,2022-09-02,00:00:00,0,0,0,FMN GV 05 Lier
60,Mechelsesteenweg 365,2022-09-02,01:00:00,0,0,0,FMN GV 05 Lier
60,Mechelsesteenweg 365,2022-09-02,02:00:00,0,0,0,FMN GV 05 Lier
60,Mechelsesteenweg 365,2022-09-02,03:00:00,2,0,2,FMN GV 05 Lier
60,Mechelsesteenweg 365,2022-09-02,04:00:00,0,0,0,FMN GV 05 Lier
60,Mechelsesteenweg 365,2022-09-02,05:00:00,6,2,4,FMN GV 05 Lier
60,Mechelsesteenweg 365,2022-09-02,06:00:00,30,8,22,FMN GV 05 Lier
60,Mechelsesteenweg 365,2022-09-02,07:00:00,148,86,62,FMN GV 05 Lier
60,Mechelsesteenweg 365,2022-09-02,08:00:00,156,74,82,FMN GV 05 Lier
60,Mechelsesteenweg 365,2022-09-02,09:00:00,66,44,22,FMN GV 05 Lier
60,Mechelsesteenweg 365,2022-09-02,10:00:00,148,84,64,FMN GV 05 Lier
60,Mechelsesteenweg 365,2022-09-02,11:00:00,96,30,66,FMN GV 05 Lier
60,Mechelsesteenweg 365,2022-09-02,12:00:00,0,0,0,FMN GV 05 Lier
60,Mechelsesteenweg 365,2022-09-02,13:00:00,2,2,0,FMN GV 05 Lier
60,Mechelsesteenweg 365,2022-09-02,14:00:00,0,0,0,FMN GV 05 Lier
60,Mechelsesteenweg 365,2022-09-02,15:00:00,0,0,0,FMN GV 05 Lier
60,Mechelsesteenweg 365,2022-09-02,16:00:00,0,0,0,FMN GV 05 Lier
60,Mechelsesteenweg 365,2022-09-02,17:00:00,28,18,10,FMN GV 05 Lier
60,Mechelsesteenweg 365,2022-09-02,18:00:00,102,60,42,FMN GV 05 Lier
60,Mechelsesteenweg 365,2022-09-02,19:00:00,56,22,34,FMN GV 05 Lier
60,Mechelsesteenweg 365,2022-09-02,20:00:00,44,18,26,FMN GV 05 Lier
60,Mechelsesteenweg 365,2022-09-02,21:00:00,20,6,14,FMN GV 05 Lier
60,Mechelsesteenweg 365,2022-09-02,22:00:00,6,4,2,FMN GV 05 Lier
60,Mechelsesteenweg 365,2022-09-02,23:00:00,6,2,4,FMN GV 05 Lier
60,Mechelsesteenweg 365,2022-09-03,00:00:00,4,4,0,FMN GV 05 Lier
60,Mechelsesteenweg 365,2022-09-03,01:00:00,4,4,0,FMN GV 05 Lier
60,Mechelsesteenweg 365,2022-09-03,02:00:00,0,0,0,FMN GV 05 Lier
60,Mechelsesteenweg 365,2022-09-03,03:00:00,0,0,0,FMN GV 05 Lier
60,Mechelsesteenweg 365,2022-09-03,04:00:00,0,0,0,FMN GV 05 Lier
60,Mechelsesteenweg 365,2022-09-03,05:00:00,0,0,0,FMN GV 05 Lier
60,Mechelsesteenweg 365,2022-09-03,06:00:00,4,4,0,FMN GV 05 Lier
60,Mechelsesteenweg 365,2022-09-03,07:00:00,12,4,8,FMN GV 05 Lier
60,Mechelsesteenweg 365,2022-09-03,08:00:00,34,12,22,FMN GV 05 Lier
60,Mechelsesteenweg 365,2022-09-03,09:00:00,56,36,20,FMN GV 05 Lier
60,Mechelsesteenweg 365,2022-09-03,10:00:00,128,64,64,FMN GV 05 Lier
60,Mechelsesteenweg 365,2022-09-03,11:00:00,90,32,58,FMN GV 05 Lier
60,Mechelsesteenweg 365,2022-09-03,12:00:00,0,0,0,FMN GV 05 Lier
60,Mechelsesteenweg 365,2022-09-03,13:00:00,0,0,0,FMN GV 05 Lier
60,Mechelsesteenweg 365,2022-09-03,14:00:00,0,0,0,FMN GV 05 Lier
60,Mechelsesteenweg 365,2022-09-03,15:00:00,4,2,2,FMN GV 05 Lier
60,Mechelsesteenweg 365,2022-09-03,16:00:00,0,0,0,FMN GV 05 Lier
60,Mechelsesteenweg 365,2022-09-03,17:00:00,70,36,34,FMN GV 05 Lier
60,Mechelsesteenweg 365,2022-09-03,18:00:00,84,44,40,FMN GV 05 Lier
60,Mechelsesteenweg 365,2022-09-03,19:00:00,32,22,10,FMN GV 05 Lier
60,Mechelsesteenweg 365,2022-09-03,20:00:00,28,10,18,FMN GV 05 Lier
60,Mechelsesteenweg 365,2022-09-03,21:00:00,6,4,2,FMN GV 05 Lier
60,Mechelsesteenweg 365,2022-09-03,22:00:00,2,2,0,FMN GV 05 Lier
60,Mechelsesteenweg 365,2022-09-03,23:00:00,2,0,2,FMN GV 05 Lier
60,Mechelsesteenweg 365,2022-09-04,00:00:00,6,6,0,FMN GV 05 Lier
60,Mechelsesteenweg 365,2022-09-04,01:00:00,12,8,4,FMN GV 05 Lier
60,Mechelsesteenweg 365,2022-09-04,02:00:00,0,0,0,FMN GV 05 Lier
60,Mechelsesteenweg 365,2022-09-04,03:00:00,2,2,0,FMN GV 05 Lier
60,Mechelsesteenweg 365,2022-09-04,04:00:00,0,0,0,FMN GV 05 Lier
60,Mechelsesteenweg 365,2022-09-04,05:00:00,0,0,0,FMN GV 05 Lier
60,Mechelsesteenweg 365,2022-09-04,06:00:00,4,2,2,FMN GV 05 Lier
60,Mechelsesteenweg 365,2022-09-04,07:00:00,14,6,8,FMN GV 05 Lier
60,Mechelsesteenweg 365,2022-09-04,08:00:00,50,28,22,FMN GV 05 Lier
60,Mechelsesteenweg 365,2022-09-04,09:00:00,174,84,90,FMN GV 05 Lier
60,Mechelsesteenweg 365,2022-09-04,10:00:00,442,230,212,FMN GV 05 Lier
60,Mechelsesteenweg 365,2022-09-04,11:00:00,514,238,276,FMN GV 05 Lier
60,Mechelsesteenweg 365,2022-09-04,12:00:00,48,26,22,FMN GV 05 Lier
60,Mechelsesteenweg 365,2022-09-04,13:00:00,0,0,0,FMN GV 05 Lier
60,Mechelsesteenweg 365,2022-09-04,14:00:00,0,0,0,FMN GV 05 Lier
60,Mechelsesteenweg 365,2022-09-04,15:00:00,0,0,0,FMN GV 05 Lier
60,Mechelsesteenweg 365,2022-09-04,16:00:00,0,0,0,FMN GV 05 Lier
60,Mechelsesteenweg 365,2022-09-04,17:00:00,50,14,36,FMN GV 05 Lier
60,Mechelsesteenweg 365,2022-09-04,18:00:00,76,28,48,FMN GV 05 Lier
60,Mechelsesteenweg 365,2022-09-04,19:00:00,66,26,40,FMN GV 05 Lier
60,Mechelsesteenweg 365,2022-09-04,20:00:00,58,28,30,FMN GV 05 Lier
60,Mechelsesteenweg 365,2022-09-04,21:00:00,12,4,8,FMN GV 05 Lier
60,Mechelsesteenweg 365,2022-09-04,22:00:00,6,6,0,FMN GV 05 Lier
60,Mechelsesteenweg 365,2022-09-04,23:00:00,0,0,0,FMN GV 05 Lier
60,Mechelsesteenweg 365,2022-09-05,00:00:00,2,0,2,FMN GV 05 Lier
60,Mechelsesteenweg 365,2022-09-05,01:00:00,2,2,0,FMN GV 05 Lier
60,Mechelsesteenweg 365,2022-09-05,02:00:00,0,0,0,FMN GV 05 Lier
60,Mechelsesteenweg 365,2022-09-05,03:00:00,2,0,2,FMN GV 05 Lier
60,Mechelsesteenweg 365,2022-09-05,04:00:00,0,0,0,FMN GV 05 Lier
60,Mechelsesteenweg 365,2022-09-05,05:00:00,0,0,0,FMN GV 05 Lier
60,Mechelsesteenweg 365,2022-09-05,06:00:00,56,18,38,FMN GV 05 Lier
60,Mechelsesteenweg 365,2022-09-05,07:00:00,168,82,86,FMN GV 05 Lier
60,Mechelsesteenweg 365,2022-09-05,08:00:00,154,88,66,FMN GV 05 Lier
60,Mechelsesteenweg 365,2022-09-05,09:00:00,104,48,56,FMN GV 05 Lier
60,Mechelsesteenweg 365,2022-09-05,10:00:00,120,56,64,FMN GV 05 Lier
60,Mechelsesteenweg 365,2022-09-05,11:00:00,106,60,46,FMN GV 05 Lier
60,Mechelsesteenweg 365,2022-09-05,12:00:00,6,4,2,FMN GV 05 Lier
60,Mechelsesteenweg 365,2022-09-05,13:00:00,2,2,0,FMN GV 05 Lier
60,Mechelsesteenweg 365,2022-09-05,14:00:00,0,0,0,FMN GV 05 Lier
60,Mechelsesteenweg 365,2022-09-05,15:00:00,0,0,0,FMN GV 05 Lier
60,Mechelsesteenweg 365,2022-09-05,16:00:00,40,12,28,FMN GV 05 Lier
60,Mechelsesteenweg 365,2022-09-05,17:00:00,92,48,44,FMN GV 05 Lier
60,Mechelsesteenweg 365,2022-09-05,18:00:00,46,24,22,FMN GV 05 Lier
60,Mechelsesteenweg 365,2022-09-05,19:00:00,58,32,26,FMN GV 05 Lier
60,Mechelsesteenweg 365,2022-09-05,20:00:00,26,12,14,FMN GV 05 Lier
60,Mechelsesteenweg 365,2022-09-05,21:00:00,4,4,0,FMN GV 05 Lier
60,Mechelsesteenweg 365,2022-09-05,22:00:00,4,4,0,FMN GV 05 Lier
60,Mechelsesteenweg 365,2022-09-05,23:00:00,2,2,0,FMN GV 05 Lier
60,Mechelsesteenweg 365,2022-09-06,00:00:00,2,0,2,FMN GV 05 Lier
60,Mechelsesteenweg 365,2022-09-06,01:00:00,0,0,0,FMN GV 05 Lier
60,Mechelsesteenweg 365,2022-09-06,02:00:00,0,0,0,FMN GV 05 Lier
60,Mechelsesteenweg 365,2022-09-06,03:00:00,2,0,2,FMN GV 05 Lier
60,Mechelsesteenweg 365,2022-09-06,04:00:00,2,0,2,FMN GV 05 Lier
60,Mechelsesteenweg 365,2022-09-06,05:00:00,4,2,2,FMN GV 05 Lier
60,Mechelsesteenweg 365,2022-09-06,06:00:00,40,8,32,FMN GV 05 Lier
60,Mechelsesteenweg 365,2022-09-06,07:00:00,160,72,88,FMN GV 05 Lier
60,Mechelsesteenweg 365,2022-09-06,08:00:00,156,80,76,FMN GV 05 Lier
60,Mechelsesteenweg 365,2022-09-06,09:00:00,120,68,52,FMN GV 05 Lier
60,Mechelsesteenweg 365,2022-09-06,10:00:00,180,92,88,FMN GV 05 Lier
60,Mechelsesteenweg 365,2022-09-06,11:00:00,164,94,70,FMN GV 05 Lier
60,Mechelsesteenweg 365,2022-09-06,12:00:00,82,40,42,FMN GV 05 Lier
60,Mechelsesteenweg 365,2022-09-06,13:00:00,0,0,0,FMN GV 05 Lier
60,Mechelsesteenweg 365,2022-09-06,14:00:00,0,0,0,FMN GV 05 Lier
60,Mechelsesteenweg 365,2022-09-06,15:00:00,0,0,0,FMN GV 05 Lier
60,Mechelsesteenweg 365,2022-09-06,16:00:00,104,40,64,FMN GV 05 Lier
60,Mechelsesteenweg 365,2022-09-06,17:00:00,194,120,74,FMN GV 05 Lier
60,Mechelsesteenweg 365,2022-09-06,18:00:00,72,40,32,FMN GV 05 Lier
60,Mechelsesteenweg 365,2022-09-06,19:00:00,114,46,68,FMN GV 05 Lier
60,Mechelsesteenweg 365,2022-09-06,20:00:00,48,10,38,FMN GV 05 Lier
60,Mechelsesteenweg 365,2022-09-06,21:00:00,24,6,18,FMN GV 05 Lier
60,Mechelsesteenweg 365,2022-09-06,22:00:00,12,8,4,FMN GV 05 Lier
60,Mechelsesteenweg 365,2022-09-06,23:00:00,4,4,0,FMN GV 05 Lier
60,Mechelsesteenweg 365,2022-09-07,00:00:00,2,0,2,FMN GV 05 Lier
60,Mechelsesteenweg 365,2022-09-07,01:00:00,0,0,0,FMN GV 05 Lier
60,Mechelsesteenweg 365,2022-09-07,02:00:00,0,0,0,FMN GV 05 Lier
60,Mechelsesteenweg 365,2022-09-07,03:00:00,2,0,2,FMN GV 05 Lier
60,Mechelsesteenweg 365,2022-09-07,04:00:00,2,0,2,FMN GV 05 Lier
60,Mechelsesteenweg 365,2022-09-07,05:00:00,4,0,4,FMN GV 05 Lier
60,Mechelsesteenweg 365,2022-09-07,06:00:00,42,10,32,FMN GV 05 Lier
60,Mechelsesteenweg 365,2022-09-07,07:00:00,164,86,78,FMN GV 05 Lier
60,Mechelsesteenweg 365,2022-09-07,08:00:00,146,80,66,FMN GV 05 Lier
60,Mechelsesteenweg 365,2022-09-07,09:00:00,60,10,50,FMN GV 05 Lier
60,Mechelsesteenweg 365,2022-09-07,10:00:00,118,58,60,FMN GV 05 Lier
60,Mechelsesteenweg 365,2022-09-07,11:00:00,160,76,84,FMN GV 05 Lier
60,Mechelsesteenweg 365,2022-09-07,12:00:00,206,60,146,FMN GV 05 Lier
60,Mechelsesteenweg 365,2022-09-07,13:00:00,128,48,80,FMN GV 05 Lier
60,Mechelsesteenweg 365,2022-09-07,14:00:00,146,70,76,FMN GV 05 Lier
60,Mechelsesteenweg 365,2022-09-07,15:00:00,132,72,60,FMN GV 05 Lier
60,Mechelsesteenweg 365,2022-09-07,16:00:00,226,120,106,FMN GV 05 Lier
60,Mechelsesteenweg 365,2022-09-07,17:00:00,174,100,74,FMN GV 05 Lier
60,Mechelsesteenweg 365,2022-09-07,18:00:00,156,74,82,FMN GV 05 Lier
60,Mechelsesteenweg 365,2022-09-07,19:00:00,150,96,54,FMN GV 05 Lier
60,Mechelsesteenweg 365,2022-09-07,20:00:00,98,82,16,FMN GV 05 Lier
60,Mechelsesteenweg 365,2022-09-07,21:00:00,6,2,4,FMN GV 05 Lier
60,Mechelsesteenweg 365,2022-09-07,22:00:00,2,0,2,FMN GV 05 Lier
60,Mechelsesteenweg 365,2022-09-07,23:00:00,4,4,0,FMN GV 05 Lier
60,Mechelsesteenweg 365,2022-09-08,00:00:00,0,0,0,FMN GV 05 Lier
60,Mechelsesteenweg 365,2022-09-08,01:00:00,2,0,2,FMN GV 05 Lier
60,Mechelsesteenweg 365,2022-09-08,02:00:00,0,0,0,FMN GV 05 Lier
60,Mechelsesteenweg 365,2022-09-08,03:00:00,0,0,0,FMN GV 05 Lier
60,Mechelsesteenweg 365,2022-09-08,04:00:00,2,0,2,FMN GV 05 Lier
60,Mechelsesteenweg 365,2022-09-08,05:00:00,4,0,4,FMN GV 05 Lier
60,Mechelsesteenweg 365,2022-09-08,06:00:00,20,8,12,FMN GV 05 Lier
60,Mechelsesteenweg 365,2022-09-08,07:00:00,158,76,82,FMN GV 05 Lier
60,Mechelsesteenweg 365,2022-09-08,08:00:00,130,84,46,FMN GV 05 Lier
60,Mechelsesteenweg 365,2022-09-08,09:00:00,58,28,30,FMN GV 05 Lier
60,Mechelsesteenweg 365,2022-09-08,10:00:00,66,32,34,FMN GV 05 Lier
60,Mechelsesteenweg 365,2022-09-08,11:00:00,86,38,48,FMN GV 05 Lier
60,Mechelsesteenweg 365,2022-09-08,12:00:00,92,26,66,FMN GV 05 Lier
60,Mechelsesteenweg 365,2022-09-08,13:00:00,40,18,22,FMN GV 05 Lier
60,Mechelsesteenweg 365,2022-09-08,14:00:00,148,80,68,FMN GV 05 Lier
60,Mechelsesteenweg 365,2022-09-08,15:00:00,104,54,50,FMN GV 05 Lier
60,Mechelsesteenweg 365,2022-09-08,16:00:00,148,48,100,FMN GV 05 Lier
60,Mechelsesteenweg 365,2022-09-08,17:00:00,96,52,44,FMN GV 05 Lier
60,Mechelsesteenweg 365,2022-09-08,18:00:00,38,18,20,FMN GV 05 Lier
60,Mechelsesteenweg 365,2022-09-08,19:00:00,30,24,6,FMN GV 05 Lier
60,Mechelsesteenweg 365,2022-09-08,20:00:00,18,12,6,FMN GV 05 Lier
60,Mechelsesteenweg 365,2022-09-08,21:00:00,4,4,0,FMN GV 05 Lier
60,Mechelsesteenweg 365,2022-09-08,22:00:00,4,2,2,FMN GV 05 Lier
60,Mechelsesteenweg 365,2022-09-08,23:00:00,0,0,0,FMN GV 05 Lier
60,Mechelsesteenweg 365,2022-09-09,00:00:00,0,0,0,FMN GV 05 Lier
60,Mechelsesteenweg 365,2022-09-09,01:00:00,0,0,0,FMN GV 05 Lier
60,Mechelsesteenweg 365,2022-09-09,02:00:00,0,0,0,FMN GV 05 Lier
60,Mechelsesteenweg 365,2022-09-09,03:00:00,0,0,0,FMN GV 05 Lier
60,Mechelsesteenweg 365,2022-09-09,04:00:00,0,0,0,FMN GV 05 Lier
60,Mechelsesteenweg 365,2022-09-09,05:00:00,4,4,0,FMN GV 05 Lier
60,Mechelsesteenweg 365,2022-09-09,06:00:00,20,10,10,FMN GV 05 Lier
60,Mechelsesteenweg 365,2022-09-09,07:00:00,122,68,54,FMN GV 05 Lier
60,Mechelsesteenweg 365,2022-09-09,08:00:00,186,56,130,FMN GV 05 Lier
60,Mechelsesteenweg 365,2022-09-09,09:00:00,62,22,40,FMN GV 05 Lier
60,Mechelsesteenweg 365,2022-09-09,10:00:00,30,22,8,FMN GV 05 Lier
60,Mechelsesteenweg 365,2022-09-09,11:00:00,30,18,12,FMN GV 05 Lier
60,Mechelsesteenweg 365,2022-09-09,12:00:00,18,10,8,FMN GV 05 Lier
60,Mechelsesteenweg 365,2022-09-09,13:00:00,26,16,10,FMN GV 05 Lier
60,Mechelsesteenweg 365,2022-09-09,14:00:00,48,12,36,FMN GV 05 Lier
60,Mechelsesteenweg 365,2022-09-09,15:00:00,206,144,62,FMN GV 05 Lier
60,Mechelsesteenweg 365,2022-09-09,16:00:00,176,46,130,FMN GV 05 Lier
60,Mechelsesteenweg 365,2022-09-09,17:00:00,48,20,28,FMN GV 05 Lier
60,Mechelsesteenweg 365,2022-09-09,18:00:00,24,20,4,FMN GV 05 Lier
60,Mechelsesteenweg 365,2022-09-09,19:00:00,18,8,10,FMN GV 05 Lier
60,Mechelsesteenweg 365,2022-09-09,20:00:00,10,8,2,FMN GV 05 Lier
60,Mechelsesteenweg 365,2022-09-09,21:00:00,6,4,2,FMN GV 05 Lier
60,Mechelsesteenweg 365,2022-09-09,22:00:00,4,2,2,FMN GV 05 Lier
60,Mechelsesteenweg 365,2022-09-09,23:00:00,2,2,0,FMN GV 05 Lier
60,Mechelsesteenweg 365,2022-09-10,00:00:00,4,2,2,FMN GV 05 Lier
60,Mechelsesteenweg 365,2022-09-10,01:00:00,0,0,0,FMN GV 05 Lier
60,Mechelsesteenweg 365,2022-09-10,02:00:00,0,0,0,FMN GV 05 Lier
60,Mechelsesteenweg 365,2022-09-10,03:00:00,0,0,0,FMN GV 05 Lier
60,Mechelsesteenweg 365,2022-09-10,04:00:00,2,0,2,FMN GV 05 Lier
60,Mechelsesteenweg 365,2022-09-10,05:00:00,0,0,0,FMN GV 05 Lier
60,Mechelsesteenweg 365,2022-09-10,06:00:00,4,2,2,FMN GV 05 Lier
60,Mechelsesteenweg 365,2022-09-10,07:00:00,4,2,2,FMN GV 05 Lier
60,Mechelsesteenweg 365,2022-09-10,08:00:00,2,0,2,FMN GV 05 Lier
60,Mechelsesteenweg 365,2022-09-10,09:00:00,2,2,0,FMN GV 05 Lier
60,Mechelsesteenweg 365,2022-09-10,10:00:00,8,2,6,FMN GV 05 Lier
60,Mechelsesteenweg 365,2022-09-10,11:00:00,24,2,22,FMN GV 05 Lier
60,Mechelsesteenweg 365,2022-09-10,12:00:00,16,6,10,FMN GV 05 Lier
60,Mechelsesteenweg 365,2022-09-10,13:00:00,12,10,2,FMN GV 05 Lier
60,Mechelsesteenweg 365,2022-09-10,14:00:00,60,2,58,FMN GV 05 Lier
60,Mechelsesteenweg 365,2022-09-10,15:00:00,18,6,12,FMN GV 05 Lier
60,Mechelsesteenweg 365,2022-09-10,16:00:00,36,16,20,FMN GV 05 Lier
60,Mechelsesteenweg 365,2022-09-10,17:00:00,32,16,16,FMN GV 05 Lier
60,Mechelsesteenweg 365,2022-09-10,18:00:00,38,22,16,FMN GV 05 Lier
60,Mechelsesteenweg 365,2022-09-10,19:00:00,20,12,8,FMN GV 05 Lier
60,Mechelsesteenweg 365,2022-09-10,20:00:00,18,8,10,FMN GV 05 Lier
60,Mechelsesteenweg 365,2022-09-10,21:00:00,4,0,4,FMN GV 05 Lier
60,Mechelsesteenweg 365,2022-09-10,22:00:00,10,4,6,FMN GV 05 Lier
60,Mechelsesteenweg 365,2022-09-10,23:00:00,2,2,0,FMN GV 05 Lier
60,Mechelsesteenweg 365,2022-09-11,00:00:00,4,4,0,FMN GV 05 Lier
60,Mechelsesteenweg 365,2022-09-11,01:00:00,2,2,0,FMN GV 05 Lier
60,Mechelsesteenweg 365,2022-09-11,02:00:00,4,2,2,FMN GV 05 Lier
60,Mechelsesteenweg 365,2022-09-11,03:00:00,0,0,0,FMN GV 05 Lier
60,Mechelsesteenweg 365,2022-09-11,04:00:00,0,0,0,FMN GV 05 Lier
60,Mechelsesteenweg 365,2022-09-11,05:00:00,0,0,0,FMN GV 05 Lier
60,Mechelsesteenweg 365,2022-09-11,06:00:00,0,0,0,FMN GV 05 Lier
60,Mechelsesteenweg 365,2022-09-11,07:00:00,6,4,2,FMN GV 05 Lier
60,Mechelsesteenweg 365,2022-09-11,08:00:00,26,14,12,FMN GV 05 Lier
60,Mechelsesteenweg 365,2022-09-11,09:00:00,126,72,54,FMN GV 05 Lier
60,Mechelsesteenweg 365,2022-09-11,10:00:00,374,150,224,FMN GV 05 Lier
60,Mechelsesteenweg 365,2022-09-11,11:00:00,392,174,218,FMN GV 05 Lier
60,Mechelsesteenweg 365,2022-09-11,12:00:00,262,148,114,FMN GV 05 Lier
60,Mechelsesteenweg 365,2022-09-11,13:00:00,230,100,130,FMN GV 05 Lier
60,Mechelsesteenweg 365,2022-09-11,14:00:00,344,176,168,FMN GV 05 Lier
60,Mechelsesteenweg 365,2022-09-11,15:00:00,342,188,154,FMN GV 05 Lier
60,Mechelsesteenweg 365,2022-09-11,16:00:00,296,120,176,FMN GV 05 Lier
60,Mechelsesteenweg 365,2022-09-11,17:00:00,244,112,132,FMN GV 05 Lier
60,Mechelsesteenweg 365,2022-09-11,18:00:00,82,30,52,FMN GV 05 Lier
60,Mechelsesteenweg 365,2022-09-11,19:00:00,74,44,30,FMN GV 05 Lier
60,Mechelsesteenweg 365,2022-09-11,20:00:00,26,12,14,FMN GV 05 Lier
60,Mechelsesteenweg 365,2022-09-11,21:00:00,10,4,6,FMN GV 05 Lier
60,Mechelsesteenweg 365,2022-09-11,22:00:00,0,0,0,FMN GV 05 Lier
60,Mechelsesteenweg 365,2022-09-11,23:00:00,0,0,0,FMN GV 05 Lier
60,Mechelsesteenweg 365,2022-09-12,00:00:00,0,0,0,FMN GV 05 Lier
60,Mechelsesteenweg 365,2022-09-12,01:00:00,2,2,0,FMN GV 05 Lier
60,Mechelsesteenweg 365,2022-09-12,02:00:00,0,0,0,FMN GV 05 Lier
60,Mechelsesteenweg 365,2022-09-12,03:00:00,0,0,0,FMN GV 05 Lier
60,Mechelsesteenweg 365,2022-09-12,04:00:00,2,0,2,FMN GV 05 Lier
60,Mechelsesteenweg 365,2022-09-12,05:00:00,10,2,8,FMN GV 05 Lier
60,Mechelsesteenweg 365,2022-09-12,06:00:00,28,16,12,FMN GV 05 Lier
60,Mechelsesteenweg 365,2022-09-12,07:00:00,186,78,108,FMN GV 05 Lier
60,Mechelsesteenweg 365,2022-09-12,08:00:00,152,76,76,FMN GV 05 Lier
60,Mechelsesteenweg 365,2022-09-12,09:00:00,92,64,28,FMN GV 05 Lier
60,Mechelsesteenweg 365,2022-09-12,10:00:00,182,122,60,FMN GV 05 Lier
60,Mechelsesteenweg 365,2022-09-12,11:00:00,182,94,88,FMN GV 05 Lier
60,Mechelsesteenweg 365,2022-09-12,12:00:00,162,70,92,FMN GV 05 Lier
60,Mechelsesteenweg 365,2022-09-12,13:00:00,264,108,156,FMN GV 05 Lier
60,Mechelsesteenweg 365,2022-09-12,14:00:00,338,148,190,FMN GV 05 Lier
60,Mechelsesteenweg 365,2022-09-12,15:00:00,310,142,168,FMN GV 05 Lier
60,Mechelsesteenweg 365,2022-09-12,16:00:00,416,162,254,FMN GV 05 Lier
60,Mechelsesteenweg 365,2022-09-12,17:00:00,268,132,136,FMN GV 05 Lier
60,Mechelsesteenweg 365,2022-09-12,18:00:00,126,78,48,FMN GV 05 Lier
60,Mechelsesteenweg 365,2022-09-12,19:00:00,106,54,52,FMN GV 05 Lier
60,Mechelsesteenweg 365,2022-09-12,20:00:00,54,24,30,FMN GV 05 Lier
60,Mechelsesteenweg 365,2022-09-12,21:00:00,2,0,2,FMN GV 05 Lier
60,Mechelsesteenweg 365,2022-09-12,22:00:00,4,4,0,FMN GV 05 Lier
60,Mechelsesteenweg 365,2022-09-12,23:00:00,4,2,2,FMN GV 05 Lier
60,Mechelsesteenweg 365,2022-09-13,00:00:00,0,0,0,FMN GV 05 Lier
60,Mechelsesteenweg 365,2022-09-13,01:00:00,0,0,0,FMN GV 05 Lier
60,Mechelsesteenweg 365,2022-09-13,02:00:00,0,0,0,FMN GV 05 Lier
60,Mechelsesteenweg 365,2022-09-13,03:00:00,0,0,0,FMN GV 05 Lier
60,Mechelsesteenweg 365,2022-09-13,04:00:00,4,0,4,FMN GV 05 Lier
60,Mechelsesteenweg 365,2022-09-13,05:00:00,8,0,8,FMN GV 05 Lier
60,Mechelsesteenweg 365,2022-09-13,06:00:00,34,14,20,FMN GV 05 Lier
60,Mechelsesteenweg 365,2022-09-13,07:00:00,166,78,88,FMN GV 05 Lier
60,Mechelsesteenweg 365,2022-09-13,08:00:00,150,86,64,FMN GV 05 Lier
60,Mechelsesteenweg 365,2022-09-13,09:00:00,102,64,38,FMN GV 05 Lier
60,Mechelsesteenweg 365,2022-09-13,10:00:00,130,60,70,FMN GV 05 Lier
60,Mechelsesteenweg 365,2022-09-13,11:00:00,122,54,68,FMN GV 05 Lier
60,Mechelsesteenweg 365,2022-09-13,12:00:00,124,74,50,FMN GV 05 Lier
60,Mechelsesteenweg 365,2022-09-13,13:00:00,156,88,68,FMN GV 05 Lier
60,Mechelsesteenweg 365,2022-09-13,14:00:00,158,108,50,FMN GV 05 Lier
60,Mechelsesteenweg 365,2022-09-13,15:00:00,126,48,78,FMN GV 05 Lier
60,Mechelsesteenweg 365,2022-09-13,16:00:00,236,70,166,FMN GV 05 Lier
60,Mechelsesteenweg 365,2022-09-13,17:00:00,104,60,44,FMN GV 05 Lier
60,Mechelsesteenweg 365,2022-09-13,18:00:00,44,22,22,FMN GV 05 Lier
60,Mechelsesteenweg 365,2022-09-13,19:00:00,36,26,10,FMN GV 05 Lier
60,Mechelsesteenweg 365,2022-09-13,20:00:00,10,2,8,FMN GV 05 Lier
60,Mechelsesteenweg 365,2022-09-13,21:00:00,6,2,4,FMN GV 05 Lier
60,Mechelsesteenweg 365,2022-09-13,22:00:00,0,0,0,FMN GV 05 Lier
60,Mechelsesteenweg 365,2022-09-13,23:00:00,2,2,0,FMN GV 05 Lier
60,Mechelsesteenweg 365,2022-09-14,00:00:00,0,0,0,FMN GV 05 Lier
60,Mechelsesteenweg 365,2022-09-14,01:00:00,0,0,0,FMN GV 05 Lier
60,Mechelsesteenweg 365,2022-09-14,02:00:00,0,0,0,FMN GV 05 Lier
60,Mechelsesteenweg 365,2022-09-14,03:00:00,0,0,0,FMN GV 05 Lier
60,Mechelsesteenweg 365,2022-09-14,04:00:00,2,0,2,FMN GV 05 Lier
60,Mechelsesteenweg 365,2022-09-14,05:00:00,2,0,2,FMN GV 05 Lier
60,Mechelsesteenweg 365,2022-09-14,06:00:00,12,4,8,FMN GV 05 Lier
60,Mechelsesteenweg 365,2022-09-14,07:00:00,76,46,30,FMN GV 05 Lier
60,Mechelsesteenweg 365,2022-09-14,08:00:00,64,40,24,FMN GV 05 Lier
60,Mechelsesteenweg 365,2022-09-14,09:00:00,68,48,20,FMN GV 05 Lier
60,Mechelsesteenweg 365,2022-09-14,10:00:00,8,2,6,FMN GV 05 Lier
60,Mechelsesteenweg 365,2022-09-14,11:00:00,32,10,22,FMN GV 05 Lier
60,Mechelsesteenweg 365,2022-09-14,12:00:00,130,38,92,FMN GV 05 Lier
60,Mechelsesteenweg 365,2022-09-14,13:00:00,18,8,10,FMN GV 05 Lier
60,Mechelsesteenweg 365,2022-09-14,14:00:00,22,14,8,FMN GV 05 Lier
60,Mechelsesteenweg 365,2022-09-14,15:00:00,28,14,14,FMN GV 05 Lier
60,Mechelsesteenweg 365,2022-09-14,16:00:00,26,14,12,FMN GV 05 Lier
60,Mechelsesteenweg 365,2022-09-14,17:00:00,48,30,18,FMN GV 05 Lier
60,Mechelsesteenweg 365,2022-09-14,18:00:00,22,16,6,FMN GV 05 Lier
60,Mechelsesteenweg 365,2022-09-14,19:00:00,38,28,10,FMN GV 05 Lier
60,Mechelsesteenweg 365,2022-09-14,20:00:00,28,20,8,FMN GV 05 Lier
60,Mechelsesteenweg 365,2022-09-14,21:00:00,10,2,8,FMN GV 05 Lier
60,Mechelsesteenweg 365,2022-09-14,22:00:00,8,4,4,FMN GV 05 Lier
60,Mechelsesteenweg 365,2022-09-14,23:00:00,0,0,0,FMN GV 05 Lier
60,Mechelsesteenweg 365,2022-09-15,00:00:00,0,0,0,FMN GV 05 Lier
60,Mechelsesteenweg 365,2022-09-15,01:00:00,0,0,0,FMN GV 05 Lier
60,Mechelsesteenweg 365,2022-09-15,02:00:00,0,0,0,FMN GV 05 Lier
60,Mechelsesteenweg 365,2022-09-15,03:00:00,0,0,0,FMN GV 05 Lier
60,Mechelsesteenweg 365,2022-09-15,04:00:00,2,0,2,FMN GV 05 Lier
60,Mechelsesteenweg 365,2022-09-15,05:00:00,4,0,4,FMN GV 05 Lier
60,Mechelsesteenweg 365,2022-09-15,06:00:00,28,12,16,FMN GV 05 Lier
60,Mechelsesteenweg 365,2022-09-15,07:00:00,150,70,80,FMN GV 05 Lier
60,Mechelsesteenweg 365,2022-09-15,08:00:00,176,92,84,FMN GV 05 Lier
60,Mechelsesteenweg 365,2022-09-15,09:00:00,74,38,36,FMN GV 05 Lier
60,Mechelsesteenweg 365,2022-09-15,10:00:00,70,28,42,FMN GV 05 Lier
60,Mechelsesteenweg 365,2022-09-15,11:00:00,112,52,60,FMN GV 05 Lier
60,Mechelsesteenweg 365,2022-09-15,12:00:00,80,30,50,FMN GV 05 Lier
60,Mechelsesteenweg 365,2022-09-15,13:00:00,100,68,32,FMN GV 05 Lier
60,Mechelsesteenweg 365,2022-09-15,14:00:00,126,58,68,FMN GV 05 Lier
60,Mechelsesteenweg 365,2022-09-15,15:00:00,166,84,82,FMN GV 05 Lier
60,Mechelsesteenweg 365,2022-09-15,16:00:00,298,110,188,FMN GV 05 Lier
60,Mechelsesteenweg 365,2022-09-15,17:00:00,140,92,48,FMN GV 05 Lier
60,Mechelsesteenweg 365,2022-09-15,18:00:00,98,48,50,FMN GV 05 Lier
60,Mechelsesteenweg 365,2022-09-15,19:00:00,48,26,22,FMN GV 05 Lier
60,Mechelsesteenweg 365,2022-09-15,20:00:00,24,10,14,FMN GV 05 Lier
60,Mechelsesteenweg 365,2022-09-15,21:00:00,14,10,4,FMN GV 05 Lier
60,Mechelsesteenweg 365,2022-09-15,22:00:00,6,4,2,FMN GV 05 Lier
60,Mechelsesteenweg 365,2022-09-15,23:00:00,0,0,0,FMN GV 05 Lier
60,Mechelsesteenweg 365,2022-09-16,00:00:00,2,2,0,FMN GV 05 Lier
60,Mechelsesteenweg 365,2022-09-16,01:00:00,0,0,0,FMN GV 05 Lier
60,Mechelsesteenweg 365,2022-09-16,02:00:00,0,0,0,FMN GV 05 Lier
60,Mechelsesteenweg 365,2022-09-16,03:00:00,0,0,0,FMN GV 05 Lier
60,Mechelsesteenweg 365,2022-09-16,04:00:00,2,0,2,FMN GV 05 Lier
60,Mechelsesteenweg 365,2022-09-16,05:00:00,2,0,2,FMN GV 05 Lier
60,Mechelsesteenweg 365,2022-09-16,06:00:00,18,4,14,FMN GV 05 Lier
60,Mechelsesteenweg 365,2022-09-16,07:00:00,102,50,52,FMN GV 05 Lier
60,Mechelsesteenweg 365,2022-09-16,08:00:00,90,66,24,FMN GV 05 Lier
60,Mechelsesteenweg 365,2022-09-16,09:00:00,16,4,12,FMN GV 05 Lier
60,Mechelsesteenweg 365,2022-09-16,10:00:00,16,10,6,FMN GV 05 Lier
60,Mechelsesteenweg 365,2022-09-16,11:00:00,20,12,8,FMN GV 05 Lier
60,Mechelsesteenweg 365,2022-09-16,12:00:00,30,8,22,FMN GV 05 Lier
60,Mechelsesteenweg 365,2022-09-16,13:00:00,22,16,6,FMN GV 05 Lier
60,Mechelsesteenweg 365,2022-09-16,14:00:00,42,26,16,FMN GV 05 Lier
60,Mechelsesteenweg 365,2022-09-16,15:00:00,52,24,28,FMN GV 05 Lier
60,Mechelsesteenweg 365,2022-09-16,16:00:00,156,38,118,FMN GV 05 Lier
60,Mechelsesteenweg 365,2022-09-16,17:00:00,50,34,16,FMN GV 05 Lier
60,Mechelsesteenweg 365,2022-09-16,18:00:00,30,18,12,FMN GV 05 Lier
60,Mechelsesteenweg 365,2022-09-16,19:00:00,10,6,4,FMN GV 05 Lier
60,Mechelsesteenweg 365,2022-09-16,20:00:00,8,4,4,FMN GV 05 Lier
60,Mechelsesteenweg 365,2022-09-16,21:00:00,2,2,0,FMN GV 05 Lier
60,Mechelsesteenweg 365,2022-09-16,22:00:00,6,2,4,FMN GV 05 Lier
60,Mechelsesteenweg 365,2022-09-16,23:00:00,0,0,0,FMN GV 05 Lier
60,Mechelsesteenweg 365,2022-09-17,00:00:00,0,0,0,FMN GV 05 Lier
60,Mechelsesteenweg 365,2022-09-17,01:00:00,0,0,0,FMN GV 05 Lier
60,Mechelsesteenweg 365,2022-09-17,02:00:00,0,0,0,FMN GV 05 Lier
60,Mechelsesteenweg 365,2022-09-17,03:00:00,0,0,0,FMN GV 05 Lier
60,Mechelsesteenweg 365,2022-09-17,04:00:00,2,0,2,FMN GV 05 Lier
60,Mechelsesteenweg 365,2022-09-17,05:00:00,2,0,2,FMN GV 05 Lier
60,Mechelsesteenweg 365,2022-09-17,06:00:00,2,0,2,FMN GV 05 Lier
60,Mechelsesteenweg 365,2022-09-17,07:00:00,8,4,4,FMN GV 05 Lier
60,Mechelsesteenweg 365,2022-09-17,08:00:00,8,6,2,FMN GV 05 Lier
60,Mechelsesteenweg 365,2022-09-17,09:00:00,20,8,12,FMN GV 05 Lier
60,Mechelsesteenweg 365,2022-09-17,10:00:00,28,16,12,FMN GV 05 Lier
60,Mechelsesteenweg 365,2022-09-17,11:00:00,44,16,28,FMN GV 05 Lier
60,Mechelsesteenweg 365,2022-09-17,12:00:00,10,2,8,FMN GV 05 Lier
60,Mechelsesteenweg 365,2022-09-17,13:00:00,22,0,22,FMN GV 05 Lier
60,Mechelsesteenweg 365,2022-09-17,14:00:00,30,16,14,FMN GV 05 Lier
60,Mechelsesteenweg 365,2022-09-17,15:00:00,52,28,24,FMN GV 05 Lier
60,Mechelsesteenweg 365,2022-09-17,16:00:00,12,4,8,FMN GV 05 Lier
60,Mechelsesteenweg 365,2022-09-17,17:00:00,16,10,6,FMN GV 05 Lier
60,Mechelsesteenweg 365,2022-09-17,18:00:00,10,4,6,FMN GV 05 Lier
60,Mechelsesteenweg 365,2022-09-17,19:00:00,12,0,12,FMN GV 05 Lier
60,Mechelsesteenweg 365,2022-09-17,20:00:00,0,0,0,FMN GV 05 Lier
60,Mechelsesteenweg 365,2022-09-17,21:00:00,0,0,0,FMN GV 05 Lier
60,Mechelsesteenweg 365,2022-09-17,22:00:00,6,0,6,FMN GV 05 Lier
60,Mechelsesteenweg 365,2022-09-17,23:00:00,0,0,0,FMN GV 05 Lier
60,Mechelsesteenweg 365,2022-09-18,00:00:00,0,0,0,FMN GV 05 Lier
60,Mechelsesteenweg 365,2022-09-18,01:00:00,0,0,0,FMN GV 05 Lier
60,Mechelsesteenweg 365,2022-09-18,02:00:00,0,0,0,FMN GV 05 Lier
60,Mechelsesteenweg 365,2022-09-18,03:00:00,0,0,0,FMN GV 05 Lier
60,Mechelsesteenweg 365,2022-09-18,04:00:00,0,0,0,FMN GV 05 Lier
60,Mechelsesteenweg 365,2022-09-18,05:00:00,0,0,0,FMN GV 05 Lier
60,Mechelsesteenweg 365,2022-09-18,06:00:00,0,0,0,FMN GV 05 Lier
60,Mechelsesteenweg 365,2022-09-18,07:00:00,2,0,2,FMN GV 05 Lier
60,Mechelsesteenweg 365,2022-09-18,08:00:00,6,0,6,FMN GV 05 Lier
60,Mechelsesteenweg 365,2022-09-18,09:00:00,54,34,20,FMN GV 05 Lier
60,Mechelsesteenweg 365,2022-09-18,10:00:00,120,52,68,FMN GV 05 Lier
60,Mechelsesteenweg 365,2022-09-18,11:00:00,84,34,50,FMN GV 05 Lier
60,Mechelsesteenweg 365,2022-09-18,12:00:00,66,36,30,FMN GV 05 Lier
60,Mechelsesteenweg 365,2022-09-18,13:00:00,48,26,22,FMN GV 05 Lier
60,Mechelsesteenweg 365,2022-09-18,14:00:00,48,26,22,FMN GV 05 Lier
60,Mechelsesteenweg 365,2022-09-18,15:00:00,52,16,36,FMN GV 05 Lier
60,Mechelsesteenweg 365,2022-09-18,16:00:00,22,8,14,FMN GV 05 Lier
60,Mechelsesteenweg 365,2022-09-18,17:00:00,16,8,8,FMN GV 05 Lier
60,Mechelsesteenweg 365,2022-09-18,18:00:00,16,8,8,FMN GV 05 Lier
60,Mechelsesteenweg 365,2022-09-18,19:00:00,0,0,0,FMN GV 05 Lier
60,Mechelsesteenweg 365,2022-09-18,20:00:00,2,2,0,FMN GV 05 Lier
60,Mechelsesteenweg 365,2022-09-18,21:00:00,0,0,0,FMN GV 05 Lier
60,Mechelsesteenweg 365,2022-09-18,22:00:00,0,0,0,FMN GV 05 Lier
60,Mechelsesteenweg 365,2022-09-18,23:00:00,0,0,0,FMN GV 05 Lier
60,Mechelsesteenweg 365,2022-09-19,00:00:00,0,0,0,FMN GV 05 Lier
60,Mechelsesteenweg 365,2022-09-19,01:00:00,2,2,0,FMN GV 05 Lier
60,Mechelsesteenweg 365,2022-09-19,02:00:00,0,0,0,FMN GV 05 Lier
60,Mechelsesteenweg 365,2022-09-19,03:00:00,0,0,0,FMN GV 05 Lier
60,Mechelsesteenweg 365,2022-09-19,04:00:00,2,0,2,FMN GV 05 Lier
60,Mechelsesteenweg 365,2022-09-19,05:00:00,2,2,0,FMN GV 05 Lier
60,Mechelsesteenweg 365,2022-09-19,06:00:00,30,8,22,FMN GV 05 Lier
60,Mechelsesteenweg 365,2022-09-19,07:00:00,152,52,100,FMN GV 05 Lier
60,Mechelsesteenweg 365,2022-09-19,08:00:00,138,88,50,FMN GV 05 Lier
60,Mechelsesteenweg 365,2022-09-19,09:00:00,128,56,72,FMN GV 05 Lier
60,Mechelsesteenweg 365,2022-09-19,10:00:00,72,36,36,FMN GV 05 Lier
60,Mechelsesteenweg 365,2022-09-19,11:00:00,86,34,52,FMN GV 05 Lier
60,Mechelsesteenweg 365,2022-09-19,12:00:00,86,50,36,FMN GV 05 Lier
60,Mechelsesteenweg 365,2022-09-19,13:00:00,108,38,70,FMN GV 05 Lier
60,Mechelsesteenweg 365,2022-09-19,14:00:00,142,54,88,FMN GV 05 Lier
60,Mechelsesteenweg 365,2022-09-19,15:00:00,150,74,76,FMN GV 05 Lier
60,Mechelsesteenweg 365,2022-09-19,16:00:00,316,112,204,FMN GV 05 Lier
60,Mechelsesteenweg 365,2022-09-19,17:00:00,150,76,74,FMN GV 05 Lier
60,Mechelsesteenweg 365,2022-09-19,18:00:00,104,60,44,FMN GV 05 Lier
60,Mechelsesteenweg 365,2022-09-19,19:00:00,46,26,20,FMN GV 05 Lier
60,Mechelsesteenweg 365,2022-09-19,20:00:00,26,10,16,FMN GV 05 Lier
60,Mechelsesteenweg 365,2022-09-19,21:00:00,8,4,4,FMN GV 05 Lier
60,Mechelsesteenweg 365,2022-09-19,22:00:00,6,6,0,FMN GV 05 Lier
60,Mechelsesteenweg 365,2022-09-19,23:00:00,2,0,2,FMN GV 05 Lier
60,Mechelsesteenweg 365,2022-09-20,00:00:00,0,0,0,FMN GV 05 Lier
60,Mechelsesteenweg 365,2022-09-20,01:00:00,0,0,0,FMN GV 05 Lier
60,Mechelsesteenweg 365,2022-09-20,02:00:00,0,0,0,FMN GV 05 Lier
60,Mechelsesteenweg 365,2022-09-20,03:00:00,0,0,0,FMN GV 05 Lier
60,Mechelsesteenweg 365,2022-09-20,04:00:00,2,0,2,FMN GV 05 Lier
60,Mechelsesteenweg 365,2022-09-20,05:00:00,2,0,2,FMN GV 05 Lier
60,Mechelsesteenweg 365,2022-09-20,06:00:00,28,2,26,FMN GV 05 Lier
60,Mechelsesteenweg 365,2022-09-20,07:00:00,142,68,74,FMN GV 05 Lier
60,Mechelsesteenweg 365,2022-09-20,08:00:00,170,96,74,FMN GV 05 Lier
60,Mechelsesteenweg 365,2022-09-20,09:00:00,72,36,36,FMN GV 05 Lier
60,Mechelsesteenweg 365,2022-09-20,10:00:00,96,50,46,FMN GV 05 Lier
60,Mechelsesteenweg 365,2022-09-20,11:00:00,94,64,30,FMN GV 05 Lier
60,Mechelsesteenweg 365,2022-09-20,12:00:00,90,46,44,FMN GV 05 Lier
60,Mechelsesteenweg 365,2022-09-20,13:00:00,120,82,38,FMN GV 05 Lier
60,Mechelsesteenweg 365,2022-09-20,14:00:00,190,90,100,FMN GV 05 Lier
60,Mechelsesteenweg 365,2022-09-20,15:00:00,214,112,102,FMN GV 05 Lier
60,Mechelsesteenweg 365,2022-09-20,16:00:00,298,132,166,FMN GV 05 Lier
60,Mechelsesteenweg 365,2022-09-20,17:00:00,166,102,64,FMN GV 05 Lier
60,Mechelsesteenweg 365,2022-09-20,18:00:00,86,52,34,FMN GV 05 Lier
60,Mechelsesteenweg 365,2022-09-20,19:00:00,54,34,20,FMN GV 05 Lier
60,Mechelsesteenweg 365,2022-09-20,20:00:00,24,4,20,FMN GV 05 Lier
60,Mechelsesteenweg 365,2022-09-20,21:00:00,12,0,12,FMN GV 05 Lier
60,Mechelsesteenweg 365,2022-09-20,22:00:00,2,2,0,FMN GV 05 Lier
60,Mechelsesteenweg 365,2022-09-20,23:00:00,4,4,0,FMN GV 05 Lier
60,Mechelsesteenweg 365,2022-09-21,00:00:00,0,0,0,FMN GV 05 Lier
60,Mechelsesteenweg 365,2022-09-21,01:00:00,0,0,0,FMN GV 05 Lier
60,Mechelsesteenweg 365,2022-09-21,02:00:00,0,0,0,FMN GV 05 Lier
60,Mechelsesteenweg 365,2022-09-21,03:00:00,0,0,0,FMN GV 05 Lier
60,Mechelsesteenweg 365,2022-09-21,04:00:00,2,0,2,FMN GV 05 Lier
60,Mechelsesteenweg 365,2022-09-21,05:00:00,0,0,0,FMN GV 05 Lier
60,Mechelsesteenweg 365,2022-09-21,06:00:00,26,8,18,FMN GV 05 Lier
60,Mechelsesteenweg 365,2022-09-21,07:00:00,140,68,72,FMN GV 05 Lier
60,Mechelsesteenweg 365,2022-09-21,08:00:00,122,62,60,FMN GV 05 Lier
60,Mechelsesteenweg 365,2022-09-21,09:00:00,104,62,42,FMN GV 05 Lier
60,Mechelsesteenweg 365,2022-09-21,10:00:00,146,48,98,FMN GV 05 Lier
60,Mechelsesteenweg 365,2022-09-21,11:00:00,136,60,76,FMN GV 05 Lier
60,Mechelsesteenweg 365,2022-09-21,12:00:00,264,78,186,FMN GV 05 Lier
60,Mechelsesteenweg 365,2022-09-21,13:00:00,168,68,100,FMN GV 05 Lier
60,Mechelsesteenweg 365,2022-09-21,14:00:00,242,124,118,FMN GV 05 Lier
60,Mechelsesteenweg 365,2022-09-21,15:00:00,258,134,124,FMN GV 05 Lier
60,Mechelsesteenweg 365,2022-09-21,16:00:00,210,122,88,FMN GV 05 Lier
60,Mechelsesteenweg 365,2022-09-21,17:00:00,204,104,100,FMN GV 05 Lier
60,Mechelsesteenweg 365,2022-09-21,18:00:00,156,86,70,FMN GV 05 Lier
60,Mechelsesteenweg 365,2022-09-21,19:00:00,120,82,38,FMN GV 05 Lier
60,Mechelsesteenweg 365,2022-09-21,20:00:00,56,34,22,FMN GV 05 Lier
60,Mechelsesteenweg 365,2022-09-21,21:00:00,14,4,10,FMN GV 05 Lier
60,Mechelsesteenweg 365,2022-09-21,22:00:00,6,2,4,FMN GV 05 Lier
60,Mechelsesteenweg 365,2022-09-21,23:00:00,2,2,0,FMN GV 05 Lier
60,Mechelsesteenweg 365,2022-09-22,00:00:00,2,0,2,FMN GV 05 Lier
60,Mechelsesteenweg 365,2022-09-22,01:00:00,0,0,0,FMN GV 05 Lier
60,Mechelsesteenweg 365,2022-09-22,02:00:00,0,0,0,FMN GV 05 Lier
60,Mechelsesteenweg 365,2022-09-22,03:00:00,0,0,0,FMN GV 05 Lier
60,Mechelsesteenweg 365,2022-09-22,04:00:00,2,0,2,FMN GV 05 Lier
60,Mechelsesteenweg 365,2022-09-22,05:00:00,4,0,4,FMN GV 05 Lier
60,Mechelsesteenweg 365,2022-09-22,06:00:00,20,6,14,FMN GV 05 Lier
60,Mechelsesteenweg 365,2022-09-22,07:00:00,152,68,84,FMN GV 05 Lier
60,Mechelsesteenweg 365,2022-09-22,08:00:00,150,78,72,FMN GV 05 Lier
60,Mechelsesteenweg 365,2022-09-22,09:00:00,76,56,20,FMN GV 05 Lier
60,Mechelsesteenweg 365,2022-09-22,10:00:00,86,48,38,FMN GV 05 Lier
60,Mechelsesteenweg 365,2022-09-22,11:00:00,120,60,60,FMN GV 05 Lier
60,Mechelsesteenweg 365,2022-09-22,12:00:00,140,66,74,FMN GV 05 Lier
60,Mechelsesteenweg 365,2022-09-22,13:00:00,262,118,144,FMN GV 05 Lier
60,Mechelsesteenweg 365,2022-09-22,14:00:00,354,140,214,FMN GV 05 Lier
60,Mechelsesteenweg 365,2022-09-22,15:00:00,322,152,170,FMN GV 05 Lier
60,Mechelsesteenweg 365,2022-09-22,16:00:00,412,152,260,FMN GV 05 Lier
60,Mechelsesteenweg 365,2022-09-22,17:00:00,208,126,82,FMN GV 05 Lier
60,Mechelsesteenweg 365,2022-09-22,18:00:00,182,100,82,FMN GV 05 Lier
60,Mechelsesteenweg 365,2022-09-22,19:00:00,78,28,50,FMN GV 05 Lier
60,Mechelsesteenweg 365,2022-09-22,20:00:00,28,8,20,FMN GV 05 Lier
60,Mechelsesteenweg 365,2022-09-22,21:00:00,14,6,8,FMN GV 05 Lier
60,Mechelsesteenweg 365,2022-09-22,22:00:00,6,2,4,FMN GV 05 Lier
60,Mechelsesteenweg 365,2022-09-22,23:00:00,4,4,0,FMN GV 05 Lier
60,Mechelsesteenweg 365,2022-09-23,00:00:00,4,4,0,FMN GV 05 Lier
60,Mechelsesteenweg 365,2022-09-23,01:00:00,0,0,0,FMN GV 05 Lier
60,Mechelsesteenweg 365,2022-09-23,02:00:00,0,0,0,FMN GV 05 Lier
60,Mechelsesteenweg 365,2022-09-23,03:00:00,0,0,0,FMN GV 05 Lier
60,Mechelsesteenweg 365,2022-09-23,04:00:00,0,0,0,FMN GV 05 Lier
60,Mechelsesteenweg 365,2022-09-23,05:00:00,0,0,0,FMN GV 05 Lier
60,Mechelsesteenweg 365,2022-09-23,06:00:00,26,12,14,FMN GV 05 Lier
60,Mechelsesteenweg 365,2022-09-23,07:00:00,126,66,60,FMN GV 05 Lier
60,Mechelsesteenweg 365,2022-09-23,08:00:00,128,76,52,FMN GV 05 Lier
60,Mechelsesteenweg 365,2022-09-23,09:00:00,146,94,52,FMN GV 05 Lier
60,Mechelsesteenweg 365,2022-09-23,10:00:00,124,74,50,FMN GV 05 Lier
60,Mechelsesteenweg 365,2022-09-23,11:00:00,124,66,58,FMN GV 05 Lier
60,Mechelsesteenweg 365,2022-09-23,12:00:00,116,66,50,FMN GV 05 Lier
60,Mechelsesteenweg 365,2022-09-23,13:00:00,196,102,94,FMN GV 05 Lier
60,Mechelsesteenweg 365,2022-09-23,14:00:00,220,142,78,FMN GV 05 Lier
60,Mechelsesteenweg 365,2022-09-23,15:00:00,254,96,158,FMN GV 05 Lier
60,Mechelsesteenweg 365,2022-09-23,16:00:00,290,120,170,FMN GV 05 Lier
60,Mechelsesteenweg 365,2022-09-23,17:00:00,124,60,64,FMN GV 05 Lier
60,Mechelsesteenweg 365,2022-09-23,18:00:00,44,20,24,FMN GV 05 Lier
60,Mechelsesteenweg 365,2022-09-23,19:00:00,32,6,26,FMN GV 05 Lier
60,Mechelsesteenweg 365,2022-09-23,20:00:00,10,4,6,FMN GV 05 Lier
60,Mechelsesteenweg 365,2022-09-23,21:00:00,4,0,4,FMN GV 05 Lier
60,Mechelsesteenweg 365,2022-09-23,22:00:00,8,6,2,FMN GV 05 Lier
60,Mechelsesteenweg 365,2022-09-23,23:00:00,0,0,0,FMN GV 05 Lier
60,Mechelsesteenweg 365,2022-09-24,00:00:00,2,2,0,FMN GV 05 Lier
60,Mechelsesteenweg 365,2022-09-24,01:00:00,4,2,2,FMN GV 05 Lier
60,Mechelsesteenweg 365,2022-09-24,02:00:00,0,0,0,FMN GV 05 Lier
60,Mechelsesteenweg 365,2022-09-24,03:00:00,0,0,0,FMN GV 05 Lier
60,Mechelsesteenweg 365,2022-09-24,04:00:00,0,0,0,FMN GV 05 Lier
60,Mechelsesteenweg 365,2022-09-24,05:00:00,0,0,0,FMN GV 05 Lier
60,Mechelsesteenweg 365,2022-09-24,06:00:00,2,2,0,FMN GV 05 Lier
60,Mechelsesteenweg 365,2022-09-24,07:00:00,4,2,2,FMN GV 05 Lier
60,Mechelsesteenweg 365,2022-09-24,08:00:00,8,2,6,FMN GV 05 Lier
60,Mechelsesteenweg 365,2022-09-24,09:00:00,14,6,8,FMN GV 05 Lier
60,Mechelsesteenweg 365,2022-09-24,10:00:00,16,8,8,FMN GV 05 Lier
60,Mechelsesteenweg 365,2022-09-24,11:00:00,70,20,50,FMN GV 05 Lier
60,Mechelsesteenweg 365,2022-09-24,12:00:00,20,8,12,FMN GV 05 Lier
60,Mechelsesteenweg 365,2022-09-24,13:00:00,10,4,6,FMN GV 05 Lier
60,Mechelsesteenweg 365,2022-09-24,14:00:00,22,8,14,FMN GV 05 Lier
60,Mechelsesteenweg 365,2022-09-24,15:00:00,4,0,4,FMN GV 05 Lier
60,Mechelsesteenweg 365,2022-09-24,16:00:00,30,18,12,FMN GV 05 Lier
60,Mechelsesteenweg 365,2022-09-24,17:00:00,12,4,8,FMN GV 05 Lier
60,Mechelsesteenweg 365,2022-09-24,18:00:00,10,4,6,FMN GV 05 Lier
60,Mechelsesteenweg 365,2022-09-24,19:00:00,6,4,2,FMN GV 05 Lier
60,Mechelsesteenweg 365,2022-09-24,20:00:00,4,0,4,FMN GV 05 Lier
60,Mechelsesteenweg 365,2022-09-24,21:00:00,0,0,0,FMN GV 05 Lier
60,Mechelsesteenweg 365,2022-09-24,22:00:00,6,4,2,FMN GV 05 Lier
60,Mechelsesteenweg 365,2022-09-24,23:00:00,8,4,4,FMN GV 05 Lier
60,Mechelsesteenweg 365,2022-09-25,00:00:00,4,4,0,FMN GV 05 Lier
60,Mechelsesteenweg 365,2022-09-25,01:00:00,2,2,0,FMN GV 05 Lier
60,Mechelsesteenweg 365,2022-09-25,02:00:00,0,0,0,FMN GV 05 Lier
60,Mechelsesteenweg 365,2022-09-25,03:00:00,0,0,0,FMN GV 05 Lier
60,Mechelsesteenweg 365,2022-09-25,04:00:00,0,0,0,FMN GV 05 Lier
60,Mechelsesteenweg 365,2022-09-25,05:00:00,0,0,0,FMN GV 05 Lier
60,Mechelsesteenweg 365,2022-09-25,06:00:00,2,2,0,FMN GV 05 Lier
60,Mechelsesteenweg 365,2022-09-25,07:00:00,4,2,2,FMN GV 05 Lier
60,Mechelsesteenweg 365,2022-09-25,08:00:00,10,6,4,FMN GV 05 Lier
60,Mechelsesteenweg 365,2022-09-25,09:00:00,102,50,52,FMN GV 05 Lier
60,Mechelsesteenweg 365,2022-09-25,10:00:00,276,142,134,FMN GV 05 Lier
60,Mechelsesteenweg 365,2022-09-25,11:00:00,354,164,190,FMN GV 05 Lier
60,Mechelsesteenweg 365,2022-09-25,12:00:00,326,162,164,FMN GV 05 Lier
60,Mechelsesteenweg 365,2022-09-25,13:00:00,226,110,116,FMN GV 05 Lier
60,Mechelsesteenweg 365,2022-09-25,14:00:00,336,152,184,FMN GV 05 Lier
60,Mechelsesteenweg 365,2022-09-25,15:00:00,300,140,160,FMN GV 05 Lier
60,Mechelsesteenweg 365,2022-09-25,16:00:00,258,110,148,FMN GV 05 Lier
60,Mechelsesteenweg 365,2022-09-25,17:00:00,144,60,84,FMN GV 05 Lier
60,Mechelsesteenweg 365,2022-09-25,18:00:00,46,18,28,FMN GV 05 Lier
60,Mechelsesteenweg 365,2022-09-25,19:00:00,8,8,0,FMN GV 05 Lier
60,Mechelsesteenweg 365,2022-09-25,20:00:00,20,8,12,FMN GV 05 Lier
60,Mechelsesteenweg 365,2022-09-25,21:00:00,8,2,6,FMN GV 05 Lier
60,Mechelsesteenweg 365,2022-09-25,22:00:00,8,0,8,FMN GV 05 Lier
60,Mechelsesteenweg 365,2022-09-25,23:00:00,0,0,0,FMN GV 05 Lier
60,Mechelsesteenweg 365,2022-09-26,00:00:00,0,0,0,FMN GV 05 Lier
60,Mechelsesteenweg 365,2022-09-26,01:00:00,0,0,0,FMN GV 05 Lier
60,Mechelsesteenweg 365,2022-09-26,02:00:00,2,0,2,FMN GV 05 Lier
60,Mechelsesteenweg 365,2022-09-26,03:00:00,0,0,0,FMN GV 05 Lier
60,Mechelsesteenweg 365,2022-09-26,04:00:00,0,0,0,FMN GV 05 Lier
60,Mechelsesteenweg 365,2022-09-26,05:00:00,4,0,4,FMN GV 05 Lier
60,Mechelsesteenweg 365,2022-09-26,06:00:00,22,6,16,FMN GV 05 Lier
60,Mechelsesteenweg 365,2022-09-26,07:00:00,102,46,56,FMN GV 05 Lier
60,Mechelsesteenweg 365,2022-09-26,08:00:00,104,72,32,FMN GV 05 Lier
60,Mechelsesteenweg 365,2022-09-26,09:00:00,36,12,24,FMN GV 05 Lier
60,Mechelsesteenweg 365,2022-09-26,10:00:00,34,22,12,FMN GV 05 Lier
60,Mechelsesteenweg 365,2022-09-26,11:00:00,24,8,16,FMN GV 05 Lier
60,Mechelsesteenweg 365,2022-09-26,12:00:00,8,6,2,FMN GV 05 Lier
60,Mechelsesteenweg 365,2022-09-26,13:00:00,8,6,2,FMN GV 05 Lier
60,Mechelsesteenweg 365,2022-09-26,14:00:00,10,6,4,FMN GV 05 Lier
60,Mechelsesteenweg 365,2022-09-26,15:00:00,46,14,32,FMN GV 05 Lier
60,Mechelsesteenweg 365,2022-09-26,16:00:00,148,50,98,FMN GV 05 Lier
60,Mechelsesteenweg 365,2022-09-26,17:00:00,50,32,18,FMN GV 05 Lier
60,Mechelsesteenweg 365,2022-09-26,18:00:00,32,24,8,FMN GV 05 Lier
60,Mechelsesteenweg 365,2022-09-26,19:00:00,18,10,8,FMN GV 05 Lier
60,Mechelsesteenweg 365,2022-09-26,20:00:00,4,4,0,FMN GV 05 Lier
60,Mechelsesteenweg 365,2022-09-26,21:00:00,4,0,4,FMN GV 05 Lier
60,Mechelsesteenweg 365,2022-09-26,22:00:00,2,2,0,FMN GV 05 Lier
60,Mechelsesteenweg 365,2022-09-26,23:00:00,0,0,0,FMN GV 05 Lier
60,Mechelsesteenweg 365,2022-09-27,00:00:00,0,0,0,FMN GV 05 Lier
60,Mechelsesteenweg 365,2022-09-27,01:00:00,0,0,0,FMN GV 05 Lier
60,Mechelsesteenweg 365,2022-09-27,02:00:00,0,0,0,FMN GV 05 Lier
60,Mechelsesteenweg 365,2022-09-27,03:00:00,0,0,0,FMN GV 05 Lier
60,Mechelsesteenweg 365,2022-09-27,04:00:00,0,0,0,FMN GV 05 Lier
60,Mechelsesteenweg 365,2022-09-27,05:00:00,0,0,0,FMN GV 05 Lier
60,Mechelsesteenweg 365,2022-09-27,06:00:00,22,8,14,FMN GV 05 Lier
60,Mechelsesteenweg 365,2022-09-27,07:00:00,74,34,40,FMN GV 05 Lier
60,Mechelsesteenweg 365,2022-09-27,08:00:00,86,58,28,FMN GV 05 Lier
60,Mechelsesteenweg 365,2022-09-27,09:00:00,24,8,16,FMN GV 05 Lier
60,Mechelsesteenweg 365,2022-09-27,10:00:00,26,18,8,FMN GV 05 Lier
60,Mechelsesteenweg 365,2022-09-27,11:00:00,16,6,10,FMN GV 05 Lier
60,Mechelsesteenweg 365,2022-09-27,12:00:00,32,14,18,FMN GV 05 Lier
60,Mechelsesteenweg 365,2022-09-27,13:00:00,30,18,12,FMN GV 05 Lier
60,Mechelsesteenweg 365,2022-09-27,14:00:00,34,18,16,FMN GV 05 Lier
60,Mechelsesteenweg 365,2022-09-27,15:00:00,66,12,54,FMN GV 05 Lier
60,Mechelsesteenweg 365,2022-09-27,16:00:00,106,42,64,FMN GV 05 Lier
60,Mechelsesteenweg 365,2022-09-27,17:00:00,54,32,22,FMN GV 05 Lier
60,Mechelsesteenweg 365,2022-09-27,18:00:00,24,14,10,FMN GV 05 Lier
60,Mechelsesteenweg 365,2022-09-27,19:00:00,8,4,4,FMN GV 05 Lier
60,Mechelsesteenweg 365,2022-09-27,20:00:00,8,4,4,FMN GV 05 Lier
60,Mechelsesteenweg 365,2022-09-27,21:00:00,0,0,0,FMN GV 05 Lier
60,Mechelsesteenweg 365,2022-09-27,22:00:00,2,2,0,FMN GV 05 Lier
60,Mechelsesteenweg 365,2022-09-27,23:00:00,0,0,0,FMN GV 05 Lier
60,Mechelsesteenweg 365,2022-09-28,00:00:00,0,0,0,FMN GV 05 Lier
60,Mechelsesteenweg 365,2022-09-28,01:00:00,0,0,0,FMN GV 05 Lier
60,Mechelsesteenweg 365,2022-09-28,02:00:00,0,0,0,FMN GV 05 Lier
60,Mechelsesteenweg 365,2022-09-28,03:00:00,0,0,0,FMN GV 05 Lier
60,Mechelsesteenweg 365,2022-09-28,04:00:00,0,0,0,FMN GV 05 Lier
60,Mechelsesteenweg 365,2022-09-28,05:00:00,4,2,2,FMN GV 05 Lier
60,Mechelsesteenweg 365,2022-09-28,06:00:00,22,6,16,FMN GV 05 Lier
60,Mechelsesteenweg 365,2022-09-28,07:00:00,92,54,38,FMN GV 05 Lier
60,Mechelsesteenweg 365,2022-09-28,08:00:00,112,74,38,FMN GV 05 Lier
60,Mechelsesteenweg 365,2022-09-28,09:00:00,44,22,22,FMN GV 05 Lier
60,Mechelsesteenweg 365,2022-09-28,10:00:00,82,40,42,FMN GV 05 Lier
60,Mechelsesteenweg 365,2022-09-28,11:00:00,92,44,48,FMN GV 05 Lier
60,Mechelsesteenweg 365,2022-09-28,12:00:00,198,40,158,FMN GV 05 Lier
60,Mechelsesteenweg 365,2022-09-28,13:00:00,66,32,34,FMN GV 05 Lier
60,Mechelsesteenweg 365,2022-09-28,14:00:00,38,12,26,FMN GV 05 Lier
60,Mechelsesteenweg 365,2022-09-28,15:00:00,58,36,22,FMN GV 05 Lier
60,Mechelsesteenweg 365,2022-09-28,16:00:00,66,40,26,FMN GV 05 Lier
60,Mechelsesteenweg 365,2022-09-28,17:00:00,98,62,36,FMN GV 05 Lier
60,Mechelsesteenweg 365,2022-09-28,18:00:00,86,44,42,FMN GV 05 Lier
60,Mechelsesteenweg 365,2022-09-28,19:00:00,110,82,28,FMN GV 05 Lier
60,Mechelsesteenweg 365,2022-09-28,20:00:00,38,30,8,FMN GV 05 Lier
60,Mechelsesteenweg 365,2022-09-28,21:00:00,6,4,2,FMN GV 05 Lier
60,Mechelsesteenweg 365,2022-09-28,22:00:00,4,2,2,FMN GV 05 Lier
60,Mechelsesteenweg 365,2022-09-28,23:00:00,6,2,4,FMN GV 05 Lier
60,Mechelsesteenweg 365,2022-09-29,00:00:00,0,0,0,FMN GV 05 Lier
60,Mechelsesteenweg 365,2022-09-29,01:00:00,0,0,0,FMN GV 05 Lier
60,Mechelsesteenweg 365,2022-09-29,02:00:00,0,0,0,FMN GV 05 Lier
60,Mechelsesteenweg 365,2022-09-29,03:00:00,0,0,0,FMN GV 05 Lier
60,Mechelsesteenweg 365,2022-09-29,04:00:00,0,0,0,FMN GV 05 Lier
60,Mechelsesteenweg 365,2022-09-29,05:00:00,6,2,4,FMN GV 05 Lier
60,Mechelsesteenweg 365,2022-09-29,06:00:00,18,10,8,FMN GV 05 Lier
60,Mechelsesteenweg 365,2022-09-29,07:00:00,132,62,70,FMN GV 05 Lier
60,Mechelsesteenweg 365,2022-09-29,08:00:00,134,72,62,FMN GV 05 Lier
60,Mechelsesteenweg 365,2022-09-29,09:00:00,106,66,40,FMN GV 05 Lier
60,Mechelsesteenweg 365,2022-09-29,10:00:00,78,40,38,FMN GV 05 Lier
60,Mechelsesteenweg 365,2022-09-29,11:00:00,160,88,72,FMN GV 05 Lier
60,Mechelsesteenweg 365,2022-09-29,12:00:00,146,62,84,FMN GV 05 Lier
60,Mechelsesteenweg 365,2022-09-29,13:00:00,122,56,66,FMN GV 05 Lier
60,Mechelsesteenweg 365,2022-09-29,14:00:00,160,62,98,FMN GV 05 Lier
60,Mechelsesteenweg 365,2022-09-29,15:00:00,156,82,74,FMN GV 05 Lier
60,Mechelsesteenweg 365,2022-09-29,16:00:00,306,104,202,FMN GV 05 Lier
60,Mechelsesteenweg 365,2022-09-29,17:00:00,124,78,46,FMN GV 05 Lier
60,Mechelsesteenweg 365,2022-09-29,18:00:00,54,28,26,FMN GV 05 Lier
60,Mechelsesteenweg 365,2022-09-29,19:00:00,46,28,18,FMN GV 05 Lier
60,Mechelsesteenweg 365,2022-09-29,20:00:00,10,6,4,FMN GV 05 Lier
60,Mechelsesteenweg 365,2022-09-29,21:00:00,4,0,4,FMN GV 05 Lier
60,Mechelsesteenweg 365,2022-09-29,22:00:00,2,0,2,FMN GV 05 Lier
60,Mechelsesteenweg 365,2022-09-29,23:00:00,0,0,0,FMN GV 05 Lier
60,Mechelsesteenweg 365,2022-09-30,00:00:00,2,0,2,FMN GV 05 Lier
60,Mechelsesteenweg 365,2022-09-30,01:00:00,2,2,0,FMN GV 05 Lier
60,Mechelsesteenweg 365,2022-09-30,02:00:00,0,0,0,FMN GV 05 Lier
60,Mechelsesteenweg 365,2022-09-30,03:00:00,0,0,0,FMN GV 05 Lier
60,Mechelsesteenweg 365,2022-09-30,04:00:00,0,0,0,FMN GV 05 Lier
60,Mechelsesteenweg 365,2022-09-30,05:00:00,6,2,4,FMN GV 05 Lier
60,Mechelsesteenweg 365,2022-09-30,06:00:00,10,2,8,FMN GV 05 Lier
60,Mechelsesteenweg 365,2022-09-30,07:00:00,120,68,52,FMN GV 05 Lier
60,Mechelsesteenweg 365,2022-09-30,08:00:00,176,60,116,FMN GV 05 Lier
60,Mechelsesteenweg 365,2022-09-30,09:00:00,58,20,38,FMN GV 05 Lier
60,Mechelsesteenweg 365,2022-09-30,10:00:00,82,42,40,FMN GV 05 Lier
60,Mechelsesteenweg 365,2022-09-30,11:00:00,106,48,58,FMN GV 05 Lier
60,Mechelsesteenweg 365,2022-09-30,12:00:00,110,42,68,FMN GV 05 Lier
60,Mechelsesteenweg 365,2022-09-30,13:00:00,220,120,100,FMN GV 05 Lier
60,Mechelsesteenweg 365,2022-09-30,14:00:00,310,138,172,FMN GV 05 Lier
60,Mechelsesteenweg 365,2022-09-30,15:00:00,464,266,198,FMN GV 05 Lier
60,Mechelsesteenweg 365,2022-09-30,16:00:00,348,128,220,FMN GV 05 Lier
60,Mechelsesteenweg 365,2022-09-30,17:00:00,130,84,46,FMN GV 05 Lier
60,Mechelsesteenweg 365,2022-09-30,18:00:00,74,42,32,FMN GV 05 Lier
60,Mechelsesteenweg 365,2022-09-30,19:00:00,38,22,16,FMN GV 05 Lier
60,Mechelsesteenweg 365,2022-09-30,20:00:00,4,0,4,FMN GV 05 Lier
60,Mechelsesteenweg 365,2022-09-30,21:00:00,6,0,6,FMN GV 05 Lier
60,Mechelsesteenweg 365,2022-09-30,22:00:00,2,2,0,FMN GV 05 Lier
60,Mechelsesteenweg 365,2022-09-30,23:00:00,0,0,0,FMN GV 05 Lier
60,Mechelsesteenweg 365,2022-10-01,00:00:00,0,0,0,FMN GV 05 Lier
60,Mechelsesteenweg 365,2022-10-01,01:00:00,0,0,0,FMN GV 05 Lier
60,Mechelsesteenweg 365,2022-10-01,02:00:00,0,0,0,FMN GV 05 Lier
60,Mechelsesteenweg 365,2022-10-01,03:00:00,0,0,0,FMN GV 05 Lier
60,Mechelsesteenweg 365,2022-10-01,04:00:00,0,0,0,FMN GV 05 Lier
60,Mechelsesteenweg 365,2022-10-01,05:00:00,2,0,2,FMN GV 05 Lier
60,Mechelsesteenweg 365,2022-10-01,06:00:00,0,0,0,FMN GV 05 Lier
60,Mechelsesteenweg 365,2022-10-01,07:00:00,6,4,2,FMN GV 05 Lier
60,Mechelsesteenweg 365,2022-10-01,08:00:00,8,6,2,FMN GV 05 Lier
60,Mechelsesteenweg 365,2022-10-01,09:00:00,36,14,22,FMN GV 05 Lier
60,Mechelsesteenweg 365,2022-10-01,10:00:00,62,26,36,FMN GV 05 Lier
60,Mechelsesteenweg 365,2022-10-01,11:00:00,44,12,32,FMN GV 05 Lier
60,Mechelsesteenweg 365,2022-10-01,12:00:00,90,38,52,FMN GV 05 Lier
60,Mechelsesteenweg 365,2022-10-01,13:00:00,74,36,38,FMN GV 05 Lier
60,Mechelsesteenweg 365,2022-10-01,14:00:00,142,62,80,FMN GV 05 Lier
60,Mechelsesteenweg 365,2022-10-01,15:00:00,146,68,78,FMN GV 05 Lier
60,Mechelsesteenweg 365,2022-10-01,16:00:00,76,32,44,FMN GV 05 Lier
60,Mechelsesteenweg 365,2022-10-01,17:00:00,80,44,36,FMN GV 05 Lier
60,Mechelsesteenweg 365,2022-10-01,18:00:00,54,40,14,FMN GV 05 Lier
60,Mechelsesteenweg 365,2022-10-01,19:00:00,10,6,4,FMN GV 05 Lier
60,Mechelsesteenweg 365,2022-10-01,20:00:00,10,6,4,FMN GV 05 Lier
60,Mechelsesteenweg 365,2022-10-01,21:00:00,2,2,0,FMN GV 05 Lier
60,Mechelsesteenweg 365,2022-10-01,22:00:00,6,0,6,FMN GV 05 Lier
60,Mechelsesteenweg 365,2022-10-01,23:00:00,2,0,2,FMN GV 05 Lier
60,Mechelsesteenweg 365,2022-10-02,00:00:00,0,0,0,FMN GV 05 Lier
60,Mechelsesteenweg 365,2022-10-02,01:00:00,0,0,0,FMN GV 05 Lier
60,Mechelsesteenweg 365,2022-10-02,02:00:00,0,0,0,FMN GV 05 Lier
60,Mechelsesteenweg 365,2022-10-02,03:00:00,2,2,0,FMN GV 05 Lier
60,Mechelsesteenweg 365,2022-10-02,04:00:00,2,0,2,FMN GV 05 Lier
60,Mechelsesteenweg 365,2022-10-02,05:00:00,0,0,0,FMN GV 05 Lier
60,Mechelsesteenweg 365,2022-10-02,06:00:00,0,0,0,FMN GV 05 Lier
60,Mechelsesteenweg 365,2022-10-02,07:00:00,4,2,2,FMN GV 05 Lier
60,Mechelsesteenweg 365,2022-10-02,08:00:00,18,16,2,FMN GV 05 Lier
60,Mechelsesteenweg 365,2022-10-02,09:00:00,44,28,16,FMN GV 05 Lier
60,Mechelsesteenweg 365,2022-10-02,10:00:00,122,46,76,FMN GV 05 Lier
60,Mechelsesteenweg 365,2022-10-02,11:00:00,130,66,64,FMN GV 05 Lier
60,Mechelsesteenweg 365,2022-10-02,12:00:00,60,42,18,FMN GV 05 Lier
60,Mechelsesteenweg 365,2022-10-02,13:00:00,114,58,56,FMN GV 05 Lier
60,Mechelsesteenweg 365,2022-10-02,14:00:00,144,92,52,FMN GV 05 Lier
60,Mechelsesteenweg 365,2022-10-02,15:00:00,124,72,52,FMN GV 05 Lier
60,Mechelsesteenweg 365,2022-10-02,16:00:00,140,50,90,FMN GV 05 Lier
60,Mechelsesteenweg 365,2022-10-02,17:00:00,136,30,106,FMN GV 05 Lier
60,Mechelsesteenweg 365,2022-10-02,18:00:00,56,20,36,FMN GV 05 Lier
60,Mechelsesteenweg 365,2022-10-02,19:00:00,18,6,12,FMN GV 05 Lier
60,Mechelsesteenweg 365,2022-10-02,20:00:00,2,2,0,FMN GV 05 Lier
60,Mechelsesteenweg 365,2022-10-02,21:00:00,0,0,0,FMN GV 05 Lier
60,Mechelsesteenweg 365,2022-10-02,22:00:00,0,0,0,FMN GV 05 Lier
60,Mechelsesteenweg 365,2022-10-02,23:00:00,0,0,0,FMN GV 05 Lier
60,Mechelsesteenweg 365,2022-10-03,00:00:00,0,0,0,FMN GV 05 Lier
60,Mechelsesteenweg 365,2022-10-03,01:00:00,0,0,0,FMN GV 05 Lier
60,Mechelsesteenweg 365,2022-10-03,02:00:00,0,0,0,FMN GV 05 Lier
60,Mechelsesteenweg 365,2022-10-03,03:00:00,0,0,0,FMN GV 05 Lier
60,Mechelsesteenweg 365,2022-10-03,04:00:00,2,0,2,FMN GV 05 Lier
60,Mechelsesteenweg 365,2022-10-03,05:00:00,2,2,0,FMN GV 05 Lier
60,Mechelsesteenweg 365,2022-10-03,06:00:00,26,8,18,FMN GV 05 Lier
60,Mechelsesteenweg 365,2022-10-03,07:00:00,140,62,78,FMN GV 05 Lier
60,Mechelsesteenweg 365,2022-10-03,08:00:00,144,78,66,FMN GV 05 Lier
60,Mechelsesteenweg 365,2022-10-03,09:00:00,88,62,26,FMN GV 05 Lier
60,Mechelsesteenweg 365,2022-10-03,10:00:00,94,48,46,FMN GV 05 Lier
60,Mechelsesteenweg 365,2022-10-03,11:00:00,90,38,52,FMN GV 05 Lier
60,Mechelsesteenweg 365,2022-10-03,12:00:00,128,58,70,FMN GV 05 Lier
60,Mechelsesteenweg 365,2022-10-03,13:00:00,154,82,72,FMN GV 05 Lier
60,Mechelsesteenweg 365,2022-10-03,14:00:00,230,128,102,FMN GV 05 Lier
60,Mechelsesteenweg 365,2022-10-03,15:00:00,214,100,114,FMN GV 05 Lier
60,Mechelsesteenweg 365,2022-10-03,16:00:00,312,112,200,FMN GV 05 Lier
60,Mechelsesteenweg 365,2022-10-03,17:00:00,182,106,76,FMN GV 05 Lier
60,Mechelsesteenweg 365,2022-10-03,18:00:00,88,48,40,FMN GV 05 Lier
60,Mechelsesteenweg 365,2022-10-03,19:00:00,46,22,24,FMN GV 05 Lier
60,Mechelsesteenweg 365,2022-10-03,20:00:00,8,6,2,FMN GV 05 Lier
60,Mechelsesteenweg 365,2022-10-03,21:00:00,2,0,2,FMN GV 05 Lier
60,Mechelsesteenweg 365,2022-10-03,22:00:00,2,2,0,FMN GV 05 Lier
60,Mechelsesteenweg 365,2022-10-03,23:00:00,0,0,0,FMN GV 05 Lier
60,Mechelsesteenweg 365,2022-10-04,00:00:00,0,0,0,FMN GV 05 Lier
60,Mechelsesteenweg 365,2022-10-04,01:00:00,0,0,0,FMN GV 05 Lier
60,Mechelsesteenweg 365,2022-10-04,02:00:00,0,0,0,FMN GV 05 Lier
60,Mechelsesteenweg 365,2022-10-04,03:00:00,0,0,0,FMN GV 05 Lier
60,Mechelsesteenweg 365,2022-10-04,04:00:00,2,0,2,FMN GV 05 Lier
60,Mechelsesteenweg 365,2022-10-04,05:00:00,4,0,4,FMN GV 05 Lier
60,Mechelsesteenweg 365,2022-10-04,06:00:00,38,12,26,FMN GV 05 Lier
60,Mechelsesteenweg 365,2022-10-04,07:00:00,172,72,100,FMN GV 05 Lier
60,Mechelsesteenweg 365,2022-10-04,08:00:00,168,100,68,FMN GV 05 Lier
60,Mechelsesteenweg 365,2022-10-04,09:00:00,82,40,42,FMN GV 05 Lier
60,Mechelsesteenweg 365,2022-10-04,10:00:00,98,48,50,FMN GV 05 Lier
60,Mechelsesteenweg 365,2022-10-04,11:00:00,168,94,74,FMN GV 05 Lier
60,Mechelsesteenweg 365,2022-10-04,12:00:00,120,64,56,FMN GV 05 Lier
60,Mechelsesteenweg 365,2022-10-04,13:00:00,200,134,66,FMN GV 05 Lier
60,Mechelsesteenweg 365,2022-10-04,14:00:00,260,132,128,FMN GV 05 Lier
60,Mechelsesteenweg 365,2022-10-04,15:00:00,296,126,170,FMN GV 05 Lier
60,Mechelsesteenweg 365,2022-10-04,16:00:00,350,152,198,FMN GV 05 Lier
60,Mechelsesteenweg 365,2022-10-04,17:00:00,212,126,86,FMN GV 05 Lier
60,Mechelsesteenweg 365,2022-10-04,18:00:00,106,70,36,FMN GV 05 Lier
60,Mechelsesteenweg 365,2022-10-04,19:00:00,32,16,16,FMN GV 05 Lier
60,Mechelsesteenweg 365,2022-10-04,20:00:00,44,16,28,FMN GV 05 Lier
60,Mechelsesteenweg 365,2022-10-04,21:00:00,6,0,6,FMN GV 05 Lier
60,Mechelsesteenweg 365,2022-10-04,22:00:00,6,0,6,FMN GV 05 Lier
60,Mechelsesteenweg 365,2022-10-04,23:00:00,2,2,0,FMN GV 05 Lier
60,Mechelsesteenweg 365,2022-10-05,00:00:00,0,0,0,FMN GV 05 Lier
60,Mechelsesteenweg 365,2022-10-05,01:00:00,0,0,0,FMN GV 05 Lier
60,Mechelsesteenweg 365,2022-10-05,02:00:00,0,0,0,FMN GV 05 Lier
60,Mechelsesteenweg 365,2022-10-05,03:00:00,2,0,2,FMN GV 05 Lier
60,Mechelsesteenweg 365,2022-10-05,04:00:00,2,0,2,FMN GV 05 Lier
60,Mechelsesteenweg 365,2022-10-05,05:00:00,4,0,4,FMN GV 05 Lier
60,Mechelsesteenweg 365,2022-10-05,06:00:00,20,6,14,FMN GV 05 Lier
60,Mechelsesteenweg 365,2022-10-05,07:00:00,134,66,68,FMN GV 05 Lier
60,Mechelsesteenweg 365,2022-10-05,08:00:00,156,92,64,FMN GV 05 Lier
60,Mechelsesteenweg 365,2022-10-05,09:00:00,80,48,32,FMN GV 05 Lier
60,Mechelsesteenweg 365,2022-10-05,10:00:00,60,30,30,FMN GV 05 Lier
60,Mechelsesteenweg 365,2022-10-05,11:00:00,98,36,62,FMN GV 05 Lier
60,Mechelsesteenweg 365,2022-10-05,12:00:00,244,84,160,FMN GV 05 Lier
60,Mechelsesteenweg 365,2022-10-05,13:00:00,140,62,78,FMN GV 05 Lier
60,Mechelsesteenweg 365,2022-10-05,14:00:00,186,114,72,FMN GV 05 Lier
60,Mechelsesteenweg 365,2022-10-05,15:00:00,180,102,78,FMN GV 05 Lier
60,Mechelsesteenweg 365,2022-10-05,16:00:00,112,76,36,FMN GV 05 Lier
60,Mechelsesteenweg 365,2022-10-05,17:00:00,126,78,48,FMN GV 05 Lier
60,Mechelsesteenweg 365,2022-10-05,18:00:00,98,58,40,FMN GV 05 Lier
60,Mechelsesteenweg 365,2022-10-05,19:00:00,56,34,22,FMN GV 05 Lier
60,Mechelsesteenweg 365,2022-10-05,20:00:00,16,6,10,FMN GV 05 Lier
60,Mechelsesteenweg 365,2022-10-05,21:00:00,4,0,4,FMN GV 05 Lier
60,Mechelsesteenweg 365,2022-10-05,22:00:00,2,0,2,FMN GV 05 Lier
60,Mechelsesteenweg 365,2022-10-05,23:00:00,0,0,0,FMN GV 05 Lier
60,Mechelsesteenweg 365,2022-10-06,00:00:00,0,0,0,FMN GV 05 Lier
60,Mechelsesteenweg 365,2022-10-06,01:00:00,0,0,0,FMN GV 05 Lier
60,Mechelsesteenweg 365,2022-10-06,02:00:00,0,0,0,FMN GV 05 Lier
60,Mechelsesteenweg 365,2022-10-06,03:00:00,2,0,2,FMN GV 05 Lier
60,Mechelsesteenweg 365,2022-10-06,04:00:00,0,0,0,FMN GV 05 Lier
60,Mechelsesteenweg 365,2022-10-06,05:00:00,2,0,2,FMN GV 05 Lier
60,Mechelsesteenweg 365,2022-10-06,06:00:00,28,6,22,FMN GV 05 Lier
60,Mechelsesteenweg 365,2022-10-06,07:00:00,154,66,88,FMN GV 05 Lier
60,Mechelsesteenweg 365,2022-10-06,08:00:00,168,90,78,FMN GV 05 Lier
60,Mechelsesteenweg 365,2022-10-06,09:00:00,92,62,30,FMN GV 05 Lier
60,Mechelsesteenweg 365,2022-10-06,10:00:00,112,66,46,FMN GV 05 Lier
60,Mechelsesteenweg 365,2022-10-06,11:00:00,126,66,60,FMN GV 05 Lier
60,Mechelsesteenweg 365,2022-10-06,12:00:00,192,88,104,FMN GV 05 Lier
60,Mechelsesteenweg 365,2022-10-06,13:00:00,222,108,114,FMN GV 05 Lier
60,Mechelsesteenweg 365,2022-10-06,14:00:00,248,126,122,FMN GV 05 Lier
60,Mechelsesteenweg 365,2022-10-06,15:00:00,292,124,168,FMN GV 05 Lier
60,Mechelsesteenweg 365,2022-10-06,16:00:00,422,134,288,FMN GV 05 Lier
60,Mechelsesteenweg 365,2022-10-06,17:00:00,204,120,84,FMN GV 05 Lier
60,Mechelsesteenweg 365,2022-10-06,18:00:00,90,60,30,FMN GV 05 Lier
60,Mechelsesteenweg 365,2022-10-06,19:00:00,62,28,34,FMN GV 05 Lier
60,Mechelsesteenweg 365,2022-10-06,20:00:00,4,2,2,FMN GV 05 Lier
60,Mechelsesteenweg 365,2022-10-06,21:00:00,2,0,2,FMN GV 05 Lier
60,Mechelsesteenweg 365,2022-10-06,22:00:00,14,4,10,FMN GV 05 Lier
60,Mechelsesteenweg 365,2022-10-06,23:00:00,0,0,0,FMN GV 05 Lier
60,Mechelsesteenweg 365,2022-10-07,00:00:00,2,0,2,FMN GV 05 Lier
60,Mechelsesteenweg 365,2022-10-07,01:00:00,0,0,0,FMN GV 05 Lier
60,Mechelsesteenweg 365,2022-10-07,02:00:00,2,2,0,FMN GV 05 Lier
60,Mechelsesteenweg 365,2022-10-07,03:00:00,2,0,2,FMN GV 05 Lier
60,Mechelsesteenweg 365,2022-10-07,04:00:00,0,0,0,FMN GV 05 Lier
60,Mechelsesteenweg 365,2022-10-07,05:00:00,10,4,6,FMN GV 05 Lier
60,Mechelsesteenweg 365,2022-10-07,06:00:00,18,2,16,FMN GV 05 Lier
60,Mechelsesteenweg 365,2022-10-07,07:00:00,102,54,48,FMN GV 05 Lier
60,Mechelsesteenweg 365,2022-10-07,08:00:00,118,68,50,FMN GV 05 Lier
60,Mechelsesteenweg 365,2022-10-07,09:00:00,130,80,50,FMN GV 05 Lier
60,Mechelsesteenweg 365,2022-10-07,10:00:00,98,52,46,FMN GV 05 Lier
60,Mechelsesteenweg 365,2022-10-07,11:00:00,82,58,24,FMN GV 05 Lier
60,Mechelsesteenweg 365,2022-10-07,12:00:00,148,48,100,FMN GV 05 Lier
60,Mechelsesteenweg 365,2022-10-07,13:00:00,152,82,70,FMN GV 05 Lier
60,Mechelsesteenweg 365,2022-10-07,14:00:00,274,132,142,FMN GV 05 Lier
60,Mechelsesteenweg 365,2022-10-07,15:00:00,212,116,96,FMN GV 05 Lier
60,Mechelsesteenweg 365,2022-10-07,16:00:00,328,128,200,FMN GV 05 Lier
60,Mechelsesteenweg 365,2022-10-07,17:00:00,188,102,86,FMN GV 05 Lier
60,Mechelsesteenweg 365,2022-10-07,18:00:00,78,56,22,FMN GV 05 Lier
60,Mechelsesteenweg 365,2022-10-07,19:00:00,36,24,12,FMN GV 05 Lier
60,Mechelsesteenweg 365,2022-10-07,20:00:00,10,2,8,FMN GV 05 Lier
60,Mechelsesteenweg 365,2022-10-07,21:00:00,2,0,2,FMN GV 05 Lier
60,Mechelsesteenweg 365,2022-10-07,22:00:00,8,2,6,FMN GV 05 Lier
60,Mechelsesteenweg 365,2022-10-07,23:00:00,4,2,2,FMN GV 05 Lier
60,Mechelsesteenweg 365,2022-10-08,00:00:00,0,0,0,FMN GV 05 Lier
60,Mechelsesteenweg 365,2022-10-08,01:00:00,2,2,0,FMN GV 05 Lier
60,Mechelsesteenweg 365,2022-10-08,02:00:00,0,0,0,FMN GV 05 Lier
60,Mechelsesteenweg 365,2022-10-08,03:00:00,2,0,2,FMN GV 05 Lier
60,Mechelsesteenweg 365,2022-10-08,04:00:00,2,0,2,FMN GV 05 Lier
60,Mechelsesteenweg 365,2022-10-08,05:00:00,0,0,0,FMN GV 05 Lier
60,Mechelsesteenweg 365,2022-10-08,06:00:00,0,0,0,FMN GV 05 Lier
60,Mechelsesteenweg 365,2022-10-08,07:00:00,6,4,2,FMN GV 05 Lier
60,Mechelsesteenweg 365,2022-10-08,08:00:00,14,8,6,FMN GV 05 Lier
60,Mechelsesteenweg 365,2022-10-08,09:00:00,64,40,24,FMN GV 05 Lier
60,Mechelsesteenweg 365,2022-10-08,10:00:00,106,64,42,FMN GV 05 Lier
60,Mechelsesteenweg 365,2022-10-08,11:00:00,176,92,84,FMN GV 05 Lier
60,Mechelsesteenweg 365,2022-10-08,12:00:00,148,72,76,FMN GV 05 Lier
60,Mechelsesteenweg 365,2022-10-08,13:00:00,152,82,70,FMN GV 05 Lier
60,Mechelsesteenweg 365,2022-10-08,14:00:00,260,122,138,FMN GV 05 Lier
60,Mechelsesteenweg 365,2022-10-08,15:00:00,174,84,90,FMN GV 05 Lier
60,Mechelsesteenweg 365,2022-10-08,16:00:00,136,58,78,FMN GV 05 Lier
60,Mechelsesteenweg 365,2022-10-08,17:00:00,76,40,36,FMN GV 05 Lier
60,Mechelsesteenweg 365,2022-10-08,18:00:00,28,8,20,FMN GV 05 Lier
60,Mechelsesteenweg 365,2022-10-08,19:00:00,16,6,10,FMN GV 05 Lier
60,Mechelsesteenweg 365,2022-10-08,20:00:00,26,6,20,FMN GV 05 Lier
60,Mechelsesteenweg 365,2022-10-08,21:00:00,4,0,4,FMN GV 05 Lier
60,Mechelsesteenweg 365,2022-10-08,22:00:00,6,4,2,FMN GV 05 Lier
60,Mechelsesteenweg 365,2022-10-08,23:00:00,0,0,0,FMN GV 05 Lier
60,Mechelsesteenweg 365,2022-10-09,00:00:00,4,0,4,FMN GV 05 Lier
60,Mechelsesteenweg 365,2022-10-09,01:00:00,8,2,6,FMN GV 05 Lier
60,Mechelsesteenweg 365,2022-10-09,02:00:00,2,2,0,FMN GV 05 Lier
60,Mechelsesteenweg 365,2022-10-09,03:00:00,0,0,0,FMN GV 05 Lier
60,Mechelsesteenweg 365,2022-10-09,04:00:00,0,0,0,FMN GV 05 Lier
60,Mechelsesteenweg 365,2022-10-09,05:00:00,0,0,0,FMN GV 05 Lier
60,Mechelsesteenweg 365,2022-10-09,06:00:00,0,0,0,FMN GV 05 Lier
60,Mechelsesteenweg 365,2022-10-09,07:00:00,8,6,2,FMN GV 05 Lier
60,Mechelsesteenweg 365,2022-10-09,08:00:00,38,18,20,FMN GV 05 Lier
60,Mechelsesteenweg 365,2022-10-09,09:00:00,114,70,44,FMN GV 05 Lier
60,Mechelsesteenweg 365,2022-10-09,10:00:00,282,150,132,FMN GV 05 Lier
60,Mechelsesteenweg 365,2022-10-09,11:00:00,370,190,180,FMN GV 05 Lier
60,Mechelsesteenweg 365,2022-10-09,12:00:00,220,94,126,FMN GV 05 Lier
60,Mechelsesteenweg 365,2022-10-09,13:00:00,306,178,128,FMN GV 05 Lier
60,Mechelsesteenweg 365,2022-10-09,14:00:00,428,280,148,FMN GV 05 Lier
60,Mechelsesteenweg 365,2022-10-09,15:00:00,376,184,192,FMN GV 05 Lier
60,Mechelsesteenweg 365,2022-10-09,16:00:00,388,112,276,FMN GV 05 Lier
60,Mechelsesteenweg 365,2022-10-09,17:00:00,194,74,120,FMN GV 05 Lier
60,Mechelsesteenweg 365,2022-10-09,18:00:00,98,30,68,FMN GV 05 Lier
60,Mechelsesteenweg 365,2022-10-09,19:00:00,24,2,22,FMN GV 05 Lier
60,Mechelsesteenweg 365,2022-10-09,20:00:00,10,4,6,FMN GV 05 Lier
60,Mechelsesteenweg 365,2022-10-09,21:00:00,6,2,4,FMN GV 05 Lier
60,Mechelsesteenweg 365,2022-10-09,22:00:00,4,4,0,FMN GV 05 Lier
60,Mechelsesteenweg 365,2022-10-09,23:00:00,2,2,0,FMN GV 05 Lier
60,Mechelsesteenweg 365,2022-10-10,00:00:00,0,0,0,FMN GV 05 Lier
60,Mechelsesteenweg 365,2022-10-10,01:00:00,0,0,0,FMN GV 05 Lier
60,Mechelsesteenweg 365,2022-10-10,02:00:00,0,0,0,FMN GV 05 Lier
60,Mechelsesteenweg 365,2022-10-10,03:00:00,0,0,0,FMN GV 05 Lier
60,Mechelsesteenweg 365,2022-10-10,04:00:00,2,0,2,FMN GV 05 Lier
60,Mechelsesteenweg 365,2022-10-10,05:00:00,4,2,2,FMN GV 05 Lier
60,Mechelsesteenweg 365,2022-10-10,06:00:00,24,8,16,FMN GV 05 Lier
60,Mechelsesteenweg 365,2022-10-10,07:00:00,88,18,70,FMN GV 05 Lier
60,Mechelsesteenweg 365,2022-10-10,08:00:00,112,48,64,FMN GV 05 Lier
60,Mechelsesteenweg 365,2022-10-10,09:00:00,104,70,34,FMN GV 05 Lier
60,Mechelsesteenweg 365,2022-10-10,10:00:00,108,52,56,FMN GV 05 Lier
60,Mechelsesteenweg 365,2022-10-10,11:00:00,58,32,26,FMN GV 05 Lier
60,Mechelsesteenweg 365,2022-10-10,12:00:00,276,126,150,FMN GV 05 Lier
60,Mechelsesteenweg 365,2022-10-10,13:00:00,120,62,58,FMN GV 05 Lier
60,Mechelsesteenweg 365,2022-10-10,14:00:00,138,64,74,FMN GV 05 Lier
60,Mechelsesteenweg 365,2022-10-10,15:00:00,180,32,148,FMN GV 05 Lier
60,Mechelsesteenweg 365,2022-10-10,16:00:00,154,92,62,FMN GV 05 Lier
60,Mechelsesteenweg 365,2022-10-10,17:00:00,108,66,42,FMN GV 05 Lier
60,Mechelsesteenweg 365,2022-10-10,18:00:00,50,34,16,FMN GV 05 Lier
60,Mechelsesteenweg 365,2022-10-10,19:00:00,20,10,10,FMN GV 05 Lier
60,Mechelsesteenweg 365,2022-10-10,20:00:00,14,4,10,FMN GV 05 Lier
60,Mechelsesteenweg 365,2022-10-10,21:00:00,6,2,4,FMN GV 05 Lier
60,Mechelsesteenweg 365,2022-10-10,22:00:00,4,4,0,FMN GV 05 Lier
60,Mechelsesteenweg 365,2022-10-10,23:00:00,0,0,0,FMN GV 05 Lier
60,Mechelsesteenweg 365,2022-10-11,00:00:00,0,0,0,FMN GV 05 Lier
60,Mechelsesteenweg 365,2022-10-11,01:00:00,0,0,0,FMN GV 05 Lier
60,Mechelsesteenweg 365,2022-10-11,02:00:00,0,0,0,FMN GV 05 Lier
60,Mechelsesteenweg 365,2022-10-11,03:00:00,2,0,2,FMN GV 05 Lier
60,Mechelsesteenweg 365,2022-10-11,04:00:00,2,0,2,FMN GV 05 Lier
60,Mechelsesteenweg 365,2022-10-11,05:00:00,4,0,4,FMN GV 05 Lier
60,Mechelsesteenweg 365,2022-10-11,06:00:00,30,6,24,FMN GV 05 Lier
60,Mechelsesteenweg 365,2022-10-11,07:00:00,120,38,82,FMN GV 05 Lier
60,Mechelsesteenweg 365,2022-10-11,08:00:00,126,72,54,FMN GV 05 Lier
60,Mechelsesteenweg 365,2022-10-11,09:00:00,66,16,50,FMN GV 05 Lier
60,Mechelsesteenweg 365,2022-10-11,10:00:00,64,28,36,FMN GV 05 Lier
60,Mechelsesteenweg 365,2022-10-11,11:00:00,122,56,66,FMN GV 05 Lier
60,Mechelsesteenweg 365,2022-10-11,12:00:00,168,84,84,FMN GV 05 Lier
60,Mechelsesteenweg 365,2022-10-11,13:00:00,228,122,106,FMN GV 05 Lier
60,Mechelsesteenweg 365,2022-10-11,14:00:00,238,88,150,FMN GV 05 Lier
60,Mechelsesteenweg 365,2022-10-11,15:00:00,244,98,146,FMN GV 05 Lier
60,Mechelsesteenweg 365,2022-10-11,16:00:00,380,132,248,FMN GV 05 Lier
60,Mechelsesteenweg 365,2022-10-11,17:00:00,220,132,88,FMN GV 05 Lier
60,Mechelsesteenweg 365,2022-10-11,18:00:00,74,44,30,FMN GV 05 Lier
60,Mechelsesteenweg 365,2022-10-11,19:00:00,22,8,14,FMN GV 05 Lier
60,Mechelsesteenweg 365,2022-10-11,20:00:00,16,2,14,FMN GV 05 Lier
60,Mechelsesteenweg 365,2022-10-11,21:00:00,10,6,4,FMN GV 05 Lier
60,Mechelsesteenweg 365,2022-10-11,22:00:00,6,4,2,FMN GV 05 Lier
60,Mechelsesteenweg 365,2022-10-11,23:00:00,0,0,0,FMN GV 05 Lier
60,Mechelsesteenweg 365,2022-10-12,00:00:00,2,2,0,FMN GV 05 Lier
60,Mechelsesteenweg 365,2022-10-12,01:00:00,0,0,0,FMN GV 05 Lier
60,Mechelsesteenweg 365,2022-10-12,02:00:00,0,0,0,FMN GV 05 Lier
60,Mechelsesteenweg 365,2022-10-12,03:00:00,2,0,2,FMN GV 05 Lier
60,Mechelsesteenweg 365,2022-10-12,04:00:00,0,0,0,FMN GV 05 Lier
60,Mechelsesteenweg 365,2022-10-12,05:00:00,2,0,2,FMN GV 05 Lier
60,Mechelsesteenweg 365,2022-10-12,06:00:00,20,2,18,FMN GV 05 Lier
60,Mechelsesteenweg 365,2022-10-12,07:00:00,110,46,64,FMN GV 05 Lier
60,Mechelsesteenweg 365,2022-10-12,08:00:00,122,76,46,FMN GV 05 Lier
60,Mechelsesteenweg 365,2022-10-12,09:00:00,50,20,30,FMN GV 05 Lier
60,Mechelsesteenweg 365,2022-10-12,10:00:00,88,48,40,FMN GV 05 Lier
60,Mechelsesteenweg 365,2022-10-12,11:00:00,128,40,88,FMN GV 05 Lier
60,Mechelsesteenweg 365,2022-10-12,12:00:00,238,68,170,FMN GV 05 Lier
60,Mechelsesteenweg 365,2022-10-12,13:00:00,162,82,80,FMN GV 05 Lier
60,Mechelsesteenweg 365,2022-10-12,14:00:00,264,140,124,FMN GV 05 Lier
60,Mechelsesteenweg 365,2022-10-12,15:00:00,192,118,74,FMN GV 05 Lier
60,Mechelsesteenweg 365,2022-10-12,16:00:00,190,94,96,FMN GV 05 Lier
60,Mechelsesteenweg 365,2022-10-12,17:00:00,178,108,70,FMN GV 05 Lier
60,Mechelsesteenweg 365,2022-10-12,18:00:00,102,72,30,FMN GV 05 Lier
60,Mechelsesteenweg 365,2022-10-12,19:00:00,40,30,10,FMN GV 05 Lier
60,Mechelsesteenweg 365,2022-10-12,20:00:00,18,6,12,FMN GV 05 Lier
60,Mechelsesteenweg 365,2022-10-12,21:00:00,2,2,0,FMN GV 05 Lier
60,Mechelsesteenweg 365,2022-10-12,22:00:00,4,2,2,FMN GV 05 Lier
60,Mechelsesteenweg 365,2022-10-12,23:00:00,2,2,0,FMN GV 05 Lier
60,Mechelsesteenweg 365,2022-10-13,00:00:00,0,0,0,FMN GV 05 Lier
60,Mechelsesteenweg 365,2022-10-13,01:00:00,0,0,0,FMN GV 05 Lier
60,Mechelsesteenweg 365,2022-10-13,02:00:00,0,0,0,FMN GV 05 Lier
60,Mechelsesteenweg 365,2022-10-13,03:00:00,2,0,2,FMN GV 05 Lier
60,Mechelsesteenweg 365,2022-10-13,04:00:00,2,0,2,FMN GV 05 Lier
60,Mechelsesteenweg 365,2022-10-13,05:00:00,2,2,0,FMN GV 05 Lier
60,Mechelsesteenweg 365,2022-10-13,06:00:00,28,12,16,FMN GV 05 Lier
60,Mechelsesteenweg 365,2022-10-13,07:00:00,106,40,66,FMN GV 05 Lier
60,Mechelsesteenweg 365,2022-10-13,08:00:00,154,88,66,FMN GV 05 Lier
60,Mechelsesteenweg 365,2022-10-13,09:00:00,74,50,24,FMN GV 05 Lier
60,Mechelsesteenweg 365,2022-10-13,10:00:00,112,94,18,FMN GV 05 Lier
60,Mechelsesteenweg 365,2022-10-13,11:00:00,66,42,24,FMN GV 05 Lier
60,Mechelsesteenweg 365,2022-10-13,12:00:00,42,14,28,FMN GV 05 Lier
60,Mechelsesteenweg 365,2022-10-13,13:00:00,42,16,26,FMN GV 05 Lier
60,Mechelsesteenweg 365,2022-10-13,14:00:00,52,20,32,FMN GV 05 Lier
60,Mechelsesteenweg 365,2022-10-13,15:00:00,68,26,42,FMN GV 05 Lier
60,Mechelsesteenweg 365,2022-10-13,16:00:00,156,56,100,FMN GV 05 Lier
60,Mechelsesteenweg 365,2022-10-13,17:00:00,100,62,38,FMN GV 05 Lier
60,Mechelsesteenweg 365,2022-10-13,18:00:00,50,34,16,FMN GV 05 Lier
60,Mechelsesteenweg 365,2022-10-13,19:00:00,14,12,2,FMN GV 05 Lier
60,Mechelsesteenweg 365,2022-10-13,20:00:00,8,2,6,FMN GV 05 Lier
60,Mechelsesteenweg 365,2022-10-13,21:00:00,4,2,2,FMN GV 05 Lier
60,Mechelsesteenweg 365,2022-10-13,22:00:00,2,0,2,FMN GV 05 Lier
60,Mechelsesteenweg 365,2022-10-13,23:00:00,0,0,0,FMN GV 05 Lier
60,Mechelsesteenweg 365,2022-10-14,00:00:00,0,0,0,FMN GV 05 Lier
60,Mechelsesteenweg 365,2022-10-14,01:00:00,0,0,0,FMN GV 05 Lier
60,Mechelsesteenweg 365,2022-10-14,02:00:00,0,0,0,FMN GV 05 Lier
60,Mechelsesteenweg 365,2022-10-14,03:00:00,4,2,2,FMN GV 05 Lier
60,Mechelsesteenweg 365,2022-10-14,04:00:00,0,0,0,FMN GV 05 Lier
60,Mechelsesteenweg 365,2022-10-14,05:00:00,8,0,8,FMN GV 05 Lier
60,Mechelsesteenweg 365,2022-10-14,06:00:00,26,8,18,FMN GV 05 Lier
60,Mechelsesteenweg 365,2022-10-14,07:00:00,78,44,34,FMN GV 05 Lier
60,Mechelsesteenweg 365,2022-10-14,08:00:00,94,66,28,FMN GV 05 Lier
60,Mechelsesteenweg 365,2022-10-14,09:00:00,30,10,20,FMN GV 05 Lier
60,Mechelsesteenweg 365,2022-10-14,10:00:00,22,12,10,FMN GV 05 Lier
60,Mechelsesteenweg 365,2022-10-14,11:00:00,24,10,14,FMN GV 05 Lier
60,Mechelsesteenweg 365,2022-10-14,12:00:00,42,12,30,FMN GV 05 Lier
60,Mechelsesteenweg 365,2022-10-14,13:00:00,22,6,16,FMN GV 05 Lier
60,Mechelsesteenweg 365,2022-10-14,14:00:00,64,36,28,FMN GV 05 Lier
60,Mechelsesteenweg 365,2022-10-14,15:00:00,66,32,34,FMN GV 05 Lier
60,Mechelsesteenweg 365,2022-10-14,16:00:00,176,58,118,FMN GV 05 Lier
60,Mechelsesteenweg 365,2022-10-14,17:00:00,80,44,36,FMN GV 05 Lier
60,Mechelsesteenweg 365,2022-10-14,18:00:00,46,26,20,FMN GV 05 Lier
60,Mechelsesteenweg 365,2022-10-14,19:00:00,22,10,12,FMN GV 05 Lier
60,Mechelsesteenweg 365,2022-10-14,20:00:00,6,6,0,FMN GV 05 Lier
60,Mechelsesteenweg 365,2022-10-14,21:00:00,6,0,6,FMN GV 05 Lier
60,Mechelsesteenweg 365,2022-10-14,22:00:00,4,2,2,FMN GV 05 Lier
60,Mechelsesteenweg 365,2022-10-14,23:00:00,0,0,0,FMN GV 05 Lier
60,Mechelsesteenweg 365,2022-10-15,00:00:00,2,0,2,FMN GV 05 Lier
60,Mechelsesteenweg 365,2022-10-15,01:00:00,2,2,0,FMN GV 05 Lier
60,Mechelsesteenweg 365,2022-10-15,02:00:00,0,0,0,FMN GV 05 Lier
60,Mechelsesteenweg 365,2022-10-15,03:00:00,2,2,0,FMN GV 05 Lier
60,Mechelsesteenweg 365,2022-10-15,04:00:00,2,2,0,FMN GV 05 Lier
60,Mechelsesteenweg 365,2022-10-15,05:00:00,4,0,4,FMN GV 05 Lier
60,Mechelsesteenweg 365,2022-10-15,06:00:00,2,2,0,FMN GV 05 Lier
60,Mechelsesteenweg 365,2022-10-15,07:00:00,4,2,2,FMN GV 05 Lier
60,Mechelsesteenweg 365,2022-10-15,08:00:00,14,4,10,FMN GV 05 Lier
60,Mechelsesteenweg 365,2022-10-15,09:00:00,42,14,28,FMN GV 05 Lier
60,Mechelsesteenweg 365,2022-10-15,10:00:00,110,44,66,FMN GV 05 Lier
60,Mechelsesteenweg 365,2022-10-15,11:00:00,94,38,56,FMN GV 05 Lier
60,Mechelsesteenweg 365,2022-10-15,12:00:00,50,28,22,FMN GV 05 Lier
60,Mechelsesteenweg 365,2022-10-15,13:00:00,50,20,30,FMN GV 05 Lier
60,Mechelsesteenweg 365,2022-10-15,14:00:00,98,32,66,FMN GV 05 Lier
60,Mechelsesteenweg 365,2022-10-15,15:00:00,128,66,62,FMN GV 05 Lier
60,Mechelsesteenweg 365,2022-10-15,16:00:00,84,42,42,FMN GV 05 Lier
60,Mechelsesteenweg 365,2022-10-15,17:00:00,92,48,44,FMN GV 05 Lier
60,Mechelsesteenweg 365,2022-10-15,18:00:00,46,26,20,FMN GV 05 Lier
60,Mechelsesteenweg 365,2022-10-15,19:00:00,34,14,20,FMN GV 05 Lier
60,Mechelsesteenweg 365,2022-10-15,20:00:00,14,10,4,FMN GV 05 Lier
60,Mechelsesteenweg 365,2022-10-15,21:00:00,14,2,12,FMN GV 05 Lier
60,Mechelsesteenweg 365,2022-10-15,22:00:00,6,0,6,FMN GV 05 Lier
60,Mechelsesteenweg 365,2022-10-15,23:00:00,10,2,8,FMN GV 05 Lier
60,Mechelsesteenweg 365,2022-10-16,00:00:00,4,2,2,FMN GV 05 Lier
60,Mechelsesteenweg 365,2022-10-16,01:00:00,2,0,2,FMN GV 05 Lier
60,Mechelsesteenweg 365,2022-10-16,02:00:00,2,2,0,FMN GV 05 Lier
60,Mechelsesteenweg 365,2022-10-16,03:00:00,0,0,0,FMN GV 05 Lier
60,Mechelsesteenweg 365,2022-10-16,04:00:00,2,0,2,FMN GV 05 Lier
60,Mechelsesteenweg 365,2022-10-16,05:00:00,2,0,2,FMN GV 05 Lier
60,Mechelsesteenweg 365,2022-10-16,06:00:00,0,0,0,FMN GV 05 Lier
60,Mechelsesteenweg 365,2022-10-16,07:00:00,6,4,2,FMN GV 05 Lier
60,Mechelsesteenweg 365,2022-10-16,08:00:00,38,26,12,FMN GV 05 Lier
60,Mechelsesteenweg 365,2022-10-16,09:00:00,166,114,52,FMN GV 05 Lier
60,Mechelsesteenweg 365,2022-10-16,10:00:00,342,232,110,FMN GV 05 Lier
60,Mechelsesteenweg 365,2022-10-16,11:00:00,398,250,148,FMN GV 05 Lier
60,Mechelsesteenweg 365,2022-10-16,12:00:00,266,134,132,FMN GV 05 Lier
60,Mechelsesteenweg 365,2022-10-16,13:00:00,252,126,126,FMN GV 05 Lier
60,Mechelsesteenweg 365,2022-10-16,14:00:00,354,200,154,FMN GV 05 Lier
60,Mechelsesteenweg 365,2022-10-16,15:00:00,284,90,194,FMN GV 05 Lier
60,Mechelsesteenweg 365,2022-10-16,16:00:00,142,48,94,FMN GV 05 Lier
60,Mechelsesteenweg 365,2022-10-16,17:00:00,90,38,52,FMN GV 05 Lier
60,Mechelsesteenweg 365,2022-10-16,18:00:00,20,8,12,FMN GV 05 Lier
60,Mechelsesteenweg 365,2022-10-16,19:00:00,8,6,2,FMN GV 05 Lier
60,Mechelsesteenweg 365,2022-10-16,20:00:00,4,4,0,FMN GV 05 Lier
60,Mechelsesteenweg 365,2022-10-16,21:00:00,6,0,6,FMN GV 05 Lier
60,Mechelsesteenweg 365,2022-10-16,22:00:00,4,2,2,FMN GV 05 Lier
60,Mechelsesteenweg 365,2022-10-16,23:00:00,0,0,0,FMN GV 05 Lier
60,Mechelsesteenweg 365,2022-10-17,00:00:00,0,0,0,FMN GV 05 Lier
60,Mechelsesteenweg 365,2022-10-17,01:00:00,0,0,0,FMN GV 05 Lier
60,Mechelsesteenweg 365,2022-10-17,02:00:00,0,0,0,FMN GV 05 Lier
60,Mechelsesteenweg 365,2022-10-17,03:00:00,0,0,0,FMN GV 05 Lier
60,Mechelsesteenweg 365,2022-10-17,04:00:00,2,0,2,FMN GV 05 Lier
60,Mechelsesteenweg 365,2022-10-17,05:00:00,2,0,2,FMN GV 05 Lier
60,Mechelsesteenweg 365,2022-10-17,06:00:00,30,12,18,FMN GV 05 Lier
60,Mechelsesteenweg 365,2022-10-17,07:00:00,100,36,64,FMN GV 05 Lier
60,Mechelsesteenweg 365,2022-10-17,08:00:00,106,64,42,FMN GV 05 Lier
60,Mechelsesteenweg 365,2022-10-17,09:00:00,34,18,16,FMN GV 05 Lier
60,Mechelsesteenweg 365,2022-10-17,10:00:00,16,14,2,FMN GV 05 Lier
60,Mechelsesteenweg 365,2022-10-17,11:00:00,12,4,8,FMN GV 05 Lier
60,Mechelsesteenweg 365,2022-10-17,12:00:00,18,8,10,FMN GV 05 Lier
60,Mechelsesteenweg 365,2022-10-17,13:00:00,32,16,16,FMN GV 05 Lier
60,Mechelsesteenweg 365,2022-10-17,14:00:00,38,24,14,FMN GV 05 Lier
60,Mechelsesteenweg 365,2022-10-17,15:00:00,50,30,20,FMN GV 05 Lier
60,Mechelsesteenweg 365,2022-10-17,16:00:00,222,68,154,FMN GV 05 Lier
60,Mechelsesteenweg 365,2022-10-17,17:00:00,82,62,20,FMN GV 05 Lier
60,Mechelsesteenweg 365,2022-10-17,18:00:00,42,26,16,FMN GV 05 Lier
60,Mechelsesteenweg 365,2022-10-17,19:00:00,22,6,16,FMN GV 05 Lier
60,Mechelsesteenweg 365,2022-10-17,20:00:00,12,8,4,FMN GV 05 Lier
60,Mechelsesteenweg 365,2022-10-17,21:00:00,6,0,6,FMN GV 05 Lier
60,Mechelsesteenweg 365,2022-10-17,22:00:00,4,2,2,FMN GV 05 Lier
60,Mechelsesteenweg 365,2022-10-17,23:00:00,0,0,0,FMN GV 05 Lier
60,Mechelsesteenweg 365,2022-10-18,00:00:00,4,4,0,FMN GV 05 Lier
60,Mechelsesteenweg 365,2022-10-18,01:00:00,0,0,0,FMN GV 05 Lier
60,Mechelsesteenweg 365,2022-10-18,02:00:00,2,2,0,FMN GV 05 Lier
60,Mechelsesteenweg 365,2022-10-18,03:00:00,0,0,0,FMN GV 05 Lier
60,Mechelsesteenweg 365,2022-10-18,04:00:00,2,0,2,FMN GV 05 Lier
60,Mechelsesteenweg 365,2022-10-18,05:00:00,4,2,2,FMN GV 05 Lier
60,Mechelsesteenweg 365,2022-10-18,06:00:00,36,16,20,FMN GV 05 Lier
60,Mechelsesteenweg 365,2022-10-18,07:00:00,142,58,84,FMN GV 05 Lier
60,Mechelsesteenweg 365,2022-10-18,08:00:00,150,88,62,FMN GV 05 Lier
60,Mechelsesteenweg 365,2022-10-18,09:00:00,96,42,54,FMN GV 05 Lier
60,Mechelsesteenweg 365,2022-10-18,10:00:00,124,52,72,FMN GV 05 Lier
60,Mechelsesteenweg 365,2022-10-18,11:00:00,146,82,64,FMN GV 05 Lier
60,Mechelsesteenweg 365,2022-10-18,12:00:00,138,60,78,FMN GV 05 Lier
60,Mechelsesteenweg 365,2022-10-18,13:00:00,292,150,142,FMN GV 05 Lier
60,Mechelsesteenweg 365,2022-10-18,14:00:00,382,174,208,FMN GV 05 Lier
60,Mechelsesteenweg 365,2022-10-18,15:00:00,328,110,218,FMN GV 05 Lier
60,Mechelsesteenweg 365,2022-10-18,16:00:00,406,140,266,FMN GV 05 Lier
60,Mechelsesteenweg 365,2022-10-18,17:00:00,230,140,90,FMN GV 05 Lier
60,Mechelsesteenweg 365,2022-10-18,18:00:00,114,62,52,FMN GV 05 Lier
60,Mechelsesteenweg 365,2022-10-18,19:00:00,40,18,22,FMN GV 05 Lier
60,Mechelsesteenweg 365,2022-10-18,20:00:00,22,10,12,FMN GV 05 Lier
60,Mechelsesteenweg 365,2022-10-18,21:00:00,14,0,14,FMN GV 05 Lier
60,Mechelsesteenweg 365,2022-10-18,22:00:00,4,2,2,FMN GV 05 Lier
60,Mechelsesteenweg 365,2022-10-18,23:00:00,2,0,2,FMN GV 05 Lier
60,Mechelsesteenweg 365,2022-10-19,00:00:00,2,2,0,FMN GV 05 Lier
60,Mechelsesteenweg 365,2022-10-19,01:00:00,0,0,0,FMN GV 05 Lier
60,Mechelsesteenweg 365,2022-10-19,02:00:00,2,0,2,FMN GV 05 Lier
60,Mechelsesteenweg 365,2022-10-19,03:00:00,2,0,2,FMN GV 05 Lier
60,Mechelsesteenweg 365,2022-10-19,04:00:00,2,0,2,FMN GV 05 Lier
60,Mechelsesteenweg 365,2022-10-19,05:00:00,2,2,0,FMN GV 05 Lier
60,Mechelsesteenweg 365,2022-10-19,06:00:00,26,10,16,FMN GV 05 Lier
60,Mechelsesteenweg 365,2022-10-19,07:00:00,128,58,70,FMN GV 05 Lier
60,Mechelsesteenweg 365,2022-10-19,08:00:00,156,84,72,FMN GV 05 Lier
60,Mechelsesteenweg 365,2022-10-19,09:00:00,64,28,36,FMN GV 05 Lier
60,Mechelsesteenweg 365,2022-10-19,10:00:00,106,54,52,FMN GV 05 Lier
60,Mechelsesteenweg 365,2022-10-19,11:00:00,104,54,50,FMN GV 05 Lier
60,Mechelsesteenweg 365,2022-10-19,12:00:00,246,64,182,FMN GV 05 Lier
60,Mechelsesteenweg 365,2022-10-19,13:00:00,162,76,86,FMN GV 05 Lier
60,Mechelsesteenweg 365,2022-10-19,14:00:00,222,86,136,FMN GV 05 Lier
60,Mechelsesteenweg 365,2022-10-19,15:00:00,162,68,94,FMN GV 05 Lier
60,Mechelsesteenweg 365,2022-10-19,16:00:00,238,118,120,FMN GV 05 Lier
60,Mechelsesteenweg 365,2022-10-19,17:00:00,172,90,82,FMN GV 05 Lier
60,Mechelsesteenweg 365,2022-10-19,18:00:00,100,56,44,FMN GV 05 Lier
60,Mechelsesteenweg 365,2022-10-19,19:00:00,32,20,12,FMN GV 05 Lier
60,Mechelsesteenweg 365,2022-10-19,20:00:00,12,10,2,FMN GV 05 Lier
60,Mechelsesteenweg 365,2022-10-19,21:00:00,6,0,6,FMN GV 05 Lier
60,Mechelsesteenweg 365,2022-10-19,22:00:00,8,4,4,FMN GV 05 Lier
60,Mechelsesteenweg 365,2022-10-19,23:00:00,2,0,2,FMN GV 05 Lier
60,Mechelsesteenweg 365,2022-10-20,00:00:00,2,2,0,FMN GV 05 Lier
60,Mechelsesteenweg 365,2022-10-20,01:00:00,0,0,0,FMN GV 05 Lier
60,Mechelsesteenweg 365,2022-10-20,02:00:00,0,0,0,FMN GV 05 Lier
60,Mechelsesteenweg 365,2022-10-20,03:00:00,0,0,0,FMN GV 05 Lier
60,Mechelsesteenweg 365,2022-10-20,04:00:00,2,0,2,FMN GV 05 Lier
60,Mechelsesteenweg 365,2022-10-20,05:00:00,4,0,4,FMN GV 05 Lier
60,Mechelsesteenweg 365,2022-10-20,06:00:00,16,4,12,FMN GV 05 Lier
60,Mechelsesteenweg 365,2022-10-20,07:00:00,114,48,66,FMN GV 05 Lier
60,Mechelsesteenweg 365,2022-10-20,08:00:00,134,84,50,FMN GV 05 Lier
60,Mechelsesteenweg 365,2022-10-20,09:00:00,66,46,20,FMN GV 05 Lier
60,Mechelsesteenweg 365,2022-10-20,10:00:00,52,24,28,FMN GV 05 Lier
60,Mechelsesteenweg 365,2022-10-20,11:00:00,24,14,10,FMN GV 05 Lier
60,Mechelsesteenweg 365,2022-10-20,12:00:00,30,16,14,FMN GV 05 Lier
60,Mechelsesteenweg 365,2022-10-20,13:00:00,28,16,12,FMN GV 05 Lier
60,Mechelsesteenweg 365,2022-10-20,14:00:00,76,18,58,FMN GV 05 Lier
60,Mechelsesteenweg 365,2022-10-20,15:00:00,98,62,36,FMN GV 05 Lier
60,Mechelsesteenweg 365,2022-10-20,16:00:00,216,86,130,FMN GV 05 Lier
60,Mechelsesteenweg 365,2022-10-20,17:00:00,132,58,74,FMN GV 05 Lier
60,Mechelsesteenweg 365,2022-10-20,18:00:00,48,28,20,FMN GV 05 Lier
60,Mechelsesteenweg 365,2022-10-20,19:00:00,18,14,4,FMN GV 05 Lier
60,Mechelsesteenweg 365,2022-10-20,20:00:00,18,12,6,FMN GV 05 Lier
60,Mechelsesteenweg 365,2022-10-20,21:00:00,8,4,4,FMN GV 05 Lier
60,Mechelsesteenweg 365,2022-10-20,22:00:00,12,0,12,FMN GV 05 Lier
60,Mechelsesteenweg 365,2022-10-20,23:00:00,2,2,0,FMN GV 05 Lier
60,Mechelsesteenweg 365,2022-10-21,00:00:00,0,0,0,FMN GV 05 Lier
60,Mechelsesteenweg 365,2022-10-21,01:00:00,2,2,0,FMN GV 05 Lier
60,Mechelsesteenweg 365,2022-10-21,02:00:00,0,0,0,FMN GV 05 Lier
60,Mechelsesteenweg 365,2022-10-21,03:00:00,2,0,2,FMN GV 05 Lier
60,Mechelsesteenweg 365,2022-10-21,04:00:00,0,0,0,FMN GV 05 Lier
60,Mechelsesteenweg 365,2022-10-21,05:00:00,6,4,2,FMN GV 05 Lier
60,Mechelsesteenweg 365,2022-10-21,06:00:00,28,12,16,FMN GV 05 Lier
60,Mechelsesteenweg 365,2022-10-21,07:00:00,96,44,52,FMN GV 05 Lier
60,Mechelsesteenweg 365,2022-10-21,08:00:00,122,76,46,FMN GV 05 Lier
60,Mechelsesteenweg 365,2022-10-21,09:00:00,74,54,20,FMN GV 05 Lier
60,Mechelsesteenweg 365,2022-10-21,10:00:00,48,14,34,FMN GV 05 Lier
60,Mechelsesteenweg 365,2022-10-21,11:00:00,72,30,42,FMN GV 05 Lier
60,Mechelsesteenweg 365,2022-10-21,12:00:00,88,38,50,FMN GV 05 Lier
60,Mechelsesteenweg 365,2022-10-21,13:00:00,180,114,66,FMN GV 05 Lier
60,Mechelsesteenweg 365,2022-10-21,14:00:00,248,110,138,FMN GV 05 Lier
60,Mechelsesteenweg 365,2022-10-21,15:00:00,166,90,76,FMN GV 05 Lier
60,Mechelsesteenweg 365,2022-10-21,16:00:00,256,84,172,FMN GV 05 Lier
60,Mechelsesteenweg 365,2022-10-21,17:00:00,132,80,52,FMN GV 05 Lier
60,Mechelsesteenweg 365,2022-10-21,18:00:00,56,34,22,FMN GV 05 Lier
60,Mechelsesteenweg 365,2022-10-21,19:00:00,26,14,12,FMN GV 05 Lier
60,Mechelsesteenweg 365,2022-10-21,20:00:00,12,8,4,FMN GV 05 Lier
60,Mechelsesteenweg 365,2022-10-21,21:00:00,6,2,4,FMN GV 05 Lier
60,Mechelsesteenweg 365,2022-10-21,22:00:00,8,0,8,FMN GV 05 Lier
60,Mechelsesteenweg 365,2022-10-21,23:00:00,4,2,2,FMN GV 05 Lier
60,Mechelsesteenweg 365,2022-10-22,00:00:00,8,4,4,FMN GV 05 Lier
60,Mechelsesteenweg 365,2022-10-22,01:00:00,0,0,0,FMN GV 05 Lier
60,Mechelsesteenweg 365,2022-10-22,02:00:00,0,0,0,FMN GV 05 Lier
60,Mechelsesteenweg 365,2022-10-22,03:00:00,0,0,0,FMN GV 05 Lier
60,Mechelsesteenweg 365,2022-10-22,04:00:00,0,0,0,FMN GV 05 Lier
60,Mechelsesteenweg 365,2022-10-22,05:00:00,0,0,0,FMN GV 05 Lier
60,Mechelsesteenweg 365,2022-10-22,06:00:00,6,2,4,FMN GV 05 Lier
60,Mechelsesteenweg 365,2022-10-22,07:00:00,8,6,2,FMN GV 05 Lier
60,Mechelsesteenweg 365,2022-10-22,08:00:00,30,14,16,FMN GV 05 Lier
60,Mechelsesteenweg 365,2022-10-22,09:00:00,58,28,30,FMN GV 05 Lier
60,Mechelsesteenweg 365,2022-10-22,10:00:00,132,66,66,FMN GV 05 Lier
60,Mechelsesteenweg 365,2022-10-22,11:00:00,136,52,84,FMN GV 05 Lier
60,Mechelsesteenweg 365,2022-10-22,12:00:00,168,84,84,FMN GV 05 Lier
60,Mechelsesteenweg 365,2022-10-22,13:00:00,200,106,94,FMN GV 05 Lier
60,Mechelsesteenweg 365,2022-10-22,14:00:00,302,162,140,FMN GV 05 Lier
60,Mechelsesteenweg 365,2022-10-22,15:00:00,310,150,160,FMN GV 05 Lier
60,Mechelsesteenweg 365,2022-10-22,16:00:00,194,94,100,FMN GV 05 Lier
60,Mechelsesteenweg 365,2022-10-22,17:00:00,92,40,52,FMN GV 05 Lier
60,Mechelsesteenweg 365,2022-10-22,18:00:00,42,22,20,FMN GV 05 Lier
60,Mechelsesteenweg 365,2022-10-22,19:00:00,24,22,2,FMN GV 05 Lier
60,Mechelsesteenweg 365,2022-10-22,20:00:00,4,2,2,FMN GV 05 Lier
60,Mechelsesteenweg 365,2022-10-22,21:00:00,10,2,8,FMN GV 05 Lier
60,Mechelsesteenweg 365,2022-10-22,22:00:00,2,0,2,FMN GV 05 Lier
60,Mechelsesteenweg 365,2022-10-22,23:00:00,0,0,0,FMN GV 05 Lier
60,Mechelsesteenweg 365,2022-10-23,00:00:00,2,0,2,FMN GV 05 Lier
60,Mechelsesteenweg 365,2022-10-23,01:00:00,2,2,0,FMN GV 05 Lier
60,Mechelsesteenweg 365,2022-10-23,02:00:00,10,8,2,FMN GV 05 Lier
60,Mechelsesteenweg 365,2022-10-23,03:00:00,8,8,0,FMN GV 05 Lier
60,Mechelsesteenweg 365,2022-10-23,04:00:00,2,0,2,FMN GV 05 Lier
60,Mechelsesteenweg 365,2022-10-23,05:00:00,4,0,4,FMN GV 05 Lier
60,Mechelsesteenweg 365,2022-10-23,06:00:00,0,0,0,FMN GV 05 Lier
60,Mechelsesteenweg 365,2022-10-23,07:00:00,2,2,0,FMN GV 05 Lier
60,Mechelsesteenweg 365,2022-10-23,08:00:00,14,12,2,FMN GV 05 Lier
60,Mechelsesteenweg 365,2022-10-23,09:00:00,114,52,62,FMN GV 05 Lier
60,Mechelsesteenweg 365,2022-10-23,10:00:00,204,100,104,FMN GV 05 Lier
60,Mechelsesteenweg 365,2022-10-23,11:00:00,258,128,130,FMN GV 05 Lier
60,Mechelsesteenweg 365,2022-10-23,12:00:00,140,64,76,FMN GV 05 Lier
60,Mechelsesteenweg 365,2022-10-23,13:00:00,226,88,138,FMN GV 05 Lier
60,Mechelsesteenweg 365,2022-10-23,14:00:00,186,112,74,FMN GV 05 Lier
60,Mechelsesteenweg 365,2022-10-23,15:00:00,170,78,92,FMN GV 05 Lier
60,Mechelsesteenweg 365,2022-10-23,16:00:00,194,82,112,FMN GV 05 Lier
60,Mechelsesteenweg 365,2022-10-23,17:00:00,100,40,60,FMN GV 05 Lier
60,Mechelsesteenweg 365,2022-10-23,18:00:00,28,10,18,FMN GV 05 Lier
60,Mechelsesteenweg 365,2022-10-23,19:00:00,8,4,4,FMN GV 05 Lier
60,Mechelsesteenweg 365,2022-10-23,20:00:00,2,0,2,FMN GV 05 Lier
60,Mechelsesteenweg 365,2022-10-23,21:00:00,2,0,2,FMN GV 05 Lier
60,Mechelsesteenweg 365,2022-10-23,22:00:00,0,0,0,FMN GV 05 Lier
60,Mechelsesteenweg 365,2022-10-23,23:00:00,0,0,0,FMN GV 05 Lier
60,Mechelsesteenweg 365,2022-10-24,00:00:00,0,0,0,FMN GV 05 Lier
60,Mechelsesteenweg 365,2022-10-24,01:00:00,0,0,0,FMN GV 05 Lier
60,Mechelsesteenweg 365,2022-10-24,02:00:00,0,0,0,FMN GV 05 Lier
60,Mechelsesteenweg 365,2022-10-24,03:00:00,2,0,2,FMN GV 05 Lier
60,Mechelsesteenweg 365,2022-10-24,04:00:00,2,0,2,FMN GV 05 Lier
60,Mechelsesteenweg 365,2022-10-24,05:00:00,2,0,2,FMN GV 05 Lier
60,Mechelsesteenweg 365,2022-10-24,06:00:00,26,4,22,FMN GV 05 Lier
60,Mechelsesteenweg 365,2022-10-24,07:00:00,100,46,54,FMN GV 05 Lier
60,Mechelsesteenweg 365,2022-10-24,08:00:00,102,70,32,FMN GV 05 Lier
60,Mechelsesteenweg 365,2022-10-24,09:00:00,48,18,30,FMN GV 05 Lier
60,Mechelsesteenweg 365,2022-10-24,10:00:00,14,6,8,FMN GV 05 Lier
60,Mechelsesteenweg 365,2022-10-24,11:00:00,34,12,22,FMN GV 05 Lier
60,Mechelsesteenweg 365,2022-10-24,12:00:00,38,14,24,FMN GV 05 Lier
60,Mechelsesteenweg 365,2022-10-24,13:00:00,22,8,14,FMN GV 05 Lier
60,Mechelsesteenweg 365,2022-10-24,14:00:00,36,14,22,FMN GV 05 Lier
60,Mechelsesteenweg 365,2022-10-24,15:00:00,76,50,26,FMN GV 05 Lier
60,Mechelsesteenweg 365,2022-10-24,16:00:00,186,76,110,FMN GV 05 Lier
60,Mechelsesteenweg 365,2022-10-24,17:00:00,94,58,36,FMN GV 05 Lier
60,Mechelsesteenweg 365,2022-10-24,18:00:00,46,28,18,FMN GV 05 Lier
60,Mechelsesteenweg 365,2022-10-24,19:00:00,6,2,4,FMN GV 05 Lier
60,Mechelsesteenweg 365,2022-10-24,20:00:00,2,2,0,FMN GV 05 Lier
60,Mechelsesteenweg 365,2022-10-24,21:00:00,0,0,0,FMN GV 05 Lier
60,Mechelsesteenweg 365,2022-10-24,22:00:00,4,0,4,FMN GV 05 Lier
60,Mechelsesteenweg 365,2022-10-24,23:00:00,0,0,0,FMN GV 05 Lier
60,Mechelsesteenweg 365,2022-10-25,00:00:00,2,2,0,FMN GV 05 Lier
60,Mechelsesteenweg 365,2022-10-25,01:00:00,0,0,0,FMN GV 05 Lier
60,Mechelsesteenweg 365,2022-10-25,02:00:00,0,0,0,FMN GV 05 Lier
60,Mechelsesteenweg 365,2022-10-25,03:00:00,2,0,2,FMN GV 05 Lier
60,Mechelsesteenweg 365,2022-10-25,04:00:00,4,0,4,FMN GV 05 Lier
60,Mechelsesteenweg 365,2022-10-25,05:00:00,0,0,0,FMN GV 05 Lier
60,Mechelsesteenweg 365,2022-10-25,06:00:00,38,10,28,FMN GV 05 Lier
60,Mechelsesteenweg 365,2022-10-25,07:00:00,116,40,76,FMN GV 05 Lier
60,Mechelsesteenweg 365,2022-10-25,08:00:00,158,82,76,FMN GV 05 Lier
60,Mechelsesteenweg 365,2022-10-25,09:00:00,64,32,32,FMN GV 05 Lier
60,Mechelsesteenweg 365,2022-10-25,10:00:00,82,42,40,FMN GV 05 Lier
60,Mechelsesteenweg 365,2022-10-25,11:00:00,124,44,80,FMN GV 05 Lier
60,Mechelsesteenweg 365,2022-10-25,12:00:00,120,80,40,FMN GV 05 Lier
60,Mechelsesteenweg 365,2022-10-25,13:00:00,166,84,82,FMN GV 05 Lier
60,Mechelsesteenweg 365,2022-10-25,14:00:00,166,112,54,FMN GV 05 Lier
60,Mechelsesteenweg 365,2022-10-25,15:00:00,234,120,114,FMN GV 05 Lier
60,Mechelsesteenweg 365,2022-10-25,16:00:00,284,92,192,FMN GV 05 Lier
60,Mechelsesteenweg 365,2022-10-25,17:00:00,150,90,60,FMN GV 05 Lier
60,Mechelsesteenweg 365,2022-10-25,18:00:00,66,38,28,FMN GV 05 Lier
60,Mechelsesteenweg 365,2022-10-25,19:00:00,20,6,14,FMN GV 05 Lier
60,Mechelsesteenweg 365,2022-10-25,20:00:00,16,8,8,FMN GV 05 Lier
60,Mechelsesteenweg 365,2022-10-25,21:00:00,6,6,0,FMN GV 05 Lier
60,Mechelsesteenweg 365,2022-10-25,22:00:00,4,4,0,FMN GV 05 Lier
60,Mechelsesteenweg 365,2022-10-25,23:00:00,0,0,0,FMN GV 05 Lier
60,Mechelsesteenweg 365,2022-10-26,00:00:00,0,0,0,FMN GV 05 Lier
60,Mechelsesteenweg 365,2022-10-26,01:00:00,0,0,0,FMN GV 05 Lier
60,Mechelsesteenweg 365,2022-10-26,02:00:00,2,2,0,FMN GV 05 Lier
60,Mechelsesteenweg 365,2022-10-26,03:00:00,2,0,2,FMN GV 05 Lier
60,Mechelsesteenweg 365,2022-10-26,04:00:00,4,0,4,FMN GV 05 Lier
60,Mechelsesteenweg 365,2022-10-26,05:00:00,2,0,2,FMN GV 05 Lier
60,Mechelsesteenweg 365,2022-10-26,06:00:00,18,4,14,FMN GV 05 Lier
60,Mechelsesteenweg 365,2022-10-26,07:00:00,112,52,60,FMN GV 05 Lier
60,Mechelsesteenweg 365,2022-10-26,08:00:00,152,88,64,FMN GV 05 Lier
60,Mechelsesteenweg 365,2022-10-26,09:00:00,68,36,32,FMN GV 05 Lier
60,Mechelsesteenweg 365,2022-10-26,10:00:00,96,50,46,FMN GV 05 Lier
60,Mechelsesteenweg 365,2022-10-26,11:00:00,164,80,84,FMN GV 05 Lier
60,Mechelsesteenweg 365,2022-10-26,12:00:00,214,66,148,FMN GV 05 Lier
60,Mechelsesteenweg 365,2022-10-26,13:00:00,166,76,90,FMN GV 05 Lier
60,Mechelsesteenweg 365,2022-10-26,14:00:00,264,134,130,FMN GV 05 Lier
60,Mechelsesteenweg 365,2022-10-26,15:00:00,236,142,94,FMN GV 05 Lier
60,Mechelsesteenweg 365,2022-10-26,16:00:00,238,122,116,FMN GV 05 Lier
60,Mechelsesteenweg 365,2022-10-26,17:00:00,152,88,64,FMN GV 05 Lier
60,Mechelsesteenweg 365,2022-10-26,18:00:00,90,52,38,FMN GV 05 Lier
60,Mechelsesteenweg 365,2022-10-26,19:00:00,40,30,10,FMN GV 05 Lier
60,Mechelsesteenweg 365,2022-10-26,20:00:00,8,2,6,FMN GV 05 Lier
60,Mechelsesteenweg 365,2022-10-26,21:00:00,10,2,8,FMN GV 05 Lier
60,Mechelsesteenweg 365,2022-10-26,22:00:00,6,2,4,FMN GV 05 Lier
60,Mechelsesteenweg 365,2022-10-26,23:00:00,2,0,2,FMN GV 05 Lier
60,Mechelsesteenweg 365,2022-10-27,00:00:00,0,0,0,FMN GV 05 Lier
60,Mechelsesteenweg 365,2022-10-27,01:00:00,0,0,0,FMN GV 05 Lier
60,Mechelsesteenweg 365,2022-10-27,02:00:00,0,0,0,FMN GV 05 Lier
60,Mechelsesteenweg 365,2022-10-27,03:00:00,2,0,2,FMN GV 05 Lier
60,Mechelsesteenweg 365,2022-10-27,04:00:00,2,0,2,FMN GV 05 Lier
60,Mechelsesteenweg 365,2022-10-27,05:00:00,2,0,2,FMN GV 05 Lier
60,Mechelsesteenweg 365,2022-10-27,06:00:00,28,8,20,FMN GV 05 Lier
60,Mechelsesteenweg 365,2022-10-27,07:00:00,124,62,62,FMN GV 05 Lier
60,Mechelsesteenweg 365,2022-10-27,08:00:00,158,86,72,FMN GV 05 Lier
60,Mechelsesteenweg 365,2022-10-27,09:00:00,202,138,64,FMN GV 05 Lier
60,Mechelsesteenweg 365,2022-10-27,10:00:00,94,56,38,FMN GV 05 Lier
60,Mechelsesteenweg 365,2022-10-27,11:00:00,118,62,56,FMN GV 05 Lier
60,Mechelsesteenweg 365,2022-10-27,12:00:00,138,72,66,FMN GV 05 Lier
60,Mechelsesteenweg 365,2022-10-27,13:00:00,182,100,82,FMN GV 05 Lier
60,Mechelsesteenweg 365,2022-10-27,14:00:00,338,130,208,FMN GV 05 Lier
60,Mechelsesteenweg 365,2022-10-27,15:00:00,198,96,102,FMN GV 05 Lier
60,Mechelsesteenweg 365,2022-10-27,16:00:00,322,110,212,FMN GV 05 Lier
60,Mechelsesteenweg 365,2022-10-27,17:00:00,210,116,94,FMN GV 05 Lier
60,Mechelsesteenweg 365,2022-10-27,18:00:00,78,44,34,FMN GV 05 Lier
60,Mechelsesteenweg 365,2022-10-27,19:00:00,34,22,12,FMN GV 05 Lier
60,Mechelsesteenweg 365,2022-10-27,20:00:00,14,10,4,FMN GV 05 Lier
60,Mechelsesteenweg 365,2022-10-27,21:00:00,14,4,10,FMN GV 05 Lier
60,Mechelsesteenweg 365,2022-10-27,22:00:00,20,10,10,FMN GV 05 Lier
60,Mechelsesteenweg 365,2022-10-27,23:00:00,0,0,0,FMN GV 05 Lier
60,Mechelsesteenweg 365,2022-10-28,00:00:00,0,0,0,FMN GV 05 Lier
60,Mechelsesteenweg 365,2022-10-28,01:00:00,0,0,0,FMN GV 05 Lier
60,Mechelsesteenweg 365,2022-10-28,02:00:00,0,0,0,FMN GV 05 Lier
60,Mechelsesteenweg 365,2022-10-28,03:00:00,0,0,0,FMN GV 05 Lier
60,Mechelsesteenweg 365,2022-10-28,04:00:00,2,0,2,FMN GV 05 Lier
60,Mechelsesteenweg 365,2022-10-28,05:00:00,6,0,6,FMN GV 05 Lier
60,Mechelsesteenweg 365,2022-10-28,06:00:00,18,4,14,FMN GV 05 Lier
60,Mechelsesteenweg 365,2022-10-28,07:00:00,84,38,46,FMN GV 05 Lier
60,Mechelsesteenweg 365,2022-10-28,08:00:00,144,94,50,FMN GV 05 Lier
60,Mechelsesteenweg 365,2022-10-28,09:00:00,78,32,46,FMN GV 05 Lier
60,Mechelsesteenweg 365,2022-10-28,10:00:00,102,48,54,FMN GV 05 Lier
60,Mechelsesteenweg 365,2022-10-28,11:00:00,158,68,90,FMN GV 05 Lier
60,Mechelsesteenweg 365,2022-10-28,12:00:00,174,80,94,FMN GV 05 Lier
60,Mechelsesteenweg 365,2022-10-28,13:00:00,252,114,138,FMN GV 05 Lier
60,Mechelsesteenweg 365,2022-10-28,14:00:00,270,126,144,FMN GV 05 Lier
60,Mechelsesteenweg 365,2022-10-28,15:00:00,244,108,136,FMN GV 05 Lier
60,Mechelsesteenweg 365,2022-10-28,16:00:00,322,112,210,FMN GV 05 Lier
60,Mechelsesteenweg 365,2022-10-28,17:00:00,154,86,68,FMN GV 05 Lier
60,Mechelsesteenweg 365,2022-10-28,18:00:00,80,30,50,FMN GV 05 Lier
60,Mechelsesteenweg 365,2022-10-28,19:00:00,10,2,8,FMN GV 05 Lier
60,Mechelsesteenweg 365,2022-10-28,20:00:00,18,14,4,FMN GV 05 Lier
60,Mechelsesteenweg 365,2022-10-28,21:00:00,4,2,2,FMN GV 05 Lier
60,Mechelsesteenweg 365,2022-10-28,22:00:00,4,2,2,FMN GV 05 Lier
60,Mechelsesteenweg 365,2022-10-28,23:00:00,10,6,4,FMN GV 05 Lier
60,Mechelsesteenweg 365,2022-10-29,00:00:00,8,6,2,FMN GV 05 Lier
60,Mechelsesteenweg 365,2022-10-29,01:00:00,0,0,0,FMN GV 05 Lier
60,Mechelsesteenweg 365,2022-10-29,02:00:00,0,0,0,FMN GV 05 Lier
60,Mechelsesteenweg 365,2022-10-29,03:00:00,4,2,2,FMN GV 05 Lier
60,Mechelsesteenweg 365,2022-10-29,04:00:00,0,0,0,FMN GV 05 Lier
60,Mechelsesteenweg 365,2022-10-29,05:00:00,0,0,0,FMN GV 05 Lier
60,Mechelsesteenweg 365,2022-10-29,06:00:00,0,0,0,FMN GV 05 Lier
60,Mechelsesteenweg 365,2022-10-29,07:00:00,4,0,4,FMN GV 05 Lier
60,Mechelsesteenweg 365,2022-10-29,08:00:00,32,16,16,FMN GV 05 Lier
60,Mechelsesteenweg 365,2022-10-29,09:00:00,68,36,32,FMN GV 05 Lier
60,Mechelsesteenweg 365,2022-10-29,10:00:00,146,80,66,FMN GV 05 Lier
60,Mechelsesteenweg 365,2022-10-29,11:00:00,234,110,124,FMN GV 05 Lier
60,Mechelsesteenweg 365,2022-10-29,12:00:00,180,94,86,FMN GV 05 Lier
60,Mechelsesteenweg 365,2022-10-29,13:00:00,200,96,104,FMN GV 05 Lier
60,Mechelsesteenweg 365,2022-10-29,14:00:00,420,216,204,FMN GV 05 Lier
60,Mechelsesteenweg 365,2022-10-29,15:00:00,366,176,190,FMN GV 05 Lier
60,Mechelsesteenweg 365,2022-10-29,16:00:00,278,106,172,FMN GV 05 Lier
60,Mechelsesteenweg 365,2022-10-29,17:00:00,156,84,72,FMN GV 05 Lier
60,Mechelsesteenweg 365,2022-10-29,18:00:00,54,28,26,FMN GV 05 Lier
60,Mechelsesteenweg 365,2022-10-29,19:00:00,20,10,10,FMN GV 05 Lier
60,Mechelsesteenweg 365,2022-10-29,20:00:00,8,2,6,FMN GV 05 Lier
60,Mechelsesteenweg 365,2022-10-29,21:00:00,16,2,14,FMN GV 05 Lier
60,Mechelsesteenweg 365,2022-10-29,22:00:00,20,6,14,FMN GV 05 Lier
60,Mechelsesteenweg 365,2022-10-29,23:00:00,8,2,6,FMN GV 05 Lier
60,Mechelsesteenweg 365,2022-10-30,00:00:00,2,2,0,FMN GV 05 Lier
60,Mechelsesteenweg 365,2022-10-30,01:00:00,0,0,0,FMN GV 05 Lier
60,Mechelsesteenweg 365,2022-10-30,02:00:00,50,44,6,FMN GV 05 Lier
60,Mechelsesteenweg 365,2022-10-30,03:00:00,0,0,0,FMN GV 05 Lier
60,Mechelsesteenweg 365,2022-10-30,04:00:00,6,0,6,FMN GV 05 Lier
60,Mechelsesteenweg 365,2022-10-30,05:00:00,0,0,0,FMN GV 05 Lier
60,Mechelsesteenweg 365,2022-10-30,06:00:00,4,2,2,FMN GV 05 Lier
60,Mechelsesteenweg 365,2022-10-30,07:00:00,12,4,8,FMN GV 05 Lier
60,Mechelsesteenweg 365,2022-10-30,08:00:00,52,28,24,FMN GV 05 Lier
60,Mechelsesteenweg 365,2022-10-30,09:00:00,192,118,74,FMN GV 05 Lier
60,Mechelsesteenweg 365,2022-10-30,10:00:00,424,224,200,FMN GV 05 Lier
60,Mechelsesteenweg 365,2022-10-30,11:00:00,460,224,236,FMN GV 05 Lier
60,Mechelsesteenweg 365,2022-10-30,12:00:00,280,158,122,FMN GV 05 Lier
60,Mechelsesteenweg 365,2022-10-30,13:00:00,288,138,150,FMN GV 05 Lier
60,Mechelsesteenweg 365,2022-10-30,14:00:00,386,226,160,FMN GV 05 Lier
60,Mechelsesteenweg 365,2022-10-30,15:00:00,448,184,264,FMN GV 05 Lier
60,Mechelsesteenweg 365,2022-10-30,16:00:00,192,66,126,FMN GV 05 Lier
60,Mechelsesteenweg 365,2022-10-30,17:00:00,84,30,54,FMN GV 05 Lier
60,Mechelsesteenweg 365,2022-10-30,18:00:00,2,2,0,FMN GV 05 Lier
60,Mechelsesteenweg 365,2022-10-30,19:00:00,6,2,4,FMN GV 05 Lier
60,Mechelsesteenweg 365,2022-10-30,20:00:00,12,6,6,FMN GV 05 Lier
60,Mechelsesteenweg 365,2022-10-30,21:00:00,0,0,0,FMN GV 05 Lier
60,Mechelsesteenweg 365,2022-10-30,22:00:00,0,0,0,FMN GV 05 Lier
60,Mechelsesteenweg 365,2022-10-30,23:00:00,4,2,2,FMN GV 05 Lier
60,Mechelsesteenweg 365,2022-10-31,00:00:00,0,0,0,FMN GV 05 Lier
60,Mechelsesteenweg 365,2022-10-31,01:00:00,0,0,0,FMN GV 05 Lier
60,Mechelsesteenweg 365,2022-10-31,02:00:00,0,0,0,FMN GV 05 Lier
60,Mechelsesteenweg 365,2022-10-31,03:00:00,2,0,2,FMN GV 05 Lier
60,Mechelsesteenweg 365,2022-10-31,04:00:00,2,0,2,FMN GV 05 Lier
60,Mechelsesteenweg 365,2022-10-31,05:00:00,0,0,0,FMN GV 05 Lier
60,Mechelsesteenweg 365,2022-10-31,06:00:00,8,4,4,FMN GV 05 Lier
60,Mechelsesteenweg 365,2022-10-31,07:00:00,26,6,20,FMN GV 05 Lier
60,Mechelsesteenweg 365,2022-10-31,08:00:00,22,2,20,FMN GV 05 Lier
60,Mechelsesteenweg 365,2022-10-31,09:00:00,22,10,12,FMN GV 05 Lier
60,Mechelsesteenweg 365,2022-10-31,10:00:00,22,8,14,FMN GV 05 Lier
60,Mechelsesteenweg 365,2022-10-31,11:00:00,66,28,38,FMN GV 05 Lier
60,Mechelsesteenweg 365,2022-10-31,12:00:00,36,12,24,FMN GV 05 Lier
60,Mechelsesteenweg 365,2022-10-31,13:00:00,92,36,56,FMN GV 05 Lier
60,Mechelsesteenweg 365,2022-10-31,14:00:00,200,92,108,FMN GV 05 Lier
60,Mechelsesteenweg 365,2022-10-31,15:00:00,198,92,106,FMN GV 05 Lier
60,Mechelsesteenweg 365,2022-10-31,16:00:00,144,80,64,FMN GV 05 Lier
60,Mechelsesteenweg 365,2022-10-31,17:00:00,54,28,26,FMN GV 05 Lier
60,Mechelsesteenweg 365,2022-10-31,18:00:00,12,6,6,FMN GV 05 Lier
60,Mechelsesteenweg 365,2022-10-31,19:00:00,10,4,6,FMN GV 05 Lier
60,Mechelsesteenweg 365,2022-10-31,20:00:00,4,0,4,FMN GV 05 Lier
60,Mechelsesteenweg 365,2022-10-31,21:00:00,4,0,4,FMN GV 05 Lier
60,Mechelsesteenweg 365,2022-10-31,22:00:00,0,0,0,FMN GV 05 Lier
60,Mechelsesteenweg 365,2022-10-31,23:00:00,2,2,0,FMN GV 05 Lier
60,Mechelsesteenweg 365,2022-11-01,00:00:00,0,0,0,FMN GV 05 Lier
60,Mechelsesteenweg 365,2022-11-01,01:00:00,4,2,2,FMN GV 05 Lier
60,Mechelsesteenweg 365,2022-11-01,02:00:00,2,0,2,FMN GV 05 Lier
60,Mechelsesteenweg 365,2022-11-01,03:00:00,0,0,0,FMN GV 05 Lier
60,Mechelsesteenweg 365,2022-11-01,04:00:00,2,0,2,FMN GV 05 Lier
60,Mechelsesteenweg 365,2022-11-01,05:00:00,0,0,0,FMN GV 05 Lier
60,Mechelsesteenweg 365,2022-11-01,06:00:00,4,4,0,FMN GV 05 Lier
60,Mechelsesteenweg 365,2022-11-01,07:00:00,6,6,0,FMN GV 05 Lier
60,Mechelsesteenweg 365,2022-11-01,08:00:00,20,12,8,FMN GV 05 Lier
60,Mechelsesteenweg 365,2022-11-01,09:00:00,108,38,70,FMN GV 05 Lier
60,Mechelsesteenweg 365,2022-11-01,10:00:00,166,80,86,FMN GV 05 Lier
60,Mechelsesteenweg 365,2022-11-01,11:00:00,156,100,56,FMN GV 05 Lier
60,Mechelsesteenweg 365,2022-11-01,12:00:00,132,78,54,FMN GV 05 Lier
60,Mechelsesteenweg 365,2022-11-01,13:00:00,112,68,44,FMN GV 05 Lier
60,Mechelsesteenweg 365,2022-11-01,14:00:00,182,96,86,FMN GV 05 Lier
60,Mechelsesteenweg 365,2022-11-01,15:00:00,116,44,72,FMN GV 05 Lier
60,Mechelsesteenweg 365,2022-11-01,16:00:00,104,32,72,FMN GV 05 Lier
60,Mechelsesteenweg 365,2022-11-01,17:00:00,36,10,26,FMN GV 05 Lier
60,Mechelsesteenweg 365,2022-11-01,18:00:00,10,4,6,FMN GV 05 Lier
60,Mechelsesteenweg 365,2022-11-01,19:00:00,14,8,6,FMN GV 05 Lier
60,Mechelsesteenweg 365,2022-11-01,20:00:00,6,2,4,FMN GV 05 Lier
60,Mechelsesteenweg 365,2022-11-01,21:00:00,0,0,0,FMN GV 05 Lier
60,Mechelsesteenweg 365,2022-11-01,22:00:00,4,0,4,FMN GV 05 Lier
60,Mechelsesteenweg 365,2022-11-01,23:00:00,0,0,0,FMN GV 05 Lier
60,Mechelsesteenweg 365,2022-11-02,00:00:00,0,0,0,FMN GV 05 Lier
60,Mechelsesteenweg 365,2022-11-02,01:00:00,2,2,0,FMN GV 05 Lier
60,Mechelsesteenweg 365,2022-11-02,02:00:00,0,0,0,FMN GV 05 Lier
60,Mechelsesteenweg 365,2022-11-02,03:00:00,2,0,2,FMN GV 05 Lier
60,Mechelsesteenweg 365,2022-11-02,04:00:00,2,0,2,FMN GV 05 Lier
60,Mechelsesteenweg 365,2022-11-02,05:00:00,2,0,2,FMN GV 05 Lier
60,Mechelsesteenweg 365,2022-11-02,06:00:00,24,6,18,FMN GV 05 Lier
60,Mechelsesteenweg 365,2022-11-02,07:00:00,38,8,30,FMN GV 05 Lier
60,Mechelsesteenweg 365,2022-11-02,08:00:00,40,10,30,FMN GV 05 Lier
60,Mechelsesteenweg 365,2022-11-02,09:00:00,40,16,24,FMN GV 05 Lier
60,Mechelsesteenweg 365,2022-11-02,10:00:00,58,34,24,FMN GV 05 Lier
60,Mechelsesteenweg 365,2022-11-02,11:00:00,102,50,52,FMN GV 05 Lier
60,Mechelsesteenweg 365,2022-11-02,12:00:00,74,36,38,FMN GV 05 Lier
60,Mechelsesteenweg 365,2022-11-02,13:00:00,150,84,66,FMN GV 05 Lier
60,Mechelsesteenweg 365,2022-11-02,14:00:00,164,100,64,FMN GV 05 Lier
60,Mechelsesteenweg 365,2022-11-02,15:00:00,162,76,86,FMN GV 05 Lier
60,Mechelsesteenweg 365,2022-11-02,16:00:00,128,74,54,FMN GV 05 Lier
60,Mechelsesteenweg 365,2022-11-02,17:00:00,78,60,18,FMN GV 05 Lier
60,Mechelsesteenweg 365,2022-11-02,18:00:00,18,12,6,FMN GV 05 Lier
60,Mechelsesteenweg 365,2022-11-02,19:00:00,10,6,4,FMN GV 05 Lier
60,Mechelsesteenweg 365,2022-11-02,20:00:00,12,6,6,FMN GV 05 Lier
60,Mechelsesteenweg 365,2022-11-02,21:00:00,6,2,4,FMN GV 05 Lier
60,Mechelsesteenweg 365,2022-11-02,22:00:00,4,2,2,FMN GV 05 Lier
60,Mechelsesteenweg 365,2022-11-02,23:00:00,0,0,0,FMN GV 05 Lier
60,Mechelsesteenweg 365,2022-11-03,00:00:00,0,0,0,FMN GV 05 Lier
60,Mechelsesteenweg 365,2022-11-03,01:00:00,0,0,0,FMN GV 05 Lier
60,Mechelsesteenweg 365,2022-11-03,02:00:00,0,0,0,FMN GV 05 Lier
60,Mechelsesteenweg 365,2022-11-03,03:00:00,2,0,2,FMN GV 05 Lier
60,Mechelsesteenweg 365,2022-11-03,04:00:00,2,0,2,FMN GV 05 Lier
60,Mechelsesteenweg 365,2022-11-03,05:00:00,4,2,2,FMN GV 05 Lier
60,Mechelsesteenweg 365,2022-11-03,06:00:00,18,8,10,FMN GV 05 Lier
60,Mechelsesteenweg 365,2022-11-03,07:00:00,40,6,34,FMN GV 05 Lier
60,Mechelsesteenweg 365,2022-11-03,08:00:00,40,16,24,FMN GV 05 Lier
60,Mechelsesteenweg 365,2022-11-03,09:00:00,20,18,2,FMN GV 05 Lier
60,Mechelsesteenweg 365,2022-11-03,10:00:00,52,26,26,FMN GV 05 Lier
60,Mechelsesteenweg 365,2022-11-03,11:00:00,66,34,32,FMN GV 05 Lier
60,Mechelsesteenweg 365,2022-11-03,12:00:00,56,36,20,FMN GV 05 Lier
60,Mechelsesteenweg 365,2022-11-03,13:00:00,32,16,16,FMN GV 05 Lier
60,Mechelsesteenweg 365,2022-11-03,14:00:00,52,34,18,FMN GV 05 Lier
60,Mechelsesteenweg 365,2022-11-03,15:00:00,46,20,26,FMN GV 05 Lier
60,Mechelsesteenweg 365,2022-11-03,16:00:00,58,38,20,FMN GV 05 Lier
60,Mechelsesteenweg 365,2022-11-03,17:00:00,28,20,8,FMN GV 05 Lier
60,Mechelsesteenweg 365,2022-11-03,18:00:00,14,10,4,FMN GV 05 Lier
60,Mechelsesteenweg 365,2022-11-03,19:00:00,6,4,2,FMN GV 05 Lier
60,Mechelsesteenweg 365,2022-11-03,20:00:00,0,0,0,FMN GV 05 Lier
60,Mechelsesteenweg 365,2022-11-03,21:00:00,0,0,0,FMN GV 05 Lier
60,Mechelsesteenweg 365,2022-11-03,22:00:00,2,0,2,FMN GV 05 Lier
60,Mechelsesteenweg 365,2022-11-03,23:00:00,0,0,0,FMN GV 05 Lier
60,Mechelsesteenweg 365,2022-11-04,00:00:00,0,0,0,FMN GV 05 Lier
60,Mechelsesteenweg 365,2022-11-04,01:00:00,0,0,0,FMN GV 05 Lier
60,Mechelsesteenweg 365,2022-11-04,02:00:00,0,0,0,FMN GV 05 Lier
60,Mechelsesteenweg 365,2022-11-04,03:00:00,2,0,2,FMN GV 05 Lier
60,Mechelsesteenweg 365,2022-11-04,04:00:00,2,0,2,FMN GV 05 Lier
60,Mechelsesteenweg 365,2022-11-04,05:00:00,10,4,6,FMN GV 05 Lier
60,Mechelsesteenweg 365,2022-11-04,06:00:00,14,4,10,FMN GV 05 Lier
60,Mechelsesteenweg 365,2022-11-04,07:00:00,18,8,10,FMN GV 05 Lier
60,Mechelsesteenweg 365,2022-11-04,08:00:00,18,12,6,FMN GV 05 Lier
60,Mechelsesteenweg 365,2022-11-04,09:00:00,22,4,18,FMN GV 05 Lier
60,Mechelsesteenweg 365,2022-11-04,10:00:00,18,10,8,FMN GV 05 Lier
60,Mechelsesteenweg 365,2022-11-04,11:00:00,44,12,32,FMN GV 05 Lier
60,Mechelsesteenweg 365,2022-11-04,12:00:00,40,24,16,FMN GV 05 Lier
60,Mechelsesteenweg 365,2022-11-04,13:00:00,56,24,32,FMN GV 05 Lier
60,Mechelsesteenweg 365,2022-11-04,14:00:00,72,42,30,FMN GV 05 Lier
60,Mechelsesteenweg 365,2022-11-04,15:00:00,44,28,16,FMN GV 05 Lier
60,Mechelsesteenweg 365,2022-11-04,16:00:00,64,34,30,FMN GV 05 Lier
60,Mechelsesteenweg 365,2022-11-04,17:00:00,34,18,16,FMN GV 05 Lier
60,Mechelsesteenweg 365,2022-11-04,18:00:00,12,8,4,FMN GV 05 Lier
60,Mechelsesteenweg 365,2022-11-04,19:00:00,4,4,0,FMN GV 05 Lier
60,Mechelsesteenweg 365,2022-11-04,20:00:00,4,0,4,FMN GV 05 Lier
60,Mechelsesteenweg 365,2022-11-04,21:00:00,0,0,0,FMN GV 05 Lier
60,Mechelsesteenweg 365,2022-11-04,22:00:00,2,2,0,FMN GV 05 Lier
60,Mechelsesteenweg 365,2022-11-04,23:00:00,2,2,0,FMN GV 05 Lier
60,Mechelsesteenweg 365,2022-11-05,00:00:00,0,0,0,FMN GV 05 Lier
60,Mechelsesteenweg 365,2022-11-05,01:00:00,10,0,10,FMN GV 05 Lier
60,Mechelsesteenweg 365,2022-11-05,02:00:00,0,0,0,FMN GV 05 Lier
60,Mechelsesteenweg 365,2022-11-05,03:00:00,0,0,0,FMN GV 05 Lier
60,Mechelsesteenweg 365,2022-11-05,04:00:00,0,0,0,FMN GV 05 Lier
60,Mechelsesteenweg 365,2022-11-05,05:00:00,0,0,0,FMN GV 05 Lier
60,Mechelsesteenweg 365,2022-11-05,06:00:00,2,2,0,FMN GV 05 Lier
60,Mechelsesteenweg 365,2022-11-05,07:00:00,8,4,4,FMN GV 05 Lier
60,Mechelsesteenweg 365,2022-11-05,08:00:00,36,14,22,FMN GV 05 Lier
60,Mechelsesteenweg 365,2022-11-05,09:00:00,60,30,30,FMN GV 05 Lier
60,Mechelsesteenweg 365,2022-11-05,10:00:00,186,66,120,FMN GV 05 Lier
60,Mechelsesteenweg 365,2022-11-05,11:00:00,174,94,80,FMN GV 05 Lier
60,Mechelsesteenweg 365,2022-11-05,12:00:00,140,80,60,FMN GV 05 Lier
60,Mechelsesteenweg 365,2022-11-05,13:00:00,172,106,66,FMN GV 05 Lier
60,Mechelsesteenweg 365,2022-11-05,14:00:00,158,80,78,FMN GV 05 Lier
60,Mechelsesteenweg 365,2022-11-05,15:00:00,150,60,90,FMN GV 05 Lier
60,Mechelsesteenweg 365,2022-11-05,16:00:00,112,62,50,FMN GV 05 Lier
60,Mechelsesteenweg 365,2022-11-05,17:00:00,24,12,12,FMN GV 05 Lier
60,Mechelsesteenweg 365,2022-11-05,18:00:00,8,4,4,FMN GV 05 Lier
60,Mechelsesteenweg 365,2022-11-05,19:00:00,4,4,0,FMN GV 05 Lier
60,Mechelsesteenweg 365,2022-11-05,20:00:00,6,2,4,FMN GV 05 Lier
60,Mechelsesteenweg 365,2022-11-05,21:00:00,2,2,0,FMN GV 05 Lier
60,Mechelsesteenweg 365,2022-11-05,22:00:00,0,0,0,FMN GV 05 Lier
60,Mechelsesteenweg 365,2022-11-05,23:00:00,2,2,0,FMN GV 05 Lier
60,Mechelsesteenweg 365,2022-11-06,00:00:00,0,0,0,FMN GV 05 Lier
60,Mechelsesteenweg 365,2022-11-06,01:00:00,2,2,0,FMN GV 05 Lier
60,Mechelsesteenweg 365,2022-11-06,02:00:00,0,0,0,FMN GV 05 Lier
60,Mechelsesteenweg 365,2022-11-06,03:00:00,4,0,4,FMN GV 05 Lier
60,Mechelsesteenweg 365,2022-11-06,04:00:00,0,0,0,FMN GV 05 Lier
60,Mechelsesteenweg 365,2022-11-06,05:00:00,0,0,0,FMN GV 05 Lier
60,Mechelsesteenweg 365,2022-11-06,06:00:00,0,0,0,FMN GV 05 Lier
60,Mechelsesteenweg 365,2022-11-06,07:00:00,2,2,0,FMN GV 05 Lier
60,Mechelsesteenweg 365,2022-11-06,08:00:00,32,16,16,FMN GV 05 Lier
60,Mechelsesteenweg 365,2022-11-06,09:00:00,78,24,54,FMN GV 05 Lier
60,Mechelsesteenweg 365,2022-11-06,10:00:00,144,76,68,FMN GV 05 Lier
60,Mechelsesteenweg 365,2022-11-06,11:00:00,148,86,62,FMN GV 05 Lier
60,Mechelsesteenweg 365,2022-11-06,12:00:00,50,22,28,FMN GV 05 Lier
60,Mechelsesteenweg 365,2022-11-06,13:00:00,30,14,16,FMN GV 05 Lier
60,Mechelsesteenweg 365,2022-11-06,14:00:00,10,8,2,FMN GV 05 Lier
60,Mechelsesteenweg 365,2022-11-06,15:00:00,12,8,4,FMN GV 05 Lier
60,Mechelsesteenweg 365,2022-11-06,16:00:00,6,6,0,FMN GV 05 Lier
60,Mechelsesteenweg 365,2022-11-06,17:00:00,6,2,4,FMN GV 05 Lier
60,Mechelsesteenweg 365,2022-11-06,18:00:00,4,2,2,FMN GV 05 Lier
60,Mechelsesteenweg 365,2022-11-06,19:00:00,4,2,2,FMN GV 05 Lier
60,Mechelsesteenweg 365,2022-11-06,20:00:00,0,0,0,FMN GV 05 Lier
60,Mechelsesteenweg 365,2022-11-06,21:00:00,0,0,0,FMN GV 05 Lier
60,Mechelsesteenweg 365,2022-11-06,22:00:00,0,0,0,FMN GV 05 Lier
60,Mechelsesteenweg 365,2022-11-06,23:00:00,0,0,0,FMN GV 05 Lier
60,Mechelsesteenweg 365,2022-11-07,00:00:00,0,0,0,FMN GV 05 Lier
60,Mechelsesteenweg 365,2022-11-07,01:00:00,0,0,0,FMN GV 05 Lier
60,Mechelsesteenweg 365,2022-11-07,02:00:00,0,0,0,FMN GV 05 Lier
60,Mechelsesteenweg 365,2022-11-07,03:00:00,2,0,2,FMN GV 05 Lier
60,Mechelsesteenweg 365,2022-11-07,04:00:00,2,0,2,FMN GV 05 Lier
60,Mechelsesteenweg 365,2022-11-07,05:00:00,0,0,0,FMN GV 05 Lier
60,Mechelsesteenweg 365,2022-11-07,06:00:00,18,4,14,FMN GV 05 Lier
60,Mechelsesteenweg 365,2022-11-07,07:00:00,64,26,38,FMN GV 05 Lier
60,Mechelsesteenweg 365,2022-11-07,08:00:00,118,72,46,FMN GV 05 Lier
60,Mechelsesteenweg 365,2022-11-07,09:00:00,40,16,24,FMN GV 05 Lier
60,Mechelsesteenweg 365,2022-11-07,10:00:00,14,10,4,FMN GV 05 Lier
60,Mechelsesteenweg 365,2022-11-07,11:00:00,64,24,40,FMN GV 05 Lier
60,Mechelsesteenweg 365,2022-11-07,12:00:00,46,30,16,FMN GV 05 Lier
60,Mechelsesteenweg 365,2022-11-07,13:00:00,40,20,20,FMN GV 05 Lier
60,Mechelsesteenweg 365,2022-11-07,14:00:00,60,38,22,FMN GV 05 Lier
60,Mechelsesteenweg 365,2022-11-07,15:00:00,54,26,28,FMN GV 05 Lier
60,Mechelsesteenweg 365,2022-11-07,16:00:00,158,52,106,FMN GV 05 Lier
60,Mechelsesteenweg 365,2022-11-07,17:00:00,74,46,28,FMN GV 05 Lier
60,Mechelsesteenweg 365,2022-11-07,18:00:00,16,12,4,FMN GV 05 Lier
60,Mechelsesteenweg 365,2022-11-07,19:00:00,2,2,0,FMN GV 05 Lier
60,Mechelsesteenweg 365,2022-11-07,20:00:00,4,2,2,FMN GV 05 Lier
60,Mechelsesteenweg 365,2022-11-07,21:00:00,4,0,4,FMN GV 05 Lier
60,Mechelsesteenweg 365,2022-11-07,22:00:00,4,4,0,FMN GV 05 Lier
60,Mechelsesteenweg 365,2022-11-07,23:00:00,0,0,0,FMN GV 05 Lier
60,Mechelsesteenweg 365,2022-11-08,00:00:00,2,2,0,FMN GV 05 Lier
60,Mechelsesteenweg 365,2022-11-08,01:00:00,0,0,0,FMN GV 05 Lier
60,Mechelsesteenweg 365,2022-11-08,02:00:00,0,0,0,FMN GV 05 Lier
60,Mechelsesteenweg 365,2022-11-08,03:00:00,2,0,2,FMN GV 05 Lier
60,Mechelsesteenweg 365,2022-11-08,04:00:00,4,0,4,FMN GV 05 Lier
60,Mechelsesteenweg 365,2022-11-08,05:00:00,2,0,2,FMN GV 05 Lier
60,Mechelsesteenweg 365,2022-11-08,06:00:00,22,0,22,FMN GV 05 Lier
60,Mechelsesteenweg 365,2022-11-08,07:00:00,100,36,64,FMN GV 05 Lier
60,Mechelsesteenweg 365,2022-11-08,08:00:00,166,88,78,FMN GV 05 Lier
60,Mechelsesteenweg 365,2022-11-08,09:00:00,38,8,30,FMN GV 05 Lier
60,Mechelsesteenweg 365,2022-11-08,10:00:00,68,40,28,FMN GV 05 Lier
60,Mechelsesteenweg 365,2022-11-08,11:00:00,64,22,42,FMN GV 05 Lier
60,Mechelsesteenweg 365,2022-11-08,12:00:00,90,50,40,FMN GV 05 Lier
60,Mechelsesteenweg 365,2022-11-08,13:00:00,102,50,52,FMN GV 05 Lier
60,Mechelsesteenweg 365,2022-11-08,14:00:00,80,52,28,FMN GV 05 Lier
60,Mechelsesteenweg 365,2022-11-08,15:00:00,128,64,64,FMN GV 05 Lier
60,Mechelsesteenweg 365,2022-11-08,16:00:00,240,96,144,FMN GV 05 Lier
60,Mechelsesteenweg 365,2022-11-08,17:00:00,124,86,38,FMN GV 05 Lier
60,Mechelsesteenweg 365,2022-11-08,18:00:00,32,22,10,FMN GV 05 Lier
60,Mechelsesteenweg 365,2022-11-08,19:00:00,16,12,4,FMN GV 05 Lier
60,Mechelsesteenweg 365,2022-11-08,20:00:00,2,0,2,FMN GV 05 Lier
60,Mechelsesteenweg 365,2022-11-08,21:00:00,10,2,8,FMN GV 05 Lier
60,Mechelsesteenweg 365,2022-11-08,22:00:00,6,4,2,FMN GV 05 Lier
60,Mechelsesteenweg 365,2022-11-08,23:00:00,2,2,0,FMN GV 05 Lier
60,Mechelsesteenweg 365,2022-11-09,00:00:00,4,2,2,FMN GV 05 Lier
60,Mechelsesteenweg 365,2022-11-09,01:00:00,0,0,0,FMN GV 05 Lier
60,Mechelsesteenweg 365,2022-11-09,02:00:00,0,0,0,FMN GV 05 Lier
60,Mechelsesteenweg 365,2022-11-09,03:00:00,0,0,0,FMN GV 05 Lier
60,Mechelsesteenweg 365,2022-11-09,04:00:00,4,0,4,FMN GV 05 Lier
60,Mechelsesteenweg 365,2022-11-09,05:00:00,0,0,0,FMN GV 05 Lier
60,Mechelsesteenweg 365,2022-11-09,06:00:00,26,4,22,FMN GV 05 Lier
60,Mechelsesteenweg 365,2022-11-09,07:00:00,104,48,56,FMN GV 05 Lier
60,Mechelsesteenweg 365,2022-11-09,08:00:00,128,68,60,FMN GV 05 Lier
60,Mechelsesteenweg 365,2022-11-09,09:00:00,58,16,42,FMN GV 05 Lier
60,Mechelsesteenweg 365,2022-11-09,10:00:00,62,40,22,FMN GV 05 Lier
60,Mechelsesteenweg 365,2022-11-09,11:00:00,66,38,28,FMN GV 05 Lier
60,Mechelsesteenweg 365,2022-11-09,12:00:00,138,34,104,FMN GV 05 Lier
60,Mechelsesteenweg 365,2022-11-09,13:00:00,52,20,32,FMN GV 05 Lier
60,Mechelsesteenweg 365,2022-11-09,14:00:00,64,42,22,FMN GV 05 Lier
60,Mechelsesteenweg 365,2022-11-09,15:00:00,142,104,38,FMN GV 05 Lier
60,Mechelsesteenweg 365,2022-11-09,16:00:00,102,54,48,FMN GV 05 Lier
60,Mechelsesteenweg 365,2022-11-09,17:00:00,84,64,20,FMN GV 05 Lier
60,Mechelsesteenweg 365,2022-11-09,18:00:00,38,30,8,FMN GV 05 Lier
60,Mechelsesteenweg 365,2022-11-09,19:00:00,20,18,2,FMN GV 05 Lier
60,Mechelsesteenweg 365,2022-11-09,20:00:00,22,8,14,FMN GV 05 Lier
60,Mechelsesteenweg 365,2022-11-09,21:00:00,4,0,4,FMN GV 05 Lier
60,Mechelsesteenweg 365,2022-11-09,22:00:00,4,0,4,FMN GV 05 Lier
60,Mechelsesteenweg 365,2022-11-09,23:00:00,4,2,2,FMN GV 05 Lier
60,Mechelsesteenweg 365,2022-11-10,00:00:00,0,0,0,FMN GV 05 Lier
60,Mechelsesteenweg 365,2022-11-10,01:00:00,0,0,0,FMN GV 05 Lier
60,Mechelsesteenweg 365,2022-11-10,02:00:00,0,0,0,FMN GV 05 Lier
60,Mechelsesteenweg 365,2022-11-10,03:00:00,0,0,0,FMN GV 05 Lier
60,Mechelsesteenweg 365,2022-11-10,04:00:00,2,0,2,FMN GV 05 Lier
60,Mechelsesteenweg 365,2022-11-10,05:00:00,4,0,4,FMN GV 05 Lier
60,Mechelsesteenweg 365,2022-11-10,06:00:00,22,6,16,FMN GV 05 Lier
60,Mechelsesteenweg 365,2022-11-10,07:00:00,88,40,48,FMN GV 05 Lier
60,Mechelsesteenweg 365,2022-11-10,08:00:00,130,70,60,FMN GV 05 Lier
60,Mechelsesteenweg 365,2022-11-10,09:00:00,76,36,40,FMN GV 05 Lier
60,Mechelsesteenweg 365,2022-11-10,10:00:00,54,26,28,FMN GV 05 Lier
60,Mechelsesteenweg 365,2022-11-10,11:00:00,74,30,44,FMN GV 05 Lier
60,Mechelsesteenweg 365,2022-11-10,12:00:00,70,32,38,FMN GV 05 Lier
60,Mechelsesteenweg 365,2022-11-10,13:00:00,172,106,66,FMN GV 05 Lier
60,Mechelsesteenweg 365,2022-11-10,14:00:00,200,122,78,FMN GV 05 Lier
60,Mechelsesteenweg 365,2022-11-10,15:00:00,166,78,88,FMN GV 05 Lier
60,Mechelsesteenweg 365,2022-11-10,16:00:00,220,76,144,FMN GV 05 Lier
60,Mechelsesteenweg 365,2022-11-10,17:00:00,98,64,34,FMN GV 05 Lier
60,Mechelsesteenweg 365,2022-11-10,18:00:00,20,12,8,FMN GV 05 Lier
60,Mechelsesteenweg 365,2022-11-10,19:00:00,18,10,8,FMN GV 05 Lier
60,Mechelsesteenweg 365,2022-11-10,20:00:00,12,4,8,FMN GV 05 Lier
60,Mechelsesteenweg 365,2022-11-10,21:00:00,4,0,4,FMN GV 05 Lier
60,Mechelsesteenweg 365,2022-11-10,22:00:00,10,2,8,FMN GV 05 Lier
60,Mechelsesteenweg 365,2022-11-10,23:00:00,6,4,2,FMN GV 05 Lier
60,Mechelsesteenweg 365,2022-11-11,00:00:00,2,0,2,FMN GV 05 Lier
60,Mechelsesteenweg 365,2022-11-11,01:00:00,4,4,0,FMN GV 05 Lier
60,Mechelsesteenweg 365,2022-11-11,02:00:00,2,2,0,FMN GV 05 Lier
60,Mechelsesteenweg 365,2022-11-11,03:00:00,2,0,2,FMN GV 05 Lier
60,Mechelsesteenweg 365,2022-11-11,04:00:00,2,0,2,FMN GV 05 Lier
60,Mechelsesteenweg 365,2022-11-11,05:00:00,2,0,2,FMN GV 05 Lier
60,Mechelsesteenweg 365,2022-11-11,06:00:00,4,2,2,FMN GV 05 Lier
60,Mechelsesteenweg 365,2022-11-11,07:00:00,4,2,2,FMN GV 05 Lier
60,Mechelsesteenweg 365,2022-11-11,08:00:00,22,12,10,FMN GV 05 Lier
60,Mechelsesteenweg 365,2022-11-11,09:00:00,66,28,38,FMN GV 05 Lier
60,Mechelsesteenweg 365,2022-11-11,10:00:00,116,56,60,FMN GV 05 Lier
60,Mechelsesteenweg 365,2022-11-11,11:00:00,204,112,92,FMN GV 05 Lier
60,Mechelsesteenweg 365,2022-11-11,12:00:00,182,106,76,FMN GV 05 Lier
60,Mechelsesteenweg 365,2022-11-11,13:00:00,214,106,108,FMN GV 05 Lier
60,Mechelsesteenweg 365,2022-11-11,14:00:00,284,148,136,FMN GV 05 Lier
60,Mechelsesteenweg 365,2022-11-11,15:00:00,216,124,92,FMN GV 05 Lier
60,Mechelsesteenweg 365,2022-11-11,16:00:00,148,48,100,FMN GV 05 Lier
60,Mechelsesteenweg 365,2022-11-11,17:00:00,42,10,32,FMN GV 05 Lier
60,Mechelsesteenweg 365,2022-11-11,18:00:00,0,0,0,FMN GV 05 Lier
60,Mechelsesteenweg 365,2022-11-11,19:00:00,10,10,0,FMN GV 05 Lier
60,Mechelsesteenweg 365,2022-11-11,20:00:00,18,8,10,FMN GV 05 Lier
60,Mechelsesteenweg 365,2022-11-11,21:00:00,4,4,0,FMN GV 05 Lier
60,Mechelsesteenweg 365,2022-11-11,22:00:00,0,0,0,FMN GV 05 Lier
60,Mechelsesteenweg 365,2022-11-11,23:00:00,4,2,2,FMN GV 05 Lier
60,Mechelsesteenweg 365,2022-11-12,00:00:00,0,0,0,FMN GV 05 Lier
60,Mechelsesteenweg 365,2022-11-12,01:00:00,0,0,0,FMN GV 05 Lier
60,Mechelsesteenweg 365,2022-11-12,02:00:00,0,0,0,FMN GV 05 Lier
60,Mechelsesteenweg 365,2022-11-12,03:00:00,0,0,0,FMN GV 05 Lier
60,Mechelsesteenweg 365,2022-11-12,04:00:00,0,0,0,FMN GV 05 Lier
60,Mechelsesteenweg 365,2022-11-12,05:00:00,2,0,2,FMN GV 05 Lier
60,Mechelsesteenweg 365,2022-11-12,06:00:00,0,0,0,FMN GV 05 Lier
60,Mechelsesteenweg 365,2022-11-12,07:00:00,10,6,4,FMN GV 05 Lier
60,Mechelsesteenweg 365,2022-11-12,08:00:00,16,8,8,FMN GV 05 Lier
60,Mechelsesteenweg 365,2022-11-12,09:00:00,68,34,34,FMN GV 05 Lier
60,Mechelsesteenweg 365,2022-11-12,10:00:00,158,100,58,FMN GV 05 Lier
60,Mechelsesteenweg 365,2022-11-12,11:00:00,226,114,112,FMN GV 05 Lier
60,Mechelsesteenweg 365,2022-11-12,12:00:00,206,124,82,FMN GV 05 Lier
60,Mechelsesteenweg 365,2022-11-12,13:00:00,296,166,130,FMN GV 05 Lier
60,Mechelsesteenweg 365,2022-11-12,14:00:00,406,176,230,FMN GV 05 Lier
60,Mechelsesteenweg 365,2022-11-12,15:00:00,388,196,192,FMN GV 05 Lier
60,Mechelsesteenweg 365,2022-11-12,16:00:00,166,80,86,FMN GV 05 Lier
60,Mechelsesteenweg 365,2022-11-12,17:00:00,40,14,26,FMN GV 05 Lier
60,Mechelsesteenweg 365,2022-11-12,18:00:00,16,6,10,FMN GV 05 Lier
60,Mechelsesteenweg 365,2022-11-12,19:00:00,8,4,4,FMN GV 05 Lier
60,Mechelsesteenweg 365,2022-11-12,20:00:00,4,0,4,FMN GV 05 Lier
60,Mechelsesteenweg 365,2022-11-12,21:00:00,4,4,0,FMN GV 05 Lier
60,Mechelsesteenweg 365,2022-11-12,22:00:00,0,0,0,FMN GV 05 Lier
60,Mechelsesteenweg 365,2022-11-12,23:00:00,4,4,0,FMN GV 05 Lier
60,Mechelsesteenweg 365,2022-11-13,00:00:00,0,0,0,FMN GV 05 Lier
60,Mechelsesteenweg 365,2022-11-13,01:00:00,0,0,0,FMN GV 05 Lier
60,Mechelsesteenweg 365,2022-11-13,02:00:00,0,0,0,FMN GV 05 Lier
60,Mechelsesteenweg 365,2022-11-13,03:00:00,0,0,0,FMN GV 05 Lier
60,Mechelsesteenweg 365,2022-11-13,04:00:00,2,0,2,FMN GV 05 Lier
60,Mechelsesteenweg 365,2022-11-13,05:00:00,0,0,0,FMN GV 05 Lier
60,Mechelsesteenweg 365,2022-11-13,06:00:00,2,2,0,FMN GV 05 Lier
60,Mechelsesteenweg 365,2022-11-13,07:00:00,4,4,0,FMN GV 05 Lier
60,Mechelsesteenweg 365,2022-11-13,08:00:00,22,10,12,FMN GV 05 Lier
60,Mechelsesteenweg 365,2022-11-13,09:00:00,68,30,38,FMN GV 05 Lier
60,Mechelsesteenweg 365,2022-11-13,10:00:00,202,116,86,FMN GV 05 Lier
60,Mechelsesteenweg 365,2022-11-13,11:00:00,290,144,146,FMN GV 05 Lier
60,Mechelsesteenweg 365,2022-11-13,12:00:00,250,124,126,FMN GV 05 Lier
60,Mechelsesteenweg 365,2022-11-13,13:00:00,300,122,178,FMN GV 05 Lier
60,Mechelsesteenweg 365,2022-11-13,14:00:00,374,210,164,FMN GV 05 Lier
60,Mechelsesteenweg 365,2022-11-13,15:00:00,338,140,198,FMN GV 05 Lier
60,Mechelsesteenweg 365,2022-11-13,16:00:00,152,34,118,FMN GV 05 Lier
60,Mechelsesteenweg 365,2022-11-13,17:00:00,52,26,26,FMN GV 05 Lier
60,Mechelsesteenweg 365,2022-11-13,18:00:00,10,4,6,FMN GV 05 Lier
60,Mechelsesteenweg 365,2022-11-13,19:00:00,12,0,12,FMN GV 05 Lier
60,Mechelsesteenweg 365,2022-11-13,20:00:00,4,2,2,FMN GV 05 Lier
60,Mechelsesteenweg 365,2022-11-13,21:00:00,4,2,2,FMN GV 05 Lier
60,Mechelsesteenweg 365,2022-11-13,22:00:00,0,0,0,FMN GV 05 Lier
60,Mechelsesteenweg 365,2022-11-13,23:00:00,0,0,0,FMN GV 05 Lier
60,Mechelsesteenweg 365,2022-11-14,00:00:00,0,0,0,FMN GV 05 Lier
60,Mechelsesteenweg 365,2022-11-14,01:00:00,0,0,0,FMN GV 05 Lier
60,Mechelsesteenweg 365,2022-11-14,02:00:00,0,0,0,FMN GV 05 Lier
60,Mechelsesteenweg 365,2022-11-14,03:00:00,0,0,0,FMN GV 05 Lier
60,Mechelsesteenweg 365,2022-11-14,04:00:00,2,0,2,FMN GV 05 Lier
60,Mechelsesteenweg 365,2022-11-14,05:00:00,2,0,2,FMN GV 05 Lier
60,Mechelsesteenweg 365,2022-11-14,06:00:00,24,10,14,FMN GV 05 Lier
60,Mechelsesteenweg 365,2022-11-14,07:00:00,66,30,36,FMN GV 05 Lier
60,Mechelsesteenweg 365,2022-11-14,08:00:00,134,76,58,FMN GV 05 Lier
60,Mechelsesteenweg 365,2022-11-14,09:00:00,36,16,20,FMN GV 05 Lier
60,Mechelsesteenweg 365,2022-11-14,10:00:00,38,18,20,FMN GV 05 Lier
60,Mechelsesteenweg 365,2022-11-14,11:00:00,54,28,26,FMN GV 05 Lier
60,Mechelsesteenweg 365,2022-11-14,12:00:00,70,32,38,FMN GV 05 Lier
60,Mechelsesteenweg 365,2022-11-14,13:00:00,108,54,54,FMN GV 05 Lier
60,Mechelsesteenweg 365,2022-11-14,14:00:00,162,96,66,FMN GV 05 Lier
60,Mechelsesteenweg 365,2022-11-14,15:00:00,140,58,82,FMN GV 05 Lier
60,Mechelsesteenweg 365,2022-11-14,16:00:00,200,70,130,FMN GV 05 Lier
60,Mechelsesteenweg 365,2022-11-14,17:00:00,72,46,26,FMN GV 05 Lier
60,Mechelsesteenweg 365,2022-11-14,18:00:00,26,18,8,FMN GV 05 Lier
60,Mechelsesteenweg 365,2022-11-14,19:00:00,10,4,6,FMN GV 05 Lier
60,Mechelsesteenweg 365,2022-11-14,20:00:00,6,4,2,FMN GV 05 Lier
60,Mechelsesteenweg 365,2022-11-14,21:00:00,6,0,6,FMN GV 05 Lier
60,Mechelsesteenweg 365,2022-11-14,22:00:00,4,2,2,FMN GV 05 Lier
60,Mechelsesteenweg 365,2022-11-14,23:00:00,0,0,0,FMN GV 05 Lier
60,Mechelsesteenweg 365,2022-11-15,00:00:00,0,0,0,FMN GV 05 Lier
60,Mechelsesteenweg 365,2022-11-15,01:00:00,0,0,0,FMN GV 05 Lier
60,Mechelsesteenweg 365,2022-11-15,02:00:00,0,0,0,FMN GV 05 Lier
60,Mechelsesteenweg 365,2022-11-15,03:00:00,2,0,2,FMN GV 05 Lier
60,Mechelsesteenweg 365,2022-11-15,04:00:00,2,2,0,FMN GV 05 Lier
60,Mechelsesteenweg 365,2022-11-15,05:00:00,0,0,0,FMN GV 05 Lier
60,Mechelsesteenweg 365,2022-11-15,06:00:00,18,6,12,FMN GV 05 Lier
60,Mechelsesteenweg 365,2022-11-15,07:00:00,110,56,54,FMN GV 05 Lier
60,Mechelsesteenweg 365,2022-11-15,08:00:00,112,66,46,FMN GV 05 Lier
60,Mechelsesteenweg 365,2022-11-15,09:00:00,62,32,30,FMN GV 05 Lier
60,Mechelsesteenweg 365,2022-11-15,10:00:00,84,44,40,FMN GV 05 Lier
60,Mechelsesteenweg 365,2022-11-15,11:00:00,70,42,28,FMN GV 05 Lier
60,Mechelsesteenweg 365,2022-11-15,12:00:00,100,52,48,FMN GV 05 Lier
60,Mechelsesteenweg 365,2022-11-15,13:00:00,86,38,48,FMN GV 05 Lier
60,Mechelsesteenweg 365,2022-11-15,14:00:00,62,34,28,FMN GV 05 Lier
60,Mechelsesteenweg 365,2022-11-15,15:00:00,68,34,34,FMN GV 05 Lier
60,Mechelsesteenweg 365,2022-11-15,16:00:00,122,42,80,FMN GV 05 Lier
60,Mechelsesteenweg 365,2022-11-15,17:00:00,52,42,10,FMN GV 05 Lier
60,Mechelsesteenweg 365,2022-11-15,18:00:00,14,14,0,FMN GV 05 Lier
60,Mechelsesteenweg 365,2022-11-15,19:00:00,10,4,6,FMN GV 05 Lier
60,Mechelsesteenweg 365,2022-11-15,20:00:00,2,0,2,FMN GV 05 Lier
60,Mechelsesteenweg 365,2022-11-15,21:00:00,6,0,6,FMN GV 05 Lier
60,Mechelsesteenweg 365,2022-11-15,22:00:00,6,4,2,FMN GV 05 Lier
60,Mechelsesteenweg 365,2022-11-15,23:00:00,0,0,0,FMN GV 05 Lier
60,Mechelsesteenweg 365,2022-11-16,00:00:00,0,0,0,FMN GV 05 Lier
60,Mechelsesteenweg 365,2022-11-16,01:00:00,0,0,0,FMN GV 05 Lier
60,Mechelsesteenweg 365,2022-11-16,02:00:00,0,0,0,FMN GV 05 Lier
60,Mechelsesteenweg 365,2022-11-16,03:00:00,0,0,0,FMN GV 05 Lier
60,Mechelsesteenweg 365,2022-11-16,04:00:00,0,0,0,FMN GV 05 Lier
60,Mechelsesteenweg 365,2022-11-16,05:00:00,0,0,0,FMN GV 05 Lier
60,Mechelsesteenweg 365,2022-11-16,06:00:00,12,4,8,FMN GV 05 Lier
60,Mechelsesteenweg 365,2022-11-16,07:00:00,94,42,52,FMN GV 05 Lier
60,Mechelsesteenweg 365,2022-11-16,08:00:00,104,58,46,FMN GV 05 Lier
60,Mechelsesteenweg 365,2022-11-16,09:00:00,40,16,24,FMN GV 05 Lier
60,Mechelsesteenweg 365,2022-11-16,10:00:00,60,32,28,FMN GV 05 Lier
60,Mechelsesteenweg 365,2022-11-16,11:00:00,42,26,16,FMN GV 05 Lier
60,Mechelsesteenweg 365,2022-11-16,12:00:00,132,44,88,FMN GV 05 Lier
60,Mechelsesteenweg 365,2022-11-16,13:00:00,76,30,46,FMN GV 05 Lier
60,Mechelsesteenweg 365,2022-11-16,14:00:00,60,22,38,FMN GV 05 Lier
60,Mechelsesteenweg 365,2022-11-16,15:00:00,74,30,44,FMN GV 05 Lier
60,Mechelsesteenweg 365,2022-11-16,16:00:00,66,36,30,FMN GV 05 Lier
60,Mechelsesteenweg 365,2022-11-16,17:00:00,58,46,12,FMN GV 05 Lier
60,Mechelsesteenweg 365,2022-11-16,18:00:00,32,14,18,FMN GV 05 Lier
60,Mechelsesteenweg 365,2022-11-16,19:00:00,6,4,2,FMN GV 05 Lier
60,Mechelsesteenweg 365,2022-11-16,20:00:00,6,4,2,FMN GV 05 Lier
60,Mechelsesteenweg 365,2022-11-16,21:00:00,4,2,2,FMN GV 05 Lier
60,Mechelsesteenweg 365,2022-11-16,22:00:00,4,4,0,FMN GV 05 Lier
60,Mechelsesteenweg 365,2022-11-16,23:00:00,0,0,0,FMN GV 05 Lier
60,Mechelsesteenweg 365,2022-11-17,00:00:00,0,0,0,FMN GV 05 Lier
60,Mechelsesteenweg 365,2022-11-17,01:00:00,2,0,2,FMN GV 05 Lier
60,Mechelsesteenweg 365,2022-11-17,02:00:00,0,0,0,FMN GV 05 Lier
60,Mechelsesteenweg 365,2022-11-17,03:00:00,0,0,0,FMN GV 05 Lier
60,Mechelsesteenweg 365,2022-11-17,04:00:00,2,0,2,FMN GV 05 Lier
60,Mechelsesteenweg 365,2022-11-17,05:00:00,0,0,0,FMN GV 05 Lier
60,Mechelsesteenweg 365,2022-11-17,06:00:00,8,2,6,FMN GV 05 Lier
60,Mechelsesteenweg 365,2022-11-17,07:00:00,46,28,18,FMN GV 05 Lier
60,Mechelsesteenweg 365,2022-11-17,08:00:00,64,36,28,FMN GV 05 Lier
60,Mechelsesteenweg 365,2022-11-17,09:00:00,16,6,10,FMN GV 05 Lier
60,Mechelsesteenweg 365,2022-11-17,10:00:00,12,8,4,FMN GV 05 Lier
60,Mechelsesteenweg 365,2022-11-17,11:00:00,4,2,2,FMN GV 05 Lier
60,Mechelsesteenweg 365,2022-11-17,12:00:00,16,4,12,FMN GV 05 Lier
60,Mechelsesteenweg 365,2022-11-17,13:00:00,18,12,6,FMN GV 05 Lier
60,Mechelsesteenweg 365,2022-11-17,14:00:00,26,16,10,FMN GV 05 Lier
60,Mechelsesteenweg 365,2022-11-17,15:00:00,64,30,34,FMN GV 05 Lier
60,Mechelsesteenweg 365,2022-11-17,16:00:00,104,44,60,FMN GV 05 Lier
60,Mechelsesteenweg 365,2022-11-17,17:00:00,58,32,26,FMN GV 05 Lier
60,Mechelsesteenweg 365,2022-11-17,18:00:00,6,2,4,FMN GV 05 Lier
60,Mechelsesteenweg 365,2022-11-17,19:00:00,16,6,10,FMN GV 05 Lier
60,Mechelsesteenweg 365,2022-11-17,20:00:00,10,4,6,FMN GV 05 Lier
60,Mechelsesteenweg 365,2022-11-17,21:00:00,4,0,4,FMN GV 05 Lier
60,Mechelsesteenweg 365,2022-11-17,22:00:00,4,2,2,FMN GV 05 Lier
60,Mechelsesteenweg 365,2022-11-17,23:00:00,2,2,0,FMN GV 05 Lier
60,Mechelsesteenweg 365,2022-11-18,00:00:00,0,0,0,FMN GV 05 Lier
60,Mechelsesteenweg 365,2022-11-18,01:00:00,0,0,0,FMN GV 05 Lier
60,Mechelsesteenweg 365,2022-11-18,02:00:00,0,0,0,FMN GV 05 Lier
60,Mechelsesteenweg 365,2022-11-18,03:00:00,2,0,2,FMN GV 05 Lier
60,Mechelsesteenweg 365,2022-11-18,04:00:00,0,0,0,FMN GV 05 Lier
60,Mechelsesteenweg 365,2022-11-18,05:00:00,2,2,0,FMN GV 05 Lier
60,Mechelsesteenweg 365,2022-11-18,06:00:00,20,8,12,FMN GV 05 Lier
60,Mechelsesteenweg 365,2022-11-18,07:00:00,72,34,38,FMN GV 05 Lier
60,Mechelsesteenweg 365,2022-11-18,08:00:00,90,56,34,FMN GV 05 Lier
60,Mechelsesteenweg 365,2022-11-18,09:00:00,44,14,30,FMN GV 05 Lier
60,Mechelsesteenweg 365,2022-11-18,10:00:00,60,22,38,FMN GV 05 Lier
60,Mechelsesteenweg 365,2022-11-18,11:00:00,42,18,24,FMN GV 05 Lier
60,Mechelsesteenweg 365,2022-11-18,12:00:00,66,28,38,FMN GV 05 Lier
60,Mechelsesteenweg 365,2022-11-18,13:00:00,22,8,14,FMN GV 05 Lier
60,Mechelsesteenweg 365,2022-11-18,14:00:00,50,38,12,FMN GV 05 Lier
60,Mechelsesteenweg 365,2022-11-18,15:00:00,30,14,16,FMN GV 05 Lier
60,Mechelsesteenweg 365,2022-11-18,16:00:00,94,30,64,FMN GV 05 Lier
60,Mechelsesteenweg 365,2022-11-18,17:00:00,46,34,12,FMN GV 05 Lier
60,Mechelsesteenweg 365,2022-11-18,18:00:00,12,6,6,FMN GV 05 Lier
60,Mechelsesteenweg 365,2022-11-18,19:00:00,6,4,2,FMN GV 05 Lier
60,Mechelsesteenweg 365,2022-11-18,20:00:00,2,0,2,FMN GV 05 Lier
60,Mechelsesteenweg 365,2022-11-18,21:00:00,6,2,4,FMN GV 05 Lier
60,Mechelsesteenweg 365,2022-11-18,22:00:00,0,0,0,FMN GV 05 Lier
60,Mechelsesteenweg 365,2022-11-18,23:00:00,6,4,2,FMN GV 05 Lier
60,Mechelsesteenweg 365,2022-11-19,00:00:00,0,0,0,FMN GV 05 Lier
60,Mechelsesteenweg 365,2022-11-19,01:00:00,0,0,0,FMN GV 05 Lier
60,Mechelsesteenweg 365,2022-11-19,02:00:00,0,0,0,FMN GV 05 Lier
60,Mechelsesteenweg 365,2022-11-19,03:00:00,0,0,0,FMN GV 05 Lier
60,Mechelsesteenweg 365,2022-11-19,04:00:00,0,0,0,FMN GV 05 Lier
60,Mechelsesteenweg 365,2022-11-19,05:00:00,0,0,0,FMN GV 05 Lier
60,Mechelsesteenweg 365,2022-11-19,06:00:00,2,0,2,FMN GV 05 Lier
60,Mechelsesteenweg 365,2022-11-19,07:00:00,0,0,0,FMN GV 05 Lier
60,Mechelsesteenweg 365,2022-11-19,08:00:00,2,0,2,FMN GV 05 Lier
60,Mechelsesteenweg 365,2022-11-19,09:00:00,12,4,8,FMN GV 05 Lier
60,Mechelsesteenweg 365,2022-11-19,10:00:00,26,10,16,FMN GV 05 Lier
60,Mechelsesteenweg 365,2022-11-19,11:00:00,38,6,32,FMN GV 05 Lier
60,Mechelsesteenweg 365,2022-11-19,12:00:00,34,18,16,FMN GV 05 Lier
60,Mechelsesteenweg 365,2022-11-19,13:00:00,38,18,20,FMN GV 05 Lier
60,Mechelsesteenweg 365,2022-11-19,14:00:00,74,34,40,FMN GV 05 Lier
60,Mechelsesteenweg 365,2022-11-19,15:00:00,34,20,14,FMN GV 05 Lier
60,Mechelsesteenweg 365,2022-11-19,16:00:00,16,6,10,FMN GV 05 Lier
60,Mechelsesteenweg 365,2022-11-19,17:00:00,8,0,8,FMN GV 05 Lier
60,Mechelsesteenweg 365,2022-11-19,18:00:00,4,0,4,FMN GV 05 Lier
60,Mechelsesteenweg 365,2022-11-19,19:00:00,2,0,2,FMN GV 05 Lier
60,Mechelsesteenweg 365,2022-11-19,20:00:00,4,4,0,FMN GV 05 Lier
60,Mechelsesteenweg 365,2022-11-19,21:00:00,2,0,2,FMN GV 05 Lier
60,Mechelsesteenweg 365,2022-11-19,22:00:00,2,2,0,FMN GV 05 Lier
60,Mechelsesteenweg 365,2022-11-19,23:00:00,6,6,0,FMN GV 05 Lier
60,Mechelsesteenweg 365,2022-11-20,00:00:00,0,0,0,FMN GV 05 Lier
60,Mechelsesteenweg 365,2022-11-20,01:00:00,0,0,0,FMN GV 05 Lier
60,Mechelsesteenweg 365,2022-11-20,02:00:00,0,0,0,FMN GV 05 Lier
60,Mechelsesteenweg 365,2022-11-20,03:00:00,0,0,0,FMN GV 05 Lier
60,Mechelsesteenweg 365,2022-11-20,04:00:00,2,0,2,FMN GV 05 Lier
60,Mechelsesteenweg 365,2022-11-20,05:00:00,0,0,0,FMN GV 05 Lier
60,Mechelsesteenweg 365,2022-11-20,06:00:00,2,0,2,FMN GV 05 Lier
60,Mechelsesteenweg 365,2022-11-20,07:00:00,2,2,0,FMN GV 05 Lier
60,Mechelsesteenweg 365,2022-11-20,08:00:00,14,4,10,FMN GV 05 Lier
60,Mechelsesteenweg 365,2022-11-20,09:00:00,42,24,18,FMN GV 05 Lier
60,Mechelsesteenweg 365,2022-11-20,10:00:00,152,64,88,FMN GV 05 Lier
60,Mechelsesteenweg 365,2022-11-20,11:00:00,120,48,72,FMN GV 05 Lier
60,Mechelsesteenweg 365,2022-11-20,12:00:00,34,20,14,FMN GV 05 Lier
60,Mechelsesteenweg 365,2022-11-20,13:00:00,30,18,12,FMN GV 05 Lier
60,Mechelsesteenweg 365,2022-11-20,14:00:00,10,8,2,FMN GV 05 Lier
60,Mechelsesteenweg 365,2022-11-20,15:00:00,8,4,4,FMN GV 05 Lier
60,Mechelsesteenweg 365,2022-11-20,16:00:00,4,2,2,FMN GV 05 Lier
60,Mechelsesteenweg 365,2022-11-20,17:00:00,22,2,20,FMN GV 05 Lier
60,Mechelsesteenweg 365,2022-11-20,18:00:00,4,4,0,FMN GV 05 Lier
60,Mechelsesteenweg 365,2022-11-20,19:00:00,2,0,2,FMN GV 05 Lier
60,Mechelsesteenweg 365,2022-11-20,20:00:00,0,0,0,FMN GV 05 Lier
60,Mechelsesteenweg 365,2022-11-20,21:00:00,0,0,0,FMN GV 05 Lier
60,Mechelsesteenweg 365,2022-11-20,22:00:00,0,0,0,FMN GV 05 Lier
60,Mechelsesteenweg 365,2022-11-20,23:00:00,0,0,0,FMN GV 05 Lier
60,Mechelsesteenweg 365,2022-11-21,00:00:00,0,0,0,FMN GV 05 Lier
60,Mechelsesteenweg 365,2022-11-21,01:00:00,0,0,0,FMN GV 05 Lier
60,Mechelsesteenweg 365,2022-11-21,02:00:00,0,0,0,FMN GV 05 Lier
60,Mechelsesteenweg 365,2022-11-21,03:00:00,0,0,0,FMN GV 05 Lier
60,Mechelsesteenweg 365,2022-11-21,04:00:00,2,0,2,FMN GV 05 Lier
60,Mechelsesteenweg 365,2022-11-21,05:00:00,0,0,0,FMN GV 05 Lier
60,Mechelsesteenweg 365,2022-11-21,06:00:00,12,8,4,FMN GV 05 Lier
60,Mechelsesteenweg 365,2022-11-21,07:00:00,66,22,44,FMN GV 05 Lier
60,Mechelsesteenweg 365,2022-11-21,08:00:00,98,62,36,FMN GV 05 Lier
60,Mechelsesteenweg 365,2022-11-21,09:00:00,46,18,28,FMN GV 05 Lier
60,Mechelsesteenweg 365,2022-11-21,10:00:00,38,12,26,FMN GV 05 Lier
60,Mechelsesteenweg 365,2022-11-21,11:00:00,68,36,32,FMN GV 05 Lier
60,Mechelsesteenweg 365,2022-11-21,12:00:00,52,24,28,FMN GV 05 Lier
60,Mechelsesteenweg 365,2022-11-21,13:00:00,50,18,32,FMN GV 05 Lier
60,Mechelsesteenweg 365,2022-11-21,14:00:00,52,28,24,FMN GV 05 Lier
60,Mechelsesteenweg 365,2022-11-21,15:00:00,66,36,30,FMN GV 05 Lier
60,Mechelsesteenweg 365,2022-11-21,16:00:00,138,54,84,FMN GV 05 Lier
60,Mechelsesteenweg 365,2022-11-21,17:00:00,48,32,16,FMN GV 05 Lier
60,Mechelsesteenweg 365,2022-11-21,18:00:00,20,18,2,FMN GV 05 Lier
60,Mechelsesteenweg 365,2022-11-21,19:00:00,2,2,0,FMN GV 05 Lier
60,Mechelsesteenweg 365,2022-11-21,20:00:00,0,0,0,FMN GV 05 Lier
60,Mechelsesteenweg 365,2022-11-21,21:00:00,4,2,2,FMN GV 05 Lier
60,Mechelsesteenweg 365,2022-11-21,22:00:00,4,4,0,FMN GV 05 Lier
60,Mechelsesteenweg 365,2022-11-21,23:00:00,4,4,0,FMN GV 05 Lier
60,Mechelsesteenweg 365,2022-11-22,00:00:00,0,0,0,FMN GV 05 Lier
60,Mechelsesteenweg 365,2022-11-22,01:00:00,0,0,0,FMN GV 05 Lier
60,Mechelsesteenweg 365,2022-11-22,02:00:00,0,0,0,FMN GV 05 Lier
60,Mechelsesteenweg 365,2022-11-22,03:00:00,0,0,0,FMN GV 05 Lier
60,Mechelsesteenweg 365,2022-11-22,04:00:00,0,0,0,FMN GV 05 Lier
60,Mechelsesteenweg 365,2022-11-22,05:00:00,0,0,0,FMN GV 05 Lier
60,Mechelsesteenweg 365,2022-11-22,06:00:00,24,8,16,FMN GV 05 Lier
60,Mechelsesteenweg 365,2022-11-22,07:00:00,66,20,46,FMN GV 05 Lier
60,Mechelsesteenweg 365,2022-11-22,08:00:00,80,50,30,FMN GV 05 Lier
60,Mechelsesteenweg 365,2022-11-22,09:00:00,30,14,16,FMN GV 05 Lier
60,Mechelsesteenweg 365,2022-11-22,10:00:00,38,22,16,FMN GV 05 Lier
60,Mechelsesteenweg 365,2022-11-22,11:00:00,30,20,10,FMN GV 05 Lier
60,Mechelsesteenweg 365,2022-11-22,12:00:00,36,18,18,FMN GV 05 Lier
60,Mechelsesteenweg 365,2022-11-22,13:00:00,46,12,34,FMN GV 05 Lier
60,Mechelsesteenweg 365,2022-11-22,14:00:00,34,24,10,FMN GV 05 Lier
60,Mechelsesteenweg 365,2022-11-22,15:00:00,48,24,24,FMN GV 05 Lier
60,Mechelsesteenweg 365,2022-11-22,16:00:00,128,44,84,FMN GV 05 Lier
60,Mechelsesteenweg 365,2022-11-22,17:00:00,68,44,24,FMN GV 05 Lier
60,Mechelsesteenweg 365,2022-11-22,18:00:00,8,6,2,FMN GV 05 Lier
60,Mechelsesteenweg 365,2022-11-22,19:00:00,4,4,0,FMN GV 05 Lier
60,Mechelsesteenweg 365,2022-11-22,20:00:00,16,6,10,FMN GV 05 Lier
60,Mechelsesteenweg 365,2022-11-22,21:00:00,4,2,2,FMN GV 05 Lier
60,Mechelsesteenweg 365,2022-11-22,22:00:00,2,0,2,FMN GV 05 Lier
60,Mechelsesteenweg 365,2022-11-22,23:00:00,4,4,0,FMN GV 05 Lier
60,Mechelsesteenweg 365,2022-11-23,00:00:00,0,0,0,FMN GV 05 Lier
60,Mechelsesteenweg 365,2022-11-23,01:00:00,2,0,2,FMN GV 05 Lier
60,Mechelsesteenweg 365,2022-11-23,02:00:00,0,0,0,FMN GV 05 Lier
60,Mechelsesteenweg 365,2022-11-23,03:00:00,0,0,0,FMN GV 05 Lier
60,Mechelsesteenweg 365,2022-11-23,04:00:00,2,0,2,FMN GV 05 Lier
60,Mechelsesteenweg 365,2022-11-23,05:00:00,0,0,0,FMN GV 05 Lier
60,Mechelsesteenweg 365,2022-11-23,06:00:00,14,2,12,FMN GV 05 Lier
60,Mechelsesteenweg 365,2022-11-23,07:00:00,78,34,44,FMN GV 05 Lier
60,Mechelsesteenweg 365,2022-11-23,08:00:00,80,48,32,FMN GV 05 Lier
60,Mechelsesteenweg 365,2022-11-23,09:00:00,46,18,28,FMN GV 05 Lier
60,Mechelsesteenweg 365,2022-11-23,10:00:00,42,10,32,FMN GV 05 Lier
60,Mechelsesteenweg 365,2022-11-23,11:00:00,34,18,16,FMN GV 05 Lier
60,Mechelsesteenweg 365,2022-11-23,12:00:00,118,42,76,FMN GV 05 Lier
60,Mechelsesteenweg 365,2022-11-23,13:00:00,32,14,18,FMN GV 05 Lier
60,Mechelsesteenweg 365,2022-11-23,14:00:00,16,10,6,FMN GV 05 Lier
60,Mechelsesteenweg 365,2022-11-23,15:00:00,6,6,0,FMN GV 05 Lier
60,Mechelsesteenweg 365,2022-11-23,16:00:00,36,26,10,FMN GV 05 Lier
60,Mechelsesteenweg 365,2022-11-23,17:00:00,32,20,12,FMN GV 05 Lier
60,Mechelsesteenweg 365,2022-11-23,18:00:00,12,12,0,FMN GV 05 Lier
60,Mechelsesteenweg 365,2022-11-23,19:00:00,12,6,6,FMN GV 05 Lier
60,Mechelsesteenweg 365,2022-11-23,20:00:00,2,2,0,FMN GV 05 Lier
60,Mechelsesteenweg 365,2022-11-23,21:00:00,4,0,4,FMN GV 05 Lier
60,Mechelsesteenweg 365,2022-11-23,22:00:00,6,6,0,FMN GV 05 Lier
60,Mechelsesteenweg 365,2022-11-23,23:00:00,0,0,0,FMN GV 05 Lier
60,Mechelsesteenweg 365,2022-11-24,00:00:00,0,0,0,FMN GV 05 Lier
60,Mechelsesteenweg 365,2022-11-24,01:00:00,0,0,0,FMN GV 05 Lier
60,Mechelsesteenweg 365,2022-11-24,02:00:00,0,0,0,FMN GV 05 Lier
60,Mechelsesteenweg 365,2022-11-24,03:00:00,0,0,0,FMN GV 05 Lier
60,Mechelsesteenweg 365,2022-11-24,04:00:00,2,0,2,FMN GV 05 Lier
60,Mechelsesteenweg 365,2022-11-24,05:00:00,2,0,2,FMN GV 05 Lier
60,Mechelsesteenweg 365,2022-11-24,06:00:00,12,2,10,FMN GV 05 Lier
60,Mechelsesteenweg 365,2022-11-24,07:00:00,72,32,40,FMN GV 05 Lier
60,Mechelsesteenweg 365,2022-11-24,08:00:00,106,64,42,FMN GV 05 Lier
60,Mechelsesteenweg 365,2022-11-24,09:00:00,40,24,16,FMN GV 05 Lier
60,Mechelsesteenweg 365,2022-11-24,10:00:00,70,44,26,FMN GV 05 Lier
60,Mechelsesteenweg 365,2022-11-24,11:00:00,80,40,40,FMN GV 05 Lier
60,Mechelsesteenweg 365,2022-11-24,12:00:00,70,22,48,FMN GV 05 Lier
60,Mechelsesteenweg 365,2022-11-24,13:00:00,98,70,28,FMN GV 05 Lier
60,Mechelsesteenweg 365,2022-11-24,14:00:00,160,90,70,FMN GV 05 Lier
60,Mechelsesteenweg 365,2022-11-24,15:00:00,120,36,84,FMN GV 05 Lier
60,Mechelsesteenweg 365,2022-11-24,16:00:00,188,70,118,FMN GV 05 Lier
60,Mechelsesteenweg 365,2022-11-24,17:00:00,68,50,18,FMN GV 05 Lier
60,Mechelsesteenweg 365,2022-11-24,18:00:00,32,26,6,FMN GV 05 Lier
60,Mechelsesteenweg 365,2022-11-24,19:00:00,16,12,4,FMN GV 05 Lier
60,Mechelsesteenweg 365,2022-11-24,20:00:00,8,2,6,FMN GV 05 Lier
60,Mechelsesteenweg 365,2022-11-24,21:00:00,10,4,6,FMN GV 05 Lier
60,Mechelsesteenweg 365,2022-11-24,22:00:00,8,6,2,FMN GV 05 Lier
60,Mechelsesteenweg 365,2022-11-24,23:00:00,0,0,0,FMN GV 05 Lier
60,Mechelsesteenweg 365,2022-11-25,00:00:00,0,0,0,FMN GV 05 Lier
60,Mechelsesteenweg 365,2022-11-25,01:00:00,0,0,0,FMN GV 05 Lier
60,Mechelsesteenweg 365,2022-11-25,02:00:00,0,0,0,FMN GV 05 Lier
60,Mechelsesteenweg 365,2022-11-25,03:00:00,2,0,2,FMN GV 05 Lier
60,Mechelsesteenweg 365,2022-11-25,04:00:00,0,0,0,FMN GV 05 Lier
60,Mechelsesteenweg 365,2022-11-25,05:00:00,2,0,2,FMN GV 05 Lier
60,Mechelsesteenweg 365,2022-11-25,06:00:00,18,6,12,FMN GV 05 Lier
60,Mechelsesteenweg 365,2022-11-25,07:00:00,80,40,40,FMN GV 05 Lier
60,Mechelsesteenweg 365,2022-11-25,08:00:00,92,68,24,FMN GV 05 Lier
60,Mechelsesteenweg 365,2022-11-25,09:00:00,32,18,14,FMN GV 05 Lier
60,Mechelsesteenweg 365,2022-11-25,10:00:00,46,22,24,FMN GV 05 Lier
60,Mechelsesteenweg 365,2022-11-25,11:00:00,44,24,20,FMN GV 05 Lier
60,Mechelsesteenweg 365,2022-11-25,12:00:00,84,40,44,FMN GV 05 Lier
60,Mechelsesteenweg 365,2022-11-25,13:00:00,160,66,94,FMN GV 05 Lier
60,Mechelsesteenweg 365,2022-11-25,14:00:00,150,92,58,FMN GV 05 Lier
60,Mechelsesteenweg 365,2022-11-25,15:00:00,120,50,70,FMN GV 05 Lier
60,Mechelsesteenweg 365,2022-11-25,16:00:00,156,60,96,FMN GV 05 Lier
60,Mechelsesteenweg 365,2022-11-25,17:00:00,56,40,16,FMN GV 05 Lier
60,Mechelsesteenweg 365,2022-11-25,18:00:00,10,2,8,FMN GV 05 Lier
60,Mechelsesteenweg 365,2022-11-25,19:00:00,8,4,4,FMN GV 05 Lier
60,Mechelsesteenweg 365,2022-11-25,20:00:00,10,6,4,FMN GV 05 Lier
60,Mechelsesteenweg 365,2022-11-25,21:00:00,2,2,0,FMN GV 05 Lier
60,Mechelsesteenweg 365,2022-11-25,22:00:00,4,4,0,FMN GV 05 Lier
60,Mechelsesteenweg 365,2022-11-25,23:00:00,0,0,0,FMN GV 05 Lier
60,Mechelsesteenweg 365,2022-11-26,00:00:00,0,0,0,FMN GV 05 Lier
60,Mechelsesteenweg 365,2022-11-26,01:00:00,0,0,0,FMN GV 05 Lier
60,Mechelsesteenweg 365,2022-11-26,02:00:00,0,0,0,FMN GV 05 Lier
60,Mechelsesteenweg 365,2022-11-26,03:00:00,2,2,0,FMN GV 05 Lier
60,Mechelsesteenweg 365,2022-11-26,04:00:00,0,0,0,FMN GV 05 Lier
60,Mechelsesteenweg 365,2022-11-26,05:00:00,0,0,0,FMN GV 05 Lier
60,Mechelsesteenweg 365,2022-11-26,06:00:00,2,2,0,FMN GV 05 Lier
60,Mechelsesteenweg 365,2022-11-26,07:00:00,8,6,2,FMN GV 05 Lier
60,Mechelsesteenweg 365,2022-11-26,08:00:00,6,0,6,FMN GV 05 Lier
60,Mechelsesteenweg 365,2022-11-26,09:00:00,54,36,18,FMN GV 05 Lier
60,Mechelsesteenweg 365,2022-11-26,10:00:00,106,66,40,FMN GV 05 Lier
60,Mechelsesteenweg 365,2022-11-26,11:00:00,142,58,84,FMN GV 05 Lier
60,Mechelsesteenweg 365,2022-11-26,12:00:00,134,72,62,FMN GV 05 Lier
60,Mechelsesteenweg 365,2022-11-26,13:00:00,154,72,82,FMN GV 05 Lier
60,Mechelsesteenweg 365,2022-11-26,14:00:00,210,100,110,FMN GV 05 Lier
60,Mechelsesteenweg 365,2022-11-26,15:00:00,116,42,74,FMN GV 05 Lier
60,Mechelsesteenweg 365,2022-11-26,16:00:00,88,48,40,FMN GV 05 Lier
60,Mechelsesteenweg 365,2022-11-26,17:00:00,12,6,6,FMN GV 05 Lier
60,Mechelsesteenweg 365,2022-11-26,18:00:00,6,6,0,FMN GV 05 Lier
60,Mechelsesteenweg 365,2022-11-26,19:00:00,4,2,2,FMN GV 05 Lier
60,Mechelsesteenweg 365,2022-11-26,20:00:00,4,2,2,FMN GV 05 Lier
60,Mechelsesteenweg 365,2022-11-26,21:00:00,6,4,2,FMN GV 05 Lier
60,Mechelsesteenweg 365,2022-11-26,22:00:00,0,0,0,FMN GV 05 Lier
60,Mechelsesteenweg 365,2022-11-26,23:00:00,4,4,0,FMN GV 05 Lier
60,Mechelsesteenweg 365,2022-11-27,00:00:00,0,0,0,FMN GV 05 Lier
60,Mechelsesteenweg 365,2022-11-27,01:00:00,0,0,0,FMN GV 05 Lier
60,Mechelsesteenweg 365,2022-11-27,02:00:00,2,0,2,FMN GV 05 Lier
60,Mechelsesteenweg 365,2022-11-27,03:00:00,0,0,0,FMN GV 05 Lier
60,Mechelsesteenweg 365,2022-11-27,04:00:00,2,0,2,FMN GV 05 Lier
60,Mechelsesteenweg 365,2022-11-27,05:00:00,0,0,0,FMN GV 05 Lier
60,Mechelsesteenweg 365,2022-11-27,06:00:00,2,0,2,FMN GV 05 Lier
60,Mechelsesteenweg 365,2022-11-27,07:00:00,2,0,2,FMN GV 05 Lier
60,Mechelsesteenweg 365,2022-11-27,08:00:00,2,2,0,FMN GV 05 Lier
60,Mechelsesteenweg 365,2022-11-27,09:00:00,24,16,8,FMN GV 05 Lier
60,Mechelsesteenweg 365,2022-11-27,10:00:00,32,16,16,FMN GV 05 Lier
60,Mechelsesteenweg 365,2022-11-27,11:00:00,42,26,16,FMN GV 05 Lier
60,Mechelsesteenweg 365,2022-11-27,12:00:00,22,10,12,FMN GV 05 Lier
60,Mechelsesteenweg 365,2022-11-27,13:00:00,20,12,8,FMN GV 05 Lier
60,Mechelsesteenweg 365,2022-11-27,14:00:00,22,10,12,FMN GV 05 Lier
60,Mechelsesteenweg 365,2022-11-27,15:00:00,4,2,2,FMN GV 05 Lier
60,Mechelsesteenweg 365,2022-11-27,16:00:00,12,6,6,FMN GV 05 Lier
60,Mechelsesteenweg 365,2022-11-27,17:00:00,6,4,2,FMN GV 05 Lier
60,Mechelsesteenweg 365,2022-11-27,18:00:00,4,4,0,FMN GV 05 Lier
60,Mechelsesteenweg 365,2022-11-27,19:00:00,0,0,0,FMN GV 05 Lier
60,Mechelsesteenweg 365,2022-11-27,20:00:00,0,0,0,FMN GV 05 Lier
60,Mechelsesteenweg 365,2022-11-27,21:00:00,4,0,4,FMN GV 05 Lier
60,Mechelsesteenweg 365,2022-11-27,22:00:00,0,0,0,FMN GV 05 Lier
60,Mechelsesteenweg 365,2022-11-27,23:00:00,0,0,0,FMN GV 05 Lier
60,Mechelsesteenweg 365,2022-11-28,00:00:00,0,0,0,FMN GV 05 Lier
60,Mechelsesteenweg 365,2022-11-28,01:00:00,0,0,0,FMN GV 05 Lier
60,Mechelsesteenweg 365,2022-11-28,02:00:00,0,0,0,FMN GV 05 Lier
60,Mechelsesteenweg 365,2022-11-28,03:00:00,0,0,0,FMN GV 05 Lier
60,Mechelsesteenweg 365,2022-11-28,04:00:00,0,0,0,FMN GV 05 Lier
60,Mechelsesteenweg 365,2022-11-28,05:00:00,4,0,4,FMN GV 05 Lier
60,Mechelsesteenweg 365,2022-11-28,06:00:00,18,8,10,FMN GV 05 Lier
60,Mechelsesteenweg 365,2022-11-28,07:00:00,66,24,42,FMN GV 05 Lier
60,Mechelsesteenweg 365,2022-11-28,08:00:00,96,62,34,FMN GV 05 Lier
60,Mechelsesteenweg 365,2022-11-28,09:00:00,16,8,8,FMN GV 05 Lier
60,Mechelsesteenweg 365,2022-11-28,10:00:00,20,10,10,FMN GV 05 Lier
60,Mechelsesteenweg 365,2022-11-28,11:00:00,18,8,10,FMN GV 05 Lier
60,Mechelsesteenweg 365,2022-11-28,12:00:00,22,12,10,FMN GV 05 Lier
60,Mechelsesteenweg 365,2022-11-28,13:00:00,28,18,10,FMN GV 05 Lier
60,Mechelsesteenweg 365,2022-11-28,14:00:00,66,32,34,FMN GV 05 Lier
60,Mechelsesteenweg 365,2022-11-28,15:00:00,72,30,42,FMN GV 05 Lier
60,Mechelsesteenweg 365,2022-11-28,16:00:00,128,42,86,FMN GV 05 Lier
60,Mechelsesteenweg 365,2022-11-28,17:00:00,56,30,26,FMN GV 05 Lier
60,Mechelsesteenweg 365,2022-11-28,18:00:00,22,14,8,FMN GV 05 Lier
60,Mechelsesteenweg 365,2022-11-28,19:00:00,4,2,2,FMN GV 05 Lier
60,Mechelsesteenweg 365,2022-11-28,20:00:00,6,2,4,FMN GV 05 Lier
60,Mechelsesteenweg 365,2022-11-28,21:00:00,0,0,0,FMN GV 05 Lier
60,Mechelsesteenweg 365,2022-11-28,22:00:00,2,2,0,FMN GV 05 Lier
60,Mechelsesteenweg 365,2022-11-28,23:00:00,0,0,0,FMN GV 05 Lier
60,Mechelsesteenweg 365,2022-11-29,00:00:00,0,0,0,FMN GV 05 Lier
60,Mechelsesteenweg 365,2022-11-29,01:00:00,0,0,0,FMN GV 05 Lier
60,Mechelsesteenweg 365,2022-11-29,02:00:00,0,0,0,FMN GV 05 Lier
60,Mechelsesteenweg 365,2022-11-29,03:00:00,0,0,0,FMN GV 05 Lier
60,Mechelsesteenweg 365,2022-11-29,04:00:00,2,0,2,FMN GV 05 Lier
60,Mechelsesteenweg 365,2022-11-29,05:00:00,4,0,4,FMN GV 05 Lier
60,Mechelsesteenweg 365,2022-11-29,06:00:00,20,8,12,FMN GV 05 Lier
60,Mechelsesteenweg 365,2022-11-29,07:00:00,88,38,50,FMN GV 05 Lier
60,Mechelsesteenweg 365,2022-11-29,08:00:00,112,76,36,FMN GV 05 Lier
60,Mechelsesteenweg 365,2022-11-29,09:00:00,42,20,22,FMN GV 05 Lier
60,Mechelsesteenweg 365,2022-11-29,10:00:00,70,38,32,FMN GV 05 Lier
60,Mechelsesteenweg 365,2022-11-29,11:00:00,52,38,14,FMN GV 05 Lier
60,Mechelsesteenweg 365,2022-11-29,12:00:00,74,34,40,FMN GV 05 Lier
60,Mechelsesteenweg 365,2022-11-29,13:00:00,68,26,42,FMN GV 05 Lier
60,Mechelsesteenweg 365,2022-11-29,14:00:00,92,58,34,FMN GV 05 Lier
60,Mechelsesteenweg 365,2022-11-29,15:00:00,112,64,48,FMN GV 05 Lier
60,Mechelsesteenweg 365,2022-11-29,16:00:00,162,48,114,FMN GV 05 Lier
60,Mechelsesteenweg 365,2022-11-29,17:00:00,60,36,24,FMN GV 05 Lier
60,Mechelsesteenweg 365,2022-11-29,18:00:00,22,14,8,FMN GV 05 Lier
60,Mechelsesteenweg 365,2022-11-29,19:00:00,6,0,6,FMN GV 05 Lier
60,Mechelsesteenweg 365,2022-11-29,20:00:00,6,2,4,FMN GV 05 Lier
60,Mechelsesteenweg 365,2022-11-29,21:00:00,4,0,4,FMN GV 05 Lier
60,Mechelsesteenweg 365,2022-11-29,22:00:00,0,0,0,FMN GV 05 Lier
60,Mechelsesteenweg 365,2022-11-29,23:00:00,0,0,0,FMN GV 05 Lier
60,Mechelsesteenweg 365,2022-11-30,00:00:00,2,2,0,FMN GV 05 Lier
60,Mechelsesteenweg 365,2022-11-30,01:00:00,0,0,0,FMN GV 05 Lier
60,Mechelsesteenweg 365,2022-11-30,02:00:00,0,0,0,FMN GV 05 Lier
60,Mechelsesteenweg 365,2022-11-30,03:00:00,0,0,0,FMN GV 05 Lier
60,Mechelsesteenweg 365,2022-11-30,04:00:00,0,0,0,FMN GV 05 Lier
60,Mechelsesteenweg 365,2022-11-30,05:00:00,6,0,6,FMN GV 05 Lier
60,Mechelsesteenweg 365,2022-11-30,06:00:00,18,4,14,FMN GV 05 Lier
60,Mechelsesteenweg 365,2022-11-30,07:00:00,76,36,40,FMN GV 05 Lier
60,Mechelsesteenweg 365,2022-11-30,08:00:00,98,66,32,FMN GV 05 Lier
60,Mechelsesteenweg 365,2022-11-30,09:00:00,36,14,22,FMN GV 05 Lier
60,Mechelsesteenweg 365,2022-11-30,10:00:00,24,10,14,FMN GV 05 Lier
60,Mechelsesteenweg 365,2022-11-30,11:00:00,44,16,28,FMN GV 05 Lier
60,Mechelsesteenweg 365,2022-11-30,12:00:00,138,28,110,FMN GV 05 Lier
60,Mechelsesteenweg 365,2022-11-30,13:00:00,60,26,34,FMN GV 05 Lier
60,Mechelsesteenweg 365,2022-11-30,14:00:00,80,54,26,FMN GV 05 Lier
60,Mechelsesteenweg 365,2022-11-30,15:00:00,60,28,32,FMN GV 05 Lier
60,Mechelsesteenweg 365,2022-11-30,16:00:00,64,44,20,FMN GV 05 Lier
60,Mechelsesteenweg 365,2022-11-30,17:00:00,40,28,12,FMN GV 05 Lier
60,Mechelsesteenweg 365,2022-11-30,18:00:00,24,14,10,FMN GV 05 Lier
60,Mechelsesteenweg 365,2022-11-30,19:00:00,6,6,0,FMN GV 05 Lier
60,Mechelsesteenweg 365,2022-11-30,20:00:00,4,0,4,FMN GV 05 Lier
60,Mechelsesteenweg 365,2022-11-30,21:00:00,6,0,6,FMN GV 05 Lier
60,Mechelsesteenweg 365,2022-11-30,22:00:00,2,2,0,FMN GV 05 Lier
60,Mechelsesteenweg 365,2022-11-30,23:00:00,2,0,2,FMN GV 05 Lier
60,Mechelsesteenweg 365,2022-12-01,00:00:00,0,0,0,FMN GV 05 Lier
60,Mechelsesteenweg 365,2022-12-01,01:00:00,0,0,0,FMN GV 05 Lier
60,Mechelsesteenweg 365,2022-12-01,02:00:00,0,0,0,FMN GV 05 Lier
60,Mechelsesteenweg 365,2022-12-01,03:00:00,0,0,0,FMN GV 05 Lier
60,Mechelsesteenweg 365,2022-12-01,04:00:00,0,0,0,FMN GV 05 Lier
60,Mechelsesteenweg 365,2022-12-01,05:00:00,4,0,4,FMN GV 05 Lier
60,Mechelsesteenweg 365,2022-12-01,06:00:00,20,8,12,FMN GV 05 Lier
60,Mechelsesteenweg 365,2022-12-01,07:00:00,70,26,44,FMN GV 05 Lier
60,Mechelsesteenweg 365,2022-12-01,08:00:00,96,64,32,FMN GV 05 Lier
60,Mechelsesteenweg 365,2022-12-01,09:00:00,50,32,18,FMN GV 05 Lier
60,Mechelsesteenweg 365,2022-12-01,10:00:00,50,36,14,FMN GV 05 Lier
60,Mechelsesteenweg 365,2022-12-01,11:00:00,32,16,16,FMN GV 05 Lier
60,Mechelsesteenweg 365,2022-12-01,12:00:00,64,18,46,FMN GV 05 Lier
60,Mechelsesteenweg 365,2022-12-01,13:00:00,52,22,30,FMN GV 05 Lier
60,Mechelsesteenweg 365,2022-12-01,14:00:00,58,32,26,FMN GV 05 Lier
60,Mechelsesteenweg 365,2022-12-01,15:00:00,96,30,66,FMN GV 05 Lier
60,Mechelsesteenweg 365,2022-12-01,16:00:00,96,36,60,FMN GV 05 Lier
60,Mechelsesteenweg 365,2022-12-01,17:00:00,42,32,10,FMN GV 05 Lier
60,Mechelsesteenweg 365,2022-12-01,18:00:00,20,16,4,FMN GV 05 Lier
60,Mechelsesteenweg 365,2022-12-01,19:00:00,10,10,0,FMN GV 05 Lier
60,Mechelsesteenweg 365,2022-12-01,20:00:00,4,0,4,FMN GV 05 Lier
60,Mechelsesteenweg 365,2022-12-01,21:00:00,0,0,0,FMN GV 05 Lier
60,Mechelsesteenweg 365,2022-12-01,22:00:00,4,2,2,FMN GV 05 Lier
60,Mechelsesteenweg 365,2022-12-01,23:00:00,2,2,0,FMN GV 05 Lier
60,Mechelsesteenweg 365,2022-12-02,00:00:00,0,0,0,FMN GV 05 Lier
60,Mechelsesteenweg 365,2022-12-02,01:00:00,0,0,0,FMN GV 05 Lier
60,Mechelsesteenweg 365,2022-12-02,02:00:00,0,0,0,FMN GV 05 Lier
60,Mechelsesteenweg 365,2022-12-02,03:00:00,0,0,0,FMN GV 05 Lier
60,Mechelsesteenweg 365,2022-12-02,04:00:00,0,0,0,FMN GV 05 Lier
60,Mechelsesteenweg 365,2022-12-02,05:00:00,6,0,6,FMN GV 05 Lier
60,Mechelsesteenweg 365,2022-12-02,06:00:00,14,4,10,FMN GV 05 Lier
60,Mechelsesteenweg 365,2022-12-02,07:00:00,56,36,20,FMN GV 05 Lier
60,Mechelsesteenweg 365,2022-12-02,08:00:00,80,58,22,FMN GV 05 Lier
60,Mechelsesteenweg 365,2022-12-02,09:00:00,14,6,8,FMN GV 05 Lier
60,Mechelsesteenweg 365,2022-12-02,10:00:00,28,12,16,FMN GV 05 Lier
60,Mechelsesteenweg 365,2022-12-02,11:00:00,20,20,0,FMN GV 05 Lier
60,Mechelsesteenweg 365,2022-12-02,12:00:00,52,12,40,FMN GV 05 Lier
60,Mechelsesteenweg 365,2022-12-02,13:00:00,58,38,20,FMN GV 05 Lier
60,Mechelsesteenweg 365,2022-12-02,14:00:00,68,28,40,FMN GV 05 Lier
60,Mechelsesteenweg 365,2022-12-02,15:00:00,70,28,42,FMN GV 05 Lier
60,Mechelsesteenweg 365,2022-12-02,16:00:00,96,40,56,FMN GV 05 Lier
60,Mechelsesteenweg 365,2022-12-02,17:00:00,28,16,12,FMN GV 05 Lier
60,Mechelsesteenweg 365,2022-12-02,18:00:00,12,12,0,FMN GV 05 Lier
60,Mechelsesteenweg 365,2022-12-02,19:00:00,4,2,2,FMN GV 05 Lier
60,Mechelsesteenweg 365,2022-12-02,20:00:00,6,4,2,FMN GV 05 Lier
60,Mechelsesteenweg 365,2022-12-02,21:00:00,0,0,0,FMN GV 05 Lier
60,Mechelsesteenweg 365,2022-12-02,22:00:00,4,2,2,FMN GV 05 Lier
60,Mechelsesteenweg 365,2022-12-02,23:00:00,0,0,0,FMN GV 05 Lier
60,Mechelsesteenweg 365,2022-12-03,00:00:00,0,0,0,FMN GV 05 Lier
60,Mechelsesteenweg 365,2022-12-03,01:00:00,0,0,0,FMN GV 05 Lier
60,Mechelsesteenweg 365,2022-12-03,02:00:00,0,0,0,FMN GV 05 Lier
60,Mechelsesteenweg 365,2022-12-03,03:00:00,6,0,6,FMN GV 05 Lier
60,Mechelsesteenweg 365,2022-12-03,04:00:00,0,0,0,FMN GV 05 Lier
60,Mechelsesteenweg 365,2022-12-03,05:00:00,2,0,2,FMN GV 05 Lier
60,Mechelsesteenweg 365,2022-12-03,06:00:00,2,0,2,FMN GV 05 Lier
60,Mechelsesteenweg 365,2022-12-03,07:00:00,0,0,0,FMN GV 05 Lier
60,Mechelsesteenweg 365,2022-12-03,08:00:00,12,6,6,FMN GV 05 Lier
60,Mechelsesteenweg 365,2022-12-03,09:00:00,36,22,14,FMN GV 05 Lier
60,Mechelsesteenweg 365,2022-12-03,10:00:00,46,24,22,FMN GV 05 Lier
60,Mechelsesteenweg 365,2022-12-03,11:00:00,48,22,26,FMN GV 05 Lier
60,Mechelsesteenweg 365,2022-12-03,12:00:00,64,24,40,FMN GV 05 Lier
60,Mechelsesteenweg 365,2022-12-03,13:00:00,68,34,34,FMN GV 05 Lier
60,Mechelsesteenweg 365,2022-12-03,14:00:00,44,22,22,FMN GV 05 Lier
60,Mechelsesteenweg 365,2022-12-03,15:00:00,60,24,36,FMN GV 05 Lier
60,Mechelsesteenweg 365,2022-12-03,16:00:00,6,2,4,FMN GV 05 Lier
60,Mechelsesteenweg 365,2022-12-03,17:00:00,12,2,10,FMN GV 05 Lier
60,Mechelsesteenweg 365,2022-12-03,18:00:00,4,4,0,FMN GV 05 Lier
60,Mechelsesteenweg 365,2022-12-03,19:00:00,4,2,2,FMN GV 05 Lier
60,Mechelsesteenweg 365,2022-12-03,20:00:00,0,0,0,FMN GV 05 Lier
60,Mechelsesteenweg 365,2022-12-03,21:00:00,2,0,2,FMN GV 05 Lier
60,Mechelsesteenweg 365,2022-12-03,22:00:00,2,0,2,FMN GV 05 Lier
60,Mechelsesteenweg 365,2022-12-03,23:00:00,0,0,0,FMN GV 05 Lier
60,Mechelsesteenweg 365,2022-12-04,00:00:00,2,0,2,FMN GV 05 Lier
60,Mechelsesteenweg 365,2022-12-04,01:00:00,0,0,0,FMN GV 05 Lier
60,Mechelsesteenweg 365,2022-12-04,02:00:00,2,0,2,FMN GV 05 Lier
60,Mechelsesteenweg 365,2022-12-04,03:00:00,0,0,0,FMN GV 05 Lier
60,Mechelsesteenweg 365,2022-12-04,04:00:00,2,2,0,FMN GV 05 Lier
60,Mechelsesteenweg 365,2022-12-04,05:00:00,0,0,0,FMN GV 05 Lier
60,Mechelsesteenweg 365,2022-12-04,06:00:00,0,0,0,FMN GV 05 Lier
60,Mechelsesteenweg 365,2022-12-04,07:00:00,0,0,0,FMN GV 05 Lier
60,Mechelsesteenweg 365,2022-12-04,08:00:00,14,10,4,FMN GV 05 Lier
60,Mechelsesteenweg 365,2022-12-04,09:00:00,50,38,12,FMN GV 05 Lier
60,Mechelsesteenweg 365,2022-12-04,10:00:00,78,44,34,FMN GV 05 Lier
60,Mechelsesteenweg 365,2022-12-04,11:00:00,90,22,68,FMN GV 05 Lier
60,Mechelsesteenweg 365,2022-12-04,12:00:00,40,18,22,FMN GV 05 Lier
60,Mechelsesteenweg 365,2022-12-04,13:00:00,40,18,22,FMN GV 05 Lier
60,Mechelsesteenweg 365,2022-12-04,14:00:00,50,22,28,FMN GV 05 Lier
60,Mechelsesteenweg 365,2022-12-04,15:00:00,22,10,12,FMN GV 05 Lier
60,Mechelsesteenweg 365,2022-12-04,16:00:00,10,8,2,FMN GV 05 Lier
60,Mechelsesteenweg 365,2022-12-04,17:00:00,6,0,6,FMN GV 05 Lier
60,Mechelsesteenweg 365,2022-12-04,18:00:00,2,0,2,FMN GV 05 Lier
60,Mechelsesteenweg 365,2022-12-04,19:00:00,0,0,0,FMN GV 05 Lier
60,Mechelsesteenweg 365,2022-12-04,20:00:00,4,4,0,FMN GV 05 Lier
60,Mechelsesteenweg 365,2022-12-04,21:00:00,0,0,0,FMN GV 05 Lier
60,Mechelsesteenweg 365,2022-12-04,22:00:00,0,0,0,FMN GV 05 Lier
60,Mechelsesteenweg 365,2022-12-04,23:00:00,0,0,0,FMN GV 05 Lier
60,Mechelsesteenweg 365,2022-12-05,00:00:00,0,0,0,FMN GV 05 Lier
60,Mechelsesteenweg 365,2022-12-05,01:00:00,0,0,0,FMN GV 05 Lier
60,Mechelsesteenweg 365,2022-12-05,02:00:00,0,0,0,FMN GV 05 Lier
60,Mechelsesteenweg 365,2022-12-05,03:00:00,0,0,0,FMN GV 05 Lier
60,Mechelsesteenweg 365,2022-12-05,04:00:00,2,0,2,FMN GV 05 Lier
60,Mechelsesteenweg 365,2022-12-05,05:00:00,2,0,2,FMN GV 05 Lier
60,Mechelsesteenweg 365,2022-12-05,06:00:00,12,0,12,FMN GV 05 Lier
60,Mechelsesteenweg 365,2022-12-05,07:00:00,46,16,30,FMN GV 05 Lier
60,Mechelsesteenweg 365,2022-12-05,08:00:00,74,48,26,FMN GV 05 Lier
60,Mechelsesteenweg 365,2022-12-05,09:00:00,6,2,4,FMN GV 05 Lier
60,Mechelsesteenweg 365,2022-12-05,10:00:00,6,0,6,FMN GV 05 Lier
60,Mechelsesteenweg 365,2022-12-05,11:00:00,12,6,6,FMN GV 05 Lier
60,Mechelsesteenweg 365,2022-12-05,12:00:00,12,2,10,FMN GV 05 Lier
60,Mechelsesteenweg 365,2022-12-05,13:00:00,14,10,4,FMN GV 05 Lier
60,Mechelsesteenweg 365,2022-12-05,14:00:00,14,12,2,FMN GV 05 Lier
60,Mechelsesteenweg 365,2022-12-05,15:00:00,30,12,18,FMN GV 05 Lier
60,Mechelsesteenweg 365,2022-12-05,16:00:00,54,18,36,FMN GV 05 Lier
60,Mechelsesteenweg 365,2022-12-05,17:00:00,52,40,12,FMN GV 05 Lier
60,Mechelsesteenweg 365,2022-12-05,18:00:00,2,2,0,FMN GV 05 Lier
60,Mechelsesteenweg 365,2022-12-05,19:00:00,0,0,0,FMN GV 05 Lier
60,Mechelsesteenweg 365,2022-12-05,20:00:00,4,2,2,FMN GV 05 Lier
60,Mechelsesteenweg 365,2022-12-05,21:00:00,4,0,4,FMN GV 05 Lier
60,Mechelsesteenweg 365,2022-12-05,22:00:00,0,0,0,FMN GV 05 Lier
60,Mechelsesteenweg 365,2022-12-05,23:00:00,0,0,0,FMN GV 05 Lier
60,Mechelsesteenweg 365,2022-12-06,00:00:00,0,0,0,FMN GV 05 Lier
60,Mechelsesteenweg 365,2022-12-06,01:00:00,0,0,0,FMN GV 05 Lier
60,Mechelsesteenweg 365,2022-12-06,02:00:00,0,0,0,FMN GV 05 Lier
60,Mechelsesteenweg 365,2022-12-06,03:00:00,0,0,0,FMN GV 05 Lier
60,Mechelsesteenweg 365,2022-12-06,04:00:00,2,0,2,FMN GV 05 Lier
60,Mechelsesteenweg 365,2022-12-06,05:00:00,2,0,2,FMN GV 05 Lier
60,Mechelsesteenweg 365,2022-12-06,06:00:00,20,4,16,FMN GV 05 Lier
60,Mechelsesteenweg 365,2022-12-06,07:00:00,60,32,28,FMN GV 05 Lier
60,Mechelsesteenweg 365,2022-12-06,08:00:00,74,44,30,FMN GV 05 Lier
60,Mechelsesteenweg 365,2022-12-06,09:00:00,44,22,22,FMN GV 05 Lier
60,Mechelsesteenweg 365,2022-12-06,10:00:00,80,26,54,FMN GV 05 Lier
60,Mechelsesteenweg 365,2022-12-06,11:00:00,80,32,48,FMN GV 05 Lier
60,Mechelsesteenweg 365,2022-12-06,12:00:00,66,28,38,FMN GV 05 Lier
60,Mechelsesteenweg 365,2022-12-06,13:00:00,124,52,72,FMN GV 05 Lier
60,Mechelsesteenweg 365,2022-12-06,14:00:00,146,76,70,FMN GV 05 Lier
60,Mechelsesteenweg 365,2022-12-06,15:00:00,90,44,46,FMN GV 05 Lier
60,Mechelsesteenweg 365,2022-12-06,16:00:00,110,48,62,FMN GV 05 Lier
60,Mechelsesteenweg 365,2022-12-06,17:00:00,56,42,14,FMN GV 05 Lier
60,Mechelsesteenweg 365,2022-12-06,18:00:00,20,14,6,FMN GV 05 Lier
60,Mechelsesteenweg 365,2022-12-06,19:00:00,4,4,0,FMN GV 05 Lier
60,Mechelsesteenweg 365,2022-12-06,20:00:00,18,8,10,FMN GV 05 Lier
60,Mechelsesteenweg 365,2022-12-06,21:00:00,4,2,2,FMN GV 05 Lier
60,Mechelsesteenweg 365,2022-12-06,22:00:00,0,0,0,FMN GV 05 Lier
60,Mechelsesteenweg 365,2022-12-06,23:00:00,4,2,2,FMN GV 05 Lier
60,Mechelsesteenweg 365,2022-12-07,00:00:00,0,0,0,FMN GV 05 Lier
60,Mechelsesteenweg 365,2022-12-07,01:00:00,0,0,0,FMN GV 05 Lier
60,Mechelsesteenweg 365,2022-12-07,02:00:00,0,0,0,FMN GV 05 Lier
60,Mechelsesteenweg 365,2022-12-07,03:00:00,0,0,0,FMN GV 05 Lier
60,Mechelsesteenweg 365,2022-12-07,04:00:00,0,0,0,FMN GV 05 Lier
60,Mechelsesteenweg 365,2022-12-07,05:00:00,2,0,2,FMN GV 05 Lier
60,Mechelsesteenweg 365,2022-12-07,06:00:00,24,6,18,FMN GV 05 Lier
60,Mechelsesteenweg 365,2022-12-07,07:00:00,50,24,26,FMN GV 05 Lier
60,Mechelsesteenweg 365,2022-12-07,08:00:00,78,52,26,FMN GV 05 Lier
60,Mechelsesteenweg 365,2022-12-07,09:00:00,10,2,8,FMN GV 05 Lier
60,Mechelsesteenweg 365,2022-12-07,10:00:00,48,22,26,FMN GV 05 Lier
60,Mechelsesteenweg 365,2022-12-07,11:00:00,38,12,26,FMN GV 05 Lier
60,Mechelsesteenweg 365,2022-12-07,12:00:00,82,20,62,FMN GV 05 Lier
60,Mechelsesteenweg 365,2022-12-07,13:00:00,34,16,18,FMN GV 05 Lier
60,Mechelsesteenweg 365,2022-12-07,14:00:00,34,20,14,FMN GV 05 Lier
60,Mechelsesteenweg 365,2022-12-07,15:00:00,30,16,14,FMN GV 05 Lier
60,Mechelsesteenweg 365,2022-12-07,16:00:00,30,16,14,FMN GV 05 Lier
60,Mechelsesteenweg 365,2022-12-07,17:00:00,34,22,12,FMN GV 05 Lier
60,Mechelsesteenweg 365,2022-12-07,18:00:00,28,18,10,FMN GV 05 Lier
60,Mechelsesteenweg 365,2022-12-07,19:00:00,2,2,0,FMN GV 05 Lier
60,Mechelsesteenweg 365,2022-12-07,20:00:00,16,12,4,FMN GV 05 Lier
60,Mechelsesteenweg 365,2022-12-07,21:00:00,0,0,0,FMN GV 05 Lier
60,Mechelsesteenweg 365,2022-12-07,22:00:00,0,0,0,FMN GV 05 Lier
60,Mechelsesteenweg 365,2022-12-07,23:00:00,2,2,0,FMN GV 05 Lier
60,Mechelsesteenweg 365,2022-12-08,00:00:00,0,0,0,FMN GV 05 Lier
60,Mechelsesteenweg 365,2022-12-08,01:00:00,0,0,0,FMN GV 05 Lier
60,Mechelsesteenweg 365,2022-12-08,02:00:00,0,0,0,FMN GV 05 Lier
60,Mechelsesteenweg 365,2022-12-08,03:00:00,0,0,0,FMN GV 05 Lier
60,Mechelsesteenweg 365,2022-12-08,04:00:00,0,0,0,FMN GV 05 Lier
60,Mechelsesteenweg 365,2022-12-08,05:00:00,2,0,2,FMN GV 05 Lier
60,Mechelsesteenweg 365,2022-12-08,06:00:00,16,4,12,FMN GV 05 Lier
60,Mechelsesteenweg 365,2022-12-08,07:00:00,60,28,32,FMN GV 05 Lier
60,Mechelsesteenweg 365,2022-12-08,08:00:00,60,40,20,FMN GV 05 Lier
60,Mechelsesteenweg 365,2022-12-08,09:00:00,34,20,14,FMN GV 05 Lier
60,Mechelsesteenweg 365,2022-12-08,10:00:00,44,12,32,FMN GV 05 Lier
60,Mechelsesteenweg 365,2022-12-08,11:00:00,42,10,32,FMN GV 05 Lier
60,Mechelsesteenweg 365,2022-12-08,12:00:00,56,10,46,FMN GV 05 Lier
60,Mechelsesteenweg 365,2022-12-08,13:00:00,38,22,16,FMN GV 05 Lier
60,Mechelsesteenweg 365,2022-12-08,14:00:00,26,8,18,FMN GV 05 Lier
60,Mechelsesteenweg 365,2022-12-08,15:00:00,30,12,18,FMN GV 05 Lier
60,Mechelsesteenweg 365,2022-12-08,16:00:00,48,34,14,FMN GV 05 Lier
60,Mechelsesteenweg 365,2022-12-08,17:00:00,46,36,10,FMN GV 05 Lier
60,Mechelsesteenweg 365,2022-12-08,18:00:00,18,10,8,FMN GV 05 Lier
60,Mechelsesteenweg 365,2022-12-08,19:00:00,12,8,4,FMN GV 05 Lier
60,Mechelsesteenweg 365,2022-12-08,20:00:00,4,2,2,FMN GV 05 Lier
60,Mechelsesteenweg 365,2022-12-08,21:00:00,4,2,2,FMN GV 05 Lier
60,Mechelsesteenweg 365,2022-12-08,22:00:00,0,0,0,FMN GV 05 Lier
60,Mechelsesteenweg 365,2022-12-08,23:00:00,0,0,0,FMN GV 05 Lier
60,Mechelsesteenweg 365,2022-12-09,00:00:00,0,0,0,FMN GV 05 Lier
60,Mechelsesteenweg 365,2022-12-09,01:00:00,0,0,0,FMN GV 05 Lier
60,Mechelsesteenweg 365,2022-12-09,02:00:00,0,0,0,FMN GV 05 Lier
60,Mechelsesteenweg 365,2022-12-09,03:00:00,0,0,0,FMN GV 05 Lier
60,Mechelsesteenweg 365,2022-12-09,04:00:00,0,0,0,FMN GV 05 Lier
60,Mechelsesteenweg 365,2022-12-09,05:00:00,0,0,0,FMN GV 05 Lier
60,Mechelsesteenweg 365,2022-12-09,06:00:00,16,10,6,FMN GV 05 Lier
60,Mechelsesteenweg 365,2022-12-09,07:00:00,30,18,12,FMN GV 05 Lier
60,Mechelsesteenweg 365,2022-12-09,08:00:00,38,24,14,FMN GV 05 Lier
60,Mechelsesteenweg 365,2022-12-09,09:00:00,10,2,8,FMN GV 05 Lier
60,Mechelsesteenweg 365,2022-12-09,10:00:00,24,6,18,FMN GV 05 Lier
60,Mechelsesteenweg 365,2022-12-09,11:00:00,34,14,20,FMN GV 05 Lier
60,Mechelsesteenweg 365,2022-12-09,12:00:00,54,8,46,FMN GV 05 Lier
60,Mechelsesteenweg 365,2022-12-09,13:00:00,48,26,22,FMN GV 05 Lier
60,Mechelsesteenweg 365,2022-12-09,14:00:00,34,20,14,FMN GV 05 Lier
60,Mechelsesteenweg 365,2022-12-09,15:00:00,56,26,30,FMN GV 05 Lier
60,Mechelsesteenweg 365,2022-12-09,16:00:00,68,36,32,FMN GV 05 Lier
60,Mechelsesteenweg 365,2022-12-09,17:00:00,14,8,6,FMN GV 05 Lier
60,Mechelsesteenweg 365,2022-12-09,18:00:00,2,2,0,FMN GV 05 Lier
60,Mechelsesteenweg 365,2022-12-09,19:00:00,2,0,2,FMN GV 05 Lier
60,Mechelsesteenweg 365,2022-12-09,20:00:00,0,0,0,FMN GV 05 Lier
60,Mechelsesteenweg 365,2022-12-09,21:00:00,2,0,2,FMN GV 05 Lier
60,Mechelsesteenweg 365,2022-12-09,22:00:00,4,2,2,FMN GV 05 Lier
60,Mechelsesteenweg 365,2022-12-09,23:00:00,0,0,0,FMN GV 05 Lier
60,Mechelsesteenweg 365,2022-12-10,00:00:00,0,0,0,FMN GV 05 Lier
60,Mechelsesteenweg 365,2022-12-10,01:00:00,0,0,0,FMN GV 05 Lier
60,Mechelsesteenweg 365,2022-12-10,02:00:00,0,0,0,FMN GV 05 Lier
60,Mechelsesteenweg 365,2022-12-10,03:00:00,0,0,0,FMN GV 05 Lier
60,Mechelsesteenweg 365,2022-12-10,04:00:00,0,0,0,FMN GV 05 Lier
60,Mechelsesteenweg 365,2022-12-10,05:00:00,0,0,0,FMN GV 05 Lier
60,Mechelsesteenweg 365,2022-12-10,06:00:00,2,0,2,FMN GV 05 Lier
60,Mechelsesteenweg 365,2022-12-10,07:00:00,0,0,0,FMN GV 05 Lier
60,Mechelsesteenweg 365,2022-12-10,08:00:00,4,0,4,FMN GV 05 Lier
60,Mechelsesteenweg 365,2022-12-10,09:00:00,8,0,8,FMN GV 05 Lier
60,Mechelsesteenweg 365,2022-12-10,10:00:00,6,0,6,FMN GV 05 Lier
60,Mechelsesteenweg 365,2022-12-10,11:00:00,16,6,10,FMN GV 05 Lier
60,Mechelsesteenweg 365,2022-12-10,12:00:00,20,8,12,FMN GV 05 Lier
60,Mechelsesteenweg 365,2022-12-10,13:00:00,34,16,18,FMN GV 05 Lier
60,Mechelsesteenweg 365,2022-12-10,14:00:00,22,6,16,FMN GV 05 Lier
60,Mechelsesteenweg 365,2022-12-10,15:00:00,24,18,6,FMN GV 05 Lier
60,Mechelsesteenweg 365,2022-12-10,16:00:00,8,2,6,FMN GV 05 Lier
60,Mechelsesteenweg 365,2022-12-10,17:00:00,6,2,4,FMN GV 05 Lier
60,Mechelsesteenweg 365,2022-12-10,18:00:00,2,2,0,FMN GV 05 Lier
60,Mechelsesteenweg 365,2022-12-10,19:00:00,2,2,0,FMN GV 05 Lier
60,Mechelsesteenweg 365,2022-12-10,20:00:00,0,0,0,FMN GV 05 Lier
60,Mechelsesteenweg 365,2022-12-10,21:00:00,0,0,0,FMN GV 05 Lier
60,Mechelsesteenweg 365,2022-12-10,22:00:00,2,2,0,FMN GV 05 Lier
60,Mechelsesteenweg 365,2022-12-10,23:00:00,0,0,0,FMN GV 05 Lier
60,Mechelsesteenweg 365,2022-12-11,00:00:00,6,4,2,FMN GV 05 Lier
60,Mechelsesteenweg 365,2022-12-11,01:00:00,0,0,0,FMN GV 05 Lier
60,Mechelsesteenweg 365,2022-12-11,02:00:00,0,0,0,FMN GV 05 Lier
60,Mechelsesteenweg 365,2022-12-11,03:00:00,0,0,0,FMN GV 05 Lier
60,Mechelsesteenweg 365,2022-12-11,04:00:00,0,0,0,FMN GV 05 Lier
60,Mechelsesteenweg 365,2022-12-11,05:00:00,0,0,0,FMN GV 05 Lier
60,Mechelsesteenweg 365,2022-12-11,06:00:00,2,2,0,FMN GV 05 Lier
60,Mechelsesteenweg 365,2022-12-11,07:00:00,0,0,0,FMN GV 05 Lier
60,Mechelsesteenweg 365,2022-12-11,08:00:00,4,2,2,FMN GV 05 Lier
60,Mechelsesteenweg 365,2022-12-11,09:00:00,14,8,6,FMN GV 05 Lier
60,Mechelsesteenweg 365,2022-12-11,10:00:00,30,16,14,FMN GV 05 Lier
60,Mechelsesteenweg 365,2022-12-11,11:00:00,38,18,20,FMN GV 05 Lier
60,Mechelsesteenweg 365,2022-12-11,12:00:00,44,20,24,FMN GV 05 Lier
60,Mechelsesteenweg 365,2022-12-11,13:00:00,40,16,24,FMN GV 05 Lier
60,Mechelsesteenweg 365,2022-12-11,14:00:00,40,20,20,FMN GV 05 Lier
60,Mechelsesteenweg 365,2022-12-11,15:00:00,28,14,14,FMN GV 05 Lier
60,Mechelsesteenweg 365,2022-12-11,16:00:00,8,4,4,FMN GV 05 Lier
60,Mechelsesteenweg 365,2022-12-11,17:00:00,2,0,2,FMN GV 05 Lier
60,Mechelsesteenweg 365,2022-12-11,18:00:00,0,0,0,FMN GV 05 Lier
60,Mechelsesteenweg 365,2022-12-11,19:00:00,0,0,0,FMN GV 05 Lier
60,Mechelsesteenweg 365,2022-12-11,20:00:00,2,2,0,FMN GV 05 Lier
60,Mechelsesteenweg 365,2022-12-11,21:00:00,0,0,0,FMN GV 05 Lier
60,Mechelsesteenweg 365,2022-12-11,22:00:00,2,2,0,FMN GV 05 Lier
60,Mechelsesteenweg 365,2022-12-11,23:00:00,0,0,0,FMN GV 05 Lier
60,Mechelsesteenweg 365,2022-12-12,00:00:00,0,0,0,FMN GV 05 Lier
60,Mechelsesteenweg 365,2022-12-12,01:00:00,0,0,0,FMN GV 05 Lier
60,Mechelsesteenweg 365,2022-12-12,02:00:00,0,0,0,FMN GV 05 Lier
60,Mechelsesteenweg 365,2022-12-12,03:00:00,0,0,0,FMN GV 05 Lier
60,Mechelsesteenweg 365,2022-12-12,04:00:00,0,0,0,FMN GV 05 Lier
60,Mechelsesteenweg 365,2022-12-12,05:00:00,0,0,0,FMN GV 05 Lier
60,Mechelsesteenweg 365,2022-12-12,06:00:00,6,4,2,FMN GV 05 Lier
60,Mechelsesteenweg 365,2022-12-12,07:00:00,18,6,12,FMN GV 05 Lier
60,Mechelsesteenweg 365,2022-12-12,08:00:00,26,16,10,FMN GV 05 Lier
60,Mechelsesteenweg 365,2022-12-12,09:00:00,2,2,0,FMN GV 05 Lier
60,Mechelsesteenweg 365,2022-12-12,10:00:00,12,4,8,FMN GV 05 Lier
60,Mechelsesteenweg 365,2022-12-12,11:00:00,24,14,10,FMN GV 05 Lier
60,Mechelsesteenweg 365,2022-12-12,12:00:00,64,10,54,FMN GV 05 Lier
60,Mechelsesteenweg 365,2022-12-12,13:00:00,40,24,16,FMN GV 05 Lier
60,Mechelsesteenweg 365,2022-12-12,14:00:00,46,26,20,FMN GV 05 Lier
60,Mechelsesteenweg 365,2022-12-12,15:00:00,50,26,24,FMN GV 05 Lier
60,Mechelsesteenweg 365,2022-12-12,16:00:00,56,22,34,FMN GV 05 Lier
60,Mechelsesteenweg 365,2022-12-12,17:00:00,40,26,14,FMN GV 05 Lier
60,Mechelsesteenweg 365,2022-12-12,18:00:00,6,6,0,FMN GV 05 Lier
60,Mechelsesteenweg 365,2022-12-12,19:00:00,0,0,0,FMN GV 05 Lier
60,Mechelsesteenweg 365,2022-12-12,20:00:00,2,0,2,FMN GV 05 Lier
60,Mechelsesteenweg 365,2022-12-12,21:00:00,6,0,6,FMN GV 05 Lier
60,Mechelsesteenweg 365,2022-12-12,22:00:00,2,2,0,FMN GV 05 Lier
60,Mechelsesteenweg 365,2022-12-12,23:00:00,4,4,0,FMN GV 05 Lier
60,Mechelsesteenweg 365,2022-12-13,00:00:00,0,0,0,FMN GV 05 Lier
60,Mechelsesteenweg 365,2022-12-13,01:00:00,0,0,0,FMN GV 05 Lier
60,Mechelsesteenweg 365,2022-12-13,02:00:00,0,0,0,FMN GV 05 Lier
60,Mechelsesteenweg 365,2022-12-13,03:00:00,0,0,0,FMN GV 05 Lier
60,Mechelsesteenweg 365,2022-12-13,04:00:00,2,0,2,FMN GV 05 Lier
60,Mechelsesteenweg 365,2022-12-13,05:00:00,0,0,0,FMN GV 05 Lier
60,Mechelsesteenweg 365,2022-12-13,06:00:00,4,0,4,FMN GV 05 Lier
60,Mechelsesteenweg 365,2022-12-13,07:00:00,22,8,14,FMN GV 05 Lier
60,Mechelsesteenweg 365,2022-12-13,08:00:00,24,16,8,FMN GV 05 Lier
60,Mechelsesteenweg 365,2022-12-13,09:00:00,4,0,4,FMN GV 05 Lier
60,Mechelsesteenweg 365,2022-12-13,10:00:00,20,6,14,FMN GV 05 Lier
60,Mechelsesteenweg 365,2022-12-13,11:00:00,28,4,24,FMN GV 05 Lier
60,Mechelsesteenweg 365,2022-12-13,12:00:00,32,10,22,FMN GV 05 Lier
60,Mechelsesteenweg 365,2022-12-13,13:00:00,42,18,24,FMN GV 05 Lier
60,Mechelsesteenweg 365,2022-12-13,14:00:00,38,18,20,FMN GV 05 Lier
60,Mechelsesteenweg 365,2022-12-13,15:00:00,20,14,6,FMN GV 05 Lier
60,Mechelsesteenweg 365,2022-12-13,16:00:00,44,20,24,FMN GV 05 Lier
60,Mechelsesteenweg 365,2022-12-13,17:00:00,36,28,8,FMN GV 05 Lier
60,Mechelsesteenweg 365,2022-12-13,18:00:00,10,8,2,FMN GV 05 Lier
60,Mechelsesteenweg 365,2022-12-13,19:00:00,4,4,0,FMN GV 05 Lier
60,Mechelsesteenweg 365,2022-12-13,20:00:00,2,0,2,FMN GV 05 Lier
60,Mechelsesteenweg 365,2022-12-13,21:00:00,4,2,2,FMN GV 05 Lier
60,Mechelsesteenweg 365,2022-12-13,22:00:00,0,0,0,FMN GV 05 Lier
60,Mechelsesteenweg 365,2022-12-13,23:00:00,0,0,0,FMN GV 05 Lier
60,Mechelsesteenweg 365,2022-12-14,00:00:00,0,0,0,FMN GV 05 Lier
60,Mechelsesteenweg 365,2022-12-14,01:00:00,0,0,0,FMN GV 05 Lier
60,Mechelsesteenweg 365,2022-12-14,02:00:00,0,0,0,FMN GV 05 Lier
60,Mechelsesteenweg 365,2022-12-14,03:00:00,0,0,0,FMN GV 05 Lier
60,Mechelsesteenweg 365,2022-12-14,04:00:00,2,0,2,FMN GV 05 Lier
60,Mechelsesteenweg 365,2022-12-14,05:00:00,0,0,0,FMN GV 05 Lier
60,Mechelsesteenweg 365,2022-12-14,06:00:00,8,4,4,FMN GV 05 Lier
60,Mechelsesteenweg 365,2022-12-14,07:00:00,20,6,14,FMN GV 05 Lier
60,Mechelsesteenweg 365,2022-12-14,08:00:00,28,22,6,FMN GV 05 Lier
60,Mechelsesteenweg 365,2022-12-14,09:00:00,6,4,2,FMN GV 05 Lier
60,Mechelsesteenweg 365,2022-12-14,10:00:00,16,4,12,FMN GV 05 Lier
60,Mechelsesteenweg 365,2022-12-14,11:00:00,24,6,18,FMN GV 05 Lier
60,Mechelsesteenweg 365,2022-12-14,12:00:00,48,20,28,FMN GV 05 Lier
60,Mechelsesteenweg 365,2022-12-14,13:00:00,28,18,10,FMN GV 05 Lier
60,Mechelsesteenweg 365,2022-12-14,14:00:00,32,8,24,FMN GV 05 Lier
60,Mechelsesteenweg 365,2022-12-14,15:00:00,42,28,14,FMN GV 05 Lier
60,Mechelsesteenweg 365,2022-12-14,16:00:00,26,18,8,FMN GV 05 Lier
60,Mechelsesteenweg 365,2022-12-14,17:00:00,12,8,4,FMN GV 05 Lier
60,Mechelsesteenweg 365,2022-12-14,18:00:00,6,4,2,FMN GV 05 Lier
60,Mechelsesteenweg 365,2022-12-14,19:00:00,2,0,2,FMN GV 05 Lier
60,Mechelsesteenweg 365,2022-12-14,20:00:00,0,0,0,FMN GV 05 Lier
60,Mechelsesteenweg 365,2022-12-14,21:00:00,0,0,0,FMN GV 05 Lier
60,Mechelsesteenweg 365,2022-12-14,22:00:00,2,0,2,FMN GV 05 Lier
60,Mechelsesteenweg 365,2022-12-14,23:00:00,0,0,0,FMN GV 05 Lier
60,Mechelsesteenweg 365,2022-12-15,00:00:00,0,0,0,FMN GV 05 Lier
60,Mechelsesteenweg 365,2022-12-15,01:00:00,0,0,0,FMN GV 05 Lier
60,Mechelsesteenweg 365,2022-12-15,02:00:00,0,0,0,FMN GV 05 Lier
60,Mechelsesteenweg 365,2022-12-15,03:00:00,0,0,0,FMN GV 05 Lier
60,Mechelsesteenweg 365,2022-12-15,04:00:00,0,0,0,FMN GV 05 Lier
60,Mechelsesteenweg 365,2022-12-15,05:00:00,0,0,0,FMN GV 05 Lier
60,Mechelsesteenweg 365,2022-12-15,06:00:00,8,2,6,FMN GV 05 Lier
60,Mechelsesteenweg 365,2022-12-15,07:00:00,20,8,12,FMN GV 05 Lier
60,Mechelsesteenweg 365,2022-12-15,08:00:00,18,8,10,FMN GV 05 Lier
60,Mechelsesteenweg 365,2022-12-15,09:00:00,8,2,6,FMN GV 05 Lier
60,Mechelsesteenweg 365,2022-12-15,10:00:00,34,6,28,FMN GV 05 Lier
60,Mechelsesteenweg 365,2022-12-15,11:00:00,12,6,6,FMN GV 05 Lier
60,Mechelsesteenweg 365,2022-12-15,12:00:00,46,18,28,FMN GV 05 Lier
60,Mechelsesteenweg 365,2022-12-15,13:00:00,38,22,16,FMN GV 05 Lier
60,Mechelsesteenweg 365,2022-12-15,14:00:00,50,26,24,FMN GV 05 Lier
60,Mechelsesteenweg 365,2022-12-15,15:00:00,58,24,34,FMN GV 05 Lier
60,Mechelsesteenweg 365,2022-12-15,16:00:00,40,28,12,FMN GV 05 Lier
60,Mechelsesteenweg 365,2022-12-15,17:00:00,30,22,8,FMN GV 05 Lier
60,Mechelsesteenweg 365,2022-12-15,18:00:00,4,2,2,FMN GV 05 Lier
60,Mechelsesteenweg 365,2022-12-15,19:00:00,4,4,0,FMN GV 05 Lier
60,Mechelsesteenweg 365,2022-12-15,20:00:00,0,0,0,FMN GV 05 Lier
60,Mechelsesteenweg 365,2022-12-15,21:00:00,2,2,0,FMN GV 05 Lier
60,Mechelsesteenweg 365,2022-12-15,22:00:00,0,0,0,FMN GV 05 Lier
60,Mechelsesteenweg 365,2022-12-15,23:00:00,2,0,2,FMN GV 05 Lier
60,Mechelsesteenweg 365,2022-12-16,00:00:00,0,0,0,FMN GV 05 Lier
60,Mechelsesteenweg 365,2022-12-16,01:00:00,0,0,0,FMN GV 05 Lier
60,Mechelsesteenweg 365,2022-12-16,02:00:00,0,0,0,FMN GV 05 Lier
60,Mechelsesteenweg 365,2022-12-16,03:00:00,0,0,0,FMN GV 05 Lier
60,Mechelsesteenweg 365,2022-12-16,04:00:00,0,0,0,FMN GV 05 Lier
60,Mechelsesteenweg 365,2022-12-16,05:00:00,2,0,2,FMN GV 05 Lier
60,Mechelsesteenweg 365,2022-12-16,06:00:00,4,0,4,FMN GV 05 Lier
60,Mechelsesteenweg 365,2022-12-16,07:00:00,4,2,2,FMN GV 05 Lier
60,Mechelsesteenweg 365,2022-12-16,08:00:00,36,22,14,FMN GV 05 Lier
60,Mechelsesteenweg 365,2022-12-16,09:00:00,14,2,12,FMN GV 05 Lier
60,Mechelsesteenweg 365,2022-12-16,10:00:00,24,4,20,FMN GV 05 Lier
60,Mechelsesteenweg 365,2022-12-16,11:00:00,12,6,6,FMN GV 05 Lier
60,Mechelsesteenweg 365,2022-12-16,12:00:00,10,6,4,FMN GV 05 Lier
60,Mechelsesteenweg 365,2022-12-16,13:00:00,42,14,28,FMN GV 05 Lier
60,Mechelsesteenweg 365,2022-12-16,14:00:00,38,20,18,FMN GV 05 Lier
60,Mechelsesteenweg 365,2022-12-16,15:00:00,60,34,26,FMN GV 05 Lier
60,Mechelsesteenweg 365,2022-12-16,16:00:00,30,18,12,FMN GV 05 Lier
60,Mechelsesteenweg 365,2022-12-16,17:00:00,12,4,8,FMN GV 05 Lier
60,Mechelsesteenweg 365,2022-12-16,18:00:00,0,0,0,FMN GV 05 Lier
60,Mechelsesteenweg 365,2022-12-16,19:00:00,2,0,2,FMN GV 05 Lier
60,Mechelsesteenweg 365,2022-12-16,20:00:00,2,0,2,FMN GV 05 Lier
60,Mechelsesteenweg 365,2022-12-16,21:00:00,2,2,0,FMN GV 05 Lier
60,Mechelsesteenweg 365,2022-12-16,22:00:00,0,0,0,FMN GV 05 Lier
60,Mechelsesteenweg 365,2022-12-16,23:00:00,0,0,0,FMN GV 05 Lier
60,Mechelsesteenweg 365,2022-12-17,00:00:00,0,0,0,FMN GV 05 Lier
60,Mechelsesteenweg 365,2022-12-17,01:00:00,0,0,0,FMN GV 05 Lier
60,Mechelsesteenweg 365,2022-12-17,02:00:00,0,0,0,FMN GV 05 Lier
60,Mechelsesteenweg 365,2022-12-17,03:00:00,0,0,0,FMN GV 05 Lier
60,Mechelsesteenweg 365,2022-12-17,04:00:00,0,0,0,FMN GV 05 Lier
60,Mechelsesteenweg 365,2022-12-17,05:00:00,0,0,0,FMN GV 05 Lier
60,Mechelsesteenweg 365,2022-12-17,06:00:00,2,0,2,FMN GV 05 Lier
60,Mechelsesteenweg 365,2022-12-17,07:00:00,2,2,0,FMN GV 05 Lier
60,Mechelsesteenweg 365,2022-12-17,08:00:00,4,2,2,FMN GV 05 Lier
60,Mechelsesteenweg 365,2022-12-17,09:00:00,4,2,2,FMN GV 05 Lier
60,Mechelsesteenweg 365,2022-12-17,10:00:00,4,2,2,FMN GV 05 Lier
60,Mechelsesteenweg 365,2022-12-17,11:00:00,16,8,8,FMN GV 05 Lier
60,Mechelsesteenweg 365,2022-12-17,12:00:00,18,6,12,FMN GV 05 Lier
60,Mechelsesteenweg 365,2022-12-17,13:00:00,18,8,10,FMN GV 05 Lier
60,Mechelsesteenweg 365,2022-12-17,14:00:00,16,8,8,FMN GV 05 Lier
60,Mechelsesteenweg 365,2022-12-17,15:00:00,30,12,18,FMN GV 05 Lier
60,Mechelsesteenweg 365,2022-12-17,16:00:00,6,6,0,FMN GV 05 Lier
60,Mechelsesteenweg 365,2022-12-17,17:00:00,6,4,2,FMN GV 05 Lier
60,Mechelsesteenweg 365,2022-12-17,18:00:00,0,0,0,FMN GV 05 Lier
60,Mechelsesteenweg 365,2022-12-17,19:00:00,2,0,2,FMN GV 05 Lier
60,Mechelsesteenweg 365,2022-12-17,20:00:00,0,0,0,FMN GV 05 Lier
60,Mechelsesteenweg 365,2022-12-17,21:00:00,2,2,0,FMN GV 05 Lier
60,Mechelsesteenweg 365,2022-12-17,22:00:00,0,0,0,FMN GV 05 Lier
60,Mechelsesteenweg 365,2022-12-17,23:00:00,2,2,0,FMN GV 05 Lier
60,Mechelsesteenweg 365,2022-12-18,00:00:00,0,0,0,FMN GV 05 Lier
60,Mechelsesteenweg 365,2022-12-18,01:00:00,0,0,0,FMN GV 05 Lier
60,Mechelsesteenweg 365,2022-12-18,02:00:00,0,0,0,FMN GV 05 Lier
60,Mechelsesteenweg 365,2022-12-18,03:00:00,0,0,0,FMN GV 05 Lier
60,Mechelsesteenweg 365,2022-12-18,04:00:00,0,0,0,FMN GV 05 Lier
60,Mechelsesteenweg 365,2022-12-18,05:00:00,0,0,0,FMN GV 05 Lier
60,Mechelsesteenweg 365,2022-12-18,06:00:00,0,0,0,FMN GV 05 Lier
60,Mechelsesteenweg 365,2022-12-18,07:00:00,0,0,0,FMN GV 05 Lier
60,Mechelsesteenweg 365,2022-12-18,08:00:00,0,0,0,FMN GV 05 Lier
60,Mechelsesteenweg 365,2022-12-18,09:00:00,0,0,0,FMN GV 05 Lier
60,Mechelsesteenweg 365,2022-12-18,10:00:00,4,4,0,FMN GV 05 Lier
60,Mechelsesteenweg 365,2022-12-18,11:00:00,10,2,8,FMN GV 05 Lier
60,Mechelsesteenweg 365,2022-12-18,12:00:00,14,6,8,FMN GV 05 Lier
60,Mechelsesteenweg 365,2022-12-18,13:00:00,12,6,6,FMN GV 05 Lier
60,Mechelsesteenweg 365,2022-12-18,14:00:00,24,10,14,FMN GV 05 Lier
60,Mechelsesteenweg 365,2022-12-18,15:00:00,22,10,12,FMN GV 05 Lier
60,Mechelsesteenweg 365,2022-12-18,16:00:00,12,8,4,FMN GV 05 Lier
60,Mechelsesteenweg 365,2022-12-18,17:00:00,0,0,0,FMN GV 05 Lier
60,Mechelsesteenweg 365,2022-12-18,18:00:00,2,2,0,FMN GV 05 Lier
60,Mechelsesteenweg 365,2022-12-18,19:00:00,0,0,0,FMN GV 05 Lier
60,Mechelsesteenweg 365,2022-12-18,20:00:00,0,0,0,FMN GV 05 Lier
60,Mechelsesteenweg 365,2022-12-18,21:00:00,0,0,0,FMN GV 05 Lier
60,Mechelsesteenweg 365,2022-12-18,22:00:00,0,0,0,FMN GV 05 Lier
60,Mechelsesteenweg 365,2022-12-18,23:00:00,0,0,0,FMN GV 05 Lier
60,Mechelsesteenweg 365,2022-12-19,00:00:00,0,0,0,FMN GV 05 Lier
60,Mechelsesteenweg 365,2022-12-19,01:00:00,0,0,0,FMN GV 05 Lier
60,Mechelsesteenweg 365,2022-12-19,02:00:00,0,0,0,FMN GV 05 Lier
60,Mechelsesteenweg 365,2022-12-19,03:00:00,0,0,0,FMN GV 05 Lier
60,Mechelsesteenweg 365,2022-12-19,04:00:00,0,0,0,FMN GV 05 Lier
60,Mechelsesteenweg 365,2022-12-19,05:00:00,0,0,0,FMN GV 05 Lier
60,Mechelsesteenweg 365,2022-12-19,06:00:00,2,2,0,FMN GV 05 Lier
60,Mechelsesteenweg 365,2022-12-19,07:00:00,26,14,12,FMN GV 05 Lier
60,Mechelsesteenweg 365,2022-12-19,08:00:00,44,16,28,FMN GV 05 Lier
60,Mechelsesteenweg 365,2022-12-19,09:00:00,14,6,8,FMN GV 05 Lier
60,Mechelsesteenweg 365,2022-12-19,10:00:00,16,6,10,FMN GV 05 Lier
60,Mechelsesteenweg 365,2022-12-19,11:00:00,20,10,10,FMN GV 05 Lier
60,Mechelsesteenweg 365,2022-12-19,12:00:00,28,10,18,FMN GV 05 Lier
60,Mechelsesteenweg 365,2022-12-19,13:00:00,26,6,20,FMN GV 05 Lier
60,Mechelsesteenweg 365,2022-12-19,14:00:00,18,12,6,FMN GV 05 Lier
60,Mechelsesteenweg 365,2022-12-19,15:00:00,30,12,18,FMN GV 05 Lier
60,Mechelsesteenweg 365,2022-12-19,16:00:00,46,28,18,FMN GV 05 Lier
60,Mechelsesteenweg 365,2022-12-19,17:00:00,34,20,14,FMN GV 05 Lier
60,Mechelsesteenweg 365,2022-12-19,18:00:00,12,10,2,FMN GV 05 Lier
60,Mechelsesteenweg 365,2022-12-19,19:00:00,8,6,2,FMN GV 05 Lier
60,Mechelsesteenweg 365,2022-12-19,20:00:00,4,2,2,FMN GV 05 Lier
60,Mechelsesteenweg 365,2022-12-19,21:00:00,4,4,0,FMN GV 05 Lier
60,Mechelsesteenweg 365,2022-12-19,22:00:00,2,2,0,FMN GV 05 Lier
60,Mechelsesteenweg 365,2022-12-19,23:00:00,2,2,0,FMN GV 05 Lier
60,Mechelsesteenweg 365,2022-12-20,00:00:00,0,0,0,FMN GV 05 Lier
60,Mechelsesteenweg 365,2022-12-20,01:00:00,0,0,0,FMN GV 05 Lier
60,Mechelsesteenweg 365,2022-12-20,02:00:00,0,0,0,FMN GV 05 Lier
60,Mechelsesteenweg 365,2022-12-20,03:00:00,0,0,0,FMN GV 05 Lier
60,Mechelsesteenweg 365,2022-12-20,04:00:00,2,0,2,FMN GV 05 Lier
60,Mechelsesteenweg 365,2022-12-20,05:00:00,0,0,0,FMN GV 05 Lier
60,Mechelsesteenweg 365,2022-12-20,06:00:00,12,8,4,FMN GV 05 Lier
60,Mechelsesteenweg 365,2022-12-20,07:00:00,38,6,32,FMN GV 05 Lier
60,Mechelsesteenweg 365,2022-12-20,08:00:00,26,14,12,FMN GV 05 Lier
60,Mechelsesteenweg 365,2022-12-20,09:00:00,16,8,8,FMN GV 05 Lier
60,Mechelsesteenweg 365,2022-12-20,10:00:00,12,2,10,FMN GV 05 Lier
60,Mechelsesteenweg 365,2022-12-20,11:00:00,12,10,2,FMN GV 05 Lier
60,Mechelsesteenweg 365,2022-12-20,12:00:00,6,6,0,FMN GV 05 Lier
60,Mechelsesteenweg 365,2022-12-20,13:00:00,10,6,4,FMN GV 05 Lier
60,Mechelsesteenweg 365,2022-12-20,14:00:00,10,6,4,FMN GV 05 Lier
60,Mechelsesteenweg 365,2022-12-20,15:00:00,12,8,4,FMN GV 05 Lier
60,Mechelsesteenweg 365,2022-12-20,16:00:00,40,20,20,FMN GV 05 Lier
60,Mechelsesteenweg 365,2022-12-20,17:00:00,18,14,4,FMN GV 05 Lier
60,Mechelsesteenweg 365,2022-12-20,18:00:00,6,4,2,FMN GV 05 Lier
60,Mechelsesteenweg 365,2022-12-20,19:00:00,8,2,6,FMN GV 05 Lier
60,Mechelsesteenweg 365,2022-12-20,20:00:00,0,0,0,FMN GV 05 Lier
60,Mechelsesteenweg 365,2022-12-20,21:00:00,4,4,0,FMN GV 05 Lier
60,Mechelsesteenweg 365,2022-12-20,22:00:00,2,0,2,FMN GV 05 Lier
60,Mechelsesteenweg 365,2022-12-20,23:00:00,0,0,0,FMN GV 05 Lier
60,Mechelsesteenweg 365,2022-12-21,00:00:00,0,0,0,FMN GV 05 Lier
60,Mechelsesteenweg 365,2022-12-21,01:00:00,0,0,0,FMN GV 05 Lier
60,Mechelsesteenweg 365,2022-12-21,02:00:00,0,0,0,FMN GV 05 Lier
60,Mechelsesteenweg 365,2022-12-21,03:00:00,0,0,0,FMN GV 05 Lier
60,Mechelsesteenweg 365,2022-12-21,04:00:00,2,0,2,FMN GV 05 Lier
60,Mechelsesteenweg 365,2022-12-21,05:00:00,0,0,0,FMN GV 05 Lier
60,Mechelsesteenweg 365,2022-12-21,06:00:00,16,4,12,FMN GV 05 Lier
60,Mechelsesteenweg 365,2022-12-21,07:00:00,30,8,22,FMN GV 05 Lier
60,Mechelsesteenweg 365,2022-12-21,08:00:00,40,22,18,FMN GV 05 Lier
60,Mechelsesteenweg 365,2022-12-21,09:00:00,42,24,18,FMN GV 05 Lier
60,Mechelsesteenweg 365,2022-12-21,10:00:00,28,12,16,FMN GV 05 Lier
60,Mechelsesteenweg 365,2022-12-21,11:00:00,64,26,38,FMN GV 05 Lier
60,Mechelsesteenweg 365,2022-12-21,12:00:00,62,26,36,FMN GV 05 Lier
60,Mechelsesteenweg 365,2022-12-21,13:00:00,56,30,26,FMN GV 05 Lier
60,Mechelsesteenweg 365,2022-12-21,14:00:00,70,34,36,FMN GV 05 Lier
60,Mechelsesteenweg 365,2022-12-21,15:00:00,62,38,24,FMN GV 05 Lier
60,Mechelsesteenweg 365,2022-12-21,16:00:00,58,32,26,FMN GV 05 Lier
60,Mechelsesteenweg 365,2022-12-21,17:00:00,34,26,8,FMN GV 05 Lier
60,Mechelsesteenweg 365,2022-12-21,18:00:00,4,4,0,FMN GV 05 Lier
60,Mechelsesteenweg 365,2022-12-21,19:00:00,4,4,0,FMN GV 05 Lier
60,Mechelsesteenweg 365,2022-12-21,20:00:00,2,0,2,FMN GV 05 Lier
60,Mechelsesteenweg 365,2022-12-21,21:00:00,0,0,0,FMN GV 05 Lier
60,Mechelsesteenweg 365,2022-12-21,22:00:00,2,0,2,FMN GV 05 Lier
60,Mechelsesteenweg 365,2022-12-21,23:00:00,0,0,0,FMN GV 05 Lier
60,Mechelsesteenweg 365,2022-12-22,00:00:00,0,0,0,FMN GV 05 Lier
60,Mechelsesteenweg 365,2022-12-22,01:00:00,0,0,0,FMN GV 05 Lier
60,Mechelsesteenweg 365,2022-12-22,02:00:00,0,0,0,FMN GV 05 Lier
60,Mechelsesteenweg 365,2022-12-22,03:00:00,2,0,2,FMN GV 05 Lier
60,Mechelsesteenweg 365,2022-12-22,04:00:00,0,0,0,FMN GV 05 Lier
60,Mechelsesteenweg 365,2022-12-22,05:00:00,0,0,0,FMN GV 05 Lier
60,Mechelsesteenweg 365,2022-12-22,06:00:00,12,6,6,FMN GV 05 Lier
60,Mechelsesteenweg 365,2022-12-22,07:00:00,28,6,22,FMN GV 05 Lier
60,Mechelsesteenweg 365,2022-12-22,08:00:00,50,24,26,FMN GV 05 Lier
60,Mechelsesteenweg 365,2022-12-22,09:00:00,34,22,12,FMN GV 05 Lier
60,Mechelsesteenweg 365,2022-12-22,10:00:00,34,10,24,FMN GV 05 Lier
60,Mechelsesteenweg 365,2022-12-22,11:00:00,56,12,44,FMN GV 05 Lier
60,Mechelsesteenweg 365,2022-12-22,12:00:00,32,10,22,FMN GV 05 Lier
60,Mechelsesteenweg 365,2022-12-22,13:00:00,30,16,14,FMN GV 05 Lier
60,Mechelsesteenweg 365,2022-12-22,14:00:00,38,20,18,FMN GV 05 Lier
60,Mechelsesteenweg 365,2022-12-22,15:00:00,30,12,18,FMN GV 05 Lier
60,Mechelsesteenweg 365,2022-12-22,16:00:00,48,22,26,FMN GV 05 Lier
60,Mechelsesteenweg 365,2022-12-22,17:00:00,26,18,8,FMN GV 05 Lier
60,Mechelsesteenweg 365,2022-12-22,18:00:00,8,6,2,FMN GV 05 Lier
60,Mechelsesteenweg 365,2022-12-22,19:00:00,6,4,2,FMN GV 05 Lier
60,Mechelsesteenweg 365,2022-12-22,20:00:00,6,4,2,FMN GV 05 Lier
60,Mechelsesteenweg 365,2022-12-22,21:00:00,8,2,6,FMN GV 05 Lier
60,Mechelsesteenweg 365,2022-12-22,22:00:00,2,2,0,FMN GV 05 Lier
60,Mechelsesteenweg 365,2022-12-22,23:00:00,0,0,0,FMN GV 05 Lier
60,Mechelsesteenweg 365,2022-12-23,00:00:00,2,2,0,FMN GV 05 Lier
60,Mechelsesteenweg 365,2022-12-23,01:00:00,0,0,0,FMN GV 05 Lier
60,Mechelsesteenweg 365,2022-12-23,02:00:00,0,0,0,FMN GV 05 Lier
60,Mechelsesteenweg 365,2022-12-23,03:00:00,0,0,0,FMN GV 05 Lier
60,Mechelsesteenweg 365,2022-12-23,04:00:00,0,0,0,FMN GV 05 Lier
60,Mechelsesteenweg 365,2022-12-23,05:00:00,4,0,4,FMN GV 05 Lier
60,Mechelsesteenweg 365,2022-12-23,06:00:00,10,6,4,FMN GV 05 Lier
60,Mechelsesteenweg 365,2022-12-23,07:00:00,30,20,10,FMN GV 05 Lier
60,Mechelsesteenweg 365,2022-12-23,08:00:00,54,34,20,FMN GV 05 Lier
60,Mechelsesteenweg 365,2022-12-23,09:00:00,30,20,10,FMN GV 05 Lier
60,Mechelsesteenweg 365,2022-12-23,10:00:00,16,6,10,FMN GV 05 Lier
60,Mechelsesteenweg 365,2022-12-23,11:00:00,40,8,32,FMN GV 05 Lier
60,Mechelsesteenweg 365,2022-12-23,12:00:00,30,4,26,FMN GV 05 Lier
60,Mechelsesteenweg 365,2022-12-23,13:00:00,16,8,8,FMN GV 05 Lier
60,Mechelsesteenweg 365,2022-12-23,14:00:00,30,14,16,FMN GV 05 Lier
60,Mechelsesteenweg 365,2022-12-23,15:00:00,28,10,18,FMN GV 05 Lier
60,Mechelsesteenweg 365,2022-12-23,16:00:00,20,10,10,FMN GV 05 Lier
60,Mechelsesteenweg 365,2022-12-23,17:00:00,12,8,4,FMN GV 05 Lier
60,Mechelsesteenweg 365,2022-12-23,18:00:00,6,6,0,FMN GV 05 Lier
60,Mechelsesteenweg 365,2022-12-23,19:00:00,2,0,2,FMN GV 05 Lier
60,Mechelsesteenweg 365,2022-12-23,20:00:00,2,2,0,FMN GV 05 Lier
60,Mechelsesteenweg 365,2022-12-23,21:00:00,4,4,0,FMN GV 05 Lier
60,Mechelsesteenweg 365,2022-12-23,22:00:00,2,0,2,FMN GV 05 Lier
60,Mechelsesteenweg 365,2022-12-23,23:00:00,2,2,0,FMN GV 05 Lier
60,Mechelsesteenweg 365,2022-12-24,00:00:00,0,0,0,FMN GV 05 Lier
60,Mechelsesteenweg 365,2022-12-24,01:00:00,2,0,2,FMN GV 05 Lier
60,Mechelsesteenweg 365,2022-12-24,02:00:00,4,4,0,FMN GV 05 Lier
60,Mechelsesteenweg 365,2022-12-24,03:00:00,0,0,0,FMN GV 05 Lier
60,Mechelsesteenweg 365,2022-12-24,04:00:00,0,0,0,FMN GV 05 Lier
60,Mechelsesteenweg 365,2022-12-24,05:00:00,0,0,0,FMN GV 05 Lier
60,Mechelsesteenweg 365,2022-12-24,06:00:00,2,2,0,FMN GV 05 Lier
60,Mechelsesteenweg 365,2022-12-24,07:00:00,6,2,4,FMN GV 05 Lier
60,Mechelsesteenweg 365,2022-12-24,08:00:00,12,4,8,FMN GV 05 Lier
60,Mechelsesteenweg 365,2022-12-24,09:00:00,24,6,18,FMN GV 05 Lier
60,Mechelsesteenweg 365,2022-12-24,10:00:00,80,54,26,FMN GV 05 Lier
60,Mechelsesteenweg 365,2022-12-24,11:00:00,102,28,74,FMN GV 05 Lier
60,Mechelsesteenweg 365,2022-12-24,12:00:00,88,40,48,FMN GV 05 Lier
60,Mechelsesteenweg 365,2022-12-24,13:00:00,128,78,50,FMN GV 05 Lier
60,Mechelsesteenweg 365,2022-12-24,14:00:00,118,66,52,FMN GV 05 Lier
60,Mechelsesteenweg 365,2022-12-24,15:00:00,94,34,60,FMN GV 05 Lier
60,Mechelsesteenweg 365,2022-12-24,16:00:00,50,20,30,FMN GV 05 Lier
60,Mechelsesteenweg 365,2022-12-24,17:00:00,16,6,10,FMN GV 05 Lier
60,Mechelsesteenweg 365,2022-12-24,18:00:00,6,0,6,FMN GV 05 Lier
60,Mechelsesteenweg 365,2022-12-24,19:00:00,0,0,0,FMN GV 05 Lier
60,Mechelsesteenweg 365,2022-12-24,20:00:00,2,2,0,FMN GV 05 Lier
60,Mechelsesteenweg 365,2022-12-24,21:00:00,0,0,0,FMN GV 05 Lier
60,Mechelsesteenweg 365,2022-12-24,22:00:00,0,0,0,FMN GV 05 Lier
60,Mechelsesteenweg 365,2022-12-24,23:00:00,2,0,2,FMN GV 05 Lier
60,Mechelsesteenweg 365,2022-12-25,00:00:00,2,2,0,FMN GV 05 Lier
60,Mechelsesteenweg 365,2022-12-25,01:00:00,0,0,0,FMN GV 05 Lier
60,Mechelsesteenweg 365,2022-12-25,02:00:00,0,0,0,FMN GV 05 Lier
60,Mechelsesteenweg 365,2022-12-25,03:00:00,0,0,0,FMN GV 05 Lier
60,Mechelsesteenweg 365,2022-12-25,04:00:00,0,0,0,FMN GV 05 Lier
60,Mechelsesteenweg 365,2022-12-25,05:00:00,0,0,0,FMN GV 05 Lier
60,Mechelsesteenweg 365,2022-12-25,06:00:00,4,2,2,FMN GV 05 Lier
60,Mechelsesteenweg 365,2022-12-25,07:00:00,0,0,0,FMN GV 05 Lier
60,Mechelsesteenweg 365,2022-12-25,08:00:00,0,0,0,FMN GV 05 Lier
60,Mechelsesteenweg 365,2022-12-25,09:00:00,22,8,14,FMN GV 05 Lier
60,Mechelsesteenweg 365,2022-12-25,10:00:00,8,4,4,FMN GV 05 Lier
60,Mechelsesteenweg 365,2022-12-25,11:00:00,10,10,0,FMN GV 05 Lier
60,Mechelsesteenweg 365,2022-12-25,12:00:00,6,2,4,FMN GV 05 Lier
60,Mechelsesteenweg 365,2022-12-25,13:00:00,4,2,2,FMN GV 05 Lier
60,Mechelsesteenweg 365,2022-12-25,14:00:00,12,8,4,FMN GV 05 Lier
60,Mechelsesteenweg 365,2022-12-25,15:00:00,14,2,12,FMN GV 05 Lier
60,Mechelsesteenweg 365,2022-12-25,16:00:00,8,4,4,FMN GV 05 Lier
60,Mechelsesteenweg 365,2022-12-25,17:00:00,4,2,2,FMN GV 05 Lier
60,Mechelsesteenweg 365,2022-12-25,18:00:00,0,0,0,FMN GV 05 Lier
60,Mechelsesteenweg 365,2022-12-25,19:00:00,0,0,0,FMN GV 05 Lier
60,Mechelsesteenweg 365,2022-12-25,20:00:00,0,0,0,FMN GV 05 Lier
60,Mechelsesteenweg 365,2022-12-25,21:00:00,2,2,0,FMN GV 05 Lier
60,Mechelsesteenweg 365,2022-12-25,22:00:00,0,0,0,FMN GV 05 Lier
60,Mechelsesteenweg 365,2022-12-25,23:00:00,0,0,0,FMN GV 05 Lier
60,Mechelsesteenweg 365,2022-12-26,00:00:00,0,0,0,FMN GV 05 Lier
60,Mechelsesteenweg 365,2022-12-26,01:00:00,0,0,0,FMN GV 05 Lier
60,Mechelsesteenweg 365,2022-12-26,02:00:00,0,0,0,FMN GV 05 Lier
60,Mechelsesteenweg 365,2022-12-26,03:00:00,0,0,0,FMN GV 05 Lier
60,Mechelsesteenweg 365,2022-12-26,04:00:00,0,0,0,FMN GV 05 Lier
60,Mechelsesteenweg 365,2022-12-26,05:00:00,4,0,4,FMN GV 05 Lier
60,Mechelsesteenweg 365,2022-12-26,06:00:00,12,4,8,FMN GV 05 Lier
60,Mechelsesteenweg 365,2022-12-26,07:00:00,6,4,2,FMN GV 05 Lier
60,Mechelsesteenweg 365,2022-12-26,08:00:00,8,6,2,FMN GV 05 Lier
60,Mechelsesteenweg 365,2022-12-26,09:00:00,16,8,8,FMN GV 05 Lier
60,Mechelsesteenweg 365,2022-12-26,10:00:00,12,4,8,FMN GV 05 Lier
60,Mechelsesteenweg 365,2022-12-26,11:00:00,32,20,12,FMN GV 05 Lier
60,Mechelsesteenweg 365,2022-12-26,12:00:00,32,16,16,FMN GV 05 Lier
60,Mechelsesteenweg 365,2022-12-26,13:00:00,52,26,26,FMN GV 05 Lier
60,Mechelsesteenweg 365,2022-12-26,14:00:00,76,50,26,FMN GV 05 Lier
60,Mechelsesteenweg 365,2022-12-26,15:00:00,60,30,30,FMN GV 05 Lier
60,Mechelsesteenweg 365,2022-12-26,16:00:00,38,12,26,FMN GV 05 Lier
60,Mechelsesteenweg 365,2022-12-26,17:00:00,16,10,6,FMN GV 05 Lier
60,Mechelsesteenweg 365,2022-12-26,18:00:00,0,0,0,FMN GV 05 Lier
60,Mechelsesteenweg 365,2022-12-26,19:00:00,0,0,0,FMN GV 05 Lier
60,Mechelsesteenweg 365,2022-12-26,20:00:00,0,0,0,FMN GV 05 Lier
60,Mechelsesteenweg 365,2022-12-26,21:00:00,0,0,0,FMN GV 05 Lier
60,Mechelsesteenweg 365,2022-12-26,22:00:00,0,0,0,FMN GV 05 Lier
60,Mechelsesteenweg 365,2022-12-26,23:00:00,2,2,0,FMN GV 05 Lier
60,Mechelsesteenweg 365,2022-12-27,00:00:00,0,0,0,FMN GV 05 Lier
60,Mechelsesteenweg 365,2022-12-27,01:00:00,2,0,2,FMN GV 05 Lier
60,Mechelsesteenweg 365,2022-12-27,02:00:00,0,0,0,FMN GV 05 Lier
60,Mechelsesteenweg 365,2022-12-27,03:00:00,0,0,0,FMN GV 05 Lier
60,Mechelsesteenweg 365,2022-12-27,04:00:00,0,0,0,FMN GV 05 Lier
60,Mechelsesteenweg 365,2022-12-27,05:00:00,0,0,0,FMN GV 05 Lier
60,Mechelsesteenweg 365,2022-12-27,06:00:00,2,0,2,FMN GV 05 Lier
60,Mechelsesteenweg 365,2022-12-27,07:00:00,4,0,4,FMN GV 05 Lier
60,Mechelsesteenweg 365,2022-12-27,08:00:00,8,4,4,FMN GV 05 Lier
60,Mechelsesteenweg 365,2022-12-27,09:00:00,34,18,16,FMN GV 05 Lier
60,Mechelsesteenweg 365,2022-12-27,10:00:00,74,30,44,FMN GV 05 Lier
60,Mechelsesteenweg 365,2022-12-27,11:00:00,106,62,44,FMN GV 05 Lier
60,Mechelsesteenweg 365,2022-12-27,12:00:00,106,66,40,FMN GV 05 Lier
60,Mechelsesteenweg 365,2022-12-27,13:00:00,108,56,52,FMN GV 05 Lier
60,Mechelsesteenweg 365,2022-12-27,14:00:00,84,42,42,FMN GV 05 Lier
60,Mechelsesteenweg 365,2022-12-27,15:00:00,64,30,34,FMN GV 05 Lier
60,Mechelsesteenweg 365,2022-12-27,16:00:00,62,26,36,FMN GV 05 Lier
60,Mechelsesteenweg 365,2022-12-27,17:00:00,18,10,8,FMN GV 05 Lier
60,Mechelsesteenweg 365,2022-12-27,18:00:00,2,2,0,FMN GV 05 Lier
60,Mechelsesteenweg 365,2022-12-27,19:00:00,4,2,2,FMN GV 05 Lier
60,Mechelsesteenweg 365,2022-12-27,20:00:00,0,0,0,FMN GV 05 Lier
60,Mechelsesteenweg 365,2022-12-27,21:00:00,4,2,2,FMN GV 05 Lier
60,Mechelsesteenweg 365,2022-12-27,22:00:00,0,0,0,FMN GV 05 Lier
60,Mechelsesteenweg 365,2022-12-27,23:00:00,0,0,0,FMN GV 05 Lier
60,Mechelsesteenweg 365,2022-12-28,00:00:00,0,0,0,FMN GV 05 Lier
60,Mechelsesteenweg 365,2022-12-28,01:00:00,0,0,0,FMN GV 05 Lier
60,Mechelsesteenweg 365,2022-12-28,02:00:00,4,4,0,FMN GV 05 Lier
60,Mechelsesteenweg 365,2022-12-28,03:00:00,0,0,0,FMN GV 05 Lier
60,Mechelsesteenweg 365,2022-12-28,04:00:00,0,0,0,FMN GV 05 Lier
60,Mechelsesteenweg 365,2022-12-28,05:00:00,0,0,0,FMN GV 05 Lier
60,Mechelsesteenweg 365,2022-12-28,06:00:00,0,0,0,FMN GV 05 Lier
60,Mechelsesteenweg 365,2022-12-28,07:00:00,10,4,6,FMN GV 05 Lier
60,Mechelsesteenweg 365,2022-12-28,08:00:00,8,4,4,FMN GV 05 Lier
60,Mechelsesteenweg 365,2022-12-28,09:00:00,12,6,6,FMN GV 05 Lier
60,Mechelsesteenweg 365,2022-12-28,10:00:00,34,24,10,FMN GV 05 Lier
60,Mechelsesteenweg 365,2022-12-28,11:00:00,12,6,6,FMN GV 05 Lier
60,Mechelsesteenweg 365,2022-12-28,12:00:00,4,4,0,FMN GV 05 Lier
60,Mechelsesteenweg 365,2022-12-28,13:00:00,16,6,10,FMN GV 05 Lier
60,Mechelsesteenweg 365,2022-12-28,14:00:00,6,4,2,FMN GV 05 Lier
60,Mechelsesteenweg 365,2022-12-28,15:00:00,38,16,22,FMN GV 05 Lier
60,Mechelsesteenweg 365,2022-12-28,16:00:00,22,14,8,FMN GV 05 Lier
60,Mechelsesteenweg 365,2022-12-28,17:00:00,14,12,2,FMN GV 05 Lier
60,Mechelsesteenweg 365,2022-12-28,18:00:00,2,2,0,FMN GV 05 Lier
60,Mechelsesteenweg 365,2022-12-28,19:00:00,2,0,2,FMN GV 05 Lier
60,Mechelsesteenweg 365,2022-12-28,20:00:00,2,2,0,FMN GV 05 Lier
60,Mechelsesteenweg 365,2022-12-28,21:00:00,4,0,4,FMN GV 05 Lier
60,Mechelsesteenweg 365,2022-12-28,22:00:00,0,0,0,FMN GV 05 Lier
60,Mechelsesteenweg 365,2022-12-28,23:00:00,2,0,2,FMN GV 05 Lier
60,Mechelsesteenweg 365,2022-12-29,00:00:00,0,0,0,FMN GV 05 Lier
60,Mechelsesteenweg 365,2022-12-29,01:00:00,0,0,0,FMN GV 05 Lier
60,Mechelsesteenweg 365,2022-12-29,02:00:00,4,4,0,FMN GV 05 Lier
60,Mechelsesteenweg 365,2022-12-29,03:00:00,0,0,0,FMN GV 05 Lier
60,Mechelsesteenweg 365,2022-12-29,04:00:00,0,0,0,FMN GV 05 Lier
60,Mechelsesteenweg 365,2022-12-29,05:00:00,0,0,0,FMN GV 05 Lier
60,Mechelsesteenweg 365,2022-12-29,06:00:00,4,2,2,FMN GV 05 Lier
60,Mechelsesteenweg 365,2022-12-29,07:00:00,8,0,8,FMN GV 05 Lier
60,Mechelsesteenweg 365,2022-12-29,08:00:00,8,6,2,FMN GV 05 Lier
60,Mechelsesteenweg 365,2022-12-29,09:00:00,16,14,2,FMN GV 05 Lier
60,Mechelsesteenweg 365,2022-12-29,10:00:00,24,16,8,FMN GV 05 Lier
60,Mechelsesteenweg 365,2022-12-29,11:00:00,22,14,8,FMN GV 05 Lier
60,Mechelsesteenweg 365,2022-12-29,12:00:00,8,4,4,FMN GV 05 Lier
60,Mechelsesteenweg 365,2022-12-29,13:00:00,30,18,12,FMN GV 05 Lier
60,Mechelsesteenweg 365,2022-12-29,14:00:00,18,6,12,FMN GV 05 Lier
60,Mechelsesteenweg 365,2022-12-29,15:00:00,16,4,12,FMN GV 05 Lier
60,Mechelsesteenweg 365,2022-12-29,16:00:00,8,4,4,FMN GV 05 Lier
60,Mechelsesteenweg 365,2022-12-29,17:00:00,20,12,8,FMN GV 05 Lier
60,Mechelsesteenweg 365,2022-12-29,18:00:00,2,2,0,FMN GV 05 Lier
60,Mechelsesteenweg 365,2022-12-29,19:00:00,4,2,2,FMN GV 05 Lier
60,Mechelsesteenweg 365,2022-12-29,20:00:00,2,0,2,FMN GV 05 Lier
60,Mechelsesteenweg 365,2022-12-29,21:00:00,8,6,2,FMN GV 05 Lier
60,Mechelsesteenweg 365,2022-12-29,22:00:00,4,0,4,FMN GV 05 Lier
60,Mechelsesteenweg 365,2022-12-29,23:00:00,0,0,0,FMN GV 05 Lier
60,Mechelsesteenweg 365,2022-12-30,00:00:00,0,0,0,FMN GV 05 Lier
60,Mechelsesteenweg 365,2022-12-30,01:00:00,0,0,0,FMN GV 05 Lier
60,Mechelsesteenweg 365,2022-12-30,02:00:00,4,4,0,FMN GV 05 Lier
60,Mechelsesteenweg 365,2022-12-30,03:00:00,2,0,2,FMN GV 05 Lier
60,Mechelsesteenweg 365,2022-12-30,04:00:00,2,0,2,FMN GV 05 Lier
60,Mechelsesteenweg 365,2022-12-30,05:00:00,2,0,2,FMN GV 05 Lier
60,Mechelsesteenweg 365,2022-12-30,06:00:00,6,2,4,FMN GV 05 Lier
60,Mechelsesteenweg 365,2022-12-30,07:00:00,10,4,6,FMN GV 05 Lier
60,Mechelsesteenweg 365,2022-12-30,08:00:00,14,6,8,FMN GV 05 Lier
60,Mechelsesteenweg 365,2022-12-30,09:00:00,24,16,8,FMN GV 05 Lier
60,Mechelsesteenweg 365,2022-12-30,10:00:00,34,20,14,FMN GV 05 Lier
60,Mechelsesteenweg 365,2022-12-30,11:00:00,24,16,8,FMN GV 05 Lier
60,Mechelsesteenweg 365,2022-12-30,12:00:00,24,14,10,FMN GV 05 Lier
60,Mechelsesteenweg 365,2022-12-30,13:00:00,14,6,8,FMN GV 05 Lier
60,Mechelsesteenweg 365,2022-12-30,14:00:00,6,6,0,FMN GV 05 Lier
60,Mechelsesteenweg 365,2022-12-30,15:00:00,8,4,4,FMN GV 05 Lier
60,Mechelsesteenweg 365,2022-12-30,16:00:00,10,2,8,FMN GV 05 Lier
60,Mechelsesteenweg 365,2022-12-30,17:00:00,8,2,6,FMN GV 05 Lier
60,Mechelsesteenweg 365,2022-12-30,18:00:00,2,2,0,FMN GV 05 Lier
60,Mechelsesteenweg 365,2022-12-30,19:00:00,2,0,2,FMN GV 05 Lier
60,Mechelsesteenweg 365,2022-12-30,20:00:00,2,2,0,FMN GV 05 Lier
60,Mechelsesteenweg 365,2022-12-30,21:00:00,0,0,0,FMN GV 05 Lier
60,Mechelsesteenweg 365,2022-12-30,22:00:00,0,0,0,FMN GV 05 Lier
60,Mechelsesteenweg 365,2022-12-30,23:00:00,0,0,0,FMN GV 05 Lier
60,Mechelsesteenweg 365,2022-12-31,00:00:00,0,0,0,FMN GV 05 Lier
60,Mechelsesteenweg 365,2022-12-31,01:00:00,4,2,2,FMN GV 05 Lier
60,Mechelsesteenweg 365,2022-12-31,02:00:00,4,4,0,FMN GV 05 Lier
60,Mechelsesteenweg 365,2022-12-31,03:00:00,0,0,0,FMN GV 05 Lier
60,Mechelsesteenweg 365,2022-12-31,04:00:00,0,0,0,FMN GV 05 Lier
60,Mechelsesteenweg 365,2022-12-31,05:00:00,0,0,0,FMN GV 05 Lier
60,Mechelsesteenweg 365,2022-12-31,06:00:00,2,2,0,FMN GV 05 Lier
60,Mechelsesteenweg 365,2022-12-31,07:00:00,2,2,0,FMN GV 05 Lier
60,Mechelsesteenweg 365,2022-12-31,08:00:00,0,0,0,FMN GV 05 Lier
60,Mechelsesteenweg 365,2022-12-31,09:00:00,12,2,10,FMN GV 05 Lier
60,Mechelsesteenweg 365,2022-12-31,10:00:00,16,8,8,FMN GV 05 Lier
60,Mechelsesteenweg 365,2022-12-31,11:00:00,12,8,4,FMN GV 05 Lier
60,Mechelsesteenweg 365,2022-12-31,12:00:00,24,16,8,FMN GV 05 Lier
60,Mechelsesteenweg 365,2022-12-31,13:00:00,18,12,6,FMN GV 05 Lier
60,Mechelsesteenweg 365,2022-12-31,14:00:00,36,22,14,FMN GV 05 Lier
60,Mechelsesteenweg 365,2022-12-31,15:00:00,50,18,32,FMN GV 05 Lier
60,Mechelsesteenweg 365,2022-12-31,16:00:00,24,20,4,FMN GV 05 Lier
60,Mechelsesteenweg 365,2022-12-31,17:00:00,14,8,6,FMN GV 05 Lier
60,Mechelsesteenweg 365,2022-12-31,18:00:00,2,2,0,FMN GV 05 Lier
60,Mechelsesteenweg 365,2022-12-31,19:00:00,2,2,0,FMN GV 05 Lier
60,Mechelsesteenweg 365,2022-12-31,20:00:00,4,2,2,FMN GV 05 Lier
60,Mechelsesteenweg 365,2022-12-31,21:00:00,0,0,0,FMN GV 05 Lier
60,Mechelsesteenweg 365,2022-12-31,22:00:00,6,6,0,FMN GV 05 Lier
60,Mechelsesteenweg 365,2022-12-31,23:00:00,4,4,0,FMN GV 05 Lier
60,Mechelsesteenweg 365,2023-01-01,00:00:00,8,0,8,FMN GV 05 Lier
60,Mechelsesteenweg 365,2023-01-01,01:00:00,0,0,0,FMN GV 05 Lier
60,Mechelsesteenweg 365,2023-01-01,02:00:00,0,0,0,FMN GV 05 Lier
60,Mechelsesteenweg 365,2023-01-01,03:00:00,0,0,0,FMN GV 05 Lier
60,Mechelsesteenweg 365,2023-01-01,04:00:00,2,0,2,FMN GV 05 Lier
60,Mechelsesteenweg 365,2023-01-01,05:00:00,2,0,2,FMN GV 05 Lier
60,Mechelsesteenweg 365,2023-01-01,06:00:00,0,0,0,FMN GV 05 Lier
60,Mechelsesteenweg 365,2023-01-01,07:00:00,0,0,0,FMN GV 05 Lier
60,Mechelsesteenweg 365,2023-01-01,08:00:00,0,0,0,FMN GV 05 Lier
60,Mechelsesteenweg 365,2023-01-01,09:00:00,18,10,8,FMN GV 05 Lier
60,Mechelsesteenweg 365,2023-01-01,10:00:00,50,34,16,FMN GV 05 Lier
60,Mechelsesteenweg 365,2023-01-01,11:00:00,102,30,72,FMN GV 05 Lier
60,Mechelsesteenweg 365,2023-01-01,12:00:00,60,28,32,FMN GV 05 Lier
60,Mechelsesteenweg 365,2023-01-01,13:00:00,72,46,26,FMN GV 05 Lier
60,Mechelsesteenweg 365,2023-01-01,14:00:00,68,26,42,FMN GV 05 Lier
60,Mechelsesteenweg 365,2023-01-01,15:00:00,68,44,24,FMN GV 05 Lier
60,Mechelsesteenweg 365,2023-01-01,16:00:00,24,10,14,FMN GV 05 Lier
60,Mechelsesteenweg 365,2023-01-01,17:00:00,16,8,8,FMN GV 05 Lier
60,Mechelsesteenweg 365,2023-01-01,18:00:00,2,0,2,FMN GV 05 Lier
60,Mechelsesteenweg 365,2023-01-01,19:00:00,0,0,0,FMN GV 05 Lier
60,Mechelsesteenweg 365,2023-01-01,20:00:00,4,0,4,FMN GV 05 Lier
60,Mechelsesteenweg 365,2023-01-01,21:00:00,2,2,0,FMN GV 05 Lier
60,Mechelsesteenweg 365,2023-01-01,22:00:00,0,0,0,FMN GV 05 Lier
60,Mechelsesteenweg 365,2023-01-01,23:00:00,0,0,0,FMN GV 05 Lier
60,Mechelsesteenweg 365,2023-01-02,00:00:00,0,0,0,FMN GV 05 Lier
60,Mechelsesteenweg 365,2023-01-02,01:00:00,4,2,2,FMN GV 05 Lier
60,Mechelsesteenweg 365,2023-01-02,02:00:00,0,0,0,FMN GV 05 Lier
60,Mechelsesteenweg 365,2023-01-02,03:00:00,0,0,0,FMN GV 05 Lier
60,Mechelsesteenweg 365,2023-01-02,04:00:00,0,0,0,FMN GV 05 Lier
60,Mechelsesteenweg 365,2023-01-02,05:00:00,2,0,2,FMN GV 05 Lier
60,Mechelsesteenweg 365,2023-01-02,06:00:00,6,2,4,FMN GV 05 Lier
60,Mechelsesteenweg 365,2023-01-02,07:00:00,8,4,4,FMN GV 05 Lier
60,Mechelsesteenweg 365,2023-01-02,08:00:00,14,4,10,FMN GV 05 Lier
60,Mechelsesteenweg 365,2023-01-02,09:00:00,8,4,4,FMN GV 05 Lier
60,Mechelsesteenweg 365,2023-01-02,10:00:00,20,6,14,FMN GV 05 Lier
60,Mechelsesteenweg 365,2023-01-02,11:00:00,18,8,10,FMN GV 05 Lier
60,Mechelsesteenweg 365,2023-01-02,12:00:00,38,22,16,FMN GV 05 Lier
60,Mechelsesteenweg 365,2023-01-02,13:00:00,64,40,24,FMN GV 05 Lier
60,Mechelsesteenweg 365,2023-01-02,14:00:00,64,38,26,FMN GV 05 Lier
60,Mechelsesteenweg 365,2023-01-02,15:00:00,46,20,26,FMN GV 05 Lier
60,Mechelsesteenweg 365,2023-01-02,16:00:00,36,22,14,FMN GV 05 Lier
60,Mechelsesteenweg 365,2023-01-02,17:00:00,32,12,20,FMN GV 05 Lier
60,Mechelsesteenweg 365,2023-01-02,18:00:00,10,4,6,FMN GV 05 Lier
60,Mechelsesteenweg 365,2023-01-02,19:00:00,0,0,0,FMN GV 05 Lier
60,Mechelsesteenweg 365,2023-01-02,20:00:00,4,2,2,FMN GV 05 Lier
60,Mechelsesteenweg 365,2023-01-02,21:00:00,4,2,2,FMN GV 05 Lier
60,Mechelsesteenweg 365,2023-01-02,22:00:00,0,0,0,FMN GV 05 Lier
60,Mechelsesteenweg 365,2023-01-02,23:00:00,0,0,0,FMN GV 05 Lier
60,Mechelsesteenweg 365,2023-01-03,00:00:00,0,0,0,FMN GV 05 Lier
60,Mechelsesteenweg 365,2023-01-03,01:00:00,0,0,0,FMN GV 05 Lier
60,Mechelsesteenweg 365,2023-01-03,02:00:00,0,0,0,FMN GV 05 Lier
60,Mechelsesteenweg 365,2023-01-03,03:00:00,0,0,0,FMN GV 05 Lier
60,Mechelsesteenweg 365,2023-01-03,04:00:00,0,0,0,FMN GV 05 Lier
60,Mechelsesteenweg 365,2023-01-03,05:00:00,0,0,0,FMN GV 05 Lier
60,Mechelsesteenweg 365,2023-01-03,06:00:00,10,0,10,FMN GV 05 Lier
60,Mechelsesteenweg 365,2023-01-03,07:00:00,16,4,12,FMN GV 05 Lier
60,Mechelsesteenweg 365,2023-01-03,08:00:00,20,8,12,FMN GV 05 Lier
60,Mechelsesteenweg 365,2023-01-03,09:00:00,16,2,14,FMN GV 05 Lier
60,Mechelsesteenweg 365,2023-01-03,10:00:00,54,20,34,FMN GV 05 Lier
60,Mechelsesteenweg 365,2023-01-03,11:00:00,70,32,38,FMN GV 05 Lier
60,Mechelsesteenweg 365,2023-01-03,12:00:00,40,18,22,FMN GV 05 Lier
60,Mechelsesteenweg 365,2023-01-03,13:00:00,88,50,38,FMN GV 05 Lier
60,Mechelsesteenweg 365,2023-01-03,14:00:00,108,38,70,FMN GV 05 Lier
60,Mechelsesteenweg 365,2023-01-03,15:00:00,74,36,38,FMN GV 05 Lier
60,Mechelsesteenweg 365,2023-01-03,16:00:00,56,26,30,FMN GV 05 Lier
60,Mechelsesteenweg 365,2023-01-03,17:00:00,36,22,14,FMN GV 05 Lier
60,Mechelsesteenweg 365,2023-01-03,18:00:00,14,12,2,FMN GV 05 Lier
60,Mechelsesteenweg 365,2023-01-03,19:00:00,6,4,2,FMN GV 05 Lier
60,Mechelsesteenweg 365,2023-01-03,20:00:00,6,4,2,FMN GV 05 Lier
60,Mechelsesteenweg 365,2023-01-03,21:00:00,6,2,4,FMN GV 05 Lier
60,Mechelsesteenweg 365,2023-01-03,22:00:00,0,0,0,FMN GV 05 Lier
60,Mechelsesteenweg 365,2023-01-03,23:00:00,0,0,0,FMN GV 05 Lier
60,Mechelsesteenweg 365,2023-01-04,00:00:00,4,0,4,FMN GV 05 Lier
60,Mechelsesteenweg 365,2023-01-04,01:00:00,0,0,0,FMN GV 05 Lier
60,Mechelsesteenweg 365,2023-01-04,02:00:00,0,0,0,FMN GV 05 Lier
60,Mechelsesteenweg 365,2023-01-04,03:00:00,0,0,0,FMN GV 05 Lier
60,Mechelsesteenweg 365,2023-01-04,04:00:00,0,0,0,FMN GV 05 Lier
60,Mechelsesteenweg 365,2023-01-04,05:00:00,0,0,0,FMN GV 05 Lier
60,Mechelsesteenweg 365,2023-01-04,06:00:00,2,0,2,FMN GV 05 Lier
60,Mechelsesteenweg 365,2023-01-04,07:00:00,10,4,6,FMN GV 05 Lier
60,Mechelsesteenweg 365,2023-01-04,08:00:00,28,12,16,FMN GV 05 Lier
60,Mechelsesteenweg 365,2023-01-04,09:00:00,8,2,6,FMN GV 05 Lier
60,Mechelsesteenweg 365,2023-01-04,10:00:00,8,8,0,FMN GV 05 Lier
60,Mechelsesteenweg 365,2023-01-04,11:00:00,10,6,4,FMN GV 05 Lier
60,Mechelsesteenweg 365,2023-01-04,12:00:00,8,2,6,FMN GV 05 Lier
60,Mechelsesteenweg 365,2023-01-04,13:00:00,10,2,8,FMN GV 05 Lier
60,Mechelsesteenweg 365,2023-01-04,14:00:00,16,6,10,FMN GV 05 Lier
60,Mechelsesteenweg 365,2023-01-04,15:00:00,14,10,4,FMN GV 05 Lier
60,Mechelsesteenweg 365,2023-01-04,16:00:00,18,14,4,FMN GV 05 Lier
60,Mechelsesteenweg 365,2023-01-04,17:00:00,24,12,12,FMN GV 05 Lier
60,Mechelsesteenweg 365,2023-01-04,18:00:00,6,4,2,FMN GV 05 Lier
60,Mechelsesteenweg 365,2023-01-04,19:00:00,4,2,2,FMN GV 05 Lier
60,Mechelsesteenweg 365,2023-01-04,20:00:00,2,0,2,FMN GV 05 Lier
60,Mechelsesteenweg 365,2023-01-04,21:00:00,0,0,0,FMN GV 05 Lier
60,Mechelsesteenweg 365,2023-01-04,22:00:00,6,0,6,FMN GV 05 Lier
60,Mechelsesteenweg 365,2023-01-04,23:00:00,0,0,0,FMN GV 05 Lier
60,Mechelsesteenweg 365,2023-01-05,00:00:00,0,0,0,FMN GV 05 Lier
60,Mechelsesteenweg 365,2023-01-05,01:00:00,2,2,0,FMN GV 05 Lier
60,Mechelsesteenweg 365,2023-01-05,02:00:00,0,0,0,FMN GV 05 Lier
60,Mechelsesteenweg 365,2023-01-05,03:00:00,0,0,0,FMN GV 05 Lier
60,Mechelsesteenweg 365,2023-01-05,04:00:00,2,0,2,FMN GV 05 Lier
60,Mechelsesteenweg 365,2023-01-05,05:00:00,2,0,2,FMN GV 05 Lier
60,Mechelsesteenweg 365,2023-01-05,06:00:00,6,0,6,FMN GV 05 Lier
60,Mechelsesteenweg 365,2023-01-05,07:00:00,28,10,18,FMN GV 05 Lier
60,Mechelsesteenweg 365,2023-01-05,08:00:00,34,14,20,FMN GV 05 Lier
60,Mechelsesteenweg 365,2023-01-05,09:00:00,58,22,36,FMN GV 05 Lier
60,Mechelsesteenweg 365,2023-01-05,10:00:00,66,42,24,FMN GV 05 Lier
60,Mechelsesteenweg 365,2023-01-05,11:00:00,104,50,54,FMN GV 05 Lier
60,Mechelsesteenweg 365,2023-01-05,12:00:00,96,52,44,FMN GV 05 Lier
60,Mechelsesteenweg 365,2023-01-05,13:00:00,94,38,56,FMN GV 05 Lier
60,Mechelsesteenweg 365,2023-01-05,14:00:00,86,42,44,FMN GV 05 Lier
60,Mechelsesteenweg 365,2023-01-05,15:00:00,50,20,30,FMN GV 05 Lier
60,Mechelsesteenweg 365,2023-01-05,16:00:00,40,22,18,FMN GV 05 Lier
60,Mechelsesteenweg 365,2023-01-05,17:00:00,36,30,6,FMN GV 05 Lier
60,Mechelsesteenweg 365,2023-01-05,18:00:00,16,14,2,FMN GV 05 Lier
60,Mechelsesteenweg 365,2023-01-05,19:00:00,4,4,0,FMN GV 05 Lier
60,Mechelsesteenweg 365,2023-01-05,20:00:00,8,6,2,FMN GV 05 Lier
60,Mechelsesteenweg 365,2023-01-05,21:00:00,4,2,2,FMN GV 05 Lier
60,Mechelsesteenweg 365,2023-01-05,22:00:00,4,0,4,FMN GV 05 Lier
60,Mechelsesteenweg 365,2023-01-05,23:00:00,0,0,0,FMN GV 05 Lier
60,Mechelsesteenweg 365,2023-01-06,00:00:00,0,0,0,FMN GV 05 Lier
60,Mechelsesteenweg 365,2023-01-06,01:00:00,0,0,0,FMN GV 05 Lier
60,Mechelsesteenweg 365,2023-01-06,02:00:00,0,0,0,FMN GV 05 Lier
60,Mechelsesteenweg 365,2023-01-06,03:00:00,0,0,0,FMN GV 05 Lier
60,Mechelsesteenweg 365,2023-01-06,04:00:00,0,0,0,FMN GV 05 Lier
60,Mechelsesteenweg 365,2023-01-06,05:00:00,0,0,0,FMN GV 05 Lier
60,Mechelsesteenweg 365,2023-01-06,06:00:00,10,2,8,FMN GV 05 Lier
60,Mechelsesteenweg 365,2023-01-06,07:00:00,18,6,12,FMN GV 05 Lier
60,Mechelsesteenweg 365,2023-01-06,08:00:00,12,4,8,FMN GV 05 Lier
60,Mechelsesteenweg 365,2023-01-06,09:00:00,6,0,6,FMN GV 05 Lier
60,Mechelsesteenweg 365,2023-01-06,10:00:00,44,16,28,FMN GV 05 Lier
60,Mechelsesteenweg 365,2023-01-06,11:00:00,58,38,20,FMN GV 05 Lier
60,Mechelsesteenweg 365,2023-01-06,12:00:00,58,26,32,FMN GV 05 Lier
60,Mechelsesteenweg 365,2023-01-06,13:00:00,58,26,32,FMN GV 05 Lier
60,Mechelsesteenweg 365,2023-01-06,14:00:00,62,40,22,FMN GV 05 Lier
60,Mechelsesteenweg 365,2023-01-06,15:00:00,32,14,18,FMN GV 05 Lier
60,Mechelsesteenweg 365,2023-01-06,16:00:00,46,32,14,FMN GV 05 Lier
60,Mechelsesteenweg 365,2023-01-06,17:00:00,30,24,6,FMN GV 05 Lier
60,Mechelsesteenweg 365,2023-01-06,18:00:00,10,8,2,FMN GV 05 Lier
60,Mechelsesteenweg 365,2023-01-06,19:00:00,10,4,6,FMN GV 05 Lier
60,Mechelsesteenweg 365,2023-01-06,20:00:00,4,4,0,FMN GV 05 Lier
60,Mechelsesteenweg 365,2023-01-06,21:00:00,4,2,2,FMN GV 05 Lier
60,Mechelsesteenweg 365,2023-01-06,22:00:00,0,0,0,FMN GV 05 Lier
60,Mechelsesteenweg 365,2023-01-06,23:00:00,2,0,2,FMN GV 05 Lier
60,Mechelsesteenweg 365,2023-01-07,00:00:00,0,0,0,FMN GV 05 Lier
60,Mechelsesteenweg 365,2023-01-07,01:00:00,2,2,0,FMN GV 05 Lier
60,Mechelsesteenweg 365,2023-01-07,02:00:00,0,0,0,FMN GV 05 Lier
60,Mechelsesteenweg 365,2023-01-07,03:00:00,2,2,0,FMN GV 05 Lier
60,Mechelsesteenweg 365,2023-01-07,04:00:00,0,0,0,FMN GV 05 Lier
60,Mechelsesteenweg 365,2023-01-07,05:00:00,2,0,2,FMN GV 05 Lier
60,Mechelsesteenweg 365,2023-01-07,06:00:00,0,0,0,FMN GV 05 Lier
60,Mechelsesteenweg 365,2023-01-07,07:00:00,0,0,0,FMN GV 05 Lier
60,Mechelsesteenweg 365,2023-01-07,08:00:00,18,4,14,FMN GV 05 Lier
60,Mechelsesteenweg 365,2023-01-07,09:00:00,48,24,24,FMN GV 05 Lier
60,Mechelsesteenweg 365,2023-01-07,10:00:00,104,54,50,FMN GV 05 Lier
60,Mechelsesteenweg 365,2023-01-07,11:00:00,148,86,62,FMN GV 05 Lier
60,Mechelsesteenweg 365,2023-01-07,12:00:00,118,62,56,FMN GV 05 Lier
60,Mechelsesteenweg 365,2023-01-07,13:00:00,142,70,72,FMN GV 05 Lier
60,Mechelsesteenweg 365,2023-01-07,14:00:00,152,90,62,FMN GV 05 Lier
60,Mechelsesteenweg 365,2023-01-07,15:00:00,54,36,18,FMN GV 05 Lier
60,Mechelsesteenweg 365,2023-01-07,16:00:00,24,14,10,FMN GV 05 Lier
60,Mechelsesteenweg 365,2023-01-07,17:00:00,4,0,4,FMN GV 05 Lier
60,Mechelsesteenweg 365,2023-01-07,18:00:00,6,4,2,FMN GV 05 Lier
60,Mechelsesteenweg 365,2023-01-07,19:00:00,2,0,2,FMN GV 05 Lier
60,Mechelsesteenweg 365,2023-01-07,20:00:00,2,2,0,FMN GV 05 Lier
60,Mechelsesteenweg 365,2023-01-07,21:00:00,2,0,2,FMN GV 05 Lier
60,Mechelsesteenweg 365,2023-01-07,22:00:00,2,0,2,FMN GV 05 Lier
60,Mechelsesteenweg 365,2023-01-07,23:00:00,0,0,0,FMN GV 05 Lier
60,Mechelsesteenweg 365,2023-01-08,00:00:00,0,0,0,FMN GV 05 Lier
60,Mechelsesteenweg 365,2023-01-08,01:00:00,0,0,0,FMN GV 05 Lier
60,Mechelsesteenweg 365,2023-01-08,02:00:00,0,0,0,FMN GV 05 Lier
60,Mechelsesteenweg 365,2023-01-08,03:00:00,0,0,0,FMN GV 05 Lier
60,Mechelsesteenweg 365,2023-01-08,04:00:00,0,0,0,FMN GV 05 Lier
60,Mechelsesteenweg 365,2023-01-08,05:00:00,0,0,0,FMN GV 05 Lier
60,Mechelsesteenweg 365,2023-01-08,06:00:00,0,0,0,FMN GV 05 Lier
60,Mechelsesteenweg 365,2023-01-08,07:00:00,4,2,2,FMN GV 05 Lier
60,Mechelsesteenweg 365,2023-01-08,08:00:00,12,6,6,FMN GV 05 Lier
60,Mechelsesteenweg 365,2023-01-08,09:00:00,70,48,22,FMN GV 05 Lier
60,Mechelsesteenweg 365,2023-01-08,10:00:00,166,90,76,FMN GV 05 Lier
60,Mechelsesteenweg 365,2023-01-08,11:00:00,262,140,122,FMN GV 05 Lier
60,Mechelsesteenweg 365,2023-01-08,12:00:00,150,74,76,FMN GV 05 Lier
60,Mechelsesteenweg 365,2023-01-08,13:00:00,102,62,40,FMN GV 05 Lier
60,Mechelsesteenweg 365,2023-01-08,14:00:00,104,52,52,FMN GV 05 Lier
60,Mechelsesteenweg 365,2023-01-08,15:00:00,98,48,50,FMN GV 05 Lier
60,Mechelsesteenweg 365,2023-01-08,16:00:00,52,28,24,FMN GV 05 Lier
60,Mechelsesteenweg 365,2023-01-08,17:00:00,8,2,6,FMN GV 05 Lier
60,Mechelsesteenweg 365,2023-01-08,18:00:00,2,0,2,FMN GV 05 Lier
60,Mechelsesteenweg 365,2023-01-08,19:00:00,2,2,0,FMN GV 05 Lier
60,Mechelsesteenweg 365,2023-01-08,20:00:00,2,0,2,FMN GV 05 Lier
60,Mechelsesteenweg 365,2023-01-08,21:00:00,4,2,2,FMN GV 05 Lier
60,Mechelsesteenweg 365,2023-01-08,22:00:00,0,0,0,FMN GV 05 Lier
60,Mechelsesteenweg 365,2023-01-08,23:00:00,0,0,0,FMN GV 05 Lier
60,Mechelsesteenweg 365,2023-01-09,00:00:00,0,0,0,FMN GV 05 Lier
60,Mechelsesteenweg 365,2023-01-09,01:00:00,0,0,0,FMN GV 05 Lier
60,Mechelsesteenweg 365,2023-01-09,02:00:00,0,0,0,FMN GV 05 Lier
60,Mechelsesteenweg 365,2023-01-09,03:00:00,2,0,2,FMN GV 05 Lier
60,Mechelsesteenweg 365,2023-01-09,04:00:00,0,0,0,FMN GV 05 Lier
60,Mechelsesteenweg 365,2023-01-09,05:00:00,2,0,2,FMN GV 05 Lier
60,Mechelsesteenweg 365,2023-01-09,06:00:00,20,8,12,FMN GV 05 Lier
60,Mechelsesteenweg 365,2023-01-09,07:00:00,56,34,22,FMN GV 05 Lier
60,Mechelsesteenweg 365,2023-01-09,08:00:00,102,58,44,FMN GV 05 Lier
60,Mechelsesteenweg 365,2023-01-09,09:00:00,26,16,10,FMN GV 05 Lier
60,Mechelsesteenweg 365,2023-01-09,10:00:00,14,2,12,FMN GV 05 Lier
60,Mechelsesteenweg 365,2023-01-09,11:00:00,22,14,8,FMN GV 05 Lier
60,Mechelsesteenweg 365,2023-01-09,12:00:00,34,16,18,FMN GV 05 Lier
60,Mechelsesteenweg 365,2023-01-09,13:00:00,30,12,18,FMN GV 05 Lier
60,Mechelsesteenweg 365,2023-01-09,14:00:00,54,22,32,FMN GV 05 Lier
60,Mechelsesteenweg 365,2023-01-09,15:00:00,64,42,22,FMN GV 05 Lier
60,Mechelsesteenweg 365,2023-01-09,16:00:00,136,42,94,FMN GV 05 Lier
60,Mechelsesteenweg 365,2023-01-09,17:00:00,58,44,14,FMN GV 05 Lier
60,Mechelsesteenweg 365,2023-01-09,18:00:00,14,12,2,FMN GV 05 Lier
60,Mechelsesteenweg 365,2023-01-09,19:00:00,0,0,0,FMN GV 05 Lier
60,Mechelsesteenweg 365,2023-01-09,20:00:00,4,2,2,FMN GV 05 Lier
60,Mechelsesteenweg 365,2023-01-09,21:00:00,0,0,0,FMN GV 05 Lier
60,Mechelsesteenweg 365,2023-01-09,22:00:00,4,2,2,FMN GV 05 Lier
60,Mechelsesteenweg 365,2023-01-09,23:00:00,0,0,0,FMN GV 05 Lier
60,Mechelsesteenweg 365,2023-01-10,00:00:00,0,0,0,FMN GV 05 Lier
60,Mechelsesteenweg 365,2023-01-10,01:00:00,0,0,0,FMN GV 05 Lier
60,Mechelsesteenweg 365,2023-01-10,02:00:00,2,2,0,FMN GV 05 Lier
60,Mechelsesteenweg 365,2023-01-10,03:00:00,0,0,0,FMN GV 05 Lier
60,Mechelsesteenweg 365,2023-01-10,04:00:00,0,0,0,FMN GV 05 Lier
60,Mechelsesteenweg 365,2023-01-10,05:00:00,2,0,2,FMN GV 05 Lier
60,Mechelsesteenweg 365,2023-01-10,06:00:00,16,6,10,FMN GV 05 Lier
60,Mechelsesteenweg 365,2023-01-10,07:00:00,76,32,44,FMN GV 05 Lier
60,Mechelsesteenweg 365,2023-01-10,08:00:00,76,52,24,FMN GV 05 Lier
60,Mechelsesteenweg 365,2023-01-10,09:00:00,30,20,10,FMN GV 05 Lier
60,Mechelsesteenweg 365,2023-01-10,10:00:00,44,12,32,FMN GV 05 Lier
60,Mechelsesteenweg 365,2023-01-10,11:00:00,68,32,36,FMN GV 05 Lier
60,Mechelsesteenweg 365,2023-01-10,12:00:00,38,18,20,FMN GV 05 Lier
60,Mechelsesteenweg 365,2023-01-10,13:00:00,44,14,30,FMN GV 05 Lier
60,Mechelsesteenweg 365,2023-01-10,14:00:00,18,8,10,FMN GV 05 Lier
60,Mechelsesteenweg 365,2023-01-10,15:00:00,32,14,18,FMN GV 05 Lier
60,Mechelsesteenweg 365,2023-01-10,16:00:00,92,22,70,FMN GV 05 Lier
60,Mechelsesteenweg 365,2023-01-10,17:00:00,40,28,12,FMN GV 05 Lier
60,Mechelsesteenweg 365,2023-01-10,18:00:00,22,16,6,FMN GV 05 Lier
60,Mechelsesteenweg 365,2023-01-10,19:00:00,6,4,2,FMN GV 05 Lier
60,Mechelsesteenweg 365,2023-01-10,20:00:00,4,0,4,FMN GV 05 Lier
60,Mechelsesteenweg 365,2023-01-10,21:00:00,6,2,4,FMN GV 05 Lier
60,Mechelsesteenweg 365,2023-01-10,22:00:00,8,4,4,FMN GV 05 Lier
60,Mechelsesteenweg 365,2023-01-10,23:00:00,2,2,0,FMN GV 05 Lier
60,Mechelsesteenweg 365,2023-01-11,00:00:00,0,0,0,FMN GV 05 Lier
60,Mechelsesteenweg 365,2023-01-11,01:00:00,0,0,0,FMN GV 05 Lier
60,Mechelsesteenweg 365,2023-01-11,02:00:00,0,0,0,FMN GV 05 Lier
60,Mechelsesteenweg 365,2023-01-11,03:00:00,0,0,0,FMN GV 05 Lier
60,Mechelsesteenweg 365,2023-01-11,04:00:00,0,0,0,FMN GV 05 Lier
60,Mechelsesteenweg 365,2023-01-11,05:00:00,2,0,2,FMN GV 05 Lier
60,Mechelsesteenweg 365,2023-01-11,06:00:00,8,2,6,FMN GV 05 Lier
60,Mechelsesteenweg 365,2023-01-11,07:00:00,74,40,34,FMN GV 05 Lier
60,Mechelsesteenweg 365,2023-01-11,08:00:00,84,60,24,FMN GV 05 Lier
60,Mechelsesteenweg 365,2023-01-11,09:00:00,26,10,16,FMN GV 05 Lier
60,Mechelsesteenweg 365,2023-01-11,10:00:00,42,24,18,FMN GV 05 Lier
60,Mechelsesteenweg 365,2023-01-11,11:00:00,80,36,44,FMN GV 05 Lier
60,Mechelsesteenweg 365,2023-01-11,12:00:00,134,38,96,FMN GV 05 Lier
60,Mechelsesteenweg 365,2023-01-11,13:00:00,96,46,50,FMN GV 05 Lier
60,Mechelsesteenweg 365,2023-01-11,14:00:00,128,72,56,FMN GV 05 Lier
60,Mechelsesteenweg 365,2023-01-11,15:00:00,90,50,40,FMN GV 05 Lier
60,Mechelsesteenweg 365,2023-01-11,16:00:00,82,52,30,FMN GV 05 Lier
60,Mechelsesteenweg 365,2023-01-11,17:00:00,34,24,10,FMN GV 05 Lier
60,Mechelsesteenweg 365,2023-01-11,18:00:00,18,12,6,FMN GV 05 Lier
60,Mechelsesteenweg 365,2023-01-11,19:00:00,0,0,0,FMN GV 05 Lier
60,Mechelsesteenweg 365,2023-01-11,20:00:00,8,4,4,FMN GV 05 Lier
60,Mechelsesteenweg 365,2023-01-11,21:00:00,4,2,2,FMN GV 05 Lier
60,Mechelsesteenweg 365,2023-01-11,22:00:00,4,2,2,FMN GV 05 Lier
60,Mechelsesteenweg 365,2023-01-11,23:00:00,2,2,0,FMN GV 05 Lier
60,Mechelsesteenweg 365,2023-01-12,00:00:00,0,0,0,FMN GV 05 Lier
60,Mechelsesteenweg 365,2023-01-12,01:00:00,0,0,0,FMN GV 05 Lier
60,Mechelsesteenweg 365,2023-01-12,02:00:00,0,0,0,FMN GV 05 Lier
60,Mechelsesteenweg 365,2023-01-12,03:00:00,0,0,0,FMN GV 05 Lier
60,Mechelsesteenweg 365,2023-01-12,04:00:00,0,0,0,FMN GV 05 Lier
60,Mechelsesteenweg 365,2023-01-12,05:00:00,0,0,0,FMN GV 05 Lier
60,Mechelsesteenweg 365,2023-01-12,06:00:00,2,0,2,FMN GV 05 Lier
60,Mechelsesteenweg 365,2023-01-12,07:00:00,16,8,8,FMN GV 05 Lier
60,Mechelsesteenweg 365,2023-01-12,08:00:00,30,16,14,FMN GV 05 Lier
60,Mechelsesteenweg 365,2023-01-12,09:00:00,10,6,4,FMN GV 05 Lier
60,Mechelsesteenweg 365,2023-01-12,10:00:00,10,4,6,FMN GV 05 Lier
60,Mechelsesteenweg 365,2023-01-12,11:00:00,6,2,4,FMN GV 05 Lier
60,Mechelsesteenweg 365,2023-01-12,12:00:00,6,2,4,FMN GV 05 Lier
60,Mechelsesteenweg 365,2023-01-12,13:00:00,4,2,2,FMN GV 05 Lier
60,Mechelsesteenweg 365,2023-01-12,14:00:00,4,4,0,FMN GV 05 Lier
60,Mechelsesteenweg 365,2023-01-12,15:00:00,14,2,12,FMN GV 05 Lier
60,Mechelsesteenweg 365,2023-01-12,16:00:00,52,18,34,FMN GV 05 Lier
60,Mechelsesteenweg 365,2023-01-12,17:00:00,24,14,10,FMN GV 05 Lier
60,Mechelsesteenweg 365,2023-01-12,18:00:00,6,6,0,FMN GV 05 Lier
60,Mechelsesteenweg 365,2023-01-12,19:00:00,2,2,0,FMN GV 05 Lier
60,Mechelsesteenweg 365,2023-01-12,20:00:00,0,0,0,FMN GV 05 Lier
60,Mechelsesteenweg 365,2023-01-12,21:00:00,2,0,2,FMN GV 05 Lier
60,Mechelsesteenweg 365,2023-01-12,22:00:00,2,0,2,FMN GV 05 Lier
60,Mechelsesteenweg 365,2023-01-12,23:00:00,0,0,0,FMN GV 05 Lier
60,Mechelsesteenweg 365,2023-01-13,00:00:00,0,0,0,FMN GV 05 Lier
60,Mechelsesteenweg 365,2023-01-13,01:00:00,0,0,0,FMN GV 05 Lier
60,Mechelsesteenweg 365,2023-01-13,02:00:00,2,2,0,FMN GV 05 Lier
60,Mechelsesteenweg 365,2023-01-13,03:00:00,0,0,0,FMN GV 05 Lier
60,Mechelsesteenweg 365,2023-01-13,04:00:00,0,0,0,FMN GV 05 Lier
60,Mechelsesteenweg 365,2023-01-13,05:00:00,0,0,0,FMN GV 05 Lier
60,Mechelsesteenweg 365,2023-01-13,06:00:00,14,0,14,FMN GV 05 Lier
60,Mechelsesteenweg 365,2023-01-13,07:00:00,50,32,18,FMN GV 05 Lier
60,Mechelsesteenweg 365,2023-01-13,08:00:00,60,38,22,FMN GV 05 Lier
60,Mechelsesteenweg 365,2023-01-13,09:00:00,26,6,20,FMN GV 05 Lier
60,Mechelsesteenweg 365,2023-01-13,10:00:00,28,20,8,FMN GV 05 Lier
60,Mechelsesteenweg 365,2023-01-13,11:00:00,40,22,18,FMN GV 05 Lier
60,Mechelsesteenweg 365,2023-01-13,12:00:00,46,24,22,FMN GV 05 Lier
60,Mechelsesteenweg 365,2023-01-13,13:00:00,42,28,14,FMN GV 05 Lier
60,Mechelsesteenweg 365,2023-01-13,14:00:00,52,32,20,FMN GV 05 Lier
60,Mechelsesteenweg 365,2023-01-13,15:00:00,40,26,14,FMN GV 05 Lier
60,Mechelsesteenweg 365,2023-01-13,16:00:00,108,38,70,FMN GV 05 Lier
60,Mechelsesteenweg 365,2023-01-13,17:00:00,36,24,12,FMN GV 05 Lier
60,Mechelsesteenweg 365,2023-01-13,18:00:00,8,4,4,FMN GV 05 Lier
60,Mechelsesteenweg 365,2023-01-13,19:00:00,2,2,0,FMN GV 05 Lier
60,Mechelsesteenweg 365,2023-01-13,20:00:00,4,4,0,FMN GV 05 Lier
60,Mechelsesteenweg 365,2023-01-13,21:00:00,2,0,2,FMN GV 05 Lier
60,Mechelsesteenweg 365,2023-01-13,22:00:00,4,2,2,FMN GV 05 Lier
60,Mechelsesteenweg 365,2023-01-13,23:00:00,4,4,0,FMN GV 05 Lier
60,Mechelsesteenweg 365,2023-01-14,00:00:00,6,0,6,FMN GV 05 Lier
60,Mechelsesteenweg 365,2023-01-14,01:00:00,2,0,2,FMN GV 05 Lier
60,Mechelsesteenweg 365,2023-01-14,02:00:00,0,0,0,FMN GV 05 Lier
60,Mechelsesteenweg 365,2023-01-14,03:00:00,0,0,0,FMN GV 05 Lier
60,Mechelsesteenweg 365,2023-01-14,04:00:00,0,0,0,FMN GV 05 Lier
60,Mechelsesteenweg 365,2023-01-14,05:00:00,0,0,0,FMN GV 05 Lier
60,Mechelsesteenweg 365,2023-01-14,06:00:00,2,0,2,FMN GV 05 Lier
60,Mechelsesteenweg 365,2023-01-14,07:00:00,0,0,0,FMN GV 05 Lier
60,Mechelsesteenweg 365,2023-01-14,08:00:00,6,2,4,FMN GV 05 Lier
60,Mechelsesteenweg 365,2023-01-14,09:00:00,6,0,6,FMN GV 05 Lier
60,Mechelsesteenweg 365,2023-01-14,10:00:00,10,4,6,FMN GV 05 Lier
60,Mechelsesteenweg 365,2023-01-14,11:00:00,12,4,8,FMN GV 05 Lier
60,Mechelsesteenweg 365,2023-01-14,12:00:00,10,6,4,FMN GV 05 Lier
60,Mechelsesteenweg 365,2023-01-14,13:00:00,4,2,2,FMN GV 05 Lier
60,Mechelsesteenweg 365,2023-01-14,14:00:00,0,0,0,FMN GV 05 Lier
60,Mechelsesteenweg 365,2023-01-14,15:00:00,4,4,0,FMN GV 05 Lier
60,Mechelsesteenweg 365,2023-01-14,16:00:00,10,2,8,FMN GV 05 Lier
60,Mechelsesteenweg 365,2023-01-14,17:00:00,2,0,2,FMN GV 05 Lier
60,Mechelsesteenweg 365,2023-01-14,18:00:00,0,0,0,FMN GV 05 Lier
60,Mechelsesteenweg 365,2023-01-14,19:00:00,0,0,0,FMN GV 05 Lier
60,Mechelsesteenweg 365,2023-01-14,20:00:00,4,4,0,FMN GV 05 Lier
60,Mechelsesteenweg 365,2023-01-14,21:00:00,2,0,2,FMN GV 05 Lier
60,Mechelsesteenweg 365,2023-01-14,22:00:00,0,0,0,FMN GV 05 Lier
60,Mechelsesteenweg 365,2023-01-14,23:00:00,2,0,2,FMN GV 05 Lier
60,Mechelsesteenweg 365,2023-01-15,00:00:00,0,0,0,FMN GV 05 Lier
60,Mechelsesteenweg 365,2023-01-15,01:00:00,2,0,2,FMN GV 05 Lier
60,Mechelsesteenweg 365,2023-01-15,02:00:00,0,0,0,FMN GV 05 Lier
60,Mechelsesteenweg 365,2023-01-15,03:00:00,0,0,0,FMN GV 05 Lier
60,Mechelsesteenweg 365,2023-01-15,04:00:00,0,0,0,FMN GV 05 Lier
60,Mechelsesteenweg 365,2023-01-15,05:00:00,0,0,0,FMN GV 05 Lier
60,Mechelsesteenweg 365,2023-01-15,06:00:00,2,0,2,FMN GV 05 Lier
60,Mechelsesteenweg 365,2023-01-15,07:00:00,0,0,0,FMN GV 05 Lier
60,Mechelsesteenweg 365,2023-01-15,08:00:00,14,4,10,FMN GV 05 Lier
60,Mechelsesteenweg 365,2023-01-15,09:00:00,32,16,16,FMN GV 05 Lier
60,Mechelsesteenweg 365,2023-01-15,10:00:00,210,102,108,FMN GV 05 Lier
60,Mechelsesteenweg 365,2023-01-15,11:00:00,176,102,74,FMN GV 05 Lier
60,Mechelsesteenweg 365,2023-01-15,12:00:00,72,54,18,FMN GV 05 Lier
60,Mechelsesteenweg 365,2023-01-15,13:00:00,58,38,20,FMN GV 05 Lier
60,Mechelsesteenweg 365,2023-01-15,14:00:00,36,20,16,FMN GV 05 Lier
60,Mechelsesteenweg 365,2023-01-15,15:00:00,14,6,8,FMN GV 05 Lier
60,Mechelsesteenweg 365,2023-01-15,16:00:00,22,12,10,FMN GV 05 Lier
60,Mechelsesteenweg 365,2023-01-15,17:00:00,2,0,2,FMN GV 05 Lier
60,Mechelsesteenweg 365,2023-01-15,18:00:00,4,4,0,FMN GV 05 Lier
60,Mechelsesteenweg 365,2023-01-15,19:00:00,2,2,0,FMN GV 05 Lier
60,Mechelsesteenweg 365,2023-01-15,20:00:00,0,0,0,FMN GV 05 Lier
60,Mechelsesteenweg 365,2023-01-15,21:00:00,0,0,0,FMN GV 05 Lier
60,Mechelsesteenweg 365,2023-01-15,22:00:00,0,0,0,FMN GV 05 Lier
60,Mechelsesteenweg 365,2023-01-15,23:00:00,0,0,0,FMN GV 05 Lier
60,Mechelsesteenweg 365,2023-01-16,00:00:00,0,0,0,FMN GV 05 Lier
60,Mechelsesteenweg 365,2023-01-16,01:00:00,0,0,0,FMN GV 05 Lier
60,Mechelsesteenweg 365,2023-01-16,02:00:00,0,0,0,FMN GV 05 Lier
60,Mechelsesteenweg 365,2023-01-16,03:00:00,0,0,0,FMN GV 05 Lier
60,Mechelsesteenweg 365,2023-01-16,04:00:00,0,0,0,FMN GV 05 Lier
60,Mechelsesteenweg 365,2023-01-16,05:00:00,0,0,0,FMN GV 05 Lier
60,Mechelsesteenweg 365,2023-01-16,06:00:00,8,2,6,FMN GV 05 Lier
60,Mechelsesteenweg 365,2023-01-16,07:00:00,34,14,20,FMN GV 05 Lier
60,Mechelsesteenweg 365,2023-01-16,08:00:00,46,28,18,FMN GV 05 Lier
60,Mechelsesteenweg 365,2023-01-16,09:00:00,12,6,6,FMN GV 05 Lier
60,Mechelsesteenweg 365,2023-01-16,10:00:00,14,10,4,FMN GV 05 Lier
60,Mechelsesteenweg 365,2023-01-16,11:00:00,4,0,4,FMN GV 05 Lier
60,Mechelsesteenweg 365,2023-01-16,12:00:00,12,6,6,FMN GV 05 Lier
60,Mechelsesteenweg 365,2023-01-16,13:00:00,4,2,2,FMN GV 05 Lier
60,Mechelsesteenweg 365,2023-01-16,14:00:00,12,6,6,FMN GV 05 Lier
60,Mechelsesteenweg 365,2023-01-16,15:00:00,24,14,10,FMN GV 05 Lier
60,Mechelsesteenweg 365,2023-01-16,16:00:00,40,12,28,FMN GV 05 Lier
60,Mechelsesteenweg 365,2023-01-16,17:00:00,30,26,4,FMN GV 05 Lier
60,Mechelsesteenweg 365,2023-01-16,18:00:00,6,6,0,FMN GV 05 Lier
60,Mechelsesteenweg 365,2023-01-16,19:00:00,0,0,0,FMN GV 05 Lier
60,Mechelsesteenweg 365,2023-01-16,20:00:00,0,0,0,FMN GV 05 Lier
60,Mechelsesteenweg 365,2023-01-16,21:00:00,2,2,0,FMN GV 05 Lier
60,Mechelsesteenweg 365,2023-01-16,22:00:00,2,2,0,FMN GV 05 Lier
60,Mechelsesteenweg 365,2023-01-16,23:00:00,0,0,0,FMN GV 05 Lier
60,Mechelsesteenweg 365,2023-01-17,00:00:00,0,0,0,FMN GV 05 Lier
60,Mechelsesteenweg 365,2023-01-17,01:00:00,0,0,0,FMN GV 05 Lier
60,Mechelsesteenweg 365,2023-01-17,02:00:00,0,0,0,FMN GV 05 Lier
60,Mechelsesteenweg 365,2023-01-17,03:00:00,0,0,0,FMN GV 05 Lier
60,Mechelsesteenweg 365,2023-01-17,04:00:00,0,0,0,FMN GV 05 Lier
60,Mechelsesteenweg 365,2023-01-17,05:00:00,0,0,0,FMN GV 05 Lier
60,Mechelsesteenweg 365,2023-01-17,06:00:00,0,0,0,FMN GV 05 Lier
60,Mechelsesteenweg 365,2023-01-17,07:00:00,12,2,10,FMN GV 05 Lier
60,Mechelsesteenweg 365,2023-01-17,08:00:00,22,16,6,FMN GV 05 Lier
60,Mechelsesteenweg 365,2023-01-17,09:00:00,14,10,4,FMN GV 05 Lier
60,Mechelsesteenweg 365,2023-01-17,10:00:00,22,16,6,FMN GV 05 Lier
60,Mechelsesteenweg 365,2023-01-17,11:00:00,28,18,10,FMN GV 05 Lier
60,Mechelsesteenweg 365,2023-01-17,12:00:00,58,24,34,FMN GV 05 Lier
60,Mechelsesteenweg 365,2023-01-17,13:00:00,104,62,42,FMN GV 05 Lier
60,Mechelsesteenweg 365,2023-01-17,14:00:00,84,54,30,FMN GV 05 Lier
60,Mechelsesteenweg 365,2023-01-17,15:00:00,96,48,48,FMN GV 05 Lier
60,Mechelsesteenweg 365,2023-01-17,16:00:00,116,44,72,FMN GV 05 Lier
60,Mechelsesteenweg 365,2023-01-17,17:00:00,60,32,28,FMN GV 05 Lier
60,Mechelsesteenweg 365,2023-01-17,18:00:00,10,6,4,FMN GV 05 Lier
60,Mechelsesteenweg 365,2023-01-17,19:00:00,8,4,4,FMN GV 05 Lier
60,Mechelsesteenweg 365,2023-01-17,20:00:00,4,2,2,FMN GV 05 Lier
60,Mechelsesteenweg 365,2023-01-17,21:00:00,2,2,0,FMN GV 05 Lier
60,Mechelsesteenweg 365,2023-01-17,22:00:00,0,0,0,FMN GV 05 Lier
60,Mechelsesteenweg 365,2023-01-17,23:00:00,0,0,0,FMN GV 05 Lier
60,Mechelsesteenweg 365,2023-01-18,00:00:00,0,0,0,FMN GV 05 Lier
60,Mechelsesteenweg 365,2023-01-18,01:00:00,0,0,0,FMN GV 05 Lier
60,Mechelsesteenweg 365,2023-01-18,02:00:00,0,0,0,FMN GV 05 Lier
60,Mechelsesteenweg 365,2023-01-18,03:00:00,0,0,0,FMN GV 05 Lier
60,Mechelsesteenweg 365,2023-01-18,04:00:00,0,0,0,FMN GV 05 Lier
60,Mechelsesteenweg 365,2023-01-18,05:00:00,2,2,0,FMN GV 05 Lier
60,Mechelsesteenweg 365,2023-01-18,06:00:00,8,4,4,FMN GV 05 Lier
60,Mechelsesteenweg 365,2023-01-18,07:00:00,12,2,10,FMN GV 05 Lier
60,Mechelsesteenweg 365,2023-01-18,08:00:00,32,24,8,FMN GV 05 Lier
60,Mechelsesteenweg 365,2023-01-18,09:00:00,16,6,10,FMN GV 05 Lier
60,Mechelsesteenweg 365,2023-01-18,10:00:00,28,18,10,FMN GV 05 Lier
60,Mechelsesteenweg 365,2023-01-18,11:00:00,38,24,14,FMN GV 05 Lier
60,Mechelsesteenweg 365,2023-01-18,12:00:00,88,32,56,FMN GV 05 Lier
60,Mechelsesteenweg 365,2023-01-18,13:00:00,64,24,40,FMN GV 05 Lier
60,Mechelsesteenweg 365,2023-01-18,14:00:00,108,48,60,FMN GV 05 Lier
60,Mechelsesteenweg 365,2023-01-18,15:00:00,84,32,52,FMN GV 05 Lier
60,Mechelsesteenweg 365,2023-01-18,16:00:00,62,38,24,FMN GV 05 Lier
60,Mechelsesteenweg 365,2023-01-18,17:00:00,32,22,10,FMN GV 05 Lier
60,Mechelsesteenweg 365,2023-01-18,18:00:00,8,8,0,FMN GV 05 Lier
60,Mechelsesteenweg 365,2023-01-18,19:00:00,2,2,0,FMN GV 05 Lier
60,Mechelsesteenweg 365,2023-01-18,20:00:00,4,4,0,FMN GV 05 Lier
60,Mechelsesteenweg 365,2023-01-18,21:00:00,2,0,2,FMN GV 05 Lier
60,Mechelsesteenweg 365,2023-01-18,22:00:00,0,0,0,FMN GV 05 Lier
60,Mechelsesteenweg 365,2023-01-18,23:00:00,0,0,0,FMN GV 05 Lier
60,Mechelsesteenweg 365,2023-01-19,00:00:00,0,0,0,FMN GV 05 Lier
60,Mechelsesteenweg 365,2023-01-19,01:00:00,0,0,0,FMN GV 05 Lier
60,Mechelsesteenweg 365,2023-01-19,02:00:00,0,0,0,FMN GV 05 Lier
60,Mechelsesteenweg 365,2023-01-19,03:00:00,0,0,0,FMN GV 05 Lier
60,Mechelsesteenweg 365,2023-01-19,04:00:00,0,0,0,FMN GV 05 Lier
60,Mechelsesteenweg 365,2023-01-19,05:00:00,0,0,0,FMN GV 05 Lier
60,Mechelsesteenweg 365,2023-01-19,06:00:00,2,0,2,FMN GV 05 Lier
60,Mechelsesteenweg 365,2023-01-19,07:00:00,2,0,2,FMN GV 05 Lier
60,Mechelsesteenweg 365,2023-01-19,08:00:00,6,0,6,FMN GV 05 Lier
60,Mechelsesteenweg 365,2023-01-19,09:00:00,0,0,0,FMN GV 05 Lier
60,Mechelsesteenweg 365,2023-01-19,10:00:00,6,0,6,FMN GV 05 Lier
60,Mechelsesteenweg 365,2023-01-19,11:00:00,12,0,12,FMN GV 05 Lier
60,Mechelsesteenweg 365,2023-01-19,12:00:00,16,8,8,FMN GV 05 Lier
60,Mechelsesteenweg 365,2023-01-19,13:00:00,16,6,10,FMN GV 05 Lier
60,Mechelsesteenweg 365,2023-01-19,14:00:00,28,16,12,FMN GV 05 Lier
60,Mechelsesteenweg 365,2023-01-19,15:00:00,54,28,26,FMN GV 05 Lier
60,Mechelsesteenweg 365,2023-01-19,16:00:00,60,28,32,FMN GV 05 Lier
60,Mechelsesteenweg 365,2023-01-19,17:00:00,34,16,18,FMN GV 05 Lier
60,Mechelsesteenweg 365,2023-01-19,18:00:00,6,2,4,FMN GV 05 Lier
60,Mechelsesteenweg 365,2023-01-19,19:00:00,2,2,0,FMN GV 05 Lier
60,Mechelsesteenweg 365,2023-01-19,20:00:00,4,0,4,FMN GV 05 Lier
60,Mechelsesteenweg 365,2023-01-19,21:00:00,4,2,2,FMN GV 05 Lier
60,Mechelsesteenweg 365,2023-01-19,22:00:00,2,2,0,FMN GV 05 Lier
60,Mechelsesteenweg 365,2023-01-19,23:00:00,0,0,0,FMN GV 05 Lier
60,Mechelsesteenweg 365,2023-01-20,00:00:00,0,0,0,FMN GV 05 Lier
60,Mechelsesteenweg 365,2023-01-20,01:00:00,0,0,0,FMN GV 05 Lier
60,Mechelsesteenweg 365,2023-01-20,02:00:00,0,0,0,FMN GV 05 Lier
60,Mechelsesteenweg 365,2023-01-20,03:00:00,2,0,2,FMN GV 05 Lier
60,Mechelsesteenweg 365,2023-01-20,04:00:00,0,0,0,FMN GV 05 Lier
60,Mechelsesteenweg 365,2023-01-20,05:00:00,0,0,0,FMN GV 05 Lier
60,Mechelsesteenweg 365,2023-01-20,06:00:00,6,0,6,FMN GV 05 Lier
60,Mechelsesteenweg 365,2023-01-20,07:00:00,24,20,4,FMN GV 05 Lier
60,Mechelsesteenweg 365,2023-01-20,08:00:00,30,22,8,FMN GV 05 Lier
60,Mechelsesteenweg 365,2023-01-20,09:00:00,6,2,4,FMN GV 05 Lier
60,Mechelsesteenweg 365,2023-01-20,10:00:00,0,0,0,FMN GV 05 Lier
60,Mechelsesteenweg 365,2023-01-20,11:00:00,2,2,0,FMN GV 05 Lier
60,Mechelsesteenweg 365,2023-01-20,12:00:00,4,2,2,FMN GV 05 Lier
60,Mechelsesteenweg 365,2023-01-20,13:00:00,8,6,2,FMN GV 05 Lier
60,Mechelsesteenweg 365,2023-01-20,14:00:00,12,6,6,FMN GV 05 Lier
60,Mechelsesteenweg 365,2023-01-20,15:00:00,8,2,6,FMN GV 05 Lier
60,Mechelsesteenweg 365,2023-01-20,16:00:00,54,8,46,FMN GV 05 Lier
60,Mechelsesteenweg 365,2023-01-20,17:00:00,10,8,2,FMN GV 05 Lier
60,Mechelsesteenweg 365,2023-01-20,18:00:00,0,0,0,FMN GV 05 Lier
60,Mechelsesteenweg 365,2023-01-20,19:00:00,4,4,0,FMN GV 05 Lier
60,Mechelsesteenweg 365,2023-01-20,20:00:00,2,2,0,FMN GV 05 Lier
60,Mechelsesteenweg 365,2023-01-20,21:00:00,0,0,0,FMN GV 05 Lier
60,Mechelsesteenweg 365,2023-01-20,22:00:00,2,2,0,FMN GV 05 Lier
60,Mechelsesteenweg 365,2023-01-20,23:00:00,0,0,0,FMN GV 05 Lier
60,Mechelsesteenweg 365,2023-01-21,00:00:00,2,0,2,FMN GV 05 Lier
60,Mechelsesteenweg 365,2023-01-21,01:00:00,0,0,0,FMN GV 05 Lier
60,Mechelsesteenweg 365,2023-01-21,02:00:00,2,0,2,FMN GV 05 Lier
60,Mechelsesteenweg 365,2023-01-21,03:00:00,0,0,0,FMN GV 05 Lier
60,Mechelsesteenweg 365,2023-01-21,04:00:00,0,0,0,FMN GV 05 Lier
60,Mechelsesteenweg 365,2023-01-21,05:00:00,0,0,0,FMN GV 05 Lier
60,Mechelsesteenweg 365,2023-01-21,06:00:00,0,0,0,FMN GV 05 Lier
60,Mechelsesteenweg 365,2023-01-21,07:00:00,0,0,0,FMN GV 05 Lier
60,Mechelsesteenweg 365,2023-01-21,08:00:00,0,0,0,FMN GV 05 Lier
60,Mechelsesteenweg 365,2023-01-21,09:00:00,0,0,0,FMN GV 05 Lier
60,Mechelsesteenweg 365,2023-01-21,10:00:00,18,10,8,FMN GV 05 Lier
60,Mechelsesteenweg 365,2023-01-21,11:00:00,16,8,8,FMN GV 05 Lier
60,Mechelsesteenweg 365,2023-01-21,12:00:00,30,18,12,FMN GV 05 Lier
60,Mechelsesteenweg 365,2023-01-21,13:00:00,54,24,30,FMN GV 05 Lier
60,Mechelsesteenweg 365,2023-01-21,14:00:00,32,20,12,FMN GV 05 Lier
60,Mechelsesteenweg 365,2023-01-21,15:00:00,60,26,34,FMN GV 05 Lier
60,Mechelsesteenweg 365,2023-01-21,16:00:00,22,12,10,FMN GV 05 Lier
60,Mechelsesteenweg 365,2023-01-21,17:00:00,16,8,8,FMN GV 05 Lier
60,Mechelsesteenweg 365,2023-01-21,18:00:00,0,0,0,FMN GV 05 Lier
60,Mechelsesteenweg 365,2023-01-21,19:00:00,0,0,0,FMN GV 05 Lier
60,Mechelsesteenweg 365,2023-01-21,20:00:00,0,0,0,FMN GV 05 Lier
60,Mechelsesteenweg 365,2023-01-21,21:00:00,8,4,4,FMN GV 05 Lier
60,Mechelsesteenweg 365,2023-01-21,22:00:00,0,0,0,FMN GV 05 Lier
60,Mechelsesteenweg 365,2023-01-21,23:00:00,0,0,0,FMN GV 05 Lier
60,Mechelsesteenweg 365,2023-01-22,00:00:00,2,0,2,FMN GV 05 Lier
60,Mechelsesteenweg 365,2023-01-22,01:00:00,0,0,0,FMN GV 05 Lier
60,Mechelsesteenweg 365,2023-01-22,02:00:00,0,0,0,FMN GV 05 Lier
60,Mechelsesteenweg 365,2023-01-22,03:00:00,0,0,0,FMN GV 05 Lier
60,Mechelsesteenweg 365,2023-01-22,04:00:00,0,0,0,FMN GV 05 Lier
60,Mechelsesteenweg 365,2023-01-22,05:00:00,0,0,0,FMN GV 05 Lier
60,Mechelsesteenweg 365,2023-01-22,06:00:00,2,2,0,FMN GV 05 Lier
60,Mechelsesteenweg 365,2023-01-22,07:00:00,0,0,0,FMN GV 05 Lier
60,Mechelsesteenweg 365,2023-01-22,08:00:00,2,0,2,FMN GV 05 Lier
60,Mechelsesteenweg 365,2023-01-22,09:00:00,14,6,8,FMN GV 05 Lier
60,Mechelsesteenweg 365,2023-01-22,10:00:00,16,6,10,FMN GV 05 Lier
60,Mechelsesteenweg 365,2023-01-22,11:00:00,34,14,20,FMN GV 05 Lier
60,Mechelsesteenweg 365,2023-01-22,12:00:00,40,20,20,FMN GV 05 Lier
60,Mechelsesteenweg 365,2023-01-22,13:00:00,34,10,24,FMN GV 05 Lier
60,Mechelsesteenweg 365,2023-01-22,14:00:00,14,6,8,FMN GV 05 Lier
60,Mechelsesteenweg 365,2023-01-22,15:00:00,22,8,14,FMN GV 05 Lier
60,Mechelsesteenweg 365,2023-01-22,16:00:00,14,6,8,FMN GV 05 Lier
60,Mechelsesteenweg 365,2023-01-22,17:00:00,2,2,0,FMN GV 05 Lier
60,Mechelsesteenweg 365,2023-01-22,18:00:00,0,0,0,FMN GV 05 Lier
60,Mechelsesteenweg 365,2023-01-22,19:00:00,2,2,0,FMN GV 05 Lier
60,Mechelsesteenweg 365,2023-01-22,20:00:00,0,0,0,FMN GV 05 Lier
60,Mechelsesteenweg 365,2023-01-22,21:00:00,0,0,0,FMN GV 05 Lier
60,Mechelsesteenweg 365,2023-01-22,22:00:00,2,2,0,FMN GV 05 Lier
60,Mechelsesteenweg 365,2023-01-22,23:00:00,0,0,0,FMN GV 05 Lier
60,Mechelsesteenweg 365,2023-01-23,00:00:00,0,0,0,FMN GV 05 Lier
60,Mechelsesteenweg 365,2023-01-23,01:00:00,0,0,0,FMN GV 05 Lier
60,Mechelsesteenweg 365,2023-01-23,02:00:00,0,0,0,FMN GV 05 Lier
60,Mechelsesteenweg 365,2023-01-23,03:00:00,0,0,0,FMN GV 05 Lier
60,Mechelsesteenweg 365,2023-01-23,04:00:00,0,0,0,FMN GV 05 Lier
60,Mechelsesteenweg 365,2023-01-23,05:00:00,2,0,2,FMN GV 05 Lier
60,Mechelsesteenweg 365,2023-01-23,06:00:00,10,2,8,FMN GV 05 Lier
60,Mechelsesteenweg 365,2023-01-23,07:00:00,46,24,22,FMN GV 05 Lier
60,Mechelsesteenweg 365,2023-01-23,08:00:00,70,50,20,FMN GV 05 Lier
60,Mechelsesteenweg 365,2023-01-23,09:00:00,10,6,4,FMN GV 05 Lier
60,Mechelsesteenweg 365,2023-01-23,10:00:00,16,10,6,FMN GV 05 Lier
60,Mechelsesteenweg 365,2023-01-23,11:00:00,16,4,12,FMN GV 05 Lier
60,Mechelsesteenweg 365,2023-01-23,12:00:00,60,44,16,FMN GV 05 Lier
60,Mechelsesteenweg 365,2023-01-23,13:00:00,32,14,18,FMN GV 05 Lier
60,Mechelsesteenweg 365,2023-01-23,14:00:00,34,14,20,FMN GV 05 Lier
60,Mechelsesteenweg 365,2023-01-23,15:00:00,128,20,108,FMN GV 05 Lier
60,Mechelsesteenweg 365,2023-01-23,16:00:00,114,44,70,FMN GV 05 Lier
60,Mechelsesteenweg 365,2023-01-23,17:00:00,58,28,30,FMN GV 05 Lier
60,Mechelsesteenweg 365,2023-01-23,18:00:00,8,6,2,FMN GV 05 Lier
60,Mechelsesteenweg 365,2023-01-23,19:00:00,2,2,0,FMN GV 05 Lier
60,Mechelsesteenweg 365,2023-01-23,20:00:00,0,0,0,FMN GV 05 Lier
60,Mechelsesteenweg 365,2023-01-23,21:00:00,0,0,0,FMN GV 05 Lier
60,Mechelsesteenweg 365,2023-01-23,22:00:00,2,2,0,FMN GV 05 Lier
60,Mechelsesteenweg 365,2023-01-23,23:00:00,2,2,0,FMN GV 05 Lier
60,Mechelsesteenweg 365,2023-01-24,00:00:00,0,0,0,FMN GV 05 Lier
60,Mechelsesteenweg 365,2023-01-24,01:00:00,0,0,0,FMN GV 05 Lier
60,Mechelsesteenweg 365,2023-01-24,02:00:00,0,0,0,FMN GV 05 Lier
60,Mechelsesteenweg 365,2023-01-24,03:00:00,0,0,0,FMN GV 05 Lier
60,Mechelsesteenweg 365,2023-01-24,04:00:00,0,0,0,FMN GV 05 Lier
60,Mechelsesteenweg 365,2023-01-24,05:00:00,2,2,0,FMN GV 05 Lier
60,Mechelsesteenweg 365,2023-01-24,06:00:00,20,6,14,FMN GV 05 Lier
60,Mechelsesteenweg 365,2023-01-24,07:00:00,38,16,22,FMN GV 05 Lier
60,Mechelsesteenweg 365,2023-01-24,08:00:00,66,44,22,FMN GV 05 Lier
60,Mechelsesteenweg 365,2023-01-24,09:00:00,32,14,18,FMN GV 05 Lier
60,Mechelsesteenweg 365,2023-01-24,10:00:00,34,22,12,FMN GV 05 Lier
60,Mechelsesteenweg 365,2023-01-24,11:00:00,36,10,26,FMN GV 05 Lier
60,Mechelsesteenweg 365,2023-01-24,12:00:00,56,40,16,FMN GV 05 Lier
60,Mechelsesteenweg 365,2023-01-24,13:00:00,64,36,28,FMN GV 05 Lier
60,Mechelsesteenweg 365,2023-01-24,14:00:00,30,12,18,FMN GV 05 Lier
60,Mechelsesteenweg 365,2023-01-24,15:00:00,86,32,54,FMN GV 05 Lier
60,Mechelsesteenweg 365,2023-01-24,16:00:00,96,30,66,FMN GV 05 Lier
60,Mechelsesteenweg 365,2023-01-24,17:00:00,46,26,20,FMN GV 05 Lier
60,Mechelsesteenweg 365,2023-01-24,18:00:00,12,8,4,FMN GV 05 Lier
60,Mechelsesteenweg 365,2023-01-24,19:00:00,6,2,4,FMN GV 05 Lier
60,Mechelsesteenweg 365,2023-01-24,20:00:00,6,4,2,FMN GV 05 Lier
60,Mechelsesteenweg 365,2023-01-24,21:00:00,8,4,4,FMN GV 05 Lier
60,Mechelsesteenweg 365,2023-01-24,22:00:00,2,2,0,FMN GV 05 Lier
60,Mechelsesteenweg 365,2023-01-24,23:00:00,0,0,0,FMN GV 05 Lier
60,Mechelsesteenweg 365,2023-01-25,00:00:00,0,0,0,FMN GV 05 Lier
60,Mechelsesteenweg 365,2023-01-25,01:00:00,0,0,0,FMN GV 05 Lier
60,Mechelsesteenweg 365,2023-01-25,02:00:00,0,0,0,FMN GV 05 Lier
60,Mechelsesteenweg 365,2023-01-25,03:00:00,0,0,0,FMN GV 05 Lier
60,Mechelsesteenweg 365,2023-01-25,04:00:00,0,0,0,FMN GV 05 Lier
60,Mechelsesteenweg 365,2023-01-25,05:00:00,0,0,0,FMN GV 05 Lier
60,Mechelsesteenweg 365,2023-01-25,06:00:00,20,8,12,FMN GV 05 Lier
60,Mechelsesteenweg 365,2023-01-25,07:00:00,44,14,30,FMN GV 05 Lier
60,Mechelsesteenweg 365,2023-01-25,08:00:00,52,38,14,FMN GV 05 Lier
60,Mechelsesteenweg 365,2023-01-25,09:00:00,22,6,16,FMN GV 05 Lier
60,Mechelsesteenweg 365,2023-01-25,10:00:00,20,12,8,FMN GV 05 Lier
60,Mechelsesteenweg 365,2023-01-25,11:00:00,24,10,14,FMN GV 05 Lier
60,Mechelsesteenweg 365,2023-01-25,12:00:00,72,22,50,FMN GV 05 Lier
60,Mechelsesteenweg 365,2023-01-25,13:00:00,40,18,22,FMN GV 05 Lier
60,Mechelsesteenweg 365,2023-01-25,14:00:00,38,16,22,FMN GV 05 Lier
60,Mechelsesteenweg 365,2023-01-25,15:00:00,32,18,14,FMN GV 05 Lier
60,Mechelsesteenweg 365,2023-01-25,16:00:00,44,36,8,FMN GV 05 Lier
60,Mechelsesteenweg 365,2023-01-25,17:00:00,38,24,14,FMN GV 05 Lier
60,Mechelsesteenweg 365,2023-01-25,18:00:00,16,10,6,FMN GV 05 Lier
60,Mechelsesteenweg 365,2023-01-25,19:00:00,10,6,4,FMN GV 05 Lier
60,Mechelsesteenweg 365,2023-01-25,20:00:00,10,8,2,FMN GV 05 Lier
60,Mechelsesteenweg 365,2023-01-25,21:00:00,4,0,4,FMN GV 05 Lier
60,Mechelsesteenweg 365,2023-01-25,22:00:00,0,0,0,FMN GV 05 Lier
60,Mechelsesteenweg 365,2023-01-25,23:00:00,0,0,0,FMN GV 05 Lier
60,Mechelsesteenweg 365,2023-01-26,00:00:00,0,0,0,FMN GV 05 Lier
60,Mechelsesteenweg 365,2023-01-26,01:00:00,0,0,0,FMN GV 05 Lier
60,Mechelsesteenweg 365,2023-01-26,02:00:00,0,0,0,FMN GV 05 Lier
60,Mechelsesteenweg 365,2023-01-26,03:00:00,0,0,0,FMN GV 05 Lier
60,Mechelsesteenweg 365,2023-01-26,04:00:00,0,0,0,FMN GV 05 Lier
60,Mechelsesteenweg 365,2023-01-26,05:00:00,0,0,0,FMN GV 05 Lier
60,Mechelsesteenweg 365,2023-01-26,06:00:00,2,0,2,FMN GV 05 Lier
60,Mechelsesteenweg 365,2023-01-26,07:00:00,20,8,12,FMN GV 05 Lier
60,Mechelsesteenweg 365,2023-01-26,08:00:00,36,24,12,FMN GV 05 Lier
60,Mechelsesteenweg 365,2023-01-26,09:00:00,12,6,6,FMN GV 05 Lier
60,Mechelsesteenweg 365,2023-01-26,10:00:00,8,4,4,FMN GV 05 Lier
60,Mechelsesteenweg 365,2023-01-26,11:00:00,16,4,12,FMN GV 05 Lier
60,Mechelsesteenweg 365,2023-01-26,12:00:00,12,4,8,FMN GV 05 Lier
60,Mechelsesteenweg 365,2023-01-26,13:00:00,30,8,22,FMN GV 05 Lier
60,Mechelsesteenweg 365,2023-01-26,14:00:00,56,30,26,FMN GV 05 Lier
60,Mechelsesteenweg 365,2023-01-26,15:00:00,54,28,26,FMN GV 05 Lier
60,Mechelsesteenweg 365,2023-01-26,16:00:00,96,30,66,FMN GV 05 Lier
60,Mechelsesteenweg 365,2023-01-26,17:00:00,48,26,22,FMN GV 05 Lier
60,Mechelsesteenweg 365,2023-01-26,18:00:00,10,4,6,FMN GV 05 Lier
60,Mechelsesteenweg 365,2023-01-26,19:00:00,8,6,2,FMN GV 05 Lier
60,Mechelsesteenweg 365,2023-01-26,20:00:00,10,2,8,FMN GV 05 Lier
60,Mechelsesteenweg 365,2023-01-26,21:00:00,6,4,2,FMN GV 05 Lier
60,Mechelsesteenweg 365,2023-01-26,22:00:00,2,0,2,FMN GV 05 Lier
60,Mechelsesteenweg 365,2023-01-26,23:00:00,0,0,0,FMN GV 05 Lier
60,Mechelsesteenweg 365,2023-01-27,00:00:00,0,0,0,FMN GV 05 Lier
60,Mechelsesteenweg 365,2023-01-27,01:00:00,0,0,0,FMN GV 05 Lier
60,Mechelsesteenweg 365,2023-01-27,02:00:00,0,0,0,FMN GV 05 Lier
60,Mechelsesteenweg 365,2023-01-27,03:00:00,0,0,0,FMN GV 05 Lier
60,Mechelsesteenweg 365,2023-01-27,04:00:00,0,0,0,FMN GV 05 Lier
60,Mechelsesteenweg 365,2023-01-27,05:00:00,6,0,6,FMN GV 05 Lier
60,Mechelsesteenweg 365,2023-01-27,06:00:00,10,0,10,FMN GV 05 Lier
60,Mechelsesteenweg 365,2023-01-27,07:00:00,40,24,16,FMN GV 05 Lier
60,Mechelsesteenweg 365,2023-01-27,08:00:00,56,40,16,FMN GV 05 Lier
60,Mechelsesteenweg 365,2023-01-27,09:00:00,24,10,14,FMN GV 05 Lier
60,Mechelsesteenweg 365,2023-01-27,10:00:00,14,6,8,FMN GV 05 Lier
60,Mechelsesteenweg 365,2023-01-27,11:00:00,34,14,20,FMN GV 05 Lier
60,Mechelsesteenweg 365,2023-01-27,12:00:00,56,16,40,FMN GV 05 Lier
60,Mechelsesteenweg 365,2023-01-27,13:00:00,62,26,36,FMN GV 05 Lier
60,Mechelsesteenweg 365,2023-01-27,14:00:00,66,30,36,FMN GV 05 Lier
60,Mechelsesteenweg 365,2023-01-27,15:00:00,42,28,14,FMN GV 05 Lier
60,Mechelsesteenweg 365,2023-01-27,16:00:00,106,38,68,FMN GV 05 Lier
60,Mechelsesteenweg 365,2023-01-27,17:00:00,34,14,20,FMN GV 05 Lier
60,Mechelsesteenweg 365,2023-01-27,18:00:00,12,4,8,FMN GV 05 Lier
60,Mechelsesteenweg 365,2023-01-27,19:00:00,10,8,2,FMN GV 05 Lier
60,Mechelsesteenweg 365,2023-01-27,20:00:00,0,0,0,FMN GV 05 Lier
60,Mechelsesteenweg 365,2023-01-27,21:00:00,0,0,0,FMN GV 05 Lier
60,Mechelsesteenweg 365,2023-01-27,22:00:00,0,0,0,FMN GV 05 Lier
60,Mechelsesteenweg 365,2023-01-27,23:00:00,0,0,0,FMN GV 05 Lier
60,Mechelsesteenweg 365,2023-01-28,00:00:00,0,0,0,FMN GV 05 Lier
60,Mechelsesteenweg 365,2023-01-28,01:00:00,0,0,0,FMN GV 05 Lier
60,Mechelsesteenweg 365,2023-01-28,02:00:00,0,0,0,FMN GV 05 Lier
60,Mechelsesteenweg 365,2023-01-28,03:00:00,0,0,0,FMN GV 05 Lier
60,Mechelsesteenweg 365,2023-01-28,04:00:00,0,0,0,FMN GV 05 Lier
60,Mechelsesteenweg 365,2023-01-28,05:00:00,0,0,0,FMN GV 05 Lier
60,Mechelsesteenweg 365,2023-01-28,06:00:00,2,0,2,FMN GV 05 Lier
60,Mechelsesteenweg 365,2023-01-28,07:00:00,4,0,4,FMN GV 05 Lier
60,Mechelsesteenweg 365,2023-01-28,08:00:00,10,6,4,FMN GV 05 Lier
60,Mechelsesteenweg 365,2023-01-28,09:00:00,26,8,18,FMN GV 05 Lier
60,Mechelsesteenweg 365,2023-01-28,10:00:00,46,20,26,FMN GV 05 Lier
60,Mechelsesteenweg 365,2023-01-28,11:00:00,62,36,26,FMN GV 05 Lier
60,Mechelsesteenweg 365,2023-01-28,12:00:00,78,36,42,FMN GV 05 Lier
60,Mechelsesteenweg 365,2023-01-28,13:00:00,80,40,40,FMN GV 05 Lier
60,Mechelsesteenweg 365,2023-01-28,14:00:00,146,74,72,FMN GV 05 Lier
60,Mechelsesteenweg 365,2023-01-28,15:00:00,124,30,94,FMN GV 05 Lier
60,Mechelsesteenweg 365,2023-01-28,16:00:00,50,16,34,FMN GV 05 Lier
60,Mechelsesteenweg 365,2023-01-28,17:00:00,16,8,8,FMN GV 05 Lier
60,Mechelsesteenweg 365,2023-01-28,18:00:00,6,4,2,FMN GV 05 Lier
60,Mechelsesteenweg 365,2023-01-28,19:00:00,4,4,0,FMN GV 05 Lier
60,Mechelsesteenweg 365,2023-01-28,20:00:00,0,0,0,FMN GV 05 Lier
60,Mechelsesteenweg 365,2023-01-28,21:00:00,0,0,0,FMN GV 05 Lier
60,Mechelsesteenweg 365,2023-01-28,22:00:00,0,0,0,FMN GV 05 Lier
60,Mechelsesteenweg 365,2023-01-28,23:00:00,0,0,0,FMN GV 05 Lier
60,Mechelsesteenweg 365,2023-01-29,00:00:00,0,0,0,FMN GV 05 Lier
60,Mechelsesteenweg 365,2023-01-29,01:00:00,0,0,0,FMN GV 05 Lier
60,Mechelsesteenweg 365,2023-01-29,02:00:00,0,0,0,FMN GV 05 Lier
60,Mechelsesteenweg 365,2023-01-29,03:00:00,0,0,0,FMN GV 05 Lier
60,Mechelsesteenweg 365,2023-01-29,04:00:00,0,0,0,FMN GV 05 Lier
60,Mechelsesteenweg 365,2023-01-29,05:00:00,0,0,0,FMN GV 05 Lier
60,Mechelsesteenweg 365,2023-01-29,06:00:00,0,0,0,FMN GV 05 Lier
60,Mechelsesteenweg 365,2023-01-29,07:00:00,0,0,0,FMN GV 05 Lier
60,Mechelsesteenweg 365,2023-01-29,08:00:00,2,0,2,FMN GV 05 Lier
60,Mechelsesteenweg 365,2023-01-29,09:00:00,38,30,8,FMN GV 05 Lier
60,Mechelsesteenweg 365,2023-01-29,10:00:00,96,52,44,FMN GV 05 Lier
60,Mechelsesteenweg 365,2023-01-29,11:00:00,130,60,70,FMN GV 05 Lier
60,Mechelsesteenweg 365,2023-01-29,12:00:00,34,14,20,FMN GV 05 Lier
60,Mechelsesteenweg 365,2023-01-29,13:00:00,50,24,26,FMN GV 05 Lier
60,Mechelsesteenweg 365,2023-01-29,14:00:00,52,28,24,FMN GV 05 Lier
60,Mechelsesteenweg 365,2023-01-29,15:00:00,50,20,30,FMN GV 05 Lier
60,Mechelsesteenweg 365,2023-01-29,16:00:00,26,12,14,FMN GV 05 Lier
60,Mechelsesteenweg 365,2023-01-29,17:00:00,12,6,6,FMN GV 05 Lier
60,Mechelsesteenweg 365,2023-01-29,18:00:00,6,2,4,FMN GV 05 Lier
60,Mechelsesteenweg 365,2023-01-29,19:00:00,6,0,6,FMN GV 05 Lier
60,Mechelsesteenweg 365,2023-01-29,20:00:00,0,0,0,FMN GV 05 Lier
60,Mechelsesteenweg 365,2023-01-29,21:00:00,0,0,0,FMN GV 05 Lier
60,Mechelsesteenweg 365,2023-01-29,22:00:00,0,0,0,FMN GV 05 Lier
60,Mechelsesteenweg 365,2023-01-29,23:00:00,0,0,0,FMN GV 05 Lier
60,Mechelsesteenweg 365,2023-01-30,00:00:00,0,0,0,FMN GV 05 Lier
60,Mechelsesteenweg 365,2023-01-30,01:00:00,0,0,0,FMN GV 05 Lier
60,Mechelsesteenweg 365,2023-01-30,02:00:00,0,0,0,FMN GV 05 Lier
60,Mechelsesteenweg 365,2023-01-30,03:00:00,0,0,0,FMN GV 05 Lier
60,Mechelsesteenweg 365,2023-01-30,04:00:00,0,0,0,FMN GV 05 Lier
60,Mechelsesteenweg 365,2023-01-30,05:00:00,4,0,4,FMN GV 05 Lier
60,Mechelsesteenweg 365,2023-01-30,06:00:00,4,2,2,FMN GV 05 Lier
60,Mechelsesteenweg 365,2023-01-30,07:00:00,32,4,28,FMN GV 05 Lier
60,Mechelsesteenweg 365,2023-01-30,08:00:00,40,10,30,FMN GV 05 Lier
60,Mechelsesteenweg 365,2023-01-30,09:00:00,12,8,4,FMN GV 05 Lier
60,Mechelsesteenweg 365,2023-01-30,10:00:00,26,16,10,FMN GV 05 Lier
60,Mechelsesteenweg 365,2023-01-30,11:00:00,46,18,28,FMN GV 05 Lier
60,Mechelsesteenweg 365,2023-01-30,12:00:00,40,12,28,FMN GV 05 Lier
60,Mechelsesteenweg 365,2023-01-30,13:00:00,74,40,34,FMN GV 05 Lier
60,Mechelsesteenweg 365,2023-01-30,14:00:00,54,32,22,FMN GV 05 Lier
60,Mechelsesteenweg 365,2023-01-30,15:00:00,42,26,16,FMN GV 05 Lier
60,Mechelsesteenweg 365,2023-01-30,16:00:00,100,64,36,FMN GV 05 Lier
60,Mechelsesteenweg 365,2023-01-30,17:00:00,52,30,22,FMN GV 05 Lier
60,Mechelsesteenweg 365,2023-01-30,18:00:00,28,18,10,FMN GV 05 Lier
60,Mechelsesteenweg 365,2023-01-30,19:00:00,4,2,2,FMN GV 05 Lier
60,Mechelsesteenweg 365,2023-01-30,20:00:00,6,4,2,FMN GV 05 Lier
60,Mechelsesteenweg 365,2023-01-30,21:00:00,6,4,2,FMN GV 05 Lier
60,Mechelsesteenweg 365,2023-01-30,22:00:00,6,6,0,FMN GV 05 Lier
60,Mechelsesteenweg 365,2023-01-30,23:00:00,0,0,0,FMN GV 05 Lier
60,Mechelsesteenweg 365,2023-01-31,00:00:00,0,0,0,FMN GV 05 Lier
60,Mechelsesteenweg 365,2023-01-31,01:00:00,0,0,0,FMN GV 05 Lier
60,Mechelsesteenweg 365,2023-01-31,02:00:00,0,0,0,FMN GV 05 Lier
60,Mechelsesteenweg 365,2023-01-31,03:00:00,0,0,0,FMN GV 05 Lier
60,Mechelsesteenweg 365,2023-01-31,04:00:00,0,0,0,FMN GV 05 Lier
60,Mechelsesteenweg 365,2023-01-31,05:00:00,2,0,2,FMN GV 05 Lier
60,Mechelsesteenweg 365,2023-01-31,06:00:00,14,4,10,FMN GV 05 Lier
60,Mechelsesteenweg 365,2023-01-31,07:00:00,44,14,30,FMN GV 05 Lier
60,Mechelsesteenweg 365,2023-01-31,08:00:00,86,48,38,FMN GV 05 Lier
60,Mechelsesteenweg 365,2023-01-31,09:00:00,38,20,18,FMN GV 05 Lier
60,Mechelsesteenweg 365,2023-01-31,10:00:00,40,26,14,FMN GV 05 Lier
60,Mechelsesteenweg 365,2023-01-31,11:00:00,34,22,12,FMN GV 05 Lier
60,Mechelsesteenweg 365,2023-01-31,12:00:00,38,18,20,FMN GV 05 Lier
60,Mechelsesteenweg 365,2023-01-31,13:00:00,48,28,20,FMN GV 05 Lier
60,Mechelsesteenweg 365,2023-01-31,14:00:00,30,20,10,FMN GV 05 Lier
60,Mechelsesteenweg 365,2023-01-31,15:00:00,54,32,22,FMN GV 05 Lier
60,Mechelsesteenweg 365,2023-01-31,16:00:00,114,46,68,FMN GV 05 Lier
60,Mechelsesteenweg 365,2023-01-31,17:00:00,70,40,30,FMN GV 05 Lier
60,Mechelsesteenweg 365,2023-01-31,18:00:00,22,14,8,FMN GV 05 Lier
60,Mechelsesteenweg 365,2023-01-31,19:00:00,8,2,6,FMN GV 05 Lier
60,Mechelsesteenweg 365,2023-01-31,20:00:00,6,0,6,FMN GV 05 Lier
60,Mechelsesteenweg 365,2023-01-31,21:00:00,2,2,0,FMN GV 05 Lier
60,Mechelsesteenweg 365,2023-01-31,22:00:00,2,2,0,FMN GV 05 Lier
60,Mechelsesteenweg 365,2023-01-31,23:00:00,0,0,0,FMN GV 05 Lier
60,Mechelsesteenweg 365,2023-02-01,00:00:00,0,0,0,FMN GV 05 Lier
60,Mechelsesteenweg 365,2023-02-01,01:00:00,0,0,0,FMN GV 05 Lier
60,Mechelsesteenweg 365,2023-02-01,02:00:00,0,0,0,FMN GV 05 Lier
60,Mechelsesteenweg 365,2023-02-01,03:00:00,0,0,0,FMN GV 05 Lier
60,Mechelsesteenweg 365,2023-02-01,04:00:00,0,0,0,FMN GV 05 Lier
60,Mechelsesteenweg 365,2023-02-01,05:00:00,0,0,0,FMN GV 05 Lier
60,Mechelsesteenweg 365,2023-02-01,06:00:00,18,10,8,FMN GV 05 Lier
60,Mechelsesteenweg 365,2023-02-01,07:00:00,76,42,34,FMN GV 05 Lier
60,Mechelsesteenweg 365,2023-02-01,08:00:00,68,44,24,FMN GV 05 Lier
60,Mechelsesteenweg 365,2023-02-01,09:00:00,30,16,14,FMN GV 05 Lier
60,Mechelsesteenweg 365,2023-02-01,10:00:00,48,26,22,FMN GV 05 Lier
60,Mechelsesteenweg 365,2023-02-01,11:00:00,38,22,16,FMN GV 05 Lier
60,Mechelsesteenweg 365,2023-02-01,12:00:00,90,18,72,FMN GV 05 Lier
60,Mechelsesteenweg 365,2023-02-01,13:00:00,78,22,56,FMN GV 05 Lier
60,Mechelsesteenweg 365,2023-02-01,14:00:00,56,18,38,FMN GV 05 Lier
60,Mechelsesteenweg 365,2023-02-01,15:00:00,48,24,24,FMN GV 05 Lier
60,Mechelsesteenweg 365,2023-02-01,16:00:00,44,28,16,FMN GV 05 Lier
60,Mechelsesteenweg 365,2023-02-01,17:00:00,56,30,26,FMN GV 05 Lier
60,Mechelsesteenweg 365,2023-02-01,18:00:00,20,12,8,FMN GV 05 Lier
60,Mechelsesteenweg 365,2023-02-01,19:00:00,0,0,0,FMN GV 05 Lier
60,Mechelsesteenweg 365,2023-02-01,20:00:00,12,8,4,FMN GV 05 Lier
60,Mechelsesteenweg 365,2023-02-01,21:00:00,2,2,0,FMN GV 05 Lier
60,Mechelsesteenweg 365,2023-02-01,22:00:00,10,10,0,FMN GV 05 Lier
60,Mechelsesteenweg 365,2023-02-01,23:00:00,2,2,0,FMN GV 05 Lier
60,Mechelsesteenweg 365,2023-02-02,00:00:00,2,0,2,FMN GV 05 Lier
60,Mechelsesteenweg 365,2023-02-02,01:00:00,0,0,0,FMN GV 05 Lier
60,Mechelsesteenweg 365,2023-02-02,02:00:00,0,0,0,FMN GV 05 Lier
60,Mechelsesteenweg 365,2023-02-02,03:00:00,2,0,2,FMN GV 05 Lier
60,Mechelsesteenweg 365,2023-02-02,04:00:00,0,0,0,FMN GV 05 Lier
60,Mechelsesteenweg 365,2023-02-02,05:00:00,2,0,2,FMN GV 05 Lier
60,Mechelsesteenweg 365,2023-02-02,06:00:00,6,2,4,FMN GV 05 Lier
60,Mechelsesteenweg 365,2023-02-02,07:00:00,76,44,32,FMN GV 05 Lier
60,Mechelsesteenweg 365,2023-02-02,08:00:00,88,50,38,FMN GV 05 Lier
60,Mechelsesteenweg 365,2023-02-02,09:00:00,42,20,22,FMN GV 05 Lier
60,Mechelsesteenweg 365,2023-02-02,10:00:00,32,12,20,FMN GV 05 Lier
60,Mechelsesteenweg 365,2023-02-02,11:00:00,38,16,22,FMN GV 05 Lier
60,Mechelsesteenweg 365,2023-02-02,12:00:00,62,18,44,FMN GV 05 Lier
60,Mechelsesteenweg 365,2023-02-02,13:00:00,62,32,30,FMN GV 05 Lier
60,Mechelsesteenweg 365,2023-02-02,14:00:00,64,48,16,FMN GV 05 Lier
60,Mechelsesteenweg 365,2023-02-02,15:00:00,84,54,30,FMN GV 05 Lier
60,Mechelsesteenweg 365,2023-02-02,16:00:00,110,38,72,FMN GV 05 Lier
60,Mechelsesteenweg 365,2023-02-02,17:00:00,74,40,34,FMN GV 05 Lier
60,Mechelsesteenweg 365,2023-02-02,18:00:00,26,14,12,FMN GV 05 Lier
60,Mechelsesteenweg 365,2023-02-02,19:00:00,10,8,2,FMN GV 05 Lier
60,Mechelsesteenweg 365,2023-02-02,20:00:00,4,2,2,FMN GV 05 Lier
60,Mechelsesteenweg 365,2023-02-02,21:00:00,4,2,2,FMN GV 05 Lier
60,Mechelsesteenweg 365,2023-02-02,22:00:00,8,4,4,FMN GV 05 Lier
60,Mechelsesteenweg 365,2023-02-02,23:00:00,0,0,0,FMN GV 05 Lier
60,Mechelsesteenweg 365,2023-02-03,00:00:00,0,0,0,FMN GV 05 Lier
60,Mechelsesteenweg 365,2023-02-03,01:00:00,0,0,0,FMN GV 05 Lier
60,Mechelsesteenweg 365,2023-02-03,02:00:00,0,0,0,FMN GV 05 Lier
60,Mechelsesteenweg 365,2023-02-03,03:00:00,2,0,2,FMN GV 05 Lier
60,Mechelsesteenweg 365,2023-02-03,04:00:00,0,0,0,FMN GV 05 Lier
60,Mechelsesteenweg 365,2023-02-03,05:00:00,6,2,4,FMN GV 05 Lier
60,Mechelsesteenweg 365,2023-02-03,06:00:00,12,4,8,FMN GV 05 Lier
60,Mechelsesteenweg 365,2023-02-03,07:00:00,72,34,38,FMN GV 05 Lier
60,Mechelsesteenweg 365,2023-02-03,08:00:00,70,38,32,FMN GV 05 Lier
60,Mechelsesteenweg 365,2023-02-03,09:00:00,28,4,24,FMN GV 05 Lier
60,Mechelsesteenweg 365,2023-02-03,10:00:00,46,20,26,FMN GV 05 Lier
60,Mechelsesteenweg 365,2023-02-03,11:00:00,32,20,12,FMN GV 05 Lier
60,Mechelsesteenweg 365,2023-02-03,12:00:00,90,56,34,FMN GV 05 Lier
60,Mechelsesteenweg 365,2023-02-03,13:00:00,54,34,20,FMN GV 05 Lier
60,Mechelsesteenweg 365,2023-02-03,14:00:00,72,40,32,FMN GV 05 Lier
60,Mechelsesteenweg 365,2023-02-03,15:00:00,114,44,70,FMN GV 05 Lier
60,Mechelsesteenweg 365,2023-02-03,16:00:00,118,40,78,FMN GV 05 Lier
60,Mechelsesteenweg 365,2023-02-03,17:00:00,56,42,14,FMN GV 05 Lier
60,Mechelsesteenweg 365,2023-02-03,18:00:00,24,16,8,FMN GV 05 Lier
60,Mechelsesteenweg 365,2023-02-03,19:00:00,12,6,6,FMN GV 05 Lier
60,Mechelsesteenweg 365,2023-02-03,20:00:00,6,2,4,FMN GV 05 Lier
60,Mechelsesteenweg 365,2023-02-03,21:00:00,10,8,2,FMN GV 05 Lier
60,Mechelsesteenweg 365,2023-02-03,22:00:00,8,4,4,FMN GV 05 Lier
60,Mechelsesteenweg 365,2023-02-03,23:00:00,4,4,0,FMN GV 05 Lier
60,Mechelsesteenweg 365,2023-02-04,00:00:00,0,0,0,FMN GV 05 Lier
60,Mechelsesteenweg 365,2023-02-04,01:00:00,6,2,4,FMN GV 05 Lier
60,Mechelsesteenweg 365,2023-02-04,02:00:00,0,0,0,FMN GV 05 Lier
60,Mechelsesteenweg 365,2023-02-04,03:00:00,4,0,4,FMN GV 05 Lier
60,Mechelsesteenweg 365,2023-02-04,04:00:00,0,0,0,FMN GV 05 Lier
60,Mechelsesteenweg 365,2023-02-04,05:00:00,4,0,4,FMN GV 05 Lier
60,Mechelsesteenweg 365,2023-02-04,06:00:00,2,2,0,FMN GV 05 Lier
60,Mechelsesteenweg 365,2023-02-04,07:00:00,2,0,2,FMN GV 05 Lier
60,Mechelsesteenweg 365,2023-02-04,08:00:00,10,2,8,FMN GV 05 Lier
60,Mechelsesteenweg 365,2023-02-04,09:00:00,32,20,12,FMN GV 05 Lier
60,Mechelsesteenweg 365,2023-02-04,10:00:00,66,36,30,FMN GV 05 Lier
60,Mechelsesteenweg 365,2023-02-04,11:00:00,50,18,32,FMN GV 05 Lier
60,Mechelsesteenweg 365,2023-02-04,12:00:00,38,12,26,FMN GV 05 Lier
60,Mechelsesteenweg 365,2023-02-04,13:00:00,42,28,14,FMN GV 05 Lier
60,Mechelsesteenweg 365,2023-02-04,14:00:00,46,28,18,FMN GV 05 Lier
60,Mechelsesteenweg 365,2023-02-04,15:00:00,64,26,38,FMN GV 05 Lier
60,Mechelsesteenweg 365,2023-02-04,16:00:00,50,22,28,FMN GV 05 Lier
60,Mechelsesteenweg 365,2023-02-04,17:00:00,22,8,14,FMN GV 05 Lier
60,Mechelsesteenweg 365,2023-02-04,18:00:00,10,4,6,FMN GV 05 Lier
60,Mechelsesteenweg 365,2023-02-04,19:00:00,4,0,4,FMN GV 05 Lier
60,Mechelsesteenweg 365,2023-02-04,20:00:00,8,6,2,FMN GV 05 Lier
60,Mechelsesteenweg 365,2023-02-04,21:00:00,6,2,4,FMN GV 05 Lier
60,Mechelsesteenweg 365,2023-02-04,22:00:00,2,0,2,FMN GV 05 Lier
60,Mechelsesteenweg 365,2023-02-04,23:00:00,2,0,2,FMN GV 05 Lier
60,Mechelsesteenweg 365,2023-02-05,00:00:00,2,2,0,FMN GV 05 Lier
60,Mechelsesteenweg 365,2023-02-05,01:00:00,0,0,0,FMN GV 05 Lier
60,Mechelsesteenweg 365,2023-02-05,02:00:00,0,0,0,FMN GV 05 Lier
60,Mechelsesteenweg 365,2023-02-05,03:00:00,0,0,0,FMN GV 05 Lier
60,Mechelsesteenweg 365,2023-02-05,04:00:00,0,0,0,FMN GV 05 Lier
60,Mechelsesteenweg 365,2023-02-05,05:00:00,4,0,4,FMN GV 05 Lier
60,Mechelsesteenweg 365,2023-02-05,06:00:00,2,0,2,FMN GV 05 Lier
60,Mechelsesteenweg 365,2023-02-05,07:00:00,0,0,0,FMN GV 05 Lier
60,Mechelsesteenweg 365,2023-02-05,08:00:00,8,2,6,FMN GV 05 Lier
60,Mechelsesteenweg 365,2023-02-05,09:00:00,54,44,10,FMN GV 05 Lier
60,Mechelsesteenweg 365,2023-02-05,10:00:00,104,58,46,FMN GV 05 Lier
60,Mechelsesteenweg 365,2023-02-05,11:00:00,66,32,34,FMN GV 05 Lier
60,Mechelsesteenweg 365,2023-02-05,12:00:00,126,56,70,FMN GV 05 Lier
60,Mechelsesteenweg 365,2023-02-05,13:00:00,98,44,54,FMN GV 05 Lier
60,Mechelsesteenweg 365,2023-02-05,14:00:00,92,50,42,FMN GV 05 Lier
60,Mechelsesteenweg 365,2023-02-05,15:00:00,70,34,36,FMN GV 05 Lier
60,Mechelsesteenweg 365,2023-02-05,16:00:00,80,40,40,FMN GV 05 Lier
60,Mechelsesteenweg 365,2023-02-05,17:00:00,24,10,14,FMN GV 05 Lier
60,Mechelsesteenweg 365,2023-02-05,18:00:00,12,6,6,FMN GV 05 Lier
60,Mechelsesteenweg 365,2023-02-05,19:00:00,0,0,0,FMN GV 05 Lier
60,Mechelsesteenweg 365,2023-02-05,20:00:00,0,0,0,FMN GV 05 Lier
60,Mechelsesteenweg 365,2023-02-05,21:00:00,4,0,4,FMN GV 05 Lier
60,Mechelsesteenweg 365,2023-02-05,22:00:00,0,0,0,FMN GV 05 Lier
60,Mechelsesteenweg 365,2023-02-05,23:00:00,0,0,0,FMN GV 05 Lier
60,Mechelsesteenweg 365,2023-02-06,00:00:00,0,0,0,FMN GV 05 Lier
60,Mechelsesteenweg 365,2023-02-06,01:00:00,0,0,0,FMN GV 05 Lier
60,Mechelsesteenweg 365,2023-02-06,02:00:00,0,0,0,FMN GV 05 Lier
60,Mechelsesteenweg 365,2023-02-06,03:00:00,0,0,0,FMN GV 05 Lier
60,Mechelsesteenweg 365,2023-02-06,04:00:00,0,0,0,FMN GV 05 Lier
60,Mechelsesteenweg 365,2023-02-06,05:00:00,4,0,4,FMN GV 05 Lier
60,Mechelsesteenweg 365,2023-02-06,06:00:00,18,8,10,FMN GV 05 Lier
60,Mechelsesteenweg 365,2023-02-06,07:00:00,26,8,18,FMN GV 05 Lier
60,Mechelsesteenweg 365,2023-02-06,08:00:00,62,36,26,FMN GV 05 Lier
60,Mechelsesteenweg 365,2023-02-06,09:00:00,20,10,10,FMN GV 05 Lier
60,Mechelsesteenweg 365,2023-02-06,10:00:00,20,8,12,FMN GV 05 Lier
60,Mechelsesteenweg 365,2023-02-06,11:00:00,20,16,4,FMN GV 05 Lier
60,Mechelsesteenweg 365,2023-02-06,12:00:00,50,26,24,FMN GV 05 Lier
60,Mechelsesteenweg 365,2023-02-06,13:00:00,60,24,36,FMN GV 05 Lier
60,Mechelsesteenweg 365,2023-02-06,14:00:00,130,56,74,FMN GV 05 Lier
60,Mechelsesteenweg 365,2023-02-06,15:00:00,142,62,80,FMN GV 05 Lier
60,Mechelsesteenweg 365,2023-02-06,16:00:00,190,80,110,FMN GV 05 Lier
60,Mechelsesteenweg 365,2023-02-06,17:00:00,100,56,44,FMN GV 05 Lier
60,Mechelsesteenweg 365,2023-02-06,18:00:00,26,18,8,FMN GV 05 Lier
60,Mechelsesteenweg 365,2023-02-06,19:00:00,4,2,2,FMN GV 05 Lier
60,Mechelsesteenweg 365,2023-02-06,20:00:00,14,4,10,FMN GV 05 Lier
60,Mechelsesteenweg 365,2023-02-06,21:00:00,0,0,0,FMN GV 05 Lier
60,Mechelsesteenweg 365,2023-02-06,22:00:00,0,0,0,FMN GV 05 Lier
60,Mechelsesteenweg 365,2023-02-06,23:00:00,2,2,0,FMN GV 05 Lier
60,Mechelsesteenweg 365,2023-02-07,00:00:00,0,0,0,FMN GV 05 Lier
60,Mechelsesteenweg 365,2023-02-07,01:00:00,0,0,0,FMN GV 05 Lier
60,Mechelsesteenweg 365,2023-02-07,02:00:00,0,0,0,FMN GV 05 Lier
60,Mechelsesteenweg 365,2023-02-07,03:00:00,0,0,0,FMN GV 05 Lier
60,Mechelsesteenweg 365,2023-02-07,04:00:00,0,0,0,FMN GV 05 Lier
60,Mechelsesteenweg 365,2023-02-07,05:00:00,4,0,4,FMN GV 05 Lier
60,Mechelsesteenweg 365,2023-02-07,06:00:00,12,4,8,FMN GV 05 Lier
60,Mechelsesteenweg 365,2023-02-07,07:00:00,34,16,18,FMN GV 05 Lier
60,Mechelsesteenweg 365,2023-02-07,08:00:00,74,38,36,FMN GV 05 Lier
60,Mechelsesteenweg 365,2023-02-07,09:00:00,16,6,10,FMN GV 05 Lier
60,Mechelsesteenweg 365,2023-02-07,10:00:00,20,12,8,FMN GV 05 Lier
60,Mechelsesteenweg 365,2023-02-07,11:00:00,44,16,28,FMN GV 05 Lier
60,Mechelsesteenweg 365,2023-02-07,12:00:00,68,24,44,FMN GV 05 Lier
60,Mechelsesteenweg 365,2023-02-07,13:00:00,122,74,48,FMN GV 05 Lier
60,Mechelsesteenweg 365,2023-02-07,14:00:00,142,66,76,FMN GV 05 Lier
60,Mechelsesteenweg 365,2023-02-07,15:00:00,110,44,66,FMN GV 05 Lier
60,Mechelsesteenweg 365,2023-02-07,16:00:00,208,68,140,FMN GV 05 Lier
60,Mechelsesteenweg 365,2023-02-07,17:00:00,88,54,34,FMN GV 05 Lier
60,Mechelsesteenweg 365,2023-02-07,18:00:00,24,16,8,FMN GV 05 Lier
60,Mechelsesteenweg 365,2023-02-07,19:00:00,4,2,2,FMN GV 05 Lier
60,Mechelsesteenweg 365,2023-02-07,20:00:00,6,2,4,FMN GV 05 Lier
60,Mechelsesteenweg 365,2023-02-07,21:00:00,8,4,4,FMN GV 05 Lier
60,Mechelsesteenweg 365,2023-02-07,22:00:00,2,2,0,FMN GV 05 Lier
60,Mechelsesteenweg 365,2023-02-07,23:00:00,2,2,0,FMN GV 05 Lier
60,Mechelsesteenweg 365,2023-02-08,00:00:00,0,0,0,FMN GV 05 Lier
60,Mechelsesteenweg 365,2023-02-08,01:00:00,0,0,0,FMN GV 05 Lier
60,Mechelsesteenweg 365,2023-02-08,02:00:00,0,0,0,FMN GV 05 Lier
60,Mechelsesteenweg 365,2023-02-08,03:00:00,0,0,0,FMN GV 05 Lier
60,Mechelsesteenweg 365,2023-02-08,04:00:00,0,0,0,FMN GV 05 Lier
60,Mechelsesteenweg 365,2023-02-08,05:00:00,0,0,0,FMN GV 05 Lier
60,Mechelsesteenweg 365,2023-02-08,06:00:00,10,2,8,FMN GV 05 Lier
60,Mechelsesteenweg 365,2023-02-08,07:00:00,30,14,16,FMN GV 05 Lier
60,Mechelsesteenweg 365,2023-02-08,08:00:00,30,20,10,FMN GV 05 Lier
60,Mechelsesteenweg 365,2023-02-08,09:00:00,16,8,8,FMN GV 05 Lier
60,Mechelsesteenweg 365,2023-02-08,10:00:00,22,8,14,FMN GV 05 Lier
60,Mechelsesteenweg 365,2023-02-08,11:00:00,42,24,18,FMN GV 05 Lier
60,Mechelsesteenweg 365,2023-02-08,12:00:00,150,50,100,FMN GV 05 Lier
60,Mechelsesteenweg 365,2023-02-08,13:00:00,112,54,58,FMN GV 05 Lier
60,Mechelsesteenweg 365,2023-02-08,14:00:00,196,90,106,FMN GV 05 Lier
60,Mechelsesteenweg 365,2023-02-08,15:00:00,152,66,86,FMN GV 05 Lier
60,Mechelsesteenweg 365,2023-02-08,16:00:00,144,84,60,FMN GV 05 Lier
60,Mechelsesteenweg 365,2023-02-08,17:00:00,78,46,32,FMN GV 05 Lier
60,Mechelsesteenweg 365,2023-02-08,18:00:00,14,6,8,FMN GV 05 Lier
60,Mechelsesteenweg 365,2023-02-08,19:00:00,12,10,2,FMN GV 05 Lier
60,Mechelsesteenweg 365,2023-02-08,20:00:00,12,8,4,FMN GV 05 Lier
60,Mechelsesteenweg 365,2023-02-08,21:00:00,6,2,4,FMN GV 05 Lier
60,Mechelsesteenweg 365,2023-02-08,22:00:00,0,0,0,FMN GV 05 Lier
60,Mechelsesteenweg 365,2023-02-08,23:00:00,2,2,0,FMN GV 05 Lier
60,Mechelsesteenweg 365,2023-02-09,00:00:00,0,0,0,FMN GV 05 Lier
60,Mechelsesteenweg 365,2023-02-09,01:00:00,0,0,0,FMN GV 05 Lier
60,Mechelsesteenweg 365,2023-02-09,02:00:00,2,0,2,FMN GV 05 Lier
60,Mechelsesteenweg 365,2023-02-09,03:00:00,0,0,0,FMN GV 05 Lier
60,Mechelsesteenweg 365,2023-02-09,04:00:00,0,0,0,FMN GV 05 Lier
60,Mechelsesteenweg 365,2023-02-09,05:00:00,6,0,6,FMN GV 05 Lier
60,Mechelsesteenweg 365,2023-02-09,06:00:00,10,0,10,FMN GV 05 Lier
60,Mechelsesteenweg 365,2023-02-09,07:00:00,28,10,18,FMN GV 05 Lier
60,Mechelsesteenweg 365,2023-02-09,08:00:00,48,26,22,FMN GV 05 Lier
60,Mechelsesteenweg 365,2023-02-09,09:00:00,38,22,16,FMN GV 05 Lier
60,Mechelsesteenweg 365,2023-02-09,10:00:00,34,24,10,FMN GV 05 Lier
60,Mechelsesteenweg 365,2023-02-09,11:00:00,34,8,26,FMN GV 05 Lier
60,Mechelsesteenweg 365,2023-02-09,12:00:00,64,12,52,FMN GV 05 Lier
60,Mechelsesteenweg 365,2023-02-09,13:00:00,72,44,28,FMN GV 05 Lier
60,Mechelsesteenweg 365,2023-02-09,14:00:00,78,32,46,FMN GV 05 Lier
60,Mechelsesteenweg 365,2023-02-09,15:00:00,92,50,42,FMN GV 05 Lier
60,Mechelsesteenweg 365,2023-02-09,16:00:00,130,60,70,FMN GV 05 Lier
60,Mechelsesteenweg 365,2023-02-09,17:00:00,80,48,32,FMN GV 05 Lier
60,Mechelsesteenweg 365,2023-02-09,18:00:00,26,20,6,FMN GV 05 Lier
60,Mechelsesteenweg 365,2023-02-09,19:00:00,18,10,8,FMN GV 05 Lier
60,Mechelsesteenweg 365,2023-02-09,20:00:00,2,2,0,FMN GV 05 Lier
60,Mechelsesteenweg 365,2023-02-09,21:00:00,8,4,4,FMN GV 05 Lier
60,Mechelsesteenweg 365,2023-02-09,22:00:00,2,0,2,FMN GV 05 Lier
60,Mechelsesteenweg 365,2023-02-09,23:00:00,2,2,0,FMN GV 05 Lier
60,Mechelsesteenweg 365,2023-02-10,00:00:00,0,0,0,FMN GV 05 Lier
60,Mechelsesteenweg 365,2023-02-10,01:00:00,0,0,0,FMN GV 05 Lier
60,Mechelsesteenweg 365,2023-02-10,02:00:00,0,0,0,FMN GV 05 Lier
60,Mechelsesteenweg 365,2023-02-10,03:00:00,0,0,0,FMN GV 05 Lier
60,Mechelsesteenweg 365,2023-02-10,04:00:00,0,0,0,FMN GV 05 Lier
60,Mechelsesteenweg 365,2023-02-10,05:00:00,4,2,2,FMN GV 05 Lier
60,Mechelsesteenweg 365,2023-02-10,06:00:00,4,0,4,FMN GV 05 Lier
60,Mechelsesteenweg 365,2023-02-10,07:00:00,36,24,12,FMN GV 05 Lier
60,Mechelsesteenweg 365,2023-02-10,08:00:00,56,26,30,FMN GV 05 Lier
60,Mechelsesteenweg 365,2023-02-10,09:00:00,28,12,16,FMN GV 05 Lier
60,Mechelsesteenweg 365,2023-02-10,10:00:00,30,14,16,FMN GV 05 Lier
60,Mechelsesteenweg 365,2023-02-10,11:00:00,24,18,6,FMN GV 05 Lier
60,Mechelsesteenweg 365,2023-02-10,12:00:00,62,38,24,FMN GV 05 Lier
60,Mechelsesteenweg 365,2023-02-10,13:00:00,78,34,44,FMN GV 05 Lier
60,Mechelsesteenweg 365,2023-02-10,14:00:00,92,48,44,FMN GV 05 Lier
60,Mechelsesteenweg 365,2023-02-10,15:00:00,64,20,44,FMN GV 05 Lier
60,Mechelsesteenweg 365,2023-02-10,16:00:00,144,56,88,FMN GV 05 Lier
60,Mechelsesteenweg 365,2023-02-10,17:00:00,44,32,12,FMN GV 05 Lier
60,Mechelsesteenweg 365,2023-02-10,18:00:00,14,8,6,FMN GV 05 Lier
60,Mechelsesteenweg 365,2023-02-10,19:00:00,8,4,4,FMN GV 05 Lier
60,Mechelsesteenweg 365,2023-02-10,20:00:00,4,2,2,FMN GV 05 Lier
60,Mechelsesteenweg 365,2023-02-10,21:00:00,4,2,2,FMN GV 05 Lier
60,Mechelsesteenweg 365,2023-02-10,22:00:00,6,2,4,FMN GV 05 Lier
60,Mechelsesteenweg 365,2023-02-10,23:00:00,2,2,0,FMN GV 05 Lier
60,Mechelsesteenweg 365,2023-02-11,00:00:00,4,0,4,FMN GV 05 Lier
60,Mechelsesteenweg 365,2023-02-11,01:00:00,0,0,0,FMN GV 05 Lier
60,Mechelsesteenweg 365,2023-02-11,02:00:00,0,0,0,FMN GV 05 Lier
60,Mechelsesteenweg 365,2023-02-11,03:00:00,0,0,0,FMN GV 05 Lier
60,Mechelsesteenweg 365,2023-02-11,04:00:00,2,0,2,FMN GV 05 Lier
60,Mechelsesteenweg 365,2023-02-11,05:00:00,4,0,4,FMN GV 05 Lier
60,Mechelsesteenweg 365,2023-02-11,06:00:00,2,0,2,FMN GV 05 Lier
60,Mechelsesteenweg 365,2023-02-11,07:00:00,4,4,0,FMN GV 05 Lier
60,Mechelsesteenweg 365,2023-02-11,08:00:00,12,2,10,FMN GV 05 Lier
60,Mechelsesteenweg 365,2023-02-11,09:00:00,40,22,18,FMN GV 05 Lier
60,Mechelsesteenweg 365,2023-02-11,10:00:00,60,22,38,FMN GV 05 Lier
60,Mechelsesteenweg 365,2023-02-11,11:00:00,76,26,50,FMN GV 05 Lier
60,Mechelsesteenweg 365,2023-02-11,12:00:00,72,46,26,FMN GV 05 Lier
60,Mechelsesteenweg 365,2023-02-11,13:00:00,86,46,40,FMN GV 05 Lier
60,Mechelsesteenweg 365,2023-02-11,14:00:00,142,90,52,FMN GV 05 Lier
60,Mechelsesteenweg 365,2023-02-11,15:00:00,92,40,52,FMN GV 05 Lier
60,Mechelsesteenweg 365,2023-02-11,16:00:00,68,34,34,FMN GV 05 Lier
60,Mechelsesteenweg 365,2023-02-11,17:00:00,34,22,12,FMN GV 05 Lier
60,Mechelsesteenweg 365,2023-02-11,18:00:00,18,4,14,FMN GV 05 Lier
60,Mechelsesteenweg 365,2023-02-11,19:00:00,2,0,2,FMN GV 05 Lier
60,Mechelsesteenweg 365,2023-02-11,20:00:00,0,0,0,FMN GV 05 Lier
60,Mechelsesteenweg 365,2023-02-11,21:00:00,4,0,4,FMN GV 05 Lier
60,Mechelsesteenweg 365,2023-02-11,22:00:00,0,0,0,FMN GV 05 Lier
60,Mechelsesteenweg 365,2023-02-11,23:00:00,0,0,0,FMN GV 05 Lier
60,Mechelsesteenweg 365,2023-02-12,00:00:00,0,0,0,FMN GV 05 Lier
60,Mechelsesteenweg 365,2023-02-12,01:00:00,0,0,0,FMN GV 05 Lier
60,Mechelsesteenweg 365,2023-02-12,02:00:00,0,0,0,FMN GV 05 Lier
60,Mechelsesteenweg 365,2023-02-12,03:00:00,0,0,0,FMN GV 05 Lier
60,Mechelsesteenweg 365,2023-02-12,04:00:00,0,0,0,FMN GV 05 Lier
60,Mechelsesteenweg 365,2023-02-12,05:00:00,2,2,0,FMN GV 05 Lier
60,Mechelsesteenweg 365,2023-02-12,06:00:00,0,0,0,FMN GV 05 Lier
60,Mechelsesteenweg 365,2023-02-12,07:00:00,2,0,2,FMN GV 05 Lier
60,Mechelsesteenweg 365,2023-02-12,08:00:00,22,4,18,FMN GV 05 Lier
60,Mechelsesteenweg 365,2023-02-12,09:00:00,96,60,36,FMN GV 05 Lier
60,Mechelsesteenweg 365,2023-02-12,10:00:00,226,144,82,FMN GV 05 Lier
60,Mechelsesteenweg 365,2023-02-12,11:00:00,322,144,178,FMN GV 05 Lier
60,Mechelsesteenweg 365,2023-02-12,12:00:00,110,46,64,FMN GV 05 Lier
60,Mechelsesteenweg 365,2023-02-12,13:00:00,136,72,64,FMN GV 05 Lier
60,Mechelsesteenweg 365,2023-02-12,14:00:00,144,84,60,FMN GV 05 Lier
60,Mechelsesteenweg 365,2023-02-12,15:00:00,98,54,44,FMN GV 05 Lier
60,Mechelsesteenweg 365,2023-02-12,16:00:00,90,36,54,FMN GV 05 Lier
60,Mechelsesteenweg 365,2023-02-12,17:00:00,26,16,10,FMN GV 05 Lier
60,Mechelsesteenweg 365,2023-02-12,18:00:00,10,8,2,FMN GV 05 Lier
60,Mechelsesteenweg 365,2023-02-12,19:00:00,0,0,0,FMN GV 05 Lier
60,Mechelsesteenweg 365,2023-02-12,20:00:00,0,0,0,FMN GV 05 Lier
60,Mechelsesteenweg 365,2023-02-12,21:00:00,2,0,2,FMN GV 05 Lier
60,Mechelsesteenweg 365,2023-02-12,22:00:00,0,0,0,FMN GV 05 Lier
60,Mechelsesteenweg 365,2023-02-12,23:00:00,0,0,0,FMN GV 05 Lier
60,Mechelsesteenweg 365,2023-02-13,00:00:00,0,0,0,FMN GV 05 Lier
60,Mechelsesteenweg 365,2023-02-13,01:00:00,0,0,0,FMN GV 05 Lier
60,Mechelsesteenweg 365,2023-02-13,02:00:00,0,0,0,FMN GV 05 Lier
60,Mechelsesteenweg 365,2023-02-13,03:00:00,0,0,0,FMN GV 05 Lier
60,Mechelsesteenweg 365,2023-02-13,04:00:00,0,0,0,FMN GV 05 Lier
60,Mechelsesteenweg 365,2023-02-13,05:00:00,0,0,0,FMN GV 05 Lier
60,Mechelsesteenweg 365,2023-02-13,06:00:00,12,2,10,FMN GV 05 Lier
60,Mechelsesteenweg 365,2023-02-13,07:00:00,64,26,38,FMN GV 05 Lier
60,Mechelsesteenweg 365,2023-02-13,08:00:00,70,40,30,FMN GV 05 Lier
60,Mechelsesteenweg 365,2023-02-13,09:00:00,30,14,16,FMN GV 05 Lier
60,Mechelsesteenweg 365,2023-02-13,10:00:00,22,12,10,FMN GV 05 Lier
60,Mechelsesteenweg 365,2023-02-13,11:00:00,70,36,34,FMN GV 05 Lier
60,Mechelsesteenweg 365,2023-02-13,12:00:00,72,30,42,FMN GV 05 Lier
60,Mechelsesteenweg 365,2023-02-13,13:00:00,130,74,56,FMN GV 05 Lier
60,Mechelsesteenweg 365,2023-02-13,14:00:00,198,96,102,FMN GV 05 Lier
60,Mechelsesteenweg 365,2023-02-13,15:00:00,204,82,122,FMN GV 05 Lier
60,Mechelsesteenweg 365,2023-02-13,16:00:00,228,78,150,FMN GV 05 Lier
60,Mechelsesteenweg 365,2023-02-13,17:00:00,120,74,46,FMN GV 05 Lier
60,Mechelsesteenweg 365,2023-02-13,18:00:00,46,26,20,FMN GV 05 Lier
60,Mechelsesteenweg 365,2023-02-13,19:00:00,12,4,8,FMN GV 05 Lier
60,Mechelsesteenweg 365,2023-02-13,20:00:00,2,0,2,FMN GV 05 Lier
60,Mechelsesteenweg 365,2023-02-13,21:00:00,6,2,4,FMN GV 05 Lier
60,Mechelsesteenweg 365,2023-02-13,22:00:00,4,4,0,FMN GV 05 Lier
60,Mechelsesteenweg 365,2023-02-13,23:00:00,0,0,0,FMN GV 05 Lier
60,Mechelsesteenweg 365,2023-02-14,00:00:00,2,2,0,FMN GV 05 Lier
60,Mechelsesteenweg 365,2023-02-14,01:00:00,0,0,0,FMN GV 05 Lier
60,Mechelsesteenweg 365,2023-02-14,02:00:00,0,0,0,FMN GV 05 Lier
60,Mechelsesteenweg 365,2023-02-14,03:00:00,0,0,0,FMN GV 05 Lier
60,Mechelsesteenweg 365,2023-02-14,04:00:00,0,0,0,FMN GV 05 Lier
60,Mechelsesteenweg 365,2023-02-14,05:00:00,0,0,0,FMN GV 05 Lier
60,Mechelsesteenweg 365,2023-02-14,06:00:00,12,4,8,FMN GV 05 Lier
60,Mechelsesteenweg 365,2023-02-14,07:00:00,70,30,40,FMN GV 05 Lier
60,Mechelsesteenweg 365,2023-02-14,08:00:00,82,36,46,FMN GV 05 Lier
60,Mechelsesteenweg 365,2023-02-14,09:00:00,28,20,8,FMN GV 05 Lier
60,Mechelsesteenweg 365,2023-02-14,10:00:00,82,50,32,FMN GV 05 Lier
60,Mechelsesteenweg 365,2023-02-14,11:00:00,82,40,42,FMN GV 05 Lier
60,Mechelsesteenweg 365,2023-02-14,12:00:00,126,64,62,FMN GV 05 Lier
60,Mechelsesteenweg 365,2023-02-14,13:00:00,160,90,70,FMN GV 05 Lier
60,Mechelsesteenweg 365,2023-02-14,14:00:00,236,132,104,FMN GV 05 Lier
60,Mechelsesteenweg 365,2023-02-14,15:00:00,306,128,178,FMN GV 05 Lier
60,Mechelsesteenweg 365,2023-02-14,16:00:00,260,112,148,FMN GV 05 Lier
60,Mechelsesteenweg 365,2023-02-14,17:00:00,154,82,72,FMN GV 05 Lier
60,Mechelsesteenweg 365,2023-02-14,18:00:00,34,24,10,FMN GV 05 Lier
60,Mechelsesteenweg 365,2023-02-14,19:00:00,18,10,8,FMN GV 05 Lier
60,Mechelsesteenweg 365,2023-02-14,20:00:00,6,2,4,FMN GV 05 Lier
60,Mechelsesteenweg 365,2023-02-14,21:00:00,2,2,0,FMN GV 05 Lier
60,Mechelsesteenweg 365,2023-02-14,22:00:00,4,2,2,FMN GV 05 Lier
60,Mechelsesteenweg 365,2023-02-14,23:00:00,2,2,0,FMN GV 05 Lier
60,Mechelsesteenweg 365,2023-02-15,00:00:00,0,0,0,FMN GV 05 Lier
60,Mechelsesteenweg 365,2023-02-15,01:00:00,0,0,0,FMN GV 05 Lier
60,Mechelsesteenweg 365,2023-02-15,02:00:00,0,0,0,FMN GV 05 Lier
60,Mechelsesteenweg 365,2023-02-15,03:00:00,0,0,0,FMN GV 05 Lier
60,Mechelsesteenweg 365,2023-02-15,04:00:00,0,0,0,FMN GV 05 Lier
60,Mechelsesteenweg 365,2023-02-15,05:00:00,2,0,2,FMN GV 05 Lier
60,Mechelsesteenweg 365,2023-02-15,06:00:00,18,4,14,FMN GV 05 Lier
60,Mechelsesteenweg 365,2023-02-15,07:00:00,64,18,46,FMN GV 05 Lier
60,Mechelsesteenweg 365,2023-02-15,08:00:00,92,56,36,FMN GV 05 Lier
60,Mechelsesteenweg 365,2023-02-15,09:00:00,18,14,4,FMN GV 05 Lier
60,Mechelsesteenweg 365,2023-02-15,10:00:00,46,26,20,FMN GV 05 Lier
60,Mechelsesteenweg 365,2023-02-15,11:00:00,60,32,28,FMN GV 05 Lier
60,Mechelsesteenweg 365,2023-02-15,12:00:00,170,46,124,FMN GV 05 Lier
60,Mechelsesteenweg 365,2023-02-15,13:00:00,182,92,90,FMN GV 05 Lier
60,Mechelsesteenweg 365,2023-02-15,14:00:00,208,112,96,FMN GV 05 Lier
60,Mechelsesteenweg 365,2023-02-15,15:00:00,290,122,168,FMN GV 05 Lier
60,Mechelsesteenweg 365,2023-02-15,16:00:00,238,118,120,FMN GV 05 Lier
60,Mechelsesteenweg 365,2023-02-15,17:00:00,102,64,38,FMN GV 05 Lier
60,Mechelsesteenweg 365,2023-02-15,18:00:00,34,22,12,FMN GV 05 Lier
60,Mechelsesteenweg 365,2023-02-15,19:00:00,12,4,8,FMN GV 05 Lier
60,Mechelsesteenweg 365,2023-02-15,20:00:00,6,4,2,FMN GV 05 Lier
60,Mechelsesteenweg 365,2023-02-15,21:00:00,6,6,0,FMN GV 05 Lier
60,Mechelsesteenweg 365,2023-02-15,22:00:00,10,6,4,FMN GV 05 Lier
60,Mechelsesteenweg 365,2023-02-15,23:00:00,2,0,2,FMN GV 05 Lier
60,Mechelsesteenweg 365,2023-02-16,00:00:00,0,0,0,FMN GV 05 Lier
60,Mechelsesteenweg 365,2023-02-16,01:00:00,0,0,0,FMN GV 05 Lier
60,Mechelsesteenweg 365,2023-02-16,02:00:00,0,0,0,FMN GV 05 Lier
60,Mechelsesteenweg 365,2023-02-16,03:00:00,0,0,0,FMN GV 05 Lier
60,Mechelsesteenweg 365,2023-02-16,04:00:00,0,0,0,FMN GV 05 Lier
60,Mechelsesteenweg 365,2023-02-16,05:00:00,2,2,0,FMN GV 05 Lier
60,Mechelsesteenweg 365,2023-02-16,06:00:00,16,4,12,FMN GV 05 Lier
60,Mechelsesteenweg 365,2023-02-16,07:00:00,80,40,40,FMN GV 05 Lier
60,Mechelsesteenweg 365,2023-02-16,08:00:00,80,44,36,FMN GV 05 Lier
60,Mechelsesteenweg 365,2023-02-16,09:00:00,32,20,12,FMN GV 05 Lier
60,Mechelsesteenweg 365,2023-02-16,10:00:00,36,20,16,FMN GV 05 Lier
60,Mechelsesteenweg 365,2023-02-16,11:00:00,16,4,12,FMN GV 05 Lier
60,Mechelsesteenweg 365,2023-02-16,12:00:00,24,10,14,FMN GV 05 Lier
60,Mechelsesteenweg 365,2023-02-16,13:00:00,42,24,18,FMN GV 05 Lier
60,Mechelsesteenweg 365,2023-02-16,14:00:00,60,32,28,FMN GV 05 Lier
60,Mechelsesteenweg 365,2023-02-16,15:00:00,98,46,52,FMN GV 05 Lier
60,Mechelsesteenweg 365,2023-02-16,16:00:00,176,54,122,FMN GV 05 Lier
60,Mechelsesteenweg 365,2023-02-16,17:00:00,60,40,20,FMN GV 05 Lier
60,Mechelsesteenweg 365,2023-02-16,18:00:00,18,12,6,FMN GV 05 Lier
60,Mechelsesteenweg 365,2023-02-16,19:00:00,10,8,2,FMN GV 05 Lier
60,Mechelsesteenweg 365,2023-02-16,20:00:00,8,2,6,FMN GV 05 Lier
60,Mechelsesteenweg 365,2023-02-16,21:00:00,2,2,0,FMN GV 05 Lier
60,Mechelsesteenweg 365,2023-02-16,22:00:00,8,2,6,FMN GV 05 Lier
60,Mechelsesteenweg 365,2023-02-16,23:00:00,0,0,0,FMN GV 05 Lier
60,Mechelsesteenweg 365,2023-02-17,00:00:00,0,0,0,FMN GV 05 Lier
60,Mechelsesteenweg 365,2023-02-17,01:00:00,0,0,0,FMN GV 05 Lier
60,Mechelsesteenweg 365,2023-02-17,02:00:00,0,0,0,FMN GV 05 Lier
60,Mechelsesteenweg 365,2023-02-17,03:00:00,2,0,2,FMN GV 05 Lier
60,Mechelsesteenweg 365,2023-02-17,04:00:00,0,0,0,FMN GV 05 Lier
60,Mechelsesteenweg 365,2023-02-17,05:00:00,6,0,6,FMN GV 05 Lier
60,Mechelsesteenweg 365,2023-02-17,06:00:00,14,4,10,FMN GV 05 Lier
60,Mechelsesteenweg 365,2023-02-17,07:00:00,68,30,38,FMN GV 05 Lier
60,Mechelsesteenweg 365,2023-02-17,08:00:00,96,54,42,FMN GV 05 Lier
60,Mechelsesteenweg 365,2023-02-17,09:00:00,30,14,16,FMN GV 05 Lier
60,Mechelsesteenweg 365,2023-02-17,10:00:00,40,20,20,FMN GV 05 Lier
60,Mechelsesteenweg 365,2023-02-17,11:00:00,50,30,20,FMN GV 05 Lier
60,Mechelsesteenweg 365,2023-02-17,12:00:00,52,32,20,FMN GV 05 Lier
60,Mechelsesteenweg 365,2023-02-17,13:00:00,44,30,14,FMN GV 05 Lier
60,Mechelsesteenweg 365,2023-02-17,14:00:00,62,42,20,FMN GV 05 Lier
60,Mechelsesteenweg 365,2023-02-17,15:00:00,82,38,44,FMN GV 05 Lier
60,Mechelsesteenweg 365,2023-02-17,16:00:00,150,56,94,FMN GV 05 Lier
60,Mechelsesteenweg 365,2023-02-17,17:00:00,52,28,24,FMN GV 05 Lier
60,Mechelsesteenweg 365,2023-02-17,18:00:00,26,16,10,FMN GV 05 Lier
60,Mechelsesteenweg 365,2023-02-17,19:00:00,6,4,2,FMN GV 05 Lier
60,Mechelsesteenweg 365,2023-02-17,20:00:00,2,0,2,FMN GV 05 Lier
60,Mechelsesteenweg 365,2023-02-17,21:00:00,10,6,4,FMN GV 05 Lier
60,Mechelsesteenweg 365,2023-02-17,22:00:00,2,0,2,FMN GV 05 Lier
60,Mechelsesteenweg 365,2023-02-17,23:00:00,6,6,0,FMN GV 05 Lier
60,Mechelsesteenweg 365,2023-02-18,00:00:00,12,0,12,FMN GV 05 Lier
60,Mechelsesteenweg 365,2023-02-18,01:00:00,0,0,0,FMN GV 05 Lier
60,Mechelsesteenweg 365,2023-02-18,02:00:00,4,2,2,FMN GV 05 Lier
60,Mechelsesteenweg 365,2023-02-18,03:00:00,0,0,0,FMN GV 05 Lier
60,Mechelsesteenweg 365,2023-02-18,04:00:00,2,0,2,FMN GV 05 Lier
60,Mechelsesteenweg 365,2023-02-18,05:00:00,0,0,0,FMN GV 05 Lier
60,Mechelsesteenweg 365,2023-02-18,06:00:00,4,0,4,FMN GV 05 Lier
60,Mechelsesteenweg 365,2023-02-18,07:00:00,2,0,2,FMN GV 05 Lier
60,Mechelsesteenweg 365,2023-02-18,08:00:00,12,6,6,FMN GV 05 Lier
60,Mechelsesteenweg 365,2023-02-18,09:00:00,44,28,16,FMN GV 05 Lier
60,Mechelsesteenweg 365,2023-02-18,10:00:00,68,42,26,FMN GV 05 Lier
60,Mechelsesteenweg 365,2023-02-18,11:00:00,102,84,18,FMN GV 05 Lier
60,Mechelsesteenweg 365,2023-02-18,12:00:00,66,36,30,FMN GV 05 Lier
60,Mechelsesteenweg 365,2023-02-18,13:00:00,50,34,16,FMN GV 05 Lier
60,Mechelsesteenweg 365,2023-02-18,14:00:00,84,56,28,FMN GV 05 Lier
60,Mechelsesteenweg 365,2023-02-18,15:00:00,52,28,24,FMN GV 05 Lier
60,Mechelsesteenweg 365,2023-02-18,16:00:00,30,12,18,FMN GV 05 Lier
60,Mechelsesteenweg 365,2023-02-18,17:00:00,30,16,14,FMN GV 05 Lier
60,Mechelsesteenweg 365,2023-02-18,18:00:00,10,8,2,FMN GV 05 Lier
60,Mechelsesteenweg 365,2023-02-18,19:00:00,6,2,4,FMN GV 05 Lier
60,Mechelsesteenweg 365,2023-02-18,20:00:00,4,0,4,FMN GV 05 Lier
60,Mechelsesteenweg 365,2023-02-18,21:00:00,2,2,0,FMN GV 05 Lier
60,Mechelsesteenweg 365,2023-02-18,22:00:00,4,2,2,FMN GV 05 Lier
60,Mechelsesteenweg 365,2023-02-18,23:00:00,2,0,2,FMN GV 05 Lier
60,Mechelsesteenweg 365,2023-02-19,00:00:00,8,2,6,FMN GV 05 Lier
60,Mechelsesteenweg 365,2023-02-19,01:00:00,0,0,0,FMN GV 05 Lier
60,Mechelsesteenweg 365,2023-02-19,02:00:00,0,0,0,FMN GV 05 Lier
60,Mechelsesteenweg 365,2023-02-19,03:00:00,0,0,0,FMN GV 05 Lier
60,Mechelsesteenweg 365,2023-02-19,04:00:00,0,0,0,FMN GV 05 Lier
60,Mechelsesteenweg 365,2023-02-19,05:00:00,0,0,0,FMN GV 05 Lier
60,Mechelsesteenweg 365,2023-02-19,06:00:00,4,2,2,FMN GV 05 Lier
60,Mechelsesteenweg 365,2023-02-19,07:00:00,2,2,0,FMN GV 05 Lier
60,Mechelsesteenweg 365,2023-02-19,08:00:00,26,14,12,FMN GV 05 Lier
60,Mechelsesteenweg 365,2023-02-19,09:00:00,84,34,50,FMN GV 05 Lier
60,Mechelsesteenweg 365,2023-02-19,10:00:00,234,142,92,FMN GV 05 Lier
60,Mechelsesteenweg 365,2023-02-19,11:00:00,194,100,94,FMN GV 05 Lier
60,Mechelsesteenweg 365,2023-02-19,12:00:00,104,70,34,FMN GV 05 Lier
60,Mechelsesteenweg 365,2023-02-19,13:00:00,104,50,54,FMN GV 05 Lier
60,Mechelsesteenweg 365,2023-02-19,14:00:00,100,56,44,FMN GV 05 Lier
60,Mechelsesteenweg 365,2023-02-19,15:00:00,116,48,68,FMN GV 05 Lier
60,Mechelsesteenweg 365,2023-02-19,16:00:00,62,36,26,FMN GV 05 Lier
60,Mechelsesteenweg 365,2023-02-19,17:00:00,38,10,28,FMN GV 05 Lier
60,Mechelsesteenweg 365,2023-02-19,18:00:00,18,10,8,FMN GV 05 Lier
60,Mechelsesteenweg 365,2023-02-19,19:00:00,4,4,0,FMN GV 05 Lier
60,Mechelsesteenweg 365,2023-02-19,20:00:00,0,0,0,FMN GV 05 Lier
60,Mechelsesteenweg 365,2023-02-19,21:00:00,0,0,0,FMN GV 05 Lier
60,Mechelsesteenweg 365,2023-02-19,22:00:00,2,0,2,FMN GV 05 Lier
60,Mechelsesteenweg 365,2023-02-19,23:00:00,0,0,0,FMN GV 05 Lier
60,Mechelsesteenweg 365,2023-02-20,00:00:00,0,0,0,FMN GV 05 Lier
60,Mechelsesteenweg 365,2023-02-20,01:00:00,0,0,0,FMN GV 05 Lier
60,Mechelsesteenweg 365,2023-02-20,02:00:00,0,0,0,FMN GV 05 Lier
60,Mechelsesteenweg 365,2023-02-20,03:00:00,0,0,0,FMN GV 05 Lier
60,Mechelsesteenweg 365,2023-02-20,04:00:00,0,0,0,FMN GV 05 Lier
60,Mechelsesteenweg 365,2023-02-20,05:00:00,4,0,4,FMN GV 05 Lier
60,Mechelsesteenweg 365,2023-02-20,06:00:00,10,4,6,FMN GV 05 Lier
60,Mechelsesteenweg 365,2023-02-20,07:00:00,50,8,42,FMN GV 05 Lier
60,Mechelsesteenweg 365,2023-02-20,08:00:00,58,24,34,FMN GV 05 Lier
60,Mechelsesteenweg 365,2023-02-20,09:00:00,18,6,12,FMN GV 05 Lier
60,Mechelsesteenweg 365,2023-02-20,10:00:00,40,24,16,FMN GV 05 Lier
60,Mechelsesteenweg 365,2023-02-20,11:00:00,44,30,14,FMN GV 05 Lier
60,Mechelsesteenweg 365,2023-02-20,12:00:00,56,22,34,FMN GV 05 Lier
60,Mechelsesteenweg 365,2023-02-20,13:00:00,62,26,36,FMN GV 05 Lier
60,Mechelsesteenweg 365,2023-02-20,14:00:00,82,58,24,FMN GV 05 Lier
60,Mechelsesteenweg 365,2023-02-20,15:00:00,108,62,46,FMN GV 05 Lier
60,Mechelsesteenweg 365,2023-02-20,16:00:00,74,38,36,FMN GV 05 Lier
60,Mechelsesteenweg 365,2023-02-20,17:00:00,78,48,30,FMN GV 05 Lier
60,Mechelsesteenweg 365,2023-02-20,18:00:00,34,18,16,FMN GV 05 Lier
60,Mechelsesteenweg 365,2023-02-20,19:00:00,10,6,4,FMN GV 05 Lier
60,Mechelsesteenweg 365,2023-02-20,20:00:00,6,2,4,FMN GV 05 Lier
60,Mechelsesteenweg 365,2023-02-20,21:00:00,4,0,4,FMN GV 05 Lier
60,Mechelsesteenweg 365,2023-02-20,22:00:00,4,2,2,FMN GV 05 Lier
60,Mechelsesteenweg 365,2023-02-20,23:00:00,0,0,0,FMN GV 05 Lier
60,Mechelsesteenweg 365,2023-02-21,00:00:00,0,0,0,FMN GV 05 Lier
60,Mechelsesteenweg 365,2023-02-21,01:00:00,0,0,0,FMN GV 05 Lier
60,Mechelsesteenweg 365,2023-02-21,02:00:00,0,0,0,FMN GV 05 Lier
60,Mechelsesteenweg 365,2023-02-21,03:00:00,0,0,0,FMN GV 05 Lier
60,Mechelsesteenweg 365,2023-02-21,04:00:00,0,0,0,FMN GV 05 Lier
60,Mechelsesteenweg 365,2023-02-21,05:00:00,4,2,2,FMN GV 05 Lier
60,Mechelsesteenweg 365,2023-02-21,06:00:00,20,2,18,FMN GV 05 Lier
60,Mechelsesteenweg 365,2023-02-21,07:00:00,58,8,50,FMN GV 05 Lier
60,Mechelsesteenweg 365,2023-02-21,08:00:00,54,18,36,FMN GV 05 Lier
60,Mechelsesteenweg 365,2023-02-21,09:00:00,36,20,16,FMN GV 05 Lier
60,Mechelsesteenweg 365,2023-02-21,10:00:00,40,26,14,FMN GV 05 Lier
60,Mechelsesteenweg 365,2023-02-21,11:00:00,48,22,26,FMN GV 05 Lier
60,Mechelsesteenweg 365,2023-02-21,12:00:00,48,20,28,FMN GV 05 Lier
60,Mechelsesteenweg 365,2023-02-21,13:00:00,58,36,22,FMN GV 05 Lier
60,Mechelsesteenweg 365,2023-02-21,14:00:00,80,50,30,FMN GV 05 Lier
60,Mechelsesteenweg 365,2023-02-21,15:00:00,82,40,42,FMN GV 05 Lier
60,Mechelsesteenweg 365,2023-02-21,16:00:00,110,64,46,FMN GV 05 Lier
60,Mechelsesteenweg 365,2023-02-21,17:00:00,82,58,24,FMN GV 05 Lier
60,Mechelsesteenweg 365,2023-02-21,18:00:00,32,22,10,FMN GV 05 Lier
60,Mechelsesteenweg 365,2023-02-21,19:00:00,12,10,2,FMN GV 05 Lier
60,Mechelsesteenweg 365,2023-02-21,20:00:00,6,2,4,FMN GV 05 Lier
60,Mechelsesteenweg 365,2023-02-21,21:00:00,4,0,4,FMN GV 05 Lier
60,Mechelsesteenweg 365,2023-02-21,22:00:00,0,0,0,FMN GV 05 Lier
60,Mechelsesteenweg 365,2023-02-21,23:00:00,2,2,0,FMN GV 05 Lier
60,Mechelsesteenweg 365,2023-02-22,00:00:00,0,0,0,FMN GV 05 Lier
60,Mechelsesteenweg 365,2023-02-22,01:00:00,0,0,0,FMN GV 05 Lier
60,Mechelsesteenweg 365,2023-02-22,02:00:00,0,0,0,FMN GV 05 Lier
60,Mechelsesteenweg 365,2023-02-22,03:00:00,0,0,0,FMN GV 05 Lier
60,Mechelsesteenweg 365,2023-02-22,04:00:00,0,0,0,FMN GV 05 Lier
60,Mechelsesteenweg 365,2023-02-22,05:00:00,2,0,2,FMN GV 05 Lier
60,Mechelsesteenweg 365,2023-02-22,06:00:00,12,4,8,FMN GV 05 Lier
60,Mechelsesteenweg 365,2023-02-22,07:00:00,22,6,16,FMN GV 05 Lier
60,Mechelsesteenweg 365,2023-02-22,08:00:00,38,12,26,FMN GV 05 Lier
60,Mechelsesteenweg 365,2023-02-22,09:00:00,26,16,10,FMN GV 05 Lier
60,Mechelsesteenweg 365,2023-02-22,10:00:00,50,30,20,FMN GV 05 Lier
60,Mechelsesteenweg 365,2023-02-22,11:00:00,40,24,16,FMN GV 05 Lier
60,Mechelsesteenweg 365,2023-02-22,12:00:00,48,30,18,FMN GV 05 Lier
60,Mechelsesteenweg 365,2023-02-22,13:00:00,46,20,26,FMN GV 05 Lier
60,Mechelsesteenweg 365,2023-02-22,14:00:00,110,62,48,FMN GV 05 Lier
60,Mechelsesteenweg 365,2023-02-22,15:00:00,86,28,58,FMN GV 05 Lier
60,Mechelsesteenweg 365,2023-02-22,16:00:00,64,36,28,FMN GV 05 Lier
60,Mechelsesteenweg 365,2023-02-22,17:00:00,52,28,24,FMN GV 05 Lier
60,Mechelsesteenweg 365,2023-02-22,18:00:00,14,8,6,FMN GV 05 Lier
60,Mechelsesteenweg 365,2023-02-22,19:00:00,0,0,0,FMN GV 05 Lier
60,Mechelsesteenweg 365,2023-02-22,20:00:00,4,2,2,FMN GV 05 Lier
60,Mechelsesteenweg 365,2023-02-22,21:00:00,4,2,2,FMN GV 05 Lier
60,Mechelsesteenweg 365,2023-02-22,22:00:00,4,2,2,FMN GV 05 Lier
60,Mechelsesteenweg 365,2023-02-22,23:00:00,0,0,0,FMN GV 05 Lier
60,Mechelsesteenweg 365,2023-02-23,00:00:00,0,0,0,FMN GV 05 Lier
60,Mechelsesteenweg 365,2023-02-23,01:00:00,0,0,0,FMN GV 05 Lier
60,Mechelsesteenweg 365,2023-02-23,02:00:00,0,0,0,FMN GV 05 Lier
60,Mechelsesteenweg 365,2023-02-23,03:00:00,0,0,0,FMN GV 05 Lier
60,Mechelsesteenweg 365,2023-02-23,04:00:00,0,0,0,FMN GV 05 Lier
60,Mechelsesteenweg 365,2023-02-23,05:00:00,0,0,0,FMN GV 05 Lier
60,Mechelsesteenweg 365,2023-02-23,06:00:00,16,4,12,FMN GV 05 Lier
60,Mechelsesteenweg 365,2023-02-23,07:00:00,40,6,34,FMN GV 05 Lier
60,Mechelsesteenweg 365,2023-02-23,08:00:00,30,14,16,FMN GV 05 Lier
60,Mechelsesteenweg 365,2023-02-23,09:00:00,28,18,10,FMN GV 05 Lier
60,Mechelsesteenweg 365,2023-02-23,10:00:00,40,32,8,FMN GV 05 Lier
60,Mechelsesteenweg 365,2023-02-23,11:00:00,28,10,18,FMN GV 05 Lier
60,Mechelsesteenweg 365,2023-02-23,12:00:00,42,18,24,FMN GV 05 Lier
60,Mechelsesteenweg 365,2023-02-23,13:00:00,68,38,30,FMN GV 05 Lier
60,Mechelsesteenweg 365,2023-02-23,14:00:00,104,52,52,FMN GV 05 Lier
60,Mechelsesteenweg 365,2023-02-23,15:00:00,100,48,52,FMN GV 05 Lier
60,Mechelsesteenweg 365,2023-02-23,16:00:00,76,42,34,FMN GV 05 Lier
60,Mechelsesteenweg 365,2023-02-23,17:00:00,80,48,32,FMN GV 05 Lier
60,Mechelsesteenweg 365,2023-02-23,18:00:00,34,10,24,FMN GV 05 Lier
60,Mechelsesteenweg 365,2023-02-23,19:00:00,20,8,12,FMN GV 05 Lier
60,Mechelsesteenweg 365,2023-02-23,20:00:00,8,6,2,FMN GV 05 Lier
60,Mechelsesteenweg 365,2023-02-23,21:00:00,2,0,2,FMN GV 05 Lier
60,Mechelsesteenweg 365,2023-02-23,22:00:00,6,2,4,FMN GV 05 Lier
60,Mechelsesteenweg 365,2023-02-23,23:00:00,2,0,2,FMN GV 05 Lier
60,Mechelsesteenweg 365,2023-02-24,00:00:00,0,0,0,FMN GV 05 Lier
60,Mechelsesteenweg 365,2023-02-24,01:00:00,0,0,0,FMN GV 05 Lier
60,Mechelsesteenweg 365,2023-02-24,02:00:00,0,0,0,FMN GV 05 Lier
60,Mechelsesteenweg 365,2023-02-24,03:00:00,0,0,0,FMN GV 05 Lier
60,Mechelsesteenweg 365,2023-02-24,04:00:00,0,0,0,FMN GV 05 Lier
60,Mechelsesteenweg 365,2023-02-24,05:00:00,8,2,6,FMN GV 05 Lier
60,Mechelsesteenweg 365,2023-02-24,06:00:00,8,2,6,FMN GV 05 Lier
60,Mechelsesteenweg 365,2023-02-24,07:00:00,28,14,14,FMN GV 05 Lier
60,Mechelsesteenweg 365,2023-02-24,08:00:00,22,12,10,FMN GV 05 Lier
60,Mechelsesteenweg 365,2023-02-24,09:00:00,34,10,24,FMN GV 05 Lier
60,Mechelsesteenweg 365,2023-02-24,10:00:00,38,10,28,FMN GV 05 Lier
60,Mechelsesteenweg 365,2023-02-24,11:00:00,34,12,22,FMN GV 05 Lier
60,Mechelsesteenweg 365,2023-02-24,12:00:00,48,30,18,FMN GV 05 Lier
60,Mechelsesteenweg 365,2023-02-24,13:00:00,40,26,14,FMN GV 05 Lier
60,Mechelsesteenweg 365,2023-02-24,14:00:00,68,34,34,FMN GV 05 Lier
60,Mechelsesteenweg 365,2023-02-24,15:00:00,36,20,16,FMN GV 05 Lier
60,Mechelsesteenweg 365,2023-02-24,16:00:00,64,28,36,FMN GV 05 Lier
60,Mechelsesteenweg 365,2023-02-24,17:00:00,46,26,20,FMN GV 05 Lier
60,Mechelsesteenweg 365,2023-02-24,18:00:00,16,6,10,FMN GV 05 Lier
60,Mechelsesteenweg 365,2023-02-24,19:00:00,0,0,0,FMN GV 05 Lier
60,Mechelsesteenweg 365,2023-02-24,20:00:00,8,2,6,FMN GV 05 Lier
60,Mechelsesteenweg 365,2023-02-24,21:00:00,4,2,2,FMN GV 05 Lier
60,Mechelsesteenweg 365,2023-02-24,22:00:00,6,6,0,FMN GV 05 Lier
60,Mechelsesteenweg 365,2023-02-24,23:00:00,2,0,2,FMN GV 05 Lier
60,Mechelsesteenweg 365,2023-02-25,00:00:00,0,0,0,FMN GV 05 Lier
60,Mechelsesteenweg 365,2023-02-25,01:00:00,0,0,0,FMN GV 05 Lier
60,Mechelsesteenweg 365,2023-02-25,02:00:00,0,0,0,FMN GV 05 Lier
60,Mechelsesteenweg 365,2023-02-25,03:00:00,0,0,0,FMN GV 05 Lier
60,Mechelsesteenweg 365,2023-02-25,04:00:00,0,0,0,FMN GV 05 Lier
60,Mechelsesteenweg 365,2023-02-25,05:00:00,0,0,0,FMN GV 05 Lier
60,Mechelsesteenweg 365,2023-02-25,06:00:00,2,0,2,FMN GV 05 Lier
60,Mechelsesteenweg 365,2023-02-25,07:00:00,10,4,6,FMN GV 05 Lier
60,Mechelsesteenweg 365,2023-02-25,08:00:00,18,8,10,FMN GV 05 Lier
60,Mechelsesteenweg 365,2023-02-25,09:00:00,60,32,28,FMN GV 05 Lier
60,Mechelsesteenweg 365,2023-02-25,10:00:00,104,58,46,FMN GV 05 Lier
60,Mechelsesteenweg 365,2023-02-25,11:00:00,98,44,54,FMN GV 05 Lier
60,Mechelsesteenweg 365,2023-02-25,12:00:00,94,30,64,FMN GV 05 Lier
60,Mechelsesteenweg 365,2023-02-25,13:00:00,60,26,34,FMN GV 05 Lier
60,Mechelsesteenweg 365,2023-02-25,14:00:00,108,62,46,FMN GV 05 Lier
60,Mechelsesteenweg 365,2023-02-25,15:00:00,120,64,56,FMN GV 05 Lier
60,Mechelsesteenweg 365,2023-02-25,16:00:00,46,20,26,FMN GV 05 Lier
60,Mechelsesteenweg 365,2023-02-25,17:00:00,24,8,16,FMN GV 05 Lier
60,Mechelsesteenweg 365,2023-02-25,18:00:00,10,4,6,FMN GV 05 Lier
60,Mechelsesteenweg 365,2023-02-25,19:00:00,0,0,0,FMN GV 05 Lier
60,Mechelsesteenweg 365,2023-02-25,20:00:00,2,2,0,FMN GV 05 Lier
60,Mechelsesteenweg 365,2023-02-25,21:00:00,6,0,6,FMN GV 05 Lier
60,Mechelsesteenweg 365,2023-02-25,22:00:00,0,0,0,FMN GV 05 Lier
60,Mechelsesteenweg 365,2023-02-25,23:00:00,0,0,0,FMN GV 05 Lier
60,Mechelsesteenweg 365,2023-02-26,00:00:00,0,0,0,FMN GV 05 Lier
60,Mechelsesteenweg 365,2023-02-26,01:00:00,0,0,0,FMN GV 05 Lier
60,Mechelsesteenweg 365,2023-02-26,02:00:00,0,0,0,FMN GV 05 Lier
60,Mechelsesteenweg 365,2023-02-26,03:00:00,0,0,0,FMN GV 05 Lier
60,Mechelsesteenweg 365,2023-02-26,04:00:00,0,0,0,FMN GV 05 Lier
60,Mechelsesteenweg 365,2023-02-26,05:00:00,0,0,0,FMN GV 05 Lier
60,Mechelsesteenweg 365,2023-02-26,06:00:00,0,0,0,FMN GV 05 Lier
60,Mechelsesteenweg 365,2023-02-26,07:00:00,0,0,0,FMN GV 05 Lier
60,Mechelsesteenweg 365,2023-02-26,08:00:00,18,12,6,FMN GV 05 Lier
60,Mechelsesteenweg 365,2023-02-26,09:00:00,110,60,50,FMN GV 05 Lier
60,Mechelsesteenweg 365,2023-02-26,10:00:00,186,106,80,FMN GV 05 Lier
60,Mechelsesteenweg 365,2023-02-26,11:00:00,266,102,164,FMN GV 05 Lier
60,Mechelsesteenweg 365,2023-02-26,12:00:00,106,50,56,FMN GV 05 Lier
60,Mechelsesteenweg 365,2023-02-26,13:00:00,136,60,76,FMN GV 05 Lier
60,Mechelsesteenweg 365,2023-02-26,14:00:00,108,58,50,FMN GV 05 Lier
60,Mechelsesteenweg 365,2023-02-26,15:00:00,90,36,54,FMN GV 05 Lier
60,Mechelsesteenweg 365,2023-02-26,16:00:00,70,28,42,FMN GV 05 Lier
60,Mechelsesteenweg 365,2023-02-26,17:00:00,14,6,8,FMN GV 05 Lier
60,Mechelsesteenweg 365,2023-02-26,18:00:00,4,0,4,FMN GV 05 Lier
60,Mechelsesteenweg 365,2023-02-26,19:00:00,2,2,0,FMN GV 05 Lier
60,Mechelsesteenweg 365,2023-02-26,20:00:00,2,2,0,FMN GV 05 Lier
60,Mechelsesteenweg 365,2023-02-26,21:00:00,0,0,0,FMN GV 05 Lier
60,Mechelsesteenweg 365,2023-02-26,22:00:00,0,0,0,FMN GV 05 Lier
60,Mechelsesteenweg 365,2023-02-26,23:00:00,0,0,0,FMN GV 05 Lier
60,Mechelsesteenweg 365,2023-02-27,00:00:00,0,0,0,FMN GV 05 Lier
60,Mechelsesteenweg 365,2023-02-27,01:00:00,0,0,0,FMN GV 05 Lier
60,Mechelsesteenweg 365,2023-02-27,02:00:00,0,0,0,FMN GV 05 Lier
60,Mechelsesteenweg 365,2023-02-27,03:00:00,0,0,0,FMN GV 05 Lier
60,Mechelsesteenweg 365,2023-02-27,04:00:00,0,0,0,FMN GV 05 Lier
60,Mechelsesteenweg 365,2023-02-27,05:00:00,2,0,2,FMN GV 05 Lier
60,Mechelsesteenweg 365,2023-02-27,06:00:00,12,4,8,FMN GV 05 Lier
60,Mechelsesteenweg 365,2023-02-27,07:00:00,58,20,38,FMN GV 05 Lier
60,Mechelsesteenweg 365,2023-02-27,08:00:00,76,36,40,FMN GV 05 Lier
60,Mechelsesteenweg 365,2023-02-27,09:00:00,36,14,22,FMN GV 05 Lier
60,Mechelsesteenweg 365,2023-02-27,10:00:00,34,16,18,FMN GV 05 Lier
60,Mechelsesteenweg 365,2023-02-27,11:00:00,52,26,26,FMN GV 05 Lier
60,Mechelsesteenweg 365,2023-02-27,12:00:00,40,16,24,FMN GV 05 Lier
60,Mechelsesteenweg 365,2023-02-27,13:00:00,70,30,40,FMN GV 05 Lier
60,Mechelsesteenweg 365,2023-02-27,14:00:00,110,54,56,FMN GV 05 Lier
60,Mechelsesteenweg 365,2023-02-27,15:00:00,86,26,60,FMN GV 05 Lier
60,Mechelsesteenweg 365,2023-02-27,16:00:00,208,68,140,FMN GV 05 Lier
60,Mechelsesteenweg 365,2023-02-27,17:00:00,84,54,30,FMN GV 05 Lier
60,Mechelsesteenweg 365,2023-02-27,18:00:00,36,20,16,FMN GV 05 Lier
60,Mechelsesteenweg 365,2023-02-27,19:00:00,8,2,6,FMN GV 05 Lier
60,Mechelsesteenweg 365,2023-02-27,20:00:00,10,2,8,FMN GV 05 Lier
60,Mechelsesteenweg 365,2023-02-27,21:00:00,4,0,4,FMN GV 05 Lier
60,Mechelsesteenweg 365,2023-02-27,22:00:00,2,2,0,FMN GV 05 Lier
60,Mechelsesteenweg 365,2023-02-27,23:00:00,0,0,0,FMN GV 05 Lier
60,Mechelsesteenweg 365,2023-02-28,00:00:00,0,0,0,FMN GV 05 Lier
60,Mechelsesteenweg 365,2023-02-28,01:00:00,0,0,0,FMN GV 05 Lier
60,Mechelsesteenweg 365,2023-02-28,02:00:00,0,0,0,FMN GV 05 Lier
60,Mechelsesteenweg 365,2023-02-28,03:00:00,0,0,0,FMN GV 05 Lier
60,Mechelsesteenweg 365,2023-02-28,04:00:00,0,0,0,FMN GV 05 Lier
60,Mechelsesteenweg 365,2023-02-28,05:00:00,4,0,4,FMN GV 05 Lier
60,Mechelsesteenweg 365,2023-02-28,06:00:00,14,0,14,FMN GV 05 Lier
60,Mechelsesteenweg 365,2023-02-28,07:00:00,76,32,44,FMN GV 05 Lier
60,Mechelsesteenweg 365,2023-02-28,08:00:00,102,56,46,FMN GV 05 Lier
60,Mechelsesteenweg 365,2023-02-28,09:00:00,42,34,8,FMN GV 05 Lier
60,Mechelsesteenweg 365,2023-02-28,10:00:00,32,6,26,FMN GV 05 Lier
60,Mechelsesteenweg 365,2023-02-28,11:00:00,44,12,32,FMN GV 05 Lier
60,Mechelsesteenweg 365,2023-02-28,12:00:00,70,34,36,FMN GV 05 Lier
60,Mechelsesteenweg 365,2023-02-28,13:00:00,112,52,60,FMN GV 05 Lier
60,Mechelsesteenweg 365,2023-02-28,14:00:00,112,52,60,FMN GV 05 Lier
60,Mechelsesteenweg 365,2023-02-28,15:00:00,88,34,54,FMN GV 05 Lier
60,Mechelsesteenweg 365,2023-02-28,16:00:00,200,84,116,FMN GV 05 Lier
60,Mechelsesteenweg 365,2023-02-28,17:00:00,130,72,58,FMN GV 05 Lier
60,Mechelsesteenweg 365,2023-02-28,18:00:00,50,28,22,FMN GV 05 Lier
60,Mechelsesteenweg 365,2023-02-28,19:00:00,6,4,2,FMN GV 05 Lier
60,Mechelsesteenweg 365,2023-02-28,20:00:00,8,4,4,FMN GV 05 Lier
60,Mechelsesteenweg 365,2023-02-28,21:00:00,4,4,0,FMN GV 05 Lier
60,Mechelsesteenweg 365,2023-02-28,22:00:00,0,0,0,FMN GV 05 Lier
60,Mechelsesteenweg 365,2023-02-28,23:00:00,2,2,0,FMN GV 05 Lier
60,Mechelsesteenweg 365,2023-03-01,00:00:00,0,0,0,FMN GV 05 Lier
60,Mechelsesteenweg 365,2023-03-01,01:00:00,0,0,0,FMN GV 05 Lier
60,Mechelsesteenweg 365,2023-03-01,02:00:00,0,0,0,FMN GV 05 Lier
60,Mechelsesteenweg 365,2023-03-01,03:00:00,0,0,0,FMN GV 05 Lier
60,Mechelsesteenweg 365,2023-03-01,04:00:00,0,0,0,FMN GV 05 Lier
60,Mechelsesteenweg 365,2023-03-01,05:00:00,2,2,0,FMN GV 05 Lier
60,Mechelsesteenweg 365,2023-03-01,06:00:00,18,4,14,FMN GV 05 Lier
60,Mechelsesteenweg 365,2023-03-01,07:00:00,62,24,38,FMN GV 05 Lier
60,Mechelsesteenweg 365,2023-03-01,08:00:00,56,28,28,FMN GV 05 Lier
60,Mechelsesteenweg 365,2023-03-01,09:00:00,24,10,14,FMN GV 05 Lier
60,Mechelsesteenweg 365,2023-03-01,10:00:00,42,18,24,FMN GV 05 Lier
60,Mechelsesteenweg 365,2023-03-01,11:00:00,40,8,32,FMN GV 05 Lier
60,Mechelsesteenweg 365,2023-03-01,12:00:00,122,40,82,FMN GV 05 Lier
60,Mechelsesteenweg 365,2023-03-01,13:00:00,118,36,82,FMN GV 05 Lier
60,Mechelsesteenweg 365,2023-03-01,14:00:00,142,74,68,FMN GV 05 Lier
60,Mechelsesteenweg 365,2023-03-01,15:00:00,126,62,64,FMN GV 05 Lier
60,Mechelsesteenweg 365,2023-03-01,16:00:00,136,66,70,FMN GV 05 Lier
60,Mechelsesteenweg 365,2023-03-01,17:00:00,104,70,34,FMN GV 05 Lier
60,Mechelsesteenweg 365,2023-03-01,18:00:00,40,20,20,FMN GV 05 Lier
60,Mechelsesteenweg 365,2023-03-01,19:00:00,4,0,4,FMN GV 05 Lier
60,Mechelsesteenweg 365,2023-03-01,20:00:00,2,0,2,FMN GV 05 Lier
60,Mechelsesteenweg 365,2023-03-01,21:00:00,2,0,2,FMN GV 05 Lier
60,Mechelsesteenweg 365,2023-03-01,22:00:00,2,2,0,FMN GV 05 Lier
60,Mechelsesteenweg 365,2023-03-01,23:00:00,0,0,0,FMN GV 05 Lier
60,Mechelsesteenweg 365,2023-03-02,00:00:00,0,0,0,FMN GV 05 Lier
60,Mechelsesteenweg 365,2023-03-02,01:00:00,0,0,0,FMN GV 05 Lier
60,Mechelsesteenweg 365,2023-03-02,02:00:00,0,0,0,FMN GV 05 Lier
60,Mechelsesteenweg 365,2023-03-02,03:00:00,0,0,0,FMN GV 05 Lier
60,Mechelsesteenweg 365,2023-03-02,04:00:00,0,0,0,FMN GV 05 Lier
60,Mechelsesteenweg 365,2023-03-02,05:00:00,4,0,4,FMN GV 05 Lier
60,Mechelsesteenweg 365,2023-03-02,06:00:00,18,0,18,FMN GV 05 Lier
60,Mechelsesteenweg 365,2023-03-02,07:00:00,60,22,38,FMN GV 05 Lier
60,Mechelsesteenweg 365,2023-03-02,08:00:00,104,70,34,FMN GV 05 Lier
60,Mechelsesteenweg 365,2023-03-02,09:00:00,34,18,16,FMN GV 05 Lier
60,Mechelsesteenweg 365,2023-03-02,10:00:00,46,24,22,FMN GV 05 Lier
60,Mechelsesteenweg 365,2023-03-02,11:00:00,62,20,42,FMN GV 05 Lier
60,Mechelsesteenweg 365,2023-03-02,12:00:00,56,20,36,FMN GV 05 Lier
60,Mechelsesteenweg 365,2023-03-02,13:00:00,118,50,68,FMN GV 05 Lier
60,Mechelsesteenweg 365,2023-03-02,14:00:00,162,70,92,FMN GV 05 Lier
60,Mechelsesteenweg 365,2023-03-02,15:00:00,138,50,88,FMN GV 05 Lier
60,Mechelsesteenweg 365,2023-03-02,16:00:00,244,78,166,FMN GV 05 Lier
60,Mechelsesteenweg 365,2023-03-02,17:00:00,148,84,64,FMN GV 05 Lier
60,Mechelsesteenweg 365,2023-03-02,18:00:00,48,28,20,FMN GV 05 Lier
60,Mechelsesteenweg 365,2023-03-02,19:00:00,20,14,6,FMN GV 05 Lier
60,Mechelsesteenweg 365,2023-03-02,20:00:00,8,4,4,FMN GV 05 Lier
60,Mechelsesteenweg 365,2023-03-02,21:00:00,0,0,0,FMN GV 05 Lier
60,Mechelsesteenweg 365,2023-03-02,22:00:00,6,0,6,FMN GV 05 Lier
60,Mechelsesteenweg 365,2023-03-02,23:00:00,0,0,0,FMN GV 05 Lier
60,Mechelsesteenweg 365,2023-03-03,00:00:00,0,0,0,FMN GV 05 Lier
60,Mechelsesteenweg 365,2023-03-03,01:00:00,0,0,0,FMN GV 05 Lier
60,Mechelsesteenweg 365,2023-03-03,02:00:00,0,0,0,FMN GV 05 Lier
60,Mechelsesteenweg 365,2023-03-03,03:00:00,0,0,0,FMN GV 05 Lier
60,Mechelsesteenweg 365,2023-03-03,04:00:00,0,0,0,FMN GV 05 Lier
60,Mechelsesteenweg 365,2023-03-03,05:00:00,6,2,4,FMN GV 05 Lier
60,Mechelsesteenweg 365,2023-03-03,06:00:00,14,0,14,FMN GV 05 Lier
60,Mechelsesteenweg 365,2023-03-03,07:00:00,78,44,34,FMN GV 05 Lier
60,Mechelsesteenweg 365,2023-03-03,08:00:00,82,42,40,FMN GV 05 Lier
60,Mechelsesteenweg 365,2023-03-03,09:00:00,22,4,18,FMN GV 05 Lier
60,Mechelsesteenweg 365,2023-03-03,10:00:00,50,20,30,FMN GV 05 Lier
60,Mechelsesteenweg 365,2023-03-03,11:00:00,38,20,18,FMN GV 05 Lier
60,Mechelsesteenweg 365,2023-03-03,12:00:00,46,16,30,FMN GV 05 Lier
60,Mechelsesteenweg 365,2023-03-03,13:00:00,70,40,30,FMN GV 05 Lier
60,Mechelsesteenweg 365,2023-03-03,14:00:00,100,54,46,FMN GV 05 Lier
60,Mechelsesteenweg 365,2023-03-03,15:00:00,122,40,82,FMN GV 05 Lier
60,Mechelsesteenweg 365,2023-03-03,16:00:00,180,60,120,FMN GV 05 Lier
60,Mechelsesteenweg 365,2023-03-03,17:00:00,80,44,36,FMN GV 05 Lier
60,Mechelsesteenweg 365,2023-03-03,18:00:00,46,28,18,FMN GV 05 Lier
60,Mechelsesteenweg 365,2023-03-03,19:00:00,10,4,6,FMN GV 05 Lier
60,Mechelsesteenweg 365,2023-03-03,20:00:00,4,2,2,FMN GV 05 Lier
60,Mechelsesteenweg 365,2023-03-03,21:00:00,6,2,4,FMN GV 05 Lier
60,Mechelsesteenweg 365,2023-03-03,22:00:00,2,2,0,FMN GV 05 Lier
60,Mechelsesteenweg 365,2023-03-03,23:00:00,2,0,2,FMN GV 05 Lier
60,Mechelsesteenweg 365,2023-03-04,00:00:00,2,2,0,FMN GV 05 Lier
60,Mechelsesteenweg 365,2023-03-04,01:00:00,0,0,0,FMN GV 05 Lier
60,Mechelsesteenweg 365,2023-03-04,02:00:00,0,0,0,FMN GV 05 Lier
60,Mechelsesteenweg 365,2023-03-04,03:00:00,0,0,0,FMN GV 05 Lier
60,Mechelsesteenweg 365,2023-03-04,04:00:00,0,0,0,FMN GV 05 Lier
60,Mechelsesteenweg 365,2023-03-04,05:00:00,2,0,2,FMN GV 05 Lier
60,Mechelsesteenweg 365,2023-03-04,06:00:00,2,0,2,FMN GV 05 Lier
60,Mechelsesteenweg 365,2023-03-04,07:00:00,4,0,4,FMN GV 05 Lier
60,Mechelsesteenweg 365,2023-03-04,08:00:00,22,14,8,FMN GV 05 Lier
60,Mechelsesteenweg 365,2023-03-04,09:00:00,66,38,28,FMN GV 05 Lier
60,Mechelsesteenweg 365,2023-03-04,10:00:00,94,48,46,FMN GV 05 Lier
60,Mechelsesteenweg 365,2023-03-04,11:00:00,110,42,68,FMN GV 05 Lier
60,Mechelsesteenweg 365,2023-03-04,12:00:00,86,42,44,FMN GV 05 Lier
60,Mechelsesteenweg 365,2023-03-04,13:00:00,100,42,58,FMN GV 05 Lier
60,Mechelsesteenweg 365,2023-03-04,14:00:00,74,30,44,FMN GV 05 Lier
60,Mechelsesteenweg 365,2023-03-04,15:00:00,84,54,30,FMN GV 05 Lier
60,Mechelsesteenweg 365,2023-03-04,16:00:00,58,30,28,FMN GV 05 Lier
60,Mechelsesteenweg 365,2023-03-04,17:00:00,48,12,36,FMN GV 05 Lier
60,Mechelsesteenweg 365,2023-03-04,18:00:00,18,10,8,FMN GV 05 Lier
60,Mechelsesteenweg 365,2023-03-04,19:00:00,6,2,4,FMN GV 05 Lier
60,Mechelsesteenweg 365,2023-03-04,20:00:00,2,2,0,FMN GV 05 Lier
60,Mechelsesteenweg 365,2023-03-04,21:00:00,2,0,2,FMN GV 05 Lier
60,Mechelsesteenweg 365,2023-03-04,22:00:00,4,0,4,FMN GV 05 Lier
60,Mechelsesteenweg 365,2023-03-04,23:00:00,2,2,0,FMN GV 05 Lier
60,Mechelsesteenweg 365,2023-03-05,00:00:00,0,0,0,FMN GV 05 Lier
60,Mechelsesteenweg 365,2023-03-05,01:00:00,0,0,0,FMN GV 05 Lier
60,Mechelsesteenweg 365,2023-03-05,02:00:00,0,0,0,FMN GV 05 Lier
60,Mechelsesteenweg 365,2023-03-05,03:00:00,0,0,0,FMN GV 05 Lier
60,Mechelsesteenweg 365,2023-03-05,04:00:00,0,0,0,FMN GV 05 Lier
60,Mechelsesteenweg 365,2023-03-05,05:00:00,0,0,0,FMN GV 05 Lier
60,Mechelsesteenweg 365,2023-03-05,06:00:00,4,0,4,FMN GV 05 Lier
60,Mechelsesteenweg 365,2023-03-05,07:00:00,4,4,0,FMN GV 05 Lier
60,Mechelsesteenweg 365,2023-03-05,08:00:00,18,8,10,FMN GV 05 Lier
60,Mechelsesteenweg 365,2023-03-05,09:00:00,82,48,34,FMN GV 05 Lier
60,Mechelsesteenweg 365,2023-03-05,10:00:00,152,104,48,FMN GV 05 Lier
60,Mechelsesteenweg 365,2023-03-05,11:00:00,88,26,62,FMN GV 05 Lier
60,Mechelsesteenweg 365,2023-03-05,12:00:00,100,30,70,FMN GV 05 Lier
60,Mechelsesteenweg 365,2023-03-05,13:00:00,56,38,18,FMN GV 05 Lier
60,Mechelsesteenweg 365,2023-03-05,14:00:00,50,20,30,FMN GV 05 Lier
60,Mechelsesteenweg 365,2023-03-05,15:00:00,48,26,22,FMN GV 05 Lier
60,Mechelsesteenweg 365,2023-03-05,16:00:00,38,18,20,FMN GV 05 Lier
60,Mechelsesteenweg 365,2023-03-05,17:00:00,30,12,18,FMN GV 05 Lier
60,Mechelsesteenweg 365,2023-03-05,18:00:00,6,2,4,FMN GV 05 Lier
60,Mechelsesteenweg 365,2023-03-05,19:00:00,0,0,0,FMN GV 05 Lier
60,Mechelsesteenweg 365,2023-03-05,20:00:00,0,0,0,FMN GV 05 Lier
60,Mechelsesteenweg 365,2023-03-05,21:00:00,0,0,0,FMN GV 05 Lier
60,Mechelsesteenweg 365,2023-03-05,22:00:00,2,0,2,FMN GV 05 Lier
60,Mechelsesteenweg 365,2023-03-05,23:00:00,0,0,0,FMN GV 05 Lier
60,Mechelsesteenweg 365,2023-03-06,00:00:00,0,0,0,FMN GV 05 Lier
60,Mechelsesteenweg 365,2023-03-06,01:00:00,0,0,0,FMN GV 05 Lier
60,Mechelsesteenweg 365,2023-03-06,02:00:00,0,0,0,FMN GV 05 Lier
60,Mechelsesteenweg 365,2023-03-06,03:00:00,0,0,0,FMN GV 05 Lier
60,Mechelsesteenweg 365,2023-03-06,04:00:00,0,0,0,FMN GV 05 Lier
60,Mechelsesteenweg 365,2023-03-06,05:00:00,2,0,2,FMN GV 05 Lier
60,Mechelsesteenweg 365,2023-03-06,06:00:00,16,6,10,FMN GV 05 Lier
60,Mechelsesteenweg 365,2023-03-06,07:00:00,76,32,44,FMN GV 05 Lier
60,Mechelsesteenweg 365,2023-03-06,08:00:00,72,44,28,FMN GV 05 Lier
60,Mechelsesteenweg 365,2023-03-06,09:00:00,36,22,14,FMN GV 05 Lier
60,Mechelsesteenweg 365,2023-03-06,10:00:00,22,12,10,FMN GV 05 Lier
60,Mechelsesteenweg 365,2023-03-06,11:00:00,38,8,30,FMN GV 05 Lier
60,Mechelsesteenweg 365,2023-03-06,12:00:00,36,18,18,FMN GV 05 Lier
60,Mechelsesteenweg 365,2023-03-06,13:00:00,50,26,24,FMN GV 05 Lier
60,Mechelsesteenweg 365,2023-03-06,14:00:00,48,28,20,FMN GV 05 Lier
60,Mechelsesteenweg 365,2023-03-06,15:00:00,60,40,20,FMN GV 05 Lier
60,Mechelsesteenweg 365,2023-03-06,16:00:00,182,64,118,FMN GV 05 Lier
60,Mechelsesteenweg 365,2023-03-06,17:00:00,82,44,38,FMN GV 05 Lier
60,Mechelsesteenweg 365,2023-03-06,18:00:00,32,18,14,FMN GV 05 Lier
60,Mechelsesteenweg 365,2023-03-06,19:00:00,2,2,0,FMN GV 05 Lier
60,Mechelsesteenweg 365,2023-03-06,20:00:00,0,0,0,FMN GV 05 Lier
60,Mechelsesteenweg 365,2023-03-06,21:00:00,2,0,2,FMN GV 05 Lier
60,Mechelsesteenweg 365,2023-03-06,22:00:00,6,0,6,FMN GV 05 Lier
60,Mechelsesteenweg 365,2023-03-06,23:00:00,2,2,0,FMN GV 05 Lier
60,Mechelsesteenweg 365,2023-03-07,00:00:00,0,0,0,FMN GV 05 Lier
60,Mechelsesteenweg 365,2023-03-07,01:00:00,0,0,0,FMN GV 05 Lier
60,Mechelsesteenweg 365,2023-03-07,02:00:00,0,0,0,FMN GV 05 Lier
60,Mechelsesteenweg 365,2023-03-07,03:00:00,0,0,0,FMN GV 05 Lier
60,Mechelsesteenweg 365,2023-03-07,04:00:00,2,2,0,FMN GV 05 Lier
60,Mechelsesteenweg 365,2023-03-07,05:00:00,2,0,2,FMN GV 05 Lier
60,Mechelsesteenweg 365,2023-03-07,06:00:00,10,2,8,FMN GV 05 Lier
60,Mechelsesteenweg 365,2023-03-07,07:00:00,66,38,28,FMN GV 05 Lier
60,Mechelsesteenweg 365,2023-03-07,08:00:00,66,36,30,FMN GV 05 Lier
60,Mechelsesteenweg 365,2023-03-07,09:00:00,20,14,6,FMN GV 05 Lier
60,Mechelsesteenweg 365,2023-03-07,10:00:00,2,2,0,FMN GV 05 Lier
60,Mechelsesteenweg 365,2023-03-07,11:00:00,4,2,2,FMN GV 05 Lier
60,Mechelsesteenweg 365,2023-03-07,12:00:00,16,8,8,FMN GV 05 Lier
60,Mechelsesteenweg 365,2023-03-07,13:00:00,16,6,10,FMN GV 05 Lier
60,Mechelsesteenweg 365,2023-03-07,14:00:00,10,6,4,FMN GV 05 Lier
60,Mechelsesteenweg 365,2023-03-07,15:00:00,30,10,20,FMN GV 05 Lier
60,Mechelsesteenweg 365,2023-03-07,16:00:00,90,30,60,FMN GV 05 Lier
60,Mechelsesteenweg 365,2023-03-07,17:00:00,32,18,14,FMN GV 05 Lier
60,Mechelsesteenweg 365,2023-03-07,18:00:00,20,16,4,FMN GV 05 Lier
60,Mechelsesteenweg 365,2023-03-07,19:00:00,4,2,2,FMN GV 05 Lier
60,Mechelsesteenweg 365,2023-03-07,20:00:00,2,2,0,FMN GV 05 Lier
60,Mechelsesteenweg 365,2023-03-07,21:00:00,2,0,2,FMN GV 05 Lier
60,Mechelsesteenweg 365,2023-03-07,22:00:00,2,2,0,FMN GV 05 Lier
60,Mechelsesteenweg 365,2023-03-07,23:00:00,2,2,0,FMN GV 05 Lier
60,Mechelsesteenweg 365,2023-03-08,00:00:00,0,0,0,FMN GV 05 Lier
60,Mechelsesteenweg 365,2023-03-08,01:00:00,0,0,0,FMN GV 05 Lier
60,Mechelsesteenweg 365,2023-03-08,02:00:00,0,0,0,FMN GV 05 Lier
60,Mechelsesteenweg 365,2023-03-08,03:00:00,0,0,0,FMN GV 05 Lier
60,Mechelsesteenweg 365,2023-03-08,04:00:00,0,0,0,FMN GV 05 Lier
60,Mechelsesteenweg 365,2023-03-08,05:00:00,0,0,0,FMN GV 05 Lier
60,Mechelsesteenweg 365,2023-03-08,06:00:00,4,0,4,FMN GV 05 Lier
60,Mechelsesteenweg 365,2023-03-08,07:00:00,18,2,16,FMN GV 05 Lier
60,Mechelsesteenweg 365,2023-03-08,08:00:00,40,26,14,FMN GV 05 Lier
60,Mechelsesteenweg 365,2023-03-08,09:00:00,2,0,2,FMN GV 05 Lier
60,Mechelsesteenweg 365,2023-03-08,10:00:00,0,0,0,FMN GV 05 Lier
60,Mechelsesteenweg 365,2023-03-08,11:00:00,6,4,2,FMN GV 05 Lier
60,Mechelsesteenweg 365,2023-03-08,12:00:00,36,12,24,FMN GV 05 Lier
60,Mechelsesteenweg 365,2023-03-08,13:00:00,26,4,22,FMN GV 05 Lier
60,Mechelsesteenweg 365,2023-03-08,14:00:00,20,8,12,FMN GV 05 Lier
60,Mechelsesteenweg 365,2023-03-08,15:00:00,24,10,14,FMN GV 05 Lier
60,Mechelsesteenweg 365,2023-03-08,16:00:00,14,12,2,FMN GV 05 Lier
60,Mechelsesteenweg 365,2023-03-08,17:00:00,18,14,4,FMN GV 05 Lier
60,Mechelsesteenweg 365,2023-03-08,18:00:00,12,8,4,FMN GV 05 Lier
60,Mechelsesteenweg 365,2023-03-08,19:00:00,0,0,0,FMN GV 05 Lier
60,Mechelsesteenweg 365,2023-03-08,20:00:00,4,4,0,FMN GV 05 Lier
60,Mechelsesteenweg 365,2023-03-08,21:00:00,2,0,2,FMN GV 05 Lier
60,Mechelsesteenweg 365,2023-03-08,22:00:00,0,0,0,FMN GV 05 Lier
60,Mechelsesteenweg 365,2023-03-08,23:00:00,2,2,0,FMN GV 05 Lier
60,Mechelsesteenweg 365,2023-03-09,00:00:00,0,0,0,FMN GV 05 Lier
60,Mechelsesteenweg 365,2023-03-09,01:00:00,0,0,0,FMN GV 05 Lier
60,Mechelsesteenweg 365,2023-03-09,02:00:00,0,0,0,FMN GV 05 Lier
60,Mechelsesteenweg 365,2023-03-09,03:00:00,0,0,0,FMN GV 05 Lier
60,Mechelsesteenweg 365,2023-03-09,04:00:00,0,0,0,FMN GV 05 Lier
60,Mechelsesteenweg 365,2023-03-09,05:00:00,4,2,2,FMN GV 05 Lier
60,Mechelsesteenweg 365,2023-03-09,06:00:00,6,0,6,FMN GV 05 Lier
60,Mechelsesteenweg 365,2023-03-09,07:00:00,46,14,32,FMN GV 05 Lier
60,Mechelsesteenweg 365,2023-03-09,08:00:00,56,32,24,FMN GV 05 Lier
60,Mechelsesteenweg 365,2023-03-09,09:00:00,52,16,36,FMN GV 05 Lier
60,Mechelsesteenweg 365,2023-03-09,10:00:00,52,26,26,FMN GV 05 Lier
60,Mechelsesteenweg 365,2023-03-09,11:00:00,36,22,14,FMN GV 05 Lier
60,Mechelsesteenweg 365,2023-03-09,12:00:00,16,6,10,FMN GV 05 Lier
60,Mechelsesteenweg 365,2023-03-09,13:00:00,6,6,0,FMN GV 05 Lier
60,Mechelsesteenweg 365,2023-03-09,14:00:00,22,10,12,FMN GV 05 Lier
60,Mechelsesteenweg 365,2023-03-09,15:00:00,48,20,28,FMN GV 05 Lier
60,Mechelsesteenweg 365,2023-03-09,16:00:00,86,28,58,FMN GV 05 Lier
60,Mechelsesteenweg 365,2023-03-09,17:00:00,50,32,18,FMN GV 05 Lier
60,Mechelsesteenweg 365,2023-03-09,18:00:00,8,6,2,FMN GV 05 Lier
60,Mechelsesteenweg 365,2023-03-09,19:00:00,2,0,2,FMN GV 05 Lier
60,Mechelsesteenweg 365,2023-03-09,20:00:00,2,0,2,FMN GV 05 Lier
60,Mechelsesteenweg 365,2023-03-09,21:00:00,4,2,2,FMN GV 05 Lier
60,Mechelsesteenweg 365,2023-03-09,22:00:00,2,0,2,FMN GV 05 Lier
60,Mechelsesteenweg 365,2023-03-09,23:00:00,0,0,0,FMN GV 05 Lier
60,Mechelsesteenweg 365,2023-03-10,00:00:00,2,2,0,FMN GV 05 Lier
60,Mechelsesteenweg 365,2023-03-10,01:00:00,0,0,0,FMN GV 05 Lier
60,Mechelsesteenweg 365,2023-03-10,02:00:00,0,0,0,FMN GV 05 Lier
60,Mechelsesteenweg 365,2023-03-10,03:00:00,0,0,0,FMN GV 05 Lier
60,Mechelsesteenweg 365,2023-03-10,04:00:00,0,0,0,FMN GV 05 Lier
60,Mechelsesteenweg 365,2023-03-10,05:00:00,2,0,2,FMN GV 05 Lier
60,Mechelsesteenweg 365,2023-03-10,06:00:00,8,4,4,FMN GV 05 Lier
60,Mechelsesteenweg 365,2023-03-10,07:00:00,70,42,28,FMN GV 05 Lier
60,Mechelsesteenweg 365,2023-03-10,08:00:00,80,42,38,FMN GV 05 Lier
60,Mechelsesteenweg 365,2023-03-10,09:00:00,6,4,2,FMN GV 05 Lier
60,Mechelsesteenweg 365,2023-03-10,10:00:00,4,0,4,FMN GV 05 Lier
60,Mechelsesteenweg 365,2023-03-10,11:00:00,4,2,2,FMN GV 05 Lier
60,Mechelsesteenweg 365,2023-03-10,12:00:00,18,14,4,FMN GV 05 Lier
60,Mechelsesteenweg 365,2023-03-10,13:00:00,14,2,12,FMN GV 05 Lier
60,Mechelsesteenweg 365,2023-03-10,14:00:00,18,6,12,FMN GV 05 Lier
60,Mechelsesteenweg 365,2023-03-10,15:00:00,34,6,28,FMN GV 05 Lier
60,Mechelsesteenweg 365,2023-03-10,16:00:00,60,22,38,FMN GV 05 Lier
60,Mechelsesteenweg 365,2023-03-10,17:00:00,22,12,10,FMN GV 05 Lier
60,Mechelsesteenweg 365,2023-03-10,18:00:00,6,2,4,FMN GV 05 Lier
60,Mechelsesteenweg 365,2023-03-10,19:00:00,2,0,2,FMN GV 05 Lier
60,Mechelsesteenweg 365,2023-03-10,20:00:00,2,2,0,FMN GV 05 Lier
60,Mechelsesteenweg 365,2023-03-10,21:00:00,0,0,0,FMN GV 05 Lier
60,Mechelsesteenweg 365,2023-03-10,22:00:00,0,0,0,FMN GV 05 Lier
60,Mechelsesteenweg 365,2023-03-10,23:00:00,0,0,0,FMN GV 05 Lier
60,Mechelsesteenweg 365,2023-03-11,00:00:00,0,0,0,FMN GV 05 Lier
60,Mechelsesteenweg 365,2023-03-11,01:00:00,0,0,0,FMN GV 05 Lier
60,Mechelsesteenweg 365,2023-03-11,02:00:00,0,0,0,FMN GV 05 Lier
60,Mechelsesteenweg 365,2023-03-11,03:00:00,0,0,0,FMN GV 05 Lier
60,Mechelsesteenweg 365,2023-03-11,04:00:00,0,0,0,FMN GV 05 Lier
60,Mechelsesteenweg 365,2023-03-11,05:00:00,0,0,0,FMN GV 05 Lier
60,Mechelsesteenweg 365,2023-03-11,06:00:00,0,0,0,FMN GV 05 Lier
60,Mechelsesteenweg 365,2023-03-11,07:00:00,4,0,4,FMN GV 05 Lier
60,Mechelsesteenweg 365,2023-03-11,08:00:00,14,4,10,FMN GV 05 Lier
60,Mechelsesteenweg 365,2023-03-11,09:00:00,68,40,28,FMN GV 05 Lier
60,Mechelsesteenweg 365,2023-03-11,10:00:00,110,68,42,FMN GV 05 Lier
60,Mechelsesteenweg 365,2023-03-11,11:00:00,182,66,116,FMN GV 05 Lier
60,Mechelsesteenweg 365,2023-03-11,12:00:00,192,108,84,FMN GV 05 Lier
60,Mechelsesteenweg 365,2023-03-11,13:00:00,230,104,126,FMN GV 05 Lier
60,Mechelsesteenweg 365,2023-03-11,14:00:00,318,202,116,FMN GV 05 Lier
60,Mechelsesteenweg 365,2023-03-11,15:00:00,260,128,132,FMN GV 05 Lier
60,Mechelsesteenweg 365,2023-03-11,16:00:00,166,78,88,FMN GV 05 Lier
60,Mechelsesteenweg 365,2023-03-11,17:00:00,84,38,46,FMN GV 05 Lier
60,Mechelsesteenweg 365,2023-03-11,18:00:00,20,8,12,FMN GV 05 Lier
60,Mechelsesteenweg 365,2023-03-11,19:00:00,14,10,4,FMN GV 05 Lier
60,Mechelsesteenweg 365,2023-03-11,20:00:00,2,0,2,FMN GV 05 Lier
60,Mechelsesteenweg 365,2023-03-11,21:00:00,2,2,0,FMN GV 05 Lier
60,Mechelsesteenweg 365,2023-03-11,22:00:00,0,0,0,FMN GV 05 Lier
60,Mechelsesteenweg 365,2023-03-11,23:00:00,4,4,0,FMN GV 05 Lier
60,Mechelsesteenweg 365,2023-03-12,00:00:00,2,2,0,FMN GV 05 Lier
60,Mechelsesteenweg 365,2023-03-12,01:00:00,6,4,2,FMN GV 05 Lier
60,Mechelsesteenweg 365,2023-03-12,02:00:00,0,0,0,FMN GV 05 Lier
60,Mechelsesteenweg 365,2023-03-12,03:00:00,0,0,0,FMN GV 05 Lier
60,Mechelsesteenweg 365,2023-03-12,04:00:00,0,0,0,FMN GV 05 Lier
60,Mechelsesteenweg 365,2023-03-12,05:00:00,0,0,0,FMN GV 05 Lier
60,Mechelsesteenweg 365,2023-03-12,06:00:00,2,0,2,FMN GV 05 Lier
60,Mechelsesteenweg 365,2023-03-12,07:00:00,6,6,0,FMN GV 05 Lier
60,Mechelsesteenweg 365,2023-03-12,08:00:00,28,8,20,FMN GV 05 Lier
60,Mechelsesteenweg 365,2023-03-12,09:00:00,64,22,42,FMN GV 05 Lier
60,Mechelsesteenweg 365,2023-03-12,10:00:00,94,38,56,FMN GV 05 Lier
60,Mechelsesteenweg 365,2023-03-12,11:00:00,116,52,64,FMN GV 05 Lier
60,Mechelsesteenweg 365,2023-03-12,12:00:00,80,38,42,FMN GV 05 Lier
60,Mechelsesteenweg 365,2023-03-12,13:00:00,86,48,38,FMN GV 05 Lier
60,Mechelsesteenweg 365,2023-03-12,14:00:00,126,68,58,FMN GV 05 Lier
60,Mechelsesteenweg 365,2023-03-12,15:00:00,52,28,24,FMN GV 05 Lier
60,Mechelsesteenweg 365,2023-03-12,16:00:00,78,32,46,FMN GV 05 Lier
60,Mechelsesteenweg 365,2023-03-12,17:00:00,28,16,12,FMN GV 05 Lier
60,Mechelsesteenweg 365,2023-03-12,18:00:00,10,4,6,FMN GV 05 Lier
60,Mechelsesteenweg 365,2023-03-12,19:00:00,4,2,2,FMN GV 05 Lier
60,Mechelsesteenweg 365,2023-03-12,20:00:00,2,0,2,FMN GV 05 Lier
60,Mechelsesteenweg 365,2023-03-12,21:00:00,0,0,0,FMN GV 05 Lier
60,Mechelsesteenweg 365,2023-03-12,22:00:00,0,0,0,FMN GV 05 Lier
60,Mechelsesteenweg 365,2023-03-12,23:00:00,0,0,0,FMN GV 05 Lier
60,Mechelsesteenweg 365,2023-03-13,00:00:00,0,0,0,FMN GV 05 Lier
60,Mechelsesteenweg 365,2023-03-13,01:00:00,0,0,0,FMN GV 05 Lier
60,Mechelsesteenweg 365,2023-03-13,02:00:00,0,0,0,FMN GV 05 Lier
60,Mechelsesteenweg 365,2023-03-13,03:00:00,0,0,0,FMN GV 05 Lier
60,Mechelsesteenweg 365,2023-03-13,04:00:00,2,0,2,FMN GV 05 Lier
60,Mechelsesteenweg 365,2023-03-13,05:00:00,2,0,2,FMN GV 05 Lier
60,Mechelsesteenweg 365,2023-03-13,06:00:00,16,6,10,FMN GV 05 Lier
60,Mechelsesteenweg 365,2023-03-13,07:00:00,82,34,48,FMN GV 05 Lier
60,Mechelsesteenweg 365,2023-03-13,08:00:00,104,62,42,FMN GV 05 Lier
60,Mechelsesteenweg 365,2023-03-13,09:00:00,28,14,14,FMN GV 05 Lier
60,Mechelsesteenweg 365,2023-03-13,10:00:00,14,8,6,FMN GV 05 Lier
60,Mechelsesteenweg 365,2023-03-13,11:00:00,32,22,10,FMN GV 05 Lier
60,Mechelsesteenweg 365,2023-03-13,12:00:00,16,12,4,FMN GV 05 Lier
60,Mechelsesteenweg 365,2023-03-13,13:00:00,38,22,16,FMN GV 05 Lier
60,Mechelsesteenweg 365,2023-03-13,14:00:00,72,38,34,FMN GV 05 Lier
60,Mechelsesteenweg 365,2023-03-13,15:00:00,86,48,38,FMN GV 05 Lier
60,Mechelsesteenweg 365,2023-03-13,16:00:00,176,60,116,FMN GV 05 Lier
60,Mechelsesteenweg 365,2023-03-13,17:00:00,94,60,34,FMN GV 05 Lier
60,Mechelsesteenweg 365,2023-03-13,18:00:00,62,30,32,FMN GV 05 Lier
60,Mechelsesteenweg 365,2023-03-13,19:00:00,14,8,6,FMN GV 05 Lier
60,Mechelsesteenweg 365,2023-03-13,20:00:00,8,6,2,FMN GV 05 Lier
60,Mechelsesteenweg 365,2023-03-13,21:00:00,14,8,6,FMN GV 05 Lier
60,Mechelsesteenweg 365,2023-03-13,22:00:00,6,4,2,FMN GV 05 Lier
60,Mechelsesteenweg 365,2023-03-13,23:00:00,0,0,0,FMN GV 05 Lier
60,Mechelsesteenweg 365,2023-03-14,00:00:00,0,0,0,FMN GV 05 Lier
60,Mechelsesteenweg 365,2023-03-14,01:00:00,0,0,0,FMN GV 05 Lier
60,Mechelsesteenweg 365,2023-03-14,02:00:00,0,0,0,FMN GV 05 Lier
60,Mechelsesteenweg 365,2023-03-14,03:00:00,0,0,0,FMN GV 05 Lier
60,Mechelsesteenweg 365,2023-03-14,04:00:00,2,0,2,FMN GV 05 Lier
60,Mechelsesteenweg 365,2023-03-14,05:00:00,2,0,2,FMN GV 05 Lier
60,Mechelsesteenweg 365,2023-03-14,06:00:00,20,4,16,FMN GV 05 Lier
60,Mechelsesteenweg 365,2023-03-14,07:00:00,56,28,28,FMN GV 05 Lier
60,Mechelsesteenweg 365,2023-03-14,08:00:00,70,44,26,FMN GV 05 Lier
60,Mechelsesteenweg 365,2023-03-14,09:00:00,30,12,18,FMN GV 05 Lier
60,Mechelsesteenweg 365,2023-03-14,10:00:00,10,2,8,FMN GV 05 Lier
60,Mechelsesteenweg 365,2023-03-14,11:00:00,10,4,6,FMN GV 05 Lier
60,Mechelsesteenweg 365,2023-03-14,12:00:00,18,10,8,FMN GV 05 Lier
60,Mechelsesteenweg 365,2023-03-14,13:00:00,24,6,18,FMN GV 05 Lier
60,Mechelsesteenweg 365,2023-03-14,14:00:00,26,12,14,FMN GV 05 Lier
60,Mechelsesteenweg 365,2023-03-14,15:00:00,38,18,20,FMN GV 05 Lier
60,Mechelsesteenweg 365,2023-03-14,16:00:00,106,38,68,FMN GV 05 Lier
60,Mechelsesteenweg 365,2023-03-14,17:00:00,66,28,38,FMN GV 05 Lier
60,Mechelsesteenweg 365,2023-03-14,18:00:00,20,12,8,FMN GV 05 Lier
60,Mechelsesteenweg 365,2023-03-14,19:00:00,14,6,8,FMN GV 05 Lier
60,Mechelsesteenweg 365,2023-03-14,20:00:00,2,2,0,FMN GV 05 Lier
60,Mechelsesteenweg 365,2023-03-14,21:00:00,4,2,2,FMN GV 05 Lier
60,Mechelsesteenweg 365,2023-03-14,22:00:00,6,6,0,FMN GV 05 Lier
60,Mechelsesteenweg 365,2023-03-14,23:00:00,0,0,0,FMN GV 05 Lier
60,Mechelsesteenweg 365,2023-03-15,00:00:00,0,0,0,FMN GV 05 Lier
60,Mechelsesteenweg 365,2023-03-15,01:00:00,0,0,0,FMN GV 05 Lier
60,Mechelsesteenweg 365,2023-03-15,02:00:00,0,0,0,FMN GV 05 Lier
60,Mechelsesteenweg 365,2023-03-15,03:00:00,0,0,0,FMN GV 05 Lier
60,Mechelsesteenweg 365,2023-03-15,04:00:00,0,0,0,FMN GV 05 Lier
60,Mechelsesteenweg 365,2023-03-15,05:00:00,0,0,0,FMN GV 05 Lier
60,Mechelsesteenweg 365,2023-03-15,06:00:00,18,4,14,FMN GV 05 Lier
60,Mechelsesteenweg 365,2023-03-15,07:00:00,70,34,36,FMN GV 05 Lier
60,Mechelsesteenweg 365,2023-03-15,08:00:00,92,54,38,FMN GV 05 Lier
60,Mechelsesteenweg 365,2023-03-15,09:00:00,60,24,36,FMN GV 05 Lier
60,Mechelsesteenweg 365,2023-03-15,10:00:00,56,44,12,FMN GV 05 Lier
60,Mechelsesteenweg 365,2023-03-15,11:00:00,44,16,28,FMN GV 05 Lier
60,Mechelsesteenweg 365,2023-03-15,12:00:00,140,44,96,FMN GV 05 Lier
60,Mechelsesteenweg 365,2023-03-15,13:00:00,118,46,72,FMN GV 05 Lier
60,Mechelsesteenweg 365,2023-03-15,14:00:00,192,96,96,FMN GV 05 Lier
60,Mechelsesteenweg 365,2023-03-15,15:00:00,182,116,66,FMN GV 05 Lier
60,Mechelsesteenweg 365,2023-03-15,16:00:00,122,62,60,FMN GV 05 Lier
60,Mechelsesteenweg 365,2023-03-15,17:00:00,122,86,36,FMN GV 05 Lier
60,Mechelsesteenweg 365,2023-03-15,18:00:00,72,46,26,FMN GV 05 Lier
60,Mechelsesteenweg 365,2023-03-15,19:00:00,20,12,8,FMN GV 05 Lier
60,Mechelsesteenweg 365,2023-03-15,20:00:00,8,8,0,FMN GV 05 Lier
60,Mechelsesteenweg 365,2023-03-15,21:00:00,10,8,2,FMN GV 05 Lier
60,Mechelsesteenweg 365,2023-03-15,22:00:00,10,4,6,FMN GV 05 Lier
60,Mechelsesteenweg 365,2023-03-15,23:00:00,0,0,0,FMN GV 05 Lier
60,Mechelsesteenweg 365,2023-03-16,00:00:00,0,0,0,FMN GV 05 Lier
60,Mechelsesteenweg 365,2023-03-16,01:00:00,0,0,0,FMN GV 05 Lier
60,Mechelsesteenweg 365,2023-03-16,02:00:00,0,0,0,FMN GV 05 Lier
60,Mechelsesteenweg 365,2023-03-16,03:00:00,0,0,0,FMN GV 05 Lier
60,Mechelsesteenweg 365,2023-03-16,04:00:00,0,0,0,FMN GV 05 Lier
60,Mechelsesteenweg 365,2023-03-16,05:00:00,2,0,2,FMN GV 05 Lier
60,Mechelsesteenweg 365,2023-03-16,06:00:00,24,8,16,FMN GV 05 Lier
60,Mechelsesteenweg 365,2023-03-16,07:00:00,66,30,36,FMN GV 05 Lier
60,Mechelsesteenweg 365,2023-03-16,08:00:00,130,74,56,FMN GV 05 Lier
60,Mechelsesteenweg 365,2023-03-16,09:00:00,54,24,30,FMN GV 05 Lier
60,Mechelsesteenweg 365,2023-03-16,10:00:00,32,22,10,FMN GV 05 Lier
60,Mechelsesteenweg 365,2023-03-16,11:00:00,70,38,32,FMN GV 05 Lier
60,Mechelsesteenweg 365,2023-03-16,12:00:00,54,24,30,FMN GV 05 Lier
60,Mechelsesteenweg 365,2023-03-16,13:00:00,126,62,64,FMN GV 05 Lier
60,Mechelsesteenweg 365,2023-03-16,14:00:00,190,98,92,FMN GV 05 Lier
60,Mechelsesteenweg 365,2023-03-16,15:00:00,188,108,80,FMN GV 05 Lier
60,Mechelsesteenweg 365,2023-03-16,16:00:00,216,86,130,FMN GV 05 Lier
60,Mechelsesteenweg 365,2023-03-16,17:00:00,156,82,74,FMN GV 05 Lier
60,Mechelsesteenweg 365,2023-03-16,18:00:00,70,52,18,FMN GV 05 Lier
60,Mechelsesteenweg 365,2023-03-16,19:00:00,38,16,22,FMN GV 05 Lier
60,Mechelsesteenweg 365,2023-03-16,20:00:00,14,2,12,FMN GV 05 Lier
60,Mechelsesteenweg 365,2023-03-16,21:00:00,8,4,4,FMN GV 05 Lier
60,Mechelsesteenweg 365,2023-03-16,22:00:00,8,4,4,FMN GV 05 Lier
60,Mechelsesteenweg 365,2023-03-16,23:00:00,2,0,2,FMN GV 05 Lier
60,Mechelsesteenweg 365,2023-03-17,00:00:00,0,0,0,FMN GV 05 Lier
60,Mechelsesteenweg 365,2023-03-17,01:00:00,0,0,0,FMN GV 05 Lier
60,Mechelsesteenweg 365,2023-03-17,02:00:00,0,0,0,FMN GV 05 Lier
60,Mechelsesteenweg 365,2023-03-17,03:00:00,0,0,0,FMN GV 05 Lier
60,Mechelsesteenweg 365,2023-03-17,04:00:00,0,0,0,FMN GV 05 Lier
60,Mechelsesteenweg 365,2023-03-17,05:00:00,8,4,4,FMN GV 05 Lier
60,Mechelsesteenweg 365,2023-03-17,06:00:00,26,4,22,FMN GV 05 Lier
60,Mechelsesteenweg 365,2023-03-17,07:00:00,118,54,64,FMN GV 05 Lier
60,Mechelsesteenweg 365,2023-03-17,08:00:00,108,58,50,FMN GV 05 Lier
60,Mechelsesteenweg 365,2023-03-17,09:00:00,78,32,46,FMN GV 05 Lier
60,Mechelsesteenweg 365,2023-03-17,10:00:00,60,34,26,FMN GV 05 Lier
60,Mechelsesteenweg 365,2023-03-17,11:00:00,80,38,42,FMN GV 05 Lier
60,Mechelsesteenweg 365,2023-03-17,12:00:00,118,62,56,FMN GV 05 Lier
60,Mechelsesteenweg 365,2023-03-17,13:00:00,158,92,66,FMN GV 05 Lier
60,Mechelsesteenweg 365,2023-03-17,14:00:00,248,154,94,FMN GV 05 Lier
60,Mechelsesteenweg 365,2023-03-17,15:00:00,204,92,112,FMN GV 05 Lier
60,Mechelsesteenweg 365,2023-03-17,16:00:00,278,118,160,FMN GV 05 Lier
60,Mechelsesteenweg 365,2023-03-17,17:00:00,132,86,46,FMN GV 05 Lier
60,Mechelsesteenweg 365,2023-03-17,18:00:00,80,44,36,FMN GV 05 Lier
60,Mechelsesteenweg 365,2023-03-17,19:00:00,24,14,10,FMN GV 05 Lier
60,Mechelsesteenweg 365,2023-03-17,20:00:00,12,8,4,FMN GV 05 Lier
60,Mechelsesteenweg 365,2023-03-17,21:00:00,6,0,6,FMN GV 05 Lier
60,Mechelsesteenweg 365,2023-03-17,22:00:00,6,4,2,FMN GV 05 Lier
60,Mechelsesteenweg 365,2023-03-17,23:00:00,2,2,0,FMN GV 05 Lier
60,Mechelsesteenweg 365,2023-03-18,00:00:00,4,0,4,FMN GV 05 Lier
60,Mechelsesteenweg 365,2023-03-18,01:00:00,4,0,4,FMN GV 05 Lier
60,Mechelsesteenweg 365,2023-03-18,02:00:00,0,0,0,FMN GV 05 Lier
60,Mechelsesteenweg 365,2023-03-18,03:00:00,4,2,2,FMN GV 05 Lier
60,Mechelsesteenweg 365,2023-03-18,04:00:00,0,0,0,FMN GV 05 Lier
60,Mechelsesteenweg 365,2023-03-18,05:00:00,0,0,0,FMN GV 05 Lier
60,Mechelsesteenweg 365,2023-03-18,06:00:00,6,2,4,FMN GV 05 Lier
60,Mechelsesteenweg 365,2023-03-18,07:00:00,10,6,4,FMN GV 05 Lier
60,Mechelsesteenweg 365,2023-03-18,08:00:00,44,14,30,FMN GV 05 Lier
60,Mechelsesteenweg 365,2023-03-18,09:00:00,142,74,68,FMN GV 05 Lier
60,Mechelsesteenweg 365,2023-03-18,10:00:00,202,80,122,FMN GV 05 Lier
60,Mechelsesteenweg 365,2023-03-18,11:00:00,276,138,138,FMN GV 05 Lier
60,Mechelsesteenweg 365,2023-03-18,12:00:00,126,54,72,FMN GV 05 Lier
60,Mechelsesteenweg 365,2023-03-18,13:00:00,140,66,74,FMN GV 05 Lier
60,Mechelsesteenweg 365,2023-03-18,14:00:00,178,112,66,FMN GV 05 Lier
60,Mechelsesteenweg 365,2023-03-18,15:00:00,152,90,62,FMN GV 05 Lier
60,Mechelsesteenweg 365,2023-03-18,16:00:00,102,44,58,FMN GV 05 Lier
60,Mechelsesteenweg 365,2023-03-18,17:00:00,92,40,52,FMN GV 05 Lier
60,Mechelsesteenweg 365,2023-03-18,18:00:00,54,32,22,FMN GV 05 Lier
60,Mechelsesteenweg 365,2023-03-18,19:00:00,2,0,2,FMN GV 05 Lier
60,Mechelsesteenweg 365,2023-03-18,20:00:00,14,8,6,FMN GV 05 Lier
60,Mechelsesteenweg 365,2023-03-18,21:00:00,6,2,4,FMN GV 05 Lier
60,Mechelsesteenweg 365,2023-03-18,22:00:00,2,2,0,FMN GV 05 Lier
60,Mechelsesteenweg 365,2023-03-18,23:00:00,2,0,2,FMN GV 05 Lier
60,Mechelsesteenweg 365,2023-03-19,00:00:00,2,0,2,FMN GV 05 Lier
60,Mechelsesteenweg 365,2023-03-19,01:00:00,2,2,0,FMN GV 05 Lier
60,Mechelsesteenweg 365,2023-03-19,02:00:00,2,0,2,FMN GV 05 Lier
60,Mechelsesteenweg 365,2023-03-19,03:00:00,4,0,4,FMN GV 05 Lier
60,Mechelsesteenweg 365,2023-03-19,04:00:00,0,0,0,FMN GV 05 Lier
60,Mechelsesteenweg 365,2023-03-19,05:00:00,2,2,0,FMN GV 05 Lier
60,Mechelsesteenweg 365,2023-03-19,06:00:00,8,4,4,FMN GV 05 Lier
60,Mechelsesteenweg 365,2023-03-19,07:00:00,4,4,0,FMN GV 05 Lier
60,Mechelsesteenweg 365,2023-03-19,08:00:00,42,22,20,FMN GV 05 Lier
60,Mechelsesteenweg 365,2023-03-19,09:00:00,162,92,70,FMN GV 05 Lier
60,Mechelsesteenweg 365,2023-03-19,10:00:00,292,172,120,FMN GV 05 Lier
60,Mechelsesteenweg 365,2023-03-19,11:00:00,270,144,126,FMN GV 05 Lier
60,Mechelsesteenweg 365,2023-03-19,12:00:00,130,74,56,FMN GV 05 Lier
60,Mechelsesteenweg 365,2023-03-19,13:00:00,186,104,82,FMN GV 05 Lier
60,Mechelsesteenweg 365,2023-03-19,14:00:00,182,106,76,FMN GV 05 Lier
60,Mechelsesteenweg 365,2023-03-19,15:00:00,164,64,100,FMN GV 05 Lier
60,Mechelsesteenweg 365,2023-03-19,16:00:00,104,40,64,FMN GV 05 Lier
60,Mechelsesteenweg 365,2023-03-19,17:00:00,62,30,32,FMN GV 05 Lier
60,Mechelsesteenweg 365,2023-03-19,18:00:00,24,12,12,FMN GV 05 Lier
60,Mechelsesteenweg 365,2023-03-19,19:00:00,14,2,12,FMN GV 05 Lier
60,Mechelsesteenweg 365,2023-03-19,20:00:00,6,2,4,FMN GV 05 Lier
60,Mechelsesteenweg 365,2023-03-19,21:00:00,0,0,0,FMN GV 05 Lier
60,Mechelsesteenweg 365,2023-03-19,22:00:00,0,0,0,FMN GV 05 Lier
60,Mechelsesteenweg 365,2023-03-19,23:00:00,0,0,0,FMN GV 05 Lier
60,Mechelsesteenweg 365,2023-03-20,00:00:00,0,0,0,FMN GV 05 Lier
60,Mechelsesteenweg 365,2023-03-20,01:00:00,0,0,0,FMN GV 05 Lier
60,Mechelsesteenweg 365,2023-03-20,02:00:00,0,0,0,FMN GV 05 Lier
60,Mechelsesteenweg 365,2023-03-20,03:00:00,0,0,0,FMN GV 05 Lier
60,Mechelsesteenweg 365,2023-03-20,04:00:00,0,0,0,FMN GV 05 Lier
60,Mechelsesteenweg 365,2023-03-20,05:00:00,6,4,2,FMN GV 05 Lier
60,Mechelsesteenweg 365,2023-03-20,06:00:00,20,6,14,FMN GV 05 Lier
60,Mechelsesteenweg 365,2023-03-20,07:00:00,126,54,72,FMN GV 05 Lier
60,Mechelsesteenweg 365,2023-03-20,08:00:00,118,56,62,FMN GV 05 Lier
60,Mechelsesteenweg 365,2023-03-20,09:00:00,28,10,18,FMN GV 05 Lier
60,Mechelsesteenweg 365,2023-03-20,10:00:00,28,16,12,FMN GV 05 Lier
60,Mechelsesteenweg 365,2023-03-20,11:00:00,40,16,24,FMN GV 05 Lier
60,Mechelsesteenweg 365,2023-03-20,12:00:00,74,22,52,FMN GV 05 Lier
60,Mechelsesteenweg 365,2023-03-20,13:00:00,68,28,40,FMN GV 05 Lier
60,Mechelsesteenweg 365,2023-03-20,14:00:00,76,46,30,FMN GV 05 Lier
60,Mechelsesteenweg 365,2023-03-20,15:00:00,84,38,46,FMN GV 05 Lier
60,Mechelsesteenweg 365,2023-03-20,16:00:00,158,68,90,FMN GV 05 Lier
60,Mechelsesteenweg 365,2023-03-20,17:00:00,102,66,36,FMN GV 05 Lier
60,Mechelsesteenweg 365,2023-03-20,18:00:00,54,30,24,FMN GV 05 Lier
60,Mechelsesteenweg 365,2023-03-20,19:00:00,2,0,2,FMN GV 05 Lier
60,Mechelsesteenweg 365,2023-03-20,20:00:00,10,8,2,FMN GV 05 Lier
60,Mechelsesteenweg 365,2023-03-20,21:00:00,2,0,2,FMN GV 05 Lier
60,Mechelsesteenweg 365,2023-03-20,22:00:00,4,4,0,FMN GV 05 Lier
60,Mechelsesteenweg 365,2023-03-20,23:00:00,0,0,0,FMN GV 05 Lier
60,Mechelsesteenweg 365,2023-03-21,00:00:00,0,0,0,FMN GV 05 Lier
60,Mechelsesteenweg 365,2023-03-21,01:00:00,0,0,0,FMN GV 05 Lier
60,Mechelsesteenweg 365,2023-03-21,02:00:00,0,0,0,FMN GV 05 Lier
60,Mechelsesteenweg 365,2023-03-21,03:00:00,0,0,0,FMN GV 05 Lier
60,Mechelsesteenweg 365,2023-03-21,04:00:00,0,0,0,FMN GV 05 Lier
60,Mechelsesteenweg 365,2023-03-21,05:00:00,8,2,6,FMN GV 05 Lier
60,Mechelsesteenweg 365,2023-03-21,06:00:00,22,4,18,FMN GV 05 Lier
60,Mechelsesteenweg 365,2023-03-21,07:00:00,104,48,56,FMN GV 05 Lier
60,Mechelsesteenweg 365,2023-03-21,08:00:00,106,64,42,FMN GV 05 Lier
60,Mechelsesteenweg 365,2023-03-21,09:00:00,34,18,16,FMN GV 05 Lier
60,Mechelsesteenweg 365,2023-03-21,10:00:00,46,20,26,FMN GV 05 Lier
60,Mechelsesteenweg 365,2023-03-21,11:00:00,60,22,38,FMN GV 05 Lier
60,Mechelsesteenweg 365,2023-03-21,12:00:00,142,28,114,FMN GV 05 Lier
60,Mechelsesteenweg 365,2023-03-21,13:00:00,60,32,28,FMN GV 05 Lier
60,Mechelsesteenweg 365,2023-03-21,14:00:00,100,56,44,FMN GV 05 Lier
60,Mechelsesteenweg 365,2023-03-21,15:00:00,116,62,54,FMN GV 05 Lier
60,Mechelsesteenweg 365,2023-03-21,16:00:00,162,74,88,FMN GV 05 Lier
60,Mechelsesteenweg 365,2023-03-21,17:00:00,80,54,26,FMN GV 05 Lier
60,Mechelsesteenweg 365,2023-03-21,18:00:00,54,38,16,FMN GV 05 Lier
60,Mechelsesteenweg 365,2023-03-21,19:00:00,22,12,10,FMN GV 05 Lier
60,Mechelsesteenweg 365,2023-03-21,20:00:00,8,0,8,FMN GV 05 Lier
60,Mechelsesteenweg 365,2023-03-21,21:00:00,4,2,2,FMN GV 05 Lier
60,Mechelsesteenweg 365,2023-03-21,22:00:00,6,6,0,FMN GV 05 Lier
60,Mechelsesteenweg 365,2023-03-21,23:00:00,4,0,4,FMN GV 05 Lier
60,Mechelsesteenweg 365,2023-03-22,00:00:00,0,0,0,FMN GV 05 Lier
60,Mechelsesteenweg 365,2023-03-22,01:00:00,0,0,0,FMN GV 05 Lier
60,Mechelsesteenweg 365,2023-03-22,02:00:00,2,2,0,FMN GV 05 Lier
60,Mechelsesteenweg 365,2023-03-22,03:00:00,0,0,0,FMN GV 05 Lier
60,Mechelsesteenweg 365,2023-03-22,04:00:00,0,0,0,FMN GV 05 Lier
60,Mechelsesteenweg 365,2023-03-22,05:00:00,4,2,2,FMN GV 05 Lier
60,Mechelsesteenweg 365,2023-03-22,06:00:00,18,2,16,FMN GV 05 Lier
60,Mechelsesteenweg 365,2023-03-22,07:00:00,100,46,54,FMN GV 05 Lier
60,Mechelsesteenweg 365,2023-03-22,08:00:00,72,38,34,FMN GV 05 Lier
60,Mechelsesteenweg 365,2023-03-22,09:00:00,28,14,14,FMN GV 05 Lier
60,Mechelsesteenweg 365,2023-03-22,10:00:00,38,12,26,FMN GV 05 Lier
60,Mechelsesteenweg 365,2023-03-22,11:00:00,24,12,12,FMN GV 05 Lier
60,Mechelsesteenweg 365,2023-03-22,12:00:00,80,20,60,FMN GV 05 Lier
60,Mechelsesteenweg 365,2023-03-22,13:00:00,46,16,30,FMN GV 05 Lier
60,Mechelsesteenweg 365,2023-03-22,14:00:00,54,34,20,FMN GV 05 Lier
60,Mechelsesteenweg 365,2023-03-22,15:00:00,40,26,14,FMN GV 05 Lier
60,Mechelsesteenweg 365,2023-03-22,16:00:00,56,40,16,FMN GV 05 Lier
60,Mechelsesteenweg 365,2023-03-22,17:00:00,46,24,22,FMN GV 05 Lier
60,Mechelsesteenweg 365,2023-03-22,18:00:00,38,20,18,FMN GV 05 Lier
60,Mechelsesteenweg 365,2023-03-22,19:00:00,10,6,4,FMN GV 05 Lier
60,Mechelsesteenweg 365,2023-03-22,20:00:00,4,2,2,FMN GV 05 Lier
60,Mechelsesteenweg 365,2023-03-22,21:00:00,0,0,0,FMN GV 05 Lier
60,Mechelsesteenweg 365,2023-03-22,22:00:00,8,4,4,FMN GV 05 Lier
60,Mechelsesteenweg 365,2023-03-22,23:00:00,4,2,2,FMN GV 05 Lier
60,Mechelsesteenweg 365,2023-03-23,00:00:00,0,0,0,FMN GV 05 Lier
60,Mechelsesteenweg 365,2023-03-23,01:00:00,0,0,0,FMN GV 05 Lier
60,Mechelsesteenweg 365,2023-03-23,02:00:00,0,0,0,FMN GV 05 Lier
60,Mechelsesteenweg 365,2023-03-23,03:00:00,0,0,0,FMN GV 05 Lier
60,Mechelsesteenweg 365,2023-03-23,04:00:00,0,0,0,FMN GV 05 Lier
60,Mechelsesteenweg 365,2023-03-23,05:00:00,2,2,0,FMN GV 05 Lier
60,Mechelsesteenweg 365,2023-03-23,06:00:00,18,4,14,FMN GV 05 Lier
60,Mechelsesteenweg 365,2023-03-23,07:00:00,76,38,38,FMN GV 05 Lier
60,Mechelsesteenweg 365,2023-03-23,08:00:00,86,50,36,FMN GV 05 Lier
60,Mechelsesteenweg 365,2023-03-23,09:00:00,26,10,16,FMN GV 05 Lier
60,Mechelsesteenweg 365,2023-03-23,10:00:00,56,20,36,FMN GV 05 Lier
60,Mechelsesteenweg 365,2023-03-23,11:00:00,38,16,22,FMN GV 05 Lier
60,Mechelsesteenweg 365,2023-03-23,12:00:00,78,40,38,FMN GV 05 Lier
60,Mechelsesteenweg 365,2023-03-23,13:00:00,52,30,22,FMN GV 05 Lier
60,Mechelsesteenweg 365,2023-03-23,14:00:00,72,38,34,FMN GV 05 Lier
60,Mechelsesteenweg 365,2023-03-23,15:00:00,98,50,48,FMN GV 05 Lier
60,Mechelsesteenweg 365,2023-03-23,16:00:00,86,36,50,FMN GV 05 Lier
60,Mechelsesteenweg 365,2023-03-23,17:00:00,80,48,32,FMN GV 05 Lier
60,Mechelsesteenweg 365,2023-03-23,18:00:00,32,18,14,FMN GV 05 Lier
60,Mechelsesteenweg 365,2023-03-23,19:00:00,18,10,8,FMN GV 05 Lier
60,Mechelsesteenweg 365,2023-03-23,20:00:00,6,4,2,FMN GV 05 Lier
60,Mechelsesteenweg 365,2023-03-23,21:00:00,4,2,2,FMN GV 05 Lier
60,Mechelsesteenweg 365,2023-03-23,22:00:00,4,0,4,FMN GV 05 Lier
60,Mechelsesteenweg 365,2023-03-23,23:00:00,2,2,0,FMN GV 05 Lier
60,Mechelsesteenweg 365,2023-03-24,00:00:00,0,0,0,FMN GV 05 Lier
60,Mechelsesteenweg 365,2023-03-24,01:00:00,0,0,0,FMN GV 05 Lier
60,Mechelsesteenweg 365,2023-03-24,02:00:00,0,0,0,FMN GV 05 Lier
60,Mechelsesteenweg 365,2023-03-24,03:00:00,0,0,0,FMN GV 05 Lier
60,Mechelsesteenweg 365,2023-03-24,04:00:00,0,0,0,FMN GV 05 Lier
60,Mechelsesteenweg 365,2023-03-24,05:00:00,6,2,4,FMN GV 05 Lier
60,Mechelsesteenweg 365,2023-03-24,06:00:00,20,6,14,FMN GV 05 Lier
60,Mechelsesteenweg 365,2023-03-24,07:00:00,88,46,42,FMN GV 05 Lier
60,Mechelsesteenweg 365,2023-03-24,08:00:00,82,46,36,FMN GV 05 Lier
60,Mechelsesteenweg 365,2023-03-24,09:00:00,46,18,28,FMN GV 05 Lier
60,Mechelsesteenweg 365,2023-03-24,10:00:00,98,38,60,FMN GV 05 Lier
60,Mechelsesteenweg 365,2023-03-24,11:00:00,78,44,34,FMN GV 05 Lier
60,Mechelsesteenweg 365,2023-03-24,12:00:00,36,14,22,FMN GV 05 Lier
60,Mechelsesteenweg 365,2023-03-24,13:00:00,32,14,18,FMN GV 05 Lier
60,Mechelsesteenweg 365,2023-03-24,14:00:00,42,20,22,FMN GV 05 Lier
60,Mechelsesteenweg 365,2023-03-24,15:00:00,66,34,32,FMN GV 05 Lier
60,Mechelsesteenweg 365,2023-03-24,16:00:00,70,40,30,FMN GV 05 Lier
60,Mechelsesteenweg 365,2023-03-24,17:00:00,66,34,32,FMN GV 05 Lier
60,Mechelsesteenweg 365,2023-03-24,18:00:00,10,4,6,FMN GV 05 Lier
60,Mechelsesteenweg 365,2023-03-24,19:00:00,12,10,2,FMN GV 05 Lier
60,Mechelsesteenweg 365,2023-03-24,20:00:00,6,4,2,FMN GV 05 Lier
60,Mechelsesteenweg 365,2023-03-24,21:00:00,4,0,4,FMN GV 05 Lier
60,Mechelsesteenweg 365,2023-03-24,22:00:00,2,2,0,FMN GV 05 Lier
60,Mechelsesteenweg 365,2023-03-24,23:00:00,0,0,0,FMN GV 05 Lier
60,Mechelsesteenweg 365,2023-03-25,00:00:00,6,2,4,FMN GV 05 Lier
60,Mechelsesteenweg 365,2023-03-25,01:00:00,2,2,0,FMN GV 05 Lier
60,Mechelsesteenweg 365,2023-03-25,02:00:00,0,0,0,FMN GV 05 Lier
60,Mechelsesteenweg 365,2023-03-25,03:00:00,0,0,0,FMN GV 05 Lier
60,Mechelsesteenweg 365,2023-03-25,04:00:00,0,0,0,FMN GV 05 Lier
60,Mechelsesteenweg 365,2023-03-25,05:00:00,2,2,0,FMN GV 05 Lier
60,Mechelsesteenweg 365,2023-03-25,06:00:00,2,0,2,FMN GV 05 Lier
60,Mechelsesteenweg 365,2023-03-25,07:00:00,10,4,6,FMN GV 05 Lier
60,Mechelsesteenweg 365,2023-03-25,08:00:00,28,12,16,FMN GV 05 Lier
60,Mechelsesteenweg 365,2023-03-25,09:00:00,56,34,22,FMN GV 05 Lier
60,Mechelsesteenweg 365,2023-03-25,10:00:00,80,56,24,FMN GV 05 Lier
60,Mechelsesteenweg 365,2023-03-25,11:00:00,90,38,52,FMN GV 05 Lier
60,Mechelsesteenweg 365,2023-03-25,12:00:00,62,20,42,FMN GV 05 Lier
60,Mechelsesteenweg 365,2023-03-25,13:00:00,24,10,14,FMN GV 05 Lier
60,Mechelsesteenweg 365,2023-03-25,14:00:00,86,28,58,FMN GV 05 Lier
60,Mechelsesteenweg 365,2023-03-25,15:00:00,50,12,38,FMN GV 05 Lier
60,Mechelsesteenweg 365,2023-03-25,16:00:00,40,8,32,FMN GV 05 Lier
60,Mechelsesteenweg 365,2023-03-25,17:00:00,14,8,6,FMN GV 05 Lier
60,Mechelsesteenweg 365,2023-03-25,18:00:00,18,12,6,FMN GV 05 Lier
60,Mechelsesteenweg 365,2023-03-25,19:00:00,12,4,8,FMN GV 05 Lier
60,Mechelsesteenweg 365,2023-03-25,20:00:00,0,0,0,FMN GV 05 Lier
60,Mechelsesteenweg 365,2023-03-25,21:00:00,4,2,2,FMN GV 05 Lier
60,Mechelsesteenweg 365,2023-03-25,22:00:00,2,2,0,FMN GV 05 Lier
60,Mechelsesteenweg 365,2023-03-25,23:00:00,2,0,2,FMN GV 05 Lier
60,Mechelsesteenweg 365,2023-03-26,00:00:00,2,2,0,FMN GV 05 Lier
60,Mechelsesteenweg 365,2023-03-26,01:00:00,0,0,0,FMN GV 05 Lier
60,Mechelsesteenweg 365,2023-03-26,02:00:00,0,0,0,FMN GV 05 Lier
60,Mechelsesteenweg 365,2023-03-26,03:00:00,0,0,0,FMN GV 05 Lier
60,Mechelsesteenweg 365,2023-03-26,04:00:00,2,2,0,FMN GV 05 Lier
60,Mechelsesteenweg 365,2023-03-26,05:00:00,2,2,0,FMN GV 05 Lier
60,Mechelsesteenweg 365,2023-03-26,06:00:00,0,0,0,FMN GV 05 Lier
60,Mechelsesteenweg 365,2023-03-26,07:00:00,2,0,2,FMN GV 05 Lier
60,Mechelsesteenweg 365,2023-03-26,08:00:00,0,0,0,FMN GV 05 Lier
60,Mechelsesteenweg 365,2023-03-26,09:00:00,8,8,0,FMN GV 05 Lier
60,Mechelsesteenweg 365,2023-03-26,10:00:00,48,16,32,FMN GV 05 Lier
60,Mechelsesteenweg 365,2023-03-26,11:00:00,48,42,6,FMN GV 05 Lier
60,Mechelsesteenweg 365,2023-03-26,12:00:00,10,2,8,FMN GV 05 Lier
60,Mechelsesteenweg 365,2023-03-26,13:00:00,18,4,14,FMN GV 05 Lier
60,Mechelsesteenweg 365,2023-03-26,14:00:00,10,4,6,FMN GV 05 Lier
60,Mechelsesteenweg 365,2023-03-26,15:00:00,20,10,10,FMN GV 05 Lier
60,Mechelsesteenweg 365,2023-03-26,16:00:00,10,6,4,FMN GV 05 Lier
60,Mechelsesteenweg 365,2023-03-26,17:00:00,10,6,4,FMN GV 05 Lier
60,Mechelsesteenweg 365,2023-03-26,18:00:00,18,14,4,FMN GV 05 Lier
60,Mechelsesteenweg 365,2023-03-26,19:00:00,12,0,12,FMN GV 05 Lier
60,Mechelsesteenweg 365,2023-03-26,20:00:00,4,0,4,FMN GV 05 Lier
60,Mechelsesteenweg 365,2023-03-26,21:00:00,8,4,4,FMN GV 05 Lier
60,Mechelsesteenweg 365,2023-03-26,22:00:00,0,0,0,FMN GV 05 Lier
60,Mechelsesteenweg 365,2023-03-26,23:00:00,0,0,0,FMN GV 05 Lier
60,Mechelsesteenweg 365,2023-03-27,00:00:00,0,0,0,FMN GV 05 Lier
60,Mechelsesteenweg 365,2023-03-27,01:00:00,0,0,0,FMN GV 05 Lier
60,Mechelsesteenweg 365,2023-03-27,02:00:00,0,0,0,FMN GV 05 Lier
60,Mechelsesteenweg 365,2023-03-27,03:00:00,0,0,0,FMN GV 05 Lier
60,Mechelsesteenweg 365,2023-03-27,04:00:00,0,0,0,FMN GV 05 Lier
60,Mechelsesteenweg 365,2023-03-27,05:00:00,4,0,4,FMN GV 05 Lier
60,Mechelsesteenweg 365,2023-03-27,06:00:00,10,2,8,FMN GV 05 Lier
60,Mechelsesteenweg 365,2023-03-27,07:00:00,74,42,32,FMN GV 05 Lier
60,Mechelsesteenweg 365,2023-03-27,08:00:00,92,48,44,FMN GV 05 Lier
60,Mechelsesteenweg 365,2023-03-27,09:00:00,34,12,22,FMN GV 05 Lier
60,Mechelsesteenweg 365,2023-03-27,10:00:00,64,32,32,FMN GV 05 Lier
60,Mechelsesteenweg 365,2023-03-27,11:00:00,52,16,36,FMN GV 05 Lier
60,Mechelsesteenweg 365,2023-03-27,12:00:00,60,26,34,FMN GV 05 Lier
60,Mechelsesteenweg 365,2023-03-27,13:00:00,66,42,24,FMN GV 05 Lier
60,Mechelsesteenweg 365,2023-03-27,14:00:00,72,32,40,FMN GV 05 Lier
60,Mechelsesteenweg 365,2023-03-27,15:00:00,80,44,36,FMN GV 05 Lier
60,Mechelsesteenweg 365,2023-03-27,16:00:00,134,64,70,FMN GV 05 Lier
60,Mechelsesteenweg 365,2023-03-27,17:00:00,118,70,48,FMN GV 05 Lier
60,Mechelsesteenweg 365,2023-03-27,18:00:00,66,30,36,FMN GV 05 Lier
60,Mechelsesteenweg 365,2023-03-27,19:00:00,38,18,20,FMN GV 05 Lier
60,Mechelsesteenweg 365,2023-03-27,20:00:00,22,12,10,FMN GV 05 Lier
60,Mechelsesteenweg 365,2023-03-27,21:00:00,8,2,6,FMN GV 05 Lier
60,Mechelsesteenweg 365,2023-03-27,22:00:00,6,4,2,FMN GV 05 Lier
60,Mechelsesteenweg 365,2023-03-27,23:00:00,0,0,0,FMN GV 05 Lier
60,Mechelsesteenweg 365,2023-03-28,00:00:00,0,0,0,FMN GV 05 Lier
60,Mechelsesteenweg 365,2023-03-28,01:00:00,0,0,0,FMN GV 05 Lier
60,Mechelsesteenweg 365,2023-03-28,02:00:00,0,0,0,FMN GV 05 Lier
60,Mechelsesteenweg 365,2023-03-28,03:00:00,2,0,2,FMN GV 05 Lier
60,Mechelsesteenweg 365,2023-03-28,04:00:00,0,0,0,FMN GV 05 Lier
60,Mechelsesteenweg 365,2023-03-28,05:00:00,6,2,4,FMN GV 05 Lier
60,Mechelsesteenweg 365,2023-03-28,06:00:00,14,2,12,FMN GV 05 Lier
60,Mechelsesteenweg 365,2023-03-28,07:00:00,50,20,30,FMN GV 05 Lier
60,Mechelsesteenweg 365,2023-03-28,08:00:00,68,24,44,FMN GV 05 Lier
60,Mechelsesteenweg 365,2023-03-28,09:00:00,36,14,22,FMN GV 05 Lier
60,Mechelsesteenweg 365,2023-03-28,10:00:00,80,42,38,FMN GV 05 Lier
60,Mechelsesteenweg 365,2023-03-28,11:00:00,88,46,42,FMN GV 05 Lier
60,Mechelsesteenweg 365,2023-03-28,12:00:00,74,32,42,FMN GV 05 Lier
60,Mechelsesteenweg 365,2023-03-28,13:00:00,134,74,60,FMN GV 05 Lier
60,Mechelsesteenweg 365,2023-03-28,14:00:00,136,58,78,FMN GV 05 Lier
60,Mechelsesteenweg 365,2023-03-28,15:00:00,118,64,54,FMN GV 05 Lier
60,Mechelsesteenweg 365,2023-03-28,16:00:00,126,78,48,FMN GV 05 Lier
60,Mechelsesteenweg 365,2023-03-28,17:00:00,118,78,40,FMN GV 05 Lier
60,Mechelsesteenweg 365,2023-03-28,18:00:00,38,12,26,FMN GV 05 Lier
60,Mechelsesteenweg 365,2023-03-28,19:00:00,76,46,30,FMN GV 05 Lier
60,Mechelsesteenweg 365,2023-03-28,20:00:00,8,6,2,FMN GV 05 Lier
60,Mechelsesteenweg 365,2023-03-28,21:00:00,0,0,0,FMN GV 05 Lier
60,Mechelsesteenweg 365,2023-03-28,22:00:00,14,10,4,FMN GV 05 Lier
60,Mechelsesteenweg 365,2023-03-28,23:00:00,2,2,0,FMN GV 05 Lier
60,Mechelsesteenweg 365,2023-03-29,00:00:00,2,0,2,FMN GV 05 Lier
60,Mechelsesteenweg 365,2023-03-29,01:00:00,0,0,0,FMN GV 05 Lier
60,Mechelsesteenweg 365,2023-03-29,02:00:00,0,0,0,FMN GV 05 Lier
60,Mechelsesteenweg 365,2023-03-29,03:00:00,4,0,4,FMN GV 05 Lier
60,Mechelsesteenweg 365,2023-03-29,04:00:00,0,0,0,FMN GV 05 Lier
60,Mechelsesteenweg 365,2023-03-29,05:00:00,0,0,0,FMN GV 05 Lier
60,Mechelsesteenweg 365,2023-03-29,06:00:00,14,0,14,FMN GV 05 Lier
60,Mechelsesteenweg 365,2023-03-29,07:00:00,64,18,46,FMN GV 05 Lier
60,Mechelsesteenweg 365,2023-03-29,08:00:00,70,38,32,FMN GV 05 Lier
60,Mechelsesteenweg 365,2023-03-29,09:00:00,42,22,20,FMN GV 05 Lier
60,Mechelsesteenweg 365,2023-03-29,10:00:00,46,18,28,FMN GV 05 Lier
60,Mechelsesteenweg 365,2023-03-29,11:00:00,72,28,44,FMN GV 05 Lier
60,Mechelsesteenweg 365,2023-03-29,12:00:00,76,32,44,FMN GV 05 Lier
60,Mechelsesteenweg 365,2023-03-29,13:00:00,118,48,70,FMN GV 05 Lier
60,Mechelsesteenweg 365,2023-03-29,14:00:00,132,76,56,FMN GV 05 Lier
60,Mechelsesteenweg 365,2023-03-29,15:00:00,180,106,74,FMN GV 05 Lier
60,Mechelsesteenweg 365,2023-03-29,16:00:00,158,82,76,FMN GV 05 Lier
60,Mechelsesteenweg 365,2023-03-29,17:00:00,118,84,34,FMN GV 05 Lier
60,Mechelsesteenweg 365,2023-03-29,18:00:00,120,64,56,FMN GV 05 Lier
60,Mechelsesteenweg 365,2023-03-29,19:00:00,78,54,24,FMN GV 05 Lier
60,Mechelsesteenweg 365,2023-03-29,20:00:00,62,46,16,FMN GV 05 Lier
60,Mechelsesteenweg 365,2023-03-29,21:00:00,14,4,10,FMN GV 05 Lier
60,Mechelsesteenweg 365,2023-03-29,22:00:00,8,4,4,FMN GV 05 Lier
60,Mechelsesteenweg 365,2023-03-29,23:00:00,4,2,2,FMN GV 05 Lier
60,Mechelsesteenweg 365,2023-03-30,00:00:00,6,2,4,FMN GV 05 Lier
60,Mechelsesteenweg 365,2023-03-30,01:00:00,2,2,0,FMN GV 05 Lier
60,Mechelsesteenweg 365,2023-03-30,02:00:00,0,0,0,FMN GV 05 Lier
60,Mechelsesteenweg 365,2023-03-30,03:00:00,0,0,0,FMN GV 05 Lier
60,Mechelsesteenweg 365,2023-03-30,04:00:00,2,0,2,FMN GV 05 Lier
60,Mechelsesteenweg 365,2023-03-30,05:00:00,4,0,4,FMN GV 05 Lier
60,Mechelsesteenweg 365,2023-03-30,06:00:00,14,0,14,FMN GV 05 Lier
60,Mechelsesteenweg 365,2023-03-30,07:00:00,46,20,26,FMN GV 05 Lier
60,Mechelsesteenweg 365,2023-03-30,08:00:00,94,48,46,FMN GV 05 Lier
60,Mechelsesteenweg 365,2023-03-30,09:00:00,32,16,16,FMN GV 05 Lier
60,Mechelsesteenweg 365,2023-03-30,10:00:00,68,50,18,FMN GV 05 Lier
60,Mechelsesteenweg 365,2023-03-30,11:00:00,32,10,22,FMN GV 05 Lier
60,Mechelsesteenweg 365,2023-03-30,12:00:00,66,26,40,FMN GV 05 Lier
60,Mechelsesteenweg 365,2023-03-30,13:00:00,56,36,20,FMN GV 05 Lier
60,Mechelsesteenweg 365,2023-03-30,14:00:00,72,40,32,FMN GV 05 Lier
60,Mechelsesteenweg 365,2023-03-30,15:00:00,56,30,26,FMN GV 05 Lier
60,Mechelsesteenweg 365,2023-03-30,16:00:00,94,66,28,FMN GV 05 Lier
60,Mechelsesteenweg 365,2023-03-30,17:00:00,96,58,38,FMN GV 05 Lier
60,Mechelsesteenweg 365,2023-03-30,18:00:00,40,20,20,FMN GV 05 Lier
60,Mechelsesteenweg 365,2023-03-30,19:00:00,32,22,10,FMN GV 05 Lier
60,Mechelsesteenweg 365,2023-03-30,20:00:00,30,20,10,FMN GV 05 Lier
60,Mechelsesteenweg 365,2023-03-30,21:00:00,4,2,2,FMN GV 05 Lier
60,Mechelsesteenweg 365,2023-03-30,22:00:00,10,8,2,FMN GV 05 Lier
60,Mechelsesteenweg 365,2023-03-30,23:00:00,2,0,2,FMN GV 05 Lier
60,Mechelsesteenweg 365,2023-03-31,00:00:00,6,0,6,FMN GV 05 Lier
60,Mechelsesteenweg 365,2023-03-31,01:00:00,2,0,2,FMN GV 05 Lier
60,Mechelsesteenweg 365,2023-03-31,02:00:00,0,0,0,FMN GV 05 Lier
60,Mechelsesteenweg 365,2023-03-31,03:00:00,0,0,0,FMN GV 05 Lier
60,Mechelsesteenweg 365,2023-03-31,04:00:00,0,0,0,FMN GV 05 Lier
60,Mechelsesteenweg 365,2023-03-31,05:00:00,0,0,0,FMN GV 05 Lier
60,Mechelsesteenweg 365,2023-03-31,06:00:00,12,0,12,FMN GV 05 Lier
60,Mechelsesteenweg 365,2023-03-31,07:00:00,34,14,20,FMN GV 05 Lier
60,Mechelsesteenweg 365,2023-03-31,08:00:00,42,20,22,FMN GV 05 Lier
60,Mechelsesteenweg 365,2023-03-31,09:00:00,52,42,10,FMN GV 05 Lier
60,Mechelsesteenweg 365,2023-03-31,10:00:00,14,2,12,FMN GV 05 Lier
60,Mechelsesteenweg 365,2023-03-31,11:00:00,20,12,8,FMN GV 05 Lier
60,Mechelsesteenweg 365,2023-03-31,12:00:00,40,10,30,FMN GV 05 Lier
60,Mechelsesteenweg 365,2023-03-31,13:00:00,22,10,12,FMN GV 05 Lier
60,Mechelsesteenweg 365,2023-03-31,14:00:00,18,10,8,FMN GV 05 Lier
60,Mechelsesteenweg 365,2023-03-31,15:00:00,22,14,8,FMN GV 05 Lier
60,Mechelsesteenweg 365,2023-03-31,16:00:00,20,8,12,FMN GV 05 Lier
60,Mechelsesteenweg 365,2023-03-31,17:00:00,34,24,10,FMN GV 05 Lier
60,Mechelsesteenweg 365,2023-03-31,18:00:00,6,0,6,FMN GV 05 Lier
60,Mechelsesteenweg 365,2023-03-31,19:00:00,4,0,4,FMN GV 05 Lier
60,Mechelsesteenweg 365,2023-03-31,20:00:00,4,2,2,FMN GV 05 Lier
60,Mechelsesteenweg 365,2023-03-31,21:00:00,0,0,0,FMN GV 05 Lier
60,Mechelsesteenweg 365,2023-03-31,22:00:00,2,2,0,FMN GV 05 Lier
60,Mechelsesteenweg 365,2023-03-31,23:00:00,2,2,0,FMN GV 05 Lier
60,Mechelsesteenweg 365,2023-04-01,00:00:00,2,0,2,FMN GV 05 Lier
60,Mechelsesteenweg 365,2023-04-01,01:00:00,0,0,0,FMN GV 05 Lier
60,Mechelsesteenweg 365,2023-04-01,02:00:00,0,0,0,FMN GV 05 Lier
60,Mechelsesteenweg 365,2023-04-01,03:00:00,0,0,0,FMN GV 05 Lier
60,Mechelsesteenweg 365,2023-04-01,04:00:00,0,0,0,FMN GV 05 Lier
60,Mechelsesteenweg 365,2023-04-01,05:00:00,2,0,2,FMN GV 05 Lier
60,Mechelsesteenweg 365,2023-04-01,06:00:00,4,2,2,FMN GV 05 Lier
60,Mechelsesteenweg 365,2023-04-01,07:00:00,2,2,0,FMN GV 05 Lier
60,Mechelsesteenweg 365,2023-04-01,08:00:00,2,0,2,FMN GV 05 Lier
60,Mechelsesteenweg 365,2023-04-01,09:00:00,6,6,0,FMN GV 05 Lier
60,Mechelsesteenweg 365,2023-04-01,10:00:00,8,2,6,FMN GV 05 Lier
60,Mechelsesteenweg 365,2023-04-01,11:00:00,20,8,12,FMN GV 05 Lier
60,Mechelsesteenweg 365,2023-04-01,12:00:00,8,2,6,FMN GV 05 Lier
60,Mechelsesteenweg 365,2023-04-01,13:00:00,16,4,12,FMN GV 05 Lier
60,Mechelsesteenweg 365,2023-04-01,14:00:00,12,8,4,FMN GV 05 Lier
60,Mechelsesteenweg 365,2023-04-01,15:00:00,12,4,8,FMN GV 05 Lier
60,Mechelsesteenweg 365,2023-04-01,16:00:00,22,12,10,FMN GV 05 Lier
60,Mechelsesteenweg 365,2023-04-01,17:00:00,10,6,4,FMN GV 05 Lier
60,Mechelsesteenweg 365,2023-04-01,18:00:00,4,2,2,FMN GV 05 Lier
60,Mechelsesteenweg 365,2023-04-01,19:00:00,4,2,2,FMN GV 05 Lier
60,Mechelsesteenweg 365,2023-04-01,20:00:00,6,6,0,FMN GV 05 Lier
60,Mechelsesteenweg 365,2023-04-01,21:00:00,6,6,0,FMN GV 05 Lier
60,Mechelsesteenweg 365,2023-04-01,22:00:00,4,0,4,FMN GV 05 Lier
60,Mechelsesteenweg 365,2023-04-01,23:00:00,4,0,4,FMN GV 05 Lier
60,Mechelsesteenweg 365,2023-04-02,00:00:00,4,0,4,FMN GV 05 Lier
60,Mechelsesteenweg 365,2023-04-02,01:00:00,2,0,2,FMN GV 05 Lier
60,Mechelsesteenweg 365,2023-04-02,02:00:00,0,0,0,FMN GV 05 Lier
60,Mechelsesteenweg 365,2023-04-02,03:00:00,0,0,0,FMN GV 05 Lier
60,Mechelsesteenweg 365,2023-04-02,04:00:00,0,0,0,FMN GV 05 Lier
60,Mechelsesteenweg 365,2023-04-02,05:00:00,0,0,0,FMN GV 05 Lier
60,Mechelsesteenweg 365,2023-04-02,06:00:00,4,2,2,FMN GV 05 Lier
60,Mechelsesteenweg 365,2023-04-02,07:00:00,10,4,6,FMN GV 05 Lier
60,Mechelsesteenweg 365,2023-04-02,08:00:00,26,16,10,FMN GV 05 Lier
60,Mechelsesteenweg 365,2023-04-02,09:00:00,180,104,76,FMN GV 05 Lier
60,Mechelsesteenweg 365,2023-04-02,10:00:00,286,140,146,FMN GV 05 Lier
60,Mechelsesteenweg 365,2023-04-02,11:00:00,252,102,150,FMN GV 05 Lier
60,Mechelsesteenweg 365,2023-04-02,12:00:00,140,60,80,FMN GV 05 Lier
60,Mechelsesteenweg 365,2023-04-02,13:00:00,120,64,56,FMN GV 05 Lier
60,Mechelsesteenweg 365,2023-04-02,14:00:00,76,32,44,FMN GV 05 Lier
60,Mechelsesteenweg 365,2023-04-02,15:00:00,58,26,32,FMN GV 05 Lier
60,Mechelsesteenweg 365,2023-04-02,16:00:00,60,22,38,FMN GV 05 Lier
60,Mechelsesteenweg 365,2023-04-02,17:00:00,56,26,30,FMN GV 05 Lier
60,Mechelsesteenweg 365,2023-04-02,18:00:00,38,16,22,FMN GV 05 Lier
60,Mechelsesteenweg 365,2023-04-02,19:00:00,22,8,14,FMN GV 05 Lier
60,Mechelsesteenweg 365,2023-04-02,20:00:00,4,2,2,FMN GV 05 Lier
60,Mechelsesteenweg 365,2023-04-02,21:00:00,6,4,2,FMN GV 05 Lier
60,Mechelsesteenweg 365,2023-04-02,22:00:00,4,4,0,FMN GV 05 Lier
60,Mechelsesteenweg 365,2023-04-02,23:00:00,2,0,2,FMN GV 05 Lier
60,Mechelsesteenweg 365,2023-04-03,00:00:00,0,0,0,FMN GV 05 Lier
60,Mechelsesteenweg 365,2023-04-03,01:00:00,0,0,0,FMN GV 05 Lier
60,Mechelsesteenweg 365,2023-04-03,02:00:00,0,0,0,FMN GV 05 Lier
60,Mechelsesteenweg 365,2023-04-03,03:00:00,0,0,0,FMN GV 05 Lier
60,Mechelsesteenweg 365,2023-04-03,04:00:00,2,0,2,FMN GV 05 Lier
60,Mechelsesteenweg 365,2023-04-03,05:00:00,0,0,0,FMN GV 05 Lier
60,Mechelsesteenweg 365,2023-04-03,06:00:00,22,10,12,FMN GV 05 Lier
60,Mechelsesteenweg 365,2023-04-03,07:00:00,40,8,32,FMN GV 05 Lier
60,Mechelsesteenweg 365,2023-04-03,08:00:00,56,26,30,FMN GV 05 Lier
60,Mechelsesteenweg 365,2023-04-03,09:00:00,42,18,24,FMN GV 05 Lier
60,Mechelsesteenweg 365,2023-04-03,10:00:00,80,34,46,FMN GV 05 Lier
60,Mechelsesteenweg 365,2023-04-03,11:00:00,92,28,64,FMN GV 05 Lier
60,Mechelsesteenweg 365,2023-04-03,12:00:00,88,44,44,FMN GV 05 Lier
60,Mechelsesteenweg 365,2023-04-03,13:00:00,112,46,66,FMN GV 05 Lier
60,Mechelsesteenweg 365,2023-04-03,14:00:00,198,92,106,FMN GV 05 Lier
60,Mechelsesteenweg 365,2023-04-03,15:00:00,200,88,112,FMN GV 05 Lier
60,Mechelsesteenweg 365,2023-04-03,16:00:00,174,86,88,FMN GV 05 Lier
60,Mechelsesteenweg 365,2023-04-03,17:00:00,128,62,66,FMN GV 05 Lier
60,Mechelsesteenweg 365,2023-04-03,18:00:00,72,50,22,FMN GV 05 Lier
60,Mechelsesteenweg 365,2023-04-03,19:00:00,72,30,42,FMN GV 05 Lier
60,Mechelsesteenweg 365,2023-04-03,20:00:00,36,22,14,FMN GV 05 Lier
60,Mechelsesteenweg 365,2023-04-03,21:00:00,10,4,6,FMN GV 05 Lier
60,Mechelsesteenweg 365,2023-04-03,22:00:00,2,0,2,FMN GV 05 Lier
60,Mechelsesteenweg 365,2023-04-03,23:00:00,2,0,2,FMN GV 05 Lier
60,Mechelsesteenweg 365,2023-04-04,00:00:00,0,0,0,FMN GV 05 Lier
60,Mechelsesteenweg 365,2023-04-04,01:00:00,0,0,0,FMN GV 05 Lier
60,Mechelsesteenweg 365,2023-04-04,02:00:00,0,0,0,FMN GV 05 Lier
60,Mechelsesteenweg 365,2023-04-04,03:00:00,0,0,0,FMN GV 05 Lier
60,Mechelsesteenweg 365,2023-04-04,04:00:00,2,0,2,FMN GV 05 Lier
60,Mechelsesteenweg 365,2023-04-04,05:00:00,6,2,4,FMN GV 05 Lier
60,Mechelsesteenweg 365,2023-04-04,06:00:00,18,8,10,FMN GV 05 Lier
60,Mechelsesteenweg 365,2023-04-04,07:00:00,46,12,34,FMN GV 05 Lier
60,Mechelsesteenweg 365,2023-04-04,08:00:00,50,14,36,FMN GV 05 Lier
60,Mechelsesteenweg 365,2023-04-04,09:00:00,52,30,22,FMN GV 05 Lier
60,Mechelsesteenweg 365,2023-04-04,10:00:00,108,54,54,FMN GV 05 Lier
60,Mechelsesteenweg 365,2023-04-04,11:00:00,86,48,38,FMN GV 05 Lier
60,Mechelsesteenweg 365,2023-04-04,12:00:00,96,46,50,FMN GV 05 Lier
60,Mechelsesteenweg 365,2023-04-04,13:00:00,156,68,88,FMN GV 05 Lier
60,Mechelsesteenweg 365,2023-04-04,14:00:00,236,122,114,FMN GV 05 Lier
60,Mechelsesteenweg 365,2023-04-04,15:00:00,216,98,118,FMN GV 05 Lier
60,Mechelsesteenweg 365,2023-04-04,16:00:00,158,76,82,FMN GV 05 Lier
60,Mechelsesteenweg 365,2023-04-04,17:00:00,182,106,76,FMN GV 05 Lier
60,Mechelsesteenweg 365,2023-04-04,18:00:00,124,80,44,FMN GV 05 Lier
60,Mechelsesteenweg 365,2023-04-04,19:00:00,84,40,44,FMN GV 05 Lier
60,Mechelsesteenweg 365,2023-04-04,20:00:00,46,16,30,FMN GV 05 Lier
60,Mechelsesteenweg 365,2023-04-04,21:00:00,12,4,8,FMN GV 05 Lier
60,Mechelsesteenweg 365,2023-04-04,22:00:00,8,4,4,FMN GV 05 Lier
60,Mechelsesteenweg 365,2023-04-04,23:00:00,0,0,0,FMN GV 05 Lier
60,Mechelsesteenweg 365,2023-04-05,00:00:00,0,0,0,FMN GV 05 Lier
60,Mechelsesteenweg 365,2023-04-05,01:00:00,0,0,0,FMN GV 05 Lier
60,Mechelsesteenweg 365,2023-04-05,02:00:00,0,0,0,FMN GV 05 Lier
60,Mechelsesteenweg 365,2023-04-05,03:00:00,0,0,0,FMN GV 05 Lier
60,Mechelsesteenweg 365,2023-04-05,04:00:00,2,0,2,FMN GV 05 Lier
60,Mechelsesteenweg 365,2023-04-05,05:00:00,4,0,4,FMN GV 05 Lier
60,Mechelsesteenweg 365,2023-04-05,06:00:00,20,6,14,FMN GV 05 Lier
60,Mechelsesteenweg 365,2023-04-05,07:00:00,26,6,20,FMN GV 05 Lier
60,Mechelsesteenweg 365,2023-04-05,08:00:00,46,18,28,FMN GV 05 Lier
60,Mechelsesteenweg 365,2023-04-05,09:00:00,42,24,18,FMN GV 05 Lier
60,Mechelsesteenweg 365,2023-04-05,10:00:00,80,44,36,FMN GV 05 Lier
60,Mechelsesteenweg 365,2023-04-05,11:00:00,84,36,48,FMN GV 05 Lier
60,Mechelsesteenweg 365,2023-04-05,12:00:00,88,44,44,FMN GV 05 Lier
60,Mechelsesteenweg 365,2023-04-05,13:00:00,166,80,86,FMN GV 05 Lier
60,Mechelsesteenweg 365,2023-04-05,14:00:00,300,156,144,FMN GV 05 Lier
60,Mechelsesteenweg 365,2023-04-05,15:00:00,280,142,138,FMN GV 05 Lier
60,Mechelsesteenweg 365,2023-04-05,16:00:00,232,128,104,FMN GV 05 Lier
60,Mechelsesteenweg 365,2023-04-05,17:00:00,212,128,84,FMN GV 05 Lier
60,Mechelsesteenweg 365,2023-04-05,18:00:00,168,74,94,FMN GV 05 Lier
60,Mechelsesteenweg 365,2023-04-05,19:00:00,128,54,74,FMN GV 05 Lier
60,Mechelsesteenweg 365,2023-04-05,20:00:00,76,66,10,FMN GV 05 Lier
60,Mechelsesteenweg 365,2023-04-05,21:00:00,12,2,10,FMN GV 05 Lier
60,Mechelsesteenweg 365,2023-04-05,22:00:00,8,6,2,FMN GV 05 Lier
60,Mechelsesteenweg 365,2023-04-05,23:00:00,6,0,6,FMN GV 05 Lier
60,Mechelsesteenweg 365,2023-04-06,00:00:00,0,0,0,FMN GV 05 Lier
60,Mechelsesteenweg 365,2023-04-06,01:00:00,0,0,0,FMN GV 05 Lier
60,Mechelsesteenweg 365,2023-04-06,02:00:00,0,0,0,FMN GV 05 Lier
60,Mechelsesteenweg 365,2023-04-06,03:00:00,0,0,0,FMN GV 05 Lier
60,Mechelsesteenweg 365,2023-04-06,04:00:00,0,0,0,FMN GV 05 Lier
60,Mechelsesteenweg 365,2023-04-06,05:00:00,2,0,2,FMN GV 05 Lier
60,Mechelsesteenweg 365,2023-04-06,06:00:00,22,4,18,FMN GV 05 Lier
60,Mechelsesteenweg 365,2023-04-06,07:00:00,32,4,28,FMN GV 05 Lier
60,Mechelsesteenweg 365,2023-04-06,08:00:00,32,12,20,FMN GV 05 Lier
60,Mechelsesteenweg 365,2023-04-06,09:00:00,12,4,8,FMN GV 05 Lier
60,Mechelsesteenweg 365,2023-04-06,10:00:00,10,4,6,FMN GV 05 Lier
60,Mechelsesteenweg 365,2023-04-06,11:00:00,16,8,8,FMN GV 05 Lier
60,Mechelsesteenweg 365,2023-04-06,12:00:00,12,0,12,FMN GV 05 Lier
60,Mechelsesteenweg 365,2023-04-06,13:00:00,8,4,4,FMN GV 05 Lier
60,Mechelsesteenweg 365,2023-04-06,14:00:00,18,18,0,FMN GV 05 Lier
60,Mechelsesteenweg 365,2023-04-06,15:00:00,16,10,6,FMN GV 05 Lier
60,Mechelsesteenweg 365,2023-04-06,16:00:00,42,28,14,FMN GV 05 Lier
60,Mechelsesteenweg 365,2023-04-06,17:00:00,44,26,18,FMN GV 05 Lier
60,Mechelsesteenweg 365,2023-04-06,18:00:00,16,10,6,FMN GV 05 Lier
60,Mechelsesteenweg 365,2023-04-06,19:00:00,16,10,6,FMN GV 05 Lier
60,Mechelsesteenweg 365,2023-04-06,20:00:00,8,4,4,FMN GV 05 Lier
60,Mechelsesteenweg 365,2023-04-06,21:00:00,2,2,0,FMN GV 05 Lier
60,Mechelsesteenweg 365,2023-04-06,22:00:00,2,0,2,FMN GV 05 Lier
60,Mechelsesteenweg 365,2023-04-06,23:00:00,2,2,0,FMN GV 05 Lier
60,Mechelsesteenweg 365,2023-04-07,00:00:00,0,0,0,FMN GV 05 Lier
60,Mechelsesteenweg 365,2023-04-07,01:00:00,0,0,0,FMN GV 05 Lier
60,Mechelsesteenweg 365,2023-04-07,02:00:00,0,0,0,FMN GV 05 Lier
60,Mechelsesteenweg 365,2023-04-07,03:00:00,2,0,2,FMN GV 05 Lier
60,Mechelsesteenweg 365,2023-04-07,04:00:00,0,0,0,FMN GV 05 Lier
60,Mechelsesteenweg 365,2023-04-07,05:00:00,0,0,0,FMN GV 05 Lier
60,Mechelsesteenweg 365,2023-04-07,06:00:00,20,4,16,FMN GV 05 Lier
60,Mechelsesteenweg 365,2023-04-07,07:00:00,40,16,24,FMN GV 05 Lier
60,Mechelsesteenweg 365,2023-04-07,08:00:00,32,12,20,FMN GV 05 Lier
60,Mechelsesteenweg 365,2023-04-07,09:00:00,34,18,16,FMN GV 05 Lier
60,Mechelsesteenweg 365,2023-04-07,10:00:00,46,18,28,FMN GV 05 Lier
60,Mechelsesteenweg 365,2023-04-07,11:00:00,60,38,22,FMN GV 05 Lier
60,Mechelsesteenweg 365,2023-04-07,12:00:00,68,18,50,FMN GV 05 Lier
60,Mechelsesteenweg 365,2023-04-07,13:00:00,96,32,64,FMN GV 05 Lier
60,Mechelsesteenweg 365,2023-04-07,14:00:00,88,36,52,FMN GV 05 Lier
60,Mechelsesteenweg 365,2023-04-07,15:00:00,96,66,30,FMN GV 05 Lier
60,Mechelsesteenweg 365,2023-04-07,16:00:00,118,52,66,FMN GV 05 Lier
60,Mechelsesteenweg 365,2023-04-07,17:00:00,74,46,28,FMN GV 05 Lier
60,Mechelsesteenweg 365,2023-04-07,18:00:00,42,28,14,FMN GV 05 Lier
60,Mechelsesteenweg 365,2023-04-07,19:00:00,22,14,8,FMN GV 05 Lier
60,Mechelsesteenweg 365,2023-04-07,20:00:00,8,6,2,FMN GV 05 Lier
60,Mechelsesteenweg 365,2023-04-07,21:00:00,6,6,0,FMN GV 05 Lier
60,Mechelsesteenweg 365,2023-04-07,22:00:00,2,2,0,FMN GV 05 Lier
60,Mechelsesteenweg 365,2023-04-07,23:00:00,0,0,0,FMN GV 05 Lier
60,Mechelsesteenweg 365,2023-04-08,00:00:00,2,2,0,FMN GV 05 Lier
60,Mechelsesteenweg 365,2023-04-08,01:00:00,4,0,4,FMN GV 05 Lier
60,Mechelsesteenweg 365,2023-04-08,02:00:00,6,0,6,FMN GV 05 Lier
60,Mechelsesteenweg 365,2023-04-08,03:00:00,0,0,0,FMN GV 05 Lier
60,Mechelsesteenweg 365,2023-04-08,04:00:00,2,0,2,FMN GV 05 Lier
60,Mechelsesteenweg 365,2023-04-08,05:00:00,0,0,0,FMN GV 05 Lier
60,Mechelsesteenweg 365,2023-04-08,06:00:00,2,0,2,FMN GV 05 Lier
60,Mechelsesteenweg 365,2023-04-08,07:00:00,12,8,4,FMN GV 05 Lier
60,Mechelsesteenweg 365,2023-04-08,08:00:00,20,8,12,FMN GV 05 Lier
60,Mechelsesteenweg 365,2023-04-08,09:00:00,86,48,38,FMN GV 05 Lier
60,Mechelsesteenweg 365,2023-04-08,10:00:00,134,74,60,FMN GV 05 Lier
60,Mechelsesteenweg 365,2023-04-08,11:00:00,144,64,80,FMN GV 05 Lier
60,Mechelsesteenweg 365,2023-04-08,12:00:00,102,56,46,FMN GV 05 Lier
60,Mechelsesteenweg 365,2023-04-08,13:00:00,162,98,64,FMN GV 05 Lier
60,Mechelsesteenweg 365,2023-04-08,14:00:00,250,108,142,FMN GV 05 Lier
60,Mechelsesteenweg 365,2023-04-08,15:00:00,338,198,140,FMN GV 05 Lier
60,Mechelsesteenweg 365,2023-04-08,16:00:00,166,58,108,FMN GV 05 Lier
60,Mechelsesteenweg 365,2023-04-08,17:00:00,128,56,72,FMN GV 05 Lier
60,Mechelsesteenweg 365,2023-04-08,18:00:00,50,24,26,FMN GV 05 Lier
60,Mechelsesteenweg 365,2023-04-08,19:00:00,22,8,14,FMN GV 05 Lier
60,Mechelsesteenweg 365,2023-04-08,20:00:00,18,8,10,FMN GV 05 Lier
60,Mechelsesteenweg 365,2023-04-08,21:00:00,8,2,6,FMN GV 05 Lier
60,Mechelsesteenweg 365,2023-04-08,22:00:00,0,0,0,FMN GV 05 Lier
60,Mechelsesteenweg 365,2023-04-08,23:00:00,8,0,8,FMN GV 05 Lier
60,Mechelsesteenweg 365,2023-04-09,00:00:00,0,0,0,FMN GV 05 Lier
60,Mechelsesteenweg 365,2023-04-09,01:00:00,2,0,2,FMN GV 05 Lier
60,Mechelsesteenweg 365,2023-04-09,02:00:00,0,0,0,FMN GV 05 Lier
60,Mechelsesteenweg 365,2023-04-09,03:00:00,0,0,0,FMN GV 05 Lier
60,Mechelsesteenweg 365,2023-04-09,04:00:00,0,0,0,FMN GV 05 Lier
60,Mechelsesteenweg 365,2023-04-09,05:00:00,0,0,0,FMN GV 05 Lier
60,Mechelsesteenweg 365,2023-04-09,06:00:00,6,4,2,FMN GV 05 Lier
60,Mechelsesteenweg 365,2023-04-09,07:00:00,8,0,8,FMN GV 05 Lier
60,Mechelsesteenweg 365,2023-04-09,08:00:00,42,12,30,FMN GV 05 Lier
60,Mechelsesteenweg 365,2023-04-09,09:00:00,166,90,76,FMN GV 05 Lier
60,Mechelsesteenweg 365,2023-04-09,10:00:00,308,146,162,FMN GV 05 Lier
60,Mechelsesteenweg 365,2023-04-09,11:00:00,386,202,184,FMN GV 05 Lier
60,Mechelsesteenweg 365,2023-04-09,12:00:00,310,136,174,FMN GV 05 Lier
60,Mechelsesteenweg 365,2023-04-09,13:00:00,328,174,154,FMN GV 05 Lier
60,Mechelsesteenweg 365,2023-04-09,14:00:00,358,180,178,FMN GV 05 Lier
60,Mechelsesteenweg 365,2023-04-09,15:00:00,296,148,148,FMN GV 05 Lier
60,Mechelsesteenweg 365,2023-04-09,16:00:00,214,70,144,FMN GV 05 Lier
60,Mechelsesteenweg 365,2023-04-09,17:00:00,116,42,74,FMN GV 05 Lier
60,Mechelsesteenweg 365,2023-04-09,18:00:00,102,44,58,FMN GV 05 Lier
60,Mechelsesteenweg 365,2023-04-09,19:00:00,34,14,20,FMN GV 05 Lier
60,Mechelsesteenweg 365,2023-04-09,20:00:00,24,12,12,FMN GV 05 Lier
60,Mechelsesteenweg 365,2023-04-09,21:00:00,10,4,6,FMN GV 05 Lier
60,Mechelsesteenweg 365,2023-04-09,22:00:00,2,0,2,FMN GV 05 Lier
60,Mechelsesteenweg 365,2023-04-09,23:00:00,0,0,0,FMN GV 05 Lier
60,Mechelsesteenweg 365,2023-04-10,00:00:00,0,0,0,FMN GV 05 Lier
60,Mechelsesteenweg 365,2023-04-10,01:00:00,0,0,0,FMN GV 05 Lier
60,Mechelsesteenweg 365,2023-04-10,02:00:00,0,0,0,FMN GV 05 Lier
60,Mechelsesteenweg 365,2023-04-10,03:00:00,0,0,0,FMN GV 05 Lier
60,Mechelsesteenweg 365,2023-04-10,04:00:00,0,0,0,FMN GV 05 Lier
60,Mechelsesteenweg 365,2023-04-10,05:00:00,0,0,0,FMN GV 05 Lier
60,Mechelsesteenweg 365,2023-04-10,06:00:00,4,2,2,FMN GV 05 Lier
60,Mechelsesteenweg 365,2023-04-10,07:00:00,10,6,4,FMN GV 05 Lier
60,Mechelsesteenweg 365,2023-04-10,08:00:00,50,16,34,FMN GV 05 Lier
60,Mechelsesteenweg 365,2023-04-10,09:00:00,138,54,84,FMN GV 05 Lier
60,Mechelsesteenweg 365,2023-04-10,10:00:00,244,134,110,FMN GV 05 Lier
60,Mechelsesteenweg 365,2023-04-10,11:00:00,268,140,128,FMN GV 05 Lier
60,Mechelsesteenweg 365,2023-04-10,12:00:00,184,74,110,FMN GV 05 Lier
60,Mechelsesteenweg 365,2023-04-10,13:00:00,124,64,60,FMN GV 05 Lier
60,Mechelsesteenweg 365,2023-04-10,14:00:00,96,40,56,FMN GV 05 Lier
60,Mechelsesteenweg 365,2023-04-10,15:00:00,44,18,26,FMN GV 05 Lier
60,Mechelsesteenweg 365,2023-04-10,16:00:00,24,10,14,FMN GV 05 Lier
60,Mechelsesteenweg 365,2023-04-10,17:00:00,10,0,10,FMN GV 05 Lier
60,Mechelsesteenweg 365,2023-04-10,18:00:00,10,4,6,FMN GV 05 Lier
60,Mechelsesteenweg 365,2023-04-10,19:00:00,2,0,2,FMN GV 05 Lier
60,Mechelsesteenweg 365,2023-04-10,20:00:00,4,0,4,FMN GV 05 Lier
60,Mechelsesteenweg 365,2023-04-10,21:00:00,4,0,4,FMN GV 05 Lier
60,Mechelsesteenweg 365,2023-04-10,22:00:00,2,0,2,FMN GV 05 Lier
60,Mechelsesteenweg 365,2023-04-10,23:00:00,2,2,0,FMN GV 05 Lier
60,Mechelsesteenweg 365,2023-04-11,00:00:00,0,0,0,FMN GV 05 Lier
60,Mechelsesteenweg 365,2023-04-11,01:00:00,0,0,0,FMN GV 05 Lier
60,Mechelsesteenweg 365,2023-04-11,02:00:00,0,0,0,FMN GV 05 Lier
60,Mechelsesteenweg 365,2023-04-11,03:00:00,0,0,0,FMN GV 05 Lier
60,Mechelsesteenweg 365,2023-04-11,04:00:00,0,0,0,FMN GV 05 Lier
60,Mechelsesteenweg 365,2023-04-11,05:00:00,4,0,4,FMN GV 05 Lier
60,Mechelsesteenweg 365,2023-04-11,06:00:00,10,2,8,FMN GV 05 Lier
60,Mechelsesteenweg 365,2023-04-11,07:00:00,64,14,50,FMN GV 05 Lier
60,Mechelsesteenweg 365,2023-04-11,08:00:00,56,24,32,FMN GV 05 Lier
60,Mechelsesteenweg 365,2023-04-11,09:00:00,94,42,52,FMN GV 05 Lier
60,Mechelsesteenweg 365,2023-04-11,10:00:00,136,88,48,FMN GV 05 Lier
60,Mechelsesteenweg 365,2023-04-11,11:00:00,180,104,76,FMN GV 05 Lier
60,Mechelsesteenweg 365,2023-04-11,12:00:00,82,42,40,FMN GV 05 Lier
60,Mechelsesteenweg 365,2023-04-11,13:00:00,98,48,50,FMN GV 05 Lier
60,Mechelsesteenweg 365,2023-04-11,14:00:00,102,42,60,FMN GV 05 Lier
60,Mechelsesteenweg 365,2023-04-11,15:00:00,108,60,48,FMN GV 05 Lier
60,Mechelsesteenweg 365,2023-04-11,16:00:00,134,70,64,FMN GV 05 Lier
60,Mechelsesteenweg 365,2023-04-11,17:00:00,112,70,42,FMN GV 05 Lier
60,Mechelsesteenweg 365,2023-04-11,18:00:00,108,66,42,FMN GV 05 Lier
60,Mechelsesteenweg 365,2023-04-11,19:00:00,132,60,72,FMN GV 05 Lier
60,Mechelsesteenweg 365,2023-04-11,20:00:00,26,14,12,FMN GV 05 Lier
60,Mechelsesteenweg 365,2023-04-11,21:00:00,6,4,2,FMN GV 05 Lier
60,Mechelsesteenweg 365,2023-04-11,22:00:00,4,2,2,FMN GV 05 Lier
60,Mechelsesteenweg 365,2023-04-11,23:00:00,4,0,4,FMN GV 05 Lier
60,Mechelsesteenweg 365,2023-04-12,00:00:00,0,0,0,FMN GV 05 Lier
60,Mechelsesteenweg 365,2023-04-12,01:00:00,0,0,0,FMN GV 05 Lier
60,Mechelsesteenweg 365,2023-04-12,02:00:00,0,0,0,FMN GV 05 Lier
60,Mechelsesteenweg 365,2023-04-12,03:00:00,0,0,0,FMN GV 05 Lier
60,Mechelsesteenweg 365,2023-04-12,04:00:00,0,0,0,FMN GV 05 Lier
60,Mechelsesteenweg 365,2023-04-12,05:00:00,2,0,2,FMN GV 05 Lier
60,Mechelsesteenweg 365,2023-04-12,06:00:00,8,4,4,FMN GV 05 Lier
60,Mechelsesteenweg 365,2023-04-12,07:00:00,12,6,6,FMN GV 05 Lier
60,Mechelsesteenweg 365,2023-04-12,08:00:00,18,6,12,FMN GV 05 Lier
60,Mechelsesteenweg 365,2023-04-12,09:00:00,16,8,8,FMN GV 05 Lier
60,Mechelsesteenweg 365,2023-04-12,10:00:00,18,8,10,FMN GV 05 Lier
60,Mechelsesteenweg 365,2023-04-12,11:00:00,18,10,8,FMN GV 05 Lier
60,Mechelsesteenweg 365,2023-04-12,12:00:00,18,10,8,FMN GV 05 Lier
60,Mechelsesteenweg 365,2023-04-12,13:00:00,14,6,8,FMN GV 05 Lier
60,Mechelsesteenweg 365,2023-04-12,14:00:00,18,12,6,FMN GV 05 Lier
60,Mechelsesteenweg 365,2023-04-12,15:00:00,42,10,32,FMN GV 05 Lier
60,Mechelsesteenweg 365,2023-04-12,16:00:00,40,22,18,FMN GV 05 Lier
60,Mechelsesteenweg 365,2023-04-12,17:00:00,42,24,18,FMN GV 05 Lier
60,Mechelsesteenweg 365,2023-04-12,18:00:00,72,32,40,FMN GV 05 Lier
60,Mechelsesteenweg 365,2023-04-12,19:00:00,78,56,22,FMN GV 05 Lier
60,Mechelsesteenweg 365,2023-04-12,20:00:00,42,24,18,FMN GV 05 Lier
60,Mechelsesteenweg 365,2023-04-12,21:00:00,4,0,4,FMN GV 05 Lier
60,Mechelsesteenweg 365,2023-04-12,22:00:00,4,4,0,FMN GV 05 Lier
60,Mechelsesteenweg 365,2023-04-12,23:00:00,8,2,6,FMN GV 05 Lier
60,Mechelsesteenweg 365,2023-04-13,00:00:00,0,0,0,FMN GV 05 Lier
60,Mechelsesteenweg 365,2023-04-13,01:00:00,0,0,0,FMN GV 05 Lier
60,Mechelsesteenweg 365,2023-04-13,02:00:00,0,0,0,FMN GV 05 Lier
60,Mechelsesteenweg 365,2023-04-13,03:00:00,0,0,0,FMN GV 05 Lier
60,Mechelsesteenweg 365,2023-04-13,04:00:00,0,0,0,FMN GV 05 Lier
60,Mechelsesteenweg 365,2023-04-13,05:00:00,2,0,2,FMN GV 05 Lier
60,Mechelsesteenweg 365,2023-04-13,06:00:00,14,0,14,FMN GV 05 Lier
60,Mechelsesteenweg 365,2023-04-13,07:00:00,46,14,32,FMN GV 05 Lier
60,Mechelsesteenweg 365,2023-04-13,08:00:00,46,18,28,FMN GV 05 Lier
60,Mechelsesteenweg 365,2023-04-13,09:00:00,38,18,20,FMN GV 05 Lier
60,Mechelsesteenweg 365,2023-04-13,10:00:00,24,12,12,FMN GV 05 Lier
60,Mechelsesteenweg 365,2023-04-13,11:00:00,40,18,22,FMN GV 05 Lier
60,Mechelsesteenweg 365,2023-04-13,12:00:00,50,22,28,FMN GV 05 Lier
60,Mechelsesteenweg 365,2023-04-13,13:00:00,70,44,26,FMN GV 05 Lier
60,Mechelsesteenweg 365,2023-04-13,14:00:00,142,106,36,FMN GV 05 Lier
60,Mechelsesteenweg 365,2023-04-13,15:00:00,186,104,82,FMN GV 05 Lier
60,Mechelsesteenweg 365,2023-04-13,16:00:00,134,94,40,FMN GV 05 Lier
60,Mechelsesteenweg 365,2023-04-13,17:00:00,160,96,64,FMN GV 05 Lier
60,Mechelsesteenweg 365,2023-04-13,18:00:00,112,74,38,FMN GV 05 Lier
60,Mechelsesteenweg 365,2023-04-13,19:00:00,104,52,52,FMN GV 05 Lier
60,Mechelsesteenweg 365,2023-04-13,20:00:00,104,50,54,FMN GV 05 Lier
60,Mechelsesteenweg 365,2023-04-13,21:00:00,6,0,6,FMN GV 05 Lier
60,Mechelsesteenweg 365,2023-04-13,22:00:00,4,2,2,FMN GV 05 Lier
60,Mechelsesteenweg 365,2023-04-13,23:00:00,0,0,0,FMN GV 05 Lier
60,Mechelsesteenweg 365,2023-04-14,00:00:00,2,2,0,FMN GV 05 Lier
60,Mechelsesteenweg 365,2023-04-14,01:00:00,2,0,2,FMN GV 05 Lier
60,Mechelsesteenweg 365,2023-04-14,02:00:00,0,0,0,FMN GV 05 Lier
60,Mechelsesteenweg 365,2023-04-14,03:00:00,0,0,0,FMN GV 05 Lier
60,Mechelsesteenweg 365,2023-04-14,04:00:00,0,0,0,FMN GV 05 Lier
60,Mechelsesteenweg 365,2023-04-14,05:00:00,0,0,0,FMN GV 05 Lier
60,Mechelsesteenweg 365,2023-04-14,06:00:00,18,4,14,FMN GV 05 Lier
60,Mechelsesteenweg 365,2023-04-14,07:00:00,40,10,30,FMN GV 05 Lier
60,Mechelsesteenweg 365,2023-04-14,08:00:00,36,12,24,FMN GV 05 Lier
60,Mechelsesteenweg 365,2023-04-14,09:00:00,56,26,30,FMN GV 05 Lier
60,Mechelsesteenweg 365,2023-04-14,10:00:00,80,40,40,FMN GV 05 Lier
60,Mechelsesteenweg 365,2023-04-14,11:00:00,106,52,54,FMN GV 05 Lier
60,Mechelsesteenweg 365,2023-04-14,12:00:00,118,50,68,FMN GV 05 Lier
60,Mechelsesteenweg 365,2023-04-14,13:00:00,126,70,56,FMN GV 05 Lier
60,Mechelsesteenweg 365,2023-04-14,14:00:00,172,96,76,FMN GV 05 Lier
60,Mechelsesteenweg 365,2023-04-14,15:00:00,178,72,106,FMN GV 05 Lier
60,Mechelsesteenweg 365,2023-04-14,16:00:00,120,56,64,FMN GV 05 Lier
60,Mechelsesteenweg 365,2023-04-14,17:00:00,96,66,30,FMN GV 05 Lier
60,Mechelsesteenweg 365,2023-04-14,18:00:00,88,40,48,FMN GV 05 Lier
60,Mechelsesteenweg 365,2023-04-14,19:00:00,56,18,38,FMN GV 05 Lier
60,Mechelsesteenweg 365,2023-04-14,20:00:00,22,4,18,FMN GV 05 Lier
60,Mechelsesteenweg 365,2023-04-14,21:00:00,14,12,2,FMN GV 05 Lier
60,Mechelsesteenweg 365,2023-04-14,22:00:00,8,8,0,FMN GV 05 Lier
60,Mechelsesteenweg 365,2023-04-14,23:00:00,0,0,0,FMN GV 05 Lier
60,Mechelsesteenweg 365,2023-04-15,00:00:00,6,0,6,FMN GV 05 Lier
60,Mechelsesteenweg 365,2023-04-15,01:00:00,2,0,2,FMN GV 05 Lier
60,Mechelsesteenweg 365,2023-04-15,02:00:00,0,0,0,FMN GV 05 Lier
60,Mechelsesteenweg 365,2023-04-15,03:00:00,0,0,0,FMN GV 05 Lier
60,Mechelsesteenweg 365,2023-04-15,04:00:00,0,0,0,FMN GV 05 Lier
60,Mechelsesteenweg 365,2023-04-15,05:00:00,2,0,2,FMN GV 05 Lier
60,Mechelsesteenweg 365,2023-04-15,06:00:00,2,0,2,FMN GV 05 Lier
60,Mechelsesteenweg 365,2023-04-15,07:00:00,14,8,6,FMN GV 05 Lier
60,Mechelsesteenweg 365,2023-04-15,08:00:00,30,8,22,FMN GV 05 Lier
60,Mechelsesteenweg 365,2023-04-15,09:00:00,56,30,26,FMN GV 05 Lier
60,Mechelsesteenweg 365,2023-04-15,10:00:00,128,54,74,FMN GV 05 Lier
60,Mechelsesteenweg 365,2023-04-15,11:00:00,202,82,120,FMN GV 05 Lier
60,Mechelsesteenweg 365,2023-04-15,12:00:00,244,100,144,FMN GV 05 Lier
60,Mechelsesteenweg 365,2023-04-15,13:00:00,266,116,150,FMN GV 05 Lier
60,Mechelsesteenweg 365,2023-04-15,14:00:00,380,222,158,FMN GV 05 Lier
60,Mechelsesteenweg 365,2023-04-15,15:00:00,344,150,194,FMN GV 05 Lier
60,Mechelsesteenweg 365,2023-04-15,16:00:00,260,102,158,FMN GV 05 Lier
60,Mechelsesteenweg 365,2023-04-15,17:00:00,152,62,90,FMN GV 05 Lier
60,Mechelsesteenweg 365,2023-04-15,18:00:00,98,44,54,FMN GV 05 Lier
60,Mechelsesteenweg 365,2023-04-15,19:00:00,32,12,20,FMN GV 05 Lier
60,Mechelsesteenweg 365,2023-04-15,20:00:00,22,8,14,FMN GV 05 Lier
60,Mechelsesteenweg 365,2023-04-15,21:00:00,12,0,12,FMN GV 05 Lier
60,Mechelsesteenweg 365,2023-04-15,22:00:00,14,10,4,FMN GV 05 Lier
60,Mechelsesteenweg 365,2023-04-15,23:00:00,2,0,2,FMN GV 05 Lier
60,Mechelsesteenweg 365,2023-04-16,00:00:00,4,4,0,FMN GV 05 Lier
60,Mechelsesteenweg 365,2023-04-16,01:00:00,2,0,2,FMN GV 05 Lier
60,Mechelsesteenweg 365,2023-04-16,02:00:00,6,6,0,FMN GV 05 Lier
60,Mechelsesteenweg 365,2023-04-16,03:00:00,2,2,0,FMN GV 05 Lier
60,Mechelsesteenweg 365,2023-04-16,04:00:00,4,0,4,FMN GV 05 Lier
60,Mechelsesteenweg 365,2023-04-16,05:00:00,0,0,0,FMN GV 05 Lier
60,Mechelsesteenweg 365,2023-04-16,06:00:00,2,2,0,FMN GV 05 Lier
60,Mechelsesteenweg 365,2023-04-16,07:00:00,10,4,6,FMN GV 05 Lier
60,Mechelsesteenweg 365,2023-04-16,08:00:00,10,4,6,FMN GV 05 Lier
60,Mechelsesteenweg 365,2023-04-16,09:00:00,96,50,46,FMN GV 05 Lier
60,Mechelsesteenweg 365,2023-04-16,10:00:00,116,42,74,FMN GV 05 Lier
60,Mechelsesteenweg 365,2023-04-16,11:00:00,118,64,54,FMN GV 05 Lier
60,Mechelsesteenweg 365,2023-04-16,12:00:00,70,44,26,FMN GV 05 Lier
60,Mechelsesteenweg 365,2023-04-16,13:00:00,48,32,16,FMN GV 05 Lier
60,Mechelsesteenweg 365,2023-04-16,14:00:00,82,42,40,FMN GV 05 Lier
60,Mechelsesteenweg 365,2023-04-16,15:00:00,68,34,34,FMN GV 05 Lier
60,Mechelsesteenweg 365,2023-04-16,16:00:00,68,36,32,FMN GV 05 Lier
60,Mechelsesteenweg 365,2023-04-16,17:00:00,46,22,24,FMN GV 05 Lier
60,Mechelsesteenweg 365,2023-04-16,18:00:00,50,18,32,FMN GV 05 Lier
60,Mechelsesteenweg 365,2023-04-16,19:00:00,22,10,12,FMN GV 05 Lier
60,Mechelsesteenweg 365,2023-04-16,20:00:00,20,6,14,FMN GV 05 Lier
60,Mechelsesteenweg 365,2023-04-16,21:00:00,2,2,0,FMN GV 05 Lier
60,Mechelsesteenweg 365,2023-04-16,22:00:00,2,2,0,FMN GV 05 Lier
60,Mechelsesteenweg 365,2023-04-16,23:00:00,0,0,0,FMN GV 05 Lier
60,Mechelsesteenweg 365,2023-04-17,00:00:00,0,0,0,FMN GV 05 Lier
60,Mechelsesteenweg 365,2023-04-17,01:00:00,0,0,0,FMN GV 05 Lier
60,Mechelsesteenweg 365,2023-04-17,02:00:00,0,0,0,FMN GV 05 Lier
60,Mechelsesteenweg 365,2023-04-17,03:00:00,0,0,0,FMN GV 05 Lier
60,Mechelsesteenweg 365,2023-04-17,04:00:00,0,0,0,FMN GV 05 Lier
60,Mechelsesteenweg 365,2023-04-17,05:00:00,4,2,2,FMN GV 05 Lier
60,Mechelsesteenweg 365,2023-04-17,06:00:00,36,18,18,FMN GV 05 Lier
60,Mechelsesteenweg 365,2023-04-17,07:00:00,142,66,76,FMN GV 05 Lier
60,Mechelsesteenweg 365,2023-04-17,08:00:00,150,84,66,FMN GV 05 Lier
60,Mechelsesteenweg 365,2023-04-17,09:00:00,66,36,30,FMN GV 05 Lier
60,Mechelsesteenweg 365,2023-04-17,10:00:00,36,14,22,FMN GV 05 Lier
60,Mechelsesteenweg 365,2023-04-17,11:00:00,64,36,28,FMN GV 05 Lier
60,Mechelsesteenweg 365,2023-04-17,12:00:00,78,40,38,FMN GV 05 Lier
60,Mechelsesteenweg 365,2023-04-17,13:00:00,106,42,64,FMN GV 05 Lier
60,Mechelsesteenweg 365,2023-04-17,14:00:00,136,80,56,FMN GV 05 Lier
60,Mechelsesteenweg 365,2023-04-17,15:00:00,208,78,130,FMN GV 05 Lier
60,Mechelsesteenweg 365,2023-04-17,16:00:00,332,110,222,FMN GV 05 Lier
60,Mechelsesteenweg 365,2023-04-17,17:00:00,174,102,72,FMN GV 05 Lier
60,Mechelsesteenweg 365,2023-04-17,18:00:00,124,68,56,FMN GV 05 Lier
60,Mechelsesteenweg 365,2023-04-17,19:00:00,80,42,38,FMN GV 05 Lier
60,Mechelsesteenweg 365,2023-04-17,20:00:00,38,8,30,FMN GV 05 Lier
60,Mechelsesteenweg 365,2023-04-17,21:00:00,12,4,8,FMN GV 05 Lier
60,Mechelsesteenweg 365,2023-04-17,22:00:00,4,0,4,FMN GV 05 Lier
60,Mechelsesteenweg 365,2023-04-17,23:00:00,0,0,0,FMN GV 05 Lier
60,Mechelsesteenweg 365,2023-04-18,00:00:00,0,0,0,FMN GV 05 Lier
60,Mechelsesteenweg 365,2023-04-18,01:00:00,0,0,0,FMN GV 05 Lier
60,Mechelsesteenweg 365,2023-04-18,02:00:00,0,0,0,FMN GV 05 Lier
60,Mechelsesteenweg 365,2023-04-18,03:00:00,0,0,0,FMN GV 05 Lier
60,Mechelsesteenweg 365,2023-04-18,04:00:00,0,0,0,FMN GV 05 Lier
60,Mechelsesteenweg 365,2023-04-18,05:00:00,4,2,2,FMN GV 05 Lier
60,Mechelsesteenweg 365,2023-04-18,06:00:00,32,10,22,FMN GV 05 Lier
60,Mechelsesteenweg 365,2023-04-18,07:00:00,154,58,96,FMN GV 05 Lier
60,Mechelsesteenweg 365,2023-04-18,08:00:00,206,112,94,FMN GV 05 Lier
60,Mechelsesteenweg 365,2023-04-18,09:00:00,68,38,30,FMN GV 05 Lier
60,Mechelsesteenweg 365,2023-04-18,10:00:00,80,30,50,FMN GV 05 Lier
60,Mechelsesteenweg 365,2023-04-18,11:00:00,112,70,42,FMN GV 05 Lier
60,Mechelsesteenweg 365,2023-04-18,12:00:00,134,42,92,FMN GV 05 Lier
60,Mechelsesteenweg 365,2023-04-18,13:00:00,124,68,56,FMN GV 05 Lier
60,Mechelsesteenweg 365,2023-04-18,14:00:00,144,72,72,FMN GV 05 Lier
60,Mechelsesteenweg 365,2023-04-18,15:00:00,172,58,114,FMN GV 05 Lier
60,Mechelsesteenweg 365,2023-04-18,16:00:00,286,108,178,FMN GV 05 Lier
60,Mechelsesteenweg 365,2023-04-18,17:00:00,162,80,82,FMN GV 05 Lier
60,Mechelsesteenweg 365,2023-04-18,18:00:00,96,58,38,FMN GV 05 Lier
60,Mechelsesteenweg 365,2023-04-18,19:00:00,134,66,68,FMN GV 05 Lier
60,Mechelsesteenweg 365,2023-04-18,20:00:00,26,8,18,FMN GV 05 Lier
60,Mechelsesteenweg 365,2023-04-18,21:00:00,12,2,10,FMN GV 05 Lier
60,Mechelsesteenweg 365,2023-04-18,22:00:00,12,10,2,FMN GV 05 Lier
60,Mechelsesteenweg 365,2023-04-18,23:00:00,2,2,0,FMN GV 05 Lier
60,Mechelsesteenweg 365,2023-04-19,00:00:00,0,0,0,FMN GV 05 Lier
60,Mechelsesteenweg 365,2023-04-19,01:00:00,0,0,0,FMN GV 05 Lier
60,Mechelsesteenweg 365,2023-04-19,02:00:00,0,0,0,FMN GV 05 Lier
60,Mechelsesteenweg 365,2023-04-19,03:00:00,0,0,0,FMN GV 05 Lier
60,Mechelsesteenweg 365,2023-04-19,04:00:00,0,0,0,FMN GV 05 Lier
60,Mechelsesteenweg 365,2023-04-19,05:00:00,8,2,6,FMN GV 05 Lier
60,Mechelsesteenweg 365,2023-04-19,06:00:00,36,8,28,FMN GV 05 Lier
60,Mechelsesteenweg 365,2023-04-19,07:00:00,126,50,76,FMN GV 05 Lier
60,Mechelsesteenweg 365,2023-04-19,08:00:00,170,88,82,FMN GV 05 Lier
60,Mechelsesteenweg 365,2023-04-19,09:00:00,78,50,28,FMN GV 05 Lier
60,Mechelsesteenweg 365,2023-04-19,10:00:00,80,36,44,FMN GV 05 Lier
60,Mechelsesteenweg 365,2023-04-19,11:00:00,100,20,80,FMN GV 05 Lier
60,Mechelsesteenweg 365,2023-04-19,12:00:00,258,92,166,FMN GV 05 Lier
60,Mechelsesteenweg 365,2023-04-19,13:00:00,152,66,86,FMN GV 05 Lier
60,Mechelsesteenweg 365,2023-04-19,14:00:00,326,146,180,FMN GV 05 Lier
60,Mechelsesteenweg 365,2023-04-19,15:00:00,302,148,154,FMN GV 05 Lier
60,Mechelsesteenweg 365,2023-04-19,16:00:00,280,146,134,FMN GV 05 Lier
60,Mechelsesteenweg 365,2023-04-19,17:00:00,192,102,90,FMN GV 05 Lier
60,Mechelsesteenweg 365,2023-04-19,18:00:00,222,102,120,FMN GV 05 Lier
60,Mechelsesteenweg 365,2023-04-19,19:00:00,270,150,120,FMN GV 05 Lier
60,Mechelsesteenweg 365,2023-04-19,20:00:00,190,166,24,FMN GV 05 Lier
60,Mechelsesteenweg 365,2023-04-19,21:00:00,10,2,8,FMN GV 05 Lier
60,Mechelsesteenweg 365,2023-04-19,22:00:00,2,0,2,FMN GV 05 Lier
60,Mechelsesteenweg 365,2023-04-19,23:00:00,6,4,2,FMN GV 05 Lier
60,Mechelsesteenweg 365,2023-04-20,00:00:00,0,0,0,FMN GV 05 Lier
60,Mechelsesteenweg 365,2023-04-20,01:00:00,0,0,0,FMN GV 05 Lier
60,Mechelsesteenweg 365,2023-04-20,02:00:00,0,0,0,FMN GV 05 Lier
60,Mechelsesteenweg 365,2023-04-20,03:00:00,0,0,0,FMN GV 05 Lier
60,Mechelsesteenweg 365,2023-04-20,04:00:00,0,0,0,FMN GV 05 Lier
60,Mechelsesteenweg 365,2023-04-20,05:00:00,6,0,6,FMN GV 05 Lier
60,Mechelsesteenweg 365,2023-04-20,06:00:00,14,2,12,FMN GV 05 Lier
60,Mechelsesteenweg 365,2023-04-20,07:00:00,108,50,58,FMN GV 05 Lier
60,Mechelsesteenweg 365,2023-04-20,08:00:00,136,68,68,FMN GV 05 Lier
60,Mechelsesteenweg 365,2023-04-20,09:00:00,54,30,24,FMN GV 05 Lier
60,Mechelsesteenweg 365,2023-04-20,10:00:00,36,18,18,FMN GV 05 Lier
60,Mechelsesteenweg 365,2023-04-20,11:00:00,58,20,38,FMN GV 05 Lier
60,Mechelsesteenweg 365,2023-04-20,12:00:00,82,26,56,FMN GV 05 Lier
60,Mechelsesteenweg 365,2023-04-20,13:00:00,62,26,36,FMN GV 05 Lier
60,Mechelsesteenweg 365,2023-04-20,14:00:00,38,18,20,FMN GV 05 Lier
60,Mechelsesteenweg 365,2023-04-20,15:00:00,102,62,40,FMN GV 05 Lier
60,Mechelsesteenweg 365,2023-04-20,16:00:00,154,50,104,FMN GV 05 Lier
60,Mechelsesteenweg 365,2023-04-20,17:00:00,100,76,24,FMN GV 05 Lier
60,Mechelsesteenweg 365,2023-04-20,18:00:00,38,30,8,FMN GV 05 Lier
60,Mechelsesteenweg 365,2023-04-20,19:00:00,80,40,40,FMN GV 05 Lier
60,Mechelsesteenweg 365,2023-04-20,20:00:00,106,14,92,FMN GV 05 Lier
60,Mechelsesteenweg 365,2023-04-20,21:00:00,8,6,2,FMN GV 05 Lier
60,Mechelsesteenweg 365,2023-04-20,22:00:00,10,4,6,FMN GV 05 Lier
60,Mechelsesteenweg 365,2023-04-20,23:00:00,0,0,0,FMN GV 05 Lier
60,Mechelsesteenweg 365,2023-04-21,00:00:00,2,2,0,FMN GV 05 Lier
60,Mechelsesteenweg 365,2023-04-21,01:00:00,0,0,0,FMN GV 05 Lier
60,Mechelsesteenweg 365,2023-04-21,02:00:00,0,0,0,FMN GV 05 Lier
60,Mechelsesteenweg 365,2023-04-21,03:00:00,0,0,0,FMN GV 05 Lier
60,Mechelsesteenweg 365,2023-04-21,04:00:00,0,0,0,FMN GV 05 Lier
60,Mechelsesteenweg 365,2023-04-21,05:00:00,6,0,6,FMN GV 05 Lier
60,Mechelsesteenweg 365,2023-04-21,06:00:00,20,8,12,FMN GV 05 Lier
60,Mechelsesteenweg 365,2023-04-21,07:00:00,114,62,52,FMN GV 05 Lier
60,Mechelsesteenweg 365,2023-04-21,08:00:00,124,80,44,FMN GV 05 Lier
60,Mechelsesteenweg 365,2023-04-21,09:00:00,66,28,38,FMN GV 05 Lier
60,Mechelsesteenweg 365,2023-04-21,10:00:00,134,68,66,FMN GV 05 Lier
60,Mechelsesteenweg 365,2023-04-21,11:00:00,106,46,60,FMN GV 05 Lier
60,Mechelsesteenweg 365,2023-04-21,12:00:00,148,70,78,FMN GV 05 Lier
60,Mechelsesteenweg 365,2023-04-21,13:00:00,180,76,104,FMN GV 05 Lier
60,Mechelsesteenweg 365,2023-04-21,14:00:00,322,122,200,FMN GV 05 Lier
60,Mechelsesteenweg 365,2023-04-21,15:00:00,228,72,156,FMN GV 05 Lier
60,Mechelsesteenweg 365,2023-04-21,16:00:00,280,112,168,FMN GV 05 Lier
60,Mechelsesteenweg 365,2023-04-21,17:00:00,190,96,94,FMN GV 05 Lier
60,Mechelsesteenweg 365,2023-04-21,18:00:00,76,34,42,FMN GV 05 Lier
60,Mechelsesteenweg 365,2023-04-21,19:00:00,30,18,12,FMN GV 05 Lier
60,Mechelsesteenweg 365,2023-04-21,20:00:00,14,4,10,FMN GV 05 Lier
60,Mechelsesteenweg 365,2023-04-21,21:00:00,10,8,2,FMN GV 05 Lier
60,Mechelsesteenweg 365,2023-04-21,22:00:00,2,0,2,FMN GV 05 Lier
60,Mechelsesteenweg 365,2023-04-21,23:00:00,0,0,0,FMN GV 05 Lier
60,Mechelsesteenweg 365,2023-04-22,00:00:00,0,0,0,FMN GV 05 Lier
60,Mechelsesteenweg 365,2023-04-22,01:00:00,2,0,2,FMN GV 05 Lier
60,Mechelsesteenweg 365,2023-04-22,02:00:00,0,0,0,FMN GV 05 Lier
60,Mechelsesteenweg 365,2023-04-22,03:00:00,0,0,0,FMN GV 05 Lier
60,Mechelsesteenweg 365,2023-04-22,04:00:00,2,0,2,FMN GV 05 Lier
60,Mechelsesteenweg 365,2023-04-22,05:00:00,2,0,2,FMN GV 05 Lier
60,Mechelsesteenweg 365,2023-04-22,06:00:00,12,6,6,FMN GV 05 Lier
60,Mechelsesteenweg 365,2023-04-22,07:00:00,20,14,6,FMN GV 05 Lier
60,Mechelsesteenweg 365,2023-04-22,08:00:00,32,16,16,FMN GV 05 Lier
60,Mechelsesteenweg 365,2023-04-22,09:00:00,128,48,80,FMN GV 05 Lier
60,Mechelsesteenweg 365,2023-04-22,10:00:00,140,66,74,FMN GV 05 Lier
60,Mechelsesteenweg 365,2023-04-22,11:00:00,114,48,66,FMN GV 05 Lier
60,Mechelsesteenweg 365,2023-04-22,12:00:00,88,44,44,FMN GV 05 Lier
60,Mechelsesteenweg 365,2023-04-22,13:00:00,26,10,16,FMN GV 05 Lier
60,Mechelsesteenweg 365,2023-04-22,14:00:00,28,18,10,FMN GV 05 Lier
60,Mechelsesteenweg 365,2023-04-22,15:00:00,36,16,20,FMN GV 05 Lier
60,Mechelsesteenweg 365,2023-04-22,16:00:00,40,20,20,FMN GV 05 Lier
60,Mechelsesteenweg 365,2023-04-22,17:00:00,4,2,2,FMN GV 05 Lier
60,Mechelsesteenweg 365,2023-04-22,18:00:00,16,8,8,FMN GV 05 Lier
60,Mechelsesteenweg 365,2023-04-22,19:00:00,10,8,2,FMN GV 05 Lier
60,Mechelsesteenweg 365,2023-04-22,20:00:00,12,0,12,FMN GV 05 Lier
60,Mechelsesteenweg 365,2023-04-22,21:00:00,0,0,0,FMN GV 05 Lier
60,Mechelsesteenweg 365,2023-04-22,22:00:00,4,0,4,FMN GV 05 Lier
60,Mechelsesteenweg 365,2023-04-22,23:00:00,4,2,2,FMN GV 05 Lier
60,Mechelsesteenweg 365,2023-04-23,00:00:00,0,0,0,FMN GV 05 Lier
60,Mechelsesteenweg 365,2023-04-23,01:00:00,0,0,0,FMN GV 05 Lier
60,Mechelsesteenweg 365,2023-04-23,02:00:00,0,0,0,FMN GV 05 Lier
60,Mechelsesteenweg 365,2023-04-23,03:00:00,2,0,2,FMN GV 05 Lier
60,Mechelsesteenweg 365,2023-04-23,04:00:00,0,0,0,FMN GV 05 Lier
60,Mechelsesteenweg 365,2023-04-23,05:00:00,0,0,0,FMN GV 05 Lier
60,Mechelsesteenweg 365,2023-04-23,06:00:00,6,4,2,FMN GV 05 Lier
60,Mechelsesteenweg 365,2023-04-23,07:00:00,16,10,6,FMN GV 05 Lier
60,Mechelsesteenweg 365,2023-04-23,08:00:00,58,28,30,FMN GV 05 Lier
60,Mechelsesteenweg 365,2023-04-23,09:00:00,204,100,104,FMN GV 05 Lier
60,Mechelsesteenweg 365,2023-04-23,10:00:00,420,230,190,FMN GV 05 Lier
60,Mechelsesteenweg 365,2023-04-23,11:00:00,502,302,200,FMN GV 05 Lier
60,Mechelsesteenweg 365,2023-04-23,12:00:00,160,82,78,FMN GV 05 Lier
60,Mechelsesteenweg 365,2023-04-23,13:00:00,68,28,40,FMN GV 05 Lier
60,Mechelsesteenweg 365,2023-04-23,14:00:00,80,52,28,FMN GV 05 Lier
60,Mechelsesteenweg 365,2023-04-23,15:00:00,22,4,18,FMN GV 05 Lier
60,Mechelsesteenweg 365,2023-04-23,16:00:00,54,48,6,FMN GV 05 Lier
60,Mechelsesteenweg 365,2023-04-23,17:00:00,24,14,10,FMN GV 05 Lier
60,Mechelsesteenweg 365,2023-04-23,18:00:00,16,12,4,FMN GV 05 Lier
60,Mechelsesteenweg 365,2023-04-23,19:00:00,10,6,4,FMN GV 05 Lier
60,Mechelsesteenweg 365,2023-04-23,20:00:00,10,6,4,FMN GV 05 Lier
60,Mechelsesteenweg 365,2023-04-23,21:00:00,0,0,0,FMN GV 05 Lier
60,Mechelsesteenweg 365,2023-04-23,22:00:00,0,0,0,FMN GV 05 Lier
60,Mechelsesteenweg 365,2023-04-23,23:00:00,0,0,0,FMN GV 05 Lier
60,Mechelsesteenweg 365,2023-04-24,00:00:00,0,0,0,FMN GV 05 Lier
60,Mechelsesteenweg 365,2023-04-24,01:00:00,0,0,0,FMN GV 05 Lier
60,Mechelsesteenweg 365,2023-04-24,02:00:00,0,0,0,FMN GV 05 Lier
60,Mechelsesteenweg 365,2023-04-24,03:00:00,0,0,0,FMN GV 05 Lier
60,Mechelsesteenweg 365,2023-04-24,04:00:00,2,0,2,FMN GV 05 Lier
60,Mechelsesteenweg 365,2023-04-24,05:00:00,0,0,0,FMN GV 05 Lier
60,Mechelsesteenweg 365,2023-04-24,06:00:00,14,6,8,FMN GV 05 Lier
60,Mechelsesteenweg 365,2023-04-24,07:00:00,80,44,36,FMN GV 05 Lier
60,Mechelsesteenweg 365,2023-04-24,08:00:00,78,42,36,FMN GV 05 Lier
60,Mechelsesteenweg 365,2023-04-24,09:00:00,26,14,12,FMN GV 05 Lier
60,Mechelsesteenweg 365,2023-04-24,10:00:00,12,6,6,FMN GV 05 Lier
60,Mechelsesteenweg 365,2023-04-24,11:00:00,18,6,12,FMN GV 05 Lier
60,Mechelsesteenweg 365,2023-04-24,12:00:00,24,10,14,FMN GV 05 Lier
60,Mechelsesteenweg 365,2023-04-24,13:00:00,60,22,38,FMN GV 05 Lier
60,Mechelsesteenweg 365,2023-04-24,14:00:00,56,24,32,FMN GV 05 Lier
60,Mechelsesteenweg 365,2023-04-24,15:00:00,128,44,84,FMN GV 05 Lier
60,Mechelsesteenweg 365,2023-04-24,16:00:00,174,74,100,FMN GV 05 Lier
60,Mechelsesteenweg 365,2023-04-24,17:00:00,120,64,56,FMN GV 05 Lier
60,Mechelsesteenweg 365,2023-04-24,18:00:00,76,48,28,FMN GV 05 Lier
60,Mechelsesteenweg 365,2023-04-24,19:00:00,30,18,12,FMN GV 05 Lier
60,Mechelsesteenweg 365,2023-04-24,20:00:00,24,18,6,FMN GV 05 Lier
60,Mechelsesteenweg 365,2023-04-24,21:00:00,16,4,12,FMN GV 05 Lier
60,Mechelsesteenweg 365,2023-04-24,22:00:00,4,4,0,FMN GV 05 Lier
60,Mechelsesteenweg 365,2023-04-24,23:00:00,0,0,0,FMN GV 05 Lier
60,Mechelsesteenweg 365,2023-04-25,00:00:00,0,0,0,FMN GV 05 Lier
60,Mechelsesteenweg 365,2023-04-25,01:00:00,0,0,0,FMN GV 05 Lier
60,Mechelsesteenweg 365,2023-04-25,02:00:00,0,0,0,FMN GV 05 Lier
60,Mechelsesteenweg 365,2023-04-25,03:00:00,0,0,0,FMN GV 05 Lier
60,Mechelsesteenweg 365,2023-04-25,04:00:00,0,0,0,FMN GV 05 Lier
60,Mechelsesteenweg 365,2023-04-25,05:00:00,4,0,4,FMN GV 05 Lier
60,Mechelsesteenweg 365,2023-04-25,06:00:00,34,4,30,FMN GV 05 Lier
60,Mechelsesteenweg 365,2023-04-25,07:00:00,128,48,80,FMN GV 05 Lier
60,Mechelsesteenweg 365,2023-04-25,08:00:00,170,104,66,FMN GV 05 Lier
60,Mechelsesteenweg 365,2023-04-25,09:00:00,68,22,46,FMN GV 05 Lier
60,Mechelsesteenweg 365,2023-04-25,10:00:00,66,38,28,FMN GV 05 Lier
60,Mechelsesteenweg 365,2023-04-25,11:00:00,66,30,36,FMN GV 05 Lier
60,Mechelsesteenweg 365,2023-04-25,12:00:00,72,24,48,FMN GV 05 Lier
60,Mechelsesteenweg 365,2023-04-25,13:00:00,106,54,52,FMN GV 05 Lier
60,Mechelsesteenweg 365,2023-04-25,14:00:00,112,54,58,FMN GV 05 Lier
60,Mechelsesteenweg 365,2023-04-25,15:00:00,144,62,82,FMN GV 05 Lier
60,Mechelsesteenweg 365,2023-04-25,16:00:00,246,108,138,FMN GV 05 Lier
60,Mechelsesteenweg 365,2023-04-25,17:00:00,162,104,58,FMN GV 05 Lier
60,Mechelsesteenweg 365,2023-04-25,18:00:00,98,58,40,FMN GV 05 Lier
60,Mechelsesteenweg 365,2023-04-25,19:00:00,72,30,42,FMN GV 05 Lier
60,Mechelsesteenweg 365,2023-04-25,20:00:00,64,26,38,FMN GV 05 Lier
60,Mechelsesteenweg 365,2023-04-25,21:00:00,8,8,0,FMN GV 05 Lier
60,Mechelsesteenweg 365,2023-04-25,22:00:00,2,2,0,FMN GV 05 Lier
60,Mechelsesteenweg 365,2023-04-25,23:00:00,2,2,0,FMN GV 05 Lier
60,Mechelsesteenweg 365,2023-04-26,00:00:00,0,0,0,FMN GV 05 Lier
60,Mechelsesteenweg 365,2023-04-26,01:00:00,0,0,0,FMN GV 05 Lier
60,Mechelsesteenweg 365,2023-04-26,02:00:00,0,0,0,FMN GV 05 Lier
60,Mechelsesteenweg 365,2023-04-26,03:00:00,0,0,0,FMN GV 05 Lier
60,Mechelsesteenweg 365,2023-04-26,04:00:00,0,0,0,FMN GV 05 Lier
60,Mechelsesteenweg 365,2023-04-26,05:00:00,6,2,4,FMN GV 05 Lier
60,Mechelsesteenweg 365,2023-04-26,06:00:00,32,4,28,FMN GV 05 Lier
60,Mechelsesteenweg 365,2023-04-26,07:00:00,110,52,58,FMN GV 05 Lier
60,Mechelsesteenweg 365,2023-04-26,08:00:00,126,64,62,FMN GV 05 Lier
60,Mechelsesteenweg 365,2023-04-26,09:00:00,44,18,26,FMN GV 05 Lier
60,Mechelsesteenweg 365,2023-04-26,10:00:00,74,52,22,FMN GV 05 Lier
60,Mechelsesteenweg 365,2023-04-26,11:00:00,94,16,78,FMN GV 05 Lier
60,Mechelsesteenweg 365,2023-04-26,12:00:00,220,62,158,FMN GV 05 Lier
60,Mechelsesteenweg 365,2023-04-26,13:00:00,136,70,66,FMN GV 05 Lier
60,Mechelsesteenweg 365,2023-04-26,14:00:00,148,76,72,FMN GV 05 Lier
60,Mechelsesteenweg 365,2023-04-26,15:00:00,174,102,72,FMN GV 05 Lier
60,Mechelsesteenweg 365,2023-04-26,16:00:00,166,80,86,FMN GV 05 Lier
60,Mechelsesteenweg 365,2023-04-26,17:00:00,198,106,92,FMN GV 05 Lier
60,Mechelsesteenweg 365,2023-04-26,18:00:00,146,92,54,FMN GV 05 Lier
60,Mechelsesteenweg 365,2023-04-26,19:00:00,148,84,64,FMN GV 05 Lier
60,Mechelsesteenweg 365,2023-04-26,20:00:00,94,50,44,FMN GV 05 Lier
60,Mechelsesteenweg 365,2023-04-26,21:00:00,22,12,10,FMN GV 05 Lier
60,Mechelsesteenweg 365,2023-04-26,22:00:00,18,16,2,FMN GV 05 Lier
60,Mechelsesteenweg 365,2023-04-26,23:00:00,0,0,0,FMN GV 05 Lier
60,Mechelsesteenweg 365,2023-04-27,00:00:00,0,0,0,FMN GV 05 Lier
60,Mechelsesteenweg 365,2023-04-27,01:00:00,0,0,0,FMN GV 05 Lier
60,Mechelsesteenweg 365,2023-04-27,02:00:00,0,0,0,FMN GV 05 Lier
60,Mechelsesteenweg 365,2023-04-27,03:00:00,0,0,0,FMN GV 05 Lier
60,Mechelsesteenweg 365,2023-04-27,04:00:00,0,0,0,FMN GV 05 Lier
60,Mechelsesteenweg 365,2023-04-27,05:00:00,2,0,2,FMN GV 05 Lier
60,Mechelsesteenweg 365,2023-04-27,06:00:00,18,2,16,FMN GV 05 Lier
60,Mechelsesteenweg 365,2023-04-27,07:00:00,132,62,70,FMN GV 05 Lier
60,Mechelsesteenweg 365,2023-04-27,08:00:00,188,100,88,FMN GV 05 Lier
60,Mechelsesteenweg 365,2023-04-27,09:00:00,94,64,30,FMN GV 05 Lier
60,Mechelsesteenweg 365,2023-04-27,10:00:00,84,42,42,FMN GV 05 Lier
60,Mechelsesteenweg 365,2023-04-27,11:00:00,156,72,84,FMN GV 05 Lier
60,Mechelsesteenweg 365,2023-04-27,12:00:00,130,48,82,FMN GV 05 Lier
60,Mechelsesteenweg 365,2023-04-27,13:00:00,138,68,70,FMN GV 05 Lier
60,Mechelsesteenweg 365,2023-04-27,14:00:00,274,154,120,FMN GV 05 Lier
60,Mechelsesteenweg 365,2023-04-27,15:00:00,242,118,124,FMN GV 05 Lier
60,Mechelsesteenweg 365,2023-04-27,16:00:00,264,94,170,FMN GV 05 Lier
60,Mechelsesteenweg 365,2023-04-27,17:00:00,196,112,84,FMN GV 05 Lier
60,Mechelsesteenweg 365,2023-04-27,18:00:00,152,96,56,FMN GV 05 Lier
60,Mechelsesteenweg 365,2023-04-27,19:00:00,96,52,44,FMN GV 05 Lier
60,Mechelsesteenweg 365,2023-04-27,20:00:00,168,34,134,FMN GV 05 Lier
60,Mechelsesteenweg 365,2023-04-27,21:00:00,32,20,12,FMN GV 05 Lier
60,Mechelsesteenweg 365,2023-04-27,22:00:00,8,6,2,FMN GV 05 Lier
60,Mechelsesteenweg 365,2023-04-27,23:00:00,0,0,0,FMN GV 05 Lier
60,Mechelsesteenweg 365,2023-04-28,00:00:00,2,2,0,FMN GV 05 Lier
60,Mechelsesteenweg 365,2023-04-28,01:00:00,0,0,0,FMN GV 05 Lier
60,Mechelsesteenweg 365,2023-04-28,02:00:00,0,0,0,FMN GV 05 Lier
60,Mechelsesteenweg 365,2023-04-28,03:00:00,0,0,0,FMN GV 05 Lier
60,Mechelsesteenweg 365,2023-04-28,04:00:00,2,0,2,FMN GV 05 Lier
60,Mechelsesteenweg 365,2023-04-28,05:00:00,4,0,4,FMN GV 05 Lier
60,Mechelsesteenweg 365,2023-04-28,06:00:00,18,4,14,FMN GV 05 Lier
60,Mechelsesteenweg 365,2023-04-28,07:00:00,102,56,46,FMN GV 05 Lier
60,Mechelsesteenweg 365,2023-04-28,08:00:00,100,66,34,FMN GV 05 Lier
60,Mechelsesteenweg 365,2023-04-28,09:00:00,24,16,8,FMN GV 05 Lier
60,Mechelsesteenweg 365,2023-04-28,10:00:00,46,10,36,FMN GV 05 Lier
60,Mechelsesteenweg 365,2023-04-28,11:00:00,32,22,10,FMN GV 05 Lier
60,Mechelsesteenweg 365,2023-04-28,12:00:00,52,20,32,FMN GV 05 Lier
60,Mechelsesteenweg 365,2023-04-28,13:00:00,82,24,58,FMN GV 05 Lier
60,Mechelsesteenweg 365,2023-04-28,14:00:00,80,52,28,FMN GV 05 Lier
60,Mechelsesteenweg 365,2023-04-28,15:00:00,94,44,50,FMN GV 05 Lier
60,Mechelsesteenweg 365,2023-04-28,16:00:00,162,62,100,FMN GV 05 Lier
60,Mechelsesteenweg 365,2023-04-28,17:00:00,86,62,24,FMN GV 05 Lier
60,Mechelsesteenweg 365,2023-04-28,18:00:00,50,36,14,FMN GV 05 Lier
60,Mechelsesteenweg 365,2023-04-28,19:00:00,40,26,14,FMN GV 05 Lier
60,Mechelsesteenweg 365,2023-04-28,20:00:00,22,8,14,FMN GV 05 Lier
60,Mechelsesteenweg 365,2023-04-28,21:00:00,12,10,2,FMN GV 05 Lier
60,Mechelsesteenweg 365,2023-04-28,22:00:00,6,6,0,FMN GV 05 Lier
60,Mechelsesteenweg 365,2023-04-28,23:00:00,10,0,10,FMN GV 05 Lier
60,Mechelsesteenweg 365,2023-04-29,00:00:00,2,0,2,FMN GV 05 Lier
60,Mechelsesteenweg 365,2023-04-29,01:00:00,2,0,2,FMN GV 05 Lier
60,Mechelsesteenweg 365,2023-04-29,02:00:00,8,2,6,FMN GV 05 Lier
60,Mechelsesteenweg 365,2023-04-29,03:00:00,0,0,0,FMN GV 05 Lier
60,Mechelsesteenweg 365,2023-04-29,04:00:00,0,0,0,FMN GV 05 Lier
60,Mechelsesteenweg 365,2023-04-29,05:00:00,2,0,2,FMN GV 05 Lier
60,Mechelsesteenweg 365,2023-04-29,06:00:00,4,2,2,FMN GV 05 Lier
60,Mechelsesteenweg 365,2023-04-29,07:00:00,10,6,4,FMN GV 05 Lier
60,Mechelsesteenweg 365,2023-04-29,08:00:00,26,20,6,FMN GV 05 Lier
60,Mechelsesteenweg 365,2023-04-29,09:00:00,88,48,40,FMN GV 05 Lier
60,Mechelsesteenweg 365,2023-04-29,10:00:00,126,70,56,FMN GV 05 Lier
60,Mechelsesteenweg 365,2023-04-29,11:00:00,154,76,78,FMN GV 05 Lier
60,Mechelsesteenweg 365,2023-04-29,12:00:00,170,74,96,FMN GV 05 Lier
60,Mechelsesteenweg 365,2023-04-29,13:00:00,128,50,78,FMN GV 05 Lier
60,Mechelsesteenweg 365,2023-04-29,14:00:00,252,152,100,FMN GV 05 Lier
60,Mechelsesteenweg 365,2023-04-29,15:00:00,216,100,116,FMN GV 05 Lier
60,Mechelsesteenweg 365,2023-04-29,16:00:00,150,60,90,FMN GV 05 Lier
60,Mechelsesteenweg 365,2023-04-29,17:00:00,134,50,84,FMN GV 05 Lier
60,Mechelsesteenweg 365,2023-04-29,18:00:00,52,30,22,FMN GV 05 Lier
60,Mechelsesteenweg 365,2023-04-29,19:00:00,28,14,14,FMN GV 05 Lier
60,Mechelsesteenweg 365,2023-04-29,20:00:00,16,6,10,FMN GV 05 Lier
60,Mechelsesteenweg 365,2023-04-29,21:00:00,10,4,6,FMN GV 05 Lier
60,Mechelsesteenweg 365,2023-04-29,22:00:00,4,2,2,FMN GV 05 Lier
60,Mechelsesteenweg 365,2023-04-29,23:00:00,0,0,0,FMN GV 05 Lier
60,Mechelsesteenweg 365,2023-04-30,00:00:00,0,0,0,FMN GV 05 Lier
60,Mechelsesteenweg 365,2023-04-30,01:00:00,2,0,2,FMN GV 05 Lier
60,Mechelsesteenweg 365,2023-04-30,02:00:00,0,0,0,FMN GV 05 Lier
60,Mechelsesteenweg 365,2023-04-30,03:00:00,0,0,0,FMN GV 05 Lier
60,Mechelsesteenweg 365,2023-04-30,04:00:00,0,0,0,FMN GV 05 Lier
60,Mechelsesteenweg 365,2023-04-30,05:00:00,0,0,0,FMN GV 05 Lier
60,Mechelsesteenweg 365,2023-04-30,06:00:00,14,8,6,FMN GV 05 Lier
60,Mechelsesteenweg 365,2023-04-30,07:00:00,34,12,22,FMN GV 05 Lier
60,Mechelsesteenweg 365,2023-04-30,08:00:00,60,24,36,FMN GV 05 Lier
60,Mechelsesteenweg 365,2023-04-30,09:00:00,216,152,64,FMN GV 05 Lier
60,Mechelsesteenweg 365,2023-04-30,10:00:00,424,256,168,FMN GV 05 Lier
60,Mechelsesteenweg 365,2023-04-30,11:00:00,506,246,260,FMN GV 05 Lier
60,Mechelsesteenweg 365,2023-04-30,12:00:00,306,178,128,FMN GV 05 Lier
60,Mechelsesteenweg 365,2023-04-30,13:00:00,356,202,154,FMN GV 05 Lier
60,Mechelsesteenweg 365,2023-04-30,14:00:00,556,262,294,FMN GV 05 Lier
60,Mechelsesteenweg 365,2023-04-30,15:00:00,466,202,264,FMN GV 05 Lier
60,Mechelsesteenweg 365,2023-04-30,16:00:00,336,136,200,FMN GV 05 Lier
60,Mechelsesteenweg 365,2023-04-30,17:00:00,208,62,146,FMN GV 05 Lier
60,Mechelsesteenweg 365,2023-04-30,18:00:00,90,30,60,FMN GV 05 Lier
60,Mechelsesteenweg 365,2023-04-30,19:00:00,66,30,36,FMN GV 05 Lier
60,Mechelsesteenweg 365,2023-04-30,20:00:00,54,22,32,FMN GV 05 Lier
60,Mechelsesteenweg 365,2023-04-30,21:00:00,20,8,12,FMN GV 05 Lier
60,Mechelsesteenweg 365,2023-04-30,22:00:00,0,0,0,FMN GV 05 Lier
60,Mechelsesteenweg 365,2023-04-30,23:00:00,2,2,0,FMN GV 05 Lier
60,Mechelsesteenweg 365,2023-05-01,00:00:00,2,2,0,FMN GV 05 Lier
60,Mechelsesteenweg 365,2023-05-01,01:00:00,0,0,0,FMN GV 05 Lier
60,Mechelsesteenweg 365,2023-05-01,02:00:00,0,0,0,FMN GV 05 Lier
60,Mechelsesteenweg 365,2023-05-01,03:00:00,0,0,0,FMN GV 05 Lier
60,Mechelsesteenweg 365,2023-05-01,04:00:00,0,0,0,FMN GV 05 Lier
60,Mechelsesteenweg 365,2023-05-01,05:00:00,0,0,0,FMN GV 05 Lier
60,Mechelsesteenweg 365,2023-05-01,06:00:00,18,10,8,FMN GV 05 Lier
60,Mechelsesteenweg 365,2023-05-01,07:00:00,22,10,12,FMN GV 05 Lier
60,Mechelsesteenweg 365,2023-05-01,08:00:00,28,12,16,FMN GV 05 Lier
60,Mechelsesteenweg 365,2023-05-01,09:00:00,176,106,70,FMN GV 05 Lier
60,Mechelsesteenweg 365,2023-05-01,10:00:00,238,112,126,FMN GV 05 Lier
60,Mechelsesteenweg 365,2023-05-01,11:00:00,350,186,164,FMN GV 05 Lier
60,Mechelsesteenweg 365,2023-05-01,12:00:00,190,92,98,FMN GV 05 Lier
60,Mechelsesteenweg 365,2023-05-01,13:00:00,246,126,120,FMN GV 05 Lier
60,Mechelsesteenweg 365,2023-05-01,14:00:00,296,150,146,FMN GV 05 Lier
60,Mechelsesteenweg 365,2023-05-01,15:00:00,254,114,140,FMN GV 05 Lier
60,Mechelsesteenweg 365,2023-05-01,16:00:00,192,102,90,FMN GV 05 Lier
60,Mechelsesteenweg 365,2023-05-01,17:00:00,160,58,102,FMN GV 05 Lier
60,Mechelsesteenweg 365,2023-05-01,18:00:00,102,38,64,FMN GV 05 Lier
60,Mechelsesteenweg 365,2023-05-01,19:00:00,50,16,34,FMN GV 05 Lier
60,Mechelsesteenweg 365,2023-05-01,20:00:00,28,12,16,FMN GV 05 Lier
60,Mechelsesteenweg 365,2023-05-01,21:00:00,8,6,2,FMN GV 05 Lier
60,Mechelsesteenweg 365,2023-05-01,22:00:00,14,8,6,FMN GV 05 Lier
60,Mechelsesteenweg 365,2023-05-01,23:00:00,4,0,4,FMN GV 05 Lier
60,Mechelsesteenweg 365,2023-05-02,00:00:00,0,0,0,FMN GV 05 Lier
60,Mechelsesteenweg 365,2023-05-02,01:00:00,0,0,0,FMN GV 05 Lier
60,Mechelsesteenweg 365,2023-05-02,02:00:00,0,0,0,FMN GV 05 Lier
60,Mechelsesteenweg 365,2023-05-02,03:00:00,0,0,0,FMN GV 05 Lier
60,Mechelsesteenweg 365,2023-05-02,04:00:00,0,0,0,FMN GV 05 Lier
60,Mechelsesteenweg 365,2023-05-02,05:00:00,2,2,0,FMN GV 05 Lier
60,Mechelsesteenweg 365,2023-05-02,06:00:00,42,16,26,FMN GV 05 Lier
60,Mechelsesteenweg 365,2023-05-02,07:00:00,130,56,74,FMN GV 05 Lier
60,Mechelsesteenweg 365,2023-05-02,08:00:00,128,56,72,FMN GV 05 Lier
60,Mechelsesteenweg 365,2023-05-02,09:00:00,178,46,132,FMN GV 05 Lier
60,Mechelsesteenweg 365,2023-05-02,10:00:00,80,50,30,FMN GV 05 Lier
60,Mechelsesteenweg 365,2023-05-02,11:00:00,88,40,48,FMN GV 05 Lier
60,Mechelsesteenweg 365,2023-05-02,12:00:00,124,40,84,FMN GV 05 Lier
60,Mechelsesteenweg 365,2023-05-02,13:00:00,100,50,50,FMN GV 05 Lier
60,Mechelsesteenweg 365,2023-05-02,14:00:00,224,114,110,FMN GV 05 Lier
60,Mechelsesteenweg 365,2023-05-02,15:00:00,164,84,80,FMN GV 05 Lier
60,Mechelsesteenweg 365,2023-05-02,16:00:00,242,110,132,FMN GV 05 Lier
60,Mechelsesteenweg 365,2023-05-02,17:00:00,194,122,72,FMN GV 05 Lier
60,Mechelsesteenweg 365,2023-05-02,18:00:00,140,96,44,FMN GV 05 Lier
60,Mechelsesteenweg 365,2023-05-02,19:00:00,174,114,60,FMN GV 05 Lier
60,Mechelsesteenweg 365,2023-05-02,20:00:00,80,30,50,FMN GV 05 Lier
60,Mechelsesteenweg 365,2023-05-02,21:00:00,34,12,22,FMN GV 05 Lier
60,Mechelsesteenweg 365,2023-05-02,22:00:00,8,4,4,FMN GV 05 Lier
60,Mechelsesteenweg 365,2023-05-02,23:00:00,0,0,0,FMN GV 05 Lier
60,Mechelsesteenweg 365,2023-05-03,00:00:00,2,0,2,FMN GV 05 Lier
60,Mechelsesteenweg 365,2023-05-03,01:00:00,0,0,0,FMN GV 05 Lier
60,Mechelsesteenweg 365,2023-05-03,02:00:00,0,0,0,FMN GV 05 Lier
60,Mechelsesteenweg 365,2023-05-03,03:00:00,0,0,0,FMN GV 05 Lier
60,Mechelsesteenweg 365,2023-05-03,04:00:00,0,0,0,FMN GV 05 Lier
60,Mechelsesteenweg 365,2023-05-03,05:00:00,12,4,8,FMN GV 05 Lier
60,Mechelsesteenweg 365,2023-05-03,06:00:00,34,10,24,FMN GV 05 Lier
60,Mechelsesteenweg 365,2023-05-03,07:00:00,152,70,82,FMN GV 05 Lier
60,Mechelsesteenweg 365,2023-05-03,08:00:00,132,78,54,FMN GV 05 Lier
60,Mechelsesteenweg 365,2023-05-03,09:00:00,60,26,34,FMN GV 05 Lier
60,Mechelsesteenweg 365,2023-05-03,10:00:00,68,28,40,FMN GV 05 Lier
60,Mechelsesteenweg 365,2023-05-03,11:00:00,148,76,72,FMN GV 05 Lier
60,Mechelsesteenweg 365,2023-05-03,12:00:00,200,80,120,FMN GV 05 Lier
60,Mechelsesteenweg 365,2023-05-03,13:00:00,106,60,46,FMN GV 05 Lier
60,Mechelsesteenweg 365,2023-05-03,14:00:00,232,98,134,FMN GV 05 Lier
60,Mechelsesteenweg 365,2023-05-03,15:00:00,240,114,126,FMN GV 05 Lier
60,Mechelsesteenweg 365,2023-05-03,16:00:00,218,88,130,FMN GV 05 Lier
60,Mechelsesteenweg 365,2023-05-03,17:00:00,236,134,102,FMN GV 05 Lier
60,Mechelsesteenweg 365,2023-05-03,18:00:00,202,94,108,FMN GV 05 Lier
60,Mechelsesteenweg 365,2023-05-03,19:00:00,248,142,106,FMN GV 05 Lier
60,Mechelsesteenweg 365,2023-05-03,20:00:00,162,72,90,FMN GV 05 Lier
60,Mechelsesteenweg 365,2023-05-03,21:00:00,20,6,14,FMN GV 05 Lier
60,Mechelsesteenweg 365,2023-05-03,22:00:00,6,4,2,FMN GV 05 Lier
60,Mechelsesteenweg 365,2023-05-03,23:00:00,4,0,4,FMN GV 05 Lier
60,Mechelsesteenweg 365,2023-05-04,00:00:00,2,2,0,FMN GV 05 Lier
60,Mechelsesteenweg 365,2023-05-04,01:00:00,0,0,0,FMN GV 05 Lier
60,Mechelsesteenweg 365,2023-05-04,02:00:00,0,0,0,FMN GV 05 Lier
60,Mechelsesteenweg 365,2023-05-04,03:00:00,0,0,0,FMN GV 05 Lier
60,Mechelsesteenweg 365,2023-05-04,04:00:00,0,0,0,FMN GV 05 Lier
60,Mechelsesteenweg 365,2023-05-04,05:00:00,8,0,8,FMN GV 05 Lier
60,Mechelsesteenweg 365,2023-05-04,06:00:00,44,12,32,FMN GV 05 Lier
60,Mechelsesteenweg 365,2023-05-04,07:00:00,138,54,84,FMN GV 05 Lier
60,Mechelsesteenweg 365,2023-05-04,08:00:00,274,102,172,FMN GV 05 Lier
60,Mechelsesteenweg 365,2023-05-04,09:00:00,112,74,38,FMN GV 05 Lier
60,Mechelsesteenweg 365,2023-05-04,10:00:00,112,44,68,FMN GV 05 Lier
60,Mechelsesteenweg 365,2023-05-04,11:00:00,210,80,130,FMN GV 05 Lier
60,Mechelsesteenweg 365,2023-05-04,12:00:00,200,104,96,FMN GV 05 Lier
60,Mechelsesteenweg 365,2023-05-04,13:00:00,212,82,130,FMN GV 05 Lier
60,Mechelsesteenweg 365,2023-05-04,14:00:00,334,170,164,FMN GV 05 Lier
60,Mechelsesteenweg 365,2023-05-04,15:00:00,388,156,232,FMN GV 05 Lier
60,Mechelsesteenweg 365,2023-05-04,16:00:00,434,182,252,FMN GV 05 Lier
60,Mechelsesteenweg 365,2023-05-04,17:00:00,368,228,140,FMN GV 05 Lier
60,Mechelsesteenweg 365,2023-05-04,18:00:00,210,124,86,FMN GV 05 Lier
60,Mechelsesteenweg 365,2023-05-04,19:00:00,222,134,88,FMN GV 05 Lier
60,Mechelsesteenweg 365,2023-05-04,20:00:00,242,70,172,FMN GV 05 Lier
60,Mechelsesteenweg 365,2023-05-04,21:00:00,60,40,20,FMN GV 05 Lier
60,Mechelsesteenweg 365,2023-05-04,22:00:00,8,6,2,FMN GV 05 Lier
60,Mechelsesteenweg 365,2023-05-04,23:00:00,8,6,2,FMN GV 05 Lier
60,Mechelsesteenweg 365,2023-05-05,00:00:00,2,2,0,FMN GV 05 Lier
60,Mechelsesteenweg 365,2023-05-05,01:00:00,0,0,0,FMN GV 05 Lier
60,Mechelsesteenweg 365,2023-05-05,02:00:00,0,0,0,FMN GV 05 Lier
60,Mechelsesteenweg 365,2023-05-05,03:00:00,0,0,0,FMN GV 05 Lier
60,Mechelsesteenweg 365,2023-05-05,04:00:00,2,0,2,FMN GV 05 Lier
60,Mechelsesteenweg 365,2023-05-05,05:00:00,4,4,0,FMN GV 05 Lier
60,Mechelsesteenweg 365,2023-05-05,06:00:00,38,10,28,FMN GV 05 Lier
60,Mechelsesteenweg 365,2023-05-05,07:00:00,118,48,70,FMN GV 05 Lier
60,Mechelsesteenweg 365,2023-05-05,08:00:00,120,60,60,FMN GV 05 Lier
60,Mechelsesteenweg 365,2023-05-05,09:00:00,62,32,30,FMN GV 05 Lier
60,Mechelsesteenweg 365,2023-05-05,10:00:00,72,32,40,FMN GV 05 Lier
60,Mechelsesteenweg 365,2023-05-05,11:00:00,60,32,28,FMN GV 05 Lier
60,Mechelsesteenweg 365,2023-05-05,12:00:00,60,22,38,FMN GV 05 Lier
60,Mechelsesteenweg 365,2023-05-05,13:00:00,56,44,12,FMN GV 05 Lier
60,Mechelsesteenweg 365,2023-05-05,14:00:00,142,102,40,FMN GV 05 Lier
60,Mechelsesteenweg 365,2023-05-05,15:00:00,86,36,50,FMN GV 05 Lier
60,Mechelsesteenweg 365,2023-05-05,16:00:00,198,86,112,FMN GV 05 Lier
60,Mechelsesteenweg 365,2023-05-05,17:00:00,88,52,36,FMN GV 05 Lier
60,Mechelsesteenweg 365,2023-05-05,18:00:00,86,48,38,FMN GV 05 Lier
60,Mechelsesteenweg 365,2023-05-05,19:00:00,34,18,16,FMN GV 05 Lier
60,Mechelsesteenweg 365,2023-05-05,20:00:00,42,20,22,FMN GV 05 Lier
60,Mechelsesteenweg 365,2023-05-05,21:00:00,26,20,6,FMN GV 05 Lier
60,Mechelsesteenweg 365,2023-05-05,22:00:00,6,2,4,FMN GV 05 Lier
60,Mechelsesteenweg 365,2023-05-05,23:00:00,4,4,0,FMN GV 05 Lier
60,Mechelsesteenweg 365,2023-05-06,00:00:00,6,0,6,FMN GV 05 Lier
60,Mechelsesteenweg 365,2023-05-06,01:00:00,0,0,0,FMN GV 05 Lier
60,Mechelsesteenweg 365,2023-05-06,02:00:00,2,2,0,FMN GV 05 Lier
60,Mechelsesteenweg 365,2023-05-06,03:00:00,0,0,0,FMN GV 05 Lier
60,Mechelsesteenweg 365,2023-05-06,04:00:00,0,0,0,FMN GV 05 Lier
60,Mechelsesteenweg 365,2023-05-06,05:00:00,2,0,2,FMN GV 05 Lier
60,Mechelsesteenweg 365,2023-05-06,06:00:00,14,6,8,FMN GV 05 Lier
60,Mechelsesteenweg 365,2023-05-06,07:00:00,26,12,14,FMN GV 05 Lier
60,Mechelsesteenweg 365,2023-05-06,08:00:00,76,24,52,FMN GV 05 Lier
60,Mechelsesteenweg 365,2023-05-06,09:00:00,210,110,100,FMN GV 05 Lier
60,Mechelsesteenweg 365,2023-05-06,10:00:00,348,212,136,FMN GV 05 Lier
60,Mechelsesteenweg 365,2023-05-06,11:00:00,370,144,226,FMN GV 05 Lier
60,Mechelsesteenweg 365,2023-05-06,12:00:00,320,158,162,FMN GV 05 Lier
60,Mechelsesteenweg 365,2023-05-06,13:00:00,220,92,128,FMN GV 05 Lier
60,Mechelsesteenweg 365,2023-05-06,14:00:00,310,168,142,FMN GV 05 Lier
60,Mechelsesteenweg 365,2023-05-06,15:00:00,238,102,136,FMN GV 05 Lier
60,Mechelsesteenweg 365,2023-05-06,16:00:00,112,58,54,FMN GV 05 Lier
60,Mechelsesteenweg 365,2023-05-06,17:00:00,102,36,66,FMN GV 05 Lier
60,Mechelsesteenweg 365,2023-05-06,18:00:00,40,18,22,FMN GV 05 Lier
60,Mechelsesteenweg 365,2023-05-06,19:00:00,30,18,12,FMN GV 05 Lier
60,Mechelsesteenweg 365,2023-05-06,20:00:00,40,20,20,FMN GV 05 Lier
60,Mechelsesteenweg 365,2023-05-06,21:00:00,12,4,8,FMN GV 05 Lier
60,Mechelsesteenweg 365,2023-05-06,22:00:00,6,6,0,FMN GV 05 Lier
60,Mechelsesteenweg 365,2023-05-06,23:00:00,0,0,0,FMN GV 05 Lier
60,Mechelsesteenweg 365,2023-05-07,00:00:00,6,4,2,FMN GV 05 Lier
60,Mechelsesteenweg 365,2023-05-07,01:00:00,0,0,0,FMN GV 05 Lier
60,Mechelsesteenweg 365,2023-05-07,02:00:00,4,2,2,FMN GV 05 Lier
60,Mechelsesteenweg 365,2023-05-07,03:00:00,0,0,0,FMN GV 05 Lier
60,Mechelsesteenweg 365,2023-05-07,04:00:00,0,0,0,FMN GV 05 Lier
60,Mechelsesteenweg 365,2023-05-07,05:00:00,4,2,2,FMN GV 05 Lier
60,Mechelsesteenweg 365,2023-05-07,06:00:00,6,4,2,FMN GV 05 Lier
60,Mechelsesteenweg 365,2023-05-07,07:00:00,32,22,10,FMN GV 05 Lier
60,Mechelsesteenweg 365,2023-05-07,08:00:00,40,24,16,FMN GV 05 Lier
60,Mechelsesteenweg 365,2023-05-07,09:00:00,84,28,56,FMN GV 05 Lier
60,Mechelsesteenweg 365,2023-05-07,10:00:00,124,42,82,FMN GV 05 Lier
60,Mechelsesteenweg 365,2023-05-07,11:00:00,106,64,42,FMN GV 05 Lier
60,Mechelsesteenweg 365,2023-05-07,12:00:00,32,14,18,FMN GV 05 Lier
60,Mechelsesteenweg 365,2023-05-07,13:00:00,30,8,22,FMN GV 05 Lier
60,Mechelsesteenweg 365,2023-05-07,14:00:00,30,20,10,FMN GV 05 Lier
60,Mechelsesteenweg 365,2023-05-07,15:00:00,50,14,36,FMN GV 05 Lier
60,Mechelsesteenweg 365,2023-05-07,16:00:00,68,16,52,FMN GV 05 Lier
60,Mechelsesteenweg 365,2023-05-07,17:00:00,72,42,30,FMN GV 05 Lier
60,Mechelsesteenweg 365,2023-05-07,18:00:00,32,8,24,FMN GV 05 Lier
60,Mechelsesteenweg 365,2023-05-07,19:00:00,38,24,14,FMN GV 05 Lier
60,Mechelsesteenweg 365,2023-05-07,20:00:00,42,10,32,FMN GV 05 Lier
60,Mechelsesteenweg 365,2023-05-07,21:00:00,10,0,10,FMN GV 05 Lier
60,Mechelsesteenweg 365,2023-05-07,22:00:00,6,2,4,FMN GV 05 Lier
60,Mechelsesteenweg 365,2023-05-07,23:00:00,2,0,2,FMN GV 05 Lier
60,Mechelsesteenweg 365,2023-05-08,00:00:00,0,0,0,FMN GV 05 Lier
60,Mechelsesteenweg 365,2023-05-08,01:00:00,0,0,0,FMN GV 05 Lier
60,Mechelsesteenweg 365,2023-05-08,02:00:00,0,0,0,FMN GV 05 Lier
60,Mechelsesteenweg 365,2023-05-08,03:00:00,2,0,2,FMN GV 05 Lier
60,Mechelsesteenweg 365,2023-05-08,04:00:00,0,0,0,FMN GV 05 Lier
60,Mechelsesteenweg 365,2023-05-08,05:00:00,4,2,2,FMN GV 05 Lier
60,Mechelsesteenweg 365,2023-05-08,06:00:00,36,8,28,FMN GV 05 Lier
60,Mechelsesteenweg 365,2023-05-08,07:00:00,166,86,80,FMN GV 05 Lier
60,Mechelsesteenweg 365,2023-05-08,08:00:00,160,88,72,FMN GV 05 Lier
60,Mechelsesteenweg 365,2023-05-08,09:00:00,60,28,32,FMN GV 05 Lier
60,Mechelsesteenweg 365,2023-05-08,10:00:00,94,52,42,FMN GV 05 Lier
60,Mechelsesteenweg 365,2023-05-08,11:00:00,76,38,38,FMN GV 05 Lier
60,Mechelsesteenweg 365,2023-05-08,12:00:00,164,60,104,FMN GV 05 Lier
60,Mechelsesteenweg 365,2023-05-08,13:00:00,154,68,86,FMN GV 05 Lier
60,Mechelsesteenweg 365,2023-05-08,14:00:00,206,104,102,FMN GV 05 Lier
60,Mechelsesteenweg 365,2023-05-08,15:00:00,270,114,156,FMN GV 05 Lier
60,Mechelsesteenweg 365,2023-05-08,16:00:00,302,126,176,FMN GV 05 Lier
60,Mechelsesteenweg 365,2023-05-08,17:00:00,214,136,78,FMN GV 05 Lier
60,Mechelsesteenweg 365,2023-05-08,18:00:00,138,80,58,FMN GV 05 Lier
60,Mechelsesteenweg 365,2023-05-08,19:00:00,96,62,34,FMN GV 05 Lier
60,Mechelsesteenweg 365,2023-05-08,20:00:00,56,14,42,FMN GV 05 Lier
60,Mechelsesteenweg 365,2023-05-08,21:00:00,18,6,12,FMN GV 05 Lier
60,Mechelsesteenweg 365,2023-05-08,22:00:00,8,8,0,FMN GV 05 Lier
60,Mechelsesteenweg 365,2023-05-08,23:00:00,2,2,0,FMN GV 05 Lier
60,Mechelsesteenweg 365,2023-05-09,00:00:00,0,0,0,FMN GV 05 Lier
60,Mechelsesteenweg 365,2023-05-09,01:00:00,0,0,0,FMN GV 05 Lier
60,Mechelsesteenweg 365,2023-05-09,02:00:00,0,0,0,FMN GV 05 Lier
60,Mechelsesteenweg 365,2023-05-09,03:00:00,0,0,0,FMN GV 05 Lier
60,Mechelsesteenweg 365,2023-05-09,04:00:00,0,0,0,FMN GV 05 Lier
60,Mechelsesteenweg 365,2023-05-09,05:00:00,4,0,4,FMN GV 05 Lier
60,Mechelsesteenweg 365,2023-05-09,06:00:00,18,2,16,FMN GV 05 Lier
60,Mechelsesteenweg 365,2023-05-09,07:00:00,122,60,62,FMN GV 05 Lier
60,Mechelsesteenweg 365,2023-05-09,08:00:00,106,60,46,FMN GV 05 Lier
60,Mechelsesteenweg 365,2023-05-09,09:00:00,30,14,16,FMN GV 05 Lier
60,Mechelsesteenweg 365,2023-05-09,10:00:00,12,10,2,FMN GV 05 Lier
60,Mechelsesteenweg 365,2023-05-09,11:00:00,18,14,4,FMN GV 05 Lier
60,Mechelsesteenweg 365,2023-05-09,12:00:00,32,18,14,FMN GV 05 Lier
60,Mechelsesteenweg 365,2023-05-09,13:00:00,32,12,20,FMN GV 05 Lier
60,Mechelsesteenweg 365,2023-05-09,14:00:00,18,2,16,FMN GV 05 Lier
60,Mechelsesteenweg 365,2023-05-09,15:00:00,50,22,28,FMN GV 05 Lier
60,Mechelsesteenweg 365,2023-05-09,16:00:00,116,32,84,FMN GV 05 Lier
60,Mechelsesteenweg 365,2023-05-09,17:00:00,50,28,22,FMN GV 05 Lier
60,Mechelsesteenweg 365,2023-05-09,18:00:00,16,14,2,FMN GV 05 Lier
60,Mechelsesteenweg 365,2023-05-09,19:00:00,18,10,8,FMN GV 05 Lier
60,Mechelsesteenweg 365,2023-05-09,20:00:00,10,8,2,FMN GV 05 Lier
60,Mechelsesteenweg 365,2023-05-09,21:00:00,6,0,6,FMN GV 05 Lier
60,Mechelsesteenweg 365,2023-05-09,22:00:00,10,8,2,FMN GV 05 Lier
60,Mechelsesteenweg 365,2023-05-09,23:00:00,0,0,0,FMN GV 05 Lier
60,Mechelsesteenweg 365,2023-05-10,00:00:00,0,0,0,FMN GV 05 Lier
60,Mechelsesteenweg 365,2023-05-10,01:00:00,0,0,0,FMN GV 05 Lier
60,Mechelsesteenweg 365,2023-05-10,02:00:00,0,0,0,FMN GV 05 Lier
60,Mechelsesteenweg 365,2023-05-10,03:00:00,2,0,2,FMN GV 05 Lier
60,Mechelsesteenweg 365,2023-05-10,04:00:00,0,0,0,FMN GV 05 Lier
60,Mechelsesteenweg 365,2023-05-10,05:00:00,8,2,6,FMN GV 05 Lier
60,Mechelsesteenweg 365,2023-05-10,06:00:00,26,6,20,FMN GV 05 Lier
60,Mechelsesteenweg 365,2023-05-10,07:00:00,96,38,58,FMN GV 05 Lier
60,Mechelsesteenweg 365,2023-05-10,08:00:00,138,82,56,FMN GV 05 Lier
60,Mechelsesteenweg 365,2023-05-10,09:00:00,50,26,24,FMN GV 05 Lier
60,Mechelsesteenweg 365,2023-05-10,10:00:00,50,32,18,FMN GV 05 Lier
60,Mechelsesteenweg 365,2023-05-10,11:00:00,62,40,22,FMN GV 05 Lier
60,Mechelsesteenweg 365,2023-05-10,12:00:00,128,46,82,FMN GV 05 Lier
60,Mechelsesteenweg 365,2023-05-10,13:00:00,70,20,50,FMN GV 05 Lier
60,Mechelsesteenweg 365,2023-05-10,14:00:00,70,34,36,FMN GV 05 Lier
60,Mechelsesteenweg 365,2023-05-10,15:00:00,56,26,30,FMN GV 05 Lier
60,Mechelsesteenweg 365,2023-05-10,16:00:00,80,52,28,FMN GV 05 Lier
60,Mechelsesteenweg 365,2023-05-10,17:00:00,62,44,18,FMN GV 05 Lier
60,Mechelsesteenweg 365,2023-05-10,18:00:00,44,24,20,FMN GV 05 Lier
60,Mechelsesteenweg 365,2023-05-10,19:00:00,38,12,26,FMN GV 05 Lier
60,Mechelsesteenweg 365,2023-05-10,20:00:00,58,34,24,FMN GV 05 Lier
60,Mechelsesteenweg 365,2023-05-10,21:00:00,32,4,28,FMN GV 05 Lier
60,Mechelsesteenweg 365,2023-05-10,22:00:00,6,6,0,FMN GV 05 Lier
60,Mechelsesteenweg 365,2023-05-10,23:00:00,0,0,0,FMN GV 05 Lier
60,Mechelsesteenweg 365,2023-05-11,00:00:00,0,0,0,FMN GV 05 Lier
60,Mechelsesteenweg 365,2023-05-11,01:00:00,0,0,0,FMN GV 05 Lier
60,Mechelsesteenweg 365,2023-05-11,02:00:00,0,0,0,FMN GV 05 Lier
60,Mechelsesteenweg 365,2023-05-11,03:00:00,0,0,0,FMN GV 05 Lier
60,Mechelsesteenweg 365,2023-05-11,04:00:00,0,0,0,FMN GV 05 Lier
60,Mechelsesteenweg 365,2023-05-11,05:00:00,8,2,6,FMN GV 05 Lier
60,Mechelsesteenweg 365,2023-05-11,06:00:00,28,8,20,FMN GV 05 Lier
60,Mechelsesteenweg 365,2023-05-11,07:00:00,126,62,64,FMN GV 05 Lier
60,Mechelsesteenweg 365,2023-05-11,08:00:00,182,102,80,FMN GV 05 Lier
60,Mechelsesteenweg 365,2023-05-11,09:00:00,100,38,62,FMN GV 05 Lier
60,Mechelsesteenweg 365,2023-05-11,10:00:00,104,48,56,FMN GV 05 Lier
60,Mechelsesteenweg 365,2023-05-11,11:00:00,100,44,56,FMN GV 05 Lier
60,Mechelsesteenweg 365,2023-05-11,12:00:00,114,58,56,FMN GV 05 Lier
60,Mechelsesteenweg 365,2023-05-11,13:00:00,122,58,64,FMN GV 05 Lier
60,Mechelsesteenweg 365,2023-05-11,14:00:00,108,30,78,FMN GV 05 Lier
60,Mechelsesteenweg 365,2023-05-11,15:00:00,172,84,88,FMN GV 05 Lier
60,Mechelsesteenweg 365,2023-05-11,16:00:00,224,60,164,FMN GV 05 Lier
60,Mechelsesteenweg 365,2023-05-11,17:00:00,122,78,44,FMN GV 05 Lier
60,Mechelsesteenweg 365,2023-05-11,18:00:00,80,50,30,FMN GV 05 Lier
60,Mechelsesteenweg 365,2023-05-11,19:00:00,48,26,22,FMN GV 05 Lier
60,Mechelsesteenweg 365,2023-05-11,20:00:00,48,34,14,FMN GV 05 Lier
60,Mechelsesteenweg 365,2023-05-11,21:00:00,12,4,8,FMN GV 05 Lier
60,Mechelsesteenweg 365,2023-05-11,22:00:00,12,6,6,FMN GV 05 Lier
60,Mechelsesteenweg 365,2023-05-11,23:00:00,4,4,0,FMN GV 05 Lier
60,Mechelsesteenweg 365,2023-05-12,00:00:00,0,0,0,FMN GV 05 Lier
60,Mechelsesteenweg 365,2023-05-12,01:00:00,0,0,0,FMN GV 05 Lier
60,Mechelsesteenweg 365,2023-05-12,02:00:00,0,0,0,FMN GV 05 Lier
60,Mechelsesteenweg 365,2023-05-12,03:00:00,2,0,2,FMN GV 05 Lier
60,Mechelsesteenweg 365,2023-05-12,04:00:00,0,0,0,FMN GV 05 Lier
60,Mechelsesteenweg 365,2023-05-12,05:00:00,6,0,6,FMN GV 05 Lier
60,Mechelsesteenweg 365,2023-05-12,06:00:00,12,2,10,FMN GV 05 Lier
60,Mechelsesteenweg 365,2023-05-12,07:00:00,64,34,30,FMN GV 05 Lier
60,Mechelsesteenweg 365,2023-05-12,08:00:00,82,56,26,FMN GV 05 Lier
60,Mechelsesteenweg 365,2023-05-12,09:00:00,14,6,8,FMN GV 05 Lier
60,Mechelsesteenweg 365,2023-05-12,10:00:00,14,8,6,FMN GV 05 Lier
60,Mechelsesteenweg 365,2023-05-12,11:00:00,34,8,26,FMN GV 05 Lier
60,Mechelsesteenweg 365,2023-05-12,12:00:00,44,18,26,FMN GV 05 Lier
60,Mechelsesteenweg 365,2023-05-12,13:00:00,54,20,34,FMN GV 05 Lier
60,Mechelsesteenweg 365,2023-05-12,14:00:00,76,30,46,FMN GV 05 Lier
60,Mechelsesteenweg 365,2023-05-12,15:00:00,98,36,62,FMN GV 05 Lier
60,Mechelsesteenweg 365,2023-05-12,16:00:00,140,38,102,FMN GV 05 Lier
60,Mechelsesteenweg 365,2023-05-12,17:00:00,72,34,38,FMN GV 05 Lier
60,Mechelsesteenweg 365,2023-05-12,18:00:00,50,26,24,FMN GV 05 Lier
60,Mechelsesteenweg 365,2023-05-12,19:00:00,44,18,26,FMN GV 05 Lier
60,Mechelsesteenweg 365,2023-05-12,20:00:00,28,10,18,FMN GV 05 Lier
60,Mechelsesteenweg 365,2023-05-12,21:00:00,12,2,10,FMN GV 05 Lier
60,Mechelsesteenweg 365,2023-05-12,22:00:00,10,6,4,FMN GV 05 Lier
60,Mechelsesteenweg 365,2023-05-12,23:00:00,2,0,2,FMN GV 05 Lier
60,Mechelsesteenweg 365,2023-05-13,00:00:00,10,4,6,FMN GV 05 Lier
60,Mechelsesteenweg 365,2023-05-13,01:00:00,0,0,0,FMN GV 05 Lier
60,Mechelsesteenweg 365,2023-05-13,02:00:00,8,0,8,FMN GV 05 Lier
60,Mechelsesteenweg 365,2023-05-13,03:00:00,0,0,0,FMN GV 05 Lier
60,Mechelsesteenweg 365,2023-05-13,04:00:00,0,0,0,FMN GV 05 Lier
60,Mechelsesteenweg 365,2023-05-13,05:00:00,4,2,2,FMN GV 05 Lier
60,Mechelsesteenweg 365,2023-05-13,06:00:00,24,10,14,FMN GV 05 Lier
60,Mechelsesteenweg 365,2023-05-13,07:00:00,12,8,4,FMN GV 05 Lier
60,Mechelsesteenweg 365,2023-05-13,08:00:00,64,42,22,FMN GV 05 Lier
60,Mechelsesteenweg 365,2023-05-13,09:00:00,128,64,64,FMN GV 05 Lier
60,Mechelsesteenweg 365,2023-05-13,10:00:00,370,202,168,FMN GV 05 Lier
60,Mechelsesteenweg 365,2023-05-13,11:00:00,358,158,200,FMN GV 05 Lier
60,Mechelsesteenweg 365,2023-05-13,12:00:00,272,138,134,FMN GV 05 Lier
60,Mechelsesteenweg 365,2023-05-13,13:00:00,136,60,76,FMN GV 05 Lier
60,Mechelsesteenweg 365,2023-05-13,14:00:00,154,64,90,FMN GV 05 Lier
60,Mechelsesteenweg 365,2023-05-13,15:00:00,328,146,182,FMN GV 05 Lier
60,Mechelsesteenweg 365,2023-05-13,16:00:00,252,94,158,FMN GV 05 Lier
60,Mechelsesteenweg 365,2023-05-13,17:00:00,206,82,124,FMN GV 05 Lier
60,Mechelsesteenweg 365,2023-05-13,18:00:00,104,40,64,FMN GV 05 Lier
60,Mechelsesteenweg 365,2023-05-13,19:00:00,94,46,48,FMN GV 05 Lier
60,Mechelsesteenweg 365,2023-05-13,20:00:00,58,26,32,FMN GV 05 Lier
60,Mechelsesteenweg 365,2023-05-13,21:00:00,26,8,18,FMN GV 05 Lier
60,Mechelsesteenweg 365,2023-05-13,22:00:00,10,2,8,FMN GV 05 Lier
60,Mechelsesteenweg 365,2023-05-13,23:00:00,2,0,2,FMN GV 05 Lier
60,Mechelsesteenweg 365,2023-05-14,00:00:00,4,0,4,FMN GV 05 Lier
60,Mechelsesteenweg 365,2023-05-14,01:00:00,2,0,2,FMN GV 05 Lier
60,Mechelsesteenweg 365,2023-05-14,02:00:00,2,0,2,FMN GV 05 Lier
60,Mechelsesteenweg 365,2023-05-14,03:00:00,0,0,0,FMN GV 05 Lier
60,Mechelsesteenweg 365,2023-05-14,04:00:00,2,0,2,FMN GV 05 Lier
60,Mechelsesteenweg 365,2023-05-14,05:00:00,4,4,0,FMN GV 05 Lier
60,Mechelsesteenweg 365,2023-05-14,06:00:00,20,12,8,FMN GV 05 Lier
60,Mechelsesteenweg 365,2023-05-14,07:00:00,24,12,12,FMN GV 05 Lier
60,Mechelsesteenweg 365,2023-05-14,08:00:00,90,40,50,FMN GV 05 Lier
60,Mechelsesteenweg 365,2023-05-14,09:00:00,288,208,80,FMN GV 05 Lier
60,Mechelsesteenweg 365,2023-05-14,10:00:00,476,272,204,FMN GV 05 Lier
60,Mechelsesteenweg 365,2023-05-14,11:00:00,442,186,256,FMN GV 05 Lier
60,Mechelsesteenweg 365,2023-05-14,12:00:00,338,164,174,FMN GV 05 Lier
60,Mechelsesteenweg 365,2023-05-14,13:00:00,216,90,126,FMN GV 05 Lier
60,Mechelsesteenweg 365,2023-05-14,14:00:00,184,68,116,FMN GV 05 Lier
60,Mechelsesteenweg 365,2023-05-14,15:00:00,302,132,170,FMN GV 05 Lier
60,Mechelsesteenweg 365,2023-05-14,16:00:00,390,144,246,FMN GV 05 Lier
60,Mechelsesteenweg 365,2023-05-14,17:00:00,268,90,178,FMN GV 05 Lier
60,Mechelsesteenweg 365,2023-05-14,18:00:00,108,36,72,FMN GV 05 Lier
60,Mechelsesteenweg 365,2023-05-14,19:00:00,48,18,30,FMN GV 05 Lier
60,Mechelsesteenweg 365,2023-05-14,20:00:00,56,22,34,FMN GV 05 Lier
60,Mechelsesteenweg 365,2023-05-14,21:00:00,12,2,10,FMN GV 05 Lier
60,Mechelsesteenweg 365,2023-05-14,22:00:00,8,4,4,FMN GV 05 Lier
60,Mechelsesteenweg 365,2023-05-14,23:00:00,2,0,2,FMN GV 05 Lier
60,Mechelsesteenweg 365,2023-05-15,00:00:00,0,0,0,FMN GV 05 Lier
60,Mechelsesteenweg 365,2023-05-15,01:00:00,0,0,0,FMN GV 05 Lier
60,Mechelsesteenweg 365,2023-05-15,02:00:00,0,0,0,FMN GV 05 Lier
60,Mechelsesteenweg 365,2023-05-15,03:00:00,0,0,0,FMN GV 05 Lier
60,Mechelsesteenweg 365,2023-05-15,04:00:00,0,0,0,FMN GV 05 Lier
60,Mechelsesteenweg 365,2023-05-15,05:00:00,6,0,6,FMN GV 05 Lier
60,Mechelsesteenweg 365,2023-05-15,06:00:00,26,12,14,FMN GV 05 Lier
60,Mechelsesteenweg 365,2023-05-15,07:00:00,128,58,70,FMN GV 05 Lier
60,Mechelsesteenweg 365,2023-05-15,08:00:00,162,88,74,FMN GV 05 Lier
60,Mechelsesteenweg 365,2023-05-15,09:00:00,174,100,74,FMN GV 05 Lier
60,Mechelsesteenweg 365,2023-05-15,10:00:00,104,34,70,FMN GV 05 Lier
60,Mechelsesteenweg 365,2023-05-15,11:00:00,58,28,30,FMN GV 05 Lier
60,Mechelsesteenweg 365,2023-05-15,12:00:00,68,22,46,FMN GV 05 Lier
60,Mechelsesteenweg 365,2023-05-15,13:00:00,46,20,26,FMN GV 05 Lier
60,Mechelsesteenweg 365,2023-05-15,14:00:00,40,14,26,FMN GV 05 Lier
60,Mechelsesteenweg 365,2023-05-15,15:00:00,50,24,26,FMN GV 05 Lier
60,Mechelsesteenweg 365,2023-05-15,16:00:00,170,48,122,FMN GV 05 Lier
60,Mechelsesteenweg 365,2023-05-15,17:00:00,106,74,32,FMN GV 05 Lier
60,Mechelsesteenweg 365,2023-05-15,18:00:00,26,16,10,FMN GV 05 Lier
60,Mechelsesteenweg 365,2023-05-15,19:00:00,28,14,14,FMN GV 05 Lier
60,Mechelsesteenweg 365,2023-05-15,20:00:00,16,4,12,FMN GV 05 Lier
60,Mechelsesteenweg 365,2023-05-15,21:00:00,6,2,4,FMN GV 05 Lier
60,Mechelsesteenweg 365,2023-05-15,22:00:00,8,4,4,FMN GV 05 Lier
60,Mechelsesteenweg 365,2023-05-15,23:00:00,0,0,0,FMN GV 05 Lier
60,Mechelsesteenweg 365,2023-05-16,00:00:00,0,0,0,FMN GV 05 Lier
60,Mechelsesteenweg 365,2023-05-16,01:00:00,0,0,0,FMN GV 05 Lier
60,Mechelsesteenweg 365,2023-05-16,02:00:00,0,0,0,FMN GV 05 Lier
60,Mechelsesteenweg 365,2023-05-16,03:00:00,0,0,0,FMN GV 05 Lier
60,Mechelsesteenweg 365,2023-05-16,04:00:00,0,0,0,FMN GV 05 Lier
60,Mechelsesteenweg 365,2023-05-16,05:00:00,6,2,4,FMN GV 05 Lier
60,Mechelsesteenweg 365,2023-05-16,06:00:00,26,4,22,FMN GV 05 Lier
60,Mechelsesteenweg 365,2023-05-16,07:00:00,166,72,94,FMN GV 05 Lier
60,Mechelsesteenweg 365,2023-05-16,08:00:00,160,70,90,FMN GV 05 Lier
60,Mechelsesteenweg 365,2023-05-16,09:00:00,84,30,54,FMN GV 05 Lier
60,Mechelsesteenweg 365,2023-05-16,10:00:00,78,38,40,FMN GV 05 Lier
60,Mechelsesteenweg 365,2023-05-16,11:00:00,102,36,66,FMN GV 05 Lier
60,Mechelsesteenweg 365,2023-05-16,12:00:00,82,46,36,FMN GV 05 Lier
60,Mechelsesteenweg 365,2023-05-16,13:00:00,150,54,96,FMN GV 05 Lier
60,Mechelsesteenweg 365,2023-05-16,14:00:00,146,64,82,FMN GV 05 Lier
60,Mechelsesteenweg 365,2023-05-16,15:00:00,174,68,106,FMN GV 05 Lier
60,Mechelsesteenweg 365,2023-05-16,16:00:00,246,90,156,FMN GV 05 Lier
60,Mechelsesteenweg 365,2023-05-16,17:00:00,168,96,72,FMN GV 05 Lier
60,Mechelsesteenweg 365,2023-05-16,18:00:00,138,68,70,FMN GV 05 Lier
60,Mechelsesteenweg 365,2023-05-16,19:00:00,112,48,64,FMN GV 05 Lier
60,Mechelsesteenweg 365,2023-05-16,20:00:00,72,36,36,FMN GV 05 Lier
60,Mechelsesteenweg 365,2023-05-16,21:00:00,16,4,12,FMN GV 05 Lier
60,Mechelsesteenweg 365,2023-05-16,22:00:00,4,4,0,FMN GV 05 Lier
60,Mechelsesteenweg 365,2023-05-16,23:00:00,2,0,2,FMN GV 05 Lier
60,Mechelsesteenweg 365,2023-05-17,00:00:00,0,0,0,FMN GV 05 Lier
60,Mechelsesteenweg 365,2023-05-17,01:00:00,0,0,0,FMN GV 05 Lier
60,Mechelsesteenweg 365,2023-05-17,02:00:00,0,0,0,FMN GV 05 Lier
60,Mechelsesteenweg 365,2023-05-17,03:00:00,0,0,0,FMN GV 05 Lier
60,Mechelsesteenweg 365,2023-05-17,04:00:00,0,0,0,FMN GV 05 Lier
60,Mechelsesteenweg 365,2023-05-17,05:00:00,6,2,4,FMN GV 05 Lier
60,Mechelsesteenweg 365,2023-05-17,06:00:00,28,8,20,FMN GV 05 Lier
60,Mechelsesteenweg 365,2023-05-17,07:00:00,116,44,72,FMN GV 05 Lier
60,Mechelsesteenweg 365,2023-05-17,08:00:00,158,92,66,FMN GV 05 Lier
60,Mechelsesteenweg 365,2023-05-17,09:00:00,100,62,38,FMN GV 05 Lier
60,Mechelsesteenweg 365,2023-05-17,10:00:00,60,24,36,FMN GV 05 Lier
60,Mechelsesteenweg 365,2023-05-17,11:00:00,60,20,40,FMN GV 05 Lier
60,Mechelsesteenweg 365,2023-05-17,12:00:00,206,54,152,FMN GV 05 Lier
60,Mechelsesteenweg 365,2023-05-17,13:00:00,128,30,98,FMN GV 05 Lier
60,Mechelsesteenweg 365,2023-05-17,14:00:00,142,66,76,FMN GV 05 Lier
60,Mechelsesteenweg 365,2023-05-17,15:00:00,132,80,52,FMN GV 05 Lier
60,Mechelsesteenweg 365,2023-05-17,16:00:00,144,78,66,FMN GV 05 Lier
60,Mechelsesteenweg 365,2023-05-17,17:00:00,156,74,82,FMN GV 05 Lier
60,Mechelsesteenweg 365,2023-05-17,18:00:00,116,66,50,FMN GV 05 Lier
60,Mechelsesteenweg 365,2023-05-17,19:00:00,104,44,60,FMN GV 05 Lier
60,Mechelsesteenweg 365,2023-05-17,20:00:00,108,70,38,FMN GV 05 Lier
60,Mechelsesteenweg 365,2023-05-17,21:00:00,18,14,4,FMN GV 05 Lier
60,Mechelsesteenweg 365,2023-05-17,22:00:00,12,8,4,FMN GV 05 Lier
60,Mechelsesteenweg 365,2023-05-17,23:00:00,4,2,2,FMN GV 05 Lier
60,Mechelsesteenweg 365,2023-05-18,00:00:00,4,0,4,FMN GV 05 Lier
60,Mechelsesteenweg 365,2023-05-18,01:00:00,0,0,0,FMN GV 05 Lier
60,Mechelsesteenweg 365,2023-05-18,02:00:00,0,0,0,FMN GV 05 Lier
60,Mechelsesteenweg 365,2023-05-18,03:00:00,0,0,0,FMN GV 05 Lier
60,Mechelsesteenweg 365,2023-05-18,04:00:00,0,0,0,FMN GV 05 Lier
60,Mechelsesteenweg 365,2023-05-18,05:00:00,2,0,2,FMN GV 05 Lier
60,Mechelsesteenweg 365,2023-05-18,06:00:00,12,2,10,FMN GV 05 Lier
60,Mechelsesteenweg 365,2023-05-18,07:00:00,10,6,4,FMN GV 05 Lier
60,Mechelsesteenweg 365,2023-05-18,08:00:00,46,24,22,FMN GV 05 Lier
60,Mechelsesteenweg 365,2023-05-18,09:00:00,128,66,62,FMN GV 05 Lier
60,Mechelsesteenweg 365,2023-05-18,10:00:00,202,94,108,FMN GV 05 Lier
60,Mechelsesteenweg 365,2023-05-18,11:00:00,248,104,144,FMN GV 05 Lier
60,Mechelsesteenweg 365,2023-05-18,12:00:00,288,100,188,FMN GV 05 Lier
60,Mechelsesteenweg 365,2023-05-18,13:00:00,406,264,142,FMN GV 05 Lier
60,Mechelsesteenweg 365,2023-05-18,14:00:00,378,176,202,FMN GV 05 Lier
60,Mechelsesteenweg 365,2023-05-18,15:00:00,382,174,208,FMN GV 05 Lier
60,Mechelsesteenweg 365,2023-05-18,16:00:00,342,130,212,FMN GV 05 Lier
60,Mechelsesteenweg 365,2023-05-18,17:00:00,166,72,94,FMN GV 05 Lier
60,Mechelsesteenweg 365,2023-05-18,18:00:00,84,50,34,FMN GV 05 Lier
60,Mechelsesteenweg 365,2023-05-18,19:00:00,68,38,30,FMN GV 05 Lier
60,Mechelsesteenweg 365,2023-05-18,20:00:00,50,16,34,FMN GV 05 Lier
60,Mechelsesteenweg 365,2023-05-18,21:00:00,20,4,16,FMN GV 05 Lier
60,Mechelsesteenweg 365,2023-05-18,22:00:00,12,2,10,FMN GV 05 Lier
60,Mechelsesteenweg 365,2023-05-18,23:00:00,6,2,4,FMN GV 05 Lier
60,Mechelsesteenweg 365,2023-05-19,00:00:00,0,0,0,FMN GV 05 Lier
60,Mechelsesteenweg 365,2023-05-19,01:00:00,0,0,0,FMN GV 05 Lier
60,Mechelsesteenweg 365,2023-05-19,02:00:00,2,0,2,FMN GV 05 Lier
60,Mechelsesteenweg 365,2023-05-19,03:00:00,0,0,0,FMN GV 05 Lier
60,Mechelsesteenweg 365,2023-05-19,04:00:00,0,0,0,FMN GV 05 Lier
60,Mechelsesteenweg 365,2023-05-19,05:00:00,4,0,4,FMN GV 05 Lier
60,Mechelsesteenweg 365,2023-05-19,06:00:00,12,4,8,FMN GV 05 Lier
60,Mechelsesteenweg 365,2023-05-19,07:00:00,24,6,18,FMN GV 05 Lier
60,Mechelsesteenweg 365,2023-05-19,08:00:00,38,12,26,FMN GV 05 Lier
60,Mechelsesteenweg 365,2023-05-19,09:00:00,80,40,40,FMN GV 05 Lier
60,Mechelsesteenweg 365,2023-05-19,10:00:00,152,68,84,FMN GV 05 Lier
60,Mechelsesteenweg 365,2023-05-19,11:00:00,230,112,118,FMN GV 05 Lier
60,Mechelsesteenweg 365,2023-05-19,12:00:00,164,74,90,FMN GV 05 Lier
60,Mechelsesteenweg 365,2023-05-19,13:00:00,158,80,78,FMN GV 05 Lier
60,Mechelsesteenweg 365,2023-05-19,14:00:00,12,4,8,FMN GV 05 Lier
60,Mechelsesteenweg 365,2023-05-19,15:00:00,16,12,4,FMN GV 05 Lier
60,Mechelsesteenweg 365,2023-05-19,16:00:00,40,14,26,FMN GV 05 Lier
60,Mechelsesteenweg 365,2023-05-19,17:00:00,172,68,104,FMN GV 05 Lier
60,Mechelsesteenweg 365,2023-05-19,18:00:00,76,40,36,FMN GV 05 Lier
60,Mechelsesteenweg 365,2023-05-19,19:00:00,100,44,56,FMN GV 05 Lier
60,Mechelsesteenweg 365,2023-05-19,20:00:00,40,18,22,FMN GV 05 Lier
60,Mechelsesteenweg 365,2023-05-19,21:00:00,28,6,22,FMN GV 05 Lier
60,Mechelsesteenweg 365,2023-05-19,22:00:00,12,8,4,FMN GV 05 Lier
60,Mechelsesteenweg 365,2023-05-19,23:00:00,8,2,6,FMN GV 05 Lier
60,Mechelsesteenweg 365,2023-05-20,00:00:00,2,2,0,FMN GV 05 Lier
60,Mechelsesteenweg 365,2023-05-20,01:00:00,10,4,6,FMN GV 05 Lier
60,Mechelsesteenweg 365,2023-05-20,02:00:00,2,0,2,FMN GV 05 Lier
60,Mechelsesteenweg 365,2023-05-20,03:00:00,0,0,0,FMN GV 05 Lier
60,Mechelsesteenweg 365,2023-05-20,04:00:00,0,0,0,FMN GV 05 Lier
60,Mechelsesteenweg 365,2023-05-20,05:00:00,4,0,4,FMN GV 05 Lier
60,Mechelsesteenweg 365,2023-05-20,06:00:00,4,2,2,FMN GV 05 Lier
60,Mechelsesteenweg 365,2023-05-20,07:00:00,16,4,12,FMN GV 05 Lier
60,Mechelsesteenweg 365,2023-05-20,08:00:00,36,20,16,FMN GV 05 Lier
60,Mechelsesteenweg 365,2023-05-20,09:00:00,90,58,32,FMN GV 05 Lier
60,Mechelsesteenweg 365,2023-05-20,10:00:00,182,76,106,FMN GV 05 Lier
60,Mechelsesteenweg 365,2023-05-20,11:00:00,242,92,150,FMN GV 05 Lier
60,Mechelsesteenweg 365,2023-05-20,12:00:00,158,70,88,FMN GV 05 Lier
60,Mechelsesteenweg 365,2023-05-20,13:00:00,0,0,0,FMN GV 05 Lier
60,Mechelsesteenweg 365,2023-05-20,14:00:00,0,0,0,FMN GV 05 Lier
60,Mechelsesteenweg 365,2023-05-20,15:00:00,68,16,52,FMN GV 05 Lier
60,Mechelsesteenweg 365,2023-05-20,16:00:00,198,58,140,FMN GV 05 Lier
60,Mechelsesteenweg 365,2023-05-20,17:00:00,140,58,82,FMN GV 05 Lier
60,Mechelsesteenweg 365,2023-05-20,18:00:00,74,40,34,FMN GV 05 Lier
60,Mechelsesteenweg 365,2023-05-20,19:00:00,80,20,60,FMN GV 05 Lier
60,Mechelsesteenweg 365,2023-05-20,20:00:00,24,10,14,FMN GV 05 Lier
60,Mechelsesteenweg 365,2023-05-20,21:00:00,34,28,6,FMN GV 05 Lier
60,Mechelsesteenweg 365,2023-05-20,22:00:00,16,4,12,FMN GV 05 Lier
60,Mechelsesteenweg 365,2023-05-20,23:00:00,2,2,0,FMN GV 05 Lier
60,Mechelsesteenweg 365,2023-05-21,00:00:00,8,0,8,FMN GV 05 Lier
60,Mechelsesteenweg 365,2023-05-21,01:00:00,0,0,0,FMN GV 05 Lier
60,Mechelsesteenweg 365,2023-05-21,02:00:00,0,0,0,FMN GV 05 Lier
60,Mechelsesteenweg 365,2023-05-21,03:00:00,0,0,0,FMN GV 05 Lier
60,Mechelsesteenweg 365,2023-05-21,04:00:00,2,0,2,FMN GV 05 Lier
60,Mechelsesteenweg 365,2023-05-21,05:00:00,2,0,2,FMN GV 05 Lier
60,Mechelsesteenweg 365,2023-05-21,06:00:00,4,4,0,FMN GV 05 Lier
60,Mechelsesteenweg 365,2023-05-21,07:00:00,26,18,8,FMN GV 05 Lier
60,Mechelsesteenweg 365,2023-05-21,08:00:00,58,30,28,FMN GV 05 Lier
60,Mechelsesteenweg 365,2023-05-21,09:00:00,194,108,86,FMN GV 05 Lier
60,Mechelsesteenweg 365,2023-05-21,10:00:00,344,124,220,FMN GV 05 Lier
60,Mechelsesteenweg 365,2023-05-21,11:00:00,450,204,246,FMN GV 05 Lier
60,Mechelsesteenweg 365,2023-05-21,12:00:00,180,60,120,FMN GV 05 Lier
60,Mechelsesteenweg 365,2023-05-21,13:00:00,182,88,94,FMN GV 05 Lier
60,Mechelsesteenweg 365,2023-05-21,14:00:00,340,184,156,FMN GV 05 Lier
60,Mechelsesteenweg 365,2023-05-21,15:00:00,38,12,26,FMN GV 05 Lier
60,Mechelsesteenweg 365,2023-05-21,16:00:00,282,100,182,FMN GV 05 Lier
60,Mechelsesteenweg 365,2023-05-21,17:00:00,206,64,142,FMN GV 05 Lier
60,Mechelsesteenweg 365,2023-05-21,18:00:00,112,34,78,FMN GV 05 Lier
60,Mechelsesteenweg 365,2023-05-21,19:00:00,80,22,58,FMN GV 05 Lier
60,Mechelsesteenweg 365,2023-05-21,20:00:00,42,20,22,FMN GV 05 Lier
60,Mechelsesteenweg 365,2023-05-21,21:00:00,32,16,16,FMN GV 05 Lier
60,Mechelsesteenweg 365,2023-05-21,22:00:00,4,4,0,FMN GV 05 Lier
60,Mechelsesteenweg 365,2023-05-21,23:00:00,10,8,2,FMN GV 05 Lier
60,Mechelsesteenweg 365,2023-05-22,00:00:00,0,0,0,FMN GV 05 Lier
60,Mechelsesteenweg 365,2023-05-22,01:00:00,0,0,0,FMN GV 05 Lier
60,Mechelsesteenweg 365,2023-05-22,02:00:00,0,0,0,FMN GV 05 Lier
60,Mechelsesteenweg 365,2023-05-22,03:00:00,2,0,2,FMN GV 05 Lier
60,Mechelsesteenweg 365,2023-05-22,04:00:00,0,0,0,FMN GV 05 Lier
60,Mechelsesteenweg 365,2023-05-22,05:00:00,6,0,6,FMN GV 05 Lier
60,Mechelsesteenweg 365,2023-05-22,06:00:00,24,6,18,FMN GV 05 Lier
60,Mechelsesteenweg 365,2023-05-22,07:00:00,144,74,70,FMN GV 05 Lier
60,Mechelsesteenweg 365,2023-05-22,08:00:00,172,90,82,FMN GV 05 Lier
60,Mechelsesteenweg 365,2023-05-22,09:00:00,58,28,30,FMN GV 05 Lier
60,Mechelsesteenweg 365,2023-05-22,10:00:00,60,34,26,FMN GV 05 Lier
60,Mechelsesteenweg 365,2023-05-22,11:00:00,82,44,38,FMN GV 05 Lier
60,Mechelsesteenweg 365,2023-05-22,12:00:00,108,52,56,FMN GV 05 Lier
60,Mechelsesteenweg 365,2023-05-22,13:00:00,72,46,26,FMN GV 05 Lier
60,Mechelsesteenweg 365,2023-05-22,14:00:00,148,68,80,FMN GV 05 Lier
60,Mechelsesteenweg 365,2023-05-22,15:00:00,158,58,100,FMN GV 05 Lier
60,Mechelsesteenweg 365,2023-05-22,16:00:00,236,88,148,FMN GV 05 Lier
60,Mechelsesteenweg 365,2023-05-22,17:00:00,168,106,62,FMN GV 05 Lier
60,Mechelsesteenweg 365,2023-05-22,18:00:00,112,56,56,FMN GV 05 Lier
60,Mechelsesteenweg 365,2023-05-22,19:00:00,82,56,26,FMN GV 05 Lier
60,Mechelsesteenweg 365,2023-05-22,20:00:00,44,30,14,FMN GV 05 Lier
60,Mechelsesteenweg 365,2023-05-22,21:00:00,22,4,18,FMN GV 05 Lier
60,Mechelsesteenweg 365,2023-05-22,22:00:00,12,8,4,FMN GV 05 Lier
60,Mechelsesteenweg 365,2023-05-22,23:00:00,0,0,0,FMN GV 05 Lier
60,Mechelsesteenweg 365,2023-05-23,00:00:00,0,0,0,FMN GV 05 Lier
60,Mechelsesteenweg 365,2023-05-23,01:00:00,0,0,0,FMN GV 05 Lier
60,Mechelsesteenweg 365,2023-05-23,02:00:00,0,0,0,FMN GV 05 Lier
60,Mechelsesteenweg 365,2023-05-23,03:00:00,2,0,2,FMN GV 05 Lier
60,Mechelsesteenweg 365,2023-05-23,04:00:00,2,0,2,FMN GV 05 Lier
60,Mechelsesteenweg 365,2023-05-23,05:00:00,0,0,0,FMN GV 05 Lier
60,Mechelsesteenweg 365,2023-05-23,06:00:00,38,12,26,FMN GV 05 Lier
60,Mechelsesteenweg 365,2023-05-23,07:00:00,152,64,88,FMN GV 05 Lier
60,Mechelsesteenweg 365,2023-05-23,08:00:00,236,110,126,FMN GV 05 Lier
60,Mechelsesteenweg 365,2023-05-23,09:00:00,112,54,58,FMN GV 05 Lier
60,Mechelsesteenweg 365,2023-05-23,10:00:00,74,38,36,FMN GV 05 Lier
60,Mechelsesteenweg 365,2023-05-23,11:00:00,132,70,62,FMN GV 05 Lier
60,Mechelsesteenweg 365,2023-05-23,12:00:00,112,46,66,FMN GV 05 Lier
60,Mechelsesteenweg 365,2023-05-23,13:00:00,100,46,54,FMN GV 05 Lier
60,Mechelsesteenweg 365,2023-05-23,14:00:00,94,64,30,FMN GV 05 Lier
60,Mechelsesteenweg 365,2023-05-23,15:00:00,134,64,70,FMN GV 05 Lier
60,Mechelsesteenweg 365,2023-05-23,16:00:00,170,84,86,FMN GV 05 Lier
60,Mechelsesteenweg 365,2023-05-23,17:00:00,158,98,60,FMN GV 05 Lier
60,Mechelsesteenweg 365,2023-05-23,18:00:00,116,64,52,FMN GV 05 Lier
60,Mechelsesteenweg 365,2023-05-23,19:00:00,100,32,68,FMN GV 05 Lier
60,Mechelsesteenweg 365,2023-05-23,20:00:00,144,60,84,FMN GV 05 Lier
60,Mechelsesteenweg 365,2023-05-23,21:00:00,16,6,10,FMN GV 05 Lier
60,Mechelsesteenweg 365,2023-05-23,22:00:00,14,8,6,FMN GV 05 Lier
60,Mechelsesteenweg 365,2023-05-23,23:00:00,4,4,0,FMN GV 05 Lier
60,Mechelsesteenweg 365,2023-05-24,00:00:00,4,2,2,FMN GV 05 Lier
60,Mechelsesteenweg 365,2023-05-24,01:00:00,0,0,0,FMN GV 05 Lier
60,Mechelsesteenweg 365,2023-05-24,02:00:00,0,0,0,FMN GV 05 Lier
60,Mechelsesteenweg 365,2023-05-24,03:00:00,0,0,0,FMN GV 05 Lier
60,Mechelsesteenweg 365,2023-05-24,04:00:00,0,0,0,FMN GV 05 Lier
60,Mechelsesteenweg 365,2023-05-24,05:00:00,8,4,4,FMN GV 05 Lier
60,Mechelsesteenweg 365,2023-05-24,06:00:00,44,8,36,FMN GV 05 Lier
60,Mechelsesteenweg 365,2023-05-24,07:00:00,154,78,76,FMN GV 05 Lier
60,Mechelsesteenweg 365,2023-05-24,08:00:00,180,94,86,FMN GV 05 Lier
60,Mechelsesteenweg 365,2023-05-24,09:00:00,72,28,44,FMN GV 05 Lier
60,Mechelsesteenweg 365,2023-05-24,10:00:00,98,42,56,FMN GV 05 Lier
60,Mechelsesteenweg 365,2023-05-24,11:00:00,108,38,70,FMN GV 05 Lier
60,Mechelsesteenweg 365,2023-05-24,12:00:00,48,18,30,FMN GV 05 Lier
60,Mechelsesteenweg 365,2023-05-24,13:00:00,184,80,104,FMN GV 05 Lier
60,Mechelsesteenweg 365,2023-05-24,14:00:00,132,72,60,FMN GV 05 Lier
60,Mechelsesteenweg 365,2023-05-24,15:00:00,146,58,88,FMN GV 05 Lier
60,Mechelsesteenweg 365,2023-05-24,16:00:00,178,112,66,FMN GV 05 Lier
60,Mechelsesteenweg 365,2023-05-24,17:00:00,156,94,62,FMN GV 05 Lier
60,Mechelsesteenweg 365,2023-05-24,18:00:00,146,86,60,FMN GV 05 Lier
60,Mechelsesteenweg 365,2023-05-24,19:00:00,152,94,58,FMN GV 05 Lier
60,Mechelsesteenweg 365,2023-05-24,20:00:00,198,132,66,FMN GV 05 Lier
60,Mechelsesteenweg 365,2023-05-24,21:00:00,34,12,22,FMN GV 05 Lier
60,Mechelsesteenweg 365,2023-05-24,22:00:00,20,12,8,FMN GV 05 Lier
60,Mechelsesteenweg 365,2023-05-24,23:00:00,4,2,2,FMN GV 05 Lier
60,Mechelsesteenweg 365,2023-05-25,00:00:00,0,0,0,FMN GV 05 Lier
60,Mechelsesteenweg 365,2023-05-25,01:00:00,0,0,0,FMN GV 05 Lier
60,Mechelsesteenweg 365,2023-05-25,02:00:00,0,0,0,FMN GV 05 Lier
60,Mechelsesteenweg 365,2023-05-25,03:00:00,2,0,2,FMN GV 05 Lier
60,Mechelsesteenweg 365,2023-05-25,04:00:00,0,0,0,FMN GV 05 Lier
60,Mechelsesteenweg 365,2023-05-25,05:00:00,12,6,6,FMN GV 05 Lier
60,Mechelsesteenweg 365,2023-05-25,06:00:00,40,12,28,FMN GV 05 Lier
60,Mechelsesteenweg 365,2023-05-25,07:00:00,158,80,78,FMN GV 05 Lier
60,Mechelsesteenweg 365,2023-05-25,08:00:00,218,114,104,FMN GV 05 Lier
60,Mechelsesteenweg 365,2023-05-25,09:00:00,104,38,66,FMN GV 05 Lier
60,Mechelsesteenweg 365,2023-05-25,10:00:00,92,40,52,FMN GV 05 Lier
60,Mechelsesteenweg 365,2023-05-25,11:00:00,68,36,32,FMN GV 05 Lier
60,Mechelsesteenweg 365,2023-05-25,12:00:00,138,62,76,FMN GV 05 Lier
60,Mechelsesteenweg 365,2023-05-25,13:00:00,82,24,58,FMN GV 05 Lier
60,Mechelsesteenweg 365,2023-05-25,14:00:00,214,114,100,FMN GV 05 Lier
60,Mechelsesteenweg 365,2023-05-25,15:00:00,72,28,44,FMN GV 05 Lier
60,Mechelsesteenweg 365,2023-05-25,16:00:00,182,90,92,FMN GV 05 Lier
60,Mechelsesteenweg 365,2023-05-25,17:00:00,240,130,110,FMN GV 05 Lier
60,Mechelsesteenweg 365,2023-05-25,18:00:00,96,48,48,FMN GV 05 Lier
60,Mechelsesteenweg 365,2023-05-25,19:00:00,122,70,52,FMN GV 05 Lier
60,Mechelsesteenweg 365,2023-05-25,20:00:00,146,56,90,FMN GV 05 Lier
60,Mechelsesteenweg 365,2023-05-25,21:00:00,50,30,20,FMN GV 05 Lier
60,Mechelsesteenweg 365,2023-05-25,22:00:00,16,4,12,FMN GV 05 Lier
60,Mechelsesteenweg 365,2023-05-25,23:00:00,2,2,0,FMN GV 05 Lier
60,Mechelsesteenweg 365,2023-05-26,00:00:00,6,4,2,FMN GV 05 Lier
60,Mechelsesteenweg 365,2023-05-26,01:00:00,0,0,0,FMN GV 05 Lier
60,Mechelsesteenweg 365,2023-05-26,02:00:00,2,2,0,FMN GV 05 Lier
60,Mechelsesteenweg 365,2023-05-26,03:00:00,0,0,0,FMN GV 05 Lier
60,Mechelsesteenweg 365,2023-05-26,04:00:00,0,0,0,FMN GV 05 Lier
60,Mechelsesteenweg 365,2023-05-26,05:00:00,12,4,8,FMN GV 05 Lier
60,Mechelsesteenweg 365,2023-05-26,06:00:00,24,6,18,FMN GV 05 Lier
60,Mechelsesteenweg 365,2023-05-26,07:00:00,146,62,84,FMN GV 05 Lier
60,Mechelsesteenweg 365,2023-05-26,08:00:00,140,92,48,FMN GV 05 Lier
60,Mechelsesteenweg 365,2023-05-26,09:00:00,66,24,42,FMN GV 05 Lier
60,Mechelsesteenweg 365,2023-05-26,10:00:00,94,46,48,FMN GV 05 Lier
60,Mechelsesteenweg 365,2023-05-26,11:00:00,120,58,62,FMN GV 05 Lier
60,Mechelsesteenweg 365,2023-05-26,12:00:00,12,6,6,FMN GV 05 Lier
60,Mechelsesteenweg 365,2023-05-26,13:00:00,0,0,0,FMN GV 05 Lier
60,Mechelsesteenweg 365,2023-05-26,14:00:00,0,0,0,FMN GV 05 Lier
60,Mechelsesteenweg 365,2023-05-26,15:00:00,0,0,0,FMN GV 05 Lier
60,Mechelsesteenweg 365,2023-05-26,16:00:00,12,4,8,FMN GV 05 Lier
60,Mechelsesteenweg 365,2023-05-26,17:00:00,136,76,60,FMN GV 05 Lier
60,Mechelsesteenweg 365,2023-05-26,18:00:00,120,78,42,FMN GV 05 Lier
60,Mechelsesteenweg 365,2023-05-26,19:00:00,74,24,50,FMN GV 05 Lier
60,Mechelsesteenweg 365,2023-05-26,20:00:00,60,16,44,FMN GV 05 Lier
60,Mechelsesteenweg 365,2023-05-26,21:00:00,42,24,18,FMN GV 05 Lier
60,Mechelsesteenweg 365,2023-05-26,22:00:00,8,0,8,FMN GV 05 Lier
60,Mechelsesteenweg 365,2023-05-26,23:00:00,6,4,2,FMN GV 05 Lier
60,Mechelsesteenweg 365,2023-05-27,00:00:00,4,2,2,FMN GV 05 Lier
60,Mechelsesteenweg 365,2023-05-27,01:00:00,0,0,0,FMN GV 05 Lier
60,Mechelsesteenweg 365,2023-05-27,02:00:00,0,0,0,FMN GV 05 Lier
60,Mechelsesteenweg 365,2023-05-27,03:00:00,0,0,0,FMN GV 05 Lier
60,Mechelsesteenweg 365,2023-05-27,04:00:00,0,0,0,FMN GV 05 Lier
60,Mechelsesteenweg 365,2023-05-27,05:00:00,2,0,2,FMN GV 05 Lier
60,Mechelsesteenweg 365,2023-05-27,06:00:00,2,0,2,FMN GV 05 Lier
60,Mechelsesteenweg 365,2023-05-27,07:00:00,8,4,4,FMN GV 05 Lier
60,Mechelsesteenweg 365,2023-05-27,08:00:00,54,24,30,FMN GV 05 Lier
60,Mechelsesteenweg 365,2023-05-27,09:00:00,136,92,44,FMN GV 05 Lier
60,Mechelsesteenweg 365,2023-05-27,10:00:00,210,98,112,FMN GV 05 Lier
60,Mechelsesteenweg 365,2023-05-27,11:00:00,244,92,152,FMN GV 05 Lier
60,Mechelsesteenweg 365,2023-05-27,12:00:00,6,6,0,FMN GV 05 Lier
60,Mechelsesteenweg 365,2023-05-27,13:00:00,0,0,0,FMN GV 05 Lier
60,Mechelsesteenweg 365,2023-05-27,14:00:00,0,0,0,FMN GV 05 Lier
60,Mechelsesteenweg 365,2023-05-27,15:00:00,0,0,0,FMN GV 05 Lier
60,Mechelsesteenweg 365,2023-05-27,16:00:00,0,0,0,FMN GV 05 Lier
60,Mechelsesteenweg 365,2023-05-27,17:00:00,66,20,46,FMN GV 05 Lier
60,Mechelsesteenweg 365,2023-05-27,18:00:00,114,46,68,FMN GV 05 Lier
60,Mechelsesteenweg 365,2023-05-27,19:00:00,90,28,62,FMN GV 05 Lier
60,Mechelsesteenweg 365,2023-05-27,20:00:00,102,54,48,FMN GV 05 Lier
60,Mechelsesteenweg 365,2023-05-27,21:00:00,48,20,28,FMN GV 05 Lier
60,Mechelsesteenweg 365,2023-05-27,22:00:00,24,8,16,FMN GV 05 Lier
60,Mechelsesteenweg 365,2023-05-27,23:00:00,8,2,6,FMN GV 05 Lier
60,Mechelsesteenweg 365,2023-05-28,00:00:00,2,0,2,FMN GV 05 Lier
60,Mechelsesteenweg 365,2023-05-28,01:00:00,0,0,0,FMN GV 05 Lier
60,Mechelsesteenweg 365,2023-05-28,02:00:00,0,0,0,FMN GV 05 Lier
60,Mechelsesteenweg 365,2023-05-28,03:00:00,0,0,0,FMN GV 05 Lier
60,Mechelsesteenweg 365,2023-05-28,04:00:00,0,0,0,FMN GV 05 Lier
60,Mechelsesteenweg 365,2023-05-28,05:00:00,0,0,0,FMN GV 05 Lier
60,Mechelsesteenweg 365,2023-05-28,06:00:00,6,6,0,FMN GV 05 Lier
60,Mechelsesteenweg 365,2023-05-28,07:00:00,24,10,14,FMN GV 05 Lier
60,Mechelsesteenweg 365,2023-05-28,08:00:00,54,14,40,FMN GV 05 Lier
60,Mechelsesteenweg 365,2023-05-28,09:00:00,198,96,102,FMN GV 05 Lier
60,Mechelsesteenweg 365,2023-05-28,10:00:00,412,216,196,FMN GV 05 Lier
60,Mechelsesteenweg 365,2023-05-28,11:00:00,462,184,278,FMN GV 05 Lier
60,Mechelsesteenweg 365,2023-05-28,12:00:00,16,4,12,FMN GV 05 Lier
60,Mechelsesteenweg 365,2023-05-28,13:00:00,0,0,0,FMN GV 05 Lier
60,Mechelsesteenweg 365,2023-05-28,14:00:00,0,0,0,FMN GV 05 Lier
60,Mechelsesteenweg 365,2023-05-28,15:00:00,0,0,0,FMN GV 05 Lier
60,Mechelsesteenweg 365,2023-05-28,16:00:00,0,0,0,FMN GV 05 Lier
60,Mechelsesteenweg 365,2023-05-28,17:00:00,74,30,44,FMN GV 05 Lier
60,Mechelsesteenweg 365,2023-05-28,18:00:00,122,54,68,FMN GV 05 Lier
60,Mechelsesteenweg 365,2023-05-28,19:00:00,102,40,62,FMN GV 05 Lier
60,Mechelsesteenweg 365,2023-05-28,20:00:00,76,36,40,FMN GV 05 Lier
60,Mechelsesteenweg 365,2023-05-28,21:00:00,32,6,26,FMN GV 05 Lier
60,Mechelsesteenweg 365,2023-05-28,22:00:00,6,2,4,FMN GV 05 Lier
60,Mechelsesteenweg 365,2023-05-28,23:00:00,10,2,8,FMN GV 05 Lier
60,Mechelsesteenweg 365,2023-05-29,00:00:00,0,0,0,FMN GV 05 Lier
60,Mechelsesteenweg 365,2023-05-29,01:00:00,0,0,0,FMN GV 05 Lier
60,Mechelsesteenweg 365,2023-05-29,02:00:00,0,0,0,FMN GV 05 Lier
60,Mechelsesteenweg 365,2023-05-29,03:00:00,0,0,0,FMN GV 05 Lier
60,Mechelsesteenweg 365,2023-05-29,04:00:00,0,0,0,FMN GV 05 Lier
60,Mechelsesteenweg 365,2023-05-29,05:00:00,0,0,0,FMN GV 05 Lier
60,Mechelsesteenweg 365,2023-05-29,06:00:00,14,8,6,FMN GV 05 Lier
60,Mechelsesteenweg 365,2023-05-29,07:00:00,6,0,6,FMN GV 05 Lier
60,Mechelsesteenweg 365,2023-05-29,08:00:00,50,14,36,FMN GV 05 Lier
60,Mechelsesteenweg 365,2023-05-29,09:00:00,196,64,132,FMN GV 05 Lier
60,Mechelsesteenweg 365,2023-05-29,10:00:00,270,130,140,FMN GV 05 Lier
60,Mechelsesteenweg 365,2023-05-29,11:00:00,312,176,136,FMN GV 05 Lier
60,Mechelsesteenweg 365,2023-05-29,12:00:00,126,48,78,FMN GV 05 Lier
60,Mechelsesteenweg 365,2023-05-29,13:00:00,0,0,0,FMN GV 05 Lier
60,Mechelsesteenweg 365,2023-05-29,14:00:00,0,0,0,FMN GV 05 Lier
60,Mechelsesteenweg 365,2023-05-29,15:00:00,34,20,14,FMN GV 05 Lier
60,Mechelsesteenweg 365,2023-05-29,16:00:00,346,150,196,FMN GV 05 Lier
60,Mechelsesteenweg 365,2023-05-29,17:00:00,240,102,138,FMN GV 05 Lier
60,Mechelsesteenweg 365,2023-05-29,18:00:00,136,60,76,FMN GV 05 Lier
60,Mechelsesteenweg 365,2023-05-29,19:00:00,52,22,30,FMN GV 05 Lier
60,Mechelsesteenweg 365,2023-05-29,20:00:00,52,10,42,FMN GV 05 Lier
60,Mechelsesteenweg 365,2023-05-29,21:00:00,28,12,16,FMN GV 05 Lier
60,Mechelsesteenweg 365,2023-05-29,22:00:00,6,4,2,FMN GV 05 Lier
60,Mechelsesteenweg 365,2023-05-29,23:00:00,6,0,6,FMN GV 05 Lier
60,Mechelsesteenweg 365,2023-05-30,00:00:00,0,0,0,FMN GV 05 Lier
60,Mechelsesteenweg 365,2023-05-30,01:00:00,0,0,0,FMN GV 05 Lier
60,Mechelsesteenweg 365,2023-05-30,02:00:00,0,0,0,FMN GV 05 Lier
60,Mechelsesteenweg 365,2023-05-30,03:00:00,0,0,0,FMN GV 05 Lier
60,Mechelsesteenweg 365,2023-05-30,04:00:00,0,0,0,FMN GV 05 Lier
60,Mechelsesteenweg 365,2023-05-30,05:00:00,10,2,8,FMN GV 05 Lier
60,Mechelsesteenweg 365,2023-05-30,06:00:00,32,8,24,FMN GV 05 Lier
60,Mechelsesteenweg 365,2023-05-30,07:00:00,174,78,96,FMN GV 05 Lier
60,Mechelsesteenweg 365,2023-05-30,08:00:00,192,102,90,FMN GV 05 Lier
60,Mechelsesteenweg 365,2023-05-30,09:00:00,82,34,48,FMN GV 05 Lier
60,Mechelsesteenweg 365,2023-05-30,10:00:00,78,36,42,FMN GV 05 Lier
60,Mechelsesteenweg 365,2023-05-30,11:00:00,92,48,44,FMN GV 05 Lier
60,Mechelsesteenweg 365,2023-05-30,12:00:00,8,2,6,FMN GV 05 Lier
60,Mechelsesteenweg 365,2023-05-30,13:00:00,0,0,0,FMN GV 05 Lier
60,Mechelsesteenweg 365,2023-05-30,14:00:00,0,0,0,FMN GV 05 Lier
60,Mechelsesteenweg 365,2023-05-30,15:00:00,0,0,0,FMN GV 05 Lier
60,Mechelsesteenweg 365,2023-05-30,16:00:00,0,0,0,FMN GV 05 Lier
60,Mechelsesteenweg 365,2023-05-30,17:00:00,70,34,36,FMN GV 05 Lier
60,Mechelsesteenweg 365,2023-05-30,18:00:00,160,74,86,FMN GV 05 Lier
60,Mechelsesteenweg 365,2023-05-30,19:00:00,90,40,50,FMN GV 05 Lier
60,Mechelsesteenweg 365,2023-05-30,20:00:00,164,68,96,FMN GV 05 Lier
60,Mechelsesteenweg 365,2023-05-30,21:00:00,38,12,26,FMN GV 05 Lier
60,Mechelsesteenweg 365,2023-05-30,22:00:00,10,6,4,FMN GV 05 Lier
60,Mechelsesteenweg 365,2023-05-30,23:00:00,8,4,4,FMN GV 05 Lier
60,Mechelsesteenweg 365,2023-05-31,00:00:00,0,0,0,FMN GV 05 Lier
60,Mechelsesteenweg 365,2023-05-31,01:00:00,0,0,0,FMN GV 05 Lier
60,Mechelsesteenweg 365,2023-05-31,02:00:00,0,0,0,FMN GV 05 Lier
60,Mechelsesteenweg 365,2023-05-31,03:00:00,0,0,0,FMN GV 05 Lier
60,Mechelsesteenweg 365,2023-05-31,04:00:00,2,0,2,FMN GV 05 Lier
60,Mechelsesteenweg 365,2023-05-31,05:00:00,8,2,6,FMN GV 05 Lier
60,Mechelsesteenweg 365,2023-05-31,06:00:00,32,2,30,FMN GV 05 Lier
60,Mechelsesteenweg 365,2023-05-31,07:00:00,192,74,118,FMN GV 05 Lier
60,Mechelsesteenweg 365,2023-05-31,08:00:00,198,82,116,FMN GV 05 Lier
60,Mechelsesteenweg 365,2023-05-31,09:00:00,66,34,32,FMN GV 05 Lier
60,Mechelsesteenweg 365,2023-05-31,10:00:00,108,50,58,FMN GV 05 Lier
60,Mechelsesteenweg 365,2023-05-31,11:00:00,118,48,70,FMN GV 05 Lier
60,Mechelsesteenweg 365,2023-05-31,12:00:00,0,0,0,FMN GV 05 Lier
60,Mechelsesteenweg 365,2023-05-31,13:00:00,0,0,0,FMN GV 05 Lier
60,Mechelsesteenweg 365,2023-05-31,14:00:00,0,0,0,FMN GV 05 Lier
60,Mechelsesteenweg 365,2023-05-31,15:00:00,0,0,0,FMN GV 05 Lier
60,Mechelsesteenweg 365,2023-05-31,16:00:00,0,0,0,FMN GV 05 Lier
60,Mechelsesteenweg 365,2023-05-31,17:00:00,14,6,8,FMN GV 05 Lier
60,Mechelsesteenweg 365,2023-05-31,18:00:00,158,74,84,FMN GV 05 Lier
60,Mechelsesteenweg 365,2023-05-31,19:00:00,174,84,90,FMN GV 05 Lier
60,Mechelsesteenweg 365,2023-05-31,20:00:00,284,152,132,FMN GV 05 Lier
60,Mechelsesteenweg 365,2023-05-31,21:00:00,78,16,62,FMN GV 05 Lier
60,Mechelsesteenweg 365,2023-05-31,22:00:00,12,6,6,FMN GV 05 Lier
60,Mechelsesteenweg 365,2023-05-31,23:00:00,6,2,4,FMN GV 05 Lier
60,Mechelsesteenweg 365,2023-06-01,00:00:00,0,0,0,FMN GV 05 Lier
60,Mechelsesteenweg 365,2023-06-01,01:00:00,0,0,0,FMN GV 05 Lier
60,Mechelsesteenweg 365,2023-06-01,02:00:00,0,0,0,FMN GV 05 Lier
60,Mechelsesteenweg 365,2023-06-01,03:00:00,2,0,2,FMN GV 05 Lier
60,Mechelsesteenweg 365,2023-06-01,04:00:00,0,0,0,FMN GV 05 Lier
60,Mechelsesteenweg 365,2023-06-01,05:00:00,4,2,2,FMN GV 05 Lier
60,Mechelsesteenweg 365,2023-06-01,06:00:00,52,10,42,FMN GV 05 Lier
60,Mechelsesteenweg 365,2023-06-01,07:00:00,172,78,94,FMN GV 05 Lier
60,Mechelsesteenweg 365,2023-06-01,08:00:00,196,106,90,FMN GV 05 Lier
60,Mechelsesteenweg 365,2023-06-01,09:00:00,126,90,36,FMN GV 05 Lier
60,Mechelsesteenweg 365,2023-06-01,10:00:00,160,96,64,FMN GV 05 Lier
60,Mechelsesteenweg 365,2023-06-01,11:00:00,62,20,42,FMN GV 05 Lier
60,Mechelsesteenweg 365,2023-06-01,12:00:00,0,0,0,FMN GV 05 Lier
60,Mechelsesteenweg 365,2023-06-01,13:00:00,0,0,0,FMN GV 05 Lier
60,Mechelsesteenweg 365,2023-06-01,14:00:00,0,0,0,FMN GV 05 Lier
60,Mechelsesteenweg 365,2023-06-01,15:00:00,0,0,0,FMN GV 05 Lier
60,Mechelsesteenweg 365,2023-06-01,16:00:00,0,0,0,FMN GV 05 Lier
60,Mechelsesteenweg 365,2023-06-01,17:00:00,8,0,8,FMN GV 05 Lier
60,Mechelsesteenweg 365,2023-06-01,18:00:00,144,98,46,FMN GV 05 Lier
60,Mechelsesteenweg 365,2023-06-01,19:00:00,170,88,82,FMN GV 05 Lier
60,Mechelsesteenweg 365,2023-06-01,20:00:00,170,46,124,FMN GV 05 Lier
60,Mechelsesteenweg 365,2023-06-01,21:00:00,54,38,16,FMN GV 05 Lier
60,Mechelsesteenweg 365,2023-06-01,22:00:00,24,8,16,FMN GV 05 Lier
60,Mechelsesteenweg 365,2023-06-01,23:00:00,4,4,0,FMN GV 05 Lier
60,Mechelsesteenweg 365,2023-06-02,00:00:00,0,0,0,FMN GV 05 Lier
60,Mechelsesteenweg 365,2023-06-02,01:00:00,0,0,0,FMN GV 05 Lier
60,Mechelsesteenweg 365,2023-06-02,02:00:00,0,0,0,FMN GV 05 Lier
60,Mechelsesteenweg 365,2023-06-02,03:00:00,0,0,0,FMN GV 05 Lier
60,Mechelsesteenweg 365,2023-06-02,04:00:00,0,0,0,FMN GV 05 Lier
60,Mechelsesteenweg 365,2023-06-02,05:00:00,8,2,6,FMN GV 05 Lier
60,Mechelsesteenweg 365,2023-06-02,06:00:00,38,6,32,FMN GV 05 Lier
60,Mechelsesteenweg 365,2023-06-02,07:00:00,146,76,70,FMN GV 05 Lier
60,Mechelsesteenweg 365,2023-06-02,08:00:00,178,114,64,FMN GV 05 Lier
60,Mechelsesteenweg 365,2023-06-02,09:00:00,68,46,22,FMN GV 05 Lier
60,Mechelsesteenweg 365,2023-06-02,10:00:00,68,30,38,FMN GV 05 Lier
60,Mechelsesteenweg 365,2023-06-02,11:00:00,72,36,36,FMN GV 05 Lier
60,Mechelsesteenweg 365,2023-06-02,12:00:00,52,20,32,FMN GV 05 Lier
60,Mechelsesteenweg 365,2023-06-02,13:00:00,4,4,0,FMN GV 05 Lier
60,Mechelsesteenweg 365,2023-06-02,14:00:00,0,0,0,FMN GV 05 Lier
60,Mechelsesteenweg 365,2023-06-02,15:00:00,0,0,0,FMN GV 05 Lier
60,Mechelsesteenweg 365,2023-06-02,16:00:00,0,0,0,FMN GV 05 Lier
60,Mechelsesteenweg 365,2023-06-02,17:00:00,50,30,20,FMN GV 05 Lier
60,Mechelsesteenweg 365,2023-06-02,18:00:00,124,76,48,FMN GV 05 Lier
60,Mechelsesteenweg 365,2023-06-02,19:00:00,80,46,34,FMN GV 05 Lier
60,Mechelsesteenweg 365,2023-06-02,20:00:00,50,16,34,FMN GV 05 Lier
60,Mechelsesteenweg 365,2023-06-02,21:00:00,20,8,12,FMN GV 05 Lier
60,Mechelsesteenweg 365,2023-06-02,22:00:00,26,10,16,FMN GV 05 Lier
60,Mechelsesteenweg 365,2023-06-02,23:00:00,8,6,2,FMN GV 05 Lier
60,Mechelsesteenweg 365,2023-06-03,00:00:00,4,4,0,FMN GV 05 Lier
60,Mechelsesteenweg 365,2023-06-03,01:00:00,8,2,6,FMN GV 05 Lier
60,Mechelsesteenweg 365,2023-06-03,02:00:00,8,6,2,FMN GV 05 Lier
60,Mechelsesteenweg 365,2023-06-03,03:00:00,0,0,0,FMN GV 05 Lier
60,Mechelsesteenweg 365,2023-06-03,04:00:00,2,0,2,FMN GV 05 Lier
60,Mechelsesteenweg 365,2023-06-03,05:00:00,8,4,4,FMN GV 05 Lier
60,Mechelsesteenweg 365,2023-06-03,06:00:00,6,2,4,FMN GV 05 Lier
60,Mechelsesteenweg 365,2023-06-03,07:00:00,14,0,14,FMN GV 05 Lier
60,Mechelsesteenweg 365,2023-06-03,08:00:00,36,22,14,FMN GV 05 Lier
60,Mechelsesteenweg 365,2023-06-03,09:00:00,144,110,34,FMN GV 05 Lier
60,Mechelsesteenweg 365,2023-06-03,10:00:00,210,114,96,FMN GV 05 Lier
60,Mechelsesteenweg 365,2023-06-03,11:00:00,178,70,108,FMN GV 05 Lier
60,Mechelsesteenweg 365,2023-06-03,12:00:00,0,0,0,FMN GV 05 Lier
60,Mechelsesteenweg 365,2023-06-03,13:00:00,0,0,0,FMN GV 05 Lier
60,Mechelsesteenweg 365,2023-06-03,14:00:00,0,0,0,FMN GV 05 Lier
60,Mechelsesteenweg 365,2023-06-03,15:00:00,0,0,0,FMN GV 05 Lier
60,Mechelsesteenweg 365,2023-06-03,16:00:00,0,0,0,FMN GV 05 Lier
60,Mechelsesteenweg 365,2023-06-03,17:00:00,0,0,0,FMN GV 05 Lier
60,Mechelsesteenweg 365,2023-06-03,18:00:00,68,36,32,FMN GV 05 Lier
60,Mechelsesteenweg 365,2023-06-03,19:00:00,64,32,32,FMN GV 05 Lier
60,Mechelsesteenweg 365,2023-06-03,20:00:00,50,24,26,FMN GV 05 Lier
60,Mechelsesteenweg 365,2023-06-03,21:00:00,42,14,28,FMN GV 05 Lier
60,Mechelsesteenweg 365,2023-06-03,22:00:00,38,12,26,FMN GV 05 Lier
60,Mechelsesteenweg 365,2023-06-03,23:00:00,4,2,2,FMN GV 05 Lier
60,Mechelsesteenweg 365,2023-06-04,00:00:00,8,0,8,FMN GV 05 Lier
60,Mechelsesteenweg 365,2023-06-04,01:00:00,2,0,2,FMN GV 05 Lier
60,Mechelsesteenweg 365,2023-06-04,02:00:00,0,0,0,FMN GV 05 Lier
60,Mechelsesteenweg 365,2023-06-04,03:00:00,0,0,0,FMN GV 05 Lier
60,Mechelsesteenweg 365,2023-06-04,04:00:00,0,0,0,FMN GV 05 Lier
60,Mechelsesteenweg 365,2023-06-04,05:00:00,2,0,2,FMN GV 05 Lier
60,Mechelsesteenweg 365,2023-06-04,06:00:00,6,0,6,FMN GV 05 Lier
60,Mechelsesteenweg 365,2023-06-04,07:00:00,18,14,4,FMN GV 05 Lier
60,Mechelsesteenweg 365,2023-06-04,08:00:00,88,42,46,FMN GV 05 Lier
60,Mechelsesteenweg 365,2023-06-04,09:00:00,236,152,84,FMN GV 05 Lier
60,Mechelsesteenweg 365,2023-06-04,10:00:00,416,196,220,FMN GV 05 Lier
60,Mechelsesteenweg 365,2023-06-04,11:00:00,430,192,238,FMN GV 05 Lier
60,Mechelsesteenweg 365,2023-06-04,12:00:00,0,0,0,FMN GV 05 Lier
60,Mechelsesteenweg 365,2023-06-04,13:00:00,0,0,0,FMN GV 05 Lier
60,Mechelsesteenweg 365,2023-06-04,14:00:00,0,0,0,FMN GV 05 Lier
60,Mechelsesteenweg 365,2023-06-04,15:00:00,0,0,0,FMN GV 05 Lier
60,Mechelsesteenweg 365,2023-06-04,16:00:00,0,0,0,FMN GV 05 Lier
60,Mechelsesteenweg 365,2023-06-04,17:00:00,6,2,4,FMN GV 05 Lier
60,Mechelsesteenweg 365,2023-06-04,18:00:00,96,38,58,FMN GV 05 Lier
60,Mechelsesteenweg 365,2023-06-04,19:00:00,52,22,30,FMN GV 05 Lier
60,Mechelsesteenweg 365,2023-06-04,20:00:00,104,40,64,FMN GV 05 Lier
60,Mechelsesteenweg 365,2023-06-04,21:00:00,38,6,32,FMN GV 05 Lier
60,Mechelsesteenweg 365,2023-06-04,22:00:00,14,8,6,FMN GV 05 Lier
60,Mechelsesteenweg 365,2023-06-04,23:00:00,8,0,8,FMN GV 05 Lier
60,Mechelsesteenweg 365,2023-06-05,00:00:00,0,0,0,FMN GV 05 Lier
60,Mechelsesteenweg 365,2023-06-05,01:00:00,0,0,0,FMN GV 05 Lier
60,Mechelsesteenweg 365,2023-06-05,02:00:00,0,0,0,FMN GV 05 Lier
60,Mechelsesteenweg 365,2023-06-05,03:00:00,2,0,2,FMN GV 05 Lier
60,Mechelsesteenweg 365,2023-06-05,04:00:00,2,2,0,FMN GV 05 Lier
60,Mechelsesteenweg 365,2023-06-05,05:00:00,2,2,0,FMN GV 05 Lier
60,Mechelsesteenweg 365,2023-06-05,06:00:00,30,6,24,FMN GV 05 Lier
60,Mechelsesteenweg 365,2023-06-05,07:00:00,196,102,94,FMN GV 05 Lier
60,Mechelsesteenweg 365,2023-06-05,08:00:00,212,122,90,FMN GV 05 Lier
60,Mechelsesteenweg 365,2023-06-05,09:00:00,124,86,38,FMN GV 05 Lier
60,Mechelsesteenweg 365,2023-06-05,10:00:00,80,40,40,FMN GV 05 Lier
60,Mechelsesteenweg 365,2023-06-05,11:00:00,38,10,28,FMN GV 05 Lier
60,Mechelsesteenweg 365,2023-06-05,12:00:00,0,0,0,FMN GV 05 Lier
60,Mechelsesteenweg 365,2023-06-05,13:00:00,0,0,0,FMN GV 05 Lier
60,Mechelsesteenweg 365,2023-06-05,14:00:00,0,0,0,FMN GV 05 Lier
60,Mechelsesteenweg 365,2023-06-05,15:00:00,0,0,0,FMN GV 05 Lier
60,Mechelsesteenweg 365,2023-06-05,16:00:00,0,0,0,FMN GV 05 Lier
60,Mechelsesteenweg 365,2023-06-05,17:00:00,2,0,2,FMN GV 05 Lier
60,Mechelsesteenweg 365,2023-06-05,18:00:00,104,60,44,FMN GV 05 Lier
60,Mechelsesteenweg 365,2023-06-05,19:00:00,96,50,46,FMN GV 05 Lier
60,Mechelsesteenweg 365,2023-06-05,20:00:00,106,34,72,FMN GV 05 Lier
60,Mechelsesteenweg 365,2023-06-05,21:00:00,34,16,18,FMN GV 05 Lier
60,Mechelsesteenweg 365,2023-06-05,22:00:00,4,2,2,FMN GV 05 Lier
60,Mechelsesteenweg 365,2023-06-05,23:00:00,2,2,0,FMN GV 05 Lier
60,Mechelsesteenweg 365,2023-06-06,00:00:00,0,0,0,FMN GV 05 Lier
60,Mechelsesteenweg 365,2023-06-06,01:00:00,0,0,0,FMN GV 05 Lier
60,Mechelsesteenweg 365,2023-06-06,02:00:00,0,0,0,FMN GV 05 Lier
60,Mechelsesteenweg 365,2023-06-06,03:00:00,2,0,2,FMN GV 05 Lier
60,Mechelsesteenweg 365,2023-06-06,04:00:00,0,0,0,FMN GV 05 Lier
60,Mechelsesteenweg 365,2023-06-06,05:00:00,12,4,8,FMN GV 05 Lier
60,Mechelsesteenweg 365,2023-06-06,06:00:00,38,12,26,FMN GV 05 Lier
60,Mechelsesteenweg 365,2023-06-06,07:00:00,208,106,102,FMN GV 05 Lier
60,Mechelsesteenweg 365,2023-06-06,08:00:00,242,122,120,FMN GV 05 Lier
60,Mechelsesteenweg 365,2023-06-06,09:00:00,102,60,42,FMN GV 05 Lier
60,Mechelsesteenweg 365,2023-06-06,10:00:00,170,70,100,FMN GV 05 Lier
60,Mechelsesteenweg 365,2023-06-06,11:00:00,66,22,44,FMN GV 05 Lier
60,Mechelsesteenweg 365,2023-06-06,12:00:00,0,0,0,FMN GV 05 Lier
60,Mechelsesteenweg 365,2023-06-06,13:00:00,0,0,0,FMN GV 05 Lier
60,Mechelsesteenweg 365,2023-06-06,14:00:00,0,0,0,FMN GV 05 Lier
60,Mechelsesteenweg 365,2023-06-06,15:00:00,0,0,0,FMN GV 05 Lier
60,Mechelsesteenweg 365,2023-06-06,16:00:00,0,0,0,FMN GV 05 Lier
60,Mechelsesteenweg 365,2023-06-06,17:00:00,58,26,32,FMN GV 05 Lier
60,Mechelsesteenweg 365,2023-06-06,18:00:00,108,46,62,FMN GV 05 Lier
60,Mechelsesteenweg 365,2023-06-06,19:00:00,162,98,64,FMN GV 05 Lier
60,Mechelsesteenweg 365,2023-06-06,20:00:00,160,86,74,FMN GV 05 Lier
60,Mechelsesteenweg 365,2023-06-06,21:00:00,72,20,52,FMN GV 05 Lier
60,Mechelsesteenweg 365,2023-06-06,22:00:00,8,8,0,FMN GV 05 Lier
60,Mechelsesteenweg 365,2023-06-06,23:00:00,0,0,0,FMN GV 05 Lier
60,Mechelsesteenweg 365,2023-06-07,00:00:00,2,2,0,FMN GV 05 Lier
60,Mechelsesteenweg 365,2023-06-07,01:00:00,0,0,0,FMN GV 05 Lier
60,Mechelsesteenweg 365,2023-06-07,02:00:00,0,0,0,FMN GV 05 Lier
60,Mechelsesteenweg 365,2023-06-07,03:00:00,0,0,0,FMN GV 05 Lier
60,Mechelsesteenweg 365,2023-06-07,04:00:00,0,0,0,FMN GV 05 Lier
60,Mechelsesteenweg 365,2023-06-07,05:00:00,6,4,2,FMN GV 05 Lier
60,Mechelsesteenweg 365,2023-06-07,06:00:00,40,6,34,FMN GV 05 Lier
60,Mechelsesteenweg 365,2023-06-07,07:00:00,176,78,98,FMN GV 05 Lier
60,Mechelsesteenweg 365,2023-06-07,08:00:00,188,114,74,FMN GV 05 Lier
60,Mechelsesteenweg 365,2023-06-07,09:00:00,76,56,20,FMN GV 05 Lier
60,Mechelsesteenweg 365,2023-06-07,10:00:00,164,96,68,FMN GV 05 Lier
60,Mechelsesteenweg 365,2023-06-07,11:00:00,20,0,20,FMN GV 05 Lier
60,Mechelsesteenweg 365,2023-06-07,12:00:00,0,0,0,FMN GV 05 Lier
60,Mechelsesteenweg 365,2023-06-07,13:00:00,0,0,0,FMN GV 05 Lier
60,Mechelsesteenweg 365,2023-06-07,14:00:00,62,28,34,FMN GV 05 Lier
60,Mechelsesteenweg 365,2023-06-07,15:00:00,180,92,88,FMN GV 05 Lier
60,Mechelsesteenweg 365,2023-06-07,16:00:00,168,98,70,FMN GV 05 Lier
60,Mechelsesteenweg 365,2023-06-07,17:00:00,178,84,94,FMN GV 05 Lier
60,Mechelsesteenweg 365,2023-06-07,18:00:00,176,92,84,FMN GV 05 Lier
60,Mechelsesteenweg 365,2023-06-07,19:00:00,198,84,114,FMN GV 05 Lier
60,Mechelsesteenweg 365,2023-06-07,20:00:00,268,154,114,FMN GV 05 Lier
60,Mechelsesteenweg 365,2023-06-07,21:00:00,56,26,30,FMN GV 05 Lier
60,Mechelsesteenweg 365,2023-06-07,22:00:00,12,6,6,FMN GV 05 Lier
60,Mechelsesteenweg 365,2023-06-07,23:00:00,8,2,6,FMN GV 05 Lier
60,Mechelsesteenweg 365,2023-06-08,00:00:00,0,0,0,FMN GV 05 Lier
60,Mechelsesteenweg 365,2023-06-08,01:00:00,0,0,0,FMN GV 05 Lier
60,Mechelsesteenweg 365,2023-06-08,02:00:00,0,0,0,FMN GV 05 Lier
60,Mechelsesteenweg 365,2023-06-08,03:00:00,2,0,2,FMN GV 05 Lier
60,Mechelsesteenweg 365,2023-06-08,04:00:00,0,0,0,FMN GV 05 Lier
60,Mechelsesteenweg 365,2023-06-08,05:00:00,6,2,4,FMN GV 05 Lier
60,Mechelsesteenweg 365,2023-06-08,06:00:00,34,8,26,FMN GV 05 Lier
60,Mechelsesteenweg 365,2023-06-08,07:00:00,196,84,112,FMN GV 05 Lier
60,Mechelsesteenweg 365,2023-06-08,08:00:00,244,128,116,FMN GV 05 Lier
60,Mechelsesteenweg 365,2023-06-08,09:00:00,112,64,48,FMN GV 05 Lier
60,Mechelsesteenweg 365,2023-06-08,10:00:00,150,86,64,FMN GV 05 Lier
60,Mechelsesteenweg 365,2023-06-08,11:00:00,30,6,24,FMN GV 05 Lier
60,Mechelsesteenweg 365,2023-06-08,12:00:00,0,0,0,FMN GV 05 Lier
60,Mechelsesteenweg 365,2023-06-08,13:00:00,0,0,0,FMN GV 05 Lier
60,Mechelsesteenweg 365,2023-06-08,14:00:00,0,0,0,FMN GV 05 Lier
60,Mechelsesteenweg 365,2023-06-08,15:00:00,0,0,0,FMN GV 05 Lier
60,Mechelsesteenweg 365,2023-06-08,16:00:00,0,0,0,FMN GV 05 Lier
60,Mechelsesteenweg 365,2023-06-08,17:00:00,0,0,0,FMN GV 05 Lier
60,Mechelsesteenweg 365,2023-06-08,18:00:00,70,40,30,FMN GV 05 Lier
60,Mechelsesteenweg 365,2023-06-08,19:00:00,226,130,96,FMN GV 05 Lier
60,Mechelsesteenweg 365,2023-06-08,20:00:00,224,78,146,FMN GV 05 Lier
60,Mechelsesteenweg 365,2023-06-08,21:00:00,74,26,48,FMN GV 05 Lier
60,Mechelsesteenweg 365,2023-06-08,22:00:00,22,14,8,FMN GV 05 Lier
60,Mechelsesteenweg 365,2023-06-08,23:00:00,6,0,6,FMN GV 05 Lier
60,Mechelsesteenweg 365,2023-06-09,00:00:00,6,2,4,FMN GV 05 Lier
60,Mechelsesteenweg 365,2023-06-09,01:00:00,4,4,0,FMN GV 05 Lier
60,Mechelsesteenweg 365,2023-06-09,02:00:00,2,0,2,FMN GV 05 Lier
60,Mechelsesteenweg 365,2023-06-09,03:00:00,2,0,2,FMN GV 05 Lier
60,Mechelsesteenweg 365,2023-06-09,04:00:00,2,0,2,FMN GV 05 Lier
60,Mechelsesteenweg 365,2023-06-09,05:00:00,8,4,4,FMN GV 05 Lier
60,Mechelsesteenweg 365,2023-06-09,06:00:00,24,6,18,FMN GV 05 Lier
60,Mechelsesteenweg 365,2023-06-09,07:00:00,210,122,88,FMN GV 05 Lier
60,Mechelsesteenweg 365,2023-06-09,08:00:00,152,76,76,FMN GV 05 Lier
60,Mechelsesteenweg 365,2023-06-09,09:00:00,94,50,44,FMN GV 05 Lier
60,Mechelsesteenweg 365,2023-06-09,10:00:00,128,50,78,FMN GV 05 Lier
60,Mechelsesteenweg 365,2023-06-09,11:00:00,6,4,2,FMN GV 05 Lier
60,Mechelsesteenweg 365,2023-06-09,12:00:00,0,0,0,FMN GV 05 Lier
60,Mechelsesteenweg 365,2023-06-09,13:00:00,0,0,0,FMN GV 05 Lier
60,Mechelsesteenweg 365,2023-06-09,14:00:00,0,0,0,FMN GV 05 Lier
60,Mechelsesteenweg 365,2023-06-09,15:00:00,0,0,0,FMN GV 05 Lier
60,Mechelsesteenweg 365,2023-06-09,16:00:00,0,0,0,FMN GV 05 Lier
60,Mechelsesteenweg 365,2023-06-09,17:00:00,0,0,0,FMN GV 05 Lier
60,Mechelsesteenweg 365,2023-06-09,18:00:00,16,4,12,FMN GV 05 Lier
60,Mechelsesteenweg 365,2023-06-09,19:00:00,106,44,62,FMN GV 05 Lier
60,Mechelsesteenweg 365,2023-06-09,20:00:00,104,44,60,FMN GV 05 Lier
60,Mechelsesteenweg 365,2023-06-09,21:00:00,48,18,30,FMN GV 05 Lier
60,Mechelsesteenweg 365,2023-06-09,22:00:00,32,18,14,FMN GV 05 Lier
60,Mechelsesteenweg 365,2023-06-09,23:00:00,18,8,10,FMN GV 05 Lier
60,Mechelsesteenweg 365,2023-06-10,00:00:00,2,0,2,FMN GV 05 Lier
60,Mechelsesteenweg 365,2023-06-10,01:00:00,2,0,2,FMN GV 05 Lier
60,Mechelsesteenweg 365,2023-06-10,02:00:00,4,0,4,FMN GV 05 Lier
60,Mechelsesteenweg 365,2023-06-10,03:00:00,2,0,2,FMN GV 05 Lier
60,Mechelsesteenweg 365,2023-06-10,04:00:00,0,0,0,FMN GV 05 Lier
60,Mechelsesteenweg 365,2023-06-10,05:00:00,0,0,0,FMN GV 05 Lier
60,Mechelsesteenweg 365,2023-06-10,06:00:00,8,6,2,FMN GV 05 Lier
60,Mechelsesteenweg 365,2023-06-10,07:00:00,36,14,22,FMN GV 05 Lier
60,Mechelsesteenweg 365,2023-06-10,08:00:00,128,58,70,FMN GV 05 Lier
60,Mechelsesteenweg 365,2023-06-10,09:00:00,208,108,100,FMN GV 05 Lier
60,Mechelsesteenweg 365,2023-06-10,10:00:00,232,110,122,FMN GV 05 Lier
60,Mechelsesteenweg 365,2023-06-10,11:00:00,0,0,0,FMN GV 05 Lier
60,Mechelsesteenweg 365,2023-06-10,12:00:00,0,0,0,FMN GV 05 Lier
60,Mechelsesteenweg 365,2023-06-10,13:00:00,0,0,0,FMN GV 05 Lier
60,Mechelsesteenweg 365,2023-06-10,14:00:00,0,0,0,FMN GV 05 Lier
60,Mechelsesteenweg 365,2023-06-10,15:00:00,0,0,0,FMN GV 05 Lier
60,Mechelsesteenweg 365,2023-06-10,16:00:00,0,0,0,FMN GV 05 Lier
60,Mechelsesteenweg 365,2023-06-10,17:00:00,0,0,0,FMN GV 05 Lier
60,Mechelsesteenweg 365,2023-06-10,18:00:00,6,2,4,FMN GV 05 Lier
60,Mechelsesteenweg 365,2023-06-10,19:00:00,56,12,44,FMN GV 05 Lier
60,Mechelsesteenweg 365,2023-06-10,20:00:00,98,36,62,FMN GV 05 Lier
60,Mechelsesteenweg 365,2023-06-10,21:00:00,66,28,38,FMN GV 05 Lier
60,Mechelsesteenweg 365,2023-06-10,22:00:00,28,16,12,FMN GV 05 Lier
60,Mechelsesteenweg 365,2023-06-10,23:00:00,38,10,28,FMN GV 05 Lier
60,Mechelsesteenweg 365,2023-06-11,00:00:00,14,6,8,FMN GV 05 Lier
60,Mechelsesteenweg 365,2023-06-11,01:00:00,2,2,0,FMN GV 05 Lier
60,Mechelsesteenweg 365,2023-06-11,02:00:00,4,0,4,FMN GV 05 Lier
60,Mechelsesteenweg 365,2023-06-11,03:00:00,2,2,0,FMN GV 05 Lier
60,Mechelsesteenweg 365,2023-06-11,04:00:00,0,0,0,FMN GV 05 Lier
60,Mechelsesteenweg 365,2023-06-11,05:00:00,0,0,0,FMN GV 05 Lier
60,Mechelsesteenweg 365,2023-06-11,06:00:00,18,12,6,FMN GV 05 Lier
60,Mechelsesteenweg 365,2023-06-11,07:00:00,62,22,40,FMN GV 05 Lier
60,Mechelsesteenweg 365,2023-06-11,08:00:00,160,94,66,FMN GV 05 Lier
60,Mechelsesteenweg 365,2023-06-11,09:00:00,332,158,174,FMN GV 05 Lier
60,Mechelsesteenweg 365,2023-06-11,10:00:00,306,162,144,FMN GV 05 Lier
60,Mechelsesteenweg 365,2023-06-11,11:00:00,0,0,0,FMN GV 05 Lier
60,Mechelsesteenweg 365,2023-06-11,12:00:00,0,0,0,FMN GV 05 Lier
60,Mechelsesteenweg 365,2023-06-11,13:00:00,0,0,0,FMN GV 05 Lier
60,Mechelsesteenweg 365,2023-06-11,14:00:00,0,0,0,FMN GV 05 Lier
60,Mechelsesteenweg 365,2023-06-11,15:00:00,0,0,0,FMN GV 05 Lier
60,Mechelsesteenweg 365,2023-06-11,16:00:00,0,0,0,FMN GV 05 Lier
60,Mechelsesteenweg 365,2023-06-11,17:00:00,0,0,0,FMN GV 05 Lier
60,Mechelsesteenweg 365,2023-06-11,18:00:00,0,0,0,FMN GV 05 Lier
60,Mechelsesteenweg 365,2023-06-11,19:00:00,112,44,68,FMN GV 05 Lier
60,Mechelsesteenweg 365,2023-06-11,20:00:00,116,60,56,FMN GV 05 Lier
60,Mechelsesteenweg 365,2023-06-11,21:00:00,46,16,30,FMN GV 05 Lier
60,Mechelsesteenweg 365,2023-06-11,22:00:00,16,8,8,FMN GV 05 Lier
60,Mechelsesteenweg 365,2023-06-11,23:00:00,6,2,4,FMN GV 05 Lier
60,Mechelsesteenweg 365,2023-06-12,00:00:00,0,0,0,FMN GV 05 Lier
60,Mechelsesteenweg 365,2023-06-12,01:00:00,2,2,0,FMN GV 05 Lier
60,Mechelsesteenweg 365,2023-06-12,02:00:00,0,0,0,FMN GV 05 Lier
60,Mechelsesteenweg 365,2023-06-12,03:00:00,2,0,2,FMN GV 05 Lier
60,Mechelsesteenweg 365,2023-06-12,04:00:00,0,0,0,FMN GV 05 Lier
60,Mechelsesteenweg 365,2023-06-12,05:00:00,6,4,2,FMN GV 05 Lier
60,Mechelsesteenweg 365,2023-06-12,06:00:00,60,20,40,FMN GV 05 Lier
60,Mechelsesteenweg 365,2023-06-12,07:00:00,214,118,96,FMN GV 05 Lier
60,Mechelsesteenweg 365,2023-06-12,08:00:00,228,110,118,FMN GV 05 Lier
60,Mechelsesteenweg 365,2023-06-12,09:00:00,126,70,56,FMN GV 05 Lier
60,Mechelsesteenweg 365,2023-06-12,10:00:00,74,22,52,FMN GV 05 Lier
60,Mechelsesteenweg 365,2023-06-12,11:00:00,0,0,0,FMN GV 05 Lier
60,Mechelsesteenweg 365,2023-06-12,12:00:00,0,0,0,FMN GV 05 Lier
60,Mechelsesteenweg 365,2023-06-12,13:00:00,0,0,0,FMN GV 05 Lier
60,Mechelsesteenweg 365,2023-06-12,14:00:00,0,0,0,FMN GV 05 Lier
60,Mechelsesteenweg 365,2023-06-12,15:00:00,0,0,0,FMN GV 05 Lier
60,Mechelsesteenweg 365,2023-06-12,16:00:00,0,0,0,FMN GV 05 Lier
60,Mechelsesteenweg 365,2023-06-12,17:00:00,0,0,0,FMN GV 05 Lier
60,Mechelsesteenweg 365,2023-06-12,18:00:00,0,0,0,FMN GV 05 Lier
60,Mechelsesteenweg 365,2023-06-12,19:00:00,56,20,36,FMN GV 05 Lier
60,Mechelsesteenweg 365,2023-06-12,20:00:00,148,60,88,FMN GV 05 Lier
60,Mechelsesteenweg 365,2023-06-12,21:00:00,90,24,66,FMN GV 05 Lier
60,Mechelsesteenweg 365,2023-06-12,22:00:00,24,8,16,FMN GV 05 Lier
60,Mechelsesteenweg 365,2023-06-12,23:00:00,4,4,0,FMN GV 05 Lier
60,Mechelsesteenweg 365,2023-06-13,00:00:00,2,0,2,FMN GV 05 Lier
60,Mechelsesteenweg 365,2023-06-13,01:00:00,0,0,0,FMN GV 05 Lier
60,Mechelsesteenweg 365,2023-06-13,02:00:00,0,0,0,FMN GV 05 Lier
60,Mechelsesteenweg 365,2023-06-13,03:00:00,2,0,2,FMN GV 05 Lier
60,Mechelsesteenweg 365,2023-06-13,04:00:00,0,0,0,FMN GV 05 Lier
60,Mechelsesteenweg 365,2023-06-13,05:00:00,10,2,8,FMN GV 05 Lier
60,Mechelsesteenweg 365,2023-06-13,06:00:00,52,14,38,FMN GV 05 Lier
60,Mechelsesteenweg 365,2023-06-13,07:00:00,254,124,130,FMN GV 05 Lier
60,Mechelsesteenweg 365,2023-06-13,08:00:00,276,158,118,FMN GV 05 Lier
60,Mechelsesteenweg 365,2023-06-13,09:00:00,220,104,116,FMN GV 05 Lier
60,Mechelsesteenweg 365,2023-06-13,10:00:00,156,62,94,FMN GV 05 Lier
60,Mechelsesteenweg 365,2023-06-13,11:00:00,0,0,0,FMN GV 05 Lier
60,Mechelsesteenweg 365,2023-06-13,12:00:00,0,0,0,FMN GV 05 Lier
60,Mechelsesteenweg 365,2023-06-13,13:00:00,0,0,0,FMN GV 05 Lier
60,Mechelsesteenweg 365,2023-06-13,14:00:00,0,0,0,FMN GV 05 Lier
60,Mechelsesteenweg 365,2023-06-13,15:00:00,0,0,0,FMN GV 05 Lier
60,Mechelsesteenweg 365,2023-06-13,16:00:00,0,0,0,FMN GV 05 Lier
60,Mechelsesteenweg 365,2023-06-13,17:00:00,0,0,0,FMN GV 05 Lier
60,Mechelsesteenweg 365,2023-06-13,18:00:00,0,0,0,FMN GV 05 Lier
60,Mechelsesteenweg 365,2023-06-13,19:00:00,120,54,66,FMN GV 05 Lier
60,Mechelsesteenweg 365,2023-06-13,20:00:00,210,66,144,FMN GV 05 Lier
60,Mechelsesteenweg 365,2023-06-13,21:00:00,96,38,58,FMN GV 05 Lier
60,Mechelsesteenweg 365,2023-06-13,22:00:00,36,12,24,FMN GV 05 Lier
60,Mechelsesteenweg 365,2023-06-13,23:00:00,8,8,0,FMN GV 05 Lier
60,Mechelsesteenweg 365,2023-06-14,00:00:00,4,2,2,FMN GV 05 Lier
60,Mechelsesteenweg 365,2023-06-14,01:00:00,0,0,0,FMN GV 05 Lier
60,Mechelsesteenweg 365,2023-06-14,02:00:00,0,0,0,FMN GV 05 Lier
60,Mechelsesteenweg 365,2023-06-14,03:00:00,2,0,2,FMN GV 05 Lier
60,Mechelsesteenweg 365,2023-06-14,04:00:00,0,0,0,FMN GV 05 Lier
60,Mechelsesteenweg 365,2023-06-14,05:00:00,10,8,2,FMN GV 05 Lier
60,Mechelsesteenweg 365,2023-06-14,06:00:00,42,16,26,FMN GV 05 Lier
60,Mechelsesteenweg 365,2023-06-14,07:00:00,216,108,108,FMN GV 05 Lier
60,Mechelsesteenweg 365,2023-06-14,08:00:00,240,130,110,FMN GV 05 Lier
60,Mechelsesteenweg 365,2023-06-14,09:00:00,158,90,68,FMN GV 05 Lier
60,Mechelsesteenweg 365,2023-06-14,10:00:00,166,64,102,FMN GV 05 Lier
60,Mechelsesteenweg 365,2023-06-14,11:00:00,0,0,0,FMN GV 05 Lier
60,Mechelsesteenweg 365,2023-06-14,12:00:00,0,0,0,FMN GV 05 Lier
60,Mechelsesteenweg 365,2023-06-14,13:00:00,0,0,0,FMN GV 05 Lier
60,Mechelsesteenweg 365,2023-06-14,14:00:00,0,0,0,FMN GV 05 Lier
60,Mechelsesteenweg 365,2023-06-14,15:00:00,0,0,0,FMN GV 05 Lier
60,Mechelsesteenweg 365,2023-06-14,16:00:00,0,0,0,FMN GV 05 Lier
60,Mechelsesteenweg 365,2023-06-14,17:00:00,0,0,0,FMN GV 05 Lier
60,Mechelsesteenweg 365,2023-06-14,18:00:00,0,0,0,FMN GV 05 Lier
60,Mechelsesteenweg 365,2023-06-14,19:00:00,206,102,104,FMN GV 05 Lier
60,Mechelsesteenweg 365,2023-06-14,20:00:00,294,166,128,FMN GV 05 Lier
60,Mechelsesteenweg 365,2023-06-14,21:00:00,102,52,50,FMN GV 05 Lier
60,Mechelsesteenweg 365,2023-06-14,22:00:00,26,6,20,FMN GV 05 Lier
60,Mechelsesteenweg 365,2023-06-14,23:00:00,10,4,6,FMN GV 05 Lier
60,Mechelsesteenweg 365,2023-06-15,00:00:00,0,0,0,FMN GV 05 Lier
60,Mechelsesteenweg 365,2023-06-15,01:00:00,0,0,0,FMN GV 05 Lier
60,Mechelsesteenweg 365,2023-06-15,02:00:00,0,0,0,FMN GV 05 Lier
60,Mechelsesteenweg 365,2023-06-15,03:00:00,2,0,2,FMN GV 05 Lier
60,Mechelsesteenweg 365,2023-06-15,04:00:00,0,0,0,FMN GV 05 Lier
60,Mechelsesteenweg 365,2023-06-15,05:00:00,6,0,6,FMN GV 05 Lier
60,Mechelsesteenweg 365,2023-06-15,06:00:00,48,14,34,FMN GV 05 Lier
60,Mechelsesteenweg 365,2023-06-15,07:00:00,204,106,98,FMN GV 05 Lier
60,Mechelsesteenweg 365,2023-06-15,08:00:00,212,106,106,FMN GV 05 Lier
60,Mechelsesteenweg 365,2023-06-15,09:00:00,170,82,88,FMN GV 05 Lier
60,Mechelsesteenweg 365,2023-06-15,10:00:00,180,98,82,FMN GV 05 Lier
60,Mechelsesteenweg 365,2023-06-15,11:00:00,0,0,0,FMN GV 05 Lier
60,Mechelsesteenweg 365,2023-06-15,12:00:00,0,0,0,FMN GV 05 Lier
60,Mechelsesteenweg 365,2023-06-15,13:00:00,0,0,0,FMN GV 05 Lier
60,Mechelsesteenweg 365,2023-06-15,14:00:00,20,8,12,FMN GV 05 Lier
60,Mechelsesteenweg 365,2023-06-15,15:00:00,0,0,0,FMN GV 05 Lier
60,Mechelsesteenweg 365,2023-06-15,16:00:00,0,0,0,FMN GV 05 Lier
60,Mechelsesteenweg 365,2023-06-15,17:00:00,10,6,4,FMN GV 05 Lier
60,Mechelsesteenweg 365,2023-06-15,18:00:00,60,24,36,FMN GV 05 Lier
60,Mechelsesteenweg 365,2023-06-15,19:00:00,188,104,84,FMN GV 05 Lier
60,Mechelsesteenweg 365,2023-06-15,20:00:00,278,100,178,FMN GV 05 Lier
60,Mechelsesteenweg 365,2023-06-15,21:00:00,98,38,60,FMN GV 05 Lier
60,Mechelsesteenweg 365,2023-06-15,22:00:00,18,8,10,FMN GV 05 Lier
60,Mechelsesteenweg 365,2023-06-15,23:00:00,16,6,10,FMN GV 05 Lier
60,Mechelsesteenweg 365,2023-06-16,00:00:00,4,4,0,FMN GV 05 Lier
60,Mechelsesteenweg 365,2023-06-16,01:00:00,0,0,0,FMN GV 05 Lier
60,Mechelsesteenweg 365,2023-06-16,02:00:00,0,0,0,FMN GV 05 Lier
60,Mechelsesteenweg 365,2023-06-16,03:00:00,2,0,2,FMN GV 05 Lier
60,Mechelsesteenweg 365,2023-06-16,04:00:00,0,0,0,FMN GV 05 Lier
60,Mechelsesteenweg 365,2023-06-16,05:00:00,8,4,4,FMN GV 05 Lier
60,Mechelsesteenweg 365,2023-06-16,06:00:00,30,6,24,FMN GV 05 Lier
60,Mechelsesteenweg 365,2023-06-16,07:00:00,214,124,90,FMN GV 05 Lier
60,Mechelsesteenweg 365,2023-06-16,08:00:00,176,88,88,FMN GV 05 Lier
60,Mechelsesteenweg 365,2023-06-16,09:00:00,152,96,56,FMN GV 05 Lier
60,Mechelsesteenweg 365,2023-06-16,10:00:00,120,44,76,FMN GV 05 Lier
60,Mechelsesteenweg 365,2023-06-16,11:00:00,0,0,0,FMN GV 05 Lier
60,Mechelsesteenweg 365,2023-06-16,12:00:00,0,0,0,FMN GV 05 Lier
60,Mechelsesteenweg 365,2023-06-16,13:00:00,0,0,0,FMN GV 05 Lier
60,Mechelsesteenweg 365,2023-06-16,14:00:00,0,0,0,FMN GV 05 Lier
60,Mechelsesteenweg 365,2023-06-16,15:00:00,0,0,0,FMN GV 05 Lier
60,Mechelsesteenweg 365,2023-06-16,16:00:00,0,0,0,FMN GV 05 Lier
60,Mechelsesteenweg 365,2023-06-16,17:00:00,0,0,0,FMN GV 05 Lier
60,Mechelsesteenweg 365,2023-06-16,18:00:00,34,18,16,FMN GV 05 Lier
60,Mechelsesteenweg 365,2023-06-16,19:00:00,78,44,34,FMN GV 05 Lier
60,Mechelsesteenweg 365,2023-06-16,20:00:00,96,72,24,FMN GV 05 Lier
60,Mechelsesteenweg 365,2023-06-16,21:00:00,70,36,34,FMN GV 05 Lier
60,Mechelsesteenweg 365,2023-06-16,22:00:00,36,14,22,FMN GV 05 Lier
60,Mechelsesteenweg 365,2023-06-16,23:00:00,12,6,6,FMN GV 05 Lier
60,Mechelsesteenweg 365,2023-06-17,00:00:00,6,2,4,FMN GV 05 Lier
60,Mechelsesteenweg 365,2023-06-17,01:00:00,4,0,4,FMN GV 05 Lier
60,Mechelsesteenweg 365,2023-06-17,02:00:00,4,0,4,FMN GV 05 Lier
60,Mechelsesteenweg 365,2023-06-17,03:00:00,4,2,2,FMN GV 05 Lier
60,Mechelsesteenweg 365,2023-06-17,04:00:00,0,0,0,FMN GV 05 Lier
60,Mechelsesteenweg 365,2023-06-17,05:00:00,8,2,6,FMN GV 05 Lier
60,Mechelsesteenweg 365,2023-06-17,06:00:00,18,4,14,FMN GV 05 Lier
60,Mechelsesteenweg 365,2023-06-17,07:00:00,42,28,14,FMN GV 05 Lier
60,Mechelsesteenweg 365,2023-06-17,08:00:00,112,60,52,FMN GV 05 Lier
60,Mechelsesteenweg 365,2023-06-17,09:00:00,210,122,88,FMN GV 05 Lier
60,Mechelsesteenweg 365,2023-06-17,10:00:00,310,168,142,FMN GV 05 Lier
60,Mechelsesteenweg 365,2023-06-17,11:00:00,12,2,10,FMN GV 05 Lier
60,Mechelsesteenweg 365,2023-06-17,12:00:00,0,0,0,FMN GV 05 Lier
60,Mechelsesteenweg 365,2023-06-17,13:00:00,0,0,0,FMN GV 05 Lier
60,Mechelsesteenweg 365,2023-06-17,14:00:00,0,0,0,FMN GV 05 Lier
60,Mechelsesteenweg 365,2023-06-17,15:00:00,0,0,0,FMN GV 05 Lier
60,Mechelsesteenweg 365,2023-06-17,16:00:00,0,0,0,FMN GV 05 Lier
60,Mechelsesteenweg 365,2023-06-17,17:00:00,14,6,8,FMN GV 05 Lier
60,Mechelsesteenweg 365,2023-06-17,18:00:00,112,64,48,FMN GV 05 Lier
60,Mechelsesteenweg 365,2023-06-17,19:00:00,88,42,46,FMN GV 05 Lier
60,Mechelsesteenweg 365,2023-06-17,20:00:00,78,26,52,FMN GV 05 Lier
60,Mechelsesteenweg 365,2023-06-17,21:00:00,42,16,26,FMN GV 05 Lier
60,Mechelsesteenweg 365,2023-06-17,22:00:00,34,6,28,FMN GV 05 Lier
60,Mechelsesteenweg 365,2023-06-17,23:00:00,22,0,22,FMN GV 05 Lier
60,Mechelsesteenweg 365,2023-06-18,00:00:00,6,6,0,FMN GV 05 Lier
60,Mechelsesteenweg 365,2023-06-18,01:00:00,0,0,0,FMN GV 05 Lier
60,Mechelsesteenweg 365,2023-06-18,02:00:00,0,0,0,FMN GV 05 Lier
60,Mechelsesteenweg 365,2023-06-18,03:00:00,6,2,4,FMN GV 05 Lier
60,Mechelsesteenweg 365,2023-06-18,04:00:00,0,0,0,FMN GV 05 Lier
60,Mechelsesteenweg 365,2023-06-18,05:00:00,4,4,0,FMN GV 05 Lier
60,Mechelsesteenweg 365,2023-06-18,06:00:00,10,6,4,FMN GV 05 Lier
60,Mechelsesteenweg 365,2023-06-18,07:00:00,20,14,6,FMN GV 05 Lier
60,Mechelsesteenweg 365,2023-06-18,08:00:00,92,58,34,FMN GV 05 Lier
60,Mechelsesteenweg 365,2023-06-18,09:00:00,174,106,68,FMN GV 05 Lier
60,Mechelsesteenweg 365,2023-06-18,10:00:00,214,84,130,FMN GV 05 Lier
60,Mechelsesteenweg 365,2023-06-18,11:00:00,234,124,110,FMN GV 05 Lier
60,Mechelsesteenweg 365,2023-06-18,12:00:00,102,42,60,FMN GV 05 Lier
60,Mechelsesteenweg 365,2023-06-18,13:00:00,160,92,68,FMN GV 05 Lier
60,Mechelsesteenweg 365,2023-06-18,14:00:00,180,90,90,FMN GV 05 Lier
60,Mechelsesteenweg 365,2023-06-18,15:00:00,220,110,110,FMN GV 05 Lier
60,Mechelsesteenweg 365,2023-06-18,16:00:00,52,32,20,FMN GV 05 Lier
60,Mechelsesteenweg 365,2023-06-18,17:00:00,154,44,110,FMN GV 05 Lier
60,Mechelsesteenweg 365,2023-06-18,18:00:00,78,34,44,FMN GV 05 Lier
60,Mechelsesteenweg 365,2023-06-18,19:00:00,44,22,22,FMN GV 05 Lier
60,Mechelsesteenweg 365,2023-06-18,20:00:00,40,12,28,FMN GV 05 Lier
60,Mechelsesteenweg 365,2023-06-18,21:00:00,28,20,8,FMN GV 05 Lier
60,Mechelsesteenweg 365,2023-06-18,22:00:00,6,6,0,FMN GV 05 Lier
60,Mechelsesteenweg 365,2023-06-18,23:00:00,4,0,4,FMN GV 05 Lier
60,Mechelsesteenweg 365,2023-06-19,00:00:00,6,4,2,FMN GV 05 Lier
60,Mechelsesteenweg 365,2023-06-19,01:00:00,0,0,0,FMN GV 05 Lier
60,Mechelsesteenweg 365,2023-06-19,02:00:00,0,0,0,FMN GV 05 Lier
60,Mechelsesteenweg 365,2023-06-19,03:00:00,2,0,2,FMN GV 05 Lier
60,Mechelsesteenweg 365,2023-06-19,04:00:00,2,2,0,FMN GV 05 Lier
60,Mechelsesteenweg 365,2023-06-19,05:00:00,8,0,8,FMN GV 05 Lier
60,Mechelsesteenweg 365,2023-06-19,06:00:00,34,16,18,FMN GV 05 Lier
60,Mechelsesteenweg 365,2023-06-19,07:00:00,224,124,100,FMN GV 05 Lier
60,Mechelsesteenweg 365,2023-06-19,08:00:00,206,86,120,FMN GV 05 Lier
60,Mechelsesteenweg 365,2023-06-19,09:00:00,140,38,102,FMN GV 05 Lier
60,Mechelsesteenweg 365,2023-06-19,10:00:00,120,46,74,FMN GV 05 Lier
60,Mechelsesteenweg 365,2023-06-19,11:00:00,70,38,32,FMN GV 05 Lier
60,Mechelsesteenweg 365,2023-06-19,12:00:00,22,8,14,FMN GV 05 Lier
60,Mechelsesteenweg 365,2023-06-19,13:00:00,0,0,0,FMN GV 05 Lier
60,Mechelsesteenweg 365,2023-06-19,14:00:00,0,0,0,FMN GV 05 Lier
60,Mechelsesteenweg 365,2023-06-19,15:00:00,0,0,0,FMN GV 05 Lier
60,Mechelsesteenweg 365,2023-06-19,16:00:00,0,0,0,FMN GV 05 Lier
60,Mechelsesteenweg 365,2023-06-19,17:00:00,10,4,6,FMN GV 05 Lier
60,Mechelsesteenweg 365,2023-06-19,18:00:00,72,28,44,FMN GV 05 Lier
60,Mechelsesteenweg 365,2023-06-19,19:00:00,146,72,74,FMN GV 05 Lier
60,Mechelsesteenweg 365,2023-06-19,20:00:00,136,54,82,FMN GV 05 Lier
60,Mechelsesteenweg 365,2023-06-19,21:00:00,70,34,36,FMN GV 05 Lier
60,Mechelsesteenweg 365,2023-06-19,22:00:00,12,2,10,FMN GV 05 Lier
60,Mechelsesteenweg 365,2023-06-19,23:00:00,6,6,0,FMN GV 05 Lier
60,Mechelsesteenweg 365,2023-06-20,00:00:00,0,0,0,FMN GV 05 Lier
60,Mechelsesteenweg 365,2023-06-20,01:00:00,0,0,0,FMN GV 05 Lier
60,Mechelsesteenweg 365,2023-06-20,02:00:00,0,0,0,FMN GV 05 Lier
60,Mechelsesteenweg 365,2023-06-20,03:00:00,2,0,2,FMN GV 05 Lier
60,Mechelsesteenweg 365,2023-06-20,04:00:00,2,0,2,FMN GV 05 Lier
60,Mechelsesteenweg 365,2023-06-20,05:00:00,6,0,6,FMN GV 05 Lier
60,Mechelsesteenweg 365,2023-06-20,06:00:00,40,14,26,FMN GV 05 Lier
60,Mechelsesteenweg 365,2023-06-20,07:00:00,210,118,92,FMN GV 05 Lier
60,Mechelsesteenweg 365,2023-06-20,08:00:00,180,96,84,FMN GV 05 Lier
60,Mechelsesteenweg 365,2023-06-20,09:00:00,166,80,86,FMN GV 05 Lier
60,Mechelsesteenweg 365,2023-06-20,10:00:00,110,32,78,FMN GV 05 Lier
60,Mechelsesteenweg 365,2023-06-20,11:00:00,0,0,0,FMN GV 05 Lier
60,Mechelsesteenweg 365,2023-06-20,12:00:00,0,0,0,FMN GV 05 Lier
60,Mechelsesteenweg 365,2023-06-20,13:00:00,0,0,0,FMN GV 05 Lier
60,Mechelsesteenweg 365,2023-06-20,14:00:00,44,32,12,FMN GV 05 Lier
60,Mechelsesteenweg 365,2023-06-20,15:00:00,142,94,48,FMN GV 05 Lier
60,Mechelsesteenweg 365,2023-06-20,16:00:00,180,106,74,FMN GV 05 Lier
60,Mechelsesteenweg 365,2023-06-20,17:00:00,122,70,52,FMN GV 05 Lier
60,Mechelsesteenweg 365,2023-06-20,18:00:00,26,16,10,FMN GV 05 Lier
60,Mechelsesteenweg 365,2023-06-20,19:00:00,22,14,8,FMN GV 05 Lier
60,Mechelsesteenweg 365,2023-06-20,20:00:00,12,4,8,FMN GV 05 Lier
60,Mechelsesteenweg 365,2023-06-20,21:00:00,4,0,4,FMN GV 05 Lier
60,Mechelsesteenweg 365,2023-06-20,22:00:00,10,4,6,FMN GV 05 Lier
60,Mechelsesteenweg 365,2023-06-20,23:00:00,2,2,0,FMN GV 05 Lier
60,Mechelsesteenweg 365,2023-06-21,00:00:00,2,0,2,FMN GV 05 Lier
60,Mechelsesteenweg 365,2023-06-21,01:00:00,2,2,0,FMN GV 05 Lier
60,Mechelsesteenweg 365,2023-06-21,02:00:00,0,0,0,FMN GV 05 Lier
60,Mechelsesteenweg 365,2023-06-21,03:00:00,2,0,2,FMN GV 05 Lier
60,Mechelsesteenweg 365,2023-06-21,04:00:00,0,0,0,FMN GV 05 Lier
60,Mechelsesteenweg 365,2023-06-21,05:00:00,4,0,4,FMN GV 05 Lier
60,Mechelsesteenweg 365,2023-06-21,06:00:00,44,10,34,FMN GV 05 Lier
60,Mechelsesteenweg 365,2023-06-21,07:00:00,206,122,84,FMN GV 05 Lier
60,Mechelsesteenweg 365,2023-06-21,08:00:00,188,104,84,FMN GV 05 Lier
60,Mechelsesteenweg 365,2023-06-21,09:00:00,206,72,134,FMN GV 05 Lier
60,Mechelsesteenweg 365,2023-06-21,10:00:00,218,104,114,FMN GV 05 Lier
60,Mechelsesteenweg 365,2023-06-21,11:00:00,66,28,38,FMN GV 05 Lier
60,Mechelsesteenweg 365,2023-06-21,12:00:00,0,0,0,FMN GV 05 Lier
60,Mechelsesteenweg 365,2023-06-21,13:00:00,0,0,0,FMN GV 05 Lier
60,Mechelsesteenweg 365,2023-06-21,14:00:00,0,0,0,FMN GV 05 Lier
60,Mechelsesteenweg 365,2023-06-21,15:00:00,0,0,0,FMN GV 05 Lier
60,Mechelsesteenweg 365,2023-06-21,16:00:00,0,0,0,FMN GV 05 Lier
60,Mechelsesteenweg 365,2023-06-21,17:00:00,0,0,0,FMN GV 05 Lier
60,Mechelsesteenweg 365,2023-06-21,18:00:00,112,70,42,FMN GV 05 Lier
60,Mechelsesteenweg 365,2023-06-21,19:00:00,242,114,128,FMN GV 05 Lier
60,Mechelsesteenweg 365,2023-06-21,20:00:00,316,184,132,FMN GV 05 Lier
60,Mechelsesteenweg 365,2023-06-21,21:00:00,96,24,72,FMN GV 05 Lier
60,Mechelsesteenweg 365,2023-06-21,22:00:00,26,14,12,FMN GV 05 Lier
60,Mechelsesteenweg 365,2023-06-21,23:00:00,12,8,4,FMN GV 05 Lier
60,Mechelsesteenweg 365,2023-06-22,00:00:00,2,0,2,FMN GV 05 Lier
60,Mechelsesteenweg 365,2023-06-22,01:00:00,0,0,0,FMN GV 05 Lier
60,Mechelsesteenweg 365,2023-06-22,02:00:00,2,2,0,FMN GV 05 Lier
60,Mechelsesteenweg 365,2023-06-22,03:00:00,4,2,2,FMN GV 05 Lier
60,Mechelsesteenweg 365,2023-06-22,04:00:00,2,0,2,FMN GV 05 Lier
60,Mechelsesteenweg 365,2023-06-22,05:00:00,0,0,0,FMN GV 05 Lier
60,Mechelsesteenweg 365,2023-06-22,06:00:00,32,6,26,FMN GV 05 Lier
60,Mechelsesteenweg 365,2023-06-22,07:00:00,184,120,64,FMN GV 05 Lier
60,Mechelsesteenweg 365,2023-06-22,08:00:00,168,84,84,FMN GV 05 Lier
60,Mechelsesteenweg 365,2023-06-22,09:00:00,148,80,68,FMN GV 05 Lier
60,Mechelsesteenweg 365,2023-06-22,10:00:00,152,44,108,FMN GV 05 Lier
60,Mechelsesteenweg 365,2023-06-22,11:00:00,70,22,48,FMN GV 05 Lier
60,Mechelsesteenweg 365,2023-06-22,12:00:00,40,16,24,FMN GV 05 Lier
60,Mechelsesteenweg 365,2023-06-22,13:00:00,8,4,4,FMN GV 05 Lier
60,Mechelsesteenweg 365,2023-06-22,14:00:00,54,8,46,FMN GV 05 Lier
60,Mechelsesteenweg 365,2023-06-22,15:00:00,30,18,12,FMN GV 05 Lier
60,Mechelsesteenweg 365,2023-06-22,16:00:00,40,30,10,FMN GV 05 Lier
60,Mechelsesteenweg 365,2023-06-22,17:00:00,58,44,14,FMN GV 05 Lier
60,Mechelsesteenweg 365,2023-06-22,18:00:00,32,18,14,FMN GV 05 Lier
60,Mechelsesteenweg 365,2023-06-22,19:00:00,20,14,6,FMN GV 05 Lier
60,Mechelsesteenweg 365,2023-06-22,20:00:00,28,16,12,FMN GV 05 Lier
60,Mechelsesteenweg 365,2023-06-22,21:00:00,12,2,10,FMN GV 05 Lier
60,Mechelsesteenweg 365,2023-06-22,22:00:00,10,4,6,FMN GV 05 Lier
60,Mechelsesteenweg 365,2023-06-22,23:00:00,0,0,0,FMN GV 05 Lier
60,Mechelsesteenweg 365,2023-06-23,00:00:00,10,4,6,FMN GV 05 Lier
60,Mechelsesteenweg 365,2023-06-23,01:00:00,0,0,0,FMN GV 05 Lier
60,Mechelsesteenweg 365,2023-06-23,02:00:00,0,0,0,FMN GV 05 Lier
60,Mechelsesteenweg 365,2023-06-23,03:00:00,2,0,2,FMN GV 05 Lier
60,Mechelsesteenweg 365,2023-06-23,04:00:00,0,0,0,FMN GV 05 Lier
60,Mechelsesteenweg 365,2023-06-23,05:00:00,6,2,4,FMN GV 05 Lier
60,Mechelsesteenweg 365,2023-06-23,06:00:00,20,6,14,FMN GV 05 Lier
60,Mechelsesteenweg 365,2023-06-23,07:00:00,152,94,58,FMN GV 05 Lier
60,Mechelsesteenweg 365,2023-06-23,08:00:00,184,106,78,FMN GV 05 Lier
60,Mechelsesteenweg 365,2023-06-23,09:00:00,172,92,80,FMN GV 05 Lier
60,Mechelsesteenweg 365,2023-06-23,10:00:00,254,102,152,FMN GV 05 Lier
60,Mechelsesteenweg 365,2023-06-23,11:00:00,116,46,70,FMN GV 05 Lier
60,Mechelsesteenweg 365,2023-06-23,12:00:00,0,0,0,FMN GV 05 Lier
60,Mechelsesteenweg 365,2023-06-23,13:00:00,0,0,0,FMN GV 05 Lier
60,Mechelsesteenweg 365,2023-06-23,14:00:00,0,0,0,FMN GV 05 Lier
60,Mechelsesteenweg 365,2023-06-23,15:00:00,0,0,0,FMN GV 05 Lier
60,Mechelsesteenweg 365,2023-06-23,16:00:00,0,0,0,FMN GV 05 Lier
60,Mechelsesteenweg 365,2023-06-23,17:00:00,188,108,80,FMN GV 05 Lier
60,Mechelsesteenweg 365,2023-06-23,18:00:00,148,78,70,FMN GV 05 Lier
60,Mechelsesteenweg 365,2023-06-23,19:00:00,152,70,82,FMN GV 05 Lier
60,Mechelsesteenweg 365,2023-06-23,20:00:00,148,88,60,FMN GV 05 Lier
60,Mechelsesteenweg 365,2023-06-23,21:00:00,66,28,38,FMN GV 05 Lier
60,Mechelsesteenweg 365,2023-06-23,22:00:00,38,12,26,FMN GV 05 Lier
60,Mechelsesteenweg 365,2023-06-23,23:00:00,10,2,8,FMN GV 05 Lier
60,Mechelsesteenweg 365,2023-06-24,00:00:00,12,0,12,FMN GV 05 Lier
60,Mechelsesteenweg 365,2023-06-24,01:00:00,10,6,4,FMN GV 05 Lier
60,Mechelsesteenweg 365,2023-06-24,02:00:00,12,2,10,FMN GV 05 Lier
60,Mechelsesteenweg 365,2023-06-24,03:00:00,0,0,0,FMN GV 05 Lier
60,Mechelsesteenweg 365,2023-06-24,04:00:00,2,0,2,FMN GV 05 Lier
60,Mechelsesteenweg 365,2023-06-24,05:00:00,8,2,6,FMN GV 05 Lier
60,Mechelsesteenweg 365,2023-06-24,06:00:00,12,10,2,FMN GV 05 Lier
60,Mechelsesteenweg 365,2023-06-24,07:00:00,30,12,18,FMN GV 05 Lier
60,Mechelsesteenweg 365,2023-06-24,08:00:00,98,60,38,FMN GV 05 Lier
60,Mechelsesteenweg 365,2023-06-24,09:00:00,164,92,72,FMN GV 05 Lier
60,Mechelsesteenweg 365,2023-06-24,10:00:00,246,148,98,FMN GV 05 Lier
60,Mechelsesteenweg 365,2023-06-24,11:00:00,92,54,38,FMN GV 05 Lier
60,Mechelsesteenweg 365,2023-06-24,12:00:00,0,0,0,FMN GV 05 Lier
60,Mechelsesteenweg 365,2023-06-24,13:00:00,0,0,0,FMN GV 05 Lier
60,Mechelsesteenweg 365,2023-06-24,14:00:00,0,0,0,FMN GV 05 Lier
60,Mechelsesteenweg 365,2023-06-24,15:00:00,0,0,0,FMN GV 05 Lier
60,Mechelsesteenweg 365,2023-06-24,16:00:00,0,0,0,FMN GV 05 Lier
60,Mechelsesteenweg 365,2023-06-24,17:00:00,0,0,0,FMN GV 05 Lier
60,Mechelsesteenweg 365,2023-06-24,18:00:00,6,6,0,FMN GV 05 Lier
60,Mechelsesteenweg 365,2023-06-24,19:00:00,122,66,56,FMN GV 05 Lier
60,Mechelsesteenweg 365,2023-06-24,20:00:00,122,72,50,FMN GV 05 Lier
60,Mechelsesteenweg 365,2023-06-24,21:00:00,70,22,48,FMN GV 05 Lier
60,Mechelsesteenweg 365,2023-06-24,22:00:00,36,22,14,FMN GV 05 Lier
60,Mechelsesteenweg 365,2023-06-24,23:00:00,10,10,0,FMN GV 05 Lier
60,Mechelsesteenweg 365,2023-06-25,00:00:00,8,2,6,FMN GV 05 Lier
60,Mechelsesteenweg 365,2023-06-25,01:00:00,10,0,10,FMN GV 05 Lier
60,Mechelsesteenweg 365,2023-06-25,02:00:00,2,0,2,FMN GV 05 Lier
60,Mechelsesteenweg 365,2023-06-25,03:00:00,2,2,0,FMN GV 05 Lier
60,Mechelsesteenweg 365,2023-06-25,04:00:00,0,0,0,FMN GV 05 Lier
60,Mechelsesteenweg 365,2023-06-25,05:00:00,6,6,0,FMN GV 05 Lier
60,Mechelsesteenweg 365,2023-06-25,06:00:00,24,10,14,FMN GV 05 Lier
60,Mechelsesteenweg 365,2023-06-25,07:00:00,46,22,24,FMN GV 05 Lier
60,Mechelsesteenweg 365,2023-06-25,08:00:00,160,92,68,FMN GV 05 Lier
60,Mechelsesteenweg 365,2023-06-25,09:00:00,380,216,164,FMN GV 05 Lier
60,Mechelsesteenweg 365,2023-06-25,10:00:00,548,282,266,FMN GV 05 Lier
60,Mechelsesteenweg 365,2023-06-25,11:00:00,128,52,76,FMN GV 05 Lier
60,Mechelsesteenweg 365,2023-06-25,12:00:00,0,0,0,FMN GV 05 Lier
60,Mechelsesteenweg 365,2023-06-25,13:00:00,0,0,0,FMN GV 05 Lier
60,Mechelsesteenweg 365,2023-06-25,14:00:00,0,0,0,FMN GV 05 Lier
60,Mechelsesteenweg 365,2023-06-25,15:00:00,0,0,0,FMN GV 05 Lier
60,Mechelsesteenweg 365,2023-06-25,16:00:00,0,0,0,FMN GV 05 Lier
60,Mechelsesteenweg 365,2023-06-25,17:00:00,0,0,0,FMN GV 05 Lier
60,Mechelsesteenweg 365,2023-06-25,18:00:00,8,2,6,FMN GV 05 Lier
60,Mechelsesteenweg 365,2023-06-25,19:00:00,86,24,62,FMN GV 05 Lier
60,Mechelsesteenweg 365,2023-06-25,20:00:00,110,40,70,FMN GV 05 Lier
60,Mechelsesteenweg 365,2023-06-25,21:00:00,96,32,64,FMN GV 05 Lier
60,Mechelsesteenweg 365,2023-06-25,22:00:00,22,16,6,FMN GV 05 Lier
60,Mechelsesteenweg 365,2023-06-25,23:00:00,18,0,18,FMN GV 05 Lier
60,Mechelsesteenweg 365,2023-06-26,00:00:00,4,0,4,FMN GV 05 Lier
60,Mechelsesteenweg 365,2023-06-26,01:00:00,0,0,0,FMN GV 05 Lier
60,Mechelsesteenweg 365,2023-06-26,02:00:00,0,0,0,FMN GV 05 Lier
60,Mechelsesteenweg 365,2023-06-26,03:00:00,2,0,2,FMN GV 05 Lier
60,Mechelsesteenweg 365,2023-06-26,04:00:00,0,0,0,FMN GV 05 Lier
60,Mechelsesteenweg 365,2023-06-26,05:00:00,8,2,6,FMN GV 05 Lier
60,Mechelsesteenweg 365,2023-06-26,06:00:00,54,24,30,FMN GV 05 Lier
60,Mechelsesteenweg 365,2023-06-26,07:00:00,140,42,98,FMN GV 05 Lier
60,Mechelsesteenweg 365,2023-06-26,08:00:00,152,52,100,FMN GV 05 Lier
60,Mechelsesteenweg 365,2023-06-26,09:00:00,126,62,64,FMN GV 05 Lier
60,Mechelsesteenweg 365,2023-06-26,10:00:00,234,158,76,FMN GV 05 Lier
60,Mechelsesteenweg 365,2023-06-26,11:00:00,108,54,54,FMN GV 05 Lier
60,Mechelsesteenweg 365,2023-06-26,12:00:00,62,18,44,FMN GV 05 Lier
60,Mechelsesteenweg 365,2023-06-26,13:00:00,4,0,4,FMN GV 05 Lier
60,Mechelsesteenweg 365,2023-06-26,14:00:00,0,0,0,FMN GV 05 Lier
60,Mechelsesteenweg 365,2023-06-26,15:00:00,60,30,30,FMN GV 05 Lier
60,Mechelsesteenweg 365,2023-06-26,16:00:00,146,92,54,FMN GV 05 Lier
60,Mechelsesteenweg 365,2023-06-26,17:00:00,194,110,84,FMN GV 05 Lier
60,Mechelsesteenweg 365,2023-06-26,18:00:00,150,86,64,FMN GV 05 Lier
60,Mechelsesteenweg 365,2023-06-26,19:00:00,104,54,50,FMN GV 05 Lier
60,Mechelsesteenweg 365,2023-06-26,20:00:00,108,58,50,FMN GV 05 Lier
60,Mechelsesteenweg 365,2023-06-26,21:00:00,56,20,36,FMN GV 05 Lier
60,Mechelsesteenweg 365,2023-06-26,22:00:00,40,20,20,FMN GV 05 Lier
60,Mechelsesteenweg 365,2023-06-26,23:00:00,2,0,2,FMN GV 05 Lier
60,Mechelsesteenweg 365,2023-06-27,00:00:00,4,2,2,FMN GV 05 Lier
60,Mechelsesteenweg 365,2023-06-27,01:00:00,6,0,6,FMN GV 05 Lier
60,Mechelsesteenweg 365,2023-06-27,02:00:00,0,0,0,FMN GV 05 Lier
60,Mechelsesteenweg 365,2023-06-27,03:00:00,2,0,2,FMN GV 05 Lier
60,Mechelsesteenweg 365,2023-06-27,04:00:00,0,0,0,FMN GV 05 Lier
60,Mechelsesteenweg 365,2023-06-27,05:00:00,10,4,6,FMN GV 05 Lier
60,Mechelsesteenweg 365,2023-06-27,06:00:00,56,20,36,FMN GV 05 Lier
60,Mechelsesteenweg 365,2023-06-27,07:00:00,154,40,114,FMN GV 05 Lier
60,Mechelsesteenweg 365,2023-06-27,08:00:00,174,70,104,FMN GV 05 Lier
60,Mechelsesteenweg 365,2023-06-27,09:00:00,240,90,150,FMN GV 05 Lier
60,Mechelsesteenweg 365,2023-06-27,10:00:00,200,102,98,FMN GV 05 Lier
60,Mechelsesteenweg 365,2023-06-27,11:00:00,162,98,64,FMN GV 05 Lier
60,Mechelsesteenweg 365,2023-06-27,12:00:00,116,58,58,FMN GV 05 Lier
60,Mechelsesteenweg 365,2023-06-27,13:00:00,194,96,98,FMN GV 05 Lier
60,Mechelsesteenweg 365,2023-06-27,14:00:00,162,80,82,FMN GV 05 Lier
60,Mechelsesteenweg 365,2023-06-27,15:00:00,246,164,82,FMN GV 05 Lier
60,Mechelsesteenweg 365,2023-06-27,16:00:00,284,140,144,FMN GV 05 Lier
60,Mechelsesteenweg 365,2023-06-27,17:00:00,220,138,82,FMN GV 05 Lier
60,Mechelsesteenweg 365,2023-06-27,18:00:00,140,100,40,FMN GV 05 Lier
60,Mechelsesteenweg 365,2023-06-27,19:00:00,138,80,58,FMN GV 05 Lier
60,Mechelsesteenweg 365,2023-06-27,20:00:00,150,62,88,FMN GV 05 Lier
60,Mechelsesteenweg 365,2023-06-27,21:00:00,58,26,32,FMN GV 05 Lier
60,Mechelsesteenweg 365,2023-06-27,22:00:00,14,14,0,FMN GV 05 Lier
60,Mechelsesteenweg 365,2023-06-27,23:00:00,12,4,8,FMN GV 05 Lier
60,Mechelsesteenweg 365,2023-06-28,00:00:00,4,2,2,FMN GV 05 Lier
60,Mechelsesteenweg 365,2023-06-28,01:00:00,0,0,0,FMN GV 05 Lier
60,Mechelsesteenweg 365,2023-06-28,02:00:00,2,2,0,FMN GV 05 Lier
60,Mechelsesteenweg 365,2023-06-28,03:00:00,2,0,2,FMN GV 05 Lier
60,Mechelsesteenweg 365,2023-06-28,04:00:00,2,0,2,FMN GV 05 Lier
60,Mechelsesteenweg 365,2023-06-28,05:00:00,4,2,2,FMN GV 05 Lier
60,Mechelsesteenweg 365,2023-06-28,06:00:00,40,14,26,FMN GV 05 Lier
60,Mechelsesteenweg 365,2023-06-28,07:00:00,90,30,60,FMN GV 05 Lier
60,Mechelsesteenweg 365,2023-06-28,08:00:00,112,46,66,FMN GV 05 Lier
60,Mechelsesteenweg 365,2023-06-28,09:00:00,98,48,50,FMN GV 05 Lier
60,Mechelsesteenweg 365,2023-06-28,10:00:00,98,54,44,FMN GV 05 Lier
60,Mechelsesteenweg 365,2023-06-28,11:00:00,108,76,32,FMN GV 05 Lier
60,Mechelsesteenweg 365,2023-06-28,12:00:00,110,48,62,FMN GV 05 Lier
60,Mechelsesteenweg 365,2023-06-28,13:00:00,138,76,62,FMN GV 05 Lier
60,Mechelsesteenweg 365,2023-06-28,14:00:00,170,94,76,FMN GV 05 Lier
60,Mechelsesteenweg 365,2023-06-28,15:00:00,220,100,120,FMN GV 05 Lier
60,Mechelsesteenweg 365,2023-06-28,16:00:00,194,112,82,FMN GV 05 Lier
60,Mechelsesteenweg 365,2023-06-28,17:00:00,154,84,70,FMN GV 05 Lier
60,Mechelsesteenweg 365,2023-06-28,18:00:00,128,86,42,FMN GV 05 Lier
60,Mechelsesteenweg 365,2023-06-28,19:00:00,112,54,58,FMN GV 05 Lier
60,Mechelsesteenweg 365,2023-06-28,20:00:00,180,124,56,FMN GV 05 Lier
60,Mechelsesteenweg 365,2023-06-28,21:00:00,44,14,30,FMN GV 05 Lier
60,Mechelsesteenweg 365,2023-06-28,22:00:00,20,4,16,FMN GV 05 Lier
60,Mechelsesteenweg 365,2023-06-28,23:00:00,4,4,0,FMN GV 05 Lier
60,Mechelsesteenweg 365,2023-06-29,00:00:00,2,2,0,FMN GV 05 Lier
60,Mechelsesteenweg 365,2023-06-29,01:00:00,0,0,0,FMN GV 05 Lier
60,Mechelsesteenweg 365,2023-06-29,02:00:00,2,2,0,FMN GV 05 Lier
60,Mechelsesteenweg 365,2023-06-29,03:00:00,4,0,4,FMN GV 05 Lier
60,Mechelsesteenweg 365,2023-06-29,04:00:00,0,0,0,FMN GV 05 Lier
60,Mechelsesteenweg 365,2023-06-29,05:00:00,4,0,4,FMN GV 05 Lier
60,Mechelsesteenweg 365,2023-06-29,06:00:00,30,4,26,FMN GV 05 Lier
60,Mechelsesteenweg 365,2023-06-29,07:00:00,122,52,70,FMN GV 05 Lier
60,Mechelsesteenweg 365,2023-06-29,08:00:00,174,104,70,FMN GV 05 Lier
60,Mechelsesteenweg 365,2023-06-29,09:00:00,132,62,70,FMN GV 05 Lier
60,Mechelsesteenweg 365,2023-06-29,10:00:00,168,64,104,FMN GV 05 Lier
60,Mechelsesteenweg 365,2023-06-29,11:00:00,208,104,104,FMN GV 05 Lier
60,Mechelsesteenweg 365,2023-06-29,12:00:00,148,62,86,FMN GV 05 Lier
60,Mechelsesteenweg 365,2023-06-29,13:00:00,144,86,58,FMN GV 05 Lier
60,Mechelsesteenweg 365,2023-06-29,14:00:00,200,96,104,FMN GV 05 Lier
60,Mechelsesteenweg 365,2023-06-29,15:00:00,124,56,68,FMN GV 05 Lier
60,Mechelsesteenweg 365,2023-06-29,16:00:00,158,80,78,FMN GV 05 Lier
60,Mechelsesteenweg 365,2023-06-29,17:00:00,184,130,54,FMN GV 05 Lier
60,Mechelsesteenweg 365,2023-06-29,18:00:00,72,48,24,FMN GV 05 Lier
60,Mechelsesteenweg 365,2023-06-29,19:00:00,142,56,86,FMN GV 05 Lier
60,Mechelsesteenweg 365,2023-06-29,20:00:00,62,34,28,FMN GV 05 Lier
60,Mechelsesteenweg 365,2023-06-29,21:00:00,52,32,20,FMN GV 05 Lier
60,Mechelsesteenweg 365,2023-06-29,22:00:00,12,6,6,FMN GV 05 Lier
60,Mechelsesteenweg 365,2023-06-29,23:00:00,6,4,2,FMN GV 05 Lier
60,Mechelsesteenweg 365,2023-06-30,00:00:00,4,2,2,FMN GV 05 Lier
60,Mechelsesteenweg 365,2023-06-30,01:00:00,0,0,0,FMN GV 05 Lier
60,Mechelsesteenweg 365,2023-06-30,02:00:00,0,0,0,FMN GV 05 Lier
60,Mechelsesteenweg 365,2023-06-30,03:00:00,0,0,0,FMN GV 05 Lier
60,Mechelsesteenweg 365,2023-06-30,04:00:00,0,0,0,FMN GV 05 Lier
60,Mechelsesteenweg 365,2023-06-30,05:00:00,6,2,4,FMN GV 05 Lier
60,Mechelsesteenweg 365,2023-06-30,06:00:00,40,16,24,FMN GV 05 Lier
60,Mechelsesteenweg 365,2023-06-30,07:00:00,108,40,68,FMN GV 05 Lier
60,Mechelsesteenweg 365,2023-06-30,08:00:00,128,80,48,FMN GV 05 Lier
60,Mechelsesteenweg 365,2023-06-30,09:00:00,140,98,42,FMN GV 05 Lier
60,Mechelsesteenweg 365,2023-06-30,10:00:00,180,96,84,FMN GV 05 Lier
60,Mechelsesteenweg 365,2023-06-30,11:00:00,188,90,98,FMN GV 05 Lier
60,Mechelsesteenweg 365,2023-06-30,12:00:00,98,50,48,FMN GV 05 Lier
60,Mechelsesteenweg 365,2023-06-30,13:00:00,86,44,42,FMN GV 05 Lier
60,Mechelsesteenweg 365,2023-06-30,14:00:00,30,14,16,FMN GV 05 Lier
60,Mechelsesteenweg 365,2023-06-30,15:00:00,0,0,0,FMN GV 05 Lier
60,Mechelsesteenweg 365,2023-06-30,16:00:00,192,98,94,FMN GV 05 Lier
60,Mechelsesteenweg 365,2023-06-30,17:00:00,146,96,50,FMN GV 05 Lier
60,Mechelsesteenweg 365,2023-06-30,18:00:00,114,64,50,FMN GV 05 Lier
60,Mechelsesteenweg 365,2023-06-30,19:00:00,82,46,36,FMN GV 05 Lier
60,Mechelsesteenweg 365,2023-06-30,20:00:00,84,40,44,FMN GV 05 Lier
60,Mechelsesteenweg 365,2023-06-30,21:00:00,58,28,30,FMN GV 05 Lier
60,Mechelsesteenweg 365,2023-06-30,22:00:00,40,0,40,FMN GV 05 Lier
60,Mechelsesteenweg 365,2023-06-30,23:00:00,36,6,30,FMN GV 05 Lier
60,Mechelsesteenweg 365,2023-07-01,00:00:00,16,10,6,FMN GV 05 Lier
60,Mechelsesteenweg 365,2023-07-01,01:00:00,6,6,0,FMN GV 05 Lier
60,Mechelsesteenweg 365,2023-07-01,02:00:00,16,16,0,FMN GV 05 Lier
60,Mechelsesteenweg 365,2023-07-01,03:00:00,18,18,0,FMN GV 05 Lier
60,Mechelsesteenweg 365,2023-07-01,04:00:00,4,0,4,FMN GV 05 Lier
60,Mechelsesteenweg 365,2023-07-01,05:00:00,2,0,2,FMN GV 05 Lier
60,Mechelsesteenweg 365,2023-07-01,06:00:00,6,2,4,FMN GV 05 Lier
60,Mechelsesteenweg 365,2023-07-01,07:00:00,32,28,4,FMN GV 05 Lier
60,Mechelsesteenweg 365,2023-07-01,08:00:00,20,14,6,FMN GV 05 Lier
60,Mechelsesteenweg 365,2023-07-01,09:00:00,84,56,28,FMN GV 05 Lier
60,Mechelsesteenweg 365,2023-07-01,10:00:00,36,12,24,FMN GV 05 Lier
60,Mechelsesteenweg 365,2023-07-01,11:00:00,58,36,22,FMN GV 05 Lier
60,Mechelsesteenweg 365,2023-07-01,12:00:00,42,22,20,FMN GV 05 Lier
60,Mechelsesteenweg 365,2023-07-01,13:00:00,52,34,18,FMN GV 05 Lier
60,Mechelsesteenweg 365,2023-07-01,14:00:00,68,26,42,FMN GV 05 Lier
60,Mechelsesteenweg 365,2023-07-01,15:00:00,66,36,30,FMN GV 05 Lier
60,Mechelsesteenweg 365,2023-07-01,16:00:00,40,22,18,FMN GV 05 Lier
60,Mechelsesteenweg 365,2023-07-01,17:00:00,32,12,20,FMN GV 05 Lier
60,Mechelsesteenweg 365,2023-07-01,18:00:00,10,6,4,FMN GV 05 Lier
60,Mechelsesteenweg 365,2023-07-01,19:00:00,32,22,10,FMN GV 05 Lier
60,Mechelsesteenweg 365,2023-07-01,20:00:00,62,32,30,FMN GV 05 Lier
60,Mechelsesteenweg 365,2023-07-01,21:00:00,32,12,20,FMN GV 05 Lier
60,Mechelsesteenweg 365,2023-07-01,22:00:00,4,0,4,FMN GV 05 Lier
60,Mechelsesteenweg 365,2023-07-01,23:00:00,12,4,8,FMN GV 05 Lier
60,Mechelsesteenweg 365,2023-07-02,00:00:00,6,4,2,FMN GV 05 Lier
60,Mechelsesteenweg 365,2023-07-02,01:00:00,8,4,4,FMN GV 05 Lier
60,Mechelsesteenweg 365,2023-07-02,02:00:00,0,0,0,FMN GV 05 Lier
60,Mechelsesteenweg 365,2023-07-02,03:00:00,4,4,0,FMN GV 05 Lier
60,Mechelsesteenweg 365,2023-07-02,04:00:00,0,0,0,FMN GV 05 Lier
60,Mechelsesteenweg 365,2023-07-02,05:00:00,2,0,2,FMN GV 05 Lier
60,Mechelsesteenweg 365,2023-07-02,06:00:00,8,2,6,FMN GV 05 Lier
60,Mechelsesteenweg 365,2023-07-02,07:00:00,22,16,6,FMN GV 05 Lier
60,Mechelsesteenweg 365,2023-07-02,08:00:00,72,46,26,FMN GV 05 Lier
60,Mechelsesteenweg 365,2023-07-02,09:00:00,246,142,104,FMN GV 05 Lier
60,Mechelsesteenweg 365,2023-07-02,10:00:00,384,190,194,FMN GV 05 Lier
60,Mechelsesteenweg 365,2023-07-02,11:00:00,504,250,254,FMN GV 05 Lier
60,Mechelsesteenweg 365,2023-07-02,12:00:00,290,176,114,FMN GV 05 Lier
60,Mechelsesteenweg 365,2023-07-02,13:00:00,252,158,94,FMN GV 05 Lier
60,Mechelsesteenweg 365,2023-07-02,14:00:00,236,102,134,FMN GV 05 Lier
60,Mechelsesteenweg 365,2023-07-02,15:00:00,68,38,30,FMN GV 05 Lier
60,Mechelsesteenweg 365,2023-07-02,16:00:00,248,104,144,FMN GV 05 Lier
60,Mechelsesteenweg 365,2023-07-02,17:00:00,134,42,92,FMN GV 05 Lier
60,Mechelsesteenweg 365,2023-07-02,18:00:00,110,56,54,FMN GV 05 Lier
60,Mechelsesteenweg 365,2023-07-02,19:00:00,58,30,28,FMN GV 05 Lier
60,Mechelsesteenweg 365,2023-07-02,20:00:00,74,32,42,FMN GV 05 Lier
60,Mechelsesteenweg 365,2023-07-02,21:00:00,58,16,42,FMN GV 05 Lier
60,Mechelsesteenweg 365,2023-07-02,22:00:00,10,6,4,FMN GV 05 Lier
60,Mechelsesteenweg 365,2023-07-02,23:00:00,4,0,4,FMN GV 05 Lier
60,Mechelsesteenweg 365,2023-07-03,00:00:00,0,0,0,FMN GV 05 Lier
60,Mechelsesteenweg 365,2023-07-03,01:00:00,2,2,0,FMN GV 05 Lier
60,Mechelsesteenweg 365,2023-07-03,02:00:00,0,0,0,FMN GV 05 Lier
60,Mechelsesteenweg 365,2023-07-03,03:00:00,2,0,2,FMN GV 05 Lier
60,Mechelsesteenweg 365,2023-07-03,04:00:00,0,0,0,FMN GV 05 Lier
60,Mechelsesteenweg 365,2023-07-03,05:00:00,2,0,2,FMN GV 05 Lier
60,Mechelsesteenweg 365,2023-07-03,06:00:00,38,8,30,FMN GV 05 Lier
60,Mechelsesteenweg 365,2023-07-03,07:00:00,104,28,76,FMN GV 05 Lier
60,Mechelsesteenweg 365,2023-07-03,08:00:00,106,40,66,FMN GV 05 Lier
60,Mechelsesteenweg 365,2023-07-03,09:00:00,64,30,34,FMN GV 05 Lier
60,Mechelsesteenweg 365,2023-07-03,10:00:00,112,64,48,FMN GV 05 Lier
60,Mechelsesteenweg 365,2023-07-03,11:00:00,76,42,34,FMN GV 05 Lier
60,Mechelsesteenweg 365,2023-07-03,12:00:00,66,40,26,FMN GV 05 Lier
60,Mechelsesteenweg 365,2023-07-03,13:00:00,106,56,50,FMN GV 05 Lier
60,Mechelsesteenweg 365,2023-07-03,14:00:00,96,42,54,FMN GV 05 Lier
60,Mechelsesteenweg 365,2023-07-03,15:00:00,156,106,50,FMN GV 05 Lier
60,Mechelsesteenweg 365,2023-07-03,16:00:00,124,82,42,FMN GV 05 Lier
60,Mechelsesteenweg 365,2023-07-03,17:00:00,134,88,46,FMN GV 05 Lier
60,Mechelsesteenweg 365,2023-07-03,18:00:00,84,56,28,FMN GV 05 Lier
60,Mechelsesteenweg 365,2023-07-03,19:00:00,52,28,24,FMN GV 05 Lier
60,Mechelsesteenweg 365,2023-07-03,20:00:00,72,48,24,FMN GV 05 Lier
60,Mechelsesteenweg 365,2023-07-03,21:00:00,40,22,18,FMN GV 05 Lier
60,Mechelsesteenweg 365,2023-07-03,22:00:00,22,10,12,FMN GV 05 Lier
60,Mechelsesteenweg 365,2023-07-03,23:00:00,6,6,0,FMN GV 05 Lier
60,Mechelsesteenweg 365,2023-07-04,00:00:00,0,0,0,FMN GV 05 Lier
60,Mechelsesteenweg 365,2023-07-04,01:00:00,0,0,0,FMN GV 05 Lier
60,Mechelsesteenweg 365,2023-07-04,02:00:00,0,0,0,FMN GV 05 Lier
60,Mechelsesteenweg 365,2023-07-04,03:00:00,2,0,2,FMN GV 05 Lier
60,Mechelsesteenweg 365,2023-07-04,04:00:00,2,0,2,FMN GV 05 Lier
60,Mechelsesteenweg 365,2023-07-04,05:00:00,6,2,4,FMN GV 05 Lier
60,Mechelsesteenweg 365,2023-07-04,06:00:00,52,16,36,FMN GV 05 Lier
60,Mechelsesteenweg 365,2023-07-04,07:00:00,118,34,84,FMN GV 05 Lier
60,Mechelsesteenweg 365,2023-07-04,08:00:00,146,68,78,FMN GV 05 Lier
60,Mechelsesteenweg 365,2023-07-04,09:00:00,106,44,62,FMN GV 05 Lier
60,Mechelsesteenweg 365,2023-07-04,10:00:00,196,82,114,FMN GV 05 Lier
60,Mechelsesteenweg 365,2023-07-04,11:00:00,194,80,114,FMN GV 05 Lier
60,Mechelsesteenweg 365,2023-07-04,12:00:00,104,58,46,FMN GV 05 Lier
60,Mechelsesteenweg 365,2023-07-04,13:00:00,176,96,80,FMN GV 05 Lier
60,Mechelsesteenweg 365,2023-07-04,14:00:00,182,102,80,FMN GV 05 Lier
60,Mechelsesteenweg 365,2023-07-04,15:00:00,180,126,54,FMN GV 05 Lier
60,Mechelsesteenweg 365,2023-07-04,16:00:00,204,118,86,FMN GV 05 Lier
60,Mechelsesteenweg 365,2023-07-04,17:00:00,184,124,60,FMN GV 05 Lier
60,Mechelsesteenweg 365,2023-07-04,18:00:00,86,48,38,FMN GV 05 Lier
60,Mechelsesteenweg 365,2023-07-04,19:00:00,102,80,22,FMN GV 05 Lier
60,Mechelsesteenweg 365,2023-07-04,20:00:00,98,60,38,FMN GV 05 Lier
60,Mechelsesteenweg 365,2023-07-04,21:00:00,30,16,14,FMN GV 05 Lier
60,Mechelsesteenweg 365,2023-07-04,22:00:00,8,6,2,FMN GV 05 Lier
60,Mechelsesteenweg 365,2023-07-04,23:00:00,8,8,0,FMN GV 05 Lier
60,Mechelsesteenweg 365,2023-07-05,00:00:00,4,2,2,FMN GV 05 Lier
60,Mechelsesteenweg 365,2023-07-05,01:00:00,0,0,0,FMN GV 05 Lier
60,Mechelsesteenweg 365,2023-07-05,02:00:00,0,0,0,FMN GV 05 Lier
60,Mechelsesteenweg 365,2023-07-05,03:00:00,2,0,2,FMN GV 05 Lier
60,Mechelsesteenweg 365,2023-07-05,04:00:00,2,0,2,FMN GV 05 Lier
60,Mechelsesteenweg 365,2023-07-05,05:00:00,6,2,4,FMN GV 05 Lier
60,Mechelsesteenweg 365,2023-07-05,06:00:00,22,6,16,FMN GV 05 Lier
60,Mechelsesteenweg 365,2023-07-05,07:00:00,32,12,20,FMN GV 05 Lier
60,Mechelsesteenweg 365,2023-07-05,08:00:00,42,16,26,FMN GV 05 Lier
60,Mechelsesteenweg 365,2023-07-05,09:00:00,40,20,20,FMN GV 05 Lier
60,Mechelsesteenweg 365,2023-07-05,10:00:00,34,22,12,FMN GV 05 Lier
60,Mechelsesteenweg 365,2023-07-05,11:00:00,34,18,16,FMN GV 05 Lier
60,Mechelsesteenweg 365,2023-07-05,12:00:00,28,10,18,FMN GV 05 Lier
60,Mechelsesteenweg 365,2023-07-05,13:00:00,46,14,32,FMN GV 05 Lier
60,Mechelsesteenweg 365,2023-07-05,14:00:00,90,40,50,FMN GV 05 Lier
60,Mechelsesteenweg 365,2023-07-05,15:00:00,72,40,32,FMN GV 05 Lier
60,Mechelsesteenweg 365,2023-07-05,16:00:00,66,46,20,FMN GV 05 Lier
60,Mechelsesteenweg 365,2023-07-05,17:00:00,48,20,28,FMN GV 05 Lier
60,Mechelsesteenweg 365,2023-07-05,18:00:00,20,10,10,FMN GV 05 Lier
60,Mechelsesteenweg 365,2023-07-05,19:00:00,34,20,14,FMN GV 05 Lier
60,Mechelsesteenweg 365,2023-07-05,20:00:00,44,32,12,FMN GV 05 Lier
60,Mechelsesteenweg 365,2023-07-05,21:00:00,20,12,8,FMN GV 05 Lier
60,Mechelsesteenweg 365,2023-07-05,22:00:00,16,8,8,FMN GV 05 Lier
60,Mechelsesteenweg 365,2023-07-05,23:00:00,6,2,4,FMN GV 05 Lier
60,Mechelsesteenweg 365,2023-07-06,00:00:00,2,0,2,FMN GV 05 Lier
60,Mechelsesteenweg 365,2023-07-06,01:00:00,0,0,0,FMN GV 05 Lier
60,Mechelsesteenweg 365,2023-07-06,02:00:00,0,0,0,FMN GV 05 Lier
60,Mechelsesteenweg 365,2023-07-06,03:00:00,2,0,2,FMN GV 05 Lier
60,Mechelsesteenweg 365,2023-07-06,04:00:00,0,0,0,FMN GV 05 Lier
60,Mechelsesteenweg 365,2023-07-06,05:00:00,4,2,2,FMN GV 05 Lier
60,Mechelsesteenweg 365,2023-07-06,06:00:00,50,8,42,FMN GV 05 Lier
60,Mechelsesteenweg 365,2023-07-06,07:00:00,72,20,52,FMN GV 05 Lier
60,Mechelsesteenweg 365,2023-07-06,08:00:00,116,46,70,FMN GV 05 Lier
60,Mechelsesteenweg 365,2023-07-06,09:00:00,130,74,56,FMN GV 05 Lier
60,Mechelsesteenweg 365,2023-07-06,10:00:00,120,78,42,FMN GV 05 Lier
60,Mechelsesteenweg 365,2023-07-06,11:00:00,182,88,94,FMN GV 05 Lier
60,Mechelsesteenweg 365,2023-07-06,12:00:00,216,112,104,FMN GV 05 Lier
60,Mechelsesteenweg 365,2023-07-06,13:00:00,244,120,124,FMN GV 05 Lier
60,Mechelsesteenweg 365,2023-07-06,14:00:00,154,70,84,FMN GV 05 Lier
60,Mechelsesteenweg 365,2023-07-06,15:00:00,222,120,102,FMN GV 05 Lier
60,Mechelsesteenweg 365,2023-07-06,16:00:00,118,64,54,FMN GV 05 Lier
60,Mechelsesteenweg 365,2023-07-06,17:00:00,188,96,92,FMN GV 05 Lier
60,Mechelsesteenweg 365,2023-07-06,18:00:00,188,114,74,FMN GV 05 Lier
60,Mechelsesteenweg 365,2023-07-06,19:00:00,268,172,96,FMN GV 05 Lier
60,Mechelsesteenweg 365,2023-07-06,20:00:00,186,74,112,FMN GV 05 Lier
60,Mechelsesteenweg 365,2023-07-06,21:00:00,86,40,46,FMN GV 05 Lier
60,Mechelsesteenweg 365,2023-07-06,22:00:00,36,10,26,FMN GV 05 Lier
60,Mechelsesteenweg 365,2023-07-06,23:00:00,34,0,34,FMN GV 05 Lier
60,Mechelsesteenweg 365,2023-07-07,00:00:00,14,2,12,FMN GV 05 Lier
60,Mechelsesteenweg 365,2023-07-07,01:00:00,2,0,2,FMN GV 05 Lier
60,Mechelsesteenweg 365,2023-07-07,02:00:00,0,0,0,FMN GV 05 Lier
60,Mechelsesteenweg 365,2023-07-07,03:00:00,2,0,2,FMN GV 05 Lier
60,Mechelsesteenweg 365,2023-07-07,04:00:00,4,2,2,FMN GV 05 Lier
60,Mechelsesteenweg 365,2023-07-07,05:00:00,6,2,4,FMN GV 05 Lier
60,Mechelsesteenweg 365,2023-07-07,06:00:00,44,16,28,FMN GV 05 Lier
60,Mechelsesteenweg 365,2023-07-07,07:00:00,86,26,60,FMN GV 05 Lier
60,Mechelsesteenweg 365,2023-07-07,08:00:00,74,20,54,FMN GV 05 Lier
60,Mechelsesteenweg 365,2023-07-07,09:00:00,146,66,80,FMN GV 05 Lier
60,Mechelsesteenweg 365,2023-07-07,10:00:00,210,102,108,FMN GV 05 Lier
60,Mechelsesteenweg 365,2023-07-07,11:00:00,164,84,80,FMN GV 05 Lier
60,Mechelsesteenweg 365,2023-07-07,12:00:00,10,6,4,FMN GV 05 Lier
60,Mechelsesteenweg 365,2023-07-07,13:00:00,0,0,0,FMN GV 05 Lier
60,Mechelsesteenweg 365,2023-07-07,14:00:00,0,0,0,FMN GV 05 Lier
60,Mechelsesteenweg 365,2023-07-07,15:00:00,0,0,0,FMN GV 05 Lier
60,Mechelsesteenweg 365,2023-07-07,16:00:00,0,0,0,FMN GV 05 Lier
60,Mechelsesteenweg 365,2023-07-07,17:00:00,58,36,22,FMN GV 05 Lier
60,Mechelsesteenweg 365,2023-07-07,18:00:00,124,56,68,FMN GV 05 Lier
60,Mechelsesteenweg 365,2023-07-07,19:00:00,116,46,70,FMN GV 05 Lier
60,Mechelsesteenweg 365,2023-07-07,20:00:00,122,66,56,FMN GV 05 Lier
60,Mechelsesteenweg 365,2023-07-07,21:00:00,58,22,36,FMN GV 05 Lier
60,Mechelsesteenweg 365,2023-07-07,22:00:00,40,18,22,FMN GV 05 Lier
60,Mechelsesteenweg 365,2023-07-07,23:00:00,8,4,4,FMN GV 05 Lier
60,Mechelsesteenweg 365,2023-07-08,00:00:00,4,0,4,FMN GV 05 Lier
60,Mechelsesteenweg 365,2023-07-08,01:00:00,0,0,0,FMN GV 05 Lier
60,Mechelsesteenweg 365,2023-07-08,02:00:00,2,2,0,FMN GV 05 Lier
60,Mechelsesteenweg 365,2023-07-08,03:00:00,4,0,4,FMN GV 05 Lier
60,Mechelsesteenweg 365,2023-07-08,04:00:00,0,0,0,FMN GV 05 Lier
60,Mechelsesteenweg 365,2023-07-08,05:00:00,0,0,0,FMN GV 05 Lier
60,Mechelsesteenweg 365,2023-07-08,06:00:00,14,6,8,FMN GV 05 Lier
60,Mechelsesteenweg 365,2023-07-08,07:00:00,50,28,22,FMN GV 05 Lier
60,Mechelsesteenweg 365,2023-07-08,08:00:00,124,60,64,FMN GV 05 Lier
60,Mechelsesteenweg 365,2023-07-08,09:00:00,260,166,94,FMN GV 05 Lier
60,Mechelsesteenweg 365,2023-07-08,10:00:00,448,278,170,FMN GV 05 Lier
60,Mechelsesteenweg 365,2023-07-08,11:00:00,180,80,100,FMN GV 05 Lier
60,Mechelsesteenweg 365,2023-07-08,12:00:00,0,0,0,FMN GV 05 Lier
60,Mechelsesteenweg 365,2023-07-08,13:00:00,0,0,0,FMN GV 05 Lier
60,Mechelsesteenweg 365,2023-07-08,14:00:00,0,0,0,FMN GV 05 Lier
60,Mechelsesteenweg 365,2023-07-08,15:00:00,64,34,30,FMN GV 05 Lier
60,Mechelsesteenweg 365,2023-07-08,16:00:00,62,22,40,FMN GV 05 Lier
60,Mechelsesteenweg 365,2023-07-08,17:00:00,68,30,38,FMN GV 05 Lier
60,Mechelsesteenweg 365,2023-07-08,18:00:00,54,20,34,FMN GV 05 Lier
60,Mechelsesteenweg 365,2023-07-08,19:00:00,88,26,62,FMN GV 05 Lier
60,Mechelsesteenweg 365,2023-07-08,20:00:00,88,30,58,FMN GV 05 Lier
60,Mechelsesteenweg 365,2023-07-08,21:00:00,58,22,36,FMN GV 05 Lier
60,Mechelsesteenweg 365,2023-07-08,22:00:00,20,12,8,FMN GV 05 Lier
60,Mechelsesteenweg 365,2023-07-08,23:00:00,0,0,0,FMN GV 05 Lier
60,Mechelsesteenweg 365,2023-07-09,00:00:00,2,0,2,FMN GV 05 Lier
60,Mechelsesteenweg 365,2023-07-09,01:00:00,8,8,0,FMN GV 05 Lier
60,Mechelsesteenweg 365,2023-07-09,02:00:00,2,2,0,FMN GV 05 Lier
60,Mechelsesteenweg 365,2023-07-09,03:00:00,0,0,0,FMN GV 05 Lier
60,Mechelsesteenweg 365,2023-07-09,04:00:00,2,2,0,FMN GV 05 Lier
60,Mechelsesteenweg 365,2023-07-09,05:00:00,0,0,0,FMN GV 05 Lier
60,Mechelsesteenweg 365,2023-07-09,06:00:00,20,10,10,FMN GV 05 Lier
60,Mechelsesteenweg 365,2023-07-09,07:00:00,26,14,12,FMN GV 05 Lier
60,Mechelsesteenweg 365,2023-07-09,08:00:00,130,86,44,FMN GV 05 Lier
60,Mechelsesteenweg 365,2023-07-09,09:00:00,402,198,204,FMN GV 05 Lier
60,Mechelsesteenweg 365,2023-07-09,10:00:00,552,236,316,FMN GV 05 Lier
60,Mechelsesteenweg 365,2023-07-09,11:00:00,326,188,138,FMN GV 05 Lier
60,Mechelsesteenweg 365,2023-07-09,12:00:00,158,88,70,FMN GV 05 Lier
60,Mechelsesteenweg 365,2023-07-09,13:00:00,170,62,108,FMN GV 05 Lier
60,Mechelsesteenweg 365,2023-07-09,14:00:00,78,44,34,FMN GV 05 Lier
60,Mechelsesteenweg 365,2023-07-09,15:00:00,20,14,6,FMN GV 05 Lier
60,Mechelsesteenweg 365,2023-07-09,16:00:00,60,18,42,FMN GV 05 Lier
60,Mechelsesteenweg 365,2023-07-09,17:00:00,48,30,18,FMN GV 05 Lier
60,Mechelsesteenweg 365,2023-07-09,18:00:00,56,22,34,FMN GV 05 Lier
60,Mechelsesteenweg 365,2023-07-09,19:00:00,48,20,28,FMN GV 05 Lier
60,Mechelsesteenweg 365,2023-07-09,20:00:00,54,26,28,FMN GV 05 Lier
60,Mechelsesteenweg 365,2023-07-09,21:00:00,44,18,26,FMN GV 05 Lier
60,Mechelsesteenweg 365,2023-07-09,22:00:00,10,6,4,FMN GV 05 Lier
60,Mechelsesteenweg 365,2023-07-09,23:00:00,6,0,6,FMN GV 05 Lier
60,Mechelsesteenweg 365,2023-07-10,00:00:00,0,0,0,FMN GV 05 Lier
60,Mechelsesteenweg 365,2023-07-10,01:00:00,0,0,0,FMN GV 05 Lier
60,Mechelsesteenweg 365,2023-07-10,02:00:00,0,0,0,FMN GV 05 Lier
60,Mechelsesteenweg 365,2023-07-10,03:00:00,0,0,0,FMN GV 05 Lier
60,Mechelsesteenweg 365,2023-07-10,04:00:00,0,0,0,FMN GV 05 Lier
60,Mechelsesteenweg 365,2023-07-10,05:00:00,6,0,6,FMN GV 05 Lier
60,Mechelsesteenweg 365,2023-07-10,06:00:00,42,14,28,FMN GV 05 Lier
60,Mechelsesteenweg 365,2023-07-10,07:00:00,84,32,52,FMN GV 05 Lier
60,Mechelsesteenweg 365,2023-07-10,08:00:00,92,30,62,FMN GV 05 Lier
60,Mechelsesteenweg 365,2023-07-10,09:00:00,110,52,58,FMN GV 05 Lier
60,Mechelsesteenweg 365,2023-07-10,10:00:00,182,104,78,FMN GV 05 Lier
60,Mechelsesteenweg 365,2023-07-10,11:00:00,170,80,90,FMN GV 05 Lier
60,Mechelsesteenweg 365,2023-07-10,12:00:00,0,0,0,FMN GV 05 Lier
60,Mechelsesteenweg 365,2023-07-10,13:00:00,0,0,0,FMN GV 05 Lier
60,Mechelsesteenweg 365,2023-07-10,14:00:00,2,0,2,FMN GV 05 Lier
60,Mechelsesteenweg 365,2023-07-10,15:00:00,2,0,2,FMN GV 05 Lier
60,Mechelsesteenweg 365,2023-07-10,16:00:00,68,36,32,FMN GV 05 Lier
60,Mechelsesteenweg 365,2023-07-10,17:00:00,70,30,40,FMN GV 05 Lier
60,Mechelsesteenweg 365,2023-07-10,18:00:00,162,80,82,FMN GV 05 Lier
60,Mechelsesteenweg 365,2023-07-10,19:00:00,152,82,70,FMN GV 05 Lier
60,Mechelsesteenweg 365,2023-07-10,20:00:00,198,84,114,FMN GV 05 Lier
60,Mechelsesteenweg 365,2023-07-10,21:00:00,92,38,54,FMN GV 05 Lier
60,Mechelsesteenweg 365,2023-07-10,22:00:00,36,26,10,FMN GV 05 Lier
60,Mechelsesteenweg 365,2023-07-10,23:00:00,6,0,6,FMN GV 05 Lier
60,Mechelsesteenweg 365,2023-07-11,00:00:00,4,0,4,FMN GV 05 Lier
60,Mechelsesteenweg 365,2023-07-11,01:00:00,2,2,0,FMN GV 05 Lier
60,Mechelsesteenweg 365,2023-07-11,02:00:00,0,0,0,FMN GV 05 Lier
60,Mechelsesteenweg 365,2023-07-11,03:00:00,0,0,0,FMN GV 05 Lier
60,Mechelsesteenweg 365,2023-07-11,04:00:00,2,0,2,FMN GV 05 Lier
60,Mechelsesteenweg 365,2023-07-11,05:00:00,12,4,8,FMN GV 05 Lier
60,Mechelsesteenweg 365,2023-07-11,06:00:00,28,10,18,FMN GV 05 Lier
60,Mechelsesteenweg 365,2023-07-11,07:00:00,92,30,62,FMN GV 05 Lier
60,Mechelsesteenweg 365,2023-07-11,08:00:00,106,40,66,FMN GV 05 Lier
60,Mechelsesteenweg 365,2023-07-11,09:00:00,272,168,104,FMN GV 05 Lier
60,Mechelsesteenweg 365,2023-07-11,10:00:00,294,138,156,FMN GV 05 Lier
60,Mechelsesteenweg 365,2023-07-11,11:00:00,284,198,86,FMN GV 05 Lier
60,Mechelsesteenweg 365,2023-07-11,12:00:00,198,120,78,FMN GV 05 Lier
60,Mechelsesteenweg 365,2023-07-11,13:00:00,10,2,8,FMN GV 05 Lier
60,Mechelsesteenweg 365,2023-07-11,14:00:00,0,0,0,FMN GV 05 Lier
60,Mechelsesteenweg 365,2023-07-11,15:00:00,32,14,18,FMN GV 05 Lier
60,Mechelsesteenweg 365,2023-07-11,16:00:00,62,20,42,FMN GV 05 Lier
60,Mechelsesteenweg 365,2023-07-11,17:00:00,156,66,90,FMN GV 05 Lier
60,Mechelsesteenweg 365,2023-07-11,18:00:00,174,98,76,FMN GV 05 Lier
60,Mechelsesteenweg 365,2023-07-11,19:00:00,148,78,70,FMN GV 05 Lier
60,Mechelsesteenweg 365,2023-07-11,20:00:00,120,48,72,FMN GV 05 Lier
60,Mechelsesteenweg 365,2023-07-11,21:00:00,62,28,34,FMN GV 05 Lier
60,Mechelsesteenweg 365,2023-07-11,22:00:00,12,8,4,FMN GV 05 Lier
60,Mechelsesteenweg 365,2023-07-11,23:00:00,6,4,2,FMN GV 05 Lier
60,Mechelsesteenweg 365,2023-07-12,00:00:00,0,0,0,FMN GV 05 Lier
60,Mechelsesteenweg 365,2023-07-12,01:00:00,0,0,0,FMN GV 05 Lier
60,Mechelsesteenweg 365,2023-07-12,02:00:00,0,0,0,FMN GV 05 Lier
60,Mechelsesteenweg 365,2023-07-12,03:00:00,0,0,0,FMN GV 05 Lier
60,Mechelsesteenweg 365,2023-07-12,04:00:00,0,0,0,FMN GV 05 Lier
60,Mechelsesteenweg 365,2023-07-12,05:00:00,20,6,14,FMN GV 05 Lier
60,Mechelsesteenweg 365,2023-07-12,06:00:00,48,12,36,FMN GV 05 Lier
60,Mechelsesteenweg 365,2023-07-12,07:00:00,74,32,42,FMN GV 05 Lier
60,Mechelsesteenweg 365,2023-07-12,08:00:00,84,40,44,FMN GV 05 Lier
60,Mechelsesteenweg 365,2023-07-12,09:00:00,60,28,32,FMN GV 05 Lier
60,Mechelsesteenweg 365,2023-07-12,10:00:00,104,48,56,FMN GV 05 Lier
60,Mechelsesteenweg 365,2023-07-12,11:00:00,160,122,38,FMN GV 05 Lier
60,Mechelsesteenweg 365,2023-07-12,12:00:00,124,84,40,FMN GV 05 Lier
60,Mechelsesteenweg 365,2023-07-12,13:00:00,58,22,36,FMN GV 05 Lier
60,Mechelsesteenweg 365,2023-07-12,14:00:00,148,62,86,FMN GV 05 Lier
60,Mechelsesteenweg 365,2023-07-12,15:00:00,144,78,66,FMN GV 05 Lier
60,Mechelsesteenweg 365,2023-07-12,16:00:00,224,112,112,FMN GV 05 Lier
60,Mechelsesteenweg 365,2023-07-12,17:00:00,128,58,70,FMN GV 05 Lier
60,Mechelsesteenweg 365,2023-07-12,18:00:00,144,70,74,FMN GV 05 Lier
60,Mechelsesteenweg 365,2023-07-12,19:00:00,134,62,72,FMN GV 05 Lier
60,Mechelsesteenweg 365,2023-07-12,20:00:00,204,128,76,FMN GV 05 Lier
60,Mechelsesteenweg 365,2023-07-12,21:00:00,44,24,20,FMN GV 05 Lier
60,Mechelsesteenweg 365,2023-07-12,22:00:00,10,0,10,FMN GV 05 Lier
60,Mechelsesteenweg 365,2023-07-12,23:00:00,2,2,0,FMN GV 05 Lier
60,Mechelsesteenweg 365,2023-07-13,00:00:00,4,2,2,FMN GV 05 Lier
60,Mechelsesteenweg 365,2023-07-13,01:00:00,0,0,0,FMN GV 05 Lier
60,Mechelsesteenweg 365,2023-07-13,02:00:00,0,0,0,FMN GV 05 Lier
60,Mechelsesteenweg 365,2023-07-13,03:00:00,4,4,0,FMN GV 05 Lier
60,Mechelsesteenweg 365,2023-07-13,04:00:00,2,0,2,FMN GV 05 Lier
60,Mechelsesteenweg 365,2023-07-13,05:00:00,22,4,18,FMN GV 05 Lier
60,Mechelsesteenweg 365,2023-07-13,06:00:00,52,8,44,FMN GV 05 Lier
60,Mechelsesteenweg 365,2023-07-13,07:00:00,52,16,36,FMN GV 05 Lier
60,Mechelsesteenweg 365,2023-07-13,08:00:00,94,46,48,FMN GV 05 Lier
60,Mechelsesteenweg 365,2023-07-13,09:00:00,60,26,34,FMN GV 05 Lier
60,Mechelsesteenweg 365,2023-07-13,10:00:00,132,48,84,FMN GV 05 Lier
60,Mechelsesteenweg 365,2023-07-13,11:00:00,122,84,38,FMN GV 05 Lier
60,Mechelsesteenweg 365,2023-07-13,12:00:00,84,54,30,FMN GV 05 Lier
60,Mechelsesteenweg 365,2023-07-13,13:00:00,122,44,78,FMN GV 05 Lier
60,Mechelsesteenweg 365,2023-07-13,14:00:00,60,28,32,FMN GV 05 Lier
60,Mechelsesteenweg 365,2023-07-13,15:00:00,92,54,38,FMN GV 05 Lier
60,Mechelsesteenweg 365,2023-07-13,16:00:00,178,102,76,FMN GV 05 Lier
60,Mechelsesteenweg 365,2023-07-13,17:00:00,138,80,58,FMN GV 05 Lier
60,Mechelsesteenweg 365,2023-07-13,18:00:00,146,86,60,FMN GV 05 Lier
60,Mechelsesteenweg 365,2023-07-13,19:00:00,146,92,54,FMN GV 05 Lier
60,Mechelsesteenweg 365,2023-07-13,20:00:00,192,70,122,FMN GV 05 Lier
60,Mechelsesteenweg 365,2023-07-13,21:00:00,78,44,34,FMN GV 05 Lier
60,Mechelsesteenweg 365,2023-07-13,22:00:00,6,0,6,FMN GV 05 Lier
60,Mechelsesteenweg 365,2023-07-13,23:00:00,4,0,4,FMN GV 05 Lier
60,Mechelsesteenweg 365,2023-07-14,00:00:00,4,0,4,FMN GV 05 Lier
60,Mechelsesteenweg 365,2023-07-14,01:00:00,0,0,0,FMN GV 05 Lier
60,Mechelsesteenweg 365,2023-07-14,02:00:00,0,0,0,FMN GV 05 Lier
60,Mechelsesteenweg 365,2023-07-14,03:00:00,0,0,0,FMN GV 05 Lier
60,Mechelsesteenweg 365,2023-07-14,04:00:00,2,0,2,FMN GV 05 Lier
60,Mechelsesteenweg 365,2023-07-14,05:00:00,10,6,4,FMN GV 05 Lier
60,Mechelsesteenweg 365,2023-07-14,06:00:00,40,14,26,FMN GV 05 Lier
60,Mechelsesteenweg 365,2023-07-14,07:00:00,62,32,30,FMN GV 05 Lier
60,Mechelsesteenweg 365,2023-07-14,08:00:00,66,28,38,FMN GV 05 Lier
60,Mechelsesteenweg 365,2023-07-14,09:00:00,126,80,46,FMN GV 05 Lier
60,Mechelsesteenweg 365,2023-07-14,10:00:00,178,88,90,FMN GV 05 Lier
60,Mechelsesteenweg 365,2023-07-14,11:00:00,176,74,102,FMN GV 05 Lier
60,Mechelsesteenweg 365,2023-07-14,12:00:00,204,80,124,FMN GV 05 Lier
60,Mechelsesteenweg 365,2023-07-14,13:00:00,182,102,80,FMN GV 05 Lier
60,Mechelsesteenweg 365,2023-07-14,14:00:00,252,150,102,FMN GV 05 Lier
60,Mechelsesteenweg 365,2023-07-14,15:00:00,238,118,120,FMN GV 05 Lier
60,Mechelsesteenweg 365,2023-07-14,16:00:00,188,108,80,FMN GV 05 Lier
60,Mechelsesteenweg 365,2023-07-14,17:00:00,158,84,74,FMN GV 05 Lier
60,Mechelsesteenweg 365,2023-07-14,18:00:00,168,100,68,FMN GV 05 Lier
60,Mechelsesteenweg 365,2023-07-14,19:00:00,106,52,54,FMN GV 05 Lier
60,Mechelsesteenweg 365,2023-07-14,20:00:00,78,20,58,FMN GV 05 Lier
60,Mechelsesteenweg 365,2023-07-14,21:00:00,26,8,18,FMN GV 05 Lier
60,Mechelsesteenweg 365,2023-07-14,22:00:00,16,6,10,FMN GV 05 Lier
60,Mechelsesteenweg 365,2023-07-14,23:00:00,14,8,6,FMN GV 05 Lier
60,Mechelsesteenweg 365,2023-07-15,00:00:00,2,0,2,FMN GV 05 Lier
60,Mechelsesteenweg 365,2023-07-15,01:00:00,2,0,2,FMN GV 05 Lier
60,Mechelsesteenweg 365,2023-07-15,02:00:00,10,0,10,FMN GV 05 Lier
60,Mechelsesteenweg 365,2023-07-15,03:00:00,4,2,2,FMN GV 05 Lier
60,Mechelsesteenweg 365,2023-07-15,04:00:00,2,0,2,FMN GV 05 Lier
60,Mechelsesteenweg 365,2023-07-15,05:00:00,16,4,12,FMN GV 05 Lier
60,Mechelsesteenweg 365,2023-07-15,06:00:00,12,8,4,FMN GV 05 Lier
60,Mechelsesteenweg 365,2023-07-15,07:00:00,28,18,10,FMN GV 05 Lier
60,Mechelsesteenweg 365,2023-07-15,08:00:00,48,20,28,FMN GV 05 Lier
60,Mechelsesteenweg 365,2023-07-15,09:00:00,196,110,86,FMN GV 05 Lier
60,Mechelsesteenweg 365,2023-07-15,10:00:00,248,130,118,FMN GV 05 Lier
60,Mechelsesteenweg 365,2023-07-15,11:00:00,378,162,216,FMN GV 05 Lier
60,Mechelsesteenweg 365,2023-07-15,12:00:00,242,76,166,FMN GV 05 Lier
60,Mechelsesteenweg 365,2023-07-15,13:00:00,184,100,84,FMN GV 05 Lier
60,Mechelsesteenweg 365,2023-07-15,14:00:00,144,78,66,FMN GV 05 Lier
60,Mechelsesteenweg 365,2023-07-15,15:00:00,42,30,12,FMN GV 05 Lier
60,Mechelsesteenweg 365,2023-07-15,16:00:00,86,40,46,FMN GV 05 Lier
60,Mechelsesteenweg 365,2023-07-15,17:00:00,22,10,12,FMN GV 05 Lier
60,Mechelsesteenweg 365,2023-07-15,18:00:00,56,32,24,FMN GV 05 Lier
60,Mechelsesteenweg 365,2023-07-15,19:00:00,34,14,20,FMN GV 05 Lier
60,Mechelsesteenweg 365,2023-07-15,20:00:00,30,20,10,FMN GV 05 Lier
60,Mechelsesteenweg 365,2023-07-15,21:00:00,14,6,8,FMN GV 05 Lier
60,Mechelsesteenweg 365,2023-07-15,22:00:00,14,12,2,FMN GV 05 Lier
60,Mechelsesteenweg 365,2023-07-15,23:00:00,10,0,10,FMN GV 05 Lier
60,Mechelsesteenweg 365,2023-07-16,00:00:00,4,2,2,FMN GV 05 Lier
60,Mechelsesteenweg 365,2023-07-16,01:00:00,4,4,0,FMN GV 05 Lier
60,Mechelsesteenweg 365,2023-07-16,02:00:00,0,0,0,FMN GV 05 Lier
60,Mechelsesteenweg 365,2023-07-16,03:00:00,2,0,2,FMN GV 05 Lier
60,Mechelsesteenweg 365,2023-07-16,04:00:00,2,0,2,FMN GV 05 Lier
60,Mechelsesteenweg 365,2023-07-16,05:00:00,2,0,2,FMN GV 05 Lier
60,Mechelsesteenweg 365,2023-07-16,06:00:00,4,2,2,FMN GV 05 Lier
60,Mechelsesteenweg 365,2023-07-16,07:00:00,20,12,8,FMN GV 05 Lier
60,Mechelsesteenweg 365,2023-07-16,08:00:00,76,28,48,FMN GV 05 Lier
60,Mechelsesteenweg 365,2023-07-16,09:00:00,246,86,160,FMN GV 05 Lier
60,Mechelsesteenweg 365,2023-07-16,10:00:00,304,178,126,FMN GV 05 Lier
60,Mechelsesteenweg 365,2023-07-16,11:00:00,362,206,156,FMN GV 05 Lier
60,Mechelsesteenweg 365,2023-07-16,12:00:00,234,148,86,FMN GV 05 Lier
60,Mechelsesteenweg 365,2023-07-16,13:00:00,164,62,102,FMN GV 05 Lier
60,Mechelsesteenweg 365,2023-07-16,14:00:00,114,64,50,FMN GV 05 Lier
60,Mechelsesteenweg 365,2023-07-16,15:00:00,196,106,90,FMN GV 05 Lier
60,Mechelsesteenweg 365,2023-07-16,16:00:00,132,64,68,FMN GV 05 Lier
60,Mechelsesteenweg 365,2023-07-16,17:00:00,72,20,52,FMN GV 05 Lier
60,Mechelsesteenweg 365,2023-07-16,18:00:00,70,28,42,FMN GV 05 Lier
60,Mechelsesteenweg 365,2023-07-16,19:00:00,38,18,20,FMN GV 05 Lier
60,Mechelsesteenweg 365,2023-07-16,20:00:00,34,4,30,FMN GV 05 Lier
60,Mechelsesteenweg 365,2023-07-16,21:00:00,16,12,4,FMN GV 05 Lier
60,Mechelsesteenweg 365,2023-07-16,22:00:00,6,2,4,FMN GV 05 Lier
60,Mechelsesteenweg 365,2023-07-16,23:00:00,2,0,2,FMN GV 05 Lier
60,Mechelsesteenweg 365,2023-07-17,00:00:00,0,0,0,FMN GV 05 Lier
60,Mechelsesteenweg 365,2023-07-17,01:00:00,0,0,0,FMN GV 05 Lier
60,Mechelsesteenweg 365,2023-07-17,02:00:00,0,0,0,FMN GV 05 Lier
60,Mechelsesteenweg 365,2023-07-17,03:00:00,0,0,0,FMN GV 05 Lier
60,Mechelsesteenweg 365,2023-07-17,04:00:00,2,0,2,FMN GV 05 Lier
60,Mechelsesteenweg 365,2023-07-17,05:00:00,4,2,2,FMN GV 05 Lier
60,Mechelsesteenweg 365,2023-07-17,06:00:00,26,6,20,FMN GV 05 Lier
60,Mechelsesteenweg 365,2023-07-17,07:00:00,76,32,44,FMN GV 05 Lier
60,Mechelsesteenweg 365,2023-07-17,08:00:00,108,42,66,FMN GV 05 Lier
60,Mechelsesteenweg 365,2023-07-17,09:00:00,124,80,44,FMN GV 05 Lier
60,Mechelsesteenweg 365,2023-07-17,10:00:00,146,76,70,FMN GV 05 Lier
60,Mechelsesteenweg 365,2023-07-17,11:00:00,198,146,52,FMN GV 05 Lier
60,Mechelsesteenweg 365,2023-07-17,12:00:00,156,82,74,FMN GV 05 Lier
60,Mechelsesteenweg 365,2023-07-17,13:00:00,144,102,42,FMN GV 05 Lier
60,Mechelsesteenweg 365,2023-07-17,14:00:00,104,40,64,FMN GV 05 Lier
60,Mechelsesteenweg 365,2023-07-17,15:00:00,100,52,48,FMN GV 05 Lier
60,Mechelsesteenweg 365,2023-07-17,16:00:00,162,60,102,FMN GV 05 Lier
60,Mechelsesteenweg 365,2023-07-17,17:00:00,114,56,58,FMN GV 05 Lier
60,Mechelsesteenweg 365,2023-07-17,18:00:00,104,50,54,FMN GV 05 Lier
60,Mechelsesteenweg 365,2023-07-17,19:00:00,106,54,52,FMN GV 05 Lier
60,Mechelsesteenweg 365,2023-07-17,20:00:00,116,50,66,FMN GV 05 Lier
60,Mechelsesteenweg 365,2023-07-17,21:00:00,34,20,14,FMN GV 05 Lier
60,Mechelsesteenweg 365,2023-07-17,22:00:00,12,6,6,FMN GV 05 Lier
60,Mechelsesteenweg 365,2023-07-17,23:00:00,8,2,6,FMN GV 05 Lier
60,Mechelsesteenweg 365,2023-07-18,00:00:00,4,4,0,FMN GV 05 Lier
60,Mechelsesteenweg 365,2023-07-18,01:00:00,2,0,2,FMN GV 05 Lier
60,Mechelsesteenweg 365,2023-07-18,02:00:00,0,0,0,FMN GV 05 Lier
60,Mechelsesteenweg 365,2023-07-18,03:00:00,0,0,0,FMN GV 05 Lier
60,Mechelsesteenweg 365,2023-07-18,04:00:00,4,0,4,FMN GV 05 Lier
60,Mechelsesteenweg 365,2023-07-18,05:00:00,8,4,4,FMN GV 05 Lier
60,Mechelsesteenweg 365,2023-07-18,06:00:00,38,4,34,FMN GV 05 Lier
60,Mechelsesteenweg 365,2023-07-18,07:00:00,100,42,58,FMN GV 05 Lier
60,Mechelsesteenweg 365,2023-07-18,08:00:00,102,32,70,FMN GV 05 Lier
60,Mechelsesteenweg 365,2023-07-18,09:00:00,174,60,114,FMN GV 05 Lier
60,Mechelsesteenweg 365,2023-07-18,10:00:00,372,200,172,FMN GV 05 Lier
60,Mechelsesteenweg 365,2023-07-18,11:00:00,318,202,116,FMN GV 05 Lier
60,Mechelsesteenweg 365,2023-07-18,12:00:00,244,136,108,FMN GV 05 Lier
60,Mechelsesteenweg 365,2023-07-18,13:00:00,0,0,0,FMN GV 05 Lier
60,Mechelsesteenweg 365,2023-07-18,14:00:00,0,0,0,FMN GV 05 Lier
60,Mechelsesteenweg 365,2023-07-18,15:00:00,0,0,0,FMN GV 05 Lier
60,Mechelsesteenweg 365,2023-07-18,16:00:00,0,0,0,FMN GV 05 Lier
60,Mechelsesteenweg 365,2023-07-18,17:00:00,106,50,56,FMN GV 05 Lier
60,Mechelsesteenweg 365,2023-07-18,18:00:00,222,110,112,FMN GV 05 Lier
60,Mechelsesteenweg 365,2023-07-18,19:00:00,248,116,132,FMN GV 05 Lier
60,Mechelsesteenweg 365,2023-07-18,20:00:00,220,96,124,FMN GV 05 Lier
60,Mechelsesteenweg 365,2023-07-18,21:00:00,84,32,52,FMN GV 05 Lier
60,Mechelsesteenweg 365,2023-07-18,22:00:00,18,12,6,FMN GV 05 Lier
60,Mechelsesteenweg 365,2023-07-18,23:00:00,12,6,6,FMN GV 05 Lier
60,Mechelsesteenweg 365,2023-07-19,00:00:00,16,2,14,FMN GV 05 Lier
60,Mechelsesteenweg 365,2023-07-19,01:00:00,0,0,0,FMN GV 05 Lier
60,Mechelsesteenweg 365,2023-07-19,02:00:00,4,0,4,FMN GV 05 Lier
60,Mechelsesteenweg 365,2023-07-19,03:00:00,0,0,0,FMN GV 05 Lier
60,Mechelsesteenweg 365,2023-07-19,04:00:00,4,0,4,FMN GV 05 Lier
60,Mechelsesteenweg 365,2023-07-19,05:00:00,0,0,0,FMN GV 05 Lier
60,Mechelsesteenweg 365,2023-07-19,06:00:00,36,10,26,FMN GV 05 Lier
60,Mechelsesteenweg 365,2023-07-19,07:00:00,72,28,44,FMN GV 05 Lier
60,Mechelsesteenweg 365,2023-07-19,08:00:00,72,18,54,FMN GV 05 Lier
60,Mechelsesteenweg 365,2023-07-19,09:00:00,70,32,38,FMN GV 05 Lier
60,Mechelsesteenweg 365,2023-07-19,10:00:00,238,136,102,FMN GV 05 Lier
60,Mechelsesteenweg 365,2023-07-19,11:00:00,184,126,58,FMN GV 05 Lier
60,Mechelsesteenweg 365,2023-07-19,12:00:00,150,82,68,FMN GV 05 Lier
60,Mechelsesteenweg 365,2023-07-19,13:00:00,96,30,66,FMN GV 05 Lier
60,Mechelsesteenweg 365,2023-07-19,14:00:00,120,60,60,FMN GV 05 Lier
60,Mechelsesteenweg 365,2023-07-19,15:00:00,190,120,70,FMN GV 05 Lier
60,Mechelsesteenweg 365,2023-07-19,16:00:00,116,68,48,FMN GV 05 Lier
60,Mechelsesteenweg 365,2023-07-19,17:00:00,134,80,54,FMN GV 05 Lier
60,Mechelsesteenweg 365,2023-07-19,18:00:00,140,106,34,FMN GV 05 Lier
60,Mechelsesteenweg 365,2023-07-19,19:00:00,156,88,68,FMN GV 05 Lier
60,Mechelsesteenweg 365,2023-07-19,20:00:00,146,96,50,FMN GV 05 Lier
60,Mechelsesteenweg 365,2023-07-19,21:00:00,42,24,18,FMN GV 05 Lier
60,Mechelsesteenweg 365,2023-07-19,22:00:00,14,8,6,FMN GV 05 Lier
60,Mechelsesteenweg 365,2023-07-19,23:00:00,4,2,2,FMN GV 05 Lier
60,Mechelsesteenweg 365,2023-07-20,00:00:00,8,6,2,FMN GV 05 Lier
60,Mechelsesteenweg 365,2023-07-20,01:00:00,6,0,6,FMN GV 05 Lier
60,Mechelsesteenweg 365,2023-07-20,02:00:00,0,0,0,FMN GV 05 Lier
60,Mechelsesteenweg 365,2023-07-20,03:00:00,2,0,2,FMN GV 05 Lier
60,Mechelsesteenweg 365,2023-07-20,04:00:00,4,2,2,FMN GV 05 Lier
60,Mechelsesteenweg 365,2023-07-20,05:00:00,0,0,0,FMN GV 05 Lier
60,Mechelsesteenweg 365,2023-07-20,06:00:00,58,30,28,FMN GV 05 Lier
60,Mechelsesteenweg 365,2023-07-20,07:00:00,68,12,56,FMN GV 05 Lier
60,Mechelsesteenweg 365,2023-07-20,08:00:00,96,40,56,FMN GV 05 Lier
60,Mechelsesteenweg 365,2023-07-20,09:00:00,126,66,60,FMN GV 05 Lier
60,Mechelsesteenweg 365,2023-07-20,10:00:00,220,142,78,FMN GV 05 Lier
60,Mechelsesteenweg 365,2023-07-20,11:00:00,246,126,120,FMN GV 05 Lier
60,Mechelsesteenweg 365,2023-07-20,12:00:00,150,90,60,FMN GV 05 Lier
60,Mechelsesteenweg 365,2023-07-20,13:00:00,142,46,96,FMN GV 05 Lier
60,Mechelsesteenweg 365,2023-07-20,14:00:00,236,150,86,FMN GV 05 Lier
60,Mechelsesteenweg 365,2023-07-20,15:00:00,278,164,114,FMN GV 05 Lier
60,Mechelsesteenweg 365,2023-07-20,16:00:00,218,152,66,FMN GV 05 Lier
60,Mechelsesteenweg 365,2023-07-20,17:00:00,144,102,42,FMN GV 05 Lier
60,Mechelsesteenweg 365,2023-07-20,18:00:00,34,24,10,FMN GV 05 Lier
60,Mechelsesteenweg 365,2023-07-20,19:00:00,42,34,8,FMN GV 05 Lier
60,Mechelsesteenweg 365,2023-07-20,20:00:00,70,30,40,FMN GV 05 Lier
60,Mechelsesteenweg 365,2023-07-20,21:00:00,48,22,26,FMN GV 05 Lier
60,Mechelsesteenweg 365,2023-07-20,22:00:00,22,12,10,FMN GV 05 Lier
60,Mechelsesteenweg 365,2023-07-20,23:00:00,4,2,2,FMN GV 05 Lier
60,Mechelsesteenweg 365,2023-07-21,00:00:00,0,0,0,FMN GV 05 Lier
60,Mechelsesteenweg 365,2023-07-21,01:00:00,0,0,0,FMN GV 05 Lier
60,Mechelsesteenweg 365,2023-07-21,02:00:00,0,0,0,FMN GV 05 Lier
60,Mechelsesteenweg 365,2023-07-21,03:00:00,0,0,0,FMN GV 05 Lier
60,Mechelsesteenweg 365,2023-07-21,04:00:00,0,0,0,FMN GV 05 Lier
60,Mechelsesteenweg 365,2023-07-21,05:00:00,2,0,2,FMN GV 05 Lier
60,Mechelsesteenweg 365,2023-07-21,06:00:00,6,4,2,FMN GV 05 Lier
60,Mechelsesteenweg 365,2023-07-21,07:00:00,22,12,10,FMN GV 05 Lier
60,Mechelsesteenweg 365,2023-07-21,08:00:00,80,66,14,FMN GV 05 Lier
60,Mechelsesteenweg 365,2023-07-21,09:00:00,198,130,68,FMN GV 05 Lier
60,Mechelsesteenweg 365,2023-07-21,10:00:00,284,142,142,FMN GV 05 Lier
60,Mechelsesteenweg 365,2023-07-21,11:00:00,364,212,152,FMN GV 05 Lier
60,Mechelsesteenweg 365,2023-07-21,12:00:00,142,76,66,FMN GV 05 Lier
60,Mechelsesteenweg 365,2023-07-21,13:00:00,118,52,66,FMN GV 05 Lier
60,Mechelsesteenweg 365,2023-07-21,14:00:00,124,36,88,FMN GV 05 Lier
60,Mechelsesteenweg 365,2023-07-21,15:00:00,156,88,68,FMN GV 05 Lier
60,Mechelsesteenweg 365,2023-07-21,16:00:00,184,86,98,FMN GV 05 Lier
60,Mechelsesteenweg 365,2023-07-21,17:00:00,110,46,64,FMN GV 05 Lier
60,Mechelsesteenweg 365,2023-07-21,18:00:00,96,50,46,FMN GV 05 Lier
60,Mechelsesteenweg 365,2023-07-21,19:00:00,62,26,36,FMN GV 05 Lier
60,Mechelsesteenweg 365,2023-07-21,20:00:00,78,38,40,FMN GV 05 Lier
60,Mechelsesteenweg 365,2023-07-21,21:00:00,44,12,32,FMN GV 05 Lier
60,Mechelsesteenweg 365,2023-07-21,22:00:00,10,4,6,FMN GV 05 Lier
60,Mechelsesteenweg 365,2023-07-21,23:00:00,14,6,8,FMN GV 05 Lier
60,Mechelsesteenweg 365,2023-07-22,00:00:00,0,0,0,FMN GV 05 Lier
60,Mechelsesteenweg 365,2023-07-22,01:00:00,2,2,0,FMN GV 05 Lier
60,Mechelsesteenweg 365,2023-07-22,02:00:00,0,0,0,FMN GV 05 Lier
60,Mechelsesteenweg 365,2023-07-22,03:00:00,4,2,2,FMN GV 05 Lier
60,Mechelsesteenweg 365,2023-07-22,04:00:00,0,0,0,FMN GV 05 Lier
60,Mechelsesteenweg 365,2023-07-22,05:00:00,8,2,6,FMN GV 05 Lier
60,Mechelsesteenweg 365,2023-07-22,06:00:00,14,4,10,FMN GV 05 Lier
60,Mechelsesteenweg 365,2023-07-22,07:00:00,18,10,8,FMN GV 05 Lier
60,Mechelsesteenweg 365,2023-07-22,08:00:00,32,18,14,FMN GV 05 Lier
60,Mechelsesteenweg 365,2023-07-22,09:00:00,176,86,90,FMN GV 05 Lier
60,Mechelsesteenweg 365,2023-07-22,10:00:00,230,114,116,FMN GV 05 Lier
60,Mechelsesteenweg 365,2023-07-22,11:00:00,274,132,142,FMN GV 05 Lier
60,Mechelsesteenweg 365,2023-07-22,12:00:00,210,96,114,FMN GV 05 Lier
60,Mechelsesteenweg 365,2023-07-22,13:00:00,164,86,78,FMN GV 05 Lier
60,Mechelsesteenweg 365,2023-07-22,14:00:00,204,128,76,FMN GV 05 Lier
60,Mechelsesteenweg 365,2023-07-22,15:00:00,254,152,102,FMN GV 05 Lier
60,Mechelsesteenweg 365,2023-07-22,16:00:00,168,78,90,FMN GV 05 Lier
60,Mechelsesteenweg 365,2023-07-22,17:00:00,104,74,30,FMN GV 05 Lier
60,Mechelsesteenweg 365,2023-07-22,18:00:00,62,30,32,FMN GV 05 Lier
60,Mechelsesteenweg 365,2023-07-22,19:00:00,28,8,20,FMN GV 05 Lier
60,Mechelsesteenweg 365,2023-07-22,20:00:00,34,12,22,FMN GV 05 Lier
60,Mechelsesteenweg 365,2023-07-22,21:00:00,14,4,10,FMN GV 05 Lier
60,Mechelsesteenweg 365,2023-07-22,22:00:00,2,0,2,FMN GV 05 Lier
60,Mechelsesteenweg 365,2023-07-22,23:00:00,4,2,2,FMN GV 05 Lier
60,Mechelsesteenweg 365,2023-07-23,00:00:00,2,0,2,FMN GV 05 Lier
60,Mechelsesteenweg 365,2023-07-23,01:00:00,8,2,6,FMN GV 05 Lier
60,Mechelsesteenweg 365,2023-07-23,02:00:00,0,0,0,FMN GV 05 Lier
60,Mechelsesteenweg 365,2023-07-23,03:00:00,4,4,0,FMN GV 05 Lier
60,Mechelsesteenweg 365,2023-07-23,04:00:00,2,2,0,FMN GV 05 Lier
60,Mechelsesteenweg 365,2023-07-23,05:00:00,8,6,2,FMN GV 05 Lier
60,Mechelsesteenweg 365,2023-07-23,06:00:00,10,4,6,FMN GV 05 Lier
60,Mechelsesteenweg 365,2023-07-23,07:00:00,14,8,6,FMN GV 05 Lier
60,Mechelsesteenweg 365,2023-07-23,08:00:00,16,10,6,FMN GV 05 Lier
60,Mechelsesteenweg 365,2023-07-23,09:00:00,40,20,20,FMN GV 05 Lier
60,Mechelsesteenweg 365,2023-07-23,10:00:00,84,42,42,FMN GV 05 Lier
60,Mechelsesteenweg 365,2023-07-23,11:00:00,92,54,38,FMN GV 05 Lier
60,Mechelsesteenweg 365,2023-07-23,12:00:00,80,34,46,FMN GV 05 Lier
60,Mechelsesteenweg 365,2023-07-23,13:00:00,76,38,38,FMN GV 05 Lier
60,Mechelsesteenweg 365,2023-07-23,14:00:00,88,44,44,FMN GV 05 Lier
60,Mechelsesteenweg 365,2023-07-23,15:00:00,56,28,28,FMN GV 05 Lier
60,Mechelsesteenweg 365,2023-07-23,16:00:00,52,28,24,FMN GV 05 Lier
60,Mechelsesteenweg 365,2023-07-23,17:00:00,34,22,12,FMN GV 05 Lier
60,Mechelsesteenweg 365,2023-07-23,18:00:00,18,14,4,FMN GV 05 Lier
60,Mechelsesteenweg 365,2023-07-23,19:00:00,8,2,6,FMN GV 05 Lier
60,Mechelsesteenweg 365,2023-07-23,20:00:00,4,2,2,FMN GV 05 Lier
60,Mechelsesteenweg 365,2023-07-23,21:00:00,8,4,4,FMN GV 05 Lier
60,Mechelsesteenweg 365,2023-07-23,22:00:00,0,0,0,FMN GV 05 Lier
60,Mechelsesteenweg 365,2023-07-23,23:00:00,4,4,0,FMN GV 05 Lier
60,Mechelsesteenweg 365,2023-07-24,00:00:00,0,0,0,FMN GV 05 Lier
60,Mechelsesteenweg 365,2023-07-24,01:00:00,0,0,0,FMN GV 05 Lier
60,Mechelsesteenweg 365,2023-07-24,02:00:00,0,0,0,FMN GV 05 Lier
60,Mechelsesteenweg 365,2023-07-24,03:00:00,0,0,0,FMN GV 05 Lier
60,Mechelsesteenweg 365,2023-07-24,04:00:00,2,0,2,FMN GV 05 Lier
60,Mechelsesteenweg 365,2023-07-24,05:00:00,4,4,0,FMN GV 05 Lier
60,Mechelsesteenweg 365,2023-07-24,06:00:00,20,6,14,FMN GV 05 Lier
60,Mechelsesteenweg 365,2023-07-24,07:00:00,40,14,26,FMN GV 05 Lier
60,Mechelsesteenweg 365,2023-07-24,08:00:00,36,8,28,FMN GV 05 Lier
60,Mechelsesteenweg 365,2023-07-24,09:00:00,24,16,8,FMN GV 05 Lier
60,Mechelsesteenweg 365,2023-07-24,10:00:00,64,34,30,FMN GV 05 Lier
60,Mechelsesteenweg 365,2023-07-24,11:00:00,34,10,24,FMN GV 05 Lier
60,Mechelsesteenweg 365,2023-07-24,12:00:00,42,22,20,FMN GV 05 Lier
60,Mechelsesteenweg 365,2023-07-24,13:00:00,42,16,26,FMN GV 05 Lier
60,Mechelsesteenweg 365,2023-07-24,14:00:00,90,32,58,FMN GV 05 Lier
60,Mechelsesteenweg 365,2023-07-24,15:00:00,68,42,26,FMN GV 05 Lier
60,Mechelsesteenweg 365,2023-07-24,16:00:00,28,16,12,FMN GV 05 Lier
60,Mechelsesteenweg 365,2023-07-24,17:00:00,76,40,36,FMN GV 05 Lier
60,Mechelsesteenweg 365,2023-07-24,18:00:00,44,34,10,FMN GV 05 Lier
60,Mechelsesteenweg 365,2023-07-24,19:00:00,54,24,30,FMN GV 05 Lier
60,Mechelsesteenweg 365,2023-07-24,20:00:00,100,48,52,FMN GV 05 Lier
60,Mechelsesteenweg 365,2023-07-24,21:00:00,32,8,24,FMN GV 05 Lier
60,Mechelsesteenweg 365,2023-07-24,22:00:00,2,2,0,FMN GV 05 Lier
60,Mechelsesteenweg 365,2023-07-24,23:00:00,2,2,0,FMN GV 05 Lier
60,Mechelsesteenweg 365,2023-07-25,00:00:00,2,0,2,FMN GV 05 Lier
60,Mechelsesteenweg 365,2023-07-25,01:00:00,0,0,0,FMN GV 05 Lier
60,Mechelsesteenweg 365,2023-07-25,02:00:00,0,0,0,FMN GV 05 Lier
60,Mechelsesteenweg 365,2023-07-25,03:00:00,0,0,0,FMN GV 05 Lier
60,Mechelsesteenweg 365,2023-07-25,04:00:00,0,0,0,FMN GV 05 Lier
60,Mechelsesteenweg 365,2023-07-25,05:00:00,10,2,8,FMN GV 05 Lier
60,Mechelsesteenweg 365,2023-07-25,06:00:00,46,24,22,FMN GV 05 Lier
60,Mechelsesteenweg 365,2023-07-25,07:00:00,68,20,48,FMN GV 05 Lier
60,Mechelsesteenweg 365,2023-07-25,08:00:00,58,20,38,FMN GV 05 Lier
60,Mechelsesteenweg 365,2023-07-25,09:00:00,42,16,26,FMN GV 05 Lier
60,Mechelsesteenweg 365,2023-07-25,10:00:00,102,40,62,FMN GV 05 Lier
60,Mechelsesteenweg 365,2023-07-25,11:00:00,118,50,68,FMN GV 05 Lier
60,Mechelsesteenweg 365,2023-07-25,12:00:00,146,86,60,FMN GV 05 Lier
60,Mechelsesteenweg 365,2023-07-25,13:00:00,230,104,126,FMN GV 05 Lier
60,Mechelsesteenweg 365,2023-07-25,14:00:00,262,138,124,FMN GV 05 Lier
60,Mechelsesteenweg 365,2023-07-25,15:00:00,270,130,140,FMN GV 05 Lier
60,Mechelsesteenweg 365,2023-07-25,16:00:00,206,94,112,FMN GV 05 Lier
60,Mechelsesteenweg 365,2023-07-25,17:00:00,186,88,98,FMN GV 05 Lier
60,Mechelsesteenweg 365,2023-07-25,18:00:00,146,82,64,FMN GV 05 Lier
60,Mechelsesteenweg 365,2023-07-25,19:00:00,140,66,74,FMN GV 05 Lier
60,Mechelsesteenweg 365,2023-07-25,20:00:00,90,46,44,FMN GV 05 Lier
60,Mechelsesteenweg 365,2023-07-25,21:00:00,40,20,20,FMN GV 05 Lier
60,Mechelsesteenweg 365,2023-07-25,22:00:00,16,12,4,FMN GV 05 Lier
60,Mechelsesteenweg 365,2023-07-25,23:00:00,0,0,0,FMN GV 05 Lier
60,Mechelsesteenweg 365,2023-07-26,00:00:00,0,0,0,FMN GV 05 Lier
60,Mechelsesteenweg 365,2023-07-26,01:00:00,2,2,0,FMN GV 05 Lier
60,Mechelsesteenweg 365,2023-07-26,02:00:00,0,0,0,FMN GV 05 Lier
60,Mechelsesteenweg 365,2023-07-26,03:00:00,0,0,0,FMN GV 05 Lier
60,Mechelsesteenweg 365,2023-07-26,04:00:00,2,0,2,FMN GV 05 Lier
60,Mechelsesteenweg 365,2023-07-26,05:00:00,10,4,6,FMN GV 05 Lier
60,Mechelsesteenweg 365,2023-07-26,06:00:00,32,4,28,FMN GV 05 Lier
60,Mechelsesteenweg 365,2023-07-26,07:00:00,82,28,54,FMN GV 05 Lier
60,Mechelsesteenweg 365,2023-07-26,08:00:00,86,22,64,FMN GV 05 Lier
60,Mechelsesteenweg 365,2023-07-26,09:00:00,104,78,26,FMN GV 05 Lier
60,Mechelsesteenweg 365,2023-07-26,10:00:00,176,92,84,FMN GV 05 Lier
60,Mechelsesteenweg 365,2023-07-26,11:00:00,172,84,88,FMN GV 05 Lier
60,Mechelsesteenweg 365,2023-07-26,12:00:00,184,114,70,FMN GV 05 Lier
60,Mechelsesteenweg 365,2023-07-26,13:00:00,224,114,110,FMN GV 05 Lier
60,Mechelsesteenweg 365,2023-07-26,14:00:00,260,148,112,FMN GV 05 Lier
60,Mechelsesteenweg 365,2023-07-26,15:00:00,330,172,158,FMN GV 05 Lier
60,Mechelsesteenweg 365,2023-07-26,16:00:00,274,134,140,FMN GV 05 Lier
60,Mechelsesteenweg 365,2023-07-26,17:00:00,218,112,106,FMN GV 05 Lier
60,Mechelsesteenweg 365,2023-07-26,18:00:00,168,86,82,FMN GV 05 Lier
60,Mechelsesteenweg 365,2023-07-26,19:00:00,210,138,72,FMN GV 05 Lier
60,Mechelsesteenweg 365,2023-07-26,20:00:00,260,114,146,FMN GV 05 Lier
60,Mechelsesteenweg 365,2023-07-26,21:00:00,46,30,16,FMN GV 05 Lier
60,Mechelsesteenweg 365,2023-07-26,22:00:00,22,10,12,FMN GV 05 Lier
60,Mechelsesteenweg 365,2023-07-26,23:00:00,0,0,0,FMN GV 05 Lier
60,Mechelsesteenweg 365,2023-07-27,00:00:00,6,2,4,FMN GV 05 Lier
60,Mechelsesteenweg 365,2023-07-27,01:00:00,0,0,0,FMN GV 05 Lier
60,Mechelsesteenweg 365,2023-07-27,02:00:00,2,2,0,FMN GV 05 Lier
60,Mechelsesteenweg 365,2023-07-27,03:00:00,0,0,0,FMN GV 05 Lier
60,Mechelsesteenweg 365,2023-07-27,04:00:00,2,0,2,FMN GV 05 Lier
60,Mechelsesteenweg 365,2023-07-27,05:00:00,0,0,0,FMN GV 05 Lier
60,Mechelsesteenweg 365,2023-07-27,06:00:00,12,2,10,FMN GV 05 Lier
60,Mechelsesteenweg 365,2023-07-27,07:00:00,16,6,10,FMN GV 05 Lier
60,Mechelsesteenweg 365,2023-07-27,08:00:00,40,14,26,FMN GV 05 Lier
60,Mechelsesteenweg 365,2023-07-27,09:00:00,20,10,10,FMN GV 05 Lier
60,Mechelsesteenweg 365,2023-07-27,10:00:00,20,6,14,FMN GV 05 Lier
60,Mechelsesteenweg 365,2023-07-27,11:00:00,16,10,6,FMN GV 05 Lier
60,Mechelsesteenweg 365,2023-07-27,12:00:00,16,10,6,FMN GV 05 Lier
60,Mechelsesteenweg 365,2023-07-27,13:00:00,26,14,12,FMN GV 05 Lier
60,Mechelsesteenweg 365,2023-07-27,14:00:00,16,10,6,FMN GV 05 Lier
60,Mechelsesteenweg 365,2023-07-27,15:00:00,38,12,26,FMN GV 05 Lier
60,Mechelsesteenweg 365,2023-07-27,16:00:00,30,20,10,FMN GV 05 Lier
60,Mechelsesteenweg 365,2023-07-27,17:00:00,32,24,8,FMN GV 05 Lier
60,Mechelsesteenweg 365,2023-07-27,18:00:00,28,16,12,FMN GV 05 Lier
60,Mechelsesteenweg 365,2023-07-27,19:00:00,28,12,16,FMN GV 05 Lier
60,Mechelsesteenweg 365,2023-07-27,20:00:00,26,10,16,FMN GV 05 Lier
60,Mechelsesteenweg 365,2023-07-27,21:00:00,12,4,8,FMN GV 05 Lier
60,Mechelsesteenweg 365,2023-07-27,22:00:00,4,4,0,FMN GV 05 Lier
60,Mechelsesteenweg 365,2023-07-27,23:00:00,2,2,0,FMN GV 05 Lier
60,Mechelsesteenweg 365,2023-07-28,00:00:00,2,0,2,FMN GV 05 Lier
60,Mechelsesteenweg 365,2023-07-28,01:00:00,0,0,0,FMN GV 05 Lier
60,Mechelsesteenweg 365,2023-07-28,02:00:00,2,0,2,FMN GV 05 Lier
60,Mechelsesteenweg 365,2023-07-28,03:00:00,0,0,0,FMN GV 05 Lier
60,Mechelsesteenweg 365,2023-07-28,04:00:00,0,0,0,FMN GV 05 Lier
60,Mechelsesteenweg 365,2023-07-28,05:00:00,8,2,6,FMN GV 05 Lier
60,Mechelsesteenweg 365,2023-07-28,06:00:00,24,8,16,FMN GV 05 Lier
60,Mechelsesteenweg 365,2023-07-28,07:00:00,54,20,34,FMN GV 05 Lier
60,Mechelsesteenweg 365,2023-07-28,08:00:00,70,30,40,FMN GV 05 Lier
60,Mechelsesteenweg 365,2023-07-28,09:00:00,40,26,14,FMN GV 05 Lier
60,Mechelsesteenweg 365,2023-07-28,10:00:00,120,82,38,FMN GV 05 Lier
60,Mechelsesteenweg 365,2023-07-28,11:00:00,116,72,44,FMN GV 05 Lier
60,Mechelsesteenweg 365,2023-07-28,12:00:00,100,46,54,FMN GV 05 Lier
60,Mechelsesteenweg 365,2023-07-28,13:00:00,126,52,74,FMN GV 05 Lier
60,Mechelsesteenweg 365,2023-07-28,14:00:00,188,114,74,FMN GV 05 Lier
60,Mechelsesteenweg 365,2023-07-28,15:00:00,176,102,74,FMN GV 05 Lier
60,Mechelsesteenweg 365,2023-07-28,16:00:00,206,102,104,FMN GV 05 Lier
60,Mechelsesteenweg 365,2023-07-28,17:00:00,150,80,70,FMN GV 05 Lier
60,Mechelsesteenweg 365,2023-07-28,18:00:00,134,88,46,FMN GV 05 Lier
60,Mechelsesteenweg 365,2023-07-28,19:00:00,88,52,36,FMN GV 05 Lier
60,Mechelsesteenweg 365,2023-07-28,20:00:00,80,46,34,FMN GV 05 Lier
60,Mechelsesteenweg 365,2023-07-28,21:00:00,50,18,32,FMN GV 05 Lier
60,Mechelsesteenweg 365,2023-07-28,22:00:00,14,6,8,FMN GV 05 Lier
60,Mechelsesteenweg 365,2023-07-28,23:00:00,0,0,0,FMN GV 05 Lier
60,Mechelsesteenweg 365,2023-07-29,00:00:00,0,0,0,FMN GV 05 Lier
60,Mechelsesteenweg 365,2023-07-29,01:00:00,4,0,4,FMN GV 05 Lier
60,Mechelsesteenweg 365,2023-07-29,02:00:00,2,2,0,FMN GV 05 Lier
60,Mechelsesteenweg 365,2023-07-29,03:00:00,0,0,0,FMN GV 05 Lier
60,Mechelsesteenweg 365,2023-07-29,04:00:00,0,0,0,FMN GV 05 Lier
60,Mechelsesteenweg 365,2023-07-29,05:00:00,4,2,2,FMN GV 05 Lier
60,Mechelsesteenweg 365,2023-07-29,06:00:00,14,6,8,FMN GV 05 Lier
60,Mechelsesteenweg 365,2023-07-29,07:00:00,36,12,24,FMN GV 05 Lier
60,Mechelsesteenweg 365,2023-07-29,08:00:00,56,34,22,FMN GV 05 Lier
60,Mechelsesteenweg 365,2023-07-29,09:00:00,112,52,60,FMN GV 05 Lier
60,Mechelsesteenweg 365,2023-07-29,10:00:00,154,78,76,FMN GV 05 Lier
60,Mechelsesteenweg 365,2023-07-29,11:00:00,176,94,82,FMN GV 05 Lier
60,Mechelsesteenweg 365,2023-07-29,12:00:00,124,66,58,FMN GV 05 Lier
60,Mechelsesteenweg 365,2023-07-29,13:00:00,90,52,38,FMN GV 05 Lier
60,Mechelsesteenweg 365,2023-07-29,14:00:00,88,54,34,FMN GV 05 Lier
60,Mechelsesteenweg 365,2023-07-29,15:00:00,106,42,64,FMN GV 05 Lier
60,Mechelsesteenweg 365,2023-07-29,16:00:00,72,22,50,FMN GV 05 Lier
60,Mechelsesteenweg 365,2023-07-29,17:00:00,80,48,32,FMN GV 05 Lier
60,Mechelsesteenweg 365,2023-07-29,18:00:00,56,26,30,FMN GV 05 Lier
60,Mechelsesteenweg 365,2023-07-29,19:00:00,36,18,18,FMN GV 05 Lier
60,Mechelsesteenweg 365,2023-07-29,20:00:00,58,24,34,FMN GV 05 Lier
60,Mechelsesteenweg 365,2023-07-29,21:00:00,20,4,16,FMN GV 05 Lier
60,Mechelsesteenweg 365,2023-07-29,22:00:00,10,6,4,FMN GV 05 Lier
60,Mechelsesteenweg 365,2023-07-29,23:00:00,6,4,2,FMN GV 05 Lier
60,Mechelsesteenweg 365,2023-07-30,00:00:00,2,0,2,FMN GV 05 Lier
60,Mechelsesteenweg 365,2023-07-30,01:00:00,0,0,0,FMN GV 05 Lier
60,Mechelsesteenweg 365,2023-07-30,02:00:00,0,0,0,FMN GV 05 Lier
60,Mechelsesteenweg 365,2023-07-30,03:00:00,0,0,0,FMN GV 05 Lier
60,Mechelsesteenweg 365,2023-07-30,04:00:00,0,0,0,FMN GV 05 Lier
60,Mechelsesteenweg 365,2023-07-30,05:00:00,2,2,0,FMN GV 05 Lier
60,Mechelsesteenweg 365,2023-07-30,06:00:00,10,4,6,FMN GV 05 Lier
60,Mechelsesteenweg 365,2023-07-30,07:00:00,18,8,10,FMN GV 05 Lier
60,Mechelsesteenweg 365,2023-07-30,08:00:00,72,26,46,FMN GV 05 Lier
60,Mechelsesteenweg 365,2023-07-30,09:00:00,210,104,106,FMN GV 05 Lier
60,Mechelsesteenweg 365,2023-07-30,10:00:00,318,210,108,FMN GV 05 Lier
60,Mechelsesteenweg 365,2023-07-30,11:00:00,364,204,160,FMN GV 05 Lier
60,Mechelsesteenweg 365,2023-07-30,12:00:00,190,96,94,FMN GV 05 Lier
60,Mechelsesteenweg 365,2023-07-30,13:00:00,174,84,90,FMN GV 05 Lier
60,Mechelsesteenweg 365,2023-07-30,14:00:00,266,126,140,FMN GV 05 Lier
60,Mechelsesteenweg 365,2023-07-30,15:00:00,270,144,126,FMN GV 05 Lier
60,Mechelsesteenweg 365,2023-07-30,16:00:00,212,110,102,FMN GV 05 Lier
60,Mechelsesteenweg 365,2023-07-30,17:00:00,98,50,48,FMN GV 05 Lier
60,Mechelsesteenweg 365,2023-07-30,18:00:00,36,8,28,FMN GV 05 Lier
60,Mechelsesteenweg 365,2023-07-30,19:00:00,8,2,6,FMN GV 05 Lier
60,Mechelsesteenweg 365,2023-07-30,20:00:00,12,4,8,FMN GV 05 Lier
60,Mechelsesteenweg 365,2023-07-30,21:00:00,8,4,4,FMN GV 05 Lier
60,Mechelsesteenweg 365,2023-07-30,22:00:00,2,0,2,FMN GV 05 Lier
60,Mechelsesteenweg 365,2023-07-30,23:00:00,2,0,2,FMN GV 05 Lier
60,Mechelsesteenweg 365,2023-07-31,00:00:00,0,0,0,FMN GV 05 Lier
60,Mechelsesteenweg 365,2023-07-31,01:00:00,2,2,0,FMN GV 05 Lier
60,Mechelsesteenweg 365,2023-07-31,02:00:00,0,0,0,FMN GV 05 Lier
60,Mechelsesteenweg 365,2023-07-31,03:00:00,2,0,2,FMN GV 05 Lier
60,Mechelsesteenweg 365,2023-07-31,04:00:00,0,0,0,FMN GV 05 Lier
60,Mechelsesteenweg 365,2023-07-31,05:00:00,6,2,4,FMN GV 05 Lier
60,Mechelsesteenweg 365,2023-07-31,06:00:00,12,0,12,FMN GV 05 Lier
60,Mechelsesteenweg 365,2023-07-31,07:00:00,36,16,20,FMN GV 05 Lier
60,Mechelsesteenweg 365,2023-07-31,08:00:00,52,24,28,FMN GV 05 Lier
60,Mechelsesteenweg 365,2023-07-31,09:00:00,30,18,12,FMN GV 05 Lier
60,Mechelsesteenweg 365,2023-07-31,10:00:00,106,90,16,FMN GV 05 Lier
60,Mechelsesteenweg 365,2023-07-31,11:00:00,94,60,34,FMN GV 05 Lier
60,Mechelsesteenweg 365,2023-07-31,12:00:00,32,10,22,FMN GV 05 Lier
60,Mechelsesteenweg 365,2023-07-31,13:00:00,60,32,28,FMN GV 05 Lier
60,Mechelsesteenweg 365,2023-07-31,14:00:00,38,24,14,FMN GV 05 Lier
60,Mechelsesteenweg 365,2023-07-31,15:00:00,94,80,14,FMN GV 05 Lier
60,Mechelsesteenweg 365,2023-07-31,16:00:00,44,30,14,FMN GV 05 Lier
60,Mechelsesteenweg 365,2023-07-31,17:00:00,64,40,24,FMN GV 05 Lier
60,Mechelsesteenweg 365,2023-07-31,18:00:00,20,10,10,FMN GV 05 Lier
60,Mechelsesteenweg 365,2023-07-31,19:00:00,6,2,4,FMN GV 05 Lier
60,Mechelsesteenweg 365,2023-07-31,20:00:00,16,8,8,FMN GV 05 Lier
60,Mechelsesteenweg 365,2023-07-31,21:00:00,10,6,4,FMN GV 05 Lier
60,Mechelsesteenweg 365,2023-07-31,22:00:00,8,8,0,FMN GV 05 Lier
60,Mechelsesteenweg 365,2023-07-31,23:00:00,0,0,0,FMN GV 05 Lier
60,Mechelsesteenweg 365,2023-08-01,00:00:00,0,0,0,FMN GV 05 Lier
60,Mechelsesteenweg 365,2023-08-01,01:00:00,0,0,0,FMN GV 05 Lier
60,Mechelsesteenweg 365,2023-08-01,02:00:00,0,0,0,FMN GV 05 Lier
60,Mechelsesteenweg 365,2023-08-01,03:00:00,2,0,2,FMN GV 05 Lier
60,Mechelsesteenweg 365,2023-08-01,04:00:00,0,0,0,FMN GV 05 Lier
60,Mechelsesteenweg 365,2023-08-01,05:00:00,6,0,6,FMN GV 05 Lier
60,Mechelsesteenweg 365,2023-08-01,06:00:00,28,6,22,FMN GV 05 Lier
60,Mechelsesteenweg 365,2023-08-01,07:00:00,80,34,46,FMN GV 05 Lier
60,Mechelsesteenweg 365,2023-08-01,08:00:00,58,16,42,FMN GV 05 Lier
60,Mechelsesteenweg 365,2023-08-01,09:00:00,92,60,32,FMN GV 05 Lier
60,Mechelsesteenweg 365,2023-08-01,10:00:00,118,62,56,FMN GV 05 Lier
60,Mechelsesteenweg 365,2023-08-01,11:00:00,68,38,30,FMN GV 05 Lier
60,Mechelsesteenweg 365,2023-08-01,12:00:00,90,54,36,FMN GV 05 Lier
60,Mechelsesteenweg 365,2023-08-01,13:00:00,134,78,56,FMN GV 05 Lier
60,Mechelsesteenweg 365,2023-08-01,14:00:00,198,110,88,FMN GV 05 Lier
60,Mechelsesteenweg 365,2023-08-01,15:00:00,188,100,88,FMN GV 05 Lier
60,Mechelsesteenweg 365,2023-08-01,16:00:00,164,102,62,FMN GV 05 Lier
60,Mechelsesteenweg 365,2023-08-01,17:00:00,116,66,50,FMN GV 05 Lier
60,Mechelsesteenweg 365,2023-08-01,18:00:00,78,36,42,FMN GV 05 Lier
60,Mechelsesteenweg 365,2023-08-01,19:00:00,102,34,68,FMN GV 05 Lier
60,Mechelsesteenweg 365,2023-08-01,20:00:00,110,44,66,FMN GV 05 Lier
60,Mechelsesteenweg 365,2023-08-01,21:00:00,26,12,14,FMN GV 05 Lier
60,Mechelsesteenweg 365,2023-08-01,22:00:00,10,10,0,FMN GV 05 Lier
60,Mechelsesteenweg 365,2023-08-01,23:00:00,0,0,0,FMN GV 05 Lier
60,Mechelsesteenweg 365,2023-08-02,00:00:00,0,0,0,FMN GV 05 Lier
60,Mechelsesteenweg 365,2023-08-02,01:00:00,4,0,4,FMN GV 05 Lier
60,Mechelsesteenweg 365,2023-08-02,02:00:00,2,2,0,FMN GV 05 Lier
60,Mechelsesteenweg 365,2023-08-02,03:00:00,2,0,2,FMN GV 05 Lier
60,Mechelsesteenweg 365,2023-08-02,04:00:00,2,0,2,FMN GV 05 Lier
60,Mechelsesteenweg 365,2023-08-02,05:00:00,6,2,4,FMN GV 05 Lier
60,Mechelsesteenweg 365,2023-08-02,06:00:00,18,2,16,FMN GV 05 Lier
60,Mechelsesteenweg 365,2023-08-02,07:00:00,32,12,20,FMN GV 05 Lier
60,Mechelsesteenweg 365,2023-08-02,08:00:00,34,12,22,FMN GV 05 Lier
60,Mechelsesteenweg 365,2023-08-02,09:00:00,8,2,6,FMN GV 05 Lier
60,Mechelsesteenweg 365,2023-08-02,10:00:00,18,14,4,FMN GV 05 Lier
60,Mechelsesteenweg 365,2023-08-02,11:00:00,150,108,42,FMN GV 05 Lier
60,Mechelsesteenweg 365,2023-08-02,12:00:00,62,46,16,FMN GV 05 Lier
60,Mechelsesteenweg 365,2023-08-02,13:00:00,30,18,12,FMN GV 05 Lier
60,Mechelsesteenweg 365,2023-08-02,14:00:00,84,54,30,FMN GV 05 Lier
60,Mechelsesteenweg 365,2023-08-02,15:00:00,76,44,32,FMN GV 05 Lier
60,Mechelsesteenweg 365,2023-08-02,16:00:00,52,34,18,FMN GV 05 Lier
60,Mechelsesteenweg 365,2023-08-02,17:00:00,82,40,42,FMN GV 05 Lier
60,Mechelsesteenweg 365,2023-08-02,18:00:00,34,22,12,FMN GV 05 Lier
60,Mechelsesteenweg 365,2023-08-02,19:00:00,24,18,6,FMN GV 05 Lier
60,Mechelsesteenweg 365,2023-08-02,20:00:00,48,44,4,FMN GV 05 Lier
60,Mechelsesteenweg 365,2023-08-02,21:00:00,10,6,4,FMN GV 05 Lier
60,Mechelsesteenweg 365,2023-08-02,22:00:00,8,8,0,FMN GV 05 Lier
60,Mechelsesteenweg 365,2023-08-02,23:00:00,2,2,0,FMN GV 05 Lier
60,Mechelsesteenweg 365,2023-08-03,00:00:00,0,0,0,FMN GV 05 Lier
60,Mechelsesteenweg 365,2023-08-03,01:00:00,6,2,4,FMN GV 05 Lier
60,Mechelsesteenweg 365,2023-08-03,02:00:00,0,0,0,FMN GV 05 Lier
60,Mechelsesteenweg 365,2023-08-03,03:00:00,2,0,2,FMN GV 05 Lier
60,Mechelsesteenweg 365,2023-08-03,04:00:00,0,0,0,FMN GV 05 Lier
60,Mechelsesteenweg 365,2023-08-03,05:00:00,2,0,2,FMN GV 05 Lier
60,Mechelsesteenweg 365,2023-08-03,06:00:00,16,6,10,FMN GV 05 Lier
60,Mechelsesteenweg 365,2023-08-03,07:00:00,34,10,24,FMN GV 05 Lier
60,Mechelsesteenweg 365,2023-08-03,08:00:00,40,12,28,FMN GV 05 Lier
60,Mechelsesteenweg 365,2023-08-03,09:00:00,24,8,16,FMN GV 05 Lier
60,Mechelsesteenweg 365,2023-08-03,10:00:00,68,62,6,FMN GV 05 Lier
60,Mechelsesteenweg 365,2023-08-03,11:00:00,14,10,4,FMN GV 05 Lier
60,Mechelsesteenweg 365,2023-08-03,12:00:00,24,10,14,FMN GV 05 Lier
60,Mechelsesteenweg 365,2023-08-03,13:00:00,50,36,14,FMN GV 05 Lier
60,Mechelsesteenweg 365,2023-08-03,14:00:00,46,24,22,FMN GV 05 Lier
60,Mechelsesteenweg 365,2023-08-03,15:00:00,54,24,30,FMN GV 05 Lier
60,Mechelsesteenweg 365,2023-08-03,16:00:00,86,36,50,FMN GV 05 Lier
60,Mechelsesteenweg 365,2023-08-03,17:00:00,66,40,26,FMN GV 05 Lier
60,Mechelsesteenweg 365,2023-08-03,18:00:00,66,36,30,FMN GV 05 Lier
60,Mechelsesteenweg 365,2023-08-03,19:00:00,62,38,24,FMN GV 05 Lier
60,Mechelsesteenweg 365,2023-08-03,20:00:00,108,34,74,FMN GV 05 Lier
60,Mechelsesteenweg 365,2023-08-03,21:00:00,14,4,10,FMN GV 05 Lier
60,Mechelsesteenweg 365,2023-08-03,22:00:00,26,14,12,FMN GV 05 Lier
60,Mechelsesteenweg 365,2023-08-03,23:00:00,2,0,2,FMN GV 05 Lier
60,Mechelsesteenweg 365,2023-08-04,00:00:00,4,4,0,FMN GV 05 Lier
60,Mechelsesteenweg 365,2023-08-04,01:00:00,0,0,0,FMN GV 05 Lier
60,Mechelsesteenweg 365,2023-08-04,02:00:00,2,0,2,FMN GV 05 Lier
60,Mechelsesteenweg 365,2023-08-04,03:00:00,2,0,2,FMN GV 05 Lier
60,Mechelsesteenweg 365,2023-08-04,04:00:00,2,0,2,FMN GV 05 Lier
60,Mechelsesteenweg 365,2023-08-04,05:00:00,2,2,0,FMN GV 05 Lier
60,Mechelsesteenweg 365,2023-08-04,06:00:00,28,8,20,FMN GV 05 Lier
60,Mechelsesteenweg 365,2023-08-04,07:00:00,50,14,36,FMN GV 05 Lier
60,Mechelsesteenweg 365,2023-08-04,08:00:00,46,22,24,FMN GV 05 Lier
60,Mechelsesteenweg 365,2023-08-04,09:00:00,40,34,6,FMN GV 05 Lier
60,Mechelsesteenweg 365,2023-08-04,10:00:00,32,10,22,FMN GV 05 Lier
60,Mechelsesteenweg 365,2023-08-04,11:00:00,60,34,26,FMN GV 05 Lier
60,Mechelsesteenweg 365,2023-08-04,12:00:00,80,48,32,FMN GV 05 Lier
60,Mechelsesteenweg 365,2023-08-04,13:00:00,90,40,50,FMN GV 05 Lier
60,Mechelsesteenweg 365,2023-08-04,14:00:00,144,62,82,FMN GV 05 Lier
60,Mechelsesteenweg 365,2023-08-04,15:00:00,156,74,82,FMN GV 05 Lier
60,Mechelsesteenweg 365,2023-08-04,16:00:00,166,70,96,FMN GV 05 Lier
60,Mechelsesteenweg 365,2023-08-04,17:00:00,128,72,56,FMN GV 05 Lier
60,Mechelsesteenweg 365,2023-08-04,18:00:00,118,70,48,FMN GV 05 Lier
60,Mechelsesteenweg 365,2023-08-04,19:00:00,112,58,54,FMN GV 05 Lier
60,Mechelsesteenweg 365,2023-08-04,20:00:00,74,20,54,FMN GV 05 Lier
60,Mechelsesteenweg 365,2023-08-04,21:00:00,38,16,22,FMN GV 05 Lier
60,Mechelsesteenweg 365,2023-08-04,22:00:00,14,8,6,FMN GV 05 Lier
60,Mechelsesteenweg 365,2023-08-04,23:00:00,8,6,2,FMN GV 05 Lier
60,Mechelsesteenweg 365,2023-08-05,00:00:00,26,22,4,FMN GV 05 Lier
60,Mechelsesteenweg 365,2023-08-05,01:00:00,38,34,4,FMN GV 05 Lier
60,Mechelsesteenweg 365,2023-08-05,02:00:00,8,6,2,FMN GV 05 Lier
60,Mechelsesteenweg 365,2023-08-05,03:00:00,6,6,0,FMN GV 05 Lier
60,Mechelsesteenweg 365,2023-08-05,04:00:00,4,2,2,FMN GV 05 Lier
60,Mechelsesteenweg 365,2023-08-05,05:00:00,8,2,6,FMN GV 05 Lier
60,Mechelsesteenweg 365,2023-08-05,06:00:00,14,4,10,FMN GV 05 Lier
60,Mechelsesteenweg 365,2023-08-05,07:00:00,16,8,8,FMN GV 05 Lier
60,Mechelsesteenweg 365,2023-08-05,08:00:00,42,22,20,FMN GV 05 Lier
60,Mechelsesteenweg 365,2023-08-05,09:00:00,154,86,68,FMN GV 05 Lier
60,Mechelsesteenweg 365,2023-08-05,10:00:00,186,98,88,FMN GV 05 Lier
60,Mechelsesteenweg 365,2023-08-05,11:00:00,230,134,96,FMN GV 05 Lier
60,Mechelsesteenweg 365,2023-08-05,12:00:00,160,94,66,FMN GV 05 Lier
60,Mechelsesteenweg 365,2023-08-05,13:00:00,52,22,30,FMN GV 05 Lier
60,Mechelsesteenweg 365,2023-08-05,14:00:00,48,24,24,FMN GV 05 Lier
60,Mechelsesteenweg 365,2023-08-05,15:00:00,34,12,22,FMN GV 05 Lier
60,Mechelsesteenweg 365,2023-08-05,16:00:00,32,14,18,FMN GV 05 Lier
60,Mechelsesteenweg 365,2023-08-05,17:00:00,38,12,26,FMN GV 05 Lier
60,Mechelsesteenweg 365,2023-08-05,18:00:00,10,6,4,FMN GV 05 Lier
60,Mechelsesteenweg 365,2023-08-05,19:00:00,8,2,6,FMN GV 05 Lier
60,Mechelsesteenweg 365,2023-08-05,20:00:00,14,4,10,FMN GV 05 Lier
60,Mechelsesteenweg 365,2023-08-05,21:00:00,12,6,6,FMN GV 05 Lier
60,Mechelsesteenweg 365,2023-08-05,22:00:00,16,16,0,FMN GV 05 Lier
60,Mechelsesteenweg 365,2023-08-05,23:00:00,4,4,0,FMN GV 05 Lier
60,Mechelsesteenweg 365,2023-08-06,00:00:00,0,0,0,FMN GV 05 Lier
60,Mechelsesteenweg 365,2023-08-06,01:00:00,12,10,2,FMN GV 05 Lier
60,Mechelsesteenweg 365,2023-08-06,02:00:00,6,6,0,FMN GV 05 Lier
60,Mechelsesteenweg 365,2023-08-06,03:00:00,0,0,0,FMN GV 05 Lier
60,Mechelsesteenweg 365,2023-08-06,04:00:00,0,0,0,FMN GV 05 Lier
60,Mechelsesteenweg 365,2023-08-06,05:00:00,0,0,0,FMN GV 05 Lier
60,Mechelsesteenweg 365,2023-08-06,06:00:00,6,2,4,FMN GV 05 Lier
60,Mechelsesteenweg 365,2023-08-06,07:00:00,0,0,0,FMN GV 05 Lier
60,Mechelsesteenweg 365,2023-08-06,08:00:00,0,0,0,FMN GV 05 Lier
60,Mechelsesteenweg 365,2023-08-06,09:00:00,22,12,10,FMN GV 05 Lier
60,Mechelsesteenweg 365,2023-08-06,10:00:00,42,28,14,FMN GV 05 Lier
60,Mechelsesteenweg 365,2023-08-06,11:00:00,26,14,12,FMN GV 05 Lier
60,Mechelsesteenweg 365,2023-08-06,12:00:00,18,6,12,FMN GV 05 Lier
60,Mechelsesteenweg 365,2023-08-06,13:00:00,10,4,6,FMN GV 05 Lier
60,Mechelsesteenweg 365,2023-08-06,14:00:00,8,6,2,FMN GV 05 Lier
60,Mechelsesteenweg 365,2023-08-06,15:00:00,40,0,40,FMN GV 05 Lier
60,Mechelsesteenweg 365,2023-08-06,16:00:00,6,4,2,FMN GV 05 Lier
60,Mechelsesteenweg 365,2023-08-06,17:00:00,0,0,0,FMN GV 05 Lier
60,Mechelsesteenweg 365,2023-08-06,18:00:00,10,8,2,FMN GV 05 Lier
60,Mechelsesteenweg 365,2023-08-06,19:00:00,16,12,4,FMN GV 05 Lier
60,Mechelsesteenweg 365,2023-08-06,20:00:00,26,14,12,FMN GV 05 Lier
60,Mechelsesteenweg 365,2023-08-06,21:00:00,12,8,4,FMN GV 05 Lier
60,Mechelsesteenweg 365,2023-08-06,22:00:00,2,2,0,FMN GV 05 Lier
60,Mechelsesteenweg 365,2023-08-06,23:00:00,0,0,0,FMN GV 05 Lier
60,Mechelsesteenweg 365,2023-08-07,00:00:00,0,0,0,FMN GV 05 Lier
60,Mechelsesteenweg 365,2023-08-07,01:00:00,0,0,0,FMN GV 05 Lier
60,Mechelsesteenweg 365,2023-08-07,02:00:00,0,0,0,FMN GV 05 Lier
60,Mechelsesteenweg 365,2023-08-07,03:00:00,2,0,2,FMN GV 05 Lier
60,Mechelsesteenweg 365,2023-08-07,04:00:00,0,0,0,FMN GV 05 Lier
60,Mechelsesteenweg 365,2023-08-07,05:00:00,2,0,2,FMN GV 05 Lier
60,Mechelsesteenweg 365,2023-08-07,06:00:00,26,12,14,FMN GV 05 Lier
60,Mechelsesteenweg 365,2023-08-07,07:00:00,86,20,66,FMN GV 05 Lier
60,Mechelsesteenweg 365,2023-08-07,08:00:00,72,26,46,FMN GV 05 Lier
60,Mechelsesteenweg 365,2023-08-07,09:00:00,78,42,36,FMN GV 05 Lier
60,Mechelsesteenweg 365,2023-08-07,10:00:00,48,14,34,FMN GV 05 Lier
60,Mechelsesteenweg 365,2023-08-07,11:00:00,128,60,68,FMN GV 05 Lier
60,Mechelsesteenweg 365,2023-08-07,12:00:00,96,42,54,FMN GV 05 Lier
60,Mechelsesteenweg 365,2023-08-07,13:00:00,132,76,56,FMN GV 05 Lier
60,Mechelsesteenweg 365,2023-08-07,14:00:00,220,86,134,FMN GV 05 Lier
60,Mechelsesteenweg 365,2023-08-07,15:00:00,206,114,92,FMN GV 05 Lier
60,Mechelsesteenweg 365,2023-08-07,16:00:00,250,108,142,FMN GV 05 Lier
60,Mechelsesteenweg 365,2023-08-07,17:00:00,210,118,92,FMN GV 05 Lier
60,Mechelsesteenweg 365,2023-08-07,18:00:00,134,84,50,FMN GV 05 Lier
60,Mechelsesteenweg 365,2023-08-07,19:00:00,114,82,32,FMN GV 05 Lier
60,Mechelsesteenweg 365,2023-08-07,20:00:00,74,24,50,FMN GV 05 Lier
60,Mechelsesteenweg 365,2023-08-07,21:00:00,34,12,22,FMN GV 05 Lier
60,Mechelsesteenweg 365,2023-08-07,22:00:00,12,8,4,FMN GV 05 Lier
60,Mechelsesteenweg 365,2023-08-07,23:00:00,2,0,2,FMN GV 05 Lier
60,Mechelsesteenweg 365,2023-08-08,00:00:00,2,2,0,FMN GV 05 Lier
60,Mechelsesteenweg 365,2023-08-08,01:00:00,0,0,0,FMN GV 05 Lier
60,Mechelsesteenweg 365,2023-08-08,02:00:00,0,0,0,FMN GV 05 Lier
60,Mechelsesteenweg 365,2023-08-08,03:00:00,2,0,2,FMN GV 05 Lier
60,Mechelsesteenweg 365,2023-08-08,04:00:00,0,0,0,FMN GV 05 Lier
60,Mechelsesteenweg 365,2023-08-08,05:00:00,2,0,2,FMN GV 05 Lier
60,Mechelsesteenweg 365,2023-08-08,06:00:00,38,8,30,FMN GV 05 Lier
60,Mechelsesteenweg 365,2023-08-08,07:00:00,72,18,54,FMN GV 05 Lier
60,Mechelsesteenweg 365,2023-08-08,08:00:00,94,40,54,FMN GV 05 Lier
60,Mechelsesteenweg 365,2023-08-08,09:00:00,108,64,44,FMN GV 05 Lier
60,Mechelsesteenweg 365,2023-08-08,10:00:00,124,80,44,FMN GV 05 Lier
60,Mechelsesteenweg 365,2023-08-08,11:00:00,108,66,42,FMN GV 05 Lier
60,Mechelsesteenweg 365,2023-08-08,12:00:00,122,66,56,FMN GV 05 Lier
60,Mechelsesteenweg 365,2023-08-08,13:00:00,110,70,40,FMN GV 05 Lier
60,Mechelsesteenweg 365,2023-08-08,14:00:00,162,90,72,FMN GV 05 Lier
60,Mechelsesteenweg 365,2023-08-08,15:00:00,214,132,82,FMN GV 05 Lier
60,Mechelsesteenweg 365,2023-08-08,16:00:00,216,114,102,FMN GV 05 Lier
60,Mechelsesteenweg 365,2023-08-08,17:00:00,148,90,58,FMN GV 05 Lier
60,Mechelsesteenweg 365,2023-08-08,18:00:00,78,44,34,FMN GV 05 Lier
60,Mechelsesteenweg 365,2023-08-08,19:00:00,36,20,16,FMN GV 05 Lier
60,Mechelsesteenweg 365,2023-08-08,20:00:00,52,10,42,FMN GV 05 Lier
60,Mechelsesteenweg 365,2023-08-08,21:00:00,2,2,0,FMN GV 05 Lier
60,Mechelsesteenweg 365,2023-08-08,22:00:00,4,2,2,FMN GV 05 Lier
60,Mechelsesteenweg 365,2023-08-08,23:00:00,2,0,2,FMN GV 05 Lier
60,Mechelsesteenweg 365,2023-08-09,00:00:00,0,0,0,FMN GV 05 Lier
60,Mechelsesteenweg 365,2023-08-09,01:00:00,0,0,0,FMN GV 05 Lier
60,Mechelsesteenweg 365,2023-08-09,02:00:00,0,0,0,FMN GV 05 Lier
60,Mechelsesteenweg 365,2023-08-09,03:00:00,4,0,4,FMN GV 05 Lier
60,Mechelsesteenweg 365,2023-08-09,04:00:00,0,0,0,FMN GV 05 Lier
60,Mechelsesteenweg 365,2023-08-09,05:00:00,10,4,6,FMN GV 05 Lier
60,Mechelsesteenweg 365,2023-08-09,06:00:00,42,6,36,FMN GV 05 Lier
60,Mechelsesteenweg 365,2023-08-09,07:00:00,68,14,54,FMN GV 05 Lier
60,Mechelsesteenweg 365,2023-08-09,08:00:00,92,36,56,FMN GV 05 Lier
60,Mechelsesteenweg 365,2023-08-09,09:00:00,68,32,36,FMN GV 05 Lier
60,Mechelsesteenweg 365,2023-08-09,10:00:00,132,44,88,FMN GV 05 Lier
60,Mechelsesteenweg 365,2023-08-09,11:00:00,200,96,104,FMN GV 05 Lier
60,Mechelsesteenweg 365,2023-08-09,12:00:00,204,98,106,FMN GV 05 Lier
60,Mechelsesteenweg 365,2023-08-09,13:00:00,268,138,130,FMN GV 05 Lier
60,Mechelsesteenweg 365,2023-08-09,14:00:00,356,164,192,FMN GV 05 Lier
60,Mechelsesteenweg 365,2023-08-09,15:00:00,424,200,224,FMN GV 05 Lier
60,Mechelsesteenweg 365,2023-08-09,16:00:00,288,134,154,FMN GV 05 Lier
60,Mechelsesteenweg 365,2023-08-09,17:00:00,240,134,106,FMN GV 05 Lier
60,Mechelsesteenweg 365,2023-08-09,18:00:00,202,112,90,FMN GV 05 Lier
60,Mechelsesteenweg 365,2023-08-09,19:00:00,174,110,64,FMN GV 05 Lier
60,Mechelsesteenweg 365,2023-08-09,20:00:00,346,192,154,FMN GV 05 Lier
60,Mechelsesteenweg 365,2023-08-09,21:00:00,48,26,22,FMN GV 05 Lier
60,Mechelsesteenweg 365,2023-08-09,22:00:00,24,6,18,FMN GV 05 Lier
60,Mechelsesteenweg 365,2023-08-09,23:00:00,4,0,4,FMN GV 05 Lier
60,Mechelsesteenweg 365,2023-08-10,00:00:00,2,0,2,FMN GV 05 Lier
60,Mechelsesteenweg 365,2023-08-10,01:00:00,4,2,2,FMN GV 05 Lier
60,Mechelsesteenweg 365,2023-08-10,02:00:00,0,0,0,FMN GV 05 Lier
60,Mechelsesteenweg 365,2023-08-10,03:00:00,2,0,2,FMN GV 05 Lier
60,Mechelsesteenweg 365,2023-08-10,04:00:00,0,0,0,FMN GV 05 Lier
60,Mechelsesteenweg 365,2023-08-10,05:00:00,4,0,4,FMN GV 05 Lier
60,Mechelsesteenweg 365,2023-08-10,06:00:00,36,6,30,FMN GV 05 Lier
60,Mechelsesteenweg 365,2023-08-10,07:00:00,86,24,62,FMN GV 05 Lier
60,Mechelsesteenweg 365,2023-08-10,08:00:00,106,48,58,FMN GV 05 Lier
60,Mechelsesteenweg 365,2023-08-10,09:00:00,138,86,52,FMN GV 05 Lier
60,Mechelsesteenweg 365,2023-08-10,10:00:00,184,108,76,FMN GV 05 Lier
60,Mechelsesteenweg 365,2023-08-10,11:00:00,350,200,150,FMN GV 05 Lier
60,Mechelsesteenweg 365,2023-08-10,12:00:00,238,136,102,FMN GV 05 Lier
60,Mechelsesteenweg 365,2023-08-10,13:00:00,316,142,174,FMN GV 05 Lier
60,Mechelsesteenweg 365,2023-08-10,14:00:00,524,286,238,FMN GV 05 Lier
60,Mechelsesteenweg 365,2023-08-10,15:00:00,510,254,256,FMN GV 05 Lier
60,Mechelsesteenweg 365,2023-08-10,16:00:00,430,190,240,FMN GV 05 Lier
60,Mechelsesteenweg 365,2023-08-10,17:00:00,316,180,136,FMN GV 05 Lier
60,Mechelsesteenweg 365,2023-08-10,18:00:00,182,74,108,FMN GV 05 Lier
60,Mechelsesteenweg 365,2023-08-10,19:00:00,188,96,92,FMN GV 05 Lier
60,Mechelsesteenweg 365,2023-08-10,20:00:00,198,74,124,FMN GV 05 Lier
60,Mechelsesteenweg 365,2023-08-10,21:00:00,60,36,24,FMN GV 05 Lier
60,Mechelsesteenweg 365,2023-08-10,22:00:00,32,16,16,FMN GV 05 Lier
60,Mechelsesteenweg 365,2023-08-10,23:00:00,4,4,0,FMN GV 05 Lier
60,Mechelsesteenweg 365,2023-08-11,00:00:00,4,2,2,FMN GV 05 Lier
60,Mechelsesteenweg 365,2023-08-11,01:00:00,0,0,0,FMN GV 05 Lier
60,Mechelsesteenweg 365,2023-08-11,02:00:00,0,0,0,FMN GV 05 Lier
60,Mechelsesteenweg 365,2023-08-11,03:00:00,2,0,2,FMN GV 05 Lier
60,Mechelsesteenweg 365,2023-08-11,04:00:00,0,0,0,FMN GV 05 Lier
60,Mechelsesteenweg 365,2023-08-11,05:00:00,8,2,6,FMN GV 05 Lier
60,Mechelsesteenweg 365,2023-08-11,06:00:00,42,12,30,FMN GV 05 Lier
60,Mechelsesteenweg 365,2023-08-11,07:00:00,82,28,54,FMN GV 05 Lier
60,Mechelsesteenweg 365,2023-08-11,08:00:00,90,44,46,FMN GV 05 Lier
60,Mechelsesteenweg 365,2023-08-11,09:00:00,90,44,46,FMN GV 05 Lier
60,Mechelsesteenweg 365,2023-08-11,10:00:00,222,108,114,FMN GV 05 Lier
60,Mechelsesteenweg 365,2023-08-11,11:00:00,250,126,124,FMN GV 05 Lier
60,Mechelsesteenweg 365,2023-08-11,12:00:00,218,126,92,FMN GV 05 Lier
60,Mechelsesteenweg 365,2023-08-11,13:00:00,268,136,132,FMN GV 05 Lier
60,Mechelsesteenweg 365,2023-08-11,14:00:00,352,162,190,FMN GV 05 Lier
60,Mechelsesteenweg 365,2023-08-11,15:00:00,318,168,150,FMN GV 05 Lier
60,Mechelsesteenweg 365,2023-08-11,16:00:00,270,124,146,FMN GV 05 Lier
60,Mechelsesteenweg 365,2023-08-11,17:00:00,240,112,128,FMN GV 05 Lier
60,Mechelsesteenweg 365,2023-08-11,18:00:00,138,84,54,FMN GV 05 Lier
60,Mechelsesteenweg 365,2023-08-11,19:00:00,52,32,20,FMN GV 05 Lier
60,Mechelsesteenweg 365,2023-08-11,20:00:00,52,28,24,FMN GV 05 Lier
60,Mechelsesteenweg 365,2023-08-11,21:00:00,44,18,26,FMN GV 05 Lier
60,Mechelsesteenweg 365,2023-08-11,22:00:00,22,10,12,FMN GV 05 Lier
60,Mechelsesteenweg 365,2023-08-11,23:00:00,8,4,4,FMN GV 05 Lier
60,Mechelsesteenweg 365,2023-08-12,00:00:00,16,10,6,FMN GV 05 Lier
60,Mechelsesteenweg 365,2023-08-12,01:00:00,2,2,0,FMN GV 05 Lier
60,Mechelsesteenweg 365,2023-08-12,02:00:00,2,0,2,FMN GV 05 Lier
60,Mechelsesteenweg 365,2023-08-12,03:00:00,8,0,8,FMN GV 05 Lier
60,Mechelsesteenweg 365,2023-08-12,04:00:00,0,0,0,FMN GV 05 Lier
60,Mechelsesteenweg 365,2023-08-12,05:00:00,2,0,2,FMN GV 05 Lier
60,Mechelsesteenweg 365,2023-08-12,06:00:00,2,0,2,FMN GV 05 Lier
60,Mechelsesteenweg 365,2023-08-12,07:00:00,4,4,0,FMN GV 05 Lier
60,Mechelsesteenweg 365,2023-08-12,08:00:00,8,2,6,FMN GV 05 Lier
60,Mechelsesteenweg 365,2023-08-12,09:00:00,26,14,12,FMN GV 05 Lier
60,Mechelsesteenweg 365,2023-08-12,10:00:00,38,12,26,FMN GV 05 Lier
60,Mechelsesteenweg 365,2023-08-12,11:00:00,82,56,26,FMN GV 05 Lier
60,Mechelsesteenweg 365,2023-08-12,12:00:00,102,54,48,FMN GV 05 Lier
60,Mechelsesteenweg 365,2023-08-12,13:00:00,176,106,70,FMN GV 05 Lier
60,Mechelsesteenweg 365,2023-08-12,14:00:00,304,156,148,FMN GV 05 Lier
60,Mechelsesteenweg 365,2023-08-12,15:00:00,302,150,152,FMN GV 05 Lier
60,Mechelsesteenweg 365,2023-08-12,16:00:00,204,82,122,FMN GV 05 Lier
60,Mechelsesteenweg 365,2023-08-12,17:00:00,182,80,102,FMN GV 05 Lier
60,Mechelsesteenweg 365,2023-08-12,18:00:00,84,48,36,FMN GV 05 Lier
60,Mechelsesteenweg 365,2023-08-12,19:00:00,74,32,42,FMN GV 05 Lier
60,Mechelsesteenweg 365,2023-08-12,20:00:00,62,28,34,FMN GV 05 Lier
60,Mechelsesteenweg 365,2023-08-12,21:00:00,42,6,36,FMN GV 05 Lier
60,Mechelsesteenweg 365,2023-08-12,22:00:00,12,0,12,FMN GV 05 Lier
60,Mechelsesteenweg 365,2023-08-12,23:00:00,6,0,6,FMN GV 05 Lier
60,Mechelsesteenweg 365,2023-08-13,00:00:00,2,2,0,FMN GV 05 Lier
60,Mechelsesteenweg 365,2023-08-13,01:00:00,4,0,4,FMN GV 05 Lier
60,Mechelsesteenweg 365,2023-08-13,02:00:00,0,0,0,FMN GV 05 Lier
60,Mechelsesteenweg 365,2023-08-13,03:00:00,2,0,2,FMN GV 05 Lier
60,Mechelsesteenweg 365,2023-08-13,04:00:00,0,0,0,FMN GV 05 Lier
60,Mechelsesteenweg 365,2023-08-13,05:00:00,2,2,0,FMN GV 05 Lier
60,Mechelsesteenweg 365,2023-08-13,06:00:00,10,8,2,FMN GV 05 Lier
60,Mechelsesteenweg 365,2023-08-13,07:00:00,22,14,8,FMN GV 05 Lier
60,Mechelsesteenweg 365,2023-08-13,08:00:00,26,20,6,FMN GV 05 Lier
60,Mechelsesteenweg 365,2023-08-13,09:00:00,218,112,106,FMN GV 05 Lier
60,Mechelsesteenweg 365,2023-08-13,10:00:00,412,214,198,FMN GV 05 Lier
60,Mechelsesteenweg 365,2023-08-13,11:00:00,380,234,146,FMN GV 05 Lier
60,Mechelsesteenweg 365,2023-08-13,12:00:00,288,172,116,FMN GV 05 Lier
60,Mechelsesteenweg 365,2023-08-13,13:00:00,260,118,142,FMN GV 05 Lier
60,Mechelsesteenweg 365,2023-08-13,14:00:00,474,250,224,FMN GV 05 Lier
60,Mechelsesteenweg 365,2023-08-13,15:00:00,428,198,230,FMN GV 05 Lier
60,Mechelsesteenweg 365,2023-08-13,16:00:00,372,170,202,FMN GV 05 Lier
60,Mechelsesteenweg 365,2023-08-13,17:00:00,222,96,126,FMN GV 05 Lier
60,Mechelsesteenweg 365,2023-08-13,18:00:00,156,92,64,FMN GV 05 Lier
60,Mechelsesteenweg 365,2023-08-13,19:00:00,198,60,138,FMN GV 05 Lier
60,Mechelsesteenweg 365,2023-08-13,20:00:00,78,30,48,FMN GV 05 Lier
60,Mechelsesteenweg 365,2023-08-13,21:00:00,40,8,32,FMN GV 05 Lier
60,Mechelsesteenweg 365,2023-08-13,22:00:00,14,4,10,FMN GV 05 Lier
60,Mechelsesteenweg 365,2023-08-13,23:00:00,0,0,0,FMN GV 05 Lier
60,Mechelsesteenweg 365,2023-08-14,00:00:00,6,0,6,FMN GV 05 Lier
60,Mechelsesteenweg 365,2023-08-14,01:00:00,0,0,0,FMN GV 05 Lier
60,Mechelsesteenweg 365,2023-08-14,02:00:00,0,0,0,FMN GV 05 Lier
60,Mechelsesteenweg 365,2023-08-14,03:00:00,2,0,2,FMN GV 05 Lier
60,Mechelsesteenweg 365,2023-08-14,04:00:00,0,0,0,FMN GV 05 Lier
60,Mechelsesteenweg 365,2023-08-14,05:00:00,6,2,4,FMN GV 05 Lier
60,Mechelsesteenweg 365,2023-08-14,06:00:00,20,8,12,FMN GV 05 Lier
60,Mechelsesteenweg 365,2023-08-14,07:00:00,50,22,28,FMN GV 05 Lier
60,Mechelsesteenweg 365,2023-08-14,08:00:00,60,26,34,FMN GV 05 Lier
60,Mechelsesteenweg 365,2023-08-14,09:00:00,106,58,48,FMN GV 05 Lier
60,Mechelsesteenweg 365,2023-08-14,10:00:00,140,78,62,FMN GV 05 Lier
60,Mechelsesteenweg 365,2023-08-14,11:00:00,280,146,134,FMN GV 05 Lier
60,Mechelsesteenweg 365,2023-08-14,12:00:00,228,120,108,FMN GV 05 Lier
60,Mechelsesteenweg 365,2023-08-14,13:00:00,372,198,174,FMN GV 05 Lier
60,Mechelsesteenweg 365,2023-08-14,14:00:00,402,284,118,FMN GV 05 Lier
60,Mechelsesteenweg 365,2023-08-14,15:00:00,388,172,216,FMN GV 05 Lier
60,Mechelsesteenweg 365,2023-08-14,16:00:00,348,132,216,FMN GV 05 Lier
60,Mechelsesteenweg 365,2023-08-14,17:00:00,234,102,132,FMN GV 05 Lier
60,Mechelsesteenweg 365,2023-08-14,18:00:00,152,86,66,FMN GV 05 Lier
60,Mechelsesteenweg 365,2023-08-14,19:00:00,124,58,66,FMN GV 05 Lier
60,Mechelsesteenweg 365,2023-08-14,20:00:00,134,54,80,FMN GV 05 Lier
60,Mechelsesteenweg 365,2023-08-14,21:00:00,60,18,42,FMN GV 05 Lier
60,Mechelsesteenweg 365,2023-08-14,22:00:00,24,8,16,FMN GV 05 Lier
60,Mechelsesteenweg 365,2023-08-14,23:00:00,4,0,4,FMN GV 05 Lier
60,Mechelsesteenweg 365,2023-08-15,00:00:00,12,4,8,FMN GV 05 Lier
60,Mechelsesteenweg 365,2023-08-15,01:00:00,0,0,0,FMN GV 05 Lier
60,Mechelsesteenweg 365,2023-08-15,02:00:00,6,2,4,FMN GV 05 Lier
60,Mechelsesteenweg 365,2023-08-15,03:00:00,0,0,0,FMN GV 05 Lier
60,Mechelsesteenweg 365,2023-08-15,04:00:00,0,0,0,FMN GV 05 Lier
60,Mechelsesteenweg 365,2023-08-15,05:00:00,4,2,2,FMN GV 05 Lier
60,Mechelsesteenweg 365,2023-08-15,06:00:00,14,12,2,FMN GV 05 Lier
60,Mechelsesteenweg 365,2023-08-15,07:00:00,22,8,14,FMN GV 05 Lier
60,Mechelsesteenweg 365,2023-08-15,08:00:00,72,54,18,FMN GV 05 Lier
60,Mechelsesteenweg 365,2023-08-15,09:00:00,234,120,114,FMN GV 05 Lier
60,Mechelsesteenweg 365,2023-08-15,10:00:00,448,256,192,FMN GV 05 Lier
60,Mechelsesteenweg 365,2023-08-15,11:00:00,610,328,282,FMN GV 05 Lier
60,Mechelsesteenweg 365,2023-08-15,12:00:00,416,218,198,FMN GV 05 Lier
60,Mechelsesteenweg 365,2023-08-15,13:00:00,440,192,248,FMN GV 05 Lier
60,Mechelsesteenweg 365,2023-08-15,14:00:00,544,304,240,FMN GV 05 Lier
60,Mechelsesteenweg 365,2023-08-15,15:00:00,608,270,338,FMN GV 05 Lier
60,Mechelsesteenweg 365,2023-08-15,16:00:00,452,230,222,FMN GV 05 Lier
60,Mechelsesteenweg 365,2023-08-15,17:00:00,292,108,184,FMN GV 05 Lier
60,Mechelsesteenweg 365,2023-08-15,18:00:00,172,74,98,FMN GV 05 Lier
60,Mechelsesteenweg 365,2023-08-15,19:00:00,118,44,74,FMN GV 05 Lier
60,Mechelsesteenweg 365,2023-08-15,20:00:00,76,30,46,FMN GV 05 Lier
60,Mechelsesteenweg 365,2023-08-15,21:00:00,48,20,28,FMN GV 05 Lier
60,Mechelsesteenweg 365,2023-08-15,22:00:00,36,2,34,FMN GV 05 Lier
60,Mechelsesteenweg 365,2023-08-15,23:00:00,4,2,2,FMN GV 05 Lier
60,Mechelsesteenweg 365,2023-08-16,00:00:00,2,0,2,FMN GV 05 Lier
60,Mechelsesteenweg 365,2023-08-16,01:00:00,0,0,0,FMN GV 05 Lier
60,Mechelsesteenweg 365,2023-08-16,02:00:00,0,0,0,FMN GV 05 Lier
60,Mechelsesteenweg 365,2023-08-16,03:00:00,2,0,2,FMN GV 05 Lier
60,Mechelsesteenweg 365,2023-08-16,04:00:00,2,0,2,FMN GV 05 Lier
60,Mechelsesteenweg 365,2023-08-16,05:00:00,6,6,0,FMN GV 05 Lier
60,Mechelsesteenweg 365,2023-08-16,06:00:00,42,14,28,FMN GV 05 Lier
60,Mechelsesteenweg 365,2023-08-16,07:00:00,88,24,64,FMN GV 05 Lier
60,Mechelsesteenweg 365,2023-08-16,08:00:00,100,36,64,FMN GV 05 Lier
60,Mechelsesteenweg 365,2023-08-16,09:00:00,102,40,62,FMN GV 05 Lier
60,Mechelsesteenweg 365,2023-08-16,10:00:00,164,90,74,FMN GV 05 Lier
60,Mechelsesteenweg 365,2023-08-16,11:00:00,174,62,112,FMN GV 05 Lier
60,Mechelsesteenweg 365,2023-08-16,12:00:00,132,68,64,FMN GV 05 Lier
60,Mechelsesteenweg 365,2023-08-16,13:00:00,268,158,110,FMN GV 05 Lier
60,Mechelsesteenweg 365,2023-08-16,14:00:00,308,170,138,FMN GV 05 Lier
60,Mechelsesteenweg 365,2023-08-16,15:00:00,320,132,188,FMN GV 05 Lier
60,Mechelsesteenweg 365,2023-08-16,16:00:00,242,116,126,FMN GV 05 Lier
60,Mechelsesteenweg 365,2023-08-16,17:00:00,220,104,116,FMN GV 05 Lier
60,Mechelsesteenweg 365,2023-08-16,18:00:00,184,102,82,FMN GV 05 Lier
60,Mechelsesteenweg 365,2023-08-16,19:00:00,132,52,80,FMN GV 05 Lier
60,Mechelsesteenweg 365,2023-08-16,20:00:00,194,126,68,FMN GV 05 Lier
60,Mechelsesteenweg 365,2023-08-16,21:00:00,24,8,16,FMN GV 05 Lier
60,Mechelsesteenweg 365,2023-08-16,22:00:00,14,8,6,FMN GV 05 Lier
60,Mechelsesteenweg 365,2023-08-16,23:00:00,6,2,4,FMN GV 05 Lier
60,Mechelsesteenweg 365,2023-08-17,00:00:00,0,0,0,FMN GV 05 Lier
60,Mechelsesteenweg 365,2023-08-17,01:00:00,0,0,0,FMN GV 05 Lier
60,Mechelsesteenweg 365,2023-08-17,02:00:00,2,0,2,FMN GV 05 Lier
60,Mechelsesteenweg 365,2023-08-17,03:00:00,2,0,2,FMN GV 05 Lier
60,Mechelsesteenweg 365,2023-08-17,04:00:00,2,0,2,FMN GV 05 Lier
60,Mechelsesteenweg 365,2023-08-17,05:00:00,14,6,8,FMN GV 05 Lier
60,Mechelsesteenweg 365,2023-08-17,06:00:00,52,14,38,FMN GV 05 Lier
60,Mechelsesteenweg 365,2023-08-17,07:00:00,118,16,102,FMN GV 05 Lier
60,Mechelsesteenweg 365,2023-08-17,08:00:00,94,28,66,FMN GV 05 Lier
60,Mechelsesteenweg 365,2023-08-17,09:00:00,86,62,24,FMN GV 05 Lier
60,Mechelsesteenweg 365,2023-08-17,10:00:00,132,82,50,FMN GV 05 Lier
60,Mechelsesteenweg 365,2023-08-17,11:00:00,134,66,68,FMN GV 05 Lier
60,Mechelsesteenweg 365,2023-08-17,12:00:00,148,84,64,FMN GV 05 Lier
60,Mechelsesteenweg 365,2023-08-17,13:00:00,162,76,86,FMN GV 05 Lier
60,Mechelsesteenweg 365,2023-08-17,14:00:00,326,138,188,FMN GV 05 Lier
60,Mechelsesteenweg 365,2023-08-17,15:00:00,206,104,102,FMN GV 05 Lier
60,Mechelsesteenweg 365,2023-08-17,16:00:00,234,116,118,FMN GV 05 Lier
60,Mechelsesteenweg 365,2023-08-17,17:00:00,246,160,86,FMN GV 05 Lier
60,Mechelsesteenweg 365,2023-08-17,18:00:00,196,128,68,FMN GV 05 Lier
60,Mechelsesteenweg 365,2023-08-17,19:00:00,208,126,82,FMN GV 05 Lier
60,Mechelsesteenweg 365,2023-08-17,20:00:00,184,90,94,FMN GV 05 Lier
60,Mechelsesteenweg 365,2023-08-17,21:00:00,40,14,26,FMN GV 05 Lier
60,Mechelsesteenweg 365,2023-08-17,22:00:00,10,2,8,FMN GV 05 Lier
60,Mechelsesteenweg 365,2023-08-17,23:00:00,32,0,32,FMN GV 05 Lier
60,Mechelsesteenweg 365,2023-08-18,00:00:00,8,4,4,FMN GV 05 Lier
60,Mechelsesteenweg 365,2023-08-18,01:00:00,0,0,0,FMN GV 05 Lier
60,Mechelsesteenweg 365,2023-08-18,02:00:00,0,0,0,FMN GV 05 Lier
60,Mechelsesteenweg 365,2023-08-18,03:00:00,2,0,2,FMN GV 05 Lier
60,Mechelsesteenweg 365,2023-08-18,04:00:00,2,0,2,FMN GV 05 Lier
60,Mechelsesteenweg 365,2023-08-18,05:00:00,10,6,4,FMN GV 05 Lier
60,Mechelsesteenweg 365,2023-08-18,06:00:00,32,14,18,FMN GV 05 Lier
60,Mechelsesteenweg 365,2023-08-18,07:00:00,74,20,54,FMN GV 05 Lier
60,Mechelsesteenweg 365,2023-08-18,08:00:00,82,28,54,FMN GV 05 Lier
60,Mechelsesteenweg 365,2023-08-18,09:00:00,94,44,50,FMN GV 05 Lier
60,Mechelsesteenweg 365,2023-08-18,10:00:00,128,74,54,FMN GV 05 Lier
60,Mechelsesteenweg 365,2023-08-18,11:00:00,166,88,78,FMN GV 05 Lier
60,Mechelsesteenweg 365,2023-08-18,12:00:00,172,66,106,FMN GV 05 Lier
60,Mechelsesteenweg 365,2023-08-18,13:00:00,200,114,86,FMN GV 05 Lier
60,Mechelsesteenweg 365,2023-08-18,14:00:00,236,134,102,FMN GV 05 Lier
60,Mechelsesteenweg 365,2023-08-18,15:00:00,250,126,124,FMN GV 05 Lier
60,Mechelsesteenweg 365,2023-08-18,16:00:00,304,158,146,FMN GV 05 Lier
60,Mechelsesteenweg 365,2023-08-18,17:00:00,256,136,120,FMN GV 05 Lier
60,Mechelsesteenweg 365,2023-08-18,18:00:00,154,74,80,FMN GV 05 Lier
60,Mechelsesteenweg 365,2023-08-18,19:00:00,142,66,76,FMN GV 05 Lier
60,Mechelsesteenweg 365,2023-08-18,20:00:00,86,50,36,FMN GV 05 Lier
60,Mechelsesteenweg 365,2023-08-18,21:00:00,56,20,36,FMN GV 05 Lier
60,Mechelsesteenweg 365,2023-08-18,22:00:00,20,10,10,FMN GV 05 Lier
60,Mechelsesteenweg 365,2023-08-18,23:00:00,6,4,2,FMN GV 05 Lier
60,Mechelsesteenweg 365,2023-08-19,00:00:00,8,8,0,FMN GV 05 Lier
60,Mechelsesteenweg 365,2023-08-19,01:00:00,14,12,2,FMN GV 05 Lier
60,Mechelsesteenweg 365,2023-08-19,02:00:00,0,0,0,FMN GV 05 Lier
60,Mechelsesteenweg 365,2023-08-19,03:00:00,0,0,0,FMN GV 05 Lier
60,Mechelsesteenweg 365,2023-08-19,04:00:00,0,0,0,FMN GV 05 Lier
60,Mechelsesteenweg 365,2023-08-19,05:00:00,8,2,6,FMN GV 05 Lier
60,Mechelsesteenweg 365,2023-08-19,06:00:00,8,4,4,FMN GV 05 Lier
60,Mechelsesteenweg 365,2023-08-19,07:00:00,34,14,20,FMN GV 05 Lier
60,Mechelsesteenweg 365,2023-08-19,08:00:00,40,18,22,FMN GV 05 Lier
60,Mechelsesteenweg 365,2023-08-19,09:00:00,168,104,64,FMN GV 05 Lier
60,Mechelsesteenweg 365,2023-08-19,10:00:00,208,130,78,FMN GV 05 Lier
60,Mechelsesteenweg 365,2023-08-19,11:00:00,206,86,120,FMN GV 05 Lier
60,Mechelsesteenweg 365,2023-08-19,12:00:00,180,82,98,FMN GV 05 Lier
60,Mechelsesteenweg 365,2023-08-19,13:00:00,198,104,94,FMN GV 05 Lier
60,Mechelsesteenweg 365,2023-08-19,14:00:00,224,132,92,FMN GV 05 Lier
60,Mechelsesteenweg 365,2023-08-19,15:00:00,234,116,118,FMN GV 05 Lier
60,Mechelsesteenweg 365,2023-08-19,16:00:00,258,112,146,FMN GV 05 Lier
60,Mechelsesteenweg 365,2023-08-19,17:00:00,208,110,98,FMN GV 05 Lier
60,Mechelsesteenweg 365,2023-08-19,18:00:00,106,44,62,FMN GV 05 Lier
60,Mechelsesteenweg 365,2023-08-19,19:00:00,102,58,44,FMN GV 05 Lier
60,Mechelsesteenweg 365,2023-08-19,20:00:00,102,50,52,FMN GV 05 Lier
60,Mechelsesteenweg 365,2023-08-19,21:00:00,52,20,32,FMN GV 05 Lier
60,Mechelsesteenweg 365,2023-08-19,22:00:00,26,2,24,FMN GV 05 Lier
60,Mechelsesteenweg 365,2023-08-19,23:00:00,12,4,8,FMN GV 05 Lier
60,Mechelsesteenweg 365,2023-08-20,00:00:00,6,6,0,FMN GV 05 Lier
60,Mechelsesteenweg 365,2023-08-20,01:00:00,10,10,0,FMN GV 05 Lier
60,Mechelsesteenweg 365,2023-08-20,02:00:00,2,0,2,FMN GV 05 Lier
60,Mechelsesteenweg 365,2023-08-20,03:00:00,2,0,2,FMN GV 05 Lier
60,Mechelsesteenweg 365,2023-08-20,04:00:00,2,0,2,FMN GV 05 Lier
60,Mechelsesteenweg 365,2023-08-20,05:00:00,2,2,0,FMN GV 05 Lier
60,Mechelsesteenweg 365,2023-08-20,06:00:00,8,6,2,FMN GV 05 Lier
60,Mechelsesteenweg 365,2023-08-20,07:00:00,36,24,12,FMN GV 05 Lier
60,Mechelsesteenweg 365,2023-08-20,08:00:00,76,40,36,FMN GV 05 Lier
60,Mechelsesteenweg 365,2023-08-20,09:00:00,436,276,160,FMN GV 05 Lier
60,Mechelsesteenweg 365,2023-08-20,10:00:00,508,294,214,FMN GV 05 Lier
60,Mechelsesteenweg 365,2023-08-20,11:00:00,590,268,322,FMN GV 05 Lier
60,Mechelsesteenweg 365,2023-08-20,12:00:00,426,218,208,FMN GV 05 Lier
60,Mechelsesteenweg 365,2023-08-20,13:00:00,376,174,202,FMN GV 05 Lier
60,Mechelsesteenweg 365,2023-08-20,14:00:00,394,192,202,FMN GV 05 Lier
60,Mechelsesteenweg 365,2023-08-20,15:00:00,466,212,254,FMN GV 05 Lier
60,Mechelsesteenweg 365,2023-08-20,16:00:00,478,202,276,FMN GV 05 Lier
60,Mechelsesteenweg 365,2023-08-20,17:00:00,308,106,202,FMN GV 05 Lier
60,Mechelsesteenweg 365,2023-08-20,18:00:00,160,70,90,FMN GV 05 Lier
60,Mechelsesteenweg 365,2023-08-20,19:00:00,136,56,80,FMN GV 05 Lier
60,Mechelsesteenweg 365,2023-08-20,20:00:00,154,52,102,FMN GV 05 Lier
60,Mechelsesteenweg 365,2023-08-20,21:00:00,44,6,38,FMN GV 05 Lier
60,Mechelsesteenweg 365,2023-08-20,22:00:00,8,4,4,FMN GV 05 Lier
60,Mechelsesteenweg 365,2023-08-20,23:00:00,8,6,2,FMN GV 05 Lier
60,Mechelsesteenweg 365,2023-08-21,00:00:00,10,8,2,FMN GV 05 Lier
60,Mechelsesteenweg 365,2023-08-21,01:00:00,2,2,0,FMN GV 05 Lier
60,Mechelsesteenweg 365,2023-08-21,02:00:00,0,0,0,FMN GV 05 Lier
60,Mechelsesteenweg 365,2023-08-21,03:00:00,2,0,2,FMN GV 05 Lier
60,Mechelsesteenweg 365,2023-08-21,04:00:00,2,0,2,FMN GV 05 Lier
60,Mechelsesteenweg 365,2023-08-21,05:00:00,10,2,8,FMN GV 05 Lier
60,Mechelsesteenweg 365,2023-08-21,06:00:00,48,22,26,FMN GV 05 Lier
60,Mechelsesteenweg 365,2023-08-21,07:00:00,110,34,76,FMN GV 05 Lier
60,Mechelsesteenweg 365,2023-08-21,08:00:00,114,40,74,FMN GV 05 Lier
60,Mechelsesteenweg 365,2023-08-21,09:00:00,98,44,54,FMN GV 05 Lier
60,Mechelsesteenweg 365,2023-08-21,10:00:00,178,90,88,FMN GV 05 Lier
60,Mechelsesteenweg 365,2023-08-21,11:00:00,198,114,84,FMN GV 05 Lier
60,Mechelsesteenweg 365,2023-08-21,12:00:00,188,82,106,FMN GV 05 Lier
60,Mechelsesteenweg 365,2023-08-21,13:00:00,232,116,116,FMN GV 05 Lier
60,Mechelsesteenweg 365,2023-08-21,14:00:00,224,130,94,FMN GV 05 Lier
60,Mechelsesteenweg 365,2023-08-21,15:00:00,234,124,110,FMN GV 05 Lier
60,Mechelsesteenweg 365,2023-08-21,16:00:00,310,170,140,FMN GV 05 Lier
60,Mechelsesteenweg 365,2023-08-21,17:00:00,248,154,94,FMN GV 05 Lier
60,Mechelsesteenweg 365,2023-08-21,18:00:00,178,90,88,FMN GV 05 Lier
60,Mechelsesteenweg 365,2023-08-21,19:00:00,182,82,100,FMN GV 05 Lier
60,Mechelsesteenweg 365,2023-08-21,20:00:00,160,62,98,FMN GV 05 Lier
60,Mechelsesteenweg 365,2023-08-21,21:00:00,64,32,32,FMN GV 05 Lier
60,Mechelsesteenweg 365,2023-08-21,22:00:00,4,2,2,FMN GV 05 Lier
60,Mechelsesteenweg 365,2023-08-21,23:00:00,12,8,4,FMN GV 05 Lier
60,Mechelsesteenweg 365,2023-08-22,00:00:00,8,6,2,FMN GV 05 Lier
60,Mechelsesteenweg 365,2023-08-22,01:00:00,4,4,0,FMN GV 05 Lier
60,Mechelsesteenweg 365,2023-08-22,02:00:00,0,0,0,FMN GV 05 Lier
60,Mechelsesteenweg 365,2023-08-22,03:00:00,0,0,0,FMN GV 05 Lier
60,Mechelsesteenweg 365,2023-08-22,04:00:00,0,0,0,FMN GV 05 Lier
60,Mechelsesteenweg 365,2023-08-22,05:00:00,6,4,2,FMN GV 05 Lier
60,Mechelsesteenweg 365,2023-08-22,06:00:00,50,20,30,FMN GV 05 Lier
60,Mechelsesteenweg 365,2023-08-22,07:00:00,114,28,86,FMN GV 05 Lier
60,Mechelsesteenweg 365,2023-08-22,08:00:00,164,60,104,FMN GV 05 Lier
60,Mechelsesteenweg 365,2023-08-22,09:00:00,170,96,74,FMN GV 05 Lier
60,Mechelsesteenweg 365,2023-08-22,10:00:00,312,140,172,FMN GV 05 Lier
60,Mechelsesteenweg 365,2023-08-22,11:00:00,230,134,96,FMN GV 05 Lier
60,Mechelsesteenweg 365,2023-08-22,12:00:00,292,150,142,FMN GV 05 Lier
60,Mechelsesteenweg 365,2023-08-22,13:00:00,242,138,104,FMN GV 05 Lier
60,Mechelsesteenweg 365,2023-08-22,14:00:00,382,210,172,FMN GV 05 Lier
60,Mechelsesteenweg 365,2023-08-22,15:00:00,278,172,106,FMN GV 05 Lier
60,Mechelsesteenweg 365,2023-08-22,16:00:00,306,168,138,FMN GV 05 Lier
60,Mechelsesteenweg 365,2023-08-22,17:00:00,304,180,124,FMN GV 05 Lier
60,Mechelsesteenweg 365,2023-08-22,18:00:00,182,100,82,FMN GV 05 Lier
60,Mechelsesteenweg 365,2023-08-22,19:00:00,188,110,78,FMN GV 05 Lier
60,Mechelsesteenweg 365,2023-08-22,20:00:00,194,76,118,FMN GV 05 Lier
60,Mechelsesteenweg 365,2023-08-22,21:00:00,44,16,28,FMN GV 05 Lier
60,Mechelsesteenweg 365,2023-08-22,22:00:00,24,12,12,FMN GV 05 Lier
60,Mechelsesteenweg 365,2023-08-22,23:00:00,16,8,8,FMN GV 05 Lier
60,Mechelsesteenweg 365,2023-08-23,00:00:00,4,4,0,FMN GV 05 Lier
60,Mechelsesteenweg 365,2023-08-23,01:00:00,2,2,0,FMN GV 05 Lier
60,Mechelsesteenweg 365,2023-08-23,02:00:00,0,0,0,FMN GV 05 Lier
60,Mechelsesteenweg 365,2023-08-23,03:00:00,0,0,0,FMN GV 05 Lier
60,Mechelsesteenweg 365,2023-08-23,04:00:00,0,0,0,FMN GV 05 Lier
60,Mechelsesteenweg 365,2023-08-23,05:00:00,12,4,8,FMN GV 05 Lier
60,Mechelsesteenweg 365,2023-08-23,06:00:00,50,14,36,FMN GV 05 Lier
60,Mechelsesteenweg 365,2023-08-23,07:00:00,116,34,82,FMN GV 05 Lier
60,Mechelsesteenweg 365,2023-08-23,08:00:00,116,42,74,FMN GV 05 Lier
60,Mechelsesteenweg 365,2023-08-23,09:00:00,108,62,46,FMN GV 05 Lier
60,Mechelsesteenweg 365,2023-08-23,10:00:00,206,88,118,FMN GV 05 Lier
60,Mechelsesteenweg 365,2023-08-23,11:00:00,278,122,156,FMN GV 05 Lier
60,Mechelsesteenweg 365,2023-08-23,12:00:00,180,96,84,FMN GV 05 Lier
60,Mechelsesteenweg 365,2023-08-23,13:00:00,238,112,126,FMN GV 05 Lier
60,Mechelsesteenweg 365,2023-08-23,14:00:00,346,190,156,FMN GV 05 Lier
60,Mechelsesteenweg 365,2023-08-23,15:00:00,298,136,162,FMN GV 05 Lier
60,Mechelsesteenweg 365,2023-08-23,16:00:00,408,228,180,FMN GV 05 Lier
60,Mechelsesteenweg 365,2023-08-23,17:00:00,294,162,132,FMN GV 05 Lier
60,Mechelsesteenweg 365,2023-08-23,18:00:00,268,112,156,FMN GV 05 Lier
60,Mechelsesteenweg 365,2023-08-23,19:00:00,296,146,150,FMN GV 05 Lier
60,Mechelsesteenweg 365,2023-08-23,20:00:00,328,160,168,FMN GV 05 Lier
60,Mechelsesteenweg 365,2023-08-23,21:00:00,82,50,32,FMN GV 05 Lier
60,Mechelsesteenweg 365,2023-08-23,22:00:00,20,12,8,FMN GV 05 Lier
60,Mechelsesteenweg 365,2023-08-23,23:00:00,14,8,6,FMN GV 05 Lier
60,Mechelsesteenweg 365,2023-08-24,00:00:00,10,6,4,FMN GV 05 Lier
60,Mechelsesteenweg 365,2023-08-24,01:00:00,0,0,0,FMN GV 05 Lier
60,Mechelsesteenweg 365,2023-08-24,02:00:00,2,2,0,FMN GV 05 Lier
60,Mechelsesteenweg 365,2023-08-24,03:00:00,2,0,2,FMN GV 05 Lier
60,Mechelsesteenweg 365,2023-08-24,04:00:00,0,0,0,FMN GV 05 Lier
60,Mechelsesteenweg 365,2023-08-24,05:00:00,6,2,4,FMN GV 05 Lier
60,Mechelsesteenweg 365,2023-08-24,06:00:00,34,12,22,FMN GV 05 Lier
60,Mechelsesteenweg 365,2023-08-24,07:00:00,92,18,74,FMN GV 05 Lier
60,Mechelsesteenweg 365,2023-08-24,08:00:00,124,50,74,FMN GV 05 Lier
60,Mechelsesteenweg 365,2023-08-24,09:00:00,94,46,48,FMN GV 05 Lier
60,Mechelsesteenweg 365,2023-08-24,10:00:00,132,72,60,FMN GV 05 Lier
60,Mechelsesteenweg 365,2023-08-24,11:00:00,124,64,60,FMN GV 05 Lier
60,Mechelsesteenweg 365,2023-08-24,12:00:00,44,30,14,FMN GV 05 Lier
60,Mechelsesteenweg 365,2023-08-24,13:00:00,50,28,22,FMN GV 05 Lier
60,Mechelsesteenweg 365,2023-08-24,14:00:00,104,50,54,FMN GV 05 Lier
60,Mechelsesteenweg 365,2023-08-24,15:00:00,86,60,26,FMN GV 05 Lier
60,Mechelsesteenweg 365,2023-08-24,16:00:00,118,72,46,FMN GV 05 Lier
60,Mechelsesteenweg 365,2023-08-24,17:00:00,158,114,44,FMN GV 05 Lier
60,Mechelsesteenweg 365,2023-08-24,18:00:00,112,70,42,FMN GV 05 Lier
60,Mechelsesteenweg 365,2023-08-24,19:00:00,114,50,64,FMN GV 05 Lier
60,Mechelsesteenweg 365,2023-08-24,20:00:00,172,74,98,FMN GV 05 Lier
60,Mechelsesteenweg 365,2023-08-24,21:00:00,36,12,24,FMN GV 05 Lier
60,Mechelsesteenweg 365,2023-08-24,22:00:00,36,12,24,FMN GV 05 Lier
60,Mechelsesteenweg 365,2023-08-24,23:00:00,14,14,0,FMN GV 05 Lier
60,Mechelsesteenweg 365,2023-08-25,00:00:00,22,16,6,FMN GV 05 Lier
60,Mechelsesteenweg 365,2023-08-25,01:00:00,16,12,4,FMN GV 05 Lier
60,Mechelsesteenweg 365,2023-08-25,02:00:00,0,0,0,FMN GV 05 Lier
60,Mechelsesteenweg 365,2023-08-25,03:00:00,2,0,2,FMN GV 05 Lier
60,Mechelsesteenweg 365,2023-08-25,04:00:00,0,0,0,FMN GV 05 Lier
60,Mechelsesteenweg 365,2023-08-25,05:00:00,2,2,0,FMN GV 05 Lier
60,Mechelsesteenweg 365,2023-08-25,06:00:00,22,12,10,FMN GV 05 Lier
60,Mechelsesteenweg 365,2023-08-25,07:00:00,46,10,36,FMN GV 05 Lier
60,Mechelsesteenweg 365,2023-08-25,08:00:00,32,8,24,FMN GV 05 Lier
60,Mechelsesteenweg 365,2023-08-25,09:00:00,20,10,10,FMN GV 05 Lier
60,Mechelsesteenweg 365,2023-08-25,10:00:00,24,16,8,FMN GV 05 Lier
60,Mechelsesteenweg 365,2023-08-25,11:00:00,48,40,8,FMN GV 05 Lier
60,Mechelsesteenweg 365,2023-08-25,12:00:00,46,24,22,FMN GV 05 Lier
60,Mechelsesteenweg 365,2023-08-25,13:00:00,86,48,38,FMN GV 05 Lier
60,Mechelsesteenweg 365,2023-08-25,14:00:00,140,78,62,FMN GV 05 Lier
60,Mechelsesteenweg 365,2023-08-25,15:00:00,126,70,56,FMN GV 05 Lier
60,Mechelsesteenweg 365,2023-08-25,16:00:00,120,72,48,FMN GV 05 Lier
60,Mechelsesteenweg 365,2023-08-25,17:00:00,82,54,28,FMN GV 05 Lier
60,Mechelsesteenweg 365,2023-08-25,18:00:00,24,8,16,FMN GV 05 Lier
60,Mechelsesteenweg 365,2023-08-25,19:00:00,36,22,14,FMN GV 05 Lier
60,Mechelsesteenweg 365,2023-08-25,20:00:00,26,8,18,FMN GV 05 Lier
60,Mechelsesteenweg 365,2023-08-25,21:00:00,16,6,10,FMN GV 05 Lier
60,Mechelsesteenweg 365,2023-08-25,22:00:00,14,8,6,FMN GV 05 Lier
60,Mechelsesteenweg 365,2023-08-25,23:00:00,0,0,0,FMN GV 05 Lier
60,Mechelsesteenweg 365,2023-08-26,00:00:00,0,0,0,FMN GV 05 Lier
60,Mechelsesteenweg 365,2023-08-26,01:00:00,16,14,2,FMN GV 05 Lier
60,Mechelsesteenweg 365,2023-08-26,02:00:00,2,2,0,FMN GV 05 Lier
60,Mechelsesteenweg 365,2023-08-26,03:00:00,0,0,0,FMN GV 05 Lier
60,Mechelsesteenweg 365,2023-08-26,04:00:00,2,2,0,FMN GV 05 Lier
60,Mechelsesteenweg 365,2023-08-26,05:00:00,4,2,2,FMN GV 05 Lier
60,Mechelsesteenweg 365,2023-08-26,06:00:00,6,2,4,FMN GV 05 Lier
60,Mechelsesteenweg 365,2023-08-26,07:00:00,16,6,10,FMN GV 05 Lier
60,Mechelsesteenweg 365,2023-08-26,08:00:00,40,20,20,FMN GV 05 Lier
60,Mechelsesteenweg 365,2023-08-26,09:00:00,132,66,66,FMN GV 05 Lier
60,Mechelsesteenweg 365,2023-08-26,10:00:00,230,136,94,FMN GV 05 Lier
60,Mechelsesteenweg 365,2023-08-26,11:00:00,300,140,160,FMN GV 05 Lier
60,Mechelsesteenweg 365,2023-08-26,12:00:00,180,72,108,FMN GV 05 Lier
60,Mechelsesteenweg 365,2023-08-26,13:00:00,180,106,74,FMN GV 05 Lier
60,Mechelsesteenweg 365,2023-08-26,14:00:00,180,112,68,FMN GV 05 Lier
60,Mechelsesteenweg 365,2023-08-26,15:00:00,268,124,144,FMN GV 05 Lier
60,Mechelsesteenweg 365,2023-08-26,16:00:00,218,98,120,FMN GV 05 Lier
60,Mechelsesteenweg 365,2023-08-26,17:00:00,62,28,34,FMN GV 05 Lier
60,Mechelsesteenweg 365,2023-08-26,18:00:00,46,28,18,FMN GV 05 Lier
60,Mechelsesteenweg 365,2023-08-26,19:00:00,46,18,28,FMN GV 05 Lier
60,Mechelsesteenweg 365,2023-08-26,20:00:00,60,14,46,FMN GV 05 Lier
60,Mechelsesteenweg 365,2023-08-26,21:00:00,14,6,8,FMN GV 05 Lier
60,Mechelsesteenweg 365,2023-08-26,22:00:00,8,0,8,FMN GV 05 Lier
60,Mechelsesteenweg 365,2023-08-26,23:00:00,26,6,20,FMN GV 05 Lier
60,Mechelsesteenweg 365,2023-08-27,00:00:00,2,2,0,FMN GV 05 Lier
60,Mechelsesteenweg 365,2023-08-27,01:00:00,32,24,8,FMN GV 05 Lier
60,Mechelsesteenweg 365,2023-08-27,02:00:00,6,6,0,FMN GV 05 Lier
60,Mechelsesteenweg 365,2023-08-27,03:00:00,8,8,0,FMN GV 05 Lier
60,Mechelsesteenweg 365,2023-08-27,04:00:00,2,0,2,FMN GV 05 Lier
60,Mechelsesteenweg 365,2023-08-27,05:00:00,2,0,2,FMN GV 05 Lier
60,Mechelsesteenweg 365,2023-08-27,06:00:00,8,2,6,FMN GV 05 Lier
60,Mechelsesteenweg 365,2023-08-27,07:00:00,16,4,12,FMN GV 05 Lier
60,Mechelsesteenweg 365,2023-08-27,08:00:00,56,32,24,FMN GV 05 Lier
60,Mechelsesteenweg 365,2023-08-27,09:00:00,190,126,64,FMN GV 05 Lier
60,Mechelsesteenweg 365,2023-08-27,10:00:00,390,214,176,FMN GV 05 Lier
60,Mechelsesteenweg 365,2023-08-27,11:00:00,388,190,198,FMN GV 05 Lier
60,Mechelsesteenweg 365,2023-08-27,12:00:00,244,128,116,FMN GV 05 Lier
60,Mechelsesteenweg 365,2023-08-27,13:00:00,148,78,70,FMN GV 05 Lier
60,Mechelsesteenweg 365,2023-08-27,14:00:00,68,24,44,FMN GV 05 Lier
60,Mechelsesteenweg 365,2023-08-27,15:00:00,226,90,136,FMN GV 05 Lier
60,Mechelsesteenweg 365,2023-08-27,16:00:00,80,30,50,FMN GV 05 Lier
60,Mechelsesteenweg 365,2023-08-27,17:00:00,94,34,60,FMN GV 05 Lier
60,Mechelsesteenweg 365,2023-08-27,18:00:00,82,40,42,FMN GV 05 Lier
60,Mechelsesteenweg 365,2023-08-27,19:00:00,74,34,40,FMN GV 05 Lier
60,Mechelsesteenweg 365,2023-08-27,20:00:00,42,8,34,FMN GV 05 Lier
60,Mechelsesteenweg 365,2023-08-27,21:00:00,50,6,44,FMN GV 05 Lier
60,Mechelsesteenweg 365,2023-08-27,22:00:00,24,10,14,FMN GV 05 Lier
60,Mechelsesteenweg 365,2023-08-27,23:00:00,26,16,10,FMN GV 05 Lier
60,Mechelsesteenweg 365,2023-08-28,00:00:00,20,18,2,FMN GV 05 Lier
60,Mechelsesteenweg 365,2023-08-28,01:00:00,0,0,0,FMN GV 05 Lier
60,Mechelsesteenweg 365,2023-08-28,02:00:00,2,2,0,FMN GV 05 Lier
60,Mechelsesteenweg 365,2023-08-28,03:00:00,2,0,2,FMN GV 05 Lier
60,Mechelsesteenweg 365,2023-08-28,04:00:00,4,0,4,FMN GV 05 Lier
60,Mechelsesteenweg 365,2023-08-28,05:00:00,4,0,4,FMN GV 05 Lier
60,Mechelsesteenweg 365,2023-08-28,06:00:00,34,14,20,FMN GV 05 Lier
60,Mechelsesteenweg 365,2023-08-28,07:00:00,84,18,66,FMN GV 05 Lier
60,Mechelsesteenweg 365,2023-08-28,08:00:00,118,38,80,FMN GV 05 Lier
60,Mechelsesteenweg 365,2023-08-28,09:00:00,74,32,42,FMN GV 05 Lier
60,Mechelsesteenweg 365,2023-08-28,10:00:00,110,56,54,FMN GV 05 Lier
60,Mechelsesteenweg 365,2023-08-28,11:00:00,128,64,64,FMN GV 05 Lier
60,Mechelsesteenweg 365,2023-08-28,12:00:00,98,50,48,FMN GV 05 Lier
60,Mechelsesteenweg 365,2023-08-28,13:00:00,118,66,52,FMN GV 05 Lier
60,Mechelsesteenweg 365,2023-08-28,14:00:00,158,98,60,FMN GV 05 Lier
60,Mechelsesteenweg 365,2023-08-28,15:00:00,172,96,76,FMN GV 05 Lier
60,Mechelsesteenweg 365,2023-08-28,16:00:00,162,78,84,FMN GV 05 Lier
60,Mechelsesteenweg 365,2023-08-28,17:00:00,154,102,52,FMN GV 05 Lier
60,Mechelsesteenweg 365,2023-08-28,18:00:00,62,36,26,FMN GV 05 Lier
60,Mechelsesteenweg 365,2023-08-28,19:00:00,16,12,4,FMN GV 05 Lier
60,Mechelsesteenweg 365,2023-08-28,20:00:00,22,8,14,FMN GV 05 Lier
60,Mechelsesteenweg 365,2023-08-28,21:00:00,6,4,2,FMN GV 05 Lier
60,Mechelsesteenweg 365,2023-08-28,22:00:00,8,8,0,FMN GV 05 Lier
60,Mechelsesteenweg 365,2023-08-28,23:00:00,4,0,4,FMN GV 05 Lier
60,Mechelsesteenweg 365,2023-08-29,00:00:00,0,0,0,FMN GV 05 Lier
60,Mechelsesteenweg 365,2023-08-29,01:00:00,0,0,0,FMN GV 05 Lier
60,Mechelsesteenweg 365,2023-08-29,02:00:00,0,0,0,FMN GV 05 Lier
60,Mechelsesteenweg 365,2023-08-29,03:00:00,2,0,2,FMN GV 05 Lier
60,Mechelsesteenweg 365,2023-08-29,04:00:00,2,0,2,FMN GV 05 Lier
60,Mechelsesteenweg 365,2023-08-29,05:00:00,8,2,6,FMN GV 05 Lier
60,Mechelsesteenweg 365,2023-08-29,06:00:00,30,6,24,FMN GV 05 Lier
60,Mechelsesteenweg 365,2023-08-29,07:00:00,126,18,108,FMN GV 05 Lier
60,Mechelsesteenweg 365,2023-08-29,08:00:00,116,32,84,FMN GV 05 Lier
60,Mechelsesteenweg 365,2023-08-29,09:00:00,108,60,48,FMN GV 05 Lier
60,Mechelsesteenweg 365,2023-08-29,10:00:00,140,88,52,FMN GV 05 Lier
60,Mechelsesteenweg 365,2023-08-29,11:00:00,124,74,50,FMN GV 05 Lier
60,Mechelsesteenweg 365,2023-08-29,12:00:00,180,80,100,FMN GV 05 Lier
60,Mechelsesteenweg 365,2023-08-29,13:00:00,250,126,124,FMN GV 05 Lier
60,Mechelsesteenweg 365,2023-08-29,14:00:00,210,110,100,FMN GV 05 Lier
60,Mechelsesteenweg 365,2023-08-29,15:00:00,170,90,80,FMN GV 05 Lier
60,Mechelsesteenweg 365,2023-08-29,16:00:00,232,126,106,FMN GV 05 Lier
60,Mechelsesteenweg 365,2023-08-29,17:00:00,162,106,56,FMN GV 05 Lier
60,Mechelsesteenweg 365,2023-08-29,18:00:00,158,96,62,FMN GV 05 Lier
60,Mechelsesteenweg 365,2023-08-29,19:00:00,108,62,46,FMN GV 05 Lier
60,Mechelsesteenweg 365,2023-08-29,20:00:00,76,26,50,FMN GV 05 Lier
60,Mechelsesteenweg 365,2023-08-29,21:00:00,22,10,12,FMN GV 05 Lier
60,Mechelsesteenweg 365,2023-08-29,22:00:00,12,6,6,FMN GV 05 Lier
60,Mechelsesteenweg 365,2023-08-29,23:00:00,10,4,6,FMN GV 05 Lier
60,Mechelsesteenweg 365,2023-08-30,00:00:00,0,0,0,FMN GV 05 Lier
60,Mechelsesteenweg 365,2023-08-30,01:00:00,0,0,0,FMN GV 05 Lier
60,Mechelsesteenweg 365,2023-08-30,02:00:00,0,0,0,FMN GV 05 Lier
60,Mechelsesteenweg 365,2023-08-30,03:00:00,2,0,2,FMN GV 05 Lier
60,Mechelsesteenweg 365,2023-08-30,04:00:00,6,2,4,FMN GV 05 Lier
60,Mechelsesteenweg 365,2023-08-30,05:00:00,2,0,2,FMN GV 05 Lier
60,Mechelsesteenweg 365,2023-08-30,06:00:00,30,10,20,FMN GV 05 Lier
60,Mechelsesteenweg 365,2023-08-30,07:00:00,44,12,32,FMN GV 05 Lier
60,Mechelsesteenweg 365,2023-08-30,08:00:00,70,28,42,FMN GV 05 Lier
60,Mechelsesteenweg 365,2023-08-30,09:00:00,12,6,6,FMN GV 05 Lier
60,Mechelsesteenweg 365,2023-08-30,10:00:00,18,6,12,FMN GV 05 Lier
60,Mechelsesteenweg 365,2023-08-30,11:00:00,20,12,8,FMN GV 05 Lier
60,Mechelsesteenweg 365,2023-08-30,12:00:00,56,30,26,FMN GV 05 Lier
60,Mechelsesteenweg 365,2023-08-30,13:00:00,70,30,40,FMN GV 05 Lier
60,Mechelsesteenweg 365,2023-08-30,14:00:00,126,64,62,FMN GV 05 Lier
60,Mechelsesteenweg 365,2023-08-30,15:00:00,166,98,68,FMN GV 05 Lier
60,Mechelsesteenweg 365,2023-08-30,16:00:00,174,88,86,FMN GV 05 Lier
60,Mechelsesteenweg 365,2023-08-30,17:00:00,172,96,76,FMN GV 05 Lier
60,Mechelsesteenweg 365,2023-08-30,18:00:00,120,60,60,FMN GV 05 Lier
60,Mechelsesteenweg 365,2023-08-30,19:00:00,112,60,52,FMN GV 05 Lier
60,Mechelsesteenweg 365,2023-08-30,20:00:00,124,96,28,FMN GV 05 Lier
60,Mechelsesteenweg 365,2023-08-30,21:00:00,18,12,6,FMN GV 05 Lier
60,Mechelsesteenweg 365,2023-08-30,22:00:00,12,10,2,FMN GV 05 Lier
60,Mechelsesteenweg 365,2023-08-30,23:00:00,0,0,0,FMN GV 05 Lier
60,Mechelsesteenweg 365,2023-08-31,00:00:00,2,0,2,FMN GV 05 Lier
60,Mechelsesteenweg 365,2023-08-31,01:00:00,4,2,2,FMN GV 05 Lier
60,Mechelsesteenweg 365,2023-08-31,02:00:00,0,0,0,FMN GV 05 Lier
60,Mechelsesteenweg 365,2023-08-31,03:00:00,0,0,0,FMN GV 05 Lier
60,Mechelsesteenweg 365,2023-08-31,04:00:00,2,0,2,FMN GV 05 Lier
60,Mechelsesteenweg 365,2023-08-31,05:00:00,4,2,2,FMN GV 05 Lier
60,Mechelsesteenweg 365,2023-08-31,06:00:00,28,12,16,FMN GV 05 Lier
60,Mechelsesteenweg 365,2023-08-31,07:00:00,104,28,76,FMN GV 05 Lier
60,Mechelsesteenweg 365,2023-08-31,08:00:00,146,54,92,FMN GV 05 Lier
60,Mechelsesteenweg 365,2023-08-31,09:00:00,156,80,76,FMN GV 05 Lier
60,Mechelsesteenweg 365,2023-08-31,10:00:00,210,132,78,FMN GV 05 Lier
60,Mechelsesteenweg 365,2023-08-31,11:00:00,194,90,104,FMN GV 05 Lier
60,Mechelsesteenweg 365,2023-08-31,12:00:00,216,142,74,FMN GV 05 Lier
60,Mechelsesteenweg 365,2023-08-31,13:00:00,198,90,108,FMN GV 05 Lier
60,Mechelsesteenweg 365,2023-08-31,14:00:00,266,156,110,FMN GV 05 Lier
60,Mechelsesteenweg 365,2023-08-31,15:00:00,214,114,100,FMN GV 05 Lier
60,Mechelsesteenweg 365,2023-08-31,16:00:00,176,100,76,FMN GV 05 Lier
60,Mechelsesteenweg 365,2023-08-31,17:00:00,204,116,88,FMN GV 05 Lier
60,Mechelsesteenweg 365,2023-08-31,18:00:00,128,58,70,FMN GV 05 Lier
60,Mechelsesteenweg 365,2023-08-31,19:00:00,112,78,34,FMN GV 05 Lier
60,Mechelsesteenweg 365,2023-08-31,20:00:00,116,44,72,FMN GV 05 Lier
60,Mechelsesteenweg 365,2023-08-31,21:00:00,10,4,6,FMN GV 05 Lier
60,Mechelsesteenweg 365,2023-08-31,22:00:00,14,8,6,FMN GV 05 Lier
60,Mechelsesteenweg 365,2023-08-31,23:00:00,6,6,0,FMN GV 05 Lier
60,Mechelsesteenweg 365,2023-09-01,00:00:00,2,0,2,FMN GV 05 Lier
60,Mechelsesteenweg 365,2023-09-01,01:00:00,0,0,0,FMN GV 05 Lier
60,Mechelsesteenweg 365,2023-09-01,02:00:00,0,0,0,FMN GV 05 Lier
60,Mechelsesteenweg 365,2023-09-01,03:00:00,2,0,2,FMN GV 05 Lier
60,Mechelsesteenweg 365,2023-09-01,04:00:00,2,0,2,FMN GV 05 Lier
60,Mechelsesteenweg 365,2023-09-01,05:00:00,2,0,2,FMN GV 05 Lier
60,Mechelsesteenweg 365,2023-09-01,06:00:00,10,2,8,FMN GV 05 Lier
60,Mechelsesteenweg 365,2023-09-01,07:00:00,84,46,38,FMN GV 05 Lier
60,Mechelsesteenweg 365,2023-09-01,08:00:00,116,76,40,FMN GV 05 Lier
60,Mechelsesteenweg 365,2023-09-01,09:00:00,26,10,16,FMN GV 05 Lier
60,Mechelsesteenweg 365,2023-09-01,10:00:00,18,12,6,FMN GV 05 Lier
60,Mechelsesteenweg 365,2023-09-01,11:00:00,10,4,6,FMN GV 05 Lier
60,Mechelsesteenweg 365,2023-09-01,12:00:00,82,2,80,FMN GV 05 Lier
60,Mechelsesteenweg 365,2023-09-01,13:00:00,46,14,32,FMN GV 05 Lier
60,Mechelsesteenweg 365,2023-09-01,14:00:00,56,26,30,FMN GV 05 Lier
60,Mechelsesteenweg 365,2023-09-01,15:00:00,94,52,42,FMN GV 05 Lier
60,Mechelsesteenweg 365,2023-09-01,16:00:00,102,52,50,FMN GV 05 Lier
60,Mechelsesteenweg 365,2023-09-01,17:00:00,92,64,28,FMN GV 05 Lier
60,Mechelsesteenweg 365,2023-09-01,18:00:00,74,42,32,FMN GV 05 Lier
60,Mechelsesteenweg 365,2023-09-01,19:00:00,82,34,48,FMN GV 05 Lier
60,Mechelsesteenweg 365,2023-09-01,20:00:00,38,8,30,FMN GV 05 Lier
60,Mechelsesteenweg 365,2023-09-01,21:00:00,10,6,4,FMN GV 05 Lier
60,Mechelsesteenweg 365,2023-09-01,22:00:00,6,2,4,FMN GV 05 Lier
60,Mechelsesteenweg 365,2023-09-01,23:00:00,2,0,2,FMN GV 05 Lier
60,Mechelsesteenweg 365,2023-09-02,00:00:00,8,0,8,FMN GV 05 Lier
60,Mechelsesteenweg 365,2023-09-02,01:00:00,0,0,0,FMN GV 05 Lier
60,Mechelsesteenweg 365,2023-09-02,02:00:00,2,0,2,FMN GV 05 Lier
60,Mechelsesteenweg 365,2023-09-02,03:00:00,2,2,0,FMN GV 05 Lier
60,Mechelsesteenweg 365,2023-09-02,04:00:00,0,0,0,FMN GV 05 Lier
60,Mechelsesteenweg 365,2023-09-02,05:00:00,4,0,4,FMN GV 05 Lier
60,Mechelsesteenweg 365,2023-09-02,06:00:00,12,4,8,FMN GV 05 Lier
60,Mechelsesteenweg 365,2023-09-02,07:00:00,24,18,6,FMN GV 05 Lier
60,Mechelsesteenweg 365,2023-09-02,08:00:00,46,28,18,FMN GV 05 Lier
60,Mechelsesteenweg 365,2023-09-02,09:00:00,116,52,64,FMN GV 05 Lier
60,Mechelsesteenweg 365,2023-09-02,10:00:00,164,70,94,FMN GV 05 Lier
60,Mechelsesteenweg 365,2023-09-02,11:00:00,238,130,108,FMN GV 05 Lier
60,Mechelsesteenweg 365,2023-09-02,12:00:00,232,106,126,FMN GV 05 Lier
60,Mechelsesteenweg 365,2023-09-02,13:00:00,230,122,108,FMN GV 05 Lier
60,Mechelsesteenweg 365,2023-09-02,14:00:00,368,218,150,FMN GV 05 Lier
60,Mechelsesteenweg 365,2023-09-02,15:00:00,416,176,240,FMN GV 05 Lier
60,Mechelsesteenweg 365,2023-09-02,16:00:00,240,114,126,FMN GV 05 Lier
60,Mechelsesteenweg 365,2023-09-02,17:00:00,138,68,70,FMN GV 05 Lier
60,Mechelsesteenweg 365,2023-09-02,18:00:00,128,68,60,FMN GV 05 Lier
60,Mechelsesteenweg 365,2023-09-02,19:00:00,76,36,40,FMN GV 05 Lier
60,Mechelsesteenweg 365,2023-09-02,20:00:00,54,26,28,FMN GV 05 Lier
60,Mechelsesteenweg 365,2023-09-02,21:00:00,16,8,8,FMN GV 05 Lier
60,Mechelsesteenweg 365,2023-09-02,22:00:00,28,6,22,FMN GV 05 Lier
60,Mechelsesteenweg 365,2023-09-02,23:00:00,12,8,4,FMN GV 05 Lier
60,Mechelsesteenweg 365,2023-09-03,00:00:00,4,2,2,FMN GV 05 Lier
60,Mechelsesteenweg 365,2023-09-03,01:00:00,6,0,6,FMN GV 05 Lier
60,Mechelsesteenweg 365,2023-09-03,02:00:00,6,4,2,FMN GV 05 Lier
60,Mechelsesteenweg 365,2023-09-03,03:00:00,6,6,0,FMN GV 05 Lier
60,Mechelsesteenweg 365,2023-09-03,04:00:00,2,2,0,FMN GV 05 Lier
60,Mechelsesteenweg 365,2023-09-03,05:00:00,0,0,0,FMN GV 05 Lier
60,Mechelsesteenweg 365,2023-09-03,06:00:00,4,2,2,FMN GV 05 Lier
60,Mechelsesteenweg 365,2023-09-03,07:00:00,28,8,20,FMN GV 05 Lier
60,Mechelsesteenweg 365,2023-09-03,08:00:00,80,34,46,FMN GV 05 Lier
60,Mechelsesteenweg 365,2023-09-03,09:00:00,204,126,78,FMN GV 05 Lier
60,Mechelsesteenweg 365,2023-09-03,10:00:00,522,250,272,FMN GV 05 Lier
60,Mechelsesteenweg 365,2023-09-03,11:00:00,614,240,374,FMN GV 05 Lier
60,Mechelsesteenweg 365,2023-09-03,12:00:00,414,202,212,FMN GV 05 Lier
60,Mechelsesteenweg 365,2023-09-03,13:00:00,384,204,180,FMN GV 05 Lier
60,Mechelsesteenweg 365,2023-09-03,14:00:00,526,288,238,FMN GV 05 Lier
60,Mechelsesteenweg 365,2023-09-03,15:00:00,524,228,296,FMN GV 05 Lier
60,Mechelsesteenweg 365,2023-09-03,16:00:00,558,228,330,FMN GV 05 Lier
60,Mechelsesteenweg 365,2023-09-03,17:00:00,258,76,182,FMN GV 05 Lier
60,Mechelsesteenweg 365,2023-09-03,18:00:00,228,98,130,FMN GV 05 Lier
60,Mechelsesteenweg 365,2023-09-03,19:00:00,130,70,60,FMN GV 05 Lier
60,Mechelsesteenweg 365,2023-09-03,20:00:00,74,30,44,FMN GV 05 Lier
60,Mechelsesteenweg 365,2023-09-03,21:00:00,20,6,14,FMN GV 05 Lier
60,Mechelsesteenweg 365,2023-09-03,22:00:00,10,10,0,FMN GV 05 Lier
60,Mechelsesteenweg 365,2023-09-03,23:00:00,4,0,4,FMN GV 05 Lier
60,Mechelsesteenweg 365,2023-09-04,00:00:00,2,0,2,FMN GV 05 Lier
60,Mechelsesteenweg 365,2023-09-04,01:00:00,0,0,0,FMN GV 05 Lier
60,Mechelsesteenweg 365,2023-09-04,02:00:00,0,0,0,FMN GV 05 Lier
60,Mechelsesteenweg 365,2023-09-04,03:00:00,4,0,4,FMN GV 05 Lier
60,Mechelsesteenweg 365,2023-09-04,04:00:00,2,0,2,FMN GV 05 Lier
60,Mechelsesteenweg 365,2023-09-04,05:00:00,12,2,10,FMN GV 05 Lier
60,Mechelsesteenweg 365,2023-09-04,06:00:00,46,16,30,FMN GV 05 Lier
60,Mechelsesteenweg 365,2023-09-04,07:00:00,252,118,134,FMN GV 05 Lier
60,Mechelsesteenweg 365,2023-09-04,08:00:00,264,154,110,FMN GV 05 Lier
60,Mechelsesteenweg 365,2023-09-04,09:00:00,74,44,30,FMN GV 05 Lier
60,Mechelsesteenweg 365,2023-09-04,10:00:00,118,60,58,FMN GV 05 Lier
60,Mechelsesteenweg 365,2023-09-04,11:00:00,140,60,80,FMN GV 05 Lier
60,Mechelsesteenweg 365,2023-09-04,12:00:00,188,92,96,FMN GV 05 Lier
60,Mechelsesteenweg 365,2023-09-04,13:00:00,218,116,102,FMN GV 05 Lier
60,Mechelsesteenweg 365,2023-09-04,14:00:00,304,134,170,FMN GV 05 Lier
60,Mechelsesteenweg 365,2023-09-04,15:00:00,352,166,186,FMN GV 05 Lier
60,Mechelsesteenweg 365,2023-09-04,16:00:00,516,192,324,FMN GV 05 Lier
60,Mechelsesteenweg 365,2023-09-04,17:00:00,254,146,108,FMN GV 05 Lier
60,Mechelsesteenweg 365,2023-09-04,18:00:00,198,112,86,FMN GV 05 Lier
60,Mechelsesteenweg 365,2023-09-04,19:00:00,180,84,96,FMN GV 05 Lier
60,Mechelsesteenweg 365,2023-09-04,20:00:00,102,40,62,FMN GV 05 Lier
60,Mechelsesteenweg 365,2023-09-04,21:00:00,16,6,10,FMN GV 05 Lier
60,Mechelsesteenweg 365,2023-09-04,22:00:00,12,0,12,FMN GV 05 Lier
60,Mechelsesteenweg 365,2023-09-04,23:00:00,6,0,6,FMN GV 05 Lier
60,Mechelsesteenweg 365,2023-09-05,00:00:00,2,0,2,FMN GV 05 Lier
60,Mechelsesteenweg 365,2023-09-05,01:00:00,0,0,0,FMN GV 05 Lier
60,Mechelsesteenweg 365,2023-09-05,02:00:00,0,0,0,FMN GV 05 Lier
60,Mechelsesteenweg 365,2023-09-05,03:00:00,2,0,2,FMN GV 05 Lier
60,Mechelsesteenweg 365,2023-09-05,04:00:00,2,0,2,FMN GV 05 Lier
60,Mechelsesteenweg 365,2023-09-05,05:00:00,6,4,2,FMN GV 05 Lier
60,Mechelsesteenweg 365,2023-09-05,06:00:00,54,22,32,FMN GV 05 Lier
60,Mechelsesteenweg 365,2023-09-05,07:00:00,292,148,144,FMN GV 05 Lier
60,Mechelsesteenweg 365,2023-09-05,08:00:00,266,144,122,FMN GV 05 Lier
60,Mechelsesteenweg 365,2023-09-05,09:00:00,166,64,102,FMN GV 05 Lier
60,Mechelsesteenweg 365,2023-09-05,10:00:00,234,128,106,FMN GV 05 Lier
60,Mechelsesteenweg 365,2023-09-05,11:00:00,256,112,144,FMN GV 05 Lier
60,Mechelsesteenweg 365,2023-09-05,12:00:00,184,88,96,FMN GV 05 Lier
60,Mechelsesteenweg 365,2023-09-05,13:00:00,240,110,130,FMN GV 05 Lier
60,Mechelsesteenweg 365,2023-09-05,14:00:00,330,152,178,FMN GV 05 Lier
60,Mechelsesteenweg 365,2023-09-05,15:00:00,320,136,184,FMN GV 05 Lier
60,Mechelsesteenweg 365,2023-09-05,16:00:00,508,202,306,FMN GV 05 Lier
60,Mechelsesteenweg 365,2023-09-05,17:00:00,308,174,134,FMN GV 05 Lier
60,Mechelsesteenweg 365,2023-09-05,18:00:00,202,104,98,FMN GV 05 Lier
60,Mechelsesteenweg 365,2023-09-05,19:00:00,214,76,138,FMN GV 05 Lier
60,Mechelsesteenweg 365,2023-09-05,20:00:00,116,50,66,FMN GV 05 Lier
60,Mechelsesteenweg 365,2023-09-05,21:00:00,16,6,10,FMN GV 05 Lier
60,Mechelsesteenweg 365,2023-09-05,22:00:00,6,6,0,FMN GV 05 Lier
60,Mechelsesteenweg 365,2023-09-05,23:00:00,10,4,6,FMN GV 05 Lier
60,Mechelsesteenweg 365,2023-09-06,00:00:00,0,0,0,FMN GV 05 Lier
60,Mechelsesteenweg 365,2023-09-06,01:00:00,2,2,0,FMN GV 05 Lier
60,Mechelsesteenweg 365,2023-09-06,02:00:00,8,2,6,FMN GV 05 Lier
60,Mechelsesteenweg 365,2023-09-06,03:00:00,4,0,4,FMN GV 05 Lier
60,Mechelsesteenweg 365,2023-09-06,04:00:00,4,0,4,FMN GV 05 Lier
60,Mechelsesteenweg 365,2023-09-06,05:00:00,12,6,6,FMN GV 05 Lier
60,Mechelsesteenweg 365,2023-09-06,06:00:00,46,14,32,FMN GV 05 Lier
60,Mechelsesteenweg 365,2023-09-06,07:00:00,268,140,128,FMN GV 05 Lier
60,Mechelsesteenweg 365,2023-09-06,08:00:00,262,140,122,FMN GV 05 Lier
60,Mechelsesteenweg 365,2023-09-06,09:00:00,162,80,82,FMN GV 05 Lier
60,Mechelsesteenweg 365,2023-09-06,10:00:00,202,82,120,FMN GV 05 Lier
60,Mechelsesteenweg 365,2023-09-06,11:00:00,230,96,134,FMN GV 05 Lier
60,Mechelsesteenweg 365,2023-09-06,12:00:00,362,106,256,FMN GV 05 Lier
60,Mechelsesteenweg 365,2023-09-06,13:00:00,246,94,152,FMN GV 05 Lier
60,Mechelsesteenweg 365,2023-09-06,14:00:00,272,134,138,FMN GV 05 Lier
60,Mechelsesteenweg 365,2023-09-06,15:00:00,268,120,148,FMN GV 05 Lier
60,Mechelsesteenweg 365,2023-09-06,16:00:00,346,188,158,FMN GV 05 Lier
60,Mechelsesteenweg 365,2023-09-06,17:00:00,240,138,102,FMN GV 05 Lier
60,Mechelsesteenweg 365,2023-09-06,18:00:00,228,136,92,FMN GV 05 Lier
60,Mechelsesteenweg 365,2023-09-06,19:00:00,276,124,152,FMN GV 05 Lier
60,Mechelsesteenweg 365,2023-09-06,20:00:00,202,112,90,FMN GV 05 Lier
60,Mechelsesteenweg 365,2023-09-06,21:00:00,34,12,22,FMN GV 05 Lier
60,Mechelsesteenweg 365,2023-09-06,22:00:00,14,6,8,FMN GV 05 Lier
60,Mechelsesteenweg 365,2023-09-06,23:00:00,4,2,2,FMN GV 05 Lier
60,Mechelsesteenweg 365,2023-09-07,00:00:00,0,0,0,FMN GV 05 Lier
60,Mechelsesteenweg 365,2023-09-07,01:00:00,0,0,0,FMN GV 05 Lier
60,Mechelsesteenweg 365,2023-09-07,02:00:00,2,2,0,FMN GV 05 Lier
60,Mechelsesteenweg 365,2023-09-07,03:00:00,8,0,8,FMN GV 05 Lier
60,Mechelsesteenweg 365,2023-09-07,04:00:00,4,4,0,FMN GV 05 Lier
60,Mechelsesteenweg 365,2023-09-07,05:00:00,12,4,8,FMN GV 05 Lier
60,Mechelsesteenweg 365,2023-09-07,06:00:00,52,18,34,FMN GV 05 Lier
60,Mechelsesteenweg 365,2023-09-07,07:00:00,256,140,116,FMN GV 05 Lier
60,Mechelsesteenweg 365,2023-09-07,08:00:00,288,156,132,FMN GV 05 Lier
60,Mechelsesteenweg 365,2023-09-07,09:00:00,168,84,84,FMN GV 05 Lier
60,Mechelsesteenweg 365,2023-09-07,10:00:00,236,128,108,FMN GV 05 Lier
60,Mechelsesteenweg 365,2023-09-07,11:00:00,214,108,106,FMN GV 05 Lier
60,Mechelsesteenweg 365,2023-09-07,12:00:00,326,134,192,FMN GV 05 Lier
60,Mechelsesteenweg 365,2023-09-07,13:00:00,272,104,168,FMN GV 05 Lier
60,Mechelsesteenweg 365,2023-09-07,14:00:00,252,146,106,FMN GV 05 Lier
60,Mechelsesteenweg 365,2023-09-07,15:00:00,264,140,124,FMN GV 05 Lier
60,Mechelsesteenweg 365,2023-09-07,16:00:00,324,124,200,FMN GV 05 Lier
60,Mechelsesteenweg 365,2023-09-07,17:00:00,270,160,110,FMN GV 05 Lier
60,Mechelsesteenweg 365,2023-09-07,18:00:00,208,100,108,FMN GV 05 Lier
60,Mechelsesteenweg 365,2023-09-07,19:00:00,250,128,122,FMN GV 05 Lier
60,Mechelsesteenweg 365,2023-09-07,20:00:00,172,76,96,FMN GV 05 Lier
60,Mechelsesteenweg 365,2023-09-07,21:00:00,38,6,32,FMN GV 05 Lier
60,Mechelsesteenweg 365,2023-09-07,22:00:00,12,6,6,FMN GV 05 Lier
60,Mechelsesteenweg 365,2023-09-07,23:00:00,8,8,0,FMN GV 05 Lier
60,Mechelsesteenweg 365,2023-09-08,00:00:00,8,2,6,FMN GV 05 Lier
60,Mechelsesteenweg 365,2023-09-08,01:00:00,4,0,4,FMN GV 05 Lier
60,Mechelsesteenweg 365,2023-09-08,02:00:00,4,4,0,FMN GV 05 Lier
60,Mechelsesteenweg 365,2023-09-08,03:00:00,2,0,2,FMN GV 05 Lier
60,Mechelsesteenweg 365,2023-09-08,04:00:00,0,0,0,FMN GV 05 Lier
60,Mechelsesteenweg 365,2023-09-08,05:00:00,10,4,6,FMN GV 05 Lier
60,Mechelsesteenweg 365,2023-09-08,06:00:00,40,14,26,FMN GV 05 Lier
60,Mechelsesteenweg 365,2023-09-08,07:00:00,226,126,100,FMN GV 05 Lier
60,Mechelsesteenweg 365,2023-09-08,08:00:00,452,174,278,FMN GV 05 Lier
60,Mechelsesteenweg 365,2023-09-08,09:00:00,166,76,90,FMN GV 05 Lier
60,Mechelsesteenweg 365,2023-09-08,10:00:00,228,100,128,FMN GV 05 Lier
60,Mechelsesteenweg 365,2023-09-08,11:00:00,230,114,116,FMN GV 05 Lier
60,Mechelsesteenweg 365,2023-09-08,12:00:00,146,70,76,FMN GV 05 Lier
60,Mechelsesteenweg 365,2023-09-08,13:00:00,164,80,84,FMN GV 05 Lier
60,Mechelsesteenweg 365,2023-09-08,14:00:00,174,92,82,FMN GV 05 Lier
60,Mechelsesteenweg 365,2023-09-08,15:00:00,384,276,108,FMN GV 05 Lier
60,Mechelsesteenweg 365,2023-09-08,16:00:00,374,128,246,FMN GV 05 Lier
60,Mechelsesteenweg 365,2023-09-08,17:00:00,148,98,50,FMN GV 05 Lier
60,Mechelsesteenweg 365,2023-09-08,18:00:00,162,80,82,FMN GV 05 Lier
60,Mechelsesteenweg 365,2023-09-08,19:00:00,118,70,48,FMN GV 05 Lier
60,Mechelsesteenweg 365,2023-09-08,20:00:00,108,48,60,FMN GV 05 Lier
60,Mechelsesteenweg 365,2023-09-08,21:00:00,16,0,16,FMN GV 05 Lier
60,Mechelsesteenweg 365,2023-09-08,22:00:00,10,4,6,FMN GV 05 Lier
60,Mechelsesteenweg 365,2023-09-08,23:00:00,10,6,4,FMN GV 05 Lier
60,Mechelsesteenweg 365,2023-09-09,00:00:00,16,2,14,FMN GV 05 Lier
60,Mechelsesteenweg 365,2023-09-09,01:00:00,2,0,2,FMN GV 05 Lier
60,Mechelsesteenweg 365,2023-09-09,02:00:00,2,2,0,FMN GV 05 Lier
60,Mechelsesteenweg 365,2023-09-09,03:00:00,4,0,4,FMN GV 05 Lier
60,Mechelsesteenweg 365,2023-09-09,04:00:00,0,0,0,FMN GV 05 Lier
60,Mechelsesteenweg 365,2023-09-09,05:00:00,6,4,2,FMN GV 05 Lier
60,Mechelsesteenweg 365,2023-09-09,06:00:00,12,10,2,FMN GV 05 Lier
60,Mechelsesteenweg 365,2023-09-09,07:00:00,28,16,12,FMN GV 05 Lier
60,Mechelsesteenweg 365,2023-09-09,08:00:00,92,66,26,FMN GV 05 Lier
60,Mechelsesteenweg 365,2023-09-09,09:00:00,242,106,136,FMN GV 05 Lier
60,Mechelsesteenweg 365,2023-09-09,10:00:00,284,166,118,FMN GV 05 Lier
60,Mechelsesteenweg 365,2023-09-09,11:00:00,256,120,136,FMN GV 05 Lier
60,Mechelsesteenweg 365,2023-09-09,12:00:00,244,114,130,FMN GV 05 Lier
60,Mechelsesteenweg 365,2023-09-09,13:00:00,196,86,110,FMN GV 05 Lier
60,Mechelsesteenweg 365,2023-09-09,14:00:00,184,70,114,FMN GV 05 Lier
60,Mechelsesteenweg 365,2023-09-09,15:00:00,230,94,136,FMN GV 05 Lier
60,Mechelsesteenweg 365,2023-09-09,16:00:00,182,78,104,FMN GV 05 Lier
60,Mechelsesteenweg 365,2023-09-09,17:00:00,182,90,92,FMN GV 05 Lier
60,Mechelsesteenweg 365,2023-09-09,18:00:00,150,82,68,FMN GV 05 Lier
60,Mechelsesteenweg 365,2023-09-09,19:00:00,144,64,80,FMN GV 05 Lier
60,Mechelsesteenweg 365,2023-09-09,20:00:00,68,26,42,FMN GV 05 Lier
60,Mechelsesteenweg 365,2023-09-09,21:00:00,28,4,24,FMN GV 05 Lier
60,Mechelsesteenweg 365,2023-09-09,22:00:00,22,10,12,FMN GV 05 Lier
60,Mechelsesteenweg 365,2023-09-09,23:00:00,20,0,20,FMN GV 05 Lier
60,Mechelsesteenweg 365,2023-09-10,00:00:00,8,4,4,FMN GV 05 Lier
60,Mechelsesteenweg 365,2023-09-10,01:00:00,6,4,2,FMN GV 05 Lier
60,Mechelsesteenweg 365,2023-09-10,02:00:00,0,0,0,FMN GV 05 Lier
60,Mechelsesteenweg 365,2023-09-10,03:00:00,0,0,0,FMN GV 05 Lier
60,Mechelsesteenweg 365,2023-09-10,04:00:00,0,0,0,FMN GV 05 Lier
60,Mechelsesteenweg 365,2023-09-10,05:00:00,4,0,4,FMN GV 05 Lier
60,Mechelsesteenweg 365,2023-09-10,06:00:00,10,8,2,FMN GV 05 Lier
60,Mechelsesteenweg 365,2023-09-10,07:00:00,20,6,14,FMN GV 05 Lier
60,Mechelsesteenweg 365,2023-09-10,08:00:00,132,64,68,FMN GV 05 Lier
60,Mechelsesteenweg 365,2023-09-10,09:00:00,386,198,188,FMN GV 05 Lier
60,Mechelsesteenweg 365,2023-09-10,10:00:00,552,268,284,FMN GV 05 Lier
60,Mechelsesteenweg 365,2023-09-10,11:00:00,484,260,224,FMN GV 05 Lier
60,Mechelsesteenweg 365,2023-09-10,12:00:00,348,130,218,FMN GV 05 Lier
60,Mechelsesteenweg 365,2023-09-10,13:00:00,348,138,210,FMN GV 05 Lier
60,Mechelsesteenweg 365,2023-09-10,14:00:00,286,134,152,FMN GV 05 Lier
60,Mechelsesteenweg 365,2023-09-10,15:00:00,276,160,116,FMN GV 05 Lier
60,Mechelsesteenweg 365,2023-09-10,16:00:00,304,74,230,FMN GV 05 Lier
60,Mechelsesteenweg 365,2023-09-10,17:00:00,176,62,114,FMN GV 05 Lier
60,Mechelsesteenweg 365,2023-09-10,18:00:00,132,82,50,FMN GV 05 Lier
60,Mechelsesteenweg 365,2023-09-10,19:00:00,116,42,74,FMN GV 05 Lier
60,Mechelsesteenweg 365,2023-09-10,20:00:00,96,50,46,FMN GV 05 Lier
60,Mechelsesteenweg 365,2023-09-10,21:00:00,14,6,8,FMN GV 05 Lier
60,Mechelsesteenweg 365,2023-09-10,22:00:00,2,0,2,FMN GV 05 Lier
60,Mechelsesteenweg 365,2023-09-10,23:00:00,2,0,2,FMN GV 05 Lier
60,Mechelsesteenweg 365,2023-09-11,00:00:00,4,0,4,FMN GV 05 Lier
60,Mechelsesteenweg 365,2023-09-11,01:00:00,2,2,0,FMN GV 05 Lier
60,Mechelsesteenweg 365,2023-09-11,02:00:00,0,0,0,FMN GV 05 Lier
60,Mechelsesteenweg 365,2023-09-11,03:00:00,2,0,2,FMN GV 05 Lier
60,Mechelsesteenweg 365,2023-09-11,04:00:00,2,0,2,FMN GV 05 Lier
60,Mechelsesteenweg 365,2023-09-11,05:00:00,4,2,2,FMN GV 05 Lier
60,Mechelsesteenweg 365,2023-09-11,06:00:00,52,16,36,FMN GV 05 Lier
60,Mechelsesteenweg 365,2023-09-11,07:00:00,222,130,92,FMN GV 05 Lier
60,Mechelsesteenweg 365,2023-09-11,08:00:00,276,154,122,FMN GV 05 Lier
60,Mechelsesteenweg 365,2023-09-11,09:00:00,148,62,86,FMN GV 05 Lier
60,Mechelsesteenweg 365,2023-09-11,10:00:00,186,88,98,FMN GV 05 Lier
60,Mechelsesteenweg 365,2023-09-11,11:00:00,158,76,82,FMN GV 05 Lier
60,Mechelsesteenweg 365,2023-09-11,12:00:00,156,84,72,FMN GV 05 Lier
60,Mechelsesteenweg 365,2023-09-11,13:00:00,162,92,70,FMN GV 05 Lier
60,Mechelsesteenweg 365,2023-09-11,14:00:00,204,78,126,FMN GV 05 Lier
60,Mechelsesteenweg 365,2023-09-11,15:00:00,268,126,142,FMN GV 05 Lier
60,Mechelsesteenweg 365,2023-09-11,16:00:00,398,142,256,FMN GV 05 Lier
60,Mechelsesteenweg 365,2023-09-11,17:00:00,272,152,120,FMN GV 05 Lier
60,Mechelsesteenweg 365,2023-09-11,18:00:00,128,70,58,FMN GV 05 Lier
60,Mechelsesteenweg 365,2023-09-11,19:00:00,116,54,62,FMN GV 05 Lier
60,Mechelsesteenweg 365,2023-09-11,20:00:00,46,16,30,FMN GV 05 Lier
60,Mechelsesteenweg 365,2023-09-11,21:00:00,14,2,12,FMN GV 05 Lier
60,Mechelsesteenweg 365,2023-09-11,22:00:00,0,0,0,FMN GV 05 Lier
60,Mechelsesteenweg 365,2023-09-11,23:00:00,6,6,0,FMN GV 05 Lier
60,Mechelsesteenweg 365,2023-09-12,00:00:00,8,8,0,FMN GV 05 Lier
60,Mechelsesteenweg 365,2023-09-12,01:00:00,0,0,0,FMN GV 05 Lier
60,Mechelsesteenweg 365,2023-09-12,02:00:00,0,0,0,FMN GV 05 Lier
60,Mechelsesteenweg 365,2023-09-12,03:00:00,4,2,2,FMN GV 05 Lier
60,Mechelsesteenweg 365,2023-09-12,04:00:00,0,0,0,FMN GV 05 Lier
60,Mechelsesteenweg 365,2023-09-12,05:00:00,4,0,4,FMN GV 05 Lier
60,Mechelsesteenweg 365,2023-09-12,06:00:00,44,22,22,FMN GV 05 Lier
60,Mechelsesteenweg 365,2023-09-12,07:00:00,212,106,106,FMN GV 05 Lier
60,Mechelsesteenweg 365,2023-09-12,08:00:00,236,130,106,FMN GV 05 Lier
60,Mechelsesteenweg 365,2023-09-12,09:00:00,102,50,52,FMN GV 05 Lier
60,Mechelsesteenweg 365,2023-09-12,10:00:00,144,84,60,FMN GV 05 Lier
60,Mechelsesteenweg 365,2023-09-12,11:00:00,170,84,86,FMN GV 05 Lier
60,Mechelsesteenweg 365,2023-09-12,12:00:00,98,62,36,FMN GV 05 Lier
60,Mechelsesteenweg 365,2023-09-12,13:00:00,148,94,54,FMN GV 05 Lier
60,Mechelsesteenweg 365,2023-09-12,14:00:00,212,120,92,FMN GV 05 Lier
60,Mechelsesteenweg 365,2023-09-12,15:00:00,226,94,132,FMN GV 05 Lier
60,Mechelsesteenweg 365,2023-09-12,16:00:00,394,156,238,FMN GV 05 Lier
60,Mechelsesteenweg 365,2023-09-12,17:00:00,184,108,76,FMN GV 05 Lier
60,Mechelsesteenweg 365,2023-09-12,18:00:00,128,82,46,FMN GV 05 Lier
60,Mechelsesteenweg 365,2023-09-12,19:00:00,56,28,28,FMN GV 05 Lier
60,Mechelsesteenweg 365,2023-09-12,20:00:00,20,4,16,FMN GV 05 Lier
60,Mechelsesteenweg 365,2023-09-12,21:00:00,24,4,20,FMN GV 05 Lier
60,Mechelsesteenweg 365,2023-09-12,22:00:00,10,8,2,FMN GV 05 Lier
60,Mechelsesteenweg 365,2023-09-12,23:00:00,4,4,0,FMN GV 05 Lier
60,Mechelsesteenweg 365,2023-09-13,00:00:00,2,0,2,FMN GV 05 Lier
60,Mechelsesteenweg 365,2023-09-13,01:00:00,0,0,0,FMN GV 05 Lier
60,Mechelsesteenweg 365,2023-09-13,02:00:00,0,0,0,FMN GV 05 Lier
60,Mechelsesteenweg 365,2023-09-13,03:00:00,2,0,2,FMN GV 05 Lier
60,Mechelsesteenweg 365,2023-09-13,04:00:00,2,0,2,FMN GV 05 Lier
60,Mechelsesteenweg 365,2023-09-13,05:00:00,8,0,8,FMN GV 05 Lier
60,Mechelsesteenweg 365,2023-09-13,06:00:00,34,12,22,FMN GV 05 Lier
60,Mechelsesteenweg 365,2023-09-13,07:00:00,206,136,70,FMN GV 05 Lier
60,Mechelsesteenweg 365,2023-09-13,08:00:00,208,138,70,FMN GV 05 Lier
60,Mechelsesteenweg 365,2023-09-13,09:00:00,84,36,48,FMN GV 05 Lier
60,Mechelsesteenweg 365,2023-09-13,10:00:00,82,40,42,FMN GV 05 Lier
60,Mechelsesteenweg 365,2023-09-13,11:00:00,118,40,78,FMN GV 05 Lier
60,Mechelsesteenweg 365,2023-09-13,12:00:00,304,78,226,FMN GV 05 Lier
60,Mechelsesteenweg 365,2023-09-13,13:00:00,146,66,80,FMN GV 05 Lier
60,Mechelsesteenweg 365,2023-09-13,14:00:00,168,82,86,FMN GV 05 Lier
60,Mechelsesteenweg 365,2023-09-13,15:00:00,230,128,102,FMN GV 05 Lier
60,Mechelsesteenweg 365,2023-09-13,16:00:00,176,92,84,FMN GV 05 Lier
60,Mechelsesteenweg 365,2023-09-13,17:00:00,188,106,82,FMN GV 05 Lier
60,Mechelsesteenweg 365,2023-09-13,18:00:00,176,108,68,FMN GV 05 Lier
60,Mechelsesteenweg 365,2023-09-13,19:00:00,140,46,94,FMN GV 05 Lier
60,Mechelsesteenweg 365,2023-09-13,20:00:00,134,98,36,FMN GV 05 Lier
60,Mechelsesteenweg 365,2023-09-13,21:00:00,38,14,24,FMN GV 05 Lier
60,Mechelsesteenweg 365,2023-09-13,22:00:00,14,2,12,FMN GV 05 Lier
60,Mechelsesteenweg 365,2023-09-13,23:00:00,2,2,0,FMN GV 05 Lier
60,Mechelsesteenweg 365,2023-09-14,00:00:00,4,4,0,FMN GV 05 Lier
60,Mechelsesteenweg 365,2023-09-14,01:00:00,14,8,6,FMN GV 05 Lier
60,Mechelsesteenweg 365,2023-09-14,02:00:00,0,0,0,FMN GV 05 Lier
60,Mechelsesteenweg 365,2023-09-14,03:00:00,2,0,2,FMN GV 05 Lier
60,Mechelsesteenweg 365,2023-09-14,04:00:00,2,0,2,FMN GV 05 Lier
60,Mechelsesteenweg 365,2023-09-14,05:00:00,2,0,2,FMN GV 05 Lier
60,Mechelsesteenweg 365,2023-09-14,06:00:00,48,20,28,FMN GV 05 Lier
60,Mechelsesteenweg 365,2023-09-14,07:00:00,236,120,116,FMN GV 05 Lier
60,Mechelsesteenweg 365,2023-09-14,08:00:00,270,156,114,FMN GV 05 Lier
60,Mechelsesteenweg 365,2023-09-14,09:00:00,122,72,50,FMN GV 05 Lier
60,Mechelsesteenweg 365,2023-09-14,10:00:00,150,72,78,FMN GV 05 Lier
60,Mechelsesteenweg 365,2023-09-14,11:00:00,200,78,122,FMN GV 05 Lier
60,Mechelsesteenweg 365,2023-09-14,12:00:00,226,110,116,FMN GV 05 Lier
60,Mechelsesteenweg 365,2023-09-14,13:00:00,210,104,106,FMN GV 05 Lier
60,Mechelsesteenweg 365,2023-09-14,14:00:00,252,126,126,FMN GV 05 Lier
60,Mechelsesteenweg 365,2023-09-14,15:00:00,318,144,174,FMN GV 05 Lier
60,Mechelsesteenweg 365,2023-09-14,16:00:00,422,166,256,FMN GV 05 Lier
60,Mechelsesteenweg 365,2023-09-14,17:00:00,272,180,92,FMN GV 05 Lier
60,Mechelsesteenweg 365,2023-09-14,18:00:00,208,124,84,FMN GV 05 Lier
60,Mechelsesteenweg 365,2023-09-14,19:00:00,208,84,124,FMN GV 05 Lier
60,Mechelsesteenweg 365,2023-09-14,20:00:00,82,46,36,FMN GV 05 Lier
60,Mechelsesteenweg 365,2023-09-14,21:00:00,52,24,28,FMN GV 05 Lier
60,Mechelsesteenweg 365,2023-09-14,22:00:00,12,4,8,FMN GV 05 Lier
60,Mechelsesteenweg 365,2023-09-14,23:00:00,0,0,0,FMN GV 05 Lier
60,Mechelsesteenweg 365,2023-09-15,00:00:00,2,2,0,FMN GV 05 Lier
60,Mechelsesteenweg 365,2023-09-15,01:00:00,0,0,0,FMN GV 05 Lier
60,Mechelsesteenweg 365,2023-09-15,02:00:00,0,0,0,FMN GV 05 Lier
60,Mechelsesteenweg 365,2023-09-15,03:00:00,2,0,2,FMN GV 05 Lier
60,Mechelsesteenweg 365,2023-09-15,04:00:00,0,0,0,FMN GV 05 Lier
60,Mechelsesteenweg 365,2023-09-15,05:00:00,8,2,6,FMN GV 05 Lier
60,Mechelsesteenweg 365,2023-09-15,06:00:00,44,28,16,FMN GV 05 Lier
60,Mechelsesteenweg 365,2023-09-15,07:00:00,166,96,70,FMN GV 05 Lier
60,Mechelsesteenweg 365,2023-09-15,08:00:00,204,138,66,FMN GV 05 Lier
60,Mechelsesteenweg 365,2023-09-15,09:00:00,112,66,46,FMN GV 05 Lier
60,Mechelsesteenweg 365,2023-09-15,10:00:00,174,82,92,FMN GV 05 Lier
60,Mechelsesteenweg 365,2023-09-15,11:00:00,224,104,120,FMN GV 05 Lier
60,Mechelsesteenweg 365,2023-09-15,12:00:00,160,66,94,FMN GV 05 Lier
60,Mechelsesteenweg 365,2023-09-15,13:00:00,204,78,126,FMN GV 05 Lier
60,Mechelsesteenweg 365,2023-09-15,14:00:00,308,174,134,FMN GV 05 Lier
60,Mechelsesteenweg 365,2023-09-15,15:00:00,348,178,170,FMN GV 05 Lier
60,Mechelsesteenweg 365,2023-09-15,16:00:00,422,146,276,FMN GV 05 Lier
60,Mechelsesteenweg 365,2023-09-15,17:00:00,210,110,100,FMN GV 05 Lier
60,Mechelsesteenweg 365,2023-09-15,18:00:00,138,82,56,FMN GV 05 Lier
60,Mechelsesteenweg 365,2023-09-15,19:00:00,118,56,62,FMN GV 05 Lier
60,Mechelsesteenweg 365,2023-09-15,20:00:00,52,16,36,FMN GV 05 Lier
60,Mechelsesteenweg 365,2023-09-15,21:00:00,18,2,16,FMN GV 05 Lier
60,Mechelsesteenweg 365,2023-09-15,22:00:00,8,2,6,FMN GV 05 Lier
60,Mechelsesteenweg 365,2023-09-15,23:00:00,8,4,4,FMN GV 05 Lier
60,Mechelsesteenweg 365,2023-09-16,00:00:00,6,4,2,FMN GV 05 Lier
60,Mechelsesteenweg 365,2023-09-16,01:00:00,0,0,0,FMN GV 05 Lier
60,Mechelsesteenweg 365,2023-09-16,02:00:00,2,2,0,FMN GV 05 Lier
60,Mechelsesteenweg 365,2023-09-16,03:00:00,2,2,0,FMN GV 05 Lier
60,Mechelsesteenweg 365,2023-09-16,04:00:00,2,2,0,FMN GV 05 Lier
60,Mechelsesteenweg 365,2023-09-16,05:00:00,6,2,4,FMN GV 05 Lier
60,Mechelsesteenweg 365,2023-09-16,06:00:00,4,4,0,FMN GV 05 Lier
60,Mechelsesteenweg 365,2023-09-16,07:00:00,12,6,6,FMN GV 05 Lier
60,Mechelsesteenweg 365,2023-09-16,08:00:00,48,24,24,FMN GV 05 Lier
60,Mechelsesteenweg 365,2023-09-16,09:00:00,186,78,108,FMN GV 05 Lier
60,Mechelsesteenweg 365,2023-09-16,10:00:00,328,94,234,FMN GV 05 Lier
60,Mechelsesteenweg 365,2023-09-16,11:00:00,390,152,238,FMN GV 05 Lier
60,Mechelsesteenweg 365,2023-09-16,12:00:00,314,182,132,FMN GV 05 Lier
60,Mechelsesteenweg 365,2023-09-16,13:00:00,278,102,176,FMN GV 05 Lier
60,Mechelsesteenweg 365,2023-09-16,14:00:00,454,236,218,FMN GV 05 Lier
60,Mechelsesteenweg 365,2023-09-16,15:00:00,384,176,208,FMN GV 05 Lier
60,Mechelsesteenweg 365,2023-09-16,16:00:00,280,132,148,FMN GV 05 Lier
60,Mechelsesteenweg 365,2023-09-16,17:00:00,242,102,140,FMN GV 05 Lier
60,Mechelsesteenweg 365,2023-09-16,18:00:00,116,36,80,FMN GV 05 Lier
60,Mechelsesteenweg 365,2023-09-16,19:00:00,38,18,20,FMN GV 05 Lier
60,Mechelsesteenweg 365,2023-09-16,20:00:00,36,16,20,FMN GV 05 Lier
60,Mechelsesteenweg 365,2023-09-16,21:00:00,16,8,8,FMN GV 05 Lier
60,Mechelsesteenweg 365,2023-09-16,22:00:00,12,2,10,FMN GV 05 Lier
60,Mechelsesteenweg 365,2023-09-16,23:00:00,12,4,8,FMN GV 05 Lier
60,Mechelsesteenweg 365,2023-09-17,00:00:00,10,6,4,FMN GV 05 Lier
60,Mechelsesteenweg 365,2023-09-17,01:00:00,8,0,8,FMN GV 05 Lier
60,Mechelsesteenweg 365,2023-09-17,02:00:00,2,2,0,FMN GV 05 Lier
60,Mechelsesteenweg 365,2023-09-17,03:00:00,0,0,0,FMN GV 05 Lier
60,Mechelsesteenweg 365,2023-09-17,04:00:00,0,0,0,FMN GV 05 Lier
60,Mechelsesteenweg 365,2023-09-17,05:00:00,2,2,0,FMN GV 05 Lier
60,Mechelsesteenweg 365,2023-09-17,06:00:00,0,0,0,FMN GV 05 Lier
60,Mechelsesteenweg 365,2023-09-17,07:00:00,14,10,4,FMN GV 05 Lier
60,Mechelsesteenweg 365,2023-09-17,08:00:00,106,84,22,FMN GV 05 Lier
60,Mechelsesteenweg 365,2023-09-17,09:00:00,198,92,106,FMN GV 05 Lier
60,Mechelsesteenweg 365,2023-09-17,10:00:00,470,174,296,FMN GV 05 Lier
60,Mechelsesteenweg 365,2023-09-17,11:00:00,430,140,290,FMN GV 05 Lier
60,Mechelsesteenweg 365,2023-09-17,12:00:00,296,128,168,FMN GV 05 Lier
60,Mechelsesteenweg 365,2023-09-17,13:00:00,306,188,118,FMN GV 05 Lier
60,Mechelsesteenweg 365,2023-09-17,14:00:00,408,220,188,FMN GV 05 Lier
60,Mechelsesteenweg 365,2023-09-17,15:00:00,440,192,248,FMN GV 05 Lier
60,Mechelsesteenweg 365,2023-09-17,16:00:00,354,160,194,FMN GV 05 Lier
60,Mechelsesteenweg 365,2023-09-17,17:00:00,248,90,158,FMN GV 05 Lier
60,Mechelsesteenweg 365,2023-09-17,18:00:00,96,28,68,FMN GV 05 Lier
60,Mechelsesteenweg 365,2023-09-17,19:00:00,54,20,34,FMN GV 05 Lier
60,Mechelsesteenweg 365,2023-09-17,20:00:00,34,8,26,FMN GV 05 Lier
60,Mechelsesteenweg 365,2023-09-17,21:00:00,6,0,6,FMN GV 05 Lier
60,Mechelsesteenweg 365,2023-09-17,22:00:00,8,0,8,FMN GV 05 Lier
60,Mechelsesteenweg 365,2023-09-17,23:00:00,6,0,6,FMN GV 05 Lier
60,Mechelsesteenweg 365,2023-09-18,00:00:00,0,0,0,FMN GV 05 Lier
60,Mechelsesteenweg 365,2023-09-18,01:00:00,0,0,0,FMN GV 05 Lier
60,Mechelsesteenweg 365,2023-09-18,02:00:00,0,0,0,FMN GV 05 Lier
60,Mechelsesteenweg 365,2023-09-18,03:00:00,4,0,4,FMN GV 05 Lier
60,Mechelsesteenweg 365,2023-09-18,04:00:00,2,2,0,FMN GV 05 Lier
60,Mechelsesteenweg 365,2023-09-18,05:00:00,2,2,0,FMN GV 05 Lier
60,Mechelsesteenweg 365,2023-09-18,06:00:00,32,10,22,FMN GV 05 Lier
60,Mechelsesteenweg 365,2023-09-18,07:00:00,210,122,88,FMN GV 05 Lier
60,Mechelsesteenweg 365,2023-09-18,08:00:00,222,122,100,FMN GV 05 Lier
60,Mechelsesteenweg 365,2023-09-18,09:00:00,60,32,28,FMN GV 05 Lier
60,Mechelsesteenweg 365,2023-09-18,10:00:00,74,42,32,FMN GV 05 Lier
60,Mechelsesteenweg 365,2023-09-18,11:00:00,62,28,34,FMN GV 05 Lier
60,Mechelsesteenweg 365,2023-09-18,12:00:00,62,36,26,FMN GV 05 Lier
60,Mechelsesteenweg 365,2023-09-18,13:00:00,92,36,56,FMN GV 05 Lier
60,Mechelsesteenweg 365,2023-09-18,14:00:00,130,80,50,FMN GV 05 Lier
60,Mechelsesteenweg 365,2023-09-18,15:00:00,176,82,94,FMN GV 05 Lier
60,Mechelsesteenweg 365,2023-09-18,16:00:00,242,88,154,FMN GV 05 Lier
60,Mechelsesteenweg 365,2023-09-18,17:00:00,102,66,36,FMN GV 05 Lier
60,Mechelsesteenweg 365,2023-09-18,18:00:00,86,54,32,FMN GV 05 Lier
60,Mechelsesteenweg 365,2023-09-18,19:00:00,46,26,20,FMN GV 05 Lier
60,Mechelsesteenweg 365,2023-09-18,20:00:00,20,4,16,FMN GV 05 Lier
60,Mechelsesteenweg 365,2023-09-18,21:00:00,4,0,4,FMN GV 05 Lier
60,Mechelsesteenweg 365,2023-09-18,22:00:00,6,4,2,FMN GV 05 Lier
60,Mechelsesteenweg 365,2023-09-18,23:00:00,0,0,0,FMN GV 05 Lier
60,Mechelsesteenweg 365,2023-09-19,00:00:00,2,0,2,FMN GV 05 Lier
60,Mechelsesteenweg 365,2023-09-19,01:00:00,0,0,0,FMN GV 05 Lier
60,Mechelsesteenweg 365,2023-09-19,02:00:00,0,0,0,FMN GV 05 Lier
60,Mechelsesteenweg 365,2023-09-19,03:00:00,2,0,2,FMN GV 05 Lier
60,Mechelsesteenweg 365,2023-09-19,04:00:00,2,2,0,FMN GV 05 Lier
60,Mechelsesteenweg 365,2023-09-19,05:00:00,4,2,2,FMN GV 05 Lier
60,Mechelsesteenweg 365,2023-09-19,06:00:00,32,12,20,FMN GV 05 Lier
60,Mechelsesteenweg 365,2023-09-19,07:00:00,206,114,92,FMN GV 05 Lier
60,Mechelsesteenweg 365,2023-09-19,08:00:00,264,146,118,FMN GV 05 Lier
60,Mechelsesteenweg 365,2023-09-19,09:00:00,110,62,48,FMN GV 05 Lier
60,Mechelsesteenweg 365,2023-09-19,10:00:00,100,52,48,FMN GV 05 Lier
60,Mechelsesteenweg 365,2023-09-19,11:00:00,122,82,40,FMN GV 05 Lier
60,Mechelsesteenweg 365,2023-09-19,12:00:00,110,70,40,FMN GV 05 Lier
60,Mechelsesteenweg 365,2023-09-19,13:00:00,154,78,76,FMN GV 05 Lier
60,Mechelsesteenweg 365,2023-09-19,14:00:00,134,78,56,FMN GV 05 Lier
60,Mechelsesteenweg 365,2023-09-19,15:00:00,186,98,88,FMN GV 05 Lier
60,Mechelsesteenweg 365,2023-09-19,16:00:00,282,110,172,FMN GV 05 Lier
60,Mechelsesteenweg 365,2023-09-19,17:00:00,148,102,46,FMN GV 05 Lier
60,Mechelsesteenweg 365,2023-09-19,18:00:00,88,66,22,FMN GV 05 Lier
60,Mechelsesteenweg 365,2023-09-19,19:00:00,34,22,12,FMN GV 05 Lier
60,Mechelsesteenweg 365,2023-09-19,20:00:00,22,4,18,FMN GV 05 Lier
60,Mechelsesteenweg 365,2023-09-19,21:00:00,8,2,6,FMN GV 05 Lier
60,Mechelsesteenweg 365,2023-09-19,22:00:00,10,8,2,FMN GV 05 Lier
60,Mechelsesteenweg 365,2023-09-19,23:00:00,0,0,0,FMN GV 05 Lier
60,Mechelsesteenweg 365,2023-09-20,00:00:00,2,0,2,FMN GV 05 Lier
60,Mechelsesteenweg 365,2023-09-20,01:00:00,0,0,0,FMN GV 05 Lier
60,Mechelsesteenweg 365,2023-09-20,02:00:00,0,0,0,FMN GV 05 Lier
60,Mechelsesteenweg 365,2023-09-20,03:00:00,2,0,2,FMN GV 05 Lier
60,Mechelsesteenweg 365,2023-09-20,04:00:00,0,0,0,FMN GV 05 Lier
60,Mechelsesteenweg 365,2023-09-20,05:00:00,6,2,4,FMN GV 05 Lier
60,Mechelsesteenweg 365,2023-09-20,06:00:00,24,6,18,FMN GV 05 Lier
60,Mechelsesteenweg 365,2023-09-20,07:00:00,226,138,88,FMN GV 05 Lier
60,Mechelsesteenweg 365,2023-09-20,08:00:00,188,94,94,FMN GV 05 Lier
60,Mechelsesteenweg 365,2023-09-20,09:00:00,98,52,46,FMN GV 05 Lier
60,Mechelsesteenweg 365,2023-09-20,10:00:00,78,48,30,FMN GV 05 Lier
60,Mechelsesteenweg 365,2023-09-20,11:00:00,86,44,42,FMN GV 05 Lier
60,Mechelsesteenweg 365,2023-09-20,12:00:00,282,72,210,FMN GV 05 Lier
60,Mechelsesteenweg 365,2023-09-20,13:00:00,148,104,44,FMN GV 05 Lier
60,Mechelsesteenweg 365,2023-09-20,14:00:00,158,76,82,FMN GV 05 Lier
60,Mechelsesteenweg 365,2023-09-20,15:00:00,160,112,48,FMN GV 05 Lier
60,Mechelsesteenweg 365,2023-09-20,16:00:00,188,126,62,FMN GV 05 Lier
60,Mechelsesteenweg 365,2023-09-20,17:00:00,168,102,66,FMN GV 05 Lier
60,Mechelsesteenweg 365,2023-09-20,18:00:00,140,82,58,FMN GV 05 Lier
60,Mechelsesteenweg 365,2023-09-20,19:00:00,202,148,54,FMN GV 05 Lier
60,Mechelsesteenweg 365,2023-09-20,20:00:00,40,22,18,FMN GV 05 Lier
60,Mechelsesteenweg 365,2023-09-20,21:00:00,10,4,6,FMN GV 05 Lier
60,Mechelsesteenweg 365,2023-09-20,22:00:00,8,6,2,FMN GV 05 Lier
60,Mechelsesteenweg 365,2023-09-20,23:00:00,2,0,2,FMN GV 05 Lier
60,Mechelsesteenweg 365,2023-09-21,00:00:00,2,2,0,FMN GV 05 Lier
60,Mechelsesteenweg 365,2023-09-21,01:00:00,0,0,0,FMN GV 05 Lier
60,Mechelsesteenweg 365,2023-09-21,02:00:00,0,0,0,FMN GV 05 Lier
60,Mechelsesteenweg 365,2023-09-21,03:00:00,2,0,2,FMN GV 05 Lier
60,Mechelsesteenweg 365,2023-09-21,04:00:00,0,0,0,FMN GV 05 Lier
60,Mechelsesteenweg 365,2023-09-21,05:00:00,2,0,2,FMN GV 05 Lier
60,Mechelsesteenweg 365,2023-09-21,06:00:00,18,4,14,FMN GV 05 Lier
60,Mechelsesteenweg 365,2023-09-21,07:00:00,124,74,50,FMN GV 05 Lier
60,Mechelsesteenweg 365,2023-09-21,08:00:00,128,80,48,FMN GV 05 Lier
60,Mechelsesteenweg 365,2023-09-21,09:00:00,40,18,22,FMN GV 05 Lier
60,Mechelsesteenweg 365,2023-09-21,10:00:00,18,10,8,FMN GV 05 Lier
60,Mechelsesteenweg 365,2023-09-21,11:00:00,18,12,6,FMN GV 05 Lier
60,Mechelsesteenweg 365,2023-09-21,12:00:00,20,12,8,FMN GV 05 Lier
60,Mechelsesteenweg 365,2023-09-21,13:00:00,38,4,34,FMN GV 05 Lier
60,Mechelsesteenweg 365,2023-09-21,14:00:00,26,14,12,FMN GV 05 Lier
60,Mechelsesteenweg 365,2023-09-21,15:00:00,40,6,34,FMN GV 05 Lier
60,Mechelsesteenweg 365,2023-09-21,16:00:00,162,64,98,FMN GV 05 Lier
60,Mechelsesteenweg 365,2023-09-21,17:00:00,66,42,24,FMN GV 05 Lier
60,Mechelsesteenweg 365,2023-09-21,18:00:00,34,18,16,FMN GV 05 Lier
60,Mechelsesteenweg 365,2023-09-21,19:00:00,28,24,4,FMN GV 05 Lier
60,Mechelsesteenweg 365,2023-09-21,20:00:00,20,8,12,FMN GV 05 Lier
60,Mechelsesteenweg 365,2023-09-21,21:00:00,10,2,8,FMN GV 05 Lier
60,Mechelsesteenweg 365,2023-09-21,22:00:00,8,6,2,FMN GV 05 Lier
60,Mechelsesteenweg 365,2023-09-21,23:00:00,2,0,2,FMN GV 05 Lier
60,Mechelsesteenweg 365,2023-09-22,00:00:00,2,0,2,FMN GV 05 Lier
60,Mechelsesteenweg 365,2023-09-22,01:00:00,0,0,0,FMN GV 05 Lier
60,Mechelsesteenweg 365,2023-09-22,02:00:00,0,0,0,FMN GV 05 Lier
60,Mechelsesteenweg 365,2023-09-22,03:00:00,4,2,2,FMN GV 05 Lier
60,Mechelsesteenweg 365,2023-09-22,04:00:00,0,0,0,FMN GV 05 Lier
60,Mechelsesteenweg 365,2023-09-22,05:00:00,4,0,4,FMN GV 05 Lier
60,Mechelsesteenweg 365,2023-09-22,06:00:00,24,8,16,FMN GV 05 Lier
60,Mechelsesteenweg 365,2023-09-22,07:00:00,154,90,64,FMN GV 05 Lier
60,Mechelsesteenweg 365,2023-09-22,08:00:00,308,120,188,FMN GV 05 Lier
60,Mechelsesteenweg 365,2023-09-22,09:00:00,322,194,128,FMN GV 05 Lier
60,Mechelsesteenweg 365,2023-09-22,10:00:00,86,44,42,FMN GV 05 Lier
60,Mechelsesteenweg 365,2023-09-22,11:00:00,190,68,122,FMN GV 05 Lier
60,Mechelsesteenweg 365,2023-09-22,12:00:00,210,154,56,FMN GV 05 Lier
60,Mechelsesteenweg 365,2023-09-22,13:00:00,70,34,36,FMN GV 05 Lier
60,Mechelsesteenweg 365,2023-09-22,14:00:00,90,60,30,FMN GV 05 Lier
60,Mechelsesteenweg 365,2023-09-22,15:00:00,330,160,170,FMN GV 05 Lier
60,Mechelsesteenweg 365,2023-09-22,16:00:00,186,54,132,FMN GV 05 Lier
60,Mechelsesteenweg 365,2023-09-22,17:00:00,78,44,34,FMN GV 05 Lier
60,Mechelsesteenweg 365,2023-09-22,18:00:00,52,36,16,FMN GV 05 Lier
60,Mechelsesteenweg 365,2023-09-22,19:00:00,50,44,6,FMN GV 05 Lier
60,Mechelsesteenweg 365,2023-09-22,20:00:00,26,8,18,FMN GV 05 Lier
60,Mechelsesteenweg 365,2023-09-22,21:00:00,10,2,8,FMN GV 05 Lier
60,Mechelsesteenweg 365,2023-09-22,22:00:00,4,2,2,FMN GV 05 Lier
60,Mechelsesteenweg 365,2023-09-22,23:00:00,10,8,2,FMN GV 05 Lier
60,Mechelsesteenweg 365,2023-09-23,00:00:00,2,0,2,FMN GV 05 Lier
60,Mechelsesteenweg 365,2023-09-23,01:00:00,0,0,0,FMN GV 05 Lier
60,Mechelsesteenweg 365,2023-09-23,02:00:00,0,0,0,FMN GV 05 Lier
60,Mechelsesteenweg 365,2023-09-23,03:00:00,0,0,0,FMN GV 05 Lier
60,Mechelsesteenweg 365,2023-09-23,04:00:00,0,0,0,FMN GV 05 Lier
60,Mechelsesteenweg 365,2023-09-23,05:00:00,2,0,2,FMN GV 05 Lier
60,Mechelsesteenweg 365,2023-09-23,06:00:00,4,2,2,FMN GV 05 Lier
60,Mechelsesteenweg 365,2023-09-23,07:00:00,18,8,10,FMN GV 05 Lier
60,Mechelsesteenweg 365,2023-09-23,08:00:00,24,12,12,FMN GV 05 Lier
60,Mechelsesteenweg 365,2023-09-23,09:00:00,94,46,48,FMN GV 05 Lier
60,Mechelsesteenweg 365,2023-09-23,10:00:00,178,100,78,FMN GV 05 Lier
60,Mechelsesteenweg 365,2023-09-23,11:00:00,210,104,106,FMN GV 05 Lier
60,Mechelsesteenweg 365,2023-09-23,12:00:00,138,66,72,FMN GV 05 Lier
60,Mechelsesteenweg 365,2023-09-23,13:00:00,114,62,52,FMN GV 05 Lier
60,Mechelsesteenweg 365,2023-09-23,14:00:00,240,124,116,FMN GV 05 Lier
60,Mechelsesteenweg 365,2023-09-23,15:00:00,174,126,48,FMN GV 05 Lier
60,Mechelsesteenweg 365,2023-09-23,16:00:00,96,52,44,FMN GV 05 Lier
60,Mechelsesteenweg 365,2023-09-23,17:00:00,122,56,66,FMN GV 05 Lier
60,Mechelsesteenweg 365,2023-09-23,18:00:00,68,36,32,FMN GV 05 Lier
60,Mechelsesteenweg 365,2023-09-23,19:00:00,36,20,16,FMN GV 05 Lier
60,Mechelsesteenweg 365,2023-09-23,20:00:00,24,12,12,FMN GV 05 Lier
60,Mechelsesteenweg 365,2023-09-23,21:00:00,20,10,10,FMN GV 05 Lier
60,Mechelsesteenweg 365,2023-09-23,22:00:00,2,0,2,FMN GV 05 Lier
60,Mechelsesteenweg 365,2023-09-23,23:00:00,0,0,0,FMN GV 05 Lier
60,Mechelsesteenweg 365,2023-09-24,00:00:00,2,0,2,FMN GV 05 Lier
60,Mechelsesteenweg 365,2023-09-24,01:00:00,6,0,6,FMN GV 05 Lier
60,Mechelsesteenweg 365,2023-09-24,02:00:00,0,0,0,FMN GV 05 Lier
60,Mechelsesteenweg 365,2023-09-24,03:00:00,0,0,0,FMN GV 05 Lier
60,Mechelsesteenweg 365,2023-09-24,04:00:00,0,0,0,FMN GV 05 Lier
60,Mechelsesteenweg 365,2023-09-24,05:00:00,0,0,0,FMN GV 05 Lier
60,Mechelsesteenweg 365,2023-09-24,06:00:00,2,2,0,FMN GV 05 Lier
60,Mechelsesteenweg 365,2023-09-24,07:00:00,18,12,6,FMN GV 05 Lier
60,Mechelsesteenweg 365,2023-09-24,08:00:00,38,28,10,FMN GV 05 Lier
60,Mechelsesteenweg 365,2023-09-24,09:00:00,180,112,68,FMN GV 05 Lier
60,Mechelsesteenweg 365,2023-09-24,10:00:00,430,212,218,FMN GV 05 Lier
60,Mechelsesteenweg 365,2023-09-24,11:00:00,480,238,242,FMN GV 05 Lier
60,Mechelsesteenweg 365,2023-09-24,12:00:00,392,220,172,FMN GV 05 Lier
60,Mechelsesteenweg 365,2023-09-24,13:00:00,352,234,118,FMN GV 05 Lier
60,Mechelsesteenweg 365,2023-09-24,14:00:00,520,300,220,FMN GV 05 Lier
60,Mechelsesteenweg 365,2023-09-24,15:00:00,464,190,274,FMN GV 05 Lier
60,Mechelsesteenweg 365,2023-09-24,16:00:00,330,114,216,FMN GV 05 Lier
60,Mechelsesteenweg 365,2023-09-24,17:00:00,204,86,118,FMN GV 05 Lier
60,Mechelsesteenweg 365,2023-09-24,18:00:00,140,66,74,FMN GV 05 Lier
60,Mechelsesteenweg 365,2023-09-24,19:00:00,66,18,48,FMN GV 05 Lier
60,Mechelsesteenweg 365,2023-09-24,20:00:00,14,6,8,FMN GV 05 Lier
60,Mechelsesteenweg 365,2023-09-24,21:00:00,22,8,14,FMN GV 05 Lier
60,Mechelsesteenweg 365,2023-09-24,22:00:00,8,2,6,FMN GV 05 Lier
60,Mechelsesteenweg 365,2023-09-24,23:00:00,0,0,0,FMN GV 05 Lier
60,Mechelsesteenweg 365,2023-09-25,00:00:00,0,0,0,FMN GV 05 Lier
60,Mechelsesteenweg 365,2023-09-25,01:00:00,2,0,2,FMN GV 05 Lier
60,Mechelsesteenweg 365,2023-09-25,02:00:00,0,0,0,FMN GV 05 Lier
60,Mechelsesteenweg 365,2023-09-25,03:00:00,2,0,2,FMN GV 05 Lier
60,Mechelsesteenweg 365,2023-09-25,04:00:00,4,0,4,FMN GV 05 Lier
60,Mechelsesteenweg 365,2023-09-25,05:00:00,6,2,4,FMN GV 05 Lier
60,Mechelsesteenweg 365,2023-09-25,06:00:00,42,8,34,FMN GV 05 Lier
60,Mechelsesteenweg 365,2023-09-25,07:00:00,246,132,114,FMN GV 05 Lier
60,Mechelsesteenweg 365,2023-09-25,08:00:00,222,124,98,FMN GV 05 Lier
60,Mechelsesteenweg 365,2023-09-25,09:00:00,78,46,32,FMN GV 05 Lier
60,Mechelsesteenweg 365,2023-09-25,10:00:00,88,48,40,FMN GV 05 Lier
60,Mechelsesteenweg 365,2023-09-25,11:00:00,140,86,54,FMN GV 05 Lier
60,Mechelsesteenweg 365,2023-09-25,12:00:00,120,54,66,FMN GV 05 Lier
60,Mechelsesteenweg 365,2023-09-25,13:00:00,178,72,106,FMN GV 05 Lier
60,Mechelsesteenweg 365,2023-09-25,14:00:00,320,180,140,FMN GV 05 Lier
60,Mechelsesteenweg 365,2023-09-25,15:00:00,356,166,190,FMN GV 05 Lier
60,Mechelsesteenweg 365,2023-09-25,16:00:00,506,214,292,FMN GV 05 Lier
60,Mechelsesteenweg 365,2023-09-25,17:00:00,226,138,88,FMN GV 05 Lier
60,Mechelsesteenweg 365,2023-09-25,18:00:00,154,78,76,FMN GV 05 Lier
60,Mechelsesteenweg 365,2023-09-25,19:00:00,58,30,28,FMN GV 05 Lier
60,Mechelsesteenweg 365,2023-09-25,20:00:00,14,10,4,FMN GV 05 Lier
60,Mechelsesteenweg 365,2023-09-25,21:00:00,2,0,2,FMN GV 05 Lier
60,Mechelsesteenweg 365,2023-09-25,22:00:00,14,4,10,FMN GV 05 Lier
60,Mechelsesteenweg 365,2023-09-25,23:00:00,0,0,0,FMN GV 05 Lier
60,Mechelsesteenweg 365,2023-09-26,00:00:00,0,0,0,FMN GV 05 Lier
60,Mechelsesteenweg 365,2023-09-26,01:00:00,2,2,0,FMN GV 05 Lier
60,Mechelsesteenweg 365,2023-09-26,02:00:00,0,0,0,FMN GV 05 Lier
60,Mechelsesteenweg 365,2023-09-26,03:00:00,2,0,2,FMN GV 05 Lier
60,Mechelsesteenweg 365,2023-09-26,04:00:00,0,0,0,FMN GV 05 Lier
60,Mechelsesteenweg 365,2023-09-26,05:00:00,8,2,6,FMN GV 05 Lier
60,Mechelsesteenweg 365,2023-09-26,06:00:00,30,16,14,FMN GV 05 Lier
60,Mechelsesteenweg 365,2023-09-26,07:00:00,260,128,132,FMN GV 05 Lier
60,Mechelsesteenweg 365,2023-09-26,08:00:00,264,158,106,FMN GV 05 Lier
60,Mechelsesteenweg 365,2023-09-26,09:00:00,148,76,72,FMN GV 05 Lier
60,Mechelsesteenweg 365,2023-09-26,10:00:00,182,66,116,FMN GV 05 Lier
60,Mechelsesteenweg 365,2023-09-26,11:00:00,256,92,164,FMN GV 05 Lier
60,Mechelsesteenweg 365,2023-09-26,12:00:00,228,148,80,FMN GV 05 Lier
60,Mechelsesteenweg 365,2023-09-26,13:00:00,222,116,106,FMN GV 05 Lier
60,Mechelsesteenweg 365,2023-09-26,14:00:00,448,182,266,FMN GV 05 Lier
60,Mechelsesteenweg 365,2023-09-26,15:00:00,318,152,166,FMN GV 05 Lier
60,Mechelsesteenweg 365,2023-09-26,16:00:00,434,154,280,FMN GV 05 Lier
60,Mechelsesteenweg 365,2023-09-26,17:00:00,276,170,106,FMN GV 05 Lier
60,Mechelsesteenweg 365,2023-09-26,18:00:00,224,138,86,FMN GV 05 Lier
60,Mechelsesteenweg 365,2023-09-26,19:00:00,70,36,34,FMN GV 05 Lier
60,Mechelsesteenweg 365,2023-09-26,20:00:00,34,20,14,FMN GV 05 Lier
60,Mechelsesteenweg 365,2023-09-26,21:00:00,32,8,24,FMN GV 05 Lier
60,Mechelsesteenweg 365,2023-09-26,22:00:00,16,14,2,FMN GV 05 Lier
60,Mechelsesteenweg 365,2023-09-26,23:00:00,0,0,0,FMN GV 05 Lier
60,Mechelsesteenweg 365,2023-09-27,00:00:00,0,0,0,FMN GV 05 Lier
60,Mechelsesteenweg 365,2023-09-27,01:00:00,0,0,0,FMN GV 05 Lier
60,Mechelsesteenweg 365,2023-09-27,02:00:00,0,0,0,FMN GV 05 Lier
60,Mechelsesteenweg 365,2023-09-27,03:00:00,4,2,2,FMN GV 05 Lier
60,Mechelsesteenweg 365,2023-09-27,04:00:00,2,0,2,FMN GV 05 Lier
60,Mechelsesteenweg 365,2023-09-27,05:00:00,2,0,2,FMN GV 05 Lier
60,Mechelsesteenweg 365,2023-09-27,06:00:00,44,18,26,FMN GV 05 Lier
60,Mechelsesteenweg 365,2023-09-27,07:00:00,224,124,100,FMN GV 05 Lier
60,Mechelsesteenweg 365,2023-09-27,08:00:00,200,110,90,FMN GV 05 Lier
60,Mechelsesteenweg 365,2023-09-27,09:00:00,104,40,64,FMN GV 05 Lier
60,Mechelsesteenweg 365,2023-09-27,10:00:00,132,78,54,FMN GV 05 Lier
60,Mechelsesteenweg 365,2023-09-27,11:00:00,200,78,122,FMN GV 05 Lier
60,Mechelsesteenweg 365,2023-09-27,12:00:00,340,116,224,FMN GV 05 Lier
60,Mechelsesteenweg 365,2023-09-27,13:00:00,254,140,114,FMN GV 05 Lier
60,Mechelsesteenweg 365,2023-09-27,14:00:00,320,174,146,FMN GV 05 Lier
60,Mechelsesteenweg 365,2023-09-27,15:00:00,312,150,162,FMN GV 05 Lier
60,Mechelsesteenweg 365,2023-09-27,16:00:00,306,142,164,FMN GV 05 Lier
60,Mechelsesteenweg 365,2023-09-27,17:00:00,256,144,112,FMN GV 05 Lier
60,Mechelsesteenweg 365,2023-09-27,18:00:00,168,88,80,FMN GV 05 Lier
60,Mechelsesteenweg 365,2023-09-27,19:00:00,154,82,72,FMN GV 05 Lier
60,Mechelsesteenweg 365,2023-09-27,20:00:00,48,20,28,FMN GV 05 Lier
60,Mechelsesteenweg 365,2023-09-27,21:00:00,14,0,14,FMN GV 05 Lier
60,Mechelsesteenweg 365,2023-09-27,22:00:00,20,10,10,FMN GV 05 Lier
60,Mechelsesteenweg 365,2023-09-27,23:00:00,0,0,0,FMN GV 05 Lier
