Meetpunt surrogate key,Meetpunt locatie,Datum,Tijd,Aantal fietsers,Aantal fietsers van,Aantal fietsers naar,Meetpunt code
660,Statielei 26,2022-08-22,00:00:00,18,8,10,FMN 12 Statielei
660,Statielei 26,2022-08-22,01:00:00,16,10,6,FMN 12 Statielei
660,Statielei 26,2022-08-22,02:00:00,9,6,3,FMN 12 Statielei
660,Statielei 26,2022-08-22,03:00:00,9,3,6,FMN 12 Statielei
660,Statielei 26,2022-08-22,04:00:00,5,3,2,FMN 12 Statielei
660,Statielei 26,2022-08-22,05:00:00,12,5,7,FMN 12 Statielei
660,Statielei 26,2022-08-22,06:00:00,36,15,21,FMN 12 Statielei
660,Statielei 26,2022-08-22,07:00:00,64,30,34,FMN 12 Statielei
660,Statielei 26,2022-08-22,08:00:00,139,77,62,FMN 12 Statielei
660,Statielei 26,2022-08-22,09:00:00,119,67,52,FMN 12 Statielei
660,Statielei 26,2022-08-22,10:00:00,80,53,27,FMN 12 Statielei
660,Statielei 26,2022-08-22,11:00:00,82,50,32,FMN 12 Statielei
660,Statielei 26,2022-08-22,12:00:00,95,47,48,FMN 12 Statielei
660,Statielei 26,2022-08-22,13:00:00,113,55,58,FMN 12 Statielei
660,Statielei 26,2022-08-22,14:00:00,106,58,48,FMN 12 Statielei
660,Statielei 26,2022-08-22,15:00:00,110,51,59,FMN 12 Statielei
660,Statielei 26,2022-08-22,16:00:00,178,100,78,FMN 12 Statielei
660,Statielei 26,2022-08-22,17:00:00,201,92,109,FMN 12 Statielei
660,Statielei 26,2022-08-22,18:00:00,164,82,82,FMN 12 Statielei
660,Statielei 26,2022-08-22,19:00:00,137,55,82,FMN 12 Statielei
660,Statielei 26,2022-08-22,20:00:00,144,71,73,FMN 12 Statielei
660,Statielei 26,2022-08-22,21:00:00,103,59,44,FMN 12 Statielei
660,Statielei 26,2022-08-22,22:00:00,82,46,36,FMN 12 Statielei
660,Statielei 26,2022-08-22,23:00:00,58,32,26,FMN 12 Statielei
660,Statielei 26,2022-08-23,00:00:00,33,21,12,FMN 12 Statielei
660,Statielei 26,2022-08-23,01:00:00,26,11,15,FMN 12 Statielei
660,Statielei 26,2022-08-23,02:00:00,7,2,5,FMN 12 Statielei
660,Statielei 26,2022-08-23,03:00:00,5,3,2,FMN 12 Statielei
660,Statielei 26,2022-08-23,04:00:00,7,4,3,FMN 12 Statielei
660,Statielei 26,2022-08-23,05:00:00,19,9,10,FMN 12 Statielei
660,Statielei 26,2022-08-23,06:00:00,43,22,21,FMN 12 Statielei
660,Statielei 26,2022-08-23,07:00:00,78,40,38,FMN 12 Statielei
660,Statielei 26,2022-08-23,08:00:00,159,88,71,FMN 12 Statielei
660,Statielei 26,2022-08-23,09:00:00,133,83,50,FMN 12 Statielei
660,Statielei 26,2022-08-23,10:00:00,74,47,27,FMN 12 Statielei
660,Statielei 26,2022-08-23,11:00:00,81,41,40,FMN 12 Statielei
660,Statielei 26,2022-08-23,12:00:00,107,53,54,FMN 12 Statielei
660,Statielei 26,2022-08-23,13:00:00,88,45,43,FMN 12 Statielei
660,Statielei 26,2022-08-23,14:00:00,110,60,50,FMN 12 Statielei
660,Statielei 26,2022-08-23,15:00:00,127,65,62,FMN 12 Statielei
660,Statielei 26,2022-08-23,16:00:00,220,106,114,FMN 12 Statielei
660,Statielei 26,2022-08-23,17:00:00,213,94,119,FMN 12 Statielei
660,Statielei 26,2022-08-23,18:00:00,172,84,88,FMN 12 Statielei
660,Statielei 26,2022-08-23,19:00:00,171,75,96,FMN 12 Statielei
660,Statielei 26,2022-08-23,20:00:00,132,78,54,FMN 12 Statielei
660,Statielei 26,2022-08-23,21:00:00,76,36,40,FMN 12 Statielei
660,Statielei 26,2022-08-23,22:00:00,73,34,39,FMN 12 Statielei
660,Statielei 26,2022-08-23,23:00:00,60,38,22,FMN 12 Statielei
660,Statielei 26,2022-08-24,00:00:00,39,16,23,FMN 12 Statielei
660,Statielei 26,2022-08-24,01:00:00,19,11,8,FMN 12 Statielei
660,Statielei 26,2022-08-24,02:00:00,10,5,5,FMN 12 Statielei
660,Statielei 26,2022-08-24,03:00:00,4,1,3,FMN 12 Statielei
660,Statielei 26,2022-08-24,04:00:00,9,2,7,FMN 12 Statielei
660,Statielei 26,2022-08-24,05:00:00,15,8,7,FMN 12 Statielei
660,Statielei 26,2022-08-24,06:00:00,29,7,22,FMN 12 Statielei
660,Statielei 26,2022-08-24,07:00:00,63,31,32,FMN 12 Statielei
660,Statielei 26,2022-08-24,08:00:00,160,97,63,FMN 12 Statielei
660,Statielei 26,2022-08-24,09:00:00,92,60,32,FMN 12 Statielei
660,Statielei 26,2022-08-24,10:00:00,102,58,44,FMN 12 Statielei
660,Statielei 26,2022-08-24,11:00:00,93,49,44,FMN 12 Statielei
660,Statielei 26,2022-08-24,12:00:00,132,71,61,FMN 12 Statielei
660,Statielei 26,2022-08-24,13:00:00,110,54,56,FMN 12 Statielei
660,Statielei 26,2022-08-24,14:00:00,118,62,56,FMN 12 Statielei
660,Statielei 26,2022-08-24,15:00:00,158,87,71,FMN 12 Statielei
660,Statielei 26,2022-08-24,16:00:00,189,79,110,FMN 12 Statielei
660,Statielei 26,2022-08-24,17:00:00,220,106,114,FMN 12 Statielei
660,Statielei 26,2022-08-24,18:00:00,189,101,88,FMN 12 Statielei
660,Statielei 26,2022-08-24,19:00:00,136,75,61,FMN 12 Statielei
660,Statielei 26,2022-08-24,20:00:00,137,69,68,FMN 12 Statielei
660,Statielei 26,2022-08-24,21:00:00,109,49,60,FMN 12 Statielei
660,Statielei 26,2022-08-24,22:00:00,94,52,42,FMN 12 Statielei
660,Statielei 26,2022-08-24,23:00:00,55,24,31,FMN 12 Statielei
660,Statielei 26,2022-08-25,00:00:00,31,9,22,FMN 12 Statielei
660,Statielei 26,2022-08-25,01:00:00,26,11,15,FMN 12 Statielei
660,Statielei 26,2022-08-25,02:00:00,4,1,3,FMN 12 Statielei
660,Statielei 26,2022-08-25,03:00:00,7,3,4,FMN 12 Statielei
660,Statielei 26,2022-08-25,04:00:00,8,4,4,FMN 12 Statielei
660,Statielei 26,2022-08-25,05:00:00,21,11,10,FMN 12 Statielei
660,Statielei 26,2022-08-25,06:00:00,31,14,17,FMN 12 Statielei
660,Statielei 26,2022-08-25,07:00:00,77,41,36,FMN 12 Statielei
660,Statielei 26,2022-08-25,08:00:00,146,77,69,FMN 12 Statielei
660,Statielei 26,2022-08-25,09:00:00,135,87,48,FMN 12 Statielei
660,Statielei 26,2022-08-25,10:00:00,77,49,28,FMN 12 Statielei
660,Statielei 26,2022-08-25,11:00:00,85,44,41,FMN 12 Statielei
660,Statielei 26,2022-08-25,12:00:00,96,41,55,FMN 12 Statielei
660,Statielei 26,2022-08-25,13:00:00,94,49,45,FMN 12 Statielei
660,Statielei 26,2022-08-25,14:00:00,113,55,58,FMN 12 Statielei
660,Statielei 26,2022-08-25,15:00:00,148,70,78,FMN 12 Statielei
660,Statielei 26,2022-08-25,16:00:00,197,90,107,FMN 12 Statielei
660,Statielei 26,2022-08-25,17:00:00,224,101,123,FMN 12 Statielei
660,Statielei 26,2022-08-25,18:00:00,171,97,74,FMN 12 Statielei
660,Statielei 26,2022-08-25,19:00:00,209,80,129,FMN 12 Statielei
660,Statielei 26,2022-08-25,20:00:00,110,54,56,FMN 12 Statielei
660,Statielei 26,2022-08-25,21:00:00,101,54,47,FMN 12 Statielei
660,Statielei 26,2022-08-25,22:00:00,72,44,28,FMN 12 Statielei
660,Statielei 26,2022-08-25,23:00:00,98,57,41,FMN 12 Statielei
660,Statielei 26,2022-08-26,00:00:00,52,25,27,FMN 12 Statielei
660,Statielei 26,2022-08-26,01:00:00,26,10,16,FMN 12 Statielei
660,Statielei 26,2022-08-26,02:00:00,13,4,9,FMN 12 Statielei
660,Statielei 26,2022-08-26,03:00:00,5,1,4,FMN 12 Statielei
660,Statielei 26,2022-08-26,04:00:00,15,4,11,FMN 12 Statielei
660,Statielei 26,2022-08-26,05:00:00,9,6,3,FMN 12 Statielei
660,Statielei 26,2022-08-26,06:00:00,40,21,19,FMN 12 Statielei
660,Statielei 26,2022-08-26,07:00:00,76,40,36,FMN 12 Statielei
660,Statielei 26,2022-08-26,08:00:00,127,78,49,FMN 12 Statielei
660,Statielei 26,2022-08-26,09:00:00,124,78,46,FMN 12 Statielei
660,Statielei 26,2022-08-26,10:00:00,92,54,38,FMN 12 Statielei
660,Statielei 26,2022-08-26,11:00:00,97,61,36,FMN 12 Statielei
660,Statielei 26,2022-08-26,12:00:00,99,45,54,FMN 12 Statielei
660,Statielei 26,2022-08-26,13:00:00,96,57,39,FMN 12 Statielei
660,Statielei 26,2022-08-26,14:00:00,119,59,60,FMN 12 Statielei
660,Statielei 26,2022-08-26,15:00:00,139,62,77,FMN 12 Statielei
660,Statielei 26,2022-08-26,16:00:00,183,97,86,FMN 12 Statielei
660,Statielei 26,2022-08-26,17:00:00,202,97,105,FMN 12 Statielei
660,Statielei 26,2022-08-26,18:00:00,160,79,81,FMN 12 Statielei
660,Statielei 26,2022-08-26,19:00:00,156,87,69,FMN 12 Statielei
660,Statielei 26,2022-08-26,20:00:00,128,76,52,FMN 12 Statielei
660,Statielei 26,2022-08-26,21:00:00,85,41,44,FMN 12 Statielei
660,Statielei 26,2022-08-26,22:00:00,101,48,53,FMN 12 Statielei
660,Statielei 26,2022-08-26,23:00:00,74,32,42,FMN 12 Statielei
660,Statielei 26,2022-08-27,00:00:00,44,19,25,FMN 12 Statielei
660,Statielei 26,2022-08-27,01:00:00,38,15,23,FMN 12 Statielei
660,Statielei 26,2022-08-27,02:00:00,20,8,12,FMN 12 Statielei
660,Statielei 26,2022-08-27,03:00:00,15,3,12,FMN 12 Statielei
660,Statielei 26,2022-08-27,04:00:00,7,2,5,FMN 12 Statielei
660,Statielei 26,2022-08-27,05:00:00,16,5,11,FMN 12 Statielei
660,Statielei 26,2022-08-27,06:00:00,8,4,4,FMN 12 Statielei
660,Statielei 26,2022-08-27,07:00:00,21,12,9,FMN 12 Statielei
660,Statielei 26,2022-08-27,08:00:00,32,16,16,FMN 12 Statielei
660,Statielei 26,2022-08-27,09:00:00,84,42,42,FMN 12 Statielei
660,Statielei 26,2022-08-27,10:00:00,107,59,48,FMN 12 Statielei
660,Statielei 26,2022-08-27,11:00:00,85,47,38,FMN 12 Statielei
660,Statielei 26,2022-08-27,12:00:00,128,70,58,FMN 12 Statielei
660,Statielei 26,2022-08-27,13:00:00,148,79,69,FMN 12 Statielei
660,Statielei 26,2022-08-27,14:00:00,138,68,70,FMN 12 Statielei
660,Statielei 26,2022-08-27,15:00:00,120,61,59,FMN 12 Statielei
660,Statielei 26,2022-08-27,16:00:00,168,93,75,FMN 12 Statielei
660,Statielei 26,2022-08-27,17:00:00,128,60,68,FMN 12 Statielei
660,Statielei 26,2022-08-27,18:00:00,144,69,75,FMN 12 Statielei
660,Statielei 26,2022-08-27,19:00:00,132,67,65,FMN 12 Statielei
660,Statielei 26,2022-08-27,20:00:00,110,75,35,FMN 12 Statielei
660,Statielei 26,2022-08-27,21:00:00,95,52,43,FMN 12 Statielei
660,Statielei 26,2022-08-27,22:00:00,52,27,25,FMN 12 Statielei
660,Statielei 26,2022-08-27,23:00:00,65,35,30,FMN 12 Statielei
660,Statielei 26,2022-08-28,00:00:00,46,24,22,FMN 12 Statielei
660,Statielei 26,2022-08-28,01:00:00,30,12,18,FMN 12 Statielei
660,Statielei 26,2022-08-28,02:00:00,25,6,19,FMN 12 Statielei
660,Statielei 26,2022-08-28,03:00:00,9,1,8,FMN 12 Statielei
660,Statielei 26,2022-08-28,04:00:00,10,4,6,FMN 12 Statielei
660,Statielei 26,2022-08-28,05:00:00,8,2,6,FMN 12 Statielei
660,Statielei 26,2022-08-28,06:00:00,8,4,4,FMN 12 Statielei
660,Statielei 26,2022-08-28,07:00:00,14,8,6,FMN 12 Statielei
660,Statielei 26,2022-08-28,08:00:00,30,16,14,FMN 12 Statielei
660,Statielei 26,2022-08-28,09:00:00,38,19,19,FMN 12 Statielei
660,Statielei 26,2022-08-28,10:00:00,91,49,42,FMN 12 Statielei
660,Statielei 26,2022-08-28,11:00:00,105,62,43,FMN 12 Statielei
660,Statielei 26,2022-08-28,12:00:00,120,67,53,FMN 12 Statielei
660,Statielei 26,2022-08-28,13:00:00,103,52,51,FMN 12 Statielei
660,Statielei 26,2022-08-28,14:00:00,155,95,60,FMN 12 Statielei
660,Statielei 26,2022-08-28,15:00:00,153,63,90,FMN 12 Statielei
660,Statielei 26,2022-08-28,16:00:00,139,77,62,FMN 12 Statielei
660,Statielei 26,2022-08-28,17:00:00,142,61,81,FMN 12 Statielei
660,Statielei 26,2022-08-28,18:00:00,138,75,63,FMN 12 Statielei
660,Statielei 26,2022-08-28,19:00:00,149,81,68,FMN 12 Statielei
660,Statielei 26,2022-08-28,20:00:00,135,68,67,FMN 12 Statielei
660,Statielei 26,2022-08-28,21:00:00,94,52,42,FMN 12 Statielei
660,Statielei 26,2022-08-28,22:00:00,51,26,25,FMN 12 Statielei
660,Statielei 26,2022-08-28,23:00:00,35,12,23,FMN 12 Statielei
660,Statielei 26,2022-08-29,00:00:00,15,6,9,FMN 12 Statielei
660,Statielei 26,2022-08-29,01:00:00,18,10,8,FMN 12 Statielei
660,Statielei 26,2022-08-29,02:00:00,9,4,5,FMN 12 Statielei
660,Statielei 26,2022-08-29,03:00:00,3,1,2,FMN 12 Statielei
660,Statielei 26,2022-08-29,04:00:00,11,7,4,FMN 12 Statielei
660,Statielei 26,2022-08-29,05:00:00,17,7,10,FMN 12 Statielei
660,Statielei 26,2022-08-29,06:00:00,32,18,14,FMN 12 Statielei
660,Statielei 26,2022-08-29,07:00:00,78,35,43,FMN 12 Statielei
660,Statielei 26,2022-08-29,08:00:00,157,103,54,FMN 12 Statielei
660,Statielei 26,2022-08-29,09:00:00,99,52,47,FMN 12 Statielei
660,Statielei 26,2022-08-29,10:00:00,96,57,39,FMN 12 Statielei
660,Statielei 26,2022-08-29,11:00:00,86,47,39,FMN 12 Statielei
660,Statielei 26,2022-08-29,12:00:00,98,47,51,FMN 12 Statielei
660,Statielei 26,2022-08-29,13:00:00,104,59,45,FMN 12 Statielei
660,Statielei 26,2022-08-29,14:00:00,102,45,57,FMN 12 Statielei
660,Statielei 26,2022-08-29,15:00:00,0,0,0,FMN 12 Statielei
660,Statielei 26,2022-08-29,16:00:00,28,13,15,FMN 12 Statielei
660,Statielei 26,2022-08-29,17:00:00,234,106,128,FMN 12 Statielei
660,Statielei 26,2022-08-29,18:00:00,181,96,85,FMN 12 Statielei
660,Statielei 26,2022-08-29,19:00:00,157,83,74,FMN 12 Statielei
660,Statielei 26,2022-08-29,20:00:00,111,61,50,FMN 12 Statielei
660,Statielei 26,2022-08-29,21:00:00,97,44,53,FMN 12 Statielei
660,Statielei 26,2022-08-29,22:00:00,47,21,26,FMN 12 Statielei
660,Statielei 26,2022-08-29,23:00:00,61,24,37,FMN 12 Statielei
660,Statielei 26,2022-08-30,00:00:00,31,13,18,FMN 12 Statielei
660,Statielei 26,2022-08-30,01:00:00,19,7,12,FMN 12 Statielei
660,Statielei 26,2022-08-30,02:00:00,8,3,5,FMN 12 Statielei
660,Statielei 26,2022-08-30,03:00:00,6,2,4,FMN 12 Statielei
660,Statielei 26,2022-08-30,04:00:00,10,6,4,FMN 12 Statielei
660,Statielei 26,2022-08-30,05:00:00,18,7,11,FMN 12 Statielei
660,Statielei 26,2022-08-30,06:00:00,33,19,14,FMN 12 Statielei
660,Statielei 26,2022-08-30,07:00:00,83,40,43,FMN 12 Statielei
660,Statielei 26,2022-08-30,08:00:00,176,106,70,FMN 12 Statielei
660,Statielei 26,2022-08-30,09:00:00,138,88,50,FMN 12 Statielei
660,Statielei 26,2022-08-30,10:00:00,111,71,40,FMN 12 Statielei
660,Statielei 26,2022-08-30,11:00:00,105,50,55,FMN 12 Statielei
660,Statielei 26,2022-08-30,12:00:00,112,62,50,FMN 12 Statielei
660,Statielei 26,2022-08-30,13:00:00,103,59,44,FMN 12 Statielei
660,Statielei 26,2022-08-30,14:00:00,163,84,79,FMN 12 Statielei
660,Statielei 26,2022-08-30,15:00:00,146,82,64,FMN 12 Statielei
660,Statielei 26,2022-08-30,16:00:00,196,77,119,FMN 12 Statielei
660,Statielei 26,2022-08-30,17:00:00,210,91,119,FMN 12 Statielei
660,Statielei 26,2022-08-30,18:00:00,212,108,104,FMN 12 Statielei
660,Statielei 26,2022-08-30,19:00:00,172,79,93,FMN 12 Statielei
660,Statielei 26,2022-08-30,20:00:00,127,66,61,FMN 12 Statielei
660,Statielei 26,2022-08-30,21:00:00,73,31,42,FMN 12 Statielei
660,Statielei 26,2022-08-30,22:00:00,83,49,34,FMN 12 Statielei
660,Statielei 26,2022-08-30,23:00:00,66,35,31,FMN 12 Statielei
660,Statielei 26,2022-08-31,00:00:00,32,13,19,FMN 12 Statielei
660,Statielei 26,2022-08-31,01:00:00,23,10,13,FMN 12 Statielei
660,Statielei 26,2022-08-31,02:00:00,13,5,8,FMN 12 Statielei
660,Statielei 26,2022-08-31,03:00:00,3,0,3,FMN 12 Statielei
660,Statielei 26,2022-08-31,04:00:00,14,7,7,FMN 12 Statielei
660,Statielei 26,2022-08-31,05:00:00,21,12,9,FMN 12 Statielei
660,Statielei 26,2022-08-31,06:00:00,34,21,13,FMN 12 Statielei
660,Statielei 26,2022-08-31,07:00:00,80,44,36,FMN 12 Statielei
660,Statielei 26,2022-08-31,08:00:00,165,93,72,FMN 12 Statielei
660,Statielei 26,2022-08-31,09:00:00,103,65,38,FMN 12 Statielei
660,Statielei 26,2022-08-31,10:00:00,88,49,39,FMN 12 Statielei
660,Statielei 26,2022-08-31,11:00:00,101,60,41,FMN 12 Statielei
660,Statielei 26,2022-08-31,12:00:00,124,63,61,FMN 12 Statielei
660,Statielei 26,2022-08-31,13:00:00,148,56,92,FMN 12 Statielei
660,Statielei 26,2022-08-31,14:00:00,141,76,65,FMN 12 Statielei
660,Statielei 26,2022-08-31,15:00:00,199,111,88,FMN 12 Statielei
660,Statielei 26,2022-08-31,16:00:00,223,105,118,FMN 12 Statielei
660,Statielei 26,2022-08-31,17:00:00,262,124,138,FMN 12 Statielei
660,Statielei 26,2022-08-31,18:00:00,179,96,83,FMN 12 Statielei
660,Statielei 26,2022-08-31,19:00:00,205,65,140,FMN 12 Statielei
660,Statielei 26,2022-08-31,20:00:00,119,60,59,FMN 12 Statielei
660,Statielei 26,2022-08-31,21:00:00,80,39,41,FMN 12 Statielei
660,Statielei 26,2022-08-31,22:00:00,100,57,43,FMN 12 Statielei
660,Statielei 26,2022-08-31,23:00:00,90,54,36,FMN 12 Statielei
660,Statielei 26,2022-09-01,00:00:00,31,18,13,FMN 12 Statielei
660,Statielei 26,2022-09-01,01:00:00,18,7,11,FMN 12 Statielei
660,Statielei 26,2022-09-01,02:00:00,16,3,13,FMN 12 Statielei
660,Statielei 26,2022-09-01,03:00:00,4,1,3,FMN 12 Statielei
660,Statielei 26,2022-09-01,04:00:00,9,5,4,FMN 12 Statielei
660,Statielei 26,2022-09-01,05:00:00,15,12,3,FMN 12 Statielei
660,Statielei 26,2022-09-01,06:00:00,36,16,20,FMN 12 Statielei
660,Statielei 26,2022-09-01,07:00:00,136,67,69,FMN 12 Statielei
660,Statielei 26,2022-09-01,08:00:00,302,163,139,FMN 12 Statielei
660,Statielei 26,2022-09-01,09:00:00,183,97,86,FMN 12 Statielei
660,Statielei 26,2022-09-01,10:00:00,81,40,41,FMN 12 Statielei
660,Statielei 26,2022-09-01,11:00:00,85,47,38,FMN 12 Statielei
660,Statielei 26,2022-09-01,12:00:00,136,82,54,FMN 12 Statielei
660,Statielei 26,2022-09-01,13:00:00,127,55,72,FMN 12 Statielei
660,Statielei 26,2022-09-01,14:00:00,124,65,59,FMN 12 Statielei
660,Statielei 26,2022-09-01,15:00:00,212,92,120,FMN 12 Statielei
660,Statielei 26,2022-09-01,16:00:00,282,159,123,FMN 12 Statielei
660,Statielei 26,2022-09-01,17:00:00,250,116,134,FMN 12 Statielei
660,Statielei 26,2022-09-01,18:00:00,202,118,84,FMN 12 Statielei
660,Statielei 26,2022-09-01,19:00:00,141,69,72,FMN 12 Statielei
660,Statielei 26,2022-09-01,20:00:00,136,81,55,FMN 12 Statielei
660,Statielei 26,2022-09-01,21:00:00,88,43,45,FMN 12 Statielei
660,Statielei 26,2022-09-01,22:00:00,91,48,43,FMN 12 Statielei
660,Statielei 26,2022-09-01,23:00:00,78,25,53,FMN 12 Statielei
660,Statielei 26,2022-09-02,00:00:00,33,12,21,FMN 12 Statielei
660,Statielei 26,2022-09-02,01:00:00,23,6,17,FMN 12 Statielei
660,Statielei 26,2022-09-02,02:00:00,10,1,9,FMN 12 Statielei
660,Statielei 26,2022-09-02,03:00:00,3,2,1,FMN 12 Statielei
660,Statielei 26,2022-09-02,04:00:00,11,6,5,FMN 12 Statielei
660,Statielei 26,2022-09-02,05:00:00,17,11,6,FMN 12 Statielei
660,Statielei 26,2022-09-02,06:00:00,33,17,16,FMN 12 Statielei
660,Statielei 26,2022-09-02,07:00:00,152,63,89,FMN 12 Statielei
660,Statielei 26,2022-09-02,08:00:00,267,143,124,FMN 12 Statielei
660,Statielei 26,2022-09-02,09:00:00,114,83,31,FMN 12 Statielei
660,Statielei 26,2022-09-02,10:00:00,93,56,37,FMN 12 Statielei
660,Statielei 26,2022-09-02,11:00:00,90,55,35,FMN 12 Statielei
660,Statielei 26,2022-09-02,12:00:00,97,48,49,FMN 12 Statielei
660,Statielei 26,2022-09-02,13:00:00,105,50,55,FMN 12 Statielei
660,Statielei 26,2022-09-02,14:00:00,111,54,57,FMN 12 Statielei
660,Statielei 26,2022-09-02,15:00:00,202,94,108,FMN 12 Statielei
660,Statielei 26,2022-09-02,16:00:00,245,133,112,FMN 12 Statielei
660,Statielei 26,2022-09-02,17:00:00,244,118,126,FMN 12 Statielei
660,Statielei 26,2022-09-02,18:00:00,171,80,91,FMN 12 Statielei
660,Statielei 26,2022-09-02,19:00:00,168,107,61,FMN 12 Statielei
660,Statielei 26,2022-09-02,20:00:00,144,85,59,FMN 12 Statielei
660,Statielei 26,2022-09-02,21:00:00,113,58,55,FMN 12 Statielei
660,Statielei 26,2022-09-02,22:00:00,116,63,53,FMN 12 Statielei
660,Statielei 26,2022-09-02,23:00:00,83,36,47,FMN 12 Statielei
660,Statielei 26,2022-09-03,00:00:00,76,35,41,FMN 12 Statielei
660,Statielei 26,2022-09-03,01:00:00,28,6,22,FMN 12 Statielei
660,Statielei 26,2022-09-03,02:00:00,30,12,18,FMN 12 Statielei
660,Statielei 26,2022-09-03,03:00:00,14,5,9,FMN 12 Statielei
660,Statielei 26,2022-09-03,04:00:00,15,9,6,FMN 12 Statielei
660,Statielei 26,2022-09-03,05:00:00,12,8,4,FMN 12 Statielei
660,Statielei 26,2022-09-03,06:00:00,10,6,4,FMN 12 Statielei
660,Statielei 26,2022-09-03,07:00:00,24,11,13,FMN 12 Statielei
660,Statielei 26,2022-09-03,08:00:00,57,27,30,FMN 12 Statielei
660,Statielei 26,2022-09-03,09:00:00,79,43,36,FMN 12 Statielei
660,Statielei 26,2022-09-03,10:00:00,97,57,40,FMN 12 Statielei
660,Statielei 26,2022-09-03,11:00:00,115,64,51,FMN 12 Statielei
660,Statielei 26,2022-09-03,12:00:00,157,86,71,FMN 12 Statielei
660,Statielei 26,2022-09-03,13:00:00,148,72,76,FMN 12 Statielei
660,Statielei 26,2022-09-03,14:00:00,148,86,62,FMN 12 Statielei
660,Statielei 26,2022-09-03,15:00:00,210,113,97,FMN 12 Statielei
660,Statielei 26,2022-09-03,16:00:00,155,68,87,FMN 12 Statielei
660,Statielei 26,2022-09-03,17:00:00,168,92,76,FMN 12 Statielei
660,Statielei 26,2022-09-03,18:00:00,194,110,84,FMN 12 Statielei
660,Statielei 26,2022-09-03,19:00:00,153,91,62,FMN 12 Statielei
660,Statielei 26,2022-09-03,20:00:00,140,76,64,FMN 12 Statielei
660,Statielei 26,2022-09-03,21:00:00,128,69,59,FMN 12 Statielei
660,Statielei 26,2022-09-03,22:00:00,83,37,46,FMN 12 Statielei
660,Statielei 26,2022-09-03,23:00:00,68,28,40,FMN 12 Statielei
660,Statielei 26,2022-09-04,00:00:00,84,38,46,FMN 12 Statielei
660,Statielei 26,2022-09-04,01:00:00,28,11,17,FMN 12 Statielei
660,Statielei 26,2022-09-04,02:00:00,39,18,21,FMN 12 Statielei
660,Statielei 26,2022-09-04,03:00:00,16,8,8,FMN 12 Statielei
660,Statielei 26,2022-09-04,04:00:00,14,8,6,FMN 12 Statielei
660,Statielei 26,2022-09-04,05:00:00,13,4,9,FMN 12 Statielei
660,Statielei 26,2022-09-04,06:00:00,11,7,4,FMN 12 Statielei
660,Statielei 26,2022-09-04,07:00:00,17,6,11,FMN 12 Statielei
660,Statielei 26,2022-09-04,08:00:00,41,22,19,FMN 12 Statielei
660,Statielei 26,2022-09-04,09:00:00,86,37,49,FMN 12 Statielei
660,Statielei 26,2022-09-04,10:00:00,144,77,67,FMN 12 Statielei
660,Statielei 26,2022-09-04,11:00:00,113,62,51,FMN 12 Statielei
660,Statielei 26,2022-09-04,12:00:00,166,101,65,FMN 12 Statielei
660,Statielei 26,2022-09-04,13:00:00,149,69,80,FMN 12 Statielei
660,Statielei 26,2022-09-04,14:00:00,182,83,99,FMN 12 Statielei
660,Statielei 26,2022-09-04,15:00:00,166,81,85,FMN 12 Statielei
660,Statielei 26,2022-09-04,16:00:00,137,62,75,FMN 12 Statielei
660,Statielei 26,2022-09-04,17:00:00,154,85,69,FMN 12 Statielei
660,Statielei 26,2022-09-04,18:00:00,180,106,74,FMN 12 Statielei
660,Statielei 26,2022-09-04,19:00:00,118,71,47,FMN 12 Statielei
660,Statielei 26,2022-09-04,20:00:00,114,53,61,FMN 12 Statielei
660,Statielei 26,2022-09-04,21:00:00,86,39,47,FMN 12 Statielei
660,Statielei 26,2022-09-04,22:00:00,71,46,25,FMN 12 Statielei
660,Statielei 26,2022-09-04,23:00:00,59,22,37,FMN 12 Statielei
660,Statielei 26,2022-09-05,00:00:00,55,21,34,FMN 12 Statielei
660,Statielei 26,2022-09-05,01:00:00,14,6,8,FMN 12 Statielei
660,Statielei 26,2022-09-05,02:00:00,5,2,3,FMN 12 Statielei
660,Statielei 26,2022-09-05,03:00:00,1,1,0,FMN 12 Statielei
660,Statielei 26,2022-09-05,04:00:00,8,4,4,FMN 12 Statielei
660,Statielei 26,2022-09-05,05:00:00,11,7,4,FMN 12 Statielei
660,Statielei 26,2022-09-05,06:00:00,36,16,20,FMN 12 Statielei
660,Statielei 26,2022-09-05,07:00:00,151,67,84,FMN 12 Statielei
660,Statielei 26,2022-09-05,08:00:00,312,159,153,FMN 12 Statielei
660,Statielei 26,2022-09-05,09:00:00,112,80,32,FMN 12 Statielei
660,Statielei 26,2022-09-05,10:00:00,91,50,41,FMN 12 Statielei
660,Statielei 26,2022-09-05,11:00:00,103,60,43,FMN 12 Statielei
660,Statielei 26,2022-09-05,12:00:00,102,55,47,FMN 12 Statielei
660,Statielei 26,2022-09-05,13:00:00,113,62,51,FMN 12 Statielei
660,Statielei 26,2022-09-05,14:00:00,119,63,56,FMN 12 Statielei
660,Statielei 26,2022-09-05,15:00:00,188,86,102,FMN 12 Statielei
660,Statielei 26,2022-09-05,16:00:00,274,148,126,FMN 12 Statielei
660,Statielei 26,2022-09-05,17:00:00,279,127,152,FMN 12 Statielei
660,Statielei 26,2022-09-05,18:00:00,181,90,91,FMN 12 Statielei
660,Statielei 26,2022-09-05,19:00:00,158,64,94,FMN 12 Statielei
660,Statielei 26,2022-09-05,20:00:00,136,54,82,FMN 12 Statielei
660,Statielei 26,2022-09-05,21:00:00,63,27,36,FMN 12 Statielei
660,Statielei 26,2022-09-05,22:00:00,127,84,43,FMN 12 Statielei
660,Statielei 26,2022-09-05,23:00:00,66,43,23,FMN 12 Statielei
660,Statielei 26,2022-09-06,00:00:00,11,2,9,FMN 12 Statielei
660,Statielei 26,2022-09-06,01:00:00,8,3,5,FMN 12 Statielei
660,Statielei 26,2022-09-06,02:00:00,10,3,7,FMN 12 Statielei
660,Statielei 26,2022-09-06,03:00:00,2,2,0,FMN 12 Statielei
660,Statielei 26,2022-09-06,04:00:00,8,2,6,FMN 12 Statielei
660,Statielei 26,2022-09-06,05:00:00,12,6,6,FMN 12 Statielei
660,Statielei 26,2022-09-06,06:00:00,28,15,13,FMN 12 Statielei
660,Statielei 26,2022-09-06,07:00:00,166,80,86,FMN 12 Statielei
660,Statielei 26,2022-09-06,08:00:00,326,183,143,FMN 12 Statielei
660,Statielei 26,2022-09-06,09:00:00,128,79,49,FMN 12 Statielei
660,Statielei 26,2022-09-06,10:00:00,79,52,27,FMN 12 Statielei
660,Statielei 26,2022-09-06,11:00:00,84,44,40,FMN 12 Statielei
660,Statielei 26,2022-09-06,12:00:00,126,66,60,FMN 12 Statielei
660,Statielei 26,2022-09-06,13:00:00,107,55,52,FMN 12 Statielei
660,Statielei 26,2022-09-06,14:00:00,126,65,61,FMN 12 Statielei
660,Statielei 26,2022-09-06,15:00:00,161,76,85,FMN 12 Statielei
660,Statielei 26,2022-09-06,16:00:00,337,172,165,FMN 12 Statielei
660,Statielei 26,2022-09-06,17:00:00,276,112,164,FMN 12 Statielei
660,Statielei 26,2022-09-06,18:00:00,219,115,104,FMN 12 Statielei
660,Statielei 26,2022-09-06,19:00:00,173,96,77,FMN 12 Statielei
660,Statielei 26,2022-09-06,20:00:00,152,76,76,FMN 12 Statielei
660,Statielei 26,2022-09-06,21:00:00,103,59,44,FMN 12 Statielei
660,Statielei 26,2022-09-06,22:00:00,94,49,45,FMN 12 Statielei
660,Statielei 26,2022-09-06,23:00:00,52,15,37,FMN 12 Statielei
660,Statielei 26,2022-09-07,00:00:00,10,2,8,FMN 12 Statielei
660,Statielei 26,2022-09-07,01:00:00,9,5,4,FMN 12 Statielei
660,Statielei 26,2022-09-07,02:00:00,16,4,12,FMN 12 Statielei
660,Statielei 26,2022-09-07,03:00:00,0,0,0,FMN 12 Statielei
660,Statielei 26,2022-09-07,04:00:00,11,6,5,FMN 12 Statielei
660,Statielei 26,2022-09-07,05:00:00,21,12,9,FMN 12 Statielei
660,Statielei 26,2022-09-07,06:00:00,36,18,18,FMN 12 Statielei
660,Statielei 26,2022-09-07,07:00:00,138,70,68,FMN 12 Statielei
660,Statielei 26,2022-09-07,08:00:00,283,147,136,FMN 12 Statielei
660,Statielei 26,2022-09-07,09:00:00,130,88,42,FMN 12 Statielei
660,Statielei 26,2022-09-07,10:00:00,81,47,34,FMN 12 Statielei
660,Statielei 26,2022-09-07,11:00:00,119,63,56,FMN 12 Statielei
660,Statielei 26,2022-09-07,12:00:00,267,135,132,FMN 12 Statielei
660,Statielei 26,2022-09-07,13:00:00,159,77,82,FMN 12 Statielei
660,Statielei 26,2022-09-07,14:00:00,129,69,60,FMN 12 Statielei
660,Statielei 26,2022-09-07,15:00:00,174,73,101,FMN 12 Statielei
660,Statielei 26,2022-09-07,16:00:00,228,103,125,FMN 12 Statielei
660,Statielei 26,2022-09-07,17:00:00,217,106,111,FMN 12 Statielei
660,Statielei 26,2022-09-07,18:00:00,200,107,93,FMN 12 Statielei
660,Statielei 26,2022-09-07,19:00:00,183,106,77,FMN 12 Statielei
660,Statielei 26,2022-09-07,20:00:00,173,92,81,FMN 12 Statielei
660,Statielei 26,2022-09-07,21:00:00,97,62,35,FMN 12 Statielei
660,Statielei 26,2022-09-07,22:00:00,101,44,57,FMN 12 Statielei
660,Statielei 26,2022-09-07,23:00:00,59,30,29,FMN 12 Statielei
660,Statielei 26,2022-09-08,00:00:00,24,8,16,FMN 12 Statielei
660,Statielei 26,2022-09-08,01:00:00,19,8,11,FMN 12 Statielei
660,Statielei 26,2022-09-08,02:00:00,7,1,6,FMN 12 Statielei
660,Statielei 26,2022-09-08,03:00:00,8,6,2,FMN 12 Statielei
660,Statielei 26,2022-09-08,04:00:00,9,2,7,FMN 12 Statielei
660,Statielei 26,2022-09-08,05:00:00,17,12,5,FMN 12 Statielei
660,Statielei 26,2022-09-08,06:00:00,22,11,11,FMN 12 Statielei
660,Statielei 26,2022-09-08,07:00:00,135,68,67,FMN 12 Statielei
660,Statielei 26,2022-09-08,08:00:00,303,159,144,FMN 12 Statielei
660,Statielei 26,2022-09-08,09:00:00,120,78,42,FMN 12 Statielei
660,Statielei 26,2022-09-08,10:00:00,74,49,25,FMN 12 Statielei
660,Statielei 26,2022-09-08,11:00:00,68,43,25,FMN 12 Statielei
660,Statielei 26,2022-09-08,12:00:00,133,67,66,FMN 12 Statielei
660,Statielei 26,2022-09-08,13:00:00,97,52,45,FMN 12 Statielei
660,Statielei 26,2022-09-08,14:00:00,119,63,56,FMN 12 Statielei
660,Statielei 26,2022-09-08,15:00:00,156,66,90,FMN 12 Statielei
660,Statielei 26,2022-09-08,16:00:00,225,110,115,FMN 12 Statielei
660,Statielei 26,2022-09-08,17:00:00,249,99,150,FMN 12 Statielei
660,Statielei 26,2022-09-08,18:00:00,200,103,97,FMN 12 Statielei
660,Statielei 26,2022-09-08,19:00:00,139,81,58,FMN 12 Statielei
660,Statielei 26,2022-09-08,20:00:00,95,59,36,FMN 12 Statielei
660,Statielei 26,2022-09-08,21:00:00,97,41,56,FMN 12 Statielei
660,Statielei 26,2022-09-08,22:00:00,55,28,27,FMN 12 Statielei
660,Statielei 26,2022-09-08,23:00:00,45,22,23,FMN 12 Statielei
660,Statielei 26,2022-09-09,00:00:00,22,9,13,FMN 12 Statielei
660,Statielei 26,2022-09-09,01:00:00,13,10,3,FMN 12 Statielei
660,Statielei 26,2022-09-09,02:00:00,10,6,4,FMN 12 Statielei
660,Statielei 26,2022-09-09,03:00:00,7,1,6,FMN 12 Statielei
660,Statielei 26,2022-09-09,04:00:00,11,5,6,FMN 12 Statielei
660,Statielei 26,2022-09-09,05:00:00,15,10,5,FMN 12 Statielei
660,Statielei 26,2022-09-09,06:00:00,32,15,17,FMN 12 Statielei
660,Statielei 26,2022-09-09,07:00:00,118,59,59,FMN 12 Statielei
660,Statielei 26,2022-09-09,08:00:00,272,146,126,FMN 12 Statielei
660,Statielei 26,2022-09-09,09:00:00,109,68,41,FMN 12 Statielei
660,Statielei 26,2022-09-09,10:00:00,71,36,35,FMN 12 Statielei
660,Statielei 26,2022-09-09,11:00:00,57,33,24,FMN 12 Statielei
660,Statielei 26,2022-09-09,12:00:00,93,44,49,FMN 12 Statielei
660,Statielei 26,2022-09-09,13:00:00,71,29,42,FMN 12 Statielei
660,Statielei 26,2022-09-09,14:00:00,97,45,52,FMN 12 Statielei
660,Statielei 26,2022-09-09,15:00:00,173,92,81,FMN 12 Statielei
660,Statielei 26,2022-09-09,16:00:00,239,124,115,FMN 12 Statielei
660,Statielei 26,2022-09-09,17:00:00,191,81,110,FMN 12 Statielei
660,Statielei 26,2022-09-09,18:00:00,133,73,60,FMN 12 Statielei
660,Statielei 26,2022-09-09,19:00:00,108,64,44,FMN 12 Statielei
660,Statielei 26,2022-09-09,20:00:00,99,48,51,FMN 12 Statielei
660,Statielei 26,2022-09-09,21:00:00,61,31,30,FMN 12 Statielei
660,Statielei 26,2022-09-09,22:00:00,65,39,26,FMN 12 Statielei
660,Statielei 26,2022-09-09,23:00:00,46,25,21,FMN 12 Statielei
660,Statielei 26,2022-09-10,00:00:00,39,13,26,FMN 12 Statielei
660,Statielei 26,2022-09-10,01:00:00,21,3,18,FMN 12 Statielei
660,Statielei 26,2022-09-10,02:00:00,13,7,6,FMN 12 Statielei
660,Statielei 26,2022-09-10,03:00:00,2,2,0,FMN 12 Statielei
660,Statielei 26,2022-09-10,04:00:00,7,5,2,FMN 12 Statielei
660,Statielei 26,2022-09-10,05:00:00,13,9,4,FMN 12 Statielei
660,Statielei 26,2022-09-10,06:00:00,4,2,2,FMN 12 Statielei
660,Statielei 26,2022-09-10,07:00:00,10,3,7,FMN 12 Statielei
660,Statielei 26,2022-09-10,08:00:00,28,11,17,FMN 12 Statielei
660,Statielei 26,2022-09-10,09:00:00,44,20,24,FMN 12 Statielei
660,Statielei 26,2022-09-10,10:00:00,42,18,24,FMN 12 Statielei
660,Statielei 26,2022-09-10,11:00:00,69,35,34,FMN 12 Statielei
660,Statielei 26,2022-09-10,12:00:00,79,47,32,FMN 12 Statielei
660,Statielei 26,2022-09-10,13:00:00,64,33,31,FMN 12 Statielei
660,Statielei 26,2022-09-10,14:00:00,78,41,37,FMN 12 Statielei
660,Statielei 26,2022-09-10,15:00:00,75,36,39,FMN 12 Statielei
660,Statielei 26,2022-09-10,16:00:00,108,46,62,FMN 12 Statielei
660,Statielei 26,2022-09-10,17:00:00,115,68,47,FMN 12 Statielei
660,Statielei 26,2022-09-10,18:00:00,133,68,65,FMN 12 Statielei
660,Statielei 26,2022-09-10,19:00:00,127,67,60,FMN 12 Statielei
660,Statielei 26,2022-09-10,20:00:00,137,49,88,FMN 12 Statielei
660,Statielei 26,2022-09-10,21:00:00,66,30,36,FMN 12 Statielei
660,Statielei 26,2022-09-10,22:00:00,69,39,30,FMN 12 Statielei
660,Statielei 26,2022-09-10,23:00:00,59,30,29,FMN 12 Statielei
660,Statielei 26,2022-09-11,00:00:00,40,24,16,FMN 12 Statielei
660,Statielei 26,2022-09-11,01:00:00,29,9,20,FMN 12 Statielei
660,Statielei 26,2022-09-11,02:00:00,27,8,19,FMN 12 Statielei
660,Statielei 26,2022-09-11,03:00:00,11,5,6,FMN 12 Statielei
660,Statielei 26,2022-09-11,04:00:00,12,8,4,FMN 12 Statielei
660,Statielei 26,2022-09-11,05:00:00,10,4,6,FMN 12 Statielei
660,Statielei 26,2022-09-11,06:00:00,11,9,2,FMN 12 Statielei
660,Statielei 26,2022-09-11,07:00:00,16,4,12,FMN 12 Statielei
660,Statielei 26,2022-09-11,08:00:00,22,15,7,FMN 12 Statielei
660,Statielei 26,2022-09-11,09:00:00,66,32,34,FMN 12 Statielei
660,Statielei 26,2022-09-11,10:00:00,104,62,42,FMN 12 Statielei
660,Statielei 26,2022-09-11,11:00:00,114,56,58,FMN 12 Statielei
660,Statielei 26,2022-09-11,12:00:00,124,81,43,FMN 12 Statielei
660,Statielei 26,2022-09-11,13:00:00,177,114,63,FMN 12 Statielei
660,Statielei 26,2022-09-11,14:00:00,182,103,79,FMN 12 Statielei
660,Statielei 26,2022-09-11,15:00:00,181,85,96,FMN 12 Statielei
660,Statielei 26,2022-09-11,16:00:00,155,79,76,FMN 12 Statielei
660,Statielei 26,2022-09-11,17:00:00,173,71,102,FMN 12 Statielei
660,Statielei 26,2022-09-11,18:00:00,139,63,76,FMN 12 Statielei
660,Statielei 26,2022-09-11,19:00:00,130,61,69,FMN 12 Statielei
660,Statielei 26,2022-09-11,20:00:00,122,56,66,FMN 12 Statielei
660,Statielei 26,2022-09-11,21:00:00,83,32,51,FMN 12 Statielei
660,Statielei 26,2022-09-11,22:00:00,73,38,35,FMN 12 Statielei
660,Statielei 26,2022-09-11,23:00:00,41,17,24,FMN 12 Statielei
660,Statielei 26,2022-09-12,00:00:00,15,10,5,FMN 12 Statielei
660,Statielei 26,2022-09-12,01:00:00,8,3,5,FMN 12 Statielei
660,Statielei 26,2022-09-12,02:00:00,9,3,6,FMN 12 Statielei
660,Statielei 26,2022-09-12,03:00:00,0,0,0,FMN 12 Statielei
660,Statielei 26,2022-09-12,04:00:00,16,9,7,FMN 12 Statielei
660,Statielei 26,2022-09-12,05:00:00,19,8,11,FMN 12 Statielei
660,Statielei 26,2022-09-12,06:00:00,35,15,20,FMN 12 Statielei
660,Statielei 26,2022-09-12,07:00:00,145,71,74,FMN 12 Statielei
660,Statielei 26,2022-09-12,08:00:00,289,152,137,FMN 12 Statielei
660,Statielei 26,2022-09-12,09:00:00,108,74,34,FMN 12 Statielei
660,Statielei 26,2022-09-12,10:00:00,73,49,24,FMN 12 Statielei
660,Statielei 26,2022-09-12,11:00:00,94,51,43,FMN 12 Statielei
660,Statielei 26,2022-09-12,12:00:00,133,76,57,FMN 12 Statielei
660,Statielei 26,2022-09-12,13:00:00,90,40,50,FMN 12 Statielei
660,Statielei 26,2022-09-12,14:00:00,122,64,58,FMN 12 Statielei
660,Statielei 26,2022-09-12,15:00:00,200,75,125,FMN 12 Statielei
660,Statielei 26,2022-09-12,16:00:00,272,150,122,FMN 12 Statielei
660,Statielei 26,2022-09-12,17:00:00,259,128,131,FMN 12 Statielei
660,Statielei 26,2022-09-12,18:00:00,190,92,98,FMN 12 Statielei
660,Statielei 26,2022-09-12,19:00:00,156,81,75,FMN 12 Statielei
660,Statielei 26,2022-09-12,20:00:00,139,62,77,FMN 12 Statielei
660,Statielei 26,2022-09-12,21:00:00,105,56,49,FMN 12 Statielei
660,Statielei 26,2022-09-12,22:00:00,78,30,48,FMN 12 Statielei
660,Statielei 26,2022-09-12,23:00:00,42,23,19,FMN 12 Statielei
660,Statielei 26,2022-09-13,00:00:00,22,16,6,FMN 12 Statielei
660,Statielei 26,2022-09-13,01:00:00,14,5,9,FMN 12 Statielei
660,Statielei 26,2022-09-13,02:00:00,6,2,4,FMN 12 Statielei
660,Statielei 26,2022-09-13,03:00:00,1,0,1,FMN 12 Statielei
660,Statielei 26,2022-09-13,04:00:00,7,3,4,FMN 12 Statielei
660,Statielei 26,2022-09-13,05:00:00,16,11,5,FMN 12 Statielei
660,Statielei 26,2022-09-13,06:00:00,32,16,16,FMN 12 Statielei
660,Statielei 26,2022-09-13,07:00:00,153,71,82,FMN 12 Statielei
660,Statielei 26,2022-09-13,08:00:00,313,154,159,FMN 12 Statielei
660,Statielei 26,2022-09-13,09:00:00,113,79,34,FMN 12 Statielei
660,Statielei 26,2022-09-13,10:00:00,84,55,29,FMN 12 Statielei
660,Statielei 26,2022-09-13,11:00:00,75,47,28,FMN 12 Statielei
660,Statielei 26,2022-09-13,12:00:00,131,72,59,FMN 12 Statielei
660,Statielei 26,2022-09-13,13:00:00,98,54,44,FMN 12 Statielei
660,Statielei 26,2022-09-13,14:00:00,91,54,37,FMN 12 Statielei
660,Statielei 26,2022-09-13,15:00:00,186,95,91,FMN 12 Statielei
660,Statielei 26,2022-09-13,16:00:00,233,118,115,FMN 12 Statielei
660,Statielei 26,2022-09-13,17:00:00,209,100,109,FMN 12 Statielei
660,Statielei 26,2022-09-13,18:00:00,165,83,82,FMN 12 Statielei
660,Statielei 26,2022-09-13,19:00:00,125,66,59,FMN 12 Statielei
660,Statielei 26,2022-09-13,20:00:00,120,52,68,FMN 12 Statielei
660,Statielei 26,2022-09-13,21:00:00,89,39,50,FMN 12 Statielei
660,Statielei 26,2022-09-13,22:00:00,72,31,41,FMN 12 Statielei
660,Statielei 26,2022-09-13,23:00:00,39,16,23,FMN 12 Statielei
660,Statielei 26,2022-09-14,00:00:00,16,5,11,FMN 12 Statielei
660,Statielei 26,2022-09-14,01:00:00,17,9,8,FMN 12 Statielei
660,Statielei 26,2022-09-14,02:00:00,3,1,2,FMN 12 Statielei
660,Statielei 26,2022-09-14,03:00:00,3,1,2,FMN 12 Statielei
660,Statielei 26,2022-09-14,04:00:00,5,1,4,FMN 12 Statielei
660,Statielei 26,2022-09-14,05:00:00,12,7,5,FMN 12 Statielei
660,Statielei 26,2022-09-14,06:00:00,17,11,6,FMN 12 Statielei
660,Statielei 26,2022-09-14,07:00:00,81,36,45,FMN 12 Statielei
660,Statielei 26,2022-09-14,08:00:00,220,116,104,FMN 12 Statielei
660,Statielei 26,2022-09-14,09:00:00,58,38,20,FMN 12 Statielei
660,Statielei 26,2022-09-14,10:00:00,44,22,22,FMN 12 Statielei
660,Statielei 26,2022-09-14,11:00:00,45,22,23,FMN 12 Statielei
660,Statielei 26,2022-09-14,12:00:00,153,85,68,FMN 12 Statielei
660,Statielei 26,2022-09-14,13:00:00,88,45,43,FMN 12 Statielei
660,Statielei 26,2022-09-14,14:00:00,61,25,36,FMN 12 Statielei
660,Statielei 26,2022-09-14,15:00:00,85,39,46,FMN 12 Statielei
660,Statielei 26,2022-09-14,16:00:00,125,59,66,FMN 12 Statielei
660,Statielei 26,2022-09-14,17:00:00,148,74,74,FMN 12 Statielei
660,Statielei 26,2022-09-14,18:00:00,121,62,59,FMN 12 Statielei
660,Statielei 26,2022-09-14,19:00:00,102,56,46,FMN 12 Statielei
660,Statielei 26,2022-09-14,20:00:00,75,37,38,FMN 12 Statielei
660,Statielei 26,2022-09-14,21:00:00,58,24,34,FMN 12 Statielei
660,Statielei 26,2022-09-14,22:00:00,48,22,26,FMN 12 Statielei
660,Statielei 26,2022-09-14,23:00:00,30,12,18,FMN 12 Statielei
660,Statielei 26,2022-09-15,00:00:00,29,12,17,FMN 12 Statielei
660,Statielei 26,2022-09-15,01:00:00,12,3,9,FMN 12 Statielei
660,Statielei 26,2022-09-15,02:00:00,4,1,3,FMN 12 Statielei
660,Statielei 26,2022-09-15,03:00:00,3,2,1,FMN 12 Statielei
660,Statielei 26,2022-09-15,04:00:00,7,5,2,FMN 12 Statielei
660,Statielei 26,2022-09-15,05:00:00,17,8,9,FMN 12 Statielei
660,Statielei 26,2022-09-15,06:00:00,35,16,19,FMN 12 Statielei
660,Statielei 26,2022-09-15,07:00:00,130,61,69,FMN 12 Statielei
660,Statielei 26,2022-09-15,08:00:00,328,176,152,FMN 12 Statielei
660,Statielei 26,2022-09-15,09:00:00,125,90,35,FMN 12 Statielei
660,Statielei 26,2022-09-15,10:00:00,77,48,29,FMN 12 Statielei
660,Statielei 26,2022-09-15,11:00:00,69,36,33,FMN 12 Statielei
660,Statielei 26,2022-09-15,12:00:00,105,56,49,FMN 12 Statielei
660,Statielei 26,2022-09-15,13:00:00,81,34,47,FMN 12 Statielei
660,Statielei 26,2022-09-15,14:00:00,102,48,54,FMN 12 Statielei
660,Statielei 26,2022-09-15,15:00:00,193,97,96,FMN 12 Statielei
660,Statielei 26,2022-09-15,16:00:00,242,120,122,FMN 12 Statielei
660,Statielei 26,2022-09-15,17:00:00,231,111,120,FMN 12 Statielei
660,Statielei 26,2022-09-15,18:00:00,214,113,101,FMN 12 Statielei
660,Statielei 26,2022-09-15,19:00:00,139,70,69,FMN 12 Statielei
660,Statielei 26,2022-09-15,20:00:00,101,54,47,FMN 12 Statielei
660,Statielei 26,2022-09-15,21:00:00,98,42,56,FMN 12 Statielei
660,Statielei 26,2022-09-15,22:00:00,79,35,44,FMN 12 Statielei
660,Statielei 26,2022-09-15,23:00:00,45,21,24,FMN 12 Statielei
660,Statielei 26,2022-09-16,00:00:00,27,14,13,FMN 12 Statielei
660,Statielei 26,2022-09-16,01:00:00,30,20,10,FMN 12 Statielei
660,Statielei 26,2022-09-16,02:00:00,12,2,10,FMN 12 Statielei
660,Statielei 26,2022-09-16,03:00:00,9,4,5,FMN 12 Statielei
660,Statielei 26,2022-09-16,04:00:00,3,1,2,FMN 12 Statielei
660,Statielei 26,2022-09-16,05:00:00,18,10,8,FMN 12 Statielei
660,Statielei 26,2022-09-16,06:00:00,31,14,17,FMN 12 Statielei
660,Statielei 26,2022-09-16,07:00:00,101,43,58,FMN 12 Statielei
660,Statielei 26,2022-09-16,08:00:00,199,92,107,FMN 12 Statielei
660,Statielei 26,2022-09-16,09:00:00,75,53,22,FMN 12 Statielei
660,Statielei 26,2022-09-16,10:00:00,40,24,16,FMN 12 Statielei
660,Statielei 26,2022-09-16,11:00:00,58,31,27,FMN 12 Statielei
660,Statielei 26,2022-09-16,12:00:00,85,44,41,FMN 12 Statielei
660,Statielei 26,2022-09-16,13:00:00,62,36,26,FMN 12 Statielei
660,Statielei 26,2022-09-16,14:00:00,70,38,32,FMN 12 Statielei
660,Statielei 26,2022-09-16,15:00:00,160,72,88,FMN 12 Statielei
660,Statielei 26,2022-09-16,16:00:00,199,116,83,FMN 12 Statielei
660,Statielei 26,2022-09-16,17:00:00,181,84,97,FMN 12 Statielei
660,Statielei 26,2022-09-16,18:00:00,124,64,60,FMN 12 Statielei
660,Statielei 26,2022-09-16,19:00:00,99,41,58,FMN 12 Statielei
660,Statielei 26,2022-09-16,20:00:00,94,51,43,FMN 12 Statielei
660,Statielei 26,2022-09-16,21:00:00,78,35,43,FMN 12 Statielei
660,Statielei 26,2022-09-16,22:00:00,86,52,34,FMN 12 Statielei
660,Statielei 26,2022-09-16,23:00:00,56,33,23,FMN 12 Statielei
660,Statielei 26,2022-09-17,00:00:00,26,16,10,FMN 12 Statielei
660,Statielei 26,2022-09-17,01:00:00,30,17,13,FMN 12 Statielei
660,Statielei 26,2022-09-17,02:00:00,19,7,12,FMN 12 Statielei
660,Statielei 26,2022-09-17,03:00:00,14,4,10,FMN 12 Statielei
660,Statielei 26,2022-09-17,04:00:00,5,2,3,FMN 12 Statielei
660,Statielei 26,2022-09-17,05:00:00,13,5,8,FMN 12 Statielei
660,Statielei 26,2022-09-17,06:00:00,14,9,5,FMN 12 Statielei
660,Statielei 26,2022-09-17,07:00:00,16,9,7,FMN 12 Statielei
660,Statielei 26,2022-09-17,08:00:00,45,22,23,FMN 12 Statielei
660,Statielei 26,2022-09-17,09:00:00,76,32,44,FMN 12 Statielei
660,Statielei 26,2022-09-17,10:00:00,102,55,47,FMN 12 Statielei
660,Statielei 26,2022-09-17,11:00:00,93,50,43,FMN 12 Statielei
660,Statielei 26,2022-09-17,12:00:00,99,55,44,FMN 12 Statielei
660,Statielei 26,2022-09-17,13:00:00,99,46,53,FMN 12 Statielei
660,Statielei 26,2022-09-17,14:00:00,102,55,47,FMN 12 Statielei
660,Statielei 26,2022-09-17,15:00:00,106,57,49,FMN 12 Statielei
660,Statielei 26,2022-09-17,16:00:00,121,60,61,FMN 12 Statielei
660,Statielei 26,2022-09-17,17:00:00,73,35,38,FMN 12 Statielei
660,Statielei 26,2022-09-17,18:00:00,103,55,48,FMN 12 Statielei
660,Statielei 26,2022-09-17,19:00:00,91,53,38,FMN 12 Statielei
660,Statielei 26,2022-09-17,20:00:00,65,41,24,FMN 12 Statielei
660,Statielei 26,2022-09-17,21:00:00,52,23,29,FMN 12 Statielei
660,Statielei 26,2022-09-17,22:00:00,64,30,34,FMN 12 Statielei
660,Statielei 26,2022-09-17,23:00:00,46,17,29,FMN 12 Statielei
660,Statielei 26,2022-09-18,00:00:00,33,16,17,FMN 12 Statielei
660,Statielei 26,2022-09-18,01:00:00,15,3,12,FMN 12 Statielei
660,Statielei 26,2022-09-18,02:00:00,12,7,5,FMN 12 Statielei
660,Statielei 26,2022-09-18,03:00:00,10,3,7,FMN 12 Statielei
660,Statielei 26,2022-09-18,04:00:00,2,1,1,FMN 12 Statielei
660,Statielei 26,2022-09-18,05:00:00,5,2,3,FMN 12 Statielei
660,Statielei 26,2022-09-18,06:00:00,3,1,2,FMN 12 Statielei
660,Statielei 26,2022-09-18,07:00:00,9,5,4,FMN 12 Statielei
660,Statielei 26,2022-09-18,08:00:00,9,6,3,FMN 12 Statielei
660,Statielei 26,2022-09-18,09:00:00,42,19,23,FMN 12 Statielei
660,Statielei 26,2022-09-18,10:00:00,51,25,26,FMN 12 Statielei
660,Statielei 26,2022-09-18,11:00:00,68,34,34,FMN 12 Statielei
660,Statielei 26,2022-09-18,12:00:00,88,50,38,FMN 12 Statielei
660,Statielei 26,2022-09-18,13:00:00,84,40,44,FMN 12 Statielei
660,Statielei 26,2022-09-18,14:00:00,99,54,45,FMN 12 Statielei
660,Statielei 26,2022-09-18,15:00:00,88,48,40,FMN 12 Statielei
660,Statielei 26,2022-09-18,16:00:00,77,37,40,FMN 12 Statielei
660,Statielei 26,2022-09-18,17:00:00,92,51,41,FMN 12 Statielei
660,Statielei 26,2022-09-18,18:00:00,81,51,30,FMN 12 Statielei
660,Statielei 26,2022-09-18,19:00:00,53,31,22,FMN 12 Statielei
660,Statielei 26,2022-09-18,20:00:00,59,21,38,FMN 12 Statielei
660,Statielei 26,2022-09-18,21:00:00,47,20,27,FMN 12 Statielei
660,Statielei 26,2022-09-18,22:00:00,34,18,16,FMN 12 Statielei
660,Statielei 26,2022-09-18,23:00:00,49,28,21,FMN 12 Statielei
660,Statielei 26,2022-09-19,00:00:00,4,3,1,FMN 12 Statielei
660,Statielei 26,2022-09-19,01:00:00,9,2,7,FMN 12 Statielei
660,Statielei 26,2022-09-19,02:00:00,8,1,7,FMN 12 Statielei
660,Statielei 26,2022-09-19,03:00:00,5,2,3,FMN 12 Statielei
660,Statielei 26,2022-09-19,04:00:00,10,3,7,FMN 12 Statielei
660,Statielei 26,2022-09-19,05:00:00,13,7,6,FMN 12 Statielei
660,Statielei 26,2022-09-19,06:00:00,30,13,17,FMN 12 Statielei
660,Statielei 26,2022-09-19,07:00:00,135,61,74,FMN 12 Statielei
660,Statielei 26,2022-09-19,08:00:00,306,168,138,FMN 12 Statielei
660,Statielei 26,2022-09-19,09:00:00,107,64,43,FMN 12 Statielei
660,Statielei 26,2022-09-19,10:00:00,80,50,30,FMN 12 Statielei
660,Statielei 26,2022-09-19,11:00:00,83,52,31,FMN 12 Statielei
660,Statielei 26,2022-09-19,12:00:00,114,62,52,FMN 12 Statielei
660,Statielei 26,2022-09-19,13:00:00,85,49,36,FMN 12 Statielei
660,Statielei 26,2022-09-19,14:00:00,87,30,57,FMN 12 Statielei
660,Statielei 26,2022-09-19,15:00:00,190,80,110,FMN 12 Statielei
660,Statielei 26,2022-09-19,16:00:00,233,137,96,FMN 12 Statielei
660,Statielei 26,2022-09-19,17:00:00,242,122,120,FMN 12 Statielei
660,Statielei 26,2022-09-19,18:00:00,161,75,86,FMN 12 Statielei
660,Statielei 26,2022-09-19,19:00:00,135,73,62,FMN 12 Statielei
660,Statielei 26,2022-09-19,20:00:00,105,62,43,FMN 12 Statielei
660,Statielei 26,2022-09-19,21:00:00,83,46,37,FMN 12 Statielei
660,Statielei 26,2022-09-19,22:00:00,50,22,28,FMN 12 Statielei
660,Statielei 26,2022-09-19,23:00:00,22,12,10,FMN 12 Statielei
660,Statielei 26,2022-09-20,00:00:00,15,2,13,FMN 12 Statielei
660,Statielei 26,2022-09-20,01:00:00,7,2,5,FMN 12 Statielei
660,Statielei 26,2022-09-20,02:00:00,6,3,3,FMN 12 Statielei
660,Statielei 26,2022-09-20,03:00:00,3,1,2,FMN 12 Statielei
660,Statielei 26,2022-09-20,04:00:00,9,4,5,FMN 12 Statielei
660,Statielei 26,2022-09-20,05:00:00,17,9,8,FMN 12 Statielei
660,Statielei 26,2022-09-20,06:00:00,35,17,18,FMN 12 Statielei
660,Statielei 26,2022-09-20,07:00:00,143,73,70,FMN 12 Statielei
660,Statielei 26,2022-09-20,08:00:00,317,176,141,FMN 12 Statielei
660,Statielei 26,2022-09-20,09:00:00,120,81,39,FMN 12 Statielei
660,Statielei 26,2022-09-20,10:00:00,78,48,30,FMN 12 Statielei
660,Statielei 26,2022-09-20,11:00:00,71,48,23,FMN 12 Statielei
660,Statielei 26,2022-09-20,12:00:00,117,66,51,FMN 12 Statielei
660,Statielei 26,2022-09-20,13:00:00,82,44,38,FMN 12 Statielei
660,Statielei 26,2022-09-20,14:00:00,103,54,49,FMN 12 Statielei
660,Statielei 26,2022-09-20,15:00:00,198,75,123,FMN 12 Statielei
660,Statielei 26,2022-09-20,16:00:00,255,144,111,FMN 12 Statielei
660,Statielei 26,2022-09-20,17:00:00,261,141,120,FMN 12 Statielei
660,Statielei 26,2022-09-20,18:00:00,215,114,101,FMN 12 Statielei
660,Statielei 26,2022-09-20,19:00:00,150,74,76,FMN 12 Statielei
660,Statielei 26,2022-09-20,20:00:00,104,53,51,FMN 12 Statielei
660,Statielei 26,2022-09-20,21:00:00,84,30,54,FMN 12 Statielei
660,Statielei 26,2022-09-20,22:00:00,74,39,35,FMN 12 Statielei
660,Statielei 26,2022-09-20,23:00:00,45,18,27,FMN 12 Statielei
660,Statielei 26,2022-09-21,00:00:00,22,9,13,FMN 12 Statielei
660,Statielei 26,2022-09-21,01:00:00,13,4,9,FMN 12 Statielei
660,Statielei 26,2022-09-21,02:00:00,7,3,4,FMN 12 Statielei
660,Statielei 26,2022-09-21,03:00:00,5,1,4,FMN 12 Statielei
660,Statielei 26,2022-09-21,04:00:00,9,6,3,FMN 12 Statielei
660,Statielei 26,2022-09-21,05:00:00,17,11,6,FMN 12 Statielei
660,Statielei 26,2022-09-21,06:00:00,49,26,23,FMN 12 Statielei
660,Statielei 26,2022-09-21,07:00:00,149,90,59,FMN 12 Statielei
660,Statielei 26,2022-09-21,08:00:00,310,178,132,FMN 12 Statielei
660,Statielei 26,2022-09-21,09:00:00,130,84,46,FMN 12 Statielei
660,Statielei 26,2022-09-21,10:00:00,94,72,22,FMN 12 Statielei
660,Statielei 26,2022-09-21,11:00:00,125,79,46,FMN 12 Statielei
660,Statielei 26,2022-09-21,12:00:00,274,133,141,FMN 12 Statielei
660,Statielei 26,2022-09-21,13:00:00,173,81,92,FMN 12 Statielei
660,Statielei 26,2022-09-21,14:00:00,181,92,89,FMN 12 Statielei
660,Statielei 26,2022-09-21,15:00:00,186,90,96,FMN 12 Statielei
660,Statielei 26,2022-09-21,16:00:00,243,109,134,FMN 12 Statielei
660,Statielei 26,2022-09-21,17:00:00,277,148,129,FMN 12 Statielei
660,Statielei 26,2022-09-21,18:00:00,218,121,97,FMN 12 Statielei
660,Statielei 26,2022-09-21,19:00:00,184,108,76,FMN 12 Statielei
660,Statielei 26,2022-09-21,20:00:00,126,72,54,FMN 12 Statielei
660,Statielei 26,2022-09-21,21:00:00,88,30,58,FMN 12 Statielei
660,Statielei 26,2022-09-21,22:00:00,57,24,33,FMN 12 Statielei
660,Statielei 26,2022-09-21,23:00:00,61,17,44,FMN 12 Statielei
660,Statielei 26,2022-09-22,00:00:00,22,6,16,FMN 12 Statielei
660,Statielei 26,2022-09-22,01:00:00,14,1,13,FMN 12 Statielei
660,Statielei 26,2022-09-22,02:00:00,5,2,3,FMN 12 Statielei
660,Statielei 26,2022-09-22,03:00:00,4,0,4,FMN 12 Statielei
660,Statielei 26,2022-09-22,04:00:00,8,2,6,FMN 12 Statielei
660,Statielei 26,2022-09-22,05:00:00,14,10,4,FMN 12 Statielei
660,Statielei 26,2022-09-22,06:00:00,43,17,26,FMN 12 Statielei
660,Statielei 26,2022-09-22,07:00:00,150,73,77,FMN 12 Statielei
660,Statielei 26,2022-09-22,08:00:00,297,175,122,FMN 12 Statielei
660,Statielei 26,2022-09-22,09:00:00,129,78,51,FMN 12 Statielei
660,Statielei 26,2022-09-22,10:00:00,94,65,29,FMN 12 Statielei
660,Statielei 26,2022-09-22,11:00:00,104,66,38,FMN 12 Statielei
660,Statielei 26,2022-09-22,12:00:00,118,52,66,FMN 12 Statielei
660,Statielei 26,2022-09-22,13:00:00,115,53,62,FMN 12 Statielei
660,Statielei 26,2022-09-22,14:00:00,128,69,59,FMN 12 Statielei
660,Statielei 26,2022-09-22,15:00:00,185,89,96,FMN 12 Statielei
660,Statielei 26,2022-09-22,16:00:00,272,130,142,FMN 12 Statielei
660,Statielei 26,2022-09-22,17:00:00,267,131,136,FMN 12 Statielei
660,Statielei 26,2022-09-22,18:00:00,229,115,114,FMN 12 Statielei
660,Statielei 26,2022-09-22,19:00:00,166,83,83,FMN 12 Statielei
660,Statielei 26,2022-09-22,20:00:00,113,56,57,FMN 12 Statielei
660,Statielei 26,2022-09-22,21:00:00,89,49,40,FMN 12 Statielei
660,Statielei 26,2022-09-22,22:00:00,80,29,51,FMN 12 Statielei
660,Statielei 26,2022-09-22,23:00:00,85,34,51,FMN 12 Statielei
660,Statielei 26,2022-09-23,00:00:00,26,16,10,FMN 12 Statielei
660,Statielei 26,2022-09-23,01:00:00,18,5,13,FMN 12 Statielei
660,Statielei 26,2022-09-23,02:00:00,12,1,11,FMN 12 Statielei
660,Statielei 26,2022-09-23,03:00:00,3,1,2,FMN 12 Statielei
660,Statielei 26,2022-09-23,04:00:00,12,4,8,FMN 12 Statielei
660,Statielei 26,2022-09-23,05:00:00,17,12,5,FMN 12 Statielei
660,Statielei 26,2022-09-23,06:00:00,26,12,14,FMN 12 Statielei
660,Statielei 26,2022-09-23,07:00:00,113,56,57,FMN 12 Statielei
660,Statielei 26,2022-09-23,08:00:00,238,134,104,FMN 12 Statielei
660,Statielei 26,2022-09-23,09:00:00,129,83,46,FMN 12 Statielei
660,Statielei 26,2022-09-23,10:00:00,70,43,27,FMN 12 Statielei
660,Statielei 26,2022-09-23,11:00:00,79,45,34,FMN 12 Statielei
660,Statielei 26,2022-09-23,12:00:00,125,56,69,FMN 12 Statielei
660,Statielei 26,2022-09-23,13:00:00,125,67,58,FMN 12 Statielei
660,Statielei 26,2022-09-23,14:00:00,127,63,64,FMN 12 Statielei
660,Statielei 26,2022-09-23,15:00:00,205,90,115,FMN 12 Statielei
660,Statielei 26,2022-09-23,16:00:00,227,113,114,FMN 12 Statielei
660,Statielei 26,2022-09-23,17:00:00,189,91,98,FMN 12 Statielei
660,Statielei 26,2022-09-23,18:00:00,185,105,80,FMN 12 Statielei
660,Statielei 26,2022-09-23,19:00:00,144,69,75,FMN 12 Statielei
660,Statielei 26,2022-09-23,20:00:00,99,59,40,FMN 12 Statielei
660,Statielei 26,2022-09-23,21:00:00,60,34,26,FMN 12 Statielei
660,Statielei 26,2022-09-23,22:00:00,56,29,27,FMN 12 Statielei
660,Statielei 26,2022-09-23,23:00:00,59,29,30,FMN 12 Statielei
660,Statielei 26,2022-09-24,00:00:00,42,14,28,FMN 12 Statielei
660,Statielei 26,2022-09-24,01:00:00,32,11,21,FMN 12 Statielei
660,Statielei 26,2022-09-24,02:00:00,13,6,7,FMN 12 Statielei
660,Statielei 26,2022-09-24,03:00:00,8,3,5,FMN 12 Statielei
660,Statielei 26,2022-09-24,04:00:00,6,1,5,FMN 12 Statielei
660,Statielei 26,2022-09-24,05:00:00,10,2,8,FMN 12 Statielei
660,Statielei 26,2022-09-24,06:00:00,12,5,7,FMN 12 Statielei
660,Statielei 26,2022-09-24,07:00:00,18,7,11,FMN 12 Statielei
660,Statielei 26,2022-09-24,08:00:00,36,18,18,FMN 12 Statielei
660,Statielei 26,2022-09-24,09:00:00,85,45,40,FMN 12 Statielei
660,Statielei 26,2022-09-24,10:00:00,69,30,39,FMN 12 Statielei
660,Statielei 26,2022-09-24,11:00:00,79,47,32,FMN 12 Statielei
660,Statielei 26,2022-09-24,12:00:00,87,52,35,FMN 12 Statielei
660,Statielei 26,2022-09-24,13:00:00,124,62,62,FMN 12 Statielei
660,Statielei 26,2022-09-24,14:00:00,100,47,53,FMN 12 Statielei
660,Statielei 26,2022-09-24,15:00:00,102,60,42,FMN 12 Statielei
660,Statielei 26,2022-09-24,16:00:00,123,56,67,FMN 12 Statielei
660,Statielei 26,2022-09-24,17:00:00,106,57,49,FMN 12 Statielei
660,Statielei 26,2022-09-24,18:00:00,104,49,55,FMN 12 Statielei
660,Statielei 26,2022-09-24,19:00:00,90,49,41,FMN 12 Statielei
660,Statielei 26,2022-09-24,20:00:00,79,36,43,FMN 12 Statielei
660,Statielei 26,2022-09-24,21:00:00,49,30,19,FMN 12 Statielei
660,Statielei 26,2022-09-24,22:00:00,59,18,41,FMN 12 Statielei
660,Statielei 26,2022-09-24,23:00:00,51,15,36,FMN 12 Statielei
660,Statielei 26,2022-09-25,00:00:00,55,23,32,FMN 12 Statielei
660,Statielei 26,2022-09-25,01:00:00,28,5,23,FMN 12 Statielei
660,Statielei 26,2022-09-25,02:00:00,28,10,18,FMN 12 Statielei
660,Statielei 26,2022-09-25,03:00:00,14,4,10,FMN 12 Statielei
660,Statielei 26,2022-09-25,04:00:00,7,2,5,FMN 12 Statielei
660,Statielei 26,2022-09-25,05:00:00,8,5,3,FMN 12 Statielei
660,Statielei 26,2022-09-25,06:00:00,11,7,4,FMN 12 Statielei
660,Statielei 26,2022-09-25,07:00:00,15,8,7,FMN 12 Statielei
660,Statielei 26,2022-09-25,08:00:00,32,17,15,FMN 12 Statielei
660,Statielei 26,2022-09-25,09:00:00,63,29,34,FMN 12 Statielei
660,Statielei 26,2022-09-25,10:00:00,93,42,51,FMN 12 Statielei
660,Statielei 26,2022-09-25,11:00:00,86,37,49,FMN 12 Statielei
660,Statielei 26,2022-09-25,12:00:00,129,68,61,FMN 12 Statielei
660,Statielei 26,2022-09-25,13:00:00,111,49,62,FMN 12 Statielei
660,Statielei 26,2022-09-25,14:00:00,160,98,62,FMN 12 Statielei
660,Statielei 26,2022-09-25,15:00:00,137,83,54,FMN 12 Statielei
660,Statielei 26,2022-09-25,16:00:00,134,69,65,FMN 12 Statielei
660,Statielei 26,2022-09-25,17:00:00,136,64,72,FMN 12 Statielei
660,Statielei 26,2022-09-25,18:00:00,136,71,65,FMN 12 Statielei
660,Statielei 26,2022-09-25,19:00:00,92,36,56,FMN 12 Statielei
660,Statielei 26,2022-09-25,20:00:00,83,39,44,FMN 12 Statielei
660,Statielei 26,2022-09-25,21:00:00,58,25,33,FMN 12 Statielei
660,Statielei 26,2022-09-25,22:00:00,44,21,23,FMN 12 Statielei
660,Statielei 26,2022-09-25,23:00:00,25,11,14,FMN 12 Statielei
660,Statielei 26,2022-09-26,00:00:00,17,5,12,FMN 12 Statielei
660,Statielei 26,2022-09-26,01:00:00,13,7,6,FMN 12 Statielei
660,Statielei 26,2022-09-26,02:00:00,5,1,4,FMN 12 Statielei
660,Statielei 26,2022-09-26,03:00:00,3,2,1,FMN 12 Statielei
660,Statielei 26,2022-09-26,04:00:00,5,3,2,FMN 12 Statielei
660,Statielei 26,2022-09-26,05:00:00,7,5,2,FMN 12 Statielei
660,Statielei 26,2022-09-26,06:00:00,29,14,15,FMN 12 Statielei
660,Statielei 26,2022-09-26,07:00:00,119,48,71,FMN 12 Statielei
660,Statielei 26,2022-09-26,08:00:00,247,129,118,FMN 12 Statielei
660,Statielei 26,2022-09-26,09:00:00,117,80,37,FMN 12 Statielei
660,Statielei 26,2022-09-26,10:00:00,73,41,32,FMN 12 Statielei
660,Statielei 26,2022-09-26,11:00:00,42,22,20,FMN 12 Statielei
660,Statielei 26,2022-09-26,12:00:00,77,36,41,FMN 12 Statielei
660,Statielei 26,2022-09-26,13:00:00,61,34,27,FMN 12 Statielei
660,Statielei 26,2022-09-26,14:00:00,57,37,20,FMN 12 Statielei
660,Statielei 26,2022-09-26,15:00:00,118,55,63,FMN 12 Statielei
660,Statielei 26,2022-09-26,16:00:00,186,85,101,FMN 12 Statielei
660,Statielei 26,2022-09-26,17:00:00,159,73,86,FMN 12 Statielei
660,Statielei 26,2022-09-26,18:00:00,124,63,61,FMN 12 Statielei
660,Statielei 26,2022-09-26,19:00:00,101,56,45,FMN 12 Statielei
660,Statielei 26,2022-09-26,20:00:00,75,39,36,FMN 12 Statielei
660,Statielei 26,2022-09-26,21:00:00,66,33,33,FMN 12 Statielei
660,Statielei 26,2022-09-26,22:00:00,57,22,35,FMN 12 Statielei
660,Statielei 26,2022-09-26,23:00:00,33,14,19,FMN 12 Statielei
660,Statielei 26,2022-09-27,00:00:00,13,5,8,FMN 12 Statielei
660,Statielei 26,2022-09-27,01:00:00,11,3,8,FMN 12 Statielei
660,Statielei 26,2022-09-27,02:00:00,5,1,4,FMN 12 Statielei
660,Statielei 26,2022-09-27,03:00:00,1,1,0,FMN 12 Statielei
660,Statielei 26,2022-09-27,04:00:00,7,4,3,FMN 12 Statielei
660,Statielei 26,2022-09-27,05:00:00,15,9,6,FMN 12 Statielei
660,Statielei 26,2022-09-27,06:00:00,13,7,6,FMN 12 Statielei
660,Statielei 26,2022-09-27,07:00:00,106,49,57,FMN 12 Statielei
660,Statielei 26,2022-09-27,08:00:00,254,142,112,FMN 12 Statielei
660,Statielei 26,2022-09-27,09:00:00,77,53,24,FMN 12 Statielei
660,Statielei 26,2022-09-27,10:00:00,65,40,25,FMN 12 Statielei
660,Statielei 26,2022-09-27,11:00:00,39,19,20,FMN 12 Statielei
660,Statielei 26,2022-09-27,12:00:00,93,50,43,FMN 12 Statielei
660,Statielei 26,2022-09-27,13:00:00,76,40,36,FMN 12 Statielei
660,Statielei 26,2022-09-27,14:00:00,73,36,37,FMN 12 Statielei
660,Statielei 26,2022-09-27,15:00:00,144,63,81,FMN 12 Statielei
660,Statielei 26,2022-09-27,16:00:00,196,111,85,FMN 12 Statielei
660,Statielei 26,2022-09-27,17:00:00,182,71,111,FMN 12 Statielei
660,Statielei 26,2022-09-27,18:00:00,149,74,75,FMN 12 Statielei
660,Statielei 26,2022-09-27,19:00:00,105,54,51,FMN 12 Statielei
660,Statielei 26,2022-09-27,20:00:00,74,40,34,FMN 12 Statielei
660,Statielei 26,2022-09-27,21:00:00,65,24,41,FMN 12 Statielei
660,Statielei 26,2022-09-27,22:00:00,52,29,23,FMN 12 Statielei
660,Statielei 26,2022-09-27,23:00:00,33,12,21,FMN 12 Statielei
660,Statielei 26,2022-09-28,00:00:00,19,11,8,FMN 12 Statielei
660,Statielei 26,2022-09-28,01:00:00,1,1,0,FMN 12 Statielei
660,Statielei 26,2022-09-28,02:00:00,3,1,2,FMN 12 Statielei
660,Statielei 26,2022-09-28,03:00:00,4,2,2,FMN 12 Statielei
660,Statielei 26,2022-09-28,04:00:00,4,2,2,FMN 12 Statielei
660,Statielei 26,2022-09-28,05:00:00,10,6,4,FMN 12 Statielei
660,Statielei 26,2022-09-28,06:00:00,26,14,12,FMN 12 Statielei
660,Statielei 26,2022-09-28,07:00:00,121,48,73,FMN 12 Statielei
660,Statielei 26,2022-09-28,08:00:00,294,152,142,FMN 12 Statielei
660,Statielei 26,2022-09-28,09:00:00,105,61,44,FMN 12 Statielei
660,Statielei 26,2022-09-28,10:00:00,112,82,30,FMN 12 Statielei
660,Statielei 26,2022-09-28,11:00:00,117,72,45,FMN 12 Statielei
660,Statielei 26,2022-09-28,12:00:00,243,126,117,FMN 12 Statielei
660,Statielei 26,2022-09-28,13:00:00,134,59,75,FMN 12 Statielei
660,Statielei 26,2022-09-28,14:00:00,111,46,65,FMN 12 Statielei
660,Statielei 26,2022-09-28,15:00:00,132,68,64,FMN 12 Statielei
660,Statielei 26,2022-09-28,16:00:00,202,91,111,FMN 12 Statielei
660,Statielei 26,2022-09-28,17:00:00,229,117,112,FMN 12 Statielei
660,Statielei 26,2022-09-28,18:00:00,162,75,87,FMN 12 Statielei
660,Statielei 26,2022-09-28,19:00:00,157,88,69,FMN 12 Statielei
660,Statielei 26,2022-09-28,20:00:00,121,77,44,FMN 12 Statielei
660,Statielei 26,2022-09-28,21:00:00,52,22,30,FMN 12 Statielei
660,Statielei 26,2022-09-28,22:00:00,59,32,27,FMN 12 Statielei
660,Statielei 26,2022-09-28,23:00:00,49,20,29,FMN 12 Statielei
660,Statielei 26,2022-09-29,00:00:00,19,5,14,FMN 12 Statielei
660,Statielei 26,2022-09-29,01:00:00,5,3,2,FMN 12 Statielei
660,Statielei 26,2022-09-29,02:00:00,3,0,3,FMN 12 Statielei
660,Statielei 26,2022-09-29,03:00:00,5,2,3,FMN 12 Statielei
660,Statielei 26,2022-09-29,04:00:00,13,6,7,FMN 12 Statielei
660,Statielei 26,2022-09-29,05:00:00,11,8,3,FMN 12 Statielei
660,Statielei 26,2022-09-29,06:00:00,30,12,18,FMN 12 Statielei
660,Statielei 26,2022-09-29,07:00:00,116,52,64,FMN 12 Statielei
660,Statielei 26,2022-09-29,08:00:00,289,150,139,FMN 12 Statielei
660,Statielei 26,2022-09-29,09:00:00,119,78,41,FMN 12 Statielei
660,Statielei 26,2022-09-29,10:00:00,68,43,25,FMN 12 Statielei
660,Statielei 26,2022-09-29,11:00:00,84,44,40,FMN 12 Statielei
660,Statielei 26,2022-09-29,12:00:00,120,71,49,FMN 12 Statielei
660,Statielei 26,2022-09-29,13:00:00,99,55,44,FMN 12 Statielei
660,Statielei 26,2022-09-29,14:00:00,107,50,57,FMN 12 Statielei
660,Statielei 26,2022-09-29,15:00:00,185,79,106,FMN 12 Statielei
660,Statielei 26,2022-09-29,16:00:00,274,143,131,FMN 12 Statielei
660,Statielei 26,2022-09-29,17:00:00,258,136,122,FMN 12 Statielei
660,Statielei 26,2022-09-29,18:00:00,204,109,95,FMN 12 Statielei
660,Statielei 26,2022-09-29,19:00:00,174,83,91,FMN 12 Statielei
660,Statielei 26,2022-09-29,20:00:00,110,66,44,FMN 12 Statielei
660,Statielei 26,2022-09-29,21:00:00,109,56,53,FMN 12 Statielei
660,Statielei 26,2022-09-29,22:00:00,153,99,54,FMN 12 Statielei
660,Statielei 26,2022-09-29,23:00:00,63,38,25,FMN 12 Statielei
660,Statielei 26,2022-09-30,00:00:00,26,10,16,FMN 12 Statielei
660,Statielei 26,2022-09-30,01:00:00,15,6,9,FMN 12 Statielei
660,Statielei 26,2022-09-30,02:00:00,5,3,2,FMN 12 Statielei
660,Statielei 26,2022-09-30,03:00:00,6,1,5,FMN 12 Statielei
660,Statielei 26,2022-09-30,04:00:00,6,3,3,FMN 12 Statielei
660,Statielei 26,2022-09-30,05:00:00,14,9,5,FMN 12 Statielei
660,Statielei 26,2022-09-30,06:00:00,33,13,20,FMN 12 Statielei
660,Statielei 26,2022-09-30,07:00:00,116,48,68,FMN 12 Statielei
660,Statielei 26,2022-09-30,08:00:00,238,133,105,FMN 12 Statielei
660,Statielei 26,2022-09-30,09:00:00,94,65,29,FMN 12 Statielei
660,Statielei 26,2022-09-30,10:00:00,76,43,33,FMN 12 Statielei
660,Statielei 26,2022-09-30,11:00:00,94,57,37,FMN 12 Statielei
660,Statielei 26,2022-09-30,12:00:00,106,54,52,FMN 12 Statielei
660,Statielei 26,2022-09-30,13:00:00,122,69,53,FMN 12 Statielei
660,Statielei 26,2022-09-30,14:00:00,118,59,59,FMN 12 Statielei
660,Statielei 26,2022-09-30,15:00:00,187,89,98,FMN 12 Statielei
660,Statielei 26,2022-09-30,16:00:00,245,143,102,FMN 12 Statielei
660,Statielei 26,2022-09-30,17:00:00,222,94,128,FMN 12 Statielei
660,Statielei 26,2022-09-30,18:00:00,197,94,103,FMN 12 Statielei
660,Statielei 26,2022-09-30,19:00:00,166,90,76,FMN 12 Statielei
660,Statielei 26,2022-09-30,20:00:00,106,70,36,FMN 12 Statielei
660,Statielei 26,2022-09-30,21:00:00,76,33,43,FMN 12 Statielei
660,Statielei 26,2022-09-30,22:00:00,79,36,43,FMN 12 Statielei
660,Statielei 26,2022-09-30,23:00:00,43,19,24,FMN 12 Statielei
660,Statielei 26,2022-10-01,00:00:00,36,18,18,FMN 12 Statielei
660,Statielei 26,2022-10-01,01:00:00,24,11,13,FMN 12 Statielei
660,Statielei 26,2022-10-01,02:00:00,21,12,9,FMN 12 Statielei
660,Statielei 26,2022-10-01,03:00:00,13,9,4,FMN 12 Statielei
660,Statielei 26,2022-10-01,04:00:00,18,9,9,FMN 12 Statielei
660,Statielei 26,2022-10-01,05:00:00,12,5,7,FMN 12 Statielei
660,Statielei 26,2022-10-01,06:00:00,13,7,6,FMN 12 Statielei
660,Statielei 26,2022-10-01,07:00:00,14,7,7,FMN 12 Statielei
660,Statielei 26,2022-10-01,08:00:00,43,20,23,FMN 12 Statielei
660,Statielei 26,2022-10-01,09:00:00,89,46,43,FMN 12 Statielei
660,Statielei 26,2022-10-01,10:00:00,86,43,43,FMN 12 Statielei
660,Statielei 26,2022-10-01,11:00:00,120,70,50,FMN 12 Statielei
660,Statielei 26,2022-10-01,12:00:00,91,50,41,FMN 12 Statielei
660,Statielei 26,2022-10-01,13:00:00,114,69,45,FMN 12 Statielei
660,Statielei 26,2022-10-01,14:00:00,103,56,47,FMN 12 Statielei
660,Statielei 26,2022-10-01,15:00:00,105,54,51,FMN 12 Statielei
660,Statielei 26,2022-10-01,16:00:00,92,52,40,FMN 12 Statielei
660,Statielei 26,2022-10-01,17:00:00,148,87,61,FMN 12 Statielei
660,Statielei 26,2022-10-01,18:00:00,136,64,72,FMN 12 Statielei
660,Statielei 26,2022-10-01,19:00:00,109,58,51,FMN 12 Statielei
660,Statielei 26,2022-10-01,20:00:00,85,41,44,FMN 12 Statielei
660,Statielei 26,2022-10-01,21:00:00,76,43,33,FMN 12 Statielei
660,Statielei 26,2022-10-01,22:00:00,80,31,49,FMN 12 Statielei
660,Statielei 26,2022-10-01,23:00:00,50,15,35,FMN 12 Statielei
660,Statielei 26,2022-10-02,00:00:00,43,22,21,FMN 12 Statielei
660,Statielei 26,2022-10-02,01:00:00,28,18,10,FMN 12 Statielei
660,Statielei 26,2022-10-02,02:00:00,47,23,24,FMN 12 Statielei
660,Statielei 26,2022-10-02,03:00:00,24,17,7,FMN 12 Statielei
660,Statielei 26,2022-10-02,04:00:00,7,4,3,FMN 12 Statielei
660,Statielei 26,2022-10-02,05:00:00,12,5,7,FMN 12 Statielei
660,Statielei 26,2022-10-02,06:00:00,8,5,3,FMN 12 Statielei
660,Statielei 26,2022-10-02,07:00:00,10,4,6,FMN 12 Statielei
660,Statielei 26,2022-10-02,08:00:00,32,12,20,FMN 12 Statielei
660,Statielei 26,2022-10-02,09:00:00,84,30,54,FMN 12 Statielei
660,Statielei 26,2022-10-02,10:00:00,79,37,42,FMN 12 Statielei
660,Statielei 26,2022-10-02,11:00:00,79,44,35,FMN 12 Statielei
660,Statielei 26,2022-10-02,12:00:00,122,87,35,FMN 12 Statielei
660,Statielei 26,2022-10-02,13:00:00,137,63,74,FMN 12 Statielei
660,Statielei 26,2022-10-02,14:00:00,106,51,55,FMN 12 Statielei
660,Statielei 26,2022-10-02,15:00:00,93,57,36,FMN 12 Statielei
660,Statielei 26,2022-10-02,16:00:00,119,57,62,FMN 12 Statielei
660,Statielei 26,2022-10-02,17:00:00,139,76,63,FMN 12 Statielei
660,Statielei 26,2022-10-02,18:00:00,133,85,48,FMN 12 Statielei
660,Statielei 26,2022-10-02,19:00:00,101,51,50,FMN 12 Statielei
660,Statielei 26,2022-10-02,20:00:00,79,46,33,FMN 12 Statielei
660,Statielei 26,2022-10-02,21:00:00,63,23,40,FMN 12 Statielei
660,Statielei 26,2022-10-02,22:00:00,41,18,23,FMN 12 Statielei
660,Statielei 26,2022-10-02,23:00:00,42,15,27,FMN 12 Statielei
660,Statielei 26,2022-10-03,00:00:00,18,8,10,FMN 12 Statielei
660,Statielei 26,2022-10-03,01:00:00,8,3,5,FMN 12 Statielei
660,Statielei 26,2022-10-03,02:00:00,6,1,5,FMN 12 Statielei
660,Statielei 26,2022-10-03,03:00:00,1,0,1,FMN 12 Statielei
660,Statielei 26,2022-10-03,04:00:00,6,3,3,FMN 12 Statielei
660,Statielei 26,2022-10-03,05:00:00,16,7,9,FMN 12 Statielei
660,Statielei 26,2022-10-03,06:00:00,30,10,20,FMN 12 Statielei
660,Statielei 26,2022-10-03,07:00:00,122,57,65,FMN 12 Statielei
660,Statielei 26,2022-10-03,08:00:00,236,147,89,FMN 12 Statielei
660,Statielei 26,2022-10-03,09:00:00,100,66,34,FMN 12 Statielei
660,Statielei 26,2022-10-03,10:00:00,75,43,32,FMN 12 Statielei
660,Statielei 26,2022-10-03,11:00:00,88,50,38,FMN 12 Statielei
660,Statielei 26,2022-10-03,12:00:00,147,72,75,FMN 12 Statielei
660,Statielei 26,2022-10-03,13:00:00,111,58,53,FMN 12 Statielei
660,Statielei 26,2022-10-03,14:00:00,96,59,37,FMN 12 Statielei
660,Statielei 26,2022-10-03,15:00:00,150,70,80,FMN 12 Statielei
660,Statielei 26,2022-10-03,16:00:00,192,91,101,FMN 12 Statielei
660,Statielei 26,2022-10-03,17:00:00,217,102,115,FMN 12 Statielei
660,Statielei 26,2022-10-03,18:00:00,188,92,96,FMN 12 Statielei
660,Statielei 26,2022-10-03,19:00:00,159,76,83,FMN 12 Statielei
660,Statielei 26,2022-10-03,20:00:00,95,56,39,FMN 12 Statielei
660,Statielei 26,2022-10-03,21:00:00,70,29,41,FMN 12 Statielei
660,Statielei 26,2022-10-03,22:00:00,67,28,39,FMN 12 Statielei
660,Statielei 26,2022-10-03,23:00:00,43,16,27,FMN 12 Statielei
660,Statielei 26,2022-10-04,00:00:00,11,1,10,FMN 12 Statielei
660,Statielei 26,2022-10-04,01:00:00,10,6,4,FMN 12 Statielei
660,Statielei 26,2022-10-04,02:00:00,3,1,2,FMN 12 Statielei
660,Statielei 26,2022-10-04,03:00:00,2,0,2,FMN 12 Statielei
660,Statielei 26,2022-10-04,04:00:00,6,3,3,FMN 12 Statielei
660,Statielei 26,2022-10-04,05:00:00,14,8,6,FMN 12 Statielei
660,Statielei 26,2022-10-04,06:00:00,37,13,24,FMN 12 Statielei
660,Statielei 26,2022-10-04,07:00:00,138,65,73,FMN 12 Statielei
660,Statielei 26,2022-10-04,08:00:00,284,168,116,FMN 12 Statielei
660,Statielei 26,2022-10-04,09:00:00,165,92,73,FMN 12 Statielei
660,Statielei 26,2022-10-04,10:00:00,80,55,25,FMN 12 Statielei
660,Statielei 26,2022-10-04,11:00:00,93,57,36,FMN 12 Statielei
660,Statielei 26,2022-10-04,12:00:00,118,73,45,FMN 12 Statielei
660,Statielei 26,2022-10-04,13:00:00,79,48,31,FMN 12 Statielei
660,Statielei 26,2022-10-04,14:00:00,103,45,58,FMN 12 Statielei
660,Statielei 26,2022-10-04,15:00:00,166,70,96,FMN 12 Statielei
660,Statielei 26,2022-10-04,16:00:00,264,139,125,FMN 12 Statielei
660,Statielei 26,2022-10-04,17:00:00,272,131,141,FMN 12 Statielei
660,Statielei 26,2022-10-04,18:00:00,195,97,98,FMN 12 Statielei
660,Statielei 26,2022-10-04,19:00:00,141,68,73,FMN 12 Statielei
660,Statielei 26,2022-10-04,20:00:00,107,53,54,FMN 12 Statielei
660,Statielei 26,2022-10-04,21:00:00,86,37,49,FMN 12 Statielei
660,Statielei 26,2022-10-04,22:00:00,69,32,37,FMN 12 Statielei
660,Statielei 26,2022-10-04,23:00:00,41,18,23,FMN 12 Statielei
660,Statielei 26,2022-10-05,00:00:00,26,15,11,FMN 12 Statielei
660,Statielei 26,2022-10-05,01:00:00,7,3,4,FMN 12 Statielei
660,Statielei 26,2022-10-05,02:00:00,5,2,3,FMN 12 Statielei
660,Statielei 26,2022-10-05,03:00:00,3,1,2,FMN 12 Statielei
660,Statielei 26,2022-10-05,04:00:00,5,2,3,FMN 12 Statielei
660,Statielei 26,2022-10-05,05:00:00,14,7,7,FMN 12 Statielei
660,Statielei 26,2022-10-05,06:00:00,33,12,21,FMN 12 Statielei
660,Statielei 26,2022-10-05,07:00:00,107,42,65,FMN 12 Statielei
660,Statielei 26,2022-10-05,08:00:00,271,143,128,FMN 12 Statielei
660,Statielei 26,2022-10-05,09:00:00,106,68,38,FMN 12 Statielei
660,Statielei 26,2022-10-05,10:00:00,81,44,37,FMN 12 Statielei
660,Statielei 26,2022-10-05,11:00:00,99,55,44,FMN 12 Statielei
660,Statielei 26,2022-10-05,12:00:00,195,95,100,FMN 12 Statielei
660,Statielei 26,2022-10-05,13:00:00,180,98,82,FMN 12 Statielei
660,Statielei 26,2022-10-05,14:00:00,130,70,60,FMN 12 Statielei
660,Statielei 26,2022-10-05,15:00:00,164,90,74,FMN 12 Statielei
660,Statielei 26,2022-10-05,16:00:00,213,112,101,FMN 12 Statielei
660,Statielei 26,2022-10-05,17:00:00,227,102,125,FMN 12 Statielei
660,Statielei 26,2022-10-05,18:00:00,197,106,91,FMN 12 Statielei
660,Statielei 26,2022-10-05,19:00:00,186,92,94,FMN 12 Statielei
660,Statielei 26,2022-10-05,20:00:00,92,42,50,FMN 12 Statielei
660,Statielei 26,2022-10-05,21:00:00,72,44,28,FMN 12 Statielei
660,Statielei 26,2022-10-05,22:00:00,65,36,29,FMN 12 Statielei
660,Statielei 26,2022-10-05,23:00:00,51,18,33,FMN 12 Statielei
660,Statielei 26,2022-10-06,00:00:00,20,4,16,FMN 12 Statielei
660,Statielei 26,2022-10-06,01:00:00,16,7,9,FMN 12 Statielei
660,Statielei 26,2022-10-06,02:00:00,8,2,6,FMN 12 Statielei
660,Statielei 26,2022-10-06,03:00:00,4,1,3,FMN 12 Statielei
660,Statielei 26,2022-10-06,04:00:00,8,2,6,FMN 12 Statielei
660,Statielei 26,2022-10-06,05:00:00,12,6,6,FMN 12 Statielei
660,Statielei 26,2022-10-06,06:00:00,37,11,26,FMN 12 Statielei
660,Statielei 26,2022-10-06,07:00:00,128,63,65,FMN 12 Statielei
660,Statielei 26,2022-10-06,08:00:00,296,156,140,FMN 12 Statielei
660,Statielei 26,2022-10-06,09:00:00,128,89,39,FMN 12 Statielei
660,Statielei 26,2022-10-06,10:00:00,96,71,25,FMN 12 Statielei
660,Statielei 26,2022-10-06,11:00:00,99,62,37,FMN 12 Statielei
660,Statielei 26,2022-10-06,12:00:00,134,72,62,FMN 12 Statielei
660,Statielei 26,2022-10-06,13:00:00,100,50,50,FMN 12 Statielei
660,Statielei 26,2022-10-06,14:00:00,107,50,57,FMN 12 Statielei
660,Statielei 26,2022-10-06,15:00:00,158,68,90,FMN 12 Statielei
660,Statielei 26,2022-10-06,16:00:00,264,137,127,FMN 12 Statielei
660,Statielei 26,2022-10-06,17:00:00,250,130,120,FMN 12 Statielei
660,Statielei 26,2022-10-06,18:00:00,215,102,113,FMN 12 Statielei
660,Statielei 26,2022-10-06,19:00:00,183,104,79,FMN 12 Statielei
660,Statielei 26,2022-10-06,20:00:00,118,60,58,FMN 12 Statielei
660,Statielei 26,2022-10-06,21:00:00,94,43,51,FMN 12 Statielei
660,Statielei 26,2022-10-06,22:00:00,92,41,51,FMN 12 Statielei
660,Statielei 26,2022-10-06,23:00:00,64,33,31,FMN 12 Statielei
660,Statielei 26,2022-10-07,00:00:00,18,4,14,FMN 12 Statielei
660,Statielei 26,2022-10-07,01:00:00,20,7,13,FMN 12 Statielei
660,Statielei 26,2022-10-07,02:00:00,5,2,3,FMN 12 Statielei
660,Statielei 26,2022-10-07,03:00:00,3,1,2,FMN 12 Statielei
660,Statielei 26,2022-10-07,04:00:00,8,3,5,FMN 12 Statielei
660,Statielei 26,2022-10-07,05:00:00,15,6,9,FMN 12 Statielei
660,Statielei 26,2022-10-07,06:00:00,32,14,18,FMN 12 Statielei
660,Statielei 26,2022-10-07,07:00:00,117,57,60,FMN 12 Statielei
660,Statielei 26,2022-10-07,08:00:00,252,136,116,FMN 12 Statielei
660,Statielei 26,2022-10-07,09:00:00,130,79,51,FMN 12 Statielei
660,Statielei 26,2022-10-07,10:00:00,78,51,27,FMN 12 Statielei
660,Statielei 26,2022-10-07,11:00:00,91,54,37,FMN 12 Statielei
660,Statielei 26,2022-10-07,12:00:00,130,80,50,FMN 12 Statielei
660,Statielei 26,2022-10-07,13:00:00,90,54,36,FMN 12 Statielei
660,Statielei 26,2022-10-07,14:00:00,114,56,58,FMN 12 Statielei
660,Statielei 26,2022-10-07,15:00:00,165,69,96,FMN 12 Statielei
660,Statielei 26,2022-10-07,16:00:00,263,150,113,FMN 12 Statielei
660,Statielei 26,2022-10-07,17:00:00,230,114,116,FMN 12 Statielei
660,Statielei 26,2022-10-07,18:00:00,178,84,94,FMN 12 Statielei
660,Statielei 26,2022-10-07,19:00:00,193,103,90,FMN 12 Statielei
660,Statielei 26,2022-10-07,20:00:00,119,60,59,FMN 12 Statielei
660,Statielei 26,2022-10-07,21:00:00,72,38,34,FMN 12 Statielei
660,Statielei 26,2022-10-07,22:00:00,80,33,47,FMN 12 Statielei
660,Statielei 26,2022-10-07,23:00:00,88,42,46,FMN 12 Statielei
660,Statielei 26,2022-10-08,00:00:00,45,24,21,FMN 12 Statielei
660,Statielei 26,2022-10-08,01:00:00,35,16,19,FMN 12 Statielei
660,Statielei 26,2022-10-08,02:00:00,18,11,7,FMN 12 Statielei
660,Statielei 26,2022-10-08,03:00:00,10,2,8,FMN 12 Statielei
660,Statielei 26,2022-10-08,04:00:00,10,3,7,FMN 12 Statielei
660,Statielei 26,2022-10-08,05:00:00,9,7,2,FMN 12 Statielei
660,Statielei 26,2022-10-08,06:00:00,16,5,11,FMN 12 Statielei
660,Statielei 26,2022-10-08,07:00:00,15,5,10,FMN 12 Statielei
660,Statielei 26,2022-10-08,08:00:00,52,19,33,FMN 12 Statielei
660,Statielei 26,2022-10-08,09:00:00,80,41,39,FMN 12 Statielei
660,Statielei 26,2022-10-08,10:00:00,142,78,64,FMN 12 Statielei
660,Statielei 26,2022-10-08,11:00:00,139,98,41,FMN 12 Statielei
660,Statielei 26,2022-10-08,12:00:00,138,86,52,FMN 12 Statielei
660,Statielei 26,2022-10-08,13:00:00,164,82,82,FMN 12 Statielei
660,Statielei 26,2022-10-08,14:00:00,156,81,75,FMN 12 Statielei
660,Statielei 26,2022-10-08,15:00:00,117,51,66,FMN 12 Statielei
660,Statielei 26,2022-10-08,16:00:00,167,79,88,FMN 12 Statielei
660,Statielei 26,2022-10-08,17:00:00,137,70,67,FMN 12 Statielei
660,Statielei 26,2022-10-08,18:00:00,163,101,62,FMN 12 Statielei
660,Statielei 26,2022-10-08,19:00:00,134,84,50,FMN 12 Statielei
660,Statielei 26,2022-10-08,20:00:00,106,58,48,FMN 12 Statielei
660,Statielei 26,2022-10-08,21:00:00,60,27,33,FMN 12 Statielei
660,Statielei 26,2022-10-08,22:00:00,89,44,45,FMN 12 Statielei
660,Statielei 26,2022-10-08,23:00:00,66,26,40,FMN 12 Statielei
660,Statielei 26,2022-10-09,00:00:00,36,20,16,FMN 12 Statielei
660,Statielei 26,2022-10-09,01:00:00,50,22,28,FMN 12 Statielei
660,Statielei 26,2022-10-09,02:00:00,28,8,20,FMN 12 Statielei
660,Statielei 26,2022-10-09,03:00:00,14,8,6,FMN 12 Statielei
660,Statielei 26,2022-10-09,04:00:00,20,9,11,FMN 12 Statielei
660,Statielei 26,2022-10-09,05:00:00,22,10,12,FMN 12 Statielei
660,Statielei 26,2022-10-09,06:00:00,8,3,5,FMN 12 Statielei
660,Statielei 26,2022-10-09,07:00:00,10,7,3,FMN 12 Statielei
660,Statielei 26,2022-10-09,08:00:00,41,17,24,FMN 12 Statielei
660,Statielei 26,2022-10-09,09:00:00,85,31,54,FMN 12 Statielei
660,Statielei 26,2022-10-09,10:00:00,85,36,49,FMN 12 Statielei
660,Statielei 26,2022-10-09,11:00:00,111,55,56,FMN 12 Statielei
660,Statielei 26,2022-10-09,12:00:00,116,64,52,FMN 12 Statielei
660,Statielei 26,2022-10-09,13:00:00,170,88,82,FMN 12 Statielei
660,Statielei 26,2022-10-09,14:00:00,188,83,105,FMN 12 Statielei
660,Statielei 26,2022-10-09,15:00:00,172,78,94,FMN 12 Statielei
660,Statielei 26,2022-10-09,16:00:00,153,77,76,FMN 12 Statielei
660,Statielei 26,2022-10-09,17:00:00,189,117,72,FMN 12 Statielei
660,Statielei 26,2022-10-09,18:00:00,178,126,52,FMN 12 Statielei
660,Statielei 26,2022-10-09,19:00:00,120,63,57,FMN 12 Statielei
660,Statielei 26,2022-10-09,20:00:00,83,38,45,FMN 12 Statielei
660,Statielei 26,2022-10-09,21:00:00,48,25,23,FMN 12 Statielei
660,Statielei 26,2022-10-09,22:00:00,39,19,20,FMN 12 Statielei
660,Statielei 26,2022-10-09,23:00:00,22,8,14,FMN 12 Statielei
660,Statielei 26,2022-10-10,00:00:00,23,14,9,FMN 12 Statielei
660,Statielei 26,2022-10-10,01:00:00,3,3,0,FMN 12 Statielei
660,Statielei 26,2022-10-10,02:00:00,2,0,2,FMN 12 Statielei
660,Statielei 26,2022-10-10,03:00:00,4,3,1,FMN 12 Statielei
660,Statielei 26,2022-10-10,04:00:00,7,4,3,FMN 12 Statielei
660,Statielei 26,2022-10-10,05:00:00,13,6,7,FMN 12 Statielei
660,Statielei 26,2022-10-10,06:00:00,33,10,23,FMN 12 Statielei
660,Statielei 26,2022-10-10,07:00:00,128,63,65,FMN 12 Statielei
660,Statielei 26,2022-10-10,08:00:00,300,157,143,FMN 12 Statielei
660,Statielei 26,2022-10-10,09:00:00,105,59,46,FMN 12 Statielei
660,Statielei 26,2022-10-10,10:00:00,85,55,30,FMN 12 Statielei
660,Statielei 26,2022-10-10,11:00:00,76,45,31,FMN 12 Statielei
660,Statielei 26,2022-10-10,12:00:00,126,64,62,FMN 12 Statielei
660,Statielei 26,2022-10-10,13:00:00,104,53,51,FMN 12 Statielei
660,Statielei 26,2022-10-10,14:00:00,101,49,52,FMN 12 Statielei
660,Statielei 26,2022-10-10,15:00:00,173,83,90,FMN 12 Statielei
660,Statielei 26,2022-10-10,16:00:00,234,126,108,FMN 12 Statielei
660,Statielei 26,2022-10-10,17:00:00,226,118,108,FMN 12 Statielei
660,Statielei 26,2022-10-10,18:00:00,175,80,95,FMN 12 Statielei
660,Statielei 26,2022-10-10,19:00:00,102,56,46,FMN 12 Statielei
660,Statielei 26,2022-10-10,20:00:00,88,47,41,FMN 12 Statielei
660,Statielei 26,2022-10-10,21:00:00,56,27,29,FMN 12 Statielei
660,Statielei 26,2022-10-10,22:00:00,61,27,34,FMN 12 Statielei
660,Statielei 26,2022-10-10,23:00:00,34,10,24,FMN 12 Statielei
660,Statielei 26,2022-10-11,00:00:00,13,6,7,FMN 12 Statielei
660,Statielei 26,2022-10-11,01:00:00,13,4,9,FMN 12 Statielei
660,Statielei 26,2022-10-11,02:00:00,5,2,3,FMN 12 Statielei
660,Statielei 26,2022-10-11,03:00:00,5,4,1,FMN 12 Statielei
660,Statielei 26,2022-10-11,04:00:00,4,2,2,FMN 12 Statielei
660,Statielei 26,2022-10-11,05:00:00,15,9,6,FMN 12 Statielei
660,Statielei 26,2022-10-11,06:00:00,36,15,21,FMN 12 Statielei
660,Statielei 26,2022-10-11,07:00:00,128,62,66,FMN 12 Statielei
660,Statielei 26,2022-10-11,08:00:00,307,162,145,FMN 12 Statielei
660,Statielei 26,2022-10-11,09:00:00,132,69,63,FMN 12 Statielei
660,Statielei 26,2022-10-11,10:00:00,75,49,26,FMN 12 Statielei
660,Statielei 26,2022-10-11,11:00:00,81,53,28,FMN 12 Statielei
660,Statielei 26,2022-10-11,12:00:00,129,81,48,FMN 12 Statielei
660,Statielei 26,2022-10-11,13:00:00,99,53,46,FMN 12 Statielei
660,Statielei 26,2022-10-11,14:00:00,104,45,59,FMN 12 Statielei
660,Statielei 26,2022-10-11,15:00:00,174,69,105,FMN 12 Statielei
660,Statielei 26,2022-10-11,16:00:00,254,122,132,FMN 12 Statielei
660,Statielei 26,2022-10-11,17:00:00,252,120,132,FMN 12 Statielei
660,Statielei 26,2022-10-11,18:00:00,205,103,102,FMN 12 Statielei
660,Statielei 26,2022-10-11,19:00:00,147,68,79,FMN 12 Statielei
660,Statielei 26,2022-10-11,20:00:00,92,51,41,FMN 12 Statielei
660,Statielei 26,2022-10-11,21:00:00,66,27,39,FMN 12 Statielei
660,Statielei 26,2022-10-11,22:00:00,69,33,36,FMN 12 Statielei
660,Statielei 26,2022-10-11,23:00:00,29,9,20,FMN 12 Statielei
660,Statielei 26,2022-10-12,00:00:00,22,10,12,FMN 12 Statielei
660,Statielei 26,2022-10-12,01:00:00,13,8,5,FMN 12 Statielei
660,Statielei 26,2022-10-12,02:00:00,5,0,5,FMN 12 Statielei
660,Statielei 26,2022-10-12,03:00:00,2,0,2,FMN 12 Statielei
660,Statielei 26,2022-10-12,04:00:00,5,2,3,FMN 12 Statielei
660,Statielei 26,2022-10-12,05:00:00,15,7,8,FMN 12 Statielei
660,Statielei 26,2022-10-12,06:00:00,23,6,17,FMN 12 Statielei
660,Statielei 26,2022-10-12,07:00:00,122,48,74,FMN 12 Statielei
660,Statielei 26,2022-10-12,08:00:00,269,162,107,FMN 12 Statielei
660,Statielei 26,2022-10-12,09:00:00,116,81,35,FMN 12 Statielei
660,Statielei 26,2022-10-12,10:00:00,99,59,40,FMN 12 Statielei
660,Statielei 26,2022-10-12,11:00:00,106,58,48,FMN 12 Statielei
660,Statielei 26,2022-10-12,12:00:00,226,95,131,FMN 12 Statielei
660,Statielei 26,2022-10-12,13:00:00,158,90,68,FMN 12 Statielei
660,Statielei 26,2022-10-12,14:00:00,148,65,83,FMN 12 Statielei
660,Statielei 26,2022-10-12,15:00:00,156,70,86,FMN 12 Statielei
660,Statielei 26,2022-10-12,16:00:00,202,94,108,FMN 12 Statielei
660,Statielei 26,2022-10-12,17:00:00,263,140,123,FMN 12 Statielei
660,Statielei 26,2022-10-12,18:00:00,198,107,91,FMN 12 Statielei
660,Statielei 26,2022-10-12,19:00:00,147,77,70,FMN 12 Statielei
660,Statielei 26,2022-10-12,20:00:00,93,54,39,FMN 12 Statielei
660,Statielei 26,2022-10-12,21:00:00,60,32,28,FMN 12 Statielei
660,Statielei 26,2022-10-12,22:00:00,84,37,47,FMN 12 Statielei
660,Statielei 26,2022-10-12,23:00:00,37,16,21,FMN 12 Statielei
660,Statielei 26,2022-10-13,00:00:00,35,15,20,FMN 12 Statielei
660,Statielei 26,2022-10-13,01:00:00,11,1,10,FMN 12 Statielei
660,Statielei 26,2022-10-13,02:00:00,5,2,3,FMN 12 Statielei
660,Statielei 26,2022-10-13,03:00:00,3,1,2,FMN 12 Statielei
660,Statielei 26,2022-10-13,04:00:00,6,4,2,FMN 12 Statielei
660,Statielei 26,2022-10-13,05:00:00,14,7,7,FMN 12 Statielei
660,Statielei 26,2022-10-13,06:00:00,36,10,26,FMN 12 Statielei
660,Statielei 26,2022-10-13,07:00:00,123,47,76,FMN 12 Statielei
660,Statielei 26,2022-10-13,08:00:00,307,174,133,FMN 12 Statielei
660,Statielei 26,2022-10-13,09:00:00,121,83,38,FMN 12 Statielei
660,Statielei 26,2022-10-13,10:00:00,53,34,19,FMN 12 Statielei
660,Statielei 26,2022-10-13,11:00:00,63,39,24,FMN 12 Statielei
660,Statielei 26,2022-10-13,12:00:00,107,49,58,FMN 12 Statielei
660,Statielei 26,2022-10-13,13:00:00,63,33,30,FMN 12 Statielei
660,Statielei 26,2022-10-13,14:00:00,71,37,34,FMN 12 Statielei
660,Statielei 26,2022-10-13,15:00:00,160,66,94,FMN 12 Statielei
660,Statielei 26,2022-10-13,16:00:00,235,136,99,FMN 12 Statielei
660,Statielei 26,2022-10-13,17:00:00,213,81,132,FMN 12 Statielei
660,Statielei 26,2022-10-13,18:00:00,168,88,80,FMN 12 Statielei
660,Statielei 26,2022-10-13,19:00:00,137,85,52,FMN 12 Statielei
660,Statielei 26,2022-10-13,20:00:00,102,61,41,FMN 12 Statielei
660,Statielei 26,2022-10-13,21:00:00,79,44,35,FMN 12 Statielei
660,Statielei 26,2022-10-13,22:00:00,67,34,33,FMN 12 Statielei
660,Statielei 26,2022-10-13,23:00:00,42,19,23,FMN 12 Statielei
660,Statielei 26,2022-10-14,00:00:00,21,4,17,FMN 12 Statielei
660,Statielei 26,2022-10-14,01:00:00,19,10,9,FMN 12 Statielei
660,Statielei 26,2022-10-14,02:00:00,12,2,10,FMN 12 Statielei
660,Statielei 26,2022-10-14,03:00:00,8,0,8,FMN 12 Statielei
660,Statielei 26,2022-10-14,04:00:00,5,2,3,FMN 12 Statielei
660,Statielei 26,2022-10-14,05:00:00,17,8,9,FMN 12 Statielei
660,Statielei 26,2022-10-14,06:00:00,35,16,19,FMN 12 Statielei
660,Statielei 26,2022-10-14,07:00:00,119,55,64,FMN 12 Statielei
660,Statielei 26,2022-10-14,08:00:00,248,126,122,FMN 12 Statielei
660,Statielei 26,2022-10-14,09:00:00,81,52,29,FMN 12 Statielei
660,Statielei 26,2022-10-14,10:00:00,62,34,28,FMN 12 Statielei
660,Statielei 26,2022-10-14,11:00:00,56,27,29,FMN 12 Statielei
660,Statielei 26,2022-10-14,12:00:00,91,52,39,FMN 12 Statielei
660,Statielei 26,2022-10-14,13:00:00,85,46,39,FMN 12 Statielei
660,Statielei 26,2022-10-14,14:00:00,97,48,49,FMN 12 Statielei
660,Statielei 26,2022-10-14,15:00:00,179,79,100,FMN 12 Statielei
660,Statielei 26,2022-10-14,16:00:00,189,104,85,FMN 12 Statielei
660,Statielei 26,2022-10-14,17:00:00,201,89,112,FMN 12 Statielei
660,Statielei 26,2022-10-14,18:00:00,207,90,117,FMN 12 Statielei
660,Statielei 26,2022-10-14,19:00:00,161,89,72,FMN 12 Statielei
660,Statielei 26,2022-10-14,20:00:00,128,76,52,FMN 12 Statielei
660,Statielei 26,2022-10-14,21:00:00,64,34,30,FMN 12 Statielei
660,Statielei 26,2022-10-14,22:00:00,55,29,26,FMN 12 Statielei
660,Statielei 26,2022-10-14,23:00:00,91,54,37,FMN 12 Statielei
660,Statielei 26,2022-10-15,00:00:00,57,26,31,FMN 12 Statielei
660,Statielei 26,2022-10-15,01:00:00,39,17,22,FMN 12 Statielei
660,Statielei 26,2022-10-15,02:00:00,23,13,10,FMN 12 Statielei
660,Statielei 26,2022-10-15,03:00:00,16,7,9,FMN 12 Statielei
660,Statielei 26,2022-10-15,04:00:00,9,3,6,FMN 12 Statielei
660,Statielei 26,2022-10-15,05:00:00,14,5,9,FMN 12 Statielei
660,Statielei 26,2022-10-15,06:00:00,12,4,8,FMN 12 Statielei
660,Statielei 26,2022-10-15,07:00:00,22,12,10,FMN 12 Statielei
660,Statielei 26,2022-10-15,08:00:00,54,29,25,FMN 12 Statielei
660,Statielei 26,2022-10-15,09:00:00,83,38,45,FMN 12 Statielei
660,Statielei 26,2022-10-15,10:00:00,91,59,32,FMN 12 Statielei
660,Statielei 26,2022-10-15,11:00:00,102,50,52,FMN 12 Statielei
660,Statielei 26,2022-10-15,12:00:00,120,74,46,FMN 12 Statielei
660,Statielei 26,2022-10-15,13:00:00,115,67,48,FMN 12 Statielei
660,Statielei 26,2022-10-15,14:00:00,144,61,83,FMN 12 Statielei
660,Statielei 26,2022-10-15,15:00:00,148,76,72,FMN 12 Statielei
660,Statielei 26,2022-10-15,16:00:00,151,73,78,FMN 12 Statielei
660,Statielei 26,2022-10-15,17:00:00,164,93,71,FMN 12 Statielei
660,Statielei 26,2022-10-15,18:00:00,151,83,68,FMN 12 Statielei
660,Statielei 26,2022-10-15,19:00:00,132,69,63,FMN 12 Statielei
660,Statielei 26,2022-10-15,20:00:00,83,48,35,FMN 12 Statielei
660,Statielei 26,2022-10-15,21:00:00,54,23,31,FMN 12 Statielei
660,Statielei 26,2022-10-15,22:00:00,73,31,42,FMN 12 Statielei
660,Statielei 26,2022-10-15,23:00:00,32,11,21,FMN 12 Statielei
660,Statielei 26,2022-10-16,00:00:00,51,20,31,FMN 12 Statielei
660,Statielei 26,2022-10-16,01:00:00,57,29,28,FMN 12 Statielei
660,Statielei 26,2022-10-16,02:00:00,22,7,15,FMN 12 Statielei
660,Statielei 26,2022-10-16,03:00:00,17,11,6,FMN 12 Statielei
660,Statielei 26,2022-10-16,04:00:00,8,5,3,FMN 12 Statielei
660,Statielei 26,2022-10-16,05:00:00,17,9,8,FMN 12 Statielei
660,Statielei 26,2022-10-16,06:00:00,5,1,4,FMN 12 Statielei
660,Statielei 26,2022-10-16,07:00:00,14,5,9,FMN 12 Statielei
660,Statielei 26,2022-10-16,08:00:00,40,20,20,FMN 12 Statielei
660,Statielei 26,2022-10-16,09:00:00,72,35,37,FMN 12 Statielei
660,Statielei 26,2022-10-16,10:00:00,87,40,47,FMN 12 Statielei
660,Statielei 26,2022-10-16,11:00:00,117,67,50,FMN 12 Statielei
660,Statielei 26,2022-10-16,12:00:00,110,62,48,FMN 12 Statielei
660,Statielei 26,2022-10-16,13:00:00,161,69,92,FMN 12 Statielei
660,Statielei 26,2022-10-16,14:00:00,152,74,78,FMN 12 Statielei
660,Statielei 26,2022-10-16,15:00:00,126,56,70,FMN 12 Statielei
660,Statielei 26,2022-10-16,16:00:00,141,83,58,FMN 12 Statielei
660,Statielei 26,2022-10-16,17:00:00,176,110,66,FMN 12 Statielei
660,Statielei 26,2022-10-16,18:00:00,141,84,57,FMN 12 Statielei
660,Statielei 26,2022-10-16,19:00:00,104,55,49,FMN 12 Statielei
660,Statielei 26,2022-10-16,20:00:00,69,29,40,FMN 12 Statielei
660,Statielei 26,2022-10-16,21:00:00,61,28,33,FMN 12 Statielei
660,Statielei 26,2022-10-16,22:00:00,52,19,33,FMN 12 Statielei
660,Statielei 26,2022-10-16,23:00:00,26,7,19,FMN 12 Statielei
660,Statielei 26,2022-10-17,00:00:00,19,9,10,FMN 12 Statielei
660,Statielei 26,2022-10-17,01:00:00,14,12,2,FMN 12 Statielei
660,Statielei 26,2022-10-17,02:00:00,13,8,5,FMN 12 Statielei
660,Statielei 26,2022-10-17,03:00:00,11,9,2,FMN 12 Statielei
660,Statielei 26,2022-10-17,04:00:00,14,6,8,FMN 12 Statielei
660,Statielei 26,2022-10-17,05:00:00,16,8,8,FMN 12 Statielei
660,Statielei 26,2022-10-17,06:00:00,27,11,16,FMN 12 Statielei
660,Statielei 26,2022-10-17,07:00:00,123,59,64,FMN 12 Statielei
660,Statielei 26,2022-10-17,08:00:00,265,137,128,FMN 12 Statielei
660,Statielei 26,2022-10-17,09:00:00,66,44,22,FMN 12 Statielei
660,Statielei 26,2022-10-17,10:00:00,33,22,11,FMN 12 Statielei
660,Statielei 26,2022-10-17,11:00:00,55,26,29,FMN 12 Statielei
660,Statielei 26,2022-10-17,12:00:00,90,55,35,FMN 12 Statielei
660,Statielei 26,2022-10-17,13:00:00,70,35,35,FMN 12 Statielei
660,Statielei 26,2022-10-17,14:00:00,63,33,30,FMN 12 Statielei
660,Statielei 26,2022-10-17,15:00:00,139,60,79,FMN 12 Statielei
660,Statielei 26,2022-10-17,16:00:00,221,130,91,FMN 12 Statielei
660,Statielei 26,2022-10-17,17:00:00,231,111,120,FMN 12 Statielei
660,Statielei 26,2022-10-17,18:00:00,146,78,68,FMN 12 Statielei
660,Statielei 26,2022-10-17,19:00:00,116,59,57,FMN 12 Statielei
660,Statielei 26,2022-10-17,20:00:00,88,50,38,FMN 12 Statielei
660,Statielei 26,2022-10-17,21:00:00,70,36,34,FMN 12 Statielei
660,Statielei 26,2022-10-17,22:00:00,60,25,35,FMN 12 Statielei
660,Statielei 26,2022-10-17,23:00:00,22,10,12,FMN 12 Statielei
660,Statielei 26,2022-10-18,00:00:00,17,4,13,FMN 12 Statielei
660,Statielei 26,2022-10-18,01:00:00,6,4,2,FMN 12 Statielei
660,Statielei 26,2022-10-18,02:00:00,4,2,2,FMN 12 Statielei
660,Statielei 26,2022-10-18,03:00:00,4,2,2,FMN 12 Statielei
660,Statielei 26,2022-10-18,04:00:00,9,3,6,FMN 12 Statielei
660,Statielei 26,2022-10-18,05:00:00,13,8,5,FMN 12 Statielei
660,Statielei 26,2022-10-18,06:00:00,34,15,19,FMN 12 Statielei
660,Statielei 26,2022-10-18,07:00:00,151,71,80,FMN 12 Statielei
660,Statielei 26,2022-10-18,08:00:00,322,173,149,FMN 12 Statielei
660,Statielei 26,2022-10-18,09:00:00,134,86,48,FMN 12 Statielei
660,Statielei 26,2022-10-18,10:00:00,85,57,28,FMN 12 Statielei
660,Statielei 26,2022-10-18,11:00:00,89,49,40,FMN 12 Statielei
660,Statielei 26,2022-10-18,12:00:00,136,72,64,FMN 12 Statielei
660,Statielei 26,2022-10-18,13:00:00,147,77,70,FMN 12 Statielei
660,Statielei 26,2022-10-18,14:00:00,105,52,53,FMN 12 Statielei
660,Statielei 26,2022-10-18,15:00:00,204,85,119,FMN 12 Statielei
660,Statielei 26,2022-10-18,16:00:00,320,178,142,FMN 12 Statielei
660,Statielei 26,2022-10-18,17:00:00,276,132,144,FMN 12 Statielei
660,Statielei 26,2022-10-18,18:00:00,193,94,99,FMN 12 Statielei
660,Statielei 26,2022-10-18,19:00:00,136,71,65,FMN 12 Statielei
660,Statielei 26,2022-10-18,20:00:00,115,72,43,FMN 12 Statielei
660,Statielei 26,2022-10-18,21:00:00,80,29,51,FMN 12 Statielei
660,Statielei 26,2022-10-18,22:00:00,90,38,52,FMN 12 Statielei
660,Statielei 26,2022-10-18,23:00:00,35,16,19,FMN 12 Statielei
660,Statielei 26,2022-10-19,00:00:00,20,4,16,FMN 12 Statielei
660,Statielei 26,2022-10-19,01:00:00,7,4,3,FMN 12 Statielei
660,Statielei 26,2022-10-19,02:00:00,8,2,6,FMN 12 Statielei
660,Statielei 26,2022-10-19,03:00:00,6,2,4,FMN 12 Statielei
660,Statielei 26,2022-10-19,04:00:00,8,2,6,FMN 12 Statielei
660,Statielei 26,2022-10-19,05:00:00,13,7,6,FMN 12 Statielei
660,Statielei 26,2022-10-19,06:00:00,38,11,27,FMN 12 Statielei
660,Statielei 26,2022-10-19,07:00:00,116,47,69,FMN 12 Statielei
660,Statielei 26,2022-10-19,08:00:00,309,169,140,FMN 12 Statielei
660,Statielei 26,2022-10-19,09:00:00,110,80,30,FMN 12 Statielei
660,Statielei 26,2022-10-19,10:00:00,111,69,42,FMN 12 Statielei
660,Statielei 26,2022-10-19,11:00:00,100,53,47,FMN 12 Statielei
660,Statielei 26,2022-10-19,12:00:00,232,130,102,FMN 12 Statielei
660,Statielei 26,2022-10-19,13:00:00,141,76,65,FMN 12 Statielei
660,Statielei 26,2022-10-19,14:00:00,153,81,72,FMN 12 Statielei
660,Statielei 26,2022-10-19,15:00:00,159,58,101,FMN 12 Statielei
660,Statielei 26,2022-10-19,16:00:00,213,93,120,FMN 12 Statielei
660,Statielei 26,2022-10-19,17:00:00,286,130,156,FMN 12 Statielei
660,Statielei 26,2022-10-19,18:00:00,209,107,102,FMN 12 Statielei
660,Statielei 26,2022-10-19,19:00:00,155,99,56,FMN 12 Statielei
660,Statielei 26,2022-10-19,20:00:00,111,56,55,FMN 12 Statielei
660,Statielei 26,2022-10-19,21:00:00,71,28,43,FMN 12 Statielei
660,Statielei 26,2022-10-19,22:00:00,72,34,38,FMN 12 Statielei
660,Statielei 26,2022-10-19,23:00:00,78,27,51,FMN 12 Statielei
660,Statielei 26,2022-10-20,00:00:00,31,16,15,FMN 12 Statielei
660,Statielei 26,2022-10-20,01:00:00,9,4,5,FMN 12 Statielei
660,Statielei 26,2022-10-20,02:00:00,6,1,5,FMN 12 Statielei
660,Statielei 26,2022-10-20,03:00:00,3,0,3,FMN 12 Statielei
660,Statielei 26,2022-10-20,04:00:00,8,2,6,FMN 12 Statielei
660,Statielei 26,2022-10-20,05:00:00,17,9,8,FMN 12 Statielei
660,Statielei 26,2022-10-20,06:00:00,36,12,24,FMN 12 Statielei
660,Statielei 26,2022-10-20,07:00:00,141,66,75,FMN 12 Statielei
660,Statielei 26,2022-10-20,08:00:00,307,161,146,FMN 12 Statielei
660,Statielei 26,2022-10-20,09:00:00,99,59,40,FMN 12 Statielei
660,Statielei 26,2022-10-20,10:00:00,67,46,21,FMN 12 Statielei
660,Statielei 26,2022-10-20,11:00:00,59,32,27,FMN 12 Statielei
660,Statielei 26,2022-10-20,12:00:00,101,53,48,FMN 12 Statielei
660,Statielei 26,2022-10-20,13:00:00,74,42,32,FMN 12 Statielei
660,Statielei 26,2022-10-20,14:00:00,72,36,36,FMN 12 Statielei
660,Statielei 26,2022-10-20,15:00:00,160,74,86,FMN 12 Statielei
660,Statielei 26,2022-10-20,16:00:00,265,136,129,FMN 12 Statielei
660,Statielei 26,2022-10-20,17:00:00,259,115,144,FMN 12 Statielei
660,Statielei 26,2022-10-20,18:00:00,246,127,119,FMN 12 Statielei
660,Statielei 26,2022-10-20,19:00:00,169,90,79,FMN 12 Statielei
660,Statielei 26,2022-10-20,20:00:00,106,65,41,FMN 12 Statielei
660,Statielei 26,2022-10-20,21:00:00,122,74,48,FMN 12 Statielei
660,Statielei 26,2022-10-20,22:00:00,90,48,42,FMN 12 Statielei
660,Statielei 26,2022-10-20,23:00:00,62,21,41,FMN 12 Statielei
660,Statielei 26,2022-10-21,00:00:00,24,9,15,FMN 12 Statielei
660,Statielei 26,2022-10-21,01:00:00,16,7,9,FMN 12 Statielei
660,Statielei 26,2022-10-21,02:00:00,9,1,8,FMN 12 Statielei
660,Statielei 26,2022-10-21,03:00:00,7,2,5,FMN 12 Statielei
660,Statielei 26,2022-10-21,04:00:00,5,2,3,FMN 12 Statielei
660,Statielei 26,2022-10-21,05:00:00,23,9,14,FMN 12 Statielei
660,Statielei 26,2022-10-21,06:00:00,43,22,21,FMN 12 Statielei
660,Statielei 26,2022-10-21,07:00:00,125,63,62,FMN 12 Statielei
660,Statielei 26,2022-10-21,08:00:00,248,125,123,FMN 12 Statielei
660,Statielei 26,2022-10-21,09:00:00,119,83,36,FMN 12 Statielei
660,Statielei 26,2022-10-21,10:00:00,89,60,29,FMN 12 Statielei
660,Statielei 26,2022-10-21,11:00:00,90,44,46,FMN 12 Statielei
660,Statielei 26,2022-10-21,12:00:00,121,64,57,FMN 12 Statielei
660,Statielei 26,2022-10-21,13:00:00,122,66,56,FMN 12 Statielei
660,Statielei 26,2022-10-21,14:00:00,108,60,48,FMN 12 Statielei
660,Statielei 26,2022-10-21,15:00:00,188,80,108,FMN 12 Statielei
660,Statielei 26,2022-10-21,16:00:00,269,134,135,FMN 12 Statielei
660,Statielei 26,2022-10-21,17:00:00,236,100,136,FMN 12 Statielei
660,Statielei 26,2022-10-21,18:00:00,184,103,81,FMN 12 Statielei
660,Statielei 26,2022-10-21,19:00:00,178,99,79,FMN 12 Statielei
660,Statielei 26,2022-10-21,20:00:00,133,75,58,FMN 12 Statielei
660,Statielei 26,2022-10-21,21:00:00,92,44,48,FMN 12 Statielei
660,Statielei 26,2022-10-21,22:00:00,90,42,48,FMN 12 Statielei
660,Statielei 26,2022-10-21,23:00:00,83,28,55,FMN 12 Statielei
660,Statielei 26,2022-10-22,00:00:00,69,36,33,FMN 12 Statielei
660,Statielei 26,2022-10-22,01:00:00,55,19,36,FMN 12 Statielei
660,Statielei 26,2022-10-22,02:00:00,34,16,18,FMN 12 Statielei
660,Statielei 26,2022-10-22,03:00:00,12,2,10,FMN 12 Statielei
660,Statielei 26,2022-10-22,04:00:00,5,1,4,FMN 12 Statielei
660,Statielei 26,2022-10-22,05:00:00,8,2,6,FMN 12 Statielei
660,Statielei 26,2022-10-22,06:00:00,15,6,9,FMN 12 Statielei
660,Statielei 26,2022-10-22,07:00:00,18,6,12,FMN 12 Statielei
660,Statielei 26,2022-10-22,08:00:00,55,17,38,FMN 12 Statielei
660,Statielei 26,2022-10-22,09:00:00,108,59,49,FMN 12 Statielei
660,Statielei 26,2022-10-22,10:00:00,108,56,52,FMN 12 Statielei
660,Statielei 26,2022-10-22,11:00:00,105,67,38,FMN 12 Statielei
660,Statielei 26,2022-10-22,12:00:00,117,71,46,FMN 12 Statielei
660,Statielei 26,2022-10-22,13:00:00,143,73,70,FMN 12 Statielei
660,Statielei 26,2022-10-22,14:00:00,142,73,69,FMN 12 Statielei
660,Statielei 26,2022-10-22,15:00:00,134,70,64,FMN 12 Statielei
660,Statielei 26,2022-10-22,16:00:00,141,65,76,FMN 12 Statielei
660,Statielei 26,2022-10-22,17:00:00,185,119,66,FMN 12 Statielei
660,Statielei 26,2022-10-22,18:00:00,148,83,65,FMN 12 Statielei
660,Statielei 26,2022-10-22,19:00:00,121,65,56,FMN 12 Statielei
660,Statielei 26,2022-10-22,20:00:00,101,62,39,FMN 12 Statielei
660,Statielei 26,2022-10-22,21:00:00,84,42,42,FMN 12 Statielei
660,Statielei 26,2022-10-22,22:00:00,78,33,45,FMN 12 Statielei
660,Statielei 26,2022-10-22,23:00:00,70,32,38,FMN 12 Statielei
660,Statielei 26,2022-10-23,00:00:00,44,12,32,FMN 12 Statielei
660,Statielei 26,2022-10-23,01:00:00,31,11,20,FMN 12 Statielei
660,Statielei 26,2022-10-23,02:00:00,24,8,16,FMN 12 Statielei
660,Statielei 26,2022-10-23,03:00:00,17,5,12,FMN 12 Statielei
660,Statielei 26,2022-10-23,04:00:00,10,4,6,FMN 12 Statielei
660,Statielei 26,2022-10-23,05:00:00,14,8,6,FMN 12 Statielei
660,Statielei 26,2022-10-23,06:00:00,14,7,7,FMN 12 Statielei
660,Statielei 26,2022-10-23,07:00:00,13,5,8,FMN 12 Statielei
660,Statielei 26,2022-10-23,08:00:00,39,16,23,FMN 12 Statielei
660,Statielei 26,2022-10-23,09:00:00,74,28,46,FMN 12 Statielei
660,Statielei 26,2022-10-23,10:00:00,91,44,47,FMN 12 Statielei
660,Statielei 26,2022-10-23,11:00:00,87,43,44,FMN 12 Statielei
660,Statielei 26,2022-10-23,12:00:00,149,77,72,FMN 12 Statielei
660,Statielei 26,2022-10-23,13:00:00,132,56,76,FMN 12 Statielei
660,Statielei 26,2022-10-23,14:00:00,140,66,74,FMN 12 Statielei
660,Statielei 26,2022-10-23,15:00:00,150,89,61,FMN 12 Statielei
660,Statielei 26,2022-10-23,16:00:00,165,104,61,FMN 12 Statielei
660,Statielei 26,2022-10-23,17:00:00,162,100,62,FMN 12 Statielei
660,Statielei 26,2022-10-23,18:00:00,155,91,64,FMN 12 Statielei
660,Statielei 26,2022-10-23,19:00:00,89,38,51,FMN 12 Statielei
660,Statielei 26,2022-10-23,20:00:00,54,19,35,FMN 12 Statielei
660,Statielei 26,2022-10-23,21:00:00,50,27,23,FMN 12 Statielei
660,Statielei 26,2022-10-23,22:00:00,42,21,21,FMN 12 Statielei
660,Statielei 26,2022-10-23,23:00:00,26,7,19,FMN 12 Statielei
660,Statielei 26,2022-10-24,00:00:00,15,5,10,FMN 12 Statielei
660,Statielei 26,2022-10-24,01:00:00,6,4,2,FMN 12 Statielei
660,Statielei 26,2022-10-24,02:00:00,7,3,4,FMN 12 Statielei
660,Statielei 26,2022-10-24,03:00:00,0,0,0,FMN 12 Statielei
660,Statielei 26,2022-10-24,04:00:00,9,5,4,FMN 12 Statielei
660,Statielei 26,2022-10-24,05:00:00,15,6,9,FMN 12 Statielei
660,Statielei 26,2022-10-24,06:00:00,29,12,17,FMN 12 Statielei
660,Statielei 26,2022-10-24,07:00:00,122,53,69,FMN 12 Statielei
660,Statielei 26,2022-10-24,08:00:00,264,131,133,FMN 12 Statielei
660,Statielei 26,2022-10-24,09:00:00,110,69,41,FMN 12 Statielei
660,Statielei 26,2022-10-24,10:00:00,81,52,29,FMN 12 Statielei
660,Statielei 26,2022-10-24,11:00:00,83,41,42,FMN 12 Statielei
660,Statielei 26,2022-10-24,12:00:00,106,65,41,FMN 12 Statielei
660,Statielei 26,2022-10-24,13:00:00,102,66,36,FMN 12 Statielei
660,Statielei 26,2022-10-24,14:00:00,85,40,45,FMN 12 Statielei
660,Statielei 26,2022-10-24,15:00:00,163,82,81,FMN 12 Statielei
660,Statielei 26,2022-10-24,16:00:00,225,115,110,FMN 12 Statielei
660,Statielei 26,2022-10-24,17:00:00,228,116,112,FMN 12 Statielei
660,Statielei 26,2022-10-24,18:00:00,170,90,80,FMN 12 Statielei
660,Statielei 26,2022-10-24,19:00:00,77,40,37,FMN 12 Statielei
660,Statielei 26,2022-10-24,20:00:00,73,41,32,FMN 12 Statielei
660,Statielei 26,2022-10-24,21:00:00,69,30,39,FMN 12 Statielei
660,Statielei 26,2022-10-24,22:00:00,64,25,39,FMN 12 Statielei
660,Statielei 26,2022-10-24,23:00:00,31,11,20,FMN 12 Statielei
660,Statielei 26,2022-10-25,00:00:00,17,5,12,FMN 12 Statielei
660,Statielei 26,2022-10-25,01:00:00,6,2,4,FMN 12 Statielei
660,Statielei 26,2022-10-25,02:00:00,6,3,3,FMN 12 Statielei
660,Statielei 26,2022-10-25,03:00:00,1,1,0,FMN 12 Statielei
660,Statielei 26,2022-10-25,04:00:00,6,5,1,FMN 12 Statielei
660,Statielei 26,2022-10-25,05:00:00,17,10,7,FMN 12 Statielei
660,Statielei 26,2022-10-25,06:00:00,35,14,21,FMN 12 Statielei
660,Statielei 26,2022-10-25,07:00:00,146,65,81,FMN 12 Statielei
660,Statielei 26,2022-10-25,08:00:00,309,171,138,FMN 12 Statielei
660,Statielei 26,2022-10-25,09:00:00,136,92,44,FMN 12 Statielei
660,Statielei 26,2022-10-25,10:00:00,73,51,22,FMN 12 Statielei
660,Statielei 26,2022-10-25,11:00:00,98,57,41,FMN 12 Statielei
660,Statielei 26,2022-10-25,12:00:00,126,69,57,FMN 12 Statielei
660,Statielei 26,2022-10-25,13:00:00,129,77,52,FMN 12 Statielei
660,Statielei 26,2022-10-25,14:00:00,113,47,66,FMN 12 Statielei
660,Statielei 26,2022-10-25,15:00:00,156,75,81,FMN 12 Statielei
660,Statielei 26,2022-10-25,16:00:00,279,129,150,FMN 12 Statielei
660,Statielei 26,2022-10-25,17:00:00,246,111,135,FMN 12 Statielei
660,Statielei 26,2022-10-25,18:00:00,216,112,104,FMN 12 Statielei
660,Statielei 26,2022-10-25,19:00:00,133,75,58,FMN 12 Statielei
660,Statielei 26,2022-10-25,20:00:00,108,74,34,FMN 12 Statielei
660,Statielei 26,2022-10-25,21:00:00,87,37,50,FMN 12 Statielei
660,Statielei 26,2022-10-25,22:00:00,83,33,50,FMN 12 Statielei
660,Statielei 26,2022-10-25,23:00:00,46,15,31,FMN 12 Statielei
660,Statielei 26,2022-10-26,00:00:00,23,9,14,FMN 12 Statielei
660,Statielei 26,2022-10-26,01:00:00,17,4,13,FMN 12 Statielei
660,Statielei 26,2022-10-26,02:00:00,6,3,3,FMN 12 Statielei
660,Statielei 26,2022-10-26,03:00:00,1,0,1,FMN 12 Statielei
660,Statielei 26,2022-10-26,04:00:00,8,3,5,FMN 12 Statielei
660,Statielei 26,2022-10-26,05:00:00,14,11,3,FMN 12 Statielei
660,Statielei 26,2022-10-26,06:00:00,39,18,21,FMN 12 Statielei
660,Statielei 26,2022-10-26,07:00:00,131,60,71,FMN 12 Statielei
660,Statielei 26,2022-10-26,08:00:00,281,149,132,FMN 12 Statielei
660,Statielei 26,2022-10-26,09:00:00,137,96,41,FMN 12 Statielei
660,Statielei 26,2022-10-26,10:00:00,91,57,34,FMN 12 Statielei
660,Statielei 26,2022-10-26,11:00:00,101,55,46,FMN 12 Statielei
660,Statielei 26,2022-10-26,12:00:00,244,132,112,FMN 12 Statielei
660,Statielei 26,2022-10-26,13:00:00,164,85,79,FMN 12 Statielei
660,Statielei 26,2022-10-26,14:00:00,161,73,88,FMN 12 Statielei
660,Statielei 26,2022-10-26,15:00:00,171,85,86,FMN 12 Statielei
660,Statielei 26,2022-10-26,16:00:00,210,98,112,FMN 12 Statielei
660,Statielei 26,2022-10-26,17:00:00,255,122,133,FMN 12 Statielei
660,Statielei 26,2022-10-26,18:00:00,210,107,103,FMN 12 Statielei
660,Statielei 26,2022-10-26,19:00:00,162,95,67,FMN 12 Statielei
660,Statielei 26,2022-10-26,20:00:00,109,57,52,FMN 12 Statielei
660,Statielei 26,2022-10-26,21:00:00,92,44,48,FMN 12 Statielei
660,Statielei 26,2022-10-26,22:00:00,74,36,38,FMN 12 Statielei
660,Statielei 26,2022-10-26,23:00:00,70,28,42,FMN 12 Statielei
660,Statielei 26,2022-10-27,00:00:00,21,9,12,FMN 12 Statielei
660,Statielei 26,2022-10-27,01:00:00,14,5,9,FMN 12 Statielei
660,Statielei 26,2022-10-27,02:00:00,4,2,2,FMN 12 Statielei
660,Statielei 26,2022-10-27,03:00:00,7,2,5,FMN 12 Statielei
660,Statielei 26,2022-10-27,04:00:00,9,2,7,FMN 12 Statielei
660,Statielei 26,2022-10-27,05:00:00,18,10,8,FMN 12 Statielei
660,Statielei 26,2022-10-27,06:00:00,28,14,14,FMN 12 Statielei
660,Statielei 26,2022-10-27,07:00:00,139,71,68,FMN 12 Statielei
660,Statielei 26,2022-10-27,08:00:00,317,170,147,FMN 12 Statielei
660,Statielei 26,2022-10-27,09:00:00,141,101,40,FMN 12 Statielei
660,Statielei 26,2022-10-27,10:00:00,93,55,38,FMN 12 Statielei
660,Statielei 26,2022-10-27,11:00:00,92,56,36,FMN 12 Statielei
660,Statielei 26,2022-10-27,12:00:00,131,71,60,FMN 12 Statielei
660,Statielei 26,2022-10-27,13:00:00,121,64,57,FMN 12 Statielei
660,Statielei 26,2022-10-27,14:00:00,127,71,56,FMN 12 Statielei
660,Statielei 26,2022-10-27,15:00:00,186,93,93,FMN 12 Statielei
660,Statielei 26,2022-10-27,16:00:00,262,138,124,FMN 12 Statielei
660,Statielei 26,2022-10-27,17:00:00,260,130,130,FMN 12 Statielei
660,Statielei 26,2022-10-27,18:00:00,233,122,111,FMN 12 Statielei
660,Statielei 26,2022-10-27,19:00:00,165,102,63,FMN 12 Statielei
660,Statielei 26,2022-10-27,20:00:00,126,76,50,FMN 12 Statielei
660,Statielei 26,2022-10-27,21:00:00,90,39,51,FMN 12 Statielei
660,Statielei 26,2022-10-27,22:00:00,90,45,45,FMN 12 Statielei
660,Statielei 26,2022-10-27,23:00:00,52,23,29,FMN 12 Statielei
660,Statielei 26,2022-10-28,00:00:00,42,15,27,FMN 12 Statielei
660,Statielei 26,2022-10-28,01:00:00,14,7,7,FMN 12 Statielei
660,Statielei 26,2022-10-28,02:00:00,11,0,11,FMN 12 Statielei
660,Statielei 26,2022-10-28,03:00:00,7,3,4,FMN 12 Statielei
660,Statielei 26,2022-10-28,04:00:00,7,3,4,FMN 12 Statielei
660,Statielei 26,2022-10-28,05:00:00,16,9,7,FMN 12 Statielei
660,Statielei 26,2022-10-28,06:00:00,34,11,23,FMN 12 Statielei
660,Statielei 26,2022-10-28,07:00:00,143,61,82,FMN 12 Statielei
660,Statielei 26,2022-10-28,08:00:00,252,129,123,FMN 12 Statielei
660,Statielei 26,2022-10-28,09:00:00,115,74,41,FMN 12 Statielei
660,Statielei 26,2022-10-28,10:00:00,84,54,30,FMN 12 Statielei
660,Statielei 26,2022-10-28,11:00:00,87,53,34,FMN 12 Statielei
660,Statielei 26,2022-10-28,12:00:00,136,76,60,FMN 12 Statielei
660,Statielei 26,2022-10-28,13:00:00,128,72,56,FMN 12 Statielei
660,Statielei 26,2022-10-28,14:00:00,131,66,65,FMN 12 Statielei
660,Statielei 26,2022-10-28,15:00:00,188,77,111,FMN 12 Statielei
660,Statielei 26,2022-10-28,16:00:00,243,121,122,FMN 12 Statielei
660,Statielei 26,2022-10-28,17:00:00,203,99,104,FMN 12 Statielei
660,Statielei 26,2022-10-28,18:00:00,176,88,88,FMN 12 Statielei
660,Statielei 26,2022-10-28,19:00:00,162,84,78,FMN 12 Statielei
660,Statielei 26,2022-10-28,20:00:00,82,26,56,FMN 12 Statielei
660,Statielei 26,2022-10-28,21:00:00,57,16,41,FMN 12 Statielei
660,Statielei 26,2022-10-28,22:00:00,68,22,46,FMN 12 Statielei
660,Statielei 26,2022-10-28,23:00:00,71,29,42,FMN 12 Statielei
660,Statielei 26,2022-10-29,00:00:00,46,19,27,FMN 12 Statielei
660,Statielei 26,2022-10-29,01:00:00,30,10,20,FMN 12 Statielei
660,Statielei 26,2022-10-29,02:00:00,22,3,19,FMN 12 Statielei
660,Statielei 26,2022-10-29,03:00:00,8,1,7,FMN 12 Statielei
660,Statielei 26,2022-10-29,04:00:00,9,4,5,FMN 12 Statielei
660,Statielei 26,2022-10-29,05:00:00,10,4,6,FMN 12 Statielei
660,Statielei 26,2022-10-29,06:00:00,7,2,5,FMN 12 Statielei
660,Statielei 26,2022-10-29,07:00:00,19,4,15,FMN 12 Statielei
660,Statielei 26,2022-10-29,08:00:00,37,13,24,FMN 12 Statielei
660,Statielei 26,2022-10-29,09:00:00,49,11,38,FMN 12 Statielei
660,Statielei 26,2022-10-29,10:00:00,58,17,41,FMN 12 Statielei
660,Statielei 26,2022-10-29,11:00:00,71,37,34,FMN 12 Statielei
660,Statielei 26,2022-10-29,12:00:00,89,41,48,FMN 12 Statielei
660,Statielei 26,2022-10-29,13:00:00,78,22,56,FMN 12 Statielei
660,Statielei 26,2022-10-29,14:00:00,83,34,49,FMN 12 Statielei
660,Statielei 26,2022-10-29,15:00:00,103,34,69,FMN 12 Statielei
660,Statielei 26,2022-10-29,16:00:00,95,35,60,FMN 12 Statielei
660,Statielei 26,2022-10-29,17:00:00,97,36,61,FMN 12 Statielei
660,Statielei 26,2022-10-29,18:00:00,100,51,49,FMN 12 Statielei
660,Statielei 26,2022-10-29,19:00:00,75,37,38,FMN 12 Statielei
660,Statielei 26,2022-10-29,20:00:00,107,29,78,FMN 12 Statielei
660,Statielei 26,2022-10-29,21:00:00,45,20,25,FMN 12 Statielei
660,Statielei 26,2022-10-29,22:00:00,73,29,44,FMN 12 Statielei
660,Statielei 26,2022-10-29,23:00:00,54,25,29,FMN 12 Statielei
660,Statielei 26,2022-10-30,00:00:00,43,18,25,FMN 12 Statielei
660,Statielei 26,2022-10-30,01:00:00,33,20,13,FMN 12 Statielei
660,Statielei 26,2022-10-30,02:00:00,26,11,15,FMN 12 Statielei
660,Statielei 26,2022-10-30,03:00:00,7,4,3,FMN 12 Statielei
660,Statielei 26,2022-10-30,04:00:00,7,5,2,FMN 12 Statielei
660,Statielei 26,2022-10-30,05:00:00,8,5,3,FMN 12 Statielei
660,Statielei 26,2022-10-30,06:00:00,9,4,5,FMN 12 Statielei
660,Statielei 26,2022-10-30,07:00:00,10,3,7,FMN 12 Statielei
660,Statielei 26,2022-10-30,08:00:00,23,3,20,FMN 12 Statielei
660,Statielei 26,2022-10-30,09:00:00,47,9,38,FMN 12 Statielei
660,Statielei 26,2022-10-30,10:00:00,36,8,28,FMN 12 Statielei
660,Statielei 26,2022-10-30,11:00:00,50,13,37,FMN 12 Statielei
660,Statielei 26,2022-10-30,12:00:00,60,20,40,FMN 12 Statielei
660,Statielei 26,2022-10-30,13:00:00,76,21,55,FMN 12 Statielei
660,Statielei 26,2022-10-30,14:00:00,70,33,37,FMN 12 Statielei
660,Statielei 26,2022-10-30,15:00:00,65,28,37,FMN 12 Statielei
660,Statielei 26,2022-10-30,16:00:00,90,36,54,FMN 12 Statielei
660,Statielei 26,2022-10-30,17:00:00,86,43,43,FMN 12 Statielei
660,Statielei 26,2022-10-30,18:00:00,65,24,41,FMN 12 Statielei
660,Statielei 26,2022-10-30,19:00:00,37,16,21,FMN 12 Statielei
660,Statielei 26,2022-10-30,20:00:00,57,18,39,FMN 12 Statielei
660,Statielei 26,2022-10-30,21:00:00,28,13,15,FMN 12 Statielei
660,Statielei 26,2022-10-30,22:00:00,30,11,19,FMN 12 Statielei
660,Statielei 26,2022-10-30,23:00:00,18,5,13,FMN 12 Statielei
660,Statielei 26,2022-10-31,00:00:00,11,1,10,FMN 12 Statielei
660,Statielei 26,2022-10-31,01:00:00,4,2,2,FMN 12 Statielei
660,Statielei 26,2022-10-31,02:00:00,7,0,7,FMN 12 Statielei
660,Statielei 26,2022-10-31,03:00:00,1,1,0,FMN 12 Statielei
660,Statielei 26,2022-10-31,04:00:00,8,2,6,FMN 12 Statielei
660,Statielei 26,2022-10-31,05:00:00,11,2,9,FMN 12 Statielei
660,Statielei 26,2022-10-31,06:00:00,18,5,13,FMN 12 Statielei
660,Statielei 26,2022-10-31,07:00:00,23,4,19,FMN 12 Statielei
660,Statielei 26,2022-10-31,08:00:00,48,15,33,FMN 12 Statielei
660,Statielei 26,2022-10-31,09:00:00,43,16,27,FMN 12 Statielei
660,Statielei 26,2022-10-31,10:00:00,35,13,22,FMN 12 Statielei
660,Statielei 26,2022-10-31,11:00:00,48,21,27,FMN 12 Statielei
660,Statielei 26,2022-10-31,12:00:00,52,25,27,FMN 12 Statielei
660,Statielei 26,2022-10-31,13:00:00,42,17,25,FMN 12 Statielei
660,Statielei 26,2022-10-31,14:00:00,66,25,41,FMN 12 Statielei
660,Statielei 26,2022-10-31,15:00:00,60,24,36,FMN 12 Statielei
660,Statielei 26,2022-10-31,16:00:00,76,31,45,FMN 12 Statielei
660,Statielei 26,2022-10-31,17:00:00,87,42,45,FMN 12 Statielei
660,Statielei 26,2022-10-31,18:00:00,70,30,40,FMN 12 Statielei
660,Statielei 26,2022-10-31,19:00:00,70,36,34,FMN 12 Statielei
660,Statielei 26,2022-10-31,20:00:00,41,18,23,FMN 12 Statielei
660,Statielei 26,2022-10-31,21:00:00,44,14,30,FMN 12 Statielei
660,Statielei 26,2022-10-31,22:00:00,23,10,13,FMN 12 Statielei
660,Statielei 26,2022-10-31,23:00:00,21,4,17,FMN 12 Statielei
660,Statielei 26,2022-11-01,00:00:00,16,4,12,FMN 12 Statielei
660,Statielei 26,2022-11-01,01:00:00,10,5,5,FMN 12 Statielei
660,Statielei 26,2022-11-01,02:00:00,7,3,4,FMN 12 Statielei
660,Statielei 26,2022-11-01,03:00:00,4,0,4,FMN 12 Statielei
660,Statielei 26,2022-11-01,04:00:00,5,0,5,FMN 12 Statielei
660,Statielei 26,2022-11-01,05:00:00,5,2,3,FMN 12 Statielei
660,Statielei 26,2022-11-01,06:00:00,8,2,6,FMN 12 Statielei
660,Statielei 26,2022-11-01,07:00:00,8,1,7,FMN 12 Statielei
660,Statielei 26,2022-11-01,08:00:00,16,4,12,FMN 12 Statielei
660,Statielei 26,2022-11-01,09:00:00,26,8,18,FMN 12 Statielei
660,Statielei 26,2022-11-01,10:00:00,47,15,32,FMN 12 Statielei
660,Statielei 26,2022-11-01,11:00:00,49,19,30,FMN 12 Statielei
660,Statielei 26,2022-11-01,12:00:00,41,20,21,FMN 12 Statielei
660,Statielei 26,2022-11-01,13:00:00,52,16,36,FMN 12 Statielei
660,Statielei 26,2022-11-01,14:00:00,60,19,41,FMN 12 Statielei
660,Statielei 26,2022-11-01,15:00:00,55,25,30,FMN 12 Statielei
660,Statielei 26,2022-11-01,16:00:00,75,47,28,FMN 12 Statielei
660,Statielei 26,2022-11-01,17:00:00,60,30,30,FMN 12 Statielei
660,Statielei 26,2022-11-01,18:00:00,78,36,42,FMN 12 Statielei
660,Statielei 26,2022-11-01,19:00:00,65,35,30,FMN 12 Statielei
660,Statielei 26,2022-11-01,20:00:00,45,23,22,FMN 12 Statielei
660,Statielei 26,2022-11-01,21:00:00,29,18,11,FMN 12 Statielei
660,Statielei 26,2022-11-01,22:00:00,38,20,18,FMN 12 Statielei
660,Statielei 26,2022-11-01,23:00:00,24,11,13,FMN 12 Statielei
660,Statielei 26,2022-11-02,00:00:00,9,2,7,FMN 12 Statielei
660,Statielei 26,2022-11-02,01:00:00,8,4,4,FMN 12 Statielei
660,Statielei 26,2022-11-02,02:00:00,4,2,2,FMN 12 Statielei
660,Statielei 26,2022-11-02,03:00:00,2,1,1,FMN 12 Statielei
660,Statielei 26,2022-11-02,04:00:00,2,1,1,FMN 12 Statielei
660,Statielei 26,2022-11-02,05:00:00,11,1,10,FMN 12 Statielei
660,Statielei 26,2022-11-02,06:00:00,26,7,19,FMN 12 Statielei
660,Statielei 26,2022-11-02,07:00:00,46,27,19,FMN 12 Statielei
660,Statielei 26,2022-11-02,08:00:00,95,36,59,FMN 12 Statielei
660,Statielei 26,2022-11-02,09:00:00,93,52,41,FMN 12 Statielei
660,Statielei 26,2022-11-02,10:00:00,55,28,27,FMN 12 Statielei
660,Statielei 26,2022-11-02,11:00:00,67,33,34,FMN 12 Statielei
660,Statielei 26,2022-11-02,12:00:00,95,52,43,FMN 12 Statielei
660,Statielei 26,2022-11-02,13:00:00,83,47,36,FMN 12 Statielei
660,Statielei 26,2022-11-02,14:00:00,87,46,41,FMN 12 Statielei
660,Statielei 26,2022-11-02,15:00:00,104,60,44,FMN 12 Statielei
660,Statielei 26,2022-11-02,16:00:00,164,77,87,FMN 12 Statielei
660,Statielei 26,2022-11-02,17:00:00,160,79,81,FMN 12 Statielei
660,Statielei 26,2022-11-02,18:00:00,97,47,50,FMN 12 Statielei
660,Statielei 26,2022-11-02,19:00:00,133,81,52,FMN 12 Statielei
660,Statielei 26,2022-11-02,20:00:00,83,60,23,FMN 12 Statielei
660,Statielei 26,2022-11-02,21:00:00,38,15,23,FMN 12 Statielei
660,Statielei 26,2022-11-02,22:00:00,64,29,35,FMN 12 Statielei
660,Statielei 26,2022-11-02,23:00:00,52,12,40,FMN 12 Statielei
660,Statielei 26,2022-11-03,00:00:00,29,8,21,FMN 12 Statielei
660,Statielei 26,2022-11-03,01:00:00,9,4,5,FMN 12 Statielei
660,Statielei 26,2022-11-03,02:00:00,5,0,5,FMN 12 Statielei
660,Statielei 26,2022-11-03,03:00:00,5,2,3,FMN 12 Statielei
660,Statielei 26,2022-11-03,04:00:00,6,3,3,FMN 12 Statielei
660,Statielei 26,2022-11-03,05:00:00,15,6,9,FMN 12 Statielei
660,Statielei 26,2022-11-03,06:00:00,30,11,19,FMN 12 Statielei
660,Statielei 26,2022-11-03,07:00:00,65,30,35,FMN 12 Statielei
660,Statielei 26,2022-11-03,08:00:00,115,57,58,FMN 12 Statielei
660,Statielei 26,2022-11-03,09:00:00,86,52,34,FMN 12 Statielei
660,Statielei 26,2022-11-03,10:00:00,84,53,31,FMN 12 Statielei
660,Statielei 26,2022-11-03,11:00:00,91,46,45,FMN 12 Statielei
660,Statielei 26,2022-11-03,12:00:00,78,46,32,FMN 12 Statielei
660,Statielei 26,2022-11-03,13:00:00,82,45,37,FMN 12 Statielei
660,Statielei 26,2022-11-03,14:00:00,79,38,41,FMN 12 Statielei
660,Statielei 26,2022-11-03,15:00:00,74,41,33,FMN 12 Statielei
660,Statielei 26,2022-11-03,16:00:00,113,45,68,FMN 12 Statielei
660,Statielei 26,2022-11-03,17:00:00,112,39,73,FMN 12 Statielei
660,Statielei 26,2022-11-03,18:00:00,94,54,40,FMN 12 Statielei
660,Statielei 26,2022-11-03,19:00:00,84,41,43,FMN 12 Statielei
660,Statielei 26,2022-11-03,20:00:00,60,30,30,FMN 12 Statielei
660,Statielei 26,2022-11-03,21:00:00,46,19,27,FMN 12 Statielei
660,Statielei 26,2022-11-03,22:00:00,53,19,34,FMN 12 Statielei
660,Statielei 26,2022-11-03,23:00:00,61,37,24,FMN 12 Statielei
660,Statielei 26,2022-11-04,00:00:00,27,10,17,FMN 12 Statielei
660,Statielei 26,2022-11-04,01:00:00,16,7,9,FMN 12 Statielei
660,Statielei 26,2022-11-04,02:00:00,3,1,2,FMN 12 Statielei
660,Statielei 26,2022-11-04,03:00:00,7,4,3,FMN 12 Statielei
660,Statielei 26,2022-11-04,04:00:00,9,4,5,FMN 12 Statielei
660,Statielei 26,2022-11-04,05:00:00,16,6,10,FMN 12 Statielei
660,Statielei 26,2022-11-04,06:00:00,21,10,11,FMN 12 Statielei
660,Statielei 26,2022-11-04,07:00:00,61,30,31,FMN 12 Statielei
660,Statielei 26,2022-11-04,08:00:00,82,44,38,FMN 12 Statielei
660,Statielei 26,2022-11-04,09:00:00,76,39,37,FMN 12 Statielei
660,Statielei 26,2022-11-04,10:00:00,65,41,24,FMN 12 Statielei
660,Statielei 26,2022-11-04,11:00:00,56,33,23,FMN 12 Statielei
660,Statielei 26,2022-11-04,12:00:00,66,30,36,FMN 12 Statielei
660,Statielei 26,2022-11-04,13:00:00,92,45,47,FMN 12 Statielei
660,Statielei 26,2022-11-04,14:00:00,71,34,37,FMN 12 Statielei
660,Statielei 26,2022-11-04,15:00:00,102,49,53,FMN 12 Statielei
660,Statielei 26,2022-11-04,16:00:00,115,48,67,FMN 12 Statielei
660,Statielei 26,2022-11-04,17:00:00,128,71,57,FMN 12 Statielei
660,Statielei 26,2022-11-04,18:00:00,138,70,68,FMN 12 Statielei
660,Statielei 26,2022-11-04,19:00:00,102,53,49,FMN 12 Statielei
660,Statielei 26,2022-11-04,20:00:00,75,47,28,FMN 12 Statielei
660,Statielei 26,2022-11-04,21:00:00,57,23,34,FMN 12 Statielei
660,Statielei 26,2022-11-04,22:00:00,93,45,48,FMN 12 Statielei
660,Statielei 26,2022-11-04,23:00:00,71,40,31,FMN 12 Statielei
660,Statielei 26,2022-11-05,00:00:00,36,14,22,FMN 12 Statielei
660,Statielei 26,2022-11-05,01:00:00,26,6,20,FMN 12 Statielei
660,Statielei 26,2022-11-05,02:00:00,12,5,7,FMN 12 Statielei
660,Statielei 26,2022-11-05,03:00:00,6,0,6,FMN 12 Statielei
660,Statielei 26,2022-11-05,04:00:00,9,3,6,FMN 12 Statielei
660,Statielei 26,2022-11-05,05:00:00,12,4,8,FMN 12 Statielei
660,Statielei 26,2022-11-05,06:00:00,9,3,6,FMN 12 Statielei
660,Statielei 26,2022-11-05,07:00:00,24,9,15,FMN 12 Statielei
660,Statielei 26,2022-11-05,08:00:00,31,19,12,FMN 12 Statielei
660,Statielei 26,2022-11-05,09:00:00,82,48,34,FMN 12 Statielei
660,Statielei 26,2022-11-05,10:00:00,75,49,26,FMN 12 Statielei
660,Statielei 26,2022-11-05,11:00:00,84,48,36,FMN 12 Statielei
660,Statielei 26,2022-11-05,12:00:00,103,62,41,FMN 12 Statielei
660,Statielei 26,2022-11-05,13:00:00,85,41,44,FMN 12 Statielei
660,Statielei 26,2022-11-05,14:00:00,123,57,66,FMN 12 Statielei
660,Statielei 26,2022-11-05,15:00:00,109,60,49,FMN 12 Statielei
660,Statielei 26,2022-11-05,16:00:00,120,53,67,FMN 12 Statielei
660,Statielei 26,2022-11-05,17:00:00,110,56,54,FMN 12 Statielei
660,Statielei 26,2022-11-05,18:00:00,106,59,47,FMN 12 Statielei
660,Statielei 26,2022-11-05,19:00:00,99,52,47,FMN 12 Statielei
660,Statielei 26,2022-11-05,20:00:00,107,42,65,FMN 12 Statielei
660,Statielei 26,2022-11-05,21:00:00,53,26,27,FMN 12 Statielei
660,Statielei 26,2022-11-05,22:00:00,82,29,53,FMN 12 Statielei
660,Statielei 26,2022-11-05,23:00:00,44,18,26,FMN 12 Statielei
660,Statielei 26,2022-11-06,00:00:00,48,27,21,FMN 12 Statielei
660,Statielei 26,2022-11-06,01:00:00,20,3,17,FMN 12 Statielei
660,Statielei 26,2022-11-06,02:00:00,15,8,7,FMN 12 Statielei
660,Statielei 26,2022-11-06,03:00:00,11,2,9,FMN 12 Statielei
660,Statielei 26,2022-11-06,04:00:00,2,1,1,FMN 12 Statielei
660,Statielei 26,2022-11-06,05:00:00,9,3,6,FMN 12 Statielei
660,Statielei 26,2022-11-06,06:00:00,4,0,4,FMN 12 Statielei
660,Statielei 26,2022-11-06,07:00:00,10,5,5,FMN 12 Statielei
660,Statielei 26,2022-11-06,08:00:00,34,14,20,FMN 12 Statielei
660,Statielei 26,2022-11-06,09:00:00,44,20,24,FMN 12 Statielei
660,Statielei 26,2022-11-06,10:00:00,58,35,23,FMN 12 Statielei
660,Statielei 26,2022-11-06,11:00:00,85,45,40,FMN 12 Statielei
660,Statielei 26,2022-11-06,12:00:00,74,51,23,FMN 12 Statielei
660,Statielei 26,2022-11-06,13:00:00,67,25,42,FMN 12 Statielei
660,Statielei 26,2022-11-06,14:00:00,50,22,28,FMN 12 Statielei
660,Statielei 26,2022-11-06,15:00:00,41,20,21,FMN 12 Statielei
660,Statielei 26,2022-11-06,16:00:00,59,28,31,FMN 12 Statielei
660,Statielei 26,2022-11-06,17:00:00,87,24,63,FMN 12 Statielei
660,Statielei 26,2022-11-06,18:00:00,98,55,43,FMN 12 Statielei
660,Statielei 26,2022-11-06,19:00:00,63,37,26,FMN 12 Statielei
660,Statielei 26,2022-11-06,20:00:00,48,32,16,FMN 12 Statielei
660,Statielei 26,2022-11-06,21:00:00,66,42,24,FMN 12 Statielei
660,Statielei 26,2022-11-06,22:00:00,48,23,25,FMN 12 Statielei
660,Statielei 26,2022-11-06,23:00:00,25,16,9,FMN 12 Statielei
660,Statielei 26,2022-11-07,00:00:00,6,3,3,FMN 12 Statielei
660,Statielei 26,2022-11-07,01:00:00,7,2,5,FMN 12 Statielei
660,Statielei 26,2022-11-07,02:00:00,4,0,4,FMN 12 Statielei
660,Statielei 26,2022-11-07,03:00:00,3,2,1,FMN 12 Statielei
660,Statielei 26,2022-11-07,04:00:00,5,2,3,FMN 12 Statielei
660,Statielei 26,2022-11-07,05:00:00,12,7,5,FMN 12 Statielei
660,Statielei 26,2022-11-07,06:00:00,27,7,20,FMN 12 Statielei
660,Statielei 26,2022-11-07,07:00:00,117,47,70,FMN 12 Statielei
660,Statielei 26,2022-11-07,08:00:00,264,145,119,FMN 12 Statielei
660,Statielei 26,2022-11-07,09:00:00,105,76,29,FMN 12 Statielei
660,Statielei 26,2022-11-07,10:00:00,70,48,22,FMN 12 Statielei
660,Statielei 26,2022-11-07,11:00:00,67,31,36,FMN 12 Statielei
660,Statielei 26,2022-11-07,12:00:00,105,50,55,FMN 12 Statielei
660,Statielei 26,2022-11-07,13:00:00,84,44,40,FMN 12 Statielei
660,Statielei 26,2022-11-07,14:00:00,79,39,40,FMN 12 Statielei
660,Statielei 26,2022-11-07,15:00:00,164,72,92,FMN 12 Statielei
660,Statielei 26,2022-11-07,16:00:00,245,135,110,FMN 12 Statielei
660,Statielei 26,2022-11-07,17:00:00,233,124,109,FMN 12 Statielei
660,Statielei 26,2022-11-07,18:00:00,148,68,80,FMN 12 Statielei
660,Statielei 26,2022-11-07,19:00:00,128,56,72,FMN 12 Statielei
660,Statielei 26,2022-11-07,20:00:00,101,52,49,FMN 12 Statielei
660,Statielei 26,2022-11-07,21:00:00,46,24,22,FMN 12 Statielei
660,Statielei 26,2022-11-07,22:00:00,54,22,32,FMN 12 Statielei
660,Statielei 26,2022-11-07,23:00:00,34,9,25,FMN 12 Statielei
660,Statielei 26,2022-11-08,00:00:00,10,1,9,FMN 12 Statielei
660,Statielei 26,2022-11-08,01:00:00,13,4,9,FMN 12 Statielei
660,Statielei 26,2022-11-08,02:00:00,3,1,2,FMN 12 Statielei
660,Statielei 26,2022-11-08,03:00:00,1,0,1,FMN 12 Statielei
660,Statielei 26,2022-11-08,04:00:00,8,5,3,FMN 12 Statielei
660,Statielei 26,2022-11-08,05:00:00,21,14,7,FMN 12 Statielei
660,Statielei 26,2022-11-08,06:00:00,24,12,12,FMN 12 Statielei
660,Statielei 26,2022-11-08,07:00:00,147,77,70,FMN 12 Statielei
660,Statielei 26,2022-11-08,08:00:00,303,170,133,FMN 12 Statielei
660,Statielei 26,2022-11-08,09:00:00,125,67,58,FMN 12 Statielei
660,Statielei 26,2022-11-08,10:00:00,85,53,32,FMN 12 Statielei
660,Statielei 26,2022-11-08,11:00:00,88,64,24,FMN 12 Statielei
660,Statielei 26,2022-11-08,12:00:00,119,66,53,FMN 12 Statielei
660,Statielei 26,2022-11-08,13:00:00,85,55,30,FMN 12 Statielei
660,Statielei 26,2022-11-08,14:00:00,87,44,43,FMN 12 Statielei
660,Statielei 26,2022-11-08,15:00:00,160,76,84,FMN 12 Statielei
660,Statielei 26,2022-11-08,16:00:00,268,131,137,FMN 12 Statielei
660,Statielei 26,2022-11-08,17:00:00,247,120,127,FMN 12 Statielei
660,Statielei 26,2022-11-08,18:00:00,141,68,73,FMN 12 Statielei
660,Statielei 26,2022-11-08,19:00:00,129,71,58,FMN 12 Statielei
660,Statielei 26,2022-11-08,20:00:00,102,53,49,FMN 12 Statielei
660,Statielei 26,2022-11-08,21:00:00,67,32,35,FMN 12 Statielei
660,Statielei 26,2022-11-08,22:00:00,76,43,33,FMN 12 Statielei
660,Statielei 26,2022-11-08,23:00:00,30,12,18,FMN 12 Statielei
660,Statielei 26,2022-11-09,00:00:00,30,14,16,FMN 12 Statielei
660,Statielei 26,2022-11-09,01:00:00,12,4,8,FMN 12 Statielei
660,Statielei 26,2022-11-09,02:00:00,3,1,2,FMN 12 Statielei
660,Statielei 26,2022-11-09,03:00:00,6,1,5,FMN 12 Statielei
660,Statielei 26,2022-11-09,04:00:00,9,5,4,FMN 12 Statielei
660,Statielei 26,2022-11-09,05:00:00,21,10,11,FMN 12 Statielei
660,Statielei 26,2022-11-09,06:00:00,35,14,21,FMN 12 Statielei
660,Statielei 26,2022-11-09,07:00:00,134,66,68,FMN 12 Statielei
660,Statielei 26,2022-11-09,08:00:00,273,161,112,FMN 12 Statielei
660,Statielei 26,2022-11-09,09:00:00,110,71,39,FMN 12 Statielei
660,Statielei 26,2022-11-09,10:00:00,120,82,38,FMN 12 Statielei
660,Statielei 26,2022-11-09,11:00:00,106,60,46,FMN 12 Statielei
660,Statielei 26,2022-11-09,12:00:00,197,93,104,FMN 12 Statielei
660,Statielei 26,2022-11-09,13:00:00,156,83,73,FMN 12 Statielei
660,Statielei 26,2022-11-09,14:00:00,137,70,67,FMN 12 Statielei
660,Statielei 26,2022-11-09,15:00:00,164,92,72,FMN 12 Statielei
660,Statielei 26,2022-11-09,16:00:00,231,104,127,FMN 12 Statielei
660,Statielei 26,2022-11-09,17:00:00,261,136,125,FMN 12 Statielei
660,Statielei 26,2022-11-09,18:00:00,207,109,98,FMN 12 Statielei
660,Statielei 26,2022-11-09,19:00:00,129,75,54,FMN 12 Statielei
660,Statielei 26,2022-11-09,20:00:00,94,51,43,FMN 12 Statielei
660,Statielei 26,2022-11-09,21:00:00,75,31,44,FMN 12 Statielei
660,Statielei 26,2022-11-09,22:00:00,70,36,34,FMN 12 Statielei
660,Statielei 26,2022-11-09,23:00:00,54,19,35,FMN 12 Statielei
660,Statielei 26,2022-11-10,00:00:00,26,9,17,FMN 12 Statielei
660,Statielei 26,2022-11-10,01:00:00,14,6,8,FMN 12 Statielei
660,Statielei 26,2022-11-10,02:00:00,5,3,2,FMN 12 Statielei
660,Statielei 26,2022-11-10,03:00:00,2,1,1,FMN 12 Statielei
660,Statielei 26,2022-11-10,04:00:00,11,5,6,FMN 12 Statielei
660,Statielei 26,2022-11-10,05:00:00,17,8,9,FMN 12 Statielei
660,Statielei 26,2022-11-10,06:00:00,28,9,19,FMN 12 Statielei
660,Statielei 26,2022-11-10,07:00:00,112,58,54,FMN 12 Statielei
660,Statielei 26,2022-11-10,08:00:00,272,141,131,FMN 12 Statielei
660,Statielei 26,2022-11-10,09:00:00,93,59,34,FMN 12 Statielei
660,Statielei 26,2022-11-10,10:00:00,107,69,38,FMN 12 Statielei
660,Statielei 26,2022-11-10,11:00:00,73,46,27,FMN 12 Statielei
660,Statielei 26,2022-11-10,12:00:00,121,64,57,FMN 12 Statielei
660,Statielei 26,2022-11-10,13:00:00,105,60,45,FMN 12 Statielei
660,Statielei 26,2022-11-10,14:00:00,111,62,49,FMN 12 Statielei
660,Statielei 26,2022-11-10,15:00:00,164,82,82,FMN 12 Statielei
660,Statielei 26,2022-11-10,16:00:00,246,121,125,FMN 12 Statielei
660,Statielei 26,2022-11-10,17:00:00,223,125,98,FMN 12 Statielei
660,Statielei 26,2022-11-10,18:00:00,197,94,103,FMN 12 Statielei
660,Statielei 26,2022-11-10,19:00:00,169,80,89,FMN 12 Statielei
660,Statielei 26,2022-11-10,20:00:00,124,75,49,FMN 12 Statielei
660,Statielei 26,2022-11-10,21:00:00,94,54,40,FMN 12 Statielei
660,Statielei 26,2022-11-10,22:00:00,66,30,36,FMN 12 Statielei
660,Statielei 26,2022-11-10,23:00:00,85,28,57,FMN 12 Statielei
660,Statielei 26,2022-11-11,00:00:00,29,12,17,FMN 12 Statielei
660,Statielei 26,2022-11-11,01:00:00,39,22,17,FMN 12 Statielei
660,Statielei 26,2022-11-11,02:00:00,43,34,9,FMN 12 Statielei
660,Statielei 26,2022-11-11,03:00:00,24,11,13,FMN 12 Statielei
660,Statielei 26,2022-11-11,04:00:00,20,12,8,FMN 12 Statielei
660,Statielei 26,2022-11-11,05:00:00,32,17,15,FMN 12 Statielei
660,Statielei 26,2022-11-11,06:00:00,12,7,5,FMN 12 Statielei
660,Statielei 26,2022-11-11,07:00:00,21,14,7,FMN 12 Statielei
660,Statielei 26,2022-11-11,08:00:00,26,12,14,FMN 12 Statielei
660,Statielei 26,2022-11-11,09:00:00,35,24,11,FMN 12 Statielei
660,Statielei 26,2022-11-11,10:00:00,61,25,36,FMN 12 Statielei
660,Statielei 26,2022-11-11,11:00:00,78,51,27,FMN 12 Statielei
660,Statielei 26,2022-11-11,12:00:00,89,50,39,FMN 12 Statielei
660,Statielei 26,2022-11-11,13:00:00,98,56,42,FMN 12 Statielei
660,Statielei 26,2022-11-11,14:00:00,110,67,43,FMN 12 Statielei
660,Statielei 26,2022-11-11,15:00:00,131,71,60,FMN 12 Statielei
660,Statielei 26,2022-11-11,16:00:00,154,79,75,FMN 12 Statielei
660,Statielei 26,2022-11-11,17:00:00,156,90,66,FMN 12 Statielei
660,Statielei 26,2022-11-11,18:00:00,121,69,52,FMN 12 Statielei
660,Statielei 26,2022-11-11,19:00:00,114,65,49,FMN 12 Statielei
660,Statielei 26,2022-11-11,20:00:00,96,64,32,FMN 12 Statielei
660,Statielei 26,2022-11-11,21:00:00,86,47,39,FMN 12 Statielei
660,Statielei 26,2022-11-11,22:00:00,77,30,47,FMN 12 Statielei
660,Statielei 26,2022-11-11,23:00:00,66,31,35,FMN 12 Statielei
660,Statielei 26,2022-11-12,00:00:00,49,15,34,FMN 12 Statielei
660,Statielei 26,2022-11-12,01:00:00,27,11,16,FMN 12 Statielei
660,Statielei 26,2022-11-12,02:00:00,13,9,4,FMN 12 Statielei
660,Statielei 26,2022-11-12,03:00:00,3,0,3,FMN 12 Statielei
660,Statielei 26,2022-11-12,04:00:00,8,2,6,FMN 12 Statielei
660,Statielei 26,2022-11-12,05:00:00,20,8,12,FMN 12 Statielei
660,Statielei 26,2022-11-12,06:00:00,6,4,2,FMN 12 Statielei
660,Statielei 26,2022-11-12,07:00:00,22,12,10,FMN 12 Statielei
660,Statielei 26,2022-11-12,08:00:00,49,23,26,FMN 12 Statielei
660,Statielei 26,2022-11-12,09:00:00,78,37,41,FMN 12 Statielei
660,Statielei 26,2022-11-12,10:00:00,104,62,42,FMN 12 Statielei
660,Statielei 26,2022-11-12,11:00:00,105,73,32,FMN 12 Statielei
660,Statielei 26,2022-11-12,12:00:00,121,69,52,FMN 12 Statielei
660,Statielei 26,2022-11-12,13:00:00,136,89,47,FMN 12 Statielei
660,Statielei 26,2022-11-12,14:00:00,164,75,89,FMN 12 Statielei
660,Statielei 26,2022-11-12,15:00:00,128,66,62,FMN 12 Statielei
660,Statielei 26,2022-11-12,16:00:00,139,68,71,FMN 12 Statielei
660,Statielei 26,2022-11-12,17:00:00,149,73,76,FMN 12 Statielei
660,Statielei 26,2022-11-12,18:00:00,131,65,66,FMN 12 Statielei
660,Statielei 26,2022-11-12,19:00:00,111,63,48,FMN 12 Statielei
660,Statielei 26,2022-11-12,20:00:00,68,42,26,FMN 12 Statielei
660,Statielei 26,2022-11-12,21:00:00,59,21,38,FMN 12 Statielei
660,Statielei 26,2022-11-12,22:00:00,75,21,54,FMN 12 Statielei
660,Statielei 26,2022-11-12,23:00:00,86,37,49,FMN 12 Statielei
660,Statielei 26,2022-11-13,00:00:00,62,25,37,FMN 12 Statielei
660,Statielei 26,2022-11-13,01:00:00,37,21,16,FMN 12 Statielei
660,Statielei 26,2022-11-13,02:00:00,51,27,24,FMN 12 Statielei
660,Statielei 26,2022-11-13,03:00:00,24,8,16,FMN 12 Statielei
660,Statielei 26,2022-11-13,04:00:00,22,16,6,FMN 12 Statielei
660,Statielei 26,2022-11-13,05:00:00,25,21,4,FMN 12 Statielei
660,Statielei 26,2022-11-13,06:00:00,4,1,3,FMN 12 Statielei
660,Statielei 26,2022-11-13,07:00:00,9,4,5,FMN 12 Statielei
660,Statielei 26,2022-11-13,08:00:00,35,13,22,FMN 12 Statielei
660,Statielei 26,2022-11-13,09:00:00,52,26,26,FMN 12 Statielei
660,Statielei 26,2022-11-13,10:00:00,84,32,52,FMN 12 Statielei
660,Statielei 26,2022-11-13,11:00:00,74,32,42,FMN 12 Statielei
660,Statielei 26,2022-11-13,12:00:00,113,60,53,FMN 12 Statielei
660,Statielei 26,2022-11-13,13:00:00,134,72,62,FMN 12 Statielei
660,Statielei 26,2022-11-13,14:00:00,152,91,61,FMN 12 Statielei
660,Statielei 26,2022-11-13,15:00:00,144,65,79,FMN 12 Statielei
660,Statielei 26,2022-11-13,16:00:00,154,83,71,FMN 12 Statielei
660,Statielei 26,2022-11-13,17:00:00,137,76,61,FMN 12 Statielei
660,Statielei 26,2022-11-13,18:00:00,101,55,46,FMN 12 Statielei
660,Statielei 26,2022-11-13,19:00:00,104,54,50,FMN 12 Statielei
660,Statielei 26,2022-11-13,20:00:00,62,34,28,FMN 12 Statielei
660,Statielei 26,2022-11-13,21:00:00,54,20,34,FMN 12 Statielei
660,Statielei 26,2022-11-13,22:00:00,44,10,34,FMN 12 Statielei
660,Statielei 26,2022-11-13,23:00:00,23,6,17,FMN 12 Statielei
660,Statielei 26,2022-11-14,00:00:00,9,6,3,FMN 12 Statielei
660,Statielei 26,2022-11-14,01:00:00,8,3,5,FMN 12 Statielei
660,Statielei 26,2022-11-14,02:00:00,5,0,5,FMN 12 Statielei
660,Statielei 26,2022-11-14,03:00:00,2,0,2,FMN 12 Statielei
660,Statielei 26,2022-11-14,04:00:00,6,3,3,FMN 12 Statielei
660,Statielei 26,2022-11-14,05:00:00,16,7,9,FMN 12 Statielei
660,Statielei 26,2022-11-14,06:00:00,23,10,13,FMN 12 Statielei
660,Statielei 26,2022-11-14,07:00:00,133,60,73,FMN 12 Statielei
660,Statielei 26,2022-11-14,08:00:00,251,134,117,FMN 12 Statielei
660,Statielei 26,2022-11-14,09:00:00,103,65,38,FMN 12 Statielei
660,Statielei 26,2022-11-14,10:00:00,65,42,23,FMN 12 Statielei
660,Statielei 26,2022-11-14,11:00:00,55,30,25,FMN 12 Statielei
660,Statielei 26,2022-11-14,12:00:00,127,75,52,FMN 12 Statielei
660,Statielei 26,2022-11-14,13:00:00,92,53,39,FMN 12 Statielei
660,Statielei 26,2022-11-14,14:00:00,86,47,39,FMN 12 Statielei
660,Statielei 26,2022-11-14,15:00:00,142,63,79,FMN 12 Statielei
660,Statielei 26,2022-11-14,16:00:00,246,128,118,FMN 12 Statielei
660,Statielei 26,2022-11-14,17:00:00,191,86,105,FMN 12 Statielei
660,Statielei 26,2022-11-14,18:00:00,138,60,78,FMN 12 Statielei
660,Statielei 26,2022-11-14,19:00:00,100,49,51,FMN 12 Statielei
660,Statielei 26,2022-11-14,20:00:00,95,50,45,FMN 12 Statielei
660,Statielei 26,2022-11-14,21:00:00,67,34,33,FMN 12 Statielei
660,Statielei 26,2022-11-14,22:00:00,70,37,33,FMN 12 Statielei
660,Statielei 26,2022-11-14,23:00:00,22,7,15,FMN 12 Statielei
660,Statielei 26,2022-11-15,00:00:00,7,1,6,FMN 12 Statielei
660,Statielei 26,2022-11-15,01:00:00,5,3,2,FMN 12 Statielei
660,Statielei 26,2022-11-15,02:00:00,3,3,0,FMN 12 Statielei
660,Statielei 26,2022-11-15,03:00:00,4,0,4,FMN 12 Statielei
660,Statielei 26,2022-11-15,04:00:00,5,3,2,FMN 12 Statielei
660,Statielei 26,2022-11-15,05:00:00,15,8,7,FMN 12 Statielei
660,Statielei 26,2022-11-15,06:00:00,27,12,15,FMN 12 Statielei
660,Statielei 26,2022-11-15,07:00:00,115,55,60,FMN 12 Statielei
660,Statielei 26,2022-11-15,08:00:00,284,158,126,FMN 12 Statielei
660,Statielei 26,2022-11-15,09:00:00,118,61,57,FMN 12 Statielei
660,Statielei 26,2022-11-15,10:00:00,72,51,21,FMN 12 Statielei
660,Statielei 26,2022-11-15,11:00:00,85,54,31,FMN 12 Statielei
660,Statielei 26,2022-11-15,12:00:00,112,62,50,FMN 12 Statielei
660,Statielei 26,2022-11-15,13:00:00,99,56,43,FMN 12 Statielei
660,Statielei 26,2022-11-15,14:00:00,105,56,49,FMN 12 Statielei
660,Statielei 26,2022-11-15,15:00:00,151,63,88,FMN 12 Statielei
660,Statielei 26,2022-11-15,16:00:00,201,102,99,FMN 12 Statielei
660,Statielei 26,2022-11-15,17:00:00,180,64,116,FMN 12 Statielei
660,Statielei 26,2022-11-15,18:00:00,121,58,63,FMN 12 Statielei
660,Statielei 26,2022-11-15,19:00:00,94,49,45,FMN 12 Statielei
660,Statielei 26,2022-11-15,20:00:00,93,44,49,FMN 12 Statielei
660,Statielei 26,2022-11-15,21:00:00,81,29,52,FMN 12 Statielei
660,Statielei 26,2022-11-15,22:00:00,56,40,16,FMN 12 Statielei
660,Statielei 26,2022-11-15,23:00:00,34,15,19,FMN 12 Statielei
660,Statielei 26,2022-11-16,00:00:00,19,8,11,FMN 12 Statielei
660,Statielei 26,2022-11-16,01:00:00,4,1,3,FMN 12 Statielei
660,Statielei 26,2022-11-16,02:00:00,4,2,2,FMN 12 Statielei
660,Statielei 26,2022-11-16,03:00:00,3,1,2,FMN 12 Statielei
660,Statielei 26,2022-11-16,04:00:00,12,3,9,FMN 12 Statielei
660,Statielei 26,2022-11-16,05:00:00,15,8,7,FMN 12 Statielei
660,Statielei 26,2022-11-16,06:00:00,30,13,17,FMN 12 Statielei
660,Statielei 26,2022-11-16,07:00:00,109,53,56,FMN 12 Statielei
660,Statielei 26,2022-11-16,08:00:00,257,131,126,FMN 12 Statielei
660,Statielei 26,2022-11-16,09:00:00,95,60,35,FMN 12 Statielei
660,Statielei 26,2022-11-16,10:00:00,84,49,35,FMN 12 Statielei
660,Statielei 26,2022-11-16,11:00:00,75,44,31,FMN 12 Statielei
660,Statielei 26,2022-11-16,12:00:00,197,101,96,FMN 12 Statielei
660,Statielei 26,2022-11-16,13:00:00,131,79,52,FMN 12 Statielei
660,Statielei 26,2022-11-16,14:00:00,115,51,64,FMN 12 Statielei
660,Statielei 26,2022-11-16,15:00:00,132,62,70,FMN 12 Statielei
660,Statielei 26,2022-11-16,16:00:00,202,89,113,FMN 12 Statielei
660,Statielei 26,2022-11-16,17:00:00,198,101,97,FMN 12 Statielei
660,Statielei 26,2022-11-16,18:00:00,134,81,53,FMN 12 Statielei
660,Statielei 26,2022-11-16,19:00:00,149,81,68,FMN 12 Statielei
660,Statielei 26,2022-11-16,20:00:00,87,48,39,FMN 12 Statielei
660,Statielei 26,2022-11-16,21:00:00,57,25,32,FMN 12 Statielei
660,Statielei 26,2022-11-16,22:00:00,65,23,42,FMN 12 Statielei
660,Statielei 26,2022-11-16,23:00:00,38,10,28,FMN 12 Statielei
660,Statielei 26,2022-11-17,00:00:00,14,7,7,FMN 12 Statielei
660,Statielei 26,2022-11-17,01:00:00,12,6,6,FMN 12 Statielei
660,Statielei 26,2022-11-17,02:00:00,3,3,0,FMN 12 Statielei
660,Statielei 26,2022-11-17,03:00:00,2,1,1,FMN 12 Statielei
660,Statielei 26,2022-11-17,04:00:00,8,4,4,FMN 12 Statielei
660,Statielei 26,2022-11-17,05:00:00,17,8,9,FMN 12 Statielei
660,Statielei 26,2022-11-17,06:00:00,23,6,17,FMN 12 Statielei
660,Statielei 26,2022-11-17,07:00:00,92,40,52,FMN 12 Statielei
660,Statielei 26,2022-11-17,08:00:00,264,138,126,FMN 12 Statielei
660,Statielei 26,2022-11-17,09:00:00,95,64,31,FMN 12 Statielei
660,Statielei 26,2022-11-17,10:00:00,58,33,25,FMN 12 Statielei
660,Statielei 26,2022-11-17,11:00:00,53,29,24,FMN 12 Statielei
660,Statielei 26,2022-11-17,12:00:00,89,40,49,FMN 12 Statielei
660,Statielei 26,2022-11-17,13:00:00,75,37,38,FMN 12 Statielei
660,Statielei 26,2022-11-17,14:00:00,62,36,26,FMN 12 Statielei
660,Statielei 26,2022-11-17,15:00:00,155,74,81,FMN 12 Statielei
660,Statielei 26,2022-11-17,16:00:00,213,96,117,FMN 12 Statielei
660,Statielei 26,2022-11-17,17:00:00,211,115,96,FMN 12 Statielei
660,Statielei 26,2022-11-17,18:00:00,166,88,78,FMN 12 Statielei
660,Statielei 26,2022-11-17,19:00:00,96,59,37,FMN 12 Statielei
660,Statielei 26,2022-11-17,20:00:00,109,59,50,FMN 12 Statielei
660,Statielei 26,2022-11-17,21:00:00,69,32,37,FMN 12 Statielei
660,Statielei 26,2022-11-17,22:00:00,71,27,44,FMN 12 Statielei
660,Statielei 26,2022-11-17,23:00:00,53,21,32,FMN 12 Statielei
660,Statielei 26,2022-11-18,00:00:00,28,14,14,FMN 12 Statielei
660,Statielei 26,2022-11-18,01:00:00,17,6,11,FMN 12 Statielei
660,Statielei 26,2022-11-18,02:00:00,3,1,2,FMN 12 Statielei
660,Statielei 26,2022-11-18,03:00:00,4,1,3,FMN 12 Statielei
660,Statielei 26,2022-11-18,04:00:00,7,4,3,FMN 12 Statielei
660,Statielei 26,2022-11-18,05:00:00,18,8,10,FMN 12 Statielei
660,Statielei 26,2022-11-18,06:00:00,29,12,17,FMN 12 Statielei
660,Statielei 26,2022-11-18,07:00:00,104,55,49,FMN 12 Statielei
660,Statielei 26,2022-11-18,08:00:00,261,144,117,FMN 12 Statielei
660,Statielei 26,2022-11-18,09:00:00,103,62,41,FMN 12 Statielei
660,Statielei 26,2022-11-18,10:00:00,74,41,33,FMN 12 Statielei
660,Statielei 26,2022-11-18,11:00:00,71,45,26,FMN 12 Statielei
660,Statielei 26,2022-11-18,12:00:00,105,51,54,FMN 12 Statielei
660,Statielei 26,2022-11-18,13:00:00,95,51,44,FMN 12 Statielei
660,Statielei 26,2022-11-18,14:00:00,82,46,36,FMN 12 Statielei
660,Statielei 26,2022-11-18,15:00:00,142,61,81,FMN 12 Statielei
660,Statielei 26,2022-11-18,16:00:00,208,102,106,FMN 12 Statielei
660,Statielei 26,2022-11-18,17:00:00,166,81,85,FMN 12 Statielei
660,Statielei 26,2022-11-18,18:00:00,125,47,78,FMN 12 Statielei
660,Statielei 26,2022-11-18,19:00:00,82,48,34,FMN 12 Statielei
660,Statielei 26,2022-11-18,20:00:00,92,45,47,FMN 12 Statielei
660,Statielei 26,2022-11-18,21:00:00,50,21,29,FMN 12 Statielei
660,Statielei 26,2022-11-18,22:00:00,68,33,35,FMN 12 Statielei
660,Statielei 26,2022-11-18,23:00:00,43,13,30,FMN 12 Statielei
660,Statielei 26,2022-11-19,00:00:00,47,18,29,FMN 12 Statielei
660,Statielei 26,2022-11-19,01:00:00,32,17,15,FMN 12 Statielei
660,Statielei 26,2022-11-19,02:00:00,11,6,5,FMN 12 Statielei
660,Statielei 26,2022-11-19,03:00:00,7,5,2,FMN 12 Statielei
660,Statielei 26,2022-11-19,04:00:00,8,3,5,FMN 12 Statielei
660,Statielei 26,2022-11-19,05:00:00,15,5,10,FMN 12 Statielei
660,Statielei 26,2022-11-19,06:00:00,4,3,1,FMN 12 Statielei
660,Statielei 26,2022-11-19,07:00:00,18,8,10,FMN 12 Statielei
660,Statielei 26,2022-11-19,08:00:00,41,18,23,FMN 12 Statielei
660,Statielei 26,2022-11-19,09:00:00,75,34,41,FMN 12 Statielei
660,Statielei 26,2022-11-19,10:00:00,75,43,32,FMN 12 Statielei
660,Statielei 26,2022-11-19,11:00:00,75,47,28,FMN 12 Statielei
660,Statielei 26,2022-11-19,12:00:00,120,61,59,FMN 12 Statielei
660,Statielei 26,2022-11-19,13:00:00,111,53,58,FMN 12 Statielei
660,Statielei 26,2022-11-19,14:00:00,105,59,46,FMN 12 Statielei
660,Statielei 26,2022-11-19,15:00:00,96,53,43,FMN 12 Statielei
660,Statielei 26,2022-11-19,16:00:00,90,46,44,FMN 12 Statielei
660,Statielei 26,2022-11-19,17:00:00,139,75,64,FMN 12 Statielei
660,Statielei 26,2022-11-19,18:00:00,89,52,37,FMN 12 Statielei
660,Statielei 26,2022-11-19,19:00:00,88,52,36,FMN 12 Statielei
660,Statielei 26,2022-11-19,20:00:00,86,45,41,FMN 12 Statielei
660,Statielei 26,2022-11-19,21:00:00,65,37,28,FMN 12 Statielei
660,Statielei 26,2022-11-19,22:00:00,75,35,40,FMN 12 Statielei
660,Statielei 26,2022-11-19,23:00:00,50,13,37,FMN 12 Statielei
660,Statielei 26,2022-11-20,00:00:00,47,24,23,FMN 12 Statielei
660,Statielei 26,2022-11-20,01:00:00,24,9,15,FMN 12 Statielei
660,Statielei 26,2022-11-20,02:00:00,20,3,17,FMN 12 Statielei
660,Statielei 26,2022-11-20,03:00:00,5,2,3,FMN 12 Statielei
660,Statielei 26,2022-11-20,04:00:00,8,3,5,FMN 12 Statielei
660,Statielei 26,2022-11-20,05:00:00,10,5,5,FMN 12 Statielei
660,Statielei 26,2022-11-20,06:00:00,6,1,5,FMN 12 Statielei
660,Statielei 26,2022-11-20,07:00:00,16,12,4,FMN 12 Statielei
660,Statielei 26,2022-11-20,08:00:00,30,17,13,FMN 12 Statielei
660,Statielei 26,2022-11-20,09:00:00,47,26,21,FMN 12 Statielei
660,Statielei 26,2022-11-20,10:00:00,54,22,32,FMN 12 Statielei
660,Statielei 26,2022-11-20,11:00:00,45,27,18,FMN 12 Statielei
660,Statielei 26,2022-11-20,12:00:00,78,37,41,FMN 12 Statielei
660,Statielei 26,2022-11-20,13:00:00,92,55,37,FMN 12 Statielei
660,Statielei 26,2022-11-20,14:00:00,75,34,41,FMN 12 Statielei
660,Statielei 26,2022-11-20,15:00:00,69,41,28,FMN 12 Statielei
660,Statielei 26,2022-11-20,16:00:00,71,38,33,FMN 12 Statielei
660,Statielei 26,2022-11-20,17:00:00,87,44,43,FMN 12 Statielei
660,Statielei 26,2022-11-20,18:00:00,82,45,37,FMN 12 Statielei
660,Statielei 26,2022-11-20,19:00:00,75,35,40,FMN 12 Statielei
660,Statielei 26,2022-11-20,20:00:00,55,31,24,FMN 12 Statielei
660,Statielei 26,2022-11-20,21:00:00,49,22,27,FMN 12 Statielei
660,Statielei 26,2022-11-20,22:00:00,36,19,17,FMN 12 Statielei
660,Statielei 26,2022-11-20,23:00:00,24,17,7,FMN 12 Statielei
660,Statielei 26,2022-11-21,00:00:00,12,7,5,FMN 12 Statielei
660,Statielei 26,2022-11-21,01:00:00,7,6,1,FMN 12 Statielei
660,Statielei 26,2022-11-21,02:00:00,2,1,1,FMN 12 Statielei
660,Statielei 26,2022-11-21,03:00:00,2,0,2,FMN 12 Statielei
660,Statielei 26,2022-11-21,04:00:00,5,3,2,FMN 12 Statielei
660,Statielei 26,2022-11-21,05:00:00,14,6,8,FMN 12 Statielei
660,Statielei 26,2022-11-21,06:00:00,28,10,18,FMN 12 Statielei
660,Statielei 26,2022-11-21,07:00:00,115,55,60,FMN 12 Statielei
660,Statielei 26,2022-11-21,08:00:00,263,145,118,FMN 12 Statielei
660,Statielei 26,2022-11-21,09:00:00,93,62,31,FMN 12 Statielei
660,Statielei 26,2022-11-21,10:00:00,74,45,29,FMN 12 Statielei
660,Statielei 26,2022-11-21,11:00:00,73,36,37,FMN 12 Statielei
660,Statielei 26,2022-11-21,12:00:00,129,66,63,FMN 12 Statielei
660,Statielei 26,2022-11-21,13:00:00,88,49,39,FMN 12 Statielei
660,Statielei 26,2022-11-21,14:00:00,83,40,43,FMN 12 Statielei
660,Statielei 26,2022-11-21,15:00:00,150,64,86,FMN 12 Statielei
660,Statielei 26,2022-11-21,16:00:00,225,114,111,FMN 12 Statielei
660,Statielei 26,2022-11-21,17:00:00,203,98,105,FMN 12 Statielei
660,Statielei 26,2022-11-21,18:00:00,104,45,59,FMN 12 Statielei
660,Statielei 26,2022-11-21,19:00:00,100,53,47,FMN 12 Statielei
660,Statielei 26,2022-11-21,20:00:00,64,32,32,FMN 12 Statielei
660,Statielei 26,2022-11-21,21:00:00,48,25,23,FMN 12 Statielei
660,Statielei 26,2022-11-21,22:00:00,54,22,32,FMN 12 Statielei
660,Statielei 26,2022-11-21,23:00:00,25,15,10,FMN 12 Statielei
660,Statielei 26,2022-11-22,00:00:00,6,2,4,FMN 12 Statielei
660,Statielei 26,2022-11-22,01:00:00,7,4,3,FMN 12 Statielei
660,Statielei 26,2022-11-22,02:00:00,4,3,1,FMN 12 Statielei
660,Statielei 26,2022-11-22,03:00:00,1,1,0,FMN 12 Statielei
660,Statielei 26,2022-11-22,04:00:00,7,4,3,FMN 12 Statielei
660,Statielei 26,2022-11-22,05:00:00,16,9,7,FMN 12 Statielei
660,Statielei 26,2022-11-22,06:00:00,34,17,17,FMN 12 Statielei
660,Statielei 26,2022-11-22,07:00:00,114,55,59,FMN 12 Statielei
660,Statielei 26,2022-11-22,08:00:00,6,2,4,FMN 12 Statielei
660,Statielei 26,2022-11-22,09:00:00,0,0,0,FMN 12 Statielei
660,Statielei 26,2022-11-22,10:00:00,0,0,0,FMN 12 Statielei
660,Statielei 26,2022-11-22,11:00:00,0,0,0,FMN 12 Statielei
660,Statielei 26,2022-11-22,12:00:00,0,0,0,FMN 12 Statielei
660,Statielei 26,2022-11-22,13:00:00,0,0,0,FMN 12 Statielei
660,Statielei 26,2022-11-22,14:00:00,0,0,0,FMN 12 Statielei
660,Statielei 26,2022-11-22,15:00:00,0,0,0,FMN 12 Statielei
660,Statielei 26,2022-11-22,16:00:00,0,0,0,FMN 12 Statielei
660,Statielei 26,2022-11-22,17:00:00,0,0,0,FMN 12 Statielei
660,Statielei 26,2022-11-22,18:00:00,0,0,0,FMN 12 Statielei
660,Statielei 26,2022-11-22,19:00:00,0,0,0,FMN 12 Statielei
660,Statielei 26,2022-11-22,20:00:00,0,0,0,FMN 12 Statielei
660,Statielei 26,2022-11-22,21:00:00,0,0,0,FMN 12 Statielei
660,Statielei 26,2022-11-22,22:00:00,0,0,0,FMN 12 Statielei
660,Statielei 26,2022-11-22,23:00:00,0,0,0,FMN 12 Statielei
660,Statielei 26,2022-11-23,00:00:00,0,0,0,FMN 12 Statielei
660,Statielei 26,2022-11-23,01:00:00,0,0,0,FMN 12 Statielei
660,Statielei 26,2022-11-23,02:00:00,0,0,0,FMN 12 Statielei
660,Statielei 26,2022-11-23,03:00:00,0,0,0,FMN 12 Statielei
660,Statielei 26,2022-11-23,04:00:00,0,0,0,FMN 12 Statielei
660,Statielei 26,2022-11-23,05:00:00,0,0,0,FMN 12 Statielei
660,Statielei 26,2022-11-23,06:00:00,0,0,0,FMN 12 Statielei
660,Statielei 26,2022-11-23,07:00:00,0,0,0,FMN 12 Statielei
660,Statielei 26,2022-11-23,08:00:00,0,0,0,FMN 12 Statielei
660,Statielei 26,2022-11-23,09:00:00,0,0,0,FMN 12 Statielei
660,Statielei 26,2022-11-23,10:00:00,0,0,0,FMN 12 Statielei
660,Statielei 26,2022-11-23,11:00:00,89,45,44,FMN 12 Statielei
660,Statielei 26,2022-11-23,12:00:00,195,107,88,FMN 12 Statielei
660,Statielei 26,2022-11-23,13:00:00,131,75,56,FMN 12 Statielei
660,Statielei 26,2022-11-23,14:00:00,81,46,35,FMN 12 Statielei
660,Statielei 26,2022-11-23,15:00:00,112,49,63,FMN 12 Statielei
660,Statielei 26,2022-11-23,16:00:00,164,83,81,FMN 12 Statielei
660,Statielei 26,2022-11-23,17:00:00,193,96,97,FMN 12 Statielei
660,Statielei 26,2022-11-23,18:00:00,136,71,65,FMN 12 Statielei
660,Statielei 26,2022-11-23,19:00:00,120,65,55,FMN 12 Statielei
660,Statielei 26,2022-11-23,20:00:00,64,32,32,FMN 12 Statielei
660,Statielei 26,2022-11-23,21:00:00,47,25,22,FMN 12 Statielei
660,Statielei 26,2022-11-23,22:00:00,72,38,34,FMN 12 Statielei
660,Statielei 26,2022-11-23,23:00:00,31,13,18,FMN 12 Statielei
660,Statielei 26,2022-11-24,00:00:00,24,10,14,FMN 12 Statielei
660,Statielei 26,2022-11-24,01:00:00,6,1,5,FMN 12 Statielei
660,Statielei 26,2022-11-24,02:00:00,3,1,2,FMN 12 Statielei
660,Statielei 26,2022-11-24,03:00:00,3,0,3,FMN 12 Statielei
660,Statielei 26,2022-11-24,04:00:00,4,2,2,FMN 12 Statielei
660,Statielei 26,2022-11-24,05:00:00,20,7,13,FMN 12 Statielei
660,Statielei 26,2022-11-24,06:00:00,24,7,17,FMN 12 Statielei
660,Statielei 26,2022-11-24,07:00:00,129,63,66,FMN 12 Statielei
660,Statielei 26,2022-11-24,08:00:00,300,167,133,FMN 12 Statielei
660,Statielei 26,2022-11-24,09:00:00,99,62,37,FMN 12 Statielei
660,Statielei 26,2022-11-24,10:00:00,77,46,31,FMN 12 Statielei
660,Statielei 26,2022-11-24,11:00:00,80,45,35,FMN 12 Statielei
660,Statielei 26,2022-11-24,12:00:00,130,68,62,FMN 12 Statielei
660,Statielei 26,2022-11-24,13:00:00,84,51,33,FMN 12 Statielei
660,Statielei 26,2022-11-24,14:00:00,102,49,53,FMN 12 Statielei
660,Statielei 26,2022-11-24,15:00:00,161,81,80,FMN 12 Statielei
660,Statielei 26,2022-11-24,16:00:00,236,107,129,FMN 12 Statielei
660,Statielei 26,2022-11-24,17:00:00,215,103,112,FMN 12 Statielei
660,Statielei 26,2022-11-24,18:00:00,192,100,92,FMN 12 Statielei
660,Statielei 26,2022-11-24,19:00:00,123,61,62,FMN 12 Statielei
660,Statielei 26,2022-11-24,20:00:00,132,71,61,FMN 12 Statielei
660,Statielei 26,2022-11-24,21:00:00,64,27,37,FMN 12 Statielei
660,Statielei 26,2022-11-24,22:00:00,67,29,38,FMN 12 Statielei
660,Statielei 26,2022-11-24,23:00:00,54,28,26,FMN 12 Statielei
660,Statielei 26,2022-11-25,00:00:00,31,10,21,FMN 12 Statielei
660,Statielei 26,2022-11-25,01:00:00,24,9,15,FMN 12 Statielei
660,Statielei 26,2022-11-25,02:00:00,4,2,2,FMN 12 Statielei
660,Statielei 26,2022-11-25,03:00:00,5,4,1,FMN 12 Statielei
660,Statielei 26,2022-11-25,04:00:00,10,3,7,FMN 12 Statielei
660,Statielei 26,2022-11-25,05:00:00,13,6,7,FMN 12 Statielei
660,Statielei 26,2022-11-25,06:00:00,31,12,19,FMN 12 Statielei
660,Statielei 26,2022-11-25,07:00:00,2,1,1,FMN 12 Statielei
660,Statielei 26,2022-11-25,08:00:00,0,0,0,FMN 12 Statielei
660,Statielei 26,2022-11-25,09:00:00,0,0,0,FMN 12 Statielei
660,Statielei 26,2022-11-25,10:00:00,0,0,0,FMN 12 Statielei
660,Statielei 26,2022-11-25,11:00:00,0,0,0,FMN 12 Statielei
660,Statielei 26,2022-11-25,12:00:00,83,46,37,FMN 12 Statielei
660,Statielei 26,2022-11-25,13:00:00,84,35,49,FMN 12 Statielei
660,Statielei 26,2022-11-25,14:00:00,86,43,43,FMN 12 Statielei
660,Statielei 26,2022-11-25,15:00:00,157,70,87,FMN 12 Statielei
660,Statielei 26,2022-11-25,16:00:00,248,126,122,FMN 12 Statielei
660,Statielei 26,2022-11-25,17:00:00,179,86,93,FMN 12 Statielei
660,Statielei 26,2022-11-25,18:00:00,121,51,70,FMN 12 Statielei
660,Statielei 26,2022-11-25,19:00:00,103,51,52,FMN 12 Statielei
660,Statielei 26,2022-11-25,20:00:00,94,52,42,FMN 12 Statielei
660,Statielei 26,2022-11-25,21:00:00,61,32,29,FMN 12 Statielei
660,Statielei 26,2022-11-25,22:00:00,75,20,55,FMN 12 Statielei
660,Statielei 26,2022-11-25,23:00:00,46,14,32,FMN 12 Statielei
660,Statielei 26,2022-11-26,00:00:00,54,25,29,FMN 12 Statielei
660,Statielei 26,2022-11-26,01:00:00,31,8,23,FMN 12 Statielei
660,Statielei 26,2022-11-26,02:00:00,19,7,12,FMN 12 Statielei
660,Statielei 26,2022-11-26,03:00:00,9,3,6,FMN 12 Statielei
660,Statielei 26,2022-11-26,04:00:00,10,7,3,FMN 12 Statielei
660,Statielei 26,2022-11-26,05:00:00,9,2,7,FMN 12 Statielei
660,Statielei 26,2022-11-26,06:00:00,10,6,4,FMN 12 Statielei
660,Statielei 26,2022-11-26,07:00:00,0,0,0,FMN 12 Statielei
660,Statielei 26,2022-11-26,08:00:00,0,0,0,FMN 12 Statielei
660,Statielei 26,2022-11-26,09:00:00,0,0,0,FMN 12 Statielei
660,Statielei 26,2022-11-26,10:00:00,0,0,0,FMN 12 Statielei
660,Statielei 26,2022-11-26,11:00:00,88,45,43,FMN 12 Statielei
660,Statielei 26,2022-11-26,12:00:00,135,82,53,FMN 12 Statielei
660,Statielei 26,2022-11-26,13:00:00,148,70,78,FMN 12 Statielei
660,Statielei 26,2022-11-26,14:00:00,113,59,54,FMN 12 Statielei
660,Statielei 26,2022-11-26,15:00:00,119,66,53,FMN 12 Statielei
660,Statielei 26,2022-11-26,16:00:00,129,62,67,FMN 12 Statielei
660,Statielei 26,2022-11-26,17:00:00,123,63,60,FMN 12 Statielei
660,Statielei 26,2022-11-26,18:00:00,136,79,57,FMN 12 Statielei
660,Statielei 26,2022-11-26,19:00:00,101,57,44,FMN 12 Statielei
660,Statielei 26,2022-11-26,20:00:00,68,39,29,FMN 12 Statielei
660,Statielei 26,2022-11-26,21:00:00,57,20,37,FMN 12 Statielei
660,Statielei 26,2022-11-26,22:00:00,77,29,48,FMN 12 Statielei
660,Statielei 26,2022-11-26,23:00:00,69,24,45,FMN 12 Statielei
660,Statielei 26,2022-11-27,00:00:00,35,17,18,FMN 12 Statielei
660,Statielei 26,2022-11-27,01:00:00,53,14,39,FMN 12 Statielei
660,Statielei 26,2022-11-27,02:00:00,25,6,19,FMN 12 Statielei
660,Statielei 26,2022-11-27,03:00:00,12,3,9,FMN 12 Statielei
660,Statielei 26,2022-11-27,04:00:00,6,3,3,FMN 12 Statielei
660,Statielei 26,2022-11-27,05:00:00,6,1,5,FMN 12 Statielei
660,Statielei 26,2022-11-27,06:00:00,17,11,6,FMN 12 Statielei
660,Statielei 26,2022-11-27,07:00:00,0,0,0,FMN 12 Statielei
660,Statielei 26,2022-11-27,08:00:00,0,0,0,FMN 12 Statielei
660,Statielei 26,2022-11-27,09:00:00,0,0,0,FMN 12 Statielei
660,Statielei 26,2022-11-27,10:00:00,0,0,0,FMN 12 Statielei
660,Statielei 26,2022-11-27,11:00:00,0,0,0,FMN 12 Statielei
660,Statielei 26,2022-11-27,12:00:00,0,0,0,FMN 12 Statielei
660,Statielei 26,2022-11-27,13:00:00,0,0,0,FMN 12 Statielei
660,Statielei 26,2022-11-27,14:00:00,0,0,0,FMN 12 Statielei
660,Statielei 26,2022-11-27,15:00:00,0,0,0,FMN 12 Statielei
660,Statielei 26,2022-11-27,16:00:00,0,0,0,FMN 12 Statielei
660,Statielei 26,2022-11-27,17:00:00,0,0,0,FMN 12 Statielei
660,Statielei 26,2022-11-27,18:00:00,0,0,0,FMN 12 Statielei
660,Statielei 26,2022-11-27,19:00:00,0,0,0,FMN 12 Statielei
660,Statielei 26,2022-11-27,20:00:00,0,0,0,FMN 12 Statielei
660,Statielei 26,2022-11-27,21:00:00,0,0,0,FMN 12 Statielei
660,Statielei 26,2022-11-27,22:00:00,0,0,0,FMN 12 Statielei
660,Statielei 26,2022-11-27,23:00:00,0,0,0,FMN 12 Statielei
660,Statielei 26,2022-11-28,00:00:00,0,0,0,FMN 12 Statielei
660,Statielei 26,2022-11-28,01:00:00,0,0,0,FMN 12 Statielei
660,Statielei 26,2022-11-28,02:00:00,0,0,0,FMN 12 Statielei
660,Statielei 26,2022-11-28,03:00:00,0,0,0,FMN 12 Statielei
660,Statielei 26,2022-11-28,04:00:00,0,0,0,FMN 12 Statielei
660,Statielei 26,2022-11-28,05:00:00,0,0,0,FMN 12 Statielei
660,Statielei 26,2022-11-28,06:00:00,0,0,0,FMN 12 Statielei
660,Statielei 26,2022-11-28,07:00:00,0,0,0,FMN 12 Statielei
660,Statielei 26,2022-11-28,08:00:00,0,0,0,FMN 12 Statielei
660,Statielei 26,2022-11-28,09:00:00,0,0,0,FMN 12 Statielei
660,Statielei 26,2022-11-28,10:00:00,0,0,0,FMN 12 Statielei
660,Statielei 26,2022-11-28,11:00:00,0,0,0,FMN 12 Statielei
660,Statielei 26,2022-11-28,12:00:00,71,41,30,FMN 12 Statielei
660,Statielei 26,2022-11-28,13:00:00,106,52,54,FMN 12 Statielei
660,Statielei 26,2022-11-28,14:00:00,100,50,50,FMN 12 Statielei
660,Statielei 26,2022-11-28,15:00:00,160,71,89,FMN 12 Statielei
660,Statielei 26,2022-11-28,16:00:00,227,116,111,FMN 12 Statielei
660,Statielei 26,2022-11-28,17:00:00,183,94,89,FMN 12 Statielei
660,Statielei 26,2022-11-28,18:00:00,148,86,62,FMN 12 Statielei
660,Statielei 26,2022-11-28,19:00:00,104,55,49,FMN 12 Statielei
660,Statielei 26,2022-11-28,20:00:00,87,43,44,FMN 12 Statielei
660,Statielei 26,2022-11-28,21:00:00,56,20,36,FMN 12 Statielei
660,Statielei 26,2022-11-28,22:00:00,68,33,35,FMN 12 Statielei
660,Statielei 26,2022-11-28,23:00:00,30,10,20,FMN 12 Statielei
660,Statielei 26,2022-11-29,00:00:00,12,4,8,FMN 12 Statielei
660,Statielei 26,2022-11-29,01:00:00,20,6,14,FMN 12 Statielei
660,Statielei 26,2022-11-29,02:00:00,8,4,4,FMN 12 Statielei
660,Statielei 26,2022-11-29,03:00:00,7,4,3,FMN 12 Statielei
660,Statielei 26,2022-11-29,04:00:00,8,4,4,FMN 12 Statielei
660,Statielei 26,2022-11-29,05:00:00,12,6,6,FMN 12 Statielei
660,Statielei 26,2022-11-29,06:00:00,39,18,21,FMN 12 Statielei
660,Statielei 26,2022-11-29,07:00:00,94,40,54,FMN 12 Statielei
660,Statielei 26,2022-11-29,08:00:00,0,0,0,FMN 12 Statielei
660,Statielei 26,2022-11-29,09:00:00,0,0,0,FMN 12 Statielei
660,Statielei 26,2022-11-29,10:00:00,0,0,0,FMN 12 Statielei
660,Statielei 26,2022-11-29,11:00:00,0,0,0,FMN 12 Statielei
660,Statielei 26,2022-11-29,12:00:00,105,56,49,FMN 12 Statielei
660,Statielei 26,2022-11-29,13:00:00,94,61,33,FMN 12 Statielei
660,Statielei 26,2022-11-29,14:00:00,104,53,51,FMN 12 Statielei
660,Statielei 26,2022-11-29,15:00:00,169,59,110,FMN 12 Statielei
660,Statielei 26,2022-11-29,16:00:00,263,142,121,FMN 12 Statielei
660,Statielei 26,2022-11-29,17:00:00,205,96,109,FMN 12 Statielei
660,Statielei 26,2022-11-29,18:00:00,170,80,90,FMN 12 Statielei
660,Statielei 26,2022-11-29,19:00:00,88,53,35,FMN 12 Statielei
660,Statielei 26,2022-11-29,20:00:00,105,61,44,FMN 12 Statielei
660,Statielei 26,2022-11-29,21:00:00,76,32,44,FMN 12 Statielei
660,Statielei 26,2022-11-29,22:00:00,70,34,36,FMN 12 Statielei
660,Statielei 26,2022-11-29,23:00:00,46,17,29,FMN 12 Statielei
660,Statielei 26,2022-11-30,00:00:00,15,4,11,FMN 12 Statielei
660,Statielei 26,2022-11-30,01:00:00,5,2,3,FMN 12 Statielei
660,Statielei 26,2022-11-30,02:00:00,5,3,2,FMN 12 Statielei
660,Statielei 26,2022-11-30,03:00:00,5,3,2,FMN 12 Statielei
660,Statielei 26,2022-11-30,04:00:00,6,2,4,FMN 12 Statielei
660,Statielei 26,2022-11-30,05:00:00,2,1,1,FMN 12 Statielei
660,Statielei 26,2022-11-30,06:00:00,0,0,0,FMN 12 Statielei
660,Statielei 26,2022-11-30,07:00:00,0,0,0,FMN 12 Statielei
660,Statielei 26,2022-11-30,08:00:00,0,0,0,FMN 12 Statielei
660,Statielei 26,2022-11-30,09:00:00,0,0,0,FMN 12 Statielei
660,Statielei 26,2022-11-30,10:00:00,0,0,0,FMN 12 Statielei
660,Statielei 26,2022-11-30,11:00:00,0,0,0,FMN 12 Statielei
660,Statielei 26,2022-11-30,12:00:00,0,0,0,FMN 12 Statielei
660,Statielei 26,2022-11-30,13:00:00,31,13,18,FMN 12 Statielei
660,Statielei 26,2022-11-30,14:00:00,126,61,65,FMN 12 Statielei
660,Statielei 26,2022-11-30,15:00:00,136,66,70,FMN 12 Statielei
660,Statielei 26,2022-11-30,16:00:00,187,89,98,FMN 12 Statielei
660,Statielei 26,2022-11-30,17:00:00,184,94,90,FMN 12 Statielei
660,Statielei 26,2022-11-30,18:00:00,163,91,72,FMN 12 Statielei
660,Statielei 26,2022-11-30,19:00:00,95,49,46,FMN 12 Statielei
660,Statielei 26,2022-11-30,20:00:00,85,34,51,FMN 12 Statielei
660,Statielei 26,2022-11-30,21:00:00,65,28,37,FMN 12 Statielei
660,Statielei 26,2022-11-30,22:00:00,69,34,35,FMN 12 Statielei
660,Statielei 26,2022-11-30,23:00:00,37,13,24,FMN 12 Statielei
660,Statielei 26,2022-12-01,00:00:00,21,10,11,FMN 12 Statielei
660,Statielei 26,2022-12-01,01:00:00,12,4,8,FMN 12 Statielei
660,Statielei 26,2022-12-01,02:00:00,4,1,3,FMN 12 Statielei
660,Statielei 26,2022-12-01,03:00:00,4,2,2,FMN 12 Statielei
660,Statielei 26,2022-12-01,04:00:00,6,2,4,FMN 12 Statielei
660,Statielei 26,2022-12-01,05:00:00,18,6,12,FMN 12 Statielei
660,Statielei 26,2022-12-01,06:00:00,34,10,24,FMN 12 Statielei
660,Statielei 26,2022-12-01,07:00:00,112,55,57,FMN 12 Statielei
660,Statielei 26,2022-12-01,08:00:00,225,116,109,FMN 12 Statielei
660,Statielei 26,2022-12-01,09:00:00,93,58,35,FMN 12 Statielei
660,Statielei 26,2022-12-01,10:00:00,65,38,27,FMN 12 Statielei
660,Statielei 26,2022-12-01,11:00:00,75,43,32,FMN 12 Statielei
660,Statielei 26,2022-12-01,12:00:00,102,54,48,FMN 12 Statielei
660,Statielei 26,2022-12-01,13:00:00,85,43,42,FMN 12 Statielei
660,Statielei 26,2022-12-01,14:00:00,82,43,39,FMN 12 Statielei
660,Statielei 26,2022-12-01,15:00:00,153,62,91,FMN 12 Statielei
660,Statielei 26,2022-12-01,16:00:00,214,107,107,FMN 12 Statielei
660,Statielei 26,2022-12-01,17:00:00,219,102,117,FMN 12 Statielei
660,Statielei 26,2022-12-01,18:00:00,181,88,93,FMN 12 Statielei
660,Statielei 26,2022-12-01,19:00:00,136,71,65,FMN 12 Statielei
660,Statielei 26,2022-12-01,20:00:00,80,38,42,FMN 12 Statielei
660,Statielei 26,2022-12-01,21:00:00,76,34,42,FMN 12 Statielei
660,Statielei 26,2022-12-01,22:00:00,78,40,38,FMN 12 Statielei
660,Statielei 26,2022-12-01,23:00:00,46,26,20,FMN 12 Statielei
660,Statielei 26,2022-12-02,00:00:00,21,9,12,FMN 12 Statielei
660,Statielei 26,2022-12-02,01:00:00,12,5,7,FMN 12 Statielei
660,Statielei 26,2022-12-02,02:00:00,4,2,2,FMN 12 Statielei
660,Statielei 26,2022-12-02,03:00:00,5,1,4,FMN 12 Statielei
660,Statielei 26,2022-12-02,04:00:00,11,3,8,FMN 12 Statielei
660,Statielei 26,2022-12-02,05:00:00,10,4,6,FMN 12 Statielei
660,Statielei 26,2022-12-02,06:00:00,31,11,20,FMN 12 Statielei
660,Statielei 26,2022-12-02,07:00:00,89,41,48,FMN 12 Statielei
660,Statielei 26,2022-12-02,08:00:00,181,90,91,FMN 12 Statielei
660,Statielei 26,2022-12-02,09:00:00,89,52,37,FMN 12 Statielei
660,Statielei 26,2022-12-02,10:00:00,59,38,21,FMN 12 Statielei
660,Statielei 26,2022-12-02,11:00:00,65,37,28,FMN 12 Statielei
660,Statielei 26,2022-12-02,12:00:00,92,55,37,FMN 12 Statielei
660,Statielei 26,2022-12-02,13:00:00,85,44,41,FMN 12 Statielei
660,Statielei 26,2022-12-02,14:00:00,102,49,53,FMN 12 Statielei
660,Statielei 26,2022-12-02,15:00:00,166,83,83,FMN 12 Statielei
660,Statielei 26,2022-12-02,16:00:00,175,91,84,FMN 12 Statielei
660,Statielei 26,2022-12-02,17:00:00,174,86,88,FMN 12 Statielei
660,Statielei 26,2022-12-02,18:00:00,138,69,69,FMN 12 Statielei
660,Statielei 26,2022-12-02,19:00:00,128,56,72,FMN 12 Statielei
660,Statielei 26,2022-12-02,20:00:00,101,54,47,FMN 12 Statielei
660,Statielei 26,2022-12-02,21:00:00,75,35,40,FMN 12 Statielei
660,Statielei 26,2022-12-02,22:00:00,71,34,37,FMN 12 Statielei
660,Statielei 26,2022-12-02,23:00:00,60,24,36,FMN 12 Statielei
660,Statielei 26,2022-12-03,00:00:00,26,16,10,FMN 12 Statielei
660,Statielei 26,2022-12-03,01:00:00,19,4,15,FMN 12 Statielei
660,Statielei 26,2022-12-03,02:00:00,9,5,4,FMN 12 Statielei
660,Statielei 26,2022-12-03,03:00:00,6,1,5,FMN 12 Statielei
660,Statielei 26,2022-12-03,04:00:00,8,1,7,FMN 12 Statielei
660,Statielei 26,2022-12-03,05:00:00,6,5,1,FMN 12 Statielei
660,Statielei 26,2022-12-03,06:00:00,12,3,9,FMN 12 Statielei
660,Statielei 26,2022-12-03,07:00:00,16,10,6,FMN 12 Statielei
660,Statielei 26,2022-12-03,08:00:00,26,12,14,FMN 12 Statielei
660,Statielei 26,2022-12-03,09:00:00,60,29,31,FMN 12 Statielei
660,Statielei 26,2022-12-03,10:00:00,71,36,35,FMN 12 Statielei
660,Statielei 26,2022-12-03,11:00:00,69,40,29,FMN 12 Statielei
660,Statielei 26,2022-12-03,12:00:00,77,34,43,FMN 12 Statielei
660,Statielei 26,2022-12-03,13:00:00,98,51,47,FMN 12 Statielei
660,Statielei 26,2022-12-03,14:00:00,95,46,49,FMN 12 Statielei
660,Statielei 26,2022-12-03,15:00:00,85,47,38,FMN 12 Statielei
660,Statielei 26,2022-12-03,16:00:00,84,44,40,FMN 12 Statielei
660,Statielei 26,2022-12-03,17:00:00,101,52,49,FMN 12 Statielei
660,Statielei 26,2022-12-03,18:00:00,97,48,49,FMN 12 Statielei
660,Statielei 26,2022-12-03,19:00:00,79,40,39,FMN 12 Statielei
660,Statielei 26,2022-12-03,20:00:00,71,38,33,FMN 12 Statielei
660,Statielei 26,2022-12-03,21:00:00,43,21,22,FMN 12 Statielei
660,Statielei 26,2022-12-03,22:00:00,59,26,33,FMN 12 Statielei
660,Statielei 26,2022-12-03,23:00:00,41,17,24,FMN 12 Statielei
660,Statielei 26,2022-12-04,00:00:00,29,13,16,FMN 12 Statielei
660,Statielei 26,2022-12-04,01:00:00,21,9,12,FMN 12 Statielei
660,Statielei 26,2022-12-04,02:00:00,11,4,7,FMN 12 Statielei
660,Statielei 26,2022-12-04,03:00:00,7,1,6,FMN 12 Statielei
660,Statielei 26,2022-12-04,04:00:00,5,0,5,FMN 12 Statielei
660,Statielei 26,2022-12-04,05:00:00,3,3,0,FMN 12 Statielei
660,Statielei 26,2022-12-04,06:00:00,8,5,3,FMN 12 Statielei
660,Statielei 26,2022-12-04,07:00:00,10,5,5,FMN 12 Statielei
660,Statielei 26,2022-12-04,08:00:00,23,12,11,FMN 12 Statielei
660,Statielei 26,2022-12-04,09:00:00,36,19,17,FMN 12 Statielei
660,Statielei 26,2022-12-04,10:00:00,51,25,26,FMN 12 Statielei
660,Statielei 26,2022-12-04,11:00:00,53,29,24,FMN 12 Statielei
660,Statielei 26,2022-12-04,12:00:00,78,43,35,FMN 12 Statielei
660,Statielei 26,2022-12-04,13:00:00,73,36,37,FMN 12 Statielei
660,Statielei 26,2022-12-04,14:00:00,94,49,45,FMN 12 Statielei
660,Statielei 26,2022-12-04,15:00:00,79,37,42,FMN 12 Statielei
660,Statielei 26,2022-12-04,16:00:00,88,37,51,FMN 12 Statielei
660,Statielei 26,2022-12-04,17:00:00,82,42,40,FMN 12 Statielei
660,Statielei 26,2022-12-04,18:00:00,94,50,44,FMN 12 Statielei
660,Statielei 26,2022-12-04,19:00:00,69,36,33,FMN 12 Statielei
660,Statielei 26,2022-12-04,20:00:00,47,22,25,FMN 12 Statielei
660,Statielei 26,2022-12-04,21:00:00,38,20,18,FMN 12 Statielei
660,Statielei 26,2022-12-04,22:00:00,40,21,19,FMN 12 Statielei
660,Statielei 26,2022-12-04,23:00:00,19,12,7,FMN 12 Statielei
660,Statielei 26,2022-12-05,00:00:00,12,4,8,FMN 12 Statielei
660,Statielei 26,2022-12-05,01:00:00,9,4,5,FMN 12 Statielei
660,Statielei 26,2022-12-05,02:00:00,5,1,4,FMN 12 Statielei
660,Statielei 26,2022-12-05,03:00:00,6,3,3,FMN 12 Statielei
660,Statielei 26,2022-12-05,04:00:00,7,4,3,FMN 12 Statielei
660,Statielei 26,2022-12-05,05:00:00,6,4,2,FMN 12 Statielei
660,Statielei 26,2022-12-05,06:00:00,35,18,17,FMN 12 Statielei
660,Statielei 26,2022-12-05,07:00:00,84,46,38,FMN 12 Statielei
660,Statielei 26,2022-12-05,08:00:00,159,90,69,FMN 12 Statielei
660,Statielei 26,2022-12-05,09:00:00,80,49,31,FMN 12 Statielei
660,Statielei 26,2022-12-05,10:00:00,55,29,26,FMN 12 Statielei
660,Statielei 26,2022-12-05,11:00:00,55,28,27,FMN 12 Statielei
660,Statielei 26,2022-12-05,12:00:00,76,38,38,FMN 12 Statielei
660,Statielei 26,2022-12-05,13:00:00,80,31,49,FMN 12 Statielei
660,Statielei 26,2022-12-05,14:00:00,65,32,33,FMN 12 Statielei
660,Statielei 26,2022-12-05,15:00:00,113,55,58,FMN 12 Statielei
660,Statielei 26,2022-12-05,16:00:00,165,84,81,FMN 12 Statielei
660,Statielei 26,2022-12-05,17:00:00,175,88,87,FMN 12 Statielei
660,Statielei 26,2022-12-05,18:00:00,125,65,60,FMN 12 Statielei
660,Statielei 26,2022-12-05,19:00:00,103,55,48,FMN 12 Statielei
660,Statielei 26,2022-12-05,20:00:00,85,46,39,FMN 12 Statielei
660,Statielei 26,2022-12-05,21:00:00,62,34,28,FMN 12 Statielei
660,Statielei 26,2022-12-05,22:00:00,44,20,24,FMN 12 Statielei
660,Statielei 26,2022-12-05,23:00:00,27,12,15,FMN 12 Statielei
660,Statielei 26,2022-12-06,00:00:00,0,0,0,FMN 12 Statielei
660,Statielei 26,2022-12-06,01:00:00,0,0,0,FMN 12 Statielei
660,Statielei 26,2022-12-06,02:00:00,0,0,0,FMN 12 Statielei
660,Statielei 26,2022-12-06,03:00:00,0,0,0,FMN 12 Statielei
660,Statielei 26,2022-12-06,04:00:00,0,0,0,FMN 12 Statielei
660,Statielei 26,2022-12-06,05:00:00,0,0,0,FMN 12 Statielei
660,Statielei 26,2022-12-06,06:00:00,0,0,0,FMN 12 Statielei
660,Statielei 26,2022-12-06,07:00:00,0,0,0,FMN 12 Statielei
660,Statielei 26,2022-12-06,08:00:00,0,0,0,FMN 12 Statielei
660,Statielei 26,2022-12-06,09:00:00,0,0,0,FMN 12 Statielei
660,Statielei 26,2022-12-06,10:00:00,0,0,0,FMN 12 Statielei
660,Statielei 26,2022-12-06,11:00:00,0,0,0,FMN 12 Statielei
660,Statielei 26,2022-12-06,12:00:00,89,59,30,FMN 12 Statielei
660,Statielei 26,2022-12-06,13:00:00,93,53,40,FMN 12 Statielei
660,Statielei 26,2022-12-06,14:00:00,104,51,53,FMN 12 Statielei
660,Statielei 26,2022-12-06,15:00:00,186,77,109,FMN 12 Statielei
660,Statielei 26,2022-12-06,16:00:00,223,116,107,FMN 12 Statielei
660,Statielei 26,2022-12-06,17:00:00,160,67,93,FMN 12 Statielei
660,Statielei 26,2022-12-06,18:00:00,119,57,62,FMN 12 Statielei
660,Statielei 26,2022-12-06,19:00:00,110,64,46,FMN 12 Statielei
660,Statielei 26,2022-12-06,20:00:00,97,59,38,FMN 12 Statielei
660,Statielei 26,2022-12-06,21:00:00,67,20,47,FMN 12 Statielei
660,Statielei 26,2022-12-06,22:00:00,57,28,29,FMN 12 Statielei
660,Statielei 26,2022-12-06,23:00:00,25,8,17,FMN 12 Statielei
660,Statielei 26,2022-12-07,00:00:00,23,8,15,FMN 12 Statielei
660,Statielei 26,2022-12-07,01:00:00,6,3,3,FMN 12 Statielei
660,Statielei 26,2022-12-07,02:00:00,0,0,0,FMN 12 Statielei
660,Statielei 26,2022-12-07,03:00:00,2,0,2,FMN 12 Statielei
660,Statielei 26,2022-12-07,04:00:00,6,3,3,FMN 12 Statielei
660,Statielei 26,2022-12-07,05:00:00,17,9,8,FMN 12 Statielei
660,Statielei 26,2022-12-07,06:00:00,32,16,16,FMN 12 Statielei
660,Statielei 26,2022-12-07,07:00:00,113,47,66,FMN 12 Statielei
660,Statielei 26,2022-12-07,08:00:00,246,152,94,FMN 12 Statielei
660,Statielei 26,2022-12-07,09:00:00,101,62,39,FMN 12 Statielei
660,Statielei 26,2022-12-07,10:00:00,83,49,34,FMN 12 Statielei
660,Statielei 26,2022-12-07,11:00:00,82,42,40,FMN 12 Statielei
660,Statielei 26,2022-12-07,12:00:00,196,88,108,FMN 12 Statielei
660,Statielei 26,2022-12-07,13:00:00,114,60,54,FMN 12 Statielei
660,Statielei 26,2022-12-07,14:00:00,76,38,38,FMN 12 Statielei
660,Statielei 26,2022-12-07,15:00:00,108,54,54,FMN 12 Statielei
660,Statielei 26,2022-12-07,16:00:00,189,84,105,FMN 12 Statielei
660,Statielei 26,2022-12-07,17:00:00,196,96,100,FMN 12 Statielei
660,Statielei 26,2022-12-07,18:00:00,142,81,61,FMN 12 Statielei
660,Statielei 26,2022-12-07,19:00:00,100,54,46,FMN 12 Statielei
660,Statielei 26,2022-12-07,20:00:00,82,30,52,FMN 12 Statielei
660,Statielei 26,2022-12-07,21:00:00,59,32,27,FMN 12 Statielei
660,Statielei 26,2022-12-07,22:00:00,59,27,32,FMN 12 Statielei
660,Statielei 26,2022-12-07,23:00:00,48,21,27,FMN 12 Statielei
660,Statielei 26,2022-12-08,00:00:00,13,5,8,FMN 12 Statielei
660,Statielei 26,2022-12-08,01:00:00,9,4,5,FMN 12 Statielei
660,Statielei 26,2022-12-08,02:00:00,4,1,3,FMN 12 Statielei
660,Statielei 26,2022-12-08,03:00:00,5,2,3,FMN 12 Statielei
660,Statielei 26,2022-12-08,04:00:00,10,8,2,FMN 12 Statielei
660,Statielei 26,2022-12-08,05:00:00,11,5,6,FMN 12 Statielei
660,Statielei 26,2022-12-08,06:00:00,27,15,12,FMN 12 Statielei
660,Statielei 26,2022-12-08,07:00:00,9,5,4,FMN 12 Statielei
660,Statielei 26,2022-12-08,08:00:00,0,0,0,FMN 12 Statielei
660,Statielei 26,2022-12-08,09:00:00,0,0,0,FMN 12 Statielei
660,Statielei 26,2022-12-08,10:00:00,2,2,0,FMN 12 Statielei
660,Statielei 26,2022-12-08,11:00:00,65,40,25,FMN 12 Statielei
660,Statielei 26,2022-12-08,12:00:00,100,54,46,FMN 12 Statielei
660,Statielei 26,2022-12-08,13:00:00,62,30,32,FMN 12 Statielei
660,Statielei 26,2022-12-08,14:00:00,75,40,35,FMN 12 Statielei
660,Statielei 26,2022-12-08,15:00:00,116,46,70,FMN 12 Statielei
660,Statielei 26,2022-12-08,16:00:00,221,102,119,FMN 12 Statielei
660,Statielei 26,2022-12-08,17:00:00,166,79,87,FMN 12 Statielei
660,Statielei 26,2022-12-08,18:00:00,145,76,69,FMN 12 Statielei
660,Statielei 26,2022-12-08,19:00:00,0,0,0,FMN 12 Statielei
660,Statielei 26,2022-12-08,20:00:00,0,0,0,FMN 12 Statielei
660,Statielei 26,2022-12-08,21:00:00,0,0,0,FMN 12 Statielei
660,Statielei 26,2022-12-08,22:00:00,0,0,0,FMN 12 Statielei
660,Statielei 26,2022-12-08,23:00:00,0,0,0,FMN 12 Statielei
660,Statielei 26,2022-12-09,00:00:00,0,0,0,FMN 12 Statielei
660,Statielei 26,2022-12-09,01:00:00,0,0,0,FMN 12 Statielei
660,Statielei 26,2022-12-09,02:00:00,0,0,0,FMN 12 Statielei
660,Statielei 26,2022-12-09,03:00:00,0,0,0,FMN 12 Statielei
660,Statielei 26,2022-12-09,04:00:00,0,0,0,FMN 12 Statielei
660,Statielei 26,2022-12-09,05:00:00,0,0,0,FMN 12 Statielei
660,Statielei 26,2022-12-09,06:00:00,0,0,0,FMN 12 Statielei
660,Statielei 26,2022-12-09,07:00:00,0,0,0,FMN 12 Statielei
660,Statielei 26,2022-12-09,08:00:00,0,0,0,FMN 12 Statielei
660,Statielei 26,2022-12-09,09:00:00,0,0,0,FMN 12 Statielei
660,Statielei 26,2022-12-09,10:00:00,0,0,0,FMN 12 Statielei
660,Statielei 26,2022-12-09,11:00:00,32,18,14,FMN 12 Statielei
660,Statielei 26,2022-12-09,12:00:00,105,56,49,FMN 12 Statielei
660,Statielei 26,2022-12-09,13:00:00,89,39,50,FMN 12 Statielei
660,Statielei 26,2022-12-09,14:00:00,96,39,57,FMN 12 Statielei
660,Statielei 26,2022-12-09,15:00:00,144,70,74,FMN 12 Statielei
660,Statielei 26,2022-12-09,16:00:00,203,104,99,FMN 12 Statielei
660,Statielei 26,2022-12-09,17:00:00,144,77,67,FMN 12 Statielei
660,Statielei 26,2022-12-09,18:00:00,115,56,59,FMN 12 Statielei
660,Statielei 26,2022-12-09,19:00:00,142,90,52,FMN 12 Statielei
660,Statielei 26,2022-12-09,20:00:00,74,33,41,FMN 12 Statielei
660,Statielei 26,2022-12-09,21:00:00,56,28,28,FMN 12 Statielei
660,Statielei 26,2022-12-09,22:00:00,43,14,29,FMN 12 Statielei
660,Statielei 26,2022-12-09,23:00:00,55,16,39,FMN 12 Statielei
660,Statielei 26,2022-12-10,00:00:00,30,11,19,FMN 12 Statielei
660,Statielei 26,2022-12-10,01:00:00,17,5,12,FMN 12 Statielei
660,Statielei 26,2022-12-10,02:00:00,9,3,6,FMN 12 Statielei
660,Statielei 26,2022-12-10,03:00:00,7,2,5,FMN 12 Statielei
660,Statielei 26,2022-12-10,04:00:00,3,3,0,FMN 12 Statielei
660,Statielei 26,2022-12-10,05:00:00,2,1,1,FMN 12 Statielei
660,Statielei 26,2022-12-10,06:00:00,10,6,4,FMN 12 Statielei
660,Statielei 26,2022-12-10,07:00:00,11,5,6,FMN 12 Statielei
660,Statielei 26,2022-12-10,08:00:00,26,13,13,FMN 12 Statielei
660,Statielei 26,2022-12-10,09:00:00,50,24,26,FMN 12 Statielei
660,Statielei 26,2022-12-10,10:00:00,52,28,24,FMN 12 Statielei
660,Statielei 26,2022-12-10,11:00:00,76,35,41,FMN 12 Statielei
660,Statielei 26,2022-12-10,12:00:00,69,39,30,FMN 12 Statielei
660,Statielei 26,2022-12-10,13:00:00,81,43,38,FMN 12 Statielei
660,Statielei 26,2022-12-10,14:00:00,88,48,40,FMN 12 Statielei
660,Statielei 26,2022-12-10,15:00:00,75,40,35,FMN 12 Statielei
660,Statielei 26,2022-12-10,16:00:00,82,48,34,FMN 12 Statielei
660,Statielei 26,2022-12-10,17:00:00,91,49,42,FMN 12 Statielei
660,Statielei 26,2022-12-10,18:00:00,82,37,45,FMN 12 Statielei
660,Statielei 26,2022-12-10,19:00:00,69,41,28,FMN 12 Statielei
660,Statielei 26,2022-12-10,20:00:00,65,27,38,FMN 12 Statielei
660,Statielei 26,2022-12-10,21:00:00,44,20,24,FMN 12 Statielei
660,Statielei 26,2022-12-10,22:00:00,40,17,23,FMN 12 Statielei
660,Statielei 26,2022-12-10,23:00:00,38,10,28,FMN 12 Statielei
660,Statielei 26,2022-12-11,00:00:00,31,7,24,FMN 12 Statielei
660,Statielei 26,2022-12-11,01:00:00,10,5,5,FMN 12 Statielei
660,Statielei 26,2022-12-11,02:00:00,12,6,6,FMN 12 Statielei
660,Statielei 26,2022-12-11,03:00:00,11,5,6,FMN 12 Statielei
660,Statielei 26,2022-12-11,04:00:00,5,1,4,FMN 12 Statielei
660,Statielei 26,2022-12-11,05:00:00,6,2,4,FMN 12 Statielei
660,Statielei 26,2022-12-11,06:00:00,8,5,3,FMN 12 Statielei
660,Statielei 26,2022-12-11,07:00:00,9,6,3,FMN 12 Statielei
660,Statielei 26,2022-12-11,08:00:00,13,4,9,FMN 12 Statielei
660,Statielei 26,2022-12-11,09:00:00,43,18,25,FMN 12 Statielei
660,Statielei 26,2022-12-11,10:00:00,46,21,25,FMN 12 Statielei
660,Statielei 26,2022-12-11,11:00:00,53,28,25,FMN 12 Statielei
660,Statielei 26,2022-12-11,12:00:00,62,34,28,FMN 12 Statielei
660,Statielei 26,2022-12-11,13:00:00,65,31,34,FMN 12 Statielei
660,Statielei 26,2022-12-11,14:00:00,63,28,35,FMN 12 Statielei
660,Statielei 26,2022-12-11,15:00:00,73,38,35,FMN 12 Statielei
660,Statielei 26,2022-12-11,16:00:00,71,39,32,FMN 12 Statielei
660,Statielei 26,2022-12-11,17:00:00,80,40,40,FMN 12 Statielei
660,Statielei 26,2022-12-11,18:00:00,63,32,31,FMN 12 Statielei
660,Statielei 26,2022-12-11,19:00:00,49,27,22,FMN 12 Statielei
660,Statielei 26,2022-12-11,20:00:00,52,27,25,FMN 12 Statielei
660,Statielei 26,2022-12-11,21:00:00,28,11,17,FMN 12 Statielei
660,Statielei 26,2022-12-11,22:00:00,23,12,11,FMN 12 Statielei
660,Statielei 26,2022-12-11,23:00:00,22,9,13,FMN 12 Statielei
660,Statielei 26,2022-12-12,00:00:00,0,0,0,FMN 12 Statielei
660,Statielei 26,2022-12-12,01:00:00,0,0,0,FMN 12 Statielei
660,Statielei 26,2022-12-12,02:00:00,0,0,0,FMN 12 Statielei
660,Statielei 26,2022-12-12,03:00:00,0,0,0,FMN 12 Statielei
660,Statielei 26,2022-12-12,04:00:00,0,0,0,FMN 12 Statielei
660,Statielei 26,2022-12-12,05:00:00,0,0,0,FMN 12 Statielei
660,Statielei 26,2022-12-12,06:00:00,0,0,0,FMN 12 Statielei
660,Statielei 26,2022-12-12,07:00:00,0,0,0,FMN 12 Statielei
660,Statielei 26,2022-12-12,08:00:00,0,0,0,FMN 12 Statielei
660,Statielei 26,2022-12-12,09:00:00,0,0,0,FMN 12 Statielei
660,Statielei 26,2022-12-12,10:00:00,0,0,0,FMN 12 Statielei
660,Statielei 26,2022-12-12,11:00:00,0,0,0,FMN 12 Statielei
660,Statielei 26,2022-12-12,12:00:00,41,22,19,FMN 12 Statielei
660,Statielei 26,2022-12-12,13:00:00,72,42,30,FMN 12 Statielei
660,Statielei 26,2022-12-12,14:00:00,77,38,39,FMN 12 Statielei
660,Statielei 26,2022-12-12,15:00:00,144,66,78,FMN 12 Statielei
660,Statielei 26,2022-12-12,16:00:00,150,60,90,FMN 12 Statielei
660,Statielei 26,2022-12-12,17:00:00,144,64,80,FMN 12 Statielei
660,Statielei 26,2022-12-12,18:00:00,113,60,53,FMN 12 Statielei
660,Statielei 26,2022-12-12,19:00:00,83,47,36,FMN 12 Statielei
660,Statielei 26,2022-12-12,20:00:00,77,38,39,FMN 12 Statielei
660,Statielei 26,2022-12-12,21:00:00,41,19,22,FMN 12 Statielei
660,Statielei 26,2022-12-12,22:00:00,44,18,26,FMN 12 Statielei
660,Statielei 26,2022-12-12,23:00:00,22,11,11,FMN 12 Statielei
660,Statielei 26,2022-12-13,00:00:00,14,6,8,FMN 12 Statielei
660,Statielei 26,2022-12-13,01:00:00,3,2,1,FMN 12 Statielei
660,Statielei 26,2022-12-13,02:00:00,6,3,3,FMN 12 Statielei
660,Statielei 26,2022-12-13,03:00:00,2,1,1,FMN 12 Statielei
660,Statielei 26,2022-12-13,04:00:00,4,3,1,FMN 12 Statielei
660,Statielei 26,2022-12-13,05:00:00,0,0,0,FMN 12 Statielei
660,Statielei 26,2022-12-13,06:00:00,0,0,0,FMN 12 Statielei
660,Statielei 26,2022-12-13,07:00:00,0,0,0,FMN 12 Statielei
660,Statielei 26,2022-12-13,08:00:00,0,0,0,FMN 12 Statielei
660,Statielei 26,2022-12-13,09:00:00,0,0,0,FMN 12 Statielei
660,Statielei 26,2022-12-13,10:00:00,41,24,17,FMN 12 Statielei
660,Statielei 26,2022-12-13,11:00:00,67,39,28,FMN 12 Statielei
660,Statielei 26,2022-12-13,12:00:00,135,84,51,FMN 12 Statielei
660,Statielei 26,2022-12-13,13:00:00,85,43,42,FMN 12 Statielei
660,Statielei 26,2022-12-13,14:00:00,73,42,31,FMN 12 Statielei
660,Statielei 26,2022-12-13,15:00:00,108,46,62,FMN 12 Statielei
660,Statielei 26,2022-12-13,16:00:00,166,72,94,FMN 12 Statielei
660,Statielei 26,2022-12-13,17:00:00,140,70,70,FMN 12 Statielei
660,Statielei 26,2022-12-13,18:00:00,137,66,71,FMN 12 Statielei
660,Statielei 26,2022-12-13,19:00:00,77,34,43,FMN 12 Statielei
660,Statielei 26,2022-12-13,20:00:00,49,28,21,FMN 12 Statielei
660,Statielei 26,2022-12-13,21:00:00,53,29,24,FMN 12 Statielei
660,Statielei 26,2022-12-13,22:00:00,59,32,27,FMN 12 Statielei
660,Statielei 26,2022-12-13,23:00:00,31,5,26,FMN 12 Statielei
660,Statielei 26,2022-12-14,00:00:00,0,0,0,FMN 12 Statielei
660,Statielei 26,2022-12-14,01:00:00,0,0,0,FMN 12 Statielei
660,Statielei 26,2022-12-14,02:00:00,0,0,0,FMN 12 Statielei
660,Statielei 26,2022-12-14,03:00:00,0,0,0,FMN 12 Statielei
660,Statielei 26,2022-12-14,04:00:00,0,0,0,FMN 12 Statielei
660,Statielei 26,2022-12-14,05:00:00,0,0,0,FMN 12 Statielei
660,Statielei 26,2022-12-14,06:00:00,0,0,0,FMN 12 Statielei
660,Statielei 26,2022-12-14,07:00:00,0,0,0,FMN 12 Statielei
660,Statielei 26,2022-12-14,08:00:00,0,0,0,FMN 12 Statielei
660,Statielei 26,2022-12-14,09:00:00,0,0,0,FMN 12 Statielei
660,Statielei 26,2022-12-14,10:00:00,0,0,0,FMN 12 Statielei
660,Statielei 26,2022-12-14,11:00:00,0,0,0,FMN 12 Statielei
660,Statielei 26,2022-12-14,12:00:00,50,26,24,FMN 12 Statielei
660,Statielei 26,2022-12-14,13:00:00,81,46,35,FMN 12 Statielei
660,Statielei 26,2022-12-14,14:00:00,87,38,49,FMN 12 Statielei
660,Statielei 26,2022-12-14,15:00:00,95,48,47,FMN 12 Statielei
660,Statielei 26,2022-12-14,16:00:00,129,65,64,FMN 12 Statielei
660,Statielei 26,2022-12-14,17:00:00,136,70,66,FMN 12 Statielei
660,Statielei 26,2022-12-14,18:00:00,119,61,58,FMN 12 Statielei
660,Statielei 26,2022-12-14,19:00:00,84,42,42,FMN 12 Statielei
660,Statielei 26,2022-12-14,20:00:00,52,14,38,FMN 12 Statielei
660,Statielei 26,2022-12-14,21:00:00,32,13,19,FMN 12 Statielei
660,Statielei 26,2022-12-14,22:00:00,27,13,14,FMN 12 Statielei
660,Statielei 26,2022-12-14,23:00:00,0,0,0,FMN 12 Statielei
660,Statielei 26,2022-12-15,00:00:00,0,0,0,FMN 12 Statielei
660,Statielei 26,2022-12-15,01:00:00,0,0,0,FMN 12 Statielei
660,Statielei 26,2022-12-15,02:00:00,0,0,0,FMN 12 Statielei
660,Statielei 26,2022-12-15,03:00:00,0,0,0,FMN 12 Statielei
660,Statielei 26,2022-12-15,04:00:00,0,0,0,FMN 12 Statielei
660,Statielei 26,2022-12-15,05:00:00,0,0,0,FMN 12 Statielei
660,Statielei 26,2022-12-15,06:00:00,0,0,0,FMN 12 Statielei
660,Statielei 26,2022-12-15,07:00:00,0,0,0,FMN 12 Statielei
660,Statielei 26,2022-12-15,08:00:00,0,0,0,FMN 12 Statielei
660,Statielei 26,2022-12-15,09:00:00,0,0,0,FMN 12 Statielei
660,Statielei 26,2022-12-15,10:00:00,0,0,0,FMN 12 Statielei
660,Statielei 26,2022-12-15,11:00:00,0,0,0,FMN 12 Statielei
660,Statielei 26,2022-12-15,12:00:00,31,17,14,FMN 12 Statielei
660,Statielei 26,2022-12-15,13:00:00,70,40,30,FMN 12 Statielei
660,Statielei 26,2022-12-15,14:00:00,83,48,35,FMN 12 Statielei
660,Statielei 26,2022-12-15,15:00:00,111,47,64,FMN 12 Statielei
660,Statielei 26,2022-12-15,16:00:00,165,75,90,FMN 12 Statielei
660,Statielei 26,2022-12-15,17:00:00,165,85,80,FMN 12 Statielei
660,Statielei 26,2022-12-15,18:00:00,108,54,54,FMN 12 Statielei
660,Statielei 26,2022-12-15,19:00:00,90,49,41,FMN 12 Statielei
660,Statielei 26,2022-12-15,20:00:00,78,31,47,FMN 12 Statielei
660,Statielei 26,2022-12-15,21:00:00,39,18,21,FMN 12 Statielei
660,Statielei 26,2022-12-15,22:00:00,15,8,7,FMN 12 Statielei
660,Statielei 26,2022-12-15,23:00:00,0,0,0,FMN 12 Statielei
660,Statielei 26,2022-12-16,00:00:00,0,0,0,FMN 12 Statielei
660,Statielei 26,2022-12-16,01:00:00,0,0,0,FMN 12 Statielei
660,Statielei 26,2022-12-16,02:00:00,0,0,0,FMN 12 Statielei
660,Statielei 26,2022-12-16,03:00:00,0,0,0,FMN 12 Statielei
660,Statielei 26,2022-12-16,04:00:00,0,0,0,FMN 12 Statielei
660,Statielei 26,2022-12-16,05:00:00,0,0,0,FMN 12 Statielei
660,Statielei 26,2022-12-16,06:00:00,0,0,0,FMN 12 Statielei
660,Statielei 26,2022-12-16,07:00:00,0,0,0,FMN 12 Statielei
660,Statielei 26,2022-12-16,08:00:00,0,0,0,FMN 12 Statielei
660,Statielei 26,2022-12-16,09:00:00,0,0,0,FMN 12 Statielei
660,Statielei 26,2022-12-16,10:00:00,0,0,0,FMN 12 Statielei
660,Statielei 26,2022-12-16,11:00:00,0,0,0,FMN 12 Statielei
660,Statielei 26,2022-12-16,12:00:00,38,19,19,FMN 12 Statielei
660,Statielei 26,2022-12-16,13:00:00,110,56,54,FMN 12 Statielei
660,Statielei 26,2022-12-16,14:00:00,114,50,64,FMN 12 Statielei
660,Statielei 26,2022-12-16,15:00:00,129,59,70,FMN 12 Statielei
660,Statielei 26,2022-12-16,16:00:00,162,83,79,FMN 12 Statielei
660,Statielei 26,2022-12-16,17:00:00,144,75,69,FMN 12 Statielei
660,Statielei 26,2022-12-16,18:00:00,132,63,69,FMN 12 Statielei
660,Statielei 26,2022-12-16,19:00:00,100,51,49,FMN 12 Statielei
660,Statielei 26,2022-12-16,20:00:00,73,34,39,FMN 12 Statielei
660,Statielei 26,2022-12-16,21:00:00,59,27,32,FMN 12 Statielei
660,Statielei 26,2022-12-16,22:00:00,26,15,11,FMN 12 Statielei
660,Statielei 26,2022-12-16,23:00:00,0,0,0,FMN 12 Statielei
660,Statielei 26,2022-12-17,00:00:00,0,0,0,FMN 12 Statielei
660,Statielei 26,2022-12-17,01:00:00,0,0,0,FMN 12 Statielei
660,Statielei 26,2022-12-17,02:00:00,0,0,0,FMN 12 Statielei
660,Statielei 26,2022-12-17,03:00:00,0,0,0,FMN 12 Statielei
660,Statielei 26,2022-12-17,04:00:00,0,0,0,FMN 12 Statielei
660,Statielei 26,2022-12-17,05:00:00,0,0,0,FMN 12 Statielei
660,Statielei 26,2022-12-17,06:00:00,0,0,0,FMN 12 Statielei
660,Statielei 26,2022-12-17,07:00:00,0,0,0,FMN 12 Statielei
660,Statielei 26,2022-12-17,08:00:00,0,0,0,FMN 12 Statielei
660,Statielei 26,2022-12-17,09:00:00,0,0,0,FMN 12 Statielei
660,Statielei 26,2022-12-17,10:00:00,0,0,0,FMN 12 Statielei
660,Statielei 26,2022-12-17,11:00:00,0,0,0,FMN 12 Statielei
660,Statielei 26,2022-12-17,12:00:00,27,16,11,FMN 12 Statielei
660,Statielei 26,2022-12-17,13:00:00,80,46,34,FMN 12 Statielei
660,Statielei 26,2022-12-17,14:00:00,89,52,37,FMN 12 Statielei
660,Statielei 26,2022-12-17,15:00:00,92,64,28,FMN 12 Statielei
660,Statielei 26,2022-12-17,16:00:00,71,40,31,FMN 12 Statielei
660,Statielei 26,2022-12-17,17:00:00,80,43,37,FMN 12 Statielei
660,Statielei 26,2022-12-17,18:00:00,75,40,35,FMN 12 Statielei
660,Statielei 26,2022-12-17,19:00:00,73,42,31,FMN 12 Statielei
660,Statielei 26,2022-12-17,20:00:00,52,25,27,FMN 12 Statielei
660,Statielei 26,2022-12-17,21:00:00,36,10,26,FMN 12 Statielei
660,Statielei 26,2022-12-17,22:00:00,0,0,0,FMN 12 Statielei
660,Statielei 26,2022-12-17,23:00:00,0,0,0,FMN 12 Statielei
660,Statielei 26,2022-12-18,00:00:00,0,0,0,FMN 12 Statielei
660,Statielei 26,2022-12-18,01:00:00,0,0,0,FMN 12 Statielei
660,Statielei 26,2022-12-18,02:00:00,0,0,0,FMN 12 Statielei
660,Statielei 26,2022-12-18,03:00:00,0,0,0,FMN 12 Statielei
660,Statielei 26,2022-12-18,04:00:00,0,0,0,FMN 12 Statielei
660,Statielei 26,2022-12-18,05:00:00,0,0,0,FMN 12 Statielei
660,Statielei 26,2022-12-18,06:00:00,0,0,0,FMN 12 Statielei
660,Statielei 26,2022-12-18,07:00:00,0,0,0,FMN 12 Statielei
660,Statielei 26,2022-12-18,08:00:00,0,0,0,FMN 12 Statielei
660,Statielei 26,2022-12-18,09:00:00,0,0,0,FMN 12 Statielei
660,Statielei 26,2022-12-18,10:00:00,0,0,0,FMN 12 Statielei
660,Statielei 26,2022-12-18,11:00:00,52,26,26,FMN 12 Statielei
660,Statielei 26,2022-12-18,12:00:00,73,44,29,FMN 12 Statielei
660,Statielei 26,2022-12-18,13:00:00,78,40,38,FMN 12 Statielei
660,Statielei 26,2022-12-18,14:00:00,66,31,35,FMN 12 Statielei
660,Statielei 26,2022-12-18,15:00:00,61,32,29,FMN 12 Statielei
660,Statielei 26,2022-12-18,16:00:00,64,34,30,FMN 12 Statielei
660,Statielei 26,2022-12-18,17:00:00,59,25,34,FMN 12 Statielei
660,Statielei 26,2022-12-18,18:00:00,49,32,17,FMN 12 Statielei
660,Statielei 26,2022-12-18,19:00:00,42,22,20,FMN 12 Statielei
660,Statielei 26,2022-12-18,20:00:00,22,12,10,FMN 12 Statielei
660,Statielei 26,2022-12-18,21:00:00,1,0,1,FMN 12 Statielei
660,Statielei 26,2022-12-18,22:00:00,0,0,0,FMN 12 Statielei
660,Statielei 26,2022-12-18,23:00:00,0,0,0,FMN 12 Statielei
660,Statielei 26,2022-12-19,00:00:00,16,6,10,FMN 12 Statielei
660,Statielei 26,2022-12-19,01:00:00,5,2,3,FMN 12 Statielei
660,Statielei 26,2022-12-19,02:00:00,3,2,1,FMN 12 Statielei
660,Statielei 26,2022-12-19,03:00:00,0,0,0,FMN 12 Statielei
660,Statielei 26,2022-12-19,04:00:00,7,3,4,FMN 12 Statielei
660,Statielei 26,2022-12-19,05:00:00,10,6,4,FMN 12 Statielei
660,Statielei 26,2022-12-19,06:00:00,28,11,17,FMN 12 Statielei
660,Statielei 26,2022-12-19,07:00:00,94,50,44,FMN 12 Statielei
660,Statielei 26,2022-12-19,08:00:00,164,95,69,FMN 12 Statielei
660,Statielei 26,2022-12-19,09:00:00,67,45,22,FMN 12 Statielei
660,Statielei 26,2022-12-19,10:00:00,50,29,21,FMN 12 Statielei
660,Statielei 26,2022-12-19,11:00:00,66,32,34,FMN 12 Statielei
660,Statielei 26,2022-12-19,12:00:00,87,44,43,FMN 12 Statielei
660,Statielei 26,2022-12-19,13:00:00,80,43,37,FMN 12 Statielei
660,Statielei 26,2022-12-19,14:00:00,75,40,35,FMN 12 Statielei
660,Statielei 26,2022-12-19,15:00:00,112,48,64,FMN 12 Statielei
660,Statielei 26,2022-12-19,16:00:00,148,67,81,FMN 12 Statielei
660,Statielei 26,2022-12-19,17:00:00,148,69,79,FMN 12 Statielei
660,Statielei 26,2022-12-19,18:00:00,114,60,54,FMN 12 Statielei
660,Statielei 26,2022-12-19,19:00:00,94,47,47,FMN 12 Statielei
660,Statielei 26,2022-12-19,20:00:00,54,28,26,FMN 12 Statielei
660,Statielei 26,2022-12-19,21:00:00,50,21,29,FMN 12 Statielei
660,Statielei 26,2022-12-19,22:00:00,50,28,22,FMN 12 Statielei
660,Statielei 26,2022-12-19,23:00:00,35,20,15,FMN 12 Statielei
660,Statielei 26,2022-12-20,00:00:00,8,5,3,FMN 12 Statielei
660,Statielei 26,2022-12-20,01:00:00,7,3,4,FMN 12 Statielei
660,Statielei 26,2022-12-20,02:00:00,5,2,3,FMN 12 Statielei
660,Statielei 26,2022-12-20,03:00:00,5,3,2,FMN 12 Statielei
660,Statielei 26,2022-12-20,04:00:00,5,2,3,FMN 12 Statielei
660,Statielei 26,2022-12-20,05:00:00,8,6,2,FMN 12 Statielei
660,Statielei 26,2022-12-20,06:00:00,27,13,14,FMN 12 Statielei
660,Statielei 26,2022-12-20,07:00:00,76,38,38,FMN 12 Statielei
660,Statielei 26,2022-12-20,08:00:00,149,82,67,FMN 12 Statielei
660,Statielei 26,2022-12-20,09:00:00,69,43,26,FMN 12 Statielei
660,Statielei 26,2022-12-20,10:00:00,50,32,18,FMN 12 Statielei
660,Statielei 26,2022-12-20,11:00:00,48,22,26,FMN 12 Statielei
660,Statielei 26,2022-12-20,12:00:00,75,36,39,FMN 12 Statielei
660,Statielei 26,2022-12-20,13:00:00,64,36,28,FMN 12 Statielei
660,Statielei 26,2022-12-20,14:00:00,58,33,25,FMN 12 Statielei
660,Statielei 26,2022-12-20,15:00:00,114,50,64,FMN 12 Statielei
660,Statielei 26,2022-12-20,16:00:00,146,76,70,FMN 12 Statielei
660,Statielei 26,2022-12-20,17:00:00,136,64,72,FMN 12 Statielei
660,Statielei 26,2022-12-20,18:00:00,110,53,57,FMN 12 Statielei
660,Statielei 26,2022-12-20,19:00:00,89,42,47,FMN 12 Statielei
660,Statielei 26,2022-12-20,20:00:00,60,35,25,FMN 12 Statielei
660,Statielei 26,2022-12-20,21:00:00,65,31,34,FMN 12 Statielei
660,Statielei 26,2022-12-20,22:00:00,40,19,21,FMN 12 Statielei
660,Statielei 26,2022-12-20,23:00:00,23,4,19,FMN 12 Statielei
660,Statielei 26,2022-12-21,00:00:00,14,4,10,FMN 12 Statielei
660,Statielei 26,2022-12-21,01:00:00,13,7,6,FMN 12 Statielei
660,Statielei 26,2022-12-21,02:00:00,1,0,1,FMN 12 Statielei
660,Statielei 26,2022-12-21,03:00:00,0,0,0,FMN 12 Statielei
660,Statielei 26,2022-12-21,04:00:00,6,4,2,FMN 12 Statielei
660,Statielei 26,2022-12-21,05:00:00,11,7,4,FMN 12 Statielei
660,Statielei 26,2022-12-21,06:00:00,25,9,16,FMN 12 Statielei
660,Statielei 26,2022-12-21,07:00:00,80,40,40,FMN 12 Statielei
660,Statielei 26,2022-12-21,08:00:00,149,79,70,FMN 12 Statielei
660,Statielei 26,2022-12-21,09:00:00,60,41,19,FMN 12 Statielei
660,Statielei 26,2022-12-21,10:00:00,56,31,25,FMN 12 Statielei
660,Statielei 26,2022-12-21,11:00:00,69,39,30,FMN 12 Statielei
660,Statielei 26,2022-12-21,12:00:00,125,63,62,FMN 12 Statielei
660,Statielei 26,2022-12-21,13:00:00,107,57,50,FMN 12 Statielei
660,Statielei 26,2022-12-21,14:00:00,87,49,38,FMN 12 Statielei
660,Statielei 26,2022-12-21,15:00:00,84,38,46,FMN 12 Statielei
660,Statielei 26,2022-12-21,16:00:00,128,60,68,FMN 12 Statielei
660,Statielei 26,2022-12-21,17:00:00,154,74,80,FMN 12 Statielei
660,Statielei 26,2022-12-21,18:00:00,122,58,64,FMN 12 Statielei
660,Statielei 26,2022-12-21,19:00:00,99,48,51,FMN 12 Statielei
660,Statielei 26,2022-12-21,20:00:00,74,39,35,FMN 12 Statielei
660,Statielei 26,2022-12-21,21:00:00,47,25,22,FMN 12 Statielei
660,Statielei 26,2022-12-21,22:00:00,41,21,20,FMN 12 Statielei
660,Statielei 26,2022-12-21,23:00:00,36,12,24,FMN 12 Statielei
660,Statielei 26,2022-12-22,00:00:00,10,5,5,FMN 12 Statielei
660,Statielei 26,2022-12-22,01:00:00,13,8,5,FMN 12 Statielei
660,Statielei 26,2022-12-22,02:00:00,4,1,3,FMN 12 Statielei
660,Statielei 26,2022-12-22,03:00:00,5,1,4,FMN 12 Statielei
660,Statielei 26,2022-12-22,04:00:00,8,3,5,FMN 12 Statielei
660,Statielei 26,2022-12-22,05:00:00,7,6,1,FMN 12 Statielei
660,Statielei 26,2022-12-22,06:00:00,27,12,15,FMN 12 Statielei
660,Statielei 26,2022-12-22,07:00:00,88,41,47,FMN 12 Statielei
660,Statielei 26,2022-12-22,08:00:00,172,96,76,FMN 12 Statielei
660,Statielei 26,2022-12-22,09:00:00,85,51,34,FMN 12 Statielei
660,Statielei 26,2022-12-22,10:00:00,58,30,28,FMN 12 Statielei
660,Statielei 26,2022-12-22,11:00:00,72,47,25,FMN 12 Statielei
660,Statielei 26,2022-12-22,12:00:00,77,47,30,FMN 12 Statielei
660,Statielei 26,2022-12-22,13:00:00,63,34,29,FMN 12 Statielei
660,Statielei 26,2022-12-22,14:00:00,82,42,40,FMN 12 Statielei
660,Statielei 26,2022-12-22,15:00:00,108,53,55,FMN 12 Statielei
660,Statielei 26,2022-12-22,16:00:00,173,80,93,FMN 12 Statielei
660,Statielei 26,2022-12-22,17:00:00,157,73,84,FMN 12 Statielei
660,Statielei 26,2022-12-22,18:00:00,125,64,61,FMN 12 Statielei
660,Statielei 26,2022-12-22,19:00:00,109,57,52,FMN 12 Statielei
660,Statielei 26,2022-12-22,20:00:00,73,37,36,FMN 12 Statielei
660,Statielei 26,2022-12-22,21:00:00,51,26,25,FMN 12 Statielei
660,Statielei 26,2022-12-22,22:00:00,58,24,34,FMN 12 Statielei
660,Statielei 26,2022-12-22,23:00:00,36,18,18,FMN 12 Statielei
660,Statielei 26,2022-12-23,00:00:00,17,10,7,FMN 12 Statielei
660,Statielei 26,2022-12-23,01:00:00,11,1,10,FMN 12 Statielei
660,Statielei 26,2022-12-23,02:00:00,4,0,4,FMN 12 Statielei
660,Statielei 26,2022-12-23,03:00:00,1,0,1,FMN 12 Statielei
660,Statielei 26,2022-12-23,04:00:00,7,3,4,FMN 12 Statielei
660,Statielei 26,2022-12-23,05:00:00,19,9,10,FMN 12 Statielei
660,Statielei 26,2022-12-23,06:00:00,26,12,14,FMN 12 Statielei
660,Statielei 26,2022-12-23,07:00:00,68,27,41,FMN 12 Statielei
660,Statielei 26,2022-12-23,08:00:00,117,67,50,FMN 12 Statielei
660,Statielei 26,2022-12-23,09:00:00,67,42,25,FMN 12 Statielei
660,Statielei 26,2022-12-23,10:00:00,49,32,17,FMN 12 Statielei
660,Statielei 26,2022-12-23,11:00:00,52,22,30,FMN 12 Statielei
660,Statielei 26,2022-12-23,12:00:00,78,38,40,FMN 12 Statielei
660,Statielei 26,2022-12-23,13:00:00,66,38,28,FMN 12 Statielei
660,Statielei 26,2022-12-23,14:00:00,74,32,42,FMN 12 Statielei
660,Statielei 26,2022-12-23,15:00:00,107,47,60,FMN 12 Statielei
660,Statielei 26,2022-12-23,16:00:00,148,81,67,FMN 12 Statielei
660,Statielei 26,2022-12-23,17:00:00,118,59,59,FMN 12 Statielei
660,Statielei 26,2022-12-23,18:00:00,92,46,46,FMN 12 Statielei
660,Statielei 26,2022-12-23,19:00:00,89,52,37,FMN 12 Statielei
660,Statielei 26,2022-12-23,20:00:00,87,40,47,FMN 12 Statielei
660,Statielei 26,2022-12-23,21:00:00,50,28,22,FMN 12 Statielei
660,Statielei 26,2022-12-23,22:00:00,48,20,28,FMN 12 Statielei
660,Statielei 26,2022-12-23,23:00:00,38,20,18,FMN 12 Statielei
660,Statielei 26,2022-12-24,00:00:00,0,0,0,FMN 12 Statielei
660,Statielei 26,2022-12-24,01:00:00,0,0,0,FMN 12 Statielei
660,Statielei 26,2022-12-24,02:00:00,0,0,0,FMN 12 Statielei
660,Statielei 26,2022-12-24,03:00:00,0,0,0,FMN 12 Statielei
660,Statielei 26,2022-12-24,04:00:00,0,0,0,FMN 12 Statielei
660,Statielei 26,2022-12-24,05:00:00,0,0,0,FMN 12 Statielei
660,Statielei 26,2022-12-24,06:00:00,0,0,0,FMN 12 Statielei
660,Statielei 26,2022-12-24,07:00:00,0,0,0,FMN 12 Statielei
660,Statielei 26,2022-12-24,08:00:00,0,0,0,FMN 12 Statielei
660,Statielei 26,2022-12-24,09:00:00,0,0,0,FMN 12 Statielei
660,Statielei 26,2022-12-24,10:00:00,0,0,0,FMN 12 Statielei
660,Statielei 26,2022-12-24,11:00:00,0,0,0,FMN 12 Statielei
660,Statielei 26,2022-12-24,12:00:00,50,22,28,FMN 12 Statielei
660,Statielei 26,2022-12-24,13:00:00,83,50,33,FMN 12 Statielei
660,Statielei 26,2022-12-24,14:00:00,82,39,43,FMN 12 Statielei
660,Statielei 26,2022-12-24,15:00:00,102,47,55,FMN 12 Statielei
660,Statielei 26,2022-12-24,16:00:00,117,54,63,FMN 12 Statielei
660,Statielei 26,2022-12-24,17:00:00,82,41,41,FMN 12 Statielei
660,Statielei 26,2022-12-24,18:00:00,52,27,25,FMN 12 Statielei
660,Statielei 26,2022-12-24,19:00:00,55,24,31,FMN 12 Statielei
660,Statielei 26,2022-12-24,20:00:00,49,20,29,FMN 12 Statielei
660,Statielei 26,2022-12-24,21:00:00,36,23,13,FMN 12 Statielei
660,Statielei 26,2022-12-24,22:00:00,50,29,21,FMN 12 Statielei
660,Statielei 26,2022-12-24,23:00:00,30,17,13,FMN 12 Statielei
660,Statielei 26,2022-12-25,00:00:00,22,8,14,FMN 12 Statielei
660,Statielei 26,2022-12-25,01:00:00,19,13,6,FMN 12 Statielei
660,Statielei 26,2022-12-25,02:00:00,4,2,2,FMN 12 Statielei
660,Statielei 26,2022-12-25,03:00:00,5,4,1,FMN 12 Statielei
660,Statielei 26,2022-12-25,04:00:00,6,4,2,FMN 12 Statielei
660,Statielei 26,2022-12-25,05:00:00,6,3,3,FMN 12 Statielei
660,Statielei 26,2022-12-25,06:00:00,7,4,3,FMN 12 Statielei
660,Statielei 26,2022-12-25,07:00:00,6,1,5,FMN 12 Statielei
660,Statielei 26,2022-12-25,08:00:00,2,1,1,FMN 12 Statielei
660,Statielei 26,2022-12-25,09:00:00,7,5,2,FMN 12 Statielei
660,Statielei 26,2022-12-25,10:00:00,21,10,11,FMN 12 Statielei
660,Statielei 26,2022-12-25,11:00:00,26,12,14,FMN 12 Statielei
660,Statielei 26,2022-12-25,12:00:00,27,17,10,FMN 12 Statielei
660,Statielei 26,2022-12-25,13:00:00,30,14,16,FMN 12 Statielei
660,Statielei 26,2022-12-25,14:00:00,32,16,16,FMN 12 Statielei
660,Statielei 26,2022-12-25,15:00:00,34,18,16,FMN 12 Statielei
660,Statielei 26,2022-12-25,16:00:00,39,22,17,FMN 12 Statielei
660,Statielei 26,2022-12-25,17:00:00,21,8,13,FMN 12 Statielei
660,Statielei 26,2022-12-25,18:00:00,31,13,18,FMN 12 Statielei
660,Statielei 26,2022-12-25,19:00:00,45,28,17,FMN 12 Statielei
660,Statielei 26,2022-12-25,20:00:00,32,17,15,FMN 12 Statielei
660,Statielei 26,2022-12-25,21:00:00,20,6,14,FMN 12 Statielei
660,Statielei 26,2022-12-25,22:00:00,29,15,14,FMN 12 Statielei
660,Statielei 26,2022-12-25,23:00:00,24,9,15,FMN 12 Statielei
660,Statielei 26,2022-12-26,00:00:00,5,0,5,FMN 12 Statielei
660,Statielei 26,2022-12-26,01:00:00,4,1,3,FMN 12 Statielei
660,Statielei 26,2022-12-26,02:00:00,4,1,3,FMN 12 Statielei
660,Statielei 26,2022-12-26,03:00:00,1,1,0,FMN 12 Statielei
660,Statielei 26,2022-12-26,04:00:00,3,1,2,FMN 12 Statielei
660,Statielei 26,2022-12-26,05:00:00,2,2,0,FMN 12 Statielei
660,Statielei 26,2022-12-26,06:00:00,7,1,6,FMN 12 Statielei
660,Statielei 26,2022-12-26,07:00:00,40,19,21,FMN 12 Statielei
660,Statielei 26,2022-12-26,08:00:00,69,34,35,FMN 12 Statielei
660,Statielei 26,2022-12-26,09:00:00,36,23,13,FMN 12 Statielei
660,Statielei 26,2022-12-26,10:00:00,28,16,12,FMN 12 Statielei
660,Statielei 26,2022-12-26,11:00:00,32,17,15,FMN 12 Statielei
660,Statielei 26,2022-12-26,12:00:00,40,20,20,FMN 12 Statielei
660,Statielei 26,2022-12-26,13:00:00,37,17,20,FMN 12 Statielei
660,Statielei 26,2022-12-26,14:00:00,39,23,16,FMN 12 Statielei
660,Statielei 26,2022-12-26,15:00:00,48,22,26,FMN 12 Statielei
660,Statielei 26,2022-12-26,16:00:00,86,42,44,FMN 12 Statielei
660,Statielei 26,2022-12-26,17:00:00,77,36,41,FMN 12 Statielei
660,Statielei 26,2022-12-26,18:00:00,54,26,28,FMN 12 Statielei
660,Statielei 26,2022-12-26,19:00:00,45,26,19,FMN 12 Statielei
660,Statielei 26,2022-12-26,20:00:00,33,18,15,FMN 12 Statielei
660,Statielei 26,2022-12-26,21:00:00,23,14,9,FMN 12 Statielei
660,Statielei 26,2022-12-26,22:00:00,23,14,9,FMN 12 Statielei
660,Statielei 26,2022-12-26,23:00:00,7,2,5,FMN 12 Statielei
660,Statielei 26,2022-12-27,00:00:00,5,1,4,FMN 12 Statielei
660,Statielei 26,2022-12-27,01:00:00,5,2,3,FMN 12 Statielei
660,Statielei 26,2022-12-27,02:00:00,0,0,0,FMN 12 Statielei
660,Statielei 26,2022-12-27,03:00:00,2,0,2,FMN 12 Statielei
660,Statielei 26,2022-12-27,04:00:00,5,1,4,FMN 12 Statielei
660,Statielei 26,2022-12-27,05:00:00,6,4,2,FMN 12 Statielei
660,Statielei 26,2022-12-27,06:00:00,13,3,10,FMN 12 Statielei
660,Statielei 26,2022-12-27,07:00:00,53,26,27,FMN 12 Statielei
660,Statielei 26,2022-12-27,08:00:00,105,58,47,FMN 12 Statielei
660,Statielei 26,2022-12-27,09:00:00,42,25,17,FMN 12 Statielei
660,Statielei 26,2022-12-27,10:00:00,36,16,20,FMN 12 Statielei
660,Statielei 26,2022-12-27,11:00:00,43,21,22,FMN 12 Statielei
660,Statielei 26,2022-12-27,12:00:00,44,26,18,FMN 12 Statielei
660,Statielei 26,2022-12-27,13:00:00,48,23,25,FMN 12 Statielei
660,Statielei 26,2022-12-27,14:00:00,61,32,29,FMN 12 Statielei
660,Statielei 26,2022-12-27,15:00:00,84,42,42,FMN 12 Statielei
660,Statielei 26,2022-12-27,16:00:00,113,54,59,FMN 12 Statielei
660,Statielei 26,2022-12-27,17:00:00,111,43,68,FMN 12 Statielei
660,Statielei 26,2022-12-27,18:00:00,86,41,45,FMN 12 Statielei
660,Statielei 26,2022-12-27,19:00:00,63,39,24,FMN 12 Statielei
660,Statielei 26,2022-12-27,20:00:00,51,21,30,FMN 12 Statielei
660,Statielei 26,2022-12-27,21:00:00,32,20,12,FMN 12 Statielei
660,Statielei 26,2022-12-27,22:00:00,42,18,24,FMN 12 Statielei
660,Statielei 26,2022-12-27,23:00:00,11,4,7,FMN 12 Statielei
660,Statielei 26,2022-12-28,00:00:00,7,3,4,FMN 12 Statielei
660,Statielei 26,2022-12-28,01:00:00,5,0,5,FMN 12 Statielei
660,Statielei 26,2022-12-28,02:00:00,5,2,3,FMN 12 Statielei
660,Statielei 26,2022-12-28,03:00:00,3,1,2,FMN 12 Statielei
660,Statielei 26,2022-12-28,04:00:00,3,0,3,FMN 12 Statielei
660,Statielei 26,2022-12-28,05:00:00,8,6,2,FMN 12 Statielei
660,Statielei 26,2022-12-28,06:00:00,15,6,9,FMN 12 Statielei
660,Statielei 26,2022-12-28,07:00:00,41,21,20,FMN 12 Statielei
660,Statielei 26,2022-12-28,08:00:00,82,45,37,FMN 12 Statielei
660,Statielei 26,2022-12-28,09:00:00,26,14,12,FMN 12 Statielei
660,Statielei 26,2022-12-28,10:00:00,33,21,12,FMN 12 Statielei
660,Statielei 26,2022-12-28,11:00:00,33,21,12,FMN 12 Statielei
660,Statielei 26,2022-12-28,12:00:00,88,42,46,FMN 12 Statielei
660,Statielei 26,2022-12-28,13:00:00,40,22,18,FMN 12 Statielei
660,Statielei 26,2022-12-28,14:00:00,45,19,26,FMN 12 Statielei
660,Statielei 26,2022-12-28,15:00:00,49,22,27,FMN 12 Statielei
660,Statielei 26,2022-12-28,16:00:00,75,41,34,FMN 12 Statielei
660,Statielei 26,2022-12-28,17:00:00,70,36,34,FMN 12 Statielei
660,Statielei 26,2022-12-28,18:00:00,64,34,30,FMN 12 Statielei
660,Statielei 26,2022-12-28,19:00:00,58,22,36,FMN 12 Statielei
660,Statielei 26,2022-12-28,20:00:00,32,17,15,FMN 12 Statielei
660,Statielei 26,2022-12-28,21:00:00,25,13,12,FMN 12 Statielei
660,Statielei 26,2022-12-28,22:00:00,22,14,8,FMN 12 Statielei
660,Statielei 26,2022-12-28,23:00:00,13,5,8,FMN 12 Statielei
660,Statielei 26,2022-12-29,00:00:00,9,3,6,FMN 12 Statielei
660,Statielei 26,2022-12-29,01:00:00,4,1,3,FMN 12 Statielei
660,Statielei 26,2022-12-29,02:00:00,1,1,0,FMN 12 Statielei
660,Statielei 26,2022-12-29,03:00:00,3,1,2,FMN 12 Statielei
660,Statielei 26,2022-12-29,04:00:00,2,1,1,FMN 12 Statielei
660,Statielei 26,2022-12-29,05:00:00,5,5,0,FMN 12 Statielei
660,Statielei 26,2022-12-29,06:00:00,11,3,8,FMN 12 Statielei
660,Statielei 26,2022-12-29,07:00:00,48,22,26,FMN 12 Statielei
660,Statielei 26,2022-12-29,08:00:00,93,50,43,FMN 12 Statielei
660,Statielei 26,2022-12-29,09:00:00,39,23,16,FMN 12 Statielei
660,Statielei 26,2022-12-29,10:00:00,36,17,19,FMN 12 Statielei
660,Statielei 26,2022-12-29,11:00:00,38,21,17,FMN 12 Statielei
660,Statielei 26,2022-12-29,12:00:00,54,29,25,FMN 12 Statielei
660,Statielei 26,2022-12-29,13:00:00,47,21,26,FMN 12 Statielei
660,Statielei 26,2022-12-29,14:00:00,49,25,24,FMN 12 Statielei
660,Statielei 26,2022-12-29,15:00:00,64,30,34,FMN 12 Statielei
660,Statielei 26,2022-12-29,16:00:00,88,48,40,FMN 12 Statielei
660,Statielei 26,2022-12-29,17:00:00,102,54,48,FMN 12 Statielei
660,Statielei 26,2022-12-29,18:00:00,70,38,32,FMN 12 Statielei
660,Statielei 26,2022-12-29,19:00:00,58,31,27,FMN 12 Statielei
660,Statielei 26,2022-12-29,20:00:00,38,15,23,FMN 12 Statielei
660,Statielei 26,2022-12-29,21:00:00,35,16,19,FMN 12 Statielei
660,Statielei 26,2022-12-29,22:00:00,30,14,16,FMN 12 Statielei
660,Statielei 26,2022-12-29,23:00:00,18,7,11,FMN 12 Statielei
660,Statielei 26,2022-12-30,00:00:00,11,3,8,FMN 12 Statielei
660,Statielei 26,2022-12-30,01:00:00,5,3,2,FMN 12 Statielei
660,Statielei 26,2022-12-30,02:00:00,4,0,4,FMN 12 Statielei
660,Statielei 26,2022-12-30,03:00:00,1,1,0,FMN 12 Statielei
660,Statielei 26,2022-12-30,04:00:00,3,2,1,FMN 12 Statielei
660,Statielei 26,2022-12-30,05:00:00,6,2,4,FMN 12 Statielei
660,Statielei 26,2022-12-30,06:00:00,18,7,11,FMN 12 Statielei
660,Statielei 26,2022-12-30,07:00:00,36,17,19,FMN 12 Statielei
660,Statielei 26,2022-12-30,08:00:00,69,38,31,FMN 12 Statielei
660,Statielei 26,2022-12-30,09:00:00,36,25,11,FMN 12 Statielei
660,Statielei 26,2022-12-30,10:00:00,33,22,11,FMN 12 Statielei
660,Statielei 26,2022-12-30,11:00:00,37,20,17,FMN 12 Statielei
660,Statielei 26,2022-12-30,12:00:00,51,23,28,FMN 12 Statielei
660,Statielei 26,2022-12-30,13:00:00,31,17,14,FMN 12 Statielei
660,Statielei 26,2022-12-30,14:00:00,46,17,29,FMN 12 Statielei
660,Statielei 26,2022-12-30,15:00:00,61,27,34,FMN 12 Statielei
660,Statielei 26,2022-12-30,16:00:00,65,32,33,FMN 12 Statielei
660,Statielei 26,2022-12-30,17:00:00,76,38,38,FMN 12 Statielei
660,Statielei 26,2022-12-30,18:00:00,59,28,31,FMN 12 Statielei
660,Statielei 26,2022-12-30,19:00:00,47,23,24,FMN 12 Statielei
660,Statielei 26,2022-12-30,20:00:00,33,22,11,FMN 12 Statielei
660,Statielei 26,2022-12-30,21:00:00,23,8,15,FMN 12 Statielei
660,Statielei 26,2022-12-30,22:00:00,22,11,11,FMN 12 Statielei
660,Statielei 26,2022-12-30,23:00:00,31,15,16,FMN 12 Statielei
660,Statielei 26,2022-12-31,00:00:00,19,5,14,FMN 12 Statielei
660,Statielei 26,2022-12-31,01:00:00,15,7,8,FMN 12 Statielei
660,Statielei 26,2022-12-31,02:00:00,6,3,3,FMN 12 Statielei
660,Statielei 26,2022-12-31,03:00:00,5,2,3,FMN 12 Statielei
660,Statielei 26,2022-12-31,04:00:00,3,1,2,FMN 12 Statielei
660,Statielei 26,2022-12-31,05:00:00,3,3,0,FMN 12 Statielei
660,Statielei 26,2022-12-31,06:00:00,6,3,3,FMN 12 Statielei
660,Statielei 26,2022-12-31,07:00:00,8,3,5,FMN 12 Statielei
660,Statielei 26,2022-12-31,08:00:00,22,11,11,FMN 12 Statielei
660,Statielei 26,2022-12-31,09:00:00,40,23,17,FMN 12 Statielei
660,Statielei 26,2022-12-31,10:00:00,42,16,26,FMN 12 Statielei
660,Statielei 26,2022-12-31,11:00:00,50,23,27,FMN 12 Statielei
660,Statielei 26,2022-12-31,12:00:00,52,27,25,FMN 12 Statielei
660,Statielei 26,2022-12-31,13:00:00,58,23,35,FMN 12 Statielei
660,Statielei 26,2022-12-31,14:00:00,65,34,31,FMN 12 Statielei
660,Statielei 26,2022-12-31,15:00:00,76,40,36,FMN 12 Statielei
660,Statielei 26,2022-12-31,16:00:00,56,27,29,FMN 12 Statielei
660,Statielei 26,2022-12-31,17:00:00,67,40,27,FMN 12 Statielei
660,Statielei 26,2022-12-31,18:00:00,60,26,34,FMN 12 Statielei
660,Statielei 26,2022-12-31,19:00:00,47,25,22,FMN 12 Statielei
660,Statielei 26,2022-12-31,20:00:00,45,27,18,FMN 12 Statielei
660,Statielei 26,2022-12-31,21:00:00,32,18,14,FMN 12 Statielei
660,Statielei 26,2022-12-31,22:00:00,25,12,13,FMN 12 Statielei
660,Statielei 26,2022-12-31,23:00:00,35,14,21,FMN 12 Statielei
660,Statielei 26,2023-01-04,00:00:00,15,4,11,FMN 12 Statielei
660,Statielei 26,2023-01-04,01:00:00,9,3,6,FMN 12 Statielei
660,Statielei 26,2023-01-04,02:00:00,5,2,3,FMN 12 Statielei
660,Statielei 26,2023-01-04,03:00:00,4,3,1,FMN 12 Statielei
660,Statielei 26,2023-01-04,04:00:00,3,1,2,FMN 12 Statielei
660,Statielei 26,2023-01-04,05:00:00,13,5,8,FMN 12 Statielei
660,Statielei 26,2023-01-04,06:00:00,13,6,7,FMN 12 Statielei
660,Statielei 26,2023-01-04,07:00:00,36,15,21,FMN 12 Statielei
660,Statielei 26,2023-01-04,08:00:00,65,32,33,FMN 12 Statielei
660,Statielei 26,2023-01-04,09:00:00,49,35,14,FMN 12 Statielei
660,Statielei 26,2023-01-04,10:00:00,30,14,16,FMN 12 Statielei
660,Statielei 26,2023-01-04,11:00:00,40,23,17,FMN 12 Statielei
660,Statielei 26,2023-01-04,12:00:00,54,21,33,FMN 12 Statielei
660,Statielei 26,2023-01-04,13:00:00,63,35,28,FMN 12 Statielei
660,Statielei 26,2023-01-04,14:00:00,73,40,33,FMN 12 Statielei
660,Statielei 26,2023-01-04,15:00:00,52,32,20,FMN 12 Statielei
660,Statielei 26,2023-01-04,16:00:00,112,55,57,FMN 12 Statielei
660,Statielei 26,2023-01-04,17:00:00,111,56,55,FMN 12 Statielei
660,Statielei 26,2023-01-04,18:00:00,101,44,57,FMN 12 Statielei
660,Statielei 26,2023-01-04,19:00:00,96,58,38,FMN 12 Statielei
660,Statielei 26,2023-01-04,20:00:00,55,24,31,FMN 12 Statielei
660,Statielei 26,2023-01-04,21:00:00,49,22,27,FMN 12 Statielei
660,Statielei 26,2023-01-04,22:00:00,45,19,26,FMN 12 Statielei
660,Statielei 26,2023-01-04,23:00:00,29,11,18,FMN 12 Statielei
660,Statielei 26,2023-01-05,00:00:00,21,6,15,FMN 12 Statielei
660,Statielei 26,2023-01-05,01:00:00,15,6,9,FMN 12 Statielei
660,Statielei 26,2023-01-05,02:00:00,10,5,5,FMN 12 Statielei
660,Statielei 26,2023-01-05,03:00:00,3,1,2,FMN 12 Statielei
660,Statielei 26,2023-01-05,04:00:00,7,5,2,FMN 12 Statielei
660,Statielei 26,2023-01-05,05:00:00,8,3,5,FMN 12 Statielei
660,Statielei 26,2023-01-05,06:00:00,14,4,10,FMN 12 Statielei
660,Statielei 26,2023-01-05,07:00:00,43,21,22,FMN 12 Statielei
660,Statielei 26,2023-01-05,08:00:00,84,45,39,FMN 12 Statielei
660,Statielei 26,2023-01-05,09:00:00,76,51,25,FMN 12 Statielei
660,Statielei 26,2023-01-05,10:00:00,74,41,33,FMN 12 Statielei
660,Statielei 26,2023-01-05,11:00:00,75,38,37,FMN 12 Statielei
660,Statielei 26,2023-01-05,12:00:00,89,47,42,FMN 12 Statielei
660,Statielei 26,2023-01-05,13:00:00,86,44,42,FMN 12 Statielei
660,Statielei 26,2023-01-05,14:00:00,73,36,37,FMN 12 Statielei
660,Statielei 26,2023-01-05,15:00:00,101,56,45,FMN 12 Statielei
660,Statielei 26,2023-01-05,16:00:00,104,60,44,FMN 12 Statielei
660,Statielei 26,2023-01-05,17:00:00,142,70,72,FMN 12 Statielei
660,Statielei 26,2023-01-05,18:00:00,94,46,48,FMN 12 Statielei
660,Statielei 26,2023-01-05,19:00:00,87,45,42,FMN 12 Statielei
660,Statielei 26,2023-01-05,20:00:00,86,50,36,FMN 12 Statielei
660,Statielei 26,2023-01-05,21:00:00,35,17,18,FMN 12 Statielei
660,Statielei 26,2023-01-05,22:00:00,42,19,23,FMN 12 Statielei
660,Statielei 26,2023-01-05,23:00:00,38,14,24,FMN 12 Statielei
660,Statielei 26,2023-01-06,00:00:00,21,5,16,FMN 12 Statielei
660,Statielei 26,2023-01-06,01:00:00,12,2,10,FMN 12 Statielei
660,Statielei 26,2023-01-06,02:00:00,7,2,5,FMN 12 Statielei
660,Statielei 26,2023-01-06,03:00:00,6,2,4,FMN 12 Statielei
660,Statielei 26,2023-01-06,04:00:00,7,5,2,FMN 12 Statielei
660,Statielei 26,2023-01-06,05:00:00,2,0,2,FMN 12 Statielei
660,Statielei 26,2023-01-06,06:00:00,0,0,0,FMN 12 Statielei
660,Statielei 26,2023-01-06,07:00:00,0,0,0,FMN 12 Statielei
660,Statielei 26,2023-01-06,08:00:00,0,0,0,FMN 12 Statielei
660,Statielei 26,2023-01-06,09:00:00,0,0,0,FMN 12 Statielei
660,Statielei 26,2023-01-06,10:00:00,0,0,0,FMN 12 Statielei
660,Statielei 26,2023-01-06,11:00:00,0,0,0,FMN 12 Statielei
660,Statielei 26,2023-01-06,12:00:00,50,29,21,FMN 12 Statielei
660,Statielei 26,2023-01-06,13:00:00,86,37,49,FMN 12 Statielei
660,Statielei 26,2023-01-06,14:00:00,91,53,38,FMN 12 Statielei
660,Statielei 26,2023-01-06,15:00:00,92,62,30,FMN 12 Statielei
660,Statielei 26,2023-01-06,16:00:00,108,55,53,FMN 12 Statielei
660,Statielei 26,2023-01-06,17:00:00,98,62,36,FMN 12 Statielei
660,Statielei 26,2023-01-06,18:00:00,101,52,49,FMN 12 Statielei
660,Statielei 26,2023-01-06,19:00:00,81,49,32,FMN 12 Statielei
660,Statielei 26,2023-01-06,20:00:00,62,37,25,FMN 12 Statielei
660,Statielei 26,2023-01-06,21:00:00,55,27,28,FMN 12 Statielei
660,Statielei 26,2023-01-06,22:00:00,63,31,32,FMN 12 Statielei
660,Statielei 26,2023-01-06,23:00:00,45,12,33,FMN 12 Statielei
660,Statielei 26,2023-01-07,00:00:00,0,0,0,FMN 12 Statielei
660,Statielei 26,2023-01-07,01:00:00,0,0,0,FMN 12 Statielei
660,Statielei 26,2023-01-07,02:00:00,0,0,0,FMN 12 Statielei
660,Statielei 26,2023-01-07,03:00:00,0,0,0,FMN 12 Statielei
660,Statielei 26,2023-01-07,04:00:00,0,0,0,FMN 12 Statielei
660,Statielei 26,2023-01-07,05:00:00,0,0,0,FMN 12 Statielei
660,Statielei 26,2023-01-07,06:00:00,0,0,0,FMN 12 Statielei
660,Statielei 26,2023-01-07,07:00:00,0,0,0,FMN 12 Statielei
660,Statielei 26,2023-01-07,08:00:00,0,0,0,FMN 12 Statielei
660,Statielei 26,2023-01-07,09:00:00,0,0,0,FMN 12 Statielei
660,Statielei 26,2023-01-07,10:00:00,0,0,0,FMN 12 Statielei
660,Statielei 26,2023-01-07,11:00:00,0,0,0,FMN 12 Statielei
660,Statielei 26,2023-01-07,12:00:00,35,24,11,FMN 12 Statielei
660,Statielei 26,2023-01-07,13:00:00,84,51,33,FMN 12 Statielei
660,Statielei 26,2023-01-07,14:00:00,105,34,71,FMN 12 Statielei
660,Statielei 26,2023-01-07,15:00:00,99,49,50,FMN 12 Statielei
660,Statielei 26,2023-01-07,16:00:00,94,50,44,FMN 12 Statielei
660,Statielei 26,2023-01-07,17:00:00,87,41,46,FMN 12 Statielei
660,Statielei 26,2023-01-07,18:00:00,93,56,37,FMN 12 Statielei
660,Statielei 26,2023-01-07,19:00:00,109,58,51,FMN 12 Statielei
660,Statielei 26,2023-01-07,20:00:00,49,21,28,FMN 12 Statielei
660,Statielei 26,2023-01-07,21:00:00,49,23,26,FMN 12 Statielei
660,Statielei 26,2023-01-07,22:00:00,45,21,24,FMN 12 Statielei
660,Statielei 26,2023-01-07,23:00:00,77,52,25,FMN 12 Statielei
660,Statielei 26,2023-01-08,00:00:00,33,16,17,FMN 12 Statielei
660,Statielei 26,2023-01-08,01:00:00,18,7,11,FMN 12 Statielei
660,Statielei 26,2023-01-08,02:00:00,16,6,10,FMN 12 Statielei
660,Statielei 26,2023-01-08,03:00:00,1,0,1,FMN 12 Statielei
660,Statielei 26,2023-01-08,04:00:00,0,0,0,FMN 12 Statielei
660,Statielei 26,2023-01-08,05:00:00,0,0,0,FMN 12 Statielei
660,Statielei 26,2023-01-08,06:00:00,0,0,0,FMN 12 Statielei
660,Statielei 26,2023-01-08,07:00:00,0,0,0,FMN 12 Statielei
660,Statielei 26,2023-01-08,08:00:00,0,0,0,FMN 12 Statielei
660,Statielei 26,2023-01-08,09:00:00,0,0,0,FMN 12 Statielei
660,Statielei 26,2023-01-08,10:00:00,0,0,0,FMN 12 Statielei
660,Statielei 26,2023-01-08,11:00:00,0,0,0,FMN 12 Statielei
660,Statielei 26,2023-01-08,12:00:00,45,18,27,FMN 12 Statielei
660,Statielei 26,2023-01-08,13:00:00,79,46,33,FMN 12 Statielei
660,Statielei 26,2023-01-08,14:00:00,102,44,58,FMN 12 Statielei
660,Statielei 26,2023-01-08,15:00:00,94,45,49,FMN 12 Statielei
660,Statielei 26,2023-01-08,16:00:00,103,53,50,FMN 12 Statielei
660,Statielei 26,2023-01-08,17:00:00,98,62,36,FMN 12 Statielei
660,Statielei 26,2023-01-08,18:00:00,85,50,35,FMN 12 Statielei
660,Statielei 26,2023-01-08,19:00:00,59,32,27,FMN 12 Statielei
660,Statielei 26,2023-01-08,20:00:00,38,22,16,FMN 12 Statielei
660,Statielei 26,2023-01-08,21:00:00,43,22,21,FMN 12 Statielei
660,Statielei 26,2023-01-08,22:00:00,24,7,17,FMN 12 Statielei
660,Statielei 26,2023-01-08,23:00:00,22,6,16,FMN 12 Statielei
660,Statielei 26,2023-01-09,00:00:00,7,4,3,FMN 12 Statielei
660,Statielei 26,2023-01-09,01:00:00,1,1,0,FMN 12 Statielei
660,Statielei 26,2023-01-09,02:00:00,0,0,0,FMN 12 Statielei
660,Statielei 26,2023-01-09,03:00:00,0,0,0,FMN 12 Statielei
660,Statielei 26,2023-01-09,04:00:00,0,0,0,FMN 12 Statielei
660,Statielei 26,2023-01-09,05:00:00,0,0,0,FMN 12 Statielei
660,Statielei 26,2023-01-09,06:00:00,0,0,0,FMN 12 Statielei
660,Statielei 26,2023-01-09,07:00:00,0,0,0,FMN 12 Statielei
660,Statielei 26,2023-01-09,08:00:00,0,0,0,FMN 12 Statielei
660,Statielei 26,2023-01-09,09:00:00,0,0,0,FMN 12 Statielei
660,Statielei 26,2023-01-09,10:00:00,0,0,0,FMN 12 Statielei
660,Statielei 26,2023-01-09,11:00:00,0,0,0,FMN 12 Statielei
660,Statielei 26,2023-01-09,12:00:00,27,11,16,FMN 12 Statielei
660,Statielei 26,2023-01-09,13:00:00,80,40,40,FMN 12 Statielei
660,Statielei 26,2023-01-09,14:00:00,76,41,35,FMN 12 Statielei
660,Statielei 26,2023-01-09,15:00:00,130,48,82,FMN 12 Statielei
660,Statielei 26,2023-01-09,16:00:00,191,103,88,FMN 12 Statielei
660,Statielei 26,2023-01-09,17:00:00,174,77,97,FMN 12 Statielei
660,Statielei 26,2023-01-09,18:00:00,87,41,46,FMN 12 Statielei
660,Statielei 26,2023-01-09,19:00:00,86,47,39,FMN 12 Statielei
660,Statielei 26,2023-01-09,20:00:00,56,27,29,FMN 12 Statielei
660,Statielei 26,2023-01-09,21:00:00,18,8,10,FMN 12 Statielei
660,Statielei 26,2023-01-09,22:00:00,0,0,0,FMN 12 Statielei
660,Statielei 26,2023-01-09,23:00:00,0,0,0,FMN 12 Statielei
660,Statielei 26,2023-01-11,00:00:00,19,5,14,FMN 12 Statielei
660,Statielei 26,2023-01-11,01:00:00,11,8,3,FMN 12 Statielei
660,Statielei 26,2023-01-11,02:00:00,4,1,3,FMN 12 Statielei
660,Statielei 26,2023-01-11,03:00:00,5,0,5,FMN 12 Statielei
660,Statielei 26,2023-01-11,04:00:00,6,3,3,FMN 12 Statielei
660,Statielei 26,2023-01-11,05:00:00,12,7,5,FMN 12 Statielei
660,Statielei 26,2023-01-11,06:00:00,36,16,20,FMN 12 Statielei
660,Statielei 26,2023-01-11,07:00:00,90,49,41,FMN 12 Statielei
660,Statielei 26,2023-01-11,08:00:00,177,98,79,FMN 12 Statielei
660,Statielei 26,2023-01-11,09:00:00,86,59,27,FMN 12 Statielei
660,Statielei 26,2023-01-11,10:00:00,53,33,20,FMN 12 Statielei
660,Statielei 26,2023-01-11,11:00:00,84,47,37,FMN 12 Statielei
660,Statielei 26,2023-01-11,12:00:00,156,89,67,FMN 12 Statielei
660,Statielei 26,2023-01-11,13:00:00,120,58,62,FMN 12 Statielei
660,Statielei 26,2023-01-11,14:00:00,102,49,53,FMN 12 Statielei
660,Statielei 26,2023-01-11,15:00:00,120,50,70,FMN 12 Statielei
660,Statielei 26,2023-01-11,16:00:00,159,79,80,FMN 12 Statielei
660,Statielei 26,2023-01-11,17:00:00,187,98,89,FMN 12 Statielei
660,Statielei 26,2023-01-11,18:00:00,158,75,83,FMN 12 Statielei
660,Statielei 26,2023-01-11,19:00:00,109,63,46,FMN 12 Statielei
660,Statielei 26,2023-01-11,20:00:00,88,48,40,FMN 12 Statielei
660,Statielei 26,2023-01-11,21:00:00,60,34,26,FMN 12 Statielei
660,Statielei 26,2023-01-11,22:00:00,48,26,22,FMN 12 Statielei
660,Statielei 26,2023-01-11,23:00:00,38,14,24,FMN 12 Statielei
660,Statielei 26,2023-01-12,00:00:00,17,8,9,FMN 12 Statielei
660,Statielei 26,2023-01-12,01:00:00,8,1,7,FMN 12 Statielei
660,Statielei 26,2023-01-12,02:00:00,5,2,3,FMN 12 Statielei
660,Statielei 26,2023-01-12,03:00:00,1,0,1,FMN 12 Statielei
660,Statielei 26,2023-01-12,04:00:00,3,1,2,FMN 12 Statielei
660,Statielei 26,2023-01-12,05:00:00,11,8,3,FMN 12 Statielei
660,Statielei 26,2023-01-12,06:00:00,20,6,14,FMN 12 Statielei
660,Statielei 26,2023-01-12,07:00:00,55,21,34,FMN 12 Statielei
660,Statielei 26,2023-01-12,08:00:00,134,70,64,FMN 12 Statielei
660,Statielei 26,2023-01-12,09:00:00,53,29,24,FMN 12 Statielei
660,Statielei 26,2023-01-12,10:00:00,41,29,12,FMN 12 Statielei
660,Statielei 26,2023-01-12,11:00:00,38,22,16,FMN 12 Statielei
660,Statielei 26,2023-01-12,12:00:00,67,41,26,FMN 12 Statielei
660,Statielei 26,2023-01-12,13:00:00,48,28,20,FMN 12 Statielei
660,Statielei 26,2023-01-12,14:00:00,55,26,29,FMN 12 Statielei
660,Statielei 26,2023-01-12,15:00:00,96,43,53,FMN 12 Statielei
660,Statielei 26,2023-01-12,16:00:00,116,60,56,FMN 12 Statielei
660,Statielei 26,2023-01-12,17:00:00,123,56,67,FMN 12 Statielei
660,Statielei 26,2023-01-12,18:00:00,119,55,64,FMN 12 Statielei
660,Statielei 26,2023-01-12,19:00:00,83,44,39,FMN 12 Statielei
660,Statielei 26,2023-01-12,20:00:00,48,21,27,FMN 12 Statielei
660,Statielei 26,2023-01-12,21:00:00,42,18,24,FMN 12 Statielei
660,Statielei 26,2023-01-12,22:00:00,38,20,18,FMN 12 Statielei
660,Statielei 26,2023-01-12,23:00:00,31,10,21,FMN 12 Statielei
660,Statielei 26,2023-01-13,00:00:00,22,13,9,FMN 12 Statielei
660,Statielei 26,2023-01-13,01:00:00,17,4,13,FMN 12 Statielei
660,Statielei 26,2023-01-13,02:00:00,6,4,2,FMN 12 Statielei
660,Statielei 26,2023-01-13,03:00:00,3,1,2,FMN 12 Statielei
660,Statielei 26,2023-01-13,04:00:00,6,3,3,FMN 12 Statielei
660,Statielei 26,2023-01-13,05:00:00,12,7,5,FMN 12 Statielei
660,Statielei 26,2023-01-13,06:00:00,37,17,20,FMN 12 Statielei
660,Statielei 26,2023-01-13,07:00:00,86,43,43,FMN 12 Statielei
660,Statielei 26,2023-01-13,08:00:00,168,83,85,FMN 12 Statielei
660,Statielei 26,2023-01-13,09:00:00,76,50,26,FMN 12 Statielei
660,Statielei 26,2023-01-13,10:00:00,63,38,25,FMN 12 Statielei
660,Statielei 26,2023-01-13,11:00:00,77,38,39,FMN 12 Statielei
660,Statielei 26,2023-01-13,12:00:00,99,48,51,FMN 12 Statielei
660,Statielei 26,2023-01-13,13:00:00,83,44,39,FMN 12 Statielei
660,Statielei 26,2023-01-13,14:00:00,103,54,49,FMN 12 Statielei
660,Statielei 26,2023-01-13,15:00:00,154,68,86,FMN 12 Statielei
660,Statielei 26,2023-01-13,16:00:00,168,82,86,FMN 12 Statielei
660,Statielei 26,2023-01-13,17:00:00,153,74,79,FMN 12 Statielei
660,Statielei 26,2023-01-13,18:00:00,137,78,59,FMN 12 Statielei
660,Statielei 26,2023-01-13,19:00:00,110,57,53,FMN 12 Statielei
660,Statielei 26,2023-01-13,20:00:00,95,52,43,FMN 12 Statielei
660,Statielei 26,2023-01-13,21:00:00,60,33,27,FMN 12 Statielei
660,Statielei 26,2023-01-13,22:00:00,57,23,34,FMN 12 Statielei
660,Statielei 26,2023-01-13,23:00:00,55,29,26,FMN 12 Statielei
660,Statielei 26,2023-01-14,00:00:00,20,11,9,FMN 12 Statielei
660,Statielei 26,2023-01-14,01:00:00,11,3,8,FMN 12 Statielei
660,Statielei 26,2023-01-14,02:00:00,5,3,2,FMN 12 Statielei
660,Statielei 26,2023-01-14,03:00:00,7,1,6,FMN 12 Statielei
660,Statielei 26,2023-01-14,04:00:00,4,1,3,FMN 12 Statielei
660,Statielei 26,2023-01-14,05:00:00,4,1,3,FMN 12 Statielei
660,Statielei 26,2023-01-14,06:00:00,1,0,1,FMN 12 Statielei
660,Statielei 26,2023-01-14,07:00:00,5,1,4,FMN 12 Statielei
660,Statielei 26,2023-01-14,08:00:00,11,7,4,FMN 12 Statielei
660,Statielei 26,2023-01-14,09:00:00,31,19,12,FMN 12 Statielei
660,Statielei 26,2023-01-14,10:00:00,47,26,21,FMN 12 Statielei
660,Statielei 26,2023-01-14,11:00:00,48,30,18,FMN 12 Statielei
660,Statielei 26,2023-01-14,12:00:00,61,35,26,FMN 12 Statielei
660,Statielei 26,2023-01-14,13:00:00,54,26,28,FMN 12 Statielei
660,Statielei 26,2023-01-14,14:00:00,56,28,28,FMN 12 Statielei
660,Statielei 26,2023-01-14,15:00:00,55,26,29,FMN 12 Statielei
660,Statielei 26,2023-01-14,16:00:00,44,26,18,FMN 12 Statielei
660,Statielei 26,2023-01-14,17:00:00,60,33,27,FMN 12 Statielei
660,Statielei 26,2023-01-14,18:00:00,60,30,30,FMN 12 Statielei
660,Statielei 26,2023-01-14,19:00:00,55,28,27,FMN 12 Statielei
660,Statielei 26,2023-01-14,20:00:00,48,27,21,FMN 12 Statielei
660,Statielei 26,2023-01-14,21:00:00,28,11,17,FMN 12 Statielei
660,Statielei 26,2023-01-14,22:00:00,21,9,12,FMN 12 Statielei
660,Statielei 26,2023-01-14,23:00:00,22,12,10,FMN 12 Statielei
660,Statielei 26,2023-01-15,00:00:00,35,17,18,FMN 12 Statielei
660,Statielei 26,2023-01-15,01:00:00,20,11,9,FMN 12 Statielei
660,Statielei 26,2023-01-15,02:00:00,17,8,9,FMN 12 Statielei
660,Statielei 26,2023-01-15,03:00:00,13,6,7,FMN 12 Statielei
660,Statielei 26,2023-01-15,04:00:00,10,6,4,FMN 12 Statielei
660,Statielei 26,2023-01-15,05:00:00,6,2,4,FMN 12 Statielei
660,Statielei 26,2023-01-15,06:00:00,5,5,0,FMN 12 Statielei
660,Statielei 26,2023-01-15,07:00:00,13,4,9,FMN 12 Statielei
660,Statielei 26,2023-01-15,08:00:00,19,7,12,FMN 12 Statielei
660,Statielei 26,2023-01-15,09:00:00,56,21,35,FMN 12 Statielei
660,Statielei 26,2023-01-15,10:00:00,83,38,45,FMN 12 Statielei
660,Statielei 26,2023-01-15,11:00:00,77,34,43,FMN 12 Statielei
660,Statielei 26,2023-01-15,12:00:00,84,46,38,FMN 12 Statielei
660,Statielei 26,2023-01-15,13:00:00,94,51,43,FMN 12 Statielei
660,Statielei 26,2023-01-15,14:00:00,95,55,40,FMN 12 Statielei
660,Statielei 26,2023-01-15,15:00:00,91,50,41,FMN 12 Statielei
660,Statielei 26,2023-01-15,16:00:00,69,34,35,FMN 12 Statielei
660,Statielei 26,2023-01-15,17:00:00,83,49,34,FMN 12 Statielei
660,Statielei 26,2023-01-15,18:00:00,77,36,41,FMN 12 Statielei
660,Statielei 26,2023-01-15,19:00:00,37,17,20,FMN 12 Statielei
660,Statielei 26,2023-01-15,20:00:00,49,23,26,FMN 12 Statielei
660,Statielei 26,2023-01-15,21:00:00,36,22,14,FMN 12 Statielei
660,Statielei 26,2023-01-15,22:00:00,23,11,12,FMN 12 Statielei
660,Statielei 26,2023-01-15,23:00:00,14,5,9,FMN 12 Statielei
660,Statielei 26,2023-01-16,00:00:00,13,7,6,FMN 12 Statielei
660,Statielei 26,2023-01-16,01:00:00,4,3,1,FMN 12 Statielei
660,Statielei 26,2023-01-16,02:00:00,4,1,3,FMN 12 Statielei
660,Statielei 26,2023-01-16,03:00:00,2,0,2,FMN 12 Statielei
660,Statielei 26,2023-01-16,04:00:00,9,7,2,FMN 12 Statielei
660,Statielei 26,2023-01-16,05:00:00,13,7,6,FMN 12 Statielei
660,Statielei 26,2023-01-16,06:00:00,20,8,12,FMN 12 Statielei
660,Statielei 26,2023-01-16,07:00:00,61,29,32,FMN 12 Statielei
660,Statielei 26,2023-01-16,08:00:00,197,101,96,FMN 12 Statielei
660,Statielei 26,2023-01-16,09:00:00,79,57,22,FMN 12 Statielei
660,Statielei 26,2023-01-16,10:00:00,42,22,20,FMN 12 Statielei
660,Statielei 26,2023-01-16,11:00:00,41,19,22,FMN 12 Statielei
660,Statielei 26,2023-01-16,12:00:00,73,40,33,FMN 12 Statielei
660,Statielei 26,2023-01-16,13:00:00,62,35,27,FMN 12 Statielei
660,Statielei 26,2023-01-16,14:00:00,60,33,27,FMN 12 Statielei
660,Statielei 26,2023-01-16,15:00:00,83,40,43,FMN 12 Statielei
660,Statielei 26,2023-01-16,16:00:00,135,66,69,FMN 12 Statielei
660,Statielei 26,2023-01-16,17:00:00,105,43,62,FMN 12 Statielei
660,Statielei 26,2023-01-16,18:00:00,75,37,38,FMN 12 Statielei
660,Statielei 26,2023-01-16,19:00:00,71,44,27,FMN 12 Statielei
660,Statielei 26,2023-01-16,20:00:00,54,30,24,FMN 12 Statielei
660,Statielei 26,2023-01-16,21:00:00,47,20,27,FMN 12 Statielei
660,Statielei 26,2023-01-16,22:00:00,26,17,9,FMN 12 Statielei
660,Statielei 26,2023-01-16,23:00:00,11,3,8,FMN 12 Statielei
660,Statielei 26,2023-01-17,00:00:00,9,2,7,FMN 12 Statielei
660,Statielei 26,2023-01-17,01:00:00,4,3,1,FMN 12 Statielei
660,Statielei 26,2023-01-17,02:00:00,5,3,2,FMN 12 Statielei
660,Statielei 26,2023-01-17,03:00:00,3,1,2,FMN 12 Statielei
660,Statielei 26,2023-01-17,04:00:00,8,5,3,FMN 12 Statielei
660,Statielei 26,2023-01-17,05:00:00,14,10,4,FMN 12 Statielei
660,Statielei 26,2023-01-17,06:00:00,23,10,13,FMN 12 Statielei
660,Statielei 26,2023-01-17,07:00:00,109,54,55,FMN 12 Statielei
660,Statielei 26,2023-01-17,08:00:00,231,125,106,FMN 12 Statielei
660,Statielei 26,2023-01-17,09:00:00,109,69,40,FMN 12 Statielei
660,Statielei 26,2023-01-17,10:00:00,53,27,26,FMN 12 Statielei
660,Statielei 26,2023-01-17,11:00:00,61,34,27,FMN 12 Statielei
660,Statielei 26,2023-01-17,12:00:00,88,50,38,FMN 12 Statielei
660,Statielei 26,2023-01-17,13:00:00,75,49,26,FMN 12 Statielei
660,Statielei 26,2023-01-17,14:00:00,78,37,41,FMN 12 Statielei
660,Statielei 26,2023-01-17,15:00:00,132,65,67,FMN 12 Statielei
660,Statielei 26,2023-01-17,16:00:00,204,100,104,FMN 12 Statielei
660,Statielei 26,2023-01-17,17:00:00,159,69,90,FMN 12 Statielei
660,Statielei 26,2023-01-17,18:00:00,123,53,70,FMN 12 Statielei
660,Statielei 26,2023-01-17,19:00:00,72,31,41,FMN 12 Statielei
660,Statielei 26,2023-01-17,20:00:00,89,51,38,FMN 12 Statielei
660,Statielei 26,2023-01-17,21:00:00,54,32,22,FMN 12 Statielei
660,Statielei 26,2023-01-17,22:00:00,37,19,18,FMN 12 Statielei
660,Statielei 26,2023-01-17,23:00:00,30,12,18,FMN 12 Statielei
660,Statielei 26,2023-01-18,00:00:00,12,3,9,FMN 12 Statielei
660,Statielei 26,2023-01-18,01:00:00,4,2,2,FMN 12 Statielei
660,Statielei 26,2023-01-18,02:00:00,4,2,2,FMN 12 Statielei
660,Statielei 26,2023-01-18,03:00:00,2,2,0,FMN 12 Statielei
660,Statielei 26,2023-01-18,04:00:00,7,6,1,FMN 12 Statielei
660,Statielei 26,2023-01-18,05:00:00,10,5,5,FMN 12 Statielei
660,Statielei 26,2023-01-18,06:00:00,27,14,13,FMN 12 Statielei
660,Statielei 26,2023-01-18,07:00:00,93,33,60,FMN 12 Statielei
660,Statielei 26,2023-01-18,08:00:00,233,120,113,FMN 12 Statielei
660,Statielei 26,2023-01-18,09:00:00,106,70,36,FMN 12 Statielei
660,Statielei 26,2023-01-18,10:00:00,65,33,32,FMN 12 Statielei
660,Statielei 26,2023-01-18,11:00:00,91,43,48,FMN 12 Statielei
660,Statielei 26,2023-01-18,12:00:00,174,106,68,FMN 12 Statielei
660,Statielei 26,2023-01-18,13:00:00,125,64,61,FMN 12 Statielei
660,Statielei 26,2023-01-18,14:00:00,103,50,53,FMN 12 Statielei
660,Statielei 26,2023-01-18,15:00:00,118,44,74,FMN 12 Statielei
660,Statielei 26,2023-01-18,16:00:00,179,97,82,FMN 12 Statielei
660,Statielei 26,2023-01-18,17:00:00,166,89,77,FMN 12 Statielei
660,Statielei 26,2023-01-18,18:00:00,140,68,72,FMN 12 Statielei
660,Statielei 26,2023-01-18,19:00:00,96,60,36,FMN 12 Statielei
660,Statielei 26,2023-01-18,20:00:00,60,32,28,FMN 12 Statielei
660,Statielei 26,2023-01-18,21:00:00,47,20,27,FMN 12 Statielei
660,Statielei 26,2023-01-18,22:00:00,54,32,22,FMN 12 Statielei
660,Statielei 26,2023-01-18,23:00:00,22,7,15,FMN 12 Statielei
660,Statielei 26,2023-01-19,00:00:00,13,2,11,FMN 12 Statielei
660,Statielei 26,2023-01-19,01:00:00,4,1,3,FMN 12 Statielei
660,Statielei 26,2023-01-19,02:00:00,6,3,3,FMN 12 Statielei
660,Statielei 26,2023-01-19,03:00:00,2,0,2,FMN 12 Statielei
660,Statielei 26,2023-01-19,04:00:00,7,5,2,FMN 12 Statielei
660,Statielei 26,2023-01-19,05:00:00,9,4,5,FMN 12 Statielei
660,Statielei 26,2023-01-19,06:00:00,24,10,14,FMN 12 Statielei
660,Statielei 26,2023-01-19,07:00:00,68,27,41,FMN 12 Statielei
660,Statielei 26,2023-01-19,08:00:00,217,122,95,FMN 12 Statielei
660,Statielei 26,2023-01-19,09:00:00,88,63,25,FMN 12 Statielei
660,Statielei 26,2023-01-19,10:00:00,65,30,35,FMN 12 Statielei
660,Statielei 26,2023-01-19,11:00:00,68,34,34,FMN 12 Statielei
660,Statielei 26,2023-01-19,12:00:00,89,42,47,FMN 12 Statielei
660,Statielei 26,2023-01-19,13:00:00,78,45,33,FMN 12 Statielei
660,Statielei 26,2023-01-19,14:00:00,66,33,33,FMN 12 Statielei
660,Statielei 26,2023-01-19,15:00:00,135,66,69,FMN 12 Statielei
660,Statielei 26,2023-01-19,16:00:00,192,99,93,FMN 12 Statielei
660,Statielei 26,2023-01-19,17:00:00,161,69,92,FMN 12 Statielei
660,Statielei 26,2023-01-19,18:00:00,130,66,64,FMN 12 Statielei
660,Statielei 26,2023-01-19,19:00:00,89,57,32,FMN 12 Statielei
660,Statielei 26,2023-01-19,20:00:00,72,41,31,FMN 12 Statielei
660,Statielei 26,2023-01-19,21:00:00,63,27,36,FMN 12 Statielei
660,Statielei 26,2023-01-19,22:00:00,35,17,18,FMN 12 Statielei
660,Statielei 26,2023-01-19,23:00:00,36,13,23,FMN 12 Statielei
660,Statielei 26,2023-01-20,00:00:00,15,4,11,FMN 12 Statielei
660,Statielei 26,2023-01-20,01:00:00,8,5,3,FMN 12 Statielei
660,Statielei 26,2023-01-20,02:00:00,1,1,0,FMN 12 Statielei
660,Statielei 26,2023-01-20,03:00:00,3,2,1,FMN 12 Statielei
660,Statielei 26,2023-01-20,04:00:00,4,2,2,FMN 12 Statielei
660,Statielei 26,2023-01-20,05:00:00,9,6,3,FMN 12 Statielei
660,Statielei 26,2023-01-20,06:00:00,19,9,10,FMN 12 Statielei
660,Statielei 26,2023-01-20,07:00:00,80,25,55,FMN 12 Statielei
660,Statielei 26,2023-01-20,08:00:00,157,77,80,FMN 12 Statielei
660,Statielei 26,2023-01-20,09:00:00,49,30,19,FMN 12 Statielei
660,Statielei 26,2023-01-20,10:00:00,29,14,15,FMN 12 Statielei
660,Statielei 26,2023-01-20,11:00:00,33,18,15,FMN 12 Statielei
660,Statielei 26,2023-01-20,12:00:00,35,23,12,FMN 12 Statielei
660,Statielei 26,2023-01-20,13:00:00,31,14,17,FMN 12 Statielei
660,Statielei 26,2023-01-20,14:00:00,55,28,27,FMN 12 Statielei
660,Statielei 26,2023-01-20,15:00:00,104,40,64,FMN 12 Statielei
660,Statielei 26,2023-01-20,16:00:00,122,66,56,FMN 12 Statielei
660,Statielei 26,2023-01-20,17:00:00,95,40,55,FMN 12 Statielei
660,Statielei 26,2023-01-20,18:00:00,80,38,42,FMN 12 Statielei
660,Statielei 26,2023-01-20,19:00:00,90,56,34,FMN 12 Statielei
660,Statielei 26,2023-01-20,20:00:00,71,37,34,FMN 12 Statielei
660,Statielei 26,2023-01-20,21:00:00,62,39,23,FMN 12 Statielei
660,Statielei 26,2023-01-20,22:00:00,60,31,29,FMN 12 Statielei
660,Statielei 26,2023-01-20,23:00:00,39,15,24,FMN 12 Statielei
660,Statielei 26,2023-01-21,00:00:00,41,9,32,FMN 12 Statielei
660,Statielei 26,2023-01-21,01:00:00,22,14,8,FMN 12 Statielei
660,Statielei 26,2023-01-21,02:00:00,27,13,14,FMN 12 Statielei
660,Statielei 26,2023-01-21,03:00:00,8,2,6,FMN 12 Statielei
660,Statielei 26,2023-01-21,04:00:00,3,3,0,FMN 12 Statielei
660,Statielei 26,2023-01-21,05:00:00,7,1,6,FMN 12 Statielei
660,Statielei 26,2023-01-21,06:00:00,12,8,4,FMN 12 Statielei
660,Statielei 26,2023-01-21,07:00:00,10,4,6,FMN 12 Statielei
660,Statielei 26,2023-01-21,08:00:00,25,11,14,FMN 12 Statielei
660,Statielei 26,2023-01-21,09:00:00,50,20,30,FMN 12 Statielei
660,Statielei 26,2023-01-21,10:00:00,60,27,33,FMN 12 Statielei
660,Statielei 26,2023-01-21,11:00:00,73,45,28,FMN 12 Statielei
660,Statielei 26,2023-01-21,12:00:00,97,61,36,FMN 12 Statielei
660,Statielei 26,2023-01-21,13:00:00,97,55,42,FMN 12 Statielei
660,Statielei 26,2023-01-21,14:00:00,100,52,48,FMN 12 Statielei
660,Statielei 26,2023-01-21,15:00:00,90,47,43,FMN 12 Statielei
660,Statielei 26,2023-01-21,16:00:00,97,41,56,FMN 12 Statielei
660,Statielei 26,2023-01-21,17:00:00,97,59,38,FMN 12 Statielei
660,Statielei 26,2023-01-21,18:00:00,69,38,31,FMN 12 Statielei
660,Statielei 26,2023-01-21,19:00:00,65,41,24,FMN 12 Statielei
660,Statielei 26,2023-01-21,20:00:00,63,37,26,FMN 12 Statielei
660,Statielei 26,2023-01-21,21:00:00,41,25,16,FMN 12 Statielei
660,Statielei 26,2023-01-21,22:00:00,39,18,21,FMN 12 Statielei
660,Statielei 26,2023-01-21,23:00:00,53,14,39,FMN 12 Statielei
660,Statielei 26,2023-01-22,00:00:00,34,14,20,FMN 12 Statielei
660,Statielei 26,2023-01-22,01:00:00,18,2,16,FMN 12 Statielei
660,Statielei 26,2023-01-22,02:00:00,11,7,4,FMN 12 Statielei
660,Statielei 26,2023-01-22,03:00:00,6,0,6,FMN 12 Statielei
660,Statielei 26,2023-01-22,04:00:00,5,1,4,FMN 12 Statielei
660,Statielei 26,2023-01-22,05:00:00,8,3,5,FMN 12 Statielei
660,Statielei 26,2023-01-22,06:00:00,4,3,1,FMN 12 Statielei
660,Statielei 26,2023-01-22,07:00:00,12,7,5,FMN 12 Statielei
660,Statielei 26,2023-01-22,08:00:00,29,10,19,FMN 12 Statielei
660,Statielei 26,2023-01-22,09:00:00,52,24,28,FMN 12 Statielei
660,Statielei 26,2023-01-22,10:00:00,55,23,32,FMN 12 Statielei
660,Statielei 26,2023-01-22,11:00:00,65,37,28,FMN 12 Statielei
660,Statielei 26,2023-01-22,12:00:00,112,55,57,FMN 12 Statielei
660,Statielei 26,2023-01-22,13:00:00,94,35,59,FMN 12 Statielei
660,Statielei 26,2023-01-22,14:00:00,79,46,33,FMN 12 Statielei
660,Statielei 26,2023-01-22,15:00:00,75,47,28,FMN 12 Statielei
660,Statielei 26,2023-01-22,16:00:00,72,43,29,FMN 12 Statielei
660,Statielei 26,2023-01-22,17:00:00,71,40,31,FMN 12 Statielei
660,Statielei 26,2023-01-22,18:00:00,59,37,22,FMN 12 Statielei
660,Statielei 26,2023-01-22,19:00:00,41,15,26,FMN 12 Statielei
660,Statielei 26,2023-01-22,20:00:00,39,22,17,FMN 12 Statielei
660,Statielei 26,2023-01-22,21:00:00,32,15,17,FMN 12 Statielei
660,Statielei 26,2023-01-22,22:00:00,37,21,16,FMN 12 Statielei
660,Statielei 26,2023-01-22,23:00:00,15,8,7,FMN 12 Statielei
660,Statielei 26,2023-01-23,00:00:00,3,1,2,FMN 12 Statielei
660,Statielei 26,2023-01-23,01:00:00,4,2,2,FMN 12 Statielei
660,Statielei 26,2023-01-23,02:00:00,4,2,2,FMN 12 Statielei
660,Statielei 26,2023-01-23,03:00:00,2,1,1,FMN 12 Statielei
660,Statielei 26,2023-01-23,04:00:00,6,3,3,FMN 12 Statielei
660,Statielei 26,2023-01-23,05:00:00,11,6,5,FMN 12 Statielei
660,Statielei 26,2023-01-23,06:00:00,25,10,15,FMN 12 Statielei
660,Statielei 26,2023-01-23,07:00:00,99,45,54,FMN 12 Statielei
660,Statielei 26,2023-01-23,08:00:00,248,127,121,FMN 12 Statielei
660,Statielei 26,2023-01-23,09:00:00,81,49,32,FMN 12 Statielei
660,Statielei 26,2023-01-23,10:00:00,40,24,16,FMN 12 Statielei
660,Statielei 26,2023-01-23,11:00:00,71,41,30,FMN 12 Statielei
660,Statielei 26,2023-01-23,12:00:00,84,51,33,FMN 12 Statielei
660,Statielei 26,2023-01-23,13:00:00,69,37,32,FMN 12 Statielei
660,Statielei 26,2023-01-23,14:00:00,81,40,41,FMN 12 Statielei
660,Statielei 26,2023-01-23,15:00:00,121,57,64,FMN 12 Statielei
660,Statielei 26,2023-01-23,16:00:00,192,110,82,FMN 12 Statielei
660,Statielei 26,2023-01-23,17:00:00,198,86,112,FMN 12 Statielei
660,Statielei 26,2023-01-23,18:00:00,92,48,44,FMN 12 Statielei
660,Statielei 26,2023-01-23,19:00:00,74,43,31,FMN 12 Statielei
660,Statielei 26,2023-01-23,20:00:00,44,25,19,FMN 12 Statielei
660,Statielei 26,2023-01-23,21:00:00,35,18,17,FMN 12 Statielei
660,Statielei 26,2023-01-23,22:00:00,47,23,24,FMN 12 Statielei
660,Statielei 26,2023-01-23,23:00:00,19,6,13,FMN 12 Statielei
660,Statielei 26,2023-01-24,00:00:00,8,5,3,FMN 12 Statielei
660,Statielei 26,2023-01-24,01:00:00,10,4,6,FMN 12 Statielei
660,Statielei 26,2023-01-24,02:00:00,3,3,0,FMN 12 Statielei
660,Statielei 26,2023-01-24,03:00:00,4,2,2,FMN 12 Statielei
660,Statielei 26,2023-01-24,04:00:00,7,3,4,FMN 12 Statielei
660,Statielei 26,2023-01-24,05:00:00,16,9,7,FMN 12 Statielei
660,Statielei 26,2023-01-24,06:00:00,32,15,17,FMN 12 Statielei
660,Statielei 26,2023-01-24,07:00:00,101,51,50,FMN 12 Statielei
660,Statielei 26,2023-01-24,08:00:00,263,135,128,FMN 12 Statielei
660,Statielei 26,2023-01-24,09:00:00,93,60,33,FMN 12 Statielei
660,Statielei 26,2023-01-24,10:00:00,49,32,17,FMN 12 Statielei
660,Statielei 26,2023-01-24,11:00:00,57,27,30,FMN 12 Statielei
660,Statielei 26,2023-01-24,12:00:00,87,45,42,FMN 12 Statielei
660,Statielei 26,2023-01-24,13:00:00,79,47,32,FMN 12 Statielei
660,Statielei 26,2023-01-24,14:00:00,61,31,30,FMN 12 Statielei
660,Statielei 26,2023-01-24,15:00:00,129,50,79,FMN 12 Statielei
660,Statielei 26,2023-01-24,16:00:00,184,90,94,FMN 12 Statielei
660,Statielei 26,2023-01-24,17:00:00,200,90,110,FMN 12 Statielei
660,Statielei 26,2023-01-24,18:00:00,120,70,50,FMN 12 Statielei
660,Statielei 26,2023-01-24,19:00:00,98,50,48,FMN 12 Statielei
660,Statielei 26,2023-01-24,20:00:00,71,41,30,FMN 12 Statielei
660,Statielei 26,2023-01-24,21:00:00,58,24,34,FMN 12 Statielei
660,Statielei 26,2023-01-24,22:00:00,53,28,25,FMN 12 Statielei
660,Statielei 26,2023-01-24,23:00:00,26,7,19,FMN 12 Statielei
660,Statielei 26,2023-01-25,00:00:00,11,5,6,FMN 12 Statielei
660,Statielei 26,2023-01-25,01:00:00,8,5,3,FMN 12 Statielei
660,Statielei 26,2023-01-25,02:00:00,1,1,0,FMN 12 Statielei
660,Statielei 26,2023-01-25,03:00:00,4,2,2,FMN 12 Statielei
660,Statielei 26,2023-01-25,04:00:00,8,4,4,FMN 12 Statielei
660,Statielei 26,2023-01-25,05:00:00,10,8,2,FMN 12 Statielei
660,Statielei 26,2023-01-25,06:00:00,26,13,13,FMN 12 Statielei
660,Statielei 26,2023-01-25,07:00:00,95,39,56,FMN 12 Statielei
660,Statielei 26,2023-01-25,08:00:00,226,121,105,FMN 12 Statielei
660,Statielei 26,2023-01-25,09:00:00,85,49,36,FMN 12 Statielei
660,Statielei 26,2023-01-25,10:00:00,53,33,20,FMN 12 Statielei
660,Statielei 26,2023-01-25,11:00:00,71,37,34,FMN 12 Statielei
660,Statielei 26,2023-01-25,12:00:00,184,101,83,FMN 12 Statielei
660,Statielei 26,2023-01-25,13:00:00,123,59,64,FMN 12 Statielei
660,Statielei 26,2023-01-25,14:00:00,89,38,51,FMN 12 Statielei
660,Statielei 26,2023-01-25,15:00:00,111,52,59,FMN 12 Statielei
660,Statielei 26,2023-01-25,16:00:00,150,72,78,FMN 12 Statielei
660,Statielei 26,2023-01-25,17:00:00,143,60,83,FMN 12 Statielei
660,Statielei 26,2023-01-25,18:00:00,127,65,62,FMN 12 Statielei
660,Statielei 26,2023-01-25,19:00:00,81,45,36,FMN 12 Statielei
660,Statielei 26,2023-01-25,20:00:00,67,41,26,FMN 12 Statielei
660,Statielei 26,2023-01-25,21:00:00,45,16,29,FMN 12 Statielei
660,Statielei 26,2023-01-25,22:00:00,54,28,26,FMN 12 Statielei
660,Statielei 26,2023-01-25,23:00:00,33,17,16,FMN 12 Statielei
660,Statielei 26,2023-01-26,00:00:00,8,4,4,FMN 12 Statielei
660,Statielei 26,2023-01-26,01:00:00,7,4,3,FMN 12 Statielei
660,Statielei 26,2023-01-26,02:00:00,3,0,3,FMN 12 Statielei
660,Statielei 26,2023-01-26,03:00:00,4,1,3,FMN 12 Statielei
660,Statielei 26,2023-01-26,04:00:00,10,7,3,FMN 12 Statielei
660,Statielei 26,2023-01-26,05:00:00,9,5,4,FMN 12 Statielei
660,Statielei 26,2023-01-26,06:00:00,25,11,14,FMN 12 Statielei
660,Statielei 26,2023-01-26,07:00:00,87,40,47,FMN 12 Statielei
660,Statielei 26,2023-01-26,08:00:00,239,123,116,FMN 12 Statielei
660,Statielei 26,2023-01-26,09:00:00,100,62,38,FMN 12 Statielei
660,Statielei 26,2023-01-26,10:00:00,55,27,28,FMN 12 Statielei
660,Statielei 26,2023-01-26,11:00:00,58,33,25,FMN 12 Statielei
660,Statielei 26,2023-01-26,12:00:00,84,50,34,FMN 12 Statielei
660,Statielei 26,2023-01-26,13:00:00,77,38,39,FMN 12 Statielei
660,Statielei 26,2023-01-26,14:00:00,86,34,52,FMN 12 Statielei
660,Statielei 26,2023-01-26,15:00:00,109,41,68,FMN 12 Statielei
660,Statielei 26,2023-01-26,16:00:00,198,102,96,FMN 12 Statielei
660,Statielei 26,2023-01-26,17:00:00,167,78,89,FMN 12 Statielei
660,Statielei 26,2023-01-26,18:00:00,161,91,70,FMN 12 Statielei
660,Statielei 26,2023-01-26,19:00:00,115,73,42,FMN 12 Statielei
660,Statielei 26,2023-01-26,20:00:00,82,52,30,FMN 12 Statielei
660,Statielei 26,2023-01-26,21:00:00,65,36,29,FMN 12 Statielei
660,Statielei 26,2023-01-26,22:00:00,73,21,52,FMN 12 Statielei
660,Statielei 26,2023-01-26,23:00:00,43,21,22,FMN 12 Statielei
660,Statielei 26,2023-01-27,00:00:00,34,14,20,FMN 12 Statielei
660,Statielei 26,2023-01-27,01:00:00,10,6,4,FMN 12 Statielei
660,Statielei 26,2023-01-27,02:00:00,3,1,2,FMN 12 Statielei
660,Statielei 26,2023-01-27,03:00:00,2,0,2,FMN 12 Statielei
660,Statielei 26,2023-01-27,04:00:00,8,3,5,FMN 12 Statielei
660,Statielei 26,2023-01-27,05:00:00,12,8,4,FMN 12 Statielei
660,Statielei 26,2023-01-27,06:00:00,28,15,13,FMN 12 Statielei
660,Statielei 26,2023-01-27,07:00:00,94,46,48,FMN 12 Statielei
660,Statielei 26,2023-01-27,08:00:00,197,101,96,FMN 12 Statielei
660,Statielei 26,2023-01-27,09:00:00,90,52,38,FMN 12 Statielei
660,Statielei 26,2023-01-27,10:00:00,60,38,22,FMN 12 Statielei
660,Statielei 26,2023-01-27,11:00:00,69,44,25,FMN 12 Statielei
660,Statielei 26,2023-01-27,12:00:00,107,64,43,FMN 12 Statielei
660,Statielei 26,2023-01-27,13:00:00,99,56,43,FMN 12 Statielei
660,Statielei 26,2023-01-27,14:00:00,97,52,45,FMN 12 Statielei
660,Statielei 26,2023-01-27,15:00:00,140,43,97,FMN 12 Statielei
660,Statielei 26,2023-01-27,16:00:00,166,89,77,FMN 12 Statielei
660,Statielei 26,2023-01-27,17:00:00,145,70,75,FMN 12 Statielei
660,Statielei 26,2023-01-27,18:00:00,140,70,70,FMN 12 Statielei
660,Statielei 26,2023-01-27,19:00:00,113,67,46,FMN 12 Statielei
660,Statielei 26,2023-01-27,20:00:00,68,38,30,FMN 12 Statielei
660,Statielei 26,2023-01-27,21:00:00,49,30,19,FMN 12 Statielei
660,Statielei 26,2023-01-27,22:00:00,58,29,29,FMN 12 Statielei
660,Statielei 26,2023-01-27,23:00:00,62,34,28,FMN 12 Statielei
660,Statielei 26,2023-01-28,00:00:00,36,8,28,FMN 12 Statielei
660,Statielei 26,2023-01-28,01:00:00,32,8,24,FMN 12 Statielei
660,Statielei 26,2023-01-28,02:00:00,23,11,12,FMN 12 Statielei
660,Statielei 26,2023-01-28,03:00:00,13,4,9,FMN 12 Statielei
660,Statielei 26,2023-01-28,04:00:00,8,4,4,FMN 12 Statielei
660,Statielei 26,2023-01-28,05:00:00,11,6,5,FMN 12 Statielei
660,Statielei 26,2023-01-28,06:00:00,13,7,6,FMN 12 Statielei
660,Statielei 26,2023-01-28,07:00:00,12,4,8,FMN 12 Statielei
660,Statielei 26,2023-01-28,08:00:00,41,18,23,FMN 12 Statielei
660,Statielei 26,2023-01-28,09:00:00,69,39,30,FMN 12 Statielei
660,Statielei 26,2023-01-28,10:00:00,60,32,28,FMN 12 Statielei
660,Statielei 26,2023-01-28,11:00:00,109,61,48,FMN 12 Statielei
660,Statielei 26,2023-01-28,12:00:00,112,62,50,FMN 12 Statielei
660,Statielei 26,2023-01-28,13:00:00,108,67,41,FMN 12 Statielei
660,Statielei 26,2023-01-28,14:00:00,119,55,64,FMN 12 Statielei
660,Statielei 26,2023-01-28,15:00:00,118,51,67,FMN 12 Statielei
660,Statielei 26,2023-01-28,16:00:00,98,54,44,FMN 12 Statielei
660,Statielei 26,2023-01-28,17:00:00,103,63,40,FMN 12 Statielei
660,Statielei 26,2023-01-28,18:00:00,106,62,44,FMN 12 Statielei
660,Statielei 26,2023-01-28,19:00:00,109,66,43,FMN 12 Statielei
660,Statielei 26,2023-01-28,20:00:00,76,37,39,FMN 12 Statielei
660,Statielei 26,2023-01-28,21:00:00,64,38,26,FMN 12 Statielei
660,Statielei 26,2023-01-28,22:00:00,76,41,35,FMN 12 Statielei
660,Statielei 26,2023-01-28,23:00:00,70,35,35,FMN 12 Statielei
660,Statielei 26,2023-01-29,00:00:00,47,15,32,FMN 12 Statielei
660,Statielei 26,2023-01-29,01:00:00,33,4,29,FMN 12 Statielei
660,Statielei 26,2023-01-29,02:00:00,22,4,18,FMN 12 Statielei
660,Statielei 26,2023-01-29,03:00:00,24,8,16,FMN 12 Statielei
660,Statielei 26,2023-01-29,04:00:00,16,9,7,FMN 12 Statielei
660,Statielei 26,2023-01-29,05:00:00,11,3,8,FMN 12 Statielei
660,Statielei 26,2023-01-29,06:00:00,5,3,2,FMN 12 Statielei
660,Statielei 26,2023-01-29,07:00:00,9,4,5,FMN 12 Statielei
660,Statielei 26,2023-01-29,08:00:00,34,15,19,FMN 12 Statielei
660,Statielei 26,2023-01-29,09:00:00,74,28,46,FMN 12 Statielei
660,Statielei 26,2023-01-29,10:00:00,59,25,34,FMN 12 Statielei
660,Statielei 26,2023-01-29,11:00:00,81,46,35,FMN 12 Statielei
660,Statielei 26,2023-01-29,12:00:00,89,57,32,FMN 12 Statielei
660,Statielei 26,2023-01-29,13:00:00,101,57,44,FMN 12 Statielei
660,Statielei 26,2023-01-29,14:00:00,95,59,36,FMN 12 Statielei
660,Statielei 26,2023-01-29,15:00:00,93,48,45,FMN 12 Statielei
660,Statielei 26,2023-01-29,16:00:00,80,38,42,FMN 12 Statielei
660,Statielei 26,2023-01-29,17:00:00,101,49,52,FMN 12 Statielei
660,Statielei 26,2023-01-29,18:00:00,68,39,29,FMN 12 Statielei
660,Statielei 26,2023-01-29,19:00:00,71,30,41,FMN 12 Statielei
660,Statielei 26,2023-01-29,20:00:00,54,27,27,FMN 12 Statielei
660,Statielei 26,2023-01-29,21:00:00,46,20,26,FMN 12 Statielei
660,Statielei 26,2023-01-29,22:00:00,38,18,20,FMN 12 Statielei
660,Statielei 26,2023-01-29,23:00:00,23,6,17,FMN 12 Statielei
660,Statielei 26,2023-01-30,00:00:00,7,3,4,FMN 12 Statielei
660,Statielei 26,2023-01-30,01:00:00,6,2,4,FMN 12 Statielei
660,Statielei 26,2023-01-30,02:00:00,5,3,2,FMN 12 Statielei
660,Statielei 26,2023-01-30,03:00:00,1,0,1,FMN 12 Statielei
660,Statielei 26,2023-01-30,04:00:00,8,3,5,FMN 12 Statielei
660,Statielei 26,2023-01-30,05:00:00,15,11,4,FMN 12 Statielei
660,Statielei 26,2023-01-30,06:00:00,30,16,14,FMN 12 Statielei
660,Statielei 26,2023-01-30,07:00:00,95,45,50,FMN 12 Statielei
660,Statielei 26,2023-01-30,08:00:00,230,122,108,FMN 12 Statielei
660,Statielei 26,2023-01-30,09:00:00,103,64,39,FMN 12 Statielei
660,Statielei 26,2023-01-30,10:00:00,57,35,22,FMN 12 Statielei
660,Statielei 26,2023-01-30,11:00:00,78,44,34,FMN 12 Statielei
660,Statielei 26,2023-01-30,12:00:00,91,46,45,FMN 12 Statielei
660,Statielei 26,2023-01-30,13:00:00,73,37,36,FMN 12 Statielei
660,Statielei 26,2023-01-30,14:00:00,86,41,45,FMN 12 Statielei
660,Statielei 26,2023-01-30,15:00:00,136,61,75,FMN 12 Statielei
660,Statielei 26,2023-01-30,16:00:00,197,99,98,FMN 12 Statielei
660,Statielei 26,2023-01-30,17:00:00,195,88,107,FMN 12 Statielei
660,Statielei 26,2023-01-30,18:00:00,123,59,64,FMN 12 Statielei
660,Statielei 26,2023-01-30,19:00:00,93,47,46,FMN 12 Statielei
660,Statielei 26,2023-01-30,20:00:00,77,34,43,FMN 12 Statielei
660,Statielei 26,2023-01-30,21:00:00,59,26,33,FMN 12 Statielei
660,Statielei 26,2023-01-30,22:00:00,42,21,21,FMN 12 Statielei
660,Statielei 26,2023-01-30,23:00:00,29,9,20,FMN 12 Statielei
660,Statielei 26,2023-01-31,00:00:00,16,2,14,FMN 12 Statielei
660,Statielei 26,2023-01-31,01:00:00,9,5,4,FMN 12 Statielei
660,Statielei 26,2023-01-31,02:00:00,4,2,2,FMN 12 Statielei
660,Statielei 26,2023-01-31,03:00:00,4,0,4,FMN 12 Statielei
660,Statielei 26,2023-01-31,04:00:00,14,7,7,FMN 12 Statielei
660,Statielei 26,2023-01-31,05:00:00,12,8,4,FMN 12 Statielei
660,Statielei 26,2023-01-31,06:00:00,32,14,18,FMN 12 Statielei
660,Statielei 26,2023-01-31,07:00:00,113,49,64,FMN 12 Statielei
660,Statielei 26,2023-01-31,08:00:00,258,136,122,FMN 12 Statielei
660,Statielei 26,2023-01-31,09:00:00,111,71,40,FMN 12 Statielei
660,Statielei 26,2023-01-31,10:00:00,70,44,26,FMN 12 Statielei
660,Statielei 26,2023-01-31,11:00:00,71,30,41,FMN 12 Statielei
660,Statielei 26,2023-01-31,12:00:00,81,48,33,FMN 12 Statielei
660,Statielei 26,2023-01-31,13:00:00,88,43,45,FMN 12 Statielei
660,Statielei 26,2023-01-31,14:00:00,77,38,39,FMN 12 Statielei
660,Statielei 26,2023-01-31,15:00:00,126,57,69,FMN 12 Statielei
660,Statielei 26,2023-01-31,16:00:00,190,88,102,FMN 12 Statielei
660,Statielei 26,2023-01-31,17:00:00,166,84,82,FMN 12 Statielei
660,Statielei 26,2023-01-31,18:00:00,146,67,79,FMN 12 Statielei
660,Statielei 26,2023-01-31,19:00:00,110,52,58,FMN 12 Statielei
660,Statielei 26,2023-01-31,20:00:00,70,39,31,FMN 12 Statielei
660,Statielei 26,2023-01-31,21:00:00,57,31,26,FMN 12 Statielei
660,Statielei 26,2023-01-31,22:00:00,78,44,34,FMN 12 Statielei
660,Statielei 26,2023-01-31,23:00:00,27,8,19,FMN 12 Statielei
660,Statielei 26,2023-02-01,00:00:00,13,3,10,FMN 12 Statielei
660,Statielei 26,2023-02-01,01:00:00,8,4,4,FMN 12 Statielei
660,Statielei 26,2023-02-01,02:00:00,7,4,3,FMN 12 Statielei
660,Statielei 26,2023-02-01,03:00:00,0,0,0,FMN 12 Statielei
660,Statielei 26,2023-02-01,04:00:00,10,4,6,FMN 12 Statielei
660,Statielei 26,2023-02-01,05:00:00,14,9,5,FMN 12 Statielei
660,Statielei 26,2023-02-01,06:00:00,30,13,17,FMN 12 Statielei
660,Statielei 26,2023-02-01,07:00:00,125,49,76,FMN 12 Statielei
660,Statielei 26,2023-02-01,08:00:00,263,124,139,FMN 12 Statielei
660,Statielei 26,2023-02-01,09:00:00,94,65,29,FMN 12 Statielei
660,Statielei 26,2023-02-01,10:00:00,66,42,24,FMN 12 Statielei
660,Statielei 26,2023-02-01,11:00:00,89,47,42,FMN 12 Statielei
660,Statielei 26,2023-02-01,12:00:00,200,98,102,FMN 12 Statielei
660,Statielei 26,2023-02-01,13:00:00,135,72,63,FMN 12 Statielei
660,Statielei 26,2023-02-01,14:00:00,110,51,59,FMN 12 Statielei
660,Statielei 26,2023-02-01,15:00:00,146,67,79,FMN 12 Statielei
660,Statielei 26,2023-02-01,16:00:00,145,67,78,FMN 12 Statielei
660,Statielei 26,2023-02-01,17:00:00,181,95,86,FMN 12 Statielei
660,Statielei 26,2023-02-01,18:00:00,135,66,69,FMN 12 Statielei
660,Statielei 26,2023-02-01,19:00:00,97,53,44,FMN 12 Statielei
660,Statielei 26,2023-02-01,20:00:00,71,37,34,FMN 12 Statielei
660,Statielei 26,2023-02-01,21:00:00,53,22,31,FMN 12 Statielei
660,Statielei 26,2023-02-01,22:00:00,52,27,25,FMN 12 Statielei
660,Statielei 26,2023-02-01,23:00:00,42,12,30,FMN 12 Statielei
660,Statielei 26,2023-02-02,00:00:00,21,6,15,FMN 12 Statielei
660,Statielei 26,2023-02-02,01:00:00,9,6,3,FMN 12 Statielei
660,Statielei 26,2023-02-02,02:00:00,6,3,3,FMN 12 Statielei
660,Statielei 26,2023-02-02,03:00:00,2,1,1,FMN 12 Statielei
660,Statielei 26,2023-02-02,04:00:00,13,7,6,FMN 12 Statielei
660,Statielei 26,2023-02-02,05:00:00,14,9,5,FMN 12 Statielei
660,Statielei 26,2023-02-02,06:00:00,33,15,18,FMN 12 Statielei
660,Statielei 26,2023-02-02,07:00:00,95,41,54,FMN 12 Statielei
660,Statielei 26,2023-02-02,08:00:00,274,150,124,FMN 12 Statielei
660,Statielei 26,2023-02-02,09:00:00,119,81,38,FMN 12 Statielei
660,Statielei 26,2023-02-02,10:00:00,47,31,16,FMN 12 Statielei
660,Statielei 26,2023-02-02,11:00:00,79,46,33,FMN 12 Statielei
660,Statielei 26,2023-02-02,12:00:00,117,65,52,FMN 12 Statielei
660,Statielei 26,2023-02-02,13:00:00,87,49,38,FMN 12 Statielei
660,Statielei 26,2023-02-02,14:00:00,91,45,46,FMN 12 Statielei
660,Statielei 26,2023-02-02,15:00:00,160,75,85,FMN 12 Statielei
660,Statielei 26,2023-02-02,16:00:00,207,97,110,FMN 12 Statielei
660,Statielei 26,2023-02-02,17:00:00,153,65,88,FMN 12 Statielei
660,Statielei 26,2023-02-02,18:00:00,155,78,77,FMN 12 Statielei
660,Statielei 26,2023-02-02,19:00:00,99,53,46,FMN 12 Statielei
660,Statielei 26,2023-02-02,20:00:00,82,45,37,FMN 12 Statielei
660,Statielei 26,2023-02-02,21:00:00,69,36,33,FMN 12 Statielei
660,Statielei 26,2023-02-02,22:00:00,61,28,33,FMN 12 Statielei
660,Statielei 26,2023-02-02,23:00:00,43,8,35,FMN 12 Statielei
660,Statielei 26,2023-02-03,00:00:00,22,9,13,FMN 12 Statielei
660,Statielei 26,2023-02-03,01:00:00,13,5,8,FMN 12 Statielei
660,Statielei 26,2023-02-03,02:00:00,9,4,5,FMN 12 Statielei
660,Statielei 26,2023-02-03,03:00:00,5,4,1,FMN 12 Statielei
660,Statielei 26,2023-02-03,04:00:00,8,4,4,FMN 12 Statielei
660,Statielei 26,2023-02-03,05:00:00,15,7,8,FMN 12 Statielei
660,Statielei 26,2023-02-03,06:00:00,34,17,17,FMN 12 Statielei
660,Statielei 26,2023-02-03,07:00:00,85,34,51,FMN 12 Statielei
660,Statielei 26,2023-02-03,08:00:00,221,121,100,FMN 12 Statielei
660,Statielei 26,2023-02-03,09:00:00,91,64,27,FMN 12 Statielei
660,Statielei 26,2023-02-03,10:00:00,66,31,35,FMN 12 Statielei
660,Statielei 26,2023-02-03,11:00:00,69,39,30,FMN 12 Statielei
660,Statielei 26,2023-02-03,12:00:00,93,56,37,FMN 12 Statielei
660,Statielei 26,2023-02-03,13:00:00,74,30,44,FMN 12 Statielei
660,Statielei 26,2023-02-03,14:00:00,101,46,55,FMN 12 Statielei
660,Statielei 26,2023-02-03,15:00:00,138,58,80,FMN 12 Statielei
660,Statielei 26,2023-02-03,16:00:00,177,86,91,FMN 12 Statielei
660,Statielei 26,2023-02-03,17:00:00,150,70,80,FMN 12 Statielei
660,Statielei 26,2023-02-03,18:00:00,134,70,64,FMN 12 Statielei
660,Statielei 26,2023-02-03,19:00:00,116,68,48,FMN 12 Statielei
660,Statielei 26,2023-02-03,20:00:00,77,38,39,FMN 12 Statielei
660,Statielei 26,2023-02-03,21:00:00,65,36,29,FMN 12 Statielei
660,Statielei 26,2023-02-03,22:00:00,57,30,27,FMN 12 Statielei
660,Statielei 26,2023-02-03,23:00:00,56,26,30,FMN 12 Statielei
660,Statielei 26,2023-02-04,00:00:00,52,28,24,FMN 12 Statielei
660,Statielei 26,2023-02-04,01:00:00,20,7,13,FMN 12 Statielei
660,Statielei 26,2023-02-04,02:00:00,18,10,8,FMN 12 Statielei
660,Statielei 26,2023-02-04,03:00:00,17,4,13,FMN 12 Statielei
660,Statielei 26,2023-02-04,04:00:00,16,6,10,FMN 12 Statielei
660,Statielei 26,2023-02-04,05:00:00,16,4,12,FMN 12 Statielei
660,Statielei 26,2023-02-04,06:00:00,9,4,5,FMN 12 Statielei
660,Statielei 26,2023-02-04,07:00:00,17,5,12,FMN 12 Statielei
660,Statielei 26,2023-02-04,08:00:00,32,14,18,FMN 12 Statielei
660,Statielei 26,2023-02-04,09:00:00,58,24,34,FMN 12 Statielei
660,Statielei 26,2023-02-04,10:00:00,79,34,45,FMN 12 Statielei
660,Statielei 26,2023-02-04,11:00:00,93,50,43,FMN 12 Statielei
660,Statielei 26,2023-02-04,12:00:00,69,39,30,FMN 12 Statielei
660,Statielei 26,2023-02-04,13:00:00,100,52,48,FMN 12 Statielei
660,Statielei 26,2023-02-04,14:00:00,103,55,48,FMN 12 Statielei
660,Statielei 26,2023-02-04,15:00:00,88,49,39,FMN 12 Statielei
660,Statielei 26,2023-02-04,16:00:00,102,58,44,FMN 12 Statielei
660,Statielei 26,2023-02-04,17:00:00,120,75,45,FMN 12 Statielei
660,Statielei 26,2023-02-04,18:00:00,81,43,38,FMN 12 Statielei
660,Statielei 26,2023-02-04,19:00:00,89,64,25,FMN 12 Statielei
660,Statielei 26,2023-02-04,20:00:00,78,42,36,FMN 12 Statielei
660,Statielei 26,2023-02-04,21:00:00,40,16,24,FMN 12 Statielei
660,Statielei 26,2023-02-04,22:00:00,48,19,29,FMN 12 Statielei
660,Statielei 26,2023-02-04,23:00:00,38,13,25,FMN 12 Statielei
660,Statielei 26,2023-02-05,00:00:00,51,23,28,FMN 12 Statielei
660,Statielei 26,2023-02-05,01:00:00,25,9,16,FMN 12 Statielei
660,Statielei 26,2023-02-05,02:00:00,11,3,8,FMN 12 Statielei
660,Statielei 26,2023-02-05,03:00:00,6,3,3,FMN 12 Statielei
660,Statielei 26,2023-02-05,04:00:00,13,5,8,FMN 12 Statielei
660,Statielei 26,2023-02-05,05:00:00,9,0,9,FMN 12 Statielei
660,Statielei 26,2023-02-05,06:00:00,11,6,5,FMN 12 Statielei
660,Statielei 26,2023-02-05,07:00:00,9,3,6,FMN 12 Statielei
660,Statielei 26,2023-02-05,08:00:00,29,17,12,FMN 12 Statielei
660,Statielei 26,2023-02-05,09:00:00,56,26,30,FMN 12 Statielei
660,Statielei 26,2023-02-05,10:00:00,69,31,38,FMN 12 Statielei
660,Statielei 26,2023-02-05,11:00:00,70,34,36,FMN 12 Statielei
660,Statielei 26,2023-02-05,12:00:00,136,73,63,FMN 12 Statielei
660,Statielei 26,2023-02-05,13:00:00,115,47,68,FMN 12 Statielei
660,Statielei 26,2023-02-05,14:00:00,98,50,48,FMN 12 Statielei
660,Statielei 26,2023-02-05,15:00:00,123,67,56,FMN 12 Statielei
660,Statielei 26,2023-02-05,16:00:00,114,66,48,FMN 12 Statielei
660,Statielei 26,2023-02-05,17:00:00,99,48,51,FMN 12 Statielei
660,Statielei 26,2023-02-05,18:00:00,104,59,45,FMN 12 Statielei
660,Statielei 26,2023-02-05,19:00:00,71,28,43,FMN 12 Statielei
660,Statielei 26,2023-02-05,20:00:00,66,38,28,FMN 12 Statielei
660,Statielei 26,2023-02-05,21:00:00,42,21,21,FMN 12 Statielei
660,Statielei 26,2023-02-05,22:00:00,34,16,18,FMN 12 Statielei
660,Statielei 26,2023-02-05,23:00:00,25,9,16,FMN 12 Statielei
660,Statielei 26,2023-02-06,00:00:00,15,4,11,FMN 12 Statielei
660,Statielei 26,2023-02-06,01:00:00,2,2,0,FMN 12 Statielei
660,Statielei 26,2023-02-06,02:00:00,3,1,2,FMN 12 Statielei
660,Statielei 26,2023-02-06,03:00:00,5,2,3,FMN 12 Statielei
660,Statielei 26,2023-02-06,04:00:00,4,4,0,FMN 12 Statielei
660,Statielei 26,2023-02-06,05:00:00,18,15,3,FMN 12 Statielei
660,Statielei 26,2023-02-06,06:00:00,27,14,13,FMN 12 Statielei
660,Statielei 26,2023-02-06,07:00:00,104,40,64,FMN 12 Statielei
660,Statielei 26,2023-02-06,08:00:00,228,133,95,FMN 12 Statielei
660,Statielei 26,2023-02-06,09:00:00,95,55,40,FMN 12 Statielei
660,Statielei 26,2023-02-06,10:00:00,62,37,25,FMN 12 Statielei
660,Statielei 26,2023-02-06,11:00:00,62,30,32,FMN 12 Statielei
660,Statielei 26,2023-02-06,12:00:00,101,45,56,FMN 12 Statielei
660,Statielei 26,2023-02-06,13:00:00,95,50,45,FMN 12 Statielei
660,Statielei 26,2023-02-06,14:00:00,89,46,43,FMN 12 Statielei
660,Statielei 26,2023-02-06,15:00:00,163,78,85,FMN 12 Statielei
660,Statielei 26,2023-02-06,16:00:00,205,107,98,FMN 12 Statielei
660,Statielei 26,2023-02-06,17:00:00,175,80,95,FMN 12 Statielei
660,Statielei 26,2023-02-06,18:00:00,150,77,73,FMN 12 Statielei
660,Statielei 26,2023-02-06,19:00:00,93,54,39,FMN 12 Statielei
660,Statielei 26,2023-02-06,20:00:00,75,34,41,FMN 12 Statielei
660,Statielei 26,2023-02-06,21:00:00,40,19,21,FMN 12 Statielei
660,Statielei 26,2023-02-06,22:00:00,45,18,27,FMN 12 Statielei
660,Statielei 26,2023-02-06,23:00:00,26,11,15,FMN 12 Statielei
660,Statielei 26,2023-02-07,00:00:00,5,1,4,FMN 12 Statielei
660,Statielei 26,2023-02-07,01:00:00,6,2,4,FMN 12 Statielei
660,Statielei 26,2023-02-07,02:00:00,5,2,3,FMN 12 Statielei
660,Statielei 26,2023-02-07,03:00:00,4,0,4,FMN 12 Statielei
660,Statielei 26,2023-02-07,04:00:00,10,7,3,FMN 12 Statielei
660,Statielei 26,2023-02-07,05:00:00,16,12,4,FMN 12 Statielei
660,Statielei 26,2023-02-07,06:00:00,23,14,9,FMN 12 Statielei
660,Statielei 26,2023-02-07,07:00:00,112,55,57,FMN 12 Statielei
660,Statielei 26,2023-02-07,08:00:00,252,126,126,FMN 12 Statielei
660,Statielei 26,2023-02-07,09:00:00,91,58,33,FMN 12 Statielei
660,Statielei 26,2023-02-07,10:00:00,69,31,38,FMN 12 Statielei
660,Statielei 26,2023-02-07,11:00:00,51,28,23,FMN 12 Statielei
660,Statielei 26,2023-02-07,12:00:00,90,45,45,FMN 12 Statielei
660,Statielei 26,2023-02-07,13:00:00,77,35,42,FMN 12 Statielei
660,Statielei 26,2023-02-07,14:00:00,83,48,35,FMN 12 Statielei
660,Statielei 26,2023-02-07,15:00:00,158,61,97,FMN 12 Statielei
660,Statielei 26,2023-02-07,16:00:00,187,96,91,FMN 12 Statielei
660,Statielei 26,2023-02-07,17:00:00,180,81,99,FMN 12 Statielei
660,Statielei 26,2023-02-07,18:00:00,155,88,67,FMN 12 Statielei
660,Statielei 26,2023-02-07,19:00:00,116,65,51,FMN 12 Statielei
660,Statielei 26,2023-02-07,20:00:00,85,46,39,FMN 12 Statielei
660,Statielei 26,2023-02-07,21:00:00,54,19,35,FMN 12 Statielei
660,Statielei 26,2023-02-07,22:00:00,66,34,32,FMN 12 Statielei
660,Statielei 26,2023-02-07,23:00:00,24,10,14,FMN 12 Statielei
660,Statielei 26,2023-02-08,00:00:00,14,2,12,FMN 12 Statielei
660,Statielei 26,2023-02-08,01:00:00,7,1,6,FMN 12 Statielei
660,Statielei 26,2023-02-08,02:00:00,4,2,2,FMN 12 Statielei
660,Statielei 26,2023-02-08,03:00:00,7,2,5,FMN 12 Statielei
660,Statielei 26,2023-02-08,04:00:00,8,5,3,FMN 12 Statielei
660,Statielei 26,2023-02-08,05:00:00,12,7,5,FMN 12 Statielei
660,Statielei 26,2023-02-08,06:00:00,22,11,11,FMN 12 Statielei
660,Statielei 26,2023-02-08,07:00:00,93,34,59,FMN 12 Statielei
660,Statielei 26,2023-02-08,08:00:00,233,128,105,FMN 12 Statielei
660,Statielei 26,2023-02-08,09:00:00,99,67,32,FMN 12 Statielei
660,Statielei 26,2023-02-08,10:00:00,64,43,21,FMN 12 Statielei
660,Statielei 26,2023-02-08,11:00:00,69,36,33,FMN 12 Statielei
660,Statielei 26,2023-02-08,12:00:00,201,105,96,FMN 12 Statielei
660,Statielei 26,2023-02-08,13:00:00,123,65,58,FMN 12 Statielei
660,Statielei 26,2023-02-08,14:00:00,129,62,67,FMN 12 Statielei
660,Statielei 26,2023-02-08,15:00:00,101,46,55,FMN 12 Statielei
660,Statielei 26,2023-02-08,16:00:00,154,74,80,FMN 12 Statielei
660,Statielei 26,2023-02-08,17:00:00,207,103,104,FMN 12 Statielei
660,Statielei 26,2023-02-08,18:00:00,168,73,95,FMN 12 Statielei
660,Statielei 26,2023-02-08,19:00:00,112,51,61,FMN 12 Statielei
660,Statielei 26,2023-02-08,20:00:00,74,39,35,FMN 12 Statielei
660,Statielei 26,2023-02-08,21:00:00,49,25,24,FMN 12 Statielei
660,Statielei 26,2023-02-08,22:00:00,44,20,24,FMN 12 Statielei
660,Statielei 26,2023-02-08,23:00:00,33,14,19,FMN 12 Statielei
660,Statielei 26,2023-02-09,00:00:00,13,5,8,FMN 12 Statielei
660,Statielei 26,2023-02-09,01:00:00,6,3,3,FMN 12 Statielei
660,Statielei 26,2023-02-09,02:00:00,3,1,2,FMN 12 Statielei
660,Statielei 26,2023-02-09,03:00:00,0,0,0,FMN 12 Statielei
660,Statielei 26,2023-02-09,04:00:00,10,6,4,FMN 12 Statielei
660,Statielei 26,2023-02-09,05:00:00,21,13,8,FMN 12 Statielei
660,Statielei 26,2023-02-09,06:00:00,17,9,8,FMN 12 Statielei
660,Statielei 26,2023-02-09,07:00:00,114,52,62,FMN 12 Statielei
660,Statielei 26,2023-02-09,08:00:00,258,142,116,FMN 12 Statielei
660,Statielei 26,2023-02-09,09:00:00,115,78,37,FMN 12 Statielei
660,Statielei 26,2023-02-09,10:00:00,55,34,21,FMN 12 Statielei
660,Statielei 26,2023-02-09,11:00:00,66,33,33,FMN 12 Statielei
660,Statielei 26,2023-02-09,12:00:00,97,51,46,FMN 12 Statielei
660,Statielei 26,2023-02-09,13:00:00,80,46,34,FMN 12 Statielei
660,Statielei 26,2023-02-09,14:00:00,76,34,42,FMN 12 Statielei
660,Statielei 26,2023-02-09,15:00:00,147,61,86,FMN 12 Statielei
660,Statielei 26,2023-02-09,16:00:00,229,116,113,FMN 12 Statielei
660,Statielei 26,2023-02-09,17:00:00,197,90,107,FMN 12 Statielei
660,Statielei 26,2023-02-09,18:00:00,177,82,95,FMN 12 Statielei
660,Statielei 26,2023-02-09,19:00:00,115,75,40,FMN 12 Statielei
660,Statielei 26,2023-02-09,20:00:00,76,49,27,FMN 12 Statielei
660,Statielei 26,2023-02-09,21:00:00,60,24,36,FMN 12 Statielei
660,Statielei 26,2023-02-09,22:00:00,59,22,37,FMN 12 Statielei
660,Statielei 26,2023-02-09,23:00:00,27,6,21,FMN 12 Statielei
660,Statielei 26,2023-02-10,00:00:00,18,5,13,FMN 12 Statielei
660,Statielei 26,2023-02-10,01:00:00,12,3,9,FMN 12 Statielei
660,Statielei 26,2023-02-10,02:00:00,1,0,1,FMN 12 Statielei
660,Statielei 26,2023-02-10,03:00:00,4,1,3,FMN 12 Statielei
660,Statielei 26,2023-02-10,04:00:00,11,7,4,FMN 12 Statielei
660,Statielei 26,2023-02-10,05:00:00,14,7,7,FMN 12 Statielei
660,Statielei 26,2023-02-10,06:00:00,26,14,12,FMN 12 Statielei
660,Statielei 26,2023-02-10,07:00:00,101,51,50,FMN 12 Statielei
660,Statielei 26,2023-02-10,08:00:00,212,121,91,FMN 12 Statielei
660,Statielei 26,2023-02-10,09:00:00,108,75,33,FMN 12 Statielei
660,Statielei 26,2023-02-10,10:00:00,70,38,32,FMN 12 Statielei
660,Statielei 26,2023-02-10,11:00:00,70,36,34,FMN 12 Statielei
660,Statielei 26,2023-02-10,12:00:00,98,52,46,FMN 12 Statielei
660,Statielei 26,2023-02-10,13:00:00,80,42,38,FMN 12 Statielei
660,Statielei 26,2023-02-10,14:00:00,99,39,60,FMN 12 Statielei
660,Statielei 26,2023-02-10,15:00:00,164,78,86,FMN 12 Statielei
660,Statielei 26,2023-02-10,16:00:00,189,97,92,FMN 12 Statielei
660,Statielei 26,2023-02-10,17:00:00,173,90,83,FMN 12 Statielei
660,Statielei 26,2023-02-10,18:00:00,171,76,95,FMN 12 Statielei
660,Statielei 26,2023-02-10,19:00:00,121,61,60,FMN 12 Statielei
660,Statielei 26,2023-02-10,20:00:00,118,58,60,FMN 12 Statielei
660,Statielei 26,2023-02-10,21:00:00,68,32,36,FMN 12 Statielei
660,Statielei 26,2023-02-10,22:00:00,69,32,37,FMN 12 Statielei
660,Statielei 26,2023-02-10,23:00:00,51,30,21,FMN 12 Statielei
660,Statielei 26,2023-02-11,00:00:00,48,27,21,FMN 12 Statielei
660,Statielei 26,2023-02-11,01:00:00,46,21,25,FMN 12 Statielei
660,Statielei 26,2023-02-11,02:00:00,20,13,7,FMN 12 Statielei
660,Statielei 26,2023-02-11,03:00:00,15,9,6,FMN 12 Statielei
660,Statielei 26,2023-02-11,04:00:00,9,6,3,FMN 12 Statielei
660,Statielei 26,2023-02-11,05:00:00,14,13,1,FMN 12 Statielei
660,Statielei 26,2023-02-11,06:00:00,9,3,6,FMN 12 Statielei
660,Statielei 26,2023-02-11,07:00:00,13,4,9,FMN 12 Statielei
660,Statielei 26,2023-02-11,08:00:00,53,21,32,FMN 12 Statielei
660,Statielei 26,2023-02-11,09:00:00,86,34,52,FMN 12 Statielei
660,Statielei 26,2023-02-11,10:00:00,88,38,50,FMN 12 Statielei
660,Statielei 26,2023-02-11,11:00:00,154,73,81,FMN 12 Statielei
660,Statielei 26,2023-02-11,12:00:00,117,75,42,FMN 12 Statielei
660,Statielei 26,2023-02-11,13:00:00,160,88,72,FMN 12 Statielei
660,Statielei 26,2023-02-11,14:00:00,126,54,72,FMN 12 Statielei
660,Statielei 26,2023-02-11,15:00:00,106,65,41,FMN 12 Statielei
660,Statielei 26,2023-02-11,16:00:00,126,72,54,FMN 12 Statielei
660,Statielei 26,2023-02-11,17:00:00,140,85,55,FMN 12 Statielei
660,Statielei 26,2023-02-11,18:00:00,109,68,41,FMN 12 Statielei
660,Statielei 26,2023-02-11,19:00:00,118,69,49,FMN 12 Statielei
660,Statielei 26,2023-02-11,20:00:00,116,52,64,FMN 12 Statielei
660,Statielei 26,2023-02-11,21:00:00,54,21,33,FMN 12 Statielei
660,Statielei 26,2023-02-11,22:00:00,56,27,29,FMN 12 Statielei
660,Statielei 26,2023-02-11,23:00:00,74,32,42,FMN 12 Statielei
660,Statielei 26,2023-02-12,00:00:00,72,35,37,FMN 12 Statielei
660,Statielei 26,2023-02-12,01:00:00,47,27,20,FMN 12 Statielei
660,Statielei 26,2023-02-12,02:00:00,36,27,9,FMN 12 Statielei
660,Statielei 26,2023-02-12,03:00:00,15,12,3,FMN 12 Statielei
660,Statielei 26,2023-02-12,04:00:00,10,6,4,FMN 12 Statielei
660,Statielei 26,2023-02-12,05:00:00,4,3,1,FMN 12 Statielei
660,Statielei 26,2023-02-12,06:00:00,10,6,4,FMN 12 Statielei
660,Statielei 26,2023-02-12,07:00:00,10,4,6,FMN 12 Statielei
660,Statielei 26,2023-02-12,08:00:00,29,16,13,FMN 12 Statielei
660,Statielei 26,2023-02-12,09:00:00,79,29,50,FMN 12 Statielei
660,Statielei 26,2023-02-12,10:00:00,93,43,50,FMN 12 Statielei
660,Statielei 26,2023-02-12,11:00:00,73,37,36,FMN 12 Statielei
660,Statielei 26,2023-02-12,12:00:00,116,70,46,FMN 12 Statielei
660,Statielei 26,2023-02-12,13:00:00,119,60,59,FMN 12 Statielei
660,Statielei 26,2023-02-12,14:00:00,116,56,60,FMN 12 Statielei
660,Statielei 26,2023-02-12,15:00:00,103,57,46,FMN 12 Statielei
660,Statielei 26,2023-02-12,16:00:00,99,63,36,FMN 12 Statielei
660,Statielei 26,2023-02-12,17:00:00,108,65,43,FMN 12 Statielei
660,Statielei 26,2023-02-12,18:00:00,98,55,43,FMN 12 Statielei
660,Statielei 26,2023-02-12,19:00:00,65,32,33,FMN 12 Statielei
660,Statielei 26,2023-02-12,20:00:00,61,29,32,FMN 12 Statielei
660,Statielei 26,2023-02-12,21:00:00,38,20,18,FMN 12 Statielei
660,Statielei 26,2023-02-12,22:00:00,42,14,28,FMN 12 Statielei
660,Statielei 26,2023-02-12,23:00:00,20,7,13,FMN 12 Statielei
660,Statielei 26,2023-02-13,00:00:00,13,6,7,FMN 12 Statielei
660,Statielei 26,2023-02-13,01:00:00,5,4,1,FMN 12 Statielei
660,Statielei 26,2023-02-13,02:00:00,6,3,3,FMN 12 Statielei
660,Statielei 26,2023-02-13,03:00:00,3,1,2,FMN 12 Statielei
660,Statielei 26,2023-02-13,04:00:00,8,4,4,FMN 12 Statielei
660,Statielei 26,2023-02-13,05:00:00,13,8,5,FMN 12 Statielei
660,Statielei 26,2023-02-13,06:00:00,29,12,17,FMN 12 Statielei
660,Statielei 26,2023-02-13,07:00:00,112,51,61,FMN 12 Statielei
660,Statielei 26,2023-02-13,08:00:00,249,132,117,FMN 12 Statielei
660,Statielei 26,2023-02-13,09:00:00,99,66,33,FMN 12 Statielei
660,Statielei 26,2023-02-13,10:00:00,58,31,27,FMN 12 Statielei
660,Statielei 26,2023-02-13,11:00:00,65,35,30,FMN 12 Statielei
660,Statielei 26,2023-02-13,12:00:00,125,67,58,FMN 12 Statielei
660,Statielei 26,2023-02-13,13:00:00,105,52,53,FMN 12 Statielei
660,Statielei 26,2023-02-13,14:00:00,86,49,37,FMN 12 Statielei
660,Statielei 26,2023-02-13,15:00:00,157,78,79,FMN 12 Statielei
660,Statielei 26,2023-02-13,16:00:00,254,125,129,FMN 12 Statielei
660,Statielei 26,2023-02-13,17:00:00,207,95,112,FMN 12 Statielei
660,Statielei 26,2023-02-13,18:00:00,146,78,68,FMN 12 Statielei
660,Statielei 26,2023-02-13,19:00:00,116,59,57,FMN 12 Statielei
660,Statielei 26,2023-02-13,20:00:00,61,33,28,FMN 12 Statielei
660,Statielei 26,2023-02-13,21:00:00,65,32,33,FMN 12 Statielei
660,Statielei 26,2023-02-13,22:00:00,48,21,27,FMN 12 Statielei
660,Statielei 26,2023-02-13,23:00:00,29,8,21,FMN 12 Statielei
660,Statielei 26,2023-02-14,00:00:00,16,6,10,FMN 12 Statielei
660,Statielei 26,2023-02-14,01:00:00,7,5,2,FMN 12 Statielei
660,Statielei 26,2023-02-14,02:00:00,3,1,2,FMN 12 Statielei
660,Statielei 26,2023-02-14,03:00:00,1,1,0,FMN 12 Statielei
660,Statielei 26,2023-02-14,04:00:00,10,5,5,FMN 12 Statielei
660,Statielei 26,2023-02-14,05:00:00,20,10,10,FMN 12 Statielei
660,Statielei 26,2023-02-14,06:00:00,35,20,15,FMN 12 Statielei
660,Statielei 26,2023-02-14,07:00:00,133,66,67,FMN 12 Statielei
660,Statielei 26,2023-02-14,08:00:00,279,165,114,FMN 12 Statielei
660,Statielei 26,2023-02-14,09:00:00,116,76,40,FMN 12 Statielei
660,Statielei 26,2023-02-14,10:00:00,94,58,36,FMN 12 Statielei
660,Statielei 26,2023-02-14,11:00:00,87,48,39,FMN 12 Statielei
660,Statielei 26,2023-02-14,12:00:00,98,63,35,FMN 12 Statielei
660,Statielei 26,2023-02-14,13:00:00,102,59,43,FMN 12 Statielei
660,Statielei 26,2023-02-14,14:00:00,104,51,53,FMN 12 Statielei
660,Statielei 26,2023-02-14,15:00:00,189,76,113,FMN 12 Statielei
660,Statielei 26,2023-02-14,16:00:00,258,133,125,FMN 12 Statielei
660,Statielei 26,2023-02-14,17:00:00,254,122,132,FMN 12 Statielei
660,Statielei 26,2023-02-14,18:00:00,172,91,81,FMN 12 Statielei
660,Statielei 26,2023-02-14,19:00:00,139,63,76,FMN 12 Statielei
660,Statielei 26,2023-02-14,20:00:00,90,55,35,FMN 12 Statielei
660,Statielei 26,2023-02-14,21:00:00,61,27,34,FMN 12 Statielei
660,Statielei 26,2023-02-14,22:00:00,72,30,42,FMN 12 Statielei
660,Statielei 26,2023-02-14,23:00:00,41,9,32,FMN 12 Statielei
660,Statielei 26,2023-02-15,00:00:00,16,9,7,FMN 12 Statielei
660,Statielei 26,2023-02-15,01:00:00,9,2,7,FMN 12 Statielei
660,Statielei 26,2023-02-15,02:00:00,4,1,3,FMN 12 Statielei
660,Statielei 26,2023-02-15,03:00:00,3,2,1,FMN 12 Statielei
660,Statielei 26,2023-02-15,04:00:00,8,5,3,FMN 12 Statielei
660,Statielei 26,2023-02-15,05:00:00,16,9,7,FMN 12 Statielei
660,Statielei 26,2023-02-15,06:00:00,34,19,15,FMN 12 Statielei
660,Statielei 26,2023-02-15,07:00:00,120,42,78,FMN 12 Statielei
660,Statielei 26,2023-02-15,08:00:00,257,141,116,FMN 12 Statielei
660,Statielei 26,2023-02-15,09:00:00,90,44,46,FMN 12 Statielei
660,Statielei 26,2023-02-15,10:00:00,90,58,32,FMN 12 Statielei
660,Statielei 26,2023-02-15,11:00:00,90,53,37,FMN 12 Statielei
660,Statielei 26,2023-02-15,12:00:00,201,109,92,FMN 12 Statielei
660,Statielei 26,2023-02-15,13:00:00,138,65,73,FMN 12 Statielei
660,Statielei 26,2023-02-15,14:00:00,100,50,50,FMN 12 Statielei
660,Statielei 26,2023-02-15,15:00:00,139,57,82,FMN 12 Statielei
660,Statielei 26,2023-02-15,16:00:00,182,76,106,FMN 12 Statielei
660,Statielei 26,2023-02-15,17:00:00,202,98,104,FMN 12 Statielei
660,Statielei 26,2023-02-15,18:00:00,157,87,70,FMN 12 Statielei
660,Statielei 26,2023-02-15,19:00:00,127,72,55,FMN 12 Statielei
660,Statielei 26,2023-02-15,20:00:00,81,48,33,FMN 12 Statielei
660,Statielei 26,2023-02-15,21:00:00,73,40,33,FMN 12 Statielei
660,Statielei 26,2023-02-15,22:00:00,72,32,40,FMN 12 Statielei
660,Statielei 26,2023-02-15,23:00:00,39,17,22,FMN 12 Statielei
660,Statielei 26,2023-02-16,00:00:00,26,9,17,FMN 12 Statielei
660,Statielei 26,2023-02-16,01:00:00,9,4,5,FMN 12 Statielei
660,Statielei 26,2023-02-16,02:00:00,3,3,0,FMN 12 Statielei
660,Statielei 26,2023-02-16,03:00:00,1,1,0,FMN 12 Statielei
660,Statielei 26,2023-02-16,04:00:00,7,5,2,FMN 12 Statielei
660,Statielei 26,2023-02-16,05:00:00,15,9,6,FMN 12 Statielei
660,Statielei 26,2023-02-16,06:00:00,31,12,19,FMN 12 Statielei
660,Statielei 26,2023-02-16,07:00:00,130,61,69,FMN 12 Statielei
660,Statielei 26,2023-02-16,08:00:00,283,157,126,FMN 12 Statielei
660,Statielei 26,2023-02-16,09:00:00,90,58,32,FMN 12 Statielei
660,Statielei 26,2023-02-16,10:00:00,62,39,23,FMN 12 Statielei
660,Statielei 26,2023-02-16,11:00:00,73,38,35,FMN 12 Statielei
660,Statielei 26,2023-02-16,12:00:00,114,63,51,FMN 12 Statielei
660,Statielei 26,2023-02-16,13:00:00,87,42,45,FMN 12 Statielei
660,Statielei 26,2023-02-16,14:00:00,74,38,36,FMN 12 Statielei
660,Statielei 26,2023-02-16,15:00:00,145,65,80,FMN 12 Statielei
660,Statielei 26,2023-02-16,16:00:00,220,107,113,FMN 12 Statielei
660,Statielei 26,2023-02-16,17:00:00,193,91,102,FMN 12 Statielei
660,Statielei 26,2023-02-16,18:00:00,148,72,76,FMN 12 Statielei
660,Statielei 26,2023-02-16,19:00:00,102,62,40,FMN 12 Statielei
660,Statielei 26,2023-02-16,20:00:00,91,59,32,FMN 12 Statielei
660,Statielei 26,2023-02-16,21:00:00,55,27,28,FMN 12 Statielei
660,Statielei 26,2023-02-16,22:00:00,63,23,40,FMN 12 Statielei
660,Statielei 26,2023-02-16,23:00:00,44,10,34,FMN 12 Statielei
660,Statielei 26,2023-02-17,00:00:00,24,12,12,FMN 12 Statielei
660,Statielei 26,2023-02-17,01:00:00,9,4,5,FMN 12 Statielei
660,Statielei 26,2023-02-17,02:00:00,8,3,5,FMN 12 Statielei
660,Statielei 26,2023-02-17,03:00:00,8,5,3,FMN 12 Statielei
660,Statielei 26,2023-02-17,04:00:00,8,5,3,FMN 12 Statielei
660,Statielei 26,2023-02-17,05:00:00,9,6,3,FMN 12 Statielei
660,Statielei 26,2023-02-17,06:00:00,37,15,22,FMN 12 Statielei
660,Statielei 26,2023-02-17,07:00:00,114,51,63,FMN 12 Statielei
660,Statielei 26,2023-02-17,08:00:00,205,117,88,FMN 12 Statielei
660,Statielei 26,2023-02-17,09:00:00,94,64,30,FMN 12 Statielei
660,Statielei 26,2023-02-17,10:00:00,81,41,40,FMN 12 Statielei
660,Statielei 26,2023-02-17,11:00:00,65,43,22,FMN 12 Statielei
660,Statielei 26,2023-02-17,12:00:00,100,48,52,FMN 12 Statielei
660,Statielei 26,2023-02-17,13:00:00,87,42,45,FMN 12 Statielei
660,Statielei 26,2023-02-17,14:00:00,107,45,62,FMN 12 Statielei
660,Statielei 26,2023-02-17,15:00:00,179,88,91,FMN 12 Statielei
660,Statielei 26,2023-02-17,16:00:00,202,103,99,FMN 12 Statielei
660,Statielei 26,2023-02-17,17:00:00,170,74,96,FMN 12 Statielei
660,Statielei 26,2023-02-17,18:00:00,147,69,78,FMN 12 Statielei
660,Statielei 26,2023-02-17,19:00:00,111,53,58,FMN 12 Statielei
660,Statielei 26,2023-02-17,20:00:00,97,45,52,FMN 12 Statielei
660,Statielei 26,2023-02-17,21:00:00,55,29,26,FMN 12 Statielei
660,Statielei 26,2023-02-17,22:00:00,71,28,43,FMN 12 Statielei
660,Statielei 26,2023-02-17,23:00:00,64,24,40,FMN 12 Statielei
660,Statielei 26,2023-02-18,00:00:00,52,28,24,FMN 12 Statielei
660,Statielei 26,2023-02-18,01:00:00,24,10,14,FMN 12 Statielei
660,Statielei 26,2023-02-18,02:00:00,19,7,12,FMN 12 Statielei
660,Statielei 26,2023-02-18,03:00:00,8,3,5,FMN 12 Statielei
660,Statielei 26,2023-02-18,04:00:00,9,6,3,FMN 12 Statielei
660,Statielei 26,2023-02-18,05:00:00,8,0,8,FMN 12 Statielei
660,Statielei 26,2023-02-18,06:00:00,13,7,6,FMN 12 Statielei
660,Statielei 26,2023-02-18,07:00:00,13,7,6,FMN 12 Statielei
660,Statielei 26,2023-02-18,08:00:00,30,13,17,FMN 12 Statielei
660,Statielei 26,2023-02-18,09:00:00,86,43,43,FMN 12 Statielei
660,Statielei 26,2023-02-18,10:00:00,86,39,47,FMN 12 Statielei
660,Statielei 26,2023-02-18,11:00:00,89,48,41,FMN 12 Statielei
660,Statielei 26,2023-02-18,12:00:00,96,48,48,FMN 12 Statielei
660,Statielei 26,2023-02-18,13:00:00,116,60,56,FMN 12 Statielei
660,Statielei 26,2023-02-18,14:00:00,113,54,59,FMN 12 Statielei
660,Statielei 26,2023-02-18,15:00:00,93,43,50,FMN 12 Statielei
660,Statielei 26,2023-02-18,16:00:00,120,60,60,FMN 12 Statielei
660,Statielei 26,2023-02-18,17:00:00,115,64,51,FMN 12 Statielei
660,Statielei 26,2023-02-18,18:00:00,131,90,41,FMN 12 Statielei
660,Statielei 26,2023-02-18,19:00:00,91,53,38,FMN 12 Statielei
660,Statielei 26,2023-02-18,20:00:00,77,42,35,FMN 12 Statielei
660,Statielei 26,2023-02-18,21:00:00,61,44,17,FMN 12 Statielei
660,Statielei 26,2023-02-18,22:00:00,54,21,33,FMN 12 Statielei
660,Statielei 26,2023-02-18,23:00:00,63,25,38,FMN 12 Statielei
660,Statielei 26,2023-02-19,00:00:00,41,18,23,FMN 12 Statielei
660,Statielei 26,2023-02-19,01:00:00,31,11,20,FMN 12 Statielei
660,Statielei 26,2023-02-19,02:00:00,24,13,11,FMN 12 Statielei
660,Statielei 26,2023-02-19,03:00:00,10,5,5,FMN 12 Statielei
660,Statielei 26,2023-02-19,04:00:00,11,6,5,FMN 12 Statielei
660,Statielei 26,2023-02-19,05:00:00,11,3,8,FMN 12 Statielei
660,Statielei 26,2023-02-19,06:00:00,8,6,2,FMN 12 Statielei
660,Statielei 26,2023-02-19,07:00:00,12,5,7,FMN 12 Statielei
660,Statielei 26,2023-02-19,08:00:00,34,13,21,FMN 12 Statielei
660,Statielei 26,2023-02-19,09:00:00,79,28,51,FMN 12 Statielei
660,Statielei 26,2023-02-19,10:00:00,66,19,47,FMN 12 Statielei
660,Statielei 26,2023-02-19,11:00:00,61,30,31,FMN 12 Statielei
660,Statielei 26,2023-02-19,12:00:00,105,53,52,FMN 12 Statielei
660,Statielei 26,2023-02-19,13:00:00,98,59,39,FMN 12 Statielei
660,Statielei 26,2023-02-19,14:00:00,107,51,56,FMN 12 Statielei
660,Statielei 26,2023-02-19,15:00:00,76,43,33,FMN 12 Statielei
660,Statielei 26,2023-02-19,16:00:00,78,38,40,FMN 12 Statielei
660,Statielei 26,2023-02-19,17:00:00,106,57,49,FMN 12 Statielei
660,Statielei 26,2023-02-19,18:00:00,83,48,35,FMN 12 Statielei
660,Statielei 26,2023-02-19,19:00:00,63,37,26,FMN 12 Statielei
660,Statielei 26,2023-02-19,20:00:00,52,26,26,FMN 12 Statielei
660,Statielei 26,2023-02-19,21:00:00,43,24,19,FMN 12 Statielei
660,Statielei 26,2023-02-19,22:00:00,49,17,32,FMN 12 Statielei
660,Statielei 26,2023-02-19,23:00:00,22,5,17,FMN 12 Statielei
660,Statielei 26,2023-02-20,00:00:00,19,5,14,FMN 12 Statielei
660,Statielei 26,2023-02-20,01:00:00,6,5,1,FMN 12 Statielei
660,Statielei 26,2023-02-20,02:00:00,1,0,1,FMN 12 Statielei
660,Statielei 26,2023-02-20,03:00:00,4,1,3,FMN 12 Statielei
660,Statielei 26,2023-02-20,04:00:00,9,3,6,FMN 12 Statielei
660,Statielei 26,2023-02-20,05:00:00,18,9,9,FMN 12 Statielei
660,Statielei 26,2023-02-20,06:00:00,20,10,10,FMN 12 Statielei
660,Statielei 26,2023-02-20,07:00:00,71,27,44,FMN 12 Statielei
660,Statielei 26,2023-02-20,08:00:00,122,77,45,FMN 12 Statielei
660,Statielei 26,2023-02-20,09:00:00,87,46,41,FMN 12 Statielei
660,Statielei 26,2023-02-20,10:00:00,53,31,22,FMN 12 Statielei
660,Statielei 26,2023-02-20,11:00:00,83,34,49,FMN 12 Statielei
660,Statielei 26,2023-02-20,12:00:00,93,47,46,FMN 12 Statielei
660,Statielei 26,2023-02-20,13:00:00,82,43,39,FMN 12 Statielei
660,Statielei 26,2023-02-20,14:00:00,62,32,30,FMN 12 Statielei
660,Statielei 26,2023-02-20,15:00:00,85,41,44,FMN 12 Statielei
660,Statielei 26,2023-02-20,16:00:00,134,72,62,FMN 12 Statielei
660,Statielei 26,2023-02-20,17:00:00,154,85,69,FMN 12 Statielei
660,Statielei 26,2023-02-20,18:00:00,120,57,63,FMN 12 Statielei
660,Statielei 26,2023-02-20,19:00:00,73,34,39,FMN 12 Statielei
660,Statielei 26,2023-02-20,20:00:00,62,32,30,FMN 12 Statielei
660,Statielei 26,2023-02-20,21:00:00,45,21,24,FMN 12 Statielei
660,Statielei 26,2023-02-20,22:00:00,46,20,26,FMN 12 Statielei
660,Statielei 26,2023-02-20,23:00:00,21,8,13,FMN 12 Statielei
660,Statielei 26,2023-02-21,00:00:00,16,5,11,FMN 12 Statielei
660,Statielei 26,2023-02-21,01:00:00,6,3,3,FMN 12 Statielei
660,Statielei 26,2023-02-21,02:00:00,5,2,3,FMN 12 Statielei
660,Statielei 26,2023-02-21,03:00:00,3,2,1,FMN 12 Statielei
660,Statielei 26,2023-02-21,04:00:00,9,6,3,FMN 12 Statielei
660,Statielei 26,2023-02-21,05:00:00,13,7,6,FMN 12 Statielei
660,Statielei 26,2023-02-21,06:00:00,27,13,14,FMN 12 Statielei
660,Statielei 26,2023-02-21,07:00:00,84,39,45,FMN 12 Statielei
660,Statielei 26,2023-02-21,08:00:00,118,70,48,FMN 12 Statielei
660,Statielei 26,2023-02-21,09:00:00,90,53,37,FMN 12 Statielei
660,Statielei 26,2023-02-21,10:00:00,69,32,37,FMN 12 Statielei
660,Statielei 26,2023-02-21,11:00:00,47,30,17,FMN 12 Statielei
660,Statielei 26,2023-02-21,12:00:00,79,43,36,FMN 12 Statielei
660,Statielei 26,2023-02-21,13:00:00,78,35,43,FMN 12 Statielei
660,Statielei 26,2023-02-21,14:00:00,100,58,42,FMN 12 Statielei
660,Statielei 26,2023-02-21,15:00:00,93,41,52,FMN 12 Statielei
660,Statielei 26,2023-02-21,16:00:00,120,65,55,FMN 12 Statielei
660,Statielei 26,2023-02-21,17:00:00,147,68,79,FMN 12 Statielei
660,Statielei 26,2023-02-21,18:00:00,117,61,56,FMN 12 Statielei
660,Statielei 26,2023-02-21,19:00:00,100,52,48,FMN 12 Statielei
660,Statielei 26,2023-02-21,20:00:00,87,50,37,FMN 12 Statielei
660,Statielei 26,2023-02-21,21:00:00,51,14,37,FMN 12 Statielei
660,Statielei 26,2023-02-21,22:00:00,64,35,29,FMN 12 Statielei
660,Statielei 26,2023-02-21,23:00:00,47,17,30,FMN 12 Statielei
660,Statielei 26,2023-02-22,00:00:00,19,11,8,FMN 12 Statielei
660,Statielei 26,2023-02-22,01:00:00,6,2,4,FMN 12 Statielei
660,Statielei 26,2023-02-22,02:00:00,2,1,1,FMN 12 Statielei
660,Statielei 26,2023-02-22,03:00:00,5,2,3,FMN 12 Statielei
660,Statielei 26,2023-02-22,04:00:00,8,5,3,FMN 12 Statielei
660,Statielei 26,2023-02-22,05:00:00,12,6,6,FMN 12 Statielei
660,Statielei 26,2023-02-22,06:00:00,25,13,12,FMN 12 Statielei
660,Statielei 26,2023-02-22,07:00:00,59,28,31,FMN 12 Statielei
660,Statielei 26,2023-02-22,08:00:00,94,52,42,FMN 12 Statielei
660,Statielei 26,2023-02-22,09:00:00,85,47,38,FMN 12 Statielei
660,Statielei 26,2023-02-22,10:00:00,69,43,26,FMN 12 Statielei
660,Statielei 26,2023-02-22,11:00:00,58,31,27,FMN 12 Statielei
660,Statielei 26,2023-02-22,12:00:00,74,34,40,FMN 12 Statielei
660,Statielei 26,2023-02-22,13:00:00,58,25,33,FMN 12 Statielei
660,Statielei 26,2023-02-22,14:00:00,79,36,43,FMN 12 Statielei
660,Statielei 26,2023-02-22,15:00:00,92,36,56,FMN 12 Statielei
660,Statielei 26,2023-02-22,16:00:00,133,69,64,FMN 12 Statielei
660,Statielei 26,2023-02-22,17:00:00,132,72,60,FMN 12 Statielei
660,Statielei 26,2023-02-22,18:00:00,121,62,59,FMN 12 Statielei
660,Statielei 26,2023-02-22,19:00:00,110,61,49,FMN 12 Statielei
660,Statielei 26,2023-02-22,20:00:00,86,29,57,FMN 12 Statielei
660,Statielei 26,2023-02-22,21:00:00,62,24,38,FMN 12 Statielei
660,Statielei 26,2023-02-22,22:00:00,76,44,32,FMN 12 Statielei
660,Statielei 26,2023-02-22,23:00:00,61,26,35,FMN 12 Statielei
660,Statielei 26,2023-02-23,00:00:00,23,7,16,FMN 12 Statielei
660,Statielei 26,2023-02-23,01:00:00,9,7,2,FMN 12 Statielei
660,Statielei 26,2023-02-23,02:00:00,5,0,5,FMN 12 Statielei
660,Statielei 26,2023-02-23,03:00:00,4,2,2,FMN 12 Statielei
660,Statielei 26,2023-02-23,04:00:00,12,9,3,FMN 12 Statielei
660,Statielei 26,2023-02-23,05:00:00,12,4,8,FMN 12 Statielei
660,Statielei 26,2023-02-23,06:00:00,26,13,13,FMN 12 Statielei
660,Statielei 26,2023-02-23,07:00:00,69,30,39,FMN 12 Statielei
660,Statielei 26,2023-02-23,08:00:00,112,64,48,FMN 12 Statielei
660,Statielei 26,2023-02-23,09:00:00,69,43,26,FMN 12 Statielei
660,Statielei 26,2023-02-23,10:00:00,69,42,27,FMN 12 Statielei
660,Statielei 26,2023-02-23,11:00:00,82,42,40,FMN 12 Statielei
660,Statielei 26,2023-02-23,12:00:00,82,42,40,FMN 12 Statielei
660,Statielei 26,2023-02-23,13:00:00,89,44,45,FMN 12 Statielei
660,Statielei 26,2023-02-23,14:00:00,84,48,36,FMN 12 Statielei
660,Statielei 26,2023-02-23,15:00:00,109,52,57,FMN 12 Statielei
660,Statielei 26,2023-02-23,16:00:00,123,63,60,FMN 12 Statielei
660,Statielei 26,2023-02-23,17:00:00,145,86,59,FMN 12 Statielei
660,Statielei 26,2023-02-23,18:00:00,145,71,74,FMN 12 Statielei
660,Statielei 26,2023-02-23,19:00:00,108,62,46,FMN 12 Statielei
660,Statielei 26,2023-02-23,20:00:00,90,39,51,FMN 12 Statielei
660,Statielei 26,2023-02-23,21:00:00,46,19,27,FMN 12 Statielei
660,Statielei 26,2023-02-23,22:00:00,72,35,37,FMN 12 Statielei
660,Statielei 26,2023-02-23,23:00:00,55,14,41,FMN 12 Statielei
660,Statielei 26,2023-02-24,00:00:00,26,7,19,FMN 12 Statielei
660,Statielei 26,2023-02-24,01:00:00,13,7,6,FMN 12 Statielei
660,Statielei 26,2023-02-24,02:00:00,4,3,1,FMN 12 Statielei
660,Statielei 26,2023-02-24,03:00:00,5,3,2,FMN 12 Statielei
660,Statielei 26,2023-02-24,04:00:00,12,9,3,FMN 12 Statielei
660,Statielei 26,2023-02-24,05:00:00,12,8,4,FMN 12 Statielei
660,Statielei 26,2023-02-24,06:00:00,28,15,13,FMN 12 Statielei
660,Statielei 26,2023-02-24,07:00:00,56,28,28,FMN 12 Statielei
660,Statielei 26,2023-02-24,08:00:00,92,43,49,FMN 12 Statielei
660,Statielei 26,2023-02-24,09:00:00,103,64,39,FMN 12 Statielei
660,Statielei 26,2023-02-24,10:00:00,56,29,27,FMN 12 Statielei
660,Statielei 26,2023-02-24,11:00:00,86,45,41,FMN 12 Statielei
660,Statielei 26,2023-02-24,12:00:00,86,47,39,FMN 12 Statielei
660,Statielei 26,2023-02-24,13:00:00,75,44,31,FMN 12 Statielei
660,Statielei 26,2023-02-24,14:00:00,71,32,39,FMN 12 Statielei
660,Statielei 26,2023-02-24,15:00:00,90,36,54,FMN 12 Statielei
660,Statielei 26,2023-02-24,16:00:00,118,61,57,FMN 12 Statielei
660,Statielei 26,2023-02-24,17:00:00,124,65,59,FMN 12 Statielei
660,Statielei 26,2023-02-24,18:00:00,119,58,61,FMN 12 Statielei
660,Statielei 26,2023-02-24,19:00:00,87,50,37,FMN 12 Statielei
660,Statielei 26,2023-02-24,20:00:00,89,50,39,FMN 12 Statielei
660,Statielei 26,2023-02-24,21:00:00,49,21,28,FMN 12 Statielei
660,Statielei 26,2023-02-24,22:00:00,43,14,29,FMN 12 Statielei
660,Statielei 26,2023-02-24,23:00:00,47,13,34,FMN 12 Statielei
660,Statielei 26,2023-02-25,00:00:00,46,15,31,FMN 12 Statielei
660,Statielei 26,2023-02-25,01:00:00,18,9,9,FMN 12 Statielei
660,Statielei 26,2023-02-25,02:00:00,15,8,7,FMN 12 Statielei
660,Statielei 26,2023-02-25,03:00:00,5,2,3,FMN 12 Statielei
660,Statielei 26,2023-02-25,04:00:00,7,4,3,FMN 12 Statielei
660,Statielei 26,2023-02-25,05:00:00,6,6,0,FMN 12 Statielei
660,Statielei 26,2023-02-25,06:00:00,9,6,3,FMN 12 Statielei
660,Statielei 26,2023-02-25,07:00:00,11,1,10,FMN 12 Statielei
660,Statielei 26,2023-02-25,08:00:00,34,17,17,FMN 12 Statielei
660,Statielei 26,2023-02-25,09:00:00,73,41,32,FMN 12 Statielei
660,Statielei 26,2023-02-25,10:00:00,65,37,28,FMN 12 Statielei
660,Statielei 26,2023-02-25,11:00:00,104,65,39,FMN 12 Statielei
660,Statielei 26,2023-02-25,12:00:00,79,42,37,FMN 12 Statielei
660,Statielei 26,2023-02-25,13:00:00,98,54,44,FMN 12 Statielei
660,Statielei 26,2023-02-25,14:00:00,87,47,40,FMN 12 Statielei
660,Statielei 26,2023-02-25,15:00:00,75,42,33,FMN 12 Statielei
660,Statielei 26,2023-02-25,16:00:00,104,54,50,FMN 12 Statielei
660,Statielei 26,2023-02-25,17:00:00,127,66,61,FMN 12 Statielei
660,Statielei 26,2023-02-25,18:00:00,101,58,43,FMN 12 Statielei
660,Statielei 26,2023-02-25,19:00:00,70,47,23,FMN 12 Statielei
660,Statielei 26,2023-02-25,20:00:00,52,22,30,FMN 12 Statielei
660,Statielei 26,2023-02-25,21:00:00,63,36,27,FMN 12 Statielei
660,Statielei 26,2023-02-25,22:00:00,51,22,29,FMN 12 Statielei
660,Statielei 26,2023-02-25,23:00:00,51,17,34,FMN 12 Statielei
660,Statielei 26,2023-02-26,00:00:00,48,17,31,FMN 12 Statielei
660,Statielei 26,2023-02-26,01:00:00,33,8,25,FMN 12 Statielei
660,Statielei 26,2023-02-26,02:00:00,23,8,15,FMN 12 Statielei
660,Statielei 26,2023-02-26,03:00:00,21,8,13,FMN 12 Statielei
660,Statielei 26,2023-02-26,04:00:00,10,6,4,FMN 12 Statielei
660,Statielei 26,2023-02-26,05:00:00,18,12,6,FMN 12 Statielei
660,Statielei 26,2023-02-26,06:00:00,10,4,6,FMN 12 Statielei
660,Statielei 26,2023-02-26,07:00:00,8,1,7,FMN 12 Statielei
660,Statielei 26,2023-02-26,08:00:00,30,18,12,FMN 12 Statielei
660,Statielei 26,2023-02-26,09:00:00,79,26,53,FMN 12 Statielei
660,Statielei 26,2023-02-26,10:00:00,51,25,26,FMN 12 Statielei
660,Statielei 26,2023-02-26,11:00:00,80,39,41,FMN 12 Statielei
660,Statielei 26,2023-02-26,12:00:00,104,60,44,FMN 12 Statielei
660,Statielei 26,2023-02-26,13:00:00,104,54,50,FMN 12 Statielei
660,Statielei 26,2023-02-26,14:00:00,77,38,39,FMN 12 Statielei
660,Statielei 26,2023-02-26,15:00:00,144,77,67,FMN 12 Statielei
660,Statielei 26,2023-02-26,16:00:00,93,46,47,FMN 12 Statielei
660,Statielei 26,2023-02-26,17:00:00,92,47,45,FMN 12 Statielei
660,Statielei 26,2023-02-26,18:00:00,85,47,38,FMN 12 Statielei
660,Statielei 26,2023-02-26,19:00:00,62,36,26,FMN 12 Statielei
660,Statielei 26,2023-02-26,20:00:00,53,20,33,FMN 12 Statielei
660,Statielei 26,2023-02-26,21:00:00,33,7,26,FMN 12 Statielei
660,Statielei 26,2023-02-26,22:00:00,34,14,20,FMN 12 Statielei
660,Statielei 26,2023-02-26,23:00:00,15,11,4,FMN 12 Statielei
660,Statielei 26,2023-02-27,00:00:00,18,9,9,FMN 12 Statielei
660,Statielei 26,2023-02-27,01:00:00,4,4,0,FMN 12 Statielei
660,Statielei 26,2023-02-27,02:00:00,6,1,5,FMN 12 Statielei
660,Statielei 26,2023-02-27,03:00:00,2,1,1,FMN 12 Statielei
660,Statielei 26,2023-02-27,04:00:00,7,5,2,FMN 12 Statielei
660,Statielei 26,2023-02-27,05:00:00,19,11,8,FMN 12 Statielei
660,Statielei 26,2023-02-27,06:00:00,32,17,15,FMN 12 Statielei
660,Statielei 26,2023-02-27,07:00:00,102,39,63,FMN 12 Statielei
660,Statielei 26,2023-02-27,08:00:00,261,145,116,FMN 12 Statielei
660,Statielei 26,2023-02-27,09:00:00,96,64,32,FMN 12 Statielei
660,Statielei 26,2023-02-27,10:00:00,80,52,28,FMN 12 Statielei
660,Statielei 26,2023-02-27,11:00:00,73,39,34,FMN 12 Statielei
660,Statielei 26,2023-02-27,12:00:00,89,50,39,FMN 12 Statielei
660,Statielei 26,2023-02-27,13:00:00,71,37,34,FMN 12 Statielei
660,Statielei 26,2023-02-27,14:00:00,100,52,48,FMN 12 Statielei
660,Statielei 26,2023-02-27,15:00:00,155,70,85,FMN 12 Statielei
660,Statielei 26,2023-02-27,16:00:00,225,109,116,FMN 12 Statielei
660,Statielei 26,2023-02-27,17:00:00,214,105,109,FMN 12 Statielei
660,Statielei 26,2023-02-27,18:00:00,130,69,61,FMN 12 Statielei
660,Statielei 26,2023-02-27,19:00:00,115,66,49,FMN 12 Statielei
660,Statielei 26,2023-02-27,20:00:00,79,26,53,FMN 12 Statielei
660,Statielei 26,2023-02-27,21:00:00,55,26,29,FMN 12 Statielei
660,Statielei 26,2023-02-27,22:00:00,65,36,29,FMN 12 Statielei
660,Statielei 26,2023-02-27,23:00:00,31,13,18,FMN 12 Statielei
660,Statielei 26,2023-02-28,00:00:00,12,7,5,FMN 12 Statielei
660,Statielei 26,2023-02-28,01:00:00,5,3,2,FMN 12 Statielei
660,Statielei 26,2023-02-28,02:00:00,6,2,4,FMN 12 Statielei
660,Statielei 26,2023-02-28,03:00:00,2,0,2,FMN 12 Statielei
660,Statielei 26,2023-02-28,04:00:00,5,4,1,FMN 12 Statielei
660,Statielei 26,2023-02-28,05:00:00,20,11,9,FMN 12 Statielei
660,Statielei 26,2023-02-28,06:00:00,31,16,15,FMN 12 Statielei
660,Statielei 26,2023-02-28,07:00:00,129,64,65,FMN 12 Statielei
660,Statielei 26,2023-02-28,08:00:00,270,147,123,FMN 12 Statielei
660,Statielei 26,2023-02-28,09:00:00,106,61,45,FMN 12 Statielei
660,Statielei 26,2023-02-28,10:00:00,82,46,36,FMN 12 Statielei
660,Statielei 26,2023-02-28,11:00:00,61,31,30,FMN 12 Statielei
660,Statielei 26,2023-02-28,12:00:00,103,62,41,FMN 12 Statielei
660,Statielei 26,2023-02-28,13:00:00,102,61,41,FMN 12 Statielei
660,Statielei 26,2023-02-28,14:00:00,96,44,52,FMN 12 Statielei
660,Statielei 26,2023-02-28,15:00:00,179,73,106,FMN 12 Statielei
660,Statielei 26,2023-02-28,16:00:00,215,97,118,FMN 12 Statielei
660,Statielei 26,2023-02-28,17:00:00,199,99,100,FMN 12 Statielei
660,Statielei 26,2023-02-28,18:00:00,138,70,68,FMN 12 Statielei
660,Statielei 26,2023-02-28,19:00:00,119,61,58,FMN 12 Statielei
660,Statielei 26,2023-02-28,20:00:00,99,47,52,FMN 12 Statielei
660,Statielei 26,2023-02-28,21:00:00,51,24,27,FMN 12 Statielei
660,Statielei 26,2023-02-28,22:00:00,67,36,31,FMN 12 Statielei
660,Statielei 26,2023-02-28,23:00:00,53,24,29,FMN 12 Statielei
660,Statielei 26,2023-03-01,00:00:00,20,12,8,FMN 12 Statielei
660,Statielei 26,2023-03-01,01:00:00,9,5,4,FMN 12 Statielei
660,Statielei 26,2023-03-01,02:00:00,3,2,1,FMN 12 Statielei
660,Statielei 26,2023-03-01,03:00:00,0,0,0,FMN 12 Statielei
660,Statielei 26,2023-03-01,04:00:00,8,6,2,FMN 12 Statielei
660,Statielei 26,2023-03-01,05:00:00,11,8,3,FMN 12 Statielei
660,Statielei 26,2023-03-01,06:00:00,25,11,14,FMN 12 Statielei
660,Statielei 26,2023-03-01,07:00:00,113,51,62,FMN 12 Statielei
660,Statielei 26,2023-03-01,08:00:00,250,135,115,FMN 12 Statielei
660,Statielei 26,2023-03-01,09:00:00,105,66,39,FMN 12 Statielei
660,Statielei 26,2023-03-01,10:00:00,69,38,31,FMN 12 Statielei
660,Statielei 26,2023-03-01,11:00:00,71,45,26,FMN 12 Statielei
660,Statielei 26,2023-03-01,12:00:00,189,107,82,FMN 12 Statielei
660,Statielei 26,2023-03-01,13:00:00,140,70,70,FMN 12 Statielei
660,Statielei 26,2023-03-01,14:00:00,108,53,55,FMN 12 Statielei
660,Statielei 26,2023-03-01,15:00:00,94,45,49,FMN 12 Statielei
660,Statielei 26,2023-03-01,16:00:00,153,74,79,FMN 12 Statielei
660,Statielei 26,2023-03-01,17:00:00,188,99,89,FMN 12 Statielei
660,Statielei 26,2023-03-01,18:00:00,178,91,87,FMN 12 Statielei
660,Statielei 26,2023-03-01,19:00:00,111,58,53,FMN 12 Statielei
660,Statielei 26,2023-03-01,20:00:00,74,34,40,FMN 12 Statielei
660,Statielei 26,2023-03-01,21:00:00,69,26,43,FMN 12 Statielei
660,Statielei 26,2023-03-01,22:00:00,57,27,30,FMN 12 Statielei
660,Statielei 26,2023-03-01,23:00:00,39,15,24,FMN 12 Statielei
660,Statielei 26,2023-03-02,00:00:00,14,5,9,FMN 12 Statielei
660,Statielei 26,2023-03-02,01:00:00,11,4,7,FMN 12 Statielei
660,Statielei 26,2023-03-02,02:00:00,2,0,2,FMN 12 Statielei
660,Statielei 26,2023-03-02,03:00:00,2,0,2,FMN 12 Statielei
660,Statielei 26,2023-03-02,04:00:00,7,4,3,FMN 12 Statielei
660,Statielei 26,2023-03-02,05:00:00,14,8,6,FMN 12 Statielei
660,Statielei 26,2023-03-02,06:00:00,25,14,11,FMN 12 Statielei
660,Statielei 26,2023-03-02,07:00:00,114,51,63,FMN 12 Statielei
660,Statielei 26,2023-03-02,08:00:00,272,155,117,FMN 12 Statielei
660,Statielei 26,2023-03-02,09:00:00,106,70,36,FMN 12 Statielei
660,Statielei 26,2023-03-02,10:00:00,72,43,29,FMN 12 Statielei
660,Statielei 26,2023-03-02,11:00:00,78,40,38,FMN 12 Statielei
660,Statielei 26,2023-03-02,12:00:00,110,56,54,FMN 12 Statielei
660,Statielei 26,2023-03-02,13:00:00,90,40,50,FMN 12 Statielei
660,Statielei 26,2023-03-02,14:00:00,93,44,49,FMN 12 Statielei
660,Statielei 26,2023-03-02,15:00:00,159,69,90,FMN 12 Statielei
660,Statielei 26,2023-03-02,16:00:00,217,116,101,FMN 12 Statielei
660,Statielei 26,2023-03-02,17:00:00,201,94,107,FMN 12 Statielei
660,Statielei 26,2023-03-02,18:00:00,161,84,77,FMN 12 Statielei
660,Statielei 26,2023-03-02,19:00:00,150,72,78,FMN 12 Statielei
660,Statielei 26,2023-03-02,20:00:00,105,55,50,FMN 12 Statielei
660,Statielei 26,2023-03-02,21:00:00,65,29,36,FMN 12 Statielei
660,Statielei 26,2023-03-02,22:00:00,49,23,26,FMN 12 Statielei
660,Statielei 26,2023-03-02,23:00:00,58,25,33,FMN 12 Statielei
660,Statielei 26,2023-03-03,00:00:00,48,36,12,FMN 12 Statielei
660,Statielei 26,2023-03-03,01:00:00,28,19,9,FMN 12 Statielei
660,Statielei 26,2023-03-03,02:00:00,7,5,2,FMN 12 Statielei
660,Statielei 26,2023-03-03,03:00:00,4,0,4,FMN 12 Statielei
660,Statielei 26,2023-03-03,04:00:00,8,7,1,FMN 12 Statielei
660,Statielei 26,2023-03-03,05:00:00,13,8,5,FMN 12 Statielei
660,Statielei 26,2023-03-03,06:00:00,31,17,14,FMN 12 Statielei
660,Statielei 26,2023-03-03,07:00:00,96,52,44,FMN 12 Statielei
660,Statielei 26,2023-03-03,08:00:00,249,126,123,FMN 12 Statielei
660,Statielei 26,2023-03-03,09:00:00,103,63,40,FMN 12 Statielei
660,Statielei 26,2023-03-03,10:00:00,71,46,25,FMN 12 Statielei
660,Statielei 26,2023-03-03,11:00:00,75,36,39,FMN 12 Statielei
660,Statielei 26,2023-03-03,12:00:00,100,51,49,FMN 12 Statielei
660,Statielei 26,2023-03-03,13:00:00,82,43,39,FMN 12 Statielei
660,Statielei 26,2023-03-03,14:00:00,87,32,55,FMN 12 Statielei
660,Statielei 26,2023-03-03,15:00:00,155,64,91,FMN 12 Statielei
660,Statielei 26,2023-03-03,16:00:00,207,108,99,FMN 12 Statielei
660,Statielei 26,2023-03-03,17:00:00,161,76,85,FMN 12 Statielei
660,Statielei 26,2023-03-03,18:00:00,153,83,70,FMN 12 Statielei
660,Statielei 26,2023-03-03,19:00:00,141,92,49,FMN 12 Statielei
660,Statielei 26,2023-03-03,20:00:00,89,43,46,FMN 12 Statielei
660,Statielei 26,2023-03-03,21:00:00,57,29,28,FMN 12 Statielei
660,Statielei 26,2023-03-03,22:00:00,69,19,50,FMN 12 Statielei
660,Statielei 26,2023-03-03,23:00:00,55,20,35,FMN 12 Statielei
660,Statielei 26,2023-03-04,00:00:00,18,9,9,FMN 12 Statielei
660,Statielei 26,2023-03-04,01:00:00,25,9,16,FMN 12 Statielei
660,Statielei 26,2023-03-04,02:00:00,9,6,3,FMN 12 Statielei
660,Statielei 26,2023-03-04,03:00:00,10,1,9,FMN 12 Statielei
660,Statielei 26,2023-03-04,04:00:00,9,5,4,FMN 12 Statielei
660,Statielei 26,2023-03-04,05:00:00,5,2,3,FMN 12 Statielei
660,Statielei 26,2023-03-04,06:00:00,16,6,10,FMN 12 Statielei
660,Statielei 26,2023-03-04,07:00:00,15,3,12,FMN 12 Statielei
660,Statielei 26,2023-03-04,08:00:00,36,18,18,FMN 12 Statielei
660,Statielei 26,2023-03-04,09:00:00,81,38,43,FMN 12 Statielei
660,Statielei 26,2023-03-04,10:00:00,96,51,45,FMN 12 Statielei
660,Statielei 26,2023-03-04,11:00:00,112,62,50,FMN 12 Statielei
660,Statielei 26,2023-03-04,12:00:00,116,64,52,FMN 12 Statielei
660,Statielei 26,2023-03-04,13:00:00,121,68,53,FMN 12 Statielei
660,Statielei 26,2023-03-04,14:00:00,118,66,52,FMN 12 Statielei
660,Statielei 26,2023-03-04,15:00:00,97,54,43,FMN 12 Statielei
660,Statielei 26,2023-03-04,16:00:00,81,46,35,FMN 12 Statielei
660,Statielei 26,2023-03-04,17:00:00,116,63,53,FMN 12 Statielei
660,Statielei 26,2023-03-04,18:00:00,99,59,40,FMN 12 Statielei
660,Statielei 26,2023-03-04,19:00:00,88,48,40,FMN 12 Statielei
660,Statielei 26,2023-03-04,20:00:00,67,35,32,FMN 12 Statielei
660,Statielei 26,2023-03-04,21:00:00,31,15,16,FMN 12 Statielei
660,Statielei 26,2023-03-04,22:00:00,46,22,24,FMN 12 Statielei
660,Statielei 26,2023-03-04,23:00:00,57,20,37,FMN 12 Statielei
660,Statielei 26,2023-03-05,00:00:00,42,21,21,FMN 12 Statielei
660,Statielei 26,2023-03-05,01:00:00,25,9,16,FMN 12 Statielei
660,Statielei 26,2023-03-05,02:00:00,18,7,11,FMN 12 Statielei
660,Statielei 26,2023-03-05,03:00:00,8,4,4,FMN 12 Statielei
660,Statielei 26,2023-03-05,04:00:00,10,6,4,FMN 12 Statielei
660,Statielei 26,2023-03-05,05:00:00,5,4,1,FMN 12 Statielei
660,Statielei 26,2023-03-05,06:00:00,9,4,5,FMN 12 Statielei
660,Statielei 26,2023-03-05,07:00:00,8,3,5,FMN 12 Statielei
660,Statielei 26,2023-03-05,08:00:00,29,13,16,FMN 12 Statielei
660,Statielei 26,2023-03-05,09:00:00,60,24,36,FMN 12 Statielei
660,Statielei 26,2023-03-05,10:00:00,59,31,28,FMN 12 Statielei
660,Statielei 26,2023-03-05,11:00:00,62,25,37,FMN 12 Statielei
660,Statielei 26,2023-03-05,12:00:00,83,57,26,FMN 12 Statielei
660,Statielei 26,2023-03-05,13:00:00,95,46,49,FMN 12 Statielei
660,Statielei 26,2023-03-05,14:00:00,101,54,47,FMN 12 Statielei
660,Statielei 26,2023-03-05,15:00:00,108,54,54,FMN 12 Statielei
660,Statielei 26,2023-03-05,16:00:00,73,40,33,FMN 12 Statielei
660,Statielei 26,2023-03-05,17:00:00,96,56,40,FMN 12 Statielei
660,Statielei 26,2023-03-05,18:00:00,116,75,41,FMN 12 Statielei
660,Statielei 26,2023-03-05,19:00:00,68,38,30,FMN 12 Statielei
660,Statielei 26,2023-03-05,20:00:00,71,31,40,FMN 12 Statielei
660,Statielei 26,2023-03-05,21:00:00,36,15,21,FMN 12 Statielei
660,Statielei 26,2023-03-05,22:00:00,41,14,27,FMN 12 Statielei
660,Statielei 26,2023-03-05,23:00:00,16,6,10,FMN 12 Statielei
660,Statielei 26,2023-03-06,00:00:00,10,3,7,FMN 12 Statielei
660,Statielei 26,2023-03-06,01:00:00,3,2,1,FMN 12 Statielei
660,Statielei 26,2023-03-06,02:00:00,3,1,2,FMN 12 Statielei
660,Statielei 26,2023-03-06,03:00:00,5,1,4,FMN 12 Statielei
660,Statielei 26,2023-03-06,04:00:00,6,4,2,FMN 12 Statielei
660,Statielei 26,2023-03-06,05:00:00,11,6,5,FMN 12 Statielei
660,Statielei 26,2023-03-06,06:00:00,31,14,17,FMN 12 Statielei
660,Statielei 26,2023-03-06,07:00:00,107,48,59,FMN 12 Statielei
660,Statielei 26,2023-03-06,08:00:00,256,139,117,FMN 12 Statielei
660,Statielei 26,2023-03-06,09:00:00,101,68,33,FMN 12 Statielei
660,Statielei 26,2023-03-06,10:00:00,66,37,29,FMN 12 Statielei
660,Statielei 26,2023-03-06,11:00:00,56,31,25,FMN 12 Statielei
660,Statielei 26,2023-03-06,12:00:00,96,56,40,FMN 12 Statielei
660,Statielei 26,2023-03-06,13:00:00,69,34,35,FMN 12 Statielei
660,Statielei 26,2023-03-06,14:00:00,83,42,41,FMN 12 Statielei
660,Statielei 26,2023-03-06,15:00:00,170,75,95,FMN 12 Statielei
660,Statielei 26,2023-03-06,16:00:00,197,97,100,FMN 12 Statielei
660,Statielei 26,2023-03-06,17:00:00,196,113,83,FMN 12 Statielei
660,Statielei 26,2023-03-06,18:00:00,127,63,64,FMN 12 Statielei
660,Statielei 26,2023-03-06,19:00:00,70,47,23,FMN 12 Statielei
660,Statielei 26,2023-03-06,20:00:00,76,42,34,FMN 12 Statielei
660,Statielei 26,2023-03-06,21:00:00,42,20,22,FMN 12 Statielei
660,Statielei 26,2023-03-06,22:00:00,52,21,31,FMN 12 Statielei
660,Statielei 26,2023-03-06,23:00:00,22,7,15,FMN 12 Statielei
660,Statielei 26,2023-03-07,00:00:00,16,7,9,FMN 12 Statielei
660,Statielei 26,2023-03-07,01:00:00,4,2,2,FMN 12 Statielei
660,Statielei 26,2023-03-07,02:00:00,4,2,2,FMN 12 Statielei
660,Statielei 26,2023-03-07,03:00:00,2,0,2,FMN 12 Statielei
660,Statielei 26,2023-03-07,04:00:00,6,4,2,FMN 12 Statielei
660,Statielei 26,2023-03-07,05:00:00,9,4,5,FMN 12 Statielei
660,Statielei 26,2023-03-07,06:00:00,28,13,15,FMN 12 Statielei
660,Statielei 26,2023-03-07,07:00:00,105,46,59,FMN 12 Statielei
660,Statielei 26,2023-03-07,08:00:00,243,128,115,FMN 12 Statielei
660,Statielei 26,2023-03-07,09:00:00,78,49,29,FMN 12 Statielei
660,Statielei 26,2023-03-07,10:00:00,38,23,15,FMN 12 Statielei
660,Statielei 26,2023-03-07,11:00:00,49,25,24,FMN 12 Statielei
660,Statielei 26,2023-03-07,12:00:00,66,35,31,FMN 12 Statielei
660,Statielei 26,2023-03-07,13:00:00,76,41,35,FMN 12 Statielei
660,Statielei 26,2023-03-07,14:00:00,57,31,26,FMN 12 Statielei
660,Statielei 26,2023-03-07,15:00:00,112,47,65,FMN 12 Statielei
660,Statielei 26,2023-03-07,16:00:00,189,91,98,FMN 12 Statielei
660,Statielei 26,2023-03-07,17:00:00,158,86,72,FMN 12 Statielei
660,Statielei 26,2023-03-07,18:00:00,112,56,56,FMN 12 Statielei
660,Statielei 26,2023-03-07,19:00:00,89,52,37,FMN 12 Statielei
660,Statielei 26,2023-03-07,20:00:00,70,36,34,FMN 12 Statielei
660,Statielei 26,2023-03-07,21:00:00,55,34,21,FMN 12 Statielei
660,Statielei 26,2023-03-07,22:00:00,52,17,35,FMN 12 Statielei
660,Statielei 26,2023-03-07,23:00:00,24,8,16,FMN 12 Statielei
660,Statielei 26,2023-03-08,00:00:00,14,4,10,FMN 12 Statielei
660,Statielei 26,2023-03-08,01:00:00,7,3,4,FMN 12 Statielei
660,Statielei 26,2023-03-08,02:00:00,2,1,1,FMN 12 Statielei
660,Statielei 26,2023-03-08,03:00:00,5,2,3,FMN 12 Statielei
660,Statielei 26,2023-03-08,04:00:00,9,7,2,FMN 12 Statielei
660,Statielei 26,2023-03-08,05:00:00,10,7,3,FMN 12 Statielei
660,Statielei 26,2023-03-08,06:00:00,30,9,21,FMN 12 Statielei
660,Statielei 26,2023-03-08,07:00:00,77,37,40,FMN 12 Statielei
660,Statielei 26,2023-03-08,08:00:00,179,94,85,FMN 12 Statielei
660,Statielei 26,2023-03-08,09:00:00,41,33,8,FMN 12 Statielei
660,Statielei 26,2023-03-08,10:00:00,36,14,22,FMN 12 Statielei
660,Statielei 26,2023-03-08,11:00:00,49,28,21,FMN 12 Statielei
660,Statielei 26,2023-03-08,12:00:00,147,68,79,FMN 12 Statielei
660,Statielei 26,2023-03-08,13:00:00,106,56,50,FMN 12 Statielei
660,Statielei 26,2023-03-08,14:00:00,85,46,39,FMN 12 Statielei
660,Statielei 26,2023-03-08,15:00:00,77,39,38,FMN 12 Statielei
660,Statielei 26,2023-03-08,16:00:00,110,61,49,FMN 12 Statielei
660,Statielei 26,2023-03-08,17:00:00,116,59,57,FMN 12 Statielei
660,Statielei 26,2023-03-08,18:00:00,102,58,44,FMN 12 Statielei
660,Statielei 26,2023-03-08,19:00:00,86,54,32,FMN 12 Statielei
660,Statielei 26,2023-03-08,20:00:00,42,22,20,FMN 12 Statielei
660,Statielei 26,2023-03-08,21:00:00,59,26,33,FMN 12 Statielei
660,Statielei 26,2023-03-08,22:00:00,47,20,27,FMN 12 Statielei
660,Statielei 26,2023-03-08,23:00:00,24,5,19,FMN 12 Statielei
660,Statielei 26,2023-03-09,00:00:00,14,3,11,FMN 12 Statielei
660,Statielei 26,2023-03-09,01:00:00,7,4,3,FMN 12 Statielei
660,Statielei 26,2023-03-09,02:00:00,2,0,2,FMN 12 Statielei
660,Statielei 26,2023-03-09,03:00:00,4,1,3,FMN 12 Statielei
660,Statielei 26,2023-03-09,04:00:00,8,6,2,FMN 12 Statielei
660,Statielei 26,2023-03-09,05:00:00,15,3,12,FMN 12 Statielei
660,Statielei 26,2023-03-09,06:00:00,28,12,16,FMN 12 Statielei
660,Statielei 26,2023-03-09,07:00:00,107,47,60,FMN 12 Statielei
660,Statielei 26,2023-03-09,08:00:00,249,145,104,FMN 12 Statielei
660,Statielei 26,2023-03-09,09:00:00,103,68,35,FMN 12 Statielei
660,Statielei 26,2023-03-09,10:00:00,56,32,24,FMN 12 Statielei
660,Statielei 26,2023-03-09,11:00:00,59,29,30,FMN 12 Statielei
660,Statielei 26,2023-03-09,12:00:00,85,49,36,FMN 12 Statielei
660,Statielei 26,2023-03-09,13:00:00,57,30,27,FMN 12 Statielei
660,Statielei 26,2023-03-09,14:00:00,69,31,38,FMN 12 Statielei
660,Statielei 26,2023-03-09,15:00:00,113,51,62,FMN 12 Statielei
660,Statielei 26,2023-03-09,16:00:00,198,106,92,FMN 12 Statielei
660,Statielei 26,2023-03-09,17:00:00,151,65,86,FMN 12 Statielei
660,Statielei 26,2023-03-09,18:00:00,113,65,48,FMN 12 Statielei
660,Statielei 26,2023-03-09,19:00:00,86,51,35,FMN 12 Statielei
660,Statielei 26,2023-03-09,20:00:00,63,36,27,FMN 12 Statielei
660,Statielei 26,2023-03-09,21:00:00,40,17,23,FMN 12 Statielei
660,Statielei 26,2023-03-09,22:00:00,27,16,11,FMN 12 Statielei
660,Statielei 26,2023-03-09,23:00:00,31,8,23,FMN 12 Statielei
660,Statielei 26,2023-03-10,00:00:00,17,10,7,FMN 12 Statielei
660,Statielei 26,2023-03-10,01:00:00,16,9,7,FMN 12 Statielei
660,Statielei 26,2023-03-10,02:00:00,5,4,1,FMN 12 Statielei
660,Statielei 26,2023-03-10,03:00:00,3,0,3,FMN 12 Statielei
660,Statielei 26,2023-03-10,04:00:00,11,5,6,FMN 12 Statielei
660,Statielei 26,2023-03-10,05:00:00,14,4,10,FMN 12 Statielei
660,Statielei 26,2023-03-10,06:00:00,34,15,19,FMN 12 Statielei
660,Statielei 26,2023-03-10,07:00:00,108,54,54,FMN 12 Statielei
660,Statielei 26,2023-03-10,08:00:00,218,125,93,FMN 12 Statielei
660,Statielei 26,2023-03-10,09:00:00,73,50,23,FMN 12 Statielei
660,Statielei 26,2023-03-10,10:00:00,45,30,15,FMN 12 Statielei
660,Statielei 26,2023-03-10,11:00:00,54,35,19,FMN 12 Statielei
660,Statielei 26,2023-03-10,12:00:00,90,51,39,FMN 12 Statielei
660,Statielei 26,2023-03-10,13:00:00,85,44,41,FMN 12 Statielei
660,Statielei 26,2023-03-10,14:00:00,62,32,30,FMN 12 Statielei
660,Statielei 26,2023-03-10,15:00:00,115,46,69,FMN 12 Statielei
660,Statielei 26,2023-03-10,16:00:00,168,91,77,FMN 12 Statielei
660,Statielei 26,2023-03-10,17:00:00,146,77,69,FMN 12 Statielei
660,Statielei 26,2023-03-10,18:00:00,98,51,47,FMN 12 Statielei
660,Statielei 26,2023-03-10,19:00:00,111,55,56,FMN 12 Statielei
660,Statielei 26,2023-03-10,20:00:00,81,44,37,FMN 12 Statielei
660,Statielei 26,2023-03-10,21:00:00,49,22,27,FMN 12 Statielei
660,Statielei 26,2023-03-10,22:00:00,84,32,52,FMN 12 Statielei
660,Statielei 26,2023-03-10,23:00:00,57,26,31,FMN 12 Statielei
660,Statielei 26,2023-03-11,00:00:00,60,21,39,FMN 12 Statielei
660,Statielei 26,2023-03-11,01:00:00,18,6,12,FMN 12 Statielei
660,Statielei 26,2023-03-11,02:00:00,22,8,14,FMN 12 Statielei
660,Statielei 26,2023-03-11,03:00:00,7,4,3,FMN 12 Statielei
660,Statielei 26,2023-03-11,04:00:00,11,6,5,FMN 12 Statielei
660,Statielei 26,2023-03-11,05:00:00,8,4,4,FMN 12 Statielei
660,Statielei 26,2023-03-11,06:00:00,11,4,7,FMN 12 Statielei
660,Statielei 26,2023-03-11,07:00:00,13,4,9,FMN 12 Statielei
660,Statielei 26,2023-03-11,08:00:00,45,19,26,FMN 12 Statielei
660,Statielei 26,2023-03-11,09:00:00,86,43,43,FMN 12 Statielei
660,Statielei 26,2023-03-11,10:00:00,120,68,52,FMN 12 Statielei
660,Statielei 26,2023-03-11,11:00:00,115,80,35,FMN 12 Statielei
660,Statielei 26,2023-03-11,12:00:00,113,63,50,FMN 12 Statielei
660,Statielei 26,2023-03-11,13:00:00,136,60,76,FMN 12 Statielei
660,Statielei 26,2023-03-11,14:00:00,125,61,64,FMN 12 Statielei
660,Statielei 26,2023-03-11,15:00:00,112,57,55,FMN 12 Statielei
660,Statielei 26,2023-03-11,16:00:00,130,68,62,FMN 12 Statielei
660,Statielei 26,2023-03-11,17:00:00,156,77,79,FMN 12 Statielei
660,Statielei 26,2023-03-11,18:00:00,144,68,76,FMN 12 Statielei
660,Statielei 26,2023-03-11,19:00:00,102,50,52,FMN 12 Statielei
660,Statielei 26,2023-03-11,20:00:00,86,46,40,FMN 12 Statielei
660,Statielei 26,2023-03-11,21:00:00,50,21,29,FMN 12 Statielei
660,Statielei 26,2023-03-11,22:00:00,66,23,43,FMN 12 Statielei
660,Statielei 26,2023-03-11,23:00:00,49,22,27,FMN 12 Statielei
660,Statielei 26,2023-03-12,00:00:00,54,34,20,FMN 12 Statielei
660,Statielei 26,2023-03-12,01:00:00,20,10,10,FMN 12 Statielei
660,Statielei 26,2023-03-12,02:00:00,15,6,9,FMN 12 Statielei
660,Statielei 26,2023-03-12,03:00:00,13,5,8,FMN 12 Statielei
660,Statielei 26,2023-03-12,04:00:00,18,10,8,FMN 12 Statielei
660,Statielei 26,2023-03-12,05:00:00,9,3,6,FMN 12 Statielei
660,Statielei 26,2023-03-12,06:00:00,9,4,5,FMN 12 Statielei
660,Statielei 26,2023-03-12,07:00:00,10,3,7,FMN 12 Statielei
660,Statielei 26,2023-03-12,08:00:00,19,14,5,FMN 12 Statielei
660,Statielei 26,2023-03-12,09:00:00,45,16,29,FMN 12 Statielei
660,Statielei 26,2023-03-12,10:00:00,52,24,28,FMN 12 Statielei
660,Statielei 26,2023-03-12,11:00:00,57,28,29,FMN 12 Statielei
660,Statielei 26,2023-03-12,12:00:00,78,43,35,FMN 12 Statielei
660,Statielei 26,2023-03-12,13:00:00,94,44,50,FMN 12 Statielei
660,Statielei 26,2023-03-12,14:00:00,110,70,40,FMN 12 Statielei
660,Statielei 26,2023-03-12,15:00:00,90,51,39,FMN 12 Statielei
660,Statielei 26,2023-03-12,16:00:00,100,51,49,FMN 12 Statielei
660,Statielei 26,2023-03-12,17:00:00,119,48,71,FMN 12 Statielei
660,Statielei 26,2023-03-12,18:00:00,93,56,37,FMN 12 Statielei
660,Statielei 26,2023-03-12,19:00:00,69,41,28,FMN 12 Statielei
660,Statielei 26,2023-03-12,20:00:00,60,25,35,FMN 12 Statielei
660,Statielei 26,2023-03-12,21:00:00,49,17,32,FMN 12 Statielei
660,Statielei 26,2023-03-12,22:00:00,31,14,17,FMN 12 Statielei
660,Statielei 26,2023-03-12,23:00:00,16,8,8,FMN 12 Statielei
660,Statielei 26,2023-03-13,00:00:00,14,6,8,FMN 12 Statielei
660,Statielei 26,2023-03-13,01:00:00,7,4,3,FMN 12 Statielei
660,Statielei 26,2023-03-13,02:00:00,2,0,2,FMN 12 Statielei
660,Statielei 26,2023-03-13,03:00:00,5,1,4,FMN 12 Statielei
660,Statielei 26,2023-03-13,04:00:00,6,2,4,FMN 12 Statielei
660,Statielei 26,2023-03-13,05:00:00,16,9,7,FMN 12 Statielei
660,Statielei 26,2023-03-13,06:00:00,23,12,11,FMN 12 Statielei
660,Statielei 26,2023-03-13,07:00:00,102,49,53,FMN 12 Statielei
660,Statielei 26,2023-03-13,08:00:00,261,141,120,FMN 12 Statielei
660,Statielei 26,2023-03-13,09:00:00,98,55,43,FMN 12 Statielei
660,Statielei 26,2023-03-13,10:00:00,54,32,22,FMN 12 Statielei
660,Statielei 26,2023-03-13,11:00:00,58,28,30,FMN 12 Statielei
660,Statielei 26,2023-03-13,12:00:00,111,63,48,FMN 12 Statielei
660,Statielei 26,2023-03-13,13:00:00,89,43,46,FMN 12 Statielei
660,Statielei 26,2023-03-13,14:00:00,95,46,49,FMN 12 Statielei
660,Statielei 26,2023-03-13,15:00:00,129,49,80,FMN 12 Statielei
660,Statielei 26,2023-03-13,16:00:00,210,112,98,FMN 12 Statielei
660,Statielei 26,2023-03-13,17:00:00,209,101,108,FMN 12 Statielei
660,Statielei 26,2023-03-13,18:00:00,138,74,64,FMN 12 Statielei
660,Statielei 26,2023-03-13,19:00:00,111,63,48,FMN 12 Statielei
660,Statielei 26,2023-03-13,20:00:00,77,35,42,FMN 12 Statielei
660,Statielei 26,2023-03-13,21:00:00,63,28,35,FMN 12 Statielei
660,Statielei 26,2023-03-13,22:00:00,64,25,39,FMN 12 Statielei
660,Statielei 26,2023-03-13,23:00:00,29,12,17,FMN 12 Statielei
660,Statielei 26,2023-03-14,00:00:00,13,2,11,FMN 12 Statielei
660,Statielei 26,2023-03-14,01:00:00,7,2,5,FMN 12 Statielei
660,Statielei 26,2023-03-14,02:00:00,5,2,3,FMN 12 Statielei
660,Statielei 26,2023-03-14,03:00:00,4,2,2,FMN 12 Statielei
660,Statielei 26,2023-03-14,04:00:00,7,4,3,FMN 12 Statielei
660,Statielei 26,2023-03-14,05:00:00,10,5,5,FMN 12 Statielei
660,Statielei 26,2023-03-14,06:00:00,33,11,22,FMN 12 Statielei
660,Statielei 26,2023-03-14,07:00:00,104,46,58,FMN 12 Statielei
660,Statielei 26,2023-03-14,08:00:00,217,119,98,FMN 12 Statielei
660,Statielei 26,2023-03-14,09:00:00,92,51,41,FMN 12 Statielei
660,Statielei 26,2023-03-14,10:00:00,47,31,16,FMN 12 Statielei
660,Statielei 26,2023-03-14,11:00:00,48,25,23,FMN 12 Statielei
660,Statielei 26,2023-03-14,12:00:00,79,38,41,FMN 12 Statielei
660,Statielei 26,2023-03-14,13:00:00,76,30,46,FMN 12 Statielei
660,Statielei 26,2023-03-14,14:00:00,64,37,27,FMN 12 Statielei
660,Statielei 26,2023-03-14,15:00:00,153,58,95,FMN 12 Statielei
660,Statielei 26,2023-03-14,16:00:00,221,116,105,FMN 12 Statielei
660,Statielei 26,2023-03-14,17:00:00,197,85,112,FMN 12 Statielei
660,Statielei 26,2023-03-14,18:00:00,132,73,59,FMN 12 Statielei
660,Statielei 26,2023-03-14,19:00:00,90,43,47,FMN 12 Statielei
660,Statielei 26,2023-03-14,20:00:00,83,46,37,FMN 12 Statielei
660,Statielei 26,2023-03-14,21:00:00,59,30,29,FMN 12 Statielei
660,Statielei 26,2023-03-14,22:00:00,50,28,22,FMN 12 Statielei
660,Statielei 26,2023-03-14,23:00:00,38,7,31,FMN 12 Statielei
660,Statielei 26,2023-03-15,00:00:00,12,6,6,FMN 12 Statielei
660,Statielei 26,2023-03-15,01:00:00,7,3,4,FMN 12 Statielei
660,Statielei 26,2023-03-15,02:00:00,1,0,1,FMN 12 Statielei
660,Statielei 26,2023-03-15,03:00:00,8,3,5,FMN 12 Statielei
660,Statielei 26,2023-03-15,04:00:00,9,7,2,FMN 12 Statielei
660,Statielei 26,2023-03-15,05:00:00,18,7,11,FMN 12 Statielei
660,Statielei 26,2023-03-15,06:00:00,29,14,15,FMN 12 Statielei
660,Statielei 26,2023-03-15,07:00:00,103,51,52,FMN 12 Statielei
660,Statielei 26,2023-03-15,08:00:00,214,118,96,FMN 12 Statielei
660,Statielei 26,2023-03-15,09:00:00,88,52,36,FMN 12 Statielei
660,Statielei 26,2023-03-15,10:00:00,69,39,30,FMN 12 Statielei
660,Statielei 26,2023-03-15,11:00:00,92,49,43,FMN 12 Statielei
660,Statielei 26,2023-03-15,12:00:00,158,76,82,FMN 12 Statielei
660,Statielei 26,2023-03-15,13:00:00,153,75,78,FMN 12 Statielei
660,Statielei 26,2023-03-15,14:00:00,150,64,86,FMN 12 Statielei
660,Statielei 26,2023-03-15,15:00:00,135,68,67,FMN 12 Statielei
660,Statielei 26,2023-03-15,16:00:00,189,102,87,FMN 12 Statielei
660,Statielei 26,2023-03-15,17:00:00,208,95,113,FMN 12 Statielei
660,Statielei 26,2023-03-15,18:00:00,156,80,76,FMN 12 Statielei
660,Statielei 26,2023-03-15,19:00:00,118,70,48,FMN 12 Statielei
660,Statielei 26,2023-03-15,20:00:00,79,46,33,FMN 12 Statielei
660,Statielei 26,2023-03-15,21:00:00,69,28,41,FMN 12 Statielei
660,Statielei 26,2023-03-15,22:00:00,69,34,35,FMN 12 Statielei
660,Statielei 26,2023-03-15,23:00:00,48,20,28,FMN 12 Statielei
660,Statielei 26,2023-03-16,00:00:00,16,2,14,FMN 12 Statielei
660,Statielei 26,2023-03-16,01:00:00,10,4,6,FMN 12 Statielei
660,Statielei 26,2023-03-16,02:00:00,9,2,7,FMN 12 Statielei
660,Statielei 26,2023-03-16,03:00:00,5,2,3,FMN 12 Statielei
660,Statielei 26,2023-03-16,04:00:00,10,9,1,FMN 12 Statielei
660,Statielei 26,2023-03-16,05:00:00,16,9,7,FMN 12 Statielei
660,Statielei 26,2023-03-16,06:00:00,36,19,17,FMN 12 Statielei
660,Statielei 26,2023-03-16,07:00:00,112,56,56,FMN 12 Statielei
660,Statielei 26,2023-03-16,08:00:00,288,162,126,FMN 12 Statielei
660,Statielei 26,2023-03-16,09:00:00,123,71,52,FMN 12 Statielei
660,Statielei 26,2023-03-16,10:00:00,75,44,31,FMN 12 Statielei
660,Statielei 26,2023-03-16,11:00:00,59,29,30,FMN 12 Statielei
660,Statielei 26,2023-03-16,12:00:00,103,53,50,FMN 12 Statielei
660,Statielei 26,2023-03-16,13:00:00,86,39,47,FMN 12 Statielei
660,Statielei 26,2023-03-16,14:00:00,107,56,51,FMN 12 Statielei
660,Statielei 26,2023-03-16,15:00:00,140,59,81,FMN 12 Statielei
660,Statielei 26,2023-03-16,16:00:00,227,115,112,FMN 12 Statielei
660,Statielei 26,2023-03-16,17:00:00,206,92,114,FMN 12 Statielei
660,Statielei 26,2023-03-16,18:00:00,186,86,100,FMN 12 Statielei
660,Statielei 26,2023-03-16,19:00:00,140,68,72,FMN 12 Statielei
660,Statielei 26,2023-03-16,20:00:00,99,57,42,FMN 12 Statielei
660,Statielei 26,2023-03-16,21:00:00,77,43,34,FMN 12 Statielei
660,Statielei 26,2023-03-16,22:00:00,63,28,35,FMN 12 Statielei
660,Statielei 26,2023-03-16,23:00:00,38,10,28,FMN 12 Statielei
660,Statielei 26,2023-03-17,00:00:00,28,14,14,FMN 12 Statielei
660,Statielei 26,2023-03-17,01:00:00,15,4,11,FMN 12 Statielei
660,Statielei 26,2023-03-17,02:00:00,8,2,6,FMN 12 Statielei
660,Statielei 26,2023-03-17,03:00:00,5,3,2,FMN 12 Statielei
660,Statielei 26,2023-03-17,04:00:00,11,6,5,FMN 12 Statielei
660,Statielei 26,2023-03-17,05:00:00,18,9,9,FMN 12 Statielei
660,Statielei 26,2023-03-17,06:00:00,31,17,14,FMN 12 Statielei
660,Statielei 26,2023-03-17,07:00:00,121,58,63,FMN 12 Statielei
660,Statielei 26,2023-03-17,08:00:00,265,140,125,FMN 12 Statielei
660,Statielei 26,2023-03-17,09:00:00,120,84,36,FMN 12 Statielei
660,Statielei 26,2023-03-17,10:00:00,78,46,32,FMN 12 Statielei
660,Statielei 26,2023-03-17,11:00:00,88,47,41,FMN 12 Statielei
660,Statielei 26,2023-03-17,12:00:00,115,61,54,FMN 12 Statielei
660,Statielei 26,2023-03-17,13:00:00,84,33,51,FMN 12 Statielei
660,Statielei 26,2023-03-17,14:00:00,114,56,58,FMN 12 Statielei
660,Statielei 26,2023-03-17,15:00:00,174,84,90,FMN 12 Statielei
660,Statielei 26,2023-03-17,16:00:00,233,122,111,FMN 12 Statielei
660,Statielei 26,2023-03-17,17:00:00,183,68,115,FMN 12 Statielei
660,Statielei 26,2023-03-17,18:00:00,121,68,53,FMN 12 Statielei
660,Statielei 26,2023-03-17,19:00:00,159,82,77,FMN 12 Statielei
660,Statielei 26,2023-03-17,20:00:00,105,71,34,FMN 12 Statielei
660,Statielei 26,2023-03-17,21:00:00,79,39,40,FMN 12 Statielei
660,Statielei 26,2023-03-17,22:00:00,64,26,38,FMN 12 Statielei
660,Statielei 26,2023-03-17,23:00:00,73,25,48,FMN 12 Statielei
660,Statielei 26,2023-03-18,00:00:00,47,18,29,FMN 12 Statielei
660,Statielei 26,2023-03-18,01:00:00,35,13,22,FMN 12 Statielei
660,Statielei 26,2023-03-18,02:00:00,25,4,21,FMN 12 Statielei
660,Statielei 26,2023-03-18,03:00:00,14,4,10,FMN 12 Statielei
660,Statielei 26,2023-03-18,04:00:00,6,2,4,FMN 12 Statielei
660,Statielei 26,2023-03-18,05:00:00,8,4,4,FMN 12 Statielei
660,Statielei 26,2023-03-18,06:00:00,18,9,9,FMN 12 Statielei
660,Statielei 26,2023-03-18,07:00:00,18,4,14,FMN 12 Statielei
660,Statielei 26,2023-03-18,08:00:00,52,21,31,FMN 12 Statielei
660,Statielei 26,2023-03-18,09:00:00,100,46,54,FMN 12 Statielei
660,Statielei 26,2023-03-18,10:00:00,100,52,48,FMN 12 Statielei
660,Statielei 26,2023-03-18,11:00:00,109,60,49,FMN 12 Statielei
660,Statielei 26,2023-03-18,12:00:00,102,62,40,FMN 12 Statielei
660,Statielei 26,2023-03-18,13:00:00,134,65,69,FMN 12 Statielei
660,Statielei 26,2023-03-18,14:00:00,136,83,53,FMN 12 Statielei
660,Statielei 26,2023-03-18,15:00:00,125,67,58,FMN 12 Statielei
660,Statielei 26,2023-03-18,16:00:00,147,72,75,FMN 12 Statielei
660,Statielei 26,2023-03-18,17:00:00,154,87,67,FMN 12 Statielei
660,Statielei 26,2023-03-18,18:00:00,119,72,47,FMN 12 Statielei
660,Statielei 26,2023-03-18,19:00:00,66,34,32,FMN 12 Statielei
660,Statielei 26,2023-03-18,20:00:00,84,47,37,FMN 12 Statielei
660,Statielei 26,2023-03-18,21:00:00,46,25,21,FMN 12 Statielei
660,Statielei 26,2023-03-18,22:00:00,43,20,23,FMN 12 Statielei
660,Statielei 26,2023-03-18,23:00:00,51,17,34,FMN 12 Statielei
660,Statielei 26,2023-03-19,00:00:00,47,18,29,FMN 12 Statielei
660,Statielei 26,2023-03-19,01:00:00,26,7,19,FMN 12 Statielei
660,Statielei 26,2023-03-19,02:00:00,15,5,10,FMN 12 Statielei
660,Statielei 26,2023-03-19,03:00:00,12,5,7,FMN 12 Statielei
660,Statielei 26,2023-03-19,04:00:00,19,7,12,FMN 12 Statielei
660,Statielei 26,2023-03-19,05:00:00,12,3,9,FMN 12 Statielei
660,Statielei 26,2023-03-19,06:00:00,10,5,5,FMN 12 Statielei
660,Statielei 26,2023-03-19,07:00:00,16,10,6,FMN 12 Statielei
660,Statielei 26,2023-03-19,08:00:00,43,17,26,FMN 12 Statielei
660,Statielei 26,2023-03-19,09:00:00,92,36,56,FMN 12 Statielei
660,Statielei 26,2023-03-19,10:00:00,92,47,45,FMN 12 Statielei
660,Statielei 26,2023-03-19,11:00:00,90,47,43,FMN 12 Statielei
660,Statielei 26,2023-03-19,12:00:00,142,68,74,FMN 12 Statielei
660,Statielei 26,2023-03-19,13:00:00,92,31,61,FMN 12 Statielei
660,Statielei 26,2023-03-19,14:00:00,102,64,38,FMN 12 Statielei
660,Statielei 26,2023-03-19,15:00:00,141,81,60,FMN 12 Statielei
660,Statielei 26,2023-03-19,16:00:00,108,65,43,FMN 12 Statielei
660,Statielei 26,2023-03-19,17:00:00,131,64,67,FMN 12 Statielei
660,Statielei 26,2023-03-19,18:00:00,88,53,35,FMN 12 Statielei
660,Statielei 26,2023-03-19,19:00:00,74,32,42,FMN 12 Statielei
660,Statielei 26,2023-03-19,20:00:00,72,31,41,FMN 12 Statielei
660,Statielei 26,2023-03-19,21:00:00,54,15,39,FMN 12 Statielei
660,Statielei 26,2023-03-19,22:00:00,38,22,16,FMN 12 Statielei
660,Statielei 26,2023-03-19,23:00:00,28,16,12,FMN 12 Statielei
660,Statielei 26,2023-03-20,00:00:00,16,7,9,FMN 12 Statielei
660,Statielei 26,2023-03-20,01:00:00,10,4,6,FMN 12 Statielei
660,Statielei 26,2023-03-20,02:00:00,7,0,7,FMN 12 Statielei
660,Statielei 26,2023-03-20,03:00:00,1,0,1,FMN 12 Statielei
660,Statielei 26,2023-03-20,04:00:00,8,5,3,FMN 12 Statielei
660,Statielei 26,2023-03-20,05:00:00,19,10,9,FMN 12 Statielei
660,Statielei 26,2023-03-20,06:00:00,26,14,12,FMN 12 Statielei
660,Statielei 26,2023-03-20,07:00:00,105,48,57,FMN 12 Statielei
660,Statielei 26,2023-03-20,08:00:00,289,162,127,FMN 12 Statielei
660,Statielei 26,2023-03-20,09:00:00,113,73,40,FMN 12 Statielei
660,Statielei 26,2023-03-20,10:00:00,56,31,25,FMN 12 Statielei
660,Statielei 26,2023-03-20,11:00:00,48,26,22,FMN 12 Statielei
660,Statielei 26,2023-03-20,12:00:00,123,67,56,FMN 12 Statielei
660,Statielei 26,2023-03-20,13:00:00,69,35,34,FMN 12 Statielei
660,Statielei 26,2023-03-20,14:00:00,115,63,52,FMN 12 Statielei
660,Statielei 26,2023-03-20,15:00:00,145,64,81,FMN 12 Statielei
660,Statielei 26,2023-03-20,16:00:00,199,93,106,FMN 12 Statielei
660,Statielei 26,2023-03-20,17:00:00,185,78,107,FMN 12 Statielei
660,Statielei 26,2023-03-20,18:00:00,116,62,54,FMN 12 Statielei
660,Statielei 26,2023-03-20,19:00:00,82,41,41,FMN 12 Statielei
660,Statielei 26,2023-03-20,20:00:00,72,37,35,FMN 12 Statielei
660,Statielei 26,2023-03-20,21:00:00,67,34,33,FMN 12 Statielei
660,Statielei 26,2023-03-20,22:00:00,47,23,24,FMN 12 Statielei
660,Statielei 26,2023-03-20,23:00:00,26,9,17,FMN 12 Statielei
660,Statielei 26,2023-03-21,00:00:00,10,0,10,FMN 12 Statielei
660,Statielei 26,2023-03-21,01:00:00,7,5,2,FMN 12 Statielei
660,Statielei 26,2023-03-21,02:00:00,4,1,3,FMN 12 Statielei
660,Statielei 26,2023-03-21,03:00:00,2,0,2,FMN 12 Statielei
660,Statielei 26,2023-03-21,04:00:00,7,4,3,FMN 12 Statielei
660,Statielei 26,2023-03-21,05:00:00,17,12,5,FMN 12 Statielei
660,Statielei 26,2023-03-21,06:00:00,32,15,17,FMN 12 Statielei
660,Statielei 26,2023-03-21,07:00:00,112,62,50,FMN 12 Statielei
660,Statielei 26,2023-03-21,08:00:00,282,143,139,FMN 12 Statielei
660,Statielei 26,2023-03-21,09:00:00,102,64,38,FMN 12 Statielei
660,Statielei 26,2023-03-21,10:00:00,77,41,36,FMN 12 Statielei
660,Statielei 26,2023-03-21,11:00:00,81,45,36,FMN 12 Statielei
660,Statielei 26,2023-03-21,12:00:00,106,66,40,FMN 12 Statielei
660,Statielei 26,2023-03-21,13:00:00,101,54,47,FMN 12 Statielei
660,Statielei 26,2023-03-21,14:00:00,89,52,37,FMN 12 Statielei
660,Statielei 26,2023-03-21,15:00:00,155,63,92,FMN 12 Statielei
660,Statielei 26,2023-03-21,16:00:00,227,109,118,FMN 12 Statielei
660,Statielei 26,2023-03-21,17:00:00,187,78,109,FMN 12 Statielei
660,Statielei 26,2023-03-21,18:00:00,181,86,95,FMN 12 Statielei
660,Statielei 26,2023-03-21,19:00:00,115,65,50,FMN 12 Statielei
660,Statielei 26,2023-03-21,20:00:00,98,55,43,FMN 12 Statielei
660,Statielei 26,2023-03-21,21:00:00,60,28,32,FMN 12 Statielei
660,Statielei 26,2023-03-21,22:00:00,63,26,37,FMN 12 Statielei
660,Statielei 26,2023-03-21,23:00:00,41,17,24,FMN 12 Statielei
660,Statielei 26,2023-03-22,00:00:00,15,5,10,FMN 12 Statielei
660,Statielei 26,2023-03-22,01:00:00,8,4,4,FMN 12 Statielei
660,Statielei 26,2023-03-22,02:00:00,6,2,4,FMN 12 Statielei
660,Statielei 26,2023-03-22,03:00:00,2,0,2,FMN 12 Statielei
660,Statielei 26,2023-03-22,04:00:00,9,4,5,FMN 12 Statielei
660,Statielei 26,2023-03-22,05:00:00,17,11,6,FMN 12 Statielei
660,Statielei 26,2023-03-22,06:00:00,34,12,22,FMN 12 Statielei
660,Statielei 26,2023-03-22,07:00:00,100,50,50,FMN 12 Statielei
660,Statielei 26,2023-03-22,08:00:00,266,130,136,FMN 12 Statielei
660,Statielei 26,2023-03-22,09:00:00,77,42,35,FMN 12 Statielei
660,Statielei 26,2023-03-22,10:00:00,78,44,34,FMN 12 Statielei
660,Statielei 26,2023-03-22,11:00:00,75,34,41,FMN 12 Statielei
660,Statielei 26,2023-03-22,12:00:00,202,105,97,FMN 12 Statielei
660,Statielei 26,2023-03-22,13:00:00,141,65,76,FMN 12 Statielei
660,Statielei 26,2023-03-22,14:00:00,98,45,53,FMN 12 Statielei
660,Statielei 26,2023-03-22,15:00:00,117,52,65,FMN 12 Statielei
660,Statielei 26,2023-03-22,16:00:00,171,87,84,FMN 12 Statielei
660,Statielei 26,2023-03-22,17:00:00,172,84,88,FMN 12 Statielei
660,Statielei 26,2023-03-22,18:00:00,133,70,63,FMN 12 Statielei
660,Statielei 26,2023-03-22,19:00:00,97,46,51,FMN 12 Statielei
660,Statielei 26,2023-03-22,20:00:00,79,44,35,FMN 12 Statielei
660,Statielei 26,2023-03-22,21:00:00,57,27,30,FMN 12 Statielei
660,Statielei 26,2023-03-22,22:00:00,63,23,40,FMN 12 Statielei
660,Statielei 26,2023-03-22,23:00:00,38,12,26,FMN 12 Statielei
660,Statielei 26,2023-03-23,00:00:00,16,4,12,FMN 12 Statielei
660,Statielei 26,2023-03-23,01:00:00,5,3,2,FMN 12 Statielei
660,Statielei 26,2023-03-23,02:00:00,6,3,3,FMN 12 Statielei
660,Statielei 26,2023-03-23,03:00:00,4,1,3,FMN 12 Statielei
660,Statielei 26,2023-03-23,04:00:00,5,4,1,FMN 12 Statielei
660,Statielei 26,2023-03-23,05:00:00,16,9,7,FMN 12 Statielei
660,Statielei 26,2023-03-23,06:00:00,29,12,17,FMN 12 Statielei
660,Statielei 26,2023-03-23,07:00:00,94,41,53,FMN 12 Statielei
660,Statielei 26,2023-03-23,08:00:00,221,118,103,FMN 12 Statielei
660,Statielei 26,2023-03-23,09:00:00,94,62,32,FMN 12 Statielei
660,Statielei 26,2023-03-23,10:00:00,65,35,30,FMN 12 Statielei
660,Statielei 26,2023-03-23,11:00:00,73,36,37,FMN 12 Statielei
660,Statielei 26,2023-03-23,12:00:00,118,65,53,FMN 12 Statielei
660,Statielei 26,2023-03-23,13:00:00,86,43,43,FMN 12 Statielei
660,Statielei 26,2023-03-23,14:00:00,74,38,36,FMN 12 Statielei
660,Statielei 26,2023-03-23,15:00:00,125,57,68,FMN 12 Statielei
660,Statielei 26,2023-03-23,16:00:00,203,97,106,FMN 12 Statielei
660,Statielei 26,2023-03-23,17:00:00,196,93,103,FMN 12 Statielei
660,Statielei 26,2023-03-23,18:00:00,159,69,90,FMN 12 Statielei
660,Statielei 26,2023-03-23,19:00:00,105,56,49,FMN 12 Statielei
660,Statielei 26,2023-03-23,20:00:00,86,52,34,FMN 12 Statielei
660,Statielei 26,2023-03-23,21:00:00,74,34,40,FMN 12 Statielei
660,Statielei 26,2023-03-23,22:00:00,60,28,32,FMN 12 Statielei
660,Statielei 26,2023-03-23,23:00:00,44,6,38,FMN 12 Statielei
660,Statielei 26,2023-03-24,00:00:00,24,6,18,FMN 12 Statielei
660,Statielei 26,2023-03-24,01:00:00,10,4,6,FMN 12 Statielei
660,Statielei 26,2023-03-24,02:00:00,6,1,5,FMN 12 Statielei
660,Statielei 26,2023-03-24,03:00:00,4,0,4,FMN 12 Statielei
660,Statielei 26,2023-03-24,04:00:00,4,2,2,FMN 12 Statielei
660,Statielei 26,2023-03-24,05:00:00,15,8,7,FMN 12 Statielei
660,Statielei 26,2023-03-24,06:00:00,31,17,14,FMN 12 Statielei
660,Statielei 26,2023-03-24,07:00:00,115,51,64,FMN 12 Statielei
660,Statielei 26,2023-03-24,08:00:00,192,106,86,FMN 12 Statielei
660,Statielei 26,2023-03-24,09:00:00,105,67,38,FMN 12 Statielei
660,Statielei 26,2023-03-24,10:00:00,71,41,30,FMN 12 Statielei
660,Statielei 26,2023-03-24,11:00:00,79,34,45,FMN 12 Statielei
660,Statielei 26,2023-03-24,12:00:00,89,53,36,FMN 12 Statielei
660,Statielei 26,2023-03-24,13:00:00,85,41,44,FMN 12 Statielei
660,Statielei 26,2023-03-24,14:00:00,70,23,47,FMN 12 Statielei
660,Statielei 26,2023-03-24,15:00:00,181,91,90,FMN 12 Statielei
660,Statielei 26,2023-03-24,16:00:00,171,84,87,FMN 12 Statielei
660,Statielei 26,2023-03-24,17:00:00,189,87,102,FMN 12 Statielei
660,Statielei 26,2023-03-24,18:00:00,143,71,72,FMN 12 Statielei
660,Statielei 26,2023-03-24,19:00:00,111,49,62,FMN 12 Statielei
660,Statielei 26,2023-03-24,20:00:00,99,66,33,FMN 12 Statielei
660,Statielei 26,2023-03-24,21:00:00,60,38,22,FMN 12 Statielei
660,Statielei 26,2023-03-24,22:00:00,62,23,39,FMN 12 Statielei
660,Statielei 26,2023-03-24,23:00:00,51,20,31,FMN 12 Statielei
660,Statielei 26,2023-03-25,00:00:00,42,16,26,FMN 12 Statielei
660,Statielei 26,2023-03-25,01:00:00,30,8,22,FMN 12 Statielei
660,Statielei 26,2023-03-25,02:00:00,20,6,14,FMN 12 Statielei
660,Statielei 26,2023-03-25,03:00:00,13,2,11,FMN 12 Statielei
660,Statielei 26,2023-03-25,04:00:00,7,2,5,FMN 12 Statielei
660,Statielei 26,2023-03-25,05:00:00,0,0,0,FMN 12 Statielei
660,Statielei 26,2023-03-25,06:00:00,0,0,0,FMN 12 Statielei
660,Statielei 26,2023-03-25,07:00:00,16,7,9,FMN 12 Statielei
660,Statielei 26,2023-03-25,08:00:00,26,12,14,FMN 12 Statielei
660,Statielei 26,2023-03-25,09:00:00,75,34,41,FMN 12 Statielei
660,Statielei 26,2023-03-25,10:00:00,77,31,46,FMN 12 Statielei
660,Statielei 26,2023-03-25,11:00:00,91,46,45,FMN 12 Statielei
660,Statielei 26,2023-03-25,12:00:00,73,33,40,FMN 12 Statielei
660,Statielei 26,2023-03-25,13:00:00,102,52,50,FMN 12 Statielei
660,Statielei 26,2023-03-25,14:00:00,92,46,46,FMN 12 Statielei
660,Statielei 26,2023-03-25,15:00:00,105,60,45,FMN 12 Statielei
660,Statielei 26,2023-03-25,16:00:00,82,50,32,FMN 12 Statielei
660,Statielei 26,2023-03-25,17:00:00,115,57,58,FMN 12 Statielei
660,Statielei 26,2023-03-25,18:00:00,130,61,69,FMN 12 Statielei
660,Statielei 26,2023-03-25,19:00:00,89,42,47,FMN 12 Statielei
660,Statielei 26,2023-03-25,20:00:00,94,71,23,FMN 12 Statielei
660,Statielei 26,2023-03-25,21:00:00,76,51,25,FMN 12 Statielei
660,Statielei 26,2023-03-25,22:00:00,70,35,35,FMN 12 Statielei
660,Statielei 26,2023-03-25,23:00:00,52,22,30,FMN 12 Statielei
660,Statielei 26,2023-03-26,00:00:00,50,22,28,FMN 12 Statielei
660,Statielei 26,2023-03-26,01:00:00,34,2,32,FMN 12 Statielei
660,Statielei 26,2023-03-26,02:00:00,0,0,0,FMN 12 Statielei
660,Statielei 26,2023-03-26,03:00:00,37,14,23,FMN 12 Statielei
660,Statielei 26,2023-03-26,04:00:00,16,7,9,FMN 12 Statielei
660,Statielei 26,2023-03-26,05:00:00,14,6,8,FMN 12 Statielei
660,Statielei 26,2023-03-26,06:00:00,6,2,4,FMN 12 Statielei
660,Statielei 26,2023-03-26,07:00:00,3,1,2,FMN 12 Statielei
660,Statielei 26,2023-03-26,08:00:00,18,7,11,FMN 12 Statielei
660,Statielei 26,2023-03-26,09:00:00,46,17,29,FMN 12 Statielei
660,Statielei 26,2023-03-26,10:00:00,26,6,20,FMN 12 Statielei
660,Statielei 26,2023-03-26,11:00:00,26,13,13,FMN 12 Statielei
660,Statielei 26,2023-03-26,12:00:00,56,31,25,FMN 12 Statielei
660,Statielei 26,2023-03-26,13:00:00,63,31,32,FMN 12 Statielei
660,Statielei 26,2023-03-26,14:00:00,71,34,37,FMN 12 Statielei
660,Statielei 26,2023-03-26,15:00:00,69,36,33,FMN 12 Statielei
660,Statielei 26,2023-03-26,16:00:00,80,36,44,FMN 12 Statielei
660,Statielei 26,2023-03-26,17:00:00,92,50,42,FMN 12 Statielei
660,Statielei 26,2023-03-26,18:00:00,83,48,35,FMN 12 Statielei
660,Statielei 26,2023-03-26,19:00:00,51,22,29,FMN 12 Statielei
660,Statielei 26,2023-03-26,20:00:00,50,26,24,FMN 12 Statielei
660,Statielei 26,2023-03-26,21:00:00,65,37,28,FMN 12 Statielei
660,Statielei 26,2023-03-26,22:00:00,39,23,16,FMN 12 Statielei
660,Statielei 26,2023-03-26,23:00:00,39,19,20,FMN 12 Statielei
660,Statielei 26,2023-03-27,00:00:00,18,6,12,FMN 12 Statielei
660,Statielei 26,2023-03-27,01:00:00,8,4,4,FMN 12 Statielei
660,Statielei 26,2023-03-27,02:00:00,7,2,5,FMN 12 Statielei
660,Statielei 26,2023-03-27,03:00:00,4,1,3,FMN 12 Statielei
660,Statielei 26,2023-03-27,04:00:00,8,4,4,FMN 12 Statielei
660,Statielei 26,2023-03-27,05:00:00,26,13,13,FMN 12 Statielei
660,Statielei 26,2023-03-27,06:00:00,27,16,11,FMN 12 Statielei
660,Statielei 26,2023-03-27,07:00:00,84,39,45,FMN 12 Statielei
660,Statielei 26,2023-03-27,08:00:00,234,128,106,FMN 12 Statielei
660,Statielei 26,2023-03-27,09:00:00,95,58,37,FMN 12 Statielei
660,Statielei 26,2023-03-27,10:00:00,61,38,23,FMN 12 Statielei
660,Statielei 26,2023-03-27,11:00:00,60,33,27,FMN 12 Statielei
660,Statielei 26,2023-03-27,12:00:00,102,54,48,FMN 12 Statielei
660,Statielei 26,2023-03-27,13:00:00,83,44,39,FMN 12 Statielei
660,Statielei 26,2023-03-27,14:00:00,82,43,39,FMN 12 Statielei
660,Statielei 26,2023-03-27,15:00:00,130,58,72,FMN 12 Statielei
660,Statielei 26,2023-03-27,16:00:00,228,114,114,FMN 12 Statielei
660,Statielei 26,2023-03-27,17:00:00,191,84,107,FMN 12 Statielei
660,Statielei 26,2023-03-27,18:00:00,133,52,81,FMN 12 Statielei
660,Statielei 26,2023-03-27,19:00:00,105,52,53,FMN 12 Statielei
660,Statielei 26,2023-03-27,20:00:00,55,25,30,FMN 12 Statielei
660,Statielei 26,2023-03-27,21:00:00,74,43,31,FMN 12 Statielei
660,Statielei 26,2023-03-27,22:00:00,35,21,14,FMN 12 Statielei
660,Statielei 26,2023-03-27,23:00:00,37,15,22,FMN 12 Statielei
660,Statielei 26,2023-03-28,00:00:00,15,5,10,FMN 12 Statielei
660,Statielei 26,2023-03-28,01:00:00,5,5,0,FMN 12 Statielei
660,Statielei 26,2023-03-28,02:00:00,3,1,2,FMN 12 Statielei
660,Statielei 26,2023-03-28,03:00:00,5,0,5,FMN 12 Statielei
660,Statielei 26,2023-03-28,04:00:00,3,2,1,FMN 12 Statielei
660,Statielei 26,2023-03-28,05:00:00,15,7,8,FMN 12 Statielei
660,Statielei 26,2023-03-28,06:00:00,28,13,15,FMN 12 Statielei
660,Statielei 26,2023-03-28,07:00:00,103,46,57,FMN 12 Statielei
660,Statielei 26,2023-03-28,08:00:00,248,126,122,FMN 12 Statielei
660,Statielei 26,2023-03-28,09:00:00,113,82,31,FMN 12 Statielei
660,Statielei 26,2023-03-28,10:00:00,76,54,22,FMN 12 Statielei
660,Statielei 26,2023-03-28,11:00:00,71,44,27,FMN 12 Statielei
660,Statielei 26,2023-03-28,12:00:00,109,59,50,FMN 12 Statielei
660,Statielei 26,2023-03-28,13:00:00,87,49,38,FMN 12 Statielei
660,Statielei 26,2023-03-28,14:00:00,78,38,40,FMN 12 Statielei
660,Statielei 26,2023-03-28,15:00:00,161,76,85,FMN 12 Statielei
660,Statielei 26,2023-03-28,16:00:00,216,113,103,FMN 12 Statielei
660,Statielei 26,2023-03-28,17:00:00,206,83,123,FMN 12 Statielei
660,Statielei 26,2023-03-28,18:00:00,146,71,75,FMN 12 Statielei
660,Statielei 26,2023-03-28,19:00:00,113,58,55,FMN 12 Statielei
660,Statielei 26,2023-03-28,20:00:00,94,45,49,FMN 12 Statielei
660,Statielei 26,2023-03-28,21:00:00,62,32,30,FMN 12 Statielei
660,Statielei 26,2023-03-28,22:00:00,75,46,29,FMN 12 Statielei
660,Statielei 26,2023-03-28,23:00:00,67,22,45,FMN 12 Statielei
660,Statielei 26,2023-03-29,00:00:00,22,11,11,FMN 12 Statielei
660,Statielei 26,2023-03-29,01:00:00,10,4,6,FMN 12 Statielei
660,Statielei 26,2023-03-29,02:00:00,5,2,3,FMN 12 Statielei
660,Statielei 26,2023-03-29,03:00:00,6,1,5,FMN 12 Statielei
660,Statielei 26,2023-03-29,04:00:00,8,3,5,FMN 12 Statielei
660,Statielei 26,2023-03-29,05:00:00,20,9,11,FMN 12 Statielei
660,Statielei 26,2023-03-29,06:00:00,27,15,12,FMN 12 Statielei
660,Statielei 26,2023-03-29,07:00:00,98,45,53,FMN 12 Statielei
660,Statielei 26,2023-03-29,08:00:00,305,147,158,FMN 12 Statielei
660,Statielei 26,2023-03-29,09:00:00,108,66,42,FMN 12 Statielei
660,Statielei 26,2023-03-29,10:00:00,89,43,46,FMN 12 Statielei
660,Statielei 26,2023-03-29,11:00:00,92,48,44,FMN 12 Statielei
660,Statielei 26,2023-03-29,12:00:00,216,127,89,FMN 12 Statielei
660,Statielei 26,2023-03-29,13:00:00,146,75,71,FMN 12 Statielei
660,Statielei 26,2023-03-29,14:00:00,98,52,46,FMN 12 Statielei
660,Statielei 26,2023-03-29,15:00:00,135,71,64,FMN 12 Statielei
660,Statielei 26,2023-03-29,16:00:00,151,68,83,FMN 12 Statielei
660,Statielei 26,2023-03-29,17:00:00,199,107,92,FMN 12 Statielei
660,Statielei 26,2023-03-29,18:00:00,185,91,94,FMN 12 Statielei
660,Statielei 26,2023-03-29,19:00:00,160,87,73,FMN 12 Statielei
660,Statielei 26,2023-03-29,20:00:00,85,47,38,FMN 12 Statielei
660,Statielei 26,2023-03-29,21:00:00,71,38,33,FMN 12 Statielei
660,Statielei 26,2023-03-29,22:00:00,88,35,53,FMN 12 Statielei
660,Statielei 26,2023-03-29,23:00:00,67,25,42,FMN 12 Statielei
660,Statielei 26,2023-03-30,00:00:00,37,12,25,FMN 12 Statielei
660,Statielei 26,2023-03-30,01:00:00,15,6,9,FMN 12 Statielei
660,Statielei 26,2023-03-30,02:00:00,6,2,4,FMN 12 Statielei
660,Statielei 26,2023-03-30,03:00:00,3,0,3,FMN 12 Statielei
660,Statielei 26,2023-03-30,04:00:00,9,3,6,FMN 12 Statielei
660,Statielei 26,2023-03-30,05:00:00,16,8,8,FMN 12 Statielei
660,Statielei 26,2023-03-30,06:00:00,33,14,19,FMN 12 Statielei
660,Statielei 26,2023-03-30,07:00:00,97,42,55,FMN 12 Statielei
660,Statielei 26,2023-03-30,08:00:00,252,144,108,FMN 12 Statielei
660,Statielei 26,2023-03-30,09:00:00,117,78,39,FMN 12 Statielei
660,Statielei 26,2023-03-30,10:00:00,65,38,27,FMN 12 Statielei
660,Statielei 26,2023-03-30,11:00:00,75,36,39,FMN 12 Statielei
660,Statielei 26,2023-03-30,12:00:00,104,53,51,FMN 12 Statielei
660,Statielei 26,2023-03-30,13:00:00,72,33,39,FMN 12 Statielei
660,Statielei 26,2023-03-30,14:00:00,78,41,37,FMN 12 Statielei
660,Statielei 26,2023-03-30,15:00:00,129,64,65,FMN 12 Statielei
660,Statielei 26,2023-03-30,16:00:00,228,112,116,FMN 12 Statielei
660,Statielei 26,2023-03-30,17:00:00,197,79,118,FMN 12 Statielei
660,Statielei 26,2023-03-30,18:00:00,176,86,90,FMN 12 Statielei
660,Statielei 26,2023-03-30,19:00:00,136,60,76,FMN 12 Statielei
660,Statielei 26,2023-03-30,20:00:00,102,54,48,FMN 12 Statielei
660,Statielei 26,2023-03-30,21:00:00,88,53,35,FMN 12 Statielei
660,Statielei 26,2023-03-30,22:00:00,85,32,53,FMN 12 Statielei
660,Statielei 26,2023-03-30,23:00:00,56,21,35,FMN 12 Statielei
660,Statielei 26,2023-03-31,00:00:00,32,12,20,FMN 12 Statielei
660,Statielei 26,2023-03-31,01:00:00,23,6,17,FMN 12 Statielei
660,Statielei 26,2023-03-31,02:00:00,10,1,9,FMN 12 Statielei
660,Statielei 26,2023-03-31,03:00:00,4,2,2,FMN 12 Statielei
660,Statielei 26,2023-03-31,04:00:00,12,4,8,FMN 12 Statielei
660,Statielei 26,2023-03-31,05:00:00,13,4,9,FMN 12 Statielei
660,Statielei 26,2023-03-31,06:00:00,22,14,8,FMN 12 Statielei
660,Statielei 26,2023-03-31,07:00:00,60,24,36,FMN 12 Statielei
660,Statielei 26,2023-03-31,08:00:00,187,84,103,FMN 12 Statielei
660,Statielei 26,2023-03-31,09:00:00,72,43,29,FMN 12 Statielei
660,Statielei 26,2023-03-31,10:00:00,48,29,19,FMN 12 Statielei
660,Statielei 26,2023-03-31,11:00:00,60,36,24,FMN 12 Statielei
660,Statielei 26,2023-03-31,12:00:00,88,53,35,FMN 12 Statielei
660,Statielei 26,2023-03-31,13:00:00,69,34,35,FMN 12 Statielei
660,Statielei 26,2023-03-31,14:00:00,69,36,33,FMN 12 Statielei
660,Statielei 26,2023-03-31,15:00:00,129,55,74,FMN 12 Statielei
660,Statielei 26,2023-03-31,16:00:00,148,68,80,FMN 12 Statielei
660,Statielei 26,2023-03-31,17:00:00,129,60,69,FMN 12 Statielei
660,Statielei 26,2023-03-31,18:00:00,114,54,60,FMN 12 Statielei
660,Statielei 26,2023-03-31,19:00:00,125,57,68,FMN 12 Statielei
660,Statielei 26,2023-03-31,20:00:00,52,36,16,FMN 12 Statielei
660,Statielei 26,2023-03-31,21:00:00,52,25,27,FMN 12 Statielei
660,Statielei 26,2023-03-31,22:00:00,61,27,34,FMN 12 Statielei
660,Statielei 26,2023-03-31,23:00:00,52,24,28,FMN 12 Statielei
660,Statielei 26,2023-04-01,00:00:00,32,10,22,FMN 12 Statielei
660,Statielei 26,2023-04-01,01:00:00,31,9,22,FMN 12 Statielei
660,Statielei 26,2023-04-01,02:00:00,24,11,13,FMN 12 Statielei
660,Statielei 26,2023-04-01,03:00:00,10,2,8,FMN 12 Statielei
660,Statielei 26,2023-04-01,04:00:00,8,2,6,FMN 12 Statielei
660,Statielei 26,2023-04-01,05:00:00,4,2,2,FMN 12 Statielei
660,Statielei 26,2023-04-01,06:00:00,12,6,6,FMN 12 Statielei
660,Statielei 26,2023-04-01,07:00:00,7,0,7,FMN 12 Statielei
660,Statielei 26,2023-04-01,08:00:00,30,10,20,FMN 12 Statielei
660,Statielei 26,2023-04-01,09:00:00,45,20,25,FMN 12 Statielei
660,Statielei 26,2023-04-01,10:00:00,33,12,21,FMN 12 Statielei
660,Statielei 26,2023-04-01,11:00:00,57,34,23,FMN 12 Statielei
660,Statielei 26,2023-04-01,12:00:00,64,40,24,FMN 12 Statielei
660,Statielei 26,2023-04-01,13:00:00,66,34,32,FMN 12 Statielei
660,Statielei 26,2023-04-01,14:00:00,60,23,37,FMN 12 Statielei
660,Statielei 26,2023-04-01,15:00:00,62,30,32,FMN 12 Statielei
660,Statielei 26,2023-04-01,16:00:00,63,34,29,FMN 12 Statielei
660,Statielei 26,2023-04-01,17:00:00,67,29,38,FMN 12 Statielei
660,Statielei 26,2023-04-01,18:00:00,60,31,29,FMN 12 Statielei
660,Statielei 26,2023-04-01,19:00:00,62,31,31,FMN 12 Statielei
660,Statielei 26,2023-04-01,20:00:00,44,22,22,FMN 12 Statielei
660,Statielei 26,2023-04-01,21:00:00,55,34,21,FMN 12 Statielei
660,Statielei 26,2023-04-01,22:00:00,43,19,24,FMN 12 Statielei
660,Statielei 26,2023-04-01,23:00:00,40,18,22,FMN 12 Statielei
660,Statielei 26,2023-04-02,00:00:00,42,12,30,FMN 12 Statielei
660,Statielei 26,2023-04-02,01:00:00,24,5,19,FMN 12 Statielei
660,Statielei 26,2023-04-02,02:00:00,20,10,10,FMN 12 Statielei
660,Statielei 26,2023-04-02,03:00:00,13,3,10,FMN 12 Statielei
660,Statielei 26,2023-04-02,04:00:00,6,1,5,FMN 12 Statielei
660,Statielei 26,2023-04-02,05:00:00,4,2,2,FMN 12 Statielei
660,Statielei 26,2023-04-02,06:00:00,10,9,1,FMN 12 Statielei
660,Statielei 26,2023-04-02,07:00:00,7,3,4,FMN 12 Statielei
660,Statielei 26,2023-04-02,08:00:00,34,18,16,FMN 12 Statielei
660,Statielei 26,2023-04-02,09:00:00,63,31,32,FMN 12 Statielei
660,Statielei 26,2023-04-02,10:00:00,66,34,32,FMN 12 Statielei
660,Statielei 26,2023-04-02,11:00:00,53,21,32,FMN 12 Statielei
660,Statielei 26,2023-04-02,12:00:00,53,28,25,FMN 12 Statielei
660,Statielei 26,2023-04-02,13:00:00,77,43,34,FMN 12 Statielei
660,Statielei 26,2023-04-02,14:00:00,75,39,36,FMN 12 Statielei
660,Statielei 26,2023-04-02,15:00:00,63,37,26,FMN 12 Statielei
660,Statielei 26,2023-04-02,16:00:00,83,45,38,FMN 12 Statielei
660,Statielei 26,2023-04-02,17:00:00,89,50,39,FMN 12 Statielei
660,Statielei 26,2023-04-02,18:00:00,78,40,38,FMN 12 Statielei
660,Statielei 26,2023-04-02,19:00:00,83,46,37,FMN 12 Statielei
660,Statielei 26,2023-04-02,20:00:00,63,21,42,FMN 12 Statielei
660,Statielei 26,2023-04-02,21:00:00,56,27,29,FMN 12 Statielei
660,Statielei 26,2023-04-02,22:00:00,43,20,23,FMN 12 Statielei
660,Statielei 26,2023-04-02,23:00:00,33,13,20,FMN 12 Statielei
660,Statielei 26,2023-04-03,00:00:00,26,9,17,FMN 12 Statielei
660,Statielei 26,2023-04-03,01:00:00,9,3,6,FMN 12 Statielei
660,Statielei 26,2023-04-03,02:00:00,7,2,5,FMN 12 Statielei
660,Statielei 26,2023-04-03,03:00:00,3,1,2,FMN 12 Statielei
660,Statielei 26,2023-04-03,04:00:00,4,2,2,FMN 12 Statielei
660,Statielei 26,2023-04-03,05:00:00,7,4,3,FMN 12 Statielei
660,Statielei 26,2023-04-03,06:00:00,26,14,12,FMN 12 Statielei
660,Statielei 26,2023-04-03,07:00:00,45,18,27,FMN 12 Statielei
660,Statielei 26,2023-04-03,08:00:00,110,62,48,FMN 12 Statielei
660,Statielei 26,2023-04-03,09:00:00,87,55,32,FMN 12 Statielei
660,Statielei 26,2023-04-03,10:00:00,74,38,36,FMN 12 Statielei
660,Statielei 26,2023-04-03,11:00:00,63,36,27,FMN 12 Statielei
660,Statielei 26,2023-04-03,12:00:00,2,0,2,FMN 12 Statielei
660,Statielei 26,2023-04-03,13:00:00,0,0,0,FMN 12 Statielei
660,Statielei 26,2023-04-03,14:00:00,71,45,26,FMN 12 Statielei
660,Statielei 26,2023-04-03,15:00:00,110,56,54,FMN 12 Statielei
660,Statielei 26,2023-04-03,16:00:00,144,68,76,FMN 12 Statielei
660,Statielei 26,2023-04-03,17:00:00,152,63,89,FMN 12 Statielei
660,Statielei 26,2023-04-03,18:00:00,127,62,65,FMN 12 Statielei
660,Statielei 26,2023-04-03,19:00:00,124,66,58,FMN 12 Statielei
660,Statielei 26,2023-04-03,20:00:00,69,35,34,FMN 12 Statielei
660,Statielei 26,2023-04-03,21:00:00,79,49,30,FMN 12 Statielei
660,Statielei 26,2023-04-03,22:00:00,60,31,29,FMN 12 Statielei
660,Statielei 26,2023-04-03,23:00:00,44,16,28,FMN 12 Statielei
660,Statielei 26,2023-04-04,00:00:00,25,6,19,FMN 12 Statielei
660,Statielei 26,2023-04-04,01:00:00,17,5,12,FMN 12 Statielei
660,Statielei 26,2023-04-04,02:00:00,6,3,3,FMN 12 Statielei
660,Statielei 26,2023-04-04,03:00:00,5,0,5,FMN 12 Statielei
660,Statielei 26,2023-04-04,04:00:00,5,3,2,FMN 12 Statielei
660,Statielei 26,2023-04-04,05:00:00,11,8,3,FMN 12 Statielei
660,Statielei 26,2023-04-04,06:00:00,23,13,10,FMN 12 Statielei
660,Statielei 26,2023-04-04,07:00:00,56,26,30,FMN 12 Statielei
660,Statielei 26,2023-04-04,08:00:00,118,67,51,FMN 12 Statielei
660,Statielei 26,2023-04-04,09:00:00,75,50,25,FMN 12 Statielei
660,Statielei 26,2023-04-04,10:00:00,56,35,21,FMN 12 Statielei
660,Statielei 26,2023-04-04,11:00:00,73,39,34,FMN 12 Statielei
660,Statielei 26,2023-04-04,12:00:00,93,51,42,FMN 12 Statielei
660,Statielei 26,2023-04-04,13:00:00,74,36,38,FMN 12 Statielei
660,Statielei 26,2023-04-04,14:00:00,74,42,32,FMN 12 Statielei
660,Statielei 26,2023-04-04,15:00:00,129,69,60,FMN 12 Statielei
660,Statielei 26,2023-04-04,16:00:00,132,67,65,FMN 12 Statielei
660,Statielei 26,2023-04-04,17:00:00,167,78,89,FMN 12 Statielei
660,Statielei 26,2023-04-04,18:00:00,153,90,63,FMN 12 Statielei
660,Statielei 26,2023-04-04,19:00:00,140,84,56,FMN 12 Statielei
660,Statielei 26,2023-04-04,20:00:00,78,48,30,FMN 12 Statielei
660,Statielei 26,2023-04-04,21:00:00,59,31,28,FMN 12 Statielei
660,Statielei 26,2023-04-04,22:00:00,66,25,41,FMN 12 Statielei
660,Statielei 26,2023-04-04,23:00:00,29,4,25,FMN 12 Statielei
660,Statielei 26,2023-04-05,00:00:00,23,10,13,FMN 12 Statielei
660,Statielei 26,2023-04-05,01:00:00,17,6,11,FMN 12 Statielei
660,Statielei 26,2023-04-05,02:00:00,6,1,5,FMN 12 Statielei
660,Statielei 26,2023-04-05,03:00:00,9,1,8,FMN 12 Statielei
660,Statielei 26,2023-04-05,04:00:00,7,2,5,FMN 12 Statielei
660,Statielei 26,2023-04-05,05:00:00,13,9,4,FMN 12 Statielei
660,Statielei 26,2023-04-05,06:00:00,22,14,8,FMN 12 Statielei
660,Statielei 26,2023-04-05,07:00:00,59,25,34,FMN 12 Statielei
660,Statielei 26,2023-04-05,08:00:00,118,60,58,FMN 12 Statielei
660,Statielei 26,2023-04-05,09:00:00,77,48,29,FMN 12 Statielei
660,Statielei 26,2023-04-05,10:00:00,69,40,29,FMN 12 Statielei
660,Statielei 26,2023-04-05,11:00:00,86,55,31,FMN 12 Statielei
660,Statielei 26,2023-04-05,12:00:00,93,60,33,FMN 12 Statielei
660,Statielei 26,2023-04-05,13:00:00,95,48,47,FMN 12 Statielei
660,Statielei 26,2023-04-05,14:00:00,92,48,44,FMN 12 Statielei
660,Statielei 26,2023-04-05,15:00:00,97,54,43,FMN 12 Statielei
660,Statielei 26,2023-04-05,16:00:00,0,0,0,FMN 12 Statielei
660,Statielei 26,2023-04-05,17:00:00,0,0,0,FMN 12 Statielei
660,Statielei 26,2023-04-05,18:00:00,148,70,78,FMN 12 Statielei
660,Statielei 26,2023-04-05,19:00:00,118,65,53,FMN 12 Statielei
660,Statielei 26,2023-04-05,20:00:00,73,43,30,FMN 12 Statielei
660,Statielei 26,2023-04-05,21:00:00,62,32,30,FMN 12 Statielei
660,Statielei 26,2023-04-05,22:00:00,62,35,27,FMN 12 Statielei
660,Statielei 26,2023-04-05,23:00:00,51,17,34,FMN 12 Statielei
660,Statielei 26,2023-04-06,00:00:00,28,6,22,FMN 12 Statielei
660,Statielei 26,2023-04-06,01:00:00,15,3,12,FMN 12 Statielei
660,Statielei 26,2023-04-06,02:00:00,14,4,10,FMN 12 Statielei
660,Statielei 26,2023-04-06,03:00:00,8,0,8,FMN 12 Statielei
660,Statielei 26,2023-04-06,04:00:00,6,1,5,FMN 12 Statielei
660,Statielei 26,2023-04-06,05:00:00,11,7,4,FMN 12 Statielei
660,Statielei 26,2023-04-06,06:00:00,28,20,8,FMN 12 Statielei
660,Statielei 26,2023-04-06,07:00:00,47,17,30,FMN 12 Statielei
660,Statielei 26,2023-04-06,08:00:00,112,56,56,FMN 12 Statielei
660,Statielei 26,2023-04-06,09:00:00,67,41,26,FMN 12 Statielei
660,Statielei 26,2023-04-06,10:00:00,32,22,10,FMN 12 Statielei
660,Statielei 26,2023-04-06,11:00:00,43,23,20,FMN 12 Statielei
660,Statielei 26,2023-04-06,12:00:00,47,22,25,FMN 12 Statielei
660,Statielei 26,2023-04-06,13:00:00,58,29,29,FMN 12 Statielei
660,Statielei 26,2023-04-06,14:00:00,51,24,27,FMN 12 Statielei
660,Statielei 26,2023-04-06,15:00:00,63,29,34,FMN 12 Statielei
660,Statielei 26,2023-04-06,16:00:00,96,47,49,FMN 12 Statielei
660,Statielei 26,2023-04-06,17:00:00,104,49,55,FMN 12 Statielei
660,Statielei 26,2023-04-06,18:00:00,87,47,40,FMN 12 Statielei
660,Statielei 26,2023-04-06,19:00:00,75,30,45,FMN 12 Statielei
660,Statielei 26,2023-04-06,20:00:00,41,13,28,FMN 12 Statielei
660,Statielei 26,2023-04-06,21:00:00,44,23,21,FMN 12 Statielei
660,Statielei 26,2023-04-06,22:00:00,49,26,23,FMN 12 Statielei
660,Statielei 26,2023-04-06,23:00:00,45,17,28,FMN 12 Statielei
660,Statielei 26,2023-04-07,00:00:00,19,8,11,FMN 12 Statielei
660,Statielei 26,2023-04-07,01:00:00,16,7,9,FMN 12 Statielei
660,Statielei 26,2023-04-07,02:00:00,2,1,1,FMN 12 Statielei
660,Statielei 26,2023-04-07,03:00:00,2,0,2,FMN 12 Statielei
660,Statielei 26,2023-04-07,04:00:00,7,3,4,FMN 12 Statielei
660,Statielei 26,2023-04-07,05:00:00,6,2,4,FMN 12 Statielei
660,Statielei 26,2023-04-07,06:00:00,22,14,8,FMN 12 Statielei
660,Statielei 26,2023-04-07,07:00:00,47,21,26,FMN 12 Statielei
660,Statielei 26,2023-04-07,08:00:00,82,42,40,FMN 12 Statielei
660,Statielei 26,2023-04-07,09:00:00,62,38,24,FMN 12 Statielei
660,Statielei 26,2023-04-07,10:00:00,61,36,25,FMN 12 Statielei
660,Statielei 26,2023-04-07,11:00:00,76,44,32,FMN 12 Statielei
660,Statielei 26,2023-04-07,12:00:00,76,46,30,FMN 12 Statielei
660,Statielei 26,2023-04-07,13:00:00,68,41,27,FMN 12 Statielei
660,Statielei 26,2023-04-07,14:00:00,72,45,27,FMN 12 Statielei
660,Statielei 26,2023-04-07,15:00:00,101,53,48,FMN 12 Statielei
660,Statielei 26,2023-04-07,16:00:00,140,72,68,FMN 12 Statielei
660,Statielei 26,2023-04-07,17:00:00,133,62,71,FMN 12 Statielei
660,Statielei 26,2023-04-07,18:00:00,113,63,50,FMN 12 Statielei
660,Statielei 26,2023-04-07,19:00:00,101,56,45,FMN 12 Statielei
660,Statielei 26,2023-04-07,20:00:00,69,32,37,FMN 12 Statielei
660,Statielei 26,2023-04-07,21:00:00,59,28,31,FMN 12 Statielei
660,Statielei 26,2023-04-07,22:00:00,68,36,32,FMN 12 Statielei
660,Statielei 26,2023-04-07,23:00:00,80,26,54,FMN 12 Statielei
660,Statielei 26,2023-04-08,00:00:00,46,14,32,FMN 12 Statielei
660,Statielei 26,2023-04-08,01:00:00,35,18,17,FMN 12 Statielei
660,Statielei 26,2023-04-08,02:00:00,26,8,18,FMN 12 Statielei
660,Statielei 26,2023-04-08,03:00:00,18,2,16,FMN 12 Statielei
660,Statielei 26,2023-04-08,04:00:00,5,0,5,FMN 12 Statielei
660,Statielei 26,2023-04-08,05:00:00,12,7,5,FMN 12 Statielei
660,Statielei 26,2023-04-08,06:00:00,8,4,4,FMN 12 Statielei
660,Statielei 26,2023-04-08,07:00:00,10,3,7,FMN 12 Statielei
660,Statielei 26,2023-04-08,08:00:00,34,18,16,FMN 12 Statielei
660,Statielei 26,2023-04-08,09:00:00,62,32,30,FMN 12 Statielei
660,Statielei 26,2023-04-08,10:00:00,65,41,24,FMN 12 Statielei
660,Statielei 26,2023-04-08,11:00:00,62,39,23,FMN 12 Statielei
660,Statielei 26,2023-04-08,12:00:00,72,30,42,FMN 12 Statielei
660,Statielei 26,2023-04-08,13:00:00,91,49,42,FMN 12 Statielei
660,Statielei 26,2023-04-08,14:00:00,97,44,53,FMN 12 Statielei
660,Statielei 26,2023-04-08,15:00:00,118,75,43,FMN 12 Statielei
660,Statielei 26,2023-04-08,16:00:00,129,68,61,FMN 12 Statielei
660,Statielei 26,2023-04-08,17:00:00,94,45,49,FMN 12 Statielei
660,Statielei 26,2023-04-08,18:00:00,129,73,56,FMN 12 Statielei
660,Statielei 26,2023-04-08,19:00:00,127,63,64,FMN 12 Statielei
660,Statielei 26,2023-04-08,20:00:00,87,32,55,FMN 12 Statielei
660,Statielei 26,2023-04-08,21:00:00,67,37,30,FMN 12 Statielei
660,Statielei 26,2023-04-08,22:00:00,56,30,26,FMN 12 Statielei
660,Statielei 26,2023-04-08,23:00:00,77,35,42,FMN 12 Statielei
660,Statielei 26,2023-04-09,00:00:00,55,24,31,FMN 12 Statielei
660,Statielei 26,2023-04-09,01:00:00,37,10,27,FMN 12 Statielei
660,Statielei 26,2023-04-09,02:00:00,31,15,16,FMN 12 Statielei
660,Statielei 26,2023-04-09,03:00:00,14,3,11,FMN 12 Statielei
660,Statielei 26,2023-04-09,04:00:00,13,6,7,FMN 12 Statielei
660,Statielei 26,2023-04-09,05:00:00,6,2,4,FMN 12 Statielei
660,Statielei 26,2023-04-09,06:00:00,7,1,6,FMN 12 Statielei
660,Statielei 26,2023-04-09,07:00:00,8,1,7,FMN 12 Statielei
660,Statielei 26,2023-04-09,08:00:00,23,16,7,FMN 12 Statielei
660,Statielei 26,2023-04-09,09:00:00,36,14,22,FMN 12 Statielei
660,Statielei 26,2023-04-09,10:00:00,46,20,26,FMN 12 Statielei
660,Statielei 26,2023-04-09,11:00:00,72,40,32,FMN 12 Statielei
660,Statielei 26,2023-04-09,12:00:00,57,27,30,FMN 12 Statielei
660,Statielei 26,2023-04-09,13:00:00,77,39,38,FMN 12 Statielei
660,Statielei 26,2023-04-09,14:00:00,64,30,34,FMN 12 Statielei
660,Statielei 26,2023-04-09,15:00:00,130,56,74,FMN 12 Statielei
660,Statielei 26,2023-04-09,16:00:00,80,49,31,FMN 12 Statielei
660,Statielei 26,2023-04-09,17:00:00,91,49,42,FMN 12 Statielei
660,Statielei 26,2023-04-09,18:00:00,120,76,44,FMN 12 Statielei
660,Statielei 26,2023-04-09,19:00:00,92,54,38,FMN 12 Statielei
660,Statielei 26,2023-04-09,20:00:00,70,33,37,FMN 12 Statielei
660,Statielei 26,2023-04-09,21:00:00,65,37,28,FMN 12 Statielei
660,Statielei 26,2023-04-09,22:00:00,46,27,19,FMN 12 Statielei
660,Statielei 26,2023-04-09,23:00:00,34,16,18,FMN 12 Statielei
660,Statielei 26,2023-04-10,00:00:00,46,13,33,FMN 12 Statielei
660,Statielei 26,2023-04-10,01:00:00,33,15,18,FMN 12 Statielei
660,Statielei 26,2023-04-10,02:00:00,13,2,11,FMN 12 Statielei
660,Statielei 26,2023-04-10,03:00:00,9,1,8,FMN 12 Statielei
660,Statielei 26,2023-04-10,04:00:00,3,0,3,FMN 12 Statielei
660,Statielei 26,2023-04-10,05:00:00,7,5,2,FMN 12 Statielei
660,Statielei 26,2023-04-10,06:00:00,7,4,3,FMN 12 Statielei
660,Statielei 26,2023-04-10,07:00:00,12,4,8,FMN 12 Statielei
660,Statielei 26,2023-04-10,08:00:00,16,9,7,FMN 12 Statielei
660,Statielei 26,2023-04-10,09:00:00,37,12,25,FMN 12 Statielei
660,Statielei 26,2023-04-10,10:00:00,40,22,18,FMN 12 Statielei
660,Statielei 26,2023-04-10,11:00:00,36,22,14,FMN 12 Statielei
660,Statielei 26,2023-04-10,12:00:00,60,24,36,FMN 12 Statielei
660,Statielei 26,2023-04-10,13:00:00,48,33,15,FMN 12 Statielei
660,Statielei 26,2023-04-10,14:00:00,75,39,36,FMN 12 Statielei
660,Statielei 26,2023-04-10,15:00:00,40,26,14,FMN 12 Statielei
660,Statielei 26,2023-04-10,16:00:00,57,26,31,FMN 12 Statielei
660,Statielei 26,2023-04-10,17:00:00,47,26,21,FMN 12 Statielei
660,Statielei 26,2023-04-10,18:00:00,56,37,19,FMN 12 Statielei
660,Statielei 26,2023-04-10,19:00:00,46,19,27,FMN 12 Statielei
660,Statielei 26,2023-04-10,20:00:00,53,24,29,FMN 12 Statielei
660,Statielei 26,2023-04-10,21:00:00,43,20,23,FMN 12 Statielei
660,Statielei 26,2023-04-10,22:00:00,34,18,16,FMN 12 Statielei
660,Statielei 26,2023-04-10,23:00:00,31,11,20,FMN 12 Statielei
660,Statielei 26,2023-04-11,00:00:00,18,5,13,FMN 12 Statielei
660,Statielei 26,2023-04-11,01:00:00,14,4,10,FMN 12 Statielei
660,Statielei 26,2023-04-11,02:00:00,8,1,7,FMN 12 Statielei
660,Statielei 26,2023-04-11,03:00:00,7,1,6,FMN 12 Statielei
660,Statielei 26,2023-04-11,04:00:00,6,3,3,FMN 12 Statielei
660,Statielei 26,2023-04-11,05:00:00,15,7,8,FMN 12 Statielei
660,Statielei 26,2023-04-11,06:00:00,28,18,10,FMN 12 Statielei
660,Statielei 26,2023-04-11,07:00:00,65,29,36,FMN 12 Statielei
660,Statielei 26,2023-04-11,08:00:00,87,35,52,FMN 12 Statielei
660,Statielei 26,2023-04-11,09:00:00,105,47,58,FMN 12 Statielei
660,Statielei 26,2023-04-11,10:00:00,57,40,17,FMN 12 Statielei
660,Statielei 26,2023-04-11,11:00:00,71,39,32,FMN 12 Statielei
660,Statielei 26,2023-04-11,12:00:00,81,46,35,FMN 12 Statielei
660,Statielei 26,2023-04-11,13:00:00,76,45,31,FMN 12 Statielei
660,Statielei 26,2023-04-11,14:00:00,78,44,34,FMN 12 Statielei
660,Statielei 26,2023-04-11,15:00:00,100,40,60,FMN 12 Statielei
660,Statielei 26,2023-04-11,16:00:00,141,65,76,FMN 12 Statielei
660,Statielei 26,2023-04-11,17:00:00,152,81,71,FMN 12 Statielei
660,Statielei 26,2023-04-11,18:00:00,138,67,71,FMN 12 Statielei
660,Statielei 26,2023-04-11,19:00:00,113,62,51,FMN 12 Statielei
660,Statielei 26,2023-04-11,20:00:00,101,55,46,FMN 12 Statielei
660,Statielei 26,2023-04-11,21:00:00,66,34,32,FMN 12 Statielei
660,Statielei 26,2023-04-11,22:00:00,56,24,32,FMN 12 Statielei
660,Statielei 26,2023-04-11,23:00:00,50,17,33,FMN 12 Statielei
660,Statielei 26,2023-04-12,00:00:00,28,4,24,FMN 12 Statielei
660,Statielei 26,2023-04-12,01:00:00,14,4,10,FMN 12 Statielei
660,Statielei 26,2023-04-12,02:00:00,5,2,3,FMN 12 Statielei
660,Statielei 26,2023-04-12,03:00:00,6,1,5,FMN 12 Statielei
660,Statielei 26,2023-04-12,04:00:00,6,4,2,FMN 12 Statielei
660,Statielei 26,2023-04-12,05:00:00,9,4,5,FMN 12 Statielei
660,Statielei 26,2023-04-12,06:00:00,25,14,11,FMN 12 Statielei
660,Statielei 26,2023-04-12,07:00:00,41,17,24,FMN 12 Statielei
660,Statielei 26,2023-04-12,08:00:00,72,32,40,FMN 12 Statielei
660,Statielei 26,2023-04-12,09:00:00,77,48,29,FMN 12 Statielei
660,Statielei 26,2023-04-12,10:00:00,53,29,24,FMN 12 Statielei
660,Statielei 26,2023-04-12,11:00:00,69,31,38,FMN 12 Statielei
660,Statielei 26,2023-04-12,12:00:00,68,33,35,FMN 12 Statielei
660,Statielei 26,2023-04-12,13:00:00,46,30,16,FMN 12 Statielei
660,Statielei 26,2023-04-12,14:00:00,63,31,32,FMN 12 Statielei
660,Statielei 26,2023-04-12,15:00:00,55,24,31,FMN 12 Statielei
660,Statielei 26,2023-04-12,16:00:00,119,70,49,FMN 12 Statielei
660,Statielei 26,2023-04-12,17:00:00,141,58,83,FMN 12 Statielei
660,Statielei 26,2023-04-12,18:00:00,105,61,44,FMN 12 Statielei
660,Statielei 26,2023-04-12,19:00:00,118,68,50,FMN 12 Statielei
660,Statielei 26,2023-04-12,20:00:00,82,36,46,FMN 12 Statielei
660,Statielei 26,2023-04-12,21:00:00,55,37,18,FMN 12 Statielei
660,Statielei 26,2023-04-12,22:00:00,69,36,33,FMN 12 Statielei
660,Statielei 26,2023-04-12,23:00:00,38,6,32,FMN 12 Statielei
660,Statielei 26,2023-04-13,00:00:00,35,10,25,FMN 12 Statielei
660,Statielei 26,2023-04-13,01:00:00,15,6,9,FMN 12 Statielei
660,Statielei 26,2023-04-13,02:00:00,7,3,4,FMN 12 Statielei
660,Statielei 26,2023-04-13,03:00:00,7,1,6,FMN 12 Statielei
660,Statielei 26,2023-04-13,04:00:00,14,6,8,FMN 12 Statielei
660,Statielei 26,2023-04-13,05:00:00,11,5,6,FMN 12 Statielei
660,Statielei 26,2023-04-13,06:00:00,25,12,13,FMN 12 Statielei
660,Statielei 26,2023-04-13,07:00:00,61,29,32,FMN 12 Statielei
660,Statielei 26,2023-04-13,08:00:00,124,64,60,FMN 12 Statielei
660,Statielei 26,2023-04-13,09:00:00,90,55,35,FMN 12 Statielei
660,Statielei 26,2023-04-13,10:00:00,88,56,32,FMN 12 Statielei
660,Statielei 26,2023-04-13,11:00:00,61,23,38,FMN 12 Statielei
660,Statielei 26,2023-04-13,12:00:00,72,38,34,FMN 12 Statielei
660,Statielei 26,2023-04-13,13:00:00,60,26,34,FMN 12 Statielei
660,Statielei 26,2023-04-13,14:00:00,60,30,30,FMN 12 Statielei
660,Statielei 26,2023-04-13,15:00:00,100,58,42,FMN 12 Statielei
660,Statielei 26,2023-04-13,16:00:00,133,62,71,FMN 12 Statielei
660,Statielei 26,2023-04-13,17:00:00,148,65,83,FMN 12 Statielei
660,Statielei 26,2023-04-13,18:00:00,164,85,79,FMN 12 Statielei
660,Statielei 26,2023-04-13,19:00:00,139,81,58,FMN 12 Statielei
660,Statielei 26,2023-04-13,20:00:00,94,41,53,FMN 12 Statielei
660,Statielei 26,2023-04-13,21:00:00,76,40,36,FMN 12 Statielei
660,Statielei 26,2023-04-13,22:00:00,63,36,27,FMN 12 Statielei
660,Statielei 26,2023-04-13,23:00:00,48,17,31,FMN 12 Statielei
660,Statielei 26,2023-04-14,00:00:00,32,13,19,FMN 12 Statielei
660,Statielei 26,2023-04-14,01:00:00,17,6,11,FMN 12 Statielei
660,Statielei 26,2023-04-14,02:00:00,12,3,9,FMN 12 Statielei
660,Statielei 26,2023-04-14,03:00:00,11,5,6,FMN 12 Statielei
660,Statielei 26,2023-04-14,04:00:00,8,4,4,FMN 12 Statielei
660,Statielei 26,2023-04-14,05:00:00,11,3,8,FMN 12 Statielei
660,Statielei 26,2023-04-14,06:00:00,29,11,18,FMN 12 Statielei
660,Statielei 26,2023-04-14,07:00:00,58,26,32,FMN 12 Statielei
660,Statielei 26,2023-04-14,08:00:00,82,49,33,FMN 12 Statielei
660,Statielei 26,2023-04-14,09:00:00,93,55,38,FMN 12 Statielei
660,Statielei 26,2023-04-14,10:00:00,90,55,35,FMN 12 Statielei
660,Statielei 26,2023-04-14,11:00:00,103,54,49,FMN 12 Statielei
660,Statielei 26,2023-04-14,12:00:00,91,47,44,FMN 12 Statielei
660,Statielei 26,2023-04-14,13:00:00,93,54,39,FMN 12 Statielei
660,Statielei 26,2023-04-14,14:00:00,94,60,34,FMN 12 Statielei
660,Statielei 26,2023-04-14,15:00:00,106,37,69,FMN 12 Statielei
660,Statielei 26,2023-04-14,16:00:00,156,86,70,FMN 12 Statielei
660,Statielei 26,2023-04-14,17:00:00,166,76,90,FMN 12 Statielei
660,Statielei 26,2023-04-14,18:00:00,159,92,67,FMN 12 Statielei
660,Statielei 26,2023-04-14,19:00:00,141,73,68,FMN 12 Statielei
660,Statielei 26,2023-04-14,20:00:00,103,47,56,FMN 12 Statielei
660,Statielei 26,2023-04-14,21:00:00,64,32,32,FMN 12 Statielei
660,Statielei 26,2023-04-14,22:00:00,90,49,41,FMN 12 Statielei
660,Statielei 26,2023-04-14,23:00:00,67,35,32,FMN 12 Statielei
660,Statielei 26,2023-04-15,00:00:00,47,20,27,FMN 12 Statielei
660,Statielei 26,2023-04-15,01:00:00,35,10,25,FMN 12 Statielei
660,Statielei 26,2023-04-15,02:00:00,26,9,17,FMN 12 Statielei
660,Statielei 26,2023-04-15,03:00:00,15,4,11,FMN 12 Statielei
660,Statielei 26,2023-04-15,04:00:00,8,4,4,FMN 12 Statielei
660,Statielei 26,2023-04-15,05:00:00,12,6,6,FMN 12 Statielei
660,Statielei 26,2023-04-15,06:00:00,8,4,4,FMN 12 Statielei
660,Statielei 26,2023-04-15,07:00:00,14,6,8,FMN 12 Statielei
660,Statielei 26,2023-04-15,08:00:00,37,20,17,FMN 12 Statielei
660,Statielei 26,2023-04-15,09:00:00,73,38,35,FMN 12 Statielei
660,Statielei 26,2023-04-15,10:00:00,91,52,39,FMN 12 Statielei
660,Statielei 26,2023-04-15,11:00:00,81,46,35,FMN 12 Statielei
660,Statielei 26,2023-04-15,12:00:00,127,67,60,FMN 12 Statielei
660,Statielei 26,2023-04-15,13:00:00,118,64,54,FMN 12 Statielei
660,Statielei 26,2023-04-15,14:00:00,115,53,62,FMN 12 Statielei
660,Statielei 26,2023-04-15,15:00:00,112,59,53,FMN 12 Statielei
660,Statielei 26,2023-04-15,16:00:00,127,74,53,FMN 12 Statielei
660,Statielei 26,2023-04-15,17:00:00,136,69,67,FMN 12 Statielei
660,Statielei 26,2023-04-15,18:00:00,181,99,82,FMN 12 Statielei
660,Statielei 26,2023-04-15,19:00:00,158,69,89,FMN 12 Statielei
660,Statielei 26,2023-04-15,20:00:00,102,45,57,FMN 12 Statielei
660,Statielei 26,2023-04-15,21:00:00,58,21,37,FMN 12 Statielei
660,Statielei 26,2023-04-15,22:00:00,62,34,28,FMN 12 Statielei
660,Statielei 26,2023-04-15,23:00:00,69,25,44,FMN 12 Statielei
660,Statielei 26,2023-04-16,00:00:00,57,24,33,FMN 12 Statielei
660,Statielei 26,2023-04-16,01:00:00,36,17,19,FMN 12 Statielei
660,Statielei 26,2023-04-16,02:00:00,29,7,22,FMN 12 Statielei
660,Statielei 26,2023-04-16,03:00:00,21,7,14,FMN 12 Statielei
660,Statielei 26,2023-04-16,04:00:00,6,2,4,FMN 12 Statielei
660,Statielei 26,2023-04-16,05:00:00,15,8,7,FMN 12 Statielei
660,Statielei 26,2023-04-16,06:00:00,11,8,3,FMN 12 Statielei
660,Statielei 26,2023-04-16,07:00:00,9,4,5,FMN 12 Statielei
660,Statielei 26,2023-04-16,08:00:00,19,8,11,FMN 12 Statielei
660,Statielei 26,2023-04-16,09:00:00,35,12,23,FMN 12 Statielei
660,Statielei 26,2023-04-16,10:00:00,59,30,29,FMN 12 Statielei
660,Statielei 26,2023-04-16,11:00:00,55,29,26,FMN 12 Statielei
660,Statielei 26,2023-04-16,12:00:00,86,55,31,FMN 12 Statielei
660,Statielei 26,2023-04-16,13:00:00,108,63,45,FMN 12 Statielei
660,Statielei 26,2023-04-16,14:00:00,66,44,22,FMN 12 Statielei
660,Statielei 26,2023-04-16,15:00:00,89,41,48,FMN 12 Statielei
660,Statielei 26,2023-04-16,16:00:00,108,58,50,FMN 12 Statielei
660,Statielei 26,2023-04-16,17:00:00,104,43,61,FMN 12 Statielei
660,Statielei 26,2023-04-16,18:00:00,124,72,52,FMN 12 Statielei
660,Statielei 26,2023-04-16,19:00:00,95,54,41,FMN 12 Statielei
660,Statielei 26,2023-04-16,20:00:00,87,50,37,FMN 12 Statielei
660,Statielei 26,2023-04-16,21:00:00,39,19,20,FMN 12 Statielei
660,Statielei 26,2023-04-16,22:00:00,54,35,19,FMN 12 Statielei
660,Statielei 26,2023-04-16,23:00:00,33,9,24,FMN 12 Statielei
660,Statielei 26,2023-04-17,00:00:00,29,6,23,FMN 12 Statielei
660,Statielei 26,2023-04-17,01:00:00,12,4,8,FMN 12 Statielei
660,Statielei 26,2023-04-17,02:00:00,5,1,4,FMN 12 Statielei
660,Statielei 26,2023-04-17,03:00:00,2,0,2,FMN 12 Statielei
660,Statielei 26,2023-04-17,04:00:00,5,4,1,FMN 12 Statielei
660,Statielei 26,2023-04-17,05:00:00,18,13,5,FMN 12 Statielei
660,Statielei 26,2023-04-17,06:00:00,35,19,16,FMN 12 Statielei
660,Statielei 26,2023-04-17,07:00:00,123,54,69,FMN 12 Statielei
660,Statielei 26,2023-04-17,08:00:00,275,140,135,FMN 12 Statielei
660,Statielei 26,2023-04-17,09:00:00,126,75,51,FMN 12 Statielei
660,Statielei 26,2023-04-17,10:00:00,69,42,27,FMN 12 Statielei
660,Statielei 26,2023-04-17,11:00:00,72,45,27,FMN 12 Statielei
660,Statielei 26,2023-04-17,12:00:00,93,53,40,FMN 12 Statielei
660,Statielei 26,2023-04-17,13:00:00,72,36,36,FMN 12 Statielei
660,Statielei 26,2023-04-17,14:00:00,91,53,38,FMN 12 Statielei
660,Statielei 26,2023-04-17,15:00:00,172,68,104,FMN 12 Statielei
660,Statielei 26,2023-04-17,16:00:00,269,138,131,FMN 12 Statielei
660,Statielei 26,2023-04-17,17:00:00,242,114,128,FMN 12 Statielei
660,Statielei 26,2023-04-17,18:00:00,140,69,71,FMN 12 Statielei
660,Statielei 26,2023-04-17,19:00:00,142,75,67,FMN 12 Statielei
660,Statielei 26,2023-04-17,20:00:00,105,49,56,FMN 12 Statielei
660,Statielei 26,2023-04-17,21:00:00,78,49,29,FMN 12 Statielei
660,Statielei 26,2023-04-17,22:00:00,82,54,28,FMN 12 Statielei
660,Statielei 26,2023-04-17,23:00:00,32,8,24,FMN 12 Statielei
660,Statielei 26,2023-04-18,00:00:00,29,6,23,FMN 12 Statielei
660,Statielei 26,2023-04-18,01:00:00,23,9,14,FMN 12 Statielei
660,Statielei 26,2023-04-18,02:00:00,8,2,6,FMN 12 Statielei
660,Statielei 26,2023-04-18,03:00:00,4,0,4,FMN 12 Statielei
660,Statielei 26,2023-04-18,04:00:00,9,5,4,FMN 12 Statielei
660,Statielei 26,2023-04-18,05:00:00,16,10,6,FMN 12 Statielei
660,Statielei 26,2023-04-18,06:00:00,31,15,16,FMN 12 Statielei
660,Statielei 26,2023-04-18,07:00:00,153,66,87,FMN 12 Statielei
660,Statielei 26,2023-04-18,08:00:00,302,168,134,FMN 12 Statielei
660,Statielei 26,2023-04-18,09:00:00,120,77,43,FMN 12 Statielei
660,Statielei 26,2023-04-18,10:00:00,73,47,26,FMN 12 Statielei
660,Statielei 26,2023-04-18,11:00:00,60,27,33,FMN 12 Statielei
660,Statielei 26,2023-04-18,12:00:00,99,58,41,FMN 12 Statielei
660,Statielei 26,2023-04-18,13:00:00,90,51,39,FMN 12 Statielei
660,Statielei 26,2023-04-18,14:00:00,78,44,34,FMN 12 Statielei
660,Statielei 26,2023-04-18,15:00:00,146,56,90,FMN 12 Statielei
660,Statielei 26,2023-04-18,16:00:00,219,112,107,FMN 12 Statielei
660,Statielei 26,2023-04-18,17:00:00,259,118,141,FMN 12 Statielei
660,Statielei 26,2023-04-18,18:00:00,182,98,84,FMN 12 Statielei
660,Statielei 26,2023-04-18,19:00:00,156,81,75,FMN 12 Statielei
660,Statielei 26,2023-04-18,20:00:00,126,80,46,FMN 12 Statielei
660,Statielei 26,2023-04-18,21:00:00,76,40,36,FMN 12 Statielei
660,Statielei 26,2023-04-18,22:00:00,78,38,40,FMN 12 Statielei
660,Statielei 26,2023-04-18,23:00:00,65,17,48,FMN 12 Statielei
660,Statielei 26,2023-04-19,00:00:00,46,9,37,FMN 12 Statielei
660,Statielei 26,2023-04-19,01:00:00,18,4,14,FMN 12 Statielei
660,Statielei 26,2023-04-19,02:00:00,6,1,5,FMN 12 Statielei
660,Statielei 26,2023-04-19,03:00:00,8,2,6,FMN 12 Statielei
660,Statielei 26,2023-04-19,04:00:00,6,4,2,FMN 12 Statielei
660,Statielei 26,2023-04-19,05:00:00,17,10,7,FMN 12 Statielei
660,Statielei 26,2023-04-19,06:00:00,28,15,13,FMN 12 Statielei
660,Statielei 26,2023-04-19,07:00:00,122,51,71,FMN 12 Statielei
660,Statielei 26,2023-04-19,08:00:00,289,171,118,FMN 12 Statielei
660,Statielei 26,2023-04-19,09:00:00,116,72,44,FMN 12 Statielei
660,Statielei 26,2023-04-19,10:00:00,81,51,30,FMN 12 Statielei
660,Statielei 26,2023-04-19,11:00:00,84,51,33,FMN 12 Statielei
660,Statielei 26,2023-04-19,12:00:00,247,126,121,FMN 12 Statielei
660,Statielei 26,2023-04-19,13:00:00,150,92,58,FMN 12 Statielei
660,Statielei 26,2023-04-19,14:00:00,111,52,59,FMN 12 Statielei
660,Statielei 26,2023-04-19,15:00:00,151,60,91,FMN 12 Statielei
660,Statielei 26,2023-04-19,16:00:00,247,95,152,FMN 12 Statielei
660,Statielei 26,2023-04-19,17:00:00,231,111,120,FMN 12 Statielei
660,Statielei 26,2023-04-19,18:00:00,193,95,98,FMN 12 Statielei
660,Statielei 26,2023-04-19,19:00:00,143,59,84,FMN 12 Statielei
660,Statielei 26,2023-04-19,20:00:00,118,61,57,FMN 12 Statielei
660,Statielei 26,2023-04-19,21:00:00,86,50,36,FMN 12 Statielei
660,Statielei 26,2023-04-19,22:00:00,74,43,31,FMN 12 Statielei
660,Statielei 26,2023-04-19,23:00:00,58,15,43,FMN 12 Statielei
660,Statielei 26,2023-04-20,00:00:00,42,15,27,FMN 12 Statielei
660,Statielei 26,2023-04-20,01:00:00,11,6,5,FMN 12 Statielei
660,Statielei 26,2023-04-20,02:00:00,4,1,3,FMN 12 Statielei
660,Statielei 26,2023-04-20,03:00:00,7,2,5,FMN 12 Statielei
660,Statielei 26,2023-04-20,04:00:00,8,3,5,FMN 12 Statielei
660,Statielei 26,2023-04-20,05:00:00,13,6,7,FMN 12 Statielei
660,Statielei 26,2023-04-20,06:00:00,32,14,18,FMN 12 Statielei
660,Statielei 26,2023-04-20,07:00:00,108,50,58,FMN 12 Statielei
660,Statielei 26,2023-04-20,08:00:00,297,168,129,FMN 12 Statielei
660,Statielei 26,2023-04-20,09:00:00,117,78,39,FMN 12 Statielei
660,Statielei 26,2023-04-20,10:00:00,68,43,25,FMN 12 Statielei
660,Statielei 26,2023-04-20,11:00:00,67,36,31,FMN 12 Statielei
660,Statielei 26,2023-04-20,12:00:00,114,64,50,FMN 12 Statielei
660,Statielei 26,2023-04-20,13:00:00,83,48,35,FMN 12 Statielei
660,Statielei 26,2023-04-20,14:00:00,96,47,49,FMN 12 Statielei
660,Statielei 26,2023-04-20,15:00:00,140,63,77,FMN 12 Statielei
660,Statielei 26,2023-04-20,16:00:00,217,120,97,FMN 12 Statielei
660,Statielei 26,2023-04-20,17:00:00,189,73,116,FMN 12 Statielei
660,Statielei 26,2023-04-20,18:00:00,165,88,77,FMN 12 Statielei
660,Statielei 26,2023-04-20,19:00:00,168,91,77,FMN 12 Statielei
660,Statielei 26,2023-04-20,20:00:00,95,45,50,FMN 12 Statielei
660,Statielei 26,2023-04-20,21:00:00,91,50,41,FMN 12 Statielei
660,Statielei 26,2023-04-20,22:00:00,83,41,42,FMN 12 Statielei
660,Statielei 26,2023-04-20,23:00:00,76,26,50,FMN 12 Statielei
660,Statielei 26,2023-04-21,00:00:00,41,12,29,FMN 12 Statielei
660,Statielei 26,2023-04-21,01:00:00,28,8,20,FMN 12 Statielei
660,Statielei 26,2023-04-21,02:00:00,16,6,10,FMN 12 Statielei
660,Statielei 26,2023-04-21,03:00:00,3,1,2,FMN 12 Statielei
660,Statielei 26,2023-04-21,04:00:00,7,3,4,FMN 12 Statielei
660,Statielei 26,2023-04-21,05:00:00,11,6,5,FMN 12 Statielei
660,Statielei 26,2023-04-21,06:00:00,32,18,14,FMN 12 Statielei
660,Statielei 26,2023-04-21,07:00:00,102,49,53,FMN 12 Statielei
660,Statielei 26,2023-04-21,08:00:00,3,1,2,FMN 12 Statielei
660,Statielei 26,2023-04-21,09:00:00,0,0,0,FMN 12 Statielei
660,Statielei 26,2023-04-21,10:00:00,0,0,0,FMN 12 Statielei
660,Statielei 26,2023-04-21,11:00:00,0,0,0,FMN 12 Statielei
660,Statielei 26,2023-04-21,12:00:00,95,57,38,FMN 12 Statielei
660,Statielei 26,2023-04-21,13:00:00,116,65,51,FMN 12 Statielei
660,Statielei 26,2023-04-21,14:00:00,128,59,69,FMN 12 Statielei
660,Statielei 26,2023-04-21,15:00:00,175,83,92,FMN 12 Statielei
660,Statielei 26,2023-04-21,16:00:00,168,93,75,FMN 12 Statielei
660,Statielei 26,2023-04-21,17:00:00,178,91,87,FMN 12 Statielei
660,Statielei 26,2023-04-21,18:00:00,4,3,1,FMN 12 Statielei
660,Statielei 26,2023-04-21,19:00:00,0,0,0,FMN 12 Statielei
660,Statielei 26,2023-04-21,20:00:00,111,57,54,FMN 12 Statielei
660,Statielei 26,2023-04-21,21:00:00,52,26,26,FMN 12 Statielei
660,Statielei 26,2023-04-21,22:00:00,78,41,37,FMN 12 Statielei
660,Statielei 26,2023-04-21,23:00:00,67,22,45,FMN 12 Statielei
660,Statielei 26,2023-04-22,00:00:00,55,21,34,FMN 12 Statielei
660,Statielei 26,2023-04-22,01:00:00,15,6,9,FMN 12 Statielei
660,Statielei 26,2023-04-22,02:00:00,21,9,12,FMN 12 Statielei
660,Statielei 26,2023-04-22,03:00:00,12,5,7,FMN 12 Statielei
660,Statielei 26,2023-04-22,04:00:00,5,4,1,FMN 12 Statielei
660,Statielei 26,2023-04-22,05:00:00,4,3,1,FMN 12 Statielei
660,Statielei 26,2023-04-22,06:00:00,7,3,4,FMN 12 Statielei
660,Statielei 26,2023-04-22,07:00:00,18,9,9,FMN 12 Statielei
660,Statielei 26,2023-04-22,08:00:00,63,28,35,FMN 12 Statielei
660,Statielei 26,2023-04-22,09:00:00,98,40,58,FMN 12 Statielei
660,Statielei 26,2023-04-22,10:00:00,128,73,55,FMN 12 Statielei
660,Statielei 26,2023-04-22,11:00:00,114,61,53,FMN 12 Statielei
660,Statielei 26,2023-04-22,12:00:00,89,54,35,FMN 12 Statielei
660,Statielei 26,2023-04-22,13:00:00,81,41,40,FMN 12 Statielei
660,Statielei 26,2023-04-22,14:00:00,85,38,47,FMN 12 Statielei
660,Statielei 26,2023-04-22,15:00:00,71,39,32,FMN 12 Statielei
660,Statielei 26,2023-04-22,16:00:00,70,33,37,FMN 12 Statielei
660,Statielei 26,2023-04-22,17:00:00,122,59,63,FMN 12 Statielei
660,Statielei 26,2023-04-22,18:00:00,96,60,36,FMN 12 Statielei
660,Statielei 26,2023-04-22,19:00:00,116,70,46,FMN 12 Statielei
660,Statielei 26,2023-04-22,20:00:00,115,56,59,FMN 12 Statielei
660,Statielei 26,2023-04-22,21:00:00,64,28,36,FMN 12 Statielei
660,Statielei 26,2023-04-22,22:00:00,55,23,32,FMN 12 Statielei
660,Statielei 26,2023-04-22,23:00:00,78,41,37,FMN 12 Statielei
660,Statielei 26,2023-04-23,00:00:00,40,14,26,FMN 12 Statielei
660,Statielei 26,2023-04-23,01:00:00,58,22,36,FMN 12 Statielei
660,Statielei 26,2023-04-23,02:00:00,21,9,12,FMN 12 Statielei
660,Statielei 26,2023-04-23,03:00:00,26,12,14,FMN 12 Statielei
660,Statielei 26,2023-04-23,04:00:00,10,6,4,FMN 12 Statielei
660,Statielei 26,2023-04-23,05:00:00,9,5,4,FMN 12 Statielei
660,Statielei 26,2023-04-23,06:00:00,3,2,1,FMN 12 Statielei
660,Statielei 26,2023-04-23,07:00:00,12,6,6,FMN 12 Statielei
660,Statielei 26,2023-04-23,08:00:00,41,16,25,FMN 12 Statielei
660,Statielei 26,2023-04-23,09:00:00,74,37,37,FMN 12 Statielei
660,Statielei 26,2023-04-23,10:00:00,90,40,50,FMN 12 Statielei
660,Statielei 26,2023-04-23,11:00:00,98,52,46,FMN 12 Statielei
660,Statielei 26,2023-04-23,12:00:00,134,87,47,FMN 12 Statielei
660,Statielei 26,2023-04-23,13:00:00,114,56,58,FMN 12 Statielei
660,Statielei 26,2023-04-23,14:00:00,133,62,71,FMN 12 Statielei
660,Statielei 26,2023-04-23,15:00:00,81,43,38,FMN 12 Statielei
660,Statielei 26,2023-04-23,16:00:00,76,30,46,FMN 12 Statielei
660,Statielei 26,2023-04-23,17:00:00,111,50,61,FMN 12 Statielei
660,Statielei 26,2023-04-23,18:00:00,93,58,35,FMN 12 Statielei
660,Statielei 26,2023-04-23,19:00:00,60,29,31,FMN 12 Statielei
660,Statielei 26,2023-04-23,20:00:00,60,31,29,FMN 12 Statielei
660,Statielei 26,2023-04-23,21:00:00,49,22,27,FMN 12 Statielei
660,Statielei 26,2023-04-23,22:00:00,52,19,33,FMN 12 Statielei
660,Statielei 26,2023-04-23,23:00:00,21,5,16,FMN 12 Statielei
660,Statielei 26,2023-04-24,00:00:00,15,7,8,FMN 12 Statielei
660,Statielei 26,2023-04-24,01:00:00,5,4,1,FMN 12 Statielei
660,Statielei 26,2023-04-24,02:00:00,1,1,0,FMN 12 Statielei
660,Statielei 26,2023-04-24,03:00:00,3,1,2,FMN 12 Statielei
660,Statielei 26,2023-04-24,04:00:00,3,1,2,FMN 12 Statielei
660,Statielei 26,2023-04-24,05:00:00,15,5,10,FMN 12 Statielei
660,Statielei 26,2023-04-24,06:00:00,22,10,12,FMN 12 Statielei
660,Statielei 26,2023-04-24,07:00:00,94,41,53,FMN 12 Statielei
660,Statielei 26,2023-04-24,08:00:00,219,107,112,FMN 12 Statielei
660,Statielei 26,2023-04-24,09:00:00,96,62,34,FMN 12 Statielei
660,Statielei 26,2023-04-24,10:00:00,49,29,20,FMN 12 Statielei
660,Statielei 26,2023-04-24,11:00:00,48,26,22,FMN 12 Statielei
660,Statielei 26,2023-04-24,12:00:00,99,57,42,FMN 12 Statielei
660,Statielei 26,2023-04-24,13:00:00,64,42,22,FMN 12 Statielei
660,Statielei 26,2023-04-24,14:00:00,88,42,46,FMN 12 Statielei
660,Statielei 26,2023-04-24,15:00:00,133,62,71,FMN 12 Statielei
660,Statielei 26,2023-04-24,16:00:00,201,97,104,FMN 12 Statielei
660,Statielei 26,2023-04-24,17:00:00,194,95,99,FMN 12 Statielei
660,Statielei 26,2023-04-24,18:00:00,149,71,78,FMN 12 Statielei
660,Statielei 26,2023-04-24,19:00:00,107,57,50,FMN 12 Statielei
660,Statielei 26,2023-04-24,20:00:00,76,37,39,FMN 12 Statielei
660,Statielei 26,2023-04-24,21:00:00,80,43,37,FMN 12 Statielei
660,Statielei 26,2023-04-24,22:00:00,64,34,30,FMN 12 Statielei
660,Statielei 26,2023-04-24,23:00:00,32,12,20,FMN 12 Statielei
660,Statielei 26,2023-04-25,00:00:00,8,3,5,FMN 12 Statielei
660,Statielei 26,2023-04-25,01:00:00,10,5,5,FMN 12 Statielei
660,Statielei 26,2023-04-25,02:00:00,7,3,4,FMN 12 Statielei
660,Statielei 26,2023-04-25,03:00:00,5,4,1,FMN 12 Statielei
660,Statielei 26,2023-04-25,04:00:00,6,4,2,FMN 12 Statielei
660,Statielei 26,2023-04-25,05:00:00,16,6,10,FMN 12 Statielei
660,Statielei 26,2023-04-25,06:00:00,36,17,19,FMN 12 Statielei
660,Statielei 26,2023-04-25,07:00:00,110,56,54,FMN 12 Statielei
660,Statielei 26,2023-04-25,08:00:00,318,172,146,FMN 12 Statielei
660,Statielei 26,2023-04-25,09:00:00,125,81,44,FMN 12 Statielei
660,Statielei 26,2023-04-25,10:00:00,66,44,22,FMN 12 Statielei
660,Statielei 26,2023-04-25,11:00:00,75,32,43,FMN 12 Statielei
660,Statielei 26,2023-04-25,12:00:00,100,59,41,FMN 12 Statielei
660,Statielei 26,2023-04-25,13:00:00,86,48,38,FMN 12 Statielei
660,Statielei 26,2023-04-25,14:00:00,118,60,58,FMN 12 Statielei
660,Statielei 26,2023-04-25,15:00:00,166,66,100,FMN 12 Statielei
660,Statielei 26,2023-04-25,16:00:00,216,104,112,FMN 12 Statielei
660,Statielei 26,2023-04-25,17:00:00,218,95,123,FMN 12 Statielei
660,Statielei 26,2023-04-25,18:00:00,163,92,71,FMN 12 Statielei
660,Statielei 26,2023-04-25,19:00:00,136,75,61,FMN 12 Statielei
660,Statielei 26,2023-04-25,20:00:00,109,59,50,FMN 12 Statielei
660,Statielei 26,2023-04-25,21:00:00,78,33,45,FMN 12 Statielei
660,Statielei 26,2023-04-25,22:00:00,87,33,54,FMN 12 Statielei
660,Statielei 26,2023-04-25,23:00:00,48,17,31,FMN 12 Statielei
660,Statielei 26,2023-04-26,00:00:00,16,4,12,FMN 12 Statielei
660,Statielei 26,2023-04-26,01:00:00,10,2,8,FMN 12 Statielei
660,Statielei 26,2023-04-26,02:00:00,5,2,3,FMN 12 Statielei
660,Statielei 26,2023-04-26,03:00:00,1,0,1,FMN 12 Statielei
660,Statielei 26,2023-04-26,04:00:00,8,5,3,FMN 12 Statielei
660,Statielei 26,2023-04-26,05:00:00,16,8,8,FMN 12 Statielei
660,Statielei 26,2023-04-26,06:00:00,23,11,12,FMN 12 Statielei
660,Statielei 26,2023-04-26,07:00:00,124,48,76,FMN 12 Statielei
660,Statielei 26,2023-04-26,08:00:00,290,152,138,FMN 12 Statielei
660,Statielei 26,2023-04-26,09:00:00,93,54,39,FMN 12 Statielei
660,Statielei 26,2023-04-26,10:00:00,81,44,37,FMN 12 Statielei
660,Statielei 26,2023-04-26,11:00:00,95,41,54,FMN 12 Statielei
660,Statielei 26,2023-04-26,12:00:00,207,110,97,FMN 12 Statielei
660,Statielei 26,2023-04-26,13:00:00,137,65,72,FMN 12 Statielei
660,Statielei 26,2023-04-26,14:00:00,137,74,63,FMN 12 Statielei
660,Statielei 26,2023-04-26,15:00:00,136,62,74,FMN 12 Statielei
660,Statielei 26,2023-04-26,16:00:00,201,97,104,FMN 12 Statielei
660,Statielei 26,2023-04-26,17:00:00,196,105,91,FMN 12 Statielei
660,Statielei 26,2023-04-26,18:00:00,173,98,75,FMN 12 Statielei
660,Statielei 26,2023-04-26,19:00:00,159,78,81,FMN 12 Statielei
660,Statielei 26,2023-04-26,20:00:00,126,68,58,FMN 12 Statielei
660,Statielei 26,2023-04-26,21:00:00,88,52,36,FMN 12 Statielei
660,Statielei 26,2023-04-26,22:00:00,86,39,47,FMN 12 Statielei
660,Statielei 26,2023-04-26,23:00:00,60,21,39,FMN 12 Statielei
660,Statielei 26,2023-04-27,00:00:00,18,6,12,FMN 12 Statielei
660,Statielei 26,2023-04-27,01:00:00,6,3,3,FMN 12 Statielei
660,Statielei 26,2023-04-27,02:00:00,0,0,0,FMN 12 Statielei
660,Statielei 26,2023-04-27,03:00:00,3,2,1,FMN 12 Statielei
660,Statielei 26,2023-04-27,04:00:00,10,6,4,FMN 12 Statielei
660,Statielei 26,2023-04-27,05:00:00,13,4,9,FMN 12 Statielei
660,Statielei 26,2023-04-27,06:00:00,27,17,10,FMN 12 Statielei
660,Statielei 26,2023-04-27,07:00:00,145,67,78,FMN 12 Statielei
660,Statielei 26,2023-04-27,08:00:00,292,174,118,FMN 12 Statielei
660,Statielei 26,2023-04-27,09:00:00,137,99,38,FMN 12 Statielei
660,Statielei 26,2023-04-27,10:00:00,97,56,41,FMN 12 Statielei
660,Statielei 26,2023-04-27,11:00:00,80,43,37,FMN 12 Statielei
660,Statielei 26,2023-04-27,12:00:00,129,75,54,FMN 12 Statielei
660,Statielei 26,2023-04-27,13:00:00,96,51,45,FMN 12 Statielei
660,Statielei 26,2023-04-27,14:00:00,91,49,42,FMN 12 Statielei
660,Statielei 26,2023-04-27,15:00:00,190,84,106,FMN 12 Statielei
660,Statielei 26,2023-04-27,16:00:00,224,109,115,FMN 12 Statielei
660,Statielei 26,2023-04-27,17:00:00,233,122,111,FMN 12 Statielei
660,Statielei 26,2023-04-27,18:00:00,199,101,98,FMN 12 Statielei
660,Statielei 26,2023-04-27,19:00:00,154,93,61,FMN 12 Statielei
660,Statielei 26,2023-04-27,20:00:00,115,63,52,FMN 12 Statielei
660,Statielei 26,2023-04-27,21:00:00,83,50,33,FMN 12 Statielei
660,Statielei 26,2023-04-27,22:00:00,95,35,60,FMN 12 Statielei
660,Statielei 26,2023-04-27,23:00:00,51,17,34,FMN 12 Statielei
660,Statielei 26,2023-04-28,00:00:00,25,5,20,FMN 12 Statielei
660,Statielei 26,2023-04-28,01:00:00,13,7,6,FMN 12 Statielei
660,Statielei 26,2023-04-28,02:00:00,4,0,4,FMN 12 Statielei
660,Statielei 26,2023-04-28,03:00:00,5,2,3,FMN 12 Statielei
660,Statielei 26,2023-04-28,04:00:00,7,4,3,FMN 12 Statielei
660,Statielei 26,2023-04-28,05:00:00,18,8,10,FMN 12 Statielei
660,Statielei 26,2023-04-28,06:00:00,31,18,13,FMN 12 Statielei
660,Statielei 26,2023-04-28,07:00:00,111,43,68,FMN 12 Statielei
660,Statielei 26,2023-04-28,08:00:00,236,135,101,FMN 12 Statielei
660,Statielei 26,2023-04-28,09:00:00,91,54,37,FMN 12 Statielei
660,Statielei 26,2023-04-28,10:00:00,93,59,34,FMN 12 Statielei
660,Statielei 26,2023-04-28,11:00:00,82,51,31,FMN 12 Statielei
660,Statielei 26,2023-04-28,12:00:00,80,42,38,FMN 12 Statielei
660,Statielei 26,2023-04-28,13:00:00,77,41,36,FMN 12 Statielei
660,Statielei 26,2023-04-28,14:00:00,97,43,54,FMN 12 Statielei
660,Statielei 26,2023-04-28,15:00:00,137,68,69,FMN 12 Statielei
660,Statielei 26,2023-04-28,16:00:00,183,87,96,FMN 12 Statielei
660,Statielei 26,2023-04-28,17:00:00,174,83,91,FMN 12 Statielei
660,Statielei 26,2023-04-28,18:00:00,135,71,64,FMN 12 Statielei
660,Statielei 26,2023-04-28,19:00:00,131,67,64,FMN 12 Statielei
660,Statielei 26,2023-04-28,20:00:00,83,47,36,FMN 12 Statielei
660,Statielei 26,2023-04-28,21:00:00,85,44,41,FMN 12 Statielei
660,Statielei 26,2023-04-28,22:00:00,63,26,37,FMN 12 Statielei
660,Statielei 26,2023-04-28,23:00:00,70,29,41,FMN 12 Statielei
660,Statielei 26,2023-04-29,00:00:00,48,17,31,FMN 12 Statielei
660,Statielei 26,2023-04-29,01:00:00,35,10,25,FMN 12 Statielei
660,Statielei 26,2023-04-29,02:00:00,19,5,14,FMN 12 Statielei
660,Statielei 26,2023-04-29,03:00:00,9,4,5,FMN 12 Statielei
660,Statielei 26,2023-04-29,04:00:00,10,2,8,FMN 12 Statielei
660,Statielei 26,2023-04-29,05:00:00,9,4,5,FMN 12 Statielei
660,Statielei 26,2023-04-29,06:00:00,14,10,4,FMN 12 Statielei
660,Statielei 26,2023-04-29,07:00:00,21,8,13,FMN 12 Statielei
660,Statielei 26,2023-04-29,08:00:00,49,21,28,FMN 12 Statielei
660,Statielei 26,2023-04-29,09:00:00,95,53,42,FMN 12 Statielei
660,Statielei 26,2023-04-29,10:00:00,115,64,51,FMN 12 Statielei
660,Statielei 26,2023-04-29,11:00:00,114,66,48,FMN 12 Statielei
660,Statielei 26,2023-04-29,12:00:00,114,72,42,FMN 12 Statielei
660,Statielei 26,2023-04-29,13:00:00,140,84,56,FMN 12 Statielei
660,Statielei 26,2023-04-29,14:00:00,113,66,47,FMN 12 Statielei
660,Statielei 26,2023-04-29,15:00:00,131,69,62,FMN 12 Statielei
660,Statielei 26,2023-04-29,16:00:00,123,64,59,FMN 12 Statielei
660,Statielei 26,2023-04-29,17:00:00,110,63,47,FMN 12 Statielei
660,Statielei 26,2023-04-29,18:00:00,140,62,78,FMN 12 Statielei
660,Statielei 26,2023-04-29,19:00:00,120,53,67,FMN 12 Statielei
660,Statielei 26,2023-04-29,20:00:00,93,36,57,FMN 12 Statielei
660,Statielei 26,2023-04-29,21:00:00,68,32,36,FMN 12 Statielei
660,Statielei 26,2023-04-29,22:00:00,69,32,37,FMN 12 Statielei
660,Statielei 26,2023-04-29,23:00:00,60,32,28,FMN 12 Statielei
660,Statielei 26,2023-04-30,00:00:00,53,15,38,FMN 12 Statielei
660,Statielei 26,2023-04-30,01:00:00,30,16,14,FMN 12 Statielei
660,Statielei 26,2023-04-30,02:00:00,21,8,13,FMN 12 Statielei
660,Statielei 26,2023-04-30,03:00:00,11,5,6,FMN 12 Statielei
660,Statielei 26,2023-04-30,04:00:00,6,1,5,FMN 12 Statielei
660,Statielei 26,2023-04-30,05:00:00,10,4,6,FMN 12 Statielei
660,Statielei 26,2023-04-30,06:00:00,9,6,3,FMN 12 Statielei
660,Statielei 26,2023-04-30,07:00:00,20,8,12,FMN 12 Statielei
660,Statielei 26,2023-04-30,08:00:00,31,16,15,FMN 12 Statielei
660,Statielei 26,2023-04-30,09:00:00,87,33,54,FMN 12 Statielei
660,Statielei 26,2023-04-30,10:00:00,80,32,48,FMN 12 Statielei
660,Statielei 26,2023-04-30,11:00:00,106,54,52,FMN 12 Statielei
660,Statielei 26,2023-04-30,12:00:00,144,75,69,FMN 12 Statielei
660,Statielei 26,2023-04-30,13:00:00,152,76,76,FMN 12 Statielei
660,Statielei 26,2023-04-30,14:00:00,134,58,76,FMN 12 Statielei
660,Statielei 26,2023-04-30,15:00:00,130,56,74,FMN 12 Statielei
660,Statielei 26,2023-04-30,16:00:00,156,88,68,FMN 12 Statielei
660,Statielei 26,2023-04-30,17:00:00,157,94,63,FMN 12 Statielei
660,Statielei 26,2023-04-30,18:00:00,133,89,44,FMN 12 Statielei
660,Statielei 26,2023-04-30,19:00:00,128,83,45,FMN 12 Statielei
660,Statielei 26,2023-04-30,20:00:00,105,58,47,FMN 12 Statielei
660,Statielei 26,2023-04-30,21:00:00,84,33,51,FMN 12 Statielei
660,Statielei 26,2023-04-30,22:00:00,66,34,32,FMN 12 Statielei
660,Statielei 26,2023-04-30,23:00:00,59,27,32,FMN 12 Statielei
660,Statielei 26,2023-05-01,00:00:00,27,9,18,FMN 12 Statielei
660,Statielei 26,2023-05-01,01:00:00,31,10,21,FMN 12 Statielei
660,Statielei 26,2023-05-01,02:00:00,18,9,9,FMN 12 Statielei
660,Statielei 26,2023-05-01,03:00:00,20,7,13,FMN 12 Statielei
660,Statielei 26,2023-05-01,04:00:00,18,7,11,FMN 12 Statielei
660,Statielei 26,2023-05-01,05:00:00,16,3,13,FMN 12 Statielei
660,Statielei 26,2023-05-01,06:00:00,10,8,2,FMN 12 Statielei
660,Statielei 26,2023-05-01,07:00:00,17,10,7,FMN 12 Statielei
660,Statielei 26,2023-05-01,08:00:00,25,9,16,FMN 12 Statielei
660,Statielei 26,2023-05-01,09:00:00,43,18,25,FMN 12 Statielei
660,Statielei 26,2023-05-01,10:00:00,76,32,44,FMN 12 Statielei
660,Statielei 26,2023-05-01,11:00:00,80,48,32,FMN 12 Statielei
660,Statielei 26,2023-05-01,12:00:00,112,54,58,FMN 12 Statielei
660,Statielei 26,2023-05-01,13:00:00,84,37,47,FMN 12 Statielei
660,Statielei 26,2023-05-01,14:00:00,111,62,49,FMN 12 Statielei
660,Statielei 26,2023-05-01,15:00:00,134,69,65,FMN 12 Statielei
660,Statielei 26,2023-05-01,16:00:00,141,75,66,FMN 12 Statielei
660,Statielei 26,2023-05-01,17:00:00,151,86,65,FMN 12 Statielei
660,Statielei 26,2023-05-01,18:00:00,130,70,60,FMN 12 Statielei
660,Statielei 26,2023-05-01,19:00:00,112,77,35,FMN 12 Statielei
660,Statielei 26,2023-05-01,20:00:00,85,39,46,FMN 12 Statielei
660,Statielei 26,2023-05-01,21:00:00,64,24,40,FMN 12 Statielei
660,Statielei 26,2023-05-01,22:00:00,51,25,26,FMN 12 Statielei
660,Statielei 26,2023-05-01,23:00:00,30,13,17,FMN 12 Statielei
660,Statielei 26,2023-05-02,00:00:00,19,5,14,FMN 12 Statielei
660,Statielei 26,2023-05-02,01:00:00,11,5,6,FMN 12 Statielei
660,Statielei 26,2023-05-02,02:00:00,4,2,2,FMN 12 Statielei
660,Statielei 26,2023-05-02,03:00:00,4,1,3,FMN 12 Statielei
660,Statielei 26,2023-05-02,04:00:00,9,6,3,FMN 12 Statielei
660,Statielei 26,2023-05-02,05:00:00,22,13,9,FMN 12 Statielei
660,Statielei 26,2023-05-02,06:00:00,35,18,17,FMN 12 Statielei
660,Statielei 26,2023-05-02,07:00:00,137,60,77,FMN 12 Statielei
660,Statielei 26,2023-05-02,08:00:00,311,163,148,FMN 12 Statielei
660,Statielei 26,2023-05-02,09:00:00,139,92,47,FMN 12 Statielei
660,Statielei 26,2023-05-02,10:00:00,106,62,44,FMN 12 Statielei
660,Statielei 26,2023-05-02,11:00:00,89,44,45,FMN 12 Statielei
660,Statielei 26,2023-05-02,12:00:00,129,71,58,FMN 12 Statielei
660,Statielei 26,2023-05-02,13:00:00,124,66,58,FMN 12 Statielei
660,Statielei 26,2023-05-02,14:00:00,105,53,52,FMN 12 Statielei
660,Statielei 26,2023-05-02,15:00:00,172,81,91,FMN 12 Statielei
660,Statielei 26,2023-05-02,16:00:00,250,113,137,FMN 12 Statielei
660,Statielei 26,2023-05-02,17:00:00,241,114,127,FMN 12 Statielei
660,Statielei 26,2023-05-02,18:00:00,215,119,96,FMN 12 Statielei
660,Statielei 26,2023-05-02,19:00:00,129,53,76,FMN 12 Statielei
660,Statielei 26,2023-05-02,20:00:00,123,66,57,FMN 12 Statielei
660,Statielei 26,2023-05-02,21:00:00,91,40,51,FMN 12 Statielei
660,Statielei 26,2023-05-02,22:00:00,81,44,37,FMN 12 Statielei
660,Statielei 26,2023-05-02,23:00:00,38,18,20,FMN 12 Statielei
660,Statielei 26,2023-05-03,00:00:00,20,6,14,FMN 12 Statielei
660,Statielei 26,2023-05-03,01:00:00,4,3,1,FMN 12 Statielei
660,Statielei 26,2023-05-03,02:00:00,8,4,4,FMN 12 Statielei
660,Statielei 26,2023-05-03,03:00:00,10,4,6,FMN 12 Statielei
660,Statielei 26,2023-05-03,04:00:00,6,6,0,FMN 12 Statielei
660,Statielei 26,2023-05-03,05:00:00,15,9,6,FMN 12 Statielei
660,Statielei 26,2023-05-03,06:00:00,26,12,14,FMN 12 Statielei
660,Statielei 26,2023-05-03,07:00:00,138,63,75,FMN 12 Statielei
660,Statielei 26,2023-05-03,08:00:00,308,170,138,FMN 12 Statielei
660,Statielei 26,2023-05-03,09:00:00,139,82,57,FMN 12 Statielei
660,Statielei 26,2023-05-03,10:00:00,104,71,33,FMN 12 Statielei
660,Statielei 26,2023-05-03,11:00:00,102,59,43,FMN 12 Statielei
660,Statielei 26,2023-05-03,12:00:00,248,127,121,FMN 12 Statielei
660,Statielei 26,2023-05-03,13:00:00,143,73,70,FMN 12 Statielei
660,Statielei 26,2023-05-03,14:00:00,132,75,57,FMN 12 Statielei
660,Statielei 26,2023-05-03,15:00:00,161,63,98,FMN 12 Statielei
660,Statielei 26,2023-05-03,16:00:00,210,104,106,FMN 12 Statielei
660,Statielei 26,2023-05-03,17:00:00,264,123,141,FMN 12 Statielei
660,Statielei 26,2023-05-03,18:00:00,186,98,88,FMN 12 Statielei
660,Statielei 26,2023-05-03,19:00:00,153,74,79,FMN 12 Statielei
660,Statielei 26,2023-05-03,20:00:00,114,60,54,FMN 12 Statielei
660,Statielei 26,2023-05-03,21:00:00,106,48,58,FMN 12 Statielei
660,Statielei 26,2023-05-03,22:00:00,74,33,41,FMN 12 Statielei
660,Statielei 26,2023-05-03,23:00:00,38,14,24,FMN 12 Statielei
660,Statielei 26,2023-05-04,00:00:00,22,8,14,FMN 12 Statielei
660,Statielei 26,2023-05-04,01:00:00,8,4,4,FMN 12 Statielei
660,Statielei 26,2023-05-04,02:00:00,6,4,2,FMN 12 Statielei
660,Statielei 26,2023-05-04,03:00:00,5,3,2,FMN 12 Statielei
660,Statielei 26,2023-05-04,04:00:00,7,4,3,FMN 12 Statielei
660,Statielei 26,2023-05-04,05:00:00,21,12,9,FMN 12 Statielei
660,Statielei 26,2023-05-04,06:00:00,34,12,22,FMN 12 Statielei
660,Statielei 26,2023-05-04,07:00:00,155,76,79,FMN 12 Statielei
660,Statielei 26,2023-05-04,08:00:00,314,182,132,FMN 12 Statielei
660,Statielei 26,2023-05-04,09:00:00,128,83,45,FMN 12 Statielei
660,Statielei 26,2023-05-04,10:00:00,108,60,48,FMN 12 Statielei
660,Statielei 26,2023-05-04,11:00:00,80,48,32,FMN 12 Statielei
660,Statielei 26,2023-05-04,12:00:00,135,74,61,FMN 12 Statielei
660,Statielei 26,2023-05-04,13:00:00,116,63,53,FMN 12 Statielei
660,Statielei 26,2023-05-04,14:00:00,111,62,49,FMN 12 Statielei
660,Statielei 26,2023-05-04,15:00:00,193,86,107,FMN 12 Statielei
660,Statielei 26,2023-05-04,16:00:00,259,115,144,FMN 12 Statielei
660,Statielei 26,2023-05-04,17:00:00,255,111,144,FMN 12 Statielei
660,Statielei 26,2023-05-04,18:00:00,224,131,93,FMN 12 Statielei
660,Statielei 26,2023-05-04,19:00:00,193,109,84,FMN 12 Statielei
660,Statielei 26,2023-05-04,20:00:00,130,54,76,FMN 12 Statielei
660,Statielei 26,2023-05-04,21:00:00,85,43,42,FMN 12 Statielei
660,Statielei 26,2023-05-04,22:00:00,103,42,61,FMN 12 Statielei
660,Statielei 26,2023-05-04,23:00:00,68,27,41,FMN 12 Statielei
660,Statielei 26,2023-05-05,00:00:00,0,0,0,FMN 12 Statielei
660,Statielei 26,2023-05-05,01:00:00,18,7,11,FMN 12 Statielei
660,Statielei 26,2023-05-05,02:00:00,3,3,0,FMN 12 Statielei
660,Statielei 26,2023-05-05,03:00:00,15,6,9,FMN 12 Statielei
660,Statielei 26,2023-05-05,04:00:00,11,7,4,FMN 12 Statielei
660,Statielei 26,2023-05-05,05:00:00,19,11,8,FMN 12 Statielei
660,Statielei 26,2023-05-05,06:00:00,34,19,15,FMN 12 Statielei
660,Statielei 26,2023-05-05,07:00:00,117,54,63,FMN 12 Statielei
660,Statielei 26,2023-05-05,08:00:00,305,162,143,FMN 12 Statielei
660,Statielei 26,2023-05-05,09:00:00,112,67,45,FMN 12 Statielei
660,Statielei 26,2023-05-05,10:00:00,72,53,19,FMN 12 Statielei
660,Statielei 26,2023-05-05,11:00:00,60,28,32,FMN 12 Statielei
660,Statielei 26,2023-05-05,12:00:00,105,49,56,FMN 12 Statielei
660,Statielei 26,2023-05-05,13:00:00,82,42,40,FMN 12 Statielei
660,Statielei 26,2023-05-05,14:00:00,76,42,34,FMN 12 Statielei
660,Statielei 26,2023-05-05,15:00:00,168,63,105,FMN 12 Statielei
660,Statielei 26,2023-05-05,16:00:00,214,104,110,FMN 12 Statielei
660,Statielei 26,2023-05-05,17:00:00,193,104,89,FMN 12 Statielei
660,Statielei 26,2023-05-05,18:00:00,158,85,73,FMN 12 Statielei
660,Statielei 26,2023-05-05,19:00:00,131,70,61,FMN 12 Statielei
660,Statielei 26,2023-05-05,20:00:00,104,51,53,FMN 12 Statielei
660,Statielei 26,2023-05-05,21:00:00,105,60,45,FMN 12 Statielei
660,Statielei 26,2023-05-05,22:00:00,120,61,59,FMN 12 Statielei
660,Statielei 26,2023-05-05,23:00:00,56,22,34,FMN 12 Statielei
660,Statielei 26,2023-05-06,00:00:00,60,23,37,FMN 12 Statielei
660,Statielei 26,2023-05-06,01:00:00,49,9,40,FMN 12 Statielei
660,Statielei 26,2023-05-06,02:00:00,25,13,12,FMN 12 Statielei
660,Statielei 26,2023-05-06,03:00:00,12,5,7,FMN 12 Statielei
660,Statielei 26,2023-05-06,04:00:00,10,9,1,FMN 12 Statielei
660,Statielei 26,2023-05-06,05:00:00,9,5,4,FMN 12 Statielei
660,Statielei 26,2023-05-06,06:00:00,9,7,2,FMN 12 Statielei
660,Statielei 26,2023-05-06,07:00:00,24,11,13,FMN 12 Statielei
660,Statielei 26,2023-05-06,08:00:00,51,19,32,FMN 12 Statielei
660,Statielei 26,2023-05-06,09:00:00,127,56,71,FMN 12 Statielei
660,Statielei 26,2023-05-06,10:00:00,135,58,77,FMN 12 Statielei
660,Statielei 26,2023-05-06,11:00:00,134,71,63,FMN 12 Statielei
660,Statielei 26,2023-05-06,12:00:00,151,81,70,FMN 12 Statielei
660,Statielei 26,2023-05-06,13:00:00,147,85,62,FMN 12 Statielei
660,Statielei 26,2023-05-06,14:00:00,127,67,60,FMN 12 Statielei
660,Statielei 26,2023-05-06,15:00:00,153,78,75,FMN 12 Statielei
660,Statielei 26,2023-05-06,16:00:00,138,54,84,FMN 12 Statielei
660,Statielei 26,2023-05-06,17:00:00,145,80,65,FMN 12 Statielei
660,Statielei 26,2023-05-06,18:00:00,146,67,79,FMN 12 Statielei
660,Statielei 26,2023-05-06,19:00:00,126,53,73,FMN 12 Statielei
660,Statielei 26,2023-05-06,20:00:00,97,55,42,FMN 12 Statielei
660,Statielei 26,2023-05-06,21:00:00,84,43,41,FMN 12 Statielei
660,Statielei 26,2023-05-06,22:00:00,130,78,52,FMN 12 Statielei
660,Statielei 26,2023-05-06,23:00:00,58,29,29,FMN 12 Statielei
660,Statielei 26,2023-05-07,00:00:00,48,18,30,FMN 12 Statielei
660,Statielei 26,2023-05-07,01:00:00,30,16,14,FMN 12 Statielei
660,Statielei 26,2023-05-07,02:00:00,17,13,4,FMN 12 Statielei
660,Statielei 26,2023-05-07,03:00:00,13,5,8,FMN 12 Statielei
660,Statielei 26,2023-05-07,04:00:00,3,1,2,FMN 12 Statielei
660,Statielei 26,2023-05-07,05:00:00,8,3,5,FMN 12 Statielei
660,Statielei 26,2023-05-07,06:00:00,5,2,3,FMN 12 Statielei
660,Statielei 26,2023-05-07,07:00:00,18,6,12,FMN 12 Statielei
660,Statielei 26,2023-05-07,08:00:00,38,20,18,FMN 12 Statielei
660,Statielei 26,2023-05-07,09:00:00,78,41,37,FMN 12 Statielei
660,Statielei 26,2023-05-07,10:00:00,66,32,34,FMN 12 Statielei
660,Statielei 26,2023-05-07,11:00:00,86,51,35,FMN 12 Statielei
660,Statielei 26,2023-05-07,12:00:00,125,69,56,FMN 12 Statielei
660,Statielei 26,2023-05-07,13:00:00,158,76,82,FMN 12 Statielei
660,Statielei 26,2023-05-07,14:00:00,114,67,47,FMN 12 Statielei
660,Statielei 26,2023-05-07,15:00:00,123,59,64,FMN 12 Statielei
660,Statielei 26,2023-05-07,16:00:00,117,49,68,FMN 12 Statielei
660,Statielei 26,2023-05-07,17:00:00,177,89,88,FMN 12 Statielei
660,Statielei 26,2023-05-07,18:00:00,117,55,62,FMN 12 Statielei
660,Statielei 26,2023-05-07,19:00:00,90,41,49,FMN 12 Statielei
660,Statielei 26,2023-05-07,20:00:00,83,53,30,FMN 12 Statielei
660,Statielei 26,2023-05-07,21:00:00,92,52,40,FMN 12 Statielei
660,Statielei 26,2023-05-07,22:00:00,55,33,22,FMN 12 Statielei
660,Statielei 26,2023-05-07,23:00:00,30,16,14,FMN 12 Statielei
660,Statielei 26,2023-05-08,00:00:00,16,5,11,FMN 12 Statielei
660,Statielei 26,2023-05-08,01:00:00,9,4,5,FMN 12 Statielei
660,Statielei 26,2023-05-08,02:00:00,6,2,4,FMN 12 Statielei
660,Statielei 26,2023-05-08,03:00:00,1,1,0,FMN 12 Statielei
660,Statielei 26,2023-05-08,04:00:00,11,6,5,FMN 12 Statielei
660,Statielei 26,2023-05-08,05:00:00,20,10,10,FMN 12 Statielei
660,Statielei 26,2023-05-08,06:00:00,29,12,17,FMN 12 Statielei
660,Statielei 26,2023-05-08,07:00:00,129,54,75,FMN 12 Statielei
660,Statielei 26,2023-05-08,08:00:00,306,158,148,FMN 12 Statielei
660,Statielei 26,2023-05-08,09:00:00,120,76,44,FMN 12 Statielei
660,Statielei 26,2023-05-08,10:00:00,69,47,22,FMN 12 Statielei
660,Statielei 26,2023-05-08,11:00:00,77,42,35,FMN 12 Statielei
660,Statielei 26,2023-05-08,12:00:00,112,57,55,FMN 12 Statielei
660,Statielei 26,2023-05-08,13:00:00,94,57,37,FMN 12 Statielei
660,Statielei 26,2023-05-08,14:00:00,92,41,51,FMN 12 Statielei
660,Statielei 26,2023-05-08,15:00:00,159,66,93,FMN 12 Statielei
660,Statielei 26,2023-05-08,16:00:00,226,119,107,FMN 12 Statielei
660,Statielei 26,2023-05-08,17:00:00,260,129,131,FMN 12 Statielei
660,Statielei 26,2023-05-08,18:00:00,176,75,101,FMN 12 Statielei
660,Statielei 26,2023-05-08,19:00:00,137,69,68,FMN 12 Statielei
660,Statielei 26,2023-05-08,20:00:00,111,48,63,FMN 12 Statielei
660,Statielei 26,2023-05-08,21:00:00,79,44,35,FMN 12 Statielei
660,Statielei 26,2023-05-08,22:00:00,75,34,41,FMN 12 Statielei
660,Statielei 26,2023-05-08,23:00:00,42,9,33,FMN 12 Statielei
660,Statielei 26,2023-05-09,00:00:00,8,1,7,FMN 12 Statielei
660,Statielei 26,2023-05-09,01:00:00,12,4,8,FMN 12 Statielei
660,Statielei 26,2023-05-09,02:00:00,8,4,4,FMN 12 Statielei
660,Statielei 26,2023-05-09,03:00:00,6,5,1,FMN 12 Statielei
660,Statielei 26,2023-05-09,04:00:00,6,2,4,FMN 12 Statielei
660,Statielei 26,2023-05-09,05:00:00,18,8,10,FMN 12 Statielei
660,Statielei 26,2023-05-09,06:00:00,34,16,18,FMN 12 Statielei
660,Statielei 26,2023-05-09,07:00:00,127,54,73,FMN 12 Statielei
660,Statielei 26,2023-05-09,08:00:00,277,145,132,FMN 12 Statielei
660,Statielei 26,2023-05-09,09:00:00,96,65,31,FMN 12 Statielei
660,Statielei 26,2023-05-09,10:00:00,52,33,19,FMN 12 Statielei
660,Statielei 26,2023-05-09,11:00:00,33,20,13,FMN 12 Statielei
660,Statielei 26,2023-05-09,12:00:00,60,36,24,FMN 12 Statielei
660,Statielei 26,2023-05-09,13:00:00,49,27,22,FMN 12 Statielei
660,Statielei 26,2023-05-09,14:00:00,63,27,36,FMN 12 Statielei
660,Statielei 26,2023-05-09,15:00:00,128,61,67,FMN 12 Statielei
660,Statielei 26,2023-05-09,16:00:00,184,89,95,FMN 12 Statielei
660,Statielei 26,2023-05-09,17:00:00,175,75,100,FMN 12 Statielei
660,Statielei 26,2023-05-09,18:00:00,103,51,52,FMN 12 Statielei
660,Statielei 26,2023-05-09,19:00:00,80,37,43,FMN 12 Statielei
660,Statielei 26,2023-05-09,20:00:00,61,33,28,FMN 12 Statielei
660,Statielei 26,2023-05-09,21:00:00,46,23,23,FMN 12 Statielei
660,Statielei 26,2023-05-09,22:00:00,48,24,24,FMN 12 Statielei
660,Statielei 26,2023-05-09,23:00:00,36,13,23,FMN 12 Statielei
660,Statielei 26,2023-05-10,00:00:00,17,8,9,FMN 12 Statielei
660,Statielei 26,2023-05-10,01:00:00,6,2,4,FMN 12 Statielei
660,Statielei 26,2023-05-10,02:00:00,4,1,3,FMN 12 Statielei
660,Statielei 26,2023-05-10,03:00:00,3,2,1,FMN 12 Statielei
660,Statielei 26,2023-05-10,04:00:00,8,6,2,FMN 12 Statielei
660,Statielei 26,2023-05-10,05:00:00,15,8,7,FMN 12 Statielei
660,Statielei 26,2023-05-10,06:00:00,28,13,15,FMN 12 Statielei
660,Statielei 26,2023-05-10,07:00:00,117,46,71,FMN 12 Statielei
660,Statielei 26,2023-05-10,08:00:00,282,140,142,FMN 12 Statielei
660,Statielei 26,2023-05-10,09:00:00,95,59,36,FMN 12 Statielei
660,Statielei 26,2023-05-10,10:00:00,102,61,41,FMN 12 Statielei
660,Statielei 26,2023-05-10,11:00:00,78,48,30,FMN 12 Statielei
660,Statielei 26,2023-05-10,12:00:00,222,126,96,FMN 12 Statielei
660,Statielei 26,2023-05-10,13:00:00,100,50,50,FMN 12 Statielei
660,Statielei 26,2023-05-10,14:00:00,106,46,60,FMN 12 Statielei
660,Statielei 26,2023-05-10,15:00:00,116,46,70,FMN 12 Statielei
660,Statielei 26,2023-05-10,16:00:00,165,70,95,FMN 12 Statielei
660,Statielei 26,2023-05-10,17:00:00,170,88,82,FMN 12 Statielei
660,Statielei 26,2023-05-10,18:00:00,119,54,65,FMN 12 Statielei
660,Statielei 26,2023-05-10,19:00:00,102,57,45,FMN 12 Statielei
660,Statielei 26,2023-05-10,20:00:00,83,41,42,FMN 12 Statielei
660,Statielei 26,2023-05-10,21:00:00,67,25,42,FMN 12 Statielei
660,Statielei 26,2023-05-10,22:00:00,75,39,36,FMN 12 Statielei
660,Statielei 26,2023-05-10,23:00:00,39,14,25,FMN 12 Statielei
660,Statielei 26,2023-05-11,00:00:00,25,7,18,FMN 12 Statielei
660,Statielei 26,2023-05-11,01:00:00,14,4,10,FMN 12 Statielei
660,Statielei 26,2023-05-11,02:00:00,6,3,3,FMN 12 Statielei
660,Statielei 26,2023-05-11,03:00:00,1,1,0,FMN 12 Statielei
660,Statielei 26,2023-05-11,04:00:00,9,4,5,FMN 12 Statielei
660,Statielei 26,2023-05-11,05:00:00,22,10,12,FMN 12 Statielei
660,Statielei 26,2023-05-11,06:00:00,34,13,21,FMN 12 Statielei
660,Statielei 26,2023-05-11,07:00:00,120,53,67,FMN 12 Statielei
660,Statielei 26,2023-05-11,08:00:00,305,171,134,FMN 12 Statielei
660,Statielei 26,2023-05-11,09:00:00,126,69,57,FMN 12 Statielei
660,Statielei 26,2023-05-11,10:00:00,83,52,31,FMN 12 Statielei
660,Statielei 26,2023-05-11,11:00:00,91,56,35,FMN 12 Statielei
660,Statielei 26,2023-05-11,12:00:00,138,70,68,FMN 12 Statielei
660,Statielei 26,2023-05-11,13:00:00,118,64,54,FMN 12 Statielei
660,Statielei 26,2023-05-11,14:00:00,84,36,48,FMN 12 Statielei
660,Statielei 26,2023-05-11,15:00:00,153,67,86,FMN 12 Statielei
660,Statielei 26,2023-05-11,16:00:00,208,106,102,FMN 12 Statielei
660,Statielei 26,2023-05-11,17:00:00,206,89,117,FMN 12 Statielei
660,Statielei 26,2023-05-11,18:00:00,179,98,81,FMN 12 Statielei
660,Statielei 26,2023-05-11,19:00:00,165,107,58,FMN 12 Statielei
660,Statielei 26,2023-05-11,20:00:00,124,59,65,FMN 12 Statielei
660,Statielei 26,2023-05-11,21:00:00,79,41,38,FMN 12 Statielei
660,Statielei 26,2023-05-11,22:00:00,78,27,51,FMN 12 Statielei
660,Statielei 26,2023-05-11,23:00:00,78,27,51,FMN 12 Statielei
660,Statielei 26,2023-05-12,00:00:00,36,8,28,FMN 12 Statielei
660,Statielei 26,2023-05-12,01:00:00,38,12,26,FMN 12 Statielei
660,Statielei 26,2023-05-12,02:00:00,5,0,5,FMN 12 Statielei
660,Statielei 26,2023-05-12,03:00:00,6,2,4,FMN 12 Statielei
660,Statielei 26,2023-05-12,04:00:00,6,3,3,FMN 12 Statielei
660,Statielei 26,2023-05-12,05:00:00,14,7,7,FMN 12 Statielei
660,Statielei 26,2023-05-12,06:00:00,32,16,16,FMN 12 Statielei
660,Statielei 26,2023-05-12,07:00:00,86,25,61,FMN 12 Statielei
660,Statielei 26,2023-05-12,08:00:00,230,117,113,FMN 12 Statielei
660,Statielei 26,2023-05-12,09:00:00,76,50,26,FMN 12 Statielei
660,Statielei 26,2023-05-12,10:00:00,79,52,27,FMN 12 Statielei
660,Statielei 26,2023-05-12,11:00:00,71,36,35,FMN 12 Statielei
660,Statielei 26,2023-05-12,12:00:00,102,52,50,FMN 12 Statielei
660,Statielei 26,2023-05-12,13:00:00,89,42,47,FMN 12 Statielei
660,Statielei 26,2023-05-12,14:00:00,105,57,48,FMN 12 Statielei
660,Statielei 26,2023-05-12,15:00:00,182,91,91,FMN 12 Statielei
660,Statielei 26,2023-05-12,16:00:00,230,104,126,FMN 12 Statielei
660,Statielei 26,2023-05-12,17:00:00,170,77,93,FMN 12 Statielei
660,Statielei 26,2023-05-12,18:00:00,165,90,75,FMN 12 Statielei
660,Statielei 26,2023-05-12,19:00:00,155,89,66,FMN 12 Statielei
660,Statielei 26,2023-05-12,20:00:00,135,64,71,FMN 12 Statielei
660,Statielei 26,2023-05-12,21:00:00,85,44,41,FMN 12 Statielei
660,Statielei 26,2023-05-12,22:00:00,86,43,43,FMN 12 Statielei
660,Statielei 26,2023-05-12,23:00:00,95,25,70,FMN 12 Statielei
660,Statielei 26,2023-05-13,00:00:00,51,20,31,FMN 12 Statielei
660,Statielei 26,2023-05-13,01:00:00,35,16,19,FMN 12 Statielei
660,Statielei 26,2023-05-13,02:00:00,19,11,8,FMN 12 Statielei
660,Statielei 26,2023-05-13,03:00:00,19,9,10,FMN 12 Statielei
660,Statielei 26,2023-05-13,04:00:00,13,3,10,FMN 12 Statielei
660,Statielei 26,2023-05-13,05:00:00,11,4,7,FMN 12 Statielei
660,Statielei 26,2023-05-13,06:00:00,17,8,9,FMN 12 Statielei
660,Statielei 26,2023-05-13,07:00:00,26,13,13,FMN 12 Statielei
660,Statielei 26,2023-05-13,08:00:00,48,26,22,FMN 12 Statielei
660,Statielei 26,2023-05-13,09:00:00,111,51,60,FMN 12 Statielei
660,Statielei 26,2023-05-13,10:00:00,119,54,65,FMN 12 Statielei
660,Statielei 26,2023-05-13,11:00:00,140,68,72,FMN 12 Statielei
660,Statielei 26,2023-05-13,12:00:00,122,66,56,FMN 12 Statielei
660,Statielei 26,2023-05-13,13:00:00,172,91,81,FMN 12 Statielei
660,Statielei 26,2023-05-13,14:00:00,171,90,81,FMN 12 Statielei
660,Statielei 26,2023-05-13,15:00:00,141,67,74,FMN 12 Statielei
660,Statielei 26,2023-05-13,16:00:00,142,80,62,FMN 12 Statielei
660,Statielei 26,2023-05-13,17:00:00,152,79,73,FMN 12 Statielei
660,Statielei 26,2023-05-13,18:00:00,144,75,69,FMN 12 Statielei
660,Statielei 26,2023-05-13,19:00:00,151,83,68,FMN 12 Statielei
660,Statielei 26,2023-05-13,20:00:00,127,69,58,FMN 12 Statielei
660,Statielei 26,2023-05-13,21:00:00,84,37,47,FMN 12 Statielei
660,Statielei 26,2023-05-13,22:00:00,78,47,31,FMN 12 Statielei
660,Statielei 26,2023-05-13,23:00:00,79,32,47,FMN 12 Statielei
660,Statielei 26,2023-05-14,00:00:00,47,13,34,FMN 12 Statielei
660,Statielei 26,2023-05-14,01:00:00,50,22,28,FMN 12 Statielei
660,Statielei 26,2023-05-14,02:00:00,18,9,9,FMN 12 Statielei
660,Statielei 26,2023-05-14,03:00:00,15,8,7,FMN 12 Statielei
660,Statielei 26,2023-05-14,04:00:00,27,13,14,FMN 12 Statielei
660,Statielei 26,2023-05-14,05:00:00,10,3,7,FMN 12 Statielei
660,Statielei 26,2023-05-14,06:00:00,11,7,4,FMN 12 Statielei
660,Statielei 26,2023-05-14,07:00:00,13,5,8,FMN 12 Statielei
660,Statielei 26,2023-05-14,08:00:00,48,25,23,FMN 12 Statielei
660,Statielei 26,2023-05-14,09:00:00,94,60,34,FMN 12 Statielei
660,Statielei 26,2023-05-14,10:00:00,124,67,57,FMN 12 Statielei
660,Statielei 26,2023-05-14,11:00:00,145,86,59,FMN 12 Statielei
660,Statielei 26,2023-05-14,12:00:00,182,86,96,FMN 12 Statielei
660,Statielei 26,2023-05-14,13:00:00,162,89,73,FMN 12 Statielei
660,Statielei 26,2023-05-14,14:00:00,194,124,70,FMN 12 Statielei
660,Statielei 26,2023-05-14,15:00:00,223,97,126,FMN 12 Statielei
660,Statielei 26,2023-05-14,16:00:00,232,120,112,FMN 12 Statielei
660,Statielei 26,2023-05-14,17:00:00,206,85,121,FMN 12 Statielei
660,Statielei 26,2023-05-14,18:00:00,152,80,72,FMN 12 Statielei
660,Statielei 26,2023-05-14,19:00:00,137,68,69,FMN 12 Statielei
660,Statielei 26,2023-05-14,20:00:00,123,63,60,FMN 12 Statielei
660,Statielei 26,2023-05-14,21:00:00,66,38,28,FMN 12 Statielei
660,Statielei 26,2023-05-14,22:00:00,53,23,30,FMN 12 Statielei
660,Statielei 26,2023-05-14,23:00:00,46,20,26,FMN 12 Statielei
660,Statielei 26,2023-05-15,00:00:00,22,5,17,FMN 12 Statielei
660,Statielei 26,2023-05-15,01:00:00,8,4,4,FMN 12 Statielei
660,Statielei 26,2023-05-15,02:00:00,7,3,4,FMN 12 Statielei
660,Statielei 26,2023-05-15,03:00:00,4,0,4,FMN 12 Statielei
660,Statielei 26,2023-05-15,04:00:00,5,3,2,FMN 12 Statielei
660,Statielei 26,2023-05-15,05:00:00,16,8,8,FMN 12 Statielei
660,Statielei 26,2023-05-15,06:00:00,36,21,15,FMN 12 Statielei
660,Statielei 26,2023-05-15,07:00:00,122,56,66,FMN 12 Statielei
660,Statielei 26,2023-05-15,08:00:00,292,149,143,FMN 12 Statielei
660,Statielei 26,2023-05-15,09:00:00,130,76,54,FMN 12 Statielei
660,Statielei 26,2023-05-15,10:00:00,70,39,31,FMN 12 Statielei
660,Statielei 26,2023-05-15,11:00:00,93,58,35,FMN 12 Statielei
660,Statielei 26,2023-05-15,12:00:00,120,63,57,FMN 12 Statielei
660,Statielei 26,2023-05-15,13:00:00,71,41,30,FMN 12 Statielei
660,Statielei 26,2023-05-15,14:00:00,63,31,32,FMN 12 Statielei
660,Statielei 26,2023-05-15,15:00:00,137,62,75,FMN 12 Statielei
660,Statielei 26,2023-05-15,16:00:00,206,108,98,FMN 12 Statielei
660,Statielei 26,2023-05-15,17:00:00,175,75,100,FMN 12 Statielei
660,Statielei 26,2023-05-15,18:00:00,112,47,65,FMN 12 Statielei
660,Statielei 26,2023-05-15,19:00:00,99,49,50,FMN 12 Statielei
660,Statielei 26,2023-05-15,20:00:00,77,35,42,FMN 12 Statielei
660,Statielei 26,2023-05-15,21:00:00,65,36,29,FMN 12 Statielei
660,Statielei 26,2023-05-15,22:00:00,45,21,24,FMN 12 Statielei
660,Statielei 26,2023-05-15,23:00:00,33,11,22,FMN 12 Statielei
660,Statielei 26,2023-05-16,00:00:00,8,3,5,FMN 12 Statielei
660,Statielei 26,2023-05-16,01:00:00,6,2,4,FMN 12 Statielei
660,Statielei 26,2023-05-16,02:00:00,6,3,3,FMN 12 Statielei
660,Statielei 26,2023-05-16,03:00:00,3,2,1,FMN 12 Statielei
660,Statielei 26,2023-05-16,04:00:00,5,4,1,FMN 12 Statielei
660,Statielei 26,2023-05-16,05:00:00,19,11,8,FMN 12 Statielei
660,Statielei 26,2023-05-16,06:00:00,41,20,21,FMN 12 Statielei
660,Statielei 26,2023-05-16,07:00:00,130,69,61,FMN 12 Statielei
660,Statielei 26,2023-05-16,08:00:00,315,171,144,FMN 12 Statielei
660,Statielei 26,2023-05-16,09:00:00,134,76,58,FMN 12 Statielei
660,Statielei 26,2023-05-16,10:00:00,83,64,19,FMN 12 Statielei
660,Statielei 26,2023-05-16,11:00:00,74,33,41,FMN 12 Statielei
660,Statielei 26,2023-05-16,12:00:00,127,87,40,FMN 12 Statielei
660,Statielei 26,2023-05-16,13:00:00,133,73,60,FMN 12 Statielei
660,Statielei 26,2023-05-16,14:00:00,98,40,58,FMN 12 Statielei
660,Statielei 26,2023-05-16,15:00:00,167,67,100,FMN 12 Statielei
660,Statielei 26,2023-05-16,16:00:00,235,115,120,FMN 12 Statielei
660,Statielei 26,2023-05-16,17:00:00,243,107,136,FMN 12 Statielei
660,Statielei 26,2023-05-16,18:00:00,161,75,86,FMN 12 Statielei
660,Statielei 26,2023-05-16,19:00:00,132,67,65,FMN 12 Statielei
660,Statielei 26,2023-05-16,20:00:00,109,58,51,FMN 12 Statielei
660,Statielei 26,2023-05-16,21:00:00,88,43,45,FMN 12 Statielei
660,Statielei 26,2023-05-16,22:00:00,86,44,42,FMN 12 Statielei
660,Statielei 26,2023-05-16,23:00:00,36,10,26,FMN 12 Statielei
660,Statielei 26,2023-05-17,00:00:00,22,11,11,FMN 12 Statielei
660,Statielei 26,2023-05-17,01:00:00,12,7,5,FMN 12 Statielei
660,Statielei 26,2023-05-17,02:00:00,1,1,0,FMN 12 Statielei
660,Statielei 26,2023-05-17,03:00:00,7,2,5,FMN 12 Statielei
660,Statielei 26,2023-05-17,04:00:00,7,5,2,FMN 12 Statielei
660,Statielei 26,2023-05-17,05:00:00,21,12,9,FMN 12 Statielei
660,Statielei 26,2023-05-17,06:00:00,34,20,14,FMN 12 Statielei
660,Statielei 26,2023-05-17,07:00:00,108,49,59,FMN 12 Statielei
660,Statielei 26,2023-05-17,08:00:00,251,134,117,FMN 12 Statielei
660,Statielei 26,2023-05-17,09:00:00,127,78,49,FMN 12 Statielei
660,Statielei 26,2023-05-17,10:00:00,89,54,35,FMN 12 Statielei
660,Statielei 26,2023-05-17,11:00:00,126,67,59,FMN 12 Statielei
660,Statielei 26,2023-05-17,12:00:00,190,110,80,FMN 12 Statielei
660,Statielei 26,2023-05-17,13:00:00,151,76,75,FMN 12 Statielei
660,Statielei 26,2023-05-17,14:00:00,132,71,61,FMN 12 Statielei
660,Statielei 26,2023-05-17,15:00:00,139,71,68,FMN 12 Statielei
660,Statielei 26,2023-05-17,16:00:00,190,88,102,FMN 12 Statielei
660,Statielei 26,2023-05-17,17:00:00,195,85,110,FMN 12 Statielei
660,Statielei 26,2023-05-17,18:00:00,199,95,104,FMN 12 Statielei
660,Statielei 26,2023-05-17,19:00:00,128,76,52,FMN 12 Statielei
660,Statielei 26,2023-05-17,20:00:00,102,61,41,FMN 12 Statielei
660,Statielei 26,2023-05-17,21:00:00,90,39,51,FMN 12 Statielei
660,Statielei 26,2023-05-17,22:00:00,73,39,34,FMN 12 Statielei
660,Statielei 26,2023-05-17,23:00:00,53,8,45,FMN 12 Statielei
660,Statielei 26,2023-05-18,00:00:00,32,8,24,FMN 12 Statielei
660,Statielei 26,2023-05-18,01:00:00,35,11,24,FMN 12 Statielei
660,Statielei 26,2023-05-18,02:00:00,16,2,14,FMN 12 Statielei
660,Statielei 26,2023-05-18,03:00:00,6,2,4,FMN 12 Statielei
660,Statielei 26,2023-05-18,04:00:00,6,2,4,FMN 12 Statielei
660,Statielei 26,2023-05-18,05:00:00,8,5,3,FMN 12 Statielei
660,Statielei 26,2023-05-18,06:00:00,15,9,6,FMN 12 Statielei
660,Statielei 26,2023-05-18,07:00:00,16,6,10,FMN 12 Statielei
660,Statielei 26,2023-05-18,08:00:00,37,20,17,FMN 12 Statielei
660,Statielei 26,2023-05-18,09:00:00,61,33,28,FMN 12 Statielei
660,Statielei 26,2023-05-18,10:00:00,80,44,36,FMN 12 Statielei
660,Statielei 26,2023-05-18,11:00:00,85,42,43,FMN 12 Statielei
660,Statielei 26,2023-05-18,12:00:00,92,53,39,FMN 12 Statielei
660,Statielei 26,2023-05-18,13:00:00,104,59,45,FMN 12 Statielei
660,Statielei 26,2023-05-18,14:00:00,128,62,66,FMN 12 Statielei
660,Statielei 26,2023-05-18,15:00:00,109,40,69,FMN 12 Statielei
660,Statielei 26,2023-05-18,16:00:00,134,63,71,FMN 12 Statielei
660,Statielei 26,2023-05-18,17:00:00,146,67,79,FMN 12 Statielei
660,Statielei 26,2023-05-18,18:00:00,135,80,55,FMN 12 Statielei
660,Statielei 26,2023-05-18,19:00:00,110,71,39,FMN 12 Statielei
660,Statielei 26,2023-05-18,20:00:00,135,73,62,FMN 12 Statielei
660,Statielei 26,2023-05-18,21:00:00,87,34,53,FMN 12 Statielei
660,Statielei 26,2023-05-18,22:00:00,81,41,40,FMN 12 Statielei
660,Statielei 26,2023-05-18,23:00:00,64,23,41,FMN 12 Statielei
660,Statielei 26,2023-05-19,00:00:00,25,7,18,FMN 12 Statielei
660,Statielei 26,2023-05-19,01:00:00,37,12,25,FMN 12 Statielei
660,Statielei 26,2023-05-19,02:00:00,14,4,10,FMN 12 Statielei
660,Statielei 26,2023-05-19,03:00:00,4,1,3,FMN 12 Statielei
660,Statielei 26,2023-05-19,04:00:00,8,5,3,FMN 12 Statielei
660,Statielei 26,2023-05-19,05:00:00,11,7,4,FMN 12 Statielei
660,Statielei 26,2023-05-19,06:00:00,20,7,13,FMN 12 Statielei
660,Statielei 26,2023-05-19,07:00:00,40,15,25,FMN 12 Statielei
660,Statielei 26,2023-05-19,08:00:00,60,32,28,FMN 12 Statielei
660,Statielei 26,2023-05-19,09:00:00,82,40,42,FMN 12 Statielei
660,Statielei 26,2023-05-19,10:00:00,90,65,25,FMN 12 Statielei
660,Statielei 26,2023-05-19,11:00:00,100,64,36,FMN 12 Statielei
660,Statielei 26,2023-05-19,12:00:00,133,73,60,FMN 12 Statielei
660,Statielei 26,2023-05-19,13:00:00,131,64,67,FMN 12 Statielei
660,Statielei 26,2023-05-19,14:00:00,123,66,57,FMN 12 Statielei
660,Statielei 26,2023-05-19,15:00:00,138,54,84,FMN 12 Statielei
660,Statielei 26,2023-05-19,16:00:00,129,55,74,FMN 12 Statielei
660,Statielei 26,2023-05-19,17:00:00,137,74,63,FMN 12 Statielei
660,Statielei 26,2023-05-19,18:00:00,145,74,71,FMN 12 Statielei
660,Statielei 26,2023-05-19,19:00:00,168,113,55,FMN 12 Statielei
660,Statielei 26,2023-05-19,20:00:00,95,57,38,FMN 12 Statielei
660,Statielei 26,2023-05-19,21:00:00,84,43,41,FMN 12 Statielei
660,Statielei 26,2023-05-19,22:00:00,82,24,58,FMN 12 Statielei
660,Statielei 26,2023-05-19,23:00:00,65,25,40,FMN 12 Statielei
660,Statielei 26,2023-05-20,00:00:00,43,20,23,FMN 12 Statielei
660,Statielei 26,2023-05-20,01:00:00,23,4,19,FMN 12 Statielei
660,Statielei 26,2023-05-20,02:00:00,26,16,10,FMN 12 Statielei
660,Statielei 26,2023-05-20,03:00:00,2,2,0,FMN 12 Statielei
660,Statielei 26,2023-05-20,04:00:00,6,5,1,FMN 12 Statielei
660,Statielei 26,2023-05-20,05:00:00,11,6,5,FMN 12 Statielei
660,Statielei 26,2023-05-20,06:00:00,9,5,4,FMN 12 Statielei
660,Statielei 26,2023-05-20,07:00:00,21,10,11,FMN 12 Statielei
660,Statielei 26,2023-05-20,08:00:00,28,16,12,FMN 12 Statielei
660,Statielei 26,2023-05-20,09:00:00,86,42,44,FMN 12 Statielei
660,Statielei 26,2023-05-20,10:00:00,108,55,53,FMN 12 Statielei
660,Statielei 26,2023-05-20,11:00:00,164,103,61,FMN 12 Statielei
660,Statielei 26,2023-05-20,12:00:00,124,66,58,FMN 12 Statielei
660,Statielei 26,2023-05-20,13:00:00,112,42,70,FMN 12 Statielei
660,Statielei 26,2023-05-20,14:00:00,112,52,60,FMN 12 Statielei
660,Statielei 26,2023-05-20,15:00:00,146,74,72,FMN 12 Statielei
660,Statielei 26,2023-05-20,16:00:00,194,85,109,FMN 12 Statielei
660,Statielei 26,2023-05-20,17:00:00,130,63,67,FMN 12 Statielei
660,Statielei 26,2023-05-20,18:00:00,97,57,40,FMN 12 Statielei
660,Statielei 26,2023-05-20,19:00:00,157,88,69,FMN 12 Statielei
660,Statielei 26,2023-05-20,20:00:00,118,61,57,FMN 12 Statielei
660,Statielei 26,2023-05-20,21:00:00,73,43,30,FMN 12 Statielei
660,Statielei 26,2023-05-20,22:00:00,76,27,49,FMN 12 Statielei
660,Statielei 26,2023-05-20,23:00:00,77,29,48,FMN 12 Statielei
660,Statielei 26,2023-05-21,00:00:00,41,14,27,FMN 12 Statielei
660,Statielei 26,2023-05-21,01:00:00,32,11,21,FMN 12 Statielei
660,Statielei 26,2023-05-21,02:00:00,22,7,15,FMN 12 Statielei
660,Statielei 26,2023-05-21,03:00:00,9,7,2,FMN 12 Statielei
660,Statielei 26,2023-05-21,04:00:00,14,6,8,FMN 12 Statielei
660,Statielei 26,2023-05-21,05:00:00,15,8,7,FMN 12 Statielei
660,Statielei 26,2023-05-21,06:00:00,16,5,11,FMN 12 Statielei
660,Statielei 26,2023-05-21,07:00:00,16,10,6,FMN 12 Statielei
660,Statielei 26,2023-05-21,08:00:00,33,19,14,FMN 12 Statielei
660,Statielei 26,2023-05-21,09:00:00,74,31,43,FMN 12 Statielei
660,Statielei 26,2023-05-21,10:00:00,76,36,40,FMN 12 Statielei
660,Statielei 26,2023-05-21,11:00:00,89,47,42,FMN 12 Statielei
660,Statielei 26,2023-05-21,12:00:00,141,80,61,FMN 12 Statielei
660,Statielei 26,2023-05-21,13:00:00,118,61,57,FMN 12 Statielei
660,Statielei 26,2023-05-21,14:00:00,122,61,61,FMN 12 Statielei
660,Statielei 26,2023-05-21,15:00:00,145,77,68,FMN 12 Statielei
660,Statielei 26,2023-05-21,16:00:00,122,65,57,FMN 12 Statielei
660,Statielei 26,2023-05-21,17:00:00,138,76,62,FMN 12 Statielei
660,Statielei 26,2023-05-21,18:00:00,134,62,72,FMN 12 Statielei
660,Statielei 26,2023-05-21,19:00:00,104,54,50,FMN 12 Statielei
660,Statielei 26,2023-05-21,20:00:00,101,59,42,FMN 12 Statielei
660,Statielei 26,2023-05-21,21:00:00,99,47,52,FMN 12 Statielei
660,Statielei 26,2023-05-21,22:00:00,52,20,32,FMN 12 Statielei
660,Statielei 26,2023-05-21,23:00:00,32,13,19,FMN 12 Statielei
660,Statielei 26,2023-05-22,00:00:00,16,4,12,FMN 12 Statielei
660,Statielei 26,2023-05-22,01:00:00,12,9,3,FMN 12 Statielei
660,Statielei 26,2023-05-22,02:00:00,6,1,5,FMN 12 Statielei
660,Statielei 26,2023-05-22,03:00:00,3,2,1,FMN 12 Statielei
660,Statielei 26,2023-05-22,04:00:00,7,2,5,FMN 12 Statielei
660,Statielei 26,2023-05-22,05:00:00,27,14,13,FMN 12 Statielei
660,Statielei 26,2023-05-22,06:00:00,43,24,19,FMN 12 Statielei
660,Statielei 26,2023-05-22,07:00:00,157,90,67,FMN 12 Statielei
660,Statielei 26,2023-05-22,08:00:00,322,186,136,FMN 12 Statielei
660,Statielei 26,2023-05-22,09:00:00,136,84,52,FMN 12 Statielei
660,Statielei 26,2023-05-22,10:00:00,79,43,36,FMN 12 Statielei
660,Statielei 26,2023-05-22,11:00:00,87,53,34,FMN 12 Statielei
660,Statielei 26,2023-05-22,12:00:00,153,98,55,FMN 12 Statielei
660,Statielei 26,2023-05-22,13:00:00,108,49,59,FMN 12 Statielei
660,Statielei 26,2023-05-22,14:00:00,112,58,54,FMN 12 Statielei
660,Statielei 26,2023-05-22,15:00:00,211,102,109,FMN 12 Statielei
660,Statielei 26,2023-05-22,16:00:00,292,139,153,FMN 12 Statielei
660,Statielei 26,2023-05-22,17:00:00,292,135,157,FMN 12 Statielei
660,Statielei 26,2023-05-22,18:00:00,197,83,114,FMN 12 Statielei
660,Statielei 26,2023-05-22,19:00:00,148,73,75,FMN 12 Statielei
660,Statielei 26,2023-05-22,20:00:00,96,40,56,FMN 12 Statielei
660,Statielei 26,2023-05-22,21:00:00,100,55,45,FMN 12 Statielei
660,Statielei 26,2023-05-22,22:00:00,84,37,47,FMN 12 Statielei
660,Statielei 26,2023-05-22,23:00:00,37,14,23,FMN 12 Statielei
660,Statielei 26,2023-05-23,00:00:00,20,6,14,FMN 12 Statielei
660,Statielei 26,2023-05-23,01:00:00,15,5,10,FMN 12 Statielei
660,Statielei 26,2023-05-23,02:00:00,5,2,3,FMN 12 Statielei
660,Statielei 26,2023-05-23,03:00:00,8,2,6,FMN 12 Statielei
660,Statielei 26,2023-05-23,04:00:00,9,5,4,FMN 12 Statielei
660,Statielei 26,2023-05-23,05:00:00,21,9,12,FMN 12 Statielei
660,Statielei 26,2023-05-23,06:00:00,49,21,28,FMN 12 Statielei
660,Statielei 26,2023-05-23,07:00:00,144,68,76,FMN 12 Statielei
660,Statielei 26,2023-05-23,08:00:00,322,179,143,FMN 12 Statielei
660,Statielei 26,2023-05-23,09:00:00,135,80,55,FMN 12 Statielei
660,Statielei 26,2023-05-23,10:00:00,97,63,34,FMN 12 Statielei
660,Statielei 26,2023-05-23,11:00:00,83,43,40,FMN 12 Statielei
660,Statielei 26,2023-05-23,12:00:00,124,74,50,FMN 12 Statielei
660,Statielei 26,2023-05-23,13:00:00,101,58,43,FMN 12 Statielei
660,Statielei 26,2023-05-23,14:00:00,85,42,43,FMN 12 Statielei
660,Statielei 26,2023-05-23,15:00:00,198,87,111,FMN 12 Statielei
660,Statielei 26,2023-05-23,16:00:00,275,121,154,FMN 12 Statielei
660,Statielei 26,2023-05-23,17:00:00,241,107,134,FMN 12 Statielei
660,Statielei 26,2023-05-23,18:00:00,203,111,92,FMN 12 Statielei
660,Statielei 26,2023-05-23,19:00:00,157,86,71,FMN 12 Statielei
660,Statielei 26,2023-05-23,20:00:00,108,62,46,FMN 12 Statielei
660,Statielei 26,2023-05-23,21:00:00,88,32,56,FMN 12 Statielei
660,Statielei 26,2023-05-23,22:00:00,66,28,38,FMN 12 Statielei
660,Statielei 26,2023-05-23,23:00:00,41,11,30,FMN 12 Statielei
660,Statielei 26,2023-05-24,00:00:00,21,5,16,FMN 12 Statielei
660,Statielei 26,2023-05-24,01:00:00,11,4,7,FMN 12 Statielei
660,Statielei 26,2023-05-24,02:00:00,9,6,3,FMN 12 Statielei
660,Statielei 26,2023-05-24,03:00:00,5,2,3,FMN 12 Statielei
660,Statielei 26,2023-05-24,04:00:00,10,4,6,FMN 12 Statielei
660,Statielei 26,2023-05-24,05:00:00,21,10,11,FMN 12 Statielei
660,Statielei 26,2023-05-24,06:00:00,38,19,19,FMN 12 Statielei
660,Statielei 26,2023-05-24,07:00:00,132,63,69,FMN 12 Statielei
660,Statielei 26,2023-05-24,08:00:00,299,152,147,FMN 12 Statielei
660,Statielei 26,2023-05-24,09:00:00,121,80,41,FMN 12 Statielei
660,Statielei 26,2023-05-24,10:00:00,93,49,44,FMN 12 Statielei
660,Statielei 26,2023-05-24,11:00:00,107,58,49,FMN 12 Statielei
660,Statielei 26,2023-05-24,12:00:00,230,126,104,FMN 12 Statielei
660,Statielei 26,2023-05-24,13:00:00,124,66,58,FMN 12 Statielei
660,Statielei 26,2023-05-24,14:00:00,123,57,66,FMN 12 Statielei
660,Statielei 26,2023-05-24,15:00:00,145,57,88,FMN 12 Statielei
660,Statielei 26,2023-05-24,16:00:00,214,102,112,FMN 12 Statielei
660,Statielei 26,2023-05-24,17:00:00,216,117,99,FMN 12 Statielei
660,Statielei 26,2023-05-24,18:00:00,154,73,81,FMN 12 Statielei
660,Statielei 26,2023-05-24,19:00:00,144,76,68,FMN 12 Statielei
660,Statielei 26,2023-05-24,20:00:00,121,50,71,FMN 12 Statielei
660,Statielei 26,2023-05-24,21:00:00,89,45,44,FMN 12 Statielei
660,Statielei 26,2023-05-24,22:00:00,69,36,33,FMN 12 Statielei
660,Statielei 26,2023-05-24,23:00:00,65,29,36,FMN 12 Statielei
660,Statielei 26,2023-05-25,00:00:00,31,10,21,FMN 12 Statielei
660,Statielei 26,2023-05-25,01:00:00,9,3,6,FMN 12 Statielei
660,Statielei 26,2023-05-25,02:00:00,7,4,3,FMN 12 Statielei
660,Statielei 26,2023-05-25,03:00:00,3,2,1,FMN 12 Statielei
660,Statielei 26,2023-05-25,04:00:00,11,6,5,FMN 12 Statielei
660,Statielei 26,2023-05-25,05:00:00,22,12,10,FMN 12 Statielei
660,Statielei 26,2023-05-25,06:00:00,34,17,17,FMN 12 Statielei
660,Statielei 26,2023-05-25,07:00:00,146,70,76,FMN 12 Statielei
660,Statielei 26,2023-05-25,08:00:00,297,169,128,FMN 12 Statielei
660,Statielei 26,2023-05-25,09:00:00,117,73,44,FMN 12 Statielei
660,Statielei 26,2023-05-25,10:00:00,92,52,40,FMN 12 Statielei
660,Statielei 26,2023-05-25,11:00:00,100,51,49,FMN 12 Statielei
660,Statielei 26,2023-05-25,12:00:00,121,64,57,FMN 12 Statielei
660,Statielei 26,2023-05-25,13:00:00,94,48,46,FMN 12 Statielei
660,Statielei 26,2023-05-25,14:00:00,113,55,58,FMN 12 Statielei
660,Statielei 26,2023-05-25,15:00:00,160,79,81,FMN 12 Statielei
660,Statielei 26,2023-05-25,16:00:00,253,118,135,FMN 12 Statielei
660,Statielei 26,2023-05-25,17:00:00,227,108,119,FMN 12 Statielei
660,Statielei 26,2023-05-25,18:00:00,225,119,106,FMN 12 Statielei
660,Statielei 26,2023-05-25,19:00:00,145,69,76,FMN 12 Statielei
660,Statielei 26,2023-05-25,20:00:00,126,65,61,FMN 12 Statielei
660,Statielei 26,2023-05-25,21:00:00,100,46,54,FMN 12 Statielei
660,Statielei 26,2023-05-25,22:00:00,80,37,43,FMN 12 Statielei
660,Statielei 26,2023-05-25,23:00:00,68,23,45,FMN 12 Statielei
660,Statielei 26,2023-05-26,00:00:00,34,10,24,FMN 12 Statielei
660,Statielei 26,2023-05-26,01:00:00,14,6,8,FMN 12 Statielei
660,Statielei 26,2023-05-26,02:00:00,7,2,5,FMN 12 Statielei
660,Statielei 26,2023-05-26,03:00:00,6,3,3,FMN 12 Statielei
660,Statielei 26,2023-05-26,04:00:00,11,7,4,FMN 12 Statielei
660,Statielei 26,2023-05-26,05:00:00,26,13,13,FMN 12 Statielei
660,Statielei 26,2023-05-26,06:00:00,40,21,19,FMN 12 Statielei
660,Statielei 26,2023-05-26,07:00:00,136,61,75,FMN 12 Statielei
660,Statielei 26,2023-05-26,08:00:00,289,168,121,FMN 12 Statielei
660,Statielei 26,2023-05-26,09:00:00,121,79,42,FMN 12 Statielei
660,Statielei 26,2023-05-26,10:00:00,85,53,32,FMN 12 Statielei
660,Statielei 26,2023-05-26,11:00:00,90,53,37,FMN 12 Statielei
660,Statielei 26,2023-05-26,12:00:00,113,59,54,FMN 12 Statielei
660,Statielei 26,2023-05-26,13:00:00,128,54,74,FMN 12 Statielei
660,Statielei 26,2023-05-26,14:00:00,133,62,71,FMN 12 Statielei
660,Statielei 26,2023-05-26,15:00:00,190,85,105,FMN 12 Statielei
660,Statielei 26,2023-05-26,16:00:00,233,119,114,FMN 12 Statielei
660,Statielei 26,2023-05-26,17:00:00,204,86,118,FMN 12 Statielei
660,Statielei 26,2023-05-26,18:00:00,171,82,89,FMN 12 Statielei
660,Statielei 26,2023-05-26,19:00:00,150,76,74,FMN 12 Statielei
660,Statielei 26,2023-05-26,20:00:00,117,59,58,FMN 12 Statielei
660,Statielei 26,2023-05-26,21:00:00,141,77,64,FMN 12 Statielei
660,Statielei 26,2023-05-26,22:00:00,75,45,30,FMN 12 Statielei
660,Statielei 26,2023-05-26,23:00:00,64,27,37,FMN 12 Statielei
660,Statielei 26,2023-05-27,00:00:00,57,18,39,FMN 12 Statielei
660,Statielei 26,2023-05-27,01:00:00,32,14,18,FMN 12 Statielei
660,Statielei 26,2023-05-27,02:00:00,24,4,20,FMN 12 Statielei
660,Statielei 26,2023-05-27,03:00:00,8,3,5,FMN 12 Statielei
660,Statielei 26,2023-05-27,04:00:00,8,3,5,FMN 12 Statielei
660,Statielei 26,2023-05-27,05:00:00,6,2,4,FMN 12 Statielei
660,Statielei 26,2023-05-27,06:00:00,10,5,5,FMN 12 Statielei
660,Statielei 26,2023-05-27,07:00:00,18,7,11,FMN 12 Statielei
660,Statielei 26,2023-05-27,08:00:00,53,23,30,FMN 12 Statielei
660,Statielei 26,2023-05-27,09:00:00,95,47,48,FMN 12 Statielei
660,Statielei 26,2023-05-27,10:00:00,107,49,58,FMN 12 Statielei
660,Statielei 26,2023-05-27,11:00:00,120,75,45,FMN 12 Statielei
660,Statielei 26,2023-05-27,12:00:00,142,81,61,FMN 12 Statielei
660,Statielei 26,2023-05-27,13:00:00,123,65,58,FMN 12 Statielei
660,Statielei 26,2023-05-27,14:00:00,152,75,77,FMN 12 Statielei
660,Statielei 26,2023-05-27,15:00:00,139,66,73,FMN 12 Statielei
660,Statielei 26,2023-05-27,16:00:00,140,63,77,FMN 12 Statielei
660,Statielei 26,2023-05-27,17:00:00,157,90,67,FMN 12 Statielei
660,Statielei 26,2023-05-27,18:00:00,150,87,63,FMN 12 Statielei
660,Statielei 26,2023-05-27,19:00:00,126,67,59,FMN 12 Statielei
660,Statielei 26,2023-05-27,20:00:00,127,67,60,FMN 12 Statielei
660,Statielei 26,2023-05-27,21:00:00,93,51,42,FMN 12 Statielei
660,Statielei 26,2023-05-27,22:00:00,99,48,51,FMN 12 Statielei
660,Statielei 26,2023-05-27,23:00:00,86,33,53,FMN 12 Statielei
660,Statielei 26,2023-05-28,00:00:00,67,22,45,FMN 12 Statielei
660,Statielei 26,2023-05-28,01:00:00,54,15,39,FMN 12 Statielei
660,Statielei 26,2023-05-28,02:00:00,25,7,18,FMN 12 Statielei
660,Statielei 26,2023-05-28,03:00:00,11,4,7,FMN 12 Statielei
660,Statielei 26,2023-05-28,04:00:00,9,3,6,FMN 12 Statielei
660,Statielei 26,2023-05-28,05:00:00,11,6,5,FMN 12 Statielei
660,Statielei 26,2023-05-28,06:00:00,13,7,6,FMN 12 Statielei
660,Statielei 26,2023-05-28,07:00:00,13,5,8,FMN 12 Statielei
660,Statielei 26,2023-05-28,08:00:00,34,18,16,FMN 12 Statielei
660,Statielei 26,2023-05-28,09:00:00,76,32,44,FMN 12 Statielei
660,Statielei 26,2023-05-28,10:00:00,82,42,40,FMN 12 Statielei
660,Statielei 26,2023-05-28,11:00:00,123,52,71,FMN 12 Statielei
660,Statielei 26,2023-05-28,12:00:00,223,119,104,FMN 12 Statielei
660,Statielei 26,2023-05-28,13:00:00,145,65,80,FMN 12 Statielei
660,Statielei 26,2023-05-28,14:00:00,152,69,83,FMN 12 Statielei
660,Statielei 26,2023-05-28,15:00:00,161,84,77,FMN 12 Statielei
660,Statielei 26,2023-05-28,16:00:00,229,155,74,FMN 12 Statielei
660,Statielei 26,2023-05-28,17:00:00,165,91,74,FMN 12 Statielei
660,Statielei 26,2023-05-28,18:00:00,151,72,79,FMN 12 Statielei
660,Statielei 26,2023-05-28,19:00:00,133,64,69,FMN 12 Statielei
660,Statielei 26,2023-05-28,20:00:00,116,52,64,FMN 12 Statielei
660,Statielei 26,2023-05-28,21:00:00,103,48,55,FMN 12 Statielei
660,Statielei 26,2023-05-28,22:00:00,97,47,50,FMN 12 Statielei
660,Statielei 26,2023-05-28,23:00:00,83,44,39,FMN 12 Statielei
660,Statielei 26,2023-05-29,00:00:00,45,16,29,FMN 12 Statielei
660,Statielei 26,2023-05-29,01:00:00,37,9,28,FMN 12 Statielei
660,Statielei 26,2023-05-29,02:00:00,7,3,4,FMN 12 Statielei
660,Statielei 26,2023-05-29,03:00:00,10,2,8,FMN 12 Statielei
660,Statielei 26,2023-05-29,04:00:00,3,0,3,FMN 12 Statielei
660,Statielei 26,2023-05-29,05:00:00,8,5,3,FMN 12 Statielei
660,Statielei 26,2023-05-29,06:00:00,10,5,5,FMN 12 Statielei
660,Statielei 26,2023-05-29,07:00:00,12,5,7,FMN 12 Statielei
660,Statielei 26,2023-05-29,08:00:00,23,8,15,FMN 12 Statielei
660,Statielei 26,2023-05-29,09:00:00,74,50,24,FMN 12 Statielei
660,Statielei 26,2023-05-29,10:00:00,89,43,46,FMN 12 Statielei
660,Statielei 26,2023-05-29,11:00:00,89,52,37,FMN 12 Statielei
660,Statielei 26,2023-05-29,12:00:00,120,75,45,FMN 12 Statielei
660,Statielei 26,2023-05-29,13:00:00,158,75,83,FMN 12 Statielei
660,Statielei 26,2023-05-29,14:00:00,187,95,92,FMN 12 Statielei
660,Statielei 26,2023-05-29,15:00:00,137,65,72,FMN 12 Statielei
660,Statielei 26,2023-05-29,16:00:00,159,83,76,FMN 12 Statielei
660,Statielei 26,2023-05-29,17:00:00,162,101,61,FMN 12 Statielei
660,Statielei 26,2023-05-29,18:00:00,156,83,73,FMN 12 Statielei
660,Statielei 26,2023-05-29,19:00:00,131,69,62,FMN 12 Statielei
660,Statielei 26,2023-05-29,20:00:00,110,46,64,FMN 12 Statielei
660,Statielei 26,2023-05-29,21:00:00,91,47,44,FMN 12 Statielei
660,Statielei 26,2023-05-29,22:00:00,94,41,53,FMN 12 Statielei
660,Statielei 26,2023-05-29,23:00:00,44,15,29,FMN 12 Statielei
660,Statielei 26,2023-05-30,00:00:00,15,7,8,FMN 12 Statielei
660,Statielei 26,2023-05-30,01:00:00,5,2,3,FMN 12 Statielei
660,Statielei 26,2023-05-30,02:00:00,6,2,4,FMN 12 Statielei
660,Statielei 26,2023-05-30,03:00:00,2,1,1,FMN 12 Statielei
660,Statielei 26,2023-05-30,04:00:00,9,4,5,FMN 12 Statielei
660,Statielei 26,2023-05-30,05:00:00,24,9,15,FMN 12 Statielei
660,Statielei 26,2023-05-30,06:00:00,42,18,24,FMN 12 Statielei
660,Statielei 26,2023-05-30,07:00:00,135,67,68,FMN 12 Statielei
660,Statielei 26,2023-05-30,08:00:00,332,169,163,FMN 12 Statielei
660,Statielei 26,2023-05-30,09:00:00,120,83,37,FMN 12 Statielei
660,Statielei 26,2023-05-30,10:00:00,102,62,40,FMN 12 Statielei
660,Statielei 26,2023-05-30,11:00:00,90,49,41,FMN 12 Statielei
660,Statielei 26,2023-05-30,12:00:00,130,75,55,FMN 12 Statielei
660,Statielei 26,2023-05-30,13:00:00,127,71,56,FMN 12 Statielei
660,Statielei 26,2023-05-30,14:00:00,121,55,66,FMN 12 Statielei
660,Statielei 26,2023-05-30,15:00:00,200,70,130,FMN 12 Statielei
660,Statielei 26,2023-05-30,16:00:00,274,150,124,FMN 12 Statielei
660,Statielei 26,2023-05-30,17:00:00,241,112,129,FMN 12 Statielei
660,Statielei 26,2023-05-30,18:00:00,197,98,99,FMN 12 Statielei
660,Statielei 26,2023-05-30,19:00:00,156,94,62,FMN 12 Statielei
660,Statielei 26,2023-05-30,20:00:00,88,44,44,FMN 12 Statielei
660,Statielei 26,2023-05-30,21:00:00,124,53,71,FMN 12 Statielei
660,Statielei 26,2023-05-30,22:00:00,88,38,50,FMN 12 Statielei
660,Statielei 26,2023-05-30,23:00:00,45,9,36,FMN 12 Statielei
660,Statielei 26,2023-05-31,00:00:00,18,6,12,FMN 12 Statielei
660,Statielei 26,2023-05-31,01:00:00,11,5,6,FMN 12 Statielei
660,Statielei 26,2023-05-31,02:00:00,2,2,0,FMN 12 Statielei
660,Statielei 26,2023-05-31,03:00:00,7,5,2,FMN 12 Statielei
660,Statielei 26,2023-05-31,04:00:00,10,5,5,FMN 12 Statielei
660,Statielei 26,2023-05-31,05:00:00,23,9,14,FMN 12 Statielei
660,Statielei 26,2023-05-31,06:00:00,37,21,16,FMN 12 Statielei
660,Statielei 26,2023-05-31,07:00:00,140,67,73,FMN 12 Statielei
660,Statielei 26,2023-05-31,08:00:00,316,162,154,FMN 12 Statielei
660,Statielei 26,2023-05-31,09:00:00,121,70,51,FMN 12 Statielei
660,Statielei 26,2023-05-31,10:00:00,100,61,39,FMN 12 Statielei
660,Statielei 26,2023-05-31,11:00:00,120,65,55,FMN 12 Statielei
660,Statielei 26,2023-05-31,12:00:00,236,134,102,FMN 12 Statielei
660,Statielei 26,2023-05-31,13:00:00,145,77,68,FMN 12 Statielei
660,Statielei 26,2023-05-31,14:00:00,162,70,92,FMN 12 Statielei
660,Statielei 26,2023-05-31,15:00:00,195,88,107,FMN 12 Statielei
660,Statielei 26,2023-05-31,16:00:00,218,86,132,FMN 12 Statielei
660,Statielei 26,2023-05-31,17:00:00,245,129,116,FMN 12 Statielei
660,Statielei 26,2023-05-31,18:00:00,214,118,96,FMN 12 Statielei
660,Statielei 26,2023-05-31,19:00:00,173,102,71,FMN 12 Statielei
660,Statielei 26,2023-05-31,20:00:00,151,67,84,FMN 12 Statielei
660,Statielei 26,2023-05-31,21:00:00,118,53,65,FMN 12 Statielei
660,Statielei 26,2023-05-31,22:00:00,112,44,68,FMN 12 Statielei
660,Statielei 26,2023-05-31,23:00:00,74,37,37,FMN 12 Statielei
660,Statielei 26,2023-06-01,00:00:00,36,12,24,FMN 12 Statielei
660,Statielei 26,2023-06-01,01:00:00,6,4,2,FMN 12 Statielei
660,Statielei 26,2023-06-01,02:00:00,1,0,1,FMN 12 Statielei
660,Statielei 26,2023-06-01,03:00:00,7,4,3,FMN 12 Statielei
660,Statielei 26,2023-06-01,04:00:00,10,3,7,FMN 12 Statielei
660,Statielei 26,2023-06-01,05:00:00,22,8,14,FMN 12 Statielei
660,Statielei 26,2023-06-01,06:00:00,28,9,19,FMN 12 Statielei
660,Statielei 26,2023-06-01,07:00:00,144,63,81,FMN 12 Statielei
660,Statielei 26,2023-06-01,08:00:00,320,173,147,FMN 12 Statielei
660,Statielei 26,2023-06-01,09:00:00,145,98,47,FMN 12 Statielei
660,Statielei 26,2023-06-01,10:00:00,92,55,37,FMN 12 Statielei
660,Statielei 26,2023-06-01,11:00:00,82,51,31,FMN 12 Statielei
660,Statielei 26,2023-06-01,12:00:00,134,59,75,FMN 12 Statielei
660,Statielei 26,2023-06-01,13:00:00,128,62,66,FMN 12 Statielei
660,Statielei 26,2023-06-01,14:00:00,105,52,53,FMN 12 Statielei
660,Statielei 26,2023-06-01,15:00:00,185,97,88,FMN 12 Statielei
660,Statielei 26,2023-06-01,16:00:00,281,140,141,FMN 12 Statielei
660,Statielei 26,2023-06-01,17:00:00,242,120,122,FMN 12 Statielei
660,Statielei 26,2023-06-01,18:00:00,231,104,127,FMN 12 Statielei
660,Statielei 26,2023-06-01,19:00:00,156,78,78,FMN 12 Statielei
660,Statielei 26,2023-06-01,20:00:00,92,49,43,FMN 12 Statielei
660,Statielei 26,2023-06-01,21:00:00,91,48,43,FMN 12 Statielei
660,Statielei 26,2023-06-01,22:00:00,88,43,45,FMN 12 Statielei
660,Statielei 26,2023-06-01,23:00:00,59,23,36,FMN 12 Statielei
660,Statielei 26,2023-06-02,00:00:00,22,3,19,FMN 12 Statielei
660,Statielei 26,2023-06-02,01:00:00,9,2,7,FMN 12 Statielei
660,Statielei 26,2023-06-02,02:00:00,2,1,1,FMN 12 Statielei
660,Statielei 26,2023-06-02,03:00:00,4,2,2,FMN 12 Statielei
660,Statielei 26,2023-06-02,04:00:00,10,2,8,FMN 12 Statielei
660,Statielei 26,2023-06-02,05:00:00,24,12,12,FMN 12 Statielei
660,Statielei 26,2023-06-02,06:00:00,37,19,18,FMN 12 Statielei
660,Statielei 26,2023-06-02,07:00:00,123,57,66,FMN 12 Statielei
660,Statielei 26,2023-06-02,08:00:00,305,157,148,FMN 12 Statielei
660,Statielei 26,2023-06-02,09:00:00,124,77,47,FMN 12 Statielei
660,Statielei 26,2023-06-02,10:00:00,76,44,32,FMN 12 Statielei
660,Statielei 26,2023-06-02,11:00:00,67,44,23,FMN 12 Statielei
660,Statielei 26,2023-06-02,12:00:00,118,60,58,FMN 12 Statielei
660,Statielei 26,2023-06-02,13:00:00,114,60,54,FMN 12 Statielei
660,Statielei 26,2023-06-02,14:00:00,129,75,54,FMN 12 Statielei
660,Statielei 26,2023-06-02,15:00:00,171,79,92,FMN 12 Statielei
660,Statielei 26,2023-06-02,16:00:00,269,145,124,FMN 12 Statielei
660,Statielei 26,2023-06-02,17:00:00,199,95,104,FMN 12 Statielei
660,Statielei 26,2023-06-02,18:00:00,208,106,102,FMN 12 Statielei
660,Statielei 26,2023-06-02,19:00:00,175,84,91,FMN 12 Statielei
660,Statielei 26,2023-06-02,20:00:00,126,62,64,FMN 12 Statielei
660,Statielei 26,2023-06-02,21:00:00,146,74,72,FMN 12 Statielei
660,Statielei 26,2023-06-02,22:00:00,102,41,61,FMN 12 Statielei
660,Statielei 26,2023-06-02,23:00:00,76,25,51,FMN 12 Statielei
660,Statielei 26,2023-06-03,00:00:00,69,22,47,FMN 12 Statielei
660,Statielei 26,2023-06-03,01:00:00,35,13,22,FMN 12 Statielei
660,Statielei 26,2023-06-03,02:00:00,32,10,22,FMN 12 Statielei
660,Statielei 26,2023-06-03,03:00:00,11,5,6,FMN 12 Statielei
660,Statielei 26,2023-06-03,04:00:00,10,1,9,FMN 12 Statielei
660,Statielei 26,2023-06-03,05:00:00,18,9,9,FMN 12 Statielei
660,Statielei 26,2023-06-03,06:00:00,15,11,4,FMN 12 Statielei
660,Statielei 26,2023-06-03,07:00:00,22,11,11,FMN 12 Statielei
660,Statielei 26,2023-06-03,08:00:00,64,31,33,FMN 12 Statielei
660,Statielei 26,2023-06-03,09:00:00,115,50,65,FMN 12 Statielei
660,Statielei 26,2023-06-03,10:00:00,162,86,76,FMN 12 Statielei
660,Statielei 26,2023-06-03,11:00:00,144,74,70,FMN 12 Statielei
660,Statielei 26,2023-06-03,12:00:00,133,83,50,FMN 12 Statielei
660,Statielei 26,2023-06-03,13:00:00,162,90,72,FMN 12 Statielei
660,Statielei 26,2023-06-03,14:00:00,182,92,90,FMN 12 Statielei
660,Statielei 26,2023-06-03,15:00:00,168,70,98,FMN 12 Statielei
660,Statielei 26,2023-06-03,16:00:00,214,120,94,FMN 12 Statielei
660,Statielei 26,2023-06-03,17:00:00,177,90,87,FMN 12 Statielei
660,Statielei 26,2023-06-03,18:00:00,179,116,63,FMN 12 Statielei
660,Statielei 26,2023-06-03,19:00:00,160,103,57,FMN 12 Statielei
660,Statielei 26,2023-06-03,20:00:00,136,74,62,FMN 12 Statielei
660,Statielei 26,2023-06-03,21:00:00,116,65,51,FMN 12 Statielei
660,Statielei 26,2023-06-03,22:00:00,92,42,50,FMN 12 Statielei
660,Statielei 26,2023-06-03,23:00:00,102,45,57,FMN 12 Statielei
660,Statielei 26,2023-06-04,00:00:00,81,24,57,FMN 12 Statielei
660,Statielei 26,2023-06-04,01:00:00,59,22,37,FMN 12 Statielei
660,Statielei 26,2023-06-04,02:00:00,31,17,14,FMN 12 Statielei
660,Statielei 26,2023-06-04,03:00:00,17,10,7,FMN 12 Statielei
660,Statielei 26,2023-06-04,04:00:00,5,3,2,FMN 12 Statielei
660,Statielei 26,2023-06-04,05:00:00,14,4,10,FMN 12 Statielei
660,Statielei 26,2023-06-04,06:00:00,13,4,9,FMN 12 Statielei
660,Statielei 26,2023-06-04,07:00:00,18,8,10,FMN 12 Statielei
660,Statielei 26,2023-06-04,08:00:00,54,33,21,FMN 12 Statielei
660,Statielei 26,2023-06-04,09:00:00,96,41,55,FMN 12 Statielei
660,Statielei 26,2023-06-04,10:00:00,101,42,59,FMN 12 Statielei
660,Statielei 26,2023-06-04,11:00:00,135,75,60,FMN 12 Statielei
660,Statielei 26,2023-06-04,12:00:00,145,77,68,FMN 12 Statielei
660,Statielei 26,2023-06-04,13:00:00,155,67,88,FMN 12 Statielei
660,Statielei 26,2023-06-04,14:00:00,223,108,115,FMN 12 Statielei
660,Statielei 26,2023-06-04,15:00:00,155,67,88,FMN 12 Statielei
660,Statielei 26,2023-06-04,16:00:00,187,94,93,FMN 12 Statielei
660,Statielei 26,2023-06-04,17:00:00,210,114,96,FMN 12 Statielei
660,Statielei 26,2023-06-04,18:00:00,185,109,76,FMN 12 Statielei
660,Statielei 26,2023-06-04,19:00:00,168,96,72,FMN 12 Statielei
660,Statielei 26,2023-06-04,20:00:00,93,41,52,FMN 12 Statielei
660,Statielei 26,2023-06-04,21:00:00,161,81,80,FMN 12 Statielei
660,Statielei 26,2023-06-04,22:00:00,101,50,51,FMN 12 Statielei
660,Statielei 26,2023-06-04,23:00:00,58,27,31,FMN 12 Statielei
660,Statielei 26,2023-06-05,00:00:00,80,61,19,FMN 12 Statielei
660,Statielei 26,2023-06-05,01:00:00,21,15,6,FMN 12 Statielei
660,Statielei 26,2023-06-05,02:00:00,9,7,2,FMN 12 Statielei
660,Statielei 26,2023-06-05,03:00:00,7,6,1,FMN 12 Statielei
660,Statielei 26,2023-06-05,04:00:00,12,6,6,FMN 12 Statielei
660,Statielei 26,2023-06-05,05:00:00,19,10,9,FMN 12 Statielei
660,Statielei 26,2023-06-05,06:00:00,23,7,16,FMN 12 Statielei
660,Statielei 26,2023-06-05,07:00:00,129,57,72,FMN 12 Statielei
660,Statielei 26,2023-06-05,08:00:00,311,164,147,FMN 12 Statielei
660,Statielei 26,2023-06-05,09:00:00,137,91,46,FMN 12 Statielei
660,Statielei 26,2023-06-05,10:00:00,92,55,37,FMN 12 Statielei
660,Statielei 26,2023-06-05,11:00:00,101,55,46,FMN 12 Statielei
660,Statielei 26,2023-06-05,12:00:00,150,83,67,FMN 12 Statielei
660,Statielei 26,2023-06-05,13:00:00,118,49,69,FMN 12 Statielei
660,Statielei 26,2023-06-05,14:00:00,117,66,51,FMN 12 Statielei
660,Statielei 26,2023-06-05,15:00:00,189,92,97,FMN 12 Statielei
660,Statielei 26,2023-06-05,16:00:00,274,141,133,FMN 12 Statielei
660,Statielei 26,2023-06-05,17:00:00,258,126,132,FMN 12 Statielei
660,Statielei 26,2023-06-05,18:00:00,203,114,89,FMN 12 Statielei
660,Statielei 26,2023-06-05,19:00:00,155,85,70,FMN 12 Statielei
660,Statielei 26,2023-06-05,20:00:00,148,56,92,FMN 12 Statielei
660,Statielei 26,2023-06-05,21:00:00,120,65,55,FMN 12 Statielei
660,Statielei 26,2023-06-05,22:00:00,79,25,54,FMN 12 Statielei
660,Statielei 26,2023-06-05,23:00:00,53,14,39,FMN 12 Statielei
660,Statielei 26,2023-06-06,00:00:00,0,0,0,FMN 12 Statielei
660,Statielei 26,2023-06-06,01:00:00,9,4,5,FMN 12 Statielei
660,Statielei 26,2023-06-06,02:00:00,5,2,3,FMN 12 Statielei
660,Statielei 26,2023-06-06,03:00:00,4,2,2,FMN 12 Statielei
660,Statielei 26,2023-06-06,04:00:00,8,3,5,FMN 12 Statielei
660,Statielei 26,2023-06-06,05:00:00,14,7,7,FMN 12 Statielei
660,Statielei 26,2023-06-06,06:00:00,36,16,20,FMN 12 Statielei
660,Statielei 26,2023-06-06,07:00:00,149,70,79,FMN 12 Statielei
660,Statielei 26,2023-06-06,08:00:00,363,199,164,FMN 12 Statielei
660,Statielei 26,2023-06-06,09:00:00,140,89,51,FMN 12 Statielei
660,Statielei 26,2023-06-06,10:00:00,102,67,35,FMN 12 Statielei
660,Statielei 26,2023-06-06,11:00:00,94,43,51,FMN 12 Statielei
660,Statielei 26,2023-06-06,12:00:00,123,69,54,FMN 12 Statielei
660,Statielei 26,2023-06-06,13:00:00,128,74,54,FMN 12 Statielei
660,Statielei 26,2023-06-06,14:00:00,113,44,69,FMN 12 Statielei
660,Statielei 26,2023-06-06,15:00:00,222,97,125,FMN 12 Statielei
660,Statielei 26,2023-06-06,16:00:00,305,154,151,FMN 12 Statielei
660,Statielei 26,2023-06-06,17:00:00,271,133,138,FMN 12 Statielei
660,Statielei 26,2023-06-06,18:00:00,198,110,88,FMN 12 Statielei
660,Statielei 26,2023-06-06,19:00:00,197,92,105,FMN 12 Statielei
660,Statielei 26,2023-06-06,20:00:00,130,56,74,FMN 12 Statielei
660,Statielei 26,2023-06-06,21:00:00,123,67,56,FMN 12 Statielei
660,Statielei 26,2023-06-06,22:00:00,96,41,55,FMN 12 Statielei
660,Statielei 26,2023-06-06,23:00:00,69,28,41,FMN 12 Statielei
660,Statielei 26,2023-06-07,00:00:00,22,9,13,FMN 12 Statielei
660,Statielei 26,2023-06-07,01:00:00,14,7,7,FMN 12 Statielei
660,Statielei 26,2023-06-07,02:00:00,3,1,2,FMN 12 Statielei
660,Statielei 26,2023-06-07,03:00:00,10,3,7,FMN 12 Statielei
660,Statielei 26,2023-06-07,04:00:00,8,4,4,FMN 12 Statielei
660,Statielei 26,2023-06-07,05:00:00,18,7,11,FMN 12 Statielei
660,Statielei 26,2023-06-07,06:00:00,41,18,23,FMN 12 Statielei
660,Statielei 26,2023-06-07,07:00:00,143,66,77,FMN 12 Statielei
660,Statielei 26,2023-06-07,08:00:00,319,160,159,FMN 12 Statielei
660,Statielei 26,2023-06-07,09:00:00,114,61,53,FMN 12 Statielei
660,Statielei 26,2023-06-07,10:00:00,81,44,37,FMN 12 Statielei
660,Statielei 26,2023-06-07,11:00:00,96,55,41,FMN 12 Statielei
660,Statielei 26,2023-06-07,12:00:00,247,140,107,FMN 12 Statielei
660,Statielei 26,2023-06-07,13:00:00,144,67,77,FMN 12 Statielei
660,Statielei 26,2023-06-07,14:00:00,157,83,74,FMN 12 Statielei
660,Statielei 26,2023-06-07,15:00:00,159,74,85,FMN 12 Statielei
660,Statielei 26,2023-06-07,16:00:00,230,99,131,FMN 12 Statielei
660,Statielei 26,2023-06-07,17:00:00,217,104,113,FMN 12 Statielei
660,Statielei 26,2023-06-07,18:00:00,253,134,119,FMN 12 Statielei
660,Statielei 26,2023-06-07,19:00:00,191,98,93,FMN 12 Statielei
660,Statielei 26,2023-06-07,20:00:00,133,62,71,FMN 12 Statielei
660,Statielei 26,2023-06-07,21:00:00,101,49,52,FMN 12 Statielei
660,Statielei 26,2023-06-07,22:00:00,107,42,65,FMN 12 Statielei
660,Statielei 26,2023-06-07,23:00:00,54,15,39,FMN 12 Statielei
660,Statielei 26,2023-06-08,00:00:00,33,10,23,FMN 12 Statielei
660,Statielei 26,2023-06-08,01:00:00,18,5,13,FMN 12 Statielei
660,Statielei 26,2023-06-08,02:00:00,6,3,3,FMN 12 Statielei
660,Statielei 26,2023-06-08,03:00:00,6,4,2,FMN 12 Statielei
660,Statielei 26,2023-06-08,04:00:00,6,5,1,FMN 12 Statielei
660,Statielei 26,2023-06-08,05:00:00,19,5,14,FMN 12 Statielei
660,Statielei 26,2023-06-08,06:00:00,42,17,25,FMN 12 Statielei
660,Statielei 26,2023-06-08,07:00:00,155,74,81,FMN 12 Statielei
660,Statielei 26,2023-06-08,08:00:00,338,184,154,FMN 12 Statielei
660,Statielei 26,2023-06-08,09:00:00,160,99,61,FMN 12 Statielei
660,Statielei 26,2023-06-08,10:00:00,94,68,26,FMN 12 Statielei
660,Statielei 26,2023-06-08,11:00:00,104,58,46,FMN 12 Statielei
660,Statielei 26,2023-06-08,12:00:00,169,83,86,FMN 12 Statielei
660,Statielei 26,2023-06-08,13:00:00,139,75,64,FMN 12 Statielei
660,Statielei 26,2023-06-08,14:00:00,102,44,58,FMN 12 Statielei
660,Statielei 26,2023-06-08,15:00:00,213,92,121,FMN 12 Statielei
660,Statielei 26,2023-06-08,16:00:00,283,143,140,FMN 12 Statielei
660,Statielei 26,2023-06-08,17:00:00,249,112,137,FMN 12 Statielei
660,Statielei 26,2023-06-08,18:00:00,233,128,105,FMN 12 Statielei
660,Statielei 26,2023-06-08,19:00:00,211,123,88,FMN 12 Statielei
660,Statielei 26,2023-06-08,20:00:00,112,56,56,FMN 12 Statielei
660,Statielei 26,2023-06-08,21:00:00,122,61,61,FMN 12 Statielei
660,Statielei 26,2023-06-08,22:00:00,119,44,75,FMN 12 Statielei
660,Statielei 26,2023-06-08,23:00:00,54,17,37,FMN 12 Statielei
660,Statielei 26,2023-06-09,00:00:00,30,9,21,FMN 12 Statielei
660,Statielei 26,2023-06-09,01:00:00,24,5,19,FMN 12 Statielei
660,Statielei 26,2023-06-09,02:00:00,6,1,5,FMN 12 Statielei
660,Statielei 26,2023-06-09,03:00:00,5,5,0,FMN 12 Statielei
660,Statielei 26,2023-06-09,04:00:00,12,5,7,FMN 12 Statielei
660,Statielei 26,2023-06-09,05:00:00,18,9,9,FMN 12 Statielei
660,Statielei 26,2023-06-09,06:00:00,33,17,16,FMN 12 Statielei
660,Statielei 26,2023-06-09,07:00:00,143,66,77,FMN 12 Statielei
660,Statielei 26,2023-06-09,08:00:00,347,181,166,FMN 12 Statielei
660,Statielei 26,2023-06-09,09:00:00,138,92,46,FMN 12 Statielei
660,Statielei 26,2023-06-09,10:00:00,106,62,44,FMN 12 Statielei
660,Statielei 26,2023-06-09,11:00:00,99,57,42,FMN 12 Statielei
660,Statielei 26,2023-06-09,12:00:00,150,81,69,FMN 12 Statielei
660,Statielei 26,2023-06-09,13:00:00,132,63,69,FMN 12 Statielei
660,Statielei 26,2023-06-09,14:00:00,127,61,66,FMN 12 Statielei
660,Statielei 26,2023-06-09,15:00:00,204,87,117,FMN 12 Statielei
660,Statielei 26,2023-06-09,16:00:00,276,138,138,FMN 12 Statielei
660,Statielei 26,2023-06-09,17:00:00,220,105,115,FMN 12 Statielei
660,Statielei 26,2023-06-09,18:00:00,185,101,84,FMN 12 Statielei
660,Statielei 26,2023-06-09,19:00:00,169,102,67,FMN 12 Statielei
660,Statielei 26,2023-06-09,20:00:00,141,69,72,FMN 12 Statielei
660,Statielei 26,2023-06-09,21:00:00,119,65,54,FMN 12 Statielei
660,Statielei 26,2023-06-09,22:00:00,116,50,66,FMN 12 Statielei
660,Statielei 26,2023-06-09,23:00:00,82,35,47,FMN 12 Statielei
660,Statielei 26,2023-06-10,00:00:00,83,25,58,FMN 12 Statielei
660,Statielei 26,2023-06-10,01:00:00,46,20,26,FMN 12 Statielei
660,Statielei 26,2023-06-10,02:00:00,24,14,10,FMN 12 Statielei
660,Statielei 26,2023-06-10,03:00:00,14,5,9,FMN 12 Statielei
660,Statielei 26,2023-06-10,04:00:00,10,3,7,FMN 12 Statielei
660,Statielei 26,2023-06-10,05:00:00,8,5,3,FMN 12 Statielei
660,Statielei 26,2023-06-10,06:00:00,13,6,7,FMN 12 Statielei
660,Statielei 26,2023-06-10,07:00:00,38,21,17,FMN 12 Statielei
660,Statielei 26,2023-06-10,08:00:00,72,39,33,FMN 12 Statielei
660,Statielei 26,2023-06-10,09:00:00,97,37,60,FMN 12 Statielei
660,Statielei 26,2023-06-10,10:00:00,149,83,66,FMN 12 Statielei
660,Statielei 26,2023-06-10,11:00:00,147,83,64,FMN 12 Statielei
660,Statielei 26,2023-06-10,12:00:00,123,73,50,FMN 12 Statielei
660,Statielei 26,2023-06-10,13:00:00,118,71,47,FMN 12 Statielei
660,Statielei 26,2023-06-10,14:00:00,119,49,70,FMN 12 Statielei
660,Statielei 26,2023-06-10,15:00:00,117,49,68,FMN 12 Statielei
660,Statielei 26,2023-06-10,16:00:00,128,68,60,FMN 12 Statielei
660,Statielei 26,2023-06-10,17:00:00,128,69,59,FMN 12 Statielei
660,Statielei 26,2023-06-10,18:00:00,153,76,77,FMN 12 Statielei
660,Statielei 26,2023-06-10,19:00:00,134,60,74,FMN 12 Statielei
660,Statielei 26,2023-06-10,20:00:00,130,75,55,FMN 12 Statielei
660,Statielei 26,2023-06-10,21:00:00,120,42,78,FMN 12 Statielei
660,Statielei 26,2023-06-10,22:00:00,100,52,48,FMN 12 Statielei
660,Statielei 26,2023-06-10,23:00:00,108,52,56,FMN 12 Statielei
660,Statielei 26,2023-06-11,00:00:00,74,35,39,FMN 12 Statielei
660,Statielei 26,2023-06-11,01:00:00,40,13,27,FMN 12 Statielei
660,Statielei 26,2023-06-11,02:00:00,23,12,11,FMN 12 Statielei
660,Statielei 26,2023-06-11,03:00:00,9,3,6,FMN 12 Statielei
660,Statielei 26,2023-06-11,04:00:00,7,3,4,FMN 12 Statielei
660,Statielei 26,2023-06-11,05:00:00,15,6,9,FMN 12 Statielei
660,Statielei 26,2023-06-11,06:00:00,11,4,7,FMN 12 Statielei
660,Statielei 26,2023-06-11,07:00:00,26,12,14,FMN 12 Statielei
660,Statielei 26,2023-06-11,08:00:00,40,22,18,FMN 12 Statielei
660,Statielei 26,2023-06-11,09:00:00,98,39,59,FMN 12 Statielei
660,Statielei 26,2023-06-11,10:00:00,121,36,85,FMN 12 Statielei
660,Statielei 26,2023-06-11,11:00:00,101,52,49,FMN 12 Statielei
660,Statielei 26,2023-06-11,12:00:00,94,50,44,FMN 12 Statielei
660,Statielei 26,2023-06-11,13:00:00,123,57,66,FMN 12 Statielei
660,Statielei 26,2023-06-11,14:00:00,128,68,60,FMN 12 Statielei
660,Statielei 26,2023-06-11,15:00:00,144,67,77,FMN 12 Statielei
660,Statielei 26,2023-06-11,16:00:00,129,67,62,FMN 12 Statielei
660,Statielei 26,2023-06-11,17:00:00,141,90,51,FMN 12 Statielei
660,Statielei 26,2023-06-11,18:00:00,161,95,66,FMN 12 Statielei
660,Statielei 26,2023-06-11,19:00:00,116,62,54,FMN 12 Statielei
660,Statielei 26,2023-06-11,20:00:00,123,55,68,FMN 12 Statielei
660,Statielei 26,2023-06-11,21:00:00,103,51,52,FMN 12 Statielei
660,Statielei 26,2023-06-11,22:00:00,73,40,33,FMN 12 Statielei
660,Statielei 26,2023-06-11,23:00:00,53,21,32,FMN 12 Statielei
660,Statielei 26,2023-06-12,00:00:00,25,7,18,FMN 12 Statielei
660,Statielei 26,2023-06-12,01:00:00,17,7,10,FMN 12 Statielei
660,Statielei 26,2023-06-12,02:00:00,7,2,5,FMN 12 Statielei
660,Statielei 26,2023-06-12,03:00:00,5,2,3,FMN 12 Statielei
660,Statielei 26,2023-06-12,04:00:00,6,3,3,FMN 12 Statielei
660,Statielei 26,2023-06-12,05:00:00,22,9,13,FMN 12 Statielei
660,Statielei 26,2023-06-12,06:00:00,34,17,17,FMN 12 Statielei
660,Statielei 26,2023-06-12,07:00:00,166,75,91,FMN 12 Statielei
660,Statielei 26,2023-06-12,08:00:00,359,192,167,FMN 12 Statielei
660,Statielei 26,2023-06-12,09:00:00,140,90,50,FMN 12 Statielei
660,Statielei 26,2023-06-12,10:00:00,102,64,38,FMN 12 Statielei
660,Statielei 26,2023-06-12,11:00:00,102,48,54,FMN 12 Statielei
660,Statielei 26,2023-06-12,12:00:00,158,86,72,FMN 12 Statielei
660,Statielei 26,2023-06-12,13:00:00,115,56,59,FMN 12 Statielei
660,Statielei 26,2023-06-12,14:00:00,100,52,48,FMN 12 Statielei
660,Statielei 26,2023-06-12,15:00:00,174,78,96,FMN 12 Statielei
660,Statielei 26,2023-06-12,16:00:00,207,89,118,FMN 12 Statielei
660,Statielei 26,2023-06-12,17:00:00,238,108,130,FMN 12 Statielei
660,Statielei 26,2023-06-12,18:00:00,190,94,96,FMN 12 Statielei
660,Statielei 26,2023-06-12,19:00:00,123,58,65,FMN 12 Statielei
660,Statielei 26,2023-06-12,20:00:00,109,56,53,FMN 12 Statielei
660,Statielei 26,2023-06-12,21:00:00,118,64,54,FMN 12 Statielei
660,Statielei 26,2023-06-12,22:00:00,90,42,48,FMN 12 Statielei
660,Statielei 26,2023-06-12,23:00:00,60,20,40,FMN 12 Statielei
660,Statielei 26,2023-06-13,00:00:00,32,10,22,FMN 12 Statielei
660,Statielei 26,2023-06-13,01:00:00,8,4,4,FMN 12 Statielei
660,Statielei 26,2023-06-13,02:00:00,15,5,10,FMN 12 Statielei
660,Statielei 26,2023-06-13,03:00:00,6,4,2,FMN 12 Statielei
660,Statielei 26,2023-06-13,04:00:00,10,5,5,FMN 12 Statielei
660,Statielei 26,2023-06-13,05:00:00,20,10,10,FMN 12 Statielei
660,Statielei 26,2023-06-13,06:00:00,36,14,22,FMN 12 Statielei
660,Statielei 26,2023-06-13,07:00:00,168,80,88,FMN 12 Statielei
660,Statielei 26,2023-06-13,08:00:00,356,204,152,FMN 12 Statielei
660,Statielei 26,2023-06-13,09:00:00,130,86,44,FMN 12 Statielei
660,Statielei 26,2023-06-13,10:00:00,116,62,54,FMN 12 Statielei
660,Statielei 26,2023-06-13,11:00:00,91,54,37,FMN 12 Statielei
660,Statielei 26,2023-06-13,12:00:00,158,99,59,FMN 12 Statielei
660,Statielei 26,2023-06-13,13:00:00,107,62,45,FMN 12 Statielei
660,Statielei 26,2023-06-13,14:00:00,134,69,65,FMN 12 Statielei
660,Statielei 26,2023-06-13,15:00:00,198,81,117,FMN 12 Statielei
660,Statielei 26,2023-06-13,16:00:00,228,77,151,FMN 12 Statielei
660,Statielei 26,2023-06-13,17:00:00,255,114,141,FMN 12 Statielei
660,Statielei 26,2023-06-13,18:00:00,180,95,85,FMN 12 Statielei
660,Statielei 26,2023-06-13,19:00:00,151,76,75,FMN 12 Statielei
660,Statielei 26,2023-06-13,20:00:00,129,63,66,FMN 12 Statielei
660,Statielei 26,2023-06-13,21:00:00,118,60,58,FMN 12 Statielei
660,Statielei 26,2023-06-13,22:00:00,94,52,42,FMN 12 Statielei
660,Statielei 26,2023-06-13,23:00:00,69,24,45,FMN 12 Statielei
660,Statielei 26,2023-06-14,00:00:00,51,15,36,FMN 12 Statielei
660,Statielei 26,2023-06-14,01:00:00,11,3,8,FMN 12 Statielei
660,Statielei 26,2023-06-14,02:00:00,6,2,4,FMN 12 Statielei
660,Statielei 26,2023-06-14,03:00:00,7,4,3,FMN 12 Statielei
660,Statielei 26,2023-06-14,04:00:00,10,6,4,FMN 12 Statielei
660,Statielei 26,2023-06-14,05:00:00,22,11,11,FMN 12 Statielei
660,Statielei 26,2023-06-14,06:00:00,39,16,23,FMN 12 Statielei
660,Statielei 26,2023-06-14,07:00:00,148,73,75,FMN 12 Statielei
660,Statielei 26,2023-06-14,08:00:00,314,170,144,FMN 12 Statielei
660,Statielei 26,2023-06-14,09:00:00,139,79,60,FMN 12 Statielei
660,Statielei 26,2023-06-14,10:00:00,151,94,57,FMN 12 Statielei
660,Statielei 26,2023-06-14,11:00:00,125,70,55,FMN 12 Statielei
660,Statielei 26,2023-06-14,12:00:00,224,111,113,FMN 12 Statielei
660,Statielei 26,2023-06-14,13:00:00,140,76,64,FMN 12 Statielei
660,Statielei 26,2023-06-14,14:00:00,148,67,81,FMN 12 Statielei
660,Statielei 26,2023-06-14,15:00:00,137,59,78,FMN 12 Statielei
660,Statielei 26,2023-06-14,16:00:00,223,94,129,FMN 12 Statielei
660,Statielei 26,2023-06-14,17:00:00,254,120,134,FMN 12 Statielei
660,Statielei 26,2023-06-14,18:00:00,192,93,99,FMN 12 Statielei
660,Statielei 26,2023-06-14,19:00:00,166,85,81,FMN 12 Statielei
660,Statielei 26,2023-06-14,20:00:00,147,72,75,FMN 12 Statielei
660,Statielei 26,2023-06-14,21:00:00,136,72,64,FMN 12 Statielei
660,Statielei 26,2023-06-14,22:00:00,115,53,62,FMN 12 Statielei
660,Statielei 26,2023-06-14,23:00:00,108,45,63,FMN 12 Statielei
660,Statielei 26,2023-06-15,00:00:00,40,15,25,FMN 12 Statielei
660,Statielei 26,2023-06-15,01:00:00,16,7,9,FMN 12 Statielei
660,Statielei 26,2023-06-15,02:00:00,7,1,6,FMN 12 Statielei
660,Statielei 26,2023-06-15,03:00:00,9,6,3,FMN 12 Statielei
660,Statielei 26,2023-06-15,04:00:00,13,5,8,FMN 12 Statielei
660,Statielei 26,2023-06-15,05:00:00,28,11,17,FMN 12 Statielei
660,Statielei 26,2023-06-15,06:00:00,41,16,25,FMN 12 Statielei
660,Statielei 26,2023-06-15,07:00:00,168,74,94,FMN 12 Statielei
660,Statielei 26,2023-06-15,08:00:00,368,199,169,FMN 12 Statielei
660,Statielei 26,2023-06-15,09:00:00,154,98,56,FMN 12 Statielei
660,Statielei 26,2023-06-15,10:00:00,134,87,47,FMN 12 Statielei
660,Statielei 26,2023-06-15,11:00:00,103,65,38,FMN 12 Statielei
660,Statielei 26,2023-06-15,12:00:00,172,109,63,FMN 12 Statielei
660,Statielei 26,2023-06-15,13:00:00,109,57,52,FMN 12 Statielei
660,Statielei 26,2023-06-15,14:00:00,132,65,67,FMN 12 Statielei
660,Statielei 26,2023-06-15,15:00:00,190,87,103,FMN 12 Statielei
660,Statielei 26,2023-06-15,16:00:00,264,117,147,FMN 12 Statielei
660,Statielei 26,2023-06-15,17:00:00,263,105,158,FMN 12 Statielei
660,Statielei 26,2023-06-15,18:00:00,248,136,112,FMN 12 Statielei
660,Statielei 26,2023-06-15,19:00:00,184,87,97,FMN 12 Statielei
660,Statielei 26,2023-06-15,20:00:00,137,63,74,FMN 12 Statielei
660,Statielei 26,2023-06-15,21:00:00,120,58,62,FMN 12 Statielei
660,Statielei 26,2023-06-15,22:00:00,135,54,81,FMN 12 Statielei
660,Statielei 26,2023-06-15,23:00:00,81,40,41,FMN 12 Statielei
660,Statielei 26,2023-06-16,00:00:00,45,15,30,FMN 12 Statielei
660,Statielei 26,2023-06-16,01:00:00,15,8,7,FMN 12 Statielei
660,Statielei 26,2023-06-16,02:00:00,11,6,5,FMN 12 Statielei
660,Statielei 26,2023-06-16,03:00:00,11,5,6,FMN 12 Statielei
660,Statielei 26,2023-06-16,04:00:00,8,3,5,FMN 12 Statielei
660,Statielei 26,2023-06-16,05:00:00,22,11,11,FMN 12 Statielei
660,Statielei 26,2023-06-16,06:00:00,42,19,23,FMN 12 Statielei
660,Statielei 26,2023-06-16,07:00:00,143,63,80,FMN 12 Statielei
660,Statielei 26,2023-06-16,08:00:00,312,170,142,FMN 12 Statielei
660,Statielei 26,2023-06-16,09:00:00,118,80,38,FMN 12 Statielei
660,Statielei 26,2023-06-16,10:00:00,119,66,53,FMN 12 Statielei
660,Statielei 26,2023-06-16,11:00:00,108,67,41,FMN 12 Statielei
660,Statielei 26,2023-06-16,12:00:00,166,116,50,FMN 12 Statielei
660,Statielei 26,2023-06-16,13:00:00,126,64,62,FMN 12 Statielei
660,Statielei 26,2023-06-16,14:00:00,141,67,74,FMN 12 Statielei
660,Statielei 26,2023-06-16,15:00:00,194,77,117,FMN 12 Statielei
660,Statielei 26,2023-06-16,16:00:00,234,112,122,FMN 12 Statielei
660,Statielei 26,2023-06-16,17:00:00,216,100,116,FMN 12 Statielei
660,Statielei 26,2023-06-16,18:00:00,183,91,92,FMN 12 Statielei
660,Statielei 26,2023-06-16,19:00:00,205,87,118,FMN 12 Statielei
660,Statielei 26,2023-06-16,20:00:00,158,78,80,FMN 12 Statielei
660,Statielei 26,2023-06-16,21:00:00,151,70,81,FMN 12 Statielei
660,Statielei 26,2023-06-16,22:00:00,109,45,64,FMN 12 Statielei
660,Statielei 26,2023-06-16,23:00:00,150,74,76,FMN 12 Statielei
660,Statielei 26,2023-06-17,00:00:00,70,37,33,FMN 12 Statielei
660,Statielei 26,2023-06-17,01:00:00,41,20,21,FMN 12 Statielei
660,Statielei 26,2023-06-17,02:00:00,22,10,12,FMN 12 Statielei
660,Statielei 26,2023-06-17,03:00:00,24,3,21,FMN 12 Statielei
660,Statielei 26,2023-06-17,04:00:00,8,1,7,FMN 12 Statielei
660,Statielei 26,2023-06-17,05:00:00,14,8,6,FMN 12 Statielei
660,Statielei 26,2023-06-17,06:00:00,7,3,4,FMN 12 Statielei
660,Statielei 26,2023-06-17,07:00:00,34,15,19,FMN 12 Statielei
660,Statielei 26,2023-06-17,08:00:00,64,36,28,FMN 12 Statielei
660,Statielei 26,2023-06-17,09:00:00,100,55,45,FMN 12 Statielei
660,Statielei 26,2023-06-17,10:00:00,142,76,66,FMN 12 Statielei
660,Statielei 26,2023-06-17,11:00:00,143,73,70,FMN 12 Statielei
660,Statielei 26,2023-06-17,12:00:00,145,79,66,FMN 12 Statielei
660,Statielei 26,2023-06-17,13:00:00,153,79,74,FMN 12 Statielei
660,Statielei 26,2023-06-17,14:00:00,147,61,86,FMN 12 Statielei
660,Statielei 26,2023-06-17,15:00:00,147,70,77,FMN 12 Statielei
660,Statielei 26,2023-06-17,16:00:00,135,66,69,FMN 12 Statielei
660,Statielei 26,2023-06-17,17:00:00,158,91,67,FMN 12 Statielei
660,Statielei 26,2023-06-17,18:00:00,126,76,50,FMN 12 Statielei
660,Statielei 26,2023-06-17,19:00:00,130,79,51,FMN 12 Statielei
660,Statielei 26,2023-06-17,20:00:00,144,81,63,FMN 12 Statielei
660,Statielei 26,2023-06-17,21:00:00,100,48,52,FMN 12 Statielei
660,Statielei 26,2023-06-17,22:00:00,109,42,67,FMN 12 Statielei
660,Statielei 26,2023-06-17,23:00:00,67,32,35,FMN 12 Statielei
660,Statielei 26,2023-06-18,00:00:00,78,21,57,FMN 12 Statielei
660,Statielei 26,2023-06-18,01:00:00,42,13,29,FMN 12 Statielei
660,Statielei 26,2023-06-18,02:00:00,29,14,15,FMN 12 Statielei
660,Statielei 26,2023-06-18,03:00:00,19,10,9,FMN 12 Statielei
660,Statielei 26,2023-06-18,04:00:00,11,2,9,FMN 12 Statielei
660,Statielei 26,2023-06-18,05:00:00,11,3,8,FMN 12 Statielei
660,Statielei 26,2023-06-18,06:00:00,9,4,5,FMN 12 Statielei
660,Statielei 26,2023-06-18,07:00:00,19,7,12,FMN 12 Statielei
660,Statielei 26,2023-06-18,08:00:00,68,35,33,FMN 12 Statielei
660,Statielei 26,2023-06-18,09:00:00,90,30,60,FMN 12 Statielei
660,Statielei 26,2023-06-18,10:00:00,85,45,40,FMN 12 Statielei
660,Statielei 26,2023-06-18,11:00:00,87,39,48,FMN 12 Statielei
660,Statielei 26,2023-06-18,12:00:00,121,77,44,FMN 12 Statielei
660,Statielei 26,2023-06-18,13:00:00,104,53,51,FMN 12 Statielei
660,Statielei 26,2023-06-18,14:00:00,128,63,65,FMN 12 Statielei
660,Statielei 26,2023-06-18,15:00:00,133,70,63,FMN 12 Statielei
660,Statielei 26,2023-06-18,16:00:00,132,68,64,FMN 12 Statielei
660,Statielei 26,2023-06-18,17:00:00,133,68,65,FMN 12 Statielei
660,Statielei 26,2023-06-18,18:00:00,140,72,68,FMN 12 Statielei
660,Statielei 26,2023-06-18,19:00:00,141,61,80,FMN 12 Statielei
660,Statielei 26,2023-06-18,20:00:00,134,57,77,FMN 12 Statielei
660,Statielei 26,2023-06-18,21:00:00,83,34,49,FMN 12 Statielei
660,Statielei 26,2023-06-18,22:00:00,71,32,39,FMN 12 Statielei
660,Statielei 26,2023-06-18,23:00:00,61,39,22,FMN 12 Statielei
660,Statielei 26,2023-06-19,00:00:00,30,19,11,FMN 12 Statielei
660,Statielei 26,2023-06-19,01:00:00,15,7,8,FMN 12 Statielei
660,Statielei 26,2023-06-19,02:00:00,13,8,5,FMN 12 Statielei
660,Statielei 26,2023-06-19,03:00:00,8,5,3,FMN 12 Statielei
660,Statielei 26,2023-06-19,04:00:00,13,8,5,FMN 12 Statielei
660,Statielei 26,2023-06-19,05:00:00,20,12,8,FMN 12 Statielei
660,Statielei 26,2023-06-19,06:00:00,36,16,20,FMN 12 Statielei
660,Statielei 26,2023-06-19,07:00:00,136,57,79,FMN 12 Statielei
660,Statielei 26,2023-06-19,08:00:00,343,180,163,FMN 12 Statielei
660,Statielei 26,2023-06-19,09:00:00,155,103,52,FMN 12 Statielei
660,Statielei 26,2023-06-19,10:00:00,100,61,39,FMN 12 Statielei
660,Statielei 26,2023-06-19,11:00:00,85,51,34,FMN 12 Statielei
660,Statielei 26,2023-06-19,12:00:00,178,98,80,FMN 12 Statielei
660,Statielei 26,2023-06-19,13:00:00,110,53,57,FMN 12 Statielei
660,Statielei 26,2023-06-19,14:00:00,118,68,50,FMN 12 Statielei
660,Statielei 26,2023-06-19,15:00:00,184,74,110,FMN 12 Statielei
660,Statielei 26,2023-06-19,16:00:00,230,100,130,FMN 12 Statielei
660,Statielei 26,2023-06-19,17:00:00,233,105,128,FMN 12 Statielei
660,Statielei 26,2023-06-19,18:00:00,180,86,94,FMN 12 Statielei
660,Statielei 26,2023-06-19,19:00:00,136,72,64,FMN 12 Statielei
660,Statielei 26,2023-06-19,20:00:00,127,66,61,FMN 12 Statielei
660,Statielei 26,2023-06-19,21:00:00,108,58,50,FMN 12 Statielei
660,Statielei 26,2023-06-19,22:00:00,88,43,45,FMN 12 Statielei
660,Statielei 26,2023-06-19,23:00:00,55,32,23,FMN 12 Statielei
660,Statielei 26,2023-06-20,00:00:00,29,11,18,FMN 12 Statielei
660,Statielei 26,2023-06-20,01:00:00,9,3,6,FMN 12 Statielei
660,Statielei 26,2023-06-20,02:00:00,6,2,4,FMN 12 Statielei
660,Statielei 26,2023-06-20,03:00:00,6,2,4,FMN 12 Statielei
660,Statielei 26,2023-06-20,04:00:00,11,7,4,FMN 12 Statielei
660,Statielei 26,2023-06-20,05:00:00,17,9,8,FMN 12 Statielei
660,Statielei 26,2023-06-20,06:00:00,38,15,23,FMN 12 Statielei
660,Statielei 26,2023-06-20,07:00:00,155,62,93,FMN 12 Statielei
660,Statielei 26,2023-06-20,08:00:00,334,189,145,FMN 12 Statielei
660,Statielei 26,2023-06-20,09:00:00,150,93,57,FMN 12 Statielei
660,Statielei 26,2023-06-20,10:00:00,124,73,51,FMN 12 Statielei
660,Statielei 26,2023-06-20,11:00:00,111,55,56,FMN 12 Statielei
660,Statielei 26,2023-06-20,12:00:00,163,98,65,FMN 12 Statielei
660,Statielei 26,2023-06-20,13:00:00,133,69,64,FMN 12 Statielei
660,Statielei 26,2023-06-20,14:00:00,126,59,67,FMN 12 Statielei
660,Statielei 26,2023-06-20,15:00:00,204,92,112,FMN 12 Statielei
660,Statielei 26,2023-06-20,16:00:00,216,101,115,FMN 12 Statielei
660,Statielei 26,2023-06-20,17:00:00,225,104,121,FMN 12 Statielei
660,Statielei 26,2023-06-20,18:00:00,126,56,70,FMN 12 Statielei
660,Statielei 26,2023-06-20,19:00:00,79,36,43,FMN 12 Statielei
660,Statielei 26,2023-06-20,20:00:00,68,31,37,FMN 12 Statielei
660,Statielei 26,2023-06-20,21:00:00,53,23,30,FMN 12 Statielei
660,Statielei 26,2023-06-20,22:00:00,50,21,29,FMN 12 Statielei
660,Statielei 26,2023-06-20,23:00:00,45,17,28,FMN 12 Statielei
660,Statielei 26,2023-06-21,00:00:00,19,1,18,FMN 12 Statielei
660,Statielei 26,2023-06-21,01:00:00,13,5,8,FMN 12 Statielei
660,Statielei 26,2023-06-21,02:00:00,5,1,4,FMN 12 Statielei
660,Statielei 26,2023-06-21,03:00:00,6,2,4,FMN 12 Statielei
660,Statielei 26,2023-06-21,04:00:00,8,5,3,FMN 12 Statielei
660,Statielei 26,2023-06-21,05:00:00,13,6,7,FMN 12 Statielei
660,Statielei 26,2023-06-21,06:00:00,35,13,22,FMN 12 Statielei
660,Statielei 26,2023-06-21,07:00:00,142,51,91,FMN 12 Statielei
660,Statielei 26,2023-06-21,08:00:00,327,171,156,FMN 12 Statielei
660,Statielei 26,2023-06-21,09:00:00,124,83,41,FMN 12 Statielei
660,Statielei 26,2023-06-21,10:00:00,121,59,62,FMN 12 Statielei
660,Statielei 26,2023-06-21,11:00:00,130,64,66,FMN 12 Statielei
660,Statielei 26,2023-06-21,12:00:00,241,126,115,FMN 12 Statielei
660,Statielei 26,2023-06-21,13:00:00,169,88,81,FMN 12 Statielei
660,Statielei 26,2023-06-21,14:00:00,158,80,78,FMN 12 Statielei
660,Statielei 26,2023-06-21,15:00:00,173,84,89,FMN 12 Statielei
660,Statielei 26,2023-06-21,16:00:00,217,102,115,FMN 12 Statielei
660,Statielei 26,2023-06-21,17:00:00,242,114,128,FMN 12 Statielei
660,Statielei 26,2023-06-21,18:00:00,217,109,108,FMN 12 Statielei
660,Statielei 26,2023-06-21,19:00:00,213,103,110,FMN 12 Statielei
660,Statielei 26,2023-06-21,20:00:00,161,49,112,FMN 12 Statielei
660,Statielei 26,2023-06-21,21:00:00,127,54,73,FMN 12 Statielei
660,Statielei 26,2023-06-21,22:00:00,142,86,56,FMN 12 Statielei
660,Statielei 26,2023-06-21,23:00:00,76,44,32,FMN 12 Statielei
660,Statielei 26,2023-06-22,00:00:00,41,19,22,FMN 12 Statielei
660,Statielei 26,2023-06-22,01:00:00,15,9,6,FMN 12 Statielei
660,Statielei 26,2023-06-22,02:00:00,4,2,2,FMN 12 Statielei
660,Statielei 26,2023-06-22,03:00:00,7,3,4,FMN 12 Statielei
660,Statielei 26,2023-06-22,04:00:00,8,5,3,FMN 12 Statielei
660,Statielei 26,2023-06-22,05:00:00,13,7,6,FMN 12 Statielei
660,Statielei 26,2023-06-22,06:00:00,29,11,18,FMN 12 Statielei
660,Statielei 26,2023-06-22,07:00:00,141,58,83,FMN 12 Statielei
660,Statielei 26,2023-06-22,08:00:00,312,179,133,FMN 12 Statielei
660,Statielei 26,2023-06-22,09:00:00,130,76,54,FMN 12 Statielei
660,Statielei 26,2023-06-22,10:00:00,113,63,50,FMN 12 Statielei
660,Statielei 26,2023-06-22,11:00:00,112,59,53,FMN 12 Statielei
660,Statielei 26,2023-06-22,12:00:00,136,68,68,FMN 12 Statielei
660,Statielei 26,2023-06-22,13:00:00,67,33,34,FMN 12 Statielei
660,Statielei 26,2023-06-22,14:00:00,76,29,47,FMN 12 Statielei
660,Statielei 26,2023-06-22,15:00:00,119,46,73,FMN 12 Statielei
660,Statielei 26,2023-06-22,16:00:00,126,59,67,FMN 12 Statielei
660,Statielei 26,2023-06-22,17:00:00,153,68,85,FMN 12 Statielei
660,Statielei 26,2023-06-22,18:00:00,106,51,55,FMN 12 Statielei
660,Statielei 26,2023-06-22,19:00:00,104,51,53,FMN 12 Statielei
660,Statielei 26,2023-06-22,20:00:00,92,37,55,FMN 12 Statielei
660,Statielei 26,2023-06-22,21:00:00,79,44,35,FMN 12 Statielei
660,Statielei 26,2023-06-22,22:00:00,87,42,45,FMN 12 Statielei
660,Statielei 26,2023-06-22,23:00:00,66,41,25,FMN 12 Statielei
660,Statielei 26,2023-06-23,00:00:00,30,13,17,FMN 12 Statielei
660,Statielei 26,2023-06-23,01:00:00,12,8,4,FMN 12 Statielei
660,Statielei 26,2023-06-23,02:00:00,9,3,6,FMN 12 Statielei
660,Statielei 26,2023-06-23,03:00:00,7,6,1,FMN 12 Statielei
660,Statielei 26,2023-06-23,04:00:00,9,5,4,FMN 12 Statielei
660,Statielei 26,2023-06-23,05:00:00,19,8,11,FMN 12 Statielei
660,Statielei 26,2023-06-23,06:00:00,45,24,21,FMN 12 Statielei
660,Statielei 26,2023-06-23,07:00:00,119,45,74,FMN 12 Statielei
660,Statielei 26,2023-06-23,08:00:00,273,165,108,FMN 12 Statielei
660,Statielei 26,2023-06-23,09:00:00,125,78,47,FMN 12 Statielei
660,Statielei 26,2023-06-23,10:00:00,126,66,60,FMN 12 Statielei
660,Statielei 26,2023-06-23,11:00:00,115,58,57,FMN 12 Statielei
660,Statielei 26,2023-06-23,12:00:00,167,88,79,FMN 12 Statielei
660,Statielei 26,2023-06-23,13:00:00,158,84,74,FMN 12 Statielei
660,Statielei 26,2023-06-23,14:00:00,133,72,61,FMN 12 Statielei
660,Statielei 26,2023-06-23,15:00:00,202,100,102,FMN 12 Statielei
660,Statielei 26,2023-06-23,16:00:00,244,127,117,FMN 12 Statielei
660,Statielei 26,2023-06-23,17:00:00,243,103,140,FMN 12 Statielei
660,Statielei 26,2023-06-23,18:00:00,225,130,95,FMN 12 Statielei
660,Statielei 26,2023-06-23,19:00:00,153,82,71,FMN 12 Statielei
660,Statielei 26,2023-06-23,20:00:00,179,91,88,FMN 12 Statielei
660,Statielei 26,2023-06-23,21:00:00,140,67,73,FMN 12 Statielei
660,Statielei 26,2023-06-23,22:00:00,128,57,71,FMN 12 Statielei
660,Statielei 26,2023-06-23,23:00:00,104,38,66,FMN 12 Statielei
660,Statielei 26,2023-06-24,00:00:00,91,35,56,FMN 12 Statielei
660,Statielei 26,2023-06-24,01:00:00,109,65,44,FMN 12 Statielei
660,Statielei 26,2023-06-24,02:00:00,16,7,9,FMN 12 Statielei
660,Statielei 26,2023-06-24,03:00:00,24,15,9,FMN 12 Statielei
660,Statielei 26,2023-06-24,04:00:00,12,4,8,FMN 12 Statielei
660,Statielei 26,2023-06-24,05:00:00,11,4,7,FMN 12 Statielei
660,Statielei 26,2023-06-24,06:00:00,19,9,10,FMN 12 Statielei
660,Statielei 26,2023-06-24,07:00:00,33,17,16,FMN 12 Statielei
660,Statielei 26,2023-06-24,08:00:00,82,44,38,FMN 12 Statielei
660,Statielei 26,2023-06-24,09:00:00,122,61,61,FMN 12 Statielei
660,Statielei 26,2023-06-24,10:00:00,135,77,58,FMN 12 Statielei
660,Statielei 26,2023-06-24,11:00:00,147,93,54,FMN 12 Statielei
660,Statielei 26,2023-06-24,12:00:00,189,110,79,FMN 12 Statielei
660,Statielei 26,2023-06-24,13:00:00,192,116,76,FMN 12 Statielei
660,Statielei 26,2023-06-24,14:00:00,204,114,90,FMN 12 Statielei
660,Statielei 26,2023-06-24,15:00:00,204,112,92,FMN 12 Statielei
660,Statielei 26,2023-06-24,16:00:00,169,90,79,FMN 12 Statielei
660,Statielei 26,2023-06-24,17:00:00,169,85,84,FMN 12 Statielei
660,Statielei 26,2023-06-24,18:00:00,189,74,115,FMN 12 Statielei
660,Statielei 26,2023-06-24,19:00:00,190,96,94,FMN 12 Statielei
660,Statielei 26,2023-06-24,20:00:00,158,85,73,FMN 12 Statielei
660,Statielei 26,2023-06-24,21:00:00,137,70,67,FMN 12 Statielei
660,Statielei 26,2023-06-24,22:00:00,120,58,62,FMN 12 Statielei
660,Statielei 26,2023-06-24,23:00:00,113,40,73,FMN 12 Statielei
660,Statielei 26,2023-06-25,00:00:00,96,28,68,FMN 12 Statielei
660,Statielei 26,2023-06-25,01:00:00,56,17,39,FMN 12 Statielei
660,Statielei 26,2023-06-25,02:00:00,29,18,11,FMN 12 Statielei
660,Statielei 26,2023-06-25,03:00:00,30,7,23,FMN 12 Statielei
660,Statielei 26,2023-06-25,04:00:00,11,5,6,FMN 12 Statielei
660,Statielei 26,2023-06-25,05:00:00,8,2,6,FMN 12 Statielei
660,Statielei 26,2023-06-25,06:00:00,5,2,3,FMN 12 Statielei
660,Statielei 26,2023-06-25,07:00:00,22,8,14,FMN 12 Statielei
660,Statielei 26,2023-06-25,08:00:00,40,26,14,FMN 12 Statielei
660,Statielei 26,2023-06-25,09:00:00,85,37,48,FMN 12 Statielei
660,Statielei 26,2023-06-25,10:00:00,118,47,71,FMN 12 Statielei
660,Statielei 26,2023-06-25,11:00:00,146,68,78,FMN 12 Statielei
660,Statielei 26,2023-06-25,12:00:00,152,85,67,FMN 12 Statielei
660,Statielei 26,2023-06-25,13:00:00,146,87,59,FMN 12 Statielei
660,Statielei 26,2023-06-25,14:00:00,141,67,74,FMN 12 Statielei
660,Statielei 26,2023-06-25,15:00:00,124,65,59,FMN 12 Statielei
660,Statielei 26,2023-06-25,16:00:00,122,51,71,FMN 12 Statielei
660,Statielei 26,2023-06-25,17:00:00,141,77,64,FMN 12 Statielei
660,Statielei 26,2023-06-25,18:00:00,160,86,74,FMN 12 Statielei
660,Statielei 26,2023-06-25,19:00:00,137,64,73,FMN 12 Statielei
660,Statielei 26,2023-06-25,20:00:00,110,42,68,FMN 12 Statielei
660,Statielei 26,2023-06-25,21:00:00,98,55,43,FMN 12 Statielei
660,Statielei 26,2023-06-25,22:00:00,121,63,58,FMN 12 Statielei
660,Statielei 26,2023-06-25,23:00:00,90,56,34,FMN 12 Statielei
660,Statielei 26,2023-06-26,00:00:00,54,18,36,FMN 12 Statielei
660,Statielei 26,2023-06-26,01:00:00,34,13,21,FMN 12 Statielei
660,Statielei 26,2023-06-26,02:00:00,13,7,6,FMN 12 Statielei
660,Statielei 26,2023-06-26,03:00:00,3,2,1,FMN 12 Statielei
660,Statielei 26,2023-06-26,04:00:00,6,3,3,FMN 12 Statielei
660,Statielei 26,2023-06-26,05:00:00,19,10,9,FMN 12 Statielei
660,Statielei 26,2023-06-26,06:00:00,31,15,16,FMN 12 Statielei
660,Statielei 26,2023-06-26,07:00:00,116,55,61,FMN 12 Statielei
660,Statielei 26,2023-06-26,08:00:00,276,160,116,FMN 12 Statielei
660,Statielei 26,2023-06-26,09:00:00,148,90,58,FMN 12 Statielei
660,Statielei 26,2023-06-26,10:00:00,101,56,45,FMN 12 Statielei
660,Statielei 26,2023-06-26,11:00:00,97,56,41,FMN 12 Statielei
660,Statielei 26,2023-06-26,12:00:00,130,74,56,FMN 12 Statielei
660,Statielei 26,2023-06-26,13:00:00,123,56,67,FMN 12 Statielei
660,Statielei 26,2023-06-26,14:00:00,136,68,68,FMN 12 Statielei
660,Statielei 26,2023-06-26,15:00:00,202,77,125,FMN 12 Statielei
660,Statielei 26,2023-06-26,16:00:00,230,104,126,FMN 12 Statielei
660,Statielei 26,2023-06-26,17:00:00,235,113,122,FMN 12 Statielei
660,Statielei 26,2023-06-26,18:00:00,228,119,109,FMN 12 Statielei
660,Statielei 26,2023-06-26,19:00:00,166,69,97,FMN 12 Statielei
660,Statielei 26,2023-06-26,20:00:00,132,63,69,FMN 12 Statielei
660,Statielei 26,2023-06-26,21:00:00,107,57,50,FMN 12 Statielei
660,Statielei 26,2023-06-26,22:00:00,100,51,49,FMN 12 Statielei
660,Statielei 26,2023-06-26,23:00:00,66,34,32,FMN 12 Statielei
660,Statielei 26,2023-06-27,00:00:00,39,14,25,FMN 12 Statielei
660,Statielei 26,2023-06-27,01:00:00,14,4,10,FMN 12 Statielei
660,Statielei 26,2023-06-27,02:00:00,7,5,2,FMN 12 Statielei
660,Statielei 26,2023-06-27,03:00:00,8,4,4,FMN 12 Statielei
660,Statielei 26,2023-06-27,04:00:00,12,7,5,FMN 12 Statielei
660,Statielei 26,2023-06-27,05:00:00,20,12,8,FMN 12 Statielei
660,Statielei 26,2023-06-27,06:00:00,37,20,17,FMN 12 Statielei
660,Statielei 26,2023-06-27,07:00:00,123,62,61,FMN 12 Statielei
660,Statielei 26,2023-06-27,08:00:00,298,178,120,FMN 12 Statielei
660,Statielei 26,2023-06-27,09:00:00,148,92,56,FMN 12 Statielei
660,Statielei 26,2023-06-27,10:00:00,96,48,48,FMN 12 Statielei
660,Statielei 26,2023-06-27,11:00:00,115,63,52,FMN 12 Statielei
660,Statielei 26,2023-06-27,12:00:00,138,72,66,FMN 12 Statielei
660,Statielei 26,2023-06-27,13:00:00,119,66,53,FMN 12 Statielei
660,Statielei 26,2023-06-27,14:00:00,157,78,79,FMN 12 Statielei
660,Statielei 26,2023-06-27,15:00:00,206,89,117,FMN 12 Statielei
660,Statielei 26,2023-06-27,16:00:00,237,108,129,FMN 12 Statielei
660,Statielei 26,2023-06-27,17:00:00,232,105,127,FMN 12 Statielei
660,Statielei 26,2023-06-27,18:00:00,215,109,106,FMN 12 Statielei
660,Statielei 26,2023-06-27,19:00:00,150,80,70,FMN 12 Statielei
660,Statielei 26,2023-06-27,20:00:00,149,67,82,FMN 12 Statielei
660,Statielei 26,2023-06-27,21:00:00,111,40,71,FMN 12 Statielei
660,Statielei 26,2023-06-27,22:00:00,106,32,74,FMN 12 Statielei
660,Statielei 26,2023-06-27,23:00:00,98,42,56,FMN 12 Statielei
660,Statielei 26,2023-06-28,00:00:00,54,19,35,FMN 12 Statielei
660,Statielei 26,2023-06-28,01:00:00,19,8,11,FMN 12 Statielei
660,Statielei 26,2023-06-28,02:00:00,9,2,7,FMN 12 Statielei
660,Statielei 26,2023-06-28,03:00:00,8,3,5,FMN 12 Statielei
660,Statielei 26,2023-06-28,04:00:00,9,4,5,FMN 12 Statielei
660,Statielei 26,2023-06-28,05:00:00,21,13,8,FMN 12 Statielei
660,Statielei 26,2023-06-28,06:00:00,29,14,15,FMN 12 Statielei
660,Statielei 26,2023-06-28,07:00:00,108,54,54,FMN 12 Statielei
660,Statielei 26,2023-06-28,08:00:00,218,123,95,FMN 12 Statielei
660,Statielei 26,2023-06-28,09:00:00,142,82,60,FMN 12 Statielei
660,Statielei 26,2023-06-28,10:00:00,87,53,34,FMN 12 Statielei
660,Statielei 26,2023-06-28,11:00:00,116,60,56,FMN 12 Statielei
660,Statielei 26,2023-06-28,12:00:00,177,96,81,FMN 12 Statielei
660,Statielei 26,2023-06-28,13:00:00,189,80,109,FMN 12 Statielei
660,Statielei 26,2023-06-28,14:00:00,147,76,71,FMN 12 Statielei
660,Statielei 26,2023-06-28,15:00:00,184,84,100,FMN 12 Statielei
660,Statielei 26,2023-06-28,16:00:00,196,90,106,FMN 12 Statielei
660,Statielei 26,2023-06-28,17:00:00,255,128,127,FMN 12 Statielei
660,Statielei 26,2023-06-28,18:00:00,178,84,94,FMN 12 Statielei
660,Statielei 26,2023-06-28,19:00:00,155,94,61,FMN 12 Statielei
660,Statielei 26,2023-06-28,20:00:00,109,53,56,FMN 12 Statielei
660,Statielei 26,2023-06-28,21:00:00,102,48,54,FMN 12 Statielei
660,Statielei 26,2023-06-28,22:00:00,88,26,62,FMN 12 Statielei
660,Statielei 26,2023-06-28,23:00:00,84,31,53,FMN 12 Statielei
660,Statielei 26,2023-06-29,00:00:00,35,12,23,FMN 12 Statielei
660,Statielei 26,2023-06-29,01:00:00,22,8,14,FMN 12 Statielei
660,Statielei 26,2023-06-29,02:00:00,11,4,7,FMN 12 Statielei
660,Statielei 26,2023-06-29,03:00:00,6,2,4,FMN 12 Statielei
660,Statielei 26,2023-06-29,04:00:00,8,4,4,FMN 12 Statielei
660,Statielei 26,2023-06-29,05:00:00,22,13,9,FMN 12 Statielei
660,Statielei 26,2023-06-29,06:00:00,36,18,18,FMN 12 Statielei
660,Statielei 26,2023-06-29,07:00:00,114,58,56,FMN 12 Statielei
660,Statielei 26,2023-06-29,08:00:00,263,150,113,FMN 12 Statielei
660,Statielei 26,2023-06-29,09:00:00,133,95,38,FMN 12 Statielei
660,Statielei 26,2023-06-29,10:00:00,85,47,38,FMN 12 Statielei
660,Statielei 26,2023-06-29,11:00:00,110,52,58,FMN 12 Statielei
660,Statielei 26,2023-06-29,12:00:00,140,65,75,FMN 12 Statielei
660,Statielei 26,2023-06-29,13:00:00,118,64,54,FMN 12 Statielei
660,Statielei 26,2023-06-29,14:00:00,110,58,52,FMN 12 Statielei
660,Statielei 26,2023-06-29,15:00:00,191,73,118,FMN 12 Statielei
660,Statielei 26,2023-06-29,16:00:00,188,88,100,FMN 12 Statielei
660,Statielei 26,2023-06-29,17:00:00,202,94,108,FMN 12 Statielei
660,Statielei 26,2023-06-29,18:00:00,202,99,103,FMN 12 Statielei
660,Statielei 26,2023-06-29,19:00:00,178,82,96,FMN 12 Statielei
660,Statielei 26,2023-06-29,20:00:00,121,64,57,FMN 12 Statielei
660,Statielei 26,2023-06-29,21:00:00,100,50,50,FMN 12 Statielei
660,Statielei 26,2023-06-29,22:00:00,79,34,45,FMN 12 Statielei
660,Statielei 26,2023-06-29,23:00:00,76,41,35,FMN 12 Statielei
660,Statielei 26,2023-06-30,00:00:00,44,16,28,FMN 12 Statielei
660,Statielei 26,2023-06-30,01:00:00,19,10,9,FMN 12 Statielei
660,Statielei 26,2023-06-30,02:00:00,8,1,7,FMN 12 Statielei
660,Statielei 26,2023-06-30,03:00:00,5,3,2,FMN 12 Statielei
660,Statielei 26,2023-06-30,04:00:00,16,7,9,FMN 12 Statielei
660,Statielei 26,2023-06-30,05:00:00,26,14,12,FMN 12 Statielei
660,Statielei 26,2023-06-30,06:00:00,32,16,16,FMN 12 Statielei
660,Statielei 26,2023-06-30,07:00:00,102,48,54,FMN 12 Statielei
660,Statielei 26,2023-06-30,08:00:00,221,125,96,FMN 12 Statielei
660,Statielei 26,2023-06-30,09:00:00,147,85,62,FMN 12 Statielei
660,Statielei 26,2023-06-30,10:00:00,108,55,53,FMN 12 Statielei
660,Statielei 26,2023-06-30,11:00:00,151,85,66,FMN 12 Statielei
660,Statielei 26,2023-06-30,12:00:00,162,96,66,FMN 12 Statielei
660,Statielei 26,2023-06-30,13:00:00,179,92,87,FMN 12 Statielei
660,Statielei 26,2023-06-30,14:00:00,142,83,59,FMN 12 Statielei
660,Statielei 26,2023-06-30,15:00:00,189,73,116,FMN 12 Statielei
660,Statielei 26,2023-06-30,16:00:00,220,98,122,FMN 12 Statielei
660,Statielei 26,2023-06-30,17:00:00,201,81,120,FMN 12 Statielei
660,Statielei 26,2023-06-30,18:00:00,202,101,101,FMN 12 Statielei
660,Statielei 26,2023-06-30,19:00:00,146,59,87,FMN 12 Statielei
660,Statielei 26,2023-06-30,20:00:00,150,70,80,FMN 12 Statielei
660,Statielei 26,2023-06-30,21:00:00,121,53,68,FMN 12 Statielei
660,Statielei 26,2023-06-30,22:00:00,94,48,46,FMN 12 Statielei
660,Statielei 26,2023-06-30,23:00:00,80,43,37,FMN 12 Statielei
660,Statielei 26,2023-07-01,00:00:00,70,28,42,FMN 12 Statielei
660,Statielei 26,2023-07-01,01:00:00,38,11,27,FMN 12 Statielei
660,Statielei 26,2023-07-01,02:00:00,29,8,21,FMN 12 Statielei
660,Statielei 26,2023-07-01,03:00:00,11,3,8,FMN 12 Statielei
660,Statielei 26,2023-07-01,04:00:00,9,2,7,FMN 12 Statielei
660,Statielei 26,2023-07-01,05:00:00,10,7,3,FMN 12 Statielei
660,Statielei 26,2023-07-01,06:00:00,13,7,6,FMN 12 Statielei
660,Statielei 26,2023-07-01,07:00:00,29,8,21,FMN 12 Statielei
660,Statielei 26,2023-07-01,08:00:00,34,22,12,FMN 12 Statielei
660,Statielei 26,2023-07-01,09:00:00,51,24,27,FMN 12 Statielei
660,Statielei 26,2023-07-01,10:00:00,78,37,41,FMN 12 Statielei
660,Statielei 26,2023-07-01,11:00:00,67,39,28,FMN 12 Statielei
660,Statielei 26,2023-07-01,12:00:00,56,26,30,FMN 12 Statielei
660,Statielei 26,2023-07-01,13:00:00,104,61,43,FMN 12 Statielei
660,Statielei 26,2023-07-01,14:00:00,80,53,27,FMN 12 Statielei
660,Statielei 26,2023-07-01,15:00:00,100,44,56,FMN 12 Statielei
660,Statielei 26,2023-07-01,16:00:00,80,46,34,FMN 12 Statielei
660,Statielei 26,2023-07-01,17:00:00,113,57,56,FMN 12 Statielei
660,Statielei 26,2023-07-01,18:00:00,100,59,41,FMN 12 Statielei
660,Statielei 26,2023-07-01,19:00:00,111,53,58,FMN 12 Statielei
660,Statielei 26,2023-07-01,20:00:00,81,50,31,FMN 12 Statielei
660,Statielei 26,2023-07-01,21:00:00,94,51,43,FMN 12 Statielei
660,Statielei 26,2023-07-01,22:00:00,71,32,39,FMN 12 Statielei
660,Statielei 26,2023-07-01,23:00:00,67,25,42,FMN 12 Statielei
660,Statielei 26,2023-07-02,00:00:00,51,19,32,FMN 12 Statielei
660,Statielei 26,2023-07-02,01:00:00,23,12,11,FMN 12 Statielei
660,Statielei 26,2023-07-02,02:00:00,28,15,13,FMN 12 Statielei
660,Statielei 26,2023-07-02,03:00:00,15,6,9,FMN 12 Statielei
660,Statielei 26,2023-07-02,04:00:00,9,6,3,FMN 12 Statielei
660,Statielei 26,2023-07-02,05:00:00,8,5,3,FMN 12 Statielei
660,Statielei 26,2023-07-02,06:00:00,6,4,2,FMN 12 Statielei
660,Statielei 26,2023-07-02,07:00:00,20,8,12,FMN 12 Statielei
660,Statielei 26,2023-07-02,08:00:00,33,15,18,FMN 12 Statielei
660,Statielei 26,2023-07-02,09:00:00,67,35,32,FMN 12 Statielei
660,Statielei 26,2023-07-02,10:00:00,80,28,52,FMN 12 Statielei
660,Statielei 26,2023-07-02,11:00:00,84,45,39,FMN 12 Statielei
660,Statielei 26,2023-07-02,12:00:00,103,57,46,FMN 12 Statielei
660,Statielei 26,2023-07-02,13:00:00,118,67,51,FMN 12 Statielei
660,Statielei 26,2023-07-02,14:00:00,122,59,63,FMN 12 Statielei
660,Statielei 26,2023-07-02,15:00:00,149,75,74,FMN 12 Statielei
660,Statielei 26,2023-07-02,16:00:00,124,76,48,FMN 12 Statielei
660,Statielei 26,2023-07-02,17:00:00,121,64,57,FMN 12 Statielei
660,Statielei 26,2023-07-02,18:00:00,139,69,70,FMN 12 Statielei
660,Statielei 26,2023-07-02,19:00:00,116,56,60,FMN 12 Statielei
660,Statielei 26,2023-07-02,20:00:00,117,57,60,FMN 12 Statielei
660,Statielei 26,2023-07-02,21:00:00,97,52,45,FMN 12 Statielei
660,Statielei 26,2023-07-02,22:00:00,67,31,36,FMN 12 Statielei
660,Statielei 26,2023-07-02,23:00:00,37,15,22,FMN 12 Statielei
660,Statielei 26,2023-07-03,00:00:00,34,13,21,FMN 12 Statielei
660,Statielei 26,2023-07-03,01:00:00,14,8,6,FMN 12 Statielei
660,Statielei 26,2023-07-03,02:00:00,4,2,2,FMN 12 Statielei
660,Statielei 26,2023-07-03,03:00:00,6,1,5,FMN 12 Statielei
660,Statielei 26,2023-07-03,04:00:00,7,4,3,FMN 12 Statielei
660,Statielei 26,2023-07-03,05:00:00,19,11,8,FMN 12 Statielei
660,Statielei 26,2023-07-03,06:00:00,26,11,15,FMN 12 Statielei
660,Statielei 26,2023-07-03,07:00:00,81,43,38,FMN 12 Statielei
660,Statielei 26,2023-07-03,08:00:00,165,99,66,FMN 12 Statielei
660,Statielei 26,2023-07-03,09:00:00,99,57,42,FMN 12 Statielei
660,Statielei 26,2023-07-03,10:00:00,69,41,28,FMN 12 Statielei
660,Statielei 26,2023-07-03,11:00:00,66,26,40,FMN 12 Statielei
660,Statielei 26,2023-07-03,12:00:00,82,37,45,FMN 12 Statielei
660,Statielei 26,2023-07-03,13:00:00,87,42,45,FMN 12 Statielei
660,Statielei 26,2023-07-03,14:00:00,104,62,42,FMN 12 Statielei
660,Statielei 26,2023-07-03,15:00:00,117,47,70,FMN 12 Statielei
660,Statielei 26,2023-07-03,16:00:00,143,75,68,FMN 12 Statielei
660,Statielei 26,2023-07-03,17:00:00,180,91,89,FMN 12 Statielei
660,Statielei 26,2023-07-03,18:00:00,133,60,73,FMN 12 Statielei
660,Statielei 26,2023-07-03,19:00:00,116,60,56,FMN 12 Statielei
660,Statielei 26,2023-07-03,20:00:00,97,38,59,FMN 12 Statielei
660,Statielei 26,2023-07-03,21:00:00,81,42,39,FMN 12 Statielei
660,Statielei 26,2023-07-03,22:00:00,67,28,39,FMN 12 Statielei
660,Statielei 26,2023-07-03,23:00:00,32,11,21,FMN 12 Statielei
660,Statielei 26,2023-07-04,00:00:00,16,8,8,FMN 12 Statielei
660,Statielei 26,2023-07-04,01:00:00,12,4,8,FMN 12 Statielei
660,Statielei 26,2023-07-04,02:00:00,8,5,3,FMN 12 Statielei
660,Statielei 26,2023-07-04,03:00:00,7,4,3,FMN 12 Statielei
660,Statielei 26,2023-07-04,04:00:00,9,6,3,FMN 12 Statielei
660,Statielei 26,2023-07-04,05:00:00,15,8,7,FMN 12 Statielei
660,Statielei 26,2023-07-04,06:00:00,29,13,16,FMN 12 Statielei
660,Statielei 26,2023-07-04,07:00:00,80,36,44,FMN 12 Statielei
660,Statielei 26,2023-07-04,08:00:00,175,98,77,FMN 12 Statielei
660,Statielei 26,2023-07-04,09:00:00,142,90,52,FMN 12 Statielei
660,Statielei 26,2023-07-04,10:00:00,87,53,34,FMN 12 Statielei
660,Statielei 26,2023-07-04,11:00:00,91,40,51,FMN 12 Statielei
660,Statielei 26,2023-07-04,12:00:00,98,56,42,FMN 12 Statielei
660,Statielei 26,2023-07-04,13:00:00,122,69,53,FMN 12 Statielei
660,Statielei 26,2023-07-04,14:00:00,109,60,49,FMN 12 Statielei
660,Statielei 26,2023-07-04,15:00:00,142,57,85,FMN 12 Statielei
660,Statielei 26,2023-07-04,16:00:00,209,121,88,FMN 12 Statielei
660,Statielei 26,2023-07-04,17:00:00,197,94,103,FMN 12 Statielei
660,Statielei 26,2023-07-04,18:00:00,148,80,68,FMN 12 Statielei
660,Statielei 26,2023-07-04,19:00:00,105,38,67,FMN 12 Statielei
660,Statielei 26,2023-07-04,20:00:00,83,29,54,FMN 12 Statielei
660,Statielei 26,2023-07-04,21:00:00,76,34,42,FMN 12 Statielei
660,Statielei 26,2023-07-04,22:00:00,58,29,29,FMN 12 Statielei
660,Statielei 26,2023-07-04,23:00:00,64,31,33,FMN 12 Statielei
660,Statielei 26,2023-07-05,00:00:00,28,9,19,FMN 12 Statielei
660,Statielei 26,2023-07-05,01:00:00,14,5,9,FMN 12 Statielei
660,Statielei 26,2023-07-05,02:00:00,3,2,1,FMN 12 Statielei
660,Statielei 26,2023-07-05,03:00:00,7,4,3,FMN 12 Statielei
660,Statielei 26,2023-07-05,04:00:00,6,3,3,FMN 12 Statielei
660,Statielei 26,2023-07-05,05:00:00,16,8,8,FMN 12 Statielei
660,Statielei 26,2023-07-05,06:00:00,21,10,11,FMN 12 Statielei
660,Statielei 26,2023-07-05,07:00:00,65,32,33,FMN 12 Statielei
660,Statielei 26,2023-07-05,08:00:00,123,67,56,FMN 12 Statielei
660,Statielei 26,2023-07-05,09:00:00,97,58,39,FMN 12 Statielei
660,Statielei 26,2023-07-05,10:00:00,77,42,35,FMN 12 Statielei
660,Statielei 26,2023-07-05,11:00:00,65,31,34,FMN 12 Statielei
660,Statielei 26,2023-07-05,12:00:00,99,54,45,FMN 12 Statielei
660,Statielei 26,2023-07-05,13:00:00,94,53,41,FMN 12 Statielei
660,Statielei 26,2023-07-05,14:00:00,99,45,54,FMN 12 Statielei
660,Statielei 26,2023-07-05,15:00:00,123,58,65,FMN 12 Statielei
660,Statielei 26,2023-07-05,16:00:00,160,81,79,FMN 12 Statielei
660,Statielei 26,2023-07-05,17:00:00,161,71,90,FMN 12 Statielei
660,Statielei 26,2023-07-05,18:00:00,127,58,69,FMN 12 Statielei
660,Statielei 26,2023-07-05,19:00:00,92,49,43,FMN 12 Statielei
660,Statielei 26,2023-07-05,20:00:00,69,37,32,FMN 12 Statielei
660,Statielei 26,2023-07-05,21:00:00,72,31,41,FMN 12 Statielei
660,Statielei 26,2023-07-05,22:00:00,50,18,32,FMN 12 Statielei
660,Statielei 26,2023-07-05,23:00:00,42,16,26,FMN 12 Statielei
660,Statielei 26,2023-07-06,00:00:00,23,8,15,FMN 12 Statielei
660,Statielei 26,2023-07-06,01:00:00,14,3,11,FMN 12 Statielei
660,Statielei 26,2023-07-06,02:00:00,11,2,9,FMN 12 Statielei
660,Statielei 26,2023-07-06,03:00:00,4,3,1,FMN 12 Statielei
660,Statielei 26,2023-07-06,04:00:00,7,6,1,FMN 12 Statielei
660,Statielei 26,2023-07-06,05:00:00,17,7,10,FMN 12 Statielei
660,Statielei 26,2023-07-06,06:00:00,26,13,13,FMN 12 Statielei
660,Statielei 26,2023-07-06,07:00:00,87,38,49,FMN 12 Statielei
660,Statielei 26,2023-07-06,08:00:00,177,100,77,FMN 12 Statielei
660,Statielei 26,2023-07-06,09:00:00,111,69,42,FMN 12 Statielei
660,Statielei 26,2023-07-06,10:00:00,105,63,42,FMN 12 Statielei
660,Statielei 26,2023-07-06,11:00:00,105,54,51,FMN 12 Statielei
660,Statielei 26,2023-07-06,12:00:00,102,56,46,FMN 12 Statielei
660,Statielei 26,2023-07-06,13:00:00,119,58,61,FMN 12 Statielei
660,Statielei 26,2023-07-06,14:00:00,100,39,61,FMN 12 Statielei
660,Statielei 26,2023-07-06,15:00:00,116,51,65,FMN 12 Statielei
660,Statielei 26,2023-07-06,16:00:00,191,109,82,FMN 12 Statielei
660,Statielei 26,2023-07-06,17:00:00,173,91,82,FMN 12 Statielei
660,Statielei 26,2023-07-06,18:00:00,151,70,81,FMN 12 Statielei
660,Statielei 26,2023-07-06,19:00:00,118,55,63,FMN 12 Statielei
660,Statielei 26,2023-07-06,20:00:00,131,76,55,FMN 12 Statielei
660,Statielei 26,2023-07-06,21:00:00,103,63,40,FMN 12 Statielei
660,Statielei 26,2023-07-06,22:00:00,70,25,45,FMN 12 Statielei
660,Statielei 26,2023-07-06,23:00:00,91,37,54,FMN 12 Statielei
660,Statielei 26,2023-07-07,00:00:00,46,13,33,FMN 12 Statielei
660,Statielei 26,2023-07-07,01:00:00,15,5,10,FMN 12 Statielei
660,Statielei 26,2023-07-07,02:00:00,9,5,4,FMN 12 Statielei
660,Statielei 26,2023-07-07,03:00:00,8,6,2,FMN 12 Statielei
660,Statielei 26,2023-07-07,04:00:00,10,5,5,FMN 12 Statielei
660,Statielei 26,2023-07-07,05:00:00,22,12,10,FMN 12 Statielei
660,Statielei 26,2023-07-07,06:00:00,29,16,13,FMN 12 Statielei
660,Statielei 26,2023-07-07,07:00:00,71,32,39,FMN 12 Statielei
660,Statielei 26,2023-07-07,08:00:00,136,73,63,FMN 12 Statielei
660,Statielei 26,2023-07-07,09:00:00,102,65,37,FMN 12 Statielei
660,Statielei 26,2023-07-07,10:00:00,85,57,28,FMN 12 Statielei
660,Statielei 26,2023-07-07,11:00:00,97,51,46,FMN 12 Statielei
660,Statielei 26,2023-07-07,12:00:00,115,61,54,FMN 12 Statielei
660,Statielei 26,2023-07-07,13:00:00,122,61,61,FMN 12 Statielei
660,Statielei 26,2023-07-07,14:00:00,108,56,52,FMN 12 Statielei
660,Statielei 26,2023-07-07,15:00:00,132,61,71,FMN 12 Statielei
660,Statielei 26,2023-07-07,16:00:00,169,91,78,FMN 12 Statielei
660,Statielei 26,2023-07-07,17:00:00,171,94,77,FMN 12 Statielei
660,Statielei 26,2023-07-07,18:00:00,163,84,79,FMN 12 Statielei
660,Statielei 26,2023-07-07,19:00:00,150,66,84,FMN 12 Statielei
660,Statielei 26,2023-07-07,20:00:00,116,65,51,FMN 12 Statielei
660,Statielei 26,2023-07-07,21:00:00,148,88,60,FMN 12 Statielei
660,Statielei 26,2023-07-07,22:00:00,113,47,66,FMN 12 Statielei
660,Statielei 26,2023-07-07,23:00:00,96,52,44,FMN 12 Statielei
660,Statielei 26,2023-07-08,00:00:00,62,28,34,FMN 12 Statielei
660,Statielei 26,2023-07-08,01:00:00,40,20,20,FMN 12 Statielei
660,Statielei 26,2023-07-08,02:00:00,23,11,12,FMN 12 Statielei
660,Statielei 26,2023-07-08,03:00:00,14,6,8,FMN 12 Statielei
660,Statielei 26,2023-07-08,04:00:00,13,3,10,FMN 12 Statielei
660,Statielei 26,2023-07-08,05:00:00,13,4,9,FMN 12 Statielei
660,Statielei 26,2023-07-08,06:00:00,10,6,4,FMN 12 Statielei
660,Statielei 26,2023-07-08,07:00:00,31,11,20,FMN 12 Statielei
660,Statielei 26,2023-07-08,08:00:00,62,32,30,FMN 12 Statielei
660,Statielei 26,2023-07-08,09:00:00,92,50,42,FMN 12 Statielei
660,Statielei 26,2023-07-08,10:00:00,91,49,42,FMN 12 Statielei
660,Statielei 26,2023-07-08,11:00:00,106,55,51,FMN 12 Statielei
660,Statielei 26,2023-07-08,12:00:00,92,51,41,FMN 12 Statielei
660,Statielei 26,2023-07-08,13:00:00,99,54,45,FMN 12 Statielei
660,Statielei 26,2023-07-08,14:00:00,101,43,58,FMN 12 Statielei
660,Statielei 26,2023-07-08,15:00:00,131,60,71,FMN 12 Statielei
660,Statielei 26,2023-07-08,16:00:00,86,50,36,FMN 12 Statielei
660,Statielei 26,2023-07-08,17:00:00,90,43,47,FMN 12 Statielei
660,Statielei 26,2023-07-08,18:00:00,111,54,57,FMN 12 Statielei
660,Statielei 26,2023-07-08,19:00:00,109,43,66,FMN 12 Statielei
660,Statielei 26,2023-07-08,20:00:00,91,63,28,FMN 12 Statielei
660,Statielei 26,2023-07-08,21:00:00,100,48,52,FMN 12 Statielei
660,Statielei 26,2023-07-08,22:00:00,88,62,26,FMN 12 Statielei
660,Statielei 26,2023-07-08,23:00:00,66,28,38,FMN 12 Statielei
660,Statielei 26,2023-07-09,00:00:00,55,33,22,FMN 12 Statielei
660,Statielei 26,2023-07-09,01:00:00,47,16,31,FMN 12 Statielei
660,Statielei 26,2023-07-09,02:00:00,25,11,14,FMN 12 Statielei
660,Statielei 26,2023-07-09,03:00:00,8,3,5,FMN 12 Statielei
660,Statielei 26,2023-07-09,04:00:00,6,0,6,FMN 12 Statielei
660,Statielei 26,2023-07-09,05:00:00,4,3,1,FMN 12 Statielei
660,Statielei 26,2023-07-09,06:00:00,11,6,5,FMN 12 Statielei
660,Statielei 26,2023-07-09,07:00:00,15,6,9,FMN 12 Statielei
660,Statielei 26,2023-07-09,08:00:00,23,11,12,FMN 12 Statielei
660,Statielei 26,2023-07-09,09:00:00,60,28,32,FMN 12 Statielei
660,Statielei 26,2023-07-09,10:00:00,68,22,46,FMN 12 Statielei
660,Statielei 26,2023-07-09,11:00:00,85,47,38,FMN 12 Statielei
660,Statielei 26,2023-07-09,12:00:00,95,62,33,FMN 12 Statielei
660,Statielei 26,2023-07-09,13:00:00,105,58,47,FMN 12 Statielei
660,Statielei 26,2023-07-09,14:00:00,93,55,38,FMN 12 Statielei
660,Statielei 26,2023-07-09,15:00:00,33,19,14,FMN 12 Statielei
660,Statielei 26,2023-07-09,16:00:00,64,36,28,FMN 12 Statielei
660,Statielei 26,2023-07-09,17:00:00,109,53,56,FMN 12 Statielei
660,Statielei 26,2023-07-09,18:00:00,94,56,38,FMN 12 Statielei
660,Statielei 26,2023-07-09,19:00:00,73,37,36,FMN 12 Statielei
660,Statielei 26,2023-07-09,20:00:00,80,32,48,FMN 12 Statielei
660,Statielei 26,2023-07-09,21:00:00,81,40,41,FMN 12 Statielei
660,Statielei 26,2023-07-09,22:00:00,62,36,26,FMN 12 Statielei
660,Statielei 26,2023-07-09,23:00:00,30,13,17,FMN 12 Statielei
660,Statielei 26,2023-07-10,00:00:00,19,8,11,FMN 12 Statielei
660,Statielei 26,2023-07-10,01:00:00,11,5,6,FMN 12 Statielei
660,Statielei 26,2023-07-10,02:00:00,9,3,6,FMN 12 Statielei
660,Statielei 26,2023-07-10,03:00:00,8,3,5,FMN 12 Statielei
660,Statielei 26,2023-07-10,04:00:00,9,7,2,FMN 12 Statielei
660,Statielei 26,2023-07-10,05:00:00,18,10,8,FMN 12 Statielei
660,Statielei 26,2023-07-10,06:00:00,25,12,13,FMN 12 Statielei
660,Statielei 26,2023-07-10,07:00:00,67,32,35,FMN 12 Statielei
660,Statielei 26,2023-07-10,08:00:00,117,59,58,FMN 12 Statielei
660,Statielei 26,2023-07-10,09:00:00,86,58,28,FMN 12 Statielei
660,Statielei 26,2023-07-10,10:00:00,83,45,38,FMN 12 Statielei
660,Statielei 26,2023-07-10,11:00:00,88,51,37,FMN 12 Statielei
660,Statielei 26,2023-07-10,12:00:00,82,49,33,FMN 12 Statielei
660,Statielei 26,2023-07-10,13:00:00,87,42,45,FMN 12 Statielei
660,Statielei 26,2023-07-10,14:00:00,125,71,54,FMN 12 Statielei
660,Statielei 26,2023-07-10,15:00:00,102,46,56,FMN 12 Statielei
660,Statielei 26,2023-07-10,16:00:00,134,71,63,FMN 12 Statielei
660,Statielei 26,2023-07-10,17:00:00,172,81,91,FMN 12 Statielei
660,Statielei 26,2023-07-10,18:00:00,165,82,83,FMN 12 Statielei
660,Statielei 26,2023-07-10,19:00:00,135,50,85,FMN 12 Statielei
660,Statielei 26,2023-07-10,20:00:00,100,33,67,FMN 12 Statielei
660,Statielei 26,2023-07-10,21:00:00,82,40,42,FMN 12 Statielei
660,Statielei 26,2023-07-10,22:00:00,104,73,31,FMN 12 Statielei
660,Statielei 26,2023-07-10,23:00:00,54,31,23,FMN 12 Statielei
660,Statielei 26,2023-07-11,00:00:00,47,25,22,FMN 12 Statielei
660,Statielei 26,2023-07-11,01:00:00,14,5,9,FMN 12 Statielei
660,Statielei 26,2023-07-11,02:00:00,10,3,7,FMN 12 Statielei
660,Statielei 26,2023-07-11,03:00:00,5,1,4,FMN 12 Statielei
660,Statielei 26,2023-07-11,04:00:00,18,12,6,FMN 12 Statielei
660,Statielei 26,2023-07-11,05:00:00,15,7,8,FMN 12 Statielei
660,Statielei 26,2023-07-11,06:00:00,28,16,12,FMN 12 Statielei
660,Statielei 26,2023-07-11,07:00:00,62,26,36,FMN 12 Statielei
660,Statielei 26,2023-07-11,08:00:00,83,40,43,FMN 12 Statielei
660,Statielei 26,2023-07-11,09:00:00,78,45,33,FMN 12 Statielei
660,Statielei 26,2023-07-11,10:00:00,74,39,35,FMN 12 Statielei
660,Statielei 26,2023-07-11,11:00:00,104,54,50,FMN 12 Statielei
660,Statielei 26,2023-07-11,12:00:00,92,50,42,FMN 12 Statielei
660,Statielei 26,2023-07-11,13:00:00,90,39,51,FMN 12 Statielei
660,Statielei 26,2023-07-11,14:00:00,85,39,46,FMN 12 Statielei
660,Statielei 26,2023-07-11,15:00:00,109,52,57,FMN 12 Statielei
660,Statielei 26,2023-07-11,16:00:00,152,71,81,FMN 12 Statielei
660,Statielei 26,2023-07-11,17:00:00,167,85,82,FMN 12 Statielei
660,Statielei 26,2023-07-11,18:00:00,143,77,66,FMN 12 Statielei
660,Statielei 26,2023-07-11,19:00:00,144,78,66,FMN 12 Statielei
660,Statielei 26,2023-07-11,20:00:00,100,52,48,FMN 12 Statielei
660,Statielei 26,2023-07-11,21:00:00,78,48,30,FMN 12 Statielei
660,Statielei 26,2023-07-11,22:00:00,80,28,52,FMN 12 Statielei
660,Statielei 26,2023-07-11,23:00:00,46,13,33,FMN 12 Statielei
660,Statielei 26,2023-07-12,00:00:00,28,8,20,FMN 12 Statielei
660,Statielei 26,2023-07-12,01:00:00,22,10,12,FMN 12 Statielei
660,Statielei 26,2023-07-12,02:00:00,10,3,7,FMN 12 Statielei
660,Statielei 26,2023-07-12,03:00:00,6,3,3,FMN 12 Statielei
660,Statielei 26,2023-07-12,04:00:00,13,5,8,FMN 12 Statielei
660,Statielei 26,2023-07-12,05:00:00,16,8,8,FMN 12 Statielei
660,Statielei 26,2023-07-12,06:00:00,26,14,12,FMN 12 Statielei
660,Statielei 26,2023-07-12,07:00:00,61,32,29,FMN 12 Statielei
660,Statielei 26,2023-07-12,08:00:00,130,68,62,FMN 12 Statielei
660,Statielei 26,2023-07-12,09:00:00,96,59,37,FMN 12 Statielei
660,Statielei 26,2023-07-12,10:00:00,71,44,27,FMN 12 Statielei
660,Statielei 26,2023-07-12,11:00:00,71,46,25,FMN 12 Statielei
660,Statielei 26,2023-07-12,12:00:00,96,51,45,FMN 12 Statielei
660,Statielei 26,2023-07-12,13:00:00,89,53,36,FMN 12 Statielei
660,Statielei 26,2023-07-12,14:00:00,95,46,49,FMN 12 Statielei
660,Statielei 26,2023-07-12,15:00:00,118,57,61,FMN 12 Statielei
660,Statielei 26,2023-07-12,16:00:00,162,90,72,FMN 12 Statielei
660,Statielei 26,2023-07-12,17:00:00,137,59,78,FMN 12 Statielei
660,Statielei 26,2023-07-12,18:00:00,152,83,69,FMN 12 Statielei
660,Statielei 26,2023-07-12,19:00:00,135,83,52,FMN 12 Statielei
660,Statielei 26,2023-07-12,20:00:00,87,47,40,FMN 12 Statielei
660,Statielei 26,2023-07-12,21:00:00,91,44,47,FMN 12 Statielei
660,Statielei 26,2023-07-12,22:00:00,70,28,42,FMN 12 Statielei
660,Statielei 26,2023-07-12,23:00:00,52,22,30,FMN 12 Statielei
660,Statielei 26,2023-07-13,00:00:00,25,4,21,FMN 12 Statielei
660,Statielei 26,2023-07-13,01:00:00,20,10,10,FMN 12 Statielei
660,Statielei 26,2023-07-13,02:00:00,7,5,2,FMN 12 Statielei
660,Statielei 26,2023-07-13,03:00:00,12,2,10,FMN 12 Statielei
660,Statielei 26,2023-07-13,04:00:00,7,4,3,FMN 12 Statielei
660,Statielei 26,2023-07-13,05:00:00,22,10,12,FMN 12 Statielei
660,Statielei 26,2023-07-13,06:00:00,27,13,14,FMN 12 Statielei
660,Statielei 26,2023-07-13,07:00:00,75,38,37,FMN 12 Statielei
660,Statielei 26,2023-07-13,08:00:00,131,73,58,FMN 12 Statielei
660,Statielei 26,2023-07-13,09:00:00,107,63,44,FMN 12 Statielei
660,Statielei 26,2023-07-13,10:00:00,81,44,37,FMN 12 Statielei
660,Statielei 26,2023-07-13,11:00:00,75,33,42,FMN 12 Statielei
660,Statielei 26,2023-07-13,12:00:00,90,50,40,FMN 12 Statielei
660,Statielei 26,2023-07-13,13:00:00,66,38,28,FMN 12 Statielei
660,Statielei 26,2023-07-13,14:00:00,79,41,38,FMN 12 Statielei
660,Statielei 26,2023-07-13,15:00:00,96,44,52,FMN 12 Statielei
660,Statielei 26,2023-07-13,16:00:00,169,79,90,FMN 12 Statielei
660,Statielei 26,2023-07-13,17:00:00,152,84,68,FMN 12 Statielei
660,Statielei 26,2023-07-13,18:00:00,155,79,76,FMN 12 Statielei
660,Statielei 26,2023-07-13,19:00:00,134,57,77,FMN 12 Statielei
660,Statielei 26,2023-07-13,20:00:00,135,66,69,FMN 12 Statielei
660,Statielei 26,2023-07-13,21:00:00,76,46,30,FMN 12 Statielei
660,Statielei 26,2023-07-13,22:00:00,65,25,40,FMN 12 Statielei
660,Statielei 26,2023-07-13,23:00:00,88,54,34,FMN 12 Statielei
660,Statielei 26,2023-07-14,00:00:00,48,12,36,FMN 12 Statielei
660,Statielei 26,2023-07-14,01:00:00,26,18,8,FMN 12 Statielei
660,Statielei 26,2023-07-14,02:00:00,12,7,5,FMN 12 Statielei
660,Statielei 26,2023-07-14,03:00:00,5,2,3,FMN 12 Statielei
660,Statielei 26,2023-07-14,04:00:00,6,5,1,FMN 12 Statielei
660,Statielei 26,2023-07-14,05:00:00,24,13,11,FMN 12 Statielei
660,Statielei 26,2023-07-14,06:00:00,30,13,17,FMN 12 Statielei
660,Statielei 26,2023-07-14,07:00:00,68,28,40,FMN 12 Statielei
660,Statielei 26,2023-07-14,08:00:00,109,62,47,FMN 12 Statielei
660,Statielei 26,2023-07-14,09:00:00,99,65,34,FMN 12 Statielei
660,Statielei 26,2023-07-14,10:00:00,93,62,31,FMN 12 Statielei
660,Statielei 26,2023-07-14,11:00:00,75,36,39,FMN 12 Statielei
660,Statielei 26,2023-07-14,12:00:00,120,62,58,FMN 12 Statielei
660,Statielei 26,2023-07-14,13:00:00,101,46,55,FMN 12 Statielei
660,Statielei 26,2023-07-14,14:00:00,98,57,41,FMN 12 Statielei
660,Statielei 26,2023-07-14,15:00:00,119,62,57,FMN 12 Statielei
660,Statielei 26,2023-07-14,16:00:00,175,82,93,FMN 12 Statielei
660,Statielei 26,2023-07-14,17:00:00,132,75,57,FMN 12 Statielei
660,Statielei 26,2023-07-14,18:00:00,143,71,72,FMN 12 Statielei
660,Statielei 26,2023-07-14,19:00:00,107,44,63,FMN 12 Statielei
660,Statielei 26,2023-07-14,20:00:00,78,44,34,FMN 12 Statielei
660,Statielei 26,2023-07-14,21:00:00,96,44,52,FMN 12 Statielei
660,Statielei 26,2023-07-14,22:00:00,89,48,41,FMN 12 Statielei
660,Statielei 26,2023-07-14,23:00:00,46,21,25,FMN 12 Statielei
660,Statielei 26,2023-07-15,00:00:00,38,12,26,FMN 12 Statielei
660,Statielei 26,2023-07-15,01:00:00,38,9,29,FMN 12 Statielei
660,Statielei 26,2023-07-15,02:00:00,22,12,10,FMN 12 Statielei
660,Statielei 26,2023-07-15,03:00:00,13,6,7,FMN 12 Statielei
660,Statielei 26,2023-07-15,04:00:00,14,8,6,FMN 12 Statielei
660,Statielei 26,2023-07-15,05:00:00,22,7,15,FMN 12 Statielei
660,Statielei 26,2023-07-15,06:00:00,6,2,4,FMN 12 Statielei
660,Statielei 26,2023-07-15,07:00:00,25,12,13,FMN 12 Statielei
660,Statielei 26,2023-07-15,08:00:00,37,17,20,FMN 12 Statielei
660,Statielei 26,2023-07-15,09:00:00,63,32,31,FMN 12 Statielei
660,Statielei 26,2023-07-15,10:00:00,97,51,46,FMN 12 Statielei
660,Statielei 26,2023-07-15,11:00:00,90,55,35,FMN 12 Statielei
660,Statielei 26,2023-07-15,12:00:00,98,48,50,FMN 12 Statielei
660,Statielei 26,2023-07-15,13:00:00,90,43,47,FMN 12 Statielei
660,Statielei 26,2023-07-15,14:00:00,90,46,44,FMN 12 Statielei
660,Statielei 26,2023-07-15,15:00:00,106,56,50,FMN 12 Statielei
660,Statielei 26,2023-07-15,16:00:00,129,48,81,FMN 12 Statielei
660,Statielei 26,2023-07-15,17:00:00,129,39,90,FMN 12 Statielei
660,Statielei 26,2023-07-15,18:00:00,122,65,57,FMN 12 Statielei
660,Statielei 26,2023-07-15,19:00:00,98,49,49,FMN 12 Statielei
660,Statielei 26,2023-07-15,20:00:00,89,43,46,FMN 12 Statielei
660,Statielei 26,2023-07-15,21:00:00,73,39,34,FMN 12 Statielei
660,Statielei 26,2023-07-15,22:00:00,91,38,53,FMN 12 Statielei
660,Statielei 26,2023-07-15,23:00:00,59,35,24,FMN 12 Statielei
660,Statielei 26,2023-07-16,00:00:00,66,34,32,FMN 12 Statielei
660,Statielei 26,2023-07-16,01:00:00,29,8,21,FMN 12 Statielei
660,Statielei 26,2023-07-16,02:00:00,34,17,17,FMN 12 Statielei
660,Statielei 26,2023-07-16,03:00:00,13,5,8,FMN 12 Statielei
660,Statielei 26,2023-07-16,04:00:00,20,4,16,FMN 12 Statielei
660,Statielei 26,2023-07-16,05:00:00,7,4,3,FMN 12 Statielei
660,Statielei 26,2023-07-16,06:00:00,21,18,3,FMN 12 Statielei
660,Statielei 26,2023-07-16,07:00:00,13,9,4,FMN 12 Statielei
660,Statielei 26,2023-07-16,08:00:00,36,19,17,FMN 12 Statielei
660,Statielei 26,2023-07-16,09:00:00,55,26,29,FMN 12 Statielei
660,Statielei 26,2023-07-16,10:00:00,65,38,27,FMN 12 Statielei
660,Statielei 26,2023-07-16,11:00:00,83,46,37,FMN 12 Statielei
660,Statielei 26,2023-07-16,12:00:00,55,26,29,FMN 12 Statielei
660,Statielei 26,2023-07-16,13:00:00,68,32,36,FMN 12 Statielei
660,Statielei 26,2023-07-16,14:00:00,93,54,39,FMN 12 Statielei
660,Statielei 26,2023-07-16,15:00:00,100,55,45,FMN 12 Statielei
660,Statielei 26,2023-07-16,16:00:00,97,56,41,FMN 12 Statielei
660,Statielei 26,2023-07-16,17:00:00,106,54,52,FMN 12 Statielei
660,Statielei 26,2023-07-16,18:00:00,100,57,43,FMN 12 Statielei
660,Statielei 26,2023-07-16,19:00:00,88,44,44,FMN 12 Statielei
660,Statielei 26,2023-07-16,20:00:00,58,32,26,FMN 12 Statielei
660,Statielei 26,2023-07-16,21:00:00,67,38,29,FMN 12 Statielei
660,Statielei 26,2023-07-16,22:00:00,39,18,21,FMN 12 Statielei
660,Statielei 26,2023-07-16,23:00:00,34,18,16,FMN 12 Statielei
660,Statielei 26,2023-07-17,00:00:00,18,9,9,FMN 12 Statielei
660,Statielei 26,2023-07-17,01:00:00,14,4,10,FMN 12 Statielei
660,Statielei 26,2023-07-17,02:00:00,8,2,6,FMN 12 Statielei
660,Statielei 26,2023-07-17,03:00:00,5,2,3,FMN 12 Statielei
660,Statielei 26,2023-07-17,04:00:00,13,7,6,FMN 12 Statielei
660,Statielei 26,2023-07-17,05:00:00,17,12,5,FMN 12 Statielei
660,Statielei 26,2023-07-17,06:00:00,23,13,10,FMN 12 Statielei
660,Statielei 26,2023-07-17,07:00:00,50,27,23,FMN 12 Statielei
660,Statielei 26,2023-07-17,08:00:00,105,61,44,FMN 12 Statielei
660,Statielei 26,2023-07-17,09:00:00,86,53,33,FMN 12 Statielei
660,Statielei 26,2023-07-17,10:00:00,59,35,24,FMN 12 Statielei
660,Statielei 26,2023-07-17,11:00:00,68,38,30,FMN 12 Statielei
660,Statielei 26,2023-07-17,12:00:00,82,42,40,FMN 12 Statielei
660,Statielei 26,2023-07-17,13:00:00,97,46,51,FMN 12 Statielei
660,Statielei 26,2023-07-17,14:00:00,99,55,44,FMN 12 Statielei
660,Statielei 26,2023-07-17,15:00:00,91,47,44,FMN 12 Statielei
660,Statielei 26,2023-07-17,16:00:00,124,59,65,FMN 12 Statielei
660,Statielei 26,2023-07-17,17:00:00,142,72,70,FMN 12 Statielei
660,Statielei 26,2023-07-17,18:00:00,105,57,48,FMN 12 Statielei
660,Statielei 26,2023-07-17,19:00:00,98,49,49,FMN 12 Statielei
660,Statielei 26,2023-07-17,20:00:00,60,31,29,FMN 12 Statielei
660,Statielei 26,2023-07-17,21:00:00,65,38,27,FMN 12 Statielei
660,Statielei 26,2023-07-17,22:00:00,52,24,28,FMN 12 Statielei
660,Statielei 26,2023-07-17,23:00:00,26,6,20,FMN 12 Statielei
660,Statielei 26,2023-07-18,00:00:00,29,13,16,FMN 12 Statielei
660,Statielei 26,2023-07-18,01:00:00,8,4,4,FMN 12 Statielei
660,Statielei 26,2023-07-18,02:00:00,7,2,5,FMN 12 Statielei
660,Statielei 26,2023-07-18,03:00:00,6,2,4,FMN 12 Statielei
660,Statielei 26,2023-07-18,04:00:00,12,6,6,FMN 12 Statielei
660,Statielei 26,2023-07-18,05:00:00,20,15,5,FMN 12 Statielei
660,Statielei 26,2023-07-18,06:00:00,25,12,13,FMN 12 Statielei
660,Statielei 26,2023-07-18,07:00:00,58,29,29,FMN 12 Statielei
660,Statielei 26,2023-07-18,08:00:00,140,69,71,FMN 12 Statielei
660,Statielei 26,2023-07-18,09:00:00,91,47,44,FMN 12 Statielei
660,Statielei 26,2023-07-18,10:00:00,75,41,34,FMN 12 Statielei
660,Statielei 26,2023-07-18,11:00:00,82,40,42,FMN 12 Statielei
660,Statielei 26,2023-07-18,12:00:00,84,38,46,FMN 12 Statielei
660,Statielei 26,2023-07-18,13:00:00,103,48,55,FMN 12 Statielei
660,Statielei 26,2023-07-18,14:00:00,109,61,48,FMN 12 Statielei
660,Statielei 26,2023-07-18,15:00:00,129,69,60,FMN 12 Statielei
660,Statielei 26,2023-07-18,16:00:00,129,68,61,FMN 12 Statielei
660,Statielei 26,2023-07-18,17:00:00,188,89,99,FMN 12 Statielei
660,Statielei 26,2023-07-18,18:00:00,129,63,66,FMN 12 Statielei
660,Statielei 26,2023-07-18,19:00:00,101,53,48,FMN 12 Statielei
660,Statielei 26,2023-07-18,20:00:00,92,55,37,FMN 12 Statielei
660,Statielei 26,2023-07-18,21:00:00,81,45,36,FMN 12 Statielei
660,Statielei 26,2023-07-18,22:00:00,62,27,35,FMN 12 Statielei
660,Statielei 26,2023-07-18,23:00:00,50,20,30,FMN 12 Statielei
660,Statielei 26,2023-07-19,00:00:00,27,12,15,FMN 12 Statielei
660,Statielei 26,2023-07-19,01:00:00,15,10,5,FMN 12 Statielei
660,Statielei 26,2023-07-19,02:00:00,9,5,4,FMN 12 Statielei
660,Statielei 26,2023-07-19,03:00:00,6,2,4,FMN 12 Statielei
660,Statielei 26,2023-07-19,04:00:00,16,10,6,FMN 12 Statielei
660,Statielei 26,2023-07-19,05:00:00,14,10,4,FMN 12 Statielei
660,Statielei 26,2023-07-19,06:00:00,25,14,11,FMN 12 Statielei
660,Statielei 26,2023-07-19,07:00:00,60,29,31,FMN 12 Statielei
660,Statielei 26,2023-07-19,08:00:00,109,54,55,FMN 12 Statielei
660,Statielei 26,2023-07-19,09:00:00,88,54,34,FMN 12 Statielei
660,Statielei 26,2023-07-19,10:00:00,71,45,26,FMN 12 Statielei
660,Statielei 26,2023-07-19,11:00:00,84,45,39,FMN 12 Statielei
660,Statielei 26,2023-07-19,12:00:00,86,48,38,FMN 12 Statielei
660,Statielei 26,2023-07-19,13:00:00,79,39,40,FMN 12 Statielei
660,Statielei 26,2023-07-19,14:00:00,104,50,54,FMN 12 Statielei
660,Statielei 26,2023-07-19,15:00:00,120,54,66,FMN 12 Statielei
660,Statielei 26,2023-07-19,16:00:00,139,67,72,FMN 12 Statielei
660,Statielei 26,2023-07-19,17:00:00,139,76,63,FMN 12 Statielei
660,Statielei 26,2023-07-19,18:00:00,111,66,45,FMN 12 Statielei
660,Statielei 26,2023-07-19,19:00:00,103,50,53,FMN 12 Statielei
660,Statielei 26,2023-07-19,20:00:00,71,34,37,FMN 12 Statielei
660,Statielei 26,2023-07-19,21:00:00,73,32,41,FMN 12 Statielei
660,Statielei 26,2023-07-19,22:00:00,74,41,33,FMN 12 Statielei
660,Statielei 26,2023-07-19,23:00:00,58,17,41,FMN 12 Statielei
660,Statielei 26,2023-07-20,00:00:00,31,13,18,FMN 12 Statielei
660,Statielei 26,2023-07-20,01:00:00,11,4,7,FMN 12 Statielei
660,Statielei 26,2023-07-20,02:00:00,11,5,6,FMN 12 Statielei
660,Statielei 26,2023-07-20,03:00:00,6,1,5,FMN 12 Statielei
660,Statielei 26,2023-07-20,04:00:00,10,8,2,FMN 12 Statielei
660,Statielei 26,2023-07-20,05:00:00,18,8,10,FMN 12 Statielei
660,Statielei 26,2023-07-20,06:00:00,22,11,11,FMN 12 Statielei
660,Statielei 26,2023-07-20,07:00:00,65,28,37,FMN 12 Statielei
660,Statielei 26,2023-07-20,08:00:00,134,59,75,FMN 12 Statielei
660,Statielei 26,2023-07-20,09:00:00,73,39,34,FMN 12 Statielei
660,Statielei 26,2023-07-20,10:00:00,75,49,26,FMN 12 Statielei
660,Statielei 26,2023-07-20,11:00:00,79,36,43,FMN 12 Statielei
660,Statielei 26,2023-07-20,12:00:00,86,41,45,FMN 12 Statielei
660,Statielei 26,2023-07-20,13:00:00,88,45,43,FMN 12 Statielei
660,Statielei 26,2023-07-20,14:00:00,104,47,57,FMN 12 Statielei
660,Statielei 26,2023-07-20,15:00:00,96,49,47,FMN 12 Statielei
660,Statielei 26,2023-07-20,16:00:00,135,81,54,FMN 12 Statielei
660,Statielei 26,2023-07-20,17:00:00,139,71,68,FMN 12 Statielei
660,Statielei 26,2023-07-20,18:00:00,132,61,71,FMN 12 Statielei
660,Statielei 26,2023-07-20,19:00:00,119,58,61,FMN 12 Statielei
660,Statielei 26,2023-07-20,20:00:00,101,52,49,FMN 12 Statielei
660,Statielei 26,2023-07-20,21:00:00,80,42,38,FMN 12 Statielei
660,Statielei 26,2023-07-20,22:00:00,67,34,33,FMN 12 Statielei
660,Statielei 26,2023-07-20,23:00:00,49,22,27,FMN 12 Statielei
660,Statielei 26,2023-07-21,00:00:00,35,12,23,FMN 12 Statielei
660,Statielei 26,2023-07-21,01:00:00,23,14,9,FMN 12 Statielei
660,Statielei 26,2023-07-21,02:00:00,9,3,6,FMN 12 Statielei
660,Statielei 26,2023-07-21,03:00:00,8,2,6,FMN 12 Statielei
660,Statielei 26,2023-07-21,04:00:00,6,1,5,FMN 12 Statielei
660,Statielei 26,2023-07-21,05:00:00,16,5,11,FMN 12 Statielei
660,Statielei 26,2023-07-21,06:00:00,13,4,9,FMN 12 Statielei
660,Statielei 26,2023-07-21,07:00:00,18,12,6,FMN 12 Statielei
660,Statielei 26,2023-07-21,08:00:00,29,16,13,FMN 12 Statielei
660,Statielei 26,2023-07-21,09:00:00,50,19,31,FMN 12 Statielei
660,Statielei 26,2023-07-21,10:00:00,57,32,25,FMN 12 Statielei
660,Statielei 26,2023-07-21,11:00:00,63,31,32,FMN 12 Statielei
660,Statielei 26,2023-07-21,12:00:00,44,31,13,FMN 12 Statielei
660,Statielei 26,2023-07-21,13:00:00,55,25,30,FMN 12 Statielei
660,Statielei 26,2023-07-21,14:00:00,68,21,47,FMN 12 Statielei
660,Statielei 26,2023-07-21,15:00:00,100,40,60,FMN 12 Statielei
660,Statielei 26,2023-07-21,16:00:00,73,39,34,FMN 12 Statielei
660,Statielei 26,2023-07-21,17:00:00,109,55,54,FMN 12 Statielei
660,Statielei 26,2023-07-21,18:00:00,129,60,69,FMN 12 Statielei
660,Statielei 26,2023-07-21,19:00:00,86,40,46,FMN 12 Statielei
660,Statielei 26,2023-07-21,20:00:00,90,43,47,FMN 12 Statielei
660,Statielei 26,2023-07-21,21:00:00,67,37,30,FMN 12 Statielei
660,Statielei 26,2023-07-21,22:00:00,62,36,26,FMN 12 Statielei
660,Statielei 26,2023-07-21,23:00:00,45,21,24,FMN 12 Statielei
660,Statielei 26,2023-07-22,00:00:00,52,32,20,FMN 12 Statielei
660,Statielei 26,2023-07-22,01:00:00,30,15,15,FMN 12 Statielei
660,Statielei 26,2023-07-22,02:00:00,12,9,3,FMN 12 Statielei
660,Statielei 26,2023-07-22,03:00:00,7,1,6,FMN 12 Statielei
660,Statielei 26,2023-07-22,04:00:00,8,1,7,FMN 12 Statielei
660,Statielei 26,2023-07-22,05:00:00,10,5,5,FMN 12 Statielei
660,Statielei 26,2023-07-22,06:00:00,7,5,2,FMN 12 Statielei
660,Statielei 26,2023-07-22,07:00:00,27,15,12,FMN 12 Statielei
660,Statielei 26,2023-07-22,08:00:00,43,21,22,FMN 12 Statielei
660,Statielei 26,2023-07-22,09:00:00,61,34,27,FMN 12 Statielei
660,Statielei 26,2023-07-22,10:00:00,83,38,45,FMN 12 Statielei
660,Statielei 26,2023-07-22,11:00:00,83,51,32,FMN 12 Statielei
660,Statielei 26,2023-07-22,12:00:00,88,51,37,FMN 12 Statielei
660,Statielei 26,2023-07-22,13:00:00,96,52,44,FMN 12 Statielei
660,Statielei 26,2023-07-22,14:00:00,87,25,62,FMN 12 Statielei
660,Statielei 26,2023-07-22,15:00:00,89,35,54,FMN 12 Statielei
660,Statielei 26,2023-07-22,16:00:00,94,57,37,FMN 12 Statielei
660,Statielei 26,2023-07-22,17:00:00,93,51,42,FMN 12 Statielei
660,Statielei 26,2023-07-22,18:00:00,113,46,67,FMN 12 Statielei
660,Statielei 26,2023-07-22,19:00:00,94,39,55,FMN 12 Statielei
660,Statielei 26,2023-07-22,20:00:00,77,43,34,FMN 12 Statielei
660,Statielei 26,2023-07-22,21:00:00,56,18,38,FMN 12 Statielei
660,Statielei 26,2023-07-22,22:00:00,73,36,37,FMN 12 Statielei
660,Statielei 26,2023-07-22,23:00:00,54,37,17,FMN 12 Statielei
660,Statielei 26,2023-07-23,00:00:00,31,12,19,FMN 12 Statielei
660,Statielei 26,2023-07-23,01:00:00,13,7,6,FMN 12 Statielei
660,Statielei 26,2023-07-23,02:00:00,12,5,7,FMN 12 Statielei
660,Statielei 26,2023-07-23,03:00:00,4,3,1,FMN 12 Statielei
660,Statielei 26,2023-07-23,04:00:00,10,4,6,FMN 12 Statielei
660,Statielei 26,2023-07-23,05:00:00,8,5,3,FMN 12 Statielei
660,Statielei 26,2023-07-23,06:00:00,8,3,5,FMN 12 Statielei
660,Statielei 26,2023-07-23,07:00:00,9,5,4,FMN 12 Statielei
660,Statielei 26,2023-07-23,08:00:00,14,9,5,FMN 12 Statielei
660,Statielei 26,2023-07-23,09:00:00,31,14,17,FMN 12 Statielei
660,Statielei 26,2023-07-23,10:00:00,45,24,21,FMN 12 Statielei
660,Statielei 26,2023-07-23,11:00:00,49,25,24,FMN 12 Statielei
660,Statielei 26,2023-07-23,12:00:00,66,34,32,FMN 12 Statielei
660,Statielei 26,2023-07-23,13:00:00,74,45,29,FMN 12 Statielei
660,Statielei 26,2023-07-23,14:00:00,107,49,58,FMN 12 Statielei
660,Statielei 26,2023-07-23,15:00:00,80,44,36,FMN 12 Statielei
660,Statielei 26,2023-07-23,16:00:00,104,47,57,FMN 12 Statielei
660,Statielei 26,2023-07-23,17:00:00,89,26,63,FMN 12 Statielei
660,Statielei 26,2023-07-23,18:00:00,79,44,35,FMN 12 Statielei
660,Statielei 26,2023-07-23,19:00:00,35,13,22,FMN 12 Statielei
660,Statielei 26,2023-07-23,20:00:00,45,23,22,FMN 12 Statielei
660,Statielei 26,2023-07-23,21:00:00,55,41,14,FMN 12 Statielei
660,Statielei 26,2023-07-23,22:00:00,58,33,25,FMN 12 Statielei
660,Statielei 26,2023-07-23,23:00:00,27,14,13,FMN 12 Statielei
660,Statielei 26,2023-07-24,00:00:00,13,6,7,FMN 12 Statielei
660,Statielei 26,2023-07-24,01:00:00,10,8,2,FMN 12 Statielei
660,Statielei 26,2023-07-24,02:00:00,8,1,7,FMN 12 Statielei
660,Statielei 26,2023-07-24,03:00:00,6,2,4,FMN 12 Statielei
660,Statielei 26,2023-07-24,04:00:00,7,1,6,FMN 12 Statielei
660,Statielei 26,2023-07-24,05:00:00,10,6,4,FMN 12 Statielei
660,Statielei 26,2023-07-24,06:00:00,13,5,8,FMN 12 Statielei
660,Statielei 26,2023-07-24,07:00:00,37,17,20,FMN 12 Statielei
660,Statielei 26,2023-07-24,08:00:00,71,36,35,FMN 12 Statielei
660,Statielei 26,2023-07-24,09:00:00,52,34,18,FMN 12 Statielei
660,Statielei 26,2023-07-24,10:00:00,51,29,22,FMN 12 Statielei
660,Statielei 26,2023-07-24,11:00:00,61,25,36,FMN 12 Statielei
660,Statielei 26,2023-07-24,12:00:00,69,43,26,FMN 12 Statielei
660,Statielei 26,2023-07-24,13:00:00,77,35,42,FMN 12 Statielei
660,Statielei 26,2023-07-24,14:00:00,75,40,35,FMN 12 Statielei
660,Statielei 26,2023-07-24,15:00:00,77,34,43,FMN 12 Statielei
660,Statielei 26,2023-07-24,16:00:00,89,39,50,FMN 12 Statielei
660,Statielei 26,2023-07-24,17:00:00,94,46,48,FMN 12 Statielei
660,Statielei 26,2023-07-24,18:00:00,112,44,68,FMN 12 Statielei
660,Statielei 26,2023-07-24,19:00:00,73,41,32,FMN 12 Statielei
660,Statielei 26,2023-07-24,20:00:00,73,39,34,FMN 12 Statielei
660,Statielei 26,2023-07-24,21:00:00,59,32,27,FMN 12 Statielei
660,Statielei 26,2023-07-24,22:00:00,33,14,19,FMN 12 Statielei
660,Statielei 26,2023-07-24,23:00:00,19,7,12,FMN 12 Statielei
660,Statielei 26,2023-07-25,00:00:00,17,2,15,FMN 12 Statielei
660,Statielei 26,2023-07-25,01:00:00,8,5,3,FMN 12 Statielei
660,Statielei 26,2023-07-25,02:00:00,9,2,7,FMN 12 Statielei
660,Statielei 26,2023-07-25,03:00:00,6,2,4,FMN 12 Statielei
660,Statielei 26,2023-07-25,04:00:00,9,6,3,FMN 12 Statielei
660,Statielei 26,2023-07-25,05:00:00,14,9,5,FMN 12 Statielei
660,Statielei 26,2023-07-25,06:00:00,22,8,14,FMN 12 Statielei
660,Statielei 26,2023-07-25,07:00:00,49,18,31,FMN 12 Statielei
660,Statielei 26,2023-07-25,08:00:00,83,49,34,FMN 12 Statielei
660,Statielei 26,2023-07-25,09:00:00,81,48,33,FMN 12 Statielei
660,Statielei 26,2023-07-25,10:00:00,54,29,25,FMN 12 Statielei
660,Statielei 26,2023-07-25,11:00:00,70,35,35,FMN 12 Statielei
660,Statielei 26,2023-07-25,12:00:00,86,45,41,FMN 12 Statielei
660,Statielei 26,2023-07-25,13:00:00,98,40,58,FMN 12 Statielei
660,Statielei 26,2023-07-25,14:00:00,98,56,42,FMN 12 Statielei
660,Statielei 26,2023-07-25,15:00:00,119,52,67,FMN 12 Statielei
660,Statielei 26,2023-07-25,16:00:00,119,60,59,FMN 12 Statielei
660,Statielei 26,2023-07-25,17:00:00,140,66,74,FMN 12 Statielei
660,Statielei 26,2023-07-25,18:00:00,155,71,84,FMN 12 Statielei
660,Statielei 26,2023-07-25,19:00:00,164,47,117,FMN 12 Statielei
660,Statielei 26,2023-07-25,20:00:00,99,50,49,FMN 12 Statielei
660,Statielei 26,2023-07-25,21:00:00,64,37,27,FMN 12 Statielei
660,Statielei 26,2023-07-25,22:00:00,77,40,37,FMN 12 Statielei
660,Statielei 26,2023-07-25,23:00:00,85,60,25,FMN 12 Statielei
660,Statielei 26,2023-07-26,00:00:00,49,42,7,FMN 12 Statielei
660,Statielei 26,2023-07-26,01:00:00,16,7,9,FMN 12 Statielei
660,Statielei 26,2023-07-26,02:00:00,7,3,4,FMN 12 Statielei
660,Statielei 26,2023-07-26,03:00:00,8,3,5,FMN 12 Statielei
660,Statielei 26,2023-07-26,04:00:00,9,4,5,FMN 12 Statielei
660,Statielei 26,2023-07-26,05:00:00,18,10,8,FMN 12 Statielei
660,Statielei 26,2023-07-26,06:00:00,29,15,14,FMN 12 Statielei
660,Statielei 26,2023-07-26,07:00:00,52,25,27,FMN 12 Statielei
660,Statielei 26,2023-07-26,08:00:00,96,50,46,FMN 12 Statielei
660,Statielei 26,2023-07-26,09:00:00,84,55,29,FMN 12 Statielei
660,Statielei 26,2023-07-26,10:00:00,77,44,33,FMN 12 Statielei
660,Statielei 26,2023-07-26,11:00:00,75,43,32,FMN 12 Statielei
660,Statielei 26,2023-07-26,12:00:00,95,51,44,FMN 12 Statielei
660,Statielei 26,2023-07-26,13:00:00,83,36,47,FMN 12 Statielei
660,Statielei 26,2023-07-26,14:00:00,124,69,55,FMN 12 Statielei
660,Statielei 26,2023-07-26,15:00:00,113,65,48,FMN 12 Statielei
660,Statielei 26,2023-07-26,16:00:00,129,65,64,FMN 12 Statielei
660,Statielei 26,2023-07-26,17:00:00,154,69,85,FMN 12 Statielei
660,Statielei 26,2023-07-26,18:00:00,145,69,76,FMN 12 Statielei
660,Statielei 26,2023-07-26,19:00:00,114,39,75,FMN 12 Statielei
660,Statielei 26,2023-07-26,20:00:00,112,53,59,FMN 12 Statielei
660,Statielei 26,2023-07-26,21:00:00,78,42,36,FMN 12 Statielei
660,Statielei 26,2023-07-26,22:00:00,63,32,31,FMN 12 Statielei
660,Statielei 26,2023-07-26,23:00:00,97,63,34,FMN 12 Statielei
660,Statielei 26,2023-07-27,00:00:00,46,21,25,FMN 12 Statielei
660,Statielei 26,2023-07-27,01:00:00,19,9,10,FMN 12 Statielei
660,Statielei 26,2023-07-27,02:00:00,7,3,4,FMN 12 Statielei
660,Statielei 26,2023-07-27,03:00:00,8,3,5,FMN 12 Statielei
660,Statielei 26,2023-07-27,04:00:00,9,2,7,FMN 12 Statielei
660,Statielei 26,2023-07-27,05:00:00,8,6,2,FMN 12 Statielei
660,Statielei 26,2023-07-27,06:00:00,16,8,8,FMN 12 Statielei
660,Statielei 26,2023-07-27,07:00:00,38,16,22,FMN 12 Statielei
660,Statielei 26,2023-07-27,08:00:00,64,33,31,FMN 12 Statielei
660,Statielei 26,2023-07-27,09:00:00,48,29,19,FMN 12 Statielei
660,Statielei 26,2023-07-27,10:00:00,35,24,11,FMN 12 Statielei
660,Statielei 26,2023-07-27,11:00:00,38,22,16,FMN 12 Statielei
660,Statielei 26,2023-07-27,12:00:00,53,24,29,FMN 12 Statielei
660,Statielei 26,2023-07-27,13:00:00,50,27,23,FMN 12 Statielei
660,Statielei 26,2023-07-27,14:00:00,68,40,28,FMN 12 Statielei
660,Statielei 26,2023-07-27,15:00:00,65,32,33,FMN 12 Statielei
660,Statielei 26,2023-07-27,16:00:00,75,39,36,FMN 12 Statielei
660,Statielei 26,2023-07-27,17:00:00,82,30,52,FMN 12 Statielei
660,Statielei 26,2023-07-27,18:00:00,94,49,45,FMN 12 Statielei
660,Statielei 26,2023-07-27,19:00:00,85,48,37,FMN 12 Statielei
660,Statielei 26,2023-07-27,20:00:00,75,34,41,FMN 12 Statielei
660,Statielei 26,2023-07-27,21:00:00,65,28,37,FMN 12 Statielei
660,Statielei 26,2023-07-27,22:00:00,50,23,27,FMN 12 Statielei
660,Statielei 26,2023-07-27,23:00:00,56,22,34,FMN 12 Statielei
660,Statielei 26,2023-07-28,00:00:00,23,16,7,FMN 12 Statielei
660,Statielei 26,2023-07-28,01:00:00,19,10,9,FMN 12 Statielei
660,Statielei 26,2023-07-28,02:00:00,3,1,2,FMN 12 Statielei
660,Statielei 26,2023-07-28,03:00:00,8,4,4,FMN 12 Statielei
660,Statielei 26,2023-07-28,04:00:00,7,3,4,FMN 12 Statielei
660,Statielei 26,2023-07-28,05:00:00,17,8,9,FMN 12 Statielei
660,Statielei 26,2023-07-28,06:00:00,18,9,9,FMN 12 Statielei
660,Statielei 26,2023-07-28,07:00:00,52,27,25,FMN 12 Statielei
660,Statielei 26,2023-07-28,08:00:00,58,29,29,FMN 12 Statielei
660,Statielei 26,2023-07-28,09:00:00,65,42,23,FMN 12 Statielei
660,Statielei 26,2023-07-28,10:00:00,41,24,17,FMN 12 Statielei
660,Statielei 26,2023-07-28,11:00:00,79,39,40,FMN 12 Statielei
660,Statielei 26,2023-07-28,12:00:00,74,35,39,FMN 12 Statielei
660,Statielei 26,2023-07-28,13:00:00,84,46,38,FMN 12 Statielei
660,Statielei 26,2023-07-28,14:00:00,101,46,55,FMN 12 Statielei
660,Statielei 26,2023-07-28,15:00:00,102,62,40,FMN 12 Statielei
660,Statielei 26,2023-07-28,16:00:00,151,68,83,FMN 12 Statielei
660,Statielei 26,2023-07-28,17:00:00,133,71,62,FMN 12 Statielei
660,Statielei 26,2023-07-28,18:00:00,143,80,63,FMN 12 Statielei
660,Statielei 26,2023-07-28,19:00:00,136,58,78,FMN 12 Statielei
660,Statielei 26,2023-07-28,20:00:00,147,63,84,FMN 12 Statielei
660,Statielei 26,2023-07-28,21:00:00,100,49,51,FMN 12 Statielei
660,Statielei 26,2023-07-28,22:00:00,49,36,13,FMN 12 Statielei
660,Statielei 26,2023-07-28,23:00:00,87,52,35,FMN 12 Statielei
660,Statielei 26,2023-07-29,00:00:00,89,65,24,FMN 12 Statielei
660,Statielei 26,2023-07-29,01:00:00,35,12,23,FMN 12 Statielei
660,Statielei 26,2023-07-29,02:00:00,25,12,13,FMN 12 Statielei
660,Statielei 26,2023-07-29,03:00:00,26,5,21,FMN 12 Statielei
660,Statielei 26,2023-07-29,04:00:00,14,6,8,FMN 12 Statielei
660,Statielei 26,2023-07-29,05:00:00,11,6,5,FMN 12 Statielei
660,Statielei 26,2023-07-29,06:00:00,8,6,2,FMN 12 Statielei
660,Statielei 26,2023-07-29,07:00:00,17,8,9,FMN 12 Statielei
660,Statielei 26,2023-07-29,08:00:00,32,20,12,FMN 12 Statielei
660,Statielei 26,2023-07-29,09:00:00,50,28,22,FMN 12 Statielei
660,Statielei 26,2023-07-29,10:00:00,64,30,34,FMN 12 Statielei
660,Statielei 26,2023-07-29,11:00:00,81,47,34,FMN 12 Statielei
660,Statielei 26,2023-07-29,12:00:00,84,41,43,FMN 12 Statielei
660,Statielei 26,2023-07-29,13:00:00,31,18,13,FMN 12 Statielei
660,Statielei 26,2023-07-29,14:00:00,81,45,36,FMN 12 Statielei
660,Statielei 26,2023-07-29,15:00:00,97,51,46,FMN 12 Statielei
660,Statielei 26,2023-07-29,16:00:00,58,17,41,FMN 12 Statielei
660,Statielei 26,2023-07-29,17:00:00,107,54,53,FMN 12 Statielei
660,Statielei 26,2023-07-29,18:00:00,102,58,44,FMN 12 Statielei
660,Statielei 26,2023-07-29,19:00:00,117,61,56,FMN 12 Statielei
660,Statielei 26,2023-07-29,20:00:00,83,48,35,FMN 12 Statielei
660,Statielei 26,2023-07-29,21:00:00,72,34,38,FMN 12 Statielei
660,Statielei 26,2023-07-29,22:00:00,69,43,26,FMN 12 Statielei
660,Statielei 26,2023-07-29,23:00:00,46,22,24,FMN 12 Statielei
660,Statielei 26,2023-07-30,00:00:00,42,18,24,FMN 12 Statielei
660,Statielei 26,2023-07-30,01:00:00,23,4,19,FMN 12 Statielei
660,Statielei 26,2023-07-30,02:00:00,36,13,23,FMN 12 Statielei
660,Statielei 26,2023-07-30,03:00:00,10,4,6,FMN 12 Statielei
660,Statielei 26,2023-07-30,04:00:00,9,6,3,FMN 12 Statielei
660,Statielei 26,2023-07-30,05:00:00,7,5,2,FMN 12 Statielei
660,Statielei 26,2023-07-30,06:00:00,8,4,4,FMN 12 Statielei
660,Statielei 26,2023-07-30,07:00:00,16,7,9,FMN 12 Statielei
660,Statielei 26,2023-07-30,08:00:00,19,9,10,FMN 12 Statielei
660,Statielei 26,2023-07-30,09:00:00,41,15,26,FMN 12 Statielei
660,Statielei 26,2023-07-30,10:00:00,58,26,32,FMN 12 Statielei
660,Statielei 26,2023-07-30,11:00:00,57,21,36,FMN 12 Statielei
660,Statielei 26,2023-07-30,12:00:00,104,42,62,FMN 12 Statielei
660,Statielei 26,2023-07-30,13:00:00,107,55,52,FMN 12 Statielei
660,Statielei 26,2023-07-30,14:00:00,105,55,50,FMN 12 Statielei
660,Statielei 26,2023-07-30,15:00:00,105,66,39,FMN 12 Statielei
660,Statielei 26,2023-07-30,16:00:00,127,79,48,FMN 12 Statielei
660,Statielei 26,2023-07-30,17:00:00,72,36,36,FMN 12 Statielei
660,Statielei 26,2023-07-30,18:00:00,82,43,39,FMN 12 Statielei
660,Statielei 26,2023-07-30,19:00:00,45,17,28,FMN 12 Statielei
660,Statielei 26,2023-07-30,20:00:00,30,12,18,FMN 12 Statielei
660,Statielei 26,2023-07-30,21:00:00,39,20,19,FMN 12 Statielei
660,Statielei 26,2023-07-30,22:00:00,39,23,16,FMN 12 Statielei
660,Statielei 26,2023-07-30,23:00:00,16,7,9,FMN 12 Statielei
660,Statielei 26,2023-07-31,00:00:00,13,7,6,FMN 12 Statielei
660,Statielei 26,2023-07-31,01:00:00,13,6,7,FMN 12 Statielei
660,Statielei 26,2023-07-31,02:00:00,7,3,4,FMN 12 Statielei
660,Statielei 26,2023-07-31,03:00:00,7,5,2,FMN 12 Statielei
660,Statielei 26,2023-07-31,04:00:00,8,4,4,FMN 12 Statielei
660,Statielei 26,2023-07-31,05:00:00,10,7,3,FMN 12 Statielei
660,Statielei 26,2023-07-31,06:00:00,16,6,10,FMN 12 Statielei
660,Statielei 26,2023-07-31,07:00:00,32,14,18,FMN 12 Statielei
660,Statielei 26,2023-07-31,08:00:00,66,32,34,FMN 12 Statielei
660,Statielei 26,2023-07-31,09:00:00,54,29,25,FMN 12 Statielei
660,Statielei 26,2023-07-31,10:00:00,47,22,25,FMN 12 Statielei
660,Statielei 26,2023-07-31,11:00:00,57,32,25,FMN 12 Statielei
660,Statielei 26,2023-07-31,12:00:00,62,34,28,FMN 12 Statielei
660,Statielei 26,2023-07-31,13:00:00,67,40,27,FMN 12 Statielei
660,Statielei 26,2023-07-31,14:00:00,83,44,39,FMN 12 Statielei
660,Statielei 26,2023-07-31,15:00:00,51,20,31,FMN 12 Statielei
660,Statielei 26,2023-07-31,16:00:00,85,45,40,FMN 12 Statielei
660,Statielei 26,2023-07-31,17:00:00,88,37,51,FMN 12 Statielei
660,Statielei 26,2023-07-31,18:00:00,64,28,36,FMN 12 Statielei
660,Statielei 26,2023-07-31,19:00:00,41,24,17,FMN 12 Statielei
660,Statielei 26,2023-07-31,20:00:00,30,17,13,FMN 12 Statielei
660,Statielei 26,2023-07-31,21:00:00,32,18,14,FMN 12 Statielei
660,Statielei 26,2023-07-31,22:00:00,32,9,23,FMN 12 Statielei
660,Statielei 26,2023-07-31,23:00:00,18,9,9,FMN 12 Statielei
660,Statielei 26,2023-08-01,00:00:00,16,1,15,FMN 12 Statielei
660,Statielei 26,2023-08-01,01:00:00,8,3,5,FMN 12 Statielei
660,Statielei 26,2023-08-01,02:00:00,7,2,5,FMN 12 Statielei
660,Statielei 26,2023-08-01,03:00:00,3,2,1,FMN 12 Statielei
660,Statielei 26,2023-08-01,04:00:00,6,3,3,FMN 12 Statielei
660,Statielei 26,2023-08-01,05:00:00,11,6,5,FMN 12 Statielei
660,Statielei 26,2023-08-01,06:00:00,21,10,11,FMN 12 Statielei
660,Statielei 26,2023-08-01,07:00:00,53,26,27,FMN 12 Statielei
660,Statielei 26,2023-08-01,08:00:00,90,49,41,FMN 12 Statielei
660,Statielei 26,2023-08-01,09:00:00,82,42,40,FMN 12 Statielei
660,Statielei 26,2023-08-01,10:00:00,53,33,20,FMN 12 Statielei
660,Statielei 26,2023-08-01,11:00:00,59,39,20,FMN 12 Statielei
660,Statielei 26,2023-08-01,12:00:00,74,42,32,FMN 12 Statielei
660,Statielei 26,2023-08-01,13:00:00,89,46,43,FMN 12 Statielei
660,Statielei 26,2023-08-01,14:00:00,83,50,33,FMN 12 Statielei
660,Statielei 26,2023-08-01,15:00:00,99,49,50,FMN 12 Statielei
660,Statielei 26,2023-08-01,16:00:00,131,58,73,FMN 12 Statielei
660,Statielei 26,2023-08-01,17:00:00,130,56,74,FMN 12 Statielei
660,Statielei 26,2023-08-01,18:00:00,136,66,70,FMN 12 Statielei
660,Statielei 26,2023-08-01,19:00:00,115,63,52,FMN 12 Statielei
660,Statielei 26,2023-08-01,20:00:00,89,51,38,FMN 12 Statielei
660,Statielei 26,2023-08-01,21:00:00,77,35,42,FMN 12 Statielei
660,Statielei 26,2023-08-01,22:00:00,55,35,20,FMN 12 Statielei
660,Statielei 26,2023-08-01,23:00:00,41,19,22,FMN 12 Statielei
660,Statielei 26,2023-08-02,00:00:00,18,8,10,FMN 12 Statielei
660,Statielei 26,2023-08-02,01:00:00,13,9,4,FMN 12 Statielei
660,Statielei 26,2023-08-02,02:00:00,6,1,5,FMN 12 Statielei
660,Statielei 26,2023-08-02,03:00:00,4,0,4,FMN 12 Statielei
660,Statielei 26,2023-08-02,04:00:00,8,1,7,FMN 12 Statielei
660,Statielei 26,2023-08-02,05:00:00,12,7,5,FMN 12 Statielei
660,Statielei 26,2023-08-02,06:00:00,17,9,8,FMN 12 Statielei
660,Statielei 26,2023-08-02,07:00:00,35,17,18,FMN 12 Statielei
660,Statielei 26,2023-08-02,08:00:00,64,30,34,FMN 12 Statielei
660,Statielei 26,2023-08-02,09:00:00,57,32,25,FMN 12 Statielei
660,Statielei 26,2023-08-02,10:00:00,49,28,21,FMN 12 Statielei
660,Statielei 26,2023-08-02,11:00:00,63,25,38,FMN 12 Statielei
660,Statielei 26,2023-08-02,12:00:00,62,43,19,FMN 12 Statielei
660,Statielei 26,2023-08-02,13:00:00,80,42,38,FMN 12 Statielei
660,Statielei 26,2023-08-02,14:00:00,75,37,38,FMN 12 Statielei
660,Statielei 26,2023-08-02,15:00:00,92,47,45,FMN 12 Statielei
660,Statielei 26,2023-08-02,16:00:00,106,54,52,FMN 12 Statielei
660,Statielei 26,2023-08-02,17:00:00,105,53,52,FMN 12 Statielei
660,Statielei 26,2023-08-02,18:00:00,109,60,49,FMN 12 Statielei
660,Statielei 26,2023-08-02,19:00:00,84,43,41,FMN 12 Statielei
660,Statielei 26,2023-08-02,20:00:00,52,25,27,FMN 12 Statielei
660,Statielei 26,2023-08-02,21:00:00,44,16,28,FMN 12 Statielei
660,Statielei 26,2023-08-02,22:00:00,65,48,17,FMN 12 Statielei
660,Statielei 26,2023-08-02,23:00:00,28,14,14,FMN 12 Statielei
660,Statielei 26,2023-08-03,00:00:00,16,7,9,FMN 12 Statielei
660,Statielei 26,2023-08-03,01:00:00,11,9,2,FMN 12 Statielei
660,Statielei 26,2023-08-03,02:00:00,2,0,2,FMN 12 Statielei
660,Statielei 26,2023-08-03,03:00:00,2,0,2,FMN 12 Statielei
660,Statielei 26,2023-08-03,04:00:00,6,2,4,FMN 12 Statielei
660,Statielei 26,2023-08-03,05:00:00,9,5,4,FMN 12 Statielei
660,Statielei 26,2023-08-03,06:00:00,20,5,15,FMN 12 Statielei
660,Statielei 26,2023-08-03,07:00:00,50,23,27,FMN 12 Statielei
660,Statielei 26,2023-08-03,08:00:00,76,44,32,FMN 12 Statielei
660,Statielei 26,2023-08-03,09:00:00,59,35,24,FMN 12 Statielei
660,Statielei 26,2023-08-03,10:00:00,45,22,23,FMN 12 Statielei
660,Statielei 26,2023-08-03,11:00:00,37,18,19,FMN 12 Statielei
660,Statielei 26,2023-08-03,12:00:00,58,29,29,FMN 12 Statielei
660,Statielei 26,2023-08-03,13:00:00,43,20,23,FMN 12 Statielei
660,Statielei 26,2023-08-03,14:00:00,48,22,26,FMN 12 Statielei
660,Statielei 26,2023-08-03,15:00:00,68,36,32,FMN 12 Statielei
660,Statielei 26,2023-08-03,16:00:00,104,56,48,FMN 12 Statielei
660,Statielei 26,2023-08-03,17:00:00,86,36,50,FMN 12 Statielei
660,Statielei 26,2023-08-03,18:00:00,120,68,52,FMN 12 Statielei
660,Statielei 26,2023-08-03,19:00:00,89,39,50,FMN 12 Statielei
660,Statielei 26,2023-08-03,20:00:00,91,47,44,FMN 12 Statielei
660,Statielei 26,2023-08-03,21:00:00,72,32,40,FMN 12 Statielei
660,Statielei 26,2023-08-03,22:00:00,70,39,31,FMN 12 Statielei
660,Statielei 26,2023-08-03,23:00:00,38,20,18,FMN 12 Statielei
660,Statielei 26,2023-08-04,00:00:00,15,3,12,FMN 12 Statielei
660,Statielei 26,2023-08-04,01:00:00,19,9,10,FMN 12 Statielei
660,Statielei 26,2023-08-04,02:00:00,2,1,1,FMN 12 Statielei
660,Statielei 26,2023-08-04,03:00:00,3,1,2,FMN 12 Statielei
660,Statielei 26,2023-08-04,04:00:00,8,2,6,FMN 12 Statielei
660,Statielei 26,2023-08-04,05:00:00,12,8,4,FMN 12 Statielei
660,Statielei 26,2023-08-04,06:00:00,22,11,11,FMN 12 Statielei
660,Statielei 26,2023-08-04,07:00:00,44,16,28,FMN 12 Statielei
660,Statielei 26,2023-08-04,08:00:00,75,35,40,FMN 12 Statielei
660,Statielei 26,2023-08-04,09:00:00,54,28,26,FMN 12 Statielei
660,Statielei 26,2023-08-04,10:00:00,58,31,27,FMN 12 Statielei
660,Statielei 26,2023-08-04,11:00:00,61,36,25,FMN 12 Statielei
660,Statielei 26,2023-08-04,12:00:00,64,31,33,FMN 12 Statielei
660,Statielei 26,2023-08-04,13:00:00,78,36,42,FMN 12 Statielei
660,Statielei 26,2023-08-04,14:00:00,104,64,40,FMN 12 Statielei
660,Statielei 26,2023-08-04,15:00:00,122,68,54,FMN 12 Statielei
660,Statielei 26,2023-08-04,16:00:00,137,62,75,FMN 12 Statielei
660,Statielei 26,2023-08-04,17:00:00,95,51,44,FMN 12 Statielei
660,Statielei 26,2023-08-04,18:00:00,127,64,63,FMN 12 Statielei
660,Statielei 26,2023-08-04,19:00:00,121,58,63,FMN 12 Statielei
660,Statielei 26,2023-08-04,20:00:00,100,45,55,FMN 12 Statielei
660,Statielei 26,2023-08-04,21:00:00,82,46,36,FMN 12 Statielei
660,Statielei 26,2023-08-04,22:00:00,69,40,29,FMN 12 Statielei
660,Statielei 26,2023-08-04,23:00:00,78,53,25,FMN 12 Statielei
660,Statielei 26,2023-08-05,00:00:00,49,28,21,FMN 12 Statielei
660,Statielei 26,2023-08-05,01:00:00,23,4,19,FMN 12 Statielei
660,Statielei 26,2023-08-05,02:00:00,17,7,10,FMN 12 Statielei
660,Statielei 26,2023-08-05,03:00:00,8,5,3,FMN 12 Statielei
660,Statielei 26,2023-08-05,04:00:00,8,2,6,FMN 12 Statielei
660,Statielei 26,2023-08-05,05:00:00,9,2,7,FMN 12 Statielei
660,Statielei 26,2023-08-05,06:00:00,10,5,5,FMN 12 Statielei
660,Statielei 26,2023-08-05,07:00:00,20,7,13,FMN 12 Statielei
660,Statielei 26,2023-08-05,08:00:00,31,15,16,FMN 12 Statielei
660,Statielei 26,2023-08-05,09:00:00,55,31,24,FMN 12 Statielei
660,Statielei 26,2023-08-05,10:00:00,60,40,20,FMN 12 Statielei
660,Statielei 26,2023-08-05,11:00:00,71,38,33,FMN 12 Statielei
660,Statielei 26,2023-08-05,12:00:00,92,39,53,FMN 12 Statielei
660,Statielei 26,2023-08-05,13:00:00,77,38,39,FMN 12 Statielei
660,Statielei 26,2023-08-05,14:00:00,64,39,25,FMN 12 Statielei
660,Statielei 26,2023-08-05,15:00:00,38,18,20,FMN 12 Statielei
660,Statielei 26,2023-08-05,16:00:00,86,47,39,FMN 12 Statielei
660,Statielei 26,2023-08-05,17:00:00,81,43,38,FMN 12 Statielei
660,Statielei 26,2023-08-05,18:00:00,83,45,38,FMN 12 Statielei
660,Statielei 26,2023-08-05,19:00:00,81,44,37,FMN 12 Statielei
660,Statielei 26,2023-08-05,20:00:00,54,32,22,FMN 12 Statielei
660,Statielei 26,2023-08-05,21:00:00,32,17,15,FMN 12 Statielei
660,Statielei 26,2023-08-05,22:00:00,33,19,14,FMN 12 Statielei
660,Statielei 26,2023-08-05,23:00:00,36,22,14,FMN 12 Statielei
660,Statielei 26,2023-08-06,00:00:00,32,14,18,FMN 12 Statielei
660,Statielei 26,2023-08-06,01:00:00,14,3,11,FMN 12 Statielei
660,Statielei 26,2023-08-06,02:00:00,15,6,9,FMN 12 Statielei
660,Statielei 26,2023-08-06,03:00:00,8,3,5,FMN 12 Statielei
660,Statielei 26,2023-08-06,04:00:00,3,1,2,FMN 12 Statielei
660,Statielei 26,2023-08-06,05:00:00,4,1,3,FMN 12 Statielei
660,Statielei 26,2023-08-06,06:00:00,6,4,2,FMN 12 Statielei
660,Statielei 26,2023-08-06,07:00:00,2,1,1,FMN 12 Statielei
660,Statielei 26,2023-08-06,08:00:00,10,3,7,FMN 12 Statielei
660,Statielei 26,2023-08-06,09:00:00,16,6,10,FMN 12 Statielei
660,Statielei 26,2023-08-06,10:00:00,36,20,16,FMN 12 Statielei
660,Statielei 26,2023-08-06,11:00:00,40,20,20,FMN 12 Statielei
660,Statielei 26,2023-08-06,12:00:00,32,22,10,FMN 12 Statielei
660,Statielei 26,2023-08-06,13:00:00,45,25,20,FMN 12 Statielei
660,Statielei 26,2023-08-06,14:00:00,33,18,15,FMN 12 Statielei
660,Statielei 26,2023-08-06,15:00:00,23,11,12,FMN 12 Statielei
660,Statielei 26,2023-08-06,16:00:00,15,9,6,FMN 12 Statielei
660,Statielei 26,2023-08-06,17:00:00,20,11,9,FMN 12 Statielei
660,Statielei 26,2023-08-06,18:00:00,46,24,22,FMN 12 Statielei
660,Statielei 26,2023-08-06,19:00:00,68,36,32,FMN 12 Statielei
660,Statielei 26,2023-08-06,20:00:00,50,24,26,FMN 12 Statielei
660,Statielei 26,2023-08-06,21:00:00,46,25,21,FMN 12 Statielei
660,Statielei 26,2023-08-06,22:00:00,39,13,26,FMN 12 Statielei
660,Statielei 26,2023-08-06,23:00:00,21,4,17,FMN 12 Statielei
660,Statielei 26,2023-08-07,00:00:00,15,1,14,FMN 12 Statielei
660,Statielei 26,2023-08-07,01:00:00,5,2,3,FMN 12 Statielei
660,Statielei 26,2023-08-07,02:00:00,4,1,3,FMN 12 Statielei
660,Statielei 26,2023-08-07,03:00:00,7,2,5,FMN 12 Statielei
660,Statielei 26,2023-08-07,04:00:00,4,2,2,FMN 12 Statielei
660,Statielei 26,2023-08-07,05:00:00,15,7,8,FMN 12 Statielei
660,Statielei 26,2023-08-07,06:00:00,23,9,14,FMN 12 Statielei
660,Statielei 26,2023-08-07,07:00:00,58,25,33,FMN 12 Statielei
660,Statielei 26,2023-08-07,08:00:00,84,40,44,FMN 12 Statielei
660,Statielei 26,2023-08-07,09:00:00,89,59,30,FMN 12 Statielei
660,Statielei 26,2023-08-07,10:00:00,63,33,30,FMN 12 Statielei
660,Statielei 26,2023-08-07,11:00:00,71,46,25,FMN 12 Statielei
660,Statielei 26,2023-08-07,12:00:00,78,40,38,FMN 12 Statielei
660,Statielei 26,2023-08-07,13:00:00,98,46,52,FMN 12 Statielei
660,Statielei 26,2023-08-07,14:00:00,78,43,35,FMN 12 Statielei
660,Statielei 26,2023-08-07,15:00:00,98,62,36,FMN 12 Statielei
660,Statielei 26,2023-08-07,16:00:00,139,65,74,FMN 12 Statielei
660,Statielei 26,2023-08-07,17:00:00,147,64,83,FMN 12 Statielei
660,Statielei 26,2023-08-07,18:00:00,132,73,59,FMN 12 Statielei
660,Statielei 26,2023-08-07,19:00:00,114,50,64,FMN 12 Statielei
660,Statielei 26,2023-08-07,20:00:00,80,29,51,FMN 12 Statielei
660,Statielei 26,2023-08-07,21:00:00,61,35,26,FMN 12 Statielei
660,Statielei 26,2023-08-07,22:00:00,68,31,37,FMN 12 Statielei
660,Statielei 26,2023-08-07,23:00:00,49,37,12,FMN 12 Statielei
660,Statielei 26,2023-08-08,00:00:00,40,24,16,FMN 12 Statielei
660,Statielei 26,2023-08-08,01:00:00,10,4,6,FMN 12 Statielei
660,Statielei 26,2023-08-08,02:00:00,4,2,2,FMN 12 Statielei
660,Statielei 26,2023-08-08,03:00:00,1,0,1,FMN 12 Statielei
660,Statielei 26,2023-08-08,04:00:00,6,2,4,FMN 12 Statielei
660,Statielei 26,2023-08-08,05:00:00,13,6,7,FMN 12 Statielei
660,Statielei 26,2023-08-08,06:00:00,23,14,9,FMN 12 Statielei
660,Statielei 26,2023-08-08,07:00:00,63,26,37,FMN 12 Statielei
660,Statielei 26,2023-08-08,08:00:00,99,42,57,FMN 12 Statielei
660,Statielei 26,2023-08-08,09:00:00,94,62,32,FMN 12 Statielei
660,Statielei 26,2023-08-08,10:00:00,49,30,19,FMN 12 Statielei
660,Statielei 26,2023-08-08,11:00:00,58,28,30,FMN 12 Statielei
660,Statielei 26,2023-08-08,12:00:00,83,47,36,FMN 12 Statielei
660,Statielei 26,2023-08-08,13:00:00,88,42,46,FMN 12 Statielei
660,Statielei 26,2023-08-08,14:00:00,82,38,44,FMN 12 Statielei
660,Statielei 26,2023-08-08,15:00:00,95,41,54,FMN 12 Statielei
660,Statielei 26,2023-08-08,16:00:00,156,78,78,FMN 12 Statielei
660,Statielei 26,2023-08-08,17:00:00,149,73,76,FMN 12 Statielei
660,Statielei 26,2023-08-08,18:00:00,131,73,58,FMN 12 Statielei
660,Statielei 26,2023-08-08,19:00:00,75,34,41,FMN 12 Statielei
660,Statielei 26,2023-08-08,20:00:00,52,22,30,FMN 12 Statielei
660,Statielei 26,2023-08-08,21:00:00,33,12,21,FMN 12 Statielei
660,Statielei 26,2023-08-08,22:00:00,44,18,26,FMN 12 Statielei
660,Statielei 26,2023-08-08,23:00:00,30,19,11,FMN 12 Statielei
660,Statielei 26,2023-08-09,00:00:00,31,14,17,FMN 12 Statielei
660,Statielei 26,2023-08-09,01:00:00,13,10,3,FMN 12 Statielei
660,Statielei 26,2023-08-09,02:00:00,3,2,1,FMN 12 Statielei
660,Statielei 26,2023-08-09,03:00:00,8,1,7,FMN 12 Statielei
660,Statielei 26,2023-08-09,04:00:00,10,5,5,FMN 12 Statielei
660,Statielei 26,2023-08-09,05:00:00,16,9,7,FMN 12 Statielei
660,Statielei 26,2023-08-09,06:00:00,22,6,16,FMN 12 Statielei
660,Statielei 26,2023-08-09,07:00:00,60,30,30,FMN 12 Statielei
660,Statielei 26,2023-08-09,08:00:00,104,63,41,FMN 12 Statielei
660,Statielei 26,2023-08-09,09:00:00,71,42,29,FMN 12 Statielei
660,Statielei 26,2023-08-09,10:00:00,65,36,29,FMN 12 Statielei
660,Statielei 26,2023-08-09,11:00:00,78,50,28,FMN 12 Statielei
660,Statielei 26,2023-08-09,12:00:00,93,57,36,FMN 12 Statielei
660,Statielei 26,2023-08-09,13:00:00,113,54,59,FMN 12 Statielei
660,Statielei 26,2023-08-09,14:00:00,96,52,44,FMN 12 Statielei
660,Statielei 26,2023-08-09,15:00:00,98,43,55,FMN 12 Statielei
660,Statielei 26,2023-08-09,16:00:00,169,77,92,FMN 12 Statielei
660,Statielei 26,2023-08-09,17:00:00,169,99,70,FMN 12 Statielei
660,Statielei 26,2023-08-09,18:00:00,150,69,81,FMN 12 Statielei
660,Statielei 26,2023-08-09,19:00:00,148,64,84,FMN 12 Statielei
660,Statielei 26,2023-08-09,20:00:00,76,29,47,FMN 12 Statielei
660,Statielei 26,2023-08-09,21:00:00,93,52,41,FMN 12 Statielei
660,Statielei 26,2023-08-09,22:00:00,73,37,36,FMN 12 Statielei
660,Statielei 26,2023-08-09,23:00:00,53,31,22,FMN 12 Statielei
660,Statielei 26,2023-08-10,00:00:00,43,24,19,FMN 12 Statielei
660,Statielei 26,2023-08-10,01:00:00,15,8,7,FMN 12 Statielei
660,Statielei 26,2023-08-10,02:00:00,7,5,2,FMN 12 Statielei
660,Statielei 26,2023-08-10,03:00:00,7,1,6,FMN 12 Statielei
660,Statielei 26,2023-08-10,04:00:00,9,3,6,FMN 12 Statielei
660,Statielei 26,2023-08-10,05:00:00,13,8,5,FMN 12 Statielei
660,Statielei 26,2023-08-10,06:00:00,28,13,15,FMN 12 Statielei
660,Statielei 26,2023-08-10,07:00:00,70,36,34,FMN 12 Statielei
660,Statielei 26,2023-08-10,08:00:00,121,70,51,FMN 12 Statielei
660,Statielei 26,2023-08-10,09:00:00,75,50,25,FMN 12 Statielei
660,Statielei 26,2023-08-10,10:00:00,80,43,37,FMN 12 Statielei
660,Statielei 26,2023-08-10,11:00:00,88,33,55,FMN 12 Statielei
660,Statielei 26,2023-08-10,12:00:00,91,46,45,FMN 12 Statielei
660,Statielei 26,2023-08-10,13:00:00,85,34,51,FMN 12 Statielei
660,Statielei 26,2023-08-10,14:00:00,113,61,52,FMN 12 Statielei
660,Statielei 26,2023-08-10,15:00:00,109,52,57,FMN 12 Statielei
660,Statielei 26,2023-08-10,16:00:00,148,79,69,FMN 12 Statielei
660,Statielei 26,2023-08-10,17:00:00,187,81,106,FMN 12 Statielei
660,Statielei 26,2023-08-10,18:00:00,206,88,118,FMN 12 Statielei
660,Statielei 26,2023-08-10,19:00:00,135,65,70,FMN 12 Statielei
660,Statielei 26,2023-08-10,20:00:00,135,74,61,FMN 12 Statielei
660,Statielei 26,2023-08-10,21:00:00,138,89,49,FMN 12 Statielei
660,Statielei 26,2023-08-10,22:00:00,71,35,36,FMN 12 Statielei
660,Statielei 26,2023-08-10,23:00:00,58,27,31,FMN 12 Statielei
660,Statielei 26,2023-08-11,00:00:00,48,26,22,FMN 12 Statielei
660,Statielei 26,2023-08-11,01:00:00,21,11,10,FMN 12 Statielei
660,Statielei 26,2023-08-11,02:00:00,15,5,10,FMN 12 Statielei
660,Statielei 26,2023-08-11,03:00:00,9,3,6,FMN 12 Statielei
660,Statielei 26,2023-08-11,04:00:00,6,2,4,FMN 12 Statielei
660,Statielei 26,2023-08-11,05:00:00,16,8,8,FMN 12 Statielei
660,Statielei 26,2023-08-11,06:00:00,26,10,16,FMN 12 Statielei
660,Statielei 26,2023-08-11,07:00:00,53,28,25,FMN 12 Statielei
660,Statielei 26,2023-08-11,08:00:00,101,47,54,FMN 12 Statielei
660,Statielei 26,2023-08-11,09:00:00,82,52,30,FMN 12 Statielei
660,Statielei 26,2023-08-11,10:00:00,90,51,39,FMN 12 Statielei
660,Statielei 26,2023-08-11,11:00:00,82,43,39,FMN 12 Statielei
660,Statielei 26,2023-08-11,12:00:00,110,49,61,FMN 12 Statielei
660,Statielei 26,2023-08-11,13:00:00,100,43,57,FMN 12 Statielei
660,Statielei 26,2023-08-11,14:00:00,111,52,59,FMN 12 Statielei
660,Statielei 26,2023-08-11,15:00:00,127,70,57,FMN 12 Statielei
660,Statielei 26,2023-08-11,16:00:00,149,80,69,FMN 12 Statielei
660,Statielei 26,2023-08-11,17:00:00,149,74,75,FMN 12 Statielei
660,Statielei 26,2023-08-11,18:00:00,167,71,96,FMN 12 Statielei
660,Statielei 26,2023-08-11,19:00:00,147,64,83,FMN 12 Statielei
660,Statielei 26,2023-08-11,20:00:00,92,46,46,FMN 12 Statielei
660,Statielei 26,2023-08-11,21:00:00,64,38,26,FMN 12 Statielei
660,Statielei 26,2023-08-11,22:00:00,59,33,26,FMN 12 Statielei
660,Statielei 26,2023-08-11,23:00:00,93,66,27,FMN 12 Statielei
660,Statielei 26,2023-08-12,00:00:00,60,32,28,FMN 12 Statielei
660,Statielei 26,2023-08-12,01:00:00,19,9,10,FMN 12 Statielei
660,Statielei 26,2023-08-12,02:00:00,24,14,10,FMN 12 Statielei
660,Statielei 26,2023-08-12,03:00:00,14,9,5,FMN 12 Statielei
660,Statielei 26,2023-08-12,04:00:00,9,2,7,FMN 12 Statielei
660,Statielei 26,2023-08-12,05:00:00,2,1,1,FMN 12 Statielei
660,Statielei 26,2023-08-12,06:00:00,3,2,1,FMN 12 Statielei
660,Statielei 26,2023-08-12,07:00:00,22,9,13,FMN 12 Statielei
660,Statielei 26,2023-08-12,08:00:00,20,10,10,FMN 12 Statielei
660,Statielei 26,2023-08-12,09:00:00,39,20,19,FMN 12 Statielei
660,Statielei 26,2023-08-12,10:00:00,57,28,29,FMN 12 Statielei
660,Statielei 26,2023-08-12,11:00:00,56,34,22,FMN 12 Statielei
660,Statielei 26,2023-08-12,12:00:00,85,49,36,FMN 12 Statielei
660,Statielei 26,2023-08-12,13:00:00,91,58,33,FMN 12 Statielei
660,Statielei 26,2023-08-12,14:00:00,105,61,44,FMN 12 Statielei
660,Statielei 26,2023-08-12,15:00:00,98,50,48,FMN 12 Statielei
660,Statielei 26,2023-08-12,16:00:00,85,43,42,FMN 12 Statielei
660,Statielei 26,2023-08-12,17:00:00,110,55,55,FMN 12 Statielei
660,Statielei 26,2023-08-12,18:00:00,124,62,62,FMN 12 Statielei
660,Statielei 26,2023-08-12,19:00:00,94,30,64,FMN 12 Statielei
660,Statielei 26,2023-08-12,20:00:00,126,77,49,FMN 12 Statielei
660,Statielei 26,2023-08-12,21:00:00,79,48,31,FMN 12 Statielei
660,Statielei 26,2023-08-12,22:00:00,69,25,44,FMN 12 Statielei
660,Statielei 26,2023-08-12,23:00:00,47,14,33,FMN 12 Statielei
660,Statielei 26,2023-08-13,00:00:00,36,19,17,FMN 12 Statielei
660,Statielei 26,2023-08-13,01:00:00,13,5,8,FMN 12 Statielei
660,Statielei 26,2023-08-13,02:00:00,18,7,11,FMN 12 Statielei
660,Statielei 26,2023-08-13,03:00:00,15,4,11,FMN 12 Statielei
660,Statielei 26,2023-08-13,04:00:00,6,4,2,FMN 12 Statielei
660,Statielei 26,2023-08-13,05:00:00,9,3,6,FMN 12 Statielei
660,Statielei 26,2023-08-13,06:00:00,10,5,5,FMN 12 Statielei
660,Statielei 26,2023-08-13,07:00:00,14,6,8,FMN 12 Statielei
660,Statielei 26,2023-08-13,08:00:00,17,3,14,FMN 12 Statielei
660,Statielei 26,2023-08-13,09:00:00,54,24,30,FMN 12 Statielei
660,Statielei 26,2023-08-13,10:00:00,75,22,53,FMN 12 Statielei
660,Statielei 26,2023-08-13,11:00:00,67,20,47,FMN 12 Statielei
660,Statielei 26,2023-08-13,12:00:00,98,55,43,FMN 12 Statielei
660,Statielei 26,2023-08-13,13:00:00,81,42,39,FMN 12 Statielei
660,Statielei 26,2023-08-13,14:00:00,117,50,67,FMN 12 Statielei
660,Statielei 26,2023-08-13,15:00:00,124,69,55,FMN 12 Statielei
660,Statielei 26,2023-08-13,16:00:00,91,47,44,FMN 12 Statielei
660,Statielei 26,2023-08-13,17:00:00,95,47,48,FMN 12 Statielei
660,Statielei 26,2023-08-13,18:00:00,103,61,42,FMN 12 Statielei
660,Statielei 26,2023-08-13,19:00:00,66,39,27,FMN 12 Statielei
660,Statielei 26,2023-08-13,20:00:00,86,44,42,FMN 12 Statielei
660,Statielei 26,2023-08-13,21:00:00,86,44,42,FMN 12 Statielei
660,Statielei 26,2023-08-13,22:00:00,54,33,21,FMN 12 Statielei
660,Statielei 26,2023-08-13,23:00:00,32,9,23,FMN 12 Statielei
660,Statielei 26,2023-08-14,00:00:00,20,5,15,FMN 12 Statielei
660,Statielei 26,2023-08-14,01:00:00,18,4,14,FMN 12 Statielei
660,Statielei 26,2023-08-14,02:00:00,7,4,3,FMN 12 Statielei
660,Statielei 26,2023-08-14,03:00:00,4,1,3,FMN 12 Statielei
660,Statielei 26,2023-08-14,04:00:00,4,3,1,FMN 12 Statielei
660,Statielei 26,2023-08-14,05:00:00,15,8,7,FMN 12 Statielei
660,Statielei 26,2023-08-14,06:00:00,14,8,6,FMN 12 Statielei
660,Statielei 26,2023-08-14,07:00:00,40,14,26,FMN 12 Statielei
660,Statielei 26,2023-08-14,08:00:00,61,29,32,FMN 12 Statielei
660,Statielei 26,2023-08-14,09:00:00,64,37,27,FMN 12 Statielei
660,Statielei 26,2023-08-14,10:00:00,74,33,41,FMN 12 Statielei
660,Statielei 26,2023-08-14,11:00:00,73,35,38,FMN 12 Statielei
660,Statielei 26,2023-08-14,12:00:00,80,40,40,FMN 12 Statielei
660,Statielei 26,2023-08-14,13:00:00,100,52,48,FMN 12 Statielei
660,Statielei 26,2023-08-14,14:00:00,120,62,58,FMN 12 Statielei
660,Statielei 26,2023-08-14,15:00:00,99,44,55,FMN 12 Statielei
660,Statielei 26,2023-08-14,16:00:00,137,75,62,FMN 12 Statielei
660,Statielei 26,2023-08-14,17:00:00,164,84,80,FMN 12 Statielei
660,Statielei 26,2023-08-14,18:00:00,128,71,57,FMN 12 Statielei
660,Statielei 26,2023-08-14,19:00:00,106,62,44,FMN 12 Statielei
660,Statielei 26,2023-08-14,20:00:00,99,66,33,FMN 12 Statielei
660,Statielei 26,2023-08-14,21:00:00,79,49,30,FMN 12 Statielei
660,Statielei 26,2023-08-14,22:00:00,62,33,29,FMN 12 Statielei
660,Statielei 26,2023-08-14,23:00:00,45,18,27,FMN 12 Statielei
660,Statielei 26,2023-08-15,00:00:00,20,7,13,FMN 12 Statielei
660,Statielei 26,2023-08-15,01:00:00,15,8,7,FMN 12 Statielei
660,Statielei 26,2023-08-15,02:00:00,10,3,7,FMN 12 Statielei
660,Statielei 26,2023-08-15,03:00:00,8,2,6,FMN 12 Statielei
660,Statielei 26,2023-08-15,04:00:00,7,5,2,FMN 12 Statielei
660,Statielei 26,2023-08-15,05:00:00,5,5,0,FMN 12 Statielei
660,Statielei 26,2023-08-15,06:00:00,14,9,5,FMN 12 Statielei
660,Statielei 26,2023-08-15,07:00:00,14,6,8,FMN 12 Statielei
660,Statielei 26,2023-08-15,08:00:00,37,18,19,FMN 12 Statielei
660,Statielei 26,2023-08-15,09:00:00,70,36,34,FMN 12 Statielei
660,Statielei 26,2023-08-15,10:00:00,85,42,43,FMN 12 Statielei
660,Statielei 26,2023-08-15,11:00:00,95,55,40,FMN 12 Statielei
660,Statielei 26,2023-08-15,12:00:00,78,44,34,FMN 12 Statielei
660,Statielei 26,2023-08-15,13:00:00,112,62,50,FMN 12 Statielei
660,Statielei 26,2023-08-15,14:00:00,127,68,59,FMN 12 Statielei
660,Statielei 26,2023-08-15,15:00:00,117,49,68,FMN 12 Statielei
660,Statielei 26,2023-08-15,16:00:00,85,46,39,FMN 12 Statielei
660,Statielei 26,2023-08-15,17:00:00,100,52,48,FMN 12 Statielei
660,Statielei 26,2023-08-15,18:00:00,100,57,43,FMN 12 Statielei
660,Statielei 26,2023-08-15,19:00:00,107,56,51,FMN 12 Statielei
660,Statielei 26,2023-08-15,20:00:00,109,54,55,FMN 12 Statielei
660,Statielei 26,2023-08-15,21:00:00,73,48,25,FMN 12 Statielei
660,Statielei 26,2023-08-15,22:00:00,55,26,29,FMN 12 Statielei
660,Statielei 26,2023-08-15,23:00:00,40,12,28,FMN 12 Statielei
660,Statielei 26,2023-08-16,00:00:00,23,6,17,FMN 12 Statielei
660,Statielei 26,2023-08-16,01:00:00,13,5,8,FMN 12 Statielei
660,Statielei 26,2023-08-16,02:00:00,6,0,6,FMN 12 Statielei
660,Statielei 26,2023-08-16,03:00:00,7,3,4,FMN 12 Statielei
660,Statielei 26,2023-08-16,04:00:00,14,7,7,FMN 12 Statielei
660,Statielei 26,2023-08-16,05:00:00,11,6,5,FMN 12 Statielei
660,Statielei 26,2023-08-16,06:00:00,24,9,15,FMN 12 Statielei
660,Statielei 26,2023-08-16,07:00:00,68,32,36,FMN 12 Statielei
660,Statielei 26,2023-08-16,08:00:00,117,68,49,FMN 12 Statielei
660,Statielei 26,2023-08-16,09:00:00,95,50,45,FMN 12 Statielei
660,Statielei 26,2023-08-16,10:00:00,76,45,31,FMN 12 Statielei
660,Statielei 26,2023-08-16,11:00:00,95,53,42,FMN 12 Statielei
660,Statielei 26,2023-08-16,12:00:00,103,57,46,FMN 12 Statielei
660,Statielei 26,2023-08-16,13:00:00,116,60,56,FMN 12 Statielei
660,Statielei 26,2023-08-16,14:00:00,102,55,47,FMN 12 Statielei
660,Statielei 26,2023-08-16,15:00:00,137,68,69,FMN 12 Statielei
660,Statielei 26,2023-08-16,16:00:00,165,83,82,FMN 12 Statielei
660,Statielei 26,2023-08-16,17:00:00,167,79,88,FMN 12 Statielei
660,Statielei 26,2023-08-16,18:00:00,176,93,83,FMN 12 Statielei
660,Statielei 26,2023-08-16,19:00:00,92,51,41,FMN 12 Statielei
660,Statielei 26,2023-08-16,20:00:00,118,63,55,FMN 12 Statielei
660,Statielei 26,2023-08-16,21:00:00,83,51,32,FMN 12 Statielei
660,Statielei 26,2023-08-16,22:00:00,53,27,26,FMN 12 Statielei
660,Statielei 26,2023-08-16,23:00:00,41,13,28,FMN 12 Statielei
660,Statielei 26,2023-08-17,00:00:00,34,10,24,FMN 12 Statielei
660,Statielei 26,2023-08-17,01:00:00,8,4,4,FMN 12 Statielei
660,Statielei 26,2023-08-17,02:00:00,8,4,4,FMN 12 Statielei
660,Statielei 26,2023-08-17,03:00:00,2,1,1,FMN 12 Statielei
660,Statielei 26,2023-08-17,04:00:00,14,5,9,FMN 12 Statielei
660,Statielei 26,2023-08-17,05:00:00,13,6,7,FMN 12 Statielei
660,Statielei 26,2023-08-17,06:00:00,31,12,19,FMN 12 Statielei
660,Statielei 26,2023-08-17,07:00:00,65,29,36,FMN 12 Statielei
660,Statielei 26,2023-08-17,08:00:00,131,78,53,FMN 12 Statielei
660,Statielei 26,2023-08-17,09:00:00,91,48,43,FMN 12 Statielei
660,Statielei 26,2023-08-17,10:00:00,82,40,42,FMN 12 Statielei
660,Statielei 26,2023-08-17,11:00:00,85,42,43,FMN 12 Statielei
660,Statielei 26,2023-08-17,12:00:00,109,62,47,FMN 12 Statielei
660,Statielei 26,2023-08-17,13:00:00,94,43,51,FMN 12 Statielei
660,Statielei 26,2023-08-17,14:00:00,104,59,45,FMN 12 Statielei
660,Statielei 26,2023-08-17,15:00:00,107,62,45,FMN 12 Statielei
660,Statielei 26,2023-08-17,16:00:00,150,81,69,FMN 12 Statielei
660,Statielei 26,2023-08-17,17:00:00,150,71,79,FMN 12 Statielei
660,Statielei 26,2023-08-17,18:00:00,170,97,73,FMN 12 Statielei
660,Statielei 26,2023-08-17,19:00:00,122,69,53,FMN 12 Statielei
660,Statielei 26,2023-08-17,20:00:00,90,50,40,FMN 12 Statielei
660,Statielei 26,2023-08-17,21:00:00,102,51,51,FMN 12 Statielei
660,Statielei 26,2023-08-17,22:00:00,74,38,36,FMN 12 Statielei
660,Statielei 26,2023-08-17,23:00:00,44,15,29,FMN 12 Statielei
660,Statielei 26,2023-08-18,00:00:00,33,10,23,FMN 12 Statielei
660,Statielei 26,2023-08-18,01:00:00,22,9,13,FMN 12 Statielei
660,Statielei 26,2023-08-18,02:00:00,10,2,8,FMN 12 Statielei
660,Statielei 26,2023-08-18,03:00:00,10,3,7,FMN 12 Statielei
660,Statielei 26,2023-08-18,04:00:00,13,6,7,FMN 12 Statielei
660,Statielei 26,2023-08-18,05:00:00,17,9,8,FMN 12 Statielei
660,Statielei 26,2023-08-18,06:00:00,19,10,9,FMN 12 Statielei
660,Statielei 26,2023-08-18,07:00:00,59,25,34,FMN 12 Statielei
660,Statielei 26,2023-08-18,08:00:00,98,57,41,FMN 12 Statielei
660,Statielei 26,2023-08-18,09:00:00,84,48,36,FMN 12 Statielei
660,Statielei 26,2023-08-18,10:00:00,79,45,34,FMN 12 Statielei
660,Statielei 26,2023-08-18,11:00:00,71,39,32,FMN 12 Statielei
660,Statielei 26,2023-08-18,12:00:00,81,39,42,FMN 12 Statielei
660,Statielei 26,2023-08-18,13:00:00,122,68,54,FMN 12 Statielei
660,Statielei 26,2023-08-18,14:00:00,142,68,74,FMN 12 Statielei
660,Statielei 26,2023-08-18,15:00:00,160,76,84,FMN 12 Statielei
660,Statielei 26,2023-08-18,16:00:00,144,84,60,FMN 12 Statielei
660,Statielei 26,2023-08-18,17:00:00,191,100,91,FMN 12 Statielei
660,Statielei 26,2023-08-18,18:00:00,150,75,75,FMN 12 Statielei
660,Statielei 26,2023-08-18,19:00:00,152,71,81,FMN 12 Statielei
660,Statielei 26,2023-08-18,20:00:00,135,90,45,FMN 12 Statielei
660,Statielei 26,2023-08-18,21:00:00,96,54,42,FMN 12 Statielei
660,Statielei 26,2023-08-18,22:00:00,85,47,38,FMN 12 Statielei
660,Statielei 26,2023-08-18,23:00:00,104,50,54,FMN 12 Statielei
660,Statielei 26,2023-08-19,00:00:00,53,19,34,FMN 12 Statielei
660,Statielei 26,2023-08-19,01:00:00,27,11,16,FMN 12 Statielei
660,Statielei 26,2023-08-19,02:00:00,34,8,26,FMN 12 Statielei
660,Statielei 26,2023-08-19,03:00:00,9,2,7,FMN 12 Statielei
660,Statielei 26,2023-08-19,04:00:00,4,1,3,FMN 12 Statielei
660,Statielei 26,2023-08-19,05:00:00,12,6,6,FMN 12 Statielei
660,Statielei 26,2023-08-19,06:00:00,17,7,10,FMN 12 Statielei
660,Statielei 26,2023-08-19,07:00:00,22,6,16,FMN 12 Statielei
660,Statielei 26,2023-08-19,08:00:00,39,21,18,FMN 12 Statielei
660,Statielei 26,2023-08-19,09:00:00,62,37,25,FMN 12 Statielei
660,Statielei 26,2023-08-19,10:00:00,88,41,47,FMN 12 Statielei
660,Statielei 26,2023-08-19,11:00:00,94,52,42,FMN 12 Statielei
660,Statielei 26,2023-08-19,12:00:00,75,47,28,FMN 12 Statielei
660,Statielei 26,2023-08-19,13:00:00,134,63,71,FMN 12 Statielei
660,Statielei 26,2023-08-19,14:00:00,112,66,46,FMN 12 Statielei
660,Statielei 26,2023-08-19,15:00:00,127,50,77,FMN 12 Statielei
660,Statielei 26,2023-08-19,16:00:00,109,54,55,FMN 12 Statielei
660,Statielei 26,2023-08-19,17:00:00,149,84,65,FMN 12 Statielei
660,Statielei 26,2023-08-19,18:00:00,151,72,79,FMN 12 Statielei
660,Statielei 26,2023-08-19,19:00:00,134,66,68,FMN 12 Statielei
660,Statielei 26,2023-08-19,20:00:00,113,59,54,FMN 12 Statielei
660,Statielei 26,2023-08-19,21:00:00,96,55,41,FMN 12 Statielei
660,Statielei 26,2023-08-19,22:00:00,105,61,44,FMN 12 Statielei
660,Statielei 26,2023-08-19,23:00:00,52,24,28,FMN 12 Statielei
660,Statielei 26,2023-08-20,00:00:00,52,25,27,FMN 12 Statielei
660,Statielei 26,2023-08-20,01:00:00,43,21,22,FMN 12 Statielei
660,Statielei 26,2023-08-20,02:00:00,24,7,17,FMN 12 Statielei
660,Statielei 26,2023-08-20,03:00:00,8,2,6,FMN 12 Statielei
660,Statielei 26,2023-08-20,04:00:00,9,4,5,FMN 12 Statielei
660,Statielei 26,2023-08-20,05:00:00,15,3,12,FMN 12 Statielei
660,Statielei 26,2023-08-20,06:00:00,11,4,7,FMN 12 Statielei
660,Statielei 26,2023-08-20,07:00:00,19,7,12,FMN 12 Statielei
660,Statielei 26,2023-08-20,08:00:00,33,16,17,FMN 12 Statielei
660,Statielei 26,2023-08-20,09:00:00,61,25,36,FMN 12 Statielei
660,Statielei 26,2023-08-20,10:00:00,69,41,28,FMN 12 Statielei
660,Statielei 26,2023-08-20,11:00:00,110,51,59,FMN 12 Statielei
660,Statielei 26,2023-08-20,12:00:00,91,58,33,FMN 12 Statielei
660,Statielei 26,2023-08-20,13:00:00,129,65,64,FMN 12 Statielei
660,Statielei 26,2023-08-20,14:00:00,121,58,63,FMN 12 Statielei
660,Statielei 26,2023-08-20,15:00:00,109,52,57,FMN 12 Statielei
660,Statielei 26,2023-08-20,16:00:00,150,71,79,FMN 12 Statielei
660,Statielei 26,2023-08-20,17:00:00,123,70,53,FMN 12 Statielei
660,Statielei 26,2023-08-20,18:00:00,135,67,68,FMN 12 Statielei
660,Statielei 26,2023-08-20,19:00:00,145,72,73,FMN 12 Statielei
660,Statielei 26,2023-08-20,20:00:00,111,65,46,FMN 12 Statielei
660,Statielei 26,2023-08-20,21:00:00,104,57,47,FMN 12 Statielei
660,Statielei 26,2023-08-20,22:00:00,103,63,40,FMN 12 Statielei
660,Statielei 26,2023-08-20,23:00:00,57,32,25,FMN 12 Statielei
660,Statielei 26,2023-08-21,00:00:00,34,16,18,FMN 12 Statielei
660,Statielei 26,2023-08-21,01:00:00,14,7,7,FMN 12 Statielei
660,Statielei 26,2023-08-21,02:00:00,3,0,3,FMN 12 Statielei
660,Statielei 26,2023-08-21,03:00:00,8,4,4,FMN 12 Statielei
660,Statielei 26,2023-08-21,04:00:00,9,4,5,FMN 12 Statielei
660,Statielei 26,2023-08-21,05:00:00,16,6,10,FMN 12 Statielei
660,Statielei 26,2023-08-21,06:00:00,30,14,16,FMN 12 Statielei
660,Statielei 26,2023-08-21,07:00:00,69,24,45,FMN 12 Statielei
660,Statielei 26,2023-08-21,08:00:00,150,89,61,FMN 12 Statielei
660,Statielei 26,2023-08-21,09:00:00,121,75,46,FMN 12 Statielei
660,Statielei 26,2023-08-21,10:00:00,92,49,43,FMN 12 Statielei
660,Statielei 26,2023-08-21,11:00:00,94,60,34,FMN 12 Statielei
660,Statielei 26,2023-08-21,12:00:00,94,54,40,FMN 12 Statielei
660,Statielei 26,2023-08-21,13:00:00,99,52,47,FMN 12 Statielei
660,Statielei 26,2023-08-21,14:00:00,97,51,46,FMN 12 Statielei
660,Statielei 26,2023-08-21,15:00:00,124,71,53,FMN 12 Statielei
660,Statielei 26,2023-08-21,16:00:00,192,96,96,FMN 12 Statielei
660,Statielei 26,2023-08-21,17:00:00,189,90,99,FMN 12 Statielei
660,Statielei 26,2023-08-21,18:00:00,172,83,89,FMN 12 Statielei
660,Statielei 26,2023-08-21,19:00:00,126,59,67,FMN 12 Statielei
660,Statielei 26,2023-08-21,20:00:00,131,74,57,FMN 12 Statielei
660,Statielei 26,2023-08-21,21:00:00,117,57,60,FMN 12 Statielei
660,Statielei 26,2023-08-21,22:00:00,61,30,31,FMN 12 Statielei
660,Statielei 26,2023-08-21,23:00:00,45,13,32,FMN 12 Statielei
660,Statielei 26,2023-08-22,00:00:00,22,5,17,FMN 12 Statielei
660,Statielei 26,2023-08-22,01:00:00,6,4,2,FMN 12 Statielei
660,Statielei 26,2023-08-22,02:00:00,10,4,6,FMN 12 Statielei
660,Statielei 26,2023-08-22,03:00:00,9,2,7,FMN 12 Statielei
660,Statielei 26,2023-08-22,04:00:00,17,9,8,FMN 12 Statielei
660,Statielei 26,2023-08-22,05:00:00,22,9,13,FMN 12 Statielei
660,Statielei 26,2023-08-22,06:00:00,33,17,16,FMN 12 Statielei
660,Statielei 26,2023-08-22,07:00:00,80,38,42,FMN 12 Statielei
660,Statielei 26,2023-08-22,08:00:00,166,96,70,FMN 12 Statielei
660,Statielei 26,2023-08-22,09:00:00,135,81,54,FMN 12 Statielei
660,Statielei 26,2023-08-22,10:00:00,82,42,40,FMN 12 Statielei
660,Statielei 26,2023-08-22,11:00:00,89,51,38,FMN 12 Statielei
660,Statielei 26,2023-08-22,12:00:00,103,54,49,FMN 12 Statielei
660,Statielei 26,2023-08-22,13:00:00,132,81,51,FMN 12 Statielei
660,Statielei 26,2023-08-22,14:00:00,108,49,59,FMN 12 Statielei
660,Statielei 26,2023-08-22,15:00:00,134,60,74,FMN 12 Statielei
660,Statielei 26,2023-08-22,16:00:00,183,80,103,FMN 12 Statielei
660,Statielei 26,2023-08-22,17:00:00,223,112,111,FMN 12 Statielei
660,Statielei 26,2023-08-22,18:00:00,183,87,96,FMN 12 Statielei
660,Statielei 26,2023-08-22,19:00:00,181,72,109,FMN 12 Statielei
660,Statielei 26,2023-08-22,20:00:00,115,58,57,FMN 12 Statielei
660,Statielei 26,2023-08-22,21:00:00,115,61,54,FMN 12 Statielei
660,Statielei 26,2023-08-22,22:00:00,81,43,38,FMN 12 Statielei
660,Statielei 26,2023-08-22,23:00:00,101,71,30,FMN 12 Statielei
660,Statielei 26,2023-08-23,00:00:00,50,29,21,FMN 12 Statielei
660,Statielei 26,2023-08-23,01:00:00,17,10,7,FMN 12 Statielei
660,Statielei 26,2023-08-23,02:00:00,13,6,7,FMN 12 Statielei
660,Statielei 26,2023-08-23,03:00:00,9,2,7,FMN 12 Statielei
660,Statielei 26,2023-08-23,04:00:00,15,10,5,FMN 12 Statielei
660,Statielei 26,2023-08-23,05:00:00,21,14,7,FMN 12 Statielei
660,Statielei 26,2023-08-23,06:00:00,23,12,11,FMN 12 Statielei
660,Statielei 26,2023-08-23,07:00:00,65,30,35,FMN 12 Statielei
660,Statielei 26,2023-08-23,08:00:00,163,95,68,FMN 12 Statielei
660,Statielei 26,2023-08-23,09:00:00,125,69,56,FMN 12 Statielei
660,Statielei 26,2023-08-23,10:00:00,87,49,38,FMN 12 Statielei
660,Statielei 26,2023-08-23,11:00:00,97,62,35,FMN 12 Statielei
660,Statielei 26,2023-08-23,12:00:00,119,67,52,FMN 12 Statielei
660,Statielei 26,2023-08-23,13:00:00,117,54,63,FMN 12 Statielei
660,Statielei 26,2023-08-23,14:00:00,132,62,70,FMN 12 Statielei
660,Statielei 26,2023-08-23,15:00:00,132,59,73,FMN 12 Statielei
660,Statielei 26,2023-08-23,16:00:00,199,95,104,FMN 12 Statielei
660,Statielei 26,2023-08-23,17:00:00,214,94,120,FMN 12 Statielei
660,Statielei 26,2023-08-23,18:00:00,194,97,97,FMN 12 Statielei
660,Statielei 26,2023-08-23,19:00:00,188,86,102,FMN 12 Statielei
660,Statielei 26,2023-08-23,20:00:00,152,91,61,FMN 12 Statielei
660,Statielei 26,2023-08-23,21:00:00,103,50,53,FMN 12 Statielei
660,Statielei 26,2023-08-23,22:00:00,102,49,53,FMN 12 Statielei
660,Statielei 26,2023-08-23,23:00:00,68,33,35,FMN 12 Statielei
660,Statielei 26,2023-08-24,00:00:00,45,19,26,FMN 12 Statielei
660,Statielei 26,2023-08-24,01:00:00,22,11,11,FMN 12 Statielei
660,Statielei 26,2023-08-24,02:00:00,5,1,4,FMN 12 Statielei
660,Statielei 26,2023-08-24,03:00:00,5,0,5,FMN 12 Statielei
660,Statielei 26,2023-08-24,04:00:00,11,5,6,FMN 12 Statielei
660,Statielei 26,2023-08-24,05:00:00,20,10,10,FMN 12 Statielei
660,Statielei 26,2023-08-24,06:00:00,32,16,16,FMN 12 Statielei
660,Statielei 26,2023-08-24,07:00:00,83,38,45,FMN 12 Statielei
660,Statielei 26,2023-08-24,08:00:00,159,88,71,FMN 12 Statielei
660,Statielei 26,2023-08-24,09:00:00,145,90,55,FMN 12 Statielei
660,Statielei 26,2023-08-24,10:00:00,98,50,48,FMN 12 Statielei
660,Statielei 26,2023-08-24,11:00:00,80,37,43,FMN 12 Statielei
660,Statielei 26,2023-08-24,12:00:00,75,44,31,FMN 12 Statielei
660,Statielei 26,2023-08-24,13:00:00,83,46,37,FMN 12 Statielei
660,Statielei 26,2023-08-24,14:00:00,78,44,34,FMN 12 Statielei
660,Statielei 26,2023-08-24,15:00:00,133,68,65,FMN 12 Statielei
660,Statielei 26,2023-08-24,16:00:00,184,89,95,FMN 12 Statielei
660,Statielei 26,2023-08-24,17:00:00,168,73,95,FMN 12 Statielei
660,Statielei 26,2023-08-24,18:00:00,162,88,74,FMN 12 Statielei
660,Statielei 26,2023-08-24,19:00:00,127,69,58,FMN 12 Statielei
660,Statielei 26,2023-08-24,20:00:00,105,45,60,FMN 12 Statielei
660,Statielei 26,2023-08-24,21:00:00,78,47,31,FMN 12 Statielei
660,Statielei 26,2023-08-24,22:00:00,66,26,40,FMN 12 Statielei
660,Statielei 26,2023-08-24,23:00:00,70,36,34,FMN 12 Statielei
660,Statielei 26,2023-08-25,00:00:00,51,23,28,FMN 12 Statielei
660,Statielei 26,2023-08-25,01:00:00,18,11,7,FMN 12 Statielei
660,Statielei 26,2023-08-25,02:00:00,8,5,3,FMN 12 Statielei
660,Statielei 26,2023-08-25,03:00:00,7,3,4,FMN 12 Statielei
660,Statielei 26,2023-08-25,04:00:00,6,2,4,FMN 12 Statielei
660,Statielei 26,2023-08-25,05:00:00,16,8,8,FMN 12 Statielei
660,Statielei 26,2023-08-25,06:00:00,19,11,8,FMN 12 Statielei
660,Statielei 26,2023-08-25,07:00:00,62,22,40,FMN 12 Statielei
660,Statielei 26,2023-08-25,08:00:00,127,78,49,FMN 12 Statielei
660,Statielei 26,2023-08-25,09:00:00,123,75,48,FMN 12 Statielei
660,Statielei 26,2023-08-25,10:00:00,62,31,31,FMN 12 Statielei
660,Statielei 26,2023-08-25,11:00:00,99,61,38,FMN 12 Statielei
660,Statielei 26,2023-08-25,12:00:00,105,54,51,FMN 12 Statielei
660,Statielei 26,2023-08-25,13:00:00,109,54,55,FMN 12 Statielei
660,Statielei 26,2023-08-25,14:00:00,123,72,51,FMN 12 Statielei
660,Statielei 26,2023-08-25,15:00:00,129,66,63,FMN 12 Statielei
660,Statielei 26,2023-08-25,16:00:00,222,119,103,FMN 12 Statielei
660,Statielei 26,2023-08-25,17:00:00,168,72,96,FMN 12 Statielei
660,Statielei 26,2023-08-25,18:00:00,153,66,87,FMN 12 Statielei
660,Statielei 26,2023-08-25,19:00:00,124,59,65,FMN 12 Statielei
660,Statielei 26,2023-08-25,20:00:00,90,42,48,FMN 12 Statielei
660,Statielei 26,2023-08-25,21:00:00,83,41,42,FMN 12 Statielei
660,Statielei 26,2023-08-25,22:00:00,65,30,35,FMN 12 Statielei
660,Statielei 26,2023-08-25,23:00:00,96,59,37,FMN 12 Statielei
660,Statielei 26,2023-08-26,00:00:00,54,27,27,FMN 12 Statielei
660,Statielei 26,2023-08-26,01:00:00,38,21,17,FMN 12 Statielei
660,Statielei 26,2023-08-26,02:00:00,19,9,10,FMN 12 Statielei
660,Statielei 26,2023-08-26,03:00:00,19,5,14,FMN 12 Statielei
660,Statielei 26,2023-08-26,04:00:00,23,11,12,FMN 12 Statielei
660,Statielei 26,2023-08-26,05:00:00,9,2,7,FMN 12 Statielei
660,Statielei 26,2023-08-26,06:00:00,11,6,5,FMN 12 Statielei
660,Statielei 26,2023-08-26,07:00:00,15,6,9,FMN 12 Statielei
660,Statielei 26,2023-08-26,08:00:00,35,19,16,FMN 12 Statielei
660,Statielei 26,2023-08-26,09:00:00,84,39,45,FMN 12 Statielei
660,Statielei 26,2023-08-26,10:00:00,130,75,55,FMN 12 Statielei
660,Statielei 26,2023-08-26,11:00:00,112,69,43,FMN 12 Statielei
660,Statielei 26,2023-08-26,12:00:00,148,76,72,FMN 12 Statielei
660,Statielei 26,2023-08-26,13:00:00,138,73,65,FMN 12 Statielei
660,Statielei 26,2023-08-26,14:00:00,155,87,68,FMN 12 Statielei
660,Statielei 26,2023-08-26,15:00:00,126,71,55,FMN 12 Statielei
660,Statielei 26,2023-08-26,16:00:00,98,49,49,FMN 12 Statielei
660,Statielei 26,2023-08-26,17:00:00,127,56,71,FMN 12 Statielei
660,Statielei 26,2023-08-26,18:00:00,119,60,59,FMN 12 Statielei
660,Statielei 26,2023-08-26,19:00:00,112,43,69,FMN 12 Statielei
660,Statielei 26,2023-08-26,20:00:00,116,57,59,FMN 12 Statielei
660,Statielei 26,2023-08-26,21:00:00,102,45,57,FMN 12 Statielei
660,Statielei 26,2023-08-26,22:00:00,60,24,36,FMN 12 Statielei
660,Statielei 26,2023-08-26,23:00:00,75,43,32,FMN 12 Statielei
660,Statielei 26,2023-08-27,00:00:00,49,19,30,FMN 12 Statielei
660,Statielei 26,2023-08-27,01:00:00,44,25,19,FMN 12 Statielei
660,Statielei 26,2023-08-27,02:00:00,26,11,15,FMN 12 Statielei
660,Statielei 26,2023-08-27,03:00:00,10,4,6,FMN 12 Statielei
660,Statielei 26,2023-08-27,04:00:00,8,5,3,FMN 12 Statielei
660,Statielei 26,2023-08-27,05:00:00,11,3,8,FMN 12 Statielei
660,Statielei 26,2023-08-27,06:00:00,9,5,4,FMN 12 Statielei
660,Statielei 26,2023-08-27,07:00:00,10,3,7,FMN 12 Statielei
660,Statielei 26,2023-08-27,08:00:00,23,12,11,FMN 12 Statielei
660,Statielei 26,2023-08-27,09:00:00,61,36,25,FMN 12 Statielei
660,Statielei 26,2023-08-27,10:00:00,78,42,36,FMN 12 Statielei
660,Statielei 26,2023-08-27,11:00:00,74,34,40,FMN 12 Statielei
660,Statielei 26,2023-08-27,12:00:00,90,43,47,FMN 12 Statielei
660,Statielei 26,2023-08-27,13:00:00,86,48,38,FMN 12 Statielei
660,Statielei 26,2023-08-27,14:00:00,125,52,73,FMN 12 Statielei
660,Statielei 26,2023-08-27,15:00:00,67,47,20,FMN 12 Statielei
660,Statielei 26,2023-08-27,16:00:00,75,41,34,FMN 12 Statielei
660,Statielei 26,2023-08-27,17:00:00,138,73,65,FMN 12 Statielei
660,Statielei 26,2023-08-27,18:00:00,112,48,64,FMN 12 Statielei
660,Statielei 26,2023-08-27,19:00:00,104,34,70,FMN 12 Statielei
660,Statielei 26,2023-08-27,20:00:00,124,55,69,FMN 12 Statielei
660,Statielei 26,2023-08-27,21:00:00,85,45,40,FMN 12 Statielei
660,Statielei 26,2023-08-27,22:00:00,53,25,28,FMN 12 Statielei
660,Statielei 26,2023-08-27,23:00:00,46,28,18,FMN 12 Statielei
660,Statielei 26,2023-08-28,00:00:00,26,12,14,FMN 12 Statielei
660,Statielei 26,2023-08-28,01:00:00,13,9,4,FMN 12 Statielei
660,Statielei 26,2023-08-28,02:00:00,7,5,2,FMN 12 Statielei
660,Statielei 26,2023-08-28,03:00:00,7,3,4,FMN 12 Statielei
660,Statielei 26,2023-08-28,04:00:00,8,5,3,FMN 12 Statielei
660,Statielei 26,2023-08-28,05:00:00,17,10,7,FMN 12 Statielei
660,Statielei 26,2023-08-28,06:00:00,25,14,11,FMN 12 Statielei
660,Statielei 26,2023-08-28,07:00:00,68,28,40,FMN 12 Statielei
660,Statielei 26,2023-08-28,08:00:00,188,100,88,FMN 12 Statielei
660,Statielei 26,2023-08-28,09:00:00,115,82,33,FMN 12 Statielei
660,Statielei 26,2023-08-28,10:00:00,90,49,41,FMN 12 Statielei
660,Statielei 26,2023-08-28,11:00:00,103,60,43,FMN 12 Statielei
660,Statielei 26,2023-08-28,12:00:00,118,67,51,FMN 12 Statielei
660,Statielei 26,2023-08-28,13:00:00,116,50,66,FMN 12 Statielei
660,Statielei 26,2023-08-28,14:00:00,100,50,50,FMN 12 Statielei
660,Statielei 26,2023-08-28,15:00:00,130,74,56,FMN 12 Statielei
660,Statielei 26,2023-08-28,16:00:00,160,53,107,FMN 12 Statielei
660,Statielei 26,2023-08-28,17:00:00,211,100,111,FMN 12 Statielei
660,Statielei 26,2023-08-28,18:00:00,140,70,70,FMN 12 Statielei
660,Statielei 26,2023-08-28,19:00:00,74,37,37,FMN 12 Statielei
660,Statielei 26,2023-08-28,20:00:00,77,44,33,FMN 12 Statielei
660,Statielei 26,2023-08-28,21:00:00,60,22,38,FMN 12 Statielei
660,Statielei 26,2023-08-28,22:00:00,54,20,34,FMN 12 Statielei
660,Statielei 26,2023-08-28,23:00:00,33,14,19,FMN 12 Statielei
660,Statielei 26,2023-08-29,00:00:00,24,9,15,FMN 12 Statielei
660,Statielei 26,2023-08-29,01:00:00,11,5,6,FMN 12 Statielei
660,Statielei 26,2023-08-29,02:00:00,7,3,4,FMN 12 Statielei
660,Statielei 26,2023-08-29,03:00:00,4,1,3,FMN 12 Statielei
660,Statielei 26,2023-08-29,04:00:00,9,5,4,FMN 12 Statielei
660,Statielei 26,2023-08-29,05:00:00,20,9,11,FMN 12 Statielei
660,Statielei 26,2023-08-29,06:00:00,27,13,14,FMN 12 Statielei
660,Statielei 26,2023-08-29,07:00:00,92,48,44,FMN 12 Statielei
660,Statielei 26,2023-08-29,08:00:00,167,104,63,FMN 12 Statielei
660,Statielei 26,2023-08-29,09:00:00,130,83,47,FMN 12 Statielei
660,Statielei 26,2023-08-29,10:00:00,100,47,53,FMN 12 Statielei
660,Statielei 26,2023-08-29,11:00:00,92,45,47,FMN 12 Statielei
660,Statielei 26,2023-08-29,12:00:00,106,70,36,FMN 12 Statielei
660,Statielei 26,2023-08-29,13:00:00,119,64,55,FMN 12 Statielei
660,Statielei 26,2023-08-29,14:00:00,174,89,85,FMN 12 Statielei
660,Statielei 26,2023-08-29,15:00:00,137,65,72,FMN 12 Statielei
660,Statielei 26,2023-08-29,16:00:00,187,84,103,FMN 12 Statielei
660,Statielei 26,2023-08-29,17:00:00,214,96,118,FMN 12 Statielei
660,Statielei 26,2023-08-29,18:00:00,248,122,126,FMN 12 Statielei
660,Statielei 26,2023-08-29,19:00:00,140,72,68,FMN 12 Statielei
660,Statielei 26,2023-08-29,20:00:00,188,92,96,FMN 12 Statielei
660,Statielei 26,2023-08-29,21:00:00,89,42,47,FMN 12 Statielei
660,Statielei 26,2023-08-29,22:00:00,79,51,28,FMN 12 Statielei
660,Statielei 26,2023-08-29,23:00:00,35,14,21,FMN 12 Statielei
660,Statielei 26,2023-08-30,00:00:00,27,7,20,FMN 12 Statielei
660,Statielei 26,2023-08-30,01:00:00,21,6,15,FMN 12 Statielei
660,Statielei 26,2023-08-30,02:00:00,2,1,1,FMN 12 Statielei
660,Statielei 26,2023-08-30,03:00:00,9,3,6,FMN 12 Statielei
660,Statielei 26,2023-08-30,04:00:00,10,5,5,FMN 12 Statielei
660,Statielei 26,2023-08-30,05:00:00,17,10,7,FMN 12 Statielei
660,Statielei 26,2023-08-30,06:00:00,20,11,9,FMN 12 Statielei
660,Statielei 26,2023-08-30,07:00:00,49,24,25,FMN 12 Statielei
660,Statielei 26,2023-08-30,08:00:00,132,82,50,FMN 12 Statielei
660,Statielei 26,2023-08-30,09:00:00,112,65,47,FMN 12 Statielei
660,Statielei 26,2023-08-30,10:00:00,76,46,30,FMN 12 Statielei
660,Statielei 26,2023-08-30,11:00:00,80,41,39,FMN 12 Statielei
660,Statielei 26,2023-08-30,12:00:00,144,86,58,FMN 12 Statielei
660,Statielei 26,2023-08-30,13:00:00,107,55,52,FMN 12 Statielei
660,Statielei 26,2023-08-30,14:00:00,118,52,66,FMN 12 Statielei
660,Statielei 26,2023-08-30,15:00:00,140,57,83,FMN 12 Statielei
660,Statielei 26,2023-08-30,16:00:00,203,89,114,FMN 12 Statielei
660,Statielei 26,2023-08-30,17:00:00,218,107,111,FMN 12 Statielei
660,Statielei 26,2023-08-30,18:00:00,189,93,96,FMN 12 Statielei
660,Statielei 26,2023-08-30,19:00:00,133,63,70,FMN 12 Statielei
660,Statielei 26,2023-08-30,20:00:00,138,75,63,FMN 12 Statielei
660,Statielei 26,2023-08-30,21:00:00,64,30,34,FMN 12 Statielei
660,Statielei 26,2023-08-30,22:00:00,75,39,36,FMN 12 Statielei
660,Statielei 26,2023-08-30,23:00:00,66,29,37,FMN 12 Statielei
660,Statielei 26,2023-08-31,00:00:00,31,13,18,FMN 12 Statielei
660,Statielei 26,2023-08-31,01:00:00,24,15,9,FMN 12 Statielei
660,Statielei 26,2023-08-31,02:00:00,4,0,4,FMN 12 Statielei
660,Statielei 26,2023-08-31,03:00:00,7,3,4,FMN 12 Statielei
660,Statielei 26,2023-08-31,04:00:00,8,4,4,FMN 12 Statielei
660,Statielei 26,2023-08-31,05:00:00,17,9,8,FMN 12 Statielei
660,Statielei 26,2023-08-31,06:00:00,37,17,20,FMN 12 Statielei
660,Statielei 26,2023-08-31,07:00:00,65,28,37,FMN 12 Statielei
660,Statielei 26,2023-08-31,08:00:00,170,96,74,FMN 12 Statielei
660,Statielei 26,2023-08-31,09:00:00,130,84,46,FMN 12 Statielei
660,Statielei 26,2023-08-31,10:00:00,111,63,48,FMN 12 Statielei
660,Statielei 26,2023-08-31,11:00:00,104,57,47,FMN 12 Statielei
660,Statielei 26,2023-08-31,12:00:00,118,65,53,FMN 12 Statielei
660,Statielei 26,2023-08-31,13:00:00,137,72,65,FMN 12 Statielei
660,Statielei 26,2023-08-31,14:00:00,138,74,64,FMN 12 Statielei
660,Statielei 26,2023-08-31,15:00:00,162,84,78,FMN 12 Statielei
660,Statielei 26,2023-08-31,16:00:00,195,95,100,FMN 12 Statielei
660,Statielei 26,2023-08-31,17:00:00,221,95,126,FMN 12 Statielei
660,Statielei 26,2023-08-31,18:00:00,171,76,95,FMN 12 Statielei
660,Statielei 26,2023-08-31,19:00:00,136,66,70,FMN 12 Statielei
660,Statielei 26,2023-08-31,20:00:00,126,62,64,FMN 12 Statielei
660,Statielei 26,2023-08-31,21:00:00,87,45,42,FMN 12 Statielei
660,Statielei 26,2023-08-31,22:00:00,69,37,32,FMN 12 Statielei
660,Statielei 26,2023-08-31,23:00:00,38,18,20,FMN 12 Statielei
660,Statielei 26,2023-09-01,00:00:00,22,6,16,FMN 12 Statielei
660,Statielei 26,2023-09-01,01:00:00,15,4,11,FMN 12 Statielei
660,Statielei 26,2023-09-01,02:00:00,2,1,1,FMN 12 Statielei
660,Statielei 26,2023-09-01,03:00:00,5,1,4,FMN 12 Statielei
660,Statielei 26,2023-09-01,04:00:00,9,6,3,FMN 12 Statielei
660,Statielei 26,2023-09-01,05:00:00,12,7,5,FMN 12 Statielei
660,Statielei 26,2023-09-01,06:00:00,29,14,15,FMN 12 Statielei
660,Statielei 26,2023-09-01,07:00:00,79,44,35,FMN 12 Statielei
660,Statielei 26,2023-09-01,08:00:00,163,90,73,FMN 12 Statielei
660,Statielei 26,2023-09-01,09:00:00,116,52,64,FMN 12 Statielei
660,Statielei 26,2023-09-01,10:00:00,56,32,24,FMN 12 Statielei
660,Statielei 26,2023-09-01,11:00:00,55,28,27,FMN 12 Statielei
660,Statielei 26,2023-09-01,12:00:00,89,51,38,FMN 12 Statielei
660,Statielei 26,2023-09-01,13:00:00,89,57,32,FMN 12 Statielei
660,Statielei 26,2023-09-01,14:00:00,114,64,50,FMN 12 Statielei
660,Statielei 26,2023-09-01,15:00:00,160,73,87,FMN 12 Statielei
660,Statielei 26,2023-09-01,16:00:00,190,103,87,FMN 12 Statielei
660,Statielei 26,2023-09-01,17:00:00,160,70,90,FMN 12 Statielei
660,Statielei 26,2023-09-01,18:00:00,136,67,69,FMN 12 Statielei
660,Statielei 26,2023-09-01,19:00:00,139,56,83,FMN 12 Statielei
660,Statielei 26,2023-09-01,20:00:00,140,53,87,FMN 12 Statielei
660,Statielei 26,2023-09-01,21:00:00,94,63,31,FMN 12 Statielei
660,Statielei 26,2023-09-01,22:00:00,91,50,41,FMN 12 Statielei
660,Statielei 26,2023-09-01,23:00:00,70,36,34,FMN 12 Statielei
660,Statielei 26,2023-09-02,00:00:00,40,14,26,FMN 12 Statielei
660,Statielei 26,2023-09-02,01:00:00,13,5,8,FMN 12 Statielei
660,Statielei 26,2023-09-02,02:00:00,24,8,16,FMN 12 Statielei
660,Statielei 26,2023-09-02,03:00:00,7,6,1,FMN 12 Statielei
660,Statielei 26,2023-09-02,04:00:00,8,3,5,FMN 12 Statielei
660,Statielei 26,2023-09-02,05:00:00,8,1,7,FMN 12 Statielei
660,Statielei 26,2023-09-02,06:00:00,11,6,5,FMN 12 Statielei
660,Statielei 26,2023-09-02,07:00:00,22,5,17,FMN 12 Statielei
660,Statielei 26,2023-09-02,08:00:00,50,20,30,FMN 12 Statielei
660,Statielei 26,2023-09-02,09:00:00,80,43,37,FMN 12 Statielei
660,Statielei 26,2023-09-02,10:00:00,111,53,58,FMN 12 Statielei
660,Statielei 26,2023-09-02,11:00:00,121,77,44,FMN 12 Statielei
660,Statielei 26,2023-09-02,12:00:00,161,96,65,FMN 12 Statielei
660,Statielei 26,2023-09-02,13:00:00,135,67,68,FMN 12 Statielei
660,Statielei 26,2023-09-02,14:00:00,130,64,66,FMN 12 Statielei
660,Statielei 26,2023-09-02,15:00:00,170,83,87,FMN 12 Statielei
660,Statielei 26,2023-09-02,16:00:00,147,77,70,FMN 12 Statielei
660,Statielei 26,2023-09-02,17:00:00,118,65,53,FMN 12 Statielei
660,Statielei 26,2023-09-02,18:00:00,149,86,63,FMN 12 Statielei
660,Statielei 26,2023-09-02,19:00:00,153,77,76,FMN 12 Statielei
660,Statielei 26,2023-09-02,20:00:00,117,64,53,FMN 12 Statielei
660,Statielei 26,2023-09-02,21:00:00,100,44,56,FMN 12 Statielei
660,Statielei 26,2023-09-02,22:00:00,79,33,46,FMN 12 Statielei
660,Statielei 26,2023-09-02,23:00:00,50,17,33,FMN 12 Statielei
660,Statielei 26,2023-09-03,00:00:00,57,21,36,FMN 12 Statielei
660,Statielei 26,2023-09-03,01:00:00,30,9,21,FMN 12 Statielei
660,Statielei 26,2023-09-03,02:00:00,23,14,9,FMN 12 Statielei
660,Statielei 26,2023-09-03,03:00:00,11,5,6,FMN 12 Statielei
660,Statielei 26,2023-09-03,04:00:00,6,1,5,FMN 12 Statielei
660,Statielei 26,2023-09-03,05:00:00,5,3,2,FMN 12 Statielei
660,Statielei 26,2023-09-03,06:00:00,7,3,4,FMN 12 Statielei
660,Statielei 26,2023-09-03,07:00:00,19,6,13,FMN 12 Statielei
660,Statielei 26,2023-09-03,08:00:00,42,19,23,FMN 12 Statielei
660,Statielei 26,2023-09-03,09:00:00,81,34,47,FMN 12 Statielei
660,Statielei 26,2023-09-03,10:00:00,83,44,39,FMN 12 Statielei
660,Statielei 26,2023-09-03,11:00:00,127,69,58,FMN 12 Statielei
660,Statielei 26,2023-09-03,12:00:00,125,65,60,FMN 12 Statielei
660,Statielei 26,2023-09-03,13:00:00,165,73,92,FMN 12 Statielei
660,Statielei 26,2023-09-03,14:00:00,155,71,84,FMN 12 Statielei
660,Statielei 26,2023-09-03,15:00:00,166,76,90,FMN 12 Statielei
660,Statielei 26,2023-09-03,16:00:00,183,94,89,FMN 12 Statielei
660,Statielei 26,2023-09-03,17:00:00,158,79,79,FMN 12 Statielei
660,Statielei 26,2023-09-03,18:00:00,146,99,47,FMN 12 Statielei
660,Statielei 26,2023-09-03,19:00:00,143,88,55,FMN 12 Statielei
660,Statielei 26,2023-09-03,20:00:00,120,60,60,FMN 12 Statielei
660,Statielei 26,2023-09-03,21:00:00,74,41,33,FMN 12 Statielei
660,Statielei 26,2023-09-03,22:00:00,62,21,41,FMN 12 Statielei
660,Statielei 26,2023-09-03,23:00:00,29,9,20,FMN 12 Statielei
660,Statielei 26,2023-09-04,00:00:00,23,5,18,FMN 12 Statielei
660,Statielei 26,2023-09-04,01:00:00,9,6,3,FMN 12 Statielei
660,Statielei 26,2023-09-04,02:00:00,7,2,5,FMN 12 Statielei
660,Statielei 26,2023-09-04,03:00:00,5,1,4,FMN 12 Statielei
660,Statielei 26,2023-09-04,04:00:00,6,3,3,FMN 12 Statielei
660,Statielei 26,2023-09-04,05:00:00,14,9,5,FMN 12 Statielei
660,Statielei 26,2023-09-04,06:00:00,34,12,22,FMN 12 Statielei
660,Statielei 26,2023-09-04,07:00:00,147,73,74,FMN 12 Statielei
660,Statielei 26,2023-09-04,08:00:00,338,176,162,FMN 12 Statielei
660,Statielei 26,2023-09-04,09:00:00,129,79,50,FMN 12 Statielei
660,Statielei 26,2023-09-04,10:00:00,80,49,31,FMN 12 Statielei
660,Statielei 26,2023-09-04,11:00:00,79,46,33,FMN 12 Statielei
660,Statielei 26,2023-09-04,12:00:00,144,92,52,FMN 12 Statielei
660,Statielei 26,2023-09-04,13:00:00,109,62,47,FMN 12 Statielei
660,Statielei 26,2023-09-04,14:00:00,117,63,54,FMN 12 Statielei
660,Statielei 26,2023-09-04,15:00:00,209,91,118,FMN 12 Statielei
660,Statielei 26,2023-09-04,16:00:00,275,147,128,FMN 12 Statielei
660,Statielei 26,2023-09-04,17:00:00,277,123,154,FMN 12 Statielei
660,Statielei 26,2023-09-04,18:00:00,179,91,88,FMN 12 Statielei
660,Statielei 26,2023-09-04,19:00:00,162,75,87,FMN 12 Statielei
660,Statielei 26,2023-09-04,20:00:00,134,70,64,FMN 12 Statielei
660,Statielei 26,2023-09-04,21:00:00,89,44,45,FMN 12 Statielei
660,Statielei 26,2023-09-04,22:00:00,64,24,40,FMN 12 Statielei
660,Statielei 26,2023-09-04,23:00:00,39,15,24,FMN 12 Statielei
660,Statielei 26,2023-09-05,00:00:00,18,7,11,FMN 12 Statielei
660,Statielei 26,2023-09-05,01:00:00,10,2,8,FMN 12 Statielei
660,Statielei 26,2023-09-05,02:00:00,7,1,6,FMN 12 Statielei
660,Statielei 26,2023-09-05,03:00:00,5,2,3,FMN 12 Statielei
660,Statielei 26,2023-09-05,04:00:00,9,3,6,FMN 12 Statielei
660,Statielei 26,2023-09-05,05:00:00,16,9,7,FMN 12 Statielei
660,Statielei 26,2023-09-05,06:00:00,36,19,17,FMN 12 Statielei
660,Statielei 26,2023-09-05,07:00:00,160,88,72,FMN 12 Statielei
660,Statielei 26,2023-09-05,08:00:00,342,169,173,FMN 12 Statielei
660,Statielei 26,2023-09-05,09:00:00,133,83,50,FMN 12 Statielei
660,Statielei 26,2023-09-05,10:00:00,103,62,41,FMN 12 Statielei
660,Statielei 26,2023-09-05,11:00:00,92,52,40,FMN 12 Statielei
660,Statielei 26,2023-09-05,12:00:00,151,94,57,FMN 12 Statielei
660,Statielei 26,2023-09-05,13:00:00,129,74,55,FMN 12 Statielei
660,Statielei 26,2023-09-05,14:00:00,114,52,62,FMN 12 Statielei
660,Statielei 26,2023-09-05,15:00:00,234,94,140,FMN 12 Statielei
660,Statielei 26,2023-09-05,16:00:00,294,168,126,FMN 12 Statielei
660,Statielei 26,2023-09-05,17:00:00,250,115,135,FMN 12 Statielei
660,Statielei 26,2023-09-05,18:00:00,225,120,105,FMN 12 Statielei
660,Statielei 26,2023-09-05,19:00:00,181,83,98,FMN 12 Statielei
660,Statielei 26,2023-09-05,20:00:00,161,85,76,FMN 12 Statielei
660,Statielei 26,2023-09-05,21:00:00,123,54,69,FMN 12 Statielei
660,Statielei 26,2023-09-05,22:00:00,85,49,36,FMN 12 Statielei
660,Statielei 26,2023-09-05,23:00:00,59,20,39,FMN 12 Statielei
660,Statielei 26,2023-09-06,00:00:00,33,10,23,FMN 12 Statielei
660,Statielei 26,2023-09-06,01:00:00,9,3,6,FMN 12 Statielei
660,Statielei 26,2023-09-06,02:00:00,6,3,3,FMN 12 Statielei
660,Statielei 26,2023-09-06,03:00:00,3,1,2,FMN 12 Statielei
660,Statielei 26,2023-09-06,04:00:00,9,6,3,FMN 12 Statielei
660,Statielei 26,2023-09-06,05:00:00,21,12,9,FMN 12 Statielei
660,Statielei 26,2023-09-06,06:00:00,23,9,14,FMN 12 Statielei
660,Statielei 26,2023-09-06,07:00:00,150,81,69,FMN 12 Statielei
660,Statielei 26,2023-09-06,08:00:00,351,179,172,FMN 12 Statielei
660,Statielei 26,2023-09-06,09:00:00,127,75,52,FMN 12 Statielei
660,Statielei 26,2023-09-06,10:00:00,102,59,43,FMN 12 Statielei
660,Statielei 26,2023-09-06,11:00:00,122,78,44,FMN 12 Statielei
660,Statielei 26,2023-09-06,12:00:00,295,158,137,FMN 12 Statielei
660,Statielei 26,2023-09-06,13:00:00,171,88,83,FMN 12 Statielei
660,Statielei 26,2023-09-06,14:00:00,154,67,87,FMN 12 Statielei
660,Statielei 26,2023-09-06,15:00:00,161,69,92,FMN 12 Statielei
660,Statielei 26,2023-09-06,16:00:00,215,90,125,FMN 12 Statielei
660,Statielei 26,2023-09-06,17:00:00,253,122,131,FMN 12 Statielei
660,Statielei 26,2023-09-06,18:00:00,228,121,107,FMN 12 Statielei
660,Statielei 26,2023-09-06,19:00:00,224,107,117,FMN 12 Statielei
660,Statielei 26,2023-09-06,20:00:00,137,71,66,FMN 12 Statielei
660,Statielei 26,2023-09-06,21:00:00,100,53,47,FMN 12 Statielei
660,Statielei 26,2023-09-06,22:00:00,99,44,55,FMN 12 Statielei
660,Statielei 26,2023-09-06,23:00:00,84,48,36,FMN 12 Statielei
660,Statielei 26,2023-09-07,00:00:00,39,13,26,FMN 12 Statielei
660,Statielei 26,2023-09-07,01:00:00,14,5,9,FMN 12 Statielei
660,Statielei 26,2023-09-07,02:00:00,14,2,12,FMN 12 Statielei
660,Statielei 26,2023-09-07,03:00:00,6,0,6,FMN 12 Statielei
660,Statielei 26,2023-09-07,04:00:00,8,2,6,FMN 12 Statielei
660,Statielei 26,2023-09-07,05:00:00,20,9,11,FMN 12 Statielei
660,Statielei 26,2023-09-07,06:00:00,35,15,20,FMN 12 Statielei
660,Statielei 26,2023-09-07,07:00:00,150,78,72,FMN 12 Statielei
660,Statielei 26,2023-09-07,08:00:00,326,179,147,FMN 12 Statielei
660,Statielei 26,2023-09-07,09:00:00,122,75,47,FMN 12 Statielei
660,Statielei 26,2023-09-07,10:00:00,97,51,46,FMN 12 Statielei
660,Statielei 26,2023-09-07,11:00:00,120,64,56,FMN 12 Statielei
660,Statielei 26,2023-09-07,12:00:00,133,75,58,FMN 12 Statielei
660,Statielei 26,2023-09-07,13:00:00,111,53,58,FMN 12 Statielei
660,Statielei 26,2023-09-07,14:00:00,125,68,57,FMN 12 Statielei
660,Statielei 26,2023-09-07,15:00:00,185,76,109,FMN 12 Statielei
660,Statielei 26,2023-09-07,16:00:00,303,164,139,FMN 12 Statielei
660,Statielei 26,2023-09-07,17:00:00,253,118,135,FMN 12 Statielei
660,Statielei 26,2023-09-07,18:00:00,218,105,113,FMN 12 Statielei
660,Statielei 26,2023-09-07,19:00:00,176,83,93,FMN 12 Statielei
660,Statielei 26,2023-09-07,20:00:00,162,99,63,FMN 12 Statielei
660,Statielei 26,2023-09-07,21:00:00,113,58,55,FMN 12 Statielei
660,Statielei 26,2023-09-07,22:00:00,105,42,63,FMN 12 Statielei
660,Statielei 26,2023-09-07,23:00:00,58,13,45,FMN 12 Statielei
660,Statielei 26,2023-09-08,00:00:00,32,5,27,FMN 12 Statielei
660,Statielei 26,2023-09-08,01:00:00,13,6,7,FMN 12 Statielei
660,Statielei 26,2023-09-08,02:00:00,8,0,8,FMN 12 Statielei
660,Statielei 26,2023-09-08,03:00:00,5,1,4,FMN 12 Statielei
660,Statielei 26,2023-09-08,04:00:00,7,2,5,FMN 12 Statielei
660,Statielei 26,2023-09-08,05:00:00,22,10,12,FMN 12 Statielei
660,Statielei 26,2023-09-08,06:00:00,42,26,16,FMN 12 Statielei
660,Statielei 26,2023-09-08,07:00:00,145,79,66,FMN 12 Statielei
660,Statielei 26,2023-09-08,08:00:00,303,153,150,FMN 12 Statielei
660,Statielei 26,2023-09-08,09:00:00,117,84,33,FMN 12 Statielei
660,Statielei 26,2023-09-08,10:00:00,131,63,68,FMN 12 Statielei
660,Statielei 26,2023-09-08,11:00:00,111,63,48,FMN 12 Statielei
660,Statielei 26,2023-09-08,12:00:00,152,83,69,FMN 12 Statielei
660,Statielei 26,2023-09-08,13:00:00,134,66,68,FMN 12 Statielei
660,Statielei 26,2023-09-08,14:00:00,145,81,64,FMN 12 Statielei
660,Statielei 26,2023-09-08,15:00:00,209,97,112,FMN 12 Statielei
660,Statielei 26,2023-09-08,16:00:00,280,147,133,FMN 12 Statielei
660,Statielei 26,2023-09-08,17:00:00,188,91,97,FMN 12 Statielei
660,Statielei 26,2023-09-08,18:00:00,194,98,96,FMN 12 Statielei
660,Statielei 26,2023-09-08,19:00:00,231,100,131,FMN 12 Statielei
660,Statielei 26,2023-09-08,20:00:00,168,75,93,FMN 12 Statielei
660,Statielei 26,2023-09-08,21:00:00,112,55,57,FMN 12 Statielei
660,Statielei 26,2023-09-08,22:00:00,143,74,69,FMN 12 Statielei
660,Statielei 26,2023-09-08,23:00:00,113,59,54,FMN 12 Statielei
660,Statielei 26,2023-09-09,00:00:00,59,22,37,FMN 12 Statielei
660,Statielei 26,2023-09-09,01:00:00,50,17,33,FMN 12 Statielei
660,Statielei 26,2023-09-09,02:00:00,20,7,13,FMN 12 Statielei
660,Statielei 26,2023-09-09,03:00:00,15,7,8,FMN 12 Statielei
660,Statielei 26,2023-09-09,04:00:00,15,5,10,FMN 12 Statielei
660,Statielei 26,2023-09-09,05:00:00,16,5,11,FMN 12 Statielei
660,Statielei 26,2023-09-09,06:00:00,11,4,7,FMN 12 Statielei
660,Statielei 26,2023-09-09,07:00:00,21,10,11,FMN 12 Statielei
660,Statielei 26,2023-09-09,08:00:00,78,32,46,FMN 12 Statielei
660,Statielei 26,2023-09-09,09:00:00,94,52,42,FMN 12 Statielei
660,Statielei 26,2023-09-09,10:00:00,122,70,52,FMN 12 Statielei
660,Statielei 26,2023-09-09,11:00:00,150,88,62,FMN 12 Statielei
660,Statielei 26,2023-09-09,12:00:00,135,80,55,FMN 12 Statielei
660,Statielei 26,2023-09-09,13:00:00,128,72,56,FMN 12 Statielei
660,Statielei 26,2023-09-09,14:00:00,141,70,71,FMN 12 Statielei
660,Statielei 26,2023-09-09,15:00:00,148,80,68,FMN 12 Statielei
660,Statielei 26,2023-09-09,16:00:00,149,63,86,FMN 12 Statielei
660,Statielei 26,2023-09-09,17:00:00,153,71,82,FMN 12 Statielei
660,Statielei 26,2023-09-09,18:00:00,142,67,75,FMN 12 Statielei
660,Statielei 26,2023-09-09,19:00:00,135,56,79,FMN 12 Statielei
660,Statielei 26,2023-09-09,20:00:00,158,84,74,FMN 12 Statielei
660,Statielei 26,2023-09-09,21:00:00,88,44,44,FMN 12 Statielei
660,Statielei 26,2023-09-09,22:00:00,108,61,47,FMN 12 Statielei
660,Statielei 26,2023-09-09,23:00:00,94,50,44,FMN 12 Statielei
660,Statielei 26,2023-09-10,00:00:00,99,49,50,FMN 12 Statielei
660,Statielei 26,2023-09-10,01:00:00,35,17,18,FMN 12 Statielei
660,Statielei 26,2023-09-10,02:00:00,28,13,15,FMN 12 Statielei
660,Statielei 26,2023-09-10,03:00:00,14,6,8,FMN 12 Statielei
660,Statielei 26,2023-09-10,04:00:00,6,2,4,FMN 12 Statielei
660,Statielei 26,2023-09-10,05:00:00,14,4,10,FMN 12 Statielei
660,Statielei 26,2023-09-10,06:00:00,15,5,10,FMN 12 Statielei
660,Statielei 26,2023-09-10,07:00:00,10,4,6,FMN 12 Statielei
660,Statielei 26,2023-09-10,08:00:00,40,21,19,FMN 12 Statielei
660,Statielei 26,2023-09-10,09:00:00,76,39,37,FMN 12 Statielei
660,Statielei 26,2023-09-10,10:00:00,98,46,52,FMN 12 Statielei
660,Statielei 26,2023-09-10,11:00:00,116,62,54,FMN 12 Statielei
660,Statielei 26,2023-09-10,12:00:00,148,89,59,FMN 12 Statielei
660,Statielei 26,2023-09-10,13:00:00,171,73,98,FMN 12 Statielei
660,Statielei 26,2023-09-10,14:00:00,146,76,70,FMN 12 Statielei
660,Statielei 26,2023-09-10,15:00:00,167,81,86,FMN 12 Statielei
660,Statielei 26,2023-09-10,16:00:00,185,97,88,FMN 12 Statielei
660,Statielei 26,2023-09-10,17:00:00,200,95,105,FMN 12 Statielei
660,Statielei 26,2023-09-10,18:00:00,172,79,93,FMN 12 Statielei
660,Statielei 26,2023-09-10,19:00:00,137,68,69,FMN 12 Statielei
660,Statielei 26,2023-09-10,20:00:00,134,71,63,FMN 12 Statielei
660,Statielei 26,2023-09-10,21:00:00,88,45,43,FMN 12 Statielei
660,Statielei 26,2023-09-10,22:00:00,86,45,41,FMN 12 Statielei
660,Statielei 26,2023-09-10,23:00:00,41,16,25,FMN 12 Statielei
660,Statielei 26,2023-09-11,00:00:00,45,23,22,FMN 12 Statielei
660,Statielei 26,2023-09-11,01:00:00,11,7,4,FMN 12 Statielei
660,Statielei 26,2023-09-11,02:00:00,11,5,6,FMN 12 Statielei
660,Statielei 26,2023-09-11,03:00:00,2,1,1,FMN 12 Statielei
660,Statielei 26,2023-09-11,04:00:00,9,5,4,FMN 12 Statielei
660,Statielei 26,2023-09-11,05:00:00,20,11,9,FMN 12 Statielei
660,Statielei 26,2023-09-11,06:00:00,37,17,20,FMN 12 Statielei
660,Statielei 26,2023-09-11,07:00:00,146,76,70,FMN 12 Statielei
660,Statielei 26,2023-09-11,08:00:00,356,181,175,FMN 12 Statielei
660,Statielei 26,2023-09-11,09:00:00,136,86,50,FMN 12 Statielei
660,Statielei 26,2023-09-11,10:00:00,67,40,27,FMN 12 Statielei
660,Statielei 26,2023-09-11,11:00:00,88,59,29,FMN 12 Statielei
660,Statielei 26,2023-09-11,12:00:00,129,59,70,FMN 12 Statielei
660,Statielei 26,2023-09-11,13:00:00,122,67,55,FMN 12 Statielei
660,Statielei 26,2023-09-11,14:00:00,110,45,65,FMN 12 Statielei
660,Statielei 26,2023-09-11,15:00:00,209,90,119,FMN 12 Statielei
660,Statielei 26,2023-09-11,16:00:00,279,144,135,FMN 12 Statielei
660,Statielei 26,2023-09-11,17:00:00,261,108,153,FMN 12 Statielei
660,Statielei 26,2023-09-11,18:00:00,217,108,109,FMN 12 Statielei
660,Statielei 26,2023-09-11,19:00:00,150,80,70,FMN 12 Statielei
660,Statielei 26,2023-09-11,20:00:00,112,62,50,FMN 12 Statielei
660,Statielei 26,2023-09-11,21:00:00,99,44,55,FMN 12 Statielei
660,Statielei 26,2023-09-11,22:00:00,67,33,34,FMN 12 Statielei
660,Statielei 26,2023-09-11,23:00:00,23,10,13,FMN 12 Statielei
660,Statielei 26,2023-09-12,00:00:00,20,3,17,FMN 12 Statielei
660,Statielei 26,2023-09-12,01:00:00,6,3,3,FMN 12 Statielei
660,Statielei 26,2023-09-12,02:00:00,5,2,3,FMN 12 Statielei
660,Statielei 26,2023-09-12,03:00:00,4,0,4,FMN 12 Statielei
660,Statielei 26,2023-09-12,04:00:00,10,6,4,FMN 12 Statielei
660,Statielei 26,2023-09-12,05:00:00,17,6,11,FMN 12 Statielei
660,Statielei 26,2023-09-12,06:00:00,26,15,11,FMN 12 Statielei
660,Statielei 26,2023-09-12,07:00:00,162,92,70,FMN 12 Statielei
660,Statielei 26,2023-09-12,08:00:00,360,186,174,FMN 12 Statielei
660,Statielei 26,2023-09-12,09:00:00,134,78,56,FMN 12 Statielei
660,Statielei 26,2023-09-12,10:00:00,93,54,39,FMN 12 Statielei
660,Statielei 26,2023-09-12,11:00:00,111,60,51,FMN 12 Statielei
660,Statielei 26,2023-09-12,12:00:00,154,94,60,FMN 12 Statielei
660,Statielei 26,2023-09-12,13:00:00,137,72,65,FMN 12 Statielei
660,Statielei 26,2023-09-12,14:00:00,139,65,74,FMN 12 Statielei
660,Statielei 26,2023-09-12,15:00:00,241,112,129,FMN 12 Statielei
660,Statielei 26,2023-09-12,16:00:00,298,153,145,FMN 12 Statielei
660,Statielei 26,2023-09-12,17:00:00,253,118,135,FMN 12 Statielei
660,Statielei 26,2023-09-12,18:00:00,198,107,91,FMN 12 Statielei
660,Statielei 26,2023-09-12,19:00:00,158,78,80,FMN 12 Statielei
660,Statielei 26,2023-09-12,20:00:00,120,63,57,FMN 12 Statielei
660,Statielei 26,2023-09-12,21:00:00,77,33,44,FMN 12 Statielei
660,Statielei 26,2023-09-12,22:00:00,59,18,41,FMN 12 Statielei
660,Statielei 26,2023-09-12,23:00:00,40,13,27,FMN 12 Statielei
660,Statielei 26,2023-09-13,00:00:00,14,3,11,FMN 12 Statielei
660,Statielei 26,2023-09-13,01:00:00,6,0,6,FMN 12 Statielei
660,Statielei 26,2023-09-13,02:00:00,2,0,2,FMN 12 Statielei
660,Statielei 26,2023-09-13,03:00:00,5,2,3,FMN 12 Statielei
660,Statielei 26,2023-09-13,04:00:00,10,4,6,FMN 12 Statielei
660,Statielei 26,2023-09-13,05:00:00,25,15,10,FMN 12 Statielei
660,Statielei 26,2023-09-13,06:00:00,29,13,16,FMN 12 Statielei
660,Statielei 26,2023-09-13,07:00:00,149,78,71,FMN 12 Statielei
660,Statielei 26,2023-09-13,08:00:00,335,136,199,FMN 12 Statielei
660,Statielei 26,2023-09-13,09:00:00,122,77,45,FMN 12 Statielei
660,Statielei 26,2023-09-13,10:00:00,89,50,39,FMN 12 Statielei
660,Statielei 26,2023-09-13,11:00:00,134,81,53,FMN 12 Statielei
660,Statielei 26,2023-09-13,12:00:00,257,134,123,FMN 12 Statielei
660,Statielei 26,2023-09-13,13:00:00,163,85,78,FMN 12 Statielei
660,Statielei 26,2023-09-13,14:00:00,134,51,83,FMN 12 Statielei
660,Statielei 26,2023-09-13,15:00:00,183,86,97,FMN 12 Statielei
660,Statielei 26,2023-09-13,16:00:00,209,96,113,FMN 12 Statielei
660,Statielei 26,2023-09-13,17:00:00,260,136,124,FMN 12 Statielei
660,Statielei 26,2023-09-13,18:00:00,189,104,85,FMN 12 Statielei
660,Statielei 26,2023-09-13,19:00:00,175,105,70,FMN 12 Statielei
660,Statielei 26,2023-09-13,20:00:00,125,59,66,FMN 12 Statielei
660,Statielei 26,2023-09-13,21:00:00,84,41,43,FMN 12 Statielei
660,Statielei 26,2023-09-13,22:00:00,65,31,34,FMN 12 Statielei
660,Statielei 26,2023-09-13,23:00:00,36,10,26,FMN 12 Statielei
660,Statielei 26,2023-09-14,00:00:00,22,5,17,FMN 12 Statielei
660,Statielei 26,2023-09-14,01:00:00,20,7,13,FMN 12 Statielei
660,Statielei 26,2023-09-14,02:00:00,5,0,5,FMN 12 Statielei
660,Statielei 26,2023-09-14,03:00:00,7,4,3,FMN 12 Statielei
660,Statielei 26,2023-09-14,04:00:00,7,3,4,FMN 12 Statielei
660,Statielei 26,2023-09-14,05:00:00,16,6,10,FMN 12 Statielei
660,Statielei 26,2023-09-14,06:00:00,38,16,22,FMN 12 Statielei
660,Statielei 26,2023-09-14,07:00:00,139,78,61,FMN 12 Statielei
660,Statielei 26,2023-09-14,08:00:00,353,188,165,FMN 12 Statielei
660,Statielei 26,2023-09-14,09:00:00,140,89,51,FMN 12 Statielei
660,Statielei 26,2023-09-14,10:00:00,112,68,44,FMN 12 Statielei
660,Statielei 26,2023-09-14,11:00:00,93,54,39,FMN 12 Statielei
660,Statielei 26,2023-09-14,12:00:00,134,64,70,FMN 12 Statielei
660,Statielei 26,2023-09-14,13:00:00,110,66,44,FMN 12 Statielei
660,Statielei 26,2023-09-14,14:00:00,126,60,66,FMN 12 Statielei
660,Statielei 26,2023-09-14,15:00:00,184,76,108,FMN 12 Statielei
660,Statielei 26,2023-09-14,16:00:00,286,132,154,FMN 12 Statielei
660,Statielei 26,2023-09-14,17:00:00,271,144,127,FMN 12 Statielei
660,Statielei 26,2023-09-14,18:00:00,199,107,92,FMN 12 Statielei
660,Statielei 26,2023-09-14,19:00:00,166,81,85,FMN 12 Statielei
660,Statielei 26,2023-09-14,20:00:00,128,66,62,FMN 12 Statielei
660,Statielei 26,2023-09-14,21:00:00,111,63,48,FMN 12 Statielei
660,Statielei 26,2023-09-14,22:00:00,67,27,40,FMN 12 Statielei
660,Statielei 26,2023-09-14,23:00:00,39,13,26,FMN 12 Statielei
660,Statielei 26,2023-09-15,00:00:00,42,14,28,FMN 12 Statielei
660,Statielei 26,2023-09-15,01:00:00,9,5,4,FMN 12 Statielei
660,Statielei 26,2023-09-15,02:00:00,8,2,6,FMN 12 Statielei
660,Statielei 26,2023-09-15,03:00:00,7,1,6,FMN 12 Statielei
660,Statielei 26,2023-09-15,04:00:00,4,1,3,FMN 12 Statielei
660,Statielei 26,2023-09-15,05:00:00,18,9,9,FMN 12 Statielei
660,Statielei 26,2023-09-15,06:00:00,34,16,18,FMN 12 Statielei
660,Statielei 26,2023-09-15,07:00:00,129,68,61,FMN 12 Statielei
660,Statielei 26,2023-09-15,08:00:00,297,173,124,FMN 12 Statielei
660,Statielei 26,2023-09-15,09:00:00,120,72,48,FMN 12 Statielei
660,Statielei 26,2023-09-15,10:00:00,123,67,56,FMN 12 Statielei
660,Statielei 26,2023-09-15,11:00:00,132,76,56,FMN 12 Statielei
660,Statielei 26,2023-09-15,12:00:00,134,77,57,FMN 12 Statielei
660,Statielei 26,2023-09-15,13:00:00,151,76,75,FMN 12 Statielei
660,Statielei 26,2023-09-15,14:00:00,140,71,69,FMN 12 Statielei
660,Statielei 26,2023-09-15,15:00:00,227,105,122,FMN 12 Statielei
660,Statielei 26,2023-09-15,16:00:00,277,139,138,FMN 12 Statielei
660,Statielei 26,2023-09-15,17:00:00,246,132,114,FMN 12 Statielei
660,Statielei 26,2023-09-15,18:00:00,208,118,90,FMN 12 Statielei
660,Statielei 26,2023-09-15,19:00:00,200,124,76,FMN 12 Statielei
660,Statielei 26,2023-09-15,20:00:00,146,84,62,FMN 12 Statielei
660,Statielei 26,2023-09-15,21:00:00,84,39,45,FMN 12 Statielei
660,Statielei 26,2023-09-15,22:00:00,93,34,59,FMN 12 Statielei
660,Statielei 26,2023-09-15,23:00:00,120,35,85,FMN 12 Statielei
660,Statielei 26,2023-09-16,00:00:00,47,20,27,FMN 12 Statielei
660,Statielei 26,2023-09-16,01:00:00,43,15,28,FMN 12 Statielei
660,Statielei 26,2023-09-16,02:00:00,19,6,13,FMN 12 Statielei
660,Statielei 26,2023-09-16,03:00:00,12,1,11,FMN 12 Statielei
660,Statielei 26,2023-09-16,04:00:00,8,2,6,FMN 12 Statielei
660,Statielei 26,2023-09-16,05:00:00,8,2,6,FMN 12 Statielei
660,Statielei 26,2023-09-16,06:00:00,18,8,10,FMN 12 Statielei
660,Statielei 26,2023-09-16,07:00:00,34,14,20,FMN 12 Statielei
660,Statielei 26,2023-09-16,08:00:00,67,32,35,FMN 12 Statielei
660,Statielei 26,2023-09-16,09:00:00,107,50,57,FMN 12 Statielei
660,Statielei 26,2023-09-16,10:00:00,145,85,60,FMN 12 Statielei
660,Statielei 26,2023-09-16,11:00:00,130,68,62,FMN 12 Statielei
660,Statielei 26,2023-09-16,12:00:00,172,107,65,FMN 12 Statielei
660,Statielei 26,2023-09-16,13:00:00,164,98,66,FMN 12 Statielei
660,Statielei 26,2023-09-16,14:00:00,143,86,57,FMN 12 Statielei
660,Statielei 26,2023-09-16,15:00:00,174,78,96,FMN 12 Statielei
660,Statielei 26,2023-09-16,16:00:00,185,93,92,FMN 12 Statielei
660,Statielei 26,2023-09-16,17:00:00,165,86,79,FMN 12 Statielei
660,Statielei 26,2023-09-16,18:00:00,153,91,62,FMN 12 Statielei
660,Statielei 26,2023-09-16,19:00:00,137,73,64,FMN 12 Statielei
660,Statielei 26,2023-09-16,20:00:00,118,65,53,FMN 12 Statielei
660,Statielei 26,2023-09-16,21:00:00,69,35,34,FMN 12 Statielei
660,Statielei 26,2023-09-16,22:00:00,66,25,41,FMN 12 Statielei
660,Statielei 26,2023-09-16,23:00:00,67,29,38,FMN 12 Statielei
660,Statielei 26,2023-09-17,00:00:00,44,12,32,FMN 12 Statielei
660,Statielei 26,2023-09-17,01:00:00,26,4,22,FMN 12 Statielei
660,Statielei 26,2023-09-17,02:00:00,30,11,19,FMN 12 Statielei
660,Statielei 26,2023-09-17,03:00:00,19,9,10,FMN 12 Statielei
660,Statielei 26,2023-09-17,04:00:00,4,3,1,FMN 12 Statielei
660,Statielei 26,2023-09-17,05:00:00,15,9,6,FMN 12 Statielei
660,Statielei 26,2023-09-17,06:00:00,12,6,6,FMN 12 Statielei
660,Statielei 26,2023-09-17,07:00:00,19,6,13,FMN 12 Statielei
660,Statielei 26,2023-09-17,08:00:00,40,20,20,FMN 12 Statielei
660,Statielei 26,2023-09-17,09:00:00,69,28,41,FMN 12 Statielei
660,Statielei 26,2023-09-17,10:00:00,73,38,35,FMN 12 Statielei
660,Statielei 26,2023-09-17,11:00:00,104,63,41,FMN 12 Statielei
660,Statielei 26,2023-09-17,12:00:00,107,61,46,FMN 12 Statielei
660,Statielei 26,2023-09-17,13:00:00,143,80,63,FMN 12 Statielei
660,Statielei 26,2023-09-17,14:00:00,129,70,59,FMN 12 Statielei
660,Statielei 26,2023-09-17,15:00:00,143,85,58,FMN 12 Statielei
660,Statielei 26,2023-09-17,16:00:00,133,71,62,FMN 12 Statielei
660,Statielei 26,2023-09-17,17:00:00,158,83,75,FMN 12 Statielei
660,Statielei 26,2023-09-17,18:00:00,153,84,69,FMN 12 Statielei
660,Statielei 26,2023-09-17,19:00:00,110,60,50,FMN 12 Statielei
660,Statielei 26,2023-09-17,20:00:00,125,63,62,FMN 12 Statielei
660,Statielei 26,2023-09-17,21:00:00,91,32,59,FMN 12 Statielei
660,Statielei 26,2023-09-17,22:00:00,55,18,37,FMN 12 Statielei
660,Statielei 26,2023-09-17,23:00:00,36,11,25,FMN 12 Statielei
660,Statielei 26,2023-09-18,00:00:00,22,11,11,FMN 12 Statielei
660,Statielei 26,2023-09-18,01:00:00,11,5,6,FMN 12 Statielei
660,Statielei 26,2023-09-18,02:00:00,9,3,6,FMN 12 Statielei
660,Statielei 26,2023-09-18,03:00:00,3,0,3,FMN 12 Statielei
660,Statielei 26,2023-09-18,04:00:00,9,5,4,FMN 12 Statielei
660,Statielei 26,2023-09-18,05:00:00,11,5,6,FMN 12 Statielei
660,Statielei 26,2023-09-18,06:00:00,30,14,16,FMN 12 Statielei
660,Statielei 26,2023-09-18,07:00:00,133,69,64,FMN 12 Statielei
660,Statielei 26,2023-09-18,08:00:00,347,181,166,FMN 12 Statielei
660,Statielei 26,2023-09-18,09:00:00,118,71,47,FMN 12 Statielei
660,Statielei 26,2023-09-18,10:00:00,93,50,43,FMN 12 Statielei
660,Statielei 26,2023-09-18,11:00:00,75,44,31,FMN 12 Statielei
660,Statielei 26,2023-09-18,12:00:00,114,59,55,FMN 12 Statielei
660,Statielei 26,2023-09-18,13:00:00,96,52,44,FMN 12 Statielei
660,Statielei 26,2023-09-18,14:00:00,96,49,47,FMN 12 Statielei
660,Statielei 26,2023-09-18,15:00:00,164,64,100,FMN 12 Statielei
660,Statielei 26,2023-09-18,16:00:00,211,122,89,FMN 12 Statielei
660,Statielei 26,2023-09-18,17:00:00,239,103,136,FMN 12 Statielei
660,Statielei 26,2023-09-18,18:00:00,166,82,84,FMN 12 Statielei
660,Statielei 26,2023-09-18,19:00:00,163,92,71,FMN 12 Statielei
660,Statielei 26,2023-09-18,20:00:00,110,55,55,FMN 12 Statielei
660,Statielei 26,2023-09-18,21:00:00,102,47,55,FMN 12 Statielei
660,Statielei 26,2023-09-18,22:00:00,60,31,29,FMN 12 Statielei
660,Statielei 26,2023-09-18,23:00:00,42,22,20,FMN 12 Statielei
660,Statielei 26,2023-09-19,00:00:00,16,5,11,FMN 12 Statielei
660,Statielei 26,2023-09-19,01:00:00,15,4,11,FMN 12 Statielei
660,Statielei 26,2023-09-19,02:00:00,4,1,3,FMN 12 Statielei
660,Statielei 26,2023-09-19,03:00:00,5,0,5,FMN 12 Statielei
660,Statielei 26,2023-09-19,04:00:00,10,7,3,FMN 12 Statielei
660,Statielei 26,2023-09-19,05:00:00,14,6,8,FMN 12 Statielei
660,Statielei 26,2023-09-19,06:00:00,46,19,27,FMN 12 Statielei
660,Statielei 26,2023-09-19,07:00:00,151,83,68,FMN 12 Statielei
660,Statielei 26,2023-09-19,08:00:00,320,159,161,FMN 12 Statielei
660,Statielei 26,2023-09-19,09:00:00,124,78,46,FMN 12 Statielei
660,Statielei 26,2023-09-19,10:00:00,80,52,28,FMN 12 Statielei
660,Statielei 26,2023-09-19,11:00:00,80,45,35,FMN 12 Statielei
660,Statielei 26,2023-09-19,12:00:00,110,56,54,FMN 12 Statielei
660,Statielei 26,2023-09-19,13:00:00,91,52,39,FMN 12 Statielei
660,Statielei 26,2023-09-19,14:00:00,123,62,61,FMN 12 Statielei
660,Statielei 26,2023-09-19,15:00:00,184,78,106,FMN 12 Statielei
660,Statielei 26,2023-09-19,16:00:00,267,141,126,FMN 12 Statielei
660,Statielei 26,2023-09-19,17:00:00,233,108,125,FMN 12 Statielei
660,Statielei 26,2023-09-19,18:00:00,197,93,104,FMN 12 Statielei
660,Statielei 26,2023-09-19,19:00:00,145,76,69,FMN 12 Statielei
660,Statielei 26,2023-09-19,20:00:00,97,58,39,FMN 12 Statielei
660,Statielei 26,2023-09-19,21:00:00,94,39,55,FMN 12 Statielei
660,Statielei 26,2023-09-19,22:00:00,68,34,34,FMN 12 Statielei
660,Statielei 26,2023-09-19,23:00:00,46,22,24,FMN 12 Statielei
660,Statielei 26,2023-09-20,00:00:00,16,5,11,FMN 12 Statielei
660,Statielei 26,2023-09-20,01:00:00,15,3,12,FMN 12 Statielei
660,Statielei 26,2023-09-20,02:00:00,4,2,2,FMN 12 Statielei
660,Statielei 26,2023-09-20,03:00:00,9,5,4,FMN 12 Statielei
660,Statielei 26,2023-09-20,04:00:00,5,2,3,FMN 12 Statielei
660,Statielei 26,2023-09-20,05:00:00,17,6,11,FMN 12 Statielei
660,Statielei 26,2023-09-20,06:00:00,33,16,17,FMN 12 Statielei
660,Statielei 26,2023-09-20,07:00:00,122,62,60,FMN 12 Statielei
660,Statielei 26,2023-09-20,08:00:00,300,149,151,FMN 12 Statielei
660,Statielei 26,2023-09-20,09:00:00,139,82,57,FMN 12 Statielei
660,Statielei 26,2023-09-20,10:00:00,72,47,25,FMN 12 Statielei
660,Statielei 26,2023-09-20,11:00:00,83,41,42,FMN 12 Statielei
660,Statielei 26,2023-09-20,12:00:00,253,147,106,FMN 12 Statielei
660,Statielei 26,2023-09-20,13:00:00,145,78,67,FMN 12 Statielei
660,Statielei 26,2023-09-20,14:00:00,133,63,70,FMN 12 Statielei
660,Statielei 26,2023-09-20,15:00:00,134,62,72,FMN 12 Statielei
660,Statielei 26,2023-09-20,16:00:00,253,111,142,FMN 12 Statielei
660,Statielei 26,2023-09-20,17:00:00,236,110,126,FMN 12 Statielei
660,Statielei 26,2023-09-20,18:00:00,187,105,82,FMN 12 Statielei
660,Statielei 26,2023-09-20,19:00:00,164,92,72,FMN 12 Statielei
660,Statielei 26,2023-09-20,20:00:00,106,60,46,FMN 12 Statielei
660,Statielei 26,2023-09-20,21:00:00,68,31,37,FMN 12 Statielei
660,Statielei 26,2023-09-20,22:00:00,90,38,52,FMN 12 Statielei
660,Statielei 26,2023-09-20,23:00:00,31,9,22,FMN 12 Statielei
660,Statielei 26,2023-09-21,00:00:00,23,7,16,FMN 12 Statielei
660,Statielei 26,2023-09-21,01:00:00,11,2,9,FMN 12 Statielei
660,Statielei 26,2023-09-21,02:00:00,5,2,3,FMN 12 Statielei
660,Statielei 26,2023-09-21,03:00:00,5,1,4,FMN 12 Statielei
660,Statielei 26,2023-09-21,04:00:00,7,6,1,FMN 12 Statielei
660,Statielei 26,2023-09-21,05:00:00,12,3,9,FMN 12 Statielei
660,Statielei 26,2023-09-21,06:00:00,29,11,18,FMN 12 Statielei
660,Statielei 26,2023-09-21,07:00:00,98,47,51,FMN 12 Statielei
660,Statielei 26,2023-09-21,08:00:00,251,121,130,FMN 12 Statielei
660,Statielei 26,2023-09-21,09:00:00,79,54,25,FMN 12 Statielei
660,Statielei 26,2023-09-21,10:00:00,51,34,17,FMN 12 Statielei
660,Statielei 26,2023-09-21,11:00:00,34,19,15,FMN 12 Statielei
660,Statielei 26,2023-09-21,12:00:00,75,39,36,FMN 12 Statielei
660,Statielei 26,2023-09-21,13:00:00,76,38,38,FMN 12 Statielei
660,Statielei 26,2023-09-21,14:00:00,75,43,32,FMN 12 Statielei
660,Statielei 26,2023-09-21,15:00:00,131,44,87,FMN 12 Statielei
660,Statielei 26,2023-09-21,16:00:00,171,86,85,FMN 12 Statielei
660,Statielei 26,2023-09-21,17:00:00,171,89,82,FMN 12 Statielei
660,Statielei 26,2023-09-21,18:00:00,134,86,48,FMN 12 Statielei
660,Statielei 26,2023-09-21,19:00:00,159,96,63,FMN 12 Statielei
660,Statielei 26,2023-09-21,20:00:00,77,39,38,FMN 12 Statielei
660,Statielei 26,2023-09-21,21:00:00,80,40,40,FMN 12 Statielei
660,Statielei 26,2023-09-21,22:00:00,76,20,56,FMN 12 Statielei
660,Statielei 26,2023-09-21,23:00:00,58,16,42,FMN 12 Statielei
660,Statielei 26,2023-09-22,00:00:00,26,6,20,FMN 12 Statielei
660,Statielei 26,2023-09-22,01:00:00,14,4,10,FMN 12 Statielei
660,Statielei 26,2023-09-22,02:00:00,6,0,6,FMN 12 Statielei
660,Statielei 26,2023-09-22,03:00:00,2,1,1,FMN 12 Statielei
660,Statielei 26,2023-09-22,04:00:00,4,3,1,FMN 12 Statielei
660,Statielei 26,2023-09-22,05:00:00,15,4,11,FMN 12 Statielei
660,Statielei 26,2023-09-22,06:00:00,31,15,16,FMN 12 Statielei
660,Statielei 26,2023-09-22,07:00:00,116,60,56,FMN 12 Statielei
660,Statielei 26,2023-09-22,08:00:00,276,136,140,FMN 12 Statielei
660,Statielei 26,2023-09-22,09:00:00,130,90,40,FMN 12 Statielei
660,Statielei 26,2023-09-22,10:00:00,112,59,53,FMN 12 Statielei
660,Statielei 26,2023-09-22,11:00:00,98,55,43,FMN 12 Statielei
660,Statielei 26,2023-09-22,12:00:00,122,67,55,FMN 12 Statielei
660,Statielei 26,2023-09-22,13:00:00,99,42,57,FMN 12 Statielei
660,Statielei 26,2023-09-22,14:00:00,120,65,55,FMN 12 Statielei
660,Statielei 26,2023-09-22,15:00:00,173,82,91,FMN 12 Statielei
660,Statielei 26,2023-09-22,16:00:00,196,98,98,FMN 12 Statielei
660,Statielei 26,2023-09-22,17:00:00,143,68,75,FMN 12 Statielei
660,Statielei 26,2023-09-22,18:00:00,135,64,71,FMN 12 Statielei
660,Statielei 26,2023-09-22,19:00:00,141,69,72,FMN 12 Statielei
660,Statielei 26,2023-09-22,20:00:00,82,41,41,FMN 12 Statielei
660,Statielei 26,2023-09-22,21:00:00,82,44,38,FMN 12 Statielei
660,Statielei 26,2023-09-22,22:00:00,91,44,47,FMN 12 Statielei
660,Statielei 26,2023-09-22,23:00:00,48,23,25,FMN 12 Statielei
660,Statielei 26,2023-09-23,00:00:00,34,14,20,FMN 12 Statielei
660,Statielei 26,2023-09-23,01:00:00,35,14,21,FMN 12 Statielei
660,Statielei 26,2023-09-23,02:00:00,21,7,14,FMN 12 Statielei
660,Statielei 26,2023-09-23,03:00:00,11,2,9,FMN 12 Statielei
660,Statielei 26,2023-09-23,04:00:00,6,3,3,FMN 12 Statielei
660,Statielei 26,2023-09-23,05:00:00,13,6,7,FMN 12 Statielei
660,Statielei 26,2023-09-23,06:00:00,14,9,5,FMN 12 Statielei
660,Statielei 26,2023-09-23,07:00:00,30,12,18,FMN 12 Statielei
660,Statielei 26,2023-09-23,08:00:00,54,29,25,FMN 12 Statielei
660,Statielei 26,2023-09-23,09:00:00,110,53,57,FMN 12 Statielei
660,Statielei 26,2023-09-23,10:00:00,115,50,65,FMN 12 Statielei
660,Statielei 26,2023-09-23,11:00:00,141,80,61,FMN 12 Statielei
660,Statielei 26,2023-09-23,12:00:00,170,108,62,FMN 12 Statielei
660,Statielei 26,2023-09-23,13:00:00,181,99,82,FMN 12 Statielei
660,Statielei 26,2023-09-23,14:00:00,166,97,69,FMN 12 Statielei
660,Statielei 26,2023-09-23,15:00:00,190,101,89,FMN 12 Statielei
660,Statielei 26,2023-09-23,16:00:00,197,84,113,FMN 12 Statielei
660,Statielei 26,2023-09-23,17:00:00,197,101,96,FMN 12 Statielei
660,Statielei 26,2023-09-23,18:00:00,171,93,78,FMN 12 Statielei
660,Statielei 26,2023-09-23,19:00:00,162,70,92,FMN 12 Statielei
660,Statielei 26,2023-09-23,20:00:00,131,66,65,FMN 12 Statielei
660,Statielei 26,2023-09-23,21:00:00,79,41,38,FMN 12 Statielei
660,Statielei 26,2023-09-23,22:00:00,63,31,32,FMN 12 Statielei
660,Statielei 26,2023-09-23,23:00:00,101,59,42,FMN 12 Statielei
660,Statielei 26,2023-09-24,00:00:00,91,23,68,FMN 12 Statielei
660,Statielei 26,2023-09-24,01:00:00,42,19,23,FMN 12 Statielei
660,Statielei 26,2023-09-24,02:00:00,15,5,10,FMN 12 Statielei
660,Statielei 26,2023-09-24,03:00:00,9,2,7,FMN 12 Statielei
660,Statielei 26,2023-09-24,04:00:00,13,3,10,FMN 12 Statielei
660,Statielei 26,2023-09-24,05:00:00,16,6,10,FMN 12 Statielei
660,Statielei 26,2023-09-24,06:00:00,19,12,7,FMN 12 Statielei
660,Statielei 26,2023-09-24,07:00:00,12,3,9,FMN 12 Statielei
660,Statielei 26,2023-09-24,08:00:00,52,24,28,FMN 12 Statielei
660,Statielei 26,2023-09-24,09:00:00,88,35,53,FMN 12 Statielei
660,Statielei 26,2023-09-24,10:00:00,147,77,70,FMN 12 Statielei
660,Statielei 26,2023-09-24,11:00:00,143,66,77,FMN 12 Statielei
660,Statielei 26,2023-09-24,12:00:00,197,95,102,FMN 12 Statielei
660,Statielei 26,2023-09-24,13:00:00,187,85,102,FMN 12 Statielei
660,Statielei 26,2023-09-24,14:00:00,193,99,94,FMN 12 Statielei
660,Statielei 26,2023-09-24,15:00:00,159,80,79,FMN 12 Statielei
660,Statielei 26,2023-09-24,16:00:00,192,99,93,FMN 12 Statielei
660,Statielei 26,2023-09-24,17:00:00,190,102,88,FMN 12 Statielei
660,Statielei 26,2023-09-24,18:00:00,175,106,69,FMN 12 Statielei
660,Statielei 26,2023-09-24,19:00:00,106,63,43,FMN 12 Statielei
660,Statielei 26,2023-09-24,20:00:00,131,71,60,FMN 12 Statielei
660,Statielei 26,2023-09-24,21:00:00,64,26,38,FMN 12 Statielei
660,Statielei 26,2023-09-24,22:00:00,49,22,27,FMN 12 Statielei
660,Statielei 26,2023-09-24,23:00:00,23,10,13,FMN 12 Statielei
660,Statielei 26,2023-09-25,00:00:00,12,6,6,FMN 12 Statielei
660,Statielei 26,2023-09-25,01:00:00,8,4,4,FMN 12 Statielei
660,Statielei 26,2023-09-25,02:00:00,4,2,2,FMN 12 Statielei
660,Statielei 26,2023-09-25,03:00:00,4,1,3,FMN 12 Statielei
660,Statielei 26,2023-09-25,04:00:00,6,3,3,FMN 12 Statielei
660,Statielei 26,2023-09-25,05:00:00,21,9,12,FMN 12 Statielei
660,Statielei 26,2023-09-25,06:00:00,26,12,14,FMN 12 Statielei
660,Statielei 26,2023-09-25,07:00:00,138,79,59,FMN 12 Statielei
660,Statielei 26,2023-09-25,08:00:00,300,153,147,FMN 12 Statielei
660,Statielei 26,2023-09-25,09:00:00,130,79,51,FMN 12 Statielei
660,Statielei 26,2023-09-25,10:00:00,93,54,39,FMN 12 Statielei
660,Statielei 26,2023-09-25,11:00:00,98,59,39,FMN 12 Statielei
660,Statielei 26,2023-09-25,12:00:00,138,83,55,FMN 12 Statielei
660,Statielei 26,2023-09-25,13:00:00,93,55,38,FMN 12 Statielei
660,Statielei 26,2023-09-25,14:00:00,112,55,57,FMN 12 Statielei
660,Statielei 26,2023-09-25,15:00:00,176,73,103,FMN 12 Statielei
660,Statielei 26,2023-09-25,16:00:00,266,131,135,FMN 12 Statielei
660,Statielei 26,2023-09-25,17:00:00,255,127,128,FMN 12 Statielei
660,Statielei 26,2023-09-25,18:00:00,185,84,101,FMN 12 Statielei
660,Statielei 26,2023-09-25,19:00:00,146,79,67,FMN 12 Statielei
660,Statielei 26,2023-09-25,20:00:00,111,63,48,FMN 12 Statielei
660,Statielei 26,2023-09-25,21:00:00,82,39,43,FMN 12 Statielei
660,Statielei 26,2023-09-25,22:00:00,58,26,32,FMN 12 Statielei
660,Statielei 26,2023-09-25,23:00:00,27,7,20,FMN 12 Statielei
660,Statielei 26,2023-09-26,00:00:00,19,8,11,FMN 12 Statielei
660,Statielei 26,2023-09-26,01:00:00,12,5,7,FMN 12 Statielei
660,Statielei 26,2023-09-26,02:00:00,8,6,2,FMN 12 Statielei
660,Statielei 26,2023-09-26,03:00:00,9,1,8,FMN 12 Statielei
660,Statielei 26,2023-09-26,04:00:00,8,4,4,FMN 12 Statielei
660,Statielei 26,2023-09-26,05:00:00,22,10,12,FMN 12 Statielei
660,Statielei 26,2023-09-26,06:00:00,36,15,21,FMN 12 Statielei
660,Statielei 26,2023-09-26,07:00:00,152,80,72,FMN 12 Statielei
660,Statielei 26,2023-09-26,08:00:00,338,180,158,FMN 12 Statielei
660,Statielei 26,2023-09-26,09:00:00,136,84,52,FMN 12 Statielei
660,Statielei 26,2023-09-26,10:00:00,89,48,41,FMN 12 Statielei
660,Statielei 26,2023-09-26,11:00:00,86,50,36,FMN 12 Statielei
660,Statielei 26,2023-09-26,12:00:00,131,82,49,FMN 12 Statielei
660,Statielei 26,2023-09-26,13:00:00,95,46,49,FMN 12 Statielei
660,Statielei 26,2023-09-26,14:00:00,128,71,57,FMN 12 Statielei
660,Statielei 26,2023-09-26,15:00:00,180,75,105,FMN 12 Statielei
660,Statielei 26,2023-09-26,16:00:00,287,165,122,FMN 12 Statielei
660,Statielei 26,2023-09-26,17:00:00,257,130,127,FMN 12 Statielei
660,Statielei 26,2023-09-26,18:00:00,219,117,102,FMN 12 Statielei
660,Statielei 26,2023-09-26,19:00:00,169,95,74,FMN 12 Statielei
660,Statielei 26,2023-09-26,20:00:00,119,66,53,FMN 12 Statielei
660,Statielei 26,2023-09-26,21:00:00,119,48,71,FMN 12 Statielei
660,Statielei 26,2023-09-26,22:00:00,79,37,42,FMN 12 Statielei
660,Statielei 26,2023-09-26,23:00:00,38,11,27,FMN 12 Statielei
660,Statielei 26,2023-09-27,00:00:00,24,3,21,FMN 12 Statielei
660,Statielei 26,2023-09-27,01:00:00,10,2,8,FMN 12 Statielei
660,Statielei 26,2023-09-27,02:00:00,6,0,6,FMN 12 Statielei
660,Statielei 26,2023-09-27,03:00:00,3,0,3,FMN 12 Statielei
660,Statielei 26,2023-09-27,04:00:00,9,5,4,FMN 12 Statielei
660,Statielei 26,2023-09-27,05:00:00,21,11,10,FMN 12 Statielei
660,Statielei 26,2023-09-27,06:00:00,29,12,17,FMN 12 Statielei
660,Statielei 26,2023-09-27,07:00:00,157,79,78,FMN 12 Statielei
660,Statielei 26,2023-09-27,08:00:00,330,160,170,FMN 12 Statielei
660,Statielei 26,2023-09-27,09:00:00,133,77,56,FMN 12 Statielei
660,Statielei 26,2023-09-27,10:00:00,92,53,39,FMN 12 Statielei
660,Statielei 26,2023-09-27,11:00:00,125,71,54,FMN 12 Statielei
660,Statielei 26,2023-09-27,12:00:00,279,134,145,FMN 12 Statielei
660,Statielei 26,2023-09-27,13:00:00,189,96,93,FMN 12 Statielei
660,Statielei 26,2023-09-27,14:00:00,151,70,81,FMN 12 Statielei
660,Statielei 26,2023-09-27,15:00:00,179,92,87,FMN 12 Statielei
660,Statielei 26,2023-09-27,16:00:00,242,103,139,FMN 12 Statielei
660,Statielei 26,2023-09-27,17:00:00,257,124,133,FMN 12 Statielei
660,Statielei 26,2023-09-27,18:00:00,221,120,101,FMN 12 Statielei
660,Statielei 26,2023-09-27,19:00:00,216,104,112,FMN 12 Statielei
660,Statielei 26,2023-09-27,20:00:00,122,53,69,FMN 12 Statielei
660,Statielei 26,2023-09-27,21:00:00,98,43,55,FMN 12 Statielei
660,Statielei 26,2023-09-27,22:00:00,80,39,41,FMN 12 Statielei
660,Statielei 26,2023-09-27,23:00:00,87,55,32,FMN 12 Statielei
