Meetpunt surrogate key,Meetpunt locatie,Datum,Tijd,Aantal fietsers,Aantal fietsers van,Aantal fietsers naar,Meetpunt code
653,Gerard le Grellelaan 10,2022-08-22,00:00:00,7,7,0,FMN 05 Gerard Le Grellelaan
653,Gerard le Grellelaan 10,2022-08-22,01:00:00,7,4,3,FMN 05 Gerard Le Grellelaan
653,Gerard le Grellelaan 10,2022-08-22,02:00:00,4,2,2,FMN 05 Gerard Le Grellelaan
653,Gerard le Grellelaan 10,2022-08-22,03:00:00,1,0,1,FMN 05 Gerard Le Grellelaan
653,Gerard le Grellelaan 10,2022-08-22,04:00:00,12,8,4,FMN 05 Gerard Le Grellelaan
653,Gerard le Grellelaan 10,2022-08-22,05:00:00,28,8,20,FMN 05 Gerard Le Grellelaan
653,Gerard le Grellelaan 10,2022-08-22,06:00:00,36,22,14,FMN 05 Gerard Le Grellelaan
653,Gerard le Grellelaan 10,2022-08-22,07:00:00,124,83,41,FMN 05 Gerard Le Grellelaan
653,Gerard le Grellelaan 10,2022-08-22,08:00:00,167,133,34,FMN 05 Gerard Le Grellelaan
653,Gerard le Grellelaan 10,2022-08-22,09:00:00,90,76,14,FMN 05 Gerard Le Grellelaan
653,Gerard le Grellelaan 10,2022-08-22,10:00:00,63,51,12,FMN 05 Gerard Le Grellelaan
653,Gerard le Grellelaan 10,2022-08-22,11:00:00,75,63,12,FMN 05 Gerard Le Grellelaan
653,Gerard le Grellelaan 10,2022-08-22,12:00:00,89,68,21,FMN 05 Gerard Le Grellelaan
653,Gerard le Grellelaan 10,2022-08-22,13:00:00,68,55,13,FMN 05 Gerard Le Grellelaan
653,Gerard le Grellelaan 10,2022-08-22,14:00:00,85,62,23,FMN 05 Gerard Le Grellelaan
653,Gerard le Grellelaan 10,2022-08-22,15:00:00,53,45,8,FMN 05 Gerard Le Grellelaan
653,Gerard le Grellelaan 10,2022-08-22,16:00:00,99,81,18,FMN 05 Gerard Le Grellelaan
653,Gerard le Grellelaan 10,2022-08-22,17:00:00,157,129,28,FMN 05 Gerard Le Grellelaan
653,Gerard le Grellelaan 10,2022-08-22,18:00:00,142,116,26,FMN 05 Gerard Le Grellelaan
653,Gerard le Grellelaan 10,2022-08-22,19:00:00,91,72,19,FMN 05 Gerard Le Grellelaan
653,Gerard le Grellelaan 10,2022-08-22,20:00:00,59,43,16,FMN 05 Gerard Le Grellelaan
653,Gerard le Grellelaan 10,2022-08-22,21:00:00,59,45,14,FMN 05 Gerard Le Grellelaan
653,Gerard le Grellelaan 10,2022-08-22,22:00:00,48,36,12,FMN 05 Gerard Le Grellelaan
653,Gerard le Grellelaan 10,2022-08-22,23:00:00,19,14,5,FMN 05 Gerard Le Grellelaan
653,Gerard le Grellelaan 10,2022-08-23,00:00:00,15,13,2,FMN 05 Gerard Le Grellelaan
653,Gerard le Grellelaan 10,2022-08-23,01:00:00,5,4,1,FMN 05 Gerard Le Grellelaan
653,Gerard le Grellelaan 10,2022-08-23,02:00:00,5,2,3,FMN 05 Gerard Le Grellelaan
653,Gerard le Grellelaan 10,2022-08-23,03:00:00,1,1,0,FMN 05 Gerard Le Grellelaan
653,Gerard le Grellelaan 10,2022-08-23,04:00:00,13,7,6,FMN 05 Gerard Le Grellelaan
653,Gerard le Grellelaan 10,2022-08-23,05:00:00,37,10,27,FMN 05 Gerard Le Grellelaan
653,Gerard le Grellelaan 10,2022-08-23,06:00:00,49,32,17,FMN 05 Gerard Le Grellelaan
653,Gerard le Grellelaan 10,2022-08-23,07:00:00,124,83,41,FMN 05 Gerard Le Grellelaan
653,Gerard le Grellelaan 10,2022-08-23,08:00:00,185,150,35,FMN 05 Gerard Le Grellelaan
653,Gerard le Grellelaan 10,2022-08-23,09:00:00,129,109,20,FMN 05 Gerard Le Grellelaan
653,Gerard le Grellelaan 10,2022-08-23,10:00:00,70,49,21,FMN 05 Gerard Le Grellelaan
653,Gerard le Grellelaan 10,2022-08-23,11:00:00,88,77,11,FMN 05 Gerard Le Grellelaan
653,Gerard le Grellelaan 10,2022-08-23,12:00:00,77,64,13,FMN 05 Gerard Le Grellelaan
653,Gerard le Grellelaan 10,2022-08-23,13:00:00,89,70,19,FMN 05 Gerard Le Grellelaan
653,Gerard le Grellelaan 10,2022-08-23,14:00:00,92,76,16,FMN 05 Gerard Le Grellelaan
653,Gerard le Grellelaan 10,2022-08-23,15:00:00,62,44,18,FMN 05 Gerard Le Grellelaan
653,Gerard le Grellelaan 10,2022-08-23,16:00:00,99,79,20,FMN 05 Gerard Le Grellelaan
653,Gerard le Grellelaan 10,2022-08-23,17:00:00,184,143,41,FMN 05 Gerard Le Grellelaan
653,Gerard le Grellelaan 10,2022-08-23,18:00:00,142,117,25,FMN 05 Gerard Le Grellelaan
653,Gerard le Grellelaan 10,2022-08-23,19:00:00,98,74,24,FMN 05 Gerard Le Grellelaan
653,Gerard le Grellelaan 10,2022-08-23,20:00:00,60,47,13,FMN 05 Gerard Le Grellelaan
653,Gerard le Grellelaan 10,2022-08-23,21:00:00,70,54,16,FMN 05 Gerard Le Grellelaan
653,Gerard le Grellelaan 10,2022-08-23,22:00:00,53,44,9,FMN 05 Gerard Le Grellelaan
653,Gerard le Grellelaan 10,2022-08-23,23:00:00,15,13,2,FMN 05 Gerard Le Grellelaan
653,Gerard le Grellelaan 10,2022-08-24,00:00:00,22,15,7,FMN 05 Gerard Le Grellelaan
653,Gerard le Grellelaan 10,2022-08-24,01:00:00,3,3,0,FMN 05 Gerard Le Grellelaan
653,Gerard le Grellelaan 10,2022-08-24,02:00:00,2,2,0,FMN 05 Gerard Le Grellelaan
653,Gerard le Grellelaan 10,2022-08-24,03:00:00,1,0,1,FMN 05 Gerard Le Grellelaan
653,Gerard le Grellelaan 10,2022-08-24,04:00:00,11,8,3,FMN 05 Gerard Le Grellelaan
653,Gerard le Grellelaan 10,2022-08-24,05:00:00,23,5,18,FMN 05 Gerard Le Grellelaan
653,Gerard le Grellelaan 10,2022-08-24,06:00:00,48,32,16,FMN 05 Gerard Le Grellelaan
653,Gerard le Grellelaan 10,2022-08-24,07:00:00,111,72,39,FMN 05 Gerard Le Grellelaan
653,Gerard le Grellelaan 10,2022-08-24,08:00:00,195,154,41,FMN 05 Gerard Le Grellelaan
653,Gerard le Grellelaan 10,2022-08-24,09:00:00,98,84,14,FMN 05 Gerard Le Grellelaan
653,Gerard le Grellelaan 10,2022-08-24,10:00:00,87,75,12,FMN 05 Gerard Le Grellelaan
653,Gerard le Grellelaan 10,2022-08-24,11:00:00,84,68,16,FMN 05 Gerard Le Grellelaan
653,Gerard le Grellelaan 10,2022-08-24,12:00:00,73,53,20,FMN 05 Gerard Le Grellelaan
653,Gerard le Grellelaan 10,2022-08-24,13:00:00,72,57,15,FMN 05 Gerard Le Grellelaan
653,Gerard le Grellelaan 10,2022-08-24,14:00:00,58,43,15,FMN 05 Gerard Le Grellelaan
653,Gerard le Grellelaan 10,2022-08-24,15:00:00,75,66,9,FMN 05 Gerard Le Grellelaan
653,Gerard le Grellelaan 10,2022-08-24,16:00:00,112,84,28,FMN 05 Gerard Le Grellelaan
653,Gerard le Grellelaan 10,2022-08-24,17:00:00,151,119,32,FMN 05 Gerard Le Grellelaan
653,Gerard le Grellelaan 10,2022-08-24,18:00:00,139,116,23,FMN 05 Gerard Le Grellelaan
653,Gerard le Grellelaan 10,2022-08-24,19:00:00,89,70,19,FMN 05 Gerard Le Grellelaan
653,Gerard le Grellelaan 10,2022-08-24,20:00:00,83,66,17,FMN 05 Gerard Le Grellelaan
653,Gerard le Grellelaan 10,2022-08-24,21:00:00,68,52,16,FMN 05 Gerard Le Grellelaan
653,Gerard le Grellelaan 10,2022-08-24,22:00:00,70,57,13,FMN 05 Gerard Le Grellelaan
653,Gerard le Grellelaan 10,2022-08-24,23:00:00,26,21,5,FMN 05 Gerard Le Grellelaan
653,Gerard le Grellelaan 10,2022-08-25,00:00:00,16,13,3,FMN 05 Gerard Le Grellelaan
653,Gerard le Grellelaan 10,2022-08-25,01:00:00,3,2,1,FMN 05 Gerard Le Grellelaan
653,Gerard le Grellelaan 10,2022-08-25,02:00:00,3,2,1,FMN 05 Gerard Le Grellelaan
653,Gerard le Grellelaan 10,2022-08-25,03:00:00,4,3,1,FMN 05 Gerard Le Grellelaan
653,Gerard le Grellelaan 10,2022-08-25,04:00:00,12,7,5,FMN 05 Gerard Le Grellelaan
653,Gerard le Grellelaan 10,2022-08-25,05:00:00,27,9,18,FMN 05 Gerard Le Grellelaan
653,Gerard le Grellelaan 10,2022-08-25,06:00:00,46,28,18,FMN 05 Gerard Le Grellelaan
653,Gerard le Grellelaan 10,2022-08-25,07:00:00,123,75,48,FMN 05 Gerard Le Grellelaan
653,Gerard le Grellelaan 10,2022-08-25,08:00:00,200,155,45,FMN 05 Gerard Le Grellelaan
653,Gerard le Grellelaan 10,2022-08-25,09:00:00,115,95,20,FMN 05 Gerard Le Grellelaan
653,Gerard le Grellelaan 10,2022-08-25,10:00:00,75,65,10,FMN 05 Gerard Le Grellelaan
653,Gerard le Grellelaan 10,2022-08-25,11:00:00,91,76,15,FMN 05 Gerard Le Grellelaan
653,Gerard le Grellelaan 10,2022-08-25,12:00:00,85,63,22,FMN 05 Gerard Le Grellelaan
653,Gerard le Grellelaan 10,2022-08-25,13:00:00,82,64,18,FMN 05 Gerard Le Grellelaan
653,Gerard le Grellelaan 10,2022-08-25,14:00:00,78,64,14,FMN 05 Gerard Le Grellelaan
653,Gerard le Grellelaan 10,2022-08-25,15:00:00,97,80,17,FMN 05 Gerard Le Grellelaan
653,Gerard le Grellelaan 10,2022-08-25,16:00:00,160,124,36,FMN 05 Gerard Le Grellelaan
653,Gerard le Grellelaan 10,2022-08-25,17:00:00,191,150,41,FMN 05 Gerard Le Grellelaan
653,Gerard le Grellelaan 10,2022-08-25,18:00:00,147,105,42,FMN 05 Gerard Le Grellelaan
653,Gerard le Grellelaan 10,2022-08-25,19:00:00,87,69,18,FMN 05 Gerard Le Grellelaan
653,Gerard le Grellelaan 10,2022-08-25,20:00:00,80,62,18,FMN 05 Gerard Le Grellelaan
653,Gerard le Grellelaan 10,2022-08-25,21:00:00,56,39,17,FMN 05 Gerard Le Grellelaan
653,Gerard le Grellelaan 10,2022-08-25,22:00:00,60,48,12,FMN 05 Gerard Le Grellelaan
653,Gerard le Grellelaan 10,2022-08-25,23:00:00,47,31,16,FMN 05 Gerard Le Grellelaan
653,Gerard le Grellelaan 10,2022-08-26,00:00:00,22,19,3,FMN 05 Gerard Le Grellelaan
653,Gerard le Grellelaan 10,2022-08-26,01:00:00,15,13,2,FMN 05 Gerard Le Grellelaan
653,Gerard le Grellelaan 10,2022-08-26,02:00:00,17,15,2,FMN 05 Gerard Le Grellelaan
653,Gerard le Grellelaan 10,2022-08-26,03:00:00,7,6,1,FMN 05 Gerard Le Grellelaan
653,Gerard le Grellelaan 10,2022-08-26,04:00:00,8,7,1,FMN 05 Gerard Le Grellelaan
653,Gerard le Grellelaan 10,2022-08-26,05:00:00,27,10,17,FMN 05 Gerard Le Grellelaan
653,Gerard le Grellelaan 10,2022-08-26,06:00:00,43,23,20,FMN 05 Gerard Le Grellelaan
653,Gerard le Grellelaan 10,2022-08-26,07:00:00,97,69,28,FMN 05 Gerard Le Grellelaan
653,Gerard le Grellelaan 10,2022-08-26,08:00:00,154,117,37,FMN 05 Gerard Le Grellelaan
653,Gerard le Grellelaan 10,2022-08-26,09:00:00,75,59,16,FMN 05 Gerard Le Grellelaan
653,Gerard le Grellelaan 10,2022-08-26,10:00:00,58,48,10,FMN 05 Gerard Le Grellelaan
653,Gerard le Grellelaan 10,2022-08-26,11:00:00,65,50,15,FMN 05 Gerard Le Grellelaan
653,Gerard le Grellelaan 10,2022-08-26,12:00:00,79,60,19,FMN 05 Gerard Le Grellelaan
653,Gerard le Grellelaan 10,2022-08-26,13:00:00,83,66,17,FMN 05 Gerard Le Grellelaan
653,Gerard le Grellelaan 10,2022-08-26,14:00:00,87,68,19,FMN 05 Gerard Le Grellelaan
653,Gerard le Grellelaan 10,2022-08-26,15:00:00,120,89,31,FMN 05 Gerard Le Grellelaan
653,Gerard le Grellelaan 10,2022-08-26,16:00:00,152,128,24,FMN 05 Gerard Le Grellelaan
653,Gerard le Grellelaan 10,2022-08-26,17:00:00,157,130,27,FMN 05 Gerard Le Grellelaan
653,Gerard le Grellelaan 10,2022-08-26,18:00:00,101,83,18,FMN 05 Gerard Le Grellelaan
653,Gerard le Grellelaan 10,2022-08-26,19:00:00,86,66,20,FMN 05 Gerard Le Grellelaan
653,Gerard le Grellelaan 10,2022-08-26,20:00:00,51,39,12,FMN 05 Gerard Le Grellelaan
653,Gerard le Grellelaan 10,2022-08-26,21:00:00,56,52,4,FMN 05 Gerard Le Grellelaan
653,Gerard le Grellelaan 10,2022-08-26,22:00:00,41,29,12,FMN 05 Gerard Le Grellelaan
653,Gerard le Grellelaan 10,2022-08-26,23:00:00,33,25,8,FMN 05 Gerard Le Grellelaan
653,Gerard le Grellelaan 10,2022-08-27,00:00:00,22,16,6,FMN 05 Gerard Le Grellelaan
653,Gerard le Grellelaan 10,2022-08-27,01:00:00,26,17,9,FMN 05 Gerard Le Grellelaan
653,Gerard le Grellelaan 10,2022-08-27,02:00:00,10,5,5,FMN 05 Gerard Le Grellelaan
653,Gerard le Grellelaan 10,2022-08-27,03:00:00,7,6,1,FMN 05 Gerard Le Grellelaan
653,Gerard le Grellelaan 10,2022-08-27,04:00:00,6,5,1,FMN 05 Gerard Le Grellelaan
653,Gerard le Grellelaan 10,2022-08-27,05:00:00,10,10,0,FMN 05 Gerard Le Grellelaan
653,Gerard le Grellelaan 10,2022-08-27,06:00:00,9,5,4,FMN 05 Gerard Le Grellelaan
653,Gerard le Grellelaan 10,2022-08-27,07:00:00,15,10,5,FMN 05 Gerard Le Grellelaan
653,Gerard le Grellelaan 10,2022-08-27,08:00:00,27,21,6,FMN 05 Gerard Le Grellelaan
653,Gerard le Grellelaan 10,2022-08-27,09:00:00,52,44,8,FMN 05 Gerard Le Grellelaan
653,Gerard le Grellelaan 10,2022-08-27,10:00:00,75,58,17,FMN 05 Gerard Le Grellelaan
653,Gerard le Grellelaan 10,2022-08-27,11:00:00,85,65,20,FMN 05 Gerard Le Grellelaan
653,Gerard le Grellelaan 10,2022-08-27,12:00:00,92,78,14,FMN 05 Gerard Le Grellelaan
653,Gerard le Grellelaan 10,2022-08-27,13:00:00,81,65,16,FMN 05 Gerard Le Grellelaan
653,Gerard le Grellelaan 10,2022-08-27,14:00:00,85,64,21,FMN 05 Gerard Le Grellelaan
653,Gerard le Grellelaan 10,2022-08-27,15:00:00,111,89,22,FMN 05 Gerard Le Grellelaan
653,Gerard le Grellelaan 10,2022-08-27,16:00:00,70,57,13,FMN 05 Gerard Le Grellelaan
653,Gerard le Grellelaan 10,2022-08-27,17:00:00,91,66,25,FMN 05 Gerard Le Grellelaan
653,Gerard le Grellelaan 10,2022-08-27,18:00:00,96,72,24,FMN 05 Gerard Le Grellelaan
653,Gerard le Grellelaan 10,2022-08-27,19:00:00,79,58,21,FMN 05 Gerard Le Grellelaan
653,Gerard le Grellelaan 10,2022-08-27,20:00:00,60,49,11,FMN 05 Gerard Le Grellelaan
653,Gerard le Grellelaan 10,2022-08-27,21:00:00,42,31,11,FMN 05 Gerard Le Grellelaan
653,Gerard le Grellelaan 10,2022-08-27,22:00:00,43,37,6,FMN 05 Gerard Le Grellelaan
653,Gerard le Grellelaan 10,2022-08-27,23:00:00,27,23,4,FMN 05 Gerard Le Grellelaan
653,Gerard le Grellelaan 10,2022-08-28,00:00:00,48,37,11,FMN 05 Gerard Le Grellelaan
653,Gerard le Grellelaan 10,2022-08-28,01:00:00,34,30,4,FMN 05 Gerard Le Grellelaan
653,Gerard le Grellelaan 10,2022-08-28,02:00:00,18,15,3,FMN 05 Gerard Le Grellelaan
653,Gerard le Grellelaan 10,2022-08-28,03:00:00,5,3,2,FMN 05 Gerard Le Grellelaan
653,Gerard le Grellelaan 10,2022-08-28,04:00:00,3,1,2,FMN 05 Gerard Le Grellelaan
653,Gerard le Grellelaan 10,2022-08-28,05:00:00,8,8,0,FMN 05 Gerard Le Grellelaan
653,Gerard le Grellelaan 10,2022-08-28,06:00:00,2,1,1,FMN 05 Gerard Le Grellelaan
653,Gerard le Grellelaan 10,2022-08-28,07:00:00,9,7,2,FMN 05 Gerard Le Grellelaan
653,Gerard le Grellelaan 10,2022-08-28,08:00:00,14,9,5,FMN 05 Gerard Le Grellelaan
653,Gerard le Grellelaan 10,2022-08-28,09:00:00,47,36,11,FMN 05 Gerard Le Grellelaan
653,Gerard le Grellelaan 10,2022-08-28,10:00:00,80,63,17,FMN 05 Gerard Le Grellelaan
653,Gerard le Grellelaan 10,2022-08-28,11:00:00,53,42,11,FMN 05 Gerard Le Grellelaan
653,Gerard le Grellelaan 10,2022-08-28,12:00:00,80,68,12,FMN 05 Gerard Le Grellelaan
653,Gerard le Grellelaan 10,2022-08-28,13:00:00,98,85,13,FMN 05 Gerard Le Grellelaan
653,Gerard le Grellelaan 10,2022-08-28,14:00:00,73,62,11,FMN 05 Gerard Le Grellelaan
653,Gerard le Grellelaan 10,2022-08-28,15:00:00,100,84,16,FMN 05 Gerard Le Grellelaan
653,Gerard le Grellelaan 10,2022-08-28,16:00:00,68,55,13,FMN 05 Gerard Le Grellelaan
653,Gerard le Grellelaan 10,2022-08-28,17:00:00,91,82,9,FMN 05 Gerard Le Grellelaan
653,Gerard le Grellelaan 10,2022-08-28,18:00:00,65,55,10,FMN 05 Gerard Le Grellelaan
653,Gerard le Grellelaan 10,2022-08-28,19:00:00,81,56,25,FMN 05 Gerard Le Grellelaan
653,Gerard le Grellelaan 10,2022-08-28,20:00:00,66,50,16,FMN 05 Gerard Le Grellelaan
653,Gerard le Grellelaan 10,2022-08-28,21:00:00,45,37,8,FMN 05 Gerard Le Grellelaan
653,Gerard le Grellelaan 10,2022-08-28,22:00:00,39,32,7,FMN 05 Gerard Le Grellelaan
653,Gerard le Grellelaan 10,2022-08-28,23:00:00,25,19,6,FMN 05 Gerard Le Grellelaan
653,Gerard le Grellelaan 10,2022-08-29,00:00:00,14,13,1,FMN 05 Gerard Le Grellelaan
653,Gerard le Grellelaan 10,2022-08-29,01:00:00,10,10,0,FMN 05 Gerard Le Grellelaan
653,Gerard le Grellelaan 10,2022-08-29,02:00:00,9,8,1,FMN 05 Gerard Le Grellelaan
653,Gerard le Grellelaan 10,2022-08-29,03:00:00,4,4,0,FMN 05 Gerard Le Grellelaan
653,Gerard le Grellelaan 10,2022-08-29,04:00:00,10,6,4,FMN 05 Gerard Le Grellelaan
653,Gerard le Grellelaan 10,2022-08-29,05:00:00,24,10,14,FMN 05 Gerard Le Grellelaan
653,Gerard le Grellelaan 10,2022-08-29,06:00:00,48,24,24,FMN 05 Gerard Le Grellelaan
653,Gerard le Grellelaan 10,2022-08-29,07:00:00,112,76,36,FMN 05 Gerard Le Grellelaan
653,Gerard le Grellelaan 10,2022-08-29,08:00:00,195,157,38,FMN 05 Gerard Le Grellelaan
653,Gerard le Grellelaan 10,2022-08-29,09:00:00,87,75,12,FMN 05 Gerard Le Grellelaan
653,Gerard le Grellelaan 10,2022-08-29,10:00:00,56,46,10,FMN 05 Gerard Le Grellelaan
653,Gerard le Grellelaan 10,2022-08-29,11:00:00,66,54,12,FMN 05 Gerard Le Grellelaan
653,Gerard le Grellelaan 10,2022-08-29,12:00:00,84,66,18,FMN 05 Gerard Le Grellelaan
653,Gerard le Grellelaan 10,2022-08-29,13:00:00,89,72,17,FMN 05 Gerard Le Grellelaan
653,Gerard le Grellelaan 10,2022-08-29,14:00:00,92,76,16,FMN 05 Gerard Le Grellelaan
653,Gerard le Grellelaan 10,2022-08-29,15:00:00,99,73,26,FMN 05 Gerard Le Grellelaan
653,Gerard le Grellelaan 10,2022-08-29,16:00:00,140,111,29,FMN 05 Gerard Le Grellelaan
653,Gerard le Grellelaan 10,2022-08-29,17:00:00,175,132,43,FMN 05 Gerard Le Grellelaan
653,Gerard le Grellelaan 10,2022-08-29,18:00:00,137,106,31,FMN 05 Gerard Le Grellelaan
653,Gerard le Grellelaan 10,2022-08-29,19:00:00,118,92,26,FMN 05 Gerard Le Grellelaan
653,Gerard le Grellelaan 10,2022-08-29,20:00:00,71,60,11,FMN 05 Gerard Le Grellelaan
653,Gerard le Grellelaan 10,2022-08-29,21:00:00,47,40,7,FMN 05 Gerard Le Grellelaan
653,Gerard le Grellelaan 10,2022-08-29,22:00:00,53,40,13,FMN 05 Gerard Le Grellelaan
653,Gerard le Grellelaan 10,2022-08-29,23:00:00,13,11,2,FMN 05 Gerard Le Grellelaan
653,Gerard le Grellelaan 10,2022-08-30,00:00:00,8,6,2,FMN 05 Gerard Le Grellelaan
653,Gerard le Grellelaan 10,2022-08-30,01:00:00,5,4,1,FMN 05 Gerard Le Grellelaan
653,Gerard le Grellelaan 10,2022-08-30,02:00:00,4,3,1,FMN 05 Gerard Le Grellelaan
653,Gerard le Grellelaan 10,2022-08-30,03:00:00,2,1,1,FMN 05 Gerard Le Grellelaan
653,Gerard le Grellelaan 10,2022-08-30,04:00:00,9,6,3,FMN 05 Gerard Le Grellelaan
653,Gerard le Grellelaan 10,2022-08-30,05:00:00,20,5,15,FMN 05 Gerard Le Grellelaan
653,Gerard le Grellelaan 10,2022-08-30,06:00:00,50,29,21,FMN 05 Gerard Le Grellelaan
653,Gerard le Grellelaan 10,2022-08-30,07:00:00,147,100,47,FMN 05 Gerard Le Grellelaan
653,Gerard le Grellelaan 10,2022-08-30,08:00:00,243,194,49,FMN 05 Gerard Le Grellelaan
653,Gerard le Grellelaan 10,2022-08-30,09:00:00,121,103,18,FMN 05 Gerard Le Grellelaan
653,Gerard le Grellelaan 10,2022-08-30,10:00:00,70,53,17,FMN 05 Gerard Le Grellelaan
653,Gerard le Grellelaan 10,2022-08-30,11:00:00,99,89,10,FMN 05 Gerard Le Grellelaan
653,Gerard le Grellelaan 10,2022-08-30,12:00:00,111,76,35,FMN 05 Gerard Le Grellelaan
653,Gerard le Grellelaan 10,2022-08-30,13:00:00,107,79,28,FMN 05 Gerard Le Grellelaan
653,Gerard le Grellelaan 10,2022-08-30,14:00:00,119,101,18,FMN 05 Gerard Le Grellelaan
653,Gerard le Grellelaan 10,2022-08-30,15:00:00,118,99,19,FMN 05 Gerard Le Grellelaan
653,Gerard le Grellelaan 10,2022-08-30,16:00:00,200,151,49,FMN 05 Gerard Le Grellelaan
653,Gerard le Grellelaan 10,2022-08-30,17:00:00,233,175,58,FMN 05 Gerard Le Grellelaan
653,Gerard le Grellelaan 10,2022-08-30,18:00:00,187,144,43,FMN 05 Gerard Le Grellelaan
653,Gerard le Grellelaan 10,2022-08-30,19:00:00,114,94,20,FMN 05 Gerard Le Grellelaan
653,Gerard le Grellelaan 10,2022-08-30,20:00:00,80,65,15,FMN 05 Gerard Le Grellelaan
653,Gerard le Grellelaan 10,2022-08-30,21:00:00,67,47,20,FMN 05 Gerard Le Grellelaan
653,Gerard le Grellelaan 10,2022-08-30,22:00:00,60,46,14,FMN 05 Gerard Le Grellelaan
653,Gerard le Grellelaan 10,2022-08-30,23:00:00,26,19,7,FMN 05 Gerard Le Grellelaan
653,Gerard le Grellelaan 10,2022-08-31,00:00:00,10,8,2,FMN 05 Gerard Le Grellelaan
653,Gerard le Grellelaan 10,2022-08-31,01:00:00,4,3,1,FMN 05 Gerard Le Grellelaan
653,Gerard le Grellelaan 10,2022-08-31,02:00:00,1,0,1,FMN 05 Gerard Le Grellelaan
653,Gerard le Grellelaan 10,2022-08-31,03:00:00,6,2,4,FMN 05 Gerard Le Grellelaan
653,Gerard le Grellelaan 10,2022-08-31,04:00:00,9,6,3,FMN 05 Gerard Le Grellelaan
653,Gerard le Grellelaan 10,2022-08-31,05:00:00,29,7,22,FMN 05 Gerard Le Grellelaan
653,Gerard le Grellelaan 10,2022-08-31,06:00:00,57,32,25,FMN 05 Gerard Le Grellelaan
653,Gerard le Grellelaan 10,2022-08-31,07:00:00,125,81,44,FMN 05 Gerard Le Grellelaan
653,Gerard le Grellelaan 10,2022-08-31,08:00:00,167,143,24,FMN 05 Gerard Le Grellelaan
653,Gerard le Grellelaan 10,2022-08-31,09:00:00,118,96,22,FMN 05 Gerard Le Grellelaan
653,Gerard le Grellelaan 10,2022-08-31,10:00:00,58,45,13,FMN 05 Gerard Le Grellelaan
653,Gerard le Grellelaan 10,2022-08-31,11:00:00,110,92,18,FMN 05 Gerard Le Grellelaan
653,Gerard le Grellelaan 10,2022-08-31,12:00:00,109,89,20,FMN 05 Gerard Le Grellelaan
653,Gerard le Grellelaan 10,2022-08-31,13:00:00,123,91,32,FMN 05 Gerard Le Grellelaan
653,Gerard le Grellelaan 10,2022-08-31,14:00:00,102,75,27,FMN 05 Gerard Le Grellelaan
653,Gerard le Grellelaan 10,2022-08-31,15:00:00,133,105,28,FMN 05 Gerard Le Grellelaan
653,Gerard le Grellelaan 10,2022-08-31,16:00:00,210,165,45,FMN 05 Gerard Le Grellelaan
653,Gerard le Grellelaan 10,2022-08-31,17:00:00,180,145,35,FMN 05 Gerard Le Grellelaan
653,Gerard le Grellelaan 10,2022-08-31,18:00:00,163,138,25,FMN 05 Gerard Le Grellelaan
653,Gerard le Grellelaan 10,2022-08-31,19:00:00,126,99,27,FMN 05 Gerard Le Grellelaan
653,Gerard le Grellelaan 10,2022-08-31,20:00:00,82,68,14,FMN 05 Gerard Le Grellelaan
653,Gerard le Grellelaan 10,2022-08-31,21:00:00,72,58,14,FMN 05 Gerard Le Grellelaan
653,Gerard le Grellelaan 10,2022-08-31,22:00:00,67,52,15,FMN 05 Gerard Le Grellelaan
653,Gerard le Grellelaan 10,2022-08-31,23:00:00,26,17,9,FMN 05 Gerard Le Grellelaan
653,Gerard le Grellelaan 10,2022-09-01,00:00:00,6,5,1,FMN 05 Gerard Le Grellelaan
653,Gerard le Grellelaan 10,2022-09-01,01:00:00,3,2,1,FMN 05 Gerard Le Grellelaan
653,Gerard le Grellelaan 10,2022-09-01,02:00:00,3,1,2,FMN 05 Gerard Le Grellelaan
653,Gerard le Grellelaan 10,2022-09-01,03:00:00,4,3,1,FMN 05 Gerard Le Grellelaan
653,Gerard le Grellelaan 10,2022-09-01,04:00:00,7,5,2,FMN 05 Gerard Le Grellelaan
653,Gerard le Grellelaan 10,2022-09-01,05:00:00,22,8,14,FMN 05 Gerard Le Grellelaan
653,Gerard le Grellelaan 10,2022-09-01,06:00:00,57,36,21,FMN 05 Gerard Le Grellelaan
653,Gerard le Grellelaan 10,2022-09-01,07:00:00,163,121,42,FMN 05 Gerard Le Grellelaan
653,Gerard le Grellelaan 10,2022-09-01,08:00:00,328,259,69,FMN 05 Gerard Le Grellelaan
653,Gerard le Grellelaan 10,2022-09-01,09:00:00,159,133,26,FMN 05 Gerard Le Grellelaan
653,Gerard le Grellelaan 10,2022-09-01,10:00:00,85,73,12,FMN 05 Gerard Le Grellelaan
653,Gerard le Grellelaan 10,2022-09-01,11:00:00,78,69,9,FMN 05 Gerard Le Grellelaan
653,Gerard le Grellelaan 10,2022-09-01,12:00:00,106,80,26,FMN 05 Gerard Le Grellelaan
653,Gerard le Grellelaan 10,2022-09-01,13:00:00,99,76,23,FMN 05 Gerard Le Grellelaan
653,Gerard le Grellelaan 10,2022-09-01,14:00:00,99,83,16,FMN 05 Gerard Le Grellelaan
653,Gerard le Grellelaan 10,2022-09-01,15:00:00,161,123,38,FMN 05 Gerard Le Grellelaan
653,Gerard le Grellelaan 10,2022-09-01,16:00:00,191,143,48,FMN 05 Gerard Le Grellelaan
653,Gerard le Grellelaan 10,2022-09-01,17:00:00,213,157,56,FMN 05 Gerard Le Grellelaan
653,Gerard le Grellelaan 10,2022-09-01,18:00:00,174,131,43,FMN 05 Gerard Le Grellelaan
653,Gerard le Grellelaan 10,2022-09-01,19:00:00,105,89,16,FMN 05 Gerard Le Grellelaan
653,Gerard le Grellelaan 10,2022-09-01,20:00:00,86,61,25,FMN 05 Gerard Le Grellelaan
653,Gerard le Grellelaan 10,2022-09-01,21:00:00,58,45,13,FMN 05 Gerard Le Grellelaan
653,Gerard le Grellelaan 10,2022-09-01,22:00:00,50,42,8,FMN 05 Gerard Le Grellelaan
653,Gerard le Grellelaan 10,2022-09-01,23:00:00,23,13,10,FMN 05 Gerard Le Grellelaan
653,Gerard le Grellelaan 10,2022-09-02,00:00:00,5,2,3,FMN 05 Gerard Le Grellelaan
653,Gerard le Grellelaan 10,2022-09-02,01:00:00,3,2,1,FMN 05 Gerard Le Grellelaan
653,Gerard le Grellelaan 10,2022-09-02,02:00:00,4,2,2,FMN 05 Gerard Le Grellelaan
653,Gerard le Grellelaan 10,2022-09-02,03:00:00,3,1,2,FMN 05 Gerard Le Grellelaan
653,Gerard le Grellelaan 10,2022-09-02,04:00:00,8,5,3,FMN 05 Gerard Le Grellelaan
653,Gerard le Grellelaan 10,2022-09-02,05:00:00,18,7,11,FMN 05 Gerard Le Grellelaan
653,Gerard le Grellelaan 10,2022-09-02,06:00:00,49,29,20,FMN 05 Gerard Le Grellelaan
653,Gerard le Grellelaan 10,2022-09-02,07:00:00,160,122,38,FMN 05 Gerard Le Grellelaan
653,Gerard le Grellelaan 10,2022-09-02,08:00:00,301,235,66,FMN 05 Gerard Le Grellelaan
653,Gerard le Grellelaan 10,2022-09-02,09:00:00,101,84,17,FMN 05 Gerard Le Grellelaan
653,Gerard le Grellelaan 10,2022-09-02,10:00:00,100,89,11,FMN 05 Gerard Le Grellelaan
653,Gerard le Grellelaan 10,2022-09-02,11:00:00,82,67,15,FMN 05 Gerard Le Grellelaan
653,Gerard le Grellelaan 10,2022-09-02,12:00:00,124,93,31,FMN 05 Gerard Le Grellelaan
653,Gerard le Grellelaan 10,2022-09-02,13:00:00,128,97,31,FMN 05 Gerard Le Grellelaan
653,Gerard le Grellelaan 10,2022-09-02,14:00:00,96,72,24,FMN 05 Gerard Le Grellelaan
653,Gerard le Grellelaan 10,2022-09-02,15:00:00,126,100,26,FMN 05 Gerard Le Grellelaan
653,Gerard le Grellelaan 10,2022-09-02,16:00:00,159,122,37,FMN 05 Gerard Le Grellelaan
653,Gerard le Grellelaan 10,2022-09-02,17:00:00,162,123,39,FMN 05 Gerard Le Grellelaan
653,Gerard le Grellelaan 10,2022-09-02,18:00:00,158,138,20,FMN 05 Gerard Le Grellelaan
653,Gerard le Grellelaan 10,2022-09-02,19:00:00,109,92,17,FMN 05 Gerard Le Grellelaan
653,Gerard le Grellelaan 10,2022-09-02,20:00:00,74,64,10,FMN 05 Gerard Le Grellelaan
653,Gerard le Grellelaan 10,2022-09-02,21:00:00,61,50,11,FMN 05 Gerard Le Grellelaan
653,Gerard le Grellelaan 10,2022-09-02,22:00:00,50,42,8,FMN 05 Gerard Le Grellelaan
653,Gerard le Grellelaan 10,2022-09-02,23:00:00,26,18,8,FMN 05 Gerard Le Grellelaan
653,Gerard le Grellelaan 10,2022-09-03,00:00:00,20,15,5,FMN 05 Gerard Le Grellelaan
653,Gerard le Grellelaan 10,2022-09-03,01:00:00,14,9,5,FMN 05 Gerard Le Grellelaan
653,Gerard le Grellelaan 10,2022-09-03,02:00:00,18,12,6,FMN 05 Gerard Le Grellelaan
653,Gerard le Grellelaan 10,2022-09-03,03:00:00,7,5,2,FMN 05 Gerard Le Grellelaan
653,Gerard le Grellelaan 10,2022-09-03,04:00:00,8,4,4,FMN 05 Gerard Le Grellelaan
653,Gerard le Grellelaan 10,2022-09-03,05:00:00,3,1,2,FMN 05 Gerard Le Grellelaan
653,Gerard le Grellelaan 10,2022-09-03,06:00:00,8,6,2,FMN 05 Gerard Le Grellelaan
653,Gerard le Grellelaan 10,2022-09-03,07:00:00,22,17,5,FMN 05 Gerard Le Grellelaan
653,Gerard le Grellelaan 10,2022-09-03,08:00:00,24,20,4,FMN 05 Gerard Le Grellelaan
653,Gerard le Grellelaan 10,2022-09-03,09:00:00,55,43,12,FMN 05 Gerard Le Grellelaan
653,Gerard le Grellelaan 10,2022-09-03,10:00:00,76,61,15,FMN 05 Gerard Le Grellelaan
653,Gerard le Grellelaan 10,2022-09-03,11:00:00,70,56,14,FMN 05 Gerard Le Grellelaan
653,Gerard le Grellelaan 10,2022-09-03,12:00:00,83,62,21,FMN 05 Gerard Le Grellelaan
653,Gerard le Grellelaan 10,2022-09-03,13:00:00,73,60,13,FMN 05 Gerard Le Grellelaan
653,Gerard le Grellelaan 10,2022-09-03,14:00:00,81,70,11,FMN 05 Gerard Le Grellelaan
653,Gerard le Grellelaan 10,2022-09-03,15:00:00,81,68,13,FMN 05 Gerard Le Grellelaan
653,Gerard le Grellelaan 10,2022-09-03,16:00:00,91,75,16,FMN 05 Gerard Le Grellelaan
653,Gerard le Grellelaan 10,2022-09-03,17:00:00,78,65,13,FMN 05 Gerard Le Grellelaan
653,Gerard le Grellelaan 10,2022-09-03,18:00:00,97,69,28,FMN 05 Gerard Le Grellelaan
653,Gerard le Grellelaan 10,2022-09-03,19:00:00,54,44,10,FMN 05 Gerard Le Grellelaan
653,Gerard le Grellelaan 10,2022-09-03,20:00:00,50,42,8,FMN 05 Gerard Le Grellelaan
653,Gerard le Grellelaan 10,2022-09-03,21:00:00,31,25,6,FMN 05 Gerard Le Grellelaan
653,Gerard le Grellelaan 10,2022-09-03,22:00:00,31,26,5,FMN 05 Gerard Le Grellelaan
653,Gerard le Grellelaan 10,2022-09-03,23:00:00,41,27,14,FMN 05 Gerard Le Grellelaan
653,Gerard le Grellelaan 10,2022-09-04,00:00:00,25,18,7,FMN 05 Gerard Le Grellelaan
653,Gerard le Grellelaan 10,2022-09-04,01:00:00,14,14,0,FMN 05 Gerard Le Grellelaan
653,Gerard le Grellelaan 10,2022-09-04,02:00:00,10,8,2,FMN 05 Gerard Le Grellelaan
653,Gerard le Grellelaan 10,2022-09-04,03:00:00,14,11,3,FMN 05 Gerard Le Grellelaan
653,Gerard le Grellelaan 10,2022-09-04,04:00:00,9,9,0,FMN 05 Gerard Le Grellelaan
653,Gerard le Grellelaan 10,2022-09-04,05:00:00,1,1,0,FMN 05 Gerard Le Grellelaan
653,Gerard le Grellelaan 10,2022-09-04,06:00:00,5,4,1,FMN 05 Gerard Le Grellelaan
653,Gerard le Grellelaan 10,2022-09-04,07:00:00,9,7,2,FMN 05 Gerard Le Grellelaan
653,Gerard le Grellelaan 10,2022-09-04,08:00:00,21,16,5,FMN 05 Gerard Le Grellelaan
653,Gerard le Grellelaan 10,2022-09-04,09:00:00,61,42,19,FMN 05 Gerard Le Grellelaan
653,Gerard le Grellelaan 10,2022-09-04,10:00:00,103,69,34,FMN 05 Gerard Le Grellelaan
653,Gerard le Grellelaan 10,2022-09-04,11:00:00,102,79,23,FMN 05 Gerard Le Grellelaan
653,Gerard le Grellelaan 10,2022-09-04,12:00:00,95,85,10,FMN 05 Gerard Le Grellelaan
653,Gerard le Grellelaan 10,2022-09-04,13:00:00,115,104,11,FMN 05 Gerard Le Grellelaan
653,Gerard le Grellelaan 10,2022-09-04,14:00:00,113,97,16,FMN 05 Gerard Le Grellelaan
653,Gerard le Grellelaan 10,2022-09-04,15:00:00,93,75,18,FMN 05 Gerard Le Grellelaan
653,Gerard le Grellelaan 10,2022-09-04,16:00:00,77,65,12,FMN 05 Gerard Le Grellelaan
653,Gerard le Grellelaan 10,2022-09-04,17:00:00,116,103,13,FMN 05 Gerard Le Grellelaan
653,Gerard le Grellelaan 10,2022-09-04,18:00:00,93,82,11,FMN 05 Gerard Le Grellelaan
653,Gerard le Grellelaan 10,2022-09-04,19:00:00,63,49,14,FMN 05 Gerard Le Grellelaan
653,Gerard le Grellelaan 10,2022-09-04,20:00:00,53,37,16,FMN 05 Gerard Le Grellelaan
653,Gerard le Grellelaan 10,2022-09-04,21:00:00,52,32,20,FMN 05 Gerard Le Grellelaan
653,Gerard le Grellelaan 10,2022-09-04,22:00:00,20,18,2,FMN 05 Gerard Le Grellelaan
653,Gerard le Grellelaan 10,2022-09-04,23:00:00,25,14,11,FMN 05 Gerard Le Grellelaan
653,Gerard le Grellelaan 10,2022-09-05,00:00:00,9,4,5,FMN 05 Gerard Le Grellelaan
653,Gerard le Grellelaan 10,2022-09-05,01:00:00,0,0,0,FMN 05 Gerard Le Grellelaan
653,Gerard le Grellelaan 10,2022-09-05,02:00:00,5,3,2,FMN 05 Gerard Le Grellelaan
653,Gerard le Grellelaan 10,2022-09-05,03:00:00,4,2,2,FMN 05 Gerard Le Grellelaan
653,Gerard le Grellelaan 10,2022-09-05,04:00:00,5,3,2,FMN 05 Gerard Le Grellelaan
653,Gerard le Grellelaan 10,2022-09-05,05:00:00,30,12,18,FMN 05 Gerard Le Grellelaan
653,Gerard le Grellelaan 10,2022-09-05,06:00:00,46,21,25,FMN 05 Gerard Le Grellelaan
653,Gerard le Grellelaan 10,2022-09-05,07:00:00,176,128,48,FMN 05 Gerard Le Grellelaan
653,Gerard le Grellelaan 10,2022-09-05,08:00:00,339,262,77,FMN 05 Gerard Le Grellelaan
653,Gerard le Grellelaan 10,2022-09-05,09:00:00,114,98,16,FMN 05 Gerard Le Grellelaan
653,Gerard le Grellelaan 10,2022-09-05,10:00:00,70,62,8,FMN 05 Gerard Le Grellelaan
653,Gerard le Grellelaan 10,2022-09-05,11:00:00,74,66,8,FMN 05 Gerard Le Grellelaan
653,Gerard le Grellelaan 10,2022-09-05,12:00:00,83,65,18,FMN 05 Gerard Le Grellelaan
653,Gerard le Grellelaan 10,2022-09-05,13:00:00,81,65,16,FMN 05 Gerard Le Grellelaan
653,Gerard le Grellelaan 10,2022-09-05,14:00:00,101,76,25,FMN 05 Gerard Le Grellelaan
653,Gerard le Grellelaan 10,2022-09-05,15:00:00,162,131,31,FMN 05 Gerard Le Grellelaan
653,Gerard le Grellelaan 10,2022-09-05,16:00:00,141,100,41,FMN 05 Gerard Le Grellelaan
653,Gerard le Grellelaan 10,2022-09-05,17:00:00,188,141,47,FMN 05 Gerard Le Grellelaan
653,Gerard le Grellelaan 10,2022-09-05,18:00:00,124,93,31,FMN 05 Gerard Le Grellelaan
653,Gerard le Grellelaan 10,2022-09-05,19:00:00,91,74,17,FMN 05 Gerard Le Grellelaan
653,Gerard le Grellelaan 10,2022-09-05,20:00:00,72,58,14,FMN 05 Gerard Le Grellelaan
653,Gerard le Grellelaan 10,2022-09-05,21:00:00,21,16,5,FMN 05 Gerard Le Grellelaan
653,Gerard le Grellelaan 10,2022-09-05,22:00:00,45,38,7,FMN 05 Gerard Le Grellelaan
653,Gerard le Grellelaan 10,2022-09-05,23:00:00,23,19,4,FMN 05 Gerard Le Grellelaan
653,Gerard le Grellelaan 10,2022-09-06,00:00:00,5,3,2,FMN 05 Gerard Le Grellelaan
653,Gerard le Grellelaan 10,2022-09-06,01:00:00,2,1,1,FMN 05 Gerard Le Grellelaan
653,Gerard le Grellelaan 10,2022-09-06,02:00:00,6,3,3,FMN 05 Gerard Le Grellelaan
653,Gerard le Grellelaan 10,2022-09-06,03:00:00,4,2,2,FMN 05 Gerard Le Grellelaan
653,Gerard le Grellelaan 10,2022-09-06,04:00:00,9,6,3,FMN 05 Gerard Le Grellelaan
653,Gerard le Grellelaan 10,2022-09-06,05:00:00,37,11,26,FMN 05 Gerard Le Grellelaan
653,Gerard le Grellelaan 10,2022-09-06,06:00:00,57,30,27,FMN 05 Gerard Le Grellelaan
653,Gerard le Grellelaan 10,2022-09-06,07:00:00,193,146,47,FMN 05 Gerard Le Grellelaan
653,Gerard le Grellelaan 10,2022-09-06,08:00:00,330,263,67,FMN 05 Gerard Le Grellelaan
653,Gerard le Grellelaan 10,2022-09-06,09:00:00,127,112,15,FMN 05 Gerard Le Grellelaan
653,Gerard le Grellelaan 10,2022-09-06,10:00:00,70,60,10,FMN 05 Gerard Le Grellelaan
653,Gerard le Grellelaan 10,2022-09-06,11:00:00,74,63,11,FMN 05 Gerard Le Grellelaan
653,Gerard le Grellelaan 10,2022-09-06,12:00:00,108,84,24,FMN 05 Gerard Le Grellelaan
653,Gerard le Grellelaan 10,2022-09-06,13:00:00,95,75,20,FMN 05 Gerard Le Grellelaan
653,Gerard le Grellelaan 10,2022-09-06,14:00:00,103,88,15,FMN 05 Gerard Le Grellelaan
653,Gerard le Grellelaan 10,2022-09-06,15:00:00,161,124,37,FMN 05 Gerard Le Grellelaan
653,Gerard le Grellelaan 10,2022-09-06,16:00:00,216,160,56,FMN 05 Gerard Le Grellelaan
653,Gerard le Grellelaan 10,2022-09-06,17:00:00,275,218,57,FMN 05 Gerard Le Grellelaan
653,Gerard le Grellelaan 10,2022-09-06,18:00:00,141,106,35,FMN 05 Gerard Le Grellelaan
653,Gerard le Grellelaan 10,2022-09-06,19:00:00,97,73,24,FMN 05 Gerard Le Grellelaan
653,Gerard le Grellelaan 10,2022-09-06,20:00:00,73,53,20,FMN 05 Gerard Le Grellelaan
653,Gerard le Grellelaan 10,2022-09-06,21:00:00,48,38,10,FMN 05 Gerard Le Grellelaan
653,Gerard le Grellelaan 10,2022-09-06,22:00:00,54,46,8,FMN 05 Gerard Le Grellelaan
653,Gerard le Grellelaan 10,2022-09-06,23:00:00,13,9,4,FMN 05 Gerard Le Grellelaan
653,Gerard le Grellelaan 10,2022-09-07,00:00:00,5,3,2,FMN 05 Gerard Le Grellelaan
653,Gerard le Grellelaan 10,2022-09-07,01:00:00,3,1,2,FMN 05 Gerard Le Grellelaan
653,Gerard le Grellelaan 10,2022-09-07,02:00:00,4,3,1,FMN 05 Gerard Le Grellelaan
653,Gerard le Grellelaan 10,2022-09-07,03:00:00,2,0,2,FMN 05 Gerard Le Grellelaan
653,Gerard le Grellelaan 10,2022-09-07,04:00:00,11,6,5,FMN 05 Gerard Le Grellelaan
653,Gerard le Grellelaan 10,2022-09-07,05:00:00,25,9,16,FMN 05 Gerard Le Grellelaan
653,Gerard le Grellelaan 10,2022-09-07,06:00:00,51,27,24,FMN 05 Gerard Le Grellelaan
653,Gerard le Grellelaan 10,2022-09-07,07:00:00,160,123,37,FMN 05 Gerard Le Grellelaan
653,Gerard le Grellelaan 10,2022-09-07,08:00:00,307,235,72,FMN 05 Gerard Le Grellelaan
653,Gerard le Grellelaan 10,2022-09-07,09:00:00,118,112,6,FMN 05 Gerard Le Grellelaan
653,Gerard le Grellelaan 10,2022-09-07,10:00:00,94,66,28,FMN 05 Gerard Le Grellelaan
653,Gerard le Grellelaan 10,2022-09-07,11:00:00,86,68,18,FMN 05 Gerard Le Grellelaan
653,Gerard le Grellelaan 10,2022-09-07,12:00:00,178,129,49,FMN 05 Gerard Le Grellelaan
653,Gerard le Grellelaan 10,2022-09-07,13:00:00,122,90,32,FMN 05 Gerard Le Grellelaan
653,Gerard le Grellelaan 10,2022-09-07,14:00:00,118,84,34,FMN 05 Gerard Le Grellelaan
653,Gerard le Grellelaan 10,2022-09-07,15:00:00,140,113,27,FMN 05 Gerard Le Grellelaan
653,Gerard le Grellelaan 10,2022-09-07,16:00:00,163,134,29,FMN 05 Gerard Le Grellelaan
653,Gerard le Grellelaan 10,2022-09-07,17:00:00,211,168,43,FMN 05 Gerard Le Grellelaan
653,Gerard le Grellelaan 10,2022-09-07,18:00:00,143,117,26,FMN 05 Gerard Le Grellelaan
653,Gerard le Grellelaan 10,2022-09-07,19:00:00,93,77,16,FMN 05 Gerard Le Grellelaan
653,Gerard le Grellelaan 10,2022-09-07,20:00:00,83,72,11,FMN 05 Gerard Le Grellelaan
653,Gerard le Grellelaan 10,2022-09-07,21:00:00,52,37,15,FMN 05 Gerard Le Grellelaan
653,Gerard le Grellelaan 10,2022-09-07,22:00:00,54,43,11,FMN 05 Gerard Le Grellelaan
653,Gerard le Grellelaan 10,2022-09-07,23:00:00,16,11,5,FMN 05 Gerard Le Grellelaan
653,Gerard le Grellelaan 10,2022-09-08,00:00:00,10,8,2,FMN 05 Gerard Le Grellelaan
653,Gerard le Grellelaan 10,2022-09-08,01:00:00,3,2,1,FMN 05 Gerard Le Grellelaan
653,Gerard le Grellelaan 10,2022-09-08,02:00:00,5,2,3,FMN 05 Gerard Le Grellelaan
653,Gerard le Grellelaan 10,2022-09-08,03:00:00,4,1,3,FMN 05 Gerard Le Grellelaan
653,Gerard le Grellelaan 10,2022-09-08,04:00:00,5,2,3,FMN 05 Gerard Le Grellelaan
653,Gerard le Grellelaan 10,2022-09-08,05:00:00,27,10,17,FMN 05 Gerard Le Grellelaan
653,Gerard le Grellelaan 10,2022-09-08,06:00:00,36,22,14,FMN 05 Gerard Le Grellelaan
653,Gerard le Grellelaan 10,2022-09-08,07:00:00,156,116,40,FMN 05 Gerard Le Grellelaan
653,Gerard le Grellelaan 10,2022-09-08,08:00:00,312,249,63,FMN 05 Gerard Le Grellelaan
653,Gerard le Grellelaan 10,2022-09-08,09:00:00,94,86,8,FMN 05 Gerard Le Grellelaan
653,Gerard le Grellelaan 10,2022-09-08,10:00:00,68,54,14,FMN 05 Gerard Le Grellelaan
653,Gerard le Grellelaan 10,2022-09-08,11:00:00,64,50,14,FMN 05 Gerard Le Grellelaan
653,Gerard le Grellelaan 10,2022-09-08,12:00:00,92,67,25,FMN 05 Gerard Le Grellelaan
653,Gerard le Grellelaan 10,2022-09-08,13:00:00,96,73,23,FMN 05 Gerard Le Grellelaan
653,Gerard le Grellelaan 10,2022-09-08,14:00:00,82,68,14,FMN 05 Gerard Le Grellelaan
653,Gerard le Grellelaan 10,2022-09-08,15:00:00,142,112,30,FMN 05 Gerard Le Grellelaan
653,Gerard le Grellelaan 10,2022-09-08,16:00:00,162,123,39,FMN 05 Gerard Le Grellelaan
653,Gerard le Grellelaan 10,2022-09-08,17:00:00,211,161,50,FMN 05 Gerard Le Grellelaan
653,Gerard le Grellelaan 10,2022-09-08,18:00:00,105,85,20,FMN 05 Gerard Le Grellelaan
653,Gerard le Grellelaan 10,2022-09-08,19:00:00,58,44,14,FMN 05 Gerard Le Grellelaan
653,Gerard le Grellelaan 10,2022-09-08,20:00:00,34,25,9,FMN 05 Gerard Le Grellelaan
653,Gerard le Grellelaan 10,2022-09-08,21:00:00,39,34,5,FMN 05 Gerard Le Grellelaan
653,Gerard le Grellelaan 10,2022-09-08,22:00:00,42,37,5,FMN 05 Gerard Le Grellelaan
653,Gerard le Grellelaan 10,2022-09-08,23:00:00,18,14,4,FMN 05 Gerard Le Grellelaan
653,Gerard le Grellelaan 10,2022-09-09,00:00:00,7,4,3,FMN 05 Gerard Le Grellelaan
653,Gerard le Grellelaan 10,2022-09-09,01:00:00,5,1,4,FMN 05 Gerard Le Grellelaan
653,Gerard le Grellelaan 10,2022-09-09,02:00:00,4,3,1,FMN 05 Gerard Le Grellelaan
653,Gerard le Grellelaan 10,2022-09-09,03:00:00,4,0,4,FMN 05 Gerard Le Grellelaan
653,Gerard le Grellelaan 10,2022-09-09,04:00:00,5,1,4,FMN 05 Gerard Le Grellelaan
653,Gerard le Grellelaan 10,2022-09-09,05:00:00,29,9,20,FMN 05 Gerard Le Grellelaan
653,Gerard le Grellelaan 10,2022-09-09,06:00:00,36,16,20,FMN 05 Gerard Le Grellelaan
653,Gerard le Grellelaan 10,2022-09-09,07:00:00,119,91,28,FMN 05 Gerard Le Grellelaan
653,Gerard le Grellelaan 10,2022-09-09,08:00:00,240,178,62,FMN 05 Gerard Le Grellelaan
653,Gerard le Grellelaan 10,2022-09-09,09:00:00,164,83,81,FMN 05 Gerard Le Grellelaan
653,Gerard le Grellelaan 10,2022-09-09,10:00:00,54,48,6,FMN 05 Gerard Le Grellelaan
653,Gerard le Grellelaan 10,2022-09-09,11:00:00,48,39,9,FMN 05 Gerard Le Grellelaan
653,Gerard le Grellelaan 10,2022-09-09,12:00:00,78,61,17,FMN 05 Gerard Le Grellelaan
653,Gerard le Grellelaan 10,2022-09-09,13:00:00,66,47,19,FMN 05 Gerard Le Grellelaan
653,Gerard le Grellelaan 10,2022-09-09,14:00:00,66,51,15,FMN 05 Gerard Le Grellelaan
653,Gerard le Grellelaan 10,2022-09-09,15:00:00,157,124,33,FMN 05 Gerard Le Grellelaan
653,Gerard le Grellelaan 10,2022-09-09,16:00:00,144,112,32,FMN 05 Gerard Le Grellelaan
653,Gerard le Grellelaan 10,2022-09-09,17:00:00,126,98,28,FMN 05 Gerard Le Grellelaan
653,Gerard le Grellelaan 10,2022-09-09,18:00:00,100,81,19,FMN 05 Gerard Le Grellelaan
653,Gerard le Grellelaan 10,2022-09-09,19:00:00,71,52,19,FMN 05 Gerard Le Grellelaan
653,Gerard le Grellelaan 10,2022-09-09,20:00:00,40,33,7,FMN 05 Gerard Le Grellelaan
653,Gerard le Grellelaan 10,2022-09-09,21:00:00,30,22,8,FMN 05 Gerard Le Grellelaan
653,Gerard le Grellelaan 10,2022-09-09,22:00:00,44,35,9,FMN 05 Gerard Le Grellelaan
653,Gerard le Grellelaan 10,2022-09-09,23:00:00,15,14,1,FMN 05 Gerard Le Grellelaan
653,Gerard le Grellelaan 10,2022-09-10,00:00:00,16,10,6,FMN 05 Gerard Le Grellelaan
653,Gerard le Grellelaan 10,2022-09-10,01:00:00,10,6,4,FMN 05 Gerard Le Grellelaan
653,Gerard le Grellelaan 10,2022-09-10,02:00:00,5,3,2,FMN 05 Gerard Le Grellelaan
653,Gerard le Grellelaan 10,2022-09-10,03:00:00,4,2,2,FMN 05 Gerard Le Grellelaan
653,Gerard le Grellelaan 10,2022-09-10,04:00:00,4,2,2,FMN 05 Gerard Le Grellelaan
653,Gerard le Grellelaan 10,2022-09-10,05:00:00,6,4,2,FMN 05 Gerard Le Grellelaan
653,Gerard le Grellelaan 10,2022-09-10,06:00:00,6,4,2,FMN 05 Gerard Le Grellelaan
653,Gerard le Grellelaan 10,2022-09-10,07:00:00,11,8,3,FMN 05 Gerard Le Grellelaan
653,Gerard le Grellelaan 10,2022-09-10,08:00:00,11,10,1,FMN 05 Gerard Le Grellelaan
653,Gerard le Grellelaan 10,2022-09-10,09:00:00,21,19,2,FMN 05 Gerard Le Grellelaan
653,Gerard le Grellelaan 10,2022-09-10,10:00:00,18,16,2,FMN 05 Gerard Le Grellelaan
653,Gerard le Grellelaan 10,2022-09-10,11:00:00,20,14,6,FMN 05 Gerard Le Grellelaan
653,Gerard le Grellelaan 10,2022-09-10,12:00:00,28,19,9,FMN 05 Gerard Le Grellelaan
653,Gerard le Grellelaan 10,2022-09-10,13:00:00,32,26,6,FMN 05 Gerard Le Grellelaan
653,Gerard le Grellelaan 10,2022-09-10,14:00:00,46,35,11,FMN 05 Gerard Le Grellelaan
653,Gerard le Grellelaan 10,2022-09-10,15:00:00,47,42,5,FMN 05 Gerard Le Grellelaan
653,Gerard le Grellelaan 10,2022-09-10,16:00:00,49,44,5,FMN 05 Gerard Le Grellelaan
653,Gerard le Grellelaan 10,2022-09-10,17:00:00,58,45,13,FMN 05 Gerard Le Grellelaan
653,Gerard le Grellelaan 10,2022-09-10,18:00:00,55,45,10,FMN 05 Gerard Le Grellelaan
653,Gerard le Grellelaan 10,2022-09-10,19:00:00,41,32,9,FMN 05 Gerard Le Grellelaan
653,Gerard le Grellelaan 10,2022-09-10,20:00:00,25,19,6,FMN 05 Gerard Le Grellelaan
653,Gerard le Grellelaan 10,2022-09-10,21:00:00,23,20,3,FMN 05 Gerard Le Grellelaan
653,Gerard le Grellelaan 10,2022-09-10,22:00:00,24,16,8,FMN 05 Gerard Le Grellelaan
653,Gerard le Grellelaan 10,2022-09-10,23:00:00,14,11,3,FMN 05 Gerard Le Grellelaan
653,Gerard le Grellelaan 10,2022-09-11,00:00:00,8,7,1,FMN 05 Gerard Le Grellelaan
653,Gerard le Grellelaan 10,2022-09-11,01:00:00,10,7,3,FMN 05 Gerard Le Grellelaan
653,Gerard le Grellelaan 10,2022-09-11,02:00:00,9,8,1,FMN 05 Gerard Le Grellelaan
653,Gerard le Grellelaan 10,2022-09-11,03:00:00,0,0,0,FMN 05 Gerard Le Grellelaan
653,Gerard le Grellelaan 10,2022-09-11,04:00:00,7,1,6,FMN 05 Gerard Le Grellelaan
653,Gerard le Grellelaan 10,2022-09-11,05:00:00,5,2,3,FMN 05 Gerard Le Grellelaan
653,Gerard le Grellelaan 10,2022-09-11,06:00:00,5,4,1,FMN 05 Gerard Le Grellelaan
653,Gerard le Grellelaan 10,2022-09-11,07:00:00,10,9,1,FMN 05 Gerard Le Grellelaan
653,Gerard le Grellelaan 10,2022-09-11,08:00:00,37,28,9,FMN 05 Gerard Le Grellelaan
653,Gerard le Grellelaan 10,2022-09-11,09:00:00,73,65,8,FMN 05 Gerard Le Grellelaan
653,Gerard le Grellelaan 10,2022-09-11,10:00:00,75,59,16,FMN 05 Gerard Le Grellelaan
653,Gerard le Grellelaan 10,2022-09-11,11:00:00,122,96,26,FMN 05 Gerard Le Grellelaan
653,Gerard le Grellelaan 10,2022-09-11,12:00:00,120,101,19,FMN 05 Gerard Le Grellelaan
653,Gerard le Grellelaan 10,2022-09-11,13:00:00,108,90,18,FMN 05 Gerard Le Grellelaan
653,Gerard le Grellelaan 10,2022-09-11,14:00:00,100,70,30,FMN 05 Gerard Le Grellelaan
653,Gerard le Grellelaan 10,2022-09-11,15:00:00,113,101,12,FMN 05 Gerard Le Grellelaan
653,Gerard le Grellelaan 10,2022-09-11,16:00:00,85,77,8,FMN 05 Gerard Le Grellelaan
653,Gerard le Grellelaan 10,2022-09-11,17:00:00,138,124,14,FMN 05 Gerard Le Grellelaan
653,Gerard le Grellelaan 10,2022-09-11,18:00:00,99,91,8,FMN 05 Gerard Le Grellelaan
653,Gerard le Grellelaan 10,2022-09-11,19:00:00,56,45,11,FMN 05 Gerard Le Grellelaan
653,Gerard le Grellelaan 10,2022-09-11,20:00:00,42,34,8,FMN 05 Gerard Le Grellelaan
653,Gerard le Grellelaan 10,2022-09-11,21:00:00,39,24,15,FMN 05 Gerard Le Grellelaan
653,Gerard le Grellelaan 10,2022-09-11,22:00:00,31,19,12,FMN 05 Gerard Le Grellelaan
653,Gerard le Grellelaan 10,2022-09-11,23:00:00,11,8,3,FMN 05 Gerard Le Grellelaan
653,Gerard le Grellelaan 10,2022-09-12,00:00:00,6,5,1,FMN 05 Gerard Le Grellelaan
653,Gerard le Grellelaan 10,2022-09-12,01:00:00,5,3,2,FMN 05 Gerard Le Grellelaan
653,Gerard le Grellelaan 10,2022-09-12,02:00:00,2,1,1,FMN 05 Gerard Le Grellelaan
653,Gerard le Grellelaan 10,2022-09-12,03:00:00,2,1,1,FMN 05 Gerard Le Grellelaan
653,Gerard le Grellelaan 10,2022-09-12,04:00:00,8,5,3,FMN 05 Gerard Le Grellelaan
653,Gerard le Grellelaan 10,2022-09-12,05:00:00,24,7,17,FMN 05 Gerard Le Grellelaan
653,Gerard le Grellelaan 10,2022-09-12,06:00:00,55,29,26,FMN 05 Gerard Le Grellelaan
653,Gerard le Grellelaan 10,2022-09-12,07:00:00,164,116,48,FMN 05 Gerard Le Grellelaan
653,Gerard le Grellelaan 10,2022-09-12,08:00:00,304,240,64,FMN 05 Gerard Le Grellelaan
653,Gerard le Grellelaan 10,2022-09-12,09:00:00,114,92,22,FMN 05 Gerard Le Grellelaan
653,Gerard le Grellelaan 10,2022-09-12,10:00:00,67,56,11,FMN 05 Gerard Le Grellelaan
653,Gerard le Grellelaan 10,2022-09-12,11:00:00,78,69,9,FMN 05 Gerard Le Grellelaan
653,Gerard le Grellelaan 10,2022-09-12,12:00:00,142,117,25,FMN 05 Gerard Le Grellelaan
653,Gerard le Grellelaan 10,2022-09-12,13:00:00,104,81,23,FMN 05 Gerard Le Grellelaan
653,Gerard le Grellelaan 10,2022-09-12,14:00:00,123,98,25,FMN 05 Gerard Le Grellelaan
653,Gerard le Grellelaan 10,2022-09-12,15:00:00,163,131,32,FMN 05 Gerard Le Grellelaan
653,Gerard le Grellelaan 10,2022-09-12,16:00:00,211,155,56,FMN 05 Gerard Le Grellelaan
653,Gerard le Grellelaan 10,2022-09-12,17:00:00,244,192,52,FMN 05 Gerard Le Grellelaan
653,Gerard le Grellelaan 10,2022-09-12,18:00:00,177,144,33,FMN 05 Gerard Le Grellelaan
653,Gerard le Grellelaan 10,2022-09-12,19:00:00,101,84,17,FMN 05 Gerard Le Grellelaan
653,Gerard le Grellelaan 10,2022-09-12,20:00:00,77,64,13,FMN 05 Gerard Le Grellelaan
653,Gerard le Grellelaan 10,2022-09-12,21:00:00,41,32,9,FMN 05 Gerard Le Grellelaan
653,Gerard le Grellelaan 10,2022-09-12,22:00:00,61,50,11,FMN 05 Gerard Le Grellelaan
653,Gerard le Grellelaan 10,2022-09-12,23:00:00,23,15,8,FMN 05 Gerard Le Grellelaan
653,Gerard le Grellelaan 10,2022-09-13,00:00:00,14,12,2,FMN 05 Gerard Le Grellelaan
653,Gerard le Grellelaan 10,2022-09-13,01:00:00,5,2,3,FMN 05 Gerard Le Grellelaan
653,Gerard le Grellelaan 10,2022-09-13,02:00:00,4,3,1,FMN 05 Gerard Le Grellelaan
653,Gerard le Grellelaan 10,2022-09-13,03:00:00,4,1,3,FMN 05 Gerard Le Grellelaan
653,Gerard le Grellelaan 10,2022-09-13,04:00:00,11,6,5,FMN 05 Gerard Le Grellelaan
653,Gerard le Grellelaan 10,2022-09-13,05:00:00,26,8,18,FMN 05 Gerard Le Grellelaan
653,Gerard le Grellelaan 10,2022-09-13,06:00:00,54,22,32,FMN 05 Gerard Le Grellelaan
653,Gerard le Grellelaan 10,2022-09-13,07:00:00,189,143,46,FMN 05 Gerard Le Grellelaan
653,Gerard le Grellelaan 10,2022-09-13,08:00:00,350,275,75,FMN 05 Gerard Le Grellelaan
653,Gerard le Grellelaan 10,2022-09-13,09:00:00,100,80,20,FMN 05 Gerard Le Grellelaan
653,Gerard le Grellelaan 10,2022-09-13,10:00:00,69,54,15,FMN 05 Gerard Le Grellelaan
653,Gerard le Grellelaan 10,2022-09-13,11:00:00,105,85,20,FMN 05 Gerard Le Grellelaan
653,Gerard le Grellelaan 10,2022-09-13,12:00:00,123,96,27,FMN 05 Gerard Le Grellelaan
653,Gerard le Grellelaan 10,2022-09-13,13:00:00,104,70,34,FMN 05 Gerard Le Grellelaan
653,Gerard le Grellelaan 10,2022-09-13,14:00:00,108,86,22,FMN 05 Gerard Le Grellelaan
653,Gerard le Grellelaan 10,2022-09-13,15:00:00,151,122,29,FMN 05 Gerard Le Grellelaan
653,Gerard le Grellelaan 10,2022-09-13,16:00:00,185,134,51,FMN 05 Gerard Le Grellelaan
653,Gerard le Grellelaan 10,2022-09-13,17:00:00,241,185,56,FMN 05 Gerard Le Grellelaan
653,Gerard le Grellelaan 10,2022-09-13,18:00:00,140,113,27,FMN 05 Gerard Le Grellelaan
653,Gerard le Grellelaan 10,2022-09-13,19:00:00,75,60,15,FMN 05 Gerard Le Grellelaan
653,Gerard le Grellelaan 10,2022-09-13,20:00:00,45,41,4,FMN 05 Gerard Le Grellelaan
653,Gerard le Grellelaan 10,2022-09-13,21:00:00,26,19,7,FMN 05 Gerard Le Grellelaan
653,Gerard le Grellelaan 10,2022-09-13,22:00:00,46,39,7,FMN 05 Gerard Le Grellelaan
653,Gerard le Grellelaan 10,2022-09-13,23:00:00,17,8,9,FMN 05 Gerard Le Grellelaan
653,Gerard le Grellelaan 10,2022-09-14,00:00:00,3,2,1,FMN 05 Gerard Le Grellelaan
653,Gerard le Grellelaan 10,2022-09-14,01:00:00,3,1,2,FMN 05 Gerard Le Grellelaan
653,Gerard le Grellelaan 10,2022-09-14,02:00:00,4,1,3,FMN 05 Gerard Le Grellelaan
653,Gerard le Grellelaan 10,2022-09-14,03:00:00,3,2,1,FMN 05 Gerard Le Grellelaan
653,Gerard le Grellelaan 10,2022-09-14,04:00:00,5,2,3,FMN 05 Gerard Le Grellelaan
653,Gerard le Grellelaan 10,2022-09-14,05:00:00,18,6,12,FMN 05 Gerard Le Grellelaan
653,Gerard le Grellelaan 10,2022-09-14,06:00:00,29,15,14,FMN 05 Gerard Le Grellelaan
653,Gerard le Grellelaan 10,2022-09-14,07:00:00,101,72,29,FMN 05 Gerard Le Grellelaan
653,Gerard le Grellelaan 10,2022-09-14,08:00:00,210,156,54,FMN 05 Gerard Le Grellelaan
653,Gerard le Grellelaan 10,2022-09-14,09:00:00,47,43,4,FMN 05 Gerard Le Grellelaan
653,Gerard le Grellelaan 10,2022-09-14,10:00:00,49,37,12,FMN 05 Gerard Le Grellelaan
653,Gerard le Grellelaan 10,2022-09-14,11:00:00,41,33,8,FMN 05 Gerard Le Grellelaan
653,Gerard le Grellelaan 10,2022-09-14,12:00:00,87,70,17,FMN 05 Gerard Le Grellelaan
653,Gerard le Grellelaan 10,2022-09-14,13:00:00,48,32,16,FMN 05 Gerard Le Grellelaan
653,Gerard le Grellelaan 10,2022-09-14,14:00:00,47,37,10,FMN 05 Gerard Le Grellelaan
653,Gerard le Grellelaan 10,2022-09-14,15:00:00,60,47,13,FMN 05 Gerard Le Grellelaan
653,Gerard le Grellelaan 10,2022-09-14,16:00:00,93,69,24,FMN 05 Gerard Le Grellelaan
653,Gerard le Grellelaan 10,2022-09-14,17:00:00,119,94,25,FMN 05 Gerard Le Grellelaan
653,Gerard le Grellelaan 10,2022-09-14,18:00:00,102,84,18,FMN 05 Gerard Le Grellelaan
653,Gerard le Grellelaan 10,2022-09-14,19:00:00,54,37,17,FMN 05 Gerard Le Grellelaan
653,Gerard le Grellelaan 10,2022-09-14,20:00:00,40,36,4,FMN 05 Gerard Le Grellelaan
653,Gerard le Grellelaan 10,2022-09-14,21:00:00,31,22,9,FMN 05 Gerard Le Grellelaan
653,Gerard le Grellelaan 10,2022-09-14,22:00:00,41,34,7,FMN 05 Gerard Le Grellelaan
653,Gerard le Grellelaan 10,2022-09-14,23:00:00,19,9,10,FMN 05 Gerard Le Grellelaan
653,Gerard le Grellelaan 10,2022-09-15,00:00:00,7,4,3,FMN 05 Gerard Le Grellelaan
653,Gerard le Grellelaan 10,2022-09-15,01:00:00,3,1,2,FMN 05 Gerard Le Grellelaan
653,Gerard le Grellelaan 10,2022-09-15,02:00:00,3,1,2,FMN 05 Gerard Le Grellelaan
653,Gerard le Grellelaan 10,2022-09-15,03:00:00,2,1,1,FMN 05 Gerard Le Grellelaan
653,Gerard le Grellelaan 10,2022-09-15,04:00:00,7,2,5,FMN 05 Gerard Le Grellelaan
653,Gerard le Grellelaan 10,2022-09-15,05:00:00,21,8,13,FMN 05 Gerard Le Grellelaan
653,Gerard le Grellelaan 10,2022-09-15,06:00:00,36,15,21,FMN 05 Gerard Le Grellelaan
653,Gerard le Grellelaan 10,2022-09-15,07:00:00,134,103,31,FMN 05 Gerard Le Grellelaan
653,Gerard le Grellelaan 10,2022-09-15,08:00:00,310,254,56,FMN 05 Gerard Le Grellelaan
653,Gerard le Grellelaan 10,2022-09-15,09:00:00,101,88,13,FMN 05 Gerard Le Grellelaan
653,Gerard le Grellelaan 10,2022-09-15,10:00:00,75,60,15,FMN 05 Gerard Le Grellelaan
653,Gerard le Grellelaan 10,2022-09-15,11:00:00,74,58,16,FMN 05 Gerard Le Grellelaan
653,Gerard le Grellelaan 10,2022-09-15,12:00:00,92,77,15,FMN 05 Gerard Le Grellelaan
653,Gerard le Grellelaan 10,2022-09-15,13:00:00,98,67,31,FMN 05 Gerard Le Grellelaan
653,Gerard le Grellelaan 10,2022-09-15,14:00:00,116,100,16,FMN 05 Gerard Le Grellelaan
653,Gerard le Grellelaan 10,2022-09-15,15:00:00,170,128,42,FMN 05 Gerard Le Grellelaan
653,Gerard le Grellelaan 10,2022-09-15,16:00:00,198,150,48,FMN 05 Gerard Le Grellelaan
653,Gerard le Grellelaan 10,2022-09-15,17:00:00,186,134,52,FMN 05 Gerard Le Grellelaan
653,Gerard le Grellelaan 10,2022-09-15,18:00:00,127,100,27,FMN 05 Gerard Le Grellelaan
653,Gerard le Grellelaan 10,2022-09-15,19:00:00,85,73,12,FMN 05 Gerard Le Grellelaan
653,Gerard le Grellelaan 10,2022-09-15,20:00:00,66,56,10,FMN 05 Gerard Le Grellelaan
653,Gerard le Grellelaan 10,2022-09-15,21:00:00,46,36,10,FMN 05 Gerard Le Grellelaan
653,Gerard le Grellelaan 10,2022-09-15,22:00:00,34,30,4,FMN 05 Gerard Le Grellelaan
653,Gerard le Grellelaan 10,2022-09-15,23:00:00,28,19,9,FMN 05 Gerard Le Grellelaan
653,Gerard le Grellelaan 10,2022-09-16,00:00:00,10,10,0,FMN 05 Gerard Le Grellelaan
653,Gerard le Grellelaan 10,2022-09-16,01:00:00,3,3,0,FMN 05 Gerard Le Grellelaan
653,Gerard le Grellelaan 10,2022-09-16,02:00:00,4,3,1,FMN 05 Gerard Le Grellelaan
653,Gerard le Grellelaan 10,2022-09-16,03:00:00,3,2,1,FMN 05 Gerard Le Grellelaan
653,Gerard le Grellelaan 10,2022-09-16,04:00:00,10,6,4,FMN 05 Gerard Le Grellelaan
653,Gerard le Grellelaan 10,2022-09-16,05:00:00,21,5,16,FMN 05 Gerard Le Grellelaan
653,Gerard le Grellelaan 10,2022-09-16,06:00:00,35,16,19,FMN 05 Gerard Le Grellelaan
653,Gerard le Grellelaan 10,2022-09-16,07:00:00,108,77,31,FMN 05 Gerard Le Grellelaan
653,Gerard le Grellelaan 10,2022-09-16,08:00:00,188,149,39,FMN 05 Gerard Le Grellelaan
653,Gerard le Grellelaan 10,2022-09-16,09:00:00,64,53,11,FMN 05 Gerard Le Grellelaan
653,Gerard le Grellelaan 10,2022-09-16,10:00:00,52,41,11,FMN 05 Gerard Le Grellelaan
653,Gerard le Grellelaan 10,2022-09-16,11:00:00,38,30,8,FMN 05 Gerard Le Grellelaan
653,Gerard le Grellelaan 10,2022-09-16,12:00:00,57,42,15,FMN 05 Gerard Le Grellelaan
653,Gerard le Grellelaan 10,2022-09-16,13:00:00,53,38,15,FMN 05 Gerard Le Grellelaan
653,Gerard le Grellelaan 10,2022-09-16,14:00:00,62,52,10,FMN 05 Gerard Le Grellelaan
653,Gerard le Grellelaan 10,2022-09-16,15:00:00,114,87,27,FMN 05 Gerard Le Grellelaan
653,Gerard le Grellelaan 10,2022-09-16,16:00:00,132,106,26,FMN 05 Gerard Le Grellelaan
653,Gerard le Grellelaan 10,2022-09-16,17:00:00,119,94,25,FMN 05 Gerard Le Grellelaan
653,Gerard le Grellelaan 10,2022-09-16,18:00:00,76,65,11,FMN 05 Gerard Le Grellelaan
653,Gerard le Grellelaan 10,2022-09-16,19:00:00,51,43,8,FMN 05 Gerard Le Grellelaan
653,Gerard le Grellelaan 10,2022-09-16,20:00:00,37,28,9,FMN 05 Gerard Le Grellelaan
653,Gerard le Grellelaan 10,2022-09-16,21:00:00,17,13,4,FMN 05 Gerard Le Grellelaan
653,Gerard le Grellelaan 10,2022-09-16,22:00:00,19,16,3,FMN 05 Gerard Le Grellelaan
653,Gerard le Grellelaan 10,2022-09-16,23:00:00,13,8,5,FMN 05 Gerard Le Grellelaan
653,Gerard le Grellelaan 10,2022-09-17,00:00:00,11,8,3,FMN 05 Gerard Le Grellelaan
653,Gerard le Grellelaan 10,2022-09-17,01:00:00,3,0,3,FMN 05 Gerard Le Grellelaan
653,Gerard le Grellelaan 10,2022-09-17,02:00:00,7,4,3,FMN 05 Gerard Le Grellelaan
653,Gerard le Grellelaan 10,2022-09-17,03:00:00,6,4,2,FMN 05 Gerard Le Grellelaan
653,Gerard le Grellelaan 10,2022-09-17,04:00:00,5,2,3,FMN 05 Gerard Le Grellelaan
653,Gerard le Grellelaan 10,2022-09-17,05:00:00,10,5,5,FMN 05 Gerard Le Grellelaan
653,Gerard le Grellelaan 10,2022-09-17,06:00:00,8,5,3,FMN 05 Gerard Le Grellelaan
653,Gerard le Grellelaan 10,2022-09-17,07:00:00,10,6,4,FMN 05 Gerard Le Grellelaan
653,Gerard le Grellelaan 10,2022-09-17,08:00:00,28,24,4,FMN 05 Gerard Le Grellelaan
653,Gerard le Grellelaan 10,2022-09-17,09:00:00,32,23,9,FMN 05 Gerard Le Grellelaan
653,Gerard le Grellelaan 10,2022-09-17,10:00:00,36,29,7,FMN 05 Gerard Le Grellelaan
653,Gerard le Grellelaan 10,2022-09-17,11:00:00,34,27,7,FMN 05 Gerard Le Grellelaan
653,Gerard le Grellelaan 10,2022-09-17,12:00:00,45,37,8,FMN 05 Gerard Le Grellelaan
653,Gerard le Grellelaan 10,2022-09-17,13:00:00,35,30,5,FMN 05 Gerard Le Grellelaan
653,Gerard le Grellelaan 10,2022-09-17,14:00:00,53,37,16,FMN 05 Gerard Le Grellelaan
653,Gerard le Grellelaan 10,2022-09-17,15:00:00,39,27,12,FMN 05 Gerard Le Grellelaan
653,Gerard le Grellelaan 10,2022-09-17,16:00:00,43,32,11,FMN 05 Gerard Le Grellelaan
653,Gerard le Grellelaan 10,2022-09-17,17:00:00,36,30,6,FMN 05 Gerard Le Grellelaan
653,Gerard le Grellelaan 10,2022-09-17,18:00:00,52,43,9,FMN 05 Gerard Le Grellelaan
653,Gerard le Grellelaan 10,2022-09-17,19:00:00,28,25,3,FMN 05 Gerard Le Grellelaan
653,Gerard le Grellelaan 10,2022-09-17,20:00:00,26,19,7,FMN 05 Gerard Le Grellelaan
653,Gerard le Grellelaan 10,2022-09-17,21:00:00,9,7,2,FMN 05 Gerard Le Grellelaan
653,Gerard le Grellelaan 10,2022-09-17,22:00:00,11,9,2,FMN 05 Gerard Le Grellelaan
653,Gerard le Grellelaan 10,2022-09-17,23:00:00,14,10,4,FMN 05 Gerard Le Grellelaan
653,Gerard le Grellelaan 10,2022-09-18,00:00:00,7,4,3,FMN 05 Gerard Le Grellelaan
653,Gerard le Grellelaan 10,2022-09-18,01:00:00,3,3,0,FMN 05 Gerard Le Grellelaan
653,Gerard le Grellelaan 10,2022-09-18,02:00:00,4,3,1,FMN 05 Gerard Le Grellelaan
653,Gerard le Grellelaan 10,2022-09-18,03:00:00,4,1,3,FMN 05 Gerard Le Grellelaan
653,Gerard le Grellelaan 10,2022-09-18,04:00:00,5,2,3,FMN 05 Gerard Le Grellelaan
653,Gerard le Grellelaan 10,2022-09-18,05:00:00,4,0,4,FMN 05 Gerard Le Grellelaan
653,Gerard le Grellelaan 10,2022-09-18,06:00:00,7,3,4,FMN 05 Gerard Le Grellelaan
653,Gerard le Grellelaan 10,2022-09-18,07:00:00,9,7,2,FMN 05 Gerard Le Grellelaan
653,Gerard le Grellelaan 10,2022-09-18,08:00:00,13,9,4,FMN 05 Gerard Le Grellelaan
653,Gerard le Grellelaan 10,2022-09-18,09:00:00,30,23,7,FMN 05 Gerard Le Grellelaan
653,Gerard le Grellelaan 10,2022-09-18,10:00:00,54,47,7,FMN 05 Gerard Le Grellelaan
653,Gerard le Grellelaan 10,2022-09-18,11:00:00,38,27,11,FMN 05 Gerard Le Grellelaan
653,Gerard le Grellelaan 10,2022-09-18,12:00:00,81,69,12,FMN 05 Gerard Le Grellelaan
653,Gerard le Grellelaan 10,2022-09-18,13:00:00,50,44,6,FMN 05 Gerard Le Grellelaan
653,Gerard le Grellelaan 10,2022-09-18,14:00:00,37,29,8,FMN 05 Gerard Le Grellelaan
653,Gerard le Grellelaan 10,2022-09-18,15:00:00,51,43,8,FMN 05 Gerard Le Grellelaan
653,Gerard le Grellelaan 10,2022-09-18,16:00:00,38,30,8,FMN 05 Gerard Le Grellelaan
653,Gerard le Grellelaan 10,2022-09-18,17:00:00,37,28,9,FMN 05 Gerard Le Grellelaan
653,Gerard le Grellelaan 10,2022-09-18,18:00:00,30,23,7,FMN 05 Gerard Le Grellelaan
653,Gerard le Grellelaan 10,2022-09-18,19:00:00,25,22,3,FMN 05 Gerard Le Grellelaan
653,Gerard le Grellelaan 10,2022-09-18,20:00:00,26,20,6,FMN 05 Gerard Le Grellelaan
653,Gerard le Grellelaan 10,2022-09-18,21:00:00,13,9,4,FMN 05 Gerard Le Grellelaan
653,Gerard le Grellelaan 10,2022-09-18,22:00:00,8,6,2,FMN 05 Gerard Le Grellelaan
653,Gerard le Grellelaan 10,2022-09-18,23:00:00,9,7,2,FMN 05 Gerard Le Grellelaan
653,Gerard le Grellelaan 10,2022-09-19,00:00:00,2,1,1,FMN 05 Gerard Le Grellelaan
653,Gerard le Grellelaan 10,2022-09-19,01:00:00,4,3,1,FMN 05 Gerard Le Grellelaan
653,Gerard le Grellelaan 10,2022-09-19,02:00:00,2,1,1,FMN 05 Gerard Le Grellelaan
653,Gerard le Grellelaan 10,2022-09-19,03:00:00,2,2,0,FMN 05 Gerard Le Grellelaan
653,Gerard le Grellelaan 10,2022-09-19,04:00:00,11,3,8,FMN 05 Gerard Le Grellelaan
653,Gerard le Grellelaan 10,2022-09-19,05:00:00,30,10,20,FMN 05 Gerard Le Grellelaan
653,Gerard le Grellelaan 10,2022-09-19,06:00:00,38,22,16,FMN 05 Gerard Le Grellelaan
653,Gerard le Grellelaan 10,2022-09-19,07:00:00,128,87,41,FMN 05 Gerard Le Grellelaan
653,Gerard le Grellelaan 10,2022-09-19,08:00:00,278,219,59,FMN 05 Gerard Le Grellelaan
653,Gerard le Grellelaan 10,2022-09-19,09:00:00,93,79,14,FMN 05 Gerard Le Grellelaan
653,Gerard le Grellelaan 10,2022-09-19,10:00:00,77,63,14,FMN 05 Gerard Le Grellelaan
653,Gerard le Grellelaan 10,2022-09-19,11:00:00,73,57,16,FMN 05 Gerard Le Grellelaan
653,Gerard le Grellelaan 10,2022-09-19,12:00:00,118,93,25,FMN 05 Gerard Le Grellelaan
653,Gerard le Grellelaan 10,2022-09-19,13:00:00,91,73,18,FMN 05 Gerard Le Grellelaan
653,Gerard le Grellelaan 10,2022-09-19,14:00:00,115,88,27,FMN 05 Gerard Le Grellelaan
653,Gerard le Grellelaan 10,2022-09-19,15:00:00,163,131,32,FMN 05 Gerard Le Grellelaan
653,Gerard le Grellelaan 10,2022-09-19,16:00:00,195,156,39,FMN 05 Gerard Le Grellelaan
653,Gerard le Grellelaan 10,2022-09-19,17:00:00,185,136,49,FMN 05 Gerard Le Grellelaan
653,Gerard le Grellelaan 10,2022-09-19,18:00:00,142,112,30,FMN 05 Gerard Le Grellelaan
653,Gerard le Grellelaan 10,2022-09-19,19:00:00,77,53,24,FMN 05 Gerard Le Grellelaan
653,Gerard le Grellelaan 10,2022-09-19,20:00:00,45,37,8,FMN 05 Gerard Le Grellelaan
653,Gerard le Grellelaan 10,2022-09-19,21:00:00,41,30,11,FMN 05 Gerard Le Grellelaan
653,Gerard le Grellelaan 10,2022-09-19,22:00:00,33,28,5,FMN 05 Gerard Le Grellelaan
653,Gerard le Grellelaan 10,2022-09-19,23:00:00,16,11,5,FMN 05 Gerard Le Grellelaan
653,Gerard le Grellelaan 10,2022-09-20,00:00:00,3,2,1,FMN 05 Gerard Le Grellelaan
653,Gerard le Grellelaan 10,2022-09-20,01:00:00,1,0,1,FMN 05 Gerard Le Grellelaan
653,Gerard le Grellelaan 10,2022-09-20,02:00:00,3,2,1,FMN 05 Gerard Le Grellelaan
653,Gerard le Grellelaan 10,2022-09-20,03:00:00,3,1,2,FMN 05 Gerard Le Grellelaan
653,Gerard le Grellelaan 10,2022-09-20,04:00:00,9,5,4,FMN 05 Gerard Le Grellelaan
653,Gerard le Grellelaan 10,2022-09-20,05:00:00,33,10,23,FMN 05 Gerard Le Grellelaan
653,Gerard le Grellelaan 10,2022-09-20,06:00:00,55,30,25,FMN 05 Gerard Le Grellelaan
653,Gerard le Grellelaan 10,2022-09-20,07:00:00,163,124,39,FMN 05 Gerard Le Grellelaan
653,Gerard le Grellelaan 10,2022-09-20,08:00:00,322,251,71,FMN 05 Gerard Le Grellelaan
653,Gerard le Grellelaan 10,2022-09-20,09:00:00,107,90,17,FMN 05 Gerard Le Grellelaan
653,Gerard le Grellelaan 10,2022-09-20,10:00:00,81,69,12,FMN 05 Gerard Le Grellelaan
653,Gerard le Grellelaan 10,2022-09-20,11:00:00,92,73,19,FMN 05 Gerard Le Grellelaan
653,Gerard le Grellelaan 10,2022-09-20,12:00:00,125,92,33,FMN 05 Gerard Le Grellelaan
653,Gerard le Grellelaan 10,2022-09-20,13:00:00,110,82,28,FMN 05 Gerard Le Grellelaan
653,Gerard le Grellelaan 10,2022-09-20,14:00:00,115,88,27,FMN 05 Gerard Le Grellelaan
653,Gerard le Grellelaan 10,2022-09-20,15:00:00,206,156,50,FMN 05 Gerard Le Grellelaan
653,Gerard le Grellelaan 10,2022-09-20,16:00:00,231,179,52,FMN 05 Gerard Le Grellelaan
653,Gerard le Grellelaan 10,2022-09-20,17:00:00,241,194,47,FMN 05 Gerard Le Grellelaan
653,Gerard le Grellelaan 10,2022-09-20,18:00:00,176,136,40,FMN 05 Gerard Le Grellelaan
653,Gerard le Grellelaan 10,2022-09-20,19:00:00,89,77,12,FMN 05 Gerard Le Grellelaan
653,Gerard le Grellelaan 10,2022-09-20,20:00:00,68,53,15,FMN 05 Gerard Le Grellelaan
653,Gerard le Grellelaan 10,2022-09-20,21:00:00,55,40,15,FMN 05 Gerard Le Grellelaan
653,Gerard le Grellelaan 10,2022-09-20,22:00:00,55,44,11,FMN 05 Gerard Le Grellelaan
653,Gerard le Grellelaan 10,2022-09-20,23:00:00,15,11,4,FMN 05 Gerard Le Grellelaan
653,Gerard le Grellelaan 10,2022-09-21,00:00:00,3,2,1,FMN 05 Gerard Le Grellelaan
653,Gerard le Grellelaan 10,2022-09-21,01:00:00,3,2,1,FMN 05 Gerard Le Grellelaan
653,Gerard le Grellelaan 10,2022-09-21,02:00:00,1,0,1,FMN 05 Gerard Le Grellelaan
653,Gerard le Grellelaan 10,2022-09-21,03:00:00,3,2,1,FMN 05 Gerard Le Grellelaan
653,Gerard le Grellelaan 10,2022-09-21,04:00:00,10,4,6,FMN 05 Gerard Le Grellelaan
653,Gerard le Grellelaan 10,2022-09-21,05:00:00,30,9,21,FMN 05 Gerard Le Grellelaan
653,Gerard le Grellelaan 10,2022-09-21,06:00:00,42,20,22,FMN 05 Gerard Le Grellelaan
653,Gerard le Grellelaan 10,2022-09-21,07:00:00,132,96,36,FMN 05 Gerard Le Grellelaan
653,Gerard le Grellelaan 10,2022-09-21,08:00:00,299,244,55,FMN 05 Gerard Le Grellelaan
653,Gerard le Grellelaan 10,2022-09-21,09:00:00,85,67,18,FMN 05 Gerard Le Grellelaan
653,Gerard le Grellelaan 10,2022-09-21,10:00:00,78,59,19,FMN 05 Gerard Le Grellelaan
653,Gerard le Grellelaan 10,2022-09-21,11:00:00,96,86,10,FMN 05 Gerard Le Grellelaan
653,Gerard le Grellelaan 10,2022-09-21,12:00:00,175,135,40,FMN 05 Gerard Le Grellelaan
653,Gerard le Grellelaan 10,2022-09-21,13:00:00,133,98,35,FMN 05 Gerard Le Grellelaan
653,Gerard le Grellelaan 10,2022-09-21,14:00:00,157,117,40,FMN 05 Gerard Le Grellelaan
653,Gerard le Grellelaan 10,2022-09-21,15:00:00,171,146,25,FMN 05 Gerard Le Grellelaan
653,Gerard le Grellelaan 10,2022-09-21,16:00:00,220,167,53,FMN 05 Gerard Le Grellelaan
653,Gerard le Grellelaan 10,2022-09-21,17:00:00,273,220,53,FMN 05 Gerard Le Grellelaan
653,Gerard le Grellelaan 10,2022-09-21,18:00:00,183,143,40,FMN 05 Gerard Le Grellelaan
653,Gerard le Grellelaan 10,2022-09-21,19:00:00,124,93,31,FMN 05 Gerard Le Grellelaan
653,Gerard le Grellelaan 10,2022-09-21,20:00:00,77,68,9,FMN 05 Gerard Le Grellelaan
653,Gerard le Grellelaan 10,2022-09-21,21:00:00,39,30,9,FMN 05 Gerard Le Grellelaan
653,Gerard le Grellelaan 10,2022-09-21,22:00:00,49,39,10,FMN 05 Gerard Le Grellelaan
653,Gerard le Grellelaan 10,2022-09-21,23:00:00,24,17,7,FMN 05 Gerard Le Grellelaan
653,Gerard le Grellelaan 10,2022-09-22,00:00:00,9,6,3,FMN 05 Gerard Le Grellelaan
653,Gerard le Grellelaan 10,2022-09-22,01:00:00,1,1,0,FMN 05 Gerard Le Grellelaan
653,Gerard le Grellelaan 10,2022-09-22,02:00:00,4,2,2,FMN 05 Gerard Le Grellelaan
653,Gerard le Grellelaan 10,2022-09-22,03:00:00,4,3,1,FMN 05 Gerard Le Grellelaan
653,Gerard le Grellelaan 10,2022-09-22,04:00:00,8,3,5,FMN 05 Gerard Le Grellelaan
653,Gerard le Grellelaan 10,2022-09-22,05:00:00,22,5,17,FMN 05 Gerard Le Grellelaan
653,Gerard le Grellelaan 10,2022-09-22,06:00:00,51,23,28,FMN 05 Gerard Le Grellelaan
653,Gerard le Grellelaan 10,2022-09-22,07:00:00,129,93,36,FMN 05 Gerard Le Grellelaan
653,Gerard le Grellelaan 10,2022-09-22,08:00:00,312,255,57,FMN 05 Gerard Le Grellelaan
653,Gerard le Grellelaan 10,2022-09-22,09:00:00,119,92,27,FMN 05 Gerard Le Grellelaan
653,Gerard le Grellelaan 10,2022-09-22,10:00:00,86,64,22,FMN 05 Gerard Le Grellelaan
653,Gerard le Grellelaan 10,2022-09-22,11:00:00,99,76,23,FMN 05 Gerard Le Grellelaan
653,Gerard le Grellelaan 10,2022-09-22,12:00:00,144,100,44,FMN 05 Gerard Le Grellelaan
653,Gerard le Grellelaan 10,2022-09-22,13:00:00,117,93,24,FMN 05 Gerard Le Grellelaan
653,Gerard le Grellelaan 10,2022-09-22,14:00:00,150,123,27,FMN 05 Gerard Le Grellelaan
653,Gerard le Grellelaan 10,2022-09-22,15:00:00,184,138,46,FMN 05 Gerard Le Grellelaan
653,Gerard le Grellelaan 10,2022-09-22,16:00:00,217,181,36,FMN 05 Gerard Le Grellelaan
653,Gerard le Grellelaan 10,2022-09-22,17:00:00,221,168,53,FMN 05 Gerard Le Grellelaan
653,Gerard le Grellelaan 10,2022-09-22,18:00:00,168,136,32,FMN 05 Gerard Le Grellelaan
653,Gerard le Grellelaan 10,2022-09-22,19:00:00,83,71,12,FMN 05 Gerard Le Grellelaan
653,Gerard le Grellelaan 10,2022-09-22,20:00:00,82,61,21,FMN 05 Gerard Le Grellelaan
653,Gerard le Grellelaan 10,2022-09-22,21:00:00,35,23,12,FMN 05 Gerard Le Grellelaan
653,Gerard le Grellelaan 10,2022-09-22,22:00:00,49,35,14,FMN 05 Gerard Le Grellelaan
653,Gerard le Grellelaan 10,2022-09-22,23:00:00,27,20,7,FMN 05 Gerard Le Grellelaan
653,Gerard le Grellelaan 10,2022-09-23,00:00:00,8,3,5,FMN 05 Gerard Le Grellelaan
653,Gerard le Grellelaan 10,2022-09-23,01:00:00,1,1,0,FMN 05 Gerard Le Grellelaan
653,Gerard le Grellelaan 10,2022-09-23,02:00:00,0,0,0,FMN 05 Gerard Le Grellelaan
653,Gerard le Grellelaan 10,2022-09-23,03:00:00,3,1,2,FMN 05 Gerard Le Grellelaan
653,Gerard le Grellelaan 10,2022-09-23,04:00:00,6,4,2,FMN 05 Gerard Le Grellelaan
653,Gerard le Grellelaan 10,2022-09-23,05:00:00,22,7,15,FMN 05 Gerard Le Grellelaan
653,Gerard le Grellelaan 10,2022-09-23,06:00:00,42,19,23,FMN 05 Gerard Le Grellelaan
653,Gerard le Grellelaan 10,2022-09-23,07:00:00,120,89,31,FMN 05 Gerard Le Grellelaan
653,Gerard le Grellelaan 10,2022-09-23,08:00:00,274,209,65,FMN 05 Gerard Le Grellelaan
653,Gerard le Grellelaan 10,2022-09-23,09:00:00,75,61,14,FMN 05 Gerard Le Grellelaan
653,Gerard le Grellelaan 10,2022-09-23,10:00:00,72,61,11,FMN 05 Gerard Le Grellelaan
653,Gerard le Grellelaan 10,2022-09-23,11:00:00,75,66,9,FMN 05 Gerard Le Grellelaan
653,Gerard le Grellelaan 10,2022-09-23,12:00:00,95,73,22,FMN 05 Gerard Le Grellelaan
653,Gerard le Grellelaan 10,2022-09-23,13:00:00,91,73,18,FMN 05 Gerard Le Grellelaan
653,Gerard le Grellelaan 10,2022-09-23,14:00:00,85,70,15,FMN 05 Gerard Le Grellelaan
653,Gerard le Grellelaan 10,2022-09-23,15:00:00,166,133,33,FMN 05 Gerard Le Grellelaan
653,Gerard le Grellelaan 10,2022-09-23,16:00:00,177,144,33,FMN 05 Gerard Le Grellelaan
653,Gerard le Grellelaan 10,2022-09-23,17:00:00,164,121,43,FMN 05 Gerard Le Grellelaan
653,Gerard le Grellelaan 10,2022-09-23,18:00:00,98,76,22,FMN 05 Gerard Le Grellelaan
653,Gerard le Grellelaan 10,2022-09-23,19:00:00,64,48,16,FMN 05 Gerard Le Grellelaan
653,Gerard le Grellelaan 10,2022-09-23,20:00:00,57,46,11,FMN 05 Gerard Le Grellelaan
653,Gerard le Grellelaan 10,2022-09-23,21:00:00,26,21,5,FMN 05 Gerard Le Grellelaan
653,Gerard le Grellelaan 10,2022-09-23,22:00:00,34,30,4,FMN 05 Gerard Le Grellelaan
653,Gerard le Grellelaan 10,2022-09-23,23:00:00,23,16,7,FMN 05 Gerard Le Grellelaan
653,Gerard le Grellelaan 10,2022-09-24,00:00:00,8,5,3,FMN 05 Gerard Le Grellelaan
653,Gerard le Grellelaan 10,2022-09-24,01:00:00,10,7,3,FMN 05 Gerard Le Grellelaan
653,Gerard le Grellelaan 10,2022-09-24,02:00:00,6,6,0,FMN 05 Gerard Le Grellelaan
653,Gerard le Grellelaan 10,2022-09-24,03:00:00,3,1,2,FMN 05 Gerard Le Grellelaan
653,Gerard le Grellelaan 10,2022-09-24,04:00:00,4,1,3,FMN 05 Gerard Le Grellelaan
653,Gerard le Grellelaan 10,2022-09-24,05:00:00,10,4,6,FMN 05 Gerard Le Grellelaan
653,Gerard le Grellelaan 10,2022-09-24,06:00:00,9,7,2,FMN 05 Gerard Le Grellelaan
653,Gerard le Grellelaan 10,2022-09-24,07:00:00,9,6,3,FMN 05 Gerard Le Grellelaan
653,Gerard le Grellelaan 10,2022-09-24,08:00:00,28,20,8,FMN 05 Gerard Le Grellelaan
653,Gerard le Grellelaan 10,2022-09-24,09:00:00,33,22,11,FMN 05 Gerard Le Grellelaan
653,Gerard le Grellelaan 10,2022-09-24,10:00:00,36,33,3,FMN 05 Gerard Le Grellelaan
653,Gerard le Grellelaan 10,2022-09-24,11:00:00,38,30,8,FMN 05 Gerard Le Grellelaan
653,Gerard le Grellelaan 10,2022-09-24,12:00:00,39,28,11,FMN 05 Gerard Le Grellelaan
653,Gerard le Grellelaan 10,2022-09-24,13:00:00,62,46,16,FMN 05 Gerard Le Grellelaan
653,Gerard le Grellelaan 10,2022-09-24,14:00:00,45,28,17,FMN 05 Gerard Le Grellelaan
653,Gerard le Grellelaan 10,2022-09-24,15:00:00,47,42,5,FMN 05 Gerard Le Grellelaan
653,Gerard le Grellelaan 10,2022-09-24,16:00:00,49,40,9,FMN 05 Gerard Le Grellelaan
653,Gerard le Grellelaan 10,2022-09-24,17:00:00,47,34,13,FMN 05 Gerard Le Grellelaan
653,Gerard le Grellelaan 10,2022-09-24,18:00:00,49,41,8,FMN 05 Gerard Le Grellelaan
653,Gerard le Grellelaan 10,2022-09-24,19:00:00,36,34,2,FMN 05 Gerard Le Grellelaan
653,Gerard le Grellelaan 10,2022-09-24,20:00:00,34,28,6,FMN 05 Gerard Le Grellelaan
653,Gerard le Grellelaan 10,2022-09-24,21:00:00,28,17,11,FMN 05 Gerard Le Grellelaan
653,Gerard le Grellelaan 10,2022-09-24,22:00:00,18,14,4,FMN 05 Gerard Le Grellelaan
653,Gerard le Grellelaan 10,2022-09-24,23:00:00,33,28,5,FMN 05 Gerard Le Grellelaan
653,Gerard le Grellelaan 10,2022-09-25,00:00:00,12,10,2,FMN 05 Gerard Le Grellelaan
653,Gerard le Grellelaan 10,2022-09-25,01:00:00,9,7,2,FMN 05 Gerard Le Grellelaan
653,Gerard le Grellelaan 10,2022-09-25,02:00:00,7,3,4,FMN 05 Gerard Le Grellelaan
653,Gerard le Grellelaan 10,2022-09-25,03:00:00,5,5,0,FMN 05 Gerard Le Grellelaan
653,Gerard le Grellelaan 10,2022-09-25,04:00:00,5,2,3,FMN 05 Gerard Le Grellelaan
653,Gerard le Grellelaan 10,2022-09-25,05:00:00,3,2,1,FMN 05 Gerard Le Grellelaan
653,Gerard le Grellelaan 10,2022-09-25,06:00:00,7,4,3,FMN 05 Gerard Le Grellelaan
653,Gerard le Grellelaan 10,2022-09-25,07:00:00,11,11,0,FMN 05 Gerard Le Grellelaan
653,Gerard le Grellelaan 10,2022-09-25,08:00:00,10,8,2,FMN 05 Gerard Le Grellelaan
653,Gerard le Grellelaan 10,2022-09-25,09:00:00,44,38,6,FMN 05 Gerard Le Grellelaan
653,Gerard le Grellelaan 10,2022-09-25,10:00:00,77,62,15,FMN 05 Gerard Le Grellelaan
653,Gerard le Grellelaan 10,2022-09-25,11:00:00,76,57,19,FMN 05 Gerard Le Grellelaan
653,Gerard le Grellelaan 10,2022-09-25,12:00:00,99,82,17,FMN 05 Gerard Le Grellelaan
653,Gerard le Grellelaan 10,2022-09-25,13:00:00,99,76,23,FMN 05 Gerard Le Grellelaan
653,Gerard le Grellelaan 10,2022-09-25,14:00:00,117,91,26,FMN 05 Gerard Le Grellelaan
653,Gerard le Grellelaan 10,2022-09-25,15:00:00,90,69,21,FMN 05 Gerard Le Grellelaan
653,Gerard le Grellelaan 10,2022-09-25,16:00:00,120,111,9,FMN 05 Gerard Le Grellelaan
653,Gerard le Grellelaan 10,2022-09-25,17:00:00,103,87,16,FMN 05 Gerard Le Grellelaan
653,Gerard le Grellelaan 10,2022-09-25,18:00:00,69,58,11,FMN 05 Gerard Le Grellelaan
653,Gerard le Grellelaan 10,2022-09-25,19:00:00,52,40,12,FMN 05 Gerard Le Grellelaan
653,Gerard le Grellelaan 10,2022-09-25,20:00:00,46,37,9,FMN 05 Gerard Le Grellelaan
653,Gerard le Grellelaan 10,2022-09-25,21:00:00,20,17,3,FMN 05 Gerard Le Grellelaan
653,Gerard le Grellelaan 10,2022-09-25,22:00:00,23,16,7,FMN 05 Gerard Le Grellelaan
653,Gerard le Grellelaan 10,2022-09-25,23:00:00,15,9,6,FMN 05 Gerard Le Grellelaan
653,Gerard le Grellelaan 10,2022-09-26,00:00:00,4,2,2,FMN 05 Gerard Le Grellelaan
653,Gerard le Grellelaan 10,2022-09-26,01:00:00,1,1,0,FMN 05 Gerard Le Grellelaan
653,Gerard le Grellelaan 10,2022-09-26,02:00:00,3,2,1,FMN 05 Gerard Le Grellelaan
653,Gerard le Grellelaan 10,2022-09-26,03:00:00,2,2,0,FMN 05 Gerard Le Grellelaan
653,Gerard le Grellelaan 10,2022-09-26,04:00:00,10,3,7,FMN 05 Gerard Le Grellelaan
653,Gerard le Grellelaan 10,2022-09-26,05:00:00,27,7,20,FMN 05 Gerard Le Grellelaan
653,Gerard le Grellelaan 10,2022-09-26,06:00:00,44,23,21,FMN 05 Gerard Le Grellelaan
653,Gerard le Grellelaan 10,2022-09-26,07:00:00,132,97,35,FMN 05 Gerard Le Grellelaan
653,Gerard le Grellelaan 10,2022-09-26,08:00:00,286,218,68,FMN 05 Gerard Le Grellelaan
653,Gerard le Grellelaan 10,2022-09-26,09:00:00,79,65,14,FMN 05 Gerard Le Grellelaan
653,Gerard le Grellelaan 10,2022-09-26,10:00:00,58,45,13,FMN 05 Gerard Le Grellelaan
653,Gerard le Grellelaan 10,2022-09-26,11:00:00,53,42,11,FMN 05 Gerard Le Grellelaan
653,Gerard le Grellelaan 10,2022-09-26,12:00:00,88,64,24,FMN 05 Gerard Le Grellelaan
653,Gerard le Grellelaan 10,2022-09-26,13:00:00,54,45,9,FMN 05 Gerard Le Grellelaan
653,Gerard le Grellelaan 10,2022-09-26,14:00:00,107,84,23,FMN 05 Gerard Le Grellelaan
653,Gerard le Grellelaan 10,2022-09-26,15:00:00,123,102,21,FMN 05 Gerard Le Grellelaan
653,Gerard le Grellelaan 10,2022-09-26,16:00:00,144,110,34,FMN 05 Gerard Le Grellelaan
653,Gerard le Grellelaan 10,2022-09-26,17:00:00,157,132,25,FMN 05 Gerard Le Grellelaan
653,Gerard le Grellelaan 10,2022-09-26,18:00:00,116,100,16,FMN 05 Gerard Le Grellelaan
653,Gerard le Grellelaan 10,2022-09-26,19:00:00,55,36,19,FMN 05 Gerard Le Grellelaan
653,Gerard le Grellelaan 10,2022-09-26,20:00:00,35,28,7,FMN 05 Gerard Le Grellelaan
653,Gerard le Grellelaan 10,2022-09-26,21:00:00,28,20,8,FMN 05 Gerard Le Grellelaan
653,Gerard le Grellelaan 10,2022-09-26,22:00:00,25,19,6,FMN 05 Gerard Le Grellelaan
653,Gerard le Grellelaan 10,2022-09-26,23:00:00,8,4,4,FMN 05 Gerard Le Grellelaan
653,Gerard le Grellelaan 10,2022-09-27,00:00:00,5,5,0,FMN 05 Gerard Le Grellelaan
653,Gerard le Grellelaan 10,2022-09-27,01:00:00,4,4,0,FMN 05 Gerard Le Grellelaan
653,Gerard le Grellelaan 10,2022-09-27,02:00:00,2,1,1,FMN 05 Gerard Le Grellelaan
653,Gerard le Grellelaan 10,2022-09-27,03:00:00,2,1,1,FMN 05 Gerard Le Grellelaan
653,Gerard le Grellelaan 10,2022-09-27,04:00:00,7,4,3,FMN 05 Gerard Le Grellelaan
653,Gerard le Grellelaan 10,2022-09-27,05:00:00,24,8,16,FMN 05 Gerard Le Grellelaan
653,Gerard le Grellelaan 10,2022-09-27,06:00:00,31,16,15,FMN 05 Gerard Le Grellelaan
653,Gerard le Grellelaan 10,2022-09-27,07:00:00,102,80,22,FMN 05 Gerard Le Grellelaan
653,Gerard le Grellelaan 10,2022-09-27,08:00:00,227,186,41,FMN 05 Gerard Le Grellelaan
653,Gerard le Grellelaan 10,2022-09-27,09:00:00,71,53,18,FMN 05 Gerard Le Grellelaan
653,Gerard le Grellelaan 10,2022-09-27,10:00:00,66,53,13,FMN 05 Gerard Le Grellelaan
653,Gerard le Grellelaan 10,2022-09-27,11:00:00,44,37,7,FMN 05 Gerard Le Grellelaan
653,Gerard le Grellelaan 10,2022-09-27,12:00:00,88,65,23,FMN 05 Gerard Le Grellelaan
653,Gerard le Grellelaan 10,2022-09-27,13:00:00,71,53,18,FMN 05 Gerard Le Grellelaan
653,Gerard le Grellelaan 10,2022-09-27,14:00:00,70,59,11,FMN 05 Gerard Le Grellelaan
653,Gerard le Grellelaan 10,2022-09-27,15:00:00,142,107,35,FMN 05 Gerard Le Grellelaan
653,Gerard le Grellelaan 10,2022-09-27,16:00:00,178,144,34,FMN 05 Gerard Le Grellelaan
653,Gerard le Grellelaan 10,2022-09-27,17:00:00,198,161,37,FMN 05 Gerard Le Grellelaan
653,Gerard le Grellelaan 10,2022-09-27,18:00:00,107,78,29,FMN 05 Gerard Le Grellelaan
653,Gerard le Grellelaan 10,2022-09-27,19:00:00,67,53,14,FMN 05 Gerard Le Grellelaan
653,Gerard le Grellelaan 10,2022-09-27,20:00:00,36,33,3,FMN 05 Gerard Le Grellelaan
653,Gerard le Grellelaan 10,2022-09-27,21:00:00,22,19,3,FMN 05 Gerard Le Grellelaan
653,Gerard le Grellelaan 10,2022-09-27,22:00:00,40,35,5,FMN 05 Gerard Le Grellelaan
653,Gerard le Grellelaan 10,2022-09-27,23:00:00,13,10,3,FMN 05 Gerard Le Grellelaan
653,Gerard le Grellelaan 10,2022-09-28,00:00:00,3,2,1,FMN 05 Gerard Le Grellelaan
653,Gerard le Grellelaan 10,2022-09-28,01:00:00,0,0,0,FMN 05 Gerard Le Grellelaan
653,Gerard le Grellelaan 10,2022-09-28,02:00:00,1,0,1,FMN 05 Gerard Le Grellelaan
653,Gerard le Grellelaan 10,2022-09-28,03:00:00,1,1,0,FMN 05 Gerard Le Grellelaan
653,Gerard le Grellelaan 10,2022-09-28,04:00:00,5,2,3,FMN 05 Gerard Le Grellelaan
653,Gerard le Grellelaan 10,2022-09-28,05:00:00,26,8,18,FMN 05 Gerard Le Grellelaan
653,Gerard le Grellelaan 10,2022-09-28,06:00:00,40,16,24,FMN 05 Gerard Le Grellelaan
653,Gerard le Grellelaan 10,2022-09-28,07:00:00,118,82,36,FMN 05 Gerard Le Grellelaan
653,Gerard le Grellelaan 10,2022-09-28,08:00:00,230,182,48,FMN 05 Gerard Le Grellelaan
653,Gerard le Grellelaan 10,2022-09-28,09:00:00,68,59,9,FMN 05 Gerard Le Grellelaan
653,Gerard le Grellelaan 10,2022-09-28,10:00:00,86,66,20,FMN 05 Gerard Le Grellelaan
653,Gerard le Grellelaan 10,2022-09-28,11:00:00,62,51,11,FMN 05 Gerard Le Grellelaan
653,Gerard le Grellelaan 10,2022-09-28,12:00:00,144,110,34,FMN 05 Gerard Le Grellelaan
653,Gerard le Grellelaan 10,2022-09-28,13:00:00,102,73,29,FMN 05 Gerard Le Grellelaan
653,Gerard le Grellelaan 10,2022-09-28,14:00:00,68,53,15,FMN 05 Gerard Le Grellelaan
653,Gerard le Grellelaan 10,2022-09-28,15:00:00,136,111,25,FMN 05 Gerard Le Grellelaan
653,Gerard le Grellelaan 10,2022-09-28,16:00:00,143,122,21,FMN 05 Gerard Le Grellelaan
653,Gerard le Grellelaan 10,2022-09-28,17:00:00,179,137,42,FMN 05 Gerard Le Grellelaan
653,Gerard le Grellelaan 10,2022-09-28,18:00:00,166,132,34,FMN 05 Gerard Le Grellelaan
653,Gerard le Grellelaan 10,2022-09-28,19:00:00,85,68,17,FMN 05 Gerard Le Grellelaan
653,Gerard le Grellelaan 10,2022-09-28,20:00:00,52,42,10,FMN 05 Gerard Le Grellelaan
653,Gerard le Grellelaan 10,2022-09-28,21:00:00,31,24,7,FMN 05 Gerard Le Grellelaan
653,Gerard le Grellelaan 10,2022-09-28,22:00:00,42,30,12,FMN 05 Gerard Le Grellelaan
653,Gerard le Grellelaan 10,2022-09-28,23:00:00,13,10,3,FMN 05 Gerard Le Grellelaan
653,Gerard le Grellelaan 10,2022-09-29,00:00:00,10,8,2,FMN 05 Gerard Le Grellelaan
653,Gerard le Grellelaan 10,2022-09-29,01:00:00,5,5,0,FMN 05 Gerard Le Grellelaan
653,Gerard le Grellelaan 10,2022-09-29,02:00:00,3,1,2,FMN 05 Gerard Le Grellelaan
653,Gerard le Grellelaan 10,2022-09-29,03:00:00,1,1,0,FMN 05 Gerard Le Grellelaan
653,Gerard le Grellelaan 10,2022-09-29,04:00:00,7,1,6,FMN 05 Gerard Le Grellelaan
653,Gerard le Grellelaan 10,2022-09-29,05:00:00,26,5,21,FMN 05 Gerard Le Grellelaan
653,Gerard le Grellelaan 10,2022-09-29,06:00:00,42,18,24,FMN 05 Gerard Le Grellelaan
653,Gerard le Grellelaan 10,2022-09-29,07:00:00,117,93,24,FMN 05 Gerard Le Grellelaan
653,Gerard le Grellelaan 10,2022-09-29,08:00:00,281,222,59,FMN 05 Gerard Le Grellelaan
653,Gerard le Grellelaan 10,2022-09-29,09:00:00,116,100,16,FMN 05 Gerard Le Grellelaan
653,Gerard le Grellelaan 10,2022-09-29,10:00:00,85,64,21,FMN 05 Gerard Le Grellelaan
653,Gerard le Grellelaan 10,2022-09-29,11:00:00,96,75,21,FMN 05 Gerard Le Grellelaan
653,Gerard le Grellelaan 10,2022-09-29,12:00:00,109,78,31,FMN 05 Gerard Le Grellelaan
653,Gerard le Grellelaan 10,2022-09-29,13:00:00,95,69,26,FMN 05 Gerard Le Grellelaan
653,Gerard le Grellelaan 10,2022-09-29,14:00:00,114,97,17,FMN 05 Gerard Le Grellelaan
653,Gerard le Grellelaan 10,2022-09-29,15:00:00,184,140,44,FMN 05 Gerard Le Grellelaan
653,Gerard le Grellelaan 10,2022-09-29,16:00:00,221,181,40,FMN 05 Gerard Le Grellelaan
653,Gerard le Grellelaan 10,2022-09-29,17:00:00,201,160,41,FMN 05 Gerard Le Grellelaan
653,Gerard le Grellelaan 10,2022-09-29,18:00:00,125,91,34,FMN 05 Gerard Le Grellelaan
653,Gerard le Grellelaan 10,2022-09-29,19:00:00,87,71,16,FMN 05 Gerard Le Grellelaan
653,Gerard le Grellelaan 10,2022-09-29,20:00:00,48,35,13,FMN 05 Gerard Le Grellelaan
653,Gerard le Grellelaan 10,2022-09-29,21:00:00,47,39,8,FMN 05 Gerard Le Grellelaan
653,Gerard le Grellelaan 10,2022-09-29,22:00:00,75,59,16,FMN 05 Gerard Le Grellelaan
653,Gerard le Grellelaan 10,2022-09-29,23:00:00,29,18,11,FMN 05 Gerard Le Grellelaan
653,Gerard le Grellelaan 10,2022-09-30,00:00:00,3,0,3,FMN 05 Gerard Le Grellelaan
653,Gerard le Grellelaan 10,2022-09-30,01:00:00,1,1,0,FMN 05 Gerard Le Grellelaan
653,Gerard le Grellelaan 10,2022-09-30,02:00:00,2,1,1,FMN 05 Gerard Le Grellelaan
653,Gerard le Grellelaan 10,2022-09-30,03:00:00,3,3,0,FMN 05 Gerard Le Grellelaan
653,Gerard le Grellelaan 10,2022-09-30,04:00:00,9,6,3,FMN 05 Gerard Le Grellelaan
653,Gerard le Grellelaan 10,2022-09-30,05:00:00,19,4,15,FMN 05 Gerard Le Grellelaan
653,Gerard le Grellelaan 10,2022-09-30,06:00:00,38,17,21,FMN 05 Gerard Le Grellelaan
653,Gerard le Grellelaan 10,2022-09-30,07:00:00,120,93,27,FMN 05 Gerard Le Grellelaan
653,Gerard le Grellelaan 10,2022-09-30,08:00:00,246,174,72,FMN 05 Gerard Le Grellelaan
653,Gerard le Grellelaan 10,2022-09-30,09:00:00,85,74,11,FMN 05 Gerard Le Grellelaan
653,Gerard le Grellelaan 10,2022-09-30,10:00:00,88,71,17,FMN 05 Gerard Le Grellelaan
653,Gerard le Grellelaan 10,2022-09-30,11:00:00,85,66,19,FMN 05 Gerard Le Grellelaan
653,Gerard le Grellelaan 10,2022-09-30,12:00:00,120,100,20,FMN 05 Gerard Le Grellelaan
653,Gerard le Grellelaan 10,2022-09-30,13:00:00,109,88,21,FMN 05 Gerard Le Grellelaan
653,Gerard le Grellelaan 10,2022-09-30,14:00:00,98,86,12,FMN 05 Gerard Le Grellelaan
653,Gerard le Grellelaan 10,2022-09-30,15:00:00,144,117,27,FMN 05 Gerard Le Grellelaan
653,Gerard le Grellelaan 10,2022-09-30,16:00:00,235,202,33,FMN 05 Gerard Le Grellelaan
653,Gerard le Grellelaan 10,2022-09-30,17:00:00,156,124,32,FMN 05 Gerard Le Grellelaan
653,Gerard le Grellelaan 10,2022-09-30,18:00:00,106,87,19,FMN 05 Gerard Le Grellelaan
653,Gerard le Grellelaan 10,2022-09-30,19:00:00,84,65,19,FMN 05 Gerard Le Grellelaan
653,Gerard le Grellelaan 10,2022-09-30,20:00:00,62,51,11,FMN 05 Gerard Le Grellelaan
653,Gerard le Grellelaan 10,2022-09-30,21:00:00,49,38,11,FMN 05 Gerard Le Grellelaan
653,Gerard le Grellelaan 10,2022-09-30,22:00:00,26,23,3,FMN 05 Gerard Le Grellelaan
653,Gerard le Grellelaan 10,2022-09-30,23:00:00,27,16,11,FMN 05 Gerard Le Grellelaan
653,Gerard le Grellelaan 10,2022-10-01,00:00:00,11,8,3,FMN 05 Gerard Le Grellelaan
653,Gerard le Grellelaan 10,2022-10-01,01:00:00,10,7,3,FMN 05 Gerard Le Grellelaan
653,Gerard le Grellelaan 10,2022-10-01,02:00:00,11,6,5,FMN 05 Gerard Le Grellelaan
653,Gerard le Grellelaan 10,2022-10-01,03:00:00,0,0,0,FMN 05 Gerard Le Grellelaan
653,Gerard le Grellelaan 10,2022-10-01,04:00:00,4,1,3,FMN 05 Gerard Le Grellelaan
653,Gerard le Grellelaan 10,2022-10-01,05:00:00,6,2,4,FMN 05 Gerard Le Grellelaan
653,Gerard le Grellelaan 10,2022-10-01,06:00:00,8,4,4,FMN 05 Gerard Le Grellelaan
653,Gerard le Grellelaan 10,2022-10-01,07:00:00,15,9,6,FMN 05 Gerard Le Grellelaan
653,Gerard le Grellelaan 10,2022-10-01,08:00:00,30,20,10,FMN 05 Gerard Le Grellelaan
653,Gerard le Grellelaan 10,2022-10-01,09:00:00,49,38,11,FMN 05 Gerard Le Grellelaan
653,Gerard le Grellelaan 10,2022-10-01,10:00:00,71,53,18,FMN 05 Gerard Le Grellelaan
653,Gerard le Grellelaan 10,2022-10-01,11:00:00,55,48,7,FMN 05 Gerard Le Grellelaan
653,Gerard le Grellelaan 10,2022-10-01,12:00:00,49,40,9,FMN 05 Gerard Le Grellelaan
653,Gerard le Grellelaan 10,2022-10-01,13:00:00,69,63,6,FMN 05 Gerard Le Grellelaan
653,Gerard le Grellelaan 10,2022-10-01,14:00:00,72,58,14,FMN 05 Gerard Le Grellelaan
653,Gerard le Grellelaan 10,2022-10-01,15:00:00,66,57,9,FMN 05 Gerard Le Grellelaan
653,Gerard le Grellelaan 10,2022-10-01,16:00:00,80,64,16,FMN 05 Gerard Le Grellelaan
653,Gerard le Grellelaan 10,2022-10-01,17:00:00,64,48,16,FMN 05 Gerard Le Grellelaan
653,Gerard le Grellelaan 10,2022-10-01,18:00:00,70,57,13,FMN 05 Gerard Le Grellelaan
653,Gerard le Grellelaan 10,2022-10-01,19:00:00,62,51,11,FMN 05 Gerard Le Grellelaan
653,Gerard le Grellelaan 10,2022-10-01,20:00:00,37,27,10,FMN 05 Gerard Le Grellelaan
653,Gerard le Grellelaan 10,2022-10-01,21:00:00,33,23,10,FMN 05 Gerard Le Grellelaan
653,Gerard le Grellelaan 10,2022-10-01,22:00:00,28,23,5,FMN 05 Gerard Le Grellelaan
653,Gerard le Grellelaan 10,2022-10-01,23:00:00,23,21,2,FMN 05 Gerard Le Grellelaan
653,Gerard le Grellelaan 10,2022-10-02,00:00:00,16,10,6,FMN 05 Gerard Le Grellelaan
653,Gerard le Grellelaan 10,2022-10-02,01:00:00,9,7,2,FMN 05 Gerard Le Grellelaan
653,Gerard le Grellelaan 10,2022-10-02,02:00:00,15,13,2,FMN 05 Gerard Le Grellelaan
653,Gerard le Grellelaan 10,2022-10-02,03:00:00,2,2,0,FMN 05 Gerard Le Grellelaan
653,Gerard le Grellelaan 10,2022-10-02,04:00:00,4,1,3,FMN 05 Gerard Le Grellelaan
653,Gerard le Grellelaan 10,2022-10-02,05:00:00,5,2,3,FMN 05 Gerard Le Grellelaan
653,Gerard le Grellelaan 10,2022-10-02,06:00:00,6,3,3,FMN 05 Gerard Le Grellelaan
653,Gerard le Grellelaan 10,2022-10-02,07:00:00,10,9,1,FMN 05 Gerard Le Grellelaan
653,Gerard le Grellelaan 10,2022-10-02,08:00:00,21,11,10,FMN 05 Gerard Le Grellelaan
653,Gerard le Grellelaan 10,2022-10-02,09:00:00,58,43,15,FMN 05 Gerard Le Grellelaan
653,Gerard le Grellelaan 10,2022-10-02,10:00:00,59,50,9,FMN 05 Gerard Le Grellelaan
653,Gerard le Grellelaan 10,2022-10-02,11:00:00,62,47,15,FMN 05 Gerard Le Grellelaan
653,Gerard le Grellelaan 10,2022-10-02,12:00:00,77,69,8,FMN 05 Gerard Le Grellelaan
653,Gerard le Grellelaan 10,2022-10-02,13:00:00,60,53,7,FMN 05 Gerard Le Grellelaan
653,Gerard le Grellelaan 10,2022-10-02,14:00:00,77,66,11,FMN 05 Gerard Le Grellelaan
653,Gerard le Grellelaan 10,2022-10-02,15:00:00,57,45,12,FMN 05 Gerard Le Grellelaan
653,Gerard le Grellelaan 10,2022-10-02,16:00:00,58,49,9,FMN 05 Gerard Le Grellelaan
653,Gerard le Grellelaan 10,2022-10-02,17:00:00,94,77,17,FMN 05 Gerard Le Grellelaan
653,Gerard le Grellelaan 10,2022-10-02,18:00:00,56,47,9,FMN 05 Gerard Le Grellelaan
653,Gerard le Grellelaan 10,2022-10-02,19:00:00,40,33,7,FMN 05 Gerard Le Grellelaan
653,Gerard le Grellelaan 10,2022-10-02,20:00:00,30,24,6,FMN 05 Gerard Le Grellelaan
653,Gerard le Grellelaan 10,2022-10-02,21:00:00,36,31,5,FMN 05 Gerard Le Grellelaan
653,Gerard le Grellelaan 10,2022-10-02,22:00:00,19,17,2,FMN 05 Gerard Le Grellelaan
653,Gerard le Grellelaan 10,2022-10-02,23:00:00,12,9,3,FMN 05 Gerard Le Grellelaan
653,Gerard le Grellelaan 10,2022-10-03,00:00:00,3,2,1,FMN 05 Gerard Le Grellelaan
653,Gerard le Grellelaan 10,2022-10-03,01:00:00,1,1,0,FMN 05 Gerard Le Grellelaan
653,Gerard le Grellelaan 10,2022-10-03,02:00:00,3,2,1,FMN 05 Gerard Le Grellelaan
653,Gerard le Grellelaan 10,2022-10-03,03:00:00,2,1,1,FMN 05 Gerard Le Grellelaan
653,Gerard le Grellelaan 10,2022-10-03,04:00:00,10,4,6,FMN 05 Gerard Le Grellelaan
653,Gerard le Grellelaan 10,2022-10-03,05:00:00,25,7,18,FMN 05 Gerard Le Grellelaan
653,Gerard le Grellelaan 10,2022-10-03,06:00:00,42,21,21,FMN 05 Gerard Le Grellelaan
653,Gerard le Grellelaan 10,2022-10-03,07:00:00,119,88,31,FMN 05 Gerard Le Grellelaan
653,Gerard le Grellelaan 10,2022-10-03,08:00:00,213,188,25,FMN 05 Gerard Le Grellelaan
653,Gerard le Grellelaan 10,2022-10-03,09:00:00,92,77,15,FMN 05 Gerard Le Grellelaan
653,Gerard le Grellelaan 10,2022-10-03,10:00:00,75,63,12,FMN 05 Gerard Le Grellelaan
653,Gerard le Grellelaan 10,2022-10-03,11:00:00,75,68,7,FMN 05 Gerard Le Grellelaan
653,Gerard le Grellelaan 10,2022-10-03,12:00:00,98,78,20,FMN 05 Gerard Le Grellelaan
653,Gerard le Grellelaan 10,2022-10-03,13:00:00,87,64,23,FMN 05 Gerard Le Grellelaan
653,Gerard le Grellelaan 10,2022-10-03,14:00:00,100,88,12,FMN 05 Gerard Le Grellelaan
653,Gerard le Grellelaan 10,2022-10-03,15:00:00,147,126,21,FMN 05 Gerard Le Grellelaan
653,Gerard le Grellelaan 10,2022-10-03,16:00:00,192,156,36,FMN 05 Gerard Le Grellelaan
653,Gerard le Grellelaan 10,2022-10-03,17:00:00,208,178,30,FMN 05 Gerard Le Grellelaan
653,Gerard le Grellelaan 10,2022-10-03,18:00:00,161,125,36,FMN 05 Gerard Le Grellelaan
653,Gerard le Grellelaan 10,2022-10-03,19:00:00,74,67,7,FMN 05 Gerard Le Grellelaan
653,Gerard le Grellelaan 10,2022-10-03,20:00:00,57,40,17,FMN 05 Gerard Le Grellelaan
653,Gerard le Grellelaan 10,2022-10-03,21:00:00,24,19,5,FMN 05 Gerard Le Grellelaan
653,Gerard le Grellelaan 10,2022-10-03,22:00:00,55,49,6,FMN 05 Gerard Le Grellelaan
653,Gerard le Grellelaan 10,2022-10-03,23:00:00,20,15,5,FMN 05 Gerard Le Grellelaan
653,Gerard le Grellelaan 10,2022-10-04,00:00:00,8,6,2,FMN 05 Gerard Le Grellelaan
653,Gerard le Grellelaan 10,2022-10-04,01:00:00,4,2,2,FMN 05 Gerard Le Grellelaan
653,Gerard le Grellelaan 10,2022-10-04,02:00:00,2,1,1,FMN 05 Gerard Le Grellelaan
653,Gerard le Grellelaan 10,2022-10-04,03:00:00,1,0,1,FMN 05 Gerard Le Grellelaan
653,Gerard le Grellelaan 10,2022-10-04,04:00:00,6,3,3,FMN 05 Gerard Le Grellelaan
653,Gerard le Grellelaan 10,2022-10-04,05:00:00,29,10,19,FMN 05 Gerard Le Grellelaan
653,Gerard le Grellelaan 10,2022-10-04,06:00:00,47,22,25,FMN 05 Gerard Le Grellelaan
653,Gerard le Grellelaan 10,2022-10-04,07:00:00,146,112,34,FMN 05 Gerard Le Grellelaan
653,Gerard le Grellelaan 10,2022-10-04,08:00:00,370,293,77,FMN 05 Gerard Le Grellelaan
653,Gerard le Grellelaan 10,2022-10-04,09:00:00,111,87,24,FMN 05 Gerard Le Grellelaan
653,Gerard le Grellelaan 10,2022-10-04,10:00:00,67,59,8,FMN 05 Gerard Le Grellelaan
653,Gerard le Grellelaan 10,2022-10-04,11:00:00,94,77,17,FMN 05 Gerard Le Grellelaan
653,Gerard le Grellelaan 10,2022-10-04,12:00:00,115,89,26,FMN 05 Gerard Le Grellelaan
653,Gerard le Grellelaan 10,2022-10-04,13:00:00,113,87,26,FMN 05 Gerard Le Grellelaan
653,Gerard le Grellelaan 10,2022-10-04,14:00:00,119,92,27,FMN 05 Gerard Le Grellelaan
653,Gerard le Grellelaan 10,2022-10-04,15:00:00,171,136,35,FMN 05 Gerard Le Grellelaan
653,Gerard le Grellelaan 10,2022-10-04,16:00:00,272,213,59,FMN 05 Gerard Le Grellelaan
653,Gerard le Grellelaan 10,2022-10-04,17:00:00,292,235,57,FMN 05 Gerard Le Grellelaan
653,Gerard le Grellelaan 10,2022-10-04,18:00:00,212,176,36,FMN 05 Gerard Le Grellelaan
653,Gerard le Grellelaan 10,2022-10-04,19:00:00,82,55,27,FMN 05 Gerard Le Grellelaan
653,Gerard le Grellelaan 10,2022-10-04,20:00:00,83,63,20,FMN 05 Gerard Le Grellelaan
653,Gerard le Grellelaan 10,2022-10-04,21:00:00,42,36,6,FMN 05 Gerard Le Grellelaan
653,Gerard le Grellelaan 10,2022-10-04,22:00:00,61,52,9,FMN 05 Gerard Le Grellelaan
653,Gerard le Grellelaan 10,2022-10-04,23:00:00,10,7,3,FMN 05 Gerard Le Grellelaan
653,Gerard le Grellelaan 10,2022-10-05,00:00:00,9,7,2,FMN 05 Gerard Le Grellelaan
653,Gerard le Grellelaan 10,2022-10-05,01:00:00,0,0,0,FMN 05 Gerard Le Grellelaan
653,Gerard le Grellelaan 10,2022-10-05,02:00:00,4,3,1,FMN 05 Gerard Le Grellelaan
653,Gerard le Grellelaan 10,2022-10-05,03:00:00,4,4,0,FMN 05 Gerard Le Grellelaan
653,Gerard le Grellelaan 10,2022-10-05,04:00:00,6,3,3,FMN 05 Gerard Le Grellelaan
653,Gerard le Grellelaan 10,2022-10-05,05:00:00,34,13,21,FMN 05 Gerard Le Grellelaan
653,Gerard le Grellelaan 10,2022-10-05,06:00:00,52,26,26,FMN 05 Gerard Le Grellelaan
653,Gerard le Grellelaan 10,2022-10-05,07:00:00,140,98,42,FMN 05 Gerard Le Grellelaan
653,Gerard le Grellelaan 10,2022-10-05,08:00:00,310,250,60,FMN 05 Gerard Le Grellelaan
653,Gerard le Grellelaan 10,2022-10-05,09:00:00,96,83,13,FMN 05 Gerard Le Grellelaan
653,Gerard le Grellelaan 10,2022-10-05,10:00:00,87,78,9,FMN 05 Gerard Le Grellelaan
653,Gerard le Grellelaan 10,2022-10-05,11:00:00,90,71,19,FMN 05 Gerard Le Grellelaan
653,Gerard le Grellelaan 10,2022-10-05,12:00:00,192,147,45,FMN 05 Gerard Le Grellelaan
653,Gerard le Grellelaan 10,2022-10-05,13:00:00,141,91,50,FMN 05 Gerard Le Grellelaan
653,Gerard le Grellelaan 10,2022-10-05,14:00:00,98,73,25,FMN 05 Gerard Le Grellelaan
653,Gerard le Grellelaan 10,2022-10-05,15:00:00,146,118,28,FMN 05 Gerard Le Grellelaan
653,Gerard le Grellelaan 10,2022-10-05,16:00:00,146,115,31,FMN 05 Gerard Le Grellelaan
653,Gerard le Grellelaan 10,2022-10-05,17:00:00,217,178,39,FMN 05 Gerard Le Grellelaan
653,Gerard le Grellelaan 10,2022-10-05,18:00:00,160,129,31,FMN 05 Gerard Le Grellelaan
653,Gerard le Grellelaan 10,2022-10-05,19:00:00,91,72,19,FMN 05 Gerard Le Grellelaan
653,Gerard le Grellelaan 10,2022-10-05,20:00:00,70,59,11,FMN 05 Gerard Le Grellelaan
653,Gerard le Grellelaan 10,2022-10-05,21:00:00,41,32,9,FMN 05 Gerard Le Grellelaan
653,Gerard le Grellelaan 10,2022-10-05,22:00:00,42,34,8,FMN 05 Gerard Le Grellelaan
653,Gerard le Grellelaan 10,2022-10-05,23:00:00,17,12,5,FMN 05 Gerard Le Grellelaan
653,Gerard le Grellelaan 10,2022-10-06,00:00:00,3,3,0,FMN 05 Gerard Le Grellelaan
653,Gerard le Grellelaan 10,2022-10-06,01:00:00,1,1,0,FMN 05 Gerard Le Grellelaan
653,Gerard le Grellelaan 10,2022-10-06,02:00:00,3,2,1,FMN 05 Gerard Le Grellelaan
653,Gerard le Grellelaan 10,2022-10-06,03:00:00,2,0,2,FMN 05 Gerard Le Grellelaan
653,Gerard le Grellelaan 10,2022-10-06,04:00:00,7,2,5,FMN 05 Gerard Le Grellelaan
653,Gerard le Grellelaan 10,2022-10-06,05:00:00,28,10,18,FMN 05 Gerard Le Grellelaan
653,Gerard le Grellelaan 10,2022-10-06,06:00:00,46,23,23,FMN 05 Gerard Le Grellelaan
653,Gerard le Grellelaan 10,2022-10-06,07:00:00,165,123,42,FMN 05 Gerard Le Grellelaan
653,Gerard le Grellelaan 10,2022-10-06,08:00:00,352,267,85,FMN 05 Gerard Le Grellelaan
653,Gerard le Grellelaan 10,2022-10-06,09:00:00,95,83,12,FMN 05 Gerard Le Grellelaan
653,Gerard le Grellelaan 10,2022-10-06,10:00:00,75,61,14,FMN 05 Gerard Le Grellelaan
653,Gerard le Grellelaan 10,2022-10-06,11:00:00,67,50,17,FMN 05 Gerard Le Grellelaan
653,Gerard le Grellelaan 10,2022-10-06,12:00:00,117,95,22,FMN 05 Gerard Le Grellelaan
653,Gerard le Grellelaan 10,2022-10-06,13:00:00,136,105,31,FMN 05 Gerard Le Grellelaan
653,Gerard le Grellelaan 10,2022-10-06,14:00:00,104,92,12,FMN 05 Gerard Le Grellelaan
653,Gerard le Grellelaan 10,2022-10-06,15:00:00,205,156,49,FMN 05 Gerard Le Grellelaan
653,Gerard le Grellelaan 10,2022-10-06,16:00:00,242,187,55,FMN 05 Gerard Le Grellelaan
653,Gerard le Grellelaan 10,2022-10-06,17:00:00,247,202,45,FMN 05 Gerard Le Grellelaan
653,Gerard le Grellelaan 10,2022-10-06,18:00:00,184,145,39,FMN 05 Gerard Le Grellelaan
653,Gerard le Grellelaan 10,2022-10-06,19:00:00,121,102,19,FMN 05 Gerard Le Grellelaan
653,Gerard le Grellelaan 10,2022-10-06,20:00:00,81,57,24,FMN 05 Gerard Le Grellelaan
653,Gerard le Grellelaan 10,2022-10-06,21:00:00,41,29,12,FMN 05 Gerard Le Grellelaan
653,Gerard le Grellelaan 10,2022-10-06,22:00:00,72,60,12,FMN 05 Gerard Le Grellelaan
653,Gerard le Grellelaan 10,2022-10-06,23:00:00,24,16,8,FMN 05 Gerard Le Grellelaan
653,Gerard le Grellelaan 10,2022-10-07,00:00:00,18,12,6,FMN 05 Gerard Le Grellelaan
653,Gerard le Grellelaan 10,2022-10-07,01:00:00,3,2,1,FMN 05 Gerard Le Grellelaan
653,Gerard le Grellelaan 10,2022-10-07,02:00:00,3,3,0,FMN 05 Gerard Le Grellelaan
653,Gerard le Grellelaan 10,2022-10-07,03:00:00,4,2,2,FMN 05 Gerard Le Grellelaan
653,Gerard le Grellelaan 10,2022-10-07,04:00:00,7,2,5,FMN 05 Gerard Le Grellelaan
653,Gerard le Grellelaan 10,2022-10-07,05:00:00,21,7,14,FMN 05 Gerard Le Grellelaan
653,Gerard le Grellelaan 10,2022-10-07,06:00:00,46,23,23,FMN 05 Gerard Le Grellelaan
653,Gerard le Grellelaan 10,2022-10-07,07:00:00,124,89,35,FMN 05 Gerard Le Grellelaan
653,Gerard le Grellelaan 10,2022-10-07,08:00:00,258,197,61,FMN 05 Gerard Le Grellelaan
653,Gerard le Grellelaan 10,2022-10-07,09:00:00,91,76,15,FMN 05 Gerard Le Grellelaan
653,Gerard le Grellelaan 10,2022-10-07,10:00:00,63,50,13,FMN 05 Gerard Le Grellelaan
653,Gerard le Grellelaan 10,2022-10-07,11:00:00,63,58,5,FMN 05 Gerard Le Grellelaan
653,Gerard le Grellelaan 10,2022-10-07,12:00:00,128,101,27,FMN 05 Gerard Le Grellelaan
653,Gerard le Grellelaan 10,2022-10-07,13:00:00,108,86,22,FMN 05 Gerard Le Grellelaan
653,Gerard le Grellelaan 10,2022-10-07,14:00:00,126,106,20,FMN 05 Gerard Le Grellelaan
653,Gerard le Grellelaan 10,2022-10-07,15:00:00,190,145,45,FMN 05 Gerard Le Grellelaan
653,Gerard le Grellelaan 10,2022-10-07,16:00:00,214,182,32,FMN 05 Gerard Le Grellelaan
653,Gerard le Grellelaan 10,2022-10-07,17:00:00,215,177,38,FMN 05 Gerard Le Grellelaan
653,Gerard le Grellelaan 10,2022-10-07,18:00:00,180,148,32,FMN 05 Gerard Le Grellelaan
653,Gerard le Grellelaan 10,2022-10-07,19:00:00,96,78,18,FMN 05 Gerard Le Grellelaan
653,Gerard le Grellelaan 10,2022-10-07,20:00:00,88,65,23,FMN 05 Gerard Le Grellelaan
653,Gerard le Grellelaan 10,2022-10-07,21:00:00,32,27,5,FMN 05 Gerard Le Grellelaan
653,Gerard le Grellelaan 10,2022-10-07,22:00:00,50,40,10,FMN 05 Gerard Le Grellelaan
653,Gerard le Grellelaan 10,2022-10-07,23:00:00,25,16,9,FMN 05 Gerard Le Grellelaan
653,Gerard le Grellelaan 10,2022-10-08,00:00:00,22,12,10,FMN 05 Gerard Le Grellelaan
653,Gerard le Grellelaan 10,2022-10-08,01:00:00,14,8,6,FMN 05 Gerard Le Grellelaan
653,Gerard le Grellelaan 10,2022-10-08,02:00:00,3,2,1,FMN 05 Gerard Le Grellelaan
653,Gerard le Grellelaan 10,2022-10-08,03:00:00,6,2,4,FMN 05 Gerard Le Grellelaan
653,Gerard le Grellelaan 10,2022-10-08,04:00:00,5,4,1,FMN 05 Gerard Le Grellelaan
653,Gerard le Grellelaan 10,2022-10-08,05:00:00,4,2,2,FMN 05 Gerard Le Grellelaan
653,Gerard le Grellelaan 10,2022-10-08,06:00:00,11,7,4,FMN 05 Gerard Le Grellelaan
653,Gerard le Grellelaan 10,2022-10-08,07:00:00,20,14,6,FMN 05 Gerard Le Grellelaan
653,Gerard le Grellelaan 10,2022-10-08,08:00:00,35,23,12,FMN 05 Gerard Le Grellelaan
653,Gerard le Grellelaan 10,2022-10-08,09:00:00,55,39,16,FMN 05 Gerard Le Grellelaan
653,Gerard le Grellelaan 10,2022-10-08,10:00:00,59,48,11,FMN 05 Gerard Le Grellelaan
653,Gerard le Grellelaan 10,2022-10-08,11:00:00,96,78,18,FMN 05 Gerard Le Grellelaan
653,Gerard le Grellelaan 10,2022-10-08,12:00:00,81,69,12,FMN 05 Gerard Le Grellelaan
653,Gerard le Grellelaan 10,2022-10-08,13:00:00,85,71,14,FMN 05 Gerard Le Grellelaan
653,Gerard le Grellelaan 10,2022-10-08,14:00:00,98,80,18,FMN 05 Gerard Le Grellelaan
653,Gerard le Grellelaan 10,2022-10-08,15:00:00,94,81,13,FMN 05 Gerard Le Grellelaan
653,Gerard le Grellelaan 10,2022-10-08,16:00:00,96,75,21,FMN 05 Gerard Le Grellelaan
653,Gerard le Grellelaan 10,2022-10-08,17:00:00,106,100,6,FMN 05 Gerard Le Grellelaan
653,Gerard le Grellelaan 10,2022-10-08,18:00:00,95,77,18,FMN 05 Gerard Le Grellelaan
653,Gerard le Grellelaan 10,2022-10-08,19:00:00,53,46,7,FMN 05 Gerard Le Grellelaan
653,Gerard le Grellelaan 10,2022-10-08,20:00:00,36,27,9,FMN 05 Gerard Le Grellelaan
653,Gerard le Grellelaan 10,2022-10-08,21:00:00,30,23,7,FMN 05 Gerard Le Grellelaan
653,Gerard le Grellelaan 10,2022-10-08,22:00:00,20,17,3,FMN 05 Gerard Le Grellelaan
653,Gerard le Grellelaan 10,2022-10-08,23:00:00,24,16,8,FMN 05 Gerard Le Grellelaan
653,Gerard le Grellelaan 10,2022-10-09,00:00:00,18,16,2,FMN 05 Gerard Le Grellelaan
653,Gerard le Grellelaan 10,2022-10-09,01:00:00,7,6,1,FMN 05 Gerard Le Grellelaan
653,Gerard le Grellelaan 10,2022-10-09,02:00:00,9,6,3,FMN 05 Gerard Le Grellelaan
653,Gerard le Grellelaan 10,2022-10-09,03:00:00,10,9,1,FMN 05 Gerard Le Grellelaan
653,Gerard le Grellelaan 10,2022-10-09,04:00:00,4,2,2,FMN 05 Gerard Le Grellelaan
653,Gerard le Grellelaan 10,2022-10-09,05:00:00,3,1,2,FMN 05 Gerard Le Grellelaan
653,Gerard le Grellelaan 10,2022-10-09,06:00:00,10,7,3,FMN 05 Gerard Le Grellelaan
653,Gerard le Grellelaan 10,2022-10-09,07:00:00,14,9,5,FMN 05 Gerard Le Grellelaan
653,Gerard le Grellelaan 10,2022-10-09,08:00:00,18,16,2,FMN 05 Gerard Le Grellelaan
653,Gerard le Grellelaan 10,2022-10-09,09:00:00,48,42,6,FMN 05 Gerard Le Grellelaan
653,Gerard le Grellelaan 10,2022-10-09,10:00:00,72,53,19,FMN 05 Gerard Le Grellelaan
653,Gerard le Grellelaan 10,2022-10-09,11:00:00,82,58,24,FMN 05 Gerard Le Grellelaan
653,Gerard le Grellelaan 10,2022-10-09,12:00:00,108,92,16,FMN 05 Gerard Le Grellelaan
653,Gerard le Grellelaan 10,2022-10-09,13:00:00,109,90,19,FMN 05 Gerard Le Grellelaan
653,Gerard le Grellelaan 10,2022-10-09,14:00:00,123,105,18,FMN 05 Gerard Le Grellelaan
653,Gerard le Grellelaan 10,2022-10-09,15:00:00,95,66,29,FMN 05 Gerard Le Grellelaan
653,Gerard le Grellelaan 10,2022-10-09,16:00:00,158,136,22,FMN 05 Gerard Le Grellelaan
653,Gerard le Grellelaan 10,2022-10-09,17:00:00,129,109,20,FMN 05 Gerard Le Grellelaan
653,Gerard le Grellelaan 10,2022-10-09,18:00:00,68,60,8,FMN 05 Gerard Le Grellelaan
653,Gerard le Grellelaan 10,2022-10-09,19:00:00,47,33,14,FMN 05 Gerard Le Grellelaan
653,Gerard le Grellelaan 10,2022-10-09,20:00:00,31,22,9,FMN 05 Gerard Le Grellelaan
653,Gerard le Grellelaan 10,2022-10-09,21:00:00,19,14,5,FMN 05 Gerard Le Grellelaan
653,Gerard le Grellelaan 10,2022-10-09,22:00:00,23,22,1,FMN 05 Gerard Le Grellelaan
653,Gerard le Grellelaan 10,2022-10-09,23:00:00,15,10,5,FMN 05 Gerard Le Grellelaan
653,Gerard le Grellelaan 10,2022-10-10,00:00:00,5,2,3,FMN 05 Gerard Le Grellelaan
653,Gerard le Grellelaan 10,2022-10-10,01:00:00,2,1,1,FMN 05 Gerard Le Grellelaan
653,Gerard le Grellelaan 10,2022-10-10,02:00:00,5,3,2,FMN 05 Gerard Le Grellelaan
653,Gerard le Grellelaan 10,2022-10-10,03:00:00,1,1,0,FMN 05 Gerard Le Grellelaan
653,Gerard le Grellelaan 10,2022-10-10,04:00:00,8,4,4,FMN 05 Gerard Le Grellelaan
653,Gerard le Grellelaan 10,2022-10-10,05:00:00,24,11,13,FMN 05 Gerard Le Grellelaan
653,Gerard le Grellelaan 10,2022-10-10,06:00:00,47,25,22,FMN 05 Gerard Le Grellelaan
653,Gerard le Grellelaan 10,2022-10-10,07:00:00,117,89,28,FMN 05 Gerard Le Grellelaan
653,Gerard le Grellelaan 10,2022-10-10,08:00:00,301,240,61,FMN 05 Gerard Le Grellelaan
653,Gerard le Grellelaan 10,2022-10-10,09:00:00,97,84,13,FMN 05 Gerard Le Grellelaan
653,Gerard le Grellelaan 10,2022-10-10,10:00:00,59,51,8,FMN 05 Gerard Le Grellelaan
653,Gerard le Grellelaan 10,2022-10-10,11:00:00,55,47,8,FMN 05 Gerard Le Grellelaan
653,Gerard le Grellelaan 10,2022-10-10,12:00:00,116,98,18,FMN 05 Gerard Le Grellelaan
653,Gerard le Grellelaan 10,2022-10-10,13:00:00,99,82,17,FMN 05 Gerard Le Grellelaan
653,Gerard le Grellelaan 10,2022-10-10,14:00:00,90,62,28,FMN 05 Gerard Le Grellelaan
653,Gerard le Grellelaan 10,2022-10-10,15:00:00,150,125,25,FMN 05 Gerard Le Grellelaan
653,Gerard le Grellelaan 10,2022-10-10,16:00:00,208,156,52,FMN 05 Gerard Le Grellelaan
653,Gerard le Grellelaan 10,2022-10-10,17:00:00,184,146,38,FMN 05 Gerard Le Grellelaan
653,Gerard le Grellelaan 10,2022-10-10,18:00:00,147,115,32,FMN 05 Gerard Le Grellelaan
653,Gerard le Grellelaan 10,2022-10-10,19:00:00,58,45,13,FMN 05 Gerard Le Grellelaan
653,Gerard le Grellelaan 10,2022-10-10,20:00:00,45,32,13,FMN 05 Gerard Le Grellelaan
653,Gerard le Grellelaan 10,2022-10-10,21:00:00,44,30,14,FMN 05 Gerard Le Grellelaan
653,Gerard le Grellelaan 10,2022-10-10,22:00:00,52,45,7,FMN 05 Gerard Le Grellelaan
653,Gerard le Grellelaan 10,2022-10-10,23:00:00,31,25,6,FMN 05 Gerard Le Grellelaan
653,Gerard le Grellelaan 10,2022-10-11,00:00:00,3,3,0,FMN 05 Gerard Le Grellelaan
653,Gerard le Grellelaan 10,2022-10-11,01:00:00,3,2,1,FMN 05 Gerard Le Grellelaan
653,Gerard le Grellelaan 10,2022-10-11,02:00:00,3,2,1,FMN 05 Gerard Le Grellelaan
653,Gerard le Grellelaan 10,2022-10-11,03:00:00,1,0,1,FMN 05 Gerard Le Grellelaan
653,Gerard le Grellelaan 10,2022-10-11,04:00:00,4,2,2,FMN 05 Gerard Le Grellelaan
653,Gerard le Grellelaan 10,2022-10-11,05:00:00,22,7,15,FMN 05 Gerard Le Grellelaan
653,Gerard le Grellelaan 10,2022-10-11,06:00:00,51,26,25,FMN 05 Gerard Le Grellelaan
653,Gerard le Grellelaan 10,2022-10-11,07:00:00,152,112,40,FMN 05 Gerard Le Grellelaan
653,Gerard le Grellelaan 10,2022-10-11,08:00:00,329,269,60,FMN 05 Gerard Le Grellelaan
653,Gerard le Grellelaan 10,2022-10-11,09:00:00,109,95,14,FMN 05 Gerard Le Grellelaan
653,Gerard le Grellelaan 10,2022-10-11,10:00:00,76,66,10,FMN 05 Gerard Le Grellelaan
653,Gerard le Grellelaan 10,2022-10-11,11:00:00,67,56,11,FMN 05 Gerard Le Grellelaan
653,Gerard le Grellelaan 10,2022-10-11,12:00:00,110,79,31,FMN 05 Gerard Le Grellelaan
653,Gerard le Grellelaan 10,2022-10-11,13:00:00,116,86,30,FMN 05 Gerard Le Grellelaan
653,Gerard le Grellelaan 10,2022-10-11,14:00:00,101,80,21,FMN 05 Gerard Le Grellelaan
653,Gerard le Grellelaan 10,2022-10-11,15:00:00,170,130,40,FMN 05 Gerard Le Grellelaan
653,Gerard le Grellelaan 10,2022-10-11,16:00:00,208,170,38,FMN 05 Gerard Le Grellelaan
653,Gerard le Grellelaan 10,2022-10-11,17:00:00,266,209,57,FMN 05 Gerard Le Grellelaan
653,Gerard le Grellelaan 10,2022-10-11,18:00:00,171,134,37,FMN 05 Gerard Le Grellelaan
653,Gerard le Grellelaan 10,2022-10-11,19:00:00,92,75,17,FMN 05 Gerard Le Grellelaan
653,Gerard le Grellelaan 10,2022-10-11,20:00:00,62,50,12,FMN 05 Gerard Le Grellelaan
653,Gerard le Grellelaan 10,2022-10-11,21:00:00,37,27,10,FMN 05 Gerard Le Grellelaan
653,Gerard le Grellelaan 10,2022-10-11,22:00:00,43,36,7,FMN 05 Gerard Le Grellelaan
653,Gerard le Grellelaan 10,2022-10-11,23:00:00,25,20,5,FMN 05 Gerard Le Grellelaan
653,Gerard le Grellelaan 10,2022-10-12,00:00:00,6,5,1,FMN 05 Gerard Le Grellelaan
653,Gerard le Grellelaan 10,2022-10-12,01:00:00,3,1,2,FMN 05 Gerard Le Grellelaan
653,Gerard le Grellelaan 10,2022-10-12,02:00:00,4,3,1,FMN 05 Gerard Le Grellelaan
653,Gerard le Grellelaan 10,2022-10-12,03:00:00,2,1,1,FMN 05 Gerard Le Grellelaan
653,Gerard le Grellelaan 10,2022-10-12,04:00:00,3,2,1,FMN 05 Gerard Le Grellelaan
653,Gerard le Grellelaan 10,2022-10-12,05:00:00,22,8,14,FMN 05 Gerard Le Grellelaan
653,Gerard le Grellelaan 10,2022-10-12,06:00:00,47,23,24,FMN 05 Gerard Le Grellelaan
653,Gerard le Grellelaan 10,2022-10-12,07:00:00,135,97,38,FMN 05 Gerard Le Grellelaan
653,Gerard le Grellelaan 10,2022-10-12,08:00:00,263,209,54,FMN 05 Gerard Le Grellelaan
653,Gerard le Grellelaan 10,2022-10-12,09:00:00,101,88,13,FMN 05 Gerard Le Grellelaan
653,Gerard le Grellelaan 10,2022-10-12,10:00:00,68,57,11,FMN 05 Gerard Le Grellelaan
653,Gerard le Grellelaan 10,2022-10-12,11:00:00,63,53,10,FMN 05 Gerard Le Grellelaan
653,Gerard le Grellelaan 10,2022-10-12,12:00:00,184,140,44,FMN 05 Gerard Le Grellelaan
653,Gerard le Grellelaan 10,2022-10-12,13:00:00,106,83,23,FMN 05 Gerard Le Grellelaan
653,Gerard le Grellelaan 10,2022-10-12,14:00:00,87,63,24,FMN 05 Gerard Le Grellelaan
653,Gerard le Grellelaan 10,2022-10-12,15:00:00,159,133,26,FMN 05 Gerard Le Grellelaan
653,Gerard le Grellelaan 10,2022-10-12,16:00:00,191,148,43,FMN 05 Gerard Le Grellelaan
653,Gerard le Grellelaan 10,2022-10-12,17:00:00,251,211,40,FMN 05 Gerard Le Grellelaan
653,Gerard le Grellelaan 10,2022-10-12,18:00:00,172,147,25,FMN 05 Gerard Le Grellelaan
653,Gerard le Grellelaan 10,2022-10-12,19:00:00,86,67,19,FMN 05 Gerard Le Grellelaan
653,Gerard le Grellelaan 10,2022-10-12,20:00:00,46,35,11,FMN 05 Gerard Le Grellelaan
653,Gerard le Grellelaan 10,2022-10-12,21:00:00,35,26,9,FMN 05 Gerard Le Grellelaan
653,Gerard le Grellelaan 10,2022-10-12,22:00:00,47,38,9,FMN 05 Gerard Le Grellelaan
653,Gerard le Grellelaan 10,2022-10-12,23:00:00,23,19,4,FMN 05 Gerard Le Grellelaan
653,Gerard le Grellelaan 10,2022-10-13,00:00:00,6,6,0,FMN 05 Gerard Le Grellelaan
653,Gerard le Grellelaan 10,2022-10-13,01:00:00,9,4,5,FMN 05 Gerard Le Grellelaan
653,Gerard le Grellelaan 10,2022-10-13,02:00:00,2,2,0,FMN 05 Gerard Le Grellelaan
653,Gerard le Grellelaan 10,2022-10-13,03:00:00,3,3,0,FMN 05 Gerard Le Grellelaan
653,Gerard le Grellelaan 10,2022-10-13,04:00:00,6,2,4,FMN 05 Gerard Le Grellelaan
653,Gerard le Grellelaan 10,2022-10-13,05:00:00,26,10,16,FMN 05 Gerard Le Grellelaan
653,Gerard le Grellelaan 10,2022-10-13,06:00:00,49,25,24,FMN 05 Gerard Le Grellelaan
653,Gerard le Grellelaan 10,2022-10-13,07:00:00,145,105,40,FMN 05 Gerard Le Grellelaan
653,Gerard le Grellelaan 10,2022-10-13,08:00:00,328,263,65,FMN 05 Gerard Le Grellelaan
653,Gerard le Grellelaan 10,2022-10-13,09:00:00,121,96,25,FMN 05 Gerard Le Grellelaan
653,Gerard le Grellelaan 10,2022-10-13,10:00:00,72,62,10,FMN 05 Gerard Le Grellelaan
653,Gerard le Grellelaan 10,2022-10-13,11:00:00,52,44,8,FMN 05 Gerard Le Grellelaan
653,Gerard le Grellelaan 10,2022-10-13,12:00:00,87,73,14,FMN 05 Gerard Le Grellelaan
653,Gerard le Grellelaan 10,2022-10-13,13:00:00,94,68,26,FMN 05 Gerard Le Grellelaan
653,Gerard le Grellelaan 10,2022-10-13,14:00:00,76,63,13,FMN 05 Gerard Le Grellelaan
653,Gerard le Grellelaan 10,2022-10-13,15:00:00,147,125,22,FMN 05 Gerard Le Grellelaan
653,Gerard le Grellelaan 10,2022-10-13,16:00:00,173,125,48,FMN 05 Gerard Le Grellelaan
653,Gerard le Grellelaan 10,2022-10-13,17:00:00,202,158,44,FMN 05 Gerard Le Grellelaan
653,Gerard le Grellelaan 10,2022-10-13,18:00:00,153,130,23,FMN 05 Gerard Le Grellelaan
653,Gerard le Grellelaan 10,2022-10-13,19:00:00,72,53,19,FMN 05 Gerard Le Grellelaan
653,Gerard le Grellelaan 10,2022-10-13,20:00:00,45,37,8,FMN 05 Gerard Le Grellelaan
653,Gerard le Grellelaan 10,2022-10-13,21:00:00,35,25,10,FMN 05 Gerard Le Grellelaan
653,Gerard le Grellelaan 10,2022-10-13,22:00:00,48,36,12,FMN 05 Gerard Le Grellelaan
653,Gerard le Grellelaan 10,2022-10-13,23:00:00,18,15,3,FMN 05 Gerard Le Grellelaan
653,Gerard le Grellelaan 10,2022-10-14,00:00:00,6,5,1,FMN 05 Gerard Le Grellelaan
653,Gerard le Grellelaan 10,2022-10-14,01:00:00,1,1,0,FMN 05 Gerard Le Grellelaan
653,Gerard le Grellelaan 10,2022-10-14,02:00:00,7,5,2,FMN 05 Gerard Le Grellelaan
653,Gerard le Grellelaan 10,2022-10-14,03:00:00,3,3,0,FMN 05 Gerard Le Grellelaan
653,Gerard le Grellelaan 10,2022-10-14,04:00:00,6,3,3,FMN 05 Gerard Le Grellelaan
653,Gerard le Grellelaan 10,2022-10-14,05:00:00,22,6,16,FMN 05 Gerard Le Grellelaan
653,Gerard le Grellelaan 10,2022-10-14,06:00:00,41,21,20,FMN 05 Gerard Le Grellelaan
653,Gerard le Grellelaan 10,2022-10-14,07:00:00,125,88,37,FMN 05 Gerard Le Grellelaan
653,Gerard le Grellelaan 10,2022-10-14,08:00:00,258,203,55,FMN 05 Gerard Le Grellelaan
653,Gerard le Grellelaan 10,2022-10-14,09:00:00,65,54,11,FMN 05 Gerard Le Grellelaan
653,Gerard le Grellelaan 10,2022-10-14,10:00:00,52,41,11,FMN 05 Gerard Le Grellelaan
653,Gerard le Grellelaan 10,2022-10-14,11:00:00,85,69,16,FMN 05 Gerard Le Grellelaan
653,Gerard le Grellelaan 10,2022-10-14,12:00:00,91,74,17,FMN 05 Gerard Le Grellelaan
653,Gerard le Grellelaan 10,2022-10-14,13:00:00,82,63,19,FMN 05 Gerard Le Grellelaan
653,Gerard le Grellelaan 10,2022-10-14,14:00:00,66,56,10,FMN 05 Gerard Le Grellelaan
653,Gerard le Grellelaan 10,2022-10-14,15:00:00,147,121,26,FMN 05 Gerard Le Grellelaan
653,Gerard le Grellelaan 10,2022-10-14,16:00:00,161,129,32,FMN 05 Gerard Le Grellelaan
653,Gerard le Grellelaan 10,2022-10-14,17:00:00,171,140,31,FMN 05 Gerard Le Grellelaan
653,Gerard le Grellelaan 10,2022-10-14,18:00:00,134,104,30,FMN 05 Gerard Le Grellelaan
653,Gerard le Grellelaan 10,2022-10-14,19:00:00,102,85,17,FMN 05 Gerard Le Grellelaan
653,Gerard le Grellelaan 10,2022-10-14,20:00:00,65,53,12,FMN 05 Gerard Le Grellelaan
653,Gerard le Grellelaan 10,2022-10-14,21:00:00,42,34,8,FMN 05 Gerard Le Grellelaan
653,Gerard le Grellelaan 10,2022-10-14,22:00:00,35,28,7,FMN 05 Gerard Le Grellelaan
653,Gerard le Grellelaan 10,2022-10-14,23:00:00,23,21,2,FMN 05 Gerard Le Grellelaan
653,Gerard le Grellelaan 10,2022-10-15,00:00:00,27,23,4,FMN 05 Gerard Le Grellelaan
653,Gerard le Grellelaan 10,2022-10-15,01:00:00,8,6,2,FMN 05 Gerard Le Grellelaan
653,Gerard le Grellelaan 10,2022-10-15,02:00:00,8,5,3,FMN 05 Gerard Le Grellelaan
653,Gerard le Grellelaan 10,2022-10-15,03:00:00,3,3,0,FMN 05 Gerard Le Grellelaan
653,Gerard le Grellelaan 10,2022-10-15,04:00:00,5,1,4,FMN 05 Gerard Le Grellelaan
653,Gerard le Grellelaan 10,2022-10-15,05:00:00,8,4,4,FMN 05 Gerard Le Grellelaan
653,Gerard le Grellelaan 10,2022-10-15,06:00:00,20,12,8,FMN 05 Gerard Le Grellelaan
653,Gerard le Grellelaan 10,2022-10-15,07:00:00,14,9,5,FMN 05 Gerard Le Grellelaan
653,Gerard le Grellelaan 10,2022-10-15,08:00:00,25,18,7,FMN 05 Gerard Le Grellelaan
653,Gerard le Grellelaan 10,2022-10-15,09:00:00,59,41,18,FMN 05 Gerard Le Grellelaan
653,Gerard le Grellelaan 10,2022-10-15,10:00:00,44,34,10,FMN 05 Gerard Le Grellelaan
653,Gerard le Grellelaan 10,2022-10-15,11:00:00,60,49,11,FMN 05 Gerard Le Grellelaan
653,Gerard le Grellelaan 10,2022-10-15,12:00:00,75,70,5,FMN 05 Gerard Le Grellelaan
653,Gerard le Grellelaan 10,2022-10-15,13:00:00,68,54,14,FMN 05 Gerard Le Grellelaan
653,Gerard le Grellelaan 10,2022-10-15,14:00:00,74,70,4,FMN 05 Gerard Le Grellelaan
653,Gerard le Grellelaan 10,2022-10-15,15:00:00,83,70,13,FMN 05 Gerard Le Grellelaan
653,Gerard le Grellelaan 10,2022-10-15,16:00:00,73,56,17,FMN 05 Gerard Le Grellelaan
653,Gerard le Grellelaan 10,2022-10-15,17:00:00,120,98,22,FMN 05 Gerard Le Grellelaan
653,Gerard le Grellelaan 10,2022-10-15,18:00:00,94,75,19,FMN 05 Gerard Le Grellelaan
653,Gerard le Grellelaan 10,2022-10-15,19:00:00,73,57,16,FMN 05 Gerard Le Grellelaan
653,Gerard le Grellelaan 10,2022-10-15,20:00:00,42,36,6,FMN 05 Gerard Le Grellelaan
653,Gerard le Grellelaan 10,2022-10-15,21:00:00,29,20,9,FMN 05 Gerard Le Grellelaan
653,Gerard le Grellelaan 10,2022-10-15,22:00:00,26,21,5,FMN 05 Gerard Le Grellelaan
653,Gerard le Grellelaan 10,2022-10-15,23:00:00,26,15,11,FMN 05 Gerard Le Grellelaan
653,Gerard le Grellelaan 10,2022-10-16,00:00:00,9,8,1,FMN 05 Gerard Le Grellelaan
653,Gerard le Grellelaan 10,2022-10-16,01:00:00,7,5,2,FMN 05 Gerard Le Grellelaan
653,Gerard le Grellelaan 10,2022-10-16,02:00:00,9,6,3,FMN 05 Gerard Le Grellelaan
653,Gerard le Grellelaan 10,2022-10-16,03:00:00,2,2,0,FMN 05 Gerard Le Grellelaan
653,Gerard le Grellelaan 10,2022-10-16,04:00:00,2,1,1,FMN 05 Gerard Le Grellelaan
653,Gerard le Grellelaan 10,2022-10-16,05:00:00,5,0,5,FMN 05 Gerard Le Grellelaan
653,Gerard le Grellelaan 10,2022-10-16,06:00:00,13,10,3,FMN 05 Gerard Le Grellelaan
653,Gerard le Grellelaan 10,2022-10-16,07:00:00,13,10,3,FMN 05 Gerard Le Grellelaan
653,Gerard le Grellelaan 10,2022-10-16,08:00:00,13,10,3,FMN 05 Gerard Le Grellelaan
653,Gerard le Grellelaan 10,2022-10-16,09:00:00,54,45,9,FMN 05 Gerard Le Grellelaan
653,Gerard le Grellelaan 10,2022-10-16,10:00:00,67,56,11,FMN 05 Gerard Le Grellelaan
653,Gerard le Grellelaan 10,2022-10-16,11:00:00,82,66,16,FMN 05 Gerard Le Grellelaan
653,Gerard le Grellelaan 10,2022-10-16,12:00:00,116,98,18,FMN 05 Gerard Le Grellelaan
653,Gerard le Grellelaan 10,2022-10-16,13:00:00,99,73,26,FMN 05 Gerard Le Grellelaan
653,Gerard le Grellelaan 10,2022-10-16,14:00:00,114,98,16,FMN 05 Gerard Le Grellelaan
653,Gerard le Grellelaan 10,2022-10-16,15:00:00,132,105,27,FMN 05 Gerard Le Grellelaan
653,Gerard le Grellelaan 10,2022-10-16,16:00:00,118,104,14,FMN 05 Gerard Le Grellelaan
653,Gerard le Grellelaan 10,2022-10-16,17:00:00,121,107,14,FMN 05 Gerard Le Grellelaan
653,Gerard le Grellelaan 10,2022-10-16,18:00:00,92,78,14,FMN 05 Gerard Le Grellelaan
653,Gerard le Grellelaan 10,2022-10-16,19:00:00,36,27,9,FMN 05 Gerard Le Grellelaan
653,Gerard le Grellelaan 10,2022-10-16,20:00:00,23,17,6,FMN 05 Gerard Le Grellelaan
653,Gerard le Grellelaan 10,2022-10-16,21:00:00,15,13,2,FMN 05 Gerard Le Grellelaan
653,Gerard le Grellelaan 10,2022-10-16,22:00:00,27,25,2,FMN 05 Gerard Le Grellelaan
653,Gerard le Grellelaan 10,2022-10-16,23:00:00,14,11,3,FMN 05 Gerard Le Grellelaan
653,Gerard le Grellelaan 10,2022-10-17,00:00:00,3,3,0,FMN 05 Gerard Le Grellelaan
653,Gerard le Grellelaan 10,2022-10-17,01:00:00,1,1,0,FMN 05 Gerard Le Grellelaan
653,Gerard le Grellelaan 10,2022-10-17,02:00:00,3,2,1,FMN 05 Gerard Le Grellelaan
653,Gerard le Grellelaan 10,2022-10-17,03:00:00,1,0,1,FMN 05 Gerard Le Grellelaan
653,Gerard le Grellelaan 10,2022-10-17,04:00:00,7,2,5,FMN 05 Gerard Le Grellelaan
653,Gerard le Grellelaan 10,2022-10-17,05:00:00,29,10,19,FMN 05 Gerard Le Grellelaan
653,Gerard le Grellelaan 10,2022-10-17,06:00:00,53,28,25,FMN 05 Gerard Le Grellelaan
653,Gerard le Grellelaan 10,2022-10-17,07:00:00,155,114,41,FMN 05 Gerard Le Grellelaan
653,Gerard le Grellelaan 10,2022-10-17,08:00:00,284,217,67,FMN 05 Gerard Le Grellelaan
653,Gerard le Grellelaan 10,2022-10-17,09:00:00,47,40,7,FMN 05 Gerard Le Grellelaan
653,Gerard le Grellelaan 10,2022-10-17,10:00:00,35,32,3,FMN 05 Gerard Le Grellelaan
653,Gerard le Grellelaan 10,2022-10-17,11:00:00,40,36,4,FMN 05 Gerard Le Grellelaan
653,Gerard le Grellelaan 10,2022-10-17,12:00:00,65,54,11,FMN 05 Gerard Le Grellelaan
653,Gerard le Grellelaan 10,2022-10-17,13:00:00,74,58,16,FMN 05 Gerard Le Grellelaan
653,Gerard le Grellelaan 10,2022-10-17,14:00:00,81,62,19,FMN 05 Gerard Le Grellelaan
653,Gerard le Grellelaan 10,2022-10-17,15:00:00,133,108,25,FMN 05 Gerard Le Grellelaan
653,Gerard le Grellelaan 10,2022-10-17,16:00:00,189,153,36,FMN 05 Gerard Le Grellelaan
653,Gerard le Grellelaan 10,2022-10-17,17:00:00,211,169,42,FMN 05 Gerard Le Grellelaan
653,Gerard le Grellelaan 10,2022-10-17,18:00:00,157,135,22,FMN 05 Gerard Le Grellelaan
653,Gerard le Grellelaan 10,2022-10-17,19:00:00,77,58,19,FMN 05 Gerard Le Grellelaan
653,Gerard le Grellelaan 10,2022-10-17,20:00:00,39,33,6,FMN 05 Gerard Le Grellelaan
653,Gerard le Grellelaan 10,2022-10-17,21:00:00,45,34,11,FMN 05 Gerard Le Grellelaan
653,Gerard le Grellelaan 10,2022-10-17,22:00:00,41,33,8,FMN 05 Gerard Le Grellelaan
653,Gerard le Grellelaan 10,2022-10-17,23:00:00,15,12,3,FMN 05 Gerard Le Grellelaan
653,Gerard le Grellelaan 10,2022-10-18,00:00:00,8,7,1,FMN 05 Gerard Le Grellelaan
653,Gerard le Grellelaan 10,2022-10-18,01:00:00,0,0,0,FMN 05 Gerard Le Grellelaan
653,Gerard le Grellelaan 10,2022-10-18,02:00:00,4,3,1,FMN 05 Gerard Le Grellelaan
653,Gerard le Grellelaan 10,2022-10-18,03:00:00,1,0,1,FMN 05 Gerard Le Grellelaan
653,Gerard le Grellelaan 10,2022-10-18,04:00:00,7,2,5,FMN 05 Gerard Le Grellelaan
653,Gerard le Grellelaan 10,2022-10-18,05:00:00,27,8,19,FMN 05 Gerard Le Grellelaan
653,Gerard le Grellelaan 10,2022-10-18,06:00:00,51,27,24,FMN 05 Gerard Le Grellelaan
653,Gerard le Grellelaan 10,2022-10-18,07:00:00,170,115,55,FMN 05 Gerard Le Grellelaan
653,Gerard le Grellelaan 10,2022-10-18,08:00:00,359,298,61,FMN 05 Gerard Le Grellelaan
653,Gerard le Grellelaan 10,2022-10-18,09:00:00,109,91,18,FMN 05 Gerard Le Grellelaan
653,Gerard le Grellelaan 10,2022-10-18,10:00:00,79,63,16,FMN 05 Gerard Le Grellelaan
653,Gerard le Grellelaan 10,2022-10-18,11:00:00,102,89,13,FMN 05 Gerard Le Grellelaan
653,Gerard le Grellelaan 10,2022-10-18,12:00:00,109,81,28,FMN 05 Gerard Le Grellelaan
653,Gerard le Grellelaan 10,2022-10-18,13:00:00,137,110,27,FMN 05 Gerard Le Grellelaan
653,Gerard le Grellelaan 10,2022-10-18,14:00:00,118,95,23,FMN 05 Gerard Le Grellelaan
653,Gerard le Grellelaan 10,2022-10-18,15:00:00,201,169,32,FMN 05 Gerard Le Grellelaan
653,Gerard le Grellelaan 10,2022-10-18,16:00:00,234,191,43,FMN 05 Gerard Le Grellelaan
653,Gerard le Grellelaan 10,2022-10-18,17:00:00,290,235,55,FMN 05 Gerard Le Grellelaan
653,Gerard le Grellelaan 10,2022-10-18,18:00:00,177,138,39,FMN 05 Gerard Le Grellelaan
653,Gerard le Grellelaan 10,2022-10-18,19:00:00,80,66,14,FMN 05 Gerard Le Grellelaan
653,Gerard le Grellelaan 10,2022-10-18,20:00:00,64,58,6,FMN 05 Gerard Le Grellelaan
653,Gerard le Grellelaan 10,2022-10-18,21:00:00,59,46,13,FMN 05 Gerard Le Grellelaan
653,Gerard le Grellelaan 10,2022-10-18,22:00:00,56,45,11,FMN 05 Gerard Le Grellelaan
653,Gerard le Grellelaan 10,2022-10-18,23:00:00,28,22,6,FMN 05 Gerard Le Grellelaan
653,Gerard le Grellelaan 10,2022-10-19,00:00:00,10,8,2,FMN 05 Gerard Le Grellelaan
653,Gerard le Grellelaan 10,2022-10-19,01:00:00,2,1,1,FMN 05 Gerard Le Grellelaan
653,Gerard le Grellelaan 10,2022-10-19,02:00:00,2,1,1,FMN 05 Gerard Le Grellelaan
653,Gerard le Grellelaan 10,2022-10-19,03:00:00,1,1,0,FMN 05 Gerard Le Grellelaan
653,Gerard le Grellelaan 10,2022-10-19,04:00:00,8,3,5,FMN 05 Gerard Le Grellelaan
653,Gerard le Grellelaan 10,2022-10-19,05:00:00,29,10,19,FMN 05 Gerard Le Grellelaan
653,Gerard le Grellelaan 10,2022-10-19,06:00:00,54,27,27,FMN 05 Gerard Le Grellelaan
653,Gerard le Grellelaan 10,2022-10-19,07:00:00,148,106,42,FMN 05 Gerard Le Grellelaan
653,Gerard le Grellelaan 10,2022-10-19,08:00:00,280,224,56,FMN 05 Gerard Le Grellelaan
653,Gerard le Grellelaan 10,2022-10-19,09:00:00,86,71,15,FMN 05 Gerard Le Grellelaan
653,Gerard le Grellelaan 10,2022-10-19,10:00:00,81,66,15,FMN 05 Gerard Le Grellelaan
653,Gerard le Grellelaan 10,2022-10-19,11:00:00,67,61,6,FMN 05 Gerard Le Grellelaan
653,Gerard le Grellelaan 10,2022-10-19,12:00:00,191,151,40,FMN 05 Gerard Le Grellelaan
653,Gerard le Grellelaan 10,2022-10-19,13:00:00,144,115,29,FMN 05 Gerard Le Grellelaan
653,Gerard le Grellelaan 10,2022-10-19,14:00:00,116,95,21,FMN 05 Gerard Le Grellelaan
653,Gerard le Grellelaan 10,2022-10-19,15:00:00,166,143,23,FMN 05 Gerard Le Grellelaan
653,Gerard le Grellelaan 10,2022-10-19,16:00:00,208,177,31,FMN 05 Gerard Le Grellelaan
653,Gerard le Grellelaan 10,2022-10-19,17:00:00,245,201,44,FMN 05 Gerard Le Grellelaan
653,Gerard le Grellelaan 10,2022-10-19,18:00:00,176,145,31,FMN 05 Gerard Le Grellelaan
653,Gerard le Grellelaan 10,2022-10-19,19:00:00,93,77,16,FMN 05 Gerard Le Grellelaan
653,Gerard le Grellelaan 10,2022-10-19,20:00:00,56,47,9,FMN 05 Gerard Le Grellelaan
653,Gerard le Grellelaan 10,2022-10-19,21:00:00,46,37,9,FMN 05 Gerard Le Grellelaan
653,Gerard le Grellelaan 10,2022-10-19,22:00:00,45,37,8,FMN 05 Gerard Le Grellelaan
653,Gerard le Grellelaan 10,2022-10-19,23:00:00,20,15,5,FMN 05 Gerard Le Grellelaan
653,Gerard le Grellelaan 10,2022-10-20,00:00:00,7,3,4,FMN 05 Gerard Le Grellelaan
653,Gerard le Grellelaan 10,2022-10-20,01:00:00,3,1,2,FMN 05 Gerard Le Grellelaan
653,Gerard le Grellelaan 10,2022-10-20,02:00:00,4,3,1,FMN 05 Gerard Le Grellelaan
653,Gerard le Grellelaan 10,2022-10-20,03:00:00,1,1,0,FMN 05 Gerard Le Grellelaan
653,Gerard le Grellelaan 10,2022-10-20,04:00:00,6,3,3,FMN 05 Gerard Le Grellelaan
653,Gerard le Grellelaan 10,2022-10-20,05:00:00,25,7,18,FMN 05 Gerard Le Grellelaan
653,Gerard le Grellelaan 10,2022-10-20,06:00:00,43,21,22,FMN 05 Gerard Le Grellelaan
653,Gerard le Grellelaan 10,2022-10-20,07:00:00,144,111,33,FMN 05 Gerard Le Grellelaan
653,Gerard le Grellelaan 10,2022-10-20,08:00:00,310,260,50,FMN 05 Gerard Le Grellelaan
653,Gerard le Grellelaan 10,2022-10-20,09:00:00,106,85,21,FMN 05 Gerard Le Grellelaan
653,Gerard le Grellelaan 10,2022-10-20,10:00:00,66,56,10,FMN 05 Gerard Le Grellelaan
653,Gerard le Grellelaan 10,2022-10-20,11:00:00,51,45,6,FMN 05 Gerard Le Grellelaan
653,Gerard le Grellelaan 10,2022-10-20,12:00:00,89,72,17,FMN 05 Gerard Le Grellelaan
653,Gerard le Grellelaan 10,2022-10-20,13:00:00,70,53,17,FMN 05 Gerard Le Grellelaan
653,Gerard le Grellelaan 10,2022-10-20,14:00:00,66,59,7,FMN 05 Gerard Le Grellelaan
653,Gerard le Grellelaan 10,2022-10-20,15:00:00,133,104,29,FMN 05 Gerard Le Grellelaan
653,Gerard le Grellelaan 10,2022-10-20,16:00:00,222,189,33,FMN 05 Gerard Le Grellelaan
653,Gerard le Grellelaan 10,2022-10-20,17:00:00,238,196,42,FMN 05 Gerard Le Grellelaan
653,Gerard le Grellelaan 10,2022-10-20,18:00:00,175,138,37,FMN 05 Gerard Le Grellelaan
653,Gerard le Grellelaan 10,2022-10-20,19:00:00,94,74,20,FMN 05 Gerard Le Grellelaan
653,Gerard le Grellelaan 10,2022-10-20,20:00:00,53,38,15,FMN 05 Gerard Le Grellelaan
653,Gerard le Grellelaan 10,2022-10-20,21:00:00,50,38,12,FMN 05 Gerard Le Grellelaan
653,Gerard le Grellelaan 10,2022-10-20,22:00:00,57,50,7,FMN 05 Gerard Le Grellelaan
653,Gerard le Grellelaan 10,2022-10-20,23:00:00,25,20,5,FMN 05 Gerard Le Grellelaan
653,Gerard le Grellelaan 10,2022-10-21,00:00:00,14,12,2,FMN 05 Gerard Le Grellelaan
653,Gerard le Grellelaan 10,2022-10-21,01:00:00,4,3,1,FMN 05 Gerard Le Grellelaan
653,Gerard le Grellelaan 10,2022-10-21,02:00:00,3,1,2,FMN 05 Gerard Le Grellelaan
653,Gerard le Grellelaan 10,2022-10-21,03:00:00,2,0,2,FMN 05 Gerard Le Grellelaan
653,Gerard le Grellelaan 10,2022-10-21,04:00:00,9,3,6,FMN 05 Gerard Le Grellelaan
653,Gerard le Grellelaan 10,2022-10-21,05:00:00,25,6,19,FMN 05 Gerard Le Grellelaan
653,Gerard le Grellelaan 10,2022-10-21,06:00:00,53,25,28,FMN 05 Gerard Le Grellelaan
653,Gerard le Grellelaan 10,2022-10-21,07:00:00,132,96,36,FMN 05 Gerard Le Grellelaan
653,Gerard le Grellelaan 10,2022-10-21,08:00:00,237,186,51,FMN 05 Gerard Le Grellelaan
653,Gerard le Grellelaan 10,2022-10-21,09:00:00,100,93,7,FMN 05 Gerard Le Grellelaan
653,Gerard le Grellelaan 10,2022-10-21,10:00:00,64,58,6,FMN 05 Gerard Le Grellelaan
653,Gerard le Grellelaan 10,2022-10-21,11:00:00,70,56,14,FMN 05 Gerard Le Grellelaan
653,Gerard le Grellelaan 10,2022-10-21,12:00:00,117,100,17,FMN 05 Gerard Le Grellelaan
653,Gerard le Grellelaan 10,2022-10-21,13:00:00,93,73,20,FMN 05 Gerard Le Grellelaan
653,Gerard le Grellelaan 10,2022-10-21,14:00:00,94,79,15,FMN 05 Gerard Le Grellelaan
653,Gerard le Grellelaan 10,2022-10-21,15:00:00,160,125,35,FMN 05 Gerard Le Grellelaan
653,Gerard le Grellelaan 10,2022-10-21,16:00:00,210,171,39,FMN 05 Gerard Le Grellelaan
653,Gerard le Grellelaan 10,2022-10-21,17:00:00,214,175,39,FMN 05 Gerard Le Grellelaan
653,Gerard le Grellelaan 10,2022-10-21,18:00:00,165,131,34,FMN 05 Gerard Le Grellelaan
653,Gerard le Grellelaan 10,2022-10-21,19:00:00,105,83,22,FMN 05 Gerard Le Grellelaan
653,Gerard le Grellelaan 10,2022-10-21,20:00:00,54,47,7,FMN 05 Gerard Le Grellelaan
653,Gerard le Grellelaan 10,2022-10-21,21:00:00,35,28,7,FMN 05 Gerard Le Grellelaan
653,Gerard le Grellelaan 10,2022-10-21,22:00:00,43,39,4,FMN 05 Gerard Le Grellelaan
653,Gerard le Grellelaan 10,2022-10-21,23:00:00,24,15,9,FMN 05 Gerard Le Grellelaan
653,Gerard le Grellelaan 10,2022-10-22,00:00:00,31,25,6,FMN 05 Gerard Le Grellelaan
653,Gerard le Grellelaan 10,2022-10-22,01:00:00,18,13,5,FMN 05 Gerard Le Grellelaan
653,Gerard le Grellelaan 10,2022-10-22,02:00:00,13,11,2,FMN 05 Gerard Le Grellelaan
653,Gerard le Grellelaan 10,2022-10-22,03:00:00,5,4,1,FMN 05 Gerard Le Grellelaan
653,Gerard le Grellelaan 10,2022-10-22,04:00:00,8,5,3,FMN 05 Gerard Le Grellelaan
653,Gerard le Grellelaan 10,2022-10-22,05:00:00,5,2,3,FMN 05 Gerard Le Grellelaan
653,Gerard le Grellelaan 10,2022-10-22,06:00:00,8,2,6,FMN 05 Gerard Le Grellelaan
653,Gerard le Grellelaan 10,2022-10-22,07:00:00,14,13,1,FMN 05 Gerard Le Grellelaan
653,Gerard le Grellelaan 10,2022-10-22,08:00:00,30,21,9,FMN 05 Gerard Le Grellelaan
653,Gerard le Grellelaan 10,2022-10-22,09:00:00,63,46,17,FMN 05 Gerard Le Grellelaan
653,Gerard le Grellelaan 10,2022-10-22,10:00:00,53,43,10,FMN 05 Gerard Le Grellelaan
653,Gerard le Grellelaan 10,2022-10-22,11:00:00,71,56,15,FMN 05 Gerard Le Grellelaan
653,Gerard le Grellelaan 10,2022-10-22,12:00:00,78,62,16,FMN 05 Gerard Le Grellelaan
653,Gerard le Grellelaan 10,2022-10-22,13:00:00,89,70,19,FMN 05 Gerard Le Grellelaan
653,Gerard le Grellelaan 10,2022-10-22,14:00:00,105,90,15,FMN 05 Gerard Le Grellelaan
653,Gerard le Grellelaan 10,2022-10-22,15:00:00,105,79,26,FMN 05 Gerard Le Grellelaan
653,Gerard le Grellelaan 10,2022-10-22,16:00:00,121,107,14,FMN 05 Gerard Le Grellelaan
653,Gerard le Grellelaan 10,2022-10-22,17:00:00,115,101,14,FMN 05 Gerard Le Grellelaan
653,Gerard le Grellelaan 10,2022-10-22,18:00:00,125,105,20,FMN 05 Gerard Le Grellelaan
653,Gerard le Grellelaan 10,2022-10-22,19:00:00,71,62,9,FMN 05 Gerard Le Grellelaan
653,Gerard le Grellelaan 10,2022-10-22,20:00:00,46,34,12,FMN 05 Gerard Le Grellelaan
653,Gerard le Grellelaan 10,2022-10-22,21:00:00,23,22,1,FMN 05 Gerard Le Grellelaan
653,Gerard le Grellelaan 10,2022-10-22,22:00:00,22,13,9,FMN 05 Gerard Le Grellelaan
653,Gerard le Grellelaan 10,2022-10-22,23:00:00,29,26,3,FMN 05 Gerard Le Grellelaan
653,Gerard le Grellelaan 10,2022-10-23,00:00:00,16,8,8,FMN 05 Gerard Le Grellelaan
653,Gerard le Grellelaan 10,2022-10-23,01:00:00,10,8,2,FMN 05 Gerard Le Grellelaan
653,Gerard le Grellelaan 10,2022-10-23,02:00:00,5,1,4,FMN 05 Gerard Le Grellelaan
653,Gerard le Grellelaan 10,2022-10-23,03:00:00,3,3,0,FMN 05 Gerard Le Grellelaan
653,Gerard le Grellelaan 10,2022-10-23,04:00:00,5,1,4,FMN 05 Gerard Le Grellelaan
653,Gerard le Grellelaan 10,2022-10-23,05:00:00,7,3,4,FMN 05 Gerard Le Grellelaan
653,Gerard le Grellelaan 10,2022-10-23,06:00:00,9,6,3,FMN 05 Gerard Le Grellelaan
653,Gerard le Grellelaan 10,2022-10-23,07:00:00,9,6,3,FMN 05 Gerard Le Grellelaan
653,Gerard le Grellelaan 10,2022-10-23,08:00:00,19,18,1,FMN 05 Gerard Le Grellelaan
653,Gerard le Grellelaan 10,2022-10-23,09:00:00,58,46,12,FMN 05 Gerard Le Grellelaan
653,Gerard le Grellelaan 10,2022-10-23,10:00:00,61,52,9,FMN 05 Gerard Le Grellelaan
653,Gerard le Grellelaan 10,2022-10-23,11:00:00,78,65,13,FMN 05 Gerard Le Grellelaan
653,Gerard le Grellelaan 10,2022-10-23,12:00:00,106,94,12,FMN 05 Gerard Le Grellelaan
653,Gerard le Grellelaan 10,2022-10-23,13:00:00,68,58,10,FMN 05 Gerard Le Grellelaan
653,Gerard le Grellelaan 10,2022-10-23,14:00:00,96,85,11,FMN 05 Gerard Le Grellelaan
653,Gerard le Grellelaan 10,2022-10-23,15:00:00,84,63,21,FMN 05 Gerard Le Grellelaan
653,Gerard le Grellelaan 10,2022-10-23,16:00:00,89,71,18,FMN 05 Gerard Le Grellelaan
653,Gerard le Grellelaan 10,2022-10-23,17:00:00,105,98,7,FMN 05 Gerard Le Grellelaan
653,Gerard le Grellelaan 10,2022-10-23,18:00:00,79,63,16,FMN 05 Gerard Le Grellelaan
653,Gerard le Grellelaan 10,2022-10-23,19:00:00,43,29,14,FMN 05 Gerard Le Grellelaan
653,Gerard le Grellelaan 10,2022-10-23,20:00:00,19,14,5,FMN 05 Gerard Le Grellelaan
653,Gerard le Grellelaan 10,2022-10-23,21:00:00,25,17,8,FMN 05 Gerard Le Grellelaan
653,Gerard le Grellelaan 10,2022-10-23,22:00:00,20,14,6,FMN 05 Gerard Le Grellelaan
653,Gerard le Grellelaan 10,2022-10-23,23:00:00,13,9,4,FMN 05 Gerard Le Grellelaan
653,Gerard le Grellelaan 10,2022-10-24,00:00:00,3,2,1,FMN 05 Gerard Le Grellelaan
653,Gerard le Grellelaan 10,2022-10-24,01:00:00,2,2,0,FMN 05 Gerard Le Grellelaan
653,Gerard le Grellelaan 10,2022-10-24,02:00:00,5,3,2,FMN 05 Gerard Le Grellelaan
653,Gerard le Grellelaan 10,2022-10-24,03:00:00,1,1,0,FMN 05 Gerard Le Grellelaan
653,Gerard le Grellelaan 10,2022-10-24,04:00:00,9,7,2,FMN 05 Gerard Le Grellelaan
653,Gerard le Grellelaan 10,2022-10-24,05:00:00,32,8,24,FMN 05 Gerard Le Grellelaan
653,Gerard le Grellelaan 10,2022-10-24,06:00:00,50,28,22,FMN 05 Gerard Le Grellelaan
653,Gerard le Grellelaan 10,2022-10-24,07:00:00,139,100,39,FMN 05 Gerard Le Grellelaan
653,Gerard le Grellelaan 10,2022-10-24,08:00:00,301,247,54,FMN 05 Gerard Le Grellelaan
653,Gerard le Grellelaan 10,2022-10-24,09:00:00,75,59,16,FMN 05 Gerard Le Grellelaan
653,Gerard le Grellelaan 10,2022-10-24,10:00:00,67,55,12,FMN 05 Gerard Le Grellelaan
653,Gerard le Grellelaan 10,2022-10-24,11:00:00,53,42,11,FMN 05 Gerard Le Grellelaan
653,Gerard le Grellelaan 10,2022-10-24,12:00:00,100,78,22,FMN 05 Gerard Le Grellelaan
653,Gerard le Grellelaan 10,2022-10-24,13:00:00,82,62,20,FMN 05 Gerard Le Grellelaan
653,Gerard le Grellelaan 10,2022-10-24,14:00:00,79,66,13,FMN 05 Gerard Le Grellelaan
653,Gerard le Grellelaan 10,2022-10-24,15:00:00,155,135,20,FMN 05 Gerard Le Grellelaan
653,Gerard le Grellelaan 10,2022-10-24,16:00:00,199,141,58,FMN 05 Gerard Le Grellelaan
653,Gerard le Grellelaan 10,2022-10-24,17:00:00,203,166,37,FMN 05 Gerard Le Grellelaan
653,Gerard le Grellelaan 10,2022-10-24,18:00:00,142,113,29,FMN 05 Gerard Le Grellelaan
653,Gerard le Grellelaan 10,2022-10-24,19:00:00,49,40,9,FMN 05 Gerard Le Grellelaan
653,Gerard le Grellelaan 10,2022-10-24,20:00:00,46,30,16,FMN 05 Gerard Le Grellelaan
653,Gerard le Grellelaan 10,2022-10-24,21:00:00,32,25,7,FMN 05 Gerard Le Grellelaan
653,Gerard le Grellelaan 10,2022-10-24,22:00:00,39,32,7,FMN 05 Gerard Le Grellelaan
653,Gerard le Grellelaan 10,2022-10-24,23:00:00,18,13,5,FMN 05 Gerard Le Grellelaan
653,Gerard le Grellelaan 10,2022-10-25,00:00:00,7,7,0,FMN 05 Gerard Le Grellelaan
653,Gerard le Grellelaan 10,2022-10-25,01:00:00,4,3,1,FMN 05 Gerard Le Grellelaan
653,Gerard le Grellelaan 10,2022-10-25,02:00:00,3,3,0,FMN 05 Gerard Le Grellelaan
653,Gerard le Grellelaan 10,2022-10-25,03:00:00,2,2,0,FMN 05 Gerard Le Grellelaan
653,Gerard le Grellelaan 10,2022-10-25,04:00:00,9,5,4,FMN 05 Gerard Le Grellelaan
653,Gerard le Grellelaan 10,2022-10-25,05:00:00,26,10,16,FMN 05 Gerard Le Grellelaan
653,Gerard le Grellelaan 10,2022-10-25,06:00:00,61,38,23,FMN 05 Gerard Le Grellelaan
653,Gerard le Grellelaan 10,2022-10-25,07:00:00,176,124,52,FMN 05 Gerard Le Grellelaan
653,Gerard le Grellelaan 10,2022-10-25,08:00:00,330,263,67,FMN 05 Gerard Le Grellelaan
653,Gerard le Grellelaan 10,2022-10-25,09:00:00,109,89,20,FMN 05 Gerard Le Grellelaan
653,Gerard le Grellelaan 10,2022-10-25,10:00:00,93,77,16,FMN 05 Gerard Le Grellelaan
653,Gerard le Grellelaan 10,2022-10-25,11:00:00,86,74,12,FMN 05 Gerard Le Grellelaan
653,Gerard le Grellelaan 10,2022-10-25,12:00:00,111,80,31,FMN 05 Gerard Le Grellelaan
653,Gerard le Grellelaan 10,2022-10-25,13:00:00,154,119,35,FMN 05 Gerard Le Grellelaan
653,Gerard le Grellelaan 10,2022-10-25,14:00:00,96,79,17,FMN 05 Gerard Le Grellelaan
653,Gerard le Grellelaan 10,2022-10-25,15:00:00,165,142,23,FMN 05 Gerard Le Grellelaan
653,Gerard le Grellelaan 10,2022-10-25,16:00:00,245,187,58,FMN 05 Gerard Le Grellelaan
653,Gerard le Grellelaan 10,2022-10-25,17:00:00,264,203,61,FMN 05 Gerard Le Grellelaan
653,Gerard le Grellelaan 10,2022-10-25,18:00:00,207,157,50,FMN 05 Gerard Le Grellelaan
653,Gerard le Grellelaan 10,2022-10-25,19:00:00,106,91,15,FMN 05 Gerard Le Grellelaan
653,Gerard le Grellelaan 10,2022-10-25,20:00:00,59,46,13,FMN 05 Gerard Le Grellelaan
653,Gerard le Grellelaan 10,2022-10-25,21:00:00,58,46,12,FMN 05 Gerard Le Grellelaan
653,Gerard le Grellelaan 10,2022-10-25,22:00:00,51,39,12,FMN 05 Gerard Le Grellelaan
653,Gerard le Grellelaan 10,2022-10-25,23:00:00,19,14,5,FMN 05 Gerard Le Grellelaan
653,Gerard le Grellelaan 10,2022-10-26,00:00:00,10,8,2,FMN 05 Gerard Le Grellelaan
653,Gerard le Grellelaan 10,2022-10-26,01:00:00,5,4,1,FMN 05 Gerard Le Grellelaan
653,Gerard le Grellelaan 10,2022-10-26,02:00:00,5,2,3,FMN 05 Gerard Le Grellelaan
653,Gerard le Grellelaan 10,2022-10-26,03:00:00,2,2,0,FMN 05 Gerard Le Grellelaan
653,Gerard le Grellelaan 10,2022-10-26,04:00:00,11,4,7,FMN 05 Gerard Le Grellelaan
653,Gerard le Grellelaan 10,2022-10-26,05:00:00,27,10,17,FMN 05 Gerard Le Grellelaan
653,Gerard le Grellelaan 10,2022-10-26,06:00:00,43,20,23,FMN 05 Gerard Le Grellelaan
653,Gerard le Grellelaan 10,2022-10-26,07:00:00,153,113,40,FMN 05 Gerard Le Grellelaan
653,Gerard le Grellelaan 10,2022-10-26,08:00:00,293,231,62,FMN 05 Gerard Le Grellelaan
653,Gerard le Grellelaan 10,2022-10-26,09:00:00,101,80,21,FMN 05 Gerard Le Grellelaan
653,Gerard le Grellelaan 10,2022-10-26,10:00:00,65,52,13,FMN 05 Gerard Le Grellelaan
653,Gerard le Grellelaan 10,2022-10-26,11:00:00,85,76,9,FMN 05 Gerard Le Grellelaan
653,Gerard le Grellelaan 10,2022-10-26,12:00:00,166,120,46,FMN 05 Gerard Le Grellelaan
653,Gerard le Grellelaan 10,2022-10-26,13:00:00,137,107,30,FMN 05 Gerard Le Grellelaan
653,Gerard le Grellelaan 10,2022-10-26,14:00:00,101,87,14,FMN 05 Gerard Le Grellelaan
653,Gerard le Grellelaan 10,2022-10-26,15:00:00,147,118,29,FMN 05 Gerard Le Grellelaan
653,Gerard le Grellelaan 10,2022-10-26,16:00:00,207,159,48,FMN 05 Gerard Le Grellelaan
653,Gerard le Grellelaan 10,2022-10-26,17:00:00,247,206,41,FMN 05 Gerard Le Grellelaan
653,Gerard le Grellelaan 10,2022-10-26,18:00:00,185,148,37,FMN 05 Gerard Le Grellelaan
653,Gerard le Grellelaan 10,2022-10-26,19:00:00,104,82,22,FMN 05 Gerard Le Grellelaan
653,Gerard le Grellelaan 10,2022-10-26,20:00:00,76,60,16,FMN 05 Gerard Le Grellelaan
653,Gerard le Grellelaan 10,2022-10-26,21:00:00,49,39,10,FMN 05 Gerard Le Grellelaan
653,Gerard le Grellelaan 10,2022-10-26,22:00:00,68,50,18,FMN 05 Gerard Le Grellelaan
653,Gerard le Grellelaan 10,2022-10-26,23:00:00,25,12,13,FMN 05 Gerard Le Grellelaan
653,Gerard le Grellelaan 10,2022-10-27,00:00:00,11,8,3,FMN 05 Gerard Le Grellelaan
653,Gerard le Grellelaan 10,2022-10-27,01:00:00,9,6,3,FMN 05 Gerard Le Grellelaan
653,Gerard le Grellelaan 10,2022-10-27,02:00:00,6,4,2,FMN 05 Gerard Le Grellelaan
653,Gerard le Grellelaan 10,2022-10-27,03:00:00,1,0,1,FMN 05 Gerard Le Grellelaan
653,Gerard le Grellelaan 10,2022-10-27,04:00:00,9,5,4,FMN 05 Gerard Le Grellelaan
653,Gerard le Grellelaan 10,2022-10-27,05:00:00,30,10,20,FMN 05 Gerard Le Grellelaan
653,Gerard le Grellelaan 10,2022-10-27,06:00:00,58,26,32,FMN 05 Gerard Le Grellelaan
653,Gerard le Grellelaan 10,2022-10-27,07:00:00,164,110,54,FMN 05 Gerard Le Grellelaan
653,Gerard le Grellelaan 10,2022-10-27,08:00:00,346,273,73,FMN 05 Gerard Le Grellelaan
653,Gerard le Grellelaan 10,2022-10-27,09:00:00,103,82,21,FMN 05 Gerard Le Grellelaan
653,Gerard le Grellelaan 10,2022-10-27,10:00:00,93,82,11,FMN 05 Gerard Le Grellelaan
653,Gerard le Grellelaan 10,2022-10-27,11:00:00,77,62,15,FMN 05 Gerard Le Grellelaan
653,Gerard le Grellelaan 10,2022-10-27,12:00:00,124,105,19,FMN 05 Gerard Le Grellelaan
653,Gerard le Grellelaan 10,2022-10-27,13:00:00,116,85,31,FMN 05 Gerard Le Grellelaan
653,Gerard le Grellelaan 10,2022-10-27,14:00:00,94,79,15,FMN 05 Gerard Le Grellelaan
653,Gerard le Grellelaan 10,2022-10-27,15:00:00,184,137,47,FMN 05 Gerard Le Grellelaan
653,Gerard le Grellelaan 10,2022-10-27,16:00:00,217,177,40,FMN 05 Gerard Le Grellelaan
653,Gerard le Grellelaan 10,2022-10-27,17:00:00,244,200,44,FMN 05 Gerard Le Grellelaan
653,Gerard le Grellelaan 10,2022-10-27,18:00:00,183,147,36,FMN 05 Gerard Le Grellelaan
653,Gerard le Grellelaan 10,2022-10-27,19:00:00,86,74,12,FMN 05 Gerard Le Grellelaan
653,Gerard le Grellelaan 10,2022-10-27,20:00:00,71,57,14,FMN 05 Gerard Le Grellelaan
653,Gerard le Grellelaan 10,2022-10-27,21:00:00,55,37,18,FMN 05 Gerard Le Grellelaan
653,Gerard le Grellelaan 10,2022-10-27,22:00:00,56,45,11,FMN 05 Gerard Le Grellelaan
653,Gerard le Grellelaan 10,2022-10-27,23:00:00,25,19,6,FMN 05 Gerard Le Grellelaan
653,Gerard le Grellelaan 10,2022-10-28,00:00:00,11,8,3,FMN 05 Gerard Le Grellelaan
653,Gerard le Grellelaan 10,2022-10-28,01:00:00,10,2,8,FMN 05 Gerard Le Grellelaan
653,Gerard le Grellelaan 10,2022-10-28,02:00:00,5,1,4,FMN 05 Gerard Le Grellelaan
653,Gerard le Grellelaan 10,2022-10-28,03:00:00,4,2,2,FMN 05 Gerard Le Grellelaan
653,Gerard le Grellelaan 10,2022-10-28,04:00:00,6,4,2,FMN 05 Gerard Le Grellelaan
653,Gerard le Grellelaan 10,2022-10-28,05:00:00,28,7,21,FMN 05 Gerard Le Grellelaan
653,Gerard le Grellelaan 10,2022-10-28,06:00:00,49,26,23,FMN 05 Gerard Le Grellelaan
653,Gerard le Grellelaan 10,2022-10-28,07:00:00,138,101,37,FMN 05 Gerard Le Grellelaan
653,Gerard le Grellelaan 10,2022-10-28,08:00:00,280,221,59,FMN 05 Gerard Le Grellelaan
653,Gerard le Grellelaan 10,2022-10-28,09:00:00,106,88,18,FMN 05 Gerard Le Grellelaan
653,Gerard le Grellelaan 10,2022-10-28,10:00:00,73,59,14,FMN 05 Gerard Le Grellelaan
653,Gerard le Grellelaan 10,2022-10-28,11:00:00,80,70,10,FMN 05 Gerard Le Grellelaan
653,Gerard le Grellelaan 10,2022-10-28,12:00:00,127,99,28,FMN 05 Gerard Le Grellelaan
653,Gerard le Grellelaan 10,2022-10-28,13:00:00,115,86,29,FMN 05 Gerard Le Grellelaan
653,Gerard le Grellelaan 10,2022-10-28,14:00:00,134,110,24,FMN 05 Gerard Le Grellelaan
653,Gerard le Grellelaan 10,2022-10-28,15:00:00,205,165,40,FMN 05 Gerard Le Grellelaan
653,Gerard le Grellelaan 10,2022-10-28,16:00:00,222,184,38,FMN 05 Gerard Le Grellelaan
653,Gerard le Grellelaan 10,2022-10-28,17:00:00,206,163,43,FMN 05 Gerard Le Grellelaan
653,Gerard le Grellelaan 10,2022-10-28,18:00:00,160,133,27,FMN 05 Gerard Le Grellelaan
653,Gerard le Grellelaan 10,2022-10-28,19:00:00,81,62,19,FMN 05 Gerard Le Grellelaan
653,Gerard le Grellelaan 10,2022-10-28,20:00:00,71,60,11,FMN 05 Gerard Le Grellelaan
653,Gerard le Grellelaan 10,2022-10-28,21:00:00,55,45,10,FMN 05 Gerard Le Grellelaan
653,Gerard le Grellelaan 10,2022-10-28,22:00:00,54,46,8,FMN 05 Gerard Le Grellelaan
653,Gerard le Grellelaan 10,2022-10-28,23:00:00,34,21,13,FMN 05 Gerard Le Grellelaan
653,Gerard le Grellelaan 10,2022-10-29,00:00:00,31,21,10,FMN 05 Gerard Le Grellelaan
653,Gerard le Grellelaan 10,2022-10-29,01:00:00,13,10,3,FMN 05 Gerard Le Grellelaan
653,Gerard le Grellelaan 10,2022-10-29,02:00:00,7,4,3,FMN 05 Gerard Le Grellelaan
653,Gerard le Grellelaan 10,2022-10-29,03:00:00,15,13,2,FMN 05 Gerard Le Grellelaan
653,Gerard le Grellelaan 10,2022-10-29,04:00:00,4,3,1,FMN 05 Gerard Le Grellelaan
653,Gerard le Grellelaan 10,2022-10-29,05:00:00,7,3,4,FMN 05 Gerard Le Grellelaan
653,Gerard le Grellelaan 10,2022-10-29,06:00:00,8,4,4,FMN 05 Gerard Le Grellelaan
653,Gerard le Grellelaan 10,2022-10-29,07:00:00,12,10,2,FMN 05 Gerard Le Grellelaan
653,Gerard le Grellelaan 10,2022-10-29,08:00:00,21,16,5,FMN 05 Gerard Le Grellelaan
653,Gerard le Grellelaan 10,2022-10-29,09:00:00,46,35,11,FMN 05 Gerard Le Grellelaan
653,Gerard le Grellelaan 10,2022-10-29,10:00:00,53,47,6,FMN 05 Gerard Le Grellelaan
653,Gerard le Grellelaan 10,2022-10-29,11:00:00,64,58,6,FMN 05 Gerard Le Grellelaan
653,Gerard le Grellelaan 10,2022-10-29,12:00:00,89,66,23,FMN 05 Gerard Le Grellelaan
653,Gerard le Grellelaan 10,2022-10-29,13:00:00,86,71,15,FMN 05 Gerard Le Grellelaan
653,Gerard le Grellelaan 10,2022-10-29,14:00:00,108,83,25,FMN 05 Gerard Le Grellelaan
653,Gerard le Grellelaan 10,2022-10-29,15:00:00,92,76,16,FMN 05 Gerard Le Grellelaan
653,Gerard le Grellelaan 10,2022-10-29,16:00:00,134,111,23,FMN 05 Gerard Le Grellelaan
653,Gerard le Grellelaan 10,2022-10-29,17:00:00,118,97,21,FMN 05 Gerard Le Grellelaan
653,Gerard le Grellelaan 10,2022-10-29,18:00:00,95,87,8,FMN 05 Gerard Le Grellelaan
653,Gerard le Grellelaan 10,2022-10-29,19:00:00,63,45,18,FMN 05 Gerard Le Grellelaan
653,Gerard le Grellelaan 10,2022-10-29,20:00:00,38,32,6,FMN 05 Gerard Le Grellelaan
653,Gerard le Grellelaan 10,2022-10-29,21:00:00,25,23,2,FMN 05 Gerard Le Grellelaan
653,Gerard le Grellelaan 10,2022-10-29,22:00:00,37,31,6,FMN 05 Gerard Le Grellelaan
653,Gerard le Grellelaan 10,2022-10-29,23:00:00,32,22,10,FMN 05 Gerard Le Grellelaan
653,Gerard le Grellelaan 10,2022-10-30,00:00:00,29,20,9,FMN 05 Gerard Le Grellelaan
653,Gerard le Grellelaan 10,2022-10-30,01:00:00,15,9,6,FMN 05 Gerard Le Grellelaan
653,Gerard le Grellelaan 10,2022-10-30,02:00:00,21,16,5,FMN 05 Gerard Le Grellelaan
653,Gerard le Grellelaan 10,2022-10-30,03:00:00,3,1,2,FMN 05 Gerard Le Grellelaan
653,Gerard le Grellelaan 10,2022-10-30,04:00:00,5,3,2,FMN 05 Gerard Le Grellelaan
653,Gerard le Grellelaan 10,2022-10-30,05:00:00,9,6,3,FMN 05 Gerard Le Grellelaan
653,Gerard le Grellelaan 10,2022-10-30,06:00:00,8,5,3,FMN 05 Gerard Le Grellelaan
653,Gerard le Grellelaan 10,2022-10-30,07:00:00,12,12,0,FMN 05 Gerard Le Grellelaan
653,Gerard le Grellelaan 10,2022-10-30,08:00:00,21,19,2,FMN 05 Gerard Le Grellelaan
653,Gerard le Grellelaan 10,2022-10-30,09:00:00,61,52,9,FMN 05 Gerard Le Grellelaan
653,Gerard le Grellelaan 10,2022-10-30,10:00:00,71,54,17,FMN 05 Gerard Le Grellelaan
653,Gerard le Grellelaan 10,2022-10-30,11:00:00,93,75,18,FMN 05 Gerard Le Grellelaan
653,Gerard le Grellelaan 10,2022-10-30,12:00:00,109,89,20,FMN 05 Gerard Le Grellelaan
653,Gerard le Grellelaan 10,2022-10-30,13:00:00,81,65,16,FMN 05 Gerard Le Grellelaan
653,Gerard le Grellelaan 10,2022-10-30,14:00:00,103,89,14,FMN 05 Gerard Le Grellelaan
653,Gerard le Grellelaan 10,2022-10-30,15:00:00,123,102,21,FMN 05 Gerard Le Grellelaan
653,Gerard le Grellelaan 10,2022-10-30,16:00:00,83,74,9,FMN 05 Gerard Le Grellelaan
653,Gerard le Grellelaan 10,2022-10-30,17:00:00,97,82,15,FMN 05 Gerard Le Grellelaan
653,Gerard le Grellelaan 10,2022-10-30,18:00:00,70,58,12,FMN 05 Gerard Le Grellelaan
653,Gerard le Grellelaan 10,2022-10-30,19:00:00,42,34,8,FMN 05 Gerard Le Grellelaan
653,Gerard le Grellelaan 10,2022-10-30,20:00:00,22,17,5,FMN 05 Gerard Le Grellelaan
653,Gerard le Grellelaan 10,2022-10-30,21:00:00,27,18,9,FMN 05 Gerard Le Grellelaan
653,Gerard le Grellelaan 10,2022-10-30,22:00:00,26,19,7,FMN 05 Gerard Le Grellelaan
653,Gerard le Grellelaan 10,2022-10-30,23:00:00,11,8,3,FMN 05 Gerard Le Grellelaan
653,Gerard le Grellelaan 10,2022-10-31,00:00:00,2,2,0,FMN 05 Gerard Le Grellelaan
653,Gerard le Grellelaan 10,2022-10-31,01:00:00,5,2,3,FMN 05 Gerard Le Grellelaan
653,Gerard le Grellelaan 10,2022-10-31,02:00:00,8,5,3,FMN 05 Gerard Le Grellelaan
653,Gerard le Grellelaan 10,2022-10-31,03:00:00,2,1,1,FMN 05 Gerard Le Grellelaan
653,Gerard le Grellelaan 10,2022-10-31,04:00:00,2,2,0,FMN 05 Gerard Le Grellelaan
653,Gerard le Grellelaan 10,2022-10-31,05:00:00,13,6,7,FMN 05 Gerard Le Grellelaan
653,Gerard le Grellelaan 10,2022-10-31,06:00:00,20,10,10,FMN 05 Gerard Le Grellelaan
653,Gerard le Grellelaan 10,2022-10-31,07:00:00,68,51,17,FMN 05 Gerard Le Grellelaan
653,Gerard le Grellelaan 10,2022-10-31,08:00:00,61,50,11,FMN 05 Gerard Le Grellelaan
653,Gerard le Grellelaan 10,2022-10-31,09:00:00,52,44,8,FMN 05 Gerard Le Grellelaan
653,Gerard le Grellelaan 10,2022-10-31,10:00:00,45,35,10,FMN 05 Gerard Le Grellelaan
653,Gerard le Grellelaan 10,2022-10-31,11:00:00,37,29,8,FMN 05 Gerard Le Grellelaan
653,Gerard le Grellelaan 10,2022-10-31,12:00:00,61,49,12,FMN 05 Gerard Le Grellelaan
653,Gerard le Grellelaan 10,2022-10-31,13:00:00,76,61,15,FMN 05 Gerard Le Grellelaan
653,Gerard le Grellelaan 10,2022-10-31,14:00:00,82,69,13,FMN 05 Gerard Le Grellelaan
653,Gerard le Grellelaan 10,2022-10-31,15:00:00,85,72,13,FMN 05 Gerard Le Grellelaan
653,Gerard le Grellelaan 10,2022-10-31,16:00:00,114,94,20,FMN 05 Gerard Le Grellelaan
653,Gerard le Grellelaan 10,2022-10-31,17:00:00,118,94,24,FMN 05 Gerard Le Grellelaan
653,Gerard le Grellelaan 10,2022-10-31,18:00:00,84,63,21,FMN 05 Gerard Le Grellelaan
653,Gerard le Grellelaan 10,2022-10-31,19:00:00,73,57,16,FMN 05 Gerard Le Grellelaan
653,Gerard le Grellelaan 10,2022-10-31,20:00:00,56,44,12,FMN 05 Gerard Le Grellelaan
653,Gerard le Grellelaan 10,2022-10-31,21:00:00,36,31,5,FMN 05 Gerard Le Grellelaan
653,Gerard le Grellelaan 10,2022-10-31,22:00:00,41,34,7,FMN 05 Gerard Le Grellelaan
653,Gerard le Grellelaan 10,2022-10-31,23:00:00,12,10,2,FMN 05 Gerard Le Grellelaan
653,Gerard le Grellelaan 10,2022-11-01,00:00:00,13,7,6,FMN 05 Gerard Le Grellelaan
653,Gerard le Grellelaan 10,2022-11-01,01:00:00,16,9,7,FMN 05 Gerard Le Grellelaan
653,Gerard le Grellelaan 10,2022-11-01,02:00:00,11,6,5,FMN 05 Gerard Le Grellelaan
653,Gerard le Grellelaan 10,2022-11-01,03:00:00,7,3,4,FMN 05 Gerard Le Grellelaan
653,Gerard le Grellelaan 10,2022-11-01,04:00:00,4,3,1,FMN 05 Gerard Le Grellelaan
653,Gerard le Grellelaan 10,2022-11-01,05:00:00,4,3,1,FMN 05 Gerard Le Grellelaan
653,Gerard le Grellelaan 10,2022-11-01,06:00:00,8,7,1,FMN 05 Gerard Le Grellelaan
653,Gerard le Grellelaan 10,2022-11-01,07:00:00,10,7,3,FMN 05 Gerard Le Grellelaan
653,Gerard le Grellelaan 10,2022-11-01,08:00:00,17,16,1,FMN 05 Gerard Le Grellelaan
653,Gerard le Grellelaan 10,2022-11-01,09:00:00,37,27,10,FMN 05 Gerard Le Grellelaan
653,Gerard le Grellelaan 10,2022-11-01,10:00:00,50,47,3,FMN 05 Gerard Le Grellelaan
653,Gerard le Grellelaan 10,2022-11-01,11:00:00,80,69,11,FMN 05 Gerard Le Grellelaan
653,Gerard le Grellelaan 10,2022-11-01,12:00:00,65,49,16,FMN 05 Gerard Le Grellelaan
653,Gerard le Grellelaan 10,2022-11-01,13:00:00,80,65,15,FMN 05 Gerard Le Grellelaan
653,Gerard le Grellelaan 10,2022-11-01,14:00:00,79,56,23,FMN 05 Gerard Le Grellelaan
653,Gerard le Grellelaan 10,2022-11-01,15:00:00,93,80,13,FMN 05 Gerard Le Grellelaan
653,Gerard le Grellelaan 10,2022-11-01,16:00:00,82,69,13,FMN 05 Gerard Le Grellelaan
653,Gerard le Grellelaan 10,2022-11-01,17:00:00,90,74,16,FMN 05 Gerard Le Grellelaan
653,Gerard le Grellelaan 10,2022-11-01,18:00:00,33,26,7,FMN 05 Gerard Le Grellelaan
653,Gerard le Grellelaan 10,2022-11-01,19:00:00,37,25,12,FMN 05 Gerard Le Grellelaan
653,Gerard le Grellelaan 10,2022-11-01,20:00:00,16,11,5,FMN 05 Gerard Le Grellelaan
653,Gerard le Grellelaan 10,2022-11-01,21:00:00,21,14,7,FMN 05 Gerard Le Grellelaan
653,Gerard le Grellelaan 10,2022-11-01,22:00:00,30,21,9,FMN 05 Gerard Le Grellelaan
653,Gerard le Grellelaan 10,2022-11-01,23:00:00,13,8,5,FMN 05 Gerard Le Grellelaan
653,Gerard le Grellelaan 10,2022-11-02,00:00:00,6,3,3,FMN 05 Gerard Le Grellelaan
653,Gerard le Grellelaan 10,2022-11-02,01:00:00,1,1,0,FMN 05 Gerard Le Grellelaan
653,Gerard le Grellelaan 10,2022-11-02,02:00:00,2,1,1,FMN 05 Gerard Le Grellelaan
653,Gerard le Grellelaan 10,2022-11-02,03:00:00,1,0,1,FMN 05 Gerard Le Grellelaan
653,Gerard le Grellelaan 10,2022-11-02,04:00:00,7,6,1,FMN 05 Gerard Le Grellelaan
653,Gerard le Grellelaan 10,2022-11-02,05:00:00,24,7,17,FMN 05 Gerard Le Grellelaan
653,Gerard le Grellelaan 10,2022-11-02,06:00:00,38,24,14,FMN 05 Gerard Le Grellelaan
653,Gerard le Grellelaan 10,2022-11-02,07:00:00,83,48,35,FMN 05 Gerard Le Grellelaan
653,Gerard le Grellelaan 10,2022-11-02,08:00:00,131,105,26,FMN 05 Gerard Le Grellelaan
653,Gerard le Grellelaan 10,2022-11-02,09:00:00,67,56,11,FMN 05 Gerard Le Grellelaan
653,Gerard le Grellelaan 10,2022-11-02,10:00:00,70,60,10,FMN 05 Gerard Le Grellelaan
653,Gerard le Grellelaan 10,2022-11-02,11:00:00,63,53,10,FMN 05 Gerard Le Grellelaan
653,Gerard le Grellelaan 10,2022-11-02,12:00:00,77,64,13,FMN 05 Gerard Le Grellelaan
653,Gerard le Grellelaan 10,2022-11-02,13:00:00,86,61,25,FMN 05 Gerard Le Grellelaan
653,Gerard le Grellelaan 10,2022-11-02,14:00:00,108,87,21,FMN 05 Gerard Le Grellelaan
653,Gerard le Grellelaan 10,2022-11-02,15:00:00,125,99,26,FMN 05 Gerard Le Grellelaan
653,Gerard le Grellelaan 10,2022-11-02,16:00:00,139,118,21,FMN 05 Gerard Le Grellelaan
653,Gerard le Grellelaan 10,2022-11-02,17:00:00,140,111,29,FMN 05 Gerard Le Grellelaan
653,Gerard le Grellelaan 10,2022-11-02,18:00:00,101,82,19,FMN 05 Gerard Le Grellelaan
653,Gerard le Grellelaan 10,2022-11-02,19:00:00,54,42,12,FMN 05 Gerard Le Grellelaan
653,Gerard le Grellelaan 10,2022-11-02,20:00:00,31,27,4,FMN 05 Gerard Le Grellelaan
653,Gerard le Grellelaan 10,2022-11-02,21:00:00,27,22,5,FMN 05 Gerard Le Grellelaan
653,Gerard le Grellelaan 10,2022-11-02,22:00:00,29,21,8,FMN 05 Gerard Le Grellelaan
653,Gerard le Grellelaan 10,2022-11-02,23:00:00,12,10,2,FMN 05 Gerard Le Grellelaan
653,Gerard le Grellelaan 10,2022-11-03,00:00:00,5,4,1,FMN 05 Gerard Le Grellelaan
653,Gerard le Grellelaan 10,2022-11-03,01:00:00,2,2,0,FMN 05 Gerard Le Grellelaan
653,Gerard le Grellelaan 10,2022-11-03,02:00:00,4,1,3,FMN 05 Gerard Le Grellelaan
653,Gerard le Grellelaan 10,2022-11-03,03:00:00,0,0,0,FMN 05 Gerard Le Grellelaan
653,Gerard le Grellelaan 10,2022-11-03,04:00:00,5,3,2,FMN 05 Gerard Le Grellelaan
653,Gerard le Grellelaan 10,2022-11-03,05:00:00,28,9,19,FMN 05 Gerard Le Grellelaan
653,Gerard le Grellelaan 10,2022-11-03,06:00:00,35,18,17,FMN 05 Gerard Le Grellelaan
653,Gerard le Grellelaan 10,2022-11-03,07:00:00,89,63,26,FMN 05 Gerard Le Grellelaan
653,Gerard le Grellelaan 10,2022-11-03,08:00:00,168,140,28,FMN 05 Gerard Le Grellelaan
653,Gerard le Grellelaan 10,2022-11-03,09:00:00,76,57,19,FMN 05 Gerard Le Grellelaan
653,Gerard le Grellelaan 10,2022-11-03,10:00:00,68,55,13,FMN 05 Gerard Le Grellelaan
653,Gerard le Grellelaan 10,2022-11-03,11:00:00,66,53,13,FMN 05 Gerard Le Grellelaan
653,Gerard le Grellelaan 10,2022-11-03,12:00:00,77,61,16,FMN 05 Gerard Le Grellelaan
653,Gerard le Grellelaan 10,2022-11-03,13:00:00,72,59,13,FMN 05 Gerard Le Grellelaan
653,Gerard le Grellelaan 10,2022-11-03,14:00:00,68,57,11,FMN 05 Gerard Le Grellelaan
653,Gerard le Grellelaan 10,2022-11-03,15:00:00,93,77,16,FMN 05 Gerard Le Grellelaan
653,Gerard le Grellelaan 10,2022-11-03,16:00:00,114,89,25,FMN 05 Gerard Le Grellelaan
653,Gerard le Grellelaan 10,2022-11-03,17:00:00,123,102,21,FMN 05 Gerard Le Grellelaan
653,Gerard le Grellelaan 10,2022-11-03,18:00:00,95,78,17,FMN 05 Gerard Le Grellelaan
653,Gerard le Grellelaan 10,2022-11-03,19:00:00,43,33,10,FMN 05 Gerard Le Grellelaan
653,Gerard le Grellelaan 10,2022-11-03,20:00:00,36,24,12,FMN 05 Gerard Le Grellelaan
653,Gerard le Grellelaan 10,2022-11-03,21:00:00,17,12,5,FMN 05 Gerard Le Grellelaan
653,Gerard le Grellelaan 10,2022-11-03,22:00:00,38,34,4,FMN 05 Gerard Le Grellelaan
653,Gerard le Grellelaan 10,2022-11-03,23:00:00,9,9,0,FMN 05 Gerard Le Grellelaan
653,Gerard le Grellelaan 10,2022-11-04,00:00:00,7,5,2,FMN 05 Gerard Le Grellelaan
653,Gerard le Grellelaan 10,2022-11-04,01:00:00,3,0,3,FMN 05 Gerard Le Grellelaan
653,Gerard le Grellelaan 10,2022-11-04,02:00:00,3,2,1,FMN 05 Gerard Le Grellelaan
653,Gerard le Grellelaan 10,2022-11-04,03:00:00,8,7,1,FMN 05 Gerard Le Grellelaan
653,Gerard le Grellelaan 10,2022-11-04,04:00:00,6,4,2,FMN 05 Gerard Le Grellelaan
653,Gerard le Grellelaan 10,2022-11-04,05:00:00,18,7,11,FMN 05 Gerard Le Grellelaan
653,Gerard le Grellelaan 10,2022-11-04,06:00:00,31,15,16,FMN 05 Gerard Le Grellelaan
653,Gerard le Grellelaan 10,2022-11-04,07:00:00,56,35,21,FMN 05 Gerard Le Grellelaan
653,Gerard le Grellelaan 10,2022-11-04,08:00:00,92,83,9,FMN 05 Gerard Le Grellelaan
653,Gerard le Grellelaan 10,2022-11-04,09:00:00,60,47,13,FMN 05 Gerard Le Grellelaan
653,Gerard le Grellelaan 10,2022-11-04,10:00:00,56,48,8,FMN 05 Gerard Le Grellelaan
653,Gerard le Grellelaan 10,2022-11-04,11:00:00,50,39,11,FMN 05 Gerard Le Grellelaan
653,Gerard le Grellelaan 10,2022-11-04,12:00:00,66,58,8,FMN 05 Gerard Le Grellelaan
653,Gerard le Grellelaan 10,2022-11-04,13:00:00,73,58,15,FMN 05 Gerard Le Grellelaan
653,Gerard le Grellelaan 10,2022-11-04,14:00:00,65,59,6,FMN 05 Gerard Le Grellelaan
653,Gerard le Grellelaan 10,2022-11-04,15:00:00,127,114,13,FMN 05 Gerard Le Grellelaan
653,Gerard le Grellelaan 10,2022-11-04,16:00:00,106,97,9,FMN 05 Gerard Le Grellelaan
653,Gerard le Grellelaan 10,2022-11-04,17:00:00,133,102,31,FMN 05 Gerard Le Grellelaan
653,Gerard le Grellelaan 10,2022-11-04,18:00:00,82,66,16,FMN 05 Gerard Le Grellelaan
653,Gerard le Grellelaan 10,2022-11-04,19:00:00,51,44,7,FMN 05 Gerard Le Grellelaan
653,Gerard le Grellelaan 10,2022-11-04,20:00:00,34,26,8,FMN 05 Gerard Le Grellelaan
653,Gerard le Grellelaan 10,2022-11-04,21:00:00,21,19,2,FMN 05 Gerard Le Grellelaan
653,Gerard le Grellelaan 10,2022-11-04,22:00:00,24,21,3,FMN 05 Gerard Le Grellelaan
653,Gerard le Grellelaan 10,2022-11-04,23:00:00,32,23,9,FMN 05 Gerard Le Grellelaan
653,Gerard le Grellelaan 10,2022-11-05,00:00:00,8,7,1,FMN 05 Gerard Le Grellelaan
653,Gerard le Grellelaan 10,2022-11-05,01:00:00,4,3,1,FMN 05 Gerard Le Grellelaan
653,Gerard le Grellelaan 10,2022-11-05,02:00:00,8,7,1,FMN 05 Gerard Le Grellelaan
653,Gerard le Grellelaan 10,2022-11-05,03:00:00,5,3,2,FMN 05 Gerard Le Grellelaan
653,Gerard le Grellelaan 10,2022-11-05,04:00:00,7,5,2,FMN 05 Gerard Le Grellelaan
653,Gerard le Grellelaan 10,2022-11-05,05:00:00,8,7,1,FMN 05 Gerard Le Grellelaan
653,Gerard le Grellelaan 10,2022-11-05,06:00:00,14,10,4,FMN 05 Gerard Le Grellelaan
653,Gerard le Grellelaan 10,2022-11-05,07:00:00,12,9,3,FMN 05 Gerard Le Grellelaan
653,Gerard le Grellelaan 10,2022-11-05,08:00:00,20,13,7,FMN 05 Gerard Le Grellelaan
653,Gerard le Grellelaan 10,2022-11-05,09:00:00,35,29,6,FMN 05 Gerard Le Grellelaan
653,Gerard le Grellelaan 10,2022-11-05,10:00:00,43,32,11,FMN 05 Gerard Le Grellelaan
653,Gerard le Grellelaan 10,2022-11-05,11:00:00,64,52,12,FMN 05 Gerard Le Grellelaan
653,Gerard le Grellelaan 10,2022-11-05,12:00:00,74,69,5,FMN 05 Gerard Le Grellelaan
653,Gerard le Grellelaan 10,2022-11-05,13:00:00,60,45,15,FMN 05 Gerard Le Grellelaan
653,Gerard le Grellelaan 10,2022-11-05,14:00:00,70,62,8,FMN 05 Gerard Le Grellelaan
653,Gerard le Grellelaan 10,2022-11-05,15:00:00,75,59,16,FMN 05 Gerard Le Grellelaan
653,Gerard le Grellelaan 10,2022-11-05,16:00:00,73,61,12,FMN 05 Gerard Le Grellelaan
653,Gerard le Grellelaan 10,2022-11-05,17:00:00,63,52,11,FMN 05 Gerard Le Grellelaan
653,Gerard le Grellelaan 10,2022-11-05,18:00:00,45,36,9,FMN 05 Gerard Le Grellelaan
653,Gerard le Grellelaan 10,2022-11-05,19:00:00,28,25,3,FMN 05 Gerard Le Grellelaan
653,Gerard le Grellelaan 10,2022-11-05,20:00:00,43,34,9,FMN 05 Gerard Le Grellelaan
653,Gerard le Grellelaan 10,2022-11-05,21:00:00,24,17,7,FMN 05 Gerard Le Grellelaan
653,Gerard le Grellelaan 10,2022-11-05,22:00:00,13,12,1,FMN 05 Gerard Le Grellelaan
653,Gerard le Grellelaan 10,2022-11-05,23:00:00,15,12,3,FMN 05 Gerard Le Grellelaan
653,Gerard le Grellelaan 10,2022-11-06,00:00:00,10,7,3,FMN 05 Gerard Le Grellelaan
653,Gerard le Grellelaan 10,2022-11-06,01:00:00,6,3,3,FMN 05 Gerard Le Grellelaan
653,Gerard le Grellelaan 10,2022-11-06,02:00:00,6,6,0,FMN 05 Gerard Le Grellelaan
653,Gerard le Grellelaan 10,2022-11-06,03:00:00,2,1,1,FMN 05 Gerard Le Grellelaan
653,Gerard le Grellelaan 10,2022-11-06,04:00:00,0,0,0,FMN 05 Gerard Le Grellelaan
653,Gerard le Grellelaan 10,2022-11-06,05:00:00,5,2,3,FMN 05 Gerard Le Grellelaan
653,Gerard le Grellelaan 10,2022-11-06,06:00:00,6,5,1,FMN 05 Gerard Le Grellelaan
653,Gerard le Grellelaan 10,2022-11-06,07:00:00,12,12,0,FMN 05 Gerard Le Grellelaan
653,Gerard le Grellelaan 10,2022-11-06,08:00:00,14,10,4,FMN 05 Gerard Le Grellelaan
653,Gerard le Grellelaan 10,2022-11-06,09:00:00,43,36,7,FMN 05 Gerard Le Grellelaan
653,Gerard le Grellelaan 10,2022-11-06,10:00:00,64,44,20,FMN 05 Gerard Le Grellelaan
653,Gerard le Grellelaan 10,2022-11-06,11:00:00,46,41,5,FMN 05 Gerard Le Grellelaan
653,Gerard le Grellelaan 10,2022-11-06,12:00:00,52,49,3,FMN 05 Gerard Le Grellelaan
653,Gerard le Grellelaan 10,2022-11-06,13:00:00,46,35,11,FMN 05 Gerard Le Grellelaan
653,Gerard le Grellelaan 10,2022-11-06,14:00:00,23,18,5,FMN 05 Gerard Le Grellelaan
653,Gerard le Grellelaan 10,2022-11-06,15:00:00,16,15,1,FMN 05 Gerard Le Grellelaan
653,Gerard le Grellelaan 10,2022-11-06,16:00:00,16,14,2,FMN 05 Gerard Le Grellelaan
653,Gerard le Grellelaan 10,2022-11-06,17:00:00,20,18,2,FMN 05 Gerard Le Grellelaan
653,Gerard le Grellelaan 10,2022-11-06,18:00:00,16,13,3,FMN 05 Gerard Le Grellelaan
653,Gerard le Grellelaan 10,2022-11-06,19:00:00,13,10,3,FMN 05 Gerard Le Grellelaan
653,Gerard le Grellelaan 10,2022-11-06,20:00:00,13,10,3,FMN 05 Gerard Le Grellelaan
653,Gerard le Grellelaan 10,2022-11-06,21:00:00,15,9,6,FMN 05 Gerard Le Grellelaan
653,Gerard le Grellelaan 10,2022-11-06,22:00:00,9,6,3,FMN 05 Gerard Le Grellelaan
653,Gerard le Grellelaan 10,2022-11-06,23:00:00,8,7,1,FMN 05 Gerard Le Grellelaan
653,Gerard le Grellelaan 10,2022-11-07,00:00:00,1,0,1,FMN 05 Gerard Le Grellelaan
653,Gerard le Grellelaan 10,2022-11-07,01:00:00,0,0,0,FMN 05 Gerard Le Grellelaan
653,Gerard le Grellelaan 10,2022-11-07,02:00:00,1,1,0,FMN 05 Gerard Le Grellelaan
653,Gerard le Grellelaan 10,2022-11-07,03:00:00,0,0,0,FMN 05 Gerard Le Grellelaan
653,Gerard le Grellelaan 10,2022-11-07,04:00:00,11,5,6,FMN 05 Gerard Le Grellelaan
653,Gerard le Grellelaan 10,2022-11-07,05:00:00,27,8,19,FMN 05 Gerard Le Grellelaan
653,Gerard le Grellelaan 10,2022-11-07,06:00:00,48,24,24,FMN 05 Gerard Le Grellelaan
653,Gerard le Grellelaan 10,2022-11-07,07:00:00,126,90,36,FMN 05 Gerard Le Grellelaan
653,Gerard le Grellelaan 10,2022-11-07,08:00:00,271,211,60,FMN 05 Gerard Le Grellelaan
653,Gerard le Grellelaan 10,2022-11-07,09:00:00,86,76,10,FMN 05 Gerard Le Grellelaan
653,Gerard le Grellelaan 10,2022-11-07,10:00:00,49,42,7,FMN 05 Gerard Le Grellelaan
653,Gerard le Grellelaan 10,2022-11-07,11:00:00,43,34,9,FMN 05 Gerard Le Grellelaan
653,Gerard le Grellelaan 10,2022-11-07,12:00:00,75,63,12,FMN 05 Gerard Le Grellelaan
653,Gerard le Grellelaan 10,2022-11-07,13:00:00,74,66,8,FMN 05 Gerard Le Grellelaan
653,Gerard le Grellelaan 10,2022-11-07,14:00:00,64,47,17,FMN 05 Gerard Le Grellelaan
653,Gerard le Grellelaan 10,2022-11-07,15:00:00,139,113,26,FMN 05 Gerard Le Grellelaan
653,Gerard le Grellelaan 10,2022-11-07,16:00:00,166,127,39,FMN 05 Gerard Le Grellelaan
653,Gerard le Grellelaan 10,2022-11-07,17:00:00,172,134,38,FMN 05 Gerard Le Grellelaan
653,Gerard le Grellelaan 10,2022-11-07,18:00:00,115,99,16,FMN 05 Gerard Le Grellelaan
653,Gerard le Grellelaan 10,2022-11-07,19:00:00,79,64,15,FMN 05 Gerard Le Grellelaan
653,Gerard le Grellelaan 10,2022-11-07,20:00:00,53,44,9,FMN 05 Gerard Le Grellelaan
653,Gerard le Grellelaan 10,2022-11-07,21:00:00,28,21,7,FMN 05 Gerard Le Grellelaan
653,Gerard le Grellelaan 10,2022-11-07,22:00:00,47,43,4,FMN 05 Gerard Le Grellelaan
653,Gerard le Grellelaan 10,2022-11-07,23:00:00,17,13,4,FMN 05 Gerard Le Grellelaan
653,Gerard le Grellelaan 10,2022-11-08,00:00:00,3,2,1,FMN 05 Gerard Le Grellelaan
653,Gerard le Grellelaan 10,2022-11-08,01:00:00,2,2,0,FMN 05 Gerard Le Grellelaan
653,Gerard le Grellelaan 10,2022-11-08,02:00:00,3,3,0,FMN 05 Gerard Le Grellelaan
653,Gerard le Grellelaan 10,2022-11-08,03:00:00,4,2,2,FMN 05 Gerard Le Grellelaan
653,Gerard le Grellelaan 10,2022-11-08,04:00:00,9,5,4,FMN 05 Gerard Le Grellelaan
653,Gerard le Grellelaan 10,2022-11-08,05:00:00,23,7,16,FMN 05 Gerard Le Grellelaan
653,Gerard le Grellelaan 10,2022-11-08,06:00:00,53,27,26,FMN 05 Gerard Le Grellelaan
653,Gerard le Grellelaan 10,2022-11-08,07:00:00,165,122,43,FMN 05 Gerard Le Grellelaan
653,Gerard le Grellelaan 10,2022-11-08,08:00:00,337,265,72,FMN 05 Gerard Le Grellelaan
653,Gerard le Grellelaan 10,2022-11-08,09:00:00,112,91,21,FMN 05 Gerard Le Grellelaan
653,Gerard le Grellelaan 10,2022-11-08,10:00:00,67,57,10,FMN 05 Gerard Le Grellelaan
653,Gerard le Grellelaan 10,2022-11-08,11:00:00,70,62,8,FMN 05 Gerard Le Grellelaan
653,Gerard le Grellelaan 10,2022-11-08,12:00:00,122,103,19,FMN 05 Gerard Le Grellelaan
653,Gerard le Grellelaan 10,2022-11-08,13:00:00,112,82,30,FMN 05 Gerard Le Grellelaan
653,Gerard le Grellelaan 10,2022-11-08,14:00:00,73,62,11,FMN 05 Gerard Le Grellelaan
653,Gerard le Grellelaan 10,2022-11-08,15:00:00,136,102,34,FMN 05 Gerard Le Grellelaan
653,Gerard le Grellelaan 10,2022-11-08,16:00:00,192,146,46,FMN 05 Gerard Le Grellelaan
653,Gerard le Grellelaan 10,2022-11-08,17:00:00,240,186,54,FMN 05 Gerard Le Grellelaan
653,Gerard le Grellelaan 10,2022-11-08,18:00:00,148,113,35,FMN 05 Gerard Le Grellelaan
653,Gerard le Grellelaan 10,2022-11-08,19:00:00,77,64,13,FMN 05 Gerard Le Grellelaan
653,Gerard le Grellelaan 10,2022-11-08,20:00:00,45,38,7,FMN 05 Gerard Le Grellelaan
653,Gerard le Grellelaan 10,2022-11-08,21:00:00,43,34,9,FMN 05 Gerard Le Grellelaan
653,Gerard le Grellelaan 10,2022-11-08,22:00:00,48,39,9,FMN 05 Gerard Le Grellelaan
653,Gerard le Grellelaan 10,2022-11-08,23:00:00,16,11,5,FMN 05 Gerard Le Grellelaan
653,Gerard le Grellelaan 10,2022-11-09,00:00:00,6,3,3,FMN 05 Gerard Le Grellelaan
653,Gerard le Grellelaan 10,2022-11-09,01:00:00,1,0,1,FMN 05 Gerard Le Grellelaan
653,Gerard le Grellelaan 10,2022-11-09,02:00:00,2,2,0,FMN 05 Gerard Le Grellelaan
653,Gerard le Grellelaan 10,2022-11-09,03:00:00,5,4,1,FMN 05 Gerard Le Grellelaan
653,Gerard le Grellelaan 10,2022-11-09,04:00:00,5,2,3,FMN 05 Gerard Le Grellelaan
653,Gerard le Grellelaan 10,2022-11-09,05:00:00,23,12,11,FMN 05 Gerard Le Grellelaan
653,Gerard le Grellelaan 10,2022-11-09,06:00:00,29,11,18,FMN 05 Gerard Le Grellelaan
653,Gerard le Grellelaan 10,2022-11-09,07:00:00,124,99,25,FMN 05 Gerard Le Grellelaan
653,Gerard le Grellelaan 10,2022-11-09,08:00:00,287,228,59,FMN 05 Gerard Le Grellelaan
653,Gerard le Grellelaan 10,2022-11-09,09:00:00,110,91,19,FMN 05 Gerard Le Grellelaan
653,Gerard le Grellelaan 10,2022-11-09,10:00:00,74,57,17,FMN 05 Gerard Le Grellelaan
653,Gerard le Grellelaan 10,2022-11-09,11:00:00,77,69,8,FMN 05 Gerard Le Grellelaan
653,Gerard le Grellelaan 10,2022-11-09,12:00:00,167,136,31,FMN 05 Gerard Le Grellelaan
653,Gerard le Grellelaan 10,2022-11-09,13:00:00,108,81,27,FMN 05 Gerard Le Grellelaan
653,Gerard le Grellelaan 10,2022-11-09,14:00:00,100,81,19,FMN 05 Gerard Le Grellelaan
653,Gerard le Grellelaan 10,2022-11-09,15:00:00,123,102,21,FMN 05 Gerard Le Grellelaan
653,Gerard le Grellelaan 10,2022-11-09,16:00:00,147,121,26,FMN 05 Gerard Le Grellelaan
653,Gerard le Grellelaan 10,2022-11-09,17:00:00,170,144,26,FMN 05 Gerard Le Grellelaan
653,Gerard le Grellelaan 10,2022-11-09,18:00:00,132,103,29,FMN 05 Gerard Le Grellelaan
653,Gerard le Grellelaan 10,2022-11-09,19:00:00,80,64,16,FMN 05 Gerard Le Grellelaan
653,Gerard le Grellelaan 10,2022-11-09,20:00:00,53,44,9,FMN 05 Gerard Le Grellelaan
653,Gerard le Grellelaan 10,2022-11-09,21:00:00,36,26,10,FMN 05 Gerard Le Grellelaan
653,Gerard le Grellelaan 10,2022-11-09,22:00:00,39,31,8,FMN 05 Gerard Le Grellelaan
653,Gerard le Grellelaan 10,2022-11-09,23:00:00,23,18,5,FMN 05 Gerard Le Grellelaan
653,Gerard le Grellelaan 10,2022-11-10,00:00:00,5,4,1,FMN 05 Gerard Le Grellelaan
653,Gerard le Grellelaan 10,2022-11-10,01:00:00,2,1,1,FMN 05 Gerard Le Grellelaan
653,Gerard le Grellelaan 10,2022-11-10,02:00:00,2,2,0,FMN 05 Gerard Le Grellelaan
653,Gerard le Grellelaan 10,2022-11-10,03:00:00,2,2,0,FMN 05 Gerard Le Grellelaan
653,Gerard le Grellelaan 10,2022-11-10,04:00:00,11,6,5,FMN 05 Gerard Le Grellelaan
653,Gerard le Grellelaan 10,2022-11-10,05:00:00,24,8,16,FMN 05 Gerard Le Grellelaan
653,Gerard le Grellelaan 10,2022-11-10,06:00:00,42,19,23,FMN 05 Gerard Le Grellelaan
653,Gerard le Grellelaan 10,2022-11-10,07:00:00,135,104,31,FMN 05 Gerard Le Grellelaan
653,Gerard le Grellelaan 10,2022-11-10,08:00:00,284,236,48,FMN 05 Gerard Le Grellelaan
653,Gerard le Grellelaan 10,2022-11-10,09:00:00,116,95,21,FMN 05 Gerard Le Grellelaan
653,Gerard le Grellelaan 10,2022-11-10,10:00:00,70,59,11,FMN 05 Gerard Le Grellelaan
653,Gerard le Grellelaan 10,2022-11-10,11:00:00,81,68,13,FMN 05 Gerard Le Grellelaan
653,Gerard le Grellelaan 10,2022-11-10,12:00:00,90,71,19,FMN 05 Gerard Le Grellelaan
653,Gerard le Grellelaan 10,2022-11-10,13:00:00,117,102,15,FMN 05 Gerard Le Grellelaan
653,Gerard le Grellelaan 10,2022-11-10,14:00:00,99,77,22,FMN 05 Gerard Le Grellelaan
653,Gerard le Grellelaan 10,2022-11-10,15:00:00,176,144,32,FMN 05 Gerard Le Grellelaan
653,Gerard le Grellelaan 10,2022-11-10,16:00:00,192,152,40,FMN 05 Gerard Le Grellelaan
653,Gerard le Grellelaan 10,2022-11-10,17:00:00,194,145,49,FMN 05 Gerard Le Grellelaan
653,Gerard le Grellelaan 10,2022-11-10,18:00:00,137,105,32,FMN 05 Gerard Le Grellelaan
653,Gerard le Grellelaan 10,2022-11-10,19:00:00,107,92,15,FMN 05 Gerard Le Grellelaan
653,Gerard le Grellelaan 10,2022-11-10,20:00:00,83,70,13,FMN 05 Gerard Le Grellelaan
653,Gerard le Grellelaan 10,2022-11-10,21:00:00,47,43,4,FMN 05 Gerard Le Grellelaan
653,Gerard le Grellelaan 10,2022-11-10,22:00:00,39,30,9,FMN 05 Gerard Le Grellelaan
653,Gerard le Grellelaan 10,2022-11-10,23:00:00,15,11,4,FMN 05 Gerard Le Grellelaan
653,Gerard le Grellelaan 10,2022-11-11,00:00:00,31,17,14,FMN 05 Gerard Le Grellelaan
653,Gerard le Grellelaan 10,2022-11-11,01:00:00,12,7,5,FMN 05 Gerard Le Grellelaan
653,Gerard le Grellelaan 10,2022-11-11,02:00:00,15,7,8,FMN 05 Gerard Le Grellelaan
653,Gerard le Grellelaan 10,2022-11-11,03:00:00,20,16,4,FMN 05 Gerard Le Grellelaan
653,Gerard le Grellelaan 10,2022-11-11,04:00:00,20,14,6,FMN 05 Gerard Le Grellelaan
653,Gerard le Grellelaan 10,2022-11-11,05:00:00,22,17,5,FMN 05 Gerard Le Grellelaan
653,Gerard le Grellelaan 10,2022-11-11,06:00:00,17,15,2,FMN 05 Gerard Le Grellelaan
653,Gerard le Grellelaan 10,2022-11-11,07:00:00,17,15,2,FMN 05 Gerard Le Grellelaan
653,Gerard le Grellelaan 10,2022-11-11,08:00:00,25,17,8,FMN 05 Gerard Le Grellelaan
653,Gerard le Grellelaan 10,2022-11-11,09:00:00,37,32,5,FMN 05 Gerard Le Grellelaan
653,Gerard le Grellelaan 10,2022-11-11,10:00:00,37,31,6,FMN 05 Gerard Le Grellelaan
653,Gerard le Grellelaan 10,2022-11-11,11:00:00,37,29,8,FMN 05 Gerard Le Grellelaan
653,Gerard le Grellelaan 10,2022-11-11,12:00:00,72,58,14,FMN 05 Gerard Le Grellelaan
653,Gerard le Grellelaan 10,2022-11-11,13:00:00,77,60,17,FMN 05 Gerard Le Grellelaan
653,Gerard le Grellelaan 10,2022-11-11,14:00:00,100,85,15,FMN 05 Gerard Le Grellelaan
653,Gerard le Grellelaan 10,2022-11-11,15:00:00,91,72,19,FMN 05 Gerard Le Grellelaan
653,Gerard le Grellelaan 10,2022-11-11,16:00:00,102,84,18,FMN 05 Gerard Le Grellelaan
653,Gerard le Grellelaan 10,2022-11-11,17:00:00,82,72,10,FMN 05 Gerard Le Grellelaan
653,Gerard le Grellelaan 10,2022-11-11,18:00:00,54,45,9,FMN 05 Gerard Le Grellelaan
653,Gerard le Grellelaan 10,2022-11-11,19:00:00,40,32,8,FMN 05 Gerard Le Grellelaan
653,Gerard le Grellelaan 10,2022-11-11,20:00:00,28,23,5,FMN 05 Gerard Le Grellelaan
653,Gerard le Grellelaan 10,2022-11-11,21:00:00,28,24,4,FMN 05 Gerard Le Grellelaan
653,Gerard le Grellelaan 10,2022-11-11,22:00:00,19,14,5,FMN 05 Gerard Le Grellelaan
653,Gerard le Grellelaan 10,2022-11-11,23:00:00,18,16,2,FMN 05 Gerard Le Grellelaan
653,Gerard le Grellelaan 10,2022-11-12,00:00:00,7,6,1,FMN 05 Gerard Le Grellelaan
653,Gerard le Grellelaan 10,2022-11-12,01:00:00,7,2,5,FMN 05 Gerard Le Grellelaan
653,Gerard le Grellelaan 10,2022-11-12,02:00:00,2,2,0,FMN 05 Gerard Le Grellelaan
653,Gerard le Grellelaan 10,2022-11-12,03:00:00,5,4,1,FMN 05 Gerard Le Grellelaan
653,Gerard le Grellelaan 10,2022-11-12,04:00:00,5,3,2,FMN 05 Gerard Le Grellelaan
653,Gerard le Grellelaan 10,2022-11-12,05:00:00,5,3,2,FMN 05 Gerard Le Grellelaan
653,Gerard le Grellelaan 10,2022-11-12,06:00:00,3,1,2,FMN 05 Gerard Le Grellelaan
653,Gerard le Grellelaan 10,2022-11-12,07:00:00,16,10,6,FMN 05 Gerard Le Grellelaan
653,Gerard le Grellelaan 10,2022-11-12,08:00:00,23,18,5,FMN 05 Gerard Le Grellelaan
653,Gerard le Grellelaan 10,2022-11-12,09:00:00,52,47,5,FMN 05 Gerard Le Grellelaan
653,Gerard le Grellelaan 10,2022-11-12,10:00:00,46,41,5,FMN 05 Gerard Le Grellelaan
653,Gerard le Grellelaan 10,2022-11-12,11:00:00,72,55,17,FMN 05 Gerard Le Grellelaan
653,Gerard le Grellelaan 10,2022-11-12,12:00:00,86,69,17,FMN 05 Gerard Le Grellelaan
653,Gerard le Grellelaan 10,2022-11-12,13:00:00,93,75,18,FMN 05 Gerard Le Grellelaan
653,Gerard le Grellelaan 10,2022-11-12,14:00:00,82,64,18,FMN 05 Gerard Le Grellelaan
653,Gerard le Grellelaan 10,2022-11-12,15:00:00,93,78,15,FMN 05 Gerard Le Grellelaan
653,Gerard le Grellelaan 10,2022-11-12,16:00:00,84,75,9,FMN 05 Gerard Le Grellelaan
653,Gerard le Grellelaan 10,2022-11-12,17:00:00,112,98,14,FMN 05 Gerard Le Grellelaan
653,Gerard le Grellelaan 10,2022-11-12,18:00:00,58,49,9,FMN 05 Gerard Le Grellelaan
653,Gerard le Grellelaan 10,2022-11-12,19:00:00,71,51,20,FMN 05 Gerard Le Grellelaan
653,Gerard le Grellelaan 10,2022-11-12,20:00:00,24,19,5,FMN 05 Gerard Le Grellelaan
653,Gerard le Grellelaan 10,2022-11-12,21:00:00,23,19,4,FMN 05 Gerard Le Grellelaan
653,Gerard le Grellelaan 10,2022-11-12,22:00:00,24,22,2,FMN 05 Gerard Le Grellelaan
653,Gerard le Grellelaan 10,2022-11-12,23:00:00,22,15,7,FMN 05 Gerard Le Grellelaan
653,Gerard le Grellelaan 10,2022-11-13,00:00:00,16,10,6,FMN 05 Gerard Le Grellelaan
653,Gerard le Grellelaan 10,2022-11-13,01:00:00,4,4,0,FMN 05 Gerard Le Grellelaan
653,Gerard le Grellelaan 10,2022-11-13,02:00:00,5,4,1,FMN 05 Gerard Le Grellelaan
653,Gerard le Grellelaan 10,2022-11-13,03:00:00,7,5,2,FMN 05 Gerard Le Grellelaan
653,Gerard le Grellelaan 10,2022-11-13,04:00:00,4,2,2,FMN 05 Gerard Le Grellelaan
653,Gerard le Grellelaan 10,2022-11-13,05:00:00,7,4,3,FMN 05 Gerard Le Grellelaan
653,Gerard le Grellelaan 10,2022-11-13,06:00:00,0,0,0,FMN 05 Gerard Le Grellelaan
653,Gerard le Grellelaan 10,2022-11-13,07:00:00,13,12,1,FMN 05 Gerard Le Grellelaan
653,Gerard le Grellelaan 10,2022-11-13,08:00:00,12,8,4,FMN 05 Gerard Le Grellelaan
653,Gerard le Grellelaan 10,2022-11-13,09:00:00,36,30,6,FMN 05 Gerard Le Grellelaan
653,Gerard le Grellelaan 10,2022-11-13,10:00:00,61,54,7,FMN 05 Gerard Le Grellelaan
653,Gerard le Grellelaan 10,2022-11-13,11:00:00,70,54,16,FMN 05 Gerard Le Grellelaan
653,Gerard le Grellelaan 10,2022-11-13,12:00:00,86,75,11,FMN 05 Gerard Le Grellelaan
653,Gerard le Grellelaan 10,2022-11-13,13:00:00,78,56,22,FMN 05 Gerard Le Grellelaan
653,Gerard le Grellelaan 10,2022-11-13,14:00:00,102,76,26,FMN 05 Gerard Le Grellelaan
653,Gerard le Grellelaan 10,2022-11-13,15:00:00,98,86,12,FMN 05 Gerard Le Grellelaan
653,Gerard le Grellelaan 10,2022-11-13,16:00:00,111,102,9,FMN 05 Gerard Le Grellelaan
653,Gerard le Grellelaan 10,2022-11-13,17:00:00,105,94,11,FMN 05 Gerard Le Grellelaan
653,Gerard le Grellelaan 10,2022-11-13,18:00:00,44,36,8,FMN 05 Gerard Le Grellelaan
653,Gerard le Grellelaan 10,2022-11-13,19:00:00,40,29,11,FMN 05 Gerard Le Grellelaan
653,Gerard le Grellelaan 10,2022-11-13,20:00:00,19,13,6,FMN 05 Gerard Le Grellelaan
653,Gerard le Grellelaan 10,2022-11-13,21:00:00,13,12,1,FMN 05 Gerard Le Grellelaan
653,Gerard le Grellelaan 10,2022-11-13,22:00:00,11,10,1,FMN 05 Gerard Le Grellelaan
653,Gerard le Grellelaan 10,2022-11-13,23:00:00,11,10,1,FMN 05 Gerard Le Grellelaan
653,Gerard le Grellelaan 10,2022-11-14,00:00:00,6,4,2,FMN 05 Gerard Le Grellelaan
653,Gerard le Grellelaan 10,2022-11-14,01:00:00,0,0,0,FMN 05 Gerard Le Grellelaan
653,Gerard le Grellelaan 10,2022-11-14,02:00:00,5,2,3,FMN 05 Gerard Le Grellelaan
653,Gerard le Grellelaan 10,2022-11-14,03:00:00,2,1,1,FMN 05 Gerard Le Grellelaan
653,Gerard le Grellelaan 10,2022-11-14,04:00:00,8,4,4,FMN 05 Gerard Le Grellelaan
653,Gerard le Grellelaan 10,2022-11-14,05:00:00,20,6,14,FMN 05 Gerard Le Grellelaan
653,Gerard le Grellelaan 10,2022-11-14,06:00:00,49,27,22,FMN 05 Gerard Le Grellelaan
653,Gerard le Grellelaan 10,2022-11-14,07:00:00,125,90,35,FMN 05 Gerard Le Grellelaan
653,Gerard le Grellelaan 10,2022-11-14,08:00:00,221,184,37,FMN 05 Gerard Le Grellelaan
653,Gerard le Grellelaan 10,2022-11-14,09:00:00,73,66,7,FMN 05 Gerard Le Grellelaan
653,Gerard le Grellelaan 10,2022-11-14,10:00:00,68,54,14,FMN 05 Gerard Le Grellelaan
653,Gerard le Grellelaan 10,2022-11-14,11:00:00,60,50,10,FMN 05 Gerard Le Grellelaan
653,Gerard le Grellelaan 10,2022-11-14,12:00:00,100,84,16,FMN 05 Gerard Le Grellelaan
653,Gerard le Grellelaan 10,2022-11-14,13:00:00,78,66,12,FMN 05 Gerard Le Grellelaan
653,Gerard le Grellelaan 10,2022-11-14,14:00:00,86,74,12,FMN 05 Gerard Le Grellelaan
653,Gerard le Grellelaan 10,2022-11-14,15:00:00,129,106,23,FMN 05 Gerard Le Grellelaan
653,Gerard le Grellelaan 10,2022-11-14,16:00:00,163,134,29,FMN 05 Gerard Le Grellelaan
653,Gerard le Grellelaan 10,2022-11-14,17:00:00,165,130,35,FMN 05 Gerard Le Grellelaan
653,Gerard le Grellelaan 10,2022-11-14,18:00:00,109,84,25,FMN 05 Gerard Le Grellelaan
653,Gerard le Grellelaan 10,2022-11-14,19:00:00,58,45,13,FMN 05 Gerard Le Grellelaan
653,Gerard le Grellelaan 10,2022-11-14,20:00:00,47,35,12,FMN 05 Gerard Le Grellelaan
653,Gerard le Grellelaan 10,2022-11-14,21:00:00,28,20,8,FMN 05 Gerard Le Grellelaan
653,Gerard le Grellelaan 10,2022-11-14,22:00:00,44,43,1,FMN 05 Gerard Le Grellelaan
653,Gerard le Grellelaan 10,2022-11-14,23:00:00,13,12,1,FMN 05 Gerard Le Grellelaan
653,Gerard le Grellelaan 10,2022-11-15,00:00:00,3,2,1,FMN 05 Gerard Le Grellelaan
653,Gerard le Grellelaan 10,2022-11-15,01:00:00,1,1,0,FMN 05 Gerard Le Grellelaan
653,Gerard le Grellelaan 10,2022-11-15,02:00:00,2,2,0,FMN 05 Gerard Le Grellelaan
653,Gerard le Grellelaan 10,2022-11-15,03:00:00,4,2,2,FMN 05 Gerard Le Grellelaan
653,Gerard le Grellelaan 10,2022-11-15,04:00:00,5,0,5,FMN 05 Gerard Le Grellelaan
653,Gerard le Grellelaan 10,2022-11-15,05:00:00,28,9,19,FMN 05 Gerard Le Grellelaan
653,Gerard le Grellelaan 10,2022-11-15,06:00:00,47,23,24,FMN 05 Gerard Le Grellelaan
653,Gerard le Grellelaan 10,2022-11-15,07:00:00,148,114,34,FMN 05 Gerard Le Grellelaan
653,Gerard le Grellelaan 10,2022-11-15,08:00:00,283,229,54,FMN 05 Gerard Le Grellelaan
653,Gerard le Grellelaan 10,2022-11-15,09:00:00,110,96,14,FMN 05 Gerard Le Grellelaan
653,Gerard le Grellelaan 10,2022-11-15,10:00:00,81,69,12,FMN 05 Gerard Le Grellelaan
653,Gerard le Grellelaan 10,2022-11-15,11:00:00,81,73,8,FMN 05 Gerard Le Grellelaan
653,Gerard le Grellelaan 10,2022-11-15,12:00:00,107,81,26,FMN 05 Gerard Le Grellelaan
653,Gerard le Grellelaan 10,2022-11-15,13:00:00,98,76,22,FMN 05 Gerard Le Grellelaan
653,Gerard le Grellelaan 10,2022-11-15,14:00:00,91,68,23,FMN 05 Gerard Le Grellelaan
653,Gerard le Grellelaan 10,2022-11-15,15:00:00,139,113,26,FMN 05 Gerard Le Grellelaan
653,Gerard le Grellelaan 10,2022-11-15,16:00:00,169,136,33,FMN 05 Gerard Le Grellelaan
653,Gerard le Grellelaan 10,2022-11-15,17:00:00,177,135,42,FMN 05 Gerard Le Grellelaan
653,Gerard le Grellelaan 10,2022-11-15,18:00:00,108,94,14,FMN 05 Gerard Le Grellelaan
653,Gerard le Grellelaan 10,2022-11-15,19:00:00,62,55,7,FMN 05 Gerard Le Grellelaan
653,Gerard le Grellelaan 10,2022-11-15,20:00:00,34,28,6,FMN 05 Gerard Le Grellelaan
653,Gerard le Grellelaan 10,2022-11-15,21:00:00,31,23,8,FMN 05 Gerard Le Grellelaan
653,Gerard le Grellelaan 10,2022-11-15,22:00:00,41,32,9,FMN 05 Gerard Le Grellelaan
653,Gerard le Grellelaan 10,2022-11-15,23:00:00,22,19,3,FMN 05 Gerard Le Grellelaan
653,Gerard le Grellelaan 10,2022-11-16,00:00:00,4,3,1,FMN 05 Gerard Le Grellelaan
653,Gerard le Grellelaan 10,2022-11-16,01:00:00,3,2,1,FMN 05 Gerard Le Grellelaan
653,Gerard le Grellelaan 10,2022-11-16,02:00:00,2,2,0,FMN 05 Gerard Le Grellelaan
653,Gerard le Grellelaan 10,2022-11-16,03:00:00,9,7,2,FMN 05 Gerard Le Grellelaan
653,Gerard le Grellelaan 10,2022-11-16,04:00:00,4,2,2,FMN 05 Gerard Le Grellelaan
653,Gerard le Grellelaan 10,2022-11-16,05:00:00,24,5,19,FMN 05 Gerard Le Grellelaan
653,Gerard le Grellelaan 10,2022-11-16,06:00:00,44,21,23,FMN 05 Gerard Le Grellelaan
653,Gerard le Grellelaan 10,2022-11-16,07:00:00,136,99,37,FMN 05 Gerard Le Grellelaan
653,Gerard le Grellelaan 10,2022-11-16,08:00:00,238,193,45,FMN 05 Gerard Le Grellelaan
653,Gerard le Grellelaan 10,2022-11-16,09:00:00,74,62,12,FMN 05 Gerard Le Grellelaan
653,Gerard le Grellelaan 10,2022-11-16,10:00:00,76,62,14,FMN 05 Gerard Le Grellelaan
653,Gerard le Grellelaan 10,2022-11-16,11:00:00,53,45,8,FMN 05 Gerard Le Grellelaan
653,Gerard le Grellelaan 10,2022-11-16,12:00:00,134,102,32,FMN 05 Gerard Le Grellelaan
653,Gerard le Grellelaan 10,2022-11-16,13:00:00,107,79,28,FMN 05 Gerard Le Grellelaan
653,Gerard le Grellelaan 10,2022-11-16,14:00:00,70,61,9,FMN 05 Gerard Le Grellelaan
653,Gerard le Grellelaan 10,2022-11-16,15:00:00,114,98,16,FMN 05 Gerard Le Grellelaan
653,Gerard le Grellelaan 10,2022-11-16,16:00:00,136,113,23,FMN 05 Gerard Le Grellelaan
653,Gerard le Grellelaan 10,2022-11-16,17:00:00,178,158,20,FMN 05 Gerard Le Grellelaan
653,Gerard le Grellelaan 10,2022-11-16,18:00:00,115,96,19,FMN 05 Gerard Le Grellelaan
653,Gerard le Grellelaan 10,2022-11-16,19:00:00,61,53,8,FMN 05 Gerard Le Grellelaan
653,Gerard le Grellelaan 10,2022-11-16,20:00:00,51,42,9,FMN 05 Gerard Le Grellelaan
653,Gerard le Grellelaan 10,2022-11-16,21:00:00,30,23,7,FMN 05 Gerard Le Grellelaan
653,Gerard le Grellelaan 10,2022-11-16,22:00:00,38,32,6,FMN 05 Gerard Le Grellelaan
653,Gerard le Grellelaan 10,2022-11-16,23:00:00,6,5,1,FMN 05 Gerard Le Grellelaan
653,Gerard le Grellelaan 10,2022-11-17,00:00:00,9,6,3,FMN 05 Gerard Le Grellelaan
653,Gerard le Grellelaan 10,2022-11-17,01:00:00,3,3,0,FMN 05 Gerard Le Grellelaan
653,Gerard le Grellelaan 10,2022-11-17,02:00:00,2,2,0,FMN 05 Gerard Le Grellelaan
653,Gerard le Grellelaan 10,2022-11-17,03:00:00,2,1,1,FMN 05 Gerard Le Grellelaan
653,Gerard le Grellelaan 10,2022-11-17,04:00:00,4,1,3,FMN 05 Gerard Le Grellelaan
653,Gerard le Grellelaan 10,2022-11-17,05:00:00,26,8,18,FMN 05 Gerard Le Grellelaan
653,Gerard le Grellelaan 10,2022-11-17,06:00:00,29,16,13,FMN 05 Gerard Le Grellelaan
653,Gerard le Grellelaan 10,2022-11-17,07:00:00,113,84,29,FMN 05 Gerard Le Grellelaan
653,Gerard le Grellelaan 10,2022-11-17,08:00:00,232,183,49,FMN 05 Gerard Le Grellelaan
653,Gerard le Grellelaan 10,2022-11-17,09:00:00,75,67,8,FMN 05 Gerard Le Grellelaan
653,Gerard le Grellelaan 10,2022-11-17,10:00:00,58,50,8,FMN 05 Gerard Le Grellelaan
653,Gerard le Grellelaan 10,2022-11-17,11:00:00,54,51,3,FMN 05 Gerard Le Grellelaan
653,Gerard le Grellelaan 10,2022-11-17,12:00:00,67,59,8,FMN 05 Gerard Le Grellelaan
653,Gerard le Grellelaan 10,2022-11-17,13:00:00,61,41,20,FMN 05 Gerard Le Grellelaan
653,Gerard le Grellelaan 10,2022-11-17,14:00:00,48,40,8,FMN 05 Gerard Le Grellelaan
653,Gerard le Grellelaan 10,2022-11-17,15:00:00,110,95,15,FMN 05 Gerard Le Grellelaan
653,Gerard le Grellelaan 10,2022-11-17,16:00:00,154,126,28,FMN 05 Gerard Le Grellelaan
653,Gerard le Grellelaan 10,2022-11-17,17:00:00,193,152,41,FMN 05 Gerard Le Grellelaan
653,Gerard le Grellelaan 10,2022-11-17,18:00:00,115,94,21,FMN 05 Gerard Le Grellelaan
653,Gerard le Grellelaan 10,2022-11-17,19:00:00,79,68,11,FMN 05 Gerard Le Grellelaan
653,Gerard le Grellelaan 10,2022-11-17,20:00:00,53,40,13,FMN 05 Gerard Le Grellelaan
653,Gerard le Grellelaan 10,2022-11-17,21:00:00,31,24,7,FMN 05 Gerard Le Grellelaan
653,Gerard le Grellelaan 10,2022-11-17,22:00:00,49,38,11,FMN 05 Gerard Le Grellelaan
653,Gerard le Grellelaan 10,2022-11-17,23:00:00,15,11,4,FMN 05 Gerard Le Grellelaan
653,Gerard le Grellelaan 10,2022-11-18,00:00:00,5,2,3,FMN 05 Gerard Le Grellelaan
653,Gerard le Grellelaan 10,2022-11-18,01:00:00,0,0,0,FMN 05 Gerard Le Grellelaan
653,Gerard le Grellelaan 10,2022-11-18,02:00:00,3,3,0,FMN 05 Gerard Le Grellelaan
653,Gerard le Grellelaan 10,2022-11-18,03:00:00,8,5,3,FMN 05 Gerard Le Grellelaan
653,Gerard le Grellelaan 10,2022-11-18,04:00:00,8,5,3,FMN 05 Gerard Le Grellelaan
653,Gerard le Grellelaan 10,2022-11-18,05:00:00,15,3,12,FMN 05 Gerard Le Grellelaan
653,Gerard le Grellelaan 10,2022-11-18,06:00:00,43,25,18,FMN 05 Gerard Le Grellelaan
653,Gerard le Grellelaan 10,2022-11-18,07:00:00,113,92,21,FMN 05 Gerard Le Grellelaan
653,Gerard le Grellelaan 10,2022-11-18,08:00:00,219,175,44,FMN 05 Gerard Le Grellelaan
653,Gerard le Grellelaan 10,2022-11-18,09:00:00,78,65,13,FMN 05 Gerard Le Grellelaan
653,Gerard le Grellelaan 10,2022-11-18,10:00:00,76,59,17,FMN 05 Gerard Le Grellelaan
653,Gerard le Grellelaan 10,2022-11-18,11:00:00,62,56,6,FMN 05 Gerard Le Grellelaan
653,Gerard le Grellelaan 10,2022-11-18,12:00:00,73,57,16,FMN 05 Gerard Le Grellelaan
653,Gerard le Grellelaan 10,2022-11-18,13:00:00,57,42,15,FMN 05 Gerard Le Grellelaan
653,Gerard le Grellelaan 10,2022-11-18,14:00:00,68,63,5,FMN 05 Gerard Le Grellelaan
653,Gerard le Grellelaan 10,2022-11-18,15:00:00,113,88,25,FMN 05 Gerard Le Grellelaan
653,Gerard le Grellelaan 10,2022-11-18,16:00:00,125,100,25,FMN 05 Gerard Le Grellelaan
653,Gerard le Grellelaan 10,2022-11-18,17:00:00,123,97,26,FMN 05 Gerard Le Grellelaan
653,Gerard le Grellelaan 10,2022-11-18,18:00:00,74,59,15,FMN 05 Gerard Le Grellelaan
653,Gerard le Grellelaan 10,2022-11-18,19:00:00,39,30,9,FMN 05 Gerard Le Grellelaan
653,Gerard le Grellelaan 10,2022-11-18,20:00:00,30,24,6,FMN 05 Gerard Le Grellelaan
653,Gerard le Grellelaan 10,2022-11-18,21:00:00,29,24,5,FMN 05 Gerard Le Grellelaan
653,Gerard le Grellelaan 10,2022-11-18,22:00:00,18,15,3,FMN 05 Gerard Le Grellelaan
653,Gerard le Grellelaan 10,2022-11-18,23:00:00,23,19,4,FMN 05 Gerard Le Grellelaan
653,Gerard le Grellelaan 10,2022-11-19,00:00:00,9,6,3,FMN 05 Gerard Le Grellelaan
653,Gerard le Grellelaan 10,2022-11-19,01:00:00,7,7,0,FMN 05 Gerard Le Grellelaan
653,Gerard le Grellelaan 10,2022-11-19,02:00:00,2,1,1,FMN 05 Gerard Le Grellelaan
653,Gerard le Grellelaan 10,2022-11-19,03:00:00,6,5,1,FMN 05 Gerard Le Grellelaan
653,Gerard le Grellelaan 10,2022-11-19,04:00:00,5,3,2,FMN 05 Gerard Le Grellelaan
653,Gerard le Grellelaan 10,2022-11-19,05:00:00,7,5,2,FMN 05 Gerard Le Grellelaan
653,Gerard le Grellelaan 10,2022-11-19,06:00:00,4,2,2,FMN 05 Gerard Le Grellelaan
653,Gerard le Grellelaan 10,2022-11-19,07:00:00,10,9,1,FMN 05 Gerard Le Grellelaan
653,Gerard le Grellelaan 10,2022-11-19,08:00:00,22,19,3,FMN 05 Gerard Le Grellelaan
653,Gerard le Grellelaan 10,2022-11-19,09:00:00,29,25,4,FMN 05 Gerard Le Grellelaan
653,Gerard le Grellelaan 10,2022-11-19,10:00:00,25,20,5,FMN 05 Gerard Le Grellelaan
653,Gerard le Grellelaan 10,2022-11-19,11:00:00,29,22,7,FMN 05 Gerard Le Grellelaan
653,Gerard le Grellelaan 10,2022-11-19,12:00:00,34,26,8,FMN 05 Gerard Le Grellelaan
653,Gerard le Grellelaan 10,2022-11-19,13:00:00,39,35,4,FMN 05 Gerard Le Grellelaan
653,Gerard le Grellelaan 10,2022-11-19,14:00:00,42,37,5,FMN 05 Gerard Le Grellelaan
653,Gerard le Grellelaan 10,2022-11-19,15:00:00,36,24,12,FMN 05 Gerard Le Grellelaan
653,Gerard le Grellelaan 10,2022-11-19,16:00:00,36,33,3,FMN 05 Gerard Le Grellelaan
653,Gerard le Grellelaan 10,2022-11-19,17:00:00,58,47,11,FMN 05 Gerard Le Grellelaan
653,Gerard le Grellelaan 10,2022-11-19,18:00:00,42,34,8,FMN 05 Gerard Le Grellelaan
653,Gerard le Grellelaan 10,2022-11-19,19:00:00,38,29,9,FMN 05 Gerard Le Grellelaan
653,Gerard le Grellelaan 10,2022-11-19,20:00:00,25,18,7,FMN 05 Gerard Le Grellelaan
653,Gerard le Grellelaan 10,2022-11-19,21:00:00,13,9,4,FMN 05 Gerard Le Grellelaan
653,Gerard le Grellelaan 10,2022-11-19,22:00:00,13,9,4,FMN 05 Gerard Le Grellelaan
653,Gerard le Grellelaan 10,2022-11-19,23:00:00,6,5,1,FMN 05 Gerard Le Grellelaan
653,Gerard le Grellelaan 10,2022-11-20,00:00:00,20,14,6,FMN 05 Gerard Le Grellelaan
653,Gerard le Grellelaan 10,2022-11-20,01:00:00,8,3,5,FMN 05 Gerard Le Grellelaan
653,Gerard le Grellelaan 10,2022-11-20,02:00:00,4,2,2,FMN 05 Gerard Le Grellelaan
653,Gerard le Grellelaan 10,2022-11-20,03:00:00,1,0,1,FMN 05 Gerard Le Grellelaan
653,Gerard le Grellelaan 10,2022-11-20,04:00:00,5,2,3,FMN 05 Gerard Le Grellelaan
653,Gerard le Grellelaan 10,2022-11-20,05:00:00,1,0,1,FMN 05 Gerard Le Grellelaan
653,Gerard le Grellelaan 10,2022-11-20,06:00:00,5,5,0,FMN 05 Gerard Le Grellelaan
653,Gerard le Grellelaan 10,2022-11-20,07:00:00,6,5,1,FMN 05 Gerard Le Grellelaan
653,Gerard le Grellelaan 10,2022-11-20,08:00:00,16,12,4,FMN 05 Gerard Le Grellelaan
653,Gerard le Grellelaan 10,2022-11-20,09:00:00,53,48,5,FMN 05 Gerard Le Grellelaan
653,Gerard le Grellelaan 10,2022-11-20,10:00:00,37,34,3,FMN 05 Gerard Le Grellelaan
653,Gerard le Grellelaan 10,2022-11-20,11:00:00,36,26,10,FMN 05 Gerard Le Grellelaan
653,Gerard le Grellelaan 10,2022-11-20,12:00:00,48,38,10,FMN 05 Gerard Le Grellelaan
653,Gerard le Grellelaan 10,2022-11-20,13:00:00,42,35,7,FMN 05 Gerard Le Grellelaan
653,Gerard le Grellelaan 10,2022-11-20,14:00:00,23,19,4,FMN 05 Gerard Le Grellelaan
653,Gerard le Grellelaan 10,2022-11-20,15:00:00,20,17,3,FMN 05 Gerard Le Grellelaan
653,Gerard le Grellelaan 10,2022-11-20,16:00:00,21,15,6,FMN 05 Gerard Le Grellelaan
653,Gerard le Grellelaan 10,2022-11-20,17:00:00,23,20,3,FMN 05 Gerard Le Grellelaan
653,Gerard le Grellelaan 10,2022-11-20,18:00:00,20,13,7,FMN 05 Gerard Le Grellelaan
653,Gerard le Grellelaan 10,2022-11-20,19:00:00,20,19,1,FMN 05 Gerard Le Grellelaan
653,Gerard le Grellelaan 10,2022-11-20,20:00:00,9,7,2,FMN 05 Gerard Le Grellelaan
653,Gerard le Grellelaan 10,2022-11-20,21:00:00,13,9,4,FMN 05 Gerard Le Grellelaan
653,Gerard le Grellelaan 10,2022-11-20,22:00:00,18,11,7,FMN 05 Gerard Le Grellelaan
653,Gerard le Grellelaan 10,2022-11-20,23:00:00,5,5,0,FMN 05 Gerard Le Grellelaan
653,Gerard le Grellelaan 10,2022-11-21,00:00:00,3,3,0,FMN 05 Gerard Le Grellelaan
653,Gerard le Grellelaan 10,2022-11-21,01:00:00,1,0,1,FMN 05 Gerard Le Grellelaan
653,Gerard le Grellelaan 10,2022-11-21,02:00:00,4,4,0,FMN 05 Gerard Le Grellelaan
653,Gerard le Grellelaan 10,2022-11-21,03:00:00,2,2,0,FMN 05 Gerard Le Grellelaan
653,Gerard le Grellelaan 10,2022-11-21,04:00:00,4,2,2,FMN 05 Gerard Le Grellelaan
653,Gerard le Grellelaan 10,2022-11-21,05:00:00,23,11,12,FMN 05 Gerard Le Grellelaan
653,Gerard le Grellelaan 10,2022-11-21,06:00:00,43,23,20,FMN 05 Gerard Le Grellelaan
653,Gerard le Grellelaan 10,2022-11-21,07:00:00,105,81,24,FMN 05 Gerard Le Grellelaan
653,Gerard le Grellelaan 10,2022-11-21,08:00:00,244,212,32,FMN 05 Gerard Le Grellelaan
653,Gerard le Grellelaan 10,2022-11-21,09:00:00,85,71,14,FMN 05 Gerard Le Grellelaan
653,Gerard le Grellelaan 10,2022-11-21,10:00:00,41,34,7,FMN 05 Gerard Le Grellelaan
653,Gerard le Grellelaan 10,2022-11-21,11:00:00,55,47,8,FMN 05 Gerard Le Grellelaan
653,Gerard le Grellelaan 10,2022-11-21,12:00:00,75,60,15,FMN 05 Gerard Le Grellelaan
653,Gerard le Grellelaan 10,2022-11-21,13:00:00,64,50,14,FMN 05 Gerard Le Grellelaan
653,Gerard le Grellelaan 10,2022-11-21,14:00:00,62,53,9,FMN 05 Gerard Le Grellelaan
653,Gerard le Grellelaan 10,2022-11-21,15:00:00,130,109,21,FMN 05 Gerard Le Grellelaan
653,Gerard le Grellelaan 10,2022-11-21,16:00:00,149,123,26,FMN 05 Gerard Le Grellelaan
653,Gerard le Grellelaan 10,2022-11-21,17:00:00,141,108,33,FMN 05 Gerard Le Grellelaan
653,Gerard le Grellelaan 10,2022-11-21,18:00:00,91,79,12,FMN 05 Gerard Le Grellelaan
653,Gerard le Grellelaan 10,2022-11-21,19:00:00,40,31,9,FMN 05 Gerard Le Grellelaan
653,Gerard le Grellelaan 10,2022-11-21,20:00:00,25,17,8,FMN 05 Gerard Le Grellelaan
653,Gerard le Grellelaan 10,2022-11-21,21:00:00,23,18,5,FMN 05 Gerard Le Grellelaan
653,Gerard le Grellelaan 10,2022-11-21,22:00:00,30,28,2,FMN 05 Gerard Le Grellelaan
653,Gerard le Grellelaan 10,2022-11-21,23:00:00,10,8,2,FMN 05 Gerard Le Grellelaan
653,Gerard le Grellelaan 10,2022-11-22,00:00:00,1,1,0,FMN 05 Gerard Le Grellelaan
653,Gerard le Grellelaan 10,2022-11-22,01:00:00,3,3,0,FMN 05 Gerard Le Grellelaan
653,Gerard le Grellelaan 10,2022-11-22,02:00:00,1,1,0,FMN 05 Gerard Le Grellelaan
653,Gerard le Grellelaan 10,2022-11-22,03:00:00,1,0,1,FMN 05 Gerard Le Grellelaan
653,Gerard le Grellelaan 10,2022-11-22,04:00:00,8,4,4,FMN 05 Gerard Le Grellelaan
653,Gerard le Grellelaan 10,2022-11-22,05:00:00,21,9,12,FMN 05 Gerard Le Grellelaan
653,Gerard le Grellelaan 10,2022-11-22,06:00:00,33,21,12,FMN 05 Gerard Le Grellelaan
653,Gerard le Grellelaan 10,2022-11-22,07:00:00,106,83,23,FMN 05 Gerard Le Grellelaan
653,Gerard le Grellelaan 10,2022-11-22,08:00:00,237,190,47,FMN 05 Gerard Le Grellelaan
653,Gerard le Grellelaan 10,2022-11-22,09:00:00,74,56,18,FMN 05 Gerard Le Grellelaan
653,Gerard le Grellelaan 10,2022-11-22,10:00:00,53,41,12,FMN 05 Gerard Le Grellelaan
653,Gerard le Grellelaan 10,2022-11-22,11:00:00,54,50,4,FMN 05 Gerard Le Grellelaan
653,Gerard le Grellelaan 10,2022-11-22,12:00:00,61,50,11,FMN 05 Gerard Le Grellelaan
653,Gerard le Grellelaan 10,2022-11-22,13:00:00,58,49,9,FMN 05 Gerard Le Grellelaan
653,Gerard le Grellelaan 10,2022-11-22,14:00:00,63,52,11,FMN 05 Gerard Le Grellelaan
653,Gerard le Grellelaan 10,2022-11-22,15:00:00,112,95,17,FMN 05 Gerard Le Grellelaan
653,Gerard le Grellelaan 10,2022-11-22,16:00:00,153,128,25,FMN 05 Gerard Le Grellelaan
653,Gerard le Grellelaan 10,2022-11-22,17:00:00,174,137,37,FMN 05 Gerard Le Grellelaan
653,Gerard le Grellelaan 10,2022-11-22,18:00:00,95,79,16,FMN 05 Gerard Le Grellelaan
653,Gerard le Grellelaan 10,2022-11-22,19:00:00,50,44,6,FMN 05 Gerard Le Grellelaan
653,Gerard le Grellelaan 10,2022-11-22,20:00:00,38,35,3,FMN 05 Gerard Le Grellelaan
653,Gerard le Grellelaan 10,2022-11-22,21:00:00,23,17,6,FMN 05 Gerard Le Grellelaan
653,Gerard le Grellelaan 10,2022-11-22,22:00:00,41,34,7,FMN 05 Gerard Le Grellelaan
653,Gerard le Grellelaan 10,2022-11-22,23:00:00,8,6,2,FMN 05 Gerard Le Grellelaan
653,Gerard le Grellelaan 10,2022-11-23,00:00:00,3,2,1,FMN 05 Gerard Le Grellelaan
653,Gerard le Grellelaan 10,2022-11-23,01:00:00,3,2,1,FMN 05 Gerard Le Grellelaan
653,Gerard le Grellelaan 10,2022-11-23,02:00:00,3,2,1,FMN 05 Gerard Le Grellelaan
653,Gerard le Grellelaan 10,2022-11-23,03:00:00,3,3,0,FMN 05 Gerard Le Grellelaan
653,Gerard le Grellelaan 10,2022-11-23,04:00:00,10,7,3,FMN 05 Gerard Le Grellelaan
653,Gerard le Grellelaan 10,2022-11-23,05:00:00,26,9,17,FMN 05 Gerard Le Grellelaan
653,Gerard le Grellelaan 10,2022-11-23,06:00:00,35,16,19,FMN 05 Gerard Le Grellelaan
653,Gerard le Grellelaan 10,2022-11-23,07:00:00,112,84,28,FMN 05 Gerard Le Grellelaan
653,Gerard le Grellelaan 10,2022-11-23,08:00:00,231,187,44,FMN 05 Gerard Le Grellelaan
653,Gerard le Grellelaan 10,2022-11-23,09:00:00,85,77,8,FMN 05 Gerard Le Grellelaan
653,Gerard le Grellelaan 10,2022-11-23,10:00:00,52,45,7,FMN 05 Gerard Le Grellelaan
653,Gerard le Grellelaan 10,2022-11-23,11:00:00,49,41,8,FMN 05 Gerard Le Grellelaan
653,Gerard le Grellelaan 10,2022-11-23,12:00:00,99,78,21,FMN 05 Gerard Le Grellelaan
653,Gerard le Grellelaan 10,2022-11-23,13:00:00,67,50,17,FMN 05 Gerard Le Grellelaan
653,Gerard le Grellelaan 10,2022-11-23,14:00:00,47,36,11,FMN 05 Gerard Le Grellelaan
653,Gerard le Grellelaan 10,2022-11-23,15:00:00,80,70,10,FMN 05 Gerard Le Grellelaan
653,Gerard le Grellelaan 10,2022-11-23,16:00:00,115,92,23,FMN 05 Gerard Le Grellelaan
653,Gerard le Grellelaan 10,2022-11-23,17:00:00,131,107,24,FMN 05 Gerard Le Grellelaan
653,Gerard le Grellelaan 10,2022-11-23,18:00:00,122,108,14,FMN 05 Gerard Le Grellelaan
653,Gerard le Grellelaan 10,2022-11-23,19:00:00,66,53,13,FMN 05 Gerard Le Grellelaan
653,Gerard le Grellelaan 10,2022-11-23,20:00:00,38,31,7,FMN 05 Gerard Le Grellelaan
653,Gerard le Grellelaan 10,2022-11-23,21:00:00,31,25,6,FMN 05 Gerard Le Grellelaan
653,Gerard le Grellelaan 10,2022-11-23,22:00:00,45,40,5,FMN 05 Gerard Le Grellelaan
653,Gerard le Grellelaan 10,2022-11-23,23:00:00,17,11,6,FMN 05 Gerard Le Grellelaan
653,Gerard le Grellelaan 10,2022-11-24,00:00:00,14,5,9,FMN 05 Gerard Le Grellelaan
653,Gerard le Grellelaan 10,2022-11-24,01:00:00,5,4,1,FMN 05 Gerard Le Grellelaan
653,Gerard le Grellelaan 10,2022-11-24,02:00:00,1,1,0,FMN 05 Gerard Le Grellelaan
653,Gerard le Grellelaan 10,2022-11-24,03:00:00,1,0,1,FMN 05 Gerard Le Grellelaan
653,Gerard le Grellelaan 10,2022-11-24,04:00:00,3,3,0,FMN 05 Gerard Le Grellelaan
653,Gerard le Grellelaan 10,2022-11-24,05:00:00,23,8,15,FMN 05 Gerard Le Grellelaan
653,Gerard le Grellelaan 10,2022-11-24,06:00:00,40,19,21,FMN 05 Gerard Le Grellelaan
653,Gerard le Grellelaan 10,2022-11-24,07:00:00,119,93,26,FMN 05 Gerard Le Grellelaan
653,Gerard le Grellelaan 10,2022-11-24,08:00:00,243,197,46,FMN 05 Gerard Le Grellelaan
653,Gerard le Grellelaan 10,2022-11-24,09:00:00,90,76,14,FMN 05 Gerard Le Grellelaan
653,Gerard le Grellelaan 10,2022-11-24,10:00:00,67,57,10,FMN 05 Gerard Le Grellelaan
653,Gerard le Grellelaan 10,2022-11-24,11:00:00,68,57,11,FMN 05 Gerard Le Grellelaan
653,Gerard le Grellelaan 10,2022-11-24,12:00:00,85,72,13,FMN 05 Gerard Le Grellelaan
653,Gerard le Grellelaan 10,2022-11-24,13:00:00,90,75,15,FMN 05 Gerard Le Grellelaan
653,Gerard le Grellelaan 10,2022-11-24,14:00:00,80,67,13,FMN 05 Gerard Le Grellelaan
653,Gerard le Grellelaan 10,2022-11-24,15:00:00,141,109,32,FMN 05 Gerard Le Grellelaan
653,Gerard le Grellelaan 10,2022-11-24,16:00:00,160,125,35,FMN 05 Gerard Le Grellelaan
653,Gerard le Grellelaan 10,2022-11-24,17:00:00,176,143,33,FMN 05 Gerard Le Grellelaan
653,Gerard le Grellelaan 10,2022-11-24,18:00:00,110,89,21,FMN 05 Gerard Le Grellelaan
653,Gerard le Grellelaan 10,2022-11-24,19:00:00,68,59,9,FMN 05 Gerard Le Grellelaan
653,Gerard le Grellelaan 10,2022-11-24,20:00:00,44,32,12,FMN 05 Gerard Le Grellelaan
653,Gerard le Grellelaan 10,2022-11-24,21:00:00,26,17,9,FMN 05 Gerard Le Grellelaan
653,Gerard le Grellelaan 10,2022-11-24,22:00:00,40,31,9,FMN 05 Gerard Le Grellelaan
653,Gerard le Grellelaan 10,2022-11-24,23:00:00,24,16,8,FMN 05 Gerard Le Grellelaan
653,Gerard le Grellelaan 10,2022-11-25,00:00:00,16,11,5,FMN 05 Gerard Le Grellelaan
653,Gerard le Grellelaan 10,2022-11-25,01:00:00,4,1,3,FMN 05 Gerard Le Grellelaan
653,Gerard le Grellelaan 10,2022-11-25,02:00:00,2,2,0,FMN 05 Gerard Le Grellelaan
653,Gerard le Grellelaan 10,2022-11-25,03:00:00,4,3,1,FMN 05 Gerard Le Grellelaan
653,Gerard le Grellelaan 10,2022-11-25,04:00:00,7,4,3,FMN 05 Gerard Le Grellelaan
653,Gerard le Grellelaan 10,2022-11-25,05:00:00,22,8,14,FMN 05 Gerard Le Grellelaan
653,Gerard le Grellelaan 10,2022-11-25,06:00:00,41,19,22,FMN 05 Gerard Le Grellelaan
653,Gerard le Grellelaan 10,2022-11-25,07:00:00,96,75,21,FMN 05 Gerard Le Grellelaan
653,Gerard le Grellelaan 10,2022-11-25,08:00:00,221,177,44,FMN 05 Gerard Le Grellelaan
653,Gerard le Grellelaan 10,2022-11-25,09:00:00,77,66,11,FMN 05 Gerard Le Grellelaan
653,Gerard le Grellelaan 10,2022-11-25,10:00:00,48,35,13,FMN 05 Gerard Le Grellelaan
653,Gerard le Grellelaan 10,2022-11-25,11:00:00,55,48,7,FMN 05 Gerard Le Grellelaan
653,Gerard le Grellelaan 10,2022-11-25,12:00:00,82,71,11,FMN 05 Gerard Le Grellelaan
653,Gerard le Grellelaan 10,2022-11-25,13:00:00,81,64,17,FMN 05 Gerard Le Grellelaan
653,Gerard le Grellelaan 10,2022-11-25,14:00:00,95,68,27,FMN 05 Gerard Le Grellelaan
653,Gerard le Grellelaan 10,2022-11-25,15:00:00,144,120,24,FMN 05 Gerard Le Grellelaan
653,Gerard le Grellelaan 10,2022-11-25,16:00:00,144,111,33,FMN 05 Gerard Le Grellelaan
653,Gerard le Grellelaan 10,2022-11-25,17:00:00,165,133,32,FMN 05 Gerard Le Grellelaan
653,Gerard le Grellelaan 10,2022-11-25,18:00:00,85,66,19,FMN 05 Gerard Le Grellelaan
653,Gerard le Grellelaan 10,2022-11-25,19:00:00,59,51,8,FMN 05 Gerard Le Grellelaan
653,Gerard le Grellelaan 10,2022-11-25,20:00:00,43,32,11,FMN 05 Gerard Le Grellelaan
653,Gerard le Grellelaan 10,2022-11-25,21:00:00,25,22,3,FMN 05 Gerard Le Grellelaan
653,Gerard le Grellelaan 10,2022-11-25,22:00:00,29,24,5,FMN 05 Gerard Le Grellelaan
653,Gerard le Grellelaan 10,2022-11-25,23:00:00,20,16,4,FMN 05 Gerard Le Grellelaan
653,Gerard le Grellelaan 10,2022-11-26,00:00:00,16,12,4,FMN 05 Gerard Le Grellelaan
653,Gerard le Grellelaan 10,2022-11-26,01:00:00,6,3,3,FMN 05 Gerard Le Grellelaan
653,Gerard le Grellelaan 10,2022-11-26,02:00:00,8,8,0,FMN 05 Gerard Le Grellelaan
653,Gerard le Grellelaan 10,2022-11-26,03:00:00,5,4,1,FMN 05 Gerard Le Grellelaan
653,Gerard le Grellelaan 10,2022-11-26,04:00:00,6,4,2,FMN 05 Gerard Le Grellelaan
653,Gerard le Grellelaan 10,2022-11-26,05:00:00,4,4,0,FMN 05 Gerard Le Grellelaan
653,Gerard le Grellelaan 10,2022-11-26,06:00:00,9,5,4,FMN 05 Gerard Le Grellelaan
653,Gerard le Grellelaan 10,2022-11-26,07:00:00,11,11,0,FMN 05 Gerard Le Grellelaan
653,Gerard le Grellelaan 10,2022-11-26,08:00:00,16,13,3,FMN 05 Gerard Le Grellelaan
653,Gerard le Grellelaan 10,2022-11-26,09:00:00,37,32,5,FMN 05 Gerard Le Grellelaan
653,Gerard le Grellelaan 10,2022-11-26,10:00:00,33,22,11,FMN 05 Gerard Le Grellelaan
653,Gerard le Grellelaan 10,2022-11-26,11:00:00,51,43,8,FMN 05 Gerard Le Grellelaan
653,Gerard le Grellelaan 10,2022-11-26,12:00:00,73,62,11,FMN 05 Gerard Le Grellelaan
653,Gerard le Grellelaan 10,2022-11-26,13:00:00,68,61,7,FMN 05 Gerard Le Grellelaan
653,Gerard le Grellelaan 10,2022-11-26,14:00:00,54,44,10,FMN 05 Gerard Le Grellelaan
653,Gerard le Grellelaan 10,2022-11-26,15:00:00,76,65,11,FMN 05 Gerard Le Grellelaan
653,Gerard le Grellelaan 10,2022-11-26,16:00:00,59,53,6,FMN 05 Gerard Le Grellelaan
653,Gerard le Grellelaan 10,2022-11-26,17:00:00,54,48,6,FMN 05 Gerard Le Grellelaan
653,Gerard le Grellelaan 10,2022-11-26,18:00:00,41,34,7,FMN 05 Gerard Le Grellelaan
653,Gerard le Grellelaan 10,2022-11-26,19:00:00,38,32,6,FMN 05 Gerard Le Grellelaan
653,Gerard le Grellelaan 10,2022-11-26,20:00:00,22,18,4,FMN 05 Gerard Le Grellelaan
653,Gerard le Grellelaan 10,2022-11-26,21:00:00,25,19,6,FMN 05 Gerard Le Grellelaan
653,Gerard le Grellelaan 10,2022-11-26,22:00:00,22,14,8,FMN 05 Gerard Le Grellelaan
653,Gerard le Grellelaan 10,2022-11-26,23:00:00,19,12,7,FMN 05 Gerard Le Grellelaan
653,Gerard le Grellelaan 10,2022-11-27,00:00:00,13,9,4,FMN 05 Gerard Le Grellelaan
653,Gerard le Grellelaan 10,2022-11-27,01:00:00,5,2,3,FMN 05 Gerard Le Grellelaan
653,Gerard le Grellelaan 10,2022-11-27,02:00:00,6,5,1,FMN 05 Gerard Le Grellelaan
653,Gerard le Grellelaan 10,2022-11-27,03:00:00,5,4,1,FMN 05 Gerard Le Grellelaan
653,Gerard le Grellelaan 10,2022-11-27,04:00:00,1,1,0,FMN 05 Gerard Le Grellelaan
653,Gerard le Grellelaan 10,2022-11-27,05:00:00,2,2,0,FMN 05 Gerard Le Grellelaan
653,Gerard le Grellelaan 10,2022-11-27,06:00:00,4,1,3,FMN 05 Gerard Le Grellelaan
653,Gerard le Grellelaan 10,2022-11-27,07:00:00,5,3,2,FMN 05 Gerard Le Grellelaan
653,Gerard le Grellelaan 10,2022-11-27,08:00:00,13,8,5,FMN 05 Gerard Le Grellelaan
653,Gerard le Grellelaan 10,2022-11-27,09:00:00,20,19,1,FMN 05 Gerard Le Grellelaan
653,Gerard le Grellelaan 10,2022-11-27,10:00:00,27,22,5,FMN 05 Gerard Le Grellelaan
653,Gerard le Grellelaan 10,2022-11-27,11:00:00,40,32,8,FMN 05 Gerard Le Grellelaan
653,Gerard le Grellelaan 10,2022-11-27,12:00:00,43,36,7,FMN 05 Gerard Le Grellelaan
653,Gerard le Grellelaan 10,2022-11-27,13:00:00,32,23,9,FMN 05 Gerard Le Grellelaan
653,Gerard le Grellelaan 10,2022-11-27,14:00:00,22,17,5,FMN 05 Gerard Le Grellelaan
653,Gerard le Grellelaan 10,2022-11-27,15:00:00,21,21,0,FMN 05 Gerard Le Grellelaan
653,Gerard le Grellelaan 10,2022-11-27,16:00:00,36,26,10,FMN 05 Gerard Le Grellelaan
653,Gerard le Grellelaan 10,2022-11-27,17:00:00,27,23,4,FMN 05 Gerard Le Grellelaan
653,Gerard le Grellelaan 10,2022-11-27,18:00:00,10,6,4,FMN 05 Gerard Le Grellelaan
653,Gerard le Grellelaan 10,2022-11-27,19:00:00,22,17,5,FMN 05 Gerard Le Grellelaan
653,Gerard le Grellelaan 10,2022-11-27,20:00:00,10,8,2,FMN 05 Gerard Le Grellelaan
653,Gerard le Grellelaan 10,2022-11-27,21:00:00,8,7,1,FMN 05 Gerard Le Grellelaan
653,Gerard le Grellelaan 10,2022-11-27,22:00:00,16,11,5,FMN 05 Gerard Le Grellelaan
653,Gerard le Grellelaan 10,2022-11-27,23:00:00,9,7,2,FMN 05 Gerard Le Grellelaan
653,Gerard le Grellelaan 10,2022-11-28,00:00:00,5,4,1,FMN 05 Gerard Le Grellelaan
653,Gerard le Grellelaan 10,2022-11-28,01:00:00,2,2,0,FMN 05 Gerard Le Grellelaan
653,Gerard le Grellelaan 10,2022-11-28,02:00:00,1,1,0,FMN 05 Gerard Le Grellelaan
653,Gerard le Grellelaan 10,2022-11-28,03:00:00,1,1,0,FMN 05 Gerard Le Grellelaan
653,Gerard le Grellelaan 10,2022-11-28,04:00:00,3,1,2,FMN 05 Gerard Le Grellelaan
653,Gerard le Grellelaan 10,2022-11-28,05:00:00,22,9,13,FMN 05 Gerard Le Grellelaan
653,Gerard le Grellelaan 10,2022-11-28,06:00:00,35,15,20,FMN 05 Gerard Le Grellelaan
653,Gerard le Grellelaan 10,2022-11-28,07:00:00,117,90,27,FMN 05 Gerard Le Grellelaan
653,Gerard le Grellelaan 10,2022-11-28,08:00:00,250,189,61,FMN 05 Gerard Le Grellelaan
653,Gerard le Grellelaan 10,2022-11-28,09:00:00,79,63,16,FMN 05 Gerard Le Grellelaan
653,Gerard le Grellelaan 10,2022-11-28,10:00:00,60,53,7,FMN 05 Gerard Le Grellelaan
653,Gerard le Grellelaan 10,2022-11-28,11:00:00,43,38,5,FMN 05 Gerard Le Grellelaan
653,Gerard le Grellelaan 10,2022-11-28,12:00:00,58,44,14,FMN 05 Gerard Le Grellelaan
653,Gerard le Grellelaan 10,2022-11-28,13:00:00,55,44,11,FMN 05 Gerard Le Grellelaan
653,Gerard le Grellelaan 10,2022-11-28,14:00:00,65,56,9,FMN 05 Gerard Le Grellelaan
653,Gerard le Grellelaan 10,2022-11-28,15:00:00,120,94,26,FMN 05 Gerard Le Grellelaan
653,Gerard le Grellelaan 10,2022-11-28,16:00:00,144,113,31,FMN 05 Gerard Le Grellelaan
653,Gerard le Grellelaan 10,2022-11-28,17:00:00,176,143,33,FMN 05 Gerard Le Grellelaan
653,Gerard le Grellelaan 10,2022-11-28,18:00:00,121,98,23,FMN 05 Gerard Le Grellelaan
653,Gerard le Grellelaan 10,2022-11-28,19:00:00,47,44,3,FMN 05 Gerard Le Grellelaan
653,Gerard le Grellelaan 10,2022-11-28,20:00:00,42,32,10,FMN 05 Gerard Le Grellelaan
653,Gerard le Grellelaan 10,2022-11-28,21:00:00,39,33,6,FMN 05 Gerard Le Grellelaan
653,Gerard le Grellelaan 10,2022-11-28,22:00:00,35,29,6,FMN 05 Gerard Le Grellelaan
653,Gerard le Grellelaan 10,2022-11-28,23:00:00,19,16,3,FMN 05 Gerard Le Grellelaan
653,Gerard le Grellelaan 10,2022-11-29,00:00:00,7,3,4,FMN 05 Gerard Le Grellelaan
653,Gerard le Grellelaan 10,2022-11-29,01:00:00,0,0,0,FMN 05 Gerard Le Grellelaan
653,Gerard le Grellelaan 10,2022-11-29,02:00:00,6,4,2,FMN 05 Gerard Le Grellelaan
653,Gerard le Grellelaan 10,2022-11-29,03:00:00,1,1,0,FMN 05 Gerard Le Grellelaan
653,Gerard le Grellelaan 10,2022-11-29,04:00:00,5,4,1,FMN 05 Gerard Le Grellelaan
653,Gerard le Grellelaan 10,2022-11-29,05:00:00,23,10,13,FMN 05 Gerard Le Grellelaan
653,Gerard le Grellelaan 10,2022-11-29,06:00:00,50,27,23,FMN 05 Gerard Le Grellelaan
653,Gerard le Grellelaan 10,2022-11-29,07:00:00,100,71,29,FMN 05 Gerard Le Grellelaan
653,Gerard le Grellelaan 10,2022-11-29,08:00:00,270,231,39,FMN 05 Gerard Le Grellelaan
653,Gerard le Grellelaan 10,2022-11-29,09:00:00,79,67,12,FMN 05 Gerard Le Grellelaan
653,Gerard le Grellelaan 10,2022-11-29,10:00:00,56,43,13,FMN 05 Gerard Le Grellelaan
653,Gerard le Grellelaan 10,2022-11-29,11:00:00,45,40,5,FMN 05 Gerard Le Grellelaan
653,Gerard le Grellelaan 10,2022-11-29,12:00:00,69,53,16,FMN 05 Gerard Le Grellelaan
653,Gerard le Grellelaan 10,2022-11-29,13:00:00,93,74,19,FMN 05 Gerard Le Grellelaan
653,Gerard le Grellelaan 10,2022-11-29,14:00:00,70,53,17,FMN 05 Gerard Le Grellelaan
653,Gerard le Grellelaan 10,2022-11-29,15:00:00,129,100,29,FMN 05 Gerard Le Grellelaan
653,Gerard le Grellelaan 10,2022-11-29,16:00:00,169,133,36,FMN 05 Gerard Le Grellelaan
653,Gerard le Grellelaan 10,2022-11-29,17:00:00,197,164,33,FMN 05 Gerard Le Grellelaan
653,Gerard le Grellelaan 10,2022-11-29,18:00:00,117,97,20,FMN 05 Gerard Le Grellelaan
653,Gerard le Grellelaan 10,2022-11-29,19:00:00,55,48,7,FMN 05 Gerard Le Grellelaan
653,Gerard le Grellelaan 10,2022-11-29,20:00:00,34,30,4,FMN 05 Gerard Le Grellelaan
653,Gerard le Grellelaan 10,2022-11-29,21:00:00,28,24,4,FMN 05 Gerard Le Grellelaan
653,Gerard le Grellelaan 10,2022-11-29,22:00:00,40,36,4,FMN 05 Gerard Le Grellelaan
653,Gerard le Grellelaan 10,2022-11-29,23:00:00,16,13,3,FMN 05 Gerard Le Grellelaan
653,Gerard le Grellelaan 10,2022-11-30,00:00:00,4,3,1,FMN 05 Gerard Le Grellelaan
653,Gerard le Grellelaan 10,2022-11-30,01:00:00,4,4,0,FMN 05 Gerard Le Grellelaan
653,Gerard le Grellelaan 10,2022-11-30,02:00:00,2,0,2,FMN 05 Gerard Le Grellelaan
653,Gerard le Grellelaan 10,2022-11-30,03:00:00,1,0,1,FMN 05 Gerard Le Grellelaan
653,Gerard le Grellelaan 10,2022-11-30,04:00:00,6,4,2,FMN 05 Gerard Le Grellelaan
653,Gerard le Grellelaan 10,2022-11-30,05:00:00,16,6,10,FMN 05 Gerard Le Grellelaan
653,Gerard le Grellelaan 10,2022-11-30,06:00:00,38,20,18,FMN 05 Gerard Le Grellelaan
653,Gerard le Grellelaan 10,2022-11-30,07:00:00,91,70,21,FMN 05 Gerard Le Grellelaan
653,Gerard le Grellelaan 10,2022-11-30,08:00:00,221,185,36,FMN 05 Gerard Le Grellelaan
653,Gerard le Grellelaan 10,2022-11-30,09:00:00,84,68,16,FMN 05 Gerard Le Grellelaan
653,Gerard le Grellelaan 10,2022-11-30,10:00:00,63,54,9,FMN 05 Gerard Le Grellelaan
653,Gerard le Grellelaan 10,2022-11-30,11:00:00,66,54,12,FMN 05 Gerard Le Grellelaan
653,Gerard le Grellelaan 10,2022-11-30,12:00:00,128,108,20,FMN 05 Gerard Le Grellelaan
653,Gerard le Grellelaan 10,2022-11-30,13:00:00,99,72,27,FMN 05 Gerard Le Grellelaan
653,Gerard le Grellelaan 10,2022-11-30,14:00:00,74,62,12,FMN 05 Gerard Le Grellelaan
653,Gerard le Grellelaan 10,2022-11-30,15:00:00,94,78,16,FMN 05 Gerard Le Grellelaan
653,Gerard le Grellelaan 10,2022-11-30,16:00:00,103,86,17,FMN 05 Gerard Le Grellelaan
653,Gerard le Grellelaan 10,2022-11-30,17:00:00,149,123,26,FMN 05 Gerard Le Grellelaan
653,Gerard le Grellelaan 10,2022-11-30,18:00:00,116,95,21,FMN 05 Gerard Le Grellelaan
653,Gerard le Grellelaan 10,2022-11-30,19:00:00,67,54,13,FMN 05 Gerard Le Grellelaan
653,Gerard le Grellelaan 10,2022-11-30,20:00:00,47,39,8,FMN 05 Gerard Le Grellelaan
653,Gerard le Grellelaan 10,2022-11-30,21:00:00,31,21,10,FMN 05 Gerard Le Grellelaan
653,Gerard le Grellelaan 10,2022-11-30,22:00:00,36,32,4,FMN 05 Gerard Le Grellelaan
653,Gerard le Grellelaan 10,2022-11-30,23:00:00,21,15,6,FMN 05 Gerard Le Grellelaan
653,Gerard le Grellelaan 10,2022-12-01,00:00:00,6,3,3,FMN 05 Gerard Le Grellelaan
653,Gerard le Grellelaan 10,2022-12-01,01:00:00,3,3,0,FMN 05 Gerard Le Grellelaan
653,Gerard le Grellelaan 10,2022-12-01,02:00:00,4,4,0,FMN 05 Gerard Le Grellelaan
653,Gerard le Grellelaan 10,2022-12-01,03:00:00,12,6,6,FMN 05 Gerard Le Grellelaan
653,Gerard le Grellelaan 10,2022-12-01,04:00:00,2,1,1,FMN 05 Gerard Le Grellelaan
653,Gerard le Grellelaan 10,2022-12-01,05:00:00,26,8,18,FMN 05 Gerard Le Grellelaan
653,Gerard le Grellelaan 10,2022-12-01,06:00:00,42,21,21,FMN 05 Gerard Le Grellelaan
653,Gerard le Grellelaan 10,2022-12-01,07:00:00,117,92,25,FMN 05 Gerard Le Grellelaan
653,Gerard le Grellelaan 10,2022-12-01,08:00:00,276,225,51,FMN 05 Gerard Le Grellelaan
653,Gerard le Grellelaan 10,2022-12-01,09:00:00,78,70,8,FMN 05 Gerard Le Grellelaan
653,Gerard le Grellelaan 10,2022-12-01,10:00:00,70,54,16,FMN 05 Gerard Le Grellelaan
653,Gerard le Grellelaan 10,2022-12-01,11:00:00,56,48,8,FMN 05 Gerard Le Grellelaan
653,Gerard le Grellelaan 10,2022-12-01,12:00:00,93,79,14,FMN 05 Gerard Le Grellelaan
653,Gerard le Grellelaan 10,2022-12-01,13:00:00,84,66,18,FMN 05 Gerard Le Grellelaan
653,Gerard le Grellelaan 10,2022-12-01,14:00:00,80,67,13,FMN 05 Gerard Le Grellelaan
653,Gerard le Grellelaan 10,2022-12-01,15:00:00,168,141,27,FMN 05 Gerard Le Grellelaan
653,Gerard le Grellelaan 10,2022-12-01,16:00:00,171,141,30,FMN 05 Gerard Le Grellelaan
653,Gerard le Grellelaan 10,2022-12-01,17:00:00,134,105,29,FMN 05 Gerard Le Grellelaan
653,Gerard le Grellelaan 10,2022-12-01,18:00:00,115,96,19,FMN 05 Gerard Le Grellelaan
653,Gerard le Grellelaan 10,2022-12-01,19:00:00,55,46,9,FMN 05 Gerard Le Grellelaan
653,Gerard le Grellelaan 10,2022-12-01,20:00:00,40,33,7,FMN 05 Gerard Le Grellelaan
653,Gerard le Grellelaan 10,2022-12-01,21:00:00,33,24,9,FMN 05 Gerard Le Grellelaan
653,Gerard le Grellelaan 10,2022-12-01,22:00:00,48,33,15,FMN 05 Gerard Le Grellelaan
653,Gerard le Grellelaan 10,2022-12-01,23:00:00,20,20,0,FMN 05 Gerard Le Grellelaan
653,Gerard le Grellelaan 10,2022-12-02,00:00:00,5,4,1,FMN 05 Gerard Le Grellelaan
653,Gerard le Grellelaan 10,2022-12-02,01:00:00,3,2,1,FMN 05 Gerard Le Grellelaan
653,Gerard le Grellelaan 10,2022-12-02,02:00:00,1,1,0,FMN 05 Gerard Le Grellelaan
653,Gerard le Grellelaan 10,2022-12-02,03:00:00,3,0,3,FMN 05 Gerard Le Grellelaan
653,Gerard le Grellelaan 10,2022-12-02,04:00:00,6,2,4,FMN 05 Gerard Le Grellelaan
653,Gerard le Grellelaan 10,2022-12-02,05:00:00,18,7,11,FMN 05 Gerard Le Grellelaan
653,Gerard le Grellelaan 10,2022-12-02,06:00:00,34,21,13,FMN 05 Gerard Le Grellelaan
653,Gerard le Grellelaan 10,2022-12-02,07:00:00,100,79,21,FMN 05 Gerard Le Grellelaan
653,Gerard le Grellelaan 10,2022-12-02,08:00:00,198,161,37,FMN 05 Gerard Le Grellelaan
653,Gerard le Grellelaan 10,2022-12-02,09:00:00,66,60,6,FMN 05 Gerard Le Grellelaan
653,Gerard le Grellelaan 10,2022-12-02,10:00:00,54,46,8,FMN 05 Gerard Le Grellelaan
653,Gerard le Grellelaan 10,2022-12-02,11:00:00,69,60,9,FMN 05 Gerard Le Grellelaan
653,Gerard le Grellelaan 10,2022-12-02,12:00:00,83,67,16,FMN 05 Gerard Le Grellelaan
653,Gerard le Grellelaan 10,2022-12-02,13:00:00,62,49,13,FMN 05 Gerard Le Grellelaan
653,Gerard le Grellelaan 10,2022-12-02,14:00:00,64,52,12,FMN 05 Gerard Le Grellelaan
653,Gerard le Grellelaan 10,2022-12-02,15:00:00,113,93,20,FMN 05 Gerard Le Grellelaan
653,Gerard le Grellelaan 10,2022-12-02,16:00:00,114,93,21,FMN 05 Gerard Le Grellelaan
653,Gerard le Grellelaan 10,2022-12-02,17:00:00,117,97,20,FMN 05 Gerard Le Grellelaan
653,Gerard le Grellelaan 10,2022-12-02,18:00:00,108,88,20,FMN 05 Gerard Le Grellelaan
653,Gerard le Grellelaan 10,2022-12-02,19:00:00,67,61,6,FMN 05 Gerard Le Grellelaan
653,Gerard le Grellelaan 10,2022-12-02,20:00:00,34,31,3,FMN 05 Gerard Le Grellelaan
653,Gerard le Grellelaan 10,2022-12-02,21:00:00,29,22,7,FMN 05 Gerard Le Grellelaan
653,Gerard le Grellelaan 10,2022-12-02,22:00:00,22,20,2,FMN 05 Gerard Le Grellelaan
653,Gerard le Grellelaan 10,2022-12-02,23:00:00,17,13,4,FMN 05 Gerard Le Grellelaan
653,Gerard le Grellelaan 10,2022-12-03,00:00:00,20,12,8,FMN 05 Gerard Le Grellelaan
653,Gerard le Grellelaan 10,2022-12-03,01:00:00,8,4,4,FMN 05 Gerard Le Grellelaan
653,Gerard le Grellelaan 10,2022-12-03,02:00:00,5,2,3,FMN 05 Gerard Le Grellelaan
653,Gerard le Grellelaan 10,2022-12-03,03:00:00,9,7,2,FMN 05 Gerard Le Grellelaan
653,Gerard le Grellelaan 10,2022-12-03,04:00:00,6,3,3,FMN 05 Gerard Le Grellelaan
653,Gerard le Grellelaan 10,2022-12-03,05:00:00,3,3,0,FMN 05 Gerard Le Grellelaan
653,Gerard le Grellelaan 10,2022-12-03,06:00:00,7,5,2,FMN 05 Gerard Le Grellelaan
653,Gerard le Grellelaan 10,2022-12-03,07:00:00,8,8,0,FMN 05 Gerard Le Grellelaan
653,Gerard le Grellelaan 10,2022-12-03,08:00:00,12,11,1,FMN 05 Gerard Le Grellelaan
653,Gerard le Grellelaan 10,2022-12-03,09:00:00,39,28,11,FMN 05 Gerard Le Grellelaan
653,Gerard le Grellelaan 10,2022-12-03,10:00:00,24,15,9,FMN 05 Gerard Le Grellelaan
653,Gerard le Grellelaan 10,2022-12-03,11:00:00,32,26,6,FMN 05 Gerard Le Grellelaan
653,Gerard le Grellelaan 10,2022-12-03,12:00:00,42,31,11,FMN 05 Gerard Le Grellelaan
653,Gerard le Grellelaan 10,2022-12-03,13:00:00,52,41,11,FMN 05 Gerard Le Grellelaan
653,Gerard le Grellelaan 10,2022-12-03,14:00:00,51,43,8,FMN 05 Gerard Le Grellelaan
653,Gerard le Grellelaan 10,2022-12-03,15:00:00,40,32,8,FMN 05 Gerard Le Grellelaan
653,Gerard le Grellelaan 10,2022-12-03,16:00:00,30,26,4,FMN 05 Gerard Le Grellelaan
653,Gerard le Grellelaan 10,2022-12-03,17:00:00,39,34,5,FMN 05 Gerard Le Grellelaan
653,Gerard le Grellelaan 10,2022-12-03,18:00:00,40,31,9,FMN 05 Gerard Le Grellelaan
653,Gerard le Grellelaan 10,2022-12-03,19:00:00,26,24,2,FMN 05 Gerard Le Grellelaan
653,Gerard le Grellelaan 10,2022-12-03,20:00:00,18,14,4,FMN 05 Gerard Le Grellelaan
653,Gerard le Grellelaan 10,2022-12-03,21:00:00,17,13,4,FMN 05 Gerard Le Grellelaan
653,Gerard le Grellelaan 10,2022-12-03,22:00:00,14,11,3,FMN 05 Gerard Le Grellelaan
653,Gerard le Grellelaan 10,2022-12-03,23:00:00,15,13,2,FMN 05 Gerard Le Grellelaan
653,Gerard le Grellelaan 10,2022-12-04,00:00:00,8,6,2,FMN 05 Gerard Le Grellelaan
653,Gerard le Grellelaan 10,2022-12-04,01:00:00,8,5,3,FMN 05 Gerard Le Grellelaan
653,Gerard le Grellelaan 10,2022-12-04,02:00:00,5,5,0,FMN 05 Gerard Le Grellelaan
653,Gerard le Grellelaan 10,2022-12-04,03:00:00,4,4,0,FMN 05 Gerard Le Grellelaan
653,Gerard le Grellelaan 10,2022-12-04,04:00:00,3,0,3,FMN 05 Gerard Le Grellelaan
653,Gerard le Grellelaan 10,2022-12-04,05:00:00,2,0,2,FMN 05 Gerard Le Grellelaan
653,Gerard le Grellelaan 10,2022-12-04,06:00:00,3,3,0,FMN 05 Gerard Le Grellelaan
653,Gerard le Grellelaan 10,2022-12-04,07:00:00,4,4,0,FMN 05 Gerard Le Grellelaan
653,Gerard le Grellelaan 10,2022-12-04,08:00:00,15,10,5,FMN 05 Gerard Le Grellelaan
653,Gerard le Grellelaan 10,2022-12-04,09:00:00,31,27,4,FMN 05 Gerard Le Grellelaan
653,Gerard le Grellelaan 10,2022-12-04,10:00:00,28,26,2,FMN 05 Gerard Le Grellelaan
653,Gerard le Grellelaan 10,2022-12-04,11:00:00,41,29,12,FMN 05 Gerard Le Grellelaan
653,Gerard le Grellelaan 10,2022-12-04,12:00:00,47,41,6,FMN 05 Gerard Le Grellelaan
653,Gerard le Grellelaan 10,2022-12-04,13:00:00,28,21,7,FMN 05 Gerard Le Grellelaan
653,Gerard le Grellelaan 10,2022-12-04,14:00:00,37,31,6,FMN 05 Gerard Le Grellelaan
653,Gerard le Grellelaan 10,2022-12-04,15:00:00,39,28,11,FMN 05 Gerard Le Grellelaan
653,Gerard le Grellelaan 10,2022-12-04,16:00:00,39,32,7,FMN 05 Gerard Le Grellelaan
653,Gerard le Grellelaan 10,2022-12-04,17:00:00,24,20,4,FMN 05 Gerard Le Grellelaan
653,Gerard le Grellelaan 10,2022-12-04,18:00:00,18,15,3,FMN 05 Gerard Le Grellelaan
653,Gerard le Grellelaan 10,2022-12-04,19:00:00,19,15,4,FMN 05 Gerard Le Grellelaan
653,Gerard le Grellelaan 10,2022-12-04,20:00:00,15,11,4,FMN 05 Gerard Le Grellelaan
653,Gerard le Grellelaan 10,2022-12-04,21:00:00,8,6,2,FMN 05 Gerard Le Grellelaan
653,Gerard le Grellelaan 10,2022-12-04,22:00:00,8,7,1,FMN 05 Gerard Le Grellelaan
653,Gerard le Grellelaan 10,2022-12-04,23:00:00,11,9,2,FMN 05 Gerard Le Grellelaan
653,Gerard le Grellelaan 10,2022-12-05,00:00:00,3,2,1,FMN 05 Gerard Le Grellelaan
653,Gerard le Grellelaan 10,2022-12-05,01:00:00,1,1,0,FMN 05 Gerard Le Grellelaan
653,Gerard le Grellelaan 10,2022-12-05,02:00:00,1,1,0,FMN 05 Gerard Le Grellelaan
653,Gerard le Grellelaan 10,2022-12-05,03:00:00,1,1,0,FMN 05 Gerard Le Grellelaan
653,Gerard le Grellelaan 10,2022-12-05,04:00:00,9,4,5,FMN 05 Gerard Le Grellelaan
653,Gerard le Grellelaan 10,2022-12-05,05:00:00,21,8,13,FMN 05 Gerard Le Grellelaan
653,Gerard le Grellelaan 10,2022-12-05,06:00:00,40,22,18,FMN 05 Gerard Le Grellelaan
653,Gerard le Grellelaan 10,2022-12-05,07:00:00,90,65,25,FMN 05 Gerard Le Grellelaan
653,Gerard le Grellelaan 10,2022-12-05,08:00:00,224,185,39,FMN 05 Gerard Le Grellelaan
653,Gerard le Grellelaan 10,2022-12-05,09:00:00,57,53,4,FMN 05 Gerard Le Grellelaan
653,Gerard le Grellelaan 10,2022-12-05,10:00:00,34,30,4,FMN 05 Gerard Le Grellelaan
653,Gerard le Grellelaan 10,2022-12-05,11:00:00,28,21,7,FMN 05 Gerard Le Grellelaan
653,Gerard le Grellelaan 10,2022-12-05,12:00:00,57,46,11,FMN 05 Gerard Le Grellelaan
653,Gerard le Grellelaan 10,2022-12-05,13:00:00,58,42,16,FMN 05 Gerard Le Grellelaan
653,Gerard le Grellelaan 10,2022-12-05,14:00:00,48,40,8,FMN 05 Gerard Le Grellelaan
653,Gerard le Grellelaan 10,2022-12-05,15:00:00,87,73,14,FMN 05 Gerard Le Grellelaan
653,Gerard le Grellelaan 10,2022-12-05,16:00:00,119,98,21,FMN 05 Gerard Le Grellelaan
653,Gerard le Grellelaan 10,2022-12-05,17:00:00,149,119,30,FMN 05 Gerard Le Grellelaan
653,Gerard le Grellelaan 10,2022-12-05,18:00:00,94,83,11,FMN 05 Gerard Le Grellelaan
653,Gerard le Grellelaan 10,2022-12-05,19:00:00,38,36,2,FMN 05 Gerard Le Grellelaan
653,Gerard le Grellelaan 10,2022-12-05,20:00:00,19,17,2,FMN 05 Gerard Le Grellelaan
653,Gerard le Grellelaan 10,2022-12-05,21:00:00,17,12,5,FMN 05 Gerard Le Grellelaan
653,Gerard le Grellelaan 10,2022-12-05,22:00:00,27,23,4,FMN 05 Gerard Le Grellelaan
653,Gerard le Grellelaan 10,2022-12-05,23:00:00,13,9,4,FMN 05 Gerard Le Grellelaan
653,Gerard le Grellelaan 10,2022-12-06,00:00:00,2,1,1,FMN 05 Gerard Le Grellelaan
653,Gerard le Grellelaan 10,2022-12-06,01:00:00,3,2,1,FMN 05 Gerard Le Grellelaan
653,Gerard le Grellelaan 10,2022-12-06,02:00:00,2,2,0,FMN 05 Gerard Le Grellelaan
653,Gerard le Grellelaan 10,2022-12-06,03:00:00,1,0,1,FMN 05 Gerard Le Grellelaan
653,Gerard le Grellelaan 10,2022-12-06,04:00:00,8,3,5,FMN 05 Gerard Le Grellelaan
653,Gerard le Grellelaan 10,2022-12-06,05:00:00,18,9,9,FMN 05 Gerard Le Grellelaan
653,Gerard le Grellelaan 10,2022-12-06,06:00:00,37,19,18,FMN 05 Gerard Le Grellelaan
653,Gerard le Grellelaan 10,2022-12-06,07:00:00,115,97,18,FMN 05 Gerard Le Grellelaan
653,Gerard le Grellelaan 10,2022-12-06,08:00:00,245,204,41,FMN 05 Gerard Le Grellelaan
653,Gerard le Grellelaan 10,2022-12-06,09:00:00,75,61,14,FMN 05 Gerard Le Grellelaan
653,Gerard le Grellelaan 10,2022-12-06,10:00:00,42,37,5,FMN 05 Gerard Le Grellelaan
653,Gerard le Grellelaan 10,2022-12-06,11:00:00,48,41,7,FMN 05 Gerard Le Grellelaan
653,Gerard le Grellelaan 10,2022-12-06,12:00:00,74,59,15,FMN 05 Gerard Le Grellelaan
653,Gerard le Grellelaan 10,2022-12-06,13:00:00,85,67,18,FMN 05 Gerard Le Grellelaan
653,Gerard le Grellelaan 10,2022-12-06,14:00:00,69,53,16,FMN 05 Gerard Le Grellelaan
653,Gerard le Grellelaan 10,2022-12-06,15:00:00,113,95,18,FMN 05 Gerard Le Grellelaan
653,Gerard le Grellelaan 10,2022-12-06,16:00:00,136,112,24,FMN 05 Gerard Le Grellelaan
653,Gerard le Grellelaan 10,2022-12-06,17:00:00,181,144,37,FMN 05 Gerard Le Grellelaan
653,Gerard le Grellelaan 10,2022-12-06,18:00:00,110,90,20,FMN 05 Gerard Le Grellelaan
653,Gerard le Grellelaan 10,2022-12-06,19:00:00,50,36,14,FMN 05 Gerard Le Grellelaan
653,Gerard le Grellelaan 10,2022-12-06,20:00:00,27,17,10,FMN 05 Gerard Le Grellelaan
653,Gerard le Grellelaan 10,2022-12-06,21:00:00,24,18,6,FMN 05 Gerard Le Grellelaan
653,Gerard le Grellelaan 10,2022-12-06,22:00:00,29,24,5,FMN 05 Gerard Le Grellelaan
653,Gerard le Grellelaan 10,2022-12-06,23:00:00,8,6,2,FMN 05 Gerard Le Grellelaan
653,Gerard le Grellelaan 10,2022-12-07,00:00:00,5,5,0,FMN 05 Gerard Le Grellelaan
653,Gerard le Grellelaan 10,2022-12-07,01:00:00,2,2,0,FMN 05 Gerard Le Grellelaan
653,Gerard le Grellelaan 10,2022-12-07,02:00:00,0,0,0,FMN 05 Gerard Le Grellelaan
653,Gerard le Grellelaan 10,2022-12-07,03:00:00,0,0,0,FMN 05 Gerard Le Grellelaan
653,Gerard le Grellelaan 10,2022-12-07,04:00:00,11,7,4,FMN 05 Gerard Le Grellelaan
653,Gerard le Grellelaan 10,2022-12-07,05:00:00,22,11,11,FMN 05 Gerard Le Grellelaan
653,Gerard le Grellelaan 10,2022-12-07,06:00:00,38,19,19,FMN 05 Gerard Le Grellelaan
653,Gerard le Grellelaan 10,2022-12-07,07:00:00,97,77,20,FMN 05 Gerard Le Grellelaan
653,Gerard le Grellelaan 10,2022-12-07,08:00:00,185,145,40,FMN 05 Gerard Le Grellelaan
653,Gerard le Grellelaan 10,2022-12-07,09:00:00,56,48,8,FMN 05 Gerard Le Grellelaan
653,Gerard le Grellelaan 10,2022-12-07,10:00:00,49,42,7,FMN 05 Gerard Le Grellelaan
653,Gerard le Grellelaan 10,2022-12-07,11:00:00,50,44,6,FMN 05 Gerard Le Grellelaan
653,Gerard le Grellelaan 10,2022-12-07,12:00:00,108,94,14,FMN 05 Gerard Le Grellelaan
653,Gerard le Grellelaan 10,2022-12-07,13:00:00,75,62,13,FMN 05 Gerard Le Grellelaan
653,Gerard le Grellelaan 10,2022-12-07,14:00:00,59,46,13,FMN 05 Gerard Le Grellelaan
653,Gerard le Grellelaan 10,2022-12-07,15:00:00,83,73,10,FMN 05 Gerard Le Grellelaan
653,Gerard le Grellelaan 10,2022-12-07,16:00:00,108,90,18,FMN 05 Gerard Le Grellelaan
653,Gerard le Grellelaan 10,2022-12-07,17:00:00,123,105,18,FMN 05 Gerard Le Grellelaan
653,Gerard le Grellelaan 10,2022-12-07,18:00:00,89,80,9,FMN 05 Gerard Le Grellelaan
653,Gerard le Grellelaan 10,2022-12-07,19:00:00,50,37,13,FMN 05 Gerard Le Grellelaan
653,Gerard le Grellelaan 10,2022-12-07,20:00:00,30,22,8,FMN 05 Gerard Le Grellelaan
653,Gerard le Grellelaan 10,2022-12-07,21:00:00,25,19,6,FMN 05 Gerard Le Grellelaan
653,Gerard le Grellelaan 10,2022-12-07,22:00:00,27,22,5,FMN 05 Gerard Le Grellelaan
653,Gerard le Grellelaan 10,2022-12-07,23:00:00,14,12,2,FMN 05 Gerard Le Grellelaan
653,Gerard le Grellelaan 10,2022-12-08,00:00:00,5,3,2,FMN 05 Gerard Le Grellelaan
653,Gerard le Grellelaan 10,2022-12-08,01:00:00,3,1,2,FMN 05 Gerard Le Grellelaan
653,Gerard le Grellelaan 10,2022-12-08,02:00:00,1,1,0,FMN 05 Gerard Le Grellelaan
653,Gerard le Grellelaan 10,2022-12-08,03:00:00,3,1,2,FMN 05 Gerard Le Grellelaan
653,Gerard le Grellelaan 10,2022-12-08,04:00:00,6,3,3,FMN 05 Gerard Le Grellelaan
653,Gerard le Grellelaan 10,2022-12-08,05:00:00,20,13,7,FMN 05 Gerard Le Grellelaan
653,Gerard le Grellelaan 10,2022-12-08,06:00:00,31,16,15,FMN 05 Gerard Le Grellelaan
653,Gerard le Grellelaan 10,2022-12-08,07:00:00,111,81,30,FMN 05 Gerard Le Grellelaan
653,Gerard le Grellelaan 10,2022-12-08,08:00:00,237,196,41,FMN 05 Gerard Le Grellelaan
653,Gerard le Grellelaan 10,2022-12-08,09:00:00,66,56,10,FMN 05 Gerard Le Grellelaan
653,Gerard le Grellelaan 10,2022-12-08,10:00:00,41,36,5,FMN 05 Gerard Le Grellelaan
653,Gerard le Grellelaan 10,2022-12-08,11:00:00,47,43,4,FMN 05 Gerard Le Grellelaan
653,Gerard le Grellelaan 10,2022-12-08,12:00:00,74,60,14,FMN 05 Gerard Le Grellelaan
653,Gerard le Grellelaan 10,2022-12-08,13:00:00,57,40,17,FMN 05 Gerard Le Grellelaan
653,Gerard le Grellelaan 10,2022-12-08,14:00:00,40,34,6,FMN 05 Gerard Le Grellelaan
653,Gerard le Grellelaan 10,2022-12-08,15:00:00,80,68,12,FMN 05 Gerard Le Grellelaan
653,Gerard le Grellelaan 10,2022-12-08,16:00:00,120,92,28,FMN 05 Gerard Le Grellelaan
653,Gerard le Grellelaan 10,2022-12-08,17:00:00,127,111,16,FMN 05 Gerard Le Grellelaan
653,Gerard le Grellelaan 10,2022-12-08,18:00:00,87,76,11,FMN 05 Gerard Le Grellelaan
653,Gerard le Grellelaan 10,2022-12-08,19:00:00,40,33,7,FMN 05 Gerard Le Grellelaan
653,Gerard le Grellelaan 10,2022-12-08,20:00:00,27,20,7,FMN 05 Gerard Le Grellelaan
653,Gerard le Grellelaan 10,2022-12-08,21:00:00,25,17,8,FMN 05 Gerard Le Grellelaan
653,Gerard le Grellelaan 10,2022-12-08,22:00:00,36,30,6,FMN 05 Gerard Le Grellelaan
653,Gerard le Grellelaan 10,2022-12-08,23:00:00,8,7,1,FMN 05 Gerard Le Grellelaan
653,Gerard le Grellelaan 10,2022-12-09,00:00:00,6,1,5,FMN 05 Gerard Le Grellelaan
653,Gerard le Grellelaan 10,2022-12-09,01:00:00,2,2,0,FMN 05 Gerard Le Grellelaan
653,Gerard le Grellelaan 10,2022-12-09,02:00:00,3,3,0,FMN 05 Gerard Le Grellelaan
653,Gerard le Grellelaan 10,2022-12-09,03:00:00,3,3,0,FMN 05 Gerard Le Grellelaan
653,Gerard le Grellelaan 10,2022-12-09,04:00:00,4,2,2,FMN 05 Gerard Le Grellelaan
653,Gerard le Grellelaan 10,2022-12-09,05:00:00,12,6,6,FMN 05 Gerard Le Grellelaan
653,Gerard le Grellelaan 10,2022-12-09,06:00:00,29,19,10,FMN 05 Gerard Le Grellelaan
653,Gerard le Grellelaan 10,2022-12-09,07:00:00,79,68,11,FMN 05 Gerard Le Grellelaan
653,Gerard le Grellelaan 10,2022-12-09,08:00:00,153,121,32,FMN 05 Gerard Le Grellelaan
653,Gerard le Grellelaan 10,2022-12-09,09:00:00,47,35,12,FMN 05 Gerard Le Grellelaan
653,Gerard le Grellelaan 10,2022-12-09,10:00:00,57,50,7,FMN 05 Gerard Le Grellelaan
653,Gerard le Grellelaan 10,2022-12-09,11:00:00,35,27,8,FMN 05 Gerard Le Grellelaan
653,Gerard le Grellelaan 10,2022-12-09,12:00:00,66,52,14,FMN 05 Gerard Le Grellelaan
653,Gerard le Grellelaan 10,2022-12-09,13:00:00,66,48,18,FMN 05 Gerard Le Grellelaan
653,Gerard le Grellelaan 10,2022-12-09,14:00:00,46,40,6,FMN 05 Gerard Le Grellelaan
653,Gerard le Grellelaan 10,2022-12-09,15:00:00,98,80,18,FMN 05 Gerard Le Grellelaan
653,Gerard le Grellelaan 10,2022-12-09,16:00:00,102,87,15,FMN 05 Gerard Le Grellelaan
653,Gerard le Grellelaan 10,2022-12-09,17:00:00,85,71,14,FMN 05 Gerard Le Grellelaan
653,Gerard le Grellelaan 10,2022-12-09,18:00:00,62,51,11,FMN 05 Gerard Le Grellelaan
653,Gerard le Grellelaan 10,2022-12-09,19:00:00,38,30,8,FMN 05 Gerard Le Grellelaan
653,Gerard le Grellelaan 10,2022-12-09,20:00:00,25,20,5,FMN 05 Gerard Le Grellelaan
653,Gerard le Grellelaan 10,2022-12-09,21:00:00,17,15,2,FMN 05 Gerard Le Grellelaan
653,Gerard le Grellelaan 10,2022-12-09,22:00:00,9,6,3,FMN 05 Gerard Le Grellelaan
653,Gerard le Grellelaan 10,2022-12-09,23:00:00,11,8,3,FMN 05 Gerard Le Grellelaan
653,Gerard le Grellelaan 10,2022-12-10,00:00:00,8,4,4,FMN 05 Gerard Le Grellelaan
653,Gerard le Grellelaan 10,2022-12-10,01:00:00,6,4,2,FMN 05 Gerard Le Grellelaan
653,Gerard le Grellelaan 10,2022-12-10,02:00:00,2,1,1,FMN 05 Gerard Le Grellelaan
653,Gerard le Grellelaan 10,2022-12-10,03:00:00,2,1,1,FMN 05 Gerard Le Grellelaan
653,Gerard le Grellelaan 10,2022-12-10,04:00:00,5,3,2,FMN 05 Gerard Le Grellelaan
653,Gerard le Grellelaan 10,2022-12-10,05:00:00,2,2,0,FMN 05 Gerard Le Grellelaan
653,Gerard le Grellelaan 10,2022-12-10,06:00:00,8,4,4,FMN 05 Gerard Le Grellelaan
653,Gerard le Grellelaan 10,2022-12-10,07:00:00,8,7,1,FMN 05 Gerard Le Grellelaan
653,Gerard le Grellelaan 10,2022-12-10,08:00:00,14,11,3,FMN 05 Gerard Le Grellelaan
653,Gerard le Grellelaan 10,2022-12-10,09:00:00,24,20,4,FMN 05 Gerard Le Grellelaan
653,Gerard le Grellelaan 10,2022-12-10,10:00:00,18,14,4,FMN 05 Gerard Le Grellelaan
653,Gerard le Grellelaan 10,2022-12-10,11:00:00,38,32,6,FMN 05 Gerard Le Grellelaan
653,Gerard le Grellelaan 10,2022-12-10,12:00:00,34,25,9,FMN 05 Gerard Le Grellelaan
653,Gerard le Grellelaan 10,2022-12-10,13:00:00,26,24,2,FMN 05 Gerard Le Grellelaan
653,Gerard le Grellelaan 10,2022-12-10,14:00:00,28,25,3,FMN 05 Gerard Le Grellelaan
653,Gerard le Grellelaan 10,2022-12-10,15:00:00,35,32,3,FMN 05 Gerard Le Grellelaan
653,Gerard le Grellelaan 10,2022-12-10,16:00:00,18,14,4,FMN 05 Gerard Le Grellelaan
653,Gerard le Grellelaan 10,2022-12-10,17:00:00,25,21,4,FMN 05 Gerard Le Grellelaan
653,Gerard le Grellelaan 10,2022-12-10,18:00:00,29,23,6,FMN 05 Gerard Le Grellelaan
653,Gerard le Grellelaan 10,2022-12-10,19:00:00,20,16,4,FMN 05 Gerard Le Grellelaan
653,Gerard le Grellelaan 10,2022-12-10,20:00:00,19,15,4,FMN 05 Gerard Le Grellelaan
653,Gerard le Grellelaan 10,2022-12-10,21:00:00,8,7,1,FMN 05 Gerard Le Grellelaan
653,Gerard le Grellelaan 10,2022-12-10,22:00:00,13,11,2,FMN 05 Gerard Le Grellelaan
653,Gerard le Grellelaan 10,2022-12-10,23:00:00,14,10,4,FMN 05 Gerard Le Grellelaan
653,Gerard le Grellelaan 10,2022-12-11,00:00:00,9,8,1,FMN 05 Gerard Le Grellelaan
653,Gerard le Grellelaan 10,2022-12-11,01:00:00,6,4,2,FMN 05 Gerard Le Grellelaan
653,Gerard le Grellelaan 10,2022-12-11,02:00:00,2,1,1,FMN 05 Gerard Le Grellelaan
653,Gerard le Grellelaan 10,2022-12-11,03:00:00,1,1,0,FMN 05 Gerard Le Grellelaan
653,Gerard le Grellelaan 10,2022-12-11,04:00:00,2,2,0,FMN 05 Gerard Le Grellelaan
653,Gerard le Grellelaan 10,2022-12-11,05:00:00,2,1,1,FMN 05 Gerard Le Grellelaan
653,Gerard le Grellelaan 10,2022-12-11,06:00:00,2,1,1,FMN 05 Gerard Le Grellelaan
653,Gerard le Grellelaan 10,2022-12-11,07:00:00,3,3,0,FMN 05 Gerard Le Grellelaan
653,Gerard le Grellelaan 10,2022-12-11,08:00:00,10,10,0,FMN 05 Gerard Le Grellelaan
653,Gerard le Grellelaan 10,2022-12-11,09:00:00,17,14,3,FMN 05 Gerard Le Grellelaan
653,Gerard le Grellelaan 10,2022-12-11,10:00:00,17,14,3,FMN 05 Gerard Le Grellelaan
653,Gerard le Grellelaan 10,2022-12-11,11:00:00,38,31,7,FMN 05 Gerard Le Grellelaan
653,Gerard le Grellelaan 10,2022-12-11,12:00:00,31,25,6,FMN 05 Gerard Le Grellelaan
653,Gerard le Grellelaan 10,2022-12-11,13:00:00,23,19,4,FMN 05 Gerard Le Grellelaan
653,Gerard le Grellelaan 10,2022-12-11,14:00:00,36,30,6,FMN 05 Gerard Le Grellelaan
653,Gerard le Grellelaan 10,2022-12-11,15:00:00,29,21,8,FMN 05 Gerard Le Grellelaan
653,Gerard le Grellelaan 10,2022-12-11,16:00:00,29,24,5,FMN 05 Gerard Le Grellelaan
653,Gerard le Grellelaan 10,2022-12-11,17:00:00,23,14,9,FMN 05 Gerard Le Grellelaan
653,Gerard le Grellelaan 10,2022-12-11,18:00:00,19,17,2,FMN 05 Gerard Le Grellelaan
653,Gerard le Grellelaan 10,2022-12-11,19:00:00,16,14,2,FMN 05 Gerard Le Grellelaan
653,Gerard le Grellelaan 10,2022-12-11,20:00:00,21,17,4,FMN 05 Gerard Le Grellelaan
653,Gerard le Grellelaan 10,2022-12-11,21:00:00,16,11,5,FMN 05 Gerard Le Grellelaan
653,Gerard le Grellelaan 10,2022-12-11,22:00:00,10,10,0,FMN 05 Gerard Le Grellelaan
653,Gerard le Grellelaan 10,2022-12-11,23:00:00,5,5,0,FMN 05 Gerard Le Grellelaan
653,Gerard le Grellelaan 10,2022-12-12,00:00:00,0,0,0,FMN 05 Gerard Le Grellelaan
653,Gerard le Grellelaan 10,2022-12-12,01:00:00,0,0,0,FMN 05 Gerard Le Grellelaan
653,Gerard le Grellelaan 10,2022-12-12,02:00:00,1,1,0,FMN 05 Gerard Le Grellelaan
653,Gerard le Grellelaan 10,2022-12-12,03:00:00,1,0,1,FMN 05 Gerard Le Grellelaan
653,Gerard le Grellelaan 10,2022-12-12,04:00:00,4,1,3,FMN 05 Gerard Le Grellelaan
653,Gerard le Grellelaan 10,2022-12-12,05:00:00,13,2,11,FMN 05 Gerard Le Grellelaan
653,Gerard le Grellelaan 10,2022-12-12,06:00:00,25,14,11,FMN 05 Gerard Le Grellelaan
653,Gerard le Grellelaan 10,2022-12-12,07:00:00,57,42,15,FMN 05 Gerard Le Grellelaan
653,Gerard le Grellelaan 10,2022-12-12,08:00:00,127,104,23,FMN 05 Gerard Le Grellelaan
653,Gerard le Grellelaan 10,2022-12-12,09:00:00,41,35,6,FMN 05 Gerard Le Grellelaan
653,Gerard le Grellelaan 10,2022-12-12,10:00:00,33,27,6,FMN 05 Gerard Le Grellelaan
653,Gerard le Grellelaan 10,2022-12-12,11:00:00,31,27,4,FMN 05 Gerard Le Grellelaan
653,Gerard le Grellelaan 10,2022-12-12,12:00:00,53,42,11,FMN 05 Gerard Le Grellelaan
653,Gerard le Grellelaan 10,2022-12-12,13:00:00,38,26,12,FMN 05 Gerard Le Grellelaan
653,Gerard le Grellelaan 10,2022-12-12,14:00:00,49,39,10,FMN 05 Gerard Le Grellelaan
653,Gerard le Grellelaan 10,2022-12-12,15:00:00,67,56,11,FMN 05 Gerard Le Grellelaan
653,Gerard le Grellelaan 10,2022-12-12,16:00:00,80,65,15,FMN 05 Gerard Le Grellelaan
653,Gerard le Grellelaan 10,2022-12-12,17:00:00,122,104,18,FMN 05 Gerard Le Grellelaan
653,Gerard le Grellelaan 10,2022-12-12,18:00:00,77,72,5,FMN 05 Gerard Le Grellelaan
653,Gerard le Grellelaan 10,2022-12-12,19:00:00,13,7,6,FMN 05 Gerard Le Grellelaan
653,Gerard le Grellelaan 10,2022-12-12,20:00:00,21,16,5,FMN 05 Gerard Le Grellelaan
653,Gerard le Grellelaan 10,2022-12-12,21:00:00,23,17,6,FMN 05 Gerard Le Grellelaan
653,Gerard le Grellelaan 10,2022-12-12,22:00:00,15,14,1,FMN 05 Gerard Le Grellelaan
653,Gerard le Grellelaan 10,2022-12-12,23:00:00,10,8,2,FMN 05 Gerard Le Grellelaan
653,Gerard le Grellelaan 10,2022-12-13,00:00:00,0,0,0,FMN 05 Gerard Le Grellelaan
653,Gerard le Grellelaan 10,2022-12-13,01:00:00,0,0,0,FMN 05 Gerard Le Grellelaan
653,Gerard le Grellelaan 10,2022-12-13,02:00:00,1,1,0,FMN 05 Gerard Le Grellelaan
653,Gerard le Grellelaan 10,2022-12-13,03:00:00,1,1,0,FMN 05 Gerard Le Grellelaan
653,Gerard le Grellelaan 10,2022-12-13,04:00:00,4,3,1,FMN 05 Gerard Le Grellelaan
653,Gerard le Grellelaan 10,2022-12-13,05:00:00,12,5,7,FMN 05 Gerard Le Grellelaan
653,Gerard le Grellelaan 10,2022-12-13,06:00:00,17,6,11,FMN 05 Gerard Le Grellelaan
653,Gerard le Grellelaan 10,2022-12-13,07:00:00,55,44,11,FMN 05 Gerard Le Grellelaan
653,Gerard le Grellelaan 10,2022-12-13,08:00:00,116,101,15,FMN 05 Gerard Le Grellelaan
653,Gerard le Grellelaan 10,2022-12-13,09:00:00,43,38,5,FMN 05 Gerard Le Grellelaan
653,Gerard le Grellelaan 10,2022-12-13,10:00:00,22,16,6,FMN 05 Gerard Le Grellelaan
653,Gerard le Grellelaan 10,2022-12-13,11:00:00,32,29,3,FMN 05 Gerard Le Grellelaan
653,Gerard le Grellelaan 10,2022-12-13,12:00:00,35,27,8,FMN 05 Gerard Le Grellelaan
653,Gerard le Grellelaan 10,2022-12-13,13:00:00,53,44,9,FMN 05 Gerard Le Grellelaan
653,Gerard le Grellelaan 10,2022-12-13,14:00:00,42,35,7,FMN 05 Gerard Le Grellelaan
653,Gerard le Grellelaan 10,2022-12-13,15:00:00,81,70,11,FMN 05 Gerard Le Grellelaan
653,Gerard le Grellelaan 10,2022-12-13,16:00:00,78,63,15,FMN 05 Gerard Le Grellelaan
653,Gerard le Grellelaan 10,2022-12-13,17:00:00,101,86,15,FMN 05 Gerard Le Grellelaan
653,Gerard le Grellelaan 10,2022-12-13,18:00:00,69,56,13,FMN 05 Gerard Le Grellelaan
653,Gerard le Grellelaan 10,2022-12-13,19:00:00,21,15,6,FMN 05 Gerard Le Grellelaan
653,Gerard le Grellelaan 10,2022-12-13,20:00:00,12,8,4,FMN 05 Gerard Le Grellelaan
653,Gerard le Grellelaan 10,2022-12-13,21:00:00,17,11,6,FMN 05 Gerard Le Grellelaan
653,Gerard le Grellelaan 10,2022-12-13,22:00:00,16,12,4,FMN 05 Gerard Le Grellelaan
653,Gerard le Grellelaan 10,2022-12-13,23:00:00,5,4,1,FMN 05 Gerard Le Grellelaan
653,Gerard le Grellelaan 10,2022-12-14,00:00:00,3,3,0,FMN 05 Gerard Le Grellelaan
653,Gerard le Grellelaan 10,2022-12-14,01:00:00,1,1,0,FMN 05 Gerard Le Grellelaan
653,Gerard le Grellelaan 10,2022-12-14,02:00:00,0,0,0,FMN 05 Gerard Le Grellelaan
653,Gerard le Grellelaan 10,2022-12-14,03:00:00,1,0,1,FMN 05 Gerard Le Grellelaan
653,Gerard le Grellelaan 10,2022-12-14,04:00:00,2,2,0,FMN 05 Gerard Le Grellelaan
653,Gerard le Grellelaan 10,2022-12-14,05:00:00,10,5,5,FMN 05 Gerard Le Grellelaan
653,Gerard le Grellelaan 10,2022-12-14,06:00:00,17,12,5,FMN 05 Gerard Le Grellelaan
653,Gerard le Grellelaan 10,2022-12-14,07:00:00,57,46,11,FMN 05 Gerard Le Grellelaan
653,Gerard le Grellelaan 10,2022-12-14,08:00:00,125,103,22,FMN 05 Gerard Le Grellelaan
653,Gerard le Grellelaan 10,2022-12-14,09:00:00,35,28,7,FMN 05 Gerard Le Grellelaan
653,Gerard le Grellelaan 10,2022-12-14,10:00:00,36,33,3,FMN 05 Gerard Le Grellelaan
653,Gerard le Grellelaan 10,2022-12-14,11:00:00,31,27,4,FMN 05 Gerard Le Grellelaan
653,Gerard le Grellelaan 10,2022-12-14,12:00:00,61,42,19,FMN 05 Gerard Le Grellelaan
653,Gerard le Grellelaan 10,2022-12-14,13:00:00,53,42,11,FMN 05 Gerard Le Grellelaan
653,Gerard le Grellelaan 10,2022-12-14,14:00:00,41,29,12,FMN 05 Gerard Le Grellelaan
653,Gerard le Grellelaan 10,2022-12-14,15:00:00,56,53,3,FMN 05 Gerard Le Grellelaan
653,Gerard le Grellelaan 10,2022-12-14,16:00:00,67,57,10,FMN 05 Gerard Le Grellelaan
653,Gerard le Grellelaan 10,2022-12-14,17:00:00,70,65,5,FMN 05 Gerard Le Grellelaan
653,Gerard le Grellelaan 10,2022-12-14,18:00:00,56,47,9,FMN 05 Gerard Le Grellelaan
653,Gerard le Grellelaan 10,2022-12-14,19:00:00,35,29,6,FMN 05 Gerard Le Grellelaan
653,Gerard le Grellelaan 10,2022-12-14,20:00:00,16,12,4,FMN 05 Gerard Le Grellelaan
653,Gerard le Grellelaan 10,2022-12-14,21:00:00,14,12,2,FMN 05 Gerard Le Grellelaan
653,Gerard le Grellelaan 10,2022-12-14,22:00:00,19,16,3,FMN 05 Gerard Le Grellelaan
653,Gerard le Grellelaan 10,2022-12-14,23:00:00,7,3,4,FMN 05 Gerard Le Grellelaan
653,Gerard le Grellelaan 10,2022-12-15,00:00:00,0,0,0,FMN 05 Gerard Le Grellelaan
653,Gerard le Grellelaan 10,2022-12-15,01:00:00,1,1,0,FMN 05 Gerard Le Grellelaan
653,Gerard le Grellelaan 10,2022-12-15,02:00:00,1,1,0,FMN 05 Gerard Le Grellelaan
653,Gerard le Grellelaan 10,2022-12-15,03:00:00,2,0,2,FMN 05 Gerard Le Grellelaan
653,Gerard le Grellelaan 10,2022-12-15,04:00:00,2,2,0,FMN 05 Gerard Le Grellelaan
653,Gerard le Grellelaan 10,2022-12-15,05:00:00,9,4,5,FMN 05 Gerard Le Grellelaan
653,Gerard le Grellelaan 10,2022-12-15,06:00:00,12,7,5,FMN 05 Gerard Le Grellelaan
653,Gerard le Grellelaan 10,2022-12-15,07:00:00,52,39,13,FMN 05 Gerard Le Grellelaan
653,Gerard le Grellelaan 10,2022-12-15,08:00:00,148,124,24,FMN 05 Gerard Le Grellelaan
653,Gerard le Grellelaan 10,2022-12-15,09:00:00,48,43,5,FMN 05 Gerard Le Grellelaan
653,Gerard le Grellelaan 10,2022-12-15,10:00:00,32,25,7,FMN 05 Gerard Le Grellelaan
653,Gerard le Grellelaan 10,2022-12-15,11:00:00,16,15,1,FMN 05 Gerard Le Grellelaan
653,Gerard le Grellelaan 10,2022-12-15,12:00:00,41,30,11,FMN 05 Gerard Le Grellelaan
653,Gerard le Grellelaan 10,2022-12-15,13:00:00,43,35,8,FMN 05 Gerard Le Grellelaan
653,Gerard le Grellelaan 10,2022-12-15,14:00:00,38,36,2,FMN 05 Gerard Le Grellelaan
653,Gerard le Grellelaan 10,2022-12-15,15:00:00,69,52,17,FMN 05 Gerard Le Grellelaan
653,Gerard le Grellelaan 10,2022-12-15,16:00:00,84,64,20,FMN 05 Gerard Le Grellelaan
653,Gerard le Grellelaan 10,2022-12-15,17:00:00,85,68,17,FMN 05 Gerard Le Grellelaan
653,Gerard le Grellelaan 10,2022-12-15,18:00:00,57,50,7,FMN 05 Gerard Le Grellelaan
653,Gerard le Grellelaan 10,2022-12-15,19:00:00,47,36,11,FMN 05 Gerard Le Grellelaan
653,Gerard le Grellelaan 10,2022-12-15,20:00:00,10,9,1,FMN 05 Gerard Le Grellelaan
653,Gerard le Grellelaan 10,2022-12-15,21:00:00,10,8,2,FMN 05 Gerard Le Grellelaan
653,Gerard le Grellelaan 10,2022-12-15,22:00:00,12,10,2,FMN 05 Gerard Le Grellelaan
653,Gerard le Grellelaan 10,2022-12-15,23:00:00,5,3,2,FMN 05 Gerard Le Grellelaan
653,Gerard le Grellelaan 10,2022-12-16,00:00:00,5,3,2,FMN 05 Gerard Le Grellelaan
653,Gerard le Grellelaan 10,2022-12-16,01:00:00,2,1,1,FMN 05 Gerard Le Grellelaan
653,Gerard le Grellelaan 10,2022-12-16,02:00:00,4,3,1,FMN 05 Gerard Le Grellelaan
653,Gerard le Grellelaan 10,2022-12-16,03:00:00,4,3,1,FMN 05 Gerard Le Grellelaan
653,Gerard le Grellelaan 10,2022-12-16,04:00:00,4,3,1,FMN 05 Gerard Le Grellelaan
653,Gerard le Grellelaan 10,2022-12-16,05:00:00,9,4,5,FMN 05 Gerard Le Grellelaan
653,Gerard le Grellelaan 10,2022-12-16,06:00:00,18,8,10,FMN 05 Gerard Le Grellelaan
653,Gerard le Grellelaan 10,2022-12-16,07:00:00,65,52,13,FMN 05 Gerard Le Grellelaan
653,Gerard le Grellelaan 10,2022-12-16,08:00:00,105,87,18,FMN 05 Gerard Le Grellelaan
653,Gerard le Grellelaan 10,2022-12-16,09:00:00,42,39,3,FMN 05 Gerard Le Grellelaan
653,Gerard le Grellelaan 10,2022-12-16,10:00:00,38,33,5,FMN 05 Gerard Le Grellelaan
653,Gerard le Grellelaan 10,2022-12-16,11:00:00,31,24,7,FMN 05 Gerard Le Grellelaan
653,Gerard le Grellelaan 10,2022-12-16,12:00:00,58,49,9,FMN 05 Gerard Le Grellelaan
653,Gerard le Grellelaan 10,2022-12-16,13:00:00,50,40,10,FMN 05 Gerard Le Grellelaan
653,Gerard le Grellelaan 10,2022-12-16,14:00:00,47,37,10,FMN 05 Gerard Le Grellelaan
653,Gerard le Grellelaan 10,2022-12-16,15:00:00,82,63,19,FMN 05 Gerard Le Grellelaan
653,Gerard le Grellelaan 10,2022-12-16,16:00:00,74,63,11,FMN 05 Gerard Le Grellelaan
653,Gerard le Grellelaan 10,2022-12-16,17:00:00,87,77,10,FMN 05 Gerard Le Grellelaan
653,Gerard le Grellelaan 10,2022-12-16,18:00:00,52,42,10,FMN 05 Gerard Le Grellelaan
653,Gerard le Grellelaan 10,2022-12-16,19:00:00,41,34,7,FMN 05 Gerard Le Grellelaan
653,Gerard le Grellelaan 10,2022-12-16,20:00:00,17,15,2,FMN 05 Gerard Le Grellelaan
653,Gerard le Grellelaan 10,2022-12-16,21:00:00,13,9,4,FMN 05 Gerard Le Grellelaan
653,Gerard le Grellelaan 10,2022-12-16,22:00:00,13,10,3,FMN 05 Gerard Le Grellelaan
653,Gerard le Grellelaan 10,2022-12-16,23:00:00,4,3,1,FMN 05 Gerard Le Grellelaan
653,Gerard le Grellelaan 10,2022-12-17,00:00:00,5,5,0,FMN 05 Gerard Le Grellelaan
653,Gerard le Grellelaan 10,2022-12-17,01:00:00,4,3,1,FMN 05 Gerard Le Grellelaan
653,Gerard le Grellelaan 10,2022-12-17,02:00:00,2,1,1,FMN 05 Gerard Le Grellelaan
653,Gerard le Grellelaan 10,2022-12-17,03:00:00,1,0,1,FMN 05 Gerard Le Grellelaan
653,Gerard le Grellelaan 10,2022-12-17,04:00:00,1,1,0,FMN 05 Gerard Le Grellelaan
653,Gerard le Grellelaan 10,2022-12-17,05:00:00,1,0,1,FMN 05 Gerard Le Grellelaan
653,Gerard le Grellelaan 10,2022-12-17,06:00:00,3,1,2,FMN 05 Gerard Le Grellelaan
653,Gerard le Grellelaan 10,2022-12-17,07:00:00,5,3,2,FMN 05 Gerard Le Grellelaan
653,Gerard le Grellelaan 10,2022-12-17,08:00:00,8,6,2,FMN 05 Gerard Le Grellelaan
653,Gerard le Grellelaan 10,2022-12-17,09:00:00,13,10,3,FMN 05 Gerard Le Grellelaan
653,Gerard le Grellelaan 10,2022-12-17,10:00:00,16,12,4,FMN 05 Gerard Le Grellelaan
653,Gerard le Grellelaan 10,2022-12-17,11:00:00,19,15,4,FMN 05 Gerard Le Grellelaan
653,Gerard le Grellelaan 10,2022-12-17,12:00:00,22,17,5,FMN 05 Gerard Le Grellelaan
653,Gerard le Grellelaan 10,2022-12-17,13:00:00,30,27,3,FMN 05 Gerard Le Grellelaan
653,Gerard le Grellelaan 10,2022-12-17,14:00:00,30,28,2,FMN 05 Gerard Le Grellelaan
653,Gerard le Grellelaan 10,2022-12-17,15:00:00,31,24,7,FMN 05 Gerard Le Grellelaan
653,Gerard le Grellelaan 10,2022-12-17,16:00:00,14,10,4,FMN 05 Gerard Le Grellelaan
653,Gerard le Grellelaan 10,2022-12-17,17:00:00,16,14,2,FMN 05 Gerard Le Grellelaan
653,Gerard le Grellelaan 10,2022-12-17,18:00:00,21,20,1,FMN 05 Gerard Le Grellelaan
653,Gerard le Grellelaan 10,2022-12-17,19:00:00,17,13,4,FMN 05 Gerard Le Grellelaan
653,Gerard le Grellelaan 10,2022-12-17,20:00:00,14,8,6,FMN 05 Gerard Le Grellelaan
653,Gerard le Grellelaan 10,2022-12-17,21:00:00,8,8,0,FMN 05 Gerard Le Grellelaan
653,Gerard le Grellelaan 10,2022-12-17,22:00:00,8,7,1,FMN 05 Gerard Le Grellelaan
653,Gerard le Grellelaan 10,2022-12-17,23:00:00,3,2,1,FMN 05 Gerard Le Grellelaan
653,Gerard le Grellelaan 10,2022-12-18,00:00:00,8,6,2,FMN 05 Gerard Le Grellelaan
653,Gerard le Grellelaan 10,2022-12-18,01:00:00,4,3,1,FMN 05 Gerard Le Grellelaan
653,Gerard le Grellelaan 10,2022-12-18,02:00:00,2,2,0,FMN 05 Gerard Le Grellelaan
653,Gerard le Grellelaan 10,2022-12-18,03:00:00,1,1,0,FMN 05 Gerard Le Grellelaan
653,Gerard le Grellelaan 10,2022-12-18,04:00:00,2,1,1,FMN 05 Gerard Le Grellelaan
653,Gerard le Grellelaan 10,2022-12-18,05:00:00,0,0,0,FMN 05 Gerard Le Grellelaan
653,Gerard le Grellelaan 10,2022-12-18,06:00:00,1,1,0,FMN 05 Gerard Le Grellelaan
653,Gerard le Grellelaan 10,2022-12-18,07:00:00,2,1,1,FMN 05 Gerard Le Grellelaan
653,Gerard le Grellelaan 10,2022-12-18,08:00:00,3,3,0,FMN 05 Gerard Le Grellelaan
653,Gerard le Grellelaan 10,2022-12-18,09:00:00,8,8,0,FMN 05 Gerard Le Grellelaan
653,Gerard le Grellelaan 10,2022-12-18,10:00:00,14,12,2,FMN 05 Gerard Le Grellelaan
653,Gerard le Grellelaan 10,2022-12-18,11:00:00,17,15,2,FMN 05 Gerard Le Grellelaan
653,Gerard le Grellelaan 10,2022-12-18,12:00:00,14,9,5,FMN 05 Gerard Le Grellelaan
653,Gerard le Grellelaan 10,2022-12-18,13:00:00,10,8,2,FMN 05 Gerard Le Grellelaan
653,Gerard le Grellelaan 10,2022-12-18,14:00:00,26,22,4,FMN 05 Gerard Le Grellelaan
653,Gerard le Grellelaan 10,2022-12-18,15:00:00,14,14,0,FMN 05 Gerard Le Grellelaan
653,Gerard le Grellelaan 10,2022-12-18,16:00:00,12,9,3,FMN 05 Gerard Le Grellelaan
653,Gerard le Grellelaan 10,2022-12-18,17:00:00,14,12,2,FMN 05 Gerard Le Grellelaan
653,Gerard le Grellelaan 10,2022-12-18,18:00:00,9,8,1,FMN 05 Gerard Le Grellelaan
653,Gerard le Grellelaan 10,2022-12-18,19:00:00,5,3,2,FMN 05 Gerard Le Grellelaan
653,Gerard le Grellelaan 10,2022-12-18,20:00:00,4,3,1,FMN 05 Gerard Le Grellelaan
653,Gerard le Grellelaan 10,2022-12-18,21:00:00,4,4,0,FMN 05 Gerard Le Grellelaan
653,Gerard le Grellelaan 10,2022-12-18,22:00:00,8,4,4,FMN 05 Gerard Le Grellelaan
653,Gerard le Grellelaan 10,2022-12-18,23:00:00,1,0,1,FMN 05 Gerard Le Grellelaan
653,Gerard le Grellelaan 10,2022-12-19,00:00:00,0,0,0,FMN 05 Gerard Le Grellelaan
653,Gerard le Grellelaan 10,2022-12-19,01:00:00,1,1,0,FMN 05 Gerard Le Grellelaan
653,Gerard le Grellelaan 10,2022-12-19,02:00:00,2,1,1,FMN 05 Gerard Le Grellelaan
653,Gerard le Grellelaan 10,2022-12-19,03:00:00,0,0,0,FMN 05 Gerard Le Grellelaan
653,Gerard le Grellelaan 10,2022-12-19,04:00:00,5,1,4,FMN 05 Gerard Le Grellelaan
653,Gerard le Grellelaan 10,2022-12-19,05:00:00,6,2,4,FMN 05 Gerard Le Grellelaan
653,Gerard le Grellelaan 10,2022-12-19,06:00:00,8,6,2,FMN 05 Gerard Le Grellelaan
653,Gerard le Grellelaan 10,2022-12-19,07:00:00,61,49,12,FMN 05 Gerard Le Grellelaan
653,Gerard le Grellelaan 10,2022-12-19,08:00:00,148,121,27,FMN 05 Gerard Le Grellelaan
653,Gerard le Grellelaan 10,2022-12-19,09:00:00,54,45,9,FMN 05 Gerard Le Grellelaan
653,Gerard le Grellelaan 10,2022-12-19,10:00:00,34,26,8,FMN 05 Gerard Le Grellelaan
653,Gerard le Grellelaan 10,2022-12-19,11:00:00,39,39,0,FMN 05 Gerard Le Grellelaan
653,Gerard le Grellelaan 10,2022-12-19,12:00:00,50,37,13,FMN 05 Gerard Le Grellelaan
653,Gerard le Grellelaan 10,2022-12-19,13:00:00,42,38,4,FMN 05 Gerard Le Grellelaan
653,Gerard le Grellelaan 10,2022-12-19,14:00:00,58,50,8,FMN 05 Gerard Le Grellelaan
653,Gerard le Grellelaan 10,2022-12-19,15:00:00,88,79,9,FMN 05 Gerard Le Grellelaan
653,Gerard le Grellelaan 10,2022-12-19,16:00:00,81,68,13,FMN 05 Gerard Le Grellelaan
653,Gerard le Grellelaan 10,2022-12-19,17:00:00,108,88,20,FMN 05 Gerard Le Grellelaan
653,Gerard le Grellelaan 10,2022-12-19,18:00:00,96,76,20,FMN 05 Gerard Le Grellelaan
653,Gerard le Grellelaan 10,2022-12-19,19:00:00,46,41,5,FMN 05 Gerard Le Grellelaan
653,Gerard le Grellelaan 10,2022-12-19,20:00:00,29,26,3,FMN 05 Gerard Le Grellelaan
653,Gerard le Grellelaan 10,2022-12-19,21:00:00,26,19,7,FMN 05 Gerard Le Grellelaan
653,Gerard le Grellelaan 10,2022-12-19,22:00:00,27,24,3,FMN 05 Gerard Le Grellelaan
653,Gerard le Grellelaan 10,2022-12-19,23:00:00,9,7,2,FMN 05 Gerard Le Grellelaan
653,Gerard le Grellelaan 10,2022-12-20,00:00:00,5,3,2,FMN 05 Gerard Le Grellelaan
653,Gerard le Grellelaan 10,2022-12-20,01:00:00,2,2,0,FMN 05 Gerard Le Grellelaan
653,Gerard le Grellelaan 10,2022-12-20,02:00:00,1,1,0,FMN 05 Gerard Le Grellelaan
653,Gerard le Grellelaan 10,2022-12-20,03:00:00,1,1,0,FMN 05 Gerard Le Grellelaan
653,Gerard le Grellelaan 10,2022-12-20,04:00:00,9,5,4,FMN 05 Gerard Le Grellelaan
653,Gerard le Grellelaan 10,2022-12-20,05:00:00,21,4,17,FMN 05 Gerard Le Grellelaan
653,Gerard le Grellelaan 10,2022-12-20,06:00:00,35,17,18,FMN 05 Gerard Le Grellelaan
653,Gerard le Grellelaan 10,2022-12-20,07:00:00,108,83,25,FMN 05 Gerard Le Grellelaan
653,Gerard le Grellelaan 10,2022-12-20,08:00:00,215,172,43,FMN 05 Gerard Le Grellelaan
653,Gerard le Grellelaan 10,2022-12-20,09:00:00,74,60,14,FMN 05 Gerard Le Grellelaan
653,Gerard le Grellelaan 10,2022-12-20,10:00:00,58,50,8,FMN 05 Gerard Le Grellelaan
653,Gerard le Grellelaan 10,2022-12-20,11:00:00,43,40,3,FMN 05 Gerard Le Grellelaan
653,Gerard le Grellelaan 10,2022-12-20,12:00:00,46,38,8,FMN 05 Gerard Le Grellelaan
653,Gerard le Grellelaan 10,2022-12-20,13:00:00,48,33,15,FMN 05 Gerard Le Grellelaan
653,Gerard le Grellelaan 10,2022-12-20,14:00:00,38,31,7,FMN 05 Gerard Le Grellelaan
653,Gerard le Grellelaan 10,2022-12-20,15:00:00,82,71,11,FMN 05 Gerard Le Grellelaan
653,Gerard le Grellelaan 10,2022-12-20,16:00:00,128,107,21,FMN 05 Gerard Le Grellelaan
653,Gerard le Grellelaan 10,2022-12-20,17:00:00,130,106,24,FMN 05 Gerard Le Grellelaan
653,Gerard le Grellelaan 10,2022-12-20,18:00:00,75,54,21,FMN 05 Gerard Le Grellelaan
653,Gerard le Grellelaan 10,2022-12-20,19:00:00,43,36,7,FMN 05 Gerard Le Grellelaan
653,Gerard le Grellelaan 10,2022-12-20,20:00:00,22,16,6,FMN 05 Gerard Le Grellelaan
653,Gerard le Grellelaan 10,2022-12-20,21:00:00,16,13,3,FMN 05 Gerard Le Grellelaan
653,Gerard le Grellelaan 10,2022-12-20,22:00:00,30,20,10,FMN 05 Gerard Le Grellelaan
653,Gerard le Grellelaan 10,2022-12-20,23:00:00,10,7,3,FMN 05 Gerard Le Grellelaan
653,Gerard le Grellelaan 10,2022-12-21,00:00:00,3,2,1,FMN 05 Gerard Le Grellelaan
653,Gerard le Grellelaan 10,2022-12-21,01:00:00,5,4,1,FMN 05 Gerard Le Grellelaan
653,Gerard le Grellelaan 10,2022-12-21,02:00:00,2,1,1,FMN 05 Gerard Le Grellelaan
653,Gerard le Grellelaan 10,2022-12-21,03:00:00,2,0,2,FMN 05 Gerard Le Grellelaan
653,Gerard le Grellelaan 10,2022-12-21,04:00:00,5,2,3,FMN 05 Gerard Le Grellelaan
653,Gerard le Grellelaan 10,2022-12-21,05:00:00,18,7,11,FMN 05 Gerard Le Grellelaan
653,Gerard le Grellelaan 10,2022-12-21,06:00:00,23,11,12,FMN 05 Gerard Le Grellelaan
653,Gerard le Grellelaan 10,2022-12-21,07:00:00,94,68,26,FMN 05 Gerard Le Grellelaan
653,Gerard le Grellelaan 10,2022-12-21,08:00:00,173,138,35,FMN 05 Gerard Le Grellelaan
653,Gerard le Grellelaan 10,2022-12-21,09:00:00,66,62,4,FMN 05 Gerard Le Grellelaan
653,Gerard le Grellelaan 10,2022-12-21,10:00:00,47,40,7,FMN 05 Gerard Le Grellelaan
653,Gerard le Grellelaan 10,2022-12-21,11:00:00,55,42,13,FMN 05 Gerard Le Grellelaan
653,Gerard le Grellelaan 10,2022-12-21,12:00:00,81,63,18,FMN 05 Gerard Le Grellelaan
653,Gerard le Grellelaan 10,2022-12-21,13:00:00,100,91,9,FMN 05 Gerard Le Grellelaan
653,Gerard le Grellelaan 10,2022-12-21,14:00:00,57,49,8,FMN 05 Gerard Le Grellelaan
653,Gerard le Grellelaan 10,2022-12-21,15:00:00,76,60,16,FMN 05 Gerard Le Grellelaan
653,Gerard le Grellelaan 10,2022-12-21,16:00:00,107,92,15,FMN 05 Gerard Le Grellelaan
653,Gerard le Grellelaan 10,2022-12-21,17:00:00,109,88,21,FMN 05 Gerard Le Grellelaan
653,Gerard le Grellelaan 10,2022-12-21,18:00:00,80,71,9,FMN 05 Gerard Le Grellelaan
653,Gerard le Grellelaan 10,2022-12-21,19:00:00,65,53,12,FMN 05 Gerard Le Grellelaan
653,Gerard le Grellelaan 10,2022-12-21,20:00:00,27,25,2,FMN 05 Gerard Le Grellelaan
653,Gerard le Grellelaan 10,2022-12-21,21:00:00,25,20,5,FMN 05 Gerard Le Grellelaan
653,Gerard le Grellelaan 10,2022-12-21,22:00:00,37,29,8,FMN 05 Gerard Le Grellelaan
653,Gerard le Grellelaan 10,2022-12-21,23:00:00,15,15,0,FMN 05 Gerard Le Grellelaan
653,Gerard le Grellelaan 10,2022-12-22,00:00:00,7,4,3,FMN 05 Gerard Le Grellelaan
653,Gerard le Grellelaan 10,2022-12-22,01:00:00,3,0,3,FMN 05 Gerard Le Grellelaan
653,Gerard le Grellelaan 10,2022-12-22,02:00:00,3,3,0,FMN 05 Gerard Le Grellelaan
653,Gerard le Grellelaan 10,2022-12-22,03:00:00,2,1,1,FMN 05 Gerard Le Grellelaan
653,Gerard le Grellelaan 10,2022-12-22,04:00:00,6,4,2,FMN 05 Gerard Le Grellelaan
653,Gerard le Grellelaan 10,2022-12-22,05:00:00,19,7,12,FMN 05 Gerard Le Grellelaan
653,Gerard le Grellelaan 10,2022-12-22,06:00:00,24,11,13,FMN 05 Gerard Le Grellelaan
653,Gerard le Grellelaan 10,2022-12-22,07:00:00,83,60,23,FMN 05 Gerard Le Grellelaan
653,Gerard le Grellelaan 10,2022-12-22,08:00:00,198,160,38,FMN 05 Gerard Le Grellelaan
653,Gerard le Grellelaan 10,2022-12-22,09:00:00,75,61,14,FMN 05 Gerard Le Grellelaan
653,Gerard le Grellelaan 10,2022-12-22,10:00:00,57,53,4,FMN 05 Gerard Le Grellelaan
653,Gerard le Grellelaan 10,2022-12-22,11:00:00,37,33,4,FMN 05 Gerard Le Grellelaan
653,Gerard le Grellelaan 10,2022-12-22,12:00:00,62,56,6,FMN 05 Gerard Le Grellelaan
653,Gerard le Grellelaan 10,2022-12-22,13:00:00,70,60,10,FMN 05 Gerard Le Grellelaan
653,Gerard le Grellelaan 10,2022-12-22,14:00:00,69,62,7,FMN 05 Gerard Le Grellelaan
653,Gerard le Grellelaan 10,2022-12-22,15:00:00,96,79,17,FMN 05 Gerard Le Grellelaan
653,Gerard le Grellelaan 10,2022-12-22,16:00:00,108,89,19,FMN 05 Gerard Le Grellelaan
653,Gerard le Grellelaan 10,2022-12-22,17:00:00,119,98,21,FMN 05 Gerard Le Grellelaan
653,Gerard le Grellelaan 10,2022-12-22,18:00:00,78,68,10,FMN 05 Gerard Le Grellelaan
653,Gerard le Grellelaan 10,2022-12-22,19:00:00,43,38,5,FMN 05 Gerard Le Grellelaan
653,Gerard le Grellelaan 10,2022-12-22,20:00:00,32,28,4,FMN 05 Gerard Le Grellelaan
653,Gerard le Grellelaan 10,2022-12-22,21:00:00,22,13,9,FMN 05 Gerard Le Grellelaan
653,Gerard le Grellelaan 10,2022-12-22,22:00:00,29,22,7,FMN 05 Gerard Le Grellelaan
653,Gerard le Grellelaan 10,2022-12-22,23:00:00,20,12,8,FMN 05 Gerard Le Grellelaan
653,Gerard le Grellelaan 10,2022-12-23,00:00:00,7,5,2,FMN 05 Gerard Le Grellelaan
653,Gerard le Grellelaan 10,2022-12-23,01:00:00,11,8,3,FMN 05 Gerard Le Grellelaan
653,Gerard le Grellelaan 10,2022-12-23,02:00:00,8,7,1,FMN 05 Gerard Le Grellelaan
653,Gerard le Grellelaan 10,2022-12-23,03:00:00,1,0,1,FMN 05 Gerard Le Grellelaan
653,Gerard le Grellelaan 10,2022-12-23,04:00:00,3,2,1,FMN 05 Gerard Le Grellelaan
653,Gerard le Grellelaan 10,2022-12-23,05:00:00,16,5,11,FMN 05 Gerard Le Grellelaan
653,Gerard le Grellelaan 10,2022-12-23,06:00:00,24,9,15,FMN 05 Gerard Le Grellelaan
653,Gerard le Grellelaan 10,2022-12-23,07:00:00,71,52,19,FMN 05 Gerard Le Grellelaan
653,Gerard le Grellelaan 10,2022-12-23,08:00:00,156,125,31,FMN 05 Gerard Le Grellelaan
653,Gerard le Grellelaan 10,2022-12-23,09:00:00,57,48,9,FMN 05 Gerard Le Grellelaan
653,Gerard le Grellelaan 10,2022-12-23,10:00:00,54,46,8,FMN 05 Gerard Le Grellelaan
653,Gerard le Grellelaan 10,2022-12-23,11:00:00,34,27,7,FMN 05 Gerard Le Grellelaan
653,Gerard le Grellelaan 10,2022-12-23,12:00:00,41,32,9,FMN 05 Gerard Le Grellelaan
653,Gerard le Grellelaan 10,2022-12-23,13:00:00,27,20,7,FMN 05 Gerard Le Grellelaan
653,Gerard le Grellelaan 10,2022-12-23,14:00:00,40,32,8,FMN 05 Gerard Le Grellelaan
653,Gerard le Grellelaan 10,2022-12-23,15:00:00,98,74,24,FMN 05 Gerard Le Grellelaan
653,Gerard le Grellelaan 10,2022-12-23,16:00:00,90,78,12,FMN 05 Gerard Le Grellelaan
653,Gerard le Grellelaan 10,2022-12-23,17:00:00,100,83,17,FMN 05 Gerard Le Grellelaan
653,Gerard le Grellelaan 10,2022-12-23,18:00:00,50,37,13,FMN 05 Gerard Le Grellelaan
653,Gerard le Grellelaan 10,2022-12-23,19:00:00,45,37,8,FMN 05 Gerard Le Grellelaan
653,Gerard le Grellelaan 10,2022-12-23,20:00:00,20,14,6,FMN 05 Gerard Le Grellelaan
653,Gerard le Grellelaan 10,2022-12-23,21:00:00,33,31,2,FMN 05 Gerard Le Grellelaan
653,Gerard le Grellelaan 10,2022-12-23,22:00:00,23,15,8,FMN 05 Gerard Le Grellelaan
653,Gerard le Grellelaan 10,2022-12-23,23:00:00,12,9,3,FMN 05 Gerard Le Grellelaan
653,Gerard le Grellelaan 10,2022-12-24,00:00:00,7,5,2,FMN 05 Gerard Le Grellelaan
653,Gerard le Grellelaan 10,2022-12-24,01:00:00,6,3,3,FMN 05 Gerard Le Grellelaan
653,Gerard le Grellelaan 10,2022-12-24,02:00:00,5,5,0,FMN 05 Gerard Le Grellelaan
653,Gerard le Grellelaan 10,2022-12-24,03:00:00,3,3,0,FMN 05 Gerard Le Grellelaan
653,Gerard le Grellelaan 10,2022-12-24,04:00:00,6,4,2,FMN 05 Gerard Le Grellelaan
653,Gerard le Grellelaan 10,2022-12-24,05:00:00,5,4,1,FMN 05 Gerard Le Grellelaan
653,Gerard le Grellelaan 10,2022-12-24,06:00:00,4,3,1,FMN 05 Gerard Le Grellelaan
653,Gerard le Grellelaan 10,2022-12-24,07:00:00,7,7,0,FMN 05 Gerard Le Grellelaan
653,Gerard le Grellelaan 10,2022-12-24,08:00:00,24,16,8,FMN 05 Gerard Le Grellelaan
653,Gerard le Grellelaan 10,2022-12-24,09:00:00,30,23,7,FMN 05 Gerard Le Grellelaan
653,Gerard le Grellelaan 10,2022-12-24,10:00:00,30,23,7,FMN 05 Gerard Le Grellelaan
653,Gerard le Grellelaan 10,2022-12-24,11:00:00,49,38,11,FMN 05 Gerard Le Grellelaan
653,Gerard le Grellelaan 10,2022-12-24,12:00:00,36,21,15,FMN 05 Gerard Le Grellelaan
653,Gerard le Grellelaan 10,2022-12-24,13:00:00,38,33,5,FMN 05 Gerard Le Grellelaan
653,Gerard le Grellelaan 10,2022-12-24,14:00:00,36,28,8,FMN 05 Gerard Le Grellelaan
653,Gerard le Grellelaan 10,2022-12-24,15:00:00,34,29,5,FMN 05 Gerard Le Grellelaan
653,Gerard le Grellelaan 10,2022-12-24,16:00:00,37,32,5,FMN 05 Gerard Le Grellelaan
653,Gerard le Grellelaan 10,2022-12-24,17:00:00,21,17,4,FMN 05 Gerard Le Grellelaan
653,Gerard le Grellelaan 10,2022-12-24,18:00:00,12,7,5,FMN 05 Gerard Le Grellelaan
653,Gerard le Grellelaan 10,2022-12-24,19:00:00,12,11,1,FMN 05 Gerard Le Grellelaan
653,Gerard le Grellelaan 10,2022-12-24,20:00:00,10,9,1,FMN 05 Gerard Le Grellelaan
653,Gerard le Grellelaan 10,2022-12-24,21:00:00,4,1,3,FMN 05 Gerard Le Grellelaan
653,Gerard le Grellelaan 10,2022-12-24,22:00:00,17,16,1,FMN 05 Gerard Le Grellelaan
653,Gerard le Grellelaan 10,2022-12-24,23:00:00,9,7,2,FMN 05 Gerard Le Grellelaan
653,Gerard le Grellelaan 10,2022-12-25,00:00:00,7,6,1,FMN 05 Gerard Le Grellelaan
653,Gerard le Grellelaan 10,2022-12-25,01:00:00,8,5,3,FMN 05 Gerard Le Grellelaan
653,Gerard le Grellelaan 10,2022-12-25,02:00:00,9,8,1,FMN 05 Gerard Le Grellelaan
653,Gerard le Grellelaan 10,2022-12-25,03:00:00,1,1,0,FMN 05 Gerard Le Grellelaan
653,Gerard le Grellelaan 10,2022-12-25,04:00:00,3,2,1,FMN 05 Gerard Le Grellelaan
653,Gerard le Grellelaan 10,2022-12-25,05:00:00,1,0,1,FMN 05 Gerard Le Grellelaan
653,Gerard le Grellelaan 10,2022-12-25,06:00:00,5,1,4,FMN 05 Gerard Le Grellelaan
653,Gerard le Grellelaan 10,2022-12-25,07:00:00,3,2,1,FMN 05 Gerard Le Grellelaan
653,Gerard le Grellelaan 10,2022-12-25,08:00:00,3,2,1,FMN 05 Gerard Le Grellelaan
653,Gerard le Grellelaan 10,2022-12-25,09:00:00,11,11,0,FMN 05 Gerard Le Grellelaan
653,Gerard le Grellelaan 10,2022-12-25,10:00:00,6,5,1,FMN 05 Gerard Le Grellelaan
653,Gerard le Grellelaan 10,2022-12-25,11:00:00,8,6,2,FMN 05 Gerard Le Grellelaan
653,Gerard le Grellelaan 10,2022-12-25,12:00:00,8,7,1,FMN 05 Gerard Le Grellelaan
653,Gerard le Grellelaan 10,2022-12-25,13:00:00,16,11,5,FMN 05 Gerard Le Grellelaan
653,Gerard le Grellelaan 10,2022-12-25,14:00:00,16,15,1,FMN 05 Gerard Le Grellelaan
653,Gerard le Grellelaan 10,2022-12-25,15:00:00,14,11,3,FMN 05 Gerard Le Grellelaan
653,Gerard le Grellelaan 10,2022-12-25,16:00:00,12,9,3,FMN 05 Gerard Le Grellelaan
653,Gerard le Grellelaan 10,2022-12-25,17:00:00,9,7,2,FMN 05 Gerard Le Grellelaan
653,Gerard le Grellelaan 10,2022-12-25,18:00:00,11,7,4,FMN 05 Gerard Le Grellelaan
653,Gerard le Grellelaan 10,2022-12-25,19:00:00,10,8,2,FMN 05 Gerard Le Grellelaan
653,Gerard le Grellelaan 10,2022-12-25,20:00:00,8,5,3,FMN 05 Gerard Le Grellelaan
653,Gerard le Grellelaan 10,2022-12-25,21:00:00,13,10,3,FMN 05 Gerard Le Grellelaan
653,Gerard le Grellelaan 10,2022-12-25,22:00:00,6,3,3,FMN 05 Gerard Le Grellelaan
653,Gerard le Grellelaan 10,2022-12-25,23:00:00,14,12,2,FMN 05 Gerard Le Grellelaan
653,Gerard le Grellelaan 10,2022-12-26,00:00:00,7,3,4,FMN 05 Gerard Le Grellelaan
653,Gerard le Grellelaan 10,2022-12-26,01:00:00,2,1,1,FMN 05 Gerard Le Grellelaan
653,Gerard le Grellelaan 10,2022-12-26,02:00:00,3,3,0,FMN 05 Gerard Le Grellelaan
653,Gerard le Grellelaan 10,2022-12-26,03:00:00,0,0,0,FMN 05 Gerard Le Grellelaan
653,Gerard le Grellelaan 10,2022-12-26,04:00:00,4,4,0,FMN 05 Gerard Le Grellelaan
653,Gerard le Grellelaan 10,2022-12-26,05:00:00,6,3,3,FMN 05 Gerard Le Grellelaan
653,Gerard le Grellelaan 10,2022-12-26,06:00:00,10,5,5,FMN 05 Gerard Le Grellelaan
653,Gerard le Grellelaan 10,2022-12-26,07:00:00,25,19,6,FMN 05 Gerard Le Grellelaan
653,Gerard le Grellelaan 10,2022-12-26,08:00:00,27,21,6,FMN 05 Gerard Le Grellelaan
653,Gerard le Grellelaan 10,2022-12-26,09:00:00,37,30,7,FMN 05 Gerard Le Grellelaan
653,Gerard le Grellelaan 10,2022-12-26,10:00:00,30,25,5,FMN 05 Gerard Le Grellelaan
653,Gerard le Grellelaan 10,2022-12-26,11:00:00,28,23,5,FMN 05 Gerard Le Grellelaan
653,Gerard le Grellelaan 10,2022-12-26,12:00:00,37,32,5,FMN 05 Gerard Le Grellelaan
653,Gerard le Grellelaan 10,2022-12-26,13:00:00,39,33,6,FMN 05 Gerard Le Grellelaan
653,Gerard le Grellelaan 10,2022-12-26,14:00:00,32,30,2,FMN 05 Gerard Le Grellelaan
653,Gerard le Grellelaan 10,2022-12-26,15:00:00,60,44,16,FMN 05 Gerard Le Grellelaan
653,Gerard le Grellelaan 10,2022-12-26,16:00:00,50,43,7,FMN 05 Gerard Le Grellelaan
653,Gerard le Grellelaan 10,2022-12-26,17:00:00,38,33,5,FMN 05 Gerard Le Grellelaan
653,Gerard le Grellelaan 10,2022-12-26,18:00:00,21,18,3,FMN 05 Gerard Le Grellelaan
653,Gerard le Grellelaan 10,2022-12-26,19:00:00,20,17,3,FMN 05 Gerard Le Grellelaan
653,Gerard le Grellelaan 10,2022-12-26,20:00:00,16,12,4,FMN 05 Gerard Le Grellelaan
653,Gerard le Grellelaan 10,2022-12-26,21:00:00,13,8,5,FMN 05 Gerard Le Grellelaan
653,Gerard le Grellelaan 10,2022-12-26,22:00:00,19,12,7,FMN 05 Gerard Le Grellelaan
653,Gerard le Grellelaan 10,2022-12-26,23:00:00,9,6,3,FMN 05 Gerard Le Grellelaan
653,Gerard le Grellelaan 10,2022-12-27,00:00:00,1,0,1,FMN 05 Gerard Le Grellelaan
653,Gerard le Grellelaan 10,2022-12-27,01:00:00,2,2,0,FMN 05 Gerard Le Grellelaan
653,Gerard le Grellelaan 10,2022-12-27,02:00:00,0,0,0,FMN 05 Gerard Le Grellelaan
653,Gerard le Grellelaan 10,2022-12-27,03:00:00,2,1,1,FMN 05 Gerard Le Grellelaan
653,Gerard le Grellelaan 10,2022-12-27,04:00:00,3,3,0,FMN 05 Gerard Le Grellelaan
653,Gerard le Grellelaan 10,2022-12-27,05:00:00,8,3,5,FMN 05 Gerard Le Grellelaan
653,Gerard le Grellelaan 10,2022-12-27,06:00:00,13,8,5,FMN 05 Gerard Le Grellelaan
653,Gerard le Grellelaan 10,2022-12-27,07:00:00,29,15,14,FMN 05 Gerard Le Grellelaan
653,Gerard le Grellelaan 10,2022-12-27,08:00:00,43,32,11,FMN 05 Gerard Le Grellelaan
653,Gerard le Grellelaan 10,2022-12-27,09:00:00,33,25,8,FMN 05 Gerard Le Grellelaan
653,Gerard le Grellelaan 10,2022-12-27,10:00:00,35,33,2,FMN 05 Gerard Le Grellelaan
653,Gerard le Grellelaan 10,2022-12-27,11:00:00,42,38,4,FMN 05 Gerard Le Grellelaan
653,Gerard le Grellelaan 10,2022-12-27,12:00:00,48,40,8,FMN 05 Gerard Le Grellelaan
653,Gerard le Grellelaan 10,2022-12-27,13:00:00,42,36,6,FMN 05 Gerard Le Grellelaan
653,Gerard le Grellelaan 10,2022-12-27,14:00:00,49,42,7,FMN 05 Gerard Le Grellelaan
653,Gerard le Grellelaan 10,2022-12-27,15:00:00,55,47,8,FMN 05 Gerard Le Grellelaan
653,Gerard le Grellelaan 10,2022-12-27,16:00:00,79,64,15,FMN 05 Gerard Le Grellelaan
653,Gerard le Grellelaan 10,2022-12-27,17:00:00,85,75,10,FMN 05 Gerard Le Grellelaan
653,Gerard le Grellelaan 10,2022-12-27,18:00:00,40,37,3,FMN 05 Gerard Le Grellelaan
653,Gerard le Grellelaan 10,2022-12-27,19:00:00,22,18,4,FMN 05 Gerard Le Grellelaan
653,Gerard le Grellelaan 10,2022-12-27,20:00:00,16,12,4,FMN 05 Gerard Le Grellelaan
653,Gerard le Grellelaan 10,2022-12-27,21:00:00,10,6,4,FMN 05 Gerard Le Grellelaan
653,Gerard le Grellelaan 10,2022-12-27,22:00:00,17,12,5,FMN 05 Gerard Le Grellelaan
653,Gerard le Grellelaan 10,2022-12-27,23:00:00,8,5,3,FMN 05 Gerard Le Grellelaan
653,Gerard le Grellelaan 10,2022-12-28,00:00:00,8,5,3,FMN 05 Gerard Le Grellelaan
653,Gerard le Grellelaan 10,2022-12-28,01:00:00,2,2,0,FMN 05 Gerard Le Grellelaan
653,Gerard le Grellelaan 10,2022-12-28,02:00:00,4,3,1,FMN 05 Gerard Le Grellelaan
653,Gerard le Grellelaan 10,2022-12-28,03:00:00,1,1,0,FMN 05 Gerard Le Grellelaan
653,Gerard le Grellelaan 10,2022-12-28,04:00:00,3,3,0,FMN 05 Gerard Le Grellelaan
653,Gerard le Grellelaan 10,2022-12-28,05:00:00,9,3,6,FMN 05 Gerard Le Grellelaan
653,Gerard le Grellelaan 10,2022-12-28,06:00:00,17,12,5,FMN 05 Gerard Le Grellelaan
653,Gerard le Grellelaan 10,2022-12-28,07:00:00,28,19,9,FMN 05 Gerard Le Grellelaan
653,Gerard le Grellelaan 10,2022-12-28,08:00:00,57,44,13,FMN 05 Gerard Le Grellelaan
653,Gerard le Grellelaan 10,2022-12-28,09:00:00,31,25,6,FMN 05 Gerard Le Grellelaan
653,Gerard le Grellelaan 10,2022-12-28,10:00:00,32,23,9,FMN 05 Gerard Le Grellelaan
653,Gerard le Grellelaan 10,2022-12-28,11:00:00,22,21,1,FMN 05 Gerard Le Grellelaan
653,Gerard le Grellelaan 10,2022-12-28,12:00:00,28,23,5,FMN 05 Gerard Le Grellelaan
653,Gerard le Grellelaan 10,2022-12-28,13:00:00,29,22,7,FMN 05 Gerard Le Grellelaan
653,Gerard le Grellelaan 10,2022-12-28,14:00:00,45,39,6,FMN 05 Gerard Le Grellelaan
653,Gerard le Grellelaan 10,2022-12-28,15:00:00,40,33,7,FMN 05 Gerard Le Grellelaan
653,Gerard le Grellelaan 10,2022-12-28,16:00:00,54,48,6,FMN 05 Gerard Le Grellelaan
653,Gerard le Grellelaan 10,2022-12-28,17:00:00,47,43,4,FMN 05 Gerard Le Grellelaan
653,Gerard le Grellelaan 10,2022-12-28,18:00:00,48,45,3,FMN 05 Gerard Le Grellelaan
653,Gerard le Grellelaan 10,2022-12-28,19:00:00,27,18,9,FMN 05 Gerard Le Grellelaan
653,Gerard le Grellelaan 10,2022-12-28,20:00:00,26,19,7,FMN 05 Gerard Le Grellelaan
653,Gerard le Grellelaan 10,2022-12-28,21:00:00,20,16,4,FMN 05 Gerard Le Grellelaan
653,Gerard le Grellelaan 10,2022-12-28,22:00:00,18,14,4,FMN 05 Gerard Le Grellelaan
653,Gerard le Grellelaan 10,2022-12-28,23:00:00,8,6,2,FMN 05 Gerard Le Grellelaan
653,Gerard le Grellelaan 10,2022-12-29,00:00:00,4,1,3,FMN 05 Gerard Le Grellelaan
653,Gerard le Grellelaan 10,2022-12-29,01:00:00,3,2,1,FMN 05 Gerard Le Grellelaan
653,Gerard le Grellelaan 10,2022-12-29,02:00:00,2,1,1,FMN 05 Gerard Le Grellelaan
653,Gerard le Grellelaan 10,2022-12-29,03:00:00,2,1,1,FMN 05 Gerard Le Grellelaan
653,Gerard le Grellelaan 10,2022-12-29,04:00:00,2,2,0,FMN 05 Gerard Le Grellelaan
653,Gerard le Grellelaan 10,2022-12-29,05:00:00,11,4,7,FMN 05 Gerard Le Grellelaan
653,Gerard le Grellelaan 10,2022-12-29,06:00:00,10,5,5,FMN 05 Gerard Le Grellelaan
653,Gerard le Grellelaan 10,2022-12-29,07:00:00,30,22,8,FMN 05 Gerard Le Grellelaan
653,Gerard le Grellelaan 10,2022-12-29,08:00:00,50,36,14,FMN 05 Gerard Le Grellelaan
653,Gerard le Grellelaan 10,2022-12-29,09:00:00,44,37,7,FMN 05 Gerard Le Grellelaan
653,Gerard le Grellelaan 10,2022-12-29,10:00:00,25,22,3,FMN 05 Gerard Le Grellelaan
653,Gerard le Grellelaan 10,2022-12-29,11:00:00,32,26,6,FMN 05 Gerard Le Grellelaan
653,Gerard le Grellelaan 10,2022-12-29,12:00:00,40,27,13,FMN 05 Gerard Le Grellelaan
653,Gerard le Grellelaan 10,2022-12-29,13:00:00,31,21,10,FMN 05 Gerard Le Grellelaan
653,Gerard le Grellelaan 10,2022-12-29,14:00:00,31,27,4,FMN 05 Gerard Le Grellelaan
653,Gerard le Grellelaan 10,2022-12-29,15:00:00,49,42,7,FMN 05 Gerard Le Grellelaan
653,Gerard le Grellelaan 10,2022-12-29,16:00:00,42,38,4,FMN 05 Gerard Le Grellelaan
653,Gerard le Grellelaan 10,2022-12-29,17:00:00,64,52,12,FMN 05 Gerard Le Grellelaan
653,Gerard le Grellelaan 10,2022-12-29,18:00:00,53,43,10,FMN 05 Gerard Le Grellelaan
653,Gerard le Grellelaan 10,2022-12-29,19:00:00,27,22,5,FMN 05 Gerard Le Grellelaan
653,Gerard le Grellelaan 10,2022-12-29,20:00:00,33,27,6,FMN 05 Gerard Le Grellelaan
653,Gerard le Grellelaan 10,2022-12-29,21:00:00,15,12,3,FMN 05 Gerard Le Grellelaan
653,Gerard le Grellelaan 10,2022-12-29,22:00:00,27,27,0,FMN 05 Gerard Le Grellelaan
653,Gerard le Grellelaan 10,2022-12-29,23:00:00,7,5,2,FMN 05 Gerard Le Grellelaan
653,Gerard le Grellelaan 10,2022-12-30,00:00:00,1,1,0,FMN 05 Gerard Le Grellelaan
653,Gerard le Grellelaan 10,2022-12-30,01:00:00,6,6,0,FMN 05 Gerard Le Grellelaan
653,Gerard le Grellelaan 10,2022-12-30,02:00:00,4,4,0,FMN 05 Gerard Le Grellelaan
653,Gerard le Grellelaan 10,2022-12-30,03:00:00,2,1,1,FMN 05 Gerard Le Grellelaan
653,Gerard le Grellelaan 10,2022-12-30,04:00:00,2,2,0,FMN 05 Gerard Le Grellelaan
653,Gerard le Grellelaan 10,2022-12-30,05:00:00,6,3,3,FMN 05 Gerard Le Grellelaan
653,Gerard le Grellelaan 10,2022-12-30,06:00:00,10,3,7,FMN 05 Gerard Le Grellelaan
653,Gerard le Grellelaan 10,2022-12-30,07:00:00,23,18,5,FMN 05 Gerard Le Grellelaan
653,Gerard le Grellelaan 10,2022-12-30,08:00:00,39,31,8,FMN 05 Gerard Le Grellelaan
653,Gerard le Grellelaan 10,2022-12-30,09:00:00,32,28,4,FMN 05 Gerard Le Grellelaan
653,Gerard le Grellelaan 10,2022-12-30,10:00:00,27,23,4,FMN 05 Gerard Le Grellelaan
653,Gerard le Grellelaan 10,2022-12-30,11:00:00,35,30,5,FMN 05 Gerard Le Grellelaan
653,Gerard le Grellelaan 10,2022-12-30,12:00:00,29,21,8,FMN 05 Gerard Le Grellelaan
653,Gerard le Grellelaan 10,2022-12-30,13:00:00,23,16,7,FMN 05 Gerard Le Grellelaan
653,Gerard le Grellelaan 10,2022-12-30,14:00:00,27,22,5,FMN 05 Gerard Le Grellelaan
653,Gerard le Grellelaan 10,2022-12-30,15:00:00,27,21,6,FMN 05 Gerard Le Grellelaan
653,Gerard le Grellelaan 10,2022-12-30,16:00:00,46,38,8,FMN 05 Gerard Le Grellelaan
653,Gerard le Grellelaan 10,2022-12-30,17:00:00,35,30,5,FMN 05 Gerard Le Grellelaan
653,Gerard le Grellelaan 10,2022-12-30,18:00:00,32,29,3,FMN 05 Gerard Le Grellelaan
653,Gerard le Grellelaan 10,2022-12-30,19:00:00,22,18,4,FMN 05 Gerard Le Grellelaan
653,Gerard le Grellelaan 10,2022-12-30,20:00:00,22,19,3,FMN 05 Gerard Le Grellelaan
653,Gerard le Grellelaan 10,2022-12-30,21:00:00,8,7,1,FMN 05 Gerard Le Grellelaan
653,Gerard le Grellelaan 10,2022-12-30,22:00:00,14,13,1,FMN 05 Gerard Le Grellelaan
653,Gerard le Grellelaan 10,2022-12-30,23:00:00,11,8,3,FMN 05 Gerard Le Grellelaan
653,Gerard le Grellelaan 10,2022-12-31,00:00:00,4,3,1,FMN 05 Gerard Le Grellelaan
653,Gerard le Grellelaan 10,2022-12-31,01:00:00,4,2,2,FMN 05 Gerard Le Grellelaan
653,Gerard le Grellelaan 10,2022-12-31,02:00:00,3,2,1,FMN 05 Gerard Le Grellelaan
653,Gerard le Grellelaan 10,2022-12-31,03:00:00,3,3,0,FMN 05 Gerard Le Grellelaan
653,Gerard le Grellelaan 10,2022-12-31,04:00:00,2,2,0,FMN 05 Gerard Le Grellelaan
653,Gerard le Grellelaan 10,2022-12-31,05:00:00,3,1,2,FMN 05 Gerard Le Grellelaan
653,Gerard le Grellelaan 10,2022-12-31,06:00:00,2,2,0,FMN 05 Gerard Le Grellelaan
653,Gerard le Grellelaan 10,2022-12-31,07:00:00,7,6,1,FMN 05 Gerard Le Grellelaan
653,Gerard le Grellelaan 10,2022-12-31,08:00:00,12,9,3,FMN 05 Gerard Le Grellelaan
653,Gerard le Grellelaan 10,2022-12-31,09:00:00,22,19,3,FMN 05 Gerard Le Grellelaan
653,Gerard le Grellelaan 10,2022-12-31,10:00:00,29,22,7,FMN 05 Gerard Le Grellelaan
653,Gerard le Grellelaan 10,2022-12-31,11:00:00,36,31,5,FMN 05 Gerard Le Grellelaan
653,Gerard le Grellelaan 10,2022-12-31,12:00:00,22,14,8,FMN 05 Gerard Le Grellelaan
653,Gerard le Grellelaan 10,2022-12-31,13:00:00,24,17,7,FMN 05 Gerard Le Grellelaan
653,Gerard le Grellelaan 10,2022-12-31,14:00:00,35,28,7,FMN 05 Gerard Le Grellelaan
653,Gerard le Grellelaan 10,2022-12-31,15:00:00,31,25,6,FMN 05 Gerard Le Grellelaan
653,Gerard le Grellelaan 10,2022-12-31,16:00:00,35,31,4,FMN 05 Gerard Le Grellelaan
653,Gerard le Grellelaan 10,2022-12-31,17:00:00,40,34,6,FMN 05 Gerard Le Grellelaan
653,Gerard le Grellelaan 10,2022-12-31,18:00:00,52,44,8,FMN 05 Gerard Le Grellelaan
653,Gerard le Grellelaan 10,2022-12-31,19:00:00,27,24,3,FMN 05 Gerard Le Grellelaan
653,Gerard le Grellelaan 10,2022-12-31,20:00:00,6,6,0,FMN 05 Gerard Le Grellelaan
653,Gerard le Grellelaan 10,2022-12-31,21:00:00,12,11,1,FMN 05 Gerard Le Grellelaan
653,Gerard le Grellelaan 10,2022-12-31,22:00:00,5,5,0,FMN 05 Gerard Le Grellelaan
653,Gerard le Grellelaan 10,2022-12-31,23:00:00,14,14,0,FMN 05 Gerard Le Grellelaan
653,Gerard le Grellelaan 10,2023-01-01,00:00:00,14,9,5,FMN 05 Gerard Le Grellelaan
653,Gerard le Grellelaan 10,2023-01-01,01:00:00,35,15,20,FMN 05 Gerard Le Grellelaan
653,Gerard le Grellelaan 10,2023-01-01,02:00:00,11,10,1,FMN 05 Gerard Le Grellelaan
653,Gerard le Grellelaan 10,2023-01-01,03:00:00,29,19,10,FMN 05 Gerard Le Grellelaan
653,Gerard le Grellelaan 10,2023-01-01,04:00:00,7,5,2,FMN 05 Gerard Le Grellelaan
653,Gerard le Grellelaan 10,2023-01-01,05:00:00,14,6,8,FMN 05 Gerard Le Grellelaan
653,Gerard le Grellelaan 10,2023-01-01,06:00:00,12,9,3,FMN 05 Gerard Le Grellelaan
653,Gerard le Grellelaan 10,2023-01-01,07:00:00,4,3,1,FMN 05 Gerard Le Grellelaan
653,Gerard le Grellelaan 10,2023-01-01,08:00:00,11,7,4,FMN 05 Gerard Le Grellelaan
653,Gerard le Grellelaan 10,2023-01-01,09:00:00,4,3,1,FMN 05 Gerard Le Grellelaan
653,Gerard le Grellelaan 10,2023-01-01,10:00:00,12,7,5,FMN 05 Gerard Le Grellelaan
653,Gerard le Grellelaan 10,2023-01-01,11:00:00,16,10,6,FMN 05 Gerard Le Grellelaan
653,Gerard le Grellelaan 10,2023-01-01,12:00:00,21,19,2,FMN 05 Gerard Le Grellelaan
653,Gerard le Grellelaan 10,2023-01-01,13:00:00,30,23,7,FMN 05 Gerard Le Grellelaan
653,Gerard le Grellelaan 10,2023-01-01,14:00:00,35,28,7,FMN 05 Gerard Le Grellelaan
653,Gerard le Grellelaan 10,2023-01-01,15:00:00,36,30,6,FMN 05 Gerard Le Grellelaan
653,Gerard le Grellelaan 10,2023-01-01,16:00:00,47,38,9,FMN 05 Gerard Le Grellelaan
653,Gerard le Grellelaan 10,2023-01-01,17:00:00,19,17,2,FMN 05 Gerard Le Grellelaan
653,Gerard le Grellelaan 10,2023-01-01,18:00:00,19,18,1,FMN 05 Gerard Le Grellelaan
653,Gerard le Grellelaan 10,2023-01-01,19:00:00,16,14,2,FMN 05 Gerard Le Grellelaan
653,Gerard le Grellelaan 10,2023-01-01,20:00:00,9,8,1,FMN 05 Gerard Le Grellelaan
653,Gerard le Grellelaan 10,2023-01-01,21:00:00,13,10,3,FMN 05 Gerard Le Grellelaan
653,Gerard le Grellelaan 10,2023-01-01,22:00:00,8,7,1,FMN 05 Gerard Le Grellelaan
653,Gerard le Grellelaan 10,2023-01-01,23:00:00,7,5,2,FMN 05 Gerard Le Grellelaan
653,Gerard le Grellelaan 10,2023-01-02,00:00:00,2,1,1,FMN 05 Gerard Le Grellelaan
653,Gerard le Grellelaan 10,2023-01-02,01:00:00,1,1,0,FMN 05 Gerard Le Grellelaan
653,Gerard le Grellelaan 10,2023-01-02,02:00:00,2,1,1,FMN 05 Gerard Le Grellelaan
653,Gerard le Grellelaan 10,2023-01-02,03:00:00,2,2,0,FMN 05 Gerard Le Grellelaan
653,Gerard le Grellelaan 10,2023-01-02,04:00:00,1,0,1,FMN 05 Gerard Le Grellelaan
653,Gerard le Grellelaan 10,2023-01-02,05:00:00,14,4,10,FMN 05 Gerard Le Grellelaan
653,Gerard le Grellelaan 10,2023-01-02,06:00:00,19,9,10,FMN 05 Gerard Le Grellelaan
653,Gerard le Grellelaan 10,2023-01-02,07:00:00,30,24,6,FMN 05 Gerard Le Grellelaan
653,Gerard le Grellelaan 10,2023-01-02,08:00:00,68,50,18,FMN 05 Gerard Le Grellelaan
653,Gerard le Grellelaan 10,2023-01-02,09:00:00,30,20,10,FMN 05 Gerard Le Grellelaan
653,Gerard le Grellelaan 10,2023-01-02,10:00:00,27,24,3,FMN 05 Gerard Le Grellelaan
653,Gerard le Grellelaan 10,2023-01-02,11:00:00,27,21,6,FMN 05 Gerard Le Grellelaan
653,Gerard le Grellelaan 10,2023-01-02,12:00:00,33,26,7,FMN 05 Gerard Le Grellelaan
653,Gerard le Grellelaan 10,2023-01-02,13:00:00,33,24,9,FMN 05 Gerard Le Grellelaan
653,Gerard le Grellelaan 10,2023-01-02,14:00:00,34,32,2,FMN 05 Gerard Le Grellelaan
653,Gerard le Grellelaan 10,2023-01-02,15:00:00,35,27,8,FMN 05 Gerard Le Grellelaan
653,Gerard le Grellelaan 10,2023-01-02,16:00:00,60,50,10,FMN 05 Gerard Le Grellelaan
653,Gerard le Grellelaan 10,2023-01-02,17:00:00,52,46,6,FMN 05 Gerard Le Grellelaan
653,Gerard le Grellelaan 10,2023-01-02,18:00:00,42,35,7,FMN 05 Gerard Le Grellelaan
653,Gerard le Grellelaan 10,2023-01-02,19:00:00,28,22,6,FMN 05 Gerard Le Grellelaan
653,Gerard le Grellelaan 10,2023-01-02,20:00:00,25,19,6,FMN 05 Gerard Le Grellelaan
653,Gerard le Grellelaan 10,2023-01-02,21:00:00,25,16,9,FMN 05 Gerard Le Grellelaan
653,Gerard le Grellelaan 10,2023-01-02,22:00:00,7,6,1,FMN 05 Gerard Le Grellelaan
653,Gerard le Grellelaan 10,2023-01-02,23:00:00,6,3,3,FMN 05 Gerard Le Grellelaan
653,Gerard le Grellelaan 10,2023-01-03,00:00:00,0,0,0,FMN 05 Gerard Le Grellelaan
653,Gerard le Grellelaan 10,2023-01-03,01:00:00,2,1,1,FMN 05 Gerard Le Grellelaan
653,Gerard le Grellelaan 10,2023-01-03,02:00:00,1,1,0,FMN 05 Gerard Le Grellelaan
653,Gerard le Grellelaan 10,2023-01-03,03:00:00,2,1,1,FMN 05 Gerard Le Grellelaan
653,Gerard le Grellelaan 10,2023-01-03,04:00:00,3,3,0,FMN 05 Gerard Le Grellelaan
653,Gerard le Grellelaan 10,2023-01-03,05:00:00,17,7,10,FMN 05 Gerard Le Grellelaan
653,Gerard le Grellelaan 10,2023-01-03,06:00:00,26,16,10,FMN 05 Gerard Le Grellelaan
653,Gerard le Grellelaan 10,2023-01-03,07:00:00,63,49,14,FMN 05 Gerard Le Grellelaan
653,Gerard le Grellelaan 10,2023-01-03,08:00:00,81,67,14,FMN 05 Gerard Le Grellelaan
653,Gerard le Grellelaan 10,2023-01-03,09:00:00,51,41,10,FMN 05 Gerard Le Grellelaan
653,Gerard le Grellelaan 10,2023-01-03,10:00:00,35,27,8,FMN 05 Gerard Le Grellelaan
653,Gerard le Grellelaan 10,2023-01-03,11:00:00,41,32,9,FMN 05 Gerard Le Grellelaan
653,Gerard le Grellelaan 10,2023-01-03,12:00:00,42,34,8,FMN 05 Gerard Le Grellelaan
653,Gerard le Grellelaan 10,2023-01-03,13:00:00,46,33,13,FMN 05 Gerard Le Grellelaan
653,Gerard le Grellelaan 10,2023-01-03,14:00:00,59,51,8,FMN 05 Gerard Le Grellelaan
653,Gerard le Grellelaan 10,2023-01-03,15:00:00,56,49,7,FMN 05 Gerard Le Grellelaan
653,Gerard le Grellelaan 10,2023-01-03,16:00:00,84,72,12,FMN 05 Gerard Le Grellelaan
653,Gerard le Grellelaan 10,2023-01-03,17:00:00,98,72,26,FMN 05 Gerard Le Grellelaan
653,Gerard le Grellelaan 10,2023-01-03,18:00:00,65,50,15,FMN 05 Gerard Le Grellelaan
653,Gerard le Grellelaan 10,2023-01-03,19:00:00,30,27,3,FMN 05 Gerard Le Grellelaan
653,Gerard le Grellelaan 10,2023-01-03,20:00:00,16,15,1,FMN 05 Gerard Le Grellelaan
653,Gerard le Grellelaan 10,2023-01-03,21:00:00,23,15,8,FMN 05 Gerard Le Grellelaan
653,Gerard le Grellelaan 10,2023-01-03,22:00:00,18,16,2,FMN 05 Gerard Le Grellelaan
653,Gerard le Grellelaan 10,2023-01-03,23:00:00,6,3,3,FMN 05 Gerard Le Grellelaan
653,Gerard le Grellelaan 10,2023-01-04,00:00:00,3,3,0,FMN 05 Gerard Le Grellelaan
653,Gerard le Grellelaan 10,2023-01-04,01:00:00,1,0,1,FMN 05 Gerard Le Grellelaan
653,Gerard le Grellelaan 10,2023-01-04,02:00:00,4,2,2,FMN 05 Gerard Le Grellelaan
653,Gerard le Grellelaan 10,2023-01-04,03:00:00,2,2,0,FMN 05 Gerard Le Grellelaan
653,Gerard le Grellelaan 10,2023-01-04,04:00:00,8,5,3,FMN 05 Gerard Le Grellelaan
653,Gerard le Grellelaan 10,2023-01-04,05:00:00,20,10,10,FMN 05 Gerard Le Grellelaan
653,Gerard le Grellelaan 10,2023-01-04,06:00:00,24,12,12,FMN 05 Gerard Le Grellelaan
653,Gerard le Grellelaan 10,2023-01-04,07:00:00,61,45,16,FMN 05 Gerard Le Grellelaan
653,Gerard le Grellelaan 10,2023-01-04,08:00:00,82,68,14,FMN 05 Gerard Le Grellelaan
653,Gerard le Grellelaan 10,2023-01-04,09:00:00,44,32,12,FMN 05 Gerard Le Grellelaan
653,Gerard le Grellelaan 10,2023-01-04,10:00:00,46,39,7,FMN 05 Gerard Le Grellelaan
653,Gerard le Grellelaan 10,2023-01-04,11:00:00,33,29,4,FMN 05 Gerard Le Grellelaan
653,Gerard le Grellelaan 10,2023-01-04,12:00:00,28,19,9,FMN 05 Gerard Le Grellelaan
653,Gerard le Grellelaan 10,2023-01-04,13:00:00,42,31,11,FMN 05 Gerard Le Grellelaan
653,Gerard le Grellelaan 10,2023-01-04,14:00:00,33,25,8,FMN 05 Gerard Le Grellelaan
653,Gerard le Grellelaan 10,2023-01-04,15:00:00,56,45,11,FMN 05 Gerard Le Grellelaan
653,Gerard le Grellelaan 10,2023-01-04,16:00:00,79,63,16,FMN 05 Gerard Le Grellelaan
653,Gerard le Grellelaan 10,2023-01-04,17:00:00,78,63,15,FMN 05 Gerard Le Grellelaan
653,Gerard le Grellelaan 10,2023-01-04,18:00:00,65,54,11,FMN 05 Gerard Le Grellelaan
653,Gerard le Grellelaan 10,2023-01-04,19:00:00,37,26,11,FMN 05 Gerard Le Grellelaan
653,Gerard le Grellelaan 10,2023-01-04,20:00:00,34,29,5,FMN 05 Gerard Le Grellelaan
653,Gerard le Grellelaan 10,2023-01-04,21:00:00,16,13,3,FMN 05 Gerard Le Grellelaan
653,Gerard le Grellelaan 10,2023-01-04,22:00:00,28,22,6,FMN 05 Gerard Le Grellelaan
653,Gerard le Grellelaan 10,2023-01-04,23:00:00,14,8,6,FMN 05 Gerard Le Grellelaan
653,Gerard le Grellelaan 10,2023-01-05,00:00:00,4,3,1,FMN 05 Gerard Le Grellelaan
653,Gerard le Grellelaan 10,2023-01-05,01:00:00,4,3,1,FMN 05 Gerard Le Grellelaan
653,Gerard le Grellelaan 10,2023-01-05,02:00:00,0,0,0,FMN 05 Gerard Le Grellelaan
653,Gerard le Grellelaan 10,2023-01-05,03:00:00,1,1,0,FMN 05 Gerard Le Grellelaan
653,Gerard le Grellelaan 10,2023-01-05,04:00:00,6,4,2,FMN 05 Gerard Le Grellelaan
653,Gerard le Grellelaan 10,2023-01-05,05:00:00,18,7,11,FMN 05 Gerard Le Grellelaan
653,Gerard le Grellelaan 10,2023-01-05,06:00:00,37,17,20,FMN 05 Gerard Le Grellelaan
653,Gerard le Grellelaan 10,2023-01-05,07:00:00,68,49,19,FMN 05 Gerard Le Grellelaan
653,Gerard le Grellelaan 10,2023-01-05,08:00:00,102,82,20,FMN 05 Gerard Le Grellelaan
653,Gerard le Grellelaan 10,2023-01-05,09:00:00,79,61,18,FMN 05 Gerard Le Grellelaan
653,Gerard le Grellelaan 10,2023-01-05,10:00:00,44,38,6,FMN 05 Gerard Le Grellelaan
653,Gerard le Grellelaan 10,2023-01-05,11:00:00,38,32,6,FMN 05 Gerard Le Grellelaan
653,Gerard le Grellelaan 10,2023-01-05,12:00:00,61,45,16,FMN 05 Gerard Le Grellelaan
653,Gerard le Grellelaan 10,2023-01-05,13:00:00,49,36,13,FMN 05 Gerard Le Grellelaan
653,Gerard le Grellelaan 10,2023-01-05,14:00:00,52,42,10,FMN 05 Gerard Le Grellelaan
653,Gerard le Grellelaan 10,2023-01-05,15:00:00,86,77,9,FMN 05 Gerard Le Grellelaan
653,Gerard le Grellelaan 10,2023-01-05,16:00:00,89,74,15,FMN 05 Gerard Le Grellelaan
653,Gerard le Grellelaan 10,2023-01-05,17:00:00,128,104,24,FMN 05 Gerard Le Grellelaan
653,Gerard le Grellelaan 10,2023-01-05,18:00:00,67,54,13,FMN 05 Gerard Le Grellelaan
653,Gerard le Grellelaan 10,2023-01-05,19:00:00,39,36,3,FMN 05 Gerard Le Grellelaan
653,Gerard le Grellelaan 10,2023-01-05,20:00:00,27,20,7,FMN 05 Gerard Le Grellelaan
653,Gerard le Grellelaan 10,2023-01-05,21:00:00,18,13,5,FMN 05 Gerard Le Grellelaan
653,Gerard le Grellelaan 10,2023-01-05,22:00:00,24,18,6,FMN 05 Gerard Le Grellelaan
653,Gerard le Grellelaan 10,2023-01-05,23:00:00,13,10,3,FMN 05 Gerard Le Grellelaan
653,Gerard le Grellelaan 10,2023-01-06,00:00:00,2,2,0,FMN 05 Gerard Le Grellelaan
653,Gerard le Grellelaan 10,2023-01-06,01:00:00,4,3,1,FMN 05 Gerard Le Grellelaan
653,Gerard le Grellelaan 10,2023-01-06,02:00:00,1,1,0,FMN 05 Gerard Le Grellelaan
653,Gerard le Grellelaan 10,2023-01-06,03:00:00,4,3,1,FMN 05 Gerard Le Grellelaan
653,Gerard le Grellelaan 10,2023-01-06,04:00:00,9,5,4,FMN 05 Gerard Le Grellelaan
653,Gerard le Grellelaan 10,2023-01-06,05:00:00,18,8,10,FMN 05 Gerard Le Grellelaan
653,Gerard le Grellelaan 10,2023-01-06,06:00:00,30,13,17,FMN 05 Gerard Le Grellelaan
653,Gerard le Grellelaan 10,2023-01-06,07:00:00,62,45,17,FMN 05 Gerard Le Grellelaan
653,Gerard le Grellelaan 10,2023-01-06,08:00:00,72,59,13,FMN 05 Gerard Le Grellelaan
653,Gerard le Grellelaan 10,2023-01-06,09:00:00,53,46,7,FMN 05 Gerard Le Grellelaan
653,Gerard le Grellelaan 10,2023-01-06,10:00:00,51,43,8,FMN 05 Gerard Le Grellelaan
653,Gerard le Grellelaan 10,2023-01-06,11:00:00,43,37,6,FMN 05 Gerard Le Grellelaan
653,Gerard le Grellelaan 10,2023-01-06,12:00:00,57,39,18,FMN 05 Gerard Le Grellelaan
653,Gerard le Grellelaan 10,2023-01-06,13:00:00,47,31,16,FMN 05 Gerard Le Grellelaan
653,Gerard le Grellelaan 10,2023-01-06,14:00:00,76,66,10,FMN 05 Gerard Le Grellelaan
653,Gerard le Grellelaan 10,2023-01-06,15:00:00,63,57,6,FMN 05 Gerard Le Grellelaan
653,Gerard le Grellelaan 10,2023-01-06,16:00:00,103,89,14,FMN 05 Gerard Le Grellelaan
653,Gerard le Grellelaan 10,2023-01-06,17:00:00,106,82,24,FMN 05 Gerard Le Grellelaan
653,Gerard le Grellelaan 10,2023-01-06,18:00:00,68,61,7,FMN 05 Gerard Le Grellelaan
653,Gerard le Grellelaan 10,2023-01-06,19:00:00,36,28,8,FMN 05 Gerard Le Grellelaan
653,Gerard le Grellelaan 10,2023-01-06,20:00:00,24,22,2,FMN 05 Gerard Le Grellelaan
653,Gerard le Grellelaan 10,2023-01-06,21:00:00,27,21,6,FMN 05 Gerard Le Grellelaan
653,Gerard le Grellelaan 10,2023-01-06,22:00:00,25,20,5,FMN 05 Gerard Le Grellelaan
653,Gerard le Grellelaan 10,2023-01-06,23:00:00,10,9,1,FMN 05 Gerard Le Grellelaan
653,Gerard le Grellelaan 10,2023-01-07,00:00:00,6,3,3,FMN 05 Gerard Le Grellelaan
653,Gerard le Grellelaan 10,2023-01-07,01:00:00,5,2,3,FMN 05 Gerard Le Grellelaan
653,Gerard le Grellelaan 10,2023-01-07,02:00:00,1,1,0,FMN 05 Gerard Le Grellelaan
653,Gerard le Grellelaan 10,2023-01-07,03:00:00,4,3,1,FMN 05 Gerard Le Grellelaan
653,Gerard le Grellelaan 10,2023-01-07,04:00:00,4,2,2,FMN 05 Gerard Le Grellelaan
653,Gerard le Grellelaan 10,2023-01-07,05:00:00,5,3,2,FMN 05 Gerard Le Grellelaan
653,Gerard le Grellelaan 10,2023-01-07,06:00:00,5,2,3,FMN 05 Gerard Le Grellelaan
653,Gerard le Grellelaan 10,2023-01-07,07:00:00,6,4,2,FMN 05 Gerard Le Grellelaan
653,Gerard le Grellelaan 10,2023-01-07,08:00:00,19,16,3,FMN 05 Gerard Le Grellelaan
653,Gerard le Grellelaan 10,2023-01-07,09:00:00,27,20,7,FMN 05 Gerard Le Grellelaan
653,Gerard le Grellelaan 10,2023-01-07,10:00:00,35,31,4,FMN 05 Gerard Le Grellelaan
653,Gerard le Grellelaan 10,2023-01-07,11:00:00,55,47,8,FMN 05 Gerard Le Grellelaan
653,Gerard le Grellelaan 10,2023-01-07,12:00:00,57,50,7,FMN 05 Gerard Le Grellelaan
653,Gerard le Grellelaan 10,2023-01-07,13:00:00,62,57,5,FMN 05 Gerard Le Grellelaan
653,Gerard le Grellelaan 10,2023-01-07,14:00:00,50,40,10,FMN 05 Gerard Le Grellelaan
653,Gerard le Grellelaan 10,2023-01-07,15:00:00,58,52,6,FMN 05 Gerard Le Grellelaan
653,Gerard le Grellelaan 10,2023-01-07,16:00:00,44,37,7,FMN 05 Gerard Le Grellelaan
653,Gerard le Grellelaan 10,2023-01-07,17:00:00,45,37,8,FMN 05 Gerard Le Grellelaan
653,Gerard le Grellelaan 10,2023-01-07,18:00:00,37,28,9,FMN 05 Gerard Le Grellelaan
653,Gerard le Grellelaan 10,2023-01-07,19:00:00,22,19,3,FMN 05 Gerard Le Grellelaan
653,Gerard le Grellelaan 10,2023-01-07,20:00:00,24,16,8,FMN 05 Gerard Le Grellelaan
653,Gerard le Grellelaan 10,2023-01-07,21:00:00,20,16,4,FMN 05 Gerard Le Grellelaan
653,Gerard le Grellelaan 10,2023-01-07,22:00:00,12,11,1,FMN 05 Gerard Le Grellelaan
653,Gerard le Grellelaan 10,2023-01-07,23:00:00,15,13,2,FMN 05 Gerard Le Grellelaan
653,Gerard le Grellelaan 10,2023-01-08,00:00:00,8,5,3,FMN 05 Gerard Le Grellelaan
653,Gerard le Grellelaan 10,2023-01-08,01:00:00,3,1,2,FMN 05 Gerard Le Grellelaan
653,Gerard le Grellelaan 10,2023-01-08,02:00:00,7,2,5,FMN 05 Gerard Le Grellelaan
653,Gerard le Grellelaan 10,2023-01-08,03:00:00,0,0,0,FMN 05 Gerard Le Grellelaan
653,Gerard le Grellelaan 10,2023-01-08,04:00:00,2,1,1,FMN 05 Gerard Le Grellelaan
653,Gerard le Grellelaan 10,2023-01-08,05:00:00,3,0,3,FMN 05 Gerard Le Grellelaan
653,Gerard le Grellelaan 10,2023-01-08,06:00:00,7,5,2,FMN 05 Gerard Le Grellelaan
653,Gerard le Grellelaan 10,2023-01-08,07:00:00,7,6,1,FMN 05 Gerard Le Grellelaan
653,Gerard le Grellelaan 10,2023-01-08,08:00:00,7,7,0,FMN 05 Gerard Le Grellelaan
653,Gerard le Grellelaan 10,2023-01-08,09:00:00,31,22,9,FMN 05 Gerard Le Grellelaan
653,Gerard le Grellelaan 10,2023-01-08,10:00:00,32,28,4,FMN 05 Gerard Le Grellelaan
653,Gerard le Grellelaan 10,2023-01-08,11:00:00,72,57,15,FMN 05 Gerard Le Grellelaan
653,Gerard le Grellelaan 10,2023-01-08,12:00:00,51,46,5,FMN 05 Gerard Le Grellelaan
653,Gerard le Grellelaan 10,2023-01-08,13:00:00,90,79,11,FMN 05 Gerard Le Grellelaan
653,Gerard le Grellelaan 10,2023-01-08,14:00:00,61,46,15,FMN 05 Gerard Le Grellelaan
653,Gerard le Grellelaan 10,2023-01-08,15:00:00,69,58,11,FMN 05 Gerard Le Grellelaan
653,Gerard le Grellelaan 10,2023-01-08,16:00:00,51,44,7,FMN 05 Gerard Le Grellelaan
653,Gerard le Grellelaan 10,2023-01-08,17:00:00,33,28,5,FMN 05 Gerard Le Grellelaan
653,Gerard le Grellelaan 10,2023-01-08,18:00:00,19,16,3,FMN 05 Gerard Le Grellelaan
653,Gerard le Grellelaan 10,2023-01-08,19:00:00,14,13,1,FMN 05 Gerard Le Grellelaan
653,Gerard le Grellelaan 10,2023-01-08,20:00:00,16,15,1,FMN 05 Gerard Le Grellelaan
653,Gerard le Grellelaan 10,2023-01-08,21:00:00,17,13,4,FMN 05 Gerard Le Grellelaan
653,Gerard le Grellelaan 10,2023-01-08,22:00:00,5,4,1,FMN 05 Gerard Le Grellelaan
653,Gerard le Grellelaan 10,2023-01-08,23:00:00,6,3,3,FMN 05 Gerard Le Grellelaan
653,Gerard le Grellelaan 10,2023-01-09,00:00:00,1,1,0,FMN 05 Gerard Le Grellelaan
653,Gerard le Grellelaan 10,2023-01-09,01:00:00,3,2,1,FMN 05 Gerard Le Grellelaan
653,Gerard le Grellelaan 10,2023-01-09,02:00:00,0,0,0,FMN 05 Gerard Le Grellelaan
653,Gerard le Grellelaan 10,2023-01-09,03:00:00,1,1,0,FMN 05 Gerard Le Grellelaan
653,Gerard le Grellelaan 10,2023-01-09,04:00:00,6,2,4,FMN 05 Gerard Le Grellelaan
653,Gerard le Grellelaan 10,2023-01-09,05:00:00,14,5,9,FMN 05 Gerard Le Grellelaan
653,Gerard le Grellelaan 10,2023-01-09,06:00:00,51,22,29,FMN 05 Gerard Le Grellelaan
653,Gerard le Grellelaan 10,2023-01-09,07:00:00,113,90,23,FMN 05 Gerard Le Grellelaan
653,Gerard le Grellelaan 10,2023-01-09,08:00:00,243,197,46,FMN 05 Gerard Le Grellelaan
653,Gerard le Grellelaan 10,2023-01-09,09:00:00,59,47,12,FMN 05 Gerard Le Grellelaan
653,Gerard le Grellelaan 10,2023-01-09,10:00:00,40,38,2,FMN 05 Gerard Le Grellelaan
653,Gerard le Grellelaan 10,2023-01-09,11:00:00,42,34,8,FMN 05 Gerard Le Grellelaan
653,Gerard le Grellelaan 10,2023-01-09,12:00:00,55,44,11,FMN 05 Gerard Le Grellelaan
653,Gerard le Grellelaan 10,2023-01-09,13:00:00,48,40,8,FMN 05 Gerard Le Grellelaan
653,Gerard le Grellelaan 10,2023-01-09,14:00:00,70,57,13,FMN 05 Gerard Le Grellelaan
653,Gerard le Grellelaan 10,2023-01-09,15:00:00,105,81,24,FMN 05 Gerard Le Grellelaan
653,Gerard le Grellelaan 10,2023-01-09,16:00:00,127,102,25,FMN 05 Gerard Le Grellelaan
653,Gerard le Grellelaan 10,2023-01-09,17:00:00,148,116,32,FMN 05 Gerard Le Grellelaan
653,Gerard le Grellelaan 10,2023-01-09,18:00:00,81,68,13,FMN 05 Gerard Le Grellelaan
653,Gerard le Grellelaan 10,2023-01-09,19:00:00,39,34,5,FMN 05 Gerard Le Grellelaan
653,Gerard le Grellelaan 10,2023-01-09,20:00:00,21,15,6,FMN 05 Gerard Le Grellelaan
653,Gerard le Grellelaan 10,2023-01-09,21:00:00,23,16,7,FMN 05 Gerard Le Grellelaan
653,Gerard le Grellelaan 10,2023-01-09,22:00:00,24,18,6,FMN 05 Gerard Le Grellelaan
653,Gerard le Grellelaan 10,2023-01-09,23:00:00,8,5,3,FMN 05 Gerard Le Grellelaan
653,Gerard le Grellelaan 10,2023-01-10,00:00:00,4,4,0,FMN 05 Gerard Le Grellelaan
653,Gerard le Grellelaan 10,2023-01-10,01:00:00,0,0,0,FMN 05 Gerard Le Grellelaan
653,Gerard le Grellelaan 10,2023-01-10,02:00:00,1,1,0,FMN 05 Gerard Le Grellelaan
653,Gerard le Grellelaan 10,2023-01-10,03:00:00,1,1,0,FMN 05 Gerard Le Grellelaan
653,Gerard le Grellelaan 10,2023-01-10,04:00:00,5,3,2,FMN 05 Gerard Le Grellelaan
653,Gerard le Grellelaan 10,2023-01-10,05:00:00,16,4,12,FMN 05 Gerard Le Grellelaan
653,Gerard le Grellelaan 10,2023-01-10,06:00:00,29,18,11,FMN 05 Gerard Le Grellelaan
653,Gerard le Grellelaan 10,2023-01-10,07:00:00,97,82,15,FMN 05 Gerard Le Grellelaan
653,Gerard le Grellelaan 10,2023-01-10,08:00:00,257,207,50,FMN 05 Gerard Le Grellelaan
653,Gerard le Grellelaan 10,2023-01-10,09:00:00,66,55,11,FMN 05 Gerard Le Grellelaan
653,Gerard le Grellelaan 10,2023-01-10,10:00:00,47,45,2,FMN 05 Gerard Le Grellelaan
653,Gerard le Grellelaan 10,2023-01-10,11:00:00,56,47,9,FMN 05 Gerard Le Grellelaan
653,Gerard le Grellelaan 10,2023-01-10,12:00:00,85,65,20,FMN 05 Gerard Le Grellelaan
653,Gerard le Grellelaan 10,2023-01-10,13:00:00,49,36,13,FMN 05 Gerard Le Grellelaan
653,Gerard le Grellelaan 10,2023-01-10,14:00:00,41,33,8,FMN 05 Gerard Le Grellelaan
653,Gerard le Grellelaan 10,2023-01-10,15:00:00,99,80,19,FMN 05 Gerard Le Grellelaan
653,Gerard le Grellelaan 10,2023-01-10,16:00:00,135,113,22,FMN 05 Gerard Le Grellelaan
653,Gerard le Grellelaan 10,2023-01-10,17:00:00,119,95,24,FMN 05 Gerard Le Grellelaan
653,Gerard le Grellelaan 10,2023-01-10,18:00:00,98,84,14,FMN 05 Gerard Le Grellelaan
653,Gerard le Grellelaan 10,2023-01-10,19:00:00,41,31,10,FMN 05 Gerard Le Grellelaan
653,Gerard le Grellelaan 10,2023-01-10,20:00:00,22,18,4,FMN 05 Gerard Le Grellelaan
653,Gerard le Grellelaan 10,2023-01-10,21:00:00,21,14,7,FMN 05 Gerard Le Grellelaan
653,Gerard le Grellelaan 10,2023-01-10,22:00:00,28,22,6,FMN 05 Gerard Le Grellelaan
653,Gerard le Grellelaan 10,2023-01-10,23:00:00,11,9,2,FMN 05 Gerard Le Grellelaan
653,Gerard le Grellelaan 10,2023-01-11,00:00:00,3,3,0,FMN 05 Gerard Le Grellelaan
653,Gerard le Grellelaan 10,2023-01-11,01:00:00,3,3,0,FMN 05 Gerard Le Grellelaan
653,Gerard le Grellelaan 10,2023-01-11,02:00:00,0,0,0,FMN 05 Gerard Le Grellelaan
653,Gerard le Grellelaan 10,2023-01-11,03:00:00,2,2,0,FMN 05 Gerard Le Grellelaan
653,Gerard le Grellelaan 10,2023-01-11,04:00:00,7,4,3,FMN 05 Gerard Le Grellelaan
653,Gerard le Grellelaan 10,2023-01-11,05:00:00,26,8,18,FMN 05 Gerard Le Grellelaan
653,Gerard le Grellelaan 10,2023-01-11,06:00:00,44,20,24,FMN 05 Gerard Le Grellelaan
653,Gerard le Grellelaan 10,2023-01-11,07:00:00,116,85,31,FMN 05 Gerard Le Grellelaan
653,Gerard le Grellelaan 10,2023-01-11,08:00:00,252,208,44,FMN 05 Gerard Le Grellelaan
653,Gerard le Grellelaan 10,2023-01-11,09:00:00,72,61,11,FMN 05 Gerard Le Grellelaan
653,Gerard le Grellelaan 10,2023-01-11,10:00:00,67,59,8,FMN 05 Gerard Le Grellelaan
653,Gerard le Grellelaan 10,2023-01-11,11:00:00,49,34,15,FMN 05 Gerard Le Grellelaan
653,Gerard le Grellelaan 10,2023-01-11,12:00:00,125,94,31,FMN 05 Gerard Le Grellelaan
653,Gerard le Grellelaan 10,2023-01-11,13:00:00,76,51,25,FMN 05 Gerard Le Grellelaan
653,Gerard le Grellelaan 10,2023-01-11,14:00:00,86,68,18,FMN 05 Gerard Le Grellelaan
653,Gerard le Grellelaan 10,2023-01-11,15:00:00,113,98,15,FMN 05 Gerard Le Grellelaan
653,Gerard le Grellelaan 10,2023-01-11,16:00:00,112,90,22,FMN 05 Gerard Le Grellelaan
653,Gerard le Grellelaan 10,2023-01-11,17:00:00,138,119,19,FMN 05 Gerard Le Grellelaan
653,Gerard le Grellelaan 10,2023-01-11,18:00:00,93,80,13,FMN 05 Gerard Le Grellelaan
653,Gerard le Grellelaan 10,2023-01-11,19:00:00,55,43,12,FMN 05 Gerard Le Grellelaan
653,Gerard le Grellelaan 10,2023-01-11,20:00:00,46,36,10,FMN 05 Gerard Le Grellelaan
653,Gerard le Grellelaan 10,2023-01-11,21:00:00,26,19,7,FMN 05 Gerard Le Grellelaan
653,Gerard le Grellelaan 10,2023-01-11,22:00:00,31,23,8,FMN 05 Gerard Le Grellelaan
653,Gerard le Grellelaan 10,2023-01-11,23:00:00,11,9,2,FMN 05 Gerard Le Grellelaan
653,Gerard le Grellelaan 10,2023-01-12,00:00:00,1,1,0,FMN 05 Gerard Le Grellelaan
653,Gerard le Grellelaan 10,2023-01-12,01:00:00,3,3,0,FMN 05 Gerard Le Grellelaan
653,Gerard le Grellelaan 10,2023-01-12,02:00:00,1,1,0,FMN 05 Gerard Le Grellelaan
653,Gerard le Grellelaan 10,2023-01-12,03:00:00,3,2,1,FMN 05 Gerard Le Grellelaan
653,Gerard le Grellelaan 10,2023-01-12,04:00:00,9,5,4,FMN 05 Gerard Le Grellelaan
653,Gerard le Grellelaan 10,2023-01-12,05:00:00,16,4,12,FMN 05 Gerard Le Grellelaan
653,Gerard le Grellelaan 10,2023-01-12,06:00:00,20,7,13,FMN 05 Gerard Le Grellelaan
653,Gerard le Grellelaan 10,2023-01-12,07:00:00,88,67,21,FMN 05 Gerard Le Grellelaan
653,Gerard le Grellelaan 10,2023-01-12,08:00:00,178,140,38,FMN 05 Gerard Le Grellelaan
653,Gerard le Grellelaan 10,2023-01-12,09:00:00,46,34,12,FMN 05 Gerard Le Grellelaan
653,Gerard le Grellelaan 10,2023-01-12,10:00:00,29,26,3,FMN 05 Gerard Le Grellelaan
653,Gerard le Grellelaan 10,2023-01-12,11:00:00,21,20,1,FMN 05 Gerard Le Grellelaan
653,Gerard le Grellelaan 10,2023-01-12,12:00:00,38,30,8,FMN 05 Gerard Le Grellelaan
653,Gerard le Grellelaan 10,2023-01-12,13:00:00,23,19,4,FMN 05 Gerard Le Grellelaan
653,Gerard le Grellelaan 10,2023-01-12,14:00:00,39,33,6,FMN 05 Gerard Le Grellelaan
653,Gerard le Grellelaan 10,2023-01-12,15:00:00,59,45,14,FMN 05 Gerard Le Grellelaan
653,Gerard le Grellelaan 10,2023-01-12,16:00:00,85,62,23,FMN 05 Gerard Le Grellelaan
653,Gerard le Grellelaan 10,2023-01-12,17:00:00,115,94,21,FMN 05 Gerard Le Grellelaan
653,Gerard le Grellelaan 10,2023-01-12,18:00:00,51,47,4,FMN 05 Gerard Le Grellelaan
653,Gerard le Grellelaan 10,2023-01-12,19:00:00,40,37,3,FMN 05 Gerard Le Grellelaan
653,Gerard le Grellelaan 10,2023-01-12,20:00:00,16,11,5,FMN 05 Gerard Le Grellelaan
653,Gerard le Grellelaan 10,2023-01-12,21:00:00,18,10,8,FMN 05 Gerard Le Grellelaan
653,Gerard le Grellelaan 10,2023-01-12,22:00:00,27,22,5,FMN 05 Gerard Le Grellelaan
653,Gerard le Grellelaan 10,2023-01-12,23:00:00,11,9,2,FMN 05 Gerard Le Grellelaan
653,Gerard le Grellelaan 10,2023-01-13,00:00:00,4,4,0,FMN 05 Gerard Le Grellelaan
653,Gerard le Grellelaan 10,2023-01-13,01:00:00,2,1,1,FMN 05 Gerard Le Grellelaan
653,Gerard le Grellelaan 10,2023-01-13,02:00:00,0,0,0,FMN 05 Gerard Le Grellelaan
653,Gerard le Grellelaan 10,2023-01-13,03:00:00,1,1,0,FMN 05 Gerard Le Grellelaan
653,Gerard le Grellelaan 10,2023-01-13,04:00:00,5,2,3,FMN 05 Gerard Le Grellelaan
653,Gerard le Grellelaan 10,2023-01-13,05:00:00,10,2,8,FMN 05 Gerard Le Grellelaan
653,Gerard le Grellelaan 10,2023-01-13,06:00:00,37,20,17,FMN 05 Gerard Le Grellelaan
653,Gerard le Grellelaan 10,2023-01-13,07:00:00,89,71,18,FMN 05 Gerard Le Grellelaan
653,Gerard le Grellelaan 10,2023-01-13,08:00:00,213,172,41,FMN 05 Gerard Le Grellelaan
653,Gerard le Grellelaan 10,2023-01-13,09:00:00,75,60,15,FMN 05 Gerard Le Grellelaan
653,Gerard le Grellelaan 10,2023-01-13,10:00:00,53,52,1,FMN 05 Gerard Le Grellelaan
653,Gerard le Grellelaan 10,2023-01-13,11:00:00,44,37,7,FMN 05 Gerard Le Grellelaan
653,Gerard le Grellelaan 10,2023-01-13,12:00:00,64,52,12,FMN 05 Gerard Le Grellelaan
653,Gerard le Grellelaan 10,2023-01-13,13:00:00,50,35,15,FMN 05 Gerard Le Grellelaan
653,Gerard le Grellelaan 10,2023-01-13,14:00:00,57,48,9,FMN 05 Gerard Le Grellelaan
653,Gerard le Grellelaan 10,2023-01-13,15:00:00,122,92,30,FMN 05 Gerard Le Grellelaan
653,Gerard le Grellelaan 10,2023-01-13,16:00:00,121,103,18,FMN 05 Gerard Le Grellelaan
653,Gerard le Grellelaan 10,2023-01-13,17:00:00,118,97,21,FMN 05 Gerard Le Grellelaan
653,Gerard le Grellelaan 10,2023-01-13,18:00:00,70,57,13,FMN 05 Gerard Le Grellelaan
653,Gerard le Grellelaan 10,2023-01-13,19:00:00,55,48,7,FMN 05 Gerard Le Grellelaan
653,Gerard le Grellelaan 10,2023-01-13,20:00:00,43,36,7,FMN 05 Gerard Le Grellelaan
653,Gerard le Grellelaan 10,2023-01-13,21:00:00,21,16,5,FMN 05 Gerard Le Grellelaan
653,Gerard le Grellelaan 10,2023-01-13,22:00:00,39,36,3,FMN 05 Gerard Le Grellelaan
653,Gerard le Grellelaan 10,2023-01-13,23:00:00,10,7,3,FMN 05 Gerard Le Grellelaan
653,Gerard le Grellelaan 10,2023-01-14,00:00:00,8,6,2,FMN 05 Gerard Le Grellelaan
653,Gerard le Grellelaan 10,2023-01-14,01:00:00,5,3,2,FMN 05 Gerard Le Grellelaan
653,Gerard le Grellelaan 10,2023-01-14,02:00:00,8,6,2,FMN 05 Gerard Le Grellelaan
653,Gerard le Grellelaan 10,2023-01-14,03:00:00,2,2,0,FMN 05 Gerard Le Grellelaan
653,Gerard le Grellelaan 10,2023-01-14,04:00:00,5,3,2,FMN 05 Gerard Le Grellelaan
653,Gerard le Grellelaan 10,2023-01-14,05:00:00,5,1,4,FMN 05 Gerard Le Grellelaan
653,Gerard le Grellelaan 10,2023-01-14,06:00:00,4,2,2,FMN 05 Gerard Le Grellelaan
653,Gerard le Grellelaan 10,2023-01-14,07:00:00,8,6,2,FMN 05 Gerard Le Grellelaan
653,Gerard le Grellelaan 10,2023-01-14,08:00:00,15,14,1,FMN 05 Gerard Le Grellelaan
653,Gerard le Grellelaan 10,2023-01-14,09:00:00,15,14,1,FMN 05 Gerard Le Grellelaan
653,Gerard le Grellelaan 10,2023-01-14,10:00:00,8,6,2,FMN 05 Gerard Le Grellelaan
653,Gerard le Grellelaan 10,2023-01-14,11:00:00,17,14,3,FMN 05 Gerard Le Grellelaan
653,Gerard le Grellelaan 10,2023-01-14,12:00:00,23,16,7,FMN 05 Gerard Le Grellelaan
653,Gerard le Grellelaan 10,2023-01-14,13:00:00,21,18,3,FMN 05 Gerard Le Grellelaan
653,Gerard le Grellelaan 10,2023-01-14,14:00:00,23,20,3,FMN 05 Gerard Le Grellelaan
653,Gerard le Grellelaan 10,2023-01-14,15:00:00,27,23,4,FMN 05 Gerard Le Grellelaan
653,Gerard le Grellelaan 10,2023-01-14,16:00:00,18,14,4,FMN 05 Gerard Le Grellelaan
653,Gerard le Grellelaan 10,2023-01-14,17:00:00,18,13,5,FMN 05 Gerard Le Grellelaan
653,Gerard le Grellelaan 10,2023-01-14,18:00:00,21,17,4,FMN 05 Gerard Le Grellelaan
653,Gerard le Grellelaan 10,2023-01-14,19:00:00,17,14,3,FMN 05 Gerard Le Grellelaan
653,Gerard le Grellelaan 10,2023-01-14,20:00:00,11,8,3,FMN 05 Gerard Le Grellelaan
653,Gerard le Grellelaan 10,2023-01-14,21:00:00,11,10,1,FMN 05 Gerard Le Grellelaan
653,Gerard le Grellelaan 10,2023-01-14,22:00:00,10,8,2,FMN 05 Gerard Le Grellelaan
653,Gerard le Grellelaan 10,2023-01-14,23:00:00,8,6,2,FMN 05 Gerard Le Grellelaan
653,Gerard le Grellelaan 10,2023-01-15,00:00:00,11,10,1,FMN 05 Gerard Le Grellelaan
653,Gerard le Grellelaan 10,2023-01-15,01:00:00,9,7,2,FMN 05 Gerard Le Grellelaan
653,Gerard le Grellelaan 10,2023-01-15,02:00:00,4,3,1,FMN 05 Gerard Le Grellelaan
653,Gerard le Grellelaan 10,2023-01-15,03:00:00,6,4,2,FMN 05 Gerard Le Grellelaan
653,Gerard le Grellelaan 10,2023-01-15,04:00:00,6,5,1,FMN 05 Gerard Le Grellelaan
653,Gerard le Grellelaan 10,2023-01-15,05:00:00,2,2,0,FMN 05 Gerard Le Grellelaan
653,Gerard le Grellelaan 10,2023-01-15,06:00:00,2,0,2,FMN 05 Gerard Le Grellelaan
653,Gerard le Grellelaan 10,2023-01-15,07:00:00,6,3,3,FMN 05 Gerard Le Grellelaan
653,Gerard le Grellelaan 10,2023-01-15,08:00:00,11,10,1,FMN 05 Gerard Le Grellelaan
653,Gerard le Grellelaan 10,2023-01-15,09:00:00,19,18,1,FMN 05 Gerard Le Grellelaan
653,Gerard le Grellelaan 10,2023-01-15,10:00:00,30,25,5,FMN 05 Gerard Le Grellelaan
653,Gerard le Grellelaan 10,2023-01-15,11:00:00,41,30,11,FMN 05 Gerard Le Grellelaan
653,Gerard le Grellelaan 10,2023-01-15,12:00:00,34,31,3,FMN 05 Gerard Le Grellelaan
653,Gerard le Grellelaan 10,2023-01-15,13:00:00,43,33,10,FMN 05 Gerard Le Grellelaan
653,Gerard le Grellelaan 10,2023-01-15,14:00:00,42,37,5,FMN 05 Gerard Le Grellelaan
653,Gerard le Grellelaan 10,2023-01-15,15:00:00,43,35,8,FMN 05 Gerard Le Grellelaan
653,Gerard le Grellelaan 10,2023-01-15,16:00:00,47,38,9,FMN 05 Gerard Le Grellelaan
653,Gerard le Grellelaan 10,2023-01-15,17:00:00,48,36,12,FMN 05 Gerard Le Grellelaan
653,Gerard le Grellelaan 10,2023-01-15,18:00:00,32,28,4,FMN 05 Gerard Le Grellelaan
653,Gerard le Grellelaan 10,2023-01-15,19:00:00,22,19,3,FMN 05 Gerard Le Grellelaan
653,Gerard le Grellelaan 10,2023-01-15,20:00:00,26,16,10,FMN 05 Gerard Le Grellelaan
653,Gerard le Grellelaan 10,2023-01-15,21:00:00,24,21,3,FMN 05 Gerard Le Grellelaan
653,Gerard le Grellelaan 10,2023-01-15,22:00:00,19,16,3,FMN 05 Gerard Le Grellelaan
653,Gerard le Grellelaan 10,2023-01-15,23:00:00,6,5,1,FMN 05 Gerard Le Grellelaan
653,Gerard le Grellelaan 10,2023-01-16,00:00:00,3,3,0,FMN 05 Gerard Le Grellelaan
653,Gerard le Grellelaan 10,2023-01-16,01:00:00,0,0,0,FMN 05 Gerard Le Grellelaan
653,Gerard le Grellelaan 10,2023-01-16,02:00:00,2,2,0,FMN 05 Gerard Le Grellelaan
653,Gerard le Grellelaan 10,2023-01-16,03:00:00,3,2,1,FMN 05 Gerard Le Grellelaan
653,Gerard le Grellelaan 10,2023-01-16,04:00:00,11,3,8,FMN 05 Gerard Le Grellelaan
653,Gerard le Grellelaan 10,2023-01-16,05:00:00,12,3,9,FMN 05 Gerard Le Grellelaan
653,Gerard le Grellelaan 10,2023-01-16,06:00:00,33,20,13,FMN 05 Gerard Le Grellelaan
653,Gerard le Grellelaan 10,2023-01-16,07:00:00,75,59,16,FMN 05 Gerard Le Grellelaan
653,Gerard le Grellelaan 10,2023-01-16,08:00:00,147,116,31,FMN 05 Gerard Le Grellelaan
653,Gerard le Grellelaan 10,2023-01-16,09:00:00,55,49,6,FMN 05 Gerard Le Grellelaan
653,Gerard le Grellelaan 10,2023-01-16,10:00:00,44,35,9,FMN 05 Gerard Le Grellelaan
653,Gerard le Grellelaan 10,2023-01-16,11:00:00,36,30,6,FMN 05 Gerard Le Grellelaan
653,Gerard le Grellelaan 10,2023-01-16,12:00:00,44,34,10,FMN 05 Gerard Le Grellelaan
653,Gerard le Grellelaan 10,2023-01-16,13:00:00,53,41,12,FMN 05 Gerard Le Grellelaan
653,Gerard le Grellelaan 10,2023-01-16,14:00:00,49,38,11,FMN 05 Gerard Le Grellelaan
653,Gerard le Grellelaan 10,2023-01-16,15:00:00,78,65,13,FMN 05 Gerard Le Grellelaan
653,Gerard le Grellelaan 10,2023-01-16,16:00:00,108,86,22,FMN 05 Gerard Le Grellelaan
653,Gerard le Grellelaan 10,2023-01-16,17:00:00,128,101,27,FMN 05 Gerard Le Grellelaan
653,Gerard le Grellelaan 10,2023-01-16,18:00:00,88,75,13,FMN 05 Gerard Le Grellelaan
653,Gerard le Grellelaan 10,2023-01-16,19:00:00,45,33,12,FMN 05 Gerard Le Grellelaan
653,Gerard le Grellelaan 10,2023-01-16,20:00:00,32,23,9,FMN 05 Gerard Le Grellelaan
653,Gerard le Grellelaan 10,2023-01-16,21:00:00,33,24,9,FMN 05 Gerard Le Grellelaan
653,Gerard le Grellelaan 10,2023-01-16,22:00:00,20,17,3,FMN 05 Gerard Le Grellelaan
653,Gerard le Grellelaan 10,2023-01-16,23:00:00,4,4,0,FMN 05 Gerard Le Grellelaan
653,Gerard le Grellelaan 10,2023-01-17,00:00:00,5,4,1,FMN 05 Gerard Le Grellelaan
653,Gerard le Grellelaan 10,2023-01-17,01:00:00,1,0,1,FMN 05 Gerard Le Grellelaan
653,Gerard le Grellelaan 10,2023-01-17,02:00:00,3,2,1,FMN 05 Gerard Le Grellelaan
653,Gerard le Grellelaan 10,2023-01-17,03:00:00,4,4,0,FMN 05 Gerard Le Grellelaan
653,Gerard le Grellelaan 10,2023-01-17,04:00:00,8,3,5,FMN 05 Gerard Le Grellelaan
653,Gerard le Grellelaan 10,2023-01-17,05:00:00,14,6,8,FMN 05 Gerard Le Grellelaan
653,Gerard le Grellelaan 10,2023-01-17,06:00:00,31,19,12,FMN 05 Gerard Le Grellelaan
653,Gerard le Grellelaan 10,2023-01-17,07:00:00,93,71,22,FMN 05 Gerard Le Grellelaan
653,Gerard le Grellelaan 10,2023-01-17,08:00:00,188,149,39,FMN 05 Gerard Le Grellelaan
653,Gerard le Grellelaan 10,2023-01-17,09:00:00,83,69,14,FMN 05 Gerard Le Grellelaan
653,Gerard le Grellelaan 10,2023-01-17,10:00:00,52,46,6,FMN 05 Gerard Le Grellelaan
653,Gerard le Grellelaan 10,2023-01-17,11:00:00,54,46,8,FMN 05 Gerard Le Grellelaan
653,Gerard le Grellelaan 10,2023-01-17,12:00:00,76,63,13,FMN 05 Gerard Le Grellelaan
653,Gerard le Grellelaan 10,2023-01-17,13:00:00,70,57,13,FMN 05 Gerard Le Grellelaan
653,Gerard le Grellelaan 10,2023-01-17,14:00:00,65,50,15,FMN 05 Gerard Le Grellelaan
653,Gerard le Grellelaan 10,2023-01-17,15:00:00,101,80,21,FMN 05 Gerard Le Grellelaan
653,Gerard le Grellelaan 10,2023-01-17,16:00:00,137,108,29,FMN 05 Gerard Le Grellelaan
653,Gerard le Grellelaan 10,2023-01-17,17:00:00,157,123,34,FMN 05 Gerard Le Grellelaan
653,Gerard le Grellelaan 10,2023-01-17,18:00:00,122,95,27,FMN 05 Gerard Le Grellelaan
653,Gerard le Grellelaan 10,2023-01-17,19:00:00,60,49,11,FMN 05 Gerard Le Grellelaan
653,Gerard le Grellelaan 10,2023-01-17,20:00:00,42,33,9,FMN 05 Gerard Le Grellelaan
653,Gerard le Grellelaan 10,2023-01-17,21:00:00,28,24,4,FMN 05 Gerard Le Grellelaan
653,Gerard le Grellelaan 10,2023-01-17,22:00:00,28,24,4,FMN 05 Gerard Le Grellelaan
653,Gerard le Grellelaan 10,2023-01-17,23:00:00,14,5,9,FMN 05 Gerard Le Grellelaan
653,Gerard le Grellelaan 10,2023-01-18,00:00:00,6,4,2,FMN 05 Gerard Le Grellelaan
653,Gerard le Grellelaan 10,2023-01-18,01:00:00,5,3,2,FMN 05 Gerard Le Grellelaan
653,Gerard le Grellelaan 10,2023-01-18,02:00:00,1,1,0,FMN 05 Gerard Le Grellelaan
653,Gerard le Grellelaan 10,2023-01-18,03:00:00,5,3,2,FMN 05 Gerard Le Grellelaan
653,Gerard le Grellelaan 10,2023-01-18,04:00:00,11,7,4,FMN 05 Gerard Le Grellelaan
653,Gerard le Grellelaan 10,2023-01-18,05:00:00,14,3,11,FMN 05 Gerard Le Grellelaan
653,Gerard le Grellelaan 10,2023-01-18,06:00:00,32,16,16,FMN 05 Gerard Le Grellelaan
653,Gerard le Grellelaan 10,2023-01-18,07:00:00,88,60,28,FMN 05 Gerard Le Grellelaan
653,Gerard le Grellelaan 10,2023-01-18,08:00:00,175,130,45,FMN 05 Gerard Le Grellelaan
653,Gerard le Grellelaan 10,2023-01-18,09:00:00,64,56,8,FMN 05 Gerard Le Grellelaan
653,Gerard le Grellelaan 10,2023-01-18,10:00:00,71,57,14,FMN 05 Gerard Le Grellelaan
653,Gerard le Grellelaan 10,2023-01-18,11:00:00,55,47,8,FMN 05 Gerard Le Grellelaan
653,Gerard le Grellelaan 10,2023-01-18,12:00:00,102,77,25,FMN 05 Gerard Le Grellelaan
653,Gerard le Grellelaan 10,2023-01-18,13:00:00,79,64,15,FMN 05 Gerard Le Grellelaan
653,Gerard le Grellelaan 10,2023-01-18,14:00:00,75,60,15,FMN 05 Gerard Le Grellelaan
653,Gerard le Grellelaan 10,2023-01-18,15:00:00,97,80,17,FMN 05 Gerard Le Grellelaan
653,Gerard le Grellelaan 10,2023-01-18,16:00:00,129,108,21,FMN 05 Gerard Le Grellelaan
653,Gerard le Grellelaan 10,2023-01-18,17:00:00,139,114,25,FMN 05 Gerard Le Grellelaan
653,Gerard le Grellelaan 10,2023-01-18,18:00:00,112,93,19,FMN 05 Gerard Le Grellelaan
653,Gerard le Grellelaan 10,2023-01-18,19:00:00,58,47,11,FMN 05 Gerard Le Grellelaan
653,Gerard le Grellelaan 10,2023-01-18,20:00:00,46,38,8,FMN 05 Gerard Le Grellelaan
653,Gerard le Grellelaan 10,2023-01-18,21:00:00,37,31,6,FMN 05 Gerard Le Grellelaan
653,Gerard le Grellelaan 10,2023-01-18,22:00:00,32,27,5,FMN 05 Gerard Le Grellelaan
653,Gerard le Grellelaan 10,2023-01-18,23:00:00,12,12,0,FMN 05 Gerard Le Grellelaan
653,Gerard le Grellelaan 10,2023-01-19,00:00:00,5,4,1,FMN 05 Gerard Le Grellelaan
653,Gerard le Grellelaan 10,2023-01-19,01:00:00,3,0,3,FMN 05 Gerard Le Grellelaan
653,Gerard le Grellelaan 10,2023-01-19,02:00:00,1,0,1,FMN 05 Gerard Le Grellelaan
653,Gerard le Grellelaan 10,2023-01-19,03:00:00,2,2,0,FMN 05 Gerard Le Grellelaan
653,Gerard le Grellelaan 10,2023-01-19,04:00:00,4,2,2,FMN 05 Gerard Le Grellelaan
653,Gerard le Grellelaan 10,2023-01-19,05:00:00,17,8,9,FMN 05 Gerard Le Grellelaan
653,Gerard le Grellelaan 10,2023-01-19,06:00:00,33,16,17,FMN 05 Gerard Le Grellelaan
653,Gerard le Grellelaan 10,2023-01-19,07:00:00,81,57,24,FMN 05 Gerard Le Grellelaan
653,Gerard le Grellelaan 10,2023-01-19,08:00:00,189,148,41,FMN 05 Gerard Le Grellelaan
653,Gerard le Grellelaan 10,2023-01-19,09:00:00,71,68,3,FMN 05 Gerard Le Grellelaan
653,Gerard le Grellelaan 10,2023-01-19,10:00:00,52,43,9,FMN 05 Gerard Le Grellelaan
653,Gerard le Grellelaan 10,2023-01-19,11:00:00,56,47,9,FMN 05 Gerard Le Grellelaan
653,Gerard le Grellelaan 10,2023-01-19,12:00:00,71,58,13,FMN 05 Gerard Le Grellelaan
653,Gerard le Grellelaan 10,2023-01-19,13:00:00,59,47,12,FMN 05 Gerard Le Grellelaan
653,Gerard le Grellelaan 10,2023-01-19,14:00:00,60,47,13,FMN 05 Gerard Le Grellelaan
653,Gerard le Grellelaan 10,2023-01-19,15:00:00,111,86,25,FMN 05 Gerard Le Grellelaan
653,Gerard le Grellelaan 10,2023-01-19,16:00:00,114,97,17,FMN 05 Gerard Le Grellelaan
653,Gerard le Grellelaan 10,2023-01-19,17:00:00,132,107,25,FMN 05 Gerard Le Grellelaan
653,Gerard le Grellelaan 10,2023-01-19,18:00:00,106,83,23,FMN 05 Gerard Le Grellelaan
653,Gerard le Grellelaan 10,2023-01-19,19:00:00,63,56,7,FMN 05 Gerard Le Grellelaan
653,Gerard le Grellelaan 10,2023-01-19,20:00:00,39,30,9,FMN 05 Gerard Le Grellelaan
653,Gerard le Grellelaan 10,2023-01-19,21:00:00,27,23,4,FMN 05 Gerard Le Grellelaan
653,Gerard le Grellelaan 10,2023-01-19,22:00:00,30,26,4,FMN 05 Gerard Le Grellelaan
653,Gerard le Grellelaan 10,2023-01-19,23:00:00,21,17,4,FMN 05 Gerard Le Grellelaan
653,Gerard le Grellelaan 10,2023-01-20,00:00:00,11,8,3,FMN 05 Gerard Le Grellelaan
653,Gerard le Grellelaan 10,2023-01-20,01:00:00,4,3,1,FMN 05 Gerard Le Grellelaan
653,Gerard le Grellelaan 10,2023-01-20,02:00:00,7,6,1,FMN 05 Gerard Le Grellelaan
653,Gerard le Grellelaan 10,2023-01-20,03:00:00,2,1,1,FMN 05 Gerard Le Grellelaan
653,Gerard le Grellelaan 10,2023-01-20,04:00:00,6,2,4,FMN 05 Gerard Le Grellelaan
653,Gerard le Grellelaan 10,2023-01-20,05:00:00,6,1,5,FMN 05 Gerard Le Grellelaan
653,Gerard le Grellelaan 10,2023-01-20,06:00:00,26,13,13,FMN 05 Gerard Le Grellelaan
653,Gerard le Grellelaan 10,2023-01-20,07:00:00,70,52,18,FMN 05 Gerard Le Grellelaan
653,Gerard le Grellelaan 10,2023-01-20,08:00:00,129,97,32,FMN 05 Gerard Le Grellelaan
653,Gerard le Grellelaan 10,2023-01-20,09:00:00,53,47,6,FMN 05 Gerard Le Grellelaan
653,Gerard le Grellelaan 10,2023-01-20,10:00:00,55,48,7,FMN 05 Gerard Le Grellelaan
653,Gerard le Grellelaan 10,2023-01-20,11:00:00,51,41,10,FMN 05 Gerard Le Grellelaan
653,Gerard le Grellelaan 10,2023-01-20,12:00:00,61,49,12,FMN 05 Gerard Le Grellelaan
653,Gerard le Grellelaan 10,2023-01-20,13:00:00,50,43,7,FMN 05 Gerard Le Grellelaan
653,Gerard le Grellelaan 10,2023-01-20,14:00:00,60,50,10,FMN 05 Gerard Le Grellelaan
653,Gerard le Grellelaan 10,2023-01-20,15:00:00,87,71,16,FMN 05 Gerard Le Grellelaan
653,Gerard le Grellelaan 10,2023-01-20,16:00:00,107,82,25,FMN 05 Gerard Le Grellelaan
653,Gerard le Grellelaan 10,2023-01-20,17:00:00,109,82,27,FMN 05 Gerard Le Grellelaan
653,Gerard le Grellelaan 10,2023-01-20,18:00:00,87,77,10,FMN 05 Gerard Le Grellelaan
653,Gerard le Grellelaan 10,2023-01-20,19:00:00,55,44,11,FMN 05 Gerard Le Grellelaan
653,Gerard le Grellelaan 10,2023-01-20,20:00:00,36,32,4,FMN 05 Gerard Le Grellelaan
653,Gerard le Grellelaan 10,2023-01-20,21:00:00,25,20,5,FMN 05 Gerard Le Grellelaan
653,Gerard le Grellelaan 10,2023-01-20,22:00:00,31,26,5,FMN 05 Gerard Le Grellelaan
653,Gerard le Grellelaan 10,2023-01-20,23:00:00,21,19,2,FMN 05 Gerard Le Grellelaan
653,Gerard le Grellelaan 10,2023-01-21,00:00:00,13,12,1,FMN 05 Gerard Le Grellelaan
653,Gerard le Grellelaan 10,2023-01-21,01:00:00,5,3,2,FMN 05 Gerard Le Grellelaan
653,Gerard le Grellelaan 10,2023-01-21,02:00:00,2,2,0,FMN 05 Gerard Le Grellelaan
653,Gerard le Grellelaan 10,2023-01-21,03:00:00,2,2,0,FMN 05 Gerard Le Grellelaan
653,Gerard le Grellelaan 10,2023-01-21,04:00:00,3,3,0,FMN 05 Gerard Le Grellelaan
653,Gerard le Grellelaan 10,2023-01-21,05:00:00,5,2,3,FMN 05 Gerard Le Grellelaan
653,Gerard le Grellelaan 10,2023-01-21,06:00:00,6,3,3,FMN 05 Gerard Le Grellelaan
653,Gerard le Grellelaan 10,2023-01-21,07:00:00,4,4,0,FMN 05 Gerard Le Grellelaan
653,Gerard le Grellelaan 10,2023-01-21,08:00:00,20,12,8,FMN 05 Gerard Le Grellelaan
653,Gerard le Grellelaan 10,2023-01-21,09:00:00,33,27,6,FMN 05 Gerard Le Grellelaan
653,Gerard le Grellelaan 10,2023-01-21,10:00:00,41,32,9,FMN 05 Gerard Le Grellelaan
653,Gerard le Grellelaan 10,2023-01-21,11:00:00,31,24,7,FMN 05 Gerard Le Grellelaan
653,Gerard le Grellelaan 10,2023-01-21,12:00:00,37,29,8,FMN 05 Gerard Le Grellelaan
653,Gerard le Grellelaan 10,2023-01-21,13:00:00,43,37,6,FMN 05 Gerard Le Grellelaan
653,Gerard le Grellelaan 10,2023-01-21,14:00:00,50,39,11,FMN 05 Gerard Le Grellelaan
653,Gerard le Grellelaan 10,2023-01-21,15:00:00,51,44,7,FMN 05 Gerard Le Grellelaan
653,Gerard le Grellelaan 10,2023-01-21,16:00:00,39,31,8,FMN 05 Gerard Le Grellelaan
653,Gerard le Grellelaan 10,2023-01-21,17:00:00,38,34,4,FMN 05 Gerard Le Grellelaan
653,Gerard le Grellelaan 10,2023-01-21,18:00:00,47,40,7,FMN 05 Gerard Le Grellelaan
653,Gerard le Grellelaan 10,2023-01-21,19:00:00,23,18,5,FMN 05 Gerard Le Grellelaan
653,Gerard le Grellelaan 10,2023-01-21,20:00:00,12,10,2,FMN 05 Gerard Le Grellelaan
653,Gerard le Grellelaan 10,2023-01-21,21:00:00,15,12,3,FMN 05 Gerard Le Grellelaan
653,Gerard le Grellelaan 10,2023-01-21,22:00:00,12,11,1,FMN 05 Gerard Le Grellelaan
653,Gerard le Grellelaan 10,2023-01-21,23:00:00,13,9,4,FMN 05 Gerard Le Grellelaan
653,Gerard le Grellelaan 10,2023-01-22,00:00:00,8,6,2,FMN 05 Gerard Le Grellelaan
653,Gerard le Grellelaan 10,2023-01-22,01:00:00,3,3,0,FMN 05 Gerard Le Grellelaan
653,Gerard le Grellelaan 10,2023-01-22,02:00:00,2,1,1,FMN 05 Gerard Le Grellelaan
653,Gerard le Grellelaan 10,2023-01-22,03:00:00,2,2,0,FMN 05 Gerard Le Grellelaan
653,Gerard le Grellelaan 10,2023-01-22,04:00:00,3,1,2,FMN 05 Gerard Le Grellelaan
653,Gerard le Grellelaan 10,2023-01-22,05:00:00,3,2,1,FMN 05 Gerard Le Grellelaan
653,Gerard le Grellelaan 10,2023-01-22,06:00:00,1,1,0,FMN 05 Gerard Le Grellelaan
653,Gerard le Grellelaan 10,2023-01-22,07:00:00,3,3,0,FMN 05 Gerard Le Grellelaan
653,Gerard le Grellelaan 10,2023-01-22,08:00:00,6,6,0,FMN 05 Gerard Le Grellelaan
653,Gerard le Grellelaan 10,2023-01-22,09:00:00,21,18,3,FMN 05 Gerard Le Grellelaan
653,Gerard le Grellelaan 10,2023-01-22,10:00:00,33,26,7,FMN 05 Gerard Le Grellelaan
653,Gerard le Grellelaan 10,2023-01-22,11:00:00,27,18,9,FMN 05 Gerard Le Grellelaan
653,Gerard le Grellelaan 10,2023-01-22,12:00:00,31,27,4,FMN 05 Gerard Le Grellelaan
653,Gerard le Grellelaan 10,2023-01-22,13:00:00,29,23,6,FMN 05 Gerard Le Grellelaan
653,Gerard le Grellelaan 10,2023-01-22,14:00:00,20,17,3,FMN 05 Gerard Le Grellelaan
653,Gerard le Grellelaan 10,2023-01-22,15:00:00,29,23,6,FMN 05 Gerard Le Grellelaan
653,Gerard le Grellelaan 10,2023-01-22,16:00:00,34,31,3,FMN 05 Gerard Le Grellelaan
653,Gerard le Grellelaan 10,2023-01-22,17:00:00,37,31,6,FMN 05 Gerard Le Grellelaan
653,Gerard le Grellelaan 10,2023-01-22,18:00:00,27,23,4,FMN 05 Gerard Le Grellelaan
653,Gerard le Grellelaan 10,2023-01-22,19:00:00,11,7,4,FMN 05 Gerard Le Grellelaan
653,Gerard le Grellelaan 10,2023-01-22,20:00:00,11,8,3,FMN 05 Gerard Le Grellelaan
653,Gerard le Grellelaan 10,2023-01-22,21:00:00,8,6,2,FMN 05 Gerard Le Grellelaan
653,Gerard le Grellelaan 10,2023-01-22,22:00:00,6,5,1,FMN 05 Gerard Le Grellelaan
653,Gerard le Grellelaan 10,2023-01-22,23:00:00,5,3,2,FMN 05 Gerard Le Grellelaan
653,Gerard le Grellelaan 10,2023-01-23,00:00:00,9,7,2,FMN 05 Gerard Le Grellelaan
653,Gerard le Grellelaan 10,2023-01-23,01:00:00,5,5,0,FMN 05 Gerard Le Grellelaan
653,Gerard le Grellelaan 10,2023-01-23,02:00:00,3,1,2,FMN 05 Gerard Le Grellelaan
653,Gerard le Grellelaan 10,2023-01-23,03:00:00,1,1,0,FMN 05 Gerard Le Grellelaan
653,Gerard le Grellelaan 10,2023-01-23,04:00:00,5,4,1,FMN 05 Gerard Le Grellelaan
653,Gerard le Grellelaan 10,2023-01-23,05:00:00,16,4,12,FMN 05 Gerard Le Grellelaan
653,Gerard le Grellelaan 10,2023-01-23,06:00:00,43,23,20,FMN 05 Gerard Le Grellelaan
653,Gerard le Grellelaan 10,2023-01-23,07:00:00,78,62,16,FMN 05 Gerard Le Grellelaan
653,Gerard le Grellelaan 10,2023-01-23,08:00:00,181,144,37,FMN 05 Gerard Le Grellelaan
653,Gerard le Grellelaan 10,2023-01-23,09:00:00,73,64,9,FMN 05 Gerard Le Grellelaan
653,Gerard le Grellelaan 10,2023-01-23,10:00:00,46,38,8,FMN 05 Gerard Le Grellelaan
653,Gerard le Grellelaan 10,2023-01-23,11:00:00,54,43,11,FMN 05 Gerard Le Grellelaan
653,Gerard le Grellelaan 10,2023-01-23,12:00:00,72,56,16,FMN 05 Gerard Le Grellelaan
653,Gerard le Grellelaan 10,2023-01-23,13:00:00,55,45,10,FMN 05 Gerard Le Grellelaan
653,Gerard le Grellelaan 10,2023-01-23,14:00:00,68,59,9,FMN 05 Gerard Le Grellelaan
653,Gerard le Grellelaan 10,2023-01-23,15:00:00,108,85,23,FMN 05 Gerard Le Grellelaan
653,Gerard le Grellelaan 10,2023-01-23,16:00:00,135,108,27,FMN 05 Gerard Le Grellelaan
653,Gerard le Grellelaan 10,2023-01-23,17:00:00,145,119,26,FMN 05 Gerard Le Grellelaan
653,Gerard le Grellelaan 10,2023-01-23,18:00:00,104,89,15,FMN 05 Gerard Le Grellelaan
653,Gerard le Grellelaan 10,2023-01-23,19:00:00,61,50,11,FMN 05 Gerard Le Grellelaan
653,Gerard le Grellelaan 10,2023-01-23,20:00:00,44,37,7,FMN 05 Gerard Le Grellelaan
653,Gerard le Grellelaan 10,2023-01-23,21:00:00,23,22,1,FMN 05 Gerard Le Grellelaan
653,Gerard le Grellelaan 10,2023-01-23,22:00:00,17,11,6,FMN 05 Gerard Le Grellelaan
653,Gerard le Grellelaan 10,2023-01-23,23:00:00,20,14,6,FMN 05 Gerard Le Grellelaan
653,Gerard le Grellelaan 10,2023-01-24,00:00:00,2,2,0,FMN 05 Gerard Le Grellelaan
653,Gerard le Grellelaan 10,2023-01-24,01:00:00,1,1,0,FMN 05 Gerard Le Grellelaan
653,Gerard le Grellelaan 10,2023-01-24,02:00:00,0,0,0,FMN 05 Gerard Le Grellelaan
653,Gerard le Grellelaan 10,2023-01-24,03:00:00,6,6,0,FMN 05 Gerard Le Grellelaan
653,Gerard le Grellelaan 10,2023-01-24,04:00:00,8,4,4,FMN 05 Gerard Le Grellelaan
653,Gerard le Grellelaan 10,2023-01-24,05:00:00,9,5,4,FMN 05 Gerard Le Grellelaan
653,Gerard le Grellelaan 10,2023-01-24,06:00:00,37,22,15,FMN 05 Gerard Le Grellelaan
653,Gerard le Grellelaan 10,2023-01-24,07:00:00,95,78,17,FMN 05 Gerard Le Grellelaan
653,Gerard le Grellelaan 10,2023-01-24,08:00:00,204,155,49,FMN 05 Gerard Le Grellelaan
653,Gerard le Grellelaan 10,2023-01-24,09:00:00,76,66,10,FMN 05 Gerard Le Grellelaan
653,Gerard le Grellelaan 10,2023-01-24,10:00:00,64,49,15,FMN 05 Gerard Le Grellelaan
653,Gerard le Grellelaan 10,2023-01-24,11:00:00,57,46,11,FMN 05 Gerard Le Grellelaan
653,Gerard le Grellelaan 10,2023-01-24,12:00:00,80,57,23,FMN 05 Gerard Le Grellelaan
653,Gerard le Grellelaan 10,2023-01-24,13:00:00,64,50,14,FMN 05 Gerard Le Grellelaan
653,Gerard le Grellelaan 10,2023-01-24,14:00:00,77,64,13,FMN 05 Gerard Le Grellelaan
653,Gerard le Grellelaan 10,2023-01-24,15:00:00,100,81,19,FMN 05 Gerard Le Grellelaan
653,Gerard le Grellelaan 10,2023-01-24,16:00:00,143,116,27,FMN 05 Gerard Le Grellelaan
653,Gerard le Grellelaan 10,2023-01-24,17:00:00,157,129,28,FMN 05 Gerard Le Grellelaan
653,Gerard le Grellelaan 10,2023-01-24,18:00:00,112,89,23,FMN 05 Gerard Le Grellelaan
653,Gerard le Grellelaan 10,2023-01-24,19:00:00,59,47,12,FMN 05 Gerard Le Grellelaan
653,Gerard le Grellelaan 10,2023-01-24,20:00:00,51,40,11,FMN 05 Gerard Le Grellelaan
653,Gerard le Grellelaan 10,2023-01-24,21:00:00,39,33,6,FMN 05 Gerard Le Grellelaan
653,Gerard le Grellelaan 10,2023-01-24,22:00:00,34,28,6,FMN 05 Gerard Le Grellelaan
653,Gerard le Grellelaan 10,2023-01-24,23:00:00,18,13,5,FMN 05 Gerard Le Grellelaan
653,Gerard le Grellelaan 10,2023-01-25,00:00:00,3,2,1,FMN 05 Gerard Le Grellelaan
653,Gerard le Grellelaan 10,2023-01-25,01:00:00,3,0,3,FMN 05 Gerard Le Grellelaan
653,Gerard le Grellelaan 10,2023-01-25,02:00:00,2,1,1,FMN 05 Gerard Le Grellelaan
653,Gerard le Grellelaan 10,2023-01-25,03:00:00,2,2,0,FMN 05 Gerard Le Grellelaan
653,Gerard le Grellelaan 10,2023-01-25,04:00:00,9,6,3,FMN 05 Gerard Le Grellelaan
653,Gerard le Grellelaan 10,2023-01-25,05:00:00,15,4,11,FMN 05 Gerard Le Grellelaan
653,Gerard le Grellelaan 10,2023-01-25,06:00:00,32,15,17,FMN 05 Gerard Le Grellelaan
653,Gerard le Grellelaan 10,2023-01-25,07:00:00,72,52,20,FMN 05 Gerard Le Grellelaan
653,Gerard le Grellelaan 10,2023-01-25,08:00:00,165,132,33,FMN 05 Gerard Le Grellelaan
653,Gerard le Grellelaan 10,2023-01-25,09:00:00,72,56,16,FMN 05 Gerard Le Grellelaan
653,Gerard le Grellelaan 10,2023-01-25,10:00:00,65,54,11,FMN 05 Gerard Le Grellelaan
653,Gerard le Grellelaan 10,2023-01-25,11:00:00,47,39,8,FMN 05 Gerard Le Grellelaan
653,Gerard le Grellelaan 10,2023-01-25,12:00:00,107,80,27,FMN 05 Gerard Le Grellelaan
653,Gerard le Grellelaan 10,2023-01-25,13:00:00,69,56,13,FMN 05 Gerard Le Grellelaan
653,Gerard le Grellelaan 10,2023-01-25,14:00:00,65,54,11,FMN 05 Gerard Le Grellelaan
653,Gerard le Grellelaan 10,2023-01-25,15:00:00,88,75,13,FMN 05 Gerard Le Grellelaan
653,Gerard le Grellelaan 10,2023-01-25,16:00:00,120,103,17,FMN 05 Gerard Le Grellelaan
653,Gerard le Grellelaan 10,2023-01-25,17:00:00,137,110,27,FMN 05 Gerard Le Grellelaan
653,Gerard le Grellelaan 10,2023-01-25,18:00:00,104,86,18,FMN 05 Gerard Le Grellelaan
653,Gerard le Grellelaan 10,2023-01-25,19:00:00,66,49,17,FMN 05 Gerard Le Grellelaan
653,Gerard le Grellelaan 10,2023-01-25,20:00:00,43,34,9,FMN 05 Gerard Le Grellelaan
653,Gerard le Grellelaan 10,2023-01-25,21:00:00,29,27,2,FMN 05 Gerard Le Grellelaan
653,Gerard le Grellelaan 10,2023-01-25,22:00:00,38,33,5,FMN 05 Gerard Le Grellelaan
653,Gerard le Grellelaan 10,2023-01-25,23:00:00,23,17,6,FMN 05 Gerard Le Grellelaan
653,Gerard le Grellelaan 10,2023-01-26,00:00:00,2,2,0,FMN 05 Gerard Le Grellelaan
653,Gerard le Grellelaan 10,2023-01-26,01:00:00,6,4,2,FMN 05 Gerard Le Grellelaan
653,Gerard le Grellelaan 10,2023-01-26,02:00:00,1,1,0,FMN 05 Gerard Le Grellelaan
653,Gerard le Grellelaan 10,2023-01-26,03:00:00,5,5,0,FMN 05 Gerard Le Grellelaan
653,Gerard le Grellelaan 10,2023-01-26,04:00:00,7,4,3,FMN 05 Gerard Le Grellelaan
653,Gerard le Grellelaan 10,2023-01-26,05:00:00,18,7,11,FMN 05 Gerard Le Grellelaan
653,Gerard le Grellelaan 10,2023-01-26,06:00:00,36,16,20,FMN 05 Gerard Le Grellelaan
653,Gerard le Grellelaan 10,2023-01-26,07:00:00,89,65,24,FMN 05 Gerard Le Grellelaan
653,Gerard le Grellelaan 10,2023-01-26,08:00:00,178,143,35,FMN 05 Gerard Le Grellelaan
653,Gerard le Grellelaan 10,2023-01-26,09:00:00,84,67,17,FMN 05 Gerard Le Grellelaan
653,Gerard le Grellelaan 10,2023-01-26,10:00:00,59,46,13,FMN 05 Gerard Le Grellelaan
653,Gerard le Grellelaan 10,2023-01-26,11:00:00,49,38,11,FMN 05 Gerard Le Grellelaan
653,Gerard le Grellelaan 10,2023-01-26,12:00:00,63,50,13,FMN 05 Gerard Le Grellelaan
653,Gerard le Grellelaan 10,2023-01-26,13:00:00,50,42,8,FMN 05 Gerard Le Grellelaan
653,Gerard le Grellelaan 10,2023-01-26,14:00:00,62,52,10,FMN 05 Gerard Le Grellelaan
653,Gerard le Grellelaan 10,2023-01-26,15:00:00,93,77,16,FMN 05 Gerard Le Grellelaan
653,Gerard le Grellelaan 10,2023-01-26,16:00:00,126,105,21,FMN 05 Gerard Le Grellelaan
653,Gerard le Grellelaan 10,2023-01-26,17:00:00,135,111,24,FMN 05 Gerard Le Grellelaan
653,Gerard le Grellelaan 10,2023-01-26,18:00:00,113,90,23,FMN 05 Gerard Le Grellelaan
653,Gerard le Grellelaan 10,2023-01-26,19:00:00,57,48,9,FMN 05 Gerard Le Grellelaan
653,Gerard le Grellelaan 10,2023-01-26,20:00:00,38,27,11,FMN 05 Gerard Le Grellelaan
653,Gerard le Grellelaan 10,2023-01-26,21:00:00,30,29,1,FMN 05 Gerard Le Grellelaan
653,Gerard le Grellelaan 10,2023-01-26,22:00:00,25,22,3,FMN 05 Gerard Le Grellelaan
653,Gerard le Grellelaan 10,2023-01-26,23:00:00,21,16,5,FMN 05 Gerard Le Grellelaan
653,Gerard le Grellelaan 10,2023-01-27,00:00:00,10,8,2,FMN 05 Gerard Le Grellelaan
653,Gerard le Grellelaan 10,2023-01-27,01:00:00,7,6,1,FMN 05 Gerard Le Grellelaan
653,Gerard le Grellelaan 10,2023-01-27,02:00:00,2,0,2,FMN 05 Gerard Le Grellelaan
653,Gerard le Grellelaan 10,2023-01-27,03:00:00,5,3,2,FMN 05 Gerard Le Grellelaan
653,Gerard le Grellelaan 10,2023-01-27,04:00:00,1,1,0,FMN 05 Gerard Le Grellelaan
653,Gerard le Grellelaan 10,2023-01-27,05:00:00,16,3,13,FMN 05 Gerard Le Grellelaan
653,Gerard le Grellelaan 10,2023-01-27,06:00:00,27,19,8,FMN 05 Gerard Le Grellelaan
653,Gerard le Grellelaan 10,2023-01-27,07:00:00,84,70,14,FMN 05 Gerard Le Grellelaan
653,Gerard le Grellelaan 10,2023-01-27,08:00:00,161,126,35,FMN 05 Gerard Le Grellelaan
653,Gerard le Grellelaan 10,2023-01-27,09:00:00,76,63,13,FMN 05 Gerard Le Grellelaan
653,Gerard le Grellelaan 10,2023-01-27,10:00:00,57,52,5,FMN 05 Gerard Le Grellelaan
653,Gerard le Grellelaan 10,2023-01-27,11:00:00,54,49,5,FMN 05 Gerard Le Grellelaan
653,Gerard le Grellelaan 10,2023-01-27,12:00:00,83,67,16,FMN 05 Gerard Le Grellelaan
653,Gerard le Grellelaan 10,2023-01-27,13:00:00,88,74,14,FMN 05 Gerard Le Grellelaan
653,Gerard le Grellelaan 10,2023-01-27,14:00:00,78,69,9,FMN 05 Gerard Le Grellelaan
653,Gerard le Grellelaan 10,2023-01-27,15:00:00,130,101,29,FMN 05 Gerard Le Grellelaan
653,Gerard le Grellelaan 10,2023-01-27,16:00:00,132,110,22,FMN 05 Gerard Le Grellelaan
653,Gerard le Grellelaan 10,2023-01-27,17:00:00,134,107,27,FMN 05 Gerard Le Grellelaan
653,Gerard le Grellelaan 10,2023-01-27,18:00:00,103,80,23,FMN 05 Gerard Le Grellelaan
653,Gerard le Grellelaan 10,2023-01-27,19:00:00,74,60,14,FMN 05 Gerard Le Grellelaan
653,Gerard le Grellelaan 10,2023-01-27,20:00:00,40,32,8,FMN 05 Gerard Le Grellelaan
653,Gerard le Grellelaan 10,2023-01-27,21:00:00,51,38,13,FMN 05 Gerard Le Grellelaan
653,Gerard le Grellelaan 10,2023-01-27,22:00:00,24,21,3,FMN 05 Gerard Le Grellelaan
653,Gerard le Grellelaan 10,2023-01-27,23:00:00,26,21,5,FMN 05 Gerard Le Grellelaan
653,Gerard le Grellelaan 10,2023-01-28,00:00:00,16,12,4,FMN 05 Gerard Le Grellelaan
653,Gerard le Grellelaan 10,2023-01-28,01:00:00,7,6,1,FMN 05 Gerard Le Grellelaan
653,Gerard le Grellelaan 10,2023-01-28,02:00:00,5,5,0,FMN 05 Gerard Le Grellelaan
653,Gerard le Grellelaan 10,2023-01-28,03:00:00,3,2,1,FMN 05 Gerard Le Grellelaan
653,Gerard le Grellelaan 10,2023-01-28,04:00:00,2,1,1,FMN 05 Gerard Le Grellelaan
653,Gerard le Grellelaan 10,2023-01-28,05:00:00,1,1,0,FMN 05 Gerard Le Grellelaan
653,Gerard le Grellelaan 10,2023-01-28,06:00:00,9,5,4,FMN 05 Gerard Le Grellelaan
653,Gerard le Grellelaan 10,2023-01-28,07:00:00,6,4,2,FMN 05 Gerard Le Grellelaan
653,Gerard le Grellelaan 10,2023-01-28,08:00:00,18,12,6,FMN 05 Gerard Le Grellelaan
653,Gerard le Grellelaan 10,2023-01-28,09:00:00,27,20,7,FMN 05 Gerard Le Grellelaan
653,Gerard le Grellelaan 10,2023-01-28,10:00:00,32,24,8,FMN 05 Gerard Le Grellelaan
653,Gerard le Grellelaan 10,2023-01-28,11:00:00,44,39,5,FMN 05 Gerard Le Grellelaan
653,Gerard le Grellelaan 10,2023-01-28,12:00:00,49,42,7,FMN 05 Gerard Le Grellelaan
653,Gerard le Grellelaan 10,2023-01-28,13:00:00,57,50,7,FMN 05 Gerard Le Grellelaan
653,Gerard le Grellelaan 10,2023-01-28,14:00:00,52,40,12,FMN 05 Gerard Le Grellelaan
653,Gerard le Grellelaan 10,2023-01-28,15:00:00,61,50,11,FMN 05 Gerard Le Grellelaan
653,Gerard le Grellelaan 10,2023-01-28,16:00:00,59,46,13,FMN 05 Gerard Le Grellelaan
653,Gerard le Grellelaan 10,2023-01-28,17:00:00,58,45,13,FMN 05 Gerard Le Grellelaan
653,Gerard le Grellelaan 10,2023-01-28,18:00:00,36,29,7,FMN 05 Gerard Le Grellelaan
653,Gerard le Grellelaan 10,2023-01-28,19:00:00,40,33,7,FMN 05 Gerard Le Grellelaan
653,Gerard le Grellelaan 10,2023-01-28,20:00:00,32,25,7,FMN 05 Gerard Le Grellelaan
653,Gerard le Grellelaan 10,2023-01-28,21:00:00,19,13,6,FMN 05 Gerard Le Grellelaan
653,Gerard le Grellelaan 10,2023-01-28,22:00:00,17,15,2,FMN 05 Gerard Le Grellelaan
653,Gerard le Grellelaan 10,2023-01-28,23:00:00,16,13,3,FMN 05 Gerard Le Grellelaan
653,Gerard le Grellelaan 10,2023-01-29,00:00:00,5,3,2,FMN 05 Gerard Le Grellelaan
653,Gerard le Grellelaan 10,2023-01-29,01:00:00,8,4,4,FMN 05 Gerard Le Grellelaan
653,Gerard le Grellelaan 10,2023-01-29,02:00:00,2,0,2,FMN 05 Gerard Le Grellelaan
653,Gerard le Grellelaan 10,2023-01-29,03:00:00,1,0,1,FMN 05 Gerard Le Grellelaan
653,Gerard le Grellelaan 10,2023-01-29,04:00:00,4,2,2,FMN 05 Gerard Le Grellelaan
653,Gerard le Grellelaan 10,2023-01-29,05:00:00,3,1,2,FMN 05 Gerard Le Grellelaan
653,Gerard le Grellelaan 10,2023-01-29,06:00:00,5,5,0,FMN 05 Gerard Le Grellelaan
653,Gerard le Grellelaan 10,2023-01-29,07:00:00,4,3,1,FMN 05 Gerard Le Grellelaan
653,Gerard le Grellelaan 10,2023-01-29,08:00:00,5,4,1,FMN 05 Gerard Le Grellelaan
653,Gerard le Grellelaan 10,2023-01-29,09:00:00,31,24,7,FMN 05 Gerard Le Grellelaan
653,Gerard le Grellelaan 10,2023-01-29,10:00:00,22,20,2,FMN 05 Gerard Le Grellelaan
653,Gerard le Grellelaan 10,2023-01-29,11:00:00,35,25,10,FMN 05 Gerard Le Grellelaan
653,Gerard le Grellelaan 10,2023-01-29,12:00:00,52,42,10,FMN 05 Gerard Le Grellelaan
653,Gerard le Grellelaan 10,2023-01-29,13:00:00,47,40,7,FMN 05 Gerard Le Grellelaan
653,Gerard le Grellelaan 10,2023-01-29,14:00:00,44,38,6,FMN 05 Gerard Le Grellelaan
653,Gerard le Grellelaan 10,2023-01-29,15:00:00,42,37,5,FMN 05 Gerard Le Grellelaan
653,Gerard le Grellelaan 10,2023-01-29,16:00:00,40,32,8,FMN 05 Gerard Le Grellelaan
653,Gerard le Grellelaan 10,2023-01-29,17:00:00,34,26,8,FMN 05 Gerard Le Grellelaan
653,Gerard le Grellelaan 10,2023-01-29,18:00:00,26,20,6,FMN 05 Gerard Le Grellelaan
653,Gerard le Grellelaan 10,2023-01-29,19:00:00,10,8,2,FMN 05 Gerard Le Grellelaan
653,Gerard le Grellelaan 10,2023-01-29,20:00:00,13,11,2,FMN 05 Gerard Le Grellelaan
653,Gerard le Grellelaan 10,2023-01-29,21:00:00,14,12,2,FMN 05 Gerard Le Grellelaan
653,Gerard le Grellelaan 10,2023-01-29,22:00:00,7,3,4,FMN 05 Gerard Le Grellelaan
653,Gerard le Grellelaan 10,2023-01-29,23:00:00,6,5,1,FMN 05 Gerard Le Grellelaan
653,Gerard le Grellelaan 10,2023-01-30,00:00:00,3,0,3,FMN 05 Gerard Le Grellelaan
653,Gerard le Grellelaan 10,2023-01-30,01:00:00,2,2,0,FMN 05 Gerard Le Grellelaan
653,Gerard le Grellelaan 10,2023-01-30,02:00:00,1,1,0,FMN 05 Gerard Le Grellelaan
653,Gerard le Grellelaan 10,2023-01-30,03:00:00,1,0,1,FMN 05 Gerard Le Grellelaan
653,Gerard le Grellelaan 10,2023-01-30,04:00:00,8,6,2,FMN 05 Gerard Le Grellelaan
653,Gerard le Grellelaan 10,2023-01-30,05:00:00,21,5,16,FMN 05 Gerard Le Grellelaan
653,Gerard le Grellelaan 10,2023-01-30,06:00:00,49,22,27,FMN 05 Gerard Le Grellelaan
653,Gerard le Grellelaan 10,2023-01-30,07:00:00,112,87,25,FMN 05 Gerard Le Grellelaan
653,Gerard le Grellelaan 10,2023-01-30,08:00:00,218,170,48,FMN 05 Gerard Le Grellelaan
653,Gerard le Grellelaan 10,2023-01-30,09:00:00,62,55,7,FMN 05 Gerard Le Grellelaan
653,Gerard le Grellelaan 10,2023-01-30,10:00:00,37,32,5,FMN 05 Gerard Le Grellelaan
653,Gerard le Grellelaan 10,2023-01-30,11:00:00,50,43,7,FMN 05 Gerard Le Grellelaan
653,Gerard le Grellelaan 10,2023-01-30,12:00:00,82,68,14,FMN 05 Gerard Le Grellelaan
653,Gerard le Grellelaan 10,2023-01-30,13:00:00,69,57,12,FMN 05 Gerard Le Grellelaan
653,Gerard le Grellelaan 10,2023-01-30,14:00:00,70,54,16,FMN 05 Gerard Le Grellelaan
653,Gerard le Grellelaan 10,2023-01-30,15:00:00,110,89,21,FMN 05 Gerard Le Grellelaan
653,Gerard le Grellelaan 10,2023-01-30,16:00:00,133,108,25,FMN 05 Gerard Le Grellelaan
653,Gerard le Grellelaan 10,2023-01-30,17:00:00,142,117,25,FMN 05 Gerard Le Grellelaan
653,Gerard le Grellelaan 10,2023-01-30,18:00:00,93,79,14,FMN 05 Gerard Le Grellelaan
653,Gerard le Grellelaan 10,2023-01-30,19:00:00,37,30,7,FMN 05 Gerard Le Grellelaan
653,Gerard le Grellelaan 10,2023-01-30,20:00:00,36,33,3,FMN 05 Gerard Le Grellelaan
653,Gerard le Grellelaan 10,2023-01-30,21:00:00,20,14,6,FMN 05 Gerard Le Grellelaan
653,Gerard le Grellelaan 10,2023-01-30,22:00:00,31,26,5,FMN 05 Gerard Le Grellelaan
653,Gerard le Grellelaan 10,2023-01-30,23:00:00,11,8,3,FMN 05 Gerard Le Grellelaan
653,Gerard le Grellelaan 10,2023-01-31,00:00:00,7,5,2,FMN 05 Gerard Le Grellelaan
653,Gerard le Grellelaan 10,2023-01-31,01:00:00,4,3,1,FMN 05 Gerard Le Grellelaan
653,Gerard le Grellelaan 10,2023-01-31,02:00:00,0,0,0,FMN 05 Gerard Le Grellelaan
653,Gerard le Grellelaan 10,2023-01-31,03:00:00,3,1,2,FMN 05 Gerard Le Grellelaan
653,Gerard le Grellelaan 10,2023-01-31,04:00:00,6,2,4,FMN 05 Gerard Le Grellelaan
653,Gerard le Grellelaan 10,2023-01-31,05:00:00,23,10,13,FMN 05 Gerard Le Grellelaan
653,Gerard le Grellelaan 10,2023-01-31,06:00:00,30,16,14,FMN 05 Gerard Le Grellelaan
653,Gerard le Grellelaan 10,2023-01-31,07:00:00,93,73,20,FMN 05 Gerard Le Grellelaan
653,Gerard le Grellelaan 10,2023-01-31,08:00:00,267,211,56,FMN 05 Gerard Le Grellelaan
653,Gerard le Grellelaan 10,2023-01-31,09:00:00,72,60,12,FMN 05 Gerard Le Grellelaan
653,Gerard le Grellelaan 10,2023-01-31,10:00:00,46,39,7,FMN 05 Gerard Le Grellelaan
653,Gerard le Grellelaan 10,2023-01-31,11:00:00,35,32,3,FMN 05 Gerard Le Grellelaan
653,Gerard le Grellelaan 10,2023-01-31,12:00:00,63,49,14,FMN 05 Gerard Le Grellelaan
653,Gerard le Grellelaan 10,2023-01-31,13:00:00,68,50,18,FMN 05 Gerard Le Grellelaan
653,Gerard le Grellelaan 10,2023-01-31,14:00:00,51,41,10,FMN 05 Gerard Le Grellelaan
653,Gerard le Grellelaan 10,2023-01-31,15:00:00,123,99,24,FMN 05 Gerard Le Grellelaan
653,Gerard le Grellelaan 10,2023-01-31,16:00:00,146,117,29,FMN 05 Gerard Le Grellelaan
653,Gerard le Grellelaan 10,2023-01-31,17:00:00,143,115,28,FMN 05 Gerard Le Grellelaan
653,Gerard le Grellelaan 10,2023-01-31,18:00:00,103,86,17,FMN 05 Gerard Le Grellelaan
653,Gerard le Grellelaan 10,2023-01-31,19:00:00,39,28,11,FMN 05 Gerard Le Grellelaan
653,Gerard le Grellelaan 10,2023-01-31,20:00:00,38,31,7,FMN 05 Gerard Le Grellelaan
653,Gerard le Grellelaan 10,2023-01-31,21:00:00,27,19,8,FMN 05 Gerard Le Grellelaan
653,Gerard le Grellelaan 10,2023-01-31,22:00:00,31,23,8,FMN 05 Gerard Le Grellelaan
653,Gerard le Grellelaan 10,2023-01-31,23:00:00,18,14,4,FMN 05 Gerard Le Grellelaan
653,Gerard le Grellelaan 10,2023-02-01,00:00:00,8,5,3,FMN 05 Gerard Le Grellelaan
653,Gerard le Grellelaan 10,2023-02-01,01:00:00,1,1,0,FMN 05 Gerard Le Grellelaan
653,Gerard le Grellelaan 10,2023-02-01,02:00:00,1,1,0,FMN 05 Gerard Le Grellelaan
653,Gerard le Grellelaan 10,2023-02-01,03:00:00,2,1,1,FMN 05 Gerard Le Grellelaan
653,Gerard le Grellelaan 10,2023-02-01,04:00:00,2,1,1,FMN 05 Gerard Le Grellelaan
653,Gerard le Grellelaan 10,2023-02-01,05:00:00,18,7,11,FMN 05 Gerard Le Grellelaan
653,Gerard le Grellelaan 10,2023-02-01,06:00:00,34,13,21,FMN 05 Gerard Le Grellelaan
653,Gerard le Grellelaan 10,2023-02-01,07:00:00,104,79,25,FMN 05 Gerard Le Grellelaan
653,Gerard le Grellelaan 10,2023-02-01,08:00:00,164,141,23,FMN 05 Gerard Le Grellelaan
653,Gerard le Grellelaan 10,2023-02-01,09:00:00,57,51,6,FMN 05 Gerard Le Grellelaan
653,Gerard le Grellelaan 10,2023-02-01,10:00:00,43,35,8,FMN 05 Gerard Le Grellelaan
653,Gerard le Grellelaan 10,2023-02-01,11:00:00,42,36,6,FMN 05 Gerard Le Grellelaan
653,Gerard le Grellelaan 10,2023-02-01,12:00:00,82,65,17,FMN 05 Gerard Le Grellelaan
653,Gerard le Grellelaan 10,2023-02-01,13:00:00,76,57,19,FMN 05 Gerard Le Grellelaan
653,Gerard le Grellelaan 10,2023-02-01,14:00:00,80,68,12,FMN 05 Gerard Le Grellelaan
653,Gerard le Grellelaan 10,2023-02-01,15:00:00,99,87,12,FMN 05 Gerard Le Grellelaan
653,Gerard le Grellelaan 10,2023-02-01,16:00:00,122,101,21,FMN 05 Gerard Le Grellelaan
653,Gerard le Grellelaan 10,2023-02-01,17:00:00,128,107,21,FMN 05 Gerard Le Grellelaan
653,Gerard le Grellelaan 10,2023-02-01,18:00:00,92,67,25,FMN 05 Gerard Le Grellelaan
653,Gerard le Grellelaan 10,2023-02-01,19:00:00,60,45,15,FMN 05 Gerard Le Grellelaan
653,Gerard le Grellelaan 10,2023-02-01,20:00:00,32,26,6,FMN 05 Gerard Le Grellelaan
653,Gerard le Grellelaan 10,2023-02-01,21:00:00,22,18,4,FMN 05 Gerard Le Grellelaan
653,Gerard le Grellelaan 10,2023-02-01,22:00:00,45,42,3,FMN 05 Gerard Le Grellelaan
653,Gerard le Grellelaan 10,2023-02-01,23:00:00,8,6,2,FMN 05 Gerard Le Grellelaan
653,Gerard le Grellelaan 10,2023-02-02,00:00:00,8,6,2,FMN 05 Gerard Le Grellelaan
653,Gerard le Grellelaan 10,2023-02-02,01:00:00,2,1,1,FMN 05 Gerard Le Grellelaan
653,Gerard le Grellelaan 10,2023-02-02,02:00:00,3,2,1,FMN 05 Gerard Le Grellelaan
653,Gerard le Grellelaan 10,2023-02-02,03:00:00,5,3,2,FMN 05 Gerard Le Grellelaan
653,Gerard le Grellelaan 10,2023-02-02,04:00:00,3,2,1,FMN 05 Gerard Le Grellelaan
653,Gerard le Grellelaan 10,2023-02-02,05:00:00,20,5,15,FMN 05 Gerard Le Grellelaan
653,Gerard le Grellelaan 10,2023-02-02,06:00:00,37,20,17,FMN 05 Gerard Le Grellelaan
653,Gerard le Grellelaan 10,2023-02-02,07:00:00,101,85,16,FMN 05 Gerard Le Grellelaan
653,Gerard le Grellelaan 10,2023-02-02,08:00:00,227,178,49,FMN 05 Gerard Le Grellelaan
653,Gerard le Grellelaan 10,2023-02-02,09:00:00,83,68,15,FMN 05 Gerard Le Grellelaan
653,Gerard le Grellelaan 10,2023-02-02,10:00:00,57,42,15,FMN 05 Gerard Le Grellelaan
653,Gerard le Grellelaan 10,2023-02-02,11:00:00,50,44,6,FMN 05 Gerard Le Grellelaan
653,Gerard le Grellelaan 10,2023-02-02,12:00:00,77,58,19,FMN 05 Gerard Le Grellelaan
653,Gerard le Grellelaan 10,2023-02-02,13:00:00,68,50,18,FMN 05 Gerard Le Grellelaan
653,Gerard le Grellelaan 10,2023-02-02,14:00:00,78,62,16,FMN 05 Gerard Le Grellelaan
653,Gerard le Grellelaan 10,2023-02-02,15:00:00,105,90,15,FMN 05 Gerard Le Grellelaan
653,Gerard le Grellelaan 10,2023-02-02,16:00:00,150,117,33,FMN 05 Gerard Le Grellelaan
653,Gerard le Grellelaan 10,2023-02-02,17:00:00,137,101,36,FMN 05 Gerard Le Grellelaan
653,Gerard le Grellelaan 10,2023-02-02,18:00:00,92,73,19,FMN 05 Gerard Le Grellelaan
653,Gerard le Grellelaan 10,2023-02-02,19:00:00,57,48,9,FMN 05 Gerard Le Grellelaan
653,Gerard le Grellelaan 10,2023-02-02,20:00:00,47,36,11,FMN 05 Gerard Le Grellelaan
653,Gerard le Grellelaan 10,2023-02-02,21:00:00,18,13,5,FMN 05 Gerard Le Grellelaan
653,Gerard le Grellelaan 10,2023-02-02,22:00:00,39,35,4,FMN 05 Gerard Le Grellelaan
653,Gerard le Grellelaan 10,2023-02-02,23:00:00,10,9,1,FMN 05 Gerard Le Grellelaan
653,Gerard le Grellelaan 10,2023-02-03,00:00:00,2,0,2,FMN 05 Gerard Le Grellelaan
653,Gerard le Grellelaan 10,2023-02-03,01:00:00,3,3,0,FMN 05 Gerard Le Grellelaan
653,Gerard le Grellelaan 10,2023-02-03,02:00:00,0,0,0,FMN 05 Gerard Le Grellelaan
653,Gerard le Grellelaan 10,2023-02-03,03:00:00,3,3,0,FMN 05 Gerard Le Grellelaan
653,Gerard le Grellelaan 10,2023-02-03,04:00:00,5,2,3,FMN 05 Gerard Le Grellelaan
653,Gerard le Grellelaan 10,2023-02-03,05:00:00,22,8,14,FMN 05 Gerard Le Grellelaan
653,Gerard le Grellelaan 10,2023-02-03,06:00:00,44,22,22,FMN 05 Gerard Le Grellelaan
653,Gerard le Grellelaan 10,2023-02-03,07:00:00,101,76,25,FMN 05 Gerard Le Grellelaan
653,Gerard le Grellelaan 10,2023-02-03,08:00:00,184,148,36,FMN 05 Gerard Le Grellelaan
653,Gerard le Grellelaan 10,2023-02-03,09:00:00,70,59,11,FMN 05 Gerard Le Grellelaan
653,Gerard le Grellelaan 10,2023-02-03,10:00:00,55,47,8,FMN 05 Gerard Le Grellelaan
653,Gerard le Grellelaan 10,2023-02-03,11:00:00,45,39,6,FMN 05 Gerard Le Grellelaan
653,Gerard le Grellelaan 10,2023-02-03,12:00:00,71,45,26,FMN 05 Gerard Le Grellelaan
653,Gerard le Grellelaan 10,2023-02-03,13:00:00,70,51,19,FMN 05 Gerard Le Grellelaan
653,Gerard le Grellelaan 10,2023-02-03,14:00:00,70,64,6,FMN 05 Gerard Le Grellelaan
653,Gerard le Grellelaan 10,2023-02-03,15:00:00,89,77,12,FMN 05 Gerard Le Grellelaan
653,Gerard le Grellelaan 10,2023-02-03,16:00:00,115,95,20,FMN 05 Gerard Le Grellelaan
653,Gerard le Grellelaan 10,2023-02-03,17:00:00,128,103,25,FMN 05 Gerard Le Grellelaan
653,Gerard le Grellelaan 10,2023-02-03,18:00:00,109,92,17,FMN 05 Gerard Le Grellelaan
653,Gerard le Grellelaan 10,2023-02-03,19:00:00,72,61,11,FMN 05 Gerard Le Grellelaan
653,Gerard le Grellelaan 10,2023-02-03,20:00:00,54,43,11,FMN 05 Gerard Le Grellelaan
653,Gerard le Grellelaan 10,2023-02-03,21:00:00,31,23,8,FMN 05 Gerard Le Grellelaan
653,Gerard le Grellelaan 10,2023-02-03,22:00:00,28,23,5,FMN 05 Gerard Le Grellelaan
653,Gerard le Grellelaan 10,2023-02-03,23:00:00,18,14,4,FMN 05 Gerard Le Grellelaan
653,Gerard le Grellelaan 10,2023-02-04,00:00:00,14,13,1,FMN 05 Gerard Le Grellelaan
653,Gerard le Grellelaan 10,2023-02-04,01:00:00,8,4,4,FMN 05 Gerard Le Grellelaan
653,Gerard le Grellelaan 10,2023-02-04,02:00:00,7,2,5,FMN 05 Gerard Le Grellelaan
653,Gerard le Grellelaan 10,2023-02-04,03:00:00,3,1,2,FMN 05 Gerard Le Grellelaan
653,Gerard le Grellelaan 10,2023-02-04,04:00:00,11,8,3,FMN 05 Gerard Le Grellelaan
653,Gerard le Grellelaan 10,2023-02-04,05:00:00,6,3,3,FMN 05 Gerard Le Grellelaan
653,Gerard le Grellelaan 10,2023-02-04,06:00:00,9,4,5,FMN 05 Gerard Le Grellelaan
653,Gerard le Grellelaan 10,2023-02-04,07:00:00,14,9,5,FMN 05 Gerard Le Grellelaan
653,Gerard le Grellelaan 10,2023-02-04,08:00:00,19,15,4,FMN 05 Gerard Le Grellelaan
653,Gerard le Grellelaan 10,2023-02-04,09:00:00,35,28,7,FMN 05 Gerard Le Grellelaan
653,Gerard le Grellelaan 10,2023-02-04,10:00:00,34,24,10,FMN 05 Gerard Le Grellelaan
653,Gerard le Grellelaan 10,2023-02-04,11:00:00,36,28,8,FMN 05 Gerard Le Grellelaan
653,Gerard le Grellelaan 10,2023-02-04,12:00:00,26,21,5,FMN 05 Gerard Le Grellelaan
653,Gerard le Grellelaan 10,2023-02-04,13:00:00,59,45,14,FMN 05 Gerard Le Grellelaan
653,Gerard le Grellelaan 10,2023-02-04,14:00:00,49,40,9,FMN 05 Gerard Le Grellelaan
653,Gerard le Grellelaan 10,2023-02-04,15:00:00,43,34,9,FMN 05 Gerard Le Grellelaan
653,Gerard le Grellelaan 10,2023-02-04,16:00:00,70,61,9,FMN 05 Gerard Le Grellelaan
653,Gerard le Grellelaan 10,2023-02-04,17:00:00,49,39,10,FMN 05 Gerard Le Grellelaan
653,Gerard le Grellelaan 10,2023-02-04,18:00:00,28,20,8,FMN 05 Gerard Le Grellelaan
653,Gerard le Grellelaan 10,2023-02-04,19:00:00,32,25,7,FMN 05 Gerard Le Grellelaan
653,Gerard le Grellelaan 10,2023-02-04,20:00:00,21,18,3,FMN 05 Gerard Le Grellelaan
653,Gerard le Grellelaan 10,2023-02-04,21:00:00,19,17,2,FMN 05 Gerard Le Grellelaan
653,Gerard le Grellelaan 10,2023-02-04,22:00:00,20,20,0,FMN 05 Gerard Le Grellelaan
653,Gerard le Grellelaan 10,2023-02-04,23:00:00,18,11,7,FMN 05 Gerard Le Grellelaan
653,Gerard le Grellelaan 10,2023-02-05,00:00:00,7,4,3,FMN 05 Gerard Le Grellelaan
653,Gerard le Grellelaan 10,2023-02-05,01:00:00,2,1,1,FMN 05 Gerard Le Grellelaan
653,Gerard le Grellelaan 10,2023-02-05,02:00:00,3,0,3,FMN 05 Gerard Le Grellelaan
653,Gerard le Grellelaan 10,2023-02-05,03:00:00,4,0,4,FMN 05 Gerard Le Grellelaan
653,Gerard le Grellelaan 10,2023-02-05,04:00:00,7,3,4,FMN 05 Gerard Le Grellelaan
653,Gerard le Grellelaan 10,2023-02-05,05:00:00,5,3,2,FMN 05 Gerard Le Grellelaan
653,Gerard le Grellelaan 10,2023-02-05,06:00:00,2,0,2,FMN 05 Gerard Le Grellelaan
653,Gerard le Grellelaan 10,2023-02-05,07:00:00,12,12,0,FMN 05 Gerard Le Grellelaan
653,Gerard le Grellelaan 10,2023-02-05,08:00:00,8,7,1,FMN 05 Gerard Le Grellelaan
653,Gerard le Grellelaan 10,2023-02-05,09:00:00,38,32,6,FMN 05 Gerard Le Grellelaan
653,Gerard le Grellelaan 10,2023-02-05,10:00:00,46,36,10,FMN 05 Gerard Le Grellelaan
653,Gerard le Grellelaan 10,2023-02-05,11:00:00,46,38,8,FMN 05 Gerard Le Grellelaan
653,Gerard le Grellelaan 10,2023-02-05,12:00:00,54,44,10,FMN 05 Gerard Le Grellelaan
653,Gerard le Grellelaan 10,2023-02-05,13:00:00,59,51,8,FMN 05 Gerard Le Grellelaan
653,Gerard le Grellelaan 10,2023-02-05,14:00:00,77,70,7,FMN 05 Gerard Le Grellelaan
653,Gerard le Grellelaan 10,2023-02-05,15:00:00,44,34,10,FMN 05 Gerard Le Grellelaan
653,Gerard le Grellelaan 10,2023-02-05,16:00:00,53,45,8,FMN 05 Gerard Le Grellelaan
653,Gerard le Grellelaan 10,2023-02-05,17:00:00,68,57,11,FMN 05 Gerard Le Grellelaan
653,Gerard le Grellelaan 10,2023-02-05,18:00:00,42,33,9,FMN 05 Gerard Le Grellelaan
653,Gerard le Grellelaan 10,2023-02-05,19:00:00,34,31,3,FMN 05 Gerard Le Grellelaan
653,Gerard le Grellelaan 10,2023-02-05,20:00:00,20,17,3,FMN 05 Gerard Le Grellelaan
653,Gerard le Grellelaan 10,2023-02-05,21:00:00,11,10,1,FMN 05 Gerard Le Grellelaan
653,Gerard le Grellelaan 10,2023-02-05,22:00:00,6,4,2,FMN 05 Gerard Le Grellelaan
653,Gerard le Grellelaan 10,2023-02-05,23:00:00,3,3,0,FMN 05 Gerard Le Grellelaan
653,Gerard le Grellelaan 10,2023-02-06,00:00:00,3,1,2,FMN 05 Gerard Le Grellelaan
653,Gerard le Grellelaan 10,2023-02-06,01:00:00,2,2,0,FMN 05 Gerard Le Grellelaan
653,Gerard le Grellelaan 10,2023-02-06,02:00:00,0,0,0,FMN 05 Gerard Le Grellelaan
653,Gerard le Grellelaan 10,2023-02-06,03:00:00,1,1,0,FMN 05 Gerard Le Grellelaan
653,Gerard le Grellelaan 10,2023-02-06,04:00:00,6,2,4,FMN 05 Gerard Le Grellelaan
653,Gerard le Grellelaan 10,2023-02-06,05:00:00,16,6,10,FMN 05 Gerard Le Grellelaan
653,Gerard le Grellelaan 10,2023-02-06,06:00:00,28,17,11,FMN 05 Gerard Le Grellelaan
653,Gerard le Grellelaan 10,2023-02-06,07:00:00,110,93,17,FMN 05 Gerard Le Grellelaan
653,Gerard le Grellelaan 10,2023-02-06,08:00:00,222,181,41,FMN 05 Gerard Le Grellelaan
653,Gerard le Grellelaan 10,2023-02-06,09:00:00,65,58,7,FMN 05 Gerard Le Grellelaan
653,Gerard le Grellelaan 10,2023-02-06,10:00:00,36,29,7,FMN 05 Gerard Le Grellelaan
653,Gerard le Grellelaan 10,2023-02-06,11:00:00,33,29,4,FMN 05 Gerard Le Grellelaan
653,Gerard le Grellelaan 10,2023-02-06,12:00:00,62,50,12,FMN 05 Gerard Le Grellelaan
653,Gerard le Grellelaan 10,2023-02-06,13:00:00,58,38,20,FMN 05 Gerard Le Grellelaan
653,Gerard le Grellelaan 10,2023-02-06,14:00:00,90,83,7,FMN 05 Gerard Le Grellelaan
653,Gerard le Grellelaan 10,2023-02-06,15:00:00,100,81,19,FMN 05 Gerard Le Grellelaan
653,Gerard le Grellelaan 10,2023-02-06,16:00:00,144,105,39,FMN 05 Gerard Le Grellelaan
653,Gerard le Grellelaan 10,2023-02-06,17:00:00,164,129,35,FMN 05 Gerard Le Grellelaan
653,Gerard le Grellelaan 10,2023-02-06,18:00:00,95,83,12,FMN 05 Gerard Le Grellelaan
653,Gerard le Grellelaan 10,2023-02-06,19:00:00,44,38,6,FMN 05 Gerard Le Grellelaan
653,Gerard le Grellelaan 10,2023-02-06,20:00:00,45,36,9,FMN 05 Gerard Le Grellelaan
653,Gerard le Grellelaan 10,2023-02-06,21:00:00,27,21,6,FMN 05 Gerard Le Grellelaan
653,Gerard le Grellelaan 10,2023-02-06,22:00:00,27,22,5,FMN 05 Gerard Le Grellelaan
653,Gerard le Grellelaan 10,2023-02-06,23:00:00,8,7,1,FMN 05 Gerard Le Grellelaan
653,Gerard le Grellelaan 10,2023-02-07,00:00:00,1,1,0,FMN 05 Gerard Le Grellelaan
653,Gerard le Grellelaan 10,2023-02-07,01:00:00,2,2,0,FMN 05 Gerard Le Grellelaan
653,Gerard le Grellelaan 10,2023-02-07,02:00:00,0,0,0,FMN 05 Gerard Le Grellelaan
653,Gerard le Grellelaan 10,2023-02-07,03:00:00,1,1,0,FMN 05 Gerard Le Grellelaan
653,Gerard le Grellelaan 10,2023-02-07,04:00:00,5,3,2,FMN 05 Gerard Le Grellelaan
653,Gerard le Grellelaan 10,2023-02-07,05:00:00,14,3,11,FMN 05 Gerard Le Grellelaan
653,Gerard le Grellelaan 10,2023-02-07,06:00:00,23,16,7,FMN 05 Gerard Le Grellelaan
653,Gerard le Grellelaan 10,2023-02-07,07:00:00,91,75,16,FMN 05 Gerard Le Grellelaan
653,Gerard le Grellelaan 10,2023-02-07,08:00:00,173,141,32,FMN 05 Gerard Le Grellelaan
653,Gerard le Grellelaan 10,2023-02-07,09:00:00,59,49,10,FMN 05 Gerard Le Grellelaan
653,Gerard le Grellelaan 10,2023-02-07,10:00:00,34,30,4,FMN 05 Gerard Le Grellelaan
653,Gerard le Grellelaan 10,2023-02-07,11:00:00,43,35,8,FMN 05 Gerard Le Grellelaan
653,Gerard le Grellelaan 10,2023-02-07,12:00:00,60,45,15,FMN 05 Gerard Le Grellelaan
653,Gerard le Grellelaan 10,2023-02-07,13:00:00,78,65,13,FMN 05 Gerard Le Grellelaan
653,Gerard le Grellelaan 10,2023-02-07,14:00:00,53,47,6,FMN 05 Gerard Le Grellelaan
653,Gerard le Grellelaan 10,2023-02-07,15:00:00,119,93,26,FMN 05 Gerard Le Grellelaan
653,Gerard le Grellelaan 10,2023-02-07,16:00:00,136,108,28,FMN 05 Gerard Le Grellelaan
653,Gerard le Grellelaan 10,2023-02-07,17:00:00,152,121,31,FMN 05 Gerard Le Grellelaan
653,Gerard le Grellelaan 10,2023-02-07,18:00:00,82,72,10,FMN 05 Gerard Le Grellelaan
653,Gerard le Grellelaan 10,2023-02-07,19:00:00,40,33,7,FMN 05 Gerard Le Grellelaan
653,Gerard le Grellelaan 10,2023-02-07,20:00:00,28,26,2,FMN 05 Gerard Le Grellelaan
653,Gerard le Grellelaan 10,2023-02-07,21:00:00,17,13,4,FMN 05 Gerard Le Grellelaan
653,Gerard le Grellelaan 10,2023-02-07,22:00:00,25,21,4,FMN 05 Gerard Le Grellelaan
653,Gerard le Grellelaan 10,2023-02-07,23:00:00,10,7,3,FMN 05 Gerard Le Grellelaan
653,Gerard le Grellelaan 10,2023-02-08,00:00:00,2,1,1,FMN 05 Gerard Le Grellelaan
653,Gerard le Grellelaan 10,2023-02-08,01:00:00,1,1,0,FMN 05 Gerard Le Grellelaan
653,Gerard le Grellelaan 10,2023-02-08,02:00:00,1,0,1,FMN 05 Gerard Le Grellelaan
653,Gerard le Grellelaan 10,2023-02-08,03:00:00,0,0,0,FMN 05 Gerard Le Grellelaan
653,Gerard le Grellelaan 10,2023-02-08,04:00:00,3,1,2,FMN 05 Gerard Le Grellelaan
653,Gerard le Grellelaan 10,2023-02-08,05:00:00,11,3,8,FMN 05 Gerard Le Grellelaan
653,Gerard le Grellelaan 10,2023-02-08,06:00:00,18,11,7,FMN 05 Gerard Le Grellelaan
653,Gerard le Grellelaan 10,2023-02-08,07:00:00,75,57,18,FMN 05 Gerard Le Grellelaan
653,Gerard le Grellelaan 10,2023-02-08,08:00:00,143,117,26,FMN 05 Gerard Le Grellelaan
653,Gerard le Grellelaan 10,2023-02-08,09:00:00,41,36,5,FMN 05 Gerard Le Grellelaan
653,Gerard le Grellelaan 10,2023-02-08,10:00:00,40,38,2,FMN 05 Gerard Le Grellelaan
653,Gerard le Grellelaan 10,2023-02-08,11:00:00,44,35,9,FMN 05 Gerard Le Grellelaan
653,Gerard le Grellelaan 10,2023-02-08,12:00:00,99,78,21,FMN 05 Gerard Le Grellelaan
653,Gerard le Grellelaan 10,2023-02-08,13:00:00,72,54,18,FMN 05 Gerard Le Grellelaan
653,Gerard le Grellelaan 10,2023-02-08,14:00:00,64,53,11,FMN 05 Gerard Le Grellelaan
653,Gerard le Grellelaan 10,2023-02-08,15:00:00,101,77,24,FMN 05 Gerard Le Grellelaan
653,Gerard le Grellelaan 10,2023-02-08,16:00:00,127,100,27,FMN 05 Gerard Le Grellelaan
653,Gerard le Grellelaan 10,2023-02-08,17:00:00,126,106,20,FMN 05 Gerard Le Grellelaan
653,Gerard le Grellelaan 10,2023-02-08,18:00:00,84,69,15,FMN 05 Gerard Le Grellelaan
653,Gerard le Grellelaan 10,2023-02-08,19:00:00,50,40,10,FMN 05 Gerard Le Grellelaan
653,Gerard le Grellelaan 10,2023-02-08,20:00:00,34,28,6,FMN 05 Gerard Le Grellelaan
653,Gerard le Grellelaan 10,2023-02-08,21:00:00,28,27,1,FMN 05 Gerard Le Grellelaan
653,Gerard le Grellelaan 10,2023-02-08,22:00:00,31,28,3,FMN 05 Gerard Le Grellelaan
653,Gerard le Grellelaan 10,2023-02-08,23:00:00,9,8,1,FMN 05 Gerard Le Grellelaan
653,Gerard le Grellelaan 10,2023-02-09,00:00:00,3,0,3,FMN 05 Gerard Le Grellelaan
653,Gerard le Grellelaan 10,2023-02-09,01:00:00,7,6,1,FMN 05 Gerard Le Grellelaan
653,Gerard le Grellelaan 10,2023-02-09,02:00:00,0,0,0,FMN 05 Gerard Le Grellelaan
653,Gerard le Grellelaan 10,2023-02-09,03:00:00,0,0,0,FMN 05 Gerard Le Grellelaan
653,Gerard le Grellelaan 10,2023-02-09,04:00:00,3,2,1,FMN 05 Gerard Le Grellelaan
653,Gerard le Grellelaan 10,2023-02-09,05:00:00,11,2,9,FMN 05 Gerard Le Grellelaan
653,Gerard le Grellelaan 10,2023-02-09,06:00:00,18,13,5,FMN 05 Gerard Le Grellelaan
653,Gerard le Grellelaan 10,2023-02-09,07:00:00,90,72,18,FMN 05 Gerard Le Grellelaan
653,Gerard le Grellelaan 10,2023-02-09,08:00:00,162,132,30,FMN 05 Gerard Le Grellelaan
653,Gerard le Grellelaan 10,2023-02-09,09:00:00,47,40,7,FMN 05 Gerard Le Grellelaan
653,Gerard le Grellelaan 10,2023-02-09,10:00:00,47,40,7,FMN 05 Gerard Le Grellelaan
653,Gerard le Grellelaan 10,2023-02-09,11:00:00,34,32,2,FMN 05 Gerard Le Grellelaan
653,Gerard le Grellelaan 10,2023-02-09,12:00:00,57,46,11,FMN 05 Gerard Le Grellelaan
653,Gerard le Grellelaan 10,2023-02-09,13:00:00,36,26,10,FMN 05 Gerard Le Grellelaan
653,Gerard le Grellelaan 10,2023-02-09,14:00:00,72,64,8,FMN 05 Gerard Le Grellelaan
653,Gerard le Grellelaan 10,2023-02-09,15:00:00,90,74,16,FMN 05 Gerard Le Grellelaan
653,Gerard le Grellelaan 10,2023-02-09,16:00:00,137,106,31,FMN 05 Gerard Le Grellelaan
653,Gerard le Grellelaan 10,2023-02-09,17:00:00,137,111,26,FMN 05 Gerard Le Grellelaan
653,Gerard le Grellelaan 10,2023-02-09,18:00:00,84,70,14,FMN 05 Gerard Le Grellelaan
653,Gerard le Grellelaan 10,2023-02-09,19:00:00,55,48,7,FMN 05 Gerard Le Grellelaan
653,Gerard le Grellelaan 10,2023-02-09,20:00:00,32,24,8,FMN 05 Gerard Le Grellelaan
653,Gerard le Grellelaan 10,2023-02-09,21:00:00,25,21,4,FMN 05 Gerard Le Grellelaan
653,Gerard le Grellelaan 10,2023-02-09,22:00:00,27,22,5,FMN 05 Gerard Le Grellelaan
653,Gerard le Grellelaan 10,2023-02-09,23:00:00,11,8,3,FMN 05 Gerard Le Grellelaan
653,Gerard le Grellelaan 10,2023-02-10,00:00:00,8,6,2,FMN 05 Gerard Le Grellelaan
653,Gerard le Grellelaan 10,2023-02-10,01:00:00,2,2,0,FMN 05 Gerard Le Grellelaan
653,Gerard le Grellelaan 10,2023-02-10,02:00:00,0,0,0,FMN 05 Gerard Le Grellelaan
653,Gerard le Grellelaan 10,2023-02-10,03:00:00,0,0,0,FMN 05 Gerard Le Grellelaan
653,Gerard le Grellelaan 10,2023-02-10,04:00:00,6,3,3,FMN 05 Gerard Le Grellelaan
653,Gerard le Grellelaan 10,2023-02-10,05:00:00,13,4,9,FMN 05 Gerard Le Grellelaan
653,Gerard le Grellelaan 10,2023-02-10,06:00:00,35,23,12,FMN 05 Gerard Le Grellelaan
653,Gerard le Grellelaan 10,2023-02-10,07:00:00,91,66,25,FMN 05 Gerard Le Grellelaan
653,Gerard le Grellelaan 10,2023-02-10,08:00:00,173,145,28,FMN 05 Gerard Le Grellelaan
653,Gerard le Grellelaan 10,2023-02-10,09:00:00,66,53,13,FMN 05 Gerard Le Grellelaan
653,Gerard le Grellelaan 10,2023-02-10,10:00:00,53,46,7,FMN 05 Gerard Le Grellelaan
653,Gerard le Grellelaan 10,2023-02-10,11:00:00,37,32,5,FMN 05 Gerard Le Grellelaan
653,Gerard le Grellelaan 10,2023-02-10,12:00:00,69,53,16,FMN 05 Gerard Le Grellelaan
653,Gerard le Grellelaan 10,2023-02-10,13:00:00,43,33,10,FMN 05 Gerard Le Grellelaan
653,Gerard le Grellelaan 10,2023-02-10,14:00:00,69,53,16,FMN 05 Gerard Le Grellelaan
653,Gerard le Grellelaan 10,2023-02-10,15:00:00,96,72,24,FMN 05 Gerard Le Grellelaan
653,Gerard le Grellelaan 10,2023-02-10,16:00:00,126,99,27,FMN 05 Gerard Le Grellelaan
653,Gerard le Grellelaan 10,2023-02-10,17:00:00,87,77,10,FMN 05 Gerard Le Grellelaan
653,Gerard le Grellelaan 10,2023-02-10,18:00:00,78,66,12,FMN 05 Gerard Le Grellelaan
653,Gerard le Grellelaan 10,2023-02-10,19:00:00,57,47,10,FMN 05 Gerard Le Grellelaan
653,Gerard le Grellelaan 10,2023-02-10,20:00:00,40,34,6,FMN 05 Gerard Le Grellelaan
653,Gerard le Grellelaan 10,2023-02-10,21:00:00,30,24,6,FMN 05 Gerard Le Grellelaan
653,Gerard le Grellelaan 10,2023-02-10,22:00:00,20,18,2,FMN 05 Gerard Le Grellelaan
653,Gerard le Grellelaan 10,2023-02-10,23:00:00,20,12,8,FMN 05 Gerard Le Grellelaan
653,Gerard le Grellelaan 10,2023-02-11,00:00:00,6,4,2,FMN 05 Gerard Le Grellelaan
653,Gerard le Grellelaan 10,2023-02-11,01:00:00,6,2,4,FMN 05 Gerard Le Grellelaan
653,Gerard le Grellelaan 10,2023-02-11,02:00:00,1,1,0,FMN 05 Gerard Le Grellelaan
653,Gerard le Grellelaan 10,2023-02-11,03:00:00,6,1,5,FMN 05 Gerard Le Grellelaan
653,Gerard le Grellelaan 10,2023-02-11,04:00:00,2,1,1,FMN 05 Gerard Le Grellelaan
653,Gerard le Grellelaan 10,2023-02-11,05:00:00,5,3,2,FMN 05 Gerard Le Grellelaan
653,Gerard le Grellelaan 10,2023-02-11,06:00:00,9,3,6,FMN 05 Gerard Le Grellelaan
653,Gerard le Grellelaan 10,2023-02-11,07:00:00,8,6,2,FMN 05 Gerard Le Grellelaan
653,Gerard le Grellelaan 10,2023-02-11,08:00:00,16,15,1,FMN 05 Gerard Le Grellelaan
653,Gerard le Grellelaan 10,2023-02-11,09:00:00,37,33,4,FMN 05 Gerard Le Grellelaan
653,Gerard le Grellelaan 10,2023-02-11,10:00:00,49,43,6,FMN 05 Gerard Le Grellelaan
653,Gerard le Grellelaan 10,2023-02-11,11:00:00,37,23,14,FMN 05 Gerard Le Grellelaan
653,Gerard le Grellelaan 10,2023-02-11,12:00:00,36,34,2,FMN 05 Gerard Le Grellelaan
653,Gerard le Grellelaan 10,2023-02-11,13:00:00,46,34,12,FMN 05 Gerard Le Grellelaan
653,Gerard le Grellelaan 10,2023-02-11,14:00:00,47,34,13,FMN 05 Gerard Le Grellelaan
653,Gerard le Grellelaan 10,2023-02-11,15:00:00,61,48,13,FMN 05 Gerard Le Grellelaan
653,Gerard le Grellelaan 10,2023-02-11,16:00:00,52,45,7,FMN 05 Gerard Le Grellelaan
653,Gerard le Grellelaan 10,2023-02-11,17:00:00,52,41,11,FMN 05 Gerard Le Grellelaan
653,Gerard le Grellelaan 10,2023-02-11,18:00:00,36,31,5,FMN 05 Gerard Le Grellelaan
653,Gerard le Grellelaan 10,2023-02-11,19:00:00,35,32,3,FMN 05 Gerard Le Grellelaan
653,Gerard le Grellelaan 10,2023-02-11,20:00:00,38,31,7,FMN 05 Gerard Le Grellelaan
653,Gerard le Grellelaan 10,2023-02-11,21:00:00,22,20,2,FMN 05 Gerard Le Grellelaan
653,Gerard le Grellelaan 10,2023-02-11,22:00:00,19,17,2,FMN 05 Gerard Le Grellelaan
653,Gerard le Grellelaan 10,2023-02-11,23:00:00,10,7,3,FMN 05 Gerard Le Grellelaan
653,Gerard le Grellelaan 10,2023-02-12,00:00:00,12,9,3,FMN 05 Gerard Le Grellelaan
653,Gerard le Grellelaan 10,2023-02-12,01:00:00,7,4,3,FMN 05 Gerard Le Grellelaan
653,Gerard le Grellelaan 10,2023-02-12,02:00:00,7,1,6,FMN 05 Gerard Le Grellelaan
653,Gerard le Grellelaan 10,2023-02-12,03:00:00,1,0,1,FMN 05 Gerard Le Grellelaan
653,Gerard le Grellelaan 10,2023-02-12,04:00:00,3,2,1,FMN 05 Gerard Le Grellelaan
653,Gerard le Grellelaan 10,2023-02-12,05:00:00,5,4,1,FMN 05 Gerard Le Grellelaan
653,Gerard le Grellelaan 10,2023-02-12,06:00:00,0,0,0,FMN 05 Gerard Le Grellelaan
653,Gerard le Grellelaan 10,2023-02-12,07:00:00,7,6,1,FMN 05 Gerard Le Grellelaan
653,Gerard le Grellelaan 10,2023-02-12,08:00:00,17,15,2,FMN 05 Gerard Le Grellelaan
653,Gerard le Grellelaan 10,2023-02-12,09:00:00,33,27,6,FMN 05 Gerard Le Grellelaan
653,Gerard le Grellelaan 10,2023-02-12,10:00:00,60,47,13,FMN 05 Gerard Le Grellelaan
653,Gerard le Grellelaan 10,2023-02-12,11:00:00,50,39,11,FMN 05 Gerard Le Grellelaan
653,Gerard le Grellelaan 10,2023-02-12,12:00:00,50,41,9,FMN 05 Gerard Le Grellelaan
653,Gerard le Grellelaan 10,2023-02-12,13:00:00,50,40,10,FMN 05 Gerard Le Grellelaan
653,Gerard le Grellelaan 10,2023-02-12,14:00:00,51,44,7,FMN 05 Gerard Le Grellelaan
653,Gerard le Grellelaan 10,2023-02-12,15:00:00,53,47,6,FMN 05 Gerard Le Grellelaan
653,Gerard le Grellelaan 10,2023-02-12,16:00:00,59,47,12,FMN 05 Gerard Le Grellelaan
653,Gerard le Grellelaan 10,2023-02-12,17:00:00,72,61,11,FMN 05 Gerard Le Grellelaan
653,Gerard le Grellelaan 10,2023-02-12,18:00:00,35,25,10,FMN 05 Gerard Le Grellelaan
653,Gerard le Grellelaan 10,2023-02-12,19:00:00,24,22,2,FMN 05 Gerard Le Grellelaan
653,Gerard le Grellelaan 10,2023-02-12,20:00:00,17,13,4,FMN 05 Gerard Le Grellelaan
653,Gerard le Grellelaan 10,2023-02-12,21:00:00,24,20,4,FMN 05 Gerard Le Grellelaan
653,Gerard le Grellelaan 10,2023-02-12,22:00:00,14,13,1,FMN 05 Gerard Le Grellelaan
653,Gerard le Grellelaan 10,2023-02-12,23:00:00,7,6,1,FMN 05 Gerard Le Grellelaan
653,Gerard le Grellelaan 10,2023-02-13,00:00:00,3,3,0,FMN 05 Gerard Le Grellelaan
653,Gerard le Grellelaan 10,2023-02-13,01:00:00,3,2,1,FMN 05 Gerard Le Grellelaan
653,Gerard le Grellelaan 10,2023-02-13,02:00:00,1,1,0,FMN 05 Gerard Le Grellelaan
653,Gerard le Grellelaan 10,2023-02-13,03:00:00,4,3,1,FMN 05 Gerard Le Grellelaan
653,Gerard le Grellelaan 10,2023-02-13,04:00:00,4,1,3,FMN 05 Gerard Le Grellelaan
653,Gerard le Grellelaan 10,2023-02-13,05:00:00,25,11,14,FMN 05 Gerard Le Grellelaan
653,Gerard le Grellelaan 10,2023-02-13,06:00:00,34,23,11,FMN 05 Gerard Le Grellelaan
653,Gerard le Grellelaan 10,2023-02-13,07:00:00,100,78,22,FMN 05 Gerard Le Grellelaan
653,Gerard le Grellelaan 10,2023-02-13,08:00:00,216,180,36,FMN 05 Gerard Le Grellelaan
653,Gerard le Grellelaan 10,2023-02-13,09:00:00,70,63,7,FMN 05 Gerard Le Grellelaan
653,Gerard le Grellelaan 10,2023-02-13,10:00:00,61,56,5,FMN 05 Gerard Le Grellelaan
653,Gerard le Grellelaan 10,2023-02-13,11:00:00,48,42,6,FMN 05 Gerard Le Grellelaan
653,Gerard le Grellelaan 10,2023-02-13,12:00:00,85,74,11,FMN 05 Gerard Le Grellelaan
653,Gerard le Grellelaan 10,2023-02-13,13:00:00,85,76,9,FMN 05 Gerard Le Grellelaan
653,Gerard le Grellelaan 10,2023-02-13,14:00:00,81,72,9,FMN 05 Gerard Le Grellelaan
653,Gerard le Grellelaan 10,2023-02-13,15:00:00,130,108,22,FMN 05 Gerard Le Grellelaan
653,Gerard le Grellelaan 10,2023-02-13,16:00:00,176,142,34,FMN 05 Gerard Le Grellelaan
653,Gerard le Grellelaan 10,2023-02-13,17:00:00,197,161,36,FMN 05 Gerard Le Grellelaan
653,Gerard le Grellelaan 10,2023-02-13,18:00:00,119,104,15,FMN 05 Gerard Le Grellelaan
653,Gerard le Grellelaan 10,2023-02-13,19:00:00,65,53,12,FMN 05 Gerard Le Grellelaan
653,Gerard le Grellelaan 10,2023-02-13,20:00:00,33,23,10,FMN 05 Gerard Le Grellelaan
653,Gerard le Grellelaan 10,2023-02-13,21:00:00,26,18,8,FMN 05 Gerard Le Grellelaan
653,Gerard le Grellelaan 10,2023-02-13,22:00:00,29,28,1,FMN 05 Gerard Le Grellelaan
653,Gerard le Grellelaan 10,2023-02-13,23:00:00,8,7,1,FMN 05 Gerard Le Grellelaan
653,Gerard le Grellelaan 10,2023-02-14,00:00:00,4,2,2,FMN 05 Gerard Le Grellelaan
653,Gerard le Grellelaan 10,2023-02-14,01:00:00,1,0,1,FMN 05 Gerard Le Grellelaan
653,Gerard le Grellelaan 10,2023-02-14,02:00:00,0,0,0,FMN 05 Gerard Le Grellelaan
653,Gerard le Grellelaan 10,2023-02-14,03:00:00,2,2,0,FMN 05 Gerard Le Grellelaan
653,Gerard le Grellelaan 10,2023-02-14,04:00:00,8,4,4,FMN 05 Gerard Le Grellelaan
653,Gerard le Grellelaan 10,2023-02-14,05:00:00,21,9,12,FMN 05 Gerard Le Grellelaan
653,Gerard le Grellelaan 10,2023-02-14,06:00:00,42,24,18,FMN 05 Gerard Le Grellelaan
653,Gerard le Grellelaan 10,2023-02-14,07:00:00,97,79,18,FMN 05 Gerard Le Grellelaan
653,Gerard le Grellelaan 10,2023-02-14,08:00:00,201,161,40,FMN 05 Gerard Le Grellelaan
653,Gerard le Grellelaan 10,2023-02-14,09:00:00,75,68,7,FMN 05 Gerard Le Grellelaan
653,Gerard le Grellelaan 10,2023-02-14,10:00:00,62,51,11,FMN 05 Gerard Le Grellelaan
653,Gerard le Grellelaan 10,2023-02-14,11:00:00,69,56,13,FMN 05 Gerard Le Grellelaan
653,Gerard le Grellelaan 10,2023-02-14,12:00:00,92,76,16,FMN 05 Gerard Le Grellelaan
653,Gerard le Grellelaan 10,2023-02-14,13:00:00,100,83,17,FMN 05 Gerard Le Grellelaan
653,Gerard le Grellelaan 10,2023-02-14,14:00:00,84,69,15,FMN 05 Gerard Le Grellelaan
653,Gerard le Grellelaan 10,2023-02-14,15:00:00,152,121,31,FMN 05 Gerard Le Grellelaan
653,Gerard le Grellelaan 10,2023-02-14,16:00:00,209,168,41,FMN 05 Gerard Le Grellelaan
653,Gerard le Grellelaan 10,2023-02-14,17:00:00,233,193,40,FMN 05 Gerard Le Grellelaan
653,Gerard le Grellelaan 10,2023-02-14,18:00:00,137,111,26,FMN 05 Gerard Le Grellelaan
653,Gerard le Grellelaan 10,2023-02-14,19:00:00,63,49,14,FMN 05 Gerard Le Grellelaan
653,Gerard le Grellelaan 10,2023-02-14,20:00:00,39,31,8,FMN 05 Gerard Le Grellelaan
653,Gerard le Grellelaan 10,2023-02-14,21:00:00,33,21,12,FMN 05 Gerard Le Grellelaan
653,Gerard le Grellelaan 10,2023-02-14,22:00:00,30,26,4,FMN 05 Gerard Le Grellelaan
653,Gerard le Grellelaan 10,2023-02-14,23:00:00,16,12,4,FMN 05 Gerard Le Grellelaan
653,Gerard le Grellelaan 10,2023-02-15,00:00:00,7,4,3,FMN 05 Gerard Le Grellelaan
653,Gerard le Grellelaan 10,2023-02-15,01:00:00,3,3,0,FMN 05 Gerard Le Grellelaan
653,Gerard le Grellelaan 10,2023-02-15,02:00:00,0,0,0,FMN 05 Gerard Le Grellelaan
653,Gerard le Grellelaan 10,2023-02-15,03:00:00,3,2,1,FMN 05 Gerard Le Grellelaan
653,Gerard le Grellelaan 10,2023-02-15,04:00:00,5,4,1,FMN 05 Gerard Le Grellelaan
653,Gerard le Grellelaan 10,2023-02-15,05:00:00,18,8,10,FMN 05 Gerard Le Grellelaan
653,Gerard le Grellelaan 10,2023-02-15,06:00:00,31,17,14,FMN 05 Gerard Le Grellelaan
653,Gerard le Grellelaan 10,2023-02-15,07:00:00,104,74,30,FMN 05 Gerard Le Grellelaan
653,Gerard le Grellelaan 10,2023-02-15,08:00:00,206,171,35,FMN 05 Gerard Le Grellelaan
653,Gerard le Grellelaan 10,2023-02-15,09:00:00,64,57,7,FMN 05 Gerard Le Grellelaan
653,Gerard le Grellelaan 10,2023-02-15,10:00:00,61,50,11,FMN 05 Gerard Le Grellelaan
653,Gerard le Grellelaan 10,2023-02-15,11:00:00,59,49,10,FMN 05 Gerard Le Grellelaan
653,Gerard le Grellelaan 10,2023-02-15,12:00:00,132,97,35,FMN 05 Gerard Le Grellelaan
653,Gerard le Grellelaan 10,2023-02-15,13:00:00,104,84,20,FMN 05 Gerard Le Grellelaan
653,Gerard le Grellelaan 10,2023-02-15,14:00:00,88,72,16,FMN 05 Gerard Le Grellelaan
653,Gerard le Grellelaan 10,2023-02-15,15:00:00,121,101,20,FMN 05 Gerard Le Grellelaan
653,Gerard le Grellelaan 10,2023-02-15,16:00:00,150,119,31,FMN 05 Gerard Le Grellelaan
653,Gerard le Grellelaan 10,2023-02-15,17:00:00,172,137,35,FMN 05 Gerard Le Grellelaan
653,Gerard le Grellelaan 10,2023-02-15,18:00:00,107,89,18,FMN 05 Gerard Le Grellelaan
653,Gerard le Grellelaan 10,2023-02-15,19:00:00,67,57,10,FMN 05 Gerard Le Grellelaan
653,Gerard le Grellelaan 10,2023-02-15,20:00:00,44,35,9,FMN 05 Gerard Le Grellelaan
653,Gerard le Grellelaan 10,2023-02-15,21:00:00,27,21,6,FMN 05 Gerard Le Grellelaan
653,Gerard le Grellelaan 10,2023-02-15,22:00:00,47,43,4,FMN 05 Gerard Le Grellelaan
653,Gerard le Grellelaan 10,2023-02-15,23:00:00,10,6,4,FMN 05 Gerard Le Grellelaan
653,Gerard le Grellelaan 10,2023-02-16,00:00:00,5,2,3,FMN 05 Gerard Le Grellelaan
653,Gerard le Grellelaan 10,2023-02-16,01:00:00,2,2,0,FMN 05 Gerard Le Grellelaan
653,Gerard le Grellelaan 10,2023-02-16,02:00:00,0,0,0,FMN 05 Gerard Le Grellelaan
653,Gerard le Grellelaan 10,2023-02-16,03:00:00,3,1,2,FMN 05 Gerard Le Grellelaan
653,Gerard le Grellelaan 10,2023-02-16,04:00:00,8,5,3,FMN 05 Gerard Le Grellelaan
653,Gerard le Grellelaan 10,2023-02-16,05:00:00,21,8,13,FMN 05 Gerard Le Grellelaan
653,Gerard le Grellelaan 10,2023-02-16,06:00:00,35,20,15,FMN 05 Gerard Le Grellelaan
653,Gerard le Grellelaan 10,2023-02-16,07:00:00,113,86,27,FMN 05 Gerard Le Grellelaan
653,Gerard le Grellelaan 10,2023-02-16,08:00:00,229,183,46,FMN 05 Gerard Le Grellelaan
653,Gerard le Grellelaan 10,2023-02-16,09:00:00,72,68,4,FMN 05 Gerard Le Grellelaan
653,Gerard le Grellelaan 10,2023-02-16,10:00:00,50,46,4,FMN 05 Gerard Le Grellelaan
653,Gerard le Grellelaan 10,2023-02-16,11:00:00,42,35,7,FMN 05 Gerard Le Grellelaan
653,Gerard le Grellelaan 10,2023-02-16,12:00:00,64,52,12,FMN 05 Gerard Le Grellelaan
653,Gerard le Grellelaan 10,2023-02-16,13:00:00,71,57,14,FMN 05 Gerard Le Grellelaan
653,Gerard le Grellelaan 10,2023-02-16,14:00:00,72,60,12,FMN 05 Gerard Le Grellelaan
653,Gerard le Grellelaan 10,2023-02-16,15:00:00,132,97,35,FMN 05 Gerard Le Grellelaan
653,Gerard le Grellelaan 10,2023-02-16,16:00:00,160,123,37,FMN 05 Gerard Le Grellelaan
653,Gerard le Grellelaan 10,2023-02-16,17:00:00,145,124,21,FMN 05 Gerard Le Grellelaan
653,Gerard le Grellelaan 10,2023-02-16,18:00:00,106,85,21,FMN 05 Gerard Le Grellelaan
653,Gerard le Grellelaan 10,2023-02-16,19:00:00,58,46,12,FMN 05 Gerard Le Grellelaan
653,Gerard le Grellelaan 10,2023-02-16,20:00:00,38,31,7,FMN 05 Gerard Le Grellelaan
653,Gerard le Grellelaan 10,2023-02-16,21:00:00,28,19,9,FMN 05 Gerard Le Grellelaan
653,Gerard le Grellelaan 10,2023-02-16,22:00:00,26,24,2,FMN 05 Gerard Le Grellelaan
653,Gerard le Grellelaan 10,2023-02-16,23:00:00,17,17,0,FMN 05 Gerard Le Grellelaan
653,Gerard le Grellelaan 10,2023-02-17,00:00:00,3,1,2,FMN 05 Gerard Le Grellelaan
653,Gerard le Grellelaan 10,2023-02-17,01:00:00,6,4,2,FMN 05 Gerard Le Grellelaan
653,Gerard le Grellelaan 10,2023-02-17,02:00:00,2,1,1,FMN 05 Gerard Le Grellelaan
653,Gerard le Grellelaan 10,2023-02-17,03:00:00,3,3,0,FMN 05 Gerard Le Grellelaan
653,Gerard le Grellelaan 10,2023-02-17,04:00:00,12,9,3,FMN 05 Gerard Le Grellelaan
653,Gerard le Grellelaan 10,2023-02-17,05:00:00,25,8,17,FMN 05 Gerard Le Grellelaan
653,Gerard le Grellelaan 10,2023-02-17,06:00:00,44,26,18,FMN 05 Gerard Le Grellelaan
653,Gerard le Grellelaan 10,2023-02-17,07:00:00,104,79,25,FMN 05 Gerard Le Grellelaan
653,Gerard le Grellelaan 10,2023-02-17,08:00:00,247,199,48,FMN 05 Gerard Le Grellelaan
653,Gerard le Grellelaan 10,2023-02-17,09:00:00,69,61,8,FMN 05 Gerard Le Grellelaan
653,Gerard le Grellelaan 10,2023-02-17,10:00:00,50,43,7,FMN 05 Gerard Le Grellelaan
653,Gerard le Grellelaan 10,2023-02-17,11:00:00,58,48,10,FMN 05 Gerard Le Grellelaan
653,Gerard le Grellelaan 10,2023-02-17,12:00:00,67,57,10,FMN 05 Gerard Le Grellelaan
653,Gerard le Grellelaan 10,2023-02-17,13:00:00,88,70,18,FMN 05 Gerard Le Grellelaan
653,Gerard le Grellelaan 10,2023-02-17,14:00:00,77,66,11,FMN 05 Gerard Le Grellelaan
653,Gerard le Grellelaan 10,2023-02-17,15:00:00,126,95,31,FMN 05 Gerard Le Grellelaan
653,Gerard le Grellelaan 10,2023-02-17,16:00:00,152,121,31,FMN 05 Gerard Le Grellelaan
653,Gerard le Grellelaan 10,2023-02-17,17:00:00,149,123,26,FMN 05 Gerard Le Grellelaan
653,Gerard le Grellelaan 10,2023-02-17,18:00:00,111,92,19,FMN 05 Gerard Le Grellelaan
653,Gerard le Grellelaan 10,2023-02-17,19:00:00,50,40,10,FMN 05 Gerard Le Grellelaan
653,Gerard le Grellelaan 10,2023-02-17,20:00:00,31,27,4,FMN 05 Gerard Le Grellelaan
653,Gerard le Grellelaan 10,2023-02-17,21:00:00,33,26,7,FMN 05 Gerard Le Grellelaan
653,Gerard le Grellelaan 10,2023-02-17,22:00:00,24,20,4,FMN 05 Gerard Le Grellelaan
653,Gerard le Grellelaan 10,2023-02-17,23:00:00,20,16,4,FMN 05 Gerard Le Grellelaan
653,Gerard le Grellelaan 10,2023-02-18,00:00:00,16,11,5,FMN 05 Gerard Le Grellelaan
653,Gerard le Grellelaan 10,2023-02-18,01:00:00,6,4,2,FMN 05 Gerard Le Grellelaan
653,Gerard le Grellelaan 10,2023-02-18,02:00:00,8,7,1,FMN 05 Gerard Le Grellelaan
653,Gerard le Grellelaan 10,2023-02-18,03:00:00,3,2,1,FMN 05 Gerard Le Grellelaan
653,Gerard le Grellelaan 10,2023-02-18,04:00:00,5,2,3,FMN 05 Gerard Le Grellelaan
653,Gerard le Grellelaan 10,2023-02-18,05:00:00,4,3,1,FMN 05 Gerard Le Grellelaan
653,Gerard le Grellelaan 10,2023-02-18,06:00:00,10,7,3,FMN 05 Gerard Le Grellelaan
653,Gerard le Grellelaan 10,2023-02-18,07:00:00,8,5,3,FMN 05 Gerard Le Grellelaan
653,Gerard le Grellelaan 10,2023-02-18,08:00:00,21,19,2,FMN 05 Gerard Le Grellelaan
653,Gerard le Grellelaan 10,2023-02-18,09:00:00,44,32,12,FMN 05 Gerard Le Grellelaan
653,Gerard le Grellelaan 10,2023-02-18,10:00:00,51,41,10,FMN 05 Gerard Le Grellelaan
653,Gerard le Grellelaan 10,2023-02-18,11:00:00,41,36,5,FMN 05 Gerard Le Grellelaan
653,Gerard le Grellelaan 10,2023-02-18,12:00:00,45,35,10,FMN 05 Gerard Le Grellelaan
653,Gerard le Grellelaan 10,2023-02-18,13:00:00,54,43,11,FMN 05 Gerard Le Grellelaan
653,Gerard le Grellelaan 10,2023-02-18,14:00:00,62,53,9,FMN 05 Gerard Le Grellelaan
653,Gerard le Grellelaan 10,2023-02-18,15:00:00,53,45,8,FMN 05 Gerard Le Grellelaan
653,Gerard le Grellelaan 10,2023-02-18,16:00:00,50,42,8,FMN 05 Gerard Le Grellelaan
653,Gerard le Grellelaan 10,2023-02-18,17:00:00,43,34,9,FMN 05 Gerard Le Grellelaan
653,Gerard le Grellelaan 10,2023-02-18,18:00:00,45,38,7,FMN 05 Gerard Le Grellelaan
653,Gerard le Grellelaan 10,2023-02-18,19:00:00,52,39,13,FMN 05 Gerard Le Grellelaan
653,Gerard le Grellelaan 10,2023-02-18,20:00:00,15,10,5,FMN 05 Gerard Le Grellelaan
653,Gerard le Grellelaan 10,2023-02-18,21:00:00,9,8,1,FMN 05 Gerard Le Grellelaan
653,Gerard le Grellelaan 10,2023-02-18,22:00:00,15,12,3,FMN 05 Gerard Le Grellelaan
653,Gerard le Grellelaan 10,2023-02-18,23:00:00,14,12,2,FMN 05 Gerard Le Grellelaan
653,Gerard le Grellelaan 10,2023-02-19,00:00:00,5,5,0,FMN 05 Gerard Le Grellelaan
653,Gerard le Grellelaan 10,2023-02-19,01:00:00,6,2,4,FMN 05 Gerard Le Grellelaan
653,Gerard le Grellelaan 10,2023-02-19,02:00:00,4,3,1,FMN 05 Gerard Le Grellelaan
653,Gerard le Grellelaan 10,2023-02-19,03:00:00,7,7,0,FMN 05 Gerard Le Grellelaan
653,Gerard le Grellelaan 10,2023-02-19,04:00:00,7,2,5,FMN 05 Gerard Le Grellelaan
653,Gerard le Grellelaan 10,2023-02-19,05:00:00,2,1,1,FMN 05 Gerard Le Grellelaan
653,Gerard le Grellelaan 10,2023-02-19,06:00:00,5,3,2,FMN 05 Gerard Le Grellelaan
653,Gerard le Grellelaan 10,2023-02-19,07:00:00,3,2,1,FMN 05 Gerard Le Grellelaan
653,Gerard le Grellelaan 10,2023-02-19,08:00:00,19,16,3,FMN 05 Gerard Le Grellelaan
653,Gerard le Grellelaan 10,2023-02-19,09:00:00,37,30,7,FMN 05 Gerard Le Grellelaan
653,Gerard le Grellelaan 10,2023-02-19,10:00:00,77,60,17,FMN 05 Gerard Le Grellelaan
653,Gerard le Grellelaan 10,2023-02-19,11:00:00,54,42,12,FMN 05 Gerard Le Grellelaan
653,Gerard le Grellelaan 10,2023-02-19,12:00:00,66,55,11,FMN 05 Gerard Le Grellelaan
653,Gerard le Grellelaan 10,2023-02-19,13:00:00,68,54,14,FMN 05 Gerard Le Grellelaan
653,Gerard le Grellelaan 10,2023-02-19,14:00:00,64,47,17,FMN 05 Gerard Le Grellelaan
653,Gerard le Grellelaan 10,2023-02-19,15:00:00,53,49,4,FMN 05 Gerard Le Grellelaan
653,Gerard le Grellelaan 10,2023-02-19,16:00:00,56,49,7,FMN 05 Gerard Le Grellelaan
653,Gerard le Grellelaan 10,2023-02-19,17:00:00,37,30,7,FMN 05 Gerard Le Grellelaan
653,Gerard le Grellelaan 10,2023-02-19,18:00:00,35,31,4,FMN 05 Gerard Le Grellelaan
653,Gerard le Grellelaan 10,2023-02-19,19:00:00,21,18,3,FMN 05 Gerard Le Grellelaan
653,Gerard le Grellelaan 10,2023-02-19,20:00:00,18,13,5,FMN 05 Gerard Le Grellelaan
653,Gerard le Grellelaan 10,2023-02-19,21:00:00,15,10,5,FMN 05 Gerard Le Grellelaan
653,Gerard le Grellelaan 10,2023-02-19,22:00:00,10,7,3,FMN 05 Gerard Le Grellelaan
653,Gerard le Grellelaan 10,2023-02-19,23:00:00,5,3,2,FMN 05 Gerard Le Grellelaan
653,Gerard le Grellelaan 10,2023-02-20,00:00:00,3,1,2,FMN 05 Gerard Le Grellelaan
653,Gerard le Grellelaan 10,2023-02-20,01:00:00,1,1,0,FMN 05 Gerard Le Grellelaan
653,Gerard le Grellelaan 10,2023-02-20,02:00:00,0,0,0,FMN 05 Gerard Le Grellelaan
653,Gerard le Grellelaan 10,2023-02-20,03:00:00,4,2,2,FMN 05 Gerard Le Grellelaan
653,Gerard le Grellelaan 10,2023-02-20,04:00:00,6,1,5,FMN 05 Gerard Le Grellelaan
653,Gerard le Grellelaan 10,2023-02-20,05:00:00,22,6,16,FMN 05 Gerard Le Grellelaan
653,Gerard le Grellelaan 10,2023-02-20,06:00:00,37,22,15,FMN 05 Gerard Le Grellelaan
653,Gerard le Grellelaan 10,2023-02-20,07:00:00,69,46,23,FMN 05 Gerard Le Grellelaan
653,Gerard le Grellelaan 10,2023-02-20,08:00:00,125,109,16,FMN 05 Gerard Le Grellelaan
653,Gerard le Grellelaan 10,2023-02-20,09:00:00,59,50,9,FMN 05 Gerard Le Grellelaan
653,Gerard le Grellelaan 10,2023-02-20,10:00:00,56,49,7,FMN 05 Gerard Le Grellelaan
653,Gerard le Grellelaan 10,2023-02-20,11:00:00,27,24,3,FMN 05 Gerard Le Grellelaan
653,Gerard le Grellelaan 10,2023-02-20,12:00:00,59,48,11,FMN 05 Gerard Le Grellelaan
653,Gerard le Grellelaan 10,2023-02-20,13:00:00,54,43,11,FMN 05 Gerard Le Grellelaan
653,Gerard le Grellelaan 10,2023-02-20,14:00:00,73,63,10,FMN 05 Gerard Le Grellelaan
653,Gerard le Grellelaan 10,2023-02-20,15:00:00,79,67,12,FMN 05 Gerard Le Grellelaan
653,Gerard le Grellelaan 10,2023-02-20,16:00:00,106,90,16,FMN 05 Gerard Le Grellelaan
653,Gerard le Grellelaan 10,2023-02-20,17:00:00,139,114,25,FMN 05 Gerard Le Grellelaan
653,Gerard le Grellelaan 10,2023-02-20,18:00:00,98,74,24,FMN 05 Gerard Le Grellelaan
653,Gerard le Grellelaan 10,2023-02-20,19:00:00,53,44,9,FMN 05 Gerard Le Grellelaan
653,Gerard le Grellelaan 10,2023-02-20,20:00:00,38,30,8,FMN 05 Gerard Le Grellelaan
653,Gerard le Grellelaan 10,2023-02-20,21:00:00,20,15,5,FMN 05 Gerard Le Grellelaan
653,Gerard le Grellelaan 10,2023-02-20,22:00:00,24,16,8,FMN 05 Gerard Le Grellelaan
653,Gerard le Grellelaan 10,2023-02-20,23:00:00,12,10,2,FMN 05 Gerard Le Grellelaan
653,Gerard le Grellelaan 10,2023-02-21,00:00:00,2,0,2,FMN 05 Gerard Le Grellelaan
653,Gerard le Grellelaan 10,2023-02-21,01:00:00,1,1,0,FMN 05 Gerard Le Grellelaan
653,Gerard le Grellelaan 10,2023-02-21,02:00:00,2,1,1,FMN 05 Gerard Le Grellelaan
653,Gerard le Grellelaan 10,2023-02-21,03:00:00,2,2,0,FMN 05 Gerard Le Grellelaan
653,Gerard le Grellelaan 10,2023-02-21,04:00:00,6,2,4,FMN 05 Gerard Le Grellelaan
653,Gerard le Grellelaan 10,2023-02-21,05:00:00,20,5,15,FMN 05 Gerard Le Grellelaan
653,Gerard le Grellelaan 10,2023-02-21,06:00:00,42,19,23,FMN 05 Gerard Le Grellelaan
653,Gerard le Grellelaan 10,2023-02-21,07:00:00,112,77,35,FMN 05 Gerard Le Grellelaan
653,Gerard le Grellelaan 10,2023-02-21,08:00:00,154,122,32,FMN 05 Gerard Le Grellelaan
653,Gerard le Grellelaan 10,2023-02-21,09:00:00,68,58,10,FMN 05 Gerard Le Grellelaan
653,Gerard le Grellelaan 10,2023-02-21,10:00:00,42,34,8,FMN 05 Gerard Le Grellelaan
653,Gerard le Grellelaan 10,2023-02-21,11:00:00,51,41,10,FMN 05 Gerard Le Grellelaan
653,Gerard le Grellelaan 10,2023-02-21,12:00:00,61,48,13,FMN 05 Gerard Le Grellelaan
653,Gerard le Grellelaan 10,2023-02-21,13:00:00,73,62,11,FMN 05 Gerard Le Grellelaan
653,Gerard le Grellelaan 10,2023-02-21,14:00:00,64,56,8,FMN 05 Gerard Le Grellelaan
653,Gerard le Grellelaan 10,2023-02-21,15:00:00,80,69,11,FMN 05 Gerard Le Grellelaan
653,Gerard le Grellelaan 10,2023-02-21,16:00:00,130,108,22,FMN 05 Gerard Le Grellelaan
653,Gerard le Grellelaan 10,2023-02-21,17:00:00,154,124,30,FMN 05 Gerard Le Grellelaan
653,Gerard le Grellelaan 10,2023-02-21,18:00:00,101,87,14,FMN 05 Gerard Le Grellelaan
653,Gerard le Grellelaan 10,2023-02-21,19:00:00,46,33,13,FMN 05 Gerard Le Grellelaan
653,Gerard le Grellelaan 10,2023-02-21,20:00:00,32,24,8,FMN 05 Gerard Le Grellelaan
653,Gerard le Grellelaan 10,2023-02-21,21:00:00,20,16,4,FMN 05 Gerard Le Grellelaan
653,Gerard le Grellelaan 10,2023-02-21,22:00:00,50,43,7,FMN 05 Gerard Le Grellelaan
653,Gerard le Grellelaan 10,2023-02-21,23:00:00,20,16,4,FMN 05 Gerard Le Grellelaan
653,Gerard le Grellelaan 10,2023-02-22,00:00:00,8,6,2,FMN 05 Gerard Le Grellelaan
653,Gerard le Grellelaan 10,2023-02-22,01:00:00,1,1,0,FMN 05 Gerard Le Grellelaan
653,Gerard le Grellelaan 10,2023-02-22,02:00:00,1,1,0,FMN 05 Gerard Le Grellelaan
653,Gerard le Grellelaan 10,2023-02-22,03:00:00,2,1,1,FMN 05 Gerard Le Grellelaan
653,Gerard le Grellelaan 10,2023-02-22,04:00:00,5,1,4,FMN 05 Gerard Le Grellelaan
653,Gerard le Grellelaan 10,2023-02-22,05:00:00,21,7,14,FMN 05 Gerard Le Grellelaan
653,Gerard le Grellelaan 10,2023-02-22,06:00:00,32,13,19,FMN 05 Gerard Le Grellelaan
653,Gerard le Grellelaan 10,2023-02-22,07:00:00,80,59,21,FMN 05 Gerard Le Grellelaan
653,Gerard le Grellelaan 10,2023-02-22,08:00:00,118,104,14,FMN 05 Gerard Le Grellelaan
653,Gerard le Grellelaan 10,2023-02-22,09:00:00,59,50,9,FMN 05 Gerard Le Grellelaan
653,Gerard le Grellelaan 10,2023-02-22,10:00:00,62,52,10,FMN 05 Gerard Le Grellelaan
653,Gerard le Grellelaan 10,2023-02-22,11:00:00,41,31,10,FMN 05 Gerard Le Grellelaan
653,Gerard le Grellelaan 10,2023-02-22,12:00:00,64,53,11,FMN 05 Gerard Le Grellelaan
653,Gerard le Grellelaan 10,2023-02-22,13:00:00,74,60,14,FMN 05 Gerard Le Grellelaan
653,Gerard le Grellelaan 10,2023-02-22,14:00:00,71,61,10,FMN 05 Gerard Le Grellelaan
653,Gerard le Grellelaan 10,2023-02-22,15:00:00,71,62,9,FMN 05 Gerard Le Grellelaan
653,Gerard le Grellelaan 10,2023-02-22,16:00:00,117,97,20,FMN 05 Gerard Le Grellelaan
653,Gerard le Grellelaan 10,2023-02-22,17:00:00,138,113,25,FMN 05 Gerard Le Grellelaan
653,Gerard le Grellelaan 10,2023-02-22,18:00:00,104,88,16,FMN 05 Gerard Le Grellelaan
653,Gerard le Grellelaan 10,2023-02-22,19:00:00,56,37,19,FMN 05 Gerard Le Grellelaan
653,Gerard le Grellelaan 10,2023-02-22,20:00:00,40,34,6,FMN 05 Gerard Le Grellelaan
653,Gerard le Grellelaan 10,2023-02-22,21:00:00,16,11,5,FMN 05 Gerard Le Grellelaan
653,Gerard le Grellelaan 10,2023-02-22,22:00:00,29,25,4,FMN 05 Gerard Le Grellelaan
653,Gerard le Grellelaan 10,2023-02-22,23:00:00,9,6,3,FMN 05 Gerard Le Grellelaan
653,Gerard le Grellelaan 10,2023-02-23,00:00:00,4,2,2,FMN 05 Gerard Le Grellelaan
653,Gerard le Grellelaan 10,2023-02-23,01:00:00,3,2,1,FMN 05 Gerard Le Grellelaan
653,Gerard le Grellelaan 10,2023-02-23,02:00:00,1,1,0,FMN 05 Gerard Le Grellelaan
653,Gerard le Grellelaan 10,2023-02-23,03:00:00,3,1,2,FMN 05 Gerard Le Grellelaan
653,Gerard le Grellelaan 10,2023-02-23,04:00:00,4,2,2,FMN 05 Gerard Le Grellelaan
653,Gerard le Grellelaan 10,2023-02-23,05:00:00,28,9,19,FMN 05 Gerard Le Grellelaan
653,Gerard le Grellelaan 10,2023-02-23,06:00:00,46,22,24,FMN 05 Gerard Le Grellelaan
653,Gerard le Grellelaan 10,2023-02-23,07:00:00,88,57,31,FMN 05 Gerard Le Grellelaan
653,Gerard le Grellelaan 10,2023-02-23,08:00:00,143,119,24,FMN 05 Gerard Le Grellelaan
653,Gerard le Grellelaan 10,2023-02-23,09:00:00,78,69,9,FMN 05 Gerard Le Grellelaan
653,Gerard le Grellelaan 10,2023-02-23,10:00:00,54,51,3,FMN 05 Gerard Le Grellelaan
653,Gerard le Grellelaan 10,2023-02-23,11:00:00,35,30,5,FMN 05 Gerard Le Grellelaan
653,Gerard le Grellelaan 10,2023-02-23,12:00:00,73,59,14,FMN 05 Gerard Le Grellelaan
653,Gerard le Grellelaan 10,2023-02-23,13:00:00,71,56,15,FMN 05 Gerard Le Grellelaan
653,Gerard le Grellelaan 10,2023-02-23,14:00:00,55,47,8,FMN 05 Gerard Le Grellelaan
653,Gerard le Grellelaan 10,2023-02-23,15:00:00,98,84,14,FMN 05 Gerard Le Grellelaan
653,Gerard le Grellelaan 10,2023-02-23,16:00:00,131,101,30,FMN 05 Gerard Le Grellelaan
653,Gerard le Grellelaan 10,2023-02-23,17:00:00,135,114,21,FMN 05 Gerard Le Grellelaan
653,Gerard le Grellelaan 10,2023-02-23,18:00:00,91,75,16,FMN 05 Gerard Le Grellelaan
653,Gerard le Grellelaan 10,2023-02-23,19:00:00,59,46,13,FMN 05 Gerard Le Grellelaan
653,Gerard le Grellelaan 10,2023-02-23,20:00:00,35,31,4,FMN 05 Gerard Le Grellelaan
653,Gerard le Grellelaan 10,2023-02-23,21:00:00,32,22,10,FMN 05 Gerard Le Grellelaan
653,Gerard le Grellelaan 10,2023-02-23,22:00:00,32,28,4,FMN 05 Gerard Le Grellelaan
653,Gerard le Grellelaan 10,2023-02-23,23:00:00,14,13,1,FMN 05 Gerard Le Grellelaan
653,Gerard le Grellelaan 10,2023-02-24,00:00:00,4,2,2,FMN 05 Gerard Le Grellelaan
653,Gerard le Grellelaan 10,2023-02-24,01:00:00,6,4,2,FMN 05 Gerard Le Grellelaan
653,Gerard le Grellelaan 10,2023-02-24,02:00:00,2,1,1,FMN 05 Gerard Le Grellelaan
653,Gerard le Grellelaan 10,2023-02-24,03:00:00,1,0,1,FMN 05 Gerard Le Grellelaan
653,Gerard le Grellelaan 10,2023-02-24,04:00:00,3,1,2,FMN 05 Gerard Le Grellelaan
653,Gerard le Grellelaan 10,2023-02-24,05:00:00,16,5,11,FMN 05 Gerard Le Grellelaan
653,Gerard le Grellelaan 10,2023-02-24,06:00:00,27,14,13,FMN 05 Gerard Le Grellelaan
653,Gerard le Grellelaan 10,2023-02-24,07:00:00,54,41,13,FMN 05 Gerard Le Grellelaan
653,Gerard le Grellelaan 10,2023-02-24,08:00:00,93,74,19,FMN 05 Gerard Le Grellelaan
653,Gerard le Grellelaan 10,2023-02-24,09:00:00,50,44,6,FMN 05 Gerard Le Grellelaan
653,Gerard le Grellelaan 10,2023-02-24,10:00:00,46,39,7,FMN 05 Gerard Le Grellelaan
653,Gerard le Grellelaan 10,2023-02-24,11:00:00,38,30,8,FMN 05 Gerard Le Grellelaan
653,Gerard le Grellelaan 10,2023-02-24,12:00:00,83,66,17,FMN 05 Gerard Le Grellelaan
653,Gerard le Grellelaan 10,2023-02-24,13:00:00,56,48,8,FMN 05 Gerard Le Grellelaan
653,Gerard le Grellelaan 10,2023-02-24,14:00:00,49,44,5,FMN 05 Gerard Le Grellelaan
653,Gerard le Grellelaan 10,2023-02-24,15:00:00,81,71,10,FMN 05 Gerard Le Grellelaan
653,Gerard le Grellelaan 10,2023-02-24,16:00:00,86,76,10,FMN 05 Gerard Le Grellelaan
653,Gerard le Grellelaan 10,2023-02-24,17:00:00,106,89,17,FMN 05 Gerard Le Grellelaan
653,Gerard le Grellelaan 10,2023-02-24,18:00:00,75,58,17,FMN 05 Gerard Le Grellelaan
653,Gerard le Grellelaan 10,2023-02-24,19:00:00,49,38,11,FMN 05 Gerard Le Grellelaan
653,Gerard le Grellelaan 10,2023-02-24,20:00:00,34,28,6,FMN 05 Gerard Le Grellelaan
653,Gerard le Grellelaan 10,2023-02-24,21:00:00,25,21,4,FMN 05 Gerard Le Grellelaan
653,Gerard le Grellelaan 10,2023-02-24,22:00:00,16,12,4,FMN 05 Gerard Le Grellelaan
653,Gerard le Grellelaan 10,2023-02-24,23:00:00,7,7,0,FMN 05 Gerard Le Grellelaan
653,Gerard le Grellelaan 10,2023-02-25,00:00:00,8,4,4,FMN 05 Gerard Le Grellelaan
653,Gerard le Grellelaan 10,2023-02-25,01:00:00,11,8,3,FMN 05 Gerard Le Grellelaan
653,Gerard le Grellelaan 10,2023-02-25,02:00:00,2,1,1,FMN 05 Gerard Le Grellelaan
653,Gerard le Grellelaan 10,2023-02-25,03:00:00,7,7,0,FMN 05 Gerard Le Grellelaan
653,Gerard le Grellelaan 10,2023-02-25,04:00:00,9,5,4,FMN 05 Gerard Le Grellelaan
653,Gerard le Grellelaan 10,2023-02-25,05:00:00,3,2,1,FMN 05 Gerard Le Grellelaan
653,Gerard le Grellelaan 10,2023-02-25,06:00:00,5,3,2,FMN 05 Gerard Le Grellelaan
653,Gerard le Grellelaan 10,2023-02-25,07:00:00,10,8,2,FMN 05 Gerard Le Grellelaan
653,Gerard le Grellelaan 10,2023-02-25,08:00:00,19,16,3,FMN 05 Gerard Le Grellelaan
653,Gerard le Grellelaan 10,2023-02-25,09:00:00,36,30,6,FMN 05 Gerard Le Grellelaan
653,Gerard le Grellelaan 10,2023-02-25,10:00:00,47,32,15,FMN 05 Gerard Le Grellelaan
653,Gerard le Grellelaan 10,2023-02-25,11:00:00,57,47,10,FMN 05 Gerard Le Grellelaan
653,Gerard le Grellelaan 10,2023-02-25,12:00:00,63,49,14,FMN 05 Gerard Le Grellelaan
653,Gerard le Grellelaan 10,2023-02-25,13:00:00,53,41,12,FMN 05 Gerard Le Grellelaan
653,Gerard le Grellelaan 10,2023-02-25,14:00:00,59,50,9,FMN 05 Gerard Le Grellelaan
653,Gerard le Grellelaan 10,2023-02-25,15:00:00,50,41,9,FMN 05 Gerard Le Grellelaan
653,Gerard le Grellelaan 10,2023-02-25,16:00:00,62,54,8,FMN 05 Gerard Le Grellelaan
653,Gerard le Grellelaan 10,2023-02-25,17:00:00,58,46,12,FMN 05 Gerard Le Grellelaan
653,Gerard le Grellelaan 10,2023-02-25,18:00:00,38,31,7,FMN 05 Gerard Le Grellelaan
653,Gerard le Grellelaan 10,2023-02-25,19:00:00,34,30,4,FMN 05 Gerard Le Grellelaan
653,Gerard le Grellelaan 10,2023-02-25,20:00:00,18,16,2,FMN 05 Gerard Le Grellelaan
653,Gerard le Grellelaan 10,2023-02-25,21:00:00,19,16,3,FMN 05 Gerard Le Grellelaan
653,Gerard le Grellelaan 10,2023-02-25,22:00:00,13,11,2,FMN 05 Gerard Le Grellelaan
653,Gerard le Grellelaan 10,2023-02-25,23:00:00,9,6,3,FMN 05 Gerard Le Grellelaan
653,Gerard le Grellelaan 10,2023-02-26,00:00:00,7,5,2,FMN 05 Gerard Le Grellelaan
653,Gerard le Grellelaan 10,2023-02-26,01:00:00,2,1,1,FMN 05 Gerard Le Grellelaan
653,Gerard le Grellelaan 10,2023-02-26,02:00:00,3,2,1,FMN 05 Gerard Le Grellelaan
653,Gerard le Grellelaan 10,2023-02-26,03:00:00,5,3,2,FMN 05 Gerard Le Grellelaan
653,Gerard le Grellelaan 10,2023-02-26,04:00:00,2,1,1,FMN 05 Gerard Le Grellelaan
653,Gerard le Grellelaan 10,2023-02-26,05:00:00,3,2,1,FMN 05 Gerard Le Grellelaan
653,Gerard le Grellelaan 10,2023-02-26,06:00:00,3,2,1,FMN 05 Gerard Le Grellelaan
653,Gerard le Grellelaan 10,2023-02-26,07:00:00,3,3,0,FMN 05 Gerard Le Grellelaan
653,Gerard le Grellelaan 10,2023-02-26,08:00:00,9,8,1,FMN 05 Gerard Le Grellelaan
653,Gerard le Grellelaan 10,2023-02-26,09:00:00,35,32,3,FMN 05 Gerard Le Grellelaan
653,Gerard le Grellelaan 10,2023-02-26,10:00:00,22,19,3,FMN 05 Gerard Le Grellelaan
653,Gerard le Grellelaan 10,2023-02-26,11:00:00,58,45,13,FMN 05 Gerard Le Grellelaan
653,Gerard le Grellelaan 10,2023-02-26,12:00:00,66,49,17,FMN 05 Gerard Le Grellelaan
653,Gerard le Grellelaan 10,2023-02-26,13:00:00,54,48,6,FMN 05 Gerard Le Grellelaan
653,Gerard le Grellelaan 10,2023-02-26,14:00:00,58,50,8,FMN 05 Gerard Le Grellelaan
653,Gerard le Grellelaan 10,2023-02-26,15:00:00,69,55,14,FMN 05 Gerard Le Grellelaan
653,Gerard le Grellelaan 10,2023-02-26,16:00:00,68,60,8,FMN 05 Gerard Le Grellelaan
653,Gerard le Grellelaan 10,2023-02-26,17:00:00,62,54,8,FMN 05 Gerard Le Grellelaan
653,Gerard le Grellelaan 10,2023-02-26,18:00:00,41,30,11,FMN 05 Gerard Le Grellelaan
653,Gerard le Grellelaan 10,2023-02-26,19:00:00,29,24,5,FMN 05 Gerard Le Grellelaan
653,Gerard le Grellelaan 10,2023-02-26,20:00:00,24,22,2,FMN 05 Gerard Le Grellelaan
653,Gerard le Grellelaan 10,2023-02-26,21:00:00,19,14,5,FMN 05 Gerard Le Grellelaan
653,Gerard le Grellelaan 10,2023-02-26,22:00:00,17,12,5,FMN 05 Gerard Le Grellelaan
653,Gerard le Grellelaan 10,2023-02-26,23:00:00,6,2,4,FMN 05 Gerard Le Grellelaan
653,Gerard le Grellelaan 10,2023-02-27,00:00:00,5,1,4,FMN 05 Gerard Le Grellelaan
653,Gerard le Grellelaan 10,2023-02-27,01:00:00,2,2,0,FMN 05 Gerard Le Grellelaan
653,Gerard le Grellelaan 10,2023-02-27,02:00:00,1,1,0,FMN 05 Gerard Le Grellelaan
653,Gerard le Grellelaan 10,2023-02-27,03:00:00,4,3,1,FMN 05 Gerard Le Grellelaan
653,Gerard le Grellelaan 10,2023-02-27,04:00:00,5,1,4,FMN 05 Gerard Le Grellelaan
653,Gerard le Grellelaan 10,2023-02-27,05:00:00,15,7,8,FMN 05 Gerard Le Grellelaan
653,Gerard le Grellelaan 10,2023-02-27,06:00:00,29,17,12,FMN 05 Gerard Le Grellelaan
653,Gerard le Grellelaan 10,2023-02-27,07:00:00,96,74,22,FMN 05 Gerard Le Grellelaan
653,Gerard le Grellelaan 10,2023-02-27,08:00:00,175,151,24,FMN 05 Gerard Le Grellelaan
653,Gerard le Grellelaan 10,2023-02-27,09:00:00,51,45,6,FMN 05 Gerard Le Grellelaan
653,Gerard le Grellelaan 10,2023-02-27,10:00:00,47,43,4,FMN 05 Gerard Le Grellelaan
653,Gerard le Grellelaan 10,2023-02-27,11:00:00,35,26,9,FMN 05 Gerard Le Grellelaan
653,Gerard le Grellelaan 10,2023-02-27,12:00:00,77,63,14,FMN 05 Gerard Le Grellelaan
653,Gerard le Grellelaan 10,2023-02-27,13:00:00,98,81,17,FMN 05 Gerard Le Grellelaan
653,Gerard le Grellelaan 10,2023-02-27,14:00:00,66,52,14,FMN 05 Gerard Le Grellelaan
653,Gerard le Grellelaan 10,2023-02-27,15:00:00,115,88,27,FMN 05 Gerard Le Grellelaan
653,Gerard le Grellelaan 10,2023-02-27,16:00:00,133,108,25,FMN 05 Gerard Le Grellelaan
653,Gerard le Grellelaan 10,2023-02-27,17:00:00,167,142,25,FMN 05 Gerard Le Grellelaan
653,Gerard le Grellelaan 10,2023-02-27,18:00:00,127,96,31,FMN 05 Gerard Le Grellelaan
653,Gerard le Grellelaan 10,2023-02-27,19:00:00,61,55,6,FMN 05 Gerard Le Grellelaan
653,Gerard le Grellelaan 10,2023-02-27,20:00:00,34,30,4,FMN 05 Gerard Le Grellelaan
653,Gerard le Grellelaan 10,2023-02-27,21:00:00,25,17,8,FMN 05 Gerard Le Grellelaan
653,Gerard le Grellelaan 10,2023-02-27,22:00:00,26,24,2,FMN 05 Gerard Le Grellelaan
653,Gerard le Grellelaan 10,2023-02-27,23:00:00,12,9,3,FMN 05 Gerard Le Grellelaan
653,Gerard le Grellelaan 10,2023-02-28,00:00:00,0,0,0,FMN 05 Gerard Le Grellelaan
653,Gerard le Grellelaan 10,2023-02-28,01:00:00,3,2,1,FMN 05 Gerard Le Grellelaan
653,Gerard le Grellelaan 10,2023-02-28,02:00:00,1,1,0,FMN 05 Gerard Le Grellelaan
653,Gerard le Grellelaan 10,2023-02-28,03:00:00,0,0,0,FMN 05 Gerard Le Grellelaan
653,Gerard le Grellelaan 10,2023-02-28,04:00:00,5,3,2,FMN 05 Gerard Le Grellelaan
653,Gerard le Grellelaan 10,2023-02-28,05:00:00,17,8,9,FMN 05 Gerard Le Grellelaan
653,Gerard le Grellelaan 10,2023-02-28,06:00:00,29,19,10,FMN 05 Gerard Le Grellelaan
653,Gerard le Grellelaan 10,2023-02-28,07:00:00,129,98,31,FMN 05 Gerard Le Grellelaan
653,Gerard le Grellelaan 10,2023-02-28,08:00:00,212,165,47,FMN 05 Gerard Le Grellelaan
653,Gerard le Grellelaan 10,2023-02-28,09:00:00,72,61,11,FMN 05 Gerard Le Grellelaan
653,Gerard le Grellelaan 10,2023-02-28,10:00:00,52,40,12,FMN 05 Gerard Le Grellelaan
653,Gerard le Grellelaan 10,2023-02-28,11:00:00,42,35,7,FMN 05 Gerard Le Grellelaan
653,Gerard le Grellelaan 10,2023-02-28,12:00:00,64,56,8,FMN 05 Gerard Le Grellelaan
653,Gerard le Grellelaan 10,2023-02-28,13:00:00,77,59,18,FMN 05 Gerard Le Grellelaan
653,Gerard le Grellelaan 10,2023-02-28,14:00:00,81,67,14,FMN 05 Gerard Le Grellelaan
653,Gerard le Grellelaan 10,2023-02-28,15:00:00,115,93,22,FMN 05 Gerard Le Grellelaan
653,Gerard le Grellelaan 10,2023-02-28,16:00:00,198,157,41,FMN 05 Gerard Le Grellelaan
653,Gerard le Grellelaan 10,2023-02-28,17:00:00,213,174,39,FMN 05 Gerard Le Grellelaan
653,Gerard le Grellelaan 10,2023-02-28,18:00:00,153,121,32,FMN 05 Gerard Le Grellelaan
653,Gerard le Grellelaan 10,2023-02-28,19:00:00,59,50,9,FMN 05 Gerard Le Grellelaan
653,Gerard le Grellelaan 10,2023-02-28,20:00:00,38,36,2,FMN 05 Gerard Le Grellelaan
653,Gerard le Grellelaan 10,2023-02-28,21:00:00,21,17,4,FMN 05 Gerard Le Grellelaan
653,Gerard le Grellelaan 10,2023-02-28,22:00:00,39,35,4,FMN 05 Gerard Le Grellelaan
653,Gerard le Grellelaan 10,2023-02-28,23:00:00,19,14,5,FMN 05 Gerard Le Grellelaan
653,Gerard le Grellelaan 10,2023-03-01,00:00:00,3,3,0,FMN 05 Gerard Le Grellelaan
653,Gerard le Grellelaan 10,2023-03-01,01:00:00,1,1,0,FMN 05 Gerard Le Grellelaan
653,Gerard le Grellelaan 10,2023-03-01,02:00:00,2,1,1,FMN 05 Gerard Le Grellelaan
653,Gerard le Grellelaan 10,2023-03-01,03:00:00,6,4,2,FMN 05 Gerard Le Grellelaan
653,Gerard le Grellelaan 10,2023-03-01,04:00:00,8,5,3,FMN 05 Gerard Le Grellelaan
653,Gerard le Grellelaan 10,2023-03-01,05:00:00,16,10,6,FMN 05 Gerard Le Grellelaan
653,Gerard le Grellelaan 10,2023-03-01,06:00:00,32,16,16,FMN 05 Gerard Le Grellelaan
653,Gerard le Grellelaan 10,2023-03-01,07:00:00,87,71,16,FMN 05 Gerard Le Grellelaan
653,Gerard le Grellelaan 10,2023-03-01,08:00:00,196,156,40,FMN 05 Gerard Le Grellelaan
653,Gerard le Grellelaan 10,2023-03-01,09:00:00,49,45,4,FMN 05 Gerard Le Grellelaan
653,Gerard le Grellelaan 10,2023-03-01,10:00:00,58,43,15,FMN 05 Gerard Le Grellelaan
653,Gerard le Grellelaan 10,2023-03-01,11:00:00,49,37,12,FMN 05 Gerard Le Grellelaan
653,Gerard le Grellelaan 10,2023-03-01,12:00:00,133,98,35,FMN 05 Gerard Le Grellelaan
653,Gerard le Grellelaan 10,2023-03-01,13:00:00,98,77,21,FMN 05 Gerard Le Grellelaan
653,Gerard le Grellelaan 10,2023-03-01,14:00:00,86,65,21,FMN 05 Gerard Le Grellelaan
653,Gerard le Grellelaan 10,2023-03-01,15:00:00,117,95,22,FMN 05 Gerard Le Grellelaan
653,Gerard le Grellelaan 10,2023-03-01,16:00:00,145,117,28,FMN 05 Gerard Le Grellelaan
653,Gerard le Grellelaan 10,2023-03-01,17:00:00,161,134,27,FMN 05 Gerard Le Grellelaan
653,Gerard le Grellelaan 10,2023-03-01,18:00:00,107,81,26,FMN 05 Gerard Le Grellelaan
653,Gerard le Grellelaan 10,2023-03-01,19:00:00,70,56,14,FMN 05 Gerard Le Grellelaan
653,Gerard le Grellelaan 10,2023-03-01,20:00:00,54,48,6,FMN 05 Gerard Le Grellelaan
653,Gerard le Grellelaan 10,2023-03-01,21:00:00,26,22,4,FMN 05 Gerard Le Grellelaan
653,Gerard le Grellelaan 10,2023-03-01,22:00:00,31,24,7,FMN 05 Gerard Le Grellelaan
653,Gerard le Grellelaan 10,2023-03-01,23:00:00,8,7,1,FMN 05 Gerard Le Grellelaan
653,Gerard le Grellelaan 10,2023-03-02,00:00:00,2,1,1,FMN 05 Gerard Le Grellelaan
653,Gerard le Grellelaan 10,2023-03-02,01:00:00,2,2,0,FMN 05 Gerard Le Grellelaan
653,Gerard le Grellelaan 10,2023-03-02,02:00:00,0,0,0,FMN 05 Gerard Le Grellelaan
653,Gerard le Grellelaan 10,2023-03-02,03:00:00,1,1,0,FMN 05 Gerard Le Grellelaan
653,Gerard le Grellelaan 10,2023-03-02,04:00:00,5,2,3,FMN 05 Gerard Le Grellelaan
653,Gerard le Grellelaan 10,2023-03-02,05:00:00,17,10,7,FMN 05 Gerard Le Grellelaan
653,Gerard le Grellelaan 10,2023-03-02,06:00:00,31,20,11,FMN 05 Gerard Le Grellelaan
653,Gerard le Grellelaan 10,2023-03-02,07:00:00,96,75,21,FMN 05 Gerard Le Grellelaan
653,Gerard le Grellelaan 10,2023-03-02,08:00:00,213,179,34,FMN 05 Gerard Le Grellelaan
653,Gerard le Grellelaan 10,2023-03-02,09:00:00,80,71,9,FMN 05 Gerard Le Grellelaan
653,Gerard le Grellelaan 10,2023-03-02,10:00:00,58,50,8,FMN 05 Gerard Le Grellelaan
653,Gerard le Grellelaan 10,2023-03-02,11:00:00,49,37,12,FMN 05 Gerard Le Grellelaan
653,Gerard le Grellelaan 10,2023-03-02,12:00:00,88,77,11,FMN 05 Gerard Le Grellelaan
653,Gerard le Grellelaan 10,2023-03-02,13:00:00,88,62,26,FMN 05 Gerard Le Grellelaan
653,Gerard le Grellelaan 10,2023-03-02,14:00:00,81,64,17,FMN 05 Gerard Le Grellelaan
653,Gerard le Grellelaan 10,2023-03-02,15:00:00,123,104,19,FMN 05 Gerard Le Grellelaan
653,Gerard le Grellelaan 10,2023-03-02,16:00:00,178,136,42,FMN 05 Gerard Le Grellelaan
653,Gerard le Grellelaan 10,2023-03-02,17:00:00,192,153,39,FMN 05 Gerard Le Grellelaan
653,Gerard le Grellelaan 10,2023-03-02,18:00:00,117,99,18,FMN 05 Gerard Le Grellelaan
653,Gerard le Grellelaan 10,2023-03-02,19:00:00,71,63,8,FMN 05 Gerard Le Grellelaan
653,Gerard le Grellelaan 10,2023-03-02,20:00:00,23,18,5,FMN 05 Gerard Le Grellelaan
653,Gerard le Grellelaan 10,2023-03-02,21:00:00,32,24,8,FMN 05 Gerard Le Grellelaan
653,Gerard le Grellelaan 10,2023-03-02,22:00:00,27,19,8,FMN 05 Gerard Le Grellelaan
653,Gerard le Grellelaan 10,2023-03-02,23:00:00,17,12,5,FMN 05 Gerard Le Grellelaan
653,Gerard le Grellelaan 10,2023-03-03,00:00:00,12,6,6,FMN 05 Gerard Le Grellelaan
653,Gerard le Grellelaan 10,2023-03-03,01:00:00,2,2,0,FMN 05 Gerard Le Grellelaan
653,Gerard le Grellelaan 10,2023-03-03,02:00:00,1,1,0,FMN 05 Gerard Le Grellelaan
653,Gerard le Grellelaan 10,2023-03-03,03:00:00,2,1,1,FMN 05 Gerard Le Grellelaan
653,Gerard le Grellelaan 10,2023-03-03,04:00:00,6,2,4,FMN 05 Gerard Le Grellelaan
653,Gerard le Grellelaan 10,2023-03-03,05:00:00,21,12,9,FMN 05 Gerard Le Grellelaan
653,Gerard le Grellelaan 10,2023-03-03,06:00:00,30,17,13,FMN 05 Gerard Le Grellelaan
653,Gerard le Grellelaan 10,2023-03-03,07:00:00,104,79,25,FMN 05 Gerard Le Grellelaan
653,Gerard le Grellelaan 10,2023-03-03,08:00:00,175,136,39,FMN 05 Gerard Le Grellelaan
653,Gerard le Grellelaan 10,2023-03-03,09:00:00,71,64,7,FMN 05 Gerard Le Grellelaan
653,Gerard le Grellelaan 10,2023-03-03,10:00:00,42,32,10,FMN 05 Gerard Le Grellelaan
653,Gerard le Grellelaan 10,2023-03-03,11:00:00,51,41,10,FMN 05 Gerard Le Grellelaan
653,Gerard le Grellelaan 10,2023-03-03,12:00:00,76,58,18,FMN 05 Gerard Le Grellelaan
653,Gerard le Grellelaan 10,2023-03-03,13:00:00,70,48,22,FMN 05 Gerard Le Grellelaan
653,Gerard le Grellelaan 10,2023-03-03,14:00:00,65,54,11,FMN 05 Gerard Le Grellelaan
653,Gerard le Grellelaan 10,2023-03-03,15:00:00,145,118,27,FMN 05 Gerard Le Grellelaan
653,Gerard le Grellelaan 10,2023-03-03,16:00:00,138,112,26,FMN 05 Gerard Le Grellelaan
653,Gerard le Grellelaan 10,2023-03-03,17:00:00,161,119,42,FMN 05 Gerard Le Grellelaan
653,Gerard le Grellelaan 10,2023-03-03,18:00:00,95,77,18,FMN 05 Gerard Le Grellelaan
653,Gerard le Grellelaan 10,2023-03-03,19:00:00,63,52,11,FMN 05 Gerard Le Grellelaan
653,Gerard le Grellelaan 10,2023-03-03,20:00:00,43,32,11,FMN 05 Gerard Le Grellelaan
653,Gerard le Grellelaan 10,2023-03-03,21:00:00,26,22,4,FMN 05 Gerard Le Grellelaan
653,Gerard le Grellelaan 10,2023-03-03,22:00:00,17,16,1,FMN 05 Gerard Le Grellelaan
653,Gerard le Grellelaan 10,2023-03-03,23:00:00,13,13,0,FMN 05 Gerard Le Grellelaan
653,Gerard le Grellelaan 10,2023-03-04,00:00:00,7,3,4,FMN 05 Gerard Le Grellelaan
653,Gerard le Grellelaan 10,2023-03-04,01:00:00,12,4,8,FMN 05 Gerard Le Grellelaan
653,Gerard le Grellelaan 10,2023-03-04,02:00:00,5,3,2,FMN 05 Gerard Le Grellelaan
653,Gerard le Grellelaan 10,2023-03-04,03:00:00,5,4,1,FMN 05 Gerard Le Grellelaan
653,Gerard le Grellelaan 10,2023-03-04,04:00:00,7,4,3,FMN 05 Gerard Le Grellelaan
653,Gerard le Grellelaan 10,2023-03-04,05:00:00,1,0,1,FMN 05 Gerard Le Grellelaan
653,Gerard le Grellelaan 10,2023-03-04,06:00:00,5,1,4,FMN 05 Gerard Le Grellelaan
653,Gerard le Grellelaan 10,2023-03-04,07:00:00,14,9,5,FMN 05 Gerard Le Grellelaan
653,Gerard le Grellelaan 10,2023-03-04,08:00:00,20,16,4,FMN 05 Gerard Le Grellelaan
653,Gerard le Grellelaan 10,2023-03-04,09:00:00,45,34,11,FMN 05 Gerard Le Grellelaan
653,Gerard le Grellelaan 10,2023-03-04,10:00:00,49,30,19,FMN 05 Gerard Le Grellelaan
653,Gerard le Grellelaan 10,2023-03-04,11:00:00,59,46,13,FMN 05 Gerard Le Grellelaan
653,Gerard le Grellelaan 10,2023-03-04,12:00:00,61,45,16,FMN 05 Gerard Le Grellelaan
653,Gerard le Grellelaan 10,2023-03-04,13:00:00,63,50,13,FMN 05 Gerard Le Grellelaan
653,Gerard le Grellelaan 10,2023-03-04,14:00:00,44,41,3,FMN 05 Gerard Le Grellelaan
653,Gerard le Grellelaan 10,2023-03-04,15:00:00,54,43,11,FMN 05 Gerard Le Grellelaan
653,Gerard le Grellelaan 10,2023-03-04,16:00:00,44,37,7,FMN 05 Gerard Le Grellelaan
653,Gerard le Grellelaan 10,2023-03-04,17:00:00,44,39,5,FMN 05 Gerard Le Grellelaan
653,Gerard le Grellelaan 10,2023-03-04,18:00:00,37,34,3,FMN 05 Gerard Le Grellelaan
653,Gerard le Grellelaan 10,2023-03-04,19:00:00,38,32,6,FMN 05 Gerard Le Grellelaan
653,Gerard le Grellelaan 10,2023-03-04,20:00:00,20,15,5,FMN 05 Gerard Le Grellelaan
653,Gerard le Grellelaan 10,2023-03-04,21:00:00,17,16,1,FMN 05 Gerard Le Grellelaan
653,Gerard le Grellelaan 10,2023-03-04,22:00:00,20,20,0,FMN 05 Gerard Le Grellelaan
653,Gerard le Grellelaan 10,2023-03-04,23:00:00,16,13,3,FMN 05 Gerard Le Grellelaan
653,Gerard le Grellelaan 10,2023-03-05,00:00:00,13,11,2,FMN 05 Gerard Le Grellelaan
653,Gerard le Grellelaan 10,2023-03-05,01:00:00,3,3,0,FMN 05 Gerard Le Grellelaan
653,Gerard le Grellelaan 10,2023-03-05,02:00:00,6,4,2,FMN 05 Gerard Le Grellelaan
653,Gerard le Grellelaan 10,2023-03-05,03:00:00,4,3,1,FMN 05 Gerard Le Grellelaan
653,Gerard le Grellelaan 10,2023-03-05,04:00:00,0,0,0,FMN 05 Gerard Le Grellelaan
653,Gerard le Grellelaan 10,2023-03-05,05:00:00,5,2,3,FMN 05 Gerard Le Grellelaan
653,Gerard le Grellelaan 10,2023-03-05,06:00:00,1,0,1,FMN 05 Gerard Le Grellelaan
653,Gerard le Grellelaan 10,2023-03-05,07:00:00,5,5,0,FMN 05 Gerard Le Grellelaan
653,Gerard le Grellelaan 10,2023-03-05,08:00:00,16,15,1,FMN 05 Gerard Le Grellelaan
653,Gerard le Grellelaan 10,2023-03-05,09:00:00,38,35,3,FMN 05 Gerard Le Grellelaan
653,Gerard le Grellelaan 10,2023-03-05,10:00:00,28,22,6,FMN 05 Gerard Le Grellelaan
653,Gerard le Grellelaan 10,2023-03-05,11:00:00,30,18,12,FMN 05 Gerard Le Grellelaan
653,Gerard le Grellelaan 10,2023-03-05,12:00:00,53,45,8,FMN 05 Gerard Le Grellelaan
653,Gerard le Grellelaan 10,2023-03-05,13:00:00,49,38,11,FMN 05 Gerard Le Grellelaan
653,Gerard le Grellelaan 10,2023-03-05,14:00:00,31,22,9,FMN 05 Gerard Le Grellelaan
653,Gerard le Grellelaan 10,2023-03-05,15:00:00,51,43,8,FMN 05 Gerard Le Grellelaan
653,Gerard le Grellelaan 10,2023-03-05,16:00:00,32,27,5,FMN 05 Gerard Le Grellelaan
653,Gerard le Grellelaan 10,2023-03-05,17:00:00,39,24,15,FMN 05 Gerard Le Grellelaan
653,Gerard le Grellelaan 10,2023-03-05,18:00:00,20,14,6,FMN 05 Gerard Le Grellelaan
653,Gerard le Grellelaan 10,2023-03-05,19:00:00,31,25,6,FMN 05 Gerard Le Grellelaan
653,Gerard le Grellelaan 10,2023-03-05,20:00:00,15,15,0,FMN 05 Gerard Le Grellelaan
653,Gerard le Grellelaan 10,2023-03-05,21:00:00,17,13,4,FMN 05 Gerard Le Grellelaan
653,Gerard le Grellelaan 10,2023-03-05,22:00:00,15,13,2,FMN 05 Gerard Le Grellelaan
653,Gerard le Grellelaan 10,2023-03-05,23:00:00,6,4,2,FMN 05 Gerard Le Grellelaan
653,Gerard le Grellelaan 10,2023-03-06,00:00:00,3,0,3,FMN 05 Gerard Le Grellelaan
653,Gerard le Grellelaan 10,2023-03-06,01:00:00,1,1,0,FMN 05 Gerard Le Grellelaan
653,Gerard le Grellelaan 10,2023-03-06,02:00:00,0,0,0,FMN 05 Gerard Le Grellelaan
653,Gerard le Grellelaan 10,2023-03-06,03:00:00,2,1,1,FMN 05 Gerard Le Grellelaan
653,Gerard le Grellelaan 10,2023-03-06,04:00:00,2,1,1,FMN 05 Gerard Le Grellelaan
653,Gerard le Grellelaan 10,2023-03-06,05:00:00,20,4,16,FMN 05 Gerard Le Grellelaan
653,Gerard le Grellelaan 10,2023-03-06,06:00:00,37,25,12,FMN 05 Gerard Le Grellelaan
653,Gerard le Grellelaan 10,2023-03-06,07:00:00,111,88,23,FMN 05 Gerard Le Grellelaan
653,Gerard le Grellelaan 10,2023-03-06,08:00:00,222,185,37,FMN 05 Gerard Le Grellelaan
653,Gerard le Grellelaan 10,2023-03-06,09:00:00,58,51,7,FMN 05 Gerard Le Grellelaan
653,Gerard le Grellelaan 10,2023-03-06,10:00:00,42,36,6,FMN 05 Gerard Le Grellelaan
653,Gerard le Grellelaan 10,2023-03-06,11:00:00,54,46,8,FMN 05 Gerard Le Grellelaan
653,Gerard le Grellelaan 10,2023-03-06,12:00:00,61,53,8,FMN 05 Gerard Le Grellelaan
653,Gerard le Grellelaan 10,2023-03-06,13:00:00,86,68,18,FMN 05 Gerard Le Grellelaan
653,Gerard le Grellelaan 10,2023-03-06,14:00:00,74,60,14,FMN 05 Gerard Le Grellelaan
653,Gerard le Grellelaan 10,2023-03-06,15:00:00,106,85,21,FMN 05 Gerard Le Grellelaan
653,Gerard le Grellelaan 10,2023-03-06,16:00:00,145,114,31,FMN 05 Gerard Le Grellelaan
653,Gerard le Grellelaan 10,2023-03-06,17:00:00,170,138,32,FMN 05 Gerard Le Grellelaan
653,Gerard le Grellelaan 10,2023-03-06,18:00:00,90,71,19,FMN 05 Gerard Le Grellelaan
653,Gerard le Grellelaan 10,2023-03-06,19:00:00,46,41,5,FMN 05 Gerard Le Grellelaan
653,Gerard le Grellelaan 10,2023-03-06,20:00:00,30,23,7,FMN 05 Gerard Le Grellelaan
653,Gerard le Grellelaan 10,2023-03-06,21:00:00,24,18,6,FMN 05 Gerard Le Grellelaan
653,Gerard le Grellelaan 10,2023-03-06,22:00:00,34,28,6,FMN 05 Gerard Le Grellelaan
653,Gerard le Grellelaan 10,2023-03-06,23:00:00,9,8,1,FMN 05 Gerard Le Grellelaan
653,Gerard le Grellelaan 10,2023-03-07,00:00:00,6,4,2,FMN 05 Gerard Le Grellelaan
653,Gerard le Grellelaan 10,2023-03-07,01:00:00,3,3,0,FMN 05 Gerard Le Grellelaan
653,Gerard le Grellelaan 10,2023-03-07,02:00:00,5,3,2,FMN 05 Gerard Le Grellelaan
653,Gerard le Grellelaan 10,2023-03-07,03:00:00,2,2,0,FMN 05 Gerard Le Grellelaan
653,Gerard le Grellelaan 10,2023-03-07,04:00:00,0,0,0,FMN 05 Gerard Le Grellelaan
653,Gerard le Grellelaan 10,2023-03-07,05:00:00,17,5,12,FMN 05 Gerard Le Grellelaan
653,Gerard le Grellelaan 10,2023-03-07,06:00:00,27,16,11,FMN 05 Gerard Le Grellelaan
653,Gerard le Grellelaan 10,2023-03-07,07:00:00,105,87,18,FMN 05 Gerard Le Grellelaan
653,Gerard le Grellelaan 10,2023-03-07,08:00:00,197,159,38,FMN 05 Gerard Le Grellelaan
653,Gerard le Grellelaan 10,2023-03-07,09:00:00,60,51,9,FMN 05 Gerard Le Grellelaan
653,Gerard le Grellelaan 10,2023-03-07,10:00:00,32,25,7,FMN 05 Gerard Le Grellelaan
653,Gerard le Grellelaan 10,2023-03-07,11:00:00,37,34,3,FMN 05 Gerard Le Grellelaan
653,Gerard le Grellelaan 10,2023-03-07,12:00:00,48,42,6,FMN 05 Gerard Le Grellelaan
653,Gerard le Grellelaan 10,2023-03-07,13:00:00,46,37,9,FMN 05 Gerard Le Grellelaan
653,Gerard le Grellelaan 10,2023-03-07,14:00:00,38,32,6,FMN 05 Gerard Le Grellelaan
653,Gerard le Grellelaan 10,2023-03-07,15:00:00,78,61,17,FMN 05 Gerard Le Grellelaan
653,Gerard le Grellelaan 10,2023-03-07,16:00:00,110,86,24,FMN 05 Gerard Le Grellelaan
653,Gerard le Grellelaan 10,2023-03-07,17:00:00,117,98,19,FMN 05 Gerard Le Grellelaan
653,Gerard le Grellelaan 10,2023-03-07,18:00:00,83,67,16,FMN 05 Gerard Le Grellelaan
653,Gerard le Grellelaan 10,2023-03-07,19:00:00,43,33,10,FMN 05 Gerard Le Grellelaan
653,Gerard le Grellelaan 10,2023-03-07,20:00:00,25,23,2,FMN 05 Gerard Le Grellelaan
653,Gerard le Grellelaan 10,2023-03-07,21:00:00,23,20,3,FMN 05 Gerard Le Grellelaan
653,Gerard le Grellelaan 10,2023-03-07,22:00:00,21,19,2,FMN 05 Gerard Le Grellelaan
653,Gerard le Grellelaan 10,2023-03-07,23:00:00,11,10,1,FMN 05 Gerard Le Grellelaan
653,Gerard le Grellelaan 10,2023-03-08,00:00:00,4,4,0,FMN 05 Gerard Le Grellelaan
653,Gerard le Grellelaan 10,2023-03-08,01:00:00,4,4,0,FMN 05 Gerard Le Grellelaan
653,Gerard le Grellelaan 10,2023-03-08,02:00:00,2,2,0,FMN 05 Gerard Le Grellelaan
653,Gerard le Grellelaan 10,2023-03-08,03:00:00,4,2,2,FMN 05 Gerard Le Grellelaan
653,Gerard le Grellelaan 10,2023-03-08,04:00:00,2,2,0,FMN 05 Gerard Le Grellelaan
653,Gerard le Grellelaan 10,2023-03-08,05:00:00,18,6,12,FMN 05 Gerard Le Grellelaan
653,Gerard le Grellelaan 10,2023-03-08,06:00:00,27,18,9,FMN 05 Gerard Le Grellelaan
653,Gerard le Grellelaan 10,2023-03-08,07:00:00,49,32,17,FMN 05 Gerard Le Grellelaan
653,Gerard le Grellelaan 10,2023-03-08,08:00:00,90,71,19,FMN 05 Gerard Le Grellelaan
653,Gerard le Grellelaan 10,2023-03-08,09:00:00,31,25,6,FMN 05 Gerard Le Grellelaan
653,Gerard le Grellelaan 10,2023-03-08,10:00:00,15,12,3,FMN 05 Gerard Le Grellelaan
653,Gerard le Grellelaan 10,2023-03-08,11:00:00,29,25,4,FMN 05 Gerard Le Grellelaan
653,Gerard le Grellelaan 10,2023-03-08,12:00:00,77,55,22,FMN 05 Gerard Le Grellelaan
653,Gerard le Grellelaan 10,2023-03-08,13:00:00,42,32,10,FMN 05 Gerard Le Grellelaan
653,Gerard le Grellelaan 10,2023-03-08,14:00:00,37,31,6,FMN 05 Gerard Le Grellelaan
653,Gerard le Grellelaan 10,2023-03-08,15:00:00,57,48,9,FMN 05 Gerard Le Grellelaan
653,Gerard le Grellelaan 10,2023-03-08,16:00:00,70,62,8,FMN 05 Gerard Le Grellelaan
653,Gerard le Grellelaan 10,2023-03-08,17:00:00,83,69,14,FMN 05 Gerard Le Grellelaan
653,Gerard le Grellelaan 10,2023-03-08,18:00:00,68,55,13,FMN 05 Gerard Le Grellelaan
653,Gerard le Grellelaan 10,2023-03-08,19:00:00,31,23,8,FMN 05 Gerard Le Grellelaan
653,Gerard le Grellelaan 10,2023-03-08,20:00:00,21,17,4,FMN 05 Gerard Le Grellelaan
653,Gerard le Grellelaan 10,2023-03-08,21:00:00,16,13,3,FMN 05 Gerard Le Grellelaan
653,Gerard le Grellelaan 10,2023-03-08,22:00:00,22,22,0,FMN 05 Gerard Le Grellelaan
653,Gerard le Grellelaan 10,2023-03-08,23:00:00,7,6,1,FMN 05 Gerard Le Grellelaan
653,Gerard le Grellelaan 10,2023-03-09,00:00:00,2,2,0,FMN 05 Gerard Le Grellelaan
653,Gerard le Grellelaan 10,2023-03-09,01:00:00,3,3,0,FMN 05 Gerard Le Grellelaan
653,Gerard le Grellelaan 10,2023-03-09,02:00:00,0,0,0,FMN 05 Gerard Le Grellelaan
653,Gerard le Grellelaan 10,2023-03-09,03:00:00,0,0,0,FMN 05 Gerard Le Grellelaan
653,Gerard le Grellelaan 10,2023-03-09,04:00:00,1,1,0,FMN 05 Gerard Le Grellelaan
653,Gerard le Grellelaan 10,2023-03-09,05:00:00,14,4,10,FMN 05 Gerard Le Grellelaan
653,Gerard le Grellelaan 10,2023-03-09,06:00:00,29,17,12,FMN 05 Gerard Le Grellelaan
653,Gerard le Grellelaan 10,2023-03-09,07:00:00,93,71,22,FMN 05 Gerard Le Grellelaan
653,Gerard le Grellelaan 10,2023-03-09,08:00:00,188,153,35,FMN 05 Gerard Le Grellelaan
653,Gerard le Grellelaan 10,2023-03-09,09:00:00,75,70,5,FMN 05 Gerard Le Grellelaan
653,Gerard le Grellelaan 10,2023-03-09,10:00:00,30,23,7,FMN 05 Gerard Le Grellelaan
653,Gerard le Grellelaan 10,2023-03-09,11:00:00,22,20,2,FMN 05 Gerard Le Grellelaan
653,Gerard le Grellelaan 10,2023-03-09,12:00:00,53,40,13,FMN 05 Gerard Le Grellelaan
653,Gerard le Grellelaan 10,2023-03-09,13:00:00,45,39,6,FMN 05 Gerard Le Grellelaan
653,Gerard le Grellelaan 10,2023-03-09,14:00:00,49,40,9,FMN 05 Gerard Le Grellelaan
653,Gerard le Grellelaan 10,2023-03-09,15:00:00,88,73,15,FMN 05 Gerard Le Grellelaan
653,Gerard le Grellelaan 10,2023-03-09,16:00:00,103,84,19,FMN 05 Gerard Le Grellelaan
653,Gerard le Grellelaan 10,2023-03-09,17:00:00,135,107,28,FMN 05 Gerard Le Grellelaan
653,Gerard le Grellelaan 10,2023-03-09,18:00:00,80,65,15,FMN 05 Gerard Le Grellelaan
653,Gerard le Grellelaan 10,2023-03-09,19:00:00,43,29,14,FMN 05 Gerard Le Grellelaan
653,Gerard le Grellelaan 10,2023-03-09,20:00:00,29,24,5,FMN 05 Gerard Le Grellelaan
653,Gerard le Grellelaan 10,2023-03-09,21:00:00,22,17,5,FMN 05 Gerard Le Grellelaan
653,Gerard le Grellelaan 10,2023-03-09,22:00:00,25,21,4,FMN 05 Gerard Le Grellelaan
653,Gerard le Grellelaan 10,2023-03-09,23:00:00,7,7,0,FMN 05 Gerard Le Grellelaan
653,Gerard le Grellelaan 10,2023-03-10,00:00:00,3,1,2,FMN 05 Gerard Le Grellelaan
653,Gerard le Grellelaan 10,2023-03-10,01:00:00,3,3,0,FMN 05 Gerard Le Grellelaan
653,Gerard le Grellelaan 10,2023-03-10,02:00:00,4,4,0,FMN 05 Gerard Le Grellelaan
653,Gerard le Grellelaan 10,2023-03-10,03:00:00,3,3,0,FMN 05 Gerard Le Grellelaan
653,Gerard le Grellelaan 10,2023-03-10,04:00:00,3,2,1,FMN 05 Gerard Le Grellelaan
653,Gerard le Grellelaan 10,2023-03-10,05:00:00,12,2,10,FMN 05 Gerard Le Grellelaan
653,Gerard le Grellelaan 10,2023-03-10,06:00:00,27,14,13,FMN 05 Gerard Le Grellelaan
653,Gerard le Grellelaan 10,2023-03-10,07:00:00,103,78,25,FMN 05 Gerard Le Grellelaan
653,Gerard le Grellelaan 10,2023-03-10,08:00:00,227,182,45,FMN 05 Gerard Le Grellelaan
653,Gerard le Grellelaan 10,2023-03-10,09:00:00,56,50,6,FMN 05 Gerard Le Grellelaan
653,Gerard le Grellelaan 10,2023-03-10,10:00:00,34,31,3,FMN 05 Gerard Le Grellelaan
653,Gerard le Grellelaan 10,2023-03-10,11:00:00,50,40,10,FMN 05 Gerard Le Grellelaan
653,Gerard le Grellelaan 10,2023-03-10,12:00:00,57,50,7,FMN 05 Gerard Le Grellelaan
653,Gerard le Grellelaan 10,2023-03-10,13:00:00,54,39,15,FMN 05 Gerard Le Grellelaan
653,Gerard le Grellelaan 10,2023-03-10,14:00:00,52,42,10,FMN 05 Gerard Le Grellelaan
653,Gerard le Grellelaan 10,2023-03-10,15:00:00,79,60,19,FMN 05 Gerard Le Grellelaan
653,Gerard le Grellelaan 10,2023-03-10,16:00:00,0,0,0,FMN 05 Gerard Le Grellelaan
653,Gerard le Grellelaan 10,2023-03-10,17:00:00,89,71,18,FMN 05 Gerard Le Grellelaan
653,Gerard le Grellelaan 10,2023-03-10,18:00:00,60,49,11,FMN 05 Gerard Le Grellelaan
653,Gerard le Grellelaan 10,2023-03-10,19:00:00,47,41,6,FMN 05 Gerard Le Grellelaan
653,Gerard le Grellelaan 10,2023-03-10,20:00:00,27,21,6,FMN 05 Gerard Le Grellelaan
653,Gerard le Grellelaan 10,2023-03-10,21:00:00,19,14,5,FMN 05 Gerard Le Grellelaan
653,Gerard le Grellelaan 10,2023-03-10,22:00:00,28,26,2,FMN 05 Gerard Le Grellelaan
653,Gerard le Grellelaan 10,2023-03-10,23:00:00,11,8,3,FMN 05 Gerard Le Grellelaan
653,Gerard le Grellelaan 10,2023-03-11,00:00:00,7,6,1,FMN 05 Gerard Le Grellelaan
653,Gerard le Grellelaan 10,2023-03-11,01:00:00,8,5,3,FMN 05 Gerard Le Grellelaan
653,Gerard le Grellelaan 10,2023-03-11,02:00:00,13,11,2,FMN 05 Gerard Le Grellelaan
653,Gerard le Grellelaan 10,2023-03-11,03:00:00,5,5,0,FMN 05 Gerard Le Grellelaan
653,Gerard le Grellelaan 10,2023-03-11,04:00:00,3,2,1,FMN 05 Gerard Le Grellelaan
653,Gerard le Grellelaan 10,2023-03-11,05:00:00,5,1,4,FMN 05 Gerard Le Grellelaan
653,Gerard le Grellelaan 10,2023-03-11,06:00:00,0,0,0,FMN 05 Gerard Le Grellelaan
653,Gerard le Grellelaan 10,2023-03-11,07:00:00,7,6,1,FMN 05 Gerard Le Grellelaan
653,Gerard le Grellelaan 10,2023-03-11,08:00:00,19,18,1,FMN 05 Gerard Le Grellelaan
653,Gerard le Grellelaan 10,2023-03-11,09:00:00,33,29,4,FMN 05 Gerard Le Grellelaan
653,Gerard le Grellelaan 10,2023-03-11,10:00:00,42,34,8,FMN 05 Gerard Le Grellelaan
653,Gerard le Grellelaan 10,2023-03-11,11:00:00,62,51,11,FMN 05 Gerard Le Grellelaan
653,Gerard le Grellelaan 10,2023-03-11,12:00:00,66,58,8,FMN 05 Gerard Le Grellelaan
653,Gerard le Grellelaan 10,2023-03-11,13:00:00,72,61,11,FMN 05 Gerard Le Grellelaan
653,Gerard le Grellelaan 10,2023-03-11,14:00:00,79,69,10,FMN 05 Gerard Le Grellelaan
653,Gerard le Grellelaan 10,2023-03-11,15:00:00,78,62,16,FMN 05 Gerard Le Grellelaan
653,Gerard le Grellelaan 10,2023-03-11,16:00:00,75,62,13,FMN 05 Gerard Le Grellelaan
653,Gerard le Grellelaan 10,2023-03-11,17:00:00,70,64,6,FMN 05 Gerard Le Grellelaan
653,Gerard le Grellelaan 10,2023-03-11,18:00:00,48,38,10,FMN 05 Gerard Le Grellelaan
653,Gerard le Grellelaan 10,2023-03-11,19:00:00,34,28,6,FMN 05 Gerard Le Grellelaan
653,Gerard le Grellelaan 10,2023-03-11,20:00:00,22,17,5,FMN 05 Gerard Le Grellelaan
653,Gerard le Grellelaan 10,2023-03-11,21:00:00,19,14,5,FMN 05 Gerard Le Grellelaan
653,Gerard le Grellelaan 10,2023-03-11,22:00:00,19,14,5,FMN 05 Gerard Le Grellelaan
653,Gerard le Grellelaan 10,2023-03-11,23:00:00,8,5,3,FMN 05 Gerard Le Grellelaan
653,Gerard le Grellelaan 10,2023-03-12,00:00:00,5,3,2,FMN 05 Gerard Le Grellelaan
653,Gerard le Grellelaan 10,2023-03-12,01:00:00,9,6,3,FMN 05 Gerard Le Grellelaan
653,Gerard le Grellelaan 10,2023-03-12,02:00:00,3,2,1,FMN 05 Gerard Le Grellelaan
653,Gerard le Grellelaan 10,2023-03-12,03:00:00,1,0,1,FMN 05 Gerard Le Grellelaan
653,Gerard le Grellelaan 10,2023-03-12,04:00:00,6,1,5,FMN 05 Gerard Le Grellelaan
653,Gerard le Grellelaan 10,2023-03-12,05:00:00,2,2,0,FMN 05 Gerard Le Grellelaan
653,Gerard le Grellelaan 10,2023-03-12,06:00:00,3,1,2,FMN 05 Gerard Le Grellelaan
653,Gerard le Grellelaan 10,2023-03-12,07:00:00,6,4,2,FMN 05 Gerard Le Grellelaan
653,Gerard le Grellelaan 10,2023-03-12,08:00:00,10,8,2,FMN 05 Gerard Le Grellelaan
653,Gerard le Grellelaan 10,2023-03-12,09:00:00,33,29,4,FMN 05 Gerard Le Grellelaan
653,Gerard le Grellelaan 10,2023-03-12,10:00:00,42,29,13,FMN 05 Gerard Le Grellelaan
653,Gerard le Grellelaan 10,2023-03-12,11:00:00,50,39,11,FMN 05 Gerard Le Grellelaan
653,Gerard le Grellelaan 10,2023-03-12,12:00:00,55,48,7,FMN 05 Gerard Le Grellelaan
653,Gerard le Grellelaan 10,2023-03-12,13:00:00,35,28,7,FMN 05 Gerard Le Grellelaan
653,Gerard le Grellelaan 10,2023-03-12,14:00:00,57,45,12,FMN 05 Gerard Le Grellelaan
653,Gerard le Grellelaan 10,2023-03-12,15:00:00,52,39,13,FMN 05 Gerard Le Grellelaan
653,Gerard le Grellelaan 10,2023-03-12,16:00:00,45,33,12,FMN 05 Gerard Le Grellelaan
653,Gerard le Grellelaan 10,2023-03-12,17:00:00,42,32,10,FMN 05 Gerard Le Grellelaan
653,Gerard le Grellelaan 10,2023-03-12,18:00:00,33,31,2,FMN 05 Gerard Le Grellelaan
653,Gerard le Grellelaan 10,2023-03-12,19:00:00,28,19,9,FMN 05 Gerard Le Grellelaan
653,Gerard le Grellelaan 10,2023-03-12,20:00:00,20,14,6,FMN 05 Gerard Le Grellelaan
653,Gerard le Grellelaan 10,2023-03-12,21:00:00,22,18,4,FMN 05 Gerard Le Grellelaan
653,Gerard le Grellelaan 10,2023-03-12,22:00:00,15,11,4,FMN 05 Gerard Le Grellelaan
653,Gerard le Grellelaan 10,2023-03-12,23:00:00,4,3,1,FMN 05 Gerard Le Grellelaan
653,Gerard le Grellelaan 10,2023-03-13,00:00:00,2,1,1,FMN 05 Gerard Le Grellelaan
653,Gerard le Grellelaan 10,2023-03-13,01:00:00,2,1,1,FMN 05 Gerard Le Grellelaan
653,Gerard le Grellelaan 10,2023-03-13,02:00:00,0,0,0,FMN 05 Gerard Le Grellelaan
653,Gerard le Grellelaan 10,2023-03-13,03:00:00,2,2,0,FMN 05 Gerard Le Grellelaan
653,Gerard le Grellelaan 10,2023-03-13,04:00:00,6,2,4,FMN 05 Gerard Le Grellelaan
653,Gerard le Grellelaan 10,2023-03-13,05:00:00,31,14,17,FMN 05 Gerard Le Grellelaan
653,Gerard le Grellelaan 10,2023-03-13,06:00:00,57,24,33,FMN 05 Gerard Le Grellelaan
653,Gerard le Grellelaan 10,2023-03-13,07:00:00,131,99,32,FMN 05 Gerard Le Grellelaan
653,Gerard le Grellelaan 10,2023-03-13,08:00:00,273,220,53,FMN 05 Gerard Le Grellelaan
653,Gerard le Grellelaan 10,2023-03-13,09:00:00,76,63,13,FMN 05 Gerard Le Grellelaan
653,Gerard le Grellelaan 10,2023-03-13,10:00:00,52,41,11,FMN 05 Gerard Le Grellelaan
653,Gerard le Grellelaan 10,2023-03-13,11:00:00,58,47,11,FMN 05 Gerard Le Grellelaan
653,Gerard le Grellelaan 10,2023-03-13,12:00:00,30,24,6,FMN 05 Gerard Le Grellelaan
653,Gerard le Grellelaan 10,2023-03-13,13:00:00,68,52,16,FMN 05 Gerard Le Grellelaan
653,Gerard le Grellelaan 10,2023-03-13,14:00:00,84,67,17,FMN 05 Gerard Le Grellelaan
653,Gerard le Grellelaan 10,2023-03-13,15:00:00,125,104,21,FMN 05 Gerard Le Grellelaan
653,Gerard le Grellelaan 10,2023-03-13,16:00:00,198,153,45,FMN 05 Gerard Le Grellelaan
653,Gerard le Grellelaan 10,2023-03-13,17:00:00,168,138,30,FMN 05 Gerard Le Grellelaan
653,Gerard le Grellelaan 10,2023-03-13,18:00:00,125,104,21,FMN 05 Gerard Le Grellelaan
653,Gerard le Grellelaan 10,2023-03-13,19:00:00,63,51,12,FMN 05 Gerard Le Grellelaan
653,Gerard le Grellelaan 10,2023-03-13,20:00:00,43,33,10,FMN 05 Gerard Le Grellelaan
653,Gerard le Grellelaan 10,2023-03-13,21:00:00,46,34,12,FMN 05 Gerard Le Grellelaan
653,Gerard le Grellelaan 10,2023-03-13,22:00:00,54,45,9,FMN 05 Gerard Le Grellelaan
653,Gerard le Grellelaan 10,2023-03-13,23:00:00,10,7,3,FMN 05 Gerard Le Grellelaan
653,Gerard le Grellelaan 10,2023-03-14,00:00:00,4,3,1,FMN 05 Gerard Le Grellelaan
653,Gerard le Grellelaan 10,2023-03-14,01:00:00,5,3,2,FMN 05 Gerard Le Grellelaan
653,Gerard le Grellelaan 10,2023-03-14,02:00:00,0,0,0,FMN 05 Gerard Le Grellelaan
653,Gerard le Grellelaan 10,2023-03-14,03:00:00,3,3,0,FMN 05 Gerard Le Grellelaan
653,Gerard le Grellelaan 10,2023-03-14,04:00:00,9,3,6,FMN 05 Gerard Le Grellelaan
653,Gerard le Grellelaan 10,2023-03-14,05:00:00,28,10,18,FMN 05 Gerard Le Grellelaan
653,Gerard le Grellelaan 10,2023-03-14,06:00:00,43,17,26,FMN 05 Gerard Le Grellelaan
653,Gerard le Grellelaan 10,2023-03-14,07:00:00,113,86,27,FMN 05 Gerard Le Grellelaan
653,Gerard le Grellelaan 10,2023-03-14,08:00:00,233,180,53,FMN 05 Gerard Le Grellelaan
653,Gerard le Grellelaan 10,2023-03-14,09:00:00,74,62,12,FMN 05 Gerard Le Grellelaan
653,Gerard le Grellelaan 10,2023-03-14,10:00:00,54,42,12,FMN 05 Gerard Le Grellelaan
653,Gerard le Grellelaan 10,2023-03-14,11:00:00,36,34,2,FMN 05 Gerard Le Grellelaan
653,Gerard le Grellelaan 10,2023-03-14,12:00:00,71,55,16,FMN 05 Gerard Le Grellelaan
653,Gerard le Grellelaan 10,2023-03-14,13:00:00,52,45,7,FMN 05 Gerard Le Grellelaan
653,Gerard le Grellelaan 10,2023-03-14,14:00:00,44,33,11,FMN 05 Gerard Le Grellelaan
653,Gerard le Grellelaan 10,2023-03-14,15:00:00,107,89,18,FMN 05 Gerard Le Grellelaan
653,Gerard le Grellelaan 10,2023-03-14,16:00:00,157,123,34,FMN 05 Gerard Le Grellelaan
653,Gerard le Grellelaan 10,2023-03-14,17:00:00,181,148,33,FMN 05 Gerard Le Grellelaan
653,Gerard le Grellelaan 10,2023-03-14,18:00:00,113,89,24,FMN 05 Gerard Le Grellelaan
653,Gerard le Grellelaan 10,2023-03-14,19:00:00,52,44,8,FMN 05 Gerard Le Grellelaan
653,Gerard le Grellelaan 10,2023-03-14,20:00:00,40,30,10,FMN 05 Gerard Le Grellelaan
653,Gerard le Grellelaan 10,2023-03-14,21:00:00,19,13,6,FMN 05 Gerard Le Grellelaan
653,Gerard le Grellelaan 10,2023-03-14,22:00:00,40,33,7,FMN 05 Gerard Le Grellelaan
653,Gerard le Grellelaan 10,2023-03-14,23:00:00,12,9,3,FMN 05 Gerard Le Grellelaan
653,Gerard le Grellelaan 10,2023-03-15,00:00:00,4,3,1,FMN 05 Gerard Le Grellelaan
653,Gerard le Grellelaan 10,2023-03-15,01:00:00,5,2,3,FMN 05 Gerard Le Grellelaan
653,Gerard le Grellelaan 10,2023-03-15,02:00:00,1,0,1,FMN 05 Gerard Le Grellelaan
653,Gerard le Grellelaan 10,2023-03-15,03:00:00,1,1,0,FMN 05 Gerard Le Grellelaan
653,Gerard le Grellelaan 10,2023-03-15,04:00:00,9,5,4,FMN 05 Gerard Le Grellelaan
653,Gerard le Grellelaan 10,2023-03-15,05:00:00,18,7,11,FMN 05 Gerard Le Grellelaan
653,Gerard le Grellelaan 10,2023-03-15,06:00:00,31,15,16,FMN 05 Gerard Le Grellelaan
653,Gerard le Grellelaan 10,2023-03-15,07:00:00,107,86,21,FMN 05 Gerard Le Grellelaan
653,Gerard le Grellelaan 10,2023-03-15,08:00:00,186,149,37,FMN 05 Gerard Le Grellelaan
653,Gerard le Grellelaan 10,2023-03-15,09:00:00,81,64,17,FMN 05 Gerard Le Grellelaan
653,Gerard le Grellelaan 10,2023-03-15,10:00:00,68,57,11,FMN 05 Gerard Le Grellelaan
653,Gerard le Grellelaan 10,2023-03-15,11:00:00,61,52,9,FMN 05 Gerard Le Grellelaan
653,Gerard le Grellelaan 10,2023-03-15,12:00:00,129,86,43,FMN 05 Gerard Le Grellelaan
653,Gerard le Grellelaan 10,2023-03-15,13:00:00,98,75,23,FMN 05 Gerard Le Grellelaan
653,Gerard le Grellelaan 10,2023-03-15,14:00:00,80,63,17,FMN 05 Gerard Le Grellelaan
653,Gerard le Grellelaan 10,2023-03-15,15:00:00,119,102,17,FMN 05 Gerard Le Grellelaan
653,Gerard le Grellelaan 10,2023-03-15,16:00:00,143,119,24,FMN 05 Gerard Le Grellelaan
653,Gerard le Grellelaan 10,2023-03-15,17:00:00,132,113,19,FMN 05 Gerard Le Grellelaan
653,Gerard le Grellelaan 10,2023-03-15,18:00:00,118,100,18,FMN 05 Gerard Le Grellelaan
653,Gerard le Grellelaan 10,2023-03-15,19:00:00,73,55,18,FMN 05 Gerard Le Grellelaan
653,Gerard le Grellelaan 10,2023-03-15,20:00:00,56,51,5,FMN 05 Gerard Le Grellelaan
653,Gerard le Grellelaan 10,2023-03-15,21:00:00,32,26,6,FMN 05 Gerard Le Grellelaan
653,Gerard le Grellelaan 10,2023-03-15,22:00:00,34,26,8,FMN 05 Gerard Le Grellelaan
653,Gerard le Grellelaan 10,2023-03-15,23:00:00,12,10,2,FMN 05 Gerard Le Grellelaan
653,Gerard le Grellelaan 10,2023-03-16,00:00:00,5,3,2,FMN 05 Gerard Le Grellelaan
653,Gerard le Grellelaan 10,2023-03-16,01:00:00,6,4,2,FMN 05 Gerard Le Grellelaan
653,Gerard le Grellelaan 10,2023-03-16,02:00:00,1,1,0,FMN 05 Gerard Le Grellelaan
653,Gerard le Grellelaan 10,2023-03-16,03:00:00,4,4,0,FMN 05 Gerard Le Grellelaan
653,Gerard le Grellelaan 10,2023-03-16,04:00:00,7,2,5,FMN 05 Gerard Le Grellelaan
653,Gerard le Grellelaan 10,2023-03-16,05:00:00,25,8,17,FMN 05 Gerard Le Grellelaan
653,Gerard le Grellelaan 10,2023-03-16,06:00:00,37,19,18,FMN 05 Gerard Le Grellelaan
653,Gerard le Grellelaan 10,2023-03-16,07:00:00,132,95,37,FMN 05 Gerard Le Grellelaan
653,Gerard le Grellelaan 10,2023-03-16,08:00:00,270,226,44,FMN 05 Gerard Le Grellelaan
653,Gerard le Grellelaan 10,2023-03-16,09:00:00,83,69,14,FMN 05 Gerard Le Grellelaan
653,Gerard le Grellelaan 10,2023-03-16,10:00:00,60,54,6,FMN 05 Gerard Le Grellelaan
653,Gerard le Grellelaan 10,2023-03-16,11:00:00,59,46,13,FMN 05 Gerard Le Grellelaan
653,Gerard le Grellelaan 10,2023-03-16,12:00:00,86,73,13,FMN 05 Gerard Le Grellelaan
653,Gerard le Grellelaan 10,2023-03-16,13:00:00,67,51,16,FMN 05 Gerard Le Grellelaan
653,Gerard le Grellelaan 10,2023-03-16,14:00:00,60,48,12,FMN 05 Gerard Le Grellelaan
653,Gerard le Grellelaan 10,2023-03-16,15:00:00,100,82,18,FMN 05 Gerard Le Grellelaan
653,Gerard le Grellelaan 10,2023-03-16,16:00:00,166,134,32,FMN 05 Gerard Le Grellelaan
653,Gerard le Grellelaan 10,2023-03-16,17:00:00,199,158,41,FMN 05 Gerard Le Grellelaan
653,Gerard le Grellelaan 10,2023-03-16,18:00:00,161,128,33,FMN 05 Gerard Le Grellelaan
653,Gerard le Grellelaan 10,2023-03-16,19:00:00,77,61,16,FMN 05 Gerard Le Grellelaan
653,Gerard le Grellelaan 10,2023-03-16,20:00:00,46,41,5,FMN 05 Gerard Le Grellelaan
653,Gerard le Grellelaan 10,2023-03-16,21:00:00,32,22,10,FMN 05 Gerard Le Grellelaan
653,Gerard le Grellelaan 10,2023-03-16,22:00:00,40,36,4,FMN 05 Gerard Le Grellelaan
653,Gerard le Grellelaan 10,2023-03-16,23:00:00,29,22,7,FMN 05 Gerard Le Grellelaan
653,Gerard le Grellelaan 10,2023-03-17,00:00:00,4,1,3,FMN 05 Gerard Le Grellelaan
653,Gerard le Grellelaan 10,2023-03-17,01:00:00,3,2,1,FMN 05 Gerard Le Grellelaan
653,Gerard le Grellelaan 10,2023-03-17,02:00:00,1,1,0,FMN 05 Gerard Le Grellelaan
653,Gerard le Grellelaan 10,2023-03-17,03:00:00,6,4,2,FMN 05 Gerard Le Grellelaan
653,Gerard le Grellelaan 10,2023-03-17,04:00:00,5,1,4,FMN 05 Gerard Le Grellelaan
653,Gerard le Grellelaan 10,2023-03-17,05:00:00,21,9,12,FMN 05 Gerard Le Grellelaan
653,Gerard le Grellelaan 10,2023-03-17,06:00:00,54,25,29,FMN 05 Gerard Le Grellelaan
653,Gerard le Grellelaan 10,2023-03-17,07:00:00,123,98,25,FMN 05 Gerard Le Grellelaan
653,Gerard le Grellelaan 10,2023-03-17,08:00:00,236,185,51,FMN 05 Gerard Le Grellelaan
653,Gerard le Grellelaan 10,2023-03-17,09:00:00,71,58,13,FMN 05 Gerard Le Grellelaan
653,Gerard le Grellelaan 10,2023-03-17,10:00:00,70,62,8,FMN 05 Gerard Le Grellelaan
653,Gerard le Grellelaan 10,2023-03-17,11:00:00,65,51,14,FMN 05 Gerard Le Grellelaan
653,Gerard le Grellelaan 10,2023-03-17,12:00:00,95,78,17,FMN 05 Gerard Le Grellelaan
653,Gerard le Grellelaan 10,2023-03-17,13:00:00,74,59,15,FMN 05 Gerard Le Grellelaan
653,Gerard le Grellelaan 10,2023-03-17,14:00:00,96,72,24,FMN 05 Gerard Le Grellelaan
653,Gerard le Grellelaan 10,2023-03-17,15:00:00,173,134,39,FMN 05 Gerard Le Grellelaan
653,Gerard le Grellelaan 10,2023-03-17,16:00:00,171,142,29,FMN 05 Gerard Le Grellelaan
653,Gerard le Grellelaan 10,2023-03-17,17:00:00,178,143,35,FMN 05 Gerard Le Grellelaan
653,Gerard le Grellelaan 10,2023-03-17,18:00:00,122,104,18,FMN 05 Gerard Le Grellelaan
653,Gerard le Grellelaan 10,2023-03-17,19:00:00,92,77,15,FMN 05 Gerard Le Grellelaan
653,Gerard le Grellelaan 10,2023-03-17,20:00:00,55,47,8,FMN 05 Gerard Le Grellelaan
653,Gerard le Grellelaan 10,2023-03-17,21:00:00,35,27,8,FMN 05 Gerard Le Grellelaan
653,Gerard le Grellelaan 10,2023-03-17,22:00:00,30,25,5,FMN 05 Gerard Le Grellelaan
653,Gerard le Grellelaan 10,2023-03-17,23:00:00,28,25,3,FMN 05 Gerard Le Grellelaan
653,Gerard le Grellelaan 10,2023-03-18,00:00:00,24,22,2,FMN 05 Gerard Le Grellelaan
653,Gerard le Grellelaan 10,2023-03-18,01:00:00,14,12,2,FMN 05 Gerard Le Grellelaan
653,Gerard le Grellelaan 10,2023-03-18,02:00:00,3,1,2,FMN 05 Gerard Le Grellelaan
653,Gerard le Grellelaan 10,2023-03-18,03:00:00,5,5,0,FMN 05 Gerard Le Grellelaan
653,Gerard le Grellelaan 10,2023-03-18,04:00:00,10,3,7,FMN 05 Gerard Le Grellelaan
653,Gerard le Grellelaan 10,2023-03-18,05:00:00,3,1,2,FMN 05 Gerard Le Grellelaan
653,Gerard le Grellelaan 10,2023-03-18,06:00:00,12,7,5,FMN 05 Gerard Le Grellelaan
653,Gerard le Grellelaan 10,2023-03-18,07:00:00,9,9,0,FMN 05 Gerard Le Grellelaan
653,Gerard le Grellelaan 10,2023-03-18,08:00:00,32,24,8,FMN 05 Gerard Le Grellelaan
653,Gerard le Grellelaan 10,2023-03-18,09:00:00,53,38,15,FMN 05 Gerard Le Grellelaan
653,Gerard le Grellelaan 10,2023-03-18,10:00:00,65,54,11,FMN 05 Gerard Le Grellelaan
653,Gerard le Grellelaan 10,2023-03-18,11:00:00,68,49,19,FMN 05 Gerard Le Grellelaan
653,Gerard le Grellelaan 10,2023-03-18,12:00:00,115,103,12,FMN 05 Gerard Le Grellelaan
653,Gerard le Grellelaan 10,2023-03-18,13:00:00,70,59,11,FMN 05 Gerard Le Grellelaan
653,Gerard le Grellelaan 10,2023-03-18,14:00:00,83,65,18,FMN 05 Gerard Le Grellelaan
653,Gerard le Grellelaan 10,2023-03-18,15:00:00,97,76,21,FMN 05 Gerard Le Grellelaan
653,Gerard le Grellelaan 10,2023-03-18,16:00:00,75,59,16,FMN 05 Gerard Le Grellelaan
653,Gerard le Grellelaan 10,2023-03-18,17:00:00,90,66,24,FMN 05 Gerard Le Grellelaan
653,Gerard le Grellelaan 10,2023-03-18,18:00:00,57,48,9,FMN 05 Gerard Le Grellelaan
653,Gerard le Grellelaan 10,2023-03-18,19:00:00,40,29,11,FMN 05 Gerard Le Grellelaan
653,Gerard le Grellelaan 10,2023-03-18,20:00:00,28,19,9,FMN 05 Gerard Le Grellelaan
653,Gerard le Grellelaan 10,2023-03-18,21:00:00,19,15,4,FMN 05 Gerard Le Grellelaan
653,Gerard le Grellelaan 10,2023-03-18,22:00:00,13,10,3,FMN 05 Gerard Le Grellelaan
653,Gerard le Grellelaan 10,2023-03-18,23:00:00,11,7,4,FMN 05 Gerard Le Grellelaan
653,Gerard le Grellelaan 10,2023-03-19,00:00:00,5,5,0,FMN 05 Gerard Le Grellelaan
653,Gerard le Grellelaan 10,2023-03-19,01:00:00,6,4,2,FMN 05 Gerard Le Grellelaan
653,Gerard le Grellelaan 10,2023-03-19,02:00:00,5,4,1,FMN 05 Gerard Le Grellelaan
653,Gerard le Grellelaan 10,2023-03-19,03:00:00,3,2,1,FMN 05 Gerard Le Grellelaan
653,Gerard le Grellelaan 10,2023-03-19,04:00:00,5,2,3,FMN 05 Gerard Le Grellelaan
653,Gerard le Grellelaan 10,2023-03-19,05:00:00,3,2,1,FMN 05 Gerard Le Grellelaan
653,Gerard le Grellelaan 10,2023-03-19,06:00:00,5,2,3,FMN 05 Gerard Le Grellelaan
653,Gerard le Grellelaan 10,2023-03-19,07:00:00,8,5,3,FMN 05 Gerard Le Grellelaan
653,Gerard le Grellelaan 10,2023-03-19,08:00:00,20,18,2,FMN 05 Gerard Le Grellelaan
653,Gerard le Grellelaan 10,2023-03-19,09:00:00,47,40,7,FMN 05 Gerard Le Grellelaan
653,Gerard le Grellelaan 10,2023-03-19,10:00:00,61,47,14,FMN 05 Gerard Le Grellelaan
653,Gerard le Grellelaan 10,2023-03-19,11:00:00,57,48,9,FMN 05 Gerard Le Grellelaan
653,Gerard le Grellelaan 10,2023-03-19,12:00:00,78,68,10,FMN 05 Gerard Le Grellelaan
653,Gerard le Grellelaan 10,2023-03-19,13:00:00,72,52,20,FMN 05 Gerard Le Grellelaan
653,Gerard le Grellelaan 10,2023-03-19,14:00:00,63,56,7,FMN 05 Gerard Le Grellelaan
653,Gerard le Grellelaan 10,2023-03-19,15:00:00,56,44,12,FMN 05 Gerard Le Grellelaan
653,Gerard le Grellelaan 10,2023-03-19,16:00:00,61,50,11,FMN 05 Gerard Le Grellelaan
653,Gerard le Grellelaan 10,2023-03-19,17:00:00,62,57,5,FMN 05 Gerard Le Grellelaan
653,Gerard le Grellelaan 10,2023-03-19,18:00:00,58,51,7,FMN 05 Gerard Le Grellelaan
653,Gerard le Grellelaan 10,2023-03-19,19:00:00,29,24,5,FMN 05 Gerard Le Grellelaan
653,Gerard le Grellelaan 10,2023-03-19,20:00:00,28,18,10,FMN 05 Gerard Le Grellelaan
653,Gerard le Grellelaan 10,2023-03-19,21:00:00,21,13,8,FMN 05 Gerard Le Grellelaan
653,Gerard le Grellelaan 10,2023-03-19,22:00:00,22,16,6,FMN 05 Gerard Le Grellelaan
653,Gerard le Grellelaan 10,2023-03-19,23:00:00,10,5,5,FMN 05 Gerard Le Grellelaan
653,Gerard le Grellelaan 10,2023-03-20,00:00:00,1,0,1,FMN 05 Gerard Le Grellelaan
653,Gerard le Grellelaan 10,2023-03-20,01:00:00,0,0,0,FMN 05 Gerard Le Grellelaan
653,Gerard le Grellelaan 10,2023-03-20,02:00:00,1,1,0,FMN 05 Gerard Le Grellelaan
653,Gerard le Grellelaan 10,2023-03-20,03:00:00,2,2,0,FMN 05 Gerard Le Grellelaan
653,Gerard le Grellelaan 10,2023-03-20,04:00:00,7,3,4,FMN 05 Gerard Le Grellelaan
653,Gerard le Grellelaan 10,2023-03-20,05:00:00,16,5,11,FMN 05 Gerard Le Grellelaan
653,Gerard le Grellelaan 10,2023-03-20,06:00:00,56,33,23,FMN 05 Gerard Le Grellelaan
653,Gerard le Grellelaan 10,2023-03-20,07:00:00,137,104,33,FMN 05 Gerard Le Grellelaan
653,Gerard le Grellelaan 10,2023-03-20,08:00:00,249,206,43,FMN 05 Gerard Le Grellelaan
653,Gerard le Grellelaan 10,2023-03-20,09:00:00,87,74,13,FMN 05 Gerard Le Grellelaan
653,Gerard le Grellelaan 10,2023-03-20,10:00:00,43,37,6,FMN 05 Gerard Le Grellelaan
653,Gerard le Grellelaan 10,2023-03-20,11:00:00,45,37,8,FMN 05 Gerard Le Grellelaan
653,Gerard le Grellelaan 10,2023-03-20,12:00:00,84,66,18,FMN 05 Gerard Le Grellelaan
653,Gerard le Grellelaan 10,2023-03-20,13:00:00,71,51,20,FMN 05 Gerard Le Grellelaan
653,Gerard le Grellelaan 10,2023-03-20,14:00:00,77,66,11,FMN 05 Gerard Le Grellelaan
653,Gerard le Grellelaan 10,2023-03-20,15:00:00,122,97,25,FMN 05 Gerard Le Grellelaan
653,Gerard le Grellelaan 10,2023-03-20,16:00:00,130,112,18,FMN 05 Gerard Le Grellelaan
653,Gerard le Grellelaan 10,2023-03-20,17:00:00,199,161,38,FMN 05 Gerard Le Grellelaan
653,Gerard le Grellelaan 10,2023-03-20,18:00:00,121,104,17,FMN 05 Gerard Le Grellelaan
653,Gerard le Grellelaan 10,2023-03-20,19:00:00,60,50,10,FMN 05 Gerard Le Grellelaan
653,Gerard le Grellelaan 10,2023-03-20,20:00:00,47,37,10,FMN 05 Gerard Le Grellelaan
653,Gerard le Grellelaan 10,2023-03-20,21:00:00,31,21,10,FMN 05 Gerard Le Grellelaan
653,Gerard le Grellelaan 10,2023-03-20,22:00:00,34,22,12,FMN 05 Gerard Le Grellelaan
653,Gerard le Grellelaan 10,2023-03-20,23:00:00,15,10,5,FMN 05 Gerard Le Grellelaan
653,Gerard le Grellelaan 10,2023-03-21,00:00:00,4,2,2,FMN 05 Gerard Le Grellelaan
653,Gerard le Grellelaan 10,2023-03-21,01:00:00,3,3,0,FMN 05 Gerard Le Grellelaan
653,Gerard le Grellelaan 10,2023-03-21,02:00:00,2,2,0,FMN 05 Gerard Le Grellelaan
653,Gerard le Grellelaan 10,2023-03-21,03:00:00,2,2,0,FMN 05 Gerard Le Grellelaan
653,Gerard le Grellelaan 10,2023-03-21,04:00:00,7,4,3,FMN 05 Gerard Le Grellelaan
653,Gerard le Grellelaan 10,2023-03-21,05:00:00,28,10,18,FMN 05 Gerard Le Grellelaan
653,Gerard le Grellelaan 10,2023-03-21,06:00:00,46,25,21,FMN 05 Gerard Le Grellelaan
653,Gerard le Grellelaan 10,2023-03-21,07:00:00,146,99,47,FMN 05 Gerard Le Grellelaan
653,Gerard le Grellelaan 10,2023-03-21,08:00:00,300,249,51,FMN 05 Gerard Le Grellelaan
653,Gerard le Grellelaan 10,2023-03-21,09:00:00,88,77,11,FMN 05 Gerard Le Grellelaan
653,Gerard le Grellelaan 10,2023-03-21,10:00:00,60,45,15,FMN 05 Gerard Le Grellelaan
653,Gerard le Grellelaan 10,2023-03-21,11:00:00,66,55,11,FMN 05 Gerard Le Grellelaan
653,Gerard le Grellelaan 10,2023-03-21,12:00:00,81,56,25,FMN 05 Gerard Le Grellelaan
653,Gerard le Grellelaan 10,2023-03-21,13:00:00,90,68,22,FMN 05 Gerard Le Grellelaan
653,Gerard le Grellelaan 10,2023-03-21,14:00:00,79,69,10,FMN 05 Gerard Le Grellelaan
653,Gerard le Grellelaan 10,2023-03-21,15:00:00,160,128,32,FMN 05 Gerard Le Grellelaan
653,Gerard le Grellelaan 10,2023-03-21,16:00:00,187,139,48,FMN 05 Gerard Le Grellelaan
653,Gerard le Grellelaan 10,2023-03-21,17:00:00,232,187,45,FMN 05 Gerard Le Grellelaan
653,Gerard le Grellelaan 10,2023-03-21,18:00:00,125,99,26,FMN 05 Gerard Le Grellelaan
653,Gerard le Grellelaan 10,2023-03-21,19:00:00,66,49,17,FMN 05 Gerard Le Grellelaan
653,Gerard le Grellelaan 10,2023-03-21,20:00:00,52,47,5,FMN 05 Gerard Le Grellelaan
653,Gerard le Grellelaan 10,2023-03-21,21:00:00,40,30,10,FMN 05 Gerard Le Grellelaan
653,Gerard le Grellelaan 10,2023-03-21,22:00:00,40,36,4,FMN 05 Gerard Le Grellelaan
653,Gerard le Grellelaan 10,2023-03-21,23:00:00,15,13,2,FMN 05 Gerard Le Grellelaan
653,Gerard le Grellelaan 10,2023-03-22,00:00:00,3,0,3,FMN 05 Gerard Le Grellelaan
653,Gerard le Grellelaan 10,2023-03-22,01:00:00,2,1,1,FMN 05 Gerard Le Grellelaan
653,Gerard le Grellelaan 10,2023-03-22,02:00:00,2,2,0,FMN 05 Gerard Le Grellelaan
653,Gerard le Grellelaan 10,2023-03-22,03:00:00,5,4,1,FMN 05 Gerard Le Grellelaan
653,Gerard le Grellelaan 10,2023-03-22,04:00:00,10,7,3,FMN 05 Gerard Le Grellelaan
653,Gerard le Grellelaan 10,2023-03-22,05:00:00,24,9,15,FMN 05 Gerard Le Grellelaan
653,Gerard le Grellelaan 10,2023-03-22,06:00:00,49,24,25,FMN 05 Gerard Le Grellelaan
653,Gerard le Grellelaan 10,2023-03-22,07:00:00,128,94,34,FMN 05 Gerard Le Grellelaan
653,Gerard le Grellelaan 10,2023-03-22,08:00:00,245,189,56,FMN 05 Gerard Le Grellelaan
653,Gerard le Grellelaan 10,2023-03-22,09:00:00,83,68,15,FMN 05 Gerard Le Grellelaan
653,Gerard le Grellelaan 10,2023-03-22,10:00:00,75,61,14,FMN 05 Gerard Le Grellelaan
653,Gerard le Grellelaan 10,2023-03-22,11:00:00,58,47,11,FMN 05 Gerard Le Grellelaan
653,Gerard le Grellelaan 10,2023-03-22,12:00:00,137,102,35,FMN 05 Gerard Le Grellelaan
653,Gerard le Grellelaan 10,2023-03-22,13:00:00,76,59,17,FMN 05 Gerard Le Grellelaan
653,Gerard le Grellelaan 10,2023-03-22,14:00:00,77,66,11,FMN 05 Gerard Le Grellelaan
653,Gerard le Grellelaan 10,2023-03-22,15:00:00,115,95,20,FMN 05 Gerard Le Grellelaan
653,Gerard le Grellelaan 10,2023-03-22,16:00:00,137,116,21,FMN 05 Gerard Le Grellelaan
653,Gerard le Grellelaan 10,2023-03-22,17:00:00,136,110,26,FMN 05 Gerard Le Grellelaan
653,Gerard le Grellelaan 10,2023-03-22,18:00:00,110,93,17,FMN 05 Gerard Le Grellelaan
653,Gerard le Grellelaan 10,2023-03-22,19:00:00,62,53,9,FMN 05 Gerard Le Grellelaan
653,Gerard le Grellelaan 10,2023-03-22,20:00:00,42,31,11,FMN 05 Gerard Le Grellelaan
653,Gerard le Grellelaan 10,2023-03-22,21:00:00,27,22,5,FMN 05 Gerard Le Grellelaan
653,Gerard le Grellelaan 10,2023-03-22,22:00:00,33,25,8,FMN 05 Gerard Le Grellelaan
653,Gerard le Grellelaan 10,2023-03-22,23:00:00,8,6,2,FMN 05 Gerard Le Grellelaan
653,Gerard le Grellelaan 10,2023-03-23,00:00:00,8,6,2,FMN 05 Gerard Le Grellelaan
653,Gerard le Grellelaan 10,2023-03-23,01:00:00,6,4,2,FMN 05 Gerard Le Grellelaan
653,Gerard le Grellelaan 10,2023-03-23,02:00:00,6,4,2,FMN 05 Gerard Le Grellelaan
653,Gerard le Grellelaan 10,2023-03-23,03:00:00,3,3,0,FMN 05 Gerard Le Grellelaan
653,Gerard le Grellelaan 10,2023-03-23,04:00:00,6,2,4,FMN 05 Gerard Le Grellelaan
653,Gerard le Grellelaan 10,2023-03-23,05:00:00,23,8,15,FMN 05 Gerard Le Grellelaan
653,Gerard le Grellelaan 10,2023-03-23,06:00:00,34,18,16,FMN 05 Gerard Le Grellelaan
653,Gerard le Grellelaan 10,2023-03-23,07:00:00,106,80,26,FMN 05 Gerard Le Grellelaan
653,Gerard le Grellelaan 10,2023-03-23,08:00:00,228,175,53,FMN 05 Gerard Le Grellelaan
653,Gerard le Grellelaan 10,2023-03-23,09:00:00,76,63,13,FMN 05 Gerard Le Grellelaan
653,Gerard le Grellelaan 10,2023-03-23,10:00:00,65,58,7,FMN 05 Gerard Le Grellelaan
653,Gerard le Grellelaan 10,2023-03-23,11:00:00,62,51,11,FMN 05 Gerard Le Grellelaan
653,Gerard le Grellelaan 10,2023-03-23,12:00:00,74,58,16,FMN 05 Gerard Le Grellelaan
653,Gerard le Grellelaan 10,2023-03-23,13:00:00,67,49,18,FMN 05 Gerard Le Grellelaan
653,Gerard le Grellelaan 10,2023-03-23,14:00:00,56,44,12,FMN 05 Gerard Le Grellelaan
653,Gerard le Grellelaan 10,2023-03-23,15:00:00,139,114,25,FMN 05 Gerard Le Grellelaan
653,Gerard le Grellelaan 10,2023-03-23,16:00:00,159,125,34,FMN 05 Gerard Le Grellelaan
653,Gerard le Grellelaan 10,2023-03-23,17:00:00,156,123,33,FMN 05 Gerard Le Grellelaan
653,Gerard le Grellelaan 10,2023-03-23,18:00:00,123,97,26,FMN 05 Gerard Le Grellelaan
653,Gerard le Grellelaan 10,2023-03-23,19:00:00,54,43,11,FMN 05 Gerard Le Grellelaan
653,Gerard le Grellelaan 10,2023-03-23,20:00:00,36,28,8,FMN 05 Gerard Le Grellelaan
653,Gerard le Grellelaan 10,2023-03-23,21:00:00,33,23,10,FMN 05 Gerard Le Grellelaan
653,Gerard le Grellelaan 10,2023-03-23,22:00:00,38,31,7,FMN 05 Gerard Le Grellelaan
653,Gerard le Grellelaan 10,2023-03-23,23:00:00,10,7,3,FMN 05 Gerard Le Grellelaan
653,Gerard le Grellelaan 10,2023-03-24,00:00:00,5,4,1,FMN 05 Gerard Le Grellelaan
653,Gerard le Grellelaan 10,2023-03-24,01:00:00,4,4,0,FMN 05 Gerard Le Grellelaan
653,Gerard le Grellelaan 10,2023-03-24,02:00:00,3,3,0,FMN 05 Gerard Le Grellelaan
653,Gerard le Grellelaan 10,2023-03-24,03:00:00,7,7,0,FMN 05 Gerard Le Grellelaan
653,Gerard le Grellelaan 10,2023-03-24,04:00:00,5,3,2,FMN 05 Gerard Le Grellelaan
653,Gerard le Grellelaan 10,2023-03-24,05:00:00,20,5,15,FMN 05 Gerard Le Grellelaan
653,Gerard le Grellelaan 10,2023-03-24,06:00:00,47,25,22,FMN 05 Gerard Le Grellelaan
653,Gerard le Grellelaan 10,2023-03-24,07:00:00,127,99,28,FMN 05 Gerard Le Grellelaan
653,Gerard le Grellelaan 10,2023-03-24,08:00:00,287,233,54,FMN 05 Gerard Le Grellelaan
653,Gerard le Grellelaan 10,2023-03-24,09:00:00,73,65,8,FMN 05 Gerard Le Grellelaan
653,Gerard le Grellelaan 10,2023-03-24,10:00:00,71,60,11,FMN 05 Gerard Le Grellelaan
653,Gerard le Grellelaan 10,2023-03-24,11:00:00,49,40,9,FMN 05 Gerard Le Grellelaan
653,Gerard le Grellelaan 10,2023-03-24,12:00:00,77,59,18,FMN 05 Gerard Le Grellelaan
653,Gerard le Grellelaan 10,2023-03-24,13:00:00,46,36,10,FMN 05 Gerard Le Grellelaan
653,Gerard le Grellelaan 10,2023-03-24,14:00:00,72,57,15,FMN 05 Gerard Le Grellelaan
653,Gerard le Grellelaan 10,2023-03-24,15:00:00,131,104,27,FMN 05 Gerard Le Grellelaan
653,Gerard le Grellelaan 10,2023-03-24,16:00:00,185,147,38,FMN 05 Gerard Le Grellelaan
653,Gerard le Grellelaan 10,2023-03-24,17:00:00,144,109,35,FMN 05 Gerard Le Grellelaan
653,Gerard le Grellelaan 10,2023-03-24,18:00:00,102,80,22,FMN 05 Gerard Le Grellelaan
653,Gerard le Grellelaan 10,2023-03-24,19:00:00,54,44,10,FMN 05 Gerard Le Grellelaan
653,Gerard le Grellelaan 10,2023-03-24,20:00:00,50,35,15,FMN 05 Gerard Le Grellelaan
653,Gerard le Grellelaan 10,2023-03-24,21:00:00,29,22,7,FMN 05 Gerard Le Grellelaan
653,Gerard le Grellelaan 10,2023-03-24,22:00:00,22,17,5,FMN 05 Gerard Le Grellelaan
653,Gerard le Grellelaan 10,2023-03-24,23:00:00,19,17,2,FMN 05 Gerard Le Grellelaan
653,Gerard le Grellelaan 10,2023-03-25,00:00:00,12,10,2,FMN 05 Gerard Le Grellelaan
653,Gerard le Grellelaan 10,2023-03-25,01:00:00,4,0,4,FMN 05 Gerard Le Grellelaan
653,Gerard le Grellelaan 10,2023-03-25,02:00:00,3,2,1,FMN 05 Gerard Le Grellelaan
653,Gerard le Grellelaan 10,2023-03-25,03:00:00,4,4,0,FMN 05 Gerard Le Grellelaan
653,Gerard le Grellelaan 10,2023-03-25,04:00:00,3,3,0,FMN 05 Gerard Le Grellelaan
653,Gerard le Grellelaan 10,2023-03-25,05:00:00,3,1,2,FMN 05 Gerard Le Grellelaan
653,Gerard le Grellelaan 10,2023-03-25,06:00:00,7,5,2,FMN 05 Gerard Le Grellelaan
653,Gerard le Grellelaan 10,2023-03-25,07:00:00,19,16,3,FMN 05 Gerard Le Grellelaan
653,Gerard le Grellelaan 10,2023-03-25,08:00:00,28,22,6,FMN 05 Gerard Le Grellelaan
653,Gerard le Grellelaan 10,2023-03-25,09:00:00,36,27,9,FMN 05 Gerard Le Grellelaan
653,Gerard le Grellelaan 10,2023-03-25,10:00:00,29,18,11,FMN 05 Gerard Le Grellelaan
653,Gerard le Grellelaan 10,2023-03-25,11:00:00,42,35,7,FMN 05 Gerard Le Grellelaan
653,Gerard le Grellelaan 10,2023-03-25,12:00:00,49,41,8,FMN 05 Gerard Le Grellelaan
653,Gerard le Grellelaan 10,2023-03-25,13:00:00,54,45,9,FMN 05 Gerard Le Grellelaan
653,Gerard le Grellelaan 10,2023-03-25,14:00:00,54,37,17,FMN 05 Gerard Le Grellelaan
653,Gerard le Grellelaan 10,2023-03-25,15:00:00,49,39,10,FMN 05 Gerard Le Grellelaan
653,Gerard le Grellelaan 10,2023-03-25,16:00:00,56,47,9,FMN 05 Gerard Le Grellelaan
653,Gerard le Grellelaan 10,2023-03-25,17:00:00,0,0,0,FMN 05 Gerard Le Grellelaan
653,Gerard le Grellelaan 10,2023-03-25,18:00:00,5,5,0,FMN 05 Gerard Le Grellelaan
653,Gerard le Grellelaan 10,2023-03-25,19:00:00,50,38,12,FMN 05 Gerard Le Grellelaan
653,Gerard le Grellelaan 10,2023-03-25,20:00:00,33,26,7,FMN 05 Gerard Le Grellelaan
653,Gerard le Grellelaan 10,2023-03-25,21:00:00,22,17,5,FMN 05 Gerard Le Grellelaan
653,Gerard le Grellelaan 10,2023-03-25,22:00:00,26,21,5,FMN 05 Gerard Le Grellelaan
653,Gerard le Grellelaan 10,2023-03-25,23:00:00,17,13,4,FMN 05 Gerard Le Grellelaan
653,Gerard le Grellelaan 10,2023-03-26,00:00:00,14,10,4,FMN 05 Gerard Le Grellelaan
653,Gerard le Grellelaan 10,2023-03-26,01:00:00,12,9,3,FMN 05 Gerard Le Grellelaan
653,Gerard le Grellelaan 10,2023-03-26,02:00:00,0,0,0,FMN 05 Gerard Le Grellelaan
653,Gerard le Grellelaan 10,2023-03-26,03:00:00,2,1,1,FMN 05 Gerard Le Grellelaan
653,Gerard le Grellelaan 10,2023-03-26,04:00:00,17,8,9,FMN 05 Gerard Le Grellelaan
653,Gerard le Grellelaan 10,2023-03-26,05:00:00,1,1,0,FMN 05 Gerard Le Grellelaan
653,Gerard le Grellelaan 10,2023-03-26,06:00:00,5,4,1,FMN 05 Gerard Le Grellelaan
653,Gerard le Grellelaan 10,2023-03-26,07:00:00,4,3,1,FMN 05 Gerard Le Grellelaan
653,Gerard le Grellelaan 10,2023-03-26,08:00:00,13,9,4,FMN 05 Gerard Le Grellelaan
653,Gerard le Grellelaan 10,2023-03-26,09:00:00,19,15,4,FMN 05 Gerard Le Grellelaan
653,Gerard le Grellelaan 10,2023-03-26,10:00:00,25,19,6,FMN 05 Gerard Le Grellelaan
653,Gerard le Grellelaan 10,2023-03-26,11:00:00,39,28,11,FMN 05 Gerard Le Grellelaan
653,Gerard le Grellelaan 10,2023-03-26,12:00:00,43,38,5,FMN 05 Gerard Le Grellelaan
653,Gerard le Grellelaan 10,2023-03-26,13:00:00,30,24,6,FMN 05 Gerard Le Grellelaan
653,Gerard le Grellelaan 10,2023-03-26,14:00:00,39,29,10,FMN 05 Gerard Le Grellelaan
653,Gerard le Grellelaan 10,2023-03-26,15:00:00,36,24,12,FMN 05 Gerard Le Grellelaan
653,Gerard le Grellelaan 10,2023-03-26,16:00:00,29,24,5,FMN 05 Gerard Le Grellelaan
653,Gerard le Grellelaan 10,2023-03-26,17:00:00,33,22,11,FMN 05 Gerard Le Grellelaan
653,Gerard le Grellelaan 10,2023-03-26,18:00:00,24,21,3,FMN 05 Gerard Le Grellelaan
653,Gerard le Grellelaan 10,2023-03-26,19:00:00,43,37,6,FMN 05 Gerard Le Grellelaan
653,Gerard le Grellelaan 10,2023-03-26,20:00:00,26,21,5,FMN 05 Gerard Le Grellelaan
653,Gerard le Grellelaan 10,2023-03-26,21:00:00,24,16,8,FMN 05 Gerard Le Grellelaan
653,Gerard le Grellelaan 10,2023-03-26,22:00:00,15,11,4,FMN 05 Gerard Le Grellelaan
653,Gerard le Grellelaan 10,2023-03-26,23:00:00,8,5,3,FMN 05 Gerard Le Grellelaan
653,Gerard le Grellelaan 10,2023-03-27,00:00:00,5,5,0,FMN 05 Gerard Le Grellelaan
653,Gerard le Grellelaan 10,2023-03-27,01:00:00,3,3,0,FMN 05 Gerard Le Grellelaan
653,Gerard le Grellelaan 10,2023-03-27,02:00:00,3,3,0,FMN 05 Gerard Le Grellelaan
653,Gerard le Grellelaan 10,2023-03-27,03:00:00,1,1,0,FMN 05 Gerard Le Grellelaan
653,Gerard le Grellelaan 10,2023-03-27,04:00:00,6,3,3,FMN 05 Gerard Le Grellelaan
653,Gerard le Grellelaan 10,2023-03-27,05:00:00,27,8,19,FMN 05 Gerard Le Grellelaan
653,Gerard le Grellelaan 10,2023-03-27,06:00:00,45,23,22,FMN 05 Gerard Le Grellelaan
653,Gerard le Grellelaan 10,2023-03-27,07:00:00,107,84,23,FMN 05 Gerard Le Grellelaan
653,Gerard le Grellelaan 10,2023-03-27,08:00:00,243,203,40,FMN 05 Gerard Le Grellelaan
653,Gerard le Grellelaan 10,2023-03-27,09:00:00,92,80,12,FMN 05 Gerard Le Grellelaan
653,Gerard le Grellelaan 10,2023-03-27,10:00:00,75,64,11,FMN 05 Gerard Le Grellelaan
653,Gerard le Grellelaan 10,2023-03-27,11:00:00,51,44,7,FMN 05 Gerard Le Grellelaan
653,Gerard le Grellelaan 10,2023-03-27,12:00:00,79,68,11,FMN 05 Gerard Le Grellelaan
653,Gerard le Grellelaan 10,2023-03-27,13:00:00,9,7,2,FMN 05 Gerard Le Grellelaan
653,Gerard le Grellelaan 10,2023-03-27,14:00:00,61,49,12,FMN 05 Gerard Le Grellelaan
653,Gerard le Grellelaan 10,2023-03-27,15:00:00,164,133,31,FMN 05 Gerard Le Grellelaan
653,Gerard le Grellelaan 10,2023-03-27,16:00:00,154,122,32,FMN 05 Gerard Le Grellelaan
653,Gerard le Grellelaan 10,2023-03-27,17:00:00,208,157,51,FMN 05 Gerard Le Grellelaan
653,Gerard le Grellelaan 10,2023-03-27,18:00:00,139,113,26,FMN 05 Gerard Le Grellelaan
653,Gerard le Grellelaan 10,2023-03-27,19:00:00,85,60,25,FMN 05 Gerard Le Grellelaan
653,Gerard le Grellelaan 10,2023-03-27,20:00:00,54,45,9,FMN 05 Gerard Le Grellelaan
653,Gerard le Grellelaan 10,2023-03-27,21:00:00,49,34,15,FMN 05 Gerard Le Grellelaan
653,Gerard le Grellelaan 10,2023-03-27,22:00:00,31,21,10,FMN 05 Gerard Le Grellelaan
653,Gerard le Grellelaan 10,2023-03-27,23:00:00,18,12,6,FMN 05 Gerard Le Grellelaan
653,Gerard le Grellelaan 10,2023-03-28,00:00:00,7,6,1,FMN 05 Gerard Le Grellelaan
653,Gerard le Grellelaan 10,2023-03-28,01:00:00,3,2,1,FMN 05 Gerard Le Grellelaan
653,Gerard le Grellelaan 10,2023-03-28,02:00:00,3,2,1,FMN 05 Gerard Le Grellelaan
653,Gerard le Grellelaan 10,2023-03-28,03:00:00,2,2,0,FMN 05 Gerard Le Grellelaan
653,Gerard le Grellelaan 10,2023-03-28,04:00:00,6,1,5,FMN 05 Gerard Le Grellelaan
653,Gerard le Grellelaan 10,2023-03-28,05:00:00,19,8,11,FMN 05 Gerard Le Grellelaan
653,Gerard le Grellelaan 10,2023-03-28,06:00:00,32,20,12,FMN 05 Gerard Le Grellelaan
653,Gerard le Grellelaan 10,2023-03-28,07:00:00,104,81,23,FMN 05 Gerard Le Grellelaan
653,Gerard le Grellelaan 10,2023-03-28,08:00:00,245,196,49,FMN 05 Gerard Le Grellelaan
653,Gerard le Grellelaan 10,2023-03-28,09:00:00,84,75,9,FMN 05 Gerard Le Grellelaan
653,Gerard le Grellelaan 10,2023-03-28,10:00:00,59,54,5,FMN 05 Gerard Le Grellelaan
653,Gerard le Grellelaan 10,2023-03-28,11:00:00,57,50,7,FMN 05 Gerard Le Grellelaan
653,Gerard le Grellelaan 10,2023-03-28,12:00:00,86,69,17,FMN 05 Gerard Le Grellelaan
653,Gerard le Grellelaan 10,2023-03-28,13:00:00,72,57,15,FMN 05 Gerard Le Grellelaan
653,Gerard le Grellelaan 10,2023-03-28,14:00:00,80,65,15,FMN 05 Gerard Le Grellelaan
653,Gerard le Grellelaan 10,2023-03-28,15:00:00,114,94,20,FMN 05 Gerard Le Grellelaan
653,Gerard le Grellelaan 10,2023-03-28,16:00:00,179,138,41,FMN 05 Gerard Le Grellelaan
653,Gerard le Grellelaan 10,2023-03-28,17:00:00,194,149,45,FMN 05 Gerard Le Grellelaan
653,Gerard le Grellelaan 10,2023-03-28,18:00:00,155,119,36,FMN 05 Gerard Le Grellelaan
653,Gerard le Grellelaan 10,2023-03-28,19:00:00,58,50,8,FMN 05 Gerard Le Grellelaan
653,Gerard le Grellelaan 10,2023-03-28,20:00:00,44,36,8,FMN 05 Gerard Le Grellelaan
653,Gerard le Grellelaan 10,2023-03-28,21:00:00,22,17,5,FMN 05 Gerard Le Grellelaan
653,Gerard le Grellelaan 10,2023-03-28,22:00:00,29,28,1,FMN 05 Gerard Le Grellelaan
653,Gerard le Grellelaan 10,2023-03-28,23:00:00,15,10,5,FMN 05 Gerard Le Grellelaan
653,Gerard le Grellelaan 10,2023-03-29,00:00:00,4,4,0,FMN 05 Gerard Le Grellelaan
653,Gerard le Grellelaan 10,2023-03-29,01:00:00,2,1,1,FMN 05 Gerard Le Grellelaan
653,Gerard le Grellelaan 10,2023-03-29,02:00:00,3,3,0,FMN 05 Gerard Le Grellelaan
653,Gerard le Grellelaan 10,2023-03-29,03:00:00,4,3,1,FMN 05 Gerard Le Grellelaan
653,Gerard le Grellelaan 10,2023-03-29,04:00:00,13,3,10,FMN 05 Gerard Le Grellelaan
653,Gerard le Grellelaan 10,2023-03-29,05:00:00,26,11,15,FMN 05 Gerard Le Grellelaan
653,Gerard le Grellelaan 10,2023-03-29,06:00:00,50,29,21,FMN 05 Gerard Le Grellelaan
653,Gerard le Grellelaan 10,2023-03-29,07:00:00,123,86,37,FMN 05 Gerard Le Grellelaan
653,Gerard le Grellelaan 10,2023-03-29,08:00:00,247,196,51,FMN 05 Gerard Le Grellelaan
653,Gerard le Grellelaan 10,2023-03-29,09:00:00,78,68,10,FMN 05 Gerard Le Grellelaan
653,Gerard le Grellelaan 10,2023-03-29,10:00:00,58,48,10,FMN 05 Gerard Le Grellelaan
653,Gerard le Grellelaan 10,2023-03-29,11:00:00,74,63,11,FMN 05 Gerard Le Grellelaan
653,Gerard le Grellelaan 10,2023-03-29,12:00:00,149,117,32,FMN 05 Gerard Le Grellelaan
653,Gerard le Grellelaan 10,2023-03-29,13:00:00,104,78,26,FMN 05 Gerard Le Grellelaan
653,Gerard le Grellelaan 10,2023-03-29,14:00:00,85,67,18,FMN 05 Gerard Le Grellelaan
653,Gerard le Grellelaan 10,2023-03-29,15:00:00,134,113,21,FMN 05 Gerard Le Grellelaan
653,Gerard le Grellelaan 10,2023-03-29,16:00:00,171,142,29,FMN 05 Gerard Le Grellelaan
653,Gerard le Grellelaan 10,2023-03-29,17:00:00,189,153,36,FMN 05 Gerard Le Grellelaan
653,Gerard le Grellelaan 10,2023-03-29,18:00:00,120,97,23,FMN 05 Gerard Le Grellelaan
653,Gerard le Grellelaan 10,2023-03-29,19:00:00,90,72,18,FMN 05 Gerard Le Grellelaan
653,Gerard le Grellelaan 10,2023-03-29,20:00:00,62,47,15,FMN 05 Gerard Le Grellelaan
653,Gerard le Grellelaan 10,2023-03-29,21:00:00,49,45,4,FMN 05 Gerard Le Grellelaan
653,Gerard le Grellelaan 10,2023-03-29,22:00:00,42,35,7,FMN 05 Gerard Le Grellelaan
653,Gerard le Grellelaan 10,2023-03-29,23:00:00,16,11,5,FMN 05 Gerard Le Grellelaan
653,Gerard le Grellelaan 10,2023-03-30,00:00:00,10,9,1,FMN 05 Gerard Le Grellelaan
653,Gerard le Grellelaan 10,2023-03-30,01:00:00,0,0,0,FMN 05 Gerard Le Grellelaan
653,Gerard le Grellelaan 10,2023-03-30,02:00:00,1,1,0,FMN 05 Gerard Le Grellelaan
653,Gerard le Grellelaan 10,2023-03-30,03:00:00,6,6,0,FMN 05 Gerard Le Grellelaan
653,Gerard le Grellelaan 10,2023-03-30,04:00:00,11,3,8,FMN 05 Gerard Le Grellelaan
653,Gerard le Grellelaan 10,2023-03-30,05:00:00,36,12,24,FMN 05 Gerard Le Grellelaan
653,Gerard le Grellelaan 10,2023-03-30,06:00:00,53,23,30,FMN 05 Gerard Le Grellelaan
653,Gerard le Grellelaan 10,2023-03-30,07:00:00,133,99,34,FMN 05 Gerard Le Grellelaan
653,Gerard le Grellelaan 10,2023-03-30,08:00:00,254,201,53,FMN 05 Gerard Le Grellelaan
653,Gerard le Grellelaan 10,2023-03-30,09:00:00,106,83,23,FMN 05 Gerard Le Grellelaan
653,Gerard le Grellelaan 10,2023-03-30,10:00:00,56,46,10,FMN 05 Gerard Le Grellelaan
653,Gerard le Grellelaan 10,2023-03-30,11:00:00,59,51,8,FMN 05 Gerard Le Grellelaan
653,Gerard le Grellelaan 10,2023-03-30,12:00:00,72,57,15,FMN 05 Gerard Le Grellelaan
653,Gerard le Grellelaan 10,2023-03-30,13:00:00,73,58,15,FMN 05 Gerard Le Grellelaan
653,Gerard le Grellelaan 10,2023-03-30,14:00:00,94,78,16,FMN 05 Gerard Le Grellelaan
653,Gerard le Grellelaan 10,2023-03-30,15:00:00,133,102,31,FMN 05 Gerard Le Grellelaan
653,Gerard le Grellelaan 10,2023-03-30,16:00:00,187,140,47,FMN 05 Gerard Le Grellelaan
653,Gerard le Grellelaan 10,2023-03-30,17:00:00,181,144,37,FMN 05 Gerard Le Grellelaan
653,Gerard le Grellelaan 10,2023-03-30,18:00:00,129,103,26,FMN 05 Gerard Le Grellelaan
653,Gerard le Grellelaan 10,2023-03-30,19:00:00,104,86,18,FMN 05 Gerard Le Grellelaan
653,Gerard le Grellelaan 10,2023-03-30,20:00:00,63,47,16,FMN 05 Gerard Le Grellelaan
653,Gerard le Grellelaan 10,2023-03-30,21:00:00,40,31,9,FMN 05 Gerard Le Grellelaan
653,Gerard le Grellelaan 10,2023-03-30,22:00:00,30,26,4,FMN 05 Gerard Le Grellelaan
653,Gerard le Grellelaan 10,2023-03-30,23:00:00,25,14,11,FMN 05 Gerard Le Grellelaan
653,Gerard le Grellelaan 10,2023-03-31,00:00:00,5,4,1,FMN 05 Gerard Le Grellelaan
653,Gerard le Grellelaan 10,2023-03-31,01:00:00,9,9,0,FMN 05 Gerard Le Grellelaan
653,Gerard le Grellelaan 10,2023-03-31,02:00:00,3,2,1,FMN 05 Gerard Le Grellelaan
653,Gerard le Grellelaan 10,2023-03-31,03:00:00,4,4,0,FMN 05 Gerard Le Grellelaan
653,Gerard le Grellelaan 10,2023-03-31,04:00:00,9,4,5,FMN 05 Gerard Le Grellelaan
653,Gerard le Grellelaan 10,2023-03-31,05:00:00,22,9,13,FMN 05 Gerard Le Grellelaan
653,Gerard le Grellelaan 10,2023-03-31,06:00:00,32,16,16,FMN 05 Gerard Le Grellelaan
653,Gerard le Grellelaan 10,2023-03-31,07:00:00,73,50,23,FMN 05 Gerard Le Grellelaan
653,Gerard le Grellelaan 10,2023-03-31,08:00:00,185,152,33,FMN 05 Gerard Le Grellelaan
653,Gerard le Grellelaan 10,2023-03-31,09:00:00,57,48,9,FMN 05 Gerard Le Grellelaan
653,Gerard le Grellelaan 10,2023-03-31,10:00:00,47,39,8,FMN 05 Gerard Le Grellelaan
653,Gerard le Grellelaan 10,2023-03-31,11:00:00,41,32,9,FMN 05 Gerard Le Grellelaan
653,Gerard le Grellelaan 10,2023-03-31,12:00:00,47,36,11,FMN 05 Gerard Le Grellelaan
653,Gerard le Grellelaan 10,2023-03-31,13:00:00,54,41,13,FMN 05 Gerard Le Grellelaan
653,Gerard le Grellelaan 10,2023-03-31,14:00:00,45,39,6,FMN 05 Gerard Le Grellelaan
653,Gerard le Grellelaan 10,2023-03-31,15:00:00,104,78,26,FMN 05 Gerard Le Grellelaan
653,Gerard le Grellelaan 10,2023-03-31,16:00:00,114,93,21,FMN 05 Gerard Le Grellelaan
653,Gerard le Grellelaan 10,2023-03-31,17:00:00,102,88,14,FMN 05 Gerard Le Grellelaan
653,Gerard le Grellelaan 10,2023-03-31,18:00:00,77,58,19,FMN 05 Gerard Le Grellelaan
653,Gerard le Grellelaan 10,2023-03-31,19:00:00,44,39,5,FMN 05 Gerard Le Grellelaan
653,Gerard le Grellelaan 10,2023-03-31,20:00:00,36,32,4,FMN 05 Gerard Le Grellelaan
653,Gerard le Grellelaan 10,2023-03-31,21:00:00,14,12,2,FMN 05 Gerard Le Grellelaan
653,Gerard le Grellelaan 10,2023-03-31,22:00:00,19,15,4,FMN 05 Gerard Le Grellelaan
653,Gerard le Grellelaan 10,2023-03-31,23:00:00,13,9,4,FMN 05 Gerard Le Grellelaan
653,Gerard le Grellelaan 10,2023-04-01,00:00:00,8,6,2,FMN 05 Gerard Le Grellelaan
653,Gerard le Grellelaan 10,2023-04-01,01:00:00,12,8,4,FMN 05 Gerard Le Grellelaan
653,Gerard le Grellelaan 10,2023-04-01,02:00:00,6,4,2,FMN 05 Gerard Le Grellelaan
653,Gerard le Grellelaan 10,2023-04-01,03:00:00,8,5,3,FMN 05 Gerard Le Grellelaan
653,Gerard le Grellelaan 10,2023-04-01,04:00:00,2,1,1,FMN 05 Gerard Le Grellelaan
653,Gerard le Grellelaan 10,2023-04-01,05:00:00,6,5,1,FMN 05 Gerard Le Grellelaan
653,Gerard le Grellelaan 10,2023-04-01,06:00:00,4,2,2,FMN 05 Gerard Le Grellelaan
653,Gerard le Grellelaan 10,2023-04-01,07:00:00,6,4,2,FMN 05 Gerard Le Grellelaan
653,Gerard le Grellelaan 10,2023-04-01,08:00:00,7,3,4,FMN 05 Gerard Le Grellelaan
653,Gerard le Grellelaan 10,2023-04-01,09:00:00,18,15,3,FMN 05 Gerard Le Grellelaan
653,Gerard le Grellelaan 10,2023-04-01,10:00:00,17,15,2,FMN 05 Gerard Le Grellelaan
653,Gerard le Grellelaan 10,2023-04-01,11:00:00,23,18,5,FMN 05 Gerard Le Grellelaan
653,Gerard le Grellelaan 10,2023-04-01,12:00:00,21,19,2,FMN 05 Gerard Le Grellelaan
653,Gerard le Grellelaan 10,2023-04-01,13:00:00,2,0,2,FMN 05 Gerard Le Grellelaan
653,Gerard le Grellelaan 10,2023-04-01,14:00:00,0,0,0,FMN 05 Gerard Le Grellelaan
653,Gerard le Grellelaan 10,2023-04-01,15:00:00,0,0,0,FMN 05 Gerard Le Grellelaan
653,Gerard le Grellelaan 10,2023-04-01,16:00:00,0,0,0,FMN 05 Gerard Le Grellelaan
653,Gerard le Grellelaan 10,2023-04-01,17:00:00,0,0,0,FMN 05 Gerard Le Grellelaan
653,Gerard le Grellelaan 10,2023-04-01,18:00:00,0,0,0,FMN 05 Gerard Le Grellelaan
653,Gerard le Grellelaan 10,2023-04-01,19:00:00,0,0,0,FMN 05 Gerard Le Grellelaan
653,Gerard le Grellelaan 10,2023-04-01,20:00:00,0,0,0,FMN 05 Gerard Le Grellelaan
653,Gerard le Grellelaan 10,2023-04-01,21:00:00,0,0,0,FMN 05 Gerard Le Grellelaan
653,Gerard le Grellelaan 10,2023-04-01,22:00:00,0,0,0,FMN 05 Gerard Le Grellelaan
653,Gerard le Grellelaan 10,2023-04-01,23:00:00,0,0,0,FMN 05 Gerard Le Grellelaan
653,Gerard le Grellelaan 10,2023-04-02,00:00:00,8,5,3,FMN 05 Gerard Le Grellelaan
653,Gerard le Grellelaan 10,2023-04-02,01:00:00,6,3,3,FMN 05 Gerard Le Grellelaan
653,Gerard le Grellelaan 10,2023-04-02,02:00:00,6,5,1,FMN 05 Gerard Le Grellelaan
653,Gerard le Grellelaan 10,2023-04-02,03:00:00,5,4,1,FMN 05 Gerard Le Grellelaan
653,Gerard le Grellelaan 10,2023-04-02,04:00:00,2,2,0,FMN 05 Gerard Le Grellelaan
653,Gerard le Grellelaan 10,2023-04-02,05:00:00,3,1,2,FMN 05 Gerard Le Grellelaan
653,Gerard le Grellelaan 10,2023-04-02,06:00:00,5,2,3,FMN 05 Gerard Le Grellelaan
653,Gerard le Grellelaan 10,2023-04-02,07:00:00,3,2,1,FMN 05 Gerard Le Grellelaan
653,Gerard le Grellelaan 10,2023-04-02,08:00:00,11,9,2,FMN 05 Gerard Le Grellelaan
653,Gerard le Grellelaan 10,2023-04-02,09:00:00,24,18,6,FMN 05 Gerard Le Grellelaan
653,Gerard le Grellelaan 10,2023-04-02,10:00:00,31,25,6,FMN 05 Gerard Le Grellelaan
653,Gerard le Grellelaan 10,2023-04-02,11:00:00,40,33,7,FMN 05 Gerard Le Grellelaan
653,Gerard le Grellelaan 10,2023-04-02,12:00:00,33,30,3,FMN 05 Gerard Le Grellelaan
653,Gerard le Grellelaan 10,2023-04-02,13:00:00,37,32,5,FMN 05 Gerard Le Grellelaan
653,Gerard le Grellelaan 10,2023-04-02,14:00:00,43,39,4,FMN 05 Gerard Le Grellelaan
653,Gerard le Grellelaan 10,2023-04-02,15:00:00,44,34,10,FMN 05 Gerard Le Grellelaan
653,Gerard le Grellelaan 10,2023-04-02,16:00:00,50,43,7,FMN 05 Gerard Le Grellelaan
653,Gerard le Grellelaan 10,2023-04-02,17:00:00,42,36,6,FMN 05 Gerard Le Grellelaan
653,Gerard le Grellelaan 10,2023-04-02,18:00:00,43,36,7,FMN 05 Gerard Le Grellelaan
653,Gerard le Grellelaan 10,2023-04-02,19:00:00,25,19,6,FMN 05 Gerard Le Grellelaan
653,Gerard le Grellelaan 10,2023-04-02,20:00:00,11,6,5,FMN 05 Gerard Le Grellelaan
653,Gerard le Grellelaan 10,2023-04-02,21:00:00,24,13,11,FMN 05 Gerard Le Grellelaan
653,Gerard le Grellelaan 10,2023-04-02,22:00:00,7,7,0,FMN 05 Gerard Le Grellelaan
653,Gerard le Grellelaan 10,2023-04-02,23:00:00,6,4,2,FMN 05 Gerard Le Grellelaan
653,Gerard le Grellelaan 10,2023-04-03,00:00:00,0,0,0,FMN 05 Gerard Le Grellelaan
653,Gerard le Grellelaan 10,2023-04-03,01:00:00,0,0,0,FMN 05 Gerard Le Grellelaan
653,Gerard le Grellelaan 10,2023-04-03,02:00:00,0,0,0,FMN 05 Gerard Le Grellelaan
653,Gerard le Grellelaan 10,2023-04-03,03:00:00,0,0,0,FMN 05 Gerard Le Grellelaan
653,Gerard le Grellelaan 10,2023-04-03,04:00:00,0,0,0,FMN 05 Gerard Le Grellelaan
653,Gerard le Grellelaan 10,2023-04-03,05:00:00,0,0,0,FMN 05 Gerard Le Grellelaan
653,Gerard le Grellelaan 10,2023-04-03,06:00:00,0,0,0,FMN 05 Gerard Le Grellelaan
653,Gerard le Grellelaan 10,2023-04-03,07:00:00,0,0,0,FMN 05 Gerard Le Grellelaan
653,Gerard le Grellelaan 10,2023-04-03,08:00:00,0,0,0,FMN 05 Gerard Le Grellelaan
653,Gerard le Grellelaan 10,2023-04-03,09:00:00,0,0,0,FMN 05 Gerard Le Grellelaan
653,Gerard le Grellelaan 10,2023-04-03,10:00:00,0,0,0,FMN 05 Gerard Le Grellelaan
653,Gerard le Grellelaan 10,2023-04-03,11:00:00,0,0,0,FMN 05 Gerard Le Grellelaan
653,Gerard le Grellelaan 10,2023-04-03,12:00:00,49,35,14,FMN 05 Gerard Le Grellelaan
653,Gerard le Grellelaan 10,2023-04-03,13:00:00,69,49,20,FMN 05 Gerard Le Grellelaan
653,Gerard le Grellelaan 10,2023-04-03,14:00:00,75,66,9,FMN 05 Gerard Le Grellelaan
653,Gerard le Grellelaan 10,2023-04-03,15:00:00,106,92,14,FMN 05 Gerard Le Grellelaan
653,Gerard le Grellelaan 10,2023-04-03,16:00:00,152,130,22,FMN 05 Gerard Le Grellelaan
653,Gerard le Grellelaan 10,2023-04-03,17:00:00,177,144,33,FMN 05 Gerard Le Grellelaan
653,Gerard le Grellelaan 10,2023-04-03,18:00:00,133,107,26,FMN 05 Gerard Le Grellelaan
653,Gerard le Grellelaan 10,2023-04-03,19:00:00,83,63,20,FMN 05 Gerard Le Grellelaan
653,Gerard le Grellelaan 10,2023-04-03,20:00:00,2,1,1,FMN 05 Gerard Le Grellelaan
653,Gerard le Grellelaan 10,2023-04-03,21:00:00,0,0,0,FMN 05 Gerard Le Grellelaan
653,Gerard le Grellelaan 10,2023-04-03,22:00:00,0,0,0,FMN 05 Gerard Le Grellelaan
653,Gerard le Grellelaan 10,2023-04-03,23:00:00,0,0,0,FMN 05 Gerard Le Grellelaan
653,Gerard le Grellelaan 10,2023-04-04,00:00:00,0,0,0,FMN 05 Gerard Le Grellelaan
653,Gerard le Grellelaan 10,2023-04-04,01:00:00,0,0,0,FMN 05 Gerard Le Grellelaan
653,Gerard le Grellelaan 10,2023-04-04,02:00:00,0,0,0,FMN 05 Gerard Le Grellelaan
653,Gerard le Grellelaan 10,2023-04-04,03:00:00,3,3,0,FMN 05 Gerard Le Grellelaan
653,Gerard le Grellelaan 10,2023-04-04,04:00:00,6,2,4,FMN 05 Gerard Le Grellelaan
653,Gerard le Grellelaan 10,2023-04-04,05:00:00,13,5,8,FMN 05 Gerard Le Grellelaan
653,Gerard le Grellelaan 10,2023-04-04,06:00:00,32,16,16,FMN 05 Gerard Le Grellelaan
653,Gerard le Grellelaan 10,2023-04-04,07:00:00,93,68,25,FMN 05 Gerard Le Grellelaan
653,Gerard le Grellelaan 10,2023-04-04,08:00:00,127,110,17,FMN 05 Gerard Le Grellelaan
653,Gerard le Grellelaan 10,2023-04-04,09:00:00,67,61,6,FMN 05 Gerard Le Grellelaan
653,Gerard le Grellelaan 10,2023-04-04,10:00:00,50,42,8,FMN 05 Gerard Le Grellelaan
653,Gerard le Grellelaan 10,2023-04-04,11:00:00,56,46,10,FMN 05 Gerard Le Grellelaan
653,Gerard le Grellelaan 10,2023-04-04,12:00:00,73,55,18,FMN 05 Gerard Le Grellelaan
653,Gerard le Grellelaan 10,2023-04-04,13:00:00,5,3,2,FMN 05 Gerard Le Grellelaan
653,Gerard le Grellelaan 10,2023-04-04,14:00:00,0,0,0,FMN 05 Gerard Le Grellelaan
653,Gerard le Grellelaan 10,2023-04-04,15:00:00,0,0,0,FMN 05 Gerard Le Grellelaan
653,Gerard le Grellelaan 10,2023-04-04,16:00:00,0,0,0,FMN 05 Gerard Le Grellelaan
653,Gerard le Grellelaan 10,2023-04-04,17:00:00,43,33,10,FMN 05 Gerard Le Grellelaan
653,Gerard le Grellelaan 10,2023-04-04,18:00:00,111,86,25,FMN 05 Gerard Le Grellelaan
653,Gerard le Grellelaan 10,2023-04-04,19:00:00,58,45,13,FMN 05 Gerard Le Grellelaan
653,Gerard le Grellelaan 10,2023-04-04,20:00:00,42,35,7,FMN 05 Gerard Le Grellelaan
653,Gerard le Grellelaan 10,2023-04-04,21:00:00,23,20,3,FMN 05 Gerard Le Grellelaan
653,Gerard le Grellelaan 10,2023-04-04,22:00:00,36,31,5,FMN 05 Gerard Le Grellelaan
653,Gerard le Grellelaan 10,2023-04-04,23:00:00,5,3,2,FMN 05 Gerard Le Grellelaan
653,Gerard le Grellelaan 10,2023-04-05,00:00:00,7,6,1,FMN 05 Gerard Le Grellelaan
653,Gerard le Grellelaan 10,2023-04-05,01:00:00,6,5,1,FMN 05 Gerard Le Grellelaan
653,Gerard le Grellelaan 10,2023-04-05,02:00:00,5,3,2,FMN 05 Gerard Le Grellelaan
653,Gerard le Grellelaan 10,2023-04-05,03:00:00,4,2,2,FMN 05 Gerard Le Grellelaan
653,Gerard le Grellelaan 10,2023-04-05,04:00:00,6,4,2,FMN 05 Gerard Le Grellelaan
653,Gerard le Grellelaan 10,2023-04-05,05:00:00,12,2,10,FMN 05 Gerard Le Grellelaan
653,Gerard le Grellelaan 10,2023-04-05,06:00:00,31,18,13,FMN 05 Gerard Le Grellelaan
653,Gerard le Grellelaan 10,2023-04-05,07:00:00,67,51,16,FMN 05 Gerard Le Grellelaan
653,Gerard le Grellelaan 10,2023-04-05,08:00:00,117,101,16,FMN 05 Gerard Le Grellelaan
653,Gerard le Grellelaan 10,2023-04-05,09:00:00,86,71,15,FMN 05 Gerard Le Grellelaan
653,Gerard le Grellelaan 10,2023-04-05,10:00:00,41,35,6,FMN 05 Gerard Le Grellelaan
653,Gerard le Grellelaan 10,2023-04-05,11:00:00,53,42,11,FMN 05 Gerard Le Grellelaan
653,Gerard le Grellelaan 10,2023-04-05,12:00:00,57,41,16,FMN 05 Gerard Le Grellelaan
653,Gerard le Grellelaan 10,2023-04-05,13:00:00,6,6,0,FMN 05 Gerard Le Grellelaan
653,Gerard le Grellelaan 10,2023-04-05,14:00:00,0,0,0,FMN 05 Gerard Le Grellelaan
653,Gerard le Grellelaan 10,2023-04-05,15:00:00,5,4,1,FMN 05 Gerard Le Grellelaan
653,Gerard le Grellelaan 10,2023-04-05,16:00:00,5,4,1,FMN 05 Gerard Le Grellelaan
653,Gerard le Grellelaan 10,2023-04-05,17:00:00,110,85,25,FMN 05 Gerard Le Grellelaan
653,Gerard le Grellelaan 10,2023-04-05,18:00:00,113,96,17,FMN 05 Gerard Le Grellelaan
653,Gerard le Grellelaan 10,2023-04-05,19:00:00,91,74,17,FMN 05 Gerard Le Grellelaan
653,Gerard le Grellelaan 10,2023-04-05,20:00:00,58,51,7,FMN 05 Gerard Le Grellelaan
653,Gerard le Grellelaan 10,2023-04-05,21:00:00,22,19,3,FMN 05 Gerard Le Grellelaan
653,Gerard le Grellelaan 10,2023-04-05,22:00:00,41,32,9,FMN 05 Gerard Le Grellelaan
653,Gerard le Grellelaan 10,2023-04-05,23:00:00,14,4,10,FMN 05 Gerard Le Grellelaan
653,Gerard le Grellelaan 10,2023-04-06,00:00:00,4,2,2,FMN 05 Gerard Le Grellelaan
653,Gerard le Grellelaan 10,2023-04-06,01:00:00,4,4,0,FMN 05 Gerard Le Grellelaan
653,Gerard le Grellelaan 10,2023-04-06,02:00:00,2,2,0,FMN 05 Gerard Le Grellelaan
653,Gerard le Grellelaan 10,2023-04-06,03:00:00,2,2,0,FMN 05 Gerard Le Grellelaan
653,Gerard le Grellelaan 10,2023-04-06,04:00:00,8,5,3,FMN 05 Gerard Le Grellelaan
653,Gerard le Grellelaan 10,2023-04-06,05:00:00,19,5,14,FMN 05 Gerard Le Grellelaan
653,Gerard le Grellelaan 10,2023-04-06,06:00:00,32,17,15,FMN 05 Gerard Le Grellelaan
653,Gerard le Grellelaan 10,2023-04-06,07:00:00,80,59,21,FMN 05 Gerard Le Grellelaan
653,Gerard le Grellelaan 10,2023-04-06,08:00:00,132,111,21,FMN 05 Gerard Le Grellelaan
653,Gerard le Grellelaan 10,2023-04-06,09:00:00,48,41,7,FMN 05 Gerard Le Grellelaan
653,Gerard le Grellelaan 10,2023-04-06,10:00:00,24,19,5,FMN 05 Gerard Le Grellelaan
653,Gerard le Grellelaan 10,2023-04-06,11:00:00,32,28,4,FMN 05 Gerard Le Grellelaan
653,Gerard le Grellelaan 10,2023-04-06,12:00:00,41,25,16,FMN 05 Gerard Le Grellelaan
653,Gerard le Grellelaan 10,2023-04-06,13:00:00,30,21,9,FMN 05 Gerard Le Grellelaan
653,Gerard le Grellelaan 10,2023-04-06,14:00:00,44,36,8,FMN 05 Gerard Le Grellelaan
653,Gerard le Grellelaan 10,2023-04-06,15:00:00,65,52,13,FMN 05 Gerard Le Grellelaan
653,Gerard le Grellelaan 10,2023-04-06,16:00:00,82,63,19,FMN 05 Gerard Le Grellelaan
653,Gerard le Grellelaan 10,2023-04-06,17:00:00,104,85,19,FMN 05 Gerard Le Grellelaan
653,Gerard le Grellelaan 10,2023-04-06,18:00:00,75,56,19,FMN 05 Gerard Le Grellelaan
653,Gerard le Grellelaan 10,2023-04-06,19:00:00,44,35,9,FMN 05 Gerard Le Grellelaan
653,Gerard le Grellelaan 10,2023-04-06,20:00:00,18,15,3,FMN 05 Gerard Le Grellelaan
653,Gerard le Grellelaan 10,2023-04-06,21:00:00,14,12,2,FMN 05 Gerard Le Grellelaan
653,Gerard le Grellelaan 10,2023-04-06,22:00:00,21,20,1,FMN 05 Gerard Le Grellelaan
653,Gerard le Grellelaan 10,2023-04-06,23:00:00,8,6,2,FMN 05 Gerard Le Grellelaan
653,Gerard le Grellelaan 10,2023-04-07,00:00:00,12,4,8,FMN 05 Gerard Le Grellelaan
653,Gerard le Grellelaan 10,2023-04-07,01:00:00,1,1,0,FMN 05 Gerard Le Grellelaan
653,Gerard le Grellelaan 10,2023-04-07,02:00:00,1,1,0,FMN 05 Gerard Le Grellelaan
653,Gerard le Grellelaan 10,2023-04-07,03:00:00,4,3,1,FMN 05 Gerard Le Grellelaan
653,Gerard le Grellelaan 10,2023-04-07,04:00:00,8,4,4,FMN 05 Gerard Le Grellelaan
653,Gerard le Grellelaan 10,2023-04-07,05:00:00,13,2,11,FMN 05 Gerard Le Grellelaan
653,Gerard le Grellelaan 10,2023-04-07,06:00:00,27,15,12,FMN 05 Gerard Le Grellelaan
653,Gerard le Grellelaan 10,2023-04-07,07:00:00,61,39,22,FMN 05 Gerard Le Grellelaan
653,Gerard le Grellelaan 10,2023-04-07,08:00:00,99,84,15,FMN 05 Gerard Le Grellelaan
653,Gerard le Grellelaan 10,2023-04-07,09:00:00,73,63,10,FMN 05 Gerard Le Grellelaan
653,Gerard le Grellelaan 10,2023-04-07,10:00:00,49,40,9,FMN 05 Gerard Le Grellelaan
653,Gerard le Grellelaan 10,2023-04-07,11:00:00,60,50,10,FMN 05 Gerard Le Grellelaan
653,Gerard le Grellelaan 10,2023-04-07,12:00:00,74,57,17,FMN 05 Gerard Le Grellelaan
653,Gerard le Grellelaan 10,2023-04-07,13:00:00,62,46,16,FMN 05 Gerard Le Grellelaan
653,Gerard le Grellelaan 10,2023-04-07,14:00:00,54,45,9,FMN 05 Gerard Le Grellelaan
653,Gerard le Grellelaan 10,2023-04-07,15:00:00,70,61,9,FMN 05 Gerard Le Grellelaan
653,Gerard le Grellelaan 10,2023-04-07,16:00:00,112,94,18,FMN 05 Gerard Le Grellelaan
653,Gerard le Grellelaan 10,2023-04-07,17:00:00,124,115,9,FMN 05 Gerard Le Grellelaan
653,Gerard le Grellelaan 10,2023-04-07,18:00:00,73,57,16,FMN 05 Gerard Le Grellelaan
653,Gerard le Grellelaan 10,2023-04-07,19:00:00,51,41,10,FMN 05 Gerard Le Grellelaan
653,Gerard le Grellelaan 10,2023-04-07,20:00:00,42,36,6,FMN 05 Gerard Le Grellelaan
653,Gerard le Grellelaan 10,2023-04-07,21:00:00,25,20,5,FMN 05 Gerard Le Grellelaan
653,Gerard le Grellelaan 10,2023-04-07,22:00:00,18,15,3,FMN 05 Gerard Le Grellelaan
653,Gerard le Grellelaan 10,2023-04-07,23:00:00,18,10,8,FMN 05 Gerard Le Grellelaan
653,Gerard le Grellelaan 10,2023-04-08,00:00:00,16,12,4,FMN 05 Gerard Le Grellelaan
653,Gerard le Grellelaan 10,2023-04-08,01:00:00,8,6,2,FMN 05 Gerard Le Grellelaan
653,Gerard le Grellelaan 10,2023-04-08,02:00:00,5,3,2,FMN 05 Gerard Le Grellelaan
653,Gerard le Grellelaan 10,2023-04-08,03:00:00,8,7,1,FMN 05 Gerard Le Grellelaan
653,Gerard le Grellelaan 10,2023-04-08,04:00:00,7,2,5,FMN 05 Gerard Le Grellelaan
653,Gerard le Grellelaan 10,2023-04-08,05:00:00,9,4,5,FMN 05 Gerard Le Grellelaan
653,Gerard le Grellelaan 10,2023-04-08,06:00:00,7,5,2,FMN 05 Gerard Le Grellelaan
653,Gerard le Grellelaan 10,2023-04-08,07:00:00,16,15,1,FMN 05 Gerard Le Grellelaan
653,Gerard le Grellelaan 10,2023-04-08,08:00:00,27,19,8,FMN 05 Gerard Le Grellelaan
653,Gerard le Grellelaan 10,2023-04-08,09:00:00,31,27,4,FMN 05 Gerard Le Grellelaan
653,Gerard le Grellelaan 10,2023-04-08,10:00:00,33,24,9,FMN 05 Gerard Le Grellelaan
653,Gerard le Grellelaan 10,2023-04-08,11:00:00,50,43,7,FMN 05 Gerard Le Grellelaan
653,Gerard le Grellelaan 10,2023-04-08,12:00:00,84,71,13,FMN 05 Gerard Le Grellelaan
653,Gerard le Grellelaan 10,2023-04-08,13:00:00,64,54,10,FMN 05 Gerard Le Grellelaan
653,Gerard le Grellelaan 10,2023-04-08,14:00:00,64,51,13,FMN 05 Gerard Le Grellelaan
653,Gerard le Grellelaan 10,2023-04-08,15:00:00,72,55,17,FMN 05 Gerard Le Grellelaan
653,Gerard le Grellelaan 10,2023-04-08,16:00:00,83,70,13,FMN 05 Gerard Le Grellelaan
653,Gerard le Grellelaan 10,2023-04-08,17:00:00,79,61,18,FMN 05 Gerard Le Grellelaan
653,Gerard le Grellelaan 10,2023-04-08,18:00:00,66,54,12,FMN 05 Gerard Le Grellelaan
653,Gerard le Grellelaan 10,2023-04-08,19:00:00,55,46,9,FMN 05 Gerard Le Grellelaan
653,Gerard le Grellelaan 10,2023-04-08,20:00:00,33,30,3,FMN 05 Gerard Le Grellelaan
653,Gerard le Grellelaan 10,2023-04-08,21:00:00,30,23,7,FMN 05 Gerard Le Grellelaan
653,Gerard le Grellelaan 10,2023-04-08,22:00:00,17,15,2,FMN 05 Gerard Le Grellelaan
653,Gerard le Grellelaan 10,2023-04-08,23:00:00,20,13,7,FMN 05 Gerard Le Grellelaan
653,Gerard le Grellelaan 10,2023-04-09,00:00:00,17,11,6,FMN 05 Gerard Le Grellelaan
653,Gerard le Grellelaan 10,2023-04-09,01:00:00,7,5,2,FMN 05 Gerard Le Grellelaan
653,Gerard le Grellelaan 10,2023-04-09,02:00:00,2,2,0,FMN 05 Gerard Le Grellelaan
653,Gerard le Grellelaan 10,2023-04-09,03:00:00,1,1,0,FMN 05 Gerard Le Grellelaan
653,Gerard le Grellelaan 10,2023-04-09,04:00:00,4,3,1,FMN 05 Gerard Le Grellelaan
653,Gerard le Grellelaan 10,2023-04-09,05:00:00,8,4,4,FMN 05 Gerard Le Grellelaan
653,Gerard le Grellelaan 10,2023-04-09,06:00:00,2,2,0,FMN 05 Gerard Le Grellelaan
653,Gerard le Grellelaan 10,2023-04-09,07:00:00,8,6,2,FMN 05 Gerard Le Grellelaan
653,Gerard le Grellelaan 10,2023-04-09,08:00:00,20,16,4,FMN 05 Gerard Le Grellelaan
653,Gerard le Grellelaan 10,2023-04-09,09:00:00,32,30,2,FMN 05 Gerard Le Grellelaan
653,Gerard le Grellelaan 10,2023-04-09,10:00:00,44,36,8,FMN 05 Gerard Le Grellelaan
653,Gerard le Grellelaan 10,2023-04-09,11:00:00,75,61,14,FMN 05 Gerard Le Grellelaan
653,Gerard le Grellelaan 10,2023-04-09,12:00:00,15,13,2,FMN 05 Gerard Le Grellelaan
653,Gerard le Grellelaan 10,2023-04-09,13:00:00,0,0,0,FMN 05 Gerard Le Grellelaan
653,Gerard le Grellelaan 10,2023-04-09,14:00:00,0,0,0,FMN 05 Gerard Le Grellelaan
653,Gerard le Grellelaan 10,2023-04-09,15:00:00,0,0,0,FMN 05 Gerard Le Grellelaan
653,Gerard le Grellelaan 10,2023-04-09,16:00:00,0,0,0,FMN 05 Gerard Le Grellelaan
653,Gerard le Grellelaan 10,2023-04-09,17:00:00,30,25,5,FMN 05 Gerard Le Grellelaan
653,Gerard le Grellelaan 10,2023-04-09,18:00:00,106,92,14,FMN 05 Gerard Le Grellelaan
653,Gerard le Grellelaan 10,2023-04-09,19:00:00,77,57,20,FMN 05 Gerard Le Grellelaan
653,Gerard le Grellelaan 10,2023-04-09,20:00:00,46,33,13,FMN 05 Gerard Le Grellelaan
653,Gerard le Grellelaan 10,2023-04-09,21:00:00,29,23,6,FMN 05 Gerard Le Grellelaan
653,Gerard le Grellelaan 10,2023-04-09,22:00:00,24,16,8,FMN 05 Gerard Le Grellelaan
653,Gerard le Grellelaan 10,2023-04-09,23:00:00,17,11,6,FMN 05 Gerard Le Grellelaan
653,Gerard le Grellelaan 10,2023-04-10,00:00:00,10,9,1,FMN 05 Gerard Le Grellelaan
653,Gerard le Grellelaan 10,2023-04-10,01:00:00,7,6,1,FMN 05 Gerard Le Grellelaan
653,Gerard le Grellelaan 10,2023-04-10,02:00:00,2,1,1,FMN 05 Gerard Le Grellelaan
653,Gerard le Grellelaan 10,2023-04-10,03:00:00,1,1,0,FMN 05 Gerard Le Grellelaan
653,Gerard le Grellelaan 10,2023-04-10,04:00:00,1,0,1,FMN 05 Gerard Le Grellelaan
653,Gerard le Grellelaan 10,2023-04-10,05:00:00,4,2,2,FMN 05 Gerard Le Grellelaan
653,Gerard le Grellelaan 10,2023-04-10,06:00:00,6,5,1,FMN 05 Gerard Le Grellelaan
653,Gerard le Grellelaan 10,2023-04-10,07:00:00,6,6,0,FMN 05 Gerard Le Grellelaan
653,Gerard le Grellelaan 10,2023-04-10,08:00:00,14,12,2,FMN 05 Gerard Le Grellelaan
653,Gerard le Grellelaan 10,2023-04-10,09:00:00,20,18,2,FMN 05 Gerard Le Grellelaan
653,Gerard le Grellelaan 10,2023-04-10,10:00:00,44,39,5,FMN 05 Gerard Le Grellelaan
653,Gerard le Grellelaan 10,2023-04-10,11:00:00,46,37,9,FMN 05 Gerard Le Grellelaan
653,Gerard le Grellelaan 10,2023-04-10,12:00:00,50,40,10,FMN 05 Gerard Le Grellelaan
653,Gerard le Grellelaan 10,2023-04-10,13:00:00,50,37,13,FMN 05 Gerard Le Grellelaan
653,Gerard le Grellelaan 10,2023-04-10,14:00:00,40,30,10,FMN 05 Gerard Le Grellelaan
653,Gerard le Grellelaan 10,2023-04-10,15:00:00,45,37,8,FMN 05 Gerard Le Grellelaan
653,Gerard le Grellelaan 10,2023-04-10,16:00:00,39,36,3,FMN 05 Gerard Le Grellelaan
653,Gerard le Grellelaan 10,2023-04-10,17:00:00,30,27,3,FMN 05 Gerard Le Grellelaan
653,Gerard le Grellelaan 10,2023-04-10,18:00:00,22,19,3,FMN 05 Gerard Le Grellelaan
653,Gerard le Grellelaan 10,2023-04-10,19:00:00,25,20,5,FMN 05 Gerard Le Grellelaan
653,Gerard le Grellelaan 10,2023-04-10,20:00:00,24,20,4,FMN 05 Gerard Le Grellelaan
653,Gerard le Grellelaan 10,2023-04-10,21:00:00,24,17,7,FMN 05 Gerard Le Grellelaan
653,Gerard le Grellelaan 10,2023-04-10,22:00:00,12,8,4,FMN 05 Gerard Le Grellelaan
653,Gerard le Grellelaan 10,2023-04-10,23:00:00,11,9,2,FMN 05 Gerard Le Grellelaan
653,Gerard le Grellelaan 10,2023-04-11,00:00:00,2,2,0,FMN 05 Gerard Le Grellelaan
653,Gerard le Grellelaan 10,2023-04-11,01:00:00,3,2,1,FMN 05 Gerard Le Grellelaan
653,Gerard le Grellelaan 10,2023-04-11,02:00:00,2,2,0,FMN 05 Gerard Le Grellelaan
653,Gerard le Grellelaan 10,2023-04-11,03:00:00,0,0,0,FMN 05 Gerard Le Grellelaan
653,Gerard le Grellelaan 10,2023-04-11,04:00:00,0,0,0,FMN 05 Gerard Le Grellelaan
653,Gerard le Grellelaan 10,2023-04-11,05:00:00,0,0,0,FMN 05 Gerard Le Grellelaan
653,Gerard le Grellelaan 10,2023-04-11,06:00:00,0,0,0,FMN 05 Gerard Le Grellelaan
653,Gerard le Grellelaan 10,2023-04-11,07:00:00,0,0,0,FMN 05 Gerard Le Grellelaan
653,Gerard le Grellelaan 10,2023-04-11,08:00:00,0,0,0,FMN 05 Gerard Le Grellelaan
653,Gerard le Grellelaan 10,2023-04-11,09:00:00,0,0,0,FMN 05 Gerard Le Grellelaan
653,Gerard le Grellelaan 10,2023-04-11,10:00:00,0,0,0,FMN 05 Gerard Le Grellelaan
653,Gerard le Grellelaan 10,2023-04-11,11:00:00,0,0,0,FMN 05 Gerard Le Grellelaan
653,Gerard le Grellelaan 10,2023-04-11,12:00:00,28,21,7,FMN 05 Gerard Le Grellelaan
653,Gerard le Grellelaan 10,2023-04-11,13:00:00,81,57,24,FMN 05 Gerard Le Grellelaan
653,Gerard le Grellelaan 10,2023-04-11,14:00:00,94,73,21,FMN 05 Gerard Le Grellelaan
653,Gerard le Grellelaan 10,2023-04-11,15:00:00,114,100,14,FMN 05 Gerard Le Grellelaan
653,Gerard le Grellelaan 10,2023-04-11,16:00:00,175,145,30,FMN 05 Gerard Le Grellelaan
653,Gerard le Grellelaan 10,2023-04-11,17:00:00,177,147,30,FMN 05 Gerard Le Grellelaan
653,Gerard le Grellelaan 10,2023-04-11,18:00:00,133,109,24,FMN 05 Gerard Le Grellelaan
653,Gerard le Grellelaan 10,2023-04-11,19:00:00,60,44,16,FMN 05 Gerard Le Grellelaan
653,Gerard le Grellelaan 10,2023-04-11,20:00:00,45,36,9,FMN 05 Gerard Le Grellelaan
653,Gerard le Grellelaan 10,2023-04-11,21:00:00,26,21,5,FMN 05 Gerard Le Grellelaan
653,Gerard le Grellelaan 10,2023-04-11,22:00:00,24,21,3,FMN 05 Gerard Le Grellelaan
653,Gerard le Grellelaan 10,2023-04-11,23:00:00,13,5,8,FMN 05 Gerard Le Grellelaan
653,Gerard le Grellelaan 10,2023-04-12,00:00:00,8,5,3,FMN 05 Gerard Le Grellelaan
653,Gerard le Grellelaan 10,2023-04-12,01:00:00,6,4,2,FMN 05 Gerard Le Grellelaan
653,Gerard le Grellelaan 10,2023-04-12,02:00:00,1,1,0,FMN 05 Gerard Le Grellelaan
653,Gerard le Grellelaan 10,2023-04-12,03:00:00,5,3,2,FMN 05 Gerard Le Grellelaan
653,Gerard le Grellelaan 10,2023-04-12,04:00:00,5,1,4,FMN 05 Gerard Le Grellelaan
653,Gerard le Grellelaan 10,2023-04-12,05:00:00,26,10,16,FMN 05 Gerard Le Grellelaan
653,Gerard le Grellelaan 10,2023-04-12,06:00:00,34,16,18,FMN 05 Gerard Le Grellelaan
653,Gerard le Grellelaan 10,2023-04-12,07:00:00,68,43,25,FMN 05 Gerard Le Grellelaan
653,Gerard le Grellelaan 10,2023-04-12,08:00:00,80,67,13,FMN 05 Gerard Le Grellelaan
653,Gerard le Grellelaan 10,2023-04-12,09:00:00,65,56,9,FMN 05 Gerard Le Grellelaan
653,Gerard le Grellelaan 10,2023-04-12,10:00:00,45,36,9,FMN 05 Gerard Le Grellelaan
653,Gerard le Grellelaan 10,2023-04-12,11:00:00,41,30,11,FMN 05 Gerard Le Grellelaan
653,Gerard le Grellelaan 10,2023-04-12,12:00:00,49,36,13,FMN 05 Gerard Le Grellelaan
653,Gerard le Grellelaan 10,2023-04-12,13:00:00,40,28,12,FMN 05 Gerard Le Grellelaan
653,Gerard le Grellelaan 10,2023-04-12,14:00:00,65,52,13,FMN 05 Gerard Le Grellelaan
653,Gerard le Grellelaan 10,2023-04-12,15:00:00,74,62,12,FMN 05 Gerard Le Grellelaan
653,Gerard le Grellelaan 10,2023-04-12,16:00:00,96,82,14,FMN 05 Gerard Le Grellelaan
653,Gerard le Grellelaan 10,2023-04-12,17:00:00,112,92,20,FMN 05 Gerard Le Grellelaan
653,Gerard le Grellelaan 10,2023-04-12,18:00:00,99,81,18,FMN 05 Gerard Le Grellelaan
653,Gerard le Grellelaan 10,2023-04-12,19:00:00,63,55,8,FMN 05 Gerard Le Grellelaan
653,Gerard le Grellelaan 10,2023-04-12,20:00:00,46,37,9,FMN 05 Gerard Le Grellelaan
653,Gerard le Grellelaan 10,2023-04-12,21:00:00,18,12,6,FMN 05 Gerard Le Grellelaan
653,Gerard le Grellelaan 10,2023-04-12,22:00:00,32,27,5,FMN 05 Gerard Le Grellelaan
653,Gerard le Grellelaan 10,2023-04-12,23:00:00,13,9,4,FMN 05 Gerard Le Grellelaan
653,Gerard le Grellelaan 10,2023-04-13,00:00:00,4,3,1,FMN 05 Gerard Le Grellelaan
653,Gerard le Grellelaan 10,2023-04-13,01:00:00,3,2,1,FMN 05 Gerard Le Grellelaan
653,Gerard le Grellelaan 10,2023-04-13,02:00:00,1,1,0,FMN 05 Gerard Le Grellelaan
653,Gerard le Grellelaan 10,2023-04-13,03:00:00,4,3,1,FMN 05 Gerard Le Grellelaan
653,Gerard le Grellelaan 10,2023-04-13,04:00:00,10,2,8,FMN 05 Gerard Le Grellelaan
653,Gerard le Grellelaan 10,2023-04-13,05:00:00,28,12,16,FMN 05 Gerard Le Grellelaan
653,Gerard le Grellelaan 10,2023-04-13,06:00:00,35,16,19,FMN 05 Gerard Le Grellelaan
653,Gerard le Grellelaan 10,2023-04-13,07:00:00,96,65,31,FMN 05 Gerard Le Grellelaan
653,Gerard le Grellelaan 10,2023-04-13,08:00:00,131,112,19,FMN 05 Gerard Le Grellelaan
653,Gerard le Grellelaan 10,2023-04-13,09:00:00,79,67,12,FMN 05 Gerard Le Grellelaan
653,Gerard le Grellelaan 10,2023-04-13,10:00:00,2,2,0,FMN 05 Gerard Le Grellelaan
653,Gerard le Grellelaan 10,2023-04-13,11:00:00,0,0,0,FMN 05 Gerard Le Grellelaan
653,Gerard le Grellelaan 10,2023-04-13,12:00:00,54,40,14,FMN 05 Gerard Le Grellelaan
653,Gerard le Grellelaan 10,2023-04-13,13:00:00,69,54,15,FMN 05 Gerard Le Grellelaan
653,Gerard le Grellelaan 10,2023-04-13,14:00:00,75,61,14,FMN 05 Gerard Le Grellelaan
653,Gerard le Grellelaan 10,2023-04-13,15:00:00,107,83,24,FMN 05 Gerard Le Grellelaan
653,Gerard le Grellelaan 10,2023-04-13,16:00:00,128,110,18,FMN 05 Gerard Le Grellelaan
653,Gerard le Grellelaan 10,2023-04-13,17:00:00,138,113,25,FMN 05 Gerard Le Grellelaan
653,Gerard le Grellelaan 10,2023-04-13,18:00:00,140,115,25,FMN 05 Gerard Le Grellelaan
653,Gerard le Grellelaan 10,2023-04-13,19:00:00,63,56,7,FMN 05 Gerard Le Grellelaan
653,Gerard le Grellelaan 10,2023-04-13,20:00:00,57,44,13,FMN 05 Gerard Le Grellelaan
653,Gerard le Grellelaan 10,2023-04-13,21:00:00,34,26,8,FMN 05 Gerard Le Grellelaan
653,Gerard le Grellelaan 10,2023-04-13,22:00:00,42,38,4,FMN 05 Gerard Le Grellelaan
653,Gerard le Grellelaan 10,2023-04-13,23:00:00,18,14,4,FMN 05 Gerard Le Grellelaan
653,Gerard le Grellelaan 10,2023-04-14,00:00:00,9,4,5,FMN 05 Gerard Le Grellelaan
653,Gerard le Grellelaan 10,2023-04-14,01:00:00,7,6,1,FMN 05 Gerard Le Grellelaan
653,Gerard le Grellelaan 10,2023-04-14,02:00:00,2,2,0,FMN 05 Gerard Le Grellelaan
653,Gerard le Grellelaan 10,2023-04-14,03:00:00,0,0,0,FMN 05 Gerard Le Grellelaan
653,Gerard le Grellelaan 10,2023-04-14,04:00:00,12,3,9,FMN 05 Gerard Le Grellelaan
653,Gerard le Grellelaan 10,2023-04-14,05:00:00,21,10,11,FMN 05 Gerard Le Grellelaan
653,Gerard le Grellelaan 10,2023-04-14,06:00:00,22,16,6,FMN 05 Gerard Le Grellelaan
653,Gerard le Grellelaan 10,2023-04-14,07:00:00,83,61,22,FMN 05 Gerard Le Grellelaan
653,Gerard le Grellelaan 10,2023-04-14,08:00:00,117,100,17,FMN 05 Gerard Le Grellelaan
653,Gerard le Grellelaan 10,2023-04-14,09:00:00,76,67,9,FMN 05 Gerard Le Grellelaan
653,Gerard le Grellelaan 10,2023-04-14,10:00:00,62,51,11,FMN 05 Gerard Le Grellelaan
653,Gerard le Grellelaan 10,2023-04-14,11:00:00,57,49,8,FMN 05 Gerard Le Grellelaan
653,Gerard le Grellelaan 10,2023-04-14,12:00:00,69,54,15,FMN 05 Gerard Le Grellelaan
653,Gerard le Grellelaan 10,2023-04-14,13:00:00,38,31,7,FMN 05 Gerard Le Grellelaan
653,Gerard le Grellelaan 10,2023-04-14,14:00:00,1,1,0,FMN 05 Gerard Le Grellelaan
653,Gerard le Grellelaan 10,2023-04-14,15:00:00,41,31,10,FMN 05 Gerard Le Grellelaan
653,Gerard le Grellelaan 10,2023-04-14,16:00:00,110,94,16,FMN 05 Gerard Le Grellelaan
653,Gerard le Grellelaan 10,2023-04-14,17:00:00,136,113,23,FMN 05 Gerard Le Grellelaan
653,Gerard le Grellelaan 10,2023-04-14,18:00:00,94,77,17,FMN 05 Gerard Le Grellelaan
653,Gerard le Grellelaan 10,2023-04-14,19:00:00,81,65,16,FMN 05 Gerard Le Grellelaan
653,Gerard le Grellelaan 10,2023-04-14,20:00:00,53,42,11,FMN 05 Gerard Le Grellelaan
653,Gerard le Grellelaan 10,2023-04-14,21:00:00,26,21,5,FMN 05 Gerard Le Grellelaan
653,Gerard le Grellelaan 10,2023-04-14,22:00:00,32,27,5,FMN 05 Gerard Le Grellelaan
653,Gerard le Grellelaan 10,2023-04-14,23:00:00,18,13,5,FMN 05 Gerard Le Grellelaan
653,Gerard le Grellelaan 10,2023-04-15,00:00:00,11,6,5,FMN 05 Gerard Le Grellelaan
653,Gerard le Grellelaan 10,2023-04-15,01:00:00,6,6,0,FMN 05 Gerard Le Grellelaan
653,Gerard le Grellelaan 10,2023-04-15,02:00:00,5,3,2,FMN 05 Gerard Le Grellelaan
653,Gerard le Grellelaan 10,2023-04-15,03:00:00,9,6,3,FMN 05 Gerard Le Grellelaan
653,Gerard le Grellelaan 10,2023-04-15,04:00:00,4,4,0,FMN 05 Gerard Le Grellelaan
653,Gerard le Grellelaan 10,2023-04-15,05:00:00,2,0,2,FMN 05 Gerard Le Grellelaan
653,Gerard le Grellelaan 10,2023-04-15,06:00:00,9,6,3,FMN 05 Gerard Le Grellelaan
653,Gerard le Grellelaan 10,2023-04-15,07:00:00,13,13,0,FMN 05 Gerard Le Grellelaan
653,Gerard le Grellelaan 10,2023-04-15,08:00:00,28,26,2,FMN 05 Gerard Le Grellelaan
653,Gerard le Grellelaan 10,2023-04-15,09:00:00,55,46,9,FMN 05 Gerard Le Grellelaan
653,Gerard le Grellelaan 10,2023-04-15,10:00:00,57,43,14,FMN 05 Gerard Le Grellelaan
653,Gerard le Grellelaan 10,2023-04-15,11:00:00,80,64,16,FMN 05 Gerard Le Grellelaan
653,Gerard le Grellelaan 10,2023-04-15,12:00:00,78,59,19,FMN 05 Gerard Le Grellelaan
653,Gerard le Grellelaan 10,2023-04-15,13:00:00,95,73,22,FMN 05 Gerard Le Grellelaan
653,Gerard le Grellelaan 10,2023-04-15,14:00:00,119,93,26,FMN 05 Gerard Le Grellelaan
653,Gerard le Grellelaan 10,2023-04-15,15:00:00,98,79,19,FMN 05 Gerard Le Grellelaan
653,Gerard le Grellelaan 10,2023-04-15,16:00:00,86,77,9,FMN 05 Gerard Le Grellelaan
653,Gerard le Grellelaan 10,2023-04-15,17:00:00,113,100,13,FMN 05 Gerard Le Grellelaan
653,Gerard le Grellelaan 10,2023-04-15,18:00:00,79,65,14,FMN 05 Gerard Le Grellelaan
653,Gerard le Grellelaan 10,2023-04-15,19:00:00,68,52,16,FMN 05 Gerard Le Grellelaan
653,Gerard le Grellelaan 10,2023-04-15,20:00:00,48,39,9,FMN 05 Gerard Le Grellelaan
653,Gerard le Grellelaan 10,2023-04-15,21:00:00,18,18,0,FMN 05 Gerard Le Grellelaan
653,Gerard le Grellelaan 10,2023-04-15,22:00:00,24,20,4,FMN 05 Gerard Le Grellelaan
653,Gerard le Grellelaan 10,2023-04-15,23:00:00,13,12,1,FMN 05 Gerard Le Grellelaan
653,Gerard le Grellelaan 10,2023-04-16,00:00:00,7,6,1,FMN 05 Gerard Le Grellelaan
653,Gerard le Grellelaan 10,2023-04-16,01:00:00,11,9,2,FMN 05 Gerard Le Grellelaan
653,Gerard le Grellelaan 10,2023-04-16,02:00:00,3,0,3,FMN 05 Gerard Le Grellelaan
653,Gerard le Grellelaan 10,2023-04-16,03:00:00,9,3,6,FMN 05 Gerard Le Grellelaan
653,Gerard le Grellelaan 10,2023-04-16,04:00:00,4,3,1,FMN 05 Gerard Le Grellelaan
653,Gerard le Grellelaan 10,2023-04-16,05:00:00,10,6,4,FMN 05 Gerard Le Grellelaan
653,Gerard le Grellelaan 10,2023-04-16,06:00:00,0,0,0,FMN 05 Gerard Le Grellelaan
653,Gerard le Grellelaan 10,2023-04-16,07:00:00,0,0,0,FMN 05 Gerard Le Grellelaan
653,Gerard le Grellelaan 10,2023-04-16,08:00:00,14,10,4,FMN 05 Gerard Le Grellelaan
653,Gerard le Grellelaan 10,2023-04-16,09:00:00,19,16,3,FMN 05 Gerard Le Grellelaan
653,Gerard le Grellelaan 10,2023-04-16,10:00:00,51,41,10,FMN 05 Gerard Le Grellelaan
653,Gerard le Grellelaan 10,2023-04-16,11:00:00,48,35,13,FMN 05 Gerard Le Grellelaan
653,Gerard le Grellelaan 10,2023-04-16,12:00:00,45,32,13,FMN 05 Gerard Le Grellelaan
653,Gerard le Grellelaan 10,2023-04-16,13:00:00,46,39,7,FMN 05 Gerard Le Grellelaan
653,Gerard le Grellelaan 10,2023-04-16,14:00:00,48,38,10,FMN 05 Gerard Le Grellelaan
653,Gerard le Grellelaan 10,2023-04-16,15:00:00,50,39,11,FMN 05 Gerard Le Grellelaan
653,Gerard le Grellelaan 10,2023-04-16,16:00:00,74,66,8,FMN 05 Gerard Le Grellelaan
653,Gerard le Grellelaan 10,2023-04-16,17:00:00,69,56,13,FMN 05 Gerard Le Grellelaan
653,Gerard le Grellelaan 10,2023-04-16,18:00:00,71,62,9,FMN 05 Gerard Le Grellelaan
653,Gerard le Grellelaan 10,2023-04-16,19:00:00,38,28,10,FMN 05 Gerard Le Grellelaan
653,Gerard le Grellelaan 10,2023-04-16,20:00:00,22,18,4,FMN 05 Gerard Le Grellelaan
653,Gerard le Grellelaan 10,2023-04-16,21:00:00,22,15,7,FMN 05 Gerard Le Grellelaan
653,Gerard le Grellelaan 10,2023-04-16,22:00:00,16,13,3,FMN 05 Gerard Le Grellelaan
653,Gerard le Grellelaan 10,2023-04-16,23:00:00,18,12,6,FMN 05 Gerard Le Grellelaan
653,Gerard le Grellelaan 10,2023-04-17,00:00:00,1,0,1,FMN 05 Gerard Le Grellelaan
653,Gerard le Grellelaan 10,2023-04-17,01:00:00,2,2,0,FMN 05 Gerard Le Grellelaan
653,Gerard le Grellelaan 10,2023-04-17,02:00:00,4,2,2,FMN 05 Gerard Le Grellelaan
653,Gerard le Grellelaan 10,2023-04-17,03:00:00,4,4,0,FMN 05 Gerard Le Grellelaan
653,Gerard le Grellelaan 10,2023-04-17,04:00:00,9,1,8,FMN 05 Gerard Le Grellelaan
653,Gerard le Grellelaan 10,2023-04-17,05:00:00,25,9,16,FMN 05 Gerard Le Grellelaan
653,Gerard le Grellelaan 10,2023-04-17,06:00:00,64,38,26,FMN 05 Gerard Le Grellelaan
653,Gerard le Grellelaan 10,2023-04-17,07:00:00,160,118,42,FMN 05 Gerard Le Grellelaan
653,Gerard le Grellelaan 10,2023-04-17,08:00:00,329,262,67,FMN 05 Gerard Le Grellelaan
653,Gerard le Grellelaan 10,2023-04-17,09:00:00,93,77,16,FMN 05 Gerard Le Grellelaan
653,Gerard le Grellelaan 10,2023-04-17,10:00:00,64,54,10,FMN 05 Gerard Le Grellelaan
653,Gerard le Grellelaan 10,2023-04-17,11:00:00,57,51,6,FMN 05 Gerard Le Grellelaan
653,Gerard le Grellelaan 10,2023-04-17,12:00:00,99,79,20,FMN 05 Gerard Le Grellelaan
653,Gerard le Grellelaan 10,2023-04-17,13:00:00,78,61,17,FMN 05 Gerard Le Grellelaan
653,Gerard le Grellelaan 10,2023-04-17,14:00:00,106,92,14,FMN 05 Gerard Le Grellelaan
653,Gerard le Grellelaan 10,2023-04-17,15:00:00,154,127,27,FMN 05 Gerard Le Grellelaan
653,Gerard le Grellelaan 10,2023-04-17,16:00:00,211,159,52,FMN 05 Gerard Le Grellelaan
653,Gerard le Grellelaan 10,2023-04-17,17:00:00,242,196,46,FMN 05 Gerard Le Grellelaan
653,Gerard le Grellelaan 10,2023-04-17,18:00:00,155,122,33,FMN 05 Gerard Le Grellelaan
653,Gerard le Grellelaan 10,2023-04-17,19:00:00,93,80,13,FMN 05 Gerard Le Grellelaan
653,Gerard le Grellelaan 10,2023-04-17,20:00:00,47,38,9,FMN 05 Gerard Le Grellelaan
653,Gerard le Grellelaan 10,2023-04-17,21:00:00,44,37,7,FMN 05 Gerard Le Grellelaan
653,Gerard le Grellelaan 10,2023-04-17,22:00:00,32,31,1,FMN 05 Gerard Le Grellelaan
653,Gerard le Grellelaan 10,2023-04-17,23:00:00,21,13,8,FMN 05 Gerard Le Grellelaan
653,Gerard le Grellelaan 10,2023-04-18,00:00:00,9,6,3,FMN 05 Gerard Le Grellelaan
653,Gerard le Grellelaan 10,2023-04-18,01:00:00,6,3,3,FMN 05 Gerard Le Grellelaan
653,Gerard le Grellelaan 10,2023-04-18,02:00:00,2,2,0,FMN 05 Gerard Le Grellelaan
653,Gerard le Grellelaan 10,2023-04-18,03:00:00,2,1,1,FMN 05 Gerard Le Grellelaan
653,Gerard le Grellelaan 10,2023-04-18,04:00:00,5,2,3,FMN 05 Gerard Le Grellelaan
653,Gerard le Grellelaan 10,2023-04-18,05:00:00,30,10,20,FMN 05 Gerard Le Grellelaan
653,Gerard le Grellelaan 10,2023-04-18,06:00:00,61,30,31,FMN 05 Gerard Le Grellelaan
653,Gerard le Grellelaan 10,2023-04-18,07:00:00,186,135,51,FMN 05 Gerard Le Grellelaan
653,Gerard le Grellelaan 10,2023-04-18,08:00:00,275,225,50,FMN 05 Gerard Le Grellelaan
653,Gerard le Grellelaan 10,2023-04-18,09:00:00,0,0,0,FMN 05 Gerard Le Grellelaan
653,Gerard le Grellelaan 10,2023-04-18,10:00:00,68,53,15,FMN 05 Gerard Le Grellelaan
653,Gerard le Grellelaan 10,2023-04-18,11:00:00,68,58,10,FMN 05 Gerard Le Grellelaan
653,Gerard le Grellelaan 10,2023-04-18,12:00:00,105,88,17,FMN 05 Gerard Le Grellelaan
653,Gerard le Grellelaan 10,2023-04-18,13:00:00,92,76,16,FMN 05 Gerard Le Grellelaan
653,Gerard le Grellelaan 10,2023-04-18,14:00:00,91,74,17,FMN 05 Gerard Le Grellelaan
653,Gerard le Grellelaan 10,2023-04-18,15:00:00,159,137,22,FMN 05 Gerard Le Grellelaan
653,Gerard le Grellelaan 10,2023-04-18,16:00:00,235,192,43,FMN 05 Gerard Le Grellelaan
653,Gerard le Grellelaan 10,2023-04-18,17:00:00,284,225,59,FMN 05 Gerard Le Grellelaan
653,Gerard le Grellelaan 10,2023-04-18,18:00:00,154,122,32,FMN 05 Gerard Le Grellelaan
653,Gerard le Grellelaan 10,2023-04-18,19:00:00,100,80,20,FMN 05 Gerard Le Grellelaan
653,Gerard le Grellelaan 10,2023-04-18,20:00:00,81,66,15,FMN 05 Gerard Le Grellelaan
653,Gerard le Grellelaan 10,2023-04-18,21:00:00,61,47,14,FMN 05 Gerard Le Grellelaan
653,Gerard le Grellelaan 10,2023-04-18,22:00:00,42,35,7,FMN 05 Gerard Le Grellelaan
653,Gerard le Grellelaan 10,2023-04-18,23:00:00,14,8,6,FMN 05 Gerard Le Grellelaan
653,Gerard le Grellelaan 10,2023-04-19,00:00:00,7,2,5,FMN 05 Gerard Le Grellelaan
653,Gerard le Grellelaan 10,2023-04-19,01:00:00,1,0,1,FMN 05 Gerard Le Grellelaan
653,Gerard le Grellelaan 10,2023-04-19,02:00:00,2,2,0,FMN 05 Gerard Le Grellelaan
653,Gerard le Grellelaan 10,2023-04-19,03:00:00,3,3,0,FMN 05 Gerard Le Grellelaan
653,Gerard le Grellelaan 10,2023-04-19,04:00:00,10,6,4,FMN 05 Gerard Le Grellelaan
653,Gerard le Grellelaan 10,2023-04-19,05:00:00,36,16,20,FMN 05 Gerard Le Grellelaan
653,Gerard le Grellelaan 10,2023-04-19,06:00:00,60,26,34,FMN 05 Gerard Le Grellelaan
653,Gerard le Grellelaan 10,2023-04-19,07:00:00,147,96,51,FMN 05 Gerard Le Grellelaan
653,Gerard le Grellelaan 10,2023-04-19,08:00:00,307,255,52,FMN 05 Gerard Le Grellelaan
653,Gerard le Grellelaan 10,2023-04-19,09:00:00,105,84,21,FMN 05 Gerard Le Grellelaan
653,Gerard le Grellelaan 10,2023-04-19,10:00:00,71,64,7,FMN 05 Gerard Le Grellelaan
653,Gerard le Grellelaan 10,2023-04-19,11:00:00,81,66,15,FMN 05 Gerard Le Grellelaan
653,Gerard le Grellelaan 10,2023-04-19,12:00:00,161,117,44,FMN 05 Gerard Le Grellelaan
653,Gerard le Grellelaan 10,2023-04-19,13:00:00,40,28,12,FMN 05 Gerard Le Grellelaan
653,Gerard le Grellelaan 10,2023-04-19,14:00:00,7,5,2,FMN 05 Gerard Le Grellelaan
653,Gerard le Grellelaan 10,2023-04-19,15:00:00,0,0,0,FMN 05 Gerard Le Grellelaan
653,Gerard le Grellelaan 10,2023-04-19,16:00:00,44,37,7,FMN 05 Gerard Le Grellelaan
653,Gerard le Grellelaan 10,2023-04-19,17:00:00,163,132,31,FMN 05 Gerard Le Grellelaan
653,Gerard le Grellelaan 10,2023-04-19,18:00:00,180,144,36,FMN 05 Gerard Le Grellelaan
653,Gerard le Grellelaan 10,2023-04-19,19:00:00,106,86,20,FMN 05 Gerard Le Grellelaan
653,Gerard le Grellelaan 10,2023-04-19,20:00:00,82,63,19,FMN 05 Gerard Le Grellelaan
653,Gerard le Grellelaan 10,2023-04-19,21:00:00,39,32,7,FMN 05 Gerard Le Grellelaan
653,Gerard le Grellelaan 10,2023-04-19,22:00:00,53,42,11,FMN 05 Gerard Le Grellelaan
653,Gerard le Grellelaan 10,2023-04-19,23:00:00,17,13,4,FMN 05 Gerard Le Grellelaan
653,Gerard le Grellelaan 10,2023-04-20,00:00:00,12,4,8,FMN 05 Gerard Le Grellelaan
653,Gerard le Grellelaan 10,2023-04-20,01:00:00,2,2,0,FMN 05 Gerard Le Grellelaan
653,Gerard le Grellelaan 10,2023-04-20,02:00:00,1,1,0,FMN 05 Gerard Le Grellelaan
653,Gerard le Grellelaan 10,2023-04-20,03:00:00,4,3,1,FMN 05 Gerard Le Grellelaan
653,Gerard le Grellelaan 10,2023-04-20,04:00:00,5,3,2,FMN 05 Gerard Le Grellelaan
653,Gerard le Grellelaan 10,2023-04-20,05:00:00,24,9,15,FMN 05 Gerard Le Grellelaan
653,Gerard le Grellelaan 10,2023-04-20,06:00:00,60,39,21,FMN 05 Gerard Le Grellelaan
653,Gerard le Grellelaan 10,2023-04-20,07:00:00,139,102,37,FMN 05 Gerard Le Grellelaan
653,Gerard le Grellelaan 10,2023-04-20,08:00:00,276,219,57,FMN 05 Gerard Le Grellelaan
653,Gerard le Grellelaan 10,2023-04-20,09:00:00,107,86,21,FMN 05 Gerard Le Grellelaan
653,Gerard le Grellelaan 10,2023-04-20,10:00:00,46,38,8,FMN 05 Gerard Le Grellelaan
653,Gerard le Grellelaan 10,2023-04-20,11:00:00,66,59,7,FMN 05 Gerard Le Grellelaan
653,Gerard le Grellelaan 10,2023-04-20,12:00:00,90,75,15,FMN 05 Gerard Le Grellelaan
653,Gerard le Grellelaan 10,2023-04-20,13:00:00,70,53,17,FMN 05 Gerard Le Grellelaan
653,Gerard le Grellelaan 10,2023-04-20,14:00:00,79,56,23,FMN 05 Gerard Le Grellelaan
653,Gerard le Grellelaan 10,2023-04-20,15:00:00,128,104,24,FMN 05 Gerard Le Grellelaan
653,Gerard le Grellelaan 10,2023-04-20,16:00:00,178,144,34,FMN 05 Gerard Le Grellelaan
653,Gerard le Grellelaan 10,2023-04-20,17:00:00,202,166,36,FMN 05 Gerard Le Grellelaan
653,Gerard le Grellelaan 10,2023-04-20,18:00:00,145,117,28,FMN 05 Gerard Le Grellelaan
653,Gerard le Grellelaan 10,2023-04-20,19:00:00,96,79,17,FMN 05 Gerard Le Grellelaan
653,Gerard le Grellelaan 10,2023-04-20,20:00:00,72,60,12,FMN 05 Gerard Le Grellelaan
653,Gerard le Grellelaan 10,2023-04-20,21:00:00,33,24,9,FMN 05 Gerard Le Grellelaan
653,Gerard le Grellelaan 10,2023-04-20,22:00:00,37,31,6,FMN 05 Gerard Le Grellelaan
653,Gerard le Grellelaan 10,2023-04-20,23:00:00,19,10,9,FMN 05 Gerard Le Grellelaan
653,Gerard le Grellelaan 10,2023-04-21,00:00:00,9,7,2,FMN 05 Gerard Le Grellelaan
653,Gerard le Grellelaan 10,2023-04-21,01:00:00,3,3,0,FMN 05 Gerard Le Grellelaan
653,Gerard le Grellelaan 10,2023-04-21,02:00:00,8,7,1,FMN 05 Gerard Le Grellelaan
653,Gerard le Grellelaan 10,2023-04-21,03:00:00,9,9,0,FMN 05 Gerard Le Grellelaan
653,Gerard le Grellelaan 10,2023-04-21,04:00:00,9,5,4,FMN 05 Gerard Le Grellelaan
653,Gerard le Grellelaan 10,2023-04-21,05:00:00,23,6,17,FMN 05 Gerard Le Grellelaan
653,Gerard le Grellelaan 10,2023-04-21,06:00:00,42,24,18,FMN 05 Gerard Le Grellelaan
653,Gerard le Grellelaan 10,2023-04-21,07:00:00,131,90,41,FMN 05 Gerard Le Grellelaan
653,Gerard le Grellelaan 10,2023-04-21,08:00:00,285,234,51,FMN 05 Gerard Le Grellelaan
653,Gerard le Grellelaan 10,2023-04-21,09:00:00,118,100,18,FMN 05 Gerard Le Grellelaan
653,Gerard le Grellelaan 10,2023-04-21,10:00:00,54,41,13,FMN 05 Gerard Le Grellelaan
653,Gerard le Grellelaan 10,2023-04-21,11:00:00,86,70,16,FMN 05 Gerard Le Grellelaan
653,Gerard le Grellelaan 10,2023-04-21,12:00:00,106,87,19,FMN 05 Gerard Le Grellelaan
653,Gerard le Grellelaan 10,2023-04-21,13:00:00,61,52,9,FMN 05 Gerard Le Grellelaan
653,Gerard le Grellelaan 10,2023-04-21,14:00:00,88,80,8,FMN 05 Gerard Le Grellelaan
653,Gerard le Grellelaan 10,2023-04-21,15:00:00,168,127,41,FMN 05 Gerard Le Grellelaan
653,Gerard le Grellelaan 10,2023-04-21,16:00:00,212,168,44,FMN 05 Gerard Le Grellelaan
653,Gerard le Grellelaan 10,2023-04-21,17:00:00,197,148,49,FMN 05 Gerard Le Grellelaan
653,Gerard le Grellelaan 10,2023-04-21,18:00:00,155,121,34,FMN 05 Gerard Le Grellelaan
653,Gerard le Grellelaan 10,2023-04-21,19:00:00,81,71,10,FMN 05 Gerard Le Grellelaan
653,Gerard le Grellelaan 10,2023-04-21,20:00:00,71,59,12,FMN 05 Gerard Le Grellelaan
653,Gerard le Grellelaan 10,2023-04-21,21:00:00,31,28,3,FMN 05 Gerard Le Grellelaan
653,Gerard le Grellelaan 10,2023-04-21,22:00:00,27,24,3,FMN 05 Gerard Le Grellelaan
653,Gerard le Grellelaan 10,2023-04-21,23:00:00,20,14,6,FMN 05 Gerard Le Grellelaan
653,Gerard le Grellelaan 10,2023-04-22,00:00:00,13,9,4,FMN 05 Gerard Le Grellelaan
653,Gerard le Grellelaan 10,2023-04-22,01:00:00,17,14,3,FMN 05 Gerard Le Grellelaan
653,Gerard le Grellelaan 10,2023-04-22,02:00:00,12,11,1,FMN 05 Gerard Le Grellelaan
653,Gerard le Grellelaan 10,2023-04-22,03:00:00,7,5,2,FMN 05 Gerard Le Grellelaan
653,Gerard le Grellelaan 10,2023-04-22,04:00:00,9,5,4,FMN 05 Gerard Le Grellelaan
653,Gerard le Grellelaan 10,2023-04-22,05:00:00,8,4,4,FMN 05 Gerard Le Grellelaan
653,Gerard le Grellelaan 10,2023-04-22,06:00:00,15,10,5,FMN 05 Gerard Le Grellelaan
653,Gerard le Grellelaan 10,2023-04-22,07:00:00,13,11,2,FMN 05 Gerard Le Grellelaan
653,Gerard le Grellelaan 10,2023-04-22,08:00:00,26,24,2,FMN 05 Gerard Le Grellelaan
653,Gerard le Grellelaan 10,2023-04-22,09:00:00,60,47,13,FMN 05 Gerard Le Grellelaan
653,Gerard le Grellelaan 10,2023-04-22,10:00:00,48,32,16,FMN 05 Gerard Le Grellelaan
653,Gerard le Grellelaan 10,2023-04-22,11:00:00,77,66,11,FMN 05 Gerard Le Grellelaan
653,Gerard le Grellelaan 10,2023-04-22,12:00:00,61,49,12,FMN 05 Gerard Le Grellelaan
653,Gerard le Grellelaan 10,2023-04-22,13:00:00,50,39,11,FMN 05 Gerard Le Grellelaan
653,Gerard le Grellelaan 10,2023-04-22,14:00:00,49,32,17,FMN 05 Gerard Le Grellelaan
653,Gerard le Grellelaan 10,2023-04-22,15:00:00,43,30,13,FMN 05 Gerard Le Grellelaan
653,Gerard le Grellelaan 10,2023-04-22,16:00:00,51,40,11,FMN 05 Gerard Le Grellelaan
653,Gerard le Grellelaan 10,2023-04-22,17:00:00,62,54,8,FMN 05 Gerard Le Grellelaan
653,Gerard le Grellelaan 10,2023-04-22,18:00:00,52,41,11,FMN 05 Gerard Le Grellelaan
653,Gerard le Grellelaan 10,2023-04-22,19:00:00,41,35,6,FMN 05 Gerard Le Grellelaan
653,Gerard le Grellelaan 10,2023-04-22,20:00:00,37,29,8,FMN 05 Gerard Le Grellelaan
653,Gerard le Grellelaan 10,2023-04-22,21:00:00,17,15,2,FMN 05 Gerard Le Grellelaan
653,Gerard le Grellelaan 10,2023-04-22,22:00:00,19,18,1,FMN 05 Gerard Le Grellelaan
653,Gerard le Grellelaan 10,2023-04-22,23:00:00,13,10,3,FMN 05 Gerard Le Grellelaan
653,Gerard le Grellelaan 10,2023-04-23,00:00:00,17,16,1,FMN 05 Gerard Le Grellelaan
653,Gerard le Grellelaan 10,2023-04-23,01:00:00,19,10,9,FMN 05 Gerard Le Grellelaan
653,Gerard le Grellelaan 10,2023-04-23,02:00:00,3,3,0,FMN 05 Gerard Le Grellelaan
653,Gerard le Grellelaan 10,2023-04-23,03:00:00,4,1,3,FMN 05 Gerard Le Grellelaan
653,Gerard le Grellelaan 10,2023-04-23,04:00:00,1,0,1,FMN 05 Gerard Le Grellelaan
653,Gerard le Grellelaan 10,2023-04-23,05:00:00,9,4,5,FMN 05 Gerard Le Grellelaan
653,Gerard le Grellelaan 10,2023-04-23,06:00:00,12,7,5,FMN 05 Gerard Le Grellelaan
653,Gerard le Grellelaan 10,2023-04-23,07:00:00,13,10,3,FMN 05 Gerard Le Grellelaan
653,Gerard le Grellelaan 10,2023-04-23,08:00:00,16,14,2,FMN 05 Gerard Le Grellelaan
653,Gerard le Grellelaan 10,2023-04-23,09:00:00,79,59,20,FMN 05 Gerard Le Grellelaan
653,Gerard le Grellelaan 10,2023-04-23,10:00:00,118,96,22,FMN 05 Gerard Le Grellelaan
653,Gerard le Grellelaan 10,2023-04-23,11:00:00,107,92,15,FMN 05 Gerard Le Grellelaan
653,Gerard le Grellelaan 10,2023-04-23,12:00:00,131,117,14,FMN 05 Gerard Le Grellelaan
653,Gerard le Grellelaan 10,2023-04-23,13:00:00,127,117,10,FMN 05 Gerard Le Grellelaan
653,Gerard le Grellelaan 10,2023-04-23,14:00:00,93,82,11,FMN 05 Gerard Le Grellelaan
653,Gerard le Grellelaan 10,2023-04-23,15:00:00,52,42,10,FMN 05 Gerard Le Grellelaan
653,Gerard le Grellelaan 10,2023-04-23,16:00:00,40,31,9,FMN 05 Gerard Le Grellelaan
653,Gerard le Grellelaan 10,2023-04-23,17:00:00,55,45,10,FMN 05 Gerard Le Grellelaan
653,Gerard le Grellelaan 10,2023-04-23,18:00:00,47,41,6,FMN 05 Gerard Le Grellelaan
653,Gerard le Grellelaan 10,2023-04-23,19:00:00,23,17,6,FMN 05 Gerard Le Grellelaan
653,Gerard le Grellelaan 10,2023-04-23,20:00:00,26,14,12,FMN 05 Gerard Le Grellelaan
653,Gerard le Grellelaan 10,2023-04-23,21:00:00,18,12,6,FMN 05 Gerard Le Grellelaan
653,Gerard le Grellelaan 10,2023-04-23,22:00:00,21,14,7,FMN 05 Gerard Le Grellelaan
653,Gerard le Grellelaan 10,2023-04-23,23:00:00,5,4,1,FMN 05 Gerard Le Grellelaan
653,Gerard le Grellelaan 10,2023-04-24,00:00:00,2,2,0,FMN 05 Gerard Le Grellelaan
653,Gerard le Grellelaan 10,2023-04-24,01:00:00,4,1,3,FMN 05 Gerard Le Grellelaan
653,Gerard le Grellelaan 10,2023-04-24,02:00:00,1,1,0,FMN 05 Gerard Le Grellelaan
653,Gerard le Grellelaan 10,2023-04-24,03:00:00,3,3,0,FMN 05 Gerard Le Grellelaan
653,Gerard le Grellelaan 10,2023-04-24,04:00:00,9,3,6,FMN 05 Gerard Le Grellelaan
653,Gerard le Grellelaan 10,2023-04-24,05:00:00,17,6,11,FMN 05 Gerard Le Grellelaan
653,Gerard le Grellelaan 10,2023-04-24,06:00:00,43,21,22,FMN 05 Gerard Le Grellelaan
653,Gerard le Grellelaan 10,2023-04-24,07:00:00,101,75,26,FMN 05 Gerard Le Grellelaan
653,Gerard le Grellelaan 10,2023-04-24,08:00:00,217,170,47,FMN 05 Gerard Le Grellelaan
653,Gerard le Grellelaan 10,2023-04-24,09:00:00,66,55,11,FMN 05 Gerard Le Grellelaan
653,Gerard le Grellelaan 10,2023-04-24,10:00:00,38,30,8,FMN 05 Gerard Le Grellelaan
653,Gerard le Grellelaan 10,2023-04-24,11:00:00,59,47,12,FMN 05 Gerard Le Grellelaan
653,Gerard le Grellelaan 10,2023-04-24,12:00:00,73,61,12,FMN 05 Gerard Le Grellelaan
653,Gerard le Grellelaan 10,2023-04-24,13:00:00,61,44,17,FMN 05 Gerard Le Grellelaan
653,Gerard le Grellelaan 10,2023-04-24,14:00:00,80,63,17,FMN 05 Gerard Le Grellelaan
653,Gerard le Grellelaan 10,2023-04-24,15:00:00,117,87,30,FMN 05 Gerard Le Grellelaan
653,Gerard le Grellelaan 10,2023-04-24,16:00:00,146,117,29,FMN 05 Gerard Le Grellelaan
653,Gerard le Grellelaan 10,2023-04-24,17:00:00,207,163,44,FMN 05 Gerard Le Grellelaan
653,Gerard le Grellelaan 10,2023-04-24,18:00:00,141,109,32,FMN 05 Gerard Le Grellelaan
653,Gerard le Grellelaan 10,2023-04-24,19:00:00,71,59,12,FMN 05 Gerard Le Grellelaan
653,Gerard le Grellelaan 10,2023-04-24,20:00:00,50,44,6,FMN 05 Gerard Le Grellelaan
653,Gerard le Grellelaan 10,2023-04-24,21:00:00,43,30,13,FMN 05 Gerard Le Grellelaan
653,Gerard le Grellelaan 10,2023-04-24,22:00:00,37,29,8,FMN 05 Gerard Le Grellelaan
653,Gerard le Grellelaan 10,2023-04-24,23:00:00,22,19,3,FMN 05 Gerard Le Grellelaan
653,Gerard le Grellelaan 10,2023-04-25,00:00:00,10,7,3,FMN 05 Gerard Le Grellelaan
653,Gerard le Grellelaan 10,2023-04-25,01:00:00,6,4,2,FMN 05 Gerard Le Grellelaan
653,Gerard le Grellelaan 10,2023-04-25,02:00:00,1,0,1,FMN 05 Gerard Le Grellelaan
653,Gerard le Grellelaan 10,2023-04-25,03:00:00,8,4,4,FMN 05 Gerard Le Grellelaan
653,Gerard le Grellelaan 10,2023-04-25,04:00:00,9,1,8,FMN 05 Gerard Le Grellelaan
653,Gerard le Grellelaan 10,2023-04-25,05:00:00,30,12,18,FMN 05 Gerard Le Grellelaan
653,Gerard le Grellelaan 10,2023-04-25,06:00:00,48,22,26,FMN 05 Gerard Le Grellelaan
653,Gerard le Grellelaan 10,2023-04-25,07:00:00,172,130,42,FMN 05 Gerard Le Grellelaan
653,Gerard le Grellelaan 10,2023-04-25,08:00:00,326,255,71,FMN 05 Gerard Le Grellelaan
653,Gerard le Grellelaan 10,2023-04-25,09:00:00,69,60,9,FMN 05 Gerard Le Grellelaan
653,Gerard le Grellelaan 10,2023-04-25,10:00:00,14,12,2,FMN 05 Gerard Le Grellelaan
653,Gerard le Grellelaan 10,2023-04-25,11:00:00,0,0,0,FMN 05 Gerard Le Grellelaan
653,Gerard le Grellelaan 10,2023-04-25,12:00:00,0,0,0,FMN 05 Gerard Le Grellelaan
653,Gerard le Grellelaan 10,2023-04-25,13:00:00,37,24,13,FMN 05 Gerard Le Grellelaan
653,Gerard le Grellelaan 10,2023-04-25,14:00:00,82,62,20,FMN 05 Gerard Le Grellelaan
653,Gerard le Grellelaan 10,2023-04-25,15:00:00,176,139,37,FMN 05 Gerard Le Grellelaan
653,Gerard le Grellelaan 10,2023-04-25,16:00:00,224,176,48,FMN 05 Gerard Le Grellelaan
653,Gerard le Grellelaan 10,2023-04-25,17:00:00,229,164,65,FMN 05 Gerard Le Grellelaan
653,Gerard le Grellelaan 10,2023-04-25,18:00:00,215,175,40,FMN 05 Gerard Le Grellelaan
653,Gerard le Grellelaan 10,2023-04-25,19:00:00,107,88,19,FMN 05 Gerard Le Grellelaan
653,Gerard le Grellelaan 10,2023-04-25,20:00:00,25,16,9,FMN 05 Gerard Le Grellelaan
653,Gerard le Grellelaan 10,2023-04-25,21:00:00,15,9,6,FMN 05 Gerard Le Grellelaan
653,Gerard le Grellelaan 10,2023-04-25,22:00:00,4,2,2,FMN 05 Gerard Le Grellelaan
653,Gerard le Grellelaan 10,2023-04-25,23:00:00,0,0,0,FMN 05 Gerard Le Grellelaan
653,Gerard le Grellelaan 10,2023-04-26,00:00:00,0,0,0,FMN 05 Gerard Le Grellelaan
653,Gerard le Grellelaan 10,2023-04-26,01:00:00,0,0,0,FMN 05 Gerard Le Grellelaan
653,Gerard le Grellelaan 10,2023-04-26,02:00:00,0,0,0,FMN 05 Gerard Le Grellelaan
653,Gerard le Grellelaan 10,2023-04-26,03:00:00,7,5,2,FMN 05 Gerard Le Grellelaan
653,Gerard le Grellelaan 10,2023-04-26,04:00:00,9,3,6,FMN 05 Gerard Le Grellelaan
653,Gerard le Grellelaan 10,2023-04-26,05:00:00,29,12,17,FMN 05 Gerard Le Grellelaan
653,Gerard le Grellelaan 10,2023-04-26,06:00:00,59,31,28,FMN 05 Gerard Le Grellelaan
653,Gerard le Grellelaan 10,2023-04-26,07:00:00,133,109,24,FMN 05 Gerard Le Grellelaan
653,Gerard le Grellelaan 10,2023-04-26,08:00:00,251,207,44,FMN 05 Gerard Le Grellelaan
653,Gerard le Grellelaan 10,2023-04-26,09:00:00,93,80,13,FMN 05 Gerard Le Grellelaan
653,Gerard le Grellelaan 10,2023-04-26,10:00:00,62,47,15,FMN 05 Gerard Le Grellelaan
653,Gerard le Grellelaan 10,2023-04-26,11:00:00,64,56,8,FMN 05 Gerard Le Grellelaan
653,Gerard le Grellelaan 10,2023-04-26,12:00:00,141,101,40,FMN 05 Gerard Le Grellelaan
653,Gerard le Grellelaan 10,2023-04-26,13:00:00,88,64,24,FMN 05 Gerard Le Grellelaan
653,Gerard le Grellelaan 10,2023-04-26,14:00:00,87,67,20,FMN 05 Gerard Le Grellelaan
653,Gerard le Grellelaan 10,2023-04-26,15:00:00,103,86,17,FMN 05 Gerard Le Grellelaan
653,Gerard le Grellelaan 10,2023-04-26,16:00:00,156,127,29,FMN 05 Gerard Le Grellelaan
653,Gerard le Grellelaan 10,2023-04-26,17:00:00,84,74,10,FMN 05 Gerard Le Grellelaan
653,Gerard le Grellelaan 10,2023-04-26,18:00:00,129,102,27,FMN 05 Gerard Le Grellelaan
653,Gerard le Grellelaan 10,2023-04-26,19:00:00,96,74,22,FMN 05 Gerard Le Grellelaan
653,Gerard le Grellelaan 10,2023-04-26,20:00:00,58,49,9,FMN 05 Gerard Le Grellelaan
653,Gerard le Grellelaan 10,2023-04-26,21:00:00,60,47,13,FMN 05 Gerard Le Grellelaan
653,Gerard le Grellelaan 10,2023-04-26,22:00:00,57,54,3,FMN 05 Gerard Le Grellelaan
653,Gerard le Grellelaan 10,2023-04-26,23:00:00,20,14,6,FMN 05 Gerard Le Grellelaan
653,Gerard le Grellelaan 10,2023-04-27,00:00:00,4,1,3,FMN 05 Gerard Le Grellelaan
653,Gerard le Grellelaan 10,2023-04-27,01:00:00,1,1,0,FMN 05 Gerard Le Grellelaan
653,Gerard le Grellelaan 10,2023-04-27,02:00:00,1,1,0,FMN 05 Gerard Le Grellelaan
653,Gerard le Grellelaan 10,2023-04-27,03:00:00,8,6,2,FMN 05 Gerard Le Grellelaan
653,Gerard le Grellelaan 10,2023-04-27,04:00:00,8,3,5,FMN 05 Gerard Le Grellelaan
653,Gerard le Grellelaan 10,2023-04-27,05:00:00,25,10,15,FMN 05 Gerard Le Grellelaan
653,Gerard le Grellelaan 10,2023-04-27,06:00:00,32,16,16,FMN 05 Gerard Le Grellelaan
653,Gerard le Grellelaan 10,2023-04-27,07:00:00,149,119,30,FMN 05 Gerard Le Grellelaan
653,Gerard le Grellelaan 10,2023-04-27,08:00:00,285,231,54,FMN 05 Gerard Le Grellelaan
653,Gerard le Grellelaan 10,2023-04-27,09:00:00,115,99,16,FMN 05 Gerard Le Grellelaan
653,Gerard le Grellelaan 10,2023-04-27,10:00:00,79,62,17,FMN 05 Gerard Le Grellelaan
653,Gerard le Grellelaan 10,2023-04-27,11:00:00,75,62,13,FMN 05 Gerard Le Grellelaan
653,Gerard le Grellelaan 10,2023-04-27,12:00:00,80,64,16,FMN 05 Gerard Le Grellelaan
653,Gerard le Grellelaan 10,2023-04-27,13:00:00,15,11,4,FMN 05 Gerard Le Grellelaan
653,Gerard le Grellelaan 10,2023-04-27,14:00:00,0,0,0,FMN 05 Gerard Le Grellelaan
653,Gerard le Grellelaan 10,2023-04-27,15:00:00,0,0,0,FMN 05 Gerard Le Grellelaan
653,Gerard le Grellelaan 10,2023-04-27,16:00:00,2,2,0,FMN 05 Gerard Le Grellelaan
653,Gerard le Grellelaan 10,2023-04-27,17:00:00,81,64,17,FMN 05 Gerard Le Grellelaan
653,Gerard le Grellelaan 10,2023-04-27,18:00:00,178,142,36,FMN 05 Gerard Le Grellelaan
653,Gerard le Grellelaan 10,2023-04-27,19:00:00,90,72,18,FMN 05 Gerard Le Grellelaan
653,Gerard le Grellelaan 10,2023-04-27,20:00:00,53,41,12,FMN 05 Gerard Le Grellelaan
653,Gerard le Grellelaan 10,2023-04-27,21:00:00,37,28,9,FMN 05 Gerard Le Grellelaan
653,Gerard le Grellelaan 10,2023-04-27,22:00:00,56,46,10,FMN 05 Gerard Le Grellelaan
653,Gerard le Grellelaan 10,2023-04-27,23:00:00,30,21,9,FMN 05 Gerard Le Grellelaan
653,Gerard le Grellelaan 10,2023-04-28,00:00:00,8,4,4,FMN 05 Gerard Le Grellelaan
653,Gerard le Grellelaan 10,2023-04-28,01:00:00,7,6,1,FMN 05 Gerard Le Grellelaan
653,Gerard le Grellelaan 10,2023-04-28,02:00:00,2,2,0,FMN 05 Gerard Le Grellelaan
653,Gerard le Grellelaan 10,2023-04-28,03:00:00,8,5,3,FMN 05 Gerard Le Grellelaan
653,Gerard le Grellelaan 10,2023-04-28,04:00:00,9,2,7,FMN 05 Gerard Le Grellelaan
653,Gerard le Grellelaan 10,2023-04-28,05:00:00,24,8,16,FMN 05 Gerard Le Grellelaan
653,Gerard le Grellelaan 10,2023-04-28,06:00:00,57,33,24,FMN 05 Gerard Le Grellelaan
653,Gerard le Grellelaan 10,2023-04-28,07:00:00,118,88,30,FMN 05 Gerard Le Grellelaan
653,Gerard le Grellelaan 10,2023-04-28,08:00:00,246,194,52,FMN 05 Gerard Le Grellelaan
653,Gerard le Grellelaan 10,2023-04-28,09:00:00,102,83,19,FMN 05 Gerard Le Grellelaan
653,Gerard le Grellelaan 10,2023-04-28,10:00:00,26,23,3,FMN 05 Gerard Le Grellelaan
653,Gerard le Grellelaan 10,2023-04-28,11:00:00,0,0,0,FMN 05 Gerard Le Grellelaan
653,Gerard le Grellelaan 10,2023-04-28,12:00:00,0,0,0,FMN 05 Gerard Le Grellelaan
653,Gerard le Grellelaan 10,2023-04-28,13:00:00,0,0,0,FMN 05 Gerard Le Grellelaan
653,Gerard le Grellelaan 10,2023-04-28,14:00:00,0,0,0,FMN 05 Gerard Le Grellelaan
653,Gerard le Grellelaan 10,2023-04-28,15:00:00,0,0,0,FMN 05 Gerard Le Grellelaan
653,Gerard le Grellelaan 10,2023-04-28,16:00:00,0,0,0,FMN 05 Gerard Le Grellelaan
653,Gerard le Grellelaan 10,2023-04-28,17:00:00,0,0,0,FMN 05 Gerard Le Grellelaan
653,Gerard le Grellelaan 10,2023-04-28,18:00:00,0,0,0,FMN 05 Gerard Le Grellelaan
653,Gerard le Grellelaan 10,2023-04-28,19:00:00,0,0,0,FMN 05 Gerard Le Grellelaan
653,Gerard le Grellelaan 10,2023-04-28,20:00:00,0,0,0,FMN 05 Gerard Le Grellelaan
653,Gerard le Grellelaan 10,2023-04-28,21:00:00,0,0,0,FMN 05 Gerard Le Grellelaan
653,Gerard le Grellelaan 10,2023-04-28,22:00:00,0,0,0,FMN 05 Gerard Le Grellelaan
653,Gerard le Grellelaan 10,2023-04-28,23:00:00,0,0,0,FMN 05 Gerard Le Grellelaan
653,Gerard le Grellelaan 10,2023-04-29,00:00:00,28,21,7,FMN 05 Gerard Le Grellelaan
653,Gerard le Grellelaan 10,2023-04-29,01:00:00,7,6,1,FMN 05 Gerard Le Grellelaan
653,Gerard le Grellelaan 10,2023-04-29,02:00:00,4,3,1,FMN 05 Gerard Le Grellelaan
653,Gerard le Grellelaan 10,2023-04-29,03:00:00,10,8,2,FMN 05 Gerard Le Grellelaan
653,Gerard le Grellelaan 10,2023-04-29,04:00:00,13,9,4,FMN 05 Gerard Le Grellelaan
653,Gerard le Grellelaan 10,2023-04-29,05:00:00,10,3,7,FMN 05 Gerard Le Grellelaan
653,Gerard le Grellelaan 10,2023-04-29,06:00:00,7,5,2,FMN 05 Gerard Le Grellelaan
653,Gerard le Grellelaan 10,2023-04-29,07:00:00,14,13,1,FMN 05 Gerard Le Grellelaan
653,Gerard le Grellelaan 10,2023-04-29,08:00:00,27,21,6,FMN 05 Gerard Le Grellelaan
653,Gerard le Grellelaan 10,2023-04-29,09:00:00,50,39,11,FMN 05 Gerard Le Grellelaan
653,Gerard le Grellelaan 10,2023-04-29,10:00:00,58,47,11,FMN 05 Gerard Le Grellelaan
653,Gerard le Grellelaan 10,2023-04-29,11:00:00,67,56,11,FMN 05 Gerard Le Grellelaan
653,Gerard le Grellelaan 10,2023-04-29,12:00:00,69,53,16,FMN 05 Gerard Le Grellelaan
653,Gerard le Grellelaan 10,2023-04-29,13:00:00,89,65,24,FMN 05 Gerard Le Grellelaan
653,Gerard le Grellelaan 10,2023-04-29,14:00:00,81,63,18,FMN 05 Gerard Le Grellelaan
653,Gerard le Grellelaan 10,2023-04-29,15:00:00,84,69,15,FMN 05 Gerard Le Grellelaan
653,Gerard le Grellelaan 10,2023-04-29,16:00:00,91,79,12,FMN 05 Gerard Le Grellelaan
653,Gerard le Grellelaan 10,2023-04-29,17:00:00,90,70,20,FMN 05 Gerard Le Grellelaan
653,Gerard le Grellelaan 10,2023-04-29,18:00:00,68,60,8,FMN 05 Gerard Le Grellelaan
653,Gerard le Grellelaan 10,2023-04-29,19:00:00,56,45,11,FMN 05 Gerard Le Grellelaan
653,Gerard le Grellelaan 10,2023-04-29,20:00:00,42,35,7,FMN 05 Gerard Le Grellelaan
653,Gerard le Grellelaan 10,2023-04-29,21:00:00,37,29,8,FMN 05 Gerard Le Grellelaan
653,Gerard le Grellelaan 10,2023-04-29,22:00:00,31,27,4,FMN 05 Gerard Le Grellelaan
653,Gerard le Grellelaan 10,2023-04-29,23:00:00,27,18,9,FMN 05 Gerard Le Grellelaan
653,Gerard le Grellelaan 10,2023-04-30,00:00:00,26,17,9,FMN 05 Gerard Le Grellelaan
653,Gerard le Grellelaan 10,2023-04-30,01:00:00,17,12,5,FMN 05 Gerard Le Grellelaan
653,Gerard le Grellelaan 10,2023-04-30,02:00:00,8,6,2,FMN 05 Gerard Le Grellelaan
653,Gerard le Grellelaan 10,2023-04-30,03:00:00,5,4,1,FMN 05 Gerard Le Grellelaan
653,Gerard le Grellelaan 10,2023-04-30,04:00:00,3,3,0,FMN 05 Gerard Le Grellelaan
653,Gerard le Grellelaan 10,2023-04-30,05:00:00,4,2,2,FMN 05 Gerard Le Grellelaan
653,Gerard le Grellelaan 10,2023-04-30,06:00:00,7,6,1,FMN 05 Gerard Le Grellelaan
653,Gerard le Grellelaan 10,2023-04-30,07:00:00,9,7,2,FMN 05 Gerard Le Grellelaan
653,Gerard le Grellelaan 10,2023-04-30,08:00:00,24,17,7,FMN 05 Gerard Le Grellelaan
653,Gerard le Grellelaan 10,2023-04-30,09:00:00,42,34,8,FMN 05 Gerard Le Grellelaan
653,Gerard le Grellelaan 10,2023-04-30,10:00:00,71,59,12,FMN 05 Gerard Le Grellelaan
653,Gerard le Grellelaan 10,2023-04-30,11:00:00,78,64,14,FMN 05 Gerard Le Grellelaan
653,Gerard le Grellelaan 10,2023-04-30,12:00:00,85,67,18,FMN 05 Gerard Le Grellelaan
653,Gerard le Grellelaan 10,2023-04-30,13:00:00,81,69,12,FMN 05 Gerard Le Grellelaan
653,Gerard le Grellelaan 10,2023-04-30,14:00:00,78,68,10,FMN 05 Gerard Le Grellelaan
653,Gerard le Grellelaan 10,2023-04-30,15:00:00,83,73,10,FMN 05 Gerard Le Grellelaan
653,Gerard le Grellelaan 10,2023-04-30,16:00:00,85,73,12,FMN 05 Gerard Le Grellelaan
653,Gerard le Grellelaan 10,2023-04-30,17:00:00,89,79,10,FMN 05 Gerard Le Grellelaan
653,Gerard le Grellelaan 10,2023-04-30,18:00:00,59,53,6,FMN 05 Gerard Le Grellelaan
653,Gerard le Grellelaan 10,2023-04-30,19:00:00,49,37,12,FMN 05 Gerard Le Grellelaan
653,Gerard le Grellelaan 10,2023-04-30,20:00:00,33,26,7,FMN 05 Gerard Le Grellelaan
653,Gerard le Grellelaan 10,2023-04-30,21:00:00,27,21,6,FMN 05 Gerard Le Grellelaan
653,Gerard le Grellelaan 10,2023-04-30,22:00:00,23,22,1,FMN 05 Gerard Le Grellelaan
653,Gerard le Grellelaan 10,2023-04-30,23:00:00,10,5,5,FMN 05 Gerard Le Grellelaan
653,Gerard le Grellelaan 10,2023-05-01,00:00:00,19,13,6,FMN 05 Gerard Le Grellelaan
653,Gerard le Grellelaan 10,2023-05-01,01:00:00,12,11,1,FMN 05 Gerard Le Grellelaan
653,Gerard le Grellelaan 10,2023-05-01,02:00:00,7,4,3,FMN 05 Gerard Le Grellelaan
653,Gerard le Grellelaan 10,2023-05-01,03:00:00,3,2,1,FMN 05 Gerard Le Grellelaan
653,Gerard le Grellelaan 10,2023-05-01,04:00:00,6,3,3,FMN 05 Gerard Le Grellelaan
653,Gerard le Grellelaan 10,2023-05-01,05:00:00,5,1,4,FMN 05 Gerard Le Grellelaan
653,Gerard le Grellelaan 10,2023-05-01,06:00:00,10,5,5,FMN 05 Gerard Le Grellelaan
653,Gerard le Grellelaan 10,2023-05-01,07:00:00,14,8,6,FMN 05 Gerard Le Grellelaan
653,Gerard le Grellelaan 10,2023-05-01,08:00:00,23,21,2,FMN 05 Gerard Le Grellelaan
653,Gerard le Grellelaan 10,2023-05-01,09:00:00,45,39,6,FMN 05 Gerard Le Grellelaan
653,Gerard le Grellelaan 10,2023-05-01,10:00:00,80,68,12,FMN 05 Gerard Le Grellelaan
653,Gerard le Grellelaan 10,2023-05-01,11:00:00,83,67,16,FMN 05 Gerard Le Grellelaan
653,Gerard le Grellelaan 10,2023-05-01,12:00:00,68,63,5,FMN 05 Gerard Le Grellelaan
653,Gerard le Grellelaan 10,2023-05-01,13:00:00,73,55,18,FMN 05 Gerard Le Grellelaan
653,Gerard le Grellelaan 10,2023-05-01,14:00:00,100,78,22,FMN 05 Gerard Le Grellelaan
653,Gerard le Grellelaan 10,2023-05-01,15:00:00,110,98,12,FMN 05 Gerard Le Grellelaan
653,Gerard le Grellelaan 10,2023-05-01,16:00:00,59,50,9,FMN 05 Gerard Le Grellelaan
653,Gerard le Grellelaan 10,2023-05-01,17:00:00,91,80,11,FMN 05 Gerard Le Grellelaan
653,Gerard le Grellelaan 10,2023-05-01,18:00:00,83,70,13,FMN 05 Gerard Le Grellelaan
653,Gerard le Grellelaan 10,2023-05-01,19:00:00,78,64,14,FMN 05 Gerard Le Grellelaan
653,Gerard le Grellelaan 10,2023-05-01,20:00:00,35,25,10,FMN 05 Gerard Le Grellelaan
653,Gerard le Grellelaan 10,2023-05-01,21:00:00,35,30,5,FMN 05 Gerard Le Grellelaan
653,Gerard le Grellelaan 10,2023-05-01,22:00:00,29,21,8,FMN 05 Gerard Le Grellelaan
653,Gerard le Grellelaan 10,2023-05-01,23:00:00,15,11,4,FMN 05 Gerard Le Grellelaan
653,Gerard le Grellelaan 10,2023-05-02,00:00:00,9,6,3,FMN 05 Gerard Le Grellelaan
653,Gerard le Grellelaan 10,2023-05-02,01:00:00,1,1,0,FMN 05 Gerard Le Grellelaan
653,Gerard le Grellelaan 10,2023-05-02,02:00:00,3,3,0,FMN 05 Gerard Le Grellelaan
653,Gerard le Grellelaan 10,2023-05-02,03:00:00,5,4,1,FMN 05 Gerard Le Grellelaan
653,Gerard le Grellelaan 10,2023-05-02,04:00:00,7,6,1,FMN 05 Gerard Le Grellelaan
653,Gerard le Grellelaan 10,2023-05-02,05:00:00,23,7,16,FMN 05 Gerard Le Grellelaan
653,Gerard le Grellelaan 10,2023-05-02,06:00:00,57,29,28,FMN 05 Gerard Le Grellelaan
653,Gerard le Grellelaan 10,2023-05-02,07:00:00,150,119,31,FMN 05 Gerard Le Grellelaan
653,Gerard le Grellelaan 10,2023-05-02,08:00:00,298,232,66,FMN 05 Gerard Le Grellelaan
653,Gerard le Grellelaan 10,2023-05-02,09:00:00,124,102,22,FMN 05 Gerard Le Grellelaan
653,Gerard le Grellelaan 10,2023-05-02,10:00:00,83,67,16,FMN 05 Gerard Le Grellelaan
653,Gerard le Grellelaan 10,2023-05-02,11:00:00,80,64,16,FMN 05 Gerard Le Grellelaan
653,Gerard le Grellelaan 10,2023-05-02,12:00:00,114,92,22,FMN 05 Gerard Le Grellelaan
653,Gerard le Grellelaan 10,2023-05-02,13:00:00,111,88,23,FMN 05 Gerard Le Grellelaan
653,Gerard le Grellelaan 10,2023-05-02,14:00:00,103,89,14,FMN 05 Gerard Le Grellelaan
653,Gerard le Grellelaan 10,2023-05-02,15:00:00,145,120,25,FMN 05 Gerard Le Grellelaan
653,Gerard le Grellelaan 10,2023-05-02,16:00:00,216,179,37,FMN 05 Gerard Le Grellelaan
653,Gerard le Grellelaan 10,2023-05-02,17:00:00,249,210,39,FMN 05 Gerard Le Grellelaan
653,Gerard le Grellelaan 10,2023-05-02,18:00:00,168,140,28,FMN 05 Gerard Le Grellelaan
653,Gerard le Grellelaan 10,2023-05-02,19:00:00,95,78,17,FMN 05 Gerard Le Grellelaan
653,Gerard le Grellelaan 10,2023-05-02,20:00:00,65,48,17,FMN 05 Gerard Le Grellelaan
653,Gerard le Grellelaan 10,2023-05-02,21:00:00,57,43,14,FMN 05 Gerard Le Grellelaan
653,Gerard le Grellelaan 10,2023-05-02,22:00:00,46,36,10,FMN 05 Gerard Le Grellelaan
653,Gerard le Grellelaan 10,2023-05-02,23:00:00,20,16,4,FMN 05 Gerard Le Grellelaan
653,Gerard le Grellelaan 10,2023-05-03,00:00:00,13,10,3,FMN 05 Gerard Le Grellelaan
653,Gerard le Grellelaan 10,2023-05-03,01:00:00,4,3,1,FMN 05 Gerard Le Grellelaan
653,Gerard le Grellelaan 10,2023-05-03,02:00:00,3,2,1,FMN 05 Gerard Le Grellelaan
653,Gerard le Grellelaan 10,2023-05-03,03:00:00,9,8,1,FMN 05 Gerard Le Grellelaan
653,Gerard le Grellelaan 10,2023-05-03,04:00:00,10,3,7,FMN 05 Gerard Le Grellelaan
653,Gerard le Grellelaan 10,2023-05-03,05:00:00,25,12,13,FMN 05 Gerard Le Grellelaan
653,Gerard le Grellelaan 10,2023-05-03,06:00:00,52,37,15,FMN 05 Gerard Le Grellelaan
653,Gerard le Grellelaan 10,2023-05-03,07:00:00,152,112,40,FMN 05 Gerard Le Grellelaan
653,Gerard le Grellelaan 10,2023-05-03,08:00:00,274,217,57,FMN 05 Gerard Le Grellelaan
653,Gerard le Grellelaan 10,2023-05-03,09:00:00,106,91,15,FMN 05 Gerard Le Grellelaan
653,Gerard le Grellelaan 10,2023-05-03,10:00:00,86,69,17,FMN 05 Gerard Le Grellelaan
653,Gerard le Grellelaan 10,2023-05-03,11:00:00,97,76,21,FMN 05 Gerard Le Grellelaan
653,Gerard le Grellelaan 10,2023-05-03,12:00:00,155,116,39,FMN 05 Gerard Le Grellelaan
653,Gerard le Grellelaan 10,2023-05-03,13:00:00,113,97,16,FMN 05 Gerard Le Grellelaan
653,Gerard le Grellelaan 10,2023-05-03,14:00:00,109,88,21,FMN 05 Gerard Le Grellelaan
653,Gerard le Grellelaan 10,2023-05-03,15:00:00,145,122,23,FMN 05 Gerard Le Grellelaan
653,Gerard le Grellelaan 10,2023-05-03,16:00:00,194,166,28,FMN 05 Gerard Le Grellelaan
653,Gerard le Grellelaan 10,2023-05-03,17:00:00,224,181,43,FMN 05 Gerard Le Grellelaan
653,Gerard le Grellelaan 10,2023-05-03,18:00:00,179,145,34,FMN 05 Gerard Le Grellelaan
653,Gerard le Grellelaan 10,2023-05-03,19:00:00,101,78,23,FMN 05 Gerard Le Grellelaan
653,Gerard le Grellelaan 10,2023-05-03,20:00:00,79,62,17,FMN 05 Gerard Le Grellelaan
653,Gerard le Grellelaan 10,2023-05-03,21:00:00,59,50,9,FMN 05 Gerard Le Grellelaan
653,Gerard le Grellelaan 10,2023-05-03,22:00:00,60,45,15,FMN 05 Gerard Le Grellelaan
653,Gerard le Grellelaan 10,2023-05-03,23:00:00,29,23,6,FMN 05 Gerard Le Grellelaan
653,Gerard le Grellelaan 10,2023-05-04,00:00:00,21,11,10,FMN 05 Gerard Le Grellelaan
653,Gerard le Grellelaan 10,2023-05-04,01:00:00,1,0,1,FMN 05 Gerard Le Grellelaan
653,Gerard le Grellelaan 10,2023-05-04,02:00:00,28,14,14,FMN 05 Gerard Le Grellelaan
653,Gerard le Grellelaan 10,2023-05-04,03:00:00,3,2,1,FMN 05 Gerard Le Grellelaan
653,Gerard le Grellelaan 10,2023-05-04,04:00:00,8,3,5,FMN 05 Gerard Le Grellelaan
653,Gerard le Grellelaan 10,2023-05-04,05:00:00,36,11,25,FMN 05 Gerard Le Grellelaan
653,Gerard le Grellelaan 10,2023-05-04,06:00:00,69,38,31,FMN 05 Gerard Le Grellelaan
653,Gerard le Grellelaan 10,2023-05-04,07:00:00,160,120,40,FMN 05 Gerard Le Grellelaan
653,Gerard le Grellelaan 10,2023-05-04,08:00:00,370,300,70,FMN 05 Gerard Le Grellelaan
653,Gerard le Grellelaan 10,2023-05-04,09:00:00,204,178,26,FMN 05 Gerard Le Grellelaan
653,Gerard le Grellelaan 10,2023-05-04,10:00:00,89,71,18,FMN 05 Gerard Le Grellelaan
653,Gerard le Grellelaan 10,2023-05-04,11:00:00,85,69,16,FMN 05 Gerard Le Grellelaan
653,Gerard le Grellelaan 10,2023-05-04,12:00:00,120,98,22,FMN 05 Gerard Le Grellelaan
653,Gerard le Grellelaan 10,2023-05-04,13:00:00,87,61,26,FMN 05 Gerard Le Grellelaan
653,Gerard le Grellelaan 10,2023-05-04,14:00:00,147,122,25,FMN 05 Gerard Le Grellelaan
653,Gerard le Grellelaan 10,2023-05-04,15:00:00,233,178,55,FMN 05 Gerard Le Grellelaan
653,Gerard le Grellelaan 10,2023-05-04,16:00:00,270,209,61,FMN 05 Gerard Le Grellelaan
653,Gerard le Grellelaan 10,2023-05-04,17:00:00,298,239,59,FMN 05 Gerard Le Grellelaan
653,Gerard le Grellelaan 10,2023-05-04,18:00:00,216,175,41,FMN 05 Gerard Le Grellelaan
653,Gerard le Grellelaan 10,2023-05-04,19:00:00,139,105,34,FMN 05 Gerard Le Grellelaan
653,Gerard le Grellelaan 10,2023-05-04,20:00:00,83,64,19,FMN 05 Gerard Le Grellelaan
653,Gerard le Grellelaan 10,2023-05-04,21:00:00,54,40,14,FMN 05 Gerard Le Grellelaan
653,Gerard le Grellelaan 10,2023-05-04,22:00:00,69,59,10,FMN 05 Gerard Le Grellelaan
653,Gerard le Grellelaan 10,2023-05-04,23:00:00,28,20,8,FMN 05 Gerard Le Grellelaan
653,Gerard le Grellelaan 10,2023-05-05,00:00:00,15,11,4,FMN 05 Gerard Le Grellelaan
653,Gerard le Grellelaan 10,2023-05-05,01:00:00,4,4,0,FMN 05 Gerard Le Grellelaan
653,Gerard le Grellelaan 10,2023-05-05,02:00:00,8,7,1,FMN 05 Gerard Le Grellelaan
653,Gerard le Grellelaan 10,2023-05-05,03:00:00,3,2,1,FMN 05 Gerard Le Grellelaan
653,Gerard le Grellelaan 10,2023-05-05,04:00:00,7,3,4,FMN 05 Gerard Le Grellelaan
653,Gerard le Grellelaan 10,2023-05-05,05:00:00,23,6,17,FMN 05 Gerard Le Grellelaan
653,Gerard le Grellelaan 10,2023-05-05,06:00:00,59,30,29,FMN 05 Gerard Le Grellelaan
653,Gerard le Grellelaan 10,2023-05-05,07:00:00,159,126,33,FMN 05 Gerard Le Grellelaan
653,Gerard le Grellelaan 10,2023-05-05,08:00:00,322,252,70,FMN 05 Gerard Le Grellelaan
653,Gerard le Grellelaan 10,2023-05-05,09:00:00,127,112,15,FMN 05 Gerard Le Grellelaan
653,Gerard le Grellelaan 10,2023-05-05,10:00:00,63,51,12,FMN 05 Gerard Le Grellelaan
653,Gerard le Grellelaan 10,2023-05-05,11:00:00,65,51,14,FMN 05 Gerard Le Grellelaan
653,Gerard le Grellelaan 10,2023-05-05,12:00:00,83,62,21,FMN 05 Gerard Le Grellelaan
653,Gerard le Grellelaan 10,2023-05-05,13:00:00,69,49,20,FMN 05 Gerard Le Grellelaan
653,Gerard le Grellelaan 10,2023-05-05,14:00:00,86,66,20,FMN 05 Gerard Le Grellelaan
653,Gerard le Grellelaan 10,2023-05-05,15:00:00,234,175,59,FMN 05 Gerard Le Grellelaan
653,Gerard le Grellelaan 10,2023-05-05,16:00:00,188,154,34,FMN 05 Gerard Le Grellelaan
653,Gerard le Grellelaan 10,2023-05-05,17:00:00,182,144,38,FMN 05 Gerard Le Grellelaan
653,Gerard le Grellelaan 10,2023-05-05,18:00:00,145,114,31,FMN 05 Gerard Le Grellelaan
653,Gerard le Grellelaan 10,2023-05-05,19:00:00,89,70,19,FMN 05 Gerard Le Grellelaan
653,Gerard le Grellelaan 10,2023-05-05,20:00:00,72,61,11,FMN 05 Gerard Le Grellelaan
653,Gerard le Grellelaan 10,2023-05-05,21:00:00,40,34,6,FMN 05 Gerard Le Grellelaan
653,Gerard le Grellelaan 10,2023-05-05,22:00:00,28,26,2,FMN 05 Gerard Le Grellelaan
653,Gerard le Grellelaan 10,2023-05-05,23:00:00,30,19,11,FMN 05 Gerard Le Grellelaan
653,Gerard le Grellelaan 10,2023-05-06,00:00:00,20,11,9,FMN 05 Gerard Le Grellelaan
653,Gerard le Grellelaan 10,2023-05-06,01:00:00,12,9,3,FMN 05 Gerard Le Grellelaan
653,Gerard le Grellelaan 10,2023-05-06,02:00:00,6,5,1,FMN 05 Gerard Le Grellelaan
653,Gerard le Grellelaan 10,2023-05-06,03:00:00,5,2,3,FMN 05 Gerard Le Grellelaan
653,Gerard le Grellelaan 10,2023-05-06,04:00:00,4,4,0,FMN 05 Gerard Le Grellelaan
653,Gerard le Grellelaan 10,2023-05-06,05:00:00,9,5,4,FMN 05 Gerard Le Grellelaan
653,Gerard le Grellelaan 10,2023-05-06,06:00:00,10,5,5,FMN 05 Gerard Le Grellelaan
653,Gerard le Grellelaan 10,2023-05-06,07:00:00,19,12,7,FMN 05 Gerard Le Grellelaan
653,Gerard le Grellelaan 10,2023-05-06,08:00:00,33,22,11,FMN 05 Gerard Le Grellelaan
653,Gerard le Grellelaan 10,2023-05-06,09:00:00,63,44,19,FMN 05 Gerard Le Grellelaan
653,Gerard le Grellelaan 10,2023-05-06,10:00:00,73,66,7,FMN 05 Gerard Le Grellelaan
653,Gerard le Grellelaan 10,2023-05-06,11:00:00,100,84,16,FMN 05 Gerard Le Grellelaan
653,Gerard le Grellelaan 10,2023-05-06,12:00:00,96,82,14,FMN 05 Gerard Le Grellelaan
653,Gerard le Grellelaan 10,2023-05-06,13:00:00,112,87,25,FMN 05 Gerard Le Grellelaan
653,Gerard le Grellelaan 10,2023-05-06,14:00:00,102,88,14,FMN 05 Gerard Le Grellelaan
653,Gerard le Grellelaan 10,2023-05-06,15:00:00,102,86,16,FMN 05 Gerard Le Grellelaan
653,Gerard le Grellelaan 10,2023-05-06,16:00:00,108,86,22,FMN 05 Gerard Le Grellelaan
653,Gerard le Grellelaan 10,2023-05-06,17:00:00,74,59,15,FMN 05 Gerard Le Grellelaan
653,Gerard le Grellelaan 10,2023-05-06,18:00:00,73,62,11,FMN 05 Gerard Le Grellelaan
653,Gerard le Grellelaan 10,2023-05-06,19:00:00,63,50,13,FMN 05 Gerard Le Grellelaan
653,Gerard le Grellelaan 10,2023-05-06,20:00:00,40,34,6,FMN 05 Gerard Le Grellelaan
653,Gerard le Grellelaan 10,2023-05-06,21:00:00,42,38,4,FMN 05 Gerard Le Grellelaan
653,Gerard le Grellelaan 10,2023-05-06,22:00:00,25,22,3,FMN 05 Gerard Le Grellelaan
653,Gerard le Grellelaan 10,2023-05-06,23:00:00,29,25,4,FMN 05 Gerard Le Grellelaan
653,Gerard le Grellelaan 10,2023-05-07,00:00:00,22,13,9,FMN 05 Gerard Le Grellelaan
653,Gerard le Grellelaan 10,2023-05-07,01:00:00,19,14,5,FMN 05 Gerard Le Grellelaan
653,Gerard le Grellelaan 10,2023-05-07,02:00:00,12,9,3,FMN 05 Gerard Le Grellelaan
653,Gerard le Grellelaan 10,2023-05-07,03:00:00,9,6,3,FMN 05 Gerard Le Grellelaan
653,Gerard le Grellelaan 10,2023-05-07,04:00:00,6,4,2,FMN 05 Gerard Le Grellelaan
653,Gerard le Grellelaan 10,2023-05-07,05:00:00,4,2,2,FMN 05 Gerard Le Grellelaan
653,Gerard le Grellelaan 10,2023-05-07,06:00:00,4,4,0,FMN 05 Gerard Le Grellelaan
653,Gerard le Grellelaan 10,2023-05-07,07:00:00,12,7,5,FMN 05 Gerard Le Grellelaan
653,Gerard le Grellelaan 10,2023-05-07,08:00:00,29,23,6,FMN 05 Gerard Le Grellelaan
653,Gerard le Grellelaan 10,2023-05-07,09:00:00,59,47,12,FMN 05 Gerard Le Grellelaan
653,Gerard le Grellelaan 10,2023-05-07,10:00:00,70,53,17,FMN 05 Gerard Le Grellelaan
653,Gerard le Grellelaan 10,2023-05-07,11:00:00,70,45,25,FMN 05 Gerard Le Grellelaan
653,Gerard le Grellelaan 10,2023-05-07,12:00:00,61,47,14,FMN 05 Gerard Le Grellelaan
653,Gerard le Grellelaan 10,2023-05-07,13:00:00,63,51,12,FMN 05 Gerard Le Grellelaan
653,Gerard le Grellelaan 10,2023-05-07,14:00:00,33,26,7,FMN 05 Gerard Le Grellelaan
653,Gerard le Grellelaan 10,2023-05-07,15:00:00,55,40,15,FMN 05 Gerard Le Grellelaan
653,Gerard le Grellelaan 10,2023-05-07,16:00:00,50,45,5,FMN 05 Gerard Le Grellelaan
653,Gerard le Grellelaan 10,2023-05-07,17:00:00,61,47,14,FMN 05 Gerard Le Grellelaan
653,Gerard le Grellelaan 10,2023-05-07,18:00:00,68,59,9,FMN 05 Gerard Le Grellelaan
653,Gerard le Grellelaan 10,2023-05-07,19:00:00,46,39,7,FMN 05 Gerard Le Grellelaan
653,Gerard le Grellelaan 10,2023-05-07,20:00:00,21,16,5,FMN 05 Gerard Le Grellelaan
653,Gerard le Grellelaan 10,2023-05-07,21:00:00,35,28,7,FMN 05 Gerard Le Grellelaan
653,Gerard le Grellelaan 10,2023-05-07,22:00:00,14,10,4,FMN 05 Gerard Le Grellelaan
653,Gerard le Grellelaan 10,2023-05-07,23:00:00,8,4,4,FMN 05 Gerard Le Grellelaan
653,Gerard le Grellelaan 10,2023-05-08,00:00:00,6,4,2,FMN 05 Gerard Le Grellelaan
653,Gerard le Grellelaan 10,2023-05-08,01:00:00,1,0,1,FMN 05 Gerard Le Grellelaan
653,Gerard le Grellelaan 10,2023-05-08,02:00:00,3,2,1,FMN 05 Gerard Le Grellelaan
653,Gerard le Grellelaan 10,2023-05-08,03:00:00,3,2,1,FMN 05 Gerard Le Grellelaan
653,Gerard le Grellelaan 10,2023-05-08,04:00:00,10,2,8,FMN 05 Gerard Le Grellelaan
653,Gerard le Grellelaan 10,2023-05-08,05:00:00,28,9,19,FMN 05 Gerard Le Grellelaan
653,Gerard le Grellelaan 10,2023-05-08,06:00:00,60,38,22,FMN 05 Gerard Le Grellelaan
653,Gerard le Grellelaan 10,2023-05-08,07:00:00,172,118,54,FMN 05 Gerard Le Grellelaan
653,Gerard le Grellelaan 10,2023-05-08,08:00:00,345,278,67,FMN 05 Gerard Le Grellelaan
653,Gerard le Grellelaan 10,2023-05-08,09:00:00,110,91,19,FMN 05 Gerard Le Grellelaan
653,Gerard le Grellelaan 10,2023-05-08,10:00:00,71,62,9,FMN 05 Gerard Le Grellelaan
653,Gerard le Grellelaan 10,2023-05-08,11:00:00,74,63,11,FMN 05 Gerard Le Grellelaan
653,Gerard le Grellelaan 10,2023-05-08,12:00:00,111,93,18,FMN 05 Gerard Le Grellelaan
653,Gerard le Grellelaan 10,2023-05-08,13:00:00,86,61,25,FMN 05 Gerard Le Grellelaan
653,Gerard le Grellelaan 10,2023-05-08,14:00:00,89,74,15,FMN 05 Gerard Le Grellelaan
653,Gerard le Grellelaan 10,2023-05-08,15:00:00,149,118,31,FMN 05 Gerard Le Grellelaan
653,Gerard le Grellelaan 10,2023-05-08,16:00:00,219,179,40,FMN 05 Gerard Le Grellelaan
653,Gerard le Grellelaan 10,2023-05-08,17:00:00,251,190,61,FMN 05 Gerard Le Grellelaan
653,Gerard le Grellelaan 10,2023-05-08,18:00:00,169,145,24,FMN 05 Gerard Le Grellelaan
653,Gerard le Grellelaan 10,2023-05-08,19:00:00,86,65,21,FMN 05 Gerard Le Grellelaan
653,Gerard le Grellelaan 10,2023-05-08,20:00:00,71,58,13,FMN 05 Gerard Le Grellelaan
653,Gerard le Grellelaan 10,2023-05-08,21:00:00,47,36,11,FMN 05 Gerard Le Grellelaan
653,Gerard le Grellelaan 10,2023-05-08,22:00:00,45,36,9,FMN 05 Gerard Le Grellelaan
653,Gerard le Grellelaan 10,2023-05-08,23:00:00,21,16,5,FMN 05 Gerard Le Grellelaan
653,Gerard le Grellelaan 10,2023-05-09,00:00:00,11,8,3,FMN 05 Gerard Le Grellelaan
653,Gerard le Grellelaan 10,2023-05-09,01:00:00,2,2,0,FMN 05 Gerard Le Grellelaan
653,Gerard le Grellelaan 10,2023-05-09,02:00:00,7,6,1,FMN 05 Gerard Le Grellelaan
653,Gerard le Grellelaan 10,2023-05-09,03:00:00,5,4,1,FMN 05 Gerard Le Grellelaan
653,Gerard le Grellelaan 10,2023-05-09,04:00:00,6,2,4,FMN 05 Gerard Le Grellelaan
653,Gerard le Grellelaan 10,2023-05-09,05:00:00,38,10,28,FMN 05 Gerard Le Grellelaan
653,Gerard le Grellelaan 10,2023-05-09,06:00:00,52,29,23,FMN 05 Gerard Le Grellelaan
653,Gerard le Grellelaan 10,2023-05-09,07:00:00,164,121,43,FMN 05 Gerard Le Grellelaan
653,Gerard le Grellelaan 10,2023-05-09,08:00:00,267,211,56,FMN 05 Gerard Le Grellelaan
653,Gerard le Grellelaan 10,2023-05-09,09:00:00,84,74,10,FMN 05 Gerard Le Grellelaan
653,Gerard le Grellelaan 10,2023-05-09,10:00:00,45,40,5,FMN 05 Gerard Le Grellelaan
653,Gerard le Grellelaan 10,2023-05-09,11:00:00,44,34,10,FMN 05 Gerard Le Grellelaan
653,Gerard le Grellelaan 10,2023-05-09,12:00:00,69,57,12,FMN 05 Gerard Le Grellelaan
653,Gerard le Grellelaan 10,2023-05-09,13:00:00,41,30,11,FMN 05 Gerard Le Grellelaan
653,Gerard le Grellelaan 10,2023-05-09,14:00:00,57,50,7,FMN 05 Gerard Le Grellelaan
653,Gerard le Grellelaan 10,2023-05-09,15:00:00,123,103,20,FMN 05 Gerard Le Grellelaan
653,Gerard le Grellelaan 10,2023-05-09,16:00:00,143,106,37,FMN 05 Gerard Le Grellelaan
653,Gerard le Grellelaan 10,2023-05-09,17:00:00,176,143,33,FMN 05 Gerard Le Grellelaan
653,Gerard le Grellelaan 10,2023-05-09,18:00:00,106,87,19,FMN 05 Gerard Le Grellelaan
653,Gerard le Grellelaan 10,2023-05-09,19:00:00,62,49,13,FMN 05 Gerard Le Grellelaan
653,Gerard le Grellelaan 10,2023-05-09,20:00:00,36,31,5,FMN 05 Gerard Le Grellelaan
653,Gerard le Grellelaan 10,2023-05-09,21:00:00,37,25,12,FMN 05 Gerard Le Grellelaan
653,Gerard le Grellelaan 10,2023-05-09,22:00:00,20,18,2,FMN 05 Gerard Le Grellelaan
653,Gerard le Grellelaan 10,2023-05-09,23:00:00,20,14,6,FMN 05 Gerard Le Grellelaan
653,Gerard le Grellelaan 10,2023-05-10,00:00:00,3,2,1,FMN 05 Gerard Le Grellelaan
653,Gerard le Grellelaan 10,2023-05-10,01:00:00,2,2,0,FMN 05 Gerard Le Grellelaan
653,Gerard le Grellelaan 10,2023-05-10,02:00:00,4,4,0,FMN 05 Gerard Le Grellelaan
653,Gerard le Grellelaan 10,2023-05-10,03:00:00,4,3,1,FMN 05 Gerard Le Grellelaan
653,Gerard le Grellelaan 10,2023-05-10,04:00:00,7,3,4,FMN 05 Gerard Le Grellelaan
653,Gerard le Grellelaan 10,2023-05-10,05:00:00,28,12,16,FMN 05 Gerard Le Grellelaan
653,Gerard le Grellelaan 10,2023-05-10,06:00:00,54,27,27,FMN 05 Gerard Le Grellelaan
653,Gerard le Grellelaan 10,2023-05-10,07:00:00,136,101,35,FMN 05 Gerard Le Grellelaan
653,Gerard le Grellelaan 10,2023-05-10,08:00:00,284,230,54,FMN 05 Gerard Le Grellelaan
653,Gerard le Grellelaan 10,2023-05-10,09:00:00,111,98,13,FMN 05 Gerard Le Grellelaan
653,Gerard le Grellelaan 10,2023-05-10,10:00:00,73,61,12,FMN 05 Gerard Le Grellelaan
653,Gerard le Grellelaan 10,2023-05-10,11:00:00,80,64,16,FMN 05 Gerard Le Grellelaan
653,Gerard le Grellelaan 10,2023-05-10,12:00:00,145,100,45,FMN 05 Gerard Le Grellelaan
653,Gerard le Grellelaan 10,2023-05-10,13:00:00,104,76,28,FMN 05 Gerard Le Grellelaan
653,Gerard le Grellelaan 10,2023-05-10,14:00:00,87,70,17,FMN 05 Gerard Le Grellelaan
653,Gerard le Grellelaan 10,2023-05-10,15:00:00,118,93,25,FMN 05 Gerard Le Grellelaan
653,Gerard le Grellelaan 10,2023-05-10,16:00:00,140,108,32,FMN 05 Gerard Le Grellelaan
653,Gerard le Grellelaan 10,2023-05-10,17:00:00,149,125,24,FMN 05 Gerard Le Grellelaan
653,Gerard le Grellelaan 10,2023-05-10,18:00:00,110,92,18,FMN 05 Gerard Le Grellelaan
653,Gerard le Grellelaan 10,2023-05-10,19:00:00,66,52,14,FMN 05 Gerard Le Grellelaan
653,Gerard le Grellelaan 10,2023-05-10,20:00:00,45,36,9,FMN 05 Gerard Le Grellelaan
653,Gerard le Grellelaan 10,2023-05-10,21:00:00,47,38,9,FMN 05 Gerard Le Grellelaan
653,Gerard le Grellelaan 10,2023-05-10,22:00:00,35,28,7,FMN 05 Gerard Le Grellelaan
653,Gerard le Grellelaan 10,2023-05-10,23:00:00,11,6,5,FMN 05 Gerard Le Grellelaan
653,Gerard le Grellelaan 10,2023-05-11,00:00:00,3,3,0,FMN 05 Gerard Le Grellelaan
653,Gerard le Grellelaan 10,2023-05-11,01:00:00,5,5,0,FMN 05 Gerard Le Grellelaan
653,Gerard le Grellelaan 10,2023-05-11,02:00:00,2,2,0,FMN 05 Gerard Le Grellelaan
653,Gerard le Grellelaan 10,2023-05-11,03:00:00,7,6,1,FMN 05 Gerard Le Grellelaan
653,Gerard le Grellelaan 10,2023-05-11,04:00:00,4,2,2,FMN 05 Gerard Le Grellelaan
653,Gerard le Grellelaan 10,2023-05-11,05:00:00,35,13,22,FMN 05 Gerard Le Grellelaan
653,Gerard le Grellelaan 10,2023-05-11,06:00:00,3,1,2,FMN 05 Gerard Le Grellelaan
653,Gerard le Grellelaan 10,2023-05-11,07:00:00,0,0,0,FMN 05 Gerard Le Grellelaan
653,Gerard le Grellelaan 10,2023-05-11,08:00:00,291,235,56,FMN 05 Gerard Le Grellelaan
653,Gerard le Grellelaan 10,2023-05-11,09:00:00,105,93,12,FMN 05 Gerard Le Grellelaan
653,Gerard le Grellelaan 10,2023-05-11,10:00:00,81,63,18,FMN 05 Gerard Le Grellelaan
653,Gerard le Grellelaan 10,2023-05-11,11:00:00,62,48,14,FMN 05 Gerard Le Grellelaan
653,Gerard le Grellelaan 10,2023-05-11,12:00:00,76,56,20,FMN 05 Gerard Le Grellelaan
653,Gerard le Grellelaan 10,2023-05-11,13:00:00,83,59,24,FMN 05 Gerard Le Grellelaan
653,Gerard le Grellelaan 10,2023-05-11,14:00:00,102,84,18,FMN 05 Gerard Le Grellelaan
653,Gerard le Grellelaan 10,2023-05-11,15:00:00,169,128,41,FMN 05 Gerard Le Grellelaan
653,Gerard le Grellelaan 10,2023-05-11,16:00:00,209,162,47,FMN 05 Gerard Le Grellelaan
653,Gerard le Grellelaan 10,2023-05-11,17:00:00,192,155,37,FMN 05 Gerard Le Grellelaan
653,Gerard le Grellelaan 10,2023-05-11,18:00:00,133,106,27,FMN 05 Gerard Le Grellelaan
653,Gerard le Grellelaan 10,2023-05-11,19:00:00,108,92,16,FMN 05 Gerard Le Grellelaan
653,Gerard le Grellelaan 10,2023-05-11,20:00:00,52,37,15,FMN 05 Gerard Le Grellelaan
653,Gerard le Grellelaan 10,2023-05-11,21:00:00,48,38,10,FMN 05 Gerard Le Grellelaan
653,Gerard le Grellelaan 10,2023-05-11,22:00:00,62,53,9,FMN 05 Gerard Le Grellelaan
653,Gerard le Grellelaan 10,2023-05-11,23:00:00,26,22,4,FMN 05 Gerard Le Grellelaan
653,Gerard le Grellelaan 10,2023-05-12,00:00:00,9,7,2,FMN 05 Gerard Le Grellelaan
653,Gerard le Grellelaan 10,2023-05-12,01:00:00,4,3,1,FMN 05 Gerard Le Grellelaan
653,Gerard le Grellelaan 10,2023-05-12,02:00:00,4,3,1,FMN 05 Gerard Le Grellelaan
653,Gerard le Grellelaan 10,2023-05-12,03:00:00,4,2,2,FMN 05 Gerard Le Grellelaan
653,Gerard le Grellelaan 10,2023-05-12,04:00:00,3,2,1,FMN 05 Gerard Le Grellelaan
653,Gerard le Grellelaan 10,2023-05-12,05:00:00,24,8,16,FMN 05 Gerard Le Grellelaan
653,Gerard le Grellelaan 10,2023-05-12,06:00:00,39,19,20,FMN 05 Gerard Le Grellelaan
653,Gerard le Grellelaan 10,2023-05-12,07:00:00,112,79,33,FMN 05 Gerard Le Grellelaan
653,Gerard le Grellelaan 10,2023-05-12,08:00:00,211,163,48,FMN 05 Gerard Le Grellelaan
653,Gerard le Grellelaan 10,2023-05-12,09:00:00,80,67,13,FMN 05 Gerard Le Grellelaan
653,Gerard le Grellelaan 10,2023-05-12,10:00:00,17,16,1,FMN 05 Gerard Le Grellelaan
653,Gerard le Grellelaan 10,2023-05-12,11:00:00,0,0,0,FMN 05 Gerard Le Grellelaan
653,Gerard le Grellelaan 10,2023-05-12,12:00:00,85,68,17,FMN 05 Gerard Le Grellelaan
653,Gerard le Grellelaan 10,2023-05-12,13:00:00,77,61,16,FMN 05 Gerard Le Grellelaan
653,Gerard le Grellelaan 10,2023-05-12,14:00:00,96,74,22,FMN 05 Gerard Le Grellelaan
653,Gerard le Grellelaan 10,2023-05-12,15:00:00,147,113,34,FMN 05 Gerard Le Grellelaan
653,Gerard le Grellelaan 10,2023-05-12,16:00:00,21,18,3,FMN 05 Gerard Le Grellelaan
653,Gerard le Grellelaan 10,2023-05-12,17:00:00,0,0,0,FMN 05 Gerard Le Grellelaan
653,Gerard le Grellelaan 10,2023-05-12,18:00:00,0,0,0,FMN 05 Gerard Le Grellelaan
653,Gerard le Grellelaan 10,2023-05-12,19:00:00,0,0,0,FMN 05 Gerard Le Grellelaan
653,Gerard le Grellelaan 10,2023-05-12,20:00:00,42,36,6,FMN 05 Gerard Le Grellelaan
653,Gerard le Grellelaan 10,2023-05-12,21:00:00,48,39,9,FMN 05 Gerard Le Grellelaan
653,Gerard le Grellelaan 10,2023-05-12,22:00:00,49,42,7,FMN 05 Gerard Le Grellelaan
653,Gerard le Grellelaan 10,2023-05-12,23:00:00,37,28,9,FMN 05 Gerard Le Grellelaan
653,Gerard le Grellelaan 10,2023-05-13,00:00:00,15,13,2,FMN 05 Gerard Le Grellelaan
653,Gerard le Grellelaan 10,2023-05-13,01:00:00,8,4,4,FMN 05 Gerard Le Grellelaan
653,Gerard le Grellelaan 10,2023-05-13,02:00:00,7,4,3,FMN 05 Gerard Le Grellelaan
653,Gerard le Grellelaan 10,2023-05-13,03:00:00,5,4,1,FMN 05 Gerard Le Grellelaan
653,Gerard le Grellelaan 10,2023-05-13,04:00:00,4,0,4,FMN 05 Gerard Le Grellelaan
653,Gerard le Grellelaan 10,2023-05-13,05:00:00,13,5,8,FMN 05 Gerard Le Grellelaan
653,Gerard le Grellelaan 10,2023-05-13,06:00:00,22,13,9,FMN 05 Gerard Le Grellelaan
653,Gerard le Grellelaan 10,2023-05-13,07:00:00,17,15,2,FMN 05 Gerard Le Grellelaan
653,Gerard le Grellelaan 10,2023-05-13,08:00:00,44,35,9,FMN 05 Gerard Le Grellelaan
653,Gerard le Grellelaan 10,2023-05-13,09:00:00,75,57,18,FMN 05 Gerard Le Grellelaan
653,Gerard le Grellelaan 10,2023-05-13,10:00:00,96,64,32,FMN 05 Gerard Le Grellelaan
653,Gerard le Grellelaan 10,2023-05-13,11:00:00,92,71,21,FMN 05 Gerard Le Grellelaan
653,Gerard le Grellelaan 10,2023-05-13,12:00:00,105,84,21,FMN 05 Gerard Le Grellelaan
653,Gerard le Grellelaan 10,2023-05-13,13:00:00,2,2,0,FMN 05 Gerard Le Grellelaan
653,Gerard le Grellelaan 10,2023-05-13,14:00:00,133,103,30,FMN 05 Gerard Le Grellelaan
653,Gerard le Grellelaan 10,2023-05-13,15:00:00,132,102,30,FMN 05 Gerard Le Grellelaan
653,Gerard le Grellelaan 10,2023-05-13,16:00:00,120,98,22,FMN 05 Gerard Le Grellelaan
653,Gerard le Grellelaan 10,2023-05-13,17:00:00,88,74,14,FMN 05 Gerard Le Grellelaan
653,Gerard le Grellelaan 10,2023-05-13,18:00:00,104,79,25,FMN 05 Gerard Le Grellelaan
653,Gerard le Grellelaan 10,2023-05-13,19:00:00,96,79,17,FMN 05 Gerard Le Grellelaan
653,Gerard le Grellelaan 10,2023-05-13,20:00:00,48,43,5,FMN 05 Gerard Le Grellelaan
653,Gerard le Grellelaan 10,2023-05-13,21:00:00,49,33,16,FMN 05 Gerard Le Grellelaan
653,Gerard le Grellelaan 10,2023-05-13,22:00:00,0,0,0,FMN 05 Gerard Le Grellelaan
653,Gerard le Grellelaan 10,2023-05-13,23:00:00,0,0,0,FMN 05 Gerard Le Grellelaan
653,Gerard le Grellelaan 10,2023-05-14,00:00:00,0,0,0,FMN 05 Gerard Le Grellelaan
653,Gerard le Grellelaan 10,2023-05-14,01:00:00,0,0,0,FMN 05 Gerard Le Grellelaan
653,Gerard le Grellelaan 10,2023-05-14,02:00:00,0,0,0,FMN 05 Gerard Le Grellelaan
653,Gerard le Grellelaan 10,2023-05-14,03:00:00,0,0,0,FMN 05 Gerard Le Grellelaan
653,Gerard le Grellelaan 10,2023-05-14,04:00:00,0,0,0,FMN 05 Gerard Le Grellelaan
653,Gerard le Grellelaan 10,2023-05-14,05:00:00,0,0,0,FMN 05 Gerard Le Grellelaan
653,Gerard le Grellelaan 10,2023-05-14,06:00:00,0,0,0,FMN 05 Gerard Le Grellelaan
653,Gerard le Grellelaan 10,2023-05-14,07:00:00,0,0,0,FMN 05 Gerard Le Grellelaan
653,Gerard le Grellelaan 10,2023-05-14,08:00:00,0,0,0,FMN 05 Gerard Le Grellelaan
653,Gerard le Grellelaan 10,2023-05-14,09:00:00,0,0,0,FMN 05 Gerard Le Grellelaan
653,Gerard le Grellelaan 10,2023-05-14,10:00:00,0,0,0,FMN 05 Gerard Le Grellelaan
653,Gerard le Grellelaan 10,2023-05-14,11:00:00,0,0,0,FMN 05 Gerard Le Grellelaan
653,Gerard le Grellelaan 10,2023-05-14,12:00:00,30,27,3,FMN 05 Gerard Le Grellelaan
653,Gerard le Grellelaan 10,2023-05-14,13:00:00,98,81,17,FMN 05 Gerard Le Grellelaan
653,Gerard le Grellelaan 10,2023-05-14,14:00:00,101,86,15,FMN 05 Gerard Le Grellelaan
653,Gerard le Grellelaan 10,2023-05-14,15:00:00,117,90,27,FMN 05 Gerard Le Grellelaan
653,Gerard le Grellelaan 10,2023-05-14,16:00:00,106,81,25,FMN 05 Gerard Le Grellelaan
653,Gerard le Grellelaan 10,2023-05-14,17:00:00,115,93,22,FMN 05 Gerard Le Grellelaan
653,Gerard le Grellelaan 10,2023-05-14,18:00:00,111,97,14,FMN 05 Gerard Le Grellelaan
653,Gerard le Grellelaan 10,2023-05-14,19:00:00,75,62,13,FMN 05 Gerard Le Grellelaan
653,Gerard le Grellelaan 10,2023-05-14,20:00:00,41,37,4,FMN 05 Gerard Le Grellelaan
653,Gerard le Grellelaan 10,2023-05-14,21:00:00,11,11,0,FMN 05 Gerard Le Grellelaan
653,Gerard le Grellelaan 10,2023-05-14,22:00:00,3,3,0,FMN 05 Gerard Le Grellelaan
653,Gerard le Grellelaan 10,2023-05-14,23:00:00,16,9,7,FMN 05 Gerard Le Grellelaan
653,Gerard le Grellelaan 10,2023-05-15,00:00:00,9,6,3,FMN 05 Gerard Le Grellelaan
653,Gerard le Grellelaan 10,2023-05-15,01:00:00,3,2,1,FMN 05 Gerard Le Grellelaan
653,Gerard le Grellelaan 10,2023-05-15,02:00:00,2,1,1,FMN 05 Gerard Le Grellelaan
653,Gerard le Grellelaan 10,2023-05-15,03:00:00,6,5,1,FMN 05 Gerard Le Grellelaan
653,Gerard le Grellelaan 10,2023-05-15,04:00:00,8,3,5,FMN 05 Gerard Le Grellelaan
653,Gerard le Grellelaan 10,2023-05-15,05:00:00,33,11,22,FMN 05 Gerard Le Grellelaan
653,Gerard le Grellelaan 10,2023-05-15,06:00:00,62,30,32,FMN 05 Gerard Le Grellelaan
653,Gerard le Grellelaan 10,2023-05-15,07:00:00,169,122,47,FMN 05 Gerard Le Grellelaan
653,Gerard le Grellelaan 10,2023-05-15,08:00:00,344,277,67,FMN 05 Gerard Le Grellelaan
653,Gerard le Grellelaan 10,2023-05-15,09:00:00,114,94,20,FMN 05 Gerard Le Grellelaan
653,Gerard le Grellelaan 10,2023-05-15,10:00:00,94,82,12,FMN 05 Gerard Le Grellelaan
653,Gerard le Grellelaan 10,2023-05-15,11:00:00,57,43,14,FMN 05 Gerard Le Grellelaan
653,Gerard le Grellelaan 10,2023-05-15,12:00:00,114,86,28,FMN 05 Gerard Le Grellelaan
653,Gerard le Grellelaan 10,2023-05-15,13:00:00,83,66,17,FMN 05 Gerard Le Grellelaan
653,Gerard le Grellelaan 10,2023-05-15,14:00:00,90,72,18,FMN 05 Gerard Le Grellelaan
653,Gerard le Grellelaan 10,2023-05-15,15:00:00,83,67,16,FMN 05 Gerard Le Grellelaan
653,Gerard le Grellelaan 10,2023-05-15,16:00:00,0,0,0,FMN 05 Gerard Le Grellelaan
653,Gerard le Grellelaan 10,2023-05-15,17:00:00,46,38,8,FMN 05 Gerard Le Grellelaan
653,Gerard le Grellelaan 10,2023-05-15,18:00:00,27,20,7,FMN 05 Gerard Le Grellelaan
653,Gerard le Grellelaan 10,2023-05-15,19:00:00,0,0,0,FMN 05 Gerard Le Grellelaan
653,Gerard le Grellelaan 10,2023-05-15,20:00:00,21,16,5,FMN 05 Gerard Le Grellelaan
653,Gerard le Grellelaan 10,2023-05-15,21:00:00,16,13,3,FMN 05 Gerard Le Grellelaan
653,Gerard le Grellelaan 10,2023-05-15,22:00:00,1,1,0,FMN 05 Gerard Le Grellelaan
653,Gerard le Grellelaan 10,2023-05-15,23:00:00,2,1,1,FMN 05 Gerard Le Grellelaan
653,Gerard le Grellelaan 10,2023-05-16,00:00:00,1,1,0,FMN 05 Gerard Le Grellelaan
653,Gerard le Grellelaan 10,2023-05-16,01:00:00,0,0,0,FMN 05 Gerard Le Grellelaan
653,Gerard le Grellelaan 10,2023-05-16,02:00:00,1,0,1,FMN 05 Gerard Le Grellelaan
653,Gerard le Grellelaan 10,2023-05-16,03:00:00,0,0,0,FMN 05 Gerard Le Grellelaan
653,Gerard le Grellelaan 10,2023-05-16,04:00:00,0,0,0,FMN 05 Gerard Le Grellelaan
653,Gerard le Grellelaan 10,2023-05-16,05:00:00,6,2,4,FMN 05 Gerard Le Grellelaan
653,Gerard le Grellelaan 10,2023-05-16,06:00:00,6,3,3,FMN 05 Gerard Le Grellelaan
653,Gerard le Grellelaan 10,2023-05-16,07:00:00,39,37,2,FMN 05 Gerard Le Grellelaan
653,Gerard le Grellelaan 10,2023-05-16,08:00:00,313,255,58,FMN 05 Gerard Le Grellelaan
653,Gerard le Grellelaan 10,2023-05-16,09:00:00,0,0,0,FMN 05 Gerard Le Grellelaan
653,Gerard le Grellelaan 10,2023-05-16,10:00:00,0,0,0,FMN 05 Gerard Le Grellelaan
653,Gerard le Grellelaan 10,2023-05-16,11:00:00,0,0,0,FMN 05 Gerard Le Grellelaan
653,Gerard le Grellelaan 10,2023-05-16,12:00:00,80,58,22,FMN 05 Gerard Le Grellelaan
653,Gerard le Grellelaan 10,2023-05-16,13:00:00,113,88,25,FMN 05 Gerard Le Grellelaan
653,Gerard le Grellelaan 10,2023-05-16,14:00:00,102,86,16,FMN 05 Gerard Le Grellelaan
653,Gerard le Grellelaan 10,2023-05-16,15:00:00,176,137,39,FMN 05 Gerard Le Grellelaan
653,Gerard le Grellelaan 10,2023-05-16,16:00:00,236,183,53,FMN 05 Gerard Le Grellelaan
653,Gerard le Grellelaan 10,2023-05-16,17:00:00,243,190,53,FMN 05 Gerard Le Grellelaan
653,Gerard le Grellelaan 10,2023-05-16,18:00:00,183,140,43,FMN 05 Gerard Le Grellelaan
653,Gerard le Grellelaan 10,2023-05-16,19:00:00,112,89,23,FMN 05 Gerard Le Grellelaan
653,Gerard le Grellelaan 10,2023-05-16,20:00:00,70,55,15,FMN 05 Gerard Le Grellelaan
653,Gerard le Grellelaan 10,2023-05-16,21:00:00,58,48,10,FMN 05 Gerard Le Grellelaan
653,Gerard le Grellelaan 10,2023-05-16,22:00:00,69,60,9,FMN 05 Gerard Le Grellelaan
653,Gerard le Grellelaan 10,2023-05-16,23:00:00,25,21,4,FMN 05 Gerard Le Grellelaan
653,Gerard le Grellelaan 10,2023-05-17,00:00:00,0,0,0,FMN 05 Gerard Le Grellelaan
653,Gerard le Grellelaan 10,2023-05-17,01:00:00,0,0,0,FMN 05 Gerard Le Grellelaan
653,Gerard le Grellelaan 10,2023-05-17,02:00:00,4,4,0,FMN 05 Gerard Le Grellelaan
653,Gerard le Grellelaan 10,2023-05-17,03:00:00,4,2,2,FMN 05 Gerard Le Grellelaan
653,Gerard le Grellelaan 10,2023-05-17,04:00:00,12,5,7,FMN 05 Gerard Le Grellelaan
653,Gerard le Grellelaan 10,2023-05-17,05:00:00,32,8,24,FMN 05 Gerard Le Grellelaan
653,Gerard le Grellelaan 10,2023-05-17,06:00:00,61,28,33,FMN 05 Gerard Le Grellelaan
653,Gerard le Grellelaan 10,2023-05-17,07:00:00,155,110,45,FMN 05 Gerard Le Grellelaan
653,Gerard le Grellelaan 10,2023-05-17,08:00:00,239,202,37,FMN 05 Gerard Le Grellelaan
653,Gerard le Grellelaan 10,2023-05-17,09:00:00,103,89,14,FMN 05 Gerard Le Grellelaan
653,Gerard le Grellelaan 10,2023-05-17,10:00:00,86,73,13,FMN 05 Gerard Le Grellelaan
653,Gerard le Grellelaan 10,2023-05-17,11:00:00,81,63,18,FMN 05 Gerard Le Grellelaan
653,Gerard le Grellelaan 10,2023-05-17,12:00:00,89,64,25,FMN 05 Gerard Le Grellelaan
653,Gerard le Grellelaan 10,2023-05-17,13:00:00,104,80,24,FMN 05 Gerard Le Grellelaan
653,Gerard le Grellelaan 10,2023-05-17,14:00:00,103,77,26,FMN 05 Gerard Le Grellelaan
653,Gerard le Grellelaan 10,2023-05-17,15:00:00,44,35,9,FMN 05 Gerard Le Grellelaan
653,Gerard le Grellelaan 10,2023-05-17,16:00:00,0,0,0,FMN 05 Gerard Le Grellelaan
653,Gerard le Grellelaan 10,2023-05-17,17:00:00,0,0,0,FMN 05 Gerard Le Grellelaan
653,Gerard le Grellelaan 10,2023-05-17,18:00:00,0,0,0,FMN 05 Gerard Le Grellelaan
653,Gerard le Grellelaan 10,2023-05-17,19:00:00,0,0,0,FMN 05 Gerard Le Grellelaan
653,Gerard le Grellelaan 10,2023-05-17,20:00:00,0,0,0,FMN 05 Gerard Le Grellelaan
653,Gerard le Grellelaan 10,2023-05-17,21:00:00,0,0,0,FMN 05 Gerard Le Grellelaan
653,Gerard le Grellelaan 10,2023-05-17,22:00:00,0,0,0,FMN 05 Gerard Le Grellelaan
653,Gerard le Grellelaan 10,2023-05-17,23:00:00,0,0,0,FMN 05 Gerard Le Grellelaan
653,Gerard le Grellelaan 10,2023-05-18,00:00:00,0,0,0,FMN 05 Gerard Le Grellelaan
653,Gerard le Grellelaan 10,2023-05-18,01:00:00,0,0,0,FMN 05 Gerard Le Grellelaan
653,Gerard le Grellelaan 10,2023-05-18,02:00:00,0,0,0,FMN 05 Gerard Le Grellelaan
653,Gerard le Grellelaan 10,2023-05-18,03:00:00,0,0,0,FMN 05 Gerard Le Grellelaan
653,Gerard le Grellelaan 10,2023-05-18,04:00:00,0,0,0,FMN 05 Gerard Le Grellelaan
653,Gerard le Grellelaan 10,2023-05-18,05:00:00,0,0,0,FMN 05 Gerard Le Grellelaan
653,Gerard le Grellelaan 10,2023-05-18,06:00:00,0,0,0,FMN 05 Gerard Le Grellelaan
653,Gerard le Grellelaan 10,2023-05-18,07:00:00,0,0,0,FMN 05 Gerard Le Grellelaan
653,Gerard le Grellelaan 10,2023-05-18,08:00:00,0,0,0,FMN 05 Gerard Le Grellelaan
653,Gerard le Grellelaan 10,2023-05-18,09:00:00,0,0,0,FMN 05 Gerard Le Grellelaan
653,Gerard le Grellelaan 10,2023-05-18,10:00:00,0,0,0,FMN 05 Gerard Le Grellelaan
653,Gerard le Grellelaan 10,2023-05-18,11:00:00,0,0,0,FMN 05 Gerard Le Grellelaan
653,Gerard le Grellelaan 10,2023-05-18,12:00:00,30,24,6,FMN 05 Gerard Le Grellelaan
653,Gerard le Grellelaan 10,2023-05-18,13:00:00,79,71,8,FMN 05 Gerard Le Grellelaan
653,Gerard le Grellelaan 10,2023-05-18,14:00:00,108,94,14,FMN 05 Gerard Le Grellelaan
653,Gerard le Grellelaan 10,2023-05-18,15:00:00,113,97,16,FMN 05 Gerard Le Grellelaan
653,Gerard le Grellelaan 10,2023-05-18,16:00:00,101,81,20,FMN 05 Gerard Le Grellelaan
653,Gerard le Grellelaan 10,2023-05-18,17:00:00,129,106,23,FMN 05 Gerard Le Grellelaan
653,Gerard le Grellelaan 10,2023-05-18,18:00:00,95,81,14,FMN 05 Gerard Le Grellelaan
653,Gerard le Grellelaan 10,2023-05-18,19:00:00,62,54,8,FMN 05 Gerard Le Grellelaan
653,Gerard le Grellelaan 10,2023-05-18,20:00:00,49,42,7,FMN 05 Gerard Le Grellelaan
653,Gerard le Grellelaan 10,2023-05-18,21:00:00,32,26,6,FMN 05 Gerard Le Grellelaan
653,Gerard le Grellelaan 10,2023-05-18,22:00:00,27,24,3,FMN 05 Gerard Le Grellelaan
653,Gerard le Grellelaan 10,2023-05-18,23:00:00,17,10,7,FMN 05 Gerard Le Grellelaan
653,Gerard le Grellelaan 10,2023-05-19,00:00:00,5,3,2,FMN 05 Gerard Le Grellelaan
653,Gerard le Grellelaan 10,2023-05-19,01:00:00,8,6,2,FMN 05 Gerard Le Grellelaan
653,Gerard le Grellelaan 10,2023-05-19,02:00:00,4,3,1,FMN 05 Gerard Le Grellelaan
653,Gerard le Grellelaan 10,2023-05-19,03:00:00,8,7,1,FMN 05 Gerard Le Grellelaan
653,Gerard le Grellelaan 10,2023-05-19,04:00:00,13,5,8,FMN 05 Gerard Le Grellelaan
653,Gerard le Grellelaan 10,2023-05-19,05:00:00,14,4,10,FMN 05 Gerard Le Grellelaan
653,Gerard le Grellelaan 10,2023-05-19,06:00:00,28,10,18,FMN 05 Gerard Le Grellelaan
653,Gerard le Grellelaan 10,2023-05-19,07:00:00,35,27,8,FMN 05 Gerard Le Grellelaan
653,Gerard le Grellelaan 10,2023-05-19,08:00:00,56,46,10,FMN 05 Gerard Le Grellelaan
653,Gerard le Grellelaan 10,2023-05-19,09:00:00,53,45,8,FMN 05 Gerard Le Grellelaan
653,Gerard le Grellelaan 10,2023-05-19,10:00:00,67,46,21,FMN 05 Gerard Le Grellelaan
653,Gerard le Grellelaan 10,2023-05-19,11:00:00,78,67,11,FMN 05 Gerard Le Grellelaan
653,Gerard le Grellelaan 10,2023-05-19,12:00:00,100,85,15,FMN 05 Gerard Le Grellelaan
653,Gerard le Grellelaan 10,2023-05-19,13:00:00,80,66,14,FMN 05 Gerard Le Grellelaan
653,Gerard le Grellelaan 10,2023-05-19,14:00:00,78,59,19,FMN 05 Gerard Le Grellelaan
653,Gerard le Grellelaan 10,2023-05-19,15:00:00,35,29,6,FMN 05 Gerard Le Grellelaan
653,Gerard le Grellelaan 10,2023-05-19,16:00:00,82,73,9,FMN 05 Gerard Le Grellelaan
653,Gerard le Grellelaan 10,2023-05-19,17:00:00,113,91,22,FMN 05 Gerard Le Grellelaan
653,Gerard le Grellelaan 10,2023-05-19,18:00:00,125,91,34,FMN 05 Gerard Le Grellelaan
653,Gerard le Grellelaan 10,2023-05-19,19:00:00,90,74,16,FMN 05 Gerard Le Grellelaan
653,Gerard le Grellelaan 10,2023-05-19,20:00:00,62,54,8,FMN 05 Gerard Le Grellelaan
653,Gerard le Grellelaan 10,2023-05-19,21:00:00,59,56,3,FMN 05 Gerard Le Grellelaan
653,Gerard le Grellelaan 10,2023-05-19,22:00:00,38,31,7,FMN 05 Gerard Le Grellelaan
653,Gerard le Grellelaan 10,2023-05-19,23:00:00,30,23,7,FMN 05 Gerard Le Grellelaan
653,Gerard le Grellelaan 10,2023-05-20,00:00:00,21,16,5,FMN 05 Gerard Le Grellelaan
653,Gerard le Grellelaan 10,2023-05-20,01:00:00,11,8,3,FMN 05 Gerard Le Grellelaan
653,Gerard le Grellelaan 10,2023-05-20,02:00:00,11,6,5,FMN 05 Gerard Le Grellelaan
653,Gerard le Grellelaan 10,2023-05-20,03:00:00,4,1,3,FMN 05 Gerard Le Grellelaan
653,Gerard le Grellelaan 10,2023-05-20,04:00:00,8,2,6,FMN 05 Gerard Le Grellelaan
653,Gerard le Grellelaan 10,2023-05-20,05:00:00,8,4,4,FMN 05 Gerard Le Grellelaan
653,Gerard le Grellelaan 10,2023-05-20,06:00:00,13,5,8,FMN 05 Gerard Le Grellelaan
653,Gerard le Grellelaan 10,2023-05-20,07:00:00,12,10,2,FMN 05 Gerard Le Grellelaan
653,Gerard le Grellelaan 10,2023-05-20,08:00:00,33,22,11,FMN 05 Gerard Le Grellelaan
653,Gerard le Grellelaan 10,2023-05-20,09:00:00,77,74,3,FMN 05 Gerard Le Grellelaan
653,Gerard le Grellelaan 10,2023-05-20,10:00:00,93,74,19,FMN 05 Gerard Le Grellelaan
653,Gerard le Grellelaan 10,2023-05-20,11:00:00,97,80,17,FMN 05 Gerard Le Grellelaan
653,Gerard le Grellelaan 10,2023-05-20,12:00:00,47,31,16,FMN 05 Gerard Le Grellelaan
653,Gerard le Grellelaan 10,2023-05-20,13:00:00,103,75,28,FMN 05 Gerard Le Grellelaan
653,Gerard le Grellelaan 10,2023-05-20,14:00:00,28,22,6,FMN 05 Gerard Le Grellelaan
653,Gerard le Grellelaan 10,2023-05-20,15:00:00,0,0,0,FMN 05 Gerard Le Grellelaan
653,Gerard le Grellelaan 10,2023-05-20,16:00:00,0,0,0,FMN 05 Gerard Le Grellelaan
653,Gerard le Grellelaan 10,2023-05-20,17:00:00,0,0,0,FMN 05 Gerard Le Grellelaan
653,Gerard le Grellelaan 10,2023-05-20,18:00:00,0,0,0,FMN 05 Gerard Le Grellelaan
653,Gerard le Grellelaan 10,2023-05-20,19:00:00,0,0,0,FMN 05 Gerard Le Grellelaan
653,Gerard le Grellelaan 10,2023-05-20,20:00:00,0,0,0,FMN 05 Gerard Le Grellelaan
653,Gerard le Grellelaan 10,2023-05-20,21:00:00,0,0,0,FMN 05 Gerard Le Grellelaan
653,Gerard le Grellelaan 10,2023-05-20,22:00:00,0,0,0,FMN 05 Gerard Le Grellelaan
653,Gerard le Grellelaan 10,2023-05-20,23:00:00,0,0,0,FMN 05 Gerard Le Grellelaan
653,Gerard le Grellelaan 10,2023-05-21,00:00:00,0,0,0,FMN 05 Gerard Le Grellelaan
653,Gerard le Grellelaan 10,2023-05-21,01:00:00,0,0,0,FMN 05 Gerard Le Grellelaan
653,Gerard le Grellelaan 10,2023-05-21,02:00:00,0,0,0,FMN 05 Gerard Le Grellelaan
653,Gerard le Grellelaan 10,2023-05-21,03:00:00,0,0,0,FMN 05 Gerard Le Grellelaan
653,Gerard le Grellelaan 10,2023-05-21,04:00:00,0,0,0,FMN 05 Gerard Le Grellelaan
653,Gerard le Grellelaan 10,2023-05-21,05:00:00,0,0,0,FMN 05 Gerard Le Grellelaan
653,Gerard le Grellelaan 10,2023-05-21,06:00:00,0,0,0,FMN 05 Gerard Le Grellelaan
653,Gerard le Grellelaan 10,2023-05-21,07:00:00,0,0,0,FMN 05 Gerard Le Grellelaan
653,Gerard le Grellelaan 10,2023-05-21,08:00:00,0,0,0,FMN 05 Gerard Le Grellelaan
653,Gerard le Grellelaan 10,2023-05-21,09:00:00,0,0,0,FMN 05 Gerard Le Grellelaan
653,Gerard le Grellelaan 10,2023-05-21,10:00:00,0,0,0,FMN 05 Gerard Le Grellelaan
653,Gerard le Grellelaan 10,2023-05-21,11:00:00,0,0,0,FMN 05 Gerard Le Grellelaan
653,Gerard le Grellelaan 10,2023-05-21,12:00:00,8,5,3,FMN 05 Gerard Le Grellelaan
653,Gerard le Grellelaan 10,2023-05-21,13:00:00,0,0,0,FMN 05 Gerard Le Grellelaan
653,Gerard le Grellelaan 10,2023-05-21,14:00:00,35,27,8,FMN 05 Gerard Le Grellelaan
653,Gerard le Grellelaan 10,2023-05-21,15:00:00,100,84,16,FMN 05 Gerard Le Grellelaan
653,Gerard le Grellelaan 10,2023-05-21,16:00:00,128,109,19,FMN 05 Gerard Le Grellelaan
653,Gerard le Grellelaan 10,2023-05-21,17:00:00,115,95,20,FMN 05 Gerard Le Grellelaan
653,Gerard le Grellelaan 10,2023-05-21,18:00:00,100,83,17,FMN 05 Gerard Le Grellelaan
653,Gerard le Grellelaan 10,2023-05-21,19:00:00,71,56,15,FMN 05 Gerard Le Grellelaan
653,Gerard le Grellelaan 10,2023-05-21,20:00:00,54,49,5,FMN 05 Gerard Le Grellelaan
653,Gerard le Grellelaan 10,2023-05-21,21:00:00,33,23,10,FMN 05 Gerard Le Grellelaan
653,Gerard le Grellelaan 10,2023-05-21,22:00:00,28,23,5,FMN 05 Gerard Le Grellelaan
653,Gerard le Grellelaan 10,2023-05-21,23:00:00,7,6,1,FMN 05 Gerard Le Grellelaan
653,Gerard le Grellelaan 10,2023-05-22,00:00:00,9,7,2,FMN 05 Gerard Le Grellelaan
653,Gerard le Grellelaan 10,2023-05-22,01:00:00,4,4,0,FMN 05 Gerard Le Grellelaan
653,Gerard le Grellelaan 10,2023-05-22,02:00:00,1,1,0,FMN 05 Gerard Le Grellelaan
653,Gerard le Grellelaan 10,2023-05-22,03:00:00,1,1,0,FMN 05 Gerard Le Grellelaan
653,Gerard le Grellelaan 10,2023-05-22,04:00:00,10,2,8,FMN 05 Gerard Le Grellelaan
653,Gerard le Grellelaan 10,2023-05-22,05:00:00,38,15,23,FMN 05 Gerard Le Grellelaan
653,Gerard le Grellelaan 10,2023-05-22,06:00:00,64,37,27,FMN 05 Gerard Le Grellelaan
653,Gerard le Grellelaan 10,2023-05-22,07:00:00,188,140,48,FMN 05 Gerard Le Grellelaan
653,Gerard le Grellelaan 10,2023-05-22,08:00:00,351,292,59,FMN 05 Gerard Le Grellelaan
653,Gerard le Grellelaan 10,2023-05-22,09:00:00,117,102,15,FMN 05 Gerard Le Grellelaan
653,Gerard le Grellelaan 10,2023-05-22,10:00:00,60,51,9,FMN 05 Gerard Le Grellelaan
653,Gerard le Grellelaan 10,2023-05-22,11:00:00,61,51,10,FMN 05 Gerard Le Grellelaan
653,Gerard le Grellelaan 10,2023-05-22,12:00:00,105,84,21,FMN 05 Gerard Le Grellelaan
653,Gerard le Grellelaan 10,2023-05-22,13:00:00,83,63,20,FMN 05 Gerard Le Grellelaan
653,Gerard le Grellelaan 10,2023-05-22,14:00:00,14,8,6,FMN 05 Gerard Le Grellelaan
653,Gerard le Grellelaan 10,2023-05-22,15:00:00,0,0,0,FMN 05 Gerard Le Grellelaan
653,Gerard le Grellelaan 10,2023-05-22,16:00:00,0,0,0,FMN 05 Gerard Le Grellelaan
653,Gerard le Grellelaan 10,2023-05-22,17:00:00,0,0,0,FMN 05 Gerard Le Grellelaan
653,Gerard le Grellelaan 10,2023-05-22,18:00:00,0,0,0,FMN 05 Gerard Le Grellelaan
653,Gerard le Grellelaan 10,2023-05-22,19:00:00,0,0,0,FMN 05 Gerard Le Grellelaan
653,Gerard le Grellelaan 10,2023-05-22,20:00:00,0,0,0,FMN 05 Gerard Le Grellelaan
653,Gerard le Grellelaan 10,2023-05-22,21:00:00,0,0,0,FMN 05 Gerard Le Grellelaan
653,Gerard le Grellelaan 10,2023-05-22,22:00:00,0,0,0,FMN 05 Gerard Le Grellelaan
653,Gerard le Grellelaan 10,2023-05-22,23:00:00,0,0,0,FMN 05 Gerard Le Grellelaan
653,Gerard le Grellelaan 10,2023-05-23,00:00:00,0,0,0,FMN 05 Gerard Le Grellelaan
653,Gerard le Grellelaan 10,2023-05-23,01:00:00,0,0,0,FMN 05 Gerard Le Grellelaan
653,Gerard le Grellelaan 10,2023-05-23,02:00:00,0,0,0,FMN 05 Gerard Le Grellelaan
653,Gerard le Grellelaan 10,2023-05-23,03:00:00,0,0,0,FMN 05 Gerard Le Grellelaan
653,Gerard le Grellelaan 10,2023-05-23,04:00:00,0,0,0,FMN 05 Gerard Le Grellelaan
653,Gerard le Grellelaan 10,2023-05-23,05:00:00,0,0,0,FMN 05 Gerard Le Grellelaan
653,Gerard le Grellelaan 10,2023-05-23,06:00:00,0,0,0,FMN 05 Gerard Le Grellelaan
653,Gerard le Grellelaan 10,2023-05-23,07:00:00,58,44,14,FMN 05 Gerard Le Grellelaan
653,Gerard le Grellelaan 10,2023-05-23,08:00:00,247,200,47,FMN 05 Gerard Le Grellelaan
653,Gerard le Grellelaan 10,2023-05-23,09:00:00,47,42,5,FMN 05 Gerard Le Grellelaan
653,Gerard le Grellelaan 10,2023-05-23,10:00:00,0,0,0,FMN 05 Gerard Le Grellelaan
653,Gerard le Grellelaan 10,2023-05-23,11:00:00,26,21,5,FMN 05 Gerard Le Grellelaan
653,Gerard le Grellelaan 10,2023-05-23,12:00:00,42,33,9,FMN 05 Gerard Le Grellelaan
653,Gerard le Grellelaan 10,2023-05-23,13:00:00,99,72,27,FMN 05 Gerard Le Grellelaan
653,Gerard le Grellelaan 10,2023-05-23,14:00:00,134,113,21,FMN 05 Gerard Le Grellelaan
653,Gerard le Grellelaan 10,2023-05-23,15:00:00,62,54,8,FMN 05 Gerard Le Grellelaan
653,Gerard le Grellelaan 10,2023-05-23,16:00:00,104,81,23,FMN 05 Gerard Le Grellelaan
653,Gerard le Grellelaan 10,2023-05-23,17:00:00,257,203,54,FMN 05 Gerard Le Grellelaan
653,Gerard le Grellelaan 10,2023-05-23,18:00:00,172,146,26,FMN 05 Gerard Le Grellelaan
653,Gerard le Grellelaan 10,2023-05-23,19:00:00,0,0,0,FMN 05 Gerard Le Grellelaan
653,Gerard le Grellelaan 10,2023-05-23,20:00:00,66,55,11,FMN 05 Gerard Le Grellelaan
653,Gerard le Grellelaan 10,2023-05-23,21:00:00,6,6,0,FMN 05 Gerard Le Grellelaan
653,Gerard le Grellelaan 10,2023-05-23,22:00:00,7,5,2,FMN 05 Gerard Le Grellelaan
653,Gerard le Grellelaan 10,2023-05-23,23:00:00,0,0,0,FMN 05 Gerard Le Grellelaan
653,Gerard le Grellelaan 10,2023-05-24,00:00:00,1,1,0,FMN 05 Gerard Le Grellelaan
653,Gerard le Grellelaan 10,2023-05-24,01:00:00,6,2,4,FMN 05 Gerard Le Grellelaan
653,Gerard le Grellelaan 10,2023-05-24,02:00:00,3,2,1,FMN 05 Gerard Le Grellelaan
653,Gerard le Grellelaan 10,2023-05-24,03:00:00,3,3,0,FMN 05 Gerard Le Grellelaan
653,Gerard le Grellelaan 10,2023-05-24,04:00:00,4,1,3,FMN 05 Gerard Le Grellelaan
653,Gerard le Grellelaan 10,2023-05-24,05:00:00,38,17,21,FMN 05 Gerard Le Grellelaan
653,Gerard le Grellelaan 10,2023-05-24,06:00:00,57,20,37,FMN 05 Gerard Le Grellelaan
653,Gerard le Grellelaan 10,2023-05-24,07:00:00,162,115,47,FMN 05 Gerard Le Grellelaan
653,Gerard le Grellelaan 10,2023-05-24,08:00:00,298,234,64,FMN 05 Gerard Le Grellelaan
653,Gerard le Grellelaan 10,2023-05-24,09:00:00,113,101,12,FMN 05 Gerard Le Grellelaan
653,Gerard le Grellelaan 10,2023-05-24,10:00:00,76,69,7,FMN 05 Gerard Le Grellelaan
653,Gerard le Grellelaan 10,2023-05-24,11:00:00,43,34,9,FMN 05 Gerard Le Grellelaan
653,Gerard le Grellelaan 10,2023-05-24,12:00:00,0,0,0,FMN 05 Gerard Le Grellelaan
653,Gerard le Grellelaan 10,2023-05-24,13:00:00,0,0,0,FMN 05 Gerard Le Grellelaan
653,Gerard le Grellelaan 10,2023-05-24,14:00:00,0,0,0,FMN 05 Gerard Le Grellelaan
653,Gerard le Grellelaan 10,2023-05-24,15:00:00,0,0,0,FMN 05 Gerard Le Grellelaan
653,Gerard le Grellelaan 10,2023-05-24,16:00:00,0,0,0,FMN 05 Gerard Le Grellelaan
653,Gerard le Grellelaan 10,2023-05-24,17:00:00,0,0,0,FMN 05 Gerard Le Grellelaan
653,Gerard le Grellelaan 10,2023-05-24,18:00:00,0,0,0,FMN 05 Gerard Le Grellelaan
653,Gerard le Grellelaan 10,2023-05-24,19:00:00,0,0,0,FMN 05 Gerard Le Grellelaan
653,Gerard le Grellelaan 10,2023-05-24,20:00:00,0,0,0,FMN 05 Gerard Le Grellelaan
653,Gerard le Grellelaan 10,2023-05-24,21:00:00,0,0,0,FMN 05 Gerard Le Grellelaan
653,Gerard le Grellelaan 10,2023-05-24,22:00:00,0,0,0,FMN 05 Gerard Le Grellelaan
653,Gerard le Grellelaan 10,2023-05-24,23:00:00,0,0,0,FMN 05 Gerard Le Grellelaan
653,Gerard le Grellelaan 10,2023-05-25,00:00:00,0,0,0,FMN 05 Gerard Le Grellelaan
653,Gerard le Grellelaan 10,2023-05-25,01:00:00,0,0,0,FMN 05 Gerard Le Grellelaan
653,Gerard le Grellelaan 10,2023-05-25,02:00:00,0,0,0,FMN 05 Gerard Le Grellelaan
653,Gerard le Grellelaan 10,2023-05-25,03:00:00,0,0,0,FMN 05 Gerard Le Grellelaan
653,Gerard le Grellelaan 10,2023-05-25,04:00:00,0,0,0,FMN 05 Gerard Le Grellelaan
653,Gerard le Grellelaan 10,2023-05-25,05:00:00,0,0,0,FMN 05 Gerard Le Grellelaan
653,Gerard le Grellelaan 10,2023-05-25,06:00:00,0,0,0,FMN 05 Gerard Le Grellelaan
653,Gerard le Grellelaan 10,2023-05-25,07:00:00,0,0,0,FMN 05 Gerard Le Grellelaan
653,Gerard le Grellelaan 10,2023-05-25,08:00:00,0,0,0,FMN 05 Gerard Le Grellelaan
653,Gerard le Grellelaan 10,2023-05-25,09:00:00,0,0,0,FMN 05 Gerard Le Grellelaan
653,Gerard le Grellelaan 10,2023-05-25,10:00:00,0,0,0,FMN 05 Gerard Le Grellelaan
653,Gerard le Grellelaan 10,2023-05-25,11:00:00,0,0,0,FMN 05 Gerard Le Grellelaan
653,Gerard le Grellelaan 10,2023-05-25,12:00:00,0,0,0,FMN 05 Gerard Le Grellelaan
653,Gerard le Grellelaan 10,2023-05-25,13:00:00,0,0,0,FMN 05 Gerard Le Grellelaan
653,Gerard le Grellelaan 10,2023-05-25,14:00:00,0,0,0,FMN 05 Gerard Le Grellelaan
653,Gerard le Grellelaan 10,2023-05-25,15:00:00,0,0,0,FMN 05 Gerard Le Grellelaan
653,Gerard le Grellelaan 10,2023-05-25,16:00:00,0,0,0,FMN 05 Gerard Le Grellelaan
653,Gerard le Grellelaan 10,2023-05-25,17:00:00,0,0,0,FMN 05 Gerard Le Grellelaan
653,Gerard le Grellelaan 10,2023-05-25,18:00:00,0,0,0,FMN 05 Gerard Le Grellelaan
653,Gerard le Grellelaan 10,2023-05-25,19:00:00,0,0,0,FMN 05 Gerard Le Grellelaan
653,Gerard le Grellelaan 10,2023-05-25,20:00:00,0,0,0,FMN 05 Gerard Le Grellelaan
653,Gerard le Grellelaan 10,2023-05-25,21:00:00,0,0,0,FMN 05 Gerard Le Grellelaan
653,Gerard le Grellelaan 10,2023-05-25,22:00:00,2,2,0,FMN 05 Gerard Le Grellelaan
653,Gerard le Grellelaan 10,2023-05-25,23:00:00,0,0,0,FMN 05 Gerard Le Grellelaan
653,Gerard le Grellelaan 10,2023-05-26,00:00:00,3,3,0,FMN 05 Gerard Le Grellelaan
653,Gerard le Grellelaan 10,2023-05-26,01:00:00,3,1,2,FMN 05 Gerard Le Grellelaan
653,Gerard le Grellelaan 10,2023-05-26,02:00:00,2,2,0,FMN 05 Gerard Le Grellelaan
653,Gerard le Grellelaan 10,2023-05-26,03:00:00,7,3,4,FMN 05 Gerard Le Grellelaan
653,Gerard le Grellelaan 10,2023-05-26,04:00:00,1,1,0,FMN 05 Gerard Le Grellelaan
653,Gerard le Grellelaan 10,2023-05-26,05:00:00,19,9,10,FMN 05 Gerard Le Grellelaan
653,Gerard le Grellelaan 10,2023-05-26,06:00:00,57,26,31,FMN 05 Gerard Le Grellelaan
653,Gerard le Grellelaan 10,2023-05-26,07:00:00,149,109,40,FMN 05 Gerard Le Grellelaan
653,Gerard le Grellelaan 10,2023-05-26,08:00:00,210,154,56,FMN 05 Gerard Le Grellelaan
653,Gerard le Grellelaan 10,2023-05-26,09:00:00,0,0,0,FMN 05 Gerard Le Grellelaan
653,Gerard le Grellelaan 10,2023-05-26,10:00:00,0,0,0,FMN 05 Gerard Le Grellelaan
653,Gerard le Grellelaan 10,2023-05-26,11:00:00,0,0,0,FMN 05 Gerard Le Grellelaan
653,Gerard le Grellelaan 10,2023-05-26,12:00:00,0,0,0,FMN 05 Gerard Le Grellelaan
653,Gerard le Grellelaan 10,2023-05-26,13:00:00,0,0,0,FMN 05 Gerard Le Grellelaan
653,Gerard le Grellelaan 10,2023-05-26,14:00:00,0,0,0,FMN 05 Gerard Le Grellelaan
653,Gerard le Grellelaan 10,2023-05-26,15:00:00,0,0,0,FMN 05 Gerard Le Grellelaan
653,Gerard le Grellelaan 10,2023-05-26,16:00:00,0,0,0,FMN 05 Gerard Le Grellelaan
653,Gerard le Grellelaan 10,2023-05-26,17:00:00,0,0,0,FMN 05 Gerard Le Grellelaan
653,Gerard le Grellelaan 10,2023-05-26,18:00:00,0,0,0,FMN 05 Gerard Le Grellelaan
653,Gerard le Grellelaan 10,2023-05-26,19:00:00,0,0,0,FMN 05 Gerard Le Grellelaan
653,Gerard le Grellelaan 10,2023-05-26,20:00:00,0,0,0,FMN 05 Gerard Le Grellelaan
653,Gerard le Grellelaan 10,2023-05-26,21:00:00,0,0,0,FMN 05 Gerard Le Grellelaan
653,Gerard le Grellelaan 10,2023-05-26,22:00:00,0,0,0,FMN 05 Gerard Le Grellelaan
653,Gerard le Grellelaan 10,2023-05-26,23:00:00,0,0,0,FMN 05 Gerard Le Grellelaan
653,Gerard le Grellelaan 10,2023-05-27,00:00:00,1,1,0,FMN 05 Gerard Le Grellelaan
653,Gerard le Grellelaan 10,2023-05-27,01:00:00,5,3,2,FMN 05 Gerard Le Grellelaan
653,Gerard le Grellelaan 10,2023-05-27,02:00:00,6,5,1,FMN 05 Gerard Le Grellelaan
653,Gerard le Grellelaan 10,2023-05-27,03:00:00,5,3,2,FMN 05 Gerard Le Grellelaan
653,Gerard le Grellelaan 10,2023-05-27,04:00:00,3,2,1,FMN 05 Gerard Le Grellelaan
653,Gerard le Grellelaan 10,2023-05-27,05:00:00,12,8,4,FMN 05 Gerard Le Grellelaan
653,Gerard le Grellelaan 10,2023-05-27,06:00:00,13,7,6,FMN 05 Gerard Le Grellelaan
653,Gerard le Grellelaan 10,2023-05-27,07:00:00,20,15,5,FMN 05 Gerard Le Grellelaan
653,Gerard le Grellelaan 10,2023-05-27,08:00:00,38,27,11,FMN 05 Gerard Le Grellelaan
653,Gerard le Grellelaan 10,2023-05-27,09:00:00,68,56,12,FMN 05 Gerard Le Grellelaan
653,Gerard le Grellelaan 10,2023-05-27,10:00:00,79,64,15,FMN 05 Gerard Le Grellelaan
653,Gerard le Grellelaan 10,2023-05-27,11:00:00,112,91,21,FMN 05 Gerard Le Grellelaan
653,Gerard le Grellelaan 10,2023-05-27,12:00:00,84,76,8,FMN 05 Gerard Le Grellelaan
653,Gerard le Grellelaan 10,2023-05-27,13:00:00,102,83,19,FMN 05 Gerard Le Grellelaan
653,Gerard le Grellelaan 10,2023-05-27,14:00:00,111,83,28,FMN 05 Gerard Le Grellelaan
653,Gerard le Grellelaan 10,2023-05-27,15:00:00,111,90,21,FMN 05 Gerard Le Grellelaan
653,Gerard le Grellelaan 10,2023-05-27,16:00:00,139,88,51,FMN 05 Gerard Le Grellelaan
653,Gerard le Grellelaan 10,2023-05-27,17:00:00,126,91,35,FMN 05 Gerard Le Grellelaan
653,Gerard le Grellelaan 10,2023-05-27,18:00:00,118,103,15,FMN 05 Gerard Le Grellelaan
653,Gerard le Grellelaan 10,2023-05-27,19:00:00,83,74,9,FMN 05 Gerard Le Grellelaan
653,Gerard le Grellelaan 10,2023-05-27,20:00:00,81,56,25,FMN 05 Gerard Le Grellelaan
653,Gerard le Grellelaan 10,2023-05-27,21:00:00,53,43,10,FMN 05 Gerard Le Grellelaan
653,Gerard le Grellelaan 10,2023-05-27,22:00:00,79,61,18,FMN 05 Gerard Le Grellelaan
653,Gerard le Grellelaan 10,2023-05-27,23:00:00,94,82,12,FMN 05 Gerard Le Grellelaan
653,Gerard le Grellelaan 10,2023-05-28,00:00:00,148,139,9,FMN 05 Gerard Le Grellelaan
653,Gerard le Grellelaan 10,2023-05-28,01:00:00,32,28,4,FMN 05 Gerard Le Grellelaan
653,Gerard le Grellelaan 10,2023-05-28,02:00:00,19,12,7,FMN 05 Gerard Le Grellelaan
653,Gerard le Grellelaan 10,2023-05-28,03:00:00,9,4,5,FMN 05 Gerard Le Grellelaan
653,Gerard le Grellelaan 10,2023-05-28,04:00:00,3,1,2,FMN 05 Gerard Le Grellelaan
653,Gerard le Grellelaan 10,2023-05-28,05:00:00,6,4,2,FMN 05 Gerard Le Grellelaan
653,Gerard le Grellelaan 10,2023-05-28,06:00:00,9,5,4,FMN 05 Gerard Le Grellelaan
653,Gerard le Grellelaan 10,2023-05-28,07:00:00,15,15,0,FMN 05 Gerard Le Grellelaan
653,Gerard le Grellelaan 10,2023-05-28,08:00:00,22,16,6,FMN 05 Gerard Le Grellelaan
653,Gerard le Grellelaan 10,2023-05-28,09:00:00,46,40,6,FMN 05 Gerard Le Grellelaan
653,Gerard le Grellelaan 10,2023-05-28,10:00:00,89,71,18,FMN 05 Gerard Le Grellelaan
653,Gerard le Grellelaan 10,2023-05-28,11:00:00,102,85,17,FMN 05 Gerard Le Grellelaan
653,Gerard le Grellelaan 10,2023-05-28,12:00:00,80,67,13,FMN 05 Gerard Le Grellelaan
653,Gerard le Grellelaan 10,2023-05-28,13:00:00,54,43,11,FMN 05 Gerard Le Grellelaan
653,Gerard le Grellelaan 10,2023-05-28,14:00:00,26,18,8,FMN 05 Gerard Le Grellelaan
653,Gerard le Grellelaan 10,2023-05-28,15:00:00,10,6,4,FMN 05 Gerard Le Grellelaan
653,Gerard le Grellelaan 10,2023-05-28,16:00:00,10,6,4,FMN 05 Gerard Le Grellelaan
653,Gerard le Grellelaan 10,2023-05-28,17:00:00,54,41,13,FMN 05 Gerard Le Grellelaan
653,Gerard le Grellelaan 10,2023-05-28,18:00:00,107,92,15,FMN 05 Gerard Le Grellelaan
653,Gerard le Grellelaan 10,2023-05-28,19:00:00,89,70,19,FMN 05 Gerard Le Grellelaan
653,Gerard le Grellelaan 10,2023-05-28,20:00:00,78,61,17,FMN 05 Gerard Le Grellelaan
653,Gerard le Grellelaan 10,2023-05-28,21:00:00,69,54,15,FMN 05 Gerard Le Grellelaan
653,Gerard le Grellelaan 10,2023-05-28,22:00:00,52,34,18,FMN 05 Gerard Le Grellelaan
653,Gerard le Grellelaan 10,2023-05-28,23:00:00,0,0,0,FMN 05 Gerard Le Grellelaan
653,Gerard le Grellelaan 10,2023-05-29,00:00:00,21,18,3,FMN 05 Gerard Le Grellelaan
653,Gerard le Grellelaan 10,2023-05-29,01:00:00,4,4,0,FMN 05 Gerard Le Grellelaan
653,Gerard le Grellelaan 10,2023-05-29,02:00:00,3,2,1,FMN 05 Gerard Le Grellelaan
653,Gerard le Grellelaan 10,2023-05-29,03:00:00,0,0,0,FMN 05 Gerard Le Grellelaan
653,Gerard le Grellelaan 10,2023-05-29,04:00:00,4,0,4,FMN 05 Gerard Le Grellelaan
653,Gerard le Grellelaan 10,2023-05-29,05:00:00,6,4,2,FMN 05 Gerard Le Grellelaan
653,Gerard le Grellelaan 10,2023-05-29,06:00:00,1,1,0,FMN 05 Gerard Le Grellelaan
653,Gerard le Grellelaan 10,2023-05-29,07:00:00,9,5,4,FMN 05 Gerard Le Grellelaan
653,Gerard le Grellelaan 10,2023-05-29,08:00:00,9,8,1,FMN 05 Gerard Le Grellelaan
653,Gerard le Grellelaan 10,2023-05-29,09:00:00,0,0,0,FMN 05 Gerard Le Grellelaan
653,Gerard le Grellelaan 10,2023-05-29,10:00:00,0,0,0,FMN 05 Gerard Le Grellelaan
653,Gerard le Grellelaan 10,2023-05-29,11:00:00,0,0,0,FMN 05 Gerard Le Grellelaan
653,Gerard le Grellelaan 10,2023-05-29,12:00:00,5,1,4,FMN 05 Gerard Le Grellelaan
653,Gerard le Grellelaan 10,2023-05-29,13:00:00,82,65,17,FMN 05 Gerard Le Grellelaan
653,Gerard le Grellelaan 10,2023-05-29,14:00:00,123,105,18,FMN 05 Gerard Le Grellelaan
653,Gerard le Grellelaan 10,2023-05-29,15:00:00,5,5,0,FMN 05 Gerard Le Grellelaan
653,Gerard le Grellelaan 10,2023-05-29,16:00:00,0,0,0,FMN 05 Gerard Le Grellelaan
653,Gerard le Grellelaan 10,2023-05-29,17:00:00,0,0,0,FMN 05 Gerard Le Grellelaan
653,Gerard le Grellelaan 10,2023-05-29,18:00:00,0,0,0,FMN 05 Gerard Le Grellelaan
653,Gerard le Grellelaan 10,2023-05-29,19:00:00,0,0,0,FMN 05 Gerard Le Grellelaan
653,Gerard le Grellelaan 10,2023-05-29,20:00:00,0,0,0,FMN 05 Gerard Le Grellelaan
653,Gerard le Grellelaan 10,2023-05-29,21:00:00,0,0,0,FMN 05 Gerard Le Grellelaan
653,Gerard le Grellelaan 10,2023-05-29,22:00:00,0,0,0,FMN 05 Gerard Le Grellelaan
653,Gerard le Grellelaan 10,2023-05-29,23:00:00,0,0,0,FMN 05 Gerard Le Grellelaan
653,Gerard le Grellelaan 10,2023-05-30,00:00:00,0,0,0,FMN 05 Gerard Le Grellelaan
653,Gerard le Grellelaan 10,2023-05-30,01:00:00,0,0,0,FMN 05 Gerard Le Grellelaan
653,Gerard le Grellelaan 10,2023-05-30,02:00:00,0,0,0,FMN 05 Gerard Le Grellelaan
653,Gerard le Grellelaan 10,2023-05-30,03:00:00,0,0,0,FMN 05 Gerard Le Grellelaan
653,Gerard le Grellelaan 10,2023-05-30,04:00:00,0,0,0,FMN 05 Gerard Le Grellelaan
653,Gerard le Grellelaan 10,2023-05-30,05:00:00,0,0,0,FMN 05 Gerard Le Grellelaan
653,Gerard le Grellelaan 10,2023-05-30,06:00:00,0,0,0,FMN 05 Gerard Le Grellelaan
653,Gerard le Grellelaan 10,2023-05-30,07:00:00,61,51,10,FMN 05 Gerard Le Grellelaan
653,Gerard le Grellelaan 10,2023-05-30,08:00:00,159,135,24,FMN 05 Gerard Le Grellelaan
653,Gerard le Grellelaan 10,2023-05-30,09:00:00,122,94,28,FMN 05 Gerard Le Grellelaan
653,Gerard le Grellelaan 10,2023-05-30,10:00:00,47,43,4,FMN 05 Gerard Le Grellelaan
653,Gerard le Grellelaan 10,2023-05-30,11:00:00,99,76,23,FMN 05 Gerard Le Grellelaan
653,Gerard le Grellelaan 10,2023-05-30,12:00:00,97,73,24,FMN 05 Gerard Le Grellelaan
653,Gerard le Grellelaan 10,2023-05-30,13:00:00,105,82,23,FMN 05 Gerard Le Grellelaan
653,Gerard le Grellelaan 10,2023-05-30,14:00:00,106,81,25,FMN 05 Gerard Le Grellelaan
653,Gerard le Grellelaan 10,2023-05-30,15:00:00,159,120,39,FMN 05 Gerard Le Grellelaan
653,Gerard le Grellelaan 10,2023-05-30,16:00:00,215,174,41,FMN 05 Gerard Le Grellelaan
653,Gerard le Grellelaan 10,2023-05-30,17:00:00,279,212,67,FMN 05 Gerard Le Grellelaan
653,Gerard le Grellelaan 10,2023-05-30,18:00:00,179,133,46,FMN 05 Gerard Le Grellelaan
653,Gerard le Grellelaan 10,2023-05-30,19:00:00,98,69,29,FMN 05 Gerard Le Grellelaan
653,Gerard le Grellelaan 10,2023-05-30,20:00:00,79,51,28,FMN 05 Gerard Le Grellelaan
653,Gerard le Grellelaan 10,2023-05-30,21:00:00,79,67,12,FMN 05 Gerard Le Grellelaan
653,Gerard le Grellelaan 10,2023-05-30,22:00:00,62,49,13,FMN 05 Gerard Le Grellelaan
653,Gerard le Grellelaan 10,2023-05-30,23:00:00,0,0,0,FMN 05 Gerard Le Grellelaan
653,Gerard le Grellelaan 10,2023-05-31,00:00:00,4,3,1,FMN 05 Gerard Le Grellelaan
653,Gerard le Grellelaan 10,2023-05-31,01:00:00,4,2,2,FMN 05 Gerard Le Grellelaan
653,Gerard le Grellelaan 10,2023-05-31,02:00:00,0,0,0,FMN 05 Gerard Le Grellelaan
653,Gerard le Grellelaan 10,2023-05-31,03:00:00,3,2,1,FMN 05 Gerard Le Grellelaan
653,Gerard le Grellelaan 10,2023-05-31,04:00:00,10,3,7,FMN 05 Gerard Le Grellelaan
653,Gerard le Grellelaan 10,2023-05-31,05:00:00,41,14,27,FMN 05 Gerard Le Grellelaan
653,Gerard le Grellelaan 10,2023-05-31,06:00:00,68,32,36,FMN 05 Gerard Le Grellelaan
653,Gerard le Grellelaan 10,2023-05-31,07:00:00,178,125,53,FMN 05 Gerard Le Grellelaan
653,Gerard le Grellelaan 10,2023-05-31,08:00:00,343,265,78,FMN 05 Gerard Le Grellelaan
653,Gerard le Grellelaan 10,2023-05-31,09:00:00,104,87,17,FMN 05 Gerard Le Grellelaan
653,Gerard le Grellelaan 10,2023-05-31,10:00:00,89,74,15,FMN 05 Gerard Le Grellelaan
653,Gerard le Grellelaan 10,2023-05-31,11:00:00,59,45,14,FMN 05 Gerard Le Grellelaan
653,Gerard le Grellelaan 10,2023-05-31,12:00:00,123,83,40,FMN 05 Gerard Le Grellelaan
653,Gerard le Grellelaan 10,2023-05-31,13:00:00,119,92,27,FMN 05 Gerard Le Grellelaan
653,Gerard le Grellelaan 10,2023-05-31,14:00:00,135,114,21,FMN 05 Gerard Le Grellelaan
653,Gerard le Grellelaan 10,2023-05-31,15:00:00,147,108,39,FMN 05 Gerard Le Grellelaan
653,Gerard le Grellelaan 10,2023-05-31,16:00:00,194,162,32,FMN 05 Gerard Le Grellelaan
653,Gerard le Grellelaan 10,2023-05-31,17:00:00,0,0,0,FMN 05 Gerard Le Grellelaan
653,Gerard le Grellelaan 10,2023-05-31,18:00:00,0,0,0,FMN 05 Gerard Le Grellelaan
653,Gerard le Grellelaan 10,2023-05-31,19:00:00,0,0,0,FMN 05 Gerard Le Grellelaan
653,Gerard le Grellelaan 10,2023-05-31,20:00:00,0,0,0,FMN 05 Gerard Le Grellelaan
653,Gerard le Grellelaan 10,2023-05-31,21:00:00,0,0,0,FMN 05 Gerard Le Grellelaan
653,Gerard le Grellelaan 10,2023-05-31,22:00:00,12,9,3,FMN 05 Gerard Le Grellelaan
653,Gerard le Grellelaan 10,2023-05-31,23:00:00,22,19,3,FMN 05 Gerard Le Grellelaan
653,Gerard le Grellelaan 10,2023-06-01,00:00:00,5,3,2,FMN 05 Gerard Le Grellelaan
653,Gerard le Grellelaan 10,2023-06-01,01:00:00,2,2,0,FMN 05 Gerard Le Grellelaan
653,Gerard le Grellelaan 10,2023-06-01,02:00:00,1,1,0,FMN 05 Gerard Le Grellelaan
653,Gerard le Grellelaan 10,2023-06-01,03:00:00,3,2,1,FMN 05 Gerard Le Grellelaan
653,Gerard le Grellelaan 10,2023-06-01,04:00:00,7,2,5,FMN 05 Gerard Le Grellelaan
653,Gerard le Grellelaan 10,2023-06-01,05:00:00,23,10,13,FMN 05 Gerard Le Grellelaan
653,Gerard le Grellelaan 10,2023-06-01,06:00:00,71,34,37,FMN 05 Gerard Le Grellelaan
653,Gerard le Grellelaan 10,2023-06-01,07:00:00,203,149,54,FMN 05 Gerard Le Grellelaan
653,Gerard le Grellelaan 10,2023-06-01,08:00:00,408,322,86,FMN 05 Gerard Le Grellelaan
653,Gerard le Grellelaan 10,2023-06-01,09:00:00,135,109,26,FMN 05 Gerard Le Grellelaan
653,Gerard le Grellelaan 10,2023-06-01,10:00:00,88,74,14,FMN 05 Gerard Le Grellelaan
653,Gerard le Grellelaan 10,2023-06-01,11:00:00,84,68,16,FMN 05 Gerard Le Grellelaan
653,Gerard le Grellelaan 10,2023-06-01,12:00:00,121,99,22,FMN 05 Gerard Le Grellelaan
653,Gerard le Grellelaan 10,2023-06-01,13:00:00,0,0,0,FMN 05 Gerard Le Grellelaan
653,Gerard le Grellelaan 10,2023-06-01,14:00:00,0,0,0,FMN 05 Gerard Le Grellelaan
653,Gerard le Grellelaan 10,2023-06-01,15:00:00,0,0,0,FMN 05 Gerard Le Grellelaan
653,Gerard le Grellelaan 10,2023-06-01,16:00:00,0,0,0,FMN 05 Gerard Le Grellelaan
653,Gerard le Grellelaan 10,2023-06-01,17:00:00,0,0,0,FMN 05 Gerard Le Grellelaan
653,Gerard le Grellelaan 10,2023-06-01,18:00:00,0,0,0,FMN 05 Gerard Le Grellelaan
653,Gerard le Grellelaan 10,2023-06-01,19:00:00,0,0,0,FMN 05 Gerard Le Grellelaan
653,Gerard le Grellelaan 10,2023-06-01,20:00:00,0,0,0,FMN 05 Gerard Le Grellelaan
653,Gerard le Grellelaan 10,2023-06-01,21:00:00,0,0,0,FMN 05 Gerard Le Grellelaan
653,Gerard le Grellelaan 10,2023-06-01,22:00:00,22,20,2,FMN 05 Gerard Le Grellelaan
653,Gerard le Grellelaan 10,2023-06-01,23:00:00,34,19,15,FMN 05 Gerard Le Grellelaan
653,Gerard le Grellelaan 10,2023-06-02,00:00:00,9,6,3,FMN 05 Gerard Le Grellelaan
653,Gerard le Grellelaan 10,2023-06-02,01:00:00,6,3,3,FMN 05 Gerard Le Grellelaan
653,Gerard le Grellelaan 10,2023-06-02,02:00:00,2,1,1,FMN 05 Gerard Le Grellelaan
653,Gerard le Grellelaan 10,2023-06-02,03:00:00,1,1,0,FMN 05 Gerard Le Grellelaan
653,Gerard le Grellelaan 10,2023-06-02,04:00:00,2,2,0,FMN 05 Gerard Le Grellelaan
653,Gerard le Grellelaan 10,2023-06-02,05:00:00,0,0,0,FMN 05 Gerard Le Grellelaan
653,Gerard le Grellelaan 10,2023-06-02,06:00:00,12,7,5,FMN 05 Gerard Le Grellelaan
653,Gerard le Grellelaan 10,2023-06-02,07:00:00,0,0,0,FMN 05 Gerard Le Grellelaan
653,Gerard le Grellelaan 10,2023-06-02,08:00:00,195,158,37,FMN 05 Gerard Le Grellelaan
653,Gerard le Grellelaan 10,2023-06-02,09:00:00,120,105,15,FMN 05 Gerard Le Grellelaan
653,Gerard le Grellelaan 10,2023-06-02,10:00:00,68,59,9,FMN 05 Gerard Le Grellelaan
653,Gerard le Grellelaan 10,2023-06-02,11:00:00,53,44,9,FMN 05 Gerard Le Grellelaan
653,Gerard le Grellelaan 10,2023-06-02,12:00:00,0,0,0,FMN 05 Gerard Le Grellelaan
653,Gerard le Grellelaan 10,2023-06-02,13:00:00,0,0,0,FMN 05 Gerard Le Grellelaan
653,Gerard le Grellelaan 10,2023-06-02,14:00:00,0,0,0,FMN 05 Gerard Le Grellelaan
653,Gerard le Grellelaan 10,2023-06-02,15:00:00,0,0,0,FMN 05 Gerard Le Grellelaan
653,Gerard le Grellelaan 10,2023-06-02,16:00:00,0,0,0,FMN 05 Gerard Le Grellelaan
653,Gerard le Grellelaan 10,2023-06-02,17:00:00,0,0,0,FMN 05 Gerard Le Grellelaan
653,Gerard le Grellelaan 10,2023-06-02,18:00:00,0,0,0,FMN 05 Gerard Le Grellelaan
653,Gerard le Grellelaan 10,2023-06-02,19:00:00,0,0,0,FMN 05 Gerard Le Grellelaan
653,Gerard le Grellelaan 10,2023-06-02,20:00:00,0,0,0,FMN 05 Gerard Le Grellelaan
653,Gerard le Grellelaan 10,2023-06-02,21:00:00,0,0,0,FMN 05 Gerard Le Grellelaan
653,Gerard le Grellelaan 10,2023-06-02,22:00:00,0,0,0,FMN 05 Gerard Le Grellelaan
653,Gerard le Grellelaan 10,2023-06-02,23:00:00,0,0,0,FMN 05 Gerard Le Grellelaan
653,Gerard le Grellelaan 10,2023-06-03,00:00:00,0,0,0,FMN 05 Gerard Le Grellelaan
653,Gerard le Grellelaan 10,2023-06-03,01:00:00,0,0,0,FMN 05 Gerard Le Grellelaan
653,Gerard le Grellelaan 10,2023-06-03,02:00:00,0,0,0,FMN 05 Gerard Le Grellelaan
653,Gerard le Grellelaan 10,2023-06-03,03:00:00,0,0,0,FMN 05 Gerard Le Grellelaan
653,Gerard le Grellelaan 10,2023-06-03,04:00:00,0,0,0,FMN 05 Gerard Le Grellelaan
653,Gerard le Grellelaan 10,2023-06-03,05:00:00,0,0,0,FMN 05 Gerard Le Grellelaan
653,Gerard le Grellelaan 10,2023-06-03,06:00:00,0,0,0,FMN 05 Gerard Le Grellelaan
653,Gerard le Grellelaan 10,2023-06-03,07:00:00,0,0,0,FMN 05 Gerard Le Grellelaan
653,Gerard le Grellelaan 10,2023-06-03,08:00:00,0,0,0,FMN 05 Gerard Le Grellelaan
653,Gerard le Grellelaan 10,2023-06-03,09:00:00,12,9,3,FMN 05 Gerard Le Grellelaan
653,Gerard le Grellelaan 10,2023-06-03,10:00:00,6,4,2,FMN 05 Gerard Le Grellelaan
653,Gerard le Grellelaan 10,2023-06-03,11:00:00,0,0,0,FMN 05 Gerard Le Grellelaan
653,Gerard le Grellelaan 10,2023-06-03,12:00:00,2,1,1,FMN 05 Gerard Le Grellelaan
653,Gerard le Grellelaan 10,2023-06-03,13:00:00,106,86,20,FMN 05 Gerard Le Grellelaan
653,Gerard le Grellelaan 10,2023-06-03,14:00:00,125,109,16,FMN 05 Gerard Le Grellelaan
653,Gerard le Grellelaan 10,2023-06-03,15:00:00,127,111,16,FMN 05 Gerard Le Grellelaan
653,Gerard le Grellelaan 10,2023-06-03,16:00:00,125,96,29,FMN 05 Gerard Le Grellelaan
653,Gerard le Grellelaan 10,2023-06-03,17:00:00,122,95,27,FMN 05 Gerard Le Grellelaan
653,Gerard le Grellelaan 10,2023-06-03,18:00:00,145,121,24,FMN 05 Gerard Le Grellelaan
653,Gerard le Grellelaan 10,2023-06-03,19:00:00,86,76,10,FMN 05 Gerard Le Grellelaan
653,Gerard le Grellelaan 10,2023-06-03,20:00:00,67,47,20,FMN 05 Gerard Le Grellelaan
653,Gerard le Grellelaan 10,2023-06-03,21:00:00,59,46,13,FMN 05 Gerard Le Grellelaan
653,Gerard le Grellelaan 10,2023-06-03,22:00:00,1,1,0,FMN 05 Gerard Le Grellelaan
653,Gerard le Grellelaan 10,2023-06-03,23:00:00,0,0,0,FMN 05 Gerard Le Grellelaan
653,Gerard le Grellelaan 10,2023-06-04,00:00:00,0,0,0,FMN 05 Gerard Le Grellelaan
653,Gerard le Grellelaan 10,2023-06-04,01:00:00,0,0,0,FMN 05 Gerard Le Grellelaan
653,Gerard le Grellelaan 10,2023-06-04,02:00:00,0,0,0,FMN 05 Gerard Le Grellelaan
653,Gerard le Grellelaan 10,2023-06-04,03:00:00,8,7,1,FMN 05 Gerard Le Grellelaan
653,Gerard le Grellelaan 10,2023-06-04,04:00:00,6,5,1,FMN 05 Gerard Le Grellelaan
653,Gerard le Grellelaan 10,2023-06-04,05:00:00,5,3,2,FMN 05 Gerard Le Grellelaan
653,Gerard le Grellelaan 10,2023-06-04,06:00:00,8,6,2,FMN 05 Gerard Le Grellelaan
653,Gerard le Grellelaan 10,2023-06-04,07:00:00,13,8,5,FMN 05 Gerard Le Grellelaan
653,Gerard le Grellelaan 10,2023-06-04,08:00:00,21,14,7,FMN 05 Gerard Le Grellelaan
653,Gerard le Grellelaan 10,2023-06-04,09:00:00,75,59,16,FMN 05 Gerard Le Grellelaan
653,Gerard le Grellelaan 10,2023-06-04,10:00:00,77,61,16,FMN 05 Gerard Le Grellelaan
653,Gerard le Grellelaan 10,2023-06-04,11:00:00,96,80,16,FMN 05 Gerard Le Grellelaan
653,Gerard le Grellelaan 10,2023-06-04,12:00:00,102,83,19,FMN 05 Gerard Le Grellelaan
653,Gerard le Grellelaan 10,2023-06-04,13:00:00,86,77,9,FMN 05 Gerard Le Grellelaan
653,Gerard le Grellelaan 10,2023-06-04,14:00:00,53,46,7,FMN 05 Gerard Le Grellelaan
653,Gerard le Grellelaan 10,2023-06-04,15:00:00,11,6,5,FMN 05 Gerard Le Grellelaan
653,Gerard le Grellelaan 10,2023-06-04,16:00:00,17,12,5,FMN 05 Gerard Le Grellelaan
653,Gerard le Grellelaan 10,2023-06-04,17:00:00,66,53,13,FMN 05 Gerard Le Grellelaan
653,Gerard le Grellelaan 10,2023-06-04,18:00:00,97,79,18,FMN 05 Gerard Le Grellelaan
653,Gerard le Grellelaan 10,2023-06-04,19:00:00,63,54,9,FMN 05 Gerard Le Grellelaan
653,Gerard le Grellelaan 10,2023-06-04,20:00:00,48,37,11,FMN 05 Gerard Le Grellelaan
653,Gerard le Grellelaan 10,2023-06-04,21:00:00,57,42,15,FMN 05 Gerard Le Grellelaan
653,Gerard le Grellelaan 10,2023-06-04,22:00:00,27,19,8,FMN 05 Gerard Le Grellelaan
653,Gerard le Grellelaan 10,2023-06-04,23:00:00,13,9,4,FMN 05 Gerard Le Grellelaan
653,Gerard le Grellelaan 10,2023-06-05,00:00:00,13,5,8,FMN 05 Gerard Le Grellelaan
653,Gerard le Grellelaan 10,2023-06-05,01:00:00,9,4,5,FMN 05 Gerard Le Grellelaan
653,Gerard le Grellelaan 10,2023-06-05,02:00:00,5,0,5,FMN 05 Gerard Le Grellelaan
653,Gerard le Grellelaan 10,2023-06-05,03:00:00,4,4,0,FMN 05 Gerard Le Grellelaan
653,Gerard le Grellelaan 10,2023-06-05,04:00:00,7,2,5,FMN 05 Gerard Le Grellelaan
653,Gerard le Grellelaan 10,2023-06-05,05:00:00,14,2,12,FMN 05 Gerard Le Grellelaan
653,Gerard le Grellelaan 10,2023-06-05,06:00:00,70,36,34,FMN 05 Gerard Le Grellelaan
653,Gerard le Grellelaan 10,2023-06-05,07:00:00,139,92,47,FMN 05 Gerard Le Grellelaan
653,Gerard le Grellelaan 10,2023-06-05,08:00:00,0,0,0,FMN 05 Gerard Le Grellelaan
653,Gerard le Grellelaan 10,2023-06-05,09:00:00,0,0,0,FMN 05 Gerard Le Grellelaan
653,Gerard le Grellelaan 10,2023-06-05,10:00:00,0,0,0,FMN 05 Gerard Le Grellelaan
653,Gerard le Grellelaan 10,2023-06-05,11:00:00,0,0,0,FMN 05 Gerard Le Grellelaan
653,Gerard le Grellelaan 10,2023-06-05,12:00:00,0,0,0,FMN 05 Gerard Le Grellelaan
653,Gerard le Grellelaan 10,2023-06-05,13:00:00,72,52,20,FMN 05 Gerard Le Grellelaan
653,Gerard le Grellelaan 10,2023-06-05,14:00:00,107,89,18,FMN 05 Gerard Le Grellelaan
653,Gerard le Grellelaan 10,2023-06-05,15:00:00,178,141,37,FMN 05 Gerard Le Grellelaan
653,Gerard le Grellelaan 10,2023-06-05,16:00:00,134,108,26,FMN 05 Gerard Le Grellelaan
653,Gerard le Grellelaan 10,2023-06-05,17:00:00,0,0,0,FMN 05 Gerard Le Grellelaan
653,Gerard le Grellelaan 10,2023-06-05,18:00:00,0,0,0,FMN 05 Gerard Le Grellelaan
653,Gerard le Grellelaan 10,2023-06-05,19:00:00,0,0,0,FMN 05 Gerard Le Grellelaan
653,Gerard le Grellelaan 10,2023-06-05,20:00:00,0,0,0,FMN 05 Gerard Le Grellelaan
653,Gerard le Grellelaan 10,2023-06-05,21:00:00,0,0,0,FMN 05 Gerard Le Grellelaan
653,Gerard le Grellelaan 10,2023-06-05,22:00:00,39,35,4,FMN 05 Gerard Le Grellelaan
653,Gerard le Grellelaan 10,2023-06-05,23:00:00,10,8,2,FMN 05 Gerard Le Grellelaan
653,Gerard le Grellelaan 10,2023-06-06,00:00:00,4,3,1,FMN 05 Gerard Le Grellelaan
653,Gerard le Grellelaan 10,2023-06-06,01:00:00,2,1,1,FMN 05 Gerard Le Grellelaan
653,Gerard le Grellelaan 10,2023-06-06,02:00:00,1,1,0,FMN 05 Gerard Le Grellelaan
653,Gerard le Grellelaan 10,2023-06-06,03:00:00,1,1,0,FMN 05 Gerard Le Grellelaan
653,Gerard le Grellelaan 10,2023-06-06,04:00:00,8,4,4,FMN 05 Gerard Le Grellelaan
653,Gerard le Grellelaan 10,2023-06-06,05:00:00,25,8,17,FMN 05 Gerard Le Grellelaan
653,Gerard le Grellelaan 10,2023-06-06,06:00:00,71,32,39,FMN 05 Gerard Le Grellelaan
653,Gerard le Grellelaan 10,2023-06-06,07:00:00,207,154,53,FMN 05 Gerard Le Grellelaan
653,Gerard le Grellelaan 10,2023-06-06,08:00:00,93,81,12,FMN 05 Gerard Le Grellelaan
653,Gerard le Grellelaan 10,2023-06-06,09:00:00,66,57,9,FMN 05 Gerard Le Grellelaan
653,Gerard le Grellelaan 10,2023-06-06,10:00:00,105,89,16,FMN 05 Gerard Le Grellelaan
653,Gerard le Grellelaan 10,2023-06-06,11:00:00,88,69,19,FMN 05 Gerard Le Grellelaan
653,Gerard le Grellelaan 10,2023-06-06,12:00:00,130,97,33,FMN 05 Gerard Le Grellelaan
653,Gerard le Grellelaan 10,2023-06-06,13:00:00,100,80,20,FMN 05 Gerard Le Grellelaan
653,Gerard le Grellelaan 10,2023-06-06,14:00:00,27,22,5,FMN 05 Gerard Le Grellelaan
653,Gerard le Grellelaan 10,2023-06-06,15:00:00,5,4,1,FMN 05 Gerard Le Grellelaan
653,Gerard le Grellelaan 10,2023-06-06,16:00:00,189,147,42,FMN 05 Gerard Le Grellelaan
653,Gerard le Grellelaan 10,2023-06-06,17:00:00,257,193,64,FMN 05 Gerard Le Grellelaan
653,Gerard le Grellelaan 10,2023-06-06,18:00:00,172,141,31,FMN 05 Gerard Le Grellelaan
653,Gerard le Grellelaan 10,2023-06-06,19:00:00,105,82,23,FMN 05 Gerard Le Grellelaan
653,Gerard le Grellelaan 10,2023-06-06,20:00:00,88,65,23,FMN 05 Gerard Le Grellelaan
653,Gerard le Grellelaan 10,2023-06-06,21:00:00,65,48,17,FMN 05 Gerard Le Grellelaan
653,Gerard le Grellelaan 10,2023-06-06,22:00:00,69,63,6,FMN 05 Gerard Le Grellelaan
653,Gerard le Grellelaan 10,2023-06-06,23:00:00,0,0,0,FMN 05 Gerard Le Grellelaan
653,Gerard le Grellelaan 10,2023-06-07,00:00:00,0,0,0,FMN 05 Gerard Le Grellelaan
653,Gerard le Grellelaan 10,2023-06-07,01:00:00,0,0,0,FMN 05 Gerard Le Grellelaan
653,Gerard le Grellelaan 10,2023-06-07,02:00:00,0,0,0,FMN 05 Gerard Le Grellelaan
653,Gerard le Grellelaan 10,2023-06-07,03:00:00,0,0,0,FMN 05 Gerard Le Grellelaan
653,Gerard le Grellelaan 10,2023-06-07,04:00:00,0,0,0,FMN 05 Gerard Le Grellelaan
653,Gerard le Grellelaan 10,2023-06-07,05:00:00,0,0,0,FMN 05 Gerard Le Grellelaan
653,Gerard le Grellelaan 10,2023-06-07,06:00:00,0,0,0,FMN 05 Gerard Le Grellelaan
653,Gerard le Grellelaan 10,2023-06-07,07:00:00,0,0,0,FMN 05 Gerard Le Grellelaan
653,Gerard le Grellelaan 10,2023-06-07,08:00:00,0,0,0,FMN 05 Gerard Le Grellelaan
653,Gerard le Grellelaan 10,2023-06-07,09:00:00,0,0,0,FMN 05 Gerard Le Grellelaan
653,Gerard le Grellelaan 10,2023-06-07,10:00:00,0,0,0,FMN 05 Gerard Le Grellelaan
653,Gerard le Grellelaan 10,2023-06-07,11:00:00,0,0,0,FMN 05 Gerard Le Grellelaan
653,Gerard le Grellelaan 10,2023-06-07,12:00:00,66,47,19,FMN 05 Gerard Le Grellelaan
653,Gerard le Grellelaan 10,2023-06-07,13:00:00,127,102,25,FMN 05 Gerard Le Grellelaan
653,Gerard le Grellelaan 10,2023-06-07,14:00:00,125,96,29,FMN 05 Gerard Le Grellelaan
653,Gerard le Grellelaan 10,2023-06-07,15:00:00,166,141,25,FMN 05 Gerard Le Grellelaan
653,Gerard le Grellelaan 10,2023-06-07,16:00:00,209,179,30,FMN 05 Gerard Le Grellelaan
653,Gerard le Grellelaan 10,2023-06-07,17:00:00,239,199,40,FMN 05 Gerard Le Grellelaan
653,Gerard le Grellelaan 10,2023-06-07,18:00:00,169,148,21,FMN 05 Gerard Le Grellelaan
653,Gerard le Grellelaan 10,2023-06-07,19:00:00,88,74,14,FMN 05 Gerard Le Grellelaan
653,Gerard le Grellelaan 10,2023-06-07,20:00:00,0,0,0,FMN 05 Gerard Le Grellelaan
653,Gerard le Grellelaan 10,2023-06-07,21:00:00,0,0,0,FMN 05 Gerard Le Grellelaan
653,Gerard le Grellelaan 10,2023-06-07,22:00:00,0,0,0,FMN 05 Gerard Le Grellelaan
653,Gerard le Grellelaan 10,2023-06-07,23:00:00,0,0,0,FMN 05 Gerard Le Grellelaan
653,Gerard le Grellelaan 10,2023-06-08,00:00:00,9,7,2,FMN 05 Gerard Le Grellelaan
653,Gerard le Grellelaan 10,2023-06-08,01:00:00,3,1,2,FMN 05 Gerard Le Grellelaan
653,Gerard le Grellelaan 10,2023-06-08,02:00:00,6,4,2,FMN 05 Gerard Le Grellelaan
653,Gerard le Grellelaan 10,2023-06-08,03:00:00,2,1,1,FMN 05 Gerard Le Grellelaan
653,Gerard le Grellelaan 10,2023-06-08,04:00:00,13,8,5,FMN 05 Gerard Le Grellelaan
653,Gerard le Grellelaan 10,2023-06-08,05:00:00,22,7,15,FMN 05 Gerard Le Grellelaan
653,Gerard le Grellelaan 10,2023-06-08,06:00:00,58,34,24,FMN 05 Gerard Le Grellelaan
653,Gerard le Grellelaan 10,2023-06-08,07:00:00,174,132,42,FMN 05 Gerard Le Grellelaan
653,Gerard le Grellelaan 10,2023-06-08,08:00:00,334,265,69,FMN 05 Gerard Le Grellelaan
653,Gerard le Grellelaan 10,2023-06-08,09:00:00,139,114,25,FMN 05 Gerard Le Grellelaan
653,Gerard le Grellelaan 10,2023-06-08,10:00:00,96,81,15,FMN 05 Gerard Le Grellelaan
653,Gerard le Grellelaan 10,2023-06-08,11:00:00,104,87,17,FMN 05 Gerard Le Grellelaan
653,Gerard le Grellelaan 10,2023-06-08,12:00:00,130,103,27,FMN 05 Gerard Le Grellelaan
653,Gerard le Grellelaan 10,2023-06-08,13:00:00,116,91,25,FMN 05 Gerard Le Grellelaan
653,Gerard le Grellelaan 10,2023-06-08,14:00:00,128,106,22,FMN 05 Gerard Le Grellelaan
653,Gerard le Grellelaan 10,2023-06-08,15:00:00,186,148,38,FMN 05 Gerard Le Grellelaan
653,Gerard le Grellelaan 10,2023-06-08,16:00:00,242,199,43,FMN 05 Gerard Le Grellelaan
653,Gerard le Grellelaan 10,2023-06-08,17:00:00,256,209,47,FMN 05 Gerard Le Grellelaan
653,Gerard le Grellelaan 10,2023-06-08,18:00:00,191,153,38,FMN 05 Gerard Le Grellelaan
653,Gerard le Grellelaan 10,2023-06-08,19:00:00,119,92,27,FMN 05 Gerard Le Grellelaan
653,Gerard le Grellelaan 10,2023-06-08,20:00:00,84,65,19,FMN 05 Gerard Le Grellelaan
653,Gerard le Grellelaan 10,2023-06-08,21:00:00,56,41,15,FMN 05 Gerard Le Grellelaan
653,Gerard le Grellelaan 10,2023-06-08,22:00:00,57,45,12,FMN 05 Gerard Le Grellelaan
653,Gerard le Grellelaan 10,2023-06-08,23:00:00,29,23,6,FMN 05 Gerard Le Grellelaan
653,Gerard le Grellelaan 10,2023-06-09,00:00:00,4,4,0,FMN 05 Gerard Le Grellelaan
653,Gerard le Grellelaan 10,2023-06-09,01:00:00,8,6,2,FMN 05 Gerard Le Grellelaan
653,Gerard le Grellelaan 10,2023-06-09,02:00:00,1,0,1,FMN 05 Gerard Le Grellelaan
653,Gerard le Grellelaan 10,2023-06-09,03:00:00,3,3,0,FMN 05 Gerard Le Grellelaan
653,Gerard le Grellelaan 10,2023-06-09,04:00:00,8,1,7,FMN 05 Gerard Le Grellelaan
653,Gerard le Grellelaan 10,2023-06-09,05:00:00,35,11,24,FMN 05 Gerard Le Grellelaan
653,Gerard le Grellelaan 10,2023-06-09,06:00:00,50,27,23,FMN 05 Gerard Le Grellelaan
653,Gerard le Grellelaan 10,2023-06-09,07:00:00,175,130,45,FMN 05 Gerard Le Grellelaan
653,Gerard le Grellelaan 10,2023-06-09,08:00:00,339,257,82,FMN 05 Gerard Le Grellelaan
653,Gerard le Grellelaan 10,2023-06-09,09:00:00,111,99,12,FMN 05 Gerard Le Grellelaan
653,Gerard le Grellelaan 10,2023-06-09,10:00:00,95,84,11,FMN 05 Gerard Le Grellelaan
653,Gerard le Grellelaan 10,2023-06-09,11:00:00,113,101,12,FMN 05 Gerard Le Grellelaan
653,Gerard le Grellelaan 10,2023-06-09,12:00:00,117,95,22,FMN 05 Gerard Le Grellelaan
653,Gerard le Grellelaan 10,2023-06-09,13:00:00,24,14,10,FMN 05 Gerard Le Grellelaan
653,Gerard le Grellelaan 10,2023-06-09,14:00:00,0,0,0,FMN 05 Gerard Le Grellelaan
653,Gerard le Grellelaan 10,2023-06-09,15:00:00,0,0,0,FMN 05 Gerard Le Grellelaan
653,Gerard le Grellelaan 10,2023-06-09,16:00:00,0,0,0,FMN 05 Gerard Le Grellelaan
653,Gerard le Grellelaan 10,2023-06-09,17:00:00,0,0,0,FMN 05 Gerard Le Grellelaan
653,Gerard le Grellelaan 10,2023-06-09,18:00:00,45,40,5,FMN 05 Gerard Le Grellelaan
653,Gerard le Grellelaan 10,2023-06-09,19:00:00,101,88,13,FMN 05 Gerard Le Grellelaan
653,Gerard le Grellelaan 10,2023-06-09,20:00:00,66,52,14,FMN 05 Gerard Le Grellelaan
653,Gerard le Grellelaan 10,2023-06-09,21:00:00,66,51,15,FMN 05 Gerard Le Grellelaan
653,Gerard le Grellelaan 10,2023-06-09,22:00:00,55,42,13,FMN 05 Gerard Le Grellelaan
653,Gerard le Grellelaan 10,2023-06-09,23:00:00,29,23,6,FMN 05 Gerard Le Grellelaan
653,Gerard le Grellelaan 10,2023-06-10,00:00:00,27,16,11,FMN 05 Gerard Le Grellelaan
653,Gerard le Grellelaan 10,2023-06-10,01:00:00,21,15,6,FMN 05 Gerard Le Grellelaan
653,Gerard le Grellelaan 10,2023-06-10,02:00:00,10,7,3,FMN 05 Gerard Le Grellelaan
653,Gerard le Grellelaan 10,2023-06-10,03:00:00,5,3,2,FMN 05 Gerard Le Grellelaan
653,Gerard le Grellelaan 10,2023-06-10,04:00:00,6,3,3,FMN 05 Gerard Le Grellelaan
653,Gerard le Grellelaan 10,2023-06-10,05:00:00,9,2,7,FMN 05 Gerard Le Grellelaan
653,Gerard le Grellelaan 10,2023-06-10,06:00:00,15,11,4,FMN 05 Gerard Le Grellelaan
653,Gerard le Grellelaan 10,2023-06-10,07:00:00,14,12,2,FMN 05 Gerard Le Grellelaan
653,Gerard le Grellelaan 10,2023-06-10,08:00:00,44,34,10,FMN 05 Gerard Le Grellelaan
653,Gerard le Grellelaan 10,2023-06-10,09:00:00,89,78,11,FMN 05 Gerard Le Grellelaan
653,Gerard le Grellelaan 10,2023-06-10,10:00:00,80,66,14,FMN 05 Gerard Le Grellelaan
653,Gerard le Grellelaan 10,2023-06-10,11:00:00,101,83,18,FMN 05 Gerard Le Grellelaan
653,Gerard le Grellelaan 10,2023-06-10,12:00:00,72,57,15,FMN 05 Gerard Le Grellelaan
653,Gerard le Grellelaan 10,2023-06-10,13:00:00,19,16,3,FMN 05 Gerard Le Grellelaan
653,Gerard le Grellelaan 10,2023-06-10,14:00:00,0,0,0,FMN 05 Gerard Le Grellelaan
653,Gerard le Grellelaan 10,2023-06-10,15:00:00,0,0,0,FMN 05 Gerard Le Grellelaan
653,Gerard le Grellelaan 10,2023-06-10,16:00:00,0,0,0,FMN 05 Gerard Le Grellelaan
653,Gerard le Grellelaan 10,2023-06-10,17:00:00,33,23,10,FMN 05 Gerard Le Grellelaan
653,Gerard le Grellelaan 10,2023-06-10,18:00:00,77,61,16,FMN 05 Gerard Le Grellelaan
653,Gerard le Grellelaan 10,2023-06-10,19:00:00,85,78,7,FMN 05 Gerard Le Grellelaan
653,Gerard le Grellelaan 10,2023-06-10,20:00:00,8,7,1,FMN 05 Gerard Le Grellelaan
653,Gerard le Grellelaan 10,2023-06-10,21:00:00,0,0,0,FMN 05 Gerard Le Grellelaan
653,Gerard le Grellelaan 10,2023-06-10,22:00:00,40,34,6,FMN 05 Gerard Le Grellelaan
653,Gerard le Grellelaan 10,2023-06-10,23:00:00,44,38,6,FMN 05 Gerard Le Grellelaan
653,Gerard le Grellelaan 10,2023-06-11,00:00:00,35,25,10,FMN 05 Gerard Le Grellelaan
653,Gerard le Grellelaan 10,2023-06-11,01:00:00,34,21,13,FMN 05 Gerard Le Grellelaan
653,Gerard le Grellelaan 10,2023-06-11,02:00:00,9,5,4,FMN 05 Gerard Le Grellelaan
653,Gerard le Grellelaan 10,2023-06-11,03:00:00,8,7,1,FMN 05 Gerard Le Grellelaan
653,Gerard le Grellelaan 10,2023-06-11,04:00:00,9,2,7,FMN 05 Gerard Le Grellelaan
653,Gerard le Grellelaan 10,2023-06-11,05:00:00,4,1,3,FMN 05 Gerard Le Grellelaan
653,Gerard le Grellelaan 10,2023-06-11,06:00:00,11,8,3,FMN 05 Gerard Le Grellelaan
653,Gerard le Grellelaan 10,2023-06-11,07:00:00,10,8,2,FMN 05 Gerard Le Grellelaan
653,Gerard le Grellelaan 10,2023-06-11,08:00:00,33,28,5,FMN 05 Gerard Le Grellelaan
653,Gerard le Grellelaan 10,2023-06-11,09:00:00,77,60,17,FMN 05 Gerard Le Grellelaan
653,Gerard le Grellelaan 10,2023-06-11,10:00:00,109,89,20,FMN 05 Gerard Le Grellelaan
653,Gerard le Grellelaan 10,2023-06-11,11:00:00,74,60,14,FMN 05 Gerard Le Grellelaan
653,Gerard le Grellelaan 10,2023-06-11,12:00:00,79,69,10,FMN 05 Gerard Le Grellelaan
653,Gerard le Grellelaan 10,2023-06-11,13:00:00,14,13,1,FMN 05 Gerard Le Grellelaan
653,Gerard le Grellelaan 10,2023-06-11,14:00:00,0,0,0,FMN 05 Gerard Le Grellelaan
653,Gerard le Grellelaan 10,2023-06-11,15:00:00,10,9,1,FMN 05 Gerard Le Grellelaan
653,Gerard le Grellelaan 10,2023-06-11,16:00:00,2,2,0,FMN 05 Gerard Le Grellelaan
653,Gerard le Grellelaan 10,2023-06-11,17:00:00,21,19,2,FMN 05 Gerard Le Grellelaan
653,Gerard le Grellelaan 10,2023-06-11,18:00:00,88,76,12,FMN 05 Gerard Le Grellelaan
653,Gerard le Grellelaan 10,2023-06-11,19:00:00,66,57,9,FMN 05 Gerard Le Grellelaan
653,Gerard le Grellelaan 10,2023-06-11,20:00:00,40,33,7,FMN 05 Gerard Le Grellelaan
653,Gerard le Grellelaan 10,2023-06-11,21:00:00,44,39,5,FMN 05 Gerard Le Grellelaan
653,Gerard le Grellelaan 10,2023-06-11,22:00:00,35,27,8,FMN 05 Gerard Le Grellelaan
653,Gerard le Grellelaan 10,2023-06-11,23:00:00,22,17,5,FMN 05 Gerard Le Grellelaan
653,Gerard le Grellelaan 10,2023-06-12,00:00:00,6,5,1,FMN 05 Gerard Le Grellelaan
653,Gerard le Grellelaan 10,2023-06-12,01:00:00,6,3,3,FMN 05 Gerard Le Grellelaan
653,Gerard le Grellelaan 10,2023-06-12,02:00:00,1,1,0,FMN 05 Gerard Le Grellelaan
653,Gerard le Grellelaan 10,2023-06-12,03:00:00,2,2,0,FMN 05 Gerard Le Grellelaan
653,Gerard le Grellelaan 10,2023-06-12,04:00:00,8,2,6,FMN 05 Gerard Le Grellelaan
653,Gerard le Grellelaan 10,2023-06-12,05:00:00,32,12,20,FMN 05 Gerard Le Grellelaan
653,Gerard le Grellelaan 10,2023-06-12,06:00:00,82,46,36,FMN 05 Gerard Le Grellelaan
653,Gerard le Grellelaan 10,2023-06-12,07:00:00,185,128,57,FMN 05 Gerard Le Grellelaan
653,Gerard le Grellelaan 10,2023-06-12,08:00:00,391,319,72,FMN 05 Gerard Le Grellelaan
653,Gerard le Grellelaan 10,2023-06-12,09:00:00,130,110,20,FMN 05 Gerard Le Grellelaan
653,Gerard le Grellelaan 10,2023-06-12,10:00:00,94,82,12,FMN 05 Gerard Le Grellelaan
653,Gerard le Grellelaan 10,2023-06-12,11:00:00,84,74,10,FMN 05 Gerard Le Grellelaan
653,Gerard le Grellelaan 10,2023-06-12,12:00:00,97,75,22,FMN 05 Gerard Le Grellelaan
653,Gerard le Grellelaan 10,2023-06-12,13:00:00,13,12,1,FMN 05 Gerard Le Grellelaan
653,Gerard le Grellelaan 10,2023-06-12,14:00:00,0,0,0,FMN 05 Gerard Le Grellelaan
653,Gerard le Grellelaan 10,2023-06-12,15:00:00,0,0,0,FMN 05 Gerard Le Grellelaan
653,Gerard le Grellelaan 10,2023-06-12,16:00:00,205,157,48,FMN 05 Gerard Le Grellelaan
653,Gerard le Grellelaan 10,2023-06-12,17:00:00,285,230,55,FMN 05 Gerard Le Grellelaan
653,Gerard le Grellelaan 10,2023-06-12,18:00:00,176,139,37,FMN 05 Gerard Le Grellelaan
653,Gerard le Grellelaan 10,2023-06-12,19:00:00,99,84,15,FMN 05 Gerard Le Grellelaan
653,Gerard le Grellelaan 10,2023-06-12,20:00:00,82,70,12,FMN 05 Gerard Le Grellelaan
653,Gerard le Grellelaan 10,2023-06-12,21:00:00,72,62,10,FMN 05 Gerard Le Grellelaan
653,Gerard le Grellelaan 10,2023-06-12,22:00:00,61,48,13,FMN 05 Gerard Le Grellelaan
653,Gerard le Grellelaan 10,2023-06-12,23:00:00,517,299,218,FMN 05 Gerard Le Grellelaan
653,Gerard le Grellelaan 10,2023-06-13,00:00:00,552,289,263,FMN 05 Gerard Le Grellelaan
653,Gerard le Grellelaan 10,2023-06-13,01:00:00,1,0,1,FMN 05 Gerard Le Grellelaan
653,Gerard le Grellelaan 10,2023-06-13,02:00:00,1,0,1,FMN 05 Gerard Le Grellelaan
653,Gerard le Grellelaan 10,2023-06-13,03:00:00,2,2,0,FMN 05 Gerard Le Grellelaan
653,Gerard le Grellelaan 10,2023-06-13,04:00:00,16,5,11,FMN 05 Gerard Le Grellelaan
653,Gerard le Grellelaan 10,2023-06-13,05:00:00,29,8,21,FMN 05 Gerard Le Grellelaan
653,Gerard le Grellelaan 10,2023-06-13,06:00:00,68,40,28,FMN 05 Gerard Le Grellelaan
653,Gerard le Grellelaan 10,2023-06-13,07:00:00,217,157,60,FMN 05 Gerard Le Grellelaan
653,Gerard le Grellelaan 10,2023-06-13,08:00:00,447,360,87,FMN 05 Gerard Le Grellelaan
653,Gerard le Grellelaan 10,2023-06-13,09:00:00,132,112,20,FMN 05 Gerard Le Grellelaan
653,Gerard le Grellelaan 10,2023-06-13,10:00:00,107,85,22,FMN 05 Gerard Le Grellelaan
653,Gerard le Grellelaan 10,2023-06-13,11:00:00,101,78,23,FMN 05 Gerard Le Grellelaan
653,Gerard le Grellelaan 10,2023-06-13,12:00:00,124,100,24,FMN 05 Gerard Le Grellelaan
653,Gerard le Grellelaan 10,2023-06-13,13:00:00,117,93,24,FMN 05 Gerard Le Grellelaan
653,Gerard le Grellelaan 10,2023-06-13,14:00:00,111,88,23,FMN 05 Gerard Le Grellelaan
653,Gerard le Grellelaan 10,2023-06-13,15:00:00,168,133,35,FMN 05 Gerard Le Grellelaan
653,Gerard le Grellelaan 10,2023-06-13,16:00:00,211,164,47,FMN 05 Gerard Le Grellelaan
653,Gerard le Grellelaan 10,2023-06-13,17:00:00,263,201,62,FMN 05 Gerard Le Grellelaan
653,Gerard le Grellelaan 10,2023-06-13,18:00:00,186,152,34,FMN 05 Gerard Le Grellelaan
653,Gerard le Grellelaan 10,2023-06-13,19:00:00,106,87,19,FMN 05 Gerard Le Grellelaan
653,Gerard le Grellelaan 10,2023-06-13,20:00:00,81,66,15,FMN 05 Gerard Le Grellelaan
653,Gerard le Grellelaan 10,2023-06-13,21:00:00,84,66,18,FMN 05 Gerard Le Grellelaan
653,Gerard le Grellelaan 10,2023-06-13,22:00:00,76,64,12,FMN 05 Gerard Le Grellelaan
653,Gerard le Grellelaan 10,2023-06-13,23:00:00,33,21,12,FMN 05 Gerard Le Grellelaan
653,Gerard le Grellelaan 10,2023-06-14,00:00:00,15,14,1,FMN 05 Gerard Le Grellelaan
653,Gerard le Grellelaan 10,2023-06-14,01:00:00,3,2,1,FMN 05 Gerard Le Grellelaan
653,Gerard le Grellelaan 10,2023-06-14,02:00:00,3,3,0,FMN 05 Gerard Le Grellelaan
653,Gerard le Grellelaan 10,2023-06-14,03:00:00,7,3,4,FMN 05 Gerard Le Grellelaan
653,Gerard le Grellelaan 10,2023-06-14,04:00:00,13,3,10,FMN 05 Gerard Le Grellelaan
653,Gerard le Grellelaan 10,2023-06-14,05:00:00,37,14,23,FMN 05 Gerard Le Grellelaan
653,Gerard le Grellelaan 10,2023-06-14,06:00:00,60,26,34,FMN 05 Gerard Le Grellelaan
653,Gerard le Grellelaan 10,2023-06-14,07:00:00,158,114,44,FMN 05 Gerard Le Grellelaan
653,Gerard le Grellelaan 10,2023-06-14,08:00:00,333,262,71,FMN 05 Gerard Le Grellelaan
653,Gerard le Grellelaan 10,2023-06-14,09:00:00,124,108,16,FMN 05 Gerard Le Grellelaan
653,Gerard le Grellelaan 10,2023-06-14,10:00:00,81,66,15,FMN 05 Gerard Le Grellelaan
653,Gerard le Grellelaan 10,2023-06-14,11:00:00,82,68,14,FMN 05 Gerard Le Grellelaan
653,Gerard le Grellelaan 10,2023-06-14,12:00:00,94,71,23,FMN 05 Gerard Le Grellelaan
653,Gerard le Grellelaan 10,2023-06-14,13:00:00,140,111,29,FMN 05 Gerard Le Grellelaan
653,Gerard le Grellelaan 10,2023-06-14,14:00:00,129,112,17,FMN 05 Gerard Le Grellelaan
653,Gerard le Grellelaan 10,2023-06-14,15:00:00,183,159,24,FMN 05 Gerard Le Grellelaan
653,Gerard le Grellelaan 10,2023-06-14,16:00:00,114,99,15,FMN 05 Gerard Le Grellelaan
653,Gerard le Grellelaan 10,2023-06-14,17:00:00,0,0,0,FMN 05 Gerard Le Grellelaan
653,Gerard le Grellelaan 10,2023-06-14,18:00:00,0,0,0,FMN 05 Gerard Le Grellelaan
653,Gerard le Grellelaan 10,2023-06-14,19:00:00,0,0,0,FMN 05 Gerard Le Grellelaan
653,Gerard le Grellelaan 10,2023-06-14,20:00:00,0,0,0,FMN 05 Gerard Le Grellelaan
653,Gerard le Grellelaan 10,2023-06-14,21:00:00,0,0,0,FMN 05 Gerard Le Grellelaan
653,Gerard le Grellelaan 10,2023-06-14,22:00:00,0,0,0,FMN 05 Gerard Le Grellelaan
653,Gerard le Grellelaan 10,2023-06-14,23:00:00,0,0,0,FMN 05 Gerard Le Grellelaan
653,Gerard le Grellelaan 10,2023-06-15,00:00:00,0,0,0,FMN 05 Gerard Le Grellelaan
653,Gerard le Grellelaan 10,2023-06-15,01:00:00,0,0,0,FMN 05 Gerard Le Grellelaan
653,Gerard le Grellelaan 10,2023-06-15,02:00:00,0,0,0,FMN 05 Gerard Le Grellelaan
653,Gerard le Grellelaan 10,2023-06-15,03:00:00,0,0,0,FMN 05 Gerard Le Grellelaan
653,Gerard le Grellelaan 10,2023-06-15,04:00:00,0,0,0,FMN 05 Gerard Le Grellelaan
653,Gerard le Grellelaan 10,2023-06-15,05:00:00,0,0,0,FMN 05 Gerard Le Grellelaan
653,Gerard le Grellelaan 10,2023-06-15,06:00:00,0,0,0,FMN 05 Gerard Le Grellelaan
653,Gerard le Grellelaan 10,2023-06-15,07:00:00,0,0,0,FMN 05 Gerard Le Grellelaan
653,Gerard le Grellelaan 10,2023-06-15,08:00:00,0,0,0,FMN 05 Gerard Le Grellelaan
653,Gerard le Grellelaan 10,2023-06-15,09:00:00,0,0,0,FMN 05 Gerard Le Grellelaan
653,Gerard le Grellelaan 10,2023-06-15,10:00:00,0,0,0,FMN 05 Gerard Le Grellelaan
653,Gerard le Grellelaan 10,2023-06-15,11:00:00,67,55,12,FMN 05 Gerard Le Grellelaan
653,Gerard le Grellelaan 10,2023-06-15,12:00:00,16,16,0,FMN 05 Gerard Le Grellelaan
653,Gerard le Grellelaan 10,2023-06-15,13:00:00,0,0,0,FMN 05 Gerard Le Grellelaan
653,Gerard le Grellelaan 10,2023-06-15,14:00:00,0,0,0,FMN 05 Gerard Le Grellelaan
653,Gerard le Grellelaan 10,2023-06-15,15:00:00,0,0,0,FMN 05 Gerard Le Grellelaan
653,Gerard le Grellelaan 10,2023-06-15,16:00:00,0,0,0,FMN 05 Gerard Le Grellelaan
653,Gerard le Grellelaan 10,2023-06-15,17:00:00,0,0,0,FMN 05 Gerard Le Grellelaan
653,Gerard le Grellelaan 10,2023-06-15,18:00:00,0,0,0,FMN 05 Gerard Le Grellelaan
653,Gerard le Grellelaan 10,2023-06-15,19:00:00,0,0,0,FMN 05 Gerard Le Grellelaan
653,Gerard le Grellelaan 10,2023-06-15,20:00:00,20,18,2,FMN 05 Gerard Le Grellelaan
653,Gerard le Grellelaan 10,2023-06-15,21:00:00,52,47,5,FMN 05 Gerard Le Grellelaan
653,Gerard le Grellelaan 10,2023-06-15,22:00:00,66,54,12,FMN 05 Gerard Le Grellelaan
653,Gerard le Grellelaan 10,2023-06-15,23:00:00,34,28,6,FMN 05 Gerard Le Grellelaan
653,Gerard le Grellelaan 10,2023-06-16,00:00:00,11,5,6,FMN 05 Gerard Le Grellelaan
653,Gerard le Grellelaan 10,2023-06-16,01:00:00,5,4,1,FMN 05 Gerard Le Grellelaan
653,Gerard le Grellelaan 10,2023-06-16,02:00:00,4,3,1,FMN 05 Gerard Le Grellelaan
653,Gerard le Grellelaan 10,2023-06-16,03:00:00,4,3,1,FMN 05 Gerard Le Grellelaan
653,Gerard le Grellelaan 10,2023-06-16,04:00:00,8,2,6,FMN 05 Gerard Le Grellelaan
653,Gerard le Grellelaan 10,2023-06-16,05:00:00,22,5,17,FMN 05 Gerard Le Grellelaan
653,Gerard le Grellelaan 10,2023-06-16,06:00:00,54,26,28,FMN 05 Gerard Le Grellelaan
653,Gerard le Grellelaan 10,2023-06-16,07:00:00,161,127,34,FMN 05 Gerard Le Grellelaan
653,Gerard le Grellelaan 10,2023-06-16,08:00:00,316,265,51,FMN 05 Gerard Le Grellelaan
653,Gerard le Grellelaan 10,2023-06-16,09:00:00,103,88,15,FMN 05 Gerard Le Grellelaan
653,Gerard le Grellelaan 10,2023-06-16,10:00:00,102,86,16,FMN 05 Gerard Le Grellelaan
653,Gerard le Grellelaan 10,2023-06-16,11:00:00,110,86,24,FMN 05 Gerard Le Grellelaan
653,Gerard le Grellelaan 10,2023-06-16,12:00:00,118,88,30,FMN 05 Gerard Le Grellelaan
653,Gerard le Grellelaan 10,2023-06-16,13:00:00,77,64,13,FMN 05 Gerard Le Grellelaan
653,Gerard le Grellelaan 10,2023-06-16,14:00:00,17,13,4,FMN 05 Gerard Le Grellelaan
653,Gerard le Grellelaan 10,2023-06-16,15:00:00,0,0,0,FMN 05 Gerard Le Grellelaan
653,Gerard le Grellelaan 10,2023-06-16,16:00:00,0,0,0,FMN 05 Gerard Le Grellelaan
653,Gerard le Grellelaan 10,2023-06-16,17:00:00,0,0,0,FMN 05 Gerard Le Grellelaan
653,Gerard le Grellelaan 10,2023-06-16,18:00:00,0,0,0,FMN 05 Gerard Le Grellelaan
653,Gerard le Grellelaan 10,2023-06-16,19:00:00,135,113,22,FMN 05 Gerard Le Grellelaan
653,Gerard le Grellelaan 10,2023-06-16,20:00:00,93,79,14,FMN 05 Gerard Le Grellelaan
653,Gerard le Grellelaan 10,2023-06-16,21:00:00,12,10,2,FMN 05 Gerard Le Grellelaan
653,Gerard le Grellelaan 10,2023-06-16,22:00:00,43,41,2,FMN 05 Gerard Le Grellelaan
653,Gerard le Grellelaan 10,2023-06-16,23:00:00,57,50,7,FMN 05 Gerard Le Grellelaan
653,Gerard le Grellelaan 10,2023-06-17,00:00:00,25,18,7,FMN 05 Gerard Le Grellelaan
653,Gerard le Grellelaan 10,2023-06-17,01:00:00,19,10,9,FMN 05 Gerard Le Grellelaan
653,Gerard le Grellelaan 10,2023-06-17,02:00:00,14,11,3,FMN 05 Gerard Le Grellelaan
653,Gerard le Grellelaan 10,2023-06-17,03:00:00,7,6,1,FMN 05 Gerard Le Grellelaan
653,Gerard le Grellelaan 10,2023-06-17,04:00:00,7,5,2,FMN 05 Gerard Le Grellelaan
653,Gerard le Grellelaan 10,2023-06-17,05:00:00,9,3,6,FMN 05 Gerard Le Grellelaan
653,Gerard le Grellelaan 10,2023-06-17,06:00:00,12,6,6,FMN 05 Gerard Le Grellelaan
653,Gerard le Grellelaan 10,2023-06-17,07:00:00,21,17,4,FMN 05 Gerard Le Grellelaan
653,Gerard le Grellelaan 10,2023-06-17,08:00:00,37,29,8,FMN 05 Gerard Le Grellelaan
653,Gerard le Grellelaan 10,2023-06-17,09:00:00,73,62,11,FMN 05 Gerard Le Grellelaan
653,Gerard le Grellelaan 10,2023-06-17,10:00:00,86,67,19,FMN 05 Gerard Le Grellelaan
653,Gerard le Grellelaan 10,2023-06-17,11:00:00,115,98,17,FMN 05 Gerard Le Grellelaan
653,Gerard le Grellelaan 10,2023-06-17,12:00:00,97,82,15,FMN 05 Gerard Le Grellelaan
653,Gerard le Grellelaan 10,2023-06-17,13:00:00,59,52,7,FMN 05 Gerard Le Grellelaan
653,Gerard le Grellelaan 10,2023-06-17,14:00:00,56,43,13,FMN 05 Gerard Le Grellelaan
653,Gerard le Grellelaan 10,2023-06-17,15:00:00,53,46,7,FMN 05 Gerard Le Grellelaan
653,Gerard le Grellelaan 10,2023-06-17,16:00:00,79,68,11,FMN 05 Gerard Le Grellelaan
653,Gerard le Grellelaan 10,2023-06-17,17:00:00,78,59,19,FMN 05 Gerard Le Grellelaan
653,Gerard le Grellelaan 10,2023-06-17,18:00:00,96,81,15,FMN 05 Gerard Le Grellelaan
653,Gerard le Grellelaan 10,2023-06-17,19:00:00,83,73,10,FMN 05 Gerard Le Grellelaan
653,Gerard le Grellelaan 10,2023-06-17,20:00:00,48,35,13,FMN 05 Gerard Le Grellelaan
653,Gerard le Grellelaan 10,2023-06-17,21:00:00,59,51,8,FMN 05 Gerard Le Grellelaan
653,Gerard le Grellelaan 10,2023-06-17,22:00:00,39,33,6,FMN 05 Gerard Le Grellelaan
653,Gerard le Grellelaan 10,2023-06-17,23:00:00,36,30,6,FMN 05 Gerard Le Grellelaan
653,Gerard le Grellelaan 10,2023-06-18,00:00:00,28,19,9,FMN 05 Gerard Le Grellelaan
653,Gerard le Grellelaan 10,2023-06-18,01:00:00,20,16,4,FMN 05 Gerard Le Grellelaan
653,Gerard le Grellelaan 10,2023-06-18,02:00:00,12,6,6,FMN 05 Gerard Le Grellelaan
653,Gerard le Grellelaan 10,2023-06-18,03:00:00,12,9,3,FMN 05 Gerard Le Grellelaan
653,Gerard le Grellelaan 10,2023-06-18,04:00:00,4,2,2,FMN 05 Gerard Le Grellelaan
653,Gerard le Grellelaan 10,2023-06-18,05:00:00,6,3,3,FMN 05 Gerard Le Grellelaan
653,Gerard le Grellelaan 10,2023-06-18,06:00:00,16,11,5,FMN 05 Gerard Le Grellelaan
653,Gerard le Grellelaan 10,2023-06-18,07:00:00,9,6,3,FMN 05 Gerard Le Grellelaan
653,Gerard le Grellelaan 10,2023-06-18,08:00:00,19,13,6,FMN 05 Gerard Le Grellelaan
653,Gerard le Grellelaan 10,2023-06-18,09:00:00,67,59,8,FMN 05 Gerard Le Grellelaan
653,Gerard le Grellelaan 10,2023-06-18,10:00:00,62,48,14,FMN 05 Gerard Le Grellelaan
653,Gerard le Grellelaan 10,2023-06-18,11:00:00,58,49,9,FMN 05 Gerard Le Grellelaan
653,Gerard le Grellelaan 10,2023-06-18,12:00:00,54,48,6,FMN 05 Gerard Le Grellelaan
653,Gerard le Grellelaan 10,2023-06-18,13:00:00,58,50,8,FMN 05 Gerard Le Grellelaan
653,Gerard le Grellelaan 10,2023-06-18,14:00:00,74,63,11,FMN 05 Gerard Le Grellelaan
653,Gerard le Grellelaan 10,2023-06-18,15:00:00,77,66,11,FMN 05 Gerard Le Grellelaan
653,Gerard le Grellelaan 10,2023-06-18,16:00:00,85,69,16,FMN 05 Gerard Le Grellelaan
653,Gerard le Grellelaan 10,2023-06-18,17:00:00,87,74,13,FMN 05 Gerard Le Grellelaan
653,Gerard le Grellelaan 10,2023-06-18,18:00:00,86,70,16,FMN 05 Gerard Le Grellelaan
653,Gerard le Grellelaan 10,2023-06-18,19:00:00,80,69,11,FMN 05 Gerard Le Grellelaan
653,Gerard le Grellelaan 10,2023-06-18,20:00:00,45,37,8,FMN 05 Gerard Le Grellelaan
653,Gerard le Grellelaan 10,2023-06-18,21:00:00,42,30,12,FMN 05 Gerard Le Grellelaan
653,Gerard le Grellelaan 10,2023-06-18,22:00:00,26,21,5,FMN 05 Gerard Le Grellelaan
653,Gerard le Grellelaan 10,2023-06-18,23:00:00,9,8,1,FMN 05 Gerard Le Grellelaan
653,Gerard le Grellelaan 10,2023-06-19,00:00:00,0,0,0,FMN 05 Gerard Le Grellelaan
653,Gerard le Grellelaan 10,2023-06-19,01:00:00,0,0,0,FMN 05 Gerard Le Grellelaan
653,Gerard le Grellelaan 10,2023-06-19,02:00:00,0,0,0,FMN 05 Gerard Le Grellelaan
653,Gerard le Grellelaan 10,2023-06-19,03:00:00,4,3,1,FMN 05 Gerard Le Grellelaan
653,Gerard le Grellelaan 10,2023-06-19,04:00:00,8,2,6,FMN 05 Gerard Le Grellelaan
653,Gerard le Grellelaan 10,2023-06-19,05:00:00,35,9,26,FMN 05 Gerard Le Grellelaan
653,Gerard le Grellelaan 10,2023-06-19,06:00:00,66,37,29,FMN 05 Gerard Le Grellelaan
653,Gerard le Grellelaan 10,2023-06-19,07:00:00,168,122,46,FMN 05 Gerard Le Grellelaan
653,Gerard le Grellelaan 10,2023-06-19,08:00:00,284,239,45,FMN 05 Gerard Le Grellelaan
653,Gerard le Grellelaan 10,2023-06-19,09:00:00,94,78,16,FMN 05 Gerard Le Grellelaan
653,Gerard le Grellelaan 10,2023-06-19,10:00:00,54,46,8,FMN 05 Gerard Le Grellelaan
653,Gerard le Grellelaan 10,2023-06-19,11:00:00,0,0,0,FMN 05 Gerard Le Grellelaan
653,Gerard le Grellelaan 10,2023-06-19,12:00:00,0,0,0,FMN 05 Gerard Le Grellelaan
653,Gerard le Grellelaan 10,2023-06-19,13:00:00,0,0,0,FMN 05 Gerard Le Grellelaan
653,Gerard le Grellelaan 10,2023-06-19,14:00:00,0,0,0,FMN 05 Gerard Le Grellelaan
653,Gerard le Grellelaan 10,2023-06-19,15:00:00,0,0,0,FMN 05 Gerard Le Grellelaan
653,Gerard le Grellelaan 10,2023-06-19,16:00:00,0,0,0,FMN 05 Gerard Le Grellelaan
653,Gerard le Grellelaan 10,2023-06-19,17:00:00,0,0,0,FMN 05 Gerard Le Grellelaan
653,Gerard le Grellelaan 10,2023-06-19,18:00:00,0,0,0,FMN 05 Gerard Le Grellelaan
653,Gerard le Grellelaan 10,2023-06-19,19:00:00,0,0,0,FMN 05 Gerard Le Grellelaan
653,Gerard le Grellelaan 10,2023-06-19,20:00:00,0,0,0,FMN 05 Gerard Le Grellelaan
653,Gerard le Grellelaan 10,2023-06-19,21:00:00,0,0,0,FMN 05 Gerard Le Grellelaan
653,Gerard le Grellelaan 10,2023-06-19,22:00:00,0,0,0,FMN 05 Gerard Le Grellelaan
653,Gerard le Grellelaan 10,2023-06-19,23:00:00,0,0,0,FMN 05 Gerard Le Grellelaan
653,Gerard le Grellelaan 10,2023-06-20,00:00:00,0,0,0,FMN 05 Gerard Le Grellelaan
653,Gerard le Grellelaan 10,2023-06-20,01:00:00,0,0,0,FMN 05 Gerard Le Grellelaan
653,Gerard le Grellelaan 10,2023-06-20,02:00:00,0,0,0,FMN 05 Gerard Le Grellelaan
653,Gerard le Grellelaan 10,2023-06-20,03:00:00,0,0,0,FMN 05 Gerard Le Grellelaan
653,Gerard le Grellelaan 10,2023-06-20,04:00:00,0,0,0,FMN 05 Gerard Le Grellelaan
653,Gerard le Grellelaan 10,2023-06-20,05:00:00,0,0,0,FMN 05 Gerard Le Grellelaan
653,Gerard le Grellelaan 10,2023-06-20,06:00:00,0,0,0,FMN 05 Gerard Le Grellelaan
653,Gerard le Grellelaan 10,2023-06-20,07:00:00,0,0,0,FMN 05 Gerard Le Grellelaan
653,Gerard le Grellelaan 10,2023-06-20,08:00:00,0,0,0,FMN 05 Gerard Le Grellelaan
653,Gerard le Grellelaan 10,2023-06-20,09:00:00,0,0,0,FMN 05 Gerard Le Grellelaan
653,Gerard le Grellelaan 10,2023-06-20,10:00:00,0,0,0,FMN 05 Gerard Le Grellelaan
653,Gerard le Grellelaan 10,2023-06-20,11:00:00,0,0,0,FMN 05 Gerard Le Grellelaan
653,Gerard le Grellelaan 10,2023-06-20,12:00:00,0,0,0,FMN 05 Gerard Le Grellelaan
653,Gerard le Grellelaan 10,2023-06-20,13:00:00,0,0,0,FMN 05 Gerard Le Grellelaan
653,Gerard le Grellelaan 10,2023-06-20,14:00:00,0,0,0,FMN 05 Gerard Le Grellelaan
653,Gerard le Grellelaan 10,2023-06-20,15:00:00,0,0,0,FMN 05 Gerard Le Grellelaan
653,Gerard le Grellelaan 10,2023-06-20,16:00:00,24,19,5,FMN 05 Gerard Le Grellelaan
653,Gerard le Grellelaan 10,2023-06-20,17:00:00,0,0,0,FMN 05 Gerard Le Grellelaan
653,Gerard le Grellelaan 10,2023-06-20,18:00:00,12,10,2,FMN 05 Gerard Le Grellelaan
653,Gerard le Grellelaan 10,2023-06-20,19:00:00,34,30,4,FMN 05 Gerard Le Grellelaan
653,Gerard le Grellelaan 10,2023-06-20,20:00:00,28,22,6,FMN 05 Gerard Le Grellelaan
653,Gerard le Grellelaan 10,2023-06-20,21:00:00,31,21,10,FMN 05 Gerard Le Grellelaan
653,Gerard le Grellelaan 10,2023-06-20,22:00:00,36,33,3,FMN 05 Gerard Le Grellelaan
653,Gerard le Grellelaan 10,2023-06-20,23:00:00,16,13,3,FMN 05 Gerard Le Grellelaan
653,Gerard le Grellelaan 10,2023-06-21,00:00:00,9,9,0,FMN 05 Gerard Le Grellelaan
653,Gerard le Grellelaan 10,2023-06-21,01:00:00,2,2,0,FMN 05 Gerard Le Grellelaan
653,Gerard le Grellelaan 10,2023-06-21,02:00:00,2,2,0,FMN 05 Gerard Le Grellelaan
653,Gerard le Grellelaan 10,2023-06-21,03:00:00,4,4,0,FMN 05 Gerard Le Grellelaan
653,Gerard le Grellelaan 10,2023-06-21,04:00:00,7,2,5,FMN 05 Gerard Le Grellelaan
653,Gerard le Grellelaan 10,2023-06-21,05:00:00,30,10,20,FMN 05 Gerard Le Grellelaan
653,Gerard le Grellelaan 10,2023-06-21,06:00:00,43,23,20,FMN 05 Gerard Le Grellelaan
653,Gerard le Grellelaan 10,2023-06-21,07:00:00,175,124,51,FMN 05 Gerard Le Grellelaan
653,Gerard le Grellelaan 10,2023-06-21,08:00:00,326,259,67,FMN 05 Gerard Le Grellelaan
653,Gerard le Grellelaan 10,2023-06-21,09:00:00,125,108,17,FMN 05 Gerard Le Grellelaan
653,Gerard le Grellelaan 10,2023-06-21,10:00:00,83,67,16,FMN 05 Gerard Le Grellelaan
653,Gerard le Grellelaan 10,2023-06-21,11:00:00,109,92,17,FMN 05 Gerard Le Grellelaan
653,Gerard le Grellelaan 10,2023-06-21,12:00:00,184,138,46,FMN 05 Gerard Le Grellelaan
653,Gerard le Grellelaan 10,2023-06-21,13:00:00,89,72,17,FMN 05 Gerard Le Grellelaan
653,Gerard le Grellelaan 10,2023-06-21,14:00:00,139,108,31,FMN 05 Gerard Le Grellelaan
653,Gerard le Grellelaan 10,2023-06-21,15:00:00,163,137,26,FMN 05 Gerard Le Grellelaan
653,Gerard le Grellelaan 10,2023-06-21,16:00:00,212,180,32,FMN 05 Gerard Le Grellelaan
653,Gerard le Grellelaan 10,2023-06-21,17:00:00,229,196,33,FMN 05 Gerard Le Grellelaan
653,Gerard le Grellelaan 10,2023-06-21,18:00:00,217,171,46,FMN 05 Gerard Le Grellelaan
653,Gerard le Grellelaan 10,2023-06-21,19:00:00,132,103,29,FMN 05 Gerard Le Grellelaan
653,Gerard le Grellelaan 10,2023-06-21,20:00:00,108,95,13,FMN 05 Gerard Le Grellelaan
653,Gerard le Grellelaan 10,2023-06-21,21:00:00,80,61,19,FMN 05 Gerard Le Grellelaan
653,Gerard le Grellelaan 10,2023-06-21,22:00:00,71,65,6,FMN 05 Gerard Le Grellelaan
653,Gerard le Grellelaan 10,2023-06-21,23:00:00,41,30,11,FMN 05 Gerard Le Grellelaan
653,Gerard le Grellelaan 10,2023-06-22,00:00:00,3,3,0,FMN 05 Gerard Le Grellelaan
653,Gerard le Grellelaan 10,2023-06-22,01:00:00,2,1,1,FMN 05 Gerard Le Grellelaan
653,Gerard le Grellelaan 10,2023-06-22,02:00:00,0,0,0,FMN 05 Gerard Le Grellelaan
653,Gerard le Grellelaan 10,2023-06-22,03:00:00,10,9,1,FMN 05 Gerard Le Grellelaan
653,Gerard le Grellelaan 10,2023-06-22,04:00:00,6,1,5,FMN 05 Gerard Le Grellelaan
653,Gerard le Grellelaan 10,2023-06-22,05:00:00,26,10,16,FMN 05 Gerard Le Grellelaan
653,Gerard le Grellelaan 10,2023-06-22,06:00:00,54,30,24,FMN 05 Gerard Le Grellelaan
653,Gerard le Grellelaan 10,2023-06-22,07:00:00,173,131,42,FMN 05 Gerard Le Grellelaan
653,Gerard le Grellelaan 10,2023-06-22,08:00:00,322,248,74,FMN 05 Gerard Le Grellelaan
653,Gerard le Grellelaan 10,2023-06-22,09:00:00,107,89,18,FMN 05 Gerard Le Grellelaan
653,Gerard le Grellelaan 10,2023-06-22,10:00:00,75,65,10,FMN 05 Gerard Le Grellelaan
653,Gerard le Grellelaan 10,2023-06-22,11:00:00,62,52,10,FMN 05 Gerard Le Grellelaan
653,Gerard le Grellelaan 10,2023-06-22,12:00:00,67,49,18,FMN 05 Gerard Le Grellelaan
653,Gerard le Grellelaan 10,2023-06-22,13:00:00,37,25,12,FMN 05 Gerard Le Grellelaan
653,Gerard le Grellelaan 10,2023-06-22,14:00:00,67,56,11,FMN 05 Gerard Le Grellelaan
653,Gerard le Grellelaan 10,2023-06-22,15:00:00,88,66,22,FMN 05 Gerard Le Grellelaan
653,Gerard le Grellelaan 10,2023-06-22,16:00:00,79,67,12,FMN 05 Gerard Le Grellelaan
653,Gerard le Grellelaan 10,2023-06-22,17:00:00,0,0,0,FMN 05 Gerard Le Grellelaan
653,Gerard le Grellelaan 10,2023-06-22,18:00:00,58,43,15,FMN 05 Gerard Le Grellelaan
653,Gerard le Grellelaan 10,2023-06-22,19:00:00,56,34,22,FMN 05 Gerard Le Grellelaan
653,Gerard le Grellelaan 10,2023-06-22,20:00:00,53,34,19,FMN 05 Gerard Le Grellelaan
653,Gerard le Grellelaan 10,2023-06-22,21:00:00,28,22,6,FMN 05 Gerard Le Grellelaan
653,Gerard le Grellelaan 10,2023-06-22,22:00:00,51,42,9,FMN 05 Gerard Le Grellelaan
653,Gerard le Grellelaan 10,2023-06-22,23:00:00,38,30,8,FMN 05 Gerard Le Grellelaan
653,Gerard le Grellelaan 10,2023-06-23,00:00:00,12,5,7,FMN 05 Gerard Le Grellelaan
653,Gerard le Grellelaan 10,2023-06-23,01:00:00,4,3,1,FMN 05 Gerard Le Grellelaan
653,Gerard le Grellelaan 10,2023-06-23,02:00:00,4,4,0,FMN 05 Gerard Le Grellelaan
653,Gerard le Grellelaan 10,2023-06-23,03:00:00,3,3,0,FMN 05 Gerard Le Grellelaan
653,Gerard le Grellelaan 10,2023-06-23,04:00:00,5,2,3,FMN 05 Gerard Le Grellelaan
653,Gerard le Grellelaan 10,2023-06-23,05:00:00,35,10,25,FMN 05 Gerard Le Grellelaan
653,Gerard le Grellelaan 10,2023-06-23,06:00:00,54,30,24,FMN 05 Gerard Le Grellelaan
653,Gerard le Grellelaan 10,2023-06-23,07:00:00,146,108,38,FMN 05 Gerard Le Grellelaan
653,Gerard le Grellelaan 10,2023-06-23,08:00:00,291,234,57,FMN 05 Gerard Le Grellelaan
653,Gerard le Grellelaan 10,2023-06-23,09:00:00,137,123,14,FMN 05 Gerard Le Grellelaan
653,Gerard le Grellelaan 10,2023-06-23,10:00:00,102,87,15,FMN 05 Gerard Le Grellelaan
653,Gerard le Grellelaan 10,2023-06-23,11:00:00,84,61,23,FMN 05 Gerard Le Grellelaan
653,Gerard le Grellelaan 10,2023-06-23,12:00:00,131,112,19,FMN 05 Gerard Le Grellelaan
653,Gerard le Grellelaan 10,2023-06-23,13:00:00,56,45,11,FMN 05 Gerard Le Grellelaan
653,Gerard le Grellelaan 10,2023-06-23,14:00:00,156,134,22,FMN 05 Gerard Le Grellelaan
653,Gerard le Grellelaan 10,2023-06-23,15:00:00,236,183,53,FMN 05 Gerard Le Grellelaan
653,Gerard le Grellelaan 10,2023-06-23,16:00:00,215,181,34,FMN 05 Gerard Le Grellelaan
653,Gerard le Grellelaan 10,2023-06-23,17:00:00,233,197,36,FMN 05 Gerard Le Grellelaan
653,Gerard le Grellelaan 10,2023-06-23,18:00:00,179,147,32,FMN 05 Gerard Le Grellelaan
653,Gerard le Grellelaan 10,2023-06-23,19:00:00,127,106,21,FMN 05 Gerard Le Grellelaan
653,Gerard le Grellelaan 10,2023-06-23,20:00:00,94,67,27,FMN 05 Gerard Le Grellelaan
653,Gerard le Grellelaan 10,2023-06-23,21:00:00,103,84,19,FMN 05 Gerard Le Grellelaan
653,Gerard le Grellelaan 10,2023-06-23,22:00:00,133,87,46,FMN 05 Gerard Le Grellelaan
653,Gerard le Grellelaan 10,2023-06-23,23:00:00,333,176,157,FMN 05 Gerard Le Grellelaan
653,Gerard le Grellelaan 10,2023-06-24,00:00:00,8,5,3,FMN 05 Gerard Le Grellelaan
653,Gerard le Grellelaan 10,2023-06-24,01:00:00,2,1,1,FMN 05 Gerard Le Grellelaan
653,Gerard le Grellelaan 10,2023-06-24,02:00:00,0,0,0,FMN 05 Gerard Le Grellelaan
653,Gerard le Grellelaan 10,2023-06-24,03:00:00,8,5,3,FMN 05 Gerard Le Grellelaan
653,Gerard le Grellelaan 10,2023-06-24,04:00:00,4,2,2,FMN 05 Gerard Le Grellelaan
653,Gerard le Grellelaan 10,2023-06-24,05:00:00,7,4,3,FMN 05 Gerard Le Grellelaan
653,Gerard le Grellelaan 10,2023-06-24,06:00:00,12,4,8,FMN 05 Gerard Le Grellelaan
653,Gerard le Grellelaan 10,2023-06-24,07:00:00,14,13,1,FMN 05 Gerard Le Grellelaan
653,Gerard le Grellelaan 10,2023-06-24,08:00:00,42,33,9,FMN 05 Gerard Le Grellelaan
653,Gerard le Grellelaan 10,2023-06-24,09:00:00,90,78,12,FMN 05 Gerard Le Grellelaan
653,Gerard le Grellelaan 10,2023-06-24,10:00:00,94,76,18,FMN 05 Gerard Le Grellelaan
653,Gerard le Grellelaan 10,2023-06-24,11:00:00,90,76,14,FMN 05 Gerard Le Grellelaan
653,Gerard le Grellelaan 10,2023-06-24,12:00:00,99,81,18,FMN 05 Gerard Le Grellelaan
653,Gerard le Grellelaan 10,2023-06-24,13:00:00,28,25,3,FMN 05 Gerard Le Grellelaan
653,Gerard le Grellelaan 10,2023-06-24,14:00:00,0,0,0,FMN 05 Gerard Le Grellelaan
653,Gerard le Grellelaan 10,2023-06-24,15:00:00,0,0,0,FMN 05 Gerard Le Grellelaan
653,Gerard le Grellelaan 10,2023-06-24,16:00:00,0,0,0,FMN 05 Gerard Le Grellelaan
653,Gerard le Grellelaan 10,2023-06-24,17:00:00,0,0,0,FMN 05 Gerard Le Grellelaan
653,Gerard le Grellelaan 10,2023-06-24,18:00:00,11,6,5,FMN 05 Gerard Le Grellelaan
653,Gerard le Grellelaan 10,2023-06-24,19:00:00,65,53,12,FMN 05 Gerard Le Grellelaan
653,Gerard le Grellelaan 10,2023-06-24,20:00:00,54,39,15,FMN 05 Gerard Le Grellelaan
653,Gerard le Grellelaan 10,2023-06-24,21:00:00,53,51,2,FMN 05 Gerard Le Grellelaan
653,Gerard le Grellelaan 10,2023-06-24,22:00:00,48,39,9,FMN 05 Gerard Le Grellelaan
653,Gerard le Grellelaan 10,2023-06-24,23:00:00,33,30,3,FMN 05 Gerard Le Grellelaan
653,Gerard le Grellelaan 10,2023-06-25,00:00:00,51,40,11,FMN 05 Gerard Le Grellelaan
653,Gerard le Grellelaan 10,2023-06-25,01:00:00,29,20,9,FMN 05 Gerard Le Grellelaan
653,Gerard le Grellelaan 10,2023-06-25,02:00:00,13,7,6,FMN 05 Gerard Le Grellelaan
653,Gerard le Grellelaan 10,2023-06-25,03:00:00,14,11,3,FMN 05 Gerard Le Grellelaan
653,Gerard le Grellelaan 10,2023-06-25,04:00:00,3,1,2,FMN 05 Gerard Le Grellelaan
653,Gerard le Grellelaan 10,2023-06-25,05:00:00,7,3,4,FMN 05 Gerard Le Grellelaan
653,Gerard le Grellelaan 10,2023-06-25,06:00:00,7,6,1,FMN 05 Gerard Le Grellelaan
653,Gerard le Grellelaan 10,2023-06-25,07:00:00,12,10,2,FMN 05 Gerard Le Grellelaan
653,Gerard le Grellelaan 10,2023-06-25,08:00:00,35,28,7,FMN 05 Gerard Le Grellelaan
653,Gerard le Grellelaan 10,2023-06-25,09:00:00,73,60,13,FMN 05 Gerard Le Grellelaan
653,Gerard le Grellelaan 10,2023-06-25,10:00:00,106,81,25,FMN 05 Gerard Le Grellelaan
653,Gerard le Grellelaan 10,2023-06-25,11:00:00,99,82,17,FMN 05 Gerard Le Grellelaan
653,Gerard le Grellelaan 10,2023-06-25,12:00:00,75,59,16,FMN 05 Gerard Le Grellelaan
653,Gerard le Grellelaan 10,2023-06-25,13:00:00,121,101,20,FMN 05 Gerard Le Grellelaan
653,Gerard le Grellelaan 10,2023-06-25,14:00:00,103,88,15,FMN 05 Gerard Le Grellelaan
653,Gerard le Grellelaan 10,2023-06-25,15:00:00,90,80,10,FMN 05 Gerard Le Grellelaan
653,Gerard le Grellelaan 10,2023-06-25,16:00:00,108,89,19,FMN 05 Gerard Le Grellelaan
653,Gerard le Grellelaan 10,2023-06-25,17:00:00,138,115,23,FMN 05 Gerard Le Grellelaan
653,Gerard le Grellelaan 10,2023-06-25,18:00:00,77,65,12,FMN 05 Gerard Le Grellelaan
653,Gerard le Grellelaan 10,2023-06-25,19:00:00,92,79,13,FMN 05 Gerard Le Grellelaan
653,Gerard le Grellelaan 10,2023-06-25,20:00:00,66,59,7,FMN 05 Gerard Le Grellelaan
653,Gerard le Grellelaan 10,2023-06-25,21:00:00,73,52,21,FMN 05 Gerard Le Grellelaan
653,Gerard le Grellelaan 10,2023-06-25,22:00:00,40,32,8,FMN 05 Gerard Le Grellelaan
653,Gerard le Grellelaan 10,2023-06-25,23:00:00,30,20,10,FMN 05 Gerard Le Grellelaan
653,Gerard le Grellelaan 10,2023-06-26,00:00:00,16,12,4,FMN 05 Gerard Le Grellelaan
653,Gerard le Grellelaan 10,2023-06-26,01:00:00,8,8,0,FMN 05 Gerard Le Grellelaan
653,Gerard le Grellelaan 10,2023-06-26,02:00:00,70,38,32,FMN 05 Gerard Le Grellelaan
653,Gerard le Grellelaan 10,2023-06-26,03:00:00,3,3,0,FMN 05 Gerard Le Grellelaan
653,Gerard le Grellelaan 10,2023-06-26,04:00:00,5,1,4,FMN 05 Gerard Le Grellelaan
653,Gerard le Grellelaan 10,2023-06-26,05:00:00,21,7,14,FMN 05 Gerard Le Grellelaan
653,Gerard le Grellelaan 10,2023-06-26,06:00:00,0,0,0,FMN 05 Gerard Le Grellelaan
653,Gerard le Grellelaan 10,2023-06-26,07:00:00,0,0,0,FMN 05 Gerard Le Grellelaan
653,Gerard le Grellelaan 10,2023-06-26,08:00:00,0,0,0,FMN 05 Gerard Le Grellelaan
653,Gerard le Grellelaan 10,2023-06-26,09:00:00,91,81,10,FMN 05 Gerard Le Grellelaan
653,Gerard le Grellelaan 10,2023-06-26,10:00:00,80,70,10,FMN 05 Gerard Le Grellelaan
653,Gerard le Grellelaan 10,2023-06-26,11:00:00,84,71,13,FMN 05 Gerard Le Grellelaan
653,Gerard le Grellelaan 10,2023-06-26,12:00:00,30,27,3,FMN 05 Gerard Le Grellelaan
653,Gerard le Grellelaan 10,2023-06-26,13:00:00,0,0,0,FMN 05 Gerard Le Grellelaan
653,Gerard le Grellelaan 10,2023-06-26,14:00:00,8,7,1,FMN 05 Gerard Le Grellelaan
653,Gerard le Grellelaan 10,2023-06-26,15:00:00,181,144,37,FMN 05 Gerard Le Grellelaan
653,Gerard le Grellelaan 10,2023-06-26,16:00:00,166,135,31,FMN 05 Gerard Le Grellelaan
653,Gerard le Grellelaan 10,2023-06-26,17:00:00,0,0,0,FMN 05 Gerard Le Grellelaan
653,Gerard le Grellelaan 10,2023-06-26,18:00:00,0,0,0,FMN 05 Gerard Le Grellelaan
653,Gerard le Grellelaan 10,2023-06-26,19:00:00,0,0,0,FMN 05 Gerard Le Grellelaan
653,Gerard le Grellelaan 10,2023-06-26,20:00:00,0,0,0,FMN 05 Gerard Le Grellelaan
653,Gerard le Grellelaan 10,2023-06-26,21:00:00,0,0,0,FMN 05 Gerard Le Grellelaan
653,Gerard le Grellelaan 10,2023-06-26,22:00:00,0,0,0,FMN 05 Gerard Le Grellelaan
653,Gerard le Grellelaan 10,2023-06-26,23:00:00,0,0,0,FMN 05 Gerard Le Grellelaan
653,Gerard le Grellelaan 10,2023-06-27,00:00:00,0,0,0,FMN 05 Gerard Le Grellelaan
653,Gerard le Grellelaan 10,2023-06-27,01:00:00,0,0,0,FMN 05 Gerard Le Grellelaan
653,Gerard le Grellelaan 10,2023-06-27,02:00:00,0,0,0,FMN 05 Gerard Le Grellelaan
653,Gerard le Grellelaan 10,2023-06-27,03:00:00,0,0,0,FMN 05 Gerard Le Grellelaan
653,Gerard le Grellelaan 10,2023-06-27,04:00:00,0,0,0,FMN 05 Gerard Le Grellelaan
653,Gerard le Grellelaan 10,2023-06-27,05:00:00,0,0,0,FMN 05 Gerard Le Grellelaan
653,Gerard le Grellelaan 10,2023-06-27,06:00:00,0,0,0,FMN 05 Gerard Le Grellelaan
653,Gerard le Grellelaan 10,2023-06-27,07:00:00,0,0,0,FMN 05 Gerard Le Grellelaan
653,Gerard le Grellelaan 10,2023-06-27,08:00:00,0,0,0,FMN 05 Gerard Le Grellelaan
653,Gerard le Grellelaan 10,2023-06-27,09:00:00,0,0,0,FMN 05 Gerard Le Grellelaan
653,Gerard le Grellelaan 10,2023-06-27,10:00:00,0,0,0,FMN 05 Gerard Le Grellelaan
653,Gerard le Grellelaan 10,2023-06-27,11:00:00,10,10,0,FMN 05 Gerard Le Grellelaan
653,Gerard le Grellelaan 10,2023-06-27,12:00:00,126,95,31,FMN 05 Gerard Le Grellelaan
653,Gerard le Grellelaan 10,2023-06-27,13:00:00,114,86,28,FMN 05 Gerard Le Grellelaan
653,Gerard le Grellelaan 10,2023-06-27,14:00:00,138,107,31,FMN 05 Gerard Le Grellelaan
653,Gerard le Grellelaan 10,2023-06-27,15:00:00,180,138,42,FMN 05 Gerard Le Grellelaan
653,Gerard le Grellelaan 10,2023-06-27,16:00:00,86,59,27,FMN 05 Gerard Le Grellelaan
653,Gerard le Grellelaan 10,2023-06-27,17:00:00,18,13,5,FMN 05 Gerard Le Grellelaan
653,Gerard le Grellelaan 10,2023-06-27,18:00:00,212,179,33,FMN 05 Gerard Le Grellelaan
653,Gerard le Grellelaan 10,2023-06-27,19:00:00,112,89,23,FMN 05 Gerard Le Grellelaan
653,Gerard le Grellelaan 10,2023-06-27,20:00:00,85,65,20,FMN 05 Gerard Le Grellelaan
653,Gerard le Grellelaan 10,2023-06-27,21:00:00,73,61,12,FMN 05 Gerard Le Grellelaan
653,Gerard le Grellelaan 10,2023-06-27,22:00:00,64,60,4,FMN 05 Gerard Le Grellelaan
653,Gerard le Grellelaan 10,2023-06-27,23:00:00,47,34,13,FMN 05 Gerard Le Grellelaan
653,Gerard le Grellelaan 10,2023-06-28,00:00:00,14,12,2,FMN 05 Gerard Le Grellelaan
653,Gerard le Grellelaan 10,2023-06-28,01:00:00,13,7,6,FMN 05 Gerard Le Grellelaan
653,Gerard le Grellelaan 10,2023-06-28,02:00:00,2,2,0,FMN 05 Gerard Le Grellelaan
653,Gerard le Grellelaan 10,2023-06-28,03:00:00,6,5,1,FMN 05 Gerard Le Grellelaan
653,Gerard le Grellelaan 10,2023-06-28,04:00:00,2,1,1,FMN 05 Gerard Le Grellelaan
653,Gerard le Grellelaan 10,2023-06-28,05:00:00,28,10,18,FMN 05 Gerard Le Grellelaan
653,Gerard le Grellelaan 10,2023-06-28,06:00:00,44,23,21,FMN 05 Gerard Le Grellelaan
653,Gerard le Grellelaan 10,2023-06-28,07:00:00,117,78,39,FMN 05 Gerard Le Grellelaan
653,Gerard le Grellelaan 10,2023-06-28,08:00:00,268,199,69,FMN 05 Gerard Le Grellelaan
653,Gerard le Grellelaan 10,2023-06-28,09:00:00,98,84,14,FMN 05 Gerard Le Grellelaan
653,Gerard le Grellelaan 10,2023-06-28,10:00:00,65,57,8,FMN 05 Gerard Le Grellelaan
653,Gerard le Grellelaan 10,2023-06-28,11:00:00,85,75,10,FMN 05 Gerard Le Grellelaan
653,Gerard le Grellelaan 10,2023-06-28,12:00:00,195,144,51,FMN 05 Gerard Le Grellelaan
653,Gerard le Grellelaan 10,2023-06-28,13:00:00,100,88,12,FMN 05 Gerard Le Grellelaan
653,Gerard le Grellelaan 10,2023-06-28,14:00:00,101,82,19,FMN 05 Gerard Le Grellelaan
653,Gerard le Grellelaan 10,2023-06-28,15:00:00,164,136,28,FMN 05 Gerard Le Grellelaan
653,Gerard le Grellelaan 10,2023-06-28,16:00:00,198,168,30,FMN 05 Gerard Le Grellelaan
653,Gerard le Grellelaan 10,2023-06-28,17:00:00,217,191,26,FMN 05 Gerard Le Grellelaan
653,Gerard le Grellelaan 10,2023-06-28,18:00:00,160,129,31,FMN 05 Gerard Le Grellelaan
653,Gerard le Grellelaan 10,2023-06-28,19:00:00,128,88,40,FMN 05 Gerard Le Grellelaan
653,Gerard le Grellelaan 10,2023-06-28,20:00:00,73,62,11,FMN 05 Gerard Le Grellelaan
653,Gerard le Grellelaan 10,2023-06-28,21:00:00,51,46,5,FMN 05 Gerard Le Grellelaan
653,Gerard le Grellelaan 10,2023-06-28,22:00:00,69,60,9,FMN 05 Gerard Le Grellelaan
653,Gerard le Grellelaan 10,2023-06-28,23:00:00,31,28,3,FMN 05 Gerard Le Grellelaan
653,Gerard le Grellelaan 10,2023-06-29,00:00:00,15,6,9,FMN 05 Gerard Le Grellelaan
653,Gerard le Grellelaan 10,2023-06-29,01:00:00,5,4,1,FMN 05 Gerard Le Grellelaan
653,Gerard le Grellelaan 10,2023-06-29,02:00:00,5,4,1,FMN 05 Gerard Le Grellelaan
653,Gerard le Grellelaan 10,2023-06-29,03:00:00,6,2,4,FMN 05 Gerard Le Grellelaan
653,Gerard le Grellelaan 10,2023-06-29,04:00:00,3,2,1,FMN 05 Gerard Le Grellelaan
653,Gerard le Grellelaan 10,2023-06-29,05:00:00,32,10,22,FMN 05 Gerard Le Grellelaan
653,Gerard le Grellelaan 10,2023-06-29,06:00:00,52,27,25,FMN 05 Gerard Le Grellelaan
653,Gerard le Grellelaan 10,2023-06-29,07:00:00,136,97,39,FMN 05 Gerard Le Grellelaan
653,Gerard le Grellelaan 10,2023-06-29,08:00:00,328,262,66,FMN 05 Gerard Le Grellelaan
653,Gerard le Grellelaan 10,2023-06-29,09:00:00,129,113,16,FMN 05 Gerard Le Grellelaan
653,Gerard le Grellelaan 10,2023-06-29,10:00:00,80,60,20,FMN 05 Gerard Le Grellelaan
653,Gerard le Grellelaan 10,2023-06-29,11:00:00,75,66,9,FMN 05 Gerard Le Grellelaan
653,Gerard le Grellelaan 10,2023-06-29,12:00:00,121,89,32,FMN 05 Gerard Le Grellelaan
653,Gerard le Grellelaan 10,2023-06-29,13:00:00,103,85,18,FMN 05 Gerard Le Grellelaan
653,Gerard le Grellelaan 10,2023-06-29,14:00:00,144,130,14,FMN 05 Gerard Le Grellelaan
653,Gerard le Grellelaan 10,2023-06-29,15:00:00,39,35,4,FMN 05 Gerard Le Grellelaan
653,Gerard le Grellelaan 10,2023-06-29,16:00:00,0,0,0,FMN 05 Gerard Le Grellelaan
653,Gerard le Grellelaan 10,2023-06-29,17:00:00,0,0,0,FMN 05 Gerard Le Grellelaan
653,Gerard le Grellelaan 10,2023-06-29,18:00:00,57,41,16,FMN 05 Gerard Le Grellelaan
653,Gerard le Grellelaan 10,2023-06-29,19:00:00,96,71,25,FMN 05 Gerard Le Grellelaan
653,Gerard le Grellelaan 10,2023-06-29,20:00:00,10,8,2,FMN 05 Gerard Le Grellelaan
653,Gerard le Grellelaan 10,2023-06-29,21:00:00,0,0,0,FMN 05 Gerard Le Grellelaan
653,Gerard le Grellelaan 10,2023-06-29,22:00:00,52,40,12,FMN 05 Gerard Le Grellelaan
653,Gerard le Grellelaan 10,2023-06-29,23:00:00,28,24,4,FMN 05 Gerard Le Grellelaan
653,Gerard le Grellelaan 10,2023-06-30,00:00:00,21,14,7,FMN 05 Gerard Le Grellelaan
653,Gerard le Grellelaan 10,2023-06-30,01:00:00,14,9,5,FMN 05 Gerard Le Grellelaan
653,Gerard le Grellelaan 10,2023-06-30,02:00:00,5,4,1,FMN 05 Gerard Le Grellelaan
653,Gerard le Grellelaan 10,2023-06-30,03:00:00,8,5,3,FMN 05 Gerard Le Grellelaan
653,Gerard le Grellelaan 10,2023-06-30,04:00:00,4,3,1,FMN 05 Gerard Le Grellelaan
653,Gerard le Grellelaan 10,2023-06-30,05:00:00,24,6,18,FMN 05 Gerard Le Grellelaan
653,Gerard le Grellelaan 10,2023-06-30,06:00:00,51,28,23,FMN 05 Gerard Le Grellelaan
653,Gerard le Grellelaan 10,2023-06-30,07:00:00,100,69,31,FMN 05 Gerard Le Grellelaan
653,Gerard le Grellelaan 10,2023-06-30,08:00:00,223,175,48,FMN 05 Gerard Le Grellelaan
653,Gerard le Grellelaan 10,2023-06-30,09:00:00,130,118,12,FMN 05 Gerard Le Grellelaan
653,Gerard le Grellelaan 10,2023-06-30,10:00:00,92,75,17,FMN 05 Gerard Le Grellelaan
653,Gerard le Grellelaan 10,2023-06-30,11:00:00,101,82,19,FMN 05 Gerard Le Grellelaan
653,Gerard le Grellelaan 10,2023-06-30,12:00:00,178,116,62,FMN 05 Gerard Le Grellelaan
653,Gerard le Grellelaan 10,2023-06-30,13:00:00,71,56,15,FMN 05 Gerard Le Grellelaan
653,Gerard le Grellelaan 10,2023-06-30,14:00:00,0,0,0,FMN 05 Gerard Le Grellelaan
653,Gerard le Grellelaan 10,2023-06-30,15:00:00,43,37,6,FMN 05 Gerard Le Grellelaan
653,Gerard le Grellelaan 10,2023-06-30,16:00:00,182,150,32,FMN 05 Gerard Le Grellelaan
653,Gerard le Grellelaan 10,2023-06-30,17:00:00,155,134,21,FMN 05 Gerard Le Grellelaan
653,Gerard le Grellelaan 10,2023-06-30,18:00:00,14,13,1,FMN 05 Gerard Le Grellelaan
653,Gerard le Grellelaan 10,2023-06-30,19:00:00,69,52,17,FMN 05 Gerard Le Grellelaan
653,Gerard le Grellelaan 10,2023-06-30,20:00:00,54,39,15,FMN 05 Gerard Le Grellelaan
653,Gerard le Grellelaan 10,2023-06-30,21:00:00,38,35,3,FMN 05 Gerard Le Grellelaan
653,Gerard le Grellelaan 10,2023-06-30,22:00:00,52,50,2,FMN 05 Gerard Le Grellelaan
653,Gerard le Grellelaan 10,2023-06-30,23:00:00,37,29,8,FMN 05 Gerard Le Grellelaan
653,Gerard le Grellelaan 10,2023-07-01,00:00:00,25,21,4,FMN 05 Gerard Le Grellelaan
653,Gerard le Grellelaan 10,2023-07-01,01:00:00,18,11,7,FMN 05 Gerard Le Grellelaan
653,Gerard le Grellelaan 10,2023-07-01,02:00:00,10,6,4,FMN 05 Gerard Le Grellelaan
653,Gerard le Grellelaan 10,2023-07-01,03:00:00,9,5,4,FMN 05 Gerard Le Grellelaan
653,Gerard le Grellelaan 10,2023-07-01,04:00:00,1,0,1,FMN 05 Gerard Le Grellelaan
653,Gerard le Grellelaan 10,2023-07-01,05:00:00,7,6,1,FMN 05 Gerard Le Grellelaan
653,Gerard le Grellelaan 10,2023-07-01,06:00:00,11,9,2,FMN 05 Gerard Le Grellelaan
653,Gerard le Grellelaan 10,2023-07-01,07:00:00,9,8,1,FMN 05 Gerard Le Grellelaan
653,Gerard le Grellelaan 10,2023-07-01,08:00:00,7,5,2,FMN 05 Gerard Le Grellelaan
653,Gerard le Grellelaan 10,2023-07-01,09:00:00,0,0,0,FMN 05 Gerard Le Grellelaan
653,Gerard le Grellelaan 10,2023-07-01,10:00:00,10,8,2,FMN 05 Gerard Le Grellelaan
653,Gerard le Grellelaan 10,2023-07-01,11:00:00,45,42,3,FMN 05 Gerard Le Grellelaan
653,Gerard le Grellelaan 10,2023-07-01,12:00:00,37,33,4,FMN 05 Gerard Le Grellelaan
653,Gerard le Grellelaan 10,2023-07-01,13:00:00,19,10,9,FMN 05 Gerard Le Grellelaan
653,Gerard le Grellelaan 10,2023-07-01,14:00:00,59,47,12,FMN 05 Gerard Le Grellelaan
653,Gerard le Grellelaan 10,2023-07-01,15:00:00,47,41,6,FMN 05 Gerard Le Grellelaan
653,Gerard le Grellelaan 10,2023-07-01,16:00:00,30,23,7,FMN 05 Gerard Le Grellelaan
653,Gerard le Grellelaan 10,2023-07-01,17:00:00,43,32,11,FMN 05 Gerard Le Grellelaan
653,Gerard le Grellelaan 10,2023-07-01,18:00:00,54,44,10,FMN 05 Gerard Le Grellelaan
653,Gerard le Grellelaan 10,2023-07-01,19:00:00,23,19,4,FMN 05 Gerard Le Grellelaan
653,Gerard le Grellelaan 10,2023-07-01,20:00:00,0,0,0,FMN 05 Gerard Le Grellelaan
653,Gerard le Grellelaan 10,2023-07-01,21:00:00,0,0,0,FMN 05 Gerard Le Grellelaan
653,Gerard le Grellelaan 10,2023-07-01,22:00:00,0,0,0,FMN 05 Gerard Le Grellelaan
653,Gerard le Grellelaan 10,2023-07-01,23:00:00,0,0,0,FMN 05 Gerard Le Grellelaan
653,Gerard le Grellelaan 10,2023-07-02,00:00:00,6,3,3,FMN 05 Gerard Le Grellelaan
653,Gerard le Grellelaan 10,2023-07-02,01:00:00,1,1,0,FMN 05 Gerard Le Grellelaan
653,Gerard le Grellelaan 10,2023-07-02,02:00:00,7,5,2,FMN 05 Gerard Le Grellelaan
653,Gerard le Grellelaan 10,2023-07-02,03:00:00,5,3,2,FMN 05 Gerard Le Grellelaan
653,Gerard le Grellelaan 10,2023-07-02,04:00:00,2,1,1,FMN 05 Gerard Le Grellelaan
653,Gerard le Grellelaan 10,2023-07-02,05:00:00,5,5,0,FMN 05 Gerard Le Grellelaan
653,Gerard le Grellelaan 10,2023-07-02,06:00:00,10,8,2,FMN 05 Gerard Le Grellelaan
653,Gerard le Grellelaan 10,2023-07-02,07:00:00,9,6,3,FMN 05 Gerard Le Grellelaan
653,Gerard le Grellelaan 10,2023-07-02,08:00:00,21,18,3,FMN 05 Gerard Le Grellelaan
653,Gerard le Grellelaan 10,2023-07-02,09:00:00,20,19,1,FMN 05 Gerard Le Grellelaan
653,Gerard le Grellelaan 10,2023-07-02,10:00:00,53,44,9,FMN 05 Gerard Le Grellelaan
653,Gerard le Grellelaan 10,2023-07-02,11:00:00,77,56,21,FMN 05 Gerard Le Grellelaan
653,Gerard le Grellelaan 10,2023-07-02,12:00:00,18,16,2,FMN 05 Gerard Le Grellelaan
653,Gerard le Grellelaan 10,2023-07-02,13:00:00,36,32,4,FMN 05 Gerard Le Grellelaan
653,Gerard le Grellelaan 10,2023-07-02,14:00:00,77,62,15,FMN 05 Gerard Le Grellelaan
653,Gerard le Grellelaan 10,2023-07-02,15:00:00,109,95,14,FMN 05 Gerard Le Grellelaan
653,Gerard le Grellelaan 10,2023-07-02,16:00:00,73,64,9,FMN 05 Gerard Le Grellelaan
653,Gerard le Grellelaan 10,2023-07-02,17:00:00,101,84,17,FMN 05 Gerard Le Grellelaan
653,Gerard le Grellelaan 10,2023-07-02,18:00:00,53,46,7,FMN 05 Gerard Le Grellelaan
653,Gerard le Grellelaan 10,2023-07-02,19:00:00,38,33,5,FMN 05 Gerard Le Grellelaan
653,Gerard le Grellelaan 10,2023-07-02,20:00:00,0,0,0,FMN 05 Gerard Le Grellelaan
653,Gerard le Grellelaan 10,2023-07-02,21:00:00,9,8,1,FMN 05 Gerard Le Grellelaan
653,Gerard le Grellelaan 10,2023-07-02,22:00:00,11,9,2,FMN 05 Gerard Le Grellelaan
653,Gerard le Grellelaan 10,2023-07-02,23:00:00,17,12,5,FMN 05 Gerard Le Grellelaan
653,Gerard le Grellelaan 10,2023-07-03,00:00:00,9,5,4,FMN 05 Gerard Le Grellelaan
653,Gerard le Grellelaan 10,2023-07-03,01:00:00,4,3,1,FMN 05 Gerard Le Grellelaan
653,Gerard le Grellelaan 10,2023-07-03,02:00:00,0,0,0,FMN 05 Gerard Le Grellelaan
653,Gerard le Grellelaan 10,2023-07-03,03:00:00,2,2,0,FMN 05 Gerard Le Grellelaan
653,Gerard le Grellelaan 10,2023-07-03,04:00:00,9,3,6,FMN 05 Gerard Le Grellelaan
653,Gerard le Grellelaan 10,2023-07-03,05:00:00,33,13,20,FMN 05 Gerard Le Grellelaan
653,Gerard le Grellelaan 10,2023-07-03,06:00:00,46,22,24,FMN 05 Gerard Le Grellelaan
653,Gerard le Grellelaan 10,2023-07-03,07:00:00,34,18,16,FMN 05 Gerard Le Grellelaan
653,Gerard le Grellelaan 10,2023-07-03,08:00:00,34,31,3,FMN 05 Gerard Le Grellelaan
653,Gerard le Grellelaan 10,2023-07-03,09:00:00,8,8,0,FMN 05 Gerard Le Grellelaan
653,Gerard le Grellelaan 10,2023-07-03,10:00:00,13,13,0,FMN 05 Gerard Le Grellelaan
653,Gerard le Grellelaan 10,2023-07-03,11:00:00,44,33,11,FMN 05 Gerard Le Grellelaan
653,Gerard le Grellelaan 10,2023-07-03,12:00:00,65,58,7,FMN 05 Gerard Le Grellelaan
653,Gerard le Grellelaan 10,2023-07-03,13:00:00,4,2,2,FMN 05 Gerard Le Grellelaan
653,Gerard le Grellelaan 10,2023-07-03,14:00:00,19,13,6,FMN 05 Gerard Le Grellelaan
653,Gerard le Grellelaan 10,2023-07-03,15:00:00,32,27,5,FMN 05 Gerard Le Grellelaan
653,Gerard le Grellelaan 10,2023-07-03,16:00:00,117,93,24,FMN 05 Gerard Le Grellelaan
653,Gerard le Grellelaan 10,2023-07-03,17:00:00,184,160,24,FMN 05 Gerard Le Grellelaan
653,Gerard le Grellelaan 10,2023-07-03,18:00:00,20,17,3,FMN 05 Gerard Le Grellelaan
653,Gerard le Grellelaan 10,2023-07-03,19:00:00,17,14,3,FMN 05 Gerard Le Grellelaan
653,Gerard le Grellelaan 10,2023-07-03,20:00:00,20,16,4,FMN 05 Gerard Le Grellelaan
653,Gerard le Grellelaan 10,2023-07-03,21:00:00,53,41,12,FMN 05 Gerard Le Grellelaan
653,Gerard le Grellelaan 10,2023-07-03,22:00:00,21,20,1,FMN 05 Gerard Le Grellelaan
653,Gerard le Grellelaan 10,2023-07-03,23:00:00,3,2,1,FMN 05 Gerard Le Grellelaan
653,Gerard le Grellelaan 10,2023-07-04,00:00:00,2,2,0,FMN 05 Gerard Le Grellelaan
653,Gerard le Grellelaan 10,2023-07-04,01:00:00,4,4,0,FMN 05 Gerard Le Grellelaan
653,Gerard le Grellelaan 10,2023-07-04,02:00:00,2,2,0,FMN 05 Gerard Le Grellelaan
653,Gerard le Grellelaan 10,2023-07-04,03:00:00,1,1,0,FMN 05 Gerard Le Grellelaan
653,Gerard le Grellelaan 10,2023-07-04,04:00:00,9,2,7,FMN 05 Gerard Le Grellelaan
653,Gerard le Grellelaan 10,2023-07-04,05:00:00,30,10,20,FMN 05 Gerard Le Grellelaan
653,Gerard le Grellelaan 10,2023-07-04,06:00:00,52,25,27,FMN 05 Gerard Le Grellelaan
653,Gerard le Grellelaan 10,2023-07-04,07:00:00,136,96,40,FMN 05 Gerard Le Grellelaan
653,Gerard le Grellelaan 10,2023-07-04,08:00:00,84,67,17,FMN 05 Gerard Le Grellelaan
653,Gerard le Grellelaan 10,2023-07-04,09:00:00,36,32,4,FMN 05 Gerard Le Grellelaan
653,Gerard le Grellelaan 10,2023-07-04,10:00:00,53,40,13,FMN 05 Gerard Le Grellelaan
653,Gerard le Grellelaan 10,2023-07-04,11:00:00,63,55,8,FMN 05 Gerard Le Grellelaan
653,Gerard le Grellelaan 10,2023-07-04,12:00:00,40,30,10,FMN 05 Gerard Le Grellelaan
653,Gerard le Grellelaan 10,2023-07-04,13:00:00,14,14,0,FMN 05 Gerard Le Grellelaan
653,Gerard le Grellelaan 10,2023-07-04,14:00:00,32,27,5,FMN 05 Gerard Le Grellelaan
653,Gerard le Grellelaan 10,2023-07-04,15:00:00,6,4,2,FMN 05 Gerard Le Grellelaan
653,Gerard le Grellelaan 10,2023-07-04,16:00:00,190,169,21,FMN 05 Gerard Le Grellelaan
653,Gerard le Grellelaan 10,2023-07-04,17:00:00,221,171,50,FMN 05 Gerard Le Grellelaan
653,Gerard le Grellelaan 10,2023-07-04,18:00:00,134,113,21,FMN 05 Gerard Le Grellelaan
653,Gerard le Grellelaan 10,2023-07-04,19:00:00,54,45,9,FMN 05 Gerard Le Grellelaan
653,Gerard le Grellelaan 10,2023-07-04,20:00:00,49,40,9,FMN 05 Gerard Le Grellelaan
653,Gerard le Grellelaan 10,2023-07-04,21:00:00,47,37,10,FMN 05 Gerard Le Grellelaan
653,Gerard le Grellelaan 10,2023-07-04,22:00:00,67,62,5,FMN 05 Gerard Le Grellelaan
653,Gerard le Grellelaan 10,2023-07-04,23:00:00,32,23,9,FMN 05 Gerard Le Grellelaan
653,Gerard le Grellelaan 10,2023-07-05,00:00:00,14,12,2,FMN 05 Gerard Le Grellelaan
653,Gerard le Grellelaan 10,2023-07-05,01:00:00,4,3,1,FMN 05 Gerard Le Grellelaan
653,Gerard le Grellelaan 10,2023-07-05,02:00:00,1,1,0,FMN 05 Gerard Le Grellelaan
653,Gerard le Grellelaan 10,2023-07-05,03:00:00,2,2,0,FMN 05 Gerard Le Grellelaan
653,Gerard le Grellelaan 10,2023-07-05,04:00:00,2,2,0,FMN 05 Gerard Le Grellelaan
653,Gerard le Grellelaan 10,2023-07-05,05:00:00,3,1,2,FMN 05 Gerard Le Grellelaan
653,Gerard le Grellelaan 10,2023-07-05,06:00:00,0,0,0,FMN 05 Gerard Le Grellelaan
653,Gerard le Grellelaan 10,2023-07-05,07:00:00,4,2,2,FMN 05 Gerard Le Grellelaan
653,Gerard le Grellelaan 10,2023-07-05,08:00:00,4,3,1,FMN 05 Gerard Le Grellelaan
653,Gerard le Grellelaan 10,2023-07-05,09:00:00,2,2,0,FMN 05 Gerard Le Grellelaan
653,Gerard le Grellelaan 10,2023-07-05,10:00:00,4,4,0,FMN 05 Gerard Le Grellelaan
653,Gerard le Grellelaan 10,2023-07-05,11:00:00,6,6,0,FMN 05 Gerard Le Grellelaan
653,Gerard le Grellelaan 10,2023-07-05,12:00:00,10,9,1,FMN 05 Gerard Le Grellelaan
653,Gerard le Grellelaan 10,2023-07-05,13:00:00,11,9,2,FMN 05 Gerard Le Grellelaan
653,Gerard le Grellelaan 10,2023-07-05,14:00:00,37,32,5,FMN 05 Gerard Le Grellelaan
653,Gerard le Grellelaan 10,2023-07-05,15:00:00,6,6,0,FMN 05 Gerard Le Grellelaan
653,Gerard le Grellelaan 10,2023-07-05,16:00:00,132,114,18,FMN 05 Gerard Le Grellelaan
653,Gerard le Grellelaan 10,2023-07-05,17:00:00,0,0,0,FMN 05 Gerard Le Grellelaan
653,Gerard le Grellelaan 10,2023-07-05,18:00:00,62,53,9,FMN 05 Gerard Le Grellelaan
653,Gerard le Grellelaan 10,2023-07-05,19:00:00,60,55,5,FMN 05 Gerard Le Grellelaan
653,Gerard le Grellelaan 10,2023-07-05,20:00:00,28,23,5,FMN 05 Gerard Le Grellelaan
653,Gerard le Grellelaan 10,2023-07-05,21:00:00,3,3,0,FMN 05 Gerard Le Grellelaan
653,Gerard le Grellelaan 10,2023-07-05,22:00:00,47,43,4,FMN 05 Gerard Le Grellelaan
653,Gerard le Grellelaan 10,2023-07-05,23:00:00,12,11,1,FMN 05 Gerard Le Grellelaan
653,Gerard le Grellelaan 10,2023-07-06,00:00:00,11,7,4,FMN 05 Gerard Le Grellelaan
653,Gerard le Grellelaan 10,2023-07-06,01:00:00,2,2,0,FMN 05 Gerard Le Grellelaan
653,Gerard le Grellelaan 10,2023-07-06,02:00:00,2,1,1,FMN 05 Gerard Le Grellelaan
653,Gerard le Grellelaan 10,2023-07-06,03:00:00,5,3,2,FMN 05 Gerard Le Grellelaan
653,Gerard le Grellelaan 10,2023-07-06,04:00:00,6,4,2,FMN 05 Gerard Le Grellelaan
653,Gerard le Grellelaan 10,2023-07-06,05:00:00,28,8,20,FMN 05 Gerard Le Grellelaan
653,Gerard le Grellelaan 10,2023-07-06,06:00:00,45,26,19,FMN 05 Gerard Le Grellelaan
653,Gerard le Grellelaan 10,2023-07-06,07:00:00,91,70,21,FMN 05 Gerard Le Grellelaan
653,Gerard le Grellelaan 10,2023-07-06,08:00:00,195,170,25,FMN 05 Gerard Le Grellelaan
653,Gerard le Grellelaan 10,2023-07-06,09:00:00,0,0,0,FMN 05 Gerard Le Grellelaan
653,Gerard le Grellelaan 10,2023-07-06,10:00:00,63,51,12,FMN 05 Gerard Le Grellelaan
653,Gerard le Grellelaan 10,2023-07-06,11:00:00,9,4,5,FMN 05 Gerard Le Grellelaan
653,Gerard le Grellelaan 10,2023-07-06,12:00:00,78,63,15,FMN 05 Gerard Le Grellelaan
653,Gerard le Grellelaan 10,2023-07-06,13:00:00,74,59,15,FMN 05 Gerard Le Grellelaan
653,Gerard le Grellelaan 10,2023-07-06,14:00:00,107,87,20,FMN 05 Gerard Le Grellelaan
653,Gerard le Grellelaan 10,2023-07-06,15:00:00,111,86,25,FMN 05 Gerard Le Grellelaan
653,Gerard le Grellelaan 10,2023-07-06,16:00:00,186,151,35,FMN 05 Gerard Le Grellelaan
653,Gerard le Grellelaan 10,2023-07-06,17:00:00,186,155,31,FMN 05 Gerard Le Grellelaan
653,Gerard le Grellelaan 10,2023-07-06,18:00:00,118,87,31,FMN 05 Gerard Le Grellelaan
653,Gerard le Grellelaan 10,2023-07-06,19:00:00,89,70,19,FMN 05 Gerard Le Grellelaan
653,Gerard le Grellelaan 10,2023-07-06,20:00:00,68,57,11,FMN 05 Gerard Le Grellelaan
653,Gerard le Grellelaan 10,2023-07-06,21:00:00,47,38,9,FMN 05 Gerard Le Grellelaan
653,Gerard le Grellelaan 10,2023-07-06,22:00:00,63,53,10,FMN 05 Gerard Le Grellelaan
653,Gerard le Grellelaan 10,2023-07-06,23:00:00,41,33,8,FMN 05 Gerard Le Grellelaan
653,Gerard le Grellelaan 10,2023-07-07,00:00:00,14,11,3,FMN 05 Gerard Le Grellelaan
653,Gerard le Grellelaan 10,2023-07-07,01:00:00,9,9,0,FMN 05 Gerard Le Grellelaan
653,Gerard le Grellelaan 10,2023-07-07,02:00:00,9,8,1,FMN 05 Gerard Le Grellelaan
653,Gerard le Grellelaan 10,2023-07-07,03:00:00,2,2,0,FMN 05 Gerard Le Grellelaan
653,Gerard le Grellelaan 10,2023-07-07,04:00:00,5,2,3,FMN 05 Gerard Le Grellelaan
653,Gerard le Grellelaan 10,2023-07-07,05:00:00,25,7,18,FMN 05 Gerard Le Grellelaan
653,Gerard le Grellelaan 10,2023-07-07,06:00:00,49,23,26,FMN 05 Gerard Le Grellelaan
653,Gerard le Grellelaan 10,2023-07-07,07:00:00,87,66,21,FMN 05 Gerard Le Grellelaan
653,Gerard le Grellelaan 10,2023-07-07,08:00:00,171,147,24,FMN 05 Gerard Le Grellelaan
653,Gerard le Grellelaan 10,2023-07-07,09:00:00,100,88,12,FMN 05 Gerard Le Grellelaan
653,Gerard le Grellelaan 10,2023-07-07,10:00:00,70,62,8,FMN 05 Gerard Le Grellelaan
653,Gerard le Grellelaan 10,2023-07-07,11:00:00,69,57,12,FMN 05 Gerard Le Grellelaan
653,Gerard le Grellelaan 10,2023-07-07,12:00:00,71,60,11,FMN 05 Gerard Le Grellelaan
653,Gerard le Grellelaan 10,2023-07-07,13:00:00,6,6,0,FMN 05 Gerard Le Grellelaan
653,Gerard le Grellelaan 10,2023-07-07,14:00:00,0,0,0,FMN 05 Gerard Le Grellelaan
653,Gerard le Grellelaan 10,2023-07-07,15:00:00,0,0,0,FMN 05 Gerard Le Grellelaan
653,Gerard le Grellelaan 10,2023-07-07,16:00:00,0,0,0,FMN 05 Gerard Le Grellelaan
653,Gerard le Grellelaan 10,2023-07-07,17:00:00,0,0,0,FMN 05 Gerard Le Grellelaan
653,Gerard le Grellelaan 10,2023-07-07,18:00:00,7,5,2,FMN 05 Gerard Le Grellelaan
653,Gerard le Grellelaan 10,2023-07-07,19:00:00,51,42,9,FMN 05 Gerard Le Grellelaan
653,Gerard le Grellelaan 10,2023-07-07,20:00:00,54,47,7,FMN 05 Gerard Le Grellelaan
653,Gerard le Grellelaan 10,2023-07-07,21:00:00,54,45,9,FMN 05 Gerard Le Grellelaan
653,Gerard le Grellelaan 10,2023-07-07,22:00:00,50,39,11,FMN 05 Gerard Le Grellelaan
653,Gerard le Grellelaan 10,2023-07-07,23:00:00,37,29,8,FMN 05 Gerard Le Grellelaan
653,Gerard le Grellelaan 10,2023-07-08,00:00:00,24,12,12,FMN 05 Gerard Le Grellelaan
653,Gerard le Grellelaan 10,2023-07-08,01:00:00,12,8,4,FMN 05 Gerard Le Grellelaan
653,Gerard le Grellelaan 10,2023-07-08,02:00:00,5,5,0,FMN 05 Gerard Le Grellelaan
653,Gerard le Grellelaan 10,2023-07-08,03:00:00,3,3,0,FMN 05 Gerard Le Grellelaan
653,Gerard le Grellelaan 10,2023-07-08,04:00:00,4,1,3,FMN 05 Gerard Le Grellelaan
653,Gerard le Grellelaan 10,2023-07-08,05:00:00,7,4,3,FMN 05 Gerard Le Grellelaan
653,Gerard le Grellelaan 10,2023-07-08,06:00:00,17,13,4,FMN 05 Gerard Le Grellelaan
653,Gerard le Grellelaan 10,2023-07-08,07:00:00,16,13,3,FMN 05 Gerard Le Grellelaan
653,Gerard le Grellelaan 10,2023-07-08,08:00:00,34,24,10,FMN 05 Gerard Le Grellelaan
653,Gerard le Grellelaan 10,2023-07-08,09:00:00,59,44,15,FMN 05 Gerard Le Grellelaan
653,Gerard le Grellelaan 10,2023-07-08,10:00:00,63,56,7,FMN 05 Gerard Le Grellelaan
653,Gerard le Grellelaan 10,2023-07-08,11:00:00,70,59,11,FMN 05 Gerard Le Grellelaan
653,Gerard le Grellelaan 10,2023-07-08,12:00:00,74,63,11,FMN 05 Gerard Le Grellelaan
653,Gerard le Grellelaan 10,2023-07-08,13:00:00,76,63,13,FMN 05 Gerard Le Grellelaan
653,Gerard le Grellelaan 10,2023-07-08,14:00:00,53,44,9,FMN 05 Gerard Le Grellelaan
653,Gerard le Grellelaan 10,2023-07-08,15:00:00,38,25,13,FMN 05 Gerard Le Grellelaan
653,Gerard le Grellelaan 10,2023-07-08,16:00:00,70,54,16,FMN 05 Gerard Le Grellelaan
653,Gerard le Grellelaan 10,2023-07-08,17:00:00,76,64,12,FMN 05 Gerard Le Grellelaan
653,Gerard le Grellelaan 10,2023-07-08,18:00:00,76,62,14,FMN 05 Gerard Le Grellelaan
653,Gerard le Grellelaan 10,2023-07-08,19:00:00,65,52,13,FMN 05 Gerard Le Grellelaan
653,Gerard le Grellelaan 10,2023-07-08,20:00:00,49,38,11,FMN 05 Gerard Le Grellelaan
653,Gerard le Grellelaan 10,2023-07-08,21:00:00,46,32,14,FMN 05 Gerard Le Grellelaan
653,Gerard le Grellelaan 10,2023-07-08,22:00:00,42,35,7,FMN 05 Gerard Le Grellelaan
653,Gerard le Grellelaan 10,2023-07-08,23:00:00,35,26,9,FMN 05 Gerard Le Grellelaan
653,Gerard le Grellelaan 10,2023-07-09,00:00:00,27,21,6,FMN 05 Gerard Le Grellelaan
653,Gerard le Grellelaan 10,2023-07-09,01:00:00,13,9,4,FMN 05 Gerard Le Grellelaan
653,Gerard le Grellelaan 10,2023-07-09,02:00:00,5,2,3,FMN 05 Gerard Le Grellelaan
653,Gerard le Grellelaan 10,2023-07-09,03:00:00,3,2,1,FMN 05 Gerard Le Grellelaan
653,Gerard le Grellelaan 10,2023-07-09,04:00:00,2,2,0,FMN 05 Gerard Le Grellelaan
653,Gerard le Grellelaan 10,2023-07-09,05:00:00,6,3,3,FMN 05 Gerard Le Grellelaan
653,Gerard le Grellelaan 10,2023-07-09,06:00:00,15,14,1,FMN 05 Gerard Le Grellelaan
653,Gerard le Grellelaan 10,2023-07-09,07:00:00,9,7,2,FMN 05 Gerard Le Grellelaan
653,Gerard le Grellelaan 10,2023-07-09,08:00:00,21,13,8,FMN 05 Gerard Le Grellelaan
653,Gerard le Grellelaan 10,2023-07-09,09:00:00,61,38,23,FMN 05 Gerard Le Grellelaan
653,Gerard le Grellelaan 10,2023-07-09,10:00:00,61,49,12,FMN 05 Gerard Le Grellelaan
653,Gerard le Grellelaan 10,2023-07-09,11:00:00,75,63,12,FMN 05 Gerard Le Grellelaan
653,Gerard le Grellelaan 10,2023-07-09,12:00:00,68,60,8,FMN 05 Gerard Le Grellelaan
653,Gerard le Grellelaan 10,2023-07-09,13:00:00,60,48,12,FMN 05 Gerard Le Grellelaan
653,Gerard le Grellelaan 10,2023-07-09,14:00:00,68,54,14,FMN 05 Gerard Le Grellelaan
653,Gerard le Grellelaan 10,2023-07-09,15:00:00,30,25,5,FMN 05 Gerard Le Grellelaan
653,Gerard le Grellelaan 10,2023-07-09,16:00:00,41,30,11,FMN 05 Gerard Le Grellelaan
653,Gerard le Grellelaan 10,2023-07-09,17:00:00,34,30,4,FMN 05 Gerard Le Grellelaan
653,Gerard le Grellelaan 10,2023-07-09,18:00:00,64,47,17,FMN 05 Gerard Le Grellelaan
653,Gerard le Grellelaan 10,2023-07-09,19:00:00,29,26,3,FMN 05 Gerard Le Grellelaan
653,Gerard le Grellelaan 10,2023-07-09,20:00:00,37,29,8,FMN 05 Gerard Le Grellelaan
653,Gerard le Grellelaan 10,2023-07-09,21:00:00,20,14,6,FMN 05 Gerard Le Grellelaan
653,Gerard le Grellelaan 10,2023-07-09,22:00:00,30,27,3,FMN 05 Gerard Le Grellelaan
653,Gerard le Grellelaan 10,2023-07-09,23:00:00,11,10,1,FMN 05 Gerard Le Grellelaan
653,Gerard le Grellelaan 10,2023-07-10,00:00:00,6,5,1,FMN 05 Gerard Le Grellelaan
653,Gerard le Grellelaan 10,2023-07-10,01:00:00,2,1,1,FMN 05 Gerard Le Grellelaan
653,Gerard le Grellelaan 10,2023-07-10,02:00:00,3,3,0,FMN 05 Gerard Le Grellelaan
653,Gerard le Grellelaan 10,2023-07-10,03:00:00,1,1,0,FMN 05 Gerard Le Grellelaan
653,Gerard le Grellelaan 10,2023-07-10,04:00:00,8,6,2,FMN 05 Gerard Le Grellelaan
653,Gerard le Grellelaan 10,2023-07-10,05:00:00,25,8,17,FMN 05 Gerard Le Grellelaan
653,Gerard le Grellelaan 10,2023-07-10,06:00:00,45,25,20,FMN 05 Gerard Le Grellelaan
653,Gerard le Grellelaan 10,2023-07-10,07:00:00,102,72,30,FMN 05 Gerard Le Grellelaan
653,Gerard le Grellelaan 10,2023-07-10,08:00:00,155,130,25,FMN 05 Gerard Le Grellelaan
653,Gerard le Grellelaan 10,2023-07-10,09:00:00,65,58,7,FMN 05 Gerard Le Grellelaan
653,Gerard le Grellelaan 10,2023-07-10,10:00:00,0,0,0,FMN 05 Gerard Le Grellelaan
653,Gerard le Grellelaan 10,2023-07-10,11:00:00,0,0,0,FMN 05 Gerard Le Grellelaan
653,Gerard le Grellelaan 10,2023-07-10,12:00:00,0,0,0,FMN 05 Gerard Le Grellelaan
653,Gerard le Grellelaan 10,2023-07-10,13:00:00,0,0,0,FMN 05 Gerard Le Grellelaan
653,Gerard le Grellelaan 10,2023-07-10,14:00:00,0,0,0,FMN 05 Gerard Le Grellelaan
653,Gerard le Grellelaan 10,2023-07-10,15:00:00,0,0,0,FMN 05 Gerard Le Grellelaan
653,Gerard le Grellelaan 10,2023-07-10,16:00:00,0,0,0,FMN 05 Gerard Le Grellelaan
653,Gerard le Grellelaan 10,2023-07-10,17:00:00,0,0,0,FMN 05 Gerard Le Grellelaan
653,Gerard le Grellelaan 10,2023-07-10,18:00:00,0,0,0,FMN 05 Gerard Le Grellelaan
653,Gerard le Grellelaan 10,2023-07-10,19:00:00,0,0,0,FMN 05 Gerard Le Grellelaan
653,Gerard le Grellelaan 10,2023-07-10,20:00:00,0,0,0,FMN 05 Gerard Le Grellelaan
653,Gerard le Grellelaan 10,2023-07-10,21:00:00,0,0,0,FMN 05 Gerard Le Grellelaan
653,Gerard le Grellelaan 10,2023-07-10,22:00:00,0,0,0,FMN 05 Gerard Le Grellelaan
653,Gerard le Grellelaan 10,2023-07-10,23:00:00,0,0,0,FMN 05 Gerard Le Grellelaan
653,Gerard le Grellelaan 10,2023-07-11,00:00:00,0,0,0,FMN 05 Gerard Le Grellelaan
653,Gerard le Grellelaan 10,2023-07-11,01:00:00,0,0,0,FMN 05 Gerard Le Grellelaan
653,Gerard le Grellelaan 10,2023-07-11,02:00:00,0,0,0,FMN 05 Gerard Le Grellelaan
653,Gerard le Grellelaan 10,2023-07-11,03:00:00,0,0,0,FMN 05 Gerard Le Grellelaan
653,Gerard le Grellelaan 10,2023-07-11,04:00:00,0,0,0,FMN 05 Gerard Le Grellelaan
653,Gerard le Grellelaan 10,2023-07-11,05:00:00,0,0,0,FMN 05 Gerard Le Grellelaan
653,Gerard le Grellelaan 10,2023-07-11,06:00:00,0,0,0,FMN 05 Gerard Le Grellelaan
653,Gerard le Grellelaan 10,2023-07-11,07:00:00,0,0,0,FMN 05 Gerard Le Grellelaan
653,Gerard le Grellelaan 10,2023-07-11,08:00:00,0,0,0,FMN 05 Gerard Le Grellelaan
653,Gerard le Grellelaan 10,2023-07-11,09:00:00,0,0,0,FMN 05 Gerard Le Grellelaan
653,Gerard le Grellelaan 10,2023-07-11,10:00:00,0,0,0,FMN 05 Gerard Le Grellelaan
653,Gerard le Grellelaan 10,2023-07-11,11:00:00,0,0,0,FMN 05 Gerard Le Grellelaan
653,Gerard le Grellelaan 10,2023-07-11,12:00:00,9,7,2,FMN 05 Gerard Le Grellelaan
653,Gerard le Grellelaan 10,2023-07-11,13:00:00,45,32,13,FMN 05 Gerard Le Grellelaan
653,Gerard le Grellelaan 10,2023-07-11,14:00:00,0,0,0,FMN 05 Gerard Le Grellelaan
653,Gerard le Grellelaan 10,2023-07-11,15:00:00,0,0,0,FMN 05 Gerard Le Grellelaan
653,Gerard le Grellelaan 10,2023-07-11,16:00:00,0,0,0,FMN 05 Gerard Le Grellelaan
653,Gerard le Grellelaan 10,2023-07-11,17:00:00,0,0,0,FMN 05 Gerard Le Grellelaan
653,Gerard le Grellelaan 10,2023-07-11,18:00:00,0,0,0,FMN 05 Gerard Le Grellelaan
653,Gerard le Grellelaan 10,2023-07-11,19:00:00,0,0,0,FMN 05 Gerard Le Grellelaan
653,Gerard le Grellelaan 10,2023-07-11,20:00:00,23,16,7,FMN 05 Gerard Le Grellelaan
653,Gerard le Grellelaan 10,2023-07-11,21:00:00,30,23,7,FMN 05 Gerard Le Grellelaan
653,Gerard le Grellelaan 10,2023-07-11,22:00:00,8,8,0,FMN 05 Gerard Le Grellelaan
653,Gerard le Grellelaan 10,2023-07-11,23:00:00,25,19,6,FMN 05 Gerard Le Grellelaan
653,Gerard le Grellelaan 10,2023-07-12,00:00:00,4,4,0,FMN 05 Gerard Le Grellelaan
653,Gerard le Grellelaan 10,2023-07-12,01:00:00,6,4,2,FMN 05 Gerard Le Grellelaan
653,Gerard le Grellelaan 10,2023-07-12,02:00:00,0,0,0,FMN 05 Gerard Le Grellelaan
653,Gerard le Grellelaan 10,2023-07-12,03:00:00,3,3,0,FMN 05 Gerard Le Grellelaan
653,Gerard le Grellelaan 10,2023-07-12,04:00:00,5,3,2,FMN 05 Gerard Le Grellelaan
653,Gerard le Grellelaan 10,2023-07-12,05:00:00,20,6,14,FMN 05 Gerard Le Grellelaan
653,Gerard le Grellelaan 10,2023-07-12,06:00:00,38,20,18,FMN 05 Gerard Le Grellelaan
653,Gerard le Grellelaan 10,2023-07-12,07:00:00,2,2,0,FMN 05 Gerard Le Grellelaan
653,Gerard le Grellelaan 10,2023-07-12,08:00:00,23,16,7,FMN 05 Gerard Le Grellelaan
653,Gerard le Grellelaan 10,2023-07-12,09:00:00,57,45,12,FMN 05 Gerard Le Grellelaan
653,Gerard le Grellelaan 10,2023-07-12,10:00:00,16,15,1,FMN 05 Gerard Le Grellelaan
653,Gerard le Grellelaan 10,2023-07-12,11:00:00,9,4,5,FMN 05 Gerard Le Grellelaan
653,Gerard le Grellelaan 10,2023-07-12,12:00:00,66,52,14,FMN 05 Gerard Le Grellelaan
653,Gerard le Grellelaan 10,2023-07-12,13:00:00,31,26,5,FMN 05 Gerard Le Grellelaan
653,Gerard le Grellelaan 10,2023-07-12,14:00:00,7,6,1,FMN 05 Gerard Le Grellelaan
653,Gerard le Grellelaan 10,2023-07-12,15:00:00,0,0,0,FMN 05 Gerard Le Grellelaan
653,Gerard le Grellelaan 10,2023-07-12,16:00:00,114,92,22,FMN 05 Gerard Le Grellelaan
653,Gerard le Grellelaan 10,2023-07-12,17:00:00,89,75,14,FMN 05 Gerard Le Grellelaan
653,Gerard le Grellelaan 10,2023-07-12,18:00:00,78,64,14,FMN 05 Gerard Le Grellelaan
653,Gerard le Grellelaan 10,2023-07-12,19:00:00,30,24,6,FMN 05 Gerard Le Grellelaan
653,Gerard le Grellelaan 10,2023-07-12,20:00:00,0,0,0,FMN 05 Gerard Le Grellelaan
653,Gerard le Grellelaan 10,2023-07-12,21:00:00,0,0,0,FMN 05 Gerard Le Grellelaan
653,Gerard le Grellelaan 10,2023-07-12,22:00:00,0,0,0,FMN 05 Gerard Le Grellelaan
653,Gerard le Grellelaan 10,2023-07-12,23:00:00,13,12,1,FMN 05 Gerard Le Grellelaan
653,Gerard le Grellelaan 10,2023-07-13,00:00:00,10,5,5,FMN 05 Gerard Le Grellelaan
653,Gerard le Grellelaan 10,2023-07-13,01:00:00,4,3,1,FMN 05 Gerard Le Grellelaan
653,Gerard le Grellelaan 10,2023-07-13,02:00:00,2,2,0,FMN 05 Gerard Le Grellelaan
653,Gerard le Grellelaan 10,2023-07-13,03:00:00,2,2,0,FMN 05 Gerard Le Grellelaan
653,Gerard le Grellelaan 10,2023-07-13,04:00:00,10,7,3,FMN 05 Gerard Le Grellelaan
653,Gerard le Grellelaan 10,2023-07-13,05:00:00,25,8,17,FMN 05 Gerard Le Grellelaan
653,Gerard le Grellelaan 10,2023-07-13,06:00:00,43,23,20,FMN 05 Gerard Le Grellelaan
653,Gerard le Grellelaan 10,2023-07-13,07:00:00,103,63,40,FMN 05 Gerard Le Grellelaan
653,Gerard le Grellelaan 10,2023-07-13,08:00:00,44,37,7,FMN 05 Gerard Le Grellelaan
653,Gerard le Grellelaan 10,2023-07-13,09:00:00,96,81,15,FMN 05 Gerard Le Grellelaan
653,Gerard le Grellelaan 10,2023-07-13,10:00:00,61,56,5,FMN 05 Gerard Le Grellelaan
653,Gerard le Grellelaan 10,2023-07-13,11:00:00,65,47,18,FMN 05 Gerard Le Grellelaan
653,Gerard le Grellelaan 10,2023-07-13,12:00:00,76,60,16,FMN 05 Gerard Le Grellelaan
653,Gerard le Grellelaan 10,2023-07-13,13:00:00,67,50,17,FMN 05 Gerard Le Grellelaan
653,Gerard le Grellelaan 10,2023-07-13,14:00:00,76,59,17,FMN 05 Gerard Le Grellelaan
653,Gerard le Grellelaan 10,2023-07-13,15:00:00,105,91,14,FMN 05 Gerard Le Grellelaan
653,Gerard le Grellelaan 10,2023-07-13,16:00:00,174,144,30,FMN 05 Gerard Le Grellelaan
653,Gerard le Grellelaan 10,2023-07-13,17:00:00,211,174,37,FMN 05 Gerard Le Grellelaan
653,Gerard le Grellelaan 10,2023-07-13,18:00:00,142,118,24,FMN 05 Gerard Le Grellelaan
653,Gerard le Grellelaan 10,2023-07-13,19:00:00,82,61,21,FMN 05 Gerard Le Grellelaan
653,Gerard le Grellelaan 10,2023-07-13,20:00:00,92,72,20,FMN 05 Gerard Le Grellelaan
653,Gerard le Grellelaan 10,2023-07-13,21:00:00,40,32,8,FMN 05 Gerard Le Grellelaan
653,Gerard le Grellelaan 10,2023-07-13,22:00:00,49,43,6,FMN 05 Gerard Le Grellelaan
653,Gerard le Grellelaan 10,2023-07-13,23:00:00,34,22,12,FMN 05 Gerard Le Grellelaan
653,Gerard le Grellelaan 10,2023-07-14,00:00:00,14,12,2,FMN 05 Gerard Le Grellelaan
653,Gerard le Grellelaan 10,2023-07-14,01:00:00,18,16,2,FMN 05 Gerard Le Grellelaan
653,Gerard le Grellelaan 10,2023-07-14,02:00:00,5,5,0,FMN 05 Gerard Le Grellelaan
653,Gerard le Grellelaan 10,2023-07-14,03:00:00,2,1,1,FMN 05 Gerard Le Grellelaan
653,Gerard le Grellelaan 10,2023-07-14,04:00:00,5,4,1,FMN 05 Gerard Le Grellelaan
653,Gerard le Grellelaan 10,2023-07-14,05:00:00,22,8,14,FMN 05 Gerard Le Grellelaan
653,Gerard le Grellelaan 10,2023-07-14,06:00:00,32,16,16,FMN 05 Gerard Le Grellelaan
653,Gerard le Grellelaan 10,2023-07-14,07:00:00,65,39,26,FMN 05 Gerard Le Grellelaan
653,Gerard le Grellelaan 10,2023-07-14,08:00:00,151,126,25,FMN 05 Gerard Le Grellelaan
653,Gerard le Grellelaan 10,2023-07-14,09:00:00,74,63,11,FMN 05 Gerard Le Grellelaan
653,Gerard le Grellelaan 10,2023-07-14,10:00:00,66,52,14,FMN 05 Gerard Le Grellelaan
653,Gerard le Grellelaan 10,2023-07-14,11:00:00,55,46,9,FMN 05 Gerard Le Grellelaan
653,Gerard le Grellelaan 10,2023-07-14,12:00:00,77,65,12,FMN 05 Gerard Le Grellelaan
653,Gerard le Grellelaan 10,2023-07-14,13:00:00,53,45,8,FMN 05 Gerard Le Grellelaan
653,Gerard le Grellelaan 10,2023-07-14,14:00:00,65,54,11,FMN 05 Gerard Le Grellelaan
653,Gerard le Grellelaan 10,2023-07-14,15:00:00,134,122,12,FMN 05 Gerard Le Grellelaan
653,Gerard le Grellelaan 10,2023-07-14,16:00:00,134,113,21,FMN 05 Gerard Le Grellelaan
653,Gerard le Grellelaan 10,2023-07-14,17:00:00,142,119,23,FMN 05 Gerard Le Grellelaan
653,Gerard le Grellelaan 10,2023-07-14,18:00:00,90,70,20,FMN 05 Gerard Le Grellelaan
653,Gerard le Grellelaan 10,2023-07-14,19:00:00,83,63,20,FMN 05 Gerard Le Grellelaan
653,Gerard le Grellelaan 10,2023-07-14,20:00:00,73,61,12,FMN 05 Gerard Le Grellelaan
653,Gerard le Grellelaan 10,2023-07-14,21:00:00,36,29,7,FMN 05 Gerard Le Grellelaan
653,Gerard le Grellelaan 10,2023-07-14,22:00:00,51,40,11,FMN 05 Gerard Le Grellelaan
653,Gerard le Grellelaan 10,2023-07-14,23:00:00,31,26,5,FMN 05 Gerard Le Grellelaan
653,Gerard le Grellelaan 10,2023-07-15,00:00:00,17,16,1,FMN 05 Gerard Le Grellelaan
653,Gerard le Grellelaan 10,2023-07-15,01:00:00,23,19,4,FMN 05 Gerard Le Grellelaan
653,Gerard le Grellelaan 10,2023-07-15,02:00:00,17,13,4,FMN 05 Gerard Le Grellelaan
653,Gerard le Grellelaan 10,2023-07-15,03:00:00,6,6,0,FMN 05 Gerard Le Grellelaan
653,Gerard le Grellelaan 10,2023-07-15,04:00:00,1,1,0,FMN 05 Gerard Le Grellelaan
653,Gerard le Grellelaan 10,2023-07-15,05:00:00,4,3,1,FMN 05 Gerard Le Grellelaan
653,Gerard le Grellelaan 10,2023-07-15,06:00:00,11,7,4,FMN 05 Gerard Le Grellelaan
653,Gerard le Grellelaan 10,2023-07-15,07:00:00,14,11,3,FMN 05 Gerard Le Grellelaan
653,Gerard le Grellelaan 10,2023-07-15,08:00:00,29,18,11,FMN 05 Gerard Le Grellelaan
653,Gerard le Grellelaan 10,2023-07-15,09:00:00,10,9,1,FMN 05 Gerard Le Grellelaan
653,Gerard le Grellelaan 10,2023-07-15,10:00:00,55,52,3,FMN 05 Gerard Le Grellelaan
653,Gerard le Grellelaan 10,2023-07-15,11:00:00,72,52,20,FMN 05 Gerard Le Grellelaan
653,Gerard le Grellelaan 10,2023-07-15,12:00:00,67,61,6,FMN 05 Gerard Le Grellelaan
653,Gerard le Grellelaan 10,2023-07-15,13:00:00,16,12,4,FMN 05 Gerard Le Grellelaan
653,Gerard le Grellelaan 10,2023-07-15,14:00:00,0,0,0,FMN 05 Gerard Le Grellelaan
653,Gerard le Grellelaan 10,2023-07-15,15:00:00,32,25,7,FMN 05 Gerard Le Grellelaan
653,Gerard le Grellelaan 10,2023-07-15,16:00:00,41,33,8,FMN 05 Gerard Le Grellelaan
653,Gerard le Grellelaan 10,2023-07-15,17:00:00,0,0,0,FMN 05 Gerard Le Grellelaan
653,Gerard le Grellelaan 10,2023-07-15,18:00:00,0,0,0,FMN 05 Gerard Le Grellelaan
653,Gerard le Grellelaan 10,2023-07-15,19:00:00,45,37,8,FMN 05 Gerard Le Grellelaan
653,Gerard le Grellelaan 10,2023-07-15,20:00:00,55,46,9,FMN 05 Gerard Le Grellelaan
653,Gerard le Grellelaan 10,2023-07-15,21:00:00,25,24,1,FMN 05 Gerard Le Grellelaan
653,Gerard le Grellelaan 10,2023-07-15,22:00:00,27,20,7,FMN 05 Gerard Le Grellelaan
653,Gerard le Grellelaan 10,2023-07-15,23:00:00,17,12,5,FMN 05 Gerard Le Grellelaan
653,Gerard le Grellelaan 10,2023-07-16,00:00:00,19,13,6,FMN 05 Gerard Le Grellelaan
653,Gerard le Grellelaan 10,2023-07-16,01:00:00,17,15,2,FMN 05 Gerard Le Grellelaan
653,Gerard le Grellelaan 10,2023-07-16,02:00:00,14,12,2,FMN 05 Gerard Le Grellelaan
653,Gerard le Grellelaan 10,2023-07-16,03:00:00,12,11,1,FMN 05 Gerard Le Grellelaan
653,Gerard le Grellelaan 10,2023-07-16,04:00:00,9,9,0,FMN 05 Gerard Le Grellelaan
653,Gerard le Grellelaan 10,2023-07-16,05:00:00,1,1,0,FMN 05 Gerard Le Grellelaan
653,Gerard le Grellelaan 10,2023-07-16,06:00:00,5,4,1,FMN 05 Gerard Le Grellelaan
653,Gerard le Grellelaan 10,2023-07-16,07:00:00,3,3,0,FMN 05 Gerard Le Grellelaan
653,Gerard le Grellelaan 10,2023-07-16,08:00:00,6,4,2,FMN 05 Gerard Le Grellelaan
653,Gerard le Grellelaan 10,2023-07-16,09:00:00,13,11,2,FMN 05 Gerard Le Grellelaan
653,Gerard le Grellelaan 10,2023-07-16,10:00:00,20,16,4,FMN 05 Gerard Le Grellelaan
653,Gerard le Grellelaan 10,2023-07-16,11:00:00,29,23,6,FMN 05 Gerard Le Grellelaan
653,Gerard le Grellelaan 10,2023-07-16,12:00:00,23,20,3,FMN 05 Gerard Le Grellelaan
653,Gerard le Grellelaan 10,2023-07-16,13:00:00,12,9,3,FMN 05 Gerard Le Grellelaan
653,Gerard le Grellelaan 10,2023-07-16,14:00:00,3,2,1,FMN 05 Gerard Le Grellelaan
653,Gerard le Grellelaan 10,2023-07-16,15:00:00,8,5,3,FMN 05 Gerard Le Grellelaan
653,Gerard le Grellelaan 10,2023-07-16,16:00:00,51,44,7,FMN 05 Gerard Le Grellelaan
653,Gerard le Grellelaan 10,2023-07-16,17:00:00,61,49,12,FMN 05 Gerard Le Grellelaan
653,Gerard le Grellelaan 10,2023-07-16,18:00:00,1,1,0,FMN 05 Gerard Le Grellelaan
653,Gerard le Grellelaan 10,2023-07-16,19:00:00,0,0,0,FMN 05 Gerard Le Grellelaan
653,Gerard le Grellelaan 10,2023-07-16,20:00:00,25,23,2,FMN 05 Gerard Le Grellelaan
653,Gerard le Grellelaan 10,2023-07-16,21:00:00,27,22,5,FMN 05 Gerard Le Grellelaan
653,Gerard le Grellelaan 10,2023-07-16,22:00:00,36,28,8,FMN 05 Gerard Le Grellelaan
653,Gerard le Grellelaan 10,2023-07-16,23:00:00,16,11,5,FMN 05 Gerard Le Grellelaan
653,Gerard le Grellelaan 10,2023-07-17,00:00:00,6,5,1,FMN 05 Gerard Le Grellelaan
653,Gerard le Grellelaan 10,2023-07-17,01:00:00,4,3,1,FMN 05 Gerard Le Grellelaan
653,Gerard le Grellelaan 10,2023-07-17,02:00:00,2,2,0,FMN 05 Gerard Le Grellelaan
653,Gerard le Grellelaan 10,2023-07-17,03:00:00,0,0,0,FMN 05 Gerard Le Grellelaan
653,Gerard le Grellelaan 10,2023-07-17,04:00:00,6,2,4,FMN 05 Gerard Le Grellelaan
653,Gerard le Grellelaan 10,2023-07-17,05:00:00,24,11,13,FMN 05 Gerard Le Grellelaan
653,Gerard le Grellelaan 10,2023-07-17,06:00:00,43,21,22,FMN 05 Gerard Le Grellelaan
653,Gerard le Grellelaan 10,2023-07-17,07:00:00,14,8,6,FMN 05 Gerard Le Grellelaan
653,Gerard le Grellelaan 10,2023-07-17,08:00:00,35,31,4,FMN 05 Gerard Le Grellelaan
653,Gerard le Grellelaan 10,2023-07-17,09:00:00,48,40,8,FMN 05 Gerard Le Grellelaan
653,Gerard le Grellelaan 10,2023-07-17,10:00:00,39,31,8,FMN 05 Gerard Le Grellelaan
653,Gerard le Grellelaan 10,2023-07-17,11:00:00,30,27,3,FMN 05 Gerard Le Grellelaan
653,Gerard le Grellelaan 10,2023-07-17,12:00:00,22,18,4,FMN 05 Gerard Le Grellelaan
653,Gerard le Grellelaan 10,2023-07-17,13:00:00,31,22,9,FMN 05 Gerard Le Grellelaan
653,Gerard le Grellelaan 10,2023-07-17,14:00:00,36,29,7,FMN 05 Gerard Le Grellelaan
653,Gerard le Grellelaan 10,2023-07-17,15:00:00,71,60,11,FMN 05 Gerard Le Grellelaan
653,Gerard le Grellelaan 10,2023-07-17,16:00:00,65,54,11,FMN 05 Gerard Le Grellelaan
653,Gerard le Grellelaan 10,2023-07-17,17:00:00,0,0,0,FMN 05 Gerard Le Grellelaan
653,Gerard le Grellelaan 10,2023-07-17,18:00:00,55,39,16,FMN 05 Gerard Le Grellelaan
653,Gerard le Grellelaan 10,2023-07-17,19:00:00,64,51,13,FMN 05 Gerard Le Grellelaan
653,Gerard le Grellelaan 10,2023-07-17,20:00:00,41,35,6,FMN 05 Gerard Le Grellelaan
653,Gerard le Grellelaan 10,2023-07-17,21:00:00,51,42,9,FMN 05 Gerard Le Grellelaan
653,Gerard le Grellelaan 10,2023-07-17,22:00:00,52,48,4,FMN 05 Gerard Le Grellelaan
653,Gerard le Grellelaan 10,2023-07-17,23:00:00,26,25,1,FMN 05 Gerard Le Grellelaan
653,Gerard le Grellelaan 10,2023-07-18,00:00:00,10,8,2,FMN 05 Gerard Le Grellelaan
653,Gerard le Grellelaan 10,2023-07-18,01:00:00,4,0,4,FMN 05 Gerard Le Grellelaan
653,Gerard le Grellelaan 10,2023-07-18,02:00:00,3,2,1,FMN 05 Gerard Le Grellelaan
653,Gerard le Grellelaan 10,2023-07-18,03:00:00,3,3,0,FMN 05 Gerard Le Grellelaan
653,Gerard le Grellelaan 10,2023-07-18,04:00:00,3,2,1,FMN 05 Gerard Le Grellelaan
653,Gerard le Grellelaan 10,2023-07-18,05:00:00,24,7,17,FMN 05 Gerard Le Grellelaan
653,Gerard le Grellelaan 10,2023-07-18,06:00:00,50,26,24,FMN 05 Gerard Le Grellelaan
653,Gerard le Grellelaan 10,2023-07-18,07:00:00,91,62,29,FMN 05 Gerard Le Grellelaan
653,Gerard le Grellelaan 10,2023-07-18,08:00:00,148,132,16,FMN 05 Gerard Le Grellelaan
653,Gerard le Grellelaan 10,2023-07-18,09:00:00,97,87,10,FMN 05 Gerard Le Grellelaan
653,Gerard le Grellelaan 10,2023-07-18,10:00:00,62,55,7,FMN 05 Gerard Le Grellelaan
653,Gerard le Grellelaan 10,2023-07-18,11:00:00,69,56,13,FMN 05 Gerard Le Grellelaan
653,Gerard le Grellelaan 10,2023-07-18,12:00:00,86,70,16,FMN 05 Gerard Le Grellelaan
653,Gerard le Grellelaan 10,2023-07-18,13:00:00,35,24,11,FMN 05 Gerard Le Grellelaan
653,Gerard le Grellelaan 10,2023-07-18,14:00:00,2,2,0,FMN 05 Gerard Le Grellelaan
653,Gerard le Grellelaan 10,2023-07-18,15:00:00,0,0,0,FMN 05 Gerard Le Grellelaan
653,Gerard le Grellelaan 10,2023-07-18,16:00:00,0,0,0,FMN 05 Gerard Le Grellelaan
653,Gerard le Grellelaan 10,2023-07-18,17:00:00,9,9,0,FMN 05 Gerard Le Grellelaan
653,Gerard le Grellelaan 10,2023-07-18,18:00:00,101,83,18,FMN 05 Gerard Le Grellelaan
653,Gerard le Grellelaan 10,2023-07-18,19:00:00,96,82,14,FMN 05 Gerard Le Grellelaan
653,Gerard le Grellelaan 10,2023-07-18,20:00:00,80,65,15,FMN 05 Gerard Le Grellelaan
653,Gerard le Grellelaan 10,2023-07-18,21:00:00,55,43,12,FMN 05 Gerard Le Grellelaan
653,Gerard le Grellelaan 10,2023-07-18,22:00:00,61,53,8,FMN 05 Gerard Le Grellelaan
653,Gerard le Grellelaan 10,2023-07-18,23:00:00,25,22,3,FMN 05 Gerard Le Grellelaan
653,Gerard le Grellelaan 10,2023-07-19,00:00:00,7,4,3,FMN 05 Gerard Le Grellelaan
653,Gerard le Grellelaan 10,2023-07-19,01:00:00,4,3,1,FMN 05 Gerard Le Grellelaan
653,Gerard le Grellelaan 10,2023-07-19,02:00:00,1,0,1,FMN 05 Gerard Le Grellelaan
653,Gerard le Grellelaan 10,2023-07-19,03:00:00,5,5,0,FMN 05 Gerard Le Grellelaan
653,Gerard le Grellelaan 10,2023-07-19,04:00:00,7,4,3,FMN 05 Gerard Le Grellelaan
653,Gerard le Grellelaan 10,2023-07-19,05:00:00,24,9,15,FMN 05 Gerard Le Grellelaan
653,Gerard le Grellelaan 10,2023-07-19,06:00:00,44,22,22,FMN 05 Gerard Le Grellelaan
653,Gerard le Grellelaan 10,2023-07-19,07:00:00,89,59,30,FMN 05 Gerard Le Grellelaan
653,Gerard le Grellelaan 10,2023-07-19,08:00:00,16,14,2,FMN 05 Gerard Le Grellelaan
653,Gerard le Grellelaan 10,2023-07-19,09:00:00,0,0,0,FMN 05 Gerard Le Grellelaan
653,Gerard le Grellelaan 10,2023-07-19,10:00:00,64,54,10,FMN 05 Gerard Le Grellelaan
653,Gerard le Grellelaan 10,2023-07-19,11:00:00,91,72,19,FMN 05 Gerard Le Grellelaan
653,Gerard le Grellelaan 10,2023-07-19,12:00:00,44,37,7,FMN 05 Gerard Le Grellelaan
653,Gerard le Grellelaan 10,2023-07-19,13:00:00,56,45,11,FMN 05 Gerard Le Grellelaan
653,Gerard le Grellelaan 10,2023-07-19,14:00:00,81,67,14,FMN 05 Gerard Le Grellelaan
653,Gerard le Grellelaan 10,2023-07-19,15:00:00,115,98,17,FMN 05 Gerard Le Grellelaan
653,Gerard le Grellelaan 10,2023-07-19,16:00:00,141,121,20,FMN 05 Gerard Le Grellelaan
653,Gerard le Grellelaan 10,2023-07-19,17:00:00,157,128,29,FMN 05 Gerard Le Grellelaan
653,Gerard le Grellelaan 10,2023-07-19,18:00:00,117,84,33,FMN 05 Gerard Le Grellelaan
653,Gerard le Grellelaan 10,2023-07-19,19:00:00,76,55,21,FMN 05 Gerard Le Grellelaan
653,Gerard le Grellelaan 10,2023-07-19,20:00:00,55,47,8,FMN 05 Gerard Le Grellelaan
653,Gerard le Grellelaan 10,2023-07-19,21:00:00,37,29,8,FMN 05 Gerard Le Grellelaan
653,Gerard le Grellelaan 10,2023-07-19,22:00:00,68,65,3,FMN 05 Gerard Le Grellelaan
653,Gerard le Grellelaan 10,2023-07-19,23:00:00,27,21,6,FMN 05 Gerard Le Grellelaan
653,Gerard le Grellelaan 10,2023-07-20,00:00:00,11,5,6,FMN 05 Gerard Le Grellelaan
653,Gerard le Grellelaan 10,2023-07-20,01:00:00,9,6,3,FMN 05 Gerard Le Grellelaan
653,Gerard le Grellelaan 10,2023-07-20,02:00:00,3,2,1,FMN 05 Gerard Le Grellelaan
653,Gerard le Grellelaan 10,2023-07-20,03:00:00,3,3,0,FMN 05 Gerard Le Grellelaan
653,Gerard le Grellelaan 10,2023-07-20,04:00:00,1,0,1,FMN 05 Gerard Le Grellelaan
653,Gerard le Grellelaan 10,2023-07-20,05:00:00,24,6,18,FMN 05 Gerard Le Grellelaan
653,Gerard le Grellelaan 10,2023-07-20,06:00:00,34,17,17,FMN 05 Gerard Le Grellelaan
653,Gerard le Grellelaan 10,2023-07-20,07:00:00,88,67,21,FMN 05 Gerard Le Grellelaan
653,Gerard le Grellelaan 10,2023-07-20,08:00:00,134,111,23,FMN 05 Gerard Le Grellelaan
653,Gerard le Grellelaan 10,2023-07-20,09:00:00,72,64,8,FMN 05 Gerard Le Grellelaan
653,Gerard le Grellelaan 10,2023-07-20,10:00:00,51,42,9,FMN 05 Gerard Le Grellelaan
653,Gerard le Grellelaan 10,2023-07-20,11:00:00,64,46,18,FMN 05 Gerard Le Grellelaan
653,Gerard le Grellelaan 10,2023-07-20,12:00:00,103,83,20,FMN 05 Gerard Le Grellelaan
653,Gerard le Grellelaan 10,2023-07-20,13:00:00,63,50,13,FMN 05 Gerard Le Grellelaan
653,Gerard le Grellelaan 10,2023-07-20,14:00:00,79,65,14,FMN 05 Gerard Le Grellelaan
653,Gerard le Grellelaan 10,2023-07-20,15:00:00,102,92,10,FMN 05 Gerard Le Grellelaan
653,Gerard le Grellelaan 10,2023-07-20,16:00:00,136,110,26,FMN 05 Gerard Le Grellelaan
653,Gerard le Grellelaan 10,2023-07-20,17:00:00,149,121,28,FMN 05 Gerard Le Grellelaan
653,Gerard le Grellelaan 10,2023-07-20,18:00:00,91,76,15,FMN 05 Gerard Le Grellelaan
653,Gerard le Grellelaan 10,2023-07-20,19:00:00,66,55,11,FMN 05 Gerard Le Grellelaan
653,Gerard le Grellelaan 10,2023-07-20,20:00:00,63,54,9,FMN 05 Gerard Le Grellelaan
653,Gerard le Grellelaan 10,2023-07-20,21:00:00,33,28,5,FMN 05 Gerard Le Grellelaan
653,Gerard le Grellelaan 10,2023-07-20,22:00:00,41,32,9,FMN 05 Gerard Le Grellelaan
653,Gerard le Grellelaan 10,2023-07-20,23:00:00,20,18,2,FMN 05 Gerard Le Grellelaan
653,Gerard le Grellelaan 10,2023-07-21,00:00:00,18,13,5,FMN 05 Gerard Le Grellelaan
653,Gerard le Grellelaan 10,2023-07-21,01:00:00,9,8,1,FMN 05 Gerard Le Grellelaan
653,Gerard le Grellelaan 10,2023-07-21,02:00:00,2,0,2,FMN 05 Gerard Le Grellelaan
653,Gerard le Grellelaan 10,2023-07-21,03:00:00,2,1,1,FMN 05 Gerard Le Grellelaan
653,Gerard le Grellelaan 10,2023-07-21,04:00:00,6,4,2,FMN 05 Gerard Le Grellelaan
653,Gerard le Grellelaan 10,2023-07-21,05:00:00,4,2,2,FMN 05 Gerard Le Grellelaan
653,Gerard le Grellelaan 10,2023-07-21,06:00:00,11,8,3,FMN 05 Gerard Le Grellelaan
653,Gerard le Grellelaan 10,2023-07-21,07:00:00,6,6,0,FMN 05 Gerard Le Grellelaan
653,Gerard le Grellelaan 10,2023-07-21,08:00:00,25,16,9,FMN 05 Gerard Le Grellelaan
653,Gerard le Grellelaan 10,2023-07-21,09:00:00,35,30,5,FMN 05 Gerard Le Grellelaan
653,Gerard le Grellelaan 10,2023-07-21,10:00:00,48,41,7,FMN 05 Gerard Le Grellelaan
653,Gerard le Grellelaan 10,2023-07-21,11:00:00,49,46,3,FMN 05 Gerard Le Grellelaan
653,Gerard le Grellelaan 10,2023-07-21,12:00:00,8,7,1,FMN 05 Gerard Le Grellelaan
653,Gerard le Grellelaan 10,2023-07-21,13:00:00,0,0,0,FMN 05 Gerard Le Grellelaan
653,Gerard le Grellelaan 10,2023-07-21,14:00:00,10,6,4,FMN 05 Gerard Le Grellelaan
653,Gerard le Grellelaan 10,2023-07-21,15:00:00,45,38,7,FMN 05 Gerard Le Grellelaan
653,Gerard le Grellelaan 10,2023-07-21,16:00:00,32,23,9,FMN 05 Gerard Le Grellelaan
653,Gerard le Grellelaan 10,2023-07-21,17:00:00,47,36,11,FMN 05 Gerard Le Grellelaan
653,Gerard le Grellelaan 10,2023-07-21,18:00:00,55,48,7,FMN 05 Gerard Le Grellelaan
653,Gerard le Grellelaan 10,2023-07-21,19:00:00,42,35,7,FMN 05 Gerard Le Grellelaan
653,Gerard le Grellelaan 10,2023-07-21,20:00:00,48,42,6,FMN 05 Gerard Le Grellelaan
653,Gerard le Grellelaan 10,2023-07-21,21:00:00,34,28,6,FMN 05 Gerard Le Grellelaan
653,Gerard le Grellelaan 10,2023-07-21,22:00:00,29,22,7,FMN 05 Gerard Le Grellelaan
653,Gerard le Grellelaan 10,2023-07-21,23:00:00,19,15,4,FMN 05 Gerard Le Grellelaan
653,Gerard le Grellelaan 10,2023-07-22,00:00:00,14,9,5,FMN 05 Gerard Le Grellelaan
653,Gerard le Grellelaan 10,2023-07-22,01:00:00,14,13,1,FMN 05 Gerard Le Grellelaan
653,Gerard le Grellelaan 10,2023-07-22,02:00:00,6,6,0,FMN 05 Gerard Le Grellelaan
653,Gerard le Grellelaan 10,2023-07-22,03:00:00,5,4,1,FMN 05 Gerard Le Grellelaan
653,Gerard le Grellelaan 10,2023-07-22,04:00:00,3,2,1,FMN 05 Gerard Le Grellelaan
653,Gerard le Grellelaan 10,2023-07-22,05:00:00,4,4,0,FMN 05 Gerard Le Grellelaan
653,Gerard le Grellelaan 10,2023-07-22,06:00:00,11,8,3,FMN 05 Gerard Le Grellelaan
653,Gerard le Grellelaan 10,2023-07-22,07:00:00,13,10,3,FMN 05 Gerard Le Grellelaan
653,Gerard le Grellelaan 10,2023-07-22,08:00:00,30,19,11,FMN 05 Gerard Le Grellelaan
653,Gerard le Grellelaan 10,2023-07-22,09:00:00,44,38,6,FMN 05 Gerard Le Grellelaan
653,Gerard le Grellelaan 10,2023-07-22,10:00:00,40,31,9,FMN 05 Gerard Le Grellelaan
653,Gerard le Grellelaan 10,2023-07-22,11:00:00,44,39,5,FMN 05 Gerard Le Grellelaan
653,Gerard le Grellelaan 10,2023-07-22,12:00:00,43,39,4,FMN 05 Gerard Le Grellelaan
653,Gerard le Grellelaan 10,2023-07-22,13:00:00,16,13,3,FMN 05 Gerard Le Grellelaan
653,Gerard le Grellelaan 10,2023-07-22,14:00:00,16,13,3,FMN 05 Gerard Le Grellelaan
653,Gerard le Grellelaan 10,2023-07-22,15:00:00,40,32,8,FMN 05 Gerard Le Grellelaan
653,Gerard le Grellelaan 10,2023-07-22,16:00:00,40,34,6,FMN 05 Gerard Le Grellelaan
653,Gerard le Grellelaan 10,2023-07-22,17:00:00,57,45,12,FMN 05 Gerard Le Grellelaan
653,Gerard le Grellelaan 10,2023-07-22,18:00:00,46,33,13,FMN 05 Gerard Le Grellelaan
653,Gerard le Grellelaan 10,2023-07-22,19:00:00,41,29,12,FMN 05 Gerard Le Grellelaan
653,Gerard le Grellelaan 10,2023-07-22,20:00:00,25,18,7,FMN 05 Gerard Le Grellelaan
653,Gerard le Grellelaan 10,2023-07-22,21:00:00,28,28,0,FMN 05 Gerard Le Grellelaan
653,Gerard le Grellelaan 10,2023-07-22,22:00:00,20,14,6,FMN 05 Gerard Le Grellelaan
653,Gerard le Grellelaan 10,2023-07-22,23:00:00,16,15,1,FMN 05 Gerard Le Grellelaan
653,Gerard le Grellelaan 10,2023-07-23,00:00:00,13,9,4,FMN 05 Gerard Le Grellelaan
653,Gerard le Grellelaan 10,2023-07-23,01:00:00,16,8,8,FMN 05 Gerard Le Grellelaan
653,Gerard le Grellelaan 10,2023-07-23,02:00:00,8,7,1,FMN 05 Gerard Le Grellelaan
653,Gerard le Grellelaan 10,2023-07-23,03:00:00,4,2,2,FMN 05 Gerard Le Grellelaan
653,Gerard le Grellelaan 10,2023-07-23,04:00:00,2,2,0,FMN 05 Gerard Le Grellelaan
653,Gerard le Grellelaan 10,2023-07-23,05:00:00,3,3,0,FMN 05 Gerard Le Grellelaan
653,Gerard le Grellelaan 10,2023-07-23,06:00:00,4,1,3,FMN 05 Gerard Le Grellelaan
653,Gerard le Grellelaan 10,2023-07-23,07:00:00,4,4,0,FMN 05 Gerard Le Grellelaan
653,Gerard le Grellelaan 10,2023-07-23,08:00:00,1,1,0,FMN 05 Gerard Le Grellelaan
653,Gerard le Grellelaan 10,2023-07-23,09:00:00,10,9,1,FMN 05 Gerard Le Grellelaan
653,Gerard le Grellelaan 10,2023-07-23,10:00:00,12,9,3,FMN 05 Gerard Le Grellelaan
653,Gerard le Grellelaan 10,2023-07-23,11:00:00,18,14,4,FMN 05 Gerard Le Grellelaan
653,Gerard le Grellelaan 10,2023-07-23,12:00:00,38,31,7,FMN 05 Gerard Le Grellelaan
653,Gerard le Grellelaan 10,2023-07-23,13:00:00,47,38,9,FMN 05 Gerard Le Grellelaan
653,Gerard le Grellelaan 10,2023-07-23,14:00:00,44,39,5,FMN 05 Gerard Le Grellelaan
653,Gerard le Grellelaan 10,2023-07-23,15:00:00,31,25,6,FMN 05 Gerard Le Grellelaan
653,Gerard le Grellelaan 10,2023-07-23,16:00:00,25,15,10,FMN 05 Gerard Le Grellelaan
653,Gerard le Grellelaan 10,2023-07-23,17:00:00,2,2,0,FMN 05 Gerard Le Grellelaan
653,Gerard le Grellelaan 10,2023-07-23,18:00:00,0,0,0,FMN 05 Gerard Le Grellelaan
653,Gerard le Grellelaan 10,2023-07-23,19:00:00,15,7,8,FMN 05 Gerard Le Grellelaan
653,Gerard le Grellelaan 10,2023-07-23,20:00:00,22,20,2,FMN 05 Gerard Le Grellelaan
653,Gerard le Grellelaan 10,2023-07-23,21:00:00,9,7,2,FMN 05 Gerard Le Grellelaan
653,Gerard le Grellelaan 10,2023-07-23,22:00:00,14,12,2,FMN 05 Gerard Le Grellelaan
653,Gerard le Grellelaan 10,2023-07-23,23:00:00,13,9,4,FMN 05 Gerard Le Grellelaan
653,Gerard le Grellelaan 10,2023-07-24,00:00:00,3,1,2,FMN 05 Gerard Le Grellelaan
653,Gerard le Grellelaan 10,2023-07-24,01:00:00,5,4,1,FMN 05 Gerard Le Grellelaan
653,Gerard le Grellelaan 10,2023-07-24,02:00:00,2,1,1,FMN 05 Gerard Le Grellelaan
653,Gerard le Grellelaan 10,2023-07-24,03:00:00,2,2,0,FMN 05 Gerard Le Grellelaan
653,Gerard le Grellelaan 10,2023-07-24,04:00:00,5,3,2,FMN 05 Gerard Le Grellelaan
653,Gerard le Grellelaan 10,2023-07-24,05:00:00,15,4,11,FMN 05 Gerard Le Grellelaan
653,Gerard le Grellelaan 10,2023-07-24,06:00:00,33,21,12,FMN 05 Gerard Le Grellelaan
653,Gerard le Grellelaan 10,2023-07-24,07:00:00,60,46,14,FMN 05 Gerard Le Grellelaan
653,Gerard le Grellelaan 10,2023-07-24,08:00:00,100,79,21,FMN 05 Gerard Le Grellelaan
653,Gerard le Grellelaan 10,2023-07-24,09:00:00,49,43,6,FMN 05 Gerard Le Grellelaan
653,Gerard le Grellelaan 10,2023-07-24,10:00:00,27,20,7,FMN 05 Gerard Le Grellelaan
653,Gerard le Grellelaan 10,2023-07-24,11:00:00,32,27,5,FMN 05 Gerard Le Grellelaan
653,Gerard le Grellelaan 10,2023-07-24,12:00:00,60,48,12,FMN 05 Gerard Le Grellelaan
653,Gerard le Grellelaan 10,2023-07-24,13:00:00,16,13,3,FMN 05 Gerard Le Grellelaan
653,Gerard le Grellelaan 10,2023-07-24,14:00:00,23,17,6,FMN 05 Gerard Le Grellelaan
653,Gerard le Grellelaan 10,2023-07-24,15:00:00,0,0,0,FMN 05 Gerard Le Grellelaan
653,Gerard le Grellelaan 10,2023-07-24,16:00:00,8,6,2,FMN 05 Gerard Le Grellelaan
653,Gerard le Grellelaan 10,2023-07-24,17:00:00,75,63,12,FMN 05 Gerard Le Grellelaan
653,Gerard le Grellelaan 10,2023-07-24,18:00:00,51,39,12,FMN 05 Gerard Le Grellelaan
653,Gerard le Grellelaan 10,2023-07-24,19:00:00,62,51,11,FMN 05 Gerard Le Grellelaan
653,Gerard le Grellelaan 10,2023-07-24,20:00:00,36,30,6,FMN 05 Gerard Le Grellelaan
653,Gerard le Grellelaan 10,2023-07-24,21:00:00,19,14,5,FMN 05 Gerard Le Grellelaan
653,Gerard le Grellelaan 10,2023-07-24,22:00:00,31,30,1,FMN 05 Gerard Le Grellelaan
653,Gerard le Grellelaan 10,2023-07-24,23:00:00,11,7,4,FMN 05 Gerard Le Grellelaan
653,Gerard le Grellelaan 10,2023-07-25,00:00:00,6,2,4,FMN 05 Gerard Le Grellelaan
653,Gerard le Grellelaan 10,2023-07-25,01:00:00,3,2,1,FMN 05 Gerard Le Grellelaan
653,Gerard le Grellelaan 10,2023-07-25,02:00:00,2,2,0,FMN 05 Gerard Le Grellelaan
653,Gerard le Grellelaan 10,2023-07-25,03:00:00,3,2,1,FMN 05 Gerard Le Grellelaan
653,Gerard le Grellelaan 10,2023-07-25,04:00:00,9,4,5,FMN 05 Gerard Le Grellelaan
653,Gerard le Grellelaan 10,2023-07-25,05:00:00,24,9,15,FMN 05 Gerard Le Grellelaan
653,Gerard le Grellelaan 10,2023-07-25,06:00:00,33,20,13,FMN 05 Gerard Le Grellelaan
653,Gerard le Grellelaan 10,2023-07-25,07:00:00,97,67,30,FMN 05 Gerard Le Grellelaan
653,Gerard le Grellelaan 10,2023-07-25,08:00:00,97,78,19,FMN 05 Gerard Le Grellelaan
653,Gerard le Grellelaan 10,2023-07-25,09:00:00,58,51,7,FMN 05 Gerard Le Grellelaan
653,Gerard le Grellelaan 10,2023-07-25,10:00:00,9,9,0,FMN 05 Gerard Le Grellelaan
653,Gerard le Grellelaan 10,2023-07-25,11:00:00,56,52,4,FMN 05 Gerard Le Grellelaan
653,Gerard le Grellelaan 10,2023-07-25,12:00:00,56,42,14,FMN 05 Gerard Le Grellelaan
653,Gerard le Grellelaan 10,2023-07-25,13:00:00,63,50,13,FMN 05 Gerard Le Grellelaan
653,Gerard le Grellelaan 10,2023-07-25,14:00:00,63,51,12,FMN 05 Gerard Le Grellelaan
653,Gerard le Grellelaan 10,2023-07-25,15:00:00,30,23,7,FMN 05 Gerard Le Grellelaan
653,Gerard le Grellelaan 10,2023-07-25,16:00:00,103,88,15,FMN 05 Gerard Le Grellelaan
653,Gerard le Grellelaan 10,2023-07-25,17:00:00,80,65,15,FMN 05 Gerard Le Grellelaan
653,Gerard le Grellelaan 10,2023-07-25,18:00:00,0,0,0,FMN 05 Gerard Le Grellelaan
653,Gerard le Grellelaan 10,2023-07-25,19:00:00,0,0,0,FMN 05 Gerard Le Grellelaan
653,Gerard le Grellelaan 10,2023-07-25,20:00:00,0,0,0,FMN 05 Gerard Le Grellelaan
653,Gerard le Grellelaan 10,2023-07-25,21:00:00,0,0,0,FMN 05 Gerard Le Grellelaan
653,Gerard le Grellelaan 10,2023-07-25,22:00:00,0,0,0,FMN 05 Gerard Le Grellelaan
653,Gerard le Grellelaan 10,2023-07-25,23:00:00,0,0,0,FMN 05 Gerard Le Grellelaan
653,Gerard le Grellelaan 10,2023-07-26,00:00:00,0,0,0,FMN 05 Gerard Le Grellelaan
653,Gerard le Grellelaan 10,2023-07-26,01:00:00,0,0,0,FMN 05 Gerard Le Grellelaan
653,Gerard le Grellelaan 10,2023-07-26,02:00:00,0,0,0,FMN 05 Gerard Le Grellelaan
653,Gerard le Grellelaan 10,2023-07-26,03:00:00,0,0,0,FMN 05 Gerard Le Grellelaan
653,Gerard le Grellelaan 10,2023-07-26,04:00:00,0,0,0,FMN 05 Gerard Le Grellelaan
653,Gerard le Grellelaan 10,2023-07-26,05:00:00,0,0,0,FMN 05 Gerard Le Grellelaan
653,Gerard le Grellelaan 10,2023-07-26,06:00:00,0,0,0,FMN 05 Gerard Le Grellelaan
653,Gerard le Grellelaan 10,2023-07-26,07:00:00,0,0,0,FMN 05 Gerard Le Grellelaan
653,Gerard le Grellelaan 10,2023-07-26,08:00:00,0,0,0,FMN 05 Gerard Le Grellelaan
653,Gerard le Grellelaan 10,2023-07-26,09:00:00,0,0,0,FMN 05 Gerard Le Grellelaan
653,Gerard le Grellelaan 10,2023-07-26,10:00:00,0,0,0,FMN 05 Gerard Le Grellelaan
653,Gerard le Grellelaan 10,2023-07-26,11:00:00,0,0,0,FMN 05 Gerard Le Grellelaan
653,Gerard le Grellelaan 10,2023-07-26,12:00:00,0,0,0,FMN 05 Gerard Le Grellelaan
653,Gerard le Grellelaan 10,2023-07-26,13:00:00,71,55,16,FMN 05 Gerard Le Grellelaan
653,Gerard le Grellelaan 10,2023-07-26,14:00:00,104,84,20,FMN 05 Gerard Le Grellelaan
653,Gerard le Grellelaan 10,2023-07-26,15:00:00,98,80,18,FMN 05 Gerard Le Grellelaan
653,Gerard le Grellelaan 10,2023-07-26,16:00:00,183,161,22,FMN 05 Gerard Le Grellelaan
653,Gerard le Grellelaan 10,2023-07-26,17:00:00,189,168,21,FMN 05 Gerard Le Grellelaan
653,Gerard le Grellelaan 10,2023-07-26,18:00:00,142,118,24,FMN 05 Gerard Le Grellelaan
653,Gerard le Grellelaan 10,2023-07-26,19:00:00,89,63,26,FMN 05 Gerard Le Grellelaan
653,Gerard le Grellelaan 10,2023-07-26,20:00:00,80,64,16,FMN 05 Gerard Le Grellelaan
653,Gerard le Grellelaan 10,2023-07-26,21:00:00,60,51,9,FMN 05 Gerard Le Grellelaan
653,Gerard le Grellelaan 10,2023-07-26,22:00:00,9,5,4,FMN 05 Gerard Le Grellelaan
653,Gerard le Grellelaan 10,2023-07-26,23:00:00,16,11,5,FMN 05 Gerard Le Grellelaan
653,Gerard le Grellelaan 10,2023-07-27,00:00:00,1,0,1,FMN 05 Gerard Le Grellelaan
653,Gerard le Grellelaan 10,2023-07-27,01:00:00,0,0,0,FMN 05 Gerard Le Grellelaan
653,Gerard le Grellelaan 10,2023-07-27,02:00:00,0,0,0,FMN 05 Gerard Le Grellelaan
653,Gerard le Grellelaan 10,2023-07-27,03:00:00,2,2,0,FMN 05 Gerard Le Grellelaan
653,Gerard le Grellelaan 10,2023-07-27,04:00:00,9,6,3,FMN 05 Gerard Le Grellelaan
653,Gerard le Grellelaan 10,2023-07-27,05:00:00,18,9,9,FMN 05 Gerard Le Grellelaan
653,Gerard le Grellelaan 10,2023-07-27,06:00:00,27,18,9,FMN 05 Gerard Le Grellelaan
653,Gerard le Grellelaan 10,2023-07-27,07:00:00,54,41,13,FMN 05 Gerard Le Grellelaan
653,Gerard le Grellelaan 10,2023-07-27,08:00:00,33,29,4,FMN 05 Gerard Le Grellelaan
653,Gerard le Grellelaan 10,2023-07-27,09:00:00,6,5,1,FMN 05 Gerard Le Grellelaan
653,Gerard le Grellelaan 10,2023-07-27,10:00:00,11,9,2,FMN 05 Gerard Le Grellelaan
653,Gerard le Grellelaan 10,2023-07-27,11:00:00,29,24,5,FMN 05 Gerard Le Grellelaan
653,Gerard le Grellelaan 10,2023-07-27,12:00:00,29,22,7,FMN 05 Gerard Le Grellelaan
653,Gerard le Grellelaan 10,2023-07-27,13:00:00,42,35,7,FMN 05 Gerard Le Grellelaan
653,Gerard le Grellelaan 10,2023-07-27,14:00:00,26,19,7,FMN 05 Gerard Le Grellelaan
653,Gerard le Grellelaan 10,2023-07-27,15:00:00,23,20,3,FMN 05 Gerard Le Grellelaan
653,Gerard le Grellelaan 10,2023-07-27,16:00:00,26,24,2,FMN 05 Gerard Le Grellelaan
653,Gerard le Grellelaan 10,2023-07-27,17:00:00,17,13,4,FMN 05 Gerard Le Grellelaan
653,Gerard le Grellelaan 10,2023-07-27,18:00:00,10,8,2,FMN 05 Gerard Le Grellelaan
653,Gerard le Grellelaan 10,2023-07-27,19:00:00,26,20,6,FMN 05 Gerard Le Grellelaan
653,Gerard le Grellelaan 10,2023-07-27,20:00:00,22,19,3,FMN 05 Gerard Le Grellelaan
653,Gerard le Grellelaan 10,2023-07-27,21:00:00,22,16,6,FMN 05 Gerard Le Grellelaan
653,Gerard le Grellelaan 10,2023-07-27,22:00:00,25,22,3,FMN 05 Gerard Le Grellelaan
653,Gerard le Grellelaan 10,2023-07-27,23:00:00,17,13,4,FMN 05 Gerard Le Grellelaan
653,Gerard le Grellelaan 10,2023-07-28,00:00:00,2,1,1,FMN 05 Gerard Le Grellelaan
653,Gerard le Grellelaan 10,2023-07-28,01:00:00,3,1,2,FMN 05 Gerard Le Grellelaan
653,Gerard le Grellelaan 10,2023-07-28,02:00:00,0,0,0,FMN 05 Gerard Le Grellelaan
653,Gerard le Grellelaan 10,2023-07-28,03:00:00,0,0,0,FMN 05 Gerard Le Grellelaan
653,Gerard le Grellelaan 10,2023-07-28,04:00:00,2,2,0,FMN 05 Gerard Le Grellelaan
653,Gerard le Grellelaan 10,2023-07-28,05:00:00,0,0,0,FMN 05 Gerard Le Grellelaan
653,Gerard le Grellelaan 10,2023-07-28,06:00:00,0,0,0,FMN 05 Gerard Le Grellelaan
653,Gerard le Grellelaan 10,2023-07-28,07:00:00,0,0,0,FMN 05 Gerard Le Grellelaan
653,Gerard le Grellelaan 10,2023-07-28,08:00:00,0,0,0,FMN 05 Gerard Le Grellelaan
653,Gerard le Grellelaan 10,2023-07-28,09:00:00,0,0,0,FMN 05 Gerard Le Grellelaan
653,Gerard le Grellelaan 10,2023-07-28,10:00:00,0,0,0,FMN 05 Gerard Le Grellelaan
653,Gerard le Grellelaan 10,2023-07-28,11:00:00,0,0,0,FMN 05 Gerard Le Grellelaan
653,Gerard le Grellelaan 10,2023-07-28,12:00:00,0,0,0,FMN 05 Gerard Le Grellelaan
653,Gerard le Grellelaan 10,2023-07-28,13:00:00,83,65,18,FMN 05 Gerard Le Grellelaan
653,Gerard le Grellelaan 10,2023-07-28,14:00:00,77,65,12,FMN 05 Gerard Le Grellelaan
653,Gerard le Grellelaan 10,2023-07-28,15:00:00,103,80,23,FMN 05 Gerard Le Grellelaan
653,Gerard le Grellelaan 10,2023-07-28,16:00:00,114,95,19,FMN 05 Gerard Le Grellelaan
653,Gerard le Grellelaan 10,2023-07-28,17:00:00,120,99,21,FMN 05 Gerard Le Grellelaan
653,Gerard le Grellelaan 10,2023-07-28,18:00:00,104,86,18,FMN 05 Gerard Le Grellelaan
653,Gerard le Grellelaan 10,2023-07-28,19:00:00,83,67,16,FMN 05 Gerard Le Grellelaan
653,Gerard le Grellelaan 10,2023-07-28,20:00:00,49,43,6,FMN 05 Gerard Le Grellelaan
653,Gerard le Grellelaan 10,2023-07-28,21:00:00,33,29,4,FMN 05 Gerard Le Grellelaan
653,Gerard le Grellelaan 10,2023-07-28,22:00:00,43,34,9,FMN 05 Gerard Le Grellelaan
653,Gerard le Grellelaan 10,2023-07-28,23:00:00,27,22,5,FMN 05 Gerard Le Grellelaan
653,Gerard le Grellelaan 10,2023-07-29,00:00:00,17,14,3,FMN 05 Gerard Le Grellelaan
653,Gerard le Grellelaan 10,2023-07-29,01:00:00,6,6,0,FMN 05 Gerard Le Grellelaan
653,Gerard le Grellelaan 10,2023-07-29,02:00:00,13,8,5,FMN 05 Gerard Le Grellelaan
653,Gerard le Grellelaan 10,2023-07-29,03:00:00,9,9,0,FMN 05 Gerard Le Grellelaan
653,Gerard le Grellelaan 10,2023-07-29,04:00:00,2,1,1,FMN 05 Gerard Le Grellelaan
653,Gerard le Grellelaan 10,2023-07-29,05:00:00,7,7,0,FMN 05 Gerard Le Grellelaan
653,Gerard le Grellelaan 10,2023-07-29,06:00:00,13,8,5,FMN 05 Gerard Le Grellelaan
653,Gerard le Grellelaan 10,2023-07-29,07:00:00,12,12,0,FMN 05 Gerard Le Grellelaan
653,Gerard le Grellelaan 10,2023-07-29,08:00:00,29,24,5,FMN 05 Gerard Le Grellelaan
653,Gerard le Grellelaan 10,2023-07-29,09:00:00,40,36,4,FMN 05 Gerard Le Grellelaan
653,Gerard le Grellelaan 10,2023-07-29,10:00:00,12,11,1,FMN 05 Gerard Le Grellelaan
653,Gerard le Grellelaan 10,2023-07-29,11:00:00,0,0,0,FMN 05 Gerard Le Grellelaan
653,Gerard le Grellelaan 10,2023-07-29,12:00:00,0,0,0,FMN 05 Gerard Le Grellelaan
653,Gerard le Grellelaan 10,2023-07-29,13:00:00,10,8,2,FMN 05 Gerard Le Grellelaan
653,Gerard le Grellelaan 10,2023-07-29,14:00:00,0,0,0,FMN 05 Gerard Le Grellelaan
653,Gerard le Grellelaan 10,2023-07-29,15:00:00,8,7,1,FMN 05 Gerard Le Grellelaan
653,Gerard le Grellelaan 10,2023-07-29,16:00:00,45,34,11,FMN 05 Gerard Le Grellelaan
653,Gerard le Grellelaan 10,2023-07-29,17:00:00,60,52,8,FMN 05 Gerard Le Grellelaan
653,Gerard le Grellelaan 10,2023-07-29,18:00:00,32,23,9,FMN 05 Gerard Le Grellelaan
653,Gerard le Grellelaan 10,2023-07-29,19:00:00,23,19,4,FMN 05 Gerard Le Grellelaan
653,Gerard le Grellelaan 10,2023-07-29,20:00:00,0,0,0,FMN 05 Gerard Le Grellelaan
653,Gerard le Grellelaan 10,2023-07-29,21:00:00,0,0,0,FMN 05 Gerard Le Grellelaan
653,Gerard le Grellelaan 10,2023-07-29,22:00:00,13,9,4,FMN 05 Gerard Le Grellelaan
653,Gerard le Grellelaan 10,2023-07-29,23:00:00,16,14,2,FMN 05 Gerard Le Grellelaan
653,Gerard le Grellelaan 10,2023-07-30,00:00:00,13,12,1,FMN 05 Gerard Le Grellelaan
653,Gerard le Grellelaan 10,2023-07-30,01:00:00,6,4,2,FMN 05 Gerard Le Grellelaan
653,Gerard le Grellelaan 10,2023-07-30,02:00:00,13,12,1,FMN 05 Gerard Le Grellelaan
653,Gerard le Grellelaan 10,2023-07-30,03:00:00,3,0,3,FMN 05 Gerard Le Grellelaan
653,Gerard le Grellelaan 10,2023-07-30,04:00:00,1,0,1,FMN 05 Gerard Le Grellelaan
653,Gerard le Grellelaan 10,2023-07-30,05:00:00,0,0,0,FMN 05 Gerard Le Grellelaan
653,Gerard le Grellelaan 10,2023-07-30,06:00:00,10,10,0,FMN 05 Gerard Le Grellelaan
653,Gerard le Grellelaan 10,2023-07-30,07:00:00,7,6,1,FMN 05 Gerard Le Grellelaan
653,Gerard le Grellelaan 10,2023-07-30,08:00:00,16,12,4,FMN 05 Gerard Le Grellelaan
653,Gerard le Grellelaan 10,2023-07-30,09:00:00,17,14,3,FMN 05 Gerard Le Grellelaan
653,Gerard le Grellelaan 10,2023-07-30,10:00:00,20,14,6,FMN 05 Gerard Le Grellelaan
653,Gerard le Grellelaan 10,2023-07-30,11:00:00,24,20,4,FMN 05 Gerard Le Grellelaan
653,Gerard le Grellelaan 10,2023-07-30,12:00:00,48,40,8,FMN 05 Gerard Le Grellelaan
653,Gerard le Grellelaan 10,2023-07-30,13:00:00,26,19,7,FMN 05 Gerard Le Grellelaan
653,Gerard le Grellelaan 10,2023-07-30,14:00:00,39,27,12,FMN 05 Gerard Le Grellelaan
653,Gerard le Grellelaan 10,2023-07-30,15:00:00,28,24,4,FMN 05 Gerard Le Grellelaan
653,Gerard le Grellelaan 10,2023-07-30,16:00:00,10,9,1,FMN 05 Gerard Le Grellelaan
653,Gerard le Grellelaan 10,2023-07-30,17:00:00,46,37,9,FMN 05 Gerard Le Grellelaan
653,Gerard le Grellelaan 10,2023-07-30,18:00:00,23,17,6,FMN 05 Gerard Le Grellelaan
653,Gerard le Grellelaan 10,2023-07-30,19:00:00,0,0,0,FMN 05 Gerard Le Grellelaan
653,Gerard le Grellelaan 10,2023-07-30,20:00:00,10,7,3,FMN 05 Gerard Le Grellelaan
653,Gerard le Grellelaan 10,2023-07-30,21:00:00,8,5,3,FMN 05 Gerard Le Grellelaan
653,Gerard le Grellelaan 10,2023-07-30,22:00:00,5,5,0,FMN 05 Gerard Le Grellelaan
653,Gerard le Grellelaan 10,2023-07-30,23:00:00,8,7,1,FMN 05 Gerard Le Grellelaan
653,Gerard le Grellelaan 10,2023-07-31,00:00:00,4,3,1,FMN 05 Gerard Le Grellelaan
653,Gerard le Grellelaan 10,2023-07-31,01:00:00,6,5,1,FMN 05 Gerard Le Grellelaan
653,Gerard le Grellelaan 10,2023-07-31,02:00:00,3,3,0,FMN 05 Gerard Le Grellelaan
653,Gerard le Grellelaan 10,2023-07-31,03:00:00,1,1,0,FMN 05 Gerard Le Grellelaan
653,Gerard le Grellelaan 10,2023-07-31,04:00:00,3,3,0,FMN 05 Gerard Le Grellelaan
653,Gerard le Grellelaan 10,2023-07-31,05:00:00,0,0,0,FMN 05 Gerard Le Grellelaan
653,Gerard le Grellelaan 10,2023-07-31,06:00:00,3,0,3,FMN 05 Gerard Le Grellelaan
653,Gerard le Grellelaan 10,2023-07-31,07:00:00,0,0,0,FMN 05 Gerard Le Grellelaan
653,Gerard le Grellelaan 10,2023-07-31,08:00:00,31,27,4,FMN 05 Gerard Le Grellelaan
653,Gerard le Grellelaan 10,2023-07-31,09:00:00,14,12,2,FMN 05 Gerard Le Grellelaan
653,Gerard le Grellelaan 10,2023-07-31,10:00:00,13,12,1,FMN 05 Gerard Le Grellelaan
653,Gerard le Grellelaan 10,2023-07-31,11:00:00,20,18,2,FMN 05 Gerard Le Grellelaan
653,Gerard le Grellelaan 10,2023-07-31,12:00:00,40,30,10,FMN 05 Gerard Le Grellelaan
653,Gerard le Grellelaan 10,2023-07-31,13:00:00,1,1,0,FMN 05 Gerard Le Grellelaan
653,Gerard le Grellelaan 10,2023-07-31,14:00:00,18,15,3,FMN 05 Gerard Le Grellelaan
653,Gerard le Grellelaan 10,2023-07-31,15:00:00,18,15,3,FMN 05 Gerard Le Grellelaan
653,Gerard le Grellelaan 10,2023-07-31,16:00:00,42,33,9,FMN 05 Gerard Le Grellelaan
653,Gerard le Grellelaan 10,2023-07-31,17:00:00,23,16,7,FMN 05 Gerard Le Grellelaan
653,Gerard le Grellelaan 10,2023-07-31,18:00:00,45,36,9,FMN 05 Gerard Le Grellelaan
653,Gerard le Grellelaan 10,2023-07-31,19:00:00,18,16,2,FMN 05 Gerard Le Grellelaan
653,Gerard le Grellelaan 10,2023-07-31,20:00:00,29,24,5,FMN 05 Gerard Le Grellelaan
653,Gerard le Grellelaan 10,2023-07-31,21:00:00,8,6,2,FMN 05 Gerard Le Grellelaan
653,Gerard le Grellelaan 10,2023-07-31,22:00:00,29,27,2,FMN 05 Gerard Le Grellelaan
653,Gerard le Grellelaan 10,2023-07-31,23:00:00,12,11,1,FMN 05 Gerard Le Grellelaan
653,Gerard le Grellelaan 10,2023-08-01,00:00:00,6,4,2,FMN 05 Gerard Le Grellelaan
653,Gerard le Grellelaan 10,2023-08-01,01:00:00,3,3,0,FMN 05 Gerard Le Grellelaan
653,Gerard le Grellelaan 10,2023-08-01,02:00:00,5,4,1,FMN 05 Gerard Le Grellelaan
653,Gerard le Grellelaan 10,2023-08-01,03:00:00,1,0,1,FMN 05 Gerard Le Grellelaan
653,Gerard le Grellelaan 10,2023-08-01,04:00:00,7,3,4,FMN 05 Gerard Le Grellelaan
653,Gerard le Grellelaan 10,2023-08-01,05:00:00,14,4,10,FMN 05 Gerard Le Grellelaan
653,Gerard le Grellelaan 10,2023-08-01,06:00:00,32,21,11,FMN 05 Gerard Le Grellelaan
653,Gerard le Grellelaan 10,2023-08-01,07:00:00,21,14,7,FMN 05 Gerard Le Grellelaan
653,Gerard le Grellelaan 10,2023-08-01,08:00:00,68,56,12,FMN 05 Gerard Le Grellelaan
653,Gerard le Grellelaan 10,2023-08-01,09:00:00,37,34,3,FMN 05 Gerard Le Grellelaan
653,Gerard le Grellelaan 10,2023-08-01,10:00:00,44,30,14,FMN 05 Gerard Le Grellelaan
653,Gerard le Grellelaan 10,2023-08-01,11:00:00,30,27,3,FMN 05 Gerard Le Grellelaan
653,Gerard le Grellelaan 10,2023-08-01,12:00:00,20,14,6,FMN 05 Gerard Le Grellelaan
653,Gerard le Grellelaan 10,2023-08-01,13:00:00,76,54,22,FMN 05 Gerard Le Grellelaan
653,Gerard le Grellelaan 10,2023-08-01,14:00:00,47,40,7,FMN 05 Gerard Le Grellelaan
653,Gerard le Grellelaan 10,2023-08-01,15:00:00,0,0,0,FMN 05 Gerard Le Grellelaan
653,Gerard le Grellelaan 10,2023-08-01,16:00:00,100,83,17,FMN 05 Gerard Le Grellelaan
653,Gerard le Grellelaan 10,2023-08-01,17:00:00,118,95,23,FMN 05 Gerard Le Grellelaan
653,Gerard le Grellelaan 10,2023-08-01,18:00:00,26,19,7,FMN 05 Gerard Le Grellelaan
653,Gerard le Grellelaan 10,2023-08-01,19:00:00,69,46,23,FMN 05 Gerard Le Grellelaan
653,Gerard le Grellelaan 10,2023-08-01,20:00:00,46,32,14,FMN 05 Gerard Le Grellelaan
653,Gerard le Grellelaan 10,2023-08-01,21:00:00,44,35,9,FMN 05 Gerard Le Grellelaan
653,Gerard le Grellelaan 10,2023-08-01,22:00:00,45,36,9,FMN 05 Gerard Le Grellelaan
653,Gerard le Grellelaan 10,2023-08-01,23:00:00,18,14,4,FMN 05 Gerard Le Grellelaan
653,Gerard le Grellelaan 10,2023-08-02,00:00:00,7,6,1,FMN 05 Gerard Le Grellelaan
653,Gerard le Grellelaan 10,2023-08-02,01:00:00,2,2,0,FMN 05 Gerard Le Grellelaan
653,Gerard le Grellelaan 10,2023-08-02,02:00:00,2,0,2,FMN 05 Gerard Le Grellelaan
653,Gerard le Grellelaan 10,2023-08-02,03:00:00,2,2,0,FMN 05 Gerard Le Grellelaan
653,Gerard le Grellelaan 10,2023-08-02,04:00:00,7,4,3,FMN 05 Gerard Le Grellelaan
653,Gerard le Grellelaan 10,2023-08-02,05:00:00,14,6,8,FMN 05 Gerard Le Grellelaan
653,Gerard le Grellelaan 10,2023-08-02,06:00:00,23,12,11,FMN 05 Gerard Le Grellelaan
653,Gerard le Grellelaan 10,2023-08-02,07:00:00,66,44,22,FMN 05 Gerard Le Grellelaan
653,Gerard le Grellelaan 10,2023-08-02,08:00:00,68,51,17,FMN 05 Gerard Le Grellelaan
653,Gerard le Grellelaan 10,2023-08-02,09:00:00,47,36,11,FMN 05 Gerard Le Grellelaan
653,Gerard le Grellelaan 10,2023-08-02,10:00:00,24,18,6,FMN 05 Gerard Le Grellelaan
653,Gerard le Grellelaan 10,2023-08-02,11:00:00,9,8,1,FMN 05 Gerard Le Grellelaan
653,Gerard le Grellelaan 10,2023-08-02,12:00:00,41,33,8,FMN 05 Gerard Le Grellelaan
653,Gerard le Grellelaan 10,2023-08-02,13:00:00,12,9,3,FMN 05 Gerard Le Grellelaan
653,Gerard le Grellelaan 10,2023-08-02,14:00:00,24,20,4,FMN 05 Gerard Le Grellelaan
653,Gerard le Grellelaan 10,2023-08-02,15:00:00,37,34,3,FMN 05 Gerard Le Grellelaan
653,Gerard le Grellelaan 10,2023-08-02,16:00:00,38,25,13,FMN 05 Gerard Le Grellelaan
653,Gerard le Grellelaan 10,2023-08-02,17:00:00,35,28,7,FMN 05 Gerard Le Grellelaan
653,Gerard le Grellelaan 10,2023-08-02,18:00:00,77,66,11,FMN 05 Gerard Le Grellelaan
653,Gerard le Grellelaan 10,2023-08-02,19:00:00,30,24,6,FMN 05 Gerard Le Grellelaan
653,Gerard le Grellelaan 10,2023-08-02,20:00:00,29,25,4,FMN 05 Gerard Le Grellelaan
653,Gerard le Grellelaan 10,2023-08-02,21:00:00,17,14,3,FMN 05 Gerard Le Grellelaan
653,Gerard le Grellelaan 10,2023-08-02,22:00:00,19,16,3,FMN 05 Gerard Le Grellelaan
653,Gerard le Grellelaan 10,2023-08-02,23:00:00,6,6,0,FMN 05 Gerard Le Grellelaan
653,Gerard le Grellelaan 10,2023-08-03,00:00:00,0,0,0,FMN 05 Gerard Le Grellelaan
653,Gerard le Grellelaan 10,2023-08-03,01:00:00,1,0,1,FMN 05 Gerard Le Grellelaan
653,Gerard le Grellelaan 10,2023-08-03,02:00:00,0,0,0,FMN 05 Gerard Le Grellelaan
653,Gerard le Grellelaan 10,2023-08-03,03:00:00,1,1,0,FMN 05 Gerard Le Grellelaan
653,Gerard le Grellelaan 10,2023-08-03,04:00:00,0,0,0,FMN 05 Gerard Le Grellelaan
653,Gerard le Grellelaan 10,2023-08-03,05:00:00,3,2,1,FMN 05 Gerard Le Grellelaan
653,Gerard le Grellelaan 10,2023-08-03,06:00:00,8,6,2,FMN 05 Gerard Le Grellelaan
653,Gerard le Grellelaan 10,2023-08-03,07:00:00,1,0,1,FMN 05 Gerard Le Grellelaan
653,Gerard le Grellelaan 10,2023-08-03,08:00:00,25,20,5,FMN 05 Gerard Le Grellelaan
653,Gerard le Grellelaan 10,2023-08-03,09:00:00,15,12,3,FMN 05 Gerard Le Grellelaan
653,Gerard le Grellelaan 10,2023-08-03,10:00:00,9,8,1,FMN 05 Gerard Le Grellelaan
653,Gerard le Grellelaan 10,2023-08-03,11:00:00,13,10,3,FMN 05 Gerard Le Grellelaan
653,Gerard le Grellelaan 10,2023-08-03,12:00:00,10,7,3,FMN 05 Gerard Le Grellelaan
653,Gerard le Grellelaan 10,2023-08-03,13:00:00,45,33,12,FMN 05 Gerard Le Grellelaan
653,Gerard le Grellelaan 10,2023-08-03,14:00:00,44,39,5,FMN 05 Gerard Le Grellelaan
653,Gerard le Grellelaan 10,2023-08-03,15:00:00,62,47,15,FMN 05 Gerard Le Grellelaan
653,Gerard le Grellelaan 10,2023-08-03,16:00:00,67,56,11,FMN 05 Gerard Le Grellelaan
653,Gerard le Grellelaan 10,2023-08-03,17:00:00,24,17,7,FMN 05 Gerard Le Grellelaan
653,Gerard le Grellelaan 10,2023-08-03,18:00:00,68,55,13,FMN 05 Gerard Le Grellelaan
653,Gerard le Grellelaan 10,2023-08-03,19:00:00,31,24,7,FMN 05 Gerard Le Grellelaan
653,Gerard le Grellelaan 10,2023-08-03,20:00:00,36,30,6,FMN 05 Gerard Le Grellelaan
653,Gerard le Grellelaan 10,2023-08-03,21:00:00,31,27,4,FMN 05 Gerard Le Grellelaan
653,Gerard le Grellelaan 10,2023-08-03,22:00:00,33,29,4,FMN 05 Gerard Le Grellelaan
653,Gerard le Grellelaan 10,2023-08-03,23:00:00,24,20,4,FMN 05 Gerard Le Grellelaan
653,Gerard le Grellelaan 10,2023-08-04,00:00:00,15,10,5,FMN 05 Gerard Le Grellelaan
653,Gerard le Grellelaan 10,2023-08-04,01:00:00,4,0,4,FMN 05 Gerard Le Grellelaan
653,Gerard le Grellelaan 10,2023-08-04,02:00:00,4,3,1,FMN 05 Gerard Le Grellelaan
653,Gerard le Grellelaan 10,2023-08-04,03:00:00,6,4,2,FMN 05 Gerard Le Grellelaan
653,Gerard le Grellelaan 10,2023-08-04,04:00:00,6,4,2,FMN 05 Gerard Le Grellelaan
653,Gerard le Grellelaan 10,2023-08-04,05:00:00,11,6,5,FMN 05 Gerard Le Grellelaan
653,Gerard le Grellelaan 10,2023-08-04,06:00:00,26,14,12,FMN 05 Gerard Le Grellelaan
653,Gerard le Grellelaan 10,2023-08-04,07:00:00,62,38,24,FMN 05 Gerard Le Grellelaan
653,Gerard le Grellelaan 10,2023-08-04,08:00:00,76,60,16,FMN 05 Gerard Le Grellelaan
653,Gerard le Grellelaan 10,2023-08-04,09:00:00,51,45,6,FMN 05 Gerard Le Grellelaan
653,Gerard le Grellelaan 10,2023-08-04,10:00:00,50,44,6,FMN 05 Gerard Le Grellelaan
653,Gerard le Grellelaan 10,2023-08-04,11:00:00,37,33,4,FMN 05 Gerard Le Grellelaan
653,Gerard le Grellelaan 10,2023-08-04,12:00:00,26,22,4,FMN 05 Gerard Le Grellelaan
653,Gerard le Grellelaan 10,2023-08-04,13:00:00,20,16,4,FMN 05 Gerard Le Grellelaan
653,Gerard le Grellelaan 10,2023-08-04,14:00:00,55,47,8,FMN 05 Gerard Le Grellelaan
653,Gerard le Grellelaan 10,2023-08-04,15:00:00,37,32,5,FMN 05 Gerard Le Grellelaan
653,Gerard le Grellelaan 10,2023-08-04,16:00:00,39,32,7,FMN 05 Gerard Le Grellelaan
653,Gerard le Grellelaan 10,2023-08-04,17:00:00,24,17,7,FMN 05 Gerard Le Grellelaan
653,Gerard le Grellelaan 10,2023-08-04,18:00:00,81,67,14,FMN 05 Gerard Le Grellelaan
653,Gerard le Grellelaan 10,2023-08-04,19:00:00,50,42,8,FMN 05 Gerard Le Grellelaan
653,Gerard le Grellelaan 10,2023-08-04,20:00:00,0,0,0,FMN 05 Gerard Le Grellelaan
653,Gerard le Grellelaan 10,2023-08-04,21:00:00,28,23,5,FMN 05 Gerard Le Grellelaan
653,Gerard le Grellelaan 10,2023-08-04,22:00:00,30,28,2,FMN 05 Gerard Le Grellelaan
653,Gerard le Grellelaan 10,2023-08-04,23:00:00,20,15,5,FMN 05 Gerard Le Grellelaan
653,Gerard le Grellelaan 10,2023-08-05,00:00:00,15,12,3,FMN 05 Gerard Le Grellelaan
653,Gerard le Grellelaan 10,2023-08-05,01:00:00,12,10,2,FMN 05 Gerard Le Grellelaan
653,Gerard le Grellelaan 10,2023-08-05,02:00:00,8,6,2,FMN 05 Gerard Le Grellelaan
653,Gerard le Grellelaan 10,2023-08-05,03:00:00,4,2,2,FMN 05 Gerard Le Grellelaan
653,Gerard le Grellelaan 10,2023-08-05,04:00:00,4,2,2,FMN 05 Gerard Le Grellelaan
653,Gerard le Grellelaan 10,2023-08-05,05:00:00,4,3,1,FMN 05 Gerard Le Grellelaan
653,Gerard le Grellelaan 10,2023-08-05,06:00:00,7,5,2,FMN 05 Gerard Le Grellelaan
653,Gerard le Grellelaan 10,2023-08-05,07:00:00,18,11,7,FMN 05 Gerard Le Grellelaan
653,Gerard le Grellelaan 10,2023-08-05,08:00:00,21,16,5,FMN 05 Gerard Le Grellelaan
653,Gerard le Grellelaan 10,2023-08-05,09:00:00,32,24,8,FMN 05 Gerard Le Grellelaan
653,Gerard le Grellelaan 10,2023-08-05,10:00:00,59,48,11,FMN 05 Gerard Le Grellelaan
653,Gerard le Grellelaan 10,2023-08-05,11:00:00,38,31,7,FMN 05 Gerard Le Grellelaan
653,Gerard le Grellelaan 10,2023-08-05,12:00:00,10,7,3,FMN 05 Gerard Le Grellelaan
653,Gerard le Grellelaan 10,2023-08-05,13:00:00,36,29,7,FMN 05 Gerard Le Grellelaan
653,Gerard le Grellelaan 10,2023-08-05,14:00:00,31,27,4,FMN 05 Gerard Le Grellelaan
653,Gerard le Grellelaan 10,2023-08-05,15:00:00,34,25,9,FMN 05 Gerard Le Grellelaan
653,Gerard le Grellelaan 10,2023-08-05,16:00:00,21,16,5,FMN 05 Gerard Le Grellelaan
653,Gerard le Grellelaan 10,2023-08-05,17:00:00,0,0,0,FMN 05 Gerard Le Grellelaan
653,Gerard le Grellelaan 10,2023-08-05,18:00:00,30,21,9,FMN 05 Gerard Le Grellelaan
653,Gerard le Grellelaan 10,2023-08-05,19:00:00,27,25,2,FMN 05 Gerard Le Grellelaan
653,Gerard le Grellelaan 10,2023-08-05,20:00:00,28,23,5,FMN 05 Gerard Le Grellelaan
653,Gerard le Grellelaan 10,2023-08-05,21:00:00,12,11,1,FMN 05 Gerard Le Grellelaan
653,Gerard le Grellelaan 10,2023-08-05,22:00:00,11,7,4,FMN 05 Gerard Le Grellelaan
653,Gerard le Grellelaan 10,2023-08-05,23:00:00,17,17,0,FMN 05 Gerard Le Grellelaan
653,Gerard le Grellelaan 10,2023-08-06,00:00:00,4,3,1,FMN 05 Gerard Le Grellelaan
653,Gerard le Grellelaan 10,2023-08-06,01:00:00,6,5,1,FMN 05 Gerard Le Grellelaan
653,Gerard le Grellelaan 10,2023-08-06,02:00:00,5,5,0,FMN 05 Gerard Le Grellelaan
653,Gerard le Grellelaan 10,2023-08-06,03:00:00,2,1,1,FMN 05 Gerard Le Grellelaan
653,Gerard le Grellelaan 10,2023-08-06,04:00:00,0,0,0,FMN 05 Gerard Le Grellelaan
653,Gerard le Grellelaan 10,2023-08-06,05:00:00,1,1,0,FMN 05 Gerard Le Grellelaan
653,Gerard le Grellelaan 10,2023-08-06,06:00:00,0,0,0,FMN 05 Gerard Le Grellelaan
653,Gerard le Grellelaan 10,2023-08-06,07:00:00,0,0,0,FMN 05 Gerard Le Grellelaan
653,Gerard le Grellelaan 10,2023-08-06,08:00:00,0,0,0,FMN 05 Gerard Le Grellelaan
653,Gerard le Grellelaan 10,2023-08-06,09:00:00,15,12,3,FMN 05 Gerard Le Grellelaan
653,Gerard le Grellelaan 10,2023-08-06,10:00:00,10,10,0,FMN 05 Gerard Le Grellelaan
653,Gerard le Grellelaan 10,2023-08-06,11:00:00,12,9,3,FMN 05 Gerard Le Grellelaan
653,Gerard le Grellelaan 10,2023-08-06,12:00:00,0,0,0,FMN 05 Gerard Le Grellelaan
653,Gerard le Grellelaan 10,2023-08-06,13:00:00,5,4,1,FMN 05 Gerard Le Grellelaan
653,Gerard le Grellelaan 10,2023-08-06,14:00:00,0,0,0,FMN 05 Gerard Le Grellelaan
653,Gerard le Grellelaan 10,2023-08-06,15:00:00,1,1,0,FMN 05 Gerard Le Grellelaan
653,Gerard le Grellelaan 10,2023-08-06,16:00:00,0,0,0,FMN 05 Gerard Le Grellelaan
653,Gerard le Grellelaan 10,2023-08-06,17:00:00,0,0,0,FMN 05 Gerard Le Grellelaan
653,Gerard le Grellelaan 10,2023-08-06,18:00:00,0,0,0,FMN 05 Gerard Le Grellelaan
653,Gerard le Grellelaan 10,2023-08-06,19:00:00,2,2,0,FMN 05 Gerard Le Grellelaan
653,Gerard le Grellelaan 10,2023-08-06,20:00:00,3,3,0,FMN 05 Gerard Le Grellelaan
653,Gerard le Grellelaan 10,2023-08-06,21:00:00,3,3,0,FMN 05 Gerard Le Grellelaan
653,Gerard le Grellelaan 10,2023-08-06,22:00:00,4,4,0,FMN 05 Gerard Le Grellelaan
653,Gerard le Grellelaan 10,2023-08-06,23:00:00,4,4,0,FMN 05 Gerard Le Grellelaan
653,Gerard le Grellelaan 10,2023-08-07,00:00:00,2,1,1,FMN 05 Gerard Le Grellelaan
653,Gerard le Grellelaan 10,2023-08-07,01:00:00,1,1,0,FMN 05 Gerard Le Grellelaan
653,Gerard le Grellelaan 10,2023-08-07,02:00:00,0,0,0,FMN 05 Gerard Le Grellelaan
653,Gerard le Grellelaan 10,2023-08-07,03:00:00,1,0,1,FMN 05 Gerard Le Grellelaan
653,Gerard le Grellelaan 10,2023-08-07,04:00:00,4,1,3,FMN 05 Gerard Le Grellelaan
653,Gerard le Grellelaan 10,2023-08-07,05:00:00,17,3,14,FMN 05 Gerard Le Grellelaan
653,Gerard le Grellelaan 10,2023-08-07,06:00:00,14,8,6,FMN 05 Gerard Le Grellelaan
653,Gerard le Grellelaan 10,2023-08-07,07:00:00,16,7,9,FMN 05 Gerard Le Grellelaan
653,Gerard le Grellelaan 10,2023-08-07,08:00:00,38,34,4,FMN 05 Gerard Le Grellelaan
653,Gerard le Grellelaan 10,2023-08-07,09:00:00,27,26,1,FMN 05 Gerard Le Grellelaan
653,Gerard le Grellelaan 10,2023-08-07,10:00:00,3,2,1,FMN 05 Gerard Le Grellelaan
653,Gerard le Grellelaan 10,2023-08-07,11:00:00,18,14,4,FMN 05 Gerard Le Grellelaan
653,Gerard le Grellelaan 10,2023-08-07,12:00:00,18,13,5,FMN 05 Gerard Le Grellelaan
653,Gerard le Grellelaan 10,2023-08-07,13:00:00,46,35,11,FMN 05 Gerard Le Grellelaan
653,Gerard le Grellelaan 10,2023-08-07,14:00:00,79,66,13,FMN 05 Gerard Le Grellelaan
653,Gerard le Grellelaan 10,2023-08-07,15:00:00,61,49,12,FMN 05 Gerard Le Grellelaan
653,Gerard le Grellelaan 10,2023-08-07,16:00:00,45,36,9,FMN 05 Gerard Le Grellelaan
653,Gerard le Grellelaan 10,2023-08-07,17:00:00,94,82,12,FMN 05 Gerard Le Grellelaan
653,Gerard le Grellelaan 10,2023-08-07,18:00:00,54,46,8,FMN 05 Gerard Le Grellelaan
653,Gerard le Grellelaan 10,2023-08-07,19:00:00,22,16,6,FMN 05 Gerard Le Grellelaan
653,Gerard le Grellelaan 10,2023-08-07,20:00:00,50,38,12,FMN 05 Gerard Le Grellelaan
653,Gerard le Grellelaan 10,2023-08-07,21:00:00,42,39,3,FMN 05 Gerard Le Grellelaan
653,Gerard le Grellelaan 10,2023-08-07,22:00:00,34,30,4,FMN 05 Gerard Le Grellelaan
653,Gerard le Grellelaan 10,2023-08-07,23:00:00,20,12,8,FMN 05 Gerard Le Grellelaan
653,Gerard le Grellelaan 10,2023-08-08,00:00:00,0,0,0,FMN 05 Gerard Le Grellelaan
653,Gerard le Grellelaan 10,2023-08-08,01:00:00,1,0,1,FMN 05 Gerard Le Grellelaan
653,Gerard le Grellelaan 10,2023-08-08,02:00:00,0,0,0,FMN 05 Gerard Le Grellelaan
653,Gerard le Grellelaan 10,2023-08-08,03:00:00,0,0,0,FMN 05 Gerard Le Grellelaan
653,Gerard le Grellelaan 10,2023-08-08,04:00:00,8,2,6,FMN 05 Gerard Le Grellelaan
653,Gerard le Grellelaan 10,2023-08-08,05:00:00,10,3,7,FMN 05 Gerard Le Grellelaan
653,Gerard le Grellelaan 10,2023-08-08,06:00:00,20,7,13,FMN 05 Gerard Le Grellelaan
653,Gerard le Grellelaan 10,2023-08-08,07:00:00,0,0,0,FMN 05 Gerard Le Grellelaan
653,Gerard le Grellelaan 10,2023-08-08,08:00:00,99,85,14,FMN 05 Gerard Le Grellelaan
653,Gerard le Grellelaan 10,2023-08-08,09:00:00,55,50,5,FMN 05 Gerard Le Grellelaan
653,Gerard le Grellelaan 10,2023-08-08,10:00:00,42,38,4,FMN 05 Gerard Le Grellelaan
653,Gerard le Grellelaan 10,2023-08-08,11:00:00,18,15,3,FMN 05 Gerard Le Grellelaan
653,Gerard le Grellelaan 10,2023-08-08,12:00:00,55,40,15,FMN 05 Gerard Le Grellelaan
653,Gerard le Grellelaan 10,2023-08-08,13:00:00,24,19,5,FMN 05 Gerard Le Grellelaan
653,Gerard le Grellelaan 10,2023-08-08,14:00:00,20,18,2,FMN 05 Gerard Le Grellelaan
653,Gerard le Grellelaan 10,2023-08-08,15:00:00,61,49,12,FMN 05 Gerard Le Grellelaan
653,Gerard le Grellelaan 10,2023-08-08,16:00:00,104,88,16,FMN 05 Gerard Le Grellelaan
653,Gerard le Grellelaan 10,2023-08-08,17:00:00,24,19,5,FMN 05 Gerard Le Grellelaan
653,Gerard le Grellelaan 10,2023-08-08,18:00:00,70,55,15,FMN 05 Gerard Le Grellelaan
653,Gerard le Grellelaan 10,2023-08-08,19:00:00,48,37,11,FMN 05 Gerard Le Grellelaan
653,Gerard le Grellelaan 10,2023-08-08,20:00:00,34,25,9,FMN 05 Gerard Le Grellelaan
653,Gerard le Grellelaan 10,2023-08-08,21:00:00,4,4,0,FMN 05 Gerard Le Grellelaan
653,Gerard le Grellelaan 10,2023-08-08,22:00:00,15,10,5,FMN 05 Gerard Le Grellelaan
653,Gerard le Grellelaan 10,2023-08-08,23:00:00,15,13,2,FMN 05 Gerard Le Grellelaan
653,Gerard le Grellelaan 10,2023-08-09,00:00:00,1,1,0,FMN 05 Gerard Le Grellelaan
653,Gerard le Grellelaan 10,2023-08-09,01:00:00,0,0,0,FMN 05 Gerard Le Grellelaan
653,Gerard le Grellelaan 10,2023-08-09,02:00:00,1,1,0,FMN 05 Gerard Le Grellelaan
653,Gerard le Grellelaan 10,2023-08-09,03:00:00,3,2,1,FMN 05 Gerard Le Grellelaan
653,Gerard le Grellelaan 10,2023-08-09,04:00:00,4,4,0,FMN 05 Gerard Le Grellelaan
653,Gerard le Grellelaan 10,2023-08-09,05:00:00,25,7,18,FMN 05 Gerard Le Grellelaan
653,Gerard le Grellelaan 10,2023-08-09,06:00:00,34,18,16,FMN 05 Gerard Le Grellelaan
653,Gerard le Grellelaan 10,2023-08-09,07:00:00,82,64,18,FMN 05 Gerard Le Grellelaan
653,Gerard le Grellelaan 10,2023-08-09,08:00:00,121,102,19,FMN 05 Gerard Le Grellelaan
653,Gerard le Grellelaan 10,2023-08-09,09:00:00,74,63,11,FMN 05 Gerard Le Grellelaan
653,Gerard le Grellelaan 10,2023-08-09,10:00:00,63,49,14,FMN 05 Gerard Le Grellelaan
653,Gerard le Grellelaan 10,2023-08-09,11:00:00,63,55,8,FMN 05 Gerard Le Grellelaan
653,Gerard le Grellelaan 10,2023-08-09,12:00:00,31,24,7,FMN 05 Gerard Le Grellelaan
653,Gerard le Grellelaan 10,2023-08-09,13:00:00,36,26,10,FMN 05 Gerard Le Grellelaan
653,Gerard le Grellelaan 10,2023-08-09,14:00:00,0,0,0,FMN 05 Gerard Le Grellelaan
653,Gerard le Grellelaan 10,2023-08-09,15:00:00,0,0,0,FMN 05 Gerard Le Grellelaan
653,Gerard le Grellelaan 10,2023-08-09,16:00:00,0,0,0,FMN 05 Gerard Le Grellelaan
653,Gerard le Grellelaan 10,2023-08-09,17:00:00,0,0,0,FMN 05 Gerard Le Grellelaan
653,Gerard le Grellelaan 10,2023-08-09,18:00:00,0,0,0,FMN 05 Gerard Le Grellelaan
653,Gerard le Grellelaan 10,2023-08-09,19:00:00,0,0,0,FMN 05 Gerard Le Grellelaan
653,Gerard le Grellelaan 10,2023-08-09,20:00:00,0,0,0,FMN 05 Gerard Le Grellelaan
653,Gerard le Grellelaan 10,2023-08-09,21:00:00,0,0,0,FMN 05 Gerard Le Grellelaan
653,Gerard le Grellelaan 10,2023-08-09,22:00:00,0,0,0,FMN 05 Gerard Le Grellelaan
653,Gerard le Grellelaan 10,2023-08-09,23:00:00,0,0,0,FMN 05 Gerard Le Grellelaan
653,Gerard le Grellelaan 10,2023-08-10,00:00:00,0,0,0,FMN 05 Gerard Le Grellelaan
653,Gerard le Grellelaan 10,2023-08-10,01:00:00,0,0,0,FMN 05 Gerard Le Grellelaan
653,Gerard le Grellelaan 10,2023-08-10,02:00:00,0,0,0,FMN 05 Gerard Le Grellelaan
653,Gerard le Grellelaan 10,2023-08-10,03:00:00,0,0,0,FMN 05 Gerard Le Grellelaan
653,Gerard le Grellelaan 10,2023-08-10,04:00:00,0,0,0,FMN 05 Gerard Le Grellelaan
653,Gerard le Grellelaan 10,2023-08-10,05:00:00,0,0,0,FMN 05 Gerard Le Grellelaan
653,Gerard le Grellelaan 10,2023-08-10,06:00:00,0,0,0,FMN 05 Gerard Le Grellelaan
653,Gerard le Grellelaan 10,2023-08-10,07:00:00,0,0,0,FMN 05 Gerard Le Grellelaan
653,Gerard le Grellelaan 10,2023-08-10,08:00:00,0,0,0,FMN 05 Gerard Le Grellelaan
653,Gerard le Grellelaan 10,2023-08-10,09:00:00,0,0,0,FMN 05 Gerard Le Grellelaan
653,Gerard le Grellelaan 10,2023-08-10,10:00:00,0,0,0,FMN 05 Gerard Le Grellelaan
653,Gerard le Grellelaan 10,2023-08-10,11:00:00,0,0,0,FMN 05 Gerard Le Grellelaan
653,Gerard le Grellelaan 10,2023-08-10,12:00:00,0,0,0,FMN 05 Gerard Le Grellelaan
653,Gerard le Grellelaan 10,2023-08-10,13:00:00,25,20,5,FMN 05 Gerard Le Grellelaan
653,Gerard le Grellelaan 10,2023-08-10,14:00:00,109,94,15,FMN 05 Gerard Le Grellelaan
653,Gerard le Grellelaan 10,2023-08-10,15:00:00,136,119,17,FMN 05 Gerard Le Grellelaan
653,Gerard le Grellelaan 10,2023-08-10,16:00:00,167,139,28,FMN 05 Gerard Le Grellelaan
653,Gerard le Grellelaan 10,2023-08-10,17:00:00,207,170,37,FMN 05 Gerard Le Grellelaan
653,Gerard le Grellelaan 10,2023-08-10,18:00:00,165,131,34,FMN 05 Gerard Le Grellelaan
653,Gerard le Grellelaan 10,2023-08-10,19:00:00,120,96,24,FMN 05 Gerard Le Grellelaan
653,Gerard le Grellelaan 10,2023-08-10,20:00:00,75,59,16,FMN 05 Gerard Le Grellelaan
653,Gerard le Grellelaan 10,2023-08-10,21:00:00,63,53,10,FMN 05 Gerard Le Grellelaan
653,Gerard le Grellelaan 10,2023-08-10,22:00:00,59,54,5,FMN 05 Gerard Le Grellelaan
653,Gerard le Grellelaan 10,2023-08-10,23:00:00,25,19,6,FMN 05 Gerard Le Grellelaan
653,Gerard le Grellelaan 10,2023-08-11,00:00:00,3,1,2,FMN 05 Gerard Le Grellelaan
653,Gerard le Grellelaan 10,2023-08-11,01:00:00,0,0,0,FMN 05 Gerard Le Grellelaan
653,Gerard le Grellelaan 10,2023-08-11,02:00:00,0,0,0,FMN 05 Gerard Le Grellelaan
653,Gerard le Grellelaan 10,2023-08-11,03:00:00,3,2,1,FMN 05 Gerard Le Grellelaan
653,Gerard le Grellelaan 10,2023-08-11,04:00:00,3,2,1,FMN 05 Gerard Le Grellelaan
653,Gerard le Grellelaan 10,2023-08-11,05:00:00,30,9,21,FMN 05 Gerard Le Grellelaan
653,Gerard le Grellelaan 10,2023-08-11,06:00:00,39,14,25,FMN 05 Gerard Le Grellelaan
653,Gerard le Grellelaan 10,2023-08-11,07:00:00,84,61,23,FMN 05 Gerard Le Grellelaan
653,Gerard le Grellelaan 10,2023-08-11,08:00:00,138,126,12,FMN 05 Gerard Le Grellelaan
653,Gerard le Grellelaan 10,2023-08-11,09:00:00,82,72,10,FMN 05 Gerard Le Grellelaan
653,Gerard le Grellelaan 10,2023-08-11,10:00:00,54,48,6,FMN 05 Gerard Le Grellelaan
653,Gerard le Grellelaan 10,2023-08-11,11:00:00,71,56,15,FMN 05 Gerard Le Grellelaan
653,Gerard le Grellelaan 10,2023-08-11,12:00:00,82,53,29,FMN 05 Gerard Le Grellelaan
653,Gerard le Grellelaan 10,2023-08-11,13:00:00,69,58,11,FMN 05 Gerard Le Grellelaan
653,Gerard le Grellelaan 10,2023-08-11,14:00:00,108,93,15,FMN 05 Gerard Le Grellelaan
653,Gerard le Grellelaan 10,2023-08-11,15:00:00,133,106,27,FMN 05 Gerard Le Grellelaan
653,Gerard le Grellelaan 10,2023-08-11,16:00:00,160,139,21,FMN 05 Gerard Le Grellelaan
653,Gerard le Grellelaan 10,2023-08-11,17:00:00,156,132,24,FMN 05 Gerard Le Grellelaan
653,Gerard le Grellelaan 10,2023-08-11,18:00:00,132,107,25,FMN 05 Gerard Le Grellelaan
653,Gerard le Grellelaan 10,2023-08-11,19:00:00,92,69,23,FMN 05 Gerard Le Grellelaan
653,Gerard le Grellelaan 10,2023-08-11,20:00:00,45,39,6,FMN 05 Gerard Le Grellelaan
653,Gerard le Grellelaan 10,2023-08-11,21:00:00,26,23,3,FMN 05 Gerard Le Grellelaan
653,Gerard le Grellelaan 10,2023-08-11,22:00:00,42,36,6,FMN 05 Gerard Le Grellelaan
653,Gerard le Grellelaan 10,2023-08-11,23:00:00,28,23,5,FMN 05 Gerard Le Grellelaan
653,Gerard le Grellelaan 10,2023-08-12,00:00:00,11,7,4,FMN 05 Gerard Le Grellelaan
653,Gerard le Grellelaan 10,2023-08-12,01:00:00,14,10,4,FMN 05 Gerard Le Grellelaan
653,Gerard le Grellelaan 10,2023-08-12,02:00:00,6,4,2,FMN 05 Gerard Le Grellelaan
653,Gerard le Grellelaan 10,2023-08-12,03:00:00,7,4,3,FMN 05 Gerard Le Grellelaan
653,Gerard le Grellelaan 10,2023-08-12,04:00:00,5,3,2,FMN 05 Gerard Le Grellelaan
653,Gerard le Grellelaan 10,2023-08-12,05:00:00,2,2,0,FMN 05 Gerard Le Grellelaan
653,Gerard le Grellelaan 10,2023-08-12,06:00:00,8,5,3,FMN 05 Gerard Le Grellelaan
653,Gerard le Grellelaan 10,2023-08-12,07:00:00,5,4,1,FMN 05 Gerard Le Grellelaan
653,Gerard le Grellelaan 10,2023-08-12,08:00:00,20,13,7,FMN 05 Gerard Le Grellelaan
653,Gerard le Grellelaan 10,2023-08-12,09:00:00,5,4,1,FMN 05 Gerard Le Grellelaan
653,Gerard le Grellelaan 10,2023-08-12,10:00:00,23,23,0,FMN 05 Gerard Le Grellelaan
653,Gerard le Grellelaan 10,2023-08-12,11:00:00,38,31,7,FMN 05 Gerard Le Grellelaan
653,Gerard le Grellelaan 10,2023-08-12,12:00:00,74,57,17,FMN 05 Gerard Le Grellelaan
653,Gerard le Grellelaan 10,2023-08-12,13:00:00,34,33,1,FMN 05 Gerard Le Grellelaan
653,Gerard le Grellelaan 10,2023-08-12,14:00:00,25,21,4,FMN 05 Gerard Le Grellelaan
653,Gerard le Grellelaan 10,2023-08-12,15:00:00,0,0,0,FMN 05 Gerard Le Grellelaan
653,Gerard le Grellelaan 10,2023-08-12,16:00:00,36,31,5,FMN 05 Gerard Le Grellelaan
653,Gerard le Grellelaan 10,2023-08-12,17:00:00,0,0,0,FMN 05 Gerard Le Grellelaan
653,Gerard le Grellelaan 10,2023-08-12,18:00:00,0,0,0,FMN 05 Gerard Le Grellelaan
653,Gerard le Grellelaan 10,2023-08-12,19:00:00,52,32,20,FMN 05 Gerard Le Grellelaan
653,Gerard le Grellelaan 10,2023-08-12,20:00:00,69,38,31,FMN 05 Gerard Le Grellelaan
653,Gerard le Grellelaan 10,2023-08-12,21:00:00,50,35,15,FMN 05 Gerard Le Grellelaan
653,Gerard le Grellelaan 10,2023-08-12,22:00:00,39,33,6,FMN 05 Gerard Le Grellelaan
653,Gerard le Grellelaan 10,2023-08-12,23:00:00,32,24,8,FMN 05 Gerard Le Grellelaan
653,Gerard le Grellelaan 10,2023-08-13,00:00:00,38,24,14,FMN 05 Gerard Le Grellelaan
653,Gerard le Grellelaan 10,2023-08-13,01:00:00,35,32,3,FMN 05 Gerard Le Grellelaan
653,Gerard le Grellelaan 10,2023-08-13,02:00:00,29,26,3,FMN 05 Gerard Le Grellelaan
653,Gerard le Grellelaan 10,2023-08-13,03:00:00,18,15,3,FMN 05 Gerard Le Grellelaan
653,Gerard le Grellelaan 10,2023-08-13,04:00:00,18,16,2,FMN 05 Gerard Le Grellelaan
653,Gerard le Grellelaan 10,2023-08-13,05:00:00,10,9,1,FMN 05 Gerard Le Grellelaan
653,Gerard le Grellelaan 10,2023-08-13,06:00:00,9,8,1,FMN 05 Gerard Le Grellelaan
653,Gerard le Grellelaan 10,2023-08-13,07:00:00,6,4,2,FMN 05 Gerard Le Grellelaan
653,Gerard le Grellelaan 10,2023-08-13,08:00:00,23,20,3,FMN 05 Gerard Le Grellelaan
653,Gerard le Grellelaan 10,2023-08-13,09:00:00,40,32,8,FMN 05 Gerard Le Grellelaan
653,Gerard le Grellelaan 10,2023-08-13,10:00:00,60,48,12,FMN 05 Gerard Le Grellelaan
653,Gerard le Grellelaan 10,2023-08-13,11:00:00,68,55,13,FMN 05 Gerard Le Grellelaan
653,Gerard le Grellelaan 10,2023-08-13,12:00:00,79,67,12,FMN 05 Gerard Le Grellelaan
653,Gerard le Grellelaan 10,2023-08-13,13:00:00,80,70,10,FMN 05 Gerard Le Grellelaan
653,Gerard le Grellelaan 10,2023-08-13,14:00:00,42,35,7,FMN 05 Gerard Le Grellelaan
653,Gerard le Grellelaan 10,2023-08-13,15:00:00,109,95,14,FMN 05 Gerard Le Grellelaan
653,Gerard le Grellelaan 10,2023-08-13,16:00:00,6,5,1,FMN 05 Gerard Le Grellelaan
653,Gerard le Grellelaan 10,2023-08-13,17:00:00,0,0,0,FMN 05 Gerard Le Grellelaan
653,Gerard le Grellelaan 10,2023-08-13,18:00:00,0,0,0,FMN 05 Gerard Le Grellelaan
653,Gerard le Grellelaan 10,2023-08-13,19:00:00,0,0,0,FMN 05 Gerard Le Grellelaan
653,Gerard le Grellelaan 10,2023-08-13,20:00:00,0,0,0,FMN 05 Gerard Le Grellelaan
653,Gerard le Grellelaan 10,2023-08-13,21:00:00,0,0,0,FMN 05 Gerard Le Grellelaan
653,Gerard le Grellelaan 10,2023-08-13,22:00:00,0,0,0,FMN 05 Gerard Le Grellelaan
653,Gerard le Grellelaan 10,2023-08-13,23:00:00,0,0,0,FMN 05 Gerard Le Grellelaan
653,Gerard le Grellelaan 10,2023-08-14,00:00:00,0,0,0,FMN 05 Gerard Le Grellelaan
653,Gerard le Grellelaan 10,2023-08-14,01:00:00,0,0,0,FMN 05 Gerard Le Grellelaan
653,Gerard le Grellelaan 10,2023-08-14,02:00:00,0,0,0,FMN 05 Gerard Le Grellelaan
653,Gerard le Grellelaan 10,2023-08-14,03:00:00,0,0,0,FMN 05 Gerard Le Grellelaan
653,Gerard le Grellelaan 10,2023-08-14,04:00:00,0,0,0,FMN 05 Gerard Le Grellelaan
653,Gerard le Grellelaan 10,2023-08-14,05:00:00,0,0,0,FMN 05 Gerard Le Grellelaan
653,Gerard le Grellelaan 10,2023-08-14,06:00:00,0,0,0,FMN 05 Gerard Le Grellelaan
653,Gerard le Grellelaan 10,2023-08-14,07:00:00,0,0,0,FMN 05 Gerard Le Grellelaan
653,Gerard le Grellelaan 10,2023-08-14,08:00:00,0,0,0,FMN 05 Gerard Le Grellelaan
653,Gerard le Grellelaan 10,2023-08-14,09:00:00,0,0,0,FMN 05 Gerard Le Grellelaan
653,Gerard le Grellelaan 10,2023-08-14,10:00:00,0,0,0,FMN 05 Gerard Le Grellelaan
653,Gerard le Grellelaan 10,2023-08-14,11:00:00,0,0,0,FMN 05 Gerard Le Grellelaan
653,Gerard le Grellelaan 10,2023-08-14,12:00:00,0,0,0,FMN 05 Gerard Le Grellelaan
653,Gerard le Grellelaan 10,2023-08-14,13:00:00,0,0,0,FMN 05 Gerard Le Grellelaan
653,Gerard le Grellelaan 10,2023-08-14,14:00:00,0,0,0,FMN 05 Gerard Le Grellelaan
653,Gerard le Grellelaan 10,2023-08-14,15:00:00,0,0,0,FMN 05 Gerard Le Grellelaan
653,Gerard le Grellelaan 10,2023-08-14,16:00:00,0,0,0,FMN 05 Gerard Le Grellelaan
653,Gerard le Grellelaan 10,2023-08-14,17:00:00,0,0,0,FMN 05 Gerard Le Grellelaan
653,Gerard le Grellelaan 10,2023-08-14,18:00:00,0,0,0,FMN 05 Gerard Le Grellelaan
653,Gerard le Grellelaan 10,2023-08-14,19:00:00,0,0,0,FMN 05 Gerard Le Grellelaan
653,Gerard le Grellelaan 10,2023-08-14,20:00:00,0,0,0,FMN 05 Gerard Le Grellelaan
653,Gerard le Grellelaan 10,2023-08-14,21:00:00,0,0,0,FMN 05 Gerard Le Grellelaan
653,Gerard le Grellelaan 10,2023-08-14,22:00:00,0,0,0,FMN 05 Gerard Le Grellelaan
653,Gerard le Grellelaan 10,2023-08-14,23:00:00,12,11,1,FMN 05 Gerard Le Grellelaan
653,Gerard le Grellelaan 10,2023-08-15,00:00:00,14,12,2,FMN 05 Gerard Le Grellelaan
653,Gerard le Grellelaan 10,2023-08-15,01:00:00,5,4,1,FMN 05 Gerard Le Grellelaan
653,Gerard le Grellelaan 10,2023-08-15,02:00:00,7,6,1,FMN 05 Gerard Le Grellelaan
653,Gerard le Grellelaan 10,2023-08-15,03:00:00,8,7,1,FMN 05 Gerard Le Grellelaan
653,Gerard le Grellelaan 10,2023-08-15,04:00:00,7,6,1,FMN 05 Gerard Le Grellelaan
653,Gerard le Grellelaan 10,2023-08-15,05:00:00,5,3,2,FMN 05 Gerard Le Grellelaan
653,Gerard le Grellelaan 10,2023-08-15,06:00:00,14,10,4,FMN 05 Gerard Le Grellelaan
653,Gerard le Grellelaan 10,2023-08-15,07:00:00,13,10,3,FMN 05 Gerard Le Grellelaan
653,Gerard le Grellelaan 10,2023-08-15,08:00:00,21,14,7,FMN 05 Gerard Le Grellelaan
653,Gerard le Grellelaan 10,2023-08-15,09:00:00,20,17,3,FMN 05 Gerard Le Grellelaan
653,Gerard le Grellelaan 10,2023-08-15,10:00:00,71,57,14,FMN 05 Gerard Le Grellelaan
653,Gerard le Grellelaan 10,2023-08-15,11:00:00,9,8,1,FMN 05 Gerard Le Grellelaan
653,Gerard le Grellelaan 10,2023-08-15,12:00:00,0,0,0,FMN 05 Gerard Le Grellelaan
653,Gerard le Grellelaan 10,2023-08-15,13:00:00,0,0,0,FMN 05 Gerard Le Grellelaan
653,Gerard le Grellelaan 10,2023-08-15,14:00:00,0,0,0,FMN 05 Gerard Le Grellelaan
653,Gerard le Grellelaan 10,2023-08-15,15:00:00,0,0,0,FMN 05 Gerard Le Grellelaan
653,Gerard le Grellelaan 10,2023-08-15,16:00:00,0,0,0,FMN 05 Gerard Le Grellelaan
653,Gerard le Grellelaan 10,2023-08-15,17:00:00,0,0,0,FMN 05 Gerard Le Grellelaan
653,Gerard le Grellelaan 10,2023-08-15,18:00:00,0,0,0,FMN 05 Gerard Le Grellelaan
653,Gerard le Grellelaan 10,2023-08-15,19:00:00,0,0,0,FMN 05 Gerard Le Grellelaan
653,Gerard le Grellelaan 10,2023-08-15,20:00:00,0,0,0,FMN 05 Gerard Le Grellelaan
653,Gerard le Grellelaan 10,2023-08-15,21:00:00,0,0,0,FMN 05 Gerard Le Grellelaan
653,Gerard le Grellelaan 10,2023-08-15,22:00:00,0,0,0,FMN 05 Gerard Le Grellelaan
653,Gerard le Grellelaan 10,2023-08-15,23:00:00,10,7,3,FMN 05 Gerard Le Grellelaan
653,Gerard le Grellelaan 10,2023-08-16,00:00:00,7,3,4,FMN 05 Gerard Le Grellelaan
653,Gerard le Grellelaan 10,2023-08-16,01:00:00,5,5,0,FMN 05 Gerard Le Grellelaan
653,Gerard le Grellelaan 10,2023-08-16,02:00:00,1,1,0,FMN 05 Gerard Le Grellelaan
653,Gerard le Grellelaan 10,2023-08-16,03:00:00,6,4,2,FMN 05 Gerard Le Grellelaan
653,Gerard le Grellelaan 10,2023-08-16,04:00:00,9,3,6,FMN 05 Gerard Le Grellelaan
653,Gerard le Grellelaan 10,2023-08-16,05:00:00,28,12,16,FMN 05 Gerard Le Grellelaan
653,Gerard le Grellelaan 10,2023-08-16,06:00:00,44,19,25,FMN 05 Gerard Le Grellelaan
653,Gerard le Grellelaan 10,2023-08-16,07:00:00,105,73,32,FMN 05 Gerard Le Grellelaan
653,Gerard le Grellelaan 10,2023-08-16,08:00:00,166,144,22,FMN 05 Gerard Le Grellelaan
653,Gerard le Grellelaan 10,2023-08-16,09:00:00,96,83,13,FMN 05 Gerard Le Grellelaan
653,Gerard le Grellelaan 10,2023-08-16,10:00:00,65,57,8,FMN 05 Gerard Le Grellelaan
653,Gerard le Grellelaan 10,2023-08-16,11:00:00,76,67,9,FMN 05 Gerard Le Grellelaan
653,Gerard le Grellelaan 10,2023-08-16,12:00:00,76,56,20,FMN 05 Gerard Le Grellelaan
653,Gerard le Grellelaan 10,2023-08-16,13:00:00,88,64,24,FMN 05 Gerard Le Grellelaan
653,Gerard le Grellelaan 10,2023-08-16,14:00:00,97,81,16,FMN 05 Gerard Le Grellelaan
653,Gerard le Grellelaan 10,2023-08-16,15:00:00,120,102,18,FMN 05 Gerard Le Grellelaan
653,Gerard le Grellelaan 10,2023-08-16,16:00:00,176,145,31,FMN 05 Gerard Le Grellelaan
653,Gerard le Grellelaan 10,2023-08-16,17:00:00,195,168,27,FMN 05 Gerard Le Grellelaan
653,Gerard le Grellelaan 10,2023-08-16,18:00:00,119,93,26,FMN 05 Gerard Le Grellelaan
653,Gerard le Grellelaan 10,2023-08-16,19:00:00,80,62,18,FMN 05 Gerard Le Grellelaan
653,Gerard le Grellelaan 10,2023-08-16,20:00:00,76,66,10,FMN 05 Gerard Le Grellelaan
653,Gerard le Grellelaan 10,2023-08-16,21:00:00,51,44,7,FMN 05 Gerard Le Grellelaan
653,Gerard le Grellelaan 10,2023-08-16,22:00:00,60,55,5,FMN 05 Gerard Le Grellelaan
653,Gerard le Grellelaan 10,2023-08-16,23:00:00,17,10,7,FMN 05 Gerard Le Grellelaan
653,Gerard le Grellelaan 10,2023-08-17,00:00:00,11,10,1,FMN 05 Gerard Le Grellelaan
653,Gerard le Grellelaan 10,2023-08-17,01:00:00,0,0,0,FMN 05 Gerard Le Grellelaan
653,Gerard le Grellelaan 10,2023-08-17,02:00:00,2,2,0,FMN 05 Gerard Le Grellelaan
653,Gerard le Grellelaan 10,2023-08-17,03:00:00,1,1,0,FMN 05 Gerard Le Grellelaan
653,Gerard le Grellelaan 10,2023-08-17,04:00:00,0,0,0,FMN 05 Gerard Le Grellelaan
653,Gerard le Grellelaan 10,2023-08-17,05:00:00,0,0,0,FMN 05 Gerard Le Grellelaan
653,Gerard le Grellelaan 10,2023-08-17,06:00:00,10,4,6,FMN 05 Gerard Le Grellelaan
653,Gerard le Grellelaan 10,2023-08-17,07:00:00,17,16,1,FMN 05 Gerard Le Grellelaan
653,Gerard le Grellelaan 10,2023-08-17,08:00:00,167,138,29,FMN 05 Gerard Le Grellelaan
653,Gerard le Grellelaan 10,2023-08-17,09:00:00,12,12,0,FMN 05 Gerard Le Grellelaan
653,Gerard le Grellelaan 10,2023-08-17,10:00:00,0,0,0,FMN 05 Gerard Le Grellelaan
653,Gerard le Grellelaan 10,2023-08-17,11:00:00,0,0,0,FMN 05 Gerard Le Grellelaan
653,Gerard le Grellelaan 10,2023-08-17,12:00:00,0,0,0,FMN 05 Gerard Le Grellelaan
653,Gerard le Grellelaan 10,2023-08-17,13:00:00,0,0,0,FMN 05 Gerard Le Grellelaan
653,Gerard le Grellelaan 10,2023-08-17,14:00:00,0,0,0,FMN 05 Gerard Le Grellelaan
653,Gerard le Grellelaan 10,2023-08-17,15:00:00,0,0,0,FMN 05 Gerard Le Grellelaan
653,Gerard le Grellelaan 10,2023-08-17,16:00:00,0,0,0,FMN 05 Gerard Le Grellelaan
653,Gerard le Grellelaan 10,2023-08-17,17:00:00,0,0,0,FMN 05 Gerard Le Grellelaan
653,Gerard le Grellelaan 10,2023-08-17,18:00:00,50,37,13,FMN 05 Gerard Le Grellelaan
653,Gerard le Grellelaan 10,2023-08-17,19:00:00,85,69,16,FMN 05 Gerard Le Grellelaan
653,Gerard le Grellelaan 10,2023-08-17,20:00:00,75,58,17,FMN 05 Gerard Le Grellelaan
653,Gerard le Grellelaan 10,2023-08-17,21:00:00,41,30,11,FMN 05 Gerard Le Grellelaan
653,Gerard le Grellelaan 10,2023-08-17,22:00:00,45,35,10,FMN 05 Gerard Le Grellelaan
653,Gerard le Grellelaan 10,2023-08-17,23:00:00,30,21,9,FMN 05 Gerard Le Grellelaan
653,Gerard le Grellelaan 10,2023-08-18,00:00:00,16,14,2,FMN 05 Gerard Le Grellelaan
653,Gerard le Grellelaan 10,2023-08-18,01:00:00,11,10,1,FMN 05 Gerard Le Grellelaan
653,Gerard le Grellelaan 10,2023-08-18,02:00:00,5,4,1,FMN 05 Gerard Le Grellelaan
653,Gerard le Grellelaan 10,2023-08-18,03:00:00,3,3,0,FMN 05 Gerard Le Grellelaan
653,Gerard le Grellelaan 10,2023-08-18,04:00:00,8,1,7,FMN 05 Gerard Le Grellelaan
653,Gerard le Grellelaan 10,2023-08-18,05:00:00,27,10,17,FMN 05 Gerard Le Grellelaan
653,Gerard le Grellelaan 10,2023-08-18,06:00:00,43,20,23,FMN 05 Gerard Le Grellelaan
653,Gerard le Grellelaan 10,2023-08-18,07:00:00,82,57,25,FMN 05 Gerard Le Grellelaan
653,Gerard le Grellelaan 10,2023-08-18,08:00:00,146,136,10,FMN 05 Gerard Le Grellelaan
653,Gerard le Grellelaan 10,2023-08-18,09:00:00,77,69,8,FMN 05 Gerard Le Grellelaan
653,Gerard le Grellelaan 10,2023-08-18,10:00:00,66,51,15,FMN 05 Gerard Le Grellelaan
653,Gerard le Grellelaan 10,2023-08-18,11:00:00,68,56,12,FMN 05 Gerard Le Grellelaan
653,Gerard le Grellelaan 10,2023-08-18,12:00:00,75,64,11,FMN 05 Gerard Le Grellelaan
653,Gerard le Grellelaan 10,2023-08-18,13:00:00,89,75,14,FMN 05 Gerard Le Grellelaan
653,Gerard le Grellelaan 10,2023-08-18,14:00:00,103,84,19,FMN 05 Gerard Le Grellelaan
653,Gerard le Grellelaan 10,2023-08-18,15:00:00,126,110,16,FMN 05 Gerard Le Grellelaan
653,Gerard le Grellelaan 10,2023-08-18,16:00:00,163,144,19,FMN 05 Gerard Le Grellelaan
653,Gerard le Grellelaan 10,2023-08-18,17:00:00,137,111,26,FMN 05 Gerard Le Grellelaan
653,Gerard le Grellelaan 10,2023-08-18,18:00:00,133,104,29,FMN 05 Gerard Le Grellelaan
653,Gerard le Grellelaan 10,2023-08-18,19:00:00,98,80,18,FMN 05 Gerard Le Grellelaan
653,Gerard le Grellelaan 10,2023-08-18,20:00:00,95,81,14,FMN 05 Gerard Le Grellelaan
653,Gerard le Grellelaan 10,2023-08-18,21:00:00,67,57,10,FMN 05 Gerard Le Grellelaan
653,Gerard le Grellelaan 10,2023-08-18,22:00:00,43,40,3,FMN 05 Gerard Le Grellelaan
653,Gerard le Grellelaan 10,2023-08-18,23:00:00,33,28,5,FMN 05 Gerard Le Grellelaan
653,Gerard le Grellelaan 10,2023-08-19,00:00:00,25,17,8,FMN 05 Gerard Le Grellelaan
653,Gerard le Grellelaan 10,2023-08-19,01:00:00,16,9,7,FMN 05 Gerard Le Grellelaan
653,Gerard le Grellelaan 10,2023-08-19,02:00:00,13,11,2,FMN 05 Gerard Le Grellelaan
653,Gerard le Grellelaan 10,2023-08-19,03:00:00,15,8,7,FMN 05 Gerard Le Grellelaan
653,Gerard le Grellelaan 10,2023-08-19,04:00:00,1,0,1,FMN 05 Gerard Le Grellelaan
653,Gerard le Grellelaan 10,2023-08-19,05:00:00,11,7,4,FMN 05 Gerard Le Grellelaan
653,Gerard le Grellelaan 10,2023-08-19,06:00:00,7,6,1,FMN 05 Gerard Le Grellelaan
653,Gerard le Grellelaan 10,2023-08-19,07:00:00,13,8,5,FMN 05 Gerard Le Grellelaan
653,Gerard le Grellelaan 10,2023-08-19,08:00:00,28,18,10,FMN 05 Gerard Le Grellelaan
653,Gerard le Grellelaan 10,2023-08-19,09:00:00,53,43,10,FMN 05 Gerard Le Grellelaan
653,Gerard le Grellelaan 10,2023-08-19,10:00:00,69,55,14,FMN 05 Gerard Le Grellelaan
653,Gerard le Grellelaan 10,2023-08-19,11:00:00,74,59,15,FMN 05 Gerard Le Grellelaan
653,Gerard le Grellelaan 10,2023-08-19,12:00:00,0,0,0,FMN 05 Gerard Le Grellelaan
653,Gerard le Grellelaan 10,2023-08-19,13:00:00,0,0,0,FMN 05 Gerard Le Grellelaan
653,Gerard le Grellelaan 10,2023-08-19,14:00:00,0,0,0,FMN 05 Gerard Le Grellelaan
653,Gerard le Grellelaan 10,2023-08-19,15:00:00,80,70,10,FMN 05 Gerard Le Grellelaan
653,Gerard le Grellelaan 10,2023-08-19,16:00:00,79,66,13,FMN 05 Gerard Le Grellelaan
653,Gerard le Grellelaan 10,2023-08-19,17:00:00,96,82,14,FMN 05 Gerard Le Grellelaan
653,Gerard le Grellelaan 10,2023-08-19,18:00:00,102,88,14,FMN 05 Gerard Le Grellelaan
653,Gerard le Grellelaan 10,2023-08-19,19:00:00,49,44,5,FMN 05 Gerard Le Grellelaan
653,Gerard le Grellelaan 10,2023-08-19,20:00:00,65,56,9,FMN 05 Gerard Le Grellelaan
653,Gerard le Grellelaan 10,2023-08-19,21:00:00,33,27,6,FMN 05 Gerard Le Grellelaan
653,Gerard le Grellelaan 10,2023-08-19,22:00:00,34,29,5,FMN 05 Gerard Le Grellelaan
653,Gerard le Grellelaan 10,2023-08-19,23:00:00,33,24,9,FMN 05 Gerard Le Grellelaan
653,Gerard le Grellelaan 10,2023-08-20,00:00:00,18,16,2,FMN 05 Gerard Le Grellelaan
653,Gerard le Grellelaan 10,2023-08-20,01:00:00,13,10,3,FMN 05 Gerard Le Grellelaan
653,Gerard le Grellelaan 10,2023-08-20,02:00:00,13,8,5,FMN 05 Gerard Le Grellelaan
653,Gerard le Grellelaan 10,2023-08-20,03:00:00,8,3,5,FMN 05 Gerard Le Grellelaan
653,Gerard le Grellelaan 10,2023-08-20,04:00:00,3,0,3,FMN 05 Gerard Le Grellelaan
653,Gerard le Grellelaan 10,2023-08-20,05:00:00,4,2,2,FMN 05 Gerard Le Grellelaan
653,Gerard le Grellelaan 10,2023-08-20,06:00:00,5,3,2,FMN 05 Gerard Le Grellelaan
653,Gerard le Grellelaan 10,2023-08-20,07:00:00,10,8,2,FMN 05 Gerard Le Grellelaan
653,Gerard le Grellelaan 10,2023-08-20,08:00:00,24,18,6,FMN 05 Gerard Le Grellelaan
653,Gerard le Grellelaan 10,2023-08-20,09:00:00,52,44,8,FMN 05 Gerard Le Grellelaan
653,Gerard le Grellelaan 10,2023-08-20,10:00:00,72,64,8,FMN 05 Gerard Le Grellelaan
653,Gerard le Grellelaan 10,2023-08-20,11:00:00,87,73,14,FMN 05 Gerard Le Grellelaan
653,Gerard le Grellelaan 10,2023-08-20,12:00:00,86,70,16,FMN 05 Gerard Le Grellelaan
653,Gerard le Grellelaan 10,2023-08-20,13:00:00,34,30,4,FMN 05 Gerard Le Grellelaan
653,Gerard le Grellelaan 10,2023-08-20,14:00:00,104,92,12,FMN 05 Gerard Le Grellelaan
653,Gerard le Grellelaan 10,2023-08-20,15:00:00,112,92,20,FMN 05 Gerard Le Grellelaan
653,Gerard le Grellelaan 10,2023-08-20,16:00:00,114,97,17,FMN 05 Gerard Le Grellelaan
653,Gerard le Grellelaan 10,2023-08-20,17:00:00,99,85,14,FMN 05 Gerard Le Grellelaan
653,Gerard le Grellelaan 10,2023-08-20,18:00:00,30,25,5,FMN 05 Gerard Le Grellelaan
653,Gerard le Grellelaan 10,2023-08-20,19:00:00,0,0,0,FMN 05 Gerard Le Grellelaan
653,Gerard le Grellelaan 10,2023-08-20,20:00:00,0,0,0,FMN 05 Gerard Le Grellelaan
653,Gerard le Grellelaan 10,2023-08-20,21:00:00,0,0,0,FMN 05 Gerard Le Grellelaan
653,Gerard le Grellelaan 10,2023-08-20,22:00:00,15,11,4,FMN 05 Gerard Le Grellelaan
653,Gerard le Grellelaan 10,2023-08-20,23:00:00,22,18,4,FMN 05 Gerard Le Grellelaan
653,Gerard le Grellelaan 10,2023-08-21,00:00:00,7,5,2,FMN 05 Gerard Le Grellelaan
653,Gerard le Grellelaan 10,2023-08-21,01:00:00,4,1,3,FMN 05 Gerard Le Grellelaan
653,Gerard le Grellelaan 10,2023-08-21,02:00:00,2,1,1,FMN 05 Gerard Le Grellelaan
653,Gerard le Grellelaan 10,2023-08-21,03:00:00,5,4,1,FMN 05 Gerard Le Grellelaan
653,Gerard le Grellelaan 10,2023-08-21,04:00:00,5,3,2,FMN 05 Gerard Le Grellelaan
653,Gerard le Grellelaan 10,2023-08-21,05:00:00,29,9,20,FMN 05 Gerard Le Grellelaan
653,Gerard le Grellelaan 10,2023-08-21,06:00:00,57,30,27,FMN 05 Gerard Le Grellelaan
653,Gerard le Grellelaan 10,2023-08-21,07:00:00,122,87,35,FMN 05 Gerard Le Grellelaan
653,Gerard le Grellelaan 10,2023-08-21,08:00:00,191,175,16,FMN 05 Gerard Le Grellelaan
653,Gerard le Grellelaan 10,2023-08-21,09:00:00,98,84,14,FMN 05 Gerard Le Grellelaan
653,Gerard le Grellelaan 10,2023-08-21,10:00:00,76,64,12,FMN 05 Gerard Le Grellelaan
653,Gerard le Grellelaan 10,2023-08-21,11:00:00,58,54,4,FMN 05 Gerard Le Grellelaan
653,Gerard le Grellelaan 10,2023-08-21,12:00:00,100,85,15,FMN 05 Gerard Le Grellelaan
653,Gerard le Grellelaan 10,2023-08-21,13:00:00,93,71,22,FMN 05 Gerard Le Grellelaan
653,Gerard le Grellelaan 10,2023-08-21,14:00:00,102,82,20,FMN 05 Gerard Le Grellelaan
653,Gerard le Grellelaan 10,2023-08-21,15:00:00,128,110,18,FMN 05 Gerard Le Grellelaan
653,Gerard le Grellelaan 10,2023-08-21,16:00:00,177,137,40,FMN 05 Gerard Le Grellelaan
653,Gerard le Grellelaan 10,2023-08-21,17:00:00,220,181,39,FMN 05 Gerard Le Grellelaan
653,Gerard le Grellelaan 10,2023-08-21,18:00:00,151,132,19,FMN 05 Gerard Le Grellelaan
653,Gerard le Grellelaan 10,2023-08-21,19:00:00,105,85,20,FMN 05 Gerard Le Grellelaan
653,Gerard le Grellelaan 10,2023-08-21,20:00:00,87,64,23,FMN 05 Gerard Le Grellelaan
653,Gerard le Grellelaan 10,2023-08-21,21:00:00,65,53,12,FMN 05 Gerard Le Grellelaan
653,Gerard le Grellelaan 10,2023-08-21,22:00:00,47,39,8,FMN 05 Gerard Le Grellelaan
653,Gerard le Grellelaan 10,2023-08-21,23:00:00,19,14,5,FMN 05 Gerard Le Grellelaan
653,Gerard le Grellelaan 10,2023-08-22,00:00:00,6,5,1,FMN 05 Gerard Le Grellelaan
653,Gerard le Grellelaan 10,2023-08-22,01:00:00,6,5,1,FMN 05 Gerard Le Grellelaan
653,Gerard le Grellelaan 10,2023-08-22,02:00:00,3,2,1,FMN 05 Gerard Le Grellelaan
653,Gerard le Grellelaan 10,2023-08-22,03:00:00,2,2,0,FMN 05 Gerard Le Grellelaan
653,Gerard le Grellelaan 10,2023-08-22,04:00:00,6,3,3,FMN 05 Gerard Le Grellelaan
653,Gerard le Grellelaan 10,2023-08-22,05:00:00,33,12,21,FMN 05 Gerard Le Grellelaan
653,Gerard le Grellelaan 10,2023-08-22,06:00:00,65,31,34,FMN 05 Gerard Le Grellelaan
653,Gerard le Grellelaan 10,2023-08-22,07:00:00,134,90,44,FMN 05 Gerard Le Grellelaan
653,Gerard le Grellelaan 10,2023-08-22,08:00:00,243,204,39,FMN 05 Gerard Le Grellelaan
653,Gerard le Grellelaan 10,2023-08-22,09:00:00,117,98,19,FMN 05 Gerard Le Grellelaan
653,Gerard le Grellelaan 10,2023-08-22,10:00:00,75,61,14,FMN 05 Gerard Le Grellelaan
653,Gerard le Grellelaan 10,2023-08-22,11:00:00,85,75,10,FMN 05 Gerard Le Grellelaan
653,Gerard le Grellelaan 10,2023-08-22,12:00:00,84,69,15,FMN 05 Gerard Le Grellelaan
653,Gerard le Grellelaan 10,2023-08-22,13:00:00,69,58,11,FMN 05 Gerard Le Grellelaan
653,Gerard le Grellelaan 10,2023-08-22,14:00:00,113,92,21,FMN 05 Gerard Le Grellelaan
653,Gerard le Grellelaan 10,2023-08-22,15:00:00,150,123,27,FMN 05 Gerard Le Grellelaan
653,Gerard le Grellelaan 10,2023-08-22,16:00:00,194,165,29,FMN 05 Gerard Le Grellelaan
653,Gerard le Grellelaan 10,2023-08-22,17:00:00,239,192,47,FMN 05 Gerard Le Grellelaan
653,Gerard le Grellelaan 10,2023-08-22,18:00:00,158,129,29,FMN 05 Gerard Le Grellelaan
653,Gerard le Grellelaan 10,2023-08-22,19:00:00,102,69,33,FMN 05 Gerard Le Grellelaan
653,Gerard le Grellelaan 10,2023-08-22,20:00:00,81,63,18,FMN 05 Gerard Le Grellelaan
653,Gerard le Grellelaan 10,2023-08-22,21:00:00,84,71,13,FMN 05 Gerard Le Grellelaan
653,Gerard le Grellelaan 10,2023-08-22,22:00:00,59,54,5,FMN 05 Gerard Le Grellelaan
653,Gerard le Grellelaan 10,2023-08-22,23:00:00,27,16,11,FMN 05 Gerard Le Grellelaan
653,Gerard le Grellelaan 10,2023-08-23,00:00:00,18,13,5,FMN 05 Gerard Le Grellelaan
653,Gerard le Grellelaan 10,2023-08-23,01:00:00,7,6,1,FMN 05 Gerard Le Grellelaan
653,Gerard le Grellelaan 10,2023-08-23,02:00:00,2,1,1,FMN 05 Gerard Le Grellelaan
653,Gerard le Grellelaan 10,2023-08-23,03:00:00,2,2,0,FMN 05 Gerard Le Grellelaan
653,Gerard le Grellelaan 10,2023-08-23,04:00:00,6,4,2,FMN 05 Gerard Le Grellelaan
653,Gerard le Grellelaan 10,2023-08-23,05:00:00,34,14,20,FMN 05 Gerard Le Grellelaan
653,Gerard le Grellelaan 10,2023-08-23,06:00:00,54,29,25,FMN 05 Gerard Le Grellelaan
653,Gerard le Grellelaan 10,2023-08-23,07:00:00,97,66,31,FMN 05 Gerard Le Grellelaan
653,Gerard le Grellelaan 10,2023-08-23,08:00:00,199,172,27,FMN 05 Gerard Le Grellelaan
653,Gerard le Grellelaan 10,2023-08-23,09:00:00,125,101,24,FMN 05 Gerard Le Grellelaan
653,Gerard le Grellelaan 10,2023-08-23,10:00:00,80,69,11,FMN 05 Gerard Le Grellelaan
653,Gerard le Grellelaan 10,2023-08-23,11:00:00,94,78,16,FMN 05 Gerard Le Grellelaan
653,Gerard le Grellelaan 10,2023-08-23,12:00:00,100,79,21,FMN 05 Gerard Le Grellelaan
653,Gerard le Grellelaan 10,2023-08-23,13:00:00,44,37,7,FMN 05 Gerard Le Grellelaan
653,Gerard le Grellelaan 10,2023-08-23,14:00:00,121,100,21,FMN 05 Gerard Le Grellelaan
653,Gerard le Grellelaan 10,2023-08-23,15:00:00,154,120,34,FMN 05 Gerard Le Grellelaan
653,Gerard le Grellelaan 10,2023-08-23,16:00:00,211,180,31,FMN 05 Gerard Le Grellelaan
653,Gerard le Grellelaan 10,2023-08-23,17:00:00,253,196,57,FMN 05 Gerard Le Grellelaan
653,Gerard le Grellelaan 10,2023-08-23,18:00:00,184,151,33,FMN 05 Gerard Le Grellelaan
653,Gerard le Grellelaan 10,2023-08-23,19:00:00,110,75,35,FMN 05 Gerard Le Grellelaan
653,Gerard le Grellelaan 10,2023-08-23,20:00:00,109,90,19,FMN 05 Gerard Le Grellelaan
653,Gerard le Grellelaan 10,2023-08-23,21:00:00,100,87,13,FMN 05 Gerard Le Grellelaan
653,Gerard le Grellelaan 10,2023-08-23,22:00:00,79,65,14,FMN 05 Gerard Le Grellelaan
653,Gerard le Grellelaan 10,2023-08-23,23:00:00,930,533,397,FMN 05 Gerard Le Grellelaan
653,Gerard le Grellelaan 10,2023-08-24,00:00:00,26,6,20,FMN 05 Gerard Le Grellelaan
653,Gerard le Grellelaan 10,2023-08-24,01:00:00,2534,1438,1096,FMN 05 Gerard Le Grellelaan
653,Gerard le Grellelaan 10,2023-08-24,02:00:00,359,163,196,FMN 05 Gerard Le Grellelaan
653,Gerard le Grellelaan 10,2023-08-24,03:00:00,3,3,0,FMN 05 Gerard Le Grellelaan
653,Gerard le Grellelaan 10,2023-08-24,04:00:00,8,6,2,FMN 05 Gerard Le Grellelaan
653,Gerard le Grellelaan 10,2023-08-24,05:00:00,31,13,18,FMN 05 Gerard Le Grellelaan
653,Gerard le Grellelaan 10,2023-08-24,06:00:00,50,23,27,FMN 05 Gerard Le Grellelaan
653,Gerard le Grellelaan 10,2023-08-24,07:00:00,120,81,39,FMN 05 Gerard Le Grellelaan
653,Gerard le Grellelaan 10,2023-08-24,08:00:00,237,201,36,FMN 05 Gerard Le Grellelaan
653,Gerard le Grellelaan 10,2023-08-24,09:00:00,126,101,25,FMN 05 Gerard Le Grellelaan
653,Gerard le Grellelaan 10,2023-08-24,10:00:00,75,62,13,FMN 05 Gerard Le Grellelaan
653,Gerard le Grellelaan 10,2023-08-24,11:00:00,76,61,15,FMN 05 Gerard Le Grellelaan
653,Gerard le Grellelaan 10,2023-08-24,12:00:00,46,37,9,FMN 05 Gerard Le Grellelaan
653,Gerard le Grellelaan 10,2023-08-24,13:00:00,24,20,4,FMN 05 Gerard Le Grellelaan
653,Gerard le Grellelaan 10,2023-08-24,14:00:00,0,0,0,FMN 05 Gerard Le Grellelaan
653,Gerard le Grellelaan 10,2023-08-24,15:00:00,0,0,0,FMN 05 Gerard Le Grellelaan
653,Gerard le Grellelaan 10,2023-08-24,16:00:00,0,0,0,FMN 05 Gerard Le Grellelaan
653,Gerard le Grellelaan 10,2023-08-24,17:00:00,0,0,0,FMN 05 Gerard Le Grellelaan
653,Gerard le Grellelaan 10,2023-08-24,18:00:00,0,0,0,FMN 05 Gerard Le Grellelaan
653,Gerard le Grellelaan 10,2023-08-24,19:00:00,0,0,0,FMN 05 Gerard Le Grellelaan
653,Gerard le Grellelaan 10,2023-08-24,20:00:00,0,0,0,FMN 05 Gerard Le Grellelaan
653,Gerard le Grellelaan 10,2023-08-24,21:00:00,0,0,0,FMN 05 Gerard Le Grellelaan
653,Gerard le Grellelaan 10,2023-08-24,22:00:00,0,0,0,FMN 05 Gerard Le Grellelaan
653,Gerard le Grellelaan 10,2023-08-24,23:00:00,0,0,0,FMN 05 Gerard Le Grellelaan
653,Gerard le Grellelaan 10,2023-08-25,00:00:00,0,0,0,FMN 05 Gerard Le Grellelaan
653,Gerard le Grellelaan 10,2023-08-25,01:00:00,0,0,0,FMN 05 Gerard Le Grellelaan
653,Gerard le Grellelaan 10,2023-08-25,02:00:00,0,0,0,FMN 05 Gerard Le Grellelaan
653,Gerard le Grellelaan 10,2023-08-25,03:00:00,0,0,0,FMN 05 Gerard Le Grellelaan
653,Gerard le Grellelaan 10,2023-08-25,04:00:00,0,0,0,FMN 05 Gerard Le Grellelaan
653,Gerard le Grellelaan 10,2023-08-25,05:00:00,0,0,0,FMN 05 Gerard Le Grellelaan
653,Gerard le Grellelaan 10,2023-08-25,06:00:00,0,0,0,FMN 05 Gerard Le Grellelaan
653,Gerard le Grellelaan 10,2023-08-25,07:00:00,0,0,0,FMN 05 Gerard Le Grellelaan
653,Gerard le Grellelaan 10,2023-08-25,08:00:00,0,0,0,FMN 05 Gerard Le Grellelaan
653,Gerard le Grellelaan 10,2023-08-25,09:00:00,0,0,0,FMN 05 Gerard Le Grellelaan
653,Gerard le Grellelaan 10,2023-08-25,10:00:00,0,0,0,FMN 05 Gerard Le Grellelaan
653,Gerard le Grellelaan 10,2023-08-25,11:00:00,0,0,0,FMN 05 Gerard Le Grellelaan
653,Gerard le Grellelaan 10,2023-08-25,12:00:00,0,0,0,FMN 05 Gerard Le Grellelaan
653,Gerard le Grellelaan 10,2023-08-25,13:00:00,0,0,0,FMN 05 Gerard Le Grellelaan
653,Gerard le Grellelaan 10,2023-08-25,14:00:00,0,0,0,FMN 05 Gerard Le Grellelaan
653,Gerard le Grellelaan 10,2023-08-25,15:00:00,46,37,9,FMN 05 Gerard Le Grellelaan
653,Gerard le Grellelaan 10,2023-08-25,16:00:00,141,121,20,FMN 05 Gerard Le Grellelaan
653,Gerard le Grellelaan 10,2023-08-25,17:00:00,123,101,22,FMN 05 Gerard Le Grellelaan
653,Gerard le Grellelaan 10,2023-08-25,18:00:00,102,73,29,FMN 05 Gerard Le Grellelaan
653,Gerard le Grellelaan 10,2023-08-25,19:00:00,44,37,7,FMN 05 Gerard Le Grellelaan
653,Gerard le Grellelaan 10,2023-08-25,20:00:00,64,51,13,FMN 05 Gerard Le Grellelaan
653,Gerard le Grellelaan 10,2023-08-25,21:00:00,32,27,5,FMN 05 Gerard Le Grellelaan
653,Gerard le Grellelaan 10,2023-08-25,22:00:00,39,34,5,FMN 05 Gerard Le Grellelaan
653,Gerard le Grellelaan 10,2023-08-25,23:00:00,21,16,5,FMN 05 Gerard Le Grellelaan
653,Gerard le Grellelaan 10,2023-08-26,00:00:00,14,11,3,FMN 05 Gerard Le Grellelaan
653,Gerard le Grellelaan 10,2023-08-26,01:00:00,23,19,4,FMN 05 Gerard Le Grellelaan
653,Gerard le Grellelaan 10,2023-08-26,02:00:00,13,8,5,FMN 05 Gerard Le Grellelaan
653,Gerard le Grellelaan 10,2023-08-26,03:00:00,4,1,3,FMN 05 Gerard Le Grellelaan
653,Gerard le Grellelaan 10,2023-08-26,04:00:00,0,0,0,FMN 05 Gerard Le Grellelaan
653,Gerard le Grellelaan 10,2023-08-26,05:00:00,0,0,0,FMN 05 Gerard Le Grellelaan
653,Gerard le Grellelaan 10,2023-08-26,06:00:00,0,0,0,FMN 05 Gerard Le Grellelaan
653,Gerard le Grellelaan 10,2023-08-26,07:00:00,0,0,0,FMN 05 Gerard Le Grellelaan
653,Gerard le Grellelaan 10,2023-08-26,08:00:00,0,0,0,FMN 05 Gerard Le Grellelaan
653,Gerard le Grellelaan 10,2023-08-26,09:00:00,16,12,4,FMN 05 Gerard Le Grellelaan
653,Gerard le Grellelaan 10,2023-08-26,10:00:00,29,25,4,FMN 05 Gerard Le Grellelaan
653,Gerard le Grellelaan 10,2023-08-26,11:00:00,17,15,2,FMN 05 Gerard Le Grellelaan
653,Gerard le Grellelaan 10,2023-08-26,12:00:00,36,31,5,FMN 05 Gerard Le Grellelaan
653,Gerard le Grellelaan 10,2023-08-26,13:00:00,57,47,10,FMN 05 Gerard Le Grellelaan
653,Gerard le Grellelaan 10,2023-08-26,14:00:00,91,77,14,FMN 05 Gerard Le Grellelaan
653,Gerard le Grellelaan 10,2023-08-26,15:00:00,100,93,7,FMN 05 Gerard Le Grellelaan
653,Gerard le Grellelaan 10,2023-08-26,16:00:00,74,56,18,FMN 05 Gerard Le Grellelaan
653,Gerard le Grellelaan 10,2023-08-26,17:00:00,85,69,16,FMN 05 Gerard Le Grellelaan
653,Gerard le Grellelaan 10,2023-08-26,18:00:00,69,55,14,FMN 05 Gerard Le Grellelaan
653,Gerard le Grellelaan 10,2023-08-26,19:00:00,67,43,24,FMN 05 Gerard Le Grellelaan
653,Gerard le Grellelaan 10,2023-08-26,20:00:00,51,43,8,FMN 05 Gerard Le Grellelaan
653,Gerard le Grellelaan 10,2023-08-26,21:00:00,36,28,8,FMN 05 Gerard Le Grellelaan
653,Gerard le Grellelaan 10,2023-08-26,22:00:00,37,27,10,FMN 05 Gerard Le Grellelaan
653,Gerard le Grellelaan 10,2023-08-26,23:00:00,38,29,9,FMN 05 Gerard Le Grellelaan
653,Gerard le Grellelaan 10,2023-08-27,00:00:00,36,33,3,FMN 05 Gerard Le Grellelaan
653,Gerard le Grellelaan 10,2023-08-27,01:00:00,55,53,2,FMN 05 Gerard Le Grellelaan
653,Gerard le Grellelaan 10,2023-08-27,02:00:00,8,5,3,FMN 05 Gerard Le Grellelaan
653,Gerard le Grellelaan 10,2023-08-27,03:00:00,5,3,2,FMN 05 Gerard Le Grellelaan
653,Gerard le Grellelaan 10,2023-08-27,04:00:00,4,2,2,FMN 05 Gerard Le Grellelaan
653,Gerard le Grellelaan 10,2023-08-27,05:00:00,4,3,1,FMN 05 Gerard Le Grellelaan
653,Gerard le Grellelaan 10,2023-08-27,06:00:00,11,7,4,FMN 05 Gerard Le Grellelaan
653,Gerard le Grellelaan 10,2023-08-27,07:00:00,8,7,1,FMN 05 Gerard Le Grellelaan
653,Gerard le Grellelaan 10,2023-08-27,08:00:00,5,2,3,FMN 05 Gerard Le Grellelaan
653,Gerard le Grellelaan 10,2023-08-27,09:00:00,61,57,4,FMN 05 Gerard Le Grellelaan
653,Gerard le Grellelaan 10,2023-08-27,10:00:00,70,65,5,FMN 05 Gerard Le Grellelaan
653,Gerard le Grellelaan 10,2023-08-27,11:00:00,46,41,5,FMN 05 Gerard Le Grellelaan
653,Gerard le Grellelaan 10,2023-08-27,12:00:00,19,18,1,FMN 05 Gerard Le Grellelaan
653,Gerard le Grellelaan 10,2023-08-27,13:00:00,22,20,2,FMN 05 Gerard Le Grellelaan
653,Gerard le Grellelaan 10,2023-08-27,14:00:00,113,94,19,FMN 05 Gerard Le Grellelaan
653,Gerard le Grellelaan 10,2023-08-27,15:00:00,89,85,4,FMN 05 Gerard Le Grellelaan
653,Gerard le Grellelaan 10,2023-08-27,16:00:00,57,45,12,FMN 05 Gerard Le Grellelaan
653,Gerard le Grellelaan 10,2023-08-27,17:00:00,74,57,17,FMN 05 Gerard Le Grellelaan
653,Gerard le Grellelaan 10,2023-08-27,18:00:00,43,37,6,FMN 05 Gerard Le Grellelaan
653,Gerard le Grellelaan 10,2023-08-27,19:00:00,31,25,6,FMN 05 Gerard Le Grellelaan
653,Gerard le Grellelaan 10,2023-08-27,20:00:00,29,26,3,FMN 05 Gerard Le Grellelaan
653,Gerard le Grellelaan 10,2023-08-27,21:00:00,32,22,10,FMN 05 Gerard Le Grellelaan
653,Gerard le Grellelaan 10,2023-08-27,22:00:00,12,11,1,FMN 05 Gerard Le Grellelaan
653,Gerard le Grellelaan 10,2023-08-27,23:00:00,11,10,1,FMN 05 Gerard Le Grellelaan
653,Gerard le Grellelaan 10,2023-08-28,00:00:00,4,2,2,FMN 05 Gerard Le Grellelaan
653,Gerard le Grellelaan 10,2023-08-28,01:00:00,3,1,2,FMN 05 Gerard Le Grellelaan
653,Gerard le Grellelaan 10,2023-08-28,02:00:00,6,5,1,FMN 05 Gerard Le Grellelaan
653,Gerard le Grellelaan 10,2023-08-28,03:00:00,3,3,0,FMN 05 Gerard Le Grellelaan
653,Gerard le Grellelaan 10,2023-08-28,04:00:00,11,3,8,FMN 05 Gerard Le Grellelaan
653,Gerard le Grellelaan 10,2023-08-28,05:00:00,27,11,16,FMN 05 Gerard Le Grellelaan
653,Gerard le Grellelaan 10,2023-08-28,06:00:00,54,22,32,FMN 05 Gerard Le Grellelaan
653,Gerard le Grellelaan 10,2023-08-28,07:00:00,117,82,35,FMN 05 Gerard Le Grellelaan
653,Gerard le Grellelaan 10,2023-08-28,08:00:00,214,187,27,FMN 05 Gerard Le Grellelaan
653,Gerard le Grellelaan 10,2023-08-28,09:00:00,100,91,9,FMN 05 Gerard Le Grellelaan
653,Gerard le Grellelaan 10,2023-08-28,10:00:00,83,76,7,FMN 05 Gerard Le Grellelaan
653,Gerard le Grellelaan 10,2023-08-28,11:00:00,51,37,14,FMN 05 Gerard Le Grellelaan
653,Gerard le Grellelaan 10,2023-08-28,12:00:00,94,72,22,FMN 05 Gerard Le Grellelaan
653,Gerard le Grellelaan 10,2023-08-28,13:00:00,77,63,14,FMN 05 Gerard Le Grellelaan
653,Gerard le Grellelaan 10,2023-08-28,14:00:00,101,84,17,FMN 05 Gerard Le Grellelaan
653,Gerard le Grellelaan 10,2023-08-28,15:00:00,113,95,18,FMN 05 Gerard Le Grellelaan
653,Gerard le Grellelaan 10,2023-08-28,16:00:00,162,132,30,FMN 05 Gerard Le Grellelaan
653,Gerard le Grellelaan 10,2023-08-28,17:00:00,164,137,27,FMN 05 Gerard Le Grellelaan
653,Gerard le Grellelaan 10,2023-08-28,18:00:00,78,60,18,FMN 05 Gerard Le Grellelaan
653,Gerard le Grellelaan 10,2023-08-28,19:00:00,62,50,12,FMN 05 Gerard Le Grellelaan
653,Gerard le Grellelaan 10,2023-08-28,20:00:00,47,37,10,FMN 05 Gerard Le Grellelaan
653,Gerard le Grellelaan 10,2023-08-28,21:00:00,32,28,4,FMN 05 Gerard Le Grellelaan
653,Gerard le Grellelaan 10,2023-08-28,22:00:00,42,36,6,FMN 05 Gerard Le Grellelaan
653,Gerard le Grellelaan 10,2023-08-28,23:00:00,11,8,3,FMN 05 Gerard Le Grellelaan
653,Gerard le Grellelaan 10,2023-08-29,00:00:00,3,2,1,FMN 05 Gerard Le Grellelaan
653,Gerard le Grellelaan 10,2023-08-29,01:00:00,4,3,1,FMN 05 Gerard Le Grellelaan
653,Gerard le Grellelaan 10,2023-08-29,02:00:00,4,4,0,FMN 05 Gerard Le Grellelaan
653,Gerard le Grellelaan 10,2023-08-29,03:00:00,0,0,0,FMN 05 Gerard Le Grellelaan
653,Gerard le Grellelaan 10,2023-08-29,04:00:00,15,6,9,FMN 05 Gerard Le Grellelaan
653,Gerard le Grellelaan 10,2023-08-29,05:00:00,26,9,17,FMN 05 Gerard Le Grellelaan
653,Gerard le Grellelaan 10,2023-08-29,06:00:00,62,35,27,FMN 05 Gerard Le Grellelaan
653,Gerard le Grellelaan 10,2023-08-29,07:00:00,140,99,41,FMN 05 Gerard Le Grellelaan
653,Gerard le Grellelaan 10,2023-08-29,08:00:00,252,211,41,FMN 05 Gerard Le Grellelaan
653,Gerard le Grellelaan 10,2023-08-29,09:00:00,126,111,15,FMN 05 Gerard Le Grellelaan
653,Gerard le Grellelaan 10,2023-08-29,10:00:00,73,62,11,FMN 05 Gerard Le Grellelaan
653,Gerard le Grellelaan 10,2023-08-29,11:00:00,75,64,11,FMN 05 Gerard Le Grellelaan
653,Gerard le Grellelaan 10,2023-08-29,12:00:00,0,0,0,FMN 05 Gerard Le Grellelaan
653,Gerard le Grellelaan 10,2023-08-29,13:00:00,0,0,0,FMN 05 Gerard Le Grellelaan
653,Gerard le Grellelaan 10,2023-08-29,14:00:00,0,0,0,FMN 05 Gerard Le Grellelaan
653,Gerard le Grellelaan 10,2023-08-29,15:00:00,0,0,0,FMN 05 Gerard Le Grellelaan
653,Gerard le Grellelaan 10,2023-08-29,16:00:00,0,0,0,FMN 05 Gerard Le Grellelaan
653,Gerard le Grellelaan 10,2023-08-29,17:00:00,0,0,0,FMN 05 Gerard Le Grellelaan
653,Gerard le Grellelaan 10,2023-08-29,18:00:00,0,0,0,FMN 05 Gerard Le Grellelaan
653,Gerard le Grellelaan 10,2023-08-29,19:00:00,0,0,0,FMN 05 Gerard Le Grellelaan
653,Gerard le Grellelaan 10,2023-08-29,20:00:00,0,0,0,FMN 05 Gerard Le Grellelaan
653,Gerard le Grellelaan 10,2023-08-29,21:00:00,0,0,0,FMN 05 Gerard Le Grellelaan
653,Gerard le Grellelaan 10,2023-08-29,22:00:00,0,0,0,FMN 05 Gerard Le Grellelaan
653,Gerard le Grellelaan 10,2023-08-29,23:00:00,0,0,0,FMN 05 Gerard Le Grellelaan
653,Gerard le Grellelaan 10,2023-08-30,00:00:00,0,0,0,FMN 05 Gerard Le Grellelaan
653,Gerard le Grellelaan 10,2023-08-30,01:00:00,0,0,0,FMN 05 Gerard Le Grellelaan
653,Gerard le Grellelaan 10,2023-08-30,02:00:00,0,0,0,FMN 05 Gerard Le Grellelaan
653,Gerard le Grellelaan 10,2023-08-30,03:00:00,0,0,0,FMN 05 Gerard Le Grellelaan
653,Gerard le Grellelaan 10,2023-08-30,04:00:00,0,0,0,FMN 05 Gerard Le Grellelaan
653,Gerard le Grellelaan 10,2023-08-30,05:00:00,0,0,0,FMN 05 Gerard Le Grellelaan
653,Gerard le Grellelaan 10,2023-08-30,06:00:00,0,0,0,FMN 05 Gerard Le Grellelaan
653,Gerard le Grellelaan 10,2023-08-30,07:00:00,0,0,0,FMN 05 Gerard Le Grellelaan
653,Gerard le Grellelaan 10,2023-08-30,08:00:00,104,91,13,FMN 05 Gerard Le Grellelaan
653,Gerard le Grellelaan 10,2023-08-30,09:00:00,46,41,5,FMN 05 Gerard Le Grellelaan
653,Gerard le Grellelaan 10,2023-08-30,10:00:00,33,28,5,FMN 05 Gerard Le Grellelaan
653,Gerard le Grellelaan 10,2023-08-30,11:00:00,39,30,9,FMN 05 Gerard Le Grellelaan
653,Gerard le Grellelaan 10,2023-08-30,12:00:00,28,23,5,FMN 05 Gerard Le Grellelaan
653,Gerard le Grellelaan 10,2023-08-30,13:00:00,22,14,8,FMN 05 Gerard Le Grellelaan
653,Gerard le Grellelaan 10,2023-08-30,14:00:00,45,38,7,FMN 05 Gerard Le Grellelaan
653,Gerard le Grellelaan 10,2023-08-30,15:00:00,55,46,9,FMN 05 Gerard Le Grellelaan
653,Gerard le Grellelaan 10,2023-08-30,16:00:00,72,55,17,FMN 05 Gerard Le Grellelaan
653,Gerard le Grellelaan 10,2023-08-30,17:00:00,135,108,27,FMN 05 Gerard Le Grellelaan
653,Gerard le Grellelaan 10,2023-08-30,18:00:00,92,69,23,FMN 05 Gerard Le Grellelaan
653,Gerard le Grellelaan 10,2023-08-30,19:00:00,70,53,17,FMN 05 Gerard Le Grellelaan
653,Gerard le Grellelaan 10,2023-08-30,20:00:00,66,58,8,FMN 05 Gerard Le Grellelaan
653,Gerard le Grellelaan 10,2023-08-30,21:00:00,48,42,6,FMN 05 Gerard Le Grellelaan
653,Gerard le Grellelaan 10,2023-08-30,22:00:00,47,43,4,FMN 05 Gerard Le Grellelaan
653,Gerard le Grellelaan 10,2023-08-30,23:00:00,8,7,1,FMN 05 Gerard Le Grellelaan
653,Gerard le Grellelaan 10,2023-08-31,00:00:00,9,8,1,FMN 05 Gerard Le Grellelaan
653,Gerard le Grellelaan 10,2023-08-31,01:00:00,3,2,1,FMN 05 Gerard Le Grellelaan
653,Gerard le Grellelaan 10,2023-08-31,02:00:00,2,1,1,FMN 05 Gerard Le Grellelaan
653,Gerard le Grellelaan 10,2023-08-31,03:00:00,5,2,3,FMN 05 Gerard Le Grellelaan
653,Gerard le Grellelaan 10,2023-08-31,04:00:00,6,2,4,FMN 05 Gerard Le Grellelaan
653,Gerard le Grellelaan 10,2023-08-31,05:00:00,23,8,15,FMN 05 Gerard Le Grellelaan
653,Gerard le Grellelaan 10,2023-08-31,06:00:00,54,26,28,FMN 05 Gerard Le Grellelaan
653,Gerard le Grellelaan 10,2023-08-31,07:00:00,98,69,29,FMN 05 Gerard Le Grellelaan
653,Gerard le Grellelaan 10,2023-08-31,08:00:00,201,176,25,FMN 05 Gerard Le Grellelaan
653,Gerard le Grellelaan 10,2023-08-31,09:00:00,121,105,16,FMN 05 Gerard Le Grellelaan
653,Gerard le Grellelaan 10,2023-08-31,10:00:00,42,37,5,FMN 05 Gerard Le Grellelaan
653,Gerard le Grellelaan 10,2023-08-31,11:00:00,83,63,20,FMN 05 Gerard Le Grellelaan
653,Gerard le Grellelaan 10,2023-08-31,12:00:00,80,64,16,FMN 05 Gerard Le Grellelaan
653,Gerard le Grellelaan 10,2023-08-31,13:00:00,32,24,8,FMN 05 Gerard Le Grellelaan
653,Gerard le Grellelaan 10,2023-08-31,14:00:00,11,9,2,FMN 05 Gerard Le Grellelaan
653,Gerard le Grellelaan 10,2023-08-31,15:00:00,34,27,7,FMN 05 Gerard Le Grellelaan
653,Gerard le Grellelaan 10,2023-08-31,16:00:00,95,84,11,FMN 05 Gerard Le Grellelaan
653,Gerard le Grellelaan 10,2023-08-31,17:00:00,164,132,32,FMN 05 Gerard Le Grellelaan
653,Gerard le Grellelaan 10,2023-08-31,18:00:00,121,94,27,FMN 05 Gerard Le Grellelaan
653,Gerard le Grellelaan 10,2023-08-31,19:00:00,52,40,12,FMN 05 Gerard Le Grellelaan
653,Gerard le Grellelaan 10,2023-08-31,20:00:00,0,0,0,FMN 05 Gerard Le Grellelaan
653,Gerard le Grellelaan 10,2023-08-31,21:00:00,0,0,0,FMN 05 Gerard Le Grellelaan
653,Gerard le Grellelaan 10,2023-08-31,22:00:00,0,0,0,FMN 05 Gerard Le Grellelaan
653,Gerard le Grellelaan 10,2023-08-31,23:00:00,0,0,0,FMN 05 Gerard Le Grellelaan
653,Gerard le Grellelaan 10,2023-09-01,00:00:00,0,0,0,FMN 05 Gerard Le Grellelaan
653,Gerard le Grellelaan 10,2023-09-01,01:00:00,0,0,0,FMN 05 Gerard Le Grellelaan
653,Gerard le Grellelaan 10,2023-09-01,02:00:00,0,0,0,FMN 05 Gerard Le Grellelaan
653,Gerard le Grellelaan 10,2023-09-01,03:00:00,0,0,0,FMN 05 Gerard Le Grellelaan
653,Gerard le Grellelaan 10,2023-09-01,04:00:00,0,0,0,FMN 05 Gerard Le Grellelaan
653,Gerard le Grellelaan 10,2023-09-01,05:00:00,0,0,0,FMN 05 Gerard Le Grellelaan
653,Gerard le Grellelaan 10,2023-09-01,06:00:00,0,0,0,FMN 05 Gerard Le Grellelaan
653,Gerard le Grellelaan 10,2023-09-01,07:00:00,0,0,0,FMN 05 Gerard Le Grellelaan
653,Gerard le Grellelaan 10,2023-09-01,08:00:00,0,0,0,FMN 05 Gerard Le Grellelaan
653,Gerard le Grellelaan 10,2023-09-01,09:00:00,0,0,0,FMN 05 Gerard Le Grellelaan
653,Gerard le Grellelaan 10,2023-09-01,10:00:00,0,0,0,FMN 05 Gerard Le Grellelaan
653,Gerard le Grellelaan 10,2023-09-01,11:00:00,0,0,0,FMN 05 Gerard Le Grellelaan
653,Gerard le Grellelaan 10,2023-09-01,12:00:00,0,0,0,FMN 05 Gerard Le Grellelaan
653,Gerard le Grellelaan 10,2023-09-01,13:00:00,5,5,0,FMN 05 Gerard Le Grellelaan
653,Gerard le Grellelaan 10,2023-09-01,14:00:00,94,70,24,FMN 05 Gerard Le Grellelaan
653,Gerard le Grellelaan 10,2023-09-01,15:00:00,164,128,36,FMN 05 Gerard Le Grellelaan
653,Gerard le Grellelaan 10,2023-09-01,16:00:00,143,115,28,FMN 05 Gerard Le Grellelaan
653,Gerard le Grellelaan 10,2023-09-01,17:00:00,155,122,33,FMN 05 Gerard Le Grellelaan
653,Gerard le Grellelaan 10,2023-09-01,18:00:00,119,95,24,FMN 05 Gerard Le Grellelaan
653,Gerard le Grellelaan 10,2023-09-01,19:00:00,103,80,23,FMN 05 Gerard Le Grellelaan
653,Gerard le Grellelaan 10,2023-09-01,20:00:00,76,63,13,FMN 05 Gerard Le Grellelaan
653,Gerard le Grellelaan 10,2023-09-01,21:00:00,33,29,4,FMN 05 Gerard Le Grellelaan
653,Gerard le Grellelaan 10,2023-09-01,22:00:00,47,40,7,FMN 05 Gerard Le Grellelaan
653,Gerard le Grellelaan 10,2023-09-01,23:00:00,20,15,5,FMN 05 Gerard Le Grellelaan
653,Gerard le Grellelaan 10,2023-09-02,00:00:00,16,13,3,FMN 05 Gerard Le Grellelaan
653,Gerard le Grellelaan 10,2023-09-02,01:00:00,10,6,4,FMN 05 Gerard Le Grellelaan
653,Gerard le Grellelaan 10,2023-09-02,02:00:00,8,3,5,FMN 05 Gerard Le Grellelaan
653,Gerard le Grellelaan 10,2023-09-02,03:00:00,6,3,3,FMN 05 Gerard Le Grellelaan
653,Gerard le Grellelaan 10,2023-09-02,04:00:00,6,2,4,FMN 05 Gerard Le Grellelaan
653,Gerard le Grellelaan 10,2023-09-02,05:00:00,7,4,3,FMN 05 Gerard Le Grellelaan
653,Gerard le Grellelaan 10,2023-09-02,06:00:00,10,5,5,FMN 05 Gerard Le Grellelaan
653,Gerard le Grellelaan 10,2023-09-02,07:00:00,21,16,5,FMN 05 Gerard Le Grellelaan
653,Gerard le Grellelaan 10,2023-09-02,08:00:00,37,26,11,FMN 05 Gerard Le Grellelaan
653,Gerard le Grellelaan 10,2023-09-02,09:00:00,73,62,11,FMN 05 Gerard Le Grellelaan
653,Gerard le Grellelaan 10,2023-09-02,10:00:00,91,78,13,FMN 05 Gerard Le Grellelaan
653,Gerard le Grellelaan 10,2023-09-02,11:00:00,91,80,11,FMN 05 Gerard Le Grellelaan
653,Gerard le Grellelaan 10,2023-09-02,12:00:00,76,63,13,FMN 05 Gerard Le Grellelaan
653,Gerard le Grellelaan 10,2023-09-02,13:00:00,86,72,14,FMN 05 Gerard Le Grellelaan
653,Gerard le Grellelaan 10,2023-09-02,14:00:00,101,82,19,FMN 05 Gerard Le Grellelaan
653,Gerard le Grellelaan 10,2023-09-02,15:00:00,78,64,14,FMN 05 Gerard Le Grellelaan
653,Gerard le Grellelaan 10,2023-09-02,16:00:00,99,81,18,FMN 05 Gerard Le Grellelaan
653,Gerard le Grellelaan 10,2023-09-02,17:00:00,93,73,20,FMN 05 Gerard Le Grellelaan
653,Gerard le Grellelaan 10,2023-09-02,18:00:00,107,93,14,FMN 05 Gerard Le Grellelaan
653,Gerard le Grellelaan 10,2023-09-02,19:00:00,70,51,19,FMN 05 Gerard Le Grellelaan
653,Gerard le Grellelaan 10,2023-09-02,20:00:00,52,42,10,FMN 05 Gerard Le Grellelaan
653,Gerard le Grellelaan 10,2023-09-02,21:00:00,32,29,3,FMN 05 Gerard Le Grellelaan
653,Gerard le Grellelaan 10,2023-09-02,22:00:00,41,31,10,FMN 05 Gerard Le Grellelaan
653,Gerard le Grellelaan 10,2023-09-02,23:00:00,29,20,9,FMN 05 Gerard Le Grellelaan
653,Gerard le Grellelaan 10,2023-09-03,00:00:00,23,17,6,FMN 05 Gerard Le Grellelaan
653,Gerard le Grellelaan 10,2023-09-03,01:00:00,12,6,6,FMN 05 Gerard Le Grellelaan
653,Gerard le Grellelaan 10,2023-09-03,02:00:00,8,6,2,FMN 05 Gerard Le Grellelaan
653,Gerard le Grellelaan 10,2023-09-03,03:00:00,7,6,1,FMN 05 Gerard Le Grellelaan
653,Gerard le Grellelaan 10,2023-09-03,04:00:00,2,1,1,FMN 05 Gerard Le Grellelaan
653,Gerard le Grellelaan 10,2023-09-03,05:00:00,6,2,4,FMN 05 Gerard Le Grellelaan
653,Gerard le Grellelaan 10,2023-09-03,06:00:00,5,4,1,FMN 05 Gerard Le Grellelaan
653,Gerard le Grellelaan 10,2023-09-03,07:00:00,11,10,1,FMN 05 Gerard Le Grellelaan
653,Gerard le Grellelaan 10,2023-09-03,08:00:00,19,11,8,FMN 05 Gerard Le Grellelaan
653,Gerard le Grellelaan 10,2023-09-03,09:00:00,57,50,7,FMN 05 Gerard Le Grellelaan
653,Gerard le Grellelaan 10,2023-09-03,10:00:00,91,75,16,FMN 05 Gerard Le Grellelaan
653,Gerard le Grellelaan 10,2023-09-03,11:00:00,104,83,21,FMN 05 Gerard Le Grellelaan
653,Gerard le Grellelaan 10,2023-09-03,12:00:00,88,81,7,FMN 05 Gerard Le Grellelaan
653,Gerard le Grellelaan 10,2023-09-03,13:00:00,91,76,15,FMN 05 Gerard Le Grellelaan
653,Gerard le Grellelaan 10,2023-09-03,14:00:00,82,60,22,FMN 05 Gerard Le Grellelaan
653,Gerard le Grellelaan 10,2023-09-03,15:00:00,83,70,13,FMN 05 Gerard Le Grellelaan
653,Gerard le Grellelaan 10,2023-09-03,16:00:00,19,15,4,FMN 05 Gerard Le Grellelaan
653,Gerard le Grellelaan 10,2023-09-03,17:00:00,73,59,14,FMN 05 Gerard Le Grellelaan
653,Gerard le Grellelaan 10,2023-09-03,18:00:00,123,102,21,FMN 05 Gerard Le Grellelaan
653,Gerard le Grellelaan 10,2023-09-03,19:00:00,61,54,7,FMN 05 Gerard Le Grellelaan
653,Gerard le Grellelaan 10,2023-09-03,20:00:00,56,43,13,FMN 05 Gerard Le Grellelaan
653,Gerard le Grellelaan 10,2023-09-03,21:00:00,42,39,3,FMN 05 Gerard Le Grellelaan
653,Gerard le Grellelaan 10,2023-09-03,22:00:00,20,19,1,FMN 05 Gerard Le Grellelaan
653,Gerard le Grellelaan 10,2023-09-03,23:00:00,12,10,2,FMN 05 Gerard Le Grellelaan
653,Gerard le Grellelaan 10,2023-09-04,00:00:00,9,6,3,FMN 05 Gerard Le Grellelaan
653,Gerard le Grellelaan 10,2023-09-04,01:00:00,1,0,1,FMN 05 Gerard Le Grellelaan
653,Gerard le Grellelaan 10,2023-09-04,02:00:00,3,2,1,FMN 05 Gerard Le Grellelaan
653,Gerard le Grellelaan 10,2023-09-04,03:00:00,2,2,0,FMN 05 Gerard Le Grellelaan
653,Gerard le Grellelaan 10,2023-09-04,04:00:00,8,2,6,FMN 05 Gerard Le Grellelaan
653,Gerard le Grellelaan 10,2023-09-04,05:00:00,32,9,23,FMN 05 Gerard Le Grellelaan
653,Gerard le Grellelaan 10,2023-09-04,06:00:00,70,39,31,FMN 05 Gerard Le Grellelaan
653,Gerard le Grellelaan 10,2023-09-04,07:00:00,195,154,41,FMN 05 Gerard Le Grellelaan
653,Gerard le Grellelaan 10,2023-09-04,08:00:00,374,314,60,FMN 05 Gerard Le Grellelaan
653,Gerard le Grellelaan 10,2023-09-04,09:00:00,129,114,15,FMN 05 Gerard Le Grellelaan
653,Gerard le Grellelaan 10,2023-09-04,10:00:00,95,81,14,FMN 05 Gerard Le Grellelaan
653,Gerard le Grellelaan 10,2023-09-04,11:00:00,60,53,7,FMN 05 Gerard Le Grellelaan
653,Gerard le Grellelaan 10,2023-09-04,12:00:00,105,86,19,FMN 05 Gerard Le Grellelaan
653,Gerard le Grellelaan 10,2023-09-04,13:00:00,81,69,12,FMN 05 Gerard Le Grellelaan
653,Gerard le Grellelaan 10,2023-09-04,14:00:00,15,11,4,FMN 05 Gerard Le Grellelaan
653,Gerard le Grellelaan 10,2023-09-04,15:00:00,7,7,0,FMN 05 Gerard Le Grellelaan
653,Gerard le Grellelaan 10,2023-09-04,16:00:00,77,59,18,FMN 05 Gerard Le Grellelaan
653,Gerard le Grellelaan 10,2023-09-04,17:00:00,214,167,47,FMN 05 Gerard Le Grellelaan
653,Gerard le Grellelaan 10,2023-09-04,18:00:00,179,152,27,FMN 05 Gerard Le Grellelaan
653,Gerard le Grellelaan 10,2023-09-04,19:00:00,113,88,25,FMN 05 Gerard Le Grellelaan
653,Gerard le Grellelaan 10,2023-09-04,20:00:00,83,75,8,FMN 05 Gerard Le Grellelaan
653,Gerard le Grellelaan 10,2023-09-04,21:00:00,55,44,11,FMN 05 Gerard Le Grellelaan
653,Gerard le Grellelaan 10,2023-09-04,22:00:00,43,37,6,FMN 05 Gerard Le Grellelaan
653,Gerard le Grellelaan 10,2023-09-04,23:00:00,12,9,3,FMN 05 Gerard Le Grellelaan
653,Gerard le Grellelaan 10,2023-09-05,00:00:00,7,6,1,FMN 05 Gerard Le Grellelaan
653,Gerard le Grellelaan 10,2023-09-05,01:00:00,2,1,1,FMN 05 Gerard Le Grellelaan
653,Gerard le Grellelaan 10,2023-09-05,02:00:00,4,2,2,FMN 05 Gerard Le Grellelaan
653,Gerard le Grellelaan 10,2023-09-05,03:00:00,3,2,1,FMN 05 Gerard Le Grellelaan
653,Gerard le Grellelaan 10,2023-09-05,04:00:00,9,4,5,FMN 05 Gerard Le Grellelaan
653,Gerard le Grellelaan 10,2023-09-05,05:00:00,32,9,23,FMN 05 Gerard Le Grellelaan
653,Gerard le Grellelaan 10,2023-09-05,06:00:00,78,38,40,FMN 05 Gerard Le Grellelaan
653,Gerard le Grellelaan 10,2023-09-05,07:00:00,224,177,47,FMN 05 Gerard Le Grellelaan
653,Gerard le Grellelaan 10,2023-09-05,08:00:00,381,320,61,FMN 05 Gerard Le Grellelaan
653,Gerard le Grellelaan 10,2023-09-05,09:00:00,122,108,14,FMN 05 Gerard Le Grellelaan
653,Gerard le Grellelaan 10,2023-09-05,10:00:00,93,78,15,FMN 05 Gerard Le Grellelaan
653,Gerard le Grellelaan 10,2023-09-05,11:00:00,94,78,16,FMN 05 Gerard Le Grellelaan
653,Gerard le Grellelaan 10,2023-09-05,12:00:00,122,94,28,FMN 05 Gerard Le Grellelaan
653,Gerard le Grellelaan 10,2023-09-05,13:00:00,126,98,28,FMN 05 Gerard Le Grellelaan
653,Gerard le Grellelaan 10,2023-09-05,14:00:00,122,96,26,FMN 05 Gerard Le Grellelaan
653,Gerard le Grellelaan 10,2023-09-05,15:00:00,194,154,40,FMN 05 Gerard Le Grellelaan
653,Gerard le Grellelaan 10,2023-09-05,16:00:00,239,190,49,FMN 05 Gerard Le Grellelaan
653,Gerard le Grellelaan 10,2023-09-05,17:00:00,288,218,70,FMN 05 Gerard Le Grellelaan
653,Gerard le Grellelaan 10,2023-09-05,18:00:00,187,155,32,FMN 05 Gerard Le Grellelaan
653,Gerard le Grellelaan 10,2023-09-05,19:00:00,100,76,24,FMN 05 Gerard Le Grellelaan
653,Gerard le Grellelaan 10,2023-09-05,20:00:00,107,95,12,FMN 05 Gerard Le Grellelaan
653,Gerard le Grellelaan 10,2023-09-05,21:00:00,60,49,11,FMN 05 Gerard Le Grellelaan
653,Gerard le Grellelaan 10,2023-09-05,22:00:00,50,43,7,FMN 05 Gerard Le Grellelaan
653,Gerard le Grellelaan 10,2023-09-05,23:00:00,25,14,11,FMN 05 Gerard Le Grellelaan
653,Gerard le Grellelaan 10,2023-09-06,00:00:00,9,8,1,FMN 05 Gerard Le Grellelaan
653,Gerard le Grellelaan 10,2023-09-06,01:00:00,6,5,1,FMN 05 Gerard Le Grellelaan
653,Gerard le Grellelaan 10,2023-09-06,02:00:00,2,0,2,FMN 05 Gerard Le Grellelaan
653,Gerard le Grellelaan 10,2023-09-06,03:00:00,4,3,1,FMN 05 Gerard Le Grellelaan
653,Gerard le Grellelaan 10,2023-09-06,04:00:00,5,1,4,FMN 05 Gerard Le Grellelaan
653,Gerard le Grellelaan 10,2023-09-06,05:00:00,32,12,20,FMN 05 Gerard Le Grellelaan
653,Gerard le Grellelaan 10,2023-09-06,06:00:00,71,40,31,FMN 05 Gerard Le Grellelaan
653,Gerard le Grellelaan 10,2023-09-06,07:00:00,204,155,49,FMN 05 Gerard Le Grellelaan
653,Gerard le Grellelaan 10,2023-09-06,08:00:00,346,303,43,FMN 05 Gerard Le Grellelaan
653,Gerard le Grellelaan 10,2023-09-06,09:00:00,119,105,14,FMN 05 Gerard Le Grellelaan
653,Gerard le Grellelaan 10,2023-09-06,10:00:00,78,63,15,FMN 05 Gerard Le Grellelaan
653,Gerard le Grellelaan 10,2023-09-06,11:00:00,81,63,18,FMN 05 Gerard Le Grellelaan
653,Gerard le Grellelaan 10,2023-09-06,12:00:00,172,132,40,FMN 05 Gerard Le Grellelaan
653,Gerard le Grellelaan 10,2023-09-06,13:00:00,116,85,31,FMN 05 Gerard Le Grellelaan
653,Gerard le Grellelaan 10,2023-09-06,14:00:00,125,98,27,FMN 05 Gerard Le Grellelaan
653,Gerard le Grellelaan 10,2023-09-06,15:00:00,150,130,20,FMN 05 Gerard Le Grellelaan
653,Gerard le Grellelaan 10,2023-09-06,16:00:00,190,150,40,FMN 05 Gerard Le Grellelaan
653,Gerard le Grellelaan 10,2023-09-06,17:00:00,258,204,54,FMN 05 Gerard Le Grellelaan
653,Gerard le Grellelaan 10,2023-09-06,18:00:00,166,129,37,FMN 05 Gerard Le Grellelaan
653,Gerard le Grellelaan 10,2023-09-06,19:00:00,130,106,24,FMN 05 Gerard Le Grellelaan
653,Gerard le Grellelaan 10,2023-09-06,20:00:00,95,77,18,FMN 05 Gerard Le Grellelaan
653,Gerard le Grellelaan 10,2023-09-06,21:00:00,59,48,11,FMN 05 Gerard Le Grellelaan
653,Gerard le Grellelaan 10,2023-09-06,22:00:00,62,57,5,FMN 05 Gerard Le Grellelaan
653,Gerard le Grellelaan 10,2023-09-06,23:00:00,26,18,8,FMN 05 Gerard Le Grellelaan
653,Gerard le Grellelaan 10,2023-09-07,00:00:00,4,3,1,FMN 05 Gerard Le Grellelaan
653,Gerard le Grellelaan 10,2023-09-07,01:00:00,3,2,1,FMN 05 Gerard Le Grellelaan
653,Gerard le Grellelaan 10,2023-09-07,02:00:00,1,0,1,FMN 05 Gerard Le Grellelaan
653,Gerard le Grellelaan 10,2023-09-07,03:00:00,3,3,0,FMN 05 Gerard Le Grellelaan
653,Gerard le Grellelaan 10,2023-09-07,04:00:00,9,3,6,FMN 05 Gerard Le Grellelaan
653,Gerard le Grellelaan 10,2023-09-07,05:00:00,30,7,23,FMN 05 Gerard Le Grellelaan
653,Gerard le Grellelaan 10,2023-09-07,06:00:00,59,30,29,FMN 05 Gerard Le Grellelaan
653,Gerard le Grellelaan 10,2023-09-07,07:00:00,202,149,53,FMN 05 Gerard Le Grellelaan
653,Gerard le Grellelaan 10,2023-09-07,08:00:00,397,341,56,FMN 05 Gerard Le Grellelaan
653,Gerard le Grellelaan 10,2023-09-07,09:00:00,144,130,14,FMN 05 Gerard Le Grellelaan
653,Gerard le Grellelaan 10,2023-09-07,10:00:00,100,85,15,FMN 05 Gerard Le Grellelaan
653,Gerard le Grellelaan 10,2023-09-07,11:00:00,97,81,16,FMN 05 Gerard Le Grellelaan
653,Gerard le Grellelaan 10,2023-09-07,12:00:00,114,85,29,FMN 05 Gerard Le Grellelaan
653,Gerard le Grellelaan 10,2023-09-07,13:00:00,109,86,23,FMN 05 Gerard Le Grellelaan
653,Gerard le Grellelaan 10,2023-09-07,14:00:00,97,81,16,FMN 05 Gerard Le Grellelaan
653,Gerard le Grellelaan 10,2023-09-07,15:00:00,166,132,34,FMN 05 Gerard Le Grellelaan
653,Gerard le Grellelaan 10,2023-09-07,16:00:00,224,176,48,FMN 05 Gerard Le Grellelaan
653,Gerard le Grellelaan 10,2023-09-07,17:00:00,250,187,63,FMN 05 Gerard Le Grellelaan
653,Gerard le Grellelaan 10,2023-09-07,18:00:00,197,157,40,FMN 05 Gerard Le Grellelaan
653,Gerard le Grellelaan 10,2023-09-07,19:00:00,130,109,21,FMN 05 Gerard Le Grellelaan
653,Gerard le Grellelaan 10,2023-09-07,20:00:00,87,66,21,FMN 05 Gerard Le Grellelaan
653,Gerard le Grellelaan 10,2023-09-07,21:00:00,65,49,16,FMN 05 Gerard Le Grellelaan
653,Gerard le Grellelaan 10,2023-09-07,22:00:00,56,44,12,FMN 05 Gerard Le Grellelaan
653,Gerard le Grellelaan 10,2023-09-07,23:00:00,28,22,6,FMN 05 Gerard Le Grellelaan
653,Gerard le Grellelaan 10,2023-09-08,00:00:00,17,17,0,FMN 05 Gerard Le Grellelaan
653,Gerard le Grellelaan 10,2023-09-08,01:00:00,3,3,0,FMN 05 Gerard Le Grellelaan
653,Gerard le Grellelaan 10,2023-09-08,02:00:00,1,1,0,FMN 05 Gerard Le Grellelaan
653,Gerard le Grellelaan 10,2023-09-08,03:00:00,5,5,0,FMN 05 Gerard Le Grellelaan
653,Gerard le Grellelaan 10,2023-09-08,04:00:00,6,1,5,FMN 05 Gerard Le Grellelaan
653,Gerard le Grellelaan 10,2023-09-08,05:00:00,35,16,19,FMN 05 Gerard Le Grellelaan
653,Gerard le Grellelaan 10,2023-09-08,06:00:00,57,27,30,FMN 05 Gerard Le Grellelaan
653,Gerard le Grellelaan 10,2023-09-08,07:00:00,155,118,37,FMN 05 Gerard Le Grellelaan
653,Gerard le Grellelaan 10,2023-09-08,08:00:00,338,285,53,FMN 05 Gerard Le Grellelaan
653,Gerard le Grellelaan 10,2023-09-08,09:00:00,135,123,12,FMN 05 Gerard Le Grellelaan
653,Gerard le Grellelaan 10,2023-09-08,10:00:00,89,72,17,FMN 05 Gerard Le Grellelaan
653,Gerard le Grellelaan 10,2023-09-08,11:00:00,91,80,11,FMN 05 Gerard Le Grellelaan
653,Gerard le Grellelaan 10,2023-09-08,12:00:00,119,93,26,FMN 05 Gerard Le Grellelaan
653,Gerard le Grellelaan 10,2023-09-08,13:00:00,93,62,31,FMN 05 Gerard Le Grellelaan
653,Gerard le Grellelaan 10,2023-09-08,14:00:00,114,96,18,FMN 05 Gerard Le Grellelaan
653,Gerard le Grellelaan 10,2023-09-08,15:00:00,183,140,43,FMN 05 Gerard Le Grellelaan
653,Gerard le Grellelaan 10,2023-09-08,16:00:00,200,160,40,FMN 05 Gerard Le Grellelaan
653,Gerard le Grellelaan 10,2023-09-08,17:00:00,213,165,48,FMN 05 Gerard Le Grellelaan
653,Gerard le Grellelaan 10,2023-09-08,18:00:00,175,141,34,FMN 05 Gerard Le Grellelaan
653,Gerard le Grellelaan 10,2023-09-08,19:00:00,130,116,14,FMN 05 Gerard Le Grellelaan
653,Gerard le Grellelaan 10,2023-09-08,20:00:00,81,69,12,FMN 05 Gerard Le Grellelaan
653,Gerard le Grellelaan 10,2023-09-08,21:00:00,64,45,19,FMN 05 Gerard Le Grellelaan
653,Gerard le Grellelaan 10,2023-09-08,22:00:00,72,59,13,FMN 05 Gerard Le Grellelaan
653,Gerard le Grellelaan 10,2023-09-08,23:00:00,41,32,9,FMN 05 Gerard Le Grellelaan
653,Gerard le Grellelaan 10,2023-09-09,00:00:00,25,22,3,FMN 05 Gerard Le Grellelaan
653,Gerard le Grellelaan 10,2023-09-09,01:00:00,28,21,7,FMN 05 Gerard Le Grellelaan
653,Gerard le Grellelaan 10,2023-09-09,02:00:00,36,34,2,FMN 05 Gerard Le Grellelaan
653,Gerard le Grellelaan 10,2023-09-09,03:00:00,10,8,2,FMN 05 Gerard Le Grellelaan
653,Gerard le Grellelaan 10,2023-09-09,04:00:00,6,2,4,FMN 05 Gerard Le Grellelaan
653,Gerard le Grellelaan 10,2023-09-09,05:00:00,5,4,1,FMN 05 Gerard Le Grellelaan
653,Gerard le Grellelaan 10,2023-09-09,06:00:00,11,7,4,FMN 05 Gerard Le Grellelaan
653,Gerard le Grellelaan 10,2023-09-09,07:00:00,18,15,3,FMN 05 Gerard Le Grellelaan
653,Gerard le Grellelaan 10,2023-09-09,08:00:00,48,34,14,FMN 05 Gerard Le Grellelaan
653,Gerard le Grellelaan 10,2023-09-09,09:00:00,67,56,11,FMN 05 Gerard Le Grellelaan
653,Gerard le Grellelaan 10,2023-09-09,10:00:00,86,69,17,FMN 05 Gerard Le Grellelaan
653,Gerard le Grellelaan 10,2023-09-09,11:00:00,97,75,22,FMN 05 Gerard Le Grellelaan
653,Gerard le Grellelaan 10,2023-09-09,12:00:00,122,100,22,FMN 05 Gerard Le Grellelaan
653,Gerard le Grellelaan 10,2023-09-09,13:00:00,93,76,17,FMN 05 Gerard Le Grellelaan
653,Gerard le Grellelaan 10,2023-09-09,14:00:00,95,80,15,FMN 05 Gerard Le Grellelaan
653,Gerard le Grellelaan 10,2023-09-09,15:00:00,99,73,26,FMN 05 Gerard Le Grellelaan
653,Gerard le Grellelaan 10,2023-09-09,16:00:00,101,83,18,FMN 05 Gerard Le Grellelaan
653,Gerard le Grellelaan 10,2023-09-09,17:00:00,64,54,10,FMN 05 Gerard Le Grellelaan
653,Gerard le Grellelaan 10,2023-09-09,18:00:00,93,73,20,FMN 05 Gerard Le Grellelaan
653,Gerard le Grellelaan 10,2023-09-09,19:00:00,90,81,9,FMN 05 Gerard Le Grellelaan
653,Gerard le Grellelaan 10,2023-09-09,20:00:00,65,50,15,FMN 05 Gerard Le Grellelaan
653,Gerard le Grellelaan 10,2023-09-09,21:00:00,40,36,4,FMN 05 Gerard Le Grellelaan
653,Gerard le Grellelaan 10,2023-09-09,22:00:00,44,33,11,FMN 05 Gerard Le Grellelaan
653,Gerard le Grellelaan 10,2023-09-09,23:00:00,29,25,4,FMN 05 Gerard Le Grellelaan
653,Gerard le Grellelaan 10,2023-09-10,00:00:00,26,15,11,FMN 05 Gerard Le Grellelaan
653,Gerard le Grellelaan 10,2023-09-10,01:00:00,17,10,7,FMN 05 Gerard Le Grellelaan
653,Gerard le Grellelaan 10,2023-09-10,02:00:00,15,14,1,FMN 05 Gerard Le Grellelaan
653,Gerard le Grellelaan 10,2023-09-10,03:00:00,15,12,3,FMN 05 Gerard Le Grellelaan
653,Gerard le Grellelaan 10,2023-09-10,04:00:00,12,10,2,FMN 05 Gerard Le Grellelaan
653,Gerard le Grellelaan 10,2023-09-10,05:00:00,7,4,3,FMN 05 Gerard Le Grellelaan
653,Gerard le Grellelaan 10,2023-09-10,06:00:00,5,5,0,FMN 05 Gerard Le Grellelaan
653,Gerard le Grellelaan 10,2023-09-10,07:00:00,16,12,4,FMN 05 Gerard Le Grellelaan
653,Gerard le Grellelaan 10,2023-09-10,08:00:00,26,18,8,FMN 05 Gerard Le Grellelaan
653,Gerard le Grellelaan 10,2023-09-10,09:00:00,90,76,14,FMN 05 Gerard Le Grellelaan
653,Gerard le Grellelaan 10,2023-09-10,10:00:00,78,62,16,FMN 05 Gerard Le Grellelaan
653,Gerard le Grellelaan 10,2023-09-10,11:00:00,112,102,10,FMN 05 Gerard Le Grellelaan
653,Gerard le Grellelaan 10,2023-09-10,12:00:00,95,78,17,FMN 05 Gerard Le Grellelaan
653,Gerard le Grellelaan 10,2023-09-10,13:00:00,89,73,16,FMN 05 Gerard Le Grellelaan
653,Gerard le Grellelaan 10,2023-09-10,14:00:00,88,75,13,FMN 05 Gerard Le Grellelaan
653,Gerard le Grellelaan 10,2023-09-10,15:00:00,61,48,13,FMN 05 Gerard Le Grellelaan
653,Gerard le Grellelaan 10,2023-09-10,16:00:00,87,73,14,FMN 05 Gerard Le Grellelaan
653,Gerard le Grellelaan 10,2023-09-10,17:00:00,100,82,18,FMN 05 Gerard Le Grellelaan
653,Gerard le Grellelaan 10,2023-09-10,18:00:00,104,84,20,FMN 05 Gerard Le Grellelaan
653,Gerard le Grellelaan 10,2023-09-10,19:00:00,85,69,16,FMN 05 Gerard Le Grellelaan
653,Gerard le Grellelaan 10,2023-09-10,20:00:00,69,57,12,FMN 05 Gerard Le Grellelaan
653,Gerard le Grellelaan 10,2023-09-10,21:00:00,52,39,13,FMN 05 Gerard Le Grellelaan
653,Gerard le Grellelaan 10,2023-09-10,22:00:00,23,17,6,FMN 05 Gerard Le Grellelaan
653,Gerard le Grellelaan 10,2023-09-10,23:00:00,11,9,2,FMN 05 Gerard Le Grellelaan
653,Gerard le Grellelaan 10,2023-09-11,00:00:00,9,5,4,FMN 05 Gerard Le Grellelaan
653,Gerard le Grellelaan 10,2023-09-11,01:00:00,1,1,0,FMN 05 Gerard Le Grellelaan
653,Gerard le Grellelaan 10,2023-09-11,02:00:00,5,3,2,FMN 05 Gerard Le Grellelaan
653,Gerard le Grellelaan 10,2023-09-11,03:00:00,2,1,1,FMN 05 Gerard Le Grellelaan
653,Gerard le Grellelaan 10,2023-09-11,04:00:00,12,4,8,FMN 05 Gerard Le Grellelaan
653,Gerard le Grellelaan 10,2023-09-11,05:00:00,35,12,23,FMN 05 Gerard Le Grellelaan
653,Gerard le Grellelaan 10,2023-09-11,06:00:00,78,41,37,FMN 05 Gerard Le Grellelaan
653,Gerard le Grellelaan 10,2023-09-11,07:00:00,179,131,48,FMN 05 Gerard Le Grellelaan
653,Gerard le Grellelaan 10,2023-09-11,08:00:00,366,303,63,FMN 05 Gerard Le Grellelaan
653,Gerard le Grellelaan 10,2023-09-11,09:00:00,123,110,13,FMN 05 Gerard Le Grellelaan
653,Gerard le Grellelaan 10,2023-09-11,10:00:00,87,74,13,FMN 05 Gerard Le Grellelaan
653,Gerard le Grellelaan 10,2023-09-11,11:00:00,78,62,16,FMN 05 Gerard Le Grellelaan
653,Gerard le Grellelaan 10,2023-09-11,12:00:00,94,71,23,FMN 05 Gerard Le Grellelaan
653,Gerard le Grellelaan 10,2023-09-11,13:00:00,108,82,26,FMN 05 Gerard Le Grellelaan
653,Gerard le Grellelaan 10,2023-09-11,14:00:00,0,0,0,FMN 05 Gerard Le Grellelaan
653,Gerard le Grellelaan 10,2023-09-11,15:00:00,0,0,0,FMN 05 Gerard Le Grellelaan
653,Gerard le Grellelaan 10,2023-09-11,16:00:00,97,75,22,FMN 05 Gerard Le Grellelaan
653,Gerard le Grellelaan 10,2023-09-11,17:00:00,257,185,72,FMN 05 Gerard Le Grellelaan
653,Gerard le Grellelaan 10,2023-09-11,18:00:00,155,110,45,FMN 05 Gerard Le Grellelaan
653,Gerard le Grellelaan 10,2023-09-11,19:00:00,92,67,25,FMN 05 Gerard Le Grellelaan
653,Gerard le Grellelaan 10,2023-09-11,20:00:00,76,60,16,FMN 05 Gerard Le Grellelaan
653,Gerard le Grellelaan 10,2023-09-11,21:00:00,8,5,3,FMN 05 Gerard Le Grellelaan
653,Gerard le Grellelaan 10,2023-09-11,22:00:00,6,5,1,FMN 05 Gerard Le Grellelaan
653,Gerard le Grellelaan 10,2023-09-11,23:00:00,18,15,3,FMN 05 Gerard Le Grellelaan
653,Gerard le Grellelaan 10,2023-09-12,00:00:00,5,3,2,FMN 05 Gerard Le Grellelaan
653,Gerard le Grellelaan 10,2023-09-12,01:00:00,2,2,0,FMN 05 Gerard Le Grellelaan
653,Gerard le Grellelaan 10,2023-09-12,02:00:00,1,1,0,FMN 05 Gerard Le Grellelaan
653,Gerard le Grellelaan 10,2023-09-12,03:00:00,5,3,2,FMN 05 Gerard Le Grellelaan
653,Gerard le Grellelaan 10,2023-09-12,04:00:00,13,6,7,FMN 05 Gerard Le Grellelaan
653,Gerard le Grellelaan 10,2023-09-12,05:00:00,29,14,15,FMN 05 Gerard Le Grellelaan
653,Gerard le Grellelaan 10,2023-09-12,06:00:00,74,32,42,FMN 05 Gerard Le Grellelaan
653,Gerard le Grellelaan 10,2023-09-12,07:00:00,182,143,39,FMN 05 Gerard Le Grellelaan
653,Gerard le Grellelaan 10,2023-09-12,08:00:00,362,299,63,FMN 05 Gerard Le Grellelaan
653,Gerard le Grellelaan 10,2023-09-12,09:00:00,122,105,17,FMN 05 Gerard Le Grellelaan
653,Gerard le Grellelaan 10,2023-09-12,10:00:00,88,77,11,FMN 05 Gerard Le Grellelaan
653,Gerard le Grellelaan 10,2023-09-12,11:00:00,99,82,17,FMN 05 Gerard Le Grellelaan
653,Gerard le Grellelaan 10,2023-09-12,12:00:00,100,82,18,FMN 05 Gerard Le Grellelaan
653,Gerard le Grellelaan 10,2023-09-12,13:00:00,25,22,3,FMN 05 Gerard Le Grellelaan
653,Gerard le Grellelaan 10,2023-09-12,14:00:00,0,0,0,FMN 05 Gerard Le Grellelaan
653,Gerard le Grellelaan 10,2023-09-12,15:00:00,0,0,0,FMN 05 Gerard Le Grellelaan
653,Gerard le Grellelaan 10,2023-09-12,16:00:00,0,0,0,FMN 05 Gerard Le Grellelaan
653,Gerard le Grellelaan 10,2023-09-12,17:00:00,0,0,0,FMN 05 Gerard Le Grellelaan
653,Gerard le Grellelaan 10,2023-09-12,18:00:00,0,0,0,FMN 05 Gerard Le Grellelaan
653,Gerard le Grellelaan 10,2023-09-12,19:00:00,0,0,0,FMN 05 Gerard Le Grellelaan
653,Gerard le Grellelaan 10,2023-09-12,20:00:00,0,0,0,FMN 05 Gerard Le Grellelaan
653,Gerard le Grellelaan 10,2023-09-12,21:00:00,0,0,0,FMN 05 Gerard Le Grellelaan
653,Gerard le Grellelaan 10,2023-09-12,22:00:00,0,0,0,FMN 05 Gerard Le Grellelaan
653,Gerard le Grellelaan 10,2023-09-12,23:00:00,0,0,0,FMN 05 Gerard Le Grellelaan
653,Gerard le Grellelaan 10,2023-09-13,00:00:00,0,0,0,FMN 05 Gerard Le Grellelaan
653,Gerard le Grellelaan 10,2023-09-13,01:00:00,0,0,0,FMN 05 Gerard Le Grellelaan
653,Gerard le Grellelaan 10,2023-09-13,02:00:00,0,0,0,FMN 05 Gerard Le Grellelaan
653,Gerard le Grellelaan 10,2023-09-13,03:00:00,0,0,0,FMN 05 Gerard Le Grellelaan
653,Gerard le Grellelaan 10,2023-09-13,04:00:00,3,1,2,FMN 05 Gerard Le Grellelaan
653,Gerard le Grellelaan 10,2023-09-13,05:00:00,33,13,20,FMN 05 Gerard Le Grellelaan
653,Gerard le Grellelaan 10,2023-09-13,06:00:00,65,37,28,FMN 05 Gerard Le Grellelaan
653,Gerard le Grellelaan 10,2023-09-13,07:00:00,147,109,38,FMN 05 Gerard Le Grellelaan
653,Gerard le Grellelaan 10,2023-09-13,08:00:00,300,242,58,FMN 05 Gerard Le Grellelaan
653,Gerard le Grellelaan 10,2023-09-13,09:00:00,18,17,1,FMN 05 Gerard Le Grellelaan
653,Gerard le Grellelaan 10,2023-09-13,10:00:00,26,21,5,FMN 05 Gerard Le Grellelaan
653,Gerard le Grellelaan 10,2023-09-13,11:00:00,19,16,3,FMN 05 Gerard Le Grellelaan
653,Gerard le Grellelaan 10,2023-09-13,12:00:00,96,80,16,FMN 05 Gerard Le Grellelaan
653,Gerard le Grellelaan 10,2023-09-13,13:00:00,48,38,10,FMN 05 Gerard Le Grellelaan
653,Gerard le Grellelaan 10,2023-09-13,14:00:00,46,39,7,FMN 05 Gerard Le Grellelaan
653,Gerard le Grellelaan 10,2023-09-13,15:00:00,122,99,23,FMN 05 Gerard Le Grellelaan
653,Gerard le Grellelaan 10,2023-09-13,16:00:00,42,30,12,FMN 05 Gerard Le Grellelaan
653,Gerard le Grellelaan 10,2023-09-13,17:00:00,0,0,0,FMN 05 Gerard Le Grellelaan
653,Gerard le Grellelaan 10,2023-09-13,18:00:00,93,81,12,FMN 05 Gerard Le Grellelaan
653,Gerard le Grellelaan 10,2023-09-13,19:00:00,19,14,5,FMN 05 Gerard Le Grellelaan
653,Gerard le Grellelaan 10,2023-09-13,20:00:00,0,0,0,FMN 05 Gerard Le Grellelaan
653,Gerard le Grellelaan 10,2023-09-13,21:00:00,42,27,15,FMN 05 Gerard Le Grellelaan
653,Gerard le Grellelaan 10,2023-09-13,22:00:00,56,49,7,FMN 05 Gerard Le Grellelaan
653,Gerard le Grellelaan 10,2023-09-13,23:00:00,18,12,6,FMN 05 Gerard Le Grellelaan
653,Gerard le Grellelaan 10,2023-09-14,00:00:00,9,7,2,FMN 05 Gerard Le Grellelaan
653,Gerard le Grellelaan 10,2023-09-14,01:00:00,4,1,3,FMN 05 Gerard Le Grellelaan
653,Gerard le Grellelaan 10,2023-09-14,02:00:00,3,2,1,FMN 05 Gerard Le Grellelaan
653,Gerard le Grellelaan 10,2023-09-14,03:00:00,4,2,2,FMN 05 Gerard Le Grellelaan
653,Gerard le Grellelaan 10,2023-09-14,04:00:00,6,4,2,FMN 05 Gerard Le Grellelaan
653,Gerard le Grellelaan 10,2023-09-14,05:00:00,30,15,15,FMN 05 Gerard Le Grellelaan
653,Gerard le Grellelaan 10,2023-09-14,06:00:00,73,37,36,FMN 05 Gerard Le Grellelaan
653,Gerard le Grellelaan 10,2023-09-14,07:00:00,195,143,52,FMN 05 Gerard Le Grellelaan
653,Gerard le Grellelaan 10,2023-09-14,08:00:00,340,289,51,FMN 05 Gerard Le Grellelaan
653,Gerard le Grellelaan 10,2023-09-14,09:00:00,117,101,16,FMN 05 Gerard Le Grellelaan
653,Gerard le Grellelaan 10,2023-09-14,10:00:00,97,88,9,FMN 05 Gerard Le Grellelaan
653,Gerard le Grellelaan 10,2023-09-14,11:00:00,92,75,17,FMN 05 Gerard Le Grellelaan
653,Gerard le Grellelaan 10,2023-09-14,12:00:00,89,70,19,FMN 05 Gerard Le Grellelaan
653,Gerard le Grellelaan 10,2023-09-14,13:00:00,92,69,23,FMN 05 Gerard Le Grellelaan
653,Gerard le Grellelaan 10,2023-09-14,14:00:00,119,95,24,FMN 05 Gerard Le Grellelaan
653,Gerard le Grellelaan 10,2023-09-14,15:00:00,158,120,38,FMN 05 Gerard Le Grellelaan
653,Gerard le Grellelaan 10,2023-09-14,16:00:00,228,160,68,FMN 05 Gerard Le Grellelaan
653,Gerard le Grellelaan 10,2023-09-14,17:00:00,263,197,66,FMN 05 Gerard Le Grellelaan
653,Gerard le Grellelaan 10,2023-09-14,18:00:00,184,151,33,FMN 05 Gerard Le Grellelaan
653,Gerard le Grellelaan 10,2023-09-14,19:00:00,117,104,13,FMN 05 Gerard Le Grellelaan
653,Gerard le Grellelaan 10,2023-09-14,20:00:00,91,75,16,FMN 05 Gerard Le Grellelaan
653,Gerard le Grellelaan 10,2023-09-14,21:00:00,42,31,11,FMN 05 Gerard Le Grellelaan
653,Gerard le Grellelaan 10,2023-09-14,22:00:00,51,40,11,FMN 05 Gerard Le Grellelaan
653,Gerard le Grellelaan 10,2023-09-14,23:00:00,33,25,8,FMN 05 Gerard Le Grellelaan
653,Gerard le Grellelaan 10,2023-09-15,00:00:00,10,8,2,FMN 05 Gerard Le Grellelaan
653,Gerard le Grellelaan 10,2023-09-15,01:00:00,6,4,2,FMN 05 Gerard Le Grellelaan
653,Gerard le Grellelaan 10,2023-09-15,02:00:00,3,2,1,FMN 05 Gerard Le Grellelaan
653,Gerard le Grellelaan 10,2023-09-15,03:00:00,3,1,2,FMN 05 Gerard Le Grellelaan
653,Gerard le Grellelaan 10,2023-09-15,04:00:00,5,2,3,FMN 05 Gerard Le Grellelaan
653,Gerard le Grellelaan 10,2023-09-15,05:00:00,29,11,18,FMN 05 Gerard Le Grellelaan
653,Gerard le Grellelaan 10,2023-09-15,06:00:00,45,21,24,FMN 05 Gerard Le Grellelaan
653,Gerard le Grellelaan 10,2023-09-15,07:00:00,134,101,33,FMN 05 Gerard Le Grellelaan
653,Gerard le Grellelaan 10,2023-09-15,08:00:00,309,248,61,FMN 05 Gerard Le Grellelaan
653,Gerard le Grellelaan 10,2023-09-15,09:00:00,124,108,16,FMN 05 Gerard Le Grellelaan
653,Gerard le Grellelaan 10,2023-09-15,10:00:00,86,74,12,FMN 05 Gerard Le Grellelaan
653,Gerard le Grellelaan 10,2023-09-15,11:00:00,119,98,21,FMN 05 Gerard Le Grellelaan
653,Gerard le Grellelaan 10,2023-09-15,12:00:00,124,108,16,FMN 05 Gerard Le Grellelaan
653,Gerard le Grellelaan 10,2023-09-15,13:00:00,96,73,23,FMN 05 Gerard Le Grellelaan
653,Gerard le Grellelaan 10,2023-09-15,14:00:00,115,89,26,FMN 05 Gerard Le Grellelaan
653,Gerard le Grellelaan 10,2023-09-15,15:00:00,173,144,29,FMN 05 Gerard Le Grellelaan
653,Gerard le Grellelaan 10,2023-09-15,16:00:00,210,159,51,FMN 05 Gerard Le Grellelaan
653,Gerard le Grellelaan 10,2023-09-15,17:00:00,197,154,43,FMN 05 Gerard Le Grellelaan
653,Gerard le Grellelaan 10,2023-09-15,18:00:00,171,144,27,FMN 05 Gerard Le Grellelaan
653,Gerard le Grellelaan 10,2023-09-15,19:00:00,138,116,22,FMN 05 Gerard Le Grellelaan
653,Gerard le Grellelaan 10,2023-09-15,20:00:00,79,55,24,FMN 05 Gerard Le Grellelaan
653,Gerard le Grellelaan 10,2023-09-15,21:00:00,51,39,12,FMN 05 Gerard Le Grellelaan
653,Gerard le Grellelaan 10,2023-09-15,22:00:00,42,31,11,FMN 05 Gerard Le Grellelaan
653,Gerard le Grellelaan 10,2023-09-15,23:00:00,29,22,7,FMN 05 Gerard Le Grellelaan
653,Gerard le Grellelaan 10,2023-09-16,00:00:00,22,16,6,FMN 05 Gerard Le Grellelaan
653,Gerard le Grellelaan 10,2023-09-16,01:00:00,7,6,1,FMN 05 Gerard Le Grellelaan
653,Gerard le Grellelaan 10,2023-09-16,02:00:00,5,4,1,FMN 05 Gerard Le Grellelaan
653,Gerard le Grellelaan 10,2023-09-16,03:00:00,7,2,5,FMN 05 Gerard Le Grellelaan
653,Gerard le Grellelaan 10,2023-09-16,04:00:00,8,3,5,FMN 05 Gerard Le Grellelaan
653,Gerard le Grellelaan 10,2023-09-16,05:00:00,5,4,1,FMN 05 Gerard Le Grellelaan
653,Gerard le Grellelaan 10,2023-09-16,06:00:00,13,9,4,FMN 05 Gerard Le Grellelaan
653,Gerard le Grellelaan 10,2023-09-16,07:00:00,21,20,1,FMN 05 Gerard Le Grellelaan
653,Gerard le Grellelaan 10,2023-09-16,08:00:00,41,29,12,FMN 05 Gerard Le Grellelaan
653,Gerard le Grellelaan 10,2023-09-16,09:00:00,78,65,13,FMN 05 Gerard Le Grellelaan
653,Gerard le Grellelaan 10,2023-09-16,10:00:00,74,60,14,FMN 05 Gerard Le Grellelaan
653,Gerard le Grellelaan 10,2023-09-16,11:00:00,95,83,12,FMN 05 Gerard Le Grellelaan
653,Gerard le Grellelaan 10,2023-09-16,12:00:00,78,61,17,FMN 05 Gerard Le Grellelaan
653,Gerard le Grellelaan 10,2023-09-16,13:00:00,90,69,21,FMN 05 Gerard Le Grellelaan
653,Gerard le Grellelaan 10,2023-09-16,14:00:00,109,93,16,FMN 05 Gerard Le Grellelaan
653,Gerard le Grellelaan 10,2023-09-16,15:00:00,119,97,22,FMN 05 Gerard Le Grellelaan
653,Gerard le Grellelaan 10,2023-09-16,16:00:00,99,82,17,FMN 05 Gerard Le Grellelaan
653,Gerard le Grellelaan 10,2023-09-16,17:00:00,112,92,20,FMN 05 Gerard Le Grellelaan
653,Gerard le Grellelaan 10,2023-09-16,18:00:00,92,82,10,FMN 05 Gerard Le Grellelaan
653,Gerard le Grellelaan 10,2023-09-16,19:00:00,75,64,11,FMN 05 Gerard Le Grellelaan
653,Gerard le Grellelaan 10,2023-09-16,20:00:00,56,43,13,FMN 05 Gerard Le Grellelaan
653,Gerard le Grellelaan 10,2023-09-16,21:00:00,37,34,3,FMN 05 Gerard Le Grellelaan
653,Gerard le Grellelaan 10,2023-09-16,22:00:00,47,35,12,FMN 05 Gerard Le Grellelaan
653,Gerard le Grellelaan 10,2023-09-16,23:00:00,28,20,8,FMN 05 Gerard Le Grellelaan
653,Gerard le Grellelaan 10,2023-09-17,00:00:00,18,16,2,FMN 05 Gerard Le Grellelaan
653,Gerard le Grellelaan 10,2023-09-17,01:00:00,3,1,2,FMN 05 Gerard Le Grellelaan
653,Gerard le Grellelaan 10,2023-09-17,02:00:00,5,3,2,FMN 05 Gerard Le Grellelaan
653,Gerard le Grellelaan 10,2023-09-17,03:00:00,3,2,1,FMN 05 Gerard Le Grellelaan
653,Gerard le Grellelaan 10,2023-09-17,04:00:00,4,2,2,FMN 05 Gerard Le Grellelaan
653,Gerard le Grellelaan 10,2023-09-17,05:00:00,6,3,3,FMN 05 Gerard Le Grellelaan
653,Gerard le Grellelaan 10,2023-09-17,06:00:00,9,7,2,FMN 05 Gerard Le Grellelaan
653,Gerard le Grellelaan 10,2023-09-17,07:00:00,13,11,2,FMN 05 Gerard Le Grellelaan
653,Gerard le Grellelaan 10,2023-09-17,08:00:00,28,21,7,FMN 05 Gerard Le Grellelaan
653,Gerard le Grellelaan 10,2023-09-17,09:00:00,50,41,9,FMN 05 Gerard Le Grellelaan
653,Gerard le Grellelaan 10,2023-09-17,10:00:00,64,54,10,FMN 05 Gerard Le Grellelaan
653,Gerard le Grellelaan 10,2023-09-17,11:00:00,104,76,28,FMN 05 Gerard Le Grellelaan
653,Gerard le Grellelaan 10,2023-09-17,12:00:00,115,95,20,FMN 05 Gerard Le Grellelaan
653,Gerard le Grellelaan 10,2023-09-17,13:00:00,21,18,3,FMN 05 Gerard Le Grellelaan
653,Gerard le Grellelaan 10,2023-09-17,14:00:00,0,0,0,FMN 05 Gerard Le Grellelaan
653,Gerard le Grellelaan 10,2023-09-17,15:00:00,0,0,0,FMN 05 Gerard Le Grellelaan
653,Gerard le Grellelaan 10,2023-09-17,16:00:00,0,0,0,FMN 05 Gerard Le Grellelaan
653,Gerard le Grellelaan 10,2023-09-17,17:00:00,0,0,0,FMN 05 Gerard Le Grellelaan
653,Gerard le Grellelaan 10,2023-09-17,18:00:00,0,0,0,FMN 05 Gerard Le Grellelaan
653,Gerard le Grellelaan 10,2023-09-17,19:00:00,0,0,0,FMN 05 Gerard Le Grellelaan
653,Gerard le Grellelaan 10,2023-09-17,20:00:00,0,0,0,FMN 05 Gerard Le Grellelaan
653,Gerard le Grellelaan 10,2023-09-17,21:00:00,0,0,0,FMN 05 Gerard Le Grellelaan
653,Gerard le Grellelaan 10,2023-09-17,22:00:00,0,0,0,FMN 05 Gerard Le Grellelaan
653,Gerard le Grellelaan 10,2023-09-17,23:00:00,0,0,0,FMN 05 Gerard Le Grellelaan
653,Gerard le Grellelaan 10,2023-09-18,00:00:00,0,0,0,FMN 05 Gerard Le Grellelaan
653,Gerard le Grellelaan 10,2023-09-18,01:00:00,0,0,0,FMN 05 Gerard Le Grellelaan
653,Gerard le Grellelaan 10,2023-09-18,02:00:00,0,0,0,FMN 05 Gerard Le Grellelaan
653,Gerard le Grellelaan 10,2023-09-18,03:00:00,0,0,0,FMN 05 Gerard Le Grellelaan
653,Gerard le Grellelaan 10,2023-09-18,04:00:00,0,0,0,FMN 05 Gerard Le Grellelaan
653,Gerard le Grellelaan 10,2023-09-18,05:00:00,5,0,5,FMN 05 Gerard Le Grellelaan
653,Gerard le Grellelaan 10,2023-09-18,06:00:00,19,7,12,FMN 05 Gerard Le Grellelaan
653,Gerard le Grellelaan 10,2023-09-18,07:00:00,67,43,24,FMN 05 Gerard Le Grellelaan
653,Gerard le Grellelaan 10,2023-09-18,08:00:00,0,0,0,FMN 05 Gerard Le Grellelaan
653,Gerard le Grellelaan 10,2023-09-18,09:00:00,14,13,1,FMN 05 Gerard Le Grellelaan
653,Gerard le Grellelaan 10,2023-09-18,10:00:00,26,21,5,FMN 05 Gerard Le Grellelaan
653,Gerard le Grellelaan 10,2023-09-18,11:00:00,16,15,1,FMN 05 Gerard Le Grellelaan
653,Gerard le Grellelaan 10,2023-09-18,12:00:00,25,22,3,FMN 05 Gerard Le Grellelaan
653,Gerard le Grellelaan 10,2023-09-18,13:00:00,26,19,7,FMN 05 Gerard Le Grellelaan
653,Gerard le Grellelaan 10,2023-09-18,14:00:00,33,31,2,FMN 05 Gerard Le Grellelaan
653,Gerard le Grellelaan 10,2023-09-18,15:00:00,56,35,21,FMN 05 Gerard Le Grellelaan
653,Gerard le Grellelaan 10,2023-09-18,16:00:00,27,22,5,FMN 05 Gerard Le Grellelaan
653,Gerard le Grellelaan 10,2023-09-18,17:00:00,161,119,42,FMN 05 Gerard Le Grellelaan
653,Gerard le Grellelaan 10,2023-09-18,18:00:00,62,49,13,FMN 05 Gerard Le Grellelaan
653,Gerard le Grellelaan 10,2023-09-18,19:00:00,47,28,19,FMN 05 Gerard Le Grellelaan
653,Gerard le Grellelaan 10,2023-09-18,20:00:00,11,8,3,FMN 05 Gerard Le Grellelaan
653,Gerard le Grellelaan 10,2023-09-18,21:00:00,29,17,12,FMN 05 Gerard Le Grellelaan
653,Gerard le Grellelaan 10,2023-09-18,22:00:00,7,6,1,FMN 05 Gerard Le Grellelaan
653,Gerard le Grellelaan 10,2023-09-18,23:00:00,8,5,3,FMN 05 Gerard Le Grellelaan
653,Gerard le Grellelaan 10,2023-09-19,00:00:00,0,0,0,FMN 05 Gerard Le Grellelaan
653,Gerard le Grellelaan 10,2023-09-19,01:00:00,1,1,0,FMN 05 Gerard Le Grellelaan
653,Gerard le Grellelaan 10,2023-09-19,02:00:00,0,0,0,FMN 05 Gerard Le Grellelaan
653,Gerard le Grellelaan 10,2023-09-19,03:00:00,1,0,1,FMN 05 Gerard Le Grellelaan
653,Gerard le Grellelaan 10,2023-09-19,04:00:00,0,0,0,FMN 05 Gerard Le Grellelaan
653,Gerard le Grellelaan 10,2023-09-19,05:00:00,6,2,4,FMN 05 Gerard Le Grellelaan
653,Gerard le Grellelaan 10,2023-09-19,06:00:00,28,17,11,FMN 05 Gerard Le Grellelaan
653,Gerard le Grellelaan 10,2023-09-19,07:00:00,124,100,24,FMN 05 Gerard Le Grellelaan
653,Gerard le Grellelaan 10,2023-09-19,08:00:00,98,82,16,FMN 05 Gerard Le Grellelaan
653,Gerard le Grellelaan 10,2023-09-19,09:00:00,9,9,0,FMN 05 Gerard Le Grellelaan
653,Gerard le Grellelaan 10,2023-09-19,10:00:00,6,4,2,FMN 05 Gerard Le Grellelaan
653,Gerard le Grellelaan 10,2023-09-19,11:00:00,6,5,1,FMN 05 Gerard Le Grellelaan
653,Gerard le Grellelaan 10,2023-09-19,12:00:00,8,6,2,FMN 05 Gerard Le Grellelaan
653,Gerard le Grellelaan 10,2023-09-19,13:00:00,3,2,1,FMN 05 Gerard Le Grellelaan
653,Gerard le Grellelaan 10,2023-09-19,14:00:00,1,1,0,FMN 05 Gerard Le Grellelaan
653,Gerard le Grellelaan 10,2023-09-19,15:00:00,9,8,1,FMN 05 Gerard Le Grellelaan
653,Gerard le Grellelaan 10,2023-09-19,16:00:00,12,11,1,FMN 05 Gerard Le Grellelaan
653,Gerard le Grellelaan 10,2023-09-19,17:00:00,37,27,10,FMN 05 Gerard Le Grellelaan
653,Gerard le Grellelaan 10,2023-09-19,18:00:00,38,30,8,FMN 05 Gerard Le Grellelaan
653,Gerard le Grellelaan 10,2023-09-19,19:00:00,12,6,6,FMN 05 Gerard Le Grellelaan
653,Gerard le Grellelaan 10,2023-09-19,20:00:00,22,18,4,FMN 05 Gerard Le Grellelaan
653,Gerard le Grellelaan 10,2023-09-19,21:00:00,18,15,3,FMN 05 Gerard Le Grellelaan
653,Gerard le Grellelaan 10,2023-09-19,22:00:00,14,13,1,FMN 05 Gerard Le Grellelaan
653,Gerard le Grellelaan 10,2023-09-19,23:00:00,4,4,0,FMN 05 Gerard Le Grellelaan
653,Gerard le Grellelaan 10,2023-09-20,00:00:00,6,5,1,FMN 05 Gerard Le Grellelaan
653,Gerard le Grellelaan 10,2023-09-20,01:00:00,0,0,0,FMN 05 Gerard Le Grellelaan
653,Gerard le Grellelaan 10,2023-09-20,02:00:00,0,0,0,FMN 05 Gerard Le Grellelaan
653,Gerard le Grellelaan 10,2023-09-20,03:00:00,1,1,0,FMN 05 Gerard Le Grellelaan
653,Gerard le Grellelaan 10,2023-09-20,04:00:00,2,0,2,FMN 05 Gerard Le Grellelaan
653,Gerard le Grellelaan 10,2023-09-20,05:00:00,15,6,9,FMN 05 Gerard Le Grellelaan
653,Gerard le Grellelaan 10,2023-09-20,06:00:00,25,8,17,FMN 05 Gerard Le Grellelaan
653,Gerard le Grellelaan 10,2023-09-20,07:00:00,58,41,17,FMN 05 Gerard Le Grellelaan
653,Gerard le Grellelaan 10,2023-09-20,08:00:00,86,68,18,FMN 05 Gerard Le Grellelaan
653,Gerard le Grellelaan 10,2023-09-20,09:00:00,8,5,3,FMN 05 Gerard Le Grellelaan
653,Gerard le Grellelaan 10,2023-09-20,10:00:00,18,14,4,FMN 05 Gerard Le Grellelaan
653,Gerard le Grellelaan 10,2023-09-20,11:00:00,5,4,1,FMN 05 Gerard Le Grellelaan
653,Gerard le Grellelaan 10,2023-09-20,12:00:00,40,34,6,FMN 05 Gerard Le Grellelaan
653,Gerard le Grellelaan 10,2023-09-20,13:00:00,58,37,21,FMN 05 Gerard Le Grellelaan
653,Gerard le Grellelaan 10,2023-09-20,14:00:00,54,45,9,FMN 05 Gerard Le Grellelaan
653,Gerard le Grellelaan 10,2023-09-20,15:00:00,24,20,4,FMN 05 Gerard Le Grellelaan
653,Gerard le Grellelaan 10,2023-09-20,16:00:00,88,66,22,FMN 05 Gerard Le Grellelaan
653,Gerard le Grellelaan 10,2023-09-20,17:00:00,182,147,35,FMN 05 Gerard Le Grellelaan
653,Gerard le Grellelaan 10,2023-09-20,18:00:00,113,93,20,FMN 05 Gerard Le Grellelaan
653,Gerard le Grellelaan 10,2023-09-20,19:00:00,102,83,19,FMN 05 Gerard Le Grellelaan
653,Gerard le Grellelaan 10,2023-09-20,20:00:00,84,67,17,FMN 05 Gerard Le Grellelaan
653,Gerard le Grellelaan 10,2023-09-20,21:00:00,44,33,11,FMN 05 Gerard Le Grellelaan
653,Gerard le Grellelaan 10,2023-09-20,22:00:00,49,41,8,FMN 05 Gerard Le Grellelaan
653,Gerard le Grellelaan 10,2023-09-20,23:00:00,24,17,7,FMN 05 Gerard Le Grellelaan
653,Gerard le Grellelaan 10,2023-09-21,00:00:00,6,3,3,FMN 05 Gerard Le Grellelaan
653,Gerard le Grellelaan 10,2023-09-21,01:00:00,0,0,0,FMN 05 Gerard Le Grellelaan
653,Gerard le Grellelaan 10,2023-09-21,02:00:00,2,1,1,FMN 05 Gerard Le Grellelaan
653,Gerard le Grellelaan 10,2023-09-21,03:00:00,4,4,0,FMN 05 Gerard Le Grellelaan
653,Gerard le Grellelaan 10,2023-09-21,04:00:00,4,0,4,FMN 05 Gerard Le Grellelaan
653,Gerard le Grellelaan 10,2023-09-21,05:00:00,17,9,8,FMN 05 Gerard Le Grellelaan
653,Gerard le Grellelaan 10,2023-09-21,06:00:00,32,14,18,FMN 05 Gerard Le Grellelaan
653,Gerard le Grellelaan 10,2023-09-21,07:00:00,83,65,18,FMN 05 Gerard Le Grellelaan
653,Gerard le Grellelaan 10,2023-09-21,08:00:00,4,3,1,FMN 05 Gerard Le Grellelaan
653,Gerard le Grellelaan 10,2023-09-21,09:00:00,0,0,0,FMN 05 Gerard Le Grellelaan
653,Gerard le Grellelaan 10,2023-09-21,10:00:00,48,44,4,FMN 05 Gerard Le Grellelaan
653,Gerard le Grellelaan 10,2023-09-21,11:00:00,27,21,6,FMN 05 Gerard Le Grellelaan
653,Gerard le Grellelaan 10,2023-09-21,12:00:00,50,39,11,FMN 05 Gerard Le Grellelaan
653,Gerard le Grellelaan 10,2023-09-21,13:00:00,57,43,14,FMN 05 Gerard Le Grellelaan
653,Gerard le Grellelaan 10,2023-09-21,14:00:00,60,46,14,FMN 05 Gerard Le Grellelaan
653,Gerard le Grellelaan 10,2023-09-21,15:00:00,98,77,21,FMN 05 Gerard Le Grellelaan
653,Gerard le Grellelaan 10,2023-09-21,16:00:00,125,89,36,FMN 05 Gerard Le Grellelaan
653,Gerard le Grellelaan 10,2023-09-21,17:00:00,146,119,27,FMN 05 Gerard Le Grellelaan
653,Gerard le Grellelaan 10,2023-09-21,18:00:00,11,9,2,FMN 05 Gerard Le Grellelaan
653,Gerard le Grellelaan 10,2023-09-21,19:00:00,0,0,0,FMN 05 Gerard Le Grellelaan
653,Gerard le Grellelaan 10,2023-09-21,20:00:00,25,15,10,FMN 05 Gerard Le Grellelaan
653,Gerard le Grellelaan 10,2023-09-21,21:00:00,4,4,0,FMN 05 Gerard Le Grellelaan
653,Gerard le Grellelaan 10,2023-09-21,22:00:00,7,6,1,FMN 05 Gerard Le Grellelaan
653,Gerard le Grellelaan 10,2023-09-21,23:00:00,5,3,2,FMN 05 Gerard Le Grellelaan
653,Gerard le Grellelaan 10,2023-09-22,00:00:00,0,0,0,FMN 05 Gerard Le Grellelaan
653,Gerard le Grellelaan 10,2023-09-22,01:00:00,2,0,2,FMN 05 Gerard Le Grellelaan
653,Gerard le Grellelaan 10,2023-09-22,02:00:00,1,1,0,FMN 05 Gerard Le Grellelaan
653,Gerard le Grellelaan 10,2023-09-22,03:00:00,0,0,0,FMN 05 Gerard Le Grellelaan
653,Gerard le Grellelaan 10,2023-09-22,04:00:00,4,2,2,FMN 05 Gerard Le Grellelaan
653,Gerard le Grellelaan 10,2023-09-22,05:00:00,16,9,7,FMN 05 Gerard Le Grellelaan
653,Gerard le Grellelaan 10,2023-09-22,06:00:00,23,13,10,FMN 05 Gerard Le Grellelaan
653,Gerard le Grellelaan 10,2023-09-22,07:00:00,88,61,27,FMN 05 Gerard Le Grellelaan
653,Gerard le Grellelaan 10,2023-09-22,08:00:00,16,15,1,FMN 05 Gerard Le Grellelaan
653,Gerard le Grellelaan 10,2023-09-22,09:00:00,46,45,1,FMN 05 Gerard Le Grellelaan
653,Gerard le Grellelaan 10,2023-09-22,10:00:00,18,15,3,FMN 05 Gerard Le Grellelaan
653,Gerard le Grellelaan 10,2023-09-22,11:00:00,19,16,3,FMN 05 Gerard Le Grellelaan
653,Gerard le Grellelaan 10,2023-09-22,12:00:00,29,22,7,FMN 05 Gerard Le Grellelaan
653,Gerard le Grellelaan 10,2023-09-22,13:00:00,34,28,6,FMN 05 Gerard Le Grellelaan
653,Gerard le Grellelaan 10,2023-09-22,14:00:00,69,50,19,FMN 05 Gerard Le Grellelaan
653,Gerard le Grellelaan 10,2023-09-22,15:00:00,152,112,40,FMN 05 Gerard Le Grellelaan
653,Gerard le Grellelaan 10,2023-09-22,16:00:00,153,112,41,FMN 05 Gerard Le Grellelaan
653,Gerard le Grellelaan 10,2023-09-22,17:00:00,159,126,33,FMN 05 Gerard Le Grellelaan
653,Gerard le Grellelaan 10,2023-09-22,18:00:00,103,80,23,FMN 05 Gerard Le Grellelaan
653,Gerard le Grellelaan 10,2023-09-22,19:00:00,43,35,8,FMN 05 Gerard Le Grellelaan
653,Gerard le Grellelaan 10,2023-09-22,20:00:00,44,37,7,FMN 05 Gerard Le Grellelaan
653,Gerard le Grellelaan 10,2023-09-22,21:00:00,7,6,1,FMN 05 Gerard Le Grellelaan
653,Gerard le Grellelaan 10,2023-09-22,22:00:00,38,34,4,FMN 05 Gerard Le Grellelaan
653,Gerard le Grellelaan 10,2023-09-22,23:00:00,25,18,7,FMN 05 Gerard Le Grellelaan
653,Gerard le Grellelaan 10,2023-09-23,00:00:00,15,13,2,FMN 05 Gerard Le Grellelaan
653,Gerard le Grellelaan 10,2023-09-23,01:00:00,11,8,3,FMN 05 Gerard Le Grellelaan
653,Gerard le Grellelaan 10,2023-09-23,02:00:00,8,3,5,FMN 05 Gerard Le Grellelaan
653,Gerard le Grellelaan 10,2023-09-23,03:00:00,2,2,0,FMN 05 Gerard Le Grellelaan
653,Gerard le Grellelaan 10,2023-09-23,04:00:00,2,1,1,FMN 05 Gerard Le Grellelaan
653,Gerard le Grellelaan 10,2023-09-23,05:00:00,8,5,3,FMN 05 Gerard Le Grellelaan
653,Gerard le Grellelaan 10,2023-09-23,06:00:00,4,3,1,FMN 05 Gerard Le Grellelaan
653,Gerard le Grellelaan 10,2023-09-23,07:00:00,0,0,0,FMN 05 Gerard Le Grellelaan
653,Gerard le Grellelaan 10,2023-09-23,08:00:00,15,12,3,FMN 05 Gerard Le Grellelaan
653,Gerard le Grellelaan 10,2023-09-23,09:00:00,22,21,1,FMN 05 Gerard Le Grellelaan
653,Gerard le Grellelaan 10,2023-09-23,10:00:00,27,24,3,FMN 05 Gerard Le Grellelaan
653,Gerard le Grellelaan 10,2023-09-23,11:00:00,30,25,5,FMN 05 Gerard Le Grellelaan
653,Gerard le Grellelaan 10,2023-09-23,12:00:00,16,13,3,FMN 05 Gerard Le Grellelaan
653,Gerard le Grellelaan 10,2023-09-23,13:00:00,72,57,15,FMN 05 Gerard Le Grellelaan
653,Gerard le Grellelaan 10,2023-09-23,14:00:00,25,19,6,FMN 05 Gerard Le Grellelaan
653,Gerard le Grellelaan 10,2023-09-23,15:00:00,81,67,14,FMN 05 Gerard Le Grellelaan
653,Gerard le Grellelaan 10,2023-09-23,16:00:00,76,65,11,FMN 05 Gerard Le Grellelaan
653,Gerard le Grellelaan 10,2023-09-23,17:00:00,85,70,15,FMN 05 Gerard Le Grellelaan
653,Gerard le Grellelaan 10,2023-09-23,18:00:00,92,76,16,FMN 05 Gerard Le Grellelaan
653,Gerard le Grellelaan 10,2023-09-23,19:00:00,69,59,10,FMN 05 Gerard Le Grellelaan
653,Gerard le Grellelaan 10,2023-09-23,20:00:00,44,35,9,FMN 05 Gerard Le Grellelaan
653,Gerard le Grellelaan 10,2023-09-23,21:00:00,24,22,2,FMN 05 Gerard Le Grellelaan
653,Gerard le Grellelaan 10,2023-09-23,22:00:00,28,21,7,FMN 05 Gerard Le Grellelaan
653,Gerard le Grellelaan 10,2023-09-23,23:00:00,27,21,6,FMN 05 Gerard Le Grellelaan
653,Gerard le Grellelaan 10,2023-09-24,00:00:00,14,8,6,FMN 05 Gerard Le Grellelaan
653,Gerard le Grellelaan 10,2023-09-24,01:00:00,15,12,3,FMN 05 Gerard Le Grellelaan
653,Gerard le Grellelaan 10,2023-09-24,02:00:00,2,0,2,FMN 05 Gerard Le Grellelaan
653,Gerard le Grellelaan 10,2023-09-24,03:00:00,6,3,3,FMN 05 Gerard Le Grellelaan
653,Gerard le Grellelaan 10,2023-09-24,04:00:00,1,0,1,FMN 05 Gerard Le Grellelaan
653,Gerard le Grellelaan 10,2023-09-24,05:00:00,6,4,2,FMN 05 Gerard Le Grellelaan
653,Gerard le Grellelaan 10,2023-09-24,06:00:00,11,11,0,FMN 05 Gerard Le Grellelaan
653,Gerard le Grellelaan 10,2023-09-24,07:00:00,15,9,6,FMN 05 Gerard Le Grellelaan
653,Gerard le Grellelaan 10,2023-09-24,08:00:00,16,14,2,FMN 05 Gerard Le Grellelaan
653,Gerard le Grellelaan 10,2023-09-24,09:00:00,47,40,7,FMN 05 Gerard Le Grellelaan
653,Gerard le Grellelaan 10,2023-09-24,10:00:00,72,55,17,FMN 05 Gerard Le Grellelaan
653,Gerard le Grellelaan 10,2023-09-24,11:00:00,55,43,12,FMN 05 Gerard Le Grellelaan
653,Gerard le Grellelaan 10,2023-09-24,12:00:00,26,20,6,FMN 05 Gerard Le Grellelaan
653,Gerard le Grellelaan 10,2023-09-24,13:00:00,99,76,23,FMN 05 Gerard Le Grellelaan
653,Gerard le Grellelaan 10,2023-09-24,14:00:00,47,38,9,FMN 05 Gerard Le Grellelaan
653,Gerard le Grellelaan 10,2023-09-24,15:00:00,82,66,16,FMN 05 Gerard Le Grellelaan
653,Gerard le Grellelaan 10,2023-09-24,16:00:00,0,0,0,FMN 05 Gerard Le Grellelaan
653,Gerard le Grellelaan 10,2023-09-24,17:00:00,30,20,10,FMN 05 Gerard Le Grellelaan
653,Gerard le Grellelaan 10,2023-09-24,18:00:00,69,57,12,FMN 05 Gerard Le Grellelaan
653,Gerard le Grellelaan 10,2023-09-24,19:00:00,0,0,0,FMN 05 Gerard Le Grellelaan
653,Gerard le Grellelaan 10,2023-09-24,20:00:00,0,0,0,FMN 05 Gerard Le Grellelaan
653,Gerard le Grellelaan 10,2023-09-24,21:00:00,0,0,0,FMN 05 Gerard Le Grellelaan
653,Gerard le Grellelaan 10,2023-09-24,22:00:00,0,0,0,FMN 05 Gerard Le Grellelaan
653,Gerard le Grellelaan 10,2023-09-24,23:00:00,0,0,0,FMN 05 Gerard Le Grellelaan
653,Gerard le Grellelaan 10,2023-09-25,00:00:00,0,0,0,FMN 05 Gerard Le Grellelaan
653,Gerard le Grellelaan 10,2023-09-25,01:00:00,0,0,0,FMN 05 Gerard Le Grellelaan
653,Gerard le Grellelaan 10,2023-09-25,02:00:00,0,0,0,FMN 05 Gerard Le Grellelaan
653,Gerard le Grellelaan 10,2023-09-25,03:00:00,0,0,0,FMN 05 Gerard Le Grellelaan
653,Gerard le Grellelaan 10,2023-09-25,04:00:00,0,0,0,FMN 05 Gerard Le Grellelaan
653,Gerard le Grellelaan 10,2023-09-25,05:00:00,0,0,0,FMN 05 Gerard Le Grellelaan
653,Gerard le Grellelaan 10,2023-09-25,06:00:00,0,0,0,FMN 05 Gerard Le Grellelaan
653,Gerard le Grellelaan 10,2023-09-25,07:00:00,0,0,0,FMN 05 Gerard Le Grellelaan
653,Gerard le Grellelaan 10,2023-09-25,08:00:00,0,0,0,FMN 05 Gerard Le Grellelaan
653,Gerard le Grellelaan 10,2023-09-25,09:00:00,0,0,0,FMN 05 Gerard Le Grellelaan
653,Gerard le Grellelaan 10,2023-09-25,10:00:00,37,30,7,FMN 05 Gerard Le Grellelaan
653,Gerard le Grellelaan 10,2023-09-25,11:00:00,70,63,7,FMN 05 Gerard Le Grellelaan
653,Gerard le Grellelaan 10,2023-09-25,12:00:00,120,89,31,FMN 05 Gerard Le Grellelaan
653,Gerard le Grellelaan 10,2023-09-25,13:00:00,120,94,26,FMN 05 Gerard Le Grellelaan
653,Gerard le Grellelaan 10,2023-09-25,14:00:00,125,109,16,FMN 05 Gerard Le Grellelaan
653,Gerard le Grellelaan 10,2023-09-25,15:00:00,190,153,37,FMN 05 Gerard Le Grellelaan
653,Gerard le Grellelaan 10,2023-09-25,16:00:00,211,163,48,FMN 05 Gerard Le Grellelaan
653,Gerard le Grellelaan 10,2023-09-25,17:00:00,272,199,73,FMN 05 Gerard Le Grellelaan
653,Gerard le Grellelaan 10,2023-09-25,18:00:00,193,148,45,FMN 05 Gerard Le Grellelaan
653,Gerard le Grellelaan 10,2023-09-25,19:00:00,73,56,17,FMN 05 Gerard Le Grellelaan
653,Gerard le Grellelaan 10,2023-09-25,20:00:00,68,52,16,FMN 05 Gerard Le Grellelaan
653,Gerard le Grellelaan 10,2023-09-25,21:00:00,31,19,12,FMN 05 Gerard Le Grellelaan
653,Gerard le Grellelaan 10,2023-09-25,22:00:00,49,42,7,FMN 05 Gerard Le Grellelaan
653,Gerard le Grellelaan 10,2023-09-25,23:00:00,12,9,3,FMN 05 Gerard Le Grellelaan
653,Gerard le Grellelaan 10,2023-09-26,00:00:00,10,9,1,FMN 05 Gerard Le Grellelaan
653,Gerard le Grellelaan 10,2023-09-26,01:00:00,4,2,2,FMN 05 Gerard Le Grellelaan
653,Gerard le Grellelaan 10,2023-09-26,02:00:00,0,0,0,FMN 05 Gerard Le Grellelaan
653,Gerard le Grellelaan 10,2023-09-26,03:00:00,6,4,2,FMN 05 Gerard Le Grellelaan
653,Gerard le Grellelaan 10,2023-09-26,04:00:00,8,1,7,FMN 05 Gerard Le Grellelaan
653,Gerard le Grellelaan 10,2023-09-26,05:00:00,30,12,18,FMN 05 Gerard Le Grellelaan
653,Gerard le Grellelaan 10,2023-09-26,06:00:00,81,39,42,FMN 05 Gerard Le Grellelaan
653,Gerard le Grellelaan 10,2023-09-26,07:00:00,194,150,44,FMN 05 Gerard Le Grellelaan
653,Gerard le Grellelaan 10,2023-09-26,08:00:00,375,303,72,FMN 05 Gerard Le Grellelaan
653,Gerard le Grellelaan 10,2023-09-26,09:00:00,118,103,15,FMN 05 Gerard Le Grellelaan
653,Gerard le Grellelaan 10,2023-09-26,10:00:00,101,82,19,FMN 05 Gerard Le Grellelaan
653,Gerard le Grellelaan 10,2023-09-26,11:00:00,88,70,18,FMN 05 Gerard Le Grellelaan
653,Gerard le Grellelaan 10,2023-09-26,12:00:00,117,98,19,FMN 05 Gerard Le Grellelaan
653,Gerard le Grellelaan 10,2023-09-26,13:00:00,124,100,24,FMN 05 Gerard Le Grellelaan
653,Gerard le Grellelaan 10,2023-09-26,14:00:00,107,90,17,FMN 05 Gerard Le Grellelaan
653,Gerard le Grellelaan 10,2023-09-26,15:00:00,216,173,43,FMN 05 Gerard Le Grellelaan
653,Gerard le Grellelaan 10,2023-09-26,16:00:00,255,192,63,FMN 05 Gerard Le Grellelaan
653,Gerard le Grellelaan 10,2023-09-26,17:00:00,290,217,73,FMN 05 Gerard Le Grellelaan
653,Gerard le Grellelaan 10,2023-09-26,18:00:00,228,191,37,FMN 05 Gerard Le Grellelaan
653,Gerard le Grellelaan 10,2023-09-26,19:00:00,116,91,25,FMN 05 Gerard Le Grellelaan
653,Gerard le Grellelaan 10,2023-09-26,20:00:00,76,65,11,FMN 05 Gerard Le Grellelaan
653,Gerard le Grellelaan 10,2023-09-26,21:00:00,37,29,8,FMN 05 Gerard Le Grellelaan
653,Gerard le Grellelaan 10,2023-09-26,22:00:00,81,67,14,FMN 05 Gerard Le Grellelaan
653,Gerard le Grellelaan 10,2023-09-26,23:00:00,30,23,7,FMN 05 Gerard Le Grellelaan
653,Gerard le Grellelaan 10,2023-09-27,00:00:00,6,5,1,FMN 05 Gerard Le Grellelaan
653,Gerard le Grellelaan 10,2023-09-27,01:00:00,4,3,1,FMN 05 Gerard Le Grellelaan
653,Gerard le Grellelaan 10,2023-09-27,02:00:00,0,0,0,FMN 05 Gerard Le Grellelaan
653,Gerard le Grellelaan 10,2023-09-27,03:00:00,3,3,0,FMN 05 Gerard Le Grellelaan
653,Gerard le Grellelaan 10,2023-09-27,04:00:00,7,1,6,FMN 05 Gerard Le Grellelaan
653,Gerard le Grellelaan 10,2023-09-27,05:00:00,27,10,17,FMN 05 Gerard Le Grellelaan
653,Gerard le Grellelaan 10,2023-09-27,06:00:00,70,35,35,FMN 05 Gerard Le Grellelaan
653,Gerard le Grellelaan 10,2023-09-27,07:00:00,186,142,44,FMN 05 Gerard Le Grellelaan
653,Gerard le Grellelaan 10,2023-09-27,08:00:00,342,285,57,FMN 05 Gerard Le Grellelaan
653,Gerard le Grellelaan 10,2023-09-27,09:00:00,113,96,17,FMN 05 Gerard Le Grellelaan
653,Gerard le Grellelaan 10,2023-09-27,10:00:00,106,87,19,FMN 05 Gerard Le Grellelaan
653,Gerard le Grellelaan 10,2023-09-27,11:00:00,90,72,18,FMN 05 Gerard Le Grellelaan
653,Gerard le Grellelaan 10,2023-09-27,12:00:00,197,148,49,FMN 05 Gerard Le Grellelaan
653,Gerard le Grellelaan 10,2023-09-27,13:00:00,150,113,37,FMN 05 Gerard Le Grellelaan
653,Gerard le Grellelaan 10,2023-09-27,14:00:00,12,12,0,FMN 05 Gerard Le Grellelaan
653,Gerard le Grellelaan 10,2023-09-27,15:00:00,0,0,0,FMN 05 Gerard Le Grellelaan
653,Gerard le Grellelaan 10,2023-09-27,16:00:00,0,0,0,FMN 05 Gerard Le Grellelaan
653,Gerard le Grellelaan 10,2023-09-27,17:00:00,0,0,0,FMN 05 Gerard Le Grellelaan
653,Gerard le Grellelaan 10,2023-09-27,18:00:00,0,0,0,FMN 05 Gerard Le Grellelaan
653,Gerard le Grellelaan 10,2023-09-27,19:00:00,0,0,0,FMN 05 Gerard Le Grellelaan
653,Gerard le Grellelaan 10,2023-09-27,20:00:00,0,0,0,FMN 05 Gerard Le Grellelaan
653,Gerard le Grellelaan 10,2023-09-27,21:00:00,0,0,0,FMN 05 Gerard Le Grellelaan
653,Gerard le Grellelaan 10,2023-09-27,22:00:00,0,0,0,FMN 05 Gerard Le Grellelaan
653,Gerard le Grellelaan 10,2023-09-27,23:00:00,0,0,0,FMN 05 Gerard Le Grellelaan
