Meetpunt surrogate key,Meetpunt locatie,Datum,Tijd,Aantal fietsers,Aantal fietsers van,Aantal fietsers naar,Meetpunt code
650,Mercatorstraat 36,2022-08-22,00:00:00,72,37,35,FMN 02 Mercatorstraat
650,Mercatorstraat 36,2022-08-22,01:00:00,43,13,30,FMN 02 Mercatorstraat
650,Mercatorstraat 36,2022-08-22,02:00:00,39,11,28,FMN 02 Mercatorstraat
650,Mercatorstraat 36,2022-08-22,03:00:00,26,6,20,FMN 02 Mercatorstraat
650,Mercatorstraat 36,2022-08-22,04:00:00,40,22,18,FMN 02 Mercatorstraat
650,Mercatorstraat 36,2022-08-22,05:00:00,46,26,20,FMN 02 Mercatorstraat
650,Mercatorstraat 36,2022-08-22,06:00:00,103,67,36,FMN 02 Mercatorstraat
650,Mercatorstraat 36,2022-08-22,07:00:00,270,182,88,FMN 02 Mercatorstraat
650,Mercatorstraat 36,2022-08-22,08:00:00,622,482,140,FMN 02 Mercatorstraat
650,Mercatorstraat 36,2022-08-22,09:00:00,323,235,88,FMN 02 Mercatorstraat
650,Mercatorstraat 36,2022-08-22,10:00:00,257,161,96,FMN 02 Mercatorstraat
650,Mercatorstraat 36,2022-08-22,11:00:00,273,157,116,FMN 02 Mercatorstraat
650,Mercatorstraat 36,2022-08-22,12:00:00,310,170,140,FMN 02 Mercatorstraat
650,Mercatorstraat 36,2022-08-22,13:00:00,278,165,113,FMN 02 Mercatorstraat
650,Mercatorstraat 36,2022-08-22,14:00:00,336,174,162,FMN 02 Mercatorstraat
650,Mercatorstraat 36,2022-08-22,15:00:00,369,181,188,FMN 02 Mercatorstraat
650,Mercatorstraat 36,2022-08-22,16:00:00,588,202,386,FMN 02 Mercatorstraat
650,Mercatorstraat 36,2022-08-22,17:00:00,690,234,456,FMN 02 Mercatorstraat
650,Mercatorstraat 36,2022-08-22,18:00:00,510,181,329,FMN 02 Mercatorstraat
650,Mercatorstraat 36,2022-08-22,19:00:00,361,179,182,FMN 02 Mercatorstraat
650,Mercatorstraat 36,2022-08-22,20:00:00,284,143,141,FMN 02 Mercatorstraat
650,Mercatorstraat 36,2022-08-22,21:00:00,197,79,118,FMN 02 Mercatorstraat
650,Mercatorstraat 36,2022-08-22,22:00:00,166,57,109,FMN 02 Mercatorstraat
650,Mercatorstraat 36,2022-08-22,23:00:00,108,44,64,FMN 02 Mercatorstraat
650,Mercatorstraat 36,2022-08-23,00:00:00,64,23,41,FMN 02 Mercatorstraat
650,Mercatorstraat 36,2022-08-23,01:00:00,32,14,18,FMN 02 Mercatorstraat
650,Mercatorstraat 36,2022-08-23,02:00:00,32,10,22,FMN 02 Mercatorstraat
650,Mercatorstraat 36,2022-08-23,03:00:00,20,7,13,FMN 02 Mercatorstraat
650,Mercatorstraat 36,2022-08-23,04:00:00,27,16,11,FMN 02 Mercatorstraat
650,Mercatorstraat 36,2022-08-23,05:00:00,50,30,20,FMN 02 Mercatorstraat
650,Mercatorstraat 36,2022-08-23,06:00:00,124,82,42,FMN 02 Mercatorstraat
650,Mercatorstraat 36,2022-08-23,07:00:00,329,219,110,FMN 02 Mercatorstraat
650,Mercatorstraat 36,2022-08-23,08:00:00,755,548,207,FMN 02 Mercatorstraat
650,Mercatorstraat 36,2022-08-23,09:00:00,454,327,127,FMN 02 Mercatorstraat
650,Mercatorstraat 36,2022-08-23,10:00:00,298,190,108,FMN 02 Mercatorstraat
650,Mercatorstraat 36,2022-08-23,11:00:00,310,195,115,FMN 02 Mercatorstraat
650,Mercatorstraat 36,2022-08-23,12:00:00,356,204,152,FMN 02 Mercatorstraat
650,Mercatorstraat 36,2022-08-23,13:00:00,351,208,143,FMN 02 Mercatorstraat
650,Mercatorstraat 36,2022-08-23,14:00:00,384,199,185,FMN 02 Mercatorstraat
650,Mercatorstraat 36,2022-08-23,15:00:00,378,141,237,FMN 02 Mercatorstraat
650,Mercatorstraat 36,2022-08-23,16:00:00,647,230,417,FMN 02 Mercatorstraat
650,Mercatorstraat 36,2022-08-23,17:00:00,858,311,547,FMN 02 Mercatorstraat
650,Mercatorstraat 36,2022-08-23,18:00:00,647,239,408,FMN 02 Mercatorstraat
650,Mercatorstraat 36,2022-08-23,19:00:00,367,170,197,FMN 02 Mercatorstraat
650,Mercatorstraat 36,2022-08-23,20:00:00,292,139,153,FMN 02 Mercatorstraat
650,Mercatorstraat 36,2022-08-23,21:00:00,251,112,139,FMN 02 Mercatorstraat
650,Mercatorstraat 36,2022-08-23,22:00:00,188,62,126,FMN 02 Mercatorstraat
650,Mercatorstraat 36,2022-08-23,23:00:00,127,58,69,FMN 02 Mercatorstraat
650,Mercatorstraat 36,2022-08-24,00:00:00,80,37,43,FMN 02 Mercatorstraat
650,Mercatorstraat 36,2022-08-24,01:00:00,48,21,27,FMN 02 Mercatorstraat
650,Mercatorstraat 36,2022-08-24,02:00:00,34,12,22,FMN 02 Mercatorstraat
650,Mercatorstraat 36,2022-08-24,03:00:00,16,5,11,FMN 02 Mercatorstraat
650,Mercatorstraat 36,2022-08-24,04:00:00,35,23,12,FMN 02 Mercatorstraat
650,Mercatorstraat 36,2022-08-24,05:00:00,37,19,18,FMN 02 Mercatorstraat
650,Mercatorstraat 36,2022-08-24,06:00:00,128,83,45,FMN 02 Mercatorstraat
650,Mercatorstraat 36,2022-08-24,07:00:00,295,192,103,FMN 02 Mercatorstraat
650,Mercatorstraat 36,2022-08-24,08:00:00,713,510,203,FMN 02 Mercatorstraat
650,Mercatorstraat 36,2022-08-24,09:00:00,400,285,115,FMN 02 Mercatorstraat
650,Mercatorstraat 36,2022-08-24,10:00:00,277,193,84,FMN 02 Mercatorstraat
650,Mercatorstraat 36,2022-08-24,11:00:00,319,171,148,FMN 02 Mercatorstraat
650,Mercatorstraat 36,2022-08-24,12:00:00,381,199,182,FMN 02 Mercatorstraat
650,Mercatorstraat 36,2022-08-24,13:00:00,337,178,159,FMN 02 Mercatorstraat
650,Mercatorstraat 36,2022-08-24,14:00:00,398,188,210,FMN 02 Mercatorstraat
650,Mercatorstraat 36,2022-08-24,15:00:00,383,163,220,FMN 02 Mercatorstraat
650,Mercatorstraat 36,2022-08-24,16:00:00,597,229,368,FMN 02 Mercatorstraat
650,Mercatorstraat 36,2022-08-24,17:00:00,728,262,466,FMN 02 Mercatorstraat
650,Mercatorstraat 36,2022-08-24,18:00:00,623,256,367,FMN 02 Mercatorstraat
650,Mercatorstraat 36,2022-08-24,19:00:00,375,197,178,FMN 02 Mercatorstraat
650,Mercatorstraat 36,2022-08-24,20:00:00,288,144,144,FMN 02 Mercatorstraat
650,Mercatorstraat 36,2022-08-24,21:00:00,294,142,152,FMN 02 Mercatorstraat
650,Mercatorstraat 36,2022-08-24,22:00:00,246,91,155,FMN 02 Mercatorstraat
650,Mercatorstraat 36,2022-08-24,23:00:00,194,79,115,FMN 02 Mercatorstraat
650,Mercatorstraat 36,2022-08-25,00:00:00,106,35,71,FMN 02 Mercatorstraat
650,Mercatorstraat 36,2022-08-25,01:00:00,67,29,38,FMN 02 Mercatorstraat
650,Mercatorstraat 36,2022-08-25,02:00:00,40,16,24,FMN 02 Mercatorstraat
650,Mercatorstraat 36,2022-08-25,03:00:00,18,6,12,FMN 02 Mercatorstraat
650,Mercatorstraat 36,2022-08-25,04:00:00,32,21,11,FMN 02 Mercatorstraat
650,Mercatorstraat 36,2022-08-25,05:00:00,52,29,23,FMN 02 Mercatorstraat
650,Mercatorstraat 36,2022-08-25,06:00:00,109,67,42,FMN 02 Mercatorstraat
650,Mercatorstraat 36,2022-08-25,07:00:00,305,197,108,FMN 02 Mercatorstraat
650,Mercatorstraat 36,2022-08-25,08:00:00,733,530,203,FMN 02 Mercatorstraat
650,Mercatorstraat 36,2022-08-25,09:00:00,426,327,99,FMN 02 Mercatorstraat
650,Mercatorstraat 36,2022-08-25,10:00:00,308,206,102,FMN 02 Mercatorstraat
650,Mercatorstraat 36,2022-08-25,11:00:00,287,156,131,FMN 02 Mercatorstraat
650,Mercatorstraat 36,2022-08-25,12:00:00,362,182,180,FMN 02 Mercatorstraat
650,Mercatorstraat 36,2022-08-25,13:00:00,334,180,154,FMN 02 Mercatorstraat
650,Mercatorstraat 36,2022-08-25,14:00:00,361,181,180,FMN 02 Mercatorstraat
650,Mercatorstraat 36,2022-08-25,15:00:00,380,152,228,FMN 02 Mercatorstraat
650,Mercatorstraat 36,2022-08-25,16:00:00,616,238,378,FMN 02 Mercatorstraat
650,Mercatorstraat 36,2022-08-25,17:00:00,690,260,430,FMN 02 Mercatorstraat
650,Mercatorstraat 36,2022-08-25,18:00:00,562,219,343,FMN 02 Mercatorstraat
650,Mercatorstraat 36,2022-08-25,19:00:00,391,168,223,FMN 02 Mercatorstraat
650,Mercatorstraat 36,2022-08-25,20:00:00,309,147,162,FMN 02 Mercatorstraat
650,Mercatorstraat 36,2022-08-25,21:00:00,295,124,171,FMN 02 Mercatorstraat
650,Mercatorstraat 36,2022-08-25,22:00:00,240,82,158,FMN 02 Mercatorstraat
650,Mercatorstraat 36,2022-08-25,23:00:00,214,70,144,FMN 02 Mercatorstraat
650,Mercatorstraat 36,2022-08-26,00:00:00,118,49,69,FMN 02 Mercatorstraat
650,Mercatorstraat 36,2022-08-26,01:00:00,77,42,35,FMN 02 Mercatorstraat
650,Mercatorstraat 36,2022-08-26,02:00:00,32,10,22,FMN 02 Mercatorstraat
650,Mercatorstraat 36,2022-08-26,03:00:00,19,3,16,FMN 02 Mercatorstraat
650,Mercatorstraat 36,2022-08-26,04:00:00,32,18,14,FMN 02 Mercatorstraat
650,Mercatorstraat 36,2022-08-26,05:00:00,50,22,28,FMN 02 Mercatorstraat
650,Mercatorstraat 36,2022-08-26,06:00:00,109,67,42,FMN 02 Mercatorstraat
650,Mercatorstraat 36,2022-08-26,07:00:00,255,175,80,FMN 02 Mercatorstraat
650,Mercatorstraat 36,2022-08-26,08:00:00,612,452,160,FMN 02 Mercatorstraat
650,Mercatorstraat 36,2022-08-26,09:00:00,388,270,118,FMN 02 Mercatorstraat
650,Mercatorstraat 36,2022-08-26,10:00:00,268,182,86,FMN 02 Mercatorstraat
650,Mercatorstraat 36,2022-08-26,11:00:00,294,175,119,FMN 02 Mercatorstraat
650,Mercatorstraat 36,2022-08-26,12:00:00,359,185,174,FMN 02 Mercatorstraat
650,Mercatorstraat 36,2022-08-26,13:00:00,384,204,180,FMN 02 Mercatorstraat
650,Mercatorstraat 36,2022-08-26,14:00:00,399,181,218,FMN 02 Mercatorstraat
650,Mercatorstraat 36,2022-08-26,15:00:00,451,201,250,FMN 02 Mercatorstraat
650,Mercatorstraat 36,2022-08-26,16:00:00,560,216,344,FMN 02 Mercatorstraat
650,Mercatorstraat 36,2022-08-26,17:00:00,600,206,394,FMN 02 Mercatorstraat
650,Mercatorstraat 36,2022-08-26,18:00:00,537,236,301,FMN 02 Mercatorstraat
650,Mercatorstraat 36,2022-08-26,19:00:00,393,199,194,FMN 02 Mercatorstraat
650,Mercatorstraat 36,2022-08-26,20:00:00,288,135,153,FMN 02 Mercatorstraat
650,Mercatorstraat 36,2022-08-26,21:00:00,264,130,134,FMN 02 Mercatorstraat
650,Mercatorstraat 36,2022-08-26,22:00:00,232,101,131,FMN 02 Mercatorstraat
650,Mercatorstraat 36,2022-08-26,23:00:00,205,71,134,FMN 02 Mercatorstraat
650,Mercatorstraat 36,2022-08-27,00:00:00,186,72,114,FMN 02 Mercatorstraat
650,Mercatorstraat 36,2022-08-27,01:00:00,124,53,71,FMN 02 Mercatorstraat
650,Mercatorstraat 36,2022-08-27,02:00:00,87,37,50,FMN 02 Mercatorstraat
650,Mercatorstraat 36,2022-08-27,03:00:00,63,24,39,FMN 02 Mercatorstraat
650,Mercatorstraat 36,2022-08-27,04:00:00,39,13,26,FMN 02 Mercatorstraat
650,Mercatorstraat 36,2022-08-27,05:00:00,54,24,30,FMN 02 Mercatorstraat
650,Mercatorstraat 36,2022-08-27,06:00:00,40,23,17,FMN 02 Mercatorstraat
650,Mercatorstraat 36,2022-08-27,07:00:00,65,31,34,FMN 02 Mercatorstraat
650,Mercatorstraat 36,2022-08-27,08:00:00,105,73,32,FMN 02 Mercatorstraat
650,Mercatorstraat 36,2022-08-27,09:00:00,227,171,56,FMN 02 Mercatorstraat
650,Mercatorstraat 36,2022-08-27,10:00:00,318,244,74,FMN 02 Mercatorstraat
650,Mercatorstraat 36,2022-08-27,11:00:00,359,233,126,FMN 02 Mercatorstraat
650,Mercatorstraat 36,2022-08-27,12:00:00,378,201,177,FMN 02 Mercatorstraat
650,Mercatorstraat 36,2022-08-27,13:00:00,412,236,176,FMN 02 Mercatorstraat
650,Mercatorstraat 36,2022-08-27,14:00:00,406,216,190,FMN 02 Mercatorstraat
650,Mercatorstraat 36,2022-08-27,15:00:00,409,215,194,FMN 02 Mercatorstraat
650,Mercatorstraat 36,2022-08-27,16:00:00,420,145,275,FMN 02 Mercatorstraat
650,Mercatorstraat 36,2022-08-27,17:00:00,382,153,229,FMN 02 Mercatorstraat
650,Mercatorstraat 36,2022-08-27,18:00:00,371,132,239,FMN 02 Mercatorstraat
650,Mercatorstraat 36,2022-08-27,19:00:00,289,139,150,FMN 02 Mercatorstraat
650,Mercatorstraat 36,2022-08-27,20:00:00,271,133,138,FMN 02 Mercatorstraat
650,Mercatorstraat 36,2022-08-27,21:00:00,230,99,131,FMN 02 Mercatorstraat
650,Mercatorstraat 36,2022-08-27,22:00:00,171,71,100,FMN 02 Mercatorstraat
650,Mercatorstraat 36,2022-08-27,23:00:00,150,62,88,FMN 02 Mercatorstraat
650,Mercatorstraat 36,2022-08-28,00:00:00,136,62,74,FMN 02 Mercatorstraat
650,Mercatorstraat 36,2022-08-28,01:00:00,115,49,66,FMN 02 Mercatorstraat
650,Mercatorstraat 36,2022-08-28,02:00:00,117,39,78,FMN 02 Mercatorstraat
650,Mercatorstraat 36,2022-08-28,03:00:00,74,18,56,FMN 02 Mercatorstraat
650,Mercatorstraat 36,2022-08-28,04:00:00,55,24,31,FMN 02 Mercatorstraat
650,Mercatorstraat 36,2022-08-28,05:00:00,34,12,22,FMN 02 Mercatorstraat
650,Mercatorstraat 36,2022-08-28,06:00:00,40,24,16,FMN 02 Mercatorstraat
650,Mercatorstraat 36,2022-08-28,07:00:00,50,26,24,FMN 02 Mercatorstraat
650,Mercatorstraat 36,2022-08-28,08:00:00,106,65,41,FMN 02 Mercatorstraat
650,Mercatorstraat 36,2022-08-28,09:00:00,173,105,68,FMN 02 Mercatorstraat
650,Mercatorstraat 36,2022-08-28,10:00:00,294,214,80,FMN 02 Mercatorstraat
650,Mercatorstraat 36,2022-08-28,11:00:00,317,189,128,FMN 02 Mercatorstraat
650,Mercatorstraat 36,2022-08-28,12:00:00,353,206,147,FMN 02 Mercatorstraat
650,Mercatorstraat 36,2022-08-28,13:00:00,418,244,174,FMN 02 Mercatorstraat
650,Mercatorstraat 36,2022-08-28,14:00:00,435,239,196,FMN 02 Mercatorstraat
650,Mercatorstraat 36,2022-08-28,15:00:00,430,228,202,FMN 02 Mercatorstraat
650,Mercatorstraat 36,2022-08-28,16:00:00,360,151,209,FMN 02 Mercatorstraat
650,Mercatorstraat 36,2022-08-28,17:00:00,408,169,239,FMN 02 Mercatorstraat
650,Mercatorstraat 36,2022-08-28,18:00:00,320,136,184,FMN 02 Mercatorstraat
650,Mercatorstraat 36,2022-08-28,19:00:00,329,152,177,FMN 02 Mercatorstraat
650,Mercatorstraat 36,2022-08-28,20:00:00,273,109,164,FMN 02 Mercatorstraat
650,Mercatorstraat 36,2022-08-28,21:00:00,261,109,152,FMN 02 Mercatorstraat
650,Mercatorstraat 36,2022-08-28,22:00:00,193,87,106,FMN 02 Mercatorstraat
650,Mercatorstraat 36,2022-08-28,23:00:00,113,41,72,FMN 02 Mercatorstraat
650,Mercatorstraat 36,2022-08-29,00:00:00,66,34,32,FMN 02 Mercatorstraat
650,Mercatorstraat 36,2022-08-29,01:00:00,29,13,16,FMN 02 Mercatorstraat
650,Mercatorstraat 36,2022-08-29,02:00:00,22,9,13,FMN 02 Mercatorstraat
650,Mercatorstraat 36,2022-08-29,03:00:00,21,7,14,FMN 02 Mercatorstraat
650,Mercatorstraat 36,2022-08-29,04:00:00,34,19,15,FMN 02 Mercatorstraat
650,Mercatorstraat 36,2022-08-29,05:00:00,51,27,24,FMN 02 Mercatorstraat
650,Mercatorstraat 36,2022-08-29,06:00:00,122,78,44,FMN 02 Mercatorstraat
650,Mercatorstraat 36,2022-08-29,07:00:00,293,187,106,FMN 02 Mercatorstraat
650,Mercatorstraat 36,2022-08-29,08:00:00,704,531,173,FMN 02 Mercatorstraat
650,Mercatorstraat 36,2022-08-29,09:00:00,459,348,111,FMN 02 Mercatorstraat
650,Mercatorstraat 36,2022-08-29,10:00:00,265,169,96,FMN 02 Mercatorstraat
650,Mercatorstraat 36,2022-08-29,11:00:00,281,169,112,FMN 02 Mercatorstraat
650,Mercatorstraat 36,2022-08-29,12:00:00,371,200,171,FMN 02 Mercatorstraat
650,Mercatorstraat 36,2022-08-29,13:00:00,374,197,177,FMN 02 Mercatorstraat
650,Mercatorstraat 36,2022-08-29,14:00:00,403,215,188,FMN 02 Mercatorstraat
650,Mercatorstraat 36,2022-08-29,15:00:00,420,188,232,FMN 02 Mercatorstraat
650,Mercatorstraat 36,2022-08-29,16:00:00,632,201,431,FMN 02 Mercatorstraat
650,Mercatorstraat 36,2022-08-29,17:00:00,760,226,534,FMN 02 Mercatorstraat
650,Mercatorstraat 36,2022-08-29,18:00:00,562,220,342,FMN 02 Mercatorstraat
650,Mercatorstraat 36,2022-08-29,19:00:00,359,160,199,FMN 02 Mercatorstraat
650,Mercatorstraat 36,2022-08-29,20:00:00,268,110,158,FMN 02 Mercatorstraat
650,Mercatorstraat 36,2022-08-29,21:00:00,253,100,153,FMN 02 Mercatorstraat
650,Mercatorstraat 36,2022-08-29,22:00:00,196,91,105,FMN 02 Mercatorstraat
650,Mercatorstraat 36,2022-08-29,23:00:00,139,57,82,FMN 02 Mercatorstraat
650,Mercatorstraat 36,2022-08-30,00:00:00,64,20,44,FMN 02 Mercatorstraat
650,Mercatorstraat 36,2022-08-30,01:00:00,42,14,28,FMN 02 Mercatorstraat
650,Mercatorstraat 36,2022-08-30,02:00:00,20,8,12,FMN 02 Mercatorstraat
650,Mercatorstraat 36,2022-08-30,03:00:00,15,8,7,FMN 02 Mercatorstraat
650,Mercatorstraat 36,2022-08-30,04:00:00,34,18,16,FMN 02 Mercatorstraat
650,Mercatorstraat 36,2022-08-30,05:00:00,53,34,19,FMN 02 Mercatorstraat
650,Mercatorstraat 36,2022-08-30,06:00:00,136,85,51,FMN 02 Mercatorstraat
650,Mercatorstraat 36,2022-08-30,07:00:00,337,214,123,FMN 02 Mercatorstraat
650,Mercatorstraat 36,2022-08-30,08:00:00,799,589,210,FMN 02 Mercatorstraat
650,Mercatorstraat 36,2022-08-30,09:00:00,470,339,131,FMN 02 Mercatorstraat
650,Mercatorstraat 36,2022-08-30,10:00:00,276,194,82,FMN 02 Mercatorstraat
650,Mercatorstraat 36,2022-08-30,11:00:00,312,188,124,FMN 02 Mercatorstraat
650,Mercatorstraat 36,2022-08-30,12:00:00,335,160,175,FMN 02 Mercatorstraat
650,Mercatorstraat 36,2022-08-30,13:00:00,421,248,173,FMN 02 Mercatorstraat
650,Mercatorstraat 36,2022-08-30,14:00:00,431,201,230,FMN 02 Mercatorstraat
650,Mercatorstraat 36,2022-08-30,15:00:00,436,169,267,FMN 02 Mercatorstraat
650,Mercatorstraat 36,2022-08-30,16:00:00,657,247,410,FMN 02 Mercatorstraat
650,Mercatorstraat 36,2022-08-30,17:00:00,801,271,530,FMN 02 Mercatorstraat
650,Mercatorstraat 36,2022-08-30,18:00:00,626,228,398,FMN 02 Mercatorstraat
650,Mercatorstraat 36,2022-08-30,19:00:00,372,160,212,FMN 02 Mercatorstraat
650,Mercatorstraat 36,2022-08-30,20:00:00,316,138,178,FMN 02 Mercatorstraat
650,Mercatorstraat 36,2022-08-30,21:00:00,292,134,158,FMN 02 Mercatorstraat
650,Mercatorstraat 36,2022-08-30,22:00:00,255,120,135,FMN 02 Mercatorstraat
650,Mercatorstraat 36,2022-08-30,23:00:00,129,52,77,FMN 02 Mercatorstraat
650,Mercatorstraat 36,2022-08-31,00:00:00,90,33,57,FMN 02 Mercatorstraat
650,Mercatorstraat 36,2022-08-31,01:00:00,54,14,40,FMN 02 Mercatorstraat
650,Mercatorstraat 36,2022-08-31,02:00:00,27,11,16,FMN 02 Mercatorstraat
650,Mercatorstraat 36,2022-08-31,03:00:00,23,9,14,FMN 02 Mercatorstraat
650,Mercatorstraat 36,2022-08-31,04:00:00,36,21,15,FMN 02 Mercatorstraat
650,Mercatorstraat 36,2022-08-31,05:00:00,61,30,31,FMN 02 Mercatorstraat
650,Mercatorstraat 36,2022-08-31,06:00:00,123,74,49,FMN 02 Mercatorstraat
650,Mercatorstraat 36,2022-08-31,07:00:00,323,213,110,FMN 02 Mercatorstraat
650,Mercatorstraat 36,2022-08-31,08:00:00,687,500,187,FMN 02 Mercatorstraat
650,Mercatorstraat 36,2022-08-31,09:00:00,496,349,147,FMN 02 Mercatorstraat
650,Mercatorstraat 36,2022-08-31,10:00:00,302,202,100,FMN 02 Mercatorstraat
650,Mercatorstraat 36,2022-08-31,11:00:00,313,169,144,FMN 02 Mercatorstraat
650,Mercatorstraat 36,2022-08-31,12:00:00,436,225,211,FMN 02 Mercatorstraat
650,Mercatorstraat 36,2022-08-31,13:00:00,444,242,202,FMN 02 Mercatorstraat
650,Mercatorstraat 36,2022-08-31,14:00:00,466,231,235,FMN 02 Mercatorstraat
650,Mercatorstraat 36,2022-08-31,15:00:00,457,180,277,FMN 02 Mercatorstraat
650,Mercatorstraat 36,2022-08-31,16:00:00,626,241,385,FMN 02 Mercatorstraat
650,Mercatorstraat 36,2022-08-31,17:00:00,803,292,511,FMN 02 Mercatorstraat
650,Mercatorstraat 36,2022-08-31,18:00:00,609,245,364,FMN 02 Mercatorstraat
650,Mercatorstraat 36,2022-08-31,19:00:00,410,183,227,FMN 02 Mercatorstraat
650,Mercatorstraat 36,2022-08-31,20:00:00,309,143,166,FMN 02 Mercatorstraat
650,Mercatorstraat 36,2022-08-31,21:00:00,240,107,133,FMN 02 Mercatorstraat
650,Mercatorstraat 36,2022-08-31,22:00:00,243,96,147,FMN 02 Mercatorstraat
650,Mercatorstraat 36,2022-08-31,23:00:00,164,53,111,FMN 02 Mercatorstraat
650,Mercatorstraat 36,2022-09-01,00:00:00,63,25,38,FMN 02 Mercatorstraat
650,Mercatorstraat 36,2022-09-01,01:00:00,51,19,32,FMN 02 Mercatorstraat
650,Mercatorstraat 36,2022-09-01,02:00:00,30,8,22,FMN 02 Mercatorstraat
650,Mercatorstraat 36,2022-09-01,03:00:00,21,9,12,FMN 02 Mercatorstraat
650,Mercatorstraat 36,2022-09-01,04:00:00,33,14,19,FMN 02 Mercatorstraat
650,Mercatorstraat 36,2022-09-01,05:00:00,56,28,28,FMN 02 Mercatorstraat
650,Mercatorstraat 36,2022-09-01,06:00:00,159,77,82,FMN 02 Mercatorstraat
650,Mercatorstraat 36,2022-09-01,07:00:00,432,297,135,FMN 02 Mercatorstraat
650,Mercatorstraat 36,2022-09-01,08:00:00,984,683,301,FMN 02 Mercatorstraat
650,Mercatorstraat 36,2022-09-01,09:00:00,574,429,145,FMN 02 Mercatorstraat
650,Mercatorstraat 36,2022-09-01,10:00:00,322,226,96,FMN 02 Mercatorstraat
650,Mercatorstraat 36,2022-09-01,11:00:00,299,185,114,FMN 02 Mercatorstraat
650,Mercatorstraat 36,2022-09-01,12:00:00,413,232,181,FMN 02 Mercatorstraat
650,Mercatorstraat 36,2022-09-01,13:00:00,448,213,235,FMN 02 Mercatorstraat
650,Mercatorstraat 36,2022-09-01,14:00:00,454,196,258,FMN 02 Mercatorstraat
650,Mercatorstraat 36,2022-09-01,15:00:00,618,218,400,FMN 02 Mercatorstraat
650,Mercatorstraat 36,2022-09-01,16:00:00,751,258,493,FMN 02 Mercatorstraat
650,Mercatorstraat 36,2022-09-01,17:00:00,770,248,522,FMN 02 Mercatorstraat
650,Mercatorstraat 36,2022-09-01,18:00:00,591,240,351,FMN 02 Mercatorstraat
650,Mercatorstraat 36,2022-09-01,19:00:00,379,189,190,FMN 02 Mercatorstraat
650,Mercatorstraat 36,2022-09-01,20:00:00,244,116,128,FMN 02 Mercatorstraat
650,Mercatorstraat 36,2022-09-01,21:00:00,280,109,171,FMN 02 Mercatorstraat
650,Mercatorstraat 36,2022-09-01,22:00:00,212,81,131,FMN 02 Mercatorstraat
650,Mercatorstraat 36,2022-09-01,23:00:00,133,52,81,FMN 02 Mercatorstraat
650,Mercatorstraat 36,2022-09-02,00:00:00,96,58,38,FMN 02 Mercatorstraat
650,Mercatorstraat 36,2022-09-02,01:00:00,53,16,37,FMN 02 Mercatorstraat
650,Mercatorstraat 36,2022-09-02,02:00:00,23,10,13,FMN 02 Mercatorstraat
650,Mercatorstraat 36,2022-09-02,03:00:00,30,8,22,FMN 02 Mercatorstraat
650,Mercatorstraat 36,2022-09-02,04:00:00,44,21,23,FMN 02 Mercatorstraat
650,Mercatorstraat 36,2022-09-02,05:00:00,54,21,33,FMN 02 Mercatorstraat
650,Mercatorstraat 36,2022-09-02,06:00:00,157,70,87,FMN 02 Mercatorstraat
650,Mercatorstraat 36,2022-09-02,07:00:00,449,282,167,FMN 02 Mercatorstraat
650,Mercatorstraat 36,2022-09-02,08:00:00,980,708,272,FMN 02 Mercatorstraat
650,Mercatorstraat 36,2022-09-02,09:00:00,438,325,113,FMN 02 Mercatorstraat
650,Mercatorstraat 36,2022-09-02,10:00:00,332,220,112,FMN 02 Mercatorstraat
650,Mercatorstraat 36,2022-09-02,11:00:00,312,194,118,FMN 02 Mercatorstraat
650,Mercatorstraat 36,2022-09-02,12:00:00,469,277,192,FMN 02 Mercatorstraat
650,Mercatorstraat 36,2022-09-02,13:00:00,399,201,198,FMN 02 Mercatorstraat
650,Mercatorstraat 36,2022-09-02,14:00:00,471,216,255,FMN 02 Mercatorstraat
650,Mercatorstraat 36,2022-09-02,15:00:00,602,216,386,FMN 02 Mercatorstraat
650,Mercatorstraat 36,2022-09-02,16:00:00,686,243,443,FMN 02 Mercatorstraat
650,Mercatorstraat 36,2022-09-02,17:00:00,704,236,468,FMN 02 Mercatorstraat
650,Mercatorstraat 36,2022-09-02,18:00:00,561,238,323,FMN 02 Mercatorstraat
650,Mercatorstraat 36,2022-09-02,19:00:00,405,202,203,FMN 02 Mercatorstraat
650,Mercatorstraat 36,2022-09-02,20:00:00,335,162,173,FMN 02 Mercatorstraat
650,Mercatorstraat 36,2022-09-02,21:00:00,314,142,172,FMN 02 Mercatorstraat
650,Mercatorstraat 36,2022-09-02,22:00:00,234,81,153,FMN 02 Mercatorstraat
650,Mercatorstraat 36,2022-09-02,23:00:00,228,88,140,FMN 02 Mercatorstraat
650,Mercatorstraat 36,2022-09-03,00:00:00,200,77,123,FMN 02 Mercatorstraat
650,Mercatorstraat 36,2022-09-03,01:00:00,168,66,102,FMN 02 Mercatorstraat
650,Mercatorstraat 36,2022-09-03,02:00:00,103,32,71,FMN 02 Mercatorstraat
650,Mercatorstraat 36,2022-09-03,03:00:00,64,16,48,FMN 02 Mercatorstraat
650,Mercatorstraat 36,2022-09-03,04:00:00,49,25,24,FMN 02 Mercatorstraat
650,Mercatorstraat 36,2022-09-03,05:00:00,54,27,27,FMN 02 Mercatorstraat
650,Mercatorstraat 36,2022-09-03,06:00:00,33,15,18,FMN 02 Mercatorstraat
650,Mercatorstraat 36,2022-09-03,07:00:00,63,30,33,FMN 02 Mercatorstraat
650,Mercatorstraat 36,2022-09-03,08:00:00,102,68,34,FMN 02 Mercatorstraat
650,Mercatorstraat 36,2022-09-03,09:00:00,251,196,55,FMN 02 Mercatorstraat
650,Mercatorstraat 36,2022-09-03,10:00:00,332,242,90,FMN 02 Mercatorstraat
650,Mercatorstraat 36,2022-09-03,11:00:00,347,191,156,FMN 02 Mercatorstraat
650,Mercatorstraat 36,2022-09-03,12:00:00,386,214,172,FMN 02 Mercatorstraat
650,Mercatorstraat 36,2022-09-03,13:00:00,417,236,181,FMN 02 Mercatorstraat
650,Mercatorstraat 36,2022-09-03,14:00:00,410,231,179,FMN 02 Mercatorstraat
650,Mercatorstraat 36,2022-09-03,15:00:00,442,231,211,FMN 02 Mercatorstraat
650,Mercatorstraat 36,2022-09-03,16:00:00,346,146,200,FMN 02 Mercatorstraat
650,Mercatorstraat 36,2022-09-03,17:00:00,409,174,235,FMN 02 Mercatorstraat
650,Mercatorstraat 36,2022-09-03,18:00:00,350,164,186,FMN 02 Mercatorstraat
650,Mercatorstraat 36,2022-09-03,19:00:00,295,140,155,FMN 02 Mercatorstraat
650,Mercatorstraat 36,2022-09-03,20:00:00,236,116,120,FMN 02 Mercatorstraat
650,Mercatorstraat 36,2022-09-03,21:00:00,170,72,98,FMN 02 Mercatorstraat
650,Mercatorstraat 36,2022-09-03,22:00:00,188,89,99,FMN 02 Mercatorstraat
650,Mercatorstraat 36,2022-09-03,23:00:00,149,77,72,FMN 02 Mercatorstraat
650,Mercatorstraat 36,2022-09-04,00:00:00,145,65,80,FMN 02 Mercatorstraat
650,Mercatorstraat 36,2022-09-04,01:00:00,117,48,69,FMN 02 Mercatorstraat
650,Mercatorstraat 36,2022-09-04,02:00:00,72,21,51,FMN 02 Mercatorstraat
650,Mercatorstraat 36,2022-09-04,03:00:00,72,14,58,FMN 02 Mercatorstraat
650,Mercatorstraat 36,2022-09-04,04:00:00,56,11,45,FMN 02 Mercatorstraat
650,Mercatorstraat 36,2022-09-04,05:00:00,44,16,28,FMN 02 Mercatorstraat
650,Mercatorstraat 36,2022-09-04,06:00:00,35,19,16,FMN 02 Mercatorstraat
650,Mercatorstraat 36,2022-09-04,07:00:00,70,33,37,FMN 02 Mercatorstraat
650,Mercatorstraat 36,2022-09-04,08:00:00,110,45,65,FMN 02 Mercatorstraat
650,Mercatorstraat 36,2022-09-04,09:00:00,292,150,142,FMN 02 Mercatorstraat
650,Mercatorstraat 36,2022-09-04,10:00:00,302,212,90,FMN 02 Mercatorstraat
650,Mercatorstraat 36,2022-09-04,11:00:00,361,226,135,FMN 02 Mercatorstraat
650,Mercatorstraat 36,2022-09-04,12:00:00,380,224,156,FMN 02 Mercatorstraat
650,Mercatorstraat 36,2022-09-04,13:00:00,511,304,207,FMN 02 Mercatorstraat
650,Mercatorstraat 36,2022-09-04,14:00:00,459,250,209,FMN 02 Mercatorstraat
650,Mercatorstraat 36,2022-09-04,15:00:00,416,229,187,FMN 02 Mercatorstraat
650,Mercatorstraat 36,2022-09-04,16:00:00,383,171,212,FMN 02 Mercatorstraat
650,Mercatorstraat 36,2022-09-04,17:00:00,378,144,234,FMN 02 Mercatorstraat
650,Mercatorstraat 36,2022-09-04,18:00:00,385,180,205,FMN 02 Mercatorstraat
650,Mercatorstraat 36,2022-09-04,19:00:00,341,165,176,FMN 02 Mercatorstraat
650,Mercatorstraat 36,2022-09-04,20:00:00,245,110,135,FMN 02 Mercatorstraat
650,Mercatorstraat 36,2022-09-04,21:00:00,267,119,148,FMN 02 Mercatorstraat
650,Mercatorstraat 36,2022-09-04,22:00:00,187,79,108,FMN 02 Mercatorstraat
650,Mercatorstraat 36,2022-09-04,23:00:00,81,35,46,FMN 02 Mercatorstraat
650,Mercatorstraat 36,2022-09-05,00:00:00,61,18,43,FMN 02 Mercatorstraat
650,Mercatorstraat 36,2022-09-05,01:00:00,38,19,19,FMN 02 Mercatorstraat
650,Mercatorstraat 36,2022-09-05,02:00:00,21,5,16,FMN 02 Mercatorstraat
650,Mercatorstraat 36,2022-09-05,03:00:00,15,6,9,FMN 02 Mercatorstraat
650,Mercatorstraat 36,2022-09-05,04:00:00,38,20,18,FMN 02 Mercatorstraat
650,Mercatorstraat 36,2022-09-05,05:00:00,59,30,29,FMN 02 Mercatorstraat
650,Mercatorstraat 36,2022-09-05,06:00:00,139,81,58,FMN 02 Mercatorstraat
650,Mercatorstraat 36,2022-09-05,07:00:00,522,334,188,FMN 02 Mercatorstraat
650,Mercatorstraat 36,2022-09-05,08:00:00,1074,742,332,FMN 02 Mercatorstraat
650,Mercatorstraat 36,2022-09-05,09:00:00,415,313,102,FMN 02 Mercatorstraat
650,Mercatorstraat 36,2022-09-05,10:00:00,253,165,88,FMN 02 Mercatorstraat
650,Mercatorstraat 36,2022-09-05,11:00:00,261,138,123,FMN 02 Mercatorstraat
650,Mercatorstraat 36,2022-09-05,12:00:00,379,214,165,FMN 02 Mercatorstraat
650,Mercatorstraat 36,2022-09-05,13:00:00,350,168,182,FMN 02 Mercatorstraat
650,Mercatorstraat 36,2022-09-05,14:00:00,369,173,196,FMN 02 Mercatorstraat
650,Mercatorstraat 36,2022-09-05,15:00:00,548,199,349,FMN 02 Mercatorstraat
650,Mercatorstraat 36,2022-09-05,16:00:00,798,260,538,FMN 02 Mercatorstraat
650,Mercatorstraat 36,2022-09-05,17:00:00,790,264,526,FMN 02 Mercatorstraat
650,Mercatorstraat 36,2022-09-05,18:00:00,527,198,329,FMN 02 Mercatorstraat
650,Mercatorstraat 36,2022-09-05,19:00:00,308,140,168,FMN 02 Mercatorstraat
650,Mercatorstraat 36,2022-09-05,20:00:00,222,85,137,FMN 02 Mercatorstraat
650,Mercatorstraat 36,2022-09-05,21:00:00,151,71,80,FMN 02 Mercatorstraat
650,Mercatorstraat 36,2022-09-05,22:00:00,135,63,72,FMN 02 Mercatorstraat
650,Mercatorstraat 36,2022-09-05,23:00:00,75,28,47,FMN 02 Mercatorstraat
650,Mercatorstraat 36,2022-09-06,00:00:00,41,16,25,FMN 02 Mercatorstraat
650,Mercatorstraat 36,2022-09-06,01:00:00,19,5,14,FMN 02 Mercatorstraat
650,Mercatorstraat 36,2022-09-06,02:00:00,21,8,13,FMN 02 Mercatorstraat
650,Mercatorstraat 36,2022-09-06,03:00:00,14,4,10,FMN 02 Mercatorstraat
650,Mercatorstraat 36,2022-09-06,04:00:00,36,25,11,FMN 02 Mercatorstraat
650,Mercatorstraat 36,2022-09-06,05:00:00,56,30,26,FMN 02 Mercatorstraat
650,Mercatorstraat 36,2022-09-06,06:00:00,142,77,65,FMN 02 Mercatorstraat
650,Mercatorstraat 36,2022-09-06,07:00:00,504,328,176,FMN 02 Mercatorstraat
650,Mercatorstraat 36,2022-09-06,08:00:00,1129,798,331,FMN 02 Mercatorstraat
650,Mercatorstraat 36,2022-09-06,09:00:00,459,340,119,FMN 02 Mercatorstraat
650,Mercatorstraat 36,2022-09-06,10:00:00,283,184,99,FMN 02 Mercatorstraat
650,Mercatorstraat 36,2022-09-06,11:00:00,291,163,128,FMN 02 Mercatorstraat
650,Mercatorstraat 36,2022-09-06,12:00:00,363,187,176,FMN 02 Mercatorstraat
650,Mercatorstraat 36,2022-09-06,13:00:00,386,194,192,FMN 02 Mercatorstraat
650,Mercatorstraat 36,2022-09-06,14:00:00,354,174,180,FMN 02 Mercatorstraat
650,Mercatorstraat 36,2022-09-06,15:00:00,571,196,375,FMN 02 Mercatorstraat
650,Mercatorstraat 36,2022-09-06,16:00:00,802,286,516,FMN 02 Mercatorstraat
650,Mercatorstraat 36,2022-09-06,17:00:00,972,298,674,FMN 02 Mercatorstraat
650,Mercatorstraat 36,2022-09-06,18:00:00,628,251,377,FMN 02 Mercatorstraat
650,Mercatorstraat 36,2022-09-06,19:00:00,366,169,197,FMN 02 Mercatorstraat
650,Mercatorstraat 36,2022-09-06,20:00:00,302,131,171,FMN 02 Mercatorstraat
650,Mercatorstraat 36,2022-09-06,21:00:00,249,125,124,FMN 02 Mercatorstraat
650,Mercatorstraat 36,2022-09-06,22:00:00,206,77,129,FMN 02 Mercatorstraat
650,Mercatorstraat 36,2022-09-06,23:00:00,90,39,51,FMN 02 Mercatorstraat
650,Mercatorstraat 36,2022-09-07,00:00:00,42,14,28,FMN 02 Mercatorstraat
650,Mercatorstraat 36,2022-09-07,01:00:00,39,14,25,FMN 02 Mercatorstraat
650,Mercatorstraat 36,2022-09-07,02:00:00,18,11,7,FMN 02 Mercatorstraat
650,Mercatorstraat 36,2022-09-07,03:00:00,26,10,16,FMN 02 Mercatorstraat
650,Mercatorstraat 36,2022-09-07,04:00:00,37,22,15,FMN 02 Mercatorstraat
650,Mercatorstraat 36,2022-09-07,05:00:00,50,25,25,FMN 02 Mercatorstraat
650,Mercatorstraat 36,2022-09-07,06:00:00,134,73,61,FMN 02 Mercatorstraat
650,Mercatorstraat 36,2022-09-07,07:00:00,459,290,169,FMN 02 Mercatorstraat
650,Mercatorstraat 36,2022-09-07,08:00:00,955,659,296,FMN 02 Mercatorstraat
650,Mercatorstraat 36,2022-09-07,09:00:00,419,308,111,FMN 02 Mercatorstraat
650,Mercatorstraat 36,2022-09-07,10:00:00,285,169,116,FMN 02 Mercatorstraat
650,Mercatorstraat 36,2022-09-07,11:00:00,294,152,142,FMN 02 Mercatorstraat
650,Mercatorstraat 36,2022-09-07,12:00:00,647,266,381,FMN 02 Mercatorstraat
650,Mercatorstraat 36,2022-09-07,13:00:00,511,246,265,FMN 02 Mercatorstraat
650,Mercatorstraat 36,2022-09-07,14:00:00,430,226,204,FMN 02 Mercatorstraat
650,Mercatorstraat 36,2022-09-07,15:00:00,427,168,259,FMN 02 Mercatorstraat
650,Mercatorstraat 36,2022-09-07,16:00:00,585,233,352,FMN 02 Mercatorstraat
650,Mercatorstraat 36,2022-09-07,17:00:00,734,255,479,FMN 02 Mercatorstraat
650,Mercatorstraat 36,2022-09-07,18:00:00,634,257,377,FMN 02 Mercatorstraat
650,Mercatorstraat 36,2022-09-07,19:00:00,365,169,196,FMN 02 Mercatorstraat
650,Mercatorstraat 36,2022-09-07,20:00:00,267,136,131,FMN 02 Mercatorstraat
650,Mercatorstraat 36,2022-09-07,21:00:00,247,95,152,FMN 02 Mercatorstraat
650,Mercatorstraat 36,2022-09-07,22:00:00,223,80,143,FMN 02 Mercatorstraat
650,Mercatorstraat 36,2022-09-07,23:00:00,132,65,67,FMN 02 Mercatorstraat
650,Mercatorstraat 36,2022-09-08,00:00:00,92,43,49,FMN 02 Mercatorstraat
650,Mercatorstraat 36,2022-09-08,01:00:00,36,14,22,FMN 02 Mercatorstraat
650,Mercatorstraat 36,2022-09-08,02:00:00,26,8,18,FMN 02 Mercatorstraat
650,Mercatorstraat 36,2022-09-08,03:00:00,22,6,16,FMN 02 Mercatorstraat
650,Mercatorstraat 36,2022-09-08,04:00:00,42,19,23,FMN 02 Mercatorstraat
650,Mercatorstraat 36,2022-09-08,05:00:00,56,32,24,FMN 02 Mercatorstraat
650,Mercatorstraat 36,2022-09-08,06:00:00,127,68,59,FMN 02 Mercatorstraat
650,Mercatorstraat 36,2022-09-08,07:00:00,421,253,168,FMN 02 Mercatorstraat
650,Mercatorstraat 36,2022-09-08,08:00:00,1031,737,294,FMN 02 Mercatorstraat
650,Mercatorstraat 36,2022-09-08,09:00:00,440,336,104,FMN 02 Mercatorstraat
650,Mercatorstraat 36,2022-09-08,10:00:00,250,156,94,FMN 02 Mercatorstraat
650,Mercatorstraat 36,2022-09-08,11:00:00,260,144,116,FMN 02 Mercatorstraat
650,Mercatorstraat 36,2022-09-08,12:00:00,347,175,172,FMN 02 Mercatorstraat
650,Mercatorstraat 36,2022-09-08,13:00:00,326,156,170,FMN 02 Mercatorstraat
650,Mercatorstraat 36,2022-09-08,14:00:00,318,151,167,FMN 02 Mercatorstraat
650,Mercatorstraat 36,2022-09-08,15:00:00,456,154,302,FMN 02 Mercatorstraat
650,Mercatorstraat 36,2022-09-08,16:00:00,719,253,466,FMN 02 Mercatorstraat
650,Mercatorstraat 36,2022-09-08,17:00:00,726,230,496,FMN 02 Mercatorstraat
650,Mercatorstraat 36,2022-09-08,18:00:00,485,183,302,FMN 02 Mercatorstraat
650,Mercatorstraat 36,2022-09-08,19:00:00,342,156,186,FMN 02 Mercatorstraat
650,Mercatorstraat 36,2022-09-08,20:00:00,172,83,89,FMN 02 Mercatorstraat
650,Mercatorstraat 36,2022-09-08,21:00:00,204,78,126,FMN 02 Mercatorstraat
650,Mercatorstraat 36,2022-09-08,22:00:00,145,59,86,FMN 02 Mercatorstraat
650,Mercatorstraat 36,2022-09-08,23:00:00,103,43,60,FMN 02 Mercatorstraat
650,Mercatorstraat 36,2022-09-09,00:00:00,69,35,34,FMN 02 Mercatorstraat
650,Mercatorstraat 36,2022-09-09,01:00:00,58,20,38,FMN 02 Mercatorstraat
650,Mercatorstraat 36,2022-09-09,02:00:00,20,7,13,FMN 02 Mercatorstraat
650,Mercatorstraat 36,2022-09-09,03:00:00,25,9,16,FMN 02 Mercatorstraat
650,Mercatorstraat 36,2022-09-09,04:00:00,49,17,32,FMN 02 Mercatorstraat
650,Mercatorstraat 36,2022-09-09,05:00:00,66,30,36,FMN 02 Mercatorstraat
650,Mercatorstraat 36,2022-09-09,06:00:00,124,64,60,FMN 02 Mercatorstraat
650,Mercatorstraat 36,2022-09-09,07:00:00,367,219,148,FMN 02 Mercatorstraat
650,Mercatorstraat 36,2022-09-09,08:00:00,859,606,253,FMN 02 Mercatorstraat
650,Mercatorstraat 36,2022-09-09,09:00:00,365,238,127,FMN 02 Mercatorstraat
650,Mercatorstraat 36,2022-09-09,10:00:00,218,130,88,FMN 02 Mercatorstraat
650,Mercatorstraat 36,2022-09-09,11:00:00,214,104,110,FMN 02 Mercatorstraat
650,Mercatorstraat 36,2022-09-09,12:00:00,335,170,165,FMN 02 Mercatorstraat
650,Mercatorstraat 36,2022-09-09,13:00:00,320,158,162,FMN 02 Mercatorstraat
650,Mercatorstraat 36,2022-09-09,14:00:00,301,134,167,FMN 02 Mercatorstraat
650,Mercatorstraat 36,2022-09-09,15:00:00,506,187,319,FMN 02 Mercatorstraat
650,Mercatorstraat 36,2022-09-09,16:00:00,552,193,359,FMN 02 Mercatorstraat
650,Mercatorstraat 36,2022-09-09,17:00:00,518,184,334,FMN 02 Mercatorstraat
650,Mercatorstraat 36,2022-09-09,18:00:00,448,196,252,FMN 02 Mercatorstraat
650,Mercatorstraat 36,2022-09-09,19:00:00,310,148,162,FMN 02 Mercatorstraat
650,Mercatorstraat 36,2022-09-09,20:00:00,234,106,128,FMN 02 Mercatorstraat
650,Mercatorstraat 36,2022-09-09,21:00:00,212,121,91,FMN 02 Mercatorstraat
650,Mercatorstraat 36,2022-09-09,22:00:00,158,71,87,FMN 02 Mercatorstraat
650,Mercatorstraat 36,2022-09-09,23:00:00,177,88,89,FMN 02 Mercatorstraat
650,Mercatorstraat 36,2022-09-10,00:00:00,151,57,94,FMN 02 Mercatorstraat
650,Mercatorstraat 36,2022-09-10,01:00:00,110,45,65,FMN 02 Mercatorstraat
650,Mercatorstraat 36,2022-09-10,02:00:00,79,23,56,FMN 02 Mercatorstraat
650,Mercatorstraat 36,2022-09-10,03:00:00,61,30,31,FMN 02 Mercatorstraat
650,Mercatorstraat 36,2022-09-10,04:00:00,58,24,34,FMN 02 Mercatorstraat
650,Mercatorstraat 36,2022-09-10,05:00:00,51,26,25,FMN 02 Mercatorstraat
650,Mercatorstraat 36,2022-09-10,06:00:00,30,16,14,FMN 02 Mercatorstraat
650,Mercatorstraat 36,2022-09-10,07:00:00,39,23,16,FMN 02 Mercatorstraat
650,Mercatorstraat 36,2022-09-10,08:00:00,57,25,32,FMN 02 Mercatorstraat
650,Mercatorstraat 36,2022-09-10,09:00:00,78,56,22,FMN 02 Mercatorstraat
650,Mercatorstraat 36,2022-09-10,10:00:00,79,45,34,FMN 02 Mercatorstraat
650,Mercatorstraat 36,2022-09-10,11:00:00,130,80,50,FMN 02 Mercatorstraat
650,Mercatorstraat 36,2022-09-10,12:00:00,150,85,65,FMN 02 Mercatorstraat
650,Mercatorstraat 36,2022-09-10,13:00:00,142,70,72,FMN 02 Mercatorstraat
650,Mercatorstraat 36,2022-09-10,14:00:00,238,140,98,FMN 02 Mercatorstraat
650,Mercatorstraat 36,2022-09-10,15:00:00,222,133,89,FMN 02 Mercatorstraat
650,Mercatorstraat 36,2022-09-10,16:00:00,233,125,108,FMN 02 Mercatorstraat
650,Mercatorstraat 36,2022-09-10,17:00:00,271,130,141,FMN 02 Mercatorstraat
650,Mercatorstraat 36,2022-09-10,18:00:00,261,149,112,FMN 02 Mercatorstraat
650,Mercatorstraat 36,2022-09-10,19:00:00,232,110,122,FMN 02 Mercatorstraat
650,Mercatorstraat 36,2022-09-10,20:00:00,180,91,89,FMN 02 Mercatorstraat
650,Mercatorstraat 36,2022-09-10,21:00:00,182,87,95,FMN 02 Mercatorstraat
650,Mercatorstraat 36,2022-09-10,22:00:00,154,77,77,FMN 02 Mercatorstraat
650,Mercatorstraat 36,2022-09-10,23:00:00,163,73,90,FMN 02 Mercatorstraat
650,Mercatorstraat 36,2022-09-11,00:00:00,119,41,78,FMN 02 Mercatorstraat
650,Mercatorstraat 36,2022-09-11,01:00:00,133,59,74,FMN 02 Mercatorstraat
650,Mercatorstraat 36,2022-09-11,02:00:00,102,36,66,FMN 02 Mercatorstraat
650,Mercatorstraat 36,2022-09-11,03:00:00,52,28,24,FMN 02 Mercatorstraat
650,Mercatorstraat 36,2022-09-11,04:00:00,63,27,36,FMN 02 Mercatorstraat
650,Mercatorstraat 36,2022-09-11,05:00:00,61,28,33,FMN 02 Mercatorstraat
650,Mercatorstraat 36,2022-09-11,06:00:00,50,21,29,FMN 02 Mercatorstraat
650,Mercatorstraat 36,2022-09-11,07:00:00,85,51,34,FMN 02 Mercatorstraat
650,Mercatorstraat 36,2022-09-11,08:00:00,241,143,98,FMN 02 Mercatorstraat
650,Mercatorstraat 36,2022-09-11,09:00:00,326,163,163,FMN 02 Mercatorstraat
650,Mercatorstraat 36,2022-09-11,10:00:00,340,264,76,FMN 02 Mercatorstraat
650,Mercatorstraat 36,2022-09-11,11:00:00,343,203,140,FMN 02 Mercatorstraat
650,Mercatorstraat 36,2022-09-11,12:00:00,509,269,240,FMN 02 Mercatorstraat
650,Mercatorstraat 36,2022-09-11,13:00:00,544,357,187,FMN 02 Mercatorstraat
650,Mercatorstraat 36,2022-09-11,14:00:00,554,317,237,FMN 02 Mercatorstraat
650,Mercatorstraat 36,2022-09-11,15:00:00,569,279,290,FMN 02 Mercatorstraat
650,Mercatorstraat 36,2022-09-11,16:00:00,471,230,241,FMN 02 Mercatorstraat
650,Mercatorstraat 36,2022-09-11,17:00:00,416,160,256,FMN 02 Mercatorstraat
650,Mercatorstraat 36,2022-09-11,18:00:00,385,150,235,FMN 02 Mercatorstraat
650,Mercatorstraat 36,2022-09-11,19:00:00,358,173,185,FMN 02 Mercatorstraat
650,Mercatorstraat 36,2022-09-11,20:00:00,233,101,132,FMN 02 Mercatorstraat
650,Mercatorstraat 36,2022-09-11,21:00:00,208,59,149,FMN 02 Mercatorstraat
650,Mercatorstraat 36,2022-09-11,22:00:00,201,74,127,FMN 02 Mercatorstraat
650,Mercatorstraat 36,2022-09-11,23:00:00,84,31,53,FMN 02 Mercatorstraat
650,Mercatorstraat 36,2022-09-12,00:00:00,60,21,39,FMN 02 Mercatorstraat
650,Mercatorstraat 36,2022-09-12,01:00:00,27,13,14,FMN 02 Mercatorstraat
650,Mercatorstraat 36,2022-09-12,02:00:00,18,7,11,FMN 02 Mercatorstraat
650,Mercatorstraat 36,2022-09-12,03:00:00,8,5,3,FMN 02 Mercatorstraat
650,Mercatorstraat 36,2022-09-12,04:00:00,26,15,11,FMN 02 Mercatorstraat
650,Mercatorstraat 36,2022-09-12,05:00:00,41,21,20,FMN 02 Mercatorstraat
650,Mercatorstraat 36,2022-09-12,06:00:00,120,71,49,FMN 02 Mercatorstraat
650,Mercatorstraat 36,2022-09-12,07:00:00,448,284,164,FMN 02 Mercatorstraat
650,Mercatorstraat 36,2022-09-12,08:00:00,1072,734,338,FMN 02 Mercatorstraat
650,Mercatorstraat 36,2022-09-12,09:00:00,419,309,110,FMN 02 Mercatorstraat
650,Mercatorstraat 36,2022-09-12,10:00:00,261,180,81,FMN 02 Mercatorstraat
650,Mercatorstraat 36,2022-09-12,11:00:00,257,147,110,FMN 02 Mercatorstraat
650,Mercatorstraat 36,2022-09-12,12:00:00,398,214,184,FMN 02 Mercatorstraat
650,Mercatorstraat 36,2022-09-12,13:00:00,344,180,164,FMN 02 Mercatorstraat
650,Mercatorstraat 36,2022-09-12,14:00:00,376,193,183,FMN 02 Mercatorstraat
650,Mercatorstraat 36,2022-09-12,15:00:00,513,197,316,FMN 02 Mercatorstraat
650,Mercatorstraat 36,2022-09-12,16:00:00,730,257,473,FMN 02 Mercatorstraat
650,Mercatorstraat 36,2022-09-12,17:00:00,787,245,542,FMN 02 Mercatorstraat
650,Mercatorstraat 36,2022-09-12,18:00:00,556,215,341,FMN 02 Mercatorstraat
650,Mercatorstraat 36,2022-09-12,19:00:00,386,179,207,FMN 02 Mercatorstraat
650,Mercatorstraat 36,2022-09-12,20:00:00,267,104,163,FMN 02 Mercatorstraat
650,Mercatorstraat 36,2022-09-12,21:00:00,238,107,131,FMN 02 Mercatorstraat
650,Mercatorstraat 36,2022-09-12,22:00:00,170,71,99,FMN 02 Mercatorstraat
650,Mercatorstraat 36,2022-09-12,23:00:00,111,42,69,FMN 02 Mercatorstraat
650,Mercatorstraat 36,2022-09-13,00:00:00,59,19,40,FMN 02 Mercatorstraat
650,Mercatorstraat 36,2022-09-13,01:00:00,33,14,19,FMN 02 Mercatorstraat
650,Mercatorstraat 36,2022-09-13,02:00:00,26,12,14,FMN 02 Mercatorstraat
650,Mercatorstraat 36,2022-09-13,03:00:00,9,5,4,FMN 02 Mercatorstraat
650,Mercatorstraat 36,2022-09-13,04:00:00,30,18,12,FMN 02 Mercatorstraat
650,Mercatorstraat 36,2022-09-13,05:00:00,48,24,24,FMN 02 Mercatorstraat
650,Mercatorstraat 36,2022-09-13,06:00:00,137,80,57,FMN 02 Mercatorstraat
650,Mercatorstraat 36,2022-09-13,07:00:00,454,278,176,FMN 02 Mercatorstraat
650,Mercatorstraat 36,2022-09-13,08:00:00,1105,758,347,FMN 02 Mercatorstraat
650,Mercatorstraat 36,2022-09-13,09:00:00,441,328,113,FMN 02 Mercatorstraat
650,Mercatorstraat 36,2022-09-13,10:00:00,261,163,98,FMN 02 Mercatorstraat
650,Mercatorstraat 36,2022-09-13,11:00:00,259,150,109,FMN 02 Mercatorstraat
650,Mercatorstraat 36,2022-09-13,12:00:00,382,189,193,FMN 02 Mercatorstraat
650,Mercatorstraat 36,2022-09-13,13:00:00,385,164,221,FMN 02 Mercatorstraat
650,Mercatorstraat 36,2022-09-13,14:00:00,363,157,206,FMN 02 Mercatorstraat
650,Mercatorstraat 36,2022-09-13,15:00:00,478,172,306,FMN 02 Mercatorstraat
650,Mercatorstraat 36,2022-09-13,16:00:00,683,242,441,FMN 02 Mercatorstraat
650,Mercatorstraat 36,2022-09-13,17:00:00,731,256,475,FMN 02 Mercatorstraat
650,Mercatorstraat 36,2022-09-13,18:00:00,512,198,314,FMN 02 Mercatorstraat
650,Mercatorstraat 36,2022-09-13,19:00:00,367,167,200,FMN 02 Mercatorstraat
650,Mercatorstraat 36,2022-09-13,20:00:00,207,90,117,FMN 02 Mercatorstraat
650,Mercatorstraat 36,2022-09-13,21:00:00,211,93,118,FMN 02 Mercatorstraat
650,Mercatorstraat 36,2022-09-13,22:00:00,155,62,93,FMN 02 Mercatorstraat
650,Mercatorstraat 36,2022-09-13,23:00:00,105,28,77,FMN 02 Mercatorstraat
650,Mercatorstraat 36,2022-09-14,00:00:00,39,16,23,FMN 02 Mercatorstraat
650,Mercatorstraat 36,2022-09-14,01:00:00,27,11,16,FMN 02 Mercatorstraat
650,Mercatorstraat 36,2022-09-14,02:00:00,18,5,13,FMN 02 Mercatorstraat
650,Mercatorstraat 36,2022-09-14,03:00:00,20,7,13,FMN 02 Mercatorstraat
650,Mercatorstraat 36,2022-09-14,04:00:00,27,17,10,FMN 02 Mercatorstraat
650,Mercatorstraat 36,2022-09-14,05:00:00,38,25,13,FMN 02 Mercatorstraat
650,Mercatorstraat 36,2022-09-14,06:00:00,113,66,47,FMN 02 Mercatorstraat
650,Mercatorstraat 36,2022-09-14,07:00:00,284,184,100,FMN 02 Mercatorstraat
650,Mercatorstraat 36,2022-09-14,08:00:00,704,492,212,FMN 02 Mercatorstraat
650,Mercatorstraat 36,2022-09-14,09:00:00,254,180,74,FMN 02 Mercatorstraat
650,Mercatorstraat 36,2022-09-14,10:00:00,121,68,53,FMN 02 Mercatorstraat
650,Mercatorstraat 36,2022-09-14,11:00:00,165,78,87,FMN 02 Mercatorstraat
650,Mercatorstraat 36,2022-09-14,12:00:00,310,92,218,FMN 02 Mercatorstraat
650,Mercatorstraat 36,2022-09-14,13:00:00,278,121,157,FMN 02 Mercatorstraat
650,Mercatorstraat 36,2022-09-14,14:00:00,167,78,89,FMN 02 Mercatorstraat
650,Mercatorstraat 36,2022-09-14,15:00:00,213,101,112,FMN 02 Mercatorstraat
650,Mercatorstraat 36,2022-09-14,16:00:00,324,125,199,FMN 02 Mercatorstraat
650,Mercatorstraat 36,2022-09-14,17:00:00,426,142,284,FMN 02 Mercatorstraat
650,Mercatorstraat 36,2022-09-14,18:00:00,446,195,251,FMN 02 Mercatorstraat
650,Mercatorstraat 36,2022-09-14,19:00:00,295,147,148,FMN 02 Mercatorstraat
650,Mercatorstraat 36,2022-09-14,20:00:00,178,86,92,FMN 02 Mercatorstraat
650,Mercatorstraat 36,2022-09-14,21:00:00,208,78,130,FMN 02 Mercatorstraat
650,Mercatorstraat 36,2022-09-14,22:00:00,171,72,99,FMN 02 Mercatorstraat
650,Mercatorstraat 36,2022-09-14,23:00:00,89,42,47,FMN 02 Mercatorstraat
650,Mercatorstraat 36,2022-09-15,00:00:00,65,21,44,FMN 02 Mercatorstraat
650,Mercatorstraat 36,2022-09-15,01:00:00,32,10,22,FMN 02 Mercatorstraat
650,Mercatorstraat 36,2022-09-15,02:00:00,14,3,11,FMN 02 Mercatorstraat
650,Mercatorstraat 36,2022-09-15,03:00:00,15,8,7,FMN 02 Mercatorstraat
650,Mercatorstraat 36,2022-09-15,04:00:00,28,15,13,FMN 02 Mercatorstraat
650,Mercatorstraat 36,2022-09-15,05:00:00,41,26,15,FMN 02 Mercatorstraat
650,Mercatorstraat 36,2022-09-15,06:00:00,139,78,61,FMN 02 Mercatorstraat
650,Mercatorstraat 36,2022-09-15,07:00:00,438,261,177,FMN 02 Mercatorstraat
650,Mercatorstraat 36,2022-09-15,08:00:00,1012,719,293,FMN 02 Mercatorstraat
650,Mercatorstraat 36,2022-09-15,09:00:00,411,301,110,FMN 02 Mercatorstraat
650,Mercatorstraat 36,2022-09-15,10:00:00,233,142,91,FMN 02 Mercatorstraat
650,Mercatorstraat 36,2022-09-15,11:00:00,212,120,92,FMN 02 Mercatorstraat
650,Mercatorstraat 36,2022-09-15,12:00:00,306,154,152,FMN 02 Mercatorstraat
650,Mercatorstraat 36,2022-09-15,13:00:00,346,168,178,FMN 02 Mercatorstraat
650,Mercatorstraat 36,2022-09-15,14:00:00,371,135,236,FMN 02 Mercatorstraat
650,Mercatorstraat 36,2022-09-15,15:00:00,535,178,357,FMN 02 Mercatorstraat
650,Mercatorstraat 36,2022-09-15,16:00:00,717,231,486,FMN 02 Mercatorstraat
650,Mercatorstraat 36,2022-09-15,17:00:00,768,304,464,FMN 02 Mercatorstraat
650,Mercatorstraat 36,2022-09-15,18:00:00,563,236,327,FMN 02 Mercatorstraat
650,Mercatorstraat 36,2022-09-15,19:00:00,360,167,193,FMN 02 Mercatorstraat
650,Mercatorstraat 36,2022-09-15,20:00:00,264,107,157,FMN 02 Mercatorstraat
650,Mercatorstraat 36,2022-09-15,21:00:00,268,110,158,FMN 02 Mercatorstraat
650,Mercatorstraat 36,2022-09-15,22:00:00,217,99,118,FMN 02 Mercatorstraat
650,Mercatorstraat 36,2022-09-15,23:00:00,162,46,116,FMN 02 Mercatorstraat
650,Mercatorstraat 36,2022-09-16,00:00:00,84,38,46,FMN 02 Mercatorstraat
650,Mercatorstraat 36,2022-09-16,01:00:00,57,19,38,FMN 02 Mercatorstraat
650,Mercatorstraat 36,2022-09-16,02:00:00,31,13,18,FMN 02 Mercatorstraat
650,Mercatorstraat 36,2022-09-16,03:00:00,19,5,14,FMN 02 Mercatorstraat
650,Mercatorstraat 36,2022-09-16,04:00:00,33,16,17,FMN 02 Mercatorstraat
650,Mercatorstraat 36,2022-09-16,05:00:00,48,25,23,FMN 02 Mercatorstraat
650,Mercatorstraat 36,2022-09-16,06:00:00,101,57,44,FMN 02 Mercatorstraat
650,Mercatorstraat 36,2022-09-16,07:00:00,322,188,134,FMN 02 Mercatorstraat
650,Mercatorstraat 36,2022-09-16,08:00:00,639,444,195,FMN 02 Mercatorstraat
650,Mercatorstraat 36,2022-09-16,09:00:00,308,219,89,FMN 02 Mercatorstraat
650,Mercatorstraat 36,2022-09-16,10:00:00,172,108,64,FMN 02 Mercatorstraat
650,Mercatorstraat 36,2022-09-16,11:00:00,164,88,76,FMN 02 Mercatorstraat
650,Mercatorstraat 36,2022-09-16,12:00:00,267,135,132,FMN 02 Mercatorstraat
650,Mercatorstraat 36,2022-09-16,13:00:00,251,126,125,FMN 02 Mercatorstraat
650,Mercatorstraat 36,2022-09-16,14:00:00,253,100,153,FMN 02 Mercatorstraat
650,Mercatorstraat 36,2022-09-16,15:00:00,401,135,266,FMN 02 Mercatorstraat
650,Mercatorstraat 36,2022-09-16,16:00:00,476,164,312,FMN 02 Mercatorstraat
650,Mercatorstraat 36,2022-09-16,17:00:00,428,160,268,FMN 02 Mercatorstraat
650,Mercatorstraat 36,2022-09-16,18:00:00,327,120,207,FMN 02 Mercatorstraat
650,Mercatorstraat 36,2022-09-16,19:00:00,233,109,124,FMN 02 Mercatorstraat
650,Mercatorstraat 36,2022-09-16,20:00:00,131,61,70,FMN 02 Mercatorstraat
650,Mercatorstraat 36,2022-09-16,21:00:00,138,68,70,FMN 02 Mercatorstraat
650,Mercatorstraat 36,2022-09-16,22:00:00,120,57,63,FMN 02 Mercatorstraat
650,Mercatorstraat 36,2022-09-16,23:00:00,140,49,91,FMN 02 Mercatorstraat
650,Mercatorstraat 36,2022-09-17,00:00:00,105,52,53,FMN 02 Mercatorstraat
650,Mercatorstraat 36,2022-09-17,01:00:00,109,61,48,FMN 02 Mercatorstraat
650,Mercatorstraat 36,2022-09-17,02:00:00,72,24,48,FMN 02 Mercatorstraat
650,Mercatorstraat 36,2022-09-17,03:00:00,93,24,69,FMN 02 Mercatorstraat
650,Mercatorstraat 36,2022-09-17,04:00:00,43,14,29,FMN 02 Mercatorstraat
650,Mercatorstraat 36,2022-09-17,05:00:00,48,18,30,FMN 02 Mercatorstraat
650,Mercatorstraat 36,2022-09-17,06:00:00,45,18,27,FMN 02 Mercatorstraat
650,Mercatorstraat 36,2022-09-17,07:00:00,46,24,22,FMN 02 Mercatorstraat
650,Mercatorstraat 36,2022-09-17,08:00:00,69,37,32,FMN 02 Mercatorstraat
650,Mercatorstraat 36,2022-09-17,09:00:00,126,84,42,FMN 02 Mercatorstraat
650,Mercatorstraat 36,2022-09-17,10:00:00,192,137,55,FMN 02 Mercatorstraat
650,Mercatorstraat 36,2022-09-17,11:00:00,183,116,67,FMN 02 Mercatorstraat
650,Mercatorstraat 36,2022-09-17,12:00:00,213,110,103,FMN 02 Mercatorstraat
650,Mercatorstraat 36,2022-09-17,13:00:00,243,152,91,FMN 02 Mercatorstraat
650,Mercatorstraat 36,2022-09-17,14:00:00,284,157,127,FMN 02 Mercatorstraat
650,Mercatorstraat 36,2022-09-17,15:00:00,240,127,113,FMN 02 Mercatorstraat
650,Mercatorstraat 36,2022-09-17,16:00:00,244,121,123,FMN 02 Mercatorstraat
650,Mercatorstraat 36,2022-09-17,17:00:00,280,120,160,FMN 02 Mercatorstraat
650,Mercatorstraat 36,2022-09-17,18:00:00,252,106,146,FMN 02 Mercatorstraat
650,Mercatorstraat 36,2022-09-17,19:00:00,195,90,105,FMN 02 Mercatorstraat
650,Mercatorstraat 36,2022-09-17,20:00:00,172,74,98,FMN 02 Mercatorstraat
650,Mercatorstraat 36,2022-09-17,21:00:00,111,51,60,FMN 02 Mercatorstraat
650,Mercatorstraat 36,2022-09-17,22:00:00,119,49,70,FMN 02 Mercatorstraat
650,Mercatorstraat 36,2022-09-17,23:00:00,131,52,79,FMN 02 Mercatorstraat
650,Mercatorstraat 36,2022-09-18,00:00:00,102,50,52,FMN 02 Mercatorstraat
650,Mercatorstraat 36,2022-09-18,01:00:00,85,42,43,FMN 02 Mercatorstraat
650,Mercatorstraat 36,2022-09-18,02:00:00,79,31,48,FMN 02 Mercatorstraat
650,Mercatorstraat 36,2022-09-18,03:00:00,43,8,35,FMN 02 Mercatorstraat
650,Mercatorstraat 36,2022-09-18,04:00:00,40,18,22,FMN 02 Mercatorstraat
650,Mercatorstraat 36,2022-09-18,05:00:00,43,14,29,FMN 02 Mercatorstraat
650,Mercatorstraat 36,2022-09-18,06:00:00,38,16,22,FMN 02 Mercatorstraat
650,Mercatorstraat 36,2022-09-18,07:00:00,42,25,17,FMN 02 Mercatorstraat
650,Mercatorstraat 36,2022-09-18,08:00:00,72,40,32,FMN 02 Mercatorstraat
650,Mercatorstraat 36,2022-09-18,09:00:00,228,81,147,FMN 02 Mercatorstraat
650,Mercatorstraat 36,2022-09-18,10:00:00,171,114,57,FMN 02 Mercatorstraat
650,Mercatorstraat 36,2022-09-18,11:00:00,182,104,78,FMN 02 Mercatorstraat
650,Mercatorstraat 36,2022-09-18,12:00:00,275,169,106,FMN 02 Mercatorstraat
650,Mercatorstraat 36,2022-09-18,13:00:00,274,153,121,FMN 02 Mercatorstraat
650,Mercatorstraat 36,2022-09-18,14:00:00,286,157,129,FMN 02 Mercatorstraat
650,Mercatorstraat 36,2022-09-18,15:00:00,273,150,123,FMN 02 Mercatorstraat
650,Mercatorstraat 36,2022-09-18,16:00:00,303,112,191,FMN 02 Mercatorstraat
650,Mercatorstraat 36,2022-09-18,17:00:00,230,105,125,FMN 02 Mercatorstraat
650,Mercatorstraat 36,2022-09-18,18:00:00,167,71,96,FMN 02 Mercatorstraat
650,Mercatorstraat 36,2022-09-18,19:00:00,160,86,74,FMN 02 Mercatorstraat
650,Mercatorstraat 36,2022-09-18,20:00:00,124,52,72,FMN 02 Mercatorstraat
650,Mercatorstraat 36,2022-09-18,21:00:00,110,52,58,FMN 02 Mercatorstraat
650,Mercatorstraat 36,2022-09-18,22:00:00,126,41,85,FMN 02 Mercatorstraat
650,Mercatorstraat 36,2022-09-18,23:00:00,58,23,35,FMN 02 Mercatorstraat
650,Mercatorstraat 36,2022-09-19,00:00:00,31,11,20,FMN 02 Mercatorstraat
650,Mercatorstraat 36,2022-09-19,01:00:00,40,15,25,FMN 02 Mercatorstraat
650,Mercatorstraat 36,2022-09-19,02:00:00,16,9,7,FMN 02 Mercatorstraat
650,Mercatorstraat 36,2022-09-19,03:00:00,9,4,5,FMN 02 Mercatorstraat
650,Mercatorstraat 36,2022-09-19,04:00:00,21,11,10,FMN 02 Mercatorstraat
650,Mercatorstraat 36,2022-09-19,05:00:00,44,28,16,FMN 02 Mercatorstraat
650,Mercatorstraat 36,2022-09-19,06:00:00,133,69,64,FMN 02 Mercatorstraat
650,Mercatorstraat 36,2022-09-19,07:00:00,412,273,139,FMN 02 Mercatorstraat
650,Mercatorstraat 36,2022-09-19,08:00:00,1011,704,307,FMN 02 Mercatorstraat
650,Mercatorstraat 36,2022-09-19,09:00:00,390,279,111,FMN 02 Mercatorstraat
650,Mercatorstraat 36,2022-09-19,10:00:00,208,132,76,FMN 02 Mercatorstraat
650,Mercatorstraat 36,2022-09-19,11:00:00,236,137,99,FMN 02 Mercatorstraat
650,Mercatorstraat 36,2022-09-19,12:00:00,321,145,176,FMN 02 Mercatorstraat
650,Mercatorstraat 36,2022-09-19,13:00:00,351,168,183,FMN 02 Mercatorstraat
650,Mercatorstraat 36,2022-09-19,14:00:00,356,183,173,FMN 02 Mercatorstraat
650,Mercatorstraat 36,2022-09-19,15:00:00,454,145,309,FMN 02 Mercatorstraat
650,Mercatorstraat 36,2022-09-19,16:00:00,675,229,446,FMN 02 Mercatorstraat
650,Mercatorstraat 36,2022-09-19,17:00:00,753,267,486,FMN 02 Mercatorstraat
650,Mercatorstraat 36,2022-09-19,18:00:00,510,178,332,FMN 02 Mercatorstraat
650,Mercatorstraat 36,2022-09-19,19:00:00,296,126,170,FMN 02 Mercatorstraat
650,Mercatorstraat 36,2022-09-19,20:00:00,213,82,131,FMN 02 Mercatorstraat
650,Mercatorstraat 36,2022-09-19,21:00:00,221,96,125,FMN 02 Mercatorstraat
650,Mercatorstraat 36,2022-09-19,22:00:00,157,69,88,FMN 02 Mercatorstraat
650,Mercatorstraat 36,2022-09-19,23:00:00,79,25,54,FMN 02 Mercatorstraat
650,Mercatorstraat 36,2022-09-20,00:00:00,55,21,34,FMN 02 Mercatorstraat
650,Mercatorstraat 36,2022-09-20,01:00:00,20,8,12,FMN 02 Mercatorstraat
650,Mercatorstraat 36,2022-09-20,02:00:00,13,4,9,FMN 02 Mercatorstraat
650,Mercatorstraat 36,2022-09-20,03:00:00,10,6,4,FMN 02 Mercatorstraat
650,Mercatorstraat 36,2022-09-20,04:00:00,33,15,18,FMN 02 Mercatorstraat
650,Mercatorstraat 36,2022-09-20,05:00:00,53,27,26,FMN 02 Mercatorstraat
650,Mercatorstraat 36,2022-09-20,06:00:00,146,83,63,FMN 02 Mercatorstraat
650,Mercatorstraat 36,2022-09-20,07:00:00,425,273,152,FMN 02 Mercatorstraat
650,Mercatorstraat 36,2022-09-20,08:00:00,1139,777,362,FMN 02 Mercatorstraat
650,Mercatorstraat 36,2022-09-20,09:00:00,429,305,124,FMN 02 Mercatorstraat
650,Mercatorstraat 36,2022-09-20,10:00:00,229,158,71,FMN 02 Mercatorstraat
650,Mercatorstraat 36,2022-09-20,11:00:00,277,149,128,FMN 02 Mercatorstraat
650,Mercatorstraat 36,2022-09-20,12:00:00,355,200,155,FMN 02 Mercatorstraat
650,Mercatorstraat 36,2022-09-20,13:00:00,355,161,194,FMN 02 Mercatorstraat
650,Mercatorstraat 36,2022-09-20,14:00:00,360,161,199,FMN 02 Mercatorstraat
650,Mercatorstraat 36,2022-09-20,15:00:00,510,201,309,FMN 02 Mercatorstraat
650,Mercatorstraat 36,2022-09-20,16:00:00,748,239,509,FMN 02 Mercatorstraat
650,Mercatorstraat 36,2022-09-20,17:00:00,820,298,522,FMN 02 Mercatorstraat
650,Mercatorstraat 36,2022-09-20,18:00:00,644,242,402,FMN 02 Mercatorstraat
650,Mercatorstraat 36,2022-09-20,19:00:00,432,200,232,FMN 02 Mercatorstraat
650,Mercatorstraat 36,2022-09-20,20:00:00,240,98,142,FMN 02 Mercatorstraat
650,Mercatorstraat 36,2022-09-20,21:00:00,278,114,164,FMN 02 Mercatorstraat
650,Mercatorstraat 36,2022-09-20,22:00:00,218,79,139,FMN 02 Mercatorstraat
650,Mercatorstraat 36,2022-09-20,23:00:00,131,38,93,FMN 02 Mercatorstraat
650,Mercatorstraat 36,2022-09-21,00:00:00,57,26,31,FMN 02 Mercatorstraat
650,Mercatorstraat 36,2022-09-21,01:00:00,26,8,18,FMN 02 Mercatorstraat
650,Mercatorstraat 36,2022-09-21,02:00:00,28,11,17,FMN 02 Mercatorstraat
650,Mercatorstraat 36,2022-09-21,03:00:00,17,4,13,FMN 02 Mercatorstraat
650,Mercatorstraat 36,2022-09-21,04:00:00,38,15,23,FMN 02 Mercatorstraat
650,Mercatorstraat 36,2022-09-21,05:00:00,46,24,22,FMN 02 Mercatorstraat
650,Mercatorstraat 36,2022-09-21,06:00:00,138,79,59,FMN 02 Mercatorstraat
650,Mercatorstraat 36,2022-09-21,07:00:00,458,294,164,FMN 02 Mercatorstraat
650,Mercatorstraat 36,2022-09-21,08:00:00,1035,705,330,FMN 02 Mercatorstraat
650,Mercatorstraat 36,2022-09-21,09:00:00,455,349,106,FMN 02 Mercatorstraat
650,Mercatorstraat 36,2022-09-21,10:00:00,273,164,109,FMN 02 Mercatorstraat
650,Mercatorstraat 36,2022-09-21,11:00:00,350,174,176,FMN 02 Mercatorstraat
650,Mercatorstraat 36,2022-09-21,12:00:00,638,232,406,FMN 02 Mercatorstraat
650,Mercatorstraat 36,2022-09-21,13:00:00,572,291,281,FMN 02 Mercatorstraat
650,Mercatorstraat 36,2022-09-21,14:00:00,480,274,206,FMN 02 Mercatorstraat
650,Mercatorstraat 36,2022-09-21,15:00:00,495,189,306,FMN 02 Mercatorstraat
650,Mercatorstraat 36,2022-09-21,16:00:00,654,252,402,FMN 02 Mercatorstraat
650,Mercatorstraat 36,2022-09-21,17:00:00,771,276,495,FMN 02 Mercatorstraat
650,Mercatorstraat 36,2022-09-21,18:00:00,616,248,368,FMN 02 Mercatorstraat
650,Mercatorstraat 36,2022-09-21,19:00:00,419,189,230,FMN 02 Mercatorstraat
650,Mercatorstraat 36,2022-09-21,20:00:00,272,127,145,FMN 02 Mercatorstraat
650,Mercatorstraat 36,2022-09-21,21:00:00,261,114,147,FMN 02 Mercatorstraat
650,Mercatorstraat 36,2022-09-21,22:00:00,252,85,167,FMN 02 Mercatorstraat
650,Mercatorstraat 36,2022-09-21,23:00:00,135,49,86,FMN 02 Mercatorstraat
650,Mercatorstraat 36,2022-09-22,00:00:00,76,23,53,FMN 02 Mercatorstraat
650,Mercatorstraat 36,2022-09-22,01:00:00,41,18,23,FMN 02 Mercatorstraat
650,Mercatorstraat 36,2022-09-22,02:00:00,31,8,23,FMN 02 Mercatorstraat
650,Mercatorstraat 36,2022-09-22,03:00:00,11,6,5,FMN 02 Mercatorstraat
650,Mercatorstraat 36,2022-09-22,04:00:00,37,23,14,FMN 02 Mercatorstraat
650,Mercatorstraat 36,2022-09-22,05:00:00,43,23,20,FMN 02 Mercatorstraat
650,Mercatorstraat 36,2022-09-22,06:00:00,133,69,64,FMN 02 Mercatorstraat
650,Mercatorstraat 36,2022-09-22,07:00:00,454,296,158,FMN 02 Mercatorstraat
650,Mercatorstraat 36,2022-09-22,08:00:00,1099,743,356,FMN 02 Mercatorstraat
650,Mercatorstraat 36,2022-09-22,09:00:00,438,317,121,FMN 02 Mercatorstraat
650,Mercatorstraat 36,2022-09-22,10:00:00,289,189,100,FMN 02 Mercatorstraat
650,Mercatorstraat 36,2022-09-22,11:00:00,282,159,123,FMN 02 Mercatorstraat
650,Mercatorstraat 36,2022-09-22,12:00:00,420,225,195,FMN 02 Mercatorstraat
650,Mercatorstraat 36,2022-09-22,13:00:00,451,227,224,FMN 02 Mercatorstraat
650,Mercatorstraat 36,2022-09-22,14:00:00,410,183,227,FMN 02 Mercatorstraat
650,Mercatorstraat 36,2022-09-22,15:00:00,542,196,346,FMN 02 Mercatorstraat
650,Mercatorstraat 36,2022-09-22,16:00:00,705,231,474,FMN 02 Mercatorstraat
650,Mercatorstraat 36,2022-09-22,17:00:00,834,283,551,FMN 02 Mercatorstraat
650,Mercatorstraat 36,2022-09-22,18:00:00,660,265,395,FMN 02 Mercatorstraat
650,Mercatorstraat 36,2022-09-22,19:00:00,400,188,212,FMN 02 Mercatorstraat
650,Mercatorstraat 36,2022-09-22,20:00:00,267,128,139,FMN 02 Mercatorstraat
650,Mercatorstraat 36,2022-09-22,21:00:00,257,103,154,FMN 02 Mercatorstraat
650,Mercatorstraat 36,2022-09-22,22:00:00,263,113,150,FMN 02 Mercatorstraat
650,Mercatorstraat 36,2022-09-22,23:00:00,133,58,75,FMN 02 Mercatorstraat
650,Mercatorstraat 36,2022-09-23,00:00:00,99,47,52,FMN 02 Mercatorstraat
650,Mercatorstraat 36,2022-09-23,01:00:00,60,34,26,FMN 02 Mercatorstraat
650,Mercatorstraat 36,2022-09-23,02:00:00,37,14,23,FMN 02 Mercatorstraat
650,Mercatorstraat 36,2022-09-23,03:00:00,20,12,8,FMN 02 Mercatorstraat
650,Mercatorstraat 36,2022-09-23,04:00:00,34,10,24,FMN 02 Mercatorstraat
650,Mercatorstraat 36,2022-09-23,05:00:00,44,22,22,FMN 02 Mercatorstraat
650,Mercatorstraat 36,2022-09-23,06:00:00,118,62,56,FMN 02 Mercatorstraat
650,Mercatorstraat 36,2022-09-23,07:00:00,378,250,128,FMN 02 Mercatorstraat
650,Mercatorstraat 36,2022-09-23,08:00:00,814,583,231,FMN 02 Mercatorstraat
650,Mercatorstraat 36,2022-09-23,09:00:00,472,311,161,FMN 02 Mercatorstraat
650,Mercatorstraat 36,2022-09-23,10:00:00,261,189,72,FMN 02 Mercatorstraat
650,Mercatorstraat 36,2022-09-23,11:00:00,302,193,109,FMN 02 Mercatorstraat
650,Mercatorstraat 36,2022-09-23,12:00:00,468,256,212,FMN 02 Mercatorstraat
650,Mercatorstraat 36,2022-09-23,13:00:00,421,212,209,FMN 02 Mercatorstraat
650,Mercatorstraat 36,2022-09-23,14:00:00,358,168,190,FMN 02 Mercatorstraat
650,Mercatorstraat 36,2022-09-23,15:00:00,556,190,366,FMN 02 Mercatorstraat
650,Mercatorstraat 36,2022-09-23,16:00:00,633,245,388,FMN 02 Mercatorstraat
650,Mercatorstraat 36,2022-09-23,17:00:00,637,213,424,FMN 02 Mercatorstraat
650,Mercatorstraat 36,2022-09-23,18:00:00,440,169,271,FMN 02 Mercatorstraat
650,Mercatorstraat 36,2022-09-23,19:00:00,312,153,159,FMN 02 Mercatorstraat
650,Mercatorstraat 36,2022-09-23,20:00:00,233,110,123,FMN 02 Mercatorstraat
650,Mercatorstraat 36,2022-09-23,21:00:00,203,107,96,FMN 02 Mercatorstraat
650,Mercatorstraat 36,2022-09-23,22:00:00,194,78,116,FMN 02 Mercatorstraat
650,Mercatorstraat 36,2022-09-23,23:00:00,203,73,130,FMN 02 Mercatorstraat
650,Mercatorstraat 36,2022-09-24,00:00:00,122,62,60,FMN 02 Mercatorstraat
650,Mercatorstraat 36,2022-09-24,01:00:00,115,42,73,FMN 02 Mercatorstraat
650,Mercatorstraat 36,2022-09-24,02:00:00,94,48,46,FMN 02 Mercatorstraat
650,Mercatorstraat 36,2022-09-24,03:00:00,59,18,41,FMN 02 Mercatorstraat
650,Mercatorstraat 36,2022-09-24,04:00:00,45,10,35,FMN 02 Mercatorstraat
650,Mercatorstraat 36,2022-09-24,05:00:00,47,17,30,FMN 02 Mercatorstraat
650,Mercatorstraat 36,2022-09-24,06:00:00,28,12,16,FMN 02 Mercatorstraat
650,Mercatorstraat 36,2022-09-24,07:00:00,48,26,22,FMN 02 Mercatorstraat
650,Mercatorstraat 36,2022-09-24,08:00:00,76,44,32,FMN 02 Mercatorstraat
650,Mercatorstraat 36,2022-09-24,09:00:00,159,124,35,FMN 02 Mercatorstraat
650,Mercatorstraat 36,2022-09-24,10:00:00,156,100,56,FMN 02 Mercatorstraat
650,Mercatorstraat 36,2022-09-24,11:00:00,172,94,78,FMN 02 Mercatorstraat
650,Mercatorstraat 36,2022-09-24,12:00:00,186,90,96,FMN 02 Mercatorstraat
650,Mercatorstraat 36,2022-09-24,13:00:00,216,126,90,FMN 02 Mercatorstraat
650,Mercatorstraat 36,2022-09-24,14:00:00,248,142,106,FMN 02 Mercatorstraat
650,Mercatorstraat 36,2022-09-24,15:00:00,241,130,111,FMN 02 Mercatorstraat
650,Mercatorstraat 36,2022-09-24,16:00:00,264,131,133,FMN 02 Mercatorstraat
650,Mercatorstraat 36,2022-09-24,17:00:00,253,79,174,FMN 02 Mercatorstraat
650,Mercatorstraat 36,2022-09-24,18:00:00,242,113,129,FMN 02 Mercatorstraat
650,Mercatorstraat 36,2022-09-24,19:00:00,230,106,124,FMN 02 Mercatorstraat
650,Mercatorstraat 36,2022-09-24,20:00:00,204,106,98,FMN 02 Mercatorstraat
650,Mercatorstraat 36,2022-09-24,21:00:00,175,93,82,FMN 02 Mercatorstraat
650,Mercatorstraat 36,2022-09-24,22:00:00,163,76,87,FMN 02 Mercatorstraat
650,Mercatorstraat 36,2022-09-24,23:00:00,135,54,81,FMN 02 Mercatorstraat
650,Mercatorstraat 36,2022-09-25,00:00:00,125,47,78,FMN 02 Mercatorstraat
650,Mercatorstraat 36,2022-09-25,01:00:00,108,45,63,FMN 02 Mercatorstraat
650,Mercatorstraat 36,2022-09-25,02:00:00,84,15,69,FMN 02 Mercatorstraat
650,Mercatorstraat 36,2022-09-25,03:00:00,49,14,35,FMN 02 Mercatorstraat
650,Mercatorstraat 36,2022-09-25,04:00:00,38,15,23,FMN 02 Mercatorstraat
650,Mercatorstraat 36,2022-09-25,05:00:00,54,24,30,FMN 02 Mercatorstraat
650,Mercatorstraat 36,2022-09-25,06:00:00,38,16,22,FMN 02 Mercatorstraat
650,Mercatorstraat 36,2022-09-25,07:00:00,45,21,24,FMN 02 Mercatorstraat
650,Mercatorstraat 36,2022-09-25,08:00:00,76,35,41,FMN 02 Mercatorstraat
650,Mercatorstraat 36,2022-09-25,09:00:00,160,97,63,FMN 02 Mercatorstraat
650,Mercatorstraat 36,2022-09-25,10:00:00,283,193,90,FMN 02 Mercatorstraat
650,Mercatorstraat 36,2022-09-25,11:00:00,289,186,103,FMN 02 Mercatorstraat
650,Mercatorstraat 36,2022-09-25,12:00:00,329,185,144,FMN 02 Mercatorstraat
650,Mercatorstraat 36,2022-09-25,13:00:00,317,186,131,FMN 02 Mercatorstraat
650,Mercatorstraat 36,2022-09-25,14:00:00,382,217,165,FMN 02 Mercatorstraat
650,Mercatorstraat 36,2022-09-25,15:00:00,337,179,158,FMN 02 Mercatorstraat
650,Mercatorstraat 36,2022-09-25,16:00:00,337,141,196,FMN 02 Mercatorstraat
650,Mercatorstraat 36,2022-09-25,17:00:00,337,130,207,FMN 02 Mercatorstraat
650,Mercatorstraat 36,2022-09-25,18:00:00,348,151,197,FMN 02 Mercatorstraat
650,Mercatorstraat 36,2022-09-25,19:00:00,260,130,130,FMN 02 Mercatorstraat
650,Mercatorstraat 36,2022-09-25,20:00:00,199,96,103,FMN 02 Mercatorstraat
650,Mercatorstraat 36,2022-09-25,21:00:00,170,60,110,FMN 02 Mercatorstraat
650,Mercatorstraat 36,2022-09-25,22:00:00,133,59,74,FMN 02 Mercatorstraat
650,Mercatorstraat 36,2022-09-25,23:00:00,61,25,36,FMN 02 Mercatorstraat
650,Mercatorstraat 36,2022-09-26,00:00:00,43,12,31,FMN 02 Mercatorstraat
650,Mercatorstraat 36,2022-09-26,01:00:00,26,14,12,FMN 02 Mercatorstraat
650,Mercatorstraat 36,2022-09-26,02:00:00,21,9,12,FMN 02 Mercatorstraat
650,Mercatorstraat 36,2022-09-26,03:00:00,14,6,8,FMN 02 Mercatorstraat
650,Mercatorstraat 36,2022-09-26,04:00:00,21,11,10,FMN 02 Mercatorstraat
650,Mercatorstraat 36,2022-09-26,05:00:00,48,23,25,FMN 02 Mercatorstraat
650,Mercatorstraat 36,2022-09-26,06:00:00,76,50,26,FMN 02 Mercatorstraat
650,Mercatorstraat 36,2022-09-26,07:00:00,327,231,96,FMN 02 Mercatorstraat
650,Mercatorstraat 36,2022-09-26,08:00:00,834,618,216,FMN 02 Mercatorstraat
650,Mercatorstraat 36,2022-09-26,09:00:00,373,298,75,FMN 02 Mercatorstraat
650,Mercatorstraat 36,2022-09-26,10:00:00,188,116,72,FMN 02 Mercatorstraat
650,Mercatorstraat 36,2022-09-26,11:00:00,162,90,72,FMN 02 Mercatorstraat
650,Mercatorstraat 36,2022-09-26,12:00:00,275,153,122,FMN 02 Mercatorstraat
650,Mercatorstraat 36,2022-09-26,13:00:00,200,121,79,FMN 02 Mercatorstraat
650,Mercatorstraat 36,2022-09-26,14:00:00,236,124,112,FMN 02 Mercatorstraat
650,Mercatorstraat 36,2022-09-26,15:00:00,327,127,200,FMN 02 Mercatorstraat
650,Mercatorstraat 36,2022-09-26,16:00:00,492,156,336,FMN 02 Mercatorstraat
650,Mercatorstraat 36,2022-09-26,17:00:00,524,174,350,FMN 02 Mercatorstraat
650,Mercatorstraat 36,2022-09-26,18:00:00,383,128,255,FMN 02 Mercatorstraat
650,Mercatorstraat 36,2022-09-26,19:00:00,241,94,147,FMN 02 Mercatorstraat
650,Mercatorstraat 36,2022-09-26,20:00:00,157,57,100,FMN 02 Mercatorstraat
650,Mercatorstraat 36,2022-09-26,21:00:00,180,80,100,FMN 02 Mercatorstraat
650,Mercatorstraat 36,2022-09-26,22:00:00,116,48,68,FMN 02 Mercatorstraat
650,Mercatorstraat 36,2022-09-26,23:00:00,57,20,37,FMN 02 Mercatorstraat
650,Mercatorstraat 36,2022-09-27,00:00:00,28,3,25,FMN 02 Mercatorstraat
650,Mercatorstraat 36,2022-09-27,01:00:00,27,5,22,FMN 02 Mercatorstraat
650,Mercatorstraat 36,2022-09-27,02:00:00,20,4,16,FMN 02 Mercatorstraat
650,Mercatorstraat 36,2022-09-27,03:00:00,16,6,10,FMN 02 Mercatorstraat
650,Mercatorstraat 36,2022-09-27,04:00:00,12,5,7,FMN 02 Mercatorstraat
650,Mercatorstraat 36,2022-09-27,05:00:00,37,21,16,FMN 02 Mercatorstraat
650,Mercatorstraat 36,2022-09-27,06:00:00,65,45,20,FMN 02 Mercatorstraat
650,Mercatorstraat 36,2022-09-27,07:00:00,294,195,99,FMN 02 Mercatorstraat
650,Mercatorstraat 36,2022-09-27,08:00:00,788,589,199,FMN 02 Mercatorstraat
650,Mercatorstraat 36,2022-09-27,09:00:00,355,264,91,FMN 02 Mercatorstraat
650,Mercatorstraat 36,2022-09-27,10:00:00,198,126,72,FMN 02 Mercatorstraat
650,Mercatorstraat 36,2022-09-27,11:00:00,165,101,64,FMN 02 Mercatorstraat
650,Mercatorstraat 36,2022-09-27,12:00:00,311,168,143,FMN 02 Mercatorstraat
650,Mercatorstraat 36,2022-09-27,13:00:00,241,133,108,FMN 02 Mercatorstraat
650,Mercatorstraat 36,2022-09-27,14:00:00,217,98,119,FMN 02 Mercatorstraat
650,Mercatorstraat 36,2022-09-27,15:00:00,340,134,206,FMN 02 Mercatorstraat
650,Mercatorstraat 36,2022-09-27,16:00:00,506,138,368,FMN 02 Mercatorstraat
650,Mercatorstraat 36,2022-09-27,17:00:00,611,217,394,FMN 02 Mercatorstraat
650,Mercatorstraat 36,2022-09-27,18:00:00,446,168,278,FMN 02 Mercatorstraat
650,Mercatorstraat 36,2022-09-27,19:00:00,249,118,131,FMN 02 Mercatorstraat
650,Mercatorstraat 36,2022-09-27,20:00:00,178,83,95,FMN 02 Mercatorstraat
650,Mercatorstraat 36,2022-09-27,21:00:00,196,70,126,FMN 02 Mercatorstraat
650,Mercatorstraat 36,2022-09-27,22:00:00,138,49,89,FMN 02 Mercatorstraat
650,Mercatorstraat 36,2022-09-27,23:00:00,72,22,50,FMN 02 Mercatorstraat
650,Mercatorstraat 36,2022-09-28,00:00:00,37,4,33,FMN 02 Mercatorstraat
650,Mercatorstraat 36,2022-09-28,01:00:00,17,2,15,FMN 02 Mercatorstraat
650,Mercatorstraat 36,2022-09-28,02:00:00,15,6,9,FMN 02 Mercatorstraat
650,Mercatorstraat 36,2022-09-28,03:00:00,9,3,6,FMN 02 Mercatorstraat
650,Mercatorstraat 36,2022-09-28,04:00:00,23,16,7,FMN 02 Mercatorstraat
650,Mercatorstraat 36,2022-09-28,05:00:00,43,23,20,FMN 02 Mercatorstraat
650,Mercatorstraat 36,2022-09-28,06:00:00,94,61,33,FMN 02 Mercatorstraat
650,Mercatorstraat 36,2022-09-28,07:00:00,325,234,91,FMN 02 Mercatorstraat
650,Mercatorstraat 36,2022-09-28,08:00:00,838,633,205,FMN 02 Mercatorstraat
650,Mercatorstraat 36,2022-09-28,09:00:00,481,301,180,FMN 02 Mercatorstraat
650,Mercatorstraat 36,2022-09-28,10:00:00,257,144,113,FMN 02 Mercatorstraat
650,Mercatorstraat 36,2022-09-28,11:00:00,257,138,119,FMN 02 Mercatorstraat
650,Mercatorstraat 36,2022-09-28,12:00:00,558,205,353,FMN 02 Mercatorstraat
650,Mercatorstraat 36,2022-09-28,13:00:00,398,194,204,FMN 02 Mercatorstraat
650,Mercatorstraat 36,2022-09-28,14:00:00,313,143,170,FMN 02 Mercatorstraat
650,Mercatorstraat 36,2022-09-28,15:00:00,349,158,191,FMN 02 Mercatorstraat
650,Mercatorstraat 36,2022-09-28,16:00:00,496,180,316,FMN 02 Mercatorstraat
650,Mercatorstraat 36,2022-09-28,17:00:00,664,224,440,FMN 02 Mercatorstraat
650,Mercatorstraat 36,2022-09-28,18:00:00,543,191,352,FMN 02 Mercatorstraat
650,Mercatorstraat 36,2022-09-28,19:00:00,312,146,166,FMN 02 Mercatorstraat
650,Mercatorstraat 36,2022-09-28,20:00:00,193,93,100,FMN 02 Mercatorstraat
650,Mercatorstraat 36,2022-09-28,21:00:00,227,110,117,FMN 02 Mercatorstraat
650,Mercatorstraat 36,2022-09-28,22:00:00,179,79,100,FMN 02 Mercatorstraat
650,Mercatorstraat 36,2022-09-28,23:00:00,104,35,69,FMN 02 Mercatorstraat
650,Mercatorstraat 36,2022-09-29,00:00:00,58,31,27,FMN 02 Mercatorstraat
650,Mercatorstraat 36,2022-09-29,01:00:00,23,11,12,FMN 02 Mercatorstraat
650,Mercatorstraat 36,2022-09-29,02:00:00,28,5,23,FMN 02 Mercatorstraat
650,Mercatorstraat 36,2022-09-29,03:00:00,22,6,16,FMN 02 Mercatorstraat
650,Mercatorstraat 36,2022-09-29,04:00:00,33,17,16,FMN 02 Mercatorstraat
650,Mercatorstraat 36,2022-09-29,05:00:00,40,22,18,FMN 02 Mercatorstraat
650,Mercatorstraat 36,2022-09-29,06:00:00,112,62,50,FMN 02 Mercatorstraat
650,Mercatorstraat 36,2022-09-29,07:00:00,439,286,153,FMN 02 Mercatorstraat
650,Mercatorstraat 36,2022-09-29,08:00:00,1005,694,311,FMN 02 Mercatorstraat
650,Mercatorstraat 36,2022-09-29,09:00:00,424,314,110,FMN 02 Mercatorstraat
650,Mercatorstraat 36,2022-09-29,10:00:00,253,171,82,FMN 02 Mercatorstraat
650,Mercatorstraat 36,2022-09-29,11:00:00,242,138,104,FMN 02 Mercatorstraat
650,Mercatorstraat 36,2022-09-29,12:00:00,425,230,195,FMN 02 Mercatorstraat
650,Mercatorstraat 36,2022-09-29,13:00:00,418,207,211,FMN 02 Mercatorstraat
650,Mercatorstraat 36,2022-09-29,14:00:00,404,155,249,FMN 02 Mercatorstraat
650,Mercatorstraat 36,2022-09-29,15:00:00,514,198,316,FMN 02 Mercatorstraat
650,Mercatorstraat 36,2022-09-29,16:00:00,690,255,435,FMN 02 Mercatorstraat
650,Mercatorstraat 36,2022-09-29,17:00:00,758,262,496,FMN 02 Mercatorstraat
650,Mercatorstraat 36,2022-09-29,18:00:00,588,222,366,FMN 02 Mercatorstraat
650,Mercatorstraat 36,2022-09-29,19:00:00,362,177,185,FMN 02 Mercatorstraat
650,Mercatorstraat 36,2022-09-29,20:00:00,240,119,121,FMN 02 Mercatorstraat
650,Mercatorstraat 36,2022-09-29,21:00:00,258,99,159,FMN 02 Mercatorstraat
650,Mercatorstraat 36,2022-09-29,22:00:00,244,100,144,FMN 02 Mercatorstraat
650,Mercatorstraat 36,2022-09-29,23:00:00,160,59,101,FMN 02 Mercatorstraat
650,Mercatorstraat 36,2022-09-30,00:00:00,102,39,63,FMN 02 Mercatorstraat
650,Mercatorstraat 36,2022-09-30,01:00:00,120,41,79,FMN 02 Mercatorstraat
650,Mercatorstraat 36,2022-09-30,02:00:00,68,9,59,FMN 02 Mercatorstraat
650,Mercatorstraat 36,2022-09-30,03:00:00,30,3,27,FMN 02 Mercatorstraat
650,Mercatorstraat 36,2022-09-30,04:00:00,42,14,28,FMN 02 Mercatorstraat
650,Mercatorstraat 36,2022-09-30,05:00:00,66,31,35,FMN 02 Mercatorstraat
650,Mercatorstraat 36,2022-09-30,06:00:00,111,53,58,FMN 02 Mercatorstraat
650,Mercatorstraat 36,2022-09-30,07:00:00,382,246,136,FMN 02 Mercatorstraat
650,Mercatorstraat 36,2022-09-30,08:00:00,942,680,262,FMN 02 Mercatorstraat
650,Mercatorstraat 36,2022-09-30,09:00:00,432,326,106,FMN 02 Mercatorstraat
650,Mercatorstraat 36,2022-09-30,10:00:00,346,231,115,FMN 02 Mercatorstraat
650,Mercatorstraat 36,2022-09-30,11:00:00,278,167,111,FMN 02 Mercatorstraat
650,Mercatorstraat 36,2022-09-30,12:00:00,496,246,250,FMN 02 Mercatorstraat
650,Mercatorstraat 36,2022-09-30,13:00:00,438,226,212,FMN 02 Mercatorstraat
650,Mercatorstraat 36,2022-09-30,14:00:00,454,190,264,FMN 02 Mercatorstraat
650,Mercatorstraat 36,2022-09-30,15:00:00,578,182,396,FMN 02 Mercatorstraat
650,Mercatorstraat 36,2022-09-30,16:00:00,719,258,461,FMN 02 Mercatorstraat
650,Mercatorstraat 36,2022-09-30,17:00:00,770,288,482,FMN 02 Mercatorstraat
650,Mercatorstraat 36,2022-09-30,18:00:00,581,242,339,FMN 02 Mercatorstraat
650,Mercatorstraat 36,2022-09-30,19:00:00,413,214,199,FMN 02 Mercatorstraat
650,Mercatorstraat 36,2022-09-30,20:00:00,299,143,156,FMN 02 Mercatorstraat
650,Mercatorstraat 36,2022-09-30,21:00:00,236,108,128,FMN 02 Mercatorstraat
650,Mercatorstraat 36,2022-09-30,22:00:00,229,97,132,FMN 02 Mercatorstraat
650,Mercatorstraat 36,2022-09-30,23:00:00,162,72,90,FMN 02 Mercatorstraat
650,Mercatorstraat 36,2022-10-01,00:00:00,138,61,77,FMN 02 Mercatorstraat
650,Mercatorstraat 36,2022-10-01,01:00:00,131,50,81,FMN 02 Mercatorstraat
650,Mercatorstraat 36,2022-10-01,02:00:00,74,24,50,FMN 02 Mercatorstraat
650,Mercatorstraat 36,2022-10-01,03:00:00,59,10,49,FMN 02 Mercatorstraat
650,Mercatorstraat 36,2022-10-01,04:00:00,49,17,32,FMN 02 Mercatorstraat
650,Mercatorstraat 36,2022-10-01,05:00:00,30,7,23,FMN 02 Mercatorstraat
650,Mercatorstraat 36,2022-10-01,06:00:00,32,17,15,FMN 02 Mercatorstraat
650,Mercatorstraat 36,2022-10-01,07:00:00,55,31,24,FMN 02 Mercatorstraat
650,Mercatorstraat 36,2022-10-01,08:00:00,101,60,41,FMN 02 Mercatorstraat
650,Mercatorstraat 36,2022-10-01,09:00:00,168,114,54,FMN 02 Mercatorstraat
650,Mercatorstraat 36,2022-10-01,10:00:00,222,132,90,FMN 02 Mercatorstraat
650,Mercatorstraat 36,2022-10-01,11:00:00,271,180,91,FMN 02 Mercatorstraat
650,Mercatorstraat 36,2022-10-01,12:00:00,272,145,127,FMN 02 Mercatorstraat
650,Mercatorstraat 36,2022-10-01,13:00:00,306,162,144,FMN 02 Mercatorstraat
650,Mercatorstraat 36,2022-10-01,14:00:00,349,195,154,FMN 02 Mercatorstraat
650,Mercatorstraat 36,2022-10-01,15:00:00,362,226,136,FMN 02 Mercatorstraat
650,Mercatorstraat 36,2022-10-01,16:00:00,323,135,188,FMN 02 Mercatorstraat
650,Mercatorstraat 36,2022-10-01,17:00:00,351,146,205,FMN 02 Mercatorstraat
650,Mercatorstraat 36,2022-10-01,18:00:00,344,151,193,FMN 02 Mercatorstraat
650,Mercatorstraat 36,2022-10-01,19:00:00,302,187,115,FMN 02 Mercatorstraat
650,Mercatorstraat 36,2022-10-01,20:00:00,229,111,118,FMN 02 Mercatorstraat
650,Mercatorstraat 36,2022-10-01,21:00:00,201,94,107,FMN 02 Mercatorstraat
650,Mercatorstraat 36,2022-10-01,22:00:00,194,81,113,FMN 02 Mercatorstraat
650,Mercatorstraat 36,2022-10-01,23:00:00,157,48,109,FMN 02 Mercatorstraat
650,Mercatorstraat 36,2022-10-02,00:00:00,167,67,100,FMN 02 Mercatorstraat
650,Mercatorstraat 36,2022-10-02,01:00:00,132,65,67,FMN 02 Mercatorstraat
650,Mercatorstraat 36,2022-10-02,02:00:00,104,33,71,FMN 02 Mercatorstraat
650,Mercatorstraat 36,2022-10-02,03:00:00,63,20,43,FMN 02 Mercatorstraat
650,Mercatorstraat 36,2022-10-02,04:00:00,47,10,37,FMN 02 Mercatorstraat
650,Mercatorstraat 36,2022-10-02,05:00:00,58,22,36,FMN 02 Mercatorstraat
650,Mercatorstraat 36,2022-10-02,06:00:00,43,10,33,FMN 02 Mercatorstraat
650,Mercatorstraat 36,2022-10-02,07:00:00,62,26,36,FMN 02 Mercatorstraat
650,Mercatorstraat 36,2022-10-02,08:00:00,97,39,58,FMN 02 Mercatorstraat
650,Mercatorstraat 36,2022-10-02,09:00:00,245,121,124,FMN 02 Mercatorstraat
650,Mercatorstraat 36,2022-10-02,10:00:00,181,115,66,FMN 02 Mercatorstraat
650,Mercatorstraat 36,2022-10-02,11:00:00,208,126,82,FMN 02 Mercatorstraat
650,Mercatorstraat 36,2022-10-02,12:00:00,325,185,140,FMN 02 Mercatorstraat
650,Mercatorstraat 36,2022-10-02,13:00:00,334,185,149,FMN 02 Mercatorstraat
650,Mercatorstraat 36,2022-10-02,14:00:00,369,232,137,FMN 02 Mercatorstraat
650,Mercatorstraat 36,2022-10-02,15:00:00,320,171,149,FMN 02 Mercatorstraat
650,Mercatorstraat 36,2022-10-02,16:00:00,310,116,194,FMN 02 Mercatorstraat
650,Mercatorstraat 36,2022-10-02,17:00:00,345,123,222,FMN 02 Mercatorstraat
650,Mercatorstraat 36,2022-10-02,18:00:00,294,116,178,FMN 02 Mercatorstraat
650,Mercatorstraat 36,2022-10-02,19:00:00,229,116,113,FMN 02 Mercatorstraat
650,Mercatorstraat 36,2022-10-02,20:00:00,175,77,98,FMN 02 Mercatorstraat
650,Mercatorstraat 36,2022-10-02,21:00:00,170,69,101,FMN 02 Mercatorstraat
650,Mercatorstraat 36,2022-10-02,22:00:00,139,58,81,FMN 02 Mercatorstraat
650,Mercatorstraat 36,2022-10-02,23:00:00,67,30,37,FMN 02 Mercatorstraat
650,Mercatorstraat 36,2022-10-03,00:00:00,53,19,34,FMN 02 Mercatorstraat
650,Mercatorstraat 36,2022-10-03,01:00:00,24,3,21,FMN 02 Mercatorstraat
650,Mercatorstraat 36,2022-10-03,02:00:00,13,6,7,FMN 02 Mercatorstraat
650,Mercatorstraat 36,2022-10-03,03:00:00,15,6,9,FMN 02 Mercatorstraat
650,Mercatorstraat 36,2022-10-03,04:00:00,31,23,8,FMN 02 Mercatorstraat
650,Mercatorstraat 36,2022-10-03,05:00:00,58,34,24,FMN 02 Mercatorstraat
650,Mercatorstraat 36,2022-10-03,06:00:00,116,66,50,FMN 02 Mercatorstraat
650,Mercatorstraat 36,2022-10-03,07:00:00,416,265,151,FMN 02 Mercatorstraat
650,Mercatorstraat 36,2022-10-03,08:00:00,1040,727,313,FMN 02 Mercatorstraat
650,Mercatorstraat 36,2022-10-03,09:00:00,442,325,117,FMN 02 Mercatorstraat
650,Mercatorstraat 36,2022-10-03,10:00:00,313,219,94,FMN 02 Mercatorstraat
650,Mercatorstraat 36,2022-10-03,11:00:00,287,176,111,FMN 02 Mercatorstraat
650,Mercatorstraat 36,2022-10-03,12:00:00,427,228,199,FMN 02 Mercatorstraat
650,Mercatorstraat 36,2022-10-03,13:00:00,431,221,210,FMN 02 Mercatorstraat
650,Mercatorstraat 36,2022-10-03,14:00:00,375,166,209,FMN 02 Mercatorstraat
650,Mercatorstraat 36,2022-10-03,15:00:00,574,197,377,FMN 02 Mercatorstraat
650,Mercatorstraat 36,2022-10-03,16:00:00,741,239,502,FMN 02 Mercatorstraat
650,Mercatorstraat 36,2022-10-03,17:00:00,882,275,607,FMN 02 Mercatorstraat
650,Mercatorstraat 36,2022-10-03,18:00:00,577,217,360,FMN 02 Mercatorstraat
650,Mercatorstraat 36,2022-10-03,19:00:00,353,163,190,FMN 02 Mercatorstraat
650,Mercatorstraat 36,2022-10-03,20:00:00,190,74,116,FMN 02 Mercatorstraat
650,Mercatorstraat 36,2022-10-03,21:00:00,226,91,135,FMN 02 Mercatorstraat
650,Mercatorstraat 36,2022-10-03,22:00:00,180,66,114,FMN 02 Mercatorstraat
650,Mercatorstraat 36,2022-10-03,23:00:00,68,28,40,FMN 02 Mercatorstraat
650,Mercatorstraat 36,2022-10-04,00:00:00,35,15,20,FMN 02 Mercatorstraat
650,Mercatorstraat 36,2022-10-04,01:00:00,24,6,18,FMN 02 Mercatorstraat
650,Mercatorstraat 36,2022-10-04,02:00:00,20,5,15,FMN 02 Mercatorstraat
650,Mercatorstraat 36,2022-10-04,03:00:00,14,4,10,FMN 02 Mercatorstraat
650,Mercatorstraat 36,2022-10-04,04:00:00,38,26,12,FMN 02 Mercatorstraat
650,Mercatorstraat 36,2022-10-04,05:00:00,61,38,23,FMN 02 Mercatorstraat
650,Mercatorstraat 36,2022-10-04,06:00:00,126,89,37,FMN 02 Mercatorstraat
650,Mercatorstraat 36,2022-10-04,07:00:00,449,313,136,FMN 02 Mercatorstraat
650,Mercatorstraat 36,2022-10-04,08:00:00,1077,800,277,FMN 02 Mercatorstraat
650,Mercatorstraat 36,2022-10-04,09:00:00,542,395,147,FMN 02 Mercatorstraat
650,Mercatorstraat 36,2022-10-04,10:00:00,302,188,114,FMN 02 Mercatorstraat
650,Mercatorstraat 36,2022-10-04,11:00:00,304,175,129,FMN 02 Mercatorstraat
650,Mercatorstraat 36,2022-10-04,12:00:00,435,239,196,FMN 02 Mercatorstraat
650,Mercatorstraat 36,2022-10-04,13:00:00,351,197,154,FMN 02 Mercatorstraat
650,Mercatorstraat 36,2022-10-04,14:00:00,362,165,197,FMN 02 Mercatorstraat
650,Mercatorstraat 36,2022-10-04,15:00:00,555,223,332,FMN 02 Mercatorstraat
650,Mercatorstraat 36,2022-10-04,16:00:00,864,271,593,FMN 02 Mercatorstraat
650,Mercatorstraat 36,2022-10-04,17:00:00,930,305,625,FMN 02 Mercatorstraat
650,Mercatorstraat 36,2022-10-04,18:00:00,621,242,379,FMN 02 Mercatorstraat
650,Mercatorstraat 36,2022-10-04,19:00:00,356,177,179,FMN 02 Mercatorstraat
650,Mercatorstraat 36,2022-10-04,20:00:00,212,98,114,FMN 02 Mercatorstraat
650,Mercatorstraat 36,2022-10-04,21:00:00,233,84,149,FMN 02 Mercatorstraat
650,Mercatorstraat 36,2022-10-04,22:00:00,185,69,116,FMN 02 Mercatorstraat
650,Mercatorstraat 36,2022-10-04,23:00:00,109,41,68,FMN 02 Mercatorstraat
650,Mercatorstraat 36,2022-10-05,00:00:00,47,21,26,FMN 02 Mercatorstraat
650,Mercatorstraat 36,2022-10-05,01:00:00,26,13,13,FMN 02 Mercatorstraat
650,Mercatorstraat 36,2022-10-05,02:00:00,28,8,20,FMN 02 Mercatorstraat
650,Mercatorstraat 36,2022-10-05,03:00:00,21,7,14,FMN 02 Mercatorstraat
650,Mercatorstraat 36,2022-10-05,04:00:00,38,19,19,FMN 02 Mercatorstraat
650,Mercatorstraat 36,2022-10-05,05:00:00,64,35,29,FMN 02 Mercatorstraat
650,Mercatorstraat 36,2022-10-05,06:00:00,124,84,40,FMN 02 Mercatorstraat
650,Mercatorstraat 36,2022-10-05,07:00:00,424,292,132,FMN 02 Mercatorstraat
650,Mercatorstraat 36,2022-10-05,08:00:00,959,718,241,FMN 02 Mercatorstraat
650,Mercatorstraat 36,2022-10-05,09:00:00,463,350,113,FMN 02 Mercatorstraat
650,Mercatorstraat 36,2022-10-05,10:00:00,336,234,102,FMN 02 Mercatorstraat
650,Mercatorstraat 36,2022-10-05,11:00:00,281,148,133,FMN 02 Mercatorstraat
650,Mercatorstraat 36,2022-10-05,12:00:00,592,253,339,FMN 02 Mercatorstraat
650,Mercatorstraat 36,2022-10-05,13:00:00,490,263,227,FMN 02 Mercatorstraat
650,Mercatorstraat 36,2022-10-05,14:00:00,408,206,202,FMN 02 Mercatorstraat
650,Mercatorstraat 36,2022-10-05,15:00:00,448,191,257,FMN 02 Mercatorstraat
650,Mercatorstraat 36,2022-10-05,16:00:00,604,200,404,FMN 02 Mercatorstraat
650,Mercatorstraat 36,2022-10-05,17:00:00,792,250,542,FMN 02 Mercatorstraat
650,Mercatorstraat 36,2022-10-05,18:00:00,587,239,348,FMN 02 Mercatorstraat
650,Mercatorstraat 36,2022-10-05,19:00:00,317,157,160,FMN 02 Mercatorstraat
650,Mercatorstraat 36,2022-10-05,20:00:00,206,72,134,FMN 02 Mercatorstraat
650,Mercatorstraat 36,2022-10-05,21:00:00,211,99,112,FMN 02 Mercatorstraat
650,Mercatorstraat 36,2022-10-05,22:00:00,198,75,123,FMN 02 Mercatorstraat
650,Mercatorstraat 36,2022-10-05,23:00:00,118,37,81,FMN 02 Mercatorstraat
650,Mercatorstraat 36,2022-10-06,00:00:00,71,22,49,FMN 02 Mercatorstraat
650,Mercatorstraat 36,2022-10-06,01:00:00,22,7,15,FMN 02 Mercatorstraat
650,Mercatorstraat 36,2022-10-06,02:00:00,21,7,14,FMN 02 Mercatorstraat
650,Mercatorstraat 36,2022-10-06,03:00:00,11,4,7,FMN 02 Mercatorstraat
650,Mercatorstraat 36,2022-10-06,04:00:00,28,21,7,FMN 02 Mercatorstraat
650,Mercatorstraat 36,2022-10-06,05:00:00,64,42,22,FMN 02 Mercatorstraat
650,Mercatorstraat 36,2022-10-06,06:00:00,121,75,46,FMN 02 Mercatorstraat
650,Mercatorstraat 36,2022-10-06,07:00:00,442,299,143,FMN 02 Mercatorstraat
650,Mercatorstraat 36,2022-10-06,08:00:00,1084,825,259,FMN 02 Mercatorstraat
650,Mercatorstraat 36,2022-10-06,09:00:00,549,355,194,FMN 02 Mercatorstraat
650,Mercatorstraat 36,2022-10-06,10:00:00,290,204,86,FMN 02 Mercatorstraat
650,Mercatorstraat 36,2022-10-06,11:00:00,337,186,151,FMN 02 Mercatorstraat
650,Mercatorstraat 36,2022-10-06,12:00:00,463,244,219,FMN 02 Mercatorstraat
650,Mercatorstraat 36,2022-10-06,13:00:00,448,216,232,FMN 02 Mercatorstraat
650,Mercatorstraat 36,2022-10-06,14:00:00,400,184,216,FMN 02 Mercatorstraat
650,Mercatorstraat 36,2022-10-06,15:00:00,534,182,352,FMN 02 Mercatorstraat
650,Mercatorstraat 36,2022-10-06,16:00:00,785,261,524,FMN 02 Mercatorstraat
650,Mercatorstraat 36,2022-10-06,17:00:00,915,318,597,FMN 02 Mercatorstraat
650,Mercatorstraat 36,2022-10-06,18:00:00,656,237,419,FMN 02 Mercatorstraat
650,Mercatorstraat 36,2022-10-06,19:00:00,407,209,198,FMN 02 Mercatorstraat
650,Mercatorstraat 36,2022-10-06,20:00:00,289,126,163,FMN 02 Mercatorstraat
650,Mercatorstraat 36,2022-10-06,21:00:00,239,106,133,FMN 02 Mercatorstraat
650,Mercatorstraat 36,2022-10-06,22:00:00,250,101,149,FMN 02 Mercatorstraat
650,Mercatorstraat 36,2022-10-06,23:00:00,155,58,97,FMN 02 Mercatorstraat
650,Mercatorstraat 36,2022-10-07,00:00:00,122,46,76,FMN 02 Mercatorstraat
650,Mercatorstraat 36,2022-10-07,01:00:00,61,21,40,FMN 02 Mercatorstraat
650,Mercatorstraat 36,2022-10-07,02:00:00,67,23,44,FMN 02 Mercatorstraat
650,Mercatorstraat 36,2022-10-07,03:00:00,41,3,38,FMN 02 Mercatorstraat
650,Mercatorstraat 36,2022-10-07,04:00:00,50,23,27,FMN 02 Mercatorstraat
650,Mercatorstraat 36,2022-10-07,05:00:00,84,44,40,FMN 02 Mercatorstraat
650,Mercatorstraat 36,2022-10-07,06:00:00,122,64,58,FMN 02 Mercatorstraat
650,Mercatorstraat 36,2022-10-07,07:00:00,363,216,147,FMN 02 Mercatorstraat
650,Mercatorstraat 36,2022-10-07,08:00:00,908,659,249,FMN 02 Mercatorstraat
650,Mercatorstraat 36,2022-10-07,09:00:00,464,343,121,FMN 02 Mercatorstraat
650,Mercatorstraat 36,2022-10-07,10:00:00,339,224,115,FMN 02 Mercatorstraat
650,Mercatorstraat 36,2022-10-07,11:00:00,308,172,136,FMN 02 Mercatorstraat
650,Mercatorstraat 36,2022-10-07,12:00:00,499,282,217,FMN 02 Mercatorstraat
650,Mercatorstraat 36,2022-10-07,13:00:00,375,196,179,FMN 02 Mercatorstraat
650,Mercatorstraat 36,2022-10-07,14:00:00,425,172,253,FMN 02 Mercatorstraat
650,Mercatorstraat 36,2022-10-07,15:00:00,573,202,371,FMN 02 Mercatorstraat
650,Mercatorstraat 36,2022-10-07,16:00:00,683,228,455,FMN 02 Mercatorstraat
650,Mercatorstraat 36,2022-10-07,17:00:00,731,224,507,FMN 02 Mercatorstraat
650,Mercatorstraat 36,2022-10-07,18:00:00,572,243,329,FMN 02 Mercatorstraat
650,Mercatorstraat 36,2022-10-07,19:00:00,404,230,174,FMN 02 Mercatorstraat
650,Mercatorstraat 36,2022-10-07,20:00:00,258,120,138,FMN 02 Mercatorstraat
650,Mercatorstraat 36,2022-10-07,21:00:00,224,104,120,FMN 02 Mercatorstraat
650,Mercatorstraat 36,2022-10-07,22:00:00,248,125,123,FMN 02 Mercatorstraat
650,Mercatorstraat 36,2022-10-07,23:00:00,200,73,127,FMN 02 Mercatorstraat
650,Mercatorstraat 36,2022-10-08,00:00:00,204,77,127,FMN 02 Mercatorstraat
650,Mercatorstraat 36,2022-10-08,01:00:00,145,53,92,FMN 02 Mercatorstraat
650,Mercatorstraat 36,2022-10-08,02:00:00,112,39,73,FMN 02 Mercatorstraat
650,Mercatorstraat 36,2022-10-08,03:00:00,56,19,37,FMN 02 Mercatorstraat
650,Mercatorstraat 36,2022-10-08,04:00:00,52,20,32,FMN 02 Mercatorstraat
650,Mercatorstraat 36,2022-10-08,05:00:00,44,18,26,FMN 02 Mercatorstraat
650,Mercatorstraat 36,2022-10-08,06:00:00,48,20,28,FMN 02 Mercatorstraat
650,Mercatorstraat 36,2022-10-08,07:00:00,39,19,20,FMN 02 Mercatorstraat
650,Mercatorstraat 36,2022-10-08,08:00:00,87,56,31,FMN 02 Mercatorstraat
650,Mercatorstraat 36,2022-10-08,09:00:00,185,144,41,FMN 02 Mercatorstraat
650,Mercatorstraat 36,2022-10-08,10:00:00,261,194,67,FMN 02 Mercatorstraat
650,Mercatorstraat 36,2022-10-08,11:00:00,378,229,149,FMN 02 Mercatorstraat
650,Mercatorstraat 36,2022-10-08,12:00:00,394,218,176,FMN 02 Mercatorstraat
650,Mercatorstraat 36,2022-10-08,13:00:00,413,247,166,FMN 02 Mercatorstraat
650,Mercatorstraat 36,2022-10-08,14:00:00,417,260,157,FMN 02 Mercatorstraat
650,Mercatorstraat 36,2022-10-08,15:00:00,442,224,218,FMN 02 Mercatorstraat
650,Mercatorstraat 36,2022-10-08,16:00:00,407,175,232,FMN 02 Mercatorstraat
650,Mercatorstraat 36,2022-10-08,17:00:00,370,128,242,FMN 02 Mercatorstraat
650,Mercatorstraat 36,2022-10-08,18:00:00,434,179,255,FMN 02 Mercatorstraat
650,Mercatorstraat 36,2022-10-08,19:00:00,262,131,131,FMN 02 Mercatorstraat
650,Mercatorstraat 36,2022-10-08,20:00:00,255,124,131,FMN 02 Mercatorstraat
650,Mercatorstraat 36,2022-10-08,21:00:00,242,130,112,FMN 02 Mercatorstraat
650,Mercatorstraat 36,2022-10-08,22:00:00,231,108,123,FMN 02 Mercatorstraat
650,Mercatorstraat 36,2022-10-08,23:00:00,175,65,110,FMN 02 Mercatorstraat
650,Mercatorstraat 36,2022-10-09,00:00:00,195,79,116,FMN 02 Mercatorstraat
650,Mercatorstraat 36,2022-10-09,01:00:00,126,54,72,FMN 02 Mercatorstraat
650,Mercatorstraat 36,2022-10-09,02:00:00,86,25,61,FMN 02 Mercatorstraat
650,Mercatorstraat 36,2022-10-09,03:00:00,70,8,62,FMN 02 Mercatorstraat
650,Mercatorstraat 36,2022-10-09,04:00:00,55,13,42,FMN 02 Mercatorstraat
650,Mercatorstraat 36,2022-10-09,05:00:00,45,14,31,FMN 02 Mercatorstraat
650,Mercatorstraat 36,2022-10-09,06:00:00,38,20,18,FMN 02 Mercatorstraat
650,Mercatorstraat 36,2022-10-09,07:00:00,44,20,24,FMN 02 Mercatorstraat
650,Mercatorstraat 36,2022-10-09,08:00:00,60,29,31,FMN 02 Mercatorstraat
650,Mercatorstraat 36,2022-10-09,09:00:00,190,131,59,FMN 02 Mercatorstraat
650,Mercatorstraat 36,2022-10-09,10:00:00,276,188,88,FMN 02 Mercatorstraat
650,Mercatorstraat 36,2022-10-09,11:00:00,305,159,146,FMN 02 Mercatorstraat
650,Mercatorstraat 36,2022-10-09,12:00:00,373,157,216,FMN 02 Mercatorstraat
650,Mercatorstraat 36,2022-10-09,13:00:00,392,233,159,FMN 02 Mercatorstraat
650,Mercatorstraat 36,2022-10-09,14:00:00,421,243,178,FMN 02 Mercatorstraat
650,Mercatorstraat 36,2022-10-09,15:00:00,397,197,200,FMN 02 Mercatorstraat
650,Mercatorstraat 36,2022-10-09,16:00:00,396,177,219,FMN 02 Mercatorstraat
650,Mercatorstraat 36,2022-10-09,17:00:00,426,185,241,FMN 02 Mercatorstraat
650,Mercatorstraat 36,2022-10-09,18:00:00,297,145,152,FMN 02 Mercatorstraat
650,Mercatorstraat 36,2022-10-09,19:00:00,285,146,139,FMN 02 Mercatorstraat
650,Mercatorstraat 36,2022-10-09,20:00:00,160,67,93,FMN 02 Mercatorstraat
650,Mercatorstraat 36,2022-10-09,21:00:00,155,66,89,FMN 02 Mercatorstraat
650,Mercatorstraat 36,2022-10-09,22:00:00,123,46,77,FMN 02 Mercatorstraat
650,Mercatorstraat 36,2022-10-09,23:00:00,80,15,65,FMN 02 Mercatorstraat
650,Mercatorstraat 36,2022-10-10,00:00:00,47,15,32,FMN 02 Mercatorstraat
650,Mercatorstraat 36,2022-10-10,01:00:00,26,9,17,FMN 02 Mercatorstraat
650,Mercatorstraat 36,2022-10-10,02:00:00,18,10,8,FMN 02 Mercatorstraat
650,Mercatorstraat 36,2022-10-10,03:00:00,7,4,3,FMN 02 Mercatorstraat
650,Mercatorstraat 36,2022-10-10,04:00:00,33,23,10,FMN 02 Mercatorstraat
650,Mercatorstraat 36,2022-10-10,05:00:00,50,28,22,FMN 02 Mercatorstraat
650,Mercatorstraat 36,2022-10-10,06:00:00,108,73,35,FMN 02 Mercatorstraat
650,Mercatorstraat 36,2022-10-10,07:00:00,367,253,114,FMN 02 Mercatorstraat
650,Mercatorstraat 36,2022-10-10,08:00:00,1007,774,233,FMN 02 Mercatorstraat
650,Mercatorstraat 36,2022-10-10,09:00:00,428,318,110,FMN 02 Mercatorstraat
650,Mercatorstraat 36,2022-10-10,10:00:00,267,176,91,FMN 02 Mercatorstraat
650,Mercatorstraat 36,2022-10-10,11:00:00,268,166,102,FMN 02 Mercatorstraat
650,Mercatorstraat 36,2022-10-10,12:00:00,383,200,183,FMN 02 Mercatorstraat
650,Mercatorstraat 36,2022-10-10,13:00:00,346,194,152,FMN 02 Mercatorstraat
650,Mercatorstraat 36,2022-10-10,14:00:00,269,124,145,FMN 02 Mercatorstraat
650,Mercatorstraat 36,2022-10-10,15:00:00,490,159,331,FMN 02 Mercatorstraat
650,Mercatorstraat 36,2022-10-10,16:00:00,652,198,454,FMN 02 Mercatorstraat
650,Mercatorstraat 36,2022-10-10,17:00:00,766,238,528,FMN 02 Mercatorstraat
650,Mercatorstraat 36,2022-10-10,18:00:00,535,212,323,FMN 02 Mercatorstraat
650,Mercatorstraat 36,2022-10-10,19:00:00,286,134,152,FMN 02 Mercatorstraat
650,Mercatorstraat 36,2022-10-10,20:00:00,188,75,113,FMN 02 Mercatorstraat
650,Mercatorstraat 36,2022-10-10,21:00:00,226,97,129,FMN 02 Mercatorstraat
650,Mercatorstraat 36,2022-10-10,22:00:00,133,50,83,FMN 02 Mercatorstraat
650,Mercatorstraat 36,2022-10-10,23:00:00,77,27,50,FMN 02 Mercatorstraat
650,Mercatorstraat 36,2022-10-11,00:00:00,41,14,27,FMN 02 Mercatorstraat
650,Mercatorstraat 36,2022-10-11,01:00:00,30,11,19,FMN 02 Mercatorstraat
650,Mercatorstraat 36,2022-10-11,02:00:00,15,4,11,FMN 02 Mercatorstraat
650,Mercatorstraat 36,2022-10-11,03:00:00,10,6,4,FMN 02 Mercatorstraat
650,Mercatorstraat 36,2022-10-11,04:00:00,30,19,11,FMN 02 Mercatorstraat
650,Mercatorstraat 36,2022-10-11,05:00:00,57,33,24,FMN 02 Mercatorstraat
650,Mercatorstraat 36,2022-10-11,06:00:00,142,99,43,FMN 02 Mercatorstraat
650,Mercatorstraat 36,2022-10-11,07:00:00,426,284,142,FMN 02 Mercatorstraat
650,Mercatorstraat 36,2022-10-11,08:00:00,1109,836,273,FMN 02 Mercatorstraat
650,Mercatorstraat 36,2022-10-11,09:00:00,445,338,107,FMN 02 Mercatorstraat
650,Mercatorstraat 36,2022-10-11,10:00:00,271,185,86,FMN 02 Mercatorstraat
650,Mercatorstraat 36,2022-10-11,11:00:00,292,166,126,FMN 02 Mercatorstraat
650,Mercatorstraat 36,2022-10-11,12:00:00,413,220,193,FMN 02 Mercatorstraat
650,Mercatorstraat 36,2022-10-11,13:00:00,349,200,149,FMN 02 Mercatorstraat
650,Mercatorstraat 36,2022-10-11,14:00:00,388,201,187,FMN 02 Mercatorstraat
650,Mercatorstraat 36,2022-10-11,15:00:00,564,180,384,FMN 02 Mercatorstraat
650,Mercatorstraat 36,2022-10-11,16:00:00,753,216,537,FMN 02 Mercatorstraat
650,Mercatorstraat 36,2022-10-11,17:00:00,907,322,585,FMN 02 Mercatorstraat
650,Mercatorstraat 36,2022-10-11,18:00:00,627,239,388,FMN 02 Mercatorstraat
650,Mercatorstraat 36,2022-10-11,19:00:00,353,163,190,FMN 02 Mercatorstraat
650,Mercatorstraat 36,2022-10-11,20:00:00,218,98,120,FMN 02 Mercatorstraat
650,Mercatorstraat 36,2022-10-11,21:00:00,263,92,171,FMN 02 Mercatorstraat
650,Mercatorstraat 36,2022-10-11,22:00:00,232,102,130,FMN 02 Mercatorstraat
650,Mercatorstraat 36,2022-10-11,23:00:00,102,39,63,FMN 02 Mercatorstraat
650,Mercatorstraat 36,2022-10-12,00:00:00,60,18,42,FMN 02 Mercatorstraat
650,Mercatorstraat 36,2022-10-12,01:00:00,38,13,25,FMN 02 Mercatorstraat
650,Mercatorstraat 36,2022-10-12,02:00:00,22,6,16,FMN 02 Mercatorstraat
650,Mercatorstraat 36,2022-10-12,03:00:00,9,5,4,FMN 02 Mercatorstraat
650,Mercatorstraat 36,2022-10-12,04:00:00,28,14,14,FMN 02 Mercatorstraat
650,Mercatorstraat 36,2022-10-12,05:00:00,51,28,23,FMN 02 Mercatorstraat
650,Mercatorstraat 36,2022-10-12,06:00:00,133,87,46,FMN 02 Mercatorstraat
650,Mercatorstraat 36,2022-10-12,07:00:00,392,271,121,FMN 02 Mercatorstraat
650,Mercatorstraat 36,2022-10-12,08:00:00,895,648,247,FMN 02 Mercatorstraat
650,Mercatorstraat 36,2022-10-12,09:00:00,457,315,142,FMN 02 Mercatorstraat
650,Mercatorstraat 36,2022-10-12,10:00:00,307,213,94,FMN 02 Mercatorstraat
650,Mercatorstraat 36,2022-10-12,11:00:00,282,147,135,FMN 02 Mercatorstraat
650,Mercatorstraat 36,2022-10-12,12:00:00,590,255,335,FMN 02 Mercatorstraat
650,Mercatorstraat 36,2022-10-12,13:00:00,444,243,201,FMN 02 Mercatorstraat
650,Mercatorstraat 36,2022-10-12,14:00:00,398,190,208,FMN 02 Mercatorstraat
650,Mercatorstraat 36,2022-10-12,15:00:00,440,167,273,FMN 02 Mercatorstraat
650,Mercatorstraat 36,2022-10-12,16:00:00,557,210,347,FMN 02 Mercatorstraat
650,Mercatorstraat 36,2022-10-12,17:00:00,769,265,504,FMN 02 Mercatorstraat
650,Mercatorstraat 36,2022-10-12,18:00:00,626,269,357,FMN 02 Mercatorstraat
650,Mercatorstraat 36,2022-10-12,19:00:00,389,174,215,FMN 02 Mercatorstraat
650,Mercatorstraat 36,2022-10-12,20:00:00,234,96,138,FMN 02 Mercatorstraat
650,Mercatorstraat 36,2022-10-12,21:00:00,212,84,128,FMN 02 Mercatorstraat
650,Mercatorstraat 36,2022-10-12,22:00:00,197,83,114,FMN 02 Mercatorstraat
650,Mercatorstraat 36,2022-10-12,23:00:00,158,46,112,FMN 02 Mercatorstraat
650,Mercatorstraat 36,2022-10-13,00:00:00,69,26,43,FMN 02 Mercatorstraat
650,Mercatorstraat 36,2022-10-13,01:00:00,30,14,16,FMN 02 Mercatorstraat
650,Mercatorstraat 36,2022-10-13,02:00:00,14,3,11,FMN 02 Mercatorstraat
650,Mercatorstraat 36,2022-10-13,03:00:00,15,6,9,FMN 02 Mercatorstraat
650,Mercatorstraat 36,2022-10-13,04:00:00,30,16,14,FMN 02 Mercatorstraat
650,Mercatorstraat 36,2022-10-13,05:00:00,65,32,33,FMN 02 Mercatorstraat
650,Mercatorstraat 36,2022-10-13,06:00:00,102,75,27,FMN 02 Mercatorstraat
650,Mercatorstraat 36,2022-10-13,07:00:00,387,267,120,FMN 02 Mercatorstraat
650,Mercatorstraat 36,2022-10-13,08:00:00,1069,814,255,FMN 02 Mercatorstraat
650,Mercatorstraat 36,2022-10-13,09:00:00,399,294,105,FMN 02 Mercatorstraat
650,Mercatorstraat 36,2022-10-13,10:00:00,254,173,81,FMN 02 Mercatorstraat
650,Mercatorstraat 36,2022-10-13,11:00:00,239,111,128,FMN 02 Mercatorstraat
650,Mercatorstraat 36,2022-10-13,12:00:00,340,157,183,FMN 02 Mercatorstraat
650,Mercatorstraat 36,2022-10-13,13:00:00,281,140,141,FMN 02 Mercatorstraat
650,Mercatorstraat 36,2022-10-13,14:00:00,272,112,160,FMN 02 Mercatorstraat
650,Mercatorstraat 36,2022-10-13,15:00:00,460,152,308,FMN 02 Mercatorstraat
650,Mercatorstraat 36,2022-10-13,16:00:00,680,231,449,FMN 02 Mercatorstraat
650,Mercatorstraat 36,2022-10-13,17:00:00,775,251,524,FMN 02 Mercatorstraat
650,Mercatorstraat 36,2022-10-13,18:00:00,547,211,336,FMN 02 Mercatorstraat
650,Mercatorstraat 36,2022-10-13,19:00:00,317,136,181,FMN 02 Mercatorstraat
650,Mercatorstraat 36,2022-10-13,20:00:00,217,87,130,FMN 02 Mercatorstraat
650,Mercatorstraat 36,2022-10-13,21:00:00,231,87,144,FMN 02 Mercatorstraat
650,Mercatorstraat 36,2022-10-13,22:00:00,222,87,135,FMN 02 Mercatorstraat
650,Mercatorstraat 36,2022-10-13,23:00:00,158,65,93,FMN 02 Mercatorstraat
650,Mercatorstraat 36,2022-10-14,00:00:00,86,40,46,FMN 02 Mercatorstraat
650,Mercatorstraat 36,2022-10-14,01:00:00,59,20,39,FMN 02 Mercatorstraat
650,Mercatorstraat 36,2022-10-14,02:00:00,44,11,33,FMN 02 Mercatorstraat
650,Mercatorstraat 36,2022-10-14,03:00:00,26,9,17,FMN 02 Mercatorstraat
650,Mercatorstraat 36,2022-10-14,04:00:00,41,12,29,FMN 02 Mercatorstraat
650,Mercatorstraat 36,2022-10-14,05:00:00,56,30,26,FMN 02 Mercatorstraat
650,Mercatorstraat 36,2022-10-14,06:00:00,98,67,31,FMN 02 Mercatorstraat
650,Mercatorstraat 36,2022-10-14,07:00:00,325,223,102,FMN 02 Mercatorstraat
650,Mercatorstraat 36,2022-10-14,08:00:00,824,639,185,FMN 02 Mercatorstraat
650,Mercatorstraat 36,2022-10-14,09:00:00,338,259,79,FMN 02 Mercatorstraat
650,Mercatorstraat 36,2022-10-14,10:00:00,227,138,89,FMN 02 Mercatorstraat
650,Mercatorstraat 36,2022-10-14,11:00:00,216,134,82,FMN 02 Mercatorstraat
650,Mercatorstraat 36,2022-10-14,12:00:00,307,150,157,FMN 02 Mercatorstraat
650,Mercatorstraat 36,2022-10-14,13:00:00,302,152,150,FMN 02 Mercatorstraat
650,Mercatorstraat 36,2022-10-14,14:00:00,350,160,190,FMN 02 Mercatorstraat
650,Mercatorstraat 36,2022-10-14,15:00:00,550,179,371,FMN 02 Mercatorstraat
650,Mercatorstraat 36,2022-10-14,16:00:00,596,222,374,FMN 02 Mercatorstraat
650,Mercatorstraat 36,2022-10-14,17:00:00,628,225,403,FMN 02 Mercatorstraat
650,Mercatorstraat 36,2022-10-14,18:00:00,527,218,309,FMN 02 Mercatorstraat
650,Mercatorstraat 36,2022-10-14,19:00:00,416,216,200,FMN 02 Mercatorstraat
650,Mercatorstraat 36,2022-10-14,20:00:00,289,146,143,FMN 02 Mercatorstraat
650,Mercatorstraat 36,2022-10-14,21:00:00,237,122,115,FMN 02 Mercatorstraat
650,Mercatorstraat 36,2022-10-14,22:00:00,233,96,137,FMN 02 Mercatorstraat
650,Mercatorstraat 36,2022-10-14,23:00:00,197,80,117,FMN 02 Mercatorstraat
650,Mercatorstraat 36,2022-10-15,00:00:00,224,94,130,FMN 02 Mercatorstraat
650,Mercatorstraat 36,2022-10-15,01:00:00,132,72,60,FMN 02 Mercatorstraat
650,Mercatorstraat 36,2022-10-15,02:00:00,99,29,70,FMN 02 Mercatorstraat
650,Mercatorstraat 36,2022-10-15,03:00:00,91,25,66,FMN 02 Mercatorstraat
650,Mercatorstraat 36,2022-10-15,04:00:00,72,17,55,FMN 02 Mercatorstraat
650,Mercatorstraat 36,2022-10-15,05:00:00,72,25,47,FMN 02 Mercatorstraat
650,Mercatorstraat 36,2022-10-15,06:00:00,37,19,18,FMN 02 Mercatorstraat
650,Mercatorstraat 36,2022-10-15,07:00:00,62,32,30,FMN 02 Mercatorstraat
650,Mercatorstraat 36,2022-10-15,08:00:00,100,53,47,FMN 02 Mercatorstraat
650,Mercatorstraat 36,2022-10-15,09:00:00,168,130,38,FMN 02 Mercatorstraat
650,Mercatorstraat 36,2022-10-15,10:00:00,222,153,69,FMN 02 Mercatorstraat
650,Mercatorstraat 36,2022-10-15,11:00:00,272,159,113,FMN 02 Mercatorstraat
650,Mercatorstraat 36,2022-10-15,12:00:00,265,139,126,FMN 02 Mercatorstraat
650,Mercatorstraat 36,2022-10-15,13:00:00,280,168,112,FMN 02 Mercatorstraat
650,Mercatorstraat 36,2022-10-15,14:00:00,395,250,145,FMN 02 Mercatorstraat
650,Mercatorstraat 36,2022-10-15,15:00:00,361,193,168,FMN 02 Mercatorstraat
650,Mercatorstraat 36,2022-10-15,16:00:00,368,165,203,FMN 02 Mercatorstraat
650,Mercatorstraat 36,2022-10-15,17:00:00,387,138,249,FMN 02 Mercatorstraat
650,Mercatorstraat 36,2022-10-15,18:00:00,438,178,260,FMN 02 Mercatorstraat
650,Mercatorstraat 36,2022-10-15,19:00:00,364,194,170,FMN 02 Mercatorstraat
650,Mercatorstraat 36,2022-10-15,20:00:00,219,102,117,FMN 02 Mercatorstraat
650,Mercatorstraat 36,2022-10-15,21:00:00,228,121,107,FMN 02 Mercatorstraat
650,Mercatorstraat 36,2022-10-15,22:00:00,186,68,118,FMN 02 Mercatorstraat
650,Mercatorstraat 36,2022-10-15,23:00:00,225,77,148,FMN 02 Mercatorstraat
650,Mercatorstraat 36,2022-10-16,00:00:00,169,64,105,FMN 02 Mercatorstraat
650,Mercatorstraat 36,2022-10-16,01:00:00,137,47,90,FMN 02 Mercatorstraat
650,Mercatorstraat 36,2022-10-16,02:00:00,119,53,66,FMN 02 Mercatorstraat
650,Mercatorstraat 36,2022-10-16,03:00:00,63,22,41,FMN 02 Mercatorstraat
650,Mercatorstraat 36,2022-10-16,04:00:00,46,13,33,FMN 02 Mercatorstraat
650,Mercatorstraat 36,2022-10-16,05:00:00,53,15,38,FMN 02 Mercatorstraat
650,Mercatorstraat 36,2022-10-16,06:00:00,43,18,25,FMN 02 Mercatorstraat
650,Mercatorstraat 36,2022-10-16,07:00:00,54,27,27,FMN 02 Mercatorstraat
650,Mercatorstraat 36,2022-10-16,08:00:00,81,47,34,FMN 02 Mercatorstraat
650,Mercatorstraat 36,2022-10-16,09:00:00,159,114,45,FMN 02 Mercatorstraat
650,Mercatorstraat 36,2022-10-16,10:00:00,236,155,81,FMN 02 Mercatorstraat
650,Mercatorstraat 36,2022-10-16,11:00:00,302,178,124,FMN 02 Mercatorstraat
650,Mercatorstraat 36,2022-10-16,12:00:00,350,190,160,FMN 02 Mercatorstraat
650,Mercatorstraat 36,2022-10-16,13:00:00,395,236,159,FMN 02 Mercatorstraat
650,Mercatorstraat 36,2022-10-16,14:00:00,411,250,161,FMN 02 Mercatorstraat
650,Mercatorstraat 36,2022-10-16,15:00:00,369,182,187,FMN 02 Mercatorstraat
650,Mercatorstraat 36,2022-10-16,16:00:00,334,139,195,FMN 02 Mercatorstraat
650,Mercatorstraat 36,2022-10-16,17:00:00,356,120,236,FMN 02 Mercatorstraat
650,Mercatorstraat 36,2022-10-16,18:00:00,311,144,167,FMN 02 Mercatorstraat
650,Mercatorstraat 36,2022-10-16,19:00:00,248,113,135,FMN 02 Mercatorstraat
650,Mercatorstraat 36,2022-10-16,20:00:00,158,66,92,FMN 02 Mercatorstraat
650,Mercatorstraat 36,2022-10-16,21:00:00,126,58,68,FMN 02 Mercatorstraat
650,Mercatorstraat 36,2022-10-16,22:00:00,103,33,70,FMN 02 Mercatorstraat
650,Mercatorstraat 36,2022-10-16,23:00:00,70,33,37,FMN 02 Mercatorstraat
650,Mercatorstraat 36,2022-10-17,00:00:00,36,16,20,FMN 02 Mercatorstraat
650,Mercatorstraat 36,2022-10-17,01:00:00,26,13,13,FMN 02 Mercatorstraat
650,Mercatorstraat 36,2022-10-17,02:00:00,21,8,13,FMN 02 Mercatorstraat
650,Mercatorstraat 36,2022-10-17,03:00:00,14,5,9,FMN 02 Mercatorstraat
650,Mercatorstraat 36,2022-10-17,04:00:00,26,19,7,FMN 02 Mercatorstraat
650,Mercatorstraat 36,2022-10-17,05:00:00,52,26,26,FMN 02 Mercatorstraat
650,Mercatorstraat 36,2022-10-17,06:00:00,101,70,31,FMN 02 Mercatorstraat
650,Mercatorstraat 36,2022-10-17,07:00:00,361,246,115,FMN 02 Mercatorstraat
650,Mercatorstraat 36,2022-10-17,08:00:00,928,729,199,FMN 02 Mercatorstraat
650,Mercatorstraat 36,2022-10-17,09:00:00,303,229,74,FMN 02 Mercatorstraat
650,Mercatorstraat 36,2022-10-17,10:00:00,151,83,68,FMN 02 Mercatorstraat
650,Mercatorstraat 36,2022-10-17,11:00:00,139,76,63,FMN 02 Mercatorstraat
650,Mercatorstraat 36,2022-10-17,12:00:00,241,131,110,FMN 02 Mercatorstraat
650,Mercatorstraat 36,2022-10-17,13:00:00,248,133,115,FMN 02 Mercatorstraat
650,Mercatorstraat 36,2022-10-17,14:00:00,238,108,130,FMN 02 Mercatorstraat
650,Mercatorstraat 36,2022-10-17,15:00:00,415,146,269,FMN 02 Mercatorstraat
650,Mercatorstraat 36,2022-10-17,16:00:00,580,160,420,FMN 02 Mercatorstraat
650,Mercatorstraat 36,2022-10-17,17:00:00,712,234,478,FMN 02 Mercatorstraat
650,Mercatorstraat 36,2022-10-17,18:00:00,507,199,308,FMN 02 Mercatorstraat
650,Mercatorstraat 36,2022-10-17,19:00:00,318,145,173,FMN 02 Mercatorstraat
650,Mercatorstraat 36,2022-10-17,20:00:00,213,92,121,FMN 02 Mercatorstraat
650,Mercatorstraat 36,2022-10-17,21:00:00,188,79,109,FMN 02 Mercatorstraat
650,Mercatorstraat 36,2022-10-17,22:00:00,143,43,100,FMN 02 Mercatorstraat
650,Mercatorstraat 36,2022-10-17,23:00:00,93,29,64,FMN 02 Mercatorstraat
650,Mercatorstraat 36,2022-10-18,00:00:00,42,13,29,FMN 02 Mercatorstraat
650,Mercatorstraat 36,2022-10-18,01:00:00,27,10,17,FMN 02 Mercatorstraat
650,Mercatorstraat 36,2022-10-18,02:00:00,28,6,22,FMN 02 Mercatorstraat
650,Mercatorstraat 36,2022-10-18,03:00:00,9,4,5,FMN 02 Mercatorstraat
650,Mercatorstraat 36,2022-10-18,04:00:00,34,16,18,FMN 02 Mercatorstraat
650,Mercatorstraat 36,2022-10-18,05:00:00,67,37,30,FMN 02 Mercatorstraat
650,Mercatorstraat 36,2022-10-18,06:00:00,123,83,40,FMN 02 Mercatorstraat
650,Mercatorstraat 36,2022-10-18,07:00:00,418,286,132,FMN 02 Mercatorstraat
650,Mercatorstraat 36,2022-10-18,08:00:00,1072,796,276,FMN 02 Mercatorstraat
650,Mercatorstraat 36,2022-10-18,09:00:00,448,341,107,FMN 02 Mercatorstraat
650,Mercatorstraat 36,2022-10-18,10:00:00,269,169,100,FMN 02 Mercatorstraat
650,Mercatorstraat 36,2022-10-18,11:00:00,266,152,114,FMN 02 Mercatorstraat
650,Mercatorstraat 36,2022-10-18,12:00:00,445,216,229,FMN 02 Mercatorstraat
650,Mercatorstraat 36,2022-10-18,13:00:00,401,201,200,FMN 02 Mercatorstraat
650,Mercatorstraat 36,2022-10-18,14:00:00,352,155,197,FMN 02 Mercatorstraat
650,Mercatorstraat 36,2022-10-18,15:00:00,573,227,346,FMN 02 Mercatorstraat
650,Mercatorstraat 36,2022-10-18,16:00:00,749,280,469,FMN 02 Mercatorstraat
650,Mercatorstraat 36,2022-10-18,17:00:00,921,322,599,FMN 02 Mercatorstraat
650,Mercatorstraat 36,2022-10-18,18:00:00,691,286,405,FMN 02 Mercatorstraat
650,Mercatorstraat 36,2022-10-18,19:00:00,425,213,212,FMN 02 Mercatorstraat
650,Mercatorstraat 36,2022-10-18,20:00:00,253,101,152,FMN 02 Mercatorstraat
650,Mercatorstraat 36,2022-10-18,21:00:00,216,85,131,FMN 02 Mercatorstraat
650,Mercatorstraat 36,2022-10-18,22:00:00,261,91,170,FMN 02 Mercatorstraat
650,Mercatorstraat 36,2022-10-18,23:00:00,125,41,84,FMN 02 Mercatorstraat
650,Mercatorstraat 36,2022-10-19,00:00:00,58,19,39,FMN 02 Mercatorstraat
650,Mercatorstraat 36,2022-10-19,01:00:00,24,11,13,FMN 02 Mercatorstraat
650,Mercatorstraat 36,2022-10-19,02:00:00,26,13,13,FMN 02 Mercatorstraat
650,Mercatorstraat 36,2022-10-19,03:00:00,22,6,16,FMN 02 Mercatorstraat
650,Mercatorstraat 36,2022-10-19,04:00:00,37,12,25,FMN 02 Mercatorstraat
650,Mercatorstraat 36,2022-10-19,05:00:00,62,37,25,FMN 02 Mercatorstraat
650,Mercatorstraat 36,2022-10-19,06:00:00,119,82,37,FMN 02 Mercatorstraat
650,Mercatorstraat 36,2022-10-19,07:00:00,412,288,124,FMN 02 Mercatorstraat
650,Mercatorstraat 36,2022-10-19,08:00:00,971,703,268,FMN 02 Mercatorstraat
650,Mercatorstraat 36,2022-10-19,09:00:00,492,346,146,FMN 02 Mercatorstraat
650,Mercatorstraat 36,2022-10-19,10:00:00,297,198,99,FMN 02 Mercatorstraat
650,Mercatorstraat 36,2022-10-19,11:00:00,310,153,157,FMN 02 Mercatorstraat
650,Mercatorstraat 36,2022-10-19,12:00:00,610,219,391,FMN 02 Mercatorstraat
650,Mercatorstraat 36,2022-10-19,13:00:00,543,258,285,FMN 02 Mercatorstraat
650,Mercatorstraat 36,2022-10-19,14:00:00,386,209,177,FMN 02 Mercatorstraat
650,Mercatorstraat 36,2022-10-19,15:00:00,442,178,264,FMN 02 Mercatorstraat
650,Mercatorstraat 36,2022-10-19,16:00:00,702,294,408,FMN 02 Mercatorstraat
650,Mercatorstraat 36,2022-10-19,17:00:00,795,249,546,FMN 02 Mercatorstraat
650,Mercatorstraat 36,2022-10-19,18:00:00,644,278,366,FMN 02 Mercatorstraat
650,Mercatorstraat 36,2022-10-19,19:00:00,419,207,212,FMN 02 Mercatorstraat
650,Mercatorstraat 36,2022-10-19,20:00:00,314,177,137,FMN 02 Mercatorstraat
650,Mercatorstraat 36,2022-10-19,21:00:00,217,97,120,FMN 02 Mercatorstraat
650,Mercatorstraat 36,2022-10-19,22:00:00,233,80,153,FMN 02 Mercatorstraat
650,Mercatorstraat 36,2022-10-19,23:00:00,208,45,163,FMN 02 Mercatorstraat
650,Mercatorstraat 36,2022-10-20,00:00:00,104,31,73,FMN 02 Mercatorstraat
650,Mercatorstraat 36,2022-10-20,01:00:00,43,17,26,FMN 02 Mercatorstraat
650,Mercatorstraat 36,2022-10-20,02:00:00,25,10,15,FMN 02 Mercatorstraat
650,Mercatorstraat 36,2022-10-20,03:00:00,20,8,12,FMN 02 Mercatorstraat
650,Mercatorstraat 36,2022-10-20,04:00:00,23,15,8,FMN 02 Mercatorstraat
650,Mercatorstraat 36,2022-10-20,05:00:00,59,35,24,FMN 02 Mercatorstraat
650,Mercatorstraat 36,2022-10-20,06:00:00,133,75,58,FMN 02 Mercatorstraat
650,Mercatorstraat 36,2022-10-20,07:00:00,436,269,167,FMN 02 Mercatorstraat
650,Mercatorstraat 36,2022-10-20,08:00:00,1157,836,321,FMN 02 Mercatorstraat
650,Mercatorstraat 36,2022-10-20,09:00:00,438,317,121,FMN 02 Mercatorstraat
650,Mercatorstraat 36,2022-10-20,10:00:00,267,184,83,FMN 02 Mercatorstraat
650,Mercatorstraat 36,2022-10-20,11:00:00,180,74,106,FMN 02 Mercatorstraat
650,Mercatorstraat 36,2022-10-20,12:00:00,391,169,222,FMN 02 Mercatorstraat
650,Mercatorstraat 36,2022-10-20,13:00:00,355,164,191,FMN 02 Mercatorstraat
650,Mercatorstraat 36,2022-10-20,14:00:00,319,148,171,FMN 02 Mercatorstraat
650,Mercatorstraat 36,2022-10-20,15:00:00,433,154,279,FMN 02 Mercatorstraat
650,Mercatorstraat 36,2022-10-20,16:00:00,719,251,468,FMN 02 Mercatorstraat
650,Mercatorstraat 36,2022-10-20,17:00:00,847,317,530,FMN 02 Mercatorstraat
650,Mercatorstraat 36,2022-10-20,18:00:00,643,272,371,FMN 02 Mercatorstraat
650,Mercatorstraat 36,2022-10-20,19:00:00,378,178,200,FMN 02 Mercatorstraat
650,Mercatorstraat 36,2022-10-20,20:00:00,272,121,151,FMN 02 Mercatorstraat
650,Mercatorstraat 36,2022-10-20,21:00:00,246,114,132,FMN 02 Mercatorstraat
650,Mercatorstraat 36,2022-10-20,22:00:00,221,80,141,FMN 02 Mercatorstraat
650,Mercatorstraat 36,2022-10-20,23:00:00,160,54,106,FMN 02 Mercatorstraat
650,Mercatorstraat 36,2022-10-21,00:00:00,93,38,55,FMN 02 Mercatorstraat
650,Mercatorstraat 36,2022-10-21,01:00:00,49,13,36,FMN 02 Mercatorstraat
650,Mercatorstraat 36,2022-10-21,02:00:00,47,14,33,FMN 02 Mercatorstraat
650,Mercatorstraat 36,2022-10-21,03:00:00,33,6,27,FMN 02 Mercatorstraat
650,Mercatorstraat 36,2022-10-21,04:00:00,46,21,25,FMN 02 Mercatorstraat
650,Mercatorstraat 36,2022-10-21,05:00:00,81,38,43,FMN 02 Mercatorstraat
650,Mercatorstraat 36,2022-10-21,06:00:00,223,185,38,FMN 02 Mercatorstraat
650,Mercatorstraat 36,2022-10-21,07:00:00,433,268,165,FMN 02 Mercatorstraat
650,Mercatorstraat 36,2022-10-21,08:00:00,920,650,270,FMN 02 Mercatorstraat
650,Mercatorstraat 36,2022-10-21,09:00:00,471,324,147,FMN 02 Mercatorstraat
650,Mercatorstraat 36,2022-10-21,10:00:00,286,186,100,FMN 02 Mercatorstraat
650,Mercatorstraat 36,2022-10-21,11:00:00,289,149,140,FMN 02 Mercatorstraat
650,Mercatorstraat 36,2022-10-21,12:00:00,418,220,198,FMN 02 Mercatorstraat
650,Mercatorstraat 36,2022-10-21,13:00:00,445,250,195,FMN 02 Mercatorstraat
650,Mercatorstraat 36,2022-10-21,14:00:00,438,195,243,FMN 02 Mercatorstraat
650,Mercatorstraat 36,2022-10-21,15:00:00,532,218,314,FMN 02 Mercatorstraat
650,Mercatorstraat 36,2022-10-21,16:00:00,743,256,487,FMN 02 Mercatorstraat
650,Mercatorstraat 36,2022-10-21,17:00:00,757,259,498,FMN 02 Mercatorstraat
650,Mercatorstraat 36,2022-10-21,18:00:00,562,231,331,FMN 02 Mercatorstraat
650,Mercatorstraat 36,2022-10-21,19:00:00,429,215,214,FMN 02 Mercatorstraat
650,Mercatorstraat 36,2022-10-21,20:00:00,280,130,150,FMN 02 Mercatorstraat
650,Mercatorstraat 36,2022-10-21,21:00:00,277,106,171,FMN 02 Mercatorstraat
650,Mercatorstraat 36,2022-10-21,22:00:00,248,93,155,FMN 02 Mercatorstraat
650,Mercatorstraat 36,2022-10-21,23:00:00,218,93,125,FMN 02 Mercatorstraat
650,Mercatorstraat 36,2022-10-22,00:00:00,210,83,127,FMN 02 Mercatorstraat
650,Mercatorstraat 36,2022-10-22,01:00:00,187,93,94,FMN 02 Mercatorstraat
650,Mercatorstraat 36,2022-10-22,02:00:00,141,43,98,FMN 02 Mercatorstraat
650,Mercatorstraat 36,2022-10-22,03:00:00,96,32,64,FMN 02 Mercatorstraat
650,Mercatorstraat 36,2022-10-22,04:00:00,74,21,53,FMN 02 Mercatorstraat
650,Mercatorstraat 36,2022-10-22,05:00:00,62,24,38,FMN 02 Mercatorstraat
650,Mercatorstraat 36,2022-10-22,06:00:00,43,20,23,FMN 02 Mercatorstraat
650,Mercatorstraat 36,2022-10-22,07:00:00,58,22,36,FMN 02 Mercatorstraat
650,Mercatorstraat 36,2022-10-22,08:00:00,134,82,52,FMN 02 Mercatorstraat
650,Mercatorstraat 36,2022-10-22,09:00:00,230,176,54,FMN 02 Mercatorstraat
650,Mercatorstraat 36,2022-10-22,10:00:00,273,194,79,FMN 02 Mercatorstraat
650,Mercatorstraat 36,2022-10-22,11:00:00,344,221,123,FMN 02 Mercatorstraat
650,Mercatorstraat 36,2022-10-22,12:00:00,398,212,186,FMN 02 Mercatorstraat
650,Mercatorstraat 36,2022-10-22,13:00:00,402,218,184,FMN 02 Mercatorstraat
650,Mercatorstraat 36,2022-10-22,14:00:00,443,260,183,FMN 02 Mercatorstraat
650,Mercatorstraat 36,2022-10-22,15:00:00,413,205,208,FMN 02 Mercatorstraat
650,Mercatorstraat 36,2022-10-22,16:00:00,421,166,255,FMN 02 Mercatorstraat
650,Mercatorstraat 36,2022-10-22,17:00:00,429,165,264,FMN 02 Mercatorstraat
650,Mercatorstraat 36,2022-10-22,18:00:00,401,197,204,FMN 02 Mercatorstraat
650,Mercatorstraat 36,2022-10-22,19:00:00,380,216,164,FMN 02 Mercatorstraat
650,Mercatorstraat 36,2022-10-22,20:00:00,253,135,118,FMN 02 Mercatorstraat
650,Mercatorstraat 36,2022-10-22,21:00:00,273,142,131,FMN 02 Mercatorstraat
650,Mercatorstraat 36,2022-10-22,22:00:00,234,85,149,FMN 02 Mercatorstraat
650,Mercatorstraat 36,2022-10-22,23:00:00,171,75,96,FMN 02 Mercatorstraat
650,Mercatorstraat 36,2022-10-23,00:00:00,136,45,91,FMN 02 Mercatorstraat
650,Mercatorstraat 36,2022-10-23,01:00:00,130,55,75,FMN 02 Mercatorstraat
650,Mercatorstraat 36,2022-10-23,02:00:00,96,29,67,FMN 02 Mercatorstraat
650,Mercatorstraat 36,2022-10-23,03:00:00,79,31,48,FMN 02 Mercatorstraat
650,Mercatorstraat 36,2022-10-23,04:00:00,85,25,60,FMN 02 Mercatorstraat
650,Mercatorstraat 36,2022-10-23,05:00:00,42,16,26,FMN 02 Mercatorstraat
650,Mercatorstraat 36,2022-10-23,06:00:00,42,16,26,FMN 02 Mercatorstraat
650,Mercatorstraat 36,2022-10-23,07:00:00,47,17,30,FMN 02 Mercatorstraat
650,Mercatorstraat 36,2022-10-23,08:00:00,97,40,57,FMN 02 Mercatorstraat
650,Mercatorstraat 36,2022-10-23,09:00:00,239,105,134,FMN 02 Mercatorstraat
650,Mercatorstraat 36,2022-10-23,10:00:00,242,155,87,FMN 02 Mercatorstraat
650,Mercatorstraat 36,2022-10-23,11:00:00,256,148,108,FMN 02 Mercatorstraat
650,Mercatorstraat 36,2022-10-23,12:00:00,314,150,164,FMN 02 Mercatorstraat
650,Mercatorstraat 36,2022-10-23,13:00:00,340,191,149,FMN 02 Mercatorstraat
650,Mercatorstraat 36,2022-10-23,14:00:00,330,191,139,FMN 02 Mercatorstraat
650,Mercatorstraat 36,2022-10-23,15:00:00,327,175,152,FMN 02 Mercatorstraat
650,Mercatorstraat 36,2022-10-23,16:00:00,301,116,185,FMN 02 Mercatorstraat
650,Mercatorstraat 36,2022-10-23,17:00:00,360,134,226,FMN 02 Mercatorstraat
650,Mercatorstraat 36,2022-10-23,18:00:00,294,142,152,FMN 02 Mercatorstraat
650,Mercatorstraat 36,2022-10-23,19:00:00,263,131,132,FMN 02 Mercatorstraat
650,Mercatorstraat 36,2022-10-23,20:00:00,171,82,89,FMN 02 Mercatorstraat
650,Mercatorstraat 36,2022-10-23,21:00:00,152,77,75,FMN 02 Mercatorstraat
650,Mercatorstraat 36,2022-10-23,22:00:00,95,39,56,FMN 02 Mercatorstraat
650,Mercatorstraat 36,2022-10-23,23:00:00,62,25,37,FMN 02 Mercatorstraat
650,Mercatorstraat 36,2022-10-24,00:00:00,33,18,15,FMN 02 Mercatorstraat
650,Mercatorstraat 36,2022-10-24,01:00:00,25,5,20,FMN 02 Mercatorstraat
650,Mercatorstraat 36,2022-10-24,02:00:00,16,4,12,FMN 02 Mercatorstraat
650,Mercatorstraat 36,2022-10-24,03:00:00,11,8,3,FMN 02 Mercatorstraat
650,Mercatorstraat 36,2022-10-24,04:00:00,24,17,7,FMN 02 Mercatorstraat
650,Mercatorstraat 36,2022-10-24,05:00:00,57,31,26,FMN 02 Mercatorstraat
650,Mercatorstraat 36,2022-10-24,06:00:00,119,89,30,FMN 02 Mercatorstraat
650,Mercatorstraat 36,2022-10-24,07:00:00,394,237,157,FMN 02 Mercatorstraat
650,Mercatorstraat 36,2022-10-24,08:00:00,1031,741,290,FMN 02 Mercatorstraat
650,Mercatorstraat 36,2022-10-24,09:00:00,415,291,124,FMN 02 Mercatorstraat
650,Mercatorstraat 36,2022-10-24,10:00:00,243,166,77,FMN 02 Mercatorstraat
650,Mercatorstraat 36,2022-10-24,11:00:00,253,144,109,FMN 02 Mercatorstraat
650,Mercatorstraat 36,2022-10-24,12:00:00,369,171,198,FMN 02 Mercatorstraat
650,Mercatorstraat 36,2022-10-24,13:00:00,394,187,207,FMN 02 Mercatorstraat
650,Mercatorstraat 36,2022-10-24,14:00:00,316,130,186,FMN 02 Mercatorstraat
650,Mercatorstraat 36,2022-10-24,15:00:00,489,177,312,FMN 02 Mercatorstraat
650,Mercatorstraat 36,2022-10-24,16:00:00,690,228,462,FMN 02 Mercatorstraat
650,Mercatorstraat 36,2022-10-24,17:00:00,817,257,560,FMN 02 Mercatorstraat
650,Mercatorstraat 36,2022-10-24,18:00:00,535,202,333,FMN 02 Mercatorstraat
650,Mercatorstraat 36,2022-10-24,19:00:00,253,124,129,FMN 02 Mercatorstraat
650,Mercatorstraat 36,2022-10-24,20:00:00,193,82,111,FMN 02 Mercatorstraat
650,Mercatorstraat 36,2022-10-24,21:00:00,175,59,116,FMN 02 Mercatorstraat
650,Mercatorstraat 36,2022-10-24,22:00:00,170,76,94,FMN 02 Mercatorstraat
650,Mercatorstraat 36,2022-10-24,23:00:00,93,32,61,FMN 02 Mercatorstraat
650,Mercatorstraat 36,2022-10-25,00:00:00,35,11,24,FMN 02 Mercatorstraat
650,Mercatorstraat 36,2022-10-25,01:00:00,26,8,18,FMN 02 Mercatorstraat
650,Mercatorstraat 36,2022-10-25,02:00:00,22,4,18,FMN 02 Mercatorstraat
650,Mercatorstraat 36,2022-10-25,03:00:00,13,4,9,FMN 02 Mercatorstraat
650,Mercatorstraat 36,2022-10-25,04:00:00,33,16,17,FMN 02 Mercatorstraat
650,Mercatorstraat 36,2022-10-25,05:00:00,61,36,25,FMN 02 Mercatorstraat
650,Mercatorstraat 36,2022-10-25,06:00:00,132,92,40,FMN 02 Mercatorstraat
650,Mercatorstraat 36,2022-10-25,07:00:00,464,289,175,FMN 02 Mercatorstraat
650,Mercatorstraat 36,2022-10-25,08:00:00,1123,776,347,FMN 02 Mercatorstraat
650,Mercatorstraat 36,2022-10-25,09:00:00,516,400,116,FMN 02 Mercatorstraat
650,Mercatorstraat 36,2022-10-25,10:00:00,288,189,99,FMN 02 Mercatorstraat
650,Mercatorstraat 36,2022-10-25,11:00:00,294,152,142,FMN 02 Mercatorstraat
650,Mercatorstraat 36,2022-10-25,12:00:00,407,225,182,FMN 02 Mercatorstraat
650,Mercatorstraat 36,2022-10-25,13:00:00,438,217,221,FMN 02 Mercatorstraat
650,Mercatorstraat 36,2022-10-25,14:00:00,374,167,207,FMN 02 Mercatorstraat
650,Mercatorstraat 36,2022-10-25,15:00:00,540,196,344,FMN 02 Mercatorstraat
650,Mercatorstraat 36,2022-10-25,16:00:00,761,232,529,FMN 02 Mercatorstraat
650,Mercatorstraat 36,2022-10-25,17:00:00,926,289,637,FMN 02 Mercatorstraat
650,Mercatorstraat 36,2022-10-25,18:00:00,722,284,438,FMN 02 Mercatorstraat
650,Mercatorstraat 36,2022-10-25,19:00:00,427,163,264,FMN 02 Mercatorstraat
650,Mercatorstraat 36,2022-10-25,20:00:00,274,118,156,FMN 02 Mercatorstraat
650,Mercatorstraat 36,2022-10-25,21:00:00,288,123,165,FMN 02 Mercatorstraat
650,Mercatorstraat 36,2022-10-25,22:00:00,261,99,162,FMN 02 Mercatorstraat
650,Mercatorstraat 36,2022-10-25,23:00:00,120,46,74,FMN 02 Mercatorstraat
650,Mercatorstraat 36,2022-10-26,00:00:00,72,30,42,FMN 02 Mercatorstraat
650,Mercatorstraat 36,2022-10-26,01:00:00,33,6,27,FMN 02 Mercatorstraat
650,Mercatorstraat 36,2022-10-26,02:00:00,14,2,12,FMN 02 Mercatorstraat
650,Mercatorstraat 36,2022-10-26,03:00:00,17,5,12,FMN 02 Mercatorstraat
650,Mercatorstraat 36,2022-10-26,04:00:00,36,15,21,FMN 02 Mercatorstraat
650,Mercatorstraat 36,2022-10-26,05:00:00,74,42,32,FMN 02 Mercatorstraat
650,Mercatorstraat 36,2022-10-26,06:00:00,123,88,35,FMN 02 Mercatorstraat
650,Mercatorstraat 36,2022-10-26,07:00:00,455,290,165,FMN 02 Mercatorstraat
650,Mercatorstraat 36,2022-10-26,08:00:00,990,677,313,FMN 02 Mercatorstraat
650,Mercatorstraat 36,2022-10-26,09:00:00,452,311,141,FMN 02 Mercatorstraat
650,Mercatorstraat 36,2022-10-26,10:00:00,308,192,116,FMN 02 Mercatorstraat
650,Mercatorstraat 36,2022-10-26,11:00:00,320,172,148,FMN 02 Mercatorstraat
650,Mercatorstraat 36,2022-10-26,12:00:00,575,240,335,FMN 02 Mercatorstraat
650,Mercatorstraat 36,2022-10-26,13:00:00,528,263,265,FMN 02 Mercatorstraat
650,Mercatorstraat 36,2022-10-26,14:00:00,426,226,200,FMN 02 Mercatorstraat
650,Mercatorstraat 36,2022-10-26,15:00:00,457,190,267,FMN 02 Mercatorstraat
650,Mercatorstraat 36,2022-10-26,16:00:00,644,248,396,FMN 02 Mercatorstraat
650,Mercatorstraat 36,2022-10-26,17:00:00,821,264,557,FMN 02 Mercatorstraat
650,Mercatorstraat 36,2022-10-26,18:00:00,672,252,420,FMN 02 Mercatorstraat
650,Mercatorstraat 36,2022-10-26,19:00:00,396,187,209,FMN 02 Mercatorstraat
650,Mercatorstraat 36,2022-10-26,20:00:00,247,111,136,FMN 02 Mercatorstraat
650,Mercatorstraat 36,2022-10-26,21:00:00,223,85,138,FMN 02 Mercatorstraat
650,Mercatorstraat 36,2022-10-26,22:00:00,267,120,147,FMN 02 Mercatorstraat
650,Mercatorstraat 36,2022-10-26,23:00:00,150,56,94,FMN 02 Mercatorstraat
650,Mercatorstraat 36,2022-10-27,00:00:00,77,27,50,FMN 02 Mercatorstraat
650,Mercatorstraat 36,2022-10-27,01:00:00,58,20,38,FMN 02 Mercatorstraat
650,Mercatorstraat 36,2022-10-27,02:00:00,24,8,16,FMN 02 Mercatorstraat
650,Mercatorstraat 36,2022-10-27,03:00:00,23,8,15,FMN 02 Mercatorstraat
650,Mercatorstraat 36,2022-10-27,04:00:00,31,17,14,FMN 02 Mercatorstraat
650,Mercatorstraat 36,2022-10-27,05:00:00,70,43,27,FMN 02 Mercatorstraat
650,Mercatorstraat 36,2022-10-27,06:00:00,131,94,37,FMN 02 Mercatorstraat
650,Mercatorstraat 36,2022-10-27,07:00:00,471,295,176,FMN 02 Mercatorstraat
650,Mercatorstraat 36,2022-10-27,08:00:00,1102,796,306,FMN 02 Mercatorstraat
650,Mercatorstraat 36,2022-10-27,09:00:00,498,357,141,FMN 02 Mercatorstraat
650,Mercatorstraat 36,2022-10-27,10:00:00,291,206,85,FMN 02 Mercatorstraat
650,Mercatorstraat 36,2022-10-27,11:00:00,318,175,143,FMN 02 Mercatorstraat
650,Mercatorstraat 36,2022-10-27,12:00:00,468,248,220,FMN 02 Mercatorstraat
650,Mercatorstraat 36,2022-10-27,13:00:00,420,213,207,FMN 02 Mercatorstraat
650,Mercatorstraat 36,2022-10-27,14:00:00,374,173,201,FMN 02 Mercatorstraat
650,Mercatorstraat 36,2022-10-27,15:00:00,594,216,378,FMN 02 Mercatorstraat
650,Mercatorstraat 36,2022-10-27,16:00:00,838,284,554,FMN 02 Mercatorstraat
650,Mercatorstraat 36,2022-10-27,17:00:00,868,290,578,FMN 02 Mercatorstraat
650,Mercatorstraat 36,2022-10-27,18:00:00,669,256,413,FMN 02 Mercatorstraat
650,Mercatorstraat 36,2022-10-27,19:00:00,448,214,234,FMN 02 Mercatorstraat
650,Mercatorstraat 36,2022-10-27,20:00:00,299,129,170,FMN 02 Mercatorstraat
650,Mercatorstraat 36,2022-10-27,21:00:00,256,102,154,FMN 02 Mercatorstraat
650,Mercatorstraat 36,2022-10-27,22:00:00,281,99,182,FMN 02 Mercatorstraat
650,Mercatorstraat 36,2022-10-27,23:00:00,181,66,115,FMN 02 Mercatorstraat
650,Mercatorstraat 36,2022-10-28,00:00:00,141,68,73,FMN 02 Mercatorstraat
650,Mercatorstraat 36,2022-10-28,01:00:00,68,28,40,FMN 02 Mercatorstraat
650,Mercatorstraat 36,2022-10-28,02:00:00,76,13,63,FMN 02 Mercatorstraat
650,Mercatorstraat 36,2022-10-28,03:00:00,54,7,47,FMN 02 Mercatorstraat
650,Mercatorstraat 36,2022-10-28,04:00:00,80,21,59,FMN 02 Mercatorstraat
650,Mercatorstraat 36,2022-10-28,05:00:00,66,34,32,FMN 02 Mercatorstraat
650,Mercatorstraat 36,2022-10-28,06:00:00,126,85,41,FMN 02 Mercatorstraat
650,Mercatorstraat 36,2022-10-28,07:00:00,423,256,167,FMN 02 Mercatorstraat
650,Mercatorstraat 36,2022-10-28,08:00:00,912,651,261,FMN 02 Mercatorstraat
650,Mercatorstraat 36,2022-10-28,09:00:00,463,345,118,FMN 02 Mercatorstraat
650,Mercatorstraat 36,2022-10-28,10:00:00,328,221,107,FMN 02 Mercatorstraat
650,Mercatorstraat 36,2022-10-28,11:00:00,370,215,155,FMN 02 Mercatorstraat
650,Mercatorstraat 36,2022-10-28,12:00:00,517,263,254,FMN 02 Mercatorstraat
650,Mercatorstraat 36,2022-10-28,13:00:00,462,247,215,FMN 02 Mercatorstraat
650,Mercatorstraat 36,2022-10-28,14:00:00,501,215,286,FMN 02 Mercatorstraat
650,Mercatorstraat 36,2022-10-28,15:00:00,611,182,429,FMN 02 Mercatorstraat
650,Mercatorstraat 36,2022-10-28,16:00:00,726,256,470,FMN 02 Mercatorstraat
650,Mercatorstraat 36,2022-10-28,17:00:00,702,263,439,FMN 02 Mercatorstraat
650,Mercatorstraat 36,2022-10-28,18:00:00,620,259,361,FMN 02 Mercatorstraat
650,Mercatorstraat 36,2022-10-28,19:00:00,450,235,215,FMN 02 Mercatorstraat
650,Mercatorstraat 36,2022-10-28,20:00:00,319,178,141,FMN 02 Mercatorstraat
650,Mercatorstraat 36,2022-10-28,21:00:00,254,120,134,FMN 02 Mercatorstraat
650,Mercatorstraat 36,2022-10-28,22:00:00,269,105,164,FMN 02 Mercatorstraat
650,Mercatorstraat 36,2022-10-28,23:00:00,206,79,127,FMN 02 Mercatorstraat
650,Mercatorstraat 36,2022-10-29,00:00:00,181,78,103,FMN 02 Mercatorstraat
650,Mercatorstraat 36,2022-10-29,01:00:00,148,61,87,FMN 02 Mercatorstraat
650,Mercatorstraat 36,2022-10-29,02:00:00,132,61,71,FMN 02 Mercatorstraat
650,Mercatorstraat 36,2022-10-29,03:00:00,82,18,64,FMN 02 Mercatorstraat
650,Mercatorstraat 36,2022-10-29,04:00:00,64,12,52,FMN 02 Mercatorstraat
650,Mercatorstraat 36,2022-10-29,05:00:00,59,19,40,FMN 02 Mercatorstraat
650,Mercatorstraat 36,2022-10-29,06:00:00,47,16,31,FMN 02 Mercatorstraat
650,Mercatorstraat 36,2022-10-29,07:00:00,63,25,38,FMN 02 Mercatorstraat
650,Mercatorstraat 36,2022-10-29,08:00:00,105,59,46,FMN 02 Mercatorstraat
650,Mercatorstraat 36,2022-10-29,09:00:00,203,139,64,FMN 02 Mercatorstraat
650,Mercatorstraat 36,2022-10-29,10:00:00,307,214,93,FMN 02 Mercatorstraat
650,Mercatorstraat 36,2022-10-29,11:00:00,335,219,116,FMN 02 Mercatorstraat
650,Mercatorstraat 36,2022-10-29,12:00:00,369,232,137,FMN 02 Mercatorstraat
650,Mercatorstraat 36,2022-10-29,13:00:00,393,241,152,FMN 02 Mercatorstraat
650,Mercatorstraat 36,2022-10-29,14:00:00,495,302,193,FMN 02 Mercatorstraat
650,Mercatorstraat 36,2022-10-29,15:00:00,456,272,184,FMN 02 Mercatorstraat
650,Mercatorstraat 36,2022-10-29,16:00:00,453,199,254,FMN 02 Mercatorstraat
650,Mercatorstraat 36,2022-10-29,17:00:00,475,191,284,FMN 02 Mercatorstraat
650,Mercatorstraat 36,2022-10-29,18:00:00,351,157,194,FMN 02 Mercatorstraat
650,Mercatorstraat 36,2022-10-29,19:00:00,374,185,189,FMN 02 Mercatorstraat
650,Mercatorstraat 36,2022-10-29,20:00:00,235,119,116,FMN 02 Mercatorstraat
650,Mercatorstraat 36,2022-10-29,21:00:00,243,120,123,FMN 02 Mercatorstraat
650,Mercatorstraat 36,2022-10-29,22:00:00,255,94,161,FMN 02 Mercatorstraat
650,Mercatorstraat 36,2022-10-29,23:00:00,206,74,132,FMN 02 Mercatorstraat
650,Mercatorstraat 36,2022-10-30,00:00:00,178,59,119,FMN 02 Mercatorstraat
650,Mercatorstraat 36,2022-10-30,01:00:00,114,47,67,FMN 02 Mercatorstraat
650,Mercatorstraat 36,2022-10-30,02:00:00,191,73,118,FMN 02 Mercatorstraat
650,Mercatorstraat 36,2022-10-30,03:00:00,72,34,38,FMN 02 Mercatorstraat
650,Mercatorstraat 36,2022-10-30,04:00:00,38,9,29,FMN 02 Mercatorstraat
650,Mercatorstraat 36,2022-10-30,05:00:00,31,13,18,FMN 02 Mercatorstraat
650,Mercatorstraat 36,2022-10-30,06:00:00,44,23,21,FMN 02 Mercatorstraat
650,Mercatorstraat 36,2022-10-30,07:00:00,73,35,38,FMN 02 Mercatorstraat
650,Mercatorstraat 36,2022-10-30,08:00:00,147,59,88,FMN 02 Mercatorstraat
650,Mercatorstraat 36,2022-10-30,09:00:00,242,147,95,FMN 02 Mercatorstraat
650,Mercatorstraat 36,2022-10-30,10:00:00,260,164,96,FMN 02 Mercatorstraat
650,Mercatorstraat 36,2022-10-30,11:00:00,316,200,116,FMN 02 Mercatorstraat
650,Mercatorstraat 36,2022-10-30,12:00:00,398,231,167,FMN 02 Mercatorstraat
650,Mercatorstraat 36,2022-10-30,13:00:00,404,223,181,FMN 02 Mercatorstraat
650,Mercatorstraat 36,2022-10-30,14:00:00,468,254,214,FMN 02 Mercatorstraat
650,Mercatorstraat 36,2022-10-30,15:00:00,370,175,195,FMN 02 Mercatorstraat
650,Mercatorstraat 36,2022-10-30,16:00:00,382,140,242,FMN 02 Mercatorstraat
650,Mercatorstraat 36,2022-10-30,17:00:00,327,126,201,FMN 02 Mercatorstraat
650,Mercatorstraat 36,2022-10-30,18:00:00,268,116,152,FMN 02 Mercatorstraat
650,Mercatorstraat 36,2022-10-30,19:00:00,242,131,111,FMN 02 Mercatorstraat
650,Mercatorstraat 36,2022-10-30,20:00:00,156,75,81,FMN 02 Mercatorstraat
650,Mercatorstraat 36,2022-10-30,21:00:00,177,76,101,FMN 02 Mercatorstraat
650,Mercatorstraat 36,2022-10-30,22:00:00,135,47,88,FMN 02 Mercatorstraat
650,Mercatorstraat 36,2022-10-30,23:00:00,122,42,80,FMN 02 Mercatorstraat
650,Mercatorstraat 36,2022-10-31,00:00:00,58,23,35,FMN 02 Mercatorstraat
650,Mercatorstraat 36,2022-10-31,01:00:00,35,10,25,FMN 02 Mercatorstraat
650,Mercatorstraat 36,2022-10-31,02:00:00,32,8,24,FMN 02 Mercatorstraat
650,Mercatorstraat 36,2022-10-31,03:00:00,28,15,13,FMN 02 Mercatorstraat
650,Mercatorstraat 36,2022-10-31,04:00:00,30,17,13,FMN 02 Mercatorstraat
650,Mercatorstraat 36,2022-10-31,05:00:00,50,32,18,FMN 02 Mercatorstraat
650,Mercatorstraat 36,2022-10-31,06:00:00,101,57,44,FMN 02 Mercatorstraat
650,Mercatorstraat 36,2022-10-31,07:00:00,237,111,126,FMN 02 Mercatorstraat
650,Mercatorstraat 36,2022-10-31,08:00:00,351,215,136,FMN 02 Mercatorstraat
650,Mercatorstraat 36,2022-10-31,09:00:00,203,142,61,FMN 02 Mercatorstraat
650,Mercatorstraat 36,2022-10-31,10:00:00,229,154,75,FMN 02 Mercatorstraat
650,Mercatorstraat 36,2022-10-31,11:00:00,240,148,92,FMN 02 Mercatorstraat
650,Mercatorstraat 36,2022-10-31,12:00:00,249,132,117,FMN 02 Mercatorstraat
650,Mercatorstraat 36,2022-10-31,13:00:00,316,163,153,FMN 02 Mercatorstraat
650,Mercatorstraat 36,2022-10-31,14:00:00,359,208,151,FMN 02 Mercatorstraat
650,Mercatorstraat 36,2022-10-31,15:00:00,370,181,189,FMN 02 Mercatorstraat
650,Mercatorstraat 36,2022-10-31,16:00:00,459,186,273,FMN 02 Mercatorstraat
650,Mercatorstraat 36,2022-10-31,17:00:00,449,196,253,FMN 02 Mercatorstraat
650,Mercatorstraat 36,2022-10-31,18:00:00,363,147,216,FMN 02 Mercatorstraat
650,Mercatorstraat 36,2022-10-31,19:00:00,310,166,144,FMN 02 Mercatorstraat
650,Mercatorstraat 36,2022-10-31,20:00:00,255,137,118,FMN 02 Mercatorstraat
650,Mercatorstraat 36,2022-10-31,21:00:00,226,138,88,FMN 02 Mercatorstraat
650,Mercatorstraat 36,2022-10-31,22:00:00,202,81,121,FMN 02 Mercatorstraat
650,Mercatorstraat 36,2022-10-31,23:00:00,160,64,96,FMN 02 Mercatorstraat
650,Mercatorstraat 36,2022-11-01,00:00:00,129,52,77,FMN 02 Mercatorstraat
650,Mercatorstraat 36,2022-11-01,01:00:00,70,21,49,FMN 02 Mercatorstraat
650,Mercatorstraat 36,2022-11-01,02:00:00,81,24,57,FMN 02 Mercatorstraat
650,Mercatorstraat 36,2022-11-01,03:00:00,48,15,33,FMN 02 Mercatorstraat
650,Mercatorstraat 36,2022-11-01,04:00:00,60,9,51,FMN 02 Mercatorstraat
650,Mercatorstraat 36,2022-11-01,05:00:00,70,14,56,FMN 02 Mercatorstraat
650,Mercatorstraat 36,2022-11-01,06:00:00,53,25,28,FMN 02 Mercatorstraat
650,Mercatorstraat 36,2022-11-01,07:00:00,87,34,53,FMN 02 Mercatorstraat
650,Mercatorstraat 36,2022-11-01,08:00:00,125,63,62,FMN 02 Mercatorstraat
650,Mercatorstraat 36,2022-11-01,09:00:00,225,135,90,FMN 02 Mercatorstraat
650,Mercatorstraat 36,2022-11-01,10:00:00,208,118,90,FMN 02 Mercatorstraat
650,Mercatorstraat 36,2022-11-01,11:00:00,272,159,113,FMN 02 Mercatorstraat
650,Mercatorstraat 36,2022-11-01,12:00:00,292,147,145,FMN 02 Mercatorstraat
650,Mercatorstraat 36,2022-11-01,13:00:00,332,182,150,FMN 02 Mercatorstraat
650,Mercatorstraat 36,2022-11-01,14:00:00,347,206,141,FMN 02 Mercatorstraat
650,Mercatorstraat 36,2022-11-01,15:00:00,294,119,175,FMN 02 Mercatorstraat
650,Mercatorstraat 36,2022-11-01,16:00:00,344,129,215,FMN 02 Mercatorstraat
650,Mercatorstraat 36,2022-11-01,17:00:00,298,135,163,FMN 02 Mercatorstraat
650,Mercatorstraat 36,2022-11-01,18:00:00,275,120,155,FMN 02 Mercatorstraat
650,Mercatorstraat 36,2022-11-01,19:00:00,233,114,119,FMN 02 Mercatorstraat
650,Mercatorstraat 36,2022-11-01,20:00:00,173,84,89,FMN 02 Mercatorstraat
650,Mercatorstraat 36,2022-11-01,21:00:00,122,56,66,FMN 02 Mercatorstraat
650,Mercatorstraat 36,2022-11-01,22:00:00,134,45,89,FMN 02 Mercatorstraat
650,Mercatorstraat 36,2022-11-01,23:00:00,72,34,38,FMN 02 Mercatorstraat
650,Mercatorstraat 36,2022-11-02,00:00:00,44,18,26,FMN 02 Mercatorstraat
650,Mercatorstraat 36,2022-11-02,01:00:00,32,13,19,FMN 02 Mercatorstraat
650,Mercatorstraat 36,2022-11-02,02:00:00,14,6,8,FMN 02 Mercatorstraat
650,Mercatorstraat 36,2022-11-02,03:00:00,7,3,4,FMN 02 Mercatorstraat
650,Mercatorstraat 36,2022-11-02,04:00:00,35,25,10,FMN 02 Mercatorstraat
650,Mercatorstraat 36,2022-11-02,05:00:00,46,25,21,FMN 02 Mercatorstraat
650,Mercatorstraat 36,2022-11-02,06:00:00,110,61,49,FMN 02 Mercatorstraat
650,Mercatorstraat 36,2022-11-02,07:00:00,298,164,134,FMN 02 Mercatorstraat
650,Mercatorstraat 36,2022-11-02,08:00:00,517,331,186,FMN 02 Mercatorstraat
650,Mercatorstraat 36,2022-11-02,09:00:00,340,252,88,FMN 02 Mercatorstraat
650,Mercatorstraat 36,2022-11-02,10:00:00,268,172,96,FMN 02 Mercatorstraat
650,Mercatorstraat 36,2022-11-02,11:00:00,241,135,106,FMN 02 Mercatorstraat
650,Mercatorstraat 36,2022-11-02,12:00:00,332,191,141,FMN 02 Mercatorstraat
650,Mercatorstraat 36,2022-11-02,13:00:00,385,176,209,FMN 02 Mercatorstraat
650,Mercatorstraat 36,2022-11-02,14:00:00,396,213,183,FMN 02 Mercatorstraat
650,Mercatorstraat 36,2022-11-02,15:00:00,366,142,224,FMN 02 Mercatorstraat
650,Mercatorstraat 36,2022-11-02,16:00:00,566,245,321,FMN 02 Mercatorstraat
650,Mercatorstraat 36,2022-11-02,17:00:00,592,204,388,FMN 02 Mercatorstraat
650,Mercatorstraat 36,2022-11-02,18:00:00,499,192,307,FMN 02 Mercatorstraat
650,Mercatorstraat 36,2022-11-02,19:00:00,335,169,166,FMN 02 Mercatorstraat
650,Mercatorstraat 36,2022-11-02,20:00:00,241,92,149,FMN 02 Mercatorstraat
650,Mercatorstraat 36,2022-11-02,21:00:00,184,79,105,FMN 02 Mercatorstraat
650,Mercatorstraat 36,2022-11-02,22:00:00,205,74,131,FMN 02 Mercatorstraat
650,Mercatorstraat 36,2022-11-02,23:00:00,120,49,71,FMN 02 Mercatorstraat
650,Mercatorstraat 36,2022-11-03,00:00:00,72,30,42,FMN 02 Mercatorstraat
650,Mercatorstraat 36,2022-11-03,01:00:00,31,11,20,FMN 02 Mercatorstraat
650,Mercatorstraat 36,2022-11-03,02:00:00,31,9,22,FMN 02 Mercatorstraat
650,Mercatorstraat 36,2022-11-03,03:00:00,14,7,7,FMN 02 Mercatorstraat
650,Mercatorstraat 36,2022-11-03,04:00:00,28,13,15,FMN 02 Mercatorstraat
650,Mercatorstraat 36,2022-11-03,05:00:00,51,29,22,FMN 02 Mercatorstraat
650,Mercatorstraat 36,2022-11-03,06:00:00,104,57,47,FMN 02 Mercatorstraat
650,Mercatorstraat 36,2022-11-03,07:00:00,333,194,139,FMN 02 Mercatorstraat
650,Mercatorstraat 36,2022-11-03,08:00:00,645,423,222,FMN 02 Mercatorstraat
650,Mercatorstraat 36,2022-11-03,09:00:00,359,276,83,FMN 02 Mercatorstraat
650,Mercatorstraat 36,2022-11-03,10:00:00,262,198,64,FMN 02 Mercatorstraat
650,Mercatorstraat 36,2022-11-03,11:00:00,229,118,111,FMN 02 Mercatorstraat
650,Mercatorstraat 36,2022-11-03,12:00:00,331,169,162,FMN 02 Mercatorstraat
650,Mercatorstraat 36,2022-11-03,13:00:00,345,177,168,FMN 02 Mercatorstraat
650,Mercatorstraat 36,2022-11-03,14:00:00,336,176,160,FMN 02 Mercatorstraat
650,Mercatorstraat 36,2022-11-03,15:00:00,325,127,198,FMN 02 Mercatorstraat
650,Mercatorstraat 36,2022-11-03,16:00:00,448,136,312,FMN 02 Mercatorstraat
650,Mercatorstraat 36,2022-11-03,17:00:00,541,186,355,FMN 02 Mercatorstraat
650,Mercatorstraat 36,2022-11-03,18:00:00,406,154,252,FMN 02 Mercatorstraat
650,Mercatorstraat 36,2022-11-03,19:00:00,276,124,152,FMN 02 Mercatorstraat
650,Mercatorstraat 36,2022-11-03,20:00:00,181,87,94,FMN 02 Mercatorstraat
650,Mercatorstraat 36,2022-11-03,21:00:00,138,63,75,FMN 02 Mercatorstraat
650,Mercatorstraat 36,2022-11-03,22:00:00,173,70,103,FMN 02 Mercatorstraat
650,Mercatorstraat 36,2022-11-03,23:00:00,128,47,81,FMN 02 Mercatorstraat
650,Mercatorstraat 36,2022-11-04,00:00:00,62,23,39,FMN 02 Mercatorstraat
650,Mercatorstraat 36,2022-11-04,01:00:00,32,13,19,FMN 02 Mercatorstraat
650,Mercatorstraat 36,2022-11-04,02:00:00,28,6,22,FMN 02 Mercatorstraat
650,Mercatorstraat 36,2022-11-04,03:00:00,22,11,11,FMN 02 Mercatorstraat
650,Mercatorstraat 36,2022-11-04,04:00:00,32,15,17,FMN 02 Mercatorstraat
650,Mercatorstraat 36,2022-11-04,05:00:00,47,22,25,FMN 02 Mercatorstraat
650,Mercatorstraat 36,2022-11-04,06:00:00,100,55,45,FMN 02 Mercatorstraat
650,Mercatorstraat 36,2022-11-04,07:00:00,266,133,133,FMN 02 Mercatorstraat
650,Mercatorstraat 36,2022-11-04,08:00:00,476,307,169,FMN 02 Mercatorstraat
650,Mercatorstraat 36,2022-11-04,09:00:00,324,227,97,FMN 02 Mercatorstraat
650,Mercatorstraat 36,2022-11-04,10:00:00,252,179,73,FMN 02 Mercatorstraat
650,Mercatorstraat 36,2022-11-04,11:00:00,217,120,97,FMN 02 Mercatorstraat
650,Mercatorstraat 36,2022-11-04,12:00:00,313,162,151,FMN 02 Mercatorstraat
650,Mercatorstraat 36,2022-11-04,13:00:00,332,179,153,FMN 02 Mercatorstraat
650,Mercatorstraat 36,2022-11-04,14:00:00,309,180,129,FMN 02 Mercatorstraat
650,Mercatorstraat 36,2022-11-04,15:00:00,336,141,195,FMN 02 Mercatorstraat
650,Mercatorstraat 36,2022-11-04,16:00:00,467,166,301,FMN 02 Mercatorstraat
650,Mercatorstraat 36,2022-11-04,17:00:00,503,182,321,FMN 02 Mercatorstraat
650,Mercatorstraat 36,2022-11-04,18:00:00,425,153,272,FMN 02 Mercatorstraat
650,Mercatorstraat 36,2022-11-04,19:00:00,385,230,155,FMN 02 Mercatorstraat
650,Mercatorstraat 36,2022-11-04,20:00:00,222,113,109,FMN 02 Mercatorstraat
650,Mercatorstraat 36,2022-11-04,21:00:00,234,92,142,FMN 02 Mercatorstraat
650,Mercatorstraat 36,2022-11-04,22:00:00,188,80,108,FMN 02 Mercatorstraat
650,Mercatorstraat 36,2022-11-04,23:00:00,198,81,117,FMN 02 Mercatorstraat
650,Mercatorstraat 36,2022-11-05,00:00:00,143,63,80,FMN 02 Mercatorstraat
650,Mercatorstraat 36,2022-11-05,01:00:00,99,39,60,FMN 02 Mercatorstraat
650,Mercatorstraat 36,2022-11-05,02:00:00,80,22,58,FMN 02 Mercatorstraat
650,Mercatorstraat 36,2022-11-05,03:00:00,88,15,73,FMN 02 Mercatorstraat
650,Mercatorstraat 36,2022-11-05,04:00:00,38,8,30,FMN 02 Mercatorstraat
650,Mercatorstraat 36,2022-11-05,05:00:00,52,26,26,FMN 02 Mercatorstraat
650,Mercatorstraat 36,2022-11-05,06:00:00,34,17,17,FMN 02 Mercatorstraat
650,Mercatorstraat 36,2022-11-05,07:00:00,43,18,25,FMN 02 Mercatorstraat
650,Mercatorstraat 36,2022-11-05,08:00:00,71,48,23,FMN 02 Mercatorstraat
650,Mercatorstraat 36,2022-11-05,09:00:00,187,149,38,FMN 02 Mercatorstraat
650,Mercatorstraat 36,2022-11-05,10:00:00,244,175,69,FMN 02 Mercatorstraat
650,Mercatorstraat 36,2022-11-05,11:00:00,319,186,133,FMN 02 Mercatorstraat
650,Mercatorstraat 36,2022-11-05,12:00:00,311,195,116,FMN 02 Mercatorstraat
650,Mercatorstraat 36,2022-11-05,13:00:00,323,189,134,FMN 02 Mercatorstraat
650,Mercatorstraat 36,2022-11-05,14:00:00,344,198,146,FMN 02 Mercatorstraat
650,Mercatorstraat 36,2022-11-05,15:00:00,311,155,156,FMN 02 Mercatorstraat
650,Mercatorstraat 36,2022-11-05,16:00:00,356,149,207,FMN 02 Mercatorstraat
650,Mercatorstraat 36,2022-11-05,17:00:00,355,125,230,FMN 02 Mercatorstraat
650,Mercatorstraat 36,2022-11-05,18:00:00,278,138,140,FMN 02 Mercatorstraat
650,Mercatorstraat 36,2022-11-05,19:00:00,322,189,133,FMN 02 Mercatorstraat
650,Mercatorstraat 36,2022-11-05,20:00:00,233,107,126,FMN 02 Mercatorstraat
650,Mercatorstraat 36,2022-11-05,21:00:00,163,72,91,FMN 02 Mercatorstraat
650,Mercatorstraat 36,2022-11-05,22:00:00,191,80,111,FMN 02 Mercatorstraat
650,Mercatorstraat 36,2022-11-05,23:00:00,155,63,92,FMN 02 Mercatorstraat
650,Mercatorstraat 36,2022-11-06,00:00:00,126,40,86,FMN 02 Mercatorstraat
650,Mercatorstraat 36,2022-11-06,01:00:00,107,67,40,FMN 02 Mercatorstraat
650,Mercatorstraat 36,2022-11-06,02:00:00,88,38,50,FMN 02 Mercatorstraat
650,Mercatorstraat 36,2022-11-06,03:00:00,59,24,35,FMN 02 Mercatorstraat
650,Mercatorstraat 36,2022-11-06,04:00:00,80,13,67,FMN 02 Mercatorstraat
650,Mercatorstraat 36,2022-11-06,05:00:00,49,16,33,FMN 02 Mercatorstraat
650,Mercatorstraat 36,2022-11-06,06:00:00,37,14,23,FMN 02 Mercatorstraat
650,Mercatorstraat 36,2022-11-06,07:00:00,65,26,39,FMN 02 Mercatorstraat
650,Mercatorstraat 36,2022-11-06,08:00:00,118,47,71,FMN 02 Mercatorstraat
650,Mercatorstraat 36,2022-11-06,09:00:00,229,122,107,FMN 02 Mercatorstraat
650,Mercatorstraat 36,2022-11-06,10:00:00,199,138,61,FMN 02 Mercatorstraat
650,Mercatorstraat 36,2022-11-06,11:00:00,209,109,100,FMN 02 Mercatorstraat
650,Mercatorstraat 36,2022-11-06,12:00:00,307,178,129,FMN 02 Mercatorstraat
650,Mercatorstraat 36,2022-11-06,13:00:00,235,114,121,FMN 02 Mercatorstraat
650,Mercatorstraat 36,2022-11-06,14:00:00,180,81,99,FMN 02 Mercatorstraat
650,Mercatorstraat 36,2022-11-06,15:00:00,156,71,85,FMN 02 Mercatorstraat
650,Mercatorstraat 36,2022-11-06,16:00:00,150,66,84,FMN 02 Mercatorstraat
650,Mercatorstraat 36,2022-11-06,17:00:00,173,70,103,FMN 02 Mercatorstraat
650,Mercatorstraat 36,2022-11-06,18:00:00,187,76,111,FMN 02 Mercatorstraat
650,Mercatorstraat 36,2022-11-06,19:00:00,140,65,75,FMN 02 Mercatorstraat
650,Mercatorstraat 36,2022-11-06,20:00:00,136,54,82,FMN 02 Mercatorstraat
650,Mercatorstraat 36,2022-11-06,21:00:00,110,51,59,FMN 02 Mercatorstraat
650,Mercatorstraat 36,2022-11-06,22:00:00,84,33,51,FMN 02 Mercatorstraat
650,Mercatorstraat 36,2022-11-06,23:00:00,44,23,21,FMN 02 Mercatorstraat
650,Mercatorstraat 36,2022-11-07,00:00:00,30,5,25,FMN 02 Mercatorstraat
650,Mercatorstraat 36,2022-11-07,01:00:00,16,4,12,FMN 02 Mercatorstraat
650,Mercatorstraat 36,2022-11-07,02:00:00,9,4,5,FMN 02 Mercatorstraat
650,Mercatorstraat 36,2022-11-07,03:00:00,8,4,4,FMN 02 Mercatorstraat
650,Mercatorstraat 36,2022-11-07,04:00:00,23,15,8,FMN 02 Mercatorstraat
650,Mercatorstraat 36,2022-11-07,05:00:00,52,30,22,FMN 02 Mercatorstraat
650,Mercatorstraat 36,2022-11-07,06:00:00,119,73,46,FMN 02 Mercatorstraat
650,Mercatorstraat 36,2022-11-07,07:00:00,391,265,126,FMN 02 Mercatorstraat
650,Mercatorstraat 36,2022-11-07,08:00:00,1013,735,278,FMN 02 Mercatorstraat
650,Mercatorstraat 36,2022-11-07,09:00:00,388,293,95,FMN 02 Mercatorstraat
650,Mercatorstraat 36,2022-11-07,10:00:00,252,170,82,FMN 02 Mercatorstraat
650,Mercatorstraat 36,2022-11-07,11:00:00,203,122,81,FMN 02 Mercatorstraat
650,Mercatorstraat 36,2022-11-07,12:00:00,365,190,175,FMN 02 Mercatorstraat
650,Mercatorstraat 36,2022-11-07,13:00:00,335,152,183,FMN 02 Mercatorstraat
650,Mercatorstraat 36,2022-11-07,14:00:00,289,139,150,FMN 02 Mercatorstraat
650,Mercatorstraat 36,2022-11-07,15:00:00,447,145,302,FMN 02 Mercatorstraat
650,Mercatorstraat 36,2022-11-07,16:00:00,710,214,496,FMN 02 Mercatorstraat
650,Mercatorstraat 36,2022-11-07,17:00:00,764,246,518,FMN 02 Mercatorstraat
650,Mercatorstraat 36,2022-11-07,18:00:00,479,193,286,FMN 02 Mercatorstraat
650,Mercatorstraat 36,2022-11-07,19:00:00,323,153,170,FMN 02 Mercatorstraat
650,Mercatorstraat 36,2022-11-07,20:00:00,203,87,116,FMN 02 Mercatorstraat
650,Mercatorstraat 36,2022-11-07,21:00:00,234,82,152,FMN 02 Mercatorstraat
650,Mercatorstraat 36,2022-11-07,22:00:00,175,62,113,FMN 02 Mercatorstraat
650,Mercatorstraat 36,2022-11-07,23:00:00,77,36,41,FMN 02 Mercatorstraat
650,Mercatorstraat 36,2022-11-08,00:00:00,39,14,25,FMN 02 Mercatorstraat
650,Mercatorstraat 36,2022-11-08,01:00:00,18,9,9,FMN 02 Mercatorstraat
650,Mercatorstraat 36,2022-11-08,02:00:00,16,4,12,FMN 02 Mercatorstraat
650,Mercatorstraat 36,2022-11-08,03:00:00,19,6,13,FMN 02 Mercatorstraat
650,Mercatorstraat 36,2022-11-08,04:00:00,33,17,16,FMN 02 Mercatorstraat
650,Mercatorstraat 36,2022-11-08,05:00:00,47,31,16,FMN 02 Mercatorstraat
650,Mercatorstraat 36,2022-11-08,06:00:00,142,87,55,FMN 02 Mercatorstraat
650,Mercatorstraat 36,2022-11-08,07:00:00,513,313,200,FMN 02 Mercatorstraat
650,Mercatorstraat 36,2022-11-08,08:00:00,1144,798,346,FMN 02 Mercatorstraat
650,Mercatorstraat 36,2022-11-08,09:00:00,513,402,111,FMN 02 Mercatorstraat
650,Mercatorstraat 36,2022-11-08,10:00:00,313,218,95,FMN 02 Mercatorstraat
650,Mercatorstraat 36,2022-11-08,11:00:00,276,150,126,FMN 02 Mercatorstraat
650,Mercatorstraat 36,2022-11-08,12:00:00,381,198,183,FMN 02 Mercatorstraat
650,Mercatorstraat 36,2022-11-08,13:00:00,433,186,247,FMN 02 Mercatorstraat
650,Mercatorstraat 36,2022-11-08,14:00:00,326,162,164,FMN 02 Mercatorstraat
650,Mercatorstraat 36,2022-11-08,15:00:00,560,177,383,FMN 02 Mercatorstraat
650,Mercatorstraat 36,2022-11-08,16:00:00,779,261,518,FMN 02 Mercatorstraat
650,Mercatorstraat 36,2022-11-08,17:00:00,940,316,624,FMN 02 Mercatorstraat
650,Mercatorstraat 36,2022-11-08,18:00:00,626,247,379,FMN 02 Mercatorstraat
650,Mercatorstraat 36,2022-11-08,19:00:00,388,171,217,FMN 02 Mercatorstraat
650,Mercatorstraat 36,2022-11-08,20:00:00,278,120,158,FMN 02 Mercatorstraat
650,Mercatorstraat 36,2022-11-08,21:00:00,294,137,157,FMN 02 Mercatorstraat
650,Mercatorstraat 36,2022-11-08,22:00:00,225,84,141,FMN 02 Mercatorstraat
650,Mercatorstraat 36,2022-11-08,23:00:00,112,38,74,FMN 02 Mercatorstraat
650,Mercatorstraat 36,2022-11-09,00:00:00,74,29,45,FMN 02 Mercatorstraat
650,Mercatorstraat 36,2022-11-09,01:00:00,37,14,23,FMN 02 Mercatorstraat
650,Mercatorstraat 36,2022-11-09,02:00:00,19,5,14,FMN 02 Mercatorstraat
650,Mercatorstraat 36,2022-11-09,03:00:00,15,5,10,FMN 02 Mercatorstraat
650,Mercatorstraat 36,2022-11-09,04:00:00,31,13,18,FMN 02 Mercatorstraat
650,Mercatorstraat 36,2022-11-09,05:00:00,55,33,22,FMN 02 Mercatorstraat
650,Mercatorstraat 36,2022-11-09,06:00:00,133,82,51,FMN 02 Mercatorstraat
650,Mercatorstraat 36,2022-11-09,07:00:00,548,363,185,FMN 02 Mercatorstraat
650,Mercatorstraat 36,2022-11-09,08:00:00,1073,768,305,FMN 02 Mercatorstraat
650,Mercatorstraat 36,2022-11-09,09:00:00,441,328,113,FMN 02 Mercatorstraat
650,Mercatorstraat 36,2022-11-09,10:00:00,357,216,141,FMN 02 Mercatorstraat
650,Mercatorstraat 36,2022-11-09,11:00:00,350,169,181,FMN 02 Mercatorstraat
650,Mercatorstraat 36,2022-11-09,12:00:00,623,229,394,FMN 02 Mercatorstraat
650,Mercatorstraat 36,2022-11-09,13:00:00,580,286,294,FMN 02 Mercatorstraat
650,Mercatorstraat 36,2022-11-09,14:00:00,388,204,184,FMN 02 Mercatorstraat
650,Mercatorstraat 36,2022-11-09,15:00:00,460,179,281,FMN 02 Mercatorstraat
650,Mercatorstraat 36,2022-11-09,16:00:00,667,244,423,FMN 02 Mercatorstraat
650,Mercatorstraat 36,2022-11-09,17:00:00,843,279,564,FMN 02 Mercatorstraat
650,Mercatorstraat 36,2022-11-09,18:00:00,714,272,442,FMN 02 Mercatorstraat
650,Mercatorstraat 36,2022-11-09,19:00:00,369,170,199,FMN 02 Mercatorstraat
650,Mercatorstraat 36,2022-11-09,20:00:00,239,104,135,FMN 02 Mercatorstraat
650,Mercatorstraat 36,2022-11-09,21:00:00,208,79,129,FMN 02 Mercatorstraat
650,Mercatorstraat 36,2022-11-09,22:00:00,228,96,132,FMN 02 Mercatorstraat
650,Mercatorstraat 36,2022-11-09,23:00:00,152,63,89,FMN 02 Mercatorstraat
650,Mercatorstraat 36,2022-11-10,00:00:00,72,22,50,FMN 02 Mercatorstraat
650,Mercatorstraat 36,2022-11-10,01:00:00,27,6,21,FMN 02 Mercatorstraat
650,Mercatorstraat 36,2022-11-10,02:00:00,22,5,17,FMN 02 Mercatorstraat
650,Mercatorstraat 36,2022-11-10,03:00:00,21,5,16,FMN 02 Mercatorstraat
650,Mercatorstraat 36,2022-11-10,04:00:00,32,20,12,FMN 02 Mercatorstraat
650,Mercatorstraat 36,2022-11-10,05:00:00,53,30,23,FMN 02 Mercatorstraat
650,Mercatorstraat 36,2022-11-10,06:00:00,129,78,51,FMN 02 Mercatorstraat
650,Mercatorstraat 36,2022-11-10,07:00:00,448,269,179,FMN 02 Mercatorstraat
650,Mercatorstraat 36,2022-11-10,08:00:00,1113,799,314,FMN 02 Mercatorstraat
650,Mercatorstraat 36,2022-11-10,09:00:00,480,366,114,FMN 02 Mercatorstraat
650,Mercatorstraat 36,2022-11-10,10:00:00,282,179,103,FMN 02 Mercatorstraat
650,Mercatorstraat 36,2022-11-10,11:00:00,284,174,110,FMN 02 Mercatorstraat
650,Mercatorstraat 36,2022-11-10,12:00:00,408,203,205,FMN 02 Mercatorstraat
650,Mercatorstraat 36,2022-11-10,13:00:00,389,189,200,FMN 02 Mercatorstraat
650,Mercatorstraat 36,2022-11-10,14:00:00,390,176,214,FMN 02 Mercatorstraat
650,Mercatorstraat 36,2022-11-10,15:00:00,587,198,389,FMN 02 Mercatorstraat
650,Mercatorstraat 36,2022-11-10,16:00:00,758,258,500,FMN 02 Mercatorstraat
650,Mercatorstraat 36,2022-11-10,17:00:00,868,292,576,FMN 02 Mercatorstraat
650,Mercatorstraat 36,2022-11-10,18:00:00,656,270,386,FMN 02 Mercatorstraat
650,Mercatorstraat 36,2022-11-10,19:00:00,435,208,227,FMN 02 Mercatorstraat
650,Mercatorstraat 36,2022-11-10,20:00:00,327,173,154,FMN 02 Mercatorstraat
650,Mercatorstraat 36,2022-11-10,21:00:00,271,117,154,FMN 02 Mercatorstraat
650,Mercatorstraat 36,2022-11-10,22:00:00,278,131,147,FMN 02 Mercatorstraat
650,Mercatorstraat 36,2022-11-10,23:00:00,220,103,117,FMN 02 Mercatorstraat
650,Mercatorstraat 36,2022-11-11,00:00:00,177,68,109,FMN 02 Mercatorstraat
650,Mercatorstraat 36,2022-11-11,01:00:00,153,59,94,FMN 02 Mercatorstraat
650,Mercatorstraat 36,2022-11-11,02:00:00,138,55,83,FMN 02 Mercatorstraat
650,Mercatorstraat 36,2022-11-11,03:00:00,106,40,66,FMN 02 Mercatorstraat
650,Mercatorstraat 36,2022-11-11,04:00:00,84,15,69,FMN 02 Mercatorstraat
650,Mercatorstraat 36,2022-11-11,05:00:00,83,29,54,FMN 02 Mercatorstraat
650,Mercatorstraat 36,2022-11-11,06:00:00,86,27,59,FMN 02 Mercatorstraat
650,Mercatorstraat 36,2022-11-11,07:00:00,117,44,73,FMN 02 Mercatorstraat
650,Mercatorstraat 36,2022-11-11,08:00:00,138,58,80,FMN 02 Mercatorstraat
650,Mercatorstraat 36,2022-11-11,09:00:00,185,113,72,FMN 02 Mercatorstraat
650,Mercatorstraat 36,2022-11-11,10:00:00,214,137,77,FMN 02 Mercatorstraat
650,Mercatorstraat 36,2022-11-11,11:00:00,290,174,116,FMN 02 Mercatorstraat
650,Mercatorstraat 36,2022-11-11,12:00:00,364,209,155,FMN 02 Mercatorstraat
650,Mercatorstraat 36,2022-11-11,13:00:00,352,213,139,FMN 02 Mercatorstraat
650,Mercatorstraat 36,2022-11-11,14:00:00,401,205,196,FMN 02 Mercatorstraat
650,Mercatorstraat 36,2022-11-11,15:00:00,380,188,192,FMN 02 Mercatorstraat
650,Mercatorstraat 36,2022-11-11,16:00:00,372,147,225,FMN 02 Mercatorstraat
650,Mercatorstraat 36,2022-11-11,17:00:00,339,159,180,FMN 02 Mercatorstraat
650,Mercatorstraat 36,2022-11-11,18:00:00,326,157,169,FMN 02 Mercatorstraat
650,Mercatorstraat 36,2022-11-11,19:00:00,302,168,134,FMN 02 Mercatorstraat
650,Mercatorstraat 36,2022-11-11,20:00:00,217,118,99,FMN 02 Mercatorstraat
650,Mercatorstraat 36,2022-11-11,21:00:00,201,107,94,FMN 02 Mercatorstraat
650,Mercatorstraat 36,2022-11-11,22:00:00,212,95,117,FMN 02 Mercatorstraat
650,Mercatorstraat 36,2022-11-11,23:00:00,152,70,82,FMN 02 Mercatorstraat
650,Mercatorstraat 36,2022-11-12,00:00:00,118,44,74,FMN 02 Mercatorstraat
650,Mercatorstraat 36,2022-11-12,01:00:00,112,40,72,FMN 02 Mercatorstraat
650,Mercatorstraat 36,2022-11-12,02:00:00,69,16,53,FMN 02 Mercatorstraat
650,Mercatorstraat 36,2022-11-12,03:00:00,61,9,52,FMN 02 Mercatorstraat
650,Mercatorstraat 36,2022-11-12,04:00:00,68,12,56,FMN 02 Mercatorstraat
650,Mercatorstraat 36,2022-11-12,05:00:00,87,18,69,FMN 02 Mercatorstraat
650,Mercatorstraat 36,2022-11-12,06:00:00,75,27,48,FMN 02 Mercatorstraat
650,Mercatorstraat 36,2022-11-12,07:00:00,69,24,45,FMN 02 Mercatorstraat
650,Mercatorstraat 36,2022-11-12,08:00:00,98,65,33,FMN 02 Mercatorstraat
650,Mercatorstraat 36,2022-11-12,09:00:00,206,165,41,FMN 02 Mercatorstraat
650,Mercatorstraat 36,2022-11-12,10:00:00,241,168,73,FMN 02 Mercatorstraat
650,Mercatorstraat 36,2022-11-12,11:00:00,320,207,113,FMN 02 Mercatorstraat
650,Mercatorstraat 36,2022-11-12,12:00:00,379,218,161,FMN 02 Mercatorstraat
650,Mercatorstraat 36,2022-11-12,13:00:00,522,329,193,FMN 02 Mercatorstraat
650,Mercatorstraat 36,2022-11-12,14:00:00,434,249,185,FMN 02 Mercatorstraat
650,Mercatorstraat 36,2022-11-12,15:00:00,420,192,228,FMN 02 Mercatorstraat
650,Mercatorstraat 36,2022-11-12,16:00:00,407,147,260,FMN 02 Mercatorstraat
650,Mercatorstraat 36,2022-11-12,17:00:00,429,169,260,FMN 02 Mercatorstraat
650,Mercatorstraat 36,2022-11-12,18:00:00,329,137,192,FMN 02 Mercatorstraat
650,Mercatorstraat 36,2022-11-12,19:00:00,340,203,137,FMN 02 Mercatorstraat
650,Mercatorstraat 36,2022-11-12,20:00:00,201,97,104,FMN 02 Mercatorstraat
650,Mercatorstraat 36,2022-11-12,21:00:00,177,72,105,FMN 02 Mercatorstraat
650,Mercatorstraat 36,2022-11-12,22:00:00,187,66,121,FMN 02 Mercatorstraat
650,Mercatorstraat 36,2022-11-12,23:00:00,186,83,103,FMN 02 Mercatorstraat
650,Mercatorstraat 36,2022-11-13,00:00:00,122,53,69,FMN 02 Mercatorstraat
650,Mercatorstraat 36,2022-11-13,01:00:00,107,34,73,FMN 02 Mercatorstraat
650,Mercatorstraat 36,2022-11-13,02:00:00,79,25,54,FMN 02 Mercatorstraat
650,Mercatorstraat 36,2022-11-13,03:00:00,90,32,58,FMN 02 Mercatorstraat
650,Mercatorstraat 36,2022-11-13,04:00:00,62,9,53,FMN 02 Mercatorstraat
650,Mercatorstraat 36,2022-11-13,05:00:00,48,11,37,FMN 02 Mercatorstraat
650,Mercatorstraat 36,2022-11-13,06:00:00,49,18,31,FMN 02 Mercatorstraat
650,Mercatorstraat 36,2022-11-13,07:00:00,84,24,60,FMN 02 Mercatorstraat
650,Mercatorstraat 36,2022-11-13,08:00:00,127,54,73,FMN 02 Mercatorstraat
650,Mercatorstraat 36,2022-11-13,09:00:00,214,110,104,FMN 02 Mercatorstraat
650,Mercatorstraat 36,2022-11-13,10:00:00,234,152,82,FMN 02 Mercatorstraat
650,Mercatorstraat 36,2022-11-13,11:00:00,237,138,99,FMN 02 Mercatorstraat
650,Mercatorstraat 36,2022-11-13,12:00:00,351,206,145,FMN 02 Mercatorstraat
650,Mercatorstraat 36,2022-11-13,13:00:00,367,225,142,FMN 02 Mercatorstraat
650,Mercatorstraat 36,2022-11-13,14:00:00,391,234,157,FMN 02 Mercatorstraat
650,Mercatorstraat 36,2022-11-13,15:00:00,349,152,197,FMN 02 Mercatorstraat
650,Mercatorstraat 36,2022-11-13,16:00:00,342,122,220,FMN 02 Mercatorstraat
650,Mercatorstraat 36,2022-11-13,17:00:00,334,121,213,FMN 02 Mercatorstraat
650,Mercatorstraat 36,2022-11-13,18:00:00,263,136,127,FMN 02 Mercatorstraat
650,Mercatorstraat 36,2022-11-13,19:00:00,234,116,118,FMN 02 Mercatorstraat
650,Mercatorstraat 36,2022-11-13,20:00:00,189,99,90,FMN 02 Mercatorstraat
650,Mercatorstraat 36,2022-11-13,21:00:00,156,59,97,FMN 02 Mercatorstraat
650,Mercatorstraat 36,2022-11-13,22:00:00,141,53,88,FMN 02 Mercatorstraat
650,Mercatorstraat 36,2022-11-13,23:00:00,61,24,37,FMN 02 Mercatorstraat
650,Mercatorstraat 36,2022-11-14,00:00:00,36,14,22,FMN 02 Mercatorstraat
650,Mercatorstraat 36,2022-11-14,01:00:00,21,4,17,FMN 02 Mercatorstraat
650,Mercatorstraat 36,2022-11-14,02:00:00,10,5,5,FMN 02 Mercatorstraat
650,Mercatorstraat 36,2022-11-14,03:00:00,4,1,3,FMN 02 Mercatorstraat
650,Mercatorstraat 36,2022-11-14,04:00:00,28,18,10,FMN 02 Mercatorstraat
650,Mercatorstraat 36,2022-11-14,05:00:00,45,31,14,FMN 02 Mercatorstraat
650,Mercatorstraat 36,2022-11-14,06:00:00,113,69,44,FMN 02 Mercatorstraat
650,Mercatorstraat 36,2022-11-14,07:00:00,456,281,175,FMN 02 Mercatorstraat
650,Mercatorstraat 36,2022-11-14,08:00:00,1000,717,283,FMN 02 Mercatorstraat
650,Mercatorstraat 36,2022-11-14,09:00:00,427,304,123,FMN 02 Mercatorstraat
650,Mercatorstraat 36,2022-11-14,10:00:00,284,195,89,FMN 02 Mercatorstraat
650,Mercatorstraat 36,2022-11-14,11:00:00,246,146,100,FMN 02 Mercatorstraat
650,Mercatorstraat 36,2022-11-14,12:00:00,404,189,215,FMN 02 Mercatorstraat
650,Mercatorstraat 36,2022-11-14,13:00:00,422,218,204,FMN 02 Mercatorstraat
650,Mercatorstraat 36,2022-11-14,14:00:00,350,173,177,FMN 02 Mercatorstraat
650,Mercatorstraat 36,2022-11-14,15:00:00,484,173,311,FMN 02 Mercatorstraat
650,Mercatorstraat 36,2022-11-14,16:00:00,726,217,509,FMN 02 Mercatorstraat
650,Mercatorstraat 36,2022-11-14,17:00:00,792,258,534,FMN 02 Mercatorstraat
650,Mercatorstraat 36,2022-11-14,18:00:00,545,195,350,FMN 02 Mercatorstraat
650,Mercatorstraat 36,2022-11-14,19:00:00,276,117,159,FMN 02 Mercatorstraat
650,Mercatorstraat 36,2022-11-14,20:00:00,165,67,98,FMN 02 Mercatorstraat
650,Mercatorstraat 36,2022-11-14,21:00:00,214,78,136,FMN 02 Mercatorstraat
650,Mercatorstraat 36,2022-11-14,22:00:00,143,56,87,FMN 02 Mercatorstraat
650,Mercatorstraat 36,2022-11-14,23:00:00,60,16,44,FMN 02 Mercatorstraat
650,Mercatorstraat 36,2022-11-15,00:00:00,27,13,14,FMN 02 Mercatorstraat
650,Mercatorstraat 36,2022-11-15,01:00:00,21,4,17,FMN 02 Mercatorstraat
650,Mercatorstraat 36,2022-11-15,02:00:00,13,6,7,FMN 02 Mercatorstraat
650,Mercatorstraat 36,2022-11-15,03:00:00,15,1,14,FMN 02 Mercatorstraat
650,Mercatorstraat 36,2022-11-15,04:00:00,31,18,13,FMN 02 Mercatorstraat
650,Mercatorstraat 36,2022-11-15,05:00:00,39,29,10,FMN 02 Mercatorstraat
650,Mercatorstraat 36,2022-11-15,06:00:00,126,75,51,FMN 02 Mercatorstraat
650,Mercatorstraat 36,2022-11-15,07:00:00,452,295,157,FMN 02 Mercatorstraat
650,Mercatorstraat 36,2022-11-15,08:00:00,1079,762,317,FMN 02 Mercatorstraat
650,Mercatorstraat 36,2022-11-15,09:00:00,453,337,116,FMN 02 Mercatorstraat
650,Mercatorstraat 36,2022-11-15,10:00:00,291,187,104,FMN 02 Mercatorstraat
650,Mercatorstraat 36,2022-11-15,11:00:00,275,168,107,FMN 02 Mercatorstraat
650,Mercatorstraat 36,2022-11-15,12:00:00,381,199,182,FMN 02 Mercatorstraat
650,Mercatorstraat 36,2022-11-15,13:00:00,414,189,225,FMN 02 Mercatorstraat
650,Mercatorstraat 36,2022-11-15,14:00:00,291,132,159,FMN 02 Mercatorstraat
650,Mercatorstraat 36,2022-11-15,15:00:00,538,178,360,FMN 02 Mercatorstraat
650,Mercatorstraat 36,2022-11-15,16:00:00,700,190,510,FMN 02 Mercatorstraat
650,Mercatorstraat 36,2022-11-15,17:00:00,702,221,481,FMN 02 Mercatorstraat
650,Mercatorstraat 36,2022-11-15,18:00:00,484,164,320,FMN 02 Mercatorstraat
650,Mercatorstraat 36,2022-11-15,19:00:00,282,116,166,FMN 02 Mercatorstraat
650,Mercatorstraat 36,2022-11-15,20:00:00,179,75,104,FMN 02 Mercatorstraat
650,Mercatorstraat 36,2022-11-15,21:00:00,187,82,105,FMN 02 Mercatorstraat
650,Mercatorstraat 36,2022-11-15,22:00:00,186,60,126,FMN 02 Mercatorstraat
650,Mercatorstraat 36,2022-11-15,23:00:00,88,25,63,FMN 02 Mercatorstraat
650,Mercatorstraat 36,2022-11-16,00:00:00,49,15,34,FMN 02 Mercatorstraat
650,Mercatorstraat 36,2022-11-16,01:00:00,23,5,18,FMN 02 Mercatorstraat
650,Mercatorstraat 36,2022-11-16,02:00:00,14,2,12,FMN 02 Mercatorstraat
650,Mercatorstraat 36,2022-11-16,03:00:00,8,4,4,FMN 02 Mercatorstraat
650,Mercatorstraat 36,2022-11-16,04:00:00,38,19,19,FMN 02 Mercatorstraat
650,Mercatorstraat 36,2022-11-16,05:00:00,49,30,19,FMN 02 Mercatorstraat
650,Mercatorstraat 36,2022-11-16,06:00:00,127,71,56,FMN 02 Mercatorstraat
650,Mercatorstraat 36,2022-11-16,07:00:00,434,288,146,FMN 02 Mercatorstraat
650,Mercatorstraat 36,2022-11-16,08:00:00,1005,691,314,FMN 02 Mercatorstraat
650,Mercatorstraat 36,2022-11-16,09:00:00,405,297,108,FMN 02 Mercatorstraat
650,Mercatorstraat 36,2022-11-16,10:00:00,271,170,101,FMN 02 Mercatorstraat
650,Mercatorstraat 36,2022-11-16,11:00:00,304,153,151,FMN 02 Mercatorstraat
650,Mercatorstraat 36,2022-11-16,12:00:00,525,213,312,FMN 02 Mercatorstraat
650,Mercatorstraat 36,2022-11-16,13:00:00,407,188,219,FMN 02 Mercatorstraat
650,Mercatorstraat 36,2022-11-16,14:00:00,331,140,191,FMN 02 Mercatorstraat
650,Mercatorstraat 36,2022-11-16,15:00:00,387,153,234,FMN 02 Mercatorstraat
650,Mercatorstraat 36,2022-11-16,16:00:00,554,198,356,FMN 02 Mercatorstraat
650,Mercatorstraat 36,2022-11-16,17:00:00,703,247,456,FMN 02 Mercatorstraat
650,Mercatorstraat 36,2022-11-16,18:00:00,535,202,333,FMN 02 Mercatorstraat
650,Mercatorstraat 36,2022-11-16,19:00:00,343,165,178,FMN 02 Mercatorstraat
650,Mercatorstraat 36,2022-11-16,20:00:00,203,84,119,FMN 02 Mercatorstraat
650,Mercatorstraat 36,2022-11-16,21:00:00,178,69,109,FMN 02 Mercatorstraat
650,Mercatorstraat 36,2022-11-16,22:00:00,172,61,111,FMN 02 Mercatorstraat
650,Mercatorstraat 36,2022-11-16,23:00:00,98,33,65,FMN 02 Mercatorstraat
650,Mercatorstraat 36,2022-11-17,00:00:00,49,21,28,FMN 02 Mercatorstraat
650,Mercatorstraat 36,2022-11-17,01:00:00,28,10,18,FMN 02 Mercatorstraat
650,Mercatorstraat 36,2022-11-17,02:00:00,25,10,15,FMN 02 Mercatorstraat
650,Mercatorstraat 36,2022-11-17,03:00:00,16,2,14,FMN 02 Mercatorstraat
650,Mercatorstraat 36,2022-11-17,04:00:00,39,16,23,FMN 02 Mercatorstraat
650,Mercatorstraat 36,2022-11-17,05:00:00,46,30,16,FMN 02 Mercatorstraat
650,Mercatorstraat 36,2022-11-17,06:00:00,108,66,42,FMN 02 Mercatorstraat
650,Mercatorstraat 36,2022-11-17,07:00:00,382,248,134,FMN 02 Mercatorstraat
650,Mercatorstraat 36,2022-11-17,08:00:00,923,668,255,FMN 02 Mercatorstraat
650,Mercatorstraat 36,2022-11-17,09:00:00,350,259,91,FMN 02 Mercatorstraat
650,Mercatorstraat 36,2022-11-17,10:00:00,196,129,67,FMN 02 Mercatorstraat
650,Mercatorstraat 36,2022-11-17,11:00:00,211,124,87,FMN 02 Mercatorstraat
650,Mercatorstraat 36,2022-11-17,12:00:00,339,165,174,FMN 02 Mercatorstraat
650,Mercatorstraat 36,2022-11-17,13:00:00,333,167,166,FMN 02 Mercatorstraat
650,Mercatorstraat 36,2022-11-17,14:00:00,266,118,148,FMN 02 Mercatorstraat
650,Mercatorstraat 36,2022-11-17,15:00:00,446,142,304,FMN 02 Mercatorstraat
650,Mercatorstraat 36,2022-11-17,16:00:00,609,199,410,FMN 02 Mercatorstraat
650,Mercatorstraat 36,2022-11-17,17:00:00,735,248,487,FMN 02 Mercatorstraat
650,Mercatorstraat 36,2022-11-17,18:00:00,516,217,299,FMN 02 Mercatorstraat
650,Mercatorstraat 36,2022-11-17,19:00:00,388,202,186,FMN 02 Mercatorstraat
650,Mercatorstraat 36,2022-11-17,20:00:00,228,97,131,FMN 02 Mercatorstraat
650,Mercatorstraat 36,2022-11-17,21:00:00,246,93,153,FMN 02 Mercatorstraat
650,Mercatorstraat 36,2022-11-17,22:00:00,228,77,151,FMN 02 Mercatorstraat
650,Mercatorstraat 36,2022-11-17,23:00:00,167,46,121,FMN 02 Mercatorstraat
650,Mercatorstraat 36,2022-11-18,00:00:00,96,28,68,FMN 02 Mercatorstraat
650,Mercatorstraat 36,2022-11-18,01:00:00,54,21,33,FMN 02 Mercatorstraat
650,Mercatorstraat 36,2022-11-18,02:00:00,32,8,24,FMN 02 Mercatorstraat
650,Mercatorstraat 36,2022-11-18,03:00:00,19,4,15,FMN 02 Mercatorstraat
650,Mercatorstraat 36,2022-11-18,04:00:00,37,15,22,FMN 02 Mercatorstraat
650,Mercatorstraat 36,2022-11-18,05:00:00,44,27,17,FMN 02 Mercatorstraat
650,Mercatorstraat 36,2022-11-18,06:00:00,115,70,45,FMN 02 Mercatorstraat
650,Mercatorstraat 36,2022-11-18,07:00:00,396,251,145,FMN 02 Mercatorstraat
650,Mercatorstraat 36,2022-11-18,08:00:00,937,679,258,FMN 02 Mercatorstraat
650,Mercatorstraat 36,2022-11-18,09:00:00,404,290,114,FMN 02 Mercatorstraat
650,Mercatorstraat 36,2022-11-18,10:00:00,249,162,87,FMN 02 Mercatorstraat
650,Mercatorstraat 36,2022-11-18,11:00:00,262,143,119,FMN 02 Mercatorstraat
650,Mercatorstraat 36,2022-11-18,12:00:00,393,185,208,FMN 02 Mercatorstraat
650,Mercatorstraat 36,2022-11-18,13:00:00,317,147,170,FMN 02 Mercatorstraat
650,Mercatorstraat 36,2022-11-18,14:00:00,320,150,170,FMN 02 Mercatorstraat
650,Mercatorstraat 36,2022-11-18,15:00:00,466,128,338,FMN 02 Mercatorstraat
650,Mercatorstraat 36,2022-11-18,16:00:00,556,161,395,FMN 02 Mercatorstraat
650,Mercatorstraat 36,2022-11-18,17:00:00,535,166,369,FMN 02 Mercatorstraat
650,Mercatorstraat 36,2022-11-18,18:00:00,368,152,216,FMN 02 Mercatorstraat
650,Mercatorstraat 36,2022-11-18,19:00:00,237,121,116,FMN 02 Mercatorstraat
650,Mercatorstraat 36,2022-11-18,20:00:00,193,82,111,FMN 02 Mercatorstraat
650,Mercatorstraat 36,2022-11-18,21:00:00,183,88,95,FMN 02 Mercatorstraat
650,Mercatorstraat 36,2022-11-18,22:00:00,150,55,95,FMN 02 Mercatorstraat
650,Mercatorstraat 36,2022-11-18,23:00:00,166,53,113,FMN 02 Mercatorstraat
650,Mercatorstraat 36,2022-11-19,00:00:00,145,61,84,FMN 02 Mercatorstraat
650,Mercatorstraat 36,2022-11-19,01:00:00,104,56,48,FMN 02 Mercatorstraat
650,Mercatorstraat 36,2022-11-19,02:00:00,63,29,34,FMN 02 Mercatorstraat
650,Mercatorstraat 36,2022-11-19,03:00:00,55,18,37,FMN 02 Mercatorstraat
650,Mercatorstraat 36,2022-11-19,04:00:00,43,18,25,FMN 02 Mercatorstraat
650,Mercatorstraat 36,2022-11-19,05:00:00,35,15,20,FMN 02 Mercatorstraat
650,Mercatorstraat 36,2022-11-19,06:00:00,38,23,15,FMN 02 Mercatorstraat
650,Mercatorstraat 36,2022-11-19,07:00:00,46,27,19,FMN 02 Mercatorstraat
650,Mercatorstraat 36,2022-11-19,08:00:00,47,33,14,FMN 02 Mercatorstraat
650,Mercatorstraat 36,2022-11-19,09:00:00,133,110,23,FMN 02 Mercatorstraat
650,Mercatorstraat 36,2022-11-19,10:00:00,188,120,68,FMN 02 Mercatorstraat
650,Mercatorstraat 36,2022-11-19,11:00:00,179,110,69,FMN 02 Mercatorstraat
650,Mercatorstraat 36,2022-11-19,12:00:00,208,104,104,FMN 02 Mercatorstraat
650,Mercatorstraat 36,2022-11-19,13:00:00,251,128,123,FMN 02 Mercatorstraat
650,Mercatorstraat 36,2022-11-19,14:00:00,293,155,138,FMN 02 Mercatorstraat
650,Mercatorstraat 36,2022-11-19,15:00:00,266,136,130,FMN 02 Mercatorstraat
650,Mercatorstraat 36,2022-11-19,16:00:00,241,115,126,FMN 02 Mercatorstraat
650,Mercatorstraat 36,2022-11-19,17:00:00,285,120,165,FMN 02 Mercatorstraat
650,Mercatorstraat 36,2022-11-19,18:00:00,271,132,139,FMN 02 Mercatorstraat
650,Mercatorstraat 36,2022-11-19,19:00:00,271,162,109,FMN 02 Mercatorstraat
650,Mercatorstraat 36,2022-11-19,20:00:00,172,96,76,FMN 02 Mercatorstraat
650,Mercatorstraat 36,2022-11-19,21:00:00,150,70,80,FMN 02 Mercatorstraat
650,Mercatorstraat 36,2022-11-19,22:00:00,166,60,106,FMN 02 Mercatorstraat
650,Mercatorstraat 36,2022-11-19,23:00:00,133,43,90,FMN 02 Mercatorstraat
650,Mercatorstraat 36,2022-11-20,00:00:00,152,56,96,FMN 02 Mercatorstraat
650,Mercatorstraat 36,2022-11-20,01:00:00,128,64,64,FMN 02 Mercatorstraat
650,Mercatorstraat 36,2022-11-20,02:00:00,99,29,70,FMN 02 Mercatorstraat
650,Mercatorstraat 36,2022-11-20,03:00:00,61,24,37,FMN 02 Mercatorstraat
650,Mercatorstraat 36,2022-11-20,04:00:00,38,10,28,FMN 02 Mercatorstraat
650,Mercatorstraat 36,2022-11-20,05:00:00,33,13,20,FMN 02 Mercatorstraat
650,Mercatorstraat 36,2022-11-20,06:00:00,33,14,19,FMN 02 Mercatorstraat
650,Mercatorstraat 36,2022-11-20,07:00:00,71,30,41,FMN 02 Mercatorstraat
650,Mercatorstraat 36,2022-11-20,08:00:00,124,58,66,FMN 02 Mercatorstraat
650,Mercatorstraat 36,2022-11-20,09:00:00,227,124,103,FMN 02 Mercatorstraat
650,Mercatorstraat 36,2022-11-20,10:00:00,195,116,79,FMN 02 Mercatorstraat
650,Mercatorstraat 36,2022-11-20,11:00:00,209,106,103,FMN 02 Mercatorstraat
650,Mercatorstraat 36,2022-11-20,12:00:00,225,118,107,FMN 02 Mercatorstraat
650,Mercatorstraat 36,2022-11-20,13:00:00,228,113,115,FMN 02 Mercatorstraat
650,Mercatorstraat 36,2022-11-20,14:00:00,169,78,91,FMN 02 Mercatorstraat
650,Mercatorstraat 36,2022-11-20,15:00:00,153,78,75,FMN 02 Mercatorstraat
650,Mercatorstraat 36,2022-11-20,16:00:00,172,68,104,FMN 02 Mercatorstraat
650,Mercatorstraat 36,2022-11-20,17:00:00,222,84,138,FMN 02 Mercatorstraat
650,Mercatorstraat 36,2022-11-20,18:00:00,154,71,83,FMN 02 Mercatorstraat
650,Mercatorstraat 36,2022-11-20,19:00:00,204,117,87,FMN 02 Mercatorstraat
650,Mercatorstraat 36,2022-11-20,20:00:00,162,76,86,FMN 02 Mercatorstraat
650,Mercatorstraat 36,2022-11-20,21:00:00,135,64,71,FMN 02 Mercatorstraat
650,Mercatorstraat 36,2022-11-20,22:00:00,96,33,63,FMN 02 Mercatorstraat
650,Mercatorstraat 36,2022-11-20,23:00:00,67,27,40,FMN 02 Mercatorstraat
650,Mercatorstraat 36,2022-11-21,00:00:00,45,20,25,FMN 02 Mercatorstraat
650,Mercatorstraat 36,2022-11-21,01:00:00,24,12,12,FMN 02 Mercatorstraat
650,Mercatorstraat 36,2022-11-21,02:00:00,7,2,5,FMN 02 Mercatorstraat
650,Mercatorstraat 36,2022-11-21,03:00:00,4,1,3,FMN 02 Mercatorstraat
650,Mercatorstraat 36,2022-11-21,04:00:00,24,16,8,FMN 02 Mercatorstraat
650,Mercatorstraat 36,2022-11-21,05:00:00,50,33,17,FMN 02 Mercatorstraat
650,Mercatorstraat 36,2022-11-21,06:00:00,119,78,41,FMN 02 Mercatorstraat
650,Mercatorstraat 36,2022-11-21,07:00:00,402,258,144,FMN 02 Mercatorstraat
650,Mercatorstraat 36,2022-11-21,08:00:00,987,724,263,FMN 02 Mercatorstraat
650,Mercatorstraat 36,2022-11-21,09:00:00,429,324,105,FMN 02 Mercatorstraat
650,Mercatorstraat 36,2022-11-21,10:00:00,253,152,101,FMN 02 Mercatorstraat
650,Mercatorstraat 36,2022-11-21,11:00:00,223,133,90,FMN 02 Mercatorstraat
650,Mercatorstraat 36,2022-11-21,12:00:00,366,182,184,FMN 02 Mercatorstraat
650,Mercatorstraat 36,2022-11-21,13:00:00,327,152,175,FMN 02 Mercatorstraat
650,Mercatorstraat 36,2022-11-21,14:00:00,307,148,159,FMN 02 Mercatorstraat
650,Mercatorstraat 36,2022-11-21,15:00:00,474,136,338,FMN 02 Mercatorstraat
650,Mercatorstraat 36,2022-11-21,16:00:00,643,173,470,FMN 02 Mercatorstraat
650,Mercatorstraat 36,2022-11-21,17:00:00,699,209,490,FMN 02 Mercatorstraat
650,Mercatorstraat 36,2022-11-21,18:00:00,423,134,289,FMN 02 Mercatorstraat
650,Mercatorstraat 36,2022-11-21,19:00:00,247,94,153,FMN 02 Mercatorstraat
650,Mercatorstraat 36,2022-11-21,20:00:00,144,61,83,FMN 02 Mercatorstraat
650,Mercatorstraat 36,2022-11-21,21:00:00,150,49,101,FMN 02 Mercatorstraat
650,Mercatorstraat 36,2022-11-21,22:00:00,139,48,91,FMN 02 Mercatorstraat
650,Mercatorstraat 36,2022-11-21,23:00:00,46,17,29,FMN 02 Mercatorstraat
650,Mercatorstraat 36,2022-11-22,00:00:00,28,9,19,FMN 02 Mercatorstraat
650,Mercatorstraat 36,2022-11-22,01:00:00,22,10,12,FMN 02 Mercatorstraat
650,Mercatorstraat 36,2022-11-22,02:00:00,16,8,8,FMN 02 Mercatorstraat
650,Mercatorstraat 36,2022-11-22,03:00:00,6,2,4,FMN 02 Mercatorstraat
650,Mercatorstraat 36,2022-11-22,04:00:00,25,12,13,FMN 02 Mercatorstraat
650,Mercatorstraat 36,2022-11-22,05:00:00,47,30,17,FMN 02 Mercatorstraat
650,Mercatorstraat 36,2022-11-22,06:00:00,119,72,47,FMN 02 Mercatorstraat
650,Mercatorstraat 36,2022-11-22,07:00:00,399,253,146,FMN 02 Mercatorstraat
650,Mercatorstraat 36,2022-11-22,08:00:00,1079,768,311,FMN 02 Mercatorstraat
650,Mercatorstraat 36,2022-11-22,09:00:00,400,299,101,FMN 02 Mercatorstraat
650,Mercatorstraat 36,2022-11-22,10:00:00,244,172,72,FMN 02 Mercatorstraat
650,Mercatorstraat 36,2022-11-22,11:00:00,203,102,101,FMN 02 Mercatorstraat
650,Mercatorstraat 36,2022-11-22,12:00:00,347,181,166,FMN 02 Mercatorstraat
650,Mercatorstraat 36,2022-11-22,13:00:00,342,164,178,FMN 02 Mercatorstraat
650,Mercatorstraat 36,2022-11-22,14:00:00,264,119,145,FMN 02 Mercatorstraat
650,Mercatorstraat 36,2022-11-22,15:00:00,476,143,333,FMN 02 Mercatorstraat
650,Mercatorstraat 36,2022-11-22,16:00:00,727,214,513,FMN 02 Mercatorstraat
650,Mercatorstraat 36,2022-11-22,17:00:00,771,268,503,FMN 02 Mercatorstraat
650,Mercatorstraat 36,2022-11-22,18:00:00,545,193,352,FMN 02 Mercatorstraat
650,Mercatorstraat 36,2022-11-22,19:00:00,294,135,159,FMN 02 Mercatorstraat
650,Mercatorstraat 36,2022-11-22,20:00:00,210,88,122,FMN 02 Mercatorstraat
650,Mercatorstraat 36,2022-11-22,21:00:00,205,80,125,FMN 02 Mercatorstraat
650,Mercatorstraat 36,2022-11-22,22:00:00,176,56,120,FMN 02 Mercatorstraat
650,Mercatorstraat 36,2022-11-22,23:00:00,83,26,57,FMN 02 Mercatorstraat
650,Mercatorstraat 36,2022-11-23,00:00:00,48,18,30,FMN 02 Mercatorstraat
650,Mercatorstraat 36,2022-11-23,01:00:00,19,8,11,FMN 02 Mercatorstraat
650,Mercatorstraat 36,2022-11-23,02:00:00,19,4,15,FMN 02 Mercatorstraat
650,Mercatorstraat 36,2022-11-23,03:00:00,12,2,10,FMN 02 Mercatorstraat
650,Mercatorstraat 36,2022-11-23,04:00:00,34,16,18,FMN 02 Mercatorstraat
650,Mercatorstraat 36,2022-11-23,05:00:00,43,27,16,FMN 02 Mercatorstraat
650,Mercatorstraat 36,2022-11-23,06:00:00,122,77,45,FMN 02 Mercatorstraat
650,Mercatorstraat 36,2022-11-23,07:00:00,404,273,131,FMN 02 Mercatorstraat
650,Mercatorstraat 36,2022-11-23,08:00:00,896,626,270,FMN 02 Mercatorstraat
650,Mercatorstraat 36,2022-11-23,09:00:00,443,333,110,FMN 02 Mercatorstraat
650,Mercatorstraat 36,2022-11-23,10:00:00,241,152,89,FMN 02 Mercatorstraat
650,Mercatorstraat 36,2022-11-23,11:00:00,267,125,142,FMN 02 Mercatorstraat
650,Mercatorstraat 36,2022-11-23,12:00:00,507,181,326,FMN 02 Mercatorstraat
650,Mercatorstraat 36,2022-11-23,13:00:00,396,154,242,FMN 02 Mercatorstraat
650,Mercatorstraat 36,2022-11-23,14:00:00,229,103,126,FMN 02 Mercatorstraat
650,Mercatorstraat 36,2022-11-23,15:00:00,273,94,179,FMN 02 Mercatorstraat
650,Mercatorstraat 36,2022-11-23,16:00:00,504,201,303,FMN 02 Mercatorstraat
650,Mercatorstraat 36,2022-11-23,17:00:00,665,231,434,FMN 02 Mercatorstraat
650,Mercatorstraat 36,2022-11-23,18:00:00,536,218,318,FMN 02 Mercatorstraat
650,Mercatorstraat 36,2022-11-23,19:00:00,369,177,192,FMN 02 Mercatorstraat
650,Mercatorstraat 36,2022-11-23,20:00:00,216,94,122,FMN 02 Mercatorstraat
650,Mercatorstraat 36,2022-11-23,21:00:00,201,79,122,FMN 02 Mercatorstraat
650,Mercatorstraat 36,2022-11-23,22:00:00,238,96,142,FMN 02 Mercatorstraat
650,Mercatorstraat 36,2022-11-23,23:00:00,120,49,71,FMN 02 Mercatorstraat
650,Mercatorstraat 36,2022-11-24,00:00:00,76,31,45,FMN 02 Mercatorstraat
650,Mercatorstraat 36,2022-11-24,01:00:00,50,16,34,FMN 02 Mercatorstraat
650,Mercatorstraat 36,2022-11-24,02:00:00,20,10,10,FMN 02 Mercatorstraat
650,Mercatorstraat 36,2022-11-24,03:00:00,14,2,12,FMN 02 Mercatorstraat
650,Mercatorstraat 36,2022-11-24,04:00:00,27,18,9,FMN 02 Mercatorstraat
650,Mercatorstraat 36,2022-11-24,05:00:00,51,31,20,FMN 02 Mercatorstraat
650,Mercatorstraat 36,2022-11-24,06:00:00,118,78,40,FMN 02 Mercatorstraat
650,Mercatorstraat 36,2022-11-24,07:00:00,422,268,154,FMN 02 Mercatorstraat
650,Mercatorstraat 36,2022-11-24,08:00:00,1089,760,329,FMN 02 Mercatorstraat
650,Mercatorstraat 36,2022-11-24,09:00:00,472,355,117,FMN 02 Mercatorstraat
650,Mercatorstraat 36,2022-11-24,10:00:00,267,166,101,FMN 02 Mercatorstraat
650,Mercatorstraat 36,2022-11-24,11:00:00,253,148,105,FMN 02 Mercatorstraat
650,Mercatorstraat 36,2022-11-24,12:00:00,399,214,185,FMN 02 Mercatorstraat
650,Mercatorstraat 36,2022-11-24,13:00:00,418,190,228,FMN 02 Mercatorstraat
650,Mercatorstraat 36,2022-11-24,14:00:00,333,151,182,FMN 02 Mercatorstraat
650,Mercatorstraat 36,2022-11-24,15:00:00,497,175,322,FMN 02 Mercatorstraat
650,Mercatorstraat 36,2022-11-24,16:00:00,749,231,518,FMN 02 Mercatorstraat
650,Mercatorstraat 36,2022-11-24,17:00:00,796,288,508,FMN 02 Mercatorstraat
650,Mercatorstraat 36,2022-11-24,18:00:00,604,233,371,FMN 02 Mercatorstraat
650,Mercatorstraat 36,2022-11-24,19:00:00,376,173,203,FMN 02 Mercatorstraat
650,Mercatorstraat 36,2022-11-24,20:00:00,235,105,130,FMN 02 Mercatorstraat
650,Mercatorstraat 36,2022-11-24,21:00:00,228,95,133,FMN 02 Mercatorstraat
650,Mercatorstraat 36,2022-11-24,22:00:00,228,93,135,FMN 02 Mercatorstraat
650,Mercatorstraat 36,2022-11-24,23:00:00,135,67,68,FMN 02 Mercatorstraat
650,Mercatorstraat 36,2022-11-25,00:00:00,116,66,50,FMN 02 Mercatorstraat
650,Mercatorstraat 36,2022-11-25,01:00:00,63,25,38,FMN 02 Mercatorstraat
650,Mercatorstraat 36,2022-11-25,02:00:00,41,3,38,FMN 02 Mercatorstraat
650,Mercatorstraat 36,2022-11-25,03:00:00,50,6,44,FMN 02 Mercatorstraat
650,Mercatorstraat 36,2022-11-25,04:00:00,70,21,49,FMN 02 Mercatorstraat
650,Mercatorstraat 36,2022-11-25,05:00:00,84,34,50,FMN 02 Mercatorstraat
650,Mercatorstraat 36,2022-11-25,06:00:00,89,60,29,FMN 02 Mercatorstraat
650,Mercatorstraat 36,2022-11-25,07:00:00,373,230,143,FMN 02 Mercatorstraat
650,Mercatorstraat 36,2022-11-25,08:00:00,860,583,277,FMN 02 Mercatorstraat
650,Mercatorstraat 36,2022-11-25,09:00:00,416,320,96,FMN 02 Mercatorstraat
650,Mercatorstraat 36,2022-11-25,10:00:00,291,213,78,FMN 02 Mercatorstraat
650,Mercatorstraat 36,2022-11-25,11:00:00,283,174,109,FMN 02 Mercatorstraat
650,Mercatorstraat 36,2022-11-25,12:00:00,454,238,216,FMN 02 Mercatorstraat
650,Mercatorstraat 36,2022-11-25,13:00:00,362,180,182,FMN 02 Mercatorstraat
650,Mercatorstraat 36,2022-11-25,14:00:00,396,174,222,FMN 02 Mercatorstraat
650,Mercatorstraat 36,2022-11-25,15:00:00,547,166,381,FMN 02 Mercatorstraat
650,Mercatorstraat 36,2022-11-25,16:00:00,666,228,438,FMN 02 Mercatorstraat
650,Mercatorstraat 36,2022-11-25,17:00:00,655,241,414,FMN 02 Mercatorstraat
650,Mercatorstraat 36,2022-11-25,18:00:00,486,199,287,FMN 02 Mercatorstraat
650,Mercatorstraat 36,2022-11-25,19:00:00,386,170,216,FMN 02 Mercatorstraat
650,Mercatorstraat 36,2022-11-25,20:00:00,212,111,101,FMN 02 Mercatorstraat
650,Mercatorstraat 36,2022-11-25,21:00:00,217,120,97,FMN 02 Mercatorstraat
650,Mercatorstraat 36,2022-11-25,22:00:00,195,84,111,FMN 02 Mercatorstraat
650,Mercatorstraat 36,2022-11-25,23:00:00,217,67,150,FMN 02 Mercatorstraat
650,Mercatorstraat 36,2022-11-26,00:00:00,165,77,88,FMN 02 Mercatorstraat
650,Mercatorstraat 36,2022-11-26,01:00:00,127,58,69,FMN 02 Mercatorstraat
650,Mercatorstraat 36,2022-11-26,02:00:00,87,26,61,FMN 02 Mercatorstraat
650,Mercatorstraat 36,2022-11-26,03:00:00,73,16,57,FMN 02 Mercatorstraat
650,Mercatorstraat 36,2022-11-26,04:00:00,50,15,35,FMN 02 Mercatorstraat
650,Mercatorstraat 36,2022-11-26,05:00:00,42,16,26,FMN 02 Mercatorstraat
650,Mercatorstraat 36,2022-11-26,06:00:00,41,15,26,FMN 02 Mercatorstraat
650,Mercatorstraat 36,2022-11-26,07:00:00,56,21,35,FMN 02 Mercatorstraat
650,Mercatorstraat 36,2022-11-26,08:00:00,93,48,45,FMN 02 Mercatorstraat
650,Mercatorstraat 36,2022-11-26,09:00:00,204,146,58,FMN 02 Mercatorstraat
650,Mercatorstraat 36,2022-11-26,10:00:00,245,175,70,FMN 02 Mercatorstraat
650,Mercatorstraat 36,2022-11-26,11:00:00,276,169,107,FMN 02 Mercatorstraat
650,Mercatorstraat 36,2022-11-26,12:00:00,322,182,140,FMN 02 Mercatorstraat
650,Mercatorstraat 36,2022-11-26,13:00:00,396,254,142,FMN 02 Mercatorstraat
650,Mercatorstraat 36,2022-11-26,14:00:00,379,239,140,FMN 02 Mercatorstraat
650,Mercatorstraat 36,2022-11-26,15:00:00,343,168,175,FMN 02 Mercatorstraat
650,Mercatorstraat 36,2022-11-26,16:00:00,398,166,232,FMN 02 Mercatorstraat
650,Mercatorstraat 36,2022-11-26,17:00:00,436,173,263,FMN 02 Mercatorstraat
650,Mercatorstraat 36,2022-11-26,18:00:00,355,173,182,FMN 02 Mercatorstraat
650,Mercatorstraat 36,2022-11-26,19:00:00,314,180,134,FMN 02 Mercatorstraat
650,Mercatorstraat 36,2022-11-26,20:00:00,217,101,116,FMN 02 Mercatorstraat
650,Mercatorstraat 36,2022-11-26,21:00:00,192,81,111,FMN 02 Mercatorstraat
650,Mercatorstraat 36,2022-11-26,22:00:00,230,92,138,FMN 02 Mercatorstraat
650,Mercatorstraat 36,2022-11-26,23:00:00,202,84,118,FMN 02 Mercatorstraat
650,Mercatorstraat 36,2022-11-27,00:00:00,153,50,103,FMN 02 Mercatorstraat
650,Mercatorstraat 36,2022-11-27,01:00:00,148,72,76,FMN 02 Mercatorstraat
650,Mercatorstraat 36,2022-11-27,02:00:00,116,38,78,FMN 02 Mercatorstraat
650,Mercatorstraat 36,2022-11-27,03:00:00,89,27,62,FMN 02 Mercatorstraat
650,Mercatorstraat 36,2022-11-27,04:00:00,74,29,45,FMN 02 Mercatorstraat
650,Mercatorstraat 36,2022-11-27,05:00:00,37,12,25,FMN 02 Mercatorstraat
650,Mercatorstraat 36,2022-11-27,06:00:00,50,16,34,FMN 02 Mercatorstraat
650,Mercatorstraat 36,2022-11-27,07:00:00,61,27,34,FMN 02 Mercatorstraat
650,Mercatorstraat 36,2022-11-27,08:00:00,99,37,62,FMN 02 Mercatorstraat
650,Mercatorstraat 36,2022-11-27,09:00:00,185,81,104,FMN 02 Mercatorstraat
650,Mercatorstraat 36,2022-11-27,10:00:00,137,84,53,FMN 02 Mercatorstraat
650,Mercatorstraat 36,2022-11-27,11:00:00,156,88,68,FMN 02 Mercatorstraat
650,Mercatorstraat 36,2022-11-27,12:00:00,189,111,78,FMN 02 Mercatorstraat
650,Mercatorstraat 36,2022-11-27,13:00:00,298,157,141,FMN 02 Mercatorstraat
650,Mercatorstraat 36,2022-11-27,14:00:00,210,117,93,FMN 02 Mercatorstraat
650,Mercatorstraat 36,2022-11-27,15:00:00,190,100,90,FMN 02 Mercatorstraat
650,Mercatorstraat 36,2022-11-27,16:00:00,205,99,106,FMN 02 Mercatorstraat
650,Mercatorstraat 36,2022-11-27,17:00:00,229,78,151,FMN 02 Mercatorstraat
650,Mercatorstraat 36,2022-11-27,18:00:00,215,62,153,FMN 02 Mercatorstraat
650,Mercatorstraat 36,2022-11-27,19:00:00,151,67,84,FMN 02 Mercatorstraat
650,Mercatorstraat 36,2022-11-27,20:00:00,106,48,58,FMN 02 Mercatorstraat
650,Mercatorstraat 36,2022-11-27,21:00:00,95,62,33,FMN 02 Mercatorstraat
650,Mercatorstraat 36,2022-11-27,22:00:00,76,29,47,FMN 02 Mercatorstraat
650,Mercatorstraat 36,2022-11-27,23:00:00,53,18,35,FMN 02 Mercatorstraat
650,Mercatorstraat 36,2022-11-28,00:00:00,32,13,19,FMN 02 Mercatorstraat
650,Mercatorstraat 36,2022-11-28,01:00:00,18,8,10,FMN 02 Mercatorstraat
650,Mercatorstraat 36,2022-11-28,02:00:00,13,5,8,FMN 02 Mercatorstraat
650,Mercatorstraat 36,2022-11-28,03:00:00,3,0,3,FMN 02 Mercatorstraat
650,Mercatorstraat 36,2022-11-28,04:00:00,20,14,6,FMN 02 Mercatorstraat
650,Mercatorstraat 36,2022-11-28,05:00:00,49,30,19,FMN 02 Mercatorstraat
650,Mercatorstraat 36,2022-11-28,06:00:00,92,66,26,FMN 02 Mercatorstraat
650,Mercatorstraat 36,2022-11-28,07:00:00,355,220,135,FMN 02 Mercatorstraat
650,Mercatorstraat 36,2022-11-28,08:00:00,988,715,273,FMN 02 Mercatorstraat
650,Mercatorstraat 36,2022-11-28,09:00:00,372,264,108,FMN 02 Mercatorstraat
650,Mercatorstraat 36,2022-11-28,10:00:00,249,156,93,FMN 02 Mercatorstraat
650,Mercatorstraat 36,2022-11-28,11:00:00,218,132,86,FMN 02 Mercatorstraat
650,Mercatorstraat 36,2022-11-28,12:00:00,317,144,173,FMN 02 Mercatorstraat
650,Mercatorstraat 36,2022-11-28,13:00:00,358,183,175,FMN 02 Mercatorstraat
650,Mercatorstraat 36,2022-11-28,14:00:00,290,136,154,FMN 02 Mercatorstraat
650,Mercatorstraat 36,2022-11-28,15:00:00,443,151,292,FMN 02 Mercatorstraat
650,Mercatorstraat 36,2022-11-28,16:00:00,678,200,478,FMN 02 Mercatorstraat
650,Mercatorstraat 36,2022-11-28,17:00:00,684,260,424,FMN 02 Mercatorstraat
650,Mercatorstraat 36,2022-11-28,18:00:00,526,192,334,FMN 02 Mercatorstraat
650,Mercatorstraat 36,2022-11-28,19:00:00,302,118,184,FMN 02 Mercatorstraat
650,Mercatorstraat 36,2022-11-28,20:00:00,199,83,116,FMN 02 Mercatorstraat
650,Mercatorstraat 36,2022-11-28,21:00:00,178,68,110,FMN 02 Mercatorstraat
650,Mercatorstraat 36,2022-11-28,22:00:00,163,54,109,FMN 02 Mercatorstraat
650,Mercatorstraat 36,2022-11-28,23:00:00,88,33,55,FMN 02 Mercatorstraat
650,Mercatorstraat 36,2022-11-29,00:00:00,38,11,27,FMN 02 Mercatorstraat
650,Mercatorstraat 36,2022-11-29,01:00:00,21,3,18,FMN 02 Mercatorstraat
650,Mercatorstraat 36,2022-11-29,02:00:00,13,4,9,FMN 02 Mercatorstraat
650,Mercatorstraat 36,2022-11-29,03:00:00,10,3,7,FMN 02 Mercatorstraat
650,Mercatorstraat 36,2022-11-29,04:00:00,25,17,8,FMN 02 Mercatorstraat
650,Mercatorstraat 36,2022-11-29,05:00:00,45,27,18,FMN 02 Mercatorstraat
650,Mercatorstraat 36,2022-11-29,06:00:00,142,94,48,FMN 02 Mercatorstraat
650,Mercatorstraat 36,2022-11-29,07:00:00,477,304,173,FMN 02 Mercatorstraat
650,Mercatorstraat 36,2022-11-29,08:00:00,1112,792,320,FMN 02 Mercatorstraat
650,Mercatorstraat 36,2022-11-29,09:00:00,453,341,112,FMN 02 Mercatorstraat
650,Mercatorstraat 36,2022-11-29,10:00:00,280,187,93,FMN 02 Mercatorstraat
650,Mercatorstraat 36,2022-11-29,11:00:00,252,136,116,FMN 02 Mercatorstraat
650,Mercatorstraat 36,2022-11-29,12:00:00,394,197,197,FMN 02 Mercatorstraat
650,Mercatorstraat 36,2022-11-29,13:00:00,401,199,202,FMN 02 Mercatorstraat
650,Mercatorstraat 36,2022-11-29,14:00:00,321,147,174,FMN 02 Mercatorstraat
650,Mercatorstraat 36,2022-11-29,15:00:00,536,158,378,FMN 02 Mercatorstraat
650,Mercatorstraat 36,2022-11-29,16:00:00,803,224,579,FMN 02 Mercatorstraat
650,Mercatorstraat 36,2022-11-29,17:00:00,843,307,536,FMN 02 Mercatorstraat
650,Mercatorstraat 36,2022-11-29,18:00:00,641,234,407,FMN 02 Mercatorstraat
650,Mercatorstraat 36,2022-11-29,19:00:00,354,159,195,FMN 02 Mercatorstraat
650,Mercatorstraat 36,2022-11-29,20:00:00,252,120,132,FMN 02 Mercatorstraat
650,Mercatorstraat 36,2022-11-29,21:00:00,223,88,135,FMN 02 Mercatorstraat
650,Mercatorstraat 36,2022-11-29,22:00:00,209,62,147,FMN 02 Mercatorstraat
650,Mercatorstraat 36,2022-11-29,23:00:00,98,38,60,FMN 02 Mercatorstraat
650,Mercatorstraat 36,2022-11-30,00:00:00,73,33,40,FMN 02 Mercatorstraat
650,Mercatorstraat 36,2022-11-30,01:00:00,36,14,22,FMN 02 Mercatorstraat
650,Mercatorstraat 36,2022-11-30,02:00:00,24,1,23,FMN 02 Mercatorstraat
650,Mercatorstraat 36,2022-11-30,03:00:00,13,3,10,FMN 02 Mercatorstraat
650,Mercatorstraat 36,2022-11-30,04:00:00,28,17,11,FMN 02 Mercatorstraat
650,Mercatorstraat 36,2022-11-30,05:00:00,62,38,24,FMN 02 Mercatorstraat
650,Mercatorstraat 36,2022-11-30,06:00:00,114,78,36,FMN 02 Mercatorstraat
650,Mercatorstraat 36,2022-11-30,07:00:00,424,260,164,FMN 02 Mercatorstraat
650,Mercatorstraat 36,2022-11-30,08:00:00,1001,716,285,FMN 02 Mercatorstraat
650,Mercatorstraat 36,2022-11-30,09:00:00,434,326,108,FMN 02 Mercatorstraat
650,Mercatorstraat 36,2022-11-30,10:00:00,260,155,105,FMN 02 Mercatorstraat
650,Mercatorstraat 36,2022-11-30,11:00:00,270,124,146,FMN 02 Mercatorstraat
650,Mercatorstraat 36,2022-11-30,12:00:00,579,239,340,FMN 02 Mercatorstraat
650,Mercatorstraat 36,2022-11-30,13:00:00,473,209,264,FMN 02 Mercatorstraat
650,Mercatorstraat 36,2022-11-30,14:00:00,370,189,181,FMN 02 Mercatorstraat
650,Mercatorstraat 36,2022-11-30,15:00:00,413,171,242,FMN 02 Mercatorstraat
650,Mercatorstraat 36,2022-11-30,16:00:00,580,191,389,FMN 02 Mercatorstraat
650,Mercatorstraat 36,2022-11-30,17:00:00,695,250,445,FMN 02 Mercatorstraat
650,Mercatorstraat 36,2022-11-30,18:00:00,478,173,305,FMN 02 Mercatorstraat
650,Mercatorstraat 36,2022-11-30,19:00:00,156,82,74,FMN 02 Mercatorstraat
650,Mercatorstraat 36,2022-11-30,20:00:00,228,129,99,FMN 02 Mercatorstraat
650,Mercatorstraat 36,2022-11-30,21:00:00,196,72,124,FMN 02 Mercatorstraat
650,Mercatorstraat 36,2022-11-30,22:00:00,199,63,136,FMN 02 Mercatorstraat
650,Mercatorstraat 36,2022-11-30,23:00:00,103,36,67,FMN 02 Mercatorstraat
650,Mercatorstraat 36,2022-12-01,00:00:00,75,28,47,FMN 02 Mercatorstraat
650,Mercatorstraat 36,2022-12-01,01:00:00,25,6,19,FMN 02 Mercatorstraat
650,Mercatorstraat 36,2022-12-01,02:00:00,19,2,17,FMN 02 Mercatorstraat
650,Mercatorstraat 36,2022-12-01,03:00:00,19,9,10,FMN 02 Mercatorstraat
650,Mercatorstraat 36,2022-12-01,04:00:00,21,15,6,FMN 02 Mercatorstraat
650,Mercatorstraat 36,2022-12-01,05:00:00,51,31,20,FMN 02 Mercatorstraat
650,Mercatorstraat 36,2022-12-01,06:00:00,120,87,33,FMN 02 Mercatorstraat
650,Mercatorstraat 36,2022-12-01,07:00:00,464,279,185,FMN 02 Mercatorstraat
650,Mercatorstraat 36,2022-12-01,08:00:00,1097,777,320,FMN 02 Mercatorstraat
650,Mercatorstraat 36,2022-12-01,09:00:00,472,366,106,FMN 02 Mercatorstraat
650,Mercatorstraat 36,2022-12-01,10:00:00,266,161,105,FMN 02 Mercatorstraat
650,Mercatorstraat 36,2022-12-01,11:00:00,212,133,79,FMN 02 Mercatorstraat
650,Mercatorstraat 36,2022-12-01,12:00:00,391,195,196,FMN 02 Mercatorstraat
650,Mercatorstraat 36,2022-12-01,13:00:00,363,166,197,FMN 02 Mercatorstraat
650,Mercatorstraat 36,2022-12-01,14:00:00,343,129,214,FMN 02 Mercatorstraat
650,Mercatorstraat 36,2022-12-01,15:00:00,603,187,416,FMN 02 Mercatorstraat
650,Mercatorstraat 36,2022-12-01,16:00:00,608,200,408,FMN 02 Mercatorstraat
650,Mercatorstraat 36,2022-12-01,17:00:00,591,205,386,FMN 02 Mercatorstraat
650,Mercatorstraat 36,2022-12-01,18:00:00,669,256,413,FMN 02 Mercatorstraat
650,Mercatorstraat 36,2022-12-01,19:00:00,362,165,197,FMN 02 Mercatorstraat
650,Mercatorstraat 36,2022-12-01,20:00:00,253,113,140,FMN 02 Mercatorstraat
650,Mercatorstraat 36,2022-12-01,21:00:00,236,83,153,FMN 02 Mercatorstraat
650,Mercatorstraat 36,2022-12-01,22:00:00,202,57,145,FMN 02 Mercatorstraat
650,Mercatorstraat 36,2022-12-01,23:00:00,154,66,88,FMN 02 Mercatorstraat
650,Mercatorstraat 36,2022-12-02,00:00:00,65,27,38,FMN 02 Mercatorstraat
650,Mercatorstraat 36,2022-12-02,01:00:00,46,17,29,FMN 02 Mercatorstraat
650,Mercatorstraat 36,2022-12-02,02:00:00,25,3,22,FMN 02 Mercatorstraat
650,Mercatorstraat 36,2022-12-02,03:00:00,20,7,13,FMN 02 Mercatorstraat
650,Mercatorstraat 36,2022-12-02,04:00:00,28,13,15,FMN 02 Mercatorstraat
650,Mercatorstraat 36,2022-12-02,05:00:00,52,31,21,FMN 02 Mercatorstraat
650,Mercatorstraat 36,2022-12-02,06:00:00,110,76,34,FMN 02 Mercatorstraat
650,Mercatorstraat 36,2022-12-02,07:00:00,368,220,148,FMN 02 Mercatorstraat
650,Mercatorstraat 36,2022-12-02,08:00:00,913,657,256,FMN 02 Mercatorstraat
650,Mercatorstraat 36,2022-12-02,09:00:00,445,340,105,FMN 02 Mercatorstraat
650,Mercatorstraat 36,2022-12-02,10:00:00,272,183,89,FMN 02 Mercatorstraat
650,Mercatorstraat 36,2022-12-02,11:00:00,254,149,105,FMN 02 Mercatorstraat
650,Mercatorstraat 36,2022-12-02,12:00:00,443,216,227,FMN 02 Mercatorstraat
650,Mercatorstraat 36,2022-12-02,13:00:00,329,156,173,FMN 02 Mercatorstraat
650,Mercatorstraat 36,2022-12-02,14:00:00,303,133,170,FMN 02 Mercatorstraat
650,Mercatorstraat 36,2022-12-02,15:00:00,495,148,347,FMN 02 Mercatorstraat
650,Mercatorstraat 36,2022-12-02,16:00:00,610,210,400,FMN 02 Mercatorstraat
650,Mercatorstraat 36,2022-12-02,17:00:00,551,168,383,FMN 02 Mercatorstraat
650,Mercatorstraat 36,2022-12-02,18:00:00,452,190,262,FMN 02 Mercatorstraat
650,Mercatorstraat 36,2022-12-02,19:00:00,347,201,146,FMN 02 Mercatorstraat
650,Mercatorstraat 36,2022-12-02,20:00:00,216,100,116,FMN 02 Mercatorstraat
650,Mercatorstraat 36,2022-12-02,21:00:00,183,87,96,FMN 02 Mercatorstraat
650,Mercatorstraat 36,2022-12-02,22:00:00,175,61,114,FMN 02 Mercatorstraat
650,Mercatorstraat 36,2022-12-02,23:00:00,156,60,96,FMN 02 Mercatorstraat
650,Mercatorstraat 36,2022-12-03,00:00:00,173,77,96,FMN 02 Mercatorstraat
650,Mercatorstraat 36,2022-12-03,01:00:00,91,46,45,FMN 02 Mercatorstraat
650,Mercatorstraat 36,2022-12-03,02:00:00,66,19,47,FMN 02 Mercatorstraat
650,Mercatorstraat 36,2022-12-03,03:00:00,56,18,38,FMN 02 Mercatorstraat
650,Mercatorstraat 36,2022-12-03,04:00:00,40,13,27,FMN 02 Mercatorstraat
650,Mercatorstraat 36,2022-12-03,05:00:00,41,24,17,FMN 02 Mercatorstraat
650,Mercatorstraat 36,2022-12-03,06:00:00,40,22,18,FMN 02 Mercatorstraat
650,Mercatorstraat 36,2022-12-03,07:00:00,37,16,21,FMN 02 Mercatorstraat
650,Mercatorstraat 36,2022-12-03,08:00:00,95,56,39,FMN 02 Mercatorstraat
650,Mercatorstraat 36,2022-12-03,09:00:00,176,124,52,FMN 02 Mercatorstraat
650,Mercatorstraat 36,2022-12-03,10:00:00,224,151,73,FMN 02 Mercatorstraat
650,Mercatorstraat 36,2022-12-03,11:00:00,230,134,96,FMN 02 Mercatorstraat
650,Mercatorstraat 36,2022-12-03,12:00:00,224,118,106,FMN 02 Mercatorstraat
650,Mercatorstraat 36,2022-12-03,13:00:00,265,148,117,FMN 02 Mercatorstraat
650,Mercatorstraat 36,2022-12-03,14:00:00,319,182,137,FMN 02 Mercatorstraat
650,Mercatorstraat 36,2022-12-03,15:00:00,274,144,130,FMN 02 Mercatorstraat
650,Mercatorstraat 36,2022-12-03,16:00:00,274,98,176,FMN 02 Mercatorstraat
650,Mercatorstraat 36,2022-12-03,17:00:00,277,110,167,FMN 02 Mercatorstraat
650,Mercatorstraat 36,2022-12-03,18:00:00,246,110,136,FMN 02 Mercatorstraat
650,Mercatorstraat 36,2022-12-03,19:00:00,302,187,115,FMN 02 Mercatorstraat
650,Mercatorstraat 36,2022-12-03,20:00:00,184,82,102,FMN 02 Mercatorstraat
650,Mercatorstraat 36,2022-12-03,21:00:00,174,86,88,FMN 02 Mercatorstraat
650,Mercatorstraat 36,2022-12-03,22:00:00,183,79,104,FMN 02 Mercatorstraat
650,Mercatorstraat 36,2022-12-03,23:00:00,159,55,104,FMN 02 Mercatorstraat
650,Mercatorstraat 36,2022-12-04,00:00:00,172,64,108,FMN 02 Mercatorstraat
650,Mercatorstraat 36,2022-12-04,01:00:00,126,61,65,FMN 02 Mercatorstraat
650,Mercatorstraat 36,2022-12-04,02:00:00,67,40,27,FMN 02 Mercatorstraat
650,Mercatorstraat 36,2022-12-04,03:00:00,53,25,28,FMN 02 Mercatorstraat
650,Mercatorstraat 36,2022-12-04,04:00:00,32,7,25,FMN 02 Mercatorstraat
650,Mercatorstraat 36,2022-12-04,05:00:00,32,12,20,FMN 02 Mercatorstraat
650,Mercatorstraat 36,2022-12-04,06:00:00,32,11,21,FMN 02 Mercatorstraat
650,Mercatorstraat 36,2022-12-04,07:00:00,58,23,35,FMN 02 Mercatorstraat
650,Mercatorstraat 36,2022-12-04,08:00:00,91,31,60,FMN 02 Mercatorstraat
650,Mercatorstraat 36,2022-12-04,09:00:00,188,78,110,FMN 02 Mercatorstraat
650,Mercatorstraat 36,2022-12-04,10:00:00,148,104,44,FMN 02 Mercatorstraat
650,Mercatorstraat 36,2022-12-04,11:00:00,228,150,78,FMN 02 Mercatorstraat
650,Mercatorstraat 36,2022-12-04,12:00:00,246,148,98,FMN 02 Mercatorstraat
650,Mercatorstraat 36,2022-12-04,13:00:00,260,134,126,FMN 02 Mercatorstraat
650,Mercatorstraat 36,2022-12-04,14:00:00,309,183,126,FMN 02 Mercatorstraat
650,Mercatorstraat 36,2022-12-04,15:00:00,220,110,110,FMN 02 Mercatorstraat
650,Mercatorstraat 36,2022-12-04,16:00:00,241,83,158,FMN 02 Mercatorstraat
650,Mercatorstraat 36,2022-12-04,17:00:00,240,66,174,FMN 02 Mercatorstraat
650,Mercatorstraat 36,2022-12-04,18:00:00,216,101,115,FMN 02 Mercatorstraat
650,Mercatorstraat 36,2022-12-04,19:00:00,196,116,80,FMN 02 Mercatorstraat
650,Mercatorstraat 36,2022-12-04,20:00:00,142,62,80,FMN 02 Mercatorstraat
650,Mercatorstraat 36,2022-12-04,21:00:00,111,53,58,FMN 02 Mercatorstraat
650,Mercatorstraat 36,2022-12-04,22:00:00,100,32,68,FMN 02 Mercatorstraat
650,Mercatorstraat 36,2022-12-04,23:00:00,53,15,38,FMN 02 Mercatorstraat
650,Mercatorstraat 36,2022-12-05,00:00:00,31,11,20,FMN 02 Mercatorstraat
650,Mercatorstraat 36,2022-12-05,01:00:00,15,7,8,FMN 02 Mercatorstraat
650,Mercatorstraat 36,2022-12-05,02:00:00,13,6,7,FMN 02 Mercatorstraat
650,Mercatorstraat 36,2022-12-05,03:00:00,11,7,4,FMN 02 Mercatorstraat
650,Mercatorstraat 36,2022-12-05,04:00:00,21,13,8,FMN 02 Mercatorstraat
650,Mercatorstraat 36,2022-12-05,05:00:00,29,16,13,FMN 02 Mercatorstraat
650,Mercatorstraat 36,2022-12-05,06:00:00,106,72,34,FMN 02 Mercatorstraat
650,Mercatorstraat 36,2022-12-05,07:00:00,344,215,129,FMN 02 Mercatorstraat
650,Mercatorstraat 36,2022-12-05,08:00:00,917,646,271,FMN 02 Mercatorstraat
650,Mercatorstraat 36,2022-12-05,09:00:00,377,281,96,FMN 02 Mercatorstraat
650,Mercatorstraat 36,2022-12-05,10:00:00,186,118,68,FMN 02 Mercatorstraat
650,Mercatorstraat 36,2022-12-05,11:00:00,188,100,88,FMN 02 Mercatorstraat
650,Mercatorstraat 36,2022-12-05,12:00:00,310,138,172,FMN 02 Mercatorstraat
650,Mercatorstraat 36,2022-12-05,13:00:00,294,132,162,FMN 02 Mercatorstraat
650,Mercatorstraat 36,2022-12-05,14:00:00,270,131,139,FMN 02 Mercatorstraat
650,Mercatorstraat 36,2022-12-05,15:00:00,397,133,264,FMN 02 Mercatorstraat
650,Mercatorstraat 36,2022-12-05,16:00:00,561,168,393,FMN 02 Mercatorstraat
650,Mercatorstraat 36,2022-12-05,17:00:00,653,224,429,FMN 02 Mercatorstraat
650,Mercatorstraat 36,2022-12-05,18:00:00,478,174,304,FMN 02 Mercatorstraat
650,Mercatorstraat 36,2022-12-05,19:00:00,221,97,124,FMN 02 Mercatorstraat
650,Mercatorstraat 36,2022-12-05,20:00:00,1,1,0,FMN 02 Mercatorstraat
650,Mercatorstraat 36,2022-12-05,21:00:00,6,0,6,FMN 02 Mercatorstraat
650,Mercatorstraat 36,2022-12-05,22:00:00,0,0,0,FMN 02 Mercatorstraat
650,Mercatorstraat 36,2022-12-05,23:00:00,75,32,43,FMN 02 Mercatorstraat
650,Mercatorstraat 36,2022-12-06,00:00:00,34,14,20,FMN 02 Mercatorstraat
650,Mercatorstraat 36,2022-12-06,01:00:00,15,5,10,FMN 02 Mercatorstraat
650,Mercatorstraat 36,2022-12-06,02:00:00,9,3,6,FMN 02 Mercatorstraat
650,Mercatorstraat 36,2022-12-06,03:00:00,8,3,5,FMN 02 Mercatorstraat
650,Mercatorstraat 36,2022-12-06,04:00:00,25,13,12,FMN 02 Mercatorstraat
650,Mercatorstraat 36,2022-12-06,05:00:00,39,26,13,FMN 02 Mercatorstraat
650,Mercatorstraat 36,2022-12-06,06:00:00,118,87,31,FMN 02 Mercatorstraat
650,Mercatorstraat 36,2022-12-06,07:00:00,425,273,152,FMN 02 Mercatorstraat
650,Mercatorstraat 36,2022-12-06,08:00:00,997,673,324,FMN 02 Mercatorstraat
650,Mercatorstraat 36,2022-12-06,09:00:00,460,350,110,FMN 02 Mercatorstraat
650,Mercatorstraat 36,2022-12-06,10:00:00,278,183,95,FMN 02 Mercatorstraat
650,Mercatorstraat 36,2022-12-06,11:00:00,247,134,113,FMN 02 Mercatorstraat
650,Mercatorstraat 36,2022-12-06,12:00:00,389,189,200,FMN 02 Mercatorstraat
650,Mercatorstraat 36,2022-12-06,13:00:00,340,172,168,FMN 02 Mercatorstraat
650,Mercatorstraat 36,2022-12-06,14:00:00,289,136,153,FMN 02 Mercatorstraat
650,Mercatorstraat 36,2022-12-06,15:00:00,482,174,308,FMN 02 Mercatorstraat
650,Mercatorstraat 36,2022-12-06,16:00:00,562,172,390,FMN 02 Mercatorstraat
650,Mercatorstraat 36,2022-12-06,17:00:00,747,253,494,FMN 02 Mercatorstraat
650,Mercatorstraat 36,2022-12-06,18:00:00,521,194,327,FMN 02 Mercatorstraat
650,Mercatorstraat 36,2022-12-06,19:00:00,280,115,165,FMN 02 Mercatorstraat
650,Mercatorstraat 36,2022-12-06,20:00:00,203,73,130,FMN 02 Mercatorstraat
650,Mercatorstraat 36,2022-12-06,21:00:00,200,81,119,FMN 02 Mercatorstraat
650,Mercatorstraat 36,2022-12-06,22:00:00,192,65,127,FMN 02 Mercatorstraat
650,Mercatorstraat 36,2022-12-06,23:00:00,93,38,55,FMN 02 Mercatorstraat
650,Mercatorstraat 36,2022-12-07,00:00:00,30,8,22,FMN 02 Mercatorstraat
650,Mercatorstraat 36,2022-12-07,01:00:00,16,4,12,FMN 02 Mercatorstraat
650,Mercatorstraat 36,2022-12-07,02:00:00,14,5,9,FMN 02 Mercatorstraat
650,Mercatorstraat 36,2022-12-07,03:00:00,10,3,7,FMN 02 Mercatorstraat
650,Mercatorstraat 36,2022-12-07,04:00:00,23,18,5,FMN 02 Mercatorstraat
650,Mercatorstraat 36,2022-12-07,05:00:00,50,31,19,FMN 02 Mercatorstraat
650,Mercatorstraat 36,2022-12-07,06:00:00,111,75,36,FMN 02 Mercatorstraat
650,Mercatorstraat 36,2022-12-07,07:00:00,364,237,127,FMN 02 Mercatorstraat
650,Mercatorstraat 36,2022-12-07,08:00:00,918,649,269,FMN 02 Mercatorstraat
650,Mercatorstraat 36,2022-12-07,09:00:00,435,300,135,FMN 02 Mercatorstraat
650,Mercatorstraat 36,2022-12-07,10:00:00,259,144,115,FMN 02 Mercatorstraat
650,Mercatorstraat 36,2022-12-07,11:00:00,248,109,139,FMN 02 Mercatorstraat
650,Mercatorstraat 36,2022-12-07,12:00:00,504,186,318,FMN 02 Mercatorstraat
650,Mercatorstraat 36,2022-12-07,13:00:00,362,175,187,FMN 02 Mercatorstraat
650,Mercatorstraat 36,2022-12-07,14:00:00,284,121,163,FMN 02 Mercatorstraat
650,Mercatorstraat 36,2022-12-07,15:00:00,312,130,182,FMN 02 Mercatorstraat
650,Mercatorstraat 36,2022-12-07,16:00:00,438,155,283,FMN 02 Mercatorstraat
650,Mercatorstraat 36,2022-12-07,17:00:00,624,197,427,FMN 02 Mercatorstraat
650,Mercatorstraat 36,2022-12-07,18:00:00,465,170,295,FMN 02 Mercatorstraat
650,Mercatorstraat 36,2022-12-07,19:00:00,289,144,145,FMN 02 Mercatorstraat
650,Mercatorstraat 36,2022-12-07,20:00:00,193,85,108,FMN 02 Mercatorstraat
650,Mercatorstraat 36,2022-12-07,21:00:00,208,95,113,FMN 02 Mercatorstraat
650,Mercatorstraat 36,2022-12-07,22:00:00,175,75,100,FMN 02 Mercatorstraat
650,Mercatorstraat 36,2022-12-07,23:00:00,110,41,69,FMN 02 Mercatorstraat
650,Mercatorstraat 36,2022-12-08,00:00:00,70,19,51,FMN 02 Mercatorstraat
650,Mercatorstraat 36,2022-12-08,01:00:00,27,4,23,FMN 02 Mercatorstraat
650,Mercatorstraat 36,2022-12-08,02:00:00,19,6,13,FMN 02 Mercatorstraat
650,Mercatorstraat 36,2022-12-08,03:00:00,23,9,14,FMN 02 Mercatorstraat
650,Mercatorstraat 36,2022-12-08,04:00:00,35,22,13,FMN 02 Mercatorstraat
650,Mercatorstraat 36,2022-12-08,05:00:00,38,22,16,FMN 02 Mercatorstraat
650,Mercatorstraat 36,2022-12-08,06:00:00,91,63,28,FMN 02 Mercatorstraat
650,Mercatorstraat 36,2022-12-08,07:00:00,357,226,131,FMN 02 Mercatorstraat
650,Mercatorstraat 36,2022-12-08,08:00:00,960,667,293,FMN 02 Mercatorstraat
650,Mercatorstraat 36,2022-12-08,09:00:00,400,288,112,FMN 02 Mercatorstraat
650,Mercatorstraat 36,2022-12-08,10:00:00,265,168,97,FMN 02 Mercatorstraat
650,Mercatorstraat 36,2022-12-08,11:00:00,301,150,151,FMN 02 Mercatorstraat
650,Mercatorstraat 36,2022-12-08,12:00:00,387,174,213,FMN 02 Mercatorstraat
650,Mercatorstraat 36,2022-12-08,13:00:00,281,136,145,FMN 02 Mercatorstraat
650,Mercatorstraat 36,2022-12-08,14:00:00,221,97,124,FMN 02 Mercatorstraat
650,Mercatorstraat 36,2022-12-08,15:00:00,362,122,240,FMN 02 Mercatorstraat
650,Mercatorstraat 36,2022-12-08,16:00:00,537,175,362,FMN 02 Mercatorstraat
650,Mercatorstraat 36,2022-12-08,17:00:00,655,215,440,FMN 02 Mercatorstraat
650,Mercatorstraat 36,2022-12-08,18:00:00,517,213,304,FMN 02 Mercatorstraat
650,Mercatorstraat 36,2022-12-08,19:00:00,316,155,161,FMN 02 Mercatorstraat
650,Mercatorstraat 36,2022-12-08,20:00:00,174,71,103,FMN 02 Mercatorstraat
650,Mercatorstraat 36,2022-12-08,21:00:00,206,79,127,FMN 02 Mercatorstraat
650,Mercatorstraat 36,2022-12-08,22:00:00,167,56,111,FMN 02 Mercatorstraat
650,Mercatorstraat 36,2022-12-08,23:00:00,126,41,85,FMN 02 Mercatorstraat
650,Mercatorstraat 36,2022-12-09,00:00:00,76,36,40,FMN 02 Mercatorstraat
650,Mercatorstraat 36,2022-12-09,01:00:00,36,15,21,FMN 02 Mercatorstraat
650,Mercatorstraat 36,2022-12-09,02:00:00,31,7,24,FMN 02 Mercatorstraat
650,Mercatorstraat 36,2022-12-09,03:00:00,25,9,16,FMN 02 Mercatorstraat
650,Mercatorstraat 36,2022-12-09,04:00:00,36,17,19,FMN 02 Mercatorstraat
650,Mercatorstraat 36,2022-12-09,05:00:00,39,21,18,FMN 02 Mercatorstraat
650,Mercatorstraat 36,2022-12-09,06:00:00,81,56,25,FMN 02 Mercatorstraat
650,Mercatorstraat 36,2022-12-09,07:00:00,311,189,122,FMN 02 Mercatorstraat
650,Mercatorstraat 36,2022-12-09,08:00:00,860,615,245,FMN 02 Mercatorstraat
650,Mercatorstraat 36,2022-12-09,09:00:00,371,263,108,FMN 02 Mercatorstraat
650,Mercatorstraat 36,2022-12-09,10:00:00,301,181,120,FMN 02 Mercatorstraat
650,Mercatorstraat 36,2022-12-09,11:00:00,259,153,106,FMN 02 Mercatorstraat
650,Mercatorstraat 36,2022-12-09,12:00:00,420,185,235,FMN 02 Mercatorstraat
650,Mercatorstraat 36,2022-12-09,13:00:00,370,188,182,FMN 02 Mercatorstraat
650,Mercatorstraat 36,2022-12-09,14:00:00,334,129,205,FMN 02 Mercatorstraat
650,Mercatorstraat 36,2022-12-09,15:00:00,421,132,289,FMN 02 Mercatorstraat
650,Mercatorstraat 36,2022-12-09,16:00:00,529,186,343,FMN 02 Mercatorstraat
650,Mercatorstraat 36,2022-12-09,17:00:00,554,184,370,FMN 02 Mercatorstraat
650,Mercatorstraat 36,2022-12-09,18:00:00,404,158,246,FMN 02 Mercatorstraat
650,Mercatorstraat 36,2022-12-09,19:00:00,296,162,134,FMN 02 Mercatorstraat
650,Mercatorstraat 36,2022-12-09,20:00:00,203,93,110,FMN 02 Mercatorstraat
650,Mercatorstraat 36,2022-12-09,21:00:00,204,98,106,FMN 02 Mercatorstraat
650,Mercatorstraat 36,2022-12-09,22:00:00,142,51,91,FMN 02 Mercatorstraat
650,Mercatorstraat 36,2022-12-09,23:00:00,179,67,112,FMN 02 Mercatorstraat
650,Mercatorstraat 36,2022-12-10,00:00:00,167,49,118,FMN 02 Mercatorstraat
650,Mercatorstraat 36,2022-12-10,01:00:00,124,54,70,FMN 02 Mercatorstraat
650,Mercatorstraat 36,2022-12-10,02:00:00,84,16,68,FMN 02 Mercatorstraat
650,Mercatorstraat 36,2022-12-10,03:00:00,47,12,35,FMN 02 Mercatorstraat
650,Mercatorstraat 36,2022-12-10,04:00:00,57,12,45,FMN 02 Mercatorstraat
650,Mercatorstraat 36,2022-12-10,05:00:00,43,16,27,FMN 02 Mercatorstraat
650,Mercatorstraat 36,2022-12-10,06:00:00,35,16,19,FMN 02 Mercatorstraat
650,Mercatorstraat 36,2022-12-10,07:00:00,54,25,29,FMN 02 Mercatorstraat
650,Mercatorstraat 36,2022-12-10,08:00:00,81,52,29,FMN 02 Mercatorstraat
650,Mercatorstraat 36,2022-12-10,09:00:00,143,113,30,FMN 02 Mercatorstraat
650,Mercatorstraat 36,2022-12-10,10:00:00,180,115,65,FMN 02 Mercatorstraat
650,Mercatorstraat 36,2022-12-10,11:00:00,197,129,68,FMN 02 Mercatorstraat
650,Mercatorstraat 36,2022-12-10,12:00:00,229,131,98,FMN 02 Mercatorstraat
650,Mercatorstraat 36,2022-12-10,13:00:00,243,153,90,FMN 02 Mercatorstraat
650,Mercatorstraat 36,2022-12-10,14:00:00,310,196,114,FMN 02 Mercatorstraat
650,Mercatorstraat 36,2022-12-10,15:00:00,252,138,114,FMN 02 Mercatorstraat
650,Mercatorstraat 36,2022-12-10,16:00:00,232,102,130,FMN 02 Mercatorstraat
650,Mercatorstraat 36,2022-12-10,17:00:00,267,113,154,FMN 02 Mercatorstraat
650,Mercatorstraat 36,2022-12-10,18:00:00,269,128,141,FMN 02 Mercatorstraat
650,Mercatorstraat 36,2022-12-10,19:00:00,250,119,131,FMN 02 Mercatorstraat
650,Mercatorstraat 36,2022-12-10,20:00:00,155,89,66,FMN 02 Mercatorstraat
650,Mercatorstraat 36,2022-12-10,21:00:00,121,59,62,FMN 02 Mercatorstraat
650,Mercatorstraat 36,2022-12-10,22:00:00,137,57,80,FMN 02 Mercatorstraat
650,Mercatorstraat 36,2022-12-10,23:00:00,126,44,82,FMN 02 Mercatorstraat
650,Mercatorstraat 36,2022-12-11,00:00:00,119,52,67,FMN 02 Mercatorstraat
650,Mercatorstraat 36,2022-12-11,01:00:00,102,38,64,FMN 02 Mercatorstraat
650,Mercatorstraat 36,2022-12-11,02:00:00,73,21,52,FMN 02 Mercatorstraat
650,Mercatorstraat 36,2022-12-11,03:00:00,57,18,39,FMN 02 Mercatorstraat
650,Mercatorstraat 36,2022-12-11,04:00:00,59,22,37,FMN 02 Mercatorstraat
650,Mercatorstraat 36,2022-12-11,05:00:00,39,13,26,FMN 02 Mercatorstraat
650,Mercatorstraat 36,2022-12-11,06:00:00,39,23,16,FMN 02 Mercatorstraat
650,Mercatorstraat 36,2022-12-11,07:00:00,52,23,29,FMN 02 Mercatorstraat
650,Mercatorstraat 36,2022-12-11,08:00:00,87,40,47,FMN 02 Mercatorstraat
650,Mercatorstraat 36,2022-12-11,09:00:00,161,69,92,FMN 02 Mercatorstraat
650,Mercatorstraat 36,2022-12-11,10:00:00,158,103,55,FMN 02 Mercatorstraat
650,Mercatorstraat 36,2022-12-11,11:00:00,128,84,44,FMN 02 Mercatorstraat
650,Mercatorstraat 36,2022-12-11,12:00:00,220,136,84,FMN 02 Mercatorstraat
650,Mercatorstraat 36,2022-12-11,13:00:00,195,107,88,FMN 02 Mercatorstraat
650,Mercatorstraat 36,2022-12-11,14:00:00,259,145,114,FMN 02 Mercatorstraat
650,Mercatorstraat 36,2022-12-11,15:00:00,204,106,98,FMN 02 Mercatorstraat
650,Mercatorstraat 36,2022-12-11,16:00:00,218,71,147,FMN 02 Mercatorstraat
650,Mercatorstraat 36,2022-12-11,17:00:00,199,95,104,FMN 02 Mercatorstraat
650,Mercatorstraat 36,2022-12-11,18:00:00,205,81,124,FMN 02 Mercatorstraat
650,Mercatorstraat 36,2022-12-11,19:00:00,147,65,82,FMN 02 Mercatorstraat
650,Mercatorstraat 36,2022-12-11,20:00:00,153,73,80,FMN 02 Mercatorstraat
650,Mercatorstraat 36,2022-12-11,21:00:00,109,46,63,FMN 02 Mercatorstraat
650,Mercatorstraat 36,2022-12-11,22:00:00,94,32,62,FMN 02 Mercatorstraat
650,Mercatorstraat 36,2022-12-11,23:00:00,48,21,27,FMN 02 Mercatorstraat
650,Mercatorstraat 36,2022-12-12,00:00:00,29,5,24,FMN 02 Mercatorstraat
650,Mercatorstraat 36,2022-12-12,01:00:00,22,7,15,FMN 02 Mercatorstraat
650,Mercatorstraat 36,2022-12-12,02:00:00,14,4,10,FMN 02 Mercatorstraat
650,Mercatorstraat 36,2022-12-12,03:00:00,4,4,0,FMN 02 Mercatorstraat
650,Mercatorstraat 36,2022-12-12,04:00:00,22,13,9,FMN 02 Mercatorstraat
650,Mercatorstraat 36,2022-12-12,05:00:00,39,23,16,FMN 02 Mercatorstraat
650,Mercatorstraat 36,2022-12-12,06:00:00,77,55,22,FMN 02 Mercatorstraat
650,Mercatorstraat 36,2022-12-12,07:00:00,329,203,126,FMN 02 Mercatorstraat
650,Mercatorstraat 36,2022-12-12,08:00:00,885,605,280,FMN 02 Mercatorstraat
650,Mercatorstraat 36,2022-12-12,09:00:00,386,277,109,FMN 02 Mercatorstraat
650,Mercatorstraat 36,2022-12-12,10:00:00,247,141,106,FMN 02 Mercatorstraat
650,Mercatorstraat 36,2022-12-12,11:00:00,242,112,130,FMN 02 Mercatorstraat
650,Mercatorstraat 36,2022-12-12,12:00:00,331,143,188,FMN 02 Mercatorstraat
650,Mercatorstraat 36,2022-12-12,13:00:00,267,131,136,FMN 02 Mercatorstraat
650,Mercatorstraat 36,2022-12-12,14:00:00,274,147,127,FMN 02 Mercatorstraat
650,Mercatorstraat 36,2022-12-12,15:00:00,341,124,217,FMN 02 Mercatorstraat
650,Mercatorstraat 36,2022-12-12,16:00:00,514,173,341,FMN 02 Mercatorstraat
650,Mercatorstraat 36,2022-12-12,17:00:00,588,185,403,FMN 02 Mercatorstraat
650,Mercatorstraat 36,2022-12-12,18:00:00,442,157,285,FMN 02 Mercatorstraat
650,Mercatorstraat 36,2022-12-12,19:00:00,247,113,134,FMN 02 Mercatorstraat
650,Mercatorstraat 36,2022-12-12,20:00:00,173,74,99,FMN 02 Mercatorstraat
650,Mercatorstraat 36,2022-12-12,21:00:00,168,54,114,FMN 02 Mercatorstraat
650,Mercatorstraat 36,2022-12-12,22:00:00,111,41,70,FMN 02 Mercatorstraat
650,Mercatorstraat 36,2022-12-12,23:00:00,52,15,37,FMN 02 Mercatorstraat
650,Mercatorstraat 36,2022-12-13,00:00:00,23,8,15,FMN 02 Mercatorstraat
650,Mercatorstraat 36,2022-12-13,01:00:00,11,2,9,FMN 02 Mercatorstraat
650,Mercatorstraat 36,2022-12-13,02:00:00,8,2,6,FMN 02 Mercatorstraat
650,Mercatorstraat 36,2022-12-13,03:00:00,7,2,5,FMN 02 Mercatorstraat
650,Mercatorstraat 36,2022-12-13,04:00:00,17,11,6,FMN 02 Mercatorstraat
650,Mercatorstraat 36,2022-12-13,05:00:00,33,21,12,FMN 02 Mercatorstraat
650,Mercatorstraat 36,2022-12-13,06:00:00,76,45,31,FMN 02 Mercatorstraat
650,Mercatorstraat 36,2022-12-13,07:00:00,355,221,134,FMN 02 Mercatorstraat
650,Mercatorstraat 36,2022-12-13,08:00:00,903,618,285,FMN 02 Mercatorstraat
650,Mercatorstraat 36,2022-12-13,09:00:00,419,296,123,FMN 02 Mercatorstraat
650,Mercatorstraat 36,2022-12-13,10:00:00,284,153,131,FMN 02 Mercatorstraat
650,Mercatorstraat 36,2022-12-13,11:00:00,228,114,114,FMN 02 Mercatorstraat
650,Mercatorstraat 36,2022-12-13,12:00:00,322,153,169,FMN 02 Mercatorstraat
650,Mercatorstraat 36,2022-12-13,13:00:00,309,166,143,FMN 02 Mercatorstraat
650,Mercatorstraat 36,2022-12-13,14:00:00,297,145,152,FMN 02 Mercatorstraat
650,Mercatorstraat 36,2022-12-13,15:00:00,295,99,196,FMN 02 Mercatorstraat
650,Mercatorstraat 36,2022-12-13,16:00:00,491,162,329,FMN 02 Mercatorstraat
650,Mercatorstraat 36,2022-12-13,17:00:00,656,252,404,FMN 02 Mercatorstraat
650,Mercatorstraat 36,2022-12-13,18:00:00,463,178,285,FMN 02 Mercatorstraat
650,Mercatorstraat 36,2022-12-13,19:00:00,245,108,137,FMN 02 Mercatorstraat
650,Mercatorstraat 36,2022-12-13,20:00:00,162,78,84,FMN 02 Mercatorstraat
650,Mercatorstraat 36,2022-12-13,21:00:00,161,64,97,FMN 02 Mercatorstraat
650,Mercatorstraat 36,2022-12-13,22:00:00,156,48,108,FMN 02 Mercatorstraat
650,Mercatorstraat 36,2022-12-13,23:00:00,79,24,55,FMN 02 Mercatorstraat
650,Mercatorstraat 36,2022-12-14,00:00:00,37,14,23,FMN 02 Mercatorstraat
650,Mercatorstraat 36,2022-12-14,01:00:00,27,5,22,FMN 02 Mercatorstraat
650,Mercatorstraat 36,2022-12-14,02:00:00,19,5,14,FMN 02 Mercatorstraat
650,Mercatorstraat 36,2022-12-14,03:00:00,10,2,8,FMN 02 Mercatorstraat
650,Mercatorstraat 36,2022-12-14,04:00:00,23,17,6,FMN 02 Mercatorstraat
650,Mercatorstraat 36,2022-12-14,05:00:00,39,21,18,FMN 02 Mercatorstraat
650,Mercatorstraat 36,2022-12-14,06:00:00,82,57,25,FMN 02 Mercatorstraat
650,Mercatorstraat 36,2022-12-14,07:00:00,290,195,95,FMN 02 Mercatorstraat
650,Mercatorstraat 36,2022-12-14,08:00:00,815,546,269,FMN 02 Mercatorstraat
650,Mercatorstraat 36,2022-12-14,09:00:00,366,264,102,FMN 02 Mercatorstraat
650,Mercatorstraat 36,2022-12-14,10:00:00,275,149,126,FMN 02 Mercatorstraat
650,Mercatorstraat 36,2022-12-14,11:00:00,258,110,148,FMN 02 Mercatorstraat
650,Mercatorstraat 36,2022-12-14,12:00:00,377,161,216,FMN 02 Mercatorstraat
650,Mercatorstraat 36,2022-12-14,13:00:00,274,129,145,FMN 02 Mercatorstraat
650,Mercatorstraat 36,2022-12-14,14:00:00,294,132,162,FMN 02 Mercatorstraat
650,Mercatorstraat 36,2022-12-14,15:00:00,287,110,177,FMN 02 Mercatorstraat
650,Mercatorstraat 36,2022-12-14,16:00:00,372,137,235,FMN 02 Mercatorstraat
650,Mercatorstraat 36,2022-12-14,17:00:00,560,194,366,FMN 02 Mercatorstraat
650,Mercatorstraat 36,2022-12-14,18:00:00,455,164,291,FMN 02 Mercatorstraat
650,Mercatorstraat 36,2022-12-14,19:00:00,300,137,163,FMN 02 Mercatorstraat
650,Mercatorstraat 36,2022-12-14,20:00:00,163,64,99,FMN 02 Mercatorstraat
650,Mercatorstraat 36,2022-12-14,21:00:00,170,75,95,FMN 02 Mercatorstraat
650,Mercatorstraat 36,2022-12-14,22:00:00,184,55,129,FMN 02 Mercatorstraat
650,Mercatorstraat 36,2022-12-14,23:00:00,97,40,57,FMN 02 Mercatorstraat
650,Mercatorstraat 36,2022-12-15,00:00:00,46,22,24,FMN 02 Mercatorstraat
650,Mercatorstraat 36,2022-12-15,01:00:00,26,3,23,FMN 02 Mercatorstraat
650,Mercatorstraat 36,2022-12-15,02:00:00,20,5,15,FMN 02 Mercatorstraat
650,Mercatorstraat 36,2022-12-15,03:00:00,9,3,6,FMN 02 Mercatorstraat
650,Mercatorstraat 36,2022-12-15,04:00:00,18,12,6,FMN 02 Mercatorstraat
650,Mercatorstraat 36,2022-12-15,05:00:00,46,28,18,FMN 02 Mercatorstraat
650,Mercatorstraat 36,2022-12-15,06:00:00,76,56,20,FMN 02 Mercatorstraat
650,Mercatorstraat 36,2022-12-15,07:00:00,296,183,113,FMN 02 Mercatorstraat
650,Mercatorstraat 36,2022-12-15,08:00:00,944,673,271,FMN 02 Mercatorstraat
650,Mercatorstraat 36,2022-12-15,09:00:00,406,288,118,FMN 02 Mercatorstraat
650,Mercatorstraat 36,2022-12-15,10:00:00,291,162,129,FMN 02 Mercatorstraat
650,Mercatorstraat 36,2022-12-15,11:00:00,267,118,149,FMN 02 Mercatorstraat
650,Mercatorstraat 36,2022-12-15,12:00:00,358,165,193,FMN 02 Mercatorstraat
650,Mercatorstraat 36,2022-12-15,13:00:00,293,150,143,FMN 02 Mercatorstraat
650,Mercatorstraat 36,2022-12-15,14:00:00,270,120,150,FMN 02 Mercatorstraat
650,Mercatorstraat 36,2022-12-15,15:00:00,330,117,213,FMN 02 Mercatorstraat
650,Mercatorstraat 36,2022-12-15,16:00:00,491,175,316,FMN 02 Mercatorstraat
650,Mercatorstraat 36,2022-12-15,17:00:00,612,201,411,FMN 02 Mercatorstraat
650,Mercatorstraat 36,2022-12-15,18:00:00,452,186,266,FMN 02 Mercatorstraat
650,Mercatorstraat 36,2022-12-15,19:00:00,296,160,136,FMN 02 Mercatorstraat
650,Mercatorstraat 36,2022-12-15,20:00:00,231,98,133,FMN 02 Mercatorstraat
650,Mercatorstraat 36,2022-12-15,21:00:00,168,56,112,FMN 02 Mercatorstraat
650,Mercatorstraat 36,2022-12-15,22:00:00,182,62,120,FMN 02 Mercatorstraat
650,Mercatorstraat 36,2022-12-15,23:00:00,131,33,98,FMN 02 Mercatorstraat
650,Mercatorstraat 36,2022-12-16,00:00:00,65,30,35,FMN 02 Mercatorstraat
650,Mercatorstraat 36,2022-12-16,01:00:00,37,18,19,FMN 02 Mercatorstraat
650,Mercatorstraat 36,2022-12-16,02:00:00,27,10,17,FMN 02 Mercatorstraat
650,Mercatorstraat 36,2022-12-16,03:00:00,26,4,22,FMN 02 Mercatorstraat
650,Mercatorstraat 36,2022-12-16,04:00:00,19,13,6,FMN 02 Mercatorstraat
650,Mercatorstraat 36,2022-12-16,05:00:00,44,24,20,FMN 02 Mercatorstraat
650,Mercatorstraat 36,2022-12-16,06:00:00,76,50,26,FMN 02 Mercatorstraat
650,Mercatorstraat 36,2022-12-16,07:00:00,296,194,102,FMN 02 Mercatorstraat
650,Mercatorstraat 36,2022-12-16,08:00:00,808,544,264,FMN 02 Mercatorstraat
650,Mercatorstraat 36,2022-12-16,09:00:00,420,304,116,FMN 02 Mercatorstraat
650,Mercatorstraat 36,2022-12-16,10:00:00,341,211,130,FMN 02 Mercatorstraat
650,Mercatorstraat 36,2022-12-16,11:00:00,317,179,138,FMN 02 Mercatorstraat
650,Mercatorstraat 36,2022-12-16,12:00:00,441,230,211,FMN 02 Mercatorstraat
650,Mercatorstraat 36,2022-12-16,13:00:00,432,229,203,FMN 02 Mercatorstraat
650,Mercatorstraat 36,2022-12-16,14:00:00,420,188,232,FMN 02 Mercatorstraat
650,Mercatorstraat 36,2022-12-16,15:00:00,478,187,291,FMN 02 Mercatorstraat
650,Mercatorstraat 36,2022-12-16,16:00:00,547,178,369,FMN 02 Mercatorstraat
650,Mercatorstraat 36,2022-12-16,17:00:00,564,199,365,FMN 02 Mercatorstraat
650,Mercatorstraat 36,2022-12-16,18:00:00,465,190,275,FMN 02 Mercatorstraat
650,Mercatorstraat 36,2022-12-16,19:00:00,328,174,154,FMN 02 Mercatorstraat
650,Mercatorstraat 36,2022-12-16,20:00:00,271,142,129,FMN 02 Mercatorstraat
650,Mercatorstraat 36,2022-12-16,21:00:00,188,81,107,FMN 02 Mercatorstraat
650,Mercatorstraat 36,2022-12-16,22:00:00,199,64,135,FMN 02 Mercatorstraat
650,Mercatorstraat 36,2022-12-16,23:00:00,224,72,152,FMN 02 Mercatorstraat
650,Mercatorstraat 36,2022-12-17,00:00:00,154,48,106,FMN 02 Mercatorstraat
650,Mercatorstraat 36,2022-12-17,01:00:00,118,39,79,FMN 02 Mercatorstraat
650,Mercatorstraat 36,2022-12-17,02:00:00,81,24,57,FMN 02 Mercatorstraat
650,Mercatorstraat 36,2022-12-17,03:00:00,63,17,46,FMN 02 Mercatorstraat
650,Mercatorstraat 36,2022-12-17,04:00:00,38,10,28,FMN 02 Mercatorstraat
650,Mercatorstraat 36,2022-12-17,05:00:00,36,17,19,FMN 02 Mercatorstraat
650,Mercatorstraat 36,2022-12-17,06:00:00,29,16,13,FMN 02 Mercatorstraat
650,Mercatorstraat 36,2022-12-17,07:00:00,24,11,13,FMN 02 Mercatorstraat
650,Mercatorstraat 36,2022-12-17,08:00:00,70,47,23,FMN 02 Mercatorstraat
650,Mercatorstraat 36,2022-12-17,09:00:00,147,108,39,FMN 02 Mercatorstraat
650,Mercatorstraat 36,2022-12-17,10:00:00,153,98,55,FMN 02 Mercatorstraat
650,Mercatorstraat 36,2022-12-17,11:00:00,199,128,71,FMN 02 Mercatorstraat
650,Mercatorstraat 36,2022-12-17,12:00:00,243,146,97,FMN 02 Mercatorstraat
650,Mercatorstraat 36,2022-12-17,13:00:00,275,158,117,FMN 02 Mercatorstraat
650,Mercatorstraat 36,2022-12-17,14:00:00,305,183,122,FMN 02 Mercatorstraat
650,Mercatorstraat 36,2022-12-17,15:00:00,280,126,154,FMN 02 Mercatorstraat
650,Mercatorstraat 36,2022-12-17,16:00:00,285,100,185,FMN 02 Mercatorstraat
650,Mercatorstraat 36,2022-12-17,17:00:00,246,98,148,FMN 02 Mercatorstraat
650,Mercatorstraat 36,2022-12-17,18:00:00,243,114,129,FMN 02 Mercatorstraat
650,Mercatorstraat 36,2022-12-17,19:00:00,227,113,114,FMN 02 Mercatorstraat
650,Mercatorstraat 36,2022-12-17,20:00:00,143,88,55,FMN 02 Mercatorstraat
650,Mercatorstraat 36,2022-12-17,21:00:00,127,54,73,FMN 02 Mercatorstraat
650,Mercatorstraat 36,2022-12-17,22:00:00,147,53,94,FMN 02 Mercatorstraat
650,Mercatorstraat 36,2022-12-17,23:00:00,108,51,57,FMN 02 Mercatorstraat
650,Mercatorstraat 36,2022-12-18,00:00:00,111,41,70,FMN 02 Mercatorstraat
650,Mercatorstraat 36,2022-12-18,01:00:00,89,45,44,FMN 02 Mercatorstraat
650,Mercatorstraat 36,2022-12-18,02:00:00,70,26,44,FMN 02 Mercatorstraat
650,Mercatorstraat 36,2022-12-18,03:00:00,42,11,31,FMN 02 Mercatorstraat
650,Mercatorstraat 36,2022-12-18,04:00:00,31,9,22,FMN 02 Mercatorstraat
650,Mercatorstraat 36,2022-12-18,05:00:00,29,13,16,FMN 02 Mercatorstraat
650,Mercatorstraat 36,2022-12-18,06:00:00,26,14,12,FMN 02 Mercatorstraat
650,Mercatorstraat 36,2022-12-18,07:00:00,24,12,12,FMN 02 Mercatorstraat
650,Mercatorstraat 36,2022-12-18,08:00:00,97,36,61,FMN 02 Mercatorstraat
650,Mercatorstraat 36,2022-12-18,09:00:00,115,41,74,FMN 02 Mercatorstraat
650,Mercatorstraat 36,2022-12-18,10:00:00,129,79,50,FMN 02 Mercatorstraat
650,Mercatorstraat 36,2022-12-18,11:00:00,144,96,48,FMN 02 Mercatorstraat
650,Mercatorstraat 36,2022-12-18,12:00:00,198,110,88,FMN 02 Mercatorstraat
650,Mercatorstraat 36,2022-12-18,13:00:00,189,125,64,FMN 02 Mercatorstraat
650,Mercatorstraat 36,2022-12-18,14:00:00,266,149,117,FMN 02 Mercatorstraat
650,Mercatorstraat 36,2022-12-18,15:00:00,235,107,128,FMN 02 Mercatorstraat
650,Mercatorstraat 36,2022-12-18,16:00:00,172,68,104,FMN 02 Mercatorstraat
650,Mercatorstraat 36,2022-12-18,17:00:00,186,69,117,FMN 02 Mercatorstraat
650,Mercatorstraat 36,2022-12-18,18:00:00,149,52,97,FMN 02 Mercatorstraat
650,Mercatorstraat 36,2022-12-18,19:00:00,147,56,91,FMN 02 Mercatorstraat
650,Mercatorstraat 36,2022-12-18,20:00:00,89,37,52,FMN 02 Mercatorstraat
650,Mercatorstraat 36,2022-12-18,21:00:00,77,36,41,FMN 02 Mercatorstraat
650,Mercatorstraat 36,2022-12-18,22:00:00,64,30,34,FMN 02 Mercatorstraat
650,Mercatorstraat 36,2022-12-18,23:00:00,52,24,28,FMN 02 Mercatorstraat
650,Mercatorstraat 36,2022-12-19,00:00:00,10,5,5,FMN 02 Mercatorstraat
650,Mercatorstraat 36,2022-12-19,01:00:00,13,5,8,FMN 02 Mercatorstraat
650,Mercatorstraat 36,2022-12-19,02:00:00,11,4,7,FMN 02 Mercatorstraat
650,Mercatorstraat 36,2022-12-19,03:00:00,5,3,2,FMN 02 Mercatorstraat
650,Mercatorstraat 36,2022-12-19,04:00:00,18,12,6,FMN 02 Mercatorstraat
650,Mercatorstraat 36,2022-12-19,05:00:00,33,17,16,FMN 02 Mercatorstraat
650,Mercatorstraat 36,2022-12-19,06:00:00,68,56,12,FMN 02 Mercatorstraat
650,Mercatorstraat 36,2022-12-19,07:00:00,265,162,103,FMN 02 Mercatorstraat
650,Mercatorstraat 36,2022-12-19,08:00:00,733,503,230,FMN 02 Mercatorstraat
650,Mercatorstraat 36,2022-12-19,09:00:00,370,257,113,FMN 02 Mercatorstraat
650,Mercatorstraat 36,2022-12-19,10:00:00,319,195,124,FMN 02 Mercatorstraat
650,Mercatorstraat 36,2022-12-19,11:00:00,216,103,113,FMN 02 Mercatorstraat
650,Mercatorstraat 36,2022-12-19,12:00:00,287,160,127,FMN 02 Mercatorstraat
650,Mercatorstraat 36,2022-12-19,13:00:00,269,135,134,FMN 02 Mercatorstraat
650,Mercatorstraat 36,2022-12-19,14:00:00,290,143,147,FMN 02 Mercatorstraat
650,Mercatorstraat 36,2022-12-19,15:00:00,342,147,195,FMN 02 Mercatorstraat
650,Mercatorstraat 36,2022-12-19,16:00:00,511,187,324,FMN 02 Mercatorstraat
650,Mercatorstraat 36,2022-12-19,17:00:00,580,200,380,FMN 02 Mercatorstraat
650,Mercatorstraat 36,2022-12-19,18:00:00,422,158,264,FMN 02 Mercatorstraat
650,Mercatorstraat 36,2022-12-19,19:00:00,225,95,130,FMN 02 Mercatorstraat
650,Mercatorstraat 36,2022-12-19,20:00:00,191,81,110,FMN 02 Mercatorstraat
650,Mercatorstraat 36,2022-12-19,21:00:00,171,66,105,FMN 02 Mercatorstraat
650,Mercatorstraat 36,2022-12-19,22:00:00,154,39,115,FMN 02 Mercatorstraat
650,Mercatorstraat 36,2022-12-19,23:00:00,106,27,79,FMN 02 Mercatorstraat
650,Mercatorstraat 36,2022-12-20,00:00:00,39,7,32,FMN 02 Mercatorstraat
650,Mercatorstraat 36,2022-12-20,01:00:00,28,6,22,FMN 02 Mercatorstraat
650,Mercatorstraat 36,2022-12-20,02:00:00,12,6,6,FMN 02 Mercatorstraat
650,Mercatorstraat 36,2022-12-20,03:00:00,7,2,5,FMN 02 Mercatorstraat
650,Mercatorstraat 36,2022-12-20,04:00:00,20,15,5,FMN 02 Mercatorstraat
650,Mercatorstraat 36,2022-12-20,05:00:00,34,18,16,FMN 02 Mercatorstraat
650,Mercatorstraat 36,2022-12-20,06:00:00,71,54,17,FMN 02 Mercatorstraat
650,Mercatorstraat 36,2022-12-20,07:00:00,313,195,118,FMN 02 Mercatorstraat
650,Mercatorstraat 36,2022-12-20,08:00:00,746,518,228,FMN 02 Mercatorstraat
650,Mercatorstraat 36,2022-12-20,09:00:00,307,219,88,FMN 02 Mercatorstraat
650,Mercatorstraat 36,2022-12-20,10:00:00,246,157,89,FMN 02 Mercatorstraat
650,Mercatorstraat 36,2022-12-20,11:00:00,210,115,95,FMN 02 Mercatorstraat
650,Mercatorstraat 36,2022-12-20,12:00:00,246,141,105,FMN 02 Mercatorstraat
650,Mercatorstraat 36,2022-12-20,13:00:00,269,146,123,FMN 02 Mercatorstraat
650,Mercatorstraat 36,2022-12-20,14:00:00,218,94,124,FMN 02 Mercatorstraat
650,Mercatorstraat 36,2022-12-20,15:00:00,315,108,207,FMN 02 Mercatorstraat
650,Mercatorstraat 36,2022-12-20,16:00:00,440,159,281,FMN 02 Mercatorstraat
650,Mercatorstraat 36,2022-12-20,17:00:00,548,176,372,FMN 02 Mercatorstraat
650,Mercatorstraat 36,2022-12-20,18:00:00,349,135,214,FMN 02 Mercatorstraat
650,Mercatorstraat 36,2022-12-20,19:00:00,247,113,134,FMN 02 Mercatorstraat
650,Mercatorstraat 36,2022-12-20,20:00:00,146,47,99,FMN 02 Mercatorstraat
650,Mercatorstraat 36,2022-12-20,21:00:00,148,55,93,FMN 02 Mercatorstraat
650,Mercatorstraat 36,2022-12-20,22:00:00,115,50,65,FMN 02 Mercatorstraat
650,Mercatorstraat 36,2022-12-20,23:00:00,120,46,74,FMN 02 Mercatorstraat
650,Mercatorstraat 36,2022-12-21,00:00:00,54,17,37,FMN 02 Mercatorstraat
650,Mercatorstraat 36,2022-12-21,01:00:00,37,15,22,FMN 02 Mercatorstraat
650,Mercatorstraat 36,2022-12-21,02:00:00,14,4,10,FMN 02 Mercatorstraat
650,Mercatorstraat 36,2022-12-21,03:00:00,20,5,15,FMN 02 Mercatorstraat
650,Mercatorstraat 36,2022-12-21,04:00:00,26,13,13,FMN 02 Mercatorstraat
650,Mercatorstraat 36,2022-12-21,05:00:00,33,18,15,FMN 02 Mercatorstraat
650,Mercatorstraat 36,2022-12-21,06:00:00,78,58,20,FMN 02 Mercatorstraat
650,Mercatorstraat 36,2022-12-21,07:00:00,228,154,74,FMN 02 Mercatorstraat
650,Mercatorstraat 36,2022-12-21,08:00:00,694,456,238,FMN 02 Mercatorstraat
650,Mercatorstraat 36,2022-12-21,09:00:00,392,276,116,FMN 02 Mercatorstraat
650,Mercatorstraat 36,2022-12-21,10:00:00,254,165,89,FMN 02 Mercatorstraat
650,Mercatorstraat 36,2022-12-21,11:00:00,280,149,131,FMN 02 Mercatorstraat
650,Mercatorstraat 36,2022-12-21,12:00:00,388,209,179,FMN 02 Mercatorstraat
650,Mercatorstraat 36,2022-12-21,13:00:00,403,213,190,FMN 02 Mercatorstraat
650,Mercatorstraat 36,2022-12-21,14:00:00,346,178,168,FMN 02 Mercatorstraat
650,Mercatorstraat 36,2022-12-21,15:00:00,372,146,226,FMN 02 Mercatorstraat
650,Mercatorstraat 36,2022-12-21,16:00:00,495,171,324,FMN 02 Mercatorstraat
650,Mercatorstraat 36,2022-12-21,17:00:00,541,178,363,FMN 02 Mercatorstraat
650,Mercatorstraat 36,2022-12-21,18:00:00,405,175,230,FMN 02 Mercatorstraat
650,Mercatorstraat 36,2022-12-21,19:00:00,260,126,134,FMN 02 Mercatorstraat
650,Mercatorstraat 36,2022-12-21,20:00:00,194,80,114,FMN 02 Mercatorstraat
650,Mercatorstraat 36,2022-12-21,21:00:00,204,78,126,FMN 02 Mercatorstraat
650,Mercatorstraat 36,2022-12-21,22:00:00,182,67,115,FMN 02 Mercatorstraat
650,Mercatorstraat 36,2022-12-21,23:00:00,130,40,90,FMN 02 Mercatorstraat
650,Mercatorstraat 36,2022-12-22,00:00:00,74,20,54,FMN 02 Mercatorstraat
650,Mercatorstraat 36,2022-12-22,01:00:00,44,15,29,FMN 02 Mercatorstraat
650,Mercatorstraat 36,2022-12-22,02:00:00,30,5,25,FMN 02 Mercatorstraat
650,Mercatorstraat 36,2022-12-22,03:00:00,17,8,9,FMN 02 Mercatorstraat
650,Mercatorstraat 36,2022-12-22,04:00:00,22,13,9,FMN 02 Mercatorstraat
650,Mercatorstraat 36,2022-12-22,05:00:00,35,20,15,FMN 02 Mercatorstraat
650,Mercatorstraat 36,2022-12-22,06:00:00,73,51,22,FMN 02 Mercatorstraat
650,Mercatorstraat 36,2022-12-22,07:00:00,234,167,67,FMN 02 Mercatorstraat
650,Mercatorstraat 36,2022-12-22,08:00:00,738,488,250,FMN 02 Mercatorstraat
650,Mercatorstraat 36,2022-12-22,09:00:00,408,315,93,FMN 02 Mercatorstraat
650,Mercatorstraat 36,2022-12-22,10:00:00,284,192,92,FMN 02 Mercatorstraat
650,Mercatorstraat 36,2022-12-22,11:00:00,289,164,125,FMN 02 Mercatorstraat
650,Mercatorstraat 36,2022-12-22,12:00:00,351,173,178,FMN 02 Mercatorstraat
650,Mercatorstraat 36,2022-12-22,13:00:00,354,181,173,FMN 02 Mercatorstraat
650,Mercatorstraat 36,2022-12-22,14:00:00,344,163,181,FMN 02 Mercatorstraat
650,Mercatorstraat 36,2022-12-22,15:00:00,391,152,239,FMN 02 Mercatorstraat
650,Mercatorstraat 36,2022-12-22,16:00:00,520,187,333,FMN 02 Mercatorstraat
650,Mercatorstraat 36,2022-12-22,17:00:00,570,202,368,FMN 02 Mercatorstraat
650,Mercatorstraat 36,2022-12-22,18:00:00,464,193,271,FMN 02 Mercatorstraat
650,Mercatorstraat 36,2022-12-22,19:00:00,288,137,151,FMN 02 Mercatorstraat
650,Mercatorstraat 36,2022-12-22,20:00:00,266,125,141,FMN 02 Mercatorstraat
650,Mercatorstraat 36,2022-12-22,21:00:00,196,75,121,FMN 02 Mercatorstraat
650,Mercatorstraat 36,2022-12-22,22:00:00,194,56,138,FMN 02 Mercatorstraat
650,Mercatorstraat 36,2022-12-22,23:00:00,153,43,110,FMN 02 Mercatorstraat
650,Mercatorstraat 36,2022-12-23,00:00:00,125,30,95,FMN 02 Mercatorstraat
650,Mercatorstraat 36,2022-12-23,01:00:00,56,18,38,FMN 02 Mercatorstraat
650,Mercatorstraat 36,2022-12-23,02:00:00,43,9,34,FMN 02 Mercatorstraat
650,Mercatorstraat 36,2022-12-23,03:00:00,36,11,25,FMN 02 Mercatorstraat
650,Mercatorstraat 36,2022-12-23,04:00:00,35,20,15,FMN 02 Mercatorstraat
650,Mercatorstraat 36,2022-12-23,05:00:00,38,19,19,FMN 02 Mercatorstraat
650,Mercatorstraat 36,2022-12-23,06:00:00,60,41,19,FMN 02 Mercatorstraat
650,Mercatorstraat 36,2022-12-23,07:00:00,165,105,60,FMN 02 Mercatorstraat
650,Mercatorstraat 36,2022-12-23,08:00:00,609,421,188,FMN 02 Mercatorstraat
650,Mercatorstraat 36,2022-12-23,09:00:00,384,293,91,FMN 02 Mercatorstraat
650,Mercatorstraat 36,2022-12-23,10:00:00,283,170,113,FMN 02 Mercatorstraat
650,Mercatorstraat 36,2022-12-23,11:00:00,227,98,129,FMN 02 Mercatorstraat
650,Mercatorstraat 36,2022-12-23,12:00:00,283,124,159,FMN 02 Mercatorstraat
650,Mercatorstraat 36,2022-12-23,13:00:00,210,72,138,FMN 02 Mercatorstraat
650,Mercatorstraat 36,2022-12-23,14:00:00,288,137,151,FMN 02 Mercatorstraat
650,Mercatorstraat 36,2022-12-23,15:00:00,346,140,206,FMN 02 Mercatorstraat
650,Mercatorstraat 36,2022-12-23,16:00:00,396,139,257,FMN 02 Mercatorstraat
650,Mercatorstraat 36,2022-12-23,17:00:00,395,136,259,FMN 02 Mercatorstraat
650,Mercatorstraat 36,2022-12-23,18:00:00,360,156,204,FMN 02 Mercatorstraat
650,Mercatorstraat 36,2022-12-23,19:00:00,258,149,109,FMN 02 Mercatorstraat
650,Mercatorstraat 36,2022-12-23,20:00:00,210,100,110,FMN 02 Mercatorstraat
650,Mercatorstraat 36,2022-12-23,21:00:00,149,58,91,FMN 02 Mercatorstraat
650,Mercatorstraat 36,2022-12-23,22:00:00,142,55,87,FMN 02 Mercatorstraat
650,Mercatorstraat 36,2022-12-23,23:00:00,163,55,108,FMN 02 Mercatorstraat
650,Mercatorstraat 36,2022-12-24,00:00:00,107,38,69,FMN 02 Mercatorstraat
650,Mercatorstraat 36,2022-12-24,01:00:00,101,38,63,FMN 02 Mercatorstraat
650,Mercatorstraat 36,2022-12-24,02:00:00,59,20,39,FMN 02 Mercatorstraat
650,Mercatorstraat 36,2022-12-24,03:00:00,37,13,24,FMN 02 Mercatorstraat
650,Mercatorstraat 36,2022-12-24,04:00:00,39,15,24,FMN 02 Mercatorstraat
650,Mercatorstraat 36,2022-12-24,05:00:00,35,14,21,FMN 02 Mercatorstraat
650,Mercatorstraat 36,2022-12-24,06:00:00,32,22,10,FMN 02 Mercatorstraat
650,Mercatorstraat 36,2022-12-24,07:00:00,36,18,18,FMN 02 Mercatorstraat
650,Mercatorstraat 36,2022-12-24,08:00:00,68,41,27,FMN 02 Mercatorstraat
650,Mercatorstraat 36,2022-12-24,09:00:00,158,122,36,FMN 02 Mercatorstraat
650,Mercatorstraat 36,2022-12-24,10:00:00,240,162,78,FMN 02 Mercatorstraat
650,Mercatorstraat 36,2022-12-24,11:00:00,249,149,100,FMN 02 Mercatorstraat
650,Mercatorstraat 36,2022-12-24,12:00:00,245,119,126,FMN 02 Mercatorstraat
650,Mercatorstraat 36,2022-12-24,13:00:00,253,132,121,FMN 02 Mercatorstraat
650,Mercatorstraat 36,2022-12-24,14:00:00,278,122,156,FMN 02 Mercatorstraat
650,Mercatorstraat 36,2022-12-24,15:00:00,242,102,140,FMN 02 Mercatorstraat
650,Mercatorstraat 36,2022-12-24,16:00:00,204,68,136,FMN 02 Mercatorstraat
650,Mercatorstraat 36,2022-12-24,17:00:00,176,62,114,FMN 02 Mercatorstraat
650,Mercatorstraat 36,2022-12-24,18:00:00,127,47,80,FMN 02 Mercatorstraat
650,Mercatorstraat 36,2022-12-24,19:00:00,93,45,48,FMN 02 Mercatorstraat
650,Mercatorstraat 36,2022-12-24,20:00:00,72,35,37,FMN 02 Mercatorstraat
650,Mercatorstraat 36,2022-12-24,21:00:00,69,36,33,FMN 02 Mercatorstraat
650,Mercatorstraat 36,2022-12-24,22:00:00,78,37,41,FMN 02 Mercatorstraat
650,Mercatorstraat 36,2022-12-24,23:00:00,82,44,38,FMN 02 Mercatorstraat
650,Mercatorstraat 36,2022-12-25,00:00:00,89,48,41,FMN 02 Mercatorstraat
650,Mercatorstraat 36,2022-12-25,01:00:00,58,26,32,FMN 02 Mercatorstraat
650,Mercatorstraat 36,2022-12-25,02:00:00,35,14,21,FMN 02 Mercatorstraat
650,Mercatorstraat 36,2022-12-25,03:00:00,36,20,16,FMN 02 Mercatorstraat
650,Mercatorstraat 36,2022-12-25,04:00:00,19,10,9,FMN 02 Mercatorstraat
650,Mercatorstraat 36,2022-12-25,05:00:00,13,5,8,FMN 02 Mercatorstraat
650,Mercatorstraat 36,2022-12-25,06:00:00,20,11,9,FMN 02 Mercatorstraat
650,Mercatorstraat 36,2022-12-25,07:00:00,18,12,6,FMN 02 Mercatorstraat
650,Mercatorstraat 36,2022-12-25,08:00:00,36,22,14,FMN 02 Mercatorstraat
650,Mercatorstraat 36,2022-12-25,09:00:00,46,27,19,FMN 02 Mercatorstraat
650,Mercatorstraat 36,2022-12-25,10:00:00,67,42,25,FMN 02 Mercatorstraat
650,Mercatorstraat 36,2022-12-25,11:00:00,54,22,32,FMN 02 Mercatorstraat
650,Mercatorstraat 36,2022-12-25,12:00:00,67,31,36,FMN 02 Mercatorstraat
650,Mercatorstraat 36,2022-12-25,13:00:00,88,42,46,FMN 02 Mercatorstraat
650,Mercatorstraat 36,2022-12-25,14:00:00,93,48,45,FMN 02 Mercatorstraat
650,Mercatorstraat 36,2022-12-25,15:00:00,73,35,38,FMN 02 Mercatorstraat
650,Mercatorstraat 36,2022-12-25,16:00:00,79,27,52,FMN 02 Mercatorstraat
650,Mercatorstraat 36,2022-12-25,17:00:00,84,37,47,FMN 02 Mercatorstraat
650,Mercatorstraat 36,2022-12-25,18:00:00,79,37,42,FMN 02 Mercatorstraat
650,Mercatorstraat 36,2022-12-25,19:00:00,84,45,39,FMN 02 Mercatorstraat
650,Mercatorstraat 36,2022-12-25,20:00:00,71,38,33,FMN 02 Mercatorstraat
650,Mercatorstraat 36,2022-12-25,21:00:00,68,39,29,FMN 02 Mercatorstraat
650,Mercatorstraat 36,2022-12-25,22:00:00,56,23,33,FMN 02 Mercatorstraat
650,Mercatorstraat 36,2022-12-25,23:00:00,53,25,28,FMN 02 Mercatorstraat
650,Mercatorstraat 36,2022-12-26,00:00:00,34,19,15,FMN 02 Mercatorstraat
650,Mercatorstraat 36,2022-12-26,01:00:00,20,5,15,FMN 02 Mercatorstraat
650,Mercatorstraat 36,2022-12-26,02:00:00,15,1,14,FMN 02 Mercatorstraat
650,Mercatorstraat 36,2022-12-26,03:00:00,11,4,7,FMN 02 Mercatorstraat
650,Mercatorstraat 36,2022-12-26,04:00:00,26,14,12,FMN 02 Mercatorstraat
650,Mercatorstraat 36,2022-12-26,05:00:00,35,21,14,FMN 02 Mercatorstraat
650,Mercatorstraat 36,2022-12-26,06:00:00,35,23,12,FMN 02 Mercatorstraat
650,Mercatorstraat 36,2022-12-26,07:00:00,71,41,30,FMN 02 Mercatorstraat
650,Mercatorstraat 36,2022-12-26,08:00:00,124,77,47,FMN 02 Mercatorstraat
650,Mercatorstraat 36,2022-12-26,09:00:00,126,82,44,FMN 02 Mercatorstraat
650,Mercatorstraat 36,2022-12-26,10:00:00,147,89,58,FMN 02 Mercatorstraat
650,Mercatorstraat 36,2022-12-26,11:00:00,132,71,61,FMN 02 Mercatorstraat
650,Mercatorstraat 36,2022-12-26,12:00:00,173,96,77,FMN 02 Mercatorstraat
650,Mercatorstraat 36,2022-12-26,13:00:00,245,142,103,FMN 02 Mercatorstraat
650,Mercatorstraat 36,2022-12-26,14:00:00,244,148,96,FMN 02 Mercatorstraat
650,Mercatorstraat 36,2022-12-26,15:00:00,209,115,94,FMN 02 Mercatorstraat
650,Mercatorstraat 36,2022-12-26,16:00:00,301,161,140,FMN 02 Mercatorstraat
650,Mercatorstraat 36,2022-12-26,17:00:00,277,102,175,FMN 02 Mercatorstraat
650,Mercatorstraat 36,2022-12-26,18:00:00,222,93,129,FMN 02 Mercatorstraat
650,Mercatorstraat 36,2022-12-26,19:00:00,235,116,119,FMN 02 Mercatorstraat
650,Mercatorstraat 36,2022-12-26,20:00:00,149,75,74,FMN 02 Mercatorstraat
650,Mercatorstraat 36,2022-12-26,21:00:00,89,36,53,FMN 02 Mercatorstraat
650,Mercatorstraat 36,2022-12-26,22:00:00,151,35,116,FMN 02 Mercatorstraat
650,Mercatorstraat 36,2022-12-26,23:00:00,81,29,52,FMN 02 Mercatorstraat
650,Mercatorstraat 36,2022-12-27,00:00:00,66,30,36,FMN 02 Mercatorstraat
650,Mercatorstraat 36,2022-12-27,01:00:00,38,8,30,FMN 02 Mercatorstraat
650,Mercatorstraat 36,2022-12-27,02:00:00,27,6,21,FMN 02 Mercatorstraat
650,Mercatorstraat 36,2022-12-27,03:00:00,11,6,5,FMN 02 Mercatorstraat
650,Mercatorstraat 36,2022-12-27,04:00:00,22,13,9,FMN 02 Mercatorstraat
650,Mercatorstraat 36,2022-12-27,05:00:00,38,24,14,FMN 02 Mercatorstraat
650,Mercatorstraat 36,2022-12-27,06:00:00,52,33,19,FMN 02 Mercatorstraat
650,Mercatorstraat 36,2022-12-27,07:00:00,108,76,32,FMN 02 Mercatorstraat
650,Mercatorstraat 36,2022-12-27,08:00:00,245,174,71,FMN 02 Mercatorstraat
650,Mercatorstraat 36,2022-12-27,09:00:00,197,146,51,FMN 02 Mercatorstraat
650,Mercatorstraat 36,2022-12-27,10:00:00,180,127,53,FMN 02 Mercatorstraat
650,Mercatorstraat 36,2022-12-27,11:00:00,249,159,90,FMN 02 Mercatorstraat
650,Mercatorstraat 36,2022-12-27,12:00:00,283,160,123,FMN 02 Mercatorstraat
650,Mercatorstraat 36,2022-12-27,13:00:00,255,148,107,FMN 02 Mercatorstraat
650,Mercatorstraat 36,2022-12-27,14:00:00,328,180,148,FMN 02 Mercatorstraat
650,Mercatorstraat 36,2022-12-27,15:00:00,325,172,153,FMN 02 Mercatorstraat
650,Mercatorstraat 36,2022-12-27,16:00:00,382,154,228,FMN 02 Mercatorstraat
650,Mercatorstraat 36,2022-12-27,17:00:00,436,152,284,FMN 02 Mercatorstraat
650,Mercatorstraat 36,2022-12-27,18:00:00,312,125,187,FMN 02 Mercatorstraat
650,Mercatorstraat 36,2022-12-27,19:00:00,305,158,147,FMN 02 Mercatorstraat
650,Mercatorstraat 36,2022-12-27,20:00:00,154,67,87,FMN 02 Mercatorstraat
650,Mercatorstraat 36,2022-12-27,21:00:00,146,55,91,FMN 02 Mercatorstraat
650,Mercatorstraat 36,2022-12-27,22:00:00,191,48,143,FMN 02 Mercatorstraat
650,Mercatorstraat 36,2022-12-27,23:00:00,139,39,100,FMN 02 Mercatorstraat
650,Mercatorstraat 36,2022-12-28,00:00:00,64,24,40,FMN 02 Mercatorstraat
650,Mercatorstraat 36,2022-12-28,01:00:00,48,10,38,FMN 02 Mercatorstraat
650,Mercatorstraat 36,2022-12-28,02:00:00,20,7,13,FMN 02 Mercatorstraat
650,Mercatorstraat 36,2022-12-28,03:00:00,18,9,9,FMN 02 Mercatorstraat
650,Mercatorstraat 36,2022-12-28,04:00:00,17,10,7,FMN 02 Mercatorstraat
650,Mercatorstraat 36,2022-12-28,05:00:00,37,27,10,FMN 02 Mercatorstraat
650,Mercatorstraat 36,2022-12-28,06:00:00,49,32,17,FMN 02 Mercatorstraat
650,Mercatorstraat 36,2022-12-28,07:00:00,102,64,38,FMN 02 Mercatorstraat
650,Mercatorstraat 36,2022-12-28,08:00:00,222,138,84,FMN 02 Mercatorstraat
650,Mercatorstraat 36,2022-12-28,09:00:00,185,136,49,FMN 02 Mercatorstraat
650,Mercatorstraat 36,2022-12-28,10:00:00,183,119,64,FMN 02 Mercatorstraat
650,Mercatorstraat 36,2022-12-28,11:00:00,134,88,46,FMN 02 Mercatorstraat
650,Mercatorstraat 36,2022-12-28,12:00:00,204,107,97,FMN 02 Mercatorstraat
650,Mercatorstraat 36,2022-12-28,13:00:00,237,142,95,FMN 02 Mercatorstraat
650,Mercatorstraat 36,2022-12-28,14:00:00,277,144,133,FMN 02 Mercatorstraat
650,Mercatorstraat 36,2022-12-28,15:00:00,255,139,116,FMN 02 Mercatorstraat
650,Mercatorstraat 36,2022-12-28,16:00:00,260,109,151,FMN 02 Mercatorstraat
650,Mercatorstraat 36,2022-12-28,17:00:00,292,100,192,FMN 02 Mercatorstraat
650,Mercatorstraat 36,2022-12-28,18:00:00,244,90,154,FMN 02 Mercatorstraat
650,Mercatorstraat 36,2022-12-28,19:00:00,219,91,128,FMN 02 Mercatorstraat
650,Mercatorstraat 36,2022-12-28,20:00:00,157,69,88,FMN 02 Mercatorstraat
650,Mercatorstraat 36,2022-12-28,21:00:00,124,55,69,FMN 02 Mercatorstraat
650,Mercatorstraat 36,2022-12-28,22:00:00,139,47,92,FMN 02 Mercatorstraat
650,Mercatorstraat 36,2022-12-28,23:00:00,98,29,69,FMN 02 Mercatorstraat
650,Mercatorstraat 36,2022-12-29,00:00:00,60,22,38,FMN 02 Mercatorstraat
650,Mercatorstraat 36,2022-12-29,01:00:00,43,13,30,FMN 02 Mercatorstraat
650,Mercatorstraat 36,2022-12-29,02:00:00,28,9,19,FMN 02 Mercatorstraat
650,Mercatorstraat 36,2022-12-29,03:00:00,20,9,11,FMN 02 Mercatorstraat
650,Mercatorstraat 36,2022-12-29,04:00:00,23,10,13,FMN 02 Mercatorstraat
650,Mercatorstraat 36,2022-12-29,05:00:00,46,34,12,FMN 02 Mercatorstraat
650,Mercatorstraat 36,2022-12-29,06:00:00,44,26,18,FMN 02 Mercatorstraat
650,Mercatorstraat 36,2022-12-29,07:00:00,115,73,42,FMN 02 Mercatorstraat
650,Mercatorstraat 36,2022-12-29,08:00:00,225,175,50,FMN 02 Mercatorstraat
650,Mercatorstraat 36,2022-12-29,09:00:00,172,108,64,FMN 02 Mercatorstraat
650,Mercatorstraat 36,2022-12-29,10:00:00,175,113,62,FMN 02 Mercatorstraat
650,Mercatorstraat 36,2022-12-29,11:00:00,183,115,68,FMN 02 Mercatorstraat
650,Mercatorstraat 36,2022-12-29,12:00:00,234,132,102,FMN 02 Mercatorstraat
650,Mercatorstraat 36,2022-12-29,13:00:00,227,125,102,FMN 02 Mercatorstraat
650,Mercatorstraat 36,2022-12-29,14:00:00,246,125,121,FMN 02 Mercatorstraat
650,Mercatorstraat 36,2022-12-29,15:00:00,229,125,104,FMN 02 Mercatorstraat
650,Mercatorstraat 36,2022-12-29,16:00:00,305,126,179,FMN 02 Mercatorstraat
650,Mercatorstraat 36,2022-12-29,17:00:00,353,122,231,FMN 02 Mercatorstraat
650,Mercatorstraat 36,2022-12-29,18:00:00,293,128,165,FMN 02 Mercatorstraat
650,Mercatorstraat 36,2022-12-29,19:00:00,254,150,104,FMN 02 Mercatorstraat
650,Mercatorstraat 36,2022-12-29,20:00:00,178,78,100,FMN 02 Mercatorstraat
650,Mercatorstraat 36,2022-12-29,21:00:00,117,49,68,FMN 02 Mercatorstraat
650,Mercatorstraat 36,2022-12-29,22:00:00,147,55,92,FMN 02 Mercatorstraat
650,Mercatorstraat 36,2022-12-29,23:00:00,111,25,86,FMN 02 Mercatorstraat
650,Mercatorstraat 36,2022-12-30,00:00:00,76,18,58,FMN 02 Mercatorstraat
650,Mercatorstraat 36,2022-12-30,01:00:00,53,13,40,FMN 02 Mercatorstraat
650,Mercatorstraat 36,2022-12-30,02:00:00,30,10,20,FMN 02 Mercatorstraat
650,Mercatorstraat 36,2022-12-30,03:00:00,19,8,11,FMN 02 Mercatorstraat
650,Mercatorstraat 36,2022-12-30,04:00:00,26,11,15,FMN 02 Mercatorstraat
650,Mercatorstraat 36,2022-12-30,05:00:00,35,24,11,FMN 02 Mercatorstraat
650,Mercatorstraat 36,2022-12-30,06:00:00,45,30,15,FMN 02 Mercatorstraat
650,Mercatorstraat 36,2022-12-30,07:00:00,79,44,35,FMN 02 Mercatorstraat
650,Mercatorstraat 36,2022-12-30,08:00:00,170,126,44,FMN 02 Mercatorstraat
650,Mercatorstraat 36,2022-12-30,09:00:00,168,117,51,FMN 02 Mercatorstraat
650,Mercatorstraat 36,2022-12-30,10:00:00,208,143,65,FMN 02 Mercatorstraat
650,Mercatorstraat 36,2022-12-30,11:00:00,227,126,101,FMN 02 Mercatorstraat
650,Mercatorstraat 36,2022-12-30,12:00:00,232,117,115,FMN 02 Mercatorstraat
650,Mercatorstraat 36,2022-12-30,13:00:00,152,82,70,FMN 02 Mercatorstraat
650,Mercatorstraat 36,2022-12-30,14:00:00,193,105,88,FMN 02 Mercatorstraat
650,Mercatorstraat 36,2022-12-30,15:00:00,215,102,113,FMN 02 Mercatorstraat
650,Mercatorstraat 36,2022-12-30,16:00:00,252,101,151,FMN 02 Mercatorstraat
650,Mercatorstraat 36,2022-12-30,17:00:00,250,102,148,FMN 02 Mercatorstraat
650,Mercatorstraat 36,2022-12-30,18:00:00,222,95,127,FMN 02 Mercatorstraat
650,Mercatorstraat 36,2022-12-30,19:00:00,169,93,76,FMN 02 Mercatorstraat
650,Mercatorstraat 36,2022-12-30,20:00:00,147,79,68,FMN 02 Mercatorstraat
650,Mercatorstraat 36,2022-12-30,21:00:00,117,51,66,FMN 02 Mercatorstraat
650,Mercatorstraat 36,2022-12-30,22:00:00,108,35,73,FMN 02 Mercatorstraat
650,Mercatorstraat 36,2022-12-30,23:00:00,74,31,43,FMN 02 Mercatorstraat
650,Mercatorstraat 36,2022-12-31,00:00:00,51,13,38,FMN 02 Mercatorstraat
650,Mercatorstraat 36,2022-12-31,01:00:00,54,11,43,FMN 02 Mercatorstraat
650,Mercatorstraat 36,2022-12-31,02:00:00,28,4,24,FMN 02 Mercatorstraat
650,Mercatorstraat 36,2022-12-31,03:00:00,20,8,12,FMN 02 Mercatorstraat
650,Mercatorstraat 36,2022-12-31,04:00:00,10,3,7,FMN 02 Mercatorstraat
650,Mercatorstraat 36,2022-12-31,05:00:00,18,8,10,FMN 02 Mercatorstraat
650,Mercatorstraat 36,2022-12-31,06:00:00,21,12,9,FMN 02 Mercatorstraat
650,Mercatorstraat 36,2022-12-31,07:00:00,32,17,15,FMN 02 Mercatorstraat
650,Mercatorstraat 36,2022-12-31,08:00:00,35,20,15,FMN 02 Mercatorstraat
650,Mercatorstraat 36,2022-12-31,09:00:00,83,58,25,FMN 02 Mercatorstraat
650,Mercatorstraat 36,2022-12-31,10:00:00,123,94,29,FMN 02 Mercatorstraat
650,Mercatorstraat 36,2022-12-31,11:00:00,150,88,62,FMN 02 Mercatorstraat
650,Mercatorstraat 36,2022-12-31,12:00:00,184,109,75,FMN 02 Mercatorstraat
650,Mercatorstraat 36,2022-12-31,13:00:00,204,109,95,FMN 02 Mercatorstraat
650,Mercatorstraat 36,2022-12-31,14:00:00,195,100,95,FMN 02 Mercatorstraat
650,Mercatorstraat 36,2022-12-31,15:00:00,165,76,89,FMN 02 Mercatorstraat
650,Mercatorstraat 36,2022-12-31,16:00:00,218,95,123,FMN 02 Mercatorstraat
650,Mercatorstraat 36,2022-12-31,17:00:00,251,131,120,FMN 02 Mercatorstraat
650,Mercatorstraat 36,2022-12-31,18:00:00,248,148,100,FMN 02 Mercatorstraat
650,Mercatorstraat 36,2022-12-31,19:00:00,198,106,92,FMN 02 Mercatorstraat
650,Mercatorstraat 36,2022-12-31,20:00:00,117,74,43,FMN 02 Mercatorstraat
650,Mercatorstraat 36,2022-12-31,21:00:00,103,51,52,FMN 02 Mercatorstraat
650,Mercatorstraat 36,2022-12-31,22:00:00,135,73,62,FMN 02 Mercatorstraat
650,Mercatorstraat 36,2022-12-31,23:00:00,204,157,47,FMN 02 Mercatorstraat
650,Mercatorstraat 36,2023-01-01,00:00:00,152,51,101,FMN 02 Mercatorstraat
650,Mercatorstraat 36,2023-01-01,01:00:00,314,157,157,FMN 02 Mercatorstraat
650,Mercatorstraat 36,2023-01-01,02:00:00,271,137,134,FMN 02 Mercatorstraat
650,Mercatorstraat 36,2023-01-01,03:00:00,302,149,153,FMN 02 Mercatorstraat
650,Mercatorstraat 36,2023-01-01,04:00:00,230,72,158,FMN 02 Mercatorstraat
650,Mercatorstraat 36,2023-01-01,05:00:00,139,37,102,FMN 02 Mercatorstraat
650,Mercatorstraat 36,2023-01-01,06:00:00,101,24,77,FMN 02 Mercatorstraat
650,Mercatorstraat 36,2023-01-01,07:00:00,60,15,45,FMN 02 Mercatorstraat
650,Mercatorstraat 36,2023-01-01,08:00:00,58,18,40,FMN 02 Mercatorstraat
650,Mercatorstraat 36,2023-01-01,09:00:00,61,30,31,FMN 02 Mercatorstraat
650,Mercatorstraat 36,2023-01-01,10:00:00,83,48,35,FMN 02 Mercatorstraat
650,Mercatorstraat 36,2023-01-01,11:00:00,99,58,41,FMN 02 Mercatorstraat
650,Mercatorstraat 36,2023-01-01,12:00:00,98,57,41,FMN 02 Mercatorstraat
650,Mercatorstraat 36,2023-01-01,13:00:00,153,77,76,FMN 02 Mercatorstraat
650,Mercatorstraat 36,2023-01-01,14:00:00,166,78,88,FMN 02 Mercatorstraat
650,Mercatorstraat 36,2023-01-01,15:00:00,165,72,93,FMN 02 Mercatorstraat
650,Mercatorstraat 36,2023-01-01,16:00:00,146,51,95,FMN 02 Mercatorstraat
650,Mercatorstraat 36,2023-01-01,17:00:00,117,58,59,FMN 02 Mercatorstraat
650,Mercatorstraat 36,2023-01-01,18:00:00,121,60,61,FMN 02 Mercatorstraat
650,Mercatorstraat 36,2023-01-01,19:00:00,127,61,66,FMN 02 Mercatorstraat
650,Mercatorstraat 36,2023-01-01,20:00:00,91,36,55,FMN 02 Mercatorstraat
650,Mercatorstraat 36,2023-01-01,21:00:00,86,44,42,FMN 02 Mercatorstraat
650,Mercatorstraat 36,2023-01-01,22:00:00,53,29,24,FMN 02 Mercatorstraat
650,Mercatorstraat 36,2023-01-01,23:00:00,39,21,18,FMN 02 Mercatorstraat
650,Mercatorstraat 36,2023-01-02,00:00:00,16,9,7,FMN 02 Mercatorstraat
650,Mercatorstraat 36,2023-01-02,01:00:00,18,9,9,FMN 02 Mercatorstraat
650,Mercatorstraat 36,2023-01-02,02:00:00,11,6,5,FMN 02 Mercatorstraat
650,Mercatorstraat 36,2023-01-02,03:00:00,9,3,6,FMN 02 Mercatorstraat
650,Mercatorstraat 36,2023-01-02,04:00:00,23,16,7,FMN 02 Mercatorstraat
650,Mercatorstraat 36,2023-01-02,05:00:00,21,12,9,FMN 02 Mercatorstraat
650,Mercatorstraat 36,2023-01-02,06:00:00,47,30,17,FMN 02 Mercatorstraat
650,Mercatorstraat 36,2023-01-02,07:00:00,98,63,35,FMN 02 Mercatorstraat
650,Mercatorstraat 36,2023-01-02,08:00:00,223,149,74,FMN 02 Mercatorstraat
650,Mercatorstraat 36,2023-01-02,09:00:00,160,118,42,FMN 02 Mercatorstraat
650,Mercatorstraat 36,2023-01-02,10:00:00,148,107,41,FMN 02 Mercatorstraat
650,Mercatorstraat 36,2023-01-02,11:00:00,163,112,51,FMN 02 Mercatorstraat
650,Mercatorstraat 36,2023-01-02,12:00:00,183,107,76,FMN 02 Mercatorstraat
650,Mercatorstraat 36,2023-01-02,13:00:00,237,142,95,FMN 02 Mercatorstraat
650,Mercatorstraat 36,2023-01-02,14:00:00,196,99,97,FMN 02 Mercatorstraat
650,Mercatorstraat 36,2023-01-02,15:00:00,211,91,120,FMN 02 Mercatorstraat
650,Mercatorstraat 36,2023-01-02,16:00:00,231,77,154,FMN 02 Mercatorstraat
650,Mercatorstraat 36,2023-01-02,17:00:00,297,101,196,FMN 02 Mercatorstraat
650,Mercatorstraat 36,2023-01-02,18:00:00,248,90,158,FMN 02 Mercatorstraat
650,Mercatorstraat 36,2023-01-02,19:00:00,168,81,87,FMN 02 Mercatorstraat
650,Mercatorstraat 36,2023-01-02,20:00:00,113,41,72,FMN 02 Mercatorstraat
650,Mercatorstraat 36,2023-01-02,21:00:00,132,58,74,FMN 02 Mercatorstraat
650,Mercatorstraat 36,2023-01-02,22:00:00,85,27,58,FMN 02 Mercatorstraat
650,Mercatorstraat 36,2023-01-02,23:00:00,64,18,46,FMN 02 Mercatorstraat
650,Mercatorstraat 36,2023-01-03,00:00:00,37,16,21,FMN 02 Mercatorstraat
650,Mercatorstraat 36,2023-01-03,01:00:00,17,3,14,FMN 02 Mercatorstraat
650,Mercatorstraat 36,2023-01-03,02:00:00,12,4,8,FMN 02 Mercatorstraat
650,Mercatorstraat 36,2023-01-03,03:00:00,6,5,1,FMN 02 Mercatorstraat
650,Mercatorstraat 36,2023-01-03,04:00:00,25,16,9,FMN 02 Mercatorstraat
650,Mercatorstraat 36,2023-01-03,05:00:00,32,21,11,FMN 02 Mercatorstraat
650,Mercatorstraat 36,2023-01-03,06:00:00,83,62,21,FMN 02 Mercatorstraat
650,Mercatorstraat 36,2023-01-03,07:00:00,206,151,55,FMN 02 Mercatorstraat
650,Mercatorstraat 36,2023-01-03,08:00:00,400,299,101,FMN 02 Mercatorstraat
650,Mercatorstraat 36,2023-01-03,09:00:00,273,203,70,FMN 02 Mercatorstraat
650,Mercatorstraat 36,2023-01-03,10:00:00,197,152,45,FMN 02 Mercatorstraat
650,Mercatorstraat 36,2023-01-03,11:00:00,219,141,78,FMN 02 Mercatorstraat
650,Mercatorstraat 36,2023-01-03,12:00:00,238,137,101,FMN 02 Mercatorstraat
650,Mercatorstraat 36,2023-01-03,13:00:00,281,156,125,FMN 02 Mercatorstraat
650,Mercatorstraat 36,2023-01-03,14:00:00,233,120,113,FMN 02 Mercatorstraat
650,Mercatorstraat 36,2023-01-03,15:00:00,264,107,157,FMN 02 Mercatorstraat
650,Mercatorstraat 36,2023-01-03,16:00:00,382,125,257,FMN 02 Mercatorstraat
650,Mercatorstraat 36,2023-01-03,17:00:00,518,193,325,FMN 02 Mercatorstraat
650,Mercatorstraat 36,2023-01-03,18:00:00,367,138,229,FMN 02 Mercatorstraat
650,Mercatorstraat 36,2023-01-03,19:00:00,213,89,124,FMN 02 Mercatorstraat
650,Mercatorstraat 36,2023-01-03,20:00:00,157,58,99,FMN 02 Mercatorstraat
650,Mercatorstraat 36,2023-01-03,21:00:00,146,65,81,FMN 02 Mercatorstraat
650,Mercatorstraat 36,2023-01-03,22:00:00,128,37,91,FMN 02 Mercatorstraat
650,Mercatorstraat 36,2023-01-03,23:00:00,69,27,42,FMN 02 Mercatorstraat
650,Mercatorstraat 36,2023-01-04,00:00:00,37,4,33,FMN 02 Mercatorstraat
650,Mercatorstraat 36,2023-01-04,01:00:00,21,9,12,FMN 02 Mercatorstraat
650,Mercatorstraat 36,2023-01-04,02:00:00,12,2,10,FMN 02 Mercatorstraat
650,Mercatorstraat 36,2023-01-04,03:00:00,14,7,7,FMN 02 Mercatorstraat
650,Mercatorstraat 36,2023-01-04,04:00:00,22,18,4,FMN 02 Mercatorstraat
650,Mercatorstraat 36,2023-01-04,05:00:00,35,20,15,FMN 02 Mercatorstraat
650,Mercatorstraat 36,2023-01-04,06:00:00,66,43,23,FMN 02 Mercatorstraat
650,Mercatorstraat 36,2023-01-04,07:00:00,183,122,61,FMN 02 Mercatorstraat
650,Mercatorstraat 36,2023-01-04,08:00:00,350,255,95,FMN 02 Mercatorstraat
650,Mercatorstraat 36,2023-01-04,09:00:00,220,166,54,FMN 02 Mercatorstraat
650,Mercatorstraat 36,2023-01-04,10:00:00,132,78,54,FMN 02 Mercatorstraat
650,Mercatorstraat 36,2023-01-04,11:00:00,138,78,60,FMN 02 Mercatorstraat
650,Mercatorstraat 36,2023-01-04,12:00:00,168,95,73,FMN 02 Mercatorstraat
650,Mercatorstraat 36,2023-01-04,13:00:00,185,106,79,FMN 02 Mercatorstraat
650,Mercatorstraat 36,2023-01-04,14:00:00,186,88,98,FMN 02 Mercatorstraat
650,Mercatorstraat 36,2023-01-04,15:00:00,169,66,103,FMN 02 Mercatorstraat
650,Mercatorstraat 36,2023-01-04,16:00:00,322,118,204,FMN 02 Mercatorstraat
650,Mercatorstraat 36,2023-01-04,17:00:00,396,145,251,FMN 02 Mercatorstraat
650,Mercatorstraat 36,2023-01-04,18:00:00,335,137,198,FMN 02 Mercatorstraat
650,Mercatorstraat 36,2023-01-04,19:00:00,250,127,123,FMN 02 Mercatorstraat
650,Mercatorstraat 36,2023-01-04,20:00:00,157,91,66,FMN 02 Mercatorstraat
650,Mercatorstraat 36,2023-01-04,21:00:00,135,61,74,FMN 02 Mercatorstraat
650,Mercatorstraat 36,2023-01-04,22:00:00,152,39,113,FMN 02 Mercatorstraat
650,Mercatorstraat 36,2023-01-04,23:00:00,101,25,76,FMN 02 Mercatorstraat
650,Mercatorstraat 36,2023-01-05,00:00:00,67,23,44,FMN 02 Mercatorstraat
650,Mercatorstraat 36,2023-01-05,01:00:00,23,10,13,FMN 02 Mercatorstraat
650,Mercatorstraat 36,2023-01-05,02:00:00,16,3,13,FMN 02 Mercatorstraat
650,Mercatorstraat 36,2023-01-05,03:00:00,13,8,5,FMN 02 Mercatorstraat
650,Mercatorstraat 36,2023-01-05,04:00:00,19,13,6,FMN 02 Mercatorstraat
650,Mercatorstraat 36,2023-01-05,05:00:00,35,19,16,FMN 02 Mercatorstraat
650,Mercatorstraat 36,2023-01-05,06:00:00,81,56,25,FMN 02 Mercatorstraat
650,Mercatorstraat 36,2023-01-05,07:00:00,212,134,78,FMN 02 Mercatorstraat
650,Mercatorstraat 36,2023-01-05,08:00:00,445,307,138,FMN 02 Mercatorstraat
650,Mercatorstraat 36,2023-01-05,09:00:00,273,208,65,FMN 02 Mercatorstraat
650,Mercatorstraat 36,2023-01-05,10:00:00,207,145,62,FMN 02 Mercatorstraat
650,Mercatorstraat 36,2023-01-05,11:00:00,210,136,74,FMN 02 Mercatorstraat
650,Mercatorstraat 36,2023-01-05,12:00:00,273,151,122,FMN 02 Mercatorstraat
650,Mercatorstraat 36,2023-01-05,13:00:00,281,176,105,FMN 02 Mercatorstraat
650,Mercatorstraat 36,2023-01-05,14:00:00,274,160,114,FMN 02 Mercatorstraat
650,Mercatorstraat 36,2023-01-05,15:00:00,270,118,152,FMN 02 Mercatorstraat
650,Mercatorstraat 36,2023-01-05,16:00:00,455,172,283,FMN 02 Mercatorstraat
650,Mercatorstraat 36,2023-01-05,17:00:00,506,178,328,FMN 02 Mercatorstraat
650,Mercatorstraat 36,2023-01-05,18:00:00,394,146,248,FMN 02 Mercatorstraat
650,Mercatorstraat 36,2023-01-05,19:00:00,277,138,139,FMN 02 Mercatorstraat
650,Mercatorstraat 36,2023-01-05,20:00:00,172,76,96,FMN 02 Mercatorstraat
650,Mercatorstraat 36,2023-01-05,21:00:00,149,62,87,FMN 02 Mercatorstraat
650,Mercatorstraat 36,2023-01-05,22:00:00,151,52,99,FMN 02 Mercatorstraat
650,Mercatorstraat 36,2023-01-05,23:00:00,116,36,80,FMN 02 Mercatorstraat
650,Mercatorstraat 36,2023-01-06,00:00:00,41,22,19,FMN 02 Mercatorstraat
650,Mercatorstraat 36,2023-01-06,01:00:00,39,17,22,FMN 02 Mercatorstraat
650,Mercatorstraat 36,2023-01-06,02:00:00,23,7,16,FMN 02 Mercatorstraat
650,Mercatorstraat 36,2023-01-06,03:00:00,13,3,10,FMN 02 Mercatorstraat
650,Mercatorstraat 36,2023-01-06,04:00:00,18,13,5,FMN 02 Mercatorstraat
650,Mercatorstraat 36,2023-01-06,05:00:00,39,21,18,FMN 02 Mercatorstraat
650,Mercatorstraat 36,2023-01-06,06:00:00,70,47,23,FMN 02 Mercatorstraat
650,Mercatorstraat 36,2023-01-06,07:00:00,157,96,61,FMN 02 Mercatorstraat
650,Mercatorstraat 36,2023-01-06,08:00:00,353,248,105,FMN 02 Mercatorstraat
650,Mercatorstraat 36,2023-01-06,09:00:00,248,192,56,FMN 02 Mercatorstraat
650,Mercatorstraat 36,2023-01-06,10:00:00,199,135,64,FMN 02 Mercatorstraat
650,Mercatorstraat 36,2023-01-06,11:00:00,244,165,79,FMN 02 Mercatorstraat
650,Mercatorstraat 36,2023-01-06,12:00:00,336,191,145,FMN 02 Mercatorstraat
650,Mercatorstraat 36,2023-01-06,13:00:00,276,150,126,FMN 02 Mercatorstraat
650,Mercatorstraat 36,2023-01-06,14:00:00,317,163,154,FMN 02 Mercatorstraat
650,Mercatorstraat 36,2023-01-06,15:00:00,369,153,216,FMN 02 Mercatorstraat
650,Mercatorstraat 36,2023-01-06,16:00:00,426,175,251,FMN 02 Mercatorstraat
650,Mercatorstraat 36,2023-01-06,17:00:00,439,171,268,FMN 02 Mercatorstraat
650,Mercatorstraat 36,2023-01-06,18:00:00,298,119,179,FMN 02 Mercatorstraat
650,Mercatorstraat 36,2023-01-06,19:00:00,278,138,140,FMN 02 Mercatorstraat
650,Mercatorstraat 36,2023-01-06,20:00:00,191,103,88,FMN 02 Mercatorstraat
650,Mercatorstraat 36,2023-01-06,21:00:00,130,64,66,FMN 02 Mercatorstraat
650,Mercatorstraat 36,2023-01-06,22:00:00,174,56,118,FMN 02 Mercatorstraat
650,Mercatorstraat 36,2023-01-06,23:00:00,149,49,100,FMN 02 Mercatorstraat
650,Mercatorstraat 36,2023-01-07,00:00:00,153,69,84,FMN 02 Mercatorstraat
650,Mercatorstraat 36,2023-01-07,01:00:00,67,30,37,FMN 02 Mercatorstraat
650,Mercatorstraat 36,2023-01-07,02:00:00,66,17,49,FMN 02 Mercatorstraat
650,Mercatorstraat 36,2023-01-07,03:00:00,51,9,42,FMN 02 Mercatorstraat
650,Mercatorstraat 36,2023-01-07,04:00:00,28,4,24,FMN 02 Mercatorstraat
650,Mercatorstraat 36,2023-01-07,05:00:00,30,14,16,FMN 02 Mercatorstraat
650,Mercatorstraat 36,2023-01-07,06:00:00,44,22,22,FMN 02 Mercatorstraat
650,Mercatorstraat 36,2023-01-07,07:00:00,40,22,18,FMN 02 Mercatorstraat
650,Mercatorstraat 36,2023-01-07,08:00:00,78,47,31,FMN 02 Mercatorstraat
650,Mercatorstraat 36,2023-01-07,09:00:00,149,118,31,FMN 02 Mercatorstraat
650,Mercatorstraat 36,2023-01-07,10:00:00,201,155,46,FMN 02 Mercatorstraat
650,Mercatorstraat 36,2023-01-07,11:00:00,289,170,119,FMN 02 Mercatorstraat
650,Mercatorstraat 36,2023-01-07,12:00:00,266,159,107,FMN 02 Mercatorstraat
650,Mercatorstraat 36,2023-01-07,13:00:00,321,197,124,FMN 02 Mercatorstraat
650,Mercatorstraat 36,2023-01-07,14:00:00,344,193,151,FMN 02 Mercatorstraat
650,Mercatorstraat 36,2023-01-07,15:00:00,322,141,181,FMN 02 Mercatorstraat
650,Mercatorstraat 36,2023-01-07,16:00:00,320,101,219,FMN 02 Mercatorstraat
650,Mercatorstraat 36,2023-01-07,17:00:00,235,81,154,FMN 02 Mercatorstraat
650,Mercatorstraat 36,2023-01-07,18:00:00,216,86,130,FMN 02 Mercatorstraat
650,Mercatorstraat 36,2023-01-07,19:00:00,223,124,99,FMN 02 Mercatorstraat
650,Mercatorstraat 36,2023-01-07,20:00:00,176,79,97,FMN 02 Mercatorstraat
650,Mercatorstraat 36,2023-01-07,21:00:00,181,83,98,FMN 02 Mercatorstraat
650,Mercatorstraat 36,2023-01-07,22:00:00,136,49,87,FMN 02 Mercatorstraat
650,Mercatorstraat 36,2023-01-07,23:00:00,118,46,72,FMN 02 Mercatorstraat
650,Mercatorstraat 36,2023-01-08,00:00:00,124,53,71,FMN 02 Mercatorstraat
650,Mercatorstraat 36,2023-01-08,01:00:00,86,44,42,FMN 02 Mercatorstraat
650,Mercatorstraat 36,2023-01-08,02:00:00,74,36,38,FMN 02 Mercatorstraat
650,Mercatorstraat 36,2023-01-08,03:00:00,42,12,30,FMN 02 Mercatorstraat
650,Mercatorstraat 36,2023-01-08,04:00:00,28,7,21,FMN 02 Mercatorstraat
650,Mercatorstraat 36,2023-01-08,05:00:00,21,4,17,FMN 02 Mercatorstraat
650,Mercatorstraat 36,2023-01-08,06:00:00,29,17,12,FMN 02 Mercatorstraat
650,Mercatorstraat 36,2023-01-08,07:00:00,41,18,23,FMN 02 Mercatorstraat
650,Mercatorstraat 36,2023-01-08,08:00:00,70,46,24,FMN 02 Mercatorstraat
650,Mercatorstraat 36,2023-01-08,09:00:00,123,77,46,FMN 02 Mercatorstraat
650,Mercatorstraat 36,2023-01-08,10:00:00,153,114,39,FMN 02 Mercatorstraat
650,Mercatorstraat 36,2023-01-08,11:00:00,225,145,80,FMN 02 Mercatorstraat
650,Mercatorstraat 36,2023-01-08,12:00:00,251,144,107,FMN 02 Mercatorstraat
650,Mercatorstraat 36,2023-01-08,13:00:00,305,179,126,FMN 02 Mercatorstraat
650,Mercatorstraat 36,2023-01-08,14:00:00,308,204,104,FMN 02 Mercatorstraat
650,Mercatorstraat 36,2023-01-08,15:00:00,255,131,124,FMN 02 Mercatorstraat
650,Mercatorstraat 36,2023-01-08,16:00:00,280,108,172,FMN 02 Mercatorstraat
650,Mercatorstraat 36,2023-01-08,17:00:00,257,91,166,FMN 02 Mercatorstraat
650,Mercatorstraat 36,2023-01-08,18:00:00,229,84,145,FMN 02 Mercatorstraat
650,Mercatorstraat 36,2023-01-08,19:00:00,171,62,109,FMN 02 Mercatorstraat
650,Mercatorstraat 36,2023-01-08,20:00:00,156,81,75,FMN 02 Mercatorstraat
650,Mercatorstraat 36,2023-01-08,21:00:00,135,65,70,FMN 02 Mercatorstraat
650,Mercatorstraat 36,2023-01-08,22:00:00,65,16,49,FMN 02 Mercatorstraat
650,Mercatorstraat 36,2023-01-08,23:00:00,37,17,20,FMN 02 Mercatorstraat
650,Mercatorstraat 36,2023-01-09,00:00:00,21,8,13,FMN 02 Mercatorstraat
650,Mercatorstraat 36,2023-01-09,01:00:00,13,4,9,FMN 02 Mercatorstraat
650,Mercatorstraat 36,2023-01-09,02:00:00,13,3,10,FMN 02 Mercatorstraat
650,Mercatorstraat 36,2023-01-09,03:00:00,4,1,3,FMN 02 Mercatorstraat
650,Mercatorstraat 36,2023-01-09,04:00:00,18,10,8,FMN 02 Mercatorstraat
650,Mercatorstraat 36,2023-01-09,05:00:00,43,30,13,FMN 02 Mercatorstraat
650,Mercatorstraat 36,2023-01-09,06:00:00,124,87,37,FMN 02 Mercatorstraat
650,Mercatorstraat 36,2023-01-09,07:00:00,396,252,144,FMN 02 Mercatorstraat
650,Mercatorstraat 36,2023-01-09,08:00:00,970,670,300,FMN 02 Mercatorstraat
650,Mercatorstraat 36,2023-01-09,09:00:00,340,270,70,FMN 02 Mercatorstraat
650,Mercatorstraat 36,2023-01-09,10:00:00,170,110,60,FMN 02 Mercatorstraat
650,Mercatorstraat 36,2023-01-09,11:00:00,208,121,87,FMN 02 Mercatorstraat
650,Mercatorstraat 36,2023-01-09,12:00:00,292,148,144,FMN 02 Mercatorstraat
650,Mercatorstraat 36,2023-01-09,13:00:00,318,158,160,FMN 02 Mercatorstraat
650,Mercatorstraat 36,2023-01-09,14:00:00,255,103,152,FMN 02 Mercatorstraat
650,Mercatorstraat 36,2023-01-09,15:00:00,396,125,271,FMN 02 Mercatorstraat
650,Mercatorstraat 36,2023-01-09,16:00:00,583,179,404,FMN 02 Mercatorstraat
650,Mercatorstraat 36,2023-01-09,17:00:00,688,217,471,FMN 02 Mercatorstraat
650,Mercatorstraat 36,2023-01-09,18:00:00,416,147,269,FMN 02 Mercatorstraat
650,Mercatorstraat 36,2023-01-09,19:00:00,243,110,133,FMN 02 Mercatorstraat
650,Mercatorstraat 36,2023-01-09,20:00:00,132,47,85,FMN 02 Mercatorstraat
650,Mercatorstraat 36,2023-01-09,21:00:00,168,66,102,FMN 02 Mercatorstraat
650,Mercatorstraat 36,2023-01-09,22:00:00,141,57,84,FMN 02 Mercatorstraat
650,Mercatorstraat 36,2023-01-09,23:00:00,49,15,34,FMN 02 Mercatorstraat
650,Mercatorstraat 36,2023-01-10,00:00:00,22,8,14,FMN 02 Mercatorstraat
650,Mercatorstraat 36,2023-01-10,01:00:00,13,4,9,FMN 02 Mercatorstraat
650,Mercatorstraat 36,2023-01-10,02:00:00,9,2,7,FMN 02 Mercatorstraat
650,Mercatorstraat 36,2023-01-10,03:00:00,8,1,7,FMN 02 Mercatorstraat
650,Mercatorstraat 36,2023-01-10,04:00:00,22,14,8,FMN 02 Mercatorstraat
650,Mercatorstraat 36,2023-01-10,05:00:00,46,31,15,FMN 02 Mercatorstraat
650,Mercatorstraat 36,2023-01-10,06:00:00,103,66,37,FMN 02 Mercatorstraat
650,Mercatorstraat 36,2023-01-10,07:00:00,391,243,148,FMN 02 Mercatorstraat
650,Mercatorstraat 36,2023-01-10,08:00:00,1019,719,300,FMN 02 Mercatorstraat
650,Mercatorstraat 36,2023-01-10,09:00:00,379,299,80,FMN 02 Mercatorstraat
650,Mercatorstraat 36,2023-01-10,10:00:00,215,135,80,FMN 02 Mercatorstraat
650,Mercatorstraat 36,2023-01-10,11:00:00,233,117,116,FMN 02 Mercatorstraat
650,Mercatorstraat 36,2023-01-10,12:00:00,328,146,182,FMN 02 Mercatorstraat
650,Mercatorstraat 36,2023-01-10,13:00:00,310,129,181,FMN 02 Mercatorstraat
650,Mercatorstraat 36,2023-01-10,14:00:00,230,100,130,FMN 02 Mercatorstraat
650,Mercatorstraat 36,2023-01-10,15:00:00,357,93,264,FMN 02 Mercatorstraat
650,Mercatorstraat 36,2023-01-10,16:00:00,570,199,371,FMN 02 Mercatorstraat
650,Mercatorstraat 36,2023-01-10,17:00:00,662,222,440,FMN 02 Mercatorstraat
650,Mercatorstraat 36,2023-01-10,18:00:00,476,171,305,FMN 02 Mercatorstraat
650,Mercatorstraat 36,2023-01-10,19:00:00,279,127,152,FMN 02 Mercatorstraat
650,Mercatorstraat 36,2023-01-10,20:00:00,172,64,108,FMN 02 Mercatorstraat
650,Mercatorstraat 36,2023-01-10,21:00:00,154,52,102,FMN 02 Mercatorstraat
650,Mercatorstraat 36,2023-01-10,22:00:00,136,43,93,FMN 02 Mercatorstraat
650,Mercatorstraat 36,2023-01-10,23:00:00,83,34,49,FMN 02 Mercatorstraat
650,Mercatorstraat 36,2023-01-11,00:00:00,28,12,16,FMN 02 Mercatorstraat
650,Mercatorstraat 36,2023-01-11,01:00:00,19,3,16,FMN 02 Mercatorstraat
650,Mercatorstraat 36,2023-01-11,02:00:00,10,1,9,FMN 02 Mercatorstraat
650,Mercatorstraat 36,2023-01-11,03:00:00,8,2,6,FMN 02 Mercatorstraat
650,Mercatorstraat 36,2023-01-11,04:00:00,18,10,8,FMN 02 Mercatorstraat
650,Mercatorstraat 36,2023-01-11,05:00:00,44,30,14,FMN 02 Mercatorstraat
650,Mercatorstraat 36,2023-01-11,06:00:00,87,62,25,FMN 02 Mercatorstraat
650,Mercatorstraat 36,2023-01-11,07:00:00,385,223,162,FMN 02 Mercatorstraat
650,Mercatorstraat 36,2023-01-11,08:00:00,900,615,285,FMN 02 Mercatorstraat
650,Mercatorstraat 36,2023-01-11,09:00:00,346,265,81,FMN 02 Mercatorstraat
650,Mercatorstraat 36,2023-01-11,10:00:00,216,137,79,FMN 02 Mercatorstraat
650,Mercatorstraat 36,2023-01-11,11:00:00,251,106,145,FMN 02 Mercatorstraat
650,Mercatorstraat 36,2023-01-11,12:00:00,481,188,293,FMN 02 Mercatorstraat
650,Mercatorstraat 36,2023-01-11,13:00:00,399,189,210,FMN 02 Mercatorstraat
650,Mercatorstraat 36,2023-01-11,14:00:00,324,166,158,FMN 02 Mercatorstraat
650,Mercatorstraat 36,2023-01-11,15:00:00,325,119,206,FMN 02 Mercatorstraat
650,Mercatorstraat 36,2023-01-11,16:00:00,478,160,318,FMN 02 Mercatorstraat
650,Mercatorstraat 36,2023-01-11,17:00:00,635,225,410,FMN 02 Mercatorstraat
650,Mercatorstraat 36,2023-01-11,18:00:00,417,148,269,FMN 02 Mercatorstraat
650,Mercatorstraat 36,2023-01-11,19:00:00,282,132,150,FMN 02 Mercatorstraat
650,Mercatorstraat 36,2023-01-11,20:00:00,140,57,83,FMN 02 Mercatorstraat
650,Mercatorstraat 36,2023-01-11,21:00:00,137,59,78,FMN 02 Mercatorstraat
650,Mercatorstraat 36,2023-01-11,22:00:00,138,55,83,FMN 02 Mercatorstraat
650,Mercatorstraat 36,2023-01-11,23:00:00,89,33,56,FMN 02 Mercatorstraat
650,Mercatorstraat 36,2023-01-12,00:00:00,40,21,19,FMN 02 Mercatorstraat
650,Mercatorstraat 36,2023-01-12,01:00:00,24,8,16,FMN 02 Mercatorstraat
650,Mercatorstraat 36,2023-01-12,02:00:00,9,5,4,FMN 02 Mercatorstraat
650,Mercatorstraat 36,2023-01-12,03:00:00,3,2,1,FMN 02 Mercatorstraat
650,Mercatorstraat 36,2023-01-12,04:00:00,16,11,5,FMN 02 Mercatorstraat
650,Mercatorstraat 36,2023-01-12,05:00:00,30,20,10,FMN 02 Mercatorstraat
650,Mercatorstraat 36,2023-01-12,06:00:00,61,40,21,FMN 02 Mercatorstraat
650,Mercatorstraat 36,2023-01-12,07:00:00,269,159,110,FMN 02 Mercatorstraat
650,Mercatorstraat 36,2023-01-12,08:00:00,675,459,216,FMN 02 Mercatorstraat
650,Mercatorstraat 36,2023-01-12,09:00:00,282,215,67,FMN 02 Mercatorstraat
650,Mercatorstraat 36,2023-01-12,10:00:00,127,84,43,FMN 02 Mercatorstraat
650,Mercatorstraat 36,2023-01-12,11:00:00,139,87,52,FMN 02 Mercatorstraat
650,Mercatorstraat 36,2023-01-12,12:00:00,198,86,112,FMN 02 Mercatorstraat
650,Mercatorstraat 36,2023-01-12,13:00:00,196,82,114,FMN 02 Mercatorstraat
650,Mercatorstraat 36,2023-01-12,14:00:00,150,68,82,FMN 02 Mercatorstraat
650,Mercatorstraat 36,2023-01-12,15:00:00,285,74,211,FMN 02 Mercatorstraat
650,Mercatorstraat 36,2023-01-12,16:00:00,388,133,255,FMN 02 Mercatorstraat
650,Mercatorstraat 36,2023-01-12,17:00:00,458,142,316,FMN 02 Mercatorstraat
650,Mercatorstraat 36,2023-01-12,18:00:00,358,143,215,FMN 02 Mercatorstraat
650,Mercatorstraat 36,2023-01-12,19:00:00,228,118,110,FMN 02 Mercatorstraat
650,Mercatorstraat 36,2023-01-12,20:00:00,143,58,85,FMN 02 Mercatorstraat
650,Mercatorstraat 36,2023-01-12,21:00:00,161,70,91,FMN 02 Mercatorstraat
650,Mercatorstraat 36,2023-01-12,22:00:00,112,48,64,FMN 02 Mercatorstraat
650,Mercatorstraat 36,2023-01-12,23:00:00,87,29,58,FMN 02 Mercatorstraat
650,Mercatorstraat 36,2023-01-13,00:00:00,39,12,27,FMN 02 Mercatorstraat
650,Mercatorstraat 36,2023-01-13,01:00:00,28,16,12,FMN 02 Mercatorstraat
650,Mercatorstraat 36,2023-01-13,02:00:00,14,7,7,FMN 02 Mercatorstraat
650,Mercatorstraat 36,2023-01-13,03:00:00,16,8,8,FMN 02 Mercatorstraat
650,Mercatorstraat 36,2023-01-13,04:00:00,23,12,11,FMN 02 Mercatorstraat
650,Mercatorstraat 36,2023-01-13,05:00:00,35,24,11,FMN 02 Mercatorstraat
650,Mercatorstraat 36,2023-01-13,06:00:00,87,55,32,FMN 02 Mercatorstraat
650,Mercatorstraat 36,2023-01-13,07:00:00,341,197,144,FMN 02 Mercatorstraat
650,Mercatorstraat 36,2023-01-13,08:00:00,848,600,248,FMN 02 Mercatorstraat
650,Mercatorstraat 36,2023-01-13,09:00:00,382,289,93,FMN 02 Mercatorstraat
650,Mercatorstraat 36,2023-01-13,10:00:00,233,136,97,FMN 02 Mercatorstraat
650,Mercatorstraat 36,2023-01-13,11:00:00,230,138,92,FMN 02 Mercatorstraat
650,Mercatorstraat 36,2023-01-13,12:00:00,349,172,177,FMN 02 Mercatorstraat
650,Mercatorstraat 36,2023-01-13,13:00:00,301,146,155,FMN 02 Mercatorstraat
650,Mercatorstraat 36,2023-01-13,14:00:00,277,117,160,FMN 02 Mercatorstraat
650,Mercatorstraat 36,2023-01-13,15:00:00,459,140,319,FMN 02 Mercatorstraat
650,Mercatorstraat 36,2023-01-13,16:00:00,483,151,332,FMN 02 Mercatorstraat
650,Mercatorstraat 36,2023-01-13,17:00:00,529,183,346,FMN 02 Mercatorstraat
650,Mercatorstraat 36,2023-01-13,18:00:00,440,195,245,FMN 02 Mercatorstraat
650,Mercatorstraat 36,2023-01-13,19:00:00,306,148,158,FMN 02 Mercatorstraat
650,Mercatorstraat 36,2023-01-13,20:00:00,206,107,99,FMN 02 Mercatorstraat
650,Mercatorstraat 36,2023-01-13,21:00:00,199,81,118,FMN 02 Mercatorstraat
650,Mercatorstraat 36,2023-01-13,22:00:00,184,69,115,FMN 02 Mercatorstraat
650,Mercatorstraat 36,2023-01-13,23:00:00,207,107,100,FMN 02 Mercatorstraat
650,Mercatorstraat 36,2023-01-14,00:00:00,152,55,97,FMN 02 Mercatorstraat
650,Mercatorstraat 36,2023-01-14,01:00:00,137,62,75,FMN 02 Mercatorstraat
650,Mercatorstraat 36,2023-01-14,02:00:00,62,14,48,FMN 02 Mercatorstraat
650,Mercatorstraat 36,2023-01-14,03:00:00,47,18,29,FMN 02 Mercatorstraat
650,Mercatorstraat 36,2023-01-14,04:00:00,48,14,34,FMN 02 Mercatorstraat
650,Mercatorstraat 36,2023-01-14,05:00:00,37,17,20,FMN 02 Mercatorstraat
650,Mercatorstraat 36,2023-01-14,06:00:00,26,15,11,FMN 02 Mercatorstraat
650,Mercatorstraat 36,2023-01-14,07:00:00,33,18,15,FMN 02 Mercatorstraat
650,Mercatorstraat 36,2023-01-14,08:00:00,70,41,29,FMN 02 Mercatorstraat
650,Mercatorstraat 36,2023-01-14,09:00:00,94,68,26,FMN 02 Mercatorstraat
650,Mercatorstraat 36,2023-01-14,10:00:00,88,54,34,FMN 02 Mercatorstraat
650,Mercatorstraat 36,2023-01-14,11:00:00,105,56,49,FMN 02 Mercatorstraat
650,Mercatorstraat 36,2023-01-14,12:00:00,139,76,63,FMN 02 Mercatorstraat
650,Mercatorstraat 36,2023-01-14,13:00:00,150,92,58,FMN 02 Mercatorstraat
650,Mercatorstraat 36,2023-01-14,14:00:00,174,95,79,FMN 02 Mercatorstraat
650,Mercatorstraat 36,2023-01-14,15:00:00,159,98,61,FMN 02 Mercatorstraat
650,Mercatorstraat 36,2023-01-14,16:00:00,155,62,93,FMN 02 Mercatorstraat
650,Mercatorstraat 36,2023-01-14,17:00:00,162,70,92,FMN 02 Mercatorstraat
650,Mercatorstraat 36,2023-01-14,18:00:00,172,81,91,FMN 02 Mercatorstraat
650,Mercatorstraat 36,2023-01-14,19:00:00,220,116,104,FMN 02 Mercatorstraat
650,Mercatorstraat 36,2023-01-14,20:00:00,129,70,59,FMN 02 Mercatorstraat
650,Mercatorstraat 36,2023-01-14,21:00:00,123,65,58,FMN 02 Mercatorstraat
650,Mercatorstraat 36,2023-01-14,22:00:00,105,45,60,FMN 02 Mercatorstraat
650,Mercatorstraat 36,2023-01-14,23:00:00,132,58,74,FMN 02 Mercatorstraat
650,Mercatorstraat 36,2023-01-15,00:00:00,102,49,53,FMN 02 Mercatorstraat
650,Mercatorstraat 36,2023-01-15,01:00:00,77,23,54,FMN 02 Mercatorstraat
650,Mercatorstraat 36,2023-01-15,02:00:00,46,11,35,FMN 02 Mercatorstraat
650,Mercatorstraat 36,2023-01-15,03:00:00,44,17,27,FMN 02 Mercatorstraat
650,Mercatorstraat 36,2023-01-15,04:00:00,35,12,23,FMN 02 Mercatorstraat
650,Mercatorstraat 36,2023-01-15,05:00:00,19,6,13,FMN 02 Mercatorstraat
650,Mercatorstraat 36,2023-01-15,06:00:00,35,18,17,FMN 02 Mercatorstraat
650,Mercatorstraat 36,2023-01-15,07:00:00,47,21,26,FMN 02 Mercatorstraat
650,Mercatorstraat 36,2023-01-15,08:00:00,104,43,61,FMN 02 Mercatorstraat
650,Mercatorstraat 36,2023-01-15,09:00:00,193,88,105,FMN 02 Mercatorstraat
650,Mercatorstraat 36,2023-01-15,10:00:00,195,123,72,FMN 02 Mercatorstraat
650,Mercatorstraat 36,2023-01-15,11:00:00,168,97,71,FMN 02 Mercatorstraat
650,Mercatorstraat 36,2023-01-15,12:00:00,256,136,120,FMN 02 Mercatorstraat
650,Mercatorstraat 36,2023-01-15,13:00:00,234,132,102,FMN 02 Mercatorstraat
650,Mercatorstraat 36,2023-01-15,14:00:00,229,129,100,FMN 02 Mercatorstraat
650,Mercatorstraat 36,2023-01-15,15:00:00,198,110,88,FMN 02 Mercatorstraat
650,Mercatorstraat 36,2023-01-15,16:00:00,200,74,126,FMN 02 Mercatorstraat
650,Mercatorstraat 36,2023-01-15,17:00:00,212,89,123,FMN 02 Mercatorstraat
650,Mercatorstraat 36,2023-01-15,18:00:00,156,66,90,FMN 02 Mercatorstraat
650,Mercatorstraat 36,2023-01-15,19:00:00,155,58,97,FMN 02 Mercatorstraat
650,Mercatorstraat 36,2023-01-15,20:00:00,119,49,70,FMN 02 Mercatorstraat
650,Mercatorstraat 36,2023-01-15,21:00:00,83,40,43,FMN 02 Mercatorstraat
650,Mercatorstraat 36,2023-01-15,22:00:00,76,30,46,FMN 02 Mercatorstraat
650,Mercatorstraat 36,2023-01-15,23:00:00,45,15,30,FMN 02 Mercatorstraat
650,Mercatorstraat 36,2023-01-16,00:00:00,24,9,15,FMN 02 Mercatorstraat
650,Mercatorstraat 36,2023-01-16,01:00:00,14,7,7,FMN 02 Mercatorstraat
650,Mercatorstraat 36,2023-01-16,02:00:00,8,2,6,FMN 02 Mercatorstraat
650,Mercatorstraat 36,2023-01-16,03:00:00,6,1,5,FMN 02 Mercatorstraat
650,Mercatorstraat 36,2023-01-16,04:00:00,27,17,10,FMN 02 Mercatorstraat
650,Mercatorstraat 36,2023-01-16,05:00:00,37,18,19,FMN 02 Mercatorstraat
650,Mercatorstraat 36,2023-01-16,06:00:00,58,39,19,FMN 02 Mercatorstraat
650,Mercatorstraat 36,2023-01-16,07:00:00,290,189,101,FMN 02 Mercatorstraat
650,Mercatorstraat 36,2023-01-16,08:00:00,712,507,205,FMN 02 Mercatorstraat
650,Mercatorstraat 36,2023-01-16,09:00:00,322,240,82,FMN 02 Mercatorstraat
650,Mercatorstraat 36,2023-01-16,10:00:00,180,104,76,FMN 02 Mercatorstraat
650,Mercatorstraat 36,2023-01-16,11:00:00,151,61,90,FMN 02 Mercatorstraat
650,Mercatorstraat 36,2023-01-16,12:00:00,220,109,111,FMN 02 Mercatorstraat
650,Mercatorstraat 36,2023-01-16,13:00:00,234,97,137,FMN 02 Mercatorstraat
650,Mercatorstraat 36,2023-01-16,14:00:00,230,104,126,FMN 02 Mercatorstraat
650,Mercatorstraat 36,2023-01-16,15:00:00,327,117,210,FMN 02 Mercatorstraat
650,Mercatorstraat 36,2023-01-16,16:00:00,477,137,340,FMN 02 Mercatorstraat
650,Mercatorstraat 36,2023-01-16,17:00:00,525,156,369,FMN 02 Mercatorstraat
650,Mercatorstraat 36,2023-01-16,18:00:00,291,112,179,FMN 02 Mercatorstraat
650,Mercatorstraat 36,2023-01-16,19:00:00,179,71,108,FMN 02 Mercatorstraat
650,Mercatorstraat 36,2023-01-16,20:00:00,131,57,74,FMN 02 Mercatorstraat
650,Mercatorstraat 36,2023-01-16,21:00:00,125,45,80,FMN 02 Mercatorstraat
650,Mercatorstraat 36,2023-01-16,22:00:00,99,36,63,FMN 02 Mercatorstraat
650,Mercatorstraat 36,2023-01-16,23:00:00,46,21,25,FMN 02 Mercatorstraat
650,Mercatorstraat 36,2023-01-17,00:00:00,29,11,18,FMN 02 Mercatorstraat
650,Mercatorstraat 36,2023-01-17,01:00:00,15,10,5,FMN 02 Mercatorstraat
650,Mercatorstraat 36,2023-01-17,02:00:00,13,4,9,FMN 02 Mercatorstraat
650,Mercatorstraat 36,2023-01-17,03:00:00,12,4,8,FMN 02 Mercatorstraat
650,Mercatorstraat 36,2023-01-17,04:00:00,21,14,7,FMN 02 Mercatorstraat
650,Mercatorstraat 36,2023-01-17,05:00:00,31,16,15,FMN 02 Mercatorstraat
650,Mercatorstraat 36,2023-01-17,06:00:00,97,69,28,FMN 02 Mercatorstraat
650,Mercatorstraat 36,2023-01-17,07:00:00,345,209,136,FMN 02 Mercatorstraat
650,Mercatorstraat 36,2023-01-17,08:00:00,986,688,298,FMN 02 Mercatorstraat
650,Mercatorstraat 36,2023-01-17,09:00:00,396,312,84,FMN 02 Mercatorstraat
650,Mercatorstraat 36,2023-01-17,10:00:00,222,137,85,FMN 02 Mercatorstraat
650,Mercatorstraat 36,2023-01-17,11:00:00,223,129,94,FMN 02 Mercatorstraat
650,Mercatorstraat 36,2023-01-17,12:00:00,311,155,156,FMN 02 Mercatorstraat
650,Mercatorstraat 36,2023-01-17,13:00:00,325,157,168,FMN 02 Mercatorstraat
650,Mercatorstraat 36,2023-01-17,14:00:00,255,105,150,FMN 02 Mercatorstraat
650,Mercatorstraat 36,2023-01-17,15:00:00,443,158,285,FMN 02 Mercatorstraat
650,Mercatorstraat 36,2023-01-17,16:00:00,587,192,395,FMN 02 Mercatorstraat
650,Mercatorstraat 36,2023-01-17,17:00:00,690,221,469,FMN 02 Mercatorstraat
650,Mercatorstraat 36,2023-01-17,18:00:00,510,180,330,FMN 02 Mercatorstraat
650,Mercatorstraat 36,2023-01-17,19:00:00,283,122,161,FMN 02 Mercatorstraat
650,Mercatorstraat 36,2023-01-17,20:00:00,205,73,132,FMN 02 Mercatorstraat
650,Mercatorstraat 36,2023-01-17,21:00:00,177,74,103,FMN 02 Mercatorstraat
650,Mercatorstraat 36,2023-01-17,22:00:00,129,45,84,FMN 02 Mercatorstraat
650,Mercatorstraat 36,2023-01-17,23:00:00,75,20,55,FMN 02 Mercatorstraat
650,Mercatorstraat 36,2023-01-18,00:00:00,33,11,22,FMN 02 Mercatorstraat
650,Mercatorstraat 36,2023-01-18,01:00:00,16,5,11,FMN 02 Mercatorstraat
650,Mercatorstraat 36,2023-01-18,02:00:00,9,3,6,FMN 02 Mercatorstraat
650,Mercatorstraat 36,2023-01-18,03:00:00,12,3,9,FMN 02 Mercatorstraat
650,Mercatorstraat 36,2023-01-18,04:00:00,27,16,11,FMN 02 Mercatorstraat
650,Mercatorstraat 36,2023-01-18,05:00:00,33,20,13,FMN 02 Mercatorstraat
650,Mercatorstraat 36,2023-01-18,06:00:00,91,67,24,FMN 02 Mercatorstraat
650,Mercatorstraat 36,2023-01-18,07:00:00,326,199,127,FMN 02 Mercatorstraat
650,Mercatorstraat 36,2023-01-18,08:00:00,857,566,291,FMN 02 Mercatorstraat
650,Mercatorstraat 36,2023-01-18,09:00:00,333,250,83,FMN 02 Mercatorstraat
650,Mercatorstraat 36,2023-01-18,10:00:00,203,124,79,FMN 02 Mercatorstraat
650,Mercatorstraat 36,2023-01-18,11:00:00,238,109,129,FMN 02 Mercatorstraat
650,Mercatorstraat 36,2023-01-18,12:00:00,371,141,230,FMN 02 Mercatorstraat
650,Mercatorstraat 36,2023-01-18,13:00:00,434,175,259,FMN 02 Mercatorstraat
650,Mercatorstraat 36,2023-01-18,14:00:00,338,167,171,FMN 02 Mercatorstraat
650,Mercatorstraat 36,2023-01-18,15:00:00,324,127,197,FMN 02 Mercatorstraat
650,Mercatorstraat 36,2023-01-18,16:00:00,463,178,285,FMN 02 Mercatorstraat
650,Mercatorstraat 36,2023-01-18,17:00:00,600,203,397,FMN 02 Mercatorstraat
650,Mercatorstraat 36,2023-01-18,18:00:00,470,169,301,FMN 02 Mercatorstraat
650,Mercatorstraat 36,2023-01-18,19:00:00,296,148,148,FMN 02 Mercatorstraat
650,Mercatorstraat 36,2023-01-18,20:00:00,159,57,102,FMN 02 Mercatorstraat
650,Mercatorstraat 36,2023-01-18,21:00:00,157,67,90,FMN 02 Mercatorstraat
650,Mercatorstraat 36,2023-01-18,22:00:00,162,66,96,FMN 02 Mercatorstraat
650,Mercatorstraat 36,2023-01-18,23:00:00,67,22,45,FMN 02 Mercatorstraat
650,Mercatorstraat 36,2023-01-19,00:00:00,34,16,18,FMN 02 Mercatorstraat
650,Mercatorstraat 36,2023-01-19,01:00:00,19,5,14,FMN 02 Mercatorstraat
650,Mercatorstraat 36,2023-01-19,02:00:00,13,7,6,FMN 02 Mercatorstraat
650,Mercatorstraat 36,2023-01-19,03:00:00,5,2,3,FMN 02 Mercatorstraat
650,Mercatorstraat 36,2023-01-19,04:00:00,23,17,6,FMN 02 Mercatorstraat
650,Mercatorstraat 36,2023-01-19,05:00:00,32,20,12,FMN 02 Mercatorstraat
650,Mercatorstraat 36,2023-01-19,06:00:00,85,59,26,FMN 02 Mercatorstraat
650,Mercatorstraat 36,2023-01-19,07:00:00,346,206,140,FMN 02 Mercatorstraat
650,Mercatorstraat 36,2023-01-19,08:00:00,916,634,282,FMN 02 Mercatorstraat
650,Mercatorstraat 36,2023-01-19,09:00:00,343,245,98,FMN 02 Mercatorstraat
650,Mercatorstraat 36,2023-01-19,10:00:00,180,114,66,FMN 02 Mercatorstraat
650,Mercatorstraat 36,2023-01-19,11:00:00,192,114,78,FMN 02 Mercatorstraat
650,Mercatorstraat 36,2023-01-19,12:00:00,283,132,151,FMN 02 Mercatorstraat
650,Mercatorstraat 36,2023-01-19,13:00:00,284,135,149,FMN 02 Mercatorstraat
650,Mercatorstraat 36,2023-01-19,14:00:00,285,138,147,FMN 02 Mercatorstraat
650,Mercatorstraat 36,2023-01-19,15:00:00,391,114,277,FMN 02 Mercatorstraat
650,Mercatorstraat 36,2023-01-19,16:00:00,604,188,416,FMN 02 Mercatorstraat
650,Mercatorstraat 36,2023-01-19,17:00:00,622,220,402,FMN 02 Mercatorstraat
650,Mercatorstraat 36,2023-01-19,18:00:00,496,191,305,FMN 02 Mercatorstraat
650,Mercatorstraat 36,2023-01-19,19:00:00,274,129,145,FMN 02 Mercatorstraat
650,Mercatorstraat 36,2023-01-19,20:00:00,174,63,111,FMN 02 Mercatorstraat
650,Mercatorstraat 36,2023-01-19,21:00:00,190,81,109,FMN 02 Mercatorstraat
650,Mercatorstraat 36,2023-01-19,22:00:00,142,56,86,FMN 02 Mercatorstraat
650,Mercatorstraat 36,2023-01-19,23:00:00,87,33,54,FMN 02 Mercatorstraat
650,Mercatorstraat 36,2023-01-20,00:00:00,53,18,35,FMN 02 Mercatorstraat
650,Mercatorstraat 36,2023-01-20,01:00:00,32,14,18,FMN 02 Mercatorstraat
650,Mercatorstraat 36,2023-01-20,02:00:00,9,3,6,FMN 02 Mercatorstraat
650,Mercatorstraat 36,2023-01-20,03:00:00,11,4,7,FMN 02 Mercatorstraat
650,Mercatorstraat 36,2023-01-20,04:00:00,23,14,9,FMN 02 Mercatorstraat
650,Mercatorstraat 36,2023-01-20,05:00:00,32,16,16,FMN 02 Mercatorstraat
650,Mercatorstraat 36,2023-01-20,06:00:00,64,44,20,FMN 02 Mercatorstraat
650,Mercatorstraat 36,2023-01-20,07:00:00,295,171,124,FMN 02 Mercatorstraat
650,Mercatorstraat 36,2023-01-20,08:00:00,583,413,170,FMN 02 Mercatorstraat
650,Mercatorstraat 36,2023-01-20,09:00:00,248,189,59,FMN 02 Mercatorstraat
650,Mercatorstraat 36,2023-01-20,10:00:00,138,96,42,FMN 02 Mercatorstraat
650,Mercatorstraat 36,2023-01-20,11:00:00,154,90,64,FMN 02 Mercatorstraat
650,Mercatorstraat 36,2023-01-20,12:00:00,210,96,114,FMN 02 Mercatorstraat
650,Mercatorstraat 36,2023-01-20,13:00:00,168,77,91,FMN 02 Mercatorstraat
650,Mercatorstraat 36,2023-01-20,14:00:00,174,64,110,FMN 02 Mercatorstraat
650,Mercatorstraat 36,2023-01-20,15:00:00,299,85,214,FMN 02 Mercatorstraat
650,Mercatorstraat 36,2023-01-20,16:00:00,352,102,250,FMN 02 Mercatorstraat
650,Mercatorstraat 36,2023-01-20,17:00:00,341,115,226,FMN 02 Mercatorstraat
650,Mercatorstraat 36,2023-01-20,18:00:00,275,103,172,FMN 02 Mercatorstraat
650,Mercatorstraat 36,2023-01-20,19:00:00,266,159,107,FMN 02 Mercatorstraat
650,Mercatorstraat 36,2023-01-20,20:00:00,165,83,82,FMN 02 Mercatorstraat
650,Mercatorstraat 36,2023-01-20,21:00:00,151,81,70,FMN 02 Mercatorstraat
650,Mercatorstraat 36,2023-01-20,22:00:00,149,48,101,FMN 02 Mercatorstraat
650,Mercatorstraat 36,2023-01-20,23:00:00,122,62,60,FMN 02 Mercatorstraat
650,Mercatorstraat 36,2023-01-21,00:00:00,90,22,68,FMN 02 Mercatorstraat
650,Mercatorstraat 36,2023-01-21,01:00:00,107,40,67,FMN 02 Mercatorstraat
650,Mercatorstraat 36,2023-01-21,02:00:00,72,28,44,FMN 02 Mercatorstraat
650,Mercatorstraat 36,2023-01-21,03:00:00,26,9,17,FMN 02 Mercatorstraat
650,Mercatorstraat 36,2023-01-21,04:00:00,31,12,19,FMN 02 Mercatorstraat
650,Mercatorstraat 36,2023-01-21,05:00:00,29,13,16,FMN 02 Mercatorstraat
650,Mercatorstraat 36,2023-01-21,06:00:00,21,14,7,FMN 02 Mercatorstraat
650,Mercatorstraat 36,2023-01-21,07:00:00,27,10,17,FMN 02 Mercatorstraat
650,Mercatorstraat 36,2023-01-21,08:00:00,68,45,23,FMN 02 Mercatorstraat
650,Mercatorstraat 36,2023-01-21,09:00:00,122,95,27,FMN 02 Mercatorstraat
650,Mercatorstraat 36,2023-01-21,10:00:00,171,115,56,FMN 02 Mercatorstraat
650,Mercatorstraat 36,2023-01-21,11:00:00,200,128,72,FMN 02 Mercatorstraat
650,Mercatorstraat 36,2023-01-21,12:00:00,268,167,101,FMN 02 Mercatorstraat
650,Mercatorstraat 36,2023-01-21,13:00:00,323,184,139,FMN 02 Mercatorstraat
650,Mercatorstraat 36,2023-01-21,14:00:00,321,187,134,FMN 02 Mercatorstraat
650,Mercatorstraat 36,2023-01-21,15:00:00,329,168,161,FMN 02 Mercatorstraat
650,Mercatorstraat 36,2023-01-21,16:00:00,336,98,238,FMN 02 Mercatorstraat
650,Mercatorstraat 36,2023-01-21,17:00:00,271,105,166,FMN 02 Mercatorstraat
650,Mercatorstraat 36,2023-01-21,18:00:00,272,111,161,FMN 02 Mercatorstraat
650,Mercatorstraat 36,2023-01-21,19:00:00,224,130,94,FMN 02 Mercatorstraat
650,Mercatorstraat 36,2023-01-21,20:00:00,165,95,70,FMN 02 Mercatorstraat
650,Mercatorstraat 36,2023-01-21,21:00:00,110,51,59,FMN 02 Mercatorstraat
650,Mercatorstraat 36,2023-01-21,22:00:00,182,57,125,FMN 02 Mercatorstraat
650,Mercatorstraat 36,2023-01-21,23:00:00,124,47,77,FMN 02 Mercatorstraat
650,Mercatorstraat 36,2023-01-22,00:00:00,125,64,61,FMN 02 Mercatorstraat
650,Mercatorstraat 36,2023-01-22,01:00:00,102,52,50,FMN 02 Mercatorstraat
650,Mercatorstraat 36,2023-01-22,02:00:00,54,16,38,FMN 02 Mercatorstraat
650,Mercatorstraat 36,2023-01-22,03:00:00,46,25,21,FMN 02 Mercatorstraat
650,Mercatorstraat 36,2023-01-22,04:00:00,29,11,18,FMN 02 Mercatorstraat
650,Mercatorstraat 36,2023-01-22,05:00:00,50,25,25,FMN 02 Mercatorstraat
650,Mercatorstraat 36,2023-01-22,06:00:00,34,14,20,FMN 02 Mercatorstraat
650,Mercatorstraat 36,2023-01-22,07:00:00,53,24,29,FMN 02 Mercatorstraat
650,Mercatorstraat 36,2023-01-22,08:00:00,79,32,47,FMN 02 Mercatorstraat
650,Mercatorstraat 36,2023-01-22,09:00:00,149,50,99,FMN 02 Mercatorstraat
650,Mercatorstraat 36,2023-01-22,10:00:00,146,84,62,FMN 02 Mercatorstraat
650,Mercatorstraat 36,2023-01-22,11:00:00,131,81,50,FMN 02 Mercatorstraat
650,Mercatorstraat 36,2023-01-22,12:00:00,201,131,70,FMN 02 Mercatorstraat
650,Mercatorstraat 36,2023-01-22,13:00:00,209,122,87,FMN 02 Mercatorstraat
650,Mercatorstraat 36,2023-01-22,14:00:00,244,136,108,FMN 02 Mercatorstraat
650,Mercatorstraat 36,2023-01-22,15:00:00,223,107,116,FMN 02 Mercatorstraat
650,Mercatorstraat 36,2023-01-22,16:00:00,231,80,151,FMN 02 Mercatorstraat
650,Mercatorstraat 36,2023-01-22,17:00:00,184,79,105,FMN 02 Mercatorstraat
650,Mercatorstraat 36,2023-01-22,18:00:00,182,73,109,FMN 02 Mercatorstraat
650,Mercatorstraat 36,2023-01-22,19:00:00,149,65,84,FMN 02 Mercatorstraat
650,Mercatorstraat 36,2023-01-22,20:00:00,123,50,73,FMN 02 Mercatorstraat
650,Mercatorstraat 36,2023-01-22,21:00:00,102,52,50,FMN 02 Mercatorstraat
650,Mercatorstraat 36,2023-01-22,22:00:00,82,41,41,FMN 02 Mercatorstraat
650,Mercatorstraat 36,2023-01-22,23:00:00,40,16,24,FMN 02 Mercatorstraat
650,Mercatorstraat 36,2023-01-23,00:00:00,24,9,15,FMN 02 Mercatorstraat
650,Mercatorstraat 36,2023-01-23,01:00:00,12,8,4,FMN 02 Mercatorstraat
650,Mercatorstraat 36,2023-01-23,02:00:00,5,2,3,FMN 02 Mercatorstraat
650,Mercatorstraat 36,2023-01-23,03:00:00,10,4,6,FMN 02 Mercatorstraat
650,Mercatorstraat 36,2023-01-23,04:00:00,25,14,11,FMN 02 Mercatorstraat
650,Mercatorstraat 36,2023-01-23,05:00:00,40,25,15,FMN 02 Mercatorstraat
650,Mercatorstraat 36,2023-01-23,06:00:00,95,71,24,FMN 02 Mercatorstraat
650,Mercatorstraat 36,2023-01-23,07:00:00,359,231,128,FMN 02 Mercatorstraat
650,Mercatorstraat 36,2023-01-23,08:00:00,900,652,248,FMN 02 Mercatorstraat
650,Mercatorstraat 36,2023-01-23,09:00:00,377,273,104,FMN 02 Mercatorstraat
650,Mercatorstraat 36,2023-01-23,10:00:00,181,105,76,FMN 02 Mercatorstraat
650,Mercatorstraat 36,2023-01-23,11:00:00,191,115,76,FMN 02 Mercatorstraat
650,Mercatorstraat 36,2023-01-23,12:00:00,268,122,146,FMN 02 Mercatorstraat
650,Mercatorstraat 36,2023-01-23,13:00:00,285,130,155,FMN 02 Mercatorstraat
650,Mercatorstraat 36,2023-01-23,14:00:00,263,125,138,FMN 02 Mercatorstraat
650,Mercatorstraat 36,2023-01-23,15:00:00,385,135,250,FMN 02 Mercatorstraat
650,Mercatorstraat 36,2023-01-23,16:00:00,578,169,409,FMN 02 Mercatorstraat
650,Mercatorstraat 36,2023-01-23,17:00:00,646,202,444,FMN 02 Mercatorstraat
650,Mercatorstraat 36,2023-01-23,18:00:00,401,133,268,FMN 02 Mercatorstraat
650,Mercatorstraat 36,2023-01-23,19:00:00,296,167,129,FMN 02 Mercatorstraat
650,Mercatorstraat 36,2023-01-23,20:00:00,172,72,100,FMN 02 Mercatorstraat
650,Mercatorstraat 36,2023-01-23,21:00:00,154,55,99,FMN 02 Mercatorstraat
650,Mercatorstraat 36,2023-01-23,22:00:00,151,36,115,FMN 02 Mercatorstraat
650,Mercatorstraat 36,2023-01-23,23:00:00,73,18,55,FMN 02 Mercatorstraat
650,Mercatorstraat 36,2023-01-24,00:00:00,35,13,22,FMN 02 Mercatorstraat
650,Mercatorstraat 36,2023-01-24,01:00:00,16,4,12,FMN 02 Mercatorstraat
650,Mercatorstraat 36,2023-01-24,02:00:00,15,7,8,FMN 02 Mercatorstraat
650,Mercatorstraat 36,2023-01-24,03:00:00,6,3,3,FMN 02 Mercatorstraat
650,Mercatorstraat 36,2023-01-24,04:00:00,35,18,17,FMN 02 Mercatorstraat
650,Mercatorstraat 36,2023-01-24,05:00:00,43,26,17,FMN 02 Mercatorstraat
650,Mercatorstraat 36,2023-01-24,06:00:00,94,65,29,FMN 02 Mercatorstraat
650,Mercatorstraat 36,2023-01-24,07:00:00,370,227,143,FMN 02 Mercatorstraat
650,Mercatorstraat 36,2023-01-24,08:00:00,987,694,293,FMN 02 Mercatorstraat
650,Mercatorstraat 36,2023-01-24,09:00:00,402,308,94,FMN 02 Mercatorstraat
650,Mercatorstraat 36,2023-01-24,10:00:00,223,138,85,FMN 02 Mercatorstraat
650,Mercatorstraat 36,2023-01-24,11:00:00,184,100,84,FMN 02 Mercatorstraat
650,Mercatorstraat 36,2023-01-24,12:00:00,325,156,169,FMN 02 Mercatorstraat
650,Mercatorstraat 36,2023-01-24,13:00:00,319,135,184,FMN 02 Mercatorstraat
650,Mercatorstraat 36,2023-01-24,14:00:00,270,134,136,FMN 02 Mercatorstraat
650,Mercatorstraat 36,2023-01-24,15:00:00,397,116,281,FMN 02 Mercatorstraat
650,Mercatorstraat 36,2023-01-24,16:00:00,607,210,397,FMN 02 Mercatorstraat
650,Mercatorstraat 36,2023-01-24,17:00:00,707,210,497,FMN 02 Mercatorstraat
650,Mercatorstraat 36,2023-01-24,18:00:00,507,185,322,FMN 02 Mercatorstraat
650,Mercatorstraat 36,2023-01-24,19:00:00,305,130,175,FMN 02 Mercatorstraat
650,Mercatorstraat 36,2023-01-24,20:00:00,182,73,109,FMN 02 Mercatorstraat
650,Mercatorstraat 36,2023-01-24,21:00:00,171,70,101,FMN 02 Mercatorstraat
650,Mercatorstraat 36,2023-01-24,22:00:00,165,67,98,FMN 02 Mercatorstraat
650,Mercatorstraat 36,2023-01-24,23:00:00,75,27,48,FMN 02 Mercatorstraat
650,Mercatorstraat 36,2023-01-25,00:00:00,45,20,25,FMN 02 Mercatorstraat
650,Mercatorstraat 36,2023-01-25,01:00:00,17,10,7,FMN 02 Mercatorstraat
650,Mercatorstraat 36,2023-01-25,02:00:00,13,3,10,FMN 02 Mercatorstraat
650,Mercatorstraat 36,2023-01-25,03:00:00,14,3,11,FMN 02 Mercatorstraat
650,Mercatorstraat 36,2023-01-25,04:00:00,18,9,9,FMN 02 Mercatorstraat
650,Mercatorstraat 36,2023-01-25,05:00:00,38,21,17,FMN 02 Mercatorstraat
650,Mercatorstraat 36,2023-01-25,06:00:00,100,69,31,FMN 02 Mercatorstraat
650,Mercatorstraat 36,2023-01-25,07:00:00,351,221,130,FMN 02 Mercatorstraat
650,Mercatorstraat 36,2023-01-25,08:00:00,837,567,270,FMN 02 Mercatorstraat
650,Mercatorstraat 36,2023-01-25,09:00:00,358,258,100,FMN 02 Mercatorstraat
650,Mercatorstraat 36,2023-01-25,10:00:00,186,110,76,FMN 02 Mercatorstraat
650,Mercatorstraat 36,2023-01-25,11:00:00,217,112,105,FMN 02 Mercatorstraat
650,Mercatorstraat 36,2023-01-25,12:00:00,451,209,242,FMN 02 Mercatorstraat
650,Mercatorstraat 36,2023-01-25,13:00:00,402,183,219,FMN 02 Mercatorstraat
650,Mercatorstraat 36,2023-01-25,14:00:00,301,142,159,FMN 02 Mercatorstraat
650,Mercatorstraat 36,2023-01-25,15:00:00,316,131,185,FMN 02 Mercatorstraat
650,Mercatorstraat 36,2023-01-25,16:00:00,430,156,274,FMN 02 Mercatorstraat
650,Mercatorstraat 36,2023-01-25,17:00:00,566,173,393,FMN 02 Mercatorstraat
650,Mercatorstraat 36,2023-01-25,18:00:00,436,161,275,FMN 02 Mercatorstraat
650,Mercatorstraat 36,2023-01-25,19:00:00,255,109,146,FMN 02 Mercatorstraat
650,Mercatorstraat 36,2023-01-25,20:00:00,161,59,102,FMN 02 Mercatorstraat
650,Mercatorstraat 36,2023-01-25,21:00:00,121,49,72,FMN 02 Mercatorstraat
650,Mercatorstraat 36,2023-01-25,22:00:00,170,63,107,FMN 02 Mercatorstraat
650,Mercatorstraat 36,2023-01-25,23:00:00,76,24,52,FMN 02 Mercatorstraat
650,Mercatorstraat 36,2023-01-26,00:00:00,42,20,22,FMN 02 Mercatorstraat
650,Mercatorstraat 36,2023-01-26,01:00:00,15,7,8,FMN 02 Mercatorstraat
650,Mercatorstraat 36,2023-01-26,02:00:00,17,7,10,FMN 02 Mercatorstraat
650,Mercatorstraat 36,2023-01-26,03:00:00,9,3,6,FMN 02 Mercatorstraat
650,Mercatorstraat 36,2023-01-26,04:00:00,33,18,15,FMN 02 Mercatorstraat
650,Mercatorstraat 36,2023-01-26,05:00:00,33,14,19,FMN 02 Mercatorstraat
650,Mercatorstraat 36,2023-01-26,06:00:00,82,57,25,FMN 02 Mercatorstraat
650,Mercatorstraat 36,2023-01-26,07:00:00,353,215,138,FMN 02 Mercatorstraat
650,Mercatorstraat 36,2023-01-26,08:00:00,855,606,249,FMN 02 Mercatorstraat
650,Mercatorstraat 36,2023-01-26,09:00:00,350,261,89,FMN 02 Mercatorstraat
650,Mercatorstraat 36,2023-01-26,10:00:00,181,122,59,FMN 02 Mercatorstraat
650,Mercatorstraat 36,2023-01-26,11:00:00,177,104,73,FMN 02 Mercatorstraat
650,Mercatorstraat 36,2023-01-26,12:00:00,280,150,130,FMN 02 Mercatorstraat
650,Mercatorstraat 36,2023-01-26,13:00:00,314,135,179,FMN 02 Mercatorstraat
650,Mercatorstraat 36,2023-01-26,14:00:00,284,133,151,FMN 02 Mercatorstraat
650,Mercatorstraat 36,2023-01-26,15:00:00,402,126,276,FMN 02 Mercatorstraat
650,Mercatorstraat 36,2023-01-26,16:00:00,566,204,362,FMN 02 Mercatorstraat
650,Mercatorstraat 36,2023-01-26,17:00:00,605,203,402,FMN 02 Mercatorstraat
650,Mercatorstraat 36,2023-01-26,18:00:00,489,182,307,FMN 02 Mercatorstraat
650,Mercatorstraat 36,2023-01-26,19:00:00,319,171,148,FMN 02 Mercatorstraat
650,Mercatorstraat 36,2023-01-26,20:00:00,231,102,129,FMN 02 Mercatorstraat
650,Mercatorstraat 36,2023-01-26,21:00:00,203,81,122,FMN 02 Mercatorstraat
650,Mercatorstraat 36,2023-01-26,22:00:00,169,71,98,FMN 02 Mercatorstraat
650,Mercatorstraat 36,2023-01-26,23:00:00,130,53,77,FMN 02 Mercatorstraat
650,Mercatorstraat 36,2023-01-27,00:00:00,85,40,45,FMN 02 Mercatorstraat
650,Mercatorstraat 36,2023-01-27,01:00:00,52,12,40,FMN 02 Mercatorstraat
650,Mercatorstraat 36,2023-01-27,02:00:00,25,7,18,FMN 02 Mercatorstraat
650,Mercatorstraat 36,2023-01-27,03:00:00,35,7,28,FMN 02 Mercatorstraat
650,Mercatorstraat 36,2023-01-27,04:00:00,39,17,22,FMN 02 Mercatorstraat
650,Mercatorstraat 36,2023-01-27,05:00:00,48,27,21,FMN 02 Mercatorstraat
650,Mercatorstraat 36,2023-01-27,06:00:00,103,65,38,FMN 02 Mercatorstraat
650,Mercatorstraat 36,2023-01-27,07:00:00,318,197,121,FMN 02 Mercatorstraat
650,Mercatorstraat 36,2023-01-27,08:00:00,763,522,241,FMN 02 Mercatorstraat
650,Mercatorstraat 36,2023-01-27,09:00:00,348,249,99,FMN 02 Mercatorstraat
650,Mercatorstraat 36,2023-01-27,10:00:00,214,140,74,FMN 02 Mercatorstraat
650,Mercatorstraat 36,2023-01-27,11:00:00,238,134,104,FMN 02 Mercatorstraat
650,Mercatorstraat 36,2023-01-27,12:00:00,387,212,175,FMN 02 Mercatorstraat
650,Mercatorstraat 36,2023-01-27,13:00:00,322,167,155,FMN 02 Mercatorstraat
650,Mercatorstraat 36,2023-01-27,14:00:00,308,134,174,FMN 02 Mercatorstraat
650,Mercatorstraat 36,2023-01-27,15:00:00,394,141,253,FMN 02 Mercatorstraat
650,Mercatorstraat 36,2023-01-27,16:00:00,545,187,358,FMN 02 Mercatorstraat
650,Mercatorstraat 36,2023-01-27,17:00:00,550,194,356,FMN 02 Mercatorstraat
650,Mercatorstraat 36,2023-01-27,18:00:00,442,177,265,FMN 02 Mercatorstraat
650,Mercatorstraat 36,2023-01-27,19:00:00,305,165,140,FMN 02 Mercatorstraat
650,Mercatorstraat 36,2023-01-27,20:00:00,186,81,105,FMN 02 Mercatorstraat
650,Mercatorstraat 36,2023-01-27,21:00:00,158,80,78,FMN 02 Mercatorstraat
650,Mercatorstraat 36,2023-01-27,22:00:00,218,89,129,FMN 02 Mercatorstraat
650,Mercatorstraat 36,2023-01-27,23:00:00,173,63,110,FMN 02 Mercatorstraat
650,Mercatorstraat 36,2023-01-28,00:00:00,133,59,74,FMN 02 Mercatorstraat
650,Mercatorstraat 36,2023-01-28,01:00:00,137,48,89,FMN 02 Mercatorstraat
650,Mercatorstraat 36,2023-01-28,02:00:00,88,23,65,FMN 02 Mercatorstraat
650,Mercatorstraat 36,2023-01-28,03:00:00,95,15,80,FMN 02 Mercatorstraat
650,Mercatorstraat 36,2023-01-28,04:00:00,55,15,40,FMN 02 Mercatorstraat
650,Mercatorstraat 36,2023-01-28,05:00:00,47,12,35,FMN 02 Mercatorstraat
650,Mercatorstraat 36,2023-01-28,06:00:00,38,12,26,FMN 02 Mercatorstraat
650,Mercatorstraat 36,2023-01-28,07:00:00,50,26,24,FMN 02 Mercatorstraat
650,Mercatorstraat 36,2023-01-28,08:00:00,80,50,30,FMN 02 Mercatorstraat
650,Mercatorstraat 36,2023-01-28,09:00:00,169,131,38,FMN 02 Mercatorstraat
650,Mercatorstraat 36,2023-01-28,10:00:00,216,158,58,FMN 02 Mercatorstraat
650,Mercatorstraat 36,2023-01-28,11:00:00,224,133,91,FMN 02 Mercatorstraat
650,Mercatorstraat 36,2023-01-28,12:00:00,351,176,175,FMN 02 Mercatorstraat
650,Mercatorstraat 36,2023-01-28,13:00:00,319,199,120,FMN 02 Mercatorstraat
650,Mercatorstraat 36,2023-01-28,14:00:00,370,224,146,FMN 02 Mercatorstraat
650,Mercatorstraat 36,2023-01-28,15:00:00,341,178,163,FMN 02 Mercatorstraat
650,Mercatorstraat 36,2023-01-28,16:00:00,337,111,226,FMN 02 Mercatorstraat
650,Mercatorstraat 36,2023-01-28,17:00:00,327,123,204,FMN 02 Mercatorstraat
650,Mercatorstraat 36,2023-01-28,18:00:00,307,135,172,FMN 02 Mercatorstraat
650,Mercatorstraat 36,2023-01-28,19:00:00,272,170,102,FMN 02 Mercatorstraat
650,Mercatorstraat 36,2023-01-28,20:00:00,140,73,67,FMN 02 Mercatorstraat
650,Mercatorstraat 36,2023-01-28,21:00:00,157,78,79,FMN 02 Mercatorstraat
650,Mercatorstraat 36,2023-01-28,22:00:00,168,47,121,FMN 02 Mercatorstraat
650,Mercatorstraat 36,2023-01-28,23:00:00,162,63,99,FMN 02 Mercatorstraat
650,Mercatorstraat 36,2023-01-29,00:00:00,105,44,61,FMN 02 Mercatorstraat
650,Mercatorstraat 36,2023-01-29,01:00:00,112,56,56,FMN 02 Mercatorstraat
650,Mercatorstraat 36,2023-01-29,02:00:00,62,28,34,FMN 02 Mercatorstraat
650,Mercatorstraat 36,2023-01-29,03:00:00,69,16,53,FMN 02 Mercatorstraat
650,Mercatorstraat 36,2023-01-29,04:00:00,41,9,32,FMN 02 Mercatorstraat
650,Mercatorstraat 36,2023-01-29,05:00:00,48,16,32,FMN 02 Mercatorstraat
650,Mercatorstraat 36,2023-01-29,06:00:00,47,10,37,FMN 02 Mercatorstraat
650,Mercatorstraat 36,2023-01-29,07:00:00,72,20,52,FMN 02 Mercatorstraat
650,Mercatorstraat 36,2023-01-29,08:00:00,84,34,50,FMN 02 Mercatorstraat
650,Mercatorstraat 36,2023-01-29,09:00:00,196,83,113,FMN 02 Mercatorstraat
650,Mercatorstraat 36,2023-01-29,10:00:00,172,111,61,FMN 02 Mercatorstraat
650,Mercatorstraat 36,2023-01-29,11:00:00,145,67,78,FMN 02 Mercatorstraat
650,Mercatorstraat 36,2023-01-29,12:00:00,222,146,76,FMN 02 Mercatorstraat
650,Mercatorstraat 36,2023-01-29,13:00:00,250,143,107,FMN 02 Mercatorstraat
650,Mercatorstraat 36,2023-01-29,14:00:00,260,145,115,FMN 02 Mercatorstraat
650,Mercatorstraat 36,2023-01-29,15:00:00,227,118,109,FMN 02 Mercatorstraat
650,Mercatorstraat 36,2023-01-29,16:00:00,234,73,161,FMN 02 Mercatorstraat
650,Mercatorstraat 36,2023-01-29,17:00:00,238,101,137,FMN 02 Mercatorstraat
650,Mercatorstraat 36,2023-01-29,18:00:00,205,97,108,FMN 02 Mercatorstraat
650,Mercatorstraat 36,2023-01-29,19:00:00,180,69,111,FMN 02 Mercatorstraat
650,Mercatorstraat 36,2023-01-29,20:00:00,125,55,70,FMN 02 Mercatorstraat
650,Mercatorstraat 36,2023-01-29,21:00:00,99,44,55,FMN 02 Mercatorstraat
650,Mercatorstraat 36,2023-01-29,22:00:00,95,37,58,FMN 02 Mercatorstraat
650,Mercatorstraat 36,2023-01-29,23:00:00,38,12,26,FMN 02 Mercatorstraat
650,Mercatorstraat 36,2023-01-30,00:00:00,30,7,23,FMN 02 Mercatorstraat
650,Mercatorstraat 36,2023-01-30,01:00:00,19,11,8,FMN 02 Mercatorstraat
650,Mercatorstraat 36,2023-01-30,02:00:00,10,3,7,FMN 02 Mercatorstraat
650,Mercatorstraat 36,2023-01-30,03:00:00,11,6,5,FMN 02 Mercatorstraat
650,Mercatorstraat 36,2023-01-30,04:00:00,23,17,6,FMN 02 Mercatorstraat
650,Mercatorstraat 36,2023-01-30,05:00:00,43,22,21,FMN 02 Mercatorstraat
650,Mercatorstraat 36,2023-01-30,06:00:00,90,64,26,FMN 02 Mercatorstraat
650,Mercatorstraat 36,2023-01-30,07:00:00,351,219,132,FMN 02 Mercatorstraat
650,Mercatorstraat 36,2023-01-30,08:00:00,901,648,253,FMN 02 Mercatorstraat
650,Mercatorstraat 36,2023-01-30,09:00:00,378,280,98,FMN 02 Mercatorstraat
650,Mercatorstraat 36,2023-01-30,10:00:00,197,130,67,FMN 02 Mercatorstraat
650,Mercatorstraat 36,2023-01-30,11:00:00,209,124,85,FMN 02 Mercatorstraat
650,Mercatorstraat 36,2023-01-30,12:00:00,299,169,130,FMN 02 Mercatorstraat
650,Mercatorstraat 36,2023-01-30,13:00:00,337,156,181,FMN 02 Mercatorstraat
650,Mercatorstraat 36,2023-01-30,14:00:00,301,153,148,FMN 02 Mercatorstraat
650,Mercatorstraat 36,2023-01-30,15:00:00,409,117,292,FMN 02 Mercatorstraat
650,Mercatorstraat 36,2023-01-30,16:00:00,556,172,384,FMN 02 Mercatorstraat
650,Mercatorstraat 36,2023-01-30,17:00:00,689,210,479,FMN 02 Mercatorstraat
650,Mercatorstraat 36,2023-01-30,18:00:00,434,133,301,FMN 02 Mercatorstraat
650,Mercatorstraat 36,2023-01-30,19:00:00,270,129,141,FMN 02 Mercatorstraat
650,Mercatorstraat 36,2023-01-30,20:00:00,169,77,92,FMN 02 Mercatorstraat
650,Mercatorstraat 36,2023-01-30,21:00:00,180,76,104,FMN 02 Mercatorstraat
650,Mercatorstraat 36,2023-01-30,22:00:00,152,45,107,FMN 02 Mercatorstraat
650,Mercatorstraat 36,2023-01-30,23:00:00,81,28,53,FMN 02 Mercatorstraat
650,Mercatorstraat 36,2023-01-31,00:00:00,23,13,10,FMN 02 Mercatorstraat
650,Mercatorstraat 36,2023-01-31,01:00:00,20,10,10,FMN 02 Mercatorstraat
650,Mercatorstraat 36,2023-01-31,02:00:00,17,7,10,FMN 02 Mercatorstraat
650,Mercatorstraat 36,2023-01-31,03:00:00,13,6,7,FMN 02 Mercatorstraat
650,Mercatorstraat 36,2023-01-31,04:00:00,28,16,12,FMN 02 Mercatorstraat
650,Mercatorstraat 36,2023-01-31,05:00:00,37,20,17,FMN 02 Mercatorstraat
650,Mercatorstraat 36,2023-01-31,06:00:00,96,63,33,FMN 02 Mercatorstraat
650,Mercatorstraat 36,2023-01-31,07:00:00,408,263,145,FMN 02 Mercatorstraat
650,Mercatorstraat 36,2023-01-31,08:00:00,974,689,285,FMN 02 Mercatorstraat
650,Mercatorstraat 36,2023-01-31,09:00:00,370,279,91,FMN 02 Mercatorstraat
650,Mercatorstraat 36,2023-01-31,10:00:00,195,118,77,FMN 02 Mercatorstraat
650,Mercatorstraat 36,2023-01-31,11:00:00,219,106,113,FMN 02 Mercatorstraat
650,Mercatorstraat 36,2023-01-31,12:00:00,295,153,142,FMN 02 Mercatorstraat
650,Mercatorstraat 36,2023-01-31,13:00:00,298,140,158,FMN 02 Mercatorstraat
650,Mercatorstraat 36,2023-01-31,14:00:00,277,132,145,FMN 02 Mercatorstraat
650,Mercatorstraat 36,2023-01-31,15:00:00,402,120,282,FMN 02 Mercatorstraat
650,Mercatorstraat 36,2023-01-31,16:00:00,609,195,414,FMN 02 Mercatorstraat
650,Mercatorstraat 36,2023-01-31,17:00:00,730,241,489,FMN 02 Mercatorstraat
650,Mercatorstraat 36,2023-01-31,18:00:00,495,187,308,FMN 02 Mercatorstraat
650,Mercatorstraat 36,2023-01-31,19:00:00,294,145,149,FMN 02 Mercatorstraat
650,Mercatorstraat 36,2023-01-31,20:00:00,196,69,127,FMN 02 Mercatorstraat
650,Mercatorstraat 36,2023-01-31,21:00:00,192,77,115,FMN 02 Mercatorstraat
650,Mercatorstraat 36,2023-01-31,22:00:00,150,53,97,FMN 02 Mercatorstraat
650,Mercatorstraat 36,2023-01-31,23:00:00,85,30,55,FMN 02 Mercatorstraat
650,Mercatorstraat 36,2023-02-01,00:00:00,41,12,29,FMN 02 Mercatorstraat
650,Mercatorstraat 36,2023-02-01,01:00:00,29,6,23,FMN 02 Mercatorstraat
650,Mercatorstraat 36,2023-02-01,02:00:00,22,6,16,FMN 02 Mercatorstraat
650,Mercatorstraat 36,2023-02-01,03:00:00,16,7,9,FMN 02 Mercatorstraat
650,Mercatorstraat 36,2023-02-01,04:00:00,25,16,9,FMN 02 Mercatorstraat
650,Mercatorstraat 36,2023-02-01,05:00:00,46,25,21,FMN 02 Mercatorstraat
650,Mercatorstraat 36,2023-02-01,06:00:00,97,72,25,FMN 02 Mercatorstraat
650,Mercatorstraat 36,2023-02-01,07:00:00,359,227,132,FMN 02 Mercatorstraat
650,Mercatorstraat 36,2023-02-01,08:00:00,845,585,260,FMN 02 Mercatorstraat
650,Mercatorstraat 36,2023-02-01,09:00:00,344,264,80,FMN 02 Mercatorstraat
650,Mercatorstraat 36,2023-02-01,10:00:00,219,131,88,FMN 02 Mercatorstraat
650,Mercatorstraat 36,2023-02-01,11:00:00,214,92,122,FMN 02 Mercatorstraat
650,Mercatorstraat 36,2023-02-01,12:00:00,477,194,283,FMN 02 Mercatorstraat
650,Mercatorstraat 36,2023-02-01,13:00:00,370,173,197,FMN 02 Mercatorstraat
650,Mercatorstraat 36,2023-02-01,14:00:00,309,142,167,FMN 02 Mercatorstraat
650,Mercatorstraat 36,2023-02-01,15:00:00,314,123,191,FMN 02 Mercatorstraat
650,Mercatorstraat 36,2023-02-01,16:00:00,420,153,267,FMN 02 Mercatorstraat
650,Mercatorstraat 36,2023-02-01,17:00:00,574,196,378,FMN 02 Mercatorstraat
650,Mercatorstraat 36,2023-02-01,18:00:00,458,183,275,FMN 02 Mercatorstraat
650,Mercatorstraat 36,2023-02-01,19:00:00,308,150,158,FMN 02 Mercatorstraat
650,Mercatorstraat 36,2023-02-01,20:00:00,196,81,115,FMN 02 Mercatorstraat
650,Mercatorstraat 36,2023-02-01,21:00:00,169,65,104,FMN 02 Mercatorstraat
650,Mercatorstraat 36,2023-02-01,22:00:00,199,78,121,FMN 02 Mercatorstraat
650,Mercatorstraat 36,2023-02-01,23:00:00,123,52,71,FMN 02 Mercatorstraat
650,Mercatorstraat 36,2023-02-02,00:00:00,83,32,51,FMN 02 Mercatorstraat
650,Mercatorstraat 36,2023-02-02,01:00:00,37,18,19,FMN 02 Mercatorstraat
650,Mercatorstraat 36,2023-02-02,02:00:00,19,1,18,FMN 02 Mercatorstraat
650,Mercatorstraat 36,2023-02-02,03:00:00,31,5,26,FMN 02 Mercatorstraat
650,Mercatorstraat 36,2023-02-02,04:00:00,52,18,34,FMN 02 Mercatorstraat
650,Mercatorstraat 36,2023-02-02,05:00:00,56,27,29,FMN 02 Mercatorstraat
650,Mercatorstraat 36,2023-02-02,06:00:00,92,60,32,FMN 02 Mercatorstraat
650,Mercatorstraat 36,2023-02-02,07:00:00,371,227,144,FMN 02 Mercatorstraat
650,Mercatorstraat 36,2023-02-02,08:00:00,952,664,288,FMN 02 Mercatorstraat
650,Mercatorstraat 36,2023-02-02,09:00:00,418,305,113,FMN 02 Mercatorstraat
650,Mercatorstraat 36,2023-02-02,10:00:00,221,139,82,FMN 02 Mercatorstraat
650,Mercatorstraat 36,2023-02-02,11:00:00,243,128,115,FMN 02 Mercatorstraat
650,Mercatorstraat 36,2023-02-02,12:00:00,284,143,141,FMN 02 Mercatorstraat
650,Mercatorstraat 36,2023-02-02,13:00:00,334,164,170,FMN 02 Mercatorstraat
650,Mercatorstraat 36,2023-02-02,14:00:00,292,130,162,FMN 02 Mercatorstraat
650,Mercatorstraat 36,2023-02-02,15:00:00,408,112,296,FMN 02 Mercatorstraat
650,Mercatorstraat 36,2023-02-02,16:00:00,627,192,435,FMN 02 Mercatorstraat
650,Mercatorstraat 36,2023-02-02,17:00:00,698,217,481,FMN 02 Mercatorstraat
650,Mercatorstraat 36,2023-02-02,18:00:00,546,224,322,FMN 02 Mercatorstraat
650,Mercatorstraat 36,2023-02-02,19:00:00,315,159,156,FMN 02 Mercatorstraat
650,Mercatorstraat 36,2023-02-02,20:00:00,227,105,122,FMN 02 Mercatorstraat
650,Mercatorstraat 36,2023-02-02,21:00:00,217,87,130,FMN 02 Mercatorstraat
650,Mercatorstraat 36,2023-02-02,22:00:00,196,74,122,FMN 02 Mercatorstraat
650,Mercatorstraat 36,2023-02-02,23:00:00,156,63,93,FMN 02 Mercatorstraat
650,Mercatorstraat 36,2023-02-03,00:00:00,96,42,54,FMN 02 Mercatorstraat
650,Mercatorstraat 36,2023-02-03,01:00:00,54,22,32,FMN 02 Mercatorstraat
650,Mercatorstraat 36,2023-02-03,02:00:00,32,6,26,FMN 02 Mercatorstraat
650,Mercatorstraat 36,2023-02-03,03:00:00,29,4,25,FMN 02 Mercatorstraat
650,Mercatorstraat 36,2023-02-03,04:00:00,47,17,30,FMN 02 Mercatorstraat
650,Mercatorstraat 36,2023-02-03,05:00:00,49,23,26,FMN 02 Mercatorstraat
650,Mercatorstraat 36,2023-02-03,06:00:00,103,60,43,FMN 02 Mercatorstraat
650,Mercatorstraat 36,2023-02-03,07:00:00,340,214,126,FMN 02 Mercatorstraat
650,Mercatorstraat 36,2023-02-03,08:00:00,786,546,240,FMN 02 Mercatorstraat
650,Mercatorstraat 36,2023-02-03,09:00:00,344,260,84,FMN 02 Mercatorstraat
650,Mercatorstraat 36,2023-02-03,10:00:00,271,186,85,FMN 02 Mercatorstraat
650,Mercatorstraat 36,2023-02-03,11:00:00,248,158,90,FMN 02 Mercatorstraat
650,Mercatorstraat 36,2023-02-03,12:00:00,433,229,204,FMN 02 Mercatorstraat
650,Mercatorstraat 36,2023-02-03,13:00:00,304,141,163,FMN 02 Mercatorstraat
650,Mercatorstraat 36,2023-02-03,14:00:00,298,130,168,FMN 02 Mercatorstraat
650,Mercatorstraat 36,2023-02-03,15:00:00,442,163,279,FMN 02 Mercatorstraat
650,Mercatorstraat 36,2023-02-03,16:00:00,559,188,371,FMN 02 Mercatorstraat
650,Mercatorstraat 36,2023-02-03,17:00:00,567,181,386,FMN 02 Mercatorstraat
650,Mercatorstraat 36,2023-02-03,18:00:00,401,159,242,FMN 02 Mercatorstraat
650,Mercatorstraat 36,2023-02-03,19:00:00,318,170,148,FMN 02 Mercatorstraat
650,Mercatorstraat 36,2023-02-03,20:00:00,197,99,98,FMN 02 Mercatorstraat
650,Mercatorstraat 36,2023-02-03,21:00:00,180,92,88,FMN 02 Mercatorstraat
650,Mercatorstraat 36,2023-02-03,22:00:00,144,62,82,FMN 02 Mercatorstraat
650,Mercatorstraat 36,2023-02-03,23:00:00,182,82,100,FMN 02 Mercatorstraat
650,Mercatorstraat 36,2023-02-04,00:00:00,146,52,94,FMN 02 Mercatorstraat
650,Mercatorstraat 36,2023-02-04,01:00:00,101,43,58,FMN 02 Mercatorstraat
650,Mercatorstraat 36,2023-02-04,02:00:00,83,31,52,FMN 02 Mercatorstraat
650,Mercatorstraat 36,2023-02-04,03:00:00,59,11,48,FMN 02 Mercatorstraat
650,Mercatorstraat 36,2023-02-04,04:00:00,57,17,40,FMN 02 Mercatorstraat
650,Mercatorstraat 36,2023-02-04,05:00:00,39,11,28,FMN 02 Mercatorstraat
650,Mercatorstraat 36,2023-02-04,06:00:00,30,13,17,FMN 02 Mercatorstraat
650,Mercatorstraat 36,2023-02-04,07:00:00,44,16,28,FMN 02 Mercatorstraat
650,Mercatorstraat 36,2023-02-04,08:00:00,74,50,24,FMN 02 Mercatorstraat
650,Mercatorstraat 36,2023-02-04,09:00:00,136,98,38,FMN 02 Mercatorstraat
650,Mercatorstraat 36,2023-02-04,10:00:00,165,104,61,FMN 02 Mercatorstraat
650,Mercatorstraat 36,2023-02-04,11:00:00,195,114,81,FMN 02 Mercatorstraat
650,Mercatorstraat 36,2023-02-04,12:00:00,200,114,86,FMN 02 Mercatorstraat
650,Mercatorstraat 36,2023-02-04,13:00:00,234,141,93,FMN 02 Mercatorstraat
650,Mercatorstraat 36,2023-02-04,14:00:00,253,144,109,FMN 02 Mercatorstraat
650,Mercatorstraat 36,2023-02-04,15:00:00,241,122,119,FMN 02 Mercatorstraat
650,Mercatorstraat 36,2023-02-04,16:00:00,256,110,146,FMN 02 Mercatorstraat
650,Mercatorstraat 36,2023-02-04,17:00:00,307,121,186,FMN 02 Mercatorstraat
650,Mercatorstraat 36,2023-02-04,18:00:00,273,132,141,FMN 02 Mercatorstraat
650,Mercatorstraat 36,2023-02-04,19:00:00,239,141,98,FMN 02 Mercatorstraat
650,Mercatorstraat 36,2023-02-04,20:00:00,173,89,84,FMN 02 Mercatorstraat
650,Mercatorstraat 36,2023-02-04,21:00:00,154,67,87,FMN 02 Mercatorstraat
650,Mercatorstraat 36,2023-02-04,22:00:00,158,62,96,FMN 02 Mercatorstraat
650,Mercatorstraat 36,2023-02-04,23:00:00,138,45,93,FMN 02 Mercatorstraat
650,Mercatorstraat 36,2023-02-05,00:00:00,140,66,74,FMN 02 Mercatorstraat
650,Mercatorstraat 36,2023-02-05,01:00:00,127,63,64,FMN 02 Mercatorstraat
650,Mercatorstraat 36,2023-02-05,02:00:00,75,31,44,FMN 02 Mercatorstraat
650,Mercatorstraat 36,2023-02-05,03:00:00,54,21,33,FMN 02 Mercatorstraat
650,Mercatorstraat 36,2023-02-05,04:00:00,42,16,26,FMN 02 Mercatorstraat
650,Mercatorstraat 36,2023-02-05,05:00:00,42,10,32,FMN 02 Mercatorstraat
650,Mercatorstraat 36,2023-02-05,06:00:00,40,12,28,FMN 02 Mercatorstraat
650,Mercatorstraat 36,2023-02-05,07:00:00,60,19,41,FMN 02 Mercatorstraat
650,Mercatorstraat 36,2023-02-05,08:00:00,97,45,52,FMN 02 Mercatorstraat
650,Mercatorstraat 36,2023-02-05,09:00:00,228,109,119,FMN 02 Mercatorstraat
650,Mercatorstraat 36,2023-02-05,10:00:00,197,142,55,FMN 02 Mercatorstraat
650,Mercatorstraat 36,2023-02-05,11:00:00,192,110,82,FMN 02 Mercatorstraat
650,Mercatorstraat 36,2023-02-05,12:00:00,338,179,159,FMN 02 Mercatorstraat
650,Mercatorstraat 36,2023-02-05,13:00:00,379,236,143,FMN 02 Mercatorstraat
650,Mercatorstraat 36,2023-02-05,14:00:00,301,184,117,FMN 02 Mercatorstraat
650,Mercatorstraat 36,2023-02-05,15:00:00,263,105,158,FMN 02 Mercatorstraat
650,Mercatorstraat 36,2023-02-05,16:00:00,241,80,161,FMN 02 Mercatorstraat
650,Mercatorstraat 36,2023-02-05,17:00:00,266,118,148,FMN 02 Mercatorstraat
650,Mercatorstraat 36,2023-02-05,18:00:00,202,80,122,FMN 02 Mercatorstraat
650,Mercatorstraat 36,2023-02-05,19:00:00,179,87,92,FMN 02 Mercatorstraat
650,Mercatorstraat 36,2023-02-05,20:00:00,133,67,66,FMN 02 Mercatorstraat
650,Mercatorstraat 36,2023-02-05,21:00:00,121,56,65,FMN 02 Mercatorstraat
650,Mercatorstraat 36,2023-02-05,22:00:00,105,35,70,FMN 02 Mercatorstraat
650,Mercatorstraat 36,2023-02-05,23:00:00,53,17,36,FMN 02 Mercatorstraat
650,Mercatorstraat 36,2023-02-06,00:00:00,29,6,23,FMN 02 Mercatorstraat
650,Mercatorstraat 36,2023-02-06,01:00:00,22,6,16,FMN 02 Mercatorstraat
650,Mercatorstraat 36,2023-02-06,02:00:00,11,3,8,FMN 02 Mercatorstraat
650,Mercatorstraat 36,2023-02-06,03:00:00,7,3,4,FMN 02 Mercatorstraat
650,Mercatorstraat 36,2023-02-06,04:00:00,23,15,8,FMN 02 Mercatorstraat
650,Mercatorstraat 36,2023-02-06,05:00:00,31,19,12,FMN 02 Mercatorstraat
650,Mercatorstraat 36,2023-02-06,06:00:00,106,65,41,FMN 02 Mercatorstraat
650,Mercatorstraat 36,2023-02-06,07:00:00,367,230,137,FMN 02 Mercatorstraat
650,Mercatorstraat 36,2023-02-06,08:00:00,877,622,255,FMN 02 Mercatorstraat
650,Mercatorstraat 36,2023-02-06,09:00:00,358,277,81,FMN 02 Mercatorstraat
650,Mercatorstraat 36,2023-02-06,10:00:00,251,159,92,FMN 02 Mercatorstraat
650,Mercatorstraat 36,2023-02-06,11:00:00,222,124,98,FMN 02 Mercatorstraat
650,Mercatorstraat 36,2023-02-06,12:00:00,282,143,139,FMN 02 Mercatorstraat
650,Mercatorstraat 36,2023-02-06,13:00:00,318,137,181,FMN 02 Mercatorstraat
650,Mercatorstraat 36,2023-02-06,14:00:00,297,149,148,FMN 02 Mercatorstraat
650,Mercatorstraat 36,2023-02-06,15:00:00,440,158,282,FMN 02 Mercatorstraat
650,Mercatorstraat 36,2023-02-06,16:00:00,577,162,415,FMN 02 Mercatorstraat
650,Mercatorstraat 36,2023-02-06,17:00:00,726,226,500,FMN 02 Mercatorstraat
650,Mercatorstraat 36,2023-02-06,18:00:00,465,166,299,FMN 02 Mercatorstraat
650,Mercatorstraat 36,2023-02-06,19:00:00,221,97,124,FMN 02 Mercatorstraat
650,Mercatorstraat 36,2023-02-06,20:00:00,179,85,94,FMN 02 Mercatorstraat
650,Mercatorstraat 36,2023-02-06,21:00:00,175,69,106,FMN 02 Mercatorstraat
650,Mercatorstraat 36,2023-02-06,22:00:00,151,46,105,FMN 02 Mercatorstraat
650,Mercatorstraat 36,2023-02-06,23:00:00,74,29,45,FMN 02 Mercatorstraat
650,Mercatorstraat 36,2023-02-07,00:00:00,37,15,22,FMN 02 Mercatorstraat
650,Mercatorstraat 36,2023-02-07,01:00:00,12,7,5,FMN 02 Mercatorstraat
650,Mercatorstraat 36,2023-02-07,02:00:00,13,5,8,FMN 02 Mercatorstraat
650,Mercatorstraat 36,2023-02-07,03:00:00,11,2,9,FMN 02 Mercatorstraat
650,Mercatorstraat 36,2023-02-07,04:00:00,20,13,7,FMN 02 Mercatorstraat
650,Mercatorstraat 36,2023-02-07,05:00:00,38,29,9,FMN 02 Mercatorstraat
650,Mercatorstraat 36,2023-02-07,06:00:00,102,64,38,FMN 02 Mercatorstraat
650,Mercatorstraat 36,2023-02-07,07:00:00,374,247,127,FMN 02 Mercatorstraat
650,Mercatorstraat 36,2023-02-07,08:00:00,994,694,300,FMN 02 Mercatorstraat
650,Mercatorstraat 36,2023-02-07,09:00:00,425,305,120,FMN 02 Mercatorstraat
650,Mercatorstraat 36,2023-02-07,10:00:00,231,144,87,FMN 02 Mercatorstraat
650,Mercatorstraat 36,2023-02-07,11:00:00,224,125,99,FMN 02 Mercatorstraat
650,Mercatorstraat 36,2023-02-07,12:00:00,320,165,155,FMN 02 Mercatorstraat
650,Mercatorstraat 36,2023-02-07,13:00:00,296,126,170,FMN 02 Mercatorstraat
650,Mercatorstraat 36,2023-02-07,14:00:00,298,141,157,FMN 02 Mercatorstraat
650,Mercatorstraat 36,2023-02-07,15:00:00,404,110,294,FMN 02 Mercatorstraat
650,Mercatorstraat 36,2023-02-07,16:00:00,643,212,431,FMN 02 Mercatorstraat
650,Mercatorstraat 36,2023-02-07,17:00:00,755,250,505,FMN 02 Mercatorstraat
650,Mercatorstraat 36,2023-02-07,18:00:00,534,210,324,FMN 02 Mercatorstraat
650,Mercatorstraat 36,2023-02-07,19:00:00,308,151,157,FMN 02 Mercatorstraat
650,Mercatorstraat 36,2023-02-07,20:00:00,198,89,109,FMN 02 Mercatorstraat
650,Mercatorstraat 36,2023-02-07,21:00:00,199,77,122,FMN 02 Mercatorstraat
650,Mercatorstraat 36,2023-02-07,22:00:00,197,56,141,FMN 02 Mercatorstraat
650,Mercatorstraat 36,2023-02-07,23:00:00,102,27,75,FMN 02 Mercatorstraat
650,Mercatorstraat 36,2023-02-08,00:00:00,44,16,28,FMN 02 Mercatorstraat
650,Mercatorstraat 36,2023-02-08,01:00:00,21,4,17,FMN 02 Mercatorstraat
650,Mercatorstraat 36,2023-02-08,02:00:00,14,2,12,FMN 02 Mercatorstraat
650,Mercatorstraat 36,2023-02-08,03:00:00,13,5,8,FMN 02 Mercatorstraat
650,Mercatorstraat 36,2023-02-08,04:00:00,28,15,13,FMN 02 Mercatorstraat
650,Mercatorstraat 36,2023-02-08,05:00:00,46,28,18,FMN 02 Mercatorstraat
650,Mercatorstraat 36,2023-02-08,06:00:00,117,63,54,FMN 02 Mercatorstraat
650,Mercatorstraat 36,2023-02-08,07:00:00,381,241,140,FMN 02 Mercatorstraat
650,Mercatorstraat 36,2023-02-08,08:00:00,809,543,266,FMN 02 Mercatorstraat
650,Mercatorstraat 36,2023-02-08,09:00:00,357,247,110,FMN 02 Mercatorstraat
650,Mercatorstraat 36,2023-02-08,10:00:00,218,135,83,FMN 02 Mercatorstraat
650,Mercatorstraat 36,2023-02-08,11:00:00,211,117,94,FMN 02 Mercatorstraat
650,Mercatorstraat 36,2023-02-08,12:00:00,450,187,263,FMN 02 Mercatorstraat
650,Mercatorstraat 36,2023-02-08,13:00:00,433,190,243,FMN 02 Mercatorstraat
650,Mercatorstraat 36,2023-02-08,14:00:00,316,178,138,FMN 02 Mercatorstraat
650,Mercatorstraat 36,2023-02-08,15:00:00,357,146,211,FMN 02 Mercatorstraat
650,Mercatorstraat 36,2023-02-08,16:00:00,490,177,313,FMN 02 Mercatorstraat
650,Mercatorstraat 36,2023-02-08,17:00:00,649,237,412,FMN 02 Mercatorstraat
650,Mercatorstraat 36,2023-02-08,18:00:00,470,184,286,FMN 02 Mercatorstraat
650,Mercatorstraat 36,2023-02-08,19:00:00,285,149,136,FMN 02 Mercatorstraat
650,Mercatorstraat 36,2023-02-08,20:00:00,190,81,109,FMN 02 Mercatorstraat
650,Mercatorstraat 36,2023-02-08,21:00:00,183,74,109,FMN 02 Mercatorstraat
650,Mercatorstraat 36,2023-02-08,22:00:00,190,62,128,FMN 02 Mercatorstraat
650,Mercatorstraat 36,2023-02-08,23:00:00,103,32,71,FMN 02 Mercatorstraat
650,Mercatorstraat 36,2023-02-09,00:00:00,63,21,42,FMN 02 Mercatorstraat
650,Mercatorstraat 36,2023-02-09,01:00:00,33,8,25,FMN 02 Mercatorstraat
650,Mercatorstraat 36,2023-02-09,02:00:00,20,8,12,FMN 02 Mercatorstraat
650,Mercatorstraat 36,2023-02-09,03:00:00,13,6,7,FMN 02 Mercatorstraat
650,Mercatorstraat 36,2023-02-09,04:00:00,27,17,10,FMN 02 Mercatorstraat
650,Mercatorstraat 36,2023-02-09,05:00:00,41,23,18,FMN 02 Mercatorstraat
650,Mercatorstraat 36,2023-02-09,06:00:00,112,60,52,FMN 02 Mercatorstraat
650,Mercatorstraat 36,2023-02-09,07:00:00,397,248,149,FMN 02 Mercatorstraat
650,Mercatorstraat 36,2023-02-09,08:00:00,951,664,287,FMN 02 Mercatorstraat
650,Mercatorstraat 36,2023-02-09,09:00:00,384,274,110,FMN 02 Mercatorstraat
650,Mercatorstraat 36,2023-02-09,10:00:00,224,138,86,FMN 02 Mercatorstraat
650,Mercatorstraat 36,2023-02-09,11:00:00,221,140,81,FMN 02 Mercatorstraat
650,Mercatorstraat 36,2023-02-09,12:00:00,318,172,146,FMN 02 Mercatorstraat
650,Mercatorstraat 36,2023-02-09,13:00:00,332,147,185,FMN 02 Mercatorstraat
650,Mercatorstraat 36,2023-02-09,14:00:00,333,141,192,FMN 02 Mercatorstraat
650,Mercatorstraat 36,2023-02-09,15:00:00,412,138,274,FMN 02 Mercatorstraat
650,Mercatorstraat 36,2023-02-09,16:00:00,605,184,421,FMN 02 Mercatorstraat
650,Mercatorstraat 36,2023-02-09,17:00:00,717,248,469,FMN 02 Mercatorstraat
650,Mercatorstraat 36,2023-02-09,18:00:00,501,217,284,FMN 02 Mercatorstraat
650,Mercatorstraat 36,2023-02-09,19:00:00,303,143,160,FMN 02 Mercatorstraat
650,Mercatorstraat 36,2023-02-09,20:00:00,198,84,114,FMN 02 Mercatorstraat
650,Mercatorstraat 36,2023-02-09,21:00:00,191,68,123,FMN 02 Mercatorstraat
650,Mercatorstraat 36,2023-02-09,22:00:00,197,82,115,FMN 02 Mercatorstraat
650,Mercatorstraat 36,2023-02-09,23:00:00,112,36,76,FMN 02 Mercatorstraat
650,Mercatorstraat 36,2023-02-10,00:00:00,61,23,38,FMN 02 Mercatorstraat
650,Mercatorstraat 36,2023-02-10,01:00:00,35,13,22,FMN 02 Mercatorstraat
650,Mercatorstraat 36,2023-02-10,02:00:00,18,8,10,FMN 02 Mercatorstraat
650,Mercatorstraat 36,2023-02-10,03:00:00,20,6,14,FMN 02 Mercatorstraat
650,Mercatorstraat 36,2023-02-10,04:00:00,30,17,13,FMN 02 Mercatorstraat
650,Mercatorstraat 36,2023-02-10,05:00:00,45,24,21,FMN 02 Mercatorstraat
650,Mercatorstraat 36,2023-02-10,06:00:00,93,49,44,FMN 02 Mercatorstraat
650,Mercatorstraat 36,2023-02-10,07:00:00,342,198,144,FMN 02 Mercatorstraat
650,Mercatorstraat 36,2023-02-10,08:00:00,774,539,235,FMN 02 Mercatorstraat
650,Mercatorstraat 36,2023-02-10,09:00:00,338,259,79,FMN 02 Mercatorstraat
650,Mercatorstraat 36,2023-02-10,10:00:00,207,139,68,FMN 02 Mercatorstraat
650,Mercatorstraat 36,2023-02-10,11:00:00,192,108,84,FMN 02 Mercatorstraat
650,Mercatorstraat 36,2023-02-10,12:00:00,370,186,184,FMN 02 Mercatorstraat
650,Mercatorstraat 36,2023-02-10,13:00:00,302,144,158,FMN 02 Mercatorstraat
650,Mercatorstraat 36,2023-02-10,14:00:00,323,126,197,FMN 02 Mercatorstraat
650,Mercatorstraat 36,2023-02-10,15:00:00,424,136,288,FMN 02 Mercatorstraat
650,Mercatorstraat 36,2023-02-10,16:00:00,549,185,364,FMN 02 Mercatorstraat
650,Mercatorstraat 36,2023-02-10,17:00:00,542,173,369,FMN 02 Mercatorstraat
650,Mercatorstraat 36,2023-02-10,18:00:00,436,195,241,FMN 02 Mercatorstraat
650,Mercatorstraat 36,2023-02-10,19:00:00,324,171,153,FMN 02 Mercatorstraat
650,Mercatorstraat 36,2023-02-10,20:00:00,206,114,92,FMN 02 Mercatorstraat
650,Mercatorstraat 36,2023-02-10,21:00:00,182,87,95,FMN 02 Mercatorstraat
650,Mercatorstraat 36,2023-02-10,22:00:00,184,51,133,FMN 02 Mercatorstraat
650,Mercatorstraat 36,2023-02-10,23:00:00,146,58,88,FMN 02 Mercatorstraat
650,Mercatorstraat 36,2023-02-11,00:00:00,127,46,81,FMN 02 Mercatorstraat
650,Mercatorstraat 36,2023-02-11,01:00:00,101,37,64,FMN 02 Mercatorstraat
650,Mercatorstraat 36,2023-02-11,02:00:00,74,26,48,FMN 02 Mercatorstraat
650,Mercatorstraat 36,2023-02-11,03:00:00,61,15,46,FMN 02 Mercatorstraat
650,Mercatorstraat 36,2023-02-11,04:00:00,35,10,25,FMN 02 Mercatorstraat
650,Mercatorstraat 36,2023-02-11,05:00:00,53,13,40,FMN 02 Mercatorstraat
650,Mercatorstraat 36,2023-02-11,06:00:00,26,15,11,FMN 02 Mercatorstraat
650,Mercatorstraat 36,2023-02-11,07:00:00,40,23,17,FMN 02 Mercatorstraat
650,Mercatorstraat 36,2023-02-11,08:00:00,78,49,29,FMN 02 Mercatorstraat
650,Mercatorstraat 36,2023-02-11,09:00:00,174,143,31,FMN 02 Mercatorstraat
650,Mercatorstraat 36,2023-02-11,10:00:00,187,136,51,FMN 02 Mercatorstraat
650,Mercatorstraat 36,2023-02-11,11:00:00,265,170,95,FMN 02 Mercatorstraat
650,Mercatorstraat 36,2023-02-11,12:00:00,292,165,127,FMN 02 Mercatorstraat
650,Mercatorstraat 36,2023-02-11,13:00:00,342,189,153,FMN 02 Mercatorstraat
650,Mercatorstraat 36,2023-02-11,14:00:00,262,158,104,FMN 02 Mercatorstraat
650,Mercatorstraat 36,2023-02-11,15:00:00,297,147,150,FMN 02 Mercatorstraat
650,Mercatorstraat 36,2023-02-11,16:00:00,297,102,195,FMN 02 Mercatorstraat
650,Mercatorstraat 36,2023-02-11,17:00:00,308,123,185,FMN 02 Mercatorstraat
650,Mercatorstraat 36,2023-02-11,18:00:00,262,127,135,FMN 02 Mercatorstraat
650,Mercatorstraat 36,2023-02-11,19:00:00,242,139,103,FMN 02 Mercatorstraat
650,Mercatorstraat 36,2023-02-11,20:00:00,168,85,83,FMN 02 Mercatorstraat
650,Mercatorstraat 36,2023-02-11,21:00:00,147,73,74,FMN 02 Mercatorstraat
650,Mercatorstraat 36,2023-02-11,22:00:00,169,53,116,FMN 02 Mercatorstraat
650,Mercatorstraat 36,2023-02-11,23:00:00,175,78,97,FMN 02 Mercatorstraat
650,Mercatorstraat 36,2023-02-12,00:00:00,121,46,75,FMN 02 Mercatorstraat
650,Mercatorstraat 36,2023-02-12,01:00:00,112,55,57,FMN 02 Mercatorstraat
650,Mercatorstraat 36,2023-02-12,02:00:00,72,28,44,FMN 02 Mercatorstraat
650,Mercatorstraat 36,2023-02-12,03:00:00,39,12,27,FMN 02 Mercatorstraat
650,Mercatorstraat 36,2023-02-12,04:00:00,38,6,32,FMN 02 Mercatorstraat
650,Mercatorstraat 36,2023-02-12,05:00:00,36,11,25,FMN 02 Mercatorstraat
650,Mercatorstraat 36,2023-02-12,06:00:00,29,15,14,FMN 02 Mercatorstraat
650,Mercatorstraat 36,2023-02-12,07:00:00,64,20,44,FMN 02 Mercatorstraat
650,Mercatorstraat 36,2023-02-12,08:00:00,103,51,52,FMN 02 Mercatorstraat
650,Mercatorstraat 36,2023-02-12,09:00:00,220,112,108,FMN 02 Mercatorstraat
650,Mercatorstraat 36,2023-02-12,10:00:00,203,141,62,FMN 02 Mercatorstraat
650,Mercatorstraat 36,2023-02-12,11:00:00,219,109,110,FMN 02 Mercatorstraat
650,Mercatorstraat 36,2023-02-12,12:00:00,264,147,117,FMN 02 Mercatorstraat
650,Mercatorstraat 36,2023-02-12,13:00:00,282,153,129,FMN 02 Mercatorstraat
650,Mercatorstraat 36,2023-02-12,14:00:00,279,158,121,FMN 02 Mercatorstraat
650,Mercatorstraat 36,2023-02-12,15:00:00,232,107,125,FMN 02 Mercatorstraat
650,Mercatorstraat 36,2023-02-12,16:00:00,223,94,129,FMN 02 Mercatorstraat
650,Mercatorstraat 36,2023-02-12,17:00:00,212,94,118,FMN 02 Mercatorstraat
650,Mercatorstraat 36,2023-02-12,18:00:00,226,95,131,FMN 02 Mercatorstraat
650,Mercatorstraat 36,2023-02-12,19:00:00,208,107,101,FMN 02 Mercatorstraat
650,Mercatorstraat 36,2023-02-12,20:00:00,123,58,65,FMN 02 Mercatorstraat
650,Mercatorstraat 36,2023-02-12,21:00:00,130,54,76,FMN 02 Mercatorstraat
650,Mercatorstraat 36,2023-02-12,22:00:00,135,41,94,FMN 02 Mercatorstraat
650,Mercatorstraat 36,2023-02-12,23:00:00,65,20,45,FMN 02 Mercatorstraat
650,Mercatorstraat 36,2023-02-13,00:00:00,38,12,26,FMN 02 Mercatorstraat
650,Mercatorstraat 36,2023-02-13,01:00:00,14,3,11,FMN 02 Mercatorstraat
650,Mercatorstraat 36,2023-02-13,02:00:00,12,6,6,FMN 02 Mercatorstraat
650,Mercatorstraat 36,2023-02-13,03:00:00,6,2,4,FMN 02 Mercatorstraat
650,Mercatorstraat 36,2023-02-13,04:00:00,26,19,7,FMN 02 Mercatorstraat
650,Mercatorstraat 36,2023-02-13,05:00:00,40,23,17,FMN 02 Mercatorstraat
650,Mercatorstraat 36,2023-02-13,06:00:00,110,67,43,FMN 02 Mercatorstraat
650,Mercatorstraat 36,2023-02-13,07:00:00,406,260,146,FMN 02 Mercatorstraat
650,Mercatorstraat 36,2023-02-13,08:00:00,973,706,267,FMN 02 Mercatorstraat
650,Mercatorstraat 36,2023-02-13,09:00:00,422,305,117,FMN 02 Mercatorstraat
650,Mercatorstraat 36,2023-02-13,10:00:00,233,157,76,FMN 02 Mercatorstraat
650,Mercatorstraat 36,2023-02-13,11:00:00,221,136,85,FMN 02 Mercatorstraat
650,Mercatorstraat 36,2023-02-13,12:00:00,379,183,196,FMN 02 Mercatorstraat
650,Mercatorstraat 36,2023-02-13,13:00:00,378,174,204,FMN 02 Mercatorstraat
650,Mercatorstraat 36,2023-02-13,14:00:00,313,151,162,FMN 02 Mercatorstraat
650,Mercatorstraat 36,2023-02-13,15:00:00,486,163,323,FMN 02 Mercatorstraat
650,Mercatorstraat 36,2023-02-13,16:00:00,673,215,458,FMN 02 Mercatorstraat
650,Mercatorstraat 36,2023-02-13,17:00:00,764,239,525,FMN 02 Mercatorstraat
650,Mercatorstraat 36,2023-02-13,18:00:00,529,196,333,FMN 02 Mercatorstraat
650,Mercatorstraat 36,2023-02-13,19:00:00,263,121,142,FMN 02 Mercatorstraat
650,Mercatorstraat 36,2023-02-13,20:00:00,187,76,111,FMN 02 Mercatorstraat
650,Mercatorstraat 36,2023-02-13,21:00:00,192,65,127,FMN 02 Mercatorstraat
650,Mercatorstraat 36,2023-02-13,22:00:00,148,54,94,FMN 02 Mercatorstraat
650,Mercatorstraat 36,2023-02-13,23:00:00,84,26,58,FMN 02 Mercatorstraat
650,Mercatorstraat 36,2023-02-14,00:00:00,43,16,27,FMN 02 Mercatorstraat
650,Mercatorstraat 36,2023-02-14,01:00:00,19,7,12,FMN 02 Mercatorstraat
650,Mercatorstraat 36,2023-02-14,02:00:00,14,2,12,FMN 02 Mercatorstraat
650,Mercatorstraat 36,2023-02-14,03:00:00,15,7,8,FMN 02 Mercatorstraat
650,Mercatorstraat 36,2023-02-14,04:00:00,25,15,10,FMN 02 Mercatorstraat
650,Mercatorstraat 36,2023-02-14,05:00:00,39,24,15,FMN 02 Mercatorstraat
650,Mercatorstraat 36,2023-02-14,06:00:00,127,76,51,FMN 02 Mercatorstraat
650,Mercatorstraat 36,2023-02-14,07:00:00,438,282,156,FMN 02 Mercatorstraat
650,Mercatorstraat 36,2023-02-14,08:00:00,1157,816,341,FMN 02 Mercatorstraat
650,Mercatorstraat 36,2023-02-14,09:00:00,512,399,113,FMN 02 Mercatorstraat
650,Mercatorstraat 36,2023-02-14,10:00:00,304,215,89,FMN 02 Mercatorstraat
650,Mercatorstraat 36,2023-02-14,11:00:00,262,157,105,FMN 02 Mercatorstraat
650,Mercatorstraat 36,2023-02-14,12:00:00,417,214,203,FMN 02 Mercatorstraat
650,Mercatorstraat 36,2023-02-14,13:00:00,413,207,206,FMN 02 Mercatorstraat
650,Mercatorstraat 36,2023-02-14,14:00:00,373,159,214,FMN 02 Mercatorstraat
650,Mercatorstraat 36,2023-02-14,15:00:00,588,185,403,FMN 02 Mercatorstraat
650,Mercatorstraat 36,2023-02-14,16:00:00,763,246,517,FMN 02 Mercatorstraat
650,Mercatorstraat 36,2023-02-14,17:00:00,964,332,632,FMN 02 Mercatorstraat
650,Mercatorstraat 36,2023-02-14,18:00:00,669,273,396,FMN 02 Mercatorstraat
650,Mercatorstraat 36,2023-02-14,19:00:00,347,141,206,FMN 02 Mercatorstraat
650,Mercatorstraat 36,2023-02-14,20:00:00,240,101,139,FMN 02 Mercatorstraat
650,Mercatorstraat 36,2023-02-14,21:00:00,264,95,169,FMN 02 Mercatorstraat
650,Mercatorstraat 36,2023-02-14,22:00:00,192,57,135,FMN 02 Mercatorstraat
650,Mercatorstraat 36,2023-02-14,23:00:00,133,48,85,FMN 02 Mercatorstraat
650,Mercatorstraat 36,2023-02-15,00:00:00,67,28,39,FMN 02 Mercatorstraat
650,Mercatorstraat 36,2023-02-15,01:00:00,30,14,16,FMN 02 Mercatorstraat
650,Mercatorstraat 36,2023-02-15,02:00:00,27,6,21,FMN 02 Mercatorstraat
650,Mercatorstraat 36,2023-02-15,03:00:00,20,6,14,FMN 02 Mercatorstraat
650,Mercatorstraat 36,2023-02-15,04:00:00,26,15,11,FMN 02 Mercatorstraat
650,Mercatorstraat 36,2023-02-15,05:00:00,45,28,17,FMN 02 Mercatorstraat
650,Mercatorstraat 36,2023-02-15,06:00:00,118,74,44,FMN 02 Mercatorstraat
650,Mercatorstraat 36,2023-02-15,07:00:00,405,250,155,FMN 02 Mercatorstraat
650,Mercatorstraat 36,2023-02-15,08:00:00,899,640,259,FMN 02 Mercatorstraat
650,Mercatorstraat 36,2023-02-15,09:00:00,465,302,163,FMN 02 Mercatorstraat
650,Mercatorstraat 36,2023-02-15,10:00:00,223,151,72,FMN 02 Mercatorstraat
650,Mercatorstraat 36,2023-02-15,11:00:00,252,123,129,FMN 02 Mercatorstraat
650,Mercatorstraat 36,2023-02-15,12:00:00,518,205,313,FMN 02 Mercatorstraat
650,Mercatorstraat 36,2023-02-15,13:00:00,450,211,239,FMN 02 Mercatorstraat
650,Mercatorstraat 36,2023-02-15,14:00:00,345,177,168,FMN 02 Mercatorstraat
650,Mercatorstraat 36,2023-02-15,15:00:00,408,159,249,FMN 02 Mercatorstraat
650,Mercatorstraat 36,2023-02-15,16:00:00,546,187,359,FMN 02 Mercatorstraat
650,Mercatorstraat 36,2023-02-15,17:00:00,670,229,441,FMN 02 Mercatorstraat
650,Mercatorstraat 36,2023-02-15,18:00:00,550,216,334,FMN 02 Mercatorstraat
650,Mercatorstraat 36,2023-02-15,19:00:00,312,159,153,FMN 02 Mercatorstraat
650,Mercatorstraat 36,2023-02-15,20:00:00,239,112,127,FMN 02 Mercatorstraat
650,Mercatorstraat 36,2023-02-15,21:00:00,215,90,125,FMN 02 Mercatorstraat
650,Mercatorstraat 36,2023-02-15,22:00:00,193,67,126,FMN 02 Mercatorstraat
650,Mercatorstraat 36,2023-02-15,23:00:00,132,37,95,FMN 02 Mercatorstraat
650,Mercatorstraat 36,2023-02-16,00:00:00,70,24,46,FMN 02 Mercatorstraat
650,Mercatorstraat 36,2023-02-16,01:00:00,29,11,18,FMN 02 Mercatorstraat
650,Mercatorstraat 36,2023-02-16,02:00:00,14,3,11,FMN 02 Mercatorstraat
650,Mercatorstraat 36,2023-02-16,03:00:00,20,7,13,FMN 02 Mercatorstraat
650,Mercatorstraat 36,2023-02-16,04:00:00,35,14,21,FMN 02 Mercatorstraat
650,Mercatorstraat 36,2023-02-16,05:00:00,34,16,18,FMN 02 Mercatorstraat
650,Mercatorstraat 36,2023-02-16,06:00:00,130,75,55,FMN 02 Mercatorstraat
650,Mercatorstraat 36,2023-02-16,07:00:00,393,252,141,FMN 02 Mercatorstraat
650,Mercatorstraat 36,2023-02-16,08:00:00,1010,712,298,FMN 02 Mercatorstraat
650,Mercatorstraat 36,2023-02-16,09:00:00,427,318,109,FMN 02 Mercatorstraat
650,Mercatorstraat 36,2023-02-16,10:00:00,236,151,85,FMN 02 Mercatorstraat
650,Mercatorstraat 36,2023-02-16,11:00:00,186,100,86,FMN 02 Mercatorstraat
650,Mercatorstraat 36,2023-02-16,12:00:00,333,171,162,FMN 02 Mercatorstraat
650,Mercatorstraat 36,2023-02-16,13:00:00,340,161,179,FMN 02 Mercatorstraat
650,Mercatorstraat 36,2023-02-16,14:00:00,293,136,157,FMN 02 Mercatorstraat
650,Mercatorstraat 36,2023-02-16,15:00:00,402,142,260,FMN 02 Mercatorstraat
650,Mercatorstraat 36,2023-02-16,16:00:00,729,238,491,FMN 02 Mercatorstraat
650,Mercatorstraat 36,2023-02-16,17:00:00,702,229,473,FMN 02 Mercatorstraat
650,Mercatorstraat 36,2023-02-16,18:00:00,545,219,326,FMN 02 Mercatorstraat
650,Mercatorstraat 36,2023-02-16,19:00:00,369,205,164,FMN 02 Mercatorstraat
650,Mercatorstraat 36,2023-02-16,20:00:00,193,79,114,FMN 02 Mercatorstraat
650,Mercatorstraat 36,2023-02-16,21:00:00,195,71,124,FMN 02 Mercatorstraat
650,Mercatorstraat 36,2023-02-16,22:00:00,230,70,160,FMN 02 Mercatorstraat
650,Mercatorstraat 36,2023-02-16,23:00:00,152,63,89,FMN 02 Mercatorstraat
650,Mercatorstraat 36,2023-02-17,00:00:00,69,15,54,FMN 02 Mercatorstraat
650,Mercatorstraat 36,2023-02-17,01:00:00,44,18,26,FMN 02 Mercatorstraat
650,Mercatorstraat 36,2023-02-17,02:00:00,28,6,22,FMN 02 Mercatorstraat
650,Mercatorstraat 36,2023-02-17,03:00:00,22,4,18,FMN 02 Mercatorstraat
650,Mercatorstraat 36,2023-02-17,04:00:00,33,15,18,FMN 02 Mercatorstraat
650,Mercatorstraat 36,2023-02-17,05:00:00,49,25,24,FMN 02 Mercatorstraat
650,Mercatorstraat 36,2023-02-17,06:00:00,104,55,49,FMN 02 Mercatorstraat
650,Mercatorstraat 36,2023-02-17,07:00:00,327,217,110,FMN 02 Mercatorstraat
650,Mercatorstraat 36,2023-02-17,08:00:00,854,595,259,FMN 02 Mercatorstraat
650,Mercatorstraat 36,2023-02-17,09:00:00,370,281,89,FMN 02 Mercatorstraat
650,Mercatorstraat 36,2023-02-17,10:00:00,266,189,77,FMN 02 Mercatorstraat
650,Mercatorstraat 36,2023-02-17,11:00:00,256,162,94,FMN 02 Mercatorstraat
650,Mercatorstraat 36,2023-02-17,12:00:00,419,199,220,FMN 02 Mercatorstraat
650,Mercatorstraat 36,2023-02-17,13:00:00,334,174,160,FMN 02 Mercatorstraat
650,Mercatorstraat 36,2023-02-17,14:00:00,343,156,187,FMN 02 Mercatorstraat
650,Mercatorstraat 36,2023-02-17,15:00:00,515,173,342,FMN 02 Mercatorstraat
650,Mercatorstraat 36,2023-02-17,16:00:00,552,186,366,FMN 02 Mercatorstraat
650,Mercatorstraat 36,2023-02-17,17:00:00,573,202,371,FMN 02 Mercatorstraat
650,Mercatorstraat 36,2023-02-17,18:00:00,486,200,286,FMN 02 Mercatorstraat
650,Mercatorstraat 36,2023-02-17,19:00:00,353,203,150,FMN 02 Mercatorstraat
650,Mercatorstraat 36,2023-02-17,20:00:00,224,126,98,FMN 02 Mercatorstraat
650,Mercatorstraat 36,2023-02-17,21:00:00,226,131,95,FMN 02 Mercatorstraat
650,Mercatorstraat 36,2023-02-17,22:00:00,229,81,148,FMN 02 Mercatorstraat
650,Mercatorstraat 36,2023-02-17,23:00:00,207,66,141,FMN 02 Mercatorstraat
650,Mercatorstraat 36,2023-02-18,00:00:00,204,73,131,FMN 02 Mercatorstraat
650,Mercatorstraat 36,2023-02-18,01:00:00,139,49,90,FMN 02 Mercatorstraat
650,Mercatorstraat 36,2023-02-18,02:00:00,110,31,79,FMN 02 Mercatorstraat
650,Mercatorstraat 36,2023-02-18,03:00:00,77,19,58,FMN 02 Mercatorstraat
650,Mercatorstraat 36,2023-02-18,04:00:00,50,13,37,FMN 02 Mercatorstraat
650,Mercatorstraat 36,2023-02-18,05:00:00,42,19,23,FMN 02 Mercatorstraat
650,Mercatorstraat 36,2023-02-18,06:00:00,45,18,27,FMN 02 Mercatorstraat
650,Mercatorstraat 36,2023-02-18,07:00:00,38,19,19,FMN 02 Mercatorstraat
650,Mercatorstraat 36,2023-02-18,08:00:00,74,39,35,FMN 02 Mercatorstraat
650,Mercatorstraat 36,2023-02-18,09:00:00,210,164,46,FMN 02 Mercatorstraat
650,Mercatorstraat 36,2023-02-18,10:00:00,190,137,53,FMN 02 Mercatorstraat
650,Mercatorstraat 36,2023-02-18,11:00:00,218,130,88,FMN 02 Mercatorstraat
650,Mercatorstraat 36,2023-02-18,12:00:00,255,147,108,FMN 02 Mercatorstraat
650,Mercatorstraat 36,2023-02-18,13:00:00,266,146,120,FMN 02 Mercatorstraat
650,Mercatorstraat 36,2023-02-18,14:00:00,280,172,108,FMN 02 Mercatorstraat
650,Mercatorstraat 36,2023-02-18,15:00:00,316,155,161,FMN 02 Mercatorstraat
650,Mercatorstraat 36,2023-02-18,16:00:00,250,104,146,FMN 02 Mercatorstraat
650,Mercatorstraat 36,2023-02-18,17:00:00,301,117,184,FMN 02 Mercatorstraat
650,Mercatorstraat 36,2023-02-18,18:00:00,306,140,166,FMN 02 Mercatorstraat
650,Mercatorstraat 36,2023-02-18,19:00:00,265,158,107,FMN 02 Mercatorstraat
650,Mercatorstraat 36,2023-02-18,20:00:00,177,99,78,FMN 02 Mercatorstraat
650,Mercatorstraat 36,2023-02-18,21:00:00,215,126,89,FMN 02 Mercatorstraat
650,Mercatorstraat 36,2023-02-18,22:00:00,195,83,112,FMN 02 Mercatorstraat
650,Mercatorstraat 36,2023-02-18,23:00:00,155,62,93,FMN 02 Mercatorstraat
650,Mercatorstraat 36,2023-02-19,00:00:00,168,68,100,FMN 02 Mercatorstraat
650,Mercatorstraat 36,2023-02-19,01:00:00,144,44,100,FMN 02 Mercatorstraat
650,Mercatorstraat 36,2023-02-19,02:00:00,71,19,52,FMN 02 Mercatorstraat
650,Mercatorstraat 36,2023-02-19,03:00:00,81,19,62,FMN 02 Mercatorstraat
650,Mercatorstraat 36,2023-02-19,04:00:00,70,18,52,FMN 02 Mercatorstraat
650,Mercatorstraat 36,2023-02-19,05:00:00,54,15,39,FMN 02 Mercatorstraat
650,Mercatorstraat 36,2023-02-19,06:00:00,46,23,23,FMN 02 Mercatorstraat
650,Mercatorstraat 36,2023-02-19,07:00:00,54,14,40,FMN 02 Mercatorstraat
650,Mercatorstraat 36,2023-02-19,08:00:00,105,41,64,FMN 02 Mercatorstraat
650,Mercatorstraat 36,2023-02-19,09:00:00,206,98,108,FMN 02 Mercatorstraat
650,Mercatorstraat 36,2023-02-19,10:00:00,177,124,53,FMN 02 Mercatorstraat
650,Mercatorstraat 36,2023-02-19,11:00:00,194,103,91,FMN 02 Mercatorstraat
650,Mercatorstraat 36,2023-02-19,12:00:00,247,153,94,FMN 02 Mercatorstraat
650,Mercatorstraat 36,2023-02-19,13:00:00,282,158,124,FMN 02 Mercatorstraat
650,Mercatorstraat 36,2023-02-19,14:00:00,320,201,119,FMN 02 Mercatorstraat
650,Mercatorstraat 36,2023-02-19,15:00:00,250,115,135,FMN 02 Mercatorstraat
650,Mercatorstraat 36,2023-02-19,16:00:00,266,113,153,FMN 02 Mercatorstraat
650,Mercatorstraat 36,2023-02-19,17:00:00,232,81,151,FMN 02 Mercatorstraat
650,Mercatorstraat 36,2023-02-19,18:00:00,232,81,151,FMN 02 Mercatorstraat
650,Mercatorstraat 36,2023-02-19,19:00:00,184,80,104,FMN 02 Mercatorstraat
650,Mercatorstraat 36,2023-02-19,20:00:00,144,66,78,FMN 02 Mercatorstraat
650,Mercatorstraat 36,2023-02-19,21:00:00,121,56,65,FMN 02 Mercatorstraat
650,Mercatorstraat 36,2023-02-19,22:00:00,103,39,64,FMN 02 Mercatorstraat
650,Mercatorstraat 36,2023-02-19,23:00:00,72,24,48,FMN 02 Mercatorstraat
650,Mercatorstraat 36,2023-02-20,00:00:00,33,8,25,FMN 02 Mercatorstraat
650,Mercatorstraat 36,2023-02-20,01:00:00,20,10,10,FMN 02 Mercatorstraat
650,Mercatorstraat 36,2023-02-20,02:00:00,15,7,8,FMN 02 Mercatorstraat
650,Mercatorstraat 36,2023-02-20,03:00:00,11,6,5,FMN 02 Mercatorstraat
650,Mercatorstraat 36,2023-02-20,04:00:00,29,14,15,FMN 02 Mercatorstraat
650,Mercatorstraat 36,2023-02-20,05:00:00,37,23,14,FMN 02 Mercatorstraat
650,Mercatorstraat 36,2023-02-20,06:00:00,94,66,28,FMN 02 Mercatorstraat
650,Mercatorstraat 36,2023-02-20,07:00:00,266,159,107,FMN 02 Mercatorstraat
650,Mercatorstraat 36,2023-02-20,08:00:00,630,442,188,FMN 02 Mercatorstraat
650,Mercatorstraat 36,2023-02-20,09:00:00,403,284,119,FMN 02 Mercatorstraat
650,Mercatorstraat 36,2023-02-20,10:00:00,239,166,73,FMN 02 Mercatorstraat
650,Mercatorstraat 36,2023-02-20,11:00:00,189,113,76,FMN 02 Mercatorstraat
650,Mercatorstraat 36,2023-02-20,12:00:00,298,171,127,FMN 02 Mercatorstraat
650,Mercatorstraat 36,2023-02-20,13:00:00,308,171,137,FMN 02 Mercatorstraat
650,Mercatorstraat 36,2023-02-20,14:00:00,270,148,122,FMN 02 Mercatorstraat
650,Mercatorstraat 36,2023-02-20,15:00:00,307,111,196,FMN 02 Mercatorstraat
650,Mercatorstraat 36,2023-02-20,16:00:00,515,186,329,FMN 02 Mercatorstraat
650,Mercatorstraat 36,2023-02-20,17:00:00,644,207,437,FMN 02 Mercatorstraat
650,Mercatorstraat 36,2023-02-20,18:00:00,463,177,286,FMN 02 Mercatorstraat
650,Mercatorstraat 36,2023-02-20,19:00:00,278,103,175,FMN 02 Mercatorstraat
650,Mercatorstraat 36,2023-02-20,20:00:00,175,95,80,FMN 02 Mercatorstraat
650,Mercatorstraat 36,2023-02-20,21:00:00,153,71,82,FMN 02 Mercatorstraat
650,Mercatorstraat 36,2023-02-20,22:00:00,129,48,81,FMN 02 Mercatorstraat
650,Mercatorstraat 36,2023-02-20,23:00:00,89,40,49,FMN 02 Mercatorstraat
650,Mercatorstraat 36,2023-02-21,00:00:00,39,15,24,FMN 02 Mercatorstraat
650,Mercatorstraat 36,2023-02-21,01:00:00,16,3,13,FMN 02 Mercatorstraat
650,Mercatorstraat 36,2023-02-21,02:00:00,17,3,14,FMN 02 Mercatorstraat
650,Mercatorstraat 36,2023-02-21,03:00:00,21,5,16,FMN 02 Mercatorstraat
650,Mercatorstraat 36,2023-02-21,04:00:00,31,19,12,FMN 02 Mercatorstraat
650,Mercatorstraat 36,2023-02-21,05:00:00,43,28,15,FMN 02 Mercatorstraat
650,Mercatorstraat 36,2023-02-21,06:00:00,105,69,36,FMN 02 Mercatorstraat
650,Mercatorstraat 36,2023-02-21,07:00:00,303,183,120,FMN 02 Mercatorstraat
650,Mercatorstraat 36,2023-02-21,08:00:00,651,457,194,FMN 02 Mercatorstraat
650,Mercatorstraat 36,2023-02-21,09:00:00,427,294,133,FMN 02 Mercatorstraat
650,Mercatorstraat 36,2023-02-21,10:00:00,240,168,72,FMN 02 Mercatorstraat
650,Mercatorstraat 36,2023-02-21,11:00:00,179,88,91,FMN 02 Mercatorstraat
650,Mercatorstraat 36,2023-02-21,12:00:00,305,168,137,FMN 02 Mercatorstraat
650,Mercatorstraat 36,2023-02-21,13:00:00,276,147,129,FMN 02 Mercatorstraat
650,Mercatorstraat 36,2023-02-21,14:00:00,249,138,111,FMN 02 Mercatorstraat
650,Mercatorstraat 36,2023-02-21,15:00:00,292,120,172,FMN 02 Mercatorstraat
650,Mercatorstraat 36,2023-02-21,16:00:00,481,173,308,FMN 02 Mercatorstraat
650,Mercatorstraat 36,2023-02-21,17:00:00,650,199,451,FMN 02 Mercatorstraat
650,Mercatorstraat 36,2023-02-21,18:00:00,537,225,312,FMN 02 Mercatorstraat
650,Mercatorstraat 36,2023-02-21,19:00:00,294,142,152,FMN 02 Mercatorstraat
650,Mercatorstraat 36,2023-02-21,20:00:00,204,91,113,FMN 02 Mercatorstraat
650,Mercatorstraat 36,2023-02-21,21:00:00,174,61,113,FMN 02 Mercatorstraat
650,Mercatorstraat 36,2023-02-21,22:00:00,150,50,100,FMN 02 Mercatorstraat
650,Mercatorstraat 36,2023-02-21,23:00:00,139,43,96,FMN 02 Mercatorstraat
650,Mercatorstraat 36,2023-02-22,00:00:00,44,20,24,FMN 02 Mercatorstraat
650,Mercatorstraat 36,2023-02-22,01:00:00,37,22,15,FMN 02 Mercatorstraat
650,Mercatorstraat 36,2023-02-22,02:00:00,19,6,13,FMN 02 Mercatorstraat
650,Mercatorstraat 36,2023-02-22,03:00:00,17,8,9,FMN 02 Mercatorstraat
650,Mercatorstraat 36,2023-02-22,04:00:00,18,11,7,FMN 02 Mercatorstraat
650,Mercatorstraat 36,2023-02-22,05:00:00,37,24,13,FMN 02 Mercatorstraat
650,Mercatorstraat 36,2023-02-22,06:00:00,96,61,35,FMN 02 Mercatorstraat
650,Mercatorstraat 36,2023-02-22,07:00:00,237,161,76,FMN 02 Mercatorstraat
650,Mercatorstraat 36,2023-02-22,08:00:00,596,389,207,FMN 02 Mercatorstraat
650,Mercatorstraat 36,2023-02-22,09:00:00,367,248,119,FMN 02 Mercatorstraat
650,Mercatorstraat 36,2023-02-22,10:00:00,235,161,74,FMN 02 Mercatorstraat
650,Mercatorstraat 36,2023-02-22,11:00:00,205,117,88,FMN 02 Mercatorstraat
650,Mercatorstraat 36,2023-02-22,12:00:00,261,130,131,FMN 02 Mercatorstraat
650,Mercatorstraat 36,2023-02-22,13:00:00,292,169,123,FMN 02 Mercatorstraat
650,Mercatorstraat 36,2023-02-22,14:00:00,278,160,118,FMN 02 Mercatorstraat
650,Mercatorstraat 36,2023-02-22,15:00:00,293,130,163,FMN 02 Mercatorstraat
650,Mercatorstraat 36,2023-02-22,16:00:00,458,156,302,FMN 02 Mercatorstraat
650,Mercatorstraat 36,2023-02-22,17:00:00,567,190,377,FMN 02 Mercatorstraat
650,Mercatorstraat 36,2023-02-22,18:00:00,466,168,298,FMN 02 Mercatorstraat
650,Mercatorstraat 36,2023-02-22,19:00:00,101,31,70,FMN 02 Mercatorstraat
650,Mercatorstraat 36,2023-02-22,20:00:00,166,85,81,FMN 02 Mercatorstraat
650,Mercatorstraat 36,2023-02-22,21:00:00,153,63,90,FMN 02 Mercatorstraat
650,Mercatorstraat 36,2023-02-22,22:00:00,158,63,95,FMN 02 Mercatorstraat
650,Mercatorstraat 36,2023-02-22,23:00:00,123,45,78,FMN 02 Mercatorstraat
650,Mercatorstraat 36,2023-02-23,00:00:00,57,21,36,FMN 02 Mercatorstraat
650,Mercatorstraat 36,2023-02-23,01:00:00,47,26,21,FMN 02 Mercatorstraat
650,Mercatorstraat 36,2023-02-23,02:00:00,31,12,19,FMN 02 Mercatorstraat
650,Mercatorstraat 36,2023-02-23,03:00:00,21,9,12,FMN 02 Mercatorstraat
650,Mercatorstraat 36,2023-02-23,04:00:00,31,20,11,FMN 02 Mercatorstraat
650,Mercatorstraat 36,2023-02-23,05:00:00,38,27,11,FMN 02 Mercatorstraat
650,Mercatorstraat 36,2023-02-23,06:00:00,83,55,28,FMN 02 Mercatorstraat
650,Mercatorstraat 36,2023-02-23,07:00:00,255,160,95,FMN 02 Mercatorstraat
650,Mercatorstraat 36,2023-02-23,08:00:00,653,438,215,FMN 02 Mercatorstraat
650,Mercatorstraat 36,2023-02-23,09:00:00,395,272,123,FMN 02 Mercatorstraat
650,Mercatorstraat 36,2023-02-23,10:00:00,246,186,60,FMN 02 Mercatorstraat
650,Mercatorstraat 36,2023-02-23,11:00:00,219,130,89,FMN 02 Mercatorstraat
650,Mercatorstraat 36,2023-02-23,12:00:00,304,163,141,FMN 02 Mercatorstraat
650,Mercatorstraat 36,2023-02-23,13:00:00,298,164,134,FMN 02 Mercatorstraat
650,Mercatorstraat 36,2023-02-23,14:00:00,298,136,162,FMN 02 Mercatorstraat
650,Mercatorstraat 36,2023-02-23,15:00:00,307,120,187,FMN 02 Mercatorstraat
650,Mercatorstraat 36,2023-02-23,16:00:00,449,176,273,FMN 02 Mercatorstraat
650,Mercatorstraat 36,2023-02-23,17:00:00,624,220,404,FMN 02 Mercatorstraat
650,Mercatorstraat 36,2023-02-23,18:00:00,465,187,278,FMN 02 Mercatorstraat
650,Mercatorstraat 36,2023-02-23,19:00:00,371,182,189,FMN 02 Mercatorstraat
650,Mercatorstraat 36,2023-02-23,20:00:00,233,95,138,FMN 02 Mercatorstraat
650,Mercatorstraat 36,2023-02-23,21:00:00,181,77,104,FMN 02 Mercatorstraat
650,Mercatorstraat 36,2023-02-23,22:00:00,184,62,122,FMN 02 Mercatorstraat
650,Mercatorstraat 36,2023-02-23,23:00:00,165,57,108,FMN 02 Mercatorstraat
650,Mercatorstraat 36,2023-02-24,00:00:00,89,37,52,FMN 02 Mercatorstraat
650,Mercatorstraat 36,2023-02-24,01:00:00,61,20,41,FMN 02 Mercatorstraat
650,Mercatorstraat 36,2023-02-24,02:00:00,26,8,18,FMN 02 Mercatorstraat
650,Mercatorstraat 36,2023-02-24,03:00:00,25,10,15,FMN 02 Mercatorstraat
650,Mercatorstraat 36,2023-02-24,04:00:00,38,12,26,FMN 02 Mercatorstraat
650,Mercatorstraat 36,2023-02-24,05:00:00,36,18,18,FMN 02 Mercatorstraat
650,Mercatorstraat 36,2023-02-24,06:00:00,82,57,25,FMN 02 Mercatorstraat
650,Mercatorstraat 36,2023-02-24,07:00:00,228,146,82,FMN 02 Mercatorstraat
650,Mercatorstraat 36,2023-02-24,08:00:00,489,342,147,FMN 02 Mercatorstraat
650,Mercatorstraat 36,2023-02-24,09:00:00,302,226,76,FMN 02 Mercatorstraat
650,Mercatorstraat 36,2023-02-24,10:00:00,228,157,71,FMN 02 Mercatorstraat
650,Mercatorstraat 36,2023-02-24,11:00:00,237,143,94,FMN 02 Mercatorstraat
650,Mercatorstraat 36,2023-02-24,12:00:00,326,174,152,FMN 02 Mercatorstraat
650,Mercatorstraat 36,2023-02-24,13:00:00,319,170,149,FMN 02 Mercatorstraat
650,Mercatorstraat 36,2023-02-24,14:00:00,239,119,120,FMN 02 Mercatorstraat
650,Mercatorstraat 36,2023-02-24,15:00:00,269,98,171,FMN 02 Mercatorstraat
650,Mercatorstraat 36,2023-02-24,16:00:00,428,129,299,FMN 02 Mercatorstraat
650,Mercatorstraat 36,2023-02-24,17:00:00,459,175,284,FMN 02 Mercatorstraat
650,Mercatorstraat 36,2023-02-24,18:00:00,423,201,222,FMN 02 Mercatorstraat
650,Mercatorstraat 36,2023-02-24,19:00:00,326,185,141,FMN 02 Mercatorstraat
650,Mercatorstraat 36,2023-02-24,20:00:00,229,108,121,FMN 02 Mercatorstraat
650,Mercatorstraat 36,2023-02-24,21:00:00,201,90,111,FMN 02 Mercatorstraat
650,Mercatorstraat 36,2023-02-24,22:00:00,181,76,105,FMN 02 Mercatorstraat
650,Mercatorstraat 36,2023-02-24,23:00:00,184,62,122,FMN 02 Mercatorstraat
650,Mercatorstraat 36,2023-02-25,00:00:00,144,58,86,FMN 02 Mercatorstraat
650,Mercatorstraat 36,2023-02-25,01:00:00,113,46,67,FMN 02 Mercatorstraat
650,Mercatorstraat 36,2023-02-25,02:00:00,78,19,59,FMN 02 Mercatorstraat
650,Mercatorstraat 36,2023-02-25,03:00:00,59,12,47,FMN 02 Mercatorstraat
650,Mercatorstraat 36,2023-02-25,04:00:00,59,16,43,FMN 02 Mercatorstraat
650,Mercatorstraat 36,2023-02-25,05:00:00,46,23,23,FMN 02 Mercatorstraat
650,Mercatorstraat 36,2023-02-25,06:00:00,36,15,21,FMN 02 Mercatorstraat
650,Mercatorstraat 36,2023-02-25,07:00:00,54,31,23,FMN 02 Mercatorstraat
650,Mercatorstraat 36,2023-02-25,08:00:00,67,46,21,FMN 02 Mercatorstraat
650,Mercatorstraat 36,2023-02-25,09:00:00,192,145,47,FMN 02 Mercatorstraat
650,Mercatorstraat 36,2023-02-25,10:00:00,204,159,45,FMN 02 Mercatorstraat
650,Mercatorstraat 36,2023-02-25,11:00:00,260,153,107,FMN 02 Mercatorstraat
650,Mercatorstraat 36,2023-02-25,12:00:00,242,115,127,FMN 02 Mercatorstraat
650,Mercatorstraat 36,2023-02-25,13:00:00,314,193,121,FMN 02 Mercatorstraat
650,Mercatorstraat 36,2023-02-25,14:00:00,310,168,142,FMN 02 Mercatorstraat
650,Mercatorstraat 36,2023-02-25,15:00:00,263,131,132,FMN 02 Mercatorstraat
650,Mercatorstraat 36,2023-02-25,16:00:00,284,113,171,FMN 02 Mercatorstraat
650,Mercatorstraat 36,2023-02-25,17:00:00,309,132,177,FMN 02 Mercatorstraat
650,Mercatorstraat 36,2023-02-25,18:00:00,273,118,155,FMN 02 Mercatorstraat
650,Mercatorstraat 36,2023-02-25,19:00:00,286,155,131,FMN 02 Mercatorstraat
650,Mercatorstraat 36,2023-02-25,20:00:00,188,95,93,FMN 02 Mercatorstraat
650,Mercatorstraat 36,2023-02-25,21:00:00,163,79,84,FMN 02 Mercatorstraat
650,Mercatorstraat 36,2023-02-25,22:00:00,143,66,77,FMN 02 Mercatorstraat
650,Mercatorstraat 36,2023-02-25,23:00:00,198,85,113,FMN 02 Mercatorstraat
650,Mercatorstraat 36,2023-02-26,00:00:00,144,60,84,FMN 02 Mercatorstraat
650,Mercatorstraat 36,2023-02-26,01:00:00,105,43,62,FMN 02 Mercatorstraat
650,Mercatorstraat 36,2023-02-26,02:00:00,84,28,56,FMN 02 Mercatorstraat
650,Mercatorstraat 36,2023-02-26,03:00:00,59,15,44,FMN 02 Mercatorstraat
650,Mercatorstraat 36,2023-02-26,04:00:00,38,12,26,FMN 02 Mercatorstraat
650,Mercatorstraat 36,2023-02-26,05:00:00,47,8,39,FMN 02 Mercatorstraat
650,Mercatorstraat 36,2023-02-26,06:00:00,48,14,34,FMN 02 Mercatorstraat
650,Mercatorstraat 36,2023-02-26,07:00:00,43,21,22,FMN 02 Mercatorstraat
650,Mercatorstraat 36,2023-02-26,08:00:00,61,31,30,FMN 02 Mercatorstraat
650,Mercatorstraat 36,2023-02-26,09:00:00,163,101,62,FMN 02 Mercatorstraat
650,Mercatorstraat 36,2023-02-26,10:00:00,176,117,59,FMN 02 Mercatorstraat
650,Mercatorstraat 36,2023-02-26,11:00:00,234,120,114,FMN 02 Mercatorstraat
650,Mercatorstraat 36,2023-02-26,12:00:00,240,123,117,FMN 02 Mercatorstraat
650,Mercatorstraat 36,2023-02-26,13:00:00,282,166,116,FMN 02 Mercatorstraat
650,Mercatorstraat 36,2023-02-26,14:00:00,296,179,117,FMN 02 Mercatorstraat
650,Mercatorstraat 36,2023-02-26,15:00:00,266,137,129,FMN 02 Mercatorstraat
650,Mercatorstraat 36,2023-02-26,16:00:00,256,100,156,FMN 02 Mercatorstraat
650,Mercatorstraat 36,2023-02-26,17:00:00,288,116,172,FMN 02 Mercatorstraat
650,Mercatorstraat 36,2023-02-26,18:00:00,196,75,121,FMN 02 Mercatorstraat
650,Mercatorstraat 36,2023-02-26,19:00:00,182,87,95,FMN 02 Mercatorstraat
650,Mercatorstraat 36,2023-02-26,20:00:00,152,69,83,FMN 02 Mercatorstraat
650,Mercatorstraat 36,2023-02-26,21:00:00,122,50,72,FMN 02 Mercatorstraat
650,Mercatorstraat 36,2023-02-26,22:00:00,83,34,49,FMN 02 Mercatorstraat
650,Mercatorstraat 36,2023-02-26,23:00:00,54,29,25,FMN 02 Mercatorstraat
650,Mercatorstraat 36,2023-02-27,00:00:00,30,13,17,FMN 02 Mercatorstraat
650,Mercatorstraat 36,2023-02-27,01:00:00,22,16,6,FMN 02 Mercatorstraat
650,Mercatorstraat 36,2023-02-27,02:00:00,11,3,8,FMN 02 Mercatorstraat
650,Mercatorstraat 36,2023-02-27,03:00:00,9,3,6,FMN 02 Mercatorstraat
650,Mercatorstraat 36,2023-02-27,04:00:00,21,16,5,FMN 02 Mercatorstraat
650,Mercatorstraat 36,2023-02-27,05:00:00,38,24,14,FMN 02 Mercatorstraat
650,Mercatorstraat 36,2023-02-27,06:00:00,105,75,30,FMN 02 Mercatorstraat
650,Mercatorstraat 36,2023-02-27,07:00:00,416,259,157,FMN 02 Mercatorstraat
650,Mercatorstraat 36,2023-02-27,08:00:00,986,706,280,FMN 02 Mercatorstraat
650,Mercatorstraat 36,2023-02-27,09:00:00,412,320,92,FMN 02 Mercatorstraat
650,Mercatorstraat 36,2023-02-27,10:00:00,215,140,75,FMN 02 Mercatorstraat
650,Mercatorstraat 36,2023-02-27,11:00:00,219,130,89,FMN 02 Mercatorstraat
650,Mercatorstraat 36,2023-02-27,12:00:00,302,148,154,FMN 02 Mercatorstraat
650,Mercatorstraat 36,2023-02-27,13:00:00,290,170,120,FMN 02 Mercatorstraat
650,Mercatorstraat 36,2023-02-27,14:00:00,301,146,155,FMN 02 Mercatorstraat
650,Mercatorstraat 36,2023-02-27,15:00:00,414,121,293,FMN 02 Mercatorstraat
650,Mercatorstraat 36,2023-02-27,16:00:00,623,185,438,FMN 02 Mercatorstraat
650,Mercatorstraat 36,2023-02-27,17:00:00,746,230,516,FMN 02 Mercatorstraat
650,Mercatorstraat 36,2023-02-27,18:00:00,534,185,349,FMN 02 Mercatorstraat
650,Mercatorstraat 36,2023-02-27,19:00:00,321,165,156,FMN 02 Mercatorstraat
650,Mercatorstraat 36,2023-02-27,20:00:00,187,86,101,FMN 02 Mercatorstraat
650,Mercatorstraat 36,2023-02-27,21:00:00,190,59,131,FMN 02 Mercatorstraat
650,Mercatorstraat 36,2023-02-27,22:00:00,167,51,116,FMN 02 Mercatorstraat
650,Mercatorstraat 36,2023-02-27,23:00:00,56,14,42,FMN 02 Mercatorstraat
650,Mercatorstraat 36,2023-02-28,00:00:00,21,10,11,FMN 02 Mercatorstraat
650,Mercatorstraat 36,2023-02-28,01:00:00,13,2,11,FMN 02 Mercatorstraat
650,Mercatorstraat 36,2023-02-28,02:00:00,4,2,2,FMN 02 Mercatorstraat
650,Mercatorstraat 36,2023-02-28,03:00:00,12,3,9,FMN 02 Mercatorstraat
650,Mercatorstraat 36,2023-02-28,04:00:00,19,13,6,FMN 02 Mercatorstraat
650,Mercatorstraat 36,2023-02-28,05:00:00,42,24,18,FMN 02 Mercatorstraat
650,Mercatorstraat 36,2023-02-28,06:00:00,116,72,44,FMN 02 Mercatorstraat
650,Mercatorstraat 36,2023-02-28,07:00:00,428,255,173,FMN 02 Mercatorstraat
650,Mercatorstraat 36,2023-02-28,08:00:00,1067,747,320,FMN 02 Mercatorstraat
650,Mercatorstraat 36,2023-02-28,09:00:00,441,330,111,FMN 02 Mercatorstraat
650,Mercatorstraat 36,2023-02-28,10:00:00,256,182,74,FMN 02 Mercatorstraat
650,Mercatorstraat 36,2023-02-28,11:00:00,218,123,95,FMN 02 Mercatorstraat
650,Mercatorstraat 36,2023-02-28,12:00:00,315,147,168,FMN 02 Mercatorstraat
650,Mercatorstraat 36,2023-02-28,13:00:00,374,167,207,FMN 02 Mercatorstraat
650,Mercatorstraat 36,2023-02-28,14:00:00,327,165,162,FMN 02 Mercatorstraat
650,Mercatorstraat 36,2023-02-28,15:00:00,456,145,311,FMN 02 Mercatorstraat
650,Mercatorstraat 36,2023-02-28,16:00:00,668,219,449,FMN 02 Mercatorstraat
650,Mercatorstraat 36,2023-02-28,17:00:00,777,254,523,FMN 02 Mercatorstraat
650,Mercatorstraat 36,2023-02-28,18:00:00,582,201,381,FMN 02 Mercatorstraat
650,Mercatorstraat 36,2023-02-28,19:00:00,337,150,187,FMN 02 Mercatorstraat
650,Mercatorstraat 36,2023-02-28,20:00:00,210,95,115,FMN 02 Mercatorstraat
650,Mercatorstraat 36,2023-02-28,21:00:00,222,73,149,FMN 02 Mercatorstraat
650,Mercatorstraat 36,2023-02-28,22:00:00,161,58,103,FMN 02 Mercatorstraat
650,Mercatorstraat 36,2023-02-28,23:00:00,114,34,80,FMN 02 Mercatorstraat
650,Mercatorstraat 36,2023-03-01,00:00:00,52,21,31,FMN 02 Mercatorstraat
650,Mercatorstraat 36,2023-03-01,01:00:00,13,2,11,FMN 02 Mercatorstraat
650,Mercatorstraat 36,2023-03-01,02:00:00,24,8,16,FMN 02 Mercatorstraat
650,Mercatorstraat 36,2023-03-01,03:00:00,13,3,10,FMN 02 Mercatorstraat
650,Mercatorstraat 36,2023-03-01,04:00:00,21,13,8,FMN 02 Mercatorstraat
650,Mercatorstraat 36,2023-03-01,05:00:00,48,26,22,FMN 02 Mercatorstraat
650,Mercatorstraat 36,2023-03-01,06:00:00,108,62,46,FMN 02 Mercatorstraat
650,Mercatorstraat 36,2023-03-01,07:00:00,407,245,162,FMN 02 Mercatorstraat
650,Mercatorstraat 36,2023-03-01,08:00:00,957,663,294,FMN 02 Mercatorstraat
650,Mercatorstraat 36,2023-03-01,09:00:00,340,264,76,FMN 02 Mercatorstraat
650,Mercatorstraat 36,2023-03-01,10:00:00,232,142,90,FMN 02 Mercatorstraat
650,Mercatorstraat 36,2023-03-01,11:00:00,233,121,112,FMN 02 Mercatorstraat
650,Mercatorstraat 36,2023-03-01,12:00:00,477,193,284,FMN 02 Mercatorstraat
650,Mercatorstraat 36,2023-03-01,13:00:00,450,203,247,FMN 02 Mercatorstraat
650,Mercatorstraat 36,2023-03-01,14:00:00,323,157,166,FMN 02 Mercatorstraat
650,Mercatorstraat 36,2023-03-01,15:00:00,370,145,225,FMN 02 Mercatorstraat
650,Mercatorstraat 36,2023-03-01,16:00:00,533,177,356,FMN 02 Mercatorstraat
650,Mercatorstraat 36,2023-03-01,17:00:00,685,228,457,FMN 02 Mercatorstraat
650,Mercatorstraat 36,2023-03-01,18:00:00,535,194,341,FMN 02 Mercatorstraat
650,Mercatorstraat 36,2023-03-01,19:00:00,323,153,170,FMN 02 Mercatorstraat
650,Mercatorstraat 36,2023-03-01,20:00:00,204,91,113,FMN 02 Mercatorstraat
650,Mercatorstraat 36,2023-03-01,21:00:00,214,100,114,FMN 02 Mercatorstraat
650,Mercatorstraat 36,2023-03-01,22:00:00,204,77,127,FMN 02 Mercatorstraat
650,Mercatorstraat 36,2023-03-01,23:00:00,101,31,70,FMN 02 Mercatorstraat
650,Mercatorstraat 36,2023-03-02,00:00:00,46,25,21,FMN 02 Mercatorstraat
650,Mercatorstraat 36,2023-03-02,01:00:00,7,3,4,FMN 02 Mercatorstraat
650,Mercatorstraat 36,2023-03-02,02:00:00,14,5,9,FMN 02 Mercatorstraat
650,Mercatorstraat 36,2023-03-02,03:00:00,11,2,9,FMN 02 Mercatorstraat
650,Mercatorstraat 36,2023-03-02,04:00:00,20,11,9,FMN 02 Mercatorstraat
650,Mercatorstraat 36,2023-03-02,05:00:00,39,23,16,FMN 02 Mercatorstraat
650,Mercatorstraat 36,2023-03-02,06:00:00,115,71,44,FMN 02 Mercatorstraat
650,Mercatorstraat 36,2023-03-02,07:00:00,400,247,153,FMN 02 Mercatorstraat
650,Mercatorstraat 36,2023-03-02,08:00:00,1086,755,331,FMN 02 Mercatorstraat
650,Mercatorstraat 36,2023-03-02,09:00:00,425,319,106,FMN 02 Mercatorstraat
650,Mercatorstraat 36,2023-03-02,10:00:00,259,172,87,FMN 02 Mercatorstraat
650,Mercatorstraat 36,2023-03-02,11:00:00,233,144,89,FMN 02 Mercatorstraat
650,Mercatorstraat 36,2023-03-02,12:00:00,348,188,160,FMN 02 Mercatorstraat
650,Mercatorstraat 36,2023-03-02,13:00:00,359,153,206,FMN 02 Mercatorstraat
650,Mercatorstraat 36,2023-03-02,14:00:00,338,161,177,FMN 02 Mercatorstraat
650,Mercatorstraat 36,2023-03-02,15:00:00,456,145,311,FMN 02 Mercatorstraat
650,Mercatorstraat 36,2023-03-02,16:00:00,746,213,533,FMN 02 Mercatorstraat
650,Mercatorstraat 36,2023-03-02,17:00:00,733,250,483,FMN 02 Mercatorstraat
650,Mercatorstraat 36,2023-03-02,18:00:00,576,232,344,FMN 02 Mercatorstraat
650,Mercatorstraat 36,2023-03-02,19:00:00,352,186,166,FMN 02 Mercatorstraat
650,Mercatorstraat 36,2023-03-02,20:00:00,238,105,133,FMN 02 Mercatorstraat
650,Mercatorstraat 36,2023-03-02,21:00:00,181,63,118,FMN 02 Mercatorstraat
650,Mercatorstraat 36,2023-03-02,22:00:00,183,68,115,FMN 02 Mercatorstraat
650,Mercatorstraat 36,2023-03-02,23:00:00,157,50,107,FMN 02 Mercatorstraat
650,Mercatorstraat 36,2023-03-03,00:00:00,79,36,43,FMN 02 Mercatorstraat
650,Mercatorstraat 36,2023-03-03,01:00:00,44,17,27,FMN 02 Mercatorstraat
650,Mercatorstraat 36,2023-03-03,02:00:00,35,12,23,FMN 02 Mercatorstraat
650,Mercatorstraat 36,2023-03-03,03:00:00,19,1,18,FMN 02 Mercatorstraat
650,Mercatorstraat 36,2023-03-03,04:00:00,25,12,13,FMN 02 Mercatorstraat
650,Mercatorstraat 36,2023-03-03,05:00:00,37,16,21,FMN 02 Mercatorstraat
650,Mercatorstraat 36,2023-03-03,06:00:00,121,67,54,FMN 02 Mercatorstraat
650,Mercatorstraat 36,2023-03-03,07:00:00,366,235,131,FMN 02 Mercatorstraat
650,Mercatorstraat 36,2023-03-03,08:00:00,869,606,263,FMN 02 Mercatorstraat
650,Mercatorstraat 36,2023-03-03,09:00:00,345,258,87,FMN 02 Mercatorstraat
650,Mercatorstraat 36,2023-03-03,10:00:00,258,172,86,FMN 02 Mercatorstraat
650,Mercatorstraat 36,2023-03-03,11:00:00,200,117,83,FMN 02 Mercatorstraat
650,Mercatorstraat 36,2023-03-03,12:00:00,391,202,189,FMN 02 Mercatorstraat
650,Mercatorstraat 36,2023-03-03,13:00:00,318,142,176,FMN 02 Mercatorstraat
650,Mercatorstraat 36,2023-03-03,14:00:00,299,133,166,FMN 02 Mercatorstraat
650,Mercatorstraat 36,2023-03-03,15:00:00,487,156,331,FMN 02 Mercatorstraat
650,Mercatorstraat 36,2023-03-03,16:00:00,588,195,393,FMN 02 Mercatorstraat
650,Mercatorstraat 36,2023-03-03,17:00:00,608,229,379,FMN 02 Mercatorstraat
650,Mercatorstraat 36,2023-03-03,18:00:00,493,189,304,FMN 02 Mercatorstraat
650,Mercatorstraat 36,2023-03-03,19:00:00,408,223,185,FMN 02 Mercatorstraat
650,Mercatorstraat 36,2023-03-03,20:00:00,255,122,133,FMN 02 Mercatorstraat
650,Mercatorstraat 36,2023-03-03,21:00:00,153,83,70,FMN 02 Mercatorstraat
650,Mercatorstraat 36,2023-03-03,22:00:00,206,78,128,FMN 02 Mercatorstraat
650,Mercatorstraat 36,2023-03-03,23:00:00,187,71,116,FMN 02 Mercatorstraat
650,Mercatorstraat 36,2023-03-04,00:00:00,169,87,82,FMN 02 Mercatorstraat
650,Mercatorstraat 36,2023-03-04,01:00:00,131,76,55,FMN 02 Mercatorstraat
650,Mercatorstraat 36,2023-03-04,02:00:00,83,31,52,FMN 02 Mercatorstraat
650,Mercatorstraat 36,2023-03-04,03:00:00,86,15,71,FMN 02 Mercatorstraat
650,Mercatorstraat 36,2023-03-04,04:00:00,60,13,47,FMN 02 Mercatorstraat
650,Mercatorstraat 36,2023-03-04,05:00:00,61,16,45,FMN 02 Mercatorstraat
650,Mercatorstraat 36,2023-03-04,06:00:00,70,33,37,FMN 02 Mercatorstraat
650,Mercatorstraat 36,2023-03-04,07:00:00,47,17,30,FMN 02 Mercatorstraat
650,Mercatorstraat 36,2023-03-04,08:00:00,87,54,33,FMN 02 Mercatorstraat
650,Mercatorstraat 36,2023-03-04,09:00:00,187,148,39,FMN 02 Mercatorstraat
650,Mercatorstraat 36,2023-03-04,10:00:00,233,168,65,FMN 02 Mercatorstraat
650,Mercatorstraat 36,2023-03-04,11:00:00,275,165,110,FMN 02 Mercatorstraat
650,Mercatorstraat 36,2023-03-04,12:00:00,279,144,135,FMN 02 Mercatorstraat
650,Mercatorstraat 36,2023-03-04,13:00:00,283,156,127,FMN 02 Mercatorstraat
650,Mercatorstraat 36,2023-03-04,14:00:00,309,183,126,FMN 02 Mercatorstraat
650,Mercatorstraat 36,2023-03-04,15:00:00,282,134,148,FMN 02 Mercatorstraat
650,Mercatorstraat 36,2023-03-04,16:00:00,312,123,189,FMN 02 Mercatorstraat
650,Mercatorstraat 36,2023-03-04,17:00:00,304,130,174,FMN 02 Mercatorstraat
650,Mercatorstraat 36,2023-03-04,18:00:00,286,136,150,FMN 02 Mercatorstraat
650,Mercatorstraat 36,2023-03-04,19:00:00,257,163,94,FMN 02 Mercatorstraat
650,Mercatorstraat 36,2023-03-04,20:00:00,220,105,115,FMN 02 Mercatorstraat
650,Mercatorstraat 36,2023-03-04,21:00:00,126,59,67,FMN 02 Mercatorstraat
650,Mercatorstraat 36,2023-03-04,22:00:00,182,74,108,FMN 02 Mercatorstraat
650,Mercatorstraat 36,2023-03-04,23:00:00,173,54,119,FMN 02 Mercatorstraat
650,Mercatorstraat 36,2023-03-05,00:00:00,161,81,80,FMN 02 Mercatorstraat
650,Mercatorstraat 36,2023-03-05,01:00:00,116,53,63,FMN 02 Mercatorstraat
650,Mercatorstraat 36,2023-03-05,02:00:00,87,41,46,FMN 02 Mercatorstraat
650,Mercatorstraat 36,2023-03-05,03:00:00,63,16,47,FMN 02 Mercatorstraat
650,Mercatorstraat 36,2023-03-05,04:00:00,50,5,45,FMN 02 Mercatorstraat
650,Mercatorstraat 36,2023-03-05,05:00:00,49,13,36,FMN 02 Mercatorstraat
650,Mercatorstraat 36,2023-03-05,06:00:00,31,11,20,FMN 02 Mercatorstraat
650,Mercatorstraat 36,2023-03-05,07:00:00,57,17,40,FMN 02 Mercatorstraat
650,Mercatorstraat 36,2023-03-05,08:00:00,109,46,63,FMN 02 Mercatorstraat
650,Mercatorstraat 36,2023-03-05,09:00:00,201,84,117,FMN 02 Mercatorstraat
650,Mercatorstraat 36,2023-03-05,10:00:00,204,160,44,FMN 02 Mercatorstraat
650,Mercatorstraat 36,2023-03-05,11:00:00,182,107,75,FMN 02 Mercatorstraat
650,Mercatorstraat 36,2023-03-05,12:00:00,268,126,142,FMN 02 Mercatorstraat
650,Mercatorstraat 36,2023-03-05,13:00:00,249,141,108,FMN 02 Mercatorstraat
650,Mercatorstraat 36,2023-03-05,14:00:00,254,151,103,FMN 02 Mercatorstraat
650,Mercatorstraat 36,2023-03-05,15:00:00,229,139,90,FMN 02 Mercatorstraat
650,Mercatorstraat 36,2023-03-05,16:00:00,275,104,171,FMN 02 Mercatorstraat
650,Mercatorstraat 36,2023-03-05,17:00:00,218,80,138,FMN 02 Mercatorstraat
650,Mercatorstraat 36,2023-03-05,18:00:00,237,104,133,FMN 02 Mercatorstraat
650,Mercatorstraat 36,2023-03-05,19:00:00,209,101,108,FMN 02 Mercatorstraat
650,Mercatorstraat 36,2023-03-05,20:00:00,162,74,88,FMN 02 Mercatorstraat
650,Mercatorstraat 36,2023-03-05,21:00:00,113,41,72,FMN 02 Mercatorstraat
650,Mercatorstraat 36,2023-03-05,22:00:00,104,36,68,FMN 02 Mercatorstraat
650,Mercatorstraat 36,2023-03-05,23:00:00,49,18,31,FMN 02 Mercatorstraat
650,Mercatorstraat 36,2023-03-06,00:00:00,29,12,17,FMN 02 Mercatorstraat
650,Mercatorstraat 36,2023-03-06,01:00:00,23,12,11,FMN 02 Mercatorstraat
650,Mercatorstraat 36,2023-03-06,02:00:00,13,4,9,FMN 02 Mercatorstraat
650,Mercatorstraat 36,2023-03-06,03:00:00,10,3,7,FMN 02 Mercatorstraat
650,Mercatorstraat 36,2023-03-06,04:00:00,21,10,11,FMN 02 Mercatorstraat
650,Mercatorstraat 36,2023-03-06,05:00:00,35,18,17,FMN 02 Mercatorstraat
650,Mercatorstraat 36,2023-03-06,06:00:00,100,66,34,FMN 02 Mercatorstraat
650,Mercatorstraat 36,2023-03-06,07:00:00,377,247,130,FMN 02 Mercatorstraat
650,Mercatorstraat 36,2023-03-06,08:00:00,1003,696,307,FMN 02 Mercatorstraat
650,Mercatorstraat 36,2023-03-06,09:00:00,382,297,85,FMN 02 Mercatorstraat
650,Mercatorstraat 36,2023-03-06,10:00:00,203,145,58,FMN 02 Mercatorstraat
650,Mercatorstraat 36,2023-03-06,11:00:00,206,103,103,FMN 02 Mercatorstraat
650,Mercatorstraat 36,2023-03-06,12:00:00,375,187,188,FMN 02 Mercatorstraat
650,Mercatorstraat 36,2023-03-06,13:00:00,305,145,160,FMN 02 Mercatorstraat
650,Mercatorstraat 36,2023-03-06,14:00:00,262,111,151,FMN 02 Mercatorstraat
650,Mercatorstraat 36,2023-03-06,15:00:00,415,159,256,FMN 02 Mercatorstraat
650,Mercatorstraat 36,2023-03-06,16:00:00,643,197,446,FMN 02 Mercatorstraat
650,Mercatorstraat 36,2023-03-06,17:00:00,698,219,479,FMN 02 Mercatorstraat
650,Mercatorstraat 36,2023-03-06,18:00:00,488,180,308,FMN 02 Mercatorstraat
650,Mercatorstraat 36,2023-03-06,19:00:00,229,102,127,FMN 02 Mercatorstraat
650,Mercatorstraat 36,2023-03-06,20:00:00,150,60,90,FMN 02 Mercatorstraat
650,Mercatorstraat 36,2023-03-06,21:00:00,169,70,99,FMN 02 Mercatorstraat
650,Mercatorstraat 36,2023-03-06,22:00:00,138,52,86,FMN 02 Mercatorstraat
650,Mercatorstraat 36,2023-03-06,23:00:00,61,23,38,FMN 02 Mercatorstraat
650,Mercatorstraat 36,2023-03-07,00:00:00,26,5,21,FMN 02 Mercatorstraat
650,Mercatorstraat 36,2023-03-07,01:00:00,17,1,16,FMN 02 Mercatorstraat
650,Mercatorstraat 36,2023-03-07,02:00:00,11,2,9,FMN 02 Mercatorstraat
650,Mercatorstraat 36,2023-03-07,03:00:00,15,3,12,FMN 02 Mercatorstraat
650,Mercatorstraat 36,2023-03-07,04:00:00,25,15,10,FMN 02 Mercatorstraat
650,Mercatorstraat 36,2023-03-07,05:00:00,37,22,15,FMN 02 Mercatorstraat
650,Mercatorstraat 36,2023-03-07,06:00:00,79,56,23,FMN 02 Mercatorstraat
650,Mercatorstraat 36,2023-03-07,07:00:00,329,241,88,FMN 02 Mercatorstraat
650,Mercatorstraat 36,2023-03-07,08:00:00,789,595,194,FMN 02 Mercatorstraat
650,Mercatorstraat 36,2023-03-07,09:00:00,280,220,60,FMN 02 Mercatorstraat
650,Mercatorstraat 36,2023-03-07,10:00:00,191,116,75,FMN 02 Mercatorstraat
650,Mercatorstraat 36,2023-03-07,11:00:00,167,79,88,FMN 02 Mercatorstraat
650,Mercatorstraat 36,2023-03-07,12:00:00,266,130,136,FMN 02 Mercatorstraat
650,Mercatorstraat 36,2023-03-07,13:00:00,242,126,116,FMN 02 Mercatorstraat
650,Mercatorstraat 36,2023-03-07,14:00:00,186,89,97,FMN 02 Mercatorstraat
650,Mercatorstraat 36,2023-03-07,15:00:00,353,100,253,FMN 02 Mercatorstraat
650,Mercatorstraat 36,2023-03-07,16:00:00,509,146,363,FMN 02 Mercatorstraat
650,Mercatorstraat 36,2023-03-07,17:00:00,576,186,390,FMN 02 Mercatorstraat
650,Mercatorstraat 36,2023-03-07,18:00:00,405,140,265,FMN 02 Mercatorstraat
650,Mercatorstraat 36,2023-03-07,19:00:00,231,106,125,FMN 02 Mercatorstraat
650,Mercatorstraat 36,2023-03-07,20:00:00,148,65,83,FMN 02 Mercatorstraat
650,Mercatorstraat 36,2023-03-07,21:00:00,143,51,92,FMN 02 Mercatorstraat
650,Mercatorstraat 36,2023-03-07,22:00:00,141,48,93,FMN 02 Mercatorstraat
650,Mercatorstraat 36,2023-03-07,23:00:00,67,23,44,FMN 02 Mercatorstraat
650,Mercatorstraat 36,2023-03-08,00:00:00,43,24,19,FMN 02 Mercatorstraat
650,Mercatorstraat 36,2023-03-08,01:00:00,21,10,11,FMN 02 Mercatorstraat
650,Mercatorstraat 36,2023-03-08,02:00:00,14,1,13,FMN 02 Mercatorstraat
650,Mercatorstraat 36,2023-03-08,03:00:00,6,1,5,FMN 02 Mercatorstraat
650,Mercatorstraat 36,2023-03-08,04:00:00,23,16,7,FMN 02 Mercatorstraat
650,Mercatorstraat 36,2023-03-08,05:00:00,33,19,14,FMN 02 Mercatorstraat
650,Mercatorstraat 36,2023-03-08,06:00:00,69,53,16,FMN 02 Mercatorstraat
650,Mercatorstraat 36,2023-03-08,07:00:00,254,170,84,FMN 02 Mercatorstraat
650,Mercatorstraat 36,2023-03-08,08:00:00,489,353,136,FMN 02 Mercatorstraat
650,Mercatorstraat 36,2023-03-08,09:00:00,218,156,62,FMN 02 Mercatorstraat
650,Mercatorstraat 36,2023-03-08,10:00:00,135,82,53,FMN 02 Mercatorstraat
650,Mercatorstraat 36,2023-03-08,11:00:00,139,74,65,FMN 02 Mercatorstraat
650,Mercatorstraat 36,2023-03-08,12:00:00,282,108,174,FMN 02 Mercatorstraat
650,Mercatorstraat 36,2023-03-08,13:00:00,250,134,116,FMN 02 Mercatorstraat
650,Mercatorstraat 36,2023-03-08,14:00:00,187,96,91,FMN 02 Mercatorstraat
650,Mercatorstraat 36,2023-03-08,15:00:00,236,104,132,FMN 02 Mercatorstraat
650,Mercatorstraat 36,2023-03-08,16:00:00,327,128,199,FMN 02 Mercatorstraat
650,Mercatorstraat 36,2023-03-08,17:00:00,428,139,289,FMN 02 Mercatorstraat
650,Mercatorstraat 36,2023-03-08,18:00:00,350,126,224,FMN 02 Mercatorstraat
650,Mercatorstraat 36,2023-03-08,19:00:00,203,99,104,FMN 02 Mercatorstraat
650,Mercatorstraat 36,2023-03-08,20:00:00,149,65,84,FMN 02 Mercatorstraat
650,Mercatorstraat 36,2023-03-08,21:00:00,131,51,80,FMN 02 Mercatorstraat
650,Mercatorstraat 36,2023-03-08,22:00:00,142,44,98,FMN 02 Mercatorstraat
650,Mercatorstraat 36,2023-03-08,23:00:00,67,19,48,FMN 02 Mercatorstraat
650,Mercatorstraat 36,2023-03-09,00:00:00,52,23,29,FMN 02 Mercatorstraat
650,Mercatorstraat 36,2023-03-09,01:00:00,18,8,10,FMN 02 Mercatorstraat
650,Mercatorstraat 36,2023-03-09,02:00:00,13,10,3,FMN 02 Mercatorstraat
650,Mercatorstraat 36,2023-03-09,03:00:00,12,4,8,FMN 02 Mercatorstraat
650,Mercatorstraat 36,2023-03-09,04:00:00,34,19,15,FMN 02 Mercatorstraat
650,Mercatorstraat 36,2023-03-09,05:00:00,39,22,17,FMN 02 Mercatorstraat
650,Mercatorstraat 36,2023-03-09,06:00:00,90,50,40,FMN 02 Mercatorstraat
650,Mercatorstraat 36,2023-03-09,07:00:00,338,212,126,FMN 02 Mercatorstraat
650,Mercatorstraat 36,2023-03-09,08:00:00,898,603,295,FMN 02 Mercatorstraat
650,Mercatorstraat 36,2023-03-09,09:00:00,387,273,114,FMN 02 Mercatorstraat
650,Mercatorstraat 36,2023-03-09,10:00:00,194,130,64,FMN 02 Mercatorstraat
650,Mercatorstraat 36,2023-03-09,11:00:00,176,100,76,FMN 02 Mercatorstraat
650,Mercatorstraat 36,2023-03-09,12:00:00,282,137,145,FMN 02 Mercatorstraat
650,Mercatorstraat 36,2023-03-09,13:00:00,279,126,153,FMN 02 Mercatorstraat
650,Mercatorstraat 36,2023-03-09,14:00:00,290,117,173,FMN 02 Mercatorstraat
650,Mercatorstraat 36,2023-03-09,15:00:00,344,113,231,FMN 02 Mercatorstraat
650,Mercatorstraat 36,2023-03-09,16:00:00,509,170,339,FMN 02 Mercatorstraat
650,Mercatorstraat 36,2023-03-09,17:00:00,573,167,406,FMN 02 Mercatorstraat
650,Mercatorstraat 36,2023-03-09,18:00:00,410,163,247,FMN 02 Mercatorstraat
650,Mercatorstraat 36,2023-03-09,19:00:00,245,114,131,FMN 02 Mercatorstraat
650,Mercatorstraat 36,2023-03-09,20:00:00,185,80,105,FMN 02 Mercatorstraat
650,Mercatorstraat 36,2023-03-09,21:00:00,152,54,98,FMN 02 Mercatorstraat
650,Mercatorstraat 36,2023-03-09,22:00:00,118,36,82,FMN 02 Mercatorstraat
650,Mercatorstraat 36,2023-03-09,23:00:00,87,25,62,FMN 02 Mercatorstraat
650,Mercatorstraat 36,2023-03-10,00:00:00,56,23,33,FMN 02 Mercatorstraat
650,Mercatorstraat 36,2023-03-10,01:00:00,29,8,21,FMN 02 Mercatorstraat
650,Mercatorstraat 36,2023-03-10,02:00:00,13,6,7,FMN 02 Mercatorstraat
650,Mercatorstraat 36,2023-03-10,03:00:00,7,1,6,FMN 02 Mercatorstraat
650,Mercatorstraat 36,2023-03-10,04:00:00,27,18,9,FMN 02 Mercatorstraat
650,Mercatorstraat 36,2023-03-10,05:00:00,31,18,13,FMN 02 Mercatorstraat
650,Mercatorstraat 36,2023-03-10,06:00:00,90,52,38,FMN 02 Mercatorstraat
650,Mercatorstraat 36,2023-03-10,07:00:00,372,238,134,FMN 02 Mercatorstraat
650,Mercatorstraat 36,2023-03-10,08:00:00,847,574,273,FMN 02 Mercatorstraat
650,Mercatorstraat 36,2023-03-10,09:00:00,356,281,75,FMN 02 Mercatorstraat
650,Mercatorstraat 36,2023-03-10,10:00:00,186,118,68,FMN 02 Mercatorstraat
650,Mercatorstraat 36,2023-03-10,11:00:00,197,118,79,FMN 02 Mercatorstraat
650,Mercatorstraat 36,2023-03-10,12:00:00,362,168,194,FMN 02 Mercatorstraat
650,Mercatorstraat 36,2023-03-10,13:00:00,262,118,144,FMN 02 Mercatorstraat
650,Mercatorstraat 36,2023-03-10,14:00:00,272,115,157,FMN 02 Mercatorstraat
650,Mercatorstraat 36,2023-03-10,15:00:00,396,104,292,FMN 02 Mercatorstraat
650,Mercatorstraat 36,2023-03-10,16:00:00,480,121,359,FMN 02 Mercatorstraat
650,Mercatorstraat 36,2023-03-10,17:00:00,500,183,317,FMN 02 Mercatorstraat
650,Mercatorstraat 36,2023-03-10,18:00:00,372,145,227,FMN 02 Mercatorstraat
650,Mercatorstraat 36,2023-03-10,19:00:00,246,134,112,FMN 02 Mercatorstraat
650,Mercatorstraat 36,2023-03-10,20:00:00,203,117,86,FMN 02 Mercatorstraat
650,Mercatorstraat 36,2023-03-10,21:00:00,184,94,90,FMN 02 Mercatorstraat
650,Mercatorstraat 36,2023-03-10,22:00:00,159,63,96,FMN 02 Mercatorstraat
650,Mercatorstraat 36,2023-03-10,23:00:00,148,69,79,FMN 02 Mercatorstraat
650,Mercatorstraat 36,2023-03-11,00:00:00,115,48,67,FMN 02 Mercatorstraat
650,Mercatorstraat 36,2023-03-11,01:00:00,93,42,51,FMN 02 Mercatorstraat
650,Mercatorstraat 36,2023-03-11,02:00:00,79,27,52,FMN 02 Mercatorstraat
650,Mercatorstraat 36,2023-03-11,03:00:00,58,16,42,FMN 02 Mercatorstraat
650,Mercatorstraat 36,2023-03-11,04:00:00,40,13,27,FMN 02 Mercatorstraat
650,Mercatorstraat 36,2023-03-11,05:00:00,47,21,26,FMN 02 Mercatorstraat
650,Mercatorstraat 36,2023-03-11,06:00:00,32,14,18,FMN 02 Mercatorstraat
650,Mercatorstraat 36,2023-03-11,07:00:00,49,26,23,FMN 02 Mercatorstraat
650,Mercatorstraat 36,2023-03-11,08:00:00,93,67,26,FMN 02 Mercatorstraat
650,Mercatorstraat 36,2023-03-11,09:00:00,220,175,45,FMN 02 Mercatorstraat
650,Mercatorstraat 36,2023-03-11,10:00:00,258,179,79,FMN 02 Mercatorstraat
650,Mercatorstraat 36,2023-03-11,11:00:00,279,177,102,FMN 02 Mercatorstraat
650,Mercatorstraat 36,2023-03-11,12:00:00,341,201,140,FMN 02 Mercatorstraat
650,Mercatorstraat 36,2023-03-11,13:00:00,328,184,144,FMN 02 Mercatorstraat
650,Mercatorstraat 36,2023-03-11,14:00:00,380,226,154,FMN 02 Mercatorstraat
650,Mercatorstraat 36,2023-03-11,15:00:00,347,173,174,FMN 02 Mercatorstraat
650,Mercatorstraat 36,2023-03-11,16:00:00,372,124,248,FMN 02 Mercatorstraat
650,Mercatorstraat 36,2023-03-11,17:00:00,329,118,211,FMN 02 Mercatorstraat
650,Mercatorstraat 36,2023-03-11,18:00:00,301,127,174,FMN 02 Mercatorstraat
650,Mercatorstraat 36,2023-03-11,19:00:00,307,171,136,FMN 02 Mercatorstraat
650,Mercatorstraat 36,2023-03-11,20:00:00,168,89,79,FMN 02 Mercatorstraat
650,Mercatorstraat 36,2023-03-11,21:00:00,189,90,99,FMN 02 Mercatorstraat
650,Mercatorstraat 36,2023-03-11,22:00:00,175,78,97,FMN 02 Mercatorstraat
650,Mercatorstraat 36,2023-03-11,23:00:00,143,49,94,FMN 02 Mercatorstraat
650,Mercatorstraat 36,2023-03-12,00:00:00,166,88,78,FMN 02 Mercatorstraat
650,Mercatorstraat 36,2023-03-12,01:00:00,114,43,71,FMN 02 Mercatorstraat
650,Mercatorstraat 36,2023-03-12,02:00:00,57,11,46,FMN 02 Mercatorstraat
650,Mercatorstraat 36,2023-03-12,03:00:00,56,10,46,FMN 02 Mercatorstraat
650,Mercatorstraat 36,2023-03-12,04:00:00,45,5,40,FMN 02 Mercatorstraat
650,Mercatorstraat 36,2023-03-12,05:00:00,69,21,48,FMN 02 Mercatorstraat
650,Mercatorstraat 36,2023-03-12,06:00:00,39,17,22,FMN 02 Mercatorstraat
650,Mercatorstraat 36,2023-03-12,07:00:00,50,25,25,FMN 02 Mercatorstraat
650,Mercatorstraat 36,2023-03-12,08:00:00,88,29,59,FMN 02 Mercatorstraat
650,Mercatorstraat 36,2023-03-12,09:00:00,181,88,93,FMN 02 Mercatorstraat
650,Mercatorstraat 36,2023-03-12,10:00:00,147,80,67,FMN 02 Mercatorstraat
650,Mercatorstraat 36,2023-03-12,11:00:00,163,96,67,FMN 02 Mercatorstraat
650,Mercatorstraat 36,2023-03-12,12:00:00,167,82,85,FMN 02 Mercatorstraat
650,Mercatorstraat 36,2023-03-12,13:00:00,213,101,112,FMN 02 Mercatorstraat
650,Mercatorstraat 36,2023-03-12,14:00:00,232,150,82,FMN 02 Mercatorstraat
650,Mercatorstraat 36,2023-03-12,15:00:00,224,123,101,FMN 02 Mercatorstraat
650,Mercatorstraat 36,2023-03-12,16:00:00,230,89,141,FMN 02 Mercatorstraat
650,Mercatorstraat 36,2023-03-12,17:00:00,255,103,152,FMN 02 Mercatorstraat
650,Mercatorstraat 36,2023-03-12,18:00:00,202,89,113,FMN 02 Mercatorstraat
650,Mercatorstraat 36,2023-03-12,19:00:00,230,103,127,FMN 02 Mercatorstraat
650,Mercatorstraat 36,2023-03-12,20:00:00,148,61,87,FMN 02 Mercatorstraat
650,Mercatorstraat 36,2023-03-12,21:00:00,125,57,68,FMN 02 Mercatorstraat
650,Mercatorstraat 36,2023-03-12,22:00:00,104,42,62,FMN 02 Mercatorstraat
650,Mercatorstraat 36,2023-03-12,23:00:00,52,22,30,FMN 02 Mercatorstraat
650,Mercatorstraat 36,2023-03-13,00:00:00,25,8,17,FMN 02 Mercatorstraat
650,Mercatorstraat 36,2023-03-13,01:00:00,18,11,7,FMN 02 Mercatorstraat
650,Mercatorstraat 36,2023-03-13,02:00:00,3,0,3,FMN 02 Mercatorstraat
650,Mercatorstraat 36,2023-03-13,03:00:00,8,3,5,FMN 02 Mercatorstraat
650,Mercatorstraat 36,2023-03-13,04:00:00,25,16,9,FMN 02 Mercatorstraat
650,Mercatorstraat 36,2023-03-13,05:00:00,44,22,22,FMN 02 Mercatorstraat
650,Mercatorstraat 36,2023-03-13,06:00:00,95,59,36,FMN 02 Mercatorstraat
650,Mercatorstraat 36,2023-03-13,07:00:00,419,266,153,FMN 02 Mercatorstraat
650,Mercatorstraat 36,2023-03-13,08:00:00,889,633,256,FMN 02 Mercatorstraat
650,Mercatorstraat 36,2023-03-13,09:00:00,354,263,91,FMN 02 Mercatorstraat
650,Mercatorstraat 36,2023-03-13,10:00:00,229,150,79,FMN 02 Mercatorstraat
650,Mercatorstraat 36,2023-03-13,11:00:00,207,115,92,FMN 02 Mercatorstraat
650,Mercatorstraat 36,2023-03-13,12:00:00,286,128,158,FMN 02 Mercatorstraat
650,Mercatorstraat 36,2023-03-13,13:00:00,298,141,157,FMN 02 Mercatorstraat
650,Mercatorstraat 36,2023-03-13,14:00:00,296,149,147,FMN 02 Mercatorstraat
650,Mercatorstraat 36,2023-03-13,15:00:00,402,126,276,FMN 02 Mercatorstraat
650,Mercatorstraat 36,2023-03-13,16:00:00,618,203,415,FMN 02 Mercatorstraat
650,Mercatorstraat 36,2023-03-13,17:00:00,732,229,503,FMN 02 Mercatorstraat
650,Mercatorstraat 36,2023-03-13,18:00:00,485,178,307,FMN 02 Mercatorstraat
650,Mercatorstraat 36,2023-03-13,19:00:00,282,125,157,FMN 02 Mercatorstraat
650,Mercatorstraat 36,2023-03-13,20:00:00,206,86,120,FMN 02 Mercatorstraat
650,Mercatorstraat 36,2023-03-13,21:00:00,194,71,123,FMN 02 Mercatorstraat
650,Mercatorstraat 36,2023-03-13,22:00:00,157,58,99,FMN 02 Mercatorstraat
650,Mercatorstraat 36,2023-03-13,23:00:00,60,21,39,FMN 02 Mercatorstraat
650,Mercatorstraat 36,2023-03-14,00:00:00,40,16,24,FMN 02 Mercatorstraat
650,Mercatorstraat 36,2023-03-14,01:00:00,29,8,21,FMN 02 Mercatorstraat
650,Mercatorstraat 36,2023-03-14,02:00:00,15,9,6,FMN 02 Mercatorstraat
650,Mercatorstraat 36,2023-03-14,03:00:00,8,1,7,FMN 02 Mercatorstraat
650,Mercatorstraat 36,2023-03-14,04:00:00,24,14,10,FMN 02 Mercatorstraat
650,Mercatorstraat 36,2023-03-14,05:00:00,52,29,23,FMN 02 Mercatorstraat
650,Mercatorstraat 36,2023-03-14,06:00:00,124,74,50,FMN 02 Mercatorstraat
650,Mercatorstraat 36,2023-03-14,07:00:00,340,210,130,FMN 02 Mercatorstraat
650,Mercatorstraat 36,2023-03-14,08:00:00,798,564,234,FMN 02 Mercatorstraat
650,Mercatorstraat 36,2023-03-14,09:00:00,359,273,86,FMN 02 Mercatorstraat
650,Mercatorstraat 36,2023-03-14,10:00:00,181,125,56,FMN 02 Mercatorstraat
650,Mercatorstraat 36,2023-03-14,11:00:00,195,126,69,FMN 02 Mercatorstraat
650,Mercatorstraat 36,2023-03-14,12:00:00,257,126,131,FMN 02 Mercatorstraat
650,Mercatorstraat 36,2023-03-14,13:00:00,251,112,139,FMN 02 Mercatorstraat
650,Mercatorstraat 36,2023-03-14,14:00:00,246,105,141,FMN 02 Mercatorstraat
650,Mercatorstraat 36,2023-03-14,15:00:00,398,123,275,FMN 02 Mercatorstraat
650,Mercatorstraat 36,2023-03-14,16:00:00,528,154,374,FMN 02 Mercatorstraat
650,Mercatorstraat 36,2023-03-14,17:00:00,638,217,421,FMN 02 Mercatorstraat
650,Mercatorstraat 36,2023-03-14,18:00:00,480,186,294,FMN 02 Mercatorstraat
650,Mercatorstraat 36,2023-03-14,19:00:00,290,138,152,FMN 02 Mercatorstraat
650,Mercatorstraat 36,2023-03-14,20:00:00,204,82,122,FMN 02 Mercatorstraat
650,Mercatorstraat 36,2023-03-14,21:00:00,209,86,123,FMN 02 Mercatorstraat
650,Mercatorstraat 36,2023-03-14,22:00:00,172,52,120,FMN 02 Mercatorstraat
650,Mercatorstraat 36,2023-03-14,23:00:00,81,34,47,FMN 02 Mercatorstraat
650,Mercatorstraat 36,2023-03-15,00:00:00,33,14,19,FMN 02 Mercatorstraat
650,Mercatorstraat 36,2023-03-15,01:00:00,21,5,16,FMN 02 Mercatorstraat
650,Mercatorstraat 36,2023-03-15,02:00:00,16,5,11,FMN 02 Mercatorstraat
650,Mercatorstraat 36,2023-03-15,03:00:00,20,4,16,FMN 02 Mercatorstraat
650,Mercatorstraat 36,2023-03-15,04:00:00,25,14,11,FMN 02 Mercatorstraat
650,Mercatorstraat 36,2023-03-15,05:00:00,42,25,17,FMN 02 Mercatorstraat
650,Mercatorstraat 36,2023-03-15,06:00:00,105,58,47,FMN 02 Mercatorstraat
650,Mercatorstraat 36,2023-03-15,07:00:00,398,256,142,FMN 02 Mercatorstraat
650,Mercatorstraat 36,2023-03-15,08:00:00,868,584,284,FMN 02 Mercatorstraat
650,Mercatorstraat 36,2023-03-15,09:00:00,361,276,85,FMN 02 Mercatorstraat
650,Mercatorstraat 36,2023-03-15,10:00:00,236,163,73,FMN 02 Mercatorstraat
650,Mercatorstraat 36,2023-03-15,11:00:00,234,122,112,FMN 02 Mercatorstraat
650,Mercatorstraat 36,2023-03-15,12:00:00,481,205,276,FMN 02 Mercatorstraat
650,Mercatorstraat 36,2023-03-15,13:00:00,368,167,201,FMN 02 Mercatorstraat
650,Mercatorstraat 36,2023-03-15,14:00:00,334,165,169,FMN 02 Mercatorstraat
650,Mercatorstraat 36,2023-03-15,15:00:00,346,140,206,FMN 02 Mercatorstraat
650,Mercatorstraat 36,2023-03-15,16:00:00,504,181,323,FMN 02 Mercatorstraat
650,Mercatorstraat 36,2023-03-15,17:00:00,647,220,427,FMN 02 Mercatorstraat
650,Mercatorstraat 36,2023-03-15,18:00:00,539,213,326,FMN 02 Mercatorstraat
650,Mercatorstraat 36,2023-03-15,19:00:00,358,197,161,FMN 02 Mercatorstraat
650,Mercatorstraat 36,2023-03-15,20:00:00,236,105,131,FMN 02 Mercatorstraat
650,Mercatorstraat 36,2023-03-15,21:00:00,173,58,115,FMN 02 Mercatorstraat
650,Mercatorstraat 36,2023-03-15,22:00:00,212,74,138,FMN 02 Mercatorstraat
650,Mercatorstraat 36,2023-03-15,23:00:00,126,34,92,FMN 02 Mercatorstraat
650,Mercatorstraat 36,2023-03-16,00:00:00,53,20,33,FMN 02 Mercatorstraat
650,Mercatorstraat 36,2023-03-16,01:00:00,26,11,15,FMN 02 Mercatorstraat
650,Mercatorstraat 36,2023-03-16,02:00:00,25,6,19,FMN 02 Mercatorstraat
650,Mercatorstraat 36,2023-03-16,03:00:00,18,6,12,FMN 02 Mercatorstraat
650,Mercatorstraat 36,2023-03-16,04:00:00,21,10,11,FMN 02 Mercatorstraat
650,Mercatorstraat 36,2023-03-16,05:00:00,45,30,15,FMN 02 Mercatorstraat
650,Mercatorstraat 36,2023-03-16,06:00:00,122,74,48,FMN 02 Mercatorstraat
650,Mercatorstraat 36,2023-03-16,07:00:00,430,270,160,FMN 02 Mercatorstraat
650,Mercatorstraat 36,2023-03-16,08:00:00,1017,698,319,FMN 02 Mercatorstraat
650,Mercatorstraat 36,2023-03-16,09:00:00,408,300,108,FMN 02 Mercatorstraat
650,Mercatorstraat 36,2023-03-16,10:00:00,246,164,82,FMN 02 Mercatorstraat
650,Mercatorstraat 36,2023-03-16,11:00:00,216,125,91,FMN 02 Mercatorstraat
650,Mercatorstraat 36,2023-03-16,12:00:00,338,178,160,FMN 02 Mercatorstraat
650,Mercatorstraat 36,2023-03-16,13:00:00,355,163,192,FMN 02 Mercatorstraat
650,Mercatorstraat 36,2023-03-16,14:00:00,299,135,164,FMN 02 Mercatorstraat
650,Mercatorstraat 36,2023-03-16,15:00:00,461,150,311,FMN 02 Mercatorstraat
650,Mercatorstraat 36,2023-03-16,16:00:00,701,228,473,FMN 02 Mercatorstraat
650,Mercatorstraat 36,2023-03-16,17:00:00,755,267,488,FMN 02 Mercatorstraat
650,Mercatorstraat 36,2023-03-16,18:00:00,588,228,360,FMN 02 Mercatorstraat
650,Mercatorstraat 36,2023-03-16,19:00:00,379,191,188,FMN 02 Mercatorstraat
650,Mercatorstraat 36,2023-03-16,20:00:00,242,109,133,FMN 02 Mercatorstraat
650,Mercatorstraat 36,2023-03-16,21:00:00,243,105,138,FMN 02 Mercatorstraat
650,Mercatorstraat 36,2023-03-16,22:00:00,232,86,146,FMN 02 Mercatorstraat
650,Mercatorstraat 36,2023-03-16,23:00:00,152,64,88,FMN 02 Mercatorstraat
650,Mercatorstraat 36,2023-03-17,00:00:00,94,50,44,FMN 02 Mercatorstraat
650,Mercatorstraat 36,2023-03-17,01:00:00,39,18,21,FMN 02 Mercatorstraat
650,Mercatorstraat 36,2023-03-17,02:00:00,18,2,16,FMN 02 Mercatorstraat
650,Mercatorstraat 36,2023-03-17,03:00:00,22,2,20,FMN 02 Mercatorstraat
650,Mercatorstraat 36,2023-03-17,04:00:00,53,16,37,FMN 02 Mercatorstraat
650,Mercatorstraat 36,2023-03-17,05:00:00,61,24,37,FMN 02 Mercatorstraat
650,Mercatorstraat 36,2023-03-17,06:00:00,106,70,36,FMN 02 Mercatorstraat
650,Mercatorstraat 36,2023-03-17,07:00:00,429,270,159,FMN 02 Mercatorstraat
650,Mercatorstraat 36,2023-03-17,08:00:00,860,590,270,FMN 02 Mercatorstraat
650,Mercatorstraat 36,2023-03-17,09:00:00,380,302,78,FMN 02 Mercatorstraat
650,Mercatorstraat 36,2023-03-17,10:00:00,274,187,87,FMN 02 Mercatorstraat
650,Mercatorstraat 36,2023-03-17,11:00:00,257,133,124,FMN 02 Mercatorstraat
650,Mercatorstraat 36,2023-03-17,12:00:00,412,212,200,FMN 02 Mercatorstraat
650,Mercatorstraat 36,2023-03-17,13:00:00,321,149,172,FMN 02 Mercatorstraat
650,Mercatorstraat 36,2023-03-17,14:00:00,359,164,195,FMN 02 Mercatorstraat
650,Mercatorstraat 36,2023-03-17,15:00:00,560,190,370,FMN 02 Mercatorstraat
650,Mercatorstraat 36,2023-03-17,16:00:00,655,193,462,FMN 02 Mercatorstraat
650,Mercatorstraat 36,2023-03-17,17:00:00,687,240,447,FMN 02 Mercatorstraat
650,Mercatorstraat 36,2023-03-17,18:00:00,494,217,277,FMN 02 Mercatorstraat
650,Mercatorstraat 36,2023-03-17,19:00:00,397,203,194,FMN 02 Mercatorstraat
650,Mercatorstraat 36,2023-03-17,20:00:00,233,128,105,FMN 02 Mercatorstraat
650,Mercatorstraat 36,2023-03-17,21:00:00,214,104,110,FMN 02 Mercatorstraat
650,Mercatorstraat 36,2023-03-17,22:00:00,255,94,161,FMN 02 Mercatorstraat
650,Mercatorstraat 36,2023-03-17,23:00:00,206,74,132,FMN 02 Mercatorstraat
650,Mercatorstraat 36,2023-03-18,00:00:00,166,72,94,FMN 02 Mercatorstraat
650,Mercatorstraat 36,2023-03-18,01:00:00,165,63,102,FMN 02 Mercatorstraat
650,Mercatorstraat 36,2023-03-18,02:00:00,106,39,67,FMN 02 Mercatorstraat
650,Mercatorstraat 36,2023-03-18,03:00:00,59,16,43,FMN 02 Mercatorstraat
650,Mercatorstraat 36,2023-03-18,04:00:00,83,13,70,FMN 02 Mercatorstraat
650,Mercatorstraat 36,2023-03-18,05:00:00,56,18,38,FMN 02 Mercatorstraat
650,Mercatorstraat 36,2023-03-18,06:00:00,38,26,12,FMN 02 Mercatorstraat
650,Mercatorstraat 36,2023-03-18,07:00:00,78,38,40,FMN 02 Mercatorstraat
650,Mercatorstraat 36,2023-03-18,08:00:00,99,62,37,FMN 02 Mercatorstraat
650,Mercatorstraat 36,2023-03-18,09:00:00,217,163,54,FMN 02 Mercatorstraat
650,Mercatorstraat 36,2023-03-18,10:00:00,271,189,82,FMN 02 Mercatorstraat
650,Mercatorstraat 36,2023-03-18,11:00:00,311,179,132,FMN 02 Mercatorstraat
650,Mercatorstraat 36,2023-03-18,12:00:00,313,150,163,FMN 02 Mercatorstraat
650,Mercatorstraat 36,2023-03-18,13:00:00,340,188,152,FMN 02 Mercatorstraat
650,Mercatorstraat 36,2023-03-18,14:00:00,358,212,146,FMN 02 Mercatorstraat
650,Mercatorstraat 36,2023-03-18,15:00:00,313,164,149,FMN 02 Mercatorstraat
650,Mercatorstraat 36,2023-03-18,16:00:00,308,124,184,FMN 02 Mercatorstraat
650,Mercatorstraat 36,2023-03-18,17:00:00,386,132,254,FMN 02 Mercatorstraat
650,Mercatorstraat 36,2023-03-18,18:00:00,289,134,155,FMN 02 Mercatorstraat
650,Mercatorstraat 36,2023-03-18,19:00:00,223,121,102,FMN 02 Mercatorstraat
650,Mercatorstraat 36,2023-03-18,20:00:00,212,105,107,FMN 02 Mercatorstraat
650,Mercatorstraat 36,2023-03-18,21:00:00,140,66,74,FMN 02 Mercatorstraat
650,Mercatorstraat 36,2023-03-18,22:00:00,156,74,82,FMN 02 Mercatorstraat
650,Mercatorstraat 36,2023-03-18,23:00:00,164,56,108,FMN 02 Mercatorstraat
650,Mercatorstraat 36,2023-03-19,00:00:00,144,53,91,FMN 02 Mercatorstraat
650,Mercatorstraat 36,2023-03-19,01:00:00,127,64,63,FMN 02 Mercatorstraat
650,Mercatorstraat 36,2023-03-19,02:00:00,74,22,52,FMN 02 Mercatorstraat
650,Mercatorstraat 36,2023-03-19,03:00:00,65,15,50,FMN 02 Mercatorstraat
650,Mercatorstraat 36,2023-03-19,04:00:00,44,7,37,FMN 02 Mercatorstraat
650,Mercatorstraat 36,2023-03-19,05:00:00,41,15,26,FMN 02 Mercatorstraat
650,Mercatorstraat 36,2023-03-19,06:00:00,44,24,20,FMN 02 Mercatorstraat
650,Mercatorstraat 36,2023-03-19,07:00:00,68,26,42,FMN 02 Mercatorstraat
650,Mercatorstraat 36,2023-03-19,08:00:00,110,42,68,FMN 02 Mercatorstraat
650,Mercatorstraat 36,2023-03-19,09:00:00,235,129,106,FMN 02 Mercatorstraat
650,Mercatorstraat 36,2023-03-19,10:00:00,286,201,85,FMN 02 Mercatorstraat
650,Mercatorstraat 36,2023-03-19,11:00:00,185,96,89,FMN 02 Mercatorstraat
650,Mercatorstraat 36,2023-03-19,12:00:00,300,151,149,FMN 02 Mercatorstraat
650,Mercatorstraat 36,2023-03-19,13:00:00,307,179,128,FMN 02 Mercatorstraat
650,Mercatorstraat 36,2023-03-19,14:00:00,317,187,130,FMN 02 Mercatorstraat
650,Mercatorstraat 36,2023-03-19,15:00:00,282,119,163,FMN 02 Mercatorstraat
650,Mercatorstraat 36,2023-03-19,16:00:00,322,102,220,FMN 02 Mercatorstraat
650,Mercatorstraat 36,2023-03-19,17:00:00,246,96,150,FMN 02 Mercatorstraat
650,Mercatorstraat 36,2023-03-19,18:00:00,224,103,121,FMN 02 Mercatorstraat
650,Mercatorstraat 36,2023-03-19,19:00:00,253,115,138,FMN 02 Mercatorstraat
650,Mercatorstraat 36,2023-03-19,20:00:00,169,81,88,FMN 02 Mercatorstraat
650,Mercatorstraat 36,2023-03-19,21:00:00,125,56,69,FMN 02 Mercatorstraat
650,Mercatorstraat 36,2023-03-19,22:00:00,117,53,64,FMN 02 Mercatorstraat
650,Mercatorstraat 36,2023-03-19,23:00:00,65,27,38,FMN 02 Mercatorstraat
650,Mercatorstraat 36,2023-03-20,00:00:00,25,10,15,FMN 02 Mercatorstraat
650,Mercatorstraat 36,2023-03-20,01:00:00,17,7,10,FMN 02 Mercatorstraat
650,Mercatorstraat 36,2023-03-20,02:00:00,12,2,10,FMN 02 Mercatorstraat
650,Mercatorstraat 36,2023-03-20,03:00:00,12,6,6,FMN 02 Mercatorstraat
650,Mercatorstraat 36,2023-03-20,04:00:00,20,14,6,FMN 02 Mercatorstraat
650,Mercatorstraat 36,2023-03-20,05:00:00,38,25,13,FMN 02 Mercatorstraat
650,Mercatorstraat 36,2023-03-20,06:00:00,135,87,48,FMN 02 Mercatorstraat
650,Mercatorstraat 36,2023-03-20,07:00:00,409,266,143,FMN 02 Mercatorstraat
650,Mercatorstraat 36,2023-03-20,08:00:00,986,695,291,FMN 02 Mercatorstraat
650,Mercatorstraat 36,2023-03-20,09:00:00,402,300,102,FMN 02 Mercatorstraat
650,Mercatorstraat 36,2023-03-20,10:00:00,219,138,81,FMN 02 Mercatorstraat
650,Mercatorstraat 36,2023-03-20,11:00:00,188,114,74,FMN 02 Mercatorstraat
650,Mercatorstraat 36,2023-03-20,12:00:00,368,181,187,FMN 02 Mercatorstraat
650,Mercatorstraat 36,2023-03-20,13:00:00,351,169,182,FMN 02 Mercatorstraat
650,Mercatorstraat 36,2023-03-20,14:00:00,300,145,155,FMN 02 Mercatorstraat
650,Mercatorstraat 36,2023-03-20,15:00:00,406,153,253,FMN 02 Mercatorstraat
650,Mercatorstraat 36,2023-03-20,16:00:00,618,175,443,FMN 02 Mercatorstraat
650,Mercatorstraat 36,2023-03-20,17:00:00,741,198,543,FMN 02 Mercatorstraat
650,Mercatorstraat 36,2023-03-20,18:00:00,499,188,311,FMN 02 Mercatorstraat
650,Mercatorstraat 36,2023-03-20,19:00:00,276,138,138,FMN 02 Mercatorstraat
650,Mercatorstraat 36,2023-03-20,20:00:00,167,70,97,FMN 02 Mercatorstraat
650,Mercatorstraat 36,2023-03-20,21:00:00,194,61,133,FMN 02 Mercatorstraat
650,Mercatorstraat 36,2023-03-20,22:00:00,124,48,76,FMN 02 Mercatorstraat
650,Mercatorstraat 36,2023-03-20,23:00:00,79,25,54,FMN 02 Mercatorstraat
650,Mercatorstraat 36,2023-03-21,00:00:00,40,6,34,FMN 02 Mercatorstraat
650,Mercatorstraat 36,2023-03-21,01:00:00,26,6,20,FMN 02 Mercatorstraat
650,Mercatorstraat 36,2023-03-21,02:00:00,22,6,16,FMN 02 Mercatorstraat
650,Mercatorstraat 36,2023-03-21,03:00:00,13,5,8,FMN 02 Mercatorstraat
650,Mercatorstraat 36,2023-03-21,04:00:00,25,12,13,FMN 02 Mercatorstraat
650,Mercatorstraat 36,2023-03-21,05:00:00,39,24,15,FMN 02 Mercatorstraat
650,Mercatorstraat 36,2023-03-21,06:00:00,110,70,40,FMN 02 Mercatorstraat
650,Mercatorstraat 36,2023-03-21,07:00:00,402,259,143,FMN 02 Mercatorstraat
650,Mercatorstraat 36,2023-03-21,08:00:00,1005,703,302,FMN 02 Mercatorstraat
650,Mercatorstraat 36,2023-03-21,09:00:00,387,293,94,FMN 02 Mercatorstraat
650,Mercatorstraat 36,2023-03-21,10:00:00,233,162,71,FMN 02 Mercatorstraat
650,Mercatorstraat 36,2023-03-21,11:00:00,252,145,107,FMN 02 Mercatorstraat
650,Mercatorstraat 36,2023-03-21,12:00:00,358,174,184,FMN 02 Mercatorstraat
650,Mercatorstraat 36,2023-03-21,13:00:00,392,178,214,FMN 02 Mercatorstraat
650,Mercatorstraat 36,2023-03-21,14:00:00,313,141,172,FMN 02 Mercatorstraat
650,Mercatorstraat 36,2023-03-21,15:00:00,400,129,271,FMN 02 Mercatorstraat
650,Mercatorstraat 36,2023-03-21,16:00:00,649,209,440,FMN 02 Mercatorstraat
650,Mercatorstraat 36,2023-03-21,17:00:00,733,220,513,FMN 02 Mercatorstraat
650,Mercatorstraat 36,2023-03-21,18:00:00,550,245,305,FMN 02 Mercatorstraat
650,Mercatorstraat 36,2023-03-21,19:00:00,365,177,188,FMN 02 Mercatorstraat
650,Mercatorstraat 36,2023-03-21,20:00:00,214,85,129,FMN 02 Mercatorstraat
650,Mercatorstraat 36,2023-03-21,21:00:00,245,112,133,FMN 02 Mercatorstraat
650,Mercatorstraat 36,2023-03-21,22:00:00,193,64,129,FMN 02 Mercatorstraat
650,Mercatorstraat 36,2023-03-21,23:00:00,122,39,83,FMN 02 Mercatorstraat
650,Mercatorstraat 36,2023-03-22,00:00:00,48,15,33,FMN 02 Mercatorstraat
650,Mercatorstraat 36,2023-03-22,01:00:00,26,8,18,FMN 02 Mercatorstraat
650,Mercatorstraat 36,2023-03-22,02:00:00,12,3,9,FMN 02 Mercatorstraat
650,Mercatorstraat 36,2023-03-22,03:00:00,17,3,14,FMN 02 Mercatorstraat
650,Mercatorstraat 36,2023-03-22,04:00:00,32,17,15,FMN 02 Mercatorstraat
650,Mercatorstraat 36,2023-03-22,05:00:00,35,23,12,FMN 02 Mercatorstraat
650,Mercatorstraat 36,2023-03-22,06:00:00,126,75,51,FMN 02 Mercatorstraat
650,Mercatorstraat 36,2023-03-22,07:00:00,415,255,160,FMN 02 Mercatorstraat
650,Mercatorstraat 36,2023-03-22,08:00:00,896,596,300,FMN 02 Mercatorstraat
650,Mercatorstraat 36,2023-03-22,09:00:00,367,257,110,FMN 02 Mercatorstraat
650,Mercatorstraat 36,2023-03-22,10:00:00,257,150,107,FMN 02 Mercatorstraat
650,Mercatorstraat 36,2023-03-22,11:00:00,220,106,114,FMN 02 Mercatorstraat
650,Mercatorstraat 36,2023-03-22,12:00:00,473,180,293,FMN 02 Mercatorstraat
650,Mercatorstraat 36,2023-03-22,13:00:00,404,190,214,FMN 02 Mercatorstraat
650,Mercatorstraat 36,2023-03-22,14:00:00,317,169,148,FMN 02 Mercatorstraat
650,Mercatorstraat 36,2023-03-22,15:00:00,322,116,206,FMN 02 Mercatorstraat
650,Mercatorstraat 36,2023-03-22,16:00:00,434,138,296,FMN 02 Mercatorstraat
650,Mercatorstraat 36,2023-03-22,17:00:00,582,200,382,FMN 02 Mercatorstraat
650,Mercatorstraat 36,2023-03-22,18:00:00,482,201,281,FMN 02 Mercatorstraat
650,Mercatorstraat 36,2023-03-22,19:00:00,272,125,147,FMN 02 Mercatorstraat
650,Mercatorstraat 36,2023-03-22,20:00:00,191,82,109,FMN 02 Mercatorstraat
650,Mercatorstraat 36,2023-03-22,21:00:00,153,60,93,FMN 02 Mercatorstraat
650,Mercatorstraat 36,2023-03-22,22:00:00,174,52,122,FMN 02 Mercatorstraat
650,Mercatorstraat 36,2023-03-22,23:00:00,107,46,61,FMN 02 Mercatorstraat
650,Mercatorstraat 36,2023-03-23,00:00:00,45,13,32,FMN 02 Mercatorstraat
650,Mercatorstraat 36,2023-03-23,01:00:00,18,4,14,FMN 02 Mercatorstraat
650,Mercatorstraat 36,2023-03-23,02:00:00,19,3,16,FMN 02 Mercatorstraat
650,Mercatorstraat 36,2023-03-23,03:00:00,12,2,10,FMN 02 Mercatorstraat
650,Mercatorstraat 36,2023-03-23,04:00:00,26,13,13,FMN 02 Mercatorstraat
650,Mercatorstraat 36,2023-03-23,05:00:00,41,30,11,FMN 02 Mercatorstraat
650,Mercatorstraat 36,2023-03-23,06:00:00,118,73,45,FMN 02 Mercatorstraat
650,Mercatorstraat 36,2023-03-23,07:00:00,307,193,114,FMN 02 Mercatorstraat
650,Mercatorstraat 36,2023-03-23,08:00:00,829,532,297,FMN 02 Mercatorstraat
650,Mercatorstraat 36,2023-03-23,09:00:00,399,295,104,FMN 02 Mercatorstraat
650,Mercatorstraat 36,2023-03-23,10:00:00,249,162,87,FMN 02 Mercatorstraat
650,Mercatorstraat 36,2023-03-23,11:00:00,211,123,88,FMN 02 Mercatorstraat
650,Mercatorstraat 36,2023-03-23,12:00:00,318,169,149,FMN 02 Mercatorstraat
650,Mercatorstraat 36,2023-03-23,13:00:00,306,154,152,FMN 02 Mercatorstraat
650,Mercatorstraat 36,2023-03-23,14:00:00,250,103,147,FMN 02 Mercatorstraat
650,Mercatorstraat 36,2023-03-23,15:00:00,369,121,248,FMN 02 Mercatorstraat
650,Mercatorstraat 36,2023-03-23,16:00:00,560,173,387,FMN 02 Mercatorstraat
650,Mercatorstraat 36,2023-03-23,17:00:00,643,248,395,FMN 02 Mercatorstraat
650,Mercatorstraat 36,2023-03-23,18:00:00,488,193,295,FMN 02 Mercatorstraat
650,Mercatorstraat 36,2023-03-23,19:00:00,306,162,144,FMN 02 Mercatorstraat
650,Mercatorstraat 36,2023-03-23,20:00:00,204,82,122,FMN 02 Mercatorstraat
650,Mercatorstraat 36,2023-03-23,21:00:00,205,82,123,FMN 02 Mercatorstraat
650,Mercatorstraat 36,2023-03-23,22:00:00,187,67,120,FMN 02 Mercatorstraat
650,Mercatorstraat 36,2023-03-23,23:00:00,157,73,84,FMN 02 Mercatorstraat
650,Mercatorstraat 36,2023-03-24,00:00:00,91,60,31,FMN 02 Mercatorstraat
650,Mercatorstraat 36,2023-03-24,01:00:00,61,31,30,FMN 02 Mercatorstraat
650,Mercatorstraat 36,2023-03-24,02:00:00,17,9,8,FMN 02 Mercatorstraat
650,Mercatorstraat 36,2023-03-24,03:00:00,20,2,18,FMN 02 Mercatorstraat
650,Mercatorstraat 36,2023-03-24,04:00:00,57,13,44,FMN 02 Mercatorstraat
650,Mercatorstraat 36,2023-03-24,05:00:00,50,23,27,FMN 02 Mercatorstraat
650,Mercatorstraat 36,2023-03-24,06:00:00,116,63,53,FMN 02 Mercatorstraat
650,Mercatorstraat 36,2023-03-24,07:00:00,372,237,135,FMN 02 Mercatorstraat
650,Mercatorstraat 36,2023-03-24,08:00:00,824,575,249,FMN 02 Mercatorstraat
650,Mercatorstraat 36,2023-03-24,09:00:00,400,297,103,FMN 02 Mercatorstraat
650,Mercatorstraat 36,2023-03-24,10:00:00,270,169,101,FMN 02 Mercatorstraat
650,Mercatorstraat 36,2023-03-24,11:00:00,235,122,113,FMN 02 Mercatorstraat
650,Mercatorstraat 36,2023-03-24,12:00:00,347,151,196,FMN 02 Mercatorstraat
650,Mercatorstraat 36,2023-03-24,13:00:00,286,118,168,FMN 02 Mercatorstraat
650,Mercatorstraat 36,2023-03-24,14:00:00,262,118,144,FMN 02 Mercatorstraat
650,Mercatorstraat 36,2023-03-24,15:00:00,425,132,293,FMN 02 Mercatorstraat
650,Mercatorstraat 36,2023-03-24,16:00:00,552,182,370,FMN 02 Mercatorstraat
650,Mercatorstraat 36,2023-03-24,17:00:00,581,205,376,FMN 02 Mercatorstraat
650,Mercatorstraat 36,2023-03-24,18:00:00,402,164,238,FMN 02 Mercatorstraat
650,Mercatorstraat 36,2023-03-24,19:00:00,302,176,126,FMN 02 Mercatorstraat
650,Mercatorstraat 36,2023-03-24,20:00:00,267,163,104,FMN 02 Mercatorstraat
650,Mercatorstraat 36,2023-03-24,21:00:00,165,77,88,FMN 02 Mercatorstraat
650,Mercatorstraat 36,2023-03-24,22:00:00,193,57,136,FMN 02 Mercatorstraat
650,Mercatorstraat 36,2023-03-24,23:00:00,152,48,104,FMN 02 Mercatorstraat
650,Mercatorstraat 36,2023-03-25,00:00:00,146,59,87,FMN 02 Mercatorstraat
650,Mercatorstraat 36,2023-03-25,01:00:00,125,67,58,FMN 02 Mercatorstraat
650,Mercatorstraat 36,2023-03-25,02:00:00,82,32,50,FMN 02 Mercatorstraat
650,Mercatorstraat 36,2023-03-25,03:00:00,78,19,59,FMN 02 Mercatorstraat
650,Mercatorstraat 36,2023-03-25,04:00:00,62,20,42,FMN 02 Mercatorstraat
650,Mercatorstraat 36,2023-03-25,05:00:00,53,14,39,FMN 02 Mercatorstraat
650,Mercatorstraat 36,2023-03-25,06:00:00,50,16,34,FMN 02 Mercatorstraat
650,Mercatorstraat 36,2023-03-25,07:00:00,51,22,29,FMN 02 Mercatorstraat
650,Mercatorstraat 36,2023-03-25,08:00:00,84,57,27,FMN 02 Mercatorstraat
650,Mercatorstraat 36,2023-03-25,09:00:00,148,115,33,FMN 02 Mercatorstraat
650,Mercatorstraat 36,2023-03-25,10:00:00,190,129,61,FMN 02 Mercatorstraat
650,Mercatorstraat 36,2023-03-25,11:00:00,218,132,86,FMN 02 Mercatorstraat
650,Mercatorstraat 36,2023-03-25,12:00:00,211,107,104,FMN 02 Mercatorstraat
650,Mercatorstraat 36,2023-03-25,13:00:00,221,117,104,FMN 02 Mercatorstraat
650,Mercatorstraat 36,2023-03-25,14:00:00,237,115,122,FMN 02 Mercatorstraat
650,Mercatorstraat 36,2023-03-25,15:00:00,232,129,103,FMN 02 Mercatorstraat
650,Mercatorstraat 36,2023-03-25,16:00:00,207,95,112,FMN 02 Mercatorstraat
650,Mercatorstraat 36,2023-03-25,17:00:00,218,93,125,FMN 02 Mercatorstraat
650,Mercatorstraat 36,2023-03-25,18:00:00,238,106,132,FMN 02 Mercatorstraat
650,Mercatorstraat 36,2023-03-25,19:00:00,225,130,95,FMN 02 Mercatorstraat
650,Mercatorstraat 36,2023-03-25,20:00:00,175,91,84,FMN 02 Mercatorstraat
650,Mercatorstraat 36,2023-03-25,21:00:00,146,84,62,FMN 02 Mercatorstraat
650,Mercatorstraat 36,2023-03-25,22:00:00,151,56,95,FMN 02 Mercatorstraat
650,Mercatorstraat 36,2023-03-25,23:00:00,163,54,109,FMN 02 Mercatorstraat
650,Mercatorstraat 36,2023-03-26,00:00:00,108,52,56,FMN 02 Mercatorstraat
650,Mercatorstraat 36,2023-03-26,01:00:00,113,63,50,FMN 02 Mercatorstraat
650,Mercatorstraat 36,2023-03-26,02:00:00,0,0,0,FMN 02 Mercatorstraat
650,Mercatorstraat 36,2023-03-26,03:00:00,80,33,47,FMN 02 Mercatorstraat
650,Mercatorstraat 36,2023-03-26,04:00:00,47,11,36,FMN 02 Mercatorstraat
650,Mercatorstraat 36,2023-03-26,05:00:00,55,15,40,FMN 02 Mercatorstraat
650,Mercatorstraat 36,2023-03-26,06:00:00,44,17,27,FMN 02 Mercatorstraat
650,Mercatorstraat 36,2023-03-26,07:00:00,54,27,27,FMN 02 Mercatorstraat
650,Mercatorstraat 36,2023-03-26,08:00:00,95,24,71,FMN 02 Mercatorstraat
650,Mercatorstraat 36,2023-03-26,09:00:00,144,53,91,FMN 02 Mercatorstraat
650,Mercatorstraat 36,2023-03-26,10:00:00,102,48,54,FMN 02 Mercatorstraat
650,Mercatorstraat 36,2023-03-26,11:00:00,94,47,47,FMN 02 Mercatorstraat
650,Mercatorstraat 36,2023-03-26,12:00:00,129,71,58,FMN 02 Mercatorstraat
650,Mercatorstraat 36,2023-03-26,13:00:00,198,113,85,FMN 02 Mercatorstraat
650,Mercatorstraat 36,2023-03-26,14:00:00,192,96,96,FMN 02 Mercatorstraat
650,Mercatorstraat 36,2023-03-26,15:00:00,180,79,101,FMN 02 Mercatorstraat
650,Mercatorstraat 36,2023-03-26,16:00:00,190,102,88,FMN 02 Mercatorstraat
650,Mercatorstraat 36,2023-03-26,17:00:00,188,81,107,FMN 02 Mercatorstraat
650,Mercatorstraat 36,2023-03-26,18:00:00,182,87,95,FMN 02 Mercatorstraat
650,Mercatorstraat 36,2023-03-26,19:00:00,172,87,85,FMN 02 Mercatorstraat
650,Mercatorstraat 36,2023-03-26,20:00:00,141,72,69,FMN 02 Mercatorstraat
650,Mercatorstraat 36,2023-03-26,21:00:00,121,48,73,FMN 02 Mercatorstraat
650,Mercatorstraat 36,2023-03-26,22:00:00,100,43,57,FMN 02 Mercatorstraat
650,Mercatorstraat 36,2023-03-26,23:00:00,65,24,41,FMN 02 Mercatorstraat
650,Mercatorstraat 36,2023-03-27,00:00:00,21,7,14,FMN 02 Mercatorstraat
650,Mercatorstraat 36,2023-03-27,01:00:00,15,5,10,FMN 02 Mercatorstraat
650,Mercatorstraat 36,2023-03-27,02:00:00,13,8,5,FMN 02 Mercatorstraat
650,Mercatorstraat 36,2023-03-27,03:00:00,12,6,6,FMN 02 Mercatorstraat
650,Mercatorstraat 36,2023-03-27,04:00:00,17,11,6,FMN 02 Mercatorstraat
650,Mercatorstraat 36,2023-03-27,05:00:00,43,25,18,FMN 02 Mercatorstraat
650,Mercatorstraat 36,2023-03-27,06:00:00,109,75,34,FMN 02 Mercatorstraat
650,Mercatorstraat 36,2023-03-27,07:00:00,369,225,144,FMN 02 Mercatorstraat
650,Mercatorstraat 36,2023-03-27,08:00:00,909,644,265,FMN 02 Mercatorstraat
650,Mercatorstraat 36,2023-03-27,09:00:00,403,311,92,FMN 02 Mercatorstraat
650,Mercatorstraat 36,2023-03-27,10:00:00,213,138,75,FMN 02 Mercatorstraat
650,Mercatorstraat 36,2023-03-27,11:00:00,174,101,73,FMN 02 Mercatorstraat
650,Mercatorstraat 36,2023-03-27,12:00:00,301,145,156,FMN 02 Mercatorstraat
650,Mercatorstraat 36,2023-03-27,13:00:00,285,135,150,FMN 02 Mercatorstraat
650,Mercatorstraat 36,2023-03-27,14:00:00,310,130,180,FMN 02 Mercatorstraat
650,Mercatorstraat 36,2023-03-27,15:00:00,373,125,248,FMN 02 Mercatorstraat
650,Mercatorstraat 36,2023-03-27,16:00:00,612,199,413,FMN 02 Mercatorstraat
650,Mercatorstraat 36,2023-03-27,17:00:00,703,238,465,FMN 02 Mercatorstraat
650,Mercatorstraat 36,2023-03-27,18:00:00,520,176,344,FMN 02 Mercatorstraat
650,Mercatorstraat 36,2023-03-27,19:00:00,283,143,140,FMN 02 Mercatorstraat
650,Mercatorstraat 36,2023-03-27,20:00:00,185,75,110,FMN 02 Mercatorstraat
650,Mercatorstraat 36,2023-03-27,21:00:00,194,72,122,FMN 02 Mercatorstraat
650,Mercatorstraat 36,2023-03-27,22:00:00,154,55,99,FMN 02 Mercatorstraat
650,Mercatorstraat 36,2023-03-27,23:00:00,77,23,54,FMN 02 Mercatorstraat
650,Mercatorstraat 36,2023-03-28,00:00:00,41,12,29,FMN 02 Mercatorstraat
650,Mercatorstraat 36,2023-03-28,01:00:00,15,8,7,FMN 02 Mercatorstraat
650,Mercatorstraat 36,2023-03-28,02:00:00,20,6,14,FMN 02 Mercatorstraat
650,Mercatorstraat 36,2023-03-28,03:00:00,18,8,10,FMN 02 Mercatorstraat
650,Mercatorstraat 36,2023-03-28,04:00:00,23,14,9,FMN 02 Mercatorstraat
650,Mercatorstraat 36,2023-03-28,05:00:00,44,26,18,FMN 02 Mercatorstraat
650,Mercatorstraat 36,2023-03-28,06:00:00,121,80,41,FMN 02 Mercatorstraat
650,Mercatorstraat 36,2023-03-28,07:00:00,404,245,159,FMN 02 Mercatorstraat
650,Mercatorstraat 36,2023-03-28,08:00:00,961,662,299,FMN 02 Mercatorstraat
650,Mercatorstraat 36,2023-03-28,09:00:00,497,373,124,FMN 02 Mercatorstraat
650,Mercatorstraat 36,2023-03-28,10:00:00,263,176,87,FMN 02 Mercatorstraat
650,Mercatorstraat 36,2023-03-28,11:00:00,266,161,105,FMN 02 Mercatorstraat
650,Mercatorstraat 36,2023-03-28,12:00:00,348,183,165,FMN 02 Mercatorstraat
650,Mercatorstraat 36,2023-03-28,13:00:00,378,179,199,FMN 02 Mercatorstraat
650,Mercatorstraat 36,2023-03-28,14:00:00,306,143,163,FMN 02 Mercatorstraat
650,Mercatorstraat 36,2023-03-28,15:00:00,423,142,281,FMN 02 Mercatorstraat
650,Mercatorstraat 36,2023-03-28,16:00:00,715,228,487,FMN 02 Mercatorstraat
650,Mercatorstraat 36,2023-03-28,17:00:00,762,247,515,FMN 02 Mercatorstraat
650,Mercatorstraat 36,2023-03-28,18:00:00,528,187,341,FMN 02 Mercatorstraat
650,Mercatorstraat 36,2023-03-28,19:00:00,310,143,167,FMN 02 Mercatorstraat
650,Mercatorstraat 36,2023-03-28,20:00:00,167,71,96,FMN 02 Mercatorstraat
650,Mercatorstraat 36,2023-03-28,21:00:00,216,92,124,FMN 02 Mercatorstraat
650,Mercatorstraat 36,2023-03-28,22:00:00,190,48,142,FMN 02 Mercatorstraat
650,Mercatorstraat 36,2023-03-28,23:00:00,110,38,72,FMN 02 Mercatorstraat
650,Mercatorstraat 36,2023-03-29,00:00:00,43,16,27,FMN 02 Mercatorstraat
650,Mercatorstraat 36,2023-03-29,01:00:00,20,5,15,FMN 02 Mercatorstraat
650,Mercatorstraat 36,2023-03-29,02:00:00,21,8,13,FMN 02 Mercatorstraat
650,Mercatorstraat 36,2023-03-29,03:00:00,16,6,10,FMN 02 Mercatorstraat
650,Mercatorstraat 36,2023-03-29,04:00:00,25,17,8,FMN 02 Mercatorstraat
650,Mercatorstraat 36,2023-03-29,05:00:00,48,32,16,FMN 02 Mercatorstraat
650,Mercatorstraat 36,2023-03-29,06:00:00,111,67,44,FMN 02 Mercatorstraat
650,Mercatorstraat 36,2023-03-29,07:00:00,419,268,151,FMN 02 Mercatorstraat
650,Mercatorstraat 36,2023-03-29,08:00:00,836,558,278,FMN 02 Mercatorstraat
650,Mercatorstraat 36,2023-03-29,09:00:00,409,293,116,FMN 02 Mercatorstraat
650,Mercatorstraat 36,2023-03-29,10:00:00,243,157,86,FMN 02 Mercatorstraat
650,Mercatorstraat 36,2023-03-29,11:00:00,267,132,135,FMN 02 Mercatorstraat
650,Mercatorstraat 36,2023-03-29,12:00:00,478,222,256,FMN 02 Mercatorstraat
650,Mercatorstraat 36,2023-03-29,13:00:00,483,241,242,FMN 02 Mercatorstraat
650,Mercatorstraat 36,2023-03-29,14:00:00,332,163,169,FMN 02 Mercatorstraat
650,Mercatorstraat 36,2023-03-29,15:00:00,420,159,261,FMN 02 Mercatorstraat
650,Mercatorstraat 36,2023-03-29,16:00:00,552,215,337,FMN 02 Mercatorstraat
650,Mercatorstraat 36,2023-03-29,17:00:00,725,250,475,FMN 02 Mercatorstraat
650,Mercatorstraat 36,2023-03-29,18:00:00,593,234,359,FMN 02 Mercatorstraat
650,Mercatorstraat 36,2023-03-29,19:00:00,356,202,154,FMN 02 Mercatorstraat
650,Mercatorstraat 36,2023-03-29,20:00:00,242,103,139,FMN 02 Mercatorstraat
650,Mercatorstraat 36,2023-03-29,21:00:00,214,98,116,FMN 02 Mercatorstraat
650,Mercatorstraat 36,2023-03-29,22:00:00,230,75,155,FMN 02 Mercatorstraat
650,Mercatorstraat 36,2023-03-29,23:00:00,117,36,81,FMN 02 Mercatorstraat
650,Mercatorstraat 36,2023-03-30,00:00:00,66,26,40,FMN 02 Mercatorstraat
650,Mercatorstraat 36,2023-03-30,01:00:00,42,11,31,FMN 02 Mercatorstraat
650,Mercatorstraat 36,2023-03-30,02:00:00,58,7,51,FMN 02 Mercatorstraat
650,Mercatorstraat 36,2023-03-30,03:00:00,38,7,31,FMN 02 Mercatorstraat
650,Mercatorstraat 36,2023-03-30,04:00:00,30,16,14,FMN 02 Mercatorstraat
650,Mercatorstraat 36,2023-03-30,05:00:00,45,28,17,FMN 02 Mercatorstraat
650,Mercatorstraat 36,2023-03-30,06:00:00,119,78,41,FMN 02 Mercatorstraat
650,Mercatorstraat 36,2023-03-30,07:00:00,369,231,138,FMN 02 Mercatorstraat
650,Mercatorstraat 36,2023-03-30,08:00:00,911,636,275,FMN 02 Mercatorstraat
650,Mercatorstraat 36,2023-03-30,09:00:00,436,337,99,FMN 02 Mercatorstraat
650,Mercatorstraat 36,2023-03-30,10:00:00,281,191,90,FMN 02 Mercatorstraat
650,Mercatorstraat 36,2023-03-30,11:00:00,235,126,109,FMN 02 Mercatorstraat
650,Mercatorstraat 36,2023-03-30,12:00:00,323,157,166,FMN 02 Mercatorstraat
650,Mercatorstraat 36,2023-03-30,13:00:00,381,165,216,FMN 02 Mercatorstraat
650,Mercatorstraat 36,2023-03-30,14:00:00,319,131,188,FMN 02 Mercatorstraat
650,Mercatorstraat 36,2023-03-30,15:00:00,450,147,303,FMN 02 Mercatorstraat
650,Mercatorstraat 36,2023-03-30,16:00:00,616,214,402,FMN 02 Mercatorstraat
650,Mercatorstraat 36,2023-03-30,17:00:00,702,236,466,FMN 02 Mercatorstraat
650,Mercatorstraat 36,2023-03-30,18:00:00,562,215,347,FMN 02 Mercatorstraat
650,Mercatorstraat 36,2023-03-30,19:00:00,441,235,206,FMN 02 Mercatorstraat
650,Mercatorstraat 36,2023-03-30,20:00:00,248,126,122,FMN 02 Mercatorstraat
650,Mercatorstraat 36,2023-03-30,21:00:00,261,95,166,FMN 02 Mercatorstraat
650,Mercatorstraat 36,2023-03-30,22:00:00,254,87,167,FMN 02 Mercatorstraat
650,Mercatorstraat 36,2023-03-30,23:00:00,151,46,105,FMN 02 Mercatorstraat
650,Mercatorstraat 36,2023-03-31,00:00:00,73,20,53,FMN 02 Mercatorstraat
650,Mercatorstraat 36,2023-03-31,01:00:00,70,35,35,FMN 02 Mercatorstraat
650,Mercatorstraat 36,2023-03-31,02:00:00,27,8,19,FMN 02 Mercatorstraat
650,Mercatorstraat 36,2023-03-31,03:00:00,22,3,19,FMN 02 Mercatorstraat
650,Mercatorstraat 36,2023-03-31,04:00:00,18,11,7,FMN 02 Mercatorstraat
650,Mercatorstraat 36,2023-03-31,05:00:00,40,25,15,FMN 02 Mercatorstraat
650,Mercatorstraat 36,2023-03-31,06:00:00,73,37,36,FMN 02 Mercatorstraat
650,Mercatorstraat 36,2023-03-31,07:00:00,220,136,84,FMN 02 Mercatorstraat
650,Mercatorstraat 36,2023-03-31,08:00:00,558,392,166,FMN 02 Mercatorstraat
650,Mercatorstraat 36,2023-03-31,09:00:00,328,252,76,FMN 02 Mercatorstraat
650,Mercatorstraat 36,2023-03-31,10:00:00,203,132,71,FMN 02 Mercatorstraat
650,Mercatorstraat 36,2023-03-31,11:00:00,188,108,80,FMN 02 Mercatorstraat
650,Mercatorstraat 36,2023-03-31,12:00:00,354,176,178,FMN 02 Mercatorstraat
650,Mercatorstraat 36,2023-03-31,13:00:00,269,123,146,FMN 02 Mercatorstraat
650,Mercatorstraat 36,2023-03-31,14:00:00,264,113,151,FMN 02 Mercatorstraat
650,Mercatorstraat 36,2023-03-31,15:00:00,333,101,232,FMN 02 Mercatorstraat
650,Mercatorstraat 36,2023-03-31,16:00:00,379,127,252,FMN 02 Mercatorstraat
650,Mercatorstraat 36,2023-03-31,17:00:00,423,147,276,FMN 02 Mercatorstraat
650,Mercatorstraat 36,2023-03-31,18:00:00,373,169,204,FMN 02 Mercatorstraat
650,Mercatorstraat 36,2023-03-31,19:00:00,346,204,142,FMN 02 Mercatorstraat
650,Mercatorstraat 36,2023-03-31,20:00:00,179,83,96,FMN 02 Mercatorstraat
650,Mercatorstraat 36,2023-03-31,21:00:00,142,65,77,FMN 02 Mercatorstraat
650,Mercatorstraat 36,2023-03-31,22:00:00,174,54,120,FMN 02 Mercatorstraat
650,Mercatorstraat 36,2023-03-31,23:00:00,128,53,75,FMN 02 Mercatorstraat
650,Mercatorstraat 36,2023-04-01,00:00:00,126,60,66,FMN 02 Mercatorstraat
650,Mercatorstraat 36,2023-04-01,01:00:00,101,47,54,FMN 02 Mercatorstraat
650,Mercatorstraat 36,2023-04-01,02:00:00,71,21,50,FMN 02 Mercatorstraat
650,Mercatorstraat 36,2023-04-01,03:00:00,45,9,36,FMN 02 Mercatorstraat
650,Mercatorstraat 36,2023-04-01,04:00:00,46,12,34,FMN 02 Mercatorstraat
650,Mercatorstraat 36,2023-04-01,05:00:00,40,13,27,FMN 02 Mercatorstraat
650,Mercatorstraat 36,2023-04-01,06:00:00,44,17,27,FMN 02 Mercatorstraat
650,Mercatorstraat 36,2023-04-01,07:00:00,39,22,17,FMN 02 Mercatorstraat
650,Mercatorstraat 36,2023-04-01,08:00:00,49,25,24,FMN 02 Mercatorstraat
650,Mercatorstraat 36,2023-04-01,09:00:00,88,62,26,FMN 02 Mercatorstraat
650,Mercatorstraat 36,2023-04-01,10:00:00,110,78,32,FMN 02 Mercatorstraat
650,Mercatorstraat 36,2023-04-01,11:00:00,137,84,53,FMN 02 Mercatorstraat
650,Mercatorstraat 36,2023-04-01,12:00:00,136,78,58,FMN 02 Mercatorstraat
650,Mercatorstraat 36,2023-04-01,13:00:00,201,101,100,FMN 02 Mercatorstraat
650,Mercatorstraat 36,2023-04-01,14:00:00,172,99,73,FMN 02 Mercatorstraat
650,Mercatorstraat 36,2023-04-01,15:00:00,163,88,75,FMN 02 Mercatorstraat
650,Mercatorstraat 36,2023-04-01,16:00:00,181,78,103,FMN 02 Mercatorstraat
650,Mercatorstraat 36,2023-04-01,17:00:00,182,69,113,FMN 02 Mercatorstraat
650,Mercatorstraat 36,2023-04-01,18:00:00,193,85,108,FMN 02 Mercatorstraat
650,Mercatorstraat 36,2023-04-01,19:00:00,176,84,92,FMN 02 Mercatorstraat
650,Mercatorstraat 36,2023-04-01,20:00:00,129,59,70,FMN 02 Mercatorstraat
650,Mercatorstraat 36,2023-04-01,21:00:00,127,64,63,FMN 02 Mercatorstraat
650,Mercatorstraat 36,2023-04-01,22:00:00,97,48,49,FMN 02 Mercatorstraat
650,Mercatorstraat 36,2023-04-01,23:00:00,89,36,53,FMN 02 Mercatorstraat
650,Mercatorstraat 36,2023-04-02,00:00:00,127,64,63,FMN 02 Mercatorstraat
650,Mercatorstraat 36,2023-04-02,01:00:00,95,42,53,FMN 02 Mercatorstraat
650,Mercatorstraat 36,2023-04-02,02:00:00,49,20,29,FMN 02 Mercatorstraat
650,Mercatorstraat 36,2023-04-02,03:00:00,49,16,33,FMN 02 Mercatorstraat
650,Mercatorstraat 36,2023-04-02,04:00:00,41,9,32,FMN 02 Mercatorstraat
650,Mercatorstraat 36,2023-04-02,05:00:00,38,18,20,FMN 02 Mercatorstraat
650,Mercatorstraat 36,2023-04-02,06:00:00,40,16,24,FMN 02 Mercatorstraat
650,Mercatorstraat 36,2023-04-02,07:00:00,40,19,21,FMN 02 Mercatorstraat
650,Mercatorstraat 36,2023-04-02,08:00:00,101,36,65,FMN 02 Mercatorstraat
650,Mercatorstraat 36,2023-04-02,09:00:00,197,102,95,FMN 02 Mercatorstraat
650,Mercatorstraat 36,2023-04-02,10:00:00,193,119,74,FMN 02 Mercatorstraat
650,Mercatorstraat 36,2023-04-02,11:00:00,207,121,86,FMN 02 Mercatorstraat
650,Mercatorstraat 36,2023-04-02,12:00:00,328,180,148,FMN 02 Mercatorstraat
650,Mercatorstraat 36,2023-04-02,13:00:00,238,126,112,FMN 02 Mercatorstraat
650,Mercatorstraat 36,2023-04-02,14:00:00,261,161,100,FMN 02 Mercatorstraat
650,Mercatorstraat 36,2023-04-02,15:00:00,255,140,115,FMN 02 Mercatorstraat
650,Mercatorstraat 36,2023-04-02,16:00:00,250,83,167,FMN 02 Mercatorstraat
650,Mercatorstraat 36,2023-04-02,17:00:00,256,106,150,FMN 02 Mercatorstraat
650,Mercatorstraat 36,2023-04-02,18:00:00,241,86,155,FMN 02 Mercatorstraat
650,Mercatorstraat 36,2023-04-02,19:00:00,217,102,115,FMN 02 Mercatorstraat
650,Mercatorstraat 36,2023-04-02,20:00:00,183,97,86,FMN 02 Mercatorstraat
650,Mercatorstraat 36,2023-04-02,21:00:00,165,73,92,FMN 02 Mercatorstraat
650,Mercatorstraat 36,2023-04-02,22:00:00,153,60,93,FMN 02 Mercatorstraat
650,Mercatorstraat 36,2023-04-02,23:00:00,84,25,59,FMN 02 Mercatorstraat
650,Mercatorstraat 36,2023-04-03,00:00:00,35,11,24,FMN 02 Mercatorstraat
650,Mercatorstraat 36,2023-04-03,01:00:00,16,5,11,FMN 02 Mercatorstraat
650,Mercatorstraat 36,2023-04-03,02:00:00,17,7,10,FMN 02 Mercatorstraat
650,Mercatorstraat 36,2023-04-03,03:00:00,11,5,6,FMN 02 Mercatorstraat
650,Mercatorstraat 36,2023-04-03,04:00:00,26,20,6,FMN 02 Mercatorstraat
650,Mercatorstraat 36,2023-04-03,05:00:00,39,19,20,FMN 02 Mercatorstraat
650,Mercatorstraat 36,2023-04-03,06:00:00,99,64,35,FMN 02 Mercatorstraat
650,Mercatorstraat 36,2023-04-03,07:00:00,288,186,102,FMN 02 Mercatorstraat
650,Mercatorstraat 36,2023-04-03,08:00:00,525,350,175,FMN 02 Mercatorstraat
650,Mercatorstraat 36,2023-04-03,09:00:00,378,232,146,FMN 02 Mercatorstraat
650,Mercatorstraat 36,2023-04-03,10:00:00,211,144,67,FMN 02 Mercatorstraat
650,Mercatorstraat 36,2023-04-03,11:00:00,221,131,90,FMN 02 Mercatorstraat
650,Mercatorstraat 36,2023-04-03,12:00:00,284,162,122,FMN 02 Mercatorstraat
650,Mercatorstraat 36,2023-04-03,13:00:00,274,153,121,FMN 02 Mercatorstraat
650,Mercatorstraat 36,2023-04-03,14:00:00,290,151,139,FMN 02 Mercatorstraat
650,Mercatorstraat 36,2023-04-03,15:00:00,337,159,178,FMN 02 Mercatorstraat
650,Mercatorstraat 36,2023-04-03,16:00:00,490,182,308,FMN 02 Mercatorstraat
650,Mercatorstraat 36,2023-04-03,17:00:00,599,191,408,FMN 02 Mercatorstraat
650,Mercatorstraat 36,2023-04-03,18:00:00,445,174,271,FMN 02 Mercatorstraat
650,Mercatorstraat 36,2023-04-03,19:00:00,265,122,143,FMN 02 Mercatorstraat
650,Mercatorstraat 36,2023-04-03,20:00:00,172,84,88,FMN 02 Mercatorstraat
650,Mercatorstraat 36,2023-04-03,21:00:00,163,82,81,FMN 02 Mercatorstraat
650,Mercatorstraat 36,2023-04-03,22:00:00,140,43,97,FMN 02 Mercatorstraat
650,Mercatorstraat 36,2023-04-03,23:00:00,77,23,54,FMN 02 Mercatorstraat
650,Mercatorstraat 36,2023-04-04,00:00:00,43,20,23,FMN 02 Mercatorstraat
650,Mercatorstraat 36,2023-04-04,01:00:00,23,8,15,FMN 02 Mercatorstraat
650,Mercatorstraat 36,2023-04-04,02:00:00,7,1,6,FMN 02 Mercatorstraat
650,Mercatorstraat 36,2023-04-04,03:00:00,10,3,7,FMN 02 Mercatorstraat
650,Mercatorstraat 36,2023-04-04,04:00:00,21,12,9,FMN 02 Mercatorstraat
650,Mercatorstraat 36,2023-04-04,05:00:00,42,24,18,FMN 02 Mercatorstraat
650,Mercatorstraat 36,2023-04-04,06:00:00,94,66,28,FMN 02 Mercatorstraat
650,Mercatorstraat 36,2023-04-04,07:00:00,277,184,93,FMN 02 Mercatorstraat
650,Mercatorstraat 36,2023-04-04,08:00:00,610,425,185,FMN 02 Mercatorstraat
650,Mercatorstraat 36,2023-04-04,09:00:00,359,271,88,FMN 02 Mercatorstraat
650,Mercatorstraat 36,2023-04-04,10:00:00,199,128,71,FMN 02 Mercatorstraat
650,Mercatorstraat 36,2023-04-04,11:00:00,238,140,98,FMN 02 Mercatorstraat
650,Mercatorstraat 36,2023-04-04,12:00:00,275,135,140,FMN 02 Mercatorstraat
650,Mercatorstraat 36,2023-04-04,13:00:00,283,155,128,FMN 02 Mercatorstraat
650,Mercatorstraat 36,2023-04-04,14:00:00,279,150,129,FMN 02 Mercatorstraat
650,Mercatorstraat 36,2023-04-04,15:00:00,348,145,203,FMN 02 Mercatorstraat
650,Mercatorstraat 36,2023-04-04,16:00:00,506,205,301,FMN 02 Mercatorstraat
650,Mercatorstraat 36,2023-04-04,17:00:00,675,206,469,FMN 02 Mercatorstraat
650,Mercatorstraat 36,2023-04-04,18:00:00,489,197,292,FMN 02 Mercatorstraat
650,Mercatorstraat 36,2023-04-04,19:00:00,288,120,168,FMN 02 Mercatorstraat
650,Mercatorstraat 36,2023-04-04,20:00:00,199,83,116,FMN 02 Mercatorstraat
650,Mercatorstraat 36,2023-04-04,21:00:00,192,89,103,FMN 02 Mercatorstraat
650,Mercatorstraat 36,2023-04-04,22:00:00,180,66,114,FMN 02 Mercatorstraat
650,Mercatorstraat 36,2023-04-04,23:00:00,119,44,75,FMN 02 Mercatorstraat
650,Mercatorstraat 36,2023-04-05,00:00:00,57,20,37,FMN 02 Mercatorstraat
650,Mercatorstraat 36,2023-04-05,01:00:00,26,9,17,FMN 02 Mercatorstraat
650,Mercatorstraat 36,2023-04-05,02:00:00,12,4,8,FMN 02 Mercatorstraat
650,Mercatorstraat 36,2023-04-05,03:00:00,14,7,7,FMN 02 Mercatorstraat
650,Mercatorstraat 36,2023-04-05,04:00:00,25,14,11,FMN 02 Mercatorstraat
650,Mercatorstraat 36,2023-04-05,05:00:00,46,24,22,FMN 02 Mercatorstraat
650,Mercatorstraat 36,2023-04-05,06:00:00,96,65,31,FMN 02 Mercatorstraat
650,Mercatorstraat 36,2023-04-05,07:00:00,244,157,87,FMN 02 Mercatorstraat
650,Mercatorstraat 36,2023-04-05,08:00:00,522,363,159,FMN 02 Mercatorstraat
650,Mercatorstraat 36,2023-04-05,09:00:00,322,246,76,FMN 02 Mercatorstraat
650,Mercatorstraat 36,2023-04-05,10:00:00,234,148,86,FMN 02 Mercatorstraat
650,Mercatorstraat 36,2023-04-05,11:00:00,249,141,108,FMN 02 Mercatorstraat
650,Mercatorstraat 36,2023-04-05,12:00:00,324,160,164,FMN 02 Mercatorstraat
650,Mercatorstraat 36,2023-04-05,13:00:00,332,199,133,FMN 02 Mercatorstraat
650,Mercatorstraat 36,2023-04-05,14:00:00,301,175,126,FMN 02 Mercatorstraat
650,Mercatorstraat 36,2023-04-05,15:00:00,342,136,206,FMN 02 Mercatorstraat
650,Mercatorstraat 36,2023-04-05,16:00:00,517,194,323,FMN 02 Mercatorstraat
650,Mercatorstraat 36,2023-04-05,17:00:00,629,211,418,FMN 02 Mercatorstraat
650,Mercatorstraat 36,2023-04-05,18:00:00,453,187,266,FMN 02 Mercatorstraat
650,Mercatorstraat 36,2023-04-05,19:00:00,267,124,143,FMN 02 Mercatorstraat
650,Mercatorstraat 36,2023-04-05,20:00:00,191,91,100,FMN 02 Mercatorstraat
650,Mercatorstraat 36,2023-04-05,21:00:00,167,76,91,FMN 02 Mercatorstraat
650,Mercatorstraat 36,2023-04-05,22:00:00,151,44,107,FMN 02 Mercatorstraat
650,Mercatorstraat 36,2023-04-05,23:00:00,86,25,61,FMN 02 Mercatorstraat
650,Mercatorstraat 36,2023-04-06,00:00:00,70,31,39,FMN 02 Mercatorstraat
650,Mercatorstraat 36,2023-04-06,01:00:00,23,16,7,FMN 02 Mercatorstraat
650,Mercatorstraat 36,2023-04-06,02:00:00,23,9,14,FMN 02 Mercatorstraat
650,Mercatorstraat 36,2023-04-06,03:00:00,13,2,11,FMN 02 Mercatorstraat
650,Mercatorstraat 36,2023-04-06,04:00:00,16,11,5,FMN 02 Mercatorstraat
650,Mercatorstraat 36,2023-04-06,05:00:00,39,22,17,FMN 02 Mercatorstraat
650,Mercatorstraat 36,2023-04-06,06:00:00,82,54,28,FMN 02 Mercatorstraat
650,Mercatorstraat 36,2023-04-06,07:00:00,214,143,71,FMN 02 Mercatorstraat
650,Mercatorstraat 36,2023-04-06,08:00:00,476,351,125,FMN 02 Mercatorstraat
650,Mercatorstraat 36,2023-04-06,09:00:00,254,186,68,FMN 02 Mercatorstraat
650,Mercatorstraat 36,2023-04-06,10:00:00,117,80,37,FMN 02 Mercatorstraat
650,Mercatorstraat 36,2023-04-06,11:00:00,116,59,57,FMN 02 Mercatorstraat
650,Mercatorstraat 36,2023-04-06,12:00:00,144,73,71,FMN 02 Mercatorstraat
650,Mercatorstraat 36,2023-04-06,13:00:00,144,86,58,FMN 02 Mercatorstraat
650,Mercatorstraat 36,2023-04-06,14:00:00,150,79,71,FMN 02 Mercatorstraat
650,Mercatorstraat 36,2023-04-06,15:00:00,182,86,96,FMN 02 Mercatorstraat
650,Mercatorstraat 36,2023-04-06,16:00:00,319,130,189,FMN 02 Mercatorstraat
650,Mercatorstraat 36,2023-04-06,17:00:00,460,140,320,FMN 02 Mercatorstraat
650,Mercatorstraat 36,2023-04-06,18:00:00,311,126,185,FMN 02 Mercatorstraat
650,Mercatorstraat 36,2023-04-06,19:00:00,206,93,113,FMN 02 Mercatorstraat
650,Mercatorstraat 36,2023-04-06,20:00:00,123,51,72,FMN 02 Mercatorstraat
650,Mercatorstraat 36,2023-04-06,21:00:00,114,53,61,FMN 02 Mercatorstraat
650,Mercatorstraat 36,2023-04-06,22:00:00,118,52,66,FMN 02 Mercatorstraat
650,Mercatorstraat 36,2023-04-06,23:00:00,105,37,68,FMN 02 Mercatorstraat
650,Mercatorstraat 36,2023-04-07,00:00:00,54,28,26,FMN 02 Mercatorstraat
650,Mercatorstraat 36,2023-04-07,01:00:00,31,9,22,FMN 02 Mercatorstraat
650,Mercatorstraat 36,2023-04-07,02:00:00,28,7,21,FMN 02 Mercatorstraat
650,Mercatorstraat 36,2023-04-07,03:00:00,22,8,14,FMN 02 Mercatorstraat
650,Mercatorstraat 36,2023-04-07,04:00:00,37,16,21,FMN 02 Mercatorstraat
650,Mercatorstraat 36,2023-04-07,05:00:00,34,13,21,FMN 02 Mercatorstraat
650,Mercatorstraat 36,2023-04-07,06:00:00,75,40,35,FMN 02 Mercatorstraat
650,Mercatorstraat 36,2023-04-07,07:00:00,182,111,71,FMN 02 Mercatorstraat
650,Mercatorstraat 36,2023-04-07,08:00:00,357,258,99,FMN 02 Mercatorstraat
650,Mercatorstraat 36,2023-04-07,09:00:00,256,186,70,FMN 02 Mercatorstraat
650,Mercatorstraat 36,2023-04-07,10:00:00,223,142,81,FMN 02 Mercatorstraat
650,Mercatorstraat 36,2023-04-07,11:00:00,185,111,74,FMN 02 Mercatorstraat
650,Mercatorstraat 36,2023-04-07,12:00:00,243,132,111,FMN 02 Mercatorstraat
650,Mercatorstraat 36,2023-04-07,13:00:00,242,136,106,FMN 02 Mercatorstraat
650,Mercatorstraat 36,2023-04-07,14:00:00,265,143,122,FMN 02 Mercatorstraat
650,Mercatorstraat 36,2023-04-07,15:00:00,314,145,169,FMN 02 Mercatorstraat
650,Mercatorstraat 36,2023-04-07,16:00:00,383,154,229,FMN 02 Mercatorstraat
650,Mercatorstraat 36,2023-04-07,17:00:00,422,159,263,FMN 02 Mercatorstraat
650,Mercatorstraat 36,2023-04-07,18:00:00,337,130,207,FMN 02 Mercatorstraat
650,Mercatorstraat 36,2023-04-07,19:00:00,300,162,138,FMN 02 Mercatorstraat
650,Mercatorstraat 36,2023-04-07,20:00:00,205,116,89,FMN 02 Mercatorstraat
650,Mercatorstraat 36,2023-04-07,21:00:00,177,87,90,FMN 02 Mercatorstraat
650,Mercatorstraat 36,2023-04-07,22:00:00,174,71,103,FMN 02 Mercatorstraat
650,Mercatorstraat 36,2023-04-07,23:00:00,143,49,94,FMN 02 Mercatorstraat
650,Mercatorstraat 36,2023-04-08,00:00:00,142,47,95,FMN 02 Mercatorstraat
650,Mercatorstraat 36,2023-04-08,01:00:00,118,40,78,FMN 02 Mercatorstraat
650,Mercatorstraat 36,2023-04-08,02:00:00,66,23,43,FMN 02 Mercatorstraat
650,Mercatorstraat 36,2023-04-08,03:00:00,61,21,40,FMN 02 Mercatorstraat
650,Mercatorstraat 36,2023-04-08,04:00:00,47,22,25,FMN 02 Mercatorstraat
650,Mercatorstraat 36,2023-04-08,05:00:00,45,13,32,FMN 02 Mercatorstraat
650,Mercatorstraat 36,2023-04-08,06:00:00,32,14,18,FMN 02 Mercatorstraat
650,Mercatorstraat 36,2023-04-08,07:00:00,41,20,21,FMN 02 Mercatorstraat
650,Mercatorstraat 36,2023-04-08,08:00:00,92,62,30,FMN 02 Mercatorstraat
650,Mercatorstraat 36,2023-04-08,09:00:00,158,108,50,FMN 02 Mercatorstraat
650,Mercatorstraat 36,2023-04-08,10:00:00,214,164,50,FMN 02 Mercatorstraat
650,Mercatorstraat 36,2023-04-08,11:00:00,254,162,92,FMN 02 Mercatorstraat
650,Mercatorstraat 36,2023-04-08,12:00:00,267,136,131,FMN 02 Mercatorstraat
650,Mercatorstraat 36,2023-04-08,13:00:00,328,189,139,FMN 02 Mercatorstraat
650,Mercatorstraat 36,2023-04-08,14:00:00,344,204,140,FMN 02 Mercatorstraat
650,Mercatorstraat 36,2023-04-08,15:00:00,337,191,146,FMN 02 Mercatorstraat
650,Mercatorstraat 36,2023-04-08,16:00:00,283,123,160,FMN 02 Mercatorstraat
650,Mercatorstraat 36,2023-04-08,17:00:00,309,105,204,FMN 02 Mercatorstraat
650,Mercatorstraat 36,2023-04-08,18:00:00,318,132,186,FMN 02 Mercatorstraat
650,Mercatorstraat 36,2023-04-08,19:00:00,245,110,135,FMN 02 Mercatorstraat
650,Mercatorstraat 36,2023-04-08,20:00:00,146,68,78,FMN 02 Mercatorstraat
650,Mercatorstraat 36,2023-04-08,21:00:00,186,82,104,FMN 02 Mercatorstraat
650,Mercatorstraat 36,2023-04-08,22:00:00,171,87,84,FMN 02 Mercatorstraat
650,Mercatorstraat 36,2023-04-08,23:00:00,139,67,72,FMN 02 Mercatorstraat
650,Mercatorstraat 36,2023-04-09,00:00:00,161,67,94,FMN 02 Mercatorstraat
650,Mercatorstraat 36,2023-04-09,01:00:00,103,52,51,FMN 02 Mercatorstraat
650,Mercatorstraat 36,2023-04-09,02:00:00,67,18,49,FMN 02 Mercatorstraat
650,Mercatorstraat 36,2023-04-09,03:00:00,44,15,29,FMN 02 Mercatorstraat
650,Mercatorstraat 36,2023-04-09,04:00:00,30,6,24,FMN 02 Mercatorstraat
650,Mercatorstraat 36,2023-04-09,05:00:00,36,13,23,FMN 02 Mercatorstraat
650,Mercatorstraat 36,2023-04-09,06:00:00,35,15,20,FMN 02 Mercatorstraat
650,Mercatorstraat 36,2023-04-09,07:00:00,43,20,23,FMN 02 Mercatorstraat
650,Mercatorstraat 36,2023-04-09,08:00:00,56,31,25,FMN 02 Mercatorstraat
650,Mercatorstraat 36,2023-04-09,09:00:00,158,100,58,FMN 02 Mercatorstraat
650,Mercatorstraat 36,2023-04-09,10:00:00,182,116,66,FMN 02 Mercatorstraat
650,Mercatorstraat 36,2023-04-09,11:00:00,262,154,108,FMN 02 Mercatorstraat
650,Mercatorstraat 36,2023-04-09,12:00:00,225,133,92,FMN 02 Mercatorstraat
650,Mercatorstraat 36,2023-04-09,13:00:00,269,144,125,FMN 02 Mercatorstraat
650,Mercatorstraat 36,2023-04-09,14:00:00,232,124,108,FMN 02 Mercatorstraat
650,Mercatorstraat 36,2023-04-09,15:00:00,220,116,104,FMN 02 Mercatorstraat
650,Mercatorstraat 36,2023-04-09,16:00:00,251,139,112,FMN 02 Mercatorstraat
650,Mercatorstraat 36,2023-04-09,17:00:00,242,101,141,FMN 02 Mercatorstraat
650,Mercatorstraat 36,2023-04-09,18:00:00,232,105,127,FMN 02 Mercatorstraat
650,Mercatorstraat 36,2023-04-09,19:00:00,217,101,116,FMN 02 Mercatorstraat
650,Mercatorstraat 36,2023-04-09,20:00:00,198,96,102,FMN 02 Mercatorstraat
650,Mercatorstraat 36,2023-04-09,21:00:00,161,69,92,FMN 02 Mercatorstraat
650,Mercatorstraat 36,2023-04-09,22:00:00,150,63,87,FMN 02 Mercatorstraat
650,Mercatorstraat 36,2023-04-09,23:00:00,108,37,71,FMN 02 Mercatorstraat
650,Mercatorstraat 36,2023-04-10,00:00:00,99,62,37,FMN 02 Mercatorstraat
650,Mercatorstraat 36,2023-04-10,01:00:00,57,26,31,FMN 02 Mercatorstraat
650,Mercatorstraat 36,2023-04-10,02:00:00,36,11,25,FMN 02 Mercatorstraat
650,Mercatorstraat 36,2023-04-10,03:00:00,28,5,23,FMN 02 Mercatorstraat
650,Mercatorstraat 36,2023-04-10,04:00:00,33,13,20,FMN 02 Mercatorstraat
650,Mercatorstraat 36,2023-04-10,05:00:00,37,18,19,FMN 02 Mercatorstraat
650,Mercatorstraat 36,2023-04-10,06:00:00,44,20,24,FMN 02 Mercatorstraat
650,Mercatorstraat 36,2023-04-10,07:00:00,24,16,8,FMN 02 Mercatorstraat
650,Mercatorstraat 36,2023-04-10,08:00:00,68,39,29,FMN 02 Mercatorstraat
650,Mercatorstraat 36,2023-04-10,09:00:00,130,98,32,FMN 02 Mercatorstraat
650,Mercatorstraat 36,2023-04-10,10:00:00,190,130,60,FMN 02 Mercatorstraat
650,Mercatorstraat 36,2023-04-10,11:00:00,200,115,85,FMN 02 Mercatorstraat
650,Mercatorstraat 36,2023-04-10,12:00:00,269,141,128,FMN 02 Mercatorstraat
650,Mercatorstraat 36,2023-04-10,13:00:00,234,121,113,FMN 02 Mercatorstraat
650,Mercatorstraat 36,2023-04-10,14:00:00,206,104,102,FMN 02 Mercatorstraat
650,Mercatorstraat 36,2023-04-10,15:00:00,157,66,91,FMN 02 Mercatorstraat
650,Mercatorstraat 36,2023-04-10,16:00:00,160,68,92,FMN 02 Mercatorstraat
650,Mercatorstraat 36,2023-04-10,17:00:00,138,48,90,FMN 02 Mercatorstraat
650,Mercatorstraat 36,2023-04-10,18:00:00,128,54,74,FMN 02 Mercatorstraat
650,Mercatorstraat 36,2023-04-10,19:00:00,154,81,73,FMN 02 Mercatorstraat
650,Mercatorstraat 36,2023-04-10,20:00:00,126,71,55,FMN 02 Mercatorstraat
650,Mercatorstraat 36,2023-04-10,21:00:00,103,48,55,FMN 02 Mercatorstraat
650,Mercatorstraat 36,2023-04-10,22:00:00,105,57,48,FMN 02 Mercatorstraat
650,Mercatorstraat 36,2023-04-10,23:00:00,70,27,43,FMN 02 Mercatorstraat
650,Mercatorstraat 36,2023-04-11,00:00:00,33,13,20,FMN 02 Mercatorstraat
650,Mercatorstraat 36,2023-04-11,01:00:00,23,6,17,FMN 02 Mercatorstraat
650,Mercatorstraat 36,2023-04-11,02:00:00,21,10,11,FMN 02 Mercatorstraat
650,Mercatorstraat 36,2023-04-11,03:00:00,16,8,8,FMN 02 Mercatorstraat
650,Mercatorstraat 36,2023-04-11,04:00:00,26,14,12,FMN 02 Mercatorstraat
650,Mercatorstraat 36,2023-04-11,05:00:00,41,24,17,FMN 02 Mercatorstraat
650,Mercatorstraat 36,2023-04-11,06:00:00,75,49,26,FMN 02 Mercatorstraat
650,Mercatorstraat 36,2023-04-11,07:00:00,232,151,81,FMN 02 Mercatorstraat
650,Mercatorstraat 36,2023-04-11,08:00:00,556,387,169,FMN 02 Mercatorstraat
650,Mercatorstraat 36,2023-04-11,09:00:00,355,273,82,FMN 02 Mercatorstraat
650,Mercatorstraat 36,2023-04-11,10:00:00,231,141,90,FMN 02 Mercatorstraat
650,Mercatorstraat 36,2023-04-11,11:00:00,280,170,110,FMN 02 Mercatorstraat
650,Mercatorstraat 36,2023-04-11,12:00:00,278,143,135,FMN 02 Mercatorstraat
650,Mercatorstraat 36,2023-04-11,13:00:00,251,134,117,FMN 02 Mercatorstraat
650,Mercatorstraat 36,2023-04-11,14:00:00,280,145,135,FMN 02 Mercatorstraat
650,Mercatorstraat 36,2023-04-11,15:00:00,294,144,150,FMN 02 Mercatorstraat
650,Mercatorstraat 36,2023-04-11,16:00:00,476,191,285,FMN 02 Mercatorstraat
650,Mercatorstraat 36,2023-04-11,17:00:00,605,214,391,FMN 02 Mercatorstraat
650,Mercatorstraat 36,2023-04-11,18:00:00,465,157,308,FMN 02 Mercatorstraat
650,Mercatorstraat 36,2023-04-11,19:00:00,257,124,133,FMN 02 Mercatorstraat
650,Mercatorstraat 36,2023-04-11,20:00:00,155,68,87,FMN 02 Mercatorstraat
650,Mercatorstraat 36,2023-04-11,21:00:00,147,59,88,FMN 02 Mercatorstraat
650,Mercatorstraat 36,2023-04-11,22:00:00,130,44,86,FMN 02 Mercatorstraat
650,Mercatorstraat 36,2023-04-11,23:00:00,76,27,49,FMN 02 Mercatorstraat
650,Mercatorstraat 36,2023-04-12,00:00:00,37,13,24,FMN 02 Mercatorstraat
650,Mercatorstraat 36,2023-04-12,01:00:00,24,7,17,FMN 02 Mercatorstraat
650,Mercatorstraat 36,2023-04-12,02:00:00,16,6,10,FMN 02 Mercatorstraat
650,Mercatorstraat 36,2023-04-12,03:00:00,17,6,11,FMN 02 Mercatorstraat
650,Mercatorstraat 36,2023-04-12,04:00:00,25,15,10,FMN 02 Mercatorstraat
650,Mercatorstraat 36,2023-04-12,05:00:00,39,25,14,FMN 02 Mercatorstraat
650,Mercatorstraat 36,2023-04-12,06:00:00,66,42,24,FMN 02 Mercatorstraat
650,Mercatorstraat 36,2023-04-12,07:00:00,173,116,57,FMN 02 Mercatorstraat
650,Mercatorstraat 36,2023-04-12,08:00:00,332,239,93,FMN 02 Mercatorstraat
650,Mercatorstraat 36,2023-04-12,09:00:00,272,209,63,FMN 02 Mercatorstraat
650,Mercatorstraat 36,2023-04-12,10:00:00,158,107,51,FMN 02 Mercatorstraat
650,Mercatorstraat 36,2023-04-12,11:00:00,156,102,54,FMN 02 Mercatorstraat
650,Mercatorstraat 36,2023-04-12,12:00:00,181,106,75,FMN 02 Mercatorstraat
650,Mercatorstraat 36,2023-04-12,13:00:00,165,89,76,FMN 02 Mercatorstraat
650,Mercatorstraat 36,2023-04-12,14:00:00,176,85,91,FMN 02 Mercatorstraat
650,Mercatorstraat 36,2023-04-12,15:00:00,220,92,128,FMN 02 Mercatorstraat
650,Mercatorstraat 36,2023-04-12,16:00:00,332,132,200,FMN 02 Mercatorstraat
650,Mercatorstraat 36,2023-04-12,17:00:00,433,157,276,FMN 02 Mercatorstraat
650,Mercatorstraat 36,2023-04-12,18:00:00,369,156,213,FMN 02 Mercatorstraat
650,Mercatorstraat 36,2023-04-12,19:00:00,265,122,143,FMN 02 Mercatorstraat
650,Mercatorstraat 36,2023-04-12,20:00:00,168,77,91,FMN 02 Mercatorstraat
650,Mercatorstraat 36,2023-04-12,21:00:00,138,55,83,FMN 02 Mercatorstraat
650,Mercatorstraat 36,2023-04-12,22:00:00,177,64,113,FMN 02 Mercatorstraat
650,Mercatorstraat 36,2023-04-12,23:00:00,94,23,71,FMN 02 Mercatorstraat
650,Mercatorstraat 36,2023-04-13,00:00:00,56,17,39,FMN 02 Mercatorstraat
650,Mercatorstraat 36,2023-04-13,01:00:00,24,9,15,FMN 02 Mercatorstraat
650,Mercatorstraat 36,2023-04-13,02:00:00,21,11,10,FMN 02 Mercatorstraat
650,Mercatorstraat 36,2023-04-13,03:00:00,12,5,7,FMN 02 Mercatorstraat
650,Mercatorstraat 36,2023-04-13,04:00:00,31,18,13,FMN 02 Mercatorstraat
650,Mercatorstraat 36,2023-04-13,05:00:00,49,30,19,FMN 02 Mercatorstraat
650,Mercatorstraat 36,2023-04-13,06:00:00,90,59,31,FMN 02 Mercatorstraat
650,Mercatorstraat 36,2023-04-13,07:00:00,218,154,64,FMN 02 Mercatorstraat
650,Mercatorstraat 36,2023-04-13,08:00:00,507,345,162,FMN 02 Mercatorstraat
650,Mercatorstraat 36,2023-04-13,09:00:00,299,220,79,FMN 02 Mercatorstraat
650,Mercatorstraat 36,2023-04-13,10:00:00,194,131,63,FMN 02 Mercatorstraat
650,Mercatorstraat 36,2023-04-13,11:00:00,181,110,71,FMN 02 Mercatorstraat
650,Mercatorstraat 36,2023-04-13,12:00:00,273,170,103,FMN 02 Mercatorstraat
650,Mercatorstraat 36,2023-04-13,13:00:00,217,119,98,FMN 02 Mercatorstraat
650,Mercatorstraat 36,2023-04-13,14:00:00,233,130,103,FMN 02 Mercatorstraat
650,Mercatorstraat 36,2023-04-13,15:00:00,327,143,184,FMN 02 Mercatorstraat
650,Mercatorstraat 36,2023-04-13,16:00:00,432,178,254,FMN 02 Mercatorstraat
650,Mercatorstraat 36,2023-04-13,17:00:00,533,179,354,FMN 02 Mercatorstraat
650,Mercatorstraat 36,2023-04-13,18:00:00,416,151,265,FMN 02 Mercatorstraat
650,Mercatorstraat 36,2023-04-13,19:00:00,307,130,177,FMN 02 Mercatorstraat
650,Mercatorstraat 36,2023-04-13,20:00:00,187,83,104,FMN 02 Mercatorstraat
650,Mercatorstraat 36,2023-04-13,21:00:00,163,74,89,FMN 02 Mercatorstraat
650,Mercatorstraat 36,2023-04-13,22:00:00,184,68,116,FMN 02 Mercatorstraat
650,Mercatorstraat 36,2023-04-13,23:00:00,128,48,80,FMN 02 Mercatorstraat
650,Mercatorstraat 36,2023-04-14,00:00:00,94,32,62,FMN 02 Mercatorstraat
650,Mercatorstraat 36,2023-04-14,01:00:00,35,16,19,FMN 02 Mercatorstraat
650,Mercatorstraat 36,2023-04-14,02:00:00,28,7,21,FMN 02 Mercatorstraat
650,Mercatorstraat 36,2023-04-14,03:00:00,18,6,12,FMN 02 Mercatorstraat
650,Mercatorstraat 36,2023-04-14,04:00:00,31,19,12,FMN 02 Mercatorstraat
650,Mercatorstraat 36,2023-04-14,05:00:00,52,32,20,FMN 02 Mercatorstraat
650,Mercatorstraat 36,2023-04-14,06:00:00,82,54,28,FMN 02 Mercatorstraat
650,Mercatorstraat 36,2023-04-14,07:00:00,210,141,69,FMN 02 Mercatorstraat
650,Mercatorstraat 36,2023-04-14,08:00:00,434,307,127,FMN 02 Mercatorstraat
650,Mercatorstraat 36,2023-04-14,09:00:00,317,238,79,FMN 02 Mercatorstraat
650,Mercatorstraat 36,2023-04-14,10:00:00,267,174,93,FMN 02 Mercatorstraat
650,Mercatorstraat 36,2023-04-14,11:00:00,289,175,114,FMN 02 Mercatorstraat
650,Mercatorstraat 36,2023-04-14,12:00:00,301,160,141,FMN 02 Mercatorstraat
650,Mercatorstraat 36,2023-04-14,13:00:00,310,145,165,FMN 02 Mercatorstraat
650,Mercatorstraat 36,2023-04-14,14:00:00,328,173,155,FMN 02 Mercatorstraat
650,Mercatorstraat 36,2023-04-14,15:00:00,434,197,237,FMN 02 Mercatorstraat
650,Mercatorstraat 36,2023-04-14,16:00:00,504,189,315,FMN 02 Mercatorstraat
650,Mercatorstraat 36,2023-04-14,17:00:00,528,187,341,FMN 02 Mercatorstraat
650,Mercatorstraat 36,2023-04-14,18:00:00,391,176,215,FMN 02 Mercatorstraat
650,Mercatorstraat 36,2023-04-14,19:00:00,349,170,179,FMN 02 Mercatorstraat
650,Mercatorstraat 36,2023-04-14,20:00:00,192,97,95,FMN 02 Mercatorstraat
650,Mercatorstraat 36,2023-04-14,21:00:00,203,91,112,FMN 02 Mercatorstraat
650,Mercatorstraat 36,2023-04-14,22:00:00,164,75,89,FMN 02 Mercatorstraat
650,Mercatorstraat 36,2023-04-14,23:00:00,166,62,104,FMN 02 Mercatorstraat
650,Mercatorstraat 36,2023-04-15,00:00:00,142,62,80,FMN 02 Mercatorstraat
650,Mercatorstraat 36,2023-04-15,01:00:00,90,30,60,FMN 02 Mercatorstraat
650,Mercatorstraat 36,2023-04-15,02:00:00,65,29,36,FMN 02 Mercatorstraat
650,Mercatorstraat 36,2023-04-15,03:00:00,44,10,34,FMN 02 Mercatorstraat
650,Mercatorstraat 36,2023-04-15,04:00:00,58,11,47,FMN 02 Mercatorstraat
650,Mercatorstraat 36,2023-04-15,05:00:00,44,18,26,FMN 02 Mercatorstraat
650,Mercatorstraat 36,2023-04-15,06:00:00,37,12,25,FMN 02 Mercatorstraat
650,Mercatorstraat 36,2023-04-15,07:00:00,56,36,20,FMN 02 Mercatorstraat
650,Mercatorstraat 36,2023-04-15,08:00:00,65,41,24,FMN 02 Mercatorstraat
650,Mercatorstraat 36,2023-04-15,09:00:00,190,148,42,FMN 02 Mercatorstraat
650,Mercatorstraat 36,2023-04-15,10:00:00,257,182,75,FMN 02 Mercatorstraat
650,Mercatorstraat 36,2023-04-15,11:00:00,282,185,97,FMN 02 Mercatorstraat
650,Mercatorstraat 36,2023-04-15,12:00:00,325,187,138,FMN 02 Mercatorstraat
650,Mercatorstraat 36,2023-04-15,13:00:00,389,222,167,FMN 02 Mercatorstraat
650,Mercatorstraat 36,2023-04-15,14:00:00,417,254,163,FMN 02 Mercatorstraat
650,Mercatorstraat 36,2023-04-15,15:00:00,404,206,198,FMN 02 Mercatorstraat
650,Mercatorstraat 36,2023-04-15,16:00:00,425,193,232,FMN 02 Mercatorstraat
650,Mercatorstraat 36,2023-04-15,17:00:00,353,163,190,FMN 02 Mercatorstraat
650,Mercatorstraat 36,2023-04-15,18:00:00,339,131,208,FMN 02 Mercatorstraat
650,Mercatorstraat 36,2023-04-15,19:00:00,251,117,134,FMN 02 Mercatorstraat
650,Mercatorstraat 36,2023-04-15,20:00:00,202,94,108,FMN 02 Mercatorstraat
650,Mercatorstraat 36,2023-04-15,21:00:00,209,93,116,FMN 02 Mercatorstraat
650,Mercatorstraat 36,2023-04-15,22:00:00,199,85,114,FMN 02 Mercatorstraat
650,Mercatorstraat 36,2023-04-15,23:00:00,146,59,87,FMN 02 Mercatorstraat
650,Mercatorstraat 36,2023-04-16,00:00:00,136,48,88,FMN 02 Mercatorstraat
650,Mercatorstraat 36,2023-04-16,01:00:00,120,46,74,FMN 02 Mercatorstraat
650,Mercatorstraat 36,2023-04-16,02:00:00,77,33,44,FMN 02 Mercatorstraat
650,Mercatorstraat 36,2023-04-16,03:00:00,60,10,50,FMN 02 Mercatorstraat
650,Mercatorstraat 36,2023-04-16,04:00:00,60,6,54,FMN 02 Mercatorstraat
650,Mercatorstraat 36,2023-04-16,05:00:00,34,17,17,FMN 02 Mercatorstraat
650,Mercatorstraat 36,2023-04-16,06:00:00,37,16,21,FMN 02 Mercatorstraat
650,Mercatorstraat 36,2023-04-16,07:00:00,41,22,19,FMN 02 Mercatorstraat
650,Mercatorstraat 36,2023-04-16,08:00:00,57,34,23,FMN 02 Mercatorstraat
650,Mercatorstraat 36,2023-04-16,09:00:00,98,58,40,FMN 02 Mercatorstraat
650,Mercatorstraat 36,2023-04-16,10:00:00,172,111,61,FMN 02 Mercatorstraat
650,Mercatorstraat 36,2023-04-16,11:00:00,180,94,86,FMN 02 Mercatorstraat
650,Mercatorstraat 36,2023-04-16,12:00:00,190,102,88,FMN 02 Mercatorstraat
650,Mercatorstraat 36,2023-04-16,13:00:00,218,119,99,FMN 02 Mercatorstraat
650,Mercatorstraat 36,2023-04-16,14:00:00,229,138,91,FMN 02 Mercatorstraat
650,Mercatorstraat 36,2023-04-16,15:00:00,222,117,105,FMN 02 Mercatorstraat
650,Mercatorstraat 36,2023-04-16,16:00:00,249,112,137,FMN 02 Mercatorstraat
650,Mercatorstraat 36,2023-04-16,17:00:00,234,104,130,FMN 02 Mercatorstraat
650,Mercatorstraat 36,2023-04-16,18:00:00,227,98,129,FMN 02 Mercatorstraat
650,Mercatorstraat 36,2023-04-16,19:00:00,204,94,110,FMN 02 Mercatorstraat
650,Mercatorstraat 36,2023-04-16,20:00:00,157,64,93,FMN 02 Mercatorstraat
650,Mercatorstraat 36,2023-04-16,21:00:00,140,60,80,FMN 02 Mercatorstraat
650,Mercatorstraat 36,2023-04-16,22:00:00,139,53,86,FMN 02 Mercatorstraat
650,Mercatorstraat 36,2023-04-16,23:00:00,55,18,37,FMN 02 Mercatorstraat
650,Mercatorstraat 36,2023-04-17,00:00:00,32,8,24,FMN 02 Mercatorstraat
650,Mercatorstraat 36,2023-04-17,01:00:00,20,7,13,FMN 02 Mercatorstraat
650,Mercatorstraat 36,2023-04-17,02:00:00,11,0,11,FMN 02 Mercatorstraat
650,Mercatorstraat 36,2023-04-17,03:00:00,5,4,1,FMN 02 Mercatorstraat
650,Mercatorstraat 36,2023-04-17,04:00:00,24,16,8,FMN 02 Mercatorstraat
650,Mercatorstraat 36,2023-04-17,05:00:00,47,29,18,FMN 02 Mercatorstraat
650,Mercatorstraat 36,2023-04-17,06:00:00,128,81,47,FMN 02 Mercatorstraat
650,Mercatorstraat 36,2023-04-17,07:00:00,459,308,151,FMN 02 Mercatorstraat
650,Mercatorstraat 36,2023-04-17,08:00:00,1050,729,321,FMN 02 Mercatorstraat
650,Mercatorstraat 36,2023-04-17,09:00:00,427,314,113,FMN 02 Mercatorstraat
650,Mercatorstraat 36,2023-04-17,10:00:00,240,152,88,FMN 02 Mercatorstraat
650,Mercatorstraat 36,2023-04-17,11:00:00,211,127,84,FMN 02 Mercatorstraat
650,Mercatorstraat 36,2023-04-17,12:00:00,311,146,165,FMN 02 Mercatorstraat
650,Mercatorstraat 36,2023-04-17,13:00:00,371,173,198,FMN 02 Mercatorstraat
650,Mercatorstraat 36,2023-04-17,14:00:00,295,135,160,FMN 02 Mercatorstraat
650,Mercatorstraat 36,2023-04-17,15:00:00,470,157,313,FMN 02 Mercatorstraat
650,Mercatorstraat 36,2023-04-17,16:00:00,702,217,485,FMN 02 Mercatorstraat
650,Mercatorstraat 36,2023-04-17,17:00:00,812,231,581,FMN 02 Mercatorstraat
650,Mercatorstraat 36,2023-04-17,18:00:00,534,224,310,FMN 02 Mercatorstraat
650,Mercatorstraat 36,2023-04-17,19:00:00,299,133,166,FMN 02 Mercatorstraat
650,Mercatorstraat 36,2023-04-17,20:00:00,217,103,114,FMN 02 Mercatorstraat
650,Mercatorstraat 36,2023-04-17,21:00:00,223,96,127,FMN 02 Mercatorstraat
650,Mercatorstraat 36,2023-04-17,22:00:00,197,79,118,FMN 02 Mercatorstraat
650,Mercatorstraat 36,2023-04-17,23:00:00,101,35,66,FMN 02 Mercatorstraat
650,Mercatorstraat 36,2023-04-18,00:00:00,48,12,36,FMN 02 Mercatorstraat
650,Mercatorstraat 36,2023-04-18,01:00:00,13,3,10,FMN 02 Mercatorstraat
650,Mercatorstraat 36,2023-04-18,02:00:00,19,6,13,FMN 02 Mercatorstraat
650,Mercatorstraat 36,2023-04-18,03:00:00,22,7,15,FMN 02 Mercatorstraat
650,Mercatorstraat 36,2023-04-18,04:00:00,26,15,11,FMN 02 Mercatorstraat
650,Mercatorstraat 36,2023-04-18,05:00:00,50,30,20,FMN 02 Mercatorstraat
650,Mercatorstraat 36,2023-04-18,06:00:00,143,79,64,FMN 02 Mercatorstraat
650,Mercatorstraat 36,2023-04-18,07:00:00,495,316,179,FMN 02 Mercatorstraat
650,Mercatorstraat 36,2023-04-18,08:00:00,1121,787,334,FMN 02 Mercatorstraat
650,Mercatorstraat 36,2023-04-18,09:00:00,486,376,110,FMN 02 Mercatorstraat
650,Mercatorstraat 36,2023-04-18,10:00:00,243,161,82,FMN 02 Mercatorstraat
650,Mercatorstraat 36,2023-04-18,11:00:00,238,129,109,FMN 02 Mercatorstraat
650,Mercatorstraat 36,2023-04-18,12:00:00,340,186,154,FMN 02 Mercatorstraat
650,Mercatorstraat 36,2023-04-18,13:00:00,364,153,211,FMN 02 Mercatorstraat
650,Mercatorstraat 36,2023-04-18,14:00:00,301,127,174,FMN 02 Mercatorstraat
650,Mercatorstraat 36,2023-04-18,15:00:00,509,183,326,FMN 02 Mercatorstraat
650,Mercatorstraat 36,2023-04-18,16:00:00,755,251,504,FMN 02 Mercatorstraat
650,Mercatorstraat 36,2023-04-18,17:00:00,857,292,565,FMN 02 Mercatorstraat
650,Mercatorstraat 36,2023-04-18,18:00:00,624,232,392,FMN 02 Mercatorstraat
650,Mercatorstraat 36,2023-04-18,19:00:00,381,184,197,FMN 02 Mercatorstraat
650,Mercatorstraat 36,2023-04-18,20:00:00,253,104,149,FMN 02 Mercatorstraat
650,Mercatorstraat 36,2023-04-18,21:00:00,246,97,149,FMN 02 Mercatorstraat
650,Mercatorstraat 36,2023-04-18,22:00:00,212,81,131,FMN 02 Mercatorstraat
650,Mercatorstraat 36,2023-04-18,23:00:00,100,35,65,FMN 02 Mercatorstraat
650,Mercatorstraat 36,2023-04-19,00:00:00,38,14,24,FMN 02 Mercatorstraat
650,Mercatorstraat 36,2023-04-19,01:00:00,26,6,20,FMN 02 Mercatorstraat
650,Mercatorstraat 36,2023-04-19,02:00:00,14,3,11,FMN 02 Mercatorstraat
650,Mercatorstraat 36,2023-04-19,03:00:00,17,6,11,FMN 02 Mercatorstraat
650,Mercatorstraat 36,2023-04-19,04:00:00,30,19,11,FMN 02 Mercatorstraat
650,Mercatorstraat 36,2023-04-19,05:00:00,51,32,19,FMN 02 Mercatorstraat
650,Mercatorstraat 36,2023-04-19,06:00:00,139,83,56,FMN 02 Mercatorstraat
650,Mercatorstraat 36,2023-04-19,07:00:00,458,283,175,FMN 02 Mercatorstraat
650,Mercatorstraat 36,2023-04-19,08:00:00,981,680,301,FMN 02 Mercatorstraat
650,Mercatorstraat 36,2023-04-19,09:00:00,433,323,110,FMN 02 Mercatorstraat
650,Mercatorstraat 36,2023-04-19,10:00:00,259,158,101,FMN 02 Mercatorstraat
650,Mercatorstraat 36,2023-04-19,11:00:00,292,137,155,FMN 02 Mercatorstraat
650,Mercatorstraat 36,2023-04-19,12:00:00,562,241,321,FMN 02 Mercatorstraat
650,Mercatorstraat 36,2023-04-19,13:00:00,445,211,234,FMN 02 Mercatorstraat
650,Mercatorstraat 36,2023-04-19,14:00:00,396,187,209,FMN 02 Mercatorstraat
650,Mercatorstraat 36,2023-04-19,15:00:00,406,175,231,FMN 02 Mercatorstraat
650,Mercatorstraat 36,2023-04-19,16:00:00,583,226,357,FMN 02 Mercatorstraat
650,Mercatorstraat 36,2023-04-19,17:00:00,784,269,515,FMN 02 Mercatorstraat
650,Mercatorstraat 36,2023-04-19,18:00:00,639,246,393,FMN 02 Mercatorstraat
650,Mercatorstraat 36,2023-04-19,19:00:00,369,180,189,FMN 02 Mercatorstraat
650,Mercatorstraat 36,2023-04-19,20:00:00,292,133,159,FMN 02 Mercatorstraat
650,Mercatorstraat 36,2023-04-19,21:00:00,253,114,139,FMN 02 Mercatorstraat
650,Mercatorstraat 36,2023-04-19,22:00:00,243,98,145,FMN 02 Mercatorstraat
650,Mercatorstraat 36,2023-04-19,23:00:00,132,40,92,FMN 02 Mercatorstraat
650,Mercatorstraat 36,2023-04-20,00:00:00,65,24,41,FMN 02 Mercatorstraat
650,Mercatorstraat 36,2023-04-20,01:00:00,35,12,23,FMN 02 Mercatorstraat
650,Mercatorstraat 36,2023-04-20,02:00:00,29,10,19,FMN 02 Mercatorstraat
650,Mercatorstraat 36,2023-04-20,03:00:00,17,4,13,FMN 02 Mercatorstraat
650,Mercatorstraat 36,2023-04-20,04:00:00,22,14,8,FMN 02 Mercatorstraat
650,Mercatorstraat 36,2023-04-20,05:00:00,50,33,17,FMN 02 Mercatorstraat
650,Mercatorstraat 36,2023-04-20,06:00:00,134,75,59,FMN 02 Mercatorstraat
650,Mercatorstraat 36,2023-04-20,07:00:00,402,246,156,FMN 02 Mercatorstraat
650,Mercatorstraat 36,2023-04-20,08:00:00,1011,692,319,FMN 02 Mercatorstraat
650,Mercatorstraat 36,2023-04-20,09:00:00,461,346,115,FMN 02 Mercatorstraat
650,Mercatorstraat 36,2023-04-20,10:00:00,251,162,89,FMN 02 Mercatorstraat
650,Mercatorstraat 36,2023-04-20,11:00:00,187,105,82,FMN 02 Mercatorstraat
650,Mercatorstraat 36,2023-04-20,12:00:00,369,200,169,FMN 02 Mercatorstraat
650,Mercatorstraat 36,2023-04-20,13:00:00,329,157,172,FMN 02 Mercatorstraat
650,Mercatorstraat 36,2023-04-20,14:00:00,305,135,170,FMN 02 Mercatorstraat
650,Mercatorstraat 36,2023-04-20,15:00:00,398,131,267,FMN 02 Mercatorstraat
650,Mercatorstraat 36,2023-04-20,16:00:00,626,202,424,FMN 02 Mercatorstraat
650,Mercatorstraat 36,2023-04-20,17:00:00,699,241,458,FMN 02 Mercatorstraat
650,Mercatorstraat 36,2023-04-20,18:00:00,549,215,334,FMN 02 Mercatorstraat
650,Mercatorstraat 36,2023-04-20,19:00:00,349,161,188,FMN 02 Mercatorstraat
650,Mercatorstraat 36,2023-04-20,20:00:00,243,115,128,FMN 02 Mercatorstraat
650,Mercatorstraat 36,2023-04-20,21:00:00,227,99,128,FMN 02 Mercatorstraat
650,Mercatorstraat 36,2023-04-20,22:00:00,227,87,140,FMN 02 Mercatorstraat
650,Mercatorstraat 36,2023-04-20,23:00:00,135,54,81,FMN 02 Mercatorstraat
650,Mercatorstraat 36,2023-04-21,00:00:00,83,37,46,FMN 02 Mercatorstraat
650,Mercatorstraat 36,2023-04-21,01:00:00,44,15,29,FMN 02 Mercatorstraat
650,Mercatorstraat 36,2023-04-21,02:00:00,34,9,25,FMN 02 Mercatorstraat
650,Mercatorstraat 36,2023-04-21,03:00:00,32,7,25,FMN 02 Mercatorstraat
650,Mercatorstraat 36,2023-04-21,04:00:00,38,17,21,FMN 02 Mercatorstraat
650,Mercatorstraat 36,2023-04-21,05:00:00,52,28,24,FMN 02 Mercatorstraat
650,Mercatorstraat 36,2023-04-21,06:00:00,123,69,54,FMN 02 Mercatorstraat
650,Mercatorstraat 36,2023-04-21,07:00:00,341,222,119,FMN 02 Mercatorstraat
650,Mercatorstraat 36,2023-04-21,08:00:00,901,609,292,FMN 02 Mercatorstraat
650,Mercatorstraat 36,2023-04-21,09:00:00,436,323,113,FMN 02 Mercatorstraat
650,Mercatorstraat 36,2023-04-21,10:00:00,269,181,88,FMN 02 Mercatorstraat
650,Mercatorstraat 36,2023-04-21,11:00:00,266,151,115,FMN 02 Mercatorstraat
650,Mercatorstraat 36,2023-04-21,12:00:00,443,224,219,FMN 02 Mercatorstraat
650,Mercatorstraat 36,2023-04-21,13:00:00,384,188,196,FMN 02 Mercatorstraat
650,Mercatorstraat 36,2023-04-21,14:00:00,398,182,216,FMN 02 Mercatorstraat
650,Mercatorstraat 36,2023-04-21,15:00:00,473,167,306,FMN 02 Mercatorstraat
650,Mercatorstraat 36,2023-04-21,16:00:00,629,216,413,FMN 02 Mercatorstraat
650,Mercatorstraat 36,2023-04-21,17:00:00,634,194,440,FMN 02 Mercatorstraat
650,Mercatorstraat 36,2023-04-21,18:00:00,502,222,280,FMN 02 Mercatorstraat
650,Mercatorstraat 36,2023-04-21,19:00:00,372,199,173,FMN 02 Mercatorstraat
650,Mercatorstraat 36,2023-04-21,20:00:00,208,110,98,FMN 02 Mercatorstraat
650,Mercatorstraat 36,2023-04-21,21:00:00,182,85,97,FMN 02 Mercatorstraat
650,Mercatorstraat 36,2023-04-21,22:00:00,198,85,113,FMN 02 Mercatorstraat
650,Mercatorstraat 36,2023-04-21,23:00:00,176,65,111,FMN 02 Mercatorstraat
650,Mercatorstraat 36,2023-04-22,00:00:00,148,67,81,FMN 02 Mercatorstraat
650,Mercatorstraat 36,2023-04-22,01:00:00,122,57,65,FMN 02 Mercatorstraat
650,Mercatorstraat 36,2023-04-22,02:00:00,90,33,57,FMN 02 Mercatorstraat
650,Mercatorstraat 36,2023-04-22,03:00:00,74,19,55,FMN 02 Mercatorstraat
650,Mercatorstraat 36,2023-04-22,04:00:00,60,16,44,FMN 02 Mercatorstraat
650,Mercatorstraat 36,2023-04-22,05:00:00,65,21,44,FMN 02 Mercatorstraat
650,Mercatorstraat 36,2023-04-22,06:00:00,51,15,36,FMN 02 Mercatorstraat
650,Mercatorstraat 36,2023-04-22,07:00:00,49,26,23,FMN 02 Mercatorstraat
650,Mercatorstraat 36,2023-04-22,08:00:00,119,78,41,FMN 02 Mercatorstraat
650,Mercatorstraat 36,2023-04-22,09:00:00,267,207,60,FMN 02 Mercatorstraat
650,Mercatorstraat 36,2023-04-22,10:00:00,258,185,73,FMN 02 Mercatorstraat
650,Mercatorstraat 36,2023-04-22,11:00:00,270,161,109,FMN 02 Mercatorstraat
650,Mercatorstraat 36,2023-04-22,12:00:00,216,84,132,FMN 02 Mercatorstraat
650,Mercatorstraat 36,2023-04-22,13:00:00,211,104,107,FMN 02 Mercatorstraat
650,Mercatorstraat 36,2023-04-22,14:00:00,232,122,110,FMN 02 Mercatorstraat
650,Mercatorstraat 36,2023-04-22,15:00:00,220,104,116,FMN 02 Mercatorstraat
650,Mercatorstraat 36,2023-04-22,16:00:00,228,93,135,FMN 02 Mercatorstraat
650,Mercatorstraat 36,2023-04-22,17:00:00,238,110,128,FMN 02 Mercatorstraat
650,Mercatorstraat 36,2023-04-22,18:00:00,250,113,137,FMN 02 Mercatorstraat
650,Mercatorstraat 36,2023-04-22,19:00:00,223,111,112,FMN 02 Mercatorstraat
650,Mercatorstraat 36,2023-04-22,20:00:00,145,78,67,FMN 02 Mercatorstraat
650,Mercatorstraat 36,2023-04-22,21:00:00,184,95,89,FMN 02 Mercatorstraat
650,Mercatorstraat 36,2023-04-22,22:00:00,165,74,91,FMN 02 Mercatorstraat
650,Mercatorstraat 36,2023-04-22,23:00:00,144,49,95,FMN 02 Mercatorstraat
650,Mercatorstraat 36,2023-04-23,00:00:00,129,58,71,FMN 02 Mercatorstraat
650,Mercatorstraat 36,2023-04-23,01:00:00,116,44,72,FMN 02 Mercatorstraat
650,Mercatorstraat 36,2023-04-23,02:00:00,73,25,48,FMN 02 Mercatorstraat
650,Mercatorstraat 36,2023-04-23,03:00:00,67,20,47,FMN 02 Mercatorstraat
650,Mercatorstraat 36,2023-04-23,04:00:00,51,14,37,FMN 02 Mercatorstraat
650,Mercatorstraat 36,2023-04-23,05:00:00,35,15,20,FMN 02 Mercatorstraat
650,Mercatorstraat 36,2023-04-23,06:00:00,43,13,30,FMN 02 Mercatorstraat
650,Mercatorstraat 36,2023-04-23,07:00:00,54,24,30,FMN 02 Mercatorstraat
650,Mercatorstraat 36,2023-04-23,08:00:00,104,48,56,FMN 02 Mercatorstraat
650,Mercatorstraat 36,2023-04-23,09:00:00,318,198,120,FMN 02 Mercatorstraat
650,Mercatorstraat 36,2023-04-23,10:00:00,277,191,86,FMN 02 Mercatorstraat
650,Mercatorstraat 36,2023-04-23,11:00:00,370,226,144,FMN 02 Mercatorstraat
650,Mercatorstraat 36,2023-04-23,12:00:00,508,344,164,FMN 02 Mercatorstraat
650,Mercatorstraat 36,2023-04-23,13:00:00,443,309,134,FMN 02 Mercatorstraat
650,Mercatorstraat 36,2023-04-23,14:00:00,360,225,135,FMN 02 Mercatorstraat
650,Mercatorstraat 36,2023-04-23,15:00:00,293,126,167,FMN 02 Mercatorstraat
650,Mercatorstraat 36,2023-04-23,16:00:00,393,99,294,FMN 02 Mercatorstraat
650,Mercatorstraat 36,2023-04-23,17:00:00,365,104,261,FMN 02 Mercatorstraat
650,Mercatorstraat 36,2023-04-23,18:00:00,263,68,195,FMN 02 Mercatorstraat
650,Mercatorstraat 36,2023-04-23,19:00:00,240,79,161,FMN 02 Mercatorstraat
650,Mercatorstraat 36,2023-04-23,20:00:00,164,59,105,FMN 02 Mercatorstraat
650,Mercatorstraat 36,2023-04-23,21:00:00,131,38,93,FMN 02 Mercatorstraat
650,Mercatorstraat 36,2023-04-23,22:00:00,119,41,78,FMN 02 Mercatorstraat
650,Mercatorstraat 36,2023-04-23,23:00:00,48,14,34,FMN 02 Mercatorstraat
650,Mercatorstraat 36,2023-04-24,00:00:00,22,10,12,FMN 02 Mercatorstraat
650,Mercatorstraat 36,2023-04-24,01:00:00,11,4,7,FMN 02 Mercatorstraat
650,Mercatorstraat 36,2023-04-24,02:00:00,18,8,10,FMN 02 Mercatorstraat
650,Mercatorstraat 36,2023-04-24,03:00:00,11,5,6,FMN 02 Mercatorstraat
650,Mercatorstraat 36,2023-04-24,04:00:00,25,17,8,FMN 02 Mercatorstraat
650,Mercatorstraat 36,2023-04-24,05:00:00,40,23,17,FMN 02 Mercatorstraat
650,Mercatorstraat 36,2023-04-24,06:00:00,107,58,49,FMN 02 Mercatorstraat
650,Mercatorstraat 36,2023-04-24,07:00:00,322,185,137,FMN 02 Mercatorstraat
650,Mercatorstraat 36,2023-04-24,08:00:00,814,564,250,FMN 02 Mercatorstraat
650,Mercatorstraat 36,2023-04-24,09:00:00,357,274,83,FMN 02 Mercatorstraat
650,Mercatorstraat 36,2023-04-24,10:00:00,193,131,62,FMN 02 Mercatorstraat
650,Mercatorstraat 36,2023-04-24,11:00:00,163,89,74,FMN 02 Mercatorstraat
650,Mercatorstraat 36,2023-04-24,12:00:00,280,168,112,FMN 02 Mercatorstraat
650,Mercatorstraat 36,2023-04-24,13:00:00,302,134,168,FMN 02 Mercatorstraat
650,Mercatorstraat 36,2023-04-24,14:00:00,250,108,142,FMN 02 Mercatorstraat
650,Mercatorstraat 36,2023-04-24,15:00:00,360,153,207,FMN 02 Mercatorstraat
650,Mercatorstraat 36,2023-04-24,16:00:00,524,177,347,FMN 02 Mercatorstraat
650,Mercatorstraat 36,2023-04-24,17:00:00,695,229,466,FMN 02 Mercatorstraat
650,Mercatorstraat 36,2023-04-24,18:00:00,487,202,285,FMN 02 Mercatorstraat
650,Mercatorstraat 36,2023-04-24,19:00:00,296,134,162,FMN 02 Mercatorstraat
650,Mercatorstraat 36,2023-04-24,20:00:00,195,82,113,FMN 02 Mercatorstraat
650,Mercatorstraat 36,2023-04-24,21:00:00,238,96,142,FMN 02 Mercatorstraat
650,Mercatorstraat 36,2023-04-24,22:00:00,176,76,100,FMN 02 Mercatorstraat
650,Mercatorstraat 36,2023-04-24,23:00:00,78,25,53,FMN 02 Mercatorstraat
650,Mercatorstraat 36,2023-04-25,00:00:00,43,14,29,FMN 02 Mercatorstraat
650,Mercatorstraat 36,2023-04-25,01:00:00,12,4,8,FMN 02 Mercatorstraat
650,Mercatorstraat 36,2023-04-25,02:00:00,18,5,13,FMN 02 Mercatorstraat
650,Mercatorstraat 36,2023-04-25,03:00:00,9,5,4,FMN 02 Mercatorstraat
650,Mercatorstraat 36,2023-04-25,04:00:00,21,13,8,FMN 02 Mercatorstraat
650,Mercatorstraat 36,2023-04-25,05:00:00,50,29,21,FMN 02 Mercatorstraat
650,Mercatorstraat 36,2023-04-25,06:00:00,153,82,71,FMN 02 Mercatorstraat
650,Mercatorstraat 36,2023-04-25,07:00:00,454,290,164,FMN 02 Mercatorstraat
650,Mercatorstraat 36,2023-04-25,08:00:00,1110,773,337,FMN 02 Mercatorstraat
650,Mercatorstraat 36,2023-04-25,09:00:00,449,342,107,FMN 02 Mercatorstraat
650,Mercatorstraat 36,2023-04-25,10:00:00,244,161,83,FMN 02 Mercatorstraat
650,Mercatorstraat 36,2023-04-25,11:00:00,274,142,132,FMN 02 Mercatorstraat
650,Mercatorstraat 36,2023-04-25,12:00:00,319,161,158,FMN 02 Mercatorstraat
650,Mercatorstraat 36,2023-04-25,13:00:00,367,179,188,FMN 02 Mercatorstraat
650,Mercatorstraat 36,2023-04-25,14:00:00,314,123,191,FMN 02 Mercatorstraat
650,Mercatorstraat 36,2023-04-25,15:00:00,473,146,327,FMN 02 Mercatorstraat
650,Mercatorstraat 36,2023-04-25,16:00:00,707,250,457,FMN 02 Mercatorstraat
650,Mercatorstraat 36,2023-04-25,17:00:00,818,278,540,FMN 02 Mercatorstraat
650,Mercatorstraat 36,2023-04-25,18:00:00,594,236,358,FMN 02 Mercatorstraat
650,Mercatorstraat 36,2023-04-25,19:00:00,416,204,212,FMN 02 Mercatorstraat
650,Mercatorstraat 36,2023-04-25,20:00:00,227,90,137,FMN 02 Mercatorstraat
650,Mercatorstraat 36,2023-04-25,21:00:00,259,102,157,FMN 02 Mercatorstraat
650,Mercatorstraat 36,2023-04-25,22:00:00,213,68,145,FMN 02 Mercatorstraat
650,Mercatorstraat 36,2023-04-25,23:00:00,105,28,77,FMN 02 Mercatorstraat
650,Mercatorstraat 36,2023-04-26,00:00:00,51,18,33,FMN 02 Mercatorstraat
650,Mercatorstraat 36,2023-04-26,01:00:00,22,4,18,FMN 02 Mercatorstraat
650,Mercatorstraat 36,2023-04-26,02:00:00,24,6,18,FMN 02 Mercatorstraat
650,Mercatorstraat 36,2023-04-26,03:00:00,13,2,11,FMN 02 Mercatorstraat
650,Mercatorstraat 36,2023-04-26,04:00:00,25,15,10,FMN 02 Mercatorstraat
650,Mercatorstraat 36,2023-04-26,05:00:00,47,28,19,FMN 02 Mercatorstraat
650,Mercatorstraat 36,2023-04-26,06:00:00,150,88,62,FMN 02 Mercatorstraat
650,Mercatorstraat 36,2023-04-26,07:00:00,430,276,154,FMN 02 Mercatorstraat
650,Mercatorstraat 36,2023-04-26,08:00:00,986,662,324,FMN 02 Mercatorstraat
650,Mercatorstraat 36,2023-04-26,09:00:00,453,352,101,FMN 02 Mercatorstraat
650,Mercatorstraat 36,2023-04-26,10:00:00,252,157,95,FMN 02 Mercatorstraat
650,Mercatorstraat 36,2023-04-26,11:00:00,309,153,156,FMN 02 Mercatorstraat
650,Mercatorstraat 36,2023-04-26,12:00:00,536,199,337,FMN 02 Mercatorstraat
650,Mercatorstraat 36,2023-04-26,13:00:00,455,195,260,FMN 02 Mercatorstraat
650,Mercatorstraat 36,2023-04-26,14:00:00,374,174,200,FMN 02 Mercatorstraat
650,Mercatorstraat 36,2023-04-26,15:00:00,382,153,229,FMN 02 Mercatorstraat
650,Mercatorstraat 36,2023-04-26,16:00:00,582,230,352,FMN 02 Mercatorstraat
650,Mercatorstraat 36,2023-04-26,17:00:00,752,263,489,FMN 02 Mercatorstraat
650,Mercatorstraat 36,2023-04-26,18:00:00,595,241,354,FMN 02 Mercatorstraat
650,Mercatorstraat 36,2023-04-26,19:00:00,379,202,177,FMN 02 Mercatorstraat
650,Mercatorstraat 36,2023-04-26,20:00:00,230,106,124,FMN 02 Mercatorstraat
650,Mercatorstraat 36,2023-04-26,21:00:00,226,93,133,FMN 02 Mercatorstraat
650,Mercatorstraat 36,2023-04-26,22:00:00,318,107,211,FMN 02 Mercatorstraat
650,Mercatorstraat 36,2023-04-26,23:00:00,143,52,91,FMN 02 Mercatorstraat
650,Mercatorstraat 36,2023-04-27,00:00:00,64,26,38,FMN 02 Mercatorstraat
650,Mercatorstraat 36,2023-04-27,01:00:00,28,9,19,FMN 02 Mercatorstraat
650,Mercatorstraat 36,2023-04-27,02:00:00,15,1,14,FMN 02 Mercatorstraat
650,Mercatorstraat 36,2023-04-27,03:00:00,25,5,20,FMN 02 Mercatorstraat
650,Mercatorstraat 36,2023-04-27,04:00:00,28,10,18,FMN 02 Mercatorstraat
650,Mercatorstraat 36,2023-04-27,05:00:00,51,32,19,FMN 02 Mercatorstraat
650,Mercatorstraat 36,2023-04-27,06:00:00,150,79,71,FMN 02 Mercatorstraat
650,Mercatorstraat 36,2023-04-27,07:00:00,456,293,163,FMN 02 Mercatorstraat
650,Mercatorstraat 36,2023-04-27,08:00:00,1068,729,339,FMN 02 Mercatorstraat
650,Mercatorstraat 36,2023-04-27,09:00:00,467,331,136,FMN 02 Mercatorstraat
650,Mercatorstraat 36,2023-04-27,10:00:00,274,170,104,FMN 02 Mercatorstraat
650,Mercatorstraat 36,2023-04-27,11:00:00,265,145,120,FMN 02 Mercatorstraat
650,Mercatorstraat 36,2023-04-27,12:00:00,409,222,187,FMN 02 Mercatorstraat
650,Mercatorstraat 36,2023-04-27,13:00:00,420,197,223,FMN 02 Mercatorstraat
650,Mercatorstraat 36,2023-04-27,14:00:00,361,165,196,FMN 02 Mercatorstraat
650,Mercatorstraat 36,2023-04-27,15:00:00,499,180,319,FMN 02 Mercatorstraat
650,Mercatorstraat 36,2023-04-27,16:00:00,733,262,471,FMN 02 Mercatorstraat
650,Mercatorstraat 36,2023-04-27,17:00:00,847,291,556,FMN 02 Mercatorstraat
650,Mercatorstraat 36,2023-04-27,18:00:00,609,257,352,FMN 02 Mercatorstraat
650,Mercatorstraat 36,2023-04-27,19:00:00,406,211,195,FMN 02 Mercatorstraat
650,Mercatorstraat 36,2023-04-27,20:00:00,253,108,145,FMN 02 Mercatorstraat
650,Mercatorstraat 36,2023-04-27,21:00:00,256,110,146,FMN 02 Mercatorstraat
650,Mercatorstraat 36,2023-04-27,22:00:00,283,102,181,FMN 02 Mercatorstraat
650,Mercatorstraat 36,2023-04-27,23:00:00,140,58,82,FMN 02 Mercatorstraat
650,Mercatorstraat 36,2023-04-28,00:00:00,86,35,51,FMN 02 Mercatorstraat
650,Mercatorstraat 36,2023-04-28,01:00:00,61,25,36,FMN 02 Mercatorstraat
650,Mercatorstraat 36,2023-04-28,02:00:00,24,6,18,FMN 02 Mercatorstraat
650,Mercatorstraat 36,2023-04-28,03:00:00,17,2,15,FMN 02 Mercatorstraat
650,Mercatorstraat 36,2023-04-28,04:00:00,33,13,20,FMN 02 Mercatorstraat
650,Mercatorstraat 36,2023-04-28,05:00:00,49,28,21,FMN 02 Mercatorstraat
650,Mercatorstraat 36,2023-04-28,06:00:00,126,72,54,FMN 02 Mercatorstraat
650,Mercatorstraat 36,2023-04-28,07:00:00,316,190,126,FMN 02 Mercatorstraat
650,Mercatorstraat 36,2023-04-28,08:00:00,845,580,265,FMN 02 Mercatorstraat
650,Mercatorstraat 36,2023-04-28,09:00:00,364,274,90,FMN 02 Mercatorstraat
650,Mercatorstraat 36,2023-04-28,10:00:00,250,168,82,FMN 02 Mercatorstraat
650,Mercatorstraat 36,2023-04-28,11:00:00,254,145,109,FMN 02 Mercatorstraat
650,Mercatorstraat 36,2023-04-28,12:00:00,446,215,231,FMN 02 Mercatorstraat
650,Mercatorstraat 36,2023-04-28,13:00:00,309,154,155,FMN 02 Mercatorstraat
650,Mercatorstraat 36,2023-04-28,14:00:00,318,146,172,FMN 02 Mercatorstraat
650,Mercatorstraat 36,2023-04-28,15:00:00,492,147,345,FMN 02 Mercatorstraat
650,Mercatorstraat 36,2023-04-28,16:00:00,600,196,404,FMN 02 Mercatorstraat
650,Mercatorstraat 36,2023-04-28,17:00:00,637,218,419,FMN 02 Mercatorstraat
650,Mercatorstraat 36,2023-04-28,18:00:00,494,209,285,FMN 02 Mercatorstraat
650,Mercatorstraat 36,2023-04-28,19:00:00,368,216,152,FMN 02 Mercatorstraat
650,Mercatorstraat 36,2023-04-28,20:00:00,251,114,137,FMN 02 Mercatorstraat
650,Mercatorstraat 36,2023-04-28,21:00:00,232,116,116,FMN 02 Mercatorstraat
650,Mercatorstraat 36,2023-04-28,22:00:00,228,76,152,FMN 02 Mercatorstraat
650,Mercatorstraat 36,2023-04-28,23:00:00,213,81,132,FMN 02 Mercatorstraat
650,Mercatorstraat 36,2023-04-29,00:00:00,137,64,73,FMN 02 Mercatorstraat
650,Mercatorstraat 36,2023-04-29,01:00:00,113,52,61,FMN 02 Mercatorstraat
650,Mercatorstraat 36,2023-04-29,02:00:00,103,33,70,FMN 02 Mercatorstraat
650,Mercatorstraat 36,2023-04-29,03:00:00,70,27,43,FMN 02 Mercatorstraat
650,Mercatorstraat 36,2023-04-29,04:00:00,72,18,54,FMN 02 Mercatorstraat
650,Mercatorstraat 36,2023-04-29,05:00:00,41,17,24,FMN 02 Mercatorstraat
650,Mercatorstraat 36,2023-04-29,06:00:00,46,22,24,FMN 02 Mercatorstraat
650,Mercatorstraat 36,2023-04-29,07:00:00,53,27,26,FMN 02 Mercatorstraat
650,Mercatorstraat 36,2023-04-29,08:00:00,109,64,45,FMN 02 Mercatorstraat
650,Mercatorstraat 36,2023-04-29,09:00:00,205,154,51,FMN 02 Mercatorstraat
650,Mercatorstraat 36,2023-04-29,10:00:00,269,187,82,FMN 02 Mercatorstraat
650,Mercatorstraat 36,2023-04-29,11:00:00,276,165,111,FMN 02 Mercatorstraat
650,Mercatorstraat 36,2023-04-29,12:00:00,290,172,118,FMN 02 Mercatorstraat
650,Mercatorstraat 36,2023-04-29,13:00:00,360,212,148,FMN 02 Mercatorstraat
650,Mercatorstraat 36,2023-04-29,14:00:00,404,234,170,FMN 02 Mercatorstraat
650,Mercatorstraat 36,2023-04-29,15:00:00,413,218,195,FMN 02 Mercatorstraat
650,Mercatorstraat 36,2023-04-29,16:00:00,359,148,211,FMN 02 Mercatorstraat
650,Mercatorstraat 36,2023-04-29,17:00:00,330,145,185,FMN 02 Mercatorstraat
650,Mercatorstraat 36,2023-04-29,18:00:00,336,173,163,FMN 02 Mercatorstraat
650,Mercatorstraat 36,2023-04-29,19:00:00,298,182,116,FMN 02 Mercatorstraat
650,Mercatorstraat 36,2023-04-29,20:00:00,222,106,116,FMN 02 Mercatorstraat
650,Mercatorstraat 36,2023-04-29,21:00:00,206,87,119,FMN 02 Mercatorstraat
650,Mercatorstraat 36,2023-04-29,22:00:00,210,74,136,FMN 02 Mercatorstraat
650,Mercatorstraat 36,2023-04-29,23:00:00,182,74,108,FMN 02 Mercatorstraat
650,Mercatorstraat 36,2023-04-30,00:00:00,155,46,109,FMN 02 Mercatorstraat
650,Mercatorstraat 36,2023-04-30,01:00:00,140,60,80,FMN 02 Mercatorstraat
650,Mercatorstraat 36,2023-04-30,02:00:00,85,33,52,FMN 02 Mercatorstraat
650,Mercatorstraat 36,2023-04-30,03:00:00,48,14,34,FMN 02 Mercatorstraat
650,Mercatorstraat 36,2023-04-30,04:00:00,54,11,43,FMN 02 Mercatorstraat
650,Mercatorstraat 36,2023-04-30,05:00:00,44,14,30,FMN 02 Mercatorstraat
650,Mercatorstraat 36,2023-04-30,06:00:00,42,23,19,FMN 02 Mercatorstraat
650,Mercatorstraat 36,2023-04-30,07:00:00,74,40,34,FMN 02 Mercatorstraat
650,Mercatorstraat 36,2023-04-30,08:00:00,120,51,69,FMN 02 Mercatorstraat
650,Mercatorstraat 36,2023-04-30,09:00:00,282,159,123,FMN 02 Mercatorstraat
650,Mercatorstraat 36,2023-04-30,10:00:00,248,180,68,FMN 02 Mercatorstraat
650,Mercatorstraat 36,2023-04-30,11:00:00,291,168,123,FMN 02 Mercatorstraat
650,Mercatorstraat 36,2023-04-30,12:00:00,381,190,191,FMN 02 Mercatorstraat
650,Mercatorstraat 36,2023-04-30,13:00:00,393,246,147,FMN 02 Mercatorstraat
650,Mercatorstraat 36,2023-04-30,14:00:00,380,219,161,FMN 02 Mercatorstraat
650,Mercatorstraat 36,2023-04-30,15:00:00,341,176,165,FMN 02 Mercatorstraat
650,Mercatorstraat 36,2023-04-30,16:00:00,325,138,187,FMN 02 Mercatorstraat
650,Mercatorstraat 36,2023-04-30,17:00:00,348,154,194,FMN 02 Mercatorstraat
650,Mercatorstraat 36,2023-04-30,18:00:00,311,152,159,FMN 02 Mercatorstraat
650,Mercatorstraat 36,2023-04-30,19:00:00,295,150,145,FMN 02 Mercatorstraat
650,Mercatorstraat 36,2023-04-30,20:00:00,247,112,135,FMN 02 Mercatorstraat
650,Mercatorstraat 36,2023-04-30,21:00:00,204,89,115,FMN 02 Mercatorstraat
650,Mercatorstraat 36,2023-04-30,22:00:00,199,64,135,FMN 02 Mercatorstraat
650,Mercatorstraat 36,2023-04-30,23:00:00,132,41,91,FMN 02 Mercatorstraat
650,Mercatorstraat 36,2023-05-01,00:00:00,109,37,72,FMN 02 Mercatorstraat
650,Mercatorstraat 36,2023-05-01,01:00:00,68,25,43,FMN 02 Mercatorstraat
650,Mercatorstraat 36,2023-05-01,02:00:00,47,14,33,FMN 02 Mercatorstraat
650,Mercatorstraat 36,2023-05-01,03:00:00,36,8,28,FMN 02 Mercatorstraat
650,Mercatorstraat 36,2023-05-01,04:00:00,31,11,20,FMN 02 Mercatorstraat
650,Mercatorstraat 36,2023-05-01,05:00:00,31,12,19,FMN 02 Mercatorstraat
650,Mercatorstraat 36,2023-05-01,06:00:00,55,26,29,FMN 02 Mercatorstraat
650,Mercatorstraat 36,2023-05-01,07:00:00,80,28,52,FMN 02 Mercatorstraat
650,Mercatorstraat 36,2023-05-01,08:00:00,130,50,80,FMN 02 Mercatorstraat
650,Mercatorstraat 36,2023-05-01,09:00:00,236,122,114,FMN 02 Mercatorstraat
650,Mercatorstraat 36,2023-05-01,10:00:00,264,162,102,FMN 02 Mercatorstraat
650,Mercatorstraat 36,2023-05-01,11:00:00,277,167,110,FMN 02 Mercatorstraat
650,Mercatorstraat 36,2023-05-01,12:00:00,296,178,118,FMN 02 Mercatorstraat
650,Mercatorstraat 36,2023-05-01,13:00:00,271,137,134,FMN 02 Mercatorstraat
650,Mercatorstraat 36,2023-05-01,14:00:00,383,210,173,FMN 02 Mercatorstraat
650,Mercatorstraat 36,2023-05-01,15:00:00,371,191,180,FMN 02 Mercatorstraat
650,Mercatorstraat 36,2023-05-01,16:00:00,317,149,168,FMN 02 Mercatorstraat
650,Mercatorstraat 36,2023-05-01,17:00:00,350,152,198,FMN 02 Mercatorstraat
650,Mercatorstraat 36,2023-05-01,18:00:00,315,168,147,FMN 02 Mercatorstraat
650,Mercatorstraat 36,2023-05-01,19:00:00,267,122,145,FMN 02 Mercatorstraat
650,Mercatorstraat 36,2023-05-01,20:00:00,241,117,124,FMN 02 Mercatorstraat
650,Mercatorstraat 36,2023-05-01,21:00:00,216,96,120,FMN 02 Mercatorstraat
650,Mercatorstraat 36,2023-05-01,22:00:00,156,65,91,FMN 02 Mercatorstraat
650,Mercatorstraat 36,2023-05-01,23:00:00,77,20,57,FMN 02 Mercatorstraat
650,Mercatorstraat 36,2023-05-02,00:00:00,41,14,27,FMN 02 Mercatorstraat
650,Mercatorstraat 36,2023-05-02,01:00:00,20,7,13,FMN 02 Mercatorstraat
650,Mercatorstraat 36,2023-05-02,02:00:00,10,3,7,FMN 02 Mercatorstraat
650,Mercatorstraat 36,2023-05-02,03:00:00,13,4,9,FMN 02 Mercatorstraat
650,Mercatorstraat 36,2023-05-02,04:00:00,29,16,13,FMN 02 Mercatorstraat
650,Mercatorstraat 36,2023-05-02,05:00:00,47,26,21,FMN 02 Mercatorstraat
650,Mercatorstraat 36,2023-05-02,06:00:00,142,79,63,FMN 02 Mercatorstraat
650,Mercatorstraat 36,2023-05-02,07:00:00,458,306,152,FMN 02 Mercatorstraat
650,Mercatorstraat 36,2023-05-02,08:00:00,1123,789,334,FMN 02 Mercatorstraat
650,Mercatorstraat 36,2023-05-02,09:00:00,481,368,113,FMN 02 Mercatorstraat
650,Mercatorstraat 36,2023-05-02,10:00:00,307,194,113,FMN 02 Mercatorstraat
650,Mercatorstraat 36,2023-05-02,11:00:00,270,156,114,FMN 02 Mercatorstraat
650,Mercatorstraat 36,2023-05-02,12:00:00,409,207,202,FMN 02 Mercatorstraat
650,Mercatorstraat 36,2023-05-02,13:00:00,400,195,205,FMN 02 Mercatorstraat
650,Mercatorstraat 36,2023-05-02,14:00:00,320,162,158,FMN 02 Mercatorstraat
650,Mercatorstraat 36,2023-05-02,15:00:00,534,166,368,FMN 02 Mercatorstraat
650,Mercatorstraat 36,2023-05-02,16:00:00,745,251,494,FMN 02 Mercatorstraat
650,Mercatorstraat 36,2023-05-02,17:00:00,915,316,599,FMN 02 Mercatorstraat
650,Mercatorstraat 36,2023-05-02,18:00:00,659,245,414,FMN 02 Mercatorstraat
650,Mercatorstraat 36,2023-05-02,19:00:00,367,137,230,FMN 02 Mercatorstraat
650,Mercatorstraat 36,2023-05-02,20:00:00,275,116,159,FMN 02 Mercatorstraat
650,Mercatorstraat 36,2023-05-02,21:00:00,295,130,165,FMN 02 Mercatorstraat
650,Mercatorstraat 36,2023-05-02,22:00:00,241,83,158,FMN 02 Mercatorstraat
650,Mercatorstraat 36,2023-05-02,23:00:00,112,44,68,FMN 02 Mercatorstraat
650,Mercatorstraat 36,2023-05-03,00:00:00,47,22,25,FMN 02 Mercatorstraat
650,Mercatorstraat 36,2023-05-03,01:00:00,18,4,14,FMN 02 Mercatorstraat
650,Mercatorstraat 36,2023-05-03,02:00:00,9,5,4,FMN 02 Mercatorstraat
650,Mercatorstraat 36,2023-05-03,03:00:00,21,5,16,FMN 02 Mercatorstraat
650,Mercatorstraat 36,2023-05-03,04:00:00,20,9,11,FMN 02 Mercatorstraat
650,Mercatorstraat 36,2023-05-03,05:00:00,49,32,17,FMN 02 Mercatorstraat
650,Mercatorstraat 36,2023-05-03,06:00:00,151,85,66,FMN 02 Mercatorstraat
650,Mercatorstraat 36,2023-05-03,07:00:00,472,307,165,FMN 02 Mercatorstraat
650,Mercatorstraat 36,2023-05-03,08:00:00,1003,728,275,FMN 02 Mercatorstraat
650,Mercatorstraat 36,2023-05-03,09:00:00,470,354,116,FMN 02 Mercatorstraat
650,Mercatorstraat 36,2023-05-03,10:00:00,296,181,115,FMN 02 Mercatorstraat
650,Mercatorstraat 36,2023-05-03,11:00:00,279,155,124,FMN 02 Mercatorstraat
650,Mercatorstraat 36,2023-05-03,12:00:00,571,236,335,FMN 02 Mercatorstraat
650,Mercatorstraat 36,2023-05-03,13:00:00,499,248,251,FMN 02 Mercatorstraat
650,Mercatorstraat 36,2023-05-03,14:00:00,375,200,175,FMN 02 Mercatorstraat
650,Mercatorstraat 36,2023-05-03,15:00:00,410,175,235,FMN 02 Mercatorstraat
650,Mercatorstraat 36,2023-05-03,16:00:00,577,220,357,FMN 02 Mercatorstraat
650,Mercatorstraat 36,2023-05-03,17:00:00,798,280,518,FMN 02 Mercatorstraat
650,Mercatorstraat 36,2023-05-03,18:00:00,691,271,420,FMN 02 Mercatorstraat
650,Mercatorstraat 36,2023-05-03,19:00:00,361,189,172,FMN 02 Mercatorstraat
650,Mercatorstraat 36,2023-05-03,20:00:00,310,125,185,FMN 02 Mercatorstraat
650,Mercatorstraat 36,2023-05-03,21:00:00,270,97,173,FMN 02 Mercatorstraat
650,Mercatorstraat 36,2023-05-03,22:00:00,213,82,131,FMN 02 Mercatorstraat
650,Mercatorstraat 36,2023-05-03,23:00:00,125,34,91,FMN 02 Mercatorstraat
650,Mercatorstraat 36,2023-05-04,00:00:00,60,20,40,FMN 02 Mercatorstraat
650,Mercatorstraat 36,2023-05-04,01:00:00,24,12,12,FMN 02 Mercatorstraat
650,Mercatorstraat 36,2023-05-04,02:00:00,19,9,10,FMN 02 Mercatorstraat
650,Mercatorstraat 36,2023-05-04,03:00:00,15,4,11,FMN 02 Mercatorstraat
650,Mercatorstraat 36,2023-05-04,04:00:00,25,13,12,FMN 02 Mercatorstraat
650,Mercatorstraat 36,2023-05-04,05:00:00,39,23,16,FMN 02 Mercatorstraat
650,Mercatorstraat 36,2023-05-04,06:00:00,162,95,67,FMN 02 Mercatorstraat
650,Mercatorstraat 36,2023-05-04,07:00:00,471,298,173,FMN 02 Mercatorstraat
650,Mercatorstraat 36,2023-05-04,08:00:00,1177,807,370,FMN 02 Mercatorstraat
650,Mercatorstraat 36,2023-05-04,09:00:00,481,362,119,FMN 02 Mercatorstraat
650,Mercatorstraat 36,2023-05-04,10:00:00,305,198,107,FMN 02 Mercatorstraat
650,Mercatorstraat 36,2023-05-04,11:00:00,279,156,123,FMN 02 Mercatorstraat
650,Mercatorstraat 36,2023-05-04,12:00:00,450,252,198,FMN 02 Mercatorstraat
650,Mercatorstraat 36,2023-05-04,13:00:00,410,167,243,FMN 02 Mercatorstraat
650,Mercatorstraat 36,2023-05-04,14:00:00,406,192,214,FMN 02 Mercatorstraat
650,Mercatorstraat 36,2023-05-04,15:00:00,556,184,372,FMN 02 Mercatorstraat
650,Mercatorstraat 36,2023-05-04,16:00:00,791,302,489,FMN 02 Mercatorstraat
650,Mercatorstraat 36,2023-05-04,17:00:00,955,356,599,FMN 02 Mercatorstraat
650,Mercatorstraat 36,2023-05-04,18:00:00,674,257,417,FMN 02 Mercatorstraat
650,Mercatorstraat 36,2023-05-04,19:00:00,484,247,237,FMN 02 Mercatorstraat
650,Mercatorstraat 36,2023-05-04,20:00:00,325,143,182,FMN 02 Mercatorstraat
650,Mercatorstraat 36,2023-05-04,21:00:00,320,141,179,FMN 02 Mercatorstraat
650,Mercatorstraat 36,2023-05-04,22:00:00,304,109,195,FMN 02 Mercatorstraat
650,Mercatorstraat 36,2023-05-04,23:00:00,184,59,125,FMN 02 Mercatorstraat
650,Mercatorstraat 36,2023-05-05,00:00:00,90,27,63,FMN 02 Mercatorstraat
650,Mercatorstraat 36,2023-05-05,01:00:00,46,10,36,FMN 02 Mercatorstraat
650,Mercatorstraat 36,2023-05-05,02:00:00,23,4,19,FMN 02 Mercatorstraat
650,Mercatorstraat 36,2023-05-05,03:00:00,26,8,18,FMN 02 Mercatorstraat
650,Mercatorstraat 36,2023-05-05,04:00:00,37,17,20,FMN 02 Mercatorstraat
650,Mercatorstraat 36,2023-05-05,05:00:00,38,24,14,FMN 02 Mercatorstraat
650,Mercatorstraat 36,2023-05-05,06:00:00,133,74,59,FMN 02 Mercatorstraat
650,Mercatorstraat 36,2023-05-05,07:00:00,384,238,146,FMN 02 Mercatorstraat
650,Mercatorstraat 36,2023-05-05,08:00:00,909,625,284,FMN 02 Mercatorstraat
650,Mercatorstraat 36,2023-05-05,09:00:00,413,302,111,FMN 02 Mercatorstraat
650,Mercatorstraat 36,2023-05-05,10:00:00,266,166,100,FMN 02 Mercatorstraat
650,Mercatorstraat 36,2023-05-05,11:00:00,222,109,113,FMN 02 Mercatorstraat
650,Mercatorstraat 36,2023-05-05,12:00:00,400,196,204,FMN 02 Mercatorstraat
650,Mercatorstraat 36,2023-05-05,13:00:00,310,152,158,FMN 02 Mercatorstraat
650,Mercatorstraat 36,2023-05-05,14:00:00,309,134,175,FMN 02 Mercatorstraat
650,Mercatorstraat 36,2023-05-05,15:00:00,475,170,305,FMN 02 Mercatorstraat
650,Mercatorstraat 36,2023-05-05,16:00:00,627,202,425,FMN 02 Mercatorstraat
650,Mercatorstraat 36,2023-05-05,17:00:00,600,215,385,FMN 02 Mercatorstraat
650,Mercatorstraat 36,2023-05-05,18:00:00,511,213,298,FMN 02 Mercatorstraat
650,Mercatorstraat 36,2023-05-05,19:00:00,380,204,176,FMN 02 Mercatorstraat
650,Mercatorstraat 36,2023-05-05,20:00:00,292,164,128,FMN 02 Mercatorstraat
650,Mercatorstraat 36,2023-05-05,21:00:00,209,115,94,FMN 02 Mercatorstraat
650,Mercatorstraat 36,2023-05-05,22:00:00,219,92,127,FMN 02 Mercatorstraat
650,Mercatorstraat 36,2023-05-05,23:00:00,187,54,133,FMN 02 Mercatorstraat
650,Mercatorstraat 36,2023-05-06,00:00:00,151,53,98,FMN 02 Mercatorstraat
650,Mercatorstraat 36,2023-05-06,01:00:00,159,41,118,FMN 02 Mercatorstraat
650,Mercatorstraat 36,2023-05-06,02:00:00,68,15,53,FMN 02 Mercatorstraat
650,Mercatorstraat 36,2023-05-06,03:00:00,60,21,39,FMN 02 Mercatorstraat
650,Mercatorstraat 36,2023-05-06,04:00:00,46,19,27,FMN 02 Mercatorstraat
650,Mercatorstraat 36,2023-05-06,05:00:00,62,17,45,FMN 02 Mercatorstraat
650,Mercatorstraat 36,2023-05-06,06:00:00,44,16,28,FMN 02 Mercatorstraat
650,Mercatorstraat 36,2023-05-06,07:00:00,63,33,30,FMN 02 Mercatorstraat
650,Mercatorstraat 36,2023-05-06,08:00:00,111,73,38,FMN 02 Mercatorstraat
650,Mercatorstraat 36,2023-05-06,09:00:00,293,222,71,FMN 02 Mercatorstraat
650,Mercatorstraat 36,2023-05-06,10:00:00,327,242,85,FMN 02 Mercatorstraat
650,Mercatorstraat 36,2023-05-06,11:00:00,363,207,156,FMN 02 Mercatorstraat
650,Mercatorstraat 36,2023-05-06,12:00:00,403,206,197,FMN 02 Mercatorstraat
650,Mercatorstraat 36,2023-05-06,13:00:00,415,221,194,FMN 02 Mercatorstraat
650,Mercatorstraat 36,2023-05-06,14:00:00,419,220,199,FMN 02 Mercatorstraat
650,Mercatorstraat 36,2023-05-06,15:00:00,364,164,200,FMN 02 Mercatorstraat
650,Mercatorstraat 36,2023-05-06,16:00:00,360,142,218,FMN 02 Mercatorstraat
650,Mercatorstraat 36,2023-05-06,17:00:00,350,142,208,FMN 02 Mercatorstraat
650,Mercatorstraat 36,2023-05-06,18:00:00,271,116,155,FMN 02 Mercatorstraat
650,Mercatorstraat 36,2023-05-06,19:00:00,240,128,112,FMN 02 Mercatorstraat
650,Mercatorstraat 36,2023-05-06,20:00:00,205,97,108,FMN 02 Mercatorstraat
650,Mercatorstraat 36,2023-05-06,21:00:00,161,91,70,FMN 02 Mercatorstraat
650,Mercatorstraat 36,2023-05-06,22:00:00,184,76,108,FMN 02 Mercatorstraat
650,Mercatorstraat 36,2023-05-06,23:00:00,171,45,126,FMN 02 Mercatorstraat
650,Mercatorstraat 36,2023-05-07,00:00:00,161,55,106,FMN 02 Mercatorstraat
650,Mercatorstraat 36,2023-05-07,01:00:00,129,61,68,FMN 02 Mercatorstraat
650,Mercatorstraat 36,2023-05-07,02:00:00,106,35,71,FMN 02 Mercatorstraat
650,Mercatorstraat 36,2023-05-07,03:00:00,76,38,38,FMN 02 Mercatorstraat
650,Mercatorstraat 36,2023-05-07,04:00:00,48,19,29,FMN 02 Mercatorstraat
650,Mercatorstraat 36,2023-05-07,05:00:00,53,22,31,FMN 02 Mercatorstraat
650,Mercatorstraat 36,2023-05-07,06:00:00,41,19,22,FMN 02 Mercatorstraat
650,Mercatorstraat 36,2023-05-07,07:00:00,50,25,25,FMN 02 Mercatorstraat
650,Mercatorstraat 36,2023-05-07,08:00:00,118,57,61,FMN 02 Mercatorstraat
650,Mercatorstraat 36,2023-05-07,09:00:00,230,114,116,FMN 02 Mercatorstraat
650,Mercatorstraat 36,2023-05-07,10:00:00,229,150,79,FMN 02 Mercatorstraat
650,Mercatorstraat 36,2023-05-07,11:00:00,206,127,79,FMN 02 Mercatorstraat
650,Mercatorstraat 36,2023-05-07,12:00:00,245,124,121,FMN 02 Mercatorstraat
650,Mercatorstraat 36,2023-05-07,13:00:00,264,157,107,FMN 02 Mercatorstraat
650,Mercatorstraat 36,2023-05-07,14:00:00,229,134,95,FMN 02 Mercatorstraat
650,Mercatorstraat 36,2023-05-07,15:00:00,235,131,104,FMN 02 Mercatorstraat
650,Mercatorstraat 36,2023-05-07,16:00:00,261,127,134,FMN 02 Mercatorstraat
650,Mercatorstraat 36,2023-05-07,17:00:00,248,89,159,FMN 02 Mercatorstraat
650,Mercatorstraat 36,2023-05-07,18:00:00,248,100,148,FMN 02 Mercatorstraat
650,Mercatorstraat 36,2023-05-07,19:00:00,251,106,145,FMN 02 Mercatorstraat
650,Mercatorstraat 36,2023-05-07,20:00:00,170,78,92,FMN 02 Mercatorstraat
650,Mercatorstraat 36,2023-05-07,21:00:00,172,77,95,FMN 02 Mercatorstraat
650,Mercatorstraat 36,2023-05-07,22:00:00,111,43,68,FMN 02 Mercatorstraat
650,Mercatorstraat 36,2023-05-07,23:00:00,69,28,41,FMN 02 Mercatorstraat
650,Mercatorstraat 36,2023-05-08,00:00:00,40,15,25,FMN 02 Mercatorstraat
650,Mercatorstraat 36,2023-05-08,01:00:00,23,15,8,FMN 02 Mercatorstraat
650,Mercatorstraat 36,2023-05-08,02:00:00,16,6,10,FMN 02 Mercatorstraat
650,Mercatorstraat 36,2023-05-08,03:00:00,9,3,6,FMN 02 Mercatorstraat
650,Mercatorstraat 36,2023-05-08,04:00:00,31,20,11,FMN 02 Mercatorstraat
650,Mercatorstraat 36,2023-05-08,05:00:00,46,30,16,FMN 02 Mercatorstraat
650,Mercatorstraat 36,2023-05-08,06:00:00,139,83,56,FMN 02 Mercatorstraat
650,Mercatorstraat 36,2023-05-08,07:00:00,433,272,161,FMN 02 Mercatorstraat
650,Mercatorstraat 36,2023-05-08,08:00:00,996,712,284,FMN 02 Mercatorstraat
650,Mercatorstraat 36,2023-05-08,09:00:00,425,305,120,FMN 02 Mercatorstraat
650,Mercatorstraat 36,2023-05-08,10:00:00,254,172,82,FMN 02 Mercatorstraat
650,Mercatorstraat 36,2023-05-08,11:00:00,247,143,104,FMN 02 Mercatorstraat
650,Mercatorstraat 36,2023-05-08,12:00:00,351,165,186,FMN 02 Mercatorstraat
650,Mercatorstraat 36,2023-05-08,13:00:00,357,182,175,FMN 02 Mercatorstraat
650,Mercatorstraat 36,2023-05-08,14:00:00,320,145,175,FMN 02 Mercatorstraat
650,Mercatorstraat 36,2023-05-08,15:00:00,516,184,332,FMN 02 Mercatorstraat
650,Mercatorstraat 36,2023-05-08,16:00:00,728,243,485,FMN 02 Mercatorstraat
650,Mercatorstraat 36,2023-05-08,17:00:00,857,271,586,FMN 02 Mercatorstraat
650,Mercatorstraat 36,2023-05-08,18:00:00,538,200,338,FMN 02 Mercatorstraat
650,Mercatorstraat 36,2023-05-08,19:00:00,343,162,181,FMN 02 Mercatorstraat
650,Mercatorstraat 36,2023-05-08,20:00:00,231,101,130,FMN 02 Mercatorstraat
650,Mercatorstraat 36,2023-05-08,21:00:00,237,99,138,FMN 02 Mercatorstraat
650,Mercatorstraat 36,2023-05-08,22:00:00,195,75,120,FMN 02 Mercatorstraat
650,Mercatorstraat 36,2023-05-08,23:00:00,86,20,66,FMN 02 Mercatorstraat
650,Mercatorstraat 36,2023-05-09,00:00:00,50,18,32,FMN 02 Mercatorstraat
650,Mercatorstraat 36,2023-05-09,01:00:00,19,2,17,FMN 02 Mercatorstraat
650,Mercatorstraat 36,2023-05-09,02:00:00,18,8,10,FMN 02 Mercatorstraat
650,Mercatorstraat 36,2023-05-09,03:00:00,11,2,9,FMN 02 Mercatorstraat
650,Mercatorstraat 36,2023-05-09,04:00:00,36,21,15,FMN 02 Mercatorstraat
650,Mercatorstraat 36,2023-05-09,05:00:00,36,23,13,FMN 02 Mercatorstraat
650,Mercatorstraat 36,2023-05-09,06:00:00,112,80,32,FMN 02 Mercatorstraat
650,Mercatorstraat 36,2023-05-09,07:00:00,431,259,172,FMN 02 Mercatorstraat
650,Mercatorstraat 36,2023-05-09,08:00:00,967,665,302,FMN 02 Mercatorstraat
650,Mercatorstraat 36,2023-05-09,09:00:00,417,273,144,FMN 02 Mercatorstraat
650,Mercatorstraat 36,2023-05-09,10:00:00,189,118,71,FMN 02 Mercatorstraat
650,Mercatorstraat 36,2023-05-09,11:00:00,161,95,66,FMN 02 Mercatorstraat
650,Mercatorstraat 36,2023-05-09,12:00:00,254,112,142,FMN 02 Mercatorstraat
650,Mercatorstraat 36,2023-05-09,13:00:00,222,119,103,FMN 02 Mercatorstraat
650,Mercatorstraat 36,2023-05-09,14:00:00,196,87,109,FMN 02 Mercatorstraat
650,Mercatorstraat 36,2023-05-09,15:00:00,347,111,236,FMN 02 Mercatorstraat
650,Mercatorstraat 36,2023-05-09,16:00:00,533,137,396,FMN 02 Mercatorstraat
650,Mercatorstraat 36,2023-05-09,17:00:00,629,217,412,FMN 02 Mercatorstraat
650,Mercatorstraat 36,2023-05-09,18:00:00,415,167,248,FMN 02 Mercatorstraat
650,Mercatorstraat 36,2023-05-09,19:00:00,212,91,121,FMN 02 Mercatorstraat
650,Mercatorstraat 36,2023-05-09,20:00:00,198,80,118,FMN 02 Mercatorstraat
650,Mercatorstraat 36,2023-05-09,21:00:00,176,68,108,FMN 02 Mercatorstraat
650,Mercatorstraat 36,2023-05-09,22:00:00,132,56,76,FMN 02 Mercatorstraat
650,Mercatorstraat 36,2023-05-09,23:00:00,128,41,87,FMN 02 Mercatorstraat
650,Mercatorstraat 36,2023-05-10,00:00:00,54,18,36,FMN 02 Mercatorstraat
650,Mercatorstraat 36,2023-05-10,01:00:00,13,7,6,FMN 02 Mercatorstraat
650,Mercatorstraat 36,2023-05-10,02:00:00,14,6,8,FMN 02 Mercatorstraat
650,Mercatorstraat 36,2023-05-10,03:00:00,16,8,8,FMN 02 Mercatorstraat
650,Mercatorstraat 36,2023-05-10,04:00:00,20,11,9,FMN 02 Mercatorstraat
650,Mercatorstraat 36,2023-05-10,05:00:00,46,28,18,FMN 02 Mercatorstraat
650,Mercatorstraat 36,2023-05-10,06:00:00,122,70,52,FMN 02 Mercatorstraat
650,Mercatorstraat 36,2023-05-10,07:00:00,404,254,150,FMN 02 Mercatorstraat
650,Mercatorstraat 36,2023-05-10,08:00:00,912,642,270,FMN 02 Mercatorstraat
650,Mercatorstraat 36,2023-05-10,09:00:00,392,290,102,FMN 02 Mercatorstraat
650,Mercatorstraat 36,2023-05-10,10:00:00,266,166,100,FMN 02 Mercatorstraat
650,Mercatorstraat 36,2023-05-10,11:00:00,265,130,135,FMN 02 Mercatorstraat
650,Mercatorstraat 36,2023-05-10,12:00:00,520,192,328,FMN 02 Mercatorstraat
650,Mercatorstraat 36,2023-05-10,13:00:00,340,146,194,FMN 02 Mercatorstraat
650,Mercatorstraat 36,2023-05-10,14:00:00,284,141,143,FMN 02 Mercatorstraat
650,Mercatorstraat 36,2023-05-10,15:00:00,319,130,189,FMN 02 Mercatorstraat
650,Mercatorstraat 36,2023-05-10,16:00:00,493,178,315,FMN 02 Mercatorstraat
650,Mercatorstraat 36,2023-05-10,17:00:00,577,210,367,FMN 02 Mercatorstraat
650,Mercatorstraat 36,2023-05-10,18:00:00,465,186,279,FMN 02 Mercatorstraat
650,Mercatorstraat 36,2023-05-10,19:00:00,332,158,174,FMN 02 Mercatorstraat
650,Mercatorstraat 36,2023-05-10,20:00:00,203,90,113,FMN 02 Mercatorstraat
650,Mercatorstraat 36,2023-05-10,21:00:00,202,84,118,FMN 02 Mercatorstraat
650,Mercatorstraat 36,2023-05-10,22:00:00,181,58,123,FMN 02 Mercatorstraat
650,Mercatorstraat 36,2023-05-10,23:00:00,97,26,71,FMN 02 Mercatorstraat
650,Mercatorstraat 36,2023-05-11,00:00:00,63,20,43,FMN 02 Mercatorstraat
650,Mercatorstraat 36,2023-05-11,01:00:00,23,10,13,FMN 02 Mercatorstraat
650,Mercatorstraat 36,2023-05-11,02:00:00,22,3,19,FMN 02 Mercatorstraat
650,Mercatorstraat 36,2023-05-11,03:00:00,18,8,10,FMN 02 Mercatorstraat
650,Mercatorstraat 36,2023-05-11,04:00:00,27,18,9,FMN 02 Mercatorstraat
650,Mercatorstraat 36,2023-05-11,05:00:00,50,33,17,FMN 02 Mercatorstraat
650,Mercatorstraat 36,2023-05-11,06:00:00,136,78,58,FMN 02 Mercatorstraat
650,Mercatorstraat 36,2023-05-11,07:00:00,410,257,153,FMN 02 Mercatorstraat
650,Mercatorstraat 36,2023-05-11,08:00:00,1100,765,335,FMN 02 Mercatorstraat
650,Mercatorstraat 36,2023-05-11,09:00:00,458,332,126,FMN 02 Mercatorstraat
650,Mercatorstraat 36,2023-05-11,10:00:00,269,168,101,FMN 02 Mercatorstraat
650,Mercatorstraat 36,2023-05-11,11:00:00,234,136,98,FMN 02 Mercatorstraat
650,Mercatorstraat 36,2023-05-11,12:00:00,374,199,175,FMN 02 Mercatorstraat
650,Mercatorstraat 36,2023-05-11,13:00:00,382,185,197,FMN 02 Mercatorstraat
650,Mercatorstraat 36,2023-05-11,14:00:00,380,204,176,FMN 02 Mercatorstraat
650,Mercatorstraat 36,2023-05-11,15:00:00,476,152,324,FMN 02 Mercatorstraat
650,Mercatorstraat 36,2023-05-11,16:00:00,610,189,421,FMN 02 Mercatorstraat
650,Mercatorstraat 36,2023-05-11,17:00:00,748,254,494,FMN 02 Mercatorstraat
650,Mercatorstraat 36,2023-05-11,18:00:00,565,221,344,FMN 02 Mercatorstraat
650,Mercatorstraat 36,2023-05-11,19:00:00,338,169,169,FMN 02 Mercatorstraat
650,Mercatorstraat 36,2023-05-11,20:00:00,226,90,136,FMN 02 Mercatorstraat
650,Mercatorstraat 36,2023-05-11,21:00:00,203,84,119,FMN 02 Mercatorstraat
650,Mercatorstraat 36,2023-05-11,22:00:00,236,85,151,FMN 02 Mercatorstraat
650,Mercatorstraat 36,2023-05-11,23:00:00,128,46,82,FMN 02 Mercatorstraat
650,Mercatorstraat 36,2023-05-12,00:00:00,85,40,45,FMN 02 Mercatorstraat
650,Mercatorstraat 36,2023-05-12,01:00:00,38,16,22,FMN 02 Mercatorstraat
650,Mercatorstraat 36,2023-05-12,02:00:00,30,10,20,FMN 02 Mercatorstraat
650,Mercatorstraat 36,2023-05-12,03:00:00,28,4,24,FMN 02 Mercatorstraat
650,Mercatorstraat 36,2023-05-12,04:00:00,32,17,15,FMN 02 Mercatorstraat
650,Mercatorstraat 36,2023-05-12,05:00:00,48,24,24,FMN 02 Mercatorstraat
650,Mercatorstraat 36,2023-05-12,06:00:00,92,49,43,FMN 02 Mercatorstraat
650,Mercatorstraat 36,2023-05-12,07:00:00,279,176,103,FMN 02 Mercatorstraat
650,Mercatorstraat 36,2023-05-12,08:00:00,752,514,238,FMN 02 Mercatorstraat
650,Mercatorstraat 36,2023-05-12,09:00:00,372,288,84,FMN 02 Mercatorstraat
650,Mercatorstraat 36,2023-05-12,10:00:00,225,130,95,FMN 02 Mercatorstraat
650,Mercatorstraat 36,2023-05-12,11:00:00,196,117,79,FMN 02 Mercatorstraat
650,Mercatorstraat 36,2023-05-12,12:00:00,348,169,179,FMN 02 Mercatorstraat
650,Mercatorstraat 36,2023-05-12,13:00:00,347,175,172,FMN 02 Mercatorstraat
650,Mercatorstraat 36,2023-05-12,14:00:00,334,145,189,FMN 02 Mercatorstraat
650,Mercatorstraat 36,2023-05-12,15:00:00,492,190,302,FMN 02 Mercatorstraat
650,Mercatorstraat 36,2023-05-12,16:00:00,587,215,372,FMN 02 Mercatorstraat
650,Mercatorstraat 36,2023-05-12,17:00:00,619,215,404,FMN 02 Mercatorstraat
650,Mercatorstraat 36,2023-05-12,18:00:00,474,217,257,FMN 02 Mercatorstraat
650,Mercatorstraat 36,2023-05-12,19:00:00,426,261,165,FMN 02 Mercatorstraat
650,Mercatorstraat 36,2023-05-12,20:00:00,291,158,133,FMN 02 Mercatorstraat
650,Mercatorstraat 36,2023-05-12,21:00:00,231,98,133,FMN 02 Mercatorstraat
650,Mercatorstraat 36,2023-05-12,22:00:00,258,74,184,FMN 02 Mercatorstraat
650,Mercatorstraat 36,2023-05-12,23:00:00,221,97,124,FMN 02 Mercatorstraat
650,Mercatorstraat 36,2023-05-13,00:00:00,213,83,130,FMN 02 Mercatorstraat
650,Mercatorstraat 36,2023-05-13,01:00:00,137,61,76,FMN 02 Mercatorstraat
650,Mercatorstraat 36,2023-05-13,02:00:00,84,40,44,FMN 02 Mercatorstraat
650,Mercatorstraat 36,2023-05-13,03:00:00,77,30,47,FMN 02 Mercatorstraat
650,Mercatorstraat 36,2023-05-13,04:00:00,76,25,51,FMN 02 Mercatorstraat
650,Mercatorstraat 36,2023-05-13,05:00:00,50,22,28,FMN 02 Mercatorstraat
650,Mercatorstraat 36,2023-05-13,06:00:00,49,20,29,FMN 02 Mercatorstraat
650,Mercatorstraat 36,2023-05-13,07:00:00,57,35,22,FMN 02 Mercatorstraat
650,Mercatorstraat 36,2023-05-13,08:00:00,105,57,48,FMN 02 Mercatorstraat
650,Mercatorstraat 36,2023-05-13,09:00:00,258,190,68,FMN 02 Mercatorstraat
650,Mercatorstraat 36,2023-05-13,10:00:00,336,235,101,FMN 02 Mercatorstraat
650,Mercatorstraat 36,2023-05-13,11:00:00,338,220,118,FMN 02 Mercatorstraat
650,Mercatorstraat 36,2023-05-13,12:00:00,418,202,216,FMN 02 Mercatorstraat
650,Mercatorstraat 36,2023-05-13,13:00:00,428,251,177,FMN 02 Mercatorstraat
650,Mercatorstraat 36,2023-05-13,14:00:00,432,243,189,FMN 02 Mercatorstraat
650,Mercatorstraat 36,2023-05-13,15:00:00,435,199,236,FMN 02 Mercatorstraat
650,Mercatorstraat 36,2023-05-13,16:00:00,349,126,223,FMN 02 Mercatorstraat
650,Mercatorstraat 36,2023-05-13,17:00:00,372,165,207,FMN 02 Mercatorstraat
650,Mercatorstraat 36,2023-05-13,18:00:00,403,188,215,FMN 02 Mercatorstraat
650,Mercatorstraat 36,2023-05-13,19:00:00,277,154,123,FMN 02 Mercatorstraat
650,Mercatorstraat 36,2023-05-13,20:00:00,241,120,121,FMN 02 Mercatorstraat
650,Mercatorstraat 36,2023-05-13,21:00:00,242,124,118,FMN 02 Mercatorstraat
650,Mercatorstraat 36,2023-05-13,22:00:00,187,90,97,FMN 02 Mercatorstraat
650,Mercatorstraat 36,2023-05-13,23:00:00,201,72,129,FMN 02 Mercatorstraat
650,Mercatorstraat 36,2023-05-14,00:00:00,149,53,96,FMN 02 Mercatorstraat
650,Mercatorstraat 36,2023-05-14,01:00:00,184,55,129,FMN 02 Mercatorstraat
650,Mercatorstraat 36,2023-05-14,02:00:00,124,36,88,FMN 02 Mercatorstraat
650,Mercatorstraat 36,2023-05-14,03:00:00,75,27,48,FMN 02 Mercatorstraat
650,Mercatorstraat 36,2023-05-14,04:00:00,49,21,28,FMN 02 Mercatorstraat
650,Mercatorstraat 36,2023-05-14,05:00:00,34,21,13,FMN 02 Mercatorstraat
650,Mercatorstraat 36,2023-05-14,06:00:00,30,17,13,FMN 02 Mercatorstraat
650,Mercatorstraat 36,2023-05-14,07:00:00,46,22,24,FMN 02 Mercatorstraat
650,Mercatorstraat 36,2023-05-14,08:00:00,134,79,55,FMN 02 Mercatorstraat
650,Mercatorstraat 36,2023-05-14,09:00:00,322,190,132,FMN 02 Mercatorstraat
650,Mercatorstraat 36,2023-05-14,10:00:00,202,120,82,FMN 02 Mercatorstraat
650,Mercatorstraat 36,2023-05-14,11:00:00,254,138,116,FMN 02 Mercatorstraat
650,Mercatorstraat 36,2023-05-14,12:00:00,314,161,153,FMN 02 Mercatorstraat
650,Mercatorstraat 36,2023-05-14,13:00:00,406,226,180,FMN 02 Mercatorstraat
650,Mercatorstraat 36,2023-05-14,14:00:00,347,201,146,FMN 02 Mercatorstraat
650,Mercatorstraat 36,2023-05-14,15:00:00,306,162,144,FMN 02 Mercatorstraat
650,Mercatorstraat 36,2023-05-14,16:00:00,346,147,199,FMN 02 Mercatorstraat
650,Mercatorstraat 36,2023-05-14,17:00:00,398,146,252,FMN 02 Mercatorstraat
650,Mercatorstraat 36,2023-05-14,18:00:00,286,107,179,FMN 02 Mercatorstraat
650,Mercatorstraat 36,2023-05-14,19:00:00,241,107,134,FMN 02 Mercatorstraat
650,Mercatorstraat 36,2023-05-14,20:00:00,189,93,96,FMN 02 Mercatorstraat
650,Mercatorstraat 36,2023-05-14,21:00:00,180,86,94,FMN 02 Mercatorstraat
650,Mercatorstraat 36,2023-05-14,22:00:00,138,50,88,FMN 02 Mercatorstraat
650,Mercatorstraat 36,2023-05-14,23:00:00,76,25,51,FMN 02 Mercatorstraat
650,Mercatorstraat 36,2023-05-15,00:00:00,40,19,21,FMN 02 Mercatorstraat
650,Mercatorstraat 36,2023-05-15,01:00:00,20,7,13,FMN 02 Mercatorstraat
650,Mercatorstraat 36,2023-05-15,02:00:00,16,8,8,FMN 02 Mercatorstraat
650,Mercatorstraat 36,2023-05-15,03:00:00,11,5,6,FMN 02 Mercatorstraat
650,Mercatorstraat 36,2023-05-15,04:00:00,27,15,12,FMN 02 Mercatorstraat
650,Mercatorstraat 36,2023-05-15,05:00:00,52,32,20,FMN 02 Mercatorstraat
650,Mercatorstraat 36,2023-05-15,06:00:00,136,78,58,FMN 02 Mercatorstraat
650,Mercatorstraat 36,2023-05-15,07:00:00,433,273,160,FMN 02 Mercatorstraat
650,Mercatorstraat 36,2023-05-15,08:00:00,997,703,294,FMN 02 Mercatorstraat
650,Mercatorstraat 36,2023-05-15,09:00:00,433,309,124,FMN 02 Mercatorstraat
650,Mercatorstraat 36,2023-05-15,10:00:00,249,178,71,FMN 02 Mercatorstraat
650,Mercatorstraat 36,2023-05-15,11:00:00,219,125,94,FMN 02 Mercatorstraat
650,Mercatorstraat 36,2023-05-15,12:00:00,328,146,182,FMN 02 Mercatorstraat
650,Mercatorstraat 36,2023-05-15,13:00:00,284,122,162,FMN 02 Mercatorstraat
650,Mercatorstraat 36,2023-05-15,14:00:00,217,91,126,FMN 02 Mercatorstraat
650,Mercatorstraat 36,2023-05-15,15:00:00,416,129,287,FMN 02 Mercatorstraat
650,Mercatorstraat 36,2023-05-15,16:00:00,629,204,425,FMN 02 Mercatorstraat
650,Mercatorstraat 36,2023-05-15,17:00:00,694,215,479,FMN 02 Mercatorstraat
650,Mercatorstraat 36,2023-05-15,18:00:00,521,203,318,FMN 02 Mercatorstraat
650,Mercatorstraat 36,2023-05-15,19:00:00,277,121,156,FMN 02 Mercatorstraat
650,Mercatorstraat 36,2023-05-15,20:00:00,193,85,108,FMN 02 Mercatorstraat
650,Mercatorstraat 36,2023-05-15,21:00:00,185,66,119,FMN 02 Mercatorstraat
650,Mercatorstraat 36,2023-05-15,22:00:00,145,52,93,FMN 02 Mercatorstraat
650,Mercatorstraat 36,2023-05-15,23:00:00,83,25,58,FMN 02 Mercatorstraat
650,Mercatorstraat 36,2023-05-16,00:00:00,31,12,19,FMN 02 Mercatorstraat
650,Mercatorstraat 36,2023-05-16,01:00:00,20,9,11,FMN 02 Mercatorstraat
650,Mercatorstraat 36,2023-05-16,02:00:00,14,4,10,FMN 02 Mercatorstraat
650,Mercatorstraat 36,2023-05-16,03:00:00,9,1,8,FMN 02 Mercatorstraat
650,Mercatorstraat 36,2023-05-16,04:00:00,29,18,11,FMN 02 Mercatorstraat
650,Mercatorstraat 36,2023-05-16,05:00:00,53,38,15,FMN 02 Mercatorstraat
650,Mercatorstraat 36,2023-05-16,06:00:00,138,76,62,FMN 02 Mercatorstraat
650,Mercatorstraat 36,2023-05-16,07:00:00,463,311,152,FMN 02 Mercatorstraat
650,Mercatorstraat 36,2023-05-16,08:00:00,1121,796,325,FMN 02 Mercatorstraat
650,Mercatorstraat 36,2023-05-16,09:00:00,529,390,139,FMN 02 Mercatorstraat
650,Mercatorstraat 36,2023-05-16,10:00:00,333,235,98,FMN 02 Mercatorstraat
650,Mercatorstraat 36,2023-05-16,11:00:00,229,125,104,FMN 02 Mercatorstraat
650,Mercatorstraat 36,2023-05-16,12:00:00,380,187,193,FMN 02 Mercatorstraat
650,Mercatorstraat 36,2023-05-16,13:00:00,418,204,214,FMN 02 Mercatorstraat
650,Mercatorstraat 36,2023-05-16,14:00:00,323,144,179,FMN 02 Mercatorstraat
650,Mercatorstraat 36,2023-05-16,15:00:00,497,165,332,FMN 02 Mercatorstraat
650,Mercatorstraat 36,2023-05-16,16:00:00,733,265,468,FMN 02 Mercatorstraat
650,Mercatorstraat 36,2023-05-16,17:00:00,826,254,572,FMN 02 Mercatorstraat
650,Mercatorstraat 36,2023-05-16,18:00:00,651,239,412,FMN 02 Mercatorstraat
650,Mercatorstraat 36,2023-05-16,19:00:00,390,144,246,FMN 02 Mercatorstraat
650,Mercatorstraat 36,2023-05-16,20:00:00,294,111,183,FMN 02 Mercatorstraat
650,Mercatorstraat 36,2023-05-16,21:00:00,279,104,175,FMN 02 Mercatorstraat
650,Mercatorstraat 36,2023-05-16,22:00:00,189,77,112,FMN 02 Mercatorstraat
650,Mercatorstraat 36,2023-05-16,23:00:00,134,45,89,FMN 02 Mercatorstraat
650,Mercatorstraat 36,2023-05-17,00:00:00,35,16,19,FMN 02 Mercatorstraat
650,Mercatorstraat 36,2023-05-17,01:00:00,22,5,17,FMN 02 Mercatorstraat
650,Mercatorstraat 36,2023-05-17,02:00:00,19,4,15,FMN 02 Mercatorstraat
650,Mercatorstraat 36,2023-05-17,03:00:00,14,4,10,FMN 02 Mercatorstraat
650,Mercatorstraat 36,2023-05-17,04:00:00,23,14,9,FMN 02 Mercatorstraat
650,Mercatorstraat 36,2023-05-17,05:00:00,58,39,19,FMN 02 Mercatorstraat
650,Mercatorstraat 36,2023-05-17,06:00:00,119,63,56,FMN 02 Mercatorstraat
650,Mercatorstraat 36,2023-05-17,07:00:00,428,278,150,FMN 02 Mercatorstraat
650,Mercatorstraat 36,2023-05-17,08:00:00,882,606,276,FMN 02 Mercatorstraat
650,Mercatorstraat 36,2023-05-17,09:00:00,464,347,117,FMN 02 Mercatorstraat
650,Mercatorstraat 36,2023-05-17,10:00:00,301,179,122,FMN 02 Mercatorstraat
650,Mercatorstraat 36,2023-05-17,11:00:00,284,158,126,FMN 02 Mercatorstraat
650,Mercatorstraat 36,2023-05-17,12:00:00,577,246,331,FMN 02 Mercatorstraat
650,Mercatorstraat 36,2023-05-17,13:00:00,514,234,280,FMN 02 Mercatorstraat
650,Mercatorstraat 36,2023-05-17,14:00:00,360,191,169,FMN 02 Mercatorstraat
650,Mercatorstraat 36,2023-05-17,15:00:00,397,175,222,FMN 02 Mercatorstraat
650,Mercatorstraat 36,2023-05-17,16:00:00,578,195,383,FMN 02 Mercatorstraat
650,Mercatorstraat 36,2023-05-17,17:00:00,754,258,496,FMN 02 Mercatorstraat
650,Mercatorstraat 36,2023-05-17,18:00:00,582,236,346,FMN 02 Mercatorstraat
650,Mercatorstraat 36,2023-05-17,19:00:00,425,225,200,FMN 02 Mercatorstraat
650,Mercatorstraat 36,2023-05-17,20:00:00,329,146,183,FMN 02 Mercatorstraat
650,Mercatorstraat 36,2023-05-17,21:00:00,305,135,170,FMN 02 Mercatorstraat
650,Mercatorstraat 36,2023-05-17,22:00:00,207,80,127,FMN 02 Mercatorstraat
650,Mercatorstraat 36,2023-05-17,23:00:00,220,82,138,FMN 02 Mercatorstraat
650,Mercatorstraat 36,2023-05-18,00:00:00,126,44,82,FMN 02 Mercatorstraat
650,Mercatorstraat 36,2023-05-18,01:00:00,101,33,68,FMN 02 Mercatorstraat
650,Mercatorstraat 36,2023-05-18,02:00:00,75,23,52,FMN 02 Mercatorstraat
650,Mercatorstraat 36,2023-05-18,03:00:00,44,13,31,FMN 02 Mercatorstraat
650,Mercatorstraat 36,2023-05-18,04:00:00,41,12,29,FMN 02 Mercatorstraat
650,Mercatorstraat 36,2023-05-18,05:00:00,30,14,16,FMN 02 Mercatorstraat
650,Mercatorstraat 36,2023-05-18,06:00:00,40,19,21,FMN 02 Mercatorstraat
650,Mercatorstraat 36,2023-05-18,07:00:00,108,47,61,FMN 02 Mercatorstraat
650,Mercatorstraat 36,2023-05-18,08:00:00,152,72,80,FMN 02 Mercatorstraat
650,Mercatorstraat 36,2023-05-18,09:00:00,238,131,107,FMN 02 Mercatorstraat
650,Mercatorstraat 36,2023-05-18,10:00:00,282,178,104,FMN 02 Mercatorstraat
650,Mercatorstraat 36,2023-05-18,11:00:00,241,153,88,FMN 02 Mercatorstraat
650,Mercatorstraat 36,2023-05-18,12:00:00,295,166,129,FMN 02 Mercatorstraat
650,Mercatorstraat 36,2023-05-18,13:00:00,357,196,161,FMN 02 Mercatorstraat
650,Mercatorstraat 36,2023-05-18,14:00:00,404,229,175,FMN 02 Mercatorstraat
650,Mercatorstraat 36,2023-05-18,15:00:00,356,168,188,FMN 02 Mercatorstraat
650,Mercatorstraat 36,2023-05-18,16:00:00,314,133,181,FMN 02 Mercatorstraat
650,Mercatorstraat 36,2023-05-18,17:00:00,318,129,189,FMN 02 Mercatorstraat
650,Mercatorstraat 36,2023-05-18,18:00:00,396,208,188,FMN 02 Mercatorstraat
650,Mercatorstraat 36,2023-05-18,19:00:00,318,165,153,FMN 02 Mercatorstraat
650,Mercatorstraat 36,2023-05-18,20:00:00,246,101,145,FMN 02 Mercatorstraat
650,Mercatorstraat 36,2023-05-18,21:00:00,220,79,141,FMN 02 Mercatorstraat
650,Mercatorstraat 36,2023-05-18,22:00:00,184,61,123,FMN 02 Mercatorstraat
650,Mercatorstraat 36,2023-05-18,23:00:00,199,83,116,FMN 02 Mercatorstraat
650,Mercatorstraat 36,2023-05-19,00:00:00,88,49,39,FMN 02 Mercatorstraat
650,Mercatorstraat 36,2023-05-19,01:00:00,92,58,34,FMN 02 Mercatorstraat
650,Mercatorstraat 36,2023-05-19,02:00:00,50,28,22,FMN 02 Mercatorstraat
650,Mercatorstraat 36,2023-05-19,03:00:00,30,7,23,FMN 02 Mercatorstraat
650,Mercatorstraat 36,2023-05-19,04:00:00,43,20,23,FMN 02 Mercatorstraat
650,Mercatorstraat 36,2023-05-19,05:00:00,49,25,24,FMN 02 Mercatorstraat
650,Mercatorstraat 36,2023-05-19,06:00:00,60,40,20,FMN 02 Mercatorstraat
650,Mercatorstraat 36,2023-05-19,07:00:00,144,66,78,FMN 02 Mercatorstraat
650,Mercatorstraat 36,2023-05-19,08:00:00,284,178,106,FMN 02 Mercatorstraat
650,Mercatorstraat 36,2023-05-19,09:00:00,331,203,128,FMN 02 Mercatorstraat
650,Mercatorstraat 36,2023-05-19,10:00:00,296,226,70,FMN 02 Mercatorstraat
650,Mercatorstraat 36,2023-05-19,11:00:00,387,258,129,FMN 02 Mercatorstraat
650,Mercatorstraat 36,2023-05-19,12:00:00,388,212,176,FMN 02 Mercatorstraat
650,Mercatorstraat 36,2023-05-19,13:00:00,408,224,184,FMN 02 Mercatorstraat
650,Mercatorstraat 36,2023-05-19,14:00:00,454,269,185,FMN 02 Mercatorstraat
650,Mercatorstraat 36,2023-05-19,15:00:00,410,175,235,FMN 02 Mercatorstraat
650,Mercatorstraat 36,2023-05-19,16:00:00,462,210,252,FMN 02 Mercatorstraat
650,Mercatorstraat 36,2023-05-19,17:00:00,493,215,278,FMN 02 Mercatorstraat
650,Mercatorstraat 36,2023-05-19,18:00:00,438,163,275,FMN 02 Mercatorstraat
650,Mercatorstraat 36,2023-05-19,19:00:00,333,175,158,FMN 02 Mercatorstraat
650,Mercatorstraat 36,2023-05-19,20:00:00,252,118,134,FMN 02 Mercatorstraat
650,Mercatorstraat 36,2023-05-19,21:00:00,222,81,141,FMN 02 Mercatorstraat
650,Mercatorstraat 36,2023-05-19,22:00:00,213,78,135,FMN 02 Mercatorstraat
650,Mercatorstraat 36,2023-05-19,23:00:00,200,73,127,FMN 02 Mercatorstraat
650,Mercatorstraat 36,2023-05-20,00:00:00,123,49,74,FMN 02 Mercatorstraat
650,Mercatorstraat 36,2023-05-20,01:00:00,106,39,67,FMN 02 Mercatorstraat
650,Mercatorstraat 36,2023-05-20,02:00:00,55,27,28,FMN 02 Mercatorstraat
650,Mercatorstraat 36,2023-05-20,03:00:00,50,18,32,FMN 02 Mercatorstraat
650,Mercatorstraat 36,2023-05-20,04:00:00,51,19,32,FMN 02 Mercatorstraat
650,Mercatorstraat 36,2023-05-20,05:00:00,45,23,22,FMN 02 Mercatorstraat
650,Mercatorstraat 36,2023-05-20,06:00:00,55,21,34,FMN 02 Mercatorstraat
650,Mercatorstraat 36,2023-05-20,07:00:00,43,25,18,FMN 02 Mercatorstraat
650,Mercatorstraat 36,2023-05-20,08:00:00,97,62,35,FMN 02 Mercatorstraat
650,Mercatorstraat 36,2023-05-20,09:00:00,210,156,54,FMN 02 Mercatorstraat
650,Mercatorstraat 36,2023-05-20,10:00:00,314,222,92,FMN 02 Mercatorstraat
650,Mercatorstraat 36,2023-05-20,11:00:00,328,194,134,FMN 02 Mercatorstraat
650,Mercatorstraat 36,2023-05-20,12:00:00,322,177,145,FMN 02 Mercatorstraat
650,Mercatorstraat 36,2023-05-20,13:00:00,379,224,155,FMN 02 Mercatorstraat
650,Mercatorstraat 36,2023-05-20,14:00:00,443,242,201,FMN 02 Mercatorstraat
650,Mercatorstraat 36,2023-05-20,15:00:00,342,196,146,FMN 02 Mercatorstraat
650,Mercatorstraat 36,2023-05-20,16:00:00,346,165,181,FMN 02 Mercatorstraat
650,Mercatorstraat 36,2023-05-20,17:00:00,346,133,213,FMN 02 Mercatorstraat
650,Mercatorstraat 36,2023-05-20,18:00:00,320,129,191,FMN 02 Mercatorstraat
650,Mercatorstraat 36,2023-05-20,19:00:00,261,131,130,FMN 02 Mercatorstraat
650,Mercatorstraat 36,2023-05-20,20:00:00,231,101,130,FMN 02 Mercatorstraat
650,Mercatorstraat 36,2023-05-20,21:00:00,210,87,123,FMN 02 Mercatorstraat
650,Mercatorstraat 36,2023-05-20,22:00:00,186,84,102,FMN 02 Mercatorstraat
650,Mercatorstraat 36,2023-05-20,23:00:00,209,82,127,FMN 02 Mercatorstraat
650,Mercatorstraat 36,2023-05-21,00:00:00,169,77,92,FMN 02 Mercatorstraat
650,Mercatorstraat 36,2023-05-21,01:00:00,118,53,65,FMN 02 Mercatorstraat
650,Mercatorstraat 36,2023-05-21,02:00:00,53,21,32,FMN 02 Mercatorstraat
650,Mercatorstraat 36,2023-05-21,03:00:00,56,23,33,FMN 02 Mercatorstraat
650,Mercatorstraat 36,2023-05-21,04:00:00,24,6,18,FMN 02 Mercatorstraat
650,Mercatorstraat 36,2023-05-21,05:00:00,38,12,26,FMN 02 Mercatorstraat
650,Mercatorstraat 36,2023-05-21,06:00:00,41,14,27,FMN 02 Mercatorstraat
650,Mercatorstraat 36,2023-05-21,07:00:00,70,36,34,FMN 02 Mercatorstraat
650,Mercatorstraat 36,2023-05-21,08:00:00,106,49,57,FMN 02 Mercatorstraat
650,Mercatorstraat 36,2023-05-21,09:00:00,242,113,129,FMN 02 Mercatorstraat
650,Mercatorstraat 36,2023-05-21,10:00:00,256,156,100,FMN 02 Mercatorstraat
650,Mercatorstraat 36,2023-05-21,11:00:00,283,159,124,FMN 02 Mercatorstraat
650,Mercatorstraat 36,2023-05-21,12:00:00,330,177,153,FMN 02 Mercatorstraat
650,Mercatorstraat 36,2023-05-21,13:00:00,450,243,207,FMN 02 Mercatorstraat
650,Mercatorstraat 36,2023-05-21,14:00:00,386,231,155,FMN 02 Mercatorstraat
650,Mercatorstraat 36,2023-05-21,15:00:00,378,221,157,FMN 02 Mercatorstraat
650,Mercatorstraat 36,2023-05-21,16:00:00,335,155,180,FMN 02 Mercatorstraat
650,Mercatorstraat 36,2023-05-21,17:00:00,340,127,213,FMN 02 Mercatorstraat
650,Mercatorstraat 36,2023-05-21,18:00:00,364,160,204,FMN 02 Mercatorstraat
650,Mercatorstraat 36,2023-05-21,19:00:00,264,119,145,FMN 02 Mercatorstraat
650,Mercatorstraat 36,2023-05-21,20:00:00,250,117,133,FMN 02 Mercatorstraat
650,Mercatorstraat 36,2023-05-21,21:00:00,182,79,103,FMN 02 Mercatorstraat
650,Mercatorstraat 36,2023-05-21,22:00:00,168,74,94,FMN 02 Mercatorstraat
650,Mercatorstraat 36,2023-05-21,23:00:00,83,37,46,FMN 02 Mercatorstraat
650,Mercatorstraat 36,2023-05-22,00:00:00,44,14,30,FMN 02 Mercatorstraat
650,Mercatorstraat 36,2023-05-22,01:00:00,17,10,7,FMN 02 Mercatorstraat
650,Mercatorstraat 36,2023-05-22,02:00:00,13,5,8,FMN 02 Mercatorstraat
650,Mercatorstraat 36,2023-05-22,03:00:00,12,6,6,FMN 02 Mercatorstraat
650,Mercatorstraat 36,2023-05-22,04:00:00,25,19,6,FMN 02 Mercatorstraat
650,Mercatorstraat 36,2023-05-22,05:00:00,54,35,19,FMN 02 Mercatorstraat
650,Mercatorstraat 36,2023-05-22,06:00:00,133,90,43,FMN 02 Mercatorstraat
650,Mercatorstraat 36,2023-05-22,07:00:00,504,329,175,FMN 02 Mercatorstraat
650,Mercatorstraat 36,2023-05-22,08:00:00,1106,774,332,FMN 02 Mercatorstraat
650,Mercatorstraat 36,2023-05-22,09:00:00,498,379,119,FMN 02 Mercatorstraat
650,Mercatorstraat 36,2023-05-22,10:00:00,303,190,113,FMN 02 Mercatorstraat
650,Mercatorstraat 36,2023-05-22,11:00:00,259,152,107,FMN 02 Mercatorstraat
650,Mercatorstraat 36,2023-05-22,12:00:00,390,214,176,FMN 02 Mercatorstraat
650,Mercatorstraat 36,2023-05-22,13:00:00,366,163,203,FMN 02 Mercatorstraat
650,Mercatorstraat 36,2023-05-22,14:00:00,358,158,200,FMN 02 Mercatorstraat
650,Mercatorstraat 36,2023-05-22,15:00:00,538,192,346,FMN 02 Mercatorstraat
650,Mercatorstraat 36,2023-05-22,16:00:00,784,241,543,FMN 02 Mercatorstraat
650,Mercatorstraat 36,2023-05-22,17:00:00,862,279,583,FMN 02 Mercatorstraat
650,Mercatorstraat 36,2023-05-22,18:00:00,622,207,415,FMN 02 Mercatorstraat
650,Mercatorstraat 36,2023-05-22,19:00:00,342,146,196,FMN 02 Mercatorstraat
650,Mercatorstraat 36,2023-05-22,20:00:00,238,115,123,FMN 02 Mercatorstraat
650,Mercatorstraat 36,2023-05-22,21:00:00,221,88,133,FMN 02 Mercatorstraat
650,Mercatorstraat 36,2023-05-22,22:00:00,179,69,110,FMN 02 Mercatorstraat
650,Mercatorstraat 36,2023-05-22,23:00:00,103,27,76,FMN 02 Mercatorstraat
650,Mercatorstraat 36,2023-05-23,00:00:00,52,15,37,FMN 02 Mercatorstraat
650,Mercatorstraat 36,2023-05-23,01:00:00,17,4,13,FMN 02 Mercatorstraat
650,Mercatorstraat 36,2023-05-23,02:00:00,19,7,12,FMN 02 Mercatorstraat
650,Mercatorstraat 36,2023-05-23,03:00:00,11,5,6,FMN 02 Mercatorstraat
650,Mercatorstraat 36,2023-05-23,04:00:00,28,18,10,FMN 02 Mercatorstraat
650,Mercatorstraat 36,2023-05-23,05:00:00,46,32,14,FMN 02 Mercatorstraat
650,Mercatorstraat 36,2023-05-23,06:00:00,168,111,57,FMN 02 Mercatorstraat
650,Mercatorstraat 36,2023-05-23,07:00:00,472,304,168,FMN 02 Mercatorstraat
650,Mercatorstraat 36,2023-05-23,08:00:00,1141,820,321,FMN 02 Mercatorstraat
650,Mercatorstraat 36,2023-05-23,09:00:00,567,429,138,FMN 02 Mercatorstraat
650,Mercatorstraat 36,2023-05-23,10:00:00,285,188,97,FMN 02 Mercatorstraat
650,Mercatorstraat 36,2023-05-23,11:00:00,264,133,131,FMN 02 Mercatorstraat
650,Mercatorstraat 36,2023-05-23,12:00:00,382,204,178,FMN 02 Mercatorstraat
650,Mercatorstraat 36,2023-05-23,13:00:00,376,185,191,FMN 02 Mercatorstraat
650,Mercatorstraat 36,2023-05-23,14:00:00,382,160,222,FMN 02 Mercatorstraat
650,Mercatorstraat 36,2023-05-23,15:00:00,544,195,349,FMN 02 Mercatorstraat
650,Mercatorstraat 36,2023-05-23,16:00:00,765,275,490,FMN 02 Mercatorstraat
650,Mercatorstraat 36,2023-05-23,17:00:00,918,297,621,FMN 02 Mercatorstraat
650,Mercatorstraat 36,2023-05-23,18:00:00,647,253,394,FMN 02 Mercatorstraat
650,Mercatorstraat 36,2023-05-23,19:00:00,384,159,225,FMN 02 Mercatorstraat
650,Mercatorstraat 36,2023-05-23,20:00:00,243,117,126,FMN 02 Mercatorstraat
650,Mercatorstraat 36,2023-05-23,21:00:00,256,113,143,FMN 02 Mercatorstraat
650,Mercatorstraat 36,2023-05-23,22:00:00,202,68,134,FMN 02 Mercatorstraat
650,Mercatorstraat 36,2023-05-23,23:00:00,128,46,82,FMN 02 Mercatorstraat
650,Mercatorstraat 36,2023-05-24,00:00:00,55,16,39,FMN 02 Mercatorstraat
650,Mercatorstraat 36,2023-05-24,01:00:00,26,4,22,FMN 02 Mercatorstraat
650,Mercatorstraat 36,2023-05-24,02:00:00,13,4,9,FMN 02 Mercatorstraat
650,Mercatorstraat 36,2023-05-24,03:00:00,8,3,5,FMN 02 Mercatorstraat
650,Mercatorstraat 36,2023-05-24,04:00:00,29,15,14,FMN 02 Mercatorstraat
650,Mercatorstraat 36,2023-05-24,05:00:00,54,37,17,FMN 02 Mercatorstraat
650,Mercatorstraat 36,2023-05-24,06:00:00,162,97,65,FMN 02 Mercatorstraat
650,Mercatorstraat 36,2023-05-24,07:00:00,454,292,162,FMN 02 Mercatorstraat
650,Mercatorstraat 36,2023-05-24,08:00:00,966,664,302,FMN 02 Mercatorstraat
650,Mercatorstraat 36,2023-05-24,09:00:00,462,348,114,FMN 02 Mercatorstraat
650,Mercatorstraat 36,2023-05-24,10:00:00,296,181,115,FMN 02 Mercatorstraat
650,Mercatorstraat 36,2023-05-24,11:00:00,299,158,141,FMN 02 Mercatorstraat
650,Mercatorstraat 36,2023-05-24,12:00:00,583,269,314,FMN 02 Mercatorstraat
650,Mercatorstraat 36,2023-05-24,13:00:00,456,205,251,FMN 02 Mercatorstraat
650,Mercatorstraat 36,2023-05-24,14:00:00,414,172,242,FMN 02 Mercatorstraat
650,Mercatorstraat 36,2023-05-24,15:00:00,390,150,240,FMN 02 Mercatorstraat
650,Mercatorstraat 36,2023-05-24,16:00:00,614,226,388,FMN 02 Mercatorstraat
650,Mercatorstraat 36,2023-05-24,17:00:00,778,272,506,FMN 02 Mercatorstraat
650,Mercatorstraat 36,2023-05-24,18:00:00,652,289,363,FMN 02 Mercatorstraat
650,Mercatorstraat 36,2023-05-24,19:00:00,336,149,187,FMN 02 Mercatorstraat
650,Mercatorstraat 36,2023-05-24,20:00:00,262,116,146,FMN 02 Mercatorstraat
650,Mercatorstraat 36,2023-05-24,21:00:00,235,107,128,FMN 02 Mercatorstraat
650,Mercatorstraat 36,2023-05-24,22:00:00,241,79,162,FMN 02 Mercatorstraat
650,Mercatorstraat 36,2023-05-24,23:00:00,121,45,76,FMN 02 Mercatorstraat
650,Mercatorstraat 36,2023-05-25,00:00:00,56,19,37,FMN 02 Mercatorstraat
650,Mercatorstraat 36,2023-05-25,01:00:00,23,6,17,FMN 02 Mercatorstraat
650,Mercatorstraat 36,2023-05-25,02:00:00,20,4,16,FMN 02 Mercatorstraat
650,Mercatorstraat 36,2023-05-25,03:00:00,14,5,9,FMN 02 Mercatorstraat
650,Mercatorstraat 36,2023-05-25,04:00:00,31,16,15,FMN 02 Mercatorstraat
650,Mercatorstraat 36,2023-05-25,05:00:00,58,34,24,FMN 02 Mercatorstraat
650,Mercatorstraat 36,2023-05-25,06:00:00,129,87,42,FMN 02 Mercatorstraat
650,Mercatorstraat 36,2023-05-25,07:00:00,461,286,175,FMN 02 Mercatorstraat
650,Mercatorstraat 36,2023-05-25,08:00:00,1114,793,321,FMN 02 Mercatorstraat
650,Mercatorstraat 36,2023-05-25,09:00:00,478,355,123,FMN 02 Mercatorstraat
650,Mercatorstraat 36,2023-05-25,10:00:00,270,174,96,FMN 02 Mercatorstraat
650,Mercatorstraat 36,2023-05-25,11:00:00,299,168,131,FMN 02 Mercatorstraat
650,Mercatorstraat 36,2023-05-25,12:00:00,411,221,190,FMN 02 Mercatorstraat
650,Mercatorstraat 36,2023-05-25,13:00:00,364,174,190,FMN 02 Mercatorstraat
650,Mercatorstraat 36,2023-05-25,14:00:00,351,161,190,FMN 02 Mercatorstraat
650,Mercatorstraat 36,2023-05-25,15:00:00,493,169,324,FMN 02 Mercatorstraat
650,Mercatorstraat 36,2023-05-25,16:00:00,788,292,496,FMN 02 Mercatorstraat
650,Mercatorstraat 36,2023-05-25,17:00:00,857,300,557,FMN 02 Mercatorstraat
650,Mercatorstraat 36,2023-05-25,18:00:00,666,294,372,FMN 02 Mercatorstraat
650,Mercatorstraat 36,2023-05-25,19:00:00,408,203,205,FMN 02 Mercatorstraat
650,Mercatorstraat 36,2023-05-25,20:00:00,264,138,126,FMN 02 Mercatorstraat
650,Mercatorstraat 36,2023-05-25,21:00:00,283,105,178,FMN 02 Mercatorstraat
650,Mercatorstraat 36,2023-05-25,22:00:00,281,90,191,FMN 02 Mercatorstraat
650,Mercatorstraat 36,2023-05-25,23:00:00,152,42,110,FMN 02 Mercatorstraat
650,Mercatorstraat 36,2023-05-26,00:00:00,87,27,60,FMN 02 Mercatorstraat
650,Mercatorstraat 36,2023-05-26,01:00:00,38,12,26,FMN 02 Mercatorstraat
650,Mercatorstraat 36,2023-05-26,02:00:00,17,5,12,FMN 02 Mercatorstraat
650,Mercatorstraat 36,2023-05-26,03:00:00,9,5,4,FMN 02 Mercatorstraat
650,Mercatorstraat 36,2023-05-26,04:00:00,29,19,10,FMN 02 Mercatorstraat
650,Mercatorstraat 36,2023-05-26,05:00:00,56,33,23,FMN 02 Mercatorstraat
650,Mercatorstraat 36,2023-05-26,06:00:00,109,66,43,FMN 02 Mercatorstraat
650,Mercatorstraat 36,2023-05-26,07:00:00,369,245,124,FMN 02 Mercatorstraat
650,Mercatorstraat 36,2023-05-26,08:00:00,818,621,197,FMN 02 Mercatorstraat
650,Mercatorstraat 36,2023-05-26,09:00:00,402,307,95,FMN 02 Mercatorstraat
650,Mercatorstraat 36,2023-05-26,10:00:00,278,168,110,FMN 02 Mercatorstraat
650,Mercatorstraat 36,2023-05-26,11:00:00,252,143,109,FMN 02 Mercatorstraat
650,Mercatorstraat 36,2023-05-26,12:00:00,396,202,194,FMN 02 Mercatorstraat
650,Mercatorstraat 36,2023-05-26,13:00:00,383,188,195,FMN 02 Mercatorstraat
650,Mercatorstraat 36,2023-05-26,14:00:00,390,190,200,FMN 02 Mercatorstraat
650,Mercatorstraat 36,2023-05-26,15:00:00,538,184,354,FMN 02 Mercatorstraat
650,Mercatorstraat 36,2023-05-26,16:00:00,663,212,451,FMN 02 Mercatorstraat
650,Mercatorstraat 36,2023-05-26,17:00:00,674,247,427,FMN 02 Mercatorstraat
650,Mercatorstraat 36,2023-05-26,18:00:00,526,213,313,FMN 02 Mercatorstraat
650,Mercatorstraat 36,2023-05-26,19:00:00,432,244,188,FMN 02 Mercatorstraat
650,Mercatorstraat 36,2023-05-26,20:00:00,292,125,167,FMN 02 Mercatorstraat
650,Mercatorstraat 36,2023-05-26,21:00:00,245,120,125,FMN 02 Mercatorstraat
650,Mercatorstraat 36,2023-05-26,22:00:00,277,106,171,FMN 02 Mercatorstraat
650,Mercatorstraat 36,2023-05-26,23:00:00,226,87,139,FMN 02 Mercatorstraat
650,Mercatorstraat 36,2023-05-27,00:00:00,166,66,100,FMN 02 Mercatorstraat
650,Mercatorstraat 36,2023-05-27,01:00:00,100,36,64,FMN 02 Mercatorstraat
650,Mercatorstraat 36,2023-05-27,02:00:00,75,29,46,FMN 02 Mercatorstraat
650,Mercatorstraat 36,2023-05-27,03:00:00,54,17,37,FMN 02 Mercatorstraat
650,Mercatorstraat 36,2023-05-27,04:00:00,35,9,26,FMN 02 Mercatorstraat
650,Mercatorstraat 36,2023-05-27,05:00:00,43,16,27,FMN 02 Mercatorstraat
650,Mercatorstraat 36,2023-05-27,06:00:00,54,30,24,FMN 02 Mercatorstraat
650,Mercatorstraat 36,2023-05-27,07:00:00,58,32,26,FMN 02 Mercatorstraat
650,Mercatorstraat 36,2023-05-27,08:00:00,88,55,33,FMN 02 Mercatorstraat
650,Mercatorstraat 36,2023-05-27,09:00:00,216,167,49,FMN 02 Mercatorstraat
650,Mercatorstraat 36,2023-05-27,10:00:00,300,199,101,FMN 02 Mercatorstraat
650,Mercatorstraat 36,2023-05-27,11:00:00,421,227,194,FMN 02 Mercatorstraat
650,Mercatorstraat 36,2023-05-27,12:00:00,368,204,164,FMN 02 Mercatorstraat
650,Mercatorstraat 36,2023-05-27,13:00:00,458,281,177,FMN 02 Mercatorstraat
650,Mercatorstraat 36,2023-05-27,14:00:00,480,259,221,FMN 02 Mercatorstraat
650,Mercatorstraat 36,2023-05-27,15:00:00,391,207,184,FMN 02 Mercatorstraat
650,Mercatorstraat 36,2023-05-27,16:00:00,416,176,240,FMN 02 Mercatorstraat
650,Mercatorstraat 36,2023-05-27,17:00:00,381,160,221,FMN 02 Mercatorstraat
650,Mercatorstraat 36,2023-05-27,18:00:00,379,142,237,FMN 02 Mercatorstraat
650,Mercatorstraat 36,2023-05-27,19:00:00,299,172,127,FMN 02 Mercatorstraat
650,Mercatorstraat 36,2023-05-27,20:00:00,208,104,104,FMN 02 Mercatorstraat
650,Mercatorstraat 36,2023-05-27,21:00:00,193,91,102,FMN 02 Mercatorstraat
650,Mercatorstraat 36,2023-05-27,22:00:00,224,94,130,FMN 02 Mercatorstraat
650,Mercatorstraat 36,2023-05-27,23:00:00,201,60,141,FMN 02 Mercatorstraat
650,Mercatorstraat 36,2023-05-28,00:00:00,146,59,87,FMN 02 Mercatorstraat
650,Mercatorstraat 36,2023-05-28,01:00:00,108,44,64,FMN 02 Mercatorstraat
650,Mercatorstraat 36,2023-05-28,02:00:00,88,36,52,FMN 02 Mercatorstraat
650,Mercatorstraat 36,2023-05-28,03:00:00,64,16,48,FMN 02 Mercatorstraat
650,Mercatorstraat 36,2023-05-28,04:00:00,41,10,31,FMN 02 Mercatorstraat
650,Mercatorstraat 36,2023-05-28,05:00:00,39,13,26,FMN 02 Mercatorstraat
650,Mercatorstraat 36,2023-05-28,06:00:00,42,23,19,FMN 02 Mercatorstraat
650,Mercatorstraat 36,2023-05-28,07:00:00,47,27,20,FMN 02 Mercatorstraat
650,Mercatorstraat 36,2023-05-28,08:00:00,93,66,27,FMN 02 Mercatorstraat
650,Mercatorstraat 36,2023-05-28,09:00:00,190,135,55,FMN 02 Mercatorstraat
650,Mercatorstraat 36,2023-05-28,10:00:00,267,163,104,FMN 02 Mercatorstraat
650,Mercatorstraat 36,2023-05-28,11:00:00,288,190,98,FMN 02 Mercatorstraat
650,Mercatorstraat 36,2023-05-28,12:00:00,322,164,158,FMN 02 Mercatorstraat
650,Mercatorstraat 36,2023-05-28,13:00:00,393,221,172,FMN 02 Mercatorstraat
650,Mercatorstraat 36,2023-05-28,14:00:00,435,248,187,FMN 02 Mercatorstraat
650,Mercatorstraat 36,2023-05-28,15:00:00,370,187,183,FMN 02 Mercatorstraat
650,Mercatorstraat 36,2023-05-28,16:00:00,327,150,177,FMN 02 Mercatorstraat
650,Mercatorstraat 36,2023-05-28,17:00:00,354,136,218,FMN 02 Mercatorstraat
650,Mercatorstraat 36,2023-05-28,18:00:00,366,168,198,FMN 02 Mercatorstraat
650,Mercatorstraat 36,2023-05-28,19:00:00,298,162,136,FMN 02 Mercatorstraat
650,Mercatorstraat 36,2023-05-28,20:00:00,233,106,127,FMN 02 Mercatorstraat
650,Mercatorstraat 36,2023-05-28,21:00:00,219,98,121,FMN 02 Mercatorstraat
650,Mercatorstraat 36,2023-05-28,22:00:00,170,63,107,FMN 02 Mercatorstraat
650,Mercatorstraat 36,2023-05-28,23:00:00,165,59,106,FMN 02 Mercatorstraat
650,Mercatorstraat 36,2023-05-29,00:00:00,132,66,66,FMN 02 Mercatorstraat
650,Mercatorstraat 36,2023-05-29,01:00:00,70,23,47,FMN 02 Mercatorstraat
650,Mercatorstraat 36,2023-05-29,02:00:00,56,21,35,FMN 02 Mercatorstraat
650,Mercatorstraat 36,2023-05-29,03:00:00,45,17,28,FMN 02 Mercatorstraat
650,Mercatorstraat 36,2023-05-29,04:00:00,31,8,23,FMN 02 Mercatorstraat
650,Mercatorstraat 36,2023-05-29,05:00:00,49,22,27,FMN 02 Mercatorstraat
650,Mercatorstraat 36,2023-05-29,06:00:00,47,24,23,FMN 02 Mercatorstraat
650,Mercatorstraat 36,2023-05-29,07:00:00,63,27,36,FMN 02 Mercatorstraat
650,Mercatorstraat 36,2023-05-29,08:00:00,111,63,48,FMN 02 Mercatorstraat
650,Mercatorstraat 36,2023-05-29,09:00:00,228,131,97,FMN 02 Mercatorstraat
650,Mercatorstraat 36,2023-05-29,10:00:00,208,135,73,FMN 02 Mercatorstraat
650,Mercatorstraat 36,2023-05-29,11:00:00,267,157,110,FMN 02 Mercatorstraat
650,Mercatorstraat 36,2023-05-29,12:00:00,292,163,129,FMN 02 Mercatorstraat
650,Mercatorstraat 36,2023-05-29,13:00:00,358,222,136,FMN 02 Mercatorstraat
650,Mercatorstraat 36,2023-05-29,14:00:00,376,208,168,FMN 02 Mercatorstraat
650,Mercatorstraat 36,2023-05-29,15:00:00,389,205,184,FMN 02 Mercatorstraat
650,Mercatorstraat 36,2023-05-29,16:00:00,343,149,194,FMN 02 Mercatorstraat
650,Mercatorstraat 36,2023-05-29,17:00:00,362,146,216,FMN 02 Mercatorstraat
650,Mercatorstraat 36,2023-05-29,18:00:00,300,140,160,FMN 02 Mercatorstraat
650,Mercatorstraat 36,2023-05-29,19:00:00,286,153,133,FMN 02 Mercatorstraat
650,Mercatorstraat 36,2023-05-29,20:00:00,208,99,109,FMN 02 Mercatorstraat
650,Mercatorstraat 36,2023-05-29,21:00:00,206,81,125,FMN 02 Mercatorstraat
650,Mercatorstraat 36,2023-05-29,22:00:00,153,65,88,FMN 02 Mercatorstraat
650,Mercatorstraat 36,2023-05-29,23:00:00,116,37,79,FMN 02 Mercatorstraat
650,Mercatorstraat 36,2023-05-30,00:00:00,47,15,32,FMN 02 Mercatorstraat
650,Mercatorstraat 36,2023-05-30,01:00:00,17,8,9,FMN 02 Mercatorstraat
650,Mercatorstraat 36,2023-05-30,02:00:00,11,5,6,FMN 02 Mercatorstraat
650,Mercatorstraat 36,2023-05-30,03:00:00,10,2,8,FMN 02 Mercatorstraat
650,Mercatorstraat 36,2023-05-30,04:00:00,29,13,16,FMN 02 Mercatorstraat
650,Mercatorstraat 36,2023-05-30,05:00:00,59,37,22,FMN 02 Mercatorstraat
650,Mercatorstraat 36,2023-05-30,06:00:00,142,85,57,FMN 02 Mercatorstraat
650,Mercatorstraat 36,2023-05-30,07:00:00,463,302,161,FMN 02 Mercatorstraat
650,Mercatorstraat 36,2023-05-30,08:00:00,1113,781,332,FMN 02 Mercatorstraat
650,Mercatorstraat 36,2023-05-30,09:00:00,486,360,126,FMN 02 Mercatorstraat
650,Mercatorstraat 36,2023-05-30,10:00:00,315,172,143,FMN 02 Mercatorstraat
650,Mercatorstraat 36,2023-05-30,11:00:00,296,157,139,FMN 02 Mercatorstraat
650,Mercatorstraat 36,2023-05-30,12:00:00,375,195,180,FMN 02 Mercatorstraat
650,Mercatorstraat 36,2023-05-30,13:00:00,380,181,199,FMN 02 Mercatorstraat
650,Mercatorstraat 36,2023-05-30,14:00:00,338,180,158,FMN 02 Mercatorstraat
650,Mercatorstraat 36,2023-05-30,15:00:00,522,179,343,FMN 02 Mercatorstraat
650,Mercatorstraat 36,2023-05-30,16:00:00,788,263,525,FMN 02 Mercatorstraat
650,Mercatorstraat 36,2023-05-30,17:00:00,920,307,613,FMN 02 Mercatorstraat
650,Mercatorstraat 36,2023-05-30,18:00:00,666,260,406,FMN 02 Mercatorstraat
650,Mercatorstraat 36,2023-05-30,19:00:00,360,171,189,FMN 02 Mercatorstraat
650,Mercatorstraat 36,2023-05-30,20:00:00,251,103,148,FMN 02 Mercatorstraat
650,Mercatorstraat 36,2023-05-30,21:00:00,264,124,140,FMN 02 Mercatorstraat
650,Mercatorstraat 36,2023-05-30,22:00:00,217,86,131,FMN 02 Mercatorstraat
650,Mercatorstraat 36,2023-05-30,23:00:00,103,38,65,FMN 02 Mercatorstraat
650,Mercatorstraat 36,2023-05-31,00:00:00,45,18,27,FMN 02 Mercatorstraat
650,Mercatorstraat 36,2023-05-31,01:00:00,25,10,15,FMN 02 Mercatorstraat
650,Mercatorstraat 36,2023-05-31,02:00:00,14,2,12,FMN 02 Mercatorstraat
650,Mercatorstraat 36,2023-05-31,03:00:00,17,7,10,FMN 02 Mercatorstraat
650,Mercatorstraat 36,2023-05-31,04:00:00,40,19,21,FMN 02 Mercatorstraat
650,Mercatorstraat 36,2023-05-31,05:00:00,55,29,26,FMN 02 Mercatorstraat
650,Mercatorstraat 36,2023-05-31,06:00:00,141,90,51,FMN 02 Mercatorstraat
650,Mercatorstraat 36,2023-05-31,07:00:00,437,292,145,FMN 02 Mercatorstraat
650,Mercatorstraat 36,2023-05-31,08:00:00,1032,710,322,FMN 02 Mercatorstraat
650,Mercatorstraat 36,2023-05-31,09:00:00,468,345,123,FMN 02 Mercatorstraat
650,Mercatorstraat 36,2023-05-31,10:00:00,263,158,105,FMN 02 Mercatorstraat
650,Mercatorstraat 36,2023-05-31,11:00:00,345,165,180,FMN 02 Mercatorstraat
650,Mercatorstraat 36,2023-05-31,12:00:00,579,215,364,FMN 02 Mercatorstraat
650,Mercatorstraat 36,2023-05-31,13:00:00,517,240,277,FMN 02 Mercatorstraat
650,Mercatorstraat 36,2023-05-31,14:00:00,387,186,201,FMN 02 Mercatorstraat
650,Mercatorstraat 36,2023-05-31,15:00:00,425,189,236,FMN 02 Mercatorstraat
650,Mercatorstraat 36,2023-05-31,16:00:00,584,220,364,FMN 02 Mercatorstraat
650,Mercatorstraat 36,2023-05-31,17:00:00,849,308,541,FMN 02 Mercatorstraat
650,Mercatorstraat 36,2023-05-31,18:00:00,663,281,382,FMN 02 Mercatorstraat
650,Mercatorstraat 36,2023-05-31,19:00:00,401,201,200,FMN 02 Mercatorstraat
650,Mercatorstraat 36,2023-05-31,20:00:00,291,125,166,FMN 02 Mercatorstraat
650,Mercatorstraat 36,2023-05-31,21:00:00,276,108,168,FMN 02 Mercatorstraat
650,Mercatorstraat 36,2023-05-31,22:00:00,310,114,196,FMN 02 Mercatorstraat
650,Mercatorstraat 36,2023-05-31,23:00:00,153,48,105,FMN 02 Mercatorstraat
650,Mercatorstraat 36,2023-06-01,00:00:00,79,22,57,FMN 02 Mercatorstraat
650,Mercatorstraat 36,2023-06-01,01:00:00,27,14,13,FMN 02 Mercatorstraat
650,Mercatorstraat 36,2023-06-01,02:00:00,21,5,16,FMN 02 Mercatorstraat
650,Mercatorstraat 36,2023-06-01,03:00:00,12,3,9,FMN 02 Mercatorstraat
650,Mercatorstraat 36,2023-06-01,04:00:00,42,20,22,FMN 02 Mercatorstraat
650,Mercatorstraat 36,2023-06-01,05:00:00,59,36,23,FMN 02 Mercatorstraat
650,Mercatorstraat 36,2023-06-01,06:00:00,144,88,56,FMN 02 Mercatorstraat
650,Mercatorstraat 36,2023-06-01,07:00:00,455,306,149,FMN 02 Mercatorstraat
650,Mercatorstraat 36,2023-06-01,08:00:00,1133,796,337,FMN 02 Mercatorstraat
650,Mercatorstraat 36,2023-06-01,09:00:00,531,395,136,FMN 02 Mercatorstraat
650,Mercatorstraat 36,2023-06-01,10:00:00,293,183,110,FMN 02 Mercatorstraat
650,Mercatorstraat 36,2023-06-01,11:00:00,288,167,121,FMN 02 Mercatorstraat
650,Mercatorstraat 36,2023-06-01,12:00:00,407,226,181,FMN 02 Mercatorstraat
650,Mercatorstraat 36,2023-06-01,13:00:00,412,183,229,FMN 02 Mercatorstraat
650,Mercatorstraat 36,2023-06-01,14:00:00,369,160,209,FMN 02 Mercatorstraat
650,Mercatorstraat 36,2023-06-01,15:00:00,546,184,362,FMN 02 Mercatorstraat
650,Mercatorstraat 36,2023-06-01,16:00:00,776,256,520,FMN 02 Mercatorstraat
650,Mercatorstraat 36,2023-06-01,17:00:00,890,350,540,FMN 02 Mercatorstraat
650,Mercatorstraat 36,2023-06-01,18:00:00,677,233,444,FMN 02 Mercatorstraat
650,Mercatorstraat 36,2023-06-01,19:00:00,393,191,202,FMN 02 Mercatorstraat
650,Mercatorstraat 36,2023-06-01,20:00:00,293,121,172,FMN 02 Mercatorstraat
650,Mercatorstraat 36,2023-06-01,21:00:00,306,115,191,FMN 02 Mercatorstraat
650,Mercatorstraat 36,2023-06-01,22:00:00,271,100,171,FMN 02 Mercatorstraat
650,Mercatorstraat 36,2023-06-01,23:00:00,163,65,98,FMN 02 Mercatorstraat
650,Mercatorstraat 36,2023-06-02,00:00:00,78,31,47,FMN 02 Mercatorstraat
650,Mercatorstraat 36,2023-06-02,01:00:00,47,18,29,FMN 02 Mercatorstraat
650,Mercatorstraat 36,2023-06-02,02:00:00,26,7,19,FMN 02 Mercatorstraat
650,Mercatorstraat 36,2023-06-02,03:00:00,18,4,14,FMN 02 Mercatorstraat
650,Mercatorstraat 36,2023-06-02,04:00:00,44,24,20,FMN 02 Mercatorstraat
650,Mercatorstraat 36,2023-06-02,05:00:00,51,33,18,FMN 02 Mercatorstraat
650,Mercatorstraat 36,2023-06-02,06:00:00,146,86,60,FMN 02 Mercatorstraat
650,Mercatorstraat 36,2023-06-02,07:00:00,371,232,139,FMN 02 Mercatorstraat
650,Mercatorstraat 36,2023-06-02,08:00:00,944,668,276,FMN 02 Mercatorstraat
650,Mercatorstraat 36,2023-06-02,09:00:00,446,337,109,FMN 02 Mercatorstraat
650,Mercatorstraat 36,2023-06-02,10:00:00,353,239,114,FMN 02 Mercatorstraat
650,Mercatorstraat 36,2023-06-02,11:00:00,269,153,116,FMN 02 Mercatorstraat
650,Mercatorstraat 36,2023-06-02,12:00:00,448,244,204,FMN 02 Mercatorstraat
650,Mercatorstraat 36,2023-06-02,13:00:00,376,187,189,FMN 02 Mercatorstraat
650,Mercatorstraat 36,2023-06-02,14:00:00,403,174,229,FMN 02 Mercatorstraat
650,Mercatorstraat 36,2023-06-02,15:00:00,624,215,409,FMN 02 Mercatorstraat
650,Mercatorstraat 36,2023-06-02,16:00:00,651,221,430,FMN 02 Mercatorstraat
650,Mercatorstraat 36,2023-06-02,17:00:00,704,283,421,FMN 02 Mercatorstraat
650,Mercatorstraat 36,2023-06-02,18:00:00,584,256,328,FMN 02 Mercatorstraat
650,Mercatorstraat 36,2023-06-02,19:00:00,427,233,194,FMN 02 Mercatorstraat
650,Mercatorstraat 36,2023-06-02,20:00:00,274,145,129,FMN 02 Mercatorstraat
650,Mercatorstraat 36,2023-06-02,21:00:00,298,126,172,FMN 02 Mercatorstraat
650,Mercatorstraat 36,2023-06-02,22:00:00,269,89,180,FMN 02 Mercatorstraat
650,Mercatorstraat 36,2023-06-02,23:00:00,269,110,159,FMN 02 Mercatorstraat
650,Mercatorstraat 36,2023-06-03,00:00:00,168,59,109,FMN 02 Mercatorstraat
650,Mercatorstraat 36,2023-06-03,01:00:00,128,52,76,FMN 02 Mercatorstraat
650,Mercatorstraat 36,2023-06-03,02:00:00,73,22,51,FMN 02 Mercatorstraat
650,Mercatorstraat 36,2023-06-03,03:00:00,40,7,33,FMN 02 Mercatorstraat
650,Mercatorstraat 36,2023-06-03,04:00:00,51,19,32,FMN 02 Mercatorstraat
650,Mercatorstraat 36,2023-06-03,05:00:00,37,19,18,FMN 02 Mercatorstraat
650,Mercatorstraat 36,2023-06-03,06:00:00,39,20,19,FMN 02 Mercatorstraat
650,Mercatorstraat 36,2023-06-03,07:00:00,53,33,20,FMN 02 Mercatorstraat
650,Mercatorstraat 36,2023-06-03,08:00:00,142,98,44,FMN 02 Mercatorstraat
650,Mercatorstraat 36,2023-06-03,09:00:00,247,178,69,FMN 02 Mercatorstraat
650,Mercatorstraat 36,2023-06-03,10:00:00,336,234,102,FMN 02 Mercatorstraat
650,Mercatorstraat 36,2023-06-03,11:00:00,392,239,153,FMN 02 Mercatorstraat
650,Mercatorstraat 36,2023-06-03,12:00:00,387,223,164,FMN 02 Mercatorstraat
650,Mercatorstraat 36,2023-06-03,13:00:00,433,230,203,FMN 02 Mercatorstraat
650,Mercatorstraat 36,2023-06-03,14:00:00,421,234,187,FMN 02 Mercatorstraat
650,Mercatorstraat 36,2023-06-03,15:00:00,458,241,217,FMN 02 Mercatorstraat
650,Mercatorstraat 36,2023-06-03,16:00:00,420,167,253,FMN 02 Mercatorstraat
650,Mercatorstraat 36,2023-06-03,17:00:00,403,202,201,FMN 02 Mercatorstraat
650,Mercatorstraat 36,2023-06-03,18:00:00,441,210,231,FMN 02 Mercatorstraat
650,Mercatorstraat 36,2023-06-03,19:00:00,351,184,167,FMN 02 Mercatorstraat
650,Mercatorstraat 36,2023-06-03,20:00:00,276,135,141,FMN 02 Mercatorstraat
650,Mercatorstraat 36,2023-06-03,21:00:00,232,116,116,FMN 02 Mercatorstraat
650,Mercatorstraat 36,2023-06-03,22:00:00,174,63,111,FMN 02 Mercatorstraat
650,Mercatorstraat 36,2023-06-03,23:00:00,229,95,134,FMN 02 Mercatorstraat
650,Mercatorstraat 36,2023-06-04,00:00:00,181,60,121,FMN 02 Mercatorstraat
650,Mercatorstraat 36,2023-06-04,01:00:00,137,63,74,FMN 02 Mercatorstraat
650,Mercatorstraat 36,2023-06-04,02:00:00,111,38,73,FMN 02 Mercatorstraat
650,Mercatorstraat 36,2023-06-04,03:00:00,71,8,63,FMN 02 Mercatorstraat
650,Mercatorstraat 36,2023-06-04,04:00:00,58,11,47,FMN 02 Mercatorstraat
650,Mercatorstraat 36,2023-06-04,05:00:00,45,15,30,FMN 02 Mercatorstraat
650,Mercatorstraat 36,2023-06-04,06:00:00,33,18,15,FMN 02 Mercatorstraat
650,Mercatorstraat 36,2023-06-04,07:00:00,46,25,21,FMN 02 Mercatorstraat
650,Mercatorstraat 36,2023-06-04,08:00:00,130,69,61,FMN 02 Mercatorstraat
650,Mercatorstraat 36,2023-06-04,09:00:00,273,129,144,FMN 02 Mercatorstraat
650,Mercatorstraat 36,2023-06-04,10:00:00,250,176,74,FMN 02 Mercatorstraat
650,Mercatorstraat 36,2023-06-04,11:00:00,319,202,117,FMN 02 Mercatorstraat
650,Mercatorstraat 36,2023-06-04,12:00:00,412,244,168,FMN 02 Mercatorstraat
650,Mercatorstraat 36,2023-06-04,13:00:00,438,252,186,FMN 02 Mercatorstraat
650,Mercatorstraat 36,2023-06-04,14:00:00,496,281,215,FMN 02 Mercatorstraat
650,Mercatorstraat 36,2023-06-04,15:00:00,428,236,192,FMN 02 Mercatorstraat
650,Mercatorstraat 36,2023-06-04,16:00:00,381,157,224,FMN 02 Mercatorstraat
650,Mercatorstraat 36,2023-06-04,17:00:00,355,140,215,FMN 02 Mercatorstraat
650,Mercatorstraat 36,2023-06-04,18:00:00,371,151,220,FMN 02 Mercatorstraat
650,Mercatorstraat 36,2023-06-04,19:00:00,260,114,146,FMN 02 Mercatorstraat
650,Mercatorstraat 36,2023-06-04,20:00:00,268,123,145,FMN 02 Mercatorstraat
650,Mercatorstraat 36,2023-06-04,21:00:00,191,92,99,FMN 02 Mercatorstraat
650,Mercatorstraat 36,2023-06-04,22:00:00,178,73,105,FMN 02 Mercatorstraat
650,Mercatorstraat 36,2023-06-04,23:00:00,111,39,72,FMN 02 Mercatorstraat
650,Mercatorstraat 36,2023-06-05,00:00:00,57,18,39,FMN 02 Mercatorstraat
650,Mercatorstraat 36,2023-06-05,01:00:00,31,14,17,FMN 02 Mercatorstraat
650,Mercatorstraat 36,2023-06-05,02:00:00,20,6,14,FMN 02 Mercatorstraat
650,Mercatorstraat 36,2023-06-05,03:00:00,12,8,4,FMN 02 Mercatorstraat
650,Mercatorstraat 36,2023-06-05,04:00:00,33,18,15,FMN 02 Mercatorstraat
650,Mercatorstraat 36,2023-06-05,05:00:00,57,40,17,FMN 02 Mercatorstraat
650,Mercatorstraat 36,2023-06-05,06:00:00,133,77,56,FMN 02 Mercatorstraat
650,Mercatorstraat 36,2023-06-05,07:00:00,495,335,160,FMN 02 Mercatorstraat
650,Mercatorstraat 36,2023-06-05,08:00:00,1128,824,304,FMN 02 Mercatorstraat
650,Mercatorstraat 36,2023-06-05,09:00:00,453,332,121,FMN 02 Mercatorstraat
650,Mercatorstraat 36,2023-06-05,10:00:00,291,189,102,FMN 02 Mercatorstraat
650,Mercatorstraat 36,2023-06-05,11:00:00,295,185,110,FMN 02 Mercatorstraat
650,Mercatorstraat 36,2023-06-05,12:00:00,409,197,212,FMN 02 Mercatorstraat
650,Mercatorstraat 36,2023-06-05,13:00:00,389,190,199,FMN 02 Mercatorstraat
650,Mercatorstraat 36,2023-06-05,14:00:00,400,193,207,FMN 02 Mercatorstraat
650,Mercatorstraat 36,2023-06-05,15:00:00,569,218,351,FMN 02 Mercatorstraat
650,Mercatorstraat 36,2023-06-05,16:00:00,785,274,511,FMN 02 Mercatorstraat
650,Mercatorstraat 36,2023-06-05,17:00:00,1015,401,614,FMN 02 Mercatorstraat
650,Mercatorstraat 36,2023-06-05,18:00:00,673,295,378,FMN 02 Mercatorstraat
650,Mercatorstraat 36,2023-06-05,19:00:00,383,135,248,FMN 02 Mercatorstraat
650,Mercatorstraat 36,2023-06-05,20:00:00,322,117,205,FMN 02 Mercatorstraat
650,Mercatorstraat 36,2023-06-05,21:00:00,295,105,190,FMN 02 Mercatorstraat
650,Mercatorstraat 36,2023-06-05,22:00:00,217,73,144,FMN 02 Mercatorstraat
650,Mercatorstraat 36,2023-06-05,23:00:00,116,38,78,FMN 02 Mercatorstraat
650,Mercatorstraat 36,2023-06-06,00:00:00,54,17,37,FMN 02 Mercatorstraat
650,Mercatorstraat 36,2023-06-06,01:00:00,29,4,25,FMN 02 Mercatorstraat
650,Mercatorstraat 36,2023-06-06,02:00:00,20,8,12,FMN 02 Mercatorstraat
650,Mercatorstraat 36,2023-06-06,03:00:00,12,5,7,FMN 02 Mercatorstraat
650,Mercatorstraat 36,2023-06-06,04:00:00,38,20,18,FMN 02 Mercatorstraat
650,Mercatorstraat 36,2023-06-06,05:00:00,69,48,21,FMN 02 Mercatorstraat
650,Mercatorstraat 36,2023-06-06,06:00:00,157,100,57,FMN 02 Mercatorstraat
650,Mercatorstraat 36,2023-06-06,07:00:00,511,340,171,FMN 02 Mercatorstraat
650,Mercatorstraat 36,2023-06-06,08:00:00,1183,852,331,FMN 02 Mercatorstraat
650,Mercatorstraat 36,2023-06-06,09:00:00,522,394,128,FMN 02 Mercatorstraat
650,Mercatorstraat 36,2023-06-06,10:00:00,279,186,93,FMN 02 Mercatorstraat
650,Mercatorstraat 36,2023-06-06,11:00:00,305,164,141,FMN 02 Mercatorstraat
650,Mercatorstraat 36,2023-06-06,12:00:00,431,230,201,FMN 02 Mercatorstraat
650,Mercatorstraat 36,2023-06-06,13:00:00,432,191,241,FMN 02 Mercatorstraat
650,Mercatorstraat 36,2023-06-06,14:00:00,347,165,182,FMN 02 Mercatorstraat
650,Mercatorstraat 36,2023-06-06,15:00:00,550,181,369,FMN 02 Mercatorstraat
650,Mercatorstraat 36,2023-06-06,16:00:00,844,268,576,FMN 02 Mercatorstraat
650,Mercatorstraat 36,2023-06-06,17:00:00,931,311,620,FMN 02 Mercatorstraat
650,Mercatorstraat 36,2023-06-06,18:00:00,644,253,391,FMN 02 Mercatorstraat
650,Mercatorstraat 36,2023-06-06,19:00:00,399,170,229,FMN 02 Mercatorstraat
650,Mercatorstraat 36,2023-06-06,20:00:00,272,129,143,FMN 02 Mercatorstraat
650,Mercatorstraat 36,2023-06-06,21:00:00,237,84,153,FMN 02 Mercatorstraat
650,Mercatorstraat 36,2023-06-06,22:00:00,230,79,151,FMN 02 Mercatorstraat
650,Mercatorstraat 36,2023-06-06,23:00:00,139,53,86,FMN 02 Mercatorstraat
650,Mercatorstraat 36,2023-06-07,00:00:00,70,26,44,FMN 02 Mercatorstraat
650,Mercatorstraat 36,2023-06-07,01:00:00,31,9,22,FMN 02 Mercatorstraat
650,Mercatorstraat 36,2023-06-07,02:00:00,17,6,11,FMN 02 Mercatorstraat
650,Mercatorstraat 36,2023-06-07,03:00:00,13,4,9,FMN 02 Mercatorstraat
650,Mercatorstraat 36,2023-06-07,04:00:00,32,18,14,FMN 02 Mercatorstraat
650,Mercatorstraat 36,2023-06-07,05:00:00,62,41,21,FMN 02 Mercatorstraat
650,Mercatorstraat 36,2023-06-07,06:00:00,144,89,55,FMN 02 Mercatorstraat
650,Mercatorstraat 36,2023-06-07,07:00:00,439,301,138,FMN 02 Mercatorstraat
650,Mercatorstraat 36,2023-06-07,08:00:00,1017,723,294,FMN 02 Mercatorstraat
650,Mercatorstraat 36,2023-06-07,09:00:00,411,290,121,FMN 02 Mercatorstraat
650,Mercatorstraat 36,2023-06-07,10:00:00,299,183,116,FMN 02 Mercatorstraat
650,Mercatorstraat 36,2023-06-07,11:00:00,347,181,166,FMN 02 Mercatorstraat
650,Mercatorstraat 36,2023-06-07,12:00:00,595,259,336,FMN 02 Mercatorstraat
650,Mercatorstraat 36,2023-06-07,13:00:00,529,229,300,FMN 02 Mercatorstraat
650,Mercatorstraat 36,2023-06-07,14:00:00,438,219,219,FMN 02 Mercatorstraat
650,Mercatorstraat 36,2023-06-07,15:00:00,472,187,285,FMN 02 Mercatorstraat
650,Mercatorstraat 36,2023-06-07,16:00:00,617,249,368,FMN 02 Mercatorstraat
650,Mercatorstraat 36,2023-06-07,17:00:00,775,241,534,FMN 02 Mercatorstraat
650,Mercatorstraat 36,2023-06-07,18:00:00,667,288,379,FMN 02 Mercatorstraat
650,Mercatorstraat 36,2023-06-07,19:00:00,345,159,186,FMN 02 Mercatorstraat
650,Mercatorstraat 36,2023-06-07,20:00:00,263,120,143,FMN 02 Mercatorstraat
650,Mercatorstraat 36,2023-06-07,21:00:00,278,103,175,FMN 02 Mercatorstraat
650,Mercatorstraat 36,2023-06-07,22:00:00,295,107,188,FMN 02 Mercatorstraat
650,Mercatorstraat 36,2023-06-07,23:00:00,156,67,89,FMN 02 Mercatorstraat
650,Mercatorstraat 36,2023-06-08,00:00:00,77,24,53,FMN 02 Mercatorstraat
650,Mercatorstraat 36,2023-06-08,01:00:00,24,3,21,FMN 02 Mercatorstraat
650,Mercatorstraat 36,2023-06-08,02:00:00,17,3,14,FMN 02 Mercatorstraat
650,Mercatorstraat 36,2023-06-08,03:00:00,16,7,9,FMN 02 Mercatorstraat
650,Mercatorstraat 36,2023-06-08,04:00:00,31,18,13,FMN 02 Mercatorstraat
650,Mercatorstraat 36,2023-06-08,05:00:00,57,33,24,FMN 02 Mercatorstraat
650,Mercatorstraat 36,2023-06-08,06:00:00,173,117,56,FMN 02 Mercatorstraat
650,Mercatorstraat 36,2023-06-08,07:00:00,514,332,182,FMN 02 Mercatorstraat
650,Mercatorstraat 36,2023-06-08,08:00:00,1187,838,349,FMN 02 Mercatorstraat
650,Mercatorstraat 36,2023-06-08,09:00:00,520,401,119,FMN 02 Mercatorstraat
650,Mercatorstraat 36,2023-06-08,10:00:00,324,219,105,FMN 02 Mercatorstraat
650,Mercatorstraat 36,2023-06-08,11:00:00,348,205,143,FMN 02 Mercatorstraat
650,Mercatorstraat 36,2023-06-08,12:00:00,421,200,221,FMN 02 Mercatorstraat
650,Mercatorstraat 36,2023-06-08,13:00:00,426,210,216,FMN 02 Mercatorstraat
650,Mercatorstraat 36,2023-06-08,14:00:00,381,188,193,FMN 02 Mercatorstraat
650,Mercatorstraat 36,2023-06-08,15:00:00,598,203,395,FMN 02 Mercatorstraat
650,Mercatorstraat 36,2023-06-08,16:00:00,788,293,495,FMN 02 Mercatorstraat
650,Mercatorstraat 36,2023-06-08,17:00:00,909,338,571,FMN 02 Mercatorstraat
650,Mercatorstraat 36,2023-06-08,18:00:00,687,276,411,FMN 02 Mercatorstraat
650,Mercatorstraat 36,2023-06-08,19:00:00,462,215,247,FMN 02 Mercatorstraat
650,Mercatorstraat 36,2023-06-08,20:00:00,333,132,201,FMN 02 Mercatorstraat
650,Mercatorstraat 36,2023-06-08,21:00:00,299,115,184,FMN 02 Mercatorstraat
650,Mercatorstraat 36,2023-06-08,22:00:00,325,119,206,FMN 02 Mercatorstraat
650,Mercatorstraat 36,2023-06-08,23:00:00,230,80,150,FMN 02 Mercatorstraat
650,Mercatorstraat 36,2023-06-09,00:00:00,113,49,64,FMN 02 Mercatorstraat
650,Mercatorstraat 36,2023-06-09,01:00:00,57,26,31,FMN 02 Mercatorstraat
650,Mercatorstraat 36,2023-06-09,02:00:00,26,8,18,FMN 02 Mercatorstraat
650,Mercatorstraat 36,2023-06-09,03:00:00,19,5,14,FMN 02 Mercatorstraat
650,Mercatorstraat 36,2023-06-09,04:00:00,46,16,30,FMN 02 Mercatorstraat
650,Mercatorstraat 36,2023-06-09,05:00:00,64,33,31,FMN 02 Mercatorstraat
650,Mercatorstraat 36,2023-06-09,06:00:00,153,94,59,FMN 02 Mercatorstraat
650,Mercatorstraat 36,2023-06-09,07:00:00,411,259,152,FMN 02 Mercatorstraat
650,Mercatorstraat 36,2023-06-09,08:00:00,1018,736,282,FMN 02 Mercatorstraat
650,Mercatorstraat 36,2023-06-09,09:00:00,475,327,148,FMN 02 Mercatorstraat
650,Mercatorstraat 36,2023-06-09,10:00:00,371,232,139,FMN 02 Mercatorstraat
650,Mercatorstraat 36,2023-06-09,11:00:00,364,200,164,FMN 02 Mercatorstraat
650,Mercatorstraat 36,2023-06-09,12:00:00,552,281,271,FMN 02 Mercatorstraat
650,Mercatorstraat 36,2023-06-09,13:00:00,425,220,205,FMN 02 Mercatorstraat
650,Mercatorstraat 36,2023-06-09,14:00:00,413,180,233,FMN 02 Mercatorstraat
650,Mercatorstraat 36,2023-06-09,15:00:00,568,194,374,FMN 02 Mercatorstraat
650,Mercatorstraat 36,2023-06-09,16:00:00,701,245,456,FMN 02 Mercatorstraat
650,Mercatorstraat 36,2023-06-09,17:00:00,776,332,444,FMN 02 Mercatorstraat
650,Mercatorstraat 36,2023-06-09,18:00:00,582,266,316,FMN 02 Mercatorstraat
650,Mercatorstraat 36,2023-06-09,19:00:00,437,229,208,FMN 02 Mercatorstraat
650,Mercatorstraat 36,2023-06-09,20:00:00,320,152,168,FMN 02 Mercatorstraat
650,Mercatorstraat 36,2023-06-09,21:00:00,260,134,126,FMN 02 Mercatorstraat
650,Mercatorstraat 36,2023-06-09,22:00:00,295,90,205,FMN 02 Mercatorstraat
650,Mercatorstraat 36,2023-06-09,23:00:00,258,87,171,FMN 02 Mercatorstraat
650,Mercatorstraat 36,2023-06-10,00:00:00,233,71,162,FMN 02 Mercatorstraat
650,Mercatorstraat 36,2023-06-10,01:00:00,119,44,75,FMN 02 Mercatorstraat
650,Mercatorstraat 36,2023-06-10,02:00:00,104,34,70,FMN 02 Mercatorstraat
650,Mercatorstraat 36,2023-06-10,03:00:00,64,9,55,FMN 02 Mercatorstraat
650,Mercatorstraat 36,2023-06-10,04:00:00,30,10,20,FMN 02 Mercatorstraat
650,Mercatorstraat 36,2023-06-10,05:00:00,34,14,20,FMN 02 Mercatorstraat
650,Mercatorstraat 36,2023-06-10,06:00:00,45,26,19,FMN 02 Mercatorstraat
650,Mercatorstraat 36,2023-06-10,07:00:00,58,32,26,FMN 02 Mercatorstraat
650,Mercatorstraat 36,2023-06-10,08:00:00,132,86,46,FMN 02 Mercatorstraat
650,Mercatorstraat 36,2023-06-10,09:00:00,257,196,61,FMN 02 Mercatorstraat
650,Mercatorstraat 36,2023-06-10,10:00:00,359,261,98,FMN 02 Mercatorstraat
650,Mercatorstraat 36,2023-06-10,11:00:00,353,202,151,FMN 02 Mercatorstraat
650,Mercatorstraat 36,2023-06-10,12:00:00,398,196,202,FMN 02 Mercatorstraat
650,Mercatorstraat 36,2023-06-10,13:00:00,376,209,167,FMN 02 Mercatorstraat
650,Mercatorstraat 36,2023-06-10,14:00:00,396,228,168,FMN 02 Mercatorstraat
650,Mercatorstraat 36,2023-06-10,15:00:00,402,197,205,FMN 02 Mercatorstraat
650,Mercatorstraat 36,2023-06-10,16:00:00,370,167,203,FMN 02 Mercatorstraat
650,Mercatorstraat 36,2023-06-10,17:00:00,398,176,222,FMN 02 Mercatorstraat
650,Mercatorstraat 36,2023-06-10,18:00:00,389,176,213,FMN 02 Mercatorstraat
650,Mercatorstraat 36,2023-06-10,19:00:00,316,174,142,FMN 02 Mercatorstraat
650,Mercatorstraat 36,2023-06-10,20:00:00,266,139,127,FMN 02 Mercatorstraat
650,Mercatorstraat 36,2023-06-10,21:00:00,217,90,127,FMN 02 Mercatorstraat
650,Mercatorstraat 36,2023-06-10,22:00:00,204,89,115,FMN 02 Mercatorstraat
650,Mercatorstraat 36,2023-06-10,23:00:00,278,99,179,FMN 02 Mercatorstraat
650,Mercatorstraat 36,2023-06-11,00:00:00,222,76,146,FMN 02 Mercatorstraat
650,Mercatorstraat 36,2023-06-11,01:00:00,105,53,52,FMN 02 Mercatorstraat
650,Mercatorstraat 36,2023-06-11,02:00:00,94,25,69,FMN 02 Mercatorstraat
650,Mercatorstraat 36,2023-06-11,03:00:00,78,21,57,FMN 02 Mercatorstraat
650,Mercatorstraat 36,2023-06-11,04:00:00,62,17,45,FMN 02 Mercatorstraat
650,Mercatorstraat 36,2023-06-11,05:00:00,39,15,24,FMN 02 Mercatorstraat
650,Mercatorstraat 36,2023-06-11,06:00:00,53,26,27,FMN 02 Mercatorstraat
650,Mercatorstraat 36,2023-06-11,07:00:00,57,30,27,FMN 02 Mercatorstraat
650,Mercatorstraat 36,2023-06-11,08:00:00,156,87,69,FMN 02 Mercatorstraat
650,Mercatorstraat 36,2023-06-11,09:00:00,289,148,141,FMN 02 Mercatorstraat
650,Mercatorstraat 36,2023-06-11,10:00:00,279,176,103,FMN 02 Mercatorstraat
650,Mercatorstraat 36,2023-06-11,11:00:00,268,152,116,FMN 02 Mercatorstraat
650,Mercatorstraat 36,2023-06-11,12:00:00,332,182,150,FMN 02 Mercatorstraat
650,Mercatorstraat 36,2023-06-11,13:00:00,324,167,157,FMN 02 Mercatorstraat
650,Mercatorstraat 36,2023-06-11,14:00:00,347,202,145,FMN 02 Mercatorstraat
650,Mercatorstraat 36,2023-06-11,15:00:00,287,134,153,FMN 02 Mercatorstraat
650,Mercatorstraat 36,2023-06-11,16:00:00,284,133,151,FMN 02 Mercatorstraat
650,Mercatorstraat 36,2023-06-11,17:00:00,281,121,160,FMN 02 Mercatorstraat
650,Mercatorstraat 36,2023-06-11,18:00:00,286,122,164,FMN 02 Mercatorstraat
650,Mercatorstraat 36,2023-06-11,19:00:00,258,125,133,FMN 02 Mercatorstraat
650,Mercatorstraat 36,2023-06-11,20:00:00,223,120,103,FMN 02 Mercatorstraat
650,Mercatorstraat 36,2023-06-11,21:00:00,217,108,109,FMN 02 Mercatorstraat
650,Mercatorstraat 36,2023-06-11,22:00:00,201,87,114,FMN 02 Mercatorstraat
650,Mercatorstraat 36,2023-06-11,23:00:00,94,35,59,FMN 02 Mercatorstraat
650,Mercatorstraat 36,2023-06-12,00:00:00,56,17,39,FMN 02 Mercatorstraat
650,Mercatorstraat 36,2023-06-12,01:00:00,38,19,19,FMN 02 Mercatorstraat
650,Mercatorstraat 36,2023-06-12,02:00:00,15,8,7,FMN 02 Mercatorstraat
650,Mercatorstraat 36,2023-06-12,03:00:00,16,5,11,FMN 02 Mercatorstraat
650,Mercatorstraat 36,2023-06-12,04:00:00,30,16,14,FMN 02 Mercatorstraat
650,Mercatorstraat 36,2023-06-12,05:00:00,66,43,23,FMN 02 Mercatorstraat
650,Mercatorstraat 36,2023-06-12,06:00:00,160,92,68,FMN 02 Mercatorstraat
650,Mercatorstraat 36,2023-06-12,07:00:00,497,333,164,FMN 02 Mercatorstraat
650,Mercatorstraat 36,2023-06-12,08:00:00,1114,812,302,FMN 02 Mercatorstraat
650,Mercatorstraat 36,2023-06-12,09:00:00,458,350,108,FMN 02 Mercatorstraat
650,Mercatorstraat 36,2023-06-12,10:00:00,323,189,134,FMN 02 Mercatorstraat
650,Mercatorstraat 36,2023-06-12,11:00:00,311,147,164,FMN 02 Mercatorstraat
650,Mercatorstraat 36,2023-06-12,12:00:00,427,180,247,FMN 02 Mercatorstraat
650,Mercatorstraat 36,2023-06-12,13:00:00,399,194,205,FMN 02 Mercatorstraat
650,Mercatorstraat 36,2023-06-12,14:00:00,328,135,193,FMN 02 Mercatorstraat
650,Mercatorstraat 36,2023-06-12,15:00:00,463,170,293,FMN 02 Mercatorstraat
650,Mercatorstraat 36,2023-06-12,16:00:00,682,255,427,FMN 02 Mercatorstraat
650,Mercatorstraat 36,2023-06-12,17:00:00,815,274,541,FMN 02 Mercatorstraat
650,Mercatorstraat 36,2023-06-12,18:00:00,561,204,357,FMN 02 Mercatorstraat
650,Mercatorstraat 36,2023-06-12,19:00:00,352,172,180,FMN 02 Mercatorstraat
650,Mercatorstraat 36,2023-06-12,20:00:00,295,139,156,FMN 02 Mercatorstraat
650,Mercatorstraat 36,2023-06-12,21:00:00,252,95,157,FMN 02 Mercatorstraat
650,Mercatorstraat 36,2023-06-12,22:00:00,207,82,125,FMN 02 Mercatorstraat
650,Mercatorstraat 36,2023-06-12,23:00:00,110,45,65,FMN 02 Mercatorstraat
650,Mercatorstraat 36,2023-06-13,00:00:00,58,22,36,FMN 02 Mercatorstraat
650,Mercatorstraat 36,2023-06-13,01:00:00,26,5,21,FMN 02 Mercatorstraat
650,Mercatorstraat 36,2023-06-13,02:00:00,13,2,11,FMN 02 Mercatorstraat
650,Mercatorstraat 36,2023-06-13,03:00:00,14,7,7,FMN 02 Mercatorstraat
650,Mercatorstraat 36,2023-06-13,04:00:00,40,25,15,FMN 02 Mercatorstraat
650,Mercatorstraat 36,2023-06-13,05:00:00,68,39,29,FMN 02 Mercatorstraat
650,Mercatorstraat 36,2023-06-13,06:00:00,162,104,58,FMN 02 Mercatorstraat
650,Mercatorstraat 36,2023-06-13,07:00:00,542,355,187,FMN 02 Mercatorstraat
650,Mercatorstraat 36,2023-06-13,08:00:00,1137,811,326,FMN 02 Mercatorstraat
650,Mercatorstraat 36,2023-06-13,09:00:00,541,397,144,FMN 02 Mercatorstraat
650,Mercatorstraat 36,2023-06-13,10:00:00,321,197,124,FMN 02 Mercatorstraat
650,Mercatorstraat 36,2023-06-13,11:00:00,357,177,180,FMN 02 Mercatorstraat
650,Mercatorstraat 36,2023-06-13,12:00:00,466,197,269,FMN 02 Mercatorstraat
650,Mercatorstraat 36,2023-06-13,13:00:00,376,174,202,FMN 02 Mercatorstraat
650,Mercatorstraat 36,2023-06-13,14:00:00,371,152,219,FMN 02 Mercatorstraat
650,Mercatorstraat 36,2023-06-13,15:00:00,483,183,300,FMN 02 Mercatorstraat
650,Mercatorstraat 36,2023-06-13,16:00:00,710,238,472,FMN 02 Mercatorstraat
650,Mercatorstraat 36,2023-06-13,17:00:00,893,315,578,FMN 02 Mercatorstraat
650,Mercatorstraat 36,2023-06-13,18:00:00,645,229,416,FMN 02 Mercatorstraat
650,Mercatorstraat 36,2023-06-13,19:00:00,425,210,215,FMN 02 Mercatorstraat
650,Mercatorstraat 36,2023-06-13,20:00:00,321,139,182,FMN 02 Mercatorstraat
650,Mercatorstraat 36,2023-06-13,21:00:00,321,169,152,FMN 02 Mercatorstraat
650,Mercatorstraat 36,2023-06-13,22:00:00,273,102,171,FMN 02 Mercatorstraat
650,Mercatorstraat 36,2023-06-13,23:00:00,146,39,107,FMN 02 Mercatorstraat
650,Mercatorstraat 36,2023-06-14,00:00:00,85,34,51,FMN 02 Mercatorstraat
650,Mercatorstraat 36,2023-06-14,01:00:00,33,11,22,FMN 02 Mercatorstraat
650,Mercatorstraat 36,2023-06-14,02:00:00,18,4,14,FMN 02 Mercatorstraat
650,Mercatorstraat 36,2023-06-14,03:00:00,15,7,8,FMN 02 Mercatorstraat
650,Mercatorstraat 36,2023-06-14,04:00:00,38,25,13,FMN 02 Mercatorstraat
650,Mercatorstraat 36,2023-06-14,05:00:00,67,44,23,FMN 02 Mercatorstraat
650,Mercatorstraat 36,2023-06-14,06:00:00,143,93,50,FMN 02 Mercatorstraat
650,Mercatorstraat 36,2023-06-14,07:00:00,521,331,190,FMN 02 Mercatorstraat
650,Mercatorstraat 36,2023-06-14,08:00:00,1013,716,297,FMN 02 Mercatorstraat
650,Mercatorstraat 36,2023-06-14,09:00:00,497,353,144,FMN 02 Mercatorstraat
650,Mercatorstraat 36,2023-06-14,10:00:00,369,207,162,FMN 02 Mercatorstraat
650,Mercatorstraat 36,2023-06-14,11:00:00,394,181,213,FMN 02 Mercatorstraat
650,Mercatorstraat 36,2023-06-14,12:00:00,538,218,320,FMN 02 Mercatorstraat
650,Mercatorstraat 36,2023-06-14,13:00:00,448,209,239,FMN 02 Mercatorstraat
650,Mercatorstraat 36,2023-06-14,14:00:00,365,172,193,FMN 02 Mercatorstraat
650,Mercatorstraat 36,2023-06-14,15:00:00,437,195,242,FMN 02 Mercatorstraat
650,Mercatorstraat 36,2023-06-14,16:00:00,619,275,344,FMN 02 Mercatorstraat
650,Mercatorstraat 36,2023-06-14,17:00:00,778,263,515,FMN 02 Mercatorstraat
650,Mercatorstraat 36,2023-06-14,18:00:00,637,247,390,FMN 02 Mercatorstraat
650,Mercatorstraat 36,2023-06-14,19:00:00,427,204,223,FMN 02 Mercatorstraat
650,Mercatorstraat 36,2023-06-14,20:00:00,278,136,142,FMN 02 Mercatorstraat
650,Mercatorstraat 36,2023-06-14,21:00:00,306,123,183,FMN 02 Mercatorstraat
650,Mercatorstraat 36,2023-06-14,22:00:00,287,119,168,FMN 02 Mercatorstraat
650,Mercatorstraat 36,2023-06-14,23:00:00,152,65,87,FMN 02 Mercatorstraat
650,Mercatorstraat 36,2023-06-15,00:00:00,89,35,54,FMN 02 Mercatorstraat
650,Mercatorstraat 36,2023-06-15,01:00:00,50,17,33,FMN 02 Mercatorstraat
650,Mercatorstraat 36,2023-06-15,02:00:00,13,1,12,FMN 02 Mercatorstraat
650,Mercatorstraat 36,2023-06-15,03:00:00,18,4,14,FMN 02 Mercatorstraat
650,Mercatorstraat 36,2023-06-15,04:00:00,41,29,12,FMN 02 Mercatorstraat
650,Mercatorstraat 36,2023-06-15,05:00:00,65,41,24,FMN 02 Mercatorstraat
650,Mercatorstraat 36,2023-06-15,06:00:00,145,98,47,FMN 02 Mercatorstraat
650,Mercatorstraat 36,2023-06-15,07:00:00,518,331,187,FMN 02 Mercatorstraat
650,Mercatorstraat 36,2023-06-15,08:00:00,1177,831,346,FMN 02 Mercatorstraat
650,Mercatorstraat 36,2023-06-15,09:00:00,508,378,130,FMN 02 Mercatorstraat
650,Mercatorstraat 36,2023-06-15,10:00:00,410,241,169,FMN 02 Mercatorstraat
650,Mercatorstraat 36,2023-06-15,11:00:00,364,193,171,FMN 02 Mercatorstraat
650,Mercatorstraat 36,2023-06-15,12:00:00,451,218,233,FMN 02 Mercatorstraat
650,Mercatorstraat 36,2023-06-15,13:00:00,418,203,215,FMN 02 Mercatorstraat
650,Mercatorstraat 36,2023-06-15,14:00:00,406,167,239,FMN 02 Mercatorstraat
650,Mercatorstraat 36,2023-06-15,15:00:00,457,194,263,FMN 02 Mercatorstraat
650,Mercatorstraat 36,2023-06-15,16:00:00,709,255,454,FMN 02 Mercatorstraat
650,Mercatorstraat 36,2023-06-15,17:00:00,856,299,557,FMN 02 Mercatorstraat
650,Mercatorstraat 36,2023-06-15,18:00:00,653,264,389,FMN 02 Mercatorstraat
650,Mercatorstraat 36,2023-06-15,19:00:00,464,219,245,FMN 02 Mercatorstraat
650,Mercatorstraat 36,2023-06-15,20:00:00,320,137,183,FMN 02 Mercatorstraat
650,Mercatorstraat 36,2023-06-15,21:00:00,292,109,183,FMN 02 Mercatorstraat
650,Mercatorstraat 36,2023-06-15,22:00:00,275,139,136,FMN 02 Mercatorstraat
650,Mercatorstraat 36,2023-06-15,23:00:00,238,83,155,FMN 02 Mercatorstraat
650,Mercatorstraat 36,2023-06-16,00:00:00,114,43,71,FMN 02 Mercatorstraat
650,Mercatorstraat 36,2023-06-16,01:00:00,80,36,44,FMN 02 Mercatorstraat
650,Mercatorstraat 36,2023-06-16,02:00:00,33,14,19,FMN 02 Mercatorstraat
650,Mercatorstraat 36,2023-06-16,03:00:00,27,7,20,FMN 02 Mercatorstraat
650,Mercatorstraat 36,2023-06-16,04:00:00,51,23,28,FMN 02 Mercatorstraat
650,Mercatorstraat 36,2023-06-16,05:00:00,72,41,31,FMN 02 Mercatorstraat
650,Mercatorstraat 36,2023-06-16,06:00:00,158,103,55,FMN 02 Mercatorstraat
650,Mercatorstraat 36,2023-06-16,07:00:00,442,285,157,FMN 02 Mercatorstraat
650,Mercatorstraat 36,2023-06-16,08:00:00,968,702,266,FMN 02 Mercatorstraat
650,Mercatorstraat 36,2023-06-16,09:00:00,533,374,159,FMN 02 Mercatorstraat
650,Mercatorstraat 36,2023-06-16,10:00:00,373,217,156,FMN 02 Mercatorstraat
650,Mercatorstraat 36,2023-06-16,11:00:00,411,213,198,FMN 02 Mercatorstraat
650,Mercatorstraat 36,2023-06-16,12:00:00,528,275,253,FMN 02 Mercatorstraat
650,Mercatorstraat 36,2023-06-16,13:00:00,423,199,224,FMN 02 Mercatorstraat
650,Mercatorstraat 36,2023-06-16,14:00:00,475,238,237,FMN 02 Mercatorstraat
650,Mercatorstraat 36,2023-06-16,15:00:00,573,243,330,FMN 02 Mercatorstraat
650,Mercatorstraat 36,2023-06-16,16:00:00,636,223,413,FMN 02 Mercatorstraat
650,Mercatorstraat 36,2023-06-16,17:00:00,719,258,461,FMN 02 Mercatorstraat
650,Mercatorstraat 36,2023-06-16,18:00:00,613,254,359,FMN 02 Mercatorstraat
650,Mercatorstraat 36,2023-06-16,19:00:00,416,191,225,FMN 02 Mercatorstraat
650,Mercatorstraat 36,2023-06-16,20:00:00,301,163,138,FMN 02 Mercatorstraat
650,Mercatorstraat 36,2023-06-16,21:00:00,232,109,123,FMN 02 Mercatorstraat
650,Mercatorstraat 36,2023-06-16,22:00:00,187,89,98,FMN 02 Mercatorstraat
650,Mercatorstraat 36,2023-06-16,23:00:00,258,92,166,FMN 02 Mercatorstraat
650,Mercatorstraat 36,2023-06-17,00:00:00,232,81,151,FMN 02 Mercatorstraat
650,Mercatorstraat 36,2023-06-17,01:00:00,151,64,87,FMN 02 Mercatorstraat
650,Mercatorstraat 36,2023-06-17,02:00:00,99,29,70,FMN 02 Mercatorstraat
650,Mercatorstraat 36,2023-06-17,03:00:00,69,33,36,FMN 02 Mercatorstraat
650,Mercatorstraat 36,2023-06-17,04:00:00,53,19,34,FMN 02 Mercatorstraat
650,Mercatorstraat 36,2023-06-17,05:00:00,44,23,21,FMN 02 Mercatorstraat
650,Mercatorstraat 36,2023-06-17,06:00:00,50,21,29,FMN 02 Mercatorstraat
650,Mercatorstraat 36,2023-06-17,07:00:00,67,39,28,FMN 02 Mercatorstraat
650,Mercatorstraat 36,2023-06-17,08:00:00,123,81,42,FMN 02 Mercatorstraat
650,Mercatorstraat 36,2023-06-17,09:00:00,258,190,68,FMN 02 Mercatorstraat
650,Mercatorstraat 36,2023-06-17,10:00:00,345,231,114,FMN 02 Mercatorstraat
650,Mercatorstraat 36,2023-06-17,11:00:00,375,220,155,FMN 02 Mercatorstraat
650,Mercatorstraat 36,2023-06-17,12:00:00,378,195,183,FMN 02 Mercatorstraat
650,Mercatorstraat 36,2023-06-17,13:00:00,376,222,154,FMN 02 Mercatorstraat
650,Mercatorstraat 36,2023-06-17,14:00:00,425,242,183,FMN 02 Mercatorstraat
650,Mercatorstraat 36,2023-06-17,15:00:00,436,217,219,FMN 02 Mercatorstraat
650,Mercatorstraat 36,2023-06-17,16:00:00,375,174,201,FMN 02 Mercatorstraat
650,Mercatorstraat 36,2023-06-17,17:00:00,396,171,225,FMN 02 Mercatorstraat
650,Mercatorstraat 36,2023-06-17,18:00:00,391,178,213,FMN 02 Mercatorstraat
650,Mercatorstraat 36,2023-06-17,19:00:00,305,152,153,FMN 02 Mercatorstraat
650,Mercatorstraat 36,2023-06-17,20:00:00,289,141,148,FMN 02 Mercatorstraat
650,Mercatorstraat 36,2023-06-17,21:00:00,210,97,113,FMN 02 Mercatorstraat
650,Mercatorstraat 36,2023-06-17,22:00:00,193,70,123,FMN 02 Mercatorstraat
650,Mercatorstraat 36,2023-06-17,23:00:00,203,84,119,FMN 02 Mercatorstraat
650,Mercatorstraat 36,2023-06-18,00:00:00,195,82,113,FMN 02 Mercatorstraat
650,Mercatorstraat 36,2023-06-18,01:00:00,148,69,79,FMN 02 Mercatorstraat
650,Mercatorstraat 36,2023-06-18,02:00:00,93,23,70,FMN 02 Mercatorstraat
650,Mercatorstraat 36,2023-06-18,03:00:00,81,23,58,FMN 02 Mercatorstraat
650,Mercatorstraat 36,2023-06-18,04:00:00,48,18,30,FMN 02 Mercatorstraat
650,Mercatorstraat 36,2023-06-18,05:00:00,34,15,19,FMN 02 Mercatorstraat
650,Mercatorstraat 36,2023-06-18,06:00:00,36,9,27,FMN 02 Mercatorstraat
650,Mercatorstraat 36,2023-06-18,07:00:00,55,21,34,FMN 02 Mercatorstraat
650,Mercatorstraat 36,2023-06-18,08:00:00,114,54,60,FMN 02 Mercatorstraat
650,Mercatorstraat 36,2023-06-18,09:00:00,252,129,123,FMN 02 Mercatorstraat
650,Mercatorstraat 36,2023-06-18,10:00:00,183,107,76,FMN 02 Mercatorstraat
650,Mercatorstraat 36,2023-06-18,11:00:00,195,92,103,FMN 02 Mercatorstraat
650,Mercatorstraat 36,2023-06-18,12:00:00,237,104,133,FMN 02 Mercatorstraat
650,Mercatorstraat 36,2023-06-18,13:00:00,316,193,123,FMN 02 Mercatorstraat
650,Mercatorstraat 36,2023-06-18,14:00:00,299,190,109,FMN 02 Mercatorstraat
650,Mercatorstraat 36,2023-06-18,15:00:00,334,197,137,FMN 02 Mercatorstraat
650,Mercatorstraat 36,2023-06-18,16:00:00,320,136,184,FMN 02 Mercatorstraat
650,Mercatorstraat 36,2023-06-18,17:00:00,306,138,168,FMN 02 Mercatorstraat
650,Mercatorstraat 36,2023-06-18,18:00:00,246,106,140,FMN 02 Mercatorstraat
650,Mercatorstraat 36,2023-06-18,19:00:00,266,142,124,FMN 02 Mercatorstraat
650,Mercatorstraat 36,2023-06-18,20:00:00,231,94,137,FMN 02 Mercatorstraat
650,Mercatorstraat 36,2023-06-18,21:00:00,194,102,92,FMN 02 Mercatorstraat
650,Mercatorstraat 36,2023-06-18,22:00:00,159,69,90,FMN 02 Mercatorstraat
650,Mercatorstraat 36,2023-06-18,23:00:00,96,37,59,FMN 02 Mercatorstraat
650,Mercatorstraat 36,2023-06-19,00:00:00,32,14,18,FMN 02 Mercatorstraat
650,Mercatorstraat 36,2023-06-19,01:00:00,25,11,14,FMN 02 Mercatorstraat
650,Mercatorstraat 36,2023-06-19,02:00:00,20,6,14,FMN 02 Mercatorstraat
650,Mercatorstraat 36,2023-06-19,03:00:00,13,9,4,FMN 02 Mercatorstraat
650,Mercatorstraat 36,2023-06-19,04:00:00,43,29,14,FMN 02 Mercatorstraat
650,Mercatorstraat 36,2023-06-19,05:00:00,63,35,28,FMN 02 Mercatorstraat
650,Mercatorstraat 36,2023-06-19,06:00:00,127,80,47,FMN 02 Mercatorstraat
650,Mercatorstraat 36,2023-06-19,07:00:00,495,324,171,FMN 02 Mercatorstraat
650,Mercatorstraat 36,2023-06-19,08:00:00,1144,846,298,FMN 02 Mercatorstraat
650,Mercatorstraat 36,2023-06-19,09:00:00,453,308,145,FMN 02 Mercatorstraat
650,Mercatorstraat 36,2023-06-19,10:00:00,329,195,134,FMN 02 Mercatorstraat
650,Mercatorstraat 36,2023-06-19,11:00:00,378,181,197,FMN 02 Mercatorstraat
650,Mercatorstraat 36,2023-06-19,12:00:00,424,180,244,FMN 02 Mercatorstraat
650,Mercatorstraat 36,2023-06-19,13:00:00,397,190,207,FMN 02 Mercatorstraat
650,Mercatorstraat 36,2023-06-19,14:00:00,407,194,213,FMN 02 Mercatorstraat
650,Mercatorstraat 36,2023-06-19,15:00:00,432,183,249,FMN 02 Mercatorstraat
650,Mercatorstraat 36,2023-06-19,16:00:00,676,229,447,FMN 02 Mercatorstraat
650,Mercatorstraat 36,2023-06-19,17:00:00,789,236,553,FMN 02 Mercatorstraat
650,Mercatorstraat 36,2023-06-19,18:00:00,602,254,348,FMN 02 Mercatorstraat
650,Mercatorstraat 36,2023-06-19,19:00:00,336,153,183,FMN 02 Mercatorstraat
650,Mercatorstraat 36,2023-06-19,20:00:00,246,111,135,FMN 02 Mercatorstraat
650,Mercatorstraat 36,2023-06-19,21:00:00,273,109,164,FMN 02 Mercatorstraat
650,Mercatorstraat 36,2023-06-19,22:00:00,229,86,143,FMN 02 Mercatorstraat
650,Mercatorstraat 36,2023-06-19,23:00:00,127,58,69,FMN 02 Mercatorstraat
650,Mercatorstraat 36,2023-06-20,00:00:00,51,21,30,FMN 02 Mercatorstraat
650,Mercatorstraat 36,2023-06-20,01:00:00,26,8,18,FMN 02 Mercatorstraat
650,Mercatorstraat 36,2023-06-20,02:00:00,25,5,20,FMN 02 Mercatorstraat
650,Mercatorstraat 36,2023-06-20,03:00:00,23,12,11,FMN 02 Mercatorstraat
650,Mercatorstraat 36,2023-06-20,04:00:00,48,31,17,FMN 02 Mercatorstraat
650,Mercatorstraat 36,2023-06-20,05:00:00,54,33,21,FMN 02 Mercatorstraat
650,Mercatorstraat 36,2023-06-20,06:00:00,136,94,42,FMN 02 Mercatorstraat
650,Mercatorstraat 36,2023-06-20,07:00:00,496,325,171,FMN 02 Mercatorstraat
650,Mercatorstraat 36,2023-06-20,08:00:00,1189,855,334,FMN 02 Mercatorstraat
650,Mercatorstraat 36,2023-06-20,09:00:00,523,371,152,FMN 02 Mercatorstraat
650,Mercatorstraat 36,2023-06-20,10:00:00,423,224,199,FMN 02 Mercatorstraat
650,Mercatorstraat 36,2023-06-20,11:00:00,338,174,164,FMN 02 Mercatorstraat
650,Mercatorstraat 36,2023-06-20,12:00:00,447,209,238,FMN 02 Mercatorstraat
650,Mercatorstraat 36,2023-06-20,13:00:00,421,206,215,FMN 02 Mercatorstraat
650,Mercatorstraat 36,2023-06-20,14:00:00,389,165,224,FMN 02 Mercatorstraat
650,Mercatorstraat 36,2023-06-20,15:00:00,507,182,325,FMN 02 Mercatorstraat
650,Mercatorstraat 36,2023-06-20,16:00:00,792,246,546,FMN 02 Mercatorstraat
650,Mercatorstraat 36,2023-06-20,17:00:00,742,251,491,FMN 02 Mercatorstraat
650,Mercatorstraat 36,2023-06-20,18:00:00,464,193,271,FMN 02 Mercatorstraat
650,Mercatorstraat 36,2023-06-20,19:00:00,213,90,123,FMN 02 Mercatorstraat
650,Mercatorstraat 36,2023-06-20,20:00:00,183,60,123,FMN 02 Mercatorstraat
650,Mercatorstraat 36,2023-06-20,21:00:00,124,57,67,FMN 02 Mercatorstraat
650,Mercatorstraat 36,2023-06-20,22:00:00,185,72,113,FMN 02 Mercatorstraat
650,Mercatorstraat 36,2023-06-20,23:00:00,94,32,62,FMN 02 Mercatorstraat
650,Mercatorstraat 36,2023-06-21,00:00:00,42,16,26,FMN 02 Mercatorstraat
650,Mercatorstraat 36,2023-06-21,01:00:00,25,10,15,FMN 02 Mercatorstraat
650,Mercatorstraat 36,2023-06-21,02:00:00,27,5,22,FMN 02 Mercatorstraat
650,Mercatorstraat 36,2023-06-21,03:00:00,19,8,11,FMN 02 Mercatorstraat
650,Mercatorstraat 36,2023-06-21,04:00:00,41,26,15,FMN 02 Mercatorstraat
650,Mercatorstraat 36,2023-06-21,05:00:00,73,42,31,FMN 02 Mercatorstraat
650,Mercatorstraat 36,2023-06-21,06:00:00,134,87,47,FMN 02 Mercatorstraat
650,Mercatorstraat 36,2023-06-21,07:00:00,491,298,193,FMN 02 Mercatorstraat
650,Mercatorstraat 36,2023-06-21,08:00:00,978,694,284,FMN 02 Mercatorstraat
650,Mercatorstraat 36,2023-06-21,09:00:00,506,352,154,FMN 02 Mercatorstraat
650,Mercatorstraat 36,2023-06-21,10:00:00,340,180,160,FMN 02 Mercatorstraat
650,Mercatorstraat 36,2023-06-21,11:00:00,418,206,212,FMN 02 Mercatorstraat
650,Mercatorstraat 36,2023-06-21,12:00:00,567,253,314,FMN 02 Mercatorstraat
650,Mercatorstraat 36,2023-06-21,13:00:00,396,196,200,FMN 02 Mercatorstraat
650,Mercatorstraat 36,2023-06-21,14:00:00,384,209,175,FMN 02 Mercatorstraat
650,Mercatorstraat 36,2023-06-21,15:00:00,430,199,231,FMN 02 Mercatorstraat
650,Mercatorstraat 36,2023-06-21,16:00:00,664,248,416,FMN 02 Mercatorstraat
650,Mercatorstraat 36,2023-06-21,17:00:00,762,266,496,FMN 02 Mercatorstraat
650,Mercatorstraat 36,2023-06-21,18:00:00,626,245,381,FMN 02 Mercatorstraat
650,Mercatorstraat 36,2023-06-21,19:00:00,423,216,207,FMN 02 Mercatorstraat
650,Mercatorstraat 36,2023-06-21,20:00:00,309,132,177,FMN 02 Mercatorstraat
650,Mercatorstraat 36,2023-06-21,21:00:00,299,133,166,FMN 02 Mercatorstraat
650,Mercatorstraat 36,2023-06-21,22:00:00,315,128,187,FMN 02 Mercatorstraat
650,Mercatorstraat 36,2023-06-21,23:00:00,185,62,123,FMN 02 Mercatorstraat
650,Mercatorstraat 36,2023-06-22,00:00:00,96,40,56,FMN 02 Mercatorstraat
650,Mercatorstraat 36,2023-06-22,01:00:00,62,22,40,FMN 02 Mercatorstraat
650,Mercatorstraat 36,2023-06-22,02:00:00,30,4,26,FMN 02 Mercatorstraat
650,Mercatorstraat 36,2023-06-22,03:00:00,22,6,16,FMN 02 Mercatorstraat
650,Mercatorstraat 36,2023-06-22,04:00:00,45,28,17,FMN 02 Mercatorstraat
650,Mercatorstraat 36,2023-06-22,05:00:00,59,29,30,FMN 02 Mercatorstraat
650,Mercatorstraat 36,2023-06-22,06:00:00,113,67,46,FMN 02 Mercatorstraat
650,Mercatorstraat 36,2023-06-22,07:00:00,474,268,206,FMN 02 Mercatorstraat
650,Mercatorstraat 36,2023-06-22,08:00:00,1016,717,299,FMN 02 Mercatorstraat
650,Mercatorstraat 36,2023-06-22,09:00:00,459,312,147,FMN 02 Mercatorstraat
650,Mercatorstraat 36,2023-06-22,10:00:00,366,204,162,FMN 02 Mercatorstraat
650,Mercatorstraat 36,2023-06-22,11:00:00,341,167,174,FMN 02 Mercatorstraat
650,Mercatorstraat 36,2023-06-22,12:00:00,322,130,192,FMN 02 Mercatorstraat
650,Mercatorstraat 36,2023-06-22,13:00:00,229,80,149,FMN 02 Mercatorstraat
650,Mercatorstraat 36,2023-06-22,14:00:00,219,95,124,FMN 02 Mercatorstraat
650,Mercatorstraat 36,2023-06-22,15:00:00,284,110,174,FMN 02 Mercatorstraat
650,Mercatorstraat 36,2023-06-22,16:00:00,426,157,269,FMN 02 Mercatorstraat
650,Mercatorstraat 36,2023-06-22,17:00:00,504,169,335,FMN 02 Mercatorstraat
650,Mercatorstraat 36,2023-06-22,18:00:00,376,142,234,FMN 02 Mercatorstraat
650,Mercatorstraat 36,2023-06-22,19:00:00,271,122,149,FMN 02 Mercatorstraat
650,Mercatorstraat 36,2023-06-22,20:00:00,230,118,112,FMN 02 Mercatorstraat
650,Mercatorstraat 36,2023-06-22,21:00:00,200,85,115,FMN 02 Mercatorstraat
650,Mercatorstraat 36,2023-06-22,22:00:00,218,93,125,FMN 02 Mercatorstraat
650,Mercatorstraat 36,2023-06-22,23:00:00,158,65,93,FMN 02 Mercatorstraat
650,Mercatorstraat 36,2023-06-23,00:00:00,80,26,54,FMN 02 Mercatorstraat
650,Mercatorstraat 36,2023-06-23,01:00:00,59,19,40,FMN 02 Mercatorstraat
650,Mercatorstraat 36,2023-06-23,02:00:00,40,21,19,FMN 02 Mercatorstraat
650,Mercatorstraat 36,2023-06-23,03:00:00,31,11,20,FMN 02 Mercatorstraat
650,Mercatorstraat 36,2023-06-23,04:00:00,41,21,20,FMN 02 Mercatorstraat
650,Mercatorstraat 36,2023-06-23,05:00:00,66,36,30,FMN 02 Mercatorstraat
650,Mercatorstraat 36,2023-06-23,06:00:00,139,85,54,FMN 02 Mercatorstraat
650,Mercatorstraat 36,2023-06-23,07:00:00,410,250,160,FMN 02 Mercatorstraat
650,Mercatorstraat 36,2023-06-23,08:00:00,873,612,261,FMN 02 Mercatorstraat
650,Mercatorstraat 36,2023-06-23,09:00:00,460,338,122,FMN 02 Mercatorstraat
650,Mercatorstraat 36,2023-06-23,10:00:00,386,233,153,FMN 02 Mercatorstraat
650,Mercatorstraat 36,2023-06-23,11:00:00,426,241,185,FMN 02 Mercatorstraat
650,Mercatorstraat 36,2023-06-23,12:00:00,525,268,257,FMN 02 Mercatorstraat
650,Mercatorstraat 36,2023-06-23,13:00:00,527,273,254,FMN 02 Mercatorstraat
650,Mercatorstraat 36,2023-06-23,14:00:00,506,224,282,FMN 02 Mercatorstraat
650,Mercatorstraat 36,2023-06-23,15:00:00,607,241,366,FMN 02 Mercatorstraat
650,Mercatorstraat 36,2023-06-23,16:00:00,678,263,415,FMN 02 Mercatorstraat
650,Mercatorstraat 36,2023-06-23,17:00:00,729,294,435,FMN 02 Mercatorstraat
650,Mercatorstraat 36,2023-06-23,18:00:00,649,293,356,FMN 02 Mercatorstraat
650,Mercatorstraat 36,2023-06-23,19:00:00,556,309,247,FMN 02 Mercatorstraat
650,Mercatorstraat 36,2023-06-23,20:00:00,280,125,155,FMN 02 Mercatorstraat
650,Mercatorstraat 36,2023-06-23,21:00:00,301,130,171,FMN 02 Mercatorstraat
650,Mercatorstraat 36,2023-06-23,22:00:00,326,127,199,FMN 02 Mercatorstraat
650,Mercatorstraat 36,2023-06-23,23:00:00,333,139,194,FMN 02 Mercatorstraat
650,Mercatorstraat 36,2023-06-24,00:00:00,247,97,150,FMN 02 Mercatorstraat
650,Mercatorstraat 36,2023-06-24,01:00:00,144,55,89,FMN 02 Mercatorstraat
650,Mercatorstraat 36,2023-06-24,02:00:00,129,46,83,FMN 02 Mercatorstraat
650,Mercatorstraat 36,2023-06-24,03:00:00,104,21,83,FMN 02 Mercatorstraat
650,Mercatorstraat 36,2023-06-24,04:00:00,69,19,50,FMN 02 Mercatorstraat
650,Mercatorstraat 36,2023-06-24,05:00:00,47,23,24,FMN 02 Mercatorstraat
650,Mercatorstraat 36,2023-06-24,06:00:00,67,40,27,FMN 02 Mercatorstraat
650,Mercatorstraat 36,2023-06-24,07:00:00,63,34,29,FMN 02 Mercatorstraat
650,Mercatorstraat 36,2023-06-24,08:00:00,140,94,46,FMN 02 Mercatorstraat
650,Mercatorstraat 36,2023-06-24,09:00:00,315,239,76,FMN 02 Mercatorstraat
650,Mercatorstraat 36,2023-06-24,10:00:00,400,289,111,FMN 02 Mercatorstraat
650,Mercatorstraat 36,2023-06-24,11:00:00,405,243,162,FMN 02 Mercatorstraat
650,Mercatorstraat 36,2023-06-24,12:00:00,438,233,205,FMN 02 Mercatorstraat
650,Mercatorstraat 36,2023-06-24,13:00:00,490,311,179,FMN 02 Mercatorstraat
650,Mercatorstraat 36,2023-06-24,14:00:00,522,306,216,FMN 02 Mercatorstraat
650,Mercatorstraat 36,2023-06-24,15:00:00,484,281,203,FMN 02 Mercatorstraat
650,Mercatorstraat 36,2023-06-24,16:00:00,461,232,229,FMN 02 Mercatorstraat
650,Mercatorstraat 36,2023-06-24,17:00:00,408,178,230,FMN 02 Mercatorstraat
650,Mercatorstraat 36,2023-06-24,18:00:00,406,159,247,FMN 02 Mercatorstraat
650,Mercatorstraat 36,2023-06-24,19:00:00,295,138,157,FMN 02 Mercatorstraat
650,Mercatorstraat 36,2023-06-24,20:00:00,252,114,138,FMN 02 Mercatorstraat
650,Mercatorstraat 36,2023-06-24,21:00:00,215,104,111,FMN 02 Mercatorstraat
650,Mercatorstraat 36,2023-06-24,22:00:00,219,90,129,FMN 02 Mercatorstraat
650,Mercatorstraat 36,2023-06-24,23:00:00,251,92,159,FMN 02 Mercatorstraat
650,Mercatorstraat 36,2023-06-25,00:00:00,297,92,205,FMN 02 Mercatorstraat
650,Mercatorstraat 36,2023-06-25,01:00:00,236,105,131,FMN 02 Mercatorstraat
650,Mercatorstraat 36,2023-06-25,02:00:00,132,49,83,FMN 02 Mercatorstraat
650,Mercatorstraat 36,2023-06-25,03:00:00,85,23,62,FMN 02 Mercatorstraat
650,Mercatorstraat 36,2023-06-25,04:00:00,85,20,65,FMN 02 Mercatorstraat
650,Mercatorstraat 36,2023-06-25,05:00:00,51,20,31,FMN 02 Mercatorstraat
650,Mercatorstraat 36,2023-06-25,06:00:00,59,26,33,FMN 02 Mercatorstraat
650,Mercatorstraat 36,2023-06-25,07:00:00,51,24,27,FMN 02 Mercatorstraat
650,Mercatorstraat 36,2023-06-25,08:00:00,149,73,76,FMN 02 Mercatorstraat
650,Mercatorstraat 36,2023-06-25,09:00:00,275,138,137,FMN 02 Mercatorstraat
650,Mercatorstraat 36,2023-06-25,10:00:00,286,169,117,FMN 02 Mercatorstraat
650,Mercatorstraat 36,2023-06-25,11:00:00,295,159,136,FMN 02 Mercatorstraat
650,Mercatorstraat 36,2023-06-25,12:00:00,381,231,150,FMN 02 Mercatorstraat
650,Mercatorstraat 36,2023-06-25,13:00:00,380,224,156,FMN 02 Mercatorstraat
650,Mercatorstraat 36,2023-06-25,14:00:00,381,215,166,FMN 02 Mercatorstraat
650,Mercatorstraat 36,2023-06-25,15:00:00,304,146,158,FMN 02 Mercatorstraat
650,Mercatorstraat 36,2023-06-25,16:00:00,347,165,182,FMN 02 Mercatorstraat
650,Mercatorstraat 36,2023-06-25,17:00:00,345,138,207,FMN 02 Mercatorstraat
650,Mercatorstraat 36,2023-06-25,18:00:00,359,198,161,FMN 02 Mercatorstraat
650,Mercatorstraat 36,2023-06-25,19:00:00,317,166,151,FMN 02 Mercatorstraat
650,Mercatorstraat 36,2023-06-25,20:00:00,259,137,122,FMN 02 Mercatorstraat
650,Mercatorstraat 36,2023-06-25,21:00:00,206,91,115,FMN 02 Mercatorstraat
650,Mercatorstraat 36,2023-06-25,22:00:00,221,94,127,FMN 02 Mercatorstraat
650,Mercatorstraat 36,2023-06-25,23:00:00,163,57,106,FMN 02 Mercatorstraat
650,Mercatorstraat 36,2023-06-26,00:00:00,135,35,100,FMN 02 Mercatorstraat
650,Mercatorstraat 36,2023-06-26,01:00:00,105,21,84,FMN 02 Mercatorstraat
650,Mercatorstraat 36,2023-06-26,02:00:00,22,8,14,FMN 02 Mercatorstraat
650,Mercatorstraat 36,2023-06-26,03:00:00,18,9,9,FMN 02 Mercatorstraat
650,Mercatorstraat 36,2023-06-26,04:00:00,38,21,17,FMN 02 Mercatorstraat
650,Mercatorstraat 36,2023-06-26,05:00:00,67,35,32,FMN 02 Mercatorstraat
650,Mercatorstraat 36,2023-06-26,06:00:00,129,90,39,FMN 02 Mercatorstraat
650,Mercatorstraat 36,2023-06-26,07:00:00,443,264,179,FMN 02 Mercatorstraat
650,Mercatorstraat 36,2023-06-26,08:00:00,1055,747,308,FMN 02 Mercatorstraat
650,Mercatorstraat 36,2023-06-26,09:00:00,495,364,131,FMN 02 Mercatorstraat
650,Mercatorstraat 36,2023-06-26,10:00:00,344,220,124,FMN 02 Mercatorstraat
650,Mercatorstraat 36,2023-06-26,11:00:00,326,178,148,FMN 02 Mercatorstraat
650,Mercatorstraat 36,2023-06-26,12:00:00,387,199,188,FMN 02 Mercatorstraat
650,Mercatorstraat 36,2023-06-26,13:00:00,457,236,221,FMN 02 Mercatorstraat
650,Mercatorstraat 36,2023-06-26,14:00:00,416,214,202,FMN 02 Mercatorstraat
650,Mercatorstraat 36,2023-06-26,15:00:00,478,213,265,FMN 02 Mercatorstraat
650,Mercatorstraat 36,2023-06-26,16:00:00,713,252,461,FMN 02 Mercatorstraat
650,Mercatorstraat 36,2023-06-26,17:00:00,931,298,633,FMN 02 Mercatorstraat
650,Mercatorstraat 36,2023-06-26,18:00:00,621,235,386,FMN 02 Mercatorstraat
650,Mercatorstraat 36,2023-06-26,19:00:00,385,169,216,FMN 02 Mercatorstraat
650,Mercatorstraat 36,2023-06-26,20:00:00,317,125,192,FMN 02 Mercatorstraat
650,Mercatorstraat 36,2023-06-26,21:00:00,291,117,174,FMN 02 Mercatorstraat
650,Mercatorstraat 36,2023-06-26,22:00:00,258,117,141,FMN 02 Mercatorstraat
650,Mercatorstraat 36,2023-06-26,23:00:00,144,53,91,FMN 02 Mercatorstraat
650,Mercatorstraat 36,2023-06-27,00:00:00,99,44,55,FMN 02 Mercatorstraat
650,Mercatorstraat 36,2023-06-27,01:00:00,56,27,29,FMN 02 Mercatorstraat
650,Mercatorstraat 36,2023-06-27,02:00:00,49,13,36,FMN 02 Mercatorstraat
650,Mercatorstraat 36,2023-06-27,03:00:00,29,7,22,FMN 02 Mercatorstraat
650,Mercatorstraat 36,2023-06-27,04:00:00,47,22,25,FMN 02 Mercatorstraat
650,Mercatorstraat 36,2023-06-27,05:00:00,64,36,28,FMN 02 Mercatorstraat
650,Mercatorstraat 36,2023-06-27,06:00:00,140,91,49,FMN 02 Mercatorstraat
650,Mercatorstraat 36,2023-06-27,07:00:00,452,312,140,FMN 02 Mercatorstraat
650,Mercatorstraat 36,2023-06-27,08:00:00,1053,749,304,FMN 02 Mercatorstraat
650,Mercatorstraat 36,2023-06-27,09:00:00,530,393,137,FMN 02 Mercatorstraat
650,Mercatorstraat 36,2023-06-27,10:00:00,334,211,123,FMN 02 Mercatorstraat
650,Mercatorstraat 36,2023-06-27,11:00:00,325,185,140,FMN 02 Mercatorstraat
650,Mercatorstraat 36,2023-06-27,12:00:00,479,240,239,FMN 02 Mercatorstraat
650,Mercatorstraat 36,2023-06-27,13:00:00,439,258,181,FMN 02 Mercatorstraat
650,Mercatorstraat 36,2023-06-27,14:00:00,534,241,293,FMN 02 Mercatorstraat
650,Mercatorstraat 36,2023-06-27,15:00:00,542,212,330,FMN 02 Mercatorstraat
650,Mercatorstraat 36,2023-06-27,16:00:00,797,288,509,FMN 02 Mercatorstraat
650,Mercatorstraat 36,2023-06-27,17:00:00,915,310,605,FMN 02 Mercatorstraat
650,Mercatorstraat 36,2023-06-27,18:00:00,704,294,410,FMN 02 Mercatorstraat
650,Mercatorstraat 36,2023-06-27,19:00:00,420,193,227,FMN 02 Mercatorstraat
650,Mercatorstraat 36,2023-06-27,20:00:00,315,152,163,FMN 02 Mercatorstraat
650,Mercatorstraat 36,2023-06-27,21:00:00,294,127,167,FMN 02 Mercatorstraat
650,Mercatorstraat 36,2023-06-27,22:00:00,262,87,175,FMN 02 Mercatorstraat
650,Mercatorstraat 36,2023-06-27,23:00:00,252,99,153,FMN 02 Mercatorstraat
650,Mercatorstraat 36,2023-06-28,00:00:00,108,36,72,FMN 02 Mercatorstraat
650,Mercatorstraat 36,2023-06-28,01:00:00,57,24,33,FMN 02 Mercatorstraat
650,Mercatorstraat 36,2023-06-28,02:00:00,29,10,19,FMN 02 Mercatorstraat
650,Mercatorstraat 36,2023-06-28,03:00:00,38,18,20,FMN 02 Mercatorstraat
650,Mercatorstraat 36,2023-06-28,04:00:00,33,18,15,FMN 02 Mercatorstraat
650,Mercatorstraat 36,2023-06-28,05:00:00,49,34,15,FMN 02 Mercatorstraat
650,Mercatorstraat 36,2023-06-28,06:00:00,133,83,50,FMN 02 Mercatorstraat
650,Mercatorstraat 36,2023-06-28,07:00:00,394,260,134,FMN 02 Mercatorstraat
650,Mercatorstraat 36,2023-06-28,08:00:00,827,534,293,FMN 02 Mercatorstraat
650,Mercatorstraat 36,2023-06-28,09:00:00,509,361,148,FMN 02 Mercatorstraat
650,Mercatorstraat 36,2023-06-28,10:00:00,315,205,110,FMN 02 Mercatorstraat
650,Mercatorstraat 36,2023-06-28,11:00:00,362,196,166,FMN 02 Mercatorstraat
650,Mercatorstraat 36,2023-06-28,12:00:00,515,258,257,FMN 02 Mercatorstraat
650,Mercatorstraat 36,2023-06-28,13:00:00,494,255,239,FMN 02 Mercatorstraat
650,Mercatorstraat 36,2023-06-28,14:00:00,451,241,210,FMN 02 Mercatorstraat
650,Mercatorstraat 36,2023-06-28,15:00:00,516,218,298,FMN 02 Mercatorstraat
650,Mercatorstraat 36,2023-06-28,16:00:00,700,272,428,FMN 02 Mercatorstraat
650,Mercatorstraat 36,2023-06-28,17:00:00,853,328,525,FMN 02 Mercatorstraat
650,Mercatorstraat 36,2023-06-28,18:00:00,627,283,344,FMN 02 Mercatorstraat
650,Mercatorstraat 36,2023-06-28,19:00:00,467,230,237,FMN 02 Mercatorstraat
650,Mercatorstraat 36,2023-06-28,20:00:00,311,139,172,FMN 02 Mercatorstraat
650,Mercatorstraat 36,2023-06-28,21:00:00,261,105,156,FMN 02 Mercatorstraat
650,Mercatorstraat 36,2023-06-28,22:00:00,257,101,156,FMN 02 Mercatorstraat
650,Mercatorstraat 36,2023-06-28,23:00:00,198,64,134,FMN 02 Mercatorstraat
650,Mercatorstraat 36,2023-06-29,00:00:00,129,47,82,FMN 02 Mercatorstraat
650,Mercatorstraat 36,2023-06-29,01:00:00,60,16,44,FMN 02 Mercatorstraat
650,Mercatorstraat 36,2023-06-29,02:00:00,62,27,35,FMN 02 Mercatorstraat
650,Mercatorstraat 36,2023-06-29,03:00:00,33,7,26,FMN 02 Mercatorstraat
650,Mercatorstraat 36,2023-06-29,04:00:00,57,30,27,FMN 02 Mercatorstraat
650,Mercatorstraat 36,2023-06-29,05:00:00,66,38,28,FMN 02 Mercatorstraat
650,Mercatorstraat 36,2023-06-29,06:00:00,120,74,46,FMN 02 Mercatorstraat
650,Mercatorstraat 36,2023-06-29,07:00:00,368,229,139,FMN 02 Mercatorstraat
650,Mercatorstraat 36,2023-06-29,08:00:00,1016,715,301,FMN 02 Mercatorstraat
650,Mercatorstraat 36,2023-06-29,09:00:00,484,362,122,FMN 02 Mercatorstraat
650,Mercatorstraat 36,2023-06-29,10:00:00,375,232,143,FMN 02 Mercatorstraat
650,Mercatorstraat 36,2023-06-29,11:00:00,341,180,161,FMN 02 Mercatorstraat
650,Mercatorstraat 36,2023-06-29,12:00:00,463,221,242,FMN 02 Mercatorstraat
650,Mercatorstraat 36,2023-06-29,13:00:00,442,226,216,FMN 02 Mercatorstraat
650,Mercatorstraat 36,2023-06-29,14:00:00,414,185,229,FMN 02 Mercatorstraat
650,Mercatorstraat 36,2023-06-29,15:00:00,467,209,258,FMN 02 Mercatorstraat
650,Mercatorstraat 36,2023-06-29,16:00:00,665,290,375,FMN 02 Mercatorstraat
650,Mercatorstraat 36,2023-06-29,17:00:00,857,336,521,FMN 02 Mercatorstraat
650,Mercatorstraat 36,2023-06-29,18:00:00,615,286,329,FMN 02 Mercatorstraat
650,Mercatorstraat 36,2023-06-29,19:00:00,441,221,220,FMN 02 Mercatorstraat
650,Mercatorstraat 36,2023-06-29,20:00:00,296,122,174,FMN 02 Mercatorstraat
650,Mercatorstraat 36,2023-06-29,21:00:00,251,89,162,FMN 02 Mercatorstraat
650,Mercatorstraat 36,2023-06-29,22:00:00,258,105,153,FMN 02 Mercatorstraat
650,Mercatorstraat 36,2023-06-29,23:00:00,194,52,142,FMN 02 Mercatorstraat
650,Mercatorstraat 36,2023-06-30,00:00:00,118,38,80,FMN 02 Mercatorstraat
650,Mercatorstraat 36,2023-06-30,01:00:00,101,49,52,FMN 02 Mercatorstraat
650,Mercatorstraat 36,2023-06-30,02:00:00,38,12,26,FMN 02 Mercatorstraat
650,Mercatorstraat 36,2023-06-30,03:00:00,41,10,31,FMN 02 Mercatorstraat
650,Mercatorstraat 36,2023-06-30,04:00:00,56,29,27,FMN 02 Mercatorstraat
650,Mercatorstraat 36,2023-06-30,05:00:00,55,28,27,FMN 02 Mercatorstraat
650,Mercatorstraat 36,2023-06-30,06:00:00,139,86,53,FMN 02 Mercatorstraat
650,Mercatorstraat 36,2023-06-30,07:00:00,307,201,106,FMN 02 Mercatorstraat
650,Mercatorstraat 36,2023-06-30,08:00:00,713,513,200,FMN 02 Mercatorstraat
650,Mercatorstraat 36,2023-06-30,09:00:00,487,371,116,FMN 02 Mercatorstraat
650,Mercatorstraat 36,2023-06-30,10:00:00,360,236,124,FMN 02 Mercatorstraat
650,Mercatorstraat 36,2023-06-30,11:00:00,417,217,200,FMN 02 Mercatorstraat
650,Mercatorstraat 36,2023-06-30,12:00:00,515,272,243,FMN 02 Mercatorstraat
650,Mercatorstraat 36,2023-06-30,13:00:00,511,294,217,FMN 02 Mercatorstraat
650,Mercatorstraat 36,2023-06-30,14:00:00,467,235,232,FMN 02 Mercatorstraat
650,Mercatorstraat 36,2023-06-30,15:00:00,539,245,294,FMN 02 Mercatorstraat
650,Mercatorstraat 36,2023-06-30,16:00:00,640,244,396,FMN 02 Mercatorstraat
650,Mercatorstraat 36,2023-06-30,17:00:00,658,256,402,FMN 02 Mercatorstraat
650,Mercatorstraat 36,2023-06-30,18:00:00,583,227,356,FMN 02 Mercatorstraat
650,Mercatorstraat 36,2023-06-30,19:00:00,391,182,209,FMN 02 Mercatorstraat
650,Mercatorstraat 36,2023-06-30,20:00:00,282,127,155,FMN 02 Mercatorstraat
650,Mercatorstraat 36,2023-06-30,21:00:00,275,137,138,FMN 02 Mercatorstraat
650,Mercatorstraat 36,2023-06-30,22:00:00,263,112,151,FMN 02 Mercatorstraat
650,Mercatorstraat 36,2023-06-30,23:00:00,233,100,133,FMN 02 Mercatorstraat
650,Mercatorstraat 36,2023-07-01,00:00:00,185,85,100,FMN 02 Mercatorstraat
650,Mercatorstraat 36,2023-07-01,01:00:00,156,64,92,FMN 02 Mercatorstraat
650,Mercatorstraat 36,2023-07-01,02:00:00,92,24,68,FMN 02 Mercatorstraat
650,Mercatorstraat 36,2023-07-01,03:00:00,57,9,48,FMN 02 Mercatorstraat
650,Mercatorstraat 36,2023-07-01,04:00:00,57,17,40,FMN 02 Mercatorstraat
650,Mercatorstraat 36,2023-07-01,05:00:00,51,22,29,FMN 02 Mercatorstraat
650,Mercatorstraat 36,2023-07-01,06:00:00,46,16,30,FMN 02 Mercatorstraat
650,Mercatorstraat 36,2023-07-01,07:00:00,64,33,31,FMN 02 Mercatorstraat
650,Mercatorstraat 36,2023-07-01,08:00:00,85,55,30,FMN 02 Mercatorstraat
650,Mercatorstraat 36,2023-07-01,09:00:00,168,125,43,FMN 02 Mercatorstraat
650,Mercatorstraat 36,2023-07-01,10:00:00,229,142,87,FMN 02 Mercatorstraat
650,Mercatorstraat 36,2023-07-01,11:00:00,230,147,83,FMN 02 Mercatorstraat
650,Mercatorstraat 36,2023-07-01,12:00:00,219,110,109,FMN 02 Mercatorstraat
650,Mercatorstraat 36,2023-07-01,13:00:00,267,159,108,FMN 02 Mercatorstraat
650,Mercatorstraat 36,2023-07-01,14:00:00,280,168,112,FMN 02 Mercatorstraat
650,Mercatorstraat 36,2023-07-01,15:00:00,276,146,130,FMN 02 Mercatorstraat
650,Mercatorstraat 36,2023-07-01,16:00:00,281,130,151,FMN 02 Mercatorstraat
650,Mercatorstraat 36,2023-07-01,17:00:00,273,125,148,FMN 02 Mercatorstraat
650,Mercatorstraat 36,2023-07-01,18:00:00,296,134,162,FMN 02 Mercatorstraat
650,Mercatorstraat 36,2023-07-01,19:00:00,245,145,100,FMN 02 Mercatorstraat
650,Mercatorstraat 36,2023-07-01,20:00:00,198,108,90,FMN 02 Mercatorstraat
650,Mercatorstraat 36,2023-07-01,21:00:00,180,94,86,FMN 02 Mercatorstraat
650,Mercatorstraat 36,2023-07-01,22:00:00,152,58,94,FMN 02 Mercatorstraat
650,Mercatorstraat 36,2023-07-01,23:00:00,165,60,105,FMN 02 Mercatorstraat
650,Mercatorstraat 36,2023-07-02,00:00:00,164,57,107,FMN 02 Mercatorstraat
650,Mercatorstraat 36,2023-07-02,01:00:00,128,44,84,FMN 02 Mercatorstraat
650,Mercatorstraat 36,2023-07-02,02:00:00,81,33,48,FMN 02 Mercatorstraat
650,Mercatorstraat 36,2023-07-02,03:00:00,70,24,46,FMN 02 Mercatorstraat
650,Mercatorstraat 36,2023-07-02,04:00:00,50,21,29,FMN 02 Mercatorstraat
650,Mercatorstraat 36,2023-07-02,05:00:00,41,18,23,FMN 02 Mercatorstraat
650,Mercatorstraat 36,2023-07-02,06:00:00,33,11,22,FMN 02 Mercatorstraat
650,Mercatorstraat 36,2023-07-02,07:00:00,34,21,13,FMN 02 Mercatorstraat
650,Mercatorstraat 36,2023-07-02,08:00:00,75,50,25,FMN 02 Mercatorstraat
650,Mercatorstraat 36,2023-07-02,09:00:00,236,157,79,FMN 02 Mercatorstraat
650,Mercatorstraat 36,2023-07-02,10:00:00,272,184,88,FMN 02 Mercatorstraat
650,Mercatorstraat 36,2023-07-02,11:00:00,338,213,125,FMN 02 Mercatorstraat
650,Mercatorstraat 36,2023-07-02,12:00:00,355,207,148,FMN 02 Mercatorstraat
650,Mercatorstraat 36,2023-07-02,13:00:00,439,233,206,FMN 02 Mercatorstraat
650,Mercatorstraat 36,2023-07-02,14:00:00,434,244,190,FMN 02 Mercatorstraat
650,Mercatorstraat 36,2023-07-02,15:00:00,390,218,172,FMN 02 Mercatorstraat
650,Mercatorstraat 36,2023-07-02,16:00:00,375,157,218,FMN 02 Mercatorstraat
650,Mercatorstraat 36,2023-07-02,17:00:00,380,162,218,FMN 02 Mercatorstraat
650,Mercatorstraat 36,2023-07-02,18:00:00,360,157,203,FMN 02 Mercatorstraat
650,Mercatorstraat 36,2023-07-02,19:00:00,275,108,167,FMN 02 Mercatorstraat
650,Mercatorstraat 36,2023-07-02,20:00:00,232,98,134,FMN 02 Mercatorstraat
650,Mercatorstraat 36,2023-07-02,21:00:00,209,99,110,FMN 02 Mercatorstraat
650,Mercatorstraat 36,2023-07-02,22:00:00,191,77,114,FMN 02 Mercatorstraat
650,Mercatorstraat 36,2023-07-02,23:00:00,134,55,79,FMN 02 Mercatorstraat
650,Mercatorstraat 36,2023-07-03,00:00:00,74,33,41,FMN 02 Mercatorstraat
650,Mercatorstraat 36,2023-07-03,01:00:00,29,15,14,FMN 02 Mercatorstraat
650,Mercatorstraat 36,2023-07-03,02:00:00,28,7,21,FMN 02 Mercatorstraat
650,Mercatorstraat 36,2023-07-03,03:00:00,21,14,7,FMN 02 Mercatorstraat
650,Mercatorstraat 36,2023-07-03,04:00:00,40,23,17,FMN 02 Mercatorstraat
650,Mercatorstraat 36,2023-07-03,05:00:00,55,37,18,FMN 02 Mercatorstraat
650,Mercatorstraat 36,2023-07-03,06:00:00,134,94,40,FMN 02 Mercatorstraat
650,Mercatorstraat 36,2023-07-03,07:00:00,338,230,108,FMN 02 Mercatorstraat
650,Mercatorstraat 36,2023-07-03,08:00:00,774,568,206,FMN 02 Mercatorstraat
650,Mercatorstraat 36,2023-07-03,09:00:00,512,346,166,FMN 02 Mercatorstraat
650,Mercatorstraat 36,2023-07-03,10:00:00,263,173,90,FMN 02 Mercatorstraat
650,Mercatorstraat 36,2023-07-03,11:00:00,284,158,126,FMN 02 Mercatorstraat
650,Mercatorstraat 36,2023-07-03,12:00:00,343,179,164,FMN 02 Mercatorstraat
650,Mercatorstraat 36,2023-07-03,13:00:00,383,210,173,FMN 02 Mercatorstraat
650,Mercatorstraat 36,2023-07-03,14:00:00,412,230,182,FMN 02 Mercatorstraat
650,Mercatorstraat 36,2023-07-03,15:00:00,420,171,249,FMN 02 Mercatorstraat
650,Mercatorstraat 36,2023-07-03,16:00:00,666,233,433,FMN 02 Mercatorstraat
650,Mercatorstraat 36,2023-07-03,17:00:00,779,255,524,FMN 02 Mercatorstraat
650,Mercatorstraat 36,2023-07-03,18:00:00,603,245,358,FMN 02 Mercatorstraat
650,Mercatorstraat 36,2023-07-03,19:00:00,316,147,169,FMN 02 Mercatorstraat
650,Mercatorstraat 36,2023-07-03,20:00:00,228,86,142,FMN 02 Mercatorstraat
650,Mercatorstraat 36,2023-07-03,21:00:00,222,89,133,FMN 02 Mercatorstraat
650,Mercatorstraat 36,2023-07-03,22:00:00,184,72,112,FMN 02 Mercatorstraat
650,Mercatorstraat 36,2023-07-03,23:00:00,109,40,69,FMN 02 Mercatorstraat
650,Mercatorstraat 36,2023-07-04,00:00:00,69,20,49,FMN 02 Mercatorstraat
650,Mercatorstraat 36,2023-07-04,01:00:00,20,8,12,FMN 02 Mercatorstraat
650,Mercatorstraat 36,2023-07-04,02:00:00,16,3,13,FMN 02 Mercatorstraat
650,Mercatorstraat 36,2023-07-04,03:00:00,16,10,6,FMN 02 Mercatorstraat
650,Mercatorstraat 36,2023-07-04,04:00:00,28,15,13,FMN 02 Mercatorstraat
650,Mercatorstraat 36,2023-07-04,05:00:00,64,41,23,FMN 02 Mercatorstraat
650,Mercatorstraat 36,2023-07-04,06:00:00,148,95,53,FMN 02 Mercatorstraat
650,Mercatorstraat 36,2023-07-04,07:00:00,337,234,103,FMN 02 Mercatorstraat
650,Mercatorstraat 36,2023-07-04,08:00:00,800,562,238,FMN 02 Mercatorstraat
650,Mercatorstraat 36,2023-07-04,09:00:00,566,394,172,FMN 02 Mercatorstraat
650,Mercatorstraat 36,2023-07-04,10:00:00,326,219,107,FMN 02 Mercatorstraat
650,Mercatorstraat 36,2023-07-04,11:00:00,272,149,123,FMN 02 Mercatorstraat
650,Mercatorstraat 36,2023-07-04,12:00:00,393,232,161,FMN 02 Mercatorstraat
650,Mercatorstraat 36,2023-07-04,13:00:00,389,206,183,FMN 02 Mercatorstraat
650,Mercatorstraat 36,2023-07-04,14:00:00,363,197,166,FMN 02 Mercatorstraat
650,Mercatorstraat 36,2023-07-04,15:00:00,437,196,241,FMN 02 Mercatorstraat
650,Mercatorstraat 36,2023-07-04,16:00:00,685,246,439,FMN 02 Mercatorstraat
650,Mercatorstraat 36,2023-07-04,17:00:00,815,290,525,FMN 02 Mercatorstraat
650,Mercatorstraat 36,2023-07-04,18:00:00,634,280,354,FMN 02 Mercatorstraat
650,Mercatorstraat 36,2023-07-04,19:00:00,346,167,179,FMN 02 Mercatorstraat
650,Mercatorstraat 36,2023-07-04,20:00:00,229,107,122,FMN 02 Mercatorstraat
650,Mercatorstraat 36,2023-07-04,21:00:00,225,78,147,FMN 02 Mercatorstraat
650,Mercatorstraat 36,2023-07-04,22:00:00,229,94,135,FMN 02 Mercatorstraat
650,Mercatorstraat 36,2023-07-04,23:00:00,152,60,92,FMN 02 Mercatorstraat
650,Mercatorstraat 36,2023-07-05,00:00:00,60,27,33,FMN 02 Mercatorstraat
650,Mercatorstraat 36,2023-07-05,01:00:00,33,13,20,FMN 02 Mercatorstraat
650,Mercatorstraat 36,2023-07-05,02:00:00,15,1,14,FMN 02 Mercatorstraat
650,Mercatorstraat 36,2023-07-05,03:00:00,19,6,13,FMN 02 Mercatorstraat
650,Mercatorstraat 36,2023-07-05,04:00:00,28,16,12,FMN 02 Mercatorstraat
650,Mercatorstraat 36,2023-07-05,05:00:00,59,39,20,FMN 02 Mercatorstraat
650,Mercatorstraat 36,2023-07-05,06:00:00,109,77,32,FMN 02 Mercatorstraat
650,Mercatorstraat 36,2023-07-05,07:00:00,265,182,83,FMN 02 Mercatorstraat
650,Mercatorstraat 36,2023-07-05,08:00:00,568,402,166,FMN 02 Mercatorstraat
650,Mercatorstraat 36,2023-07-05,09:00:00,421,292,129,FMN 02 Mercatorstraat
650,Mercatorstraat 36,2023-07-05,10:00:00,262,177,85,FMN 02 Mercatorstraat
650,Mercatorstraat 36,2023-07-05,11:00:00,263,162,101,FMN 02 Mercatorstraat
650,Mercatorstraat 36,2023-07-05,12:00:00,341,187,154,FMN 02 Mercatorstraat
650,Mercatorstraat 36,2023-07-05,13:00:00,336,175,161,FMN 02 Mercatorstraat
650,Mercatorstraat 36,2023-07-05,14:00:00,336,177,159,FMN 02 Mercatorstraat
650,Mercatorstraat 36,2023-07-05,15:00:00,361,156,205,FMN 02 Mercatorstraat
650,Mercatorstraat 36,2023-07-05,16:00:00,549,215,334,FMN 02 Mercatorstraat
650,Mercatorstraat 36,2023-07-05,17:00:00,655,252,403,FMN 02 Mercatorstraat
650,Mercatorstraat 36,2023-07-05,18:00:00,461,176,285,FMN 02 Mercatorstraat
650,Mercatorstraat 36,2023-07-05,19:00:00,315,157,158,FMN 02 Mercatorstraat
650,Mercatorstraat 36,2023-07-05,20:00:00,226,109,117,FMN 02 Mercatorstraat
650,Mercatorstraat 36,2023-07-05,21:00:00,176,64,112,FMN 02 Mercatorstraat
650,Mercatorstraat 36,2023-07-05,22:00:00,207,93,114,FMN 02 Mercatorstraat
650,Mercatorstraat 36,2023-07-05,23:00:00,140,59,81,FMN 02 Mercatorstraat
650,Mercatorstraat 36,2023-07-06,00:00:00,70,29,41,FMN 02 Mercatorstraat
650,Mercatorstraat 36,2023-07-06,01:00:00,44,15,29,FMN 02 Mercatorstraat
650,Mercatorstraat 36,2023-07-06,02:00:00,25,8,17,FMN 02 Mercatorstraat
650,Mercatorstraat 36,2023-07-06,03:00:00,13,7,6,FMN 02 Mercatorstraat
650,Mercatorstraat 36,2023-07-06,04:00:00,47,25,22,FMN 02 Mercatorstraat
650,Mercatorstraat 36,2023-07-06,05:00:00,69,44,25,FMN 02 Mercatorstraat
650,Mercatorstraat 36,2023-07-06,06:00:00,123,76,47,FMN 02 Mercatorstraat
650,Mercatorstraat 36,2023-07-06,07:00:00,322,201,121,FMN 02 Mercatorstraat
650,Mercatorstraat 36,2023-07-06,08:00:00,734,494,240,FMN 02 Mercatorstraat
650,Mercatorstraat 36,2023-07-06,09:00:00,509,347,162,FMN 02 Mercatorstraat
650,Mercatorstraat 36,2023-07-06,10:00:00,302,198,104,FMN 02 Mercatorstraat
650,Mercatorstraat 36,2023-07-06,11:00:00,325,191,134,FMN 02 Mercatorstraat
650,Mercatorstraat 36,2023-07-06,12:00:00,378,203,175,FMN 02 Mercatorstraat
650,Mercatorstraat 36,2023-07-06,13:00:00,382,205,177,FMN 02 Mercatorstraat
650,Mercatorstraat 36,2023-07-06,14:00:00,401,218,183,FMN 02 Mercatorstraat
650,Mercatorstraat 36,2023-07-06,15:00:00,434,192,242,FMN 02 Mercatorstraat
650,Mercatorstraat 36,2023-07-06,16:00:00,589,223,366,FMN 02 Mercatorstraat
650,Mercatorstraat 36,2023-07-06,17:00:00,758,276,482,FMN 02 Mercatorstraat
650,Mercatorstraat 36,2023-07-06,18:00:00,638,276,362,FMN 02 Mercatorstraat
650,Mercatorstraat 36,2023-07-06,19:00:00,412,206,206,FMN 02 Mercatorstraat
650,Mercatorstraat 36,2023-07-06,20:00:00,272,118,154,FMN 02 Mercatorstraat
650,Mercatorstraat 36,2023-07-06,21:00:00,238,98,140,FMN 02 Mercatorstraat
650,Mercatorstraat 36,2023-07-06,22:00:00,272,104,168,FMN 02 Mercatorstraat
650,Mercatorstraat 36,2023-07-06,23:00:00,238,79,159,FMN 02 Mercatorstraat
650,Mercatorstraat 36,2023-07-07,00:00:00,120,57,63,FMN 02 Mercatorstraat
650,Mercatorstraat 36,2023-07-07,01:00:00,84,34,50,FMN 02 Mercatorstraat
650,Mercatorstraat 36,2023-07-07,02:00:00,31,8,23,FMN 02 Mercatorstraat
650,Mercatorstraat 36,2023-07-07,03:00:00,24,7,17,FMN 02 Mercatorstraat
650,Mercatorstraat 36,2023-07-07,04:00:00,39,21,18,FMN 02 Mercatorstraat
650,Mercatorstraat 36,2023-07-07,05:00:00,69,37,32,FMN 02 Mercatorstraat
650,Mercatorstraat 36,2023-07-07,06:00:00,127,83,44,FMN 02 Mercatorstraat
650,Mercatorstraat 36,2023-07-07,07:00:00,270,167,103,FMN 02 Mercatorstraat
650,Mercatorstraat 36,2023-07-07,08:00:00,622,442,180,FMN 02 Mercatorstraat
650,Mercatorstraat 36,2023-07-07,09:00:00,501,340,161,FMN 02 Mercatorstraat
650,Mercatorstraat 36,2023-07-07,10:00:00,333,219,114,FMN 02 Mercatorstraat
650,Mercatorstraat 36,2023-07-07,11:00:00,323,181,142,FMN 02 Mercatorstraat
650,Mercatorstraat 36,2023-07-07,12:00:00,463,238,225,FMN 02 Mercatorstraat
650,Mercatorstraat 36,2023-07-07,13:00:00,395,211,184,FMN 02 Mercatorstraat
650,Mercatorstraat 36,2023-07-07,14:00:00,451,256,195,FMN 02 Mercatorstraat
650,Mercatorstraat 36,2023-07-07,15:00:00,447,185,262,FMN 02 Mercatorstraat
650,Mercatorstraat 36,2023-07-07,16:00:00,571,234,337,FMN 02 Mercatorstraat
650,Mercatorstraat 36,2023-07-07,17:00:00,658,270,388,FMN 02 Mercatorstraat
650,Mercatorstraat 36,2023-07-07,18:00:00,477,220,257,FMN 02 Mercatorstraat
650,Mercatorstraat 36,2023-07-07,19:00:00,428,207,221,FMN 02 Mercatorstraat
650,Mercatorstraat 36,2023-07-07,20:00:00,273,124,149,FMN 02 Mercatorstraat
650,Mercatorstraat 36,2023-07-07,21:00:00,229,103,126,FMN 02 Mercatorstraat
650,Mercatorstraat 36,2023-07-07,22:00:00,216,89,127,FMN 02 Mercatorstraat
650,Mercatorstraat 36,2023-07-07,23:00:00,207,75,132,FMN 02 Mercatorstraat
650,Mercatorstraat 36,2023-07-08,00:00:00,187,72,115,FMN 02 Mercatorstraat
650,Mercatorstraat 36,2023-07-08,01:00:00,164,64,100,FMN 02 Mercatorstraat
650,Mercatorstraat 36,2023-07-08,02:00:00,76,24,52,FMN 02 Mercatorstraat
650,Mercatorstraat 36,2023-07-08,03:00:00,51,23,28,FMN 02 Mercatorstraat
650,Mercatorstraat 36,2023-07-08,04:00:00,62,18,44,FMN 02 Mercatorstraat
650,Mercatorstraat 36,2023-07-08,05:00:00,45,22,23,FMN 02 Mercatorstraat
650,Mercatorstraat 36,2023-07-08,06:00:00,49,26,23,FMN 02 Mercatorstraat
650,Mercatorstraat 36,2023-07-08,07:00:00,61,30,31,FMN 02 Mercatorstraat
650,Mercatorstraat 36,2023-07-08,08:00:00,100,68,32,FMN 02 Mercatorstraat
650,Mercatorstraat 36,2023-07-08,09:00:00,273,210,63,FMN 02 Mercatorstraat
650,Mercatorstraat 36,2023-07-08,10:00:00,353,243,110,FMN 02 Mercatorstraat
650,Mercatorstraat 36,2023-07-08,11:00:00,338,192,146,FMN 02 Mercatorstraat
650,Mercatorstraat 36,2023-07-08,12:00:00,349,197,152,FMN 02 Mercatorstraat
650,Mercatorstraat 36,2023-07-08,13:00:00,343,186,157,FMN 02 Mercatorstraat
650,Mercatorstraat 36,2023-07-08,14:00:00,334,192,142,FMN 02 Mercatorstraat
650,Mercatorstraat 36,2023-07-08,15:00:00,372,205,167,FMN 02 Mercatorstraat
650,Mercatorstraat 36,2023-07-08,16:00:00,344,157,187,FMN 02 Mercatorstraat
650,Mercatorstraat 36,2023-07-08,17:00:00,343,179,164,FMN 02 Mercatorstraat
650,Mercatorstraat 36,2023-07-08,18:00:00,344,143,201,FMN 02 Mercatorstraat
650,Mercatorstraat 36,2023-07-08,19:00:00,281,142,139,FMN 02 Mercatorstraat
650,Mercatorstraat 36,2023-07-08,20:00:00,296,128,168,FMN 02 Mercatorstraat
650,Mercatorstraat 36,2023-07-08,21:00:00,247,133,114,FMN 02 Mercatorstraat
650,Mercatorstraat 36,2023-07-08,22:00:00,215,99,116,FMN 02 Mercatorstraat
650,Mercatorstraat 36,2023-07-08,23:00:00,230,77,153,FMN 02 Mercatorstraat
650,Mercatorstraat 36,2023-07-09,00:00:00,163,74,89,FMN 02 Mercatorstraat
650,Mercatorstraat 36,2023-07-09,01:00:00,148,65,83,FMN 02 Mercatorstraat
650,Mercatorstraat 36,2023-07-09,02:00:00,78,20,58,FMN 02 Mercatorstraat
650,Mercatorstraat 36,2023-07-09,03:00:00,74,17,57,FMN 02 Mercatorstraat
650,Mercatorstraat 36,2023-07-09,04:00:00,56,9,47,FMN 02 Mercatorstraat
650,Mercatorstraat 36,2023-07-09,05:00:00,50,12,38,FMN 02 Mercatorstraat
650,Mercatorstraat 36,2023-07-09,06:00:00,45,18,27,FMN 02 Mercatorstraat
650,Mercatorstraat 36,2023-07-09,07:00:00,63,30,33,FMN 02 Mercatorstraat
650,Mercatorstraat 36,2023-07-09,08:00:00,96,61,35,FMN 02 Mercatorstraat
650,Mercatorstraat 36,2023-07-09,09:00:00,241,136,105,FMN 02 Mercatorstraat
650,Mercatorstraat 36,2023-07-09,10:00:00,236,147,89,FMN 02 Mercatorstraat
650,Mercatorstraat 36,2023-07-09,11:00:00,274,168,106,FMN 02 Mercatorstraat
650,Mercatorstraat 36,2023-07-09,12:00:00,322,177,145,FMN 02 Mercatorstraat
650,Mercatorstraat 36,2023-07-09,13:00:00,303,158,145,FMN 02 Mercatorstraat
650,Mercatorstraat 36,2023-07-09,14:00:00,292,142,150,FMN 02 Mercatorstraat
650,Mercatorstraat 36,2023-07-09,15:00:00,152,66,86,FMN 02 Mercatorstraat
650,Mercatorstraat 36,2023-07-09,16:00:00,196,93,103,FMN 02 Mercatorstraat
650,Mercatorstraat 36,2023-07-09,17:00:00,223,109,114,FMN 02 Mercatorstraat
650,Mercatorstraat 36,2023-07-09,18:00:00,236,118,118,FMN 02 Mercatorstraat
650,Mercatorstraat 36,2023-07-09,19:00:00,258,128,130,FMN 02 Mercatorstraat
650,Mercatorstraat 36,2023-07-09,20:00:00,227,120,107,FMN 02 Mercatorstraat
650,Mercatorstraat 36,2023-07-09,21:00:00,205,100,105,FMN 02 Mercatorstraat
650,Mercatorstraat 36,2023-07-09,22:00:00,191,80,111,FMN 02 Mercatorstraat
650,Mercatorstraat 36,2023-07-09,23:00:00,110,45,65,FMN 02 Mercatorstraat
650,Mercatorstraat 36,2023-07-10,00:00:00,70,25,45,FMN 02 Mercatorstraat
650,Mercatorstraat 36,2023-07-10,01:00:00,45,13,32,FMN 02 Mercatorstraat
650,Mercatorstraat 36,2023-07-10,02:00:00,24,11,13,FMN 02 Mercatorstraat
650,Mercatorstraat 36,2023-07-10,03:00:00,12,8,4,FMN 02 Mercatorstraat
650,Mercatorstraat 36,2023-07-10,04:00:00,39,26,13,FMN 02 Mercatorstraat
650,Mercatorstraat 36,2023-07-10,05:00:00,57,35,22,FMN 02 Mercatorstraat
650,Mercatorstraat 36,2023-07-10,06:00:00,131,88,43,FMN 02 Mercatorstraat
650,Mercatorstraat 36,2023-07-10,07:00:00,275,173,102,FMN 02 Mercatorstraat
650,Mercatorstraat 36,2023-07-10,08:00:00,573,407,166,FMN 02 Mercatorstraat
650,Mercatorstraat 36,2023-07-10,09:00:00,436,295,141,FMN 02 Mercatorstraat
650,Mercatorstraat 36,2023-07-10,10:00:00,300,187,113,FMN 02 Mercatorstraat
650,Mercatorstraat 36,2023-07-10,11:00:00,288,185,103,FMN 02 Mercatorstraat
650,Mercatorstraat 36,2023-07-10,12:00:00,386,217,169,FMN 02 Mercatorstraat
650,Mercatorstraat 36,2023-07-10,13:00:00,357,186,171,FMN 02 Mercatorstraat
650,Mercatorstraat 36,2023-07-10,14:00:00,402,232,170,FMN 02 Mercatorstraat
650,Mercatorstraat 36,2023-07-10,15:00:00,430,194,236,FMN 02 Mercatorstraat
650,Mercatorstraat 36,2023-07-10,16:00:00,574,235,339,FMN 02 Mercatorstraat
650,Mercatorstraat 36,2023-07-10,17:00:00,725,260,465,FMN 02 Mercatorstraat
650,Mercatorstraat 36,2023-07-10,18:00:00,493,191,302,FMN 02 Mercatorstraat
650,Mercatorstraat 36,2023-07-10,19:00:00,340,177,163,FMN 02 Mercatorstraat
650,Mercatorstraat 36,2023-07-10,20:00:00,275,142,133,FMN 02 Mercatorstraat
650,Mercatorstraat 36,2023-07-10,21:00:00,242,108,134,FMN 02 Mercatorstraat
650,Mercatorstraat 36,2023-07-10,22:00:00,193,76,117,FMN 02 Mercatorstraat
650,Mercatorstraat 36,2023-07-10,23:00:00,133,48,85,FMN 02 Mercatorstraat
650,Mercatorstraat 36,2023-07-11,00:00:00,80,29,51,FMN 02 Mercatorstraat
650,Mercatorstraat 36,2023-07-11,01:00:00,45,15,30,FMN 02 Mercatorstraat
650,Mercatorstraat 36,2023-07-11,02:00:00,33,10,23,FMN 02 Mercatorstraat
650,Mercatorstraat 36,2023-07-11,03:00:00,17,9,8,FMN 02 Mercatorstraat
650,Mercatorstraat 36,2023-07-11,04:00:00,38,24,14,FMN 02 Mercatorstraat
650,Mercatorstraat 36,2023-07-11,05:00:00,56,37,19,FMN 02 Mercatorstraat
650,Mercatorstraat 36,2023-07-11,06:00:00,153,97,56,FMN 02 Mercatorstraat
650,Mercatorstraat 36,2023-07-11,07:00:00,248,160,88,FMN 02 Mercatorstraat
650,Mercatorstraat 36,2023-07-11,08:00:00,576,391,185,FMN 02 Mercatorstraat
650,Mercatorstraat 36,2023-07-11,09:00:00,457,311,146,FMN 02 Mercatorstraat
650,Mercatorstraat 36,2023-07-11,10:00:00,312,210,102,FMN 02 Mercatorstraat
650,Mercatorstraat 36,2023-07-11,11:00:00,317,167,150,FMN 02 Mercatorstraat
650,Mercatorstraat 36,2023-07-11,12:00:00,344,190,154,FMN 02 Mercatorstraat
650,Mercatorstraat 36,2023-07-11,13:00:00,386,216,170,FMN 02 Mercatorstraat
650,Mercatorstraat 36,2023-07-11,14:00:00,405,204,201,FMN 02 Mercatorstraat
650,Mercatorstraat 36,2023-07-11,15:00:00,423,218,205,FMN 02 Mercatorstraat
650,Mercatorstraat 36,2023-07-11,16:00:00,539,207,332,FMN 02 Mercatorstraat
650,Mercatorstraat 36,2023-07-11,17:00:00,703,299,404,FMN 02 Mercatorstraat
650,Mercatorstraat 36,2023-07-11,18:00:00,576,264,312,FMN 02 Mercatorstraat
650,Mercatorstraat 36,2023-07-11,19:00:00,400,191,209,FMN 02 Mercatorstraat
650,Mercatorstraat 36,2023-07-11,20:00:00,340,167,173,FMN 02 Mercatorstraat
650,Mercatorstraat 36,2023-07-11,21:00:00,280,149,131,FMN 02 Mercatorstraat
650,Mercatorstraat 36,2023-07-11,22:00:00,277,88,189,FMN 02 Mercatorstraat
650,Mercatorstraat 36,2023-07-11,23:00:00,180,54,126,FMN 02 Mercatorstraat
650,Mercatorstraat 36,2023-07-12,00:00:00,110,31,79,FMN 02 Mercatorstraat
650,Mercatorstraat 36,2023-07-12,01:00:00,67,21,46,FMN 02 Mercatorstraat
650,Mercatorstraat 36,2023-07-12,02:00:00,18,1,17,FMN 02 Mercatorstraat
650,Mercatorstraat 36,2023-07-12,03:00:00,14,6,8,FMN 02 Mercatorstraat
650,Mercatorstraat 36,2023-07-12,04:00:00,37,18,19,FMN 02 Mercatorstraat
650,Mercatorstraat 36,2023-07-12,05:00:00,59,37,22,FMN 02 Mercatorstraat
650,Mercatorstraat 36,2023-07-12,06:00:00,129,91,38,FMN 02 Mercatorstraat
650,Mercatorstraat 36,2023-07-12,07:00:00,269,168,101,FMN 02 Mercatorstraat
650,Mercatorstraat 36,2023-07-12,08:00:00,593,416,177,FMN 02 Mercatorstraat
650,Mercatorstraat 36,2023-07-12,09:00:00,405,258,147,FMN 02 Mercatorstraat
650,Mercatorstraat 36,2023-07-12,10:00:00,288,194,94,FMN 02 Mercatorstraat
650,Mercatorstraat 36,2023-07-12,11:00:00,284,156,128,FMN 02 Mercatorstraat
650,Mercatorstraat 36,2023-07-12,12:00:00,369,202,167,FMN 02 Mercatorstraat
650,Mercatorstraat 36,2023-07-12,13:00:00,341,183,158,FMN 02 Mercatorstraat
650,Mercatorstraat 36,2023-07-12,14:00:00,353,195,158,FMN 02 Mercatorstraat
650,Mercatorstraat 36,2023-07-12,15:00:00,394,170,224,FMN 02 Mercatorstraat
650,Mercatorstraat 36,2023-07-12,16:00:00,576,253,323,FMN 02 Mercatorstraat
650,Mercatorstraat 36,2023-07-12,17:00:00,696,247,449,FMN 02 Mercatorstraat
650,Mercatorstraat 36,2023-07-12,18:00:00,559,239,320,FMN 02 Mercatorstraat
650,Mercatorstraat 36,2023-07-12,19:00:00,335,156,179,FMN 02 Mercatorstraat
650,Mercatorstraat 36,2023-07-12,20:00:00,284,130,154,FMN 02 Mercatorstraat
650,Mercatorstraat 36,2023-07-12,21:00:00,214,95,119,FMN 02 Mercatorstraat
650,Mercatorstraat 36,2023-07-12,22:00:00,256,115,141,FMN 02 Mercatorstraat
650,Mercatorstraat 36,2023-07-12,23:00:00,169,68,101,FMN 02 Mercatorstraat
650,Mercatorstraat 36,2023-07-13,00:00:00,93,36,57,FMN 02 Mercatorstraat
650,Mercatorstraat 36,2023-07-13,01:00:00,45,20,25,FMN 02 Mercatorstraat
650,Mercatorstraat 36,2023-07-13,02:00:00,30,10,20,FMN 02 Mercatorstraat
650,Mercatorstraat 36,2023-07-13,03:00:00,23,15,8,FMN 02 Mercatorstraat
650,Mercatorstraat 36,2023-07-13,04:00:00,33,17,16,FMN 02 Mercatorstraat
650,Mercatorstraat 36,2023-07-13,05:00:00,61,38,23,FMN 02 Mercatorstraat
650,Mercatorstraat 36,2023-07-13,06:00:00,112,68,44,FMN 02 Mercatorstraat
650,Mercatorstraat 36,2023-07-13,07:00:00,294,197,97,FMN 02 Mercatorstraat
650,Mercatorstraat 36,2023-07-13,08:00:00,641,438,203,FMN 02 Mercatorstraat
650,Mercatorstraat 36,2023-07-13,09:00:00,409,283,126,FMN 02 Mercatorstraat
650,Mercatorstraat 36,2023-07-13,10:00:00,276,201,75,FMN 02 Mercatorstraat
650,Mercatorstraat 36,2023-07-13,11:00:00,248,157,91,FMN 02 Mercatorstraat
650,Mercatorstraat 36,2023-07-13,12:00:00,321,164,157,FMN 02 Mercatorstraat
650,Mercatorstraat 36,2023-07-13,13:00:00,277,140,137,FMN 02 Mercatorstraat
650,Mercatorstraat 36,2023-07-13,14:00:00,284,129,155,FMN 02 Mercatorstraat
650,Mercatorstraat 36,2023-07-13,15:00:00,360,164,196,FMN 02 Mercatorstraat
650,Mercatorstraat 36,2023-07-13,16:00:00,527,212,315,FMN 02 Mercatorstraat
650,Mercatorstraat 36,2023-07-13,17:00:00,651,255,396,FMN 02 Mercatorstraat
650,Mercatorstraat 36,2023-07-13,18:00:00,530,222,308,FMN 02 Mercatorstraat
650,Mercatorstraat 36,2023-07-13,19:00:00,322,154,168,FMN 02 Mercatorstraat
650,Mercatorstraat 36,2023-07-13,20:00:00,223,93,130,FMN 02 Mercatorstraat
650,Mercatorstraat 36,2023-07-13,21:00:00,235,90,145,FMN 02 Mercatorstraat
650,Mercatorstraat 36,2023-07-13,22:00:00,193,87,106,FMN 02 Mercatorstraat
650,Mercatorstraat 36,2023-07-13,23:00:00,137,51,86,FMN 02 Mercatorstraat
650,Mercatorstraat 36,2023-07-14,00:00:00,122,49,73,FMN 02 Mercatorstraat
650,Mercatorstraat 36,2023-07-14,01:00:00,57,28,29,FMN 02 Mercatorstraat
650,Mercatorstraat 36,2023-07-14,02:00:00,24,9,15,FMN 02 Mercatorstraat
650,Mercatorstraat 36,2023-07-14,03:00:00,35,12,23,FMN 02 Mercatorstraat
650,Mercatorstraat 36,2023-07-14,04:00:00,39,16,23,FMN 02 Mercatorstraat
650,Mercatorstraat 36,2023-07-14,05:00:00,58,35,23,FMN 02 Mercatorstraat
650,Mercatorstraat 36,2023-07-14,06:00:00,126,81,45,FMN 02 Mercatorstraat
650,Mercatorstraat 36,2023-07-14,07:00:00,232,153,79,FMN 02 Mercatorstraat
650,Mercatorstraat 36,2023-07-14,08:00:00,526,378,148,FMN 02 Mercatorstraat
650,Mercatorstraat 36,2023-07-14,09:00:00,475,330,145,FMN 02 Mercatorstraat
650,Mercatorstraat 36,2023-07-14,10:00:00,328,225,103,FMN 02 Mercatorstraat
650,Mercatorstraat 36,2023-07-14,11:00:00,310,179,131,FMN 02 Mercatorstraat
650,Mercatorstraat 36,2023-07-14,12:00:00,374,217,157,FMN 02 Mercatorstraat
650,Mercatorstraat 36,2023-07-14,13:00:00,362,179,183,FMN 02 Mercatorstraat
650,Mercatorstraat 36,2023-07-14,14:00:00,434,232,202,FMN 02 Mercatorstraat
650,Mercatorstraat 36,2023-07-14,15:00:00,459,204,255,FMN 02 Mercatorstraat
650,Mercatorstraat 36,2023-07-14,16:00:00,541,232,309,FMN 02 Mercatorstraat
650,Mercatorstraat 36,2023-07-14,17:00:00,573,233,340,FMN 02 Mercatorstraat
650,Mercatorstraat 36,2023-07-14,18:00:00,488,212,276,FMN 02 Mercatorstraat
650,Mercatorstraat 36,2023-07-14,19:00:00,414,206,208,FMN 02 Mercatorstraat
650,Mercatorstraat 36,2023-07-14,20:00:00,314,131,183,FMN 02 Mercatorstraat
650,Mercatorstraat 36,2023-07-14,21:00:00,233,112,121,FMN 02 Mercatorstraat
650,Mercatorstraat 36,2023-07-14,22:00:00,209,95,114,FMN 02 Mercatorstraat
650,Mercatorstraat 36,2023-07-14,23:00:00,212,85,127,FMN 02 Mercatorstraat
650,Mercatorstraat 36,2023-07-15,00:00:00,139,71,68,FMN 02 Mercatorstraat
650,Mercatorstraat 36,2023-07-15,01:00:00,133,66,67,FMN 02 Mercatorstraat
650,Mercatorstraat 36,2023-07-15,02:00:00,85,28,57,FMN 02 Mercatorstraat
650,Mercatorstraat 36,2023-07-15,03:00:00,56,20,36,FMN 02 Mercatorstraat
650,Mercatorstraat 36,2023-07-15,04:00:00,44,9,35,FMN 02 Mercatorstraat
650,Mercatorstraat 36,2023-07-15,05:00:00,37,20,17,FMN 02 Mercatorstraat
650,Mercatorstraat 36,2023-07-15,06:00:00,59,26,33,FMN 02 Mercatorstraat
650,Mercatorstraat 36,2023-07-15,07:00:00,62,38,24,FMN 02 Mercatorstraat
650,Mercatorstraat 36,2023-07-15,08:00:00,97,61,36,FMN 02 Mercatorstraat
650,Mercatorstraat 36,2023-07-15,09:00:00,207,153,54,FMN 02 Mercatorstraat
650,Mercatorstraat 36,2023-07-15,10:00:00,266,189,77,FMN 02 Mercatorstraat
650,Mercatorstraat 36,2023-07-15,11:00:00,326,194,132,FMN 02 Mercatorstraat
650,Mercatorstraat 36,2023-07-15,12:00:00,309,189,120,FMN 02 Mercatorstraat
650,Mercatorstraat 36,2023-07-15,13:00:00,361,210,151,FMN 02 Mercatorstraat
650,Mercatorstraat 36,2023-07-15,14:00:00,364,208,156,FMN 02 Mercatorstraat
650,Mercatorstraat 36,2023-07-15,15:00:00,326,166,160,FMN 02 Mercatorstraat
650,Mercatorstraat 36,2023-07-15,16:00:00,365,154,211,FMN 02 Mercatorstraat
650,Mercatorstraat 36,2023-07-15,17:00:00,251,98,153,FMN 02 Mercatorstraat
650,Mercatorstraat 36,2023-07-15,18:00:00,341,149,192,FMN 02 Mercatorstraat
650,Mercatorstraat 36,2023-07-15,19:00:00,226,103,123,FMN 02 Mercatorstraat
650,Mercatorstraat 36,2023-07-15,20:00:00,209,115,94,FMN 02 Mercatorstraat
650,Mercatorstraat 36,2023-07-15,21:00:00,167,76,91,FMN 02 Mercatorstraat
650,Mercatorstraat 36,2023-07-15,22:00:00,167,92,75,FMN 02 Mercatorstraat
650,Mercatorstraat 36,2023-07-15,23:00:00,163,66,97,FMN 02 Mercatorstraat
650,Mercatorstraat 36,2023-07-16,00:00:00,180,70,110,FMN 02 Mercatorstraat
650,Mercatorstraat 36,2023-07-16,01:00:00,131,58,73,FMN 02 Mercatorstraat
650,Mercatorstraat 36,2023-07-16,02:00:00,70,19,51,FMN 02 Mercatorstraat
650,Mercatorstraat 36,2023-07-16,03:00:00,54,26,28,FMN 02 Mercatorstraat
650,Mercatorstraat 36,2023-07-16,04:00:00,45,18,27,FMN 02 Mercatorstraat
650,Mercatorstraat 36,2023-07-16,05:00:00,29,9,20,FMN 02 Mercatorstraat
650,Mercatorstraat 36,2023-07-16,06:00:00,35,12,23,FMN 02 Mercatorstraat
650,Mercatorstraat 36,2023-07-16,07:00:00,56,37,19,FMN 02 Mercatorstraat
650,Mercatorstraat 36,2023-07-16,08:00:00,69,39,30,FMN 02 Mercatorstraat
650,Mercatorstraat 36,2023-07-16,09:00:00,160,86,74,FMN 02 Mercatorstraat
650,Mercatorstraat 36,2023-07-16,10:00:00,230,142,88,FMN 02 Mercatorstraat
650,Mercatorstraat 36,2023-07-16,11:00:00,259,146,113,FMN 02 Mercatorstraat
650,Mercatorstraat 36,2023-07-16,12:00:00,247,118,129,FMN 02 Mercatorstraat
650,Mercatorstraat 36,2023-07-16,13:00:00,261,154,107,FMN 02 Mercatorstraat
650,Mercatorstraat 36,2023-07-16,14:00:00,237,123,114,FMN 02 Mercatorstraat
650,Mercatorstraat 36,2023-07-16,15:00:00,264,142,122,FMN 02 Mercatorstraat
650,Mercatorstraat 36,2023-07-16,16:00:00,278,129,149,FMN 02 Mercatorstraat
650,Mercatorstraat 36,2023-07-16,17:00:00,272,88,184,FMN 02 Mercatorstraat
650,Mercatorstraat 36,2023-07-16,18:00:00,253,120,133,FMN 02 Mercatorstraat
650,Mercatorstraat 36,2023-07-16,19:00:00,234,105,129,FMN 02 Mercatorstraat
650,Mercatorstraat 36,2023-07-16,20:00:00,214,100,114,FMN 02 Mercatorstraat
650,Mercatorstraat 36,2023-07-16,21:00:00,179,92,87,FMN 02 Mercatorstraat
650,Mercatorstraat 36,2023-07-16,22:00:00,156,61,95,FMN 02 Mercatorstraat
650,Mercatorstraat 36,2023-07-16,23:00:00,87,38,49,FMN 02 Mercatorstraat
650,Mercatorstraat 36,2023-07-17,00:00:00,63,32,31,FMN 02 Mercatorstraat
650,Mercatorstraat 36,2023-07-17,01:00:00,29,15,14,FMN 02 Mercatorstraat
650,Mercatorstraat 36,2023-07-17,02:00:00,14,2,12,FMN 02 Mercatorstraat
650,Mercatorstraat 36,2023-07-17,03:00:00,17,9,8,FMN 02 Mercatorstraat
650,Mercatorstraat 36,2023-07-17,04:00:00,29,19,10,FMN 02 Mercatorstraat
650,Mercatorstraat 36,2023-07-17,05:00:00,51,33,18,FMN 02 Mercatorstraat
650,Mercatorstraat 36,2023-07-17,06:00:00,105,68,37,FMN 02 Mercatorstraat
650,Mercatorstraat 36,2023-07-17,07:00:00,304,192,112,FMN 02 Mercatorstraat
650,Mercatorstraat 36,2023-07-17,08:00:00,529,382,147,FMN 02 Mercatorstraat
650,Mercatorstraat 36,2023-07-17,09:00:00,384,255,129,FMN 02 Mercatorstraat
650,Mercatorstraat 36,2023-07-17,10:00:00,260,182,78,FMN 02 Mercatorstraat
650,Mercatorstraat 36,2023-07-17,11:00:00,264,169,95,FMN 02 Mercatorstraat
650,Mercatorstraat 36,2023-07-17,12:00:00,275,139,136,FMN 02 Mercatorstraat
650,Mercatorstraat 36,2023-07-17,13:00:00,303,149,154,FMN 02 Mercatorstraat
650,Mercatorstraat 36,2023-07-17,14:00:00,274,146,128,FMN 02 Mercatorstraat
650,Mercatorstraat 36,2023-07-17,15:00:00,339,147,192,FMN 02 Mercatorstraat
650,Mercatorstraat 36,2023-07-17,16:00:00,423,165,258,FMN 02 Mercatorstraat
650,Mercatorstraat 36,2023-07-17,17:00:00,656,233,423,FMN 02 Mercatorstraat
650,Mercatorstraat 36,2023-07-17,18:00:00,462,182,280,FMN 02 Mercatorstraat
650,Mercatorstraat 36,2023-07-17,19:00:00,286,134,152,FMN 02 Mercatorstraat
650,Mercatorstraat 36,2023-07-17,20:00:00,206,91,115,FMN 02 Mercatorstraat
650,Mercatorstraat 36,2023-07-17,21:00:00,163,73,90,FMN 02 Mercatorstraat
650,Mercatorstraat 36,2023-07-17,22:00:00,165,70,95,FMN 02 Mercatorstraat
650,Mercatorstraat 36,2023-07-17,23:00:00,109,52,57,FMN 02 Mercatorstraat
650,Mercatorstraat 36,2023-07-18,00:00:00,78,32,46,FMN 02 Mercatorstraat
650,Mercatorstraat 36,2023-07-18,01:00:00,30,9,21,FMN 02 Mercatorstraat
650,Mercatorstraat 36,2023-07-18,02:00:00,13,5,8,FMN 02 Mercatorstraat
650,Mercatorstraat 36,2023-07-18,03:00:00,14,7,7,FMN 02 Mercatorstraat
650,Mercatorstraat 36,2023-07-18,04:00:00,29,17,12,FMN 02 Mercatorstraat
650,Mercatorstraat 36,2023-07-18,05:00:00,46,34,12,FMN 02 Mercatorstraat
650,Mercatorstraat 36,2023-07-18,06:00:00,110,78,32,FMN 02 Mercatorstraat
650,Mercatorstraat 36,2023-07-18,07:00:00,295,191,104,FMN 02 Mercatorstraat
650,Mercatorstraat 36,2023-07-18,08:00:00,652,472,180,FMN 02 Mercatorstraat
650,Mercatorstraat 36,2023-07-18,09:00:00,445,296,149,FMN 02 Mercatorstraat
650,Mercatorstraat 36,2023-07-18,10:00:00,312,207,105,FMN 02 Mercatorstraat
650,Mercatorstraat 36,2023-07-18,11:00:00,305,193,112,FMN 02 Mercatorstraat
650,Mercatorstraat 36,2023-07-18,12:00:00,391,212,179,FMN 02 Mercatorstraat
650,Mercatorstraat 36,2023-07-18,13:00:00,395,210,185,FMN 02 Mercatorstraat
650,Mercatorstraat 36,2023-07-18,14:00:00,385,192,193,FMN 02 Mercatorstraat
650,Mercatorstraat 36,2023-07-18,15:00:00,411,188,223,FMN 02 Mercatorstraat
650,Mercatorstraat 36,2023-07-18,16:00:00,597,241,356,FMN 02 Mercatorstraat
650,Mercatorstraat 36,2023-07-18,17:00:00,753,278,475,FMN 02 Mercatorstraat
650,Mercatorstraat 36,2023-07-18,18:00:00,567,232,335,FMN 02 Mercatorstraat
650,Mercatorstraat 36,2023-07-18,19:00:00,393,151,242,FMN 02 Mercatorstraat
650,Mercatorstraat 36,2023-07-18,20:00:00,260,114,146,FMN 02 Mercatorstraat
650,Mercatorstraat 36,2023-07-18,21:00:00,247,123,124,FMN 02 Mercatorstraat
650,Mercatorstraat 36,2023-07-18,22:00:00,225,88,137,FMN 02 Mercatorstraat
650,Mercatorstraat 36,2023-07-18,23:00:00,138,48,90,FMN 02 Mercatorstraat
650,Mercatorstraat 36,2023-07-19,00:00:00,72,26,46,FMN 02 Mercatorstraat
650,Mercatorstraat 36,2023-07-19,01:00:00,28,10,18,FMN 02 Mercatorstraat
650,Mercatorstraat 36,2023-07-19,02:00:00,25,4,21,FMN 02 Mercatorstraat
650,Mercatorstraat 36,2023-07-19,03:00:00,23,7,16,FMN 02 Mercatorstraat
650,Mercatorstraat 36,2023-07-19,04:00:00,35,22,13,FMN 02 Mercatorstraat
650,Mercatorstraat 36,2023-07-19,05:00:00,66,42,24,FMN 02 Mercatorstraat
650,Mercatorstraat 36,2023-07-19,06:00:00,108,73,35,FMN 02 Mercatorstraat
650,Mercatorstraat 36,2023-07-19,07:00:00,242,157,85,FMN 02 Mercatorstraat
650,Mercatorstraat 36,2023-07-19,08:00:00,572,413,159,FMN 02 Mercatorstraat
650,Mercatorstraat 36,2023-07-19,09:00:00,393,265,128,FMN 02 Mercatorstraat
650,Mercatorstraat 36,2023-07-19,10:00:00,293,180,113,FMN 02 Mercatorstraat
650,Mercatorstraat 36,2023-07-19,11:00:00,281,184,97,FMN 02 Mercatorstraat
650,Mercatorstraat 36,2023-07-19,12:00:00,357,187,170,FMN 02 Mercatorstraat
650,Mercatorstraat 36,2023-07-19,13:00:00,320,190,130,FMN 02 Mercatorstraat
650,Mercatorstraat 36,2023-07-19,14:00:00,342,201,141,FMN 02 Mercatorstraat
650,Mercatorstraat 36,2023-07-19,15:00:00,365,170,195,FMN 02 Mercatorstraat
650,Mercatorstraat 36,2023-07-19,16:00:00,522,192,330,FMN 02 Mercatorstraat
650,Mercatorstraat 36,2023-07-19,17:00:00,608,224,384,FMN 02 Mercatorstraat
650,Mercatorstraat 36,2023-07-19,18:00:00,439,157,282,FMN 02 Mercatorstraat
650,Mercatorstraat 36,2023-07-19,19:00:00,303,154,149,FMN 02 Mercatorstraat
650,Mercatorstraat 36,2023-07-19,20:00:00,255,113,142,FMN 02 Mercatorstraat
650,Mercatorstraat 36,2023-07-19,21:00:00,204,91,113,FMN 02 Mercatorstraat
650,Mercatorstraat 36,2023-07-19,22:00:00,159,63,96,FMN 02 Mercatorstraat
650,Mercatorstraat 36,2023-07-19,23:00:00,136,50,86,FMN 02 Mercatorstraat
650,Mercatorstraat 36,2023-07-20,00:00:00,85,28,57,FMN 02 Mercatorstraat
650,Mercatorstraat 36,2023-07-20,01:00:00,53,21,32,FMN 02 Mercatorstraat
650,Mercatorstraat 36,2023-07-20,02:00:00,25,9,16,FMN 02 Mercatorstraat
650,Mercatorstraat 36,2023-07-20,03:00:00,22,6,16,FMN 02 Mercatorstraat
650,Mercatorstraat 36,2023-07-20,04:00:00,34,20,14,FMN 02 Mercatorstraat
650,Mercatorstraat 36,2023-07-20,05:00:00,56,35,21,FMN 02 Mercatorstraat
650,Mercatorstraat 36,2023-07-20,06:00:00,111,77,34,FMN 02 Mercatorstraat
650,Mercatorstraat 36,2023-07-20,07:00:00,246,167,79,FMN 02 Mercatorstraat
650,Mercatorstraat 36,2023-07-20,08:00:00,520,366,154,FMN 02 Mercatorstraat
650,Mercatorstraat 36,2023-07-20,09:00:00,368,231,137,FMN 02 Mercatorstraat
650,Mercatorstraat 36,2023-07-20,10:00:00,288,197,91,FMN 02 Mercatorstraat
650,Mercatorstraat 36,2023-07-20,11:00:00,315,214,101,FMN 02 Mercatorstraat
650,Mercatorstraat 36,2023-07-20,12:00:00,367,205,162,FMN 02 Mercatorstraat
650,Mercatorstraat 36,2023-07-20,13:00:00,332,185,147,FMN 02 Mercatorstraat
650,Mercatorstraat 36,2023-07-20,14:00:00,361,198,163,FMN 02 Mercatorstraat
650,Mercatorstraat 36,2023-07-20,15:00:00,377,177,200,FMN 02 Mercatorstraat
650,Mercatorstraat 36,2023-07-20,16:00:00,553,233,320,FMN 02 Mercatorstraat
650,Mercatorstraat 36,2023-07-20,17:00:00,594,211,383,FMN 02 Mercatorstraat
650,Mercatorstraat 36,2023-07-20,18:00:00,448,194,254,FMN 02 Mercatorstraat
650,Mercatorstraat 36,2023-07-20,19:00:00,317,161,156,FMN 02 Mercatorstraat
650,Mercatorstraat 36,2023-07-20,20:00:00,258,121,137,FMN 02 Mercatorstraat
650,Mercatorstraat 36,2023-07-20,21:00:00,206,101,105,FMN 02 Mercatorstraat
650,Mercatorstraat 36,2023-07-20,22:00:00,201,100,101,FMN 02 Mercatorstraat
650,Mercatorstraat 36,2023-07-20,23:00:00,191,72,119,FMN 02 Mercatorstraat
650,Mercatorstraat 36,2023-07-21,00:00:00,93,38,55,FMN 02 Mercatorstraat
650,Mercatorstraat 36,2023-07-21,01:00:00,62,17,45,FMN 02 Mercatorstraat
650,Mercatorstraat 36,2023-07-21,02:00:00,68,22,46,FMN 02 Mercatorstraat
650,Mercatorstraat 36,2023-07-21,03:00:00,50,13,37,FMN 02 Mercatorstraat
650,Mercatorstraat 36,2023-07-21,04:00:00,44,14,30,FMN 02 Mercatorstraat
650,Mercatorstraat 36,2023-07-21,05:00:00,49,13,36,FMN 02 Mercatorstraat
650,Mercatorstraat 36,2023-07-21,06:00:00,61,38,23,FMN 02 Mercatorstraat
650,Mercatorstraat 36,2023-07-21,07:00:00,67,36,31,FMN 02 Mercatorstraat
650,Mercatorstraat 36,2023-07-21,08:00:00,105,74,31,FMN 02 Mercatorstraat
650,Mercatorstraat 36,2023-07-21,09:00:00,214,109,105,FMN 02 Mercatorstraat
650,Mercatorstraat 36,2023-07-21,10:00:00,231,146,85,FMN 02 Mercatorstraat
650,Mercatorstraat 36,2023-07-21,11:00:00,225,132,93,FMN 02 Mercatorstraat
650,Mercatorstraat 36,2023-07-21,12:00:00,194,110,84,FMN 02 Mercatorstraat
650,Mercatorstraat 36,2023-07-21,13:00:00,213,121,92,FMN 02 Mercatorstraat
650,Mercatorstraat 36,2023-07-21,14:00:00,227,115,112,FMN 02 Mercatorstraat
650,Mercatorstraat 36,2023-07-21,15:00:00,278,176,102,FMN 02 Mercatorstraat
650,Mercatorstraat 36,2023-07-21,16:00:00,328,194,134,FMN 02 Mercatorstraat
650,Mercatorstraat 36,2023-07-21,17:00:00,291,157,134,FMN 02 Mercatorstraat
650,Mercatorstraat 36,2023-07-21,18:00:00,324,174,150,FMN 02 Mercatorstraat
650,Mercatorstraat 36,2023-07-21,19:00:00,270,141,129,FMN 02 Mercatorstraat
650,Mercatorstraat 36,2023-07-21,20:00:00,236,95,141,FMN 02 Mercatorstraat
650,Mercatorstraat 36,2023-07-21,21:00:00,213,101,112,FMN 02 Mercatorstraat
650,Mercatorstraat 36,2023-07-21,22:00:00,144,60,84,FMN 02 Mercatorstraat
650,Mercatorstraat 36,2023-07-21,23:00:00,162,56,106,FMN 02 Mercatorstraat
650,Mercatorstraat 36,2023-07-22,00:00:00,119,61,58,FMN 02 Mercatorstraat
650,Mercatorstraat 36,2023-07-22,01:00:00,84,34,50,FMN 02 Mercatorstraat
650,Mercatorstraat 36,2023-07-22,02:00:00,75,28,47,FMN 02 Mercatorstraat
650,Mercatorstraat 36,2023-07-22,03:00:00,41,12,29,FMN 02 Mercatorstraat
650,Mercatorstraat 36,2023-07-22,04:00:00,38,8,30,FMN 02 Mercatorstraat
650,Mercatorstraat 36,2023-07-22,05:00:00,35,17,18,FMN 02 Mercatorstraat
650,Mercatorstraat 36,2023-07-22,06:00:00,50,28,22,FMN 02 Mercatorstraat
650,Mercatorstraat 36,2023-07-22,07:00:00,51,32,19,FMN 02 Mercatorstraat
650,Mercatorstraat 36,2023-07-22,08:00:00,88,58,30,FMN 02 Mercatorstraat
650,Mercatorstraat 36,2023-07-22,09:00:00,168,125,43,FMN 02 Mercatorstraat
650,Mercatorstraat 36,2023-07-22,10:00:00,276,204,72,FMN 02 Mercatorstraat
650,Mercatorstraat 36,2023-07-22,11:00:00,306,206,100,FMN 02 Mercatorstraat
650,Mercatorstraat 36,2023-07-22,12:00:00,320,188,132,FMN 02 Mercatorstraat
650,Mercatorstraat 36,2023-07-22,13:00:00,348,214,134,FMN 02 Mercatorstraat
650,Mercatorstraat 36,2023-07-22,14:00:00,387,228,159,FMN 02 Mercatorstraat
650,Mercatorstraat 36,2023-07-22,15:00:00,304,154,150,FMN 02 Mercatorstraat
650,Mercatorstraat 36,2023-07-22,16:00:00,357,145,212,FMN 02 Mercatorstraat
650,Mercatorstraat 36,2023-07-22,17:00:00,291,108,183,FMN 02 Mercatorstraat
650,Mercatorstraat 36,2023-07-22,18:00:00,276,89,187,FMN 02 Mercatorstraat
650,Mercatorstraat 36,2023-07-22,19:00:00,237,126,111,FMN 02 Mercatorstraat
650,Mercatorstraat 36,2023-07-22,20:00:00,182,78,104,FMN 02 Mercatorstraat
650,Mercatorstraat 36,2023-07-22,21:00:00,134,59,75,FMN 02 Mercatorstraat
650,Mercatorstraat 36,2023-07-22,22:00:00,121,47,74,FMN 02 Mercatorstraat
650,Mercatorstraat 36,2023-07-22,23:00:00,125,38,87,FMN 02 Mercatorstraat
650,Mercatorstraat 36,2023-07-23,00:00:00,94,39,55,FMN 02 Mercatorstraat
650,Mercatorstraat 36,2023-07-23,01:00:00,69,37,32,FMN 02 Mercatorstraat
650,Mercatorstraat 36,2023-07-23,02:00:00,55,30,25,FMN 02 Mercatorstraat
650,Mercatorstraat 36,2023-07-23,03:00:00,34,12,22,FMN 02 Mercatorstraat
650,Mercatorstraat 36,2023-07-23,04:00:00,29,12,17,FMN 02 Mercatorstraat
650,Mercatorstraat 36,2023-07-23,05:00:00,34,12,22,FMN 02 Mercatorstraat
650,Mercatorstraat 36,2023-07-23,06:00:00,29,20,9,FMN 02 Mercatorstraat
650,Mercatorstraat 36,2023-07-23,07:00:00,29,14,15,FMN 02 Mercatorstraat
650,Mercatorstraat 36,2023-07-23,08:00:00,50,30,20,FMN 02 Mercatorstraat
650,Mercatorstraat 36,2023-07-23,09:00:00,92,58,34,FMN 02 Mercatorstraat
650,Mercatorstraat 36,2023-07-23,10:00:00,123,78,45,FMN 02 Mercatorstraat
650,Mercatorstraat 36,2023-07-23,11:00:00,153,99,54,FMN 02 Mercatorstraat
650,Mercatorstraat 36,2023-07-23,12:00:00,173,101,72,FMN 02 Mercatorstraat
650,Mercatorstraat 36,2023-07-23,13:00:00,242,142,100,FMN 02 Mercatorstraat
650,Mercatorstraat 36,2023-07-23,14:00:00,260,163,97,FMN 02 Mercatorstraat
650,Mercatorstraat 36,2023-07-23,15:00:00,229,117,112,FMN 02 Mercatorstraat
650,Mercatorstraat 36,2023-07-23,16:00:00,240,119,121,FMN 02 Mercatorstraat
650,Mercatorstraat 36,2023-07-23,17:00:00,208,106,102,FMN 02 Mercatorstraat
650,Mercatorstraat 36,2023-07-23,18:00:00,219,111,108,FMN 02 Mercatorstraat
650,Mercatorstraat 36,2023-07-23,19:00:00,119,54,65,FMN 02 Mercatorstraat
650,Mercatorstraat 36,2023-07-23,20:00:00,169,75,94,FMN 02 Mercatorstraat
650,Mercatorstraat 36,2023-07-23,21:00:00,127,59,68,FMN 02 Mercatorstraat
650,Mercatorstraat 36,2023-07-23,22:00:00,114,53,61,FMN 02 Mercatorstraat
650,Mercatorstraat 36,2023-07-23,23:00:00,65,24,41,FMN 02 Mercatorstraat
650,Mercatorstraat 36,2023-07-24,00:00:00,30,14,16,FMN 02 Mercatorstraat
650,Mercatorstraat 36,2023-07-24,01:00:00,17,8,9,FMN 02 Mercatorstraat
650,Mercatorstraat 36,2023-07-24,02:00:00,14,4,10,FMN 02 Mercatorstraat
650,Mercatorstraat 36,2023-07-24,03:00:00,7,4,3,FMN 02 Mercatorstraat
650,Mercatorstraat 36,2023-07-24,04:00:00,29,17,12,FMN 02 Mercatorstraat
650,Mercatorstraat 36,2023-07-24,05:00:00,32,19,13,FMN 02 Mercatorstraat
650,Mercatorstraat 36,2023-07-24,06:00:00,68,42,26,FMN 02 Mercatorstraat
650,Mercatorstraat 36,2023-07-24,07:00:00,215,142,73,FMN 02 Mercatorstraat
650,Mercatorstraat 36,2023-07-24,08:00:00,408,286,122,FMN 02 Mercatorstraat
650,Mercatorstraat 36,2023-07-24,09:00:00,263,189,74,FMN 02 Mercatorstraat
650,Mercatorstraat 36,2023-07-24,10:00:00,207,128,79,FMN 02 Mercatorstraat
650,Mercatorstraat 36,2023-07-24,11:00:00,163,105,58,FMN 02 Mercatorstraat
650,Mercatorstraat 36,2023-07-24,12:00:00,210,109,101,FMN 02 Mercatorstraat
650,Mercatorstraat 36,2023-07-24,13:00:00,237,130,107,FMN 02 Mercatorstraat
650,Mercatorstraat 36,2023-07-24,14:00:00,267,160,107,FMN 02 Mercatorstraat
650,Mercatorstraat 36,2023-07-24,15:00:00,218,100,118,FMN 02 Mercatorstraat
650,Mercatorstraat 36,2023-07-24,16:00:00,354,149,205,FMN 02 Mercatorstraat
650,Mercatorstraat 36,2023-07-24,17:00:00,433,142,291,FMN 02 Mercatorstraat
650,Mercatorstraat 36,2023-07-24,18:00:00,372,136,236,FMN 02 Mercatorstraat
650,Mercatorstraat 36,2023-07-24,19:00:00,268,129,139,FMN 02 Mercatorstraat
650,Mercatorstraat 36,2023-07-24,20:00:00,189,91,98,FMN 02 Mercatorstraat
650,Mercatorstraat 36,2023-07-24,21:00:00,169,62,107,FMN 02 Mercatorstraat
650,Mercatorstraat 36,2023-07-24,22:00:00,137,55,82,FMN 02 Mercatorstraat
650,Mercatorstraat 36,2023-07-24,23:00:00,106,40,66,FMN 02 Mercatorstraat
650,Mercatorstraat 36,2023-07-25,00:00:00,62,19,43,FMN 02 Mercatorstraat
650,Mercatorstraat 36,2023-07-25,01:00:00,21,11,10,FMN 02 Mercatorstraat
650,Mercatorstraat 36,2023-07-25,02:00:00,12,4,8,FMN 02 Mercatorstraat
650,Mercatorstraat 36,2023-07-25,03:00:00,14,5,9,FMN 02 Mercatorstraat
650,Mercatorstraat 36,2023-07-25,04:00:00,33,15,18,FMN 02 Mercatorstraat
650,Mercatorstraat 36,2023-07-25,05:00:00,48,31,17,FMN 02 Mercatorstraat
650,Mercatorstraat 36,2023-07-25,06:00:00,108,71,37,FMN 02 Mercatorstraat
650,Mercatorstraat 36,2023-07-25,07:00:00,252,163,89,FMN 02 Mercatorstraat
650,Mercatorstraat 36,2023-07-25,08:00:00,454,325,129,FMN 02 Mercatorstraat
650,Mercatorstraat 36,2023-07-25,09:00:00,335,241,94,FMN 02 Mercatorstraat
650,Mercatorstraat 36,2023-07-25,10:00:00,273,170,103,FMN 02 Mercatorstraat
650,Mercatorstraat 36,2023-07-25,11:00:00,225,145,80,FMN 02 Mercatorstraat
650,Mercatorstraat 36,2023-07-25,12:00:00,311,172,139,FMN 02 Mercatorstraat
650,Mercatorstraat 36,2023-07-25,13:00:00,344,191,153,FMN 02 Mercatorstraat
650,Mercatorstraat 36,2023-07-25,14:00:00,349,200,149,FMN 02 Mercatorstraat
650,Mercatorstraat 36,2023-07-25,15:00:00,386,175,211,FMN 02 Mercatorstraat
650,Mercatorstraat 36,2023-07-25,16:00:00,556,215,341,FMN 02 Mercatorstraat
650,Mercatorstraat 36,2023-07-25,17:00:00,667,256,411,FMN 02 Mercatorstraat
650,Mercatorstraat 36,2023-07-25,18:00:00,515,201,314,FMN 02 Mercatorstraat
650,Mercatorstraat 36,2023-07-25,19:00:00,310,148,162,FMN 02 Mercatorstraat
650,Mercatorstraat 36,2023-07-25,20:00:00,248,117,131,FMN 02 Mercatorstraat
650,Mercatorstraat 36,2023-07-25,21:00:00,207,102,105,FMN 02 Mercatorstraat
650,Mercatorstraat 36,2023-07-25,22:00:00,190,81,109,FMN 02 Mercatorstraat
650,Mercatorstraat 36,2023-07-25,23:00:00,126,40,86,FMN 02 Mercatorstraat
650,Mercatorstraat 36,2023-07-26,00:00:00,78,25,53,FMN 02 Mercatorstraat
650,Mercatorstraat 36,2023-07-26,01:00:00,41,15,26,FMN 02 Mercatorstraat
650,Mercatorstraat 36,2023-07-26,02:00:00,27,4,23,FMN 02 Mercatorstraat
650,Mercatorstraat 36,2023-07-26,03:00:00,19,5,14,FMN 02 Mercatorstraat
650,Mercatorstraat 36,2023-07-26,04:00:00,33,21,12,FMN 02 Mercatorstraat
650,Mercatorstraat 36,2023-07-26,05:00:00,40,26,14,FMN 02 Mercatorstraat
650,Mercatorstraat 36,2023-07-26,06:00:00,117,74,43,FMN 02 Mercatorstraat
650,Mercatorstraat 36,2023-07-26,07:00:00,262,174,88,FMN 02 Mercatorstraat
650,Mercatorstraat 36,2023-07-26,08:00:00,480,341,139,FMN 02 Mercatorstraat
650,Mercatorstraat 36,2023-07-26,09:00:00,352,253,99,FMN 02 Mercatorstraat
650,Mercatorstraat 36,2023-07-26,10:00:00,261,172,89,FMN 02 Mercatorstraat
650,Mercatorstraat 36,2023-07-26,11:00:00,311,189,122,FMN 02 Mercatorstraat
650,Mercatorstraat 36,2023-07-26,12:00:00,311,167,144,FMN 02 Mercatorstraat
650,Mercatorstraat 36,2023-07-26,13:00:00,339,209,130,FMN 02 Mercatorstraat
650,Mercatorstraat 36,2023-07-26,14:00:00,321,161,160,FMN 02 Mercatorstraat
650,Mercatorstraat 36,2023-07-26,15:00:00,392,207,185,FMN 02 Mercatorstraat
650,Mercatorstraat 36,2023-07-26,16:00:00,539,231,308,FMN 02 Mercatorstraat
650,Mercatorstraat 36,2023-07-26,17:00:00,682,265,417,FMN 02 Mercatorstraat
650,Mercatorstraat 36,2023-07-26,18:00:00,523,222,301,FMN 02 Mercatorstraat
650,Mercatorstraat 36,2023-07-26,19:00:00,423,195,228,FMN 02 Mercatorstraat
650,Mercatorstraat 36,2023-07-26,20:00:00,284,124,160,FMN 02 Mercatorstraat
650,Mercatorstraat 36,2023-07-26,21:00:00,220,95,125,FMN 02 Mercatorstraat
650,Mercatorstraat 36,2023-07-26,22:00:00,200,72,128,FMN 02 Mercatorstraat
650,Mercatorstraat 36,2023-07-26,23:00:00,164,51,113,FMN 02 Mercatorstraat
650,Mercatorstraat 36,2023-07-27,00:00:00,95,32,63,FMN 02 Mercatorstraat
650,Mercatorstraat 36,2023-07-27,01:00:00,50,17,33,FMN 02 Mercatorstraat
650,Mercatorstraat 36,2023-07-27,02:00:00,24,5,19,FMN 02 Mercatorstraat
650,Mercatorstraat 36,2023-07-27,03:00:00,15,6,9,FMN 02 Mercatorstraat
650,Mercatorstraat 36,2023-07-27,04:00:00,27,16,11,FMN 02 Mercatorstraat
650,Mercatorstraat 36,2023-07-27,05:00:00,33,25,8,FMN 02 Mercatorstraat
650,Mercatorstraat 36,2023-07-27,06:00:00,68,43,25,FMN 02 Mercatorstraat
650,Mercatorstraat 36,2023-07-27,07:00:00,148,92,56,FMN 02 Mercatorstraat
650,Mercatorstraat 36,2023-07-27,08:00:00,336,244,92,FMN 02 Mercatorstraat
650,Mercatorstraat 36,2023-07-27,09:00:00,232,171,61,FMN 02 Mercatorstraat
650,Mercatorstraat 36,2023-07-27,10:00:00,129,74,55,FMN 02 Mercatorstraat
650,Mercatorstraat 36,2023-07-27,11:00:00,162,90,72,FMN 02 Mercatorstraat
650,Mercatorstraat 36,2023-07-27,12:00:00,156,82,74,FMN 02 Mercatorstraat
650,Mercatorstraat 36,2023-07-27,13:00:00,184,104,80,FMN 02 Mercatorstraat
650,Mercatorstraat 36,2023-07-27,14:00:00,164,71,93,FMN 02 Mercatorstraat
650,Mercatorstraat 36,2023-07-27,15:00:00,219,100,119,FMN 02 Mercatorstraat
650,Mercatorstraat 36,2023-07-27,16:00:00,321,130,191,FMN 02 Mercatorstraat
650,Mercatorstraat 36,2023-07-27,17:00:00,398,147,251,FMN 02 Mercatorstraat
650,Mercatorstraat 36,2023-07-27,18:00:00,346,155,191,FMN 02 Mercatorstraat
650,Mercatorstraat 36,2023-07-27,19:00:00,204,89,115,FMN 02 Mercatorstraat
650,Mercatorstraat 36,2023-07-27,20:00:00,191,95,96,FMN 02 Mercatorstraat
650,Mercatorstraat 36,2023-07-27,21:00:00,127,51,76,FMN 02 Mercatorstraat
650,Mercatorstraat 36,2023-07-27,22:00:00,126,62,64,FMN 02 Mercatorstraat
650,Mercatorstraat 36,2023-07-27,23:00:00,106,43,63,FMN 02 Mercatorstraat
650,Mercatorstraat 36,2023-07-28,00:00:00,72,44,28,FMN 02 Mercatorstraat
650,Mercatorstraat 36,2023-07-28,01:00:00,50,22,28,FMN 02 Mercatorstraat
650,Mercatorstraat 36,2023-07-28,02:00:00,35,21,14,FMN 02 Mercatorstraat
650,Mercatorstraat 36,2023-07-28,03:00:00,35,7,28,FMN 02 Mercatorstraat
650,Mercatorstraat 36,2023-07-28,04:00:00,32,16,16,FMN 02 Mercatorstraat
650,Mercatorstraat 36,2023-07-28,05:00:00,40,21,19,FMN 02 Mercatorstraat
650,Mercatorstraat 36,2023-07-28,06:00:00,90,61,29,FMN 02 Mercatorstraat
650,Mercatorstraat 36,2023-07-28,07:00:00,214,132,82,FMN 02 Mercatorstraat
650,Mercatorstraat 36,2023-07-28,08:00:00,389,284,105,FMN 02 Mercatorstraat
650,Mercatorstraat 36,2023-07-28,09:00:00,314,209,105,FMN 02 Mercatorstraat
650,Mercatorstraat 36,2023-07-28,10:00:00,233,147,86,FMN 02 Mercatorstraat
650,Mercatorstraat 36,2023-07-28,11:00:00,230,130,100,FMN 02 Mercatorstraat
650,Mercatorstraat 36,2023-07-28,12:00:00,366,205,161,FMN 02 Mercatorstraat
650,Mercatorstraat 36,2023-07-28,13:00:00,316,168,148,FMN 02 Mercatorstraat
650,Mercatorstraat 36,2023-07-28,14:00:00,377,189,188,FMN 02 Mercatorstraat
650,Mercatorstraat 36,2023-07-28,15:00:00,376,192,184,FMN 02 Mercatorstraat
650,Mercatorstraat 36,2023-07-28,16:00:00,460,173,287,FMN 02 Mercatorstraat
650,Mercatorstraat 36,2023-07-28,17:00:00,533,217,316,FMN 02 Mercatorstraat
650,Mercatorstraat 36,2023-07-28,18:00:00,441,196,245,FMN 02 Mercatorstraat
650,Mercatorstraat 36,2023-07-28,19:00:00,341,174,167,FMN 02 Mercatorstraat
650,Mercatorstraat 36,2023-07-28,20:00:00,222,100,122,FMN 02 Mercatorstraat
650,Mercatorstraat 36,2023-07-28,21:00:00,203,87,116,FMN 02 Mercatorstraat
650,Mercatorstraat 36,2023-07-28,22:00:00,164,73,91,FMN 02 Mercatorstraat
650,Mercatorstraat 36,2023-07-28,23:00:00,188,66,122,FMN 02 Mercatorstraat
650,Mercatorstraat 36,2023-07-29,00:00:00,136,46,90,FMN 02 Mercatorstraat
650,Mercatorstraat 36,2023-07-29,01:00:00,99,43,56,FMN 02 Mercatorstraat
650,Mercatorstraat 36,2023-07-29,02:00:00,88,42,46,FMN 02 Mercatorstraat
650,Mercatorstraat 36,2023-07-29,03:00:00,103,52,51,FMN 02 Mercatorstraat
650,Mercatorstraat 36,2023-07-29,04:00:00,74,27,47,FMN 02 Mercatorstraat
650,Mercatorstraat 36,2023-07-29,05:00:00,56,20,36,FMN 02 Mercatorstraat
650,Mercatorstraat 36,2023-07-29,06:00:00,52,19,33,FMN 02 Mercatorstraat
650,Mercatorstraat 36,2023-07-29,07:00:00,65,34,31,FMN 02 Mercatorstraat
650,Mercatorstraat 36,2023-07-29,08:00:00,92,61,31,FMN 02 Mercatorstraat
650,Mercatorstraat 36,2023-07-29,09:00:00,195,146,49,FMN 02 Mercatorstraat
650,Mercatorstraat 36,2023-07-29,10:00:00,204,134,70,FMN 02 Mercatorstraat
650,Mercatorstraat 36,2023-07-29,11:00:00,308,210,98,FMN 02 Mercatorstraat
650,Mercatorstraat 36,2023-07-29,12:00:00,279,174,105,FMN 02 Mercatorstraat
650,Mercatorstraat 36,2023-07-29,13:00:00,174,95,79,FMN 02 Mercatorstraat
650,Mercatorstraat 36,2023-07-29,14:00:00,331,199,132,FMN 02 Mercatorstraat
650,Mercatorstraat 36,2023-07-29,15:00:00,343,170,173,FMN 02 Mercatorstraat
650,Mercatorstraat 36,2023-07-29,16:00:00,276,97,179,FMN 02 Mercatorstraat
650,Mercatorstraat 36,2023-07-29,17:00:00,319,159,160,FMN 02 Mercatorstraat
650,Mercatorstraat 36,2023-07-29,18:00:00,312,126,186,FMN 02 Mercatorstraat
650,Mercatorstraat 36,2023-07-29,19:00:00,231,101,130,FMN 02 Mercatorstraat
650,Mercatorstraat 36,2023-07-29,20:00:00,297,146,151,FMN 02 Mercatorstraat
650,Mercatorstraat 36,2023-07-29,21:00:00,170,76,94,FMN 02 Mercatorstraat
650,Mercatorstraat 36,2023-07-29,22:00:00,170,69,101,FMN 02 Mercatorstraat
650,Mercatorstraat 36,2023-07-29,23:00:00,164,63,101,FMN 02 Mercatorstraat
650,Mercatorstraat 36,2023-07-30,00:00:00,131,58,73,FMN 02 Mercatorstraat
650,Mercatorstraat 36,2023-07-30,01:00:00,114,58,56,FMN 02 Mercatorstraat
650,Mercatorstraat 36,2023-07-30,02:00:00,105,72,33,FMN 02 Mercatorstraat
650,Mercatorstraat 36,2023-07-30,03:00:00,80,34,46,FMN 02 Mercatorstraat
650,Mercatorstraat 36,2023-07-30,04:00:00,52,21,31,FMN 02 Mercatorstraat
650,Mercatorstraat 36,2023-07-30,05:00:00,47,20,27,FMN 02 Mercatorstraat
650,Mercatorstraat 36,2023-07-30,06:00:00,25,11,14,FMN 02 Mercatorstraat
650,Mercatorstraat 36,2023-07-30,07:00:00,41,26,15,FMN 02 Mercatorstraat
650,Mercatorstraat 36,2023-07-30,08:00:00,79,50,29,FMN 02 Mercatorstraat
650,Mercatorstraat 36,2023-07-30,09:00:00,105,79,26,FMN 02 Mercatorstraat
650,Mercatorstraat 36,2023-07-30,10:00:00,208,134,74,FMN 02 Mercatorstraat
650,Mercatorstraat 36,2023-07-30,11:00:00,218,122,96,FMN 02 Mercatorstraat
650,Mercatorstraat 36,2023-07-30,12:00:00,272,139,133,FMN 02 Mercatorstraat
650,Mercatorstraat 36,2023-07-30,13:00:00,267,152,115,FMN 02 Mercatorstraat
650,Mercatorstraat 36,2023-07-30,14:00:00,263,131,132,FMN 02 Mercatorstraat
650,Mercatorstraat 36,2023-07-30,15:00:00,285,155,130,FMN 02 Mercatorstraat
650,Mercatorstraat 36,2023-07-30,16:00:00,289,131,158,FMN 02 Mercatorstraat
650,Mercatorstraat 36,2023-07-30,17:00:00,281,130,151,FMN 02 Mercatorstraat
650,Mercatorstraat 36,2023-07-30,18:00:00,224,102,122,FMN 02 Mercatorstraat
650,Mercatorstraat 36,2023-07-30,19:00:00,147,78,69,FMN 02 Mercatorstraat
650,Mercatorstraat 36,2023-07-30,20:00:00,129,52,77,FMN 02 Mercatorstraat
650,Mercatorstraat 36,2023-07-30,21:00:00,101,53,48,FMN 02 Mercatorstraat
650,Mercatorstraat 36,2023-07-30,22:00:00,73,30,43,FMN 02 Mercatorstraat
650,Mercatorstraat 36,2023-07-30,23:00:00,72,32,40,FMN 02 Mercatorstraat
650,Mercatorstraat 36,2023-07-31,00:00:00,48,21,27,FMN 02 Mercatorstraat
650,Mercatorstraat 36,2023-07-31,01:00:00,22,8,14,FMN 02 Mercatorstraat
650,Mercatorstraat 36,2023-07-31,02:00:00,26,9,17,FMN 02 Mercatorstraat
650,Mercatorstraat 36,2023-07-31,03:00:00,16,9,7,FMN 02 Mercatorstraat
650,Mercatorstraat 36,2023-07-31,04:00:00,27,11,16,FMN 02 Mercatorstraat
650,Mercatorstraat 36,2023-07-31,05:00:00,44,24,20,FMN 02 Mercatorstraat
650,Mercatorstraat 36,2023-07-31,06:00:00,78,53,25,FMN 02 Mercatorstraat
650,Mercatorstraat 36,2023-07-31,07:00:00,161,97,64,FMN 02 Mercatorstraat
650,Mercatorstraat 36,2023-07-31,08:00:00,373,253,120,FMN 02 Mercatorstraat
650,Mercatorstraat 36,2023-07-31,09:00:00,243,162,81,FMN 02 Mercatorstraat
650,Mercatorstraat 36,2023-07-31,10:00:00,168,121,47,FMN 02 Mercatorstraat
650,Mercatorstraat 36,2023-07-31,11:00:00,197,119,78,FMN 02 Mercatorstraat
650,Mercatorstraat 36,2023-07-31,12:00:00,255,146,109,FMN 02 Mercatorstraat
650,Mercatorstraat 36,2023-07-31,13:00:00,237,130,107,FMN 02 Mercatorstraat
650,Mercatorstraat 36,2023-07-31,14:00:00,234,123,111,FMN 02 Mercatorstraat
650,Mercatorstraat 36,2023-07-31,15:00:00,234,95,139,FMN 02 Mercatorstraat
650,Mercatorstraat 36,2023-07-31,16:00:00,279,110,169,FMN 02 Mercatorstraat
650,Mercatorstraat 36,2023-07-31,17:00:00,407,146,261,FMN 02 Mercatorstraat
650,Mercatorstraat 36,2023-07-31,18:00:00,265,91,174,FMN 02 Mercatorstraat
650,Mercatorstraat 36,2023-07-31,19:00:00,141,63,78,FMN 02 Mercatorstraat
650,Mercatorstraat 36,2023-07-31,20:00:00,119,54,65,FMN 02 Mercatorstraat
650,Mercatorstraat 36,2023-07-31,21:00:00,80,33,47,FMN 02 Mercatorstraat
650,Mercatorstraat 36,2023-07-31,22:00:00,75,27,48,FMN 02 Mercatorstraat
650,Mercatorstraat 36,2023-07-31,23:00:00,68,24,44,FMN 02 Mercatorstraat
650,Mercatorstraat 36,2023-08-01,00:00:00,36,11,25,FMN 02 Mercatorstraat
650,Mercatorstraat 36,2023-08-01,01:00:00,15,7,8,FMN 02 Mercatorstraat
650,Mercatorstraat 36,2023-08-01,02:00:00,16,3,13,FMN 02 Mercatorstraat
650,Mercatorstraat 36,2023-08-01,03:00:00,9,2,7,FMN 02 Mercatorstraat
650,Mercatorstraat 36,2023-08-01,04:00:00,27,18,9,FMN 02 Mercatorstraat
650,Mercatorstraat 36,2023-08-01,05:00:00,40,20,20,FMN 02 Mercatorstraat
650,Mercatorstraat 36,2023-08-01,06:00:00,95,58,37,FMN 02 Mercatorstraat
650,Mercatorstraat 36,2023-08-01,07:00:00,252,172,80,FMN 02 Mercatorstraat
650,Mercatorstraat 36,2023-08-01,08:00:00,484,322,162,FMN 02 Mercatorstraat
650,Mercatorstraat 36,2023-08-01,09:00:00,320,230,90,FMN 02 Mercatorstraat
650,Mercatorstraat 36,2023-08-01,10:00:00,229,143,86,FMN 02 Mercatorstraat
650,Mercatorstraat 36,2023-08-01,11:00:00,227,118,109,FMN 02 Mercatorstraat
650,Mercatorstraat 36,2023-08-01,12:00:00,291,176,115,FMN 02 Mercatorstraat
650,Mercatorstraat 36,2023-08-01,13:00:00,280,172,108,FMN 02 Mercatorstraat
650,Mercatorstraat 36,2023-08-01,14:00:00,303,183,120,FMN 02 Mercatorstraat
650,Mercatorstraat 36,2023-08-01,15:00:00,326,151,175,FMN 02 Mercatorstraat
650,Mercatorstraat 36,2023-08-01,16:00:00,528,197,331,FMN 02 Mercatorstraat
650,Mercatorstraat 36,2023-08-01,17:00:00,590,206,384,FMN 02 Mercatorstraat
650,Mercatorstraat 36,2023-08-01,18:00:00,429,190,239,FMN 02 Mercatorstraat
650,Mercatorstraat 36,2023-08-01,19:00:00,302,156,146,FMN 02 Mercatorstraat
650,Mercatorstraat 36,2023-08-01,20:00:00,275,160,115,FMN 02 Mercatorstraat
650,Mercatorstraat 36,2023-08-01,21:00:00,186,78,108,FMN 02 Mercatorstraat
650,Mercatorstraat 36,2023-08-01,22:00:00,199,81,118,FMN 02 Mercatorstraat
650,Mercatorstraat 36,2023-08-01,23:00:00,178,70,108,FMN 02 Mercatorstraat
650,Mercatorstraat 36,2023-08-02,00:00:00,89,24,65,FMN 02 Mercatorstraat
650,Mercatorstraat 36,2023-08-02,01:00:00,43,12,31,FMN 02 Mercatorstraat
650,Mercatorstraat 36,2023-08-02,02:00:00,20,7,13,FMN 02 Mercatorstraat
650,Mercatorstraat 36,2023-08-02,03:00:00,21,6,15,FMN 02 Mercatorstraat
650,Mercatorstraat 36,2023-08-02,04:00:00,22,12,10,FMN 02 Mercatorstraat
650,Mercatorstraat 36,2023-08-02,05:00:00,50,28,22,FMN 02 Mercatorstraat
650,Mercatorstraat 36,2023-08-02,06:00:00,72,51,21,FMN 02 Mercatorstraat
650,Mercatorstraat 36,2023-08-02,07:00:00,159,104,55,FMN 02 Mercatorstraat
650,Mercatorstraat 36,2023-08-02,08:00:00,302,201,101,FMN 02 Mercatorstraat
650,Mercatorstraat 36,2023-08-02,09:00:00,211,145,66,FMN 02 Mercatorstraat
650,Mercatorstraat 36,2023-08-02,10:00:00,179,103,76,FMN 02 Mercatorstraat
650,Mercatorstraat 36,2023-08-02,11:00:00,192,97,95,FMN 02 Mercatorstraat
650,Mercatorstraat 36,2023-08-02,12:00:00,195,98,97,FMN 02 Mercatorstraat
650,Mercatorstraat 36,2023-08-02,13:00:00,208,119,89,FMN 02 Mercatorstraat
650,Mercatorstraat 36,2023-08-02,14:00:00,245,139,106,FMN 02 Mercatorstraat
650,Mercatorstraat 36,2023-08-02,15:00:00,245,118,127,FMN 02 Mercatorstraat
650,Mercatorstraat 36,2023-08-02,16:00:00,374,146,228,FMN 02 Mercatorstraat
650,Mercatorstraat 36,2023-08-02,17:00:00,484,214,270,FMN 02 Mercatorstraat
650,Mercatorstraat 36,2023-08-02,18:00:00,372,162,210,FMN 02 Mercatorstraat
650,Mercatorstraat 36,2023-08-02,19:00:00,223,112,111,FMN 02 Mercatorstraat
650,Mercatorstraat 36,2023-08-02,20:00:00,177,84,93,FMN 02 Mercatorstraat
650,Mercatorstraat 36,2023-08-02,21:00:00,139,59,80,FMN 02 Mercatorstraat
650,Mercatorstraat 36,2023-08-02,22:00:00,124,46,78,FMN 02 Mercatorstraat
650,Mercatorstraat 36,2023-08-02,23:00:00,86,25,61,FMN 02 Mercatorstraat
650,Mercatorstraat 36,2023-08-03,00:00:00,51,18,33,FMN 02 Mercatorstraat
650,Mercatorstraat 36,2023-08-03,01:00:00,28,10,18,FMN 02 Mercatorstraat
650,Mercatorstraat 36,2023-08-03,02:00:00,17,4,13,FMN 02 Mercatorstraat
650,Mercatorstraat 36,2023-08-03,03:00:00,16,9,7,FMN 02 Mercatorstraat
650,Mercatorstraat 36,2023-08-03,04:00:00,19,14,5,FMN 02 Mercatorstraat
650,Mercatorstraat 36,2023-08-03,05:00:00,34,23,11,FMN 02 Mercatorstraat
650,Mercatorstraat 36,2023-08-03,06:00:00,72,41,31,FMN 02 Mercatorstraat
650,Mercatorstraat 36,2023-08-03,07:00:00,217,135,82,FMN 02 Mercatorstraat
650,Mercatorstraat 36,2023-08-03,08:00:00,437,299,138,FMN 02 Mercatorstraat
650,Mercatorstraat 36,2023-08-03,09:00:00,263,185,78,FMN 02 Mercatorstraat
650,Mercatorstraat 36,2023-08-03,10:00:00,155,93,62,FMN 02 Mercatorstraat
650,Mercatorstraat 36,2023-08-03,11:00:00,153,89,64,FMN 02 Mercatorstraat
650,Mercatorstraat 36,2023-08-03,12:00:00,185,93,92,FMN 02 Mercatorstraat
650,Mercatorstraat 36,2023-08-03,13:00:00,150,82,68,FMN 02 Mercatorstraat
650,Mercatorstraat 36,2023-08-03,14:00:00,189,108,81,FMN 02 Mercatorstraat
650,Mercatorstraat 36,2023-08-03,15:00:00,224,99,125,FMN 02 Mercatorstraat
650,Mercatorstraat 36,2023-08-03,16:00:00,377,164,213,FMN 02 Mercatorstraat
650,Mercatorstraat 36,2023-08-03,17:00:00,460,189,271,FMN 02 Mercatorstraat
650,Mercatorstraat 36,2023-08-03,18:00:00,403,186,217,FMN 02 Mercatorstraat
650,Mercatorstraat 36,2023-08-03,19:00:00,307,147,160,FMN 02 Mercatorstraat
650,Mercatorstraat 36,2023-08-03,20:00:00,216,113,103,FMN 02 Mercatorstraat
650,Mercatorstraat 36,2023-08-03,21:00:00,173,68,105,FMN 02 Mercatorstraat
650,Mercatorstraat 36,2023-08-03,22:00:00,177,76,101,FMN 02 Mercatorstraat
650,Mercatorstraat 36,2023-08-03,23:00:00,169,66,103,FMN 02 Mercatorstraat
650,Mercatorstraat 36,2023-08-04,00:00:00,111,41,70,FMN 02 Mercatorstraat
650,Mercatorstraat 36,2023-08-04,01:00:00,64,32,32,FMN 02 Mercatorstraat
650,Mercatorstraat 36,2023-08-04,02:00:00,25,9,16,FMN 02 Mercatorstraat
650,Mercatorstraat 36,2023-08-04,03:00:00,24,4,20,FMN 02 Mercatorstraat
650,Mercatorstraat 36,2023-08-04,04:00:00,35,12,23,FMN 02 Mercatorstraat
650,Mercatorstraat 36,2023-08-04,05:00:00,59,27,32,FMN 02 Mercatorstraat
650,Mercatorstraat 36,2023-08-04,06:00:00,94,57,37,FMN 02 Mercatorstraat
650,Mercatorstraat 36,2023-08-04,07:00:00,182,116,66,FMN 02 Mercatorstraat
650,Mercatorstraat 36,2023-08-04,08:00:00,331,233,98,FMN 02 Mercatorstraat
650,Mercatorstraat 36,2023-08-04,09:00:00,301,210,91,FMN 02 Mercatorstraat
650,Mercatorstraat 36,2023-08-04,10:00:00,203,123,80,FMN 02 Mercatorstraat
650,Mercatorstraat 36,2023-08-04,11:00:00,215,124,91,FMN 02 Mercatorstraat
650,Mercatorstraat 36,2023-08-04,12:00:00,234,120,114,FMN 02 Mercatorstraat
650,Mercatorstraat 36,2023-08-04,13:00:00,269,140,129,FMN 02 Mercatorstraat
650,Mercatorstraat 36,2023-08-04,14:00:00,322,178,144,FMN 02 Mercatorstraat
650,Mercatorstraat 36,2023-08-04,15:00:00,346,160,186,FMN 02 Mercatorstraat
650,Mercatorstraat 36,2023-08-04,16:00:00,425,185,240,FMN 02 Mercatorstraat
650,Mercatorstraat 36,2023-08-04,17:00:00,450,177,273,FMN 02 Mercatorstraat
650,Mercatorstraat 36,2023-08-04,18:00:00,432,207,225,FMN 02 Mercatorstraat
650,Mercatorstraat 36,2023-08-04,19:00:00,325,180,145,FMN 02 Mercatorstraat
650,Mercatorstraat 36,2023-08-04,20:00:00,244,131,113,FMN 02 Mercatorstraat
650,Mercatorstraat 36,2023-08-04,21:00:00,204,91,113,FMN 02 Mercatorstraat
650,Mercatorstraat 36,2023-08-04,22:00:00,191,89,102,FMN 02 Mercatorstraat
650,Mercatorstraat 36,2023-08-04,23:00:00,190,87,103,FMN 02 Mercatorstraat
650,Mercatorstraat 36,2023-08-05,00:00:00,152,63,89,FMN 02 Mercatorstraat
650,Mercatorstraat 36,2023-08-05,01:00:00,103,42,61,FMN 02 Mercatorstraat
650,Mercatorstraat 36,2023-08-05,02:00:00,88,35,53,FMN 02 Mercatorstraat
650,Mercatorstraat 36,2023-08-05,03:00:00,70,31,39,FMN 02 Mercatorstraat
650,Mercatorstraat 36,2023-08-05,04:00:00,57,13,44,FMN 02 Mercatorstraat
650,Mercatorstraat 36,2023-08-05,05:00:00,52,23,29,FMN 02 Mercatorstraat
650,Mercatorstraat 36,2023-08-05,06:00:00,43,18,25,FMN 02 Mercatorstraat
650,Mercatorstraat 36,2023-08-05,07:00:00,47,29,18,FMN 02 Mercatorstraat
650,Mercatorstraat 36,2023-08-05,08:00:00,74,49,25,FMN 02 Mercatorstraat
650,Mercatorstraat 36,2023-08-05,09:00:00,175,126,49,FMN 02 Mercatorstraat
650,Mercatorstraat 36,2023-08-05,10:00:00,244,162,82,FMN 02 Mercatorstraat
650,Mercatorstraat 36,2023-08-05,11:00:00,278,185,93,FMN 02 Mercatorstraat
650,Mercatorstraat 36,2023-08-05,12:00:00,258,149,109,FMN 02 Mercatorstraat
650,Mercatorstraat 36,2023-08-05,13:00:00,237,107,130,FMN 02 Mercatorstraat
650,Mercatorstraat 36,2023-08-05,14:00:00,201,96,105,FMN 02 Mercatorstraat
650,Mercatorstraat 36,2023-08-05,15:00:00,207,99,108,FMN 02 Mercatorstraat
650,Mercatorstraat 36,2023-08-05,16:00:00,224,107,117,FMN 02 Mercatorstraat
650,Mercatorstraat 36,2023-08-05,17:00:00,209,110,99,FMN 02 Mercatorstraat
650,Mercatorstraat 36,2023-08-05,18:00:00,258,136,122,FMN 02 Mercatorstraat
650,Mercatorstraat 36,2023-08-05,19:00:00,261,158,103,FMN 02 Mercatorstraat
650,Mercatorstraat 36,2023-08-05,20:00:00,146,79,67,FMN 02 Mercatorstraat
650,Mercatorstraat 36,2023-08-05,21:00:00,130,68,62,FMN 02 Mercatorstraat
650,Mercatorstraat 36,2023-08-05,22:00:00,93,43,50,FMN 02 Mercatorstraat
650,Mercatorstraat 36,2023-08-05,23:00:00,121,41,80,FMN 02 Mercatorstraat
650,Mercatorstraat 36,2023-08-06,00:00:00,117,27,90,FMN 02 Mercatorstraat
650,Mercatorstraat 36,2023-08-06,01:00:00,145,35,110,FMN 02 Mercatorstraat
650,Mercatorstraat 36,2023-08-06,02:00:00,68,25,43,FMN 02 Mercatorstraat
650,Mercatorstraat 36,2023-08-06,03:00:00,44,15,29,FMN 02 Mercatorstraat
650,Mercatorstraat 36,2023-08-06,04:00:00,30,13,17,FMN 02 Mercatorstraat
650,Mercatorstraat 36,2023-08-06,05:00:00,20,8,12,FMN 02 Mercatorstraat
650,Mercatorstraat 36,2023-08-06,06:00:00,24,15,9,FMN 02 Mercatorstraat
650,Mercatorstraat 36,2023-08-06,07:00:00,15,7,8,FMN 02 Mercatorstraat
650,Mercatorstraat 36,2023-08-06,08:00:00,30,16,14,FMN 02 Mercatorstraat
650,Mercatorstraat 36,2023-08-06,09:00:00,62,38,24,FMN 02 Mercatorstraat
650,Mercatorstraat 36,2023-08-06,10:00:00,95,66,29,FMN 02 Mercatorstraat
650,Mercatorstraat 36,2023-08-06,11:00:00,152,77,75,FMN 02 Mercatorstraat
650,Mercatorstraat 36,2023-08-06,12:00:00,97,45,52,FMN 02 Mercatorstraat
650,Mercatorstraat 36,2023-08-06,13:00:00,151,91,60,FMN 02 Mercatorstraat
650,Mercatorstraat 36,2023-08-06,14:00:00,117,66,51,FMN 02 Mercatorstraat
650,Mercatorstraat 36,2023-08-06,15:00:00,100,46,54,FMN 02 Mercatorstraat
650,Mercatorstraat 36,2023-08-06,16:00:00,86,40,46,FMN 02 Mercatorstraat
650,Mercatorstraat 36,2023-08-06,17:00:00,134,56,78,FMN 02 Mercatorstraat
650,Mercatorstraat 36,2023-08-06,18:00:00,194,82,112,FMN 02 Mercatorstraat
650,Mercatorstraat 36,2023-08-06,19:00:00,152,89,63,FMN 02 Mercatorstraat
650,Mercatorstraat 36,2023-08-06,20:00:00,148,72,76,FMN 02 Mercatorstraat
650,Mercatorstraat 36,2023-08-06,21:00:00,126,57,69,FMN 02 Mercatorstraat
650,Mercatorstraat 36,2023-08-06,22:00:00,94,49,45,FMN 02 Mercatorstraat
650,Mercatorstraat 36,2023-08-06,23:00:00,85,30,55,FMN 02 Mercatorstraat
650,Mercatorstraat 36,2023-08-07,00:00:00,28,9,19,FMN 02 Mercatorstraat
650,Mercatorstraat 36,2023-08-07,01:00:00,23,7,16,FMN 02 Mercatorstraat
650,Mercatorstraat 36,2023-08-07,02:00:00,21,10,11,FMN 02 Mercatorstraat
650,Mercatorstraat 36,2023-08-07,03:00:00,14,9,5,FMN 02 Mercatorstraat
650,Mercatorstraat 36,2023-08-07,04:00:00,30,18,12,FMN 02 Mercatorstraat
650,Mercatorstraat 36,2023-08-07,05:00:00,47,29,18,FMN 02 Mercatorstraat
650,Mercatorstraat 36,2023-08-07,06:00:00,92,60,32,FMN 02 Mercatorstraat
650,Mercatorstraat 36,2023-08-07,07:00:00,246,157,89,FMN 02 Mercatorstraat
650,Mercatorstraat 36,2023-08-07,08:00:00,511,352,159,FMN 02 Mercatorstraat
650,Mercatorstraat 36,2023-08-07,09:00:00,342,241,101,FMN 02 Mercatorstraat
650,Mercatorstraat 36,2023-08-07,10:00:00,195,140,55,FMN 02 Mercatorstraat
650,Mercatorstraat 36,2023-08-07,11:00:00,224,139,85,FMN 02 Mercatorstraat
650,Mercatorstraat 36,2023-08-07,12:00:00,257,145,112,FMN 02 Mercatorstraat
650,Mercatorstraat 36,2023-08-07,13:00:00,230,122,108,FMN 02 Mercatorstraat
650,Mercatorstraat 36,2023-08-07,14:00:00,344,209,135,FMN 02 Mercatorstraat
650,Mercatorstraat 36,2023-08-07,15:00:00,305,155,150,FMN 02 Mercatorstraat
650,Mercatorstraat 36,2023-08-07,16:00:00,437,163,274,FMN 02 Mercatorstraat
650,Mercatorstraat 36,2023-08-07,17:00:00,640,228,412,FMN 02 Mercatorstraat
650,Mercatorstraat 36,2023-08-07,18:00:00,456,196,260,FMN 02 Mercatorstraat
650,Mercatorstraat 36,2023-08-07,19:00:00,270,131,139,FMN 02 Mercatorstraat
650,Mercatorstraat 36,2023-08-07,20:00:00,221,104,117,FMN 02 Mercatorstraat
650,Mercatorstraat 36,2023-08-07,21:00:00,188,92,96,FMN 02 Mercatorstraat
650,Mercatorstraat 36,2023-08-07,22:00:00,158,67,91,FMN 02 Mercatorstraat
650,Mercatorstraat 36,2023-08-07,23:00:00,120,34,86,FMN 02 Mercatorstraat
650,Mercatorstraat 36,2023-08-08,00:00:00,63,12,51,FMN 02 Mercatorstraat
650,Mercatorstraat 36,2023-08-08,01:00:00,24,7,17,FMN 02 Mercatorstraat
650,Mercatorstraat 36,2023-08-08,02:00:00,25,5,20,FMN 02 Mercatorstraat
650,Mercatorstraat 36,2023-08-08,03:00:00,16,9,7,FMN 02 Mercatorstraat
650,Mercatorstraat 36,2023-08-08,04:00:00,40,22,18,FMN 02 Mercatorstraat
650,Mercatorstraat 36,2023-08-08,05:00:00,49,30,19,FMN 02 Mercatorstraat
650,Mercatorstraat 36,2023-08-08,06:00:00,105,71,34,FMN 02 Mercatorstraat
650,Mercatorstraat 36,2023-08-08,07:00:00,258,167,91,FMN 02 Mercatorstraat
650,Mercatorstraat 36,2023-08-08,08:00:00,545,389,156,FMN 02 Mercatorstraat
650,Mercatorstraat 36,2023-08-08,09:00:00,337,246,91,FMN 02 Mercatorstraat
650,Mercatorstraat 36,2023-08-08,10:00:00,224,153,71,FMN 02 Mercatorstraat
650,Mercatorstraat 36,2023-08-08,11:00:00,209,132,77,FMN 02 Mercatorstraat
650,Mercatorstraat 36,2023-08-08,12:00:00,266,130,136,FMN 02 Mercatorstraat
650,Mercatorstraat 36,2023-08-08,13:00:00,277,156,121,FMN 02 Mercatorstraat
650,Mercatorstraat 36,2023-08-08,14:00:00,277,145,132,FMN 02 Mercatorstraat
650,Mercatorstraat 36,2023-08-08,15:00:00,290,134,156,FMN 02 Mercatorstraat
650,Mercatorstraat 36,2023-08-08,16:00:00,483,195,288,FMN 02 Mercatorstraat
650,Mercatorstraat 36,2023-08-08,17:00:00,705,256,449,FMN 02 Mercatorstraat
650,Mercatorstraat 36,2023-08-08,18:00:00,409,182,227,FMN 02 Mercatorstraat
650,Mercatorstraat 36,2023-08-08,19:00:00,214,101,113,FMN 02 Mercatorstraat
650,Mercatorstraat 36,2023-08-08,20:00:00,142,59,83,FMN 02 Mercatorstraat
650,Mercatorstraat 36,2023-08-08,21:00:00,129,47,82,FMN 02 Mercatorstraat
650,Mercatorstraat 36,2023-08-08,22:00:00,146,66,80,FMN 02 Mercatorstraat
650,Mercatorstraat 36,2023-08-08,23:00:00,91,29,62,FMN 02 Mercatorstraat
650,Mercatorstraat 36,2023-08-09,00:00:00,61,16,45,FMN 02 Mercatorstraat
650,Mercatorstraat 36,2023-08-09,01:00:00,44,16,28,FMN 02 Mercatorstraat
650,Mercatorstraat 36,2023-08-09,02:00:00,12,7,5,FMN 02 Mercatorstraat
650,Mercatorstraat 36,2023-08-09,03:00:00,17,9,8,FMN 02 Mercatorstraat
650,Mercatorstraat 36,2023-08-09,04:00:00,34,23,11,FMN 02 Mercatorstraat
650,Mercatorstraat 36,2023-08-09,05:00:00,46,25,21,FMN 02 Mercatorstraat
650,Mercatorstraat 36,2023-08-09,06:00:00,100,62,38,FMN 02 Mercatorstraat
650,Mercatorstraat 36,2023-08-09,07:00:00,256,172,84,FMN 02 Mercatorstraat
650,Mercatorstraat 36,2023-08-09,08:00:00,467,316,151,FMN 02 Mercatorstraat
650,Mercatorstraat 36,2023-08-09,09:00:00,301,227,74,FMN 02 Mercatorstraat
650,Mercatorstraat 36,2023-08-09,10:00:00,209,146,63,FMN 02 Mercatorstraat
650,Mercatorstraat 36,2023-08-09,11:00:00,241,134,107,FMN 02 Mercatorstraat
650,Mercatorstraat 36,2023-08-09,12:00:00,295,156,139,FMN 02 Mercatorstraat
650,Mercatorstraat 36,2023-08-09,13:00:00,327,182,145,FMN 02 Mercatorstraat
650,Mercatorstraat 36,2023-08-09,14:00:00,381,204,177,FMN 02 Mercatorstraat
650,Mercatorstraat 36,2023-08-09,15:00:00,361,175,186,FMN 02 Mercatorstraat
650,Mercatorstraat 36,2023-08-09,16:00:00,496,210,286,FMN 02 Mercatorstraat
650,Mercatorstraat 36,2023-08-09,17:00:00,625,249,376,FMN 02 Mercatorstraat
650,Mercatorstraat 36,2023-08-09,18:00:00,517,217,300,FMN 02 Mercatorstraat
650,Mercatorstraat 36,2023-08-09,19:00:00,303,149,154,FMN 02 Mercatorstraat
650,Mercatorstraat 36,2023-08-09,20:00:00,255,111,144,FMN 02 Mercatorstraat
650,Mercatorstraat 36,2023-08-09,21:00:00,206,97,109,FMN 02 Mercatorstraat
650,Mercatorstraat 36,2023-08-09,22:00:00,220,93,127,FMN 02 Mercatorstraat
650,Mercatorstraat 36,2023-08-09,23:00:00,149,54,95,FMN 02 Mercatorstraat
650,Mercatorstraat 36,2023-08-10,00:00:00,79,23,56,FMN 02 Mercatorstraat
650,Mercatorstraat 36,2023-08-10,01:00:00,45,19,26,FMN 02 Mercatorstraat
650,Mercatorstraat 36,2023-08-10,02:00:00,28,13,15,FMN 02 Mercatorstraat
650,Mercatorstraat 36,2023-08-10,03:00:00,23,11,12,FMN 02 Mercatorstraat
650,Mercatorstraat 36,2023-08-10,04:00:00,35,17,18,FMN 02 Mercatorstraat
650,Mercatorstraat 36,2023-08-10,05:00:00,64,40,24,FMN 02 Mercatorstraat
650,Mercatorstraat 36,2023-08-10,06:00:00,96,60,36,FMN 02 Mercatorstraat
650,Mercatorstraat 36,2023-08-10,07:00:00,282,188,94,FMN 02 Mercatorstraat
650,Mercatorstraat 36,2023-08-10,08:00:00,565,389,176,FMN 02 Mercatorstraat
650,Mercatorstraat 36,2023-08-10,09:00:00,348,260,88,FMN 02 Mercatorstraat
650,Mercatorstraat 36,2023-08-10,10:00:00,269,193,76,FMN 02 Mercatorstraat
650,Mercatorstraat 36,2023-08-10,11:00:00,283,159,124,FMN 02 Mercatorstraat
650,Mercatorstraat 36,2023-08-10,12:00:00,359,211,148,FMN 02 Mercatorstraat
650,Mercatorstraat 36,2023-08-10,13:00:00,350,192,158,FMN 02 Mercatorstraat
650,Mercatorstraat 36,2023-08-10,14:00:00,315,200,115,FMN 02 Mercatorstraat
650,Mercatorstraat 36,2023-08-10,15:00:00,434,189,245,FMN 02 Mercatorstraat
650,Mercatorstraat 36,2023-08-10,16:00:00,529,199,330,FMN 02 Mercatorstraat
650,Mercatorstraat 36,2023-08-10,17:00:00,704,279,425,FMN 02 Mercatorstraat
650,Mercatorstraat 36,2023-08-10,18:00:00,601,258,343,FMN 02 Mercatorstraat
650,Mercatorstraat 36,2023-08-10,19:00:00,422,192,230,FMN 02 Mercatorstraat
650,Mercatorstraat 36,2023-08-10,20:00:00,314,151,163,FMN 02 Mercatorstraat
650,Mercatorstraat 36,2023-08-10,21:00:00,296,148,148,FMN 02 Mercatorstraat
650,Mercatorstraat 36,2023-08-10,22:00:00,254,111,143,FMN 02 Mercatorstraat
650,Mercatorstraat 36,2023-08-10,23:00:00,287,129,158,FMN 02 Mercatorstraat
650,Mercatorstraat 36,2023-08-11,00:00:00,184,96,88,FMN 02 Mercatorstraat
650,Mercatorstraat 36,2023-08-11,01:00:00,107,64,43,FMN 02 Mercatorstraat
650,Mercatorstraat 36,2023-08-11,02:00:00,70,39,31,FMN 02 Mercatorstraat
650,Mercatorstraat 36,2023-08-11,03:00:00,55,27,28,FMN 02 Mercatorstraat
650,Mercatorstraat 36,2023-08-11,04:00:00,56,32,24,FMN 02 Mercatorstraat
650,Mercatorstraat 36,2023-08-11,05:00:00,50,23,27,FMN 02 Mercatorstraat
650,Mercatorstraat 36,2023-08-11,06:00:00,105,65,40,FMN 02 Mercatorstraat
650,Mercatorstraat 36,2023-08-11,07:00:00,220,144,76,FMN 02 Mercatorstraat
650,Mercatorstraat 36,2023-08-11,08:00:00,405,299,106,FMN 02 Mercatorstraat
650,Mercatorstraat 36,2023-08-11,09:00:00,299,214,85,FMN 02 Mercatorstraat
650,Mercatorstraat 36,2023-08-11,10:00:00,256,158,98,FMN 02 Mercatorstraat
650,Mercatorstraat 36,2023-08-11,11:00:00,277,174,103,FMN 02 Mercatorstraat
650,Mercatorstraat 36,2023-08-11,12:00:00,355,196,159,FMN 02 Mercatorstraat
650,Mercatorstraat 36,2023-08-11,13:00:00,369,213,156,FMN 02 Mercatorstraat
650,Mercatorstraat 36,2023-08-11,14:00:00,367,199,168,FMN 02 Mercatorstraat
650,Mercatorstraat 36,2023-08-11,15:00:00,425,180,245,FMN 02 Mercatorstraat
650,Mercatorstraat 36,2023-08-11,16:00:00,483,207,276,FMN 02 Mercatorstraat
650,Mercatorstraat 36,2023-08-11,17:00:00,540,198,342,FMN 02 Mercatorstraat
650,Mercatorstraat 36,2023-08-11,18:00:00,441,198,243,FMN 02 Mercatorstraat
650,Mercatorstraat 36,2023-08-11,19:00:00,323,165,158,FMN 02 Mercatorstraat
650,Mercatorstraat 36,2023-08-11,20:00:00,234,108,126,FMN 02 Mercatorstraat
650,Mercatorstraat 36,2023-08-11,21:00:00,240,101,139,FMN 02 Mercatorstraat
650,Mercatorstraat 36,2023-08-11,22:00:00,167,74,93,FMN 02 Mercatorstraat
650,Mercatorstraat 36,2023-08-11,23:00:00,190,75,115,FMN 02 Mercatorstraat
650,Mercatorstraat 36,2023-08-12,00:00:00,164,56,108,FMN 02 Mercatorstraat
650,Mercatorstraat 36,2023-08-12,01:00:00,83,34,49,FMN 02 Mercatorstraat
650,Mercatorstraat 36,2023-08-12,02:00:00,82,18,64,FMN 02 Mercatorstraat
650,Mercatorstraat 36,2023-08-12,03:00:00,47,22,25,FMN 02 Mercatorstraat
650,Mercatorstraat 36,2023-08-12,04:00:00,47,19,28,FMN 02 Mercatorstraat
650,Mercatorstraat 36,2023-08-12,05:00:00,32,16,16,FMN 02 Mercatorstraat
650,Mercatorstraat 36,2023-08-12,06:00:00,35,18,17,FMN 02 Mercatorstraat
650,Mercatorstraat 36,2023-08-12,07:00:00,43,24,19,FMN 02 Mercatorstraat
650,Mercatorstraat 36,2023-08-12,08:00:00,67,45,22,FMN 02 Mercatorstraat
650,Mercatorstraat 36,2023-08-12,09:00:00,115,88,27,FMN 02 Mercatorstraat
650,Mercatorstraat 36,2023-08-12,10:00:00,195,128,67,FMN 02 Mercatorstraat
650,Mercatorstraat 36,2023-08-12,11:00:00,215,124,91,FMN 02 Mercatorstraat
650,Mercatorstraat 36,2023-08-12,12:00:00,302,190,112,FMN 02 Mercatorstraat
650,Mercatorstraat 36,2023-08-12,13:00:00,410,311,99,FMN 02 Mercatorstraat
650,Mercatorstraat 36,2023-08-12,14:00:00,422,295,127,FMN 02 Mercatorstraat
650,Mercatorstraat 36,2023-08-12,15:00:00,335,199,136,FMN 02 Mercatorstraat
650,Mercatorstraat 36,2023-08-12,16:00:00,341,155,186,FMN 02 Mercatorstraat
650,Mercatorstraat 36,2023-08-12,17:00:00,413,161,252,FMN 02 Mercatorstraat
650,Mercatorstraat 36,2023-08-12,18:00:00,339,138,201,FMN 02 Mercatorstraat
650,Mercatorstraat 36,2023-08-12,19:00:00,286,130,156,FMN 02 Mercatorstraat
650,Mercatorstraat 36,2023-08-12,20:00:00,267,124,143,FMN 02 Mercatorstraat
650,Mercatorstraat 36,2023-08-12,21:00:00,236,118,118,FMN 02 Mercatorstraat
650,Mercatorstraat 36,2023-08-12,22:00:00,201,96,105,FMN 02 Mercatorstraat
650,Mercatorstraat 36,2023-08-12,23:00:00,208,77,131,FMN 02 Mercatorstraat
650,Mercatorstraat 36,2023-08-13,00:00:00,187,64,123,FMN 02 Mercatorstraat
650,Mercatorstraat 36,2023-08-13,01:00:00,159,63,96,FMN 02 Mercatorstraat
650,Mercatorstraat 36,2023-08-13,02:00:00,110,40,70,FMN 02 Mercatorstraat
650,Mercatorstraat 36,2023-08-13,03:00:00,98,29,69,FMN 02 Mercatorstraat
650,Mercatorstraat 36,2023-08-13,04:00:00,65,12,53,FMN 02 Mercatorstraat
650,Mercatorstraat 36,2023-08-13,05:00:00,60,15,45,FMN 02 Mercatorstraat
650,Mercatorstraat 36,2023-08-13,06:00:00,47,15,32,FMN 02 Mercatorstraat
650,Mercatorstraat 36,2023-08-13,07:00:00,49,16,33,FMN 02 Mercatorstraat
650,Mercatorstraat 36,2023-08-13,08:00:00,54,34,20,FMN 02 Mercatorstraat
650,Mercatorstraat 36,2023-08-13,09:00:00,109,74,35,FMN 02 Mercatorstraat
650,Mercatorstraat 36,2023-08-13,10:00:00,210,152,58,FMN 02 Mercatorstraat
650,Mercatorstraat 36,2023-08-13,11:00:00,234,149,85,FMN 02 Mercatorstraat
650,Mercatorstraat 36,2023-08-13,12:00:00,268,160,108,FMN 02 Mercatorstraat
650,Mercatorstraat 36,2023-08-13,13:00:00,314,178,136,FMN 02 Mercatorstraat
650,Mercatorstraat 36,2023-08-13,14:00:00,336,212,124,FMN 02 Mercatorstraat
650,Mercatorstraat 36,2023-08-13,15:00:00,383,215,168,FMN 02 Mercatorstraat
650,Mercatorstraat 36,2023-08-13,16:00:00,331,160,171,FMN 02 Mercatorstraat
650,Mercatorstraat 36,2023-08-13,17:00:00,292,119,173,FMN 02 Mercatorstraat
650,Mercatorstraat 36,2023-08-13,18:00:00,325,162,163,FMN 02 Mercatorstraat
650,Mercatorstraat 36,2023-08-13,19:00:00,220,127,93,FMN 02 Mercatorstraat
650,Mercatorstraat 36,2023-08-13,20:00:00,213,98,115,FMN 02 Mercatorstraat
650,Mercatorstraat 36,2023-08-13,21:00:00,191,82,109,FMN 02 Mercatorstraat
650,Mercatorstraat 36,2023-08-13,22:00:00,152,49,103,FMN 02 Mercatorstraat
650,Mercatorstraat 36,2023-08-13,23:00:00,153,50,103,FMN 02 Mercatorstraat
650,Mercatorstraat 36,2023-08-14,00:00:00,78,23,55,FMN 02 Mercatorstraat
650,Mercatorstraat 36,2023-08-14,01:00:00,62,18,44,FMN 02 Mercatorstraat
650,Mercatorstraat 36,2023-08-14,02:00:00,49,18,31,FMN 02 Mercatorstraat
650,Mercatorstraat 36,2023-08-14,03:00:00,39,18,21,FMN 02 Mercatorstraat
650,Mercatorstraat 36,2023-08-14,04:00:00,41,22,19,FMN 02 Mercatorstraat
650,Mercatorstraat 36,2023-08-14,05:00:00,51,19,32,FMN 02 Mercatorstraat
650,Mercatorstraat 36,2023-08-14,06:00:00,70,42,28,FMN 02 Mercatorstraat
650,Mercatorstraat 36,2023-08-14,07:00:00,157,93,64,FMN 02 Mercatorstraat
650,Mercatorstraat 36,2023-08-14,08:00:00,269,193,76,FMN 02 Mercatorstraat
650,Mercatorstraat 36,2023-08-14,09:00:00,218,160,58,FMN 02 Mercatorstraat
650,Mercatorstraat 36,2023-08-14,10:00:00,233,147,86,FMN 02 Mercatorstraat
650,Mercatorstraat 36,2023-08-14,11:00:00,269,173,96,FMN 02 Mercatorstraat
650,Mercatorstraat 36,2023-08-14,12:00:00,335,199,136,FMN 02 Mercatorstraat
650,Mercatorstraat 36,2023-08-14,13:00:00,313,183,130,FMN 02 Mercatorstraat
650,Mercatorstraat 36,2023-08-14,14:00:00,382,199,183,FMN 02 Mercatorstraat
650,Mercatorstraat 36,2023-08-14,15:00:00,352,173,179,FMN 02 Mercatorstraat
650,Mercatorstraat 36,2023-08-14,16:00:00,435,223,212,FMN 02 Mercatorstraat
650,Mercatorstraat 36,2023-08-14,17:00:00,432,184,248,FMN 02 Mercatorstraat
650,Mercatorstraat 36,2023-08-14,18:00:00,404,171,233,FMN 02 Mercatorstraat
650,Mercatorstraat 36,2023-08-14,19:00:00,358,175,183,FMN 02 Mercatorstraat
650,Mercatorstraat 36,2023-08-14,20:00:00,263,127,136,FMN 02 Mercatorstraat
650,Mercatorstraat 36,2023-08-14,21:00:00,264,121,143,FMN 02 Mercatorstraat
650,Mercatorstraat 36,2023-08-14,22:00:00,190,90,100,FMN 02 Mercatorstraat
650,Mercatorstraat 36,2023-08-14,23:00:00,164,62,102,FMN 02 Mercatorstraat
650,Mercatorstraat 36,2023-08-15,00:00:00,120,46,74,FMN 02 Mercatorstraat
650,Mercatorstraat 36,2023-08-15,01:00:00,82,38,44,FMN 02 Mercatorstraat
650,Mercatorstraat 36,2023-08-15,02:00:00,44,15,29,FMN 02 Mercatorstraat
650,Mercatorstraat 36,2023-08-15,03:00:00,43,10,33,FMN 02 Mercatorstraat
650,Mercatorstraat 36,2023-08-15,04:00:00,24,12,12,FMN 02 Mercatorstraat
650,Mercatorstraat 36,2023-08-15,05:00:00,30,15,15,FMN 02 Mercatorstraat
650,Mercatorstraat 36,2023-08-15,06:00:00,45,20,25,FMN 02 Mercatorstraat
650,Mercatorstraat 36,2023-08-15,07:00:00,44,20,24,FMN 02 Mercatorstraat
650,Mercatorstraat 36,2023-08-15,08:00:00,105,66,39,FMN 02 Mercatorstraat
650,Mercatorstraat 36,2023-08-15,09:00:00,248,184,64,FMN 02 Mercatorstraat
650,Mercatorstraat 36,2023-08-15,10:00:00,277,191,86,FMN 02 Mercatorstraat
650,Mercatorstraat 36,2023-08-15,11:00:00,353,237,116,FMN 02 Mercatorstraat
650,Mercatorstraat 36,2023-08-15,12:00:00,347,227,120,FMN 02 Mercatorstraat
650,Mercatorstraat 36,2023-08-15,13:00:00,390,220,170,FMN 02 Mercatorstraat
650,Mercatorstraat 36,2023-08-15,14:00:00,439,237,202,FMN 02 Mercatorstraat
650,Mercatorstraat 36,2023-08-15,15:00:00,425,190,235,FMN 02 Mercatorstraat
650,Mercatorstraat 36,2023-08-15,16:00:00,384,165,219,FMN 02 Mercatorstraat
650,Mercatorstraat 36,2023-08-15,17:00:00,421,164,257,FMN 02 Mercatorstraat
650,Mercatorstraat 36,2023-08-15,18:00:00,380,153,227,FMN 02 Mercatorstraat
650,Mercatorstraat 36,2023-08-15,19:00:00,272,129,143,FMN 02 Mercatorstraat
650,Mercatorstraat 36,2023-08-15,20:00:00,268,134,134,FMN 02 Mercatorstraat
650,Mercatorstraat 36,2023-08-15,21:00:00,218,103,115,FMN 02 Mercatorstraat
650,Mercatorstraat 36,2023-08-15,22:00:00,210,78,132,FMN 02 Mercatorstraat
650,Mercatorstraat 36,2023-08-15,23:00:00,133,37,96,FMN 02 Mercatorstraat
650,Mercatorstraat 36,2023-08-16,00:00:00,72,22,50,FMN 02 Mercatorstraat
650,Mercatorstraat 36,2023-08-16,01:00:00,39,17,22,FMN 02 Mercatorstraat
650,Mercatorstraat 36,2023-08-16,02:00:00,24,9,15,FMN 02 Mercatorstraat
650,Mercatorstraat 36,2023-08-16,03:00:00,28,16,12,FMN 02 Mercatorstraat
650,Mercatorstraat 36,2023-08-16,04:00:00,32,22,10,FMN 02 Mercatorstraat
650,Mercatorstraat 36,2023-08-16,05:00:00,53,31,22,FMN 02 Mercatorstraat
650,Mercatorstraat 36,2023-08-16,06:00:00,109,68,41,FMN 02 Mercatorstraat
650,Mercatorstraat 36,2023-08-16,07:00:00,297,194,103,FMN 02 Mercatorstraat
650,Mercatorstraat 36,2023-08-16,08:00:00,574,423,151,FMN 02 Mercatorstraat
650,Mercatorstraat 36,2023-08-16,09:00:00,384,277,107,FMN 02 Mercatorstraat
650,Mercatorstraat 36,2023-08-16,10:00:00,258,176,82,FMN 02 Mercatorstraat
650,Mercatorstraat 36,2023-08-16,11:00:00,286,165,121,FMN 02 Mercatorstraat
650,Mercatorstraat 36,2023-08-16,12:00:00,342,200,142,FMN 02 Mercatorstraat
650,Mercatorstraat 36,2023-08-16,13:00:00,322,174,148,FMN 02 Mercatorstraat
650,Mercatorstraat 36,2023-08-16,14:00:00,375,196,179,FMN 02 Mercatorstraat
650,Mercatorstraat 36,2023-08-16,15:00:00,389,192,197,FMN 02 Mercatorstraat
650,Mercatorstraat 36,2023-08-16,16:00:00,548,235,313,FMN 02 Mercatorstraat
650,Mercatorstraat 36,2023-08-16,17:00:00,679,231,448,FMN 02 Mercatorstraat
650,Mercatorstraat 36,2023-08-16,18:00:00,528,211,317,FMN 02 Mercatorstraat
650,Mercatorstraat 36,2023-08-16,19:00:00,318,154,164,FMN 02 Mercatorstraat
650,Mercatorstraat 36,2023-08-16,20:00:00,294,161,133,FMN 02 Mercatorstraat
650,Mercatorstraat 36,2023-08-16,21:00:00,220,111,109,FMN 02 Mercatorstraat
650,Mercatorstraat 36,2023-08-16,22:00:00,198,75,123,FMN 02 Mercatorstraat
650,Mercatorstraat 36,2023-08-16,23:00:00,134,46,88,FMN 02 Mercatorstraat
650,Mercatorstraat 36,2023-08-17,00:00:00,103,40,63,FMN 02 Mercatorstraat
650,Mercatorstraat 36,2023-08-17,01:00:00,32,7,25,FMN 02 Mercatorstraat
650,Mercatorstraat 36,2023-08-17,02:00:00,26,10,16,FMN 02 Mercatorstraat
650,Mercatorstraat 36,2023-08-17,03:00:00,29,9,20,FMN 02 Mercatorstraat
650,Mercatorstraat 36,2023-08-17,04:00:00,35,23,12,FMN 02 Mercatorstraat
650,Mercatorstraat 36,2023-08-17,05:00:00,48,31,17,FMN 02 Mercatorstraat
650,Mercatorstraat 36,2023-08-17,06:00:00,126,77,49,FMN 02 Mercatorstraat
650,Mercatorstraat 36,2023-08-17,07:00:00,316,221,95,FMN 02 Mercatorstraat
650,Mercatorstraat 36,2023-08-17,08:00:00,635,445,190,FMN 02 Mercatorstraat
650,Mercatorstraat 36,2023-08-17,09:00:00,379,268,111,FMN 02 Mercatorstraat
650,Mercatorstraat 36,2023-08-17,10:00:00,253,186,67,FMN 02 Mercatorstraat
650,Mercatorstraat 36,2023-08-17,11:00:00,331,205,126,FMN 02 Mercatorstraat
650,Mercatorstraat 36,2023-08-17,12:00:00,354,201,153,FMN 02 Mercatorstraat
650,Mercatorstraat 36,2023-08-17,13:00:00,355,208,147,FMN 02 Mercatorstraat
650,Mercatorstraat 36,2023-08-17,14:00:00,410,195,215,FMN 02 Mercatorstraat
650,Mercatorstraat 36,2023-08-17,15:00:00,403,186,217,FMN 02 Mercatorstraat
650,Mercatorstraat 36,2023-08-17,16:00:00,570,205,365,FMN 02 Mercatorstraat
650,Mercatorstraat 36,2023-08-17,17:00:00,756,265,491,FMN 02 Mercatorstraat
650,Mercatorstraat 36,2023-08-17,18:00:00,557,227,330,FMN 02 Mercatorstraat
650,Mercatorstraat 36,2023-08-17,19:00:00,354,167,187,FMN 02 Mercatorstraat
650,Mercatorstraat 36,2023-08-17,20:00:00,272,129,143,FMN 02 Mercatorstraat
650,Mercatorstraat 36,2023-08-17,21:00:00,238,86,152,FMN 02 Mercatorstraat
650,Mercatorstraat 36,2023-08-17,22:00:00,218,82,136,FMN 02 Mercatorstraat
650,Mercatorstraat 36,2023-08-17,23:00:00,134,40,94,FMN 02 Mercatorstraat
650,Mercatorstraat 36,2023-08-18,00:00:00,84,35,49,FMN 02 Mercatorstraat
650,Mercatorstraat 36,2023-08-18,01:00:00,79,48,31,FMN 02 Mercatorstraat
650,Mercatorstraat 36,2023-08-18,02:00:00,36,11,25,FMN 02 Mercatorstraat
650,Mercatorstraat 36,2023-08-18,03:00:00,26,10,16,FMN 02 Mercatorstraat
650,Mercatorstraat 36,2023-08-18,04:00:00,37,23,14,FMN 02 Mercatorstraat
650,Mercatorstraat 36,2023-08-18,05:00:00,63,32,31,FMN 02 Mercatorstraat
650,Mercatorstraat 36,2023-08-18,06:00:00,112,63,49,FMN 02 Mercatorstraat
650,Mercatorstraat 36,2023-08-18,07:00:00,258,158,100,FMN 02 Mercatorstraat
650,Mercatorstraat 36,2023-08-18,08:00:00,506,360,146,FMN 02 Mercatorstraat
650,Mercatorstraat 36,2023-08-18,09:00:00,351,236,115,FMN 02 Mercatorstraat
650,Mercatorstraat 36,2023-08-18,10:00:00,278,178,100,FMN 02 Mercatorstraat
650,Mercatorstraat 36,2023-08-18,11:00:00,261,165,96,FMN 02 Mercatorstraat
650,Mercatorstraat 36,2023-08-18,12:00:00,339,167,172,FMN 02 Mercatorstraat
650,Mercatorstraat 36,2023-08-18,13:00:00,319,175,144,FMN 02 Mercatorstraat
650,Mercatorstraat 36,2023-08-18,14:00:00,365,199,166,FMN 02 Mercatorstraat
650,Mercatorstraat 36,2023-08-18,15:00:00,445,201,244,FMN 02 Mercatorstraat
650,Mercatorstraat 36,2023-08-18,16:00:00,572,221,351,FMN 02 Mercatorstraat
650,Mercatorstraat 36,2023-08-18,17:00:00,619,278,341,FMN 02 Mercatorstraat
650,Mercatorstraat 36,2023-08-18,18:00:00,577,298,279,FMN 02 Mercatorstraat
650,Mercatorstraat 36,2023-08-18,19:00:00,470,272,198,FMN 02 Mercatorstraat
650,Mercatorstraat 36,2023-08-18,20:00:00,394,239,155,FMN 02 Mercatorstraat
650,Mercatorstraat 36,2023-08-18,21:00:00,370,204,166,FMN 02 Mercatorstraat
650,Mercatorstraat 36,2023-08-18,22:00:00,289,130,159,FMN 02 Mercatorstraat
650,Mercatorstraat 36,2023-08-18,23:00:00,272,92,180,FMN 02 Mercatorstraat
650,Mercatorstraat 36,2023-08-19,00:00:00,301,50,251,FMN 02 Mercatorstraat
650,Mercatorstraat 36,2023-08-19,01:00:00,219,53,166,FMN 02 Mercatorstraat
650,Mercatorstraat 36,2023-08-19,02:00:00,99,21,78,FMN 02 Mercatorstraat
650,Mercatorstraat 36,2023-08-19,03:00:00,59,15,44,FMN 02 Mercatorstraat
650,Mercatorstraat 36,2023-08-19,04:00:00,72,14,58,FMN 02 Mercatorstraat
650,Mercatorstraat 36,2023-08-19,05:00:00,48,16,32,FMN 02 Mercatorstraat
650,Mercatorstraat 36,2023-08-19,06:00:00,50,25,25,FMN 02 Mercatorstraat
650,Mercatorstraat 36,2023-08-19,07:00:00,45,17,28,FMN 02 Mercatorstraat
650,Mercatorstraat 36,2023-08-19,08:00:00,113,61,52,FMN 02 Mercatorstraat
650,Mercatorstraat 36,2023-08-19,09:00:00,213,154,59,FMN 02 Mercatorstraat
650,Mercatorstraat 36,2023-08-19,10:00:00,289,192,97,FMN 02 Mercatorstraat
650,Mercatorstraat 36,2023-08-19,11:00:00,279,157,122,FMN 02 Mercatorstraat
650,Mercatorstraat 36,2023-08-19,12:00:00,299,170,129,FMN 02 Mercatorstraat
650,Mercatorstraat 36,2023-08-19,13:00:00,374,218,156,FMN 02 Mercatorstraat
650,Mercatorstraat 36,2023-08-19,14:00:00,363,214,149,FMN 02 Mercatorstraat
650,Mercatorstraat 36,2023-08-19,15:00:00,367,201,166,FMN 02 Mercatorstraat
650,Mercatorstraat 36,2023-08-19,16:00:00,349,172,177,FMN 02 Mercatorstraat
650,Mercatorstraat 36,2023-08-19,17:00:00,403,202,201,FMN 02 Mercatorstraat
650,Mercatorstraat 36,2023-08-19,18:00:00,348,193,155,FMN 02 Mercatorstraat
650,Mercatorstraat 36,2023-08-19,19:00:00,358,187,171,FMN 02 Mercatorstraat
650,Mercatorstraat 36,2023-08-19,20:00:00,294,181,113,FMN 02 Mercatorstraat
650,Mercatorstraat 36,2023-08-19,21:00:00,310,164,146,FMN 02 Mercatorstraat
650,Mercatorstraat 36,2023-08-19,22:00:00,307,133,174,FMN 02 Mercatorstraat
650,Mercatorstraat 36,2023-08-19,23:00:00,176,58,118,FMN 02 Mercatorstraat
650,Mercatorstraat 36,2023-08-20,00:00:00,218,67,151,FMN 02 Mercatorstraat
650,Mercatorstraat 36,2023-08-20,01:00:00,143,37,106,FMN 02 Mercatorstraat
650,Mercatorstraat 36,2023-08-20,02:00:00,107,39,68,FMN 02 Mercatorstraat
650,Mercatorstraat 36,2023-08-20,03:00:00,102,36,66,FMN 02 Mercatorstraat
650,Mercatorstraat 36,2023-08-20,04:00:00,79,31,48,FMN 02 Mercatorstraat
650,Mercatorstraat 36,2023-08-20,05:00:00,53,11,42,FMN 02 Mercatorstraat
650,Mercatorstraat 36,2023-08-20,06:00:00,58,24,34,FMN 02 Mercatorstraat
650,Mercatorstraat 36,2023-08-20,07:00:00,57,33,24,FMN 02 Mercatorstraat
650,Mercatorstraat 36,2023-08-20,08:00:00,98,62,36,FMN 02 Mercatorstraat
650,Mercatorstraat 36,2023-08-20,09:00:00,152,94,58,FMN 02 Mercatorstraat
650,Mercatorstraat 36,2023-08-20,10:00:00,221,145,76,FMN 02 Mercatorstraat
650,Mercatorstraat 36,2023-08-20,11:00:00,279,164,115,FMN 02 Mercatorstraat
650,Mercatorstraat 36,2023-08-20,12:00:00,334,211,123,FMN 02 Mercatorstraat
650,Mercatorstraat 36,2023-08-20,13:00:00,418,252,166,FMN 02 Mercatorstraat
650,Mercatorstraat 36,2023-08-20,14:00:00,431,275,156,FMN 02 Mercatorstraat
650,Mercatorstraat 36,2023-08-20,15:00:00,416,243,173,FMN 02 Mercatorstraat
650,Mercatorstraat 36,2023-08-20,16:00:00,394,181,213,FMN 02 Mercatorstraat
650,Mercatorstraat 36,2023-08-20,17:00:00,393,187,206,FMN 02 Mercatorstraat
650,Mercatorstraat 36,2023-08-20,18:00:00,333,168,165,FMN 02 Mercatorstraat
650,Mercatorstraat 36,2023-08-20,19:00:00,306,153,153,FMN 02 Mercatorstraat
650,Mercatorstraat 36,2023-08-20,20:00:00,308,142,166,FMN 02 Mercatorstraat
650,Mercatorstraat 36,2023-08-20,21:00:00,270,111,159,FMN 02 Mercatorstraat
650,Mercatorstraat 36,2023-08-20,22:00:00,187,61,126,FMN 02 Mercatorstraat
650,Mercatorstraat 36,2023-08-20,23:00:00,98,33,65,FMN 02 Mercatorstraat
650,Mercatorstraat 36,2023-08-21,00:00:00,72,27,45,FMN 02 Mercatorstraat
650,Mercatorstraat 36,2023-08-21,01:00:00,33,14,19,FMN 02 Mercatorstraat
650,Mercatorstraat 36,2023-08-21,02:00:00,27,8,19,FMN 02 Mercatorstraat
650,Mercatorstraat 36,2023-08-21,03:00:00,48,16,32,FMN 02 Mercatorstraat
650,Mercatorstraat 36,2023-08-21,04:00:00,33,18,15,FMN 02 Mercatorstraat
650,Mercatorstraat 36,2023-08-21,05:00:00,53,27,26,FMN 02 Mercatorstraat
650,Mercatorstraat 36,2023-08-21,06:00:00,142,90,52,FMN 02 Mercatorstraat
650,Mercatorstraat 36,2023-08-21,07:00:00,332,239,93,FMN 02 Mercatorstraat
650,Mercatorstraat 36,2023-08-21,08:00:00,755,555,200,FMN 02 Mercatorstraat
650,Mercatorstraat 36,2023-08-21,09:00:00,402,305,97,FMN 02 Mercatorstraat
650,Mercatorstraat 36,2023-08-21,10:00:00,320,210,110,FMN 02 Mercatorstraat
650,Mercatorstraat 36,2023-08-21,11:00:00,307,186,121,FMN 02 Mercatorstraat
650,Mercatorstraat 36,2023-08-21,12:00:00,357,186,171,FMN 02 Mercatorstraat
650,Mercatorstraat 36,2023-08-21,13:00:00,390,215,175,FMN 02 Mercatorstraat
650,Mercatorstraat 36,2023-08-21,14:00:00,421,226,195,FMN 02 Mercatorstraat
650,Mercatorstraat 36,2023-08-21,15:00:00,429,182,247,FMN 02 Mercatorstraat
650,Mercatorstraat 36,2023-08-21,16:00:00,615,212,403,FMN 02 Mercatorstraat
650,Mercatorstraat 36,2023-08-21,17:00:00,756,238,518,FMN 02 Mercatorstraat
650,Mercatorstraat 36,2023-08-21,18:00:00,564,241,323,FMN 02 Mercatorstraat
650,Mercatorstraat 36,2023-08-21,19:00:00,388,207,181,FMN 02 Mercatorstraat
650,Mercatorstraat 36,2023-08-21,20:00:00,280,142,138,FMN 02 Mercatorstraat
650,Mercatorstraat 36,2023-08-21,21:00:00,228,92,136,FMN 02 Mercatorstraat
650,Mercatorstraat 36,2023-08-21,22:00:00,219,80,139,FMN 02 Mercatorstraat
650,Mercatorstraat 36,2023-08-21,23:00:00,129,43,86,FMN 02 Mercatorstraat
650,Mercatorstraat 36,2023-08-22,00:00:00,69,25,44,FMN 02 Mercatorstraat
650,Mercatorstraat 36,2023-08-22,01:00:00,36,12,24,FMN 02 Mercatorstraat
650,Mercatorstraat 36,2023-08-22,02:00:00,19,3,16,FMN 02 Mercatorstraat
650,Mercatorstraat 36,2023-08-22,03:00:00,19,9,10,FMN 02 Mercatorstraat
650,Mercatorstraat 36,2023-08-22,04:00:00,23,13,10,FMN 02 Mercatorstraat
650,Mercatorstraat 36,2023-08-22,05:00:00,47,28,19,FMN 02 Mercatorstraat
650,Mercatorstraat 36,2023-08-22,06:00:00,137,81,56,FMN 02 Mercatorstraat
650,Mercatorstraat 36,2023-08-22,07:00:00,375,260,115,FMN 02 Mercatorstraat
650,Mercatorstraat 36,2023-08-22,08:00:00,849,610,239,FMN 02 Mercatorstraat
650,Mercatorstraat 36,2023-08-22,09:00:00,447,331,116,FMN 02 Mercatorstraat
650,Mercatorstraat 36,2023-08-22,10:00:00,340,221,119,FMN 02 Mercatorstraat
650,Mercatorstraat 36,2023-08-22,11:00:00,286,163,123,FMN 02 Mercatorstraat
650,Mercatorstraat 36,2023-08-22,12:00:00,410,219,191,FMN 02 Mercatorstraat
650,Mercatorstraat 36,2023-08-22,13:00:00,387,209,178,FMN 02 Mercatorstraat
650,Mercatorstraat 36,2023-08-22,14:00:00,420,243,177,FMN 02 Mercatorstraat
650,Mercatorstraat 36,2023-08-22,15:00:00,448,204,244,FMN 02 Mercatorstraat
650,Mercatorstraat 36,2023-08-22,16:00:00,642,240,402,FMN 02 Mercatorstraat
650,Mercatorstraat 36,2023-08-22,17:00:00,858,296,562,FMN 02 Mercatorstraat
650,Mercatorstraat 36,2023-08-22,18:00:00,607,265,342,FMN 02 Mercatorstraat
650,Mercatorstraat 36,2023-08-22,19:00:00,409,202,207,FMN 02 Mercatorstraat
650,Mercatorstraat 36,2023-08-22,20:00:00,289,133,156,FMN 02 Mercatorstraat
650,Mercatorstraat 36,2023-08-22,21:00:00,282,144,138,FMN 02 Mercatorstraat
650,Mercatorstraat 36,2023-08-22,22:00:00,252,83,169,FMN 02 Mercatorstraat
650,Mercatorstraat 36,2023-08-22,23:00:00,171,60,111,FMN 02 Mercatorstraat
650,Mercatorstraat 36,2023-08-23,00:00:00,96,33,63,FMN 02 Mercatorstraat
650,Mercatorstraat 36,2023-08-23,01:00:00,54,19,35,FMN 02 Mercatorstraat
650,Mercatorstraat 36,2023-08-23,02:00:00,33,15,18,FMN 02 Mercatorstraat
650,Mercatorstraat 36,2023-08-23,03:00:00,20,9,11,FMN 02 Mercatorstraat
650,Mercatorstraat 36,2023-08-23,04:00:00,39,23,16,FMN 02 Mercatorstraat
650,Mercatorstraat 36,2023-08-23,05:00:00,54,32,22,FMN 02 Mercatorstraat
650,Mercatorstraat 36,2023-08-23,06:00:00,138,92,46,FMN 02 Mercatorstraat
650,Mercatorstraat 36,2023-08-23,07:00:00,336,218,118,FMN 02 Mercatorstraat
650,Mercatorstraat 36,2023-08-23,08:00:00,702,511,191,FMN 02 Mercatorstraat
650,Mercatorstraat 36,2023-08-23,09:00:00,456,322,134,FMN 02 Mercatorstraat
650,Mercatorstraat 36,2023-08-23,10:00:00,307,201,106,FMN 02 Mercatorstraat
650,Mercatorstraat 36,2023-08-23,11:00:00,338,213,125,FMN 02 Mercatorstraat
650,Mercatorstraat 36,2023-08-23,12:00:00,396,210,186,FMN 02 Mercatorstraat
650,Mercatorstraat 36,2023-08-23,13:00:00,439,249,190,FMN 02 Mercatorstraat
650,Mercatorstraat 36,2023-08-23,14:00:00,383,205,178,FMN 02 Mercatorstraat
650,Mercatorstraat 36,2023-08-23,15:00:00,516,225,291,FMN 02 Mercatorstraat
650,Mercatorstraat 36,2023-08-23,16:00:00,582,214,368,FMN 02 Mercatorstraat
650,Mercatorstraat 36,2023-08-23,17:00:00,795,288,507,FMN 02 Mercatorstraat
650,Mercatorstraat 36,2023-08-23,18:00:00,577,241,336,FMN 02 Mercatorstraat
650,Mercatorstraat 36,2023-08-23,19:00:00,465,208,257,FMN 02 Mercatorstraat
650,Mercatorstraat 36,2023-08-23,20:00:00,349,182,167,FMN 02 Mercatorstraat
650,Mercatorstraat 36,2023-08-23,21:00:00,269,117,152,FMN 02 Mercatorstraat
650,Mercatorstraat 36,2023-08-23,22:00:00,269,103,166,FMN 02 Mercatorstraat
650,Mercatorstraat 36,2023-08-23,23:00:00,162,71,91,FMN 02 Mercatorstraat
650,Mercatorstraat 36,2023-08-24,00:00:00,103,44,59,FMN 02 Mercatorstraat
650,Mercatorstraat 36,2023-08-24,01:00:00,68,15,53,FMN 02 Mercatorstraat
650,Mercatorstraat 36,2023-08-24,02:00:00,30,17,13,FMN 02 Mercatorstraat
650,Mercatorstraat 36,2023-08-24,03:00:00,28,9,19,FMN 02 Mercatorstraat
650,Mercatorstraat 36,2023-08-24,04:00:00,39,21,18,FMN 02 Mercatorstraat
650,Mercatorstraat 36,2023-08-24,05:00:00,65,38,27,FMN 02 Mercatorstraat
650,Mercatorstraat 36,2023-08-24,06:00:00,119,75,44,FMN 02 Mercatorstraat
650,Mercatorstraat 36,2023-08-24,07:00:00,347,238,109,FMN 02 Mercatorstraat
650,Mercatorstraat 36,2023-08-24,08:00:00,766,536,230,FMN 02 Mercatorstraat
650,Mercatorstraat 36,2023-08-24,09:00:00,433,289,144,FMN 02 Mercatorstraat
650,Mercatorstraat 36,2023-08-24,10:00:00,302,198,104,FMN 02 Mercatorstraat
650,Mercatorstraat 36,2023-08-24,11:00:00,295,172,123,FMN 02 Mercatorstraat
650,Mercatorstraat 36,2023-08-24,12:00:00,284,128,156,FMN 02 Mercatorstraat
650,Mercatorstraat 36,2023-08-24,13:00:00,323,173,150,FMN 02 Mercatorstraat
650,Mercatorstraat 36,2023-08-24,14:00:00,310,169,141,FMN 02 Mercatorstraat
650,Mercatorstraat 36,2023-08-24,15:00:00,348,166,182,FMN 02 Mercatorstraat
650,Mercatorstraat 36,2023-08-24,16:00:00,579,214,365,FMN 02 Mercatorstraat
650,Mercatorstraat 36,2023-08-24,17:00:00,773,273,500,FMN 02 Mercatorstraat
650,Mercatorstraat 36,2023-08-24,18:00:00,555,215,340,FMN 02 Mercatorstraat
650,Mercatorstraat 36,2023-08-24,19:00:00,386,187,199,FMN 02 Mercatorstraat
650,Mercatorstraat 36,2023-08-24,20:00:00,292,137,155,FMN 02 Mercatorstraat
650,Mercatorstraat 36,2023-08-24,21:00:00,285,125,160,FMN 02 Mercatorstraat
650,Mercatorstraat 36,2023-08-24,22:00:00,189,64,125,FMN 02 Mercatorstraat
650,Mercatorstraat 36,2023-08-24,23:00:00,133,43,90,FMN 02 Mercatorstraat
650,Mercatorstraat 36,2023-08-25,00:00:00,113,40,73,FMN 02 Mercatorstraat
650,Mercatorstraat 36,2023-08-25,01:00:00,47,24,23,FMN 02 Mercatorstraat
650,Mercatorstraat 36,2023-08-25,02:00:00,26,10,16,FMN 02 Mercatorstraat
650,Mercatorstraat 36,2023-08-25,03:00:00,32,12,20,FMN 02 Mercatorstraat
650,Mercatorstraat 36,2023-08-25,04:00:00,37,22,15,FMN 02 Mercatorstraat
650,Mercatorstraat 36,2023-08-25,05:00:00,47,22,25,FMN 02 Mercatorstraat
650,Mercatorstraat 36,2023-08-25,06:00:00,128,76,52,FMN 02 Mercatorstraat
650,Mercatorstraat 36,2023-08-25,07:00:00,256,166,90,FMN 02 Mercatorstraat
650,Mercatorstraat 36,2023-08-25,08:00:00,529,382,147,FMN 02 Mercatorstraat
650,Mercatorstraat 36,2023-08-25,09:00:00,454,331,123,FMN 02 Mercatorstraat
650,Mercatorstraat 36,2023-08-25,10:00:00,331,215,116,FMN 02 Mercatorstraat
650,Mercatorstraat 36,2023-08-25,11:00:00,359,221,138,FMN 02 Mercatorstraat
650,Mercatorstraat 36,2023-08-25,12:00:00,484,253,231,FMN 02 Mercatorstraat
650,Mercatorstraat 36,2023-08-25,13:00:00,479,255,224,FMN 02 Mercatorstraat
650,Mercatorstraat 36,2023-08-25,14:00:00,493,290,203,FMN 02 Mercatorstraat
650,Mercatorstraat 36,2023-08-25,15:00:00,606,287,319,FMN 02 Mercatorstraat
650,Mercatorstraat 36,2023-08-25,16:00:00,698,264,434,FMN 02 Mercatorstraat
650,Mercatorstraat 36,2023-08-25,17:00:00,693,274,419,FMN 02 Mercatorstraat
650,Mercatorstraat 36,2023-08-25,18:00:00,552,229,323,FMN 02 Mercatorstraat
650,Mercatorstraat 36,2023-08-25,19:00:00,395,143,252,FMN 02 Mercatorstraat
650,Mercatorstraat 36,2023-08-25,20:00:00,348,142,206,FMN 02 Mercatorstraat
650,Mercatorstraat 36,2023-08-25,21:00:00,252,127,125,FMN 02 Mercatorstraat
650,Mercatorstraat 36,2023-08-25,22:00:00,184,85,99,FMN 02 Mercatorstraat
650,Mercatorstraat 36,2023-08-25,23:00:00,203,83,120,FMN 02 Mercatorstraat
650,Mercatorstraat 36,2023-08-26,00:00:00,177,74,103,FMN 02 Mercatorstraat
650,Mercatorstraat 36,2023-08-26,01:00:00,113,45,68,FMN 02 Mercatorstraat
650,Mercatorstraat 36,2023-08-26,02:00:00,113,38,75,FMN 02 Mercatorstraat
650,Mercatorstraat 36,2023-08-26,03:00:00,44,19,25,FMN 02 Mercatorstraat
650,Mercatorstraat 36,2023-08-26,04:00:00,39,19,20,FMN 02 Mercatorstraat
650,Mercatorstraat 36,2023-08-26,05:00:00,47,21,26,FMN 02 Mercatorstraat
650,Mercatorstraat 36,2023-08-26,06:00:00,41,21,20,FMN 02 Mercatorstraat
650,Mercatorstraat 36,2023-08-26,07:00:00,66,37,29,FMN 02 Mercatorstraat
650,Mercatorstraat 36,2023-08-26,08:00:00,174,124,50,FMN 02 Mercatorstraat
650,Mercatorstraat 36,2023-08-26,09:00:00,371,316,55,FMN 02 Mercatorstraat
650,Mercatorstraat 36,2023-08-26,10:00:00,478,375,103,FMN 02 Mercatorstraat
650,Mercatorstraat 36,2023-08-26,11:00:00,489,290,199,FMN 02 Mercatorstraat
650,Mercatorstraat 36,2023-08-26,12:00:00,523,298,225,FMN 02 Mercatorstraat
650,Mercatorstraat 36,2023-08-26,13:00:00,620,364,256,FMN 02 Mercatorstraat
650,Mercatorstraat 36,2023-08-26,14:00:00,726,470,256,FMN 02 Mercatorstraat
650,Mercatorstraat 36,2023-08-26,15:00:00,635,348,287,FMN 02 Mercatorstraat
650,Mercatorstraat 36,2023-08-26,16:00:00,398,169,229,FMN 02 Mercatorstraat
650,Mercatorstraat 36,2023-08-26,17:00:00,551,131,420,FMN 02 Mercatorstraat
650,Mercatorstraat 36,2023-08-26,18:00:00,419,137,282,FMN 02 Mercatorstraat
650,Mercatorstraat 36,2023-08-26,19:00:00,278,128,150,FMN 02 Mercatorstraat
650,Mercatorstraat 36,2023-08-26,20:00:00,249,127,122,FMN 02 Mercatorstraat
650,Mercatorstraat 36,2023-08-26,21:00:00,183,84,99,FMN 02 Mercatorstraat
650,Mercatorstraat 36,2023-08-26,22:00:00,195,67,128,FMN 02 Mercatorstraat
650,Mercatorstraat 36,2023-08-26,23:00:00,155,68,87,FMN 02 Mercatorstraat
650,Mercatorstraat 36,2023-08-27,00:00:00,142,55,87,FMN 02 Mercatorstraat
650,Mercatorstraat 36,2023-08-27,01:00:00,117,47,70,FMN 02 Mercatorstraat
650,Mercatorstraat 36,2023-08-27,02:00:00,97,45,52,FMN 02 Mercatorstraat
650,Mercatorstraat 36,2023-08-27,03:00:00,68,20,48,FMN 02 Mercatorstraat
650,Mercatorstraat 36,2023-08-27,04:00:00,36,10,26,FMN 02 Mercatorstraat
650,Mercatorstraat 36,2023-08-27,05:00:00,48,19,29,FMN 02 Mercatorstraat
650,Mercatorstraat 36,2023-08-27,06:00:00,46,24,22,FMN 02 Mercatorstraat
650,Mercatorstraat 36,2023-08-27,07:00:00,45,26,19,FMN 02 Mercatorstraat
650,Mercatorstraat 36,2023-08-27,08:00:00,107,68,39,FMN 02 Mercatorstraat
650,Mercatorstraat 36,2023-08-27,09:00:00,197,133,64,FMN 02 Mercatorstraat
650,Mercatorstraat 36,2023-08-27,10:00:00,282,186,96,FMN 02 Mercatorstraat
650,Mercatorstraat 36,2023-08-27,11:00:00,348,220,128,FMN 02 Mercatorstraat
650,Mercatorstraat 36,2023-08-27,12:00:00,357,189,168,FMN 02 Mercatorstraat
650,Mercatorstraat 36,2023-08-27,13:00:00,339,162,177,FMN 02 Mercatorstraat
650,Mercatorstraat 36,2023-08-27,14:00:00,341,220,121,FMN 02 Mercatorstraat
650,Mercatorstraat 36,2023-08-27,15:00:00,241,137,104,FMN 02 Mercatorstraat
650,Mercatorstraat 36,2023-08-27,16:00:00,365,189,176,FMN 02 Mercatorstraat
650,Mercatorstraat 36,2023-08-27,17:00:00,308,107,201,FMN 02 Mercatorstraat
650,Mercatorstraat 36,2023-08-27,18:00:00,335,144,191,FMN 02 Mercatorstraat
650,Mercatorstraat 36,2023-08-27,19:00:00,304,114,190,FMN 02 Mercatorstraat
650,Mercatorstraat 36,2023-08-27,20:00:00,296,122,174,FMN 02 Mercatorstraat
650,Mercatorstraat 36,2023-08-27,21:00:00,247,107,140,FMN 02 Mercatorstraat
650,Mercatorstraat 36,2023-08-27,22:00:00,174,60,114,FMN 02 Mercatorstraat
650,Mercatorstraat 36,2023-08-27,23:00:00,96,38,58,FMN 02 Mercatorstraat
650,Mercatorstraat 36,2023-08-28,00:00:00,61,21,40,FMN 02 Mercatorstraat
650,Mercatorstraat 36,2023-08-28,01:00:00,36,10,26,FMN 02 Mercatorstraat
650,Mercatorstraat 36,2023-08-28,02:00:00,19,8,11,FMN 02 Mercatorstraat
650,Mercatorstraat 36,2023-08-28,03:00:00,16,8,8,FMN 02 Mercatorstraat
650,Mercatorstraat 36,2023-08-28,04:00:00,29,11,18,FMN 02 Mercatorstraat
650,Mercatorstraat 36,2023-08-28,05:00:00,62,34,28,FMN 02 Mercatorstraat
650,Mercatorstraat 36,2023-08-28,06:00:00,140,97,43,FMN 02 Mercatorstraat
650,Mercatorstraat 36,2023-08-28,07:00:00,281,189,92,FMN 02 Mercatorstraat
650,Mercatorstraat 36,2023-08-28,08:00:00,751,560,191,FMN 02 Mercatorstraat
650,Mercatorstraat 36,2023-08-28,09:00:00,421,308,113,FMN 02 Mercatorstraat
650,Mercatorstraat 36,2023-08-28,10:00:00,301,204,97,FMN 02 Mercatorstraat
650,Mercatorstraat 36,2023-08-28,11:00:00,271,150,121,FMN 02 Mercatorstraat
650,Mercatorstraat 36,2023-08-28,12:00:00,410,221,189,FMN 02 Mercatorstraat
650,Mercatorstraat 36,2023-08-28,13:00:00,440,235,205,FMN 02 Mercatorstraat
650,Mercatorstraat 36,2023-08-28,14:00:00,392,210,182,FMN 02 Mercatorstraat
650,Mercatorstraat 36,2023-08-28,15:00:00,447,211,236,FMN 02 Mercatorstraat
650,Mercatorstraat 36,2023-08-28,16:00:00,618,212,406,FMN 02 Mercatorstraat
650,Mercatorstraat 36,2023-08-28,17:00:00,801,240,561,FMN 02 Mercatorstraat
650,Mercatorstraat 36,2023-08-28,18:00:00,459,180,279,FMN 02 Mercatorstraat
650,Mercatorstraat 36,2023-08-28,19:00:00,324,142,182,FMN 02 Mercatorstraat
650,Mercatorstraat 36,2023-08-28,20:00:00,228,97,131,FMN 02 Mercatorstraat
650,Mercatorstraat 36,2023-08-28,21:00:00,191,93,98,FMN 02 Mercatorstraat
650,Mercatorstraat 36,2023-08-28,22:00:00,165,56,109,FMN 02 Mercatorstraat
650,Mercatorstraat 36,2023-08-28,23:00:00,111,50,61,FMN 02 Mercatorstraat
650,Mercatorstraat 36,2023-08-29,00:00:00,59,17,42,FMN 02 Mercatorstraat
650,Mercatorstraat 36,2023-08-29,01:00:00,29,10,19,FMN 02 Mercatorstraat
650,Mercatorstraat 36,2023-08-29,02:00:00,16,3,13,FMN 02 Mercatorstraat
650,Mercatorstraat 36,2023-08-29,03:00:00,17,6,11,FMN 02 Mercatorstraat
650,Mercatorstraat 36,2023-08-29,04:00:00,26,14,12,FMN 02 Mercatorstraat
650,Mercatorstraat 36,2023-08-29,05:00:00,56,34,22,FMN 02 Mercatorstraat
650,Mercatorstraat 36,2023-08-29,06:00:00,137,87,50,FMN 02 Mercatorstraat
650,Mercatorstraat 36,2023-08-29,07:00:00,373,264,109,FMN 02 Mercatorstraat
650,Mercatorstraat 36,2023-08-29,08:00:00,908,670,238,FMN 02 Mercatorstraat
650,Mercatorstraat 36,2023-08-29,09:00:00,460,344,116,FMN 02 Mercatorstraat
650,Mercatorstraat 36,2023-08-29,10:00:00,332,222,110,FMN 02 Mercatorstraat
650,Mercatorstraat 36,2023-08-29,11:00:00,340,193,147,FMN 02 Mercatorstraat
650,Mercatorstraat 36,2023-08-29,12:00:00,392,208,184,FMN 02 Mercatorstraat
650,Mercatorstraat 36,2023-08-29,13:00:00,455,261,194,FMN 02 Mercatorstraat
650,Mercatorstraat 36,2023-08-29,14:00:00,433,210,223,FMN 02 Mercatorstraat
650,Mercatorstraat 36,2023-08-29,15:00:00,448,189,259,FMN 02 Mercatorstraat
650,Mercatorstraat 36,2023-08-29,16:00:00,683,231,452,FMN 02 Mercatorstraat
650,Mercatorstraat 36,2023-08-29,17:00:00,892,301,591,FMN 02 Mercatorstraat
650,Mercatorstraat 36,2023-08-29,18:00:00,618,235,383,FMN 02 Mercatorstraat
650,Mercatorstraat 36,2023-08-29,19:00:00,386,154,232,FMN 02 Mercatorstraat
650,Mercatorstraat 36,2023-08-29,20:00:00,300,144,156,FMN 02 Mercatorstraat
650,Mercatorstraat 36,2023-08-29,21:00:00,303,162,141,FMN 02 Mercatorstraat
650,Mercatorstraat 36,2023-08-29,22:00:00,222,89,133,FMN 02 Mercatorstraat
650,Mercatorstraat 36,2023-08-29,23:00:00,181,75,106,FMN 02 Mercatorstraat
650,Mercatorstraat 36,2023-08-30,00:00:00,77,24,53,FMN 02 Mercatorstraat
650,Mercatorstraat 36,2023-08-30,01:00:00,49,15,34,FMN 02 Mercatorstraat
650,Mercatorstraat 36,2023-08-30,02:00:00,32,14,18,FMN 02 Mercatorstraat
650,Mercatorstraat 36,2023-08-30,03:00:00,28,8,20,FMN 02 Mercatorstraat
650,Mercatorstraat 36,2023-08-30,04:00:00,29,13,16,FMN 02 Mercatorstraat
650,Mercatorstraat 36,2023-08-30,05:00:00,52,31,21,FMN 02 Mercatorstraat
650,Mercatorstraat 36,2023-08-30,06:00:00,122,74,48,FMN 02 Mercatorstraat
650,Mercatorstraat 36,2023-08-30,07:00:00,283,198,85,FMN 02 Mercatorstraat
650,Mercatorstraat 36,2023-08-30,08:00:00,571,418,153,FMN 02 Mercatorstraat
650,Mercatorstraat 36,2023-08-30,09:00:00,378,270,108,FMN 02 Mercatorstraat
650,Mercatorstraat 36,2023-08-30,10:00:00,239,167,72,FMN 02 Mercatorstraat
650,Mercatorstraat 36,2023-08-30,11:00:00,268,163,105,FMN 02 Mercatorstraat
650,Mercatorstraat 36,2023-08-30,12:00:00,362,195,167,FMN 02 Mercatorstraat
650,Mercatorstraat 36,2023-08-30,13:00:00,374,192,182,FMN 02 Mercatorstraat
650,Mercatorstraat 36,2023-08-30,14:00:00,424,225,199,FMN 02 Mercatorstraat
650,Mercatorstraat 36,2023-08-30,15:00:00,445,196,249,FMN 02 Mercatorstraat
650,Mercatorstraat 36,2023-08-30,16:00:00,603,217,386,FMN 02 Mercatorstraat
650,Mercatorstraat 36,2023-08-30,17:00:00,689,249,440,FMN 02 Mercatorstraat
650,Mercatorstraat 36,2023-08-30,18:00:00,575,244,331,FMN 02 Mercatorstraat
650,Mercatorstraat 36,2023-08-30,19:00:00,405,191,214,FMN 02 Mercatorstraat
650,Mercatorstraat 36,2023-08-30,20:00:00,309,139,170,FMN 02 Mercatorstraat
650,Mercatorstraat 36,2023-08-30,21:00:00,221,105,116,FMN 02 Mercatorstraat
650,Mercatorstraat 36,2023-08-30,22:00:00,273,125,148,FMN 02 Mercatorstraat
650,Mercatorstraat 36,2023-08-30,23:00:00,173,78,95,FMN 02 Mercatorstraat
650,Mercatorstraat 36,2023-08-31,00:00:00,101,36,65,FMN 02 Mercatorstraat
650,Mercatorstraat 36,2023-08-31,01:00:00,58,15,43,FMN 02 Mercatorstraat
650,Mercatorstraat 36,2023-08-31,02:00:00,36,11,25,FMN 02 Mercatorstraat
650,Mercatorstraat 36,2023-08-31,03:00:00,30,12,18,FMN 02 Mercatorstraat
650,Mercatorstraat 36,2023-08-31,04:00:00,34,20,14,FMN 02 Mercatorstraat
650,Mercatorstraat 36,2023-08-31,05:00:00,60,33,27,FMN 02 Mercatorstraat
650,Mercatorstraat 36,2023-08-31,06:00:00,148,93,55,FMN 02 Mercatorstraat
650,Mercatorstraat 36,2023-08-31,07:00:00,333,224,109,FMN 02 Mercatorstraat
650,Mercatorstraat 36,2023-08-31,08:00:00,771,577,194,FMN 02 Mercatorstraat
650,Mercatorstraat 36,2023-08-31,09:00:00,534,391,143,FMN 02 Mercatorstraat
650,Mercatorstraat 36,2023-08-31,10:00:00,354,250,104,FMN 02 Mercatorstraat
650,Mercatorstraat 36,2023-08-31,11:00:00,366,225,141,FMN 02 Mercatorstraat
650,Mercatorstraat 36,2023-08-31,12:00:00,520,271,249,FMN 02 Mercatorstraat
650,Mercatorstraat 36,2023-08-31,13:00:00,538,297,241,FMN 02 Mercatorstraat
650,Mercatorstraat 36,2023-08-31,14:00:00,501,248,253,FMN 02 Mercatorstraat
650,Mercatorstraat 36,2023-08-31,15:00:00,518,214,304,FMN 02 Mercatorstraat
650,Mercatorstraat 36,2023-08-31,16:00:00,681,246,435,FMN 02 Mercatorstraat
650,Mercatorstraat 36,2023-08-31,17:00:00,869,287,582,FMN 02 Mercatorstraat
650,Mercatorstraat 36,2023-08-31,18:00:00,636,241,395,FMN 02 Mercatorstraat
650,Mercatorstraat 36,2023-08-31,19:00:00,390,174,216,FMN 02 Mercatorstraat
650,Mercatorstraat 36,2023-08-31,20:00:00,253,106,147,FMN 02 Mercatorstraat
650,Mercatorstraat 36,2023-08-31,21:00:00,248,113,135,FMN 02 Mercatorstraat
650,Mercatorstraat 36,2023-08-31,22:00:00,234,86,148,FMN 02 Mercatorstraat
650,Mercatorstraat 36,2023-08-31,23:00:00,144,62,82,FMN 02 Mercatorstraat
650,Mercatorstraat 36,2023-09-01,00:00:00,77,29,48,FMN 02 Mercatorstraat
650,Mercatorstraat 36,2023-09-01,01:00:00,39,19,20,FMN 02 Mercatorstraat
650,Mercatorstraat 36,2023-09-01,02:00:00,27,6,21,FMN 02 Mercatorstraat
650,Mercatorstraat 36,2023-09-01,03:00:00,25,6,19,FMN 02 Mercatorstraat
650,Mercatorstraat 36,2023-09-01,04:00:00,41,18,23,FMN 02 Mercatorstraat
650,Mercatorstraat 36,2023-09-01,05:00:00,53,24,29,FMN 02 Mercatorstraat
650,Mercatorstraat 36,2023-09-01,06:00:00,125,68,57,FMN 02 Mercatorstraat
650,Mercatorstraat 36,2023-09-01,07:00:00,289,186,103,FMN 02 Mercatorstraat
650,Mercatorstraat 36,2023-09-01,08:00:00,632,450,182,FMN 02 Mercatorstraat
650,Mercatorstraat 36,2023-09-01,09:00:00,335,261,74,FMN 02 Mercatorstraat
650,Mercatorstraat 36,2023-09-01,10:00:00,174,117,57,FMN 02 Mercatorstraat
650,Mercatorstraat 36,2023-09-01,11:00:00,161,74,87,FMN 02 Mercatorstraat
650,Mercatorstraat 36,2023-09-01,12:00:00,277,149,128,FMN 02 Mercatorstraat
650,Mercatorstraat 36,2023-09-01,13:00:00,284,141,143,FMN 02 Mercatorstraat
650,Mercatorstraat 36,2023-09-01,14:00:00,358,164,194,FMN 02 Mercatorstraat
650,Mercatorstraat 36,2023-09-01,15:00:00,539,183,356,FMN 02 Mercatorstraat
650,Mercatorstraat 36,2023-09-01,16:00:00,537,189,348,FMN 02 Mercatorstraat
650,Mercatorstraat 36,2023-09-01,17:00:00,586,234,352,FMN 02 Mercatorstraat
650,Mercatorstraat 36,2023-09-01,18:00:00,495,231,264,FMN 02 Mercatorstraat
650,Mercatorstraat 36,2023-09-01,19:00:00,333,174,159,FMN 02 Mercatorstraat
650,Mercatorstraat 36,2023-09-01,20:00:00,265,119,146,FMN 02 Mercatorstraat
650,Mercatorstraat 36,2023-09-01,21:00:00,263,126,137,FMN 02 Mercatorstraat
650,Mercatorstraat 36,2023-09-01,22:00:00,199,80,119,FMN 02 Mercatorstraat
650,Mercatorstraat 36,2023-09-01,23:00:00,151,51,100,FMN 02 Mercatorstraat
650,Mercatorstraat 36,2023-09-02,00:00:00,178,79,99,FMN 02 Mercatorstraat
650,Mercatorstraat 36,2023-09-02,01:00:00,134,58,76,FMN 02 Mercatorstraat
650,Mercatorstraat 36,2023-09-02,02:00:00,104,34,70,FMN 02 Mercatorstraat
650,Mercatorstraat 36,2023-09-02,03:00:00,54,16,38,FMN 02 Mercatorstraat
650,Mercatorstraat 36,2023-09-02,04:00:00,50,17,33,FMN 02 Mercatorstraat
650,Mercatorstraat 36,2023-09-02,05:00:00,62,23,39,FMN 02 Mercatorstraat
650,Mercatorstraat 36,2023-09-02,06:00:00,40,23,17,FMN 02 Mercatorstraat
650,Mercatorstraat 36,2023-09-02,07:00:00,68,33,35,FMN 02 Mercatorstraat
650,Mercatorstraat 36,2023-09-02,08:00:00,113,75,38,FMN 02 Mercatorstraat
650,Mercatorstraat 36,2023-09-02,09:00:00,222,172,50,FMN 02 Mercatorstraat
650,Mercatorstraat 36,2023-09-02,10:00:00,282,202,80,FMN 02 Mercatorstraat
650,Mercatorstraat 36,2023-09-02,11:00:00,344,218,126,FMN 02 Mercatorstraat
650,Mercatorstraat 36,2023-09-02,12:00:00,388,224,164,FMN 02 Mercatorstraat
650,Mercatorstraat 36,2023-09-02,13:00:00,455,288,167,FMN 02 Mercatorstraat
650,Mercatorstraat 36,2023-09-02,14:00:00,440,234,206,FMN 02 Mercatorstraat
650,Mercatorstraat 36,2023-09-02,15:00:00,431,212,219,FMN 02 Mercatorstraat
650,Mercatorstraat 36,2023-09-02,16:00:00,438,205,233,FMN 02 Mercatorstraat
650,Mercatorstraat 36,2023-09-02,17:00:00,381,168,213,FMN 02 Mercatorstraat
650,Mercatorstraat 36,2023-09-02,18:00:00,425,164,261,FMN 02 Mercatorstraat
650,Mercatorstraat 36,2023-09-02,19:00:00,329,187,142,FMN 02 Mercatorstraat
650,Mercatorstraat 36,2023-09-02,20:00:00,263,116,147,FMN 02 Mercatorstraat
650,Mercatorstraat 36,2023-09-02,21:00:00,234,118,116,FMN 02 Mercatorstraat
650,Mercatorstraat 36,2023-09-02,22:00:00,205,71,134,FMN 02 Mercatorstraat
650,Mercatorstraat 36,2023-09-02,23:00:00,179,66,113,FMN 02 Mercatorstraat
650,Mercatorstraat 36,2023-09-03,00:00:00,181,68,113,FMN 02 Mercatorstraat
650,Mercatorstraat 36,2023-09-03,01:00:00,135,54,81,FMN 02 Mercatorstraat
650,Mercatorstraat 36,2023-09-03,02:00:00,107,36,71,FMN 02 Mercatorstraat
650,Mercatorstraat 36,2023-09-03,03:00:00,76,23,53,FMN 02 Mercatorstraat
650,Mercatorstraat 36,2023-09-03,04:00:00,53,14,39,FMN 02 Mercatorstraat
650,Mercatorstraat 36,2023-09-03,05:00:00,51,13,38,FMN 02 Mercatorstraat
650,Mercatorstraat 36,2023-09-03,06:00:00,46,17,29,FMN 02 Mercatorstraat
650,Mercatorstraat 36,2023-09-03,07:00:00,57,30,27,FMN 02 Mercatorstraat
650,Mercatorstraat 36,2023-09-03,08:00:00,123,44,79,FMN 02 Mercatorstraat
650,Mercatorstraat 36,2023-09-03,09:00:00,234,128,106,FMN 02 Mercatorstraat
650,Mercatorstraat 36,2023-09-03,10:00:00,352,270,82,FMN 02 Mercatorstraat
650,Mercatorstraat 36,2023-09-03,11:00:00,313,190,123,FMN 02 Mercatorstraat
650,Mercatorstraat 36,2023-09-03,12:00:00,402,230,172,FMN 02 Mercatorstraat
650,Mercatorstraat 36,2023-09-03,13:00:00,486,281,205,FMN 02 Mercatorstraat
650,Mercatorstraat 36,2023-09-03,14:00:00,538,323,215,FMN 02 Mercatorstraat
650,Mercatorstraat 36,2023-09-03,15:00:00,497,259,238,FMN 02 Mercatorstraat
650,Mercatorstraat 36,2023-09-03,16:00:00,433,193,240,FMN 02 Mercatorstraat
650,Mercatorstraat 36,2023-09-03,17:00:00,478,209,269,FMN 02 Mercatorstraat
650,Mercatorstraat 36,2023-09-03,18:00:00,406,163,243,FMN 02 Mercatorstraat
650,Mercatorstraat 36,2023-09-03,19:00:00,345,161,184,FMN 02 Mercatorstraat
650,Mercatorstraat 36,2023-09-03,20:00:00,303,126,177,FMN 02 Mercatorstraat
650,Mercatorstraat 36,2023-09-03,21:00:00,286,100,186,FMN 02 Mercatorstraat
650,Mercatorstraat 36,2023-09-03,22:00:00,172,75,97,FMN 02 Mercatorstraat
650,Mercatorstraat 36,2023-09-03,23:00:00,92,38,54,FMN 02 Mercatorstraat
650,Mercatorstraat 36,2023-09-04,00:00:00,46,14,32,FMN 02 Mercatorstraat
650,Mercatorstraat 36,2023-09-04,01:00:00,32,13,19,FMN 02 Mercatorstraat
650,Mercatorstraat 36,2023-09-04,02:00:00,23,8,15,FMN 02 Mercatorstraat
650,Mercatorstraat 36,2023-09-04,03:00:00,23,9,14,FMN 02 Mercatorstraat
650,Mercatorstraat 36,2023-09-04,04:00:00,32,21,11,FMN 02 Mercatorstraat
650,Mercatorstraat 36,2023-09-04,05:00:00,49,28,21,FMN 02 Mercatorstraat
650,Mercatorstraat 36,2023-09-04,06:00:00,147,93,54,FMN 02 Mercatorstraat
650,Mercatorstraat 36,2023-09-04,07:00:00,525,326,199,FMN 02 Mercatorstraat
650,Mercatorstraat 36,2023-09-04,08:00:00,1202,886,316,FMN 02 Mercatorstraat
650,Mercatorstraat 36,2023-09-04,09:00:00,489,374,115,FMN 02 Mercatorstraat
650,Mercatorstraat 36,2023-09-04,10:00:00,311,207,104,FMN 02 Mercatorstraat
650,Mercatorstraat 36,2023-09-04,11:00:00,337,187,150,FMN 02 Mercatorstraat
650,Mercatorstraat 36,2023-09-04,12:00:00,382,177,205,FMN 02 Mercatorstraat
650,Mercatorstraat 36,2023-09-04,13:00:00,460,226,234,FMN 02 Mercatorstraat
650,Mercatorstraat 36,2023-09-04,14:00:00,476,238,238,FMN 02 Mercatorstraat
650,Mercatorstraat 36,2023-09-04,15:00:00,556,190,366,FMN 02 Mercatorstraat
650,Mercatorstraat 36,2023-09-04,16:00:00,810,256,554,FMN 02 Mercatorstraat
650,Mercatorstraat 36,2023-09-04,17:00:00,911,301,610,FMN 02 Mercatorstraat
650,Mercatorstraat 36,2023-09-04,18:00:00,636,212,424,FMN 02 Mercatorstraat
650,Mercatorstraat 36,2023-09-04,19:00:00,343,154,189,FMN 02 Mercatorstraat
650,Mercatorstraat 36,2023-09-04,20:00:00,276,124,152,FMN 02 Mercatorstraat
650,Mercatorstraat 36,2023-09-04,21:00:00,274,112,162,FMN 02 Mercatorstraat
650,Mercatorstraat 36,2023-09-04,22:00:00,206,80,126,FMN 02 Mercatorstraat
650,Mercatorstraat 36,2023-09-04,23:00:00,101,33,68,FMN 02 Mercatorstraat
650,Mercatorstraat 36,2023-09-05,00:00:00,55,26,29,FMN 02 Mercatorstraat
650,Mercatorstraat 36,2023-09-05,01:00:00,28,7,21,FMN 02 Mercatorstraat
650,Mercatorstraat 36,2023-09-05,02:00:00,20,11,9,FMN 02 Mercatorstraat
650,Mercatorstraat 36,2023-09-05,03:00:00,29,11,18,FMN 02 Mercatorstraat
650,Mercatorstraat 36,2023-09-05,04:00:00,51,25,26,FMN 02 Mercatorstraat
650,Mercatorstraat 36,2023-09-05,05:00:00,58,30,28,FMN 02 Mercatorstraat
650,Mercatorstraat 36,2023-09-05,06:00:00,171,112,59,FMN 02 Mercatorstraat
650,Mercatorstraat 36,2023-09-05,07:00:00,558,369,189,FMN 02 Mercatorstraat
650,Mercatorstraat 36,2023-09-05,08:00:00,1268,943,325,FMN 02 Mercatorstraat
650,Mercatorstraat 36,2023-09-05,09:00:00,464,345,119,FMN 02 Mercatorstraat
650,Mercatorstraat 36,2023-09-05,10:00:00,301,183,118,FMN 02 Mercatorstraat
650,Mercatorstraat 36,2023-09-05,11:00:00,300,168,132,FMN 02 Mercatorstraat
650,Mercatorstraat 36,2023-09-05,12:00:00,393,213,180,FMN 02 Mercatorstraat
650,Mercatorstraat 36,2023-09-05,13:00:00,425,199,226,FMN 02 Mercatorstraat
650,Mercatorstraat 36,2023-09-05,14:00:00,402,172,230,FMN 02 Mercatorstraat
650,Mercatorstraat 36,2023-09-05,15:00:00,576,191,385,FMN 02 Mercatorstraat
650,Mercatorstraat 36,2023-09-05,16:00:00,887,268,619,FMN 02 Mercatorstraat
650,Mercatorstraat 36,2023-09-05,17:00:00,1003,343,660,FMN 02 Mercatorstraat
650,Mercatorstraat 36,2023-09-05,18:00:00,681,262,419,FMN 02 Mercatorstraat
650,Mercatorstraat 36,2023-09-05,19:00:00,475,185,290,FMN 02 Mercatorstraat
650,Mercatorstraat 36,2023-09-05,20:00:00,315,144,171,FMN 02 Mercatorstraat
650,Mercatorstraat 36,2023-09-05,21:00:00,355,155,200,FMN 02 Mercatorstraat
650,Mercatorstraat 36,2023-09-05,22:00:00,258,87,171,FMN 02 Mercatorstraat
650,Mercatorstraat 36,2023-09-05,23:00:00,154,58,96,FMN 02 Mercatorstraat
650,Mercatorstraat 36,2023-09-06,00:00:00,87,39,48,FMN 02 Mercatorstraat
650,Mercatorstraat 36,2023-09-06,01:00:00,37,9,28,FMN 02 Mercatorstraat
650,Mercatorstraat 36,2023-09-06,02:00:00,27,10,17,FMN 02 Mercatorstraat
650,Mercatorstraat 36,2023-09-06,03:00:00,29,12,17,FMN 02 Mercatorstraat
650,Mercatorstraat 36,2023-09-06,04:00:00,41,27,14,FMN 02 Mercatorstraat
650,Mercatorstraat 36,2023-09-06,05:00:00,72,39,33,FMN 02 Mercatorstraat
650,Mercatorstraat 36,2023-09-06,06:00:00,167,108,59,FMN 02 Mercatorstraat
650,Mercatorstraat 36,2023-09-06,07:00:00,473,296,177,FMN 02 Mercatorstraat
650,Mercatorstraat 36,2023-09-06,08:00:00,1063,758,305,FMN 02 Mercatorstraat
650,Mercatorstraat 36,2023-09-06,09:00:00,453,315,138,FMN 02 Mercatorstraat
650,Mercatorstraat 36,2023-09-06,10:00:00,319,204,115,FMN 02 Mercatorstraat
650,Mercatorstraat 36,2023-09-06,11:00:00,323,156,167,FMN 02 Mercatorstraat
650,Mercatorstraat 36,2023-09-06,12:00:00,672,272,400,FMN 02 Mercatorstraat
650,Mercatorstraat 36,2023-09-06,13:00:00,539,246,293,FMN 02 Mercatorstraat
650,Mercatorstraat 36,2023-09-06,14:00:00,489,255,234,FMN 02 Mercatorstraat
650,Mercatorstraat 36,2023-09-06,15:00:00,473,209,264,FMN 02 Mercatorstraat
650,Mercatorstraat 36,2023-09-06,16:00:00,653,244,409,FMN 02 Mercatorstraat
650,Mercatorstraat 36,2023-09-06,17:00:00,822,283,539,FMN 02 Mercatorstraat
650,Mercatorstraat 36,2023-09-06,18:00:00,642,279,363,FMN 02 Mercatorstraat
650,Mercatorstraat 36,2023-09-06,19:00:00,423,210,213,FMN 02 Mercatorstraat
650,Mercatorstraat 36,2023-09-06,20:00:00,373,184,189,FMN 02 Mercatorstraat
650,Mercatorstraat 36,2023-09-06,21:00:00,335,140,195,FMN 02 Mercatorstraat
650,Mercatorstraat 36,2023-09-06,22:00:00,228,74,154,FMN 02 Mercatorstraat
650,Mercatorstraat 36,2023-09-06,23:00:00,148,47,101,FMN 02 Mercatorstraat
650,Mercatorstraat 36,2023-09-07,00:00:00,89,40,49,FMN 02 Mercatorstraat
650,Mercatorstraat 36,2023-09-07,01:00:00,47,17,30,FMN 02 Mercatorstraat
650,Mercatorstraat 36,2023-09-07,02:00:00,38,12,26,FMN 02 Mercatorstraat
650,Mercatorstraat 36,2023-09-07,03:00:00,28,10,18,FMN 02 Mercatorstraat
650,Mercatorstraat 36,2023-09-07,04:00:00,39,18,21,FMN 02 Mercatorstraat
650,Mercatorstraat 36,2023-09-07,05:00:00,77,35,42,FMN 02 Mercatorstraat
650,Mercatorstraat 36,2023-09-07,06:00:00,169,107,62,FMN 02 Mercatorstraat
650,Mercatorstraat 36,2023-09-07,07:00:00,559,347,212,FMN 02 Mercatorstraat
650,Mercatorstraat 36,2023-09-07,08:00:00,1174,852,322,FMN 02 Mercatorstraat
650,Mercatorstraat 36,2023-09-07,09:00:00,510,390,120,FMN 02 Mercatorstraat
650,Mercatorstraat 36,2023-09-07,10:00:00,326,213,113,FMN 02 Mercatorstraat
650,Mercatorstraat 36,2023-09-07,11:00:00,380,223,157,FMN 02 Mercatorstraat
650,Mercatorstraat 36,2023-09-07,12:00:00,439,213,226,FMN 02 Mercatorstraat
650,Mercatorstraat 36,2023-09-07,13:00:00,470,221,249,FMN 02 Mercatorstraat
650,Mercatorstraat 36,2023-09-07,14:00:00,422,191,231,FMN 02 Mercatorstraat
650,Mercatorstraat 36,2023-09-07,15:00:00,587,192,395,FMN 02 Mercatorstraat
650,Mercatorstraat 36,2023-09-07,16:00:00,814,262,552,FMN 02 Mercatorstraat
650,Mercatorstraat 36,2023-09-07,17:00:00,943,326,617,FMN 02 Mercatorstraat
650,Mercatorstraat 36,2023-09-07,18:00:00,743,263,480,FMN 02 Mercatorstraat
650,Mercatorstraat 36,2023-09-07,19:00:00,472,223,249,FMN 02 Mercatorstraat
650,Mercatorstraat 36,2023-09-07,20:00:00,333,159,174,FMN 02 Mercatorstraat
650,Mercatorstraat 36,2023-09-07,21:00:00,331,155,176,FMN 02 Mercatorstraat
650,Mercatorstraat 36,2023-09-07,22:00:00,281,97,184,FMN 02 Mercatorstraat
650,Mercatorstraat 36,2023-09-07,23:00:00,186,69,117,FMN 02 Mercatorstraat
650,Mercatorstraat 36,2023-09-08,00:00:00,113,44,69,FMN 02 Mercatorstraat
650,Mercatorstraat 36,2023-09-08,01:00:00,47,20,27,FMN 02 Mercatorstraat
650,Mercatorstraat 36,2023-09-08,02:00:00,36,14,22,FMN 02 Mercatorstraat
650,Mercatorstraat 36,2023-09-08,03:00:00,36,8,28,FMN 02 Mercatorstraat
650,Mercatorstraat 36,2023-09-08,04:00:00,54,29,25,FMN 02 Mercatorstraat
650,Mercatorstraat 36,2023-09-08,05:00:00,69,36,33,FMN 02 Mercatorstraat
650,Mercatorstraat 36,2023-09-08,06:00:00,151,92,59,FMN 02 Mercatorstraat
650,Mercatorstraat 36,2023-09-08,07:00:00,459,274,185,FMN 02 Mercatorstraat
650,Mercatorstraat 36,2023-09-08,08:00:00,989,699,290,FMN 02 Mercatorstraat
650,Mercatorstraat 36,2023-09-08,09:00:00,440,328,112,FMN 02 Mercatorstraat
650,Mercatorstraat 36,2023-09-08,10:00:00,298,200,98,FMN 02 Mercatorstraat
650,Mercatorstraat 36,2023-09-08,11:00:00,348,193,155,FMN 02 Mercatorstraat
650,Mercatorstraat 36,2023-09-08,12:00:00,482,239,243,FMN 02 Mercatorstraat
650,Mercatorstraat 36,2023-09-08,13:00:00,444,216,228,FMN 02 Mercatorstraat
650,Mercatorstraat 36,2023-09-08,14:00:00,425,183,242,FMN 02 Mercatorstraat
650,Mercatorstraat 36,2023-09-08,15:00:00,663,231,432,FMN 02 Mercatorstraat
650,Mercatorstraat 36,2023-09-08,16:00:00,736,248,488,FMN 02 Mercatorstraat
650,Mercatorstraat 36,2023-09-08,17:00:00,684,287,397,FMN 02 Mercatorstraat
650,Mercatorstraat 36,2023-09-08,18:00:00,585,262,323,FMN 02 Mercatorstraat
650,Mercatorstraat 36,2023-09-08,19:00:00,448,230,218,FMN 02 Mercatorstraat
650,Mercatorstraat 36,2023-09-08,20:00:00,292,156,136,FMN 02 Mercatorstraat
650,Mercatorstraat 36,2023-09-08,21:00:00,305,140,165,FMN 02 Mercatorstraat
650,Mercatorstraat 36,2023-09-08,22:00:00,276,96,180,FMN 02 Mercatorstraat
650,Mercatorstraat 36,2023-09-08,23:00:00,262,88,174,FMN 02 Mercatorstraat
650,Mercatorstraat 36,2023-09-09,00:00:00,196,62,134,FMN 02 Mercatorstraat
650,Mercatorstraat 36,2023-09-09,01:00:00,132,45,87,FMN 02 Mercatorstraat
650,Mercatorstraat 36,2023-09-09,02:00:00,108,39,69,FMN 02 Mercatorstraat
650,Mercatorstraat 36,2023-09-09,03:00:00,75,33,42,FMN 02 Mercatorstraat
650,Mercatorstraat 36,2023-09-09,04:00:00,62,15,47,FMN 02 Mercatorstraat
650,Mercatorstraat 36,2023-09-09,05:00:00,56,21,35,FMN 02 Mercatorstraat
650,Mercatorstraat 36,2023-09-09,06:00:00,58,27,31,FMN 02 Mercatorstraat
650,Mercatorstraat 36,2023-09-09,07:00:00,69,33,36,FMN 02 Mercatorstraat
650,Mercatorstraat 36,2023-09-09,08:00:00,139,87,52,FMN 02 Mercatorstraat
650,Mercatorstraat 36,2023-09-09,09:00:00,273,204,69,FMN 02 Mercatorstraat
650,Mercatorstraat 36,2023-09-09,10:00:00,336,238,98,FMN 02 Mercatorstraat
650,Mercatorstraat 36,2023-09-09,11:00:00,385,220,165,FMN 02 Mercatorstraat
650,Mercatorstraat 36,2023-09-09,12:00:00,356,180,176,FMN 02 Mercatorstraat
650,Mercatorstraat 36,2023-09-09,13:00:00,447,243,204,FMN 02 Mercatorstraat
650,Mercatorstraat 36,2023-09-09,14:00:00,410,218,192,FMN 02 Mercatorstraat
650,Mercatorstraat 36,2023-09-09,15:00:00,431,192,239,FMN 02 Mercatorstraat
650,Mercatorstraat 36,2023-09-09,16:00:00,372,195,177,FMN 02 Mercatorstraat
650,Mercatorstraat 36,2023-09-09,17:00:00,368,152,216,FMN 02 Mercatorstraat
650,Mercatorstraat 36,2023-09-09,18:00:00,389,180,209,FMN 02 Mercatorstraat
650,Mercatorstraat 36,2023-09-09,19:00:00,287,152,135,FMN 02 Mercatorstraat
650,Mercatorstraat 36,2023-09-09,20:00:00,250,113,137,FMN 02 Mercatorstraat
650,Mercatorstraat 36,2023-09-09,21:00:00,255,110,145,FMN 02 Mercatorstraat
650,Mercatorstraat 36,2023-09-09,22:00:00,234,97,137,FMN 02 Mercatorstraat
650,Mercatorstraat 36,2023-09-09,23:00:00,254,80,174,FMN 02 Mercatorstraat
650,Mercatorstraat 36,2023-09-10,00:00:00,214,84,130,FMN 02 Mercatorstraat
650,Mercatorstraat 36,2023-09-10,01:00:00,150,61,89,FMN 02 Mercatorstraat
650,Mercatorstraat 36,2023-09-10,02:00:00,111,45,66,FMN 02 Mercatorstraat
650,Mercatorstraat 36,2023-09-10,03:00:00,81,35,46,FMN 02 Mercatorstraat
650,Mercatorstraat 36,2023-09-10,04:00:00,88,36,52,FMN 02 Mercatorstraat
650,Mercatorstraat 36,2023-09-10,05:00:00,62,28,34,FMN 02 Mercatorstraat
650,Mercatorstraat 36,2023-09-10,06:00:00,78,23,55,FMN 02 Mercatorstraat
650,Mercatorstraat 36,2023-09-10,07:00:00,60,33,27,FMN 02 Mercatorstraat
650,Mercatorstraat 36,2023-09-10,08:00:00,132,75,57,FMN 02 Mercatorstraat
650,Mercatorstraat 36,2023-09-10,09:00:00,330,161,169,FMN 02 Mercatorstraat
650,Mercatorstraat 36,2023-09-10,10:00:00,340,202,138,FMN 02 Mercatorstraat
650,Mercatorstraat 36,2023-09-10,11:00:00,341,198,143,FMN 02 Mercatorstraat
650,Mercatorstraat 36,2023-09-10,12:00:00,399,200,199,FMN 02 Mercatorstraat
650,Mercatorstraat 36,2023-09-10,13:00:00,450,260,190,FMN 02 Mercatorstraat
650,Mercatorstraat 36,2023-09-10,14:00:00,399,233,166,FMN 02 Mercatorstraat
650,Mercatorstraat 36,2023-09-10,15:00:00,452,209,243,FMN 02 Mercatorstraat
650,Mercatorstraat 36,2023-09-10,16:00:00,368,162,206,FMN 02 Mercatorstraat
650,Mercatorstraat 36,2023-09-10,17:00:00,442,186,256,FMN 02 Mercatorstraat
650,Mercatorstraat 36,2023-09-10,18:00:00,368,151,217,FMN 02 Mercatorstraat
650,Mercatorstraat 36,2023-09-10,19:00:00,353,165,188,FMN 02 Mercatorstraat
650,Mercatorstraat 36,2023-09-10,20:00:00,290,131,159,FMN 02 Mercatorstraat
650,Mercatorstraat 36,2023-09-10,21:00:00,220,108,112,FMN 02 Mercatorstraat
650,Mercatorstraat 36,2023-09-10,22:00:00,184,70,114,FMN 02 Mercatorstraat
650,Mercatorstraat 36,2023-09-10,23:00:00,91,34,57,FMN 02 Mercatorstraat
650,Mercatorstraat 36,2023-09-11,00:00:00,58,13,45,FMN 02 Mercatorstraat
650,Mercatorstraat 36,2023-09-11,01:00:00,24,7,17,FMN 02 Mercatorstraat
650,Mercatorstraat 36,2023-09-11,02:00:00,14,3,11,FMN 02 Mercatorstraat
650,Mercatorstraat 36,2023-09-11,03:00:00,22,10,12,FMN 02 Mercatorstraat
650,Mercatorstraat 36,2023-09-11,04:00:00,33,21,12,FMN 02 Mercatorstraat
650,Mercatorstraat 36,2023-09-11,05:00:00,71,33,38,FMN 02 Mercatorstraat
650,Mercatorstraat 36,2023-09-11,06:00:00,161,95,66,FMN 02 Mercatorstraat
650,Mercatorstraat 36,2023-09-11,07:00:00,489,312,177,FMN 02 Mercatorstraat
650,Mercatorstraat 36,2023-09-11,08:00:00,1167,820,347,FMN 02 Mercatorstraat
650,Mercatorstraat 36,2023-09-11,09:00:00,451,339,112,FMN 02 Mercatorstraat
650,Mercatorstraat 36,2023-09-11,10:00:00,279,179,100,FMN 02 Mercatorstraat
650,Mercatorstraat 36,2023-09-11,11:00:00,275,163,112,FMN 02 Mercatorstraat
650,Mercatorstraat 36,2023-09-11,12:00:00,326,170,156,FMN 02 Mercatorstraat
650,Mercatorstraat 36,2023-09-11,13:00:00,401,185,216,FMN 02 Mercatorstraat
650,Mercatorstraat 36,2023-09-11,14:00:00,358,184,174,FMN 02 Mercatorstraat
650,Mercatorstraat 36,2023-09-11,15:00:00,573,183,390,FMN 02 Mercatorstraat
650,Mercatorstraat 36,2023-09-11,16:00:00,818,250,568,FMN 02 Mercatorstraat
650,Mercatorstraat 36,2023-09-11,17:00:00,882,292,590,FMN 02 Mercatorstraat
650,Mercatorstraat 36,2023-09-11,18:00:00,606,218,388,FMN 02 Mercatorstraat
650,Mercatorstraat 36,2023-09-11,19:00:00,360,170,190,FMN 02 Mercatorstraat
650,Mercatorstraat 36,2023-09-11,20:00:00,283,110,173,FMN 02 Mercatorstraat
650,Mercatorstraat 36,2023-09-11,21:00:00,254,97,157,FMN 02 Mercatorstraat
650,Mercatorstraat 36,2023-09-11,22:00:00,208,85,123,FMN 02 Mercatorstraat
650,Mercatorstraat 36,2023-09-11,23:00:00,81,26,55,FMN 02 Mercatorstraat
650,Mercatorstraat 36,2023-09-12,00:00:00,29,6,23,FMN 02 Mercatorstraat
650,Mercatorstraat 36,2023-09-12,01:00:00,29,13,16,FMN 02 Mercatorstraat
650,Mercatorstraat 36,2023-09-12,02:00:00,15,3,12,FMN 02 Mercatorstraat
650,Mercatorstraat 36,2023-09-12,03:00:00,14,8,6,FMN 02 Mercatorstraat
650,Mercatorstraat 36,2023-09-12,04:00:00,33,22,11,FMN 02 Mercatorstraat
650,Mercatorstraat 36,2023-09-12,05:00:00,58,32,26,FMN 02 Mercatorstraat
650,Mercatorstraat 36,2023-09-12,06:00:00,166,95,71,FMN 02 Mercatorstraat
650,Mercatorstraat 36,2023-09-12,07:00:00,460,303,157,FMN 02 Mercatorstraat
650,Mercatorstraat 36,2023-09-12,08:00:00,1150,799,351,FMN 02 Mercatorstraat
650,Mercatorstraat 36,2023-09-12,09:00:00,471,360,111,FMN 02 Mercatorstraat
650,Mercatorstraat 36,2023-09-12,10:00:00,274,194,80,FMN 02 Mercatorstraat
650,Mercatorstraat 36,2023-09-12,11:00:00,265,149,116,FMN 02 Mercatorstraat
650,Mercatorstraat 36,2023-09-12,12:00:00,393,203,190,FMN 02 Mercatorstraat
650,Mercatorstraat 36,2023-09-12,13:00:00,419,181,238,FMN 02 Mercatorstraat
650,Mercatorstraat 36,2023-09-12,14:00:00,331,142,189,FMN 02 Mercatorstraat
650,Mercatorstraat 36,2023-09-12,15:00:00,561,191,370,FMN 02 Mercatorstraat
650,Mercatorstraat 36,2023-09-12,16:00:00,798,255,543,FMN 02 Mercatorstraat
650,Mercatorstraat 36,2023-09-12,17:00:00,933,342,591,FMN 02 Mercatorstraat
650,Mercatorstraat 36,2023-09-12,18:00:00,592,236,356,FMN 02 Mercatorstraat
650,Mercatorstraat 36,2023-09-12,19:00:00,386,165,221,FMN 02 Mercatorstraat
650,Mercatorstraat 36,2023-09-12,20:00:00,270,121,149,FMN 02 Mercatorstraat
650,Mercatorstraat 36,2023-09-12,21:00:00,278,121,157,FMN 02 Mercatorstraat
650,Mercatorstraat 36,2023-09-12,22:00:00,196,77,119,FMN 02 Mercatorstraat
650,Mercatorstraat 36,2023-09-12,23:00:00,124,38,86,FMN 02 Mercatorstraat
650,Mercatorstraat 36,2023-09-13,00:00:00,44,21,23,FMN 02 Mercatorstraat
650,Mercatorstraat 36,2023-09-13,01:00:00,32,10,22,FMN 02 Mercatorstraat
650,Mercatorstraat 36,2023-09-13,02:00:00,24,8,16,FMN 02 Mercatorstraat
650,Mercatorstraat 36,2023-09-13,03:00:00,19,12,7,FMN 02 Mercatorstraat
650,Mercatorstraat 36,2023-09-13,04:00:00,20,14,6,FMN 02 Mercatorstraat
650,Mercatorstraat 36,2023-09-13,05:00:00,68,35,33,FMN 02 Mercatorstraat
650,Mercatorstraat 36,2023-09-13,06:00:00,156,92,64,FMN 02 Mercatorstraat
650,Mercatorstraat 36,2023-09-13,07:00:00,426,280,146,FMN 02 Mercatorstraat
650,Mercatorstraat 36,2023-09-13,08:00:00,1011,693,318,FMN 02 Mercatorstraat
650,Mercatorstraat 36,2023-09-13,09:00:00,405,307,98,FMN 02 Mercatorstraat
650,Mercatorstraat 36,2023-09-13,10:00:00,256,164,92,FMN 02 Mercatorstraat
650,Mercatorstraat 36,2023-09-13,11:00:00,316,159,157,FMN 02 Mercatorstraat
650,Mercatorstraat 36,2023-09-13,12:00:00,581,213,368,FMN 02 Mercatorstraat
650,Mercatorstraat 36,2023-09-13,13:00:00,478,218,260,FMN 02 Mercatorstraat
650,Mercatorstraat 36,2023-09-13,14:00:00,420,211,209,FMN 02 Mercatorstraat
650,Mercatorstraat 36,2023-09-13,15:00:00,436,185,251,FMN 02 Mercatorstraat
650,Mercatorstraat 36,2023-09-13,16:00:00,593,225,368,FMN 02 Mercatorstraat
650,Mercatorstraat 36,2023-09-13,17:00:00,820,296,524,FMN 02 Mercatorstraat
650,Mercatorstraat 36,2023-09-13,18:00:00,627,237,390,FMN 02 Mercatorstraat
650,Mercatorstraat 36,2023-09-13,19:00:00,451,252,199,FMN 02 Mercatorstraat
650,Mercatorstraat 36,2023-09-13,20:00:00,246,114,132,FMN 02 Mercatorstraat
650,Mercatorstraat 36,2023-09-13,21:00:00,298,106,192,FMN 02 Mercatorstraat
650,Mercatorstraat 36,2023-09-13,22:00:00,233,88,145,FMN 02 Mercatorstraat
650,Mercatorstraat 36,2023-09-13,23:00:00,148,54,94,FMN 02 Mercatorstraat
650,Mercatorstraat 36,2023-09-14,00:00:00,76,24,52,FMN 02 Mercatorstraat
650,Mercatorstraat 36,2023-09-14,01:00:00,37,11,26,FMN 02 Mercatorstraat
650,Mercatorstraat 36,2023-09-14,02:00:00,30,3,27,FMN 02 Mercatorstraat
650,Mercatorstraat 36,2023-09-14,03:00:00,20,8,12,FMN 02 Mercatorstraat
650,Mercatorstraat 36,2023-09-14,04:00:00,31,16,15,FMN 02 Mercatorstraat
650,Mercatorstraat 36,2023-09-14,05:00:00,70,38,32,FMN 02 Mercatorstraat
650,Mercatorstraat 36,2023-09-14,06:00:00,180,112,68,FMN 02 Mercatorstraat
650,Mercatorstraat 36,2023-09-14,07:00:00,478,308,170,FMN 02 Mercatorstraat
650,Mercatorstraat 36,2023-09-14,08:00:00,1205,838,367,FMN 02 Mercatorstraat
650,Mercatorstraat 36,2023-09-14,09:00:00,449,330,119,FMN 02 Mercatorstraat
650,Mercatorstraat 36,2023-09-14,10:00:00,281,194,87,FMN 02 Mercatorstraat
650,Mercatorstraat 36,2023-09-14,11:00:00,294,176,118,FMN 02 Mercatorstraat
650,Mercatorstraat 36,2023-09-14,12:00:00,425,234,191,FMN 02 Mercatorstraat
650,Mercatorstraat 36,2023-09-14,13:00:00,417,200,217,FMN 02 Mercatorstraat
650,Mercatorstraat 36,2023-09-14,14:00:00,402,200,202,FMN 02 Mercatorstraat
650,Mercatorstraat 36,2023-09-14,15:00:00,607,217,390,FMN 02 Mercatorstraat
650,Mercatorstraat 36,2023-09-14,16:00:00,842,251,591,FMN 02 Mercatorstraat
650,Mercatorstraat 36,2023-09-14,17:00:00,895,342,553,FMN 02 Mercatorstraat
650,Mercatorstraat 36,2023-09-14,18:00:00,648,241,407,FMN 02 Mercatorstraat
650,Mercatorstraat 36,2023-09-14,19:00:00,486,236,250,FMN 02 Mercatorstraat
650,Mercatorstraat 36,2023-09-14,20:00:00,328,139,189,FMN 02 Mercatorstraat
650,Mercatorstraat 36,2023-09-14,21:00:00,311,120,191,FMN 02 Mercatorstraat
650,Mercatorstraat 36,2023-09-14,22:00:00,268,87,181,FMN 02 Mercatorstraat
650,Mercatorstraat 36,2023-09-14,23:00:00,155,61,94,FMN 02 Mercatorstraat
650,Mercatorstraat 36,2023-09-15,00:00:00,84,29,55,FMN 02 Mercatorstraat
650,Mercatorstraat 36,2023-09-15,01:00:00,52,19,33,FMN 02 Mercatorstraat
650,Mercatorstraat 36,2023-09-15,02:00:00,26,8,18,FMN 02 Mercatorstraat
650,Mercatorstraat 36,2023-09-15,03:00:00,23,9,14,FMN 02 Mercatorstraat
650,Mercatorstraat 36,2023-09-15,04:00:00,37,20,17,FMN 02 Mercatorstraat
650,Mercatorstraat 36,2023-09-15,05:00:00,74,35,39,FMN 02 Mercatorstraat
650,Mercatorstraat 36,2023-09-15,06:00:00,141,94,47,FMN 02 Mercatorstraat
650,Mercatorstraat 36,2023-09-15,07:00:00,377,260,117,FMN 02 Mercatorstraat
650,Mercatorstraat 36,2023-09-15,08:00:00,883,655,228,FMN 02 Mercatorstraat
650,Mercatorstraat 36,2023-09-15,09:00:00,468,339,129,FMN 02 Mercatorstraat
650,Mercatorstraat 36,2023-09-15,10:00:00,313,208,105,FMN 02 Mercatorstraat
650,Mercatorstraat 36,2023-09-15,11:00:00,350,182,168,FMN 02 Mercatorstraat
650,Mercatorstraat 36,2023-09-15,12:00:00,430,209,221,FMN 02 Mercatorstraat
650,Mercatorstraat 36,2023-09-15,13:00:00,407,203,204,FMN 02 Mercatorstraat
650,Mercatorstraat 36,2023-09-15,14:00:00,458,222,236,FMN 02 Mercatorstraat
650,Mercatorstraat 36,2023-09-15,15:00:00,616,220,396,FMN 02 Mercatorstraat
650,Mercatorstraat 36,2023-09-15,16:00:00,779,259,520,FMN 02 Mercatorstraat
650,Mercatorstraat 36,2023-09-15,17:00:00,710,263,447,FMN 02 Mercatorstraat
650,Mercatorstraat 36,2023-09-15,18:00:00,631,293,338,FMN 02 Mercatorstraat
650,Mercatorstraat 36,2023-09-15,19:00:00,479,252,227,FMN 02 Mercatorstraat
650,Mercatorstraat 36,2023-09-15,20:00:00,306,158,148,FMN 02 Mercatorstraat
650,Mercatorstraat 36,2023-09-15,21:00:00,278,131,147,FMN 02 Mercatorstraat
650,Mercatorstraat 36,2023-09-15,22:00:00,296,108,188,FMN 02 Mercatorstraat
650,Mercatorstraat 36,2023-09-15,23:00:00,245,102,143,FMN 02 Mercatorstraat
650,Mercatorstraat 36,2023-09-16,00:00:00,143,71,72,FMN 02 Mercatorstraat
650,Mercatorstraat 36,2023-09-16,01:00:00,153,57,96,FMN 02 Mercatorstraat
650,Mercatorstraat 36,2023-09-16,02:00:00,71,23,48,FMN 02 Mercatorstraat
650,Mercatorstraat 36,2023-09-16,03:00:00,58,23,35,FMN 02 Mercatorstraat
650,Mercatorstraat 36,2023-09-16,04:00:00,52,16,36,FMN 02 Mercatorstraat
650,Mercatorstraat 36,2023-09-16,05:00:00,58,32,26,FMN 02 Mercatorstraat
650,Mercatorstraat 36,2023-09-16,06:00:00,70,27,43,FMN 02 Mercatorstraat
650,Mercatorstraat 36,2023-09-16,07:00:00,68,37,31,FMN 02 Mercatorstraat
650,Mercatorstraat 36,2023-09-16,08:00:00,160,98,62,FMN 02 Mercatorstraat
650,Mercatorstraat 36,2023-09-16,09:00:00,289,216,73,FMN 02 Mercatorstraat
650,Mercatorstraat 36,2023-09-16,10:00:00,379,267,112,FMN 02 Mercatorstraat
650,Mercatorstraat 36,2023-09-16,11:00:00,350,196,154,FMN 02 Mercatorstraat
650,Mercatorstraat 36,2023-09-16,12:00:00,471,246,225,FMN 02 Mercatorstraat
650,Mercatorstraat 36,2023-09-16,13:00:00,458,274,184,FMN 02 Mercatorstraat
650,Mercatorstraat 36,2023-09-16,14:00:00,474,256,218,FMN 02 Mercatorstraat
650,Mercatorstraat 36,2023-09-16,15:00:00,462,255,207,FMN 02 Mercatorstraat
650,Mercatorstraat 36,2023-09-16,16:00:00,424,191,233,FMN 02 Mercatorstraat
650,Mercatorstraat 36,2023-09-16,17:00:00,541,224,317,FMN 02 Mercatorstraat
650,Mercatorstraat 36,2023-09-16,18:00:00,485,240,245,FMN 02 Mercatorstraat
650,Mercatorstraat 36,2023-09-16,19:00:00,336,188,148,FMN 02 Mercatorstraat
650,Mercatorstraat 36,2023-09-16,20:00:00,256,125,131,FMN 02 Mercatorstraat
650,Mercatorstraat 36,2023-09-16,21:00:00,194,85,109,FMN 02 Mercatorstraat
650,Mercatorstraat 36,2023-09-16,22:00:00,222,83,139,FMN 02 Mercatorstraat
650,Mercatorstraat 36,2023-09-16,23:00:00,206,80,126,FMN 02 Mercatorstraat
650,Mercatorstraat 36,2023-09-17,00:00:00,123,54,69,FMN 02 Mercatorstraat
650,Mercatorstraat 36,2023-09-17,01:00:00,89,39,50,FMN 02 Mercatorstraat
650,Mercatorstraat 36,2023-09-17,02:00:00,87,31,56,FMN 02 Mercatorstraat
650,Mercatorstraat 36,2023-09-17,03:00:00,80,19,61,FMN 02 Mercatorstraat
650,Mercatorstraat 36,2023-09-17,04:00:00,42,16,26,FMN 02 Mercatorstraat
650,Mercatorstraat 36,2023-09-17,05:00:00,51,15,36,FMN 02 Mercatorstraat
650,Mercatorstraat 36,2023-09-17,06:00:00,42,20,22,FMN 02 Mercatorstraat
650,Mercatorstraat 36,2023-09-17,07:00:00,68,30,38,FMN 02 Mercatorstraat
650,Mercatorstraat 36,2023-09-17,08:00:00,125,80,45,FMN 02 Mercatorstraat
650,Mercatorstraat 36,2023-09-17,09:00:00,193,128,65,FMN 02 Mercatorstraat
650,Mercatorstraat 36,2023-09-17,10:00:00,308,218,90,FMN 02 Mercatorstraat
650,Mercatorstraat 36,2023-09-17,11:00:00,319,222,97,FMN 02 Mercatorstraat
650,Mercatorstraat 36,2023-09-17,12:00:00,438,271,167,FMN 02 Mercatorstraat
650,Mercatorstraat 36,2023-09-17,13:00:00,495,315,180,FMN 02 Mercatorstraat
650,Mercatorstraat 36,2023-09-17,14:00:00,576,407,169,FMN 02 Mercatorstraat
650,Mercatorstraat 36,2023-09-17,15:00:00,484,277,207,FMN 02 Mercatorstraat
650,Mercatorstraat 36,2023-09-17,16:00:00,523,234,289,FMN 02 Mercatorstraat
650,Mercatorstraat 36,2023-09-17,17:00:00,529,194,335,FMN 02 Mercatorstraat
650,Mercatorstraat 36,2023-09-17,18:00:00,434,171,263,FMN 02 Mercatorstraat
650,Mercatorstraat 36,2023-09-17,19:00:00,295,138,157,FMN 02 Mercatorstraat
650,Mercatorstraat 36,2023-09-17,20:00:00,257,117,140,FMN 02 Mercatorstraat
650,Mercatorstraat 36,2023-09-17,21:00:00,218,103,115,FMN 02 Mercatorstraat
650,Mercatorstraat 36,2023-09-17,22:00:00,144,59,85,FMN 02 Mercatorstraat
650,Mercatorstraat 36,2023-09-17,23:00:00,77,33,44,FMN 02 Mercatorstraat
650,Mercatorstraat 36,2023-09-18,00:00:00,39,12,27,FMN 02 Mercatorstraat
650,Mercatorstraat 36,2023-09-18,01:00:00,28,11,17,FMN 02 Mercatorstraat
650,Mercatorstraat 36,2023-09-18,02:00:00,34,15,19,FMN 02 Mercatorstraat
650,Mercatorstraat 36,2023-09-18,03:00:00,8,6,2,FMN 02 Mercatorstraat
650,Mercatorstraat 36,2023-09-18,04:00:00,29,20,9,FMN 02 Mercatorstraat
650,Mercatorstraat 36,2023-09-18,05:00:00,55,33,22,FMN 02 Mercatorstraat
650,Mercatorstraat 36,2023-09-18,06:00:00,128,90,38,FMN 02 Mercatorstraat
650,Mercatorstraat 36,2023-09-18,07:00:00,446,302,144,FMN 02 Mercatorstraat
650,Mercatorstraat 36,2023-09-18,08:00:00,1045,761,284,FMN 02 Mercatorstraat
650,Mercatorstraat 36,2023-09-18,09:00:00,450,330,120,FMN 02 Mercatorstraat
650,Mercatorstraat 36,2023-09-18,10:00:00,327,151,176,FMN 02 Mercatorstraat
650,Mercatorstraat 36,2023-09-18,11:00:00,266,149,117,FMN 02 Mercatorstraat
650,Mercatorstraat 36,2023-09-18,12:00:00,381,161,220,FMN 02 Mercatorstraat
650,Mercatorstraat 36,2023-09-18,13:00:00,321,160,161,FMN 02 Mercatorstraat
650,Mercatorstraat 36,2023-09-18,14:00:00,340,152,188,FMN 02 Mercatorstraat
650,Mercatorstraat 36,2023-09-18,15:00:00,515,174,341,FMN 02 Mercatorstraat
650,Mercatorstraat 36,2023-09-18,16:00:00,617,181,436,FMN 02 Mercatorstraat
650,Mercatorstraat 36,2023-09-18,17:00:00,865,282,583,FMN 02 Mercatorstraat
650,Mercatorstraat 36,2023-09-18,18:00:00,565,207,358,FMN 02 Mercatorstraat
650,Mercatorstraat 36,2023-09-18,19:00:00,338,155,183,FMN 02 Mercatorstraat
650,Mercatorstraat 36,2023-09-18,20:00:00,242,84,158,FMN 02 Mercatorstraat
650,Mercatorstraat 36,2023-09-18,21:00:00,219,79,140,FMN 02 Mercatorstraat
650,Mercatorstraat 36,2023-09-18,22:00:00,162,64,98,FMN 02 Mercatorstraat
650,Mercatorstraat 36,2023-09-18,23:00:00,85,28,57,FMN 02 Mercatorstraat
650,Mercatorstraat 36,2023-09-19,00:00:00,44,23,21,FMN 02 Mercatorstraat
650,Mercatorstraat 36,2023-09-19,01:00:00,38,12,26,FMN 02 Mercatorstraat
650,Mercatorstraat 36,2023-09-19,02:00:00,25,5,20,FMN 02 Mercatorstraat
650,Mercatorstraat 36,2023-09-19,03:00:00,11,4,7,FMN 02 Mercatorstraat
650,Mercatorstraat 36,2023-09-19,04:00:00,44,24,20,FMN 02 Mercatorstraat
650,Mercatorstraat 36,2023-09-19,05:00:00,59,32,27,FMN 02 Mercatorstraat
650,Mercatorstraat 36,2023-09-19,06:00:00,168,90,78,FMN 02 Mercatorstraat
650,Mercatorstraat 36,2023-09-19,07:00:00,498,329,169,FMN 02 Mercatorstraat
650,Mercatorstraat 36,2023-09-19,08:00:00,1183,823,360,FMN 02 Mercatorstraat
650,Mercatorstraat 36,2023-09-19,09:00:00,453,348,105,FMN 02 Mercatorstraat
650,Mercatorstraat 36,2023-09-19,10:00:00,289,184,105,FMN 02 Mercatorstraat
650,Mercatorstraat 36,2023-09-19,11:00:00,268,159,109,FMN 02 Mercatorstraat
650,Mercatorstraat 36,2023-09-19,12:00:00,365,190,175,FMN 02 Mercatorstraat
650,Mercatorstraat 36,2023-09-19,13:00:00,376,166,210,FMN 02 Mercatorstraat
650,Mercatorstraat 36,2023-09-19,14:00:00,326,141,185,FMN 02 Mercatorstraat
650,Mercatorstraat 36,2023-09-19,15:00:00,516,191,325,FMN 02 Mercatorstraat
650,Mercatorstraat 36,2023-09-19,16:00:00,822,252,570,FMN 02 Mercatorstraat
650,Mercatorstraat 36,2023-09-19,17:00:00,1004,351,653,FMN 02 Mercatorstraat
650,Mercatorstraat 36,2023-09-19,18:00:00,637,237,400,FMN 02 Mercatorstraat
650,Mercatorstraat 36,2023-09-19,19:00:00,329,154,175,FMN 02 Mercatorstraat
650,Mercatorstraat 36,2023-09-19,20:00:00,272,116,156,FMN 02 Mercatorstraat
650,Mercatorstraat 36,2023-09-19,21:00:00,214,76,138,FMN 02 Mercatorstraat
650,Mercatorstraat 36,2023-09-19,22:00:00,221,82,139,FMN 02 Mercatorstraat
650,Mercatorstraat 36,2023-09-19,23:00:00,161,52,109,FMN 02 Mercatorstraat
650,Mercatorstraat 36,2023-09-20,00:00:00,83,36,47,FMN 02 Mercatorstraat
650,Mercatorstraat 36,2023-09-20,01:00:00,50,21,29,FMN 02 Mercatorstraat
650,Mercatorstraat 36,2023-09-20,02:00:00,24,11,13,FMN 02 Mercatorstraat
650,Mercatorstraat 36,2023-09-20,03:00:00,34,12,22,FMN 02 Mercatorstraat
650,Mercatorstraat 36,2023-09-20,04:00:00,30,20,10,FMN 02 Mercatorstraat
650,Mercatorstraat 36,2023-09-20,05:00:00,61,36,25,FMN 02 Mercatorstraat
650,Mercatorstraat 36,2023-09-20,06:00:00,151,96,55,FMN 02 Mercatorstraat
650,Mercatorstraat 36,2023-09-20,07:00:00,455,289,166,FMN 02 Mercatorstraat
650,Mercatorstraat 36,2023-09-20,08:00:00,1025,708,317,FMN 02 Mercatorstraat
650,Mercatorstraat 36,2023-09-20,09:00:00,432,323,109,FMN 02 Mercatorstraat
650,Mercatorstraat 36,2023-09-20,10:00:00,269,180,89,FMN 02 Mercatorstraat
650,Mercatorstraat 36,2023-09-20,11:00:00,296,147,149,FMN 02 Mercatorstraat
650,Mercatorstraat 36,2023-09-20,12:00:00,612,233,379,FMN 02 Mercatorstraat
650,Mercatorstraat 36,2023-09-20,13:00:00,517,241,276,FMN 02 Mercatorstraat
650,Mercatorstraat 36,2023-09-20,14:00:00,425,198,227,FMN 02 Mercatorstraat
650,Mercatorstraat 36,2023-09-20,15:00:00,420,184,236,FMN 02 Mercatorstraat
650,Mercatorstraat 36,2023-09-20,16:00:00,616,223,393,FMN 02 Mercatorstraat
650,Mercatorstraat 36,2023-09-20,17:00:00,800,272,528,FMN 02 Mercatorstraat
650,Mercatorstraat 36,2023-09-20,18:00:00,614,264,350,FMN 02 Mercatorstraat
650,Mercatorstraat 36,2023-09-20,19:00:00,363,187,176,FMN 02 Mercatorstraat
650,Mercatorstraat 36,2023-09-20,20:00:00,306,123,183,FMN 02 Mercatorstraat
650,Mercatorstraat 36,2023-09-20,21:00:00,277,118,159,FMN 02 Mercatorstraat
650,Mercatorstraat 36,2023-09-20,22:00:00,267,105,162,FMN 02 Mercatorstraat
650,Mercatorstraat 36,2023-09-20,23:00:00,124,48,76,FMN 02 Mercatorstraat
650,Mercatorstraat 36,2023-09-21,00:00:00,81,21,60,FMN 02 Mercatorstraat
650,Mercatorstraat 36,2023-09-21,01:00:00,22,4,18,FMN 02 Mercatorstraat
650,Mercatorstraat 36,2023-09-21,02:00:00,25,9,16,FMN 02 Mercatorstraat
650,Mercatorstraat 36,2023-09-21,03:00:00,22,5,17,FMN 02 Mercatorstraat
650,Mercatorstraat 36,2023-09-21,04:00:00,40,30,10,FMN 02 Mercatorstraat
650,Mercatorstraat 36,2023-09-21,05:00:00,45,25,20,FMN 02 Mercatorstraat
650,Mercatorstraat 36,2023-09-21,06:00:00,126,64,62,FMN 02 Mercatorstraat
650,Mercatorstraat 36,2023-09-21,07:00:00,365,237,128,FMN 02 Mercatorstraat
650,Mercatorstraat 36,2023-09-21,08:00:00,919,645,274,FMN 02 Mercatorstraat
650,Mercatorstraat 36,2023-09-21,09:00:00,366,264,102,FMN 02 Mercatorstraat
650,Mercatorstraat 36,2023-09-21,10:00:00,161,104,57,FMN 02 Mercatorstraat
650,Mercatorstraat 36,2023-09-21,11:00:00,148,85,63,FMN 02 Mercatorstraat
650,Mercatorstraat 36,2023-09-21,12:00:00,246,128,118,FMN 02 Mercatorstraat
650,Mercatorstraat 36,2023-09-21,13:00:00,312,130,182,FMN 02 Mercatorstraat
650,Mercatorstraat 36,2023-09-21,14:00:00,233,114,119,FMN 02 Mercatorstraat
650,Mercatorstraat 36,2023-09-21,15:00:00,349,113,236,FMN 02 Mercatorstraat
650,Mercatorstraat 36,2023-09-21,16:00:00,562,160,402,FMN 02 Mercatorstraat
650,Mercatorstraat 36,2023-09-21,17:00:00,671,250,421,FMN 02 Mercatorstraat
650,Mercatorstraat 36,2023-09-21,18:00:00,546,229,317,FMN 02 Mercatorstraat
650,Mercatorstraat 36,2023-09-21,19:00:00,342,182,160,FMN 02 Mercatorstraat
650,Mercatorstraat 36,2023-09-21,20:00:00,227,98,129,FMN 02 Mercatorstraat
650,Mercatorstraat 36,2023-09-21,21:00:00,199,77,122,FMN 02 Mercatorstraat
650,Mercatorstraat 36,2023-09-21,22:00:00,222,94,128,FMN 02 Mercatorstraat
650,Mercatorstraat 36,2023-09-21,23:00:00,148,47,101,FMN 02 Mercatorstraat
650,Mercatorstraat 36,2023-09-22,00:00:00,63,23,40,FMN 02 Mercatorstraat
650,Mercatorstraat 36,2023-09-22,01:00:00,46,19,27,FMN 02 Mercatorstraat
650,Mercatorstraat 36,2023-09-22,02:00:00,26,3,23,FMN 02 Mercatorstraat
650,Mercatorstraat 36,2023-09-22,03:00:00,26,8,18,FMN 02 Mercatorstraat
650,Mercatorstraat 36,2023-09-22,04:00:00,35,17,18,FMN 02 Mercatorstraat
650,Mercatorstraat 36,2023-09-22,05:00:00,63,31,32,FMN 02 Mercatorstraat
650,Mercatorstraat 36,2023-09-22,06:00:00,142,84,58,FMN 02 Mercatorstraat
650,Mercatorstraat 36,2023-09-22,07:00:00,406,260,146,FMN 02 Mercatorstraat
650,Mercatorstraat 36,2023-09-22,08:00:00,924,641,283,FMN 02 Mercatorstraat
650,Mercatorstraat 36,2023-09-22,09:00:00,439,322,117,FMN 02 Mercatorstraat
650,Mercatorstraat 36,2023-09-22,10:00:00,301,179,122,FMN 02 Mercatorstraat
650,Mercatorstraat 36,2023-09-22,11:00:00,275,159,116,FMN 02 Mercatorstraat
650,Mercatorstraat 36,2023-09-22,12:00:00,433,201,232,FMN 02 Mercatorstraat
650,Mercatorstraat 36,2023-09-22,13:00:00,431,183,248,FMN 02 Mercatorstraat
650,Mercatorstraat 36,2023-09-22,14:00:00,360,161,199,FMN 02 Mercatorstraat
650,Mercatorstraat 36,2023-09-22,15:00:00,550,189,361,FMN 02 Mercatorstraat
650,Mercatorstraat 36,2023-09-22,16:00:00,693,226,467,FMN 02 Mercatorstraat
650,Mercatorstraat 36,2023-09-22,17:00:00,577,193,384,FMN 02 Mercatorstraat
650,Mercatorstraat 36,2023-09-22,18:00:00,449,183,266,FMN 02 Mercatorstraat
650,Mercatorstraat 36,2023-09-22,19:00:00,346,174,172,FMN 02 Mercatorstraat
650,Mercatorstraat 36,2023-09-22,20:00:00,200,97,103,FMN 02 Mercatorstraat
650,Mercatorstraat 36,2023-09-22,21:00:00,229,120,109,FMN 02 Mercatorstraat
650,Mercatorstraat 36,2023-09-22,22:00:00,174,81,93,FMN 02 Mercatorstraat
650,Mercatorstraat 36,2023-09-22,23:00:00,168,72,96,FMN 02 Mercatorstraat
650,Mercatorstraat 36,2023-09-23,00:00:00,169,72,97,FMN 02 Mercatorstraat
650,Mercatorstraat 36,2023-09-23,01:00:00,158,87,71,FMN 02 Mercatorstraat
650,Mercatorstraat 36,2023-09-23,02:00:00,74,22,52,FMN 02 Mercatorstraat
650,Mercatorstraat 36,2023-09-23,03:00:00,87,12,75,FMN 02 Mercatorstraat
650,Mercatorstraat 36,2023-09-23,04:00:00,61,16,45,FMN 02 Mercatorstraat
650,Mercatorstraat 36,2023-09-23,05:00:00,64,28,36,FMN 02 Mercatorstraat
650,Mercatorstraat 36,2023-09-23,06:00:00,54,24,30,FMN 02 Mercatorstraat
650,Mercatorstraat 36,2023-09-23,07:00:00,71,31,40,FMN 02 Mercatorstraat
650,Mercatorstraat 36,2023-09-23,08:00:00,125,70,55,FMN 02 Mercatorstraat
650,Mercatorstraat 36,2023-09-23,09:00:00,280,201,79,FMN 02 Mercatorstraat
650,Mercatorstraat 36,2023-09-23,10:00:00,315,214,101,FMN 02 Mercatorstraat
650,Mercatorstraat 36,2023-09-23,11:00:00,322,193,129,FMN 02 Mercatorstraat
650,Mercatorstraat 36,2023-09-23,12:00:00,416,231,185,FMN 02 Mercatorstraat
650,Mercatorstraat 36,2023-09-23,13:00:00,410,237,173,FMN 02 Mercatorstraat
650,Mercatorstraat 36,2023-09-23,14:00:00,437,254,183,FMN 02 Mercatorstraat
650,Mercatorstraat 36,2023-09-23,15:00:00,415,217,198,FMN 02 Mercatorstraat
650,Mercatorstraat 36,2023-09-23,16:00:00,438,200,238,FMN 02 Mercatorstraat
650,Mercatorstraat 36,2023-09-23,17:00:00,384,146,238,FMN 02 Mercatorstraat
650,Mercatorstraat 36,2023-09-23,18:00:00,410,178,232,FMN 02 Mercatorstraat
650,Mercatorstraat 36,2023-09-23,19:00:00,292,169,123,FMN 02 Mercatorstraat
650,Mercatorstraat 36,2023-09-23,20:00:00,272,143,129,FMN 02 Mercatorstraat
650,Mercatorstraat 36,2023-09-23,21:00:00,236,103,133,FMN 02 Mercatorstraat
650,Mercatorstraat 36,2023-09-23,22:00:00,195,84,111,FMN 02 Mercatorstraat
650,Mercatorstraat 36,2023-09-23,23:00:00,204,68,136,FMN 02 Mercatorstraat
650,Mercatorstraat 36,2023-09-24,00:00:00,160,61,99,FMN 02 Mercatorstraat
650,Mercatorstraat 36,2023-09-24,01:00:00,127,70,57,FMN 02 Mercatorstraat
650,Mercatorstraat 36,2023-09-24,02:00:00,87,33,54,FMN 02 Mercatorstraat
650,Mercatorstraat 36,2023-09-24,03:00:00,81,16,65,FMN 02 Mercatorstraat
650,Mercatorstraat 36,2023-09-24,04:00:00,59,19,40,FMN 02 Mercatorstraat
650,Mercatorstraat 36,2023-09-24,05:00:00,64,25,39,FMN 02 Mercatorstraat
650,Mercatorstraat 36,2023-09-24,06:00:00,60,28,32,FMN 02 Mercatorstraat
650,Mercatorstraat 36,2023-09-24,07:00:00,62,31,31,FMN 02 Mercatorstraat
650,Mercatorstraat 36,2023-09-24,08:00:00,135,83,52,FMN 02 Mercatorstraat
650,Mercatorstraat 36,2023-09-24,09:00:00,215,130,85,FMN 02 Mercatorstraat
650,Mercatorstraat 36,2023-09-24,10:00:00,277,166,111,FMN 02 Mercatorstraat
650,Mercatorstraat 36,2023-09-24,11:00:00,335,198,137,FMN 02 Mercatorstraat
650,Mercatorstraat 36,2023-09-24,12:00:00,362,195,167,FMN 02 Mercatorstraat
650,Mercatorstraat 36,2023-09-24,13:00:00,443,275,168,FMN 02 Mercatorstraat
650,Mercatorstraat 36,2023-09-24,14:00:00,459,268,191,FMN 02 Mercatorstraat
650,Mercatorstraat 36,2023-09-24,15:00:00,476,251,225,FMN 02 Mercatorstraat
650,Mercatorstraat 36,2023-09-24,16:00:00,480,223,257,FMN 02 Mercatorstraat
650,Mercatorstraat 36,2023-09-24,17:00:00,449,194,255,FMN 02 Mercatorstraat
650,Mercatorstraat 36,2023-09-24,18:00:00,393,162,231,FMN 02 Mercatorstraat
650,Mercatorstraat 36,2023-09-24,19:00:00,306,130,176,FMN 02 Mercatorstraat
650,Mercatorstraat 36,2023-09-24,20:00:00,259,118,141,FMN 02 Mercatorstraat
650,Mercatorstraat 36,2023-09-24,21:00:00,206,84,122,FMN 02 Mercatorstraat
650,Mercatorstraat 36,2023-09-24,22:00:00,153,89,64,FMN 02 Mercatorstraat
650,Mercatorstraat 36,2023-09-24,23:00:00,81,33,48,FMN 02 Mercatorstraat
650,Mercatorstraat 36,2023-09-25,00:00:00,34,15,19,FMN 02 Mercatorstraat
650,Mercatorstraat 36,2023-09-25,01:00:00,21,9,12,FMN 02 Mercatorstraat
650,Mercatorstraat 36,2023-09-25,02:00:00,26,6,20,FMN 02 Mercatorstraat
650,Mercatorstraat 36,2023-09-25,03:00:00,13,8,5,FMN 02 Mercatorstraat
650,Mercatorstraat 36,2023-09-25,04:00:00,30,18,12,FMN 02 Mercatorstraat
650,Mercatorstraat 36,2023-09-25,05:00:00,50,25,25,FMN 02 Mercatorstraat
650,Mercatorstraat 36,2023-09-25,06:00:00,130,92,38,FMN 02 Mercatorstraat
650,Mercatorstraat 36,2023-09-25,07:00:00,432,295,137,FMN 02 Mercatorstraat
650,Mercatorstraat 36,2023-09-25,08:00:00,1065,794,271,FMN 02 Mercatorstraat
650,Mercatorstraat 36,2023-09-25,09:00:00,495,399,96,FMN 02 Mercatorstraat
650,Mercatorstraat 36,2023-09-25,10:00:00,340,216,124,FMN 02 Mercatorstraat
650,Mercatorstraat 36,2023-09-25,11:00:00,320,191,129,FMN 02 Mercatorstraat
650,Mercatorstraat 36,2023-09-25,12:00:00,438,225,213,FMN 02 Mercatorstraat
650,Mercatorstraat 36,2023-09-25,13:00:00,436,234,202,FMN 02 Mercatorstraat
650,Mercatorstraat 36,2023-09-25,14:00:00,489,248,241,FMN 02 Mercatorstraat
650,Mercatorstraat 36,2023-09-25,15:00:00,611,253,358,FMN 02 Mercatorstraat
650,Mercatorstraat 36,2023-09-25,16:00:00,819,274,545,FMN 02 Mercatorstraat
650,Mercatorstraat 36,2023-09-25,17:00:00,931,333,598,FMN 02 Mercatorstraat
650,Mercatorstraat 36,2023-09-25,18:00:00,626,221,405,FMN 02 Mercatorstraat
650,Mercatorstraat 36,2023-09-25,19:00:00,372,148,224,FMN 02 Mercatorstraat
650,Mercatorstraat 36,2023-09-25,20:00:00,285,106,179,FMN 02 Mercatorstraat
650,Mercatorstraat 36,2023-09-25,21:00:00,287,85,202,FMN 02 Mercatorstraat
650,Mercatorstraat 36,2023-09-25,22:00:00,219,85,134,FMN 02 Mercatorstraat
650,Mercatorstraat 36,2023-09-25,23:00:00,122,32,90,FMN 02 Mercatorstraat
650,Mercatorstraat 36,2023-09-26,00:00:00,71,27,44,FMN 02 Mercatorstraat
650,Mercatorstraat 36,2023-09-26,01:00:00,36,8,28,FMN 02 Mercatorstraat
650,Mercatorstraat 36,2023-09-26,02:00:00,39,3,36,FMN 02 Mercatorstraat
650,Mercatorstraat 36,2023-09-26,03:00:00,24,11,13,FMN 02 Mercatorstraat
650,Mercatorstraat 36,2023-09-26,04:00:00,37,18,19,FMN 02 Mercatorstraat
650,Mercatorstraat 36,2023-09-26,05:00:00,67,38,29,FMN 02 Mercatorstraat
650,Mercatorstraat 36,2023-09-26,06:00:00,152,106,46,FMN 02 Mercatorstraat
650,Mercatorstraat 36,2023-09-26,07:00:00,498,361,137,FMN 02 Mercatorstraat
650,Mercatorstraat 36,2023-09-26,08:00:00,1237,879,358,FMN 02 Mercatorstraat
650,Mercatorstraat 36,2023-09-26,09:00:00,591,384,207,FMN 02 Mercatorstraat
650,Mercatorstraat 36,2023-09-26,10:00:00,321,223,98,FMN 02 Mercatorstraat
650,Mercatorstraat 36,2023-09-26,11:00:00,303,164,139,FMN 02 Mercatorstraat
650,Mercatorstraat 36,2023-09-26,12:00:00,493,276,217,FMN 02 Mercatorstraat
650,Mercatorstraat 36,2023-09-26,13:00:00,460,235,225,FMN 02 Mercatorstraat
650,Mercatorstraat 36,2023-09-26,14:00:00,384,171,213,FMN 02 Mercatorstraat
650,Mercatorstraat 36,2023-09-26,15:00:00,593,192,401,FMN 02 Mercatorstraat
650,Mercatorstraat 36,2023-09-26,16:00:00,915,300,615,FMN 02 Mercatorstraat
650,Mercatorstraat 36,2023-09-26,17:00:00,993,308,685,FMN 02 Mercatorstraat
650,Mercatorstraat 36,2023-09-26,18:00:00,785,299,486,FMN 02 Mercatorstraat
650,Mercatorstraat 36,2023-09-26,19:00:00,409,164,245,FMN 02 Mercatorstraat
650,Mercatorstraat 36,2023-09-26,20:00:00,297,129,168,FMN 02 Mercatorstraat
650,Mercatorstraat 36,2023-09-26,21:00:00,281,113,168,FMN 02 Mercatorstraat
650,Mercatorstraat 36,2023-09-26,22:00:00,305,125,180,FMN 02 Mercatorstraat
650,Mercatorstraat 36,2023-09-26,23:00:00,132,62,70,FMN 02 Mercatorstraat
650,Mercatorstraat 36,2023-09-27,00:00:00,49,17,32,FMN 02 Mercatorstraat
650,Mercatorstraat 36,2023-09-27,01:00:00,26,5,21,FMN 02 Mercatorstraat
650,Mercatorstraat 36,2023-09-27,02:00:00,19,5,14,FMN 02 Mercatorstraat
650,Mercatorstraat 36,2023-09-27,03:00:00,21,11,10,FMN 02 Mercatorstraat
650,Mercatorstraat 36,2023-09-27,04:00:00,28,18,10,FMN 02 Mercatorstraat
650,Mercatorstraat 36,2023-09-27,05:00:00,187,100,87,FMN 02 Mercatorstraat
650,Mercatorstraat 36,2023-09-27,06:00:00,188,117,71,FMN 02 Mercatorstraat
650,Mercatorstraat 36,2023-09-27,07:00:00,466,293,173,FMN 02 Mercatorstraat
650,Mercatorstraat 36,2023-09-27,08:00:00,1141,812,329,FMN 02 Mercatorstraat
650,Mercatorstraat 36,2023-09-27,09:00:00,460,337,123,FMN 02 Mercatorstraat
650,Mercatorstraat 36,2023-09-27,10:00:00,351,211,140,FMN 02 Mercatorstraat
650,Mercatorstraat 36,2023-09-27,11:00:00,356,184,172,FMN 02 Mercatorstraat
650,Mercatorstraat 36,2023-09-27,12:00:00,707,270,437,FMN 02 Mercatorstraat
650,Mercatorstraat 36,2023-09-27,13:00:00,584,276,308,FMN 02 Mercatorstraat
650,Mercatorstraat 36,2023-09-27,14:00:00,451,205,246,FMN 02 Mercatorstraat
650,Mercatorstraat 36,2023-09-27,15:00:00,567,266,301,FMN 02 Mercatorstraat
650,Mercatorstraat 36,2023-09-27,16:00:00,775,271,504,FMN 02 Mercatorstraat
650,Mercatorstraat 36,2023-09-27,17:00:00,881,298,583,FMN 02 Mercatorstraat
650,Mercatorstraat 36,2023-09-27,18:00:00,742,288,454,FMN 02 Mercatorstraat
650,Mercatorstraat 36,2023-09-27,19:00:00,429,195,234,FMN 02 Mercatorstraat
650,Mercatorstraat 36,2023-09-27,20:00:00,296,145,151,FMN 02 Mercatorstraat
650,Mercatorstraat 36,2023-09-27,21:00:00,294,138,156,FMN 02 Mercatorstraat
650,Mercatorstraat 36,2023-09-27,22:00:00,261,98,163,FMN 02 Mercatorstraat
650,Mercatorstraat 36,2023-09-27,23:00:00,152,65,87,FMN 02 Mercatorstraat
