Meetpunt surrogate key,Meetpunt locatie,Datum,Tijd,Aantal fietsers,Aantal fietsers van,Aantal fietsers naar,Meetpunt code
54,Posthofbrug 5366,2018-06-15,00:00:00,0,0,0,FMN GV 16 Berchem TOT
54,Posthofbrug 5366,2018-06-15,01:00:00,0,0,0,FMN GV 16 Berchem TOT
54,Posthofbrug 5366,2018-06-15,02:00:00,0,0,0,FMN GV 16 Berchem TOT
54,Posthofbrug 5366,2018-06-15,03:00:00,0,0,0,FMN GV 16 Berchem TOT
54,Posthofbrug 5366,2018-06-15,04:00:00,0,0,0,FMN GV 16 Berchem TOT
54,Posthofbrug 5366,2018-06-15,05:00:00,0,0,0,FMN GV 16 Berchem TOT
54,Posthofbrug 5366,2018-06-15,06:00:00,0,0,0,FMN GV 16 Berchem TOT
54,Posthofbrug 5366,2018-06-15,07:00:00,10,2,8,FMN GV 16 Berchem TOT
54,Posthofbrug 5366,2018-06-15,08:00:00,41,5,36,FMN GV 16 Berchem TOT
54,Posthofbrug 5366,2018-06-15,09:00:00,0,0,0,FMN GV 16 Berchem TOT
54,Posthofbrug 5366,2018-06-15,10:00:00,0,0,0,FMN GV 16 Berchem TOT
54,Posthofbrug 5366,2018-06-15,11:00:00,0,0,0,FMN GV 16 Berchem TOT
54,Posthofbrug 5366,2018-06-15,12:00:00,0,0,0,FMN GV 16 Berchem TOT
54,Posthofbrug 5366,2018-06-15,13:00:00,0,0,0,FMN GV 16 Berchem TOT
54,Posthofbrug 5366,2018-06-15,14:00:00,0,0,0,FMN GV 16 Berchem TOT
54,Posthofbrug 5366,2018-06-15,15:00:00,0,0,0,FMN GV 16 Berchem TOT
54,Posthofbrug 5366,2018-06-15,16:00:00,0,0,0,FMN GV 16 Berchem TOT
54,Posthofbrug 5366,2018-06-15,17:00:00,0,0,0,FMN GV 16 Berchem TOT
54,Posthofbrug 5366,2018-06-15,18:00:00,0,0,0,FMN GV 16 Berchem TOT
54,Posthofbrug 5366,2018-06-15,19:00:00,0,0,0,FMN GV 16 Berchem TOT
54,Posthofbrug 5366,2018-06-15,20:00:00,0,0,0,FMN GV 16 Berchem TOT
54,Posthofbrug 5366,2018-06-15,21:00:00,0,0,0,FMN GV 16 Berchem TOT
54,Posthofbrug 5366,2018-06-15,22:00:00,0,0,0,FMN GV 16 Berchem TOT
54,Posthofbrug 5366,2018-06-15,23:00:00,0,0,0,FMN GV 16 Berchem TOT
54,Posthofbrug 5366,2018-07-06,00:00:00,24,5,19,FMN GV 16 Berchem TOT
54,Posthofbrug 5366,2018-07-06,01:00:00,13,2,11,FMN GV 16 Berchem TOT
54,Posthofbrug 5366,2018-07-06,02:00:00,3,2,1,FMN GV 16 Berchem TOT
54,Posthofbrug 5366,2018-07-06,03:00:00,1,0,1,FMN GV 16 Berchem TOT
54,Posthofbrug 5366,2018-07-06,04:00:00,7,6,1,FMN GV 16 Berchem TOT
54,Posthofbrug 5366,2018-07-06,05:00:00,18,11,7,FMN GV 16 Berchem TOT
54,Posthofbrug 5366,2018-07-06,06:00:00,80,54,26,FMN GV 16 Berchem TOT
54,Posthofbrug 5366,2018-07-06,07:00:00,255,175,80,FMN GV 16 Berchem TOT
54,Posthofbrug 5366,2018-07-06,08:00:00,377,268,109,FMN GV 16 Berchem TOT
54,Posthofbrug 5366,2018-07-06,09:00:00,186,137,49,FMN GV 16 Berchem TOT
54,Posthofbrug 5366,2018-07-06,10:00:00,105,65,40,FMN GV 16 Berchem TOT
54,Posthofbrug 5366,2018-07-06,11:00:00,107,62,45,FMN GV 16 Berchem TOT
54,Posthofbrug 5366,2018-07-06,12:00:00,125,69,56,FMN GV 16 Berchem TOT
54,Posthofbrug 5366,2018-07-06,13:00:00,116,56,60,FMN GV 16 Berchem TOT
54,Posthofbrug 5366,2018-07-06,14:00:00,118,61,57,FMN GV 16 Berchem TOT
54,Posthofbrug 5366,2018-07-06,15:00:00,187,82,105,FMN GV 16 Berchem TOT
54,Posthofbrug 5366,2018-07-06,16:00:00,285,121,164,FMN GV 16 Berchem TOT
54,Posthofbrug 5366,2018-07-06,17:00:00,340,151,189,FMN GV 16 Berchem TOT
54,Posthofbrug 5366,2018-07-06,18:00:00,231,123,108,FMN GV 16 Berchem TOT
54,Posthofbrug 5366,2018-07-06,19:00:00,228,119,109,FMN GV 16 Berchem TOT
54,Posthofbrug 5366,2018-07-06,20:00:00,54,24,30,FMN GV 16 Berchem TOT
54,Posthofbrug 5366,2018-07-06,21:00:00,32,20,12,FMN GV 16 Berchem TOT
54,Posthofbrug 5366,2018-07-06,22:00:00,104,40,64,FMN GV 16 Berchem TOT
54,Posthofbrug 5366,2018-07-06,23:00:00,120,56,64,FMN GV 16 Berchem TOT
54,Posthofbrug 5366,2018-07-07,00:00:00,82,26,56,FMN GV 16 Berchem TOT
54,Posthofbrug 5366,2018-07-07,01:00:00,40,14,26,FMN GV 16 Berchem TOT
54,Posthofbrug 5366,2018-07-07,02:00:00,28,2,26,FMN GV 16 Berchem TOT
54,Posthofbrug 5366,2018-07-07,03:00:00,11,2,9,FMN GV 16 Berchem TOT
54,Posthofbrug 5366,2018-07-07,04:00:00,11,1,10,FMN GV 16 Berchem TOT
54,Posthofbrug 5366,2018-07-07,05:00:00,11,5,6,FMN GV 16 Berchem TOT
54,Posthofbrug 5366,2018-07-07,06:00:00,28,17,11,FMN GV 16 Berchem TOT
54,Posthofbrug 5366,2018-07-07,07:00:00,15,9,6,FMN GV 16 Berchem TOT
54,Posthofbrug 5366,2018-07-07,08:00:00,42,32,10,FMN GV 16 Berchem TOT
54,Posthofbrug 5366,2018-07-07,09:00:00,69,52,17,FMN GV 16 Berchem TOT
54,Posthofbrug 5366,2018-07-07,10:00:00,103,75,28,FMN GV 16 Berchem TOT
54,Posthofbrug 5366,2018-07-07,11:00:00,99,68,31,FMN GV 16 Berchem TOT
54,Posthofbrug 5366,2018-07-07,12:00:00,133,81,52,FMN GV 16 Berchem TOT
54,Posthofbrug 5366,2018-07-07,13:00:00,130,88,42,FMN GV 16 Berchem TOT
54,Posthofbrug 5366,2018-07-07,14:00:00,150,94,56,FMN GV 16 Berchem TOT
54,Posthofbrug 5366,2018-07-07,15:00:00,120,52,68,FMN GV 16 Berchem TOT
54,Posthofbrug 5366,2018-07-07,16:00:00,113,51,62,FMN GV 16 Berchem TOT
54,Posthofbrug 5366,2018-07-07,17:00:00,112,50,62,FMN GV 16 Berchem TOT
54,Posthofbrug 5366,2018-07-07,18:00:00,106,38,68,FMN GV 16 Berchem TOT
54,Posthofbrug 5366,2018-07-07,19:00:00,101,49,52,FMN GV 16 Berchem TOT
54,Posthofbrug 5366,2018-07-07,20:00:00,67,31,36,FMN GV 16 Berchem TOT
54,Posthofbrug 5366,2018-07-07,21:00:00,78,32,46,FMN GV 16 Berchem TOT
54,Posthofbrug 5366,2018-07-07,22:00:00,70,20,50,FMN GV 16 Berchem TOT
54,Posthofbrug 5366,2018-07-07,23:00:00,62,24,38,FMN GV 16 Berchem TOT
54,Posthofbrug 5366,2018-07-08,00:00:00,38,8,30,FMN GV 16 Berchem TOT
54,Posthofbrug 5366,2018-07-08,01:00:00,22,5,17,FMN GV 16 Berchem TOT
54,Posthofbrug 5366,2018-07-08,02:00:00,9,0,9,FMN GV 16 Berchem TOT
54,Posthofbrug 5366,2018-07-08,03:00:00,4,1,3,FMN GV 16 Berchem TOT
54,Posthofbrug 5366,2018-07-08,04:00:00,6,1,5,FMN GV 16 Berchem TOT
54,Posthofbrug 5366,2018-07-08,05:00:00,9,4,5,FMN GV 16 Berchem TOT
54,Posthofbrug 5366,2018-07-08,06:00:00,3,3,0,FMN GV 16 Berchem TOT
54,Posthofbrug 5366,2018-07-08,07:00:00,9,7,2,FMN GV 16 Berchem TOT
54,Posthofbrug 5366,2018-07-08,08:00:00,25,15,10,FMN GV 16 Berchem TOT
54,Posthofbrug 5366,2018-07-08,09:00:00,72,48,24,FMN GV 16 Berchem TOT
54,Posthofbrug 5366,2018-07-08,10:00:00,114,76,38,FMN GV 16 Berchem TOT
54,Posthofbrug 5366,2018-07-08,11:00:00,121,87,34,FMN GV 16 Berchem TOT
54,Posthofbrug 5366,2018-07-08,12:00:00,124,72,52,FMN GV 16 Berchem TOT
54,Posthofbrug 5366,2018-07-08,13:00:00,164,94,70,FMN GV 16 Berchem TOT
54,Posthofbrug 5366,2018-07-08,14:00:00,149,88,61,FMN GV 16 Berchem TOT
54,Posthofbrug 5366,2018-07-08,15:00:00,160,95,65,FMN GV 16 Berchem TOT
54,Posthofbrug 5366,2018-07-08,16:00:00,136,55,81,FMN GV 16 Berchem TOT
54,Posthofbrug 5366,2018-07-08,17:00:00,161,81,80,FMN GV 16 Berchem TOT
54,Posthofbrug 5366,2018-07-08,18:00:00,103,35,68,FMN GV 16 Berchem TOT
54,Posthofbrug 5366,2018-07-08,19:00:00,81,35,46,FMN GV 16 Berchem TOT
54,Posthofbrug 5366,2018-07-08,20:00:00,59,28,31,FMN GV 16 Berchem TOT
54,Posthofbrug 5366,2018-07-08,21:00:00,58,33,25,FMN GV 16 Berchem TOT
54,Posthofbrug 5366,2018-07-08,22:00:00,40,17,23,FMN GV 16 Berchem TOT
54,Posthofbrug 5366,2018-07-08,23:00:00,12,7,5,FMN GV 16 Berchem TOT
54,Posthofbrug 5366,2018-07-09,00:00:00,7,0,7,FMN GV 16 Berchem TOT
54,Posthofbrug 5366,2018-07-09,01:00:00,0,0,0,FMN GV 16 Berchem TOT
54,Posthofbrug 5366,2018-07-09,02:00:00,0,0,0,FMN GV 16 Berchem TOT
54,Posthofbrug 5366,2018-07-09,03:00:00,0,0,0,FMN GV 16 Berchem TOT
54,Posthofbrug 5366,2018-07-09,04:00:00,5,5,0,FMN GV 16 Berchem TOT
54,Posthofbrug 5366,2018-07-09,05:00:00,14,9,5,FMN GV 16 Berchem TOT
54,Posthofbrug 5366,2018-07-09,06:00:00,84,73,11,FMN GV 16 Berchem TOT
54,Posthofbrug 5366,2018-07-09,07:00:00,236,176,60,FMN GV 16 Berchem TOT
54,Posthofbrug 5366,2018-07-09,08:00:00,365,255,110,FMN GV 16 Berchem TOT
54,Posthofbrug 5366,2018-07-09,09:00:00,132,100,32,FMN GV 16 Berchem TOT
54,Posthofbrug 5366,2018-07-09,10:00:00,54,36,18,FMN GV 16 Berchem TOT
54,Posthofbrug 5366,2018-07-09,11:00:00,96,66,30,FMN GV 16 Berchem TOT
54,Posthofbrug 5366,2018-07-09,12:00:00,118,75,43,FMN GV 16 Berchem TOT
54,Posthofbrug 5366,2018-07-09,13:00:00,130,82,48,FMN GV 16 Berchem TOT
54,Posthofbrug 5366,2018-07-09,14:00:00,106,69,37,FMN GV 16 Berchem TOT
54,Posthofbrug 5366,2018-07-09,15:00:00,154,57,97,FMN GV 16 Berchem TOT
54,Posthofbrug 5366,2018-07-09,16:00:00,292,105,187,FMN GV 16 Berchem TOT
54,Posthofbrug 5366,2018-07-09,17:00:00,370,108,262,FMN GV 16 Berchem TOT
54,Posthofbrug 5366,2018-07-09,18:00:00,278,95,183,FMN GV 16 Berchem TOT
54,Posthofbrug 5366,2018-07-09,19:00:00,133,53,80,FMN GV 16 Berchem TOT
54,Posthofbrug 5366,2018-07-09,20:00:00,76,33,43,FMN GV 16 Berchem TOT
54,Posthofbrug 5366,2018-07-09,21:00:00,83,27,56,FMN GV 16 Berchem TOT
54,Posthofbrug 5366,2018-07-09,22:00:00,53,19,34,FMN GV 16 Berchem TOT
54,Posthofbrug 5366,2018-07-09,23:00:00,28,11,17,FMN GV 16 Berchem TOT
54,Posthofbrug 5366,2018-07-10,00:00:00,8,0,8,FMN GV 16 Berchem TOT
54,Posthofbrug 5366,2018-07-10,01:00:00,7,2,5,FMN GV 16 Berchem TOT
54,Posthofbrug 5366,2018-07-10,02:00:00,3,1,2,FMN GV 16 Berchem TOT
54,Posthofbrug 5366,2018-07-10,03:00:00,1,1,0,FMN GV 16 Berchem TOT
54,Posthofbrug 5366,2018-07-10,04:00:00,7,6,1,FMN GV 16 Berchem TOT
54,Posthofbrug 5366,2018-07-10,05:00:00,11,7,4,FMN GV 16 Berchem TOT
54,Posthofbrug 5366,2018-07-10,06:00:00,88,69,19,FMN GV 16 Berchem TOT
54,Posthofbrug 5366,2018-07-10,07:00:00,249,198,51,FMN GV 16 Berchem TOT
54,Posthofbrug 5366,2018-07-10,08:00:00,428,309,119,FMN GV 16 Berchem TOT
54,Posthofbrug 5366,2018-07-10,09:00:00,169,122,47,FMN GV 16 Berchem TOT
54,Posthofbrug 5366,2018-07-10,10:00:00,94,67,27,FMN GV 16 Berchem TOT
54,Posthofbrug 5366,2018-07-10,11:00:00,97,48,49,FMN GV 16 Berchem TOT
54,Posthofbrug 5366,2018-07-10,12:00:00,98,61,37,FMN GV 16 Berchem TOT
54,Posthofbrug 5366,2018-07-10,13:00:00,76,33,43,FMN GV 16 Berchem TOT
54,Posthofbrug 5366,2018-07-10,14:00:00,56,20,36,FMN GV 16 Berchem TOT
54,Posthofbrug 5366,2018-07-10,15:00:00,100,35,65,FMN GV 16 Berchem TOT
54,Posthofbrug 5366,2018-07-10,16:00:00,253,79,174,FMN GV 16 Berchem TOT
54,Posthofbrug 5366,2018-07-10,17:00:00,355,119,236,FMN GV 16 Berchem TOT
54,Posthofbrug 5366,2018-07-10,18:00:00,269,119,150,FMN GV 16 Berchem TOT
54,Posthofbrug 5366,2018-07-10,19:00:00,199,130,69,FMN GV 16 Berchem TOT
54,Posthofbrug 5366,2018-07-10,20:00:00,27,9,18,FMN GV 16 Berchem TOT
54,Posthofbrug 5366,2018-07-10,21:00:00,15,11,4,FMN GV 16 Berchem TOT
54,Posthofbrug 5366,2018-07-10,22:00:00,130,65,65,FMN GV 16 Berchem TOT
54,Posthofbrug 5366,2018-07-10,23:00:00,89,25,64,FMN GV 16 Berchem TOT
54,Posthofbrug 5366,2018-07-11,00:00:00,40,7,33,FMN GV 16 Berchem TOT
54,Posthofbrug 5366,2018-07-11,01:00:00,26,3,23,FMN GV 16 Berchem TOT
54,Posthofbrug 5366,2018-07-11,02:00:00,25,4,21,FMN GV 16 Berchem TOT
54,Posthofbrug 5366,2018-07-11,03:00:00,2,0,2,FMN GV 16 Berchem TOT
54,Posthofbrug 5366,2018-07-11,04:00:00,7,5,2,FMN GV 16 Berchem TOT
54,Posthofbrug 5366,2018-07-11,05:00:00,15,11,4,FMN GV 16 Berchem TOT
54,Posthofbrug 5366,2018-07-11,06:00:00,70,47,23,FMN GV 16 Berchem TOT
54,Posthofbrug 5366,2018-07-11,07:00:00,175,136,39,FMN GV 16 Berchem TOT
54,Posthofbrug 5366,2018-07-11,08:00:00,230,152,78,FMN GV 16 Berchem TOT
54,Posthofbrug 5366,2018-07-11,09:00:00,146,106,40,FMN GV 16 Berchem TOT
54,Posthofbrug 5366,2018-07-11,10:00:00,114,82,32,FMN GV 16 Berchem TOT
54,Posthofbrug 5366,2018-07-11,11:00:00,149,89,60,FMN GV 16 Berchem TOT
54,Posthofbrug 5366,2018-07-11,12:00:00,111,66,45,FMN GV 16 Berchem TOT
54,Posthofbrug 5366,2018-07-11,13:00:00,132,66,66,FMN GV 16 Berchem TOT
54,Posthofbrug 5366,2018-07-11,14:00:00,153,87,66,FMN GV 16 Berchem TOT
54,Posthofbrug 5366,2018-07-11,15:00:00,142,67,75,FMN GV 16 Berchem TOT
54,Posthofbrug 5366,2018-07-11,16:00:00,235,96,139,FMN GV 16 Berchem TOT
54,Posthofbrug 5366,2018-07-11,17:00:00,278,90,188,FMN GV 16 Berchem TOT
54,Posthofbrug 5366,2018-07-11,18:00:00,184,62,122,FMN GV 16 Berchem TOT
54,Posthofbrug 5366,2018-07-11,19:00:00,148,69,79,FMN GV 16 Berchem TOT
54,Posthofbrug 5366,2018-07-11,20:00:00,97,47,50,FMN GV 16 Berchem TOT
54,Posthofbrug 5366,2018-07-11,21:00:00,77,37,40,FMN GV 16 Berchem TOT
54,Posthofbrug 5366,2018-07-11,22:00:00,62,22,40,FMN GV 16 Berchem TOT
54,Posthofbrug 5366,2018-07-11,23:00:00,40,11,29,FMN GV 16 Berchem TOT
54,Posthofbrug 5366,2018-07-12,00:00:00,17,4,13,FMN GV 16 Berchem TOT
54,Posthofbrug 5366,2018-07-12,01:00:00,5,2,3,FMN GV 16 Berchem TOT
54,Posthofbrug 5366,2018-07-12,02:00:00,4,1,3,FMN GV 16 Berchem TOT
54,Posthofbrug 5366,2018-07-12,03:00:00,2,2,0,FMN GV 16 Berchem TOT
54,Posthofbrug 5366,2018-07-12,04:00:00,7,7,0,FMN GV 16 Berchem TOT
54,Posthofbrug 5366,2018-07-12,05:00:00,17,12,5,FMN GV 16 Berchem TOT
54,Posthofbrug 5366,2018-07-12,06:00:00,90,68,22,FMN GV 16 Berchem TOT
54,Posthofbrug 5366,2018-07-12,07:00:00,279,209,70,FMN GV 16 Berchem TOT
54,Posthofbrug 5366,2018-07-12,08:00:00,423,298,125,FMN GV 16 Berchem TOT
54,Posthofbrug 5366,2018-07-12,09:00:00,190,131,59,FMN GV 16 Berchem TOT
54,Posthofbrug 5366,2018-07-12,10:00:00,90,63,27,FMN GV 16 Berchem TOT
54,Posthofbrug 5366,2018-07-12,11:00:00,96,57,39,FMN GV 16 Berchem TOT
54,Posthofbrug 5366,2018-07-12,12:00:00,138,86,52,FMN GV 16 Berchem TOT
54,Posthofbrug 5366,2018-07-12,13:00:00,136,85,51,FMN GV 16 Berchem TOT
54,Posthofbrug 5366,2018-07-12,14:00:00,125,61,64,FMN GV 16 Berchem TOT
54,Posthofbrug 5366,2018-07-12,15:00:00,155,51,104,FMN GV 16 Berchem TOT
54,Posthofbrug 5366,2018-07-12,16:00:00,271,100,171,FMN GV 16 Berchem TOT
54,Posthofbrug 5366,2018-07-12,17:00:00,385,132,253,FMN GV 16 Berchem TOT
54,Posthofbrug 5366,2018-07-12,18:00:00,276,96,180,FMN GV 16 Berchem TOT
54,Posthofbrug 5366,2018-07-12,19:00:00,137,49,88,FMN GV 16 Berchem TOT
54,Posthofbrug 5366,2018-07-12,20:00:00,90,46,44,FMN GV 16 Berchem TOT
54,Posthofbrug 5366,2018-07-12,21:00:00,86,41,45,FMN GV 16 Berchem TOT
54,Posthofbrug 5366,2018-07-12,22:00:00,63,18,45,FMN GV 16 Berchem TOT
54,Posthofbrug 5366,2018-07-12,23:00:00,57,25,32,FMN GV 16 Berchem TOT
54,Posthofbrug 5366,2018-07-13,00:00:00,19,5,14,FMN GV 16 Berchem TOT
54,Posthofbrug 5366,2018-07-13,01:00:00,10,6,4,FMN GV 16 Berchem TOT
54,Posthofbrug 5366,2018-07-13,02:00:00,1,0,1,FMN GV 16 Berchem TOT
54,Posthofbrug 5366,2018-07-13,03:00:00,0,0,0,FMN GV 16 Berchem TOT
54,Posthofbrug 5366,2018-07-13,04:00:00,9,8,1,FMN GV 16 Berchem TOT
54,Posthofbrug 5366,2018-07-13,05:00:00,19,12,7,FMN GV 16 Berchem TOT
54,Posthofbrug 5366,2018-07-13,06:00:00,77,57,20,FMN GV 16 Berchem TOT
54,Posthofbrug 5366,2018-07-13,07:00:00,240,174,66,FMN GV 16 Berchem TOT
54,Posthofbrug 5366,2018-07-13,08:00:00,338,231,107,FMN GV 16 Berchem TOT
54,Posthofbrug 5366,2018-07-13,09:00:00,171,126,45,FMN GV 16 Berchem TOT
54,Posthofbrug 5366,2018-07-13,10:00:00,118,75,43,FMN GV 16 Berchem TOT
54,Posthofbrug 5366,2018-07-13,11:00:00,88,62,26,FMN GV 16 Berchem TOT
54,Posthofbrug 5366,2018-07-13,12:00:00,113,58,55,FMN GV 16 Berchem TOT
54,Posthofbrug 5366,2018-07-13,13:00:00,112,61,51,FMN GV 16 Berchem TOT
54,Posthofbrug 5366,2018-07-13,14:00:00,131,84,47,FMN GV 16 Berchem TOT
54,Posthofbrug 5366,2018-07-13,15:00:00,167,83,84,FMN GV 16 Berchem TOT
54,Posthofbrug 5366,2018-07-13,16:00:00,270,113,157,FMN GV 16 Berchem TOT
54,Posthofbrug 5366,2018-07-13,17:00:00,320,119,201,FMN GV 16 Berchem TOT
54,Posthofbrug 5366,2018-07-13,18:00:00,218,82,136,FMN GV 16 Berchem TOT
54,Posthofbrug 5366,2018-07-13,19:00:00,111,41,70,FMN GV 16 Berchem TOT
54,Posthofbrug 5366,2018-07-13,20:00:00,85,46,39,FMN GV 16 Berchem TOT
54,Posthofbrug 5366,2018-07-13,21:00:00,69,31,38,FMN GV 16 Berchem TOT
54,Posthofbrug 5366,2018-07-13,22:00:00,67,25,42,FMN GV 16 Berchem TOT
54,Posthofbrug 5366,2018-07-13,23:00:00,50,8,42,FMN GV 16 Berchem TOT
54,Posthofbrug 5366,2018-07-14,00:00:00,30,11,19,FMN GV 16 Berchem TOT
54,Posthofbrug 5366,2018-07-14,01:00:00,17,6,11,FMN GV 16 Berchem TOT
54,Posthofbrug 5366,2018-07-14,02:00:00,10,1,9,FMN GV 16 Berchem TOT
54,Posthofbrug 5366,2018-07-14,03:00:00,3,0,3,FMN GV 16 Berchem TOT
54,Posthofbrug 5366,2018-07-14,04:00:00,12,6,6,FMN GV 16 Berchem TOT
54,Posthofbrug 5366,2018-07-14,05:00:00,4,2,2,FMN GV 16 Berchem TOT
54,Posthofbrug 5366,2018-07-14,06:00:00,19,4,15,FMN GV 16 Berchem TOT
54,Posthofbrug 5366,2018-07-14,07:00:00,22,12,10,FMN GV 16 Berchem TOT
54,Posthofbrug 5366,2018-07-14,08:00:00,45,28,17,FMN GV 16 Berchem TOT
54,Posthofbrug 5366,2018-07-14,09:00:00,78,56,22,FMN GV 16 Berchem TOT
54,Posthofbrug 5366,2018-07-14,10:00:00,122,78,44,FMN GV 16 Berchem TOT
54,Posthofbrug 5366,2018-07-14,11:00:00,138,88,50,FMN GV 16 Berchem TOT
54,Posthofbrug 5366,2018-07-14,12:00:00,116,74,42,FMN GV 16 Berchem TOT
54,Posthofbrug 5366,2018-07-14,13:00:00,113,68,45,FMN GV 16 Berchem TOT
54,Posthofbrug 5366,2018-07-14,14:00:00,151,76,75,FMN GV 16 Berchem TOT
54,Posthofbrug 5366,2018-07-14,15:00:00,154,77,77,FMN GV 16 Berchem TOT
54,Posthofbrug 5366,2018-07-14,16:00:00,65,19,46,FMN GV 16 Berchem TOT
54,Posthofbrug 5366,2018-07-14,17:00:00,97,54,43,FMN GV 16 Berchem TOT
54,Posthofbrug 5366,2018-07-14,18:00:00,105,50,55,FMN GV 16 Berchem TOT
54,Posthofbrug 5366,2018-07-14,19:00:00,92,39,53,FMN GV 16 Berchem TOT
54,Posthofbrug 5366,2018-07-14,20:00:00,71,36,35,FMN GV 16 Berchem TOT
54,Posthofbrug 5366,2018-07-14,21:00:00,71,36,35,FMN GV 16 Berchem TOT
54,Posthofbrug 5366,2018-07-14,22:00:00,68,27,41,FMN GV 16 Berchem TOT
54,Posthofbrug 5366,2018-07-14,23:00:00,35,10,25,FMN GV 16 Berchem TOT
54,Posthofbrug 5366,2018-07-15,00:00:00,26,9,17,FMN GV 16 Berchem TOT
54,Posthofbrug 5366,2018-07-15,01:00:00,15,6,9,FMN GV 16 Berchem TOT
54,Posthofbrug 5366,2018-07-15,02:00:00,11,3,8,FMN GV 16 Berchem TOT
54,Posthofbrug 5366,2018-07-15,03:00:00,6,3,3,FMN GV 16 Berchem TOT
54,Posthofbrug 5366,2018-07-15,04:00:00,9,1,8,FMN GV 16 Berchem TOT
54,Posthofbrug 5366,2018-07-15,05:00:00,8,7,1,FMN GV 16 Berchem TOT
54,Posthofbrug 5366,2018-07-15,06:00:00,21,14,7,FMN GV 16 Berchem TOT
54,Posthofbrug 5366,2018-07-15,07:00:00,20,7,13,FMN GV 16 Berchem TOT
54,Posthofbrug 5366,2018-07-15,08:00:00,31,16,15,FMN GV 16 Berchem TOT
54,Posthofbrug 5366,2018-07-15,09:00:00,63,39,24,FMN GV 16 Berchem TOT
54,Posthofbrug 5366,2018-07-15,10:00:00,114,77,37,FMN GV 16 Berchem TOT
54,Posthofbrug 5366,2018-07-15,11:00:00,151,105,46,FMN GV 16 Berchem TOT
54,Posthofbrug 5366,2018-07-15,12:00:00,108,49,59,FMN GV 16 Berchem TOT
54,Posthofbrug 5366,2018-07-15,13:00:00,114,67,47,FMN GV 16 Berchem TOT
54,Posthofbrug 5366,2018-07-15,14:00:00,130,69,61,FMN GV 16 Berchem TOT
54,Posthofbrug 5366,2018-07-15,15:00:00,114,53,61,FMN GV 16 Berchem TOT
54,Posthofbrug 5366,2018-07-15,16:00:00,123,57,66,FMN GV 16 Berchem TOT
54,Posthofbrug 5366,2018-07-15,17:00:00,81,49,32,FMN GV 16 Berchem TOT
54,Posthofbrug 5366,2018-07-15,18:00:00,89,52,37,FMN GV 16 Berchem TOT
54,Posthofbrug 5366,2018-07-15,19:00:00,90,46,44,FMN GV 16 Berchem TOT
54,Posthofbrug 5366,2018-07-15,20:00:00,64,22,42,FMN GV 16 Berchem TOT
54,Posthofbrug 5366,2018-07-15,21:00:00,70,30,40,FMN GV 16 Berchem TOT
54,Posthofbrug 5366,2018-07-15,22:00:00,55,30,25,FMN GV 16 Berchem TOT
54,Posthofbrug 5366,2018-07-15,23:00:00,20,10,10,FMN GV 16 Berchem TOT
54,Posthofbrug 5366,2018-07-16,00:00:00,14,2,12,FMN GV 16 Berchem TOT
54,Posthofbrug 5366,2018-07-16,01:00:00,4,1,3,FMN GV 16 Berchem TOT
54,Posthofbrug 5366,2018-07-16,02:00:00,3,2,1,FMN GV 16 Berchem TOT
54,Posthofbrug 5366,2018-07-16,03:00:00,0,0,0,FMN GV 16 Berchem TOT
54,Posthofbrug 5366,2018-07-16,04:00:00,12,9,3,FMN GV 16 Berchem TOT
54,Posthofbrug 5366,2018-07-16,05:00:00,12,10,2,FMN GV 16 Berchem TOT
54,Posthofbrug 5366,2018-07-16,06:00:00,79,56,23,FMN GV 16 Berchem TOT
54,Posthofbrug 5366,2018-07-16,07:00:00,307,245,62,FMN GV 16 Berchem TOT
54,Posthofbrug 5366,2018-07-16,08:00:00,388,270,118,FMN GV 16 Berchem TOT
54,Posthofbrug 5366,2018-07-16,09:00:00,193,126,67,FMN GV 16 Berchem TOT
54,Posthofbrug 5366,2018-07-16,10:00:00,105,65,40,FMN GV 16 Berchem TOT
54,Posthofbrug 5366,2018-07-16,11:00:00,78,49,29,FMN GV 16 Berchem TOT
54,Posthofbrug 5366,2018-07-16,12:00:00,89,63,26,FMN GV 16 Berchem TOT
54,Posthofbrug 5366,2018-07-16,13:00:00,128,87,41,FMN GV 16 Berchem TOT
54,Posthofbrug 5366,2018-07-16,14:00:00,104,57,47,FMN GV 16 Berchem TOT
54,Posthofbrug 5366,2018-07-16,15:00:00,127,49,78,FMN GV 16 Berchem TOT
54,Posthofbrug 5366,2018-07-16,16:00:00,250,100,150,FMN GV 16 Berchem TOT
54,Posthofbrug 5366,2018-07-16,17:00:00,400,122,278,FMN GV 16 Berchem TOT
54,Posthofbrug 5366,2018-07-16,18:00:00,271,75,196,FMN GV 16 Berchem TOT
54,Posthofbrug 5366,2018-07-16,19:00:00,65,18,47,FMN GV 16 Berchem TOT
54,Posthofbrug 5366,2018-07-16,20:00:00,51,18,33,FMN GV 16 Berchem TOT
54,Posthofbrug 5366,2018-07-16,21:00:00,31,10,21,FMN GV 16 Berchem TOT
54,Posthofbrug 5366,2018-07-16,22:00:00,33,16,17,FMN GV 16 Berchem TOT
54,Posthofbrug 5366,2018-07-16,23:00:00,21,4,17,FMN GV 16 Berchem TOT
54,Posthofbrug 5366,2018-07-17,00:00:00,12,4,8,FMN GV 16 Berchem TOT
54,Posthofbrug 5366,2018-07-17,01:00:00,0,0,0,FMN GV 16 Berchem TOT
54,Posthofbrug 5366,2018-07-17,02:00:00,0,0,0,FMN GV 16 Berchem TOT
54,Posthofbrug 5366,2018-07-17,03:00:00,1,1,0,FMN GV 16 Berchem TOT
54,Posthofbrug 5366,2018-07-17,04:00:00,6,5,1,FMN GV 16 Berchem TOT
54,Posthofbrug 5366,2018-07-17,05:00:00,13,11,2,FMN GV 16 Berchem TOT
54,Posthofbrug 5366,2018-07-17,06:00:00,83,64,19,FMN GV 16 Berchem TOT
54,Posthofbrug 5366,2018-07-17,07:00:00,307,225,82,FMN GV 16 Berchem TOT
54,Posthofbrug 5366,2018-07-17,08:00:00,385,266,119,FMN GV 16 Berchem TOT
54,Posthofbrug 5366,2018-07-17,09:00:00,165,111,54,FMN GV 16 Berchem TOT
54,Posthofbrug 5366,2018-07-17,10:00:00,92,61,31,FMN GV 16 Berchem TOT
54,Posthofbrug 5366,2018-07-17,11:00:00,95,53,42,FMN GV 16 Berchem TOT
54,Posthofbrug 5366,2018-07-17,12:00:00,118,75,43,FMN GV 16 Berchem TOT
54,Posthofbrug 5366,2018-07-17,13:00:00,115,66,49,FMN GV 16 Berchem TOT
54,Posthofbrug 5366,2018-07-17,14:00:00,118,57,61,FMN GV 16 Berchem TOT
54,Posthofbrug 5366,2018-07-17,15:00:00,137,55,82,FMN GV 16 Berchem TOT
54,Posthofbrug 5366,2018-07-17,16:00:00,229,94,135,FMN GV 16 Berchem TOT
54,Posthofbrug 5366,2018-07-17,17:00:00,406,140,266,FMN GV 16 Berchem TOT
54,Posthofbrug 5366,2018-07-17,18:00:00,272,86,186,FMN GV 16 Berchem TOT
54,Posthofbrug 5366,2018-07-17,19:00:00,123,47,76,FMN GV 16 Berchem TOT
54,Posthofbrug 5366,2018-07-17,20:00:00,101,51,50,FMN GV 16 Berchem TOT
54,Posthofbrug 5366,2018-07-17,21:00:00,92,45,47,FMN GV 16 Berchem TOT
54,Posthofbrug 5366,2018-07-17,22:00:00,59,20,39,FMN GV 16 Berchem TOT
54,Posthofbrug 5366,2018-07-17,23:00:00,46,13,33,FMN GV 16 Berchem TOT
54,Posthofbrug 5366,2018-07-18,00:00:00,17,3,14,FMN GV 16 Berchem TOT
54,Posthofbrug 5366,2018-07-18,01:00:00,4,0,4,FMN GV 16 Berchem TOT
54,Posthofbrug 5366,2018-07-18,02:00:00,0,0,0,FMN GV 16 Berchem TOT
54,Posthofbrug 5366,2018-07-18,03:00:00,0,0,0,FMN GV 16 Berchem TOT
54,Posthofbrug 5366,2018-07-18,04:00:00,6,4,2,FMN GV 16 Berchem TOT
54,Posthofbrug 5366,2018-07-18,05:00:00,19,13,6,FMN GV 16 Berchem TOT
54,Posthofbrug 5366,2018-07-18,06:00:00,92,68,24,FMN GV 16 Berchem TOT
54,Posthofbrug 5366,2018-07-18,07:00:00,288,215,73,FMN GV 16 Berchem TOT
54,Posthofbrug 5366,2018-07-18,08:00:00,385,253,132,FMN GV 16 Berchem TOT
54,Posthofbrug 5366,2018-07-18,09:00:00,150,106,44,FMN GV 16 Berchem TOT
54,Posthofbrug 5366,2018-07-18,10:00:00,88,66,22,FMN GV 16 Berchem TOT
54,Posthofbrug 5366,2018-07-18,11:00:00,137,89,48,FMN GV 16 Berchem TOT
54,Posthofbrug 5366,2018-07-18,12:00:00,129,75,54,FMN GV 16 Berchem TOT
54,Posthofbrug 5366,2018-07-18,13:00:00,148,87,61,FMN GV 16 Berchem TOT
54,Posthofbrug 5366,2018-07-18,14:00:00,137,69,68,FMN GV 16 Berchem TOT
54,Posthofbrug 5366,2018-07-18,15:00:00,171,67,104,FMN GV 16 Berchem TOT
54,Posthofbrug 5366,2018-07-18,16:00:00,298,124,174,FMN GV 16 Berchem TOT
54,Posthofbrug 5366,2018-07-18,17:00:00,350,126,224,FMN GV 16 Berchem TOT
54,Posthofbrug 5366,2018-07-18,18:00:00,254,79,175,FMN GV 16 Berchem TOT
54,Posthofbrug 5366,2018-07-18,19:00:00,135,76,59,FMN GV 16 Berchem TOT
54,Posthofbrug 5366,2018-07-18,20:00:00,102,46,56,FMN GV 16 Berchem TOT
54,Posthofbrug 5366,2018-07-18,21:00:00,112,53,59,FMN GV 16 Berchem TOT
54,Posthofbrug 5366,2018-07-18,22:00:00,86,24,62,FMN GV 16 Berchem TOT
54,Posthofbrug 5366,2018-07-18,23:00:00,46,23,23,FMN GV 16 Berchem TOT
54,Posthofbrug 5366,2018-07-19,00:00:00,22,5,17,FMN GV 16 Berchem TOT
54,Posthofbrug 5366,2018-07-19,01:00:00,11,3,8,FMN GV 16 Berchem TOT
54,Posthofbrug 5366,2018-07-19,02:00:00,2,0,2,FMN GV 16 Berchem TOT
54,Posthofbrug 5366,2018-07-19,03:00:00,0,0,0,FMN GV 16 Berchem TOT
54,Posthofbrug 5366,2018-07-19,04:00:00,10,6,4,FMN GV 16 Berchem TOT
54,Posthofbrug 5366,2018-07-19,05:00:00,14,11,3,FMN GV 16 Berchem TOT
54,Posthofbrug 5366,2018-07-19,06:00:00,71,56,15,FMN GV 16 Berchem TOT
54,Posthofbrug 5366,2018-07-19,07:00:00,284,206,78,FMN GV 16 Berchem TOT
54,Posthofbrug 5366,2018-07-19,08:00:00,415,281,134,FMN GV 16 Berchem TOT
54,Posthofbrug 5366,2018-07-19,09:00:00,147,109,38,FMN GV 16 Berchem TOT
54,Posthofbrug 5366,2018-07-19,10:00:00,116,86,30,FMN GV 16 Berchem TOT
54,Posthofbrug 5366,2018-07-19,11:00:00,116,78,38,FMN GV 16 Berchem TOT
54,Posthofbrug 5366,2018-07-19,12:00:00,131,76,55,FMN GV 16 Berchem TOT
54,Posthofbrug 5366,2018-07-19,13:00:00,103,61,42,FMN GV 16 Berchem TOT
54,Posthofbrug 5366,2018-07-19,14:00:00,128,67,61,FMN GV 16 Berchem TOT
54,Posthofbrug 5366,2018-07-19,15:00:00,137,49,88,FMN GV 16 Berchem TOT
54,Posthofbrug 5366,2018-07-19,16:00:00,286,107,179,FMN GV 16 Berchem TOT
54,Posthofbrug 5366,2018-07-19,17:00:00,350,125,225,FMN GV 16 Berchem TOT
54,Posthofbrug 5366,2018-07-19,18:00:00,252,72,180,FMN GV 16 Berchem TOT
54,Posthofbrug 5366,2018-07-19,19:00:00,123,50,73,FMN GV 16 Berchem TOT
54,Posthofbrug 5366,2018-07-19,20:00:00,111,56,55,FMN GV 16 Berchem TOT
54,Posthofbrug 5366,2018-07-19,21:00:00,72,33,39,FMN GV 16 Berchem TOT
54,Posthofbrug 5366,2018-07-19,22:00:00,75,27,48,FMN GV 16 Berchem TOT
54,Posthofbrug 5366,2018-07-19,23:00:00,45,14,31,FMN GV 16 Berchem TOT
54,Posthofbrug 5366,2018-07-20,00:00:00,30,8,22,FMN GV 16 Berchem TOT
54,Posthofbrug 5366,2018-07-20,01:00:00,20,5,15,FMN GV 16 Berchem TOT
54,Posthofbrug 5366,2018-07-20,02:00:00,8,2,6,FMN GV 16 Berchem TOT
54,Posthofbrug 5366,2018-07-20,03:00:00,4,1,3,FMN GV 16 Berchem TOT
54,Posthofbrug 5366,2018-07-20,04:00:00,5,4,1,FMN GV 16 Berchem TOT
54,Posthofbrug 5366,2018-07-20,05:00:00,17,13,4,FMN GV 16 Berchem TOT
54,Posthofbrug 5366,2018-07-20,06:00:00,68,49,19,FMN GV 16 Berchem TOT
54,Posthofbrug 5366,2018-07-20,07:00:00,241,174,67,FMN GV 16 Berchem TOT
54,Posthofbrug 5366,2018-07-20,08:00:00,322,214,108,FMN GV 16 Berchem TOT
54,Posthofbrug 5366,2018-07-20,09:00:00,164,119,45,FMN GV 16 Berchem TOT
54,Posthofbrug 5366,2018-07-20,10:00:00,99,67,32,FMN GV 16 Berchem TOT
54,Posthofbrug 5366,2018-07-20,11:00:00,86,57,29,FMN GV 16 Berchem TOT
54,Posthofbrug 5366,2018-07-20,12:00:00,123,74,49,FMN GV 16 Berchem TOT
54,Posthofbrug 5366,2018-07-20,13:00:00,129,64,65,FMN GV 16 Berchem TOT
54,Posthofbrug 5366,2018-07-20,14:00:00,117,67,50,FMN GV 16 Berchem TOT
54,Posthofbrug 5366,2018-07-20,15:00:00,161,55,106,FMN GV 16 Berchem TOT
54,Posthofbrug 5366,2018-07-20,16:00:00,280,112,168,FMN GV 16 Berchem TOT
54,Posthofbrug 5366,2018-07-20,17:00:00,288,107,181,FMN GV 16 Berchem TOT
54,Posthofbrug 5366,2018-07-20,18:00:00,194,73,121,FMN GV 16 Berchem TOT
54,Posthofbrug 5366,2018-07-20,19:00:00,99,57,42,FMN GV 16 Berchem TOT
54,Posthofbrug 5366,2018-07-20,20:00:00,76,39,37,FMN GV 16 Berchem TOT
54,Posthofbrug 5366,2018-07-20,21:00:00,56,31,25,FMN GV 16 Berchem TOT
54,Posthofbrug 5366,2018-07-20,22:00:00,75,22,53,FMN GV 16 Berchem TOT
54,Posthofbrug 5366,2018-07-20,23:00:00,53,17,36,FMN GV 16 Berchem TOT
54,Posthofbrug 5366,2018-07-21,00:00:00,35,9,26,FMN GV 16 Berchem TOT
54,Posthofbrug 5366,2018-07-21,01:00:00,24,7,17,FMN GV 16 Berchem TOT
54,Posthofbrug 5366,2018-07-21,02:00:00,8,1,7,FMN GV 16 Berchem TOT
54,Posthofbrug 5366,2018-07-21,03:00:00,4,3,1,FMN GV 16 Berchem TOT
54,Posthofbrug 5366,2018-07-21,04:00:00,5,4,1,FMN GV 16 Berchem TOT
54,Posthofbrug 5366,2018-07-21,05:00:00,8,4,4,FMN GV 16 Berchem TOT
54,Posthofbrug 5366,2018-07-21,06:00:00,19,12,7,FMN GV 16 Berchem TOT
54,Posthofbrug 5366,2018-07-21,07:00:00,12,9,3,FMN GV 16 Berchem TOT
54,Posthofbrug 5366,2018-07-21,08:00:00,41,31,10,FMN GV 16 Berchem TOT
54,Posthofbrug 5366,2018-07-21,09:00:00,72,45,27,FMN GV 16 Berchem TOT
54,Posthofbrug 5366,2018-07-21,10:00:00,89,58,31,FMN GV 16 Berchem TOT
54,Posthofbrug 5366,2018-07-21,11:00:00,132,79,53,FMN GV 16 Berchem TOT
54,Posthofbrug 5366,2018-07-21,12:00:00,163,89,74,FMN GV 16 Berchem TOT
54,Posthofbrug 5366,2018-07-21,13:00:00,140,82,58,FMN GV 16 Berchem TOT
54,Posthofbrug 5366,2018-07-21,14:00:00,130,77,53,FMN GV 16 Berchem TOT
54,Posthofbrug 5366,2018-07-21,15:00:00,141,81,60,FMN GV 16 Berchem TOT
54,Posthofbrug 5366,2018-07-21,16:00:00,97,52,45,FMN GV 16 Berchem TOT
54,Posthofbrug 5366,2018-07-21,17:00:00,112,59,53,FMN GV 16 Berchem TOT
54,Posthofbrug 5366,2018-07-21,18:00:00,124,74,50,FMN GV 16 Berchem TOT
54,Posthofbrug 5366,2018-07-21,19:00:00,92,53,39,FMN GV 16 Berchem TOT
54,Posthofbrug 5366,2018-07-21,20:00:00,88,40,48,FMN GV 16 Berchem TOT
54,Posthofbrug 5366,2018-07-21,21:00:00,72,29,43,FMN GV 16 Berchem TOT
54,Posthofbrug 5366,2018-07-21,22:00:00,57,18,39,FMN GV 16 Berchem TOT
54,Posthofbrug 5366,2018-07-21,23:00:00,54,11,43,FMN GV 16 Berchem TOT
54,Posthofbrug 5366,2018-07-22,00:00:00,21,7,14,FMN GV 16 Berchem TOT
54,Posthofbrug 5366,2018-07-22,01:00:00,25,11,14,FMN GV 16 Berchem TOT
54,Posthofbrug 5366,2018-07-22,02:00:00,6,0,6,FMN GV 16 Berchem TOT
54,Posthofbrug 5366,2018-07-22,03:00:00,2,0,2,FMN GV 16 Berchem TOT
54,Posthofbrug 5366,2018-07-22,04:00:00,8,3,5,FMN GV 16 Berchem TOT
54,Posthofbrug 5366,2018-07-22,05:00:00,7,3,4,FMN GV 16 Berchem TOT
54,Posthofbrug 5366,2018-07-22,06:00:00,12,7,5,FMN GV 16 Berchem TOT
54,Posthofbrug 5366,2018-07-22,07:00:00,18,13,5,FMN GV 16 Berchem TOT
54,Posthofbrug 5366,2018-07-22,08:00:00,24,11,13,FMN GV 16 Berchem TOT
54,Posthofbrug 5366,2018-07-22,09:00:00,93,66,27,FMN GV 16 Berchem TOT
54,Posthofbrug 5366,2018-07-22,10:00:00,103,79,24,FMN GV 16 Berchem TOT
54,Posthofbrug 5366,2018-07-22,11:00:00,136,88,48,FMN GV 16 Berchem TOT
54,Posthofbrug 5366,2018-07-22,12:00:00,134,72,62,FMN GV 16 Berchem TOT
54,Posthofbrug 5366,2018-07-22,13:00:00,146,100,46,FMN GV 16 Berchem TOT
54,Posthofbrug 5366,2018-07-22,14:00:00,171,97,74,FMN GV 16 Berchem TOT
54,Posthofbrug 5366,2018-07-22,15:00:00,136,72,64,FMN GV 16 Berchem TOT
54,Posthofbrug 5366,2018-07-22,16:00:00,119,62,57,FMN GV 16 Berchem TOT
54,Posthofbrug 5366,2018-07-22,17:00:00,105,38,67,FMN GV 16 Berchem TOT
54,Posthofbrug 5366,2018-07-22,18:00:00,102,49,53,FMN GV 16 Berchem TOT
54,Posthofbrug 5366,2018-07-22,19:00:00,52,30,22,FMN GV 16 Berchem TOT
54,Posthofbrug 5366,2018-07-22,20:00:00,47,27,20,FMN GV 16 Berchem TOT
54,Posthofbrug 5366,2018-07-22,21:00:00,80,35,45,FMN GV 16 Berchem TOT
54,Posthofbrug 5366,2018-07-22,22:00:00,46,17,29,FMN GV 16 Berchem TOT
54,Posthofbrug 5366,2018-07-22,23:00:00,34,11,23,FMN GV 16 Berchem TOT
54,Posthofbrug 5366,2018-07-23,00:00:00,6,1,5,FMN GV 16 Berchem TOT
54,Posthofbrug 5366,2018-07-23,01:00:00,8,3,5,FMN GV 16 Berchem TOT
54,Posthofbrug 5366,2018-07-23,02:00:00,5,1,4,FMN GV 16 Berchem TOT
54,Posthofbrug 5366,2018-07-23,03:00:00,1,1,0,FMN GV 16 Berchem TOT
54,Posthofbrug 5366,2018-07-23,04:00:00,7,5,2,FMN GV 16 Berchem TOT
54,Posthofbrug 5366,2018-07-23,05:00:00,15,10,5,FMN GV 16 Berchem TOT
54,Posthofbrug 5366,2018-07-23,06:00:00,85,62,23,FMN GV 16 Berchem TOT
54,Posthofbrug 5366,2018-07-23,07:00:00,258,196,62,FMN GV 16 Berchem TOT
54,Posthofbrug 5366,2018-07-23,08:00:00,356,237,119,FMN GV 16 Berchem TOT
54,Posthofbrug 5366,2018-07-23,09:00:00,146,98,48,FMN GV 16 Berchem TOT
54,Posthofbrug 5366,2018-07-23,10:00:00,89,66,23,FMN GV 16 Berchem TOT
54,Posthofbrug 5366,2018-07-23,11:00:00,96,71,25,FMN GV 16 Berchem TOT
54,Posthofbrug 5366,2018-07-23,12:00:00,113,82,31,FMN GV 16 Berchem TOT
54,Posthofbrug 5366,2018-07-23,13:00:00,121,55,66,FMN GV 16 Berchem TOT
54,Posthofbrug 5366,2018-07-23,14:00:00,113,64,49,FMN GV 16 Berchem TOT
54,Posthofbrug 5366,2018-07-23,15:00:00,125,45,80,FMN GV 16 Berchem TOT
54,Posthofbrug 5366,2018-07-23,16:00:00,248,97,151,FMN GV 16 Berchem TOT
54,Posthofbrug 5366,2018-07-23,17:00:00,342,102,240,FMN GV 16 Berchem TOT
54,Posthofbrug 5366,2018-07-23,18:00:00,194,63,131,FMN GV 16 Berchem TOT
54,Posthofbrug 5366,2018-07-23,19:00:00,102,46,56,FMN GV 16 Berchem TOT
54,Posthofbrug 5366,2018-07-23,20:00:00,100,45,55,FMN GV 16 Berchem TOT
54,Posthofbrug 5366,2018-07-23,21:00:00,45,23,22,FMN GV 16 Berchem TOT
54,Posthofbrug 5366,2018-07-23,22:00:00,45,17,28,FMN GV 16 Berchem TOT
54,Posthofbrug 5366,2018-07-23,23:00:00,45,14,31,FMN GV 16 Berchem TOT
54,Posthofbrug 5366,2018-07-24,00:00:00,14,5,9,FMN GV 16 Berchem TOT
54,Posthofbrug 5366,2018-07-24,01:00:00,6,2,4,FMN GV 16 Berchem TOT
54,Posthofbrug 5366,2018-07-24,02:00:00,0,0,0,FMN GV 16 Berchem TOT
54,Posthofbrug 5366,2018-07-24,03:00:00,0,0,0,FMN GV 16 Berchem TOT
54,Posthofbrug 5366,2018-07-24,04:00:00,11,7,4,FMN GV 16 Berchem TOT
54,Posthofbrug 5366,2018-07-24,05:00:00,22,14,8,FMN GV 16 Berchem TOT
54,Posthofbrug 5366,2018-07-24,06:00:00,95,71,24,FMN GV 16 Berchem TOT
54,Posthofbrug 5366,2018-07-24,07:00:00,287,222,65,FMN GV 16 Berchem TOT
54,Posthofbrug 5366,2018-07-24,08:00:00,382,276,106,FMN GV 16 Berchem TOT
54,Posthofbrug 5366,2018-07-24,09:00:00,180,123,57,FMN GV 16 Berchem TOT
54,Posthofbrug 5366,2018-07-24,10:00:00,98,73,25,FMN GV 16 Berchem TOT
54,Posthofbrug 5366,2018-07-24,11:00:00,89,49,40,FMN GV 16 Berchem TOT
54,Posthofbrug 5366,2018-07-24,12:00:00,130,75,55,FMN GV 16 Berchem TOT
54,Posthofbrug 5366,2018-07-24,13:00:00,95,43,52,FMN GV 16 Berchem TOT
54,Posthofbrug 5366,2018-07-24,14:00:00,110,58,52,FMN GV 16 Berchem TOT
54,Posthofbrug 5366,2018-07-24,15:00:00,123,49,74,FMN GV 16 Berchem TOT
54,Posthofbrug 5366,2018-07-24,16:00:00,233,103,130,FMN GV 16 Berchem TOT
54,Posthofbrug 5366,2018-07-24,17:00:00,381,127,254,FMN GV 16 Berchem TOT
54,Posthofbrug 5366,2018-07-24,18:00:00,257,77,180,FMN GV 16 Berchem TOT
54,Posthofbrug 5366,2018-07-24,19:00:00,133,57,76,FMN GV 16 Berchem TOT
54,Posthofbrug 5366,2018-07-24,20:00:00,98,44,54,FMN GV 16 Berchem TOT
54,Posthofbrug 5366,2018-07-24,21:00:00,86,39,47,FMN GV 16 Berchem TOT
54,Posthofbrug 5366,2018-07-24,22:00:00,66,24,42,FMN GV 16 Berchem TOT
54,Posthofbrug 5366,2018-07-24,23:00:00,39,23,16,FMN GV 16 Berchem TOT
54,Posthofbrug 5366,2018-07-25,00:00:00,18,6,12,FMN GV 16 Berchem TOT
54,Posthofbrug 5366,2018-07-25,01:00:00,15,5,10,FMN GV 16 Berchem TOT
54,Posthofbrug 5366,2018-07-25,02:00:00,2,0,2,FMN GV 16 Berchem TOT
54,Posthofbrug 5366,2018-07-25,03:00:00,0,0,0,FMN GV 16 Berchem TOT
54,Posthofbrug 5366,2018-07-25,04:00:00,9,7,2,FMN GV 16 Berchem TOT
54,Posthofbrug 5366,2018-07-25,05:00:00,16,10,6,FMN GV 16 Berchem TOT
54,Posthofbrug 5366,2018-07-25,06:00:00,84,60,24,FMN GV 16 Berchem TOT
54,Posthofbrug 5366,2018-07-25,07:00:00,245,192,53,FMN GV 16 Berchem TOT
54,Posthofbrug 5366,2018-07-25,08:00:00,356,231,125,FMN GV 16 Berchem TOT
54,Posthofbrug 5366,2018-07-25,09:00:00,153,100,53,FMN GV 16 Berchem TOT
54,Posthofbrug 5366,2018-07-25,10:00:00,83,59,24,FMN GV 16 Berchem TOT
54,Posthofbrug 5366,2018-07-25,11:00:00,73,43,30,FMN GV 16 Berchem TOT
54,Posthofbrug 5366,2018-07-25,12:00:00,88,60,28,FMN GV 16 Berchem TOT
54,Posthofbrug 5366,2018-07-25,13:00:00,100,45,55,FMN GV 16 Berchem TOT
54,Posthofbrug 5366,2018-07-25,14:00:00,87,45,42,FMN GV 16 Berchem TOT
54,Posthofbrug 5366,2018-07-25,15:00:00,122,51,71,FMN GV 16 Berchem TOT
54,Posthofbrug 5366,2018-07-25,16:00:00,222,100,122,FMN GV 16 Berchem TOT
54,Posthofbrug 5366,2018-07-25,17:00:00,298,90,208,FMN GV 16 Berchem TOT
54,Posthofbrug 5366,2018-07-25,18:00:00,216,75,141,FMN GV 16 Berchem TOT
54,Posthofbrug 5366,2018-07-25,19:00:00,123,52,71,FMN GV 16 Berchem TOT
54,Posthofbrug 5366,2018-07-25,20:00:00,83,40,43,FMN GV 16 Berchem TOT
54,Posthofbrug 5366,2018-07-25,21:00:00,90,45,45,FMN GV 16 Berchem TOT
54,Posthofbrug 5366,2018-07-25,22:00:00,81,31,50,FMN GV 16 Berchem TOT
54,Posthofbrug 5366,2018-07-25,23:00:00,48,11,37,FMN GV 16 Berchem TOT
54,Posthofbrug 5366,2018-07-26,00:00:00,37,15,22,FMN GV 16 Berchem TOT
54,Posthofbrug 5366,2018-07-26,01:00:00,24,15,9,FMN GV 16 Berchem TOT
54,Posthofbrug 5366,2018-07-26,02:00:00,11,6,5,FMN GV 16 Berchem TOT
54,Posthofbrug 5366,2018-07-26,03:00:00,2,0,2,FMN GV 16 Berchem TOT
54,Posthofbrug 5366,2018-07-26,04:00:00,8,7,1,FMN GV 16 Berchem TOT
54,Posthofbrug 5366,2018-07-26,05:00:00,21,11,10,FMN GV 16 Berchem TOT
54,Posthofbrug 5366,2018-07-26,06:00:00,77,54,23,FMN GV 16 Berchem TOT
54,Posthofbrug 5366,2018-07-26,07:00:00,257,191,66,FMN GV 16 Berchem TOT
54,Posthofbrug 5366,2018-07-26,08:00:00,344,226,118,FMN GV 16 Berchem TOT
54,Posthofbrug 5366,2018-07-26,09:00:00,166,125,41,FMN GV 16 Berchem TOT
54,Posthofbrug 5366,2018-07-26,10:00:00,79,56,23,FMN GV 16 Berchem TOT
54,Posthofbrug 5366,2018-07-26,11:00:00,75,51,24,FMN GV 16 Berchem TOT
54,Posthofbrug 5366,2018-07-26,12:00:00,99,61,38,FMN GV 16 Berchem TOT
54,Posthofbrug 5366,2018-07-26,13:00:00,113,65,48,FMN GV 16 Berchem TOT
54,Posthofbrug 5366,2018-07-26,14:00:00,77,39,38,FMN GV 16 Berchem TOT
54,Posthofbrug 5366,2018-07-26,15:00:00,121,47,74,FMN GV 16 Berchem TOT
54,Posthofbrug 5366,2018-07-26,16:00:00,235,99,136,FMN GV 16 Berchem TOT
54,Posthofbrug 5366,2018-07-26,17:00:00,316,99,217,FMN GV 16 Berchem TOT
54,Posthofbrug 5366,2018-07-26,18:00:00,181,58,123,FMN GV 16 Berchem TOT
54,Posthofbrug 5366,2018-07-26,19:00:00,103,35,68,FMN GV 16 Berchem TOT
54,Posthofbrug 5366,2018-07-26,20:00:00,85,45,40,FMN GV 16 Berchem TOT
54,Posthofbrug 5366,2018-07-26,21:00:00,84,35,49,FMN GV 16 Berchem TOT
54,Posthofbrug 5366,2018-07-26,22:00:00,71,28,43,FMN GV 16 Berchem TOT
54,Posthofbrug 5366,2018-07-26,23:00:00,67,33,34,FMN GV 16 Berchem TOT
54,Posthofbrug 5366,2018-07-27,00:00:00,31,16,15,FMN GV 16 Berchem TOT
54,Posthofbrug 5366,2018-07-27,01:00:00,26,19,7,FMN GV 16 Berchem TOT
54,Posthofbrug 5366,2018-07-27,02:00:00,17,11,6,FMN GV 16 Berchem TOT
54,Posthofbrug 5366,2018-07-27,03:00:00,0,0,0,FMN GV 16 Berchem TOT
54,Posthofbrug 5366,2018-07-27,04:00:00,6,6,0,FMN GV 16 Berchem TOT
54,Posthofbrug 5366,2018-07-27,05:00:00,25,16,9,FMN GV 16 Berchem TOT
54,Posthofbrug 5366,2018-07-27,06:00:00,66,47,19,FMN GV 16 Berchem TOT
54,Posthofbrug 5366,2018-07-27,07:00:00,212,165,47,FMN GV 16 Berchem TOT
54,Posthofbrug 5366,2018-07-27,08:00:00,271,176,95,FMN GV 16 Berchem TOT
54,Posthofbrug 5366,2018-07-27,09:00:00,132,86,46,FMN GV 16 Berchem TOT
54,Posthofbrug 5366,2018-07-27,10:00:00,88,54,34,FMN GV 16 Berchem TOT
54,Posthofbrug 5366,2018-07-27,11:00:00,81,43,38,FMN GV 16 Berchem TOT
54,Posthofbrug 5366,2018-07-27,12:00:00,86,51,35,FMN GV 16 Berchem TOT
54,Posthofbrug 5366,2018-07-27,13:00:00,82,33,49,FMN GV 16 Berchem TOT
54,Posthofbrug 5366,2018-07-27,14:00:00,86,34,52,FMN GV 16 Berchem TOT
54,Posthofbrug 5366,2018-07-27,15:00:00,104,43,61,FMN GV 16 Berchem TOT
54,Posthofbrug 5366,2018-07-27,16:00:00,206,83,123,FMN GV 16 Berchem TOT
54,Posthofbrug 5366,2018-07-27,17:00:00,219,73,146,FMN GV 16 Berchem TOT
54,Posthofbrug 5366,2018-07-27,18:00:00,143,51,92,FMN GV 16 Berchem TOT
54,Posthofbrug 5366,2018-07-27,19:00:00,94,40,54,FMN GV 16 Berchem TOT
54,Posthofbrug 5366,2018-07-27,20:00:00,74,40,34,FMN GV 16 Berchem TOT
54,Posthofbrug 5366,2018-07-27,21:00:00,63,22,41,FMN GV 16 Berchem TOT
54,Posthofbrug 5366,2018-07-27,22:00:00,72,34,38,FMN GV 16 Berchem TOT
54,Posthofbrug 5366,2018-07-27,23:00:00,54,19,35,FMN GV 16 Berchem TOT
54,Posthofbrug 5366,2018-07-28,00:00:00,54,29,25,FMN GV 16 Berchem TOT
54,Posthofbrug 5366,2018-07-28,01:00:00,52,40,12,FMN GV 16 Berchem TOT
54,Posthofbrug 5366,2018-07-28,02:00:00,60,51,9,FMN GV 16 Berchem TOT
54,Posthofbrug 5366,2018-07-28,03:00:00,15,11,4,FMN GV 16 Berchem TOT
54,Posthofbrug 5366,2018-07-28,04:00:00,16,14,2,FMN GV 16 Berchem TOT
54,Posthofbrug 5366,2018-07-28,05:00:00,5,2,3,FMN GV 16 Berchem TOT
54,Posthofbrug 5366,2018-07-28,06:00:00,26,12,14,FMN GV 16 Berchem TOT
54,Posthofbrug 5366,2018-07-28,07:00:00,11,8,3,FMN GV 16 Berchem TOT
54,Posthofbrug 5366,2018-07-28,08:00:00,41,25,16,FMN GV 16 Berchem TOT
54,Posthofbrug 5366,2018-07-28,09:00:00,49,31,18,FMN GV 16 Berchem TOT
54,Posthofbrug 5366,2018-07-28,10:00:00,84,58,26,FMN GV 16 Berchem TOT
54,Posthofbrug 5366,2018-07-28,11:00:00,87,70,17,FMN GV 16 Berchem TOT
54,Posthofbrug 5366,2018-07-28,12:00:00,107,71,36,FMN GV 16 Berchem TOT
54,Posthofbrug 5366,2018-07-28,13:00:00,98,49,49,FMN GV 16 Berchem TOT
54,Posthofbrug 5366,2018-07-28,14:00:00,128,65,63,FMN GV 16 Berchem TOT
54,Posthofbrug 5366,2018-07-28,15:00:00,153,74,79,FMN GV 16 Berchem TOT
54,Posthofbrug 5366,2018-07-28,16:00:00,140,49,91,FMN GV 16 Berchem TOT
54,Posthofbrug 5366,2018-07-28,17:00:00,135,49,86,FMN GV 16 Berchem TOT
54,Posthofbrug 5366,2018-07-28,18:00:00,119,55,64,FMN GV 16 Berchem TOT
54,Posthofbrug 5366,2018-07-28,19:00:00,103,55,48,FMN GV 16 Berchem TOT
54,Posthofbrug 5366,2018-07-28,20:00:00,123,42,81,FMN GV 16 Berchem TOT
54,Posthofbrug 5366,2018-07-28,21:00:00,83,34,49,FMN GV 16 Berchem TOT
54,Posthofbrug 5366,2018-07-28,22:00:00,39,13,26,FMN GV 16 Berchem TOT
54,Posthofbrug 5366,2018-07-28,23:00:00,53,30,23,FMN GV 16 Berchem TOT
54,Posthofbrug 5366,2018-07-29,00:00:00,42,31,11,FMN GV 16 Berchem TOT
54,Posthofbrug 5366,2018-07-29,01:00:00,51,45,6,FMN GV 16 Berchem TOT
54,Posthofbrug 5366,2018-07-29,02:00:00,48,41,7,FMN GV 16 Berchem TOT
54,Posthofbrug 5366,2018-07-29,03:00:00,52,47,5,FMN GV 16 Berchem TOT
54,Posthofbrug 5366,2018-07-29,04:00:00,41,33,8,FMN GV 16 Berchem TOT
54,Posthofbrug 5366,2018-07-29,05:00:00,19,16,3,FMN GV 16 Berchem TOT
54,Posthofbrug 5366,2018-07-29,06:00:00,18,12,6,FMN GV 16 Berchem TOT
54,Posthofbrug 5366,2018-07-29,07:00:00,19,8,11,FMN GV 16 Berchem TOT
54,Posthofbrug 5366,2018-07-29,08:00:00,38,25,13,FMN GV 16 Berchem TOT
54,Posthofbrug 5366,2018-07-29,09:00:00,41,23,18,FMN GV 16 Berchem TOT
54,Posthofbrug 5366,2018-07-29,10:00:00,84,55,29,FMN GV 16 Berchem TOT
54,Posthofbrug 5366,2018-07-29,11:00:00,107,68,39,FMN GV 16 Berchem TOT
54,Posthofbrug 5366,2018-07-29,12:00:00,139,67,72,FMN GV 16 Berchem TOT
54,Posthofbrug 5366,2018-07-29,13:00:00,147,63,84,FMN GV 16 Berchem TOT
54,Posthofbrug 5366,2018-07-29,14:00:00,135,70,65,FMN GV 16 Berchem TOT
54,Posthofbrug 5366,2018-07-29,15:00:00,128,49,79,FMN GV 16 Berchem TOT
54,Posthofbrug 5366,2018-07-29,16:00:00,114,48,66,FMN GV 16 Berchem TOT
54,Posthofbrug 5366,2018-07-29,17:00:00,97,46,51,FMN GV 16 Berchem TOT
54,Posthofbrug 5366,2018-07-29,18:00:00,119,66,53,FMN GV 16 Berchem TOT
54,Posthofbrug 5366,2018-07-29,19:00:00,84,40,44,FMN GV 16 Berchem TOT
54,Posthofbrug 5366,2018-07-29,20:00:00,93,58,35,FMN GV 16 Berchem TOT
54,Posthofbrug 5366,2018-07-29,21:00:00,77,51,26,FMN GV 16 Berchem TOT
54,Posthofbrug 5366,2018-07-29,22:00:00,57,38,19,FMN GV 16 Berchem TOT
54,Posthofbrug 5366,2018-07-29,23:00:00,65,56,9,FMN GV 16 Berchem TOT
54,Posthofbrug 5366,2018-07-30,00:00:00,18,12,6,FMN GV 16 Berchem TOT
54,Posthofbrug 5366,2018-07-30,01:00:00,13,10,3,FMN GV 16 Berchem TOT
54,Posthofbrug 5366,2018-07-30,02:00:00,8,5,3,FMN GV 16 Berchem TOT
54,Posthofbrug 5366,2018-07-30,03:00:00,2,0,2,FMN GV 16 Berchem TOT
54,Posthofbrug 5366,2018-07-30,04:00:00,6,4,2,FMN GV 16 Berchem TOT
54,Posthofbrug 5366,2018-07-30,05:00:00,26,19,7,FMN GV 16 Berchem TOT
54,Posthofbrug 5366,2018-07-30,06:00:00,96,70,26,FMN GV 16 Berchem TOT
54,Posthofbrug 5366,2018-07-30,07:00:00,277,205,72,FMN GV 16 Berchem TOT
54,Posthofbrug 5366,2018-07-30,08:00:00,353,241,112,FMN GV 16 Berchem TOT
54,Posthofbrug 5366,2018-07-30,09:00:00,174,119,55,FMN GV 16 Berchem TOT
54,Posthofbrug 5366,2018-07-30,10:00:00,85,54,31,FMN GV 16 Berchem TOT
54,Posthofbrug 5366,2018-07-30,11:00:00,100,73,27,FMN GV 16 Berchem TOT
54,Posthofbrug 5366,2018-07-30,12:00:00,104,59,45,FMN GV 16 Berchem TOT
54,Posthofbrug 5366,2018-07-30,13:00:00,142,84,58,FMN GV 16 Berchem TOT
54,Posthofbrug 5366,2018-07-30,14:00:00,112,49,63,FMN GV 16 Berchem TOT
54,Posthofbrug 5366,2018-07-30,15:00:00,144,58,86,FMN GV 16 Berchem TOT
54,Posthofbrug 5366,2018-07-30,16:00:00,251,101,150,FMN GV 16 Berchem TOT
54,Posthofbrug 5366,2018-07-30,17:00:00,338,122,216,FMN GV 16 Berchem TOT
54,Posthofbrug 5366,2018-07-30,18:00:00,256,70,186,FMN GV 16 Berchem TOT
54,Posthofbrug 5366,2018-07-30,19:00:00,126,61,65,FMN GV 16 Berchem TOT
54,Posthofbrug 5366,2018-07-30,20:00:00,92,50,42,FMN GV 16 Berchem TOT
54,Posthofbrug 5366,2018-07-30,21:00:00,65,22,43,FMN GV 16 Berchem TOT
54,Posthofbrug 5366,2018-07-30,22:00:00,44,14,30,FMN GV 16 Berchem TOT
54,Posthofbrug 5366,2018-07-30,23:00:00,25,7,18,FMN GV 16 Berchem TOT
54,Posthofbrug 5366,2018-07-31,00:00:00,11,4,7,FMN GV 16 Berchem TOT
54,Posthofbrug 5366,2018-07-31,01:00:00,2,2,0,FMN GV 16 Berchem TOT
54,Posthofbrug 5366,2018-07-31,02:00:00,4,3,1,FMN GV 16 Berchem TOT
54,Posthofbrug 5366,2018-07-31,03:00:00,9,3,6,FMN GV 16 Berchem TOT
54,Posthofbrug 5366,2018-07-31,04:00:00,6,3,3,FMN GV 16 Berchem TOT
54,Posthofbrug 5366,2018-07-31,05:00:00,25,22,3,FMN GV 16 Berchem TOT
54,Posthofbrug 5366,2018-07-31,06:00:00,92,67,25,FMN GV 16 Berchem TOT
54,Posthofbrug 5366,2018-07-31,07:00:00,309,234,75,FMN GV 16 Berchem TOT
54,Posthofbrug 5366,2018-07-31,08:00:00,374,262,112,FMN GV 16 Berchem TOT
54,Posthofbrug 5366,2018-07-31,09:00:00,162,112,50,FMN GV 16 Berchem TOT
54,Posthofbrug 5366,2018-07-31,10:00:00,78,54,24,FMN GV 16 Berchem TOT
54,Posthofbrug 5366,2018-07-31,11:00:00,80,45,35,FMN GV 16 Berchem TOT
54,Posthofbrug 5366,2018-07-31,12:00:00,107,70,37,FMN GV 16 Berchem TOT
54,Posthofbrug 5366,2018-07-31,13:00:00,78,30,48,FMN GV 16 Berchem TOT
54,Posthofbrug 5366,2018-07-31,14:00:00,99,54,45,FMN GV 16 Berchem TOT
54,Posthofbrug 5366,2018-07-31,15:00:00,143,60,83,FMN GV 16 Berchem TOT
54,Posthofbrug 5366,2018-07-31,16:00:00,285,135,150,FMN GV 16 Berchem TOT
54,Posthofbrug 5366,2018-07-31,17:00:00,394,133,261,FMN GV 16 Berchem TOT
54,Posthofbrug 5366,2018-07-31,18:00:00,266,75,191,FMN GV 16 Berchem TOT
54,Posthofbrug 5366,2018-07-31,19:00:00,140,59,81,FMN GV 16 Berchem TOT
54,Posthofbrug 5366,2018-07-31,20:00:00,99,48,51,FMN GV 16 Berchem TOT
54,Posthofbrug 5366,2018-07-31,21:00:00,102,50,52,FMN GV 16 Berchem TOT
54,Posthofbrug 5366,2018-07-31,22:00:00,70,31,39,FMN GV 16 Berchem TOT
54,Posthofbrug 5366,2018-07-31,23:00:00,42,12,30,FMN GV 16 Berchem TOT
54,Posthofbrug 5366,2018-08-01,00:00:00,21,8,13,FMN GV 16 Berchem TOT
54,Posthofbrug 5366,2018-08-01,01:00:00,8,2,6,FMN GV 16 Berchem TOT
54,Posthofbrug 5366,2018-08-01,02:00:00,1,0,1,FMN GV 16 Berchem TOT
54,Posthofbrug 5366,2018-08-01,03:00:00,6,1,5,FMN GV 16 Berchem TOT
54,Posthofbrug 5366,2018-08-01,04:00:00,10,5,5,FMN GV 16 Berchem TOT
54,Posthofbrug 5366,2018-08-01,05:00:00,20,16,4,FMN GV 16 Berchem TOT
54,Posthofbrug 5366,2018-08-01,06:00:00,82,57,25,FMN GV 16 Berchem TOT
54,Posthofbrug 5366,2018-08-01,07:00:00,272,208,64,FMN GV 16 Berchem TOT
54,Posthofbrug 5366,2018-08-01,08:00:00,361,244,117,FMN GV 16 Berchem TOT
54,Posthofbrug 5366,2018-08-01,09:00:00,147,109,38,FMN GV 16 Berchem TOT
54,Posthofbrug 5366,2018-08-01,10:00:00,94,61,33,FMN GV 16 Berchem TOT
54,Posthofbrug 5366,2018-08-01,11:00:00,100,68,32,FMN GV 16 Berchem TOT
54,Posthofbrug 5366,2018-08-01,12:00:00,110,65,45,FMN GV 16 Berchem TOT
54,Posthofbrug 5366,2018-08-01,13:00:00,133,79,54,FMN GV 16 Berchem TOT
54,Posthofbrug 5366,2018-08-01,14:00:00,119,64,55,FMN GV 16 Berchem TOT
54,Posthofbrug 5366,2018-08-01,15:00:00,123,44,79,FMN GV 16 Berchem TOT
54,Posthofbrug 5366,2018-08-01,16:00:00,258,99,159,FMN GV 16 Berchem TOT
54,Posthofbrug 5366,2018-08-01,17:00:00,396,150,246,FMN GV 16 Berchem TOT
54,Posthofbrug 5366,2018-08-01,18:00:00,233,69,164,FMN GV 16 Berchem TOT
54,Posthofbrug 5366,2018-08-01,19:00:00,123,61,62,FMN GV 16 Berchem TOT
54,Posthofbrug 5366,2018-08-01,20:00:00,96,50,46,FMN GV 16 Berchem TOT
54,Posthofbrug 5366,2018-08-01,21:00:00,88,51,37,FMN GV 16 Berchem TOT
54,Posthofbrug 5366,2018-08-01,22:00:00,74,29,45,FMN GV 16 Berchem TOT
54,Posthofbrug 5366,2018-08-01,23:00:00,44,21,23,FMN GV 16 Berchem TOT
54,Posthofbrug 5366,2018-08-02,00:00:00,27,11,16,FMN GV 16 Berchem TOT
54,Posthofbrug 5366,2018-08-02,01:00:00,11,4,7,FMN GV 16 Berchem TOT
54,Posthofbrug 5366,2018-08-02,02:00:00,6,0,6,FMN GV 16 Berchem TOT
54,Posthofbrug 5366,2018-08-02,03:00:00,3,1,2,FMN GV 16 Berchem TOT
54,Posthofbrug 5366,2018-08-02,04:00:00,5,2,3,FMN GV 16 Berchem TOT
54,Posthofbrug 5366,2018-08-02,05:00:00,18,12,6,FMN GV 16 Berchem TOT
54,Posthofbrug 5366,2018-08-02,06:00:00,89,65,24,FMN GV 16 Berchem TOT
54,Posthofbrug 5366,2018-08-02,07:00:00,280,204,76,FMN GV 16 Berchem TOT
54,Posthofbrug 5366,2018-08-02,08:00:00,400,262,138,FMN GV 16 Berchem TOT
54,Posthofbrug 5366,2018-08-02,09:00:00,195,118,77,FMN GV 16 Berchem TOT
54,Posthofbrug 5366,2018-08-02,10:00:00,87,58,29,FMN GV 16 Berchem TOT
54,Posthofbrug 5366,2018-08-02,11:00:00,92,46,46,FMN GV 16 Berchem TOT
54,Posthofbrug 5366,2018-08-02,12:00:00,125,85,40,FMN GV 16 Berchem TOT
54,Posthofbrug 5366,2018-08-02,13:00:00,107,64,43,FMN GV 16 Berchem TOT
54,Posthofbrug 5366,2018-08-02,14:00:00,122,57,65,FMN GV 16 Berchem TOT
54,Posthofbrug 5366,2018-08-02,15:00:00,115,47,68,FMN GV 16 Berchem TOT
54,Posthofbrug 5366,2018-08-02,16:00:00,247,95,152,FMN GV 16 Berchem TOT
54,Posthofbrug 5366,2018-08-02,17:00:00,339,138,201,FMN GV 16 Berchem TOT
54,Posthofbrug 5366,2018-08-02,18:00:00,240,87,153,FMN GV 16 Berchem TOT
54,Posthofbrug 5366,2018-08-02,19:00:00,154,76,78,FMN GV 16 Berchem TOT
54,Posthofbrug 5366,2018-08-02,20:00:00,96,60,36,FMN GV 16 Berchem TOT
54,Posthofbrug 5366,2018-08-02,21:00:00,92,47,45,FMN GV 16 Berchem TOT
54,Posthofbrug 5366,2018-08-02,22:00:00,88,39,49,FMN GV 16 Berchem TOT
54,Posthofbrug 5366,2018-08-02,23:00:00,53,22,31,FMN GV 16 Berchem TOT
54,Posthofbrug 5366,2018-08-03,00:00:00,33,2,31,FMN GV 16 Berchem TOT
54,Posthofbrug 5366,2018-08-03,01:00:00,8,3,5,FMN GV 16 Berchem TOT
54,Posthofbrug 5366,2018-08-03,02:00:00,6,3,3,FMN GV 16 Berchem TOT
54,Posthofbrug 5366,2018-08-03,03:00:00,3,1,2,FMN GV 16 Berchem TOT
54,Posthofbrug 5366,2018-08-03,04:00:00,12,4,8,FMN GV 16 Berchem TOT
54,Posthofbrug 5366,2018-08-03,05:00:00,21,11,10,FMN GV 16 Berchem TOT
54,Posthofbrug 5366,2018-08-03,06:00:00,88,53,35,FMN GV 16 Berchem TOT
54,Posthofbrug 5366,2018-08-03,07:00:00,234,165,69,FMN GV 16 Berchem TOT
54,Posthofbrug 5366,2018-08-03,08:00:00,324,211,113,FMN GV 16 Berchem TOT
54,Posthofbrug 5366,2018-08-03,09:00:00,129,84,45,FMN GV 16 Berchem TOT
54,Posthofbrug 5366,2018-08-03,10:00:00,93,70,23,FMN GV 16 Berchem TOT
54,Posthofbrug 5366,2018-08-03,11:00:00,63,38,25,FMN GV 16 Berchem TOT
54,Posthofbrug 5366,2018-08-03,12:00:00,125,68,57,FMN GV 16 Berchem TOT
54,Posthofbrug 5366,2018-08-03,13:00:00,118,62,56,FMN GV 16 Berchem TOT
54,Posthofbrug 5366,2018-08-03,14:00:00,100,59,41,FMN GV 16 Berchem TOT
54,Posthofbrug 5366,2018-08-03,15:00:00,131,56,75,FMN GV 16 Berchem TOT
54,Posthofbrug 5366,2018-08-03,16:00:00,238,99,139,FMN GV 16 Berchem TOT
54,Posthofbrug 5366,2018-08-03,17:00:00,295,125,170,FMN GV 16 Berchem TOT
54,Posthofbrug 5366,2018-08-03,18:00:00,178,88,90,FMN GV 16 Berchem TOT
54,Posthofbrug 5366,2018-08-03,19:00:00,125,61,64,FMN GV 16 Berchem TOT
54,Posthofbrug 5366,2018-08-03,20:00:00,102,59,43,FMN GV 16 Berchem TOT
54,Posthofbrug 5366,2018-08-03,21:00:00,88,46,42,FMN GV 16 Berchem TOT
54,Posthofbrug 5366,2018-08-03,22:00:00,67,28,39,FMN GV 16 Berchem TOT
54,Posthofbrug 5366,2018-08-03,23:00:00,47,9,38,FMN GV 16 Berchem TOT
54,Posthofbrug 5366,2018-08-04,00:00:00,37,12,25,FMN GV 16 Berchem TOT
54,Posthofbrug 5366,2018-08-04,01:00:00,34,13,21,FMN GV 16 Berchem TOT
54,Posthofbrug 5366,2018-08-04,02:00:00,15,1,14,FMN GV 16 Berchem TOT
54,Posthofbrug 5366,2018-08-04,03:00:00,14,5,9,FMN GV 16 Berchem TOT
54,Posthofbrug 5366,2018-08-04,04:00:00,10,3,7,FMN GV 16 Berchem TOT
54,Posthofbrug 5366,2018-08-04,05:00:00,15,7,8,FMN GV 16 Berchem TOT
54,Posthofbrug 5366,2018-08-04,06:00:00,22,9,13,FMN GV 16 Berchem TOT
54,Posthofbrug 5366,2018-08-04,07:00:00,15,10,5,FMN GV 16 Berchem TOT
54,Posthofbrug 5366,2018-08-04,08:00:00,50,43,7,FMN GV 16 Berchem TOT
54,Posthofbrug 5366,2018-08-04,09:00:00,86,52,34,FMN GV 16 Berchem TOT
54,Posthofbrug 5366,2018-08-04,10:00:00,119,84,35,FMN GV 16 Berchem TOT
54,Posthofbrug 5366,2018-08-04,11:00:00,105,67,38,FMN GV 16 Berchem TOT
54,Posthofbrug 5366,2018-08-04,12:00:00,104,59,45,FMN GV 16 Berchem TOT
54,Posthofbrug 5366,2018-08-04,13:00:00,109,75,34,FMN GV 16 Berchem TOT
54,Posthofbrug 5366,2018-08-04,14:00:00,103,67,36,FMN GV 16 Berchem TOT
54,Posthofbrug 5366,2018-08-04,15:00:00,93,35,58,FMN GV 16 Berchem TOT
54,Posthofbrug 5366,2018-08-04,16:00:00,77,40,37,FMN GV 16 Berchem TOT
54,Posthofbrug 5366,2018-08-04,17:00:00,110,47,63,FMN GV 16 Berchem TOT
54,Posthofbrug 5366,2018-08-04,18:00:00,117,75,42,FMN GV 16 Berchem TOT
54,Posthofbrug 5366,2018-08-04,19:00:00,82,59,23,FMN GV 16 Berchem TOT
54,Posthofbrug 5366,2018-08-04,20:00:00,57,33,24,FMN GV 16 Berchem TOT
54,Posthofbrug 5366,2018-08-04,21:00:00,53,26,27,FMN GV 16 Berchem TOT
54,Posthofbrug 5366,2018-08-04,22:00:00,78,21,57,FMN GV 16 Berchem TOT
54,Posthofbrug 5366,2018-08-04,23:00:00,49,16,33,FMN GV 16 Berchem TOT
54,Posthofbrug 5366,2018-08-05,00:00:00,42,10,32,FMN GV 16 Berchem TOT
54,Posthofbrug 5366,2018-08-05,01:00:00,33,10,23,FMN GV 16 Berchem TOT
54,Posthofbrug 5366,2018-08-05,02:00:00,21,7,14,FMN GV 16 Berchem TOT
54,Posthofbrug 5366,2018-08-05,03:00:00,4,0,4,FMN GV 16 Berchem TOT
54,Posthofbrug 5366,2018-08-05,04:00:00,11,3,8,FMN GV 16 Berchem TOT
54,Posthofbrug 5366,2018-08-05,05:00:00,5,3,2,FMN GV 16 Berchem TOT
54,Posthofbrug 5366,2018-08-05,06:00:00,17,7,10,FMN GV 16 Berchem TOT
54,Posthofbrug 5366,2018-08-05,07:00:00,19,13,6,FMN GV 16 Berchem TOT
54,Posthofbrug 5366,2018-08-05,08:00:00,31,21,10,FMN GV 16 Berchem TOT
54,Posthofbrug 5366,2018-08-05,09:00:00,56,38,18,FMN GV 16 Berchem TOT
54,Posthofbrug 5366,2018-08-05,10:00:00,104,72,32,FMN GV 16 Berchem TOT
54,Posthofbrug 5366,2018-08-05,11:00:00,159,112,47,FMN GV 16 Berchem TOT
54,Posthofbrug 5366,2018-08-05,12:00:00,134,86,48,FMN GV 16 Berchem TOT
54,Posthofbrug 5366,2018-08-05,13:00:00,128,83,45,FMN GV 16 Berchem TOT
54,Posthofbrug 5366,2018-08-05,14:00:00,109,62,47,FMN GV 16 Berchem TOT
54,Posthofbrug 5366,2018-08-05,15:00:00,131,73,58,FMN GV 16 Berchem TOT
54,Posthofbrug 5366,2018-08-05,16:00:00,117,56,61,FMN GV 16 Berchem TOT
54,Posthofbrug 5366,2018-08-05,17:00:00,127,57,70,FMN GV 16 Berchem TOT
54,Posthofbrug 5366,2018-08-05,18:00:00,111,47,64,FMN GV 16 Berchem TOT
54,Posthofbrug 5366,2018-08-05,19:00:00,103,51,52,FMN GV 16 Berchem TOT
54,Posthofbrug 5366,2018-08-05,20:00:00,72,31,41,FMN GV 16 Berchem TOT
54,Posthofbrug 5366,2018-08-05,21:00:00,63,27,36,FMN GV 16 Berchem TOT
54,Posthofbrug 5366,2018-08-05,22:00:00,65,32,33,FMN GV 16 Berchem TOT
54,Posthofbrug 5366,2018-08-05,23:00:00,28,10,18,FMN GV 16 Berchem TOT
54,Posthofbrug 5366,2018-08-06,00:00:00,31,8,23,FMN GV 16 Berchem TOT
54,Posthofbrug 5366,2018-08-06,01:00:00,5,1,4,FMN GV 16 Berchem TOT
54,Posthofbrug 5366,2018-08-06,02:00:00,2,1,1,FMN GV 16 Berchem TOT
54,Posthofbrug 5366,2018-08-06,03:00:00,1,1,0,FMN GV 16 Berchem TOT
54,Posthofbrug 5366,2018-08-06,04:00:00,8,5,3,FMN GV 16 Berchem TOT
54,Posthofbrug 5366,2018-08-06,05:00:00,18,12,6,FMN GV 16 Berchem TOT
54,Posthofbrug 5366,2018-08-06,06:00:00,89,62,27,FMN GV 16 Berchem TOT
54,Posthofbrug 5366,2018-08-06,07:00:00,271,203,68,FMN GV 16 Berchem TOT
54,Posthofbrug 5366,2018-08-06,08:00:00,389,264,125,FMN GV 16 Berchem TOT
54,Posthofbrug 5366,2018-08-06,09:00:00,155,102,53,FMN GV 16 Berchem TOT
54,Posthofbrug 5366,2018-08-06,10:00:00,89,59,30,FMN GV 16 Berchem TOT
54,Posthofbrug 5366,2018-08-06,11:00:00,90,62,28,FMN GV 16 Berchem TOT
54,Posthofbrug 5366,2018-08-06,12:00:00,102,59,43,FMN GV 16 Berchem TOT
54,Posthofbrug 5366,2018-08-06,13:00:00,98,52,46,FMN GV 16 Berchem TOT
54,Posthofbrug 5366,2018-08-06,14:00:00,120,50,70,FMN GV 16 Berchem TOT
54,Posthofbrug 5366,2018-08-06,15:00:00,129,49,80,FMN GV 16 Berchem TOT
54,Posthofbrug 5366,2018-08-06,16:00:00,252,109,143,FMN GV 16 Berchem TOT
54,Posthofbrug 5366,2018-08-06,17:00:00,342,131,211,FMN GV 16 Berchem TOT
54,Posthofbrug 5366,2018-08-06,18:00:00,206,72,134,FMN GV 16 Berchem TOT
54,Posthofbrug 5366,2018-08-06,19:00:00,93,46,47,FMN GV 16 Berchem TOT
54,Posthofbrug 5366,2018-08-06,20:00:00,80,37,43,FMN GV 16 Berchem TOT
54,Posthofbrug 5366,2018-08-06,21:00:00,54,29,25,FMN GV 16 Berchem TOT
54,Posthofbrug 5366,2018-08-06,22:00:00,54,26,28,FMN GV 16 Berchem TOT
54,Posthofbrug 5366,2018-08-06,23:00:00,40,21,19,FMN GV 16 Berchem TOT
54,Posthofbrug 5366,2018-08-07,00:00:00,19,4,15,FMN GV 16 Berchem TOT
54,Posthofbrug 5366,2018-08-07,01:00:00,1,0,1,FMN GV 16 Berchem TOT
54,Posthofbrug 5366,2018-08-07,02:00:00,3,1,2,FMN GV 16 Berchem TOT
54,Posthofbrug 5366,2018-08-07,03:00:00,3,0,3,FMN GV 16 Berchem TOT
54,Posthofbrug 5366,2018-08-07,04:00:00,5,4,1,FMN GV 16 Berchem TOT
54,Posthofbrug 5366,2018-08-07,05:00:00,16,8,8,FMN GV 16 Berchem TOT
54,Posthofbrug 5366,2018-08-07,06:00:00,93,69,24,FMN GV 16 Berchem TOT
54,Posthofbrug 5366,2018-08-07,07:00:00,286,210,76,FMN GV 16 Berchem TOT
54,Posthofbrug 5366,2018-08-07,08:00:00,390,250,140,FMN GV 16 Berchem TOT
54,Posthofbrug 5366,2018-08-07,09:00:00,159,117,42,FMN GV 16 Berchem TOT
54,Posthofbrug 5366,2018-08-07,10:00:00,82,60,22,FMN GV 16 Berchem TOT
54,Posthofbrug 5366,2018-08-07,11:00:00,67,47,20,FMN GV 16 Berchem TOT
54,Posthofbrug 5366,2018-08-07,12:00:00,84,49,35,FMN GV 16 Berchem TOT
54,Posthofbrug 5366,2018-08-07,13:00:00,70,26,44,FMN GV 16 Berchem TOT
54,Posthofbrug 5366,2018-08-07,14:00:00,84,38,46,FMN GV 16 Berchem TOT
54,Posthofbrug 5366,2018-08-07,15:00:00,89,35,54,FMN GV 16 Berchem TOT
54,Posthofbrug 5366,2018-08-07,16:00:00,229,120,109,FMN GV 16 Berchem TOT
54,Posthofbrug 5366,2018-08-07,17:00:00,341,136,205,FMN GV 16 Berchem TOT
54,Posthofbrug 5366,2018-08-07,18:00:00,216,64,152,FMN GV 16 Berchem TOT
54,Posthofbrug 5366,2018-08-07,19:00:00,93,37,56,FMN GV 16 Berchem TOT
54,Posthofbrug 5366,2018-08-07,20:00:00,68,28,40,FMN GV 16 Berchem TOT
54,Posthofbrug 5366,2018-08-07,21:00:00,74,35,39,FMN GV 16 Berchem TOT
54,Posthofbrug 5366,2018-08-07,22:00:00,56,25,31,FMN GV 16 Berchem TOT
54,Posthofbrug 5366,2018-08-07,23:00:00,27,10,17,FMN GV 16 Berchem TOT
54,Posthofbrug 5366,2018-08-08,00:00:00,13,9,4,FMN GV 16 Berchem TOT
54,Posthofbrug 5366,2018-08-08,01:00:00,4,0,4,FMN GV 16 Berchem TOT
54,Posthofbrug 5366,2018-08-08,02:00:00,4,0,4,FMN GV 16 Berchem TOT
54,Posthofbrug 5366,2018-08-08,03:00:00,0,0,0,FMN GV 16 Berchem TOT
54,Posthofbrug 5366,2018-08-08,04:00:00,10,7,3,FMN GV 16 Berchem TOT
54,Posthofbrug 5366,2018-08-08,05:00:00,15,6,9,FMN GV 16 Berchem TOT
54,Posthofbrug 5366,2018-08-08,06:00:00,69,48,21,FMN GV 16 Berchem TOT
54,Posthofbrug 5366,2018-08-08,07:00:00,234,181,53,FMN GV 16 Berchem TOT
54,Posthofbrug 5366,2018-08-08,08:00:00,336,214,122,FMN GV 16 Berchem TOT
54,Posthofbrug 5366,2018-08-08,09:00:00,147,86,61,FMN GV 16 Berchem TOT
54,Posthofbrug 5366,2018-08-08,10:00:00,73,49,24,FMN GV 16 Berchem TOT
54,Posthofbrug 5366,2018-08-08,11:00:00,71,44,27,FMN GV 16 Berchem TOT
54,Posthofbrug 5366,2018-08-08,12:00:00,97,66,31,FMN GV 16 Berchem TOT
54,Posthofbrug 5366,2018-08-08,13:00:00,111,63,48,FMN GV 16 Berchem TOT
54,Posthofbrug 5366,2018-08-08,14:00:00,97,52,45,FMN GV 16 Berchem TOT
54,Posthofbrug 5366,2018-08-08,15:00:00,100,48,52,FMN GV 16 Berchem TOT
54,Posthofbrug 5366,2018-08-08,16:00:00,225,109,116,FMN GV 16 Berchem TOT
54,Posthofbrug 5366,2018-08-08,17:00:00,291,119,172,FMN GV 16 Berchem TOT
54,Posthofbrug 5366,2018-08-08,18:00:00,221,73,148,FMN GV 16 Berchem TOT
54,Posthofbrug 5366,2018-08-08,19:00:00,102,43,59,FMN GV 16 Berchem TOT
54,Posthofbrug 5366,2018-08-08,20:00:00,89,44,45,FMN GV 16 Berchem TOT
54,Posthofbrug 5366,2018-08-08,21:00:00,74,31,43,FMN GV 16 Berchem TOT
54,Posthofbrug 5366,2018-08-08,22:00:00,91,29,62,FMN GV 16 Berchem TOT
54,Posthofbrug 5366,2018-08-08,23:00:00,35,13,22,FMN GV 16 Berchem TOT
54,Posthofbrug 5366,2018-08-25,00:00:00,47,5,42,FMN GV 16 Berchem TOT
54,Posthofbrug 5366,2018-08-25,01:00:00,28,10,18,FMN GV 16 Berchem TOT
54,Posthofbrug 5366,2018-08-25,02:00:00,21,3,18,FMN GV 16 Berchem TOT
54,Posthofbrug 5366,2018-08-25,03:00:00,5,1,4,FMN GV 16 Berchem TOT
54,Posthofbrug 5366,2018-08-25,04:00:00,4,2,2,FMN GV 16 Berchem TOT
54,Posthofbrug 5366,2018-08-25,05:00:00,12,9,3,FMN GV 16 Berchem TOT
54,Posthofbrug 5366,2018-08-25,06:00:00,18,12,6,FMN GV 16 Berchem TOT
54,Posthofbrug 5366,2018-08-25,07:00:00,23,14,9,FMN GV 16 Berchem TOT
54,Posthofbrug 5366,2018-08-25,08:00:00,53,40,13,FMN GV 16 Berchem TOT
54,Posthofbrug 5366,2018-08-25,09:00:00,53,34,19,FMN GV 16 Berchem TOT
54,Posthofbrug 5366,2018-08-25,10:00:00,84,61,23,FMN GV 16 Berchem TOT
54,Posthofbrug 5366,2018-08-25,11:00:00,70,42,28,FMN GV 16 Berchem TOT
54,Posthofbrug 5366,2018-08-25,12:00:00,84,55,29,FMN GV 16 Berchem TOT
54,Posthofbrug 5366,2018-08-25,13:00:00,87,55,32,FMN GV 16 Berchem TOT
54,Posthofbrug 5366,2018-08-25,14:00:00,68,38,30,FMN GV 16 Berchem TOT
54,Posthofbrug 5366,2018-08-25,15:00:00,109,70,39,FMN GV 16 Berchem TOT
54,Posthofbrug 5366,2018-08-25,16:00:00,102,52,50,FMN GV 16 Berchem TOT
54,Posthofbrug 5366,2018-08-25,17:00:00,86,42,44,FMN GV 16 Berchem TOT
54,Posthofbrug 5366,2018-08-25,18:00:00,100,50,50,FMN GV 16 Berchem TOT
54,Posthofbrug 5366,2018-08-25,19:00:00,81,30,51,FMN GV 16 Berchem TOT
54,Posthofbrug 5366,2018-08-25,20:00:00,61,31,30,FMN GV 16 Berchem TOT
54,Posthofbrug 5366,2018-08-25,21:00:00,47,17,30,FMN GV 16 Berchem TOT
54,Posthofbrug 5366,2018-08-25,22:00:00,34,15,19,FMN GV 16 Berchem TOT
54,Posthofbrug 5366,2018-08-25,23:00:00,46,18,28,FMN GV 16 Berchem TOT
54,Posthofbrug 5366,2018-08-26,00:00:00,30,8,22,FMN GV 16 Berchem TOT
54,Posthofbrug 5366,2018-08-26,01:00:00,21,10,11,FMN GV 16 Berchem TOT
54,Posthofbrug 5366,2018-08-26,02:00:00,16,3,13,FMN GV 16 Berchem TOT
54,Posthofbrug 5366,2018-08-26,03:00:00,24,7,17,FMN GV 16 Berchem TOT
54,Posthofbrug 5366,2018-08-26,04:00:00,11,3,8,FMN GV 16 Berchem TOT
54,Posthofbrug 5366,2018-08-26,05:00:00,11,7,4,FMN GV 16 Berchem TOT
54,Posthofbrug 5366,2018-08-26,06:00:00,12,10,2,FMN GV 16 Berchem TOT
54,Posthofbrug 5366,2018-08-26,07:00:00,25,19,6,FMN GV 16 Berchem TOT
54,Posthofbrug 5366,2018-08-26,08:00:00,43,26,17,FMN GV 16 Berchem TOT
54,Posthofbrug 5366,2018-08-26,09:00:00,61,32,29,FMN GV 16 Berchem TOT
54,Posthofbrug 5366,2018-08-26,10:00:00,113,82,31,FMN GV 16 Berchem TOT
54,Posthofbrug 5366,2018-08-26,11:00:00,131,93,38,FMN GV 16 Berchem TOT
54,Posthofbrug 5366,2018-08-26,12:00:00,118,75,43,FMN GV 16 Berchem TOT
54,Posthofbrug 5366,2018-08-26,13:00:00,135,87,48,FMN GV 16 Berchem TOT
54,Posthofbrug 5366,2018-08-26,14:00:00,145,102,43,FMN GV 16 Berchem TOT
54,Posthofbrug 5366,2018-08-26,15:00:00,147,65,82,FMN GV 16 Berchem TOT
54,Posthofbrug 5366,2018-08-26,16:00:00,151,45,106,FMN GV 16 Berchem TOT
54,Posthofbrug 5366,2018-08-26,17:00:00,126,34,92,FMN GV 16 Berchem TOT
54,Posthofbrug 5366,2018-08-26,18:00:00,85,40,45,FMN GV 16 Berchem TOT
54,Posthofbrug 5366,2018-08-26,19:00:00,57,25,32,FMN GV 16 Berchem TOT
54,Posthofbrug 5366,2018-08-26,20:00:00,59,26,33,FMN GV 16 Berchem TOT
54,Posthofbrug 5366,2018-08-26,21:00:00,25,18,7,FMN GV 16 Berchem TOT
54,Posthofbrug 5366,2018-08-26,22:00:00,15,1,14,FMN GV 16 Berchem TOT
54,Posthofbrug 5366,2018-08-26,23:00:00,19,9,10,FMN GV 16 Berchem TOT
54,Posthofbrug 5366,2018-08-27,00:00:00,4,2,2,FMN GV 16 Berchem TOT
54,Posthofbrug 5366,2018-08-27,01:00:00,2,0,2,FMN GV 16 Berchem TOT
54,Posthofbrug 5366,2018-08-27,02:00:00,0,0,0,FMN GV 16 Berchem TOT
54,Posthofbrug 5366,2018-08-27,03:00:00,0,0,0,FMN GV 16 Berchem TOT
54,Posthofbrug 5366,2018-08-27,04:00:00,0,0,0,FMN GV 16 Berchem TOT
54,Posthofbrug 5366,2018-08-27,05:00:00,10,6,4,FMN GV 16 Berchem TOT
54,Posthofbrug 5366,2018-08-27,06:00:00,82,59,23,FMN GV 16 Berchem TOT
54,Posthofbrug 5366,2018-08-27,07:00:00,266,195,71,FMN GV 16 Berchem TOT
54,Posthofbrug 5366,2018-08-27,08:00:00,357,227,130,FMN GV 16 Berchem TOT
54,Posthofbrug 5366,2018-08-27,09:00:00,182,118,64,FMN GV 16 Berchem TOT
54,Posthofbrug 5366,2018-08-27,10:00:00,99,65,34,FMN GV 16 Berchem TOT
54,Posthofbrug 5366,2018-08-27,11:00:00,75,48,27,FMN GV 16 Berchem TOT
54,Posthofbrug 5366,2018-08-27,12:00:00,121,84,37,FMN GV 16 Berchem TOT
54,Posthofbrug 5366,2018-08-27,13:00:00,111,52,59,FMN GV 16 Berchem TOT
54,Posthofbrug 5366,2018-08-27,14:00:00,83,38,45,FMN GV 16 Berchem TOT
54,Posthofbrug 5366,2018-08-27,15:00:00,153,76,77,FMN GV 16 Berchem TOT
54,Posthofbrug 5366,2018-08-27,16:00:00,292,117,175,FMN GV 16 Berchem TOT
54,Posthofbrug 5366,2018-08-27,17:00:00,425,156,269,FMN GV 16 Berchem TOT
54,Posthofbrug 5366,2018-08-27,18:00:00,287,103,184,FMN GV 16 Berchem TOT
54,Posthofbrug 5366,2018-08-27,19:00:00,112,43,69,FMN GV 16 Berchem TOT
54,Posthofbrug 5366,2018-08-27,20:00:00,79,35,44,FMN GV 16 Berchem TOT
54,Posthofbrug 5366,2018-08-27,21:00:00,66,17,49,FMN GV 16 Berchem TOT
54,Posthofbrug 5366,2018-08-27,22:00:00,45,26,19,FMN GV 16 Berchem TOT
54,Posthofbrug 5366,2018-08-27,23:00:00,14,6,8,FMN GV 16 Berchem TOT
54,Posthofbrug 5366,2018-08-28,00:00:00,7,2,5,FMN GV 16 Berchem TOT
54,Posthofbrug 5366,2018-08-28,01:00:00,5,0,5,FMN GV 16 Berchem TOT
54,Posthofbrug 5366,2018-08-28,02:00:00,9,4,5,FMN GV 16 Berchem TOT
54,Posthofbrug 5366,2018-08-28,03:00:00,2,2,0,FMN GV 16 Berchem TOT
54,Posthofbrug 5366,2018-08-28,04:00:00,6,4,2,FMN GV 16 Berchem TOT
54,Posthofbrug 5366,2018-08-28,05:00:00,25,17,8,FMN GV 16 Berchem TOT
54,Posthofbrug 5366,2018-08-28,06:00:00,109,83,26,FMN GV 16 Berchem TOT
54,Posthofbrug 5366,2018-08-28,07:00:00,375,277,98,FMN GV 16 Berchem TOT
54,Posthofbrug 5366,2018-08-28,08:00:00,560,376,184,FMN GV 16 Berchem TOT
54,Posthofbrug 5366,2018-08-28,09:00:00,248,174,74,FMN GV 16 Berchem TOT
54,Posthofbrug 5366,2018-08-28,10:00:00,126,84,42,FMN GV 16 Berchem TOT
54,Posthofbrug 5366,2018-08-28,11:00:00,108,51,57,FMN GV 16 Berchem TOT
54,Posthofbrug 5366,2018-08-28,12:00:00,146,98,48,FMN GV 16 Berchem TOT
54,Posthofbrug 5366,2018-08-28,13:00:00,133,60,73,FMN GV 16 Berchem TOT
54,Posthofbrug 5366,2018-08-28,14:00:00,148,81,67,FMN GV 16 Berchem TOT
54,Posthofbrug 5366,2018-08-28,15:00:00,169,85,84,FMN GV 16 Berchem TOT
54,Posthofbrug 5366,2018-08-28,16:00:00,395,158,237,FMN GV 16 Berchem TOT
54,Posthofbrug 5366,2018-08-28,17:00:00,500,201,299,FMN GV 16 Berchem TOT
54,Posthofbrug 5366,2018-08-28,18:00:00,308,95,213,FMN GV 16 Berchem TOT
54,Posthofbrug 5366,2018-08-28,19:00:00,182,68,114,FMN GV 16 Berchem TOT
54,Posthofbrug 5366,2018-08-28,20:00:00,120,66,54,FMN GV 16 Berchem TOT
54,Posthofbrug 5366,2018-08-28,21:00:00,85,38,47,FMN GV 16 Berchem TOT
54,Posthofbrug 5366,2018-08-28,22:00:00,66,26,40,FMN GV 16 Berchem TOT
54,Posthofbrug 5366,2018-08-28,23:00:00,46,9,37,FMN GV 16 Berchem TOT
54,Posthofbrug 5366,2018-08-29,00:00:00,27,7,20,FMN GV 16 Berchem TOT
54,Posthofbrug 5366,2018-08-29,01:00:00,6,1,5,FMN GV 16 Berchem TOT
54,Posthofbrug 5366,2018-08-29,02:00:00,1,0,1,FMN GV 16 Berchem TOT
54,Posthofbrug 5366,2018-08-29,03:00:00,2,1,1,FMN GV 16 Berchem TOT
54,Posthofbrug 5366,2018-08-29,04:00:00,3,3,0,FMN GV 16 Berchem TOT
54,Posthofbrug 5366,2018-08-29,05:00:00,19,15,4,FMN GV 16 Berchem TOT
54,Posthofbrug 5366,2018-08-29,06:00:00,93,68,25,FMN GV 16 Berchem TOT
54,Posthofbrug 5366,2018-08-29,07:00:00,318,235,83,FMN GV 16 Berchem TOT
54,Posthofbrug 5366,2018-08-29,08:00:00,459,307,152,FMN GV 16 Berchem TOT
54,Posthofbrug 5366,2018-08-29,09:00:00,189,122,67,FMN GV 16 Berchem TOT
54,Posthofbrug 5366,2018-08-29,10:00:00,60,47,13,FMN GV 16 Berchem TOT
54,Posthofbrug 5366,2018-08-29,11:00:00,85,44,41,FMN GV 16 Berchem TOT
54,Posthofbrug 5366,2018-08-29,12:00:00,85,40,45,FMN GV 16 Berchem TOT
54,Posthofbrug 5366,2018-08-29,13:00:00,103,49,54,FMN GV 16 Berchem TOT
54,Posthofbrug 5366,2018-08-29,14:00:00,80,38,42,FMN GV 16 Berchem TOT
54,Posthofbrug 5366,2018-08-29,15:00:00,108,33,75,FMN GV 16 Berchem TOT
54,Posthofbrug 5366,2018-08-29,16:00:00,246,114,132,FMN GV 16 Berchem TOT
54,Posthofbrug 5366,2018-08-29,17:00:00,375,148,227,FMN GV 16 Berchem TOT
54,Posthofbrug 5366,2018-08-29,18:00:00,245,83,162,FMN GV 16 Berchem TOT
54,Posthofbrug 5366,2018-08-29,19:00:00,96,36,60,FMN GV 16 Berchem TOT
54,Posthofbrug 5366,2018-08-29,20:00:00,72,38,34,FMN GV 16 Berchem TOT
54,Posthofbrug 5366,2018-08-29,21:00:00,47,16,31,FMN GV 16 Berchem TOT
54,Posthofbrug 5366,2018-08-29,22:00:00,42,13,29,FMN GV 16 Berchem TOT
54,Posthofbrug 5366,2018-08-29,23:00:00,36,11,25,FMN GV 16 Berchem TOT
54,Posthofbrug 5366,2018-08-30,00:00:00,16,11,5,FMN GV 16 Berchem TOT
54,Posthofbrug 5366,2018-08-30,01:00:00,7,1,6,FMN GV 16 Berchem TOT
54,Posthofbrug 5366,2018-08-30,02:00:00,4,0,4,FMN GV 16 Berchem TOT
54,Posthofbrug 5366,2018-08-30,03:00:00,6,3,3,FMN GV 16 Berchem TOT
54,Posthofbrug 5366,2018-08-30,04:00:00,12,5,7,FMN GV 16 Berchem TOT
54,Posthofbrug 5366,2018-08-30,05:00:00,26,14,12,FMN GV 16 Berchem TOT
54,Posthofbrug 5366,2018-08-30,06:00:00,87,63,24,FMN GV 16 Berchem TOT
54,Posthofbrug 5366,2018-08-30,07:00:00,344,241,103,FMN GV 16 Berchem TOT
54,Posthofbrug 5366,2018-08-30,08:00:00,554,371,183,FMN GV 16 Berchem TOT
54,Posthofbrug 5366,2018-08-30,09:00:00,225,153,72,FMN GV 16 Berchem TOT
54,Posthofbrug 5366,2018-08-30,10:00:00,92,67,25,FMN GV 16 Berchem TOT
54,Posthofbrug 5366,2018-08-30,11:00:00,109,64,45,FMN GV 16 Berchem TOT
54,Posthofbrug 5366,2018-08-30,12:00:00,143,90,53,FMN GV 16 Berchem TOT
54,Posthofbrug 5366,2018-08-30,13:00:00,134,66,68,FMN GV 16 Berchem TOT
54,Posthofbrug 5366,2018-08-30,14:00:00,144,74,70,FMN GV 16 Berchem TOT
54,Posthofbrug 5366,2018-08-30,15:00:00,174,71,103,FMN GV 16 Berchem TOT
54,Posthofbrug 5366,2018-08-30,16:00:00,348,153,195,FMN GV 16 Berchem TOT
54,Posthofbrug 5366,2018-08-30,17:00:00,455,182,273,FMN GV 16 Berchem TOT
54,Posthofbrug 5366,2018-08-30,18:00:00,296,88,208,FMN GV 16 Berchem TOT
54,Posthofbrug 5366,2018-08-30,19:00:00,173,71,102,FMN GV 16 Berchem TOT
54,Posthofbrug 5366,2018-08-30,20:00:00,121,69,52,FMN GV 16 Berchem TOT
54,Posthofbrug 5366,2018-08-30,21:00:00,74,34,40,FMN GV 16 Berchem TOT
54,Posthofbrug 5366,2018-08-30,22:00:00,55,22,33,FMN GV 16 Berchem TOT
54,Posthofbrug 5366,2018-08-30,23:00:00,50,15,35,FMN GV 16 Berchem TOT
54,Posthofbrug 5366,2018-08-31,00:00:00,43,20,23,FMN GV 16 Berchem TOT
54,Posthofbrug 5366,2018-08-31,01:00:00,12,2,10,FMN GV 16 Berchem TOT
54,Posthofbrug 5366,2018-08-31,02:00:00,3,0,3,FMN GV 16 Berchem TOT
54,Posthofbrug 5366,2018-08-31,03:00:00,4,1,3,FMN GV 16 Berchem TOT
54,Posthofbrug 5366,2018-08-31,04:00:00,14,4,10,FMN GV 16 Berchem TOT
54,Posthofbrug 5366,2018-08-31,05:00:00,16,11,5,FMN GV 16 Berchem TOT
54,Posthofbrug 5366,2018-08-31,06:00:00,75,56,19,FMN GV 16 Berchem TOT
54,Posthofbrug 5366,2018-08-31,07:00:00,314,207,107,FMN GV 16 Berchem TOT
54,Posthofbrug 5366,2018-08-31,08:00:00,486,331,155,FMN GV 16 Berchem TOT
54,Posthofbrug 5366,2018-08-31,09:00:00,240,159,81,FMN GV 16 Berchem TOT
54,Posthofbrug 5366,2018-08-31,10:00:00,102,67,35,FMN GV 16 Berchem TOT
54,Posthofbrug 5366,2018-08-31,11:00:00,109,75,34,FMN GV 16 Berchem TOT
54,Posthofbrug 5366,2018-08-31,12:00:00,130,87,43,FMN GV 16 Berchem TOT
54,Posthofbrug 5366,2018-08-31,13:00:00,159,90,69,FMN GV 16 Berchem TOT
54,Posthofbrug 5366,2018-08-31,14:00:00,158,73,85,FMN GV 16 Berchem TOT
54,Posthofbrug 5366,2018-08-31,15:00:00,179,73,106,FMN GV 16 Berchem TOT
54,Posthofbrug 5366,2018-08-31,16:00:00,342,153,189,FMN GV 16 Berchem TOT
54,Posthofbrug 5366,2018-08-31,17:00:00,414,138,276,FMN GV 16 Berchem TOT
54,Posthofbrug 5366,2018-08-31,18:00:00,275,117,158,FMN GV 16 Berchem TOT
54,Posthofbrug 5366,2018-08-31,19:00:00,156,82,74,FMN GV 16 Berchem TOT
54,Posthofbrug 5366,2018-08-31,20:00:00,97,49,48,FMN GV 16 Berchem TOT
54,Posthofbrug 5366,2018-08-31,21:00:00,73,40,33,FMN GV 16 Berchem TOT
54,Posthofbrug 5366,2018-08-31,22:00:00,65,23,42,FMN GV 16 Berchem TOT
54,Posthofbrug 5366,2018-08-31,23:00:00,54,22,32,FMN GV 16 Berchem TOT
54,Posthofbrug 5366,2018-09-01,00:00:00,50,15,35,FMN GV 16 Berchem TOT
54,Posthofbrug 5366,2018-09-01,01:00:00,10,3,7,FMN GV 16 Berchem TOT
54,Posthofbrug 5366,2018-09-01,02:00:00,12,4,8,FMN GV 16 Berchem TOT
54,Posthofbrug 5366,2018-09-01,03:00:00,8,0,8,FMN GV 16 Berchem TOT
54,Posthofbrug 5366,2018-09-01,04:00:00,12,4,8,FMN GV 16 Berchem TOT
54,Posthofbrug 5366,2018-09-01,05:00:00,20,12,8,FMN GV 16 Berchem TOT
54,Posthofbrug 5366,2018-09-01,06:00:00,16,12,4,FMN GV 16 Berchem TOT
54,Posthofbrug 5366,2018-09-01,07:00:00,35,17,18,FMN GV 16 Berchem TOT
54,Posthofbrug 5366,2018-09-01,08:00:00,61,38,23,FMN GV 16 Berchem TOT
54,Posthofbrug 5366,2018-09-01,09:00:00,103,70,33,FMN GV 16 Berchem TOT
54,Posthofbrug 5366,2018-09-01,10:00:00,108,78,30,FMN GV 16 Berchem TOT
54,Posthofbrug 5366,2018-09-01,11:00:00,138,79,59,FMN GV 16 Berchem TOT
54,Posthofbrug 5366,2018-09-01,12:00:00,138,94,44,FMN GV 16 Berchem TOT
54,Posthofbrug 5366,2018-09-01,13:00:00,165,100,65,FMN GV 16 Berchem TOT
54,Posthofbrug 5366,2018-09-01,14:00:00,136,67,69,FMN GV 16 Berchem TOT
54,Posthofbrug 5366,2018-09-01,15:00:00,146,78,68,FMN GV 16 Berchem TOT
54,Posthofbrug 5366,2018-09-01,16:00:00,133,73,60,FMN GV 16 Berchem TOT
54,Posthofbrug 5366,2018-09-01,17:00:00,171,82,89,FMN GV 16 Berchem TOT
54,Posthofbrug 5366,2018-09-01,18:00:00,116,62,54,FMN GV 16 Berchem TOT
54,Posthofbrug 5366,2018-09-01,19:00:00,140,74,66,FMN GV 16 Berchem TOT
54,Posthofbrug 5366,2018-09-01,20:00:00,128,59,69,FMN GV 16 Berchem TOT
54,Posthofbrug 5366,2018-09-01,21:00:00,77,48,29,FMN GV 16 Berchem TOT
54,Posthofbrug 5366,2018-09-01,22:00:00,87,21,66,FMN GV 16 Berchem TOT
54,Posthofbrug 5366,2018-09-01,23:00:00,51,11,40,FMN GV 16 Berchem TOT
54,Posthofbrug 5366,2018-09-02,00:00:00,28,7,21,FMN GV 16 Berchem TOT
54,Posthofbrug 5366,2018-09-02,01:00:00,18,6,12,FMN GV 16 Berchem TOT
54,Posthofbrug 5366,2018-09-02,02:00:00,29,7,22,FMN GV 16 Berchem TOT
54,Posthofbrug 5366,2018-09-02,03:00:00,14,4,10,FMN GV 16 Berchem TOT
54,Posthofbrug 5366,2018-09-02,04:00:00,16,7,9,FMN GV 16 Berchem TOT
54,Posthofbrug 5366,2018-09-02,05:00:00,12,9,3,FMN GV 16 Berchem TOT
54,Posthofbrug 5366,2018-09-02,06:00:00,9,5,4,FMN GV 16 Berchem TOT
54,Posthofbrug 5366,2018-09-02,07:00:00,26,18,8,FMN GV 16 Berchem TOT
54,Posthofbrug 5366,2018-09-02,08:00:00,40,20,20,FMN GV 16 Berchem TOT
54,Posthofbrug 5366,2018-09-02,09:00:00,79,48,31,FMN GV 16 Berchem TOT
54,Posthofbrug 5366,2018-09-02,10:00:00,128,85,43,FMN GV 16 Berchem TOT
54,Posthofbrug 5366,2018-09-02,11:00:00,144,95,49,FMN GV 16 Berchem TOT
54,Posthofbrug 5366,2018-09-02,12:00:00,178,114,64,FMN GV 16 Berchem TOT
54,Posthofbrug 5366,2018-09-02,13:00:00,208,114,94,FMN GV 16 Berchem TOT
54,Posthofbrug 5366,2018-09-02,14:00:00,206,121,85,FMN GV 16 Berchem TOT
54,Posthofbrug 5366,2018-09-02,15:00:00,209,119,90,FMN GV 16 Berchem TOT
54,Posthofbrug 5366,2018-09-02,16:00:00,158,84,74,FMN GV 16 Berchem TOT
54,Posthofbrug 5366,2018-09-02,17:00:00,210,117,93,FMN GV 16 Berchem TOT
54,Posthofbrug 5366,2018-09-02,18:00:00,179,84,95,FMN GV 16 Berchem TOT
54,Posthofbrug 5366,2018-09-02,19:00:00,103,55,48,FMN GV 16 Berchem TOT
54,Posthofbrug 5366,2018-09-02,20:00:00,100,51,49,FMN GV 16 Berchem TOT
54,Posthofbrug 5366,2018-09-02,21:00:00,102,34,68,FMN GV 16 Berchem TOT
54,Posthofbrug 5366,2018-09-02,22:00:00,42,18,24,FMN GV 16 Berchem TOT
54,Posthofbrug 5366,2018-09-02,23:00:00,20,8,12,FMN GV 16 Berchem TOT
54,Posthofbrug 5366,2018-09-03,00:00:00,14,5,9,FMN GV 16 Berchem TOT
54,Posthofbrug 5366,2018-09-03,01:00:00,7,0,7,FMN GV 16 Berchem TOT
54,Posthofbrug 5366,2018-09-03,02:00:00,0,0,0,FMN GV 16 Berchem TOT
54,Posthofbrug 5366,2018-09-03,03:00:00,2,2,0,FMN GV 16 Berchem TOT
54,Posthofbrug 5366,2018-09-03,04:00:00,11,7,4,FMN GV 16 Berchem TOT
54,Posthofbrug 5366,2018-09-03,05:00:00,22,15,7,FMN GV 16 Berchem TOT
54,Posthofbrug 5366,2018-09-03,06:00:00,112,85,27,FMN GV 16 Berchem TOT
54,Posthofbrug 5366,2018-09-03,07:00:00,435,314,121,FMN GV 16 Berchem TOT
54,Posthofbrug 5366,2018-09-03,08:00:00,664,454,210,FMN GV 16 Berchem TOT
54,Posthofbrug 5366,2018-09-03,09:00:00,293,205,88,FMN GV 16 Berchem TOT
54,Posthofbrug 5366,2018-09-03,10:00:00,120,70,50,FMN GV 16 Berchem TOT
54,Posthofbrug 5366,2018-09-03,11:00:00,101,68,33,FMN GV 16 Berchem TOT
54,Posthofbrug 5366,2018-09-03,12:00:00,133,72,61,FMN GV 16 Berchem TOT
54,Posthofbrug 5366,2018-09-03,13:00:00,124,64,60,FMN GV 16 Berchem TOT
54,Posthofbrug 5366,2018-09-03,14:00:00,130,65,65,FMN GV 16 Berchem TOT
54,Posthofbrug 5366,2018-09-03,15:00:00,211,67,144,FMN GV 16 Berchem TOT
54,Posthofbrug 5366,2018-09-03,16:00:00,382,141,241,FMN GV 16 Berchem TOT
54,Posthofbrug 5366,2018-09-03,17:00:00,535,185,350,FMN GV 16 Berchem TOT
54,Posthofbrug 5366,2018-09-03,18:00:00,315,104,211,FMN GV 16 Berchem TOT
54,Posthofbrug 5366,2018-09-03,19:00:00,165,72,93,FMN GV 16 Berchem TOT
54,Posthofbrug 5366,2018-09-03,20:00:00,72,32,40,FMN GV 16 Berchem TOT
54,Posthofbrug 5366,2018-09-03,21:00:00,59,22,37,FMN GV 16 Berchem TOT
54,Posthofbrug 5366,2018-09-03,22:00:00,44,18,26,FMN GV 16 Berchem TOT
54,Posthofbrug 5366,2018-09-03,23:00:00,25,6,19,FMN GV 16 Berchem TOT
54,Posthofbrug 5366,2018-09-04,00:00:00,10,3,7,FMN GV 16 Berchem TOT
54,Posthofbrug 5366,2018-09-04,01:00:00,3,0,3,FMN GV 16 Berchem TOT
54,Posthofbrug 5366,2018-09-04,02:00:00,3,0,3,FMN GV 16 Berchem TOT
54,Posthofbrug 5366,2018-09-04,03:00:00,1,1,0,FMN GV 16 Berchem TOT
54,Posthofbrug 5366,2018-09-04,04:00:00,5,3,2,FMN GV 16 Berchem TOT
54,Posthofbrug 5366,2018-09-04,05:00:00,19,13,6,FMN GV 16 Berchem TOT
54,Posthofbrug 5366,2018-09-04,06:00:00,134,101,33,FMN GV 16 Berchem TOT
54,Posthofbrug 5366,2018-09-04,07:00:00,493,367,126,FMN GV 16 Berchem TOT
54,Posthofbrug 5366,2018-09-04,08:00:00,672,463,209,FMN GV 16 Berchem TOT
54,Posthofbrug 5366,2018-09-04,09:00:00,198,135,63,FMN GV 16 Berchem TOT
54,Posthofbrug 5366,2018-09-04,10:00:00,89,64,25,FMN GV 16 Berchem TOT
54,Posthofbrug 5366,2018-09-04,11:00:00,81,47,34,FMN GV 16 Berchem TOT
54,Posthofbrug 5366,2018-09-04,12:00:00,131,70,61,FMN GV 16 Berchem TOT
54,Posthofbrug 5366,2018-09-04,13:00:00,122,57,65,FMN GV 16 Berchem TOT
54,Posthofbrug 5366,2018-09-04,14:00:00,111,58,53,FMN GV 16 Berchem TOT
54,Posthofbrug 5366,2018-09-04,15:00:00,221,101,120,FMN GV 16 Berchem TOT
54,Posthofbrug 5366,2018-09-04,16:00:00,428,181,247,FMN GV 16 Berchem TOT
54,Posthofbrug 5366,2018-09-04,17:00:00,552,211,341,FMN GV 16 Berchem TOT
54,Posthofbrug 5366,2018-09-04,18:00:00,341,102,239,FMN GV 16 Berchem TOT
54,Posthofbrug 5366,2018-09-04,19:00:00,153,69,84,FMN GV 16 Berchem TOT
54,Posthofbrug 5366,2018-09-04,20:00:00,113,59,54,FMN GV 16 Berchem TOT
54,Posthofbrug 5366,2018-09-04,21:00:00,74,38,36,FMN GV 16 Berchem TOT
54,Posthofbrug 5366,2018-09-04,22:00:00,72,28,44,FMN GV 16 Berchem TOT
54,Posthofbrug 5366,2018-09-04,23:00:00,39,10,29,FMN GV 16 Berchem TOT
54,Posthofbrug 5366,2018-09-05,00:00:00,33,8,25,FMN GV 16 Berchem TOT
54,Posthofbrug 5366,2018-09-05,01:00:00,4,2,2,FMN GV 16 Berchem TOT
54,Posthofbrug 5366,2018-09-05,02:00:00,2,0,2,FMN GV 16 Berchem TOT
54,Posthofbrug 5366,2018-09-05,03:00:00,3,1,2,FMN GV 16 Berchem TOT
54,Posthofbrug 5366,2018-09-05,04:00:00,9,8,1,FMN GV 16 Berchem TOT
54,Posthofbrug 5366,2018-09-05,05:00:00,19,13,6,FMN GV 16 Berchem TOT
54,Posthofbrug 5366,2018-09-05,06:00:00,120,95,25,FMN GV 16 Berchem TOT
54,Posthofbrug 5366,2018-09-05,07:00:00,438,318,120,FMN GV 16 Berchem TOT
54,Posthofbrug 5366,2018-09-05,08:00:00,597,409,188,FMN GV 16 Berchem TOT
54,Posthofbrug 5366,2018-09-05,09:00:00,194,132,62,FMN GV 16 Berchem TOT
54,Posthofbrug 5366,2018-09-05,10:00:00,99,61,38,FMN GV 16 Berchem TOT
54,Posthofbrug 5366,2018-09-05,11:00:00,99,45,54,FMN GV 16 Berchem TOT
54,Posthofbrug 5366,2018-09-05,12:00:00,239,125,114,FMN GV 16 Berchem TOT
54,Posthofbrug 5366,2018-09-05,13:00:00,149,53,96,FMN GV 16 Berchem TOT
54,Posthofbrug 5366,2018-09-05,14:00:00,138,72,66,FMN GV 16 Berchem TOT
54,Posthofbrug 5366,2018-09-05,15:00:00,183,82,101,FMN GV 16 Berchem TOT
54,Posthofbrug 5366,2018-09-05,16:00:00,337,150,187,FMN GV 16 Berchem TOT
54,Posthofbrug 5366,2018-09-05,17:00:00,521,197,324,FMN GV 16 Berchem TOT
54,Posthofbrug 5366,2018-09-05,18:00:00,309,106,203,FMN GV 16 Berchem TOT
54,Posthofbrug 5366,2018-09-05,19:00:00,127,59,68,FMN GV 16 Berchem TOT
54,Posthofbrug 5366,2018-09-05,20:00:00,64,29,35,FMN GV 16 Berchem TOT
54,Posthofbrug 5366,2018-09-05,21:00:00,54,26,28,FMN GV 16 Berchem TOT
54,Posthofbrug 5366,2018-09-05,22:00:00,46,17,29,FMN GV 16 Berchem TOT
54,Posthofbrug 5366,2018-09-05,23:00:00,33,12,21,FMN GV 16 Berchem TOT
54,Posthofbrug 5366,2018-09-06,00:00:00,14,5,9,FMN GV 16 Berchem TOT
54,Posthofbrug 5366,2018-09-06,01:00:00,2,1,1,FMN GV 16 Berchem TOT
54,Posthofbrug 5366,2018-09-06,02:00:00,1,0,1,FMN GV 16 Berchem TOT
54,Posthofbrug 5366,2018-09-06,03:00:00,1,0,1,FMN GV 16 Berchem TOT
54,Posthofbrug 5366,2018-09-06,04:00:00,17,7,10,FMN GV 16 Berchem TOT
54,Posthofbrug 5366,2018-09-06,05:00:00,25,18,7,FMN GV 16 Berchem TOT
54,Posthofbrug 5366,2018-09-06,06:00:00,110,83,27,FMN GV 16 Berchem TOT
54,Posthofbrug 5366,2018-09-06,07:00:00,450,317,133,FMN GV 16 Berchem TOT
54,Posthofbrug 5366,2018-09-06,08:00:00,621,435,186,FMN GV 16 Berchem TOT
54,Posthofbrug 5366,2018-09-06,09:00:00,196,132,64,FMN GV 16 Berchem TOT
54,Posthofbrug 5366,2018-09-06,10:00:00,76,48,28,FMN GV 16 Berchem TOT
54,Posthofbrug 5366,2018-09-06,11:00:00,74,44,30,FMN GV 16 Berchem TOT
54,Posthofbrug 5366,2018-09-06,12:00:00,115,67,48,FMN GV 16 Berchem TOT
54,Posthofbrug 5366,2018-09-06,13:00:00,112,61,51,FMN GV 16 Berchem TOT
54,Posthofbrug 5366,2018-09-06,14:00:00,101,49,52,FMN GV 16 Berchem TOT
54,Posthofbrug 5366,2018-09-06,15:00:00,211,97,114,FMN GV 16 Berchem TOT
54,Posthofbrug 5366,2018-09-06,16:00:00,376,150,226,FMN GV 16 Berchem TOT
54,Posthofbrug 5366,2018-09-06,17:00:00,507,207,300,FMN GV 16 Berchem TOT
54,Posthofbrug 5366,2018-09-06,18:00:00,322,100,222,FMN GV 16 Berchem TOT
54,Posthofbrug 5366,2018-09-06,19:00:00,147,59,88,FMN GV 16 Berchem TOT
54,Posthofbrug 5366,2018-09-06,20:00:00,102,49,53,FMN GV 16 Berchem TOT
54,Posthofbrug 5366,2018-09-06,21:00:00,76,31,45,FMN GV 16 Berchem TOT
54,Posthofbrug 5366,2018-09-06,22:00:00,68,26,42,FMN GV 16 Berchem TOT
54,Posthofbrug 5366,2018-09-06,23:00:00,48,16,32,FMN GV 16 Berchem TOT
54,Posthofbrug 5366,2018-09-07,00:00:00,31,14,17,FMN GV 16 Berchem TOT
54,Posthofbrug 5366,2018-09-07,01:00:00,11,1,10,FMN GV 16 Berchem TOT
54,Posthofbrug 5366,2018-09-07,02:00:00,7,0,7,FMN GV 16 Berchem TOT
54,Posthofbrug 5366,2018-09-07,03:00:00,5,3,2,FMN GV 16 Berchem TOT
54,Posthofbrug 5366,2018-09-07,04:00:00,10,7,3,FMN GV 16 Berchem TOT
54,Posthofbrug 5366,2018-09-07,05:00:00,19,9,10,FMN GV 16 Berchem TOT
54,Posthofbrug 5366,2018-09-07,06:00:00,98,68,30,FMN GV 16 Berchem TOT
54,Posthofbrug 5366,2018-09-07,07:00:00,367,255,112,FMN GV 16 Berchem TOT
54,Posthofbrug 5366,2018-09-07,08:00:00,583,406,177,FMN GV 16 Berchem TOT
54,Posthofbrug 5366,2018-09-07,09:00:00,184,114,70,FMN GV 16 Berchem TOT
54,Posthofbrug 5366,2018-09-07,10:00:00,83,52,31,FMN GV 16 Berchem TOT
54,Posthofbrug 5366,2018-09-07,11:00:00,81,54,27,FMN GV 16 Berchem TOT
54,Posthofbrug 5366,2018-09-07,12:00:00,141,84,57,FMN GV 16 Berchem TOT
54,Posthofbrug 5366,2018-09-07,13:00:00,134,68,66,FMN GV 16 Berchem TOT
54,Posthofbrug 5366,2018-09-07,14:00:00,132,60,72,FMN GV 16 Berchem TOT
54,Posthofbrug 5366,2018-09-07,15:00:00,250,87,163,FMN GV 16 Berchem TOT
54,Posthofbrug 5366,2018-09-07,16:00:00,352,165,187,FMN GV 16 Berchem TOT
54,Posthofbrug 5366,2018-09-07,17:00:00,427,169,258,FMN GV 16 Berchem TOT
54,Posthofbrug 5366,2018-09-07,18:00:00,236,97,139,FMN GV 16 Berchem TOT
54,Posthofbrug 5366,2018-09-07,19:00:00,158,70,88,FMN GV 16 Berchem TOT
54,Posthofbrug 5366,2018-09-07,20:00:00,95,39,56,FMN GV 16 Berchem TOT
54,Posthofbrug 5366,2018-09-07,21:00:00,95,56,39,FMN GV 16 Berchem TOT
54,Posthofbrug 5366,2018-09-07,22:00:00,53,32,21,FMN GV 16 Berchem TOT
54,Posthofbrug 5366,2018-09-07,23:00:00,60,16,44,FMN GV 16 Berchem TOT
54,Posthofbrug 5366,2018-09-08,00:00:00,47,9,38,FMN GV 16 Berchem TOT
54,Posthofbrug 5366,2018-09-08,01:00:00,27,7,20,FMN GV 16 Berchem TOT
54,Posthofbrug 5366,2018-09-08,02:00:00,7,4,3,FMN GV 16 Berchem TOT
54,Posthofbrug 5366,2018-09-08,03:00:00,14,2,12,FMN GV 16 Berchem TOT
54,Posthofbrug 5366,2018-09-08,04:00:00,16,7,9,FMN GV 16 Berchem TOT
54,Posthofbrug 5366,2018-09-08,05:00:00,9,7,2,FMN GV 16 Berchem TOT
54,Posthofbrug 5366,2018-09-08,06:00:00,22,11,11,FMN GV 16 Berchem TOT
54,Posthofbrug 5366,2018-09-08,07:00:00,23,13,10,FMN GV 16 Berchem TOT
54,Posthofbrug 5366,2018-09-08,08:00:00,66,39,27,FMN GV 16 Berchem TOT
54,Posthofbrug 5366,2018-09-08,09:00:00,86,54,32,FMN GV 16 Berchem TOT
54,Posthofbrug 5366,2018-09-08,10:00:00,88,60,28,FMN GV 16 Berchem TOT
54,Posthofbrug 5366,2018-09-08,11:00:00,126,76,50,FMN GV 16 Berchem TOT
54,Posthofbrug 5366,2018-09-08,12:00:00,115,71,44,FMN GV 16 Berchem TOT
54,Posthofbrug 5366,2018-09-08,13:00:00,129,84,45,FMN GV 16 Berchem TOT
54,Posthofbrug 5366,2018-09-08,14:00:00,154,97,57,FMN GV 16 Berchem TOT
54,Posthofbrug 5366,2018-09-08,15:00:00,145,86,59,FMN GV 16 Berchem TOT
54,Posthofbrug 5366,2018-09-08,16:00:00,123,55,68,FMN GV 16 Berchem TOT
54,Posthofbrug 5366,2018-09-08,17:00:00,114,64,50,FMN GV 16 Berchem TOT
54,Posthofbrug 5366,2018-09-08,18:00:00,131,52,79,FMN GV 16 Berchem TOT
54,Posthofbrug 5366,2018-09-08,19:00:00,98,61,37,FMN GV 16 Berchem TOT
54,Posthofbrug 5366,2018-09-08,20:00:00,57,25,32,FMN GV 16 Berchem TOT
54,Posthofbrug 5366,2018-09-08,21:00:00,62,35,27,FMN GV 16 Berchem TOT
54,Posthofbrug 5366,2018-09-08,22:00:00,71,29,42,FMN GV 16 Berchem TOT
54,Posthofbrug 5366,2018-09-08,23:00:00,54,15,39,FMN GV 16 Berchem TOT
54,Posthofbrug 5366,2018-09-09,00:00:00,43,17,26,FMN GV 16 Berchem TOT
54,Posthofbrug 5366,2018-09-09,01:00:00,30,6,24,FMN GV 16 Berchem TOT
54,Posthofbrug 5366,2018-09-09,02:00:00,25,4,21,FMN GV 16 Berchem TOT
54,Posthofbrug 5366,2018-09-09,03:00:00,10,5,5,FMN GV 16 Berchem TOT
54,Posthofbrug 5366,2018-09-09,04:00:00,19,9,10,FMN GV 16 Berchem TOT
54,Posthofbrug 5366,2018-09-09,05:00:00,10,5,5,FMN GV 16 Berchem TOT
54,Posthofbrug 5366,2018-09-09,06:00:00,21,15,6,FMN GV 16 Berchem TOT
54,Posthofbrug 5366,2018-09-09,07:00:00,18,11,7,FMN GV 16 Berchem TOT
54,Posthofbrug 5366,2018-09-09,08:00:00,29,11,18,FMN GV 16 Berchem TOT
54,Posthofbrug 5366,2018-09-09,09:00:00,74,49,25,FMN GV 16 Berchem TOT
54,Posthofbrug 5366,2018-09-09,10:00:00,111,75,36,FMN GV 16 Berchem TOT
54,Posthofbrug 5366,2018-09-09,11:00:00,132,92,40,FMN GV 16 Berchem TOT
54,Posthofbrug 5366,2018-09-09,12:00:00,146,95,51,FMN GV 16 Berchem TOT
54,Posthofbrug 5366,2018-09-09,13:00:00,175,112,63,FMN GV 16 Berchem TOT
54,Posthofbrug 5366,2018-09-09,14:00:00,197,120,77,FMN GV 16 Berchem TOT
54,Posthofbrug 5366,2018-09-09,15:00:00,178,96,82,FMN GV 16 Berchem TOT
54,Posthofbrug 5366,2018-09-09,16:00:00,147,53,94,FMN GV 16 Berchem TOT
54,Posthofbrug 5366,2018-09-09,17:00:00,134,53,81,FMN GV 16 Berchem TOT
54,Posthofbrug 5366,2018-09-09,18:00:00,130,49,81,FMN GV 16 Berchem TOT
54,Posthofbrug 5366,2018-09-09,19:00:00,85,41,44,FMN GV 16 Berchem TOT
54,Posthofbrug 5366,2018-09-09,20:00:00,63,37,26,FMN GV 16 Berchem TOT
54,Posthofbrug 5366,2018-09-09,21:00:00,54,26,28,FMN GV 16 Berchem TOT
54,Posthofbrug 5366,2018-09-09,22:00:00,45,19,26,FMN GV 16 Berchem TOT
54,Posthofbrug 5366,2018-09-09,23:00:00,18,8,10,FMN GV 16 Berchem TOT
54,Posthofbrug 5366,2018-09-10,00:00:00,9,2,7,FMN GV 16 Berchem TOT
54,Posthofbrug 5366,2018-09-10,01:00:00,4,0,4,FMN GV 16 Berchem TOT
54,Posthofbrug 5366,2018-09-10,02:00:00,4,1,3,FMN GV 16 Berchem TOT
54,Posthofbrug 5366,2018-09-10,03:00:00,1,0,1,FMN GV 16 Berchem TOT
54,Posthofbrug 5366,2018-09-10,04:00:00,7,5,2,FMN GV 16 Berchem TOT
54,Posthofbrug 5366,2018-09-10,05:00:00,22,12,10,FMN GV 16 Berchem TOT
54,Posthofbrug 5366,2018-09-10,06:00:00,111,90,21,FMN GV 16 Berchem TOT
54,Posthofbrug 5366,2018-09-10,07:00:00,464,343,121,FMN GV 16 Berchem TOT
54,Posthofbrug 5366,2018-09-10,08:00:00,705,500,205,FMN GV 16 Berchem TOT
54,Posthofbrug 5366,2018-09-10,09:00:00,194,154,40,FMN GV 16 Berchem TOT
54,Posthofbrug 5366,2018-09-10,10:00:00,101,69,32,FMN GV 16 Berchem TOT
54,Posthofbrug 5366,2018-09-10,11:00:00,93,61,32,FMN GV 16 Berchem TOT
54,Posthofbrug 5366,2018-09-10,12:00:00,131,81,50,FMN GV 16 Berchem TOT
54,Posthofbrug 5366,2018-09-10,13:00:00,106,60,46,FMN GV 16 Berchem TOT
54,Posthofbrug 5366,2018-09-10,14:00:00,124,59,65,FMN GV 16 Berchem TOT
54,Posthofbrug 5366,2018-09-10,15:00:00,213,87,126,FMN GV 16 Berchem TOT
54,Posthofbrug 5366,2018-09-10,16:00:00,437,182,255,FMN GV 16 Berchem TOT
54,Posthofbrug 5366,2018-09-10,17:00:00,506,190,316,FMN GV 16 Berchem TOT
54,Posthofbrug 5366,2018-09-10,18:00:00,346,109,237,FMN GV 16 Berchem TOT
54,Posthofbrug 5366,2018-09-10,19:00:00,168,69,99,FMN GV 16 Berchem TOT
54,Posthofbrug 5366,2018-09-10,20:00:00,84,35,49,FMN GV 16 Berchem TOT
54,Posthofbrug 5366,2018-09-10,21:00:00,67,30,37,FMN GV 16 Berchem TOT
54,Posthofbrug 5366,2018-09-10,22:00:00,76,30,46,FMN GV 16 Berchem TOT
54,Posthofbrug 5366,2018-09-10,23:00:00,32,15,17,FMN GV 16 Berchem TOT
54,Posthofbrug 5366,2018-09-11,00:00:00,13,3,10,FMN GV 16 Berchem TOT
54,Posthofbrug 5366,2018-09-11,01:00:00,9,1,8,FMN GV 16 Berchem TOT
54,Posthofbrug 5366,2018-09-11,02:00:00,3,0,3,FMN GV 16 Berchem TOT
54,Posthofbrug 5366,2018-09-11,03:00:00,5,5,0,FMN GV 16 Berchem TOT
54,Posthofbrug 5366,2018-09-11,04:00:00,11,8,3,FMN GV 16 Berchem TOT
54,Posthofbrug 5366,2018-09-11,05:00:00,22,14,8,FMN GV 16 Berchem TOT
54,Posthofbrug 5366,2018-09-11,06:00:00,120,102,18,FMN GV 16 Berchem TOT
54,Posthofbrug 5366,2018-09-11,07:00:00,496,364,132,FMN GV 16 Berchem TOT
54,Posthofbrug 5366,2018-09-11,08:00:00,754,525,229,FMN GV 16 Berchem TOT
54,Posthofbrug 5366,2018-09-11,09:00:00,220,162,58,FMN GV 16 Berchem TOT
54,Posthofbrug 5366,2018-09-11,10:00:00,112,72,40,FMN GV 16 Berchem TOT
54,Posthofbrug 5366,2018-09-11,11:00:00,106,56,50,FMN GV 16 Berchem TOT
54,Posthofbrug 5366,2018-09-11,12:00:00,168,94,74,FMN GV 16 Berchem TOT
54,Posthofbrug 5366,2018-09-11,13:00:00,129,81,48,FMN GV 16 Berchem TOT
54,Posthofbrug 5366,2018-09-11,14:00:00,156,73,83,FMN GV 16 Berchem TOT
54,Posthofbrug 5366,2018-09-11,15:00:00,200,84,116,FMN GV 16 Berchem TOT
54,Posthofbrug 5366,2018-09-11,16:00:00,408,175,233,FMN GV 16 Berchem TOT
54,Posthofbrug 5366,2018-09-11,17:00:00,522,198,324,FMN GV 16 Berchem TOT
54,Posthofbrug 5366,2018-09-11,18:00:00,397,132,265,FMN GV 16 Berchem TOT
54,Posthofbrug 5366,2018-09-11,19:00:00,172,65,107,FMN GV 16 Berchem TOT
54,Posthofbrug 5366,2018-09-11,20:00:00,103,51,52,FMN GV 16 Berchem TOT
54,Posthofbrug 5366,2018-09-11,21:00:00,80,37,43,FMN GV 16 Berchem TOT
54,Posthofbrug 5366,2018-09-11,22:00:00,88,30,58,FMN GV 16 Berchem TOT
54,Posthofbrug 5366,2018-09-11,23:00:00,43,12,31,FMN GV 16 Berchem TOT
54,Posthofbrug 5366,2018-09-12,00:00:00,19,6,13,FMN GV 16 Berchem TOT
54,Posthofbrug 5366,2018-09-12,01:00:00,5,1,4,FMN GV 16 Berchem TOT
54,Posthofbrug 5366,2018-09-12,02:00:00,21,10,11,FMN GV 16 Berchem TOT
54,Posthofbrug 5366,2018-09-12,03:00:00,5,0,5,FMN GV 16 Berchem TOT
54,Posthofbrug 5366,2018-09-12,04:00:00,11,7,4,FMN GV 16 Berchem TOT
54,Posthofbrug 5366,2018-09-12,05:00:00,18,12,6,FMN GV 16 Berchem TOT
54,Posthofbrug 5366,2018-09-12,06:00:00,107,83,24,FMN GV 16 Berchem TOT
54,Posthofbrug 5366,2018-09-12,07:00:00,445,318,127,FMN GV 16 Berchem TOT
54,Posthofbrug 5366,2018-09-12,08:00:00,592,421,171,FMN GV 16 Berchem TOT
54,Posthofbrug 5366,2018-09-12,09:00:00,182,133,49,FMN GV 16 Berchem TOT
54,Posthofbrug 5366,2018-09-12,10:00:00,93,58,35,FMN GV 16 Berchem TOT
54,Posthofbrug 5366,2018-09-12,11:00:00,96,44,52,FMN GV 16 Berchem TOT
54,Posthofbrug 5366,2018-09-12,12:00:00,194,95,99,FMN GV 16 Berchem TOT
54,Posthofbrug 5366,2018-09-12,13:00:00,147,63,84,FMN GV 16 Berchem TOT
54,Posthofbrug 5366,2018-09-12,14:00:00,116,41,75,FMN GV 16 Berchem TOT
54,Posthofbrug 5366,2018-09-12,15:00:00,135,56,79,FMN GV 16 Berchem TOT
54,Posthofbrug 5366,2018-09-12,16:00:00,300,131,169,FMN GV 16 Berchem TOT
54,Posthofbrug 5366,2018-09-12,17:00:00,446,157,289,FMN GV 16 Berchem TOT
54,Posthofbrug 5366,2018-09-12,18:00:00,299,96,203,FMN GV 16 Berchem TOT
54,Posthofbrug 5366,2018-09-12,19:00:00,111,40,71,FMN GV 16 Berchem TOT
54,Posthofbrug 5366,2018-09-12,20:00:00,75,40,35,FMN GV 16 Berchem TOT
54,Posthofbrug 5366,2018-09-12,21:00:00,43,14,29,FMN GV 16 Berchem TOT
54,Posthofbrug 5366,2018-09-12,22:00:00,67,28,39,FMN GV 16 Berchem TOT
54,Posthofbrug 5366,2018-09-12,23:00:00,32,14,18,FMN GV 16 Berchem TOT
54,Posthofbrug 5366,2018-09-13,00:00:00,19,8,11,FMN GV 16 Berchem TOT
54,Posthofbrug 5366,2018-09-13,01:00:00,6,0,6,FMN GV 16 Berchem TOT
54,Posthofbrug 5366,2018-09-13,02:00:00,1,0,1,FMN GV 16 Berchem TOT
54,Posthofbrug 5366,2018-09-13,03:00:00,3,2,1,FMN GV 16 Berchem TOT
54,Posthofbrug 5366,2018-09-13,04:00:00,9,6,3,FMN GV 16 Berchem TOT
54,Posthofbrug 5366,2018-09-13,05:00:00,25,17,8,FMN GV 16 Berchem TOT
54,Posthofbrug 5366,2018-09-13,06:00:00,107,91,16,FMN GV 16 Berchem TOT
54,Posthofbrug 5366,2018-09-13,07:00:00,349,246,103,FMN GV 16 Berchem TOT
54,Posthofbrug 5366,2018-09-13,08:00:00,634,446,188,FMN GV 16 Berchem TOT
54,Posthofbrug 5366,2018-09-13,09:00:00,192,139,53,FMN GV 16 Berchem TOT
54,Posthofbrug 5366,2018-09-13,10:00:00,106,69,37,FMN GV 16 Berchem TOT
54,Posthofbrug 5366,2018-09-13,11:00:00,98,66,32,FMN GV 16 Berchem TOT
54,Posthofbrug 5366,2018-09-13,12:00:00,124,76,48,FMN GV 16 Berchem TOT
54,Posthofbrug 5366,2018-09-13,13:00:00,141,78,63,FMN GV 16 Berchem TOT
54,Posthofbrug 5366,2018-09-13,14:00:00,127,57,70,FMN GV 16 Berchem TOT
54,Posthofbrug 5366,2018-09-13,15:00:00,236,128,108,FMN GV 16 Berchem TOT
54,Posthofbrug 5366,2018-09-13,16:00:00,397,154,243,FMN GV 16 Berchem TOT
54,Posthofbrug 5366,2018-09-13,17:00:00,489,170,319,FMN GV 16 Berchem TOT
54,Posthofbrug 5366,2018-09-13,18:00:00,331,120,211,FMN GV 16 Berchem TOT
54,Posthofbrug 5366,2018-09-13,19:00:00,174,65,109,FMN GV 16 Berchem TOT
54,Posthofbrug 5366,2018-09-13,20:00:00,136,60,76,FMN GV 16 Berchem TOT
54,Posthofbrug 5366,2018-09-13,21:00:00,81,34,47,FMN GV 16 Berchem TOT
54,Posthofbrug 5366,2018-09-13,22:00:00,78,19,59,FMN GV 16 Berchem TOT
54,Posthofbrug 5366,2018-09-13,23:00:00,45,18,27,FMN GV 16 Berchem TOT
54,Posthofbrug 5366,2018-09-14,00:00:00,24,13,11,FMN GV 16 Berchem TOT
54,Posthofbrug 5366,2018-09-14,01:00:00,4,1,3,FMN GV 16 Berchem TOT
54,Posthofbrug 5366,2018-09-14,02:00:00,3,0,3,FMN GV 16 Berchem TOT
54,Posthofbrug 5366,2018-09-14,03:00:00,6,1,5,FMN GV 16 Berchem TOT
54,Posthofbrug 5366,2018-09-14,04:00:00,12,8,4,FMN GV 16 Berchem TOT
54,Posthofbrug 5366,2018-09-14,05:00:00,23,16,7,FMN GV 16 Berchem TOT
54,Posthofbrug 5366,2018-09-14,06:00:00,99,79,20,FMN GV 16 Berchem TOT
54,Posthofbrug 5366,2018-09-14,07:00:00,417,295,122,FMN GV 16 Berchem TOT
54,Posthofbrug 5366,2018-09-14,08:00:00,585,411,174,FMN GV 16 Berchem TOT
54,Posthofbrug 5366,2018-09-14,09:00:00,214,155,59,FMN GV 16 Berchem TOT
54,Posthofbrug 5366,2018-09-14,10:00:00,97,69,28,FMN GV 16 Berchem TOT
54,Posthofbrug 5366,2018-09-14,11:00:00,79,51,28,FMN GV 16 Berchem TOT
54,Posthofbrug 5366,2018-09-14,12:00:00,137,81,56,FMN GV 16 Berchem TOT
54,Posthofbrug 5366,2018-09-14,13:00:00,131,66,65,FMN GV 16 Berchem TOT
54,Posthofbrug 5366,2018-09-14,14:00:00,127,58,69,FMN GV 16 Berchem TOT
54,Posthofbrug 5366,2018-09-14,15:00:00,242,85,157,FMN GV 16 Berchem TOT
54,Posthofbrug 5366,2018-09-14,16:00:00,350,164,186,FMN GV 16 Berchem TOT
54,Posthofbrug 5366,2018-09-14,17:00:00,424,168,256,FMN GV 16 Berchem TOT
54,Posthofbrug 5366,2018-09-14,18:00:00,233,96,137,FMN GV 16 Berchem TOT
54,Posthofbrug 5366,2018-09-14,19:00:00,157,70,87,FMN GV 16 Berchem TOT
54,Posthofbrug 5366,2018-09-14,20:00:00,95,39,56,FMN GV 16 Berchem TOT
54,Posthofbrug 5366,2018-09-14,21:00:00,94,56,38,FMN GV 16 Berchem TOT
54,Posthofbrug 5366,2018-09-14,22:00:00,58,25,33,FMN GV 16 Berchem TOT
54,Posthofbrug 5366,2018-09-14,23:00:00,57,22,35,FMN GV 16 Berchem TOT
54,Posthofbrug 5366,2018-09-15,00:00:00,50,16,34,FMN GV 16 Berchem TOT
54,Posthofbrug 5366,2018-09-15,01:00:00,27,10,17,FMN GV 16 Berchem TOT
54,Posthofbrug 5366,2018-09-15,02:00:00,25,12,13,FMN GV 16 Berchem TOT
54,Posthofbrug 5366,2018-09-15,03:00:00,10,2,8,FMN GV 16 Berchem TOT
54,Posthofbrug 5366,2018-09-15,04:00:00,15,2,13,FMN GV 16 Berchem TOT
54,Posthofbrug 5366,2018-09-15,05:00:00,12,5,7,FMN GV 16 Berchem TOT
54,Posthofbrug 5366,2018-09-15,06:00:00,10,8,2,FMN GV 16 Berchem TOT
54,Posthofbrug 5366,2018-09-15,07:00:00,28,13,15,FMN GV 16 Berchem TOT
54,Posthofbrug 5366,2018-09-15,08:00:00,55,34,21,FMN GV 16 Berchem TOT
54,Posthofbrug 5366,2018-09-15,09:00:00,93,66,27,FMN GV 16 Berchem TOT
54,Posthofbrug 5366,2018-09-15,10:00:00,106,68,38,FMN GV 16 Berchem TOT
54,Posthofbrug 5366,2018-09-15,11:00:00,80,49,31,FMN GV 16 Berchem TOT
54,Posthofbrug 5366,2018-09-15,12:00:00,100,73,27,FMN GV 16 Berchem TOT
54,Posthofbrug 5366,2018-09-15,13:00:00,116,76,40,FMN GV 16 Berchem TOT
54,Posthofbrug 5366,2018-09-15,14:00:00,136,72,64,FMN GV 16 Berchem TOT
54,Posthofbrug 5366,2018-09-15,15:00:00,135,66,69,FMN GV 16 Berchem TOT
54,Posthofbrug 5366,2018-09-15,16:00:00,124,65,59,FMN GV 16 Berchem TOT
54,Posthofbrug 5366,2018-09-15,17:00:00,120,61,59,FMN GV 16 Berchem TOT
54,Posthofbrug 5366,2018-09-15,18:00:00,42,15,27,FMN GV 16 Berchem TOT
54,Posthofbrug 5366,2018-09-15,19:00:00,0,0,0,FMN GV 16 Berchem TOT
54,Posthofbrug 5366,2018-09-15,20:00:00,24,11,13,FMN GV 16 Berchem TOT
54,Posthofbrug 5366,2018-09-15,21:00:00,0,0,0,FMN GV 16 Berchem TOT
54,Posthofbrug 5366,2018-09-15,22:00:00,56,23,33,FMN GV 16 Berchem TOT
54,Posthofbrug 5366,2018-09-15,23:00:00,49,15,34,FMN GV 16 Berchem TOT
54,Posthofbrug 5366,2018-09-16,00:00:00,44,14,30,FMN GV 16 Berchem TOT
54,Posthofbrug 5366,2018-09-16,01:00:00,27,12,15,FMN GV 16 Berchem TOT
54,Posthofbrug 5366,2018-09-16,02:00:00,19,5,14,FMN GV 16 Berchem TOT
54,Posthofbrug 5366,2018-09-16,03:00:00,5,1,4,FMN GV 16 Berchem TOT
54,Posthofbrug 5366,2018-09-16,04:00:00,10,0,10,FMN GV 16 Berchem TOT
54,Posthofbrug 5366,2018-09-16,05:00:00,9,5,4,FMN GV 16 Berchem TOT
54,Posthofbrug 5366,2018-09-16,06:00:00,12,10,2,FMN GV 16 Berchem TOT
54,Posthofbrug 5366,2018-09-16,07:00:00,20,11,9,FMN GV 16 Berchem TOT
54,Posthofbrug 5366,2018-09-16,08:00:00,38,20,18,FMN GV 16 Berchem TOT
54,Posthofbrug 5366,2018-09-16,09:00:00,92,60,32,FMN GV 16 Berchem TOT
54,Posthofbrug 5366,2018-09-16,10:00:00,141,110,31,FMN GV 16 Berchem TOT
54,Posthofbrug 5366,2018-09-16,11:00:00,215,160,55,FMN GV 16 Berchem TOT
54,Posthofbrug 5366,2018-09-16,12:00:00,226,157,69,FMN GV 16 Berchem TOT
54,Posthofbrug 5366,2018-09-16,13:00:00,328,236,92,FMN GV 16 Berchem TOT
54,Posthofbrug 5366,2018-09-16,14:00:00,316,224,92,FMN GV 16 Berchem TOT
54,Posthofbrug 5366,2018-09-16,15:00:00,289,143,146,FMN GV 16 Berchem TOT
54,Posthofbrug 5366,2018-09-16,16:00:00,235,77,158,FMN GV 16 Berchem TOT
54,Posthofbrug 5366,2018-09-16,17:00:00,241,76,165,FMN GV 16 Berchem TOT
54,Posthofbrug 5366,2018-09-16,18:00:00,180,40,140,FMN GV 16 Berchem TOT
54,Posthofbrug 5366,2018-09-16,19:00:00,99,34,65,FMN GV 16 Berchem TOT
54,Posthofbrug 5366,2018-09-16,20:00:00,70,31,39,FMN GV 16 Berchem TOT
54,Posthofbrug 5366,2018-09-16,21:00:00,53,23,30,FMN GV 16 Berchem TOT
54,Posthofbrug 5366,2018-09-16,22:00:00,40,19,21,FMN GV 16 Berchem TOT
54,Posthofbrug 5366,2018-09-16,23:00:00,18,6,12,FMN GV 16 Berchem TOT
54,Posthofbrug 5366,2018-09-17,00:00:00,11,3,8,FMN GV 16 Berchem TOT
54,Posthofbrug 5366,2018-09-17,01:00:00,6,2,4,FMN GV 16 Berchem TOT
54,Posthofbrug 5366,2018-09-17,02:00:00,2,2,0,FMN GV 16 Berchem TOT
54,Posthofbrug 5366,2018-09-17,03:00:00,0,0,0,FMN GV 16 Berchem TOT
54,Posthofbrug 5366,2018-09-17,04:00:00,11,10,1,FMN GV 16 Berchem TOT
54,Posthofbrug 5366,2018-09-17,05:00:00,18,12,6,FMN GV 16 Berchem TOT
54,Posthofbrug 5366,2018-09-17,06:00:00,106,86,20,FMN GV 16 Berchem TOT
54,Posthofbrug 5366,2018-09-17,07:00:00,471,335,136,FMN GV 16 Berchem TOT
54,Posthofbrug 5366,2018-09-17,08:00:00,759,539,220,FMN GV 16 Berchem TOT
54,Posthofbrug 5366,2018-09-17,09:00:00,215,157,58,FMN GV 16 Berchem TOT
54,Posthofbrug 5366,2018-09-17,10:00:00,107,81,26,FMN GV 16 Berchem TOT
54,Posthofbrug 5366,2018-09-17,11:00:00,128,73,55,FMN GV 16 Berchem TOT
54,Posthofbrug 5366,2018-09-17,12:00:00,132,87,45,FMN GV 16 Berchem TOT
54,Posthofbrug 5366,2018-09-17,13:00:00,171,106,65,FMN GV 16 Berchem TOT
54,Posthofbrug 5366,2018-09-17,14:00:00,130,57,73,FMN GV 16 Berchem TOT
54,Posthofbrug 5366,2018-09-17,15:00:00,265,116,149,FMN GV 16 Berchem TOT
54,Posthofbrug 5366,2018-09-17,16:00:00,439,177,262,FMN GV 16 Berchem TOT
54,Posthofbrug 5366,2018-09-17,17:00:00,563,194,369,FMN GV 16 Berchem TOT
54,Posthofbrug 5366,2018-09-17,18:00:00,381,131,250,FMN GV 16 Berchem TOT
54,Posthofbrug 5366,2018-09-17,19:00:00,171,72,99,FMN GV 16 Berchem TOT
54,Posthofbrug 5366,2018-09-17,20:00:00,108,63,45,FMN GV 16 Berchem TOT
54,Posthofbrug 5366,2018-09-17,21:00:00,86,38,48,FMN GV 16 Berchem TOT
54,Posthofbrug 5366,2018-09-17,22:00:00,57,21,36,FMN GV 16 Berchem TOT
54,Posthofbrug 5366,2018-09-17,23:00:00,32,14,18,FMN GV 16 Berchem TOT
54,Posthofbrug 5366,2018-09-18,00:00:00,9,2,7,FMN GV 16 Berchem TOT
54,Posthofbrug 5366,2018-09-18,01:00:00,5,1,4,FMN GV 16 Berchem TOT
54,Posthofbrug 5366,2018-09-18,02:00:00,2,1,1,FMN GV 16 Berchem TOT
54,Posthofbrug 5366,2018-09-18,03:00:00,0,0,0,FMN GV 16 Berchem TOT
54,Posthofbrug 5366,2018-09-18,04:00:00,10,9,1,FMN GV 16 Berchem TOT
54,Posthofbrug 5366,2018-09-18,05:00:00,23,14,9,FMN GV 16 Berchem TOT
54,Posthofbrug 5366,2018-09-18,06:00:00,139,111,28,FMN GV 16 Berchem TOT
54,Posthofbrug 5366,2018-09-18,07:00:00,528,391,137,FMN GV 16 Berchem TOT
54,Posthofbrug 5366,2018-09-18,08:00:00,786,558,228,FMN GV 16 Berchem TOT
54,Posthofbrug 5366,2018-09-18,09:00:00,227,171,56,FMN GV 16 Berchem TOT
54,Posthofbrug 5366,2018-09-18,10:00:00,120,82,38,FMN GV 16 Berchem TOT
54,Posthofbrug 5366,2018-09-18,11:00:00,147,90,57,FMN GV 16 Berchem TOT
54,Posthofbrug 5366,2018-09-18,12:00:00,152,94,58,FMN GV 16 Berchem TOT
54,Posthofbrug 5366,2018-09-18,13:00:00,143,87,56,FMN GV 16 Berchem TOT
54,Posthofbrug 5366,2018-09-18,14:00:00,139,62,77,FMN GV 16 Berchem TOT
54,Posthofbrug 5366,2018-09-18,15:00:00,302,130,172,FMN GV 16 Berchem TOT
54,Posthofbrug 5366,2018-09-18,16:00:00,464,165,299,FMN GV 16 Berchem TOT
54,Posthofbrug 5366,2018-09-18,17:00:00,560,187,373,FMN GV 16 Berchem TOT
54,Posthofbrug 5366,2018-09-18,18:00:00,367,140,227,FMN GV 16 Berchem TOT
54,Posthofbrug 5366,2018-09-18,19:00:00,180,74,106,FMN GV 16 Berchem TOT
54,Posthofbrug 5366,2018-09-18,20:00:00,145,77,68,FMN GV 16 Berchem TOT
54,Posthofbrug 5366,2018-09-18,21:00:00,106,47,59,FMN GV 16 Berchem TOT
54,Posthofbrug 5366,2018-09-18,22:00:00,100,22,78,FMN GV 16 Berchem TOT
54,Posthofbrug 5366,2018-09-18,23:00:00,46,19,27,FMN GV 16 Berchem TOT
54,Posthofbrug 5366,2018-09-19,00:00:00,16,5,11,FMN GV 16 Berchem TOT
54,Posthofbrug 5366,2018-09-19,01:00:00,8,3,5,FMN GV 16 Berchem TOT
54,Posthofbrug 5366,2018-09-19,02:00:00,3,1,2,FMN GV 16 Berchem TOT
54,Posthofbrug 5366,2018-09-19,03:00:00,8,2,6,FMN GV 16 Berchem TOT
54,Posthofbrug 5366,2018-09-19,04:00:00,9,8,1,FMN GV 16 Berchem TOT
54,Posthofbrug 5366,2018-09-19,05:00:00,18,10,8,FMN GV 16 Berchem TOT
54,Posthofbrug 5366,2018-09-19,06:00:00,48,40,8,FMN GV 16 Berchem TOT
54,Posthofbrug 5366,2018-09-19,07:00:00,0,0,0,FMN GV 16 Berchem TOT
54,Posthofbrug 5366,2018-09-19,08:00:00,552,367,185,FMN GV 16 Berchem TOT
54,Posthofbrug 5366,2018-09-19,09:00:00,200,134,66,FMN GV 16 Berchem TOT
54,Posthofbrug 5366,2018-09-19,10:00:00,127,88,39,FMN GV 16 Berchem TOT
54,Posthofbrug 5366,2018-09-19,11:00:00,141,83,58,FMN GV 16 Berchem TOT
54,Posthofbrug 5366,2018-09-19,12:00:00,261,127,134,FMN GV 16 Berchem TOT
54,Posthofbrug 5366,2018-09-19,13:00:00,165,87,78,FMN GV 16 Berchem TOT
54,Posthofbrug 5366,2018-09-19,14:00:00,178,75,103,FMN GV 16 Berchem TOT
54,Posthofbrug 5366,2018-09-19,15:00:00,211,86,125,FMN GV 16 Berchem TOT
54,Posthofbrug 5366,2018-09-19,16:00:00,343,138,205,FMN GV 16 Berchem TOT
54,Posthofbrug 5366,2018-09-19,17:00:00,495,173,322,FMN GV 16 Berchem TOT
54,Posthofbrug 5366,2018-09-19,18:00:00,335,113,222,FMN GV 16 Berchem TOT
54,Posthofbrug 5366,2018-09-19,19:00:00,145,69,76,FMN GV 16 Berchem TOT
54,Posthofbrug 5366,2018-09-19,20:00:00,100,49,51,FMN GV 16 Berchem TOT
54,Posthofbrug 5366,2018-09-19,21:00:00,72,33,39,FMN GV 16 Berchem TOT
54,Posthofbrug 5366,2018-09-19,22:00:00,80,33,47,FMN GV 16 Berchem TOT
54,Posthofbrug 5366,2018-09-19,23:00:00,43,20,23,FMN GV 16 Berchem TOT
54,Posthofbrug 5366,2018-09-20,00:00:00,18,7,11,FMN GV 16 Berchem TOT
54,Posthofbrug 5366,2018-09-20,01:00:00,4,0,4,FMN GV 16 Berchem TOT
54,Posthofbrug 5366,2018-09-20,02:00:00,6,0,6,FMN GV 16 Berchem TOT
54,Posthofbrug 5366,2018-09-20,03:00:00,3,0,3,FMN GV 16 Berchem TOT
54,Posthofbrug 5366,2018-09-20,04:00:00,9,4,5,FMN GV 16 Berchem TOT
54,Posthofbrug 5366,2018-09-20,05:00:00,21,16,5,FMN GV 16 Berchem TOT
54,Posthofbrug 5366,2018-09-20,06:00:00,115,93,22,FMN GV 16 Berchem TOT
54,Posthofbrug 5366,2018-09-20,07:00:00,505,357,148,FMN GV 16 Berchem TOT
54,Posthofbrug 5366,2018-09-20,08:00:00,693,481,212,FMN GV 16 Berchem TOT
54,Posthofbrug 5366,2018-09-20,09:00:00,254,186,68,FMN GV 16 Berchem TOT
54,Posthofbrug 5366,2018-09-20,10:00:00,111,78,33,FMN GV 16 Berchem TOT
54,Posthofbrug 5366,2018-09-20,11:00:00,123,81,42,FMN GV 16 Berchem TOT
54,Posthofbrug 5366,2018-09-20,12:00:00,147,87,60,FMN GV 16 Berchem TOT
54,Posthofbrug 5366,2018-09-20,13:00:00,142,87,55,FMN GV 16 Berchem TOT
54,Posthofbrug 5366,2018-09-20,14:00:00,112,52,60,FMN GV 16 Berchem TOT
54,Posthofbrug 5366,2018-09-20,15:00:00,264,115,149,FMN GV 16 Berchem TOT
54,Posthofbrug 5366,2018-09-20,16:00:00,427,178,249,FMN GV 16 Berchem TOT
54,Posthofbrug 5366,2018-09-20,17:00:00,518,186,332,FMN GV 16 Berchem TOT
54,Posthofbrug 5366,2018-09-20,18:00:00,360,135,225,FMN GV 16 Berchem TOT
54,Posthofbrug 5366,2018-09-20,19:00:00,178,66,112,FMN GV 16 Berchem TOT
54,Posthofbrug 5366,2018-09-20,20:00:00,109,56,53,FMN GV 16 Berchem TOT
54,Posthofbrug 5366,2018-09-20,21:00:00,74,33,41,FMN GV 16 Berchem TOT
54,Posthofbrug 5366,2018-09-20,22:00:00,101,47,54,FMN GV 16 Berchem TOT
54,Posthofbrug 5366,2018-09-20,23:00:00,56,26,30,FMN GV 16 Berchem TOT
54,Posthofbrug 5366,2018-09-21,00:00:00,24,12,12,FMN GV 16 Berchem TOT
54,Posthofbrug 5366,2018-09-21,01:00:00,10,3,7,FMN GV 16 Berchem TOT
54,Posthofbrug 5366,2018-09-21,02:00:00,8,3,5,FMN GV 16 Berchem TOT
54,Posthofbrug 5366,2018-09-21,03:00:00,4,0,4,FMN GV 16 Berchem TOT
54,Posthofbrug 5366,2018-09-21,04:00:00,8,6,2,FMN GV 16 Berchem TOT
54,Posthofbrug 5366,2018-09-21,05:00:00,20,12,8,FMN GV 16 Berchem TOT
54,Posthofbrug 5366,2018-09-21,06:00:00,84,70,14,FMN GV 16 Berchem TOT
54,Posthofbrug 5366,2018-09-21,07:00:00,297,227,70,FMN GV 16 Berchem TOT
54,Posthofbrug 5366,2018-09-21,08:00:00,368,259,109,FMN GV 16 Berchem TOT
54,Posthofbrug 5366,2018-09-21,09:00:00,166,95,71,FMN GV 16 Berchem TOT
54,Posthofbrug 5366,2018-09-21,10:00:00,63,54,9,FMN GV 16 Berchem TOT
54,Posthofbrug 5366,2018-09-21,11:00:00,67,42,25,FMN GV 16 Berchem TOT
54,Posthofbrug 5366,2018-09-21,12:00:00,102,59,43,FMN GV 16 Berchem TOT
54,Posthofbrug 5366,2018-09-21,13:00:00,109,65,44,FMN GV 16 Berchem TOT
54,Posthofbrug 5366,2018-09-21,14:00:00,114,50,64,FMN GV 16 Berchem TOT
54,Posthofbrug 5366,2018-09-21,15:00:00,159,71,88,FMN GV 16 Berchem TOT
54,Posthofbrug 5366,2018-09-21,16:00:00,317,140,177,FMN GV 16 Berchem TOT
54,Posthofbrug 5366,2018-09-21,17:00:00,316,123,193,FMN GV 16 Berchem TOT
54,Posthofbrug 5366,2018-09-21,18:00:00,208,85,123,FMN GV 16 Berchem TOT
54,Posthofbrug 5366,2018-09-21,19:00:00,124,58,66,FMN GV 16 Berchem TOT
54,Posthofbrug 5366,2018-09-21,20:00:00,77,34,43,FMN GV 16 Berchem TOT
54,Posthofbrug 5366,2018-09-21,21:00:00,75,51,24,FMN GV 16 Berchem TOT
54,Posthofbrug 5366,2018-09-21,22:00:00,56,22,34,FMN GV 16 Berchem TOT
54,Posthofbrug 5366,2018-09-21,23:00:00,75,23,52,FMN GV 16 Berchem TOT
54,Posthofbrug 5366,2018-09-22,00:00:00,33,14,19,FMN GV 16 Berchem TOT
54,Posthofbrug 5366,2018-09-22,01:00:00,31,9,22,FMN GV 16 Berchem TOT
54,Posthofbrug 5366,2018-09-22,02:00:00,11,1,10,FMN GV 16 Berchem TOT
54,Posthofbrug 5366,2018-09-22,03:00:00,9,3,6,FMN GV 16 Berchem TOT
54,Posthofbrug 5366,2018-09-22,04:00:00,12,8,4,FMN GV 16 Berchem TOT
54,Posthofbrug 5366,2018-09-22,05:00:00,17,9,8,FMN GV 16 Berchem TOT
54,Posthofbrug 5366,2018-09-22,06:00:00,23,9,14,FMN GV 16 Berchem TOT
54,Posthofbrug 5366,2018-09-22,07:00:00,27,13,14,FMN GV 16 Berchem TOT
54,Posthofbrug 5366,2018-09-22,08:00:00,68,41,27,FMN GV 16 Berchem TOT
54,Posthofbrug 5366,2018-09-22,09:00:00,78,47,31,FMN GV 16 Berchem TOT
54,Posthofbrug 5366,2018-09-22,10:00:00,98,71,27,FMN GV 16 Berchem TOT
54,Posthofbrug 5366,2018-09-22,11:00:00,120,74,46,FMN GV 16 Berchem TOT
54,Posthofbrug 5366,2018-09-22,12:00:00,127,64,63,FMN GV 16 Berchem TOT
54,Posthofbrug 5366,2018-09-22,13:00:00,89,47,42,FMN GV 16 Berchem TOT
54,Posthofbrug 5366,2018-09-22,14:00:00,100,48,52,FMN GV 16 Berchem TOT
54,Posthofbrug 5366,2018-09-22,15:00:00,69,34,35,FMN GV 16 Berchem TOT
54,Posthofbrug 5366,2018-09-22,16:00:00,85,37,48,FMN GV 16 Berchem TOT
54,Posthofbrug 5366,2018-09-22,17:00:00,98,45,53,FMN GV 16 Berchem TOT
54,Posthofbrug 5366,2018-09-22,18:00:00,88,46,42,FMN GV 16 Berchem TOT
54,Posthofbrug 5366,2018-09-22,19:00:00,49,31,18,FMN GV 16 Berchem TOT
54,Posthofbrug 5366,2018-09-22,20:00:00,24,16,8,FMN GV 16 Berchem TOT
54,Posthofbrug 5366,2018-09-22,21:00:00,26,13,13,FMN GV 16 Berchem TOT
54,Posthofbrug 5366,2018-09-22,22:00:00,33,15,18,FMN GV 16 Berchem TOT
54,Posthofbrug 5366,2018-09-22,23:00:00,32,17,15,FMN GV 16 Berchem TOT
54,Posthofbrug 5366,2018-09-23,00:00:00,26,12,14,FMN GV 16 Berchem TOT
54,Posthofbrug 5366,2018-09-23,01:00:00,13,8,5,FMN GV 16 Berchem TOT
54,Posthofbrug 5366,2018-09-23,02:00:00,12,3,9,FMN GV 16 Berchem TOT
54,Posthofbrug 5366,2018-09-23,03:00:00,5,2,3,FMN GV 16 Berchem TOT
54,Posthofbrug 5366,2018-09-23,04:00:00,6,2,4,FMN GV 16 Berchem TOT
54,Posthofbrug 5366,2018-09-23,05:00:00,3,1,2,FMN GV 16 Berchem TOT
54,Posthofbrug 5366,2018-09-23,06:00:00,13,8,5,FMN GV 16 Berchem TOT
54,Posthofbrug 5366,2018-09-23,07:00:00,22,9,13,FMN GV 16 Berchem TOT
54,Posthofbrug 5366,2018-09-23,08:00:00,16,10,6,FMN GV 16 Berchem TOT
54,Posthofbrug 5366,2018-09-23,09:00:00,28,14,14,FMN GV 16 Berchem TOT
54,Posthofbrug 5366,2018-09-23,10:00:00,37,25,12,FMN GV 16 Berchem TOT
54,Posthofbrug 5366,2018-09-23,11:00:00,29,23,6,FMN GV 16 Berchem TOT
54,Posthofbrug 5366,2018-09-23,12:00:00,35,23,12,FMN GV 16 Berchem TOT
54,Posthofbrug 5366,2018-09-23,13:00:00,24,15,9,FMN GV 16 Berchem TOT
54,Posthofbrug 5366,2018-09-23,14:00:00,28,21,7,FMN GV 16 Berchem TOT
54,Posthofbrug 5366,2018-09-23,15:00:00,34,14,20,FMN GV 16 Berchem TOT
54,Posthofbrug 5366,2018-09-23,16:00:00,39,19,20,FMN GV 16 Berchem TOT
54,Posthofbrug 5366,2018-09-23,17:00:00,40,19,21,FMN GV 16 Berchem TOT
54,Posthofbrug 5366,2018-09-23,18:00:00,24,11,13,FMN GV 16 Berchem TOT
54,Posthofbrug 5366,2018-09-23,19:00:00,21,9,12,FMN GV 16 Berchem TOT
54,Posthofbrug 5366,2018-09-23,20:00:00,22,9,13,FMN GV 16 Berchem TOT
54,Posthofbrug 5366,2018-09-23,21:00:00,28,10,18,FMN GV 16 Berchem TOT
54,Posthofbrug 5366,2018-09-23,22:00:00,17,10,7,FMN GV 16 Berchem TOT
54,Posthofbrug 5366,2018-09-23,23:00:00,9,3,6,FMN GV 16 Berchem TOT
54,Posthofbrug 5366,2018-09-24,00:00:00,6,4,2,FMN GV 16 Berchem TOT
54,Posthofbrug 5366,2018-09-24,01:00:00,4,3,1,FMN GV 16 Berchem TOT
54,Posthofbrug 5366,2018-09-24,02:00:00,4,1,3,FMN GV 16 Berchem TOT
54,Posthofbrug 5366,2018-09-24,03:00:00,5,4,1,FMN GV 16 Berchem TOT
54,Posthofbrug 5366,2018-09-24,04:00:00,10,8,2,FMN GV 16 Berchem TOT
54,Posthofbrug 5366,2018-09-24,05:00:00,14,8,6,FMN GV 16 Berchem TOT
54,Posthofbrug 5366,2018-09-24,06:00:00,104,88,16,FMN GV 16 Berchem TOT
54,Posthofbrug 5366,2018-09-24,07:00:00,446,333,113,FMN GV 16 Berchem TOT
54,Posthofbrug 5366,2018-09-24,08:00:00,617,427,190,FMN GV 16 Berchem TOT
54,Posthofbrug 5366,2018-09-24,09:00:00,256,134,122,FMN GV 16 Berchem TOT
54,Posthofbrug 5366,2018-09-24,10:00:00,66,49,17,FMN GV 16 Berchem TOT
54,Posthofbrug 5366,2018-09-24,11:00:00,64,43,21,FMN GV 16 Berchem TOT
54,Posthofbrug 5366,2018-09-24,12:00:00,94,55,39,FMN GV 16 Berchem TOT
54,Posthofbrug 5366,2018-09-24,13:00:00,96,41,55,FMN GV 16 Berchem TOT
54,Posthofbrug 5366,2018-09-24,14:00:00,104,48,56,FMN GV 16 Berchem TOT
54,Posthofbrug 5366,2018-09-24,15:00:00,212,91,121,FMN GV 16 Berchem TOT
54,Posthofbrug 5366,2018-09-24,16:00:00,343,145,198,FMN GV 16 Berchem TOT
54,Posthofbrug 5366,2018-09-24,17:00:00,459,150,309,FMN GV 16 Berchem TOT
54,Posthofbrug 5366,2018-09-24,18:00:00,330,106,224,FMN GV 16 Berchem TOT
54,Posthofbrug 5366,2018-09-24,19:00:00,155,63,92,FMN GV 16 Berchem TOT
54,Posthofbrug 5366,2018-09-24,20:00:00,70,28,42,FMN GV 16 Berchem TOT
54,Posthofbrug 5366,2018-09-24,21:00:00,74,29,45,FMN GV 16 Berchem TOT
54,Posthofbrug 5366,2018-09-24,22:00:00,58,25,33,FMN GV 16 Berchem TOT
54,Posthofbrug 5366,2018-09-24,23:00:00,25,5,20,FMN GV 16 Berchem TOT
54,Posthofbrug 5366,2018-09-25,00:00:00,19,3,16,FMN GV 16 Berchem TOT
54,Posthofbrug 5366,2018-09-25,01:00:00,4,1,3,FMN GV 16 Berchem TOT
54,Posthofbrug 5366,2018-09-25,02:00:00,9,1,8,FMN GV 16 Berchem TOT
54,Posthofbrug 5366,2018-09-25,03:00:00,2,1,1,FMN GV 16 Berchem TOT
54,Posthofbrug 5366,2018-09-25,04:00:00,11,8,3,FMN GV 16 Berchem TOT
54,Posthofbrug 5366,2018-09-25,05:00:00,20,12,8,FMN GV 16 Berchem TOT
54,Posthofbrug 5366,2018-09-25,06:00:00,127,103,24,FMN GV 16 Berchem TOT
54,Posthofbrug 5366,2018-09-25,07:00:00,487,349,138,FMN GV 16 Berchem TOT
54,Posthofbrug 5366,2018-09-25,08:00:00,718,507,211,FMN GV 16 Berchem TOT
54,Posthofbrug 5366,2018-09-25,09:00:00,255,173,82,FMN GV 16 Berchem TOT
54,Posthofbrug 5366,2018-09-25,10:00:00,107,76,31,FMN GV 16 Berchem TOT
54,Posthofbrug 5366,2018-09-25,11:00:00,92,54,38,FMN GV 16 Berchem TOT
54,Posthofbrug 5366,2018-09-25,12:00:00,139,88,51,FMN GV 16 Berchem TOT
54,Posthofbrug 5366,2018-09-25,13:00:00,154,86,68,FMN GV 16 Berchem TOT
54,Posthofbrug 5366,2018-09-25,14:00:00,142,60,82,FMN GV 16 Berchem TOT
54,Posthofbrug 5366,2018-09-25,15:00:00,230,98,132,FMN GV 16 Berchem TOT
54,Posthofbrug 5366,2018-09-25,16:00:00,441,185,256,FMN GV 16 Berchem TOT
54,Posthofbrug 5366,2018-09-25,17:00:00,537,162,375,FMN GV 16 Berchem TOT
54,Posthofbrug 5366,2018-09-25,18:00:00,367,104,263,FMN GV 16 Berchem TOT
54,Posthofbrug 5366,2018-09-25,19:00:00,172,60,112,FMN GV 16 Berchem TOT
54,Posthofbrug 5366,2018-09-25,20:00:00,119,58,61,FMN GV 16 Berchem TOT
54,Posthofbrug 5366,2018-09-25,21:00:00,86,39,47,FMN GV 16 Berchem TOT
54,Posthofbrug 5366,2018-09-25,22:00:00,83,31,52,FMN GV 16 Berchem TOT
54,Posthofbrug 5366,2018-09-25,23:00:00,35,12,23,FMN GV 16 Berchem TOT
54,Posthofbrug 5366,2018-09-26,00:00:00,16,4,12,FMN GV 16 Berchem TOT
54,Posthofbrug 5366,2018-09-26,01:00:00,5,3,2,FMN GV 16 Berchem TOT
54,Posthofbrug 5366,2018-09-26,02:00:00,5,0,5,FMN GV 16 Berchem TOT
54,Posthofbrug 5366,2018-09-26,03:00:00,1,1,0,FMN GV 16 Berchem TOT
54,Posthofbrug 5366,2018-09-26,04:00:00,7,6,1,FMN GV 16 Berchem TOT
54,Posthofbrug 5366,2018-09-26,05:00:00,22,17,5,FMN GV 16 Berchem TOT
54,Posthofbrug 5366,2018-09-26,06:00:00,106,79,27,FMN GV 16 Berchem TOT
54,Posthofbrug 5366,2018-09-26,07:00:00,463,332,131,FMN GV 16 Berchem TOT
54,Posthofbrug 5366,2018-09-26,08:00:00,576,377,199,FMN GV 16 Berchem TOT
54,Posthofbrug 5366,2018-09-26,09:00:00,197,142,55,FMN GV 16 Berchem TOT
54,Posthofbrug 5366,2018-09-26,10:00:00,104,78,26,FMN GV 16 Berchem TOT
54,Posthofbrug 5366,2018-09-26,11:00:00,129,82,47,FMN GV 16 Berchem TOT
54,Posthofbrug 5366,2018-09-26,12:00:00,250,140,110,FMN GV 16 Berchem TOT
54,Posthofbrug 5366,2018-09-26,13:00:00,171,73,98,FMN GV 16 Berchem TOT
54,Posthofbrug 5366,2018-09-26,14:00:00,171,90,81,FMN GV 16 Berchem TOT
54,Posthofbrug 5366,2018-09-26,15:00:00,211,90,121,FMN GV 16 Berchem TOT
54,Posthofbrug 5366,2018-09-26,16:00:00,405,173,232,FMN GV 16 Berchem TOT
54,Posthofbrug 5366,2018-09-26,17:00:00,520,186,334,FMN GV 16 Berchem TOT
54,Posthofbrug 5366,2018-09-26,18:00:00,349,114,235,FMN GV 16 Berchem TOT
54,Posthofbrug 5366,2018-09-26,19:00:00,177,76,101,FMN GV 16 Berchem TOT
54,Posthofbrug 5366,2018-09-26,20:00:00,107,56,51,FMN GV 16 Berchem TOT
54,Posthofbrug 5366,2018-09-26,21:00:00,90,41,49,FMN GV 16 Berchem TOT
54,Posthofbrug 5366,2018-09-26,22:00:00,74,23,51,FMN GV 16 Berchem TOT
54,Posthofbrug 5366,2018-09-26,23:00:00,42,18,24,FMN GV 16 Berchem TOT
54,Posthofbrug 5366,2018-09-27,00:00:00,31,10,21,FMN GV 16 Berchem TOT
54,Posthofbrug 5366,2018-09-27,01:00:00,10,3,7,FMN GV 16 Berchem TOT
54,Posthofbrug 5366,2018-09-27,02:00:00,2,0,2,FMN GV 16 Berchem TOT
54,Posthofbrug 5366,2018-09-27,03:00:00,13,3,10,FMN GV 16 Berchem TOT
54,Posthofbrug 5366,2018-09-27,04:00:00,16,8,8,FMN GV 16 Berchem TOT
54,Posthofbrug 5366,2018-09-27,05:00:00,13,10,3,FMN GV 16 Berchem TOT
54,Posthofbrug 5366,2018-09-27,06:00:00,113,86,27,FMN GV 16 Berchem TOT
54,Posthofbrug 5366,2018-09-27,07:00:00,447,305,142,FMN GV 16 Berchem TOT
54,Posthofbrug 5366,2018-09-27,08:00:00,715,500,215,FMN GV 16 Berchem TOT
54,Posthofbrug 5366,2018-09-27,09:00:00,241,164,77,FMN GV 16 Berchem TOT
54,Posthofbrug 5366,2018-09-27,10:00:00,118,87,31,FMN GV 16 Berchem TOT
54,Posthofbrug 5366,2018-09-27,11:00:00,123,74,49,FMN GV 16 Berchem TOT
54,Posthofbrug 5366,2018-09-27,12:00:00,188,111,77,FMN GV 16 Berchem TOT
54,Posthofbrug 5366,2018-09-27,13:00:00,172,108,64,FMN GV 16 Berchem TOT
54,Posthofbrug 5366,2018-09-27,14:00:00,220,116,104,FMN GV 16 Berchem TOT
54,Posthofbrug 5366,2018-09-27,15:00:00,284,123,161,FMN GV 16 Berchem TOT
54,Posthofbrug 5366,2018-09-27,16:00:00,412,182,230,FMN GV 16 Berchem TOT
54,Posthofbrug 5366,2018-09-27,17:00:00,587,211,376,FMN GV 16 Berchem TOT
54,Posthofbrug 5366,2018-09-27,18:00:00,394,141,253,FMN GV 16 Berchem TOT
54,Posthofbrug 5366,2018-09-27,19:00:00,198,67,131,FMN GV 16 Berchem TOT
54,Posthofbrug 5366,2018-09-27,20:00:00,121,52,69,FMN GV 16 Berchem TOT
54,Posthofbrug 5366,2018-09-27,21:00:00,97,42,55,FMN GV 16 Berchem TOT
54,Posthofbrug 5366,2018-09-27,22:00:00,85,32,53,FMN GV 16 Berchem TOT
54,Posthofbrug 5366,2018-09-27,23:00:00,61,13,48,FMN GV 16 Berchem TOT
54,Posthofbrug 5366,2018-09-28,00:00:00,36,10,26,FMN GV 16 Berchem TOT
54,Posthofbrug 5366,2018-09-28,01:00:00,26,6,20,FMN GV 16 Berchem TOT
54,Posthofbrug 5366,2018-09-28,02:00:00,10,0,10,FMN GV 16 Berchem TOT
54,Posthofbrug 5366,2018-09-28,03:00:00,15,2,13,FMN GV 16 Berchem TOT
54,Posthofbrug 5366,2018-09-28,04:00:00,16,8,8,FMN GV 16 Berchem TOT
54,Posthofbrug 5366,2018-09-28,05:00:00,17,11,6,FMN GV 16 Berchem TOT
54,Posthofbrug 5366,2018-09-28,06:00:00,84,66,18,FMN GV 16 Berchem TOT
54,Posthofbrug 5366,2018-09-28,07:00:00,389,266,123,FMN GV 16 Berchem TOT
54,Posthofbrug 5366,2018-09-28,08:00:00,602,404,198,FMN GV 16 Berchem TOT
54,Posthofbrug 5366,2018-09-28,09:00:00,217,136,81,FMN GV 16 Berchem TOT
54,Posthofbrug 5366,2018-09-28,10:00:00,114,78,36,FMN GV 16 Berchem TOT
54,Posthofbrug 5366,2018-09-28,11:00:00,98,57,41,FMN GV 16 Berchem TOT
54,Posthofbrug 5366,2018-09-28,12:00:00,171,89,82,FMN GV 16 Berchem TOT
54,Posthofbrug 5366,2018-09-28,13:00:00,160,76,84,FMN GV 16 Berchem TOT
54,Posthofbrug 5366,2018-09-28,14:00:00,129,57,72,FMN GV 16 Berchem TOT
54,Posthofbrug 5366,2018-09-28,15:00:00,266,119,147,FMN GV 16 Berchem TOT
54,Posthofbrug 5366,2018-09-28,16:00:00,399,149,250,FMN GV 16 Berchem TOT
54,Posthofbrug 5366,2018-09-28,17:00:00,406,137,269,FMN GV 16 Berchem TOT
54,Posthofbrug 5366,2018-09-28,18:00:00,282,122,160,FMN GV 16 Berchem TOT
54,Posthofbrug 5366,2018-09-28,19:00:00,137,59,78,FMN GV 16 Berchem TOT
54,Posthofbrug 5366,2018-09-28,20:00:00,92,47,45,FMN GV 16 Berchem TOT
54,Posthofbrug 5366,2018-09-28,21:00:00,55,28,27,FMN GV 16 Berchem TOT
54,Posthofbrug 5366,2018-09-28,22:00:00,71,23,48,FMN GV 16 Berchem TOT
54,Posthofbrug 5366,2018-09-28,23:00:00,42,13,29,FMN GV 16 Berchem TOT
54,Posthofbrug 5366,2018-09-29,00:00:00,39,13,26,FMN GV 16 Berchem TOT
54,Posthofbrug 5366,2018-09-29,01:00:00,41,10,31,FMN GV 16 Berchem TOT
54,Posthofbrug 5366,2018-09-29,02:00:00,9,2,7,FMN GV 16 Berchem TOT
54,Posthofbrug 5366,2018-09-29,03:00:00,14,5,9,FMN GV 16 Berchem TOT
54,Posthofbrug 5366,2018-09-29,04:00:00,12,3,9,FMN GV 16 Berchem TOT
54,Posthofbrug 5366,2018-09-29,05:00:00,20,15,5,FMN GV 16 Berchem TOT
54,Posthofbrug 5366,2018-09-29,06:00:00,18,10,8,FMN GV 16 Berchem TOT
54,Posthofbrug 5366,2018-09-29,07:00:00,27,16,11,FMN GV 16 Berchem TOT
54,Posthofbrug 5366,2018-09-29,08:00:00,49,26,23,FMN GV 16 Berchem TOT
54,Posthofbrug 5366,2018-09-29,09:00:00,100,66,34,FMN GV 16 Berchem TOT
54,Posthofbrug 5366,2018-09-29,10:00:00,104,73,31,FMN GV 16 Berchem TOT
54,Posthofbrug 5366,2018-09-29,11:00:00,111,75,36,FMN GV 16 Berchem TOT
54,Posthofbrug 5366,2018-09-29,12:00:00,135,86,49,FMN GV 16 Berchem TOT
54,Posthofbrug 5366,2018-09-29,13:00:00,149,99,50,FMN GV 16 Berchem TOT
54,Posthofbrug 5366,2018-09-29,14:00:00,168,101,67,FMN GV 16 Berchem TOT
54,Posthofbrug 5366,2018-09-29,15:00:00,170,104,66,FMN GV 16 Berchem TOT
54,Posthofbrug 5366,2018-09-29,16:00:00,162,58,104,FMN GV 16 Berchem TOT
54,Posthofbrug 5366,2018-09-29,17:00:00,156,68,88,FMN GV 16 Berchem TOT
54,Posthofbrug 5366,2018-09-29,18:00:00,121,49,72,FMN GV 16 Berchem TOT
54,Posthofbrug 5366,2018-09-29,19:00:00,92,42,50,FMN GV 16 Berchem TOT
54,Posthofbrug 5366,2018-09-29,20:00:00,96,57,39,FMN GV 16 Berchem TOT
54,Posthofbrug 5366,2018-09-29,21:00:00,44,29,15,FMN GV 16 Berchem TOT
54,Posthofbrug 5366,2018-09-29,22:00:00,52,17,35,FMN GV 16 Berchem TOT
54,Posthofbrug 5366,2018-09-29,23:00:00,60,17,43,FMN GV 16 Berchem TOT
54,Posthofbrug 5366,2018-09-30,00:00:00,36,6,30,FMN GV 16 Berchem TOT
54,Posthofbrug 5366,2018-09-30,01:00:00,31,8,23,FMN GV 16 Berchem TOT
54,Posthofbrug 5366,2018-09-30,02:00:00,15,8,7,FMN GV 16 Berchem TOT
54,Posthofbrug 5366,2018-09-30,03:00:00,11,1,10,FMN GV 16 Berchem TOT
54,Posthofbrug 5366,2018-09-30,04:00:00,11,5,6,FMN GV 16 Berchem TOT
54,Posthofbrug 5366,2018-09-30,05:00:00,16,9,7,FMN GV 16 Berchem TOT
54,Posthofbrug 5366,2018-09-30,06:00:00,15,9,6,FMN GV 16 Berchem TOT
54,Posthofbrug 5366,2018-09-30,07:00:00,21,13,8,FMN GV 16 Berchem TOT
54,Posthofbrug 5366,2018-09-30,08:00:00,38,19,19,FMN GV 16 Berchem TOT
54,Posthofbrug 5366,2018-09-30,09:00:00,74,49,25,FMN GV 16 Berchem TOT
54,Posthofbrug 5366,2018-09-30,10:00:00,107,65,42,FMN GV 16 Berchem TOT
54,Posthofbrug 5366,2018-09-30,11:00:00,122,83,39,FMN GV 16 Berchem TOT
54,Posthofbrug 5366,2018-09-30,12:00:00,128,88,40,FMN GV 16 Berchem TOT
54,Posthofbrug 5366,2018-09-30,13:00:00,177,105,72,FMN GV 16 Berchem TOT
54,Posthofbrug 5366,2018-09-30,14:00:00,218,150,68,FMN GV 16 Berchem TOT
54,Posthofbrug 5366,2018-09-30,15:00:00,196,104,92,FMN GV 16 Berchem TOT
54,Posthofbrug 5366,2018-09-30,16:00:00,127,53,74,FMN GV 16 Berchem TOT
54,Posthofbrug 5366,2018-09-30,17:00:00,172,55,117,FMN GV 16 Berchem TOT
54,Posthofbrug 5366,2018-09-30,18:00:00,111,24,87,FMN GV 16 Berchem TOT
54,Posthofbrug 5366,2018-09-30,19:00:00,55,24,31,FMN GV 16 Berchem TOT
54,Posthofbrug 5366,2018-09-30,20:00:00,38,21,17,FMN GV 16 Berchem TOT
54,Posthofbrug 5366,2018-09-30,21:00:00,42,18,24,FMN GV 16 Berchem TOT
54,Posthofbrug 5366,2018-09-30,22:00:00,22,11,11,FMN GV 16 Berchem TOT
54,Posthofbrug 5366,2018-09-30,23:00:00,17,6,11,FMN GV 16 Berchem TOT
54,Posthofbrug 5366,2018-10-01,00:00:00,4,1,3,FMN GV 16 Berchem TOT
54,Posthofbrug 5366,2018-10-01,01:00:00,2,1,1,FMN GV 16 Berchem TOT
54,Posthofbrug 5366,2018-10-01,02:00:00,4,1,3,FMN GV 16 Berchem TOT
54,Posthofbrug 5366,2018-10-01,03:00:00,6,4,2,FMN GV 16 Berchem TOT
54,Posthofbrug 5366,2018-10-01,04:00:00,8,6,2,FMN GV 16 Berchem TOT
54,Posthofbrug 5366,2018-10-01,05:00:00,17,10,7,FMN GV 16 Berchem TOT
54,Posthofbrug 5366,2018-10-01,06:00:00,92,74,18,FMN GV 16 Berchem TOT
54,Posthofbrug 5366,2018-10-01,07:00:00,420,298,122,FMN GV 16 Berchem TOT
54,Posthofbrug 5366,2018-10-01,08:00:00,619,407,212,FMN GV 16 Berchem TOT
54,Posthofbrug 5366,2018-10-01,09:00:00,191,119,72,FMN GV 16 Berchem TOT
54,Posthofbrug 5366,2018-10-01,10:00:00,114,68,46,FMN GV 16 Berchem TOT
54,Posthofbrug 5366,2018-10-01,11:00:00,80,55,25,FMN GV 16 Berchem TOT
54,Posthofbrug 5366,2018-10-01,12:00:00,92,55,37,FMN GV 16 Berchem TOT
54,Posthofbrug 5366,2018-10-01,13:00:00,120,65,55,FMN GV 16 Berchem TOT
54,Posthofbrug 5366,2018-10-01,14:00:00,77,32,45,FMN GV 16 Berchem TOT
54,Posthofbrug 5366,2018-10-01,15:00:00,181,81,100,FMN GV 16 Berchem TOT
54,Posthofbrug 5366,2018-10-01,16:00:00,387,144,243,FMN GV 16 Berchem TOT
54,Posthofbrug 5366,2018-10-01,17:00:00,478,142,336,FMN GV 16 Berchem TOT
54,Posthofbrug 5366,2018-10-01,18:00:00,304,95,209,FMN GV 16 Berchem TOT
54,Posthofbrug 5366,2018-10-01,19:00:00,120,49,71,FMN GV 16 Berchem TOT
54,Posthofbrug 5366,2018-10-01,20:00:00,67,29,38,FMN GV 16 Berchem TOT
54,Posthofbrug 5366,2018-10-01,21:00:00,59,27,32,FMN GV 16 Berchem TOT
54,Posthofbrug 5366,2018-10-01,22:00:00,46,16,30,FMN GV 16 Berchem TOT
54,Posthofbrug 5366,2018-10-01,23:00:00,25,12,13,FMN GV 16 Berchem TOT
54,Posthofbrug 5366,2018-10-02,00:00:00,17,4,13,FMN GV 16 Berchem TOT
54,Posthofbrug 5366,2018-10-02,01:00:00,4,0,4,FMN GV 16 Berchem TOT
54,Posthofbrug 5366,2018-10-02,02:00:00,1,0,1,FMN GV 16 Berchem TOT
54,Posthofbrug 5366,2018-10-02,03:00:00,8,5,3,FMN GV 16 Berchem TOT
54,Posthofbrug 5366,2018-10-02,04:00:00,4,4,0,FMN GV 16 Berchem TOT
54,Posthofbrug 5366,2018-10-02,05:00:00,14,10,4,FMN GV 16 Berchem TOT
54,Posthofbrug 5366,2018-10-02,06:00:00,111,92,19,FMN GV 16 Berchem TOT
54,Posthofbrug 5366,2018-10-02,07:00:00,448,331,117,FMN GV 16 Berchem TOT
54,Posthofbrug 5366,2018-10-02,08:00:00,741,510,231,FMN GV 16 Berchem TOT
54,Posthofbrug 5366,2018-10-02,09:00:00,221,153,68,FMN GV 16 Berchem TOT
54,Posthofbrug 5366,2018-10-02,10:00:00,85,52,33,FMN GV 16 Berchem TOT
54,Posthofbrug 5366,2018-10-02,11:00:00,80,58,22,FMN GV 16 Berchem TOT
54,Posthofbrug 5366,2018-10-02,12:00:00,125,68,57,FMN GV 16 Berchem TOT
54,Posthofbrug 5366,2018-10-02,13:00:00,112,53,59,FMN GV 16 Berchem TOT
54,Posthofbrug 5366,2018-10-02,14:00:00,116,61,55,FMN GV 16 Berchem TOT
54,Posthofbrug 5366,2018-10-02,15:00:00,163,61,102,FMN GV 16 Berchem TOT
54,Posthofbrug 5366,2018-10-02,16:00:00,386,136,250,FMN GV 16 Berchem TOT
54,Posthofbrug 5366,2018-10-02,17:00:00,558,178,380,FMN GV 16 Berchem TOT
54,Posthofbrug 5366,2018-10-02,18:00:00,344,111,233,FMN GV 16 Berchem TOT
54,Posthofbrug 5366,2018-10-02,19:00:00,146,64,82,FMN GV 16 Berchem TOT
54,Posthofbrug 5366,2018-10-02,20:00:00,101,42,59,FMN GV 16 Berchem TOT
54,Posthofbrug 5366,2018-10-02,21:00:00,72,23,49,FMN GV 16 Berchem TOT
54,Posthofbrug 5366,2018-10-02,22:00:00,70,24,46,FMN GV 16 Berchem TOT
54,Posthofbrug 5366,2018-10-02,23:00:00,46,18,28,FMN GV 16 Berchem TOT
54,Posthofbrug 5366,2018-10-03,00:00:00,18,4,14,FMN GV 16 Berchem TOT
54,Posthofbrug 5366,2018-10-03,01:00:00,10,2,8,FMN GV 16 Berchem TOT
54,Posthofbrug 5366,2018-10-03,02:00:00,2,0,2,FMN GV 16 Berchem TOT
54,Posthofbrug 5366,2018-10-03,03:00:00,3,1,2,FMN GV 16 Berchem TOT
54,Posthofbrug 5366,2018-10-03,04:00:00,10,7,3,FMN GV 16 Berchem TOT
54,Posthofbrug 5366,2018-10-03,05:00:00,21,16,5,FMN GV 16 Berchem TOT
54,Posthofbrug 5366,2018-10-03,06:00:00,96,75,21,FMN GV 16 Berchem TOT
54,Posthofbrug 5366,2018-10-03,07:00:00,451,345,106,FMN GV 16 Berchem TOT
54,Posthofbrug 5366,2018-10-03,08:00:00,655,437,218,FMN GV 16 Berchem TOT
54,Posthofbrug 5366,2018-10-03,09:00:00,231,158,73,FMN GV 16 Berchem TOT
54,Posthofbrug 5366,2018-10-03,10:00:00,104,78,26,FMN GV 16 Berchem TOT
54,Posthofbrug 5366,2018-10-03,11:00:00,122,70,52,FMN GV 16 Berchem TOT
54,Posthofbrug 5366,2018-10-03,12:00:00,249,133,116,FMN GV 16 Berchem TOT
54,Posthofbrug 5366,2018-10-03,13:00:00,199,103,96,FMN GV 16 Berchem TOT
54,Posthofbrug 5366,2018-10-03,14:00:00,131,58,73,FMN GV 16 Berchem TOT
54,Posthofbrug 5366,2018-10-03,15:00:00,194,90,104,FMN GV 16 Berchem TOT
54,Posthofbrug 5366,2018-10-03,16:00:00,369,145,224,FMN GV 16 Berchem TOT
54,Posthofbrug 5366,2018-10-03,17:00:00,513,180,333,FMN GV 16 Berchem TOT
54,Posthofbrug 5366,2018-10-03,18:00:00,343,90,253,FMN GV 16 Berchem TOT
54,Posthofbrug 5366,2018-10-03,19:00:00,150,65,85,FMN GV 16 Berchem TOT
54,Posthofbrug 5366,2018-10-03,20:00:00,98,48,50,FMN GV 16 Berchem TOT
54,Posthofbrug 5366,2018-10-03,21:00:00,75,22,53,FMN GV 16 Berchem TOT
54,Posthofbrug 5366,2018-10-03,22:00:00,69,29,40,FMN GV 16 Berchem TOT
54,Posthofbrug 5366,2018-10-03,23:00:00,53,24,29,FMN GV 16 Berchem TOT
54,Posthofbrug 5366,2018-10-04,00:00:00,18,6,12,FMN GV 16 Berchem TOT
54,Posthofbrug 5366,2018-10-04,01:00:00,7,1,6,FMN GV 16 Berchem TOT
54,Posthofbrug 5366,2018-10-04,02:00:00,10,1,9,FMN GV 16 Berchem TOT
54,Posthofbrug 5366,2018-10-04,03:00:00,6,1,5,FMN GV 16 Berchem TOT
54,Posthofbrug 5366,2018-10-04,04:00:00,14,9,5,FMN GV 16 Berchem TOT
54,Posthofbrug 5366,2018-10-04,05:00:00,19,13,6,FMN GV 16 Berchem TOT
54,Posthofbrug 5366,2018-10-04,06:00:00,116,95,21,FMN GV 16 Berchem TOT
54,Posthofbrug 5366,2018-10-04,07:00:00,498,358,140,FMN GV 16 Berchem TOT
54,Posthofbrug 5366,2018-10-04,08:00:00,725,481,244,FMN GV 16 Berchem TOT
54,Posthofbrug 5366,2018-10-04,09:00:00,227,166,61,FMN GV 16 Berchem TOT
54,Posthofbrug 5366,2018-10-04,10:00:00,122,88,34,FMN GV 16 Berchem TOT
54,Posthofbrug 5366,2018-10-04,11:00:00,108,70,38,FMN GV 16 Berchem TOT
54,Posthofbrug 5366,2018-10-04,12:00:00,151,94,57,FMN GV 16 Berchem TOT
54,Posthofbrug 5366,2018-10-04,13:00:00,160,99,61,FMN GV 16 Berchem TOT
54,Posthofbrug 5366,2018-10-04,14:00:00,120,39,81,FMN GV 16 Berchem TOT
54,Posthofbrug 5366,2018-10-04,15:00:00,219,98,121,FMN GV 16 Berchem TOT
54,Posthofbrug 5366,2018-10-04,16:00:00,469,179,290,FMN GV 16 Berchem TOT
54,Posthofbrug 5366,2018-10-04,17:00:00,581,196,385,FMN GV 16 Berchem TOT
54,Posthofbrug 5366,2018-10-04,18:00:00,393,113,280,FMN GV 16 Berchem TOT
54,Posthofbrug 5366,2018-10-04,19:00:00,195,98,97,FMN GV 16 Berchem TOT
54,Posthofbrug 5366,2018-10-04,20:00:00,103,52,51,FMN GV 16 Berchem TOT
54,Posthofbrug 5366,2018-10-04,21:00:00,71,32,39,FMN GV 16 Berchem TOT
54,Posthofbrug 5366,2018-10-04,22:00:00,82,34,48,FMN GV 16 Berchem TOT
54,Posthofbrug 5366,2018-10-04,23:00:00,47,12,35,FMN GV 16 Berchem TOT
54,Posthofbrug 5366,2018-10-05,00:00:00,20,5,15,FMN GV 16 Berchem TOT
54,Posthofbrug 5366,2018-10-05,01:00:00,18,4,14,FMN GV 16 Berchem TOT
54,Posthofbrug 5366,2018-10-05,02:00:00,6,2,4,FMN GV 16 Berchem TOT
54,Posthofbrug 5366,2018-10-05,03:00:00,7,2,5,FMN GV 16 Berchem TOT
54,Posthofbrug 5366,2018-10-05,04:00:00,12,8,4,FMN GV 16 Berchem TOT
54,Posthofbrug 5366,2018-10-05,05:00:00,15,11,4,FMN GV 16 Berchem TOT
54,Posthofbrug 5366,2018-10-05,06:00:00,99,84,15,FMN GV 16 Berchem TOT
54,Posthofbrug 5366,2018-10-05,07:00:00,403,281,122,FMN GV 16 Berchem TOT
54,Posthofbrug 5366,2018-10-05,08:00:00,612,407,205,FMN GV 16 Berchem TOT
54,Posthofbrug 5366,2018-10-05,09:00:00,219,159,60,FMN GV 16 Berchem TOT
54,Posthofbrug 5366,2018-10-05,10:00:00,147,105,42,FMN GV 16 Berchem TOT
54,Posthofbrug 5366,2018-10-05,11:00:00,111,65,46,FMN GV 16 Berchem TOT
54,Posthofbrug 5366,2018-10-05,12:00:00,200,115,85,FMN GV 16 Berchem TOT
54,Posthofbrug 5366,2018-10-05,13:00:00,174,88,86,FMN GV 16 Berchem TOT
54,Posthofbrug 5366,2018-10-05,14:00:00,176,83,93,FMN GV 16 Berchem TOT
54,Posthofbrug 5366,2018-10-05,15:00:00,320,116,204,FMN GV 16 Berchem TOT
54,Posthofbrug 5366,2018-10-05,16:00:00,388,152,236,FMN GV 16 Berchem TOT
54,Posthofbrug 5366,2018-10-05,17:00:00,457,188,269,FMN GV 16 Berchem TOT
54,Posthofbrug 5366,2018-10-05,18:00:00,302,119,183,FMN GV 16 Berchem TOT
54,Posthofbrug 5366,2018-10-05,19:00:00,174,64,110,FMN GV 16 Berchem TOT
54,Posthofbrug 5366,2018-10-05,20:00:00,99,48,51,FMN GV 16 Berchem TOT
54,Posthofbrug 5366,2018-10-05,21:00:00,69,41,28,FMN GV 16 Berchem TOT
54,Posthofbrug 5366,2018-10-05,22:00:00,79,20,59,FMN GV 16 Berchem TOT
54,Posthofbrug 5366,2018-10-05,23:00:00,72,34,38,FMN GV 16 Berchem TOT
54,Posthofbrug 5366,2018-10-06,00:00:00,48,25,23,FMN GV 16 Berchem TOT
54,Posthofbrug 5366,2018-10-06,01:00:00,23,7,16,FMN GV 16 Berchem TOT
54,Posthofbrug 5366,2018-10-06,02:00:00,12,6,6,FMN GV 16 Berchem TOT
54,Posthofbrug 5366,2018-10-06,03:00:00,15,2,13,FMN GV 16 Berchem TOT
54,Posthofbrug 5366,2018-10-06,04:00:00,15,9,6,FMN GV 16 Berchem TOT
54,Posthofbrug 5366,2018-10-06,05:00:00,21,11,10,FMN GV 16 Berchem TOT
54,Posthofbrug 5366,2018-10-06,06:00:00,18,13,5,FMN GV 16 Berchem TOT
54,Posthofbrug 5366,2018-10-06,07:00:00,25,16,9,FMN GV 16 Berchem TOT
54,Posthofbrug 5366,2018-10-06,08:00:00,50,27,23,FMN GV 16 Berchem TOT
54,Posthofbrug 5366,2018-10-06,09:00:00,115,74,41,FMN GV 16 Berchem TOT
54,Posthofbrug 5366,2018-10-06,10:00:00,121,73,48,FMN GV 16 Berchem TOT
54,Posthofbrug 5366,2018-10-06,11:00:00,130,86,44,FMN GV 16 Berchem TOT
54,Posthofbrug 5366,2018-10-06,12:00:00,167,108,59,FMN GV 16 Berchem TOT
54,Posthofbrug 5366,2018-10-06,13:00:00,171,103,68,FMN GV 16 Berchem TOT
54,Posthofbrug 5366,2018-10-06,14:00:00,229,148,81,FMN GV 16 Berchem TOT
54,Posthofbrug 5366,2018-10-06,15:00:00,174,101,73,FMN GV 16 Berchem TOT
54,Posthofbrug 5366,2018-10-06,16:00:00,205,83,122,FMN GV 16 Berchem TOT
54,Posthofbrug 5366,2018-10-06,17:00:00,208,96,112,FMN GV 16 Berchem TOT
54,Posthofbrug 5366,2018-10-06,18:00:00,149,61,88,FMN GV 16 Berchem TOT
54,Posthofbrug 5366,2018-10-06,19:00:00,94,49,45,FMN GV 16 Berchem TOT
54,Posthofbrug 5366,2018-10-06,20:00:00,55,30,25,FMN GV 16 Berchem TOT
54,Posthofbrug 5366,2018-10-06,21:00:00,55,27,28,FMN GV 16 Berchem TOT
54,Posthofbrug 5366,2018-10-06,22:00:00,59,28,31,FMN GV 16 Berchem TOT
54,Posthofbrug 5366,2018-10-06,23:00:00,42,19,23,FMN GV 16 Berchem TOT
54,Posthofbrug 5366,2018-10-07,00:00:00,30,7,23,FMN GV 16 Berchem TOT
54,Posthofbrug 5366,2018-10-07,01:00:00,25,9,16,FMN GV 16 Berchem TOT
54,Posthofbrug 5366,2018-10-07,02:00:00,12,6,6,FMN GV 16 Berchem TOT
54,Posthofbrug 5366,2018-10-07,03:00:00,8,2,6,FMN GV 16 Berchem TOT
54,Posthofbrug 5366,2018-10-07,04:00:00,24,8,16,FMN GV 16 Berchem TOT
54,Posthofbrug 5366,2018-10-07,05:00:00,11,5,6,FMN GV 16 Berchem TOT
54,Posthofbrug 5366,2018-10-07,06:00:00,11,8,3,FMN GV 16 Berchem TOT
54,Posthofbrug 5366,2018-10-07,07:00:00,13,6,7,FMN GV 16 Berchem TOT
54,Posthofbrug 5366,2018-10-07,08:00:00,38,25,13,FMN GV 16 Berchem TOT
54,Posthofbrug 5366,2018-10-07,09:00:00,74,38,36,FMN GV 16 Berchem TOT
54,Posthofbrug 5366,2018-10-07,10:00:00,62,44,18,FMN GV 16 Berchem TOT
54,Posthofbrug 5366,2018-10-07,11:00:00,88,54,34,FMN GV 16 Berchem TOT
54,Posthofbrug 5366,2018-10-07,12:00:00,141,88,53,FMN GV 16 Berchem TOT
54,Posthofbrug 5366,2018-10-07,13:00:00,137,75,62,FMN GV 16 Berchem TOT
54,Posthofbrug 5366,2018-10-07,14:00:00,149,87,62,FMN GV 16 Berchem TOT
54,Posthofbrug 5366,2018-10-07,15:00:00,160,95,65,FMN GV 16 Berchem TOT
54,Posthofbrug 5366,2018-10-07,16:00:00,152,77,75,FMN GV 16 Berchem TOT
54,Posthofbrug 5366,2018-10-07,17:00:00,160,69,91,FMN GV 16 Berchem TOT
54,Posthofbrug 5366,2018-10-07,18:00:00,121,58,63,FMN GV 16 Berchem TOT
54,Posthofbrug 5366,2018-10-07,19:00:00,74,32,42,FMN GV 16 Berchem TOT
54,Posthofbrug 5366,2018-10-07,20:00:00,58,28,30,FMN GV 16 Berchem TOT
54,Posthofbrug 5366,2018-10-07,21:00:00,43,14,29,FMN GV 16 Berchem TOT
54,Posthofbrug 5366,2018-10-07,22:00:00,34,14,20,FMN GV 16 Berchem TOT
54,Posthofbrug 5366,2018-10-07,23:00:00,14,6,8,FMN GV 16 Berchem TOT
54,Posthofbrug 5366,2018-10-08,00:00:00,9,1,8,FMN GV 16 Berchem TOT
54,Posthofbrug 5366,2018-10-08,01:00:00,4,2,2,FMN GV 16 Berchem TOT
54,Posthofbrug 5366,2018-10-08,02:00:00,1,1,0,FMN GV 16 Berchem TOT
54,Posthofbrug 5366,2018-10-08,03:00:00,3,1,2,FMN GV 16 Berchem TOT
54,Posthofbrug 5366,2018-10-08,04:00:00,5,3,2,FMN GV 16 Berchem TOT
54,Posthofbrug 5366,2018-10-08,05:00:00,16,14,2,FMN GV 16 Berchem TOT
54,Posthofbrug 5366,2018-10-08,06:00:00,119,104,15,FMN GV 16 Berchem TOT
54,Posthofbrug 5366,2018-10-08,07:00:00,461,335,126,FMN GV 16 Berchem TOT
54,Posthofbrug 5366,2018-10-08,08:00:00,747,504,243,FMN GV 16 Berchem TOT
54,Posthofbrug 5366,2018-10-08,09:00:00,250,177,73,FMN GV 16 Berchem TOT
54,Posthofbrug 5366,2018-10-08,10:00:00,117,76,41,FMN GV 16 Berchem TOT
54,Posthofbrug 5366,2018-10-08,11:00:00,100,57,43,FMN GV 16 Berchem TOT
54,Posthofbrug 5366,2018-10-08,12:00:00,148,86,62,FMN GV 16 Berchem TOT
54,Posthofbrug 5366,2018-10-08,13:00:00,139,72,67,FMN GV 16 Berchem TOT
54,Posthofbrug 5366,2018-10-08,14:00:00,100,44,56,FMN GV 16 Berchem TOT
54,Posthofbrug 5366,2018-10-08,15:00:00,208,77,131,FMN GV 16 Berchem TOT
54,Posthofbrug 5366,2018-10-08,16:00:00,466,189,277,FMN GV 16 Berchem TOT
54,Posthofbrug 5366,2018-10-08,17:00:00,564,191,373,FMN GV 16 Berchem TOT
54,Posthofbrug 5366,2018-10-08,18:00:00,383,115,268,FMN GV 16 Berchem TOT
54,Posthofbrug 5366,2018-10-08,19:00:00,155,58,97,FMN GV 16 Berchem TOT
54,Posthofbrug 5366,2018-10-08,20:00:00,80,33,47,FMN GV 16 Berchem TOT
54,Posthofbrug 5366,2018-10-08,21:00:00,85,29,56,FMN GV 16 Berchem TOT
54,Posthofbrug 5366,2018-10-08,22:00:00,64,26,38,FMN GV 16 Berchem TOT
54,Posthofbrug 5366,2018-10-08,23:00:00,31,14,17,FMN GV 16 Berchem TOT
54,Posthofbrug 5366,2018-10-09,00:00:00,11,3,8,FMN GV 16 Berchem TOT
54,Posthofbrug 5366,2018-10-09,01:00:00,6,0,6,FMN GV 16 Berchem TOT
54,Posthofbrug 5366,2018-10-09,02:00:00,2,0,2,FMN GV 16 Berchem TOT
54,Posthofbrug 5366,2018-10-09,03:00:00,5,1,4,FMN GV 16 Berchem TOT
54,Posthofbrug 5366,2018-10-09,04:00:00,7,6,1,FMN GV 16 Berchem TOT
54,Posthofbrug 5366,2018-10-09,05:00:00,20,13,7,FMN GV 16 Berchem TOT
54,Posthofbrug 5366,2018-10-09,06:00:00,122,106,16,FMN GV 16 Berchem TOT
54,Posthofbrug 5366,2018-10-09,07:00:00,490,355,135,FMN GV 16 Berchem TOT
54,Posthofbrug 5366,2018-10-09,08:00:00,786,548,238,FMN GV 16 Berchem TOT
54,Posthofbrug 5366,2018-10-09,09:00:00,247,166,81,FMN GV 16 Berchem TOT
54,Posthofbrug 5366,2018-10-09,10:00:00,123,88,35,FMN GV 16 Berchem TOT
54,Posthofbrug 5366,2018-10-09,11:00:00,98,64,34,FMN GV 16 Berchem TOT
54,Posthofbrug 5366,2018-10-09,12:00:00,154,86,68,FMN GV 16 Berchem TOT
54,Posthofbrug 5366,2018-10-09,13:00:00,174,94,80,FMN GV 16 Berchem TOT
54,Posthofbrug 5366,2018-10-09,14:00:00,148,66,82,FMN GV 16 Berchem TOT
54,Posthofbrug 5366,2018-10-09,15:00:00,235,93,142,FMN GV 16 Berchem TOT
54,Posthofbrug 5366,2018-10-09,16:00:00,503,180,323,FMN GV 16 Berchem TOT
54,Posthofbrug 5366,2018-10-09,17:00:00,619,202,417,FMN GV 16 Berchem TOT
54,Posthofbrug 5366,2018-10-09,18:00:00,417,141,276,FMN GV 16 Berchem TOT
54,Posthofbrug 5366,2018-10-09,19:00:00,212,67,145,FMN GV 16 Berchem TOT
54,Posthofbrug 5366,2018-10-09,20:00:00,101,42,59,FMN GV 16 Berchem TOT
54,Posthofbrug 5366,2018-10-09,21:00:00,80,32,48,FMN GV 16 Berchem TOT
54,Posthofbrug 5366,2018-10-09,22:00:00,83,37,46,FMN GV 16 Berchem TOT
54,Posthofbrug 5366,2018-10-09,23:00:00,62,17,45,FMN GV 16 Berchem TOT
54,Posthofbrug 5366,2018-10-10,00:00:00,17,9,8,FMN GV 16 Berchem TOT
54,Posthofbrug 5366,2018-10-10,01:00:00,13,4,9,FMN GV 16 Berchem TOT
54,Posthofbrug 5366,2018-10-10,02:00:00,6,1,5,FMN GV 16 Berchem TOT
54,Posthofbrug 5366,2018-10-10,03:00:00,4,2,2,FMN GV 16 Berchem TOT
54,Posthofbrug 5366,2018-10-10,04:00:00,10,7,3,FMN GV 16 Berchem TOT
54,Posthofbrug 5366,2018-10-10,05:00:00,25,19,6,FMN GV 16 Berchem TOT
54,Posthofbrug 5366,2018-10-10,06:00:00,96,79,17,FMN GV 16 Berchem TOT
54,Posthofbrug 5366,2018-10-10,07:00:00,463,330,133,FMN GV 16 Berchem TOT
54,Posthofbrug 5366,2018-10-10,08:00:00,707,492,215,FMN GV 16 Berchem TOT
54,Posthofbrug 5366,2018-10-10,09:00:00,224,145,79,FMN GV 16 Berchem TOT
54,Posthofbrug 5366,2018-10-10,10:00:00,148,108,40,FMN GV 16 Berchem TOT
54,Posthofbrug 5366,2018-10-10,11:00:00,120,61,59,FMN GV 16 Berchem TOT
54,Posthofbrug 5366,2018-10-10,12:00:00,291,146,145,FMN GV 16 Berchem TOT
54,Posthofbrug 5366,2018-10-10,13:00:00,223,115,108,FMN GV 16 Berchem TOT
54,Posthofbrug 5366,2018-10-10,14:00:00,183,81,102,FMN GV 16 Berchem TOT
54,Posthofbrug 5366,2018-10-10,15:00:00,214,82,132,FMN GV 16 Berchem TOT
54,Posthofbrug 5366,2018-10-10,16:00:00,422,190,232,FMN GV 16 Berchem TOT
54,Posthofbrug 5366,2018-10-10,17:00:00,519,184,335,FMN GV 16 Berchem TOT
54,Posthofbrug 5366,2018-10-10,18:00:00,381,130,251,FMN GV 16 Berchem TOT
54,Posthofbrug 5366,2018-10-10,19:00:00,192,90,102,FMN GV 16 Berchem TOT
54,Posthofbrug 5366,2018-10-10,20:00:00,110,55,55,FMN GV 16 Berchem TOT
54,Posthofbrug 5366,2018-10-10,21:00:00,107,47,60,FMN GV 16 Berchem TOT
54,Posthofbrug 5366,2018-10-10,22:00:00,76,32,44,FMN GV 16 Berchem TOT
54,Posthofbrug 5366,2018-10-10,23:00:00,50,17,33,FMN GV 16 Berchem TOT
54,Posthofbrug 5366,2018-10-11,00:00:00,15,4,11,FMN GV 16 Berchem TOT
54,Posthofbrug 5366,2018-10-11,01:00:00,10,2,8,FMN GV 16 Berchem TOT
54,Posthofbrug 5366,2018-10-11,02:00:00,4,1,3,FMN GV 16 Berchem TOT
54,Posthofbrug 5366,2018-10-11,03:00:00,2,0,2,FMN GV 16 Berchem TOT
54,Posthofbrug 5366,2018-10-11,04:00:00,20,9,11,FMN GV 16 Berchem TOT
54,Posthofbrug 5366,2018-10-11,05:00:00,16,13,3,FMN GV 16 Berchem TOT
54,Posthofbrug 5366,2018-10-11,06:00:00,119,97,22,FMN GV 16 Berchem TOT
54,Posthofbrug 5366,2018-10-11,07:00:00,465,330,135,FMN GV 16 Berchem TOT
54,Posthofbrug 5366,2018-10-11,08:00:00,717,498,219,FMN GV 16 Berchem TOT
54,Posthofbrug 5366,2018-10-11,09:00:00,238,175,63,FMN GV 16 Berchem TOT
54,Posthofbrug 5366,2018-10-11,10:00:00,106,80,26,FMN GV 16 Berchem TOT
54,Posthofbrug 5366,2018-10-11,11:00:00,109,64,45,FMN GV 16 Berchem TOT
54,Posthofbrug 5366,2018-10-11,12:00:00,175,114,61,FMN GV 16 Berchem TOT
54,Posthofbrug 5366,2018-10-11,13:00:00,181,106,75,FMN GV 16 Berchem TOT
54,Posthofbrug 5366,2018-10-11,14:00:00,140,55,85,FMN GV 16 Berchem TOT
54,Posthofbrug 5366,2018-10-11,15:00:00,244,123,121,FMN GV 16 Berchem TOT
54,Posthofbrug 5366,2018-10-11,16:00:00,450,169,281,FMN GV 16 Berchem TOT
54,Posthofbrug 5366,2018-10-11,17:00:00,539,180,359,FMN GV 16 Berchem TOT
54,Posthofbrug 5366,2018-10-11,18:00:00,369,141,228,FMN GV 16 Berchem TOT
54,Posthofbrug 5366,2018-10-11,19:00:00,210,89,121,FMN GV 16 Berchem TOT
54,Posthofbrug 5366,2018-10-11,20:00:00,115,49,66,FMN GV 16 Berchem TOT
54,Posthofbrug 5366,2018-10-11,21:00:00,81,35,46,FMN GV 16 Berchem TOT
54,Posthofbrug 5366,2018-10-11,22:00:00,89,29,60,FMN GV 16 Berchem TOT
54,Posthofbrug 5366,2018-10-11,23:00:00,67,15,52,FMN GV 16 Berchem TOT
54,Posthofbrug 5366,2018-10-12,00:00:00,33,9,24,FMN GV 16 Berchem TOT
54,Posthofbrug 5366,2018-10-12,01:00:00,10,0,10,FMN GV 16 Berchem TOT
54,Posthofbrug 5366,2018-10-12,02:00:00,10,0,10,FMN GV 16 Berchem TOT
54,Posthofbrug 5366,2018-10-12,03:00:00,7,4,3,FMN GV 16 Berchem TOT
54,Posthofbrug 5366,2018-10-12,04:00:00,14,5,9,FMN GV 16 Berchem TOT
54,Posthofbrug 5366,2018-10-12,05:00:00,26,17,9,FMN GV 16 Berchem TOT
54,Posthofbrug 5366,2018-10-12,06:00:00,98,82,16,FMN GV 16 Berchem TOT
54,Posthofbrug 5366,2018-10-12,07:00:00,414,308,106,FMN GV 16 Berchem TOT
54,Posthofbrug 5366,2018-10-12,08:00:00,699,465,234,FMN GV 16 Berchem TOT
54,Posthofbrug 5366,2018-10-12,09:00:00,241,170,71,FMN GV 16 Berchem TOT
54,Posthofbrug 5366,2018-10-12,10:00:00,126,90,36,FMN GV 16 Berchem TOT
54,Posthofbrug 5366,2018-10-12,11:00:00,139,92,47,FMN GV 16 Berchem TOT
54,Posthofbrug 5366,2018-10-12,12:00:00,197,118,79,FMN GV 16 Berchem TOT
54,Posthofbrug 5366,2018-10-12,13:00:00,176,64,112,FMN GV 16 Berchem TOT
54,Posthofbrug 5366,2018-10-12,14:00:00,183,72,111,FMN GV 16 Berchem TOT
54,Posthofbrug 5366,2018-10-12,15:00:00,302,112,190,FMN GV 16 Berchem TOT
54,Posthofbrug 5366,2018-10-12,16:00:00,459,194,265,FMN GV 16 Berchem TOT
54,Posthofbrug 5366,2018-10-12,17:00:00,470,166,304,FMN GV 16 Berchem TOT
54,Posthofbrug 5366,2018-10-12,18:00:00,345,141,204,FMN GV 16 Berchem TOT
54,Posthofbrug 5366,2018-10-12,19:00:00,179,100,79,FMN GV 16 Berchem TOT
54,Posthofbrug 5366,2018-10-12,20:00:00,103,41,62,FMN GV 16 Berchem TOT
54,Posthofbrug 5366,2018-10-12,21:00:00,80,40,40,FMN GV 16 Berchem TOT
54,Posthofbrug 5366,2018-10-12,22:00:00,77,22,55,FMN GV 16 Berchem TOT
54,Posthofbrug 5366,2018-10-12,23:00:00,61,26,35,FMN GV 16 Berchem TOT
54,Posthofbrug 5366,2018-10-13,00:00:00,70,23,47,FMN GV 16 Berchem TOT
54,Posthofbrug 5366,2018-10-13,01:00:00,36,6,30,FMN GV 16 Berchem TOT
54,Posthofbrug 5366,2018-10-13,02:00:00,21,3,18,FMN GV 16 Berchem TOT
54,Posthofbrug 5366,2018-10-13,03:00:00,14,1,13,FMN GV 16 Berchem TOT
54,Posthofbrug 5366,2018-10-13,04:00:00,26,7,19,FMN GV 16 Berchem TOT
54,Posthofbrug 5366,2018-10-13,05:00:00,8,2,6,FMN GV 16 Berchem TOT
54,Posthofbrug 5366,2018-10-13,06:00:00,16,12,4,FMN GV 16 Berchem TOT
54,Posthofbrug 5366,2018-10-13,07:00:00,27,16,11,FMN GV 16 Berchem TOT
54,Posthofbrug 5366,2018-10-13,08:00:00,91,45,46,FMN GV 16 Berchem TOT
54,Posthofbrug 5366,2018-10-13,09:00:00,161,98,63,FMN GV 16 Berchem TOT
54,Posthofbrug 5366,2018-10-13,10:00:00,161,100,61,FMN GV 16 Berchem TOT
54,Posthofbrug 5366,2018-10-13,11:00:00,166,110,56,FMN GV 16 Berchem TOT
54,Posthofbrug 5366,2018-10-13,12:00:00,173,101,72,FMN GV 16 Berchem TOT
54,Posthofbrug 5366,2018-10-13,13:00:00,225,137,88,FMN GV 16 Berchem TOT
54,Posthofbrug 5366,2018-10-13,14:00:00,273,171,102,FMN GV 16 Berchem TOT
54,Posthofbrug 5366,2018-10-13,15:00:00,229,138,91,FMN GV 16 Berchem TOT
54,Posthofbrug 5366,2018-10-13,16:00:00,241,108,133,FMN GV 16 Berchem TOT
54,Posthofbrug 5366,2018-10-13,17:00:00,229,112,117,FMN GV 16 Berchem TOT
54,Posthofbrug 5366,2018-10-13,18:00:00,197,87,110,FMN GV 16 Berchem TOT
54,Posthofbrug 5366,2018-10-13,19:00:00,151,72,79,FMN GV 16 Berchem TOT
54,Posthofbrug 5366,2018-10-13,20:00:00,130,65,65,FMN GV 16 Berchem TOT
54,Posthofbrug 5366,2018-10-13,21:00:00,79,46,33,FMN GV 16 Berchem TOT
54,Posthofbrug 5366,2018-10-13,22:00:00,82,24,58,FMN GV 16 Berchem TOT
54,Posthofbrug 5366,2018-10-13,23:00:00,73,23,50,FMN GV 16 Berchem TOT
54,Posthofbrug 5366,2018-10-14,00:00:00,48,13,35,FMN GV 16 Berchem TOT
54,Posthofbrug 5366,2018-10-14,01:00:00,31,6,25,FMN GV 16 Berchem TOT
54,Posthofbrug 5366,2018-10-14,02:00:00,29,10,19,FMN GV 16 Berchem TOT
54,Posthofbrug 5366,2018-10-14,03:00:00,12,4,8,FMN GV 16 Berchem TOT
54,Posthofbrug 5366,2018-10-14,04:00:00,12,1,11,FMN GV 16 Berchem TOT
54,Posthofbrug 5366,2018-10-14,05:00:00,13,5,8,FMN GV 16 Berchem TOT
54,Posthofbrug 5366,2018-10-14,06:00:00,17,9,8,FMN GV 16 Berchem TOT
54,Posthofbrug 5366,2018-10-14,07:00:00,9,2,7,FMN GV 16 Berchem TOT
54,Posthofbrug 5366,2018-10-14,08:00:00,29,12,17,FMN GV 16 Berchem TOT
54,Posthofbrug 5366,2018-10-14,09:00:00,95,55,40,FMN GV 16 Berchem TOT
54,Posthofbrug 5366,2018-10-14,10:00:00,100,69,31,FMN GV 16 Berchem TOT
54,Posthofbrug 5366,2018-10-14,11:00:00,132,81,51,FMN GV 16 Berchem TOT
54,Posthofbrug 5366,2018-10-14,12:00:00,155,99,56,FMN GV 16 Berchem TOT
54,Posthofbrug 5366,2018-10-14,13:00:00,209,124,85,FMN GV 16 Berchem TOT
54,Posthofbrug 5366,2018-10-14,14:00:00,222,119,103,FMN GV 16 Berchem TOT
54,Posthofbrug 5366,2018-10-14,15:00:00,143,75,68,FMN GV 16 Berchem TOT
54,Posthofbrug 5366,2018-10-14,16:00:00,173,97,76,FMN GV 16 Berchem TOT
54,Posthofbrug 5366,2018-10-14,17:00:00,173,70,103,FMN GV 16 Berchem TOT
54,Posthofbrug 5366,2018-10-14,18:00:00,106,58,48,FMN GV 16 Berchem TOT
54,Posthofbrug 5366,2018-10-14,19:00:00,94,51,43,FMN GV 16 Berchem TOT
54,Posthofbrug 5366,2018-10-14,20:00:00,69,40,29,FMN GV 16 Berchem TOT
54,Posthofbrug 5366,2018-10-14,21:00:00,67,28,39,FMN GV 16 Berchem TOT
54,Posthofbrug 5366,2018-10-14,22:00:00,64,14,50,FMN GV 16 Berchem TOT
54,Posthofbrug 5366,2018-10-14,23:00:00,31,4,27,FMN GV 16 Berchem TOT
54,Posthofbrug 5366,2018-10-15,00:00:00,9,2,7,FMN GV 16 Berchem TOT
54,Posthofbrug 5366,2018-10-15,01:00:00,6,0,6,FMN GV 16 Berchem TOT
54,Posthofbrug 5366,2018-10-15,02:00:00,1,0,1,FMN GV 16 Berchem TOT
54,Posthofbrug 5366,2018-10-15,03:00:00,3,0,3,FMN GV 16 Berchem TOT
54,Posthofbrug 5366,2018-10-15,04:00:00,7,6,1,FMN GV 16 Berchem TOT
54,Posthofbrug 5366,2018-10-15,05:00:00,22,16,6,FMN GV 16 Berchem TOT
54,Posthofbrug 5366,2018-10-15,06:00:00,108,91,17,FMN GV 16 Berchem TOT
54,Posthofbrug 5366,2018-10-15,07:00:00,512,360,152,FMN GV 16 Berchem TOT
54,Posthofbrug 5366,2018-10-15,08:00:00,799,547,252,FMN GV 16 Berchem TOT
54,Posthofbrug 5366,2018-10-15,09:00:00,251,177,74,FMN GV 16 Berchem TOT
54,Posthofbrug 5366,2018-10-15,10:00:00,105,79,26,FMN GV 16 Berchem TOT
54,Posthofbrug 5366,2018-10-15,11:00:00,120,72,48,FMN GV 16 Berchem TOT
54,Posthofbrug 5366,2018-10-15,12:00:00,146,80,66,FMN GV 16 Berchem TOT
54,Posthofbrug 5366,2018-10-15,13:00:00,162,91,71,FMN GV 16 Berchem TOT
54,Posthofbrug 5366,2018-10-15,14:00:00,142,55,87,FMN GV 16 Berchem TOT
54,Posthofbrug 5366,2018-10-15,15:00:00,259,110,149,FMN GV 16 Berchem TOT
54,Posthofbrug 5366,2018-10-15,16:00:00,528,209,319,FMN GV 16 Berchem TOT
54,Posthofbrug 5366,2018-10-15,17:00:00,586,215,371,FMN GV 16 Berchem TOT
54,Posthofbrug 5366,2018-10-15,18:00:00,436,156,280,FMN GV 16 Berchem TOT
54,Posthofbrug 5366,2018-10-15,19:00:00,165,69,96,FMN GV 16 Berchem TOT
54,Posthofbrug 5366,2018-10-15,20:00:00,96,50,46,FMN GV 16 Berchem TOT
54,Posthofbrug 5366,2018-10-15,21:00:00,79,32,47,FMN GV 16 Berchem TOT
54,Posthofbrug 5366,2018-10-15,22:00:00,63,29,34,FMN GV 16 Berchem TOT
54,Posthofbrug 5366,2018-10-15,23:00:00,40,11,29,FMN GV 16 Berchem TOT
54,Posthofbrug 5366,2018-10-16,00:00:00,26,5,21,FMN GV 16 Berchem TOT
54,Posthofbrug 5366,2018-10-16,01:00:00,10,2,8,FMN GV 16 Berchem TOT
54,Posthofbrug 5366,2018-10-16,02:00:00,8,0,8,FMN GV 16 Berchem TOT
54,Posthofbrug 5366,2018-10-16,03:00:00,4,3,1,FMN GV 16 Berchem TOT
54,Posthofbrug 5366,2018-10-16,04:00:00,9,5,4,FMN GV 16 Berchem TOT
54,Posthofbrug 5366,2018-10-16,05:00:00,32,21,11,FMN GV 16 Berchem TOT
54,Posthofbrug 5366,2018-10-16,06:00:00,135,109,26,FMN GV 16 Berchem TOT
54,Posthofbrug 5366,2018-10-16,07:00:00,562,396,166,FMN GV 16 Berchem TOT
54,Posthofbrug 5366,2018-10-16,08:00:00,871,601,270,FMN GV 16 Berchem TOT
54,Posthofbrug 5366,2018-10-16,09:00:00,256,179,77,FMN GV 16 Berchem TOT
54,Posthofbrug 5366,2018-10-16,10:00:00,130,91,39,FMN GV 16 Berchem TOT
54,Posthofbrug 5366,2018-10-16,11:00:00,115,77,38,FMN GV 16 Berchem TOT
54,Posthofbrug 5366,2018-10-16,12:00:00,176,97,79,FMN GV 16 Berchem TOT
54,Posthofbrug 5366,2018-10-16,13:00:00,185,100,85,FMN GV 16 Berchem TOT
54,Posthofbrug 5366,2018-10-16,14:00:00,159,67,92,FMN GV 16 Berchem TOT
54,Posthofbrug 5366,2018-10-16,15:00:00,282,114,168,FMN GV 16 Berchem TOT
54,Posthofbrug 5366,2018-10-16,16:00:00,524,201,323,FMN GV 16 Berchem TOT
54,Posthofbrug 5366,2018-10-16,17:00:00,645,232,413,FMN GV 16 Berchem TOT
54,Posthofbrug 5366,2018-10-16,18:00:00,442,151,291,FMN GV 16 Berchem TOT
54,Posthofbrug 5366,2018-10-16,19:00:00,198,77,121,FMN GV 16 Berchem TOT
54,Posthofbrug 5366,2018-10-16,20:00:00,119,48,71,FMN GV 16 Berchem TOT
54,Posthofbrug 5366,2018-10-16,21:00:00,90,34,56,FMN GV 16 Berchem TOT
54,Posthofbrug 5366,2018-10-16,22:00:00,83,28,55,FMN GV 16 Berchem TOT
54,Posthofbrug 5366,2018-10-16,23:00:00,49,17,32,FMN GV 16 Berchem TOT
54,Posthofbrug 5366,2018-10-17,00:00:00,17,4,13,FMN GV 16 Berchem TOT
54,Posthofbrug 5366,2018-10-17,01:00:00,8,2,6,FMN GV 16 Berchem TOT
54,Posthofbrug 5366,2018-10-17,02:00:00,4,3,1,FMN GV 16 Berchem TOT
54,Posthofbrug 5366,2018-10-17,03:00:00,9,3,6,FMN GV 16 Berchem TOT
54,Posthofbrug 5366,2018-10-17,04:00:00,12,8,4,FMN GV 16 Berchem TOT
54,Posthofbrug 5366,2018-10-17,05:00:00,27,16,11,FMN GV 16 Berchem TOT
54,Posthofbrug 5366,2018-10-17,06:00:00,100,79,21,FMN GV 16 Berchem TOT
54,Posthofbrug 5366,2018-10-17,07:00:00,514,379,135,FMN GV 16 Berchem TOT
54,Posthofbrug 5366,2018-10-17,08:00:00,727,458,269,FMN GV 16 Berchem TOT
54,Posthofbrug 5366,2018-10-17,09:00:00,234,150,84,FMN GV 16 Berchem TOT
54,Posthofbrug 5366,2018-10-17,10:00:00,120,79,41,FMN GV 16 Berchem TOT
54,Posthofbrug 5366,2018-10-17,11:00:00,146,89,57,FMN GV 16 Berchem TOT
54,Posthofbrug 5366,2018-10-17,12:00:00,293,155,138,FMN GV 16 Berchem TOT
54,Posthofbrug 5366,2018-10-17,13:00:00,207,105,102,FMN GV 16 Berchem TOT
54,Posthofbrug 5366,2018-10-17,14:00:00,171,91,80,FMN GV 16 Berchem TOT
54,Posthofbrug 5366,2018-10-17,15:00:00,200,93,107,FMN GV 16 Berchem TOT
54,Posthofbrug 5366,2018-10-17,16:00:00,394,188,206,FMN GV 16 Berchem TOT
54,Posthofbrug 5366,2018-10-17,17:00:00,579,221,358,FMN GV 16 Berchem TOT
54,Posthofbrug 5366,2018-10-17,18:00:00,351,130,221,FMN GV 16 Berchem TOT
54,Posthofbrug 5366,2018-10-17,19:00:00,163,80,83,FMN GV 16 Berchem TOT
54,Posthofbrug 5366,2018-10-17,20:00:00,118,61,57,FMN GV 16 Berchem TOT
54,Posthofbrug 5366,2018-10-17,21:00:00,102,31,71,FMN GV 16 Berchem TOT
54,Posthofbrug 5366,2018-10-17,22:00:00,77,40,37,FMN GV 16 Berchem TOT
54,Posthofbrug 5366,2018-10-17,23:00:00,57,14,43,FMN GV 16 Berchem TOT
54,Posthofbrug 5366,2018-10-18,00:00:00,25,8,17,FMN GV 16 Berchem TOT
54,Posthofbrug 5366,2018-10-18,01:00:00,8,1,7,FMN GV 16 Berchem TOT
54,Posthofbrug 5366,2018-10-18,02:00:00,5,0,5,FMN GV 16 Berchem TOT
54,Posthofbrug 5366,2018-10-18,03:00:00,2,0,2,FMN GV 16 Berchem TOT
54,Posthofbrug 5366,2018-10-18,04:00:00,10,6,4,FMN GV 16 Berchem TOT
54,Posthofbrug 5366,2018-10-18,05:00:00,33,17,16,FMN GV 16 Berchem TOT
54,Posthofbrug 5366,2018-10-18,06:00:00,118,97,21,FMN GV 16 Berchem TOT
54,Posthofbrug 5366,2018-10-18,07:00:00,491,357,134,FMN GV 16 Berchem TOT
54,Posthofbrug 5366,2018-10-18,08:00:00,801,522,279,FMN GV 16 Berchem TOT
54,Posthofbrug 5366,2018-10-18,09:00:00,273,185,88,FMN GV 16 Berchem TOT
54,Posthofbrug 5366,2018-10-18,10:00:00,121,88,33,FMN GV 16 Berchem TOT
54,Posthofbrug 5366,2018-10-18,11:00:00,125,72,53,FMN GV 16 Berchem TOT
54,Posthofbrug 5366,2018-10-18,12:00:00,166,103,63,FMN GV 16 Berchem TOT
54,Posthofbrug 5366,2018-10-18,13:00:00,137,77,60,FMN GV 16 Berchem TOT
54,Posthofbrug 5366,2018-10-18,14:00:00,110,38,72,FMN GV 16 Berchem TOT
54,Posthofbrug 5366,2018-10-18,15:00:00,279,134,145,FMN GV 16 Berchem TOT
54,Posthofbrug 5366,2018-10-18,16:00:00,462,178,284,FMN GV 16 Berchem TOT
54,Posthofbrug 5366,2018-10-18,17:00:00,564,210,354,FMN GV 16 Berchem TOT
54,Posthofbrug 5366,2018-10-18,18:00:00,405,163,242,FMN GV 16 Berchem TOT
54,Posthofbrug 5366,2018-10-18,19:00:00,214,92,122,FMN GV 16 Berchem TOT
54,Posthofbrug 5366,2018-10-18,20:00:00,102,48,54,FMN GV 16 Berchem TOT
54,Posthofbrug 5366,2018-10-18,21:00:00,90,31,59,FMN GV 16 Berchem TOT
54,Posthofbrug 5366,2018-10-18,22:00:00,80,30,50,FMN GV 16 Berchem TOT
54,Posthofbrug 5366,2018-10-18,23:00:00,63,23,40,FMN GV 16 Berchem TOT
54,Posthofbrug 5366,2018-10-19,00:00:00,38,8,30,FMN GV 16 Berchem TOT
54,Posthofbrug 5366,2018-10-19,01:00:00,23,9,14,FMN GV 16 Berchem TOT
54,Posthofbrug 5366,2018-10-19,02:00:00,5,0,5,FMN GV 16 Berchem TOT
54,Posthofbrug 5366,2018-10-19,03:00:00,5,3,2,FMN GV 16 Berchem TOT
54,Posthofbrug 5366,2018-10-19,04:00:00,17,13,4,FMN GV 16 Berchem TOT
54,Posthofbrug 5366,2018-10-19,05:00:00,15,10,5,FMN GV 16 Berchem TOT
54,Posthofbrug 5366,2018-10-19,06:00:00,114,95,19,FMN GV 16 Berchem TOT
54,Posthofbrug 5366,2018-10-19,07:00:00,457,319,138,FMN GV 16 Berchem TOT
54,Posthofbrug 5366,2018-10-19,08:00:00,713,492,221,FMN GV 16 Berchem TOT
54,Posthofbrug 5366,2018-10-19,09:00:00,246,149,97,FMN GV 16 Berchem TOT
54,Posthofbrug 5366,2018-10-19,10:00:00,129,88,41,FMN GV 16 Berchem TOT
54,Posthofbrug 5366,2018-10-19,11:00:00,121,83,38,FMN GV 16 Berchem TOT
54,Posthofbrug 5366,2018-10-19,12:00:00,197,112,85,FMN GV 16 Berchem TOT
54,Posthofbrug 5366,2018-10-19,13:00:00,166,83,83,FMN GV 16 Berchem TOT
54,Posthofbrug 5366,2018-10-19,14:00:00,154,77,77,FMN GV 16 Berchem TOT
54,Posthofbrug 5366,2018-10-19,15:00:00,295,114,181,FMN GV 16 Berchem TOT
54,Posthofbrug 5366,2018-10-19,16:00:00,426,159,267,FMN GV 16 Berchem TOT
54,Posthofbrug 5366,2018-10-19,17:00:00,511,209,302,FMN GV 16 Berchem TOT
54,Posthofbrug 5366,2018-10-19,18:00:00,295,127,168,FMN GV 16 Berchem TOT
54,Posthofbrug 5366,2018-10-19,19:00:00,256,152,104,FMN GV 16 Berchem TOT
54,Posthofbrug 5366,2018-10-19,20:00:00,78,49,29,FMN GV 16 Berchem TOT
54,Posthofbrug 5366,2018-10-19,21:00:00,99,65,34,FMN GV 16 Berchem TOT
54,Posthofbrug 5366,2018-10-19,22:00:00,100,45,55,FMN GV 16 Berchem TOT
54,Posthofbrug 5366,2018-10-19,23:00:00,86,34,52,FMN GV 16 Berchem TOT
54,Posthofbrug 5366,2018-10-20,00:00:00,109,58,51,FMN GV 16 Berchem TOT
54,Posthofbrug 5366,2018-10-20,01:00:00,33,8,25,FMN GV 16 Berchem TOT
54,Posthofbrug 5366,2018-10-20,02:00:00,47,7,40,FMN GV 16 Berchem TOT
54,Posthofbrug 5366,2018-10-20,03:00:00,56,3,53,FMN GV 16 Berchem TOT
54,Posthofbrug 5366,2018-10-20,04:00:00,34,4,30,FMN GV 16 Berchem TOT
54,Posthofbrug 5366,2018-10-20,05:00:00,22,5,17,FMN GV 16 Berchem TOT
54,Posthofbrug 5366,2018-10-20,06:00:00,23,10,13,FMN GV 16 Berchem TOT
54,Posthofbrug 5366,2018-10-20,07:00:00,32,15,17,FMN GV 16 Berchem TOT
54,Posthofbrug 5366,2018-10-20,08:00:00,69,32,37,FMN GV 16 Berchem TOT
54,Posthofbrug 5366,2018-10-20,09:00:00,135,72,63,FMN GV 16 Berchem TOT
54,Posthofbrug 5366,2018-10-20,10:00:00,129,82,47,FMN GV 16 Berchem TOT
54,Posthofbrug 5366,2018-10-20,11:00:00,111,69,42,FMN GV 16 Berchem TOT
54,Posthofbrug 5366,2018-10-20,12:00:00,137,99,38,FMN GV 16 Berchem TOT
54,Posthofbrug 5366,2018-10-20,13:00:00,136,90,46,FMN GV 16 Berchem TOT
54,Posthofbrug 5366,2018-10-20,14:00:00,172,82,90,FMN GV 16 Berchem TOT
54,Posthofbrug 5366,2018-10-20,15:00:00,172,78,94,FMN GV 16 Berchem TOT
54,Posthofbrug 5366,2018-10-20,16:00:00,145,75,70,FMN GV 16 Berchem TOT
54,Posthofbrug 5366,2018-10-20,17:00:00,162,84,78,FMN GV 16 Berchem TOT
54,Posthofbrug 5366,2018-10-20,18:00:00,139,61,78,FMN GV 16 Berchem TOT
54,Posthofbrug 5366,2018-10-20,19:00:00,98,55,43,FMN GV 16 Berchem TOT
54,Posthofbrug 5366,2018-10-20,20:00:00,63,37,26,FMN GV 16 Berchem TOT
54,Posthofbrug 5366,2018-10-20,21:00:00,42,25,17,FMN GV 16 Berchem TOT
54,Posthofbrug 5366,2018-10-20,22:00:00,44,18,26,FMN GV 16 Berchem TOT
54,Posthofbrug 5366,2018-10-20,23:00:00,75,32,43,FMN GV 16 Berchem TOT
54,Posthofbrug 5366,2018-10-21,00:00:00,60,21,39,FMN GV 16 Berchem TOT
54,Posthofbrug 5366,2018-10-21,01:00:00,52,19,33,FMN GV 16 Berchem TOT
54,Posthofbrug 5366,2018-10-21,02:00:00,20,7,13,FMN GV 16 Berchem TOT
54,Posthofbrug 5366,2018-10-21,03:00:00,18,2,16,FMN GV 16 Berchem TOT
54,Posthofbrug 5366,2018-10-21,04:00:00,20,3,17,FMN GV 16 Berchem TOT
54,Posthofbrug 5366,2018-10-21,05:00:00,10,6,4,FMN GV 16 Berchem TOT
54,Posthofbrug 5366,2018-10-21,06:00:00,16,7,9,FMN GV 16 Berchem TOT
54,Posthofbrug 5366,2018-10-21,07:00:00,15,6,9,FMN GV 16 Berchem TOT
54,Posthofbrug 5366,2018-10-21,08:00:00,30,12,18,FMN GV 16 Berchem TOT
54,Posthofbrug 5366,2018-10-21,09:00:00,73,39,34,FMN GV 16 Berchem TOT
54,Posthofbrug 5366,2018-10-21,10:00:00,144,115,29,FMN GV 16 Berchem TOT
54,Posthofbrug 5366,2018-10-21,11:00:00,134,76,58,FMN GV 16 Berchem TOT
54,Posthofbrug 5366,2018-10-21,12:00:00,140,72,68,FMN GV 16 Berchem TOT
54,Posthofbrug 5366,2018-10-21,13:00:00,149,88,61,FMN GV 16 Berchem TOT
54,Posthofbrug 5366,2018-10-21,14:00:00,164,91,73,FMN GV 16 Berchem TOT
54,Posthofbrug 5366,2018-10-21,15:00:00,148,59,89,FMN GV 16 Berchem TOT
54,Posthofbrug 5366,2018-10-21,16:00:00,143,72,71,FMN GV 16 Berchem TOT
54,Posthofbrug 5366,2018-10-21,17:00:00,161,78,83,FMN GV 16 Berchem TOT
54,Posthofbrug 5366,2018-10-21,18:00:00,102,47,55,FMN GV 16 Berchem TOT
54,Posthofbrug 5366,2018-10-21,19:00:00,83,39,44,FMN GV 16 Berchem TOT
54,Posthofbrug 5366,2018-10-21,20:00:00,55,24,31,FMN GV 16 Berchem TOT
54,Posthofbrug 5366,2018-10-21,21:00:00,35,20,15,FMN GV 16 Berchem TOT
54,Posthofbrug 5366,2018-10-21,22:00:00,23,14,9,FMN GV 16 Berchem TOT
54,Posthofbrug 5366,2018-10-21,23:00:00,11,7,4,FMN GV 16 Berchem TOT
54,Posthofbrug 5366,2018-10-22,00:00:00,4,1,3,FMN GV 16 Berchem TOT
54,Posthofbrug 5366,2018-10-22,01:00:00,3,0,3,FMN GV 16 Berchem TOT
54,Posthofbrug 5366,2018-10-22,02:00:00,2,0,2,FMN GV 16 Berchem TOT
54,Posthofbrug 5366,2018-10-22,03:00:00,4,3,1,FMN GV 16 Berchem TOT
54,Posthofbrug 5366,2018-10-22,04:00:00,5,3,2,FMN GV 16 Berchem TOT
54,Posthofbrug 5366,2018-10-22,05:00:00,15,10,5,FMN GV 16 Berchem TOT
54,Posthofbrug 5366,2018-10-22,06:00:00,114,94,20,FMN GV 16 Berchem TOT
54,Posthofbrug 5366,2018-10-22,07:00:00,467,362,105,FMN GV 16 Berchem TOT
54,Posthofbrug 5366,2018-10-22,08:00:00,734,500,234,FMN GV 16 Berchem TOT
54,Posthofbrug 5366,2018-10-22,09:00:00,242,152,90,FMN GV 16 Berchem TOT
54,Posthofbrug 5366,2018-10-22,10:00:00,96,66,30,FMN GV 16 Berchem TOT
54,Posthofbrug 5366,2018-10-22,11:00:00,100,75,25,FMN GV 16 Berchem TOT
54,Posthofbrug 5366,2018-10-22,12:00:00,136,77,59,FMN GV 16 Berchem TOT
54,Posthofbrug 5366,2018-10-22,13:00:00,144,68,76,FMN GV 16 Berchem TOT
54,Posthofbrug 5366,2018-10-22,14:00:00,117,53,64,FMN GV 16 Berchem TOT
54,Posthofbrug 5366,2018-10-22,15:00:00,218,88,130,FMN GV 16 Berchem TOT
54,Posthofbrug 5366,2018-10-22,16:00:00,435,183,252,FMN GV 16 Berchem TOT
54,Posthofbrug 5366,2018-10-22,17:00:00,540,198,342,FMN GV 16 Berchem TOT
54,Posthofbrug 5366,2018-10-22,18:00:00,389,136,253,FMN GV 16 Berchem TOT
54,Posthofbrug 5366,2018-10-22,19:00:00,161,60,101,FMN GV 16 Berchem TOT
54,Posthofbrug 5366,2018-10-22,20:00:00,91,37,54,FMN GV 16 Berchem TOT
54,Posthofbrug 5366,2018-10-22,21:00:00,84,27,57,FMN GV 16 Berchem TOT
54,Posthofbrug 5366,2018-10-22,22:00:00,84,30,54,FMN GV 16 Berchem TOT
54,Posthofbrug 5366,2018-10-22,23:00:00,44,17,27,FMN GV 16 Berchem TOT
54,Posthofbrug 5366,2018-10-23,00:00:00,13,1,12,FMN GV 16 Berchem TOT
54,Posthofbrug 5366,2018-10-23,01:00:00,5,0,5,FMN GV 16 Berchem TOT
54,Posthofbrug 5366,2018-10-23,02:00:00,2,0,2,FMN GV 16 Berchem TOT
54,Posthofbrug 5366,2018-10-23,03:00:00,2,1,1,FMN GV 16 Berchem TOT
54,Posthofbrug 5366,2018-10-23,04:00:00,7,6,1,FMN GV 16 Berchem TOT
54,Posthofbrug 5366,2018-10-23,05:00:00,24,15,9,FMN GV 16 Berchem TOT
54,Posthofbrug 5366,2018-10-23,06:00:00,115,93,22,FMN GV 16 Berchem TOT
54,Posthofbrug 5366,2018-10-23,07:00:00,499,365,134,FMN GV 16 Berchem TOT
54,Posthofbrug 5366,2018-10-23,08:00:00,820,523,297,FMN GV 16 Berchem TOT
54,Posthofbrug 5366,2018-10-23,09:00:00,256,177,79,FMN GV 16 Berchem TOT
54,Posthofbrug 5366,2018-10-23,10:00:00,100,69,31,FMN GV 16 Berchem TOT
54,Posthofbrug 5366,2018-10-23,11:00:00,83,49,34,FMN GV 16 Berchem TOT
54,Posthofbrug 5366,2018-10-23,12:00:00,181,114,67,FMN GV 16 Berchem TOT
54,Posthofbrug 5366,2018-10-23,13:00:00,171,92,79,FMN GV 16 Berchem TOT
54,Posthofbrug 5366,2018-10-23,14:00:00,137,73,64,FMN GV 16 Berchem TOT
54,Posthofbrug 5366,2018-10-23,15:00:00,225,96,129,FMN GV 16 Berchem TOT
54,Posthofbrug 5366,2018-10-23,16:00:00,474,178,296,FMN GV 16 Berchem TOT
54,Posthofbrug 5366,2018-10-23,17:00:00,585,204,381,FMN GV 16 Berchem TOT
54,Posthofbrug 5366,2018-10-23,18:00:00,394,120,274,FMN GV 16 Berchem TOT
54,Posthofbrug 5366,2018-10-23,19:00:00,188,68,120,FMN GV 16 Berchem TOT
54,Posthofbrug 5366,2018-10-23,20:00:00,113,42,71,FMN GV 16 Berchem TOT
54,Posthofbrug 5366,2018-10-23,21:00:00,91,39,52,FMN GV 16 Berchem TOT
54,Posthofbrug 5366,2018-10-23,22:00:00,87,25,62,FMN GV 16 Berchem TOT
54,Posthofbrug 5366,2018-10-23,23:00:00,73,21,52,FMN GV 16 Berchem TOT
54,Posthofbrug 5366,2018-10-24,00:00:00,14,5,9,FMN GV 16 Berchem TOT
54,Posthofbrug 5366,2018-10-24,01:00:00,8,1,7,FMN GV 16 Berchem TOT
54,Posthofbrug 5366,2018-10-24,02:00:00,4,0,4,FMN GV 16 Berchem TOT
54,Posthofbrug 5366,2018-10-24,03:00:00,4,2,2,FMN GV 16 Berchem TOT
54,Posthofbrug 5366,2018-10-24,04:00:00,7,5,2,FMN GV 16 Berchem TOT
54,Posthofbrug 5366,2018-10-24,05:00:00,18,14,4,FMN GV 16 Berchem TOT
54,Posthofbrug 5366,2018-10-24,06:00:00,111,96,15,FMN GV 16 Berchem TOT
54,Posthofbrug 5366,2018-10-24,07:00:00,436,317,119,FMN GV 16 Berchem TOT
54,Posthofbrug 5366,2018-10-24,08:00:00,725,478,247,FMN GV 16 Berchem TOT
54,Posthofbrug 5366,2018-10-24,09:00:00,219,145,74,FMN GV 16 Berchem TOT
54,Posthofbrug 5366,2018-10-24,10:00:00,109,75,34,FMN GV 16 Berchem TOT
54,Posthofbrug 5366,2018-10-24,11:00:00,116,71,45,FMN GV 16 Berchem TOT
54,Posthofbrug 5366,2018-10-24,12:00:00,227,119,108,FMN GV 16 Berchem TOT
54,Posthofbrug 5366,2018-10-24,13:00:00,162,81,81,FMN GV 16 Berchem TOT
54,Posthofbrug 5366,2018-10-24,14:00:00,138,71,67,FMN GV 16 Berchem TOT
54,Posthofbrug 5366,2018-10-24,15:00:00,187,82,105,FMN GV 16 Berchem TOT
54,Posthofbrug 5366,2018-10-24,16:00:00,346,153,193,FMN GV 16 Berchem TOT
54,Posthofbrug 5366,2018-10-24,17:00:00,505,197,308,FMN GV 16 Berchem TOT
54,Posthofbrug 5366,2018-10-24,18:00:00,301,118,183,FMN GV 16 Berchem TOT
54,Posthofbrug 5366,2018-10-24,19:00:00,146,59,87,FMN GV 16 Berchem TOT
54,Posthofbrug 5366,2018-10-24,20:00:00,87,37,50,FMN GV 16 Berchem TOT
54,Posthofbrug 5366,2018-10-24,21:00:00,67,28,39,FMN GV 16 Berchem TOT
54,Posthofbrug 5366,2018-10-24,22:00:00,76,28,48,FMN GV 16 Berchem TOT
54,Posthofbrug 5366,2018-10-24,23:00:00,57,19,38,FMN GV 16 Berchem TOT
54,Posthofbrug 5366,2018-10-25,00:00:00,19,4,15,FMN GV 16 Berchem TOT
54,Posthofbrug 5366,2018-10-25,01:00:00,4,2,2,FMN GV 16 Berchem TOT
54,Posthofbrug 5366,2018-10-25,02:00:00,6,0,6,FMN GV 16 Berchem TOT
54,Posthofbrug 5366,2018-10-25,03:00:00,8,4,4,FMN GV 16 Berchem TOT
54,Posthofbrug 5366,2018-10-25,04:00:00,12,8,4,FMN GV 16 Berchem TOT
54,Posthofbrug 5366,2018-10-25,05:00:00,17,12,5,FMN GV 16 Berchem TOT
54,Posthofbrug 5366,2018-10-25,06:00:00,104,87,17,FMN GV 16 Berchem TOT
54,Posthofbrug 5366,2018-10-25,07:00:00,451,332,119,FMN GV 16 Berchem TOT
54,Posthofbrug 5366,2018-10-25,08:00:00,729,481,248,FMN GV 16 Berchem TOT
54,Posthofbrug 5366,2018-10-25,09:00:00,250,176,74,FMN GV 16 Berchem TOT
54,Posthofbrug 5366,2018-10-25,10:00:00,116,77,39,FMN GV 16 Berchem TOT
54,Posthofbrug 5366,2018-10-25,11:00:00,86,55,31,FMN GV 16 Berchem TOT
54,Posthofbrug 5366,2018-10-25,12:00:00,137,67,70,FMN GV 16 Berchem TOT
54,Posthofbrug 5366,2018-10-25,13:00:00,157,78,79,FMN GV 16 Berchem TOT
54,Posthofbrug 5366,2018-10-25,14:00:00,130,65,65,FMN GV 16 Berchem TOT
54,Posthofbrug 5366,2018-10-25,15:00:00,237,102,135,FMN GV 16 Berchem TOT
54,Posthofbrug 5366,2018-10-25,16:00:00,400,159,241,FMN GV 16 Berchem TOT
54,Posthofbrug 5366,2018-10-25,17:00:00,566,217,349,FMN GV 16 Berchem TOT
54,Posthofbrug 5366,2018-10-25,18:00:00,322,119,203,FMN GV 16 Berchem TOT
54,Posthofbrug 5366,2018-10-25,19:00:00,198,64,134,FMN GV 16 Berchem TOT
54,Posthofbrug 5366,2018-10-25,20:00:00,109,56,53,FMN GV 16 Berchem TOT
54,Posthofbrug 5366,2018-10-25,21:00:00,81,37,44,FMN GV 16 Berchem TOT
54,Posthofbrug 5366,2018-10-25,22:00:00,93,35,58,FMN GV 16 Berchem TOT
54,Posthofbrug 5366,2018-10-25,23:00:00,52,14,38,FMN GV 16 Berchem TOT
54,Posthofbrug 5366,2018-10-26,00:00:00,30,4,26,FMN GV 16 Berchem TOT
54,Posthofbrug 5366,2018-10-26,01:00:00,8,2,6,FMN GV 16 Berchem TOT
54,Posthofbrug 5366,2018-10-26,02:00:00,3,1,2,FMN GV 16 Berchem TOT
54,Posthofbrug 5366,2018-10-26,03:00:00,30,13,17,FMN GV 16 Berchem TOT
54,Posthofbrug 5366,2018-10-26,04:00:00,10,5,5,FMN GV 16 Berchem TOT
54,Posthofbrug 5366,2018-10-26,05:00:00,12,10,2,FMN GV 16 Berchem TOT
54,Posthofbrug 5366,2018-10-26,06:00:00,93,79,14,FMN GV 16 Berchem TOT
54,Posthofbrug 5366,2018-10-26,07:00:00,370,270,100,FMN GV 16 Berchem TOT
54,Posthofbrug 5366,2018-10-26,08:00:00,647,415,232,FMN GV 16 Berchem TOT
54,Posthofbrug 5366,2018-10-26,09:00:00,217,143,74,FMN GV 16 Berchem TOT
54,Posthofbrug 5366,2018-10-26,10:00:00,113,90,23,FMN GV 16 Berchem TOT
54,Posthofbrug 5366,2018-10-26,11:00:00,104,63,41,FMN GV 16 Berchem TOT
54,Posthofbrug 5366,2018-10-26,12:00:00,172,95,77,FMN GV 16 Berchem TOT
54,Posthofbrug 5366,2018-10-26,13:00:00,126,64,62,FMN GV 16 Berchem TOT
54,Posthofbrug 5366,2018-10-26,14:00:00,133,57,76,FMN GV 16 Berchem TOT
54,Posthofbrug 5366,2018-10-26,15:00:00,265,115,150,FMN GV 16 Berchem TOT
54,Posthofbrug 5366,2018-10-26,16:00:00,311,122,189,FMN GV 16 Berchem TOT
54,Posthofbrug 5366,2018-10-26,17:00:00,414,150,264,FMN GV 16 Berchem TOT
54,Posthofbrug 5366,2018-10-26,18:00:00,218,86,132,FMN GV 16 Berchem TOT
54,Posthofbrug 5366,2018-10-26,19:00:00,113,41,72,FMN GV 16 Berchem TOT
54,Posthofbrug 5366,2018-10-26,20:00:00,56,27,29,FMN GV 16 Berchem TOT
54,Posthofbrug 5366,2018-10-26,21:00:00,67,32,35,FMN GV 16 Berchem TOT
54,Posthofbrug 5366,2018-10-26,22:00:00,45,17,28,FMN GV 16 Berchem TOT
54,Posthofbrug 5366,2018-10-26,23:00:00,30,6,24,FMN GV 16 Berchem TOT
54,Posthofbrug 5366,2018-10-27,00:00:00,34,8,26,FMN GV 16 Berchem TOT
54,Posthofbrug 5366,2018-10-27,01:00:00,34,10,24,FMN GV 16 Berchem TOT
54,Posthofbrug 5366,2018-10-27,02:00:00,15,2,13,FMN GV 16 Berchem TOT
54,Posthofbrug 5366,2018-10-27,03:00:00,12,1,11,FMN GV 16 Berchem TOT
54,Posthofbrug 5366,2018-10-27,04:00:00,10,6,4,FMN GV 16 Berchem TOT
54,Posthofbrug 5366,2018-10-27,05:00:00,13,4,9,FMN GV 16 Berchem TOT
54,Posthofbrug 5366,2018-10-27,06:00:00,10,8,2,FMN GV 16 Berchem TOT
54,Posthofbrug 5366,2018-10-27,07:00:00,16,5,11,FMN GV 16 Berchem TOT
54,Posthofbrug 5366,2018-10-27,08:00:00,39,18,21,FMN GV 16 Berchem TOT
54,Posthofbrug 5366,2018-10-27,09:00:00,67,44,23,FMN GV 16 Berchem TOT
54,Posthofbrug 5366,2018-10-27,10:00:00,74,48,26,FMN GV 16 Berchem TOT
54,Posthofbrug 5366,2018-10-27,11:00:00,71,50,21,FMN GV 16 Berchem TOT
54,Posthofbrug 5366,2018-10-27,12:00:00,88,54,34,FMN GV 16 Berchem TOT
54,Posthofbrug 5366,2018-10-27,13:00:00,100,56,44,FMN GV 16 Berchem TOT
54,Posthofbrug 5366,2018-10-27,14:00:00,98,47,51,FMN GV 16 Berchem TOT
54,Posthofbrug 5366,2018-10-27,15:00:00,94,56,38,FMN GV 16 Berchem TOT
54,Posthofbrug 5366,2018-10-27,16:00:00,101,50,51,FMN GV 16 Berchem TOT
54,Posthofbrug 5366,2018-10-27,17:00:00,121,53,68,FMN GV 16 Berchem TOT
54,Posthofbrug 5366,2018-10-27,18:00:00,115,60,55,FMN GV 16 Berchem TOT
54,Posthofbrug 5366,2018-10-27,19:00:00,80,52,28,FMN GV 16 Berchem TOT
54,Posthofbrug 5366,2018-10-27,20:00:00,46,32,14,FMN GV 16 Berchem TOT
54,Posthofbrug 5366,2018-10-27,21:00:00,48,28,20,FMN GV 16 Berchem TOT
54,Posthofbrug 5366,2018-10-27,22:00:00,40,16,24,FMN GV 16 Berchem TOT
54,Posthofbrug 5366,2018-10-27,23:00:00,47,13,34,FMN GV 16 Berchem TOT
54,Posthofbrug 5366,2018-10-28,00:00:00,36,13,23,FMN GV 16 Berchem TOT
54,Posthofbrug 5366,2018-10-28,01:00:00,23,8,15,FMN GV 16 Berchem TOT
54,Posthofbrug 5366,2018-10-28,02:00:00,34,8,26,FMN GV 16 Berchem TOT
54,Posthofbrug 5366,2018-10-28,03:00:00,13,0,13,FMN GV 16 Berchem TOT
54,Posthofbrug 5366,2018-10-28,04:00:00,3,0,3,FMN GV 16 Berchem TOT
54,Posthofbrug 5366,2018-10-28,05:00:00,7,6,1,FMN GV 16 Berchem TOT
54,Posthofbrug 5366,2018-10-28,06:00:00,11,8,3,FMN GV 16 Berchem TOT
54,Posthofbrug 5366,2018-10-28,07:00:00,19,15,4,FMN GV 16 Berchem TOT
54,Posthofbrug 5366,2018-10-28,08:00:00,33,24,9,FMN GV 16 Berchem TOT
54,Posthofbrug 5366,2018-10-28,09:00:00,81,39,42,FMN GV 16 Berchem TOT
54,Posthofbrug 5366,2018-10-28,10:00:00,77,54,23,FMN GV 16 Berchem TOT
54,Posthofbrug 5366,2018-10-28,11:00:00,88,62,26,FMN GV 16 Berchem TOT
54,Posthofbrug 5366,2018-10-28,12:00:00,114,72,42,FMN GV 16 Berchem TOT
54,Posthofbrug 5366,2018-10-28,13:00:00,107,63,44,FMN GV 16 Berchem TOT
54,Posthofbrug 5366,2018-10-28,14:00:00,99,48,51,FMN GV 16 Berchem TOT
54,Posthofbrug 5366,2018-10-28,15:00:00,77,32,45,FMN GV 16 Berchem TOT
54,Posthofbrug 5366,2018-10-28,16:00:00,74,30,44,FMN GV 16 Berchem TOT
54,Posthofbrug 5366,2018-10-28,17:00:00,96,26,70,FMN GV 16 Berchem TOT
54,Posthofbrug 5366,2018-10-28,18:00:00,63,23,40,FMN GV 16 Berchem TOT
54,Posthofbrug 5366,2018-10-28,19:00:00,56,26,30,FMN GV 16 Berchem TOT
54,Posthofbrug 5366,2018-10-28,20:00:00,29,17,12,FMN GV 16 Berchem TOT
54,Posthofbrug 5366,2018-10-28,21:00:00,40,23,17,FMN GV 16 Berchem TOT
54,Posthofbrug 5366,2018-10-28,22:00:00,26,10,16,FMN GV 16 Berchem TOT
54,Posthofbrug 5366,2018-10-28,23:00:00,17,4,13,FMN GV 16 Berchem TOT
54,Posthofbrug 5366,2018-10-29,00:00:00,6,1,5,FMN GV 16 Berchem TOT
54,Posthofbrug 5366,2018-10-29,01:00:00,2,0,2,FMN GV 16 Berchem TOT
54,Posthofbrug 5366,2018-10-29,02:00:00,0,0,0,FMN GV 16 Berchem TOT
54,Posthofbrug 5366,2018-10-29,03:00:00,2,2,0,FMN GV 16 Berchem TOT
54,Posthofbrug 5366,2018-10-29,04:00:00,6,5,1,FMN GV 16 Berchem TOT
54,Posthofbrug 5366,2018-10-29,05:00:00,16,14,2,FMN GV 16 Berchem TOT
54,Posthofbrug 5366,2018-10-29,06:00:00,87,62,25,FMN GV 16 Berchem TOT
54,Posthofbrug 5366,2018-10-29,07:00:00,299,233,66,FMN GV 16 Berchem TOT
54,Posthofbrug 5366,2018-10-29,08:00:00,482,290,192,FMN GV 16 Berchem TOT
54,Posthofbrug 5366,2018-10-29,09:00:00,184,128,56,FMN GV 16 Berchem TOT
54,Posthofbrug 5366,2018-10-29,10:00:00,87,60,27,FMN GV 16 Berchem TOT
54,Posthofbrug 5366,2018-10-29,11:00:00,87,54,33,FMN GV 16 Berchem TOT
54,Posthofbrug 5366,2018-10-29,12:00:00,115,67,48,FMN GV 16 Berchem TOT
54,Posthofbrug 5366,2018-10-29,13:00:00,115,74,41,FMN GV 16 Berchem TOT
54,Posthofbrug 5366,2018-10-29,14:00:00,89,35,54,FMN GV 16 Berchem TOT
54,Posthofbrug 5366,2018-10-29,15:00:00,109,42,67,FMN GV 16 Berchem TOT
54,Posthofbrug 5366,2018-10-29,16:00:00,295,123,172,FMN GV 16 Berchem TOT
54,Posthofbrug 5366,2018-10-29,17:00:00,403,143,260,FMN GV 16 Berchem TOT
54,Posthofbrug 5366,2018-10-29,18:00:00,272,75,197,FMN GV 16 Berchem TOT
54,Posthofbrug 5366,2018-10-29,19:00:00,120,53,67,FMN GV 16 Berchem TOT
54,Posthofbrug 5366,2018-10-29,20:00:00,60,23,37,FMN GV 16 Berchem TOT
54,Posthofbrug 5366,2018-10-29,21:00:00,54,23,31,FMN GV 16 Berchem TOT
54,Posthofbrug 5366,2018-10-29,22:00:00,57,20,37,FMN GV 16 Berchem TOT
54,Posthofbrug 5366,2018-10-29,23:00:00,21,10,11,FMN GV 16 Berchem TOT
54,Posthofbrug 5366,2018-10-30,00:00:00,14,6,8,FMN GV 16 Berchem TOT
54,Posthofbrug 5366,2018-10-30,01:00:00,4,1,3,FMN GV 16 Berchem TOT
54,Posthofbrug 5366,2018-10-30,02:00:00,1,0,1,FMN GV 16 Berchem TOT
54,Posthofbrug 5366,2018-10-30,03:00:00,2,2,0,FMN GV 16 Berchem TOT
54,Posthofbrug 5366,2018-10-30,04:00:00,4,3,1,FMN GV 16 Berchem TOT
54,Posthofbrug 5366,2018-10-30,05:00:00,9,6,3,FMN GV 16 Berchem TOT
54,Posthofbrug 5366,2018-10-30,06:00:00,62,46,16,FMN GV 16 Berchem TOT
54,Posthofbrug 5366,2018-10-30,07:00:00,251,192,59,FMN GV 16 Berchem TOT
54,Posthofbrug 5366,2018-10-30,08:00:00,354,201,153,FMN GV 16 Berchem TOT
54,Posthofbrug 5366,2018-10-30,09:00:00,111,75,36,FMN GV 16 Berchem TOT
54,Posthofbrug 5366,2018-10-30,10:00:00,42,25,17,FMN GV 16 Berchem TOT
54,Posthofbrug 5366,2018-10-30,11:00:00,49,30,19,FMN GV 16 Berchem TOT
54,Posthofbrug 5366,2018-10-30,12:00:00,73,45,28,FMN GV 16 Berchem TOT
54,Posthofbrug 5366,2018-10-30,13:00:00,70,42,28,FMN GV 16 Berchem TOT
54,Posthofbrug 5366,2018-10-30,14:00:00,38,12,26,FMN GV 16 Berchem TOT
54,Posthofbrug 5366,2018-10-30,15:00:00,89,39,50,FMN GV 16 Berchem TOT
54,Posthofbrug 5366,2018-10-30,16:00:00,161,72,89,FMN GV 16 Berchem TOT
54,Posthofbrug 5366,2018-10-30,17:00:00,279,125,154,FMN GV 16 Berchem TOT
54,Posthofbrug 5366,2018-10-30,18:00:00,148,37,111,FMN GV 16 Berchem TOT
54,Posthofbrug 5366,2018-10-30,19:00:00,103,38,65,FMN GV 16 Berchem TOT
54,Posthofbrug 5366,2018-10-30,20:00:00,49,17,32,FMN GV 16 Berchem TOT
54,Posthofbrug 5366,2018-10-30,21:00:00,46,24,22,FMN GV 16 Berchem TOT
54,Posthofbrug 5366,2018-10-30,22:00:00,33,20,13,FMN GV 16 Berchem TOT
54,Posthofbrug 5366,2018-10-30,23:00:00,21,8,13,FMN GV 16 Berchem TOT
54,Posthofbrug 5366,2018-10-31,00:00:00,16,3,13,FMN GV 16 Berchem TOT
54,Posthofbrug 5366,2018-10-31,01:00:00,3,0,3,FMN GV 16 Berchem TOT
54,Posthofbrug 5366,2018-10-31,02:00:00,5,1,4,FMN GV 16 Berchem TOT
54,Posthofbrug 5366,2018-10-31,03:00:00,5,2,3,FMN GV 16 Berchem TOT
54,Posthofbrug 5366,2018-10-31,04:00:00,10,8,2,FMN GV 16 Berchem TOT
54,Posthofbrug 5366,2018-10-31,05:00:00,7,5,2,FMN GV 16 Berchem TOT
54,Posthofbrug 5366,2018-10-31,06:00:00,68,53,15,FMN GV 16 Berchem TOT
54,Posthofbrug 5366,2018-10-31,07:00:00,249,185,64,FMN GV 16 Berchem TOT
54,Posthofbrug 5366,2018-10-31,08:00:00,382,222,160,FMN GV 16 Berchem TOT
54,Posthofbrug 5366,2018-10-31,09:00:00,148,92,56,FMN GV 16 Berchem TOT
54,Posthofbrug 5366,2018-10-31,10:00:00,94,57,37,FMN GV 16 Berchem TOT
54,Posthofbrug 5366,2018-10-31,11:00:00,75,39,36,FMN GV 16 Berchem TOT
54,Posthofbrug 5366,2018-10-31,12:00:00,141,86,55,FMN GV 16 Berchem TOT
54,Posthofbrug 5366,2018-10-31,13:00:00,135,66,69,FMN GV 16 Berchem TOT
54,Posthofbrug 5366,2018-10-31,14:00:00,115,53,62,FMN GV 16 Berchem TOT
54,Posthofbrug 5366,2018-10-31,15:00:00,132,62,70,FMN GV 16 Berchem TOT
54,Posthofbrug 5366,2018-10-31,16:00:00,261,122,139,FMN GV 16 Berchem TOT
54,Posthofbrug 5366,2018-10-31,17:00:00,332,132,200,FMN GV 16 Berchem TOT
54,Posthofbrug 5366,2018-10-31,18:00:00,218,81,137,FMN GV 16 Berchem TOT
54,Posthofbrug 5366,2018-10-31,19:00:00,121,41,80,FMN GV 16 Berchem TOT
54,Posthofbrug 5366,2018-10-31,20:00:00,60,29,31,FMN GV 16 Berchem TOT
54,Posthofbrug 5366,2018-10-31,21:00:00,50,24,26,FMN GV 16 Berchem TOT
54,Posthofbrug 5366,2018-10-31,22:00:00,68,27,41,FMN GV 16 Berchem TOT
54,Posthofbrug 5366,2018-10-31,23:00:00,43,16,27,FMN GV 16 Berchem TOT
54,Posthofbrug 5366,2018-11-01,00:00:00,25,9,16,FMN GV 16 Berchem TOT
54,Posthofbrug 5366,2018-11-01,01:00:00,25,10,15,FMN GV 16 Berchem TOT
54,Posthofbrug 5366,2018-11-01,02:00:00,11,0,11,FMN GV 16 Berchem TOT
54,Posthofbrug 5366,2018-11-01,03:00:00,32,8,24,FMN GV 16 Berchem TOT
54,Posthofbrug 5366,2018-11-01,04:00:00,15,1,14,FMN GV 16 Berchem TOT
54,Posthofbrug 5366,2018-11-01,05:00:00,13,5,8,FMN GV 16 Berchem TOT
54,Posthofbrug 5366,2018-11-01,06:00:00,22,13,9,FMN GV 16 Berchem TOT
54,Posthofbrug 5366,2018-11-01,07:00:00,17,12,5,FMN GV 16 Berchem TOT
54,Posthofbrug 5366,2018-11-01,08:00:00,16,10,6,FMN GV 16 Berchem TOT
54,Posthofbrug 5366,2018-11-01,09:00:00,52,35,17,FMN GV 16 Berchem TOT
54,Posthofbrug 5366,2018-11-01,10:00:00,52,36,16,FMN GV 16 Berchem TOT
54,Posthofbrug 5366,2018-11-01,11:00:00,67,33,34,FMN GV 16 Berchem TOT
54,Posthofbrug 5366,2018-11-01,12:00:00,63,37,26,FMN GV 16 Berchem TOT
54,Posthofbrug 5366,2018-11-01,13:00:00,60,32,28,FMN GV 16 Berchem TOT
54,Posthofbrug 5366,2018-11-01,14:00:00,59,28,31,FMN GV 16 Berchem TOT
54,Posthofbrug 5366,2018-11-01,15:00:00,31,15,16,FMN GV 16 Berchem TOT
54,Posthofbrug 5366,2018-11-01,16:00:00,37,17,20,FMN GV 16 Berchem TOT
54,Posthofbrug 5366,2018-11-01,17:00:00,55,27,28,FMN GV 16 Berchem TOT
54,Posthofbrug 5366,2018-11-01,18:00:00,54,28,26,FMN GV 16 Berchem TOT
54,Posthofbrug 5366,2018-11-01,19:00:00,35,17,18,FMN GV 16 Berchem TOT
54,Posthofbrug 5366,2018-11-01,20:00:00,34,19,15,FMN GV 16 Berchem TOT
54,Posthofbrug 5366,2018-11-01,21:00:00,28,17,11,FMN GV 16 Berchem TOT
54,Posthofbrug 5366,2018-11-01,22:00:00,25,4,21,FMN GV 16 Berchem TOT
54,Posthofbrug 5366,2018-11-01,23:00:00,17,1,16,FMN GV 16 Berchem TOT
54,Posthofbrug 5366,2018-11-02,00:00:00,14,1,13,FMN GV 16 Berchem TOT
54,Posthofbrug 5366,2018-11-02,01:00:00,3,1,2,FMN GV 16 Berchem TOT
54,Posthofbrug 5366,2018-11-02,02:00:00,4,1,3,FMN GV 16 Berchem TOT
54,Posthofbrug 5366,2018-11-02,03:00:00,4,3,1,FMN GV 16 Berchem TOT
54,Posthofbrug 5366,2018-11-02,04:00:00,9,6,3,FMN GV 16 Berchem TOT
54,Posthofbrug 5366,2018-11-02,05:00:00,10,6,4,FMN GV 16 Berchem TOT
54,Posthofbrug 5366,2018-11-02,06:00:00,27,20,7,FMN GV 16 Berchem TOT
54,Posthofbrug 5366,2018-11-02,07:00:00,94,61,33,FMN GV 16 Berchem TOT
54,Posthofbrug 5366,2018-11-02,08:00:00,159,97,62,FMN GV 16 Berchem TOT
54,Posthofbrug 5366,2018-11-02,09:00:00,78,57,21,FMN GV 16 Berchem TOT
54,Posthofbrug 5366,2018-11-02,10:00:00,100,62,38,FMN GV 16 Berchem TOT
54,Posthofbrug 5366,2018-11-02,11:00:00,79,48,31,FMN GV 16 Berchem TOT
54,Posthofbrug 5366,2018-11-02,12:00:00,80,49,31,FMN GV 16 Berchem TOT
54,Posthofbrug 5366,2018-11-02,13:00:00,107,64,43,FMN GV 16 Berchem TOT
54,Posthofbrug 5366,2018-11-02,14:00:00,122,63,59,FMN GV 16 Berchem TOT
54,Posthofbrug 5366,2018-11-02,15:00:00,111,59,52,FMN GV 16 Berchem TOT
54,Posthofbrug 5366,2018-11-02,16:00:00,148,56,92,FMN GV 16 Berchem TOT
54,Posthofbrug 5366,2018-11-02,17:00:00,179,64,115,FMN GV 16 Berchem TOT
54,Posthofbrug 5366,2018-11-02,18:00:00,134,66,68,FMN GV 16 Berchem TOT
54,Posthofbrug 5366,2018-11-02,19:00:00,89,41,48,FMN GV 16 Berchem TOT
54,Posthofbrug 5366,2018-11-02,20:00:00,63,30,33,FMN GV 16 Berchem TOT
54,Posthofbrug 5366,2018-11-02,21:00:00,35,20,15,FMN GV 16 Berchem TOT
54,Posthofbrug 5366,2018-11-02,22:00:00,38,18,20,FMN GV 16 Berchem TOT
54,Posthofbrug 5366,2018-11-02,23:00:00,26,8,18,FMN GV 16 Berchem TOT
54,Posthofbrug 5366,2018-11-03,00:00:00,41,11,30,FMN GV 16 Berchem TOT
54,Posthofbrug 5366,2018-11-03,01:00:00,23,6,17,FMN GV 16 Berchem TOT
54,Posthofbrug 5366,2018-11-03,02:00:00,10,2,8,FMN GV 16 Berchem TOT
54,Posthofbrug 5366,2018-11-03,03:00:00,12,3,9,FMN GV 16 Berchem TOT
54,Posthofbrug 5366,2018-11-03,04:00:00,14,6,8,FMN GV 16 Berchem TOT
54,Posthofbrug 5366,2018-11-03,05:00:00,7,4,3,FMN GV 16 Berchem TOT
54,Posthofbrug 5366,2018-11-03,06:00:00,15,12,3,FMN GV 16 Berchem TOT
54,Posthofbrug 5366,2018-11-03,07:00:00,22,15,7,FMN GV 16 Berchem TOT
54,Posthofbrug 5366,2018-11-03,08:00:00,42,32,10,FMN GV 16 Berchem TOT
54,Posthofbrug 5366,2018-11-03,09:00:00,52,35,17,FMN GV 16 Berchem TOT
54,Posthofbrug 5366,2018-11-03,10:00:00,78,55,23,FMN GV 16 Berchem TOT
54,Posthofbrug 5366,2018-11-03,11:00:00,96,65,31,FMN GV 16 Berchem TOT
54,Posthofbrug 5366,2018-11-03,12:00:00,104,55,49,FMN GV 16 Berchem TOT
54,Posthofbrug 5366,2018-11-03,13:00:00,97,58,39,FMN GV 16 Berchem TOT
54,Posthofbrug 5366,2018-11-03,14:00:00,99,53,46,FMN GV 16 Berchem TOT
54,Posthofbrug 5366,2018-11-03,15:00:00,147,67,80,FMN GV 16 Berchem TOT
54,Posthofbrug 5366,2018-11-03,16:00:00,104,43,61,FMN GV 16 Berchem TOT
54,Posthofbrug 5366,2018-11-03,17:00:00,102,47,55,FMN GV 16 Berchem TOT
54,Posthofbrug 5366,2018-11-03,18:00:00,100,53,47,FMN GV 16 Berchem TOT
54,Posthofbrug 5366,2018-11-03,19:00:00,70,33,37,FMN GV 16 Berchem TOT
54,Posthofbrug 5366,2018-11-03,20:00:00,47,24,23,FMN GV 16 Berchem TOT
54,Posthofbrug 5366,2018-11-03,21:00:00,44,25,19,FMN GV 16 Berchem TOT
54,Posthofbrug 5366,2018-11-03,22:00:00,49,22,27,FMN GV 16 Berchem TOT
54,Posthofbrug 5366,2018-11-03,23:00:00,30,10,20,FMN GV 16 Berchem TOT
54,Posthofbrug 5366,2018-11-04,00:00:00,35,13,22,FMN GV 16 Berchem TOT
54,Posthofbrug 5366,2018-11-04,01:00:00,15,4,11,FMN GV 16 Berchem TOT
54,Posthofbrug 5366,2018-11-04,02:00:00,7,2,5,FMN GV 16 Berchem TOT
54,Posthofbrug 5366,2018-11-04,03:00:00,10,3,7,FMN GV 16 Berchem TOT
54,Posthofbrug 5366,2018-11-04,04:00:00,6,3,3,FMN GV 16 Berchem TOT
54,Posthofbrug 5366,2018-11-04,05:00:00,13,8,5,FMN GV 16 Berchem TOT
54,Posthofbrug 5366,2018-11-04,06:00:00,9,4,5,FMN GV 16 Berchem TOT
54,Posthofbrug 5366,2018-11-04,07:00:00,12,3,9,FMN GV 16 Berchem TOT
54,Posthofbrug 5366,2018-11-04,08:00:00,20,12,8,FMN GV 16 Berchem TOT
54,Posthofbrug 5366,2018-11-04,09:00:00,56,34,22,FMN GV 16 Berchem TOT
54,Posthofbrug 5366,2018-11-04,10:00:00,70,40,30,FMN GV 16 Berchem TOT
54,Posthofbrug 5366,2018-11-04,11:00:00,94,64,30,FMN GV 16 Berchem TOT
54,Posthofbrug 5366,2018-11-04,12:00:00,123,77,46,FMN GV 16 Berchem TOT
54,Posthofbrug 5366,2018-11-04,13:00:00,146,80,66,FMN GV 16 Berchem TOT
54,Posthofbrug 5366,2018-11-04,14:00:00,156,92,64,FMN GV 16 Berchem TOT
54,Posthofbrug 5366,2018-11-04,15:00:00,123,68,55,FMN GV 16 Berchem TOT
54,Posthofbrug 5366,2018-11-04,16:00:00,137,55,82,FMN GV 16 Berchem TOT
54,Posthofbrug 5366,2018-11-04,17:00:00,129,51,78,FMN GV 16 Berchem TOT
54,Posthofbrug 5366,2018-11-04,18:00:00,92,33,59,FMN GV 16 Berchem TOT
54,Posthofbrug 5366,2018-11-04,19:00:00,49,22,27,FMN GV 16 Berchem TOT
54,Posthofbrug 5366,2018-11-04,20:00:00,53,30,23,FMN GV 16 Berchem TOT
54,Posthofbrug 5366,2018-11-04,21:00:00,49,25,24,FMN GV 16 Berchem TOT
54,Posthofbrug 5366,2018-11-04,22:00:00,24,9,15,FMN GV 16 Berchem TOT
54,Posthofbrug 5366,2018-11-04,23:00:00,14,3,11,FMN GV 16 Berchem TOT
54,Posthofbrug 5366,2018-11-05,00:00:00,3,1,2,FMN GV 16 Berchem TOT
54,Posthofbrug 5366,2018-11-05,01:00:00,4,1,3,FMN GV 16 Berchem TOT
54,Posthofbrug 5366,2018-11-05,02:00:00,3,1,2,FMN GV 16 Berchem TOT
54,Posthofbrug 5366,2018-11-05,03:00:00,2,1,1,FMN GV 16 Berchem TOT
54,Posthofbrug 5366,2018-11-05,04:00:00,5,4,1,FMN GV 16 Berchem TOT
54,Posthofbrug 5366,2018-11-05,05:00:00,26,15,11,FMN GV 16 Berchem TOT
54,Posthofbrug 5366,2018-11-05,06:00:00,104,84,20,FMN GV 16 Berchem TOT
54,Posthofbrug 5366,2018-11-05,07:00:00,467,372,95,FMN GV 16 Berchem TOT
54,Posthofbrug 5366,2018-11-05,08:00:00,780,499,281,FMN GV 16 Berchem TOT
54,Posthofbrug 5366,2018-11-05,09:00:00,244,153,91,FMN GV 16 Berchem TOT
54,Posthofbrug 5366,2018-11-05,10:00:00,121,80,41,FMN GV 16 Berchem TOT
54,Posthofbrug 5366,2018-11-05,11:00:00,135,81,54,FMN GV 16 Berchem TOT
54,Posthofbrug 5366,2018-11-05,12:00:00,167,97,70,FMN GV 16 Berchem TOT
54,Posthofbrug 5366,2018-11-05,13:00:00,146,75,71,FMN GV 16 Berchem TOT
54,Posthofbrug 5366,2018-11-05,14:00:00,107,35,72,FMN GV 16 Berchem TOT
54,Posthofbrug 5366,2018-11-05,15:00:00,245,100,145,FMN GV 16 Berchem TOT
54,Posthofbrug 5366,2018-11-05,16:00:00,473,182,291,FMN GV 16 Berchem TOT
54,Posthofbrug 5366,2018-11-05,17:00:00,597,207,390,FMN GV 16 Berchem TOT
54,Posthofbrug 5366,2018-11-05,18:00:00,352,113,239,FMN GV 16 Berchem TOT
54,Posthofbrug 5366,2018-11-05,19:00:00,157,59,98,FMN GV 16 Berchem TOT
54,Posthofbrug 5366,2018-11-05,20:00:00,81,34,47,FMN GV 16 Berchem TOT
54,Posthofbrug 5366,2018-11-05,21:00:00,92,34,58,FMN GV 16 Berchem TOT
54,Posthofbrug 5366,2018-11-05,22:00:00,71,27,44,FMN GV 16 Berchem TOT
54,Posthofbrug 5366,2018-11-05,23:00:00,25,9,16,FMN GV 16 Berchem TOT
54,Posthofbrug 5366,2018-11-06,00:00:00,11,7,4,FMN GV 16 Berchem TOT
54,Posthofbrug 5366,2018-11-06,01:00:00,4,0,4,FMN GV 16 Berchem TOT
54,Posthofbrug 5366,2018-11-06,02:00:00,6,0,6,FMN GV 16 Berchem TOT
54,Posthofbrug 5366,2018-11-06,03:00:00,3,2,1,FMN GV 16 Berchem TOT
54,Posthofbrug 5366,2018-11-06,04:00:00,6,5,1,FMN GV 16 Berchem TOT
54,Posthofbrug 5366,2018-11-06,05:00:00,24,17,7,FMN GV 16 Berchem TOT
54,Posthofbrug 5366,2018-11-06,06:00:00,114,100,14,FMN GV 16 Berchem TOT
54,Posthofbrug 5366,2018-11-06,07:00:00,523,367,156,FMN GV 16 Berchem TOT
54,Posthofbrug 5366,2018-11-06,08:00:00,836,532,304,FMN GV 16 Berchem TOT
54,Posthofbrug 5366,2018-11-06,09:00:00,270,195,75,FMN GV 16 Berchem TOT
54,Posthofbrug 5366,2018-11-06,10:00:00,132,91,41,FMN GV 16 Berchem TOT
54,Posthofbrug 5366,2018-11-06,11:00:00,134,86,48,FMN GV 16 Berchem TOT
54,Posthofbrug 5366,2018-11-06,12:00:00,178,99,79,FMN GV 16 Berchem TOT
54,Posthofbrug 5366,2018-11-06,13:00:00,186,91,95,FMN GV 16 Berchem TOT
54,Posthofbrug 5366,2018-11-06,14:00:00,141,72,69,FMN GV 16 Berchem TOT
54,Posthofbrug 5366,2018-11-06,15:00:00,265,111,154,FMN GV 16 Berchem TOT
54,Posthofbrug 5366,2018-11-06,16:00:00,516,205,311,FMN GV 16 Berchem TOT
54,Posthofbrug 5366,2018-11-06,17:00:00,615,206,409,FMN GV 16 Berchem TOT
54,Posthofbrug 5366,2018-11-06,18:00:00,404,144,260,FMN GV 16 Berchem TOT
54,Posthofbrug 5366,2018-11-06,19:00:00,193,69,124,FMN GV 16 Berchem TOT
54,Posthofbrug 5366,2018-11-06,20:00:00,90,19,71,FMN GV 16 Berchem TOT
54,Posthofbrug 5366,2018-11-06,21:00:00,82,27,55,FMN GV 16 Berchem TOT
54,Posthofbrug 5366,2018-11-06,22:00:00,84,33,51,FMN GV 16 Berchem TOT
54,Posthofbrug 5366,2018-11-06,23:00:00,46,12,34,FMN GV 16 Berchem TOT
54,Posthofbrug 5366,2018-11-07,00:00:00,24,10,14,FMN GV 16 Berchem TOT
54,Posthofbrug 5366,2018-11-07,01:00:00,9,2,7,FMN GV 16 Berchem TOT
54,Posthofbrug 5366,2018-11-07,02:00:00,4,0,4,FMN GV 16 Berchem TOT
54,Posthofbrug 5366,2018-11-07,03:00:00,2,1,1,FMN GV 16 Berchem TOT
54,Posthofbrug 5366,2018-11-07,04:00:00,7,4,3,FMN GV 16 Berchem TOT
54,Posthofbrug 5366,2018-11-07,05:00:00,24,16,8,FMN GV 16 Berchem TOT
54,Posthofbrug 5366,2018-11-07,06:00:00,105,90,15,FMN GV 16 Berchem TOT
54,Posthofbrug 5366,2018-11-07,07:00:00,461,325,136,FMN GV 16 Berchem TOT
54,Posthofbrug 5366,2018-11-07,08:00:00,700,451,249,FMN GV 16 Berchem TOT
54,Posthofbrug 5366,2018-11-07,09:00:00,216,135,81,FMN GV 16 Berchem TOT
54,Posthofbrug 5366,2018-11-07,10:00:00,112,69,43,FMN GV 16 Berchem TOT
54,Posthofbrug 5366,2018-11-07,11:00:00,122,60,62,FMN GV 16 Berchem TOT
54,Posthofbrug 5366,2018-11-07,12:00:00,271,144,127,FMN GV 16 Berchem TOT
54,Posthofbrug 5366,2018-11-07,13:00:00,152,65,87,FMN GV 16 Berchem TOT
54,Posthofbrug 5366,2018-11-07,14:00:00,99,42,57,FMN GV 16 Berchem TOT
54,Posthofbrug 5366,2018-11-07,15:00:00,172,66,106,FMN GV 16 Berchem TOT
54,Posthofbrug 5366,2018-11-07,16:00:00,352,137,215,FMN GV 16 Berchem TOT
54,Posthofbrug 5366,2018-11-07,17:00:00,474,169,305,FMN GV 16 Berchem TOT
54,Posthofbrug 5366,2018-11-07,18:00:00,332,132,200,FMN GV 16 Berchem TOT
54,Posthofbrug 5366,2018-11-07,19:00:00,124,49,75,FMN GV 16 Berchem TOT
54,Posthofbrug 5366,2018-11-07,20:00:00,70,33,37,FMN GV 16 Berchem TOT
54,Posthofbrug 5366,2018-11-07,21:00:00,74,23,51,FMN GV 16 Berchem TOT
54,Posthofbrug 5366,2018-11-07,22:00:00,59,24,35,FMN GV 16 Berchem TOT
54,Posthofbrug 5366,2018-11-07,23:00:00,37,18,19,FMN GV 16 Berchem TOT
54,Posthofbrug 5366,2018-11-08,00:00:00,19,2,17,FMN GV 16 Berchem TOT
54,Posthofbrug 5366,2018-11-08,01:00:00,4,0,4,FMN GV 16 Berchem TOT
54,Posthofbrug 5366,2018-11-08,02:00:00,5,1,4,FMN GV 16 Berchem TOT
54,Posthofbrug 5366,2018-11-08,03:00:00,8,0,8,FMN GV 16 Berchem TOT
54,Posthofbrug 5366,2018-11-08,04:00:00,7,3,4,FMN GV 16 Berchem TOT
54,Posthofbrug 5366,2018-11-08,05:00:00,17,13,4,FMN GV 16 Berchem TOT
54,Posthofbrug 5366,2018-11-08,06:00:00,110,87,23,FMN GV 16 Berchem TOT
54,Posthofbrug 5366,2018-11-08,07:00:00,459,330,129,FMN GV 16 Berchem TOT
54,Posthofbrug 5366,2018-11-08,08:00:00,777,507,270,FMN GV 16 Berchem TOT
54,Posthofbrug 5366,2018-11-08,09:00:00,252,181,71,FMN GV 16 Berchem TOT
54,Posthofbrug 5366,2018-11-08,10:00:00,98,71,27,FMN GV 16 Berchem TOT
54,Posthofbrug 5366,2018-11-08,11:00:00,101,65,36,FMN GV 16 Berchem TOT
54,Posthofbrug 5366,2018-11-08,12:00:00,164,90,74,FMN GV 16 Berchem TOT
54,Posthofbrug 5366,2018-11-08,13:00:00,169,100,69,FMN GV 16 Berchem TOT
54,Posthofbrug 5366,2018-11-08,14:00:00,147,67,80,FMN GV 16 Berchem TOT
54,Posthofbrug 5366,2018-11-08,15:00:00,216,99,117,FMN GV 16 Berchem TOT
54,Posthofbrug 5366,2018-11-08,16:00:00,464,179,285,FMN GV 16 Berchem TOT
54,Posthofbrug 5366,2018-11-08,17:00:00,515,169,346,FMN GV 16 Berchem TOT
54,Posthofbrug 5366,2018-11-08,18:00:00,300,99,201,FMN GV 16 Berchem TOT
54,Posthofbrug 5366,2018-11-08,19:00:00,166,53,113,FMN GV 16 Berchem TOT
54,Posthofbrug 5366,2018-11-08,20:00:00,108,41,67,FMN GV 16 Berchem TOT
54,Posthofbrug 5366,2018-11-08,21:00:00,75,32,43,FMN GV 16 Berchem TOT
54,Posthofbrug 5366,2018-11-08,22:00:00,75,27,48,FMN GV 16 Berchem TOT
54,Posthofbrug 5366,2018-11-08,23:00:00,43,11,32,FMN GV 16 Berchem TOT
54,Posthofbrug 5366,2018-11-09,00:00:00,31,7,24,FMN GV 16 Berchem TOT
54,Posthofbrug 5366,2018-11-09,01:00:00,4,0,4,FMN GV 16 Berchem TOT
54,Posthofbrug 5366,2018-11-09,02:00:00,7,1,6,FMN GV 16 Berchem TOT
54,Posthofbrug 5366,2018-11-09,03:00:00,5,2,3,FMN GV 16 Berchem TOT
54,Posthofbrug 5366,2018-11-09,04:00:00,11,7,4,FMN GV 16 Berchem TOT
54,Posthofbrug 5366,2018-11-09,05:00:00,24,13,11,FMN GV 16 Berchem TOT
54,Posthofbrug 5366,2018-11-09,06:00:00,81,62,19,FMN GV 16 Berchem TOT
54,Posthofbrug 5366,2018-11-09,07:00:00,422,295,127,FMN GV 16 Berchem TOT
54,Posthofbrug 5366,2018-11-09,08:00:00,705,467,238,FMN GV 16 Berchem TOT
54,Posthofbrug 5366,2018-11-09,09:00:00,252,178,74,FMN GV 16 Berchem TOT
54,Posthofbrug 5366,2018-11-09,10:00:00,135,94,41,FMN GV 16 Berchem TOT
54,Posthofbrug 5366,2018-11-09,11:00:00,91,52,39,FMN GV 16 Berchem TOT
54,Posthofbrug 5366,2018-11-09,12:00:00,176,93,83,FMN GV 16 Berchem TOT
54,Posthofbrug 5366,2018-11-09,13:00:00,184,80,104,FMN GV 16 Berchem TOT
54,Posthofbrug 5366,2018-11-09,14:00:00,133,62,71,FMN GV 16 Berchem TOT
54,Posthofbrug 5366,2018-11-09,15:00:00,265,108,157,FMN GV 16 Berchem TOT
54,Posthofbrug 5366,2018-11-09,16:00:00,408,148,260,FMN GV 16 Berchem TOT
54,Posthofbrug 5366,2018-11-09,17:00:00,492,186,306,FMN GV 16 Berchem TOT
54,Posthofbrug 5366,2018-11-09,18:00:00,311,114,197,FMN GV 16 Berchem TOT
54,Posthofbrug 5366,2018-11-09,19:00:00,172,71,101,FMN GV 16 Berchem TOT
54,Posthofbrug 5366,2018-11-09,20:00:00,112,61,51,FMN GV 16 Berchem TOT
54,Posthofbrug 5366,2018-11-09,21:00:00,91,58,33,FMN GV 16 Berchem TOT
54,Posthofbrug 5366,2018-11-09,22:00:00,67,20,47,FMN GV 16 Berchem TOT
54,Posthofbrug 5366,2018-11-09,23:00:00,63,23,40,FMN GV 16 Berchem TOT
54,Posthofbrug 5366,2018-11-10,00:00:00,45,10,35,FMN GV 16 Berchem TOT
54,Posthofbrug 5366,2018-11-10,01:00:00,27,9,18,FMN GV 16 Berchem TOT
54,Posthofbrug 5366,2018-11-10,02:00:00,18,4,14,FMN GV 16 Berchem TOT
54,Posthofbrug 5366,2018-11-10,03:00:00,22,2,20,FMN GV 16 Berchem TOT
54,Posthofbrug 5366,2018-11-10,04:00:00,8,2,6,FMN GV 16 Berchem TOT
54,Posthofbrug 5366,2018-11-10,05:00:00,11,8,3,FMN GV 16 Berchem TOT
54,Posthofbrug 5366,2018-11-10,06:00:00,18,9,9,FMN GV 16 Berchem TOT
54,Posthofbrug 5366,2018-11-10,07:00:00,18,14,4,FMN GV 16 Berchem TOT
54,Posthofbrug 5366,2018-11-10,08:00:00,46,29,17,FMN GV 16 Berchem TOT
54,Posthofbrug 5366,2018-11-10,09:00:00,78,47,31,FMN GV 16 Berchem TOT
54,Posthofbrug 5366,2018-11-10,10:00:00,100,50,50,FMN GV 16 Berchem TOT
54,Posthofbrug 5366,2018-11-10,11:00:00,87,62,25,FMN GV 16 Berchem TOT
54,Posthofbrug 5366,2018-11-10,12:00:00,83,37,46,FMN GV 16 Berchem TOT
54,Posthofbrug 5366,2018-11-10,13:00:00,81,46,35,FMN GV 16 Berchem TOT
54,Posthofbrug 5366,2018-11-10,14:00:00,45,22,23,FMN GV 16 Berchem TOT
54,Posthofbrug 5366,2018-11-10,15:00:00,69,46,23,FMN GV 16 Berchem TOT
54,Posthofbrug 5366,2018-11-10,16:00:00,79,46,33,FMN GV 16 Berchem TOT
54,Posthofbrug 5366,2018-11-10,17:00:00,82,38,44,FMN GV 16 Berchem TOT
54,Posthofbrug 5366,2018-11-10,18:00:00,71,31,40,FMN GV 16 Berchem TOT
54,Posthofbrug 5366,2018-11-10,19:00:00,75,42,33,FMN GV 16 Berchem TOT
54,Posthofbrug 5366,2018-11-10,20:00:00,43,25,18,FMN GV 16 Berchem TOT
54,Posthofbrug 5366,2018-11-10,21:00:00,37,21,16,FMN GV 16 Berchem TOT
54,Posthofbrug 5366,2018-11-10,22:00:00,46,25,21,FMN GV 16 Berchem TOT
54,Posthofbrug 5366,2018-11-10,23:00:00,43,12,31,FMN GV 16 Berchem TOT
54,Posthofbrug 5366,2018-11-11,00:00:00,25,10,15,FMN GV 16 Berchem TOT
54,Posthofbrug 5366,2018-11-11,01:00:00,22,7,15,FMN GV 16 Berchem TOT
54,Posthofbrug 5366,2018-11-11,02:00:00,12,3,9,FMN GV 16 Berchem TOT
54,Posthofbrug 5366,2018-11-11,03:00:00,10,3,7,FMN GV 16 Berchem TOT
54,Posthofbrug 5366,2018-11-11,04:00:00,4,2,2,FMN GV 16 Berchem TOT
54,Posthofbrug 5366,2018-11-11,05:00:00,8,3,5,FMN GV 16 Berchem TOT
54,Posthofbrug 5366,2018-11-11,06:00:00,12,5,7,FMN GV 16 Berchem TOT
54,Posthofbrug 5366,2018-11-11,07:00:00,25,16,9,FMN GV 16 Berchem TOT
54,Posthofbrug 5366,2018-11-11,08:00:00,28,18,10,FMN GV 16 Berchem TOT
54,Posthofbrug 5366,2018-11-11,09:00:00,52,34,18,FMN GV 16 Berchem TOT
54,Posthofbrug 5366,2018-11-11,10:00:00,73,45,28,FMN GV 16 Berchem TOT
54,Posthofbrug 5366,2018-11-11,11:00:00,70,34,36,FMN GV 16 Berchem TOT
54,Posthofbrug 5366,2018-11-11,12:00:00,59,32,27,FMN GV 16 Berchem TOT
54,Posthofbrug 5366,2018-11-11,13:00:00,46,25,21,FMN GV 16 Berchem TOT
54,Posthofbrug 5366,2018-11-11,14:00:00,56,23,33,FMN GV 16 Berchem TOT
54,Posthofbrug 5366,2018-11-11,15:00:00,51,18,33,FMN GV 16 Berchem TOT
54,Posthofbrug 5366,2018-11-11,16:00:00,55,33,22,FMN GV 16 Berchem TOT
54,Posthofbrug 5366,2018-11-11,17:00:00,58,28,30,FMN GV 16 Berchem TOT
54,Posthofbrug 5366,2018-11-11,18:00:00,52,16,36,FMN GV 16 Berchem TOT
54,Posthofbrug 5366,2018-11-11,19:00:00,53,33,20,FMN GV 16 Berchem TOT
54,Posthofbrug 5366,2018-11-11,20:00:00,36,23,13,FMN GV 16 Berchem TOT
54,Posthofbrug 5366,2018-11-11,21:00:00,27,11,16,FMN GV 16 Berchem TOT
54,Posthofbrug 5366,2018-11-11,22:00:00,21,4,17,FMN GV 16 Berchem TOT
54,Posthofbrug 5366,2018-11-11,23:00:00,33,13,20,FMN GV 16 Berchem TOT
54,Posthofbrug 5366,2018-11-12,00:00:00,8,0,8,FMN GV 16 Berchem TOT
54,Posthofbrug 5366,2018-11-12,01:00:00,1,1,0,FMN GV 16 Berchem TOT
54,Posthofbrug 5366,2018-11-12,02:00:00,2,2,0,FMN GV 16 Berchem TOT
54,Posthofbrug 5366,2018-11-12,03:00:00,3,2,1,FMN GV 16 Berchem TOT
54,Posthofbrug 5366,2018-11-12,04:00:00,5,5,0,FMN GV 16 Berchem TOT
54,Posthofbrug 5366,2018-11-12,05:00:00,13,10,3,FMN GV 16 Berchem TOT
54,Posthofbrug 5366,2018-11-12,06:00:00,59,44,15,FMN GV 16 Berchem TOT
54,Posthofbrug 5366,2018-11-12,07:00:00,318,225,93,FMN GV 16 Berchem TOT
54,Posthofbrug 5366,2018-11-12,08:00:00,559,382,177,FMN GV 16 Berchem TOT
54,Posthofbrug 5366,2018-11-12,09:00:00,162,114,48,FMN GV 16 Berchem TOT
54,Posthofbrug 5366,2018-11-12,10:00:00,82,57,25,FMN GV 16 Berchem TOT
54,Posthofbrug 5366,2018-11-12,11:00:00,58,41,17,FMN GV 16 Berchem TOT
54,Posthofbrug 5366,2018-11-12,12:00:00,98,61,37,FMN GV 16 Berchem TOT
54,Posthofbrug 5366,2018-11-12,13:00:00,90,56,34,FMN GV 16 Berchem TOT
54,Posthofbrug 5366,2018-11-12,14:00:00,93,39,54,FMN GV 16 Berchem TOT
54,Posthofbrug 5366,2018-11-12,15:00:00,180,74,106,FMN GV 16 Berchem TOT
54,Posthofbrug 5366,2018-11-12,16:00:00,330,131,199,FMN GV 16 Berchem TOT
54,Posthofbrug 5366,2018-11-12,17:00:00,450,180,270,FMN GV 16 Berchem TOT
54,Posthofbrug 5366,2018-11-12,18:00:00,286,89,197,FMN GV 16 Berchem TOT
54,Posthofbrug 5366,2018-11-12,19:00:00,146,68,78,FMN GV 16 Berchem TOT
54,Posthofbrug 5366,2018-11-12,20:00:00,60,30,30,FMN GV 16 Berchem TOT
54,Posthofbrug 5366,2018-11-12,21:00:00,74,29,45,FMN GV 16 Berchem TOT
54,Posthofbrug 5366,2018-11-12,22:00:00,70,27,43,FMN GV 16 Berchem TOT
54,Posthofbrug 5366,2018-11-12,23:00:00,28,8,20,FMN GV 16 Berchem TOT
54,Posthofbrug 5366,2018-11-13,00:00:00,9,0,9,FMN GV 16 Berchem TOT
54,Posthofbrug 5366,2018-11-13,01:00:00,2,0,2,FMN GV 16 Berchem TOT
54,Posthofbrug 5366,2018-11-13,02:00:00,4,1,3,FMN GV 16 Berchem TOT
54,Posthofbrug 5366,2018-11-13,03:00:00,2,1,1,FMN GV 16 Berchem TOT
54,Posthofbrug 5366,2018-11-13,04:00:00,11,7,4,FMN GV 16 Berchem TOT
54,Posthofbrug 5366,2018-11-13,05:00:00,34,17,17,FMN GV 16 Berchem TOT
54,Posthofbrug 5366,2018-11-13,06:00:00,124,97,27,FMN GV 16 Berchem TOT
54,Posthofbrug 5366,2018-11-13,07:00:00,501,365,136,FMN GV 16 Berchem TOT
54,Posthofbrug 5366,2018-11-13,08:00:00,846,562,284,FMN GV 16 Berchem TOT
54,Posthofbrug 5366,2018-11-13,09:00:00,206,161,45,FMN GV 16 Berchem TOT
54,Posthofbrug 5366,2018-11-13,10:00:00,95,63,32,FMN GV 16 Berchem TOT
54,Posthofbrug 5366,2018-11-13,11:00:00,91,63,28,FMN GV 16 Berchem TOT
54,Posthofbrug 5366,2018-11-13,12:00:00,159,96,63,FMN GV 16 Berchem TOT
54,Posthofbrug 5366,2018-11-13,13:00:00,159,94,65,FMN GV 16 Berchem TOT
54,Posthofbrug 5366,2018-11-13,14:00:00,110,41,69,FMN GV 16 Berchem TOT
54,Posthofbrug 5366,2018-11-13,15:00:00,243,100,143,FMN GV 16 Berchem TOT
54,Posthofbrug 5366,2018-11-13,16:00:00,440,165,275,FMN GV 16 Berchem TOT
54,Posthofbrug 5366,2018-11-13,17:00:00,599,200,399,FMN GV 16 Berchem TOT
54,Posthofbrug 5366,2018-11-13,18:00:00,392,151,241,FMN GV 16 Berchem TOT
54,Posthofbrug 5366,2018-11-13,19:00:00,161,56,105,FMN GV 16 Berchem TOT
54,Posthofbrug 5366,2018-11-13,20:00:00,98,36,62,FMN GV 16 Berchem TOT
54,Posthofbrug 5366,2018-11-13,21:00:00,93,37,56,FMN GV 16 Berchem TOT
54,Posthofbrug 5366,2018-11-13,22:00:00,69,21,48,FMN GV 16 Berchem TOT
54,Posthofbrug 5366,2018-11-13,23:00:00,50,19,31,FMN GV 16 Berchem TOT
54,Posthofbrug 5366,2018-11-14,00:00:00,29,10,19,FMN GV 16 Berchem TOT
54,Posthofbrug 5366,2018-11-14,01:00:00,4,1,3,FMN GV 16 Berchem TOT
54,Posthofbrug 5366,2018-11-14,02:00:00,4,0,4,FMN GV 16 Berchem TOT
54,Posthofbrug 5366,2018-11-14,03:00:00,12,4,8,FMN GV 16 Berchem TOT
54,Posthofbrug 5366,2018-11-14,04:00:00,11,5,6,FMN GV 16 Berchem TOT
54,Posthofbrug 5366,2018-11-14,05:00:00,27,19,8,FMN GV 16 Berchem TOT
54,Posthofbrug 5366,2018-11-14,06:00:00,105,84,21,FMN GV 16 Berchem TOT
54,Posthofbrug 5366,2018-11-14,07:00:00,477,322,155,FMN GV 16 Berchem TOT
54,Posthofbrug 5366,2018-11-14,08:00:00,748,490,258,FMN GV 16 Berchem TOT
54,Posthofbrug 5366,2018-11-14,09:00:00,233,158,75,FMN GV 16 Berchem TOT
54,Posthofbrug 5366,2018-11-14,10:00:00,126,84,42,FMN GV 16 Berchem TOT
54,Posthofbrug 5366,2018-11-14,11:00:00,129,73,56,FMN GV 16 Berchem TOT
54,Posthofbrug 5366,2018-11-14,12:00:00,328,165,163,FMN GV 16 Berchem TOT
54,Posthofbrug 5366,2018-11-14,13:00:00,227,107,120,FMN GV 16 Berchem TOT
54,Posthofbrug 5366,2018-11-14,14:00:00,163,74,89,FMN GV 16 Berchem TOT
54,Posthofbrug 5366,2018-11-14,15:00:00,214,92,122,FMN GV 16 Berchem TOT
54,Posthofbrug 5366,2018-11-14,16:00:00,421,170,251,FMN GV 16 Berchem TOT
54,Posthofbrug 5366,2018-11-14,17:00:00,560,209,351,FMN GV 16 Berchem TOT
54,Posthofbrug 5366,2018-11-14,18:00:00,201,63,138,FMN GV 16 Berchem TOT
54,Posthofbrug 5366,2018-11-14,19:00:00,4,2,2,FMN GV 16 Berchem TOT
54,Posthofbrug 5366,2018-11-14,20:00:00,113,48,65,FMN GV 16 Berchem TOT
54,Posthofbrug 5366,2018-11-14,21:00:00,90,41,49,FMN GV 16 Berchem TOT
54,Posthofbrug 5366,2018-11-14,22:00:00,87,33,54,FMN GV 16 Berchem TOT
54,Posthofbrug 5366,2018-11-14,23:00:00,50,13,37,FMN GV 16 Berchem TOT
54,Posthofbrug 5366,2018-11-17,00:00:00,46,12,34,FMN GV 16 Berchem TOT
54,Posthofbrug 5366,2018-11-17,01:00:00,42,5,37,FMN GV 16 Berchem TOT
54,Posthofbrug 5366,2018-11-17,02:00:00,11,2,9,FMN GV 16 Berchem TOT
54,Posthofbrug 5366,2018-11-17,03:00:00,18,5,13,FMN GV 16 Berchem TOT
54,Posthofbrug 5366,2018-11-17,04:00:00,12,2,10,FMN GV 16 Berchem TOT
54,Posthofbrug 5366,2018-11-17,05:00:00,9,6,3,FMN GV 16 Berchem TOT
54,Posthofbrug 5366,2018-11-17,06:00:00,20,11,9,FMN GV 16 Berchem TOT
54,Posthofbrug 5366,2018-11-17,07:00:00,19,11,8,FMN GV 16 Berchem TOT
54,Posthofbrug 5366,2018-11-17,08:00:00,56,36,20,FMN GV 16 Berchem TOT
54,Posthofbrug 5366,2018-11-17,09:00:00,94,65,29,FMN GV 16 Berchem TOT
54,Posthofbrug 5366,2018-11-17,10:00:00,100,69,31,FMN GV 16 Berchem TOT
54,Posthofbrug 5366,2018-11-17,11:00:00,97,53,44,FMN GV 16 Berchem TOT
54,Posthofbrug 5366,2018-11-17,12:00:00,135,84,51,FMN GV 16 Berchem TOT
54,Posthofbrug 5366,2018-11-17,13:00:00,145,96,49,FMN GV 16 Berchem TOT
54,Posthofbrug 5366,2018-11-17,14:00:00,142,77,65,FMN GV 16 Berchem TOT
54,Posthofbrug 5366,2018-11-17,15:00:00,126,52,74,FMN GV 16 Berchem TOT
54,Posthofbrug 5366,2018-11-17,16:00:00,120,39,81,FMN GV 16 Berchem TOT
54,Posthofbrug 5366,2018-11-17,17:00:00,122,71,51,FMN GV 16 Berchem TOT
54,Posthofbrug 5366,2018-11-17,18:00:00,99,34,65,FMN GV 16 Berchem TOT
54,Posthofbrug 5366,2018-11-17,19:00:00,98,56,42,FMN GV 16 Berchem TOT
54,Posthofbrug 5366,2018-11-17,20:00:00,48,22,26,FMN GV 16 Berchem TOT
54,Posthofbrug 5366,2018-11-17,21:00:00,34,16,18,FMN GV 16 Berchem TOT
54,Posthofbrug 5366,2018-11-17,22:00:00,43,18,25,FMN GV 16 Berchem TOT
54,Posthofbrug 5366,2018-11-17,23:00:00,60,19,41,FMN GV 16 Berchem TOT
54,Posthofbrug 5366,2018-11-18,00:00:00,52,25,27,FMN GV 16 Berchem TOT
54,Posthofbrug 5366,2018-11-18,01:00:00,24,13,11,FMN GV 16 Berchem TOT
54,Posthofbrug 5366,2018-11-18,02:00:00,19,7,12,FMN GV 16 Berchem TOT
54,Posthofbrug 5366,2018-11-18,03:00:00,6,0,6,FMN GV 16 Berchem TOT
54,Posthofbrug 5366,2018-11-18,04:00:00,16,7,9,FMN GV 16 Berchem TOT
54,Posthofbrug 5366,2018-11-18,05:00:00,13,4,9,FMN GV 16 Berchem TOT
54,Posthofbrug 5366,2018-11-18,06:00:00,19,13,6,FMN GV 16 Berchem TOT
54,Posthofbrug 5366,2018-11-18,07:00:00,10,3,7,FMN GV 16 Berchem TOT
54,Posthofbrug 5366,2018-11-18,08:00:00,36,19,17,FMN GV 16 Berchem TOT
54,Posthofbrug 5366,2018-11-18,09:00:00,78,48,30,FMN GV 16 Berchem TOT
54,Posthofbrug 5366,2018-11-18,10:00:00,66,46,20,FMN GV 16 Berchem TOT
54,Posthofbrug 5366,2018-11-18,11:00:00,97,61,36,FMN GV 16 Berchem TOT
54,Posthofbrug 5366,2018-11-18,12:00:00,113,64,49,FMN GV 16 Berchem TOT
54,Posthofbrug 5366,2018-11-18,13:00:00,104,58,46,FMN GV 16 Berchem TOT
54,Posthofbrug 5366,2018-11-18,14:00:00,152,83,69,FMN GV 16 Berchem TOT
54,Posthofbrug 5366,2018-11-18,15:00:00,108,47,61,FMN GV 16 Berchem TOT
54,Posthofbrug 5366,2018-11-18,16:00:00,94,55,39,FMN GV 16 Berchem TOT
54,Posthofbrug 5366,2018-11-18,17:00:00,114,65,49,FMN GV 16 Berchem TOT
54,Posthofbrug 5366,2018-11-18,18:00:00,52,33,19,FMN GV 16 Berchem TOT
54,Posthofbrug 5366,2018-11-18,19:00:00,28,12,16,FMN GV 16 Berchem TOT
54,Posthofbrug 5366,2018-11-18,20:00:00,51,26,25,FMN GV 16 Berchem TOT
54,Posthofbrug 5366,2018-11-18,21:00:00,40,16,24,FMN GV 16 Berchem TOT
54,Posthofbrug 5366,2018-11-18,22:00:00,29,17,12,FMN GV 16 Berchem TOT
54,Posthofbrug 5366,2018-11-18,23:00:00,23,7,16,FMN GV 16 Berchem TOT
54,Posthofbrug 5366,2018-11-19,00:00:00,14,5,9,FMN GV 16 Berchem TOT
54,Posthofbrug 5366,2018-11-19,01:00:00,1,0,1,FMN GV 16 Berchem TOT
54,Posthofbrug 5366,2018-11-19,02:00:00,3,1,2,FMN GV 16 Berchem TOT
54,Posthofbrug 5366,2018-11-19,03:00:00,3,3,0,FMN GV 16 Berchem TOT
54,Posthofbrug 5366,2018-11-19,04:00:00,4,3,1,FMN GV 16 Berchem TOT
54,Posthofbrug 5366,2018-11-19,05:00:00,16,10,6,FMN GV 16 Berchem TOT
54,Posthofbrug 5366,2018-11-19,06:00:00,112,84,28,FMN GV 16 Berchem TOT
54,Posthofbrug 5366,2018-11-19,07:00:00,501,374,127,FMN GV 16 Berchem TOT
54,Posthofbrug 5366,2018-11-19,08:00:00,791,539,252,FMN GV 16 Berchem TOT
54,Posthofbrug 5366,2018-11-19,09:00:00,270,197,73,FMN GV 16 Berchem TOT
54,Posthofbrug 5366,2018-11-19,10:00:00,118,81,37,FMN GV 16 Berchem TOT
54,Posthofbrug 5366,2018-11-19,11:00:00,85,55,30,FMN GV 16 Berchem TOT
54,Posthofbrug 5366,2018-11-19,12:00:00,154,86,68,FMN GV 16 Berchem TOT
54,Posthofbrug 5366,2018-11-19,13:00:00,153,72,81,FMN GV 16 Berchem TOT
54,Posthofbrug 5366,2018-11-19,14:00:00,79,39,40,FMN GV 16 Berchem TOT
54,Posthofbrug 5366,2018-11-19,15:00:00,211,92,119,FMN GV 16 Berchem TOT
54,Posthofbrug 5366,2018-11-19,16:00:00,433,172,261,FMN GV 16 Berchem TOT
54,Posthofbrug 5366,2018-11-19,17:00:00,565,177,388,FMN GV 16 Berchem TOT
54,Posthofbrug 5366,2018-11-19,18:00:00,357,110,247,FMN GV 16 Berchem TOT
54,Posthofbrug 5366,2018-11-19,19:00:00,170,71,99,FMN GV 16 Berchem TOT
54,Posthofbrug 5366,2018-11-19,20:00:00,65,34,31,FMN GV 16 Berchem TOT
54,Posthofbrug 5366,2018-11-19,21:00:00,86,39,47,FMN GV 16 Berchem TOT
54,Posthofbrug 5366,2018-11-19,22:00:00,57,26,31,FMN GV 16 Berchem TOT
54,Posthofbrug 5366,2018-11-19,23:00:00,29,10,19,FMN GV 16 Berchem TOT
54,Posthofbrug 5366,2018-11-20,00:00:00,12,6,6,FMN GV 16 Berchem TOT
54,Posthofbrug 5366,2018-11-20,01:00:00,3,1,2,FMN GV 16 Berchem TOT
54,Posthofbrug 5366,2018-11-20,02:00:00,2,0,2,FMN GV 16 Berchem TOT
54,Posthofbrug 5366,2018-11-20,03:00:00,1,1,0,FMN GV 16 Berchem TOT
54,Posthofbrug 5366,2018-11-20,04:00:00,7,5,2,FMN GV 16 Berchem TOT
54,Posthofbrug 5366,2018-11-20,05:00:00,25,13,12,FMN GV 16 Berchem TOT
54,Posthofbrug 5366,2018-11-20,06:00:00,112,95,17,FMN GV 16 Berchem TOT
54,Posthofbrug 5366,2018-11-20,07:00:00,513,375,138,FMN GV 16 Berchem TOT
54,Posthofbrug 5366,2018-11-20,08:00:00,812,541,271,FMN GV 16 Berchem TOT
54,Posthofbrug 5366,2018-11-20,09:00:00,224,157,67,FMN GV 16 Berchem TOT
54,Posthofbrug 5366,2018-11-20,10:00:00,106,74,32,FMN GV 16 Berchem TOT
54,Posthofbrug 5366,2018-11-20,11:00:00,81,54,27,FMN GV 16 Berchem TOT
54,Posthofbrug 5366,2018-11-20,12:00:00,152,92,60,FMN GV 16 Berchem TOT
54,Posthofbrug 5366,2018-11-20,13:00:00,120,57,63,FMN GV 16 Berchem TOT
54,Posthofbrug 5366,2018-11-20,14:00:00,87,33,54,FMN GV 16 Berchem TOT
54,Posthofbrug 5366,2018-11-20,15:00:00,218,86,132,FMN GV 16 Berchem TOT
54,Posthofbrug 5366,2018-11-20,16:00:00,474,203,271,FMN GV 16 Berchem TOT
54,Posthofbrug 5366,2018-11-20,17:00:00,585,191,394,FMN GV 16 Berchem TOT
54,Posthofbrug 5366,2018-11-20,18:00:00,337,124,213,FMN GV 16 Berchem TOT
54,Posthofbrug 5366,2018-11-20,19:00:00,146,50,96,FMN GV 16 Berchem TOT
54,Posthofbrug 5366,2018-11-20,20:00:00,105,39,66,FMN GV 16 Berchem TOT
54,Posthofbrug 5366,2018-11-20,21:00:00,83,28,55,FMN GV 16 Berchem TOT
54,Posthofbrug 5366,2018-11-20,22:00:00,81,28,53,FMN GV 16 Berchem TOT
54,Posthofbrug 5366,2018-11-20,23:00:00,36,11,25,FMN GV 16 Berchem TOT
54,Posthofbrug 5366,2018-11-21,00:00:00,18,8,10,FMN GV 16 Berchem TOT
54,Posthofbrug 5366,2018-11-21,01:00:00,4,0,4,FMN GV 16 Berchem TOT
54,Posthofbrug 5366,2018-11-21,02:00:00,3,1,2,FMN GV 16 Berchem TOT
54,Posthofbrug 5366,2018-11-21,03:00:00,6,2,4,FMN GV 16 Berchem TOT
54,Posthofbrug 5366,2018-11-21,04:00:00,11,5,6,FMN GV 16 Berchem TOT
54,Posthofbrug 5366,2018-11-21,05:00:00,22,12,10,FMN GV 16 Berchem TOT
54,Posthofbrug 5366,2018-11-21,06:00:00,104,81,23,FMN GV 16 Berchem TOT
54,Posthofbrug 5366,2018-11-21,07:00:00,442,318,124,FMN GV 16 Berchem TOT
54,Posthofbrug 5366,2018-11-21,08:00:00,684,444,240,FMN GV 16 Berchem TOT
54,Posthofbrug 5366,2018-11-21,09:00:00,230,161,69,FMN GV 16 Berchem TOT
54,Posthofbrug 5366,2018-11-21,10:00:00,110,75,35,FMN GV 16 Berchem TOT
54,Posthofbrug 5366,2018-11-21,11:00:00,118,72,46,FMN GV 16 Berchem TOT
54,Posthofbrug 5366,2018-11-21,12:00:00,228,118,110,FMN GV 16 Berchem TOT
54,Posthofbrug 5366,2018-11-21,13:00:00,174,82,92,FMN GV 16 Berchem TOT
54,Posthofbrug 5366,2018-11-21,14:00:00,147,73,74,FMN GV 16 Berchem TOT
54,Posthofbrug 5366,2018-11-21,15:00:00,192,92,100,FMN GV 16 Berchem TOT
54,Posthofbrug 5366,2018-11-21,16:00:00,351,167,184,FMN GV 16 Berchem TOT
54,Posthofbrug 5366,2018-11-21,17:00:00,509,189,320,FMN GV 16 Berchem TOT
54,Posthofbrug 5366,2018-11-21,18:00:00,326,126,200,FMN GV 16 Berchem TOT
54,Posthofbrug 5366,2018-11-21,19:00:00,157,78,79,FMN GV 16 Berchem TOT
54,Posthofbrug 5366,2018-11-21,20:00:00,95,37,58,FMN GV 16 Berchem TOT
54,Posthofbrug 5366,2018-11-21,21:00:00,80,29,51,FMN GV 16 Berchem TOT
54,Posthofbrug 5366,2018-11-21,22:00:00,68,17,51,FMN GV 16 Berchem TOT
54,Posthofbrug 5366,2018-11-21,23:00:00,39,9,30,FMN GV 16 Berchem TOT
54,Posthofbrug 5366,2018-11-22,00:00:00,16,5,11,FMN GV 16 Berchem TOT
54,Posthofbrug 5366,2018-11-22,01:00:00,7,1,6,FMN GV 16 Berchem TOT
54,Posthofbrug 5366,2018-11-22,02:00:00,1,1,0,FMN GV 16 Berchem TOT
54,Posthofbrug 5366,2018-11-22,03:00:00,3,1,2,FMN GV 16 Berchem TOT
54,Posthofbrug 5366,2018-11-22,04:00:00,7,4,3,FMN GV 16 Berchem TOT
54,Posthofbrug 5366,2018-11-22,05:00:00,22,12,10,FMN GV 16 Berchem TOT
54,Posthofbrug 5366,2018-11-22,06:00:00,104,78,26,FMN GV 16 Berchem TOT
54,Posthofbrug 5366,2018-11-22,07:00:00,439,326,113,FMN GV 16 Berchem TOT
54,Posthofbrug 5366,2018-11-22,08:00:00,832,570,262,FMN GV 16 Berchem TOT
54,Posthofbrug 5366,2018-11-22,09:00:00,276,199,77,FMN GV 16 Berchem TOT
54,Posthofbrug 5366,2018-11-22,10:00:00,109,75,34,FMN GV 16 Berchem TOT
54,Posthofbrug 5366,2018-11-22,11:00:00,93,57,36,FMN GV 16 Berchem TOT
54,Posthofbrug 5366,2018-11-22,12:00:00,135,71,64,FMN GV 16 Berchem TOT
54,Posthofbrug 5366,2018-11-22,13:00:00,135,73,62,FMN GV 16 Berchem TOT
54,Posthofbrug 5366,2018-11-22,14:00:00,127,59,68,FMN GV 16 Berchem TOT
54,Posthofbrug 5366,2018-11-22,15:00:00,241,101,140,FMN GV 16 Berchem TOT
54,Posthofbrug 5366,2018-11-22,16:00:00,398,165,233,FMN GV 16 Berchem TOT
54,Posthofbrug 5366,2018-11-22,17:00:00,496,188,308,FMN GV 16 Berchem TOT
54,Posthofbrug 5366,2018-11-22,18:00:00,405,118,287,FMN GV 16 Berchem TOT
54,Posthofbrug 5366,2018-11-22,19:00:00,162,71,91,FMN GV 16 Berchem TOT
54,Posthofbrug 5366,2018-11-22,20:00:00,111,52,59,FMN GV 16 Berchem TOT
54,Posthofbrug 5366,2018-11-22,21:00:00,77,38,39,FMN GV 16 Berchem TOT
54,Posthofbrug 5366,2018-11-22,22:00:00,68,14,54,FMN GV 16 Berchem TOT
54,Posthofbrug 5366,2018-11-22,23:00:00,50,10,40,FMN GV 16 Berchem TOT
54,Posthofbrug 5366,2018-11-23,00:00:00,33,9,24,FMN GV 16 Berchem TOT
54,Posthofbrug 5366,2018-11-23,01:00:00,5,0,5,FMN GV 16 Berchem TOT
54,Posthofbrug 5366,2018-11-23,02:00:00,4,1,3,FMN GV 16 Berchem TOT
54,Posthofbrug 5366,2018-11-23,03:00:00,3,2,1,FMN GV 16 Berchem TOT
54,Posthofbrug 5366,2018-11-23,04:00:00,12,6,6,FMN GV 16 Berchem TOT
54,Posthofbrug 5366,2018-11-23,05:00:00,18,8,10,FMN GV 16 Berchem TOT
54,Posthofbrug 5366,2018-11-23,06:00:00,79,67,12,FMN GV 16 Berchem TOT
54,Posthofbrug 5366,2018-11-23,07:00:00,348,239,109,FMN GV 16 Berchem TOT
54,Posthofbrug 5366,2018-11-23,08:00:00,665,457,208,FMN GV 16 Berchem TOT
54,Posthofbrug 5366,2018-11-23,09:00:00,202,146,56,FMN GV 16 Berchem TOT
54,Posthofbrug 5366,2018-11-23,10:00:00,106,67,39,FMN GV 16 Berchem TOT
54,Posthofbrug 5366,2018-11-23,11:00:00,98,40,58,FMN GV 16 Berchem TOT
54,Posthofbrug 5366,2018-11-23,12:00:00,173,92,81,FMN GV 16 Berchem TOT
54,Posthofbrug 5366,2018-11-23,13:00:00,185,81,104,FMN GV 16 Berchem TOT
54,Posthofbrug 5366,2018-11-23,14:00:00,130,56,74,FMN GV 16 Berchem TOT
54,Posthofbrug 5366,2018-11-23,15:00:00,242,97,145,FMN GV 16 Berchem TOT
54,Posthofbrug 5366,2018-11-23,16:00:00,406,170,236,FMN GV 16 Berchem TOT
54,Posthofbrug 5366,2018-11-23,17:00:00,436,149,287,FMN GV 16 Berchem TOT
54,Posthofbrug 5366,2018-11-23,18:00:00,290,101,189,FMN GV 16 Berchem TOT
54,Posthofbrug 5366,2018-11-23,19:00:00,169,85,84,FMN GV 16 Berchem TOT
54,Posthofbrug 5366,2018-11-23,20:00:00,84,48,36,FMN GV 16 Berchem TOT
54,Posthofbrug 5366,2018-11-23,21:00:00,74,42,32,FMN GV 16 Berchem TOT
54,Posthofbrug 5366,2018-11-23,22:00:00,61,26,35,FMN GV 16 Berchem TOT
54,Posthofbrug 5366,2018-11-23,23:00:00,60,10,50,FMN GV 16 Berchem TOT
54,Posthofbrug 5366,2018-11-24,00:00:00,45,17,28,FMN GV 16 Berchem TOT
54,Posthofbrug 5366,2018-11-24,01:00:00,29,7,22,FMN GV 16 Berchem TOT
54,Posthofbrug 5366,2018-11-24,02:00:00,13,3,10,FMN GV 16 Berchem TOT
54,Posthofbrug 5366,2018-11-24,03:00:00,15,10,5,FMN GV 16 Berchem TOT
54,Posthofbrug 5366,2018-11-24,04:00:00,7,5,2,FMN GV 16 Berchem TOT
54,Posthofbrug 5366,2018-11-24,05:00:00,11,2,9,FMN GV 16 Berchem TOT
54,Posthofbrug 5366,2018-11-24,06:00:00,18,15,3,FMN GV 16 Berchem TOT
54,Posthofbrug 5366,2018-11-24,07:00:00,19,15,4,FMN GV 16 Berchem TOT
54,Posthofbrug 5366,2018-11-24,08:00:00,45,26,19,FMN GV 16 Berchem TOT
54,Posthofbrug 5366,2018-11-24,09:00:00,76,48,28,FMN GV 16 Berchem TOT
54,Posthofbrug 5366,2018-11-24,10:00:00,80,53,27,FMN GV 16 Berchem TOT
54,Posthofbrug 5366,2018-11-24,11:00:00,80,61,19,FMN GV 16 Berchem TOT
54,Posthofbrug 5366,2018-11-24,12:00:00,100,44,56,FMN GV 16 Berchem TOT
54,Posthofbrug 5366,2018-11-24,13:00:00,103,59,44,FMN GV 16 Berchem TOT
54,Posthofbrug 5366,2018-11-24,14:00:00,102,61,41,FMN GV 16 Berchem TOT
54,Posthofbrug 5366,2018-11-24,15:00:00,72,46,26,FMN GV 16 Berchem TOT
54,Posthofbrug 5366,2018-11-24,16:00:00,81,44,37,FMN GV 16 Berchem TOT
54,Posthofbrug 5366,2018-11-24,17:00:00,79,39,40,FMN GV 16 Berchem TOT
54,Posthofbrug 5366,2018-11-24,18:00:00,94,45,49,FMN GV 16 Berchem TOT
54,Posthofbrug 5366,2018-11-24,19:00:00,64,36,28,FMN GV 16 Berchem TOT
54,Posthofbrug 5366,2018-11-24,20:00:00,45,28,17,FMN GV 16 Berchem TOT
54,Posthofbrug 5366,2018-11-24,21:00:00,44,18,26,FMN GV 16 Berchem TOT
54,Posthofbrug 5366,2018-11-24,22:00:00,49,17,32,FMN GV 16 Berchem TOT
54,Posthofbrug 5366,2018-11-24,23:00:00,29,10,19,FMN GV 16 Berchem TOT
54,Posthofbrug 5366,2018-11-25,00:00:00,35,13,22,FMN GV 16 Berchem TOT
54,Posthofbrug 5366,2018-11-25,01:00:00,35,14,21,FMN GV 16 Berchem TOT
54,Posthofbrug 5366,2018-11-25,02:00:00,25,10,15,FMN GV 16 Berchem TOT
54,Posthofbrug 5366,2018-11-25,03:00:00,16,6,10,FMN GV 16 Berchem TOT
54,Posthofbrug 5366,2018-11-25,04:00:00,15,3,12,FMN GV 16 Berchem TOT
54,Posthofbrug 5366,2018-11-25,05:00:00,12,4,8,FMN GV 16 Berchem TOT
54,Posthofbrug 5366,2018-11-25,06:00:00,9,8,1,FMN GV 16 Berchem TOT
54,Posthofbrug 5366,2018-11-25,07:00:00,8,4,4,FMN GV 16 Berchem TOT
54,Posthofbrug 5366,2018-11-25,08:00:00,30,18,12,FMN GV 16 Berchem TOT
54,Posthofbrug 5366,2018-11-25,09:00:00,71,38,33,FMN GV 16 Berchem TOT
54,Posthofbrug 5366,2018-11-25,10:00:00,96,58,38,FMN GV 16 Berchem TOT
54,Posthofbrug 5366,2018-11-25,11:00:00,69,44,25,FMN GV 16 Berchem TOT
54,Posthofbrug 5366,2018-11-25,12:00:00,80,47,33,FMN GV 16 Berchem TOT
54,Posthofbrug 5366,2018-11-25,13:00:00,87,57,30,FMN GV 16 Berchem TOT
54,Posthofbrug 5366,2018-11-25,14:00:00,100,58,42,FMN GV 16 Berchem TOT
54,Posthofbrug 5366,2018-11-25,15:00:00,57,25,32,FMN GV 16 Berchem TOT
54,Posthofbrug 5366,2018-11-25,16:00:00,92,40,52,FMN GV 16 Berchem TOT
54,Posthofbrug 5366,2018-11-25,17:00:00,66,25,41,FMN GV 16 Berchem TOT
54,Posthofbrug 5366,2018-11-25,18:00:00,42,20,22,FMN GV 16 Berchem TOT
54,Posthofbrug 5366,2018-11-25,19:00:00,39,9,30,FMN GV 16 Berchem TOT
54,Posthofbrug 5366,2018-11-25,20:00:00,42,17,25,FMN GV 16 Berchem TOT
54,Posthofbrug 5366,2018-11-25,21:00:00,33,11,22,FMN GV 16 Berchem TOT
54,Posthofbrug 5366,2018-11-25,22:00:00,34,22,12,FMN GV 16 Berchem TOT
54,Posthofbrug 5366,2018-11-25,23:00:00,12,7,5,FMN GV 16 Berchem TOT
54,Posthofbrug 5366,2018-11-26,00:00:00,7,1,6,FMN GV 16 Berchem TOT
54,Posthofbrug 5366,2018-11-26,01:00:00,2,1,1,FMN GV 16 Berchem TOT
54,Posthofbrug 5366,2018-11-26,02:00:00,3,2,1,FMN GV 16 Berchem TOT
54,Posthofbrug 5366,2018-11-26,03:00:00,0,0,0,FMN GV 16 Berchem TOT
54,Posthofbrug 5366,2018-11-26,04:00:00,8,5,3,FMN GV 16 Berchem TOT
54,Posthofbrug 5366,2018-11-26,05:00:00,19,10,9,FMN GV 16 Berchem TOT
54,Posthofbrug 5366,2018-11-26,06:00:00,87,69,18,FMN GV 16 Berchem TOT
54,Posthofbrug 5366,2018-11-26,07:00:00,414,308,106,FMN GV 16 Berchem TOT
54,Posthofbrug 5366,2018-11-26,08:00:00,681,483,198,FMN GV 16 Berchem TOT
54,Posthofbrug 5366,2018-11-26,09:00:00,202,133,69,FMN GV 16 Berchem TOT
54,Posthofbrug 5366,2018-11-26,10:00:00,87,57,30,FMN GV 16 Berchem TOT
54,Posthofbrug 5366,2018-11-26,11:00:00,61,44,17,FMN GV 16 Berchem TOT
54,Posthofbrug 5366,2018-11-26,12:00:00,105,70,35,FMN GV 16 Berchem TOT
54,Posthofbrug 5366,2018-11-26,13:00:00,95,47,48,FMN GV 16 Berchem TOT
54,Posthofbrug 5366,2018-11-26,14:00:00,108,44,64,FMN GV 16 Berchem TOT
54,Posthofbrug 5366,2018-11-26,15:00:00,200,82,118,FMN GV 16 Berchem TOT
54,Posthofbrug 5366,2018-11-26,16:00:00,381,159,222,FMN GV 16 Berchem TOT
54,Posthofbrug 5366,2018-11-26,17:00:00,502,191,311,FMN GV 16 Berchem TOT
54,Posthofbrug 5366,2018-11-26,18:00:00,341,109,232,FMN GV 16 Berchem TOT
54,Posthofbrug 5366,2018-11-26,19:00:00,158,64,94,FMN GV 16 Berchem TOT
54,Posthofbrug 5366,2018-11-26,20:00:00,65,28,37,FMN GV 16 Berchem TOT
54,Posthofbrug 5366,2018-11-26,21:00:00,72,42,30,FMN GV 16 Berchem TOT
54,Posthofbrug 5366,2018-11-26,22:00:00,59,28,31,FMN GV 16 Berchem TOT
54,Posthofbrug 5366,2018-11-26,23:00:00,28,9,19,FMN GV 16 Berchem TOT
54,Posthofbrug 5366,2018-11-27,00:00:00,9,3,6,FMN GV 16 Berchem TOT
54,Posthofbrug 5366,2018-11-27,01:00:00,6,3,3,FMN GV 16 Berchem TOT
54,Posthofbrug 5366,2018-11-27,02:00:00,3,0,3,FMN GV 16 Berchem TOT
54,Posthofbrug 5366,2018-11-27,03:00:00,3,1,2,FMN GV 16 Berchem TOT
54,Posthofbrug 5366,2018-11-27,04:00:00,10,9,1,FMN GV 16 Berchem TOT
54,Posthofbrug 5366,2018-11-27,05:00:00,24,16,8,FMN GV 16 Berchem TOT
54,Posthofbrug 5366,2018-11-27,06:00:00,114,98,16,FMN GV 16 Berchem TOT
54,Posthofbrug 5366,2018-11-27,07:00:00,477,332,145,FMN GV 16 Berchem TOT
54,Posthofbrug 5366,2018-11-27,08:00:00,784,533,251,FMN GV 16 Berchem TOT
54,Posthofbrug 5366,2018-11-27,09:00:00,221,154,67,FMN GV 16 Berchem TOT
54,Posthofbrug 5366,2018-11-27,10:00:00,111,74,37,FMN GV 16 Berchem TOT
54,Posthofbrug 5366,2018-11-27,11:00:00,103,65,38,FMN GV 16 Berchem TOT
54,Posthofbrug 5366,2018-11-27,12:00:00,152,95,57,FMN GV 16 Berchem TOT
54,Posthofbrug 5366,2018-11-27,13:00:00,134,56,78,FMN GV 16 Berchem TOT
54,Posthofbrug 5366,2018-11-27,14:00:00,100,46,54,FMN GV 16 Berchem TOT
54,Posthofbrug 5366,2018-11-27,15:00:00,232,94,138,FMN GV 16 Berchem TOT
54,Posthofbrug 5366,2018-11-27,16:00:00,399,166,233,FMN GV 16 Berchem TOT
54,Posthofbrug 5366,2018-11-27,17:00:00,564,203,361,FMN GV 16 Berchem TOT
54,Posthofbrug 5366,2018-11-27,18:00:00,374,120,254,FMN GV 16 Berchem TOT
54,Posthofbrug 5366,2018-11-27,19:00:00,147,51,96,FMN GV 16 Berchem TOT
54,Posthofbrug 5366,2018-11-27,20:00:00,108,34,74,FMN GV 16 Berchem TOT
54,Posthofbrug 5366,2018-11-27,21:00:00,83,35,48,FMN GV 16 Berchem TOT
54,Posthofbrug 5366,2018-11-27,22:00:00,63,29,34,FMN GV 16 Berchem TOT
54,Posthofbrug 5366,2018-11-27,23:00:00,46,22,24,FMN GV 16 Berchem TOT
54,Posthofbrug 5366,2018-11-28,00:00:00,20,4,16,FMN GV 16 Berchem TOT
54,Posthofbrug 5366,2018-11-28,01:00:00,7,1,6,FMN GV 16 Berchem TOT
54,Posthofbrug 5366,2018-11-28,02:00:00,2,2,0,FMN GV 16 Berchem TOT
54,Posthofbrug 5366,2018-11-28,03:00:00,6,4,2,FMN GV 16 Berchem TOT
54,Posthofbrug 5366,2018-11-28,04:00:00,15,8,7,FMN GV 16 Berchem TOT
54,Posthofbrug 5366,2018-11-28,05:00:00,13,8,5,FMN GV 16 Berchem TOT
54,Posthofbrug 5366,2018-11-28,06:00:00,94,81,13,FMN GV 16 Berchem TOT
54,Posthofbrug 5366,2018-11-28,07:00:00,424,312,112,FMN GV 16 Berchem TOT
54,Posthofbrug 5366,2018-11-28,08:00:00,607,384,223,FMN GV 16 Berchem TOT
54,Posthofbrug 5366,2018-11-28,09:00:00,172,113,59,FMN GV 16 Berchem TOT
54,Posthofbrug 5366,2018-11-28,10:00:00,67,45,22,FMN GV 16 Berchem TOT
54,Posthofbrug 5366,2018-11-28,11:00:00,75,36,39,FMN GV 16 Berchem TOT
54,Posthofbrug 5366,2018-11-28,12:00:00,211,111,100,FMN GV 16 Berchem TOT
54,Posthofbrug 5366,2018-11-28,13:00:00,144,75,69,FMN GV 16 Berchem TOT
54,Posthofbrug 5366,2018-11-28,14:00:00,115,46,69,FMN GV 16 Berchem TOT
54,Posthofbrug 5366,2018-11-28,15:00:00,149,64,85,FMN GV 16 Berchem TOT
54,Posthofbrug 5366,2018-11-28,16:00:00,290,134,156,FMN GV 16 Berchem TOT
54,Posthofbrug 5366,2018-11-28,17:00:00,457,168,289,FMN GV 16 Berchem TOT
54,Posthofbrug 5366,2018-11-28,18:00:00,276,95,181,FMN GV 16 Berchem TOT
54,Posthofbrug 5366,2018-11-28,19:00:00,147,67,80,FMN GV 16 Berchem TOT
54,Posthofbrug 5366,2018-11-28,20:00:00,87,45,42,FMN GV 16 Berchem TOT
54,Posthofbrug 5366,2018-11-28,21:00:00,72,34,38,FMN GV 16 Berchem TOT
54,Posthofbrug 5366,2018-11-28,22:00:00,61,25,36,FMN GV 16 Berchem TOT
54,Posthofbrug 5366,2018-11-28,23:00:00,41,15,26,FMN GV 16 Berchem TOT
54,Posthofbrug 5366,2018-11-29,00:00:00,26,10,16,FMN GV 16 Berchem TOT
54,Posthofbrug 5366,2018-11-29,01:00:00,3,0,3,FMN GV 16 Berchem TOT
54,Posthofbrug 5366,2018-11-29,02:00:00,2,1,1,FMN GV 16 Berchem TOT
54,Posthofbrug 5366,2018-11-29,03:00:00,5,3,2,FMN GV 16 Berchem TOT
54,Posthofbrug 5366,2018-11-29,04:00:00,13,6,7,FMN GV 16 Berchem TOT
54,Posthofbrug 5366,2018-11-29,05:00:00,21,10,11,FMN GV 16 Berchem TOT
54,Posthofbrug 5366,2018-11-29,06:00:00,87,67,20,FMN GV 16 Berchem TOT
54,Posthofbrug 5366,2018-11-29,07:00:00,439,328,111,FMN GV 16 Berchem TOT
54,Posthofbrug 5366,2018-11-29,08:00:00,691,465,226,FMN GV 16 Berchem TOT
54,Posthofbrug 5366,2018-11-29,09:00:00,210,147,63,FMN GV 16 Berchem TOT
54,Posthofbrug 5366,2018-11-29,10:00:00,83,52,31,FMN GV 16 Berchem TOT
54,Posthofbrug 5366,2018-11-29,11:00:00,92,64,28,FMN GV 16 Berchem TOT
54,Posthofbrug 5366,2018-11-29,12:00:00,107,63,44,FMN GV 16 Berchem TOT
54,Posthofbrug 5366,2018-11-29,13:00:00,112,57,55,FMN GV 16 Berchem TOT
54,Posthofbrug 5366,2018-11-29,14:00:00,111,43,68,FMN GV 16 Berchem TOT
54,Posthofbrug 5366,2018-11-29,15:00:00,223,107,116,FMN GV 16 Berchem TOT
54,Posthofbrug 5366,2018-11-29,16:00:00,363,142,221,FMN GV 16 Berchem TOT
54,Posthofbrug 5366,2018-11-29,17:00:00,506,177,329,FMN GV 16 Berchem TOT
54,Posthofbrug 5366,2018-11-29,18:00:00,295,99,196,FMN GV 16 Berchem TOT
54,Posthofbrug 5366,2018-11-29,19:00:00,185,69,116,FMN GV 16 Berchem TOT
54,Posthofbrug 5366,2018-11-29,20:00:00,104,57,47,FMN GV 16 Berchem TOT
54,Posthofbrug 5366,2018-11-29,21:00:00,77,32,45,FMN GV 16 Berchem TOT
54,Posthofbrug 5366,2018-11-29,22:00:00,71,25,46,FMN GV 16 Berchem TOT
54,Posthofbrug 5366,2018-11-29,23:00:00,40,11,29,FMN GV 16 Berchem TOT
54,Posthofbrug 5366,2018-11-30,00:00:00,23,7,16,FMN GV 16 Berchem TOT
54,Posthofbrug 5366,2018-11-30,01:00:00,7,4,3,FMN GV 16 Berchem TOT
54,Posthofbrug 5366,2018-11-30,02:00:00,90,42,48,FMN GV 16 Berchem TOT
54,Posthofbrug 5366,2018-11-30,03:00:00,5,2,3,FMN GV 16 Berchem TOT
54,Posthofbrug 5366,2018-11-30,04:00:00,11,5,6,FMN GV 16 Berchem TOT
54,Posthofbrug 5366,2018-11-30,05:00:00,14,8,6,FMN GV 16 Berchem TOT
54,Posthofbrug 5366,2018-11-30,06:00:00,88,70,18,FMN GV 16 Berchem TOT
54,Posthofbrug 5366,2018-11-30,07:00:00,381,249,132,FMN GV 16 Berchem TOT
54,Posthofbrug 5366,2018-11-30,08:00:00,652,433,219,FMN GV 16 Berchem TOT
54,Posthofbrug 5366,2018-11-30,09:00:00,245,175,70,FMN GV 16 Berchem TOT
54,Posthofbrug 5366,2018-11-30,10:00:00,124,82,42,FMN GV 16 Berchem TOT
54,Posthofbrug 5366,2018-11-30,11:00:00,89,52,37,FMN GV 16 Berchem TOT
54,Posthofbrug 5366,2018-11-30,12:00:00,143,93,50,FMN GV 16 Berchem TOT
54,Posthofbrug 5366,2018-11-30,13:00:00,145,72,73,FMN GV 16 Berchem TOT
54,Posthofbrug 5366,2018-11-30,14:00:00,156,68,88,FMN GV 16 Berchem TOT
54,Posthofbrug 5366,2018-11-30,15:00:00,258,124,134,FMN GV 16 Berchem TOT
54,Posthofbrug 5366,2018-11-30,16:00:00,389,177,212,FMN GV 16 Berchem TOT
54,Posthofbrug 5366,2018-11-30,17:00:00,439,180,259,FMN GV 16 Berchem TOT
54,Posthofbrug 5366,2018-11-30,18:00:00,255,113,142,FMN GV 16 Berchem TOT
54,Posthofbrug 5366,2018-11-30,19:00:00,177,70,107,FMN GV 16 Berchem TOT
54,Posthofbrug 5366,2018-11-30,20:00:00,71,36,35,FMN GV 16 Berchem TOT
54,Posthofbrug 5366,2018-11-30,21:00:00,70,34,36,FMN GV 16 Berchem TOT
54,Posthofbrug 5366,2018-11-30,22:00:00,68,32,36,FMN GV 16 Berchem TOT
54,Posthofbrug 5366,2018-11-30,23:00:00,52,11,41,FMN GV 16 Berchem TOT
54,Posthofbrug 5366,2018-12-01,00:00:00,44,12,32,FMN GV 16 Berchem TOT
54,Posthofbrug 5366,2018-12-01,01:00:00,41,10,31,FMN GV 16 Berchem TOT
54,Posthofbrug 5366,2018-12-01,02:00:00,17,9,8,FMN GV 16 Berchem TOT
54,Posthofbrug 5366,2018-12-01,03:00:00,17,2,15,FMN GV 16 Berchem TOT
54,Posthofbrug 5366,2018-12-01,04:00:00,17,4,13,FMN GV 16 Berchem TOT
54,Posthofbrug 5366,2018-12-01,05:00:00,10,4,6,FMN GV 16 Berchem TOT
54,Posthofbrug 5366,2018-12-01,06:00:00,12,6,6,FMN GV 16 Berchem TOT
54,Posthofbrug 5366,2018-12-01,07:00:00,23,17,6,FMN GV 16 Berchem TOT
54,Posthofbrug 5366,2018-12-01,08:00:00,52,26,26,FMN GV 16 Berchem TOT
54,Posthofbrug 5366,2018-12-01,09:00:00,78,50,28,FMN GV 16 Berchem TOT
54,Posthofbrug 5366,2018-12-01,10:00:00,116,65,51,FMN GV 16 Berchem TOT
54,Posthofbrug 5366,2018-12-01,11:00:00,79,49,30,FMN GV 16 Berchem TOT
54,Posthofbrug 5366,2018-12-01,12:00:00,104,51,53,FMN GV 16 Berchem TOT
54,Posthofbrug 5366,2018-12-01,13:00:00,56,34,22,FMN GV 16 Berchem TOT
54,Posthofbrug 5366,2018-12-01,14:00:00,58,33,25,FMN GV 16 Berchem TOT
54,Posthofbrug 5366,2018-12-01,15:00:00,44,20,24,FMN GV 16 Berchem TOT
54,Posthofbrug 5366,2018-12-01,16:00:00,55,24,31,FMN GV 16 Berchem TOT
54,Posthofbrug 5366,2018-12-01,17:00:00,59,28,31,FMN GV 16 Berchem TOT
54,Posthofbrug 5366,2018-12-01,18:00:00,78,39,39,FMN GV 16 Berchem TOT
54,Posthofbrug 5366,2018-12-01,19:00:00,129,62,67,FMN GV 16 Berchem TOT
54,Posthofbrug 5366,2018-12-01,20:00:00,35,21,14,FMN GV 16 Berchem TOT
54,Posthofbrug 5366,2018-12-01,21:00:00,31,21,10,FMN GV 16 Berchem TOT
54,Posthofbrug 5366,2018-12-01,22:00:00,33,9,24,FMN GV 16 Berchem TOT
54,Posthofbrug 5366,2018-12-01,23:00:00,54,16,38,FMN GV 16 Berchem TOT
54,Posthofbrug 5366,2018-12-02,00:00:00,36,16,20,FMN GV 16 Berchem TOT
54,Posthofbrug 5366,2018-12-02,01:00:00,22,12,10,FMN GV 16 Berchem TOT
54,Posthofbrug 5366,2018-12-02,02:00:00,12,5,7,FMN GV 16 Berchem TOT
54,Posthofbrug 5366,2018-12-02,03:00:00,8,1,7,FMN GV 16 Berchem TOT
54,Posthofbrug 5366,2018-12-02,04:00:00,2,1,1,FMN GV 16 Berchem TOT
54,Posthofbrug 5366,2018-12-02,05:00:00,8,3,5,FMN GV 16 Berchem TOT
54,Posthofbrug 5366,2018-12-02,06:00:00,10,4,6,FMN GV 16 Berchem TOT
54,Posthofbrug 5366,2018-12-02,07:00:00,9,4,5,FMN GV 16 Berchem TOT
54,Posthofbrug 5366,2018-12-02,08:00:00,19,9,10,FMN GV 16 Berchem TOT
54,Posthofbrug 5366,2018-12-02,09:00:00,114,42,72,FMN GV 16 Berchem TOT
54,Posthofbrug 5366,2018-12-02,10:00:00,55,43,12,FMN GV 16 Berchem TOT
54,Posthofbrug 5366,2018-12-02,11:00:00,112,98,14,FMN GV 16 Berchem TOT
54,Posthofbrug 5366,2018-12-02,12:00:00,88,60,28,FMN GV 16 Berchem TOT
54,Posthofbrug 5366,2018-12-02,13:00:00,75,46,29,FMN GV 16 Berchem TOT
54,Posthofbrug 5366,2018-12-02,14:00:00,58,25,33,FMN GV 16 Berchem TOT
54,Posthofbrug 5366,2018-12-02,15:00:00,60,33,27,FMN GV 16 Berchem TOT
54,Posthofbrug 5366,2018-12-02,16:00:00,77,28,49,FMN GV 16 Berchem TOT
54,Posthofbrug 5366,2018-12-02,17:00:00,96,37,59,FMN GV 16 Berchem TOT
54,Posthofbrug 5366,2018-12-02,18:00:00,93,35,58,FMN GV 16 Berchem TOT
54,Posthofbrug 5366,2018-12-02,19:00:00,63,30,33,FMN GV 16 Berchem TOT
54,Posthofbrug 5366,2018-12-02,20:00:00,28,13,15,FMN GV 16 Berchem TOT
54,Posthofbrug 5366,2018-12-02,21:00:00,31,16,15,FMN GV 16 Berchem TOT
54,Posthofbrug 5366,2018-12-02,22:00:00,31,13,18,FMN GV 16 Berchem TOT
54,Posthofbrug 5366,2018-12-02,23:00:00,13,4,9,FMN GV 16 Berchem TOT
54,Posthofbrug 5366,2018-12-03,00:00:00,9,5,4,FMN GV 16 Berchem TOT
54,Posthofbrug 5366,2018-12-03,01:00:00,3,1,2,FMN GV 16 Berchem TOT
54,Posthofbrug 5366,2018-12-03,02:00:00,5,2,3,FMN GV 16 Berchem TOT
54,Posthofbrug 5366,2018-12-03,03:00:00,1,0,1,FMN GV 16 Berchem TOT
54,Posthofbrug 5366,2018-12-03,04:00:00,11,9,2,FMN GV 16 Berchem TOT
54,Posthofbrug 5366,2018-12-03,05:00:00,17,9,8,FMN GV 16 Berchem TOT
54,Posthofbrug 5366,2018-12-03,06:00:00,91,78,13,FMN GV 16 Berchem TOT
54,Posthofbrug 5366,2018-12-03,07:00:00,412,316,96,FMN GV 16 Berchem TOT
54,Posthofbrug 5366,2018-12-03,08:00:00,686,454,232,FMN GV 16 Berchem TOT
54,Posthofbrug 5366,2018-12-03,09:00:00,212,146,66,FMN GV 16 Berchem TOT
54,Posthofbrug 5366,2018-12-03,10:00:00,89,56,33,FMN GV 16 Berchem TOT
54,Posthofbrug 5366,2018-12-03,11:00:00,60,45,15,FMN GV 16 Berchem TOT
54,Posthofbrug 5366,2018-12-03,12:00:00,95,53,42,FMN GV 16 Berchem TOT
54,Posthofbrug 5366,2018-12-03,13:00:00,91,52,39,FMN GV 16 Berchem TOT
54,Posthofbrug 5366,2018-12-03,14:00:00,81,32,49,FMN GV 16 Berchem TOT
54,Posthofbrug 5366,2018-12-03,15:00:00,197,92,105,FMN GV 16 Berchem TOT
54,Posthofbrug 5366,2018-12-03,16:00:00,364,150,214,FMN GV 16 Berchem TOT
54,Posthofbrug 5366,2018-12-03,17:00:00,489,185,304,FMN GV 16 Berchem TOT
54,Posthofbrug 5366,2018-12-03,18:00:00,276,101,175,FMN GV 16 Berchem TOT
54,Posthofbrug 5366,2018-12-03,19:00:00,136,61,75,FMN GV 16 Berchem TOT
54,Posthofbrug 5366,2018-12-03,20:00:00,71,32,39,FMN GV 16 Berchem TOT
54,Posthofbrug 5366,2018-12-03,21:00:00,57,25,32,FMN GV 16 Berchem TOT
54,Posthofbrug 5366,2018-12-03,22:00:00,53,26,27,FMN GV 16 Berchem TOT
54,Posthofbrug 5366,2018-12-03,23:00:00,22,9,13,FMN GV 16 Berchem TOT
54,Posthofbrug 5366,2018-12-04,00:00:00,11,3,8,FMN GV 16 Berchem TOT
54,Posthofbrug 5366,2018-12-04,01:00:00,5,2,3,FMN GV 16 Berchem TOT
54,Posthofbrug 5366,2018-12-04,02:00:00,2,0,2,FMN GV 16 Berchem TOT
54,Posthofbrug 5366,2018-12-04,03:00:00,2,2,0,FMN GV 16 Berchem TOT
54,Posthofbrug 5366,2018-12-04,04:00:00,10,8,2,FMN GV 16 Berchem TOT
54,Posthofbrug 5366,2018-12-04,05:00:00,25,13,12,FMN GV 16 Berchem TOT
54,Posthofbrug 5366,2018-12-04,06:00:00,109,95,14,FMN GV 16 Berchem TOT
54,Posthofbrug 5366,2018-12-04,07:00:00,483,341,142,FMN GV 16 Berchem TOT
54,Posthofbrug 5366,2018-12-04,08:00:00,795,537,258,FMN GV 16 Berchem TOT
54,Posthofbrug 5366,2018-12-04,09:00:00,207,144,63,FMN GV 16 Berchem TOT
54,Posthofbrug 5366,2018-12-04,10:00:00,120,84,36,FMN GV 16 Berchem TOT
54,Posthofbrug 5366,2018-12-04,11:00:00,117,67,50,FMN GV 16 Berchem TOT
54,Posthofbrug 5366,2018-12-04,12:00:00,156,95,61,FMN GV 16 Berchem TOT
54,Posthofbrug 5366,2018-12-04,13:00:00,151,78,73,FMN GV 16 Berchem TOT
54,Posthofbrug 5366,2018-12-04,14:00:00,113,53,60,FMN GV 16 Berchem TOT
54,Posthofbrug 5366,2018-12-04,15:00:00,227,89,138,FMN GV 16 Berchem TOT
54,Posthofbrug 5366,2018-12-04,16:00:00,412,177,235,FMN GV 16 Berchem TOT
54,Posthofbrug 5366,2018-12-04,17:00:00,578,193,385,FMN GV 16 Berchem TOT
54,Posthofbrug 5366,2018-12-04,18:00:00,350,126,224,FMN GV 16 Berchem TOT
54,Posthofbrug 5366,2018-12-04,19:00:00,160,70,90,FMN GV 16 Berchem TOT
54,Posthofbrug 5366,2018-12-04,20:00:00,98,29,69,FMN GV 16 Berchem TOT
54,Posthofbrug 5366,2018-12-04,21:00:00,76,27,49,FMN GV 16 Berchem TOT
54,Posthofbrug 5366,2018-12-04,22:00:00,81,20,61,FMN GV 16 Berchem TOT
54,Posthofbrug 5366,2018-12-04,23:00:00,49,18,31,FMN GV 16 Berchem TOT
54,Posthofbrug 5366,2018-12-05,00:00:00,18,2,16,FMN GV 16 Berchem TOT
54,Posthofbrug 5366,2018-12-05,01:00:00,7,2,5,FMN GV 16 Berchem TOT
54,Posthofbrug 5366,2018-12-05,02:00:00,4,1,3,FMN GV 16 Berchem TOT
54,Posthofbrug 5366,2018-12-05,03:00:00,2,1,1,FMN GV 16 Berchem TOT
54,Posthofbrug 5366,2018-12-05,04:00:00,8,6,2,FMN GV 16 Berchem TOT
54,Posthofbrug 5366,2018-12-05,05:00:00,21,15,6,FMN GV 16 Berchem TOT
54,Posthofbrug 5366,2018-12-05,06:00:00,91,73,18,FMN GV 16 Berchem TOT
54,Posthofbrug 5366,2018-12-05,07:00:00,387,284,103,FMN GV 16 Berchem TOT
54,Posthofbrug 5366,2018-12-05,08:00:00,578,373,205,FMN GV 16 Berchem TOT
54,Posthofbrug 5366,2018-12-05,09:00:00,194,125,69,FMN GV 16 Berchem TOT
54,Posthofbrug 5366,2018-12-05,10:00:00,111,83,28,FMN GV 16 Berchem TOT
54,Posthofbrug 5366,2018-12-05,11:00:00,93,41,52,FMN GV 16 Berchem TOT
54,Posthofbrug 5366,2018-12-05,12:00:00,268,158,110,FMN GV 16 Berchem TOT
54,Posthofbrug 5366,2018-12-05,13:00:00,176,69,107,FMN GV 16 Berchem TOT
54,Posthofbrug 5366,2018-12-05,14:00:00,124,51,73,FMN GV 16 Berchem TOT
54,Posthofbrug 5366,2018-12-05,15:00:00,142,56,86,FMN GV 16 Berchem TOT
54,Posthofbrug 5366,2018-12-05,16:00:00,295,134,161,FMN GV 16 Berchem TOT
54,Posthofbrug 5366,2018-12-05,17:00:00,456,175,281,FMN GV 16 Berchem TOT
54,Posthofbrug 5366,2018-12-05,18:00:00,282,102,180,FMN GV 16 Berchem TOT
54,Posthofbrug 5366,2018-12-05,19:00:00,139,58,81,FMN GV 16 Berchem TOT
54,Posthofbrug 5366,2018-12-05,20:00:00,87,41,46,FMN GV 16 Berchem TOT
54,Posthofbrug 5366,2018-12-05,21:00:00,69,29,40,FMN GV 16 Berchem TOT
54,Posthofbrug 5366,2018-12-05,22:00:00,61,28,33,FMN GV 16 Berchem TOT
54,Posthofbrug 5366,2018-12-05,23:00:00,28,9,19,FMN GV 16 Berchem TOT
54,Posthofbrug 5366,2018-12-06,00:00:00,12,4,8,FMN GV 16 Berchem TOT
54,Posthofbrug 5366,2018-12-06,01:00:00,2,0,2,FMN GV 16 Berchem TOT
54,Posthofbrug 5366,2018-12-06,02:00:00,2,0,2,FMN GV 16 Berchem TOT
54,Posthofbrug 5366,2018-12-06,03:00:00,2,1,1,FMN GV 16 Berchem TOT
54,Posthofbrug 5366,2018-12-06,04:00:00,10,6,4,FMN GV 16 Berchem TOT
54,Posthofbrug 5366,2018-12-06,05:00:00,21,15,6,FMN GV 16 Berchem TOT
54,Posthofbrug 5366,2018-12-06,06:00:00,100,86,14,FMN GV 16 Berchem TOT
54,Posthofbrug 5366,2018-12-06,07:00:00,409,298,111,FMN GV 16 Berchem TOT
54,Posthofbrug 5366,2018-12-06,08:00:00,674,466,208,FMN GV 16 Berchem TOT
54,Posthofbrug 5366,2018-12-06,09:00:00,204,149,55,FMN GV 16 Berchem TOT
54,Posthofbrug 5366,2018-12-06,10:00:00,121,90,31,FMN GV 16 Berchem TOT
54,Posthofbrug 5366,2018-12-06,11:00:00,100,62,38,FMN GV 16 Berchem TOT
54,Posthofbrug 5366,2018-12-06,12:00:00,158,90,68,FMN GV 16 Berchem TOT
54,Posthofbrug 5366,2018-12-06,13:00:00,132,66,66,FMN GV 16 Berchem TOT
54,Posthofbrug 5366,2018-12-06,14:00:00,110,39,71,FMN GV 16 Berchem TOT
54,Posthofbrug 5366,2018-12-06,15:00:00,194,81,113,FMN GV 16 Berchem TOT
54,Posthofbrug 5366,2018-12-06,16:00:00,337,141,196,FMN GV 16 Berchem TOT
54,Posthofbrug 5366,2018-12-06,17:00:00,487,184,303,FMN GV 16 Berchem TOT
54,Posthofbrug 5366,2018-12-06,18:00:00,303,100,203,FMN GV 16 Berchem TOT
54,Posthofbrug 5366,2018-12-06,19:00:00,142,65,77,FMN GV 16 Berchem TOT
54,Posthofbrug 5366,2018-12-06,20:00:00,98,53,45,FMN GV 16 Berchem TOT
54,Posthofbrug 5366,2018-12-06,21:00:00,70,37,33,FMN GV 16 Berchem TOT
54,Posthofbrug 5366,2018-12-06,22:00:00,61,18,43,FMN GV 16 Berchem TOT
54,Posthofbrug 5366,2018-12-06,23:00:00,50,13,37,FMN GV 16 Berchem TOT
54,Posthofbrug 5366,2018-12-07,00:00:00,18,6,12,FMN GV 16 Berchem TOT
54,Posthofbrug 5366,2018-12-07,01:00:00,7,3,4,FMN GV 16 Berchem TOT
54,Posthofbrug 5366,2018-12-07,02:00:00,5,0,5,FMN GV 16 Berchem TOT
54,Posthofbrug 5366,2018-12-07,03:00:00,4,0,4,FMN GV 16 Berchem TOT
54,Posthofbrug 5366,2018-12-07,04:00:00,8,4,4,FMN GV 16 Berchem TOT
54,Posthofbrug 5366,2018-12-07,05:00:00,18,12,6,FMN GV 16 Berchem TOT
54,Posthofbrug 5366,2018-12-07,06:00:00,64,50,14,FMN GV 16 Berchem TOT
54,Posthofbrug 5366,2018-12-07,07:00:00,318,242,76,FMN GV 16 Berchem TOT
54,Posthofbrug 5366,2018-12-07,08:00:00,544,367,177,FMN GV 16 Berchem TOT
54,Posthofbrug 5366,2018-12-07,09:00:00,189,122,67,FMN GV 16 Berchem TOT
54,Posthofbrug 5366,2018-12-07,10:00:00,83,51,32,FMN GV 16 Berchem TOT
54,Posthofbrug 5366,2018-12-07,11:00:00,87,56,31,FMN GV 16 Berchem TOT
54,Posthofbrug 5366,2018-12-07,12:00:00,122,66,56,FMN GV 16 Berchem TOT
54,Posthofbrug 5366,2018-12-07,13:00:00,111,52,59,FMN GV 16 Berchem TOT
54,Posthofbrug 5366,2018-12-07,14:00:00,81,32,49,FMN GV 16 Berchem TOT
54,Posthofbrug 5366,2018-12-07,15:00:00,140,64,76,FMN GV 16 Berchem TOT
54,Posthofbrug 5366,2018-12-07,16:00:00,272,110,162,FMN GV 16 Berchem TOT
54,Posthofbrug 5366,2018-12-07,17:00:00,318,129,189,FMN GV 16 Berchem TOT
54,Posthofbrug 5366,2018-12-07,18:00:00,193,86,107,FMN GV 16 Berchem TOT
54,Posthofbrug 5366,2018-12-07,19:00:00,97,47,50,FMN GV 16 Berchem TOT
54,Posthofbrug 5366,2018-12-07,20:00:00,42,22,20,FMN GV 16 Berchem TOT
54,Posthofbrug 5366,2018-12-07,21:00:00,48,19,29,FMN GV 16 Berchem TOT
54,Posthofbrug 5366,2018-12-07,22:00:00,35,18,17,FMN GV 16 Berchem TOT
54,Posthofbrug 5366,2018-12-07,23:00:00,34,5,29,FMN GV 16 Berchem TOT
54,Posthofbrug 5366,2018-12-08,00:00:00,42,13,29,FMN GV 16 Berchem TOT
54,Posthofbrug 5366,2018-12-08,01:00:00,17,5,12,FMN GV 16 Berchem TOT
54,Posthofbrug 5366,2018-12-08,02:00:00,38,16,22,FMN GV 16 Berchem TOT
54,Posthofbrug 5366,2018-12-08,03:00:00,66,24,42,FMN GV 16 Berchem TOT
54,Posthofbrug 5366,2018-12-08,04:00:00,8,1,7,FMN GV 16 Berchem TOT
54,Posthofbrug 5366,2018-12-08,05:00:00,3,3,0,FMN GV 16 Berchem TOT
54,Posthofbrug 5366,2018-12-08,06:00:00,12,8,4,FMN GV 16 Berchem TOT
54,Posthofbrug 5366,2018-12-08,07:00:00,16,12,4,FMN GV 16 Berchem TOT
54,Posthofbrug 5366,2018-12-08,08:00:00,38,26,12,FMN GV 16 Berchem TOT
54,Posthofbrug 5366,2018-12-08,09:00:00,73,54,19,FMN GV 16 Berchem TOT
54,Posthofbrug 5366,2018-12-08,10:00:00,87,52,35,FMN GV 16 Berchem TOT
54,Posthofbrug 5366,2018-12-08,11:00:00,77,41,36,FMN GV 16 Berchem TOT
54,Posthofbrug 5366,2018-12-08,12:00:00,77,51,26,FMN GV 16 Berchem TOT
54,Posthofbrug 5366,2018-12-08,13:00:00,84,46,38,FMN GV 16 Berchem TOT
54,Posthofbrug 5366,2018-12-08,14:00:00,93,55,38,FMN GV 16 Berchem TOT
54,Posthofbrug 5366,2018-12-08,15:00:00,75,34,41,FMN GV 16 Berchem TOT
54,Posthofbrug 5366,2018-12-08,16:00:00,96,50,46,FMN GV 16 Berchem TOT
54,Posthofbrug 5366,2018-12-08,17:00:00,66,31,35,FMN GV 16 Berchem TOT
54,Posthofbrug 5366,2018-12-08,18:00:00,85,37,48,FMN GV 16 Berchem TOT
54,Posthofbrug 5366,2018-12-08,19:00:00,41,19,22,FMN GV 16 Berchem TOT
54,Posthofbrug 5366,2018-12-08,20:00:00,35,13,22,FMN GV 16 Berchem TOT
54,Posthofbrug 5366,2018-12-08,21:00:00,39,19,20,FMN GV 16 Berchem TOT
54,Posthofbrug 5366,2018-12-08,22:00:00,27,11,16,FMN GV 16 Berchem TOT
54,Posthofbrug 5366,2018-12-08,23:00:00,27,11,16,FMN GV 16 Berchem TOT
54,Posthofbrug 5366,2018-12-09,00:00:00,33,12,21,FMN GV 16 Berchem TOT
54,Posthofbrug 5366,2018-12-09,01:00:00,13,3,10,FMN GV 16 Berchem TOT
54,Posthofbrug 5366,2018-12-09,02:00:00,9,3,6,FMN GV 16 Berchem TOT
54,Posthofbrug 5366,2018-12-09,03:00:00,4,0,4,FMN GV 16 Berchem TOT
54,Posthofbrug 5366,2018-12-09,04:00:00,16,3,13,FMN GV 16 Berchem TOT
54,Posthofbrug 5366,2018-12-09,05:00:00,8,3,5,FMN GV 16 Berchem TOT
54,Posthofbrug 5366,2018-12-09,06:00:00,12,5,7,FMN GV 16 Berchem TOT
54,Posthofbrug 5366,2018-12-09,07:00:00,13,5,8,FMN GV 16 Berchem TOT
54,Posthofbrug 5366,2018-12-09,08:00:00,16,12,4,FMN GV 16 Berchem TOT
54,Posthofbrug 5366,2018-12-09,09:00:00,29,19,10,FMN GV 16 Berchem TOT
54,Posthofbrug 5366,2018-12-09,10:00:00,18,14,4,FMN GV 16 Berchem TOT
54,Posthofbrug 5366,2018-12-09,11:00:00,26,15,11,FMN GV 16 Berchem TOT
54,Posthofbrug 5366,2018-12-09,12:00:00,32,19,13,FMN GV 16 Berchem TOT
54,Posthofbrug 5366,2018-12-09,13:00:00,26,13,13,FMN GV 16 Berchem TOT
54,Posthofbrug 5366,2018-12-09,14:00:00,61,31,30,FMN GV 16 Berchem TOT
54,Posthofbrug 5366,2018-12-09,15:00:00,39,24,15,FMN GV 16 Berchem TOT
54,Posthofbrug 5366,2018-12-09,16:00:00,52,32,20,FMN GV 16 Berchem TOT
54,Posthofbrug 5366,2018-12-09,17:00:00,47,23,24,FMN GV 16 Berchem TOT
54,Posthofbrug 5366,2018-12-09,18:00:00,46,24,22,FMN GV 16 Berchem TOT
54,Posthofbrug 5366,2018-12-09,19:00:00,37,17,20,FMN GV 16 Berchem TOT
54,Posthofbrug 5366,2018-12-09,20:00:00,28,13,15,FMN GV 16 Berchem TOT
54,Posthofbrug 5366,2018-12-09,21:00:00,16,9,7,FMN GV 16 Berchem TOT
54,Posthofbrug 5366,2018-12-09,22:00:00,22,9,13,FMN GV 16 Berchem TOT
54,Posthofbrug 5366,2018-12-09,23:00:00,18,8,10,FMN GV 16 Berchem TOT
54,Posthofbrug 5366,2018-12-10,00:00:00,7,3,4,FMN GV 16 Berchem TOT
54,Posthofbrug 5366,2018-12-10,01:00:00,2,1,1,FMN GV 16 Berchem TOT
54,Posthofbrug 5366,2018-12-10,02:00:00,1,1,0,FMN GV 16 Berchem TOT
54,Posthofbrug 5366,2018-12-10,03:00:00,1,1,0,FMN GV 16 Berchem TOT
54,Posthofbrug 5366,2018-12-10,04:00:00,11,4,7,FMN GV 16 Berchem TOT
54,Posthofbrug 5366,2018-12-10,05:00:00,14,8,6,FMN GV 16 Berchem TOT
54,Posthofbrug 5366,2018-12-10,06:00:00,103,83,20,FMN GV 16 Berchem TOT
54,Posthofbrug 5366,2018-12-10,07:00:00,412,294,118,FMN GV 16 Berchem TOT
54,Posthofbrug 5366,2018-12-10,08:00:00,685,461,224,FMN GV 16 Berchem TOT
54,Posthofbrug 5366,2018-12-10,09:00:00,238,150,88,FMN GV 16 Berchem TOT
54,Posthofbrug 5366,2018-12-10,10:00:00,112,73,39,FMN GV 16 Berchem TOT
54,Posthofbrug 5366,2018-12-10,11:00:00,99,68,31,FMN GV 16 Berchem TOT
54,Posthofbrug 5366,2018-12-10,12:00:00,150,78,72,FMN GV 16 Berchem TOT
54,Posthofbrug 5366,2018-12-10,13:00:00,161,84,77,FMN GV 16 Berchem TOT
54,Posthofbrug 5366,2018-12-10,14:00:00,117,41,76,FMN GV 16 Berchem TOT
54,Posthofbrug 5366,2018-12-10,15:00:00,191,88,103,FMN GV 16 Berchem TOT
54,Posthofbrug 5366,2018-12-10,16:00:00,348,141,207,FMN GV 16 Berchem TOT
54,Posthofbrug 5366,2018-12-10,17:00:00,449,172,277,FMN GV 16 Berchem TOT
54,Posthofbrug 5366,2018-12-10,18:00:00,300,87,213,FMN GV 16 Berchem TOT
54,Posthofbrug 5366,2018-12-10,19:00:00,129,48,81,FMN GV 16 Berchem TOT
54,Posthofbrug 5366,2018-12-10,20:00:00,77,34,43,FMN GV 16 Berchem TOT
54,Posthofbrug 5366,2018-12-10,21:00:00,56,23,33,FMN GV 16 Berchem TOT
54,Posthofbrug 5366,2018-12-10,22:00:00,45,16,29,FMN GV 16 Berchem TOT
54,Posthofbrug 5366,2018-12-10,23:00:00,26,8,18,FMN GV 16 Berchem TOT
54,Posthofbrug 5366,2018-12-11,00:00:00,18,7,11,FMN GV 16 Berchem TOT
54,Posthofbrug 5366,2018-12-11,01:00:00,4,1,3,FMN GV 16 Berchem TOT
54,Posthofbrug 5366,2018-12-11,02:00:00,0,0,0,FMN GV 16 Berchem TOT
54,Posthofbrug 5366,2018-12-11,03:00:00,2,2,0,FMN GV 16 Berchem TOT
54,Posthofbrug 5366,2018-12-11,04:00:00,8,5,3,FMN GV 16 Berchem TOT
54,Posthofbrug 5366,2018-12-11,05:00:00,20,13,7,FMN GV 16 Berchem TOT
54,Posthofbrug 5366,2018-12-11,06:00:00,110,88,22,FMN GV 16 Berchem TOT
54,Posthofbrug 5366,2018-12-11,07:00:00,477,329,148,FMN GV 16 Berchem TOT
54,Posthofbrug 5366,2018-12-11,08:00:00,687,462,225,FMN GV 16 Berchem TOT
54,Posthofbrug 5366,2018-12-11,09:00:00,232,168,64,FMN GV 16 Berchem TOT
54,Posthofbrug 5366,2018-12-11,10:00:00,96,71,25,FMN GV 16 Berchem TOT
54,Posthofbrug 5366,2018-12-11,11:00:00,103,52,51,FMN GV 16 Berchem TOT
54,Posthofbrug 5366,2018-12-11,12:00:00,156,91,65,FMN GV 16 Berchem TOT
54,Posthofbrug 5366,2018-12-11,13:00:00,141,62,79,FMN GV 16 Berchem TOT
54,Posthofbrug 5366,2018-12-11,14:00:00,126,52,74,FMN GV 16 Berchem TOT
54,Posthofbrug 5366,2018-12-11,15:00:00,220,89,131,FMN GV 16 Berchem TOT
54,Posthofbrug 5366,2018-12-11,16:00:00,383,156,227,FMN GV 16 Berchem TOT
54,Posthofbrug 5366,2018-12-11,17:00:00,494,171,323,FMN GV 16 Berchem TOT
54,Posthofbrug 5366,2018-12-11,18:00:00,378,143,235,FMN GV 16 Berchem TOT
54,Posthofbrug 5366,2018-12-11,19:00:00,162,56,106,FMN GV 16 Berchem TOT
54,Posthofbrug 5366,2018-12-11,20:00:00,99,29,70,FMN GV 16 Berchem TOT
54,Posthofbrug 5366,2018-12-11,21:00:00,80,39,41,FMN GV 16 Berchem TOT
54,Posthofbrug 5366,2018-12-11,22:00:00,71,25,46,FMN GV 16 Berchem TOT
54,Posthofbrug 5366,2018-12-11,23:00:00,37,15,22,FMN GV 16 Berchem TOT
54,Posthofbrug 5366,2018-12-12,00:00:00,13,3,10,FMN GV 16 Berchem TOT
54,Posthofbrug 5366,2018-12-12,01:00:00,8,1,7,FMN GV 16 Berchem TOT
54,Posthofbrug 5366,2018-12-12,02:00:00,3,0,3,FMN GV 16 Berchem TOT
54,Posthofbrug 5366,2018-12-12,03:00:00,2,1,1,FMN GV 16 Berchem TOT
54,Posthofbrug 5366,2018-12-12,04:00:00,7,4,3,FMN GV 16 Berchem TOT
54,Posthofbrug 5366,2018-12-12,05:00:00,19,12,7,FMN GV 16 Berchem TOT
54,Posthofbrug 5366,2018-12-12,06:00:00,91,74,17,FMN GV 16 Berchem TOT
54,Posthofbrug 5366,2018-12-12,07:00:00,384,272,112,FMN GV 16 Berchem TOT
54,Posthofbrug 5366,2018-12-12,08:00:00,580,380,200,FMN GV 16 Berchem TOT
54,Posthofbrug 5366,2018-12-12,09:00:00,212,128,84,FMN GV 16 Berchem TOT
54,Posthofbrug 5366,2018-12-12,10:00:00,92,57,35,FMN GV 16 Berchem TOT
54,Posthofbrug 5366,2018-12-12,11:00:00,117,51,66,FMN GV 16 Berchem TOT
54,Posthofbrug 5366,2018-12-12,12:00:00,222,96,126,FMN GV 16 Berchem TOT
54,Posthofbrug 5366,2018-12-12,13:00:00,151,80,71,FMN GV 16 Berchem TOT
54,Posthofbrug 5366,2018-12-12,14:00:00,114,50,64,FMN GV 16 Berchem TOT
54,Posthofbrug 5366,2018-12-12,15:00:00,127,57,70,FMN GV 16 Berchem TOT
54,Posthofbrug 5366,2018-12-12,16:00:00,286,123,163,FMN GV 16 Berchem TOT
54,Posthofbrug 5366,2018-12-12,17:00:00,451,177,274,FMN GV 16 Berchem TOT
54,Posthofbrug 5366,2018-12-12,18:00:00,317,132,185,FMN GV 16 Berchem TOT
54,Posthofbrug 5366,2018-12-12,19:00:00,136,55,81,FMN GV 16 Berchem TOT
54,Posthofbrug 5366,2018-12-12,20:00:00,84,38,46,FMN GV 16 Berchem TOT
54,Posthofbrug 5366,2018-12-12,21:00:00,55,23,32,FMN GV 16 Berchem TOT
54,Posthofbrug 5366,2018-12-12,22:00:00,70,21,49,FMN GV 16 Berchem TOT
54,Posthofbrug 5366,2018-12-12,23:00:00,34,15,19,FMN GV 16 Berchem TOT
54,Posthofbrug 5366,2018-12-13,00:00:00,12,5,7,FMN GV 16 Berchem TOT
54,Posthofbrug 5366,2018-12-13,01:00:00,5,2,3,FMN GV 16 Berchem TOT
54,Posthofbrug 5366,2018-12-13,02:00:00,3,2,1,FMN GV 16 Berchem TOT
54,Posthofbrug 5366,2018-12-13,03:00:00,2,1,1,FMN GV 16 Berchem TOT
54,Posthofbrug 5366,2018-12-13,04:00:00,8,6,2,FMN GV 16 Berchem TOT
54,Posthofbrug 5366,2018-12-13,05:00:00,14,9,5,FMN GV 16 Berchem TOT
54,Posthofbrug 5366,2018-12-13,06:00:00,83,71,12,FMN GV 16 Berchem TOT
54,Posthofbrug 5366,2018-12-13,07:00:00,378,289,89,FMN GV 16 Berchem TOT
54,Posthofbrug 5366,2018-12-13,08:00:00,672,428,244,FMN GV 16 Berchem TOT
54,Posthofbrug 5366,2018-12-13,09:00:00,229,163,66,FMN GV 16 Berchem TOT
54,Posthofbrug 5366,2018-12-13,10:00:00,107,72,35,FMN GV 16 Berchem TOT
54,Posthofbrug 5366,2018-12-13,11:00:00,111,67,44,FMN GV 16 Berchem TOT
54,Posthofbrug 5366,2018-12-13,12:00:00,137,82,55,FMN GV 16 Berchem TOT
54,Posthofbrug 5366,2018-12-13,13:00:00,120,57,63,FMN GV 16 Berchem TOT
54,Posthofbrug 5366,2018-12-13,14:00:00,133,49,84,FMN GV 16 Berchem TOT
54,Posthofbrug 5366,2018-12-13,15:00:00,186,75,111,FMN GV 16 Berchem TOT
54,Posthofbrug 5366,2018-12-13,16:00:00,312,148,164,FMN GV 16 Berchem TOT
54,Posthofbrug 5366,2018-12-13,17:00:00,424,154,270,FMN GV 16 Berchem TOT
54,Posthofbrug 5366,2018-12-13,18:00:00,298,111,187,FMN GV 16 Berchem TOT
54,Posthofbrug 5366,2018-12-13,19:00:00,123,39,84,FMN GV 16 Berchem TOT
54,Posthofbrug 5366,2018-12-13,20:00:00,120,52,68,FMN GV 16 Berchem TOT
54,Posthofbrug 5366,2018-12-13,21:00:00,68,30,38,FMN GV 16 Berchem TOT
54,Posthofbrug 5366,2018-12-13,22:00:00,67,25,42,FMN GV 16 Berchem TOT
54,Posthofbrug 5366,2018-12-13,23:00:00,55,18,37,FMN GV 16 Berchem TOT
54,Posthofbrug 5366,2018-12-14,00:00:00,30,5,25,FMN GV 16 Berchem TOT
54,Posthofbrug 5366,2018-12-14,01:00:00,16,6,10,FMN GV 16 Berchem TOT
54,Posthofbrug 5366,2018-12-14,02:00:00,6,0,6,FMN GV 16 Berchem TOT
54,Posthofbrug 5366,2018-12-14,03:00:00,11,4,7,FMN GV 16 Berchem TOT
54,Posthofbrug 5366,2018-12-14,04:00:00,10,6,4,FMN GV 16 Berchem TOT
54,Posthofbrug 5366,2018-12-14,05:00:00,14,10,4,FMN GV 16 Berchem TOT
54,Posthofbrug 5366,2018-12-14,06:00:00,89,65,24,FMN GV 16 Berchem TOT
54,Posthofbrug 5366,2018-12-14,07:00:00,329,242,87,FMN GV 16 Berchem TOT
54,Posthofbrug 5366,2018-12-14,08:00:00,552,362,190,FMN GV 16 Berchem TOT
54,Posthofbrug 5366,2018-12-14,09:00:00,220,158,62,FMN GV 16 Berchem TOT
54,Posthofbrug 5366,2018-12-14,10:00:00,118,83,35,FMN GV 16 Berchem TOT
54,Posthofbrug 5366,2018-12-14,11:00:00,109,67,42,FMN GV 16 Berchem TOT
54,Posthofbrug 5366,2018-12-14,12:00:00,157,86,71,FMN GV 16 Berchem TOT
54,Posthofbrug 5366,2018-12-14,13:00:00,151,66,85,FMN GV 16 Berchem TOT
54,Posthofbrug 5366,2018-12-14,14:00:00,129,61,68,FMN GV 16 Berchem TOT
54,Posthofbrug 5366,2018-12-14,15:00:00,199,77,122,FMN GV 16 Berchem TOT
54,Posthofbrug 5366,2018-12-14,16:00:00,329,149,180,FMN GV 16 Berchem TOT
54,Posthofbrug 5366,2018-12-14,17:00:00,359,153,206,FMN GV 16 Berchem TOT
54,Posthofbrug 5366,2018-12-14,18:00:00,263,106,157,FMN GV 16 Berchem TOT
54,Posthofbrug 5366,2018-12-14,19:00:00,140,75,65,FMN GV 16 Berchem TOT
54,Posthofbrug 5366,2018-12-14,20:00:00,72,44,28,FMN GV 16 Berchem TOT
54,Posthofbrug 5366,2018-12-14,21:00:00,66,27,39,FMN GV 16 Berchem TOT
54,Posthofbrug 5366,2018-12-14,22:00:00,81,27,54,FMN GV 16 Berchem TOT
54,Posthofbrug 5366,2018-12-14,23:00:00,57,19,38,FMN GV 16 Berchem TOT
54,Posthofbrug 5366,2018-12-15,00:00:00,49,8,41,FMN GV 16 Berchem TOT
54,Posthofbrug 5366,2018-12-15,01:00:00,23,10,13,FMN GV 16 Berchem TOT
54,Posthofbrug 5366,2018-12-15,02:00:00,19,4,15,FMN GV 16 Berchem TOT
54,Posthofbrug 5366,2018-12-15,03:00:00,16,2,14,FMN GV 16 Berchem TOT
54,Posthofbrug 5366,2018-12-15,04:00:00,8,3,5,FMN GV 16 Berchem TOT
54,Posthofbrug 5366,2018-12-15,05:00:00,11,6,5,FMN GV 16 Berchem TOT
54,Posthofbrug 5366,2018-12-15,06:00:00,19,14,5,FMN GV 16 Berchem TOT
54,Posthofbrug 5366,2018-12-15,07:00:00,14,9,5,FMN GV 16 Berchem TOT
54,Posthofbrug 5366,2018-12-15,08:00:00,32,21,11,FMN GV 16 Berchem TOT
54,Posthofbrug 5366,2018-12-15,09:00:00,74,44,30,FMN GV 16 Berchem TOT
54,Posthofbrug 5366,2018-12-15,10:00:00,84,57,27,FMN GV 16 Berchem TOT
54,Posthofbrug 5366,2018-12-15,11:00:00,84,55,29,FMN GV 16 Berchem TOT
54,Posthofbrug 5366,2018-12-15,12:00:00,99,57,42,FMN GV 16 Berchem TOT
54,Posthofbrug 5366,2018-12-15,13:00:00,75,55,20,FMN GV 16 Berchem TOT
54,Posthofbrug 5366,2018-12-15,14:00:00,93,55,38,FMN GV 16 Berchem TOT
54,Posthofbrug 5366,2018-12-15,15:00:00,96,55,41,FMN GV 16 Berchem TOT
54,Posthofbrug 5366,2018-12-15,16:00:00,99,36,63,FMN GV 16 Berchem TOT
54,Posthofbrug 5366,2018-12-15,17:00:00,98,56,42,FMN GV 16 Berchem TOT
54,Posthofbrug 5366,2018-12-15,18:00:00,87,39,48,FMN GV 16 Berchem TOT
54,Posthofbrug 5366,2018-12-15,19:00:00,77,39,38,FMN GV 16 Berchem TOT
54,Posthofbrug 5366,2018-12-15,20:00:00,63,32,31,FMN GV 16 Berchem TOT
54,Posthofbrug 5366,2018-12-15,21:00:00,32,16,16,FMN GV 16 Berchem TOT
54,Posthofbrug 5366,2018-12-15,22:00:00,25,7,18,FMN GV 16 Berchem TOT
54,Posthofbrug 5366,2018-12-15,23:00:00,32,3,29,FMN GV 16 Berchem TOT
54,Posthofbrug 5366,2018-12-16,00:00:00,31,6,25,FMN GV 16 Berchem TOT
54,Posthofbrug 5366,2018-12-16,01:00:00,14,2,12,FMN GV 16 Berchem TOT
54,Posthofbrug 5366,2018-12-16,02:00:00,18,0,18,FMN GV 16 Berchem TOT
54,Posthofbrug 5366,2018-12-16,03:00:00,10,4,6,FMN GV 16 Berchem TOT
54,Posthofbrug 5366,2018-12-16,04:00:00,8,4,4,FMN GV 16 Berchem TOT
54,Posthofbrug 5366,2018-12-16,05:00:00,4,3,1,FMN GV 16 Berchem TOT
54,Posthofbrug 5366,2018-12-16,06:00:00,9,7,2,FMN GV 16 Berchem TOT
54,Posthofbrug 5366,2018-12-16,07:00:00,7,3,4,FMN GV 16 Berchem TOT
54,Posthofbrug 5366,2018-12-16,08:00:00,14,9,5,FMN GV 16 Berchem TOT
54,Posthofbrug 5366,2018-12-16,09:00:00,28,9,19,FMN GV 16 Berchem TOT
54,Posthofbrug 5366,2018-12-16,10:00:00,53,35,18,FMN GV 16 Berchem TOT
54,Posthofbrug 5366,2018-12-16,11:00:00,49,30,19,FMN GV 16 Berchem TOT
54,Posthofbrug 5366,2018-12-16,12:00:00,54,35,19,FMN GV 16 Berchem TOT
54,Posthofbrug 5366,2018-12-16,13:00:00,61,40,21,FMN GV 16 Berchem TOT
54,Posthofbrug 5366,2018-12-16,14:00:00,102,62,40,FMN GV 16 Berchem TOT
54,Posthofbrug 5366,2018-12-16,15:00:00,68,32,36,FMN GV 16 Berchem TOT
54,Posthofbrug 5366,2018-12-16,16:00:00,69,39,30,FMN GV 16 Berchem TOT
54,Posthofbrug 5366,2018-12-16,17:00:00,65,20,45,FMN GV 16 Berchem TOT
54,Posthofbrug 5366,2018-12-16,18:00:00,69,29,40,FMN GV 16 Berchem TOT
54,Posthofbrug 5366,2018-12-16,19:00:00,27,12,15,FMN GV 16 Berchem TOT
54,Posthofbrug 5366,2018-12-16,20:00:00,32,14,18,FMN GV 16 Berchem TOT
54,Posthofbrug 5366,2018-12-16,21:00:00,33,14,19,FMN GV 16 Berchem TOT
54,Posthofbrug 5366,2018-12-16,22:00:00,23,9,14,FMN GV 16 Berchem TOT
54,Posthofbrug 5366,2018-12-16,23:00:00,13,8,5,FMN GV 16 Berchem TOT
54,Posthofbrug 5366,2018-12-17,00:00:00,7,4,3,FMN GV 16 Berchem TOT
54,Posthofbrug 5366,2018-12-17,01:00:00,2,0,2,FMN GV 16 Berchem TOT
54,Posthofbrug 5366,2018-12-17,02:00:00,1,0,1,FMN GV 16 Berchem TOT
54,Posthofbrug 5366,2018-12-17,03:00:00,5,4,1,FMN GV 16 Berchem TOT
54,Posthofbrug 5366,2018-12-17,04:00:00,7,6,1,FMN GV 16 Berchem TOT
54,Posthofbrug 5366,2018-12-17,05:00:00,18,11,7,FMN GV 16 Berchem TOT
54,Posthofbrug 5366,2018-12-17,06:00:00,92,77,15,FMN GV 16 Berchem TOT
54,Posthofbrug 5366,2018-12-17,07:00:00,404,299,105,FMN GV 16 Berchem TOT
54,Posthofbrug 5366,2018-12-17,08:00:00,641,442,199,FMN GV 16 Berchem TOT
54,Posthofbrug 5366,2018-12-17,09:00:00,232,166,66,FMN GV 16 Berchem TOT
54,Posthofbrug 5366,2018-12-17,10:00:00,115,79,36,FMN GV 16 Berchem TOT
54,Posthofbrug 5366,2018-12-17,11:00:00,103,71,32,FMN GV 16 Berchem TOT
54,Posthofbrug 5366,2018-12-17,12:00:00,135,73,62,FMN GV 16 Berchem TOT
54,Posthofbrug 5366,2018-12-17,13:00:00,144,79,65,FMN GV 16 Berchem TOT
54,Posthofbrug 5366,2018-12-17,14:00:00,121,69,52,FMN GV 16 Berchem TOT
54,Posthofbrug 5366,2018-12-17,15:00:00,213,87,126,FMN GV 16 Berchem TOT
54,Posthofbrug 5366,2018-12-17,16:00:00,345,144,201,FMN GV 16 Berchem TOT
54,Posthofbrug 5366,2018-12-17,17:00:00,468,156,312,FMN GV 16 Berchem TOT
54,Posthofbrug 5366,2018-12-17,18:00:00,354,118,236,FMN GV 16 Berchem TOT
54,Posthofbrug 5366,2018-12-17,19:00:00,114,40,74,FMN GV 16 Berchem TOT
54,Posthofbrug 5366,2018-12-17,20:00:00,86,46,40,FMN GV 16 Berchem TOT
54,Posthofbrug 5366,2018-12-17,21:00:00,69,22,47,FMN GV 16 Berchem TOT
54,Posthofbrug 5366,2018-12-17,22:00:00,74,28,46,FMN GV 16 Berchem TOT
54,Posthofbrug 5366,2018-12-17,23:00:00,37,12,25,FMN GV 16 Berchem TOT
54,Posthofbrug 5366,2018-12-18,00:00:00,18,6,12,FMN GV 16 Berchem TOT
54,Posthofbrug 5366,2018-12-18,01:00:00,4,1,3,FMN GV 16 Berchem TOT
54,Posthofbrug 5366,2018-12-18,02:00:00,12,1,11,FMN GV 16 Berchem TOT
54,Posthofbrug 5366,2018-12-18,03:00:00,1,0,1,FMN GV 16 Berchem TOT
54,Posthofbrug 5366,2018-12-18,04:00:00,8,5,3,FMN GV 16 Berchem TOT
54,Posthofbrug 5366,2018-12-18,05:00:00,17,13,4,FMN GV 16 Berchem TOT
54,Posthofbrug 5366,2018-12-18,06:00:00,100,85,15,FMN GV 16 Berchem TOT
54,Posthofbrug 5366,2018-12-18,07:00:00,427,312,115,FMN GV 16 Berchem TOT
54,Posthofbrug 5366,2018-12-18,08:00:00,717,486,231,FMN GV 16 Berchem TOT
54,Posthofbrug 5366,2018-12-18,09:00:00,232,165,67,FMN GV 16 Berchem TOT
54,Posthofbrug 5366,2018-12-18,10:00:00,121,69,52,FMN GV 16 Berchem TOT
54,Posthofbrug 5366,2018-12-18,11:00:00,110,69,41,FMN GV 16 Berchem TOT
54,Posthofbrug 5366,2018-12-18,12:00:00,166,85,81,FMN GV 16 Berchem TOT
54,Posthofbrug 5366,2018-12-18,13:00:00,154,87,67,FMN GV 16 Berchem TOT
54,Posthofbrug 5366,2018-12-18,14:00:00,91,49,42,FMN GV 16 Berchem TOT
54,Posthofbrug 5366,2018-12-18,15:00:00,216,100,116,FMN GV 16 Berchem TOT
54,Posthofbrug 5366,2018-12-18,16:00:00,369,151,218,FMN GV 16 Berchem TOT
54,Posthofbrug 5366,2018-12-18,17:00:00,514,189,325,FMN GV 16 Berchem TOT
54,Posthofbrug 5366,2018-12-18,18:00:00,341,105,236,FMN GV 16 Berchem TOT
54,Posthofbrug 5366,2018-12-18,19:00:00,183,83,100,FMN GV 16 Berchem TOT
54,Posthofbrug 5366,2018-12-18,20:00:00,98,51,47,FMN GV 16 Berchem TOT
54,Posthofbrug 5366,2018-12-18,21:00:00,85,32,53,FMN GV 16 Berchem TOT
54,Posthofbrug 5366,2018-12-18,22:00:00,79,28,51,FMN GV 16 Berchem TOT
54,Posthofbrug 5366,2018-12-18,23:00:00,40,12,28,FMN GV 16 Berchem TOT
54,Posthofbrug 5366,2018-12-19,00:00:00,20,5,15,FMN GV 16 Berchem TOT
54,Posthofbrug 5366,2018-12-19,01:00:00,10,1,9,FMN GV 16 Berchem TOT
54,Posthofbrug 5366,2018-12-19,02:00:00,8,2,6,FMN GV 16 Berchem TOT
54,Posthofbrug 5366,2018-12-19,03:00:00,2,2,0,FMN GV 16 Berchem TOT
54,Posthofbrug 5366,2018-12-19,04:00:00,11,8,3,FMN GV 16 Berchem TOT
54,Posthofbrug 5366,2018-12-19,05:00:00,22,15,7,FMN GV 16 Berchem TOT
54,Posthofbrug 5366,2018-12-19,06:00:00,93,78,15,FMN GV 16 Berchem TOT
54,Posthofbrug 5366,2018-12-19,07:00:00,340,249,91,FMN GV 16 Berchem TOT
54,Posthofbrug 5366,2018-12-19,08:00:00,562,382,180,FMN GV 16 Berchem TOT
54,Posthofbrug 5366,2018-12-19,09:00:00,206,139,67,FMN GV 16 Berchem TOT
54,Posthofbrug 5366,2018-12-19,10:00:00,113,77,36,FMN GV 16 Berchem TOT
54,Posthofbrug 5366,2018-12-19,11:00:00,123,74,49,FMN GV 16 Berchem TOT
54,Posthofbrug 5366,2018-12-19,12:00:00,224,123,101,FMN GV 16 Berchem TOT
54,Posthofbrug 5366,2018-12-19,13:00:00,172,90,82,FMN GV 16 Berchem TOT
54,Posthofbrug 5366,2018-12-19,14:00:00,130,58,72,FMN GV 16 Berchem TOT
54,Posthofbrug 5366,2018-12-19,15:00:00,172,73,99,FMN GV 16 Berchem TOT
54,Posthofbrug 5366,2018-12-19,16:00:00,307,137,170,FMN GV 16 Berchem TOT
54,Posthofbrug 5366,2018-12-19,17:00:00,393,153,240,FMN GV 16 Berchem TOT
54,Posthofbrug 5366,2018-12-19,18:00:00,297,108,189,FMN GV 16 Berchem TOT
54,Posthofbrug 5366,2018-12-19,19:00:00,157,69,88,FMN GV 16 Berchem TOT
54,Posthofbrug 5366,2018-12-19,20:00:00,98,44,54,FMN GV 16 Berchem TOT
54,Posthofbrug 5366,2018-12-19,21:00:00,91,49,42,FMN GV 16 Berchem TOT
54,Posthofbrug 5366,2018-12-19,22:00:00,70,30,40,FMN GV 16 Berchem TOT
54,Posthofbrug 5366,2018-12-19,23:00:00,48,14,34,FMN GV 16 Berchem TOT
54,Posthofbrug 5366,2018-12-20,00:00:00,32,7,25,FMN GV 16 Berchem TOT
54,Posthofbrug 5366,2018-12-20,01:00:00,11,5,6,FMN GV 16 Berchem TOT
54,Posthofbrug 5366,2018-12-20,02:00:00,10,0,10,FMN GV 16 Berchem TOT
54,Posthofbrug 5366,2018-12-20,03:00:00,9,1,8,FMN GV 16 Berchem TOT
54,Posthofbrug 5366,2018-12-20,04:00:00,11,6,5,FMN GV 16 Berchem TOT
54,Posthofbrug 5366,2018-12-20,05:00:00,24,14,10,FMN GV 16 Berchem TOT
54,Posthofbrug 5366,2018-12-20,06:00:00,76,68,8,FMN GV 16 Berchem TOT
54,Posthofbrug 5366,2018-12-20,07:00:00,368,290,78,FMN GV 16 Berchem TOT
54,Posthofbrug 5366,2018-12-20,08:00:00,589,406,183,FMN GV 16 Berchem TOT
54,Posthofbrug 5366,2018-12-20,09:00:00,203,140,63,FMN GV 16 Berchem TOT
54,Posthofbrug 5366,2018-12-20,10:00:00,103,78,25,FMN GV 16 Berchem TOT
54,Posthofbrug 5366,2018-12-20,11:00:00,91,61,30,FMN GV 16 Berchem TOT
54,Posthofbrug 5366,2018-12-20,12:00:00,151,90,61,FMN GV 16 Berchem TOT
54,Posthofbrug 5366,2018-12-20,13:00:00,124,62,62,FMN GV 16 Berchem TOT
54,Posthofbrug 5366,2018-12-20,14:00:00,99,57,42,FMN GV 16 Berchem TOT
54,Posthofbrug 5366,2018-12-20,15:00:00,173,77,96,FMN GV 16 Berchem TOT
54,Posthofbrug 5366,2018-12-20,16:00:00,282,121,161,FMN GV 16 Berchem TOT
54,Posthofbrug 5366,2018-12-20,17:00:00,391,146,245,FMN GV 16 Berchem TOT
54,Posthofbrug 5366,2018-12-20,18:00:00,265,101,164,FMN GV 16 Berchem TOT
54,Posthofbrug 5366,2018-12-20,19:00:00,140,58,82,FMN GV 16 Berchem TOT
54,Posthofbrug 5366,2018-12-20,20:00:00,104,45,59,FMN GV 16 Berchem TOT
54,Posthofbrug 5366,2018-12-20,21:00:00,76,35,41,FMN GV 16 Berchem TOT
54,Posthofbrug 5366,2018-12-20,22:00:00,77,28,49,FMN GV 16 Berchem TOT
54,Posthofbrug 5366,2018-12-20,23:00:00,59,9,50,FMN GV 16 Berchem TOT
54,Posthofbrug 5366,2018-12-21,00:00:00,30,9,21,FMN GV 16 Berchem TOT
54,Posthofbrug 5366,2018-12-21,01:00:00,11,2,9,FMN GV 16 Berchem TOT
54,Posthofbrug 5366,2018-12-21,02:00:00,13,2,11,FMN GV 16 Berchem TOT
54,Posthofbrug 5366,2018-12-21,03:00:00,5,2,3,FMN GV 16 Berchem TOT
54,Posthofbrug 5366,2018-12-21,04:00:00,5,3,2,FMN GV 16 Berchem TOT
54,Posthofbrug 5366,2018-12-21,05:00:00,14,8,6,FMN GV 16 Berchem TOT
54,Posthofbrug 5366,2018-12-21,06:00:00,39,32,7,FMN GV 16 Berchem TOT
54,Posthofbrug 5366,2018-12-21,07:00:00,196,139,57,FMN GV 16 Berchem TOT
54,Posthofbrug 5366,2018-12-21,08:00:00,351,255,96,FMN GV 16 Berchem TOT
54,Posthofbrug 5366,2018-12-21,09:00:00,140,89,51,FMN GV 16 Berchem TOT
54,Posthofbrug 5366,2018-12-21,10:00:00,69,48,21,FMN GV 16 Berchem TOT
54,Posthofbrug 5366,2018-12-21,11:00:00,63,39,24,FMN GV 16 Berchem TOT
54,Posthofbrug 5366,2018-12-21,12:00:00,106,71,35,FMN GV 16 Berchem TOT
54,Posthofbrug 5366,2018-12-21,13:00:00,90,52,38,FMN GV 16 Berchem TOT
54,Posthofbrug 5366,2018-12-21,14:00:00,120,70,50,FMN GV 16 Berchem TOT
54,Posthofbrug 5366,2018-12-21,15:00:00,146,82,64,FMN GV 16 Berchem TOT
54,Posthofbrug 5366,2018-12-21,16:00:00,211,95,116,FMN GV 16 Berchem TOT
54,Posthofbrug 5366,2018-12-21,17:00:00,269,103,166,FMN GV 16 Berchem TOT
54,Posthofbrug 5366,2018-12-21,18:00:00,164,81,83,FMN GV 16 Berchem TOT
54,Posthofbrug 5366,2018-12-21,19:00:00,115,58,57,FMN GV 16 Berchem TOT
54,Posthofbrug 5366,2018-12-21,20:00:00,83,53,30,FMN GV 16 Berchem TOT
54,Posthofbrug 5366,2018-12-21,21:00:00,47,26,21,FMN GV 16 Berchem TOT
54,Posthofbrug 5366,2018-12-21,22:00:00,39,14,25,FMN GV 16 Berchem TOT
54,Posthofbrug 5366,2018-12-21,23:00:00,65,26,39,FMN GV 16 Berchem TOT
54,Posthofbrug 5366,2018-12-22,00:00:00,43,20,23,FMN GV 16 Berchem TOT
54,Posthofbrug 5366,2018-12-22,01:00:00,32,6,26,FMN GV 16 Berchem TOT
54,Posthofbrug 5366,2018-12-22,02:00:00,24,8,16,FMN GV 16 Berchem TOT
54,Posthofbrug 5366,2018-12-22,03:00:00,15,2,13,FMN GV 16 Berchem TOT
54,Posthofbrug 5366,2018-12-22,04:00:00,8,2,6,FMN GV 16 Berchem TOT
54,Posthofbrug 5366,2018-12-22,05:00:00,9,4,5,FMN GV 16 Berchem TOT
54,Posthofbrug 5366,2018-12-22,06:00:00,20,11,9,FMN GV 16 Berchem TOT
54,Posthofbrug 5366,2018-12-22,07:00:00,17,15,2,FMN GV 16 Berchem TOT
54,Posthofbrug 5366,2018-12-22,08:00:00,27,21,6,FMN GV 16 Berchem TOT
54,Posthofbrug 5366,2018-12-22,09:00:00,73,39,34,FMN GV 16 Berchem TOT
54,Posthofbrug 5366,2018-12-22,10:00:00,80,60,20,FMN GV 16 Berchem TOT
54,Posthofbrug 5366,2018-12-22,11:00:00,92,64,28,FMN GV 16 Berchem TOT
54,Posthofbrug 5366,2018-12-22,12:00:00,92,59,33,FMN GV 16 Berchem TOT
54,Posthofbrug 5366,2018-12-22,13:00:00,98,65,33,FMN GV 16 Berchem TOT
54,Posthofbrug 5366,2018-12-22,14:00:00,104,63,41,FMN GV 16 Berchem TOT
54,Posthofbrug 5366,2018-12-22,15:00:00,130,72,58,FMN GV 16 Berchem TOT
54,Posthofbrug 5366,2018-12-22,16:00:00,112,44,68,FMN GV 16 Berchem TOT
54,Posthofbrug 5366,2018-12-22,17:00:00,101,43,58,FMN GV 16 Berchem TOT
54,Posthofbrug 5366,2018-12-22,18:00:00,83,37,46,FMN GV 16 Berchem TOT
54,Posthofbrug 5366,2018-12-22,19:00:00,84,50,34,FMN GV 16 Berchem TOT
54,Posthofbrug 5366,2018-12-22,20:00:00,44,26,18,FMN GV 16 Berchem TOT
54,Posthofbrug 5366,2018-12-22,21:00:00,39,17,22,FMN GV 16 Berchem TOT
54,Posthofbrug 5366,2018-12-22,22:00:00,43,12,31,FMN GV 16 Berchem TOT
54,Posthofbrug 5366,2018-12-22,23:00:00,42,18,24,FMN GV 16 Berchem TOT
54,Posthofbrug 5366,2018-12-23,00:00:00,34,10,24,FMN GV 16 Berchem TOT
54,Posthofbrug 5366,2018-12-23,01:00:00,40,14,26,FMN GV 16 Berchem TOT
54,Posthofbrug 5366,2018-12-23,02:00:00,29,3,26,FMN GV 16 Berchem TOT
54,Posthofbrug 5366,2018-12-23,03:00:00,14,7,7,FMN GV 16 Berchem TOT
54,Posthofbrug 5366,2018-12-23,04:00:00,9,3,6,FMN GV 16 Berchem TOT
54,Posthofbrug 5366,2018-12-23,05:00:00,14,3,11,FMN GV 16 Berchem TOT
54,Posthofbrug 5366,2018-12-23,06:00:00,12,6,6,FMN GV 16 Berchem TOT
54,Posthofbrug 5366,2018-12-23,07:00:00,16,10,6,FMN GV 16 Berchem TOT
54,Posthofbrug 5366,2018-12-23,08:00:00,21,8,13,FMN GV 16 Berchem TOT
54,Posthofbrug 5366,2018-12-23,09:00:00,38,24,14,FMN GV 16 Berchem TOT
54,Posthofbrug 5366,2018-12-23,10:00:00,37,23,14,FMN GV 16 Berchem TOT
54,Posthofbrug 5366,2018-12-23,11:00:00,31,22,9,FMN GV 16 Berchem TOT
54,Posthofbrug 5366,2018-12-23,12:00:00,37,20,17,FMN GV 16 Berchem TOT
54,Posthofbrug 5366,2018-12-23,13:00:00,39,22,17,FMN GV 16 Berchem TOT
54,Posthofbrug 5366,2018-12-23,14:00:00,48,31,17,FMN GV 16 Berchem TOT
54,Posthofbrug 5366,2018-12-23,15:00:00,34,22,12,FMN GV 16 Berchem TOT
54,Posthofbrug 5366,2018-12-23,16:00:00,43,26,17,FMN GV 16 Berchem TOT
54,Posthofbrug 5366,2018-12-23,17:00:00,51,24,27,FMN GV 16 Berchem TOT
54,Posthofbrug 5366,2018-12-23,18:00:00,46,20,26,FMN GV 16 Berchem TOT
54,Posthofbrug 5366,2018-12-23,19:00:00,31,11,20,FMN GV 16 Berchem TOT
54,Posthofbrug 5366,2018-12-23,20:00:00,15,6,9,FMN GV 16 Berchem TOT
54,Posthofbrug 5366,2018-12-23,21:00:00,26,15,11,FMN GV 16 Berchem TOT
54,Posthofbrug 5366,2018-12-23,22:00:00,24,8,16,FMN GV 16 Berchem TOT
54,Posthofbrug 5366,2018-12-23,23:00:00,23,10,13,FMN GV 16 Berchem TOT
54,Posthofbrug 5366,2018-12-24,00:00:00,16,9,7,FMN GV 16 Berchem TOT
54,Posthofbrug 5366,2018-12-24,01:00:00,5,2,3,FMN GV 16 Berchem TOT
54,Posthofbrug 5366,2018-12-24,02:00:00,2,0,2,FMN GV 16 Berchem TOT
54,Posthofbrug 5366,2018-12-24,03:00:00,3,2,1,FMN GV 16 Berchem TOT
54,Posthofbrug 5366,2018-12-24,04:00:00,4,3,1,FMN GV 16 Berchem TOT
54,Posthofbrug 5366,2018-12-24,05:00:00,8,7,1,FMN GV 16 Berchem TOT
54,Posthofbrug 5366,2018-12-24,06:00:00,19,17,2,FMN GV 16 Berchem TOT
54,Posthofbrug 5366,2018-12-24,07:00:00,85,62,23,FMN GV 16 Berchem TOT
54,Posthofbrug 5366,2018-12-24,08:00:00,98,62,36,FMN GV 16 Berchem TOT
54,Posthofbrug 5366,2018-12-24,09:00:00,59,41,18,FMN GV 16 Berchem TOT
54,Posthofbrug 5366,2018-12-24,10:00:00,74,48,26,FMN GV 16 Berchem TOT
54,Posthofbrug 5366,2018-12-24,11:00:00,72,40,32,FMN GV 16 Berchem TOT
54,Posthofbrug 5366,2018-12-24,12:00:00,83,45,38,FMN GV 16 Berchem TOT
54,Posthofbrug 5366,2018-12-24,13:00:00,118,61,57,FMN GV 16 Berchem TOT
54,Posthofbrug 5366,2018-12-24,14:00:00,102,52,50,FMN GV 16 Berchem TOT
54,Posthofbrug 5366,2018-12-24,15:00:00,115,47,68,FMN GV 16 Berchem TOT
54,Posthofbrug 5366,2018-12-24,16:00:00,156,58,98,FMN GV 16 Berchem TOT
54,Posthofbrug 5366,2018-12-24,17:00:00,93,27,66,FMN GV 16 Berchem TOT
54,Posthofbrug 5366,2018-12-24,18:00:00,39,15,24,FMN GV 16 Berchem TOT
54,Posthofbrug 5366,2018-12-24,19:00:00,26,13,13,FMN GV 16 Berchem TOT
54,Posthofbrug 5366,2018-12-24,20:00:00,14,10,4,FMN GV 16 Berchem TOT
54,Posthofbrug 5366,2018-12-24,21:00:00,13,4,9,FMN GV 16 Berchem TOT
54,Posthofbrug 5366,2018-12-24,22:00:00,20,11,9,FMN GV 16 Berchem TOT
54,Posthofbrug 5366,2018-12-24,23:00:00,30,21,9,FMN GV 16 Berchem TOT
54,Posthofbrug 5366,2018-12-25,00:00:00,25,19,6,FMN GV 16 Berchem TOT
54,Posthofbrug 5366,2018-12-25,01:00:00,9,6,3,FMN GV 16 Berchem TOT
54,Posthofbrug 5366,2018-12-25,02:00:00,9,4,5,FMN GV 16 Berchem TOT
54,Posthofbrug 5366,2018-12-25,03:00:00,5,4,1,FMN GV 16 Berchem TOT
54,Posthofbrug 5366,2018-12-25,04:00:00,0,0,0,FMN GV 16 Berchem TOT
54,Posthofbrug 5366,2018-12-25,05:00:00,3,3,0,FMN GV 16 Berchem TOT
54,Posthofbrug 5366,2018-12-25,06:00:00,5,5,0,FMN GV 16 Berchem TOT
54,Posthofbrug 5366,2018-12-25,07:00:00,10,4,6,FMN GV 16 Berchem TOT
54,Posthofbrug 5366,2018-12-25,08:00:00,9,6,3,FMN GV 16 Berchem TOT
54,Posthofbrug 5366,2018-12-25,09:00:00,32,22,10,FMN GV 16 Berchem TOT
54,Posthofbrug 5366,2018-12-25,10:00:00,24,16,8,FMN GV 16 Berchem TOT
54,Posthofbrug 5366,2018-12-25,11:00:00,40,25,15,FMN GV 16 Berchem TOT
54,Posthofbrug 5366,2018-12-25,12:00:00,42,25,17,FMN GV 16 Berchem TOT
54,Posthofbrug 5366,2018-12-25,13:00:00,37,21,16,FMN GV 16 Berchem TOT
54,Posthofbrug 5366,2018-12-25,14:00:00,73,40,33,FMN GV 16 Berchem TOT
54,Posthofbrug 5366,2018-12-25,15:00:00,58,39,19,FMN GV 16 Berchem TOT
54,Posthofbrug 5366,2018-12-25,16:00:00,40,20,20,FMN GV 16 Berchem TOT
54,Posthofbrug 5366,2018-12-25,17:00:00,38,13,25,FMN GV 16 Berchem TOT
54,Posthofbrug 5366,2018-12-25,18:00:00,30,18,12,FMN GV 16 Berchem TOT
54,Posthofbrug 5366,2018-12-25,19:00:00,36,19,17,FMN GV 16 Berchem TOT
54,Posthofbrug 5366,2018-12-25,20:00:00,25,16,9,FMN GV 16 Berchem TOT
54,Posthofbrug 5366,2018-12-25,21:00:00,19,13,6,FMN GV 16 Berchem TOT
54,Posthofbrug 5366,2018-12-25,22:00:00,26,13,13,FMN GV 16 Berchem TOT
54,Posthofbrug 5366,2018-12-25,23:00:00,17,12,5,FMN GV 16 Berchem TOT
54,Posthofbrug 5366,2018-12-26,00:00:00,17,9,8,FMN GV 16 Berchem TOT
54,Posthofbrug 5366,2018-12-26,01:00:00,8,3,5,FMN GV 16 Berchem TOT
54,Posthofbrug 5366,2018-12-26,02:00:00,1,0,1,FMN GV 16 Berchem TOT
54,Posthofbrug 5366,2018-12-26,03:00:00,13,4,9,FMN GV 16 Berchem TOT
54,Posthofbrug 5366,2018-12-26,04:00:00,4,2,2,FMN GV 16 Berchem TOT
54,Posthofbrug 5366,2018-12-26,05:00:00,11,9,2,FMN GV 16 Berchem TOT
54,Posthofbrug 5366,2018-12-26,06:00:00,24,19,5,FMN GV 16 Berchem TOT
54,Posthofbrug 5366,2018-12-26,07:00:00,64,49,15,FMN GV 16 Berchem TOT
54,Posthofbrug 5366,2018-12-26,08:00:00,86,54,32,FMN GV 16 Berchem TOT
54,Posthofbrug 5366,2018-12-26,09:00:00,57,39,18,FMN GV 16 Berchem TOT
54,Posthofbrug 5366,2018-12-26,10:00:00,71,59,12,FMN GV 16 Berchem TOT
54,Posthofbrug 5366,2018-12-26,11:00:00,72,47,25,FMN GV 16 Berchem TOT
54,Posthofbrug 5366,2018-12-26,12:00:00,69,43,26,FMN GV 16 Berchem TOT
54,Posthofbrug 5366,2018-12-26,13:00:00,69,43,26,FMN GV 16 Berchem TOT
54,Posthofbrug 5366,2018-12-26,14:00:00,79,49,30,FMN GV 16 Berchem TOT
54,Posthofbrug 5366,2018-12-26,15:00:00,82,40,42,FMN GV 16 Berchem TOT
54,Posthofbrug 5366,2018-12-26,16:00:00,121,53,68,FMN GV 16 Berchem TOT
54,Posthofbrug 5366,2018-12-26,17:00:00,120,38,82,FMN GV 16 Berchem TOT
54,Posthofbrug 5366,2018-12-26,18:00:00,103,32,71,FMN GV 16 Berchem TOT
54,Posthofbrug 5366,2018-12-26,19:00:00,64,32,32,FMN GV 16 Berchem TOT
54,Posthofbrug 5366,2018-12-26,20:00:00,46,20,26,FMN GV 16 Berchem TOT
54,Posthofbrug 5366,2018-12-26,21:00:00,28,11,17,FMN GV 16 Berchem TOT
54,Posthofbrug 5366,2018-12-26,22:00:00,33,7,26,FMN GV 16 Berchem TOT
54,Posthofbrug 5366,2018-12-26,23:00:00,24,7,17,FMN GV 16 Berchem TOT
54,Posthofbrug 5366,2018-12-27,00:00:00,19,6,13,FMN GV 16 Berchem TOT
54,Posthofbrug 5366,2018-12-27,01:00:00,4,1,3,FMN GV 16 Berchem TOT
54,Posthofbrug 5366,2018-12-27,02:00:00,4,2,2,FMN GV 16 Berchem TOT
54,Posthofbrug 5366,2018-12-27,03:00:00,2,1,1,FMN GV 16 Berchem TOT
54,Posthofbrug 5366,2018-12-27,04:00:00,3,1,2,FMN GV 16 Berchem TOT
54,Posthofbrug 5366,2018-12-27,05:00:00,10,7,3,FMN GV 16 Berchem TOT
54,Posthofbrug 5366,2018-12-27,06:00:00,39,34,5,FMN GV 16 Berchem TOT
54,Posthofbrug 5366,2018-12-27,07:00:00,119,87,32,FMN GV 16 Berchem TOT
54,Posthofbrug 5366,2018-12-27,08:00:00,142,88,54,FMN GV 16 Berchem TOT
54,Posthofbrug 5366,2018-12-27,09:00:00,96,68,28,FMN GV 16 Berchem TOT
54,Posthofbrug 5366,2018-12-27,10:00:00,72,52,20,FMN GV 16 Berchem TOT
54,Posthofbrug 5366,2018-12-27,11:00:00,81,59,22,FMN GV 16 Berchem TOT
54,Posthofbrug 5366,2018-12-27,12:00:00,83,40,43,FMN GV 16 Berchem TOT
54,Posthofbrug 5366,2018-12-27,13:00:00,95,60,35,FMN GV 16 Berchem TOT
54,Posthofbrug 5366,2018-12-27,14:00:00,96,58,38,FMN GV 16 Berchem TOT
54,Posthofbrug 5366,2018-12-27,15:00:00,95,42,53,FMN GV 16 Berchem TOT
54,Posthofbrug 5366,2018-12-27,16:00:00,176,84,92,FMN GV 16 Berchem TOT
54,Posthofbrug 5366,2018-12-27,17:00:00,189,86,103,FMN GV 16 Berchem TOT
54,Posthofbrug 5366,2018-12-27,18:00:00,133,62,71,FMN GV 16 Berchem TOT
54,Posthofbrug 5366,2018-12-27,19:00:00,86,47,39,FMN GV 16 Berchem TOT
54,Posthofbrug 5366,2018-12-27,20:00:00,67,34,33,FMN GV 16 Berchem TOT
54,Posthofbrug 5366,2018-12-27,21:00:00,41,18,23,FMN GV 16 Berchem TOT
54,Posthofbrug 5366,2018-12-27,22:00:00,44,19,25,FMN GV 16 Berchem TOT
54,Posthofbrug 5366,2018-12-27,23:00:00,34,10,24,FMN GV 16 Berchem TOT
54,Posthofbrug 5366,2018-12-28,00:00:00,26,9,17,FMN GV 16 Berchem TOT
54,Posthofbrug 5366,2018-12-28,01:00:00,19,2,17,FMN GV 16 Berchem TOT
54,Posthofbrug 5366,2018-12-28,02:00:00,6,0,6,FMN GV 16 Berchem TOT
54,Posthofbrug 5366,2018-12-28,03:00:00,2,1,1,FMN GV 16 Berchem TOT
54,Posthofbrug 5366,2018-12-28,04:00:00,9,4,5,FMN GV 16 Berchem TOT
54,Posthofbrug 5366,2018-12-28,05:00:00,9,5,4,FMN GV 16 Berchem TOT
54,Posthofbrug 5366,2018-12-28,06:00:00,34,28,6,FMN GV 16 Berchem TOT
54,Posthofbrug 5366,2018-12-28,07:00:00,95,61,34,FMN GV 16 Berchem TOT
54,Posthofbrug 5366,2018-12-28,08:00:00,149,90,59,FMN GV 16 Berchem TOT
54,Posthofbrug 5366,2018-12-28,09:00:00,81,58,23,FMN GV 16 Berchem TOT
54,Posthofbrug 5366,2018-12-28,10:00:00,79,54,25,FMN GV 16 Berchem TOT
54,Posthofbrug 5366,2018-12-28,11:00:00,57,36,21,FMN GV 16 Berchem TOT
54,Posthofbrug 5366,2018-12-28,12:00:00,60,42,18,FMN GV 16 Berchem TOT
54,Posthofbrug 5366,2018-12-28,13:00:00,57,33,24,FMN GV 16 Berchem TOT
54,Posthofbrug 5366,2018-12-28,14:00:00,95,62,33,FMN GV 16 Berchem TOT
54,Posthofbrug 5366,2018-12-28,15:00:00,106,44,62,FMN GV 16 Berchem TOT
54,Posthofbrug 5366,2018-12-28,16:00:00,124,62,62,FMN GV 16 Berchem TOT
54,Posthofbrug 5366,2018-12-28,17:00:00,195,87,108,FMN GV 16 Berchem TOT
54,Posthofbrug 5366,2018-12-28,18:00:00,116,49,67,FMN GV 16 Berchem TOT
54,Posthofbrug 5366,2018-12-28,19:00:00,61,31,30,FMN GV 16 Berchem TOT
54,Posthofbrug 5366,2018-12-28,20:00:00,50,24,26,FMN GV 16 Berchem TOT
54,Posthofbrug 5366,2018-12-28,21:00:00,45,17,28,FMN GV 16 Berchem TOT
54,Posthofbrug 5366,2018-12-28,22:00:00,32,11,21,FMN GV 16 Berchem TOT
54,Posthofbrug 5366,2018-12-28,23:00:00,35,18,17,FMN GV 16 Berchem TOT
54,Posthofbrug 5366,2018-12-29,00:00:00,29,8,21,FMN GV 16 Berchem TOT
54,Posthofbrug 5366,2018-12-29,01:00:00,11,1,10,FMN GV 16 Berchem TOT
54,Posthofbrug 5366,2018-12-29,02:00:00,11,4,7,FMN GV 16 Berchem TOT
54,Posthofbrug 5366,2018-12-29,03:00:00,19,8,11,FMN GV 16 Berchem TOT
54,Posthofbrug 5366,2018-12-29,04:00:00,19,10,9,FMN GV 16 Berchem TOT
54,Posthofbrug 5366,2018-12-29,05:00:00,4,2,2,FMN GV 16 Berchem TOT
54,Posthofbrug 5366,2018-12-29,06:00:00,12,10,2,FMN GV 16 Berchem TOT
54,Posthofbrug 5366,2018-12-29,07:00:00,13,10,3,FMN GV 16 Berchem TOT
54,Posthofbrug 5366,2018-12-29,08:00:00,20,13,7,FMN GV 16 Berchem TOT
54,Posthofbrug 5366,2018-12-29,09:00:00,46,30,16,FMN GV 16 Berchem TOT
54,Posthofbrug 5366,2018-12-29,10:00:00,44,31,13,FMN GV 16 Berchem TOT
54,Posthofbrug 5366,2018-12-29,11:00:00,52,35,17,FMN GV 16 Berchem TOT
54,Posthofbrug 5366,2018-12-29,12:00:00,86,46,40,FMN GV 16 Berchem TOT
54,Posthofbrug 5366,2018-12-29,13:00:00,90,55,35,FMN GV 16 Berchem TOT
54,Posthofbrug 5366,2018-12-29,14:00:00,81,52,29,FMN GV 16 Berchem TOT
54,Posthofbrug 5366,2018-12-29,15:00:00,69,41,28,FMN GV 16 Berchem TOT
54,Posthofbrug 5366,2018-12-29,16:00:00,88,44,44,FMN GV 16 Berchem TOT
54,Posthofbrug 5366,2018-12-29,17:00:00,74,30,44,FMN GV 16 Berchem TOT
54,Posthofbrug 5366,2018-12-29,18:00:00,62,28,34,FMN GV 16 Berchem TOT
54,Posthofbrug 5366,2018-12-29,19:00:00,49,25,24,FMN GV 16 Berchem TOT
54,Posthofbrug 5366,2018-12-29,20:00:00,33,14,19,FMN GV 16 Berchem TOT
54,Posthofbrug 5366,2018-12-29,21:00:00,26,11,15,FMN GV 16 Berchem TOT
54,Posthofbrug 5366,2018-12-29,22:00:00,21,4,17,FMN GV 16 Berchem TOT
54,Posthofbrug 5366,2018-12-29,23:00:00,34,13,21,FMN GV 16 Berchem TOT
54,Posthofbrug 5366,2018-12-30,00:00:00,20,5,15,FMN GV 16 Berchem TOT
54,Posthofbrug 5366,2018-12-30,01:00:00,24,9,15,FMN GV 16 Berchem TOT
54,Posthofbrug 5366,2018-12-30,02:00:00,19,6,13,FMN GV 16 Berchem TOT
54,Posthofbrug 5366,2018-12-30,03:00:00,11,6,5,FMN GV 16 Berchem TOT
54,Posthofbrug 5366,2018-12-30,04:00:00,5,2,3,FMN GV 16 Berchem TOT
54,Posthofbrug 5366,2018-12-30,05:00:00,2,2,0,FMN GV 16 Berchem TOT
54,Posthofbrug 5366,2018-12-30,06:00:00,8,6,2,FMN GV 16 Berchem TOT
54,Posthofbrug 5366,2018-12-30,07:00:00,10,4,6,FMN GV 16 Berchem TOT
54,Posthofbrug 5366,2018-12-30,08:00:00,18,9,9,FMN GV 16 Berchem TOT
54,Posthofbrug 5366,2018-12-30,09:00:00,40,19,21,FMN GV 16 Berchem TOT
54,Posthofbrug 5366,2018-12-30,10:00:00,57,33,24,FMN GV 16 Berchem TOT
54,Posthofbrug 5366,2018-12-30,11:00:00,57,39,18,FMN GV 16 Berchem TOT
54,Posthofbrug 5366,2018-12-30,12:00:00,47,24,23,FMN GV 16 Berchem TOT
54,Posthofbrug 5366,2018-12-30,13:00:00,72,47,25,FMN GV 16 Berchem TOT
54,Posthofbrug 5366,2018-12-30,14:00:00,80,52,28,FMN GV 16 Berchem TOT
54,Posthofbrug 5366,2018-12-30,15:00:00,65,44,21,FMN GV 16 Berchem TOT
54,Posthofbrug 5366,2018-12-30,16:00:00,88,45,43,FMN GV 16 Berchem TOT
54,Posthofbrug 5366,2018-12-30,17:00:00,53,24,29,FMN GV 16 Berchem TOT
54,Posthofbrug 5366,2018-12-30,18:00:00,62,19,43,FMN GV 16 Berchem TOT
54,Posthofbrug 5366,2018-12-30,19:00:00,37,22,15,FMN GV 16 Berchem TOT
54,Posthofbrug 5366,2018-12-30,20:00:00,25,12,13,FMN GV 16 Berchem TOT
54,Posthofbrug 5366,2018-12-30,21:00:00,25,11,14,FMN GV 16 Berchem TOT
54,Posthofbrug 5366,2018-12-30,22:00:00,23,8,15,FMN GV 16 Berchem TOT
54,Posthofbrug 5366,2018-12-30,23:00:00,11,6,5,FMN GV 16 Berchem TOT
54,Posthofbrug 5366,2018-12-31,00:00:00,29,8,21,FMN GV 16 Berchem TOT
54,Posthofbrug 5366,2018-12-31,01:00:00,4,1,3,FMN GV 16 Berchem TOT
54,Posthofbrug 5366,2018-12-31,02:00:00,5,1,4,FMN GV 16 Berchem TOT
54,Posthofbrug 5366,2018-12-31,03:00:00,1,0,1,FMN GV 16 Berchem TOT
54,Posthofbrug 5366,2018-12-31,04:00:00,9,9,0,FMN GV 16 Berchem TOT
54,Posthofbrug 5366,2018-12-31,05:00:00,8,5,3,FMN GV 16 Berchem TOT
54,Posthofbrug 5366,2018-12-31,06:00:00,23,15,8,FMN GV 16 Berchem TOT
54,Posthofbrug 5366,2018-12-31,07:00:00,65,43,22,FMN GV 16 Berchem TOT
54,Posthofbrug 5366,2018-12-31,08:00:00,90,60,30,FMN GV 16 Berchem TOT
54,Posthofbrug 5366,2018-12-31,09:00:00,59,40,19,FMN GV 16 Berchem TOT
54,Posthofbrug 5366,2018-12-31,10:00:00,58,32,26,FMN GV 16 Berchem TOT
54,Posthofbrug 5366,2018-12-31,11:00:00,68,46,22,FMN GV 16 Berchem TOT
54,Posthofbrug 5366,2018-12-31,12:00:00,66,40,26,FMN GV 16 Berchem TOT
54,Posthofbrug 5366,2018-12-31,13:00:00,84,50,34,FMN GV 16 Berchem TOT
54,Posthofbrug 5366,2018-12-31,14:00:00,60,35,25,FMN GV 16 Berchem TOT
54,Posthofbrug 5366,2018-12-31,15:00:00,118,66,52,FMN GV 16 Berchem TOT
54,Posthofbrug 5366,2018-12-31,16:00:00,118,67,51,FMN GV 16 Berchem TOT
54,Posthofbrug 5366,2018-12-31,17:00:00,96,51,45,FMN GV 16 Berchem TOT
54,Posthofbrug 5366,2018-12-31,18:00:00,108,51,57,FMN GV 16 Berchem TOT
54,Posthofbrug 5366,2018-12-31,19:00:00,68,43,25,FMN GV 16 Berchem TOT
54,Posthofbrug 5366,2018-12-31,20:00:00,24,14,10,FMN GV 16 Berchem TOT
54,Posthofbrug 5366,2018-12-31,21:00:00,11,7,4,FMN GV 16 Berchem TOT
54,Posthofbrug 5366,2018-12-31,22:00:00,22,18,4,FMN GV 16 Berchem TOT
54,Posthofbrug 5366,2018-12-31,23:00:00,41,34,7,FMN GV 16 Berchem TOT
54,Posthofbrug 5366,2019-01-01,00:00:00,72,38,34,FMN GV 16 Berchem TOT
54,Posthofbrug 5366,2019-01-01,01:00:00,70,35,35,FMN GV 16 Berchem TOT
54,Posthofbrug 5366,2019-01-01,02:00:00,83,48,35,FMN GV 16 Berchem TOT
54,Posthofbrug 5366,2019-01-01,03:00:00,51,24,27,FMN GV 16 Berchem TOT
54,Posthofbrug 5366,2019-01-01,04:00:00,33,12,21,FMN GV 16 Berchem TOT
54,Posthofbrug 5366,2019-01-01,05:00:00,43,17,26,FMN GV 16 Berchem TOT
54,Posthofbrug 5366,2019-01-01,06:00:00,31,8,23,FMN GV 16 Berchem TOT
54,Posthofbrug 5366,2019-01-01,07:00:00,18,4,14,FMN GV 16 Berchem TOT
54,Posthofbrug 5366,2019-01-01,08:00:00,5,2,3,FMN GV 16 Berchem TOT
54,Posthofbrug 5366,2019-01-01,09:00:00,10,6,4,FMN GV 16 Berchem TOT
54,Posthofbrug 5366,2019-01-01,10:00:00,20,12,8,FMN GV 16 Berchem TOT
54,Posthofbrug 5366,2019-01-01,11:00:00,21,14,7,FMN GV 16 Berchem TOT
54,Posthofbrug 5366,2019-01-01,12:00:00,27,10,17,FMN GV 16 Berchem TOT
54,Posthofbrug 5366,2019-01-01,13:00:00,24,8,16,FMN GV 16 Berchem TOT
54,Posthofbrug 5366,2019-01-01,14:00:00,32,13,19,FMN GV 16 Berchem TOT
54,Posthofbrug 5366,2019-01-01,15:00:00,36,23,13,FMN GV 16 Berchem TOT
54,Posthofbrug 5366,2019-01-01,16:00:00,42,22,20,FMN GV 16 Berchem TOT
54,Posthofbrug 5366,2019-01-01,17:00:00,47,15,32,FMN GV 16 Berchem TOT
54,Posthofbrug 5366,2019-01-01,18:00:00,37,14,23,FMN GV 16 Berchem TOT
54,Posthofbrug 5366,2019-01-01,19:00:00,24,13,11,FMN GV 16 Berchem TOT
54,Posthofbrug 5366,2019-01-01,20:00:00,18,10,8,FMN GV 16 Berchem TOT
54,Posthofbrug 5366,2019-01-01,21:00:00,19,12,7,FMN GV 16 Berchem TOT
54,Posthofbrug 5366,2019-01-01,22:00:00,9,7,2,FMN GV 16 Berchem TOT
54,Posthofbrug 5366,2019-01-01,23:00:00,11,4,7,FMN GV 16 Berchem TOT
54,Posthofbrug 5366,2019-01-02,00:00:00,2,1,1,FMN GV 16 Berchem TOT
54,Posthofbrug 5366,2019-01-02,01:00:00,2,0,2,FMN GV 16 Berchem TOT
54,Posthofbrug 5366,2019-01-02,02:00:00,0,0,0,FMN GV 16 Berchem TOT
54,Posthofbrug 5366,2019-01-02,03:00:00,3,1,2,FMN GV 16 Berchem TOT
54,Posthofbrug 5366,2019-01-02,04:00:00,8,5,3,FMN GV 16 Berchem TOT
54,Posthofbrug 5366,2019-01-02,05:00:00,13,12,1,FMN GV 16 Berchem TOT
54,Posthofbrug 5366,2019-01-02,06:00:00,51,43,8,FMN GV 16 Berchem TOT
54,Posthofbrug 5366,2019-01-02,07:00:00,164,109,55,FMN GV 16 Berchem TOT
54,Posthofbrug 5366,2019-01-02,08:00:00,240,146,94,FMN GV 16 Berchem TOT
54,Posthofbrug 5366,2019-01-02,09:00:00,134,92,42,FMN GV 16 Berchem TOT
54,Posthofbrug 5366,2019-01-02,10:00:00,65,46,19,FMN GV 16 Berchem TOT
54,Posthofbrug 5366,2019-01-02,11:00:00,67,38,29,FMN GV 16 Berchem TOT
54,Posthofbrug 5366,2019-01-02,12:00:00,91,58,33,FMN GV 16 Berchem TOT
54,Posthofbrug 5366,2019-01-02,13:00:00,84,41,43,FMN GV 16 Berchem TOT
54,Posthofbrug 5366,2019-01-02,14:00:00,85,40,45,FMN GV 16 Berchem TOT
54,Posthofbrug 5366,2019-01-02,15:00:00,89,47,42,FMN GV 16 Berchem TOT
54,Posthofbrug 5366,2019-01-02,16:00:00,179,102,77,FMN GV 16 Berchem TOT
54,Posthofbrug 5366,2019-01-02,17:00:00,277,134,143,FMN GV 16 Berchem TOT
54,Posthofbrug 5366,2019-01-02,18:00:00,177,73,104,FMN GV 16 Berchem TOT
54,Posthofbrug 5366,2019-01-02,19:00:00,81,37,44,FMN GV 16 Berchem TOT
54,Posthofbrug 5366,2019-01-02,20:00:00,47,25,22,FMN GV 16 Berchem TOT
54,Posthofbrug 5366,2019-01-02,21:00:00,48,20,28,FMN GV 16 Berchem TOT
54,Posthofbrug 5366,2019-01-02,22:00:00,33,9,24,FMN GV 16 Berchem TOT
54,Posthofbrug 5366,2019-01-02,23:00:00,12,7,5,FMN GV 16 Berchem TOT
54,Posthofbrug 5366,2019-01-03,00:00:00,16,5,11,FMN GV 16 Berchem TOT
54,Posthofbrug 5366,2019-01-03,01:00:00,11,0,11,FMN GV 16 Berchem TOT
54,Posthofbrug 5366,2019-01-03,02:00:00,5,4,1,FMN GV 16 Berchem TOT
54,Posthofbrug 5366,2019-01-03,03:00:00,2,1,1,FMN GV 16 Berchem TOT
54,Posthofbrug 5366,2019-01-03,04:00:00,8,5,3,FMN GV 16 Berchem TOT
54,Posthofbrug 5366,2019-01-03,05:00:00,10,7,3,FMN GV 16 Berchem TOT
54,Posthofbrug 5366,2019-01-03,06:00:00,66,56,10,FMN GV 16 Berchem TOT
54,Posthofbrug 5366,2019-01-03,07:00:00,259,184,75,FMN GV 16 Berchem TOT
54,Posthofbrug 5366,2019-01-03,08:00:00,333,218,115,FMN GV 16 Berchem TOT
54,Posthofbrug 5366,2019-01-03,09:00:00,144,93,51,FMN GV 16 Berchem TOT
54,Posthofbrug 5366,2019-01-03,10:00:00,79,59,20,FMN GV 16 Berchem TOT
54,Posthofbrug 5366,2019-01-03,11:00:00,76,41,35,FMN GV 16 Berchem TOT
54,Posthofbrug 5366,2019-01-03,12:00:00,65,36,29,FMN GV 16 Berchem TOT
54,Posthofbrug 5366,2019-01-03,13:00:00,91,49,42,FMN GV 16 Berchem TOT
54,Posthofbrug 5366,2019-01-03,14:00:00,94,55,39,FMN GV 16 Berchem TOT
54,Posthofbrug 5366,2019-01-03,15:00:00,91,50,41,FMN GV 16 Berchem TOT
54,Posthofbrug 5366,2019-01-03,16:00:00,237,103,134,FMN GV 16 Berchem TOT
54,Posthofbrug 5366,2019-01-03,17:00:00,358,144,214,FMN GV 16 Berchem TOT
54,Posthofbrug 5366,2019-01-03,18:00:00,191,80,111,FMN GV 16 Berchem TOT
54,Posthofbrug 5366,2019-01-03,19:00:00,106,49,57,FMN GV 16 Berchem TOT
54,Posthofbrug 5366,2019-01-03,20:00:00,64,32,32,FMN GV 16 Berchem TOT
54,Posthofbrug 5366,2019-01-03,21:00:00,51,16,35,FMN GV 16 Berchem TOT
54,Posthofbrug 5366,2019-01-03,22:00:00,43,21,22,FMN GV 16 Berchem TOT
54,Posthofbrug 5366,2019-01-03,23:00:00,26,11,15,FMN GV 16 Berchem TOT
54,Posthofbrug 5366,2019-01-04,00:00:00,13,3,10,FMN GV 16 Berchem TOT
54,Posthofbrug 5366,2019-01-04,01:00:00,8,2,6,FMN GV 16 Berchem TOT
54,Posthofbrug 5366,2019-01-04,02:00:00,4,0,4,FMN GV 16 Berchem TOT
54,Posthofbrug 5366,2019-01-04,03:00:00,4,2,2,FMN GV 16 Berchem TOT
54,Posthofbrug 5366,2019-01-04,04:00:00,6,5,1,FMN GV 16 Berchem TOT
54,Posthofbrug 5366,2019-01-04,05:00:00,8,4,4,FMN GV 16 Berchem TOT
54,Posthofbrug 5366,2019-01-04,06:00:00,60,48,12,FMN GV 16 Berchem TOT
54,Posthofbrug 5366,2019-01-04,07:00:00,230,156,74,FMN GV 16 Berchem TOT
54,Posthofbrug 5366,2019-01-04,08:00:00,282,177,105,FMN GV 16 Berchem TOT
54,Posthofbrug 5366,2019-01-04,09:00:00,152,100,52,FMN GV 16 Berchem TOT
54,Posthofbrug 5366,2019-01-04,10:00:00,93,61,32,FMN GV 16 Berchem TOT
54,Posthofbrug 5366,2019-01-04,11:00:00,104,77,27,FMN GV 16 Berchem TOT
54,Posthofbrug 5366,2019-01-04,12:00:00,89,56,33,FMN GV 16 Berchem TOT
54,Posthofbrug 5366,2019-01-04,13:00:00,108,61,47,FMN GV 16 Berchem TOT
54,Posthofbrug 5366,2019-01-04,14:00:00,93,43,50,FMN GV 16 Berchem TOT
54,Posthofbrug 5366,2019-01-04,15:00:00,100,56,44,FMN GV 16 Berchem TOT
54,Posthofbrug 5366,2019-01-04,16:00:00,248,123,125,FMN GV 16 Berchem TOT
54,Posthofbrug 5366,2019-01-04,17:00:00,294,128,166,FMN GV 16 Berchem TOT
54,Posthofbrug 5366,2019-01-04,18:00:00,183,84,99,FMN GV 16 Berchem TOT
54,Posthofbrug 5366,2019-01-04,19:00:00,86,34,52,FMN GV 16 Berchem TOT
54,Posthofbrug 5366,2019-01-04,20:00:00,78,42,36,FMN GV 16 Berchem TOT
54,Posthofbrug 5366,2019-01-04,21:00:00,66,27,39,FMN GV 16 Berchem TOT
54,Posthofbrug 5366,2019-01-04,22:00:00,49,15,34,FMN GV 16 Berchem TOT
54,Posthofbrug 5366,2019-01-04,23:00:00,44,17,27,FMN GV 16 Berchem TOT
54,Posthofbrug 5366,2019-01-05,00:00:00,30,10,20,FMN GV 16 Berchem TOT
54,Posthofbrug 5366,2019-01-05,01:00:00,17,5,12,FMN GV 16 Berchem TOT
54,Posthofbrug 5366,2019-01-05,02:00:00,8,2,6,FMN GV 16 Berchem TOT
54,Posthofbrug 5366,2019-01-05,03:00:00,6,2,4,FMN GV 16 Berchem TOT
54,Posthofbrug 5366,2019-01-05,04:00:00,5,2,3,FMN GV 16 Berchem TOT
54,Posthofbrug 5366,2019-01-05,05:00:00,11,6,5,FMN GV 16 Berchem TOT
54,Posthofbrug 5366,2019-01-05,06:00:00,14,8,6,FMN GV 16 Berchem TOT
54,Posthofbrug 5366,2019-01-05,07:00:00,9,7,2,FMN GV 16 Berchem TOT
54,Posthofbrug 5366,2019-01-05,08:00:00,25,14,11,FMN GV 16 Berchem TOT
54,Posthofbrug 5366,2019-01-05,09:00:00,64,42,22,FMN GV 16 Berchem TOT
54,Posthofbrug 5366,2019-01-05,10:00:00,66,44,22,FMN GV 16 Berchem TOT
54,Posthofbrug 5366,2019-01-05,11:00:00,52,38,14,FMN GV 16 Berchem TOT
54,Posthofbrug 5366,2019-01-05,12:00:00,53,38,15,FMN GV 16 Berchem TOT
54,Posthofbrug 5366,2019-01-05,13:00:00,67,47,20,FMN GV 16 Berchem TOT
54,Posthofbrug 5366,2019-01-05,14:00:00,59,28,31,FMN GV 16 Berchem TOT
54,Posthofbrug 5366,2019-01-05,15:00:00,58,33,25,FMN GV 16 Berchem TOT
54,Posthofbrug 5366,2019-01-05,16:00:00,75,28,47,FMN GV 16 Berchem TOT
54,Posthofbrug 5366,2019-01-05,17:00:00,56,26,30,FMN GV 16 Berchem TOT
54,Posthofbrug 5366,2019-01-05,18:00:00,71,35,36,FMN GV 16 Berchem TOT
54,Posthofbrug 5366,2019-01-05,19:00:00,68,43,25,FMN GV 16 Berchem TOT
54,Posthofbrug 5366,2019-01-05,20:00:00,30,20,10,FMN GV 16 Berchem TOT
54,Posthofbrug 5366,2019-01-05,21:00:00,24,12,12,FMN GV 16 Berchem TOT
54,Posthofbrug 5366,2019-01-05,22:00:00,32,17,15,FMN GV 16 Berchem TOT
54,Posthofbrug 5366,2019-01-05,23:00:00,36,8,28,FMN GV 16 Berchem TOT
54,Posthofbrug 5366,2019-01-06,00:00:00,20,7,13,FMN GV 16 Berchem TOT
54,Posthofbrug 5366,2019-01-06,01:00:00,16,6,10,FMN GV 16 Berchem TOT
54,Posthofbrug 5366,2019-01-06,02:00:00,17,4,13,FMN GV 16 Berchem TOT
54,Posthofbrug 5366,2019-01-06,03:00:00,12,1,11,FMN GV 16 Berchem TOT
54,Posthofbrug 5366,2019-01-06,04:00:00,3,1,2,FMN GV 16 Berchem TOT
54,Posthofbrug 5366,2019-01-06,05:00:00,8,5,3,FMN GV 16 Berchem TOT
54,Posthofbrug 5366,2019-01-06,06:00:00,11,6,5,FMN GV 16 Berchem TOT
54,Posthofbrug 5366,2019-01-06,07:00:00,11,7,4,FMN GV 16 Berchem TOT
54,Posthofbrug 5366,2019-01-06,08:00:00,18,8,10,FMN GV 16 Berchem TOT
54,Posthofbrug 5366,2019-01-06,09:00:00,49,32,17,FMN GV 16 Berchem TOT
54,Posthofbrug 5366,2019-01-06,10:00:00,43,32,11,FMN GV 16 Berchem TOT
54,Posthofbrug 5366,2019-01-06,11:00:00,67,42,25,FMN GV 16 Berchem TOT
54,Posthofbrug 5366,2019-01-06,12:00:00,77,46,31,FMN GV 16 Berchem TOT
54,Posthofbrug 5366,2019-01-06,13:00:00,68,36,32,FMN GV 16 Berchem TOT
54,Posthofbrug 5366,2019-01-06,14:00:00,72,42,30,FMN GV 16 Berchem TOT
54,Posthofbrug 5366,2019-01-06,15:00:00,75,34,41,FMN GV 16 Berchem TOT
54,Posthofbrug 5366,2019-01-06,16:00:00,85,55,30,FMN GV 16 Berchem TOT
54,Posthofbrug 5366,2019-01-06,17:00:00,72,28,44,FMN GV 16 Berchem TOT
54,Posthofbrug 5366,2019-01-06,18:00:00,57,19,38,FMN GV 16 Berchem TOT
54,Posthofbrug 5366,2019-01-06,19:00:00,48,22,26,FMN GV 16 Berchem TOT
54,Posthofbrug 5366,2019-01-06,20:00:00,26,11,15,FMN GV 16 Berchem TOT
54,Posthofbrug 5366,2019-01-06,21:00:00,22,10,12,FMN GV 16 Berchem TOT
54,Posthofbrug 5366,2019-01-06,22:00:00,17,7,10,FMN GV 16 Berchem TOT
54,Posthofbrug 5366,2019-01-06,23:00:00,8,4,4,FMN GV 16 Berchem TOT
54,Posthofbrug 5366,2019-01-07,00:00:00,3,2,1,FMN GV 16 Berchem TOT
54,Posthofbrug 5366,2019-01-07,01:00:00,2,0,2,FMN GV 16 Berchem TOT
54,Posthofbrug 5366,2019-01-07,02:00:00,0,0,0,FMN GV 16 Berchem TOT
54,Posthofbrug 5366,2019-01-07,03:00:00,2,2,0,FMN GV 16 Berchem TOT
54,Posthofbrug 5366,2019-01-07,04:00:00,6,4,2,FMN GV 16 Berchem TOT
54,Posthofbrug 5366,2019-01-07,05:00:00,14,11,3,FMN GV 16 Berchem TOT
54,Posthofbrug 5366,2019-01-07,06:00:00,117,91,26,FMN GV 16 Berchem TOT
54,Posthofbrug 5366,2019-01-07,07:00:00,471,323,148,FMN GV 16 Berchem TOT
54,Posthofbrug 5366,2019-01-07,08:00:00,700,492,208,FMN GV 16 Berchem TOT
54,Posthofbrug 5366,2019-01-07,09:00:00,212,147,65,FMN GV 16 Berchem TOT
54,Posthofbrug 5366,2019-01-07,10:00:00,95,65,30,FMN GV 16 Berchem TOT
54,Posthofbrug 5366,2019-01-07,11:00:00,86,49,37,FMN GV 16 Berchem TOT
54,Posthofbrug 5366,2019-01-07,12:00:00,109,67,42,FMN GV 16 Berchem TOT
54,Posthofbrug 5366,2019-01-07,13:00:00,90,55,35,FMN GV 16 Berchem TOT
54,Posthofbrug 5366,2019-01-07,14:00:00,97,49,48,FMN GV 16 Berchem TOT
54,Posthofbrug 5366,2019-01-07,15:00:00,197,95,102,FMN GV 16 Berchem TOT
54,Posthofbrug 5366,2019-01-07,16:00:00,402,175,227,FMN GV 16 Berchem TOT
54,Posthofbrug 5366,2019-01-07,17:00:00,533,203,330,FMN GV 16 Berchem TOT
54,Posthofbrug 5366,2019-01-07,18:00:00,310,98,212,FMN GV 16 Berchem TOT
54,Posthofbrug 5366,2019-01-07,19:00:00,129,69,60,FMN GV 16 Berchem TOT
54,Posthofbrug 5366,2019-01-07,20:00:00,68,37,31,FMN GV 16 Berchem TOT
54,Posthofbrug 5366,2019-01-07,21:00:00,50,23,27,FMN GV 16 Berchem TOT
54,Posthofbrug 5366,2019-01-07,22:00:00,44,21,23,FMN GV 16 Berchem TOT
54,Posthofbrug 5366,2019-01-07,23:00:00,27,10,17,FMN GV 16 Berchem TOT
54,Posthofbrug 5366,2019-01-08,00:00:00,9,5,4,FMN GV 16 Berchem TOT
54,Posthofbrug 5366,2019-01-08,01:00:00,1,0,1,FMN GV 16 Berchem TOT
54,Posthofbrug 5366,2019-01-08,02:00:00,0,0,0,FMN GV 16 Berchem TOT
54,Posthofbrug 5366,2019-01-08,03:00:00,4,2,2,FMN GV 16 Berchem TOT
54,Posthofbrug 5366,2019-01-08,04:00:00,4,4,0,FMN GV 16 Berchem TOT
54,Posthofbrug 5366,2019-01-08,05:00:00,14,11,3,FMN GV 16 Berchem TOT
54,Posthofbrug 5366,2019-01-08,06:00:00,110,88,22,FMN GV 16 Berchem TOT
54,Posthofbrug 5366,2019-01-08,07:00:00,441,318,123,FMN GV 16 Berchem TOT
54,Posthofbrug 5366,2019-01-08,08:00:00,718,487,231,FMN GV 16 Berchem TOT
54,Posthofbrug 5366,2019-01-08,09:00:00,173,118,55,FMN GV 16 Berchem TOT
54,Posthofbrug 5366,2019-01-08,10:00:00,74,54,20,FMN GV 16 Berchem TOT
54,Posthofbrug 5366,2019-01-08,11:00:00,71,45,26,FMN GV 16 Berchem TOT
54,Posthofbrug 5366,2019-01-08,12:00:00,96,56,40,FMN GV 16 Berchem TOT
54,Posthofbrug 5366,2019-01-08,13:00:00,74,45,29,FMN GV 16 Berchem TOT
54,Posthofbrug 5366,2019-01-08,14:00:00,60,23,37,FMN GV 16 Berchem TOT
54,Posthofbrug 5366,2019-01-08,15:00:00,156,76,80,FMN GV 16 Berchem TOT
54,Posthofbrug 5366,2019-01-08,16:00:00,357,145,212,FMN GV 16 Berchem TOT
54,Posthofbrug 5366,2019-01-08,17:00:00,497,192,305,FMN GV 16 Berchem TOT
54,Posthofbrug 5366,2019-01-08,18:00:00,272,92,180,FMN GV 16 Berchem TOT
54,Posthofbrug 5366,2019-01-08,19:00:00,113,40,73,FMN GV 16 Berchem TOT
54,Posthofbrug 5366,2019-01-08,20:00:00,54,19,35,FMN GV 16 Berchem TOT
54,Posthofbrug 5366,2019-01-08,21:00:00,71,32,39,FMN GV 16 Berchem TOT
54,Posthofbrug 5366,2019-01-08,22:00:00,59,22,37,FMN GV 16 Berchem TOT
54,Posthofbrug 5366,2019-01-08,23:00:00,19,9,10,FMN GV 16 Berchem TOT
54,Posthofbrug 5366,2019-01-09,00:00:00,16,8,8,FMN GV 16 Berchem TOT
54,Posthofbrug 5366,2019-01-09,01:00:00,5,1,4,FMN GV 16 Berchem TOT
54,Posthofbrug 5366,2019-01-09,02:00:00,0,0,0,FMN GV 16 Berchem TOT
54,Posthofbrug 5366,2019-01-09,03:00:00,2,1,1,FMN GV 16 Berchem TOT
54,Posthofbrug 5366,2019-01-09,04:00:00,5,4,1,FMN GV 16 Berchem TOT
54,Posthofbrug 5366,2019-01-09,05:00:00,11,8,3,FMN GV 16 Berchem TOT
54,Posthofbrug 5366,2019-01-09,06:00:00,92,77,15,FMN GV 16 Berchem TOT
54,Posthofbrug 5366,2019-01-09,07:00:00,405,283,122,FMN GV 16 Berchem TOT
54,Posthofbrug 5366,2019-01-09,08:00:00,586,391,195,FMN GV 16 Berchem TOT
54,Posthofbrug 5366,2019-01-09,09:00:00,180,113,67,FMN GV 16 Berchem TOT
54,Posthofbrug 5366,2019-01-09,10:00:00,69,43,26,FMN GV 16 Berchem TOT
54,Posthofbrug 5366,2019-01-09,11:00:00,91,46,45,FMN GV 16 Berchem TOT
54,Posthofbrug 5366,2019-01-09,12:00:00,214,125,89,FMN GV 16 Berchem TOT
54,Posthofbrug 5366,2019-01-09,13:00:00,187,93,94,FMN GV 16 Berchem TOT
54,Posthofbrug 5366,2019-01-09,14:00:00,97,54,43,FMN GV 16 Berchem TOT
54,Posthofbrug 5366,2019-01-09,15:00:00,147,66,81,FMN GV 16 Berchem TOT
54,Posthofbrug 5366,2019-01-09,16:00:00,319,167,152,FMN GV 16 Berchem TOT
54,Posthofbrug 5366,2019-01-09,17:00:00,467,181,286,FMN GV 16 Berchem TOT
54,Posthofbrug 5366,2019-01-09,18:00:00,278,97,181,FMN GV 16 Berchem TOT
54,Posthofbrug 5366,2019-01-09,19:00:00,124,63,61,FMN GV 16 Berchem TOT
54,Posthofbrug 5366,2019-01-09,20:00:00,93,51,42,FMN GV 16 Berchem TOT
54,Posthofbrug 5366,2019-01-09,21:00:00,54,19,35,FMN GV 16 Berchem TOT
54,Posthofbrug 5366,2019-01-09,22:00:00,65,29,36,FMN GV 16 Berchem TOT
54,Posthofbrug 5366,2019-01-09,23:00:00,24,9,15,FMN GV 16 Berchem TOT
54,Posthofbrug 5366,2019-01-10,00:00:00,11,3,8,FMN GV 16 Berchem TOT
54,Posthofbrug 5366,2019-01-10,01:00:00,2,0,2,FMN GV 16 Berchem TOT
54,Posthofbrug 5366,2019-01-10,02:00:00,0,0,0,FMN GV 16 Berchem TOT
54,Posthofbrug 5366,2019-01-10,03:00:00,2,2,0,FMN GV 16 Berchem TOT
54,Posthofbrug 5366,2019-01-10,04:00:00,3,2,1,FMN GV 16 Berchem TOT
54,Posthofbrug 5366,2019-01-10,05:00:00,15,11,4,FMN GV 16 Berchem TOT
54,Posthofbrug 5366,2019-01-10,06:00:00,111,92,19,FMN GV 16 Berchem TOT
54,Posthofbrug 5366,2019-01-10,07:00:00,452,333,119,FMN GV 16 Berchem TOT
54,Posthofbrug 5366,2019-01-10,08:00:00,665,442,223,FMN GV 16 Berchem TOT
54,Posthofbrug 5366,2019-01-10,09:00:00,232,158,74,FMN GV 16 Berchem TOT
54,Posthofbrug 5366,2019-01-10,10:00:00,107,73,34,FMN GV 16 Berchem TOT
54,Posthofbrug 5366,2019-01-10,11:00:00,105,58,47,FMN GV 16 Berchem TOT
54,Posthofbrug 5366,2019-01-10,12:00:00,142,84,58,FMN GV 16 Berchem TOT
54,Posthofbrug 5366,2019-01-10,13:00:00,109,64,45,FMN GV 16 Berchem TOT
54,Posthofbrug 5366,2019-01-10,14:00:00,97,52,45,FMN GV 16 Berchem TOT
54,Posthofbrug 5366,2019-01-10,15:00:00,191,85,106,FMN GV 16 Berchem TOT
54,Posthofbrug 5366,2019-01-10,16:00:00,359,160,199,FMN GV 16 Berchem TOT
54,Posthofbrug 5366,2019-01-10,17:00:00,483,183,300,FMN GV 16 Berchem TOT
54,Posthofbrug 5366,2019-01-10,18:00:00,304,106,198,FMN GV 16 Berchem TOT
54,Posthofbrug 5366,2019-01-10,19:00:00,135,52,83,FMN GV 16 Berchem TOT
54,Posthofbrug 5366,2019-01-10,20:00:00,80,43,37,FMN GV 16 Berchem TOT
54,Posthofbrug 5366,2019-01-10,21:00:00,60,24,36,FMN GV 16 Berchem TOT
54,Posthofbrug 5366,2019-01-10,22:00:00,60,22,38,FMN GV 16 Berchem TOT
54,Posthofbrug 5366,2019-01-10,23:00:00,25,10,15,FMN GV 16 Berchem TOT
54,Posthofbrug 5366,2019-01-11,00:00:00,23,6,17,FMN GV 16 Berchem TOT
54,Posthofbrug 5366,2019-01-11,01:00:00,4,1,3,FMN GV 16 Berchem TOT
54,Posthofbrug 5366,2019-01-11,02:00:00,0,0,0,FMN GV 16 Berchem TOT
54,Posthofbrug 5366,2019-01-11,03:00:00,5,4,1,FMN GV 16 Berchem TOT
54,Posthofbrug 5366,2019-01-11,04:00:00,5,5,0,FMN GV 16 Berchem TOT
54,Posthofbrug 5366,2019-01-11,05:00:00,9,7,2,FMN GV 16 Berchem TOT
54,Posthofbrug 5366,2019-01-11,06:00:00,76,62,14,FMN GV 16 Berchem TOT
54,Posthofbrug 5366,2019-01-11,07:00:00,321,213,108,FMN GV 16 Berchem TOT
54,Posthofbrug 5366,2019-01-11,08:00:00,601,407,194,FMN GV 16 Berchem TOT
54,Posthofbrug 5366,2019-01-11,09:00:00,176,115,61,FMN GV 16 Berchem TOT
54,Posthofbrug 5366,2019-01-11,10:00:00,98,71,27,FMN GV 16 Berchem TOT
54,Posthofbrug 5366,2019-01-11,11:00:00,71,44,27,FMN GV 16 Berchem TOT
54,Posthofbrug 5366,2019-01-11,12:00:00,131,70,61,FMN GV 16 Berchem TOT
54,Posthofbrug 5366,2019-01-11,13:00:00,110,59,51,FMN GV 16 Berchem TOT
54,Posthofbrug 5366,2019-01-11,14:00:00,116,53,63,FMN GV 16 Berchem TOT
54,Posthofbrug 5366,2019-01-11,15:00:00,211,103,108,FMN GV 16 Berchem TOT
54,Posthofbrug 5366,2019-01-11,16:00:00,330,176,154,FMN GV 16 Berchem TOT
54,Posthofbrug 5366,2019-01-11,17:00:00,360,155,205,FMN GV 16 Berchem TOT
54,Posthofbrug 5366,2019-01-11,18:00:00,254,109,145,FMN GV 16 Berchem TOT
54,Posthofbrug 5366,2019-01-11,19:00:00,150,74,76,FMN GV 16 Berchem TOT
54,Posthofbrug 5366,2019-01-11,20:00:00,89,48,41,FMN GV 16 Berchem TOT
54,Posthofbrug 5366,2019-01-11,21:00:00,53,26,27,FMN GV 16 Berchem TOT
54,Posthofbrug 5366,2019-01-11,22:00:00,50,20,30,FMN GV 16 Berchem TOT
54,Posthofbrug 5366,2019-01-11,23:00:00,48,14,34,FMN GV 16 Berchem TOT
54,Posthofbrug 5366,2019-01-12,00:00:00,50,7,43,FMN GV 16 Berchem TOT
54,Posthofbrug 5366,2019-01-12,01:00:00,31,9,22,FMN GV 16 Berchem TOT
54,Posthofbrug 5366,2019-01-12,02:00:00,21,7,14,FMN GV 16 Berchem TOT
54,Posthofbrug 5366,2019-01-12,03:00:00,16,3,13,FMN GV 16 Berchem TOT
54,Posthofbrug 5366,2019-01-12,04:00:00,18,4,14,FMN GV 16 Berchem TOT
54,Posthofbrug 5366,2019-01-12,05:00:00,5,2,3,FMN GV 16 Berchem TOT
54,Posthofbrug 5366,2019-01-12,06:00:00,14,11,3,FMN GV 16 Berchem TOT
54,Posthofbrug 5366,2019-01-12,07:00:00,13,8,5,FMN GV 16 Berchem TOT
54,Posthofbrug 5366,2019-01-12,08:00:00,39,31,8,FMN GV 16 Berchem TOT
54,Posthofbrug 5366,2019-01-12,09:00:00,82,50,32,FMN GV 16 Berchem TOT
54,Posthofbrug 5366,2019-01-12,10:00:00,87,61,26,FMN GV 16 Berchem TOT
54,Posthofbrug 5366,2019-01-12,11:00:00,82,50,32,FMN GV 16 Berchem TOT
54,Posthofbrug 5366,2019-01-12,12:00:00,66,33,33,FMN GV 16 Berchem TOT
54,Posthofbrug 5366,2019-01-12,13:00:00,70,38,32,FMN GV 16 Berchem TOT
54,Posthofbrug 5366,2019-01-12,14:00:00,74,51,23,FMN GV 16 Berchem TOT
54,Posthofbrug 5366,2019-01-12,15:00:00,53,28,25,FMN GV 16 Berchem TOT
54,Posthofbrug 5366,2019-01-12,16:00:00,71,43,28,FMN GV 16 Berchem TOT
54,Posthofbrug 5366,2019-01-12,17:00:00,68,24,44,FMN GV 16 Berchem TOT
54,Posthofbrug 5366,2019-01-12,18:00:00,65,26,39,FMN GV 16 Berchem TOT
54,Posthofbrug 5366,2019-01-12,19:00:00,45,28,17,FMN GV 16 Berchem TOT
54,Posthofbrug 5366,2019-01-12,20:00:00,36,23,13,FMN GV 16 Berchem TOT
54,Posthofbrug 5366,2019-01-12,21:00:00,27,21,6,FMN GV 16 Berchem TOT
54,Posthofbrug 5366,2019-01-12,22:00:00,23,9,14,FMN GV 16 Berchem TOT
54,Posthofbrug 5366,2019-01-12,23:00:00,34,16,18,FMN GV 16 Berchem TOT
54,Posthofbrug 5366,2019-01-13,00:00:00,22,5,17,FMN GV 16 Berchem TOT
54,Posthofbrug 5366,2019-01-13,01:00:00,18,9,9,FMN GV 16 Berchem TOT
54,Posthofbrug 5366,2019-01-13,02:00:00,12,1,11,FMN GV 16 Berchem TOT
54,Posthofbrug 5366,2019-01-13,03:00:00,14,1,13,FMN GV 16 Berchem TOT
54,Posthofbrug 5366,2019-01-13,04:00:00,10,2,8,FMN GV 16 Berchem TOT
54,Posthofbrug 5366,2019-01-13,05:00:00,2,1,1,FMN GV 16 Berchem TOT
54,Posthofbrug 5366,2019-01-13,06:00:00,10,6,4,FMN GV 16 Berchem TOT
54,Posthofbrug 5366,2019-01-13,07:00:00,2,1,1,FMN GV 16 Berchem TOT
54,Posthofbrug 5366,2019-01-13,08:00:00,17,12,5,FMN GV 16 Berchem TOT
54,Posthofbrug 5366,2019-01-13,09:00:00,41,24,17,FMN GV 16 Berchem TOT
54,Posthofbrug 5366,2019-01-13,10:00:00,57,43,14,FMN GV 16 Berchem TOT
54,Posthofbrug 5366,2019-01-13,11:00:00,45,32,13,FMN GV 16 Berchem TOT
54,Posthofbrug 5366,2019-01-13,12:00:00,43,22,21,FMN GV 16 Berchem TOT
54,Posthofbrug 5366,2019-01-13,13:00:00,46,23,23,FMN GV 16 Berchem TOT
54,Posthofbrug 5366,2019-01-13,14:00:00,38,22,16,FMN GV 16 Berchem TOT
54,Posthofbrug 5366,2019-01-13,15:00:00,25,11,14,FMN GV 16 Berchem TOT
54,Posthofbrug 5366,2019-01-13,16:00:00,47,28,19,FMN GV 16 Berchem TOT
54,Posthofbrug 5366,2019-01-13,17:00:00,65,40,25,FMN GV 16 Berchem TOT
54,Posthofbrug 5366,2019-01-13,18:00:00,21,8,13,FMN GV 16 Berchem TOT
54,Posthofbrug 5366,2019-01-13,19:00:00,47,25,22,FMN GV 16 Berchem TOT
54,Posthofbrug 5366,2019-01-13,20:00:00,23,13,10,FMN GV 16 Berchem TOT
54,Posthofbrug 5366,2019-01-13,21:00:00,20,3,17,FMN GV 16 Berchem TOT
54,Posthofbrug 5366,2019-01-13,22:00:00,18,13,5,FMN GV 16 Berchem TOT
54,Posthofbrug 5366,2019-01-13,23:00:00,5,2,3,FMN GV 16 Berchem TOT
54,Posthofbrug 5366,2019-01-14,00:00:00,3,1,2,FMN GV 16 Berchem TOT
54,Posthofbrug 5366,2019-01-14,01:00:00,0,0,0,FMN GV 16 Berchem TOT
54,Posthofbrug 5366,2019-01-14,02:00:00,1,1,0,FMN GV 16 Berchem TOT
54,Posthofbrug 5366,2019-01-14,03:00:00,2,1,1,FMN GV 16 Berchem TOT
54,Posthofbrug 5366,2019-01-14,04:00:00,6,5,1,FMN GV 16 Berchem TOT
54,Posthofbrug 5366,2019-01-14,05:00:00,21,13,8,FMN GV 16 Berchem TOT
54,Posthofbrug 5366,2019-01-14,06:00:00,91,74,17,FMN GV 16 Berchem TOT
54,Posthofbrug 5366,2019-01-14,07:00:00,354,257,97,FMN GV 16 Berchem TOT
54,Posthofbrug 5366,2019-01-14,08:00:00,611,404,207,FMN GV 16 Berchem TOT
54,Posthofbrug 5366,2019-01-14,09:00:00,203,143,60,FMN GV 16 Berchem TOT
54,Posthofbrug 5366,2019-01-14,10:00:00,80,61,19,FMN GV 16 Berchem TOT
54,Posthofbrug 5366,2019-01-14,11:00:00,88,61,27,FMN GV 16 Berchem TOT
54,Posthofbrug 5366,2019-01-14,12:00:00,104,54,50,FMN GV 16 Berchem TOT
54,Posthofbrug 5366,2019-01-14,13:00:00,93,59,34,FMN GV 16 Berchem TOT
54,Posthofbrug 5366,2019-01-14,14:00:00,103,52,51,FMN GV 16 Berchem TOT
54,Posthofbrug 5366,2019-01-14,15:00:00,180,88,92,FMN GV 16 Berchem TOT
54,Posthofbrug 5366,2019-01-14,16:00:00,347,150,197,FMN GV 16 Berchem TOT
54,Posthofbrug 5366,2019-01-14,17:00:00,512,207,305,FMN GV 16 Berchem TOT
54,Posthofbrug 5366,2019-01-14,18:00:00,278,86,192,FMN GV 16 Berchem TOT
54,Posthofbrug 5366,2019-01-14,19:00:00,119,60,59,FMN GV 16 Berchem TOT
54,Posthofbrug 5366,2019-01-14,20:00:00,65,29,36,FMN GV 16 Berchem TOT
54,Posthofbrug 5366,2019-01-14,21:00:00,71,30,41,FMN GV 16 Berchem TOT
54,Posthofbrug 5366,2019-01-14,22:00:00,48,24,24,FMN GV 16 Berchem TOT
54,Posthofbrug 5366,2019-01-14,23:00:00,35,13,22,FMN GV 16 Berchem TOT
54,Posthofbrug 5366,2019-01-15,00:00:00,4,1,3,FMN GV 16 Berchem TOT
54,Posthofbrug 5366,2019-01-15,01:00:00,2,1,1,FMN GV 16 Berchem TOT
54,Posthofbrug 5366,2019-01-15,02:00:00,0,0,0,FMN GV 16 Berchem TOT
54,Posthofbrug 5366,2019-01-15,03:00:00,4,4,0,FMN GV 16 Berchem TOT
54,Posthofbrug 5366,2019-01-15,04:00:00,7,6,1,FMN GV 16 Berchem TOT
54,Posthofbrug 5366,2019-01-15,05:00:00,19,13,6,FMN GV 16 Berchem TOT
54,Posthofbrug 5366,2019-01-15,06:00:00,105,91,14,FMN GV 16 Berchem TOT
54,Posthofbrug 5366,2019-01-15,07:00:00,441,317,124,FMN GV 16 Berchem TOT
54,Posthofbrug 5366,2019-01-15,08:00:00,765,500,265,FMN GV 16 Berchem TOT
54,Posthofbrug 5366,2019-01-15,09:00:00,218,148,70,FMN GV 16 Berchem TOT
54,Posthofbrug 5366,2019-01-15,10:00:00,84,58,26,FMN GV 16 Berchem TOT
54,Posthofbrug 5366,2019-01-15,11:00:00,85,59,26,FMN GV 16 Berchem TOT
54,Posthofbrug 5366,2019-01-15,12:00:00,112,65,47,FMN GV 16 Berchem TOT
54,Posthofbrug 5366,2019-01-15,13:00:00,107,67,40,FMN GV 16 Berchem TOT
54,Posthofbrug 5366,2019-01-15,14:00:00,90,42,48,FMN GV 16 Berchem TOT
54,Posthofbrug 5366,2019-01-15,15:00:00,161,87,74,FMN GV 16 Berchem TOT
54,Posthofbrug 5366,2019-01-15,16:00:00,397,165,232,FMN GV 16 Berchem TOT
54,Posthofbrug 5366,2019-01-15,17:00:00,556,217,339,FMN GV 16 Berchem TOT
54,Posthofbrug 5366,2019-01-15,18:00:00,311,114,197,FMN GV 16 Berchem TOT
54,Posthofbrug 5366,2019-01-15,19:00:00,131,49,82,FMN GV 16 Berchem TOT
54,Posthofbrug 5366,2019-01-15,20:00:00,79,34,45,FMN GV 16 Berchem TOT
54,Posthofbrug 5366,2019-01-15,21:00:00,58,30,28,FMN GV 16 Berchem TOT
54,Posthofbrug 5366,2019-01-15,22:00:00,49,19,30,FMN GV 16 Berchem TOT
54,Posthofbrug 5366,2019-01-15,23:00:00,30,13,17,FMN GV 16 Berchem TOT
54,Posthofbrug 5366,2019-01-16,00:00:00,12,6,6,FMN GV 16 Berchem TOT
54,Posthofbrug 5366,2019-01-16,01:00:00,4,1,3,FMN GV 16 Berchem TOT
54,Posthofbrug 5366,2019-01-16,02:00:00,0,0,0,FMN GV 16 Berchem TOT
54,Posthofbrug 5366,2019-01-16,03:00:00,2,2,0,FMN GV 16 Berchem TOT
54,Posthofbrug 5366,2019-01-16,04:00:00,8,8,0,FMN GV 16 Berchem TOT
54,Posthofbrug 5366,2019-01-16,05:00:00,16,11,5,FMN GV 16 Berchem TOT
54,Posthofbrug 5366,2019-01-16,06:00:00,108,90,18,FMN GV 16 Berchem TOT
54,Posthofbrug 5366,2019-01-16,07:00:00,403,295,108,FMN GV 16 Berchem TOT
54,Posthofbrug 5366,2019-01-16,08:00:00,637,425,212,FMN GV 16 Berchem TOT
54,Posthofbrug 5366,2019-01-16,09:00:00,198,128,70,FMN GV 16 Berchem TOT
54,Posthofbrug 5366,2019-01-16,10:00:00,85,57,28,FMN GV 16 Berchem TOT
54,Posthofbrug 5366,2019-01-16,11:00:00,111,62,49,FMN GV 16 Berchem TOT
54,Posthofbrug 5366,2019-01-16,12:00:00,193,103,90,FMN GV 16 Berchem TOT
54,Posthofbrug 5366,2019-01-16,13:00:00,137,69,68,FMN GV 16 Berchem TOT
54,Posthofbrug 5366,2019-01-16,14:00:00,120,56,64,FMN GV 16 Berchem TOT
54,Posthofbrug 5366,2019-01-16,15:00:00,143,67,76,FMN GV 16 Berchem TOT
54,Posthofbrug 5366,2019-01-16,16:00:00,294,144,150,FMN GV 16 Berchem TOT
54,Posthofbrug 5366,2019-01-16,17:00:00,466,177,289,FMN GV 16 Berchem TOT
54,Posthofbrug 5366,2019-01-16,18:00:00,273,105,168,FMN GV 16 Berchem TOT
54,Posthofbrug 5366,2019-01-16,19:00:00,124,52,72,FMN GV 16 Berchem TOT
54,Posthofbrug 5366,2019-01-16,20:00:00,71,41,30,FMN GV 16 Berchem TOT
54,Posthofbrug 5366,2019-01-16,21:00:00,64,20,44,FMN GV 16 Berchem TOT
54,Posthofbrug 5366,2019-01-16,22:00:00,57,23,34,FMN GV 16 Berchem TOT
54,Posthofbrug 5366,2019-01-16,23:00:00,37,10,27,FMN GV 16 Berchem TOT
54,Posthofbrug 5366,2019-01-17,00:00:00,15,5,10,FMN GV 16 Berchem TOT
54,Posthofbrug 5366,2019-01-17,01:00:00,3,1,2,FMN GV 16 Berchem TOT
54,Posthofbrug 5366,2019-01-17,02:00:00,3,2,1,FMN GV 16 Berchem TOT
54,Posthofbrug 5366,2019-01-17,03:00:00,1,1,0,FMN GV 16 Berchem TOT
54,Posthofbrug 5366,2019-01-17,04:00:00,8,7,1,FMN GV 16 Berchem TOT
54,Posthofbrug 5366,2019-01-17,05:00:00,21,11,10,FMN GV 16 Berchem TOT
54,Posthofbrug 5366,2019-01-17,06:00:00,104,87,17,FMN GV 16 Berchem TOT
54,Posthofbrug 5366,2019-01-17,07:00:00,390,267,123,FMN GV 16 Berchem TOT
54,Posthofbrug 5366,2019-01-17,08:00:00,596,418,178,FMN GV 16 Berchem TOT
54,Posthofbrug 5366,2019-01-17,09:00:00,212,141,71,FMN GV 16 Berchem TOT
54,Posthofbrug 5366,2019-01-17,10:00:00,87,58,29,FMN GV 16 Berchem TOT
54,Posthofbrug 5366,2019-01-17,11:00:00,71,38,33,FMN GV 16 Berchem TOT
54,Posthofbrug 5366,2019-01-17,12:00:00,80,46,34,FMN GV 16 Berchem TOT
54,Posthofbrug 5366,2019-01-17,13:00:00,78,38,40,FMN GV 16 Berchem TOT
54,Posthofbrug 5366,2019-01-17,14:00:00,75,24,51,FMN GV 16 Berchem TOT
54,Posthofbrug 5366,2019-01-17,15:00:00,155,72,83,FMN GV 16 Berchem TOT
54,Posthofbrug 5366,2019-01-17,16:00:00,336,159,177,FMN GV 16 Berchem TOT
54,Posthofbrug 5366,2019-01-17,17:00:00,431,165,266,FMN GV 16 Berchem TOT
54,Posthofbrug 5366,2019-01-17,18:00:00,234,95,139,FMN GV 16 Berchem TOT
54,Posthofbrug 5366,2019-01-17,19:00:00,127,47,80,FMN GV 16 Berchem TOT
54,Posthofbrug 5366,2019-01-17,20:00:00,75,40,35,FMN GV 16 Berchem TOT
54,Posthofbrug 5366,2019-01-17,21:00:00,54,26,28,FMN GV 16 Berchem TOT
54,Posthofbrug 5366,2019-01-17,22:00:00,50,17,33,FMN GV 16 Berchem TOT
54,Posthofbrug 5366,2019-01-17,23:00:00,36,12,24,FMN GV 16 Berchem TOT
54,Posthofbrug 5366,2019-01-18,00:00:00,18,3,15,FMN GV 16 Berchem TOT
54,Posthofbrug 5366,2019-01-18,01:00:00,6,1,5,FMN GV 16 Berchem TOT
54,Posthofbrug 5366,2019-01-18,02:00:00,0,0,0,FMN GV 16 Berchem TOT
54,Posthofbrug 5366,2019-01-18,03:00:00,5,4,1,FMN GV 16 Berchem TOT
54,Posthofbrug 5366,2019-01-18,04:00:00,0,0,0,FMN GV 16 Berchem TOT
54,Posthofbrug 5366,2019-01-18,05:00:00,0,0,0,FMN GV 16 Berchem TOT
54,Posthofbrug 5366,2019-01-18,06:00:00,0,0,0,FMN GV 16 Berchem TOT
54,Posthofbrug 5366,2019-01-18,07:00:00,0,0,0,FMN GV 16 Berchem TOT
54,Posthofbrug 5366,2019-01-18,08:00:00,0,0,0,FMN GV 16 Berchem TOT
54,Posthofbrug 5366,2019-01-18,09:00:00,0,0,0,FMN GV 16 Berchem TOT
54,Posthofbrug 5366,2019-01-18,10:00:00,0,0,0,FMN GV 16 Berchem TOT
54,Posthofbrug 5366,2019-01-18,11:00:00,45,19,26,FMN GV 16 Berchem TOT
54,Posthofbrug 5366,2019-01-18,12:00:00,128,74,54,FMN GV 16 Berchem TOT
54,Posthofbrug 5366,2019-01-18,13:00:00,102,55,47,FMN GV 16 Berchem TOT
54,Posthofbrug 5366,2019-01-18,14:00:00,100,53,47,FMN GV 16 Berchem TOT
54,Posthofbrug 5366,2019-01-18,15:00:00,170,89,81,FMN GV 16 Berchem TOT
54,Posthofbrug 5366,2019-01-18,16:00:00,314,132,182,FMN GV 16 Berchem TOT
54,Posthofbrug 5366,2019-01-18,17:00:00,389,167,222,FMN GV 16 Berchem TOT
54,Posthofbrug 5366,2019-01-18,18:00:00,239,104,135,FMN GV 16 Berchem TOT
54,Posthofbrug 5366,2019-01-18,19:00:00,106,50,56,FMN GV 16 Berchem TOT
54,Posthofbrug 5366,2019-01-18,20:00:00,74,52,22,FMN GV 16 Berchem TOT
54,Posthofbrug 5366,2019-01-18,21:00:00,48,26,22,FMN GV 16 Berchem TOT
54,Posthofbrug 5366,2019-01-18,22:00:00,40,16,24,FMN GV 16 Berchem TOT
54,Posthofbrug 5366,2019-01-18,23:00:00,62,13,49,FMN GV 16 Berchem TOT
54,Posthofbrug 5366,2019-01-19,00:00:00,35,13,22,FMN GV 16 Berchem TOT
54,Posthofbrug 5366,2019-01-19,01:00:00,42,10,32,FMN GV 16 Berchem TOT
54,Posthofbrug 5366,2019-01-19,02:00:00,14,6,8,FMN GV 16 Berchem TOT
54,Posthofbrug 5366,2019-01-19,03:00:00,7,4,3,FMN GV 16 Berchem TOT
54,Posthofbrug 5366,2019-01-19,04:00:00,7,3,4,FMN GV 16 Berchem TOT
54,Posthofbrug 5366,2019-01-19,05:00:00,7,4,3,FMN GV 16 Berchem TOT
54,Posthofbrug 5366,2019-01-19,06:00:00,9,7,2,FMN GV 16 Berchem TOT
54,Posthofbrug 5366,2019-01-19,07:00:00,26,17,9,FMN GV 16 Berchem TOT
54,Posthofbrug 5366,2019-01-19,08:00:00,45,30,15,FMN GV 16 Berchem TOT
54,Posthofbrug 5366,2019-01-19,09:00:00,83,47,36,FMN GV 16 Berchem TOT
54,Posthofbrug 5366,2019-01-19,10:00:00,88,54,34,FMN GV 16 Berchem TOT
54,Posthofbrug 5366,2019-01-19,11:00:00,89,53,36,FMN GV 16 Berchem TOT
54,Posthofbrug 5366,2019-01-19,12:00:00,94,41,53,FMN GV 16 Berchem TOT
54,Posthofbrug 5366,2019-01-19,13:00:00,104,59,45,FMN GV 16 Berchem TOT
54,Posthofbrug 5366,2019-01-19,14:00:00,118,74,44,FMN GV 16 Berchem TOT
54,Posthofbrug 5366,2019-01-19,15:00:00,106,57,49,FMN GV 16 Berchem TOT
54,Posthofbrug 5366,2019-01-19,16:00:00,89,48,41,FMN GV 16 Berchem TOT
54,Posthofbrug 5366,2019-01-19,17:00:00,98,50,48,FMN GV 16 Berchem TOT
54,Posthofbrug 5366,2019-01-19,18:00:00,83,39,44,FMN GV 16 Berchem TOT
54,Posthofbrug 5366,2019-01-19,19:00:00,101,56,45,FMN GV 16 Berchem TOT
54,Posthofbrug 5366,2019-01-19,20:00:00,39,23,16,FMN GV 16 Berchem TOT
54,Posthofbrug 5366,2019-01-19,21:00:00,44,24,20,FMN GV 16 Berchem TOT
54,Posthofbrug 5366,2019-01-19,22:00:00,42,10,32,FMN GV 16 Berchem TOT
54,Posthofbrug 5366,2019-01-19,23:00:00,40,21,19,FMN GV 16 Berchem TOT
54,Posthofbrug 5366,2019-01-20,00:00:00,28,13,15,FMN GV 16 Berchem TOT
54,Posthofbrug 5366,2019-01-20,01:00:00,19,11,8,FMN GV 16 Berchem TOT
54,Posthofbrug 5366,2019-01-20,02:00:00,16,6,10,FMN GV 16 Berchem TOT
54,Posthofbrug 5366,2019-01-20,03:00:00,21,4,17,FMN GV 16 Berchem TOT
54,Posthofbrug 5366,2019-01-20,04:00:00,14,3,11,FMN GV 16 Berchem TOT
54,Posthofbrug 5366,2019-01-20,05:00:00,12,4,8,FMN GV 16 Berchem TOT
54,Posthofbrug 5366,2019-01-20,06:00:00,10,5,5,FMN GV 16 Berchem TOT
54,Posthofbrug 5366,2019-01-20,07:00:00,13,8,5,FMN GV 16 Berchem TOT
54,Posthofbrug 5366,2019-01-20,08:00:00,20,13,7,FMN GV 16 Berchem TOT
54,Posthofbrug 5366,2019-01-20,09:00:00,42,26,16,FMN GV 16 Berchem TOT
54,Posthofbrug 5366,2019-01-20,10:00:00,68,54,14,FMN GV 16 Berchem TOT
54,Posthofbrug 5366,2019-01-20,11:00:00,65,36,29,FMN GV 16 Berchem TOT
54,Posthofbrug 5366,2019-01-20,12:00:00,90,44,46,FMN GV 16 Berchem TOT
54,Posthofbrug 5366,2019-01-20,13:00:00,100,53,47,FMN GV 16 Berchem TOT
54,Posthofbrug 5366,2019-01-20,14:00:00,104,57,47,FMN GV 16 Berchem TOT
54,Posthofbrug 5366,2019-01-20,15:00:00,79,34,45,FMN GV 16 Berchem TOT
54,Posthofbrug 5366,2019-01-20,16:00:00,76,43,33,FMN GV 16 Berchem TOT
54,Posthofbrug 5366,2019-01-20,17:00:00,68,35,33,FMN GV 16 Berchem TOT
54,Posthofbrug 5366,2019-01-20,18:00:00,35,19,16,FMN GV 16 Berchem TOT
54,Posthofbrug 5366,2019-01-20,19:00:00,43,22,21,FMN GV 16 Berchem TOT
54,Posthofbrug 5366,2019-01-20,20:00:00,28,16,12,FMN GV 16 Berchem TOT
54,Posthofbrug 5366,2019-01-20,21:00:00,32,14,18,FMN GV 16 Berchem TOT
54,Posthofbrug 5366,2019-01-20,22:00:00,23,10,13,FMN GV 16 Berchem TOT
54,Posthofbrug 5366,2019-01-20,23:00:00,14,4,10,FMN GV 16 Berchem TOT
54,Posthofbrug 5366,2019-01-21,00:00:00,5,1,4,FMN GV 16 Berchem TOT
54,Posthofbrug 5366,2019-01-21,01:00:00,0,0,0,FMN GV 16 Berchem TOT
54,Posthofbrug 5366,2019-01-21,02:00:00,3,2,1,FMN GV 16 Berchem TOT
54,Posthofbrug 5366,2019-01-21,03:00:00,3,3,0,FMN GV 16 Berchem TOT
54,Posthofbrug 5366,2019-01-21,04:00:00,4,2,2,FMN GV 16 Berchem TOT
54,Posthofbrug 5366,2019-01-21,05:00:00,20,9,11,FMN GV 16 Berchem TOT
54,Posthofbrug 5366,2019-01-21,06:00:00,100,77,23,FMN GV 16 Berchem TOT
54,Posthofbrug 5366,2019-01-21,07:00:00,357,246,111,FMN GV 16 Berchem TOT
54,Posthofbrug 5366,2019-01-21,08:00:00,611,401,210,FMN GV 16 Berchem TOT
54,Posthofbrug 5366,2019-01-21,09:00:00,199,131,68,FMN GV 16 Berchem TOT
54,Posthofbrug 5366,2019-01-21,10:00:00,83,59,24,FMN GV 16 Berchem TOT
54,Posthofbrug 5366,2019-01-21,11:00:00,86,58,28,FMN GV 16 Berchem TOT
54,Posthofbrug 5366,2019-01-21,12:00:00,123,68,55,FMN GV 16 Berchem TOT
54,Posthofbrug 5366,2019-01-21,13:00:00,100,60,40,FMN GV 16 Berchem TOT
54,Posthofbrug 5366,2019-01-21,14:00:00,85,33,52,FMN GV 16 Berchem TOT
54,Posthofbrug 5366,2019-01-21,15:00:00,174,87,87,FMN GV 16 Berchem TOT
54,Posthofbrug 5366,2019-01-21,16:00:00,341,149,192,FMN GV 16 Berchem TOT
54,Posthofbrug 5366,2019-01-21,17:00:00,481,184,297,FMN GV 16 Berchem TOT
54,Posthofbrug 5366,2019-01-21,18:00:00,264,84,180,FMN GV 16 Berchem TOT
54,Posthofbrug 5366,2019-01-21,19:00:00,116,57,59,FMN GV 16 Berchem TOT
54,Posthofbrug 5366,2019-01-21,20:00:00,72,37,35,FMN GV 16 Berchem TOT
54,Posthofbrug 5366,2019-01-21,21:00:00,61,26,35,FMN GV 16 Berchem TOT
54,Posthofbrug 5366,2019-01-21,22:00:00,43,16,27,FMN GV 16 Berchem TOT
54,Posthofbrug 5366,2019-01-21,23:00:00,30,15,15,FMN GV 16 Berchem TOT
54,Posthofbrug 5366,2019-01-22,00:00:00,7,2,5,FMN GV 16 Berchem TOT
54,Posthofbrug 5366,2019-01-22,01:00:00,2,0,2,FMN GV 16 Berchem TOT
54,Posthofbrug 5366,2019-01-22,02:00:00,0,0,0,FMN GV 16 Berchem TOT
54,Posthofbrug 5366,2019-01-22,03:00:00,2,1,1,FMN GV 16 Berchem TOT
54,Posthofbrug 5366,2019-01-22,04:00:00,4,3,1,FMN GV 16 Berchem TOT
54,Posthofbrug 5366,2019-01-22,05:00:00,15,9,6,FMN GV 16 Berchem TOT
54,Posthofbrug 5366,2019-01-22,06:00:00,84,70,14,FMN GV 16 Berchem TOT
54,Posthofbrug 5366,2019-01-22,07:00:00,338,233,105,FMN GV 16 Berchem TOT
54,Posthofbrug 5366,2019-01-22,08:00:00,579,377,202,FMN GV 16 Berchem TOT
54,Posthofbrug 5366,2019-01-22,09:00:00,159,103,56,FMN GV 16 Berchem TOT
54,Posthofbrug 5366,2019-01-22,10:00:00,48,32,16,FMN GV 16 Berchem TOT
54,Posthofbrug 5366,2019-01-22,11:00:00,56,29,27,FMN GV 16 Berchem TOT
54,Posthofbrug 5366,2019-01-22,12:00:00,64,31,33,FMN GV 16 Berchem TOT
54,Posthofbrug 5366,2019-01-22,13:00:00,56,31,25,FMN GV 16 Berchem TOT
54,Posthofbrug 5366,2019-01-22,14:00:00,39,12,27,FMN GV 16 Berchem TOT
54,Posthofbrug 5366,2019-01-22,15:00:00,107,41,66,FMN GV 16 Berchem TOT
54,Posthofbrug 5366,2019-01-22,16:00:00,232,84,148,FMN GV 16 Berchem TOT
54,Posthofbrug 5366,2019-01-22,17:00:00,341,109,232,FMN GV 16 Berchem TOT
54,Posthofbrug 5366,2019-01-22,18:00:00,198,56,142,FMN GV 16 Berchem TOT
54,Posthofbrug 5366,2019-01-22,19:00:00,76,20,56,FMN GV 16 Berchem TOT
54,Posthofbrug 5366,2019-01-22,20:00:00,43,13,30,FMN GV 16 Berchem TOT
54,Posthofbrug 5366,2019-01-22,21:00:00,37,16,21,FMN GV 16 Berchem TOT
54,Posthofbrug 5366,2019-01-22,22:00:00,32,9,23,FMN GV 16 Berchem TOT
54,Posthofbrug 5366,2019-01-22,23:00:00,10,2,8,FMN GV 16 Berchem TOT
54,Posthofbrug 5366,2019-01-23,00:00:00,7,5,2,FMN GV 16 Berchem TOT
54,Posthofbrug 5366,2019-01-23,01:00:00,4,1,3,FMN GV 16 Berchem TOT
54,Posthofbrug 5366,2019-01-23,02:00:00,4,0,4,FMN GV 16 Berchem TOT
54,Posthofbrug 5366,2019-01-23,03:00:00,3,2,1,FMN GV 16 Berchem TOT
54,Posthofbrug 5366,2019-01-23,04:00:00,15,10,5,FMN GV 16 Berchem TOT
54,Posthofbrug 5366,2019-01-23,05:00:00,10,6,4,FMN GV 16 Berchem TOT
54,Posthofbrug 5366,2019-01-23,06:00:00,56,46,10,FMN GV 16 Berchem TOT
54,Posthofbrug 5366,2019-01-23,07:00:00,250,166,84,FMN GV 16 Berchem TOT
54,Posthofbrug 5366,2019-01-23,08:00:00,417,254,163,FMN GV 16 Berchem TOT
54,Posthofbrug 5366,2019-01-23,09:00:00,139,76,63,FMN GV 16 Berchem TOT
54,Posthofbrug 5366,2019-01-23,10:00:00,57,34,23,FMN GV 16 Berchem TOT
54,Posthofbrug 5366,2019-01-23,11:00:00,71,34,37,FMN GV 16 Berchem TOT
54,Posthofbrug 5366,2019-01-23,12:00:00,148,74,74,FMN GV 16 Berchem TOT
54,Posthofbrug 5366,2019-01-23,13:00:00,93,34,59,FMN GV 16 Berchem TOT
54,Posthofbrug 5366,2019-01-23,14:00:00,83,28,55,FMN GV 16 Berchem TOT
54,Posthofbrug 5366,2019-01-23,15:00:00,109,49,60,FMN GV 16 Berchem TOT
54,Posthofbrug 5366,2019-01-23,16:00:00,215,95,120,FMN GV 16 Berchem TOT
54,Posthofbrug 5366,2019-01-23,17:00:00,349,135,214,FMN GV 16 Berchem TOT
54,Posthofbrug 5366,2019-01-23,18:00:00,198,55,143,FMN GV 16 Berchem TOT
54,Posthofbrug 5366,2019-01-23,19:00:00,98,40,58,FMN GV 16 Berchem TOT
54,Posthofbrug 5366,2019-01-23,20:00:00,48,27,21,FMN GV 16 Berchem TOT
54,Posthofbrug 5366,2019-01-23,21:00:00,53,17,36,FMN GV 16 Berchem TOT
54,Posthofbrug 5366,2019-01-23,22:00:00,27,11,16,FMN GV 16 Berchem TOT
54,Posthofbrug 5366,2019-01-23,23:00:00,22,9,13,FMN GV 16 Berchem TOT
54,Posthofbrug 5366,2019-01-24,00:00:00,20,5,15,FMN GV 16 Berchem TOT
54,Posthofbrug 5366,2019-01-24,01:00:00,3,1,2,FMN GV 16 Berchem TOT
54,Posthofbrug 5366,2019-01-24,02:00:00,2,2,0,FMN GV 16 Berchem TOT
54,Posthofbrug 5366,2019-01-24,03:00:00,2,1,1,FMN GV 16 Berchem TOT
54,Posthofbrug 5366,2019-01-24,04:00:00,4,3,1,FMN GV 16 Berchem TOT
54,Posthofbrug 5366,2019-01-24,05:00:00,22,11,11,FMN GV 16 Berchem TOT
54,Posthofbrug 5366,2019-01-24,06:00:00,78,60,18,FMN GV 16 Berchem TOT
54,Posthofbrug 5366,2019-01-24,07:00:00,320,238,82,FMN GV 16 Berchem TOT
54,Posthofbrug 5366,2019-01-24,08:00:00,551,368,183,FMN GV 16 Berchem TOT
54,Posthofbrug 5366,2019-01-24,09:00:00,203,137,66,FMN GV 16 Berchem TOT
54,Posthofbrug 5366,2019-01-24,10:00:00,84,63,21,FMN GV 16 Berchem TOT
54,Posthofbrug 5366,2019-01-24,11:00:00,77,46,31,FMN GV 16 Berchem TOT
54,Posthofbrug 5366,2019-01-24,12:00:00,123,58,65,FMN GV 16 Berchem TOT
54,Posthofbrug 5366,2019-01-24,13:00:00,77,38,39,FMN GV 16 Berchem TOT
54,Posthofbrug 5366,2019-01-24,14:00:00,77,19,58,FMN GV 16 Berchem TOT
54,Posthofbrug 5366,2019-01-24,15:00:00,156,84,72,FMN GV 16 Berchem TOT
54,Posthofbrug 5366,2019-01-24,16:00:00,300,134,166,FMN GV 16 Berchem TOT
54,Posthofbrug 5366,2019-01-24,17:00:00,411,162,249,FMN GV 16 Berchem TOT
54,Posthofbrug 5366,2019-01-24,18:00:00,269,117,152,FMN GV 16 Berchem TOT
54,Posthofbrug 5366,2019-01-24,19:00:00,109,44,65,FMN GV 16 Berchem TOT
54,Posthofbrug 5366,2019-01-24,20:00:00,81,53,28,FMN GV 16 Berchem TOT
54,Posthofbrug 5366,2019-01-24,21:00:00,51,23,28,FMN GV 16 Berchem TOT
54,Posthofbrug 5366,2019-01-24,22:00:00,49,13,36,FMN GV 16 Berchem TOT
54,Posthofbrug 5366,2019-01-24,23:00:00,41,12,29,FMN GV 16 Berchem TOT
54,Posthofbrug 5366,2019-01-25,00:00:00,16,3,13,FMN GV 16 Berchem TOT
54,Posthofbrug 5366,2019-01-25,01:00:00,12,5,7,FMN GV 16 Berchem TOT
54,Posthofbrug 5366,2019-01-25,02:00:00,3,0,3,FMN GV 16 Berchem TOT
54,Posthofbrug 5366,2019-01-25,03:00:00,9,3,6,FMN GV 16 Berchem TOT
54,Posthofbrug 5366,2019-01-25,04:00:00,7,4,3,FMN GV 16 Berchem TOT
54,Posthofbrug 5366,2019-01-25,05:00:00,17,11,6,FMN GV 16 Berchem TOT
54,Posthofbrug 5366,2019-01-25,06:00:00,77,64,13,FMN GV 16 Berchem TOT
54,Posthofbrug 5366,2019-01-25,07:00:00,268,195,73,FMN GV 16 Berchem TOT
54,Posthofbrug 5366,2019-01-25,08:00:00,513,376,137,FMN GV 16 Berchem TOT
54,Posthofbrug 5366,2019-01-25,09:00:00,164,113,51,FMN GV 16 Berchem TOT
54,Posthofbrug 5366,2019-01-25,10:00:00,75,54,21,FMN GV 16 Berchem TOT
54,Posthofbrug 5366,2019-01-25,11:00:00,84,52,32,FMN GV 16 Berchem TOT
54,Posthofbrug 5366,2019-01-25,12:00:00,113,76,37,FMN GV 16 Berchem TOT
54,Posthofbrug 5366,2019-01-25,13:00:00,116,61,55,FMN GV 16 Berchem TOT
54,Posthofbrug 5366,2019-01-25,14:00:00,109,48,61,FMN GV 16 Berchem TOT
54,Posthofbrug 5366,2019-01-25,15:00:00,147,71,76,FMN GV 16 Berchem TOT
54,Posthofbrug 5366,2019-01-25,16:00:00,267,115,152,FMN GV 16 Berchem TOT
54,Posthofbrug 5366,2019-01-25,17:00:00,309,119,190,FMN GV 16 Berchem TOT
54,Posthofbrug 5366,2019-01-25,18:00:00,210,103,107,FMN GV 16 Berchem TOT
54,Posthofbrug 5366,2019-01-25,19:00:00,89,47,42,FMN GV 16 Berchem TOT
54,Posthofbrug 5366,2019-01-25,20:00:00,68,36,32,FMN GV 16 Berchem TOT
54,Posthofbrug 5366,2019-01-25,21:00:00,34,20,14,FMN GV 16 Berchem TOT
54,Posthofbrug 5366,2019-01-25,22:00:00,36,17,19,FMN GV 16 Berchem TOT
54,Posthofbrug 5366,2019-01-25,23:00:00,46,16,30,FMN GV 16 Berchem TOT
54,Posthofbrug 5366,2019-01-26,00:00:00,24,5,19,FMN GV 16 Berchem TOT
54,Posthofbrug 5366,2019-01-26,01:00:00,17,4,13,FMN GV 16 Berchem TOT
54,Posthofbrug 5366,2019-01-26,02:00:00,16,3,13,FMN GV 16 Berchem TOT
54,Posthofbrug 5366,2019-01-26,03:00:00,10,3,7,FMN GV 16 Berchem TOT
54,Posthofbrug 5366,2019-01-26,04:00:00,8,3,5,FMN GV 16 Berchem TOT
54,Posthofbrug 5366,2019-01-26,05:00:00,7,3,4,FMN GV 16 Berchem TOT
54,Posthofbrug 5366,2019-01-26,06:00:00,11,9,2,FMN GV 16 Berchem TOT
54,Posthofbrug 5366,2019-01-26,07:00:00,18,11,7,FMN GV 16 Berchem TOT
54,Posthofbrug 5366,2019-01-26,08:00:00,32,18,14,FMN GV 16 Berchem TOT
54,Posthofbrug 5366,2019-01-26,09:00:00,64,46,18,FMN GV 16 Berchem TOT
54,Posthofbrug 5366,2019-01-26,10:00:00,71,47,24,FMN GV 16 Berchem TOT
54,Posthofbrug 5366,2019-01-26,11:00:00,76,48,28,FMN GV 16 Berchem TOT
54,Posthofbrug 5366,2019-01-26,12:00:00,86,59,27,FMN GV 16 Berchem TOT
54,Posthofbrug 5366,2019-01-26,13:00:00,77,51,26,FMN GV 16 Berchem TOT
54,Posthofbrug 5366,2019-01-26,14:00:00,89,51,38,FMN GV 16 Berchem TOT
54,Posthofbrug 5366,2019-01-26,15:00:00,81,43,38,FMN GV 16 Berchem TOT
54,Posthofbrug 5366,2019-01-26,16:00:00,68,44,24,FMN GV 16 Berchem TOT
54,Posthofbrug 5366,2019-01-26,17:00:00,85,41,44,FMN GV 16 Berchem TOT
54,Posthofbrug 5366,2019-01-26,18:00:00,89,44,45,FMN GV 16 Berchem TOT
54,Posthofbrug 5366,2019-01-26,19:00:00,41,21,20,FMN GV 16 Berchem TOT
54,Posthofbrug 5366,2019-01-26,20:00:00,43,22,21,FMN GV 16 Berchem TOT
54,Posthofbrug 5366,2019-01-26,21:00:00,30,16,14,FMN GV 16 Berchem TOT
54,Posthofbrug 5366,2019-01-26,22:00:00,18,7,11,FMN GV 16 Berchem TOT
54,Posthofbrug 5366,2019-01-26,23:00:00,32,14,18,FMN GV 16 Berchem TOT
54,Posthofbrug 5366,2019-01-27,00:00:00,29,11,18,FMN GV 16 Berchem TOT
54,Posthofbrug 5366,2019-01-27,01:00:00,35,16,19,FMN GV 16 Berchem TOT
54,Posthofbrug 5366,2019-01-27,02:00:00,12,4,8,FMN GV 16 Berchem TOT
54,Posthofbrug 5366,2019-01-27,03:00:00,14,2,12,FMN GV 16 Berchem TOT
54,Posthofbrug 5366,2019-01-27,04:00:00,10,1,9,FMN GV 16 Berchem TOT
54,Posthofbrug 5366,2019-01-27,05:00:00,7,3,4,FMN GV 16 Berchem TOT
54,Posthofbrug 5366,2019-01-27,06:00:00,6,3,3,FMN GV 16 Berchem TOT
54,Posthofbrug 5366,2019-01-27,07:00:00,7,2,5,FMN GV 16 Berchem TOT
54,Posthofbrug 5366,2019-01-27,08:00:00,19,14,5,FMN GV 16 Berchem TOT
54,Posthofbrug 5366,2019-01-27,09:00:00,28,20,8,FMN GV 16 Berchem TOT
54,Posthofbrug 5366,2019-01-27,10:00:00,38,23,15,FMN GV 16 Berchem TOT
54,Posthofbrug 5366,2019-01-27,11:00:00,107,85,22,FMN GV 16 Berchem TOT
54,Posthofbrug 5366,2019-01-27,12:00:00,67,49,18,FMN GV 16 Berchem TOT
54,Posthofbrug 5366,2019-01-27,13:00:00,38,27,11,FMN GV 16 Berchem TOT
54,Posthofbrug 5366,2019-01-27,14:00:00,20,9,11,FMN GV 16 Berchem TOT
54,Posthofbrug 5366,2019-01-27,15:00:00,39,13,26,FMN GV 16 Berchem TOT
54,Posthofbrug 5366,2019-01-27,16:00:00,34,19,15,FMN GV 16 Berchem TOT
54,Posthofbrug 5366,2019-01-27,17:00:00,78,21,57,FMN GV 16 Berchem TOT
54,Posthofbrug 5366,2019-01-27,18:00:00,61,13,48,FMN GV 16 Berchem TOT
54,Posthofbrug 5366,2019-01-27,19:00:00,32,11,21,FMN GV 16 Berchem TOT
54,Posthofbrug 5366,2019-01-27,20:00:00,38,14,24,FMN GV 16 Berchem TOT
54,Posthofbrug 5366,2019-01-27,21:00:00,17,10,7,FMN GV 16 Berchem TOT
54,Posthofbrug 5366,2019-01-27,22:00:00,12,7,5,FMN GV 16 Berchem TOT
54,Posthofbrug 5366,2019-01-27,23:00:00,7,5,2,FMN GV 16 Berchem TOT
54,Posthofbrug 5366,2019-01-28,00:00:00,5,2,3,FMN GV 16 Berchem TOT
54,Posthofbrug 5366,2019-01-28,01:00:00,2,0,2,FMN GV 16 Berchem TOT
54,Posthofbrug 5366,2019-01-28,02:00:00,1,0,1,FMN GV 16 Berchem TOT
54,Posthofbrug 5366,2019-01-28,03:00:00,0,0,0,FMN GV 16 Berchem TOT
54,Posthofbrug 5366,2019-01-28,04:00:00,7,7,0,FMN GV 16 Berchem TOT
54,Posthofbrug 5366,2019-01-28,05:00:00,19,11,8,FMN GV 16 Berchem TOT
54,Posthofbrug 5366,2019-01-28,06:00:00,72,60,12,FMN GV 16 Berchem TOT
54,Posthofbrug 5366,2019-01-28,07:00:00,287,209,78,FMN GV 16 Berchem TOT
54,Posthofbrug 5366,2019-01-28,08:00:00,492,351,141,FMN GV 16 Berchem TOT
54,Posthofbrug 5366,2019-01-28,09:00:00,143,97,46,FMN GV 16 Berchem TOT
54,Posthofbrug 5366,2019-01-28,10:00:00,62,46,16,FMN GV 16 Berchem TOT
54,Posthofbrug 5366,2019-01-28,11:00:00,55,39,16,FMN GV 16 Berchem TOT
54,Posthofbrug 5366,2019-01-28,12:00:00,95,63,32,FMN GV 16 Berchem TOT
54,Posthofbrug 5366,2019-01-28,13:00:00,81,39,42,FMN GV 16 Berchem TOT
54,Posthofbrug 5366,2019-01-28,14:00:00,63,37,26,FMN GV 16 Berchem TOT
54,Posthofbrug 5366,2019-01-28,15:00:00,138,77,61,FMN GV 16 Berchem TOT
54,Posthofbrug 5366,2019-01-28,16:00:00,261,119,142,FMN GV 16 Berchem TOT
54,Posthofbrug 5366,2019-01-28,17:00:00,381,167,214,FMN GV 16 Berchem TOT
54,Posthofbrug 5366,2019-01-28,18:00:00,241,81,160,FMN GV 16 Berchem TOT
54,Posthofbrug 5366,2019-01-28,19:00:00,110,45,65,FMN GV 16 Berchem TOT
54,Posthofbrug 5366,2019-01-28,20:00:00,59,28,31,FMN GV 16 Berchem TOT
54,Posthofbrug 5366,2019-01-28,21:00:00,59,38,21,FMN GV 16 Berchem TOT
54,Posthofbrug 5366,2019-01-28,22:00:00,57,26,31,FMN GV 16 Berchem TOT
54,Posthofbrug 5366,2019-01-28,23:00:00,25,8,17,FMN GV 16 Berchem TOT
54,Posthofbrug 5366,2019-01-29,00:00:00,8,3,5,FMN GV 16 Berchem TOT
54,Posthofbrug 5366,2019-01-29,01:00:00,2,1,1,FMN GV 16 Berchem TOT
54,Posthofbrug 5366,2019-01-29,02:00:00,3,1,2,FMN GV 16 Berchem TOT
54,Posthofbrug 5366,2019-01-29,03:00:00,5,2,3,FMN GV 16 Berchem TOT
54,Posthofbrug 5366,2019-01-29,04:00:00,9,5,4,FMN GV 16 Berchem TOT
54,Posthofbrug 5366,2019-01-29,05:00:00,23,15,8,FMN GV 16 Berchem TOT
54,Posthofbrug 5366,2019-01-29,06:00:00,86,71,15,FMN GV 16 Berchem TOT
54,Posthofbrug 5366,2019-01-29,07:00:00,342,254,88,FMN GV 16 Berchem TOT
54,Posthofbrug 5366,2019-01-29,08:00:00,632,455,177,FMN GV 16 Berchem TOT
54,Posthofbrug 5366,2019-01-29,09:00:00,195,142,53,FMN GV 16 Berchem TOT
54,Posthofbrug 5366,2019-01-29,10:00:00,59,41,18,FMN GV 16 Berchem TOT
54,Posthofbrug 5366,2019-01-29,11:00:00,78,52,26,FMN GV 16 Berchem TOT
54,Posthofbrug 5366,2019-01-29,12:00:00,101,60,41,FMN GV 16 Berchem TOT
54,Posthofbrug 5366,2019-01-29,13:00:00,115,63,52,FMN GV 16 Berchem TOT
54,Posthofbrug 5366,2019-01-29,14:00:00,95,44,51,FMN GV 16 Berchem TOT
54,Posthofbrug 5366,2019-01-29,15:00:00,147,72,75,FMN GV 16 Berchem TOT
54,Posthofbrug 5366,2019-01-29,16:00:00,320,153,167,FMN GV 16 Berchem TOT
54,Posthofbrug 5366,2019-01-29,17:00:00,461,178,283,FMN GV 16 Berchem TOT
54,Posthofbrug 5366,2019-01-29,18:00:00,286,98,188,FMN GV 16 Berchem TOT
54,Posthofbrug 5366,2019-01-29,19:00:00,128,55,73,FMN GV 16 Berchem TOT
54,Posthofbrug 5366,2019-01-29,20:00:00,72,33,39,FMN GV 16 Berchem TOT
54,Posthofbrug 5366,2019-01-29,21:00:00,66,34,32,FMN GV 16 Berchem TOT
54,Posthofbrug 5366,2019-01-29,22:00:00,34,19,15,FMN GV 16 Berchem TOT
54,Posthofbrug 5366,2019-01-29,23:00:00,45,22,23,FMN GV 16 Berchem TOT
54,Posthofbrug 5366,2019-01-30,00:00:00,13,5,8,FMN GV 16 Berchem TOT
54,Posthofbrug 5366,2019-01-30,01:00:00,6,3,3,FMN GV 16 Berchem TOT
54,Posthofbrug 5366,2019-01-30,02:00:00,3,0,3,FMN GV 16 Berchem TOT
54,Posthofbrug 5366,2019-01-30,03:00:00,3,1,2,FMN GV 16 Berchem TOT
54,Posthofbrug 5366,2019-01-30,04:00:00,7,6,1,FMN GV 16 Berchem TOT
54,Posthofbrug 5366,2019-01-30,05:00:00,17,12,5,FMN GV 16 Berchem TOT
54,Posthofbrug 5366,2019-01-30,06:00:00,70,54,16,FMN GV 16 Berchem TOT
54,Posthofbrug 5366,2019-01-30,07:00:00,274,197,77,FMN GV 16 Berchem TOT
54,Posthofbrug 5366,2019-01-30,08:00:00,438,275,163,FMN GV 16 Berchem TOT
54,Posthofbrug 5366,2019-01-30,09:00:00,130,85,45,FMN GV 16 Berchem TOT
54,Posthofbrug 5366,2019-01-30,10:00:00,62,36,26,FMN GV 16 Berchem TOT
54,Posthofbrug 5366,2019-01-30,11:00:00,55,34,21,FMN GV 16 Berchem TOT
54,Posthofbrug 5366,2019-01-30,12:00:00,129,66,63,FMN GV 16 Berchem TOT
54,Posthofbrug 5366,2019-01-30,13:00:00,94,50,44,FMN GV 16 Berchem TOT
54,Posthofbrug 5366,2019-01-30,14:00:00,68,35,33,FMN GV 16 Berchem TOT
54,Posthofbrug 5366,2019-01-30,15:00:00,87,51,36,FMN GV 16 Berchem TOT
54,Posthofbrug 5366,2019-01-30,16:00:00,195,113,82,FMN GV 16 Berchem TOT
54,Posthofbrug 5366,2019-01-30,17:00:00,298,145,153,FMN GV 16 Berchem TOT
54,Posthofbrug 5366,2019-01-30,18:00:00,203,75,128,FMN GV 16 Berchem TOT
54,Posthofbrug 5366,2019-01-30,19:00:00,100,53,47,FMN GV 16 Berchem TOT
54,Posthofbrug 5366,2019-01-30,20:00:00,53,28,25,FMN GV 16 Berchem TOT
54,Posthofbrug 5366,2019-01-30,21:00:00,36,11,25,FMN GV 16 Berchem TOT
54,Posthofbrug 5366,2019-01-30,22:00:00,43,14,29,FMN GV 16 Berchem TOT
54,Posthofbrug 5366,2019-01-30,23:00:00,32,10,22,FMN GV 16 Berchem TOT
54,Posthofbrug 5366,2019-01-31,00:00:00,14,8,6,FMN GV 16 Berchem TOT
54,Posthofbrug 5366,2019-01-31,01:00:00,7,4,3,FMN GV 16 Berchem TOT
54,Posthofbrug 5366,2019-01-31,02:00:00,3,0,3,FMN GV 16 Berchem TOT
54,Posthofbrug 5366,2019-01-31,03:00:00,7,0,7,FMN GV 16 Berchem TOT
54,Posthofbrug 5366,2019-01-31,04:00:00,5,5,0,FMN GV 16 Berchem TOT
54,Posthofbrug 5366,2019-01-31,05:00:00,23,13,10,FMN GV 16 Berchem TOT
54,Posthofbrug 5366,2019-01-31,06:00:00,90,72,18,FMN GV 16 Berchem TOT
54,Posthofbrug 5366,2019-01-31,07:00:00,303,226,77,FMN GV 16 Berchem TOT
54,Posthofbrug 5366,2019-01-31,08:00:00,539,360,179,FMN GV 16 Berchem TOT
54,Posthofbrug 5366,2019-01-31,09:00:00,185,130,55,FMN GV 16 Berchem TOT
54,Posthofbrug 5366,2019-01-31,10:00:00,71,50,21,FMN GV 16 Berchem TOT
54,Posthofbrug 5366,2019-01-31,11:00:00,62,29,33,FMN GV 16 Berchem TOT
54,Posthofbrug 5366,2019-01-31,12:00:00,96,60,36,FMN GV 16 Berchem TOT
54,Posthofbrug 5366,2019-01-31,13:00:00,121,61,60,FMN GV 16 Berchem TOT
54,Posthofbrug 5366,2019-01-31,14:00:00,103,59,44,FMN GV 16 Berchem TOT
54,Posthofbrug 5366,2019-01-31,15:00:00,148,73,75,FMN GV 16 Berchem TOT
54,Posthofbrug 5366,2019-01-31,16:00:00,282,121,161,FMN GV 16 Berchem TOT
54,Posthofbrug 5366,2019-01-31,17:00:00,421,163,258,FMN GV 16 Berchem TOT
54,Posthofbrug 5366,2019-01-31,18:00:00,263,89,174,FMN GV 16 Berchem TOT
54,Posthofbrug 5366,2019-01-31,19:00:00,102,45,57,FMN GV 16 Berchem TOT
54,Posthofbrug 5366,2019-01-31,20:00:00,69,35,34,FMN GV 16 Berchem TOT
54,Posthofbrug 5366,2019-01-31,21:00:00,59,32,27,FMN GV 16 Berchem TOT
54,Posthofbrug 5366,2019-01-31,22:00:00,74,20,54,FMN GV 16 Berchem TOT
54,Posthofbrug 5366,2019-01-31,23:00:00,34,13,21,FMN GV 16 Berchem TOT
54,Posthofbrug 5366,2019-02-01,00:00:00,25,10,15,FMN GV 16 Berchem TOT
54,Posthofbrug 5366,2019-02-01,01:00:00,16,11,5,FMN GV 16 Berchem TOT
54,Posthofbrug 5366,2019-02-01,02:00:00,5,2,3,FMN GV 16 Berchem TOT
54,Posthofbrug 5366,2019-02-01,03:00:00,6,0,6,FMN GV 16 Berchem TOT
54,Posthofbrug 5366,2019-02-01,04:00:00,13,4,9,FMN GV 16 Berchem TOT
54,Posthofbrug 5366,2019-02-01,05:00:00,20,11,9,FMN GV 16 Berchem TOT
54,Posthofbrug 5366,2019-02-01,06:00:00,58,40,18,FMN GV 16 Berchem TOT
54,Posthofbrug 5366,2019-02-01,07:00:00,218,152,66,FMN GV 16 Berchem TOT
54,Posthofbrug 5366,2019-02-01,08:00:00,342,223,119,FMN GV 16 Berchem TOT
54,Posthofbrug 5366,2019-02-01,09:00:00,177,125,52,FMN GV 16 Berchem TOT
54,Posthofbrug 5366,2019-02-01,10:00:00,60,44,16,FMN GV 16 Berchem TOT
54,Posthofbrug 5366,2019-02-01,11:00:00,47,26,21,FMN GV 16 Berchem TOT
54,Posthofbrug 5366,2019-02-01,12:00:00,88,57,31,FMN GV 16 Berchem TOT
54,Posthofbrug 5366,2019-02-01,13:00:00,90,55,35,FMN GV 16 Berchem TOT
54,Posthofbrug 5366,2019-02-01,14:00:00,83,40,43,FMN GV 16 Berchem TOT
54,Posthofbrug 5366,2019-02-01,15:00:00,140,80,60,FMN GV 16 Berchem TOT
54,Posthofbrug 5366,2019-02-01,16:00:00,219,107,112,FMN GV 16 Berchem TOT
54,Posthofbrug 5366,2019-02-01,17:00:00,299,134,165,FMN GV 16 Berchem TOT
54,Posthofbrug 5366,2019-02-01,18:00:00,203,96,107,FMN GV 16 Berchem TOT
54,Posthofbrug 5366,2019-02-01,19:00:00,97,41,56,FMN GV 16 Berchem TOT
54,Posthofbrug 5366,2019-02-01,20:00:00,47,26,21,FMN GV 16 Berchem TOT
54,Posthofbrug 5366,2019-02-01,21:00:00,63,43,20,FMN GV 16 Berchem TOT
54,Posthofbrug 5366,2019-02-01,22:00:00,52,28,24,FMN GV 16 Berchem TOT
54,Posthofbrug 5366,2019-02-01,23:00:00,32,12,20,FMN GV 16 Berchem TOT
54,Posthofbrug 5366,2019-02-02,00:00:00,30,12,18,FMN GV 16 Berchem TOT
54,Posthofbrug 5366,2019-02-02,01:00:00,28,4,24,FMN GV 16 Berchem TOT
54,Posthofbrug 5366,2019-02-02,02:00:00,24,11,13,FMN GV 16 Berchem TOT
54,Posthofbrug 5366,2019-02-02,03:00:00,3,2,1,FMN GV 16 Berchem TOT
54,Posthofbrug 5366,2019-02-02,04:00:00,15,3,12,FMN GV 16 Berchem TOT
54,Posthofbrug 5366,2019-02-02,05:00:00,9,5,4,FMN GV 16 Berchem TOT
54,Posthofbrug 5366,2019-02-02,06:00:00,7,4,3,FMN GV 16 Berchem TOT
54,Posthofbrug 5366,2019-02-02,07:00:00,15,12,3,FMN GV 16 Berchem TOT
54,Posthofbrug 5366,2019-02-02,08:00:00,23,11,12,FMN GV 16 Berchem TOT
54,Posthofbrug 5366,2019-02-02,09:00:00,48,25,23,FMN GV 16 Berchem TOT
54,Posthofbrug 5366,2019-02-02,10:00:00,44,23,21,FMN GV 16 Berchem TOT
54,Posthofbrug 5366,2019-02-02,11:00:00,49,31,18,FMN GV 16 Berchem TOT
54,Posthofbrug 5366,2019-02-02,12:00:00,32,25,7,FMN GV 16 Berchem TOT
54,Posthofbrug 5366,2019-02-02,13:00:00,55,44,11,FMN GV 16 Berchem TOT
54,Posthofbrug 5366,2019-02-02,14:00:00,47,30,17,FMN GV 16 Berchem TOT
54,Posthofbrug 5366,2019-02-02,15:00:00,59,35,24,FMN GV 16 Berchem TOT
54,Posthofbrug 5366,2019-02-02,16:00:00,22,13,9,FMN GV 16 Berchem TOT
54,Posthofbrug 5366,2019-02-02,17:00:00,49,23,26,FMN GV 16 Berchem TOT
54,Posthofbrug 5366,2019-02-02,18:00:00,48,28,20,FMN GV 16 Berchem TOT
54,Posthofbrug 5366,2019-02-02,19:00:00,40,28,12,FMN GV 16 Berchem TOT
54,Posthofbrug 5366,2019-02-02,20:00:00,30,17,13,FMN GV 16 Berchem TOT
54,Posthofbrug 5366,2019-02-02,21:00:00,35,25,10,FMN GV 16 Berchem TOT
54,Posthofbrug 5366,2019-02-02,22:00:00,26,10,16,FMN GV 16 Berchem TOT
54,Posthofbrug 5366,2019-02-02,23:00:00,30,5,25,FMN GV 16 Berchem TOT
54,Posthofbrug 5366,2019-02-03,00:00:00,26,11,15,FMN GV 16 Berchem TOT
54,Posthofbrug 5366,2019-02-03,01:00:00,15,6,9,FMN GV 16 Berchem TOT
54,Posthofbrug 5366,2019-02-03,02:00:00,9,3,6,FMN GV 16 Berchem TOT
54,Posthofbrug 5366,2019-02-03,03:00:00,7,3,4,FMN GV 16 Berchem TOT
54,Posthofbrug 5366,2019-02-03,04:00:00,10,1,9,FMN GV 16 Berchem TOT
54,Posthofbrug 5366,2019-02-03,05:00:00,5,3,2,FMN GV 16 Berchem TOT
54,Posthofbrug 5366,2019-02-03,06:00:00,12,5,7,FMN GV 16 Berchem TOT
54,Posthofbrug 5366,2019-02-03,07:00:00,9,4,5,FMN GV 16 Berchem TOT
54,Posthofbrug 5366,2019-02-03,08:00:00,23,14,9,FMN GV 16 Berchem TOT
54,Posthofbrug 5366,2019-02-03,09:00:00,47,26,21,FMN GV 16 Berchem TOT
54,Posthofbrug 5366,2019-02-03,10:00:00,67,36,31,FMN GV 16 Berchem TOT
54,Posthofbrug 5366,2019-02-03,11:00:00,58,42,16,FMN GV 16 Berchem TOT
54,Posthofbrug 5366,2019-02-03,12:00:00,97,56,41,FMN GV 16 Berchem TOT
54,Posthofbrug 5366,2019-02-03,13:00:00,77,48,29,FMN GV 16 Berchem TOT
54,Posthofbrug 5366,2019-02-03,14:00:00,99,43,56,FMN GV 16 Berchem TOT
54,Posthofbrug 5366,2019-02-03,15:00:00,62,38,24,FMN GV 16 Berchem TOT
54,Posthofbrug 5366,2019-02-03,16:00:00,68,33,35,FMN GV 16 Berchem TOT
54,Posthofbrug 5366,2019-02-03,17:00:00,55,30,25,FMN GV 16 Berchem TOT
54,Posthofbrug 5366,2019-02-03,18:00:00,59,31,28,FMN GV 16 Berchem TOT
54,Posthofbrug 5366,2019-02-03,19:00:00,38,16,22,FMN GV 16 Berchem TOT
54,Posthofbrug 5366,2019-02-03,20:00:00,29,13,16,FMN GV 16 Berchem TOT
54,Posthofbrug 5366,2019-02-03,21:00:00,20,9,11,FMN GV 16 Berchem TOT
54,Posthofbrug 5366,2019-02-03,22:00:00,23,11,12,FMN GV 16 Berchem TOT
54,Posthofbrug 5366,2019-02-03,23:00:00,20,6,14,FMN GV 16 Berchem TOT
54,Posthofbrug 5366,2019-02-04,00:00:00,7,1,6,FMN GV 16 Berchem TOT
54,Posthofbrug 5366,2019-02-04,01:00:00,2,1,1,FMN GV 16 Berchem TOT
54,Posthofbrug 5366,2019-02-04,02:00:00,2,0,2,FMN GV 16 Berchem TOT
54,Posthofbrug 5366,2019-02-04,03:00:00,1,1,0,FMN GV 16 Berchem TOT
54,Posthofbrug 5366,2019-02-04,04:00:00,3,2,1,FMN GV 16 Berchem TOT
54,Posthofbrug 5366,2019-02-04,05:00:00,18,11,7,FMN GV 16 Berchem TOT
54,Posthofbrug 5366,2019-02-04,06:00:00,89,75,14,FMN GV 16 Berchem TOT
54,Posthofbrug 5366,2019-02-04,07:00:00,325,245,80,FMN GV 16 Berchem TOT
54,Posthofbrug 5366,2019-02-04,08:00:00,560,376,184,FMN GV 16 Berchem TOT
54,Posthofbrug 5366,2019-02-04,09:00:00,168,118,50,FMN GV 16 Berchem TOT
54,Posthofbrug 5366,2019-02-04,10:00:00,81,49,32,FMN GV 16 Berchem TOT
54,Posthofbrug 5366,2019-02-04,11:00:00,72,38,34,FMN GV 16 Berchem TOT
54,Posthofbrug 5366,2019-02-04,12:00:00,86,55,31,FMN GV 16 Berchem TOT
54,Posthofbrug 5366,2019-02-04,13:00:00,73,45,28,FMN GV 16 Berchem TOT
54,Posthofbrug 5366,2019-02-04,14:00:00,76,29,47,FMN GV 16 Berchem TOT
54,Posthofbrug 5366,2019-02-04,15:00:00,141,67,74,FMN GV 16 Berchem TOT
54,Posthofbrug 5366,2019-02-04,16:00:00,304,124,180,FMN GV 16 Berchem TOT
54,Posthofbrug 5366,2019-02-04,17:00:00,414,140,274,FMN GV 16 Berchem TOT
54,Posthofbrug 5366,2019-02-04,18:00:00,263,99,164,FMN GV 16 Berchem TOT
54,Posthofbrug 5366,2019-02-04,19:00:00,104,42,62,FMN GV 16 Berchem TOT
54,Posthofbrug 5366,2019-02-04,20:00:00,60,21,39,FMN GV 16 Berchem TOT
54,Posthofbrug 5366,2019-02-04,21:00:00,56,28,28,FMN GV 16 Berchem TOT
54,Posthofbrug 5366,2019-02-04,22:00:00,44,27,17,FMN GV 16 Berchem TOT
54,Posthofbrug 5366,2019-02-04,23:00:00,18,5,13,FMN GV 16 Berchem TOT
54,Posthofbrug 5366,2019-02-05,00:00:00,12,2,10,FMN GV 16 Berchem TOT
54,Posthofbrug 5366,2019-02-05,01:00:00,1,0,1,FMN GV 16 Berchem TOT
54,Posthofbrug 5366,2019-02-05,02:00:00,3,1,2,FMN GV 16 Berchem TOT
54,Posthofbrug 5366,2019-02-05,03:00:00,4,4,0,FMN GV 16 Berchem TOT
54,Posthofbrug 5366,2019-02-05,04:00:00,5,4,1,FMN GV 16 Berchem TOT
54,Posthofbrug 5366,2019-02-05,05:00:00,21,11,10,FMN GV 16 Berchem TOT
54,Posthofbrug 5366,2019-02-05,06:00:00,108,91,17,FMN GV 16 Berchem TOT
54,Posthofbrug 5366,2019-02-05,07:00:00,412,298,114,FMN GV 16 Berchem TOT
54,Posthofbrug 5366,2019-02-05,08:00:00,684,474,210,FMN GV 16 Berchem TOT
54,Posthofbrug 5366,2019-02-05,09:00:00,205,147,58,FMN GV 16 Berchem TOT
54,Posthofbrug 5366,2019-02-05,10:00:00,83,57,26,FMN GV 16 Berchem TOT
54,Posthofbrug 5366,2019-02-05,11:00:00,77,57,20,FMN GV 16 Berchem TOT
54,Posthofbrug 5366,2019-02-05,12:00:00,124,85,39,FMN GV 16 Berchem TOT
54,Posthofbrug 5366,2019-02-05,13:00:00,97,47,50,FMN GV 16 Berchem TOT
54,Posthofbrug 5366,2019-02-05,14:00:00,90,54,36,FMN GV 16 Berchem TOT
54,Posthofbrug 5366,2019-02-05,15:00:00,177,91,86,FMN GV 16 Berchem TOT
54,Posthofbrug 5366,2019-02-05,16:00:00,369,170,199,FMN GV 16 Berchem TOT
54,Posthofbrug 5366,2019-02-05,17:00:00,501,182,319,FMN GV 16 Berchem TOT
54,Posthofbrug 5366,2019-02-05,18:00:00,299,114,185,FMN GV 16 Berchem TOT
54,Posthofbrug 5366,2019-02-05,19:00:00,128,58,70,FMN GV 16 Berchem TOT
54,Posthofbrug 5366,2019-02-05,20:00:00,91,30,61,FMN GV 16 Berchem TOT
54,Posthofbrug 5366,2019-02-05,21:00:00,58,32,26,FMN GV 16 Berchem TOT
54,Posthofbrug 5366,2019-02-05,22:00:00,58,30,28,FMN GV 16 Berchem TOT
54,Posthofbrug 5366,2019-02-05,23:00:00,37,13,24,FMN GV 16 Berchem TOT
54,Posthofbrug 5366,2019-02-06,00:00:00,13,6,7,FMN GV 16 Berchem TOT
54,Posthofbrug 5366,2019-02-06,01:00:00,7,1,6,FMN GV 16 Berchem TOT
54,Posthofbrug 5366,2019-02-06,02:00:00,3,0,3,FMN GV 16 Berchem TOT
54,Posthofbrug 5366,2019-02-06,03:00:00,1,1,0,FMN GV 16 Berchem TOT
54,Posthofbrug 5366,2019-02-06,04:00:00,3,2,1,FMN GV 16 Berchem TOT
54,Posthofbrug 5366,2019-02-06,05:00:00,16,8,8,FMN GV 16 Berchem TOT
54,Posthofbrug 5366,2019-02-06,06:00:00,102,87,15,FMN GV 16 Berchem TOT
54,Posthofbrug 5366,2019-02-06,07:00:00,338,236,102,FMN GV 16 Berchem TOT
54,Posthofbrug 5366,2019-02-06,08:00:00,588,395,193,FMN GV 16 Berchem TOT
54,Posthofbrug 5366,2019-02-06,09:00:00,178,114,64,FMN GV 16 Berchem TOT
54,Posthofbrug 5366,2019-02-06,10:00:00,72,51,21,FMN GV 16 Berchem TOT
54,Posthofbrug 5366,2019-02-06,11:00:00,85,39,46,FMN GV 16 Berchem TOT
54,Posthofbrug 5366,2019-02-06,12:00:00,173,93,80,FMN GV 16 Berchem TOT
54,Posthofbrug 5366,2019-02-06,13:00:00,116,55,61,FMN GV 16 Berchem TOT
54,Posthofbrug 5366,2019-02-06,14:00:00,90,46,44,FMN GV 16 Berchem TOT
54,Posthofbrug 5366,2019-02-06,15:00:00,106,58,48,FMN GV 16 Berchem TOT
54,Posthofbrug 5366,2019-02-06,16:00:00,249,135,114,FMN GV 16 Berchem TOT
54,Posthofbrug 5366,2019-02-06,17:00:00,399,188,211,FMN GV 16 Berchem TOT
54,Posthofbrug 5366,2019-02-06,18:00:00,237,96,141,FMN GV 16 Berchem TOT
54,Posthofbrug 5366,2019-02-06,19:00:00,106,50,56,FMN GV 16 Berchem TOT
54,Posthofbrug 5366,2019-02-06,20:00:00,58,28,30,FMN GV 16 Berchem TOT
54,Posthofbrug 5366,2019-02-06,21:00:00,47,18,29,FMN GV 16 Berchem TOT
54,Posthofbrug 5366,2019-02-06,22:00:00,41,22,19,FMN GV 16 Berchem TOT
54,Posthofbrug 5366,2019-02-06,23:00:00,23,7,16,FMN GV 16 Berchem TOT
54,Posthofbrug 5366,2019-02-07,00:00:00,12,0,12,FMN GV 16 Berchem TOT
54,Posthofbrug 5366,2019-02-07,01:00:00,4,2,2,FMN GV 16 Berchem TOT
54,Posthofbrug 5366,2019-02-07,02:00:00,1,0,1,FMN GV 16 Berchem TOT
54,Posthofbrug 5366,2019-02-07,03:00:00,3,1,2,FMN GV 16 Berchem TOT
54,Posthofbrug 5366,2019-02-07,04:00:00,7,5,2,FMN GV 16 Berchem TOT
54,Posthofbrug 5366,2019-02-07,05:00:00,12,7,5,FMN GV 16 Berchem TOT
54,Posthofbrug 5366,2019-02-07,06:00:00,95,70,25,FMN GV 16 Berchem TOT
54,Posthofbrug 5366,2019-02-07,07:00:00,331,225,106,FMN GV 16 Berchem TOT
54,Posthofbrug 5366,2019-02-07,08:00:00,629,438,191,FMN GV 16 Berchem TOT
54,Posthofbrug 5366,2019-02-07,09:00:00,183,140,43,FMN GV 16 Berchem TOT
54,Posthofbrug 5366,2019-02-07,10:00:00,86,63,23,FMN GV 16 Berchem TOT
54,Posthofbrug 5366,2019-02-07,11:00:00,78,53,25,FMN GV 16 Berchem TOT
54,Posthofbrug 5366,2019-02-07,12:00:00,96,54,42,FMN GV 16 Berchem TOT
54,Posthofbrug 5366,2019-02-07,13:00:00,101,54,47,FMN GV 16 Berchem TOT
54,Posthofbrug 5366,2019-02-07,14:00:00,86,37,49,FMN GV 16 Berchem TOT
54,Posthofbrug 5366,2019-02-07,15:00:00,184,104,80,FMN GV 16 Berchem TOT
54,Posthofbrug 5366,2019-02-07,16:00:00,303,147,156,FMN GV 16 Berchem TOT
54,Posthofbrug 5366,2019-02-07,17:00:00,422,199,223,FMN GV 16 Berchem TOT
54,Posthofbrug 5366,2019-02-07,18:00:00,233,85,148,FMN GV 16 Berchem TOT
54,Posthofbrug 5366,2019-02-07,19:00:00,136,69,67,FMN GV 16 Berchem TOT
54,Posthofbrug 5366,2019-02-07,20:00:00,75,32,43,FMN GV 16 Berchem TOT
54,Posthofbrug 5366,2019-02-07,21:00:00,57,27,30,FMN GV 16 Berchem TOT
54,Posthofbrug 5366,2019-02-07,22:00:00,51,20,31,FMN GV 16 Berchem TOT
54,Posthofbrug 5366,2019-02-07,23:00:00,37,12,25,FMN GV 16 Berchem TOT
54,Posthofbrug 5366,2019-02-08,00:00:00,27,6,21,FMN GV 16 Berchem TOT
54,Posthofbrug 5366,2019-02-08,01:00:00,8,2,6,FMN GV 16 Berchem TOT
54,Posthofbrug 5366,2019-02-08,02:00:00,3,2,1,FMN GV 16 Berchem TOT
54,Posthofbrug 5366,2019-02-08,03:00:00,9,4,5,FMN GV 16 Berchem TOT
54,Posthofbrug 5366,2019-02-08,04:00:00,6,6,0,FMN GV 16 Berchem TOT
54,Posthofbrug 5366,2019-02-08,05:00:00,20,11,9,FMN GV 16 Berchem TOT
54,Posthofbrug 5366,2019-02-08,06:00:00,78,60,18,FMN GV 16 Berchem TOT
54,Posthofbrug 5366,2019-02-08,07:00:00,266,177,89,FMN GV 16 Berchem TOT
54,Posthofbrug 5366,2019-02-08,08:00:00,486,318,168,FMN GV 16 Berchem TOT
54,Posthofbrug 5366,2019-02-08,09:00:00,164,123,41,FMN GV 16 Berchem TOT
54,Posthofbrug 5366,2019-02-08,10:00:00,79,53,26,FMN GV 16 Berchem TOT
54,Posthofbrug 5366,2019-02-08,11:00:00,64,43,21,FMN GV 16 Berchem TOT
54,Posthofbrug 5366,2019-02-08,12:00:00,101,56,45,FMN GV 16 Berchem TOT
54,Posthofbrug 5366,2019-02-08,13:00:00,85,50,35,FMN GV 16 Berchem TOT
54,Posthofbrug 5366,2019-02-08,14:00:00,100,50,50,FMN GV 16 Berchem TOT
54,Posthofbrug 5366,2019-02-08,15:00:00,172,90,82,FMN GV 16 Berchem TOT
54,Posthofbrug 5366,2019-02-08,16:00:00,289,145,144,FMN GV 16 Berchem TOT
54,Posthofbrug 5366,2019-02-08,17:00:00,332,148,184,FMN GV 16 Berchem TOT
54,Posthofbrug 5366,2019-02-08,18:00:00,195,84,111,FMN GV 16 Berchem TOT
54,Posthofbrug 5366,2019-02-08,19:00:00,117,60,57,FMN GV 16 Berchem TOT
54,Posthofbrug 5366,2019-02-08,20:00:00,77,35,42,FMN GV 16 Berchem TOT
54,Posthofbrug 5366,2019-02-08,21:00:00,31,23,8,FMN GV 16 Berchem TOT
54,Posthofbrug 5366,2019-02-08,22:00:00,46,18,28,FMN GV 16 Berchem TOT
54,Posthofbrug 5366,2019-02-08,23:00:00,37,15,22,FMN GV 16 Berchem TOT
54,Posthofbrug 5366,2019-02-09,00:00:00,31,13,18,FMN GV 16 Berchem TOT
54,Posthofbrug 5366,2019-02-09,01:00:00,19,6,13,FMN GV 16 Berchem TOT
54,Posthofbrug 5366,2019-02-09,02:00:00,16,2,14,FMN GV 16 Berchem TOT
54,Posthofbrug 5366,2019-02-09,03:00:00,14,2,12,FMN GV 16 Berchem TOT
54,Posthofbrug 5366,2019-02-09,04:00:00,10,1,9,FMN GV 16 Berchem TOT
54,Posthofbrug 5366,2019-02-09,05:00:00,7,6,1,FMN GV 16 Berchem TOT
54,Posthofbrug 5366,2019-02-09,06:00:00,15,5,10,FMN GV 16 Berchem TOT
54,Posthofbrug 5366,2019-02-09,07:00:00,20,11,9,FMN GV 16 Berchem TOT
54,Posthofbrug 5366,2019-02-09,08:00:00,42,22,20,FMN GV 16 Berchem TOT
54,Posthofbrug 5366,2019-02-09,09:00:00,43,24,19,FMN GV 16 Berchem TOT
54,Posthofbrug 5366,2019-02-09,10:00:00,50,26,24,FMN GV 16 Berchem TOT
54,Posthofbrug 5366,2019-02-09,11:00:00,57,41,16,FMN GV 16 Berchem TOT
54,Posthofbrug 5366,2019-02-09,12:00:00,68,38,30,FMN GV 16 Berchem TOT
54,Posthofbrug 5366,2019-02-09,13:00:00,59,35,24,FMN GV 16 Berchem TOT
54,Posthofbrug 5366,2019-02-09,14:00:00,70,45,25,FMN GV 16 Berchem TOT
54,Posthofbrug 5366,2019-02-09,15:00:00,70,41,29,FMN GV 16 Berchem TOT
54,Posthofbrug 5366,2019-02-09,16:00:00,68,32,36,FMN GV 16 Berchem TOT
54,Posthofbrug 5366,2019-02-09,17:00:00,66,33,33,FMN GV 16 Berchem TOT
54,Posthofbrug 5366,2019-02-09,18:00:00,60,32,28,FMN GV 16 Berchem TOT
54,Posthofbrug 5366,2019-02-09,19:00:00,64,40,24,FMN GV 16 Berchem TOT
54,Posthofbrug 5366,2019-02-09,20:00:00,33,20,13,FMN GV 16 Berchem TOT
54,Posthofbrug 5366,2019-02-09,21:00:00,35,23,12,FMN GV 16 Berchem TOT
54,Posthofbrug 5366,2019-02-09,22:00:00,34,19,15,FMN GV 16 Berchem TOT
54,Posthofbrug 5366,2019-02-09,23:00:00,46,24,22,FMN GV 16 Berchem TOT
54,Posthofbrug 5366,2019-02-10,00:00:00,73,27,46,FMN GV 16 Berchem TOT
54,Posthofbrug 5366,2019-02-10,01:00:00,23,8,15,FMN GV 16 Berchem TOT
54,Posthofbrug 5366,2019-02-10,02:00:00,19,6,13,FMN GV 16 Berchem TOT
54,Posthofbrug 5366,2019-02-10,03:00:00,9,5,4,FMN GV 16 Berchem TOT
54,Posthofbrug 5366,2019-02-10,04:00:00,11,5,6,FMN GV 16 Berchem TOT
54,Posthofbrug 5366,2019-02-10,05:00:00,6,2,4,FMN GV 16 Berchem TOT
54,Posthofbrug 5366,2019-02-10,06:00:00,13,5,8,FMN GV 16 Berchem TOT
54,Posthofbrug 5366,2019-02-10,07:00:00,9,5,4,FMN GV 16 Berchem TOT
54,Posthofbrug 5366,2019-02-10,08:00:00,17,8,9,FMN GV 16 Berchem TOT
54,Posthofbrug 5366,2019-02-10,09:00:00,42,23,19,FMN GV 16 Berchem TOT
54,Posthofbrug 5366,2019-02-10,10:00:00,37,26,11,FMN GV 16 Berchem TOT
54,Posthofbrug 5366,2019-02-10,11:00:00,39,25,14,FMN GV 16 Berchem TOT
54,Posthofbrug 5366,2019-02-10,12:00:00,52,35,17,FMN GV 16 Berchem TOT
54,Posthofbrug 5366,2019-02-10,13:00:00,47,28,19,FMN GV 16 Berchem TOT
54,Posthofbrug 5366,2019-02-10,14:00:00,33,21,12,FMN GV 16 Berchem TOT
54,Posthofbrug 5366,2019-02-10,15:00:00,35,17,18,FMN GV 16 Berchem TOT
54,Posthofbrug 5366,2019-02-10,16:00:00,23,10,13,FMN GV 16 Berchem TOT
54,Posthofbrug 5366,2019-02-10,17:00:00,42,23,19,FMN GV 16 Berchem TOT
54,Posthofbrug 5366,2019-02-10,18:00:00,35,16,19,FMN GV 16 Berchem TOT
54,Posthofbrug 5366,2019-02-10,19:00:00,32,13,19,FMN GV 16 Berchem TOT
54,Posthofbrug 5366,2019-02-10,20:00:00,19,6,13,FMN GV 16 Berchem TOT
54,Posthofbrug 5366,2019-02-10,21:00:00,19,9,10,FMN GV 16 Berchem TOT
54,Posthofbrug 5366,2019-02-10,22:00:00,15,8,7,FMN GV 16 Berchem TOT
54,Posthofbrug 5366,2019-02-10,23:00:00,10,5,5,FMN GV 16 Berchem TOT
54,Posthofbrug 5366,2019-02-11,00:00:00,6,3,3,FMN GV 16 Berchem TOT
54,Posthofbrug 5366,2019-02-11,01:00:00,2,0,2,FMN GV 16 Berchem TOT
54,Posthofbrug 5366,2019-02-11,02:00:00,1,0,1,FMN GV 16 Berchem TOT
54,Posthofbrug 5366,2019-02-11,03:00:00,2,2,0,FMN GV 16 Berchem TOT
54,Posthofbrug 5366,2019-02-11,04:00:00,2,2,0,FMN GV 16 Berchem TOT
54,Posthofbrug 5366,2019-02-11,05:00:00,20,13,7,FMN GV 16 Berchem TOT
54,Posthofbrug 5366,2019-02-11,06:00:00,85,65,20,FMN GV 16 Berchem TOT
54,Posthofbrug 5366,2019-02-11,07:00:00,379,283,96,FMN GV 16 Berchem TOT
54,Posthofbrug 5366,2019-02-11,08:00:00,633,443,190,FMN GV 16 Berchem TOT
54,Posthofbrug 5366,2019-02-11,09:00:00,214,143,71,FMN GV 16 Berchem TOT
54,Posthofbrug 5366,2019-02-11,10:00:00,90,61,29,FMN GV 16 Berchem TOT
54,Posthofbrug 5366,2019-02-11,11:00:00,86,56,30,FMN GV 16 Berchem TOT
54,Posthofbrug 5366,2019-02-11,12:00:00,108,74,34,FMN GV 16 Berchem TOT
54,Posthofbrug 5366,2019-02-11,13:00:00,106,69,37,FMN GV 16 Berchem TOT
54,Posthofbrug 5366,2019-02-11,14:00:00,108,57,51,FMN GV 16 Berchem TOT
54,Posthofbrug 5366,2019-02-11,15:00:00,186,89,97,FMN GV 16 Berchem TOT
54,Posthofbrug 5366,2019-02-11,16:00:00,362,157,205,FMN GV 16 Berchem TOT
54,Posthofbrug 5366,2019-02-11,17:00:00,454,181,273,FMN GV 16 Berchem TOT
54,Posthofbrug 5366,2019-02-11,18:00:00,315,128,187,FMN GV 16 Berchem TOT
54,Posthofbrug 5366,2019-02-11,19:00:00,122,62,60,FMN GV 16 Berchem TOT
54,Posthofbrug 5366,2019-02-11,20:00:00,71,28,43,FMN GV 16 Berchem TOT
54,Posthofbrug 5366,2019-02-11,21:00:00,51,19,32,FMN GV 16 Berchem TOT
54,Posthofbrug 5366,2019-02-11,22:00:00,43,17,26,FMN GV 16 Berchem TOT
54,Posthofbrug 5366,2019-02-11,23:00:00,30,10,20,FMN GV 16 Berchem TOT
54,Posthofbrug 5366,2019-02-12,00:00:00,6,5,1,FMN GV 16 Berchem TOT
54,Posthofbrug 5366,2019-02-12,01:00:00,4,1,3,FMN GV 16 Berchem TOT
54,Posthofbrug 5366,2019-02-12,02:00:00,6,4,2,FMN GV 16 Berchem TOT
54,Posthofbrug 5366,2019-02-12,03:00:00,1,0,1,FMN GV 16 Berchem TOT
54,Posthofbrug 5366,2019-02-12,04:00:00,4,3,1,FMN GV 16 Berchem TOT
54,Posthofbrug 5366,2019-02-12,05:00:00,19,12,7,FMN GV 16 Berchem TOT
54,Posthofbrug 5366,2019-02-12,06:00:00,93,71,22,FMN GV 16 Berchem TOT
54,Posthofbrug 5366,2019-02-12,07:00:00,419,308,111,FMN GV 16 Berchem TOT
54,Posthofbrug 5366,2019-02-12,08:00:00,736,498,238,FMN GV 16 Berchem TOT
54,Posthofbrug 5366,2019-02-12,09:00:00,249,179,70,FMN GV 16 Berchem TOT
54,Posthofbrug 5366,2019-02-12,10:00:00,117,82,35,FMN GV 16 Berchem TOT
54,Posthofbrug 5366,2019-02-12,11:00:00,83,54,29,FMN GV 16 Berchem TOT
54,Posthofbrug 5366,2019-02-12,12:00:00,128,76,52,FMN GV 16 Berchem TOT
54,Posthofbrug 5366,2019-02-12,13:00:00,112,68,44,FMN GV 16 Berchem TOT
54,Posthofbrug 5366,2019-02-12,14:00:00,101,51,50,FMN GV 16 Berchem TOT
54,Posthofbrug 5366,2019-02-12,15:00:00,184,90,94,FMN GV 16 Berchem TOT
54,Posthofbrug 5366,2019-02-12,16:00:00,409,191,218,FMN GV 16 Berchem TOT
54,Posthofbrug 5366,2019-02-12,17:00:00,519,205,314,FMN GV 16 Berchem TOT
54,Posthofbrug 5366,2019-02-12,18:00:00,322,124,198,FMN GV 16 Berchem TOT
54,Posthofbrug 5366,2019-02-12,19:00:00,155,70,85,FMN GV 16 Berchem TOT
54,Posthofbrug 5366,2019-02-12,20:00:00,78,25,53,FMN GV 16 Berchem TOT
54,Posthofbrug 5366,2019-02-12,21:00:00,62,25,37,FMN GV 16 Berchem TOT
54,Posthofbrug 5366,2019-02-12,22:00:00,73,23,50,FMN GV 16 Berchem TOT
54,Posthofbrug 5366,2019-02-12,23:00:00,43,13,30,FMN GV 16 Berchem TOT
54,Posthofbrug 5366,2019-02-13,00:00:00,8,2,6,FMN GV 16 Berchem TOT
54,Posthofbrug 5366,2019-02-13,01:00:00,4,1,3,FMN GV 16 Berchem TOT
54,Posthofbrug 5366,2019-02-13,02:00:00,5,2,3,FMN GV 16 Berchem TOT
54,Posthofbrug 5366,2019-02-13,03:00:00,5,3,2,FMN GV 16 Berchem TOT
54,Posthofbrug 5366,2019-02-13,04:00:00,6,4,2,FMN GV 16 Berchem TOT
54,Posthofbrug 5366,2019-02-13,05:00:00,19,10,9,FMN GV 16 Berchem TOT
54,Posthofbrug 5366,2019-02-13,06:00:00,75,53,22,FMN GV 16 Berchem TOT
54,Posthofbrug 5366,2019-02-13,07:00:00,322,237,85,FMN GV 16 Berchem TOT
54,Posthofbrug 5366,2019-02-13,08:00:00,558,386,172,FMN GV 16 Berchem TOT
54,Posthofbrug 5366,2019-02-13,09:00:00,226,159,67,FMN GV 16 Berchem TOT
54,Posthofbrug 5366,2019-02-13,10:00:00,131,92,39,FMN GV 16 Berchem TOT
54,Posthofbrug 5366,2019-02-13,11:00:00,139,87,52,FMN GV 16 Berchem TOT
54,Posthofbrug 5366,2019-02-13,12:00:00,232,137,95,FMN GV 16 Berchem TOT
54,Posthofbrug 5366,2019-02-13,13:00:00,218,122,96,FMN GV 16 Berchem TOT
54,Posthofbrug 5366,2019-02-13,14:00:00,148,68,80,FMN GV 16 Berchem TOT
54,Posthofbrug 5366,2019-02-13,15:00:00,171,73,98,FMN GV 16 Berchem TOT
54,Posthofbrug 5366,2019-02-13,16:00:00,326,138,188,FMN GV 16 Berchem TOT
54,Posthofbrug 5366,2019-02-13,17:00:00,429,171,258,FMN GV 16 Berchem TOT
54,Posthofbrug 5366,2019-02-13,18:00:00,315,130,185,FMN GV 16 Berchem TOT
54,Posthofbrug 5366,2019-02-13,19:00:00,169,93,76,FMN GV 16 Berchem TOT
54,Posthofbrug 5366,2019-02-13,20:00:00,89,45,44,FMN GV 16 Berchem TOT
54,Posthofbrug 5366,2019-02-13,21:00:00,70,34,36,FMN GV 16 Berchem TOT
54,Posthofbrug 5366,2019-02-13,22:00:00,80,28,52,FMN GV 16 Berchem TOT
54,Posthofbrug 5366,2019-02-13,23:00:00,51,15,36,FMN GV 16 Berchem TOT
54,Posthofbrug 5366,2019-02-14,00:00:00,16,6,10,FMN GV 16 Berchem TOT
54,Posthofbrug 5366,2019-02-14,01:00:00,4,1,3,FMN GV 16 Berchem TOT
54,Posthofbrug 5366,2019-02-14,02:00:00,2,0,2,FMN GV 16 Berchem TOT
54,Posthofbrug 5366,2019-02-14,03:00:00,1,1,0,FMN GV 16 Berchem TOT
54,Posthofbrug 5366,2019-02-14,04:00:00,4,3,1,FMN GV 16 Berchem TOT
54,Posthofbrug 5366,2019-02-14,05:00:00,22,10,12,FMN GV 16 Berchem TOT
54,Posthofbrug 5366,2019-02-14,06:00:00,107,88,19,FMN GV 16 Berchem TOT
54,Posthofbrug 5366,2019-02-14,07:00:00,402,290,112,FMN GV 16 Berchem TOT
54,Posthofbrug 5366,2019-02-14,08:00:00,679,438,241,FMN GV 16 Berchem TOT
54,Posthofbrug 5366,2019-02-14,09:00:00,243,165,78,FMN GV 16 Berchem TOT
54,Posthofbrug 5366,2019-02-14,10:00:00,116,84,32,FMN GV 16 Berchem TOT
54,Posthofbrug 5366,2019-02-14,11:00:00,94,56,38,FMN GV 16 Berchem TOT
54,Posthofbrug 5366,2019-02-14,12:00:00,142,101,41,FMN GV 16 Berchem TOT
54,Posthofbrug 5366,2019-02-14,13:00:00,167,100,67,FMN GV 16 Berchem TOT
54,Posthofbrug 5366,2019-02-14,14:00:00,116,56,60,FMN GV 16 Berchem TOT
54,Posthofbrug 5366,2019-02-14,15:00:00,203,79,124,FMN GV 16 Berchem TOT
54,Posthofbrug 5366,2019-02-14,16:00:00,404,186,218,FMN GV 16 Berchem TOT
54,Posthofbrug 5366,2019-02-14,17:00:00,503,222,281,FMN GV 16 Berchem TOT
54,Posthofbrug 5366,2019-02-14,18:00:00,325,118,207,FMN GV 16 Berchem TOT
54,Posthofbrug 5366,2019-02-14,19:00:00,153,62,91,FMN GV 16 Berchem TOT
54,Posthofbrug 5366,2019-02-14,20:00:00,109,50,59,FMN GV 16 Berchem TOT
54,Posthofbrug 5366,2019-02-14,21:00:00,68,43,25,FMN GV 16 Berchem TOT
54,Posthofbrug 5366,2019-02-14,22:00:00,55,23,32,FMN GV 16 Berchem TOT
54,Posthofbrug 5366,2019-02-14,23:00:00,30,9,21,FMN GV 16 Berchem TOT
54,Posthofbrug 5366,2019-02-15,00:00:00,26,4,22,FMN GV 16 Berchem TOT
54,Posthofbrug 5366,2019-02-15,01:00:00,12,3,9,FMN GV 16 Berchem TOT
54,Posthofbrug 5366,2019-02-15,02:00:00,3,0,3,FMN GV 16 Berchem TOT
54,Posthofbrug 5366,2019-02-15,03:00:00,2,1,1,FMN GV 16 Berchem TOT
54,Posthofbrug 5366,2019-02-15,04:00:00,7,2,5,FMN GV 16 Berchem TOT
54,Posthofbrug 5366,2019-02-15,05:00:00,22,14,8,FMN GV 16 Berchem TOT
54,Posthofbrug 5366,2019-02-15,06:00:00,93,67,26,FMN GV 16 Berchem TOT
54,Posthofbrug 5366,2019-02-15,07:00:00,359,245,114,FMN GV 16 Berchem TOT
54,Posthofbrug 5366,2019-02-15,08:00:00,609,402,207,FMN GV 16 Berchem TOT
54,Posthofbrug 5366,2019-02-15,09:00:00,198,125,73,FMN GV 16 Berchem TOT
54,Posthofbrug 5366,2019-02-15,10:00:00,110,67,43,FMN GV 16 Berchem TOT
54,Posthofbrug 5366,2019-02-15,11:00:00,118,76,42,FMN GV 16 Berchem TOT
54,Posthofbrug 5366,2019-02-15,12:00:00,196,112,84,FMN GV 16 Berchem TOT
54,Posthofbrug 5366,2019-02-15,13:00:00,169,100,69,FMN GV 16 Berchem TOT
54,Posthofbrug 5366,2019-02-15,14:00:00,177,92,85,FMN GV 16 Berchem TOT
54,Posthofbrug 5366,2019-02-15,15:00:00,223,98,125,FMN GV 16 Berchem TOT
54,Posthofbrug 5366,2019-02-15,16:00:00,412,208,204,FMN GV 16 Berchem TOT
54,Posthofbrug 5366,2019-02-15,17:00:00,474,199,275,FMN GV 16 Berchem TOT
54,Posthofbrug 5366,2019-02-15,18:00:00,262,132,130,FMN GV 16 Berchem TOT
54,Posthofbrug 5366,2019-02-15,19:00:00,168,92,76,FMN GV 16 Berchem TOT
54,Posthofbrug 5366,2019-02-15,20:00:00,89,44,45,FMN GV 16 Berchem TOT
54,Posthofbrug 5366,2019-02-15,21:00:00,72,29,43,FMN GV 16 Berchem TOT
54,Posthofbrug 5366,2019-02-15,22:00:00,83,26,57,FMN GV 16 Berchem TOT
54,Posthofbrug 5366,2019-02-15,23:00:00,61,24,37,FMN GV 16 Berchem TOT
54,Posthofbrug 5366,2019-02-16,00:00:00,60,25,35,FMN GV 16 Berchem TOT
54,Posthofbrug 5366,2019-02-16,01:00:00,27,6,21,FMN GV 16 Berchem TOT
54,Posthofbrug 5366,2019-02-16,02:00:00,22,6,16,FMN GV 16 Berchem TOT
54,Posthofbrug 5366,2019-02-16,03:00:00,11,4,7,FMN GV 16 Berchem TOT
54,Posthofbrug 5366,2019-02-16,04:00:00,11,2,9,FMN GV 16 Berchem TOT
54,Posthofbrug 5366,2019-02-16,05:00:00,21,8,13,FMN GV 16 Berchem TOT
54,Posthofbrug 5366,2019-02-16,06:00:00,13,8,5,FMN GV 16 Berchem TOT
54,Posthofbrug 5366,2019-02-16,07:00:00,22,15,7,FMN GV 16 Berchem TOT
54,Posthofbrug 5366,2019-02-16,08:00:00,52,37,15,FMN GV 16 Berchem TOT
54,Posthofbrug 5366,2019-02-16,09:00:00,102,68,34,FMN GV 16 Berchem TOT
54,Posthofbrug 5366,2019-02-16,10:00:00,101,54,47,FMN GV 16 Berchem TOT
54,Posthofbrug 5366,2019-02-16,11:00:00,159,108,51,FMN GV 16 Berchem TOT
54,Posthofbrug 5366,2019-02-16,12:00:00,155,97,58,FMN GV 16 Berchem TOT
54,Posthofbrug 5366,2019-02-16,13:00:00,176,101,75,FMN GV 16 Berchem TOT
54,Posthofbrug 5366,2019-02-16,14:00:00,188,119,69,FMN GV 16 Berchem TOT
54,Posthofbrug 5366,2019-02-16,15:00:00,183,106,77,FMN GV 16 Berchem TOT
54,Posthofbrug 5366,2019-02-16,16:00:00,160,63,97,FMN GV 16 Berchem TOT
54,Posthofbrug 5366,2019-02-16,17:00:00,152,96,56,FMN GV 16 Berchem TOT
54,Posthofbrug 5366,2019-02-16,18:00:00,151,71,80,FMN GV 16 Berchem TOT
54,Posthofbrug 5366,2019-02-16,19:00:00,84,58,26,FMN GV 16 Berchem TOT
54,Posthofbrug 5366,2019-02-16,20:00:00,53,29,24,FMN GV 16 Berchem TOT
54,Posthofbrug 5366,2019-02-16,21:00:00,46,26,20,FMN GV 16 Berchem TOT
54,Posthofbrug 5366,2019-02-16,22:00:00,47,16,31,FMN GV 16 Berchem TOT
54,Posthofbrug 5366,2019-02-16,23:00:00,52,8,44,FMN GV 16 Berchem TOT
54,Posthofbrug 5366,2019-02-17,00:00:00,46,19,27,FMN GV 16 Berchem TOT
54,Posthofbrug 5366,2019-02-17,01:00:00,26,11,15,FMN GV 16 Berchem TOT
54,Posthofbrug 5366,2019-02-17,02:00:00,13,3,10,FMN GV 16 Berchem TOT
54,Posthofbrug 5366,2019-02-17,03:00:00,15,2,13,FMN GV 16 Berchem TOT
54,Posthofbrug 5366,2019-02-17,04:00:00,10,3,7,FMN GV 16 Berchem TOT
54,Posthofbrug 5366,2019-02-17,05:00:00,16,11,5,FMN GV 16 Berchem TOT
54,Posthofbrug 5366,2019-02-17,06:00:00,8,6,2,FMN GV 16 Berchem TOT
54,Posthofbrug 5366,2019-02-17,07:00:00,14,10,4,FMN GV 16 Berchem TOT
54,Posthofbrug 5366,2019-02-17,08:00:00,35,19,16,FMN GV 16 Berchem TOT
54,Posthofbrug 5366,2019-02-17,09:00:00,80,43,37,FMN GV 16 Berchem TOT
54,Posthofbrug 5366,2019-02-17,10:00:00,70,39,31,FMN GV 16 Berchem TOT
54,Posthofbrug 5366,2019-02-17,11:00:00,127,90,37,FMN GV 16 Berchem TOT
54,Posthofbrug 5366,2019-02-17,12:00:00,187,111,76,FMN GV 16 Berchem TOT
54,Posthofbrug 5366,2019-02-17,13:00:00,164,88,76,FMN GV 16 Berchem TOT
54,Posthofbrug 5366,2019-02-17,14:00:00,243,140,103,FMN GV 16 Berchem TOT
54,Posthofbrug 5366,2019-02-17,15:00:00,183,97,86,FMN GV 16 Berchem TOT
54,Posthofbrug 5366,2019-02-17,16:00:00,156,70,86,FMN GV 16 Berchem TOT
54,Posthofbrug 5366,2019-02-17,17:00:00,148,71,77,FMN GV 16 Berchem TOT
54,Posthofbrug 5366,2019-02-17,18:00:00,79,35,44,FMN GV 16 Berchem TOT
54,Posthofbrug 5366,2019-02-17,19:00:00,65,33,32,FMN GV 16 Berchem TOT
54,Posthofbrug 5366,2019-02-17,20:00:00,55,35,20,FMN GV 16 Berchem TOT
54,Posthofbrug 5366,2019-02-17,21:00:00,40,18,22,FMN GV 16 Berchem TOT
54,Posthofbrug 5366,2019-02-17,22:00:00,26,11,15,FMN GV 16 Berchem TOT
54,Posthofbrug 5366,2019-02-17,23:00:00,16,5,11,FMN GV 16 Berchem TOT
54,Posthofbrug 5366,2019-02-18,00:00:00,9,4,5,FMN GV 16 Berchem TOT
54,Posthofbrug 5366,2019-02-18,01:00:00,3,2,1,FMN GV 16 Berchem TOT
54,Posthofbrug 5366,2019-02-18,02:00:00,0,0,0,FMN GV 16 Berchem TOT
54,Posthofbrug 5366,2019-02-18,03:00:00,2,1,1,FMN GV 16 Berchem TOT
54,Posthofbrug 5366,2019-02-18,04:00:00,6,5,1,FMN GV 16 Berchem TOT
54,Posthofbrug 5366,2019-02-18,05:00:00,20,16,4,FMN GV 16 Berchem TOT
54,Posthofbrug 5366,2019-02-18,06:00:00,108,88,20,FMN GV 16 Berchem TOT
54,Posthofbrug 5366,2019-02-18,07:00:00,497,347,150,FMN GV 16 Berchem TOT
54,Posthofbrug 5366,2019-02-18,08:00:00,726,497,229,FMN GV 16 Berchem TOT
54,Posthofbrug 5366,2019-02-18,09:00:00,216,148,68,FMN GV 16 Berchem TOT
54,Posthofbrug 5366,2019-02-18,10:00:00,87,62,25,FMN GV 16 Berchem TOT
54,Posthofbrug 5366,2019-02-18,11:00:00,122,82,40,FMN GV 16 Berchem TOT
54,Posthofbrug 5366,2019-02-18,12:00:00,145,95,50,FMN GV 16 Berchem TOT
54,Posthofbrug 5366,2019-02-18,13:00:00,149,89,60,FMN GV 16 Berchem TOT
54,Posthofbrug 5366,2019-02-18,14:00:00,121,50,71,FMN GV 16 Berchem TOT
54,Posthofbrug 5366,2019-02-18,15:00:00,223,91,132,FMN GV 16 Berchem TOT
54,Posthofbrug 5366,2019-02-18,16:00:00,477,221,256,FMN GV 16 Berchem TOT
54,Posthofbrug 5366,2019-02-18,17:00:00,571,231,340,FMN GV 16 Berchem TOT
54,Posthofbrug 5366,2019-02-18,18:00:00,359,133,226,FMN GV 16 Berchem TOT
54,Posthofbrug 5366,2019-02-18,19:00:00,172,76,96,FMN GV 16 Berchem TOT
54,Posthofbrug 5366,2019-02-18,20:00:00,89,47,42,FMN GV 16 Berchem TOT
54,Posthofbrug 5366,2019-02-18,21:00:00,74,31,43,FMN GV 16 Berchem TOT
54,Posthofbrug 5366,2019-02-18,22:00:00,62,23,39,FMN GV 16 Berchem TOT
54,Posthofbrug 5366,2019-02-18,23:00:00,26,9,17,FMN GV 16 Berchem TOT
54,Posthofbrug 5366,2019-02-19,00:00:00,7,2,5,FMN GV 16 Berchem TOT
54,Posthofbrug 5366,2019-02-19,01:00:00,4,1,3,FMN GV 16 Berchem TOT
54,Posthofbrug 5366,2019-02-19,02:00:00,2,0,2,FMN GV 16 Berchem TOT
54,Posthofbrug 5366,2019-02-19,03:00:00,4,4,0,FMN GV 16 Berchem TOT
54,Posthofbrug 5366,2019-02-19,04:00:00,6,4,2,FMN GV 16 Berchem TOT
54,Posthofbrug 5366,2019-02-19,05:00:00,24,16,8,FMN GV 16 Berchem TOT
54,Posthofbrug 5366,2019-02-19,06:00:00,132,105,27,FMN GV 16 Berchem TOT
54,Posthofbrug 5366,2019-02-19,07:00:00,488,340,148,FMN GV 16 Berchem TOT
54,Posthofbrug 5366,2019-02-19,08:00:00,818,527,291,FMN GV 16 Berchem TOT
54,Posthofbrug 5366,2019-02-19,09:00:00,219,155,64,FMN GV 16 Berchem TOT
54,Posthofbrug 5366,2019-02-19,10:00:00,90,63,27,FMN GV 16 Berchem TOT
54,Posthofbrug 5366,2019-02-19,11:00:00,88,62,26,FMN GV 16 Berchem TOT
54,Posthofbrug 5366,2019-02-19,12:00:00,162,101,61,FMN GV 16 Berchem TOT
54,Posthofbrug 5366,2019-02-19,13:00:00,151,85,66,FMN GV 16 Berchem TOT
54,Posthofbrug 5366,2019-02-19,14:00:00,127,70,57,FMN GV 16 Berchem TOT
54,Posthofbrug 5366,2019-02-19,15:00:00,230,108,122,FMN GV 16 Berchem TOT
54,Posthofbrug 5366,2019-02-19,16:00:00,460,221,239,FMN GV 16 Berchem TOT
54,Posthofbrug 5366,2019-02-19,17:00:00,618,290,328,FMN GV 16 Berchem TOT
54,Posthofbrug 5366,2019-02-19,18:00:00,336,135,201,FMN GV 16 Berchem TOT
54,Posthofbrug 5366,2019-02-19,19:00:00,165,74,91,FMN GV 16 Berchem TOT
54,Posthofbrug 5366,2019-02-19,20:00:00,90,44,46,FMN GV 16 Berchem TOT
54,Posthofbrug 5366,2019-02-19,21:00:00,78,35,43,FMN GV 16 Berchem TOT
54,Posthofbrug 5366,2019-02-19,22:00:00,69,20,49,FMN GV 16 Berchem TOT
54,Posthofbrug 5366,2019-02-19,23:00:00,36,16,20,FMN GV 16 Berchem TOT
54,Posthofbrug 5366,2019-02-20,00:00:00,17,4,13,FMN GV 16 Berchem TOT
54,Posthofbrug 5366,2019-02-20,01:00:00,8,1,7,FMN GV 16 Berchem TOT
54,Posthofbrug 5366,2019-02-20,02:00:00,3,2,1,FMN GV 16 Berchem TOT
54,Posthofbrug 5366,2019-02-20,03:00:00,7,6,1,FMN GV 16 Berchem TOT
54,Posthofbrug 5366,2019-02-20,04:00:00,13,11,2,FMN GV 16 Berchem TOT
54,Posthofbrug 5366,2019-02-20,05:00:00,23,12,11,FMN GV 16 Berchem TOT
54,Posthofbrug 5366,2019-02-20,06:00:00,122,95,27,FMN GV 16 Berchem TOT
54,Posthofbrug 5366,2019-02-20,07:00:00,436,309,127,FMN GV 16 Berchem TOT
54,Posthofbrug 5366,2019-02-20,08:00:00,636,385,251,FMN GV 16 Berchem TOT
54,Posthofbrug 5366,2019-02-20,09:00:00,187,132,55,FMN GV 16 Berchem TOT
54,Posthofbrug 5366,2019-02-20,10:00:00,87,63,24,FMN GV 16 Berchem TOT
54,Posthofbrug 5366,2019-02-20,11:00:00,128,91,37,FMN GV 16 Berchem TOT
54,Posthofbrug 5366,2019-02-20,12:00:00,220,120,100,FMN GV 16 Berchem TOT
54,Posthofbrug 5366,2019-02-20,13:00:00,184,97,87,FMN GV 16 Berchem TOT
54,Posthofbrug 5366,2019-02-20,14:00:00,156,81,75,FMN GV 16 Berchem TOT
54,Posthofbrug 5366,2019-02-20,15:00:00,184,95,89,FMN GV 16 Berchem TOT
54,Posthofbrug 5366,2019-02-20,16:00:00,394,205,189,FMN GV 16 Berchem TOT
54,Posthofbrug 5366,2019-02-20,17:00:00,530,238,292,FMN GV 16 Berchem TOT
54,Posthofbrug 5366,2019-02-20,18:00:00,337,138,199,FMN GV 16 Berchem TOT
54,Posthofbrug 5366,2019-02-20,19:00:00,137,74,63,FMN GV 16 Berchem TOT
54,Posthofbrug 5366,2019-02-20,20:00:00,96,54,42,FMN GV 16 Berchem TOT
54,Posthofbrug 5366,2019-02-20,21:00:00,68,32,36,FMN GV 16 Berchem TOT
54,Posthofbrug 5366,2019-02-20,22:00:00,63,32,31,FMN GV 16 Berchem TOT
54,Posthofbrug 5366,2019-02-20,23:00:00,47,11,36,FMN GV 16 Berchem TOT
54,Posthofbrug 5366,2019-02-21,00:00:00,21,8,13,FMN GV 16 Berchem TOT
54,Posthofbrug 5366,2019-02-21,01:00:00,3,2,1,FMN GV 16 Berchem TOT
54,Posthofbrug 5366,2019-02-21,02:00:00,1,0,1,FMN GV 16 Berchem TOT
54,Posthofbrug 5366,2019-02-21,03:00:00,4,3,1,FMN GV 16 Berchem TOT
54,Posthofbrug 5366,2019-02-21,04:00:00,9,7,2,FMN GV 16 Berchem TOT
54,Posthofbrug 5366,2019-02-21,05:00:00,22,13,9,FMN GV 16 Berchem TOT
54,Posthofbrug 5366,2019-02-21,06:00:00,123,100,23,FMN GV 16 Berchem TOT
54,Posthofbrug 5366,2019-02-21,07:00:00,450,304,146,FMN GV 16 Berchem TOT
54,Posthofbrug 5366,2019-02-21,08:00:00,733,486,247,FMN GV 16 Berchem TOT
54,Posthofbrug 5366,2019-02-21,09:00:00,206,130,76,FMN GV 16 Berchem TOT
54,Posthofbrug 5366,2019-02-21,10:00:00,106,82,24,FMN GV 16 Berchem TOT
54,Posthofbrug 5366,2019-02-21,11:00:00,117,80,37,FMN GV 16 Berchem TOT
54,Posthofbrug 5366,2019-02-21,12:00:00,157,98,59,FMN GV 16 Berchem TOT
54,Posthofbrug 5366,2019-02-21,13:00:00,151,96,55,FMN GV 16 Berchem TOT
54,Posthofbrug 5366,2019-02-21,14:00:00,122,58,64,FMN GV 16 Berchem TOT
54,Posthofbrug 5366,2019-02-21,15:00:00,200,95,105,FMN GV 16 Berchem TOT
54,Posthofbrug 5366,2019-02-21,16:00:00,437,216,221,FMN GV 16 Berchem TOT
54,Posthofbrug 5366,2019-02-21,17:00:00,561,269,292,FMN GV 16 Berchem TOT
54,Posthofbrug 5366,2019-02-21,18:00:00,359,168,191,FMN GV 16 Berchem TOT
54,Posthofbrug 5366,2019-02-21,19:00:00,175,76,99,FMN GV 16 Berchem TOT
54,Posthofbrug 5366,2019-02-21,20:00:00,109,48,61,FMN GV 16 Berchem TOT
54,Posthofbrug 5366,2019-02-21,21:00:00,77,42,35,FMN GV 16 Berchem TOT
54,Posthofbrug 5366,2019-02-21,22:00:00,85,30,55,FMN GV 16 Berchem TOT
54,Posthofbrug 5366,2019-02-21,23:00:00,44,11,33,FMN GV 16 Berchem TOT
54,Posthofbrug 5366,2019-02-22,00:00:00,42,12,30,FMN GV 16 Berchem TOT
54,Posthofbrug 5366,2019-02-22,01:00:00,5,1,4,FMN GV 16 Berchem TOT
54,Posthofbrug 5366,2019-02-22,02:00:00,9,2,7,FMN GV 16 Berchem TOT
54,Posthofbrug 5366,2019-02-22,03:00:00,6,3,3,FMN GV 16 Berchem TOT
54,Posthofbrug 5366,2019-02-22,04:00:00,8,8,0,FMN GV 16 Berchem TOT
54,Posthofbrug 5366,2019-02-22,05:00:00,20,10,10,FMN GV 16 Berchem TOT
54,Posthofbrug 5366,2019-02-22,06:00:00,105,73,32,FMN GV 16 Berchem TOT
54,Posthofbrug 5366,2019-02-22,07:00:00,379,243,136,FMN GV 16 Berchem TOT
54,Posthofbrug 5366,2019-02-22,08:00:00,619,419,200,FMN GV 16 Berchem TOT
54,Posthofbrug 5366,2019-02-22,09:00:00,229,158,71,FMN GV 16 Berchem TOT
54,Posthofbrug 5366,2019-02-22,10:00:00,95,69,26,FMN GV 16 Berchem TOT
54,Posthofbrug 5366,2019-02-22,11:00:00,107,69,38,FMN GV 16 Berchem TOT
54,Posthofbrug 5366,2019-02-22,12:00:00,163,97,66,FMN GV 16 Berchem TOT
54,Posthofbrug 5366,2019-02-22,13:00:00,148,73,75,FMN GV 16 Berchem TOT
54,Posthofbrug 5366,2019-02-22,14:00:00,173,97,76,FMN GV 16 Berchem TOT
54,Posthofbrug 5366,2019-02-22,15:00:00,262,142,120,FMN GV 16 Berchem TOT
54,Posthofbrug 5366,2019-02-22,16:00:00,405,208,197,FMN GV 16 Berchem TOT
54,Posthofbrug 5366,2019-02-22,17:00:00,456,212,244,FMN GV 16 Berchem TOT
54,Posthofbrug 5366,2019-02-22,18:00:00,278,128,150,FMN GV 16 Berchem TOT
54,Posthofbrug 5366,2019-02-22,19:00:00,166,91,75,FMN GV 16 Berchem TOT
54,Posthofbrug 5366,2019-02-22,20:00:00,64,38,26,FMN GV 16 Berchem TOT
54,Posthofbrug 5366,2019-02-22,21:00:00,62,29,33,FMN GV 16 Berchem TOT
54,Posthofbrug 5366,2019-02-22,22:00:00,82,33,49,FMN GV 16 Berchem TOT
54,Posthofbrug 5366,2019-02-22,23:00:00,60,20,40,FMN GV 16 Berchem TOT
54,Posthofbrug 5366,2019-02-23,00:00:00,64,22,42,FMN GV 16 Berchem TOT
54,Posthofbrug 5366,2019-02-23,01:00:00,36,8,28,FMN GV 16 Berchem TOT
54,Posthofbrug 5366,2019-02-23,02:00:00,13,2,11,FMN GV 16 Berchem TOT
54,Posthofbrug 5366,2019-02-23,03:00:00,15,2,13,FMN GV 16 Berchem TOT
54,Posthofbrug 5366,2019-02-23,04:00:00,16,6,10,FMN GV 16 Berchem TOT
54,Posthofbrug 5366,2019-02-23,05:00:00,22,5,17,FMN GV 16 Berchem TOT
54,Posthofbrug 5366,2019-02-23,06:00:00,19,11,8,FMN GV 16 Berchem TOT
54,Posthofbrug 5366,2019-02-23,07:00:00,22,14,8,FMN GV 16 Berchem TOT
54,Posthofbrug 5366,2019-02-23,08:00:00,71,51,20,FMN GV 16 Berchem TOT
54,Posthofbrug 5366,2019-02-23,09:00:00,138,87,51,FMN GV 16 Berchem TOT
54,Posthofbrug 5366,2019-02-23,10:00:00,118,85,33,FMN GV 16 Berchem TOT
54,Posthofbrug 5366,2019-02-23,11:00:00,126,77,49,FMN GV 16 Berchem TOT
54,Posthofbrug 5366,2019-02-23,12:00:00,146,92,54,FMN GV 16 Berchem TOT
54,Posthofbrug 5366,2019-02-23,13:00:00,210,123,87,FMN GV 16 Berchem TOT
54,Posthofbrug 5366,2019-02-23,14:00:00,198,107,91,FMN GV 16 Berchem TOT
54,Posthofbrug 5366,2019-02-23,15:00:00,181,94,87,FMN GV 16 Berchem TOT
54,Posthofbrug 5366,2019-02-23,16:00:00,162,83,79,FMN GV 16 Berchem TOT
54,Posthofbrug 5366,2019-02-23,17:00:00,207,112,95,FMN GV 16 Berchem TOT
54,Posthofbrug 5366,2019-02-23,18:00:00,141,71,70,FMN GV 16 Berchem TOT
54,Posthofbrug 5366,2019-02-23,19:00:00,94,45,49,FMN GV 16 Berchem TOT
54,Posthofbrug 5366,2019-02-23,20:00:00,61,33,28,FMN GV 16 Berchem TOT
54,Posthofbrug 5366,2019-02-23,21:00:00,57,37,20,FMN GV 16 Berchem TOT
54,Posthofbrug 5366,2019-02-23,22:00:00,48,16,32,FMN GV 16 Berchem TOT
54,Posthofbrug 5366,2019-02-23,23:00:00,73,38,35,FMN GV 16 Berchem TOT
54,Posthofbrug 5366,2019-02-24,00:00:00,43,13,30,FMN GV 16 Berchem TOT
54,Posthofbrug 5366,2019-02-24,01:00:00,23,6,17,FMN GV 16 Berchem TOT
54,Posthofbrug 5366,2019-02-24,02:00:00,15,3,12,FMN GV 16 Berchem TOT
54,Posthofbrug 5366,2019-02-24,03:00:00,14,0,14,FMN GV 16 Berchem TOT
54,Posthofbrug 5366,2019-02-24,04:00:00,16,5,11,FMN GV 16 Berchem TOT
54,Posthofbrug 5366,2019-02-24,05:00:00,9,2,7,FMN GV 16 Berchem TOT
54,Posthofbrug 5366,2019-02-24,06:00:00,10,5,5,FMN GV 16 Berchem TOT
54,Posthofbrug 5366,2019-02-24,07:00:00,15,5,10,FMN GV 16 Berchem TOT
54,Posthofbrug 5366,2019-02-24,08:00:00,34,22,12,FMN GV 16 Berchem TOT
54,Posthofbrug 5366,2019-02-24,09:00:00,80,38,42,FMN GV 16 Berchem TOT
54,Posthofbrug 5366,2019-02-24,10:00:00,93,56,37,FMN GV 16 Berchem TOT
54,Posthofbrug 5366,2019-02-24,11:00:00,99,57,42,FMN GV 16 Berchem TOT
54,Posthofbrug 5366,2019-02-24,12:00:00,130,73,57,FMN GV 16 Berchem TOT
54,Posthofbrug 5366,2019-02-24,13:00:00,163,71,92,FMN GV 16 Berchem TOT
54,Posthofbrug 5366,2019-02-24,14:00:00,163,84,79,FMN GV 16 Berchem TOT
54,Posthofbrug 5366,2019-02-24,15:00:00,151,82,69,FMN GV 16 Berchem TOT
54,Posthofbrug 5366,2019-02-24,16:00:00,138,80,58,FMN GV 16 Berchem TOT
54,Posthofbrug 5366,2019-02-24,17:00:00,193,93,100,FMN GV 16 Berchem TOT
54,Posthofbrug 5366,2019-02-24,18:00:00,102,58,44,FMN GV 16 Berchem TOT
54,Posthofbrug 5366,2019-02-24,19:00:00,72,28,44,FMN GV 16 Berchem TOT
54,Posthofbrug 5366,2019-02-24,20:00:00,49,26,23,FMN GV 16 Berchem TOT
54,Posthofbrug 5366,2019-02-24,21:00:00,40,20,20,FMN GV 16 Berchem TOT
54,Posthofbrug 5366,2019-02-24,22:00:00,35,10,25,FMN GV 16 Berchem TOT
54,Posthofbrug 5366,2019-02-24,23:00:00,23,9,14,FMN GV 16 Berchem TOT
54,Posthofbrug 5366,2019-02-25,00:00:00,4,1,3,FMN GV 16 Berchem TOT
54,Posthofbrug 5366,2019-02-25,01:00:00,1,0,1,FMN GV 16 Berchem TOT
54,Posthofbrug 5366,2019-02-25,02:00:00,1,0,1,FMN GV 16 Berchem TOT
54,Posthofbrug 5366,2019-02-25,03:00:00,4,2,2,FMN GV 16 Berchem TOT
54,Posthofbrug 5366,2019-02-25,04:00:00,8,5,3,FMN GV 16 Berchem TOT
54,Posthofbrug 5366,2019-02-25,05:00:00,30,22,8,FMN GV 16 Berchem TOT
54,Posthofbrug 5366,2019-02-25,06:00:00,131,108,23,FMN GV 16 Berchem TOT
54,Posthofbrug 5366,2019-02-25,07:00:00,481,323,158,FMN GV 16 Berchem TOT
54,Posthofbrug 5366,2019-02-25,08:00:00,741,485,256,FMN GV 16 Berchem TOT
54,Posthofbrug 5366,2019-02-25,09:00:00,270,198,72,FMN GV 16 Berchem TOT
54,Posthofbrug 5366,2019-02-25,10:00:00,122,73,49,FMN GV 16 Berchem TOT
54,Posthofbrug 5366,2019-02-25,11:00:00,106,66,40,FMN GV 16 Berchem TOT
54,Posthofbrug 5366,2019-02-25,12:00:00,150,89,61,FMN GV 16 Berchem TOT
54,Posthofbrug 5366,2019-02-25,13:00:00,156,83,73,FMN GV 16 Berchem TOT
54,Posthofbrug 5366,2019-02-25,14:00:00,138,71,67,FMN GV 16 Berchem TOT
54,Posthofbrug 5366,2019-02-25,15:00:00,254,115,139,FMN GV 16 Berchem TOT
54,Posthofbrug 5366,2019-02-25,16:00:00,441,199,242,FMN GV 16 Berchem TOT
54,Posthofbrug 5366,2019-02-25,17:00:00,589,253,336,FMN GV 16 Berchem TOT
54,Posthofbrug 5366,2019-02-25,18:00:00,368,141,227,FMN GV 16 Berchem TOT
54,Posthofbrug 5366,2019-02-25,19:00:00,173,85,88,FMN GV 16 Berchem TOT
54,Posthofbrug 5366,2019-02-25,20:00:00,87,32,55,FMN GV 16 Berchem TOT
54,Posthofbrug 5366,2019-02-25,21:00:00,79,33,46,FMN GV 16 Berchem TOT
54,Posthofbrug 5366,2019-02-25,22:00:00,62,34,28,FMN GV 16 Berchem TOT
54,Posthofbrug 5366,2019-02-25,23:00:00,22,6,16,FMN GV 16 Berchem TOT
54,Posthofbrug 5366,2019-02-26,00:00:00,19,11,8,FMN GV 16 Berchem TOT
54,Posthofbrug 5366,2019-02-26,01:00:00,4,1,3,FMN GV 16 Berchem TOT
54,Posthofbrug 5366,2019-02-26,02:00:00,1,1,0,FMN GV 16 Berchem TOT
54,Posthofbrug 5366,2019-02-26,03:00:00,2,1,1,FMN GV 16 Berchem TOT
54,Posthofbrug 5366,2019-02-26,04:00:00,7,6,1,FMN GV 16 Berchem TOT
54,Posthofbrug 5366,2019-02-26,05:00:00,26,19,7,FMN GV 16 Berchem TOT
54,Posthofbrug 5366,2019-02-26,06:00:00,125,99,26,FMN GV 16 Berchem TOT
54,Posthofbrug 5366,2019-02-26,07:00:00,511,325,186,FMN GV 16 Berchem TOT
54,Posthofbrug 5366,2019-02-26,08:00:00,795,519,276,FMN GV 16 Berchem TOT
54,Posthofbrug 5366,2019-02-26,09:00:00,240,173,67,FMN GV 16 Berchem TOT
54,Posthofbrug 5366,2019-02-26,10:00:00,130,84,46,FMN GV 16 Berchem TOT
54,Posthofbrug 5366,2019-02-26,11:00:00,121,82,39,FMN GV 16 Berchem TOT
54,Posthofbrug 5366,2019-02-26,12:00:00,159,89,70,FMN GV 16 Berchem TOT
54,Posthofbrug 5366,2019-02-26,13:00:00,180,96,84,FMN GV 16 Berchem TOT
54,Posthofbrug 5366,2019-02-26,14:00:00,130,62,68,FMN GV 16 Berchem TOT
54,Posthofbrug 5366,2019-02-26,15:00:00,260,130,130,FMN GV 16 Berchem TOT
54,Posthofbrug 5366,2019-02-26,16:00:00,498,242,256,FMN GV 16 Berchem TOT
54,Posthofbrug 5366,2019-02-26,17:00:00,662,279,383,FMN GV 16 Berchem TOT
54,Posthofbrug 5366,2019-02-26,18:00:00,401,171,230,FMN GV 16 Berchem TOT
54,Posthofbrug 5366,2019-02-26,19:00:00,180,81,99,FMN GV 16 Berchem TOT
54,Posthofbrug 5366,2019-02-26,20:00:00,113,53,60,FMN GV 16 Berchem TOT
54,Posthofbrug 5366,2019-02-26,21:00:00,83,33,50,FMN GV 16 Berchem TOT
54,Posthofbrug 5366,2019-02-26,22:00:00,98,34,64,FMN GV 16 Berchem TOT
54,Posthofbrug 5366,2019-02-26,23:00:00,30,14,16,FMN GV 16 Berchem TOT
54,Posthofbrug 5366,2019-02-27,00:00:00,28,13,15,FMN GV 16 Berchem TOT
54,Posthofbrug 5366,2019-02-27,01:00:00,8,3,5,FMN GV 16 Berchem TOT
54,Posthofbrug 5366,2019-02-27,02:00:00,4,3,1,FMN GV 16 Berchem TOT
54,Posthofbrug 5366,2019-02-27,03:00:00,3,2,1,FMN GV 16 Berchem TOT
54,Posthofbrug 5366,2019-02-27,04:00:00,7,5,2,FMN GV 16 Berchem TOT
54,Posthofbrug 5366,2019-02-27,05:00:00,28,19,9,FMN GV 16 Berchem TOT
54,Posthofbrug 5366,2019-02-27,06:00:00,109,86,23,FMN GV 16 Berchem TOT
54,Posthofbrug 5366,2019-02-27,07:00:00,451,295,156,FMN GV 16 Berchem TOT
54,Posthofbrug 5366,2019-02-27,08:00:00,677,405,272,FMN GV 16 Berchem TOT
54,Posthofbrug 5366,2019-02-27,09:00:00,226,166,60,FMN GV 16 Berchem TOT
54,Posthofbrug 5366,2019-02-27,10:00:00,121,82,39,FMN GV 16 Berchem TOT
54,Posthofbrug 5366,2019-02-27,11:00:00,139,88,51,FMN GV 16 Berchem TOT
54,Posthofbrug 5366,2019-02-27,12:00:00,296,182,114,FMN GV 16 Berchem TOT
54,Posthofbrug 5366,2019-02-27,13:00:00,243,139,104,FMN GV 16 Berchem TOT
54,Posthofbrug 5366,2019-02-27,14:00:00,218,103,115,FMN GV 16 Berchem TOT
54,Posthofbrug 5366,2019-02-27,15:00:00,197,87,110,FMN GV 16 Berchem TOT
54,Posthofbrug 5366,2019-02-27,16:00:00,447,212,235,FMN GV 16 Berchem TOT
54,Posthofbrug 5366,2019-02-27,17:00:00,538,243,295,FMN GV 16 Berchem TOT
54,Posthofbrug 5366,2019-02-27,18:00:00,370,153,217,FMN GV 16 Berchem TOT
54,Posthofbrug 5366,2019-02-27,19:00:00,123,67,56,FMN GV 16 Berchem TOT
54,Posthofbrug 5366,2019-02-27,20:00:00,107,56,51,FMN GV 16 Berchem TOT
54,Posthofbrug 5366,2019-02-27,21:00:00,76,31,45,FMN GV 16 Berchem TOT
54,Posthofbrug 5366,2019-02-27,22:00:00,73,26,47,FMN GV 16 Berchem TOT
54,Posthofbrug 5366,2019-02-27,23:00:00,55,23,32,FMN GV 16 Berchem TOT
54,Posthofbrug 5366,2019-02-28,00:00:00,26,5,21,FMN GV 16 Berchem TOT
54,Posthofbrug 5366,2019-02-28,01:00:00,7,2,5,FMN GV 16 Berchem TOT
54,Posthofbrug 5366,2019-02-28,02:00:00,3,2,1,FMN GV 16 Berchem TOT
54,Posthofbrug 5366,2019-02-28,03:00:00,9,4,5,FMN GV 16 Berchem TOT
54,Posthofbrug 5366,2019-02-28,04:00:00,11,7,4,FMN GV 16 Berchem TOT
54,Posthofbrug 5366,2019-02-28,05:00:00,29,12,17,FMN GV 16 Berchem TOT
54,Posthofbrug 5366,2019-02-28,06:00:00,112,87,25,FMN GV 16 Berchem TOT
54,Posthofbrug 5366,2019-02-28,07:00:00,468,315,153,FMN GV 16 Berchem TOT
54,Posthofbrug 5366,2019-02-28,08:00:00,760,489,271,FMN GV 16 Berchem TOT
54,Posthofbrug 5366,2019-02-28,09:00:00,271,202,69,FMN GV 16 Berchem TOT
54,Posthofbrug 5366,2019-02-28,10:00:00,116,72,44,FMN GV 16 Berchem TOT
54,Posthofbrug 5366,2019-02-28,11:00:00,100,52,48,FMN GV 16 Berchem TOT
54,Posthofbrug 5366,2019-02-28,12:00:00,146,77,69,FMN GV 16 Berchem TOT
54,Posthofbrug 5366,2019-02-28,13:00:00,151,94,57,FMN GV 16 Berchem TOT
54,Posthofbrug 5366,2019-02-28,14:00:00,100,55,45,FMN GV 16 Berchem TOT
54,Posthofbrug 5366,2019-02-28,15:00:00,201,91,110,FMN GV 16 Berchem TOT
54,Posthofbrug 5366,2019-02-28,16:00:00,430,214,216,FMN GV 16 Berchem TOT
54,Posthofbrug 5366,2019-02-28,17:00:00,493,246,247,FMN GV 16 Berchem TOT
54,Posthofbrug 5366,2019-02-28,18:00:00,315,137,178,FMN GV 16 Berchem TOT
54,Posthofbrug 5366,2019-02-28,19:00:00,149,75,74,FMN GV 16 Berchem TOT
54,Posthofbrug 5366,2019-02-28,20:00:00,85,36,49,FMN GV 16 Berchem TOT
54,Posthofbrug 5366,2019-02-28,21:00:00,68,27,41,FMN GV 16 Berchem TOT
54,Posthofbrug 5366,2019-02-28,22:00:00,62,24,38,FMN GV 16 Berchem TOT
54,Posthofbrug 5366,2019-02-28,23:00:00,40,14,26,FMN GV 16 Berchem TOT
54,Posthofbrug 5366,2019-03-01,00:00:00,19,6,13,FMN GV 16 Berchem TOT
54,Posthofbrug 5366,2019-03-01,01:00:00,7,3,4,FMN GV 16 Berchem TOT
54,Posthofbrug 5366,2019-03-01,02:00:00,16,3,13,FMN GV 16 Berchem TOT
54,Posthofbrug 5366,2019-03-01,03:00:00,2,0,2,FMN GV 16 Berchem TOT
54,Posthofbrug 5366,2019-03-01,04:00:00,11,6,5,FMN GV 16 Berchem TOT
54,Posthofbrug 5366,2019-03-01,05:00:00,21,12,9,FMN GV 16 Berchem TOT
54,Posthofbrug 5366,2019-03-01,06:00:00,101,75,26,FMN GV 16 Berchem TOT
54,Posthofbrug 5366,2019-03-01,07:00:00,357,233,124,FMN GV 16 Berchem TOT
54,Posthofbrug 5366,2019-03-01,08:00:00,546,367,179,FMN GV 16 Berchem TOT
54,Posthofbrug 5366,2019-03-01,09:00:00,157,115,42,FMN GV 16 Berchem TOT
54,Posthofbrug 5366,2019-03-01,10:00:00,97,66,31,FMN GV 16 Berchem TOT
54,Posthofbrug 5366,2019-03-01,11:00:00,76,48,28,FMN GV 16 Berchem TOT
54,Posthofbrug 5366,2019-03-01,12:00:00,118,67,51,FMN GV 16 Berchem TOT
54,Posthofbrug 5366,2019-03-01,13:00:00,131,72,59,FMN GV 16 Berchem TOT
54,Posthofbrug 5366,2019-03-01,14:00:00,94,49,45,FMN GV 16 Berchem TOT
54,Posthofbrug 5366,2019-03-01,15:00:00,193,96,97,FMN GV 16 Berchem TOT
54,Posthofbrug 5366,2019-03-01,16:00:00,340,175,165,FMN GV 16 Berchem TOT
54,Posthofbrug 5366,2019-03-01,17:00:00,411,194,217,FMN GV 16 Berchem TOT
54,Posthofbrug 5366,2019-03-01,18:00:00,216,104,112,FMN GV 16 Berchem TOT
54,Posthofbrug 5366,2019-03-01,19:00:00,128,58,70,FMN GV 16 Berchem TOT
54,Posthofbrug 5366,2019-03-01,20:00:00,76,39,37,FMN GV 16 Berchem TOT
54,Posthofbrug 5366,2019-03-01,21:00:00,60,44,16,FMN GV 16 Berchem TOT
54,Posthofbrug 5366,2019-03-01,22:00:00,45,15,30,FMN GV 16 Berchem TOT
54,Posthofbrug 5366,2019-03-01,23:00:00,56,17,39,FMN GV 16 Berchem TOT
54,Posthofbrug 5366,2019-03-02,00:00:00,47,19,28,FMN GV 16 Berchem TOT
54,Posthofbrug 5366,2019-03-02,01:00:00,31,20,11,FMN GV 16 Berchem TOT
54,Posthofbrug 5366,2019-03-02,02:00:00,17,5,12,FMN GV 16 Berchem TOT
54,Posthofbrug 5366,2019-03-02,03:00:00,16,5,11,FMN GV 16 Berchem TOT
54,Posthofbrug 5366,2019-03-02,04:00:00,18,6,12,FMN GV 16 Berchem TOT
54,Posthofbrug 5366,2019-03-02,05:00:00,18,8,10,FMN GV 16 Berchem TOT
54,Posthofbrug 5366,2019-03-02,06:00:00,13,8,5,FMN GV 16 Berchem TOT
54,Posthofbrug 5366,2019-03-02,07:00:00,23,13,10,FMN GV 16 Berchem TOT
54,Posthofbrug 5366,2019-03-02,08:00:00,53,32,21,FMN GV 16 Berchem TOT
54,Posthofbrug 5366,2019-03-02,09:00:00,90,47,43,FMN GV 16 Berchem TOT
54,Posthofbrug 5366,2019-03-02,10:00:00,88,55,33,FMN GV 16 Berchem TOT
54,Posthofbrug 5366,2019-03-02,11:00:00,88,55,33,FMN GV 16 Berchem TOT
54,Posthofbrug 5366,2019-03-02,12:00:00,90,57,33,FMN GV 16 Berchem TOT
54,Posthofbrug 5366,2019-03-02,13:00:00,116,69,47,FMN GV 16 Berchem TOT
54,Posthofbrug 5366,2019-03-02,14:00:00,73,34,39,FMN GV 16 Berchem TOT
54,Posthofbrug 5366,2019-03-02,15:00:00,75,51,24,FMN GV 16 Berchem TOT
54,Posthofbrug 5366,2019-03-02,16:00:00,91,50,41,FMN GV 16 Berchem TOT
54,Posthofbrug 5366,2019-03-02,17:00:00,109,57,52,FMN GV 16 Berchem TOT
54,Posthofbrug 5366,2019-03-02,18:00:00,84,46,38,FMN GV 16 Berchem TOT
54,Posthofbrug 5366,2019-03-02,19:00:00,84,52,32,FMN GV 16 Berchem TOT
54,Posthofbrug 5366,2019-03-02,20:00:00,45,25,20,FMN GV 16 Berchem TOT
54,Posthofbrug 5366,2019-03-02,21:00:00,36,20,16,FMN GV 16 Berchem TOT
54,Posthofbrug 5366,2019-03-02,22:00:00,54,23,31,FMN GV 16 Berchem TOT
54,Posthofbrug 5366,2019-03-02,23:00:00,30,18,12,FMN GV 16 Berchem TOT
54,Posthofbrug 5366,2019-03-03,00:00:00,23,9,14,FMN GV 16 Berchem TOT
54,Posthofbrug 5366,2019-03-03,01:00:00,29,7,22,FMN GV 16 Berchem TOT
54,Posthofbrug 5366,2019-03-03,02:00:00,20,4,16,FMN GV 16 Berchem TOT
54,Posthofbrug 5366,2019-03-03,03:00:00,9,0,9,FMN GV 16 Berchem TOT
54,Posthofbrug 5366,2019-03-03,04:00:00,9,4,5,FMN GV 16 Berchem TOT
54,Posthofbrug 5366,2019-03-03,05:00:00,14,9,5,FMN GV 16 Berchem TOT
54,Posthofbrug 5366,2019-03-03,06:00:00,11,9,2,FMN GV 16 Berchem TOT
54,Posthofbrug 5366,2019-03-03,07:00:00,11,6,5,FMN GV 16 Berchem TOT
54,Posthofbrug 5366,2019-03-03,08:00:00,26,14,12,FMN GV 16 Berchem TOT
54,Posthofbrug 5366,2019-03-03,09:00:00,33,18,15,FMN GV 16 Berchem TOT
54,Posthofbrug 5366,2019-03-03,10:00:00,27,17,10,FMN GV 16 Berchem TOT
54,Posthofbrug 5366,2019-03-03,11:00:00,32,20,12,FMN GV 16 Berchem TOT
54,Posthofbrug 5366,2019-03-03,12:00:00,50,28,22,FMN GV 16 Berchem TOT
54,Posthofbrug 5366,2019-03-03,13:00:00,61,33,28,FMN GV 16 Berchem TOT
54,Posthofbrug 5366,2019-03-03,14:00:00,58,38,20,FMN GV 16 Berchem TOT
54,Posthofbrug 5366,2019-03-03,15:00:00,49,24,25,FMN GV 16 Berchem TOT
54,Posthofbrug 5366,2019-03-03,16:00:00,34,14,20,FMN GV 16 Berchem TOT
54,Posthofbrug 5366,2019-03-03,17:00:00,55,30,25,FMN GV 16 Berchem TOT
54,Posthofbrug 5366,2019-03-03,18:00:00,44,27,17,FMN GV 16 Berchem TOT
54,Posthofbrug 5366,2019-03-03,19:00:00,23,14,9,FMN GV 16 Berchem TOT
54,Posthofbrug 5366,2019-03-03,20:00:00,47,23,24,FMN GV 16 Berchem TOT
54,Posthofbrug 5366,2019-03-03,21:00:00,27,14,13,FMN GV 16 Berchem TOT
54,Posthofbrug 5366,2019-03-03,22:00:00,24,13,11,FMN GV 16 Berchem TOT
54,Posthofbrug 5366,2019-03-03,23:00:00,10,5,5,FMN GV 16 Berchem TOT
54,Posthofbrug 5366,2019-03-04,00:00:00,8,3,5,FMN GV 16 Berchem TOT
54,Posthofbrug 5366,2019-03-04,01:00:00,8,1,7,FMN GV 16 Berchem TOT
54,Posthofbrug 5366,2019-03-04,02:00:00,4,1,3,FMN GV 16 Berchem TOT
54,Posthofbrug 5366,2019-03-04,03:00:00,1,1,0,FMN GV 16 Berchem TOT
54,Posthofbrug 5366,2019-03-04,04:00:00,6,6,0,FMN GV 16 Berchem TOT
54,Posthofbrug 5366,2019-03-04,05:00:00,15,11,4,FMN GV 16 Berchem TOT
54,Posthofbrug 5366,2019-03-04,06:00:00,81,66,15,FMN GV 16 Berchem TOT
54,Posthofbrug 5366,2019-03-04,07:00:00,206,123,83,FMN GV 16 Berchem TOT
54,Posthofbrug 5366,2019-03-04,08:00:00,392,244,148,FMN GV 16 Berchem TOT
54,Posthofbrug 5366,2019-03-04,09:00:00,119,80,39,FMN GV 16 Berchem TOT
54,Posthofbrug 5366,2019-03-04,10:00:00,47,37,10,FMN GV 16 Berchem TOT
54,Posthofbrug 5366,2019-03-04,11:00:00,66,41,25,FMN GV 16 Berchem TOT
54,Posthofbrug 5366,2019-03-04,12:00:00,81,53,28,FMN GV 16 Berchem TOT
54,Posthofbrug 5366,2019-03-04,13:00:00,84,50,34,FMN GV 16 Berchem TOT
54,Posthofbrug 5366,2019-03-04,14:00:00,60,37,23,FMN GV 16 Berchem TOT
54,Posthofbrug 5366,2019-03-04,15:00:00,97,56,41,FMN GV 16 Berchem TOT
54,Posthofbrug 5366,2019-03-04,16:00:00,208,125,83,FMN GV 16 Berchem TOT
54,Posthofbrug 5366,2019-03-04,17:00:00,329,155,174,FMN GV 16 Berchem TOT
54,Posthofbrug 5366,2019-03-04,18:00:00,230,108,122,FMN GV 16 Berchem TOT
54,Posthofbrug 5366,2019-03-04,19:00:00,93,48,45,FMN GV 16 Berchem TOT
54,Posthofbrug 5366,2019-03-04,20:00:00,48,16,32,FMN GV 16 Berchem TOT
54,Posthofbrug 5366,2019-03-04,21:00:00,41,18,23,FMN GV 16 Berchem TOT
54,Posthofbrug 5366,2019-03-04,22:00:00,39,17,22,FMN GV 16 Berchem TOT
54,Posthofbrug 5366,2019-03-04,23:00:00,21,7,14,FMN GV 16 Berchem TOT
54,Posthofbrug 5366,2019-03-05,00:00:00,11,5,6,FMN GV 16 Berchem TOT
54,Posthofbrug 5366,2019-03-05,01:00:00,7,2,5,FMN GV 16 Berchem TOT
54,Posthofbrug 5366,2019-03-05,02:00:00,2,1,1,FMN GV 16 Berchem TOT
54,Posthofbrug 5366,2019-03-05,03:00:00,3,2,1,FMN GV 16 Berchem TOT
54,Posthofbrug 5366,2019-03-05,04:00:00,5,4,1,FMN GV 16 Berchem TOT
54,Posthofbrug 5366,2019-03-05,05:00:00,22,14,8,FMN GV 16 Berchem TOT
54,Posthofbrug 5366,2019-03-05,06:00:00,84,65,19,FMN GV 16 Berchem TOT
54,Posthofbrug 5366,2019-03-05,07:00:00,292,205,87,FMN GV 16 Berchem TOT
54,Posthofbrug 5366,2019-03-05,08:00:00,473,291,182,FMN GV 16 Berchem TOT
54,Posthofbrug 5366,2019-03-05,09:00:00,143,95,48,FMN GV 16 Berchem TOT
54,Posthofbrug 5366,2019-03-05,10:00:00,91,54,37,FMN GV 16 Berchem TOT
54,Posthofbrug 5366,2019-03-05,11:00:00,86,54,32,FMN GV 16 Berchem TOT
54,Posthofbrug 5366,2019-03-05,12:00:00,134,86,48,FMN GV 16 Berchem TOT
54,Posthofbrug 5366,2019-03-05,13:00:00,98,53,45,FMN GV 16 Berchem TOT
54,Posthofbrug 5366,2019-03-05,14:00:00,74,42,32,FMN GV 16 Berchem TOT
54,Posthofbrug 5366,2019-03-05,15:00:00,141,78,63,FMN GV 16 Berchem TOT
54,Posthofbrug 5366,2019-03-05,16:00:00,292,165,127,FMN GV 16 Berchem TOT
54,Posthofbrug 5366,2019-03-05,17:00:00,397,184,213,FMN GV 16 Berchem TOT
54,Posthofbrug 5366,2019-03-05,18:00:00,280,127,153,FMN GV 16 Berchem TOT
54,Posthofbrug 5366,2019-03-05,19:00:00,133,56,77,FMN GV 16 Berchem TOT
54,Posthofbrug 5366,2019-03-05,20:00:00,77,40,37,FMN GV 16 Berchem TOT
54,Posthofbrug 5366,2019-03-05,21:00:00,48,24,24,FMN GV 16 Berchem TOT
54,Posthofbrug 5366,2019-03-05,22:00:00,51,31,20,FMN GV 16 Berchem TOT
54,Posthofbrug 5366,2019-03-05,23:00:00,38,10,28,FMN GV 16 Berchem TOT
54,Posthofbrug 5366,2019-03-06,00:00:00,13,4,9,FMN GV 16 Berchem TOT
54,Posthofbrug 5366,2019-03-06,01:00:00,2,1,1,FMN GV 16 Berchem TOT
54,Posthofbrug 5366,2019-03-06,02:00:00,0,0,0,FMN GV 16 Berchem TOT
54,Posthofbrug 5366,2019-03-06,03:00:00,8,3,5,FMN GV 16 Berchem TOT
54,Posthofbrug 5366,2019-03-06,04:00:00,7,3,4,FMN GV 16 Berchem TOT
54,Posthofbrug 5366,2019-03-06,05:00:00,18,12,6,FMN GV 16 Berchem TOT
54,Posthofbrug 5366,2019-03-06,06:00:00,84,62,22,FMN GV 16 Berchem TOT
54,Posthofbrug 5366,2019-03-06,07:00:00,268,180,88,FMN GV 16 Berchem TOT
54,Posthofbrug 5366,2019-03-06,08:00:00,430,273,157,FMN GV 16 Berchem TOT
54,Posthofbrug 5366,2019-03-06,09:00:00,150,101,49,FMN GV 16 Berchem TOT
54,Posthofbrug 5366,2019-03-06,10:00:00,71,53,18,FMN GV 16 Berchem TOT
54,Posthofbrug 5366,2019-03-06,11:00:00,45,29,16,FMN GV 16 Berchem TOT
54,Posthofbrug 5366,2019-03-06,12:00:00,121,81,40,FMN GV 16 Berchem TOT
54,Posthofbrug 5366,2019-03-06,13:00:00,87,50,37,FMN GV 16 Berchem TOT
54,Posthofbrug 5366,2019-03-06,14:00:00,82,45,37,FMN GV 16 Berchem TOT
54,Posthofbrug 5366,2019-03-06,15:00:00,107,58,49,FMN GV 16 Berchem TOT
54,Posthofbrug 5366,2019-03-06,16:00:00,217,129,88,FMN GV 16 Berchem TOT
54,Posthofbrug 5366,2019-03-06,17:00:00,350,183,167,FMN GV 16 Berchem TOT
54,Posthofbrug 5366,2019-03-06,18:00:00,238,105,133,FMN GV 16 Berchem TOT
54,Posthofbrug 5366,2019-03-06,19:00:00,101,52,49,FMN GV 16 Berchem TOT
54,Posthofbrug 5366,2019-03-06,20:00:00,85,56,29,FMN GV 16 Berchem TOT
54,Posthofbrug 5366,2019-03-06,21:00:00,64,38,26,FMN GV 16 Berchem TOT
54,Posthofbrug 5366,2019-03-06,22:00:00,39,21,18,FMN GV 16 Berchem TOT
54,Posthofbrug 5366,2019-03-06,23:00:00,29,9,20,FMN GV 16 Berchem TOT
54,Posthofbrug 5366,2019-03-07,00:00:00,26,10,16,FMN GV 16 Berchem TOT
54,Posthofbrug 5366,2019-03-07,01:00:00,5,0,5,FMN GV 16 Berchem TOT
54,Posthofbrug 5366,2019-03-07,02:00:00,6,3,3,FMN GV 16 Berchem TOT
54,Posthofbrug 5366,2019-03-07,03:00:00,7,1,6,FMN GV 16 Berchem TOT
54,Posthofbrug 5366,2019-03-07,04:00:00,5,4,1,FMN GV 16 Berchem TOT
54,Posthofbrug 5366,2019-03-07,05:00:00,14,9,5,FMN GV 16 Berchem TOT
54,Posthofbrug 5366,2019-03-07,06:00:00,50,34,16,FMN GV 16 Berchem TOT
54,Posthofbrug 5366,2019-03-07,07:00:00,249,164,85,FMN GV 16 Berchem TOT
54,Posthofbrug 5366,2019-03-07,08:00:00,408,246,162,FMN GV 16 Berchem TOT
54,Posthofbrug 5366,2019-03-07,09:00:00,166,111,55,FMN GV 16 Berchem TOT
54,Posthofbrug 5366,2019-03-07,10:00:00,94,76,18,FMN GV 16 Berchem TOT
54,Posthofbrug 5366,2019-03-07,11:00:00,73,44,29,FMN GV 16 Berchem TOT
54,Posthofbrug 5366,2019-03-07,12:00:00,123,72,51,FMN GV 16 Berchem TOT
54,Posthofbrug 5366,2019-03-07,13:00:00,70,42,28,FMN GV 16 Berchem TOT
54,Posthofbrug 5366,2019-03-07,14:00:00,73,35,38,FMN GV 16 Berchem TOT
54,Posthofbrug 5366,2019-03-07,15:00:00,91,49,42,FMN GV 16 Berchem TOT
54,Posthofbrug 5366,2019-03-07,16:00:00,221,136,85,FMN GV 16 Berchem TOT
54,Posthofbrug 5366,2019-03-07,17:00:00,339,160,179,FMN GV 16 Berchem TOT
54,Posthofbrug 5366,2019-03-07,18:00:00,211,105,106,FMN GV 16 Berchem TOT
54,Posthofbrug 5366,2019-03-07,19:00:00,101,50,51,FMN GV 16 Berchem TOT
54,Posthofbrug 5366,2019-03-07,20:00:00,65,41,24,FMN GV 16 Berchem TOT
54,Posthofbrug 5366,2019-03-07,21:00:00,37,17,20,FMN GV 16 Berchem TOT
54,Posthofbrug 5366,2019-03-07,22:00:00,40,19,21,FMN GV 16 Berchem TOT
54,Posthofbrug 5366,2019-03-07,23:00:00,23,9,14,FMN GV 16 Berchem TOT
54,Posthofbrug 5366,2019-03-08,00:00:00,24,9,15,FMN GV 16 Berchem TOT
54,Posthofbrug 5366,2019-03-08,01:00:00,8,2,6,FMN GV 16 Berchem TOT
54,Posthofbrug 5366,2019-03-08,02:00:00,7,1,6,FMN GV 16 Berchem TOT
54,Posthofbrug 5366,2019-03-08,03:00:00,4,3,1,FMN GV 16 Berchem TOT
54,Posthofbrug 5366,2019-03-08,04:00:00,11,6,5,FMN GV 16 Berchem TOT
54,Posthofbrug 5366,2019-03-08,05:00:00,20,14,6,FMN GV 16 Berchem TOT
54,Posthofbrug 5366,2019-03-08,06:00:00,62,41,21,FMN GV 16 Berchem TOT
54,Posthofbrug 5366,2019-03-08,07:00:00,206,143,63,FMN GV 16 Berchem TOT
54,Posthofbrug 5366,2019-03-08,08:00:00,363,227,136,FMN GV 16 Berchem TOT
54,Posthofbrug 5366,2019-03-08,09:00:00,155,99,56,FMN GV 16 Berchem TOT
54,Posthofbrug 5366,2019-03-08,10:00:00,96,68,28,FMN GV 16 Berchem TOT
54,Posthofbrug 5366,2019-03-08,11:00:00,82,52,30,FMN GV 16 Berchem TOT
54,Posthofbrug 5366,2019-03-08,12:00:00,127,73,54,FMN GV 16 Berchem TOT
54,Posthofbrug 5366,2019-03-08,13:00:00,126,69,57,FMN GV 16 Berchem TOT
54,Posthofbrug 5366,2019-03-08,14:00:00,96,51,45,FMN GV 16 Berchem TOT
54,Posthofbrug 5366,2019-03-08,15:00:00,140,73,67,FMN GV 16 Berchem TOT
54,Posthofbrug 5366,2019-03-08,16:00:00,258,147,111,FMN GV 16 Berchem TOT
54,Posthofbrug 5366,2019-03-08,17:00:00,351,187,164,FMN GV 16 Berchem TOT
54,Posthofbrug 5366,2019-03-08,18:00:00,178,102,76,FMN GV 16 Berchem TOT
54,Posthofbrug 5366,2019-03-08,19:00:00,108,59,49,FMN GV 16 Berchem TOT
54,Posthofbrug 5366,2019-03-08,20:00:00,44,32,12,FMN GV 16 Berchem TOT
54,Posthofbrug 5366,2019-03-08,21:00:00,40,22,18,FMN GV 16 Berchem TOT
54,Posthofbrug 5366,2019-03-08,22:00:00,34,14,20,FMN GV 16 Berchem TOT
54,Posthofbrug 5366,2019-03-08,23:00:00,37,12,25,FMN GV 16 Berchem TOT
54,Posthofbrug 5366,2019-03-09,00:00:00,36,13,23,FMN GV 16 Berchem TOT
54,Posthofbrug 5366,2019-03-09,01:00:00,15,4,11,FMN GV 16 Berchem TOT
54,Posthofbrug 5366,2019-03-09,02:00:00,14,2,12,FMN GV 16 Berchem TOT
54,Posthofbrug 5366,2019-03-09,03:00:00,18,7,11,FMN GV 16 Berchem TOT
54,Posthofbrug 5366,2019-03-09,04:00:00,13,7,6,FMN GV 16 Berchem TOT
54,Posthofbrug 5366,2019-03-09,05:00:00,15,8,7,FMN GV 16 Berchem TOT
54,Posthofbrug 5366,2019-03-09,06:00:00,17,11,6,FMN GV 16 Berchem TOT
54,Posthofbrug 5366,2019-03-09,07:00:00,15,10,5,FMN GV 16 Berchem TOT
54,Posthofbrug 5366,2019-03-09,08:00:00,36,25,11,FMN GV 16 Berchem TOT
54,Posthofbrug 5366,2019-03-09,09:00:00,40,27,13,FMN GV 16 Berchem TOT
54,Posthofbrug 5366,2019-03-09,10:00:00,64,51,13,FMN GV 16 Berchem TOT
54,Posthofbrug 5366,2019-03-09,11:00:00,82,43,39,FMN GV 16 Berchem TOT
54,Posthofbrug 5366,2019-03-09,12:00:00,92,64,28,FMN GV 16 Berchem TOT
54,Posthofbrug 5366,2019-03-09,13:00:00,91,47,44,FMN GV 16 Berchem TOT
54,Posthofbrug 5366,2019-03-09,14:00:00,82,47,35,FMN GV 16 Berchem TOT
54,Posthofbrug 5366,2019-03-09,15:00:00,77,33,44,FMN GV 16 Berchem TOT
54,Posthofbrug 5366,2019-03-09,16:00:00,75,44,31,FMN GV 16 Berchem TOT
54,Posthofbrug 5366,2019-03-09,17:00:00,82,49,33,FMN GV 16 Berchem TOT
54,Posthofbrug 5366,2019-03-09,18:00:00,103,48,55,FMN GV 16 Berchem TOT
54,Posthofbrug 5366,2019-03-09,19:00:00,51,27,24,FMN GV 16 Berchem TOT
54,Posthofbrug 5366,2019-03-09,20:00:00,45,29,16,FMN GV 16 Berchem TOT
54,Posthofbrug 5366,2019-03-09,21:00:00,25,16,9,FMN GV 16 Berchem TOT
54,Posthofbrug 5366,2019-03-09,22:00:00,28,15,13,FMN GV 16 Berchem TOT
54,Posthofbrug 5366,2019-03-09,23:00:00,32,16,16,FMN GV 16 Berchem TOT
54,Posthofbrug 5366,2019-03-10,00:00:00,32,9,23,FMN GV 16 Berchem TOT
54,Posthofbrug 5366,2019-03-10,01:00:00,21,6,15,FMN GV 16 Berchem TOT
54,Posthofbrug 5366,2019-03-10,02:00:00,15,5,10,FMN GV 16 Berchem TOT
54,Posthofbrug 5366,2019-03-10,03:00:00,19,3,16,FMN GV 16 Berchem TOT
54,Posthofbrug 5366,2019-03-10,04:00:00,11,5,6,FMN GV 16 Berchem TOT
54,Posthofbrug 5366,2019-03-10,05:00:00,6,3,3,FMN GV 16 Berchem TOT
54,Posthofbrug 5366,2019-03-10,06:00:00,9,4,5,FMN GV 16 Berchem TOT
54,Posthofbrug 5366,2019-03-10,07:00:00,10,5,5,FMN GV 16 Berchem TOT
54,Posthofbrug 5366,2019-03-10,08:00:00,20,13,7,FMN GV 16 Berchem TOT
54,Posthofbrug 5366,2019-03-10,09:00:00,47,33,14,FMN GV 16 Berchem TOT
54,Posthofbrug 5366,2019-03-10,10:00:00,20,14,6,FMN GV 16 Berchem TOT
54,Posthofbrug 5366,2019-03-10,11:00:00,32,16,16,FMN GV 16 Berchem TOT
54,Posthofbrug 5366,2019-03-10,12:00:00,43,20,23,FMN GV 16 Berchem TOT
54,Posthofbrug 5366,2019-03-10,13:00:00,39,20,19,FMN GV 16 Berchem TOT
54,Posthofbrug 5366,2019-03-10,14:00:00,24,18,6,FMN GV 16 Berchem TOT
54,Posthofbrug 5366,2019-03-10,15:00:00,16,7,9,FMN GV 16 Berchem TOT
54,Posthofbrug 5366,2019-03-10,16:00:00,34,21,13,FMN GV 16 Berchem TOT
54,Posthofbrug 5366,2019-03-10,17:00:00,35,18,17,FMN GV 16 Berchem TOT
54,Posthofbrug 5366,2019-03-10,18:00:00,38,19,19,FMN GV 16 Berchem TOT
54,Posthofbrug 5366,2019-03-10,19:00:00,27,8,19,FMN GV 16 Berchem TOT
54,Posthofbrug 5366,2019-03-10,20:00:00,23,9,14,FMN GV 16 Berchem TOT
54,Posthofbrug 5366,2019-03-10,21:00:00,13,9,4,FMN GV 16 Berchem TOT
54,Posthofbrug 5366,2019-03-10,22:00:00,25,11,14,FMN GV 16 Berchem TOT
54,Posthofbrug 5366,2019-03-10,23:00:00,11,5,6,FMN GV 16 Berchem TOT
54,Posthofbrug 5366,2019-03-11,00:00:00,5,3,2,FMN GV 16 Berchem TOT
54,Posthofbrug 5366,2019-03-11,01:00:00,2,1,1,FMN GV 16 Berchem TOT
54,Posthofbrug 5366,2019-03-11,02:00:00,0,0,0,FMN GV 16 Berchem TOT
54,Posthofbrug 5366,2019-03-11,03:00:00,2,2,0,FMN GV 16 Berchem TOT
54,Posthofbrug 5366,2019-03-11,04:00:00,8,7,1,FMN GV 16 Berchem TOT
54,Posthofbrug 5366,2019-03-11,05:00:00,20,11,9,FMN GV 16 Berchem TOT
54,Posthofbrug 5366,2019-03-11,06:00:00,80,66,14,FMN GV 16 Berchem TOT
54,Posthofbrug 5366,2019-03-11,07:00:00,337,234,103,FMN GV 16 Berchem TOT
54,Posthofbrug 5366,2019-03-11,08:00:00,607,404,203,FMN GV 16 Berchem TOT
54,Posthofbrug 5366,2019-03-11,09:00:00,168,113,55,FMN GV 16 Berchem TOT
54,Posthofbrug 5366,2019-03-11,10:00:00,82,50,32,FMN GV 16 Berchem TOT
54,Posthofbrug 5366,2019-03-11,11:00:00,72,46,26,FMN GV 16 Berchem TOT
54,Posthofbrug 5366,2019-03-11,12:00:00,105,71,34,FMN GV 16 Berchem TOT
54,Posthofbrug 5366,2019-03-11,13:00:00,92,56,36,FMN GV 16 Berchem TOT
54,Posthofbrug 5366,2019-03-11,14:00:00,82,44,38,FMN GV 16 Berchem TOT
54,Posthofbrug 5366,2019-03-11,15:00:00,170,91,79,FMN GV 16 Berchem TOT
54,Posthofbrug 5366,2019-03-11,16:00:00,343,173,170,FMN GV 16 Berchem TOT
54,Posthofbrug 5366,2019-03-11,17:00:00,447,198,249,FMN GV 16 Berchem TOT
54,Posthofbrug 5366,2019-03-11,18:00:00,286,120,166,FMN GV 16 Berchem TOT
54,Posthofbrug 5366,2019-03-11,19:00:00,125,51,74,FMN GV 16 Berchem TOT
54,Posthofbrug 5366,2019-03-11,20:00:00,82,46,36,FMN GV 16 Berchem TOT
54,Posthofbrug 5366,2019-03-11,21:00:00,55,27,28,FMN GV 16 Berchem TOT
54,Posthofbrug 5366,2019-03-11,22:00:00,56,24,32,FMN GV 16 Berchem TOT
54,Posthofbrug 5366,2019-03-11,23:00:00,25,5,20,FMN GV 16 Berchem TOT
54,Posthofbrug 5366,2019-03-12,00:00:00,9,2,7,FMN GV 16 Berchem TOT
54,Posthofbrug 5366,2019-03-12,01:00:00,1,1,0,FMN GV 16 Berchem TOT
54,Posthofbrug 5366,2019-03-12,02:00:00,1,0,1,FMN GV 16 Berchem TOT
54,Posthofbrug 5366,2019-03-12,03:00:00,7,2,5,FMN GV 16 Berchem TOT
54,Posthofbrug 5366,2019-03-12,04:00:00,6,5,1,FMN GV 16 Berchem TOT
54,Posthofbrug 5366,2019-03-12,05:00:00,15,8,7,FMN GV 16 Berchem TOT
54,Posthofbrug 5366,2019-03-12,06:00:00,106,87,19,FMN GV 16 Berchem TOT
54,Posthofbrug 5366,2019-03-12,07:00:00,403,290,113,FMN GV 16 Berchem TOT
54,Posthofbrug 5366,2019-03-12,08:00:00,699,435,264,FMN GV 16 Berchem TOT
54,Posthofbrug 5366,2019-03-12,09:00:00,214,158,56,FMN GV 16 Berchem TOT
54,Posthofbrug 5366,2019-03-12,10:00:00,75,47,28,FMN GV 16 Berchem TOT
54,Posthofbrug 5366,2019-03-12,11:00:00,89,50,39,FMN GV 16 Berchem TOT
54,Posthofbrug 5366,2019-03-12,12:00:00,90,60,30,FMN GV 16 Berchem TOT
54,Posthofbrug 5366,2019-03-12,13:00:00,104,62,42,FMN GV 16 Berchem TOT
54,Posthofbrug 5366,2019-03-12,14:00:00,91,48,43,FMN GV 16 Berchem TOT
54,Posthofbrug 5366,2019-03-12,15:00:00,164,85,79,FMN GV 16 Berchem TOT
54,Posthofbrug 5366,2019-03-12,16:00:00,380,192,188,FMN GV 16 Berchem TOT
54,Posthofbrug 5366,2019-03-12,17:00:00,515,249,266,FMN GV 16 Berchem TOT
54,Posthofbrug 5366,2019-03-12,18:00:00,314,116,198,FMN GV 16 Berchem TOT
54,Posthofbrug 5366,2019-03-12,19:00:00,109,62,47,FMN GV 16 Berchem TOT
54,Posthofbrug 5366,2019-03-12,20:00:00,61,28,33,FMN GV 16 Berchem TOT
54,Posthofbrug 5366,2019-03-12,21:00:00,58,22,36,FMN GV 16 Berchem TOT
54,Posthofbrug 5366,2019-03-12,22:00:00,39,11,28,FMN GV 16 Berchem TOT
54,Posthofbrug 5366,2019-03-12,23:00:00,19,11,8,FMN GV 16 Berchem TOT
54,Posthofbrug 5366,2019-03-13,00:00:00,20,8,12,FMN GV 16 Berchem TOT
54,Posthofbrug 5366,2019-03-13,01:00:00,4,0,4,FMN GV 16 Berchem TOT
54,Posthofbrug 5366,2019-03-13,02:00:00,1,0,1,FMN GV 16 Berchem TOT
54,Posthofbrug 5366,2019-03-13,03:00:00,4,2,2,FMN GV 16 Berchem TOT
54,Posthofbrug 5366,2019-03-13,04:00:00,2,1,1,FMN GV 16 Berchem TOT
54,Posthofbrug 5366,2019-03-13,05:00:00,16,11,5,FMN GV 16 Berchem TOT
54,Posthofbrug 5366,2019-03-13,06:00:00,81,58,23,FMN GV 16 Berchem TOT
54,Posthofbrug 5366,2019-03-13,07:00:00,354,240,114,FMN GV 16 Berchem TOT
54,Posthofbrug 5366,2019-03-13,08:00:00,528,345,183,FMN GV 16 Berchem TOT
54,Posthofbrug 5366,2019-03-13,09:00:00,157,106,51,FMN GV 16 Berchem TOT
54,Posthofbrug 5366,2019-03-13,10:00:00,61,44,17,FMN GV 16 Berchem TOT
54,Posthofbrug 5366,2019-03-13,11:00:00,68,48,20,FMN GV 16 Berchem TOT
54,Posthofbrug 5366,2019-03-13,12:00:00,176,104,72,FMN GV 16 Berchem TOT
54,Posthofbrug 5366,2019-03-13,13:00:00,111,63,48,FMN GV 16 Berchem TOT
54,Posthofbrug 5366,2019-03-13,14:00:00,88,49,39,FMN GV 16 Berchem TOT
54,Posthofbrug 5366,2019-03-13,15:00:00,113,59,54,FMN GV 16 Berchem TOT
54,Posthofbrug 5366,2019-03-13,16:00:00,244,130,114,FMN GV 16 Berchem TOT
54,Posthofbrug 5366,2019-03-13,17:00:00,426,207,219,FMN GV 16 Berchem TOT
54,Posthofbrug 5366,2019-03-13,18:00:00,258,136,122,FMN GV 16 Berchem TOT
54,Posthofbrug 5366,2019-03-13,19:00:00,114,57,57,FMN GV 16 Berchem TOT
54,Posthofbrug 5366,2019-03-13,20:00:00,71,39,32,FMN GV 16 Berchem TOT
54,Posthofbrug 5366,2019-03-13,21:00:00,39,15,24,FMN GV 16 Berchem TOT
54,Posthofbrug 5366,2019-03-13,22:00:00,53,24,29,FMN GV 16 Berchem TOT
54,Posthofbrug 5366,2019-03-13,23:00:00,35,12,23,FMN GV 16 Berchem TOT
54,Posthofbrug 5366,2019-03-14,00:00:00,10,4,6,FMN GV 16 Berchem TOT
54,Posthofbrug 5366,2019-03-14,01:00:00,8,1,7,FMN GV 16 Berchem TOT
54,Posthofbrug 5366,2019-03-14,02:00:00,1,0,1,FMN GV 16 Berchem TOT
54,Posthofbrug 5366,2019-03-14,03:00:00,3,1,2,FMN GV 16 Berchem TOT
54,Posthofbrug 5366,2019-03-14,04:00:00,5,2,3,FMN GV 16 Berchem TOT
54,Posthofbrug 5366,2019-03-14,05:00:00,20,11,9,FMN GV 16 Berchem TOT
54,Posthofbrug 5366,2019-03-14,06:00:00,80,65,15,FMN GV 16 Berchem TOT
54,Posthofbrug 5366,2019-03-14,07:00:00,344,249,95,FMN GV 16 Berchem TOT
54,Posthofbrug 5366,2019-03-14,08:00:00,503,328,175,FMN GV 16 Berchem TOT
54,Posthofbrug 5366,2019-03-14,09:00:00,160,116,44,FMN GV 16 Berchem TOT
54,Posthofbrug 5366,2019-03-14,10:00:00,53,41,12,FMN GV 16 Berchem TOT
54,Posthofbrug 5366,2019-03-14,11:00:00,47,32,15,FMN GV 16 Berchem TOT
54,Posthofbrug 5366,2019-03-14,12:00:00,85,52,33,FMN GV 16 Berchem TOT
54,Posthofbrug 5366,2019-03-14,13:00:00,64,43,21,FMN GV 16 Berchem TOT
54,Posthofbrug 5366,2019-03-14,14:00:00,74,38,36,FMN GV 16 Berchem TOT
54,Posthofbrug 5366,2019-03-14,15:00:00,138,76,62,FMN GV 16 Berchem TOT
54,Posthofbrug 5366,2019-03-14,16:00:00,259,137,122,FMN GV 16 Berchem TOT
54,Posthofbrug 5366,2019-03-14,17:00:00,383,185,198,FMN GV 16 Berchem TOT
54,Posthofbrug 5366,2019-03-14,18:00:00,279,146,133,FMN GV 16 Berchem TOT
54,Posthofbrug 5366,2019-03-14,19:00:00,135,57,78,FMN GV 16 Berchem TOT
54,Posthofbrug 5366,2019-03-14,20:00:00,67,32,35,FMN GV 16 Berchem TOT
54,Posthofbrug 5366,2019-03-14,21:00:00,52,27,25,FMN GV 16 Berchem TOT
54,Posthofbrug 5366,2019-03-14,22:00:00,65,25,40,FMN GV 16 Berchem TOT
54,Posthofbrug 5366,2019-03-14,23:00:00,27,11,16,FMN GV 16 Berchem TOT
54,Posthofbrug 5366,2019-03-15,00:00:00,15,5,10,FMN GV 16 Berchem TOT
54,Posthofbrug 5366,2019-03-15,01:00:00,4,0,4,FMN GV 16 Berchem TOT
54,Posthofbrug 5366,2019-03-15,02:00:00,1,1,0,FMN GV 16 Berchem TOT
54,Posthofbrug 5366,2019-03-15,03:00:00,4,2,2,FMN GV 16 Berchem TOT
54,Posthofbrug 5366,2019-03-15,04:00:00,5,2,3,FMN GV 16 Berchem TOT
54,Posthofbrug 5366,2019-03-15,05:00:00,14,11,3,FMN GV 16 Berchem TOT
54,Posthofbrug 5366,2019-03-15,06:00:00,79,60,19,FMN GV 16 Berchem TOT
54,Posthofbrug 5366,2019-03-15,07:00:00,281,203,78,FMN GV 16 Berchem TOT
54,Posthofbrug 5366,2019-03-15,08:00:00,439,309,130,FMN GV 16 Berchem TOT
54,Posthofbrug 5366,2019-03-15,09:00:00,169,100,69,FMN GV 16 Berchem TOT
54,Posthofbrug 5366,2019-03-15,10:00:00,71,54,17,FMN GV 16 Berchem TOT
54,Posthofbrug 5366,2019-03-15,11:00:00,77,57,20,FMN GV 16 Berchem TOT
54,Posthofbrug 5366,2019-03-15,12:00:00,112,67,45,FMN GV 16 Berchem TOT
54,Posthofbrug 5366,2019-03-15,13:00:00,100,60,40,FMN GV 16 Berchem TOT
54,Posthofbrug 5366,2019-03-15,14:00:00,92,50,42,FMN GV 16 Berchem TOT
54,Posthofbrug 5366,2019-03-15,15:00:00,158,79,79,FMN GV 16 Berchem TOT
54,Posthofbrug 5366,2019-03-15,16:00:00,294,160,134,FMN GV 16 Berchem TOT
54,Posthofbrug 5366,2019-03-15,17:00:00,325,165,160,FMN GV 16 Berchem TOT
54,Posthofbrug 5366,2019-03-15,18:00:00,206,110,96,FMN GV 16 Berchem TOT
54,Posthofbrug 5366,2019-03-15,19:00:00,69,28,41,FMN GV 16 Berchem TOT
54,Posthofbrug 5366,2019-03-15,20:00:00,55,33,22,FMN GV 16 Berchem TOT
54,Posthofbrug 5366,2019-03-15,21:00:00,35,18,17,FMN GV 16 Berchem TOT
54,Posthofbrug 5366,2019-03-15,22:00:00,30,14,16,FMN GV 16 Berchem TOT
54,Posthofbrug 5366,2019-03-15,23:00:00,31,9,22,FMN GV 16 Berchem TOT
54,Posthofbrug 5366,2019-03-16,00:00:00,20,7,13,FMN GV 16 Berchem TOT
54,Posthofbrug 5366,2019-03-16,01:00:00,17,10,7,FMN GV 16 Berchem TOT
54,Posthofbrug 5366,2019-03-16,02:00:00,13,1,12,FMN GV 16 Berchem TOT
54,Posthofbrug 5366,2019-03-16,03:00:00,13,2,11,FMN GV 16 Berchem TOT
54,Posthofbrug 5366,2019-03-16,04:00:00,12,3,9,FMN GV 16 Berchem TOT
54,Posthofbrug 5366,2019-03-16,05:00:00,12,8,4,FMN GV 16 Berchem TOT
54,Posthofbrug 5366,2019-03-16,06:00:00,12,6,6,FMN GV 16 Berchem TOT
54,Posthofbrug 5366,2019-03-16,07:00:00,21,11,10,FMN GV 16 Berchem TOT
54,Posthofbrug 5366,2019-03-16,08:00:00,41,25,16,FMN GV 16 Berchem TOT
54,Posthofbrug 5366,2019-03-16,09:00:00,74,39,35,FMN GV 16 Berchem TOT
54,Posthofbrug 5366,2019-03-16,10:00:00,72,45,27,FMN GV 16 Berchem TOT
54,Posthofbrug 5366,2019-03-16,11:00:00,84,54,30,FMN GV 16 Berchem TOT
54,Posthofbrug 5366,2019-03-16,12:00:00,72,40,32,FMN GV 16 Berchem TOT
54,Posthofbrug 5366,2019-03-16,13:00:00,92,66,26,FMN GV 16 Berchem TOT
54,Posthofbrug 5366,2019-03-16,14:00:00,90,50,40,FMN GV 16 Berchem TOT
54,Posthofbrug 5366,2019-03-16,15:00:00,58,39,19,FMN GV 16 Berchem TOT
54,Posthofbrug 5366,2019-03-16,16:00:00,58,32,26,FMN GV 16 Berchem TOT
54,Posthofbrug 5366,2019-03-16,17:00:00,82,47,35,FMN GV 16 Berchem TOT
54,Posthofbrug 5366,2019-03-16,18:00:00,95,44,51,FMN GV 16 Berchem TOT
54,Posthofbrug 5366,2019-03-16,19:00:00,68,45,23,FMN GV 16 Berchem TOT
54,Posthofbrug 5366,2019-03-16,20:00:00,45,27,18,FMN GV 16 Berchem TOT
54,Posthofbrug 5366,2019-03-16,21:00:00,52,27,25,FMN GV 16 Berchem TOT
54,Posthofbrug 5366,2019-03-16,22:00:00,33,17,16,FMN GV 16 Berchem TOT
54,Posthofbrug 5366,2019-03-16,23:00:00,39,17,22,FMN GV 16 Berchem TOT
54,Posthofbrug 5366,2019-03-17,00:00:00,20,8,12,FMN GV 16 Berchem TOT
54,Posthofbrug 5366,2019-03-17,01:00:00,18,9,9,FMN GV 16 Berchem TOT
54,Posthofbrug 5366,2019-03-17,02:00:00,19,5,14,FMN GV 16 Berchem TOT
54,Posthofbrug 5366,2019-03-17,03:00:00,15,3,12,FMN GV 16 Berchem TOT
54,Posthofbrug 5366,2019-03-17,04:00:00,10,5,5,FMN GV 16 Berchem TOT
54,Posthofbrug 5366,2019-03-17,05:00:00,9,5,4,FMN GV 16 Berchem TOT
54,Posthofbrug 5366,2019-03-17,06:00:00,9,4,5,FMN GV 16 Berchem TOT
54,Posthofbrug 5366,2019-03-17,07:00:00,17,15,2,FMN GV 16 Berchem TOT
54,Posthofbrug 5366,2019-03-17,08:00:00,18,14,4,FMN GV 16 Berchem TOT
54,Posthofbrug 5366,2019-03-17,09:00:00,62,40,22,FMN GV 16 Berchem TOT
54,Posthofbrug 5366,2019-03-17,10:00:00,67,39,28,FMN GV 16 Berchem TOT
54,Posthofbrug 5366,2019-03-17,11:00:00,67,34,33,FMN GV 16 Berchem TOT
54,Posthofbrug 5366,2019-03-17,12:00:00,73,49,24,FMN GV 16 Berchem TOT
54,Posthofbrug 5366,2019-03-17,13:00:00,67,34,33,FMN GV 16 Berchem TOT
54,Posthofbrug 5366,2019-03-17,14:00:00,67,42,25,FMN GV 16 Berchem TOT
54,Posthofbrug 5366,2019-03-17,15:00:00,61,28,33,FMN GV 16 Berchem TOT
54,Posthofbrug 5366,2019-03-17,16:00:00,42,22,20,FMN GV 16 Berchem TOT
54,Posthofbrug 5366,2019-03-17,17:00:00,63,27,36,FMN GV 16 Berchem TOT
54,Posthofbrug 5366,2019-03-17,18:00:00,36,14,22,FMN GV 16 Berchem TOT
54,Posthofbrug 5366,2019-03-17,19:00:00,45,18,27,FMN GV 16 Berchem TOT
54,Posthofbrug 5366,2019-03-17,20:00:00,22,16,6,FMN GV 16 Berchem TOT
54,Posthofbrug 5366,2019-03-17,21:00:00,24,11,13,FMN GV 16 Berchem TOT
54,Posthofbrug 5366,2019-03-17,22:00:00,28,16,12,FMN GV 16 Berchem TOT
54,Posthofbrug 5366,2019-03-17,23:00:00,11,7,4,FMN GV 16 Berchem TOT
54,Posthofbrug 5366,2019-03-18,00:00:00,4,1,3,FMN GV 16 Berchem TOT
54,Posthofbrug 5366,2019-03-18,01:00:00,2,1,1,FMN GV 16 Berchem TOT
54,Posthofbrug 5366,2019-03-18,02:00:00,1,0,1,FMN GV 16 Berchem TOT
54,Posthofbrug 5366,2019-03-18,03:00:00,2,2,0,FMN GV 16 Berchem TOT
54,Posthofbrug 5366,2019-03-18,04:00:00,4,4,0,FMN GV 16 Berchem TOT
54,Posthofbrug 5366,2019-03-18,05:00:00,17,8,9,FMN GV 16 Berchem TOT
54,Posthofbrug 5366,2019-03-18,06:00:00,117,98,19,FMN GV 16 Berchem TOT
54,Posthofbrug 5366,2019-03-18,07:00:00,431,301,130,FMN GV 16 Berchem TOT
54,Posthofbrug 5366,2019-03-18,08:00:00,690,438,252,FMN GV 16 Berchem TOT
54,Posthofbrug 5366,2019-03-18,09:00:00,219,161,58,FMN GV 16 Berchem TOT
54,Posthofbrug 5366,2019-03-18,10:00:00,129,93,36,FMN GV 16 Berchem TOT
54,Posthofbrug 5366,2019-03-18,11:00:00,92,59,33,FMN GV 16 Berchem TOT
54,Posthofbrug 5366,2019-03-18,12:00:00,122,78,44,FMN GV 16 Berchem TOT
54,Posthofbrug 5366,2019-03-18,13:00:00,135,71,64,FMN GV 16 Berchem TOT
54,Posthofbrug 5366,2019-03-18,14:00:00,123,61,62,FMN GV 16 Berchem TOT
54,Posthofbrug 5366,2019-03-18,15:00:00,198,106,92,FMN GV 16 Berchem TOT
54,Posthofbrug 5366,2019-03-18,16:00:00,351,179,172,FMN GV 16 Berchem TOT
54,Posthofbrug 5366,2019-03-18,17:00:00,544,258,286,FMN GV 16 Berchem TOT
54,Posthofbrug 5366,2019-03-18,18:00:00,365,181,184,FMN GV 16 Berchem TOT
54,Posthofbrug 5366,2019-03-18,19:00:00,152,76,76,FMN GV 16 Berchem TOT
54,Posthofbrug 5366,2019-03-18,20:00:00,73,44,29,FMN GV 16 Berchem TOT
54,Posthofbrug 5366,2019-03-18,21:00:00,59,29,30,FMN GV 16 Berchem TOT
54,Posthofbrug 5366,2019-03-18,22:00:00,59,33,26,FMN GV 16 Berchem TOT
54,Posthofbrug 5366,2019-03-18,23:00:00,35,11,24,FMN GV 16 Berchem TOT
54,Posthofbrug 5366,2019-03-19,00:00:00,13,2,11,FMN GV 16 Berchem TOT
54,Posthofbrug 5366,2019-03-19,01:00:00,4,1,3,FMN GV 16 Berchem TOT
54,Posthofbrug 5366,2019-03-19,02:00:00,7,3,4,FMN GV 16 Berchem TOT
54,Posthofbrug 5366,2019-03-19,03:00:00,4,2,2,FMN GV 16 Berchem TOT
54,Posthofbrug 5366,2019-03-19,04:00:00,4,3,1,FMN GV 16 Berchem TOT
54,Posthofbrug 5366,2019-03-19,05:00:00,22,13,9,FMN GV 16 Berchem TOT
54,Posthofbrug 5366,2019-03-19,06:00:00,123,93,30,FMN GV 16 Berchem TOT
54,Posthofbrug 5366,2019-03-19,07:00:00,444,303,141,FMN GV 16 Berchem TOT
54,Posthofbrug 5366,2019-03-19,08:00:00,770,500,270,FMN GV 16 Berchem TOT
54,Posthofbrug 5366,2019-03-19,09:00:00,279,176,103,FMN GV 16 Berchem TOT
54,Posthofbrug 5366,2019-03-19,10:00:00,99,61,38,FMN GV 16 Berchem TOT
54,Posthofbrug 5366,2019-03-19,11:00:00,109,77,32,FMN GV 16 Berchem TOT
54,Posthofbrug 5366,2019-03-19,12:00:00,128,82,46,FMN GV 16 Berchem TOT
54,Posthofbrug 5366,2019-03-19,13:00:00,143,85,58,FMN GV 16 Berchem TOT
54,Posthofbrug 5366,2019-03-19,14:00:00,129,70,59,FMN GV 16 Berchem TOT
54,Posthofbrug 5366,2019-03-19,15:00:00,239,128,111,FMN GV 16 Berchem TOT
54,Posthofbrug 5366,2019-03-19,16:00:00,449,224,225,FMN GV 16 Berchem TOT
54,Posthofbrug 5366,2019-03-19,17:00:00,566,270,296,FMN GV 16 Berchem TOT
54,Posthofbrug 5366,2019-03-19,18:00:00,394,175,219,FMN GV 16 Berchem TOT
54,Posthofbrug 5366,2019-03-19,19:00:00,158,68,90,FMN GV 16 Berchem TOT
54,Posthofbrug 5366,2019-03-19,20:00:00,86,44,42,FMN GV 16 Berchem TOT
54,Posthofbrug 5366,2019-03-19,21:00:00,69,31,38,FMN GV 16 Berchem TOT
54,Posthofbrug 5366,2019-03-19,22:00:00,64,25,39,FMN GV 16 Berchem TOT
54,Posthofbrug 5366,2019-03-19,23:00:00,57,18,39,FMN GV 16 Berchem TOT
54,Posthofbrug 5366,2019-03-20,00:00:00,24,10,14,FMN GV 16 Berchem TOT
54,Posthofbrug 5366,2019-03-20,01:00:00,6,2,4,FMN GV 16 Berchem TOT
54,Posthofbrug 5366,2019-03-20,02:00:00,2,0,2,FMN GV 16 Berchem TOT
54,Posthofbrug 5366,2019-03-20,03:00:00,4,2,2,FMN GV 16 Berchem TOT
54,Posthofbrug 5366,2019-03-20,04:00:00,17,4,13,FMN GV 16 Berchem TOT
54,Posthofbrug 5366,2019-03-20,05:00:00,25,17,8,FMN GV 16 Berchem TOT
54,Posthofbrug 5366,2019-03-20,06:00:00,119,94,25,FMN GV 16 Berchem TOT
54,Posthofbrug 5366,2019-03-20,07:00:00,393,274,119,FMN GV 16 Berchem TOT
54,Posthofbrug 5366,2019-03-20,08:00:00,602,386,216,FMN GV 16 Berchem TOT
54,Posthofbrug 5366,2019-03-20,09:00:00,213,158,55,FMN GV 16 Berchem TOT
54,Posthofbrug 5366,2019-03-20,10:00:00,112,74,38,FMN GV 16 Berchem TOT
54,Posthofbrug 5366,2019-03-20,11:00:00,113,69,44,FMN GV 16 Berchem TOT
54,Posthofbrug 5366,2019-03-20,12:00:00,219,128,91,FMN GV 16 Berchem TOT
54,Posthofbrug 5366,2019-03-20,13:00:00,183,107,76,FMN GV 16 Berchem TOT
54,Posthofbrug 5366,2019-03-20,14:00:00,132,64,68,FMN GV 16 Berchem TOT
54,Posthofbrug 5366,2019-03-20,15:00:00,194,98,96,FMN GV 16 Berchem TOT
54,Posthofbrug 5366,2019-03-20,16:00:00,378,198,180,FMN GV 16 Berchem TOT
54,Posthofbrug 5366,2019-03-20,17:00:00,459,234,225,FMN GV 16 Berchem TOT
54,Posthofbrug 5366,2019-03-20,18:00:00,373,186,187,FMN GV 16 Berchem TOT
54,Posthofbrug 5366,2019-03-20,19:00:00,135,79,56,FMN GV 16 Berchem TOT
54,Posthofbrug 5366,2019-03-20,20:00:00,69,32,37,FMN GV 16 Berchem TOT
54,Posthofbrug 5366,2019-03-20,21:00:00,67,30,37,FMN GV 16 Berchem TOT
54,Posthofbrug 5366,2019-03-20,22:00:00,44,18,26,FMN GV 16 Berchem TOT
54,Posthofbrug 5366,2019-03-20,23:00:00,33,10,23,FMN GV 16 Berchem TOT
54,Posthofbrug 5366,2019-03-21,00:00:00,18,9,9,FMN GV 16 Berchem TOT
54,Posthofbrug 5366,2019-03-21,01:00:00,9,2,7,FMN GV 16 Berchem TOT
54,Posthofbrug 5366,2019-03-21,02:00:00,7,0,7,FMN GV 16 Berchem TOT
54,Posthofbrug 5366,2019-03-21,03:00:00,2,1,1,FMN GV 16 Berchem TOT
54,Posthofbrug 5366,2019-03-21,04:00:00,10,7,3,FMN GV 16 Berchem TOT
54,Posthofbrug 5366,2019-03-21,05:00:00,24,14,10,FMN GV 16 Berchem TOT
54,Posthofbrug 5366,2019-03-21,06:00:00,124,85,39,FMN GV 16 Berchem TOT
54,Posthofbrug 5366,2019-03-21,07:00:00,482,338,144,FMN GV 16 Berchem TOT
54,Posthofbrug 5366,2019-03-21,08:00:00,755,498,257,FMN GV 16 Berchem TOT
54,Posthofbrug 5366,2019-03-21,09:00:00,252,174,78,FMN GV 16 Berchem TOT
54,Posthofbrug 5366,2019-03-21,10:00:00,115,79,36,FMN GV 16 Berchem TOT
54,Posthofbrug 5366,2019-03-21,11:00:00,107,69,38,FMN GV 16 Berchem TOT
54,Posthofbrug 5366,2019-03-21,12:00:00,189,110,79,FMN GV 16 Berchem TOT
54,Posthofbrug 5366,2019-03-21,13:00:00,144,79,65,FMN GV 16 Berchem TOT
54,Posthofbrug 5366,2019-03-21,14:00:00,131,70,61,FMN GV 16 Berchem TOT
54,Posthofbrug 5366,2019-03-21,15:00:00,234,122,112,FMN GV 16 Berchem TOT
54,Posthofbrug 5366,2019-03-21,16:00:00,459,226,233,FMN GV 16 Berchem TOT
54,Posthofbrug 5366,2019-03-21,17:00:00,584,309,275,FMN GV 16 Berchem TOT
54,Posthofbrug 5366,2019-03-21,18:00:00,361,163,198,FMN GV 16 Berchem TOT
54,Posthofbrug 5366,2019-03-21,19:00:00,173,78,95,FMN GV 16 Berchem TOT
54,Posthofbrug 5366,2019-03-21,20:00:00,104,50,54,FMN GV 16 Berchem TOT
54,Posthofbrug 5366,2019-03-21,21:00:00,88,45,43,FMN GV 16 Berchem TOT
54,Posthofbrug 5366,2019-03-21,22:00:00,84,37,47,FMN GV 16 Berchem TOT
54,Posthofbrug 5366,2019-03-21,23:00:00,55,19,36,FMN GV 16 Berchem TOT
54,Posthofbrug 5366,2019-03-22,00:00:00,40,12,28,FMN GV 16 Berchem TOT
54,Posthofbrug 5366,2019-03-22,01:00:00,7,2,5,FMN GV 16 Berchem TOT
54,Posthofbrug 5366,2019-03-22,02:00:00,8,2,6,FMN GV 16 Berchem TOT
54,Posthofbrug 5366,2019-03-22,03:00:00,10,1,9,FMN GV 16 Berchem TOT
54,Posthofbrug 5366,2019-03-22,04:00:00,12,9,3,FMN GV 16 Berchem TOT
54,Posthofbrug 5366,2019-03-22,05:00:00,29,17,12,FMN GV 16 Berchem TOT
54,Posthofbrug 5366,2019-03-22,06:00:00,107,89,18,FMN GV 16 Berchem TOT
54,Posthofbrug 5366,2019-03-22,07:00:00,375,262,113,FMN GV 16 Berchem TOT
54,Posthofbrug 5366,2019-03-22,08:00:00,650,427,223,FMN GV 16 Berchem TOT
54,Posthofbrug 5366,2019-03-22,09:00:00,242,169,73,FMN GV 16 Berchem TOT
54,Posthofbrug 5366,2019-03-22,10:00:00,114,78,36,FMN GV 16 Berchem TOT
54,Posthofbrug 5366,2019-03-22,11:00:00,133,82,51,FMN GV 16 Berchem TOT
54,Posthofbrug 5366,2019-03-22,12:00:00,162,98,64,FMN GV 16 Berchem TOT
54,Posthofbrug 5366,2019-03-22,13:00:00,192,101,91,FMN GV 16 Berchem TOT
54,Posthofbrug 5366,2019-03-22,14:00:00,162,81,81,FMN GV 16 Berchem TOT
54,Posthofbrug 5366,2019-03-22,15:00:00,291,156,135,FMN GV 16 Berchem TOT
54,Posthofbrug 5366,2019-03-22,16:00:00,465,239,226,FMN GV 16 Berchem TOT
54,Posthofbrug 5366,2019-03-22,17:00:00,477,243,234,FMN GV 16 Berchem TOT
54,Posthofbrug 5366,2019-03-22,18:00:00,327,172,155,FMN GV 16 Berchem TOT
54,Posthofbrug 5366,2019-03-22,19:00:00,176,85,91,FMN GV 16 Berchem TOT
54,Posthofbrug 5366,2019-03-22,20:00:00,82,44,38,FMN GV 16 Berchem TOT
54,Posthofbrug 5366,2019-03-22,21:00:00,74,36,38,FMN GV 16 Berchem TOT
54,Posthofbrug 5366,2019-03-22,22:00:00,50,15,35,FMN GV 16 Berchem TOT
54,Posthofbrug 5366,2019-03-22,23:00:00,69,28,41,FMN GV 16 Berchem TOT
54,Posthofbrug 5366,2019-03-23,00:00:00,56,31,25,FMN GV 16 Berchem TOT
54,Posthofbrug 5366,2019-03-23,01:00:00,30,8,22,FMN GV 16 Berchem TOT
54,Posthofbrug 5366,2019-03-23,02:00:00,28,9,19,FMN GV 16 Berchem TOT
54,Posthofbrug 5366,2019-03-23,03:00:00,11,5,6,FMN GV 16 Berchem TOT
54,Posthofbrug 5366,2019-03-23,04:00:00,12,4,8,FMN GV 16 Berchem TOT
54,Posthofbrug 5366,2019-03-23,05:00:00,15,7,8,FMN GV 16 Berchem TOT
54,Posthofbrug 5366,2019-03-23,06:00:00,20,12,8,FMN GV 16 Berchem TOT
54,Posthofbrug 5366,2019-03-23,07:00:00,20,11,9,FMN GV 16 Berchem TOT
54,Posthofbrug 5366,2019-03-23,08:00:00,52,34,18,FMN GV 16 Berchem TOT
54,Posthofbrug 5366,2019-03-23,09:00:00,129,79,50,FMN GV 16 Berchem TOT
54,Posthofbrug 5366,2019-03-23,10:00:00,114,79,35,FMN GV 16 Berchem TOT
54,Posthofbrug 5366,2019-03-23,11:00:00,128,82,46,FMN GV 16 Berchem TOT
54,Posthofbrug 5366,2019-03-23,12:00:00,107,57,50,FMN GV 16 Berchem TOT
54,Posthofbrug 5366,2019-03-23,13:00:00,154,104,50,FMN GV 16 Berchem TOT
54,Posthofbrug 5366,2019-03-23,14:00:00,132,76,56,FMN GV 16 Berchem TOT
54,Posthofbrug 5366,2019-03-23,15:00:00,92,48,44,FMN GV 16 Berchem TOT
54,Posthofbrug 5366,2019-03-23,16:00:00,127,55,72,FMN GV 16 Berchem TOT
54,Posthofbrug 5366,2019-03-23,17:00:00,125,54,71,FMN GV 16 Berchem TOT
54,Posthofbrug 5366,2019-03-23,18:00:00,111,63,48,FMN GV 16 Berchem TOT
54,Posthofbrug 5366,2019-03-23,19:00:00,109,74,35,FMN GV 16 Berchem TOT
54,Posthofbrug 5366,2019-03-23,20:00:00,57,42,15,FMN GV 16 Berchem TOT
54,Posthofbrug 5366,2019-03-23,21:00:00,93,61,32,FMN GV 16 Berchem TOT
54,Posthofbrug 5366,2019-03-23,22:00:00,48,23,25,FMN GV 16 Berchem TOT
54,Posthofbrug 5366,2019-03-23,23:00:00,47,23,24,FMN GV 16 Berchem TOT
54,Posthofbrug 5366,2019-03-24,00:00:00,45,25,20,FMN GV 16 Berchem TOT
54,Posthofbrug 5366,2019-03-24,01:00:00,38,8,30,FMN GV 16 Berchem TOT
54,Posthofbrug 5366,2019-03-24,02:00:00,16,9,7,FMN GV 16 Berchem TOT
54,Posthofbrug 5366,2019-03-24,03:00:00,19,8,11,FMN GV 16 Berchem TOT
54,Posthofbrug 5366,2019-03-24,04:00:00,13,7,6,FMN GV 16 Berchem TOT
54,Posthofbrug 5366,2019-03-24,05:00:00,13,7,6,FMN GV 16 Berchem TOT
54,Posthofbrug 5366,2019-03-24,06:00:00,14,7,7,FMN GV 16 Berchem TOT
54,Posthofbrug 5366,2019-03-24,07:00:00,17,11,6,FMN GV 16 Berchem TOT
54,Posthofbrug 5366,2019-03-24,08:00:00,43,26,17,FMN GV 16 Berchem TOT
54,Posthofbrug 5366,2019-03-24,09:00:00,91,57,34,FMN GV 16 Berchem TOT
54,Posthofbrug 5366,2019-03-24,10:00:00,153,90,63,FMN GV 16 Berchem TOT
54,Posthofbrug 5366,2019-03-24,11:00:00,106,70,36,FMN GV 16 Berchem TOT
54,Posthofbrug 5366,2019-03-24,12:00:00,155,94,61,FMN GV 16 Berchem TOT
54,Posthofbrug 5366,2019-03-24,13:00:00,157,93,64,FMN GV 16 Berchem TOT
54,Posthofbrug 5366,2019-03-24,14:00:00,173,98,75,FMN GV 16 Berchem TOT
54,Posthofbrug 5366,2019-03-24,15:00:00,124,82,42,FMN GV 16 Berchem TOT
54,Posthofbrug 5366,2019-03-24,16:00:00,174,89,85,FMN GV 16 Berchem TOT
54,Posthofbrug 5366,2019-03-24,17:00:00,165,93,72,FMN GV 16 Berchem TOT
54,Posthofbrug 5366,2019-03-24,18:00:00,98,43,55,FMN GV 16 Berchem TOT
54,Posthofbrug 5366,2019-03-24,19:00:00,62,26,36,FMN GV 16 Berchem TOT
54,Posthofbrug 5366,2019-03-24,20:00:00,59,27,32,FMN GV 16 Berchem TOT
54,Posthofbrug 5366,2019-03-24,21:00:00,39,21,18,FMN GV 16 Berchem TOT
54,Posthofbrug 5366,2019-03-24,22:00:00,29,13,16,FMN GV 16 Berchem TOT
54,Posthofbrug 5366,2019-03-24,23:00:00,21,10,11,FMN GV 16 Berchem TOT
54,Posthofbrug 5366,2019-03-25,00:00:00,6,2,4,FMN GV 16 Berchem TOT
54,Posthofbrug 5366,2019-03-25,01:00:00,2,2,0,FMN GV 16 Berchem TOT
54,Posthofbrug 5366,2019-03-25,02:00:00,1,1,0,FMN GV 16 Berchem TOT
54,Posthofbrug 5366,2019-03-25,03:00:00,0,0,0,FMN GV 16 Berchem TOT
54,Posthofbrug 5366,2019-03-25,04:00:00,7,4,3,FMN GV 16 Berchem TOT
54,Posthofbrug 5366,2019-03-25,05:00:00,18,10,8,FMN GV 16 Berchem TOT
54,Posthofbrug 5366,2019-03-25,06:00:00,99,88,11,FMN GV 16 Berchem TOT
54,Posthofbrug 5366,2019-03-25,07:00:00,427,294,133,FMN GV 16 Berchem TOT
54,Posthofbrug 5366,2019-03-25,08:00:00,688,465,223,FMN GV 16 Berchem TOT
54,Posthofbrug 5366,2019-03-25,09:00:00,237,159,78,FMN GV 16 Berchem TOT
54,Posthofbrug 5366,2019-03-25,10:00:00,85,60,25,FMN GV 16 Berchem TOT
54,Posthofbrug 5366,2019-03-25,11:00:00,81,49,32,FMN GV 16 Berchem TOT
54,Posthofbrug 5366,2019-03-25,12:00:00,134,87,47,FMN GV 16 Berchem TOT
54,Posthofbrug 5366,2019-03-25,13:00:00,116,64,52,FMN GV 16 Berchem TOT
54,Posthofbrug 5366,2019-03-25,14:00:00,88,48,40,FMN GV 16 Berchem TOT
54,Posthofbrug 5366,2019-03-25,15:00:00,221,117,104,FMN GV 16 Berchem TOT
54,Posthofbrug 5366,2019-03-25,16:00:00,397,228,169,FMN GV 16 Berchem TOT
54,Posthofbrug 5366,2019-03-25,17:00:00,506,272,234,FMN GV 16 Berchem TOT
54,Posthofbrug 5366,2019-03-25,18:00:00,320,151,169,FMN GV 16 Berchem TOT
54,Posthofbrug 5366,2019-03-25,19:00:00,141,74,67,FMN GV 16 Berchem TOT
54,Posthofbrug 5366,2019-03-25,20:00:00,64,38,26,FMN GV 16 Berchem TOT
54,Posthofbrug 5366,2019-03-25,21:00:00,71,33,38,FMN GV 16 Berchem TOT
54,Posthofbrug 5366,2019-03-25,22:00:00,48,24,24,FMN GV 16 Berchem TOT
54,Posthofbrug 5366,2019-03-25,23:00:00,25,9,16,FMN GV 16 Berchem TOT
54,Posthofbrug 5366,2019-03-26,00:00:00,14,4,10,FMN GV 16 Berchem TOT
54,Posthofbrug 5366,2019-03-26,01:00:00,5,1,4,FMN GV 16 Berchem TOT
54,Posthofbrug 5366,2019-03-26,02:00:00,3,0,3,FMN GV 16 Berchem TOT
54,Posthofbrug 5366,2019-03-26,03:00:00,5,1,4,FMN GV 16 Berchem TOT
54,Posthofbrug 5366,2019-03-26,04:00:00,10,6,4,FMN GV 16 Berchem TOT
54,Posthofbrug 5366,2019-03-26,05:00:00,25,19,6,FMN GV 16 Berchem TOT
54,Posthofbrug 5366,2019-03-26,06:00:00,118,88,30,FMN GV 16 Berchem TOT
54,Posthofbrug 5366,2019-03-26,07:00:00,479,308,171,FMN GV 16 Berchem TOT
54,Posthofbrug 5366,2019-03-26,08:00:00,732,478,254,FMN GV 16 Berchem TOT
54,Posthofbrug 5366,2019-03-26,09:00:00,224,148,76,FMN GV 16 Berchem TOT
54,Posthofbrug 5366,2019-03-26,10:00:00,111,79,32,FMN GV 16 Berchem TOT
54,Posthofbrug 5366,2019-03-26,11:00:00,85,62,23,FMN GV 16 Berchem TOT
54,Posthofbrug 5366,2019-03-26,12:00:00,136,88,48,FMN GV 16 Berchem TOT
54,Posthofbrug 5366,2019-03-26,13:00:00,125,74,51,FMN GV 16 Berchem TOT
54,Posthofbrug 5366,2019-03-26,14:00:00,97,50,47,FMN GV 16 Berchem TOT
54,Posthofbrug 5366,2019-03-26,15:00:00,218,131,87,FMN GV 16 Berchem TOT
54,Posthofbrug 5366,2019-03-26,16:00:00,394,208,186,FMN GV 16 Berchem TOT
54,Posthofbrug 5366,2019-03-26,17:00:00,599,323,276,FMN GV 16 Berchem TOT
54,Posthofbrug 5366,2019-03-26,18:00:00,383,187,196,FMN GV 16 Berchem TOT
54,Posthofbrug 5366,2019-03-26,19:00:00,151,65,86,FMN GV 16 Berchem TOT
54,Posthofbrug 5366,2019-03-26,20:00:00,111,56,55,FMN GV 16 Berchem TOT
54,Posthofbrug 5366,2019-03-26,21:00:00,76,34,42,FMN GV 16 Berchem TOT
54,Posthofbrug 5366,2019-03-26,22:00:00,73,39,34,FMN GV 16 Berchem TOT
54,Posthofbrug 5366,2019-03-26,23:00:00,36,15,21,FMN GV 16 Berchem TOT
54,Posthofbrug 5366,2019-03-27,00:00:00,24,4,20,FMN GV 16 Berchem TOT
54,Posthofbrug 5366,2019-03-27,01:00:00,10,3,7,FMN GV 16 Berchem TOT
54,Posthofbrug 5366,2019-03-27,02:00:00,0,0,0,FMN GV 16 Berchem TOT
54,Posthofbrug 5366,2019-03-27,03:00:00,5,2,3,FMN GV 16 Berchem TOT
54,Posthofbrug 5366,2019-03-27,04:00:00,4,4,0,FMN GV 16 Berchem TOT
54,Posthofbrug 5366,2019-03-27,05:00:00,31,22,9,FMN GV 16 Berchem TOT
54,Posthofbrug 5366,2019-03-27,06:00:00,108,88,20,FMN GV 16 Berchem TOT
54,Posthofbrug 5366,2019-03-27,07:00:00,407,285,122,FMN GV 16 Berchem TOT
54,Posthofbrug 5366,2019-03-27,08:00:00,679,434,245,FMN GV 16 Berchem TOT
54,Posthofbrug 5366,2019-03-27,09:00:00,188,126,62,FMN GV 16 Berchem TOT
54,Posthofbrug 5366,2019-03-27,10:00:00,103,62,41,FMN GV 16 Berchem TOT
54,Posthofbrug 5366,2019-03-27,11:00:00,107,67,40,FMN GV 16 Berchem TOT
54,Posthofbrug 5366,2019-03-27,12:00:00,230,136,94,FMN GV 16 Berchem TOT
54,Posthofbrug 5366,2019-03-27,13:00:00,139,82,57,FMN GV 16 Berchem TOT
54,Posthofbrug 5366,2019-03-27,14:00:00,108,60,48,FMN GV 16 Berchem TOT
54,Posthofbrug 5366,2019-03-27,15:00:00,169,95,74,FMN GV 16 Berchem TOT
54,Posthofbrug 5366,2019-03-27,16:00:00,333,184,149,FMN GV 16 Berchem TOT
54,Posthofbrug 5366,2019-03-27,17:00:00,552,298,254,FMN GV 16 Berchem TOT
54,Posthofbrug 5366,2019-03-27,18:00:00,278,140,138,FMN GV 16 Berchem TOT
54,Posthofbrug 5366,2019-03-27,19:00:00,177,95,82,FMN GV 16 Berchem TOT
54,Posthofbrug 5366,2019-03-27,20:00:00,88,49,39,FMN GV 16 Berchem TOT
54,Posthofbrug 5366,2019-03-27,21:00:00,72,31,41,FMN GV 16 Berchem TOT
54,Posthofbrug 5366,2019-03-27,22:00:00,76,30,46,FMN GV 16 Berchem TOT
54,Posthofbrug 5366,2019-03-27,23:00:00,34,15,19,FMN GV 16 Berchem TOT
54,Posthofbrug 5366,2019-03-28,00:00:00,20,5,15,FMN GV 16 Berchem TOT
54,Posthofbrug 5366,2019-03-28,01:00:00,9,3,6,FMN GV 16 Berchem TOT
54,Posthofbrug 5366,2019-03-28,02:00:00,4,2,2,FMN GV 16 Berchem TOT
54,Posthofbrug 5366,2019-03-28,03:00:00,6,2,4,FMN GV 16 Berchem TOT
54,Posthofbrug 5366,2019-03-28,04:00:00,7,2,5,FMN GV 16 Berchem TOT
54,Posthofbrug 5366,2019-03-28,05:00:00,31,21,10,FMN GV 16 Berchem TOT
54,Posthofbrug 5366,2019-03-28,06:00:00,106,83,23,FMN GV 16 Berchem TOT
54,Posthofbrug 5366,2019-03-28,07:00:00,456,307,149,FMN GV 16 Berchem TOT
54,Posthofbrug 5366,2019-03-28,08:00:00,719,455,264,FMN GV 16 Berchem TOT
54,Posthofbrug 5366,2019-03-28,09:00:00,249,165,84,FMN GV 16 Berchem TOT
54,Posthofbrug 5366,2019-03-28,10:00:00,128,87,41,FMN GV 16 Berchem TOT
54,Posthofbrug 5366,2019-03-28,11:00:00,137,82,55,FMN GV 16 Berchem TOT
54,Posthofbrug 5366,2019-03-28,12:00:00,165,103,62,FMN GV 16 Berchem TOT
54,Posthofbrug 5366,2019-03-28,13:00:00,138,78,60,FMN GV 16 Berchem TOT
54,Posthofbrug 5366,2019-03-28,14:00:00,143,86,57,FMN GV 16 Berchem TOT
54,Posthofbrug 5366,2019-03-28,15:00:00,252,144,108,FMN GV 16 Berchem TOT
54,Posthofbrug 5366,2019-03-28,16:00:00,413,214,199,FMN GV 16 Berchem TOT
54,Posthofbrug 5366,2019-03-28,17:00:00,543,284,259,FMN GV 16 Berchem TOT
54,Posthofbrug 5366,2019-03-28,18:00:00,299,160,139,FMN GV 16 Berchem TOT
54,Posthofbrug 5366,2019-03-28,19:00:00,191,103,88,FMN GV 16 Berchem TOT
54,Posthofbrug 5366,2019-03-28,20:00:00,123,62,61,FMN GV 16 Berchem TOT
54,Posthofbrug 5366,2019-03-28,21:00:00,91,45,46,FMN GV 16 Berchem TOT
54,Posthofbrug 5366,2019-03-28,22:00:00,80,38,42,FMN GV 16 Berchem TOT
54,Posthofbrug 5366,2019-03-28,23:00:00,48,9,39,FMN GV 16 Berchem TOT
54,Posthofbrug 5366,2019-03-29,00:00:00,32,12,20,FMN GV 16 Berchem TOT
54,Posthofbrug 5366,2019-03-29,01:00:00,0,0,0,FMN GV 16 Berchem TOT
54,Posthofbrug 5366,2019-03-29,02:00:00,8,5,3,FMN GV 16 Berchem TOT
54,Posthofbrug 5366,2019-03-29,03:00:00,2,1,1,FMN GV 16 Berchem TOT
54,Posthofbrug 5366,2019-03-29,04:00:00,9,4,5,FMN GV 16 Berchem TOT
54,Posthofbrug 5366,2019-03-29,05:00:00,22,17,5,FMN GV 16 Berchem TOT
54,Posthofbrug 5366,2019-03-29,06:00:00,95,80,15,FMN GV 16 Berchem TOT
54,Posthofbrug 5366,2019-03-29,07:00:00,367,264,103,FMN GV 16 Berchem TOT
54,Posthofbrug 5366,2019-03-29,08:00:00,624,438,186,FMN GV 16 Berchem TOT
54,Posthofbrug 5366,2019-03-29,09:00:00,242,161,81,FMN GV 16 Berchem TOT
54,Posthofbrug 5366,2019-03-29,10:00:00,143,87,56,FMN GV 16 Berchem TOT
54,Posthofbrug 5366,2019-03-29,11:00:00,101,67,34,FMN GV 16 Berchem TOT
54,Posthofbrug 5366,2019-03-29,12:00:00,193,125,68,FMN GV 16 Berchem TOT
54,Posthofbrug 5366,2019-03-29,13:00:00,192,105,87,FMN GV 16 Berchem TOT
54,Posthofbrug 5366,2019-03-29,14:00:00,182,85,97,FMN GV 16 Berchem TOT
54,Posthofbrug 5366,2019-03-29,15:00:00,260,126,134,FMN GV 16 Berchem TOT
54,Posthofbrug 5366,2019-03-29,16:00:00,410,213,197,FMN GV 16 Berchem TOT
54,Posthofbrug 5366,2019-03-29,17:00:00,451,229,222,FMN GV 16 Berchem TOT
54,Posthofbrug 5366,2019-03-29,18:00:00,297,162,135,FMN GV 16 Berchem TOT
54,Posthofbrug 5366,2019-03-29,19:00:00,201,124,77,FMN GV 16 Berchem TOT
54,Posthofbrug 5366,2019-03-29,20:00:00,104,68,36,FMN GV 16 Berchem TOT
54,Posthofbrug 5366,2019-03-29,21:00:00,89,46,43,FMN GV 16 Berchem TOT
54,Posthofbrug 5366,2019-03-29,22:00:00,81,33,48,FMN GV 16 Berchem TOT
54,Posthofbrug 5366,2019-03-29,23:00:00,69,18,51,FMN GV 16 Berchem TOT
54,Posthofbrug 5366,2019-03-30,00:00:00,57,18,39,FMN GV 16 Berchem TOT
54,Posthofbrug 5366,2019-03-30,01:00:00,37,8,29,FMN GV 16 Berchem TOT
54,Posthofbrug 5366,2019-03-30,02:00:00,35,8,27,FMN GV 16 Berchem TOT
54,Posthofbrug 5366,2019-03-30,03:00:00,10,4,6,FMN GV 16 Berchem TOT
54,Posthofbrug 5366,2019-03-30,04:00:00,15,8,7,FMN GV 16 Berchem TOT
54,Posthofbrug 5366,2019-03-30,05:00:00,7,5,2,FMN GV 16 Berchem TOT
54,Posthofbrug 5366,2019-03-30,06:00:00,21,12,9,FMN GV 16 Berchem TOT
54,Posthofbrug 5366,2019-03-30,07:00:00,20,15,5,FMN GV 16 Berchem TOT
54,Posthofbrug 5366,2019-03-30,08:00:00,61,34,27,FMN GV 16 Berchem TOT
54,Posthofbrug 5366,2019-03-30,09:00:00,123,82,41,FMN GV 16 Berchem TOT
54,Posthofbrug 5366,2019-03-30,10:00:00,122,83,39,FMN GV 16 Berchem TOT
54,Posthofbrug 5366,2019-03-30,11:00:00,135,78,57,FMN GV 16 Berchem TOT
54,Posthofbrug 5366,2019-03-30,12:00:00,166,107,59,FMN GV 16 Berchem TOT
54,Posthofbrug 5366,2019-03-30,13:00:00,194,99,95,FMN GV 16 Berchem TOT
54,Posthofbrug 5366,2019-03-30,14:00:00,182,107,75,FMN GV 16 Berchem TOT
54,Posthofbrug 5366,2019-03-30,15:00:00,131,72,59,FMN GV 16 Berchem TOT
54,Posthofbrug 5366,2019-03-30,16:00:00,188,103,85,FMN GV 16 Berchem TOT
54,Posthofbrug 5366,2019-03-30,17:00:00,184,115,69,FMN GV 16 Berchem TOT
54,Posthofbrug 5366,2019-03-30,18:00:00,166,105,61,FMN GV 16 Berchem TOT
54,Posthofbrug 5366,2019-03-30,19:00:00,123,79,44,FMN GV 16 Berchem TOT
54,Posthofbrug 5366,2019-03-30,20:00:00,95,56,39,FMN GV 16 Berchem TOT
54,Posthofbrug 5366,2019-03-30,21:00:00,67,31,36,FMN GV 16 Berchem TOT
54,Posthofbrug 5366,2019-03-30,22:00:00,54,29,25,FMN GV 16 Berchem TOT
54,Posthofbrug 5366,2019-03-30,23:00:00,82,39,43,FMN GV 16 Berchem TOT
54,Posthofbrug 5366,2019-03-31,00:00:00,41,23,18,FMN GV 16 Berchem TOT
54,Posthofbrug 5366,2019-03-31,01:00:00,45,20,25,FMN GV 16 Berchem TOT
54,Posthofbrug 5366,2019-03-31,02:00:00,0,0,0,FMN GV 16 Berchem TOT
54,Posthofbrug 5366,2019-03-31,03:00:00,30,12,18,FMN GV 16 Berchem TOT
54,Posthofbrug 5366,2019-03-31,04:00:00,8,5,3,FMN GV 16 Berchem TOT
54,Posthofbrug 5366,2019-03-31,05:00:00,21,9,12,FMN GV 16 Berchem TOT
54,Posthofbrug 5366,2019-03-31,06:00:00,9,4,5,FMN GV 16 Berchem TOT
54,Posthofbrug 5366,2019-03-31,07:00:00,12,7,5,FMN GV 16 Berchem TOT
54,Posthofbrug 5366,2019-03-31,08:00:00,29,17,12,FMN GV 16 Berchem TOT
54,Posthofbrug 5366,2019-03-31,09:00:00,65,43,22,FMN GV 16 Berchem TOT
54,Posthofbrug 5366,2019-03-31,10:00:00,94,71,23,FMN GV 16 Berchem TOT
54,Posthofbrug 5366,2019-03-31,11:00:00,76,51,25,FMN GV 16 Berchem TOT
54,Posthofbrug 5366,2019-03-31,12:00:00,86,54,32,FMN GV 16 Berchem TOT
54,Posthofbrug 5366,2019-03-31,13:00:00,122,82,40,FMN GV 16 Berchem TOT
54,Posthofbrug 5366,2019-03-31,14:00:00,174,103,71,FMN GV 16 Berchem TOT
54,Posthofbrug 5366,2019-03-31,15:00:00,87,58,29,FMN GV 16 Berchem TOT
54,Posthofbrug 5366,2019-03-31,16:00:00,123,63,60,FMN GV 16 Berchem TOT
54,Posthofbrug 5366,2019-03-31,17:00:00,147,85,62,FMN GV 16 Berchem TOT
54,Posthofbrug 5366,2019-03-31,18:00:00,112,62,50,FMN GV 16 Berchem TOT
54,Posthofbrug 5366,2019-03-31,19:00:00,63,43,20,FMN GV 16 Berchem TOT
54,Posthofbrug 5366,2019-03-31,20:00:00,51,27,24,FMN GV 16 Berchem TOT
54,Posthofbrug 5366,2019-03-31,21:00:00,51,29,22,FMN GV 16 Berchem TOT
54,Posthofbrug 5366,2019-03-31,22:00:00,36,22,14,FMN GV 16 Berchem TOT
54,Posthofbrug 5366,2019-03-31,23:00:00,17,5,12,FMN GV 16 Berchem TOT
54,Posthofbrug 5366,2019-04-01,00:00:00,13,5,8,FMN GV 16 Berchem TOT
54,Posthofbrug 5366,2019-04-01,01:00:00,2,1,1,FMN GV 16 Berchem TOT
54,Posthofbrug 5366,2019-04-01,02:00:00,4,0,4,FMN GV 16 Berchem TOT
54,Posthofbrug 5366,2019-04-01,03:00:00,0,0,0,FMN GV 16 Berchem TOT
54,Posthofbrug 5366,2019-04-01,04:00:00,9,7,2,FMN GV 16 Berchem TOT
54,Posthofbrug 5366,2019-04-01,05:00:00,24,16,8,FMN GV 16 Berchem TOT
54,Posthofbrug 5366,2019-04-01,06:00:00,104,84,20,FMN GV 16 Berchem TOT
54,Posthofbrug 5366,2019-04-01,07:00:00,430,312,118,FMN GV 16 Berchem TOT
54,Posthofbrug 5366,2019-04-01,08:00:00,750,473,277,FMN GV 16 Berchem TOT
54,Posthofbrug 5366,2019-04-01,09:00:00,256,176,80,FMN GV 16 Berchem TOT
54,Posthofbrug 5366,2019-04-01,10:00:00,128,97,31,FMN GV 16 Berchem TOT
54,Posthofbrug 5366,2019-04-01,11:00:00,111,71,40,FMN GV 16 Berchem TOT
54,Posthofbrug 5366,2019-04-01,12:00:00,165,100,65,FMN GV 16 Berchem TOT
54,Posthofbrug 5366,2019-04-01,13:00:00,165,98,67,FMN GV 16 Berchem TOT
54,Posthofbrug 5366,2019-04-01,14:00:00,124,54,70,FMN GV 16 Berchem TOT
54,Posthofbrug 5366,2019-04-01,15:00:00,254,126,128,FMN GV 16 Berchem TOT
54,Posthofbrug 5366,2019-04-01,16:00:00,457,246,211,FMN GV 16 Berchem TOT
54,Posthofbrug 5366,2019-04-01,17:00:00,582,314,268,FMN GV 16 Berchem TOT
54,Posthofbrug 5366,2019-04-01,18:00:00,390,179,211,FMN GV 16 Berchem TOT
54,Posthofbrug 5366,2019-04-01,19:00:00,195,93,102,FMN GV 16 Berchem TOT
54,Posthofbrug 5366,2019-04-01,20:00:00,96,53,43,FMN GV 16 Berchem TOT
54,Posthofbrug 5366,2019-04-01,21:00:00,73,37,36,FMN GV 16 Berchem TOT
54,Posthofbrug 5366,2019-04-01,22:00:00,68,34,34,FMN GV 16 Berchem TOT
54,Posthofbrug 5366,2019-04-01,23:00:00,27,13,14,FMN GV 16 Berchem TOT
54,Posthofbrug 5366,2019-04-02,00:00:00,14,3,11,FMN GV 16 Berchem TOT
54,Posthofbrug 5366,2019-04-02,01:00:00,11,5,6,FMN GV 16 Berchem TOT
54,Posthofbrug 5366,2019-04-02,02:00:00,12,6,6,FMN GV 16 Berchem TOT
54,Posthofbrug 5366,2019-04-02,03:00:00,5,1,4,FMN GV 16 Berchem TOT
54,Posthofbrug 5366,2019-04-02,04:00:00,4,4,0,FMN GV 16 Berchem TOT
54,Posthofbrug 5366,2019-04-02,05:00:00,24,15,9,FMN GV 16 Berchem TOT
54,Posthofbrug 5366,2019-04-02,06:00:00,102,78,24,FMN GV 16 Berchem TOT
54,Posthofbrug 5366,2019-04-02,07:00:00,411,272,139,FMN GV 16 Berchem TOT
54,Posthofbrug 5366,2019-04-02,08:00:00,754,493,261,FMN GV 16 Berchem TOT
54,Posthofbrug 5366,2019-04-02,09:00:00,298,171,127,FMN GV 16 Berchem TOT
54,Posthofbrug 5366,2019-04-02,10:00:00,117,77,40,FMN GV 16 Berchem TOT
54,Posthofbrug 5366,2019-04-02,11:00:00,136,103,33,FMN GV 16 Berchem TOT
54,Posthofbrug 5366,2019-04-02,12:00:00,123,72,51,FMN GV 16 Berchem TOT
54,Posthofbrug 5366,2019-04-02,13:00:00,135,84,51,FMN GV 16 Berchem TOT
54,Posthofbrug 5366,2019-04-02,14:00:00,112,51,61,FMN GV 16 Berchem TOT
54,Posthofbrug 5366,2019-04-02,15:00:00,205,108,97,FMN GV 16 Berchem TOT
54,Posthofbrug 5366,2019-04-02,16:00:00,373,194,179,FMN GV 16 Berchem TOT
54,Posthofbrug 5366,2019-04-02,17:00:00,442,210,232,FMN GV 16 Berchem TOT
54,Posthofbrug 5366,2019-04-02,18:00:00,359,154,205,FMN GV 16 Berchem TOT
54,Posthofbrug 5366,2019-04-02,19:00:00,160,76,84,FMN GV 16 Berchem TOT
54,Posthofbrug 5366,2019-04-02,20:00:00,61,31,30,FMN GV 16 Berchem TOT
54,Posthofbrug 5366,2019-04-02,21:00:00,61,32,29,FMN GV 16 Berchem TOT
54,Posthofbrug 5366,2019-04-02,22:00:00,55,20,35,FMN GV 16 Berchem TOT
54,Posthofbrug 5366,2019-04-02,23:00:00,45,10,35,FMN GV 16 Berchem TOT
54,Posthofbrug 5366,2019-04-03,00:00:00,17,8,9,FMN GV 16 Berchem TOT
54,Posthofbrug 5366,2019-04-03,01:00:00,6,4,2,FMN GV 16 Berchem TOT
54,Posthofbrug 5366,2019-04-03,02:00:00,12,5,7,FMN GV 16 Berchem TOT
54,Posthofbrug 5366,2019-04-03,03:00:00,1,1,0,FMN GV 16 Berchem TOT
54,Posthofbrug 5366,2019-04-03,04:00:00,7,6,1,FMN GV 16 Berchem TOT
54,Posthofbrug 5366,2019-04-03,05:00:00,16,9,7,FMN GV 16 Berchem TOT
54,Posthofbrug 5366,2019-04-03,06:00:00,85,67,18,FMN GV 16 Berchem TOT
54,Posthofbrug 5366,2019-04-03,07:00:00,366,246,120,FMN GV 16 Berchem TOT
54,Posthofbrug 5366,2019-04-03,08:00:00,577,367,210,FMN GV 16 Berchem TOT
54,Posthofbrug 5366,2019-04-03,09:00:00,181,111,70,FMN GV 16 Berchem TOT
54,Posthofbrug 5366,2019-04-03,10:00:00,94,59,35,FMN GV 16 Berchem TOT
54,Posthofbrug 5366,2019-04-03,11:00:00,96,58,38,FMN GV 16 Berchem TOT
54,Posthofbrug 5366,2019-04-03,12:00:00,211,118,93,FMN GV 16 Berchem TOT
54,Posthofbrug 5366,2019-04-03,13:00:00,154,97,57,FMN GV 16 Berchem TOT
54,Posthofbrug 5366,2019-04-03,14:00:00,120,61,59,FMN GV 16 Berchem TOT
54,Posthofbrug 5366,2019-04-03,15:00:00,143,70,73,FMN GV 16 Berchem TOT
54,Posthofbrug 5366,2019-04-03,16:00:00,297,158,139,FMN GV 16 Berchem TOT
54,Posthofbrug 5366,2019-04-03,17:00:00,460,211,249,FMN GV 16 Berchem TOT
54,Posthofbrug 5366,2019-04-03,18:00:00,273,113,160,FMN GV 16 Berchem TOT
54,Posthofbrug 5366,2019-04-03,19:00:00,117,64,53,FMN GV 16 Berchem TOT
54,Posthofbrug 5366,2019-04-03,20:00:00,79,43,36,FMN GV 16 Berchem TOT
54,Posthofbrug 5366,2019-04-03,21:00:00,59,24,35,FMN GV 16 Berchem TOT
54,Posthofbrug 5366,2019-04-03,22:00:00,63,20,43,FMN GV 16 Berchem TOT
54,Posthofbrug 5366,2019-04-03,23:00:00,40,13,27,FMN GV 16 Berchem TOT
54,Posthofbrug 5366,2019-04-04,00:00:00,18,7,11,FMN GV 16 Berchem TOT
54,Posthofbrug 5366,2019-04-04,01:00:00,12,3,9,FMN GV 16 Berchem TOT
54,Posthofbrug 5366,2019-04-04,02:00:00,13,3,10,FMN GV 16 Berchem TOT
54,Posthofbrug 5366,2019-04-04,03:00:00,14,3,11,FMN GV 16 Berchem TOT
54,Posthofbrug 5366,2019-04-04,04:00:00,12,6,6,FMN GV 16 Berchem TOT
54,Posthofbrug 5366,2019-04-04,05:00:00,25,14,11,FMN GV 16 Berchem TOT
54,Posthofbrug 5366,2019-04-04,06:00:00,107,82,25,FMN GV 16 Berchem TOT
54,Posthofbrug 5366,2019-04-04,07:00:00,382,281,101,FMN GV 16 Berchem TOT
54,Posthofbrug 5366,2019-04-04,08:00:00,734,472,262,FMN GV 16 Berchem TOT
54,Posthofbrug 5366,2019-04-04,09:00:00,223,154,69,FMN GV 16 Berchem TOT
54,Posthofbrug 5366,2019-04-04,10:00:00,95,66,29,FMN GV 16 Berchem TOT
54,Posthofbrug 5366,2019-04-04,11:00:00,82,50,32,FMN GV 16 Berchem TOT
54,Posthofbrug 5366,2019-04-04,12:00:00,177,98,79,FMN GV 16 Berchem TOT
54,Posthofbrug 5366,2019-04-04,13:00:00,157,85,72,FMN GV 16 Berchem TOT
54,Posthofbrug 5366,2019-04-04,14:00:00,90,50,40,FMN GV 16 Berchem TOT
54,Posthofbrug 5366,2019-04-04,15:00:00,227,114,113,FMN GV 16 Berchem TOT
54,Posthofbrug 5366,2019-04-04,16:00:00,402,210,192,FMN GV 16 Berchem TOT
54,Posthofbrug 5366,2019-04-04,17:00:00,544,259,285,FMN GV 16 Berchem TOT
54,Posthofbrug 5366,2019-04-04,18:00:00,387,166,221,FMN GV 16 Berchem TOT
54,Posthofbrug 5366,2019-04-04,19:00:00,192,103,89,FMN GV 16 Berchem TOT
54,Posthofbrug 5366,2019-04-04,20:00:00,100,46,54,FMN GV 16 Berchem TOT
54,Posthofbrug 5366,2019-04-04,21:00:00,68,36,32,FMN GV 16 Berchem TOT
54,Posthofbrug 5366,2019-04-04,22:00:00,85,44,41,FMN GV 16 Berchem TOT
54,Posthofbrug 5366,2019-04-04,23:00:00,34,12,22,FMN GV 16 Berchem TOT
54,Posthofbrug 5366,2019-04-05,00:00:00,31,9,22,FMN GV 16 Berchem TOT
54,Posthofbrug 5366,2019-04-05,01:00:00,14,2,12,FMN GV 16 Berchem TOT
54,Posthofbrug 5366,2019-04-05,02:00:00,8,3,5,FMN GV 16 Berchem TOT
54,Posthofbrug 5366,2019-04-05,03:00:00,4,3,1,FMN GV 16 Berchem TOT
54,Posthofbrug 5366,2019-04-05,04:00:00,14,7,7,FMN GV 16 Berchem TOT
54,Posthofbrug 5366,2019-04-05,05:00:00,23,12,11,FMN GV 16 Berchem TOT
54,Posthofbrug 5366,2019-04-05,06:00:00,91,73,18,FMN GV 16 Berchem TOT
54,Posthofbrug 5366,2019-04-05,07:00:00,341,236,105,FMN GV 16 Berchem TOT
54,Posthofbrug 5366,2019-04-05,08:00:00,655,435,220,FMN GV 16 Berchem TOT
54,Posthofbrug 5366,2019-04-05,09:00:00,220,147,73,FMN GV 16 Berchem TOT
54,Posthofbrug 5366,2019-04-05,10:00:00,124,78,46,FMN GV 16 Berchem TOT
54,Posthofbrug 5366,2019-04-05,11:00:00,133,76,57,FMN GV 16 Berchem TOT
54,Posthofbrug 5366,2019-04-05,12:00:00,149,84,65,FMN GV 16 Berchem TOT
54,Posthofbrug 5366,2019-04-05,13:00:00,175,82,93,FMN GV 16 Berchem TOT
54,Posthofbrug 5366,2019-04-05,14:00:00,190,93,97,FMN GV 16 Berchem TOT
54,Posthofbrug 5366,2019-04-05,15:00:00,238,115,123,FMN GV 16 Berchem TOT
54,Posthofbrug 5366,2019-04-05,16:00:00,393,209,184,FMN GV 16 Berchem TOT
54,Posthofbrug 5366,2019-04-05,17:00:00,482,254,228,FMN GV 16 Berchem TOT
54,Posthofbrug 5366,2019-04-05,18:00:00,274,137,137,FMN GV 16 Berchem TOT
54,Posthofbrug 5366,2019-04-05,19:00:00,161,99,62,FMN GV 16 Berchem TOT
54,Posthofbrug 5366,2019-04-05,20:00:00,83,50,33,FMN GV 16 Berchem TOT
54,Posthofbrug 5366,2019-04-05,21:00:00,55,26,29,FMN GV 16 Berchem TOT
54,Posthofbrug 5366,2019-04-05,22:00:00,54,22,32,FMN GV 16 Berchem TOT
54,Posthofbrug 5366,2019-04-05,23:00:00,65,19,46,FMN GV 16 Berchem TOT
54,Posthofbrug 5366,2019-04-06,00:00:00,53,19,34,FMN GV 16 Berchem TOT
54,Posthofbrug 5366,2019-04-06,01:00:00,35,13,22,FMN GV 16 Berchem TOT
54,Posthofbrug 5366,2019-04-06,02:00:00,15,5,10,FMN GV 16 Berchem TOT
54,Posthofbrug 5366,2019-04-06,03:00:00,11,2,9,FMN GV 16 Berchem TOT
54,Posthofbrug 5366,2019-04-06,04:00:00,8,5,3,FMN GV 16 Berchem TOT
54,Posthofbrug 5366,2019-04-06,05:00:00,13,6,7,FMN GV 16 Berchem TOT
54,Posthofbrug 5366,2019-04-06,06:00:00,45,37,8,FMN GV 16 Berchem TOT
54,Posthofbrug 5366,2019-04-06,07:00:00,35,20,15,FMN GV 16 Berchem TOT
54,Posthofbrug 5366,2019-04-06,08:00:00,67,46,21,FMN GV 16 Berchem TOT
54,Posthofbrug 5366,2019-04-06,09:00:00,77,53,24,FMN GV 16 Berchem TOT
54,Posthofbrug 5366,2019-04-06,10:00:00,84,57,27,FMN GV 16 Berchem TOT
54,Posthofbrug 5366,2019-04-06,11:00:00,102,68,34,FMN GV 16 Berchem TOT
54,Posthofbrug 5366,2019-04-06,12:00:00,107,78,29,FMN GV 16 Berchem TOT
54,Posthofbrug 5366,2019-04-06,13:00:00,121,66,55,FMN GV 16 Berchem TOT
54,Posthofbrug 5366,2019-04-06,14:00:00,138,82,56,FMN GV 16 Berchem TOT
54,Posthofbrug 5366,2019-04-06,15:00:00,115,50,65,FMN GV 16 Berchem TOT
54,Posthofbrug 5366,2019-04-06,16:00:00,153,81,72,FMN GV 16 Berchem TOT
54,Posthofbrug 5366,2019-04-06,17:00:00,134,56,78,FMN GV 16 Berchem TOT
54,Posthofbrug 5366,2019-04-06,18:00:00,122,73,49,FMN GV 16 Berchem TOT
54,Posthofbrug 5366,2019-04-06,19:00:00,105,72,33,FMN GV 16 Berchem TOT
54,Posthofbrug 5366,2019-04-06,20:00:00,65,40,25,FMN GV 16 Berchem TOT
54,Posthofbrug 5366,2019-04-06,21:00:00,59,30,29,FMN GV 16 Berchem TOT
54,Posthofbrug 5366,2019-04-06,22:00:00,39,20,19,FMN GV 16 Berchem TOT
54,Posthofbrug 5366,2019-04-06,23:00:00,64,21,43,FMN GV 16 Berchem TOT
54,Posthofbrug 5366,2019-04-07,00:00:00,33,15,18,FMN GV 16 Berchem TOT
54,Posthofbrug 5366,2019-04-07,01:00:00,32,10,22,FMN GV 16 Berchem TOT
54,Posthofbrug 5366,2019-04-07,02:00:00,15,7,8,FMN GV 16 Berchem TOT
54,Posthofbrug 5366,2019-04-07,03:00:00,16,2,14,FMN GV 16 Berchem TOT
54,Posthofbrug 5366,2019-04-07,04:00:00,11,6,5,FMN GV 16 Berchem TOT
54,Posthofbrug 5366,2019-04-07,05:00:00,8,6,2,FMN GV 16 Berchem TOT
54,Posthofbrug 5366,2019-04-07,06:00:00,17,11,6,FMN GV 16 Berchem TOT
54,Posthofbrug 5366,2019-04-07,07:00:00,24,14,10,FMN GV 16 Berchem TOT
54,Posthofbrug 5366,2019-04-07,08:00:00,90,71,19,FMN GV 16 Berchem TOT
54,Posthofbrug 5366,2019-04-07,09:00:00,138,96,42,FMN GV 16 Berchem TOT
54,Posthofbrug 5366,2019-04-07,10:00:00,124,65,59,FMN GV 16 Berchem TOT
54,Posthofbrug 5366,2019-04-07,11:00:00,157,94,63,FMN GV 16 Berchem TOT
54,Posthofbrug 5366,2019-04-07,12:00:00,150,63,87,FMN GV 16 Berchem TOT
54,Posthofbrug 5366,2019-04-07,13:00:00,164,102,62,FMN GV 16 Berchem TOT
54,Posthofbrug 5366,2019-04-07,14:00:00,154,81,73,FMN GV 16 Berchem TOT
54,Posthofbrug 5366,2019-04-07,15:00:00,120,66,54,FMN GV 16 Berchem TOT
54,Posthofbrug 5366,2019-04-07,16:00:00,119,57,62,FMN GV 16 Berchem TOT
54,Posthofbrug 5366,2019-04-07,17:00:00,111,58,53,FMN GV 16 Berchem TOT
54,Posthofbrug 5366,2019-04-07,18:00:00,81,31,50,FMN GV 16 Berchem TOT
54,Posthofbrug 5366,2019-04-07,19:00:00,67,34,33,FMN GV 16 Berchem TOT
54,Posthofbrug 5366,2019-04-07,20:00:00,61,39,22,FMN GV 16 Berchem TOT
54,Posthofbrug 5366,2019-04-07,21:00:00,39,19,20,FMN GV 16 Berchem TOT
54,Posthofbrug 5366,2019-04-07,22:00:00,39,19,20,FMN GV 16 Berchem TOT
54,Posthofbrug 5366,2019-04-07,23:00:00,21,6,15,FMN GV 16 Berchem TOT
54,Posthofbrug 5366,2019-04-08,00:00:00,12,3,9,FMN GV 16 Berchem TOT
54,Posthofbrug 5366,2019-04-08,01:00:00,2,1,1,FMN GV 16 Berchem TOT
54,Posthofbrug 5366,2019-04-08,02:00:00,2,0,2,FMN GV 16 Berchem TOT
54,Posthofbrug 5366,2019-04-08,03:00:00,3,3,0,FMN GV 16 Berchem TOT
54,Posthofbrug 5366,2019-04-08,04:00:00,3,3,0,FMN GV 16 Berchem TOT
54,Posthofbrug 5366,2019-04-08,05:00:00,14,11,3,FMN GV 16 Berchem TOT
54,Posthofbrug 5366,2019-04-08,06:00:00,88,69,19,FMN GV 16 Berchem TOT
54,Posthofbrug 5366,2019-04-08,07:00:00,285,195,90,FMN GV 16 Berchem TOT
54,Posthofbrug 5366,2019-04-08,08:00:00,484,320,164,FMN GV 16 Berchem TOT
54,Posthofbrug 5366,2019-04-08,09:00:00,208,141,67,FMN GV 16 Berchem TOT
54,Posthofbrug 5366,2019-04-08,10:00:00,88,55,33,FMN GV 16 Berchem TOT
54,Posthofbrug 5366,2019-04-08,11:00:00,77,54,23,FMN GV 16 Berchem TOT
54,Posthofbrug 5366,2019-04-08,12:00:00,110,70,40,FMN GV 16 Berchem TOT
54,Posthofbrug 5366,2019-04-08,13:00:00,88,54,34,FMN GV 16 Berchem TOT
54,Posthofbrug 5366,2019-04-08,14:00:00,71,34,37,FMN GV 16 Berchem TOT
54,Posthofbrug 5366,2019-04-08,15:00:00,122,61,61,FMN GV 16 Berchem TOT
54,Posthofbrug 5366,2019-04-08,16:00:00,291,152,139,FMN GV 16 Berchem TOT
54,Posthofbrug 5366,2019-04-08,17:00:00,454,232,222,FMN GV 16 Berchem TOT
54,Posthofbrug 5366,2019-04-08,18:00:00,283,139,144,FMN GV 16 Berchem TOT
54,Posthofbrug 5366,2019-04-08,19:00:00,133,74,59,FMN GV 16 Berchem TOT
54,Posthofbrug 5366,2019-04-08,20:00:00,88,45,43,FMN GV 16 Berchem TOT
54,Posthofbrug 5366,2019-04-08,21:00:00,37,20,17,FMN GV 16 Berchem TOT
54,Posthofbrug 5366,2019-04-08,22:00:00,42,24,18,FMN GV 16 Berchem TOT
54,Posthofbrug 5366,2019-04-08,23:00:00,33,9,24,FMN GV 16 Berchem TOT
54,Posthofbrug 5366,2019-04-09,00:00:00,9,4,5,FMN GV 16 Berchem TOT
54,Posthofbrug 5366,2019-04-09,01:00:00,5,5,0,FMN GV 16 Berchem TOT
54,Posthofbrug 5366,2019-04-09,02:00:00,7,3,4,FMN GV 16 Berchem TOT
54,Posthofbrug 5366,2019-04-09,03:00:00,5,4,1,FMN GV 16 Berchem TOT
54,Posthofbrug 5366,2019-04-09,04:00:00,4,3,1,FMN GV 16 Berchem TOT
54,Posthofbrug 5366,2019-04-09,05:00:00,21,15,6,FMN GV 16 Berchem TOT
54,Posthofbrug 5366,2019-04-09,06:00:00,93,72,21,FMN GV 16 Berchem TOT
54,Posthofbrug 5366,2019-04-09,07:00:00,307,227,80,FMN GV 16 Berchem TOT
54,Posthofbrug 5366,2019-04-09,08:00:00,466,302,164,FMN GV 16 Berchem TOT
54,Posthofbrug 5366,2019-04-09,09:00:00,163,111,52,FMN GV 16 Berchem TOT
54,Posthofbrug 5366,2019-04-09,10:00:00,70,44,26,FMN GV 16 Berchem TOT
54,Posthofbrug 5366,2019-04-09,11:00:00,70,36,34,FMN GV 16 Berchem TOT
54,Posthofbrug 5366,2019-04-09,12:00:00,86,53,33,FMN GV 16 Berchem TOT
54,Posthofbrug 5366,2019-04-09,13:00:00,102,65,37,FMN GV 16 Berchem TOT
54,Posthofbrug 5366,2019-04-09,14:00:00,69,40,29,FMN GV 16 Berchem TOT
54,Posthofbrug 5366,2019-04-09,15:00:00,123,68,55,FMN GV 16 Berchem TOT
54,Posthofbrug 5366,2019-04-09,16:00:00,334,178,156,FMN GV 16 Berchem TOT
54,Posthofbrug 5366,2019-04-09,17:00:00,398,201,197,FMN GV 16 Berchem TOT
54,Posthofbrug 5366,2019-04-09,18:00:00,266,143,123,FMN GV 16 Berchem TOT
54,Posthofbrug 5366,2019-04-09,19:00:00,111,62,49,FMN GV 16 Berchem TOT
54,Posthofbrug 5366,2019-04-09,20:00:00,86,48,38,FMN GV 16 Berchem TOT
54,Posthofbrug 5366,2019-04-09,21:00:00,51,24,27,FMN GV 16 Berchem TOT
54,Posthofbrug 5366,2019-04-09,22:00:00,54,24,30,FMN GV 16 Berchem TOT
54,Posthofbrug 5366,2019-04-09,23:00:00,32,15,17,FMN GV 16 Berchem TOT
54,Posthofbrug 5366,2019-04-10,00:00:00,17,7,10,FMN GV 16 Berchem TOT
54,Posthofbrug 5366,2019-04-10,01:00:00,5,2,3,FMN GV 16 Berchem TOT
54,Posthofbrug 5366,2019-04-10,02:00:00,1,0,1,FMN GV 16 Berchem TOT
54,Posthofbrug 5366,2019-04-10,03:00:00,4,1,3,FMN GV 16 Berchem TOT
54,Posthofbrug 5366,2019-04-10,04:00:00,5,2,3,FMN GV 16 Berchem TOT
54,Posthofbrug 5366,2019-04-10,05:00:00,20,15,5,FMN GV 16 Berchem TOT
54,Posthofbrug 5366,2019-04-10,06:00:00,83,63,20,FMN GV 16 Berchem TOT
54,Posthofbrug 5366,2019-04-10,07:00:00,282,187,95,FMN GV 16 Berchem TOT
54,Posthofbrug 5366,2019-04-10,08:00:00,471,292,179,FMN GV 16 Berchem TOT
54,Posthofbrug 5366,2019-04-10,09:00:00,194,129,65,FMN GV 16 Berchem TOT
54,Posthofbrug 5366,2019-04-10,10:00:00,102,68,34,FMN GV 16 Berchem TOT
54,Posthofbrug 5366,2019-04-10,11:00:00,84,52,32,FMN GV 16 Berchem TOT
54,Posthofbrug 5366,2019-04-10,12:00:00,100,57,43,FMN GV 16 Berchem TOT
54,Posthofbrug 5366,2019-04-10,13:00:00,133,82,51,FMN GV 16 Berchem TOT
54,Posthofbrug 5366,2019-04-10,14:00:00,103,56,47,FMN GV 16 Berchem TOT
54,Posthofbrug 5366,2019-04-10,15:00:00,143,60,83,FMN GV 16 Berchem TOT
54,Posthofbrug 5366,2019-04-10,16:00:00,291,163,128,FMN GV 16 Berchem TOT
54,Posthofbrug 5366,2019-04-10,17:00:00,442,201,241,FMN GV 16 Berchem TOT
54,Posthofbrug 5366,2019-04-10,18:00:00,287,137,150,FMN GV 16 Berchem TOT
54,Posthofbrug 5366,2019-04-10,19:00:00,156,88,68,FMN GV 16 Berchem TOT
54,Posthofbrug 5366,2019-04-10,20:00:00,99,58,41,FMN GV 16 Berchem TOT
54,Posthofbrug 5366,2019-04-10,21:00:00,52,22,30,FMN GV 16 Berchem TOT
54,Posthofbrug 5366,2019-04-10,22:00:00,63,27,36,FMN GV 16 Berchem TOT
54,Posthofbrug 5366,2019-04-10,23:00:00,46,22,24,FMN GV 16 Berchem TOT
54,Posthofbrug 5366,2019-04-11,00:00:00,16,7,9,FMN GV 16 Berchem TOT
54,Posthofbrug 5366,2019-04-11,01:00:00,9,3,6,FMN GV 16 Berchem TOT
54,Posthofbrug 5366,2019-04-11,02:00:00,5,2,3,FMN GV 16 Berchem TOT
54,Posthofbrug 5366,2019-04-11,03:00:00,1,1,0,FMN GV 16 Berchem TOT
54,Posthofbrug 5366,2019-04-11,04:00:00,9,6,3,FMN GV 16 Berchem TOT
54,Posthofbrug 5366,2019-04-11,05:00:00,15,12,3,FMN GV 16 Berchem TOT
54,Posthofbrug 5366,2019-04-11,06:00:00,89,73,16,FMN GV 16 Berchem TOT
54,Posthofbrug 5366,2019-04-11,07:00:00,289,200,89,FMN GV 16 Berchem TOT
54,Posthofbrug 5366,2019-04-11,08:00:00,502,324,178,FMN GV 16 Berchem TOT
54,Posthofbrug 5366,2019-04-11,09:00:00,223,156,67,FMN GV 16 Berchem TOT
54,Posthofbrug 5366,2019-04-11,10:00:00,105,64,41,FMN GV 16 Berchem TOT
54,Posthofbrug 5366,2019-04-11,11:00:00,78,45,33,FMN GV 16 Berchem TOT
54,Posthofbrug 5366,2019-04-11,12:00:00,118,80,38,FMN GV 16 Berchem TOT
54,Posthofbrug 5366,2019-04-11,13:00:00,128,67,61,FMN GV 16 Berchem TOT
54,Posthofbrug 5366,2019-04-11,14:00:00,100,53,47,FMN GV 16 Berchem TOT
54,Posthofbrug 5366,2019-04-11,15:00:00,136,69,67,FMN GV 16 Berchem TOT
54,Posthofbrug 5366,2019-04-11,16:00:00,298,157,141,FMN GV 16 Berchem TOT
54,Posthofbrug 5366,2019-04-11,17:00:00,395,210,185,FMN GV 16 Berchem TOT
54,Posthofbrug 5366,2019-04-11,18:00:00,318,156,162,FMN GV 16 Berchem TOT
54,Posthofbrug 5366,2019-04-11,19:00:00,139,61,78,FMN GV 16 Berchem TOT
54,Posthofbrug 5366,2019-04-11,20:00:00,108,78,30,FMN GV 16 Berchem TOT
54,Posthofbrug 5366,2019-04-11,21:00:00,62,26,36,FMN GV 16 Berchem TOT
54,Posthofbrug 5366,2019-04-11,22:00:00,55,22,33,FMN GV 16 Berchem TOT
54,Posthofbrug 5366,2019-04-11,23:00:00,49,15,34,FMN GV 16 Berchem TOT
54,Posthofbrug 5366,2019-04-12,00:00:00,29,8,21,FMN GV 16 Berchem TOT
54,Posthofbrug 5366,2019-04-12,01:00:00,20,12,8,FMN GV 16 Berchem TOT
54,Posthofbrug 5366,2019-04-12,02:00:00,2,1,1,FMN GV 16 Berchem TOT
54,Posthofbrug 5366,2019-04-12,03:00:00,8,4,4,FMN GV 16 Berchem TOT
54,Posthofbrug 5366,2019-04-12,04:00:00,9,2,7,FMN GV 16 Berchem TOT
54,Posthofbrug 5366,2019-04-12,05:00:00,18,13,5,FMN GV 16 Berchem TOT
54,Posthofbrug 5366,2019-04-12,06:00:00,68,42,26,FMN GV 16 Berchem TOT
54,Posthofbrug 5366,2019-04-12,07:00:00,251,162,89,FMN GV 16 Berchem TOT
54,Posthofbrug 5366,2019-04-12,08:00:00,388,248,140,FMN GV 16 Berchem TOT
54,Posthofbrug 5366,2019-04-12,09:00:00,188,133,55,FMN GV 16 Berchem TOT
54,Posthofbrug 5366,2019-04-12,10:00:00,82,53,29,FMN GV 16 Berchem TOT
54,Posthofbrug 5366,2019-04-12,11:00:00,90,60,30,FMN GV 16 Berchem TOT
54,Posthofbrug 5366,2019-04-12,12:00:00,131,83,48,FMN GV 16 Berchem TOT
54,Posthofbrug 5366,2019-04-12,13:00:00,111,63,48,FMN GV 16 Berchem TOT
54,Posthofbrug 5366,2019-04-12,14:00:00,96,62,34,FMN GV 16 Berchem TOT
54,Posthofbrug 5366,2019-04-12,15:00:00,154,79,75,FMN GV 16 Berchem TOT
54,Posthofbrug 5366,2019-04-12,16:00:00,277,161,116,FMN GV 16 Berchem TOT
54,Posthofbrug 5366,2019-04-12,17:00:00,347,162,185,FMN GV 16 Berchem TOT
54,Posthofbrug 5366,2019-04-12,18:00:00,216,114,102,FMN GV 16 Berchem TOT
54,Posthofbrug 5366,2019-04-12,19:00:00,117,49,68,FMN GV 16 Berchem TOT
54,Posthofbrug 5366,2019-04-12,20:00:00,71,45,26,FMN GV 16 Berchem TOT
54,Posthofbrug 5366,2019-04-12,21:00:00,56,29,27,FMN GV 16 Berchem TOT
54,Posthofbrug 5366,2019-04-12,22:00:00,73,29,44,FMN GV 16 Berchem TOT
54,Posthofbrug 5366,2019-04-12,23:00:00,44,17,27,FMN GV 16 Berchem TOT
54,Posthofbrug 5366,2019-04-13,00:00:00,26,9,17,FMN GV 16 Berchem TOT
54,Posthofbrug 5366,2019-04-13,01:00:00,29,6,23,FMN GV 16 Berchem TOT
54,Posthofbrug 5366,2019-04-13,02:00:00,23,7,16,FMN GV 16 Berchem TOT
54,Posthofbrug 5366,2019-04-13,03:00:00,12,5,7,FMN GV 16 Berchem TOT
54,Posthofbrug 5366,2019-04-13,04:00:00,9,3,6,FMN GV 16 Berchem TOT
54,Posthofbrug 5366,2019-04-13,05:00:00,11,7,4,FMN GV 16 Berchem TOT
54,Posthofbrug 5366,2019-04-13,06:00:00,11,7,4,FMN GV 16 Berchem TOT
54,Posthofbrug 5366,2019-04-13,07:00:00,23,11,12,FMN GV 16 Berchem TOT
54,Posthofbrug 5366,2019-04-13,08:00:00,35,23,12,FMN GV 16 Berchem TOT
54,Posthofbrug 5366,2019-04-13,09:00:00,65,48,17,FMN GV 16 Berchem TOT
54,Posthofbrug 5366,2019-04-13,10:00:00,67,48,19,FMN GV 16 Berchem TOT
54,Posthofbrug 5366,2019-04-13,11:00:00,82,50,32,FMN GV 16 Berchem TOT
54,Posthofbrug 5366,2019-04-13,12:00:00,97,60,37,FMN GV 16 Berchem TOT
54,Posthofbrug 5366,2019-04-13,13:00:00,126,79,47,FMN GV 16 Berchem TOT
54,Posthofbrug 5366,2019-04-13,14:00:00,115,63,52,FMN GV 16 Berchem TOT
54,Posthofbrug 5366,2019-04-13,15:00:00,102,52,50,FMN GV 16 Berchem TOT
54,Posthofbrug 5366,2019-04-13,16:00:00,85,44,41,FMN GV 16 Berchem TOT
54,Posthofbrug 5366,2019-04-13,17:00:00,99,58,41,FMN GV 16 Berchem TOT
54,Posthofbrug 5366,2019-04-13,18:00:00,91,52,39,FMN GV 16 Berchem TOT
54,Posthofbrug 5366,2019-04-13,19:00:00,75,41,34,FMN GV 16 Berchem TOT
54,Posthofbrug 5366,2019-04-13,20:00:00,53,28,25,FMN GV 16 Berchem TOT
54,Posthofbrug 5366,2019-04-13,21:00:00,35,21,14,FMN GV 16 Berchem TOT
54,Posthofbrug 5366,2019-04-13,22:00:00,28,12,16,FMN GV 16 Berchem TOT
54,Posthofbrug 5366,2019-04-13,23:00:00,28,17,11,FMN GV 16 Berchem TOT
54,Posthofbrug 5366,2019-04-14,00:00:00,36,13,23,FMN GV 16 Berchem TOT
54,Posthofbrug 5366,2019-04-14,01:00:00,33,14,19,FMN GV 16 Berchem TOT
54,Posthofbrug 5366,2019-04-14,02:00:00,12,4,8,FMN GV 16 Berchem TOT
54,Posthofbrug 5366,2019-04-14,03:00:00,13,3,10,FMN GV 16 Berchem TOT
54,Posthofbrug 5366,2019-04-14,04:00:00,7,2,5,FMN GV 16 Berchem TOT
54,Posthofbrug 5366,2019-04-14,05:00:00,16,6,10,FMN GV 16 Berchem TOT
54,Posthofbrug 5366,2019-04-14,06:00:00,25,9,16,FMN GV 16 Berchem TOT
54,Posthofbrug 5366,2019-04-14,07:00:00,18,9,9,FMN GV 16 Berchem TOT
54,Posthofbrug 5366,2019-04-14,08:00:00,27,15,12,FMN GV 16 Berchem TOT
54,Posthofbrug 5366,2019-04-14,09:00:00,45,20,25,FMN GV 16 Berchem TOT
54,Posthofbrug 5366,2019-04-14,10:00:00,58,33,25,FMN GV 16 Berchem TOT
54,Posthofbrug 5366,2019-04-14,11:00:00,50,34,16,FMN GV 16 Berchem TOT
54,Posthofbrug 5366,2019-04-14,12:00:00,73,43,30,FMN GV 16 Berchem TOT
54,Posthofbrug 5366,2019-04-14,13:00:00,86,49,37,FMN GV 16 Berchem TOT
54,Posthofbrug 5366,2019-04-14,14:00:00,108,52,56,FMN GV 16 Berchem TOT
54,Posthofbrug 5366,2019-04-14,15:00:00,70,41,29,FMN GV 16 Berchem TOT
54,Posthofbrug 5366,2019-04-14,16:00:00,53,28,25,FMN GV 16 Berchem TOT
54,Posthofbrug 5366,2019-04-14,17:00:00,84,46,38,FMN GV 16 Berchem TOT
54,Posthofbrug 5366,2019-04-14,18:00:00,84,49,35,FMN GV 16 Berchem TOT
54,Posthofbrug 5366,2019-04-14,19:00:00,49,22,27,FMN GV 16 Berchem TOT
54,Posthofbrug 5366,2019-04-14,20:00:00,44,23,21,FMN GV 16 Berchem TOT
54,Posthofbrug 5366,2019-04-14,21:00:00,34,14,20,FMN GV 16 Berchem TOT
54,Posthofbrug 5366,2019-04-14,22:00:00,20,13,7,FMN GV 16 Berchem TOT
54,Posthofbrug 5366,2019-04-14,23:00:00,6,1,5,FMN GV 16 Berchem TOT
54,Posthofbrug 5366,2019-04-15,00:00:00,6,3,3,FMN GV 16 Berchem TOT
54,Posthofbrug 5366,2019-04-15,01:00:00,4,0,4,FMN GV 16 Berchem TOT
54,Posthofbrug 5366,2019-04-15,02:00:00,1,1,0,FMN GV 16 Berchem TOT
54,Posthofbrug 5366,2019-04-15,03:00:00,3,1,2,FMN GV 16 Berchem TOT
54,Posthofbrug 5366,2019-04-15,04:00:00,6,4,2,FMN GV 16 Berchem TOT
54,Posthofbrug 5366,2019-04-15,05:00:00,16,13,3,FMN GV 16 Berchem TOT
54,Posthofbrug 5366,2019-04-15,06:00:00,80,64,16,FMN GV 16 Berchem TOT
54,Posthofbrug 5366,2019-04-15,07:00:00,309,217,92,FMN GV 16 Berchem TOT
54,Posthofbrug 5366,2019-04-15,08:00:00,452,277,175,FMN GV 16 Berchem TOT
54,Posthofbrug 5366,2019-04-15,09:00:00,203,145,58,FMN GV 16 Berchem TOT
54,Posthofbrug 5366,2019-04-15,10:00:00,67,41,26,FMN GV 16 Berchem TOT
54,Posthofbrug 5366,2019-04-15,11:00:00,109,64,45,FMN GV 16 Berchem TOT
54,Posthofbrug 5366,2019-04-15,12:00:00,80,48,32,FMN GV 16 Berchem TOT
54,Posthofbrug 5366,2019-04-15,13:00:00,125,72,53,FMN GV 16 Berchem TOT
54,Posthofbrug 5366,2019-04-15,14:00:00,109,49,60,FMN GV 16 Berchem TOT
54,Posthofbrug 5366,2019-04-15,15:00:00,108,41,67,FMN GV 16 Berchem TOT
54,Posthofbrug 5366,2019-04-15,16:00:00,281,142,139,FMN GV 16 Berchem TOT
54,Posthofbrug 5366,2019-04-15,17:00:00,465,231,234,FMN GV 16 Berchem TOT
54,Posthofbrug 5366,2019-04-15,18:00:00,289,137,152,FMN GV 16 Berchem TOT
54,Posthofbrug 5366,2019-04-15,19:00:00,133,72,61,FMN GV 16 Berchem TOT
54,Posthofbrug 5366,2019-04-15,20:00:00,72,40,32,FMN GV 16 Berchem TOT
54,Posthofbrug 5366,2019-04-15,21:00:00,60,28,32,FMN GV 16 Berchem TOT
54,Posthofbrug 5366,2019-04-15,22:00:00,53,25,28,FMN GV 16 Berchem TOT
54,Posthofbrug 5366,2019-04-15,23:00:00,24,9,15,FMN GV 16 Berchem TOT
54,Posthofbrug 5366,2019-04-16,00:00:00,10,6,4,FMN GV 16 Berchem TOT
54,Posthofbrug 5366,2019-04-16,01:00:00,4,2,2,FMN GV 16 Berchem TOT
54,Posthofbrug 5366,2019-04-16,02:00:00,6,2,4,FMN GV 16 Berchem TOT
54,Posthofbrug 5366,2019-04-16,03:00:00,7,5,2,FMN GV 16 Berchem TOT
54,Posthofbrug 5366,2019-04-16,04:00:00,5,4,1,FMN GV 16 Berchem TOT
54,Posthofbrug 5366,2019-04-16,05:00:00,18,7,11,FMN GV 16 Berchem TOT
54,Posthofbrug 5366,2019-04-16,06:00:00,102,81,21,FMN GV 16 Berchem TOT
54,Posthofbrug 5366,2019-04-16,07:00:00,322,214,108,FMN GV 16 Berchem TOT
54,Posthofbrug 5366,2019-04-16,08:00:00,530,330,200,FMN GV 16 Berchem TOT
54,Posthofbrug 5366,2019-04-16,09:00:00,201,135,66,FMN GV 16 Berchem TOT
54,Posthofbrug 5366,2019-04-16,10:00:00,78,58,20,FMN GV 16 Berchem TOT
54,Posthofbrug 5366,2019-04-16,11:00:00,108,60,48,FMN GV 16 Berchem TOT
54,Posthofbrug 5366,2019-04-16,12:00:00,132,84,48,FMN GV 16 Berchem TOT
54,Posthofbrug 5366,2019-04-16,13:00:00,114,66,48,FMN GV 16 Berchem TOT
54,Posthofbrug 5366,2019-04-16,14:00:00,128,60,68,FMN GV 16 Berchem TOT
54,Posthofbrug 5366,2019-04-16,15:00:00,155,69,86,FMN GV 16 Berchem TOT
54,Posthofbrug 5366,2019-04-16,16:00:00,348,179,169,FMN GV 16 Berchem TOT
54,Posthofbrug 5366,2019-04-16,17:00:00,493,246,247,FMN GV 16 Berchem TOT
54,Posthofbrug 5366,2019-04-16,18:00:00,293,117,176,FMN GV 16 Berchem TOT
54,Posthofbrug 5366,2019-04-16,19:00:00,151,71,80,FMN GV 16 Berchem TOT
54,Posthofbrug 5366,2019-04-16,20:00:00,104,49,55,FMN GV 16 Berchem TOT
54,Posthofbrug 5366,2019-04-16,21:00:00,73,40,33,FMN GV 16 Berchem TOT
54,Posthofbrug 5366,2019-04-16,22:00:00,72,28,44,FMN GV 16 Berchem TOT
54,Posthofbrug 5366,2019-04-16,23:00:00,29,8,21,FMN GV 16 Berchem TOT
54,Posthofbrug 5366,2019-04-17,00:00:00,25,9,16,FMN GV 16 Berchem TOT
54,Posthofbrug 5366,2019-04-17,01:00:00,7,3,4,FMN GV 16 Berchem TOT
54,Posthofbrug 5366,2019-04-17,02:00:00,3,2,1,FMN GV 16 Berchem TOT
54,Posthofbrug 5366,2019-04-17,03:00:00,4,1,3,FMN GV 16 Berchem TOT
54,Posthofbrug 5366,2019-04-17,04:00:00,11,10,1,FMN GV 16 Berchem TOT
54,Posthofbrug 5366,2019-04-17,05:00:00,12,8,4,FMN GV 16 Berchem TOT
54,Posthofbrug 5366,2019-04-17,06:00:00,79,58,21,FMN GV 16 Berchem TOT
54,Posthofbrug 5366,2019-04-17,07:00:00,279,173,106,FMN GV 16 Berchem TOT
54,Posthofbrug 5366,2019-04-17,08:00:00,460,289,171,FMN GV 16 Berchem TOT
54,Posthofbrug 5366,2019-04-17,09:00:00,179,122,57,FMN GV 16 Berchem TOT
54,Posthofbrug 5366,2019-04-17,10:00:00,101,63,38,FMN GV 16 Berchem TOT
54,Posthofbrug 5366,2019-04-17,11:00:00,90,50,40,FMN GV 16 Berchem TOT
54,Posthofbrug 5366,2019-04-17,12:00:00,119,71,48,FMN GV 16 Berchem TOT
54,Posthofbrug 5366,2019-04-17,13:00:00,107,66,41,FMN GV 16 Berchem TOT
54,Posthofbrug 5366,2019-04-17,14:00:00,81,47,34,FMN GV 16 Berchem TOT
54,Posthofbrug 5366,2019-04-17,15:00:00,107,52,55,FMN GV 16 Berchem TOT
54,Posthofbrug 5366,2019-04-17,16:00:00,279,152,127,FMN GV 16 Berchem TOT
54,Posthofbrug 5366,2019-04-17,17:00:00,441,203,238,FMN GV 16 Berchem TOT
54,Posthofbrug 5366,2019-04-17,18:00:00,299,143,156,FMN GV 16 Berchem TOT
54,Posthofbrug 5366,2019-04-17,19:00:00,140,72,68,FMN GV 16 Berchem TOT
54,Posthofbrug 5366,2019-04-17,20:00:00,107,65,42,FMN GV 16 Berchem TOT
54,Posthofbrug 5366,2019-04-17,21:00:00,73,42,31,FMN GV 16 Berchem TOT
54,Posthofbrug 5366,2019-04-17,22:00:00,55,24,31,FMN GV 16 Berchem TOT
54,Posthofbrug 5366,2019-04-17,23:00:00,59,25,34,FMN GV 16 Berchem TOT
54,Posthofbrug 5366,2019-04-18,00:00:00,24,8,16,FMN GV 16 Berchem TOT
54,Posthofbrug 5366,2019-04-18,01:00:00,8,1,7,FMN GV 16 Berchem TOT
54,Posthofbrug 5366,2019-04-18,02:00:00,6,1,5,FMN GV 16 Berchem TOT
54,Posthofbrug 5366,2019-04-18,03:00:00,0,0,0,FMN GV 16 Berchem TOT
54,Posthofbrug 5366,2019-04-18,04:00:00,14,11,3,FMN GV 16 Berchem TOT
54,Posthofbrug 5366,2019-04-18,05:00:00,15,12,3,FMN GV 16 Berchem TOT
54,Posthofbrug 5366,2019-04-18,06:00:00,92,72,20,FMN GV 16 Berchem TOT
54,Posthofbrug 5366,2019-04-18,07:00:00,303,214,89,FMN GV 16 Berchem TOT
54,Posthofbrug 5366,2019-04-18,08:00:00,531,347,184,FMN GV 16 Berchem TOT
54,Posthofbrug 5366,2019-04-18,09:00:00,226,156,70,FMN GV 16 Berchem TOT
54,Posthofbrug 5366,2019-04-18,10:00:00,125,90,35,FMN GV 16 Berchem TOT
54,Posthofbrug 5366,2019-04-18,11:00:00,132,79,53,FMN GV 16 Berchem TOT
54,Posthofbrug 5366,2019-04-18,12:00:00,135,82,53,FMN GV 16 Berchem TOT
54,Posthofbrug 5366,2019-04-18,13:00:00,133,72,61,FMN GV 16 Berchem TOT
54,Posthofbrug 5366,2019-04-18,14:00:00,135,65,70,FMN GV 16 Berchem TOT
54,Posthofbrug 5366,2019-04-18,15:00:00,162,81,81,FMN GV 16 Berchem TOT
54,Posthofbrug 5366,2019-04-18,16:00:00,333,158,175,FMN GV 16 Berchem TOT
54,Posthofbrug 5366,2019-04-18,17:00:00,467,227,240,FMN GV 16 Berchem TOT
54,Posthofbrug 5366,2019-04-18,18:00:00,331,162,169,FMN GV 16 Berchem TOT
54,Posthofbrug 5366,2019-04-18,19:00:00,145,79,66,FMN GV 16 Berchem TOT
54,Posthofbrug 5366,2019-04-18,20:00:00,123,77,46,FMN GV 16 Berchem TOT
54,Posthofbrug 5366,2019-04-18,21:00:00,98,62,36,FMN GV 16 Berchem TOT
54,Posthofbrug 5366,2019-04-18,22:00:00,77,35,42,FMN GV 16 Berchem TOT
54,Posthofbrug 5366,2019-04-18,23:00:00,62,32,30,FMN GV 16 Berchem TOT
54,Posthofbrug 5366,2019-04-19,00:00:00,15,7,8,FMN GV 16 Berchem TOT
54,Posthofbrug 5366,2019-04-19,01:00:00,22,12,10,FMN GV 16 Berchem TOT
54,Posthofbrug 5366,2019-04-19,02:00:00,8,3,5,FMN GV 16 Berchem TOT
54,Posthofbrug 5366,2019-04-19,03:00:00,12,5,7,FMN GV 16 Berchem TOT
54,Posthofbrug 5366,2019-04-19,04:00:00,16,9,7,FMN GV 16 Berchem TOT
54,Posthofbrug 5366,2019-04-19,05:00:00,21,10,11,FMN GV 16 Berchem TOT
54,Posthofbrug 5366,2019-04-19,06:00:00,64,48,16,FMN GV 16 Berchem TOT
54,Posthofbrug 5366,2019-04-19,07:00:00,212,131,81,FMN GV 16 Berchem TOT
54,Posthofbrug 5366,2019-04-19,08:00:00,348,224,124,FMN GV 16 Berchem TOT
54,Posthofbrug 5366,2019-04-19,09:00:00,181,119,62,FMN GV 16 Berchem TOT
54,Posthofbrug 5366,2019-04-19,10:00:00,111,65,46,FMN GV 16 Berchem TOT
54,Posthofbrug 5366,2019-04-19,11:00:00,119,79,40,FMN GV 16 Berchem TOT
54,Posthofbrug 5366,2019-04-19,12:00:00,145,87,58,FMN GV 16 Berchem TOT
54,Posthofbrug 5366,2019-04-19,13:00:00,153,85,68,FMN GV 16 Berchem TOT
54,Posthofbrug 5366,2019-04-19,14:00:00,141,72,69,FMN GV 16 Berchem TOT
54,Posthofbrug 5366,2019-04-19,15:00:00,196,116,80,FMN GV 16 Berchem TOT
54,Posthofbrug 5366,2019-04-19,16:00:00,335,194,141,FMN GV 16 Berchem TOT
54,Posthofbrug 5366,2019-04-19,17:00:00,313,154,159,FMN GV 16 Berchem TOT
54,Posthofbrug 5366,2019-04-19,18:00:00,247,154,93,FMN GV 16 Berchem TOT
54,Posthofbrug 5366,2019-04-19,19:00:00,158,92,66,FMN GV 16 Berchem TOT
54,Posthofbrug 5366,2019-04-19,20:00:00,89,48,41,FMN GV 16 Berchem TOT
54,Posthofbrug 5366,2019-04-19,21:00:00,89,48,41,FMN GV 16 Berchem TOT
54,Posthofbrug 5366,2019-04-19,22:00:00,68,34,34,FMN GV 16 Berchem TOT
54,Posthofbrug 5366,2019-04-19,23:00:00,62,24,38,FMN GV 16 Berchem TOT
54,Posthofbrug 5366,2019-04-20,00:00:00,44,17,27,FMN GV 16 Berchem TOT
54,Posthofbrug 5366,2019-04-20,01:00:00,27,9,18,FMN GV 16 Berchem TOT
54,Posthofbrug 5366,2019-04-20,02:00:00,14,4,10,FMN GV 16 Berchem TOT
54,Posthofbrug 5366,2019-04-20,03:00:00,14,9,5,FMN GV 16 Berchem TOT
54,Posthofbrug 5366,2019-04-20,04:00:00,19,8,11,FMN GV 16 Berchem TOT
54,Posthofbrug 5366,2019-04-20,05:00:00,10,6,4,FMN GV 16 Berchem TOT
54,Posthofbrug 5366,2019-04-20,06:00:00,15,12,3,FMN GV 16 Berchem TOT
54,Posthofbrug 5366,2019-04-20,07:00:00,26,18,8,FMN GV 16 Berchem TOT
54,Posthofbrug 5366,2019-04-20,08:00:00,65,38,27,FMN GV 16 Berchem TOT
54,Posthofbrug 5366,2019-04-20,09:00:00,93,65,28,FMN GV 16 Berchem TOT
54,Posthofbrug 5366,2019-04-20,10:00:00,140,96,44,FMN GV 16 Berchem TOT
54,Posthofbrug 5366,2019-04-20,11:00:00,145,102,43,FMN GV 16 Berchem TOT
54,Posthofbrug 5366,2019-04-20,12:00:00,170,102,68,FMN GV 16 Berchem TOT
54,Posthofbrug 5366,2019-04-20,13:00:00,181,105,76,FMN GV 16 Berchem TOT
54,Posthofbrug 5366,2019-04-20,14:00:00,211,99,112,FMN GV 16 Berchem TOT
54,Posthofbrug 5366,2019-04-20,15:00:00,180,79,101,FMN GV 16 Berchem TOT
54,Posthofbrug 5366,2019-04-20,16:00:00,163,79,84,FMN GV 16 Berchem TOT
54,Posthofbrug 5366,2019-04-20,17:00:00,153,86,67,FMN GV 16 Berchem TOT
54,Posthofbrug 5366,2019-04-20,18:00:00,154,94,60,FMN GV 16 Berchem TOT
54,Posthofbrug 5366,2019-04-20,19:00:00,104,63,41,FMN GV 16 Berchem TOT
54,Posthofbrug 5366,2019-04-20,20:00:00,97,56,41,FMN GV 16 Berchem TOT
54,Posthofbrug 5366,2019-04-20,21:00:00,70,36,34,FMN GV 16 Berchem TOT
54,Posthofbrug 5366,2019-04-20,22:00:00,50,29,21,FMN GV 16 Berchem TOT
54,Posthofbrug 5366,2019-04-20,23:00:00,80,41,39,FMN GV 16 Berchem TOT
54,Posthofbrug 5366,2019-04-21,00:00:00,50,29,21,FMN GV 16 Berchem TOT
54,Posthofbrug 5366,2019-04-21,01:00:00,25,16,9,FMN GV 16 Berchem TOT
54,Posthofbrug 5366,2019-04-21,02:00:00,14,7,7,FMN GV 16 Berchem TOT
54,Posthofbrug 5366,2019-04-21,03:00:00,18,6,12,FMN GV 16 Berchem TOT
54,Posthofbrug 5366,2019-04-21,04:00:00,8,4,4,FMN GV 16 Berchem TOT
54,Posthofbrug 5366,2019-04-21,05:00:00,11,8,3,FMN GV 16 Berchem TOT
54,Posthofbrug 5366,2019-04-21,06:00:00,14,9,5,FMN GV 16 Berchem TOT
54,Posthofbrug 5366,2019-04-21,07:00:00,17,9,8,FMN GV 16 Berchem TOT
54,Posthofbrug 5366,2019-04-21,08:00:00,20,9,11,FMN GV 16 Berchem TOT
54,Posthofbrug 5366,2019-04-21,09:00:00,69,47,22,FMN GV 16 Berchem TOT
54,Posthofbrug 5366,2019-04-21,10:00:00,130,83,47,FMN GV 16 Berchem TOT
54,Posthofbrug 5366,2019-04-21,11:00:00,118,61,57,FMN GV 16 Berchem TOT
54,Posthofbrug 5366,2019-04-21,12:00:00,153,79,74,FMN GV 16 Berchem TOT
54,Posthofbrug 5366,2019-04-21,13:00:00,159,91,68,FMN GV 16 Berchem TOT
54,Posthofbrug 5366,2019-04-21,14:00:00,152,82,70,FMN GV 16 Berchem TOT
54,Posthofbrug 5366,2019-04-21,15:00:00,162,68,94,FMN GV 16 Berchem TOT
54,Posthofbrug 5366,2019-04-21,16:00:00,123,69,54,FMN GV 16 Berchem TOT
54,Posthofbrug 5366,2019-04-21,17:00:00,119,75,44,FMN GV 16 Berchem TOT
54,Posthofbrug 5366,2019-04-21,18:00:00,104,67,37,FMN GV 16 Berchem TOT
54,Posthofbrug 5366,2019-04-21,19:00:00,85,53,32,FMN GV 16 Berchem TOT
54,Posthofbrug 5366,2019-04-21,20:00:00,83,50,33,FMN GV 16 Berchem TOT
54,Posthofbrug 5366,2019-04-21,21:00:00,73,52,21,FMN GV 16 Berchem TOT
54,Posthofbrug 5366,2019-04-21,22:00:00,68,39,29,FMN GV 16 Berchem TOT
54,Posthofbrug 5366,2019-04-21,23:00:00,32,20,12,FMN GV 16 Berchem TOT
54,Posthofbrug 5366,2019-04-22,00:00:00,30,14,16,FMN GV 16 Berchem TOT
54,Posthofbrug 5366,2019-04-22,01:00:00,10,6,4,FMN GV 16 Berchem TOT
54,Posthofbrug 5366,2019-04-22,02:00:00,11,5,6,FMN GV 16 Berchem TOT
54,Posthofbrug 5366,2019-04-22,03:00:00,4,1,3,FMN GV 16 Berchem TOT
54,Posthofbrug 5366,2019-04-22,04:00:00,12,4,8,FMN GV 16 Berchem TOT
54,Posthofbrug 5366,2019-04-22,05:00:00,8,3,5,FMN GV 16 Berchem TOT
54,Posthofbrug 5366,2019-04-22,06:00:00,9,8,1,FMN GV 16 Berchem TOT
54,Posthofbrug 5366,2019-04-22,07:00:00,14,8,6,FMN GV 16 Berchem TOT
54,Posthofbrug 5366,2019-04-22,08:00:00,37,16,21,FMN GV 16 Berchem TOT
54,Posthofbrug 5366,2019-04-22,09:00:00,73,49,24,FMN GV 16 Berchem TOT
54,Posthofbrug 5366,2019-04-22,10:00:00,115,69,46,FMN GV 16 Berchem TOT
54,Posthofbrug 5366,2019-04-22,11:00:00,151,83,68,FMN GV 16 Berchem TOT
54,Posthofbrug 5366,2019-04-22,12:00:00,137,76,61,FMN GV 16 Berchem TOT
54,Posthofbrug 5366,2019-04-22,13:00:00,146,90,56,FMN GV 16 Berchem TOT
54,Posthofbrug 5366,2019-04-22,14:00:00,174,94,80,FMN GV 16 Berchem TOT
54,Posthofbrug 5366,2019-04-22,15:00:00,208,105,103,FMN GV 16 Berchem TOT
54,Posthofbrug 5366,2019-04-22,16:00:00,159,85,74,FMN GV 16 Berchem TOT
54,Posthofbrug 5366,2019-04-22,17:00:00,175,90,85,FMN GV 16 Berchem TOT
54,Posthofbrug 5366,2019-04-22,18:00:00,170,85,85,FMN GV 16 Berchem TOT
54,Posthofbrug 5366,2019-04-22,19:00:00,70,41,29,FMN GV 16 Berchem TOT
54,Posthofbrug 5366,2019-04-22,20:00:00,105,69,36,FMN GV 16 Berchem TOT
54,Posthofbrug 5366,2019-04-22,21:00:00,68,42,26,FMN GV 16 Berchem TOT
54,Posthofbrug 5366,2019-04-22,22:00:00,39,18,21,FMN GV 16 Berchem TOT
54,Posthofbrug 5366,2019-04-22,23:00:00,16,7,9,FMN GV 16 Berchem TOT
54,Posthofbrug 5366,2019-04-23,00:00:00,13,5,8,FMN GV 16 Berchem TOT
54,Posthofbrug 5366,2019-04-23,01:00:00,5,3,2,FMN GV 16 Berchem TOT
54,Posthofbrug 5366,2019-04-23,02:00:00,3,1,2,FMN GV 16 Berchem TOT
54,Posthofbrug 5366,2019-04-23,03:00:00,4,3,1,FMN GV 16 Berchem TOT
54,Posthofbrug 5366,2019-04-23,04:00:00,7,6,1,FMN GV 16 Berchem TOT
54,Posthofbrug 5366,2019-04-23,05:00:00,25,17,8,FMN GV 16 Berchem TOT
54,Posthofbrug 5366,2019-04-23,06:00:00,110,80,30,FMN GV 16 Berchem TOT
54,Posthofbrug 5366,2019-04-23,07:00:00,448,285,163,FMN GV 16 Berchem TOT
54,Posthofbrug 5366,2019-04-23,08:00:00,752,473,279,FMN GV 16 Berchem TOT
54,Posthofbrug 5366,2019-04-23,09:00:00,258,172,86,FMN GV 16 Berchem TOT
54,Posthofbrug 5366,2019-04-23,10:00:00,101,65,36,FMN GV 16 Berchem TOT
54,Posthofbrug 5366,2019-04-23,11:00:00,117,74,43,FMN GV 16 Berchem TOT
54,Posthofbrug 5366,2019-04-23,12:00:00,172,105,67,FMN GV 16 Berchem TOT
54,Posthofbrug 5366,2019-04-23,13:00:00,151,90,61,FMN GV 16 Berchem TOT
54,Posthofbrug 5366,2019-04-23,14:00:00,136,81,55,FMN GV 16 Berchem TOT
54,Posthofbrug 5366,2019-04-23,15:00:00,259,136,123,FMN GV 16 Berchem TOT
54,Posthofbrug 5366,2019-04-23,16:00:00,476,234,242,FMN GV 16 Berchem TOT
54,Posthofbrug 5366,2019-04-23,17:00:00,623,303,320,FMN GV 16 Berchem TOT
54,Posthofbrug 5366,2019-04-23,18:00:00,382,189,193,FMN GV 16 Berchem TOT
54,Posthofbrug 5366,2019-04-23,19:00:00,176,105,71,FMN GV 16 Berchem TOT
54,Posthofbrug 5366,2019-04-23,20:00:00,106,63,43,FMN GV 16 Berchem TOT
54,Posthofbrug 5366,2019-04-23,21:00:00,78,40,38,FMN GV 16 Berchem TOT
54,Posthofbrug 5366,2019-04-23,22:00:00,78,37,41,FMN GV 16 Berchem TOT
54,Posthofbrug 5366,2019-04-23,23:00:00,36,19,17,FMN GV 16 Berchem TOT
54,Posthofbrug 5366,2019-04-24,00:00:00,9,2,7,FMN GV 16 Berchem TOT
54,Posthofbrug 5366,2019-04-24,01:00:00,5,1,4,FMN GV 16 Berchem TOT
54,Posthofbrug 5366,2019-04-24,02:00:00,3,3,0,FMN GV 16 Berchem TOT
54,Posthofbrug 5366,2019-04-24,03:00:00,4,1,3,FMN GV 16 Berchem TOT
54,Posthofbrug 5366,2019-04-24,04:00:00,4,2,2,FMN GV 16 Berchem TOT
54,Posthofbrug 5366,2019-04-24,05:00:00,23,15,8,FMN GV 16 Berchem TOT
54,Posthofbrug 5366,2019-04-24,06:00:00,117,84,33,FMN GV 16 Berchem TOT
54,Posthofbrug 5366,2019-04-24,07:00:00,383,253,130,FMN GV 16 Berchem TOT
54,Posthofbrug 5366,2019-04-24,08:00:00,597,382,215,FMN GV 16 Berchem TOT
54,Posthofbrug 5366,2019-04-24,09:00:00,201,117,84,FMN GV 16 Berchem TOT
54,Posthofbrug 5366,2019-04-24,10:00:00,98,58,40,FMN GV 16 Berchem TOT
54,Posthofbrug 5366,2019-04-24,11:00:00,123,75,48,FMN GV 16 Berchem TOT
54,Posthofbrug 5366,2019-04-24,12:00:00,261,157,104,FMN GV 16 Berchem TOT
54,Posthofbrug 5366,2019-04-24,13:00:00,211,122,89,FMN GV 16 Berchem TOT
54,Posthofbrug 5366,2019-04-24,14:00:00,169,95,74,FMN GV 16 Berchem TOT
54,Posthofbrug 5366,2019-04-24,15:00:00,182,101,81,FMN GV 16 Berchem TOT
54,Posthofbrug 5366,2019-04-24,16:00:00,332,184,148,FMN GV 16 Berchem TOT
54,Posthofbrug 5366,2019-04-24,17:00:00,480,245,235,FMN GV 16 Berchem TOT
54,Posthofbrug 5366,2019-04-24,18:00:00,302,164,138,FMN GV 16 Berchem TOT
54,Posthofbrug 5366,2019-04-24,19:00:00,136,74,62,FMN GV 16 Berchem TOT
54,Posthofbrug 5366,2019-04-24,20:00:00,65,39,26,FMN GV 16 Berchem TOT
54,Posthofbrug 5366,2019-04-24,21:00:00,47,27,20,FMN GV 16 Berchem TOT
54,Posthofbrug 5366,2019-04-24,22:00:00,51,25,26,FMN GV 16 Berchem TOT
54,Posthofbrug 5366,2019-04-24,23:00:00,46,23,23,FMN GV 16 Berchem TOT
54,Posthofbrug 5366,2019-04-25,00:00:00,19,11,8,FMN GV 16 Berchem TOT
54,Posthofbrug 5366,2019-04-25,01:00:00,7,2,5,FMN GV 16 Berchem TOT
54,Posthofbrug 5366,2019-04-25,02:00:00,5,1,4,FMN GV 16 Berchem TOT
54,Posthofbrug 5366,2019-04-25,03:00:00,2,2,0,FMN GV 16 Berchem TOT
54,Posthofbrug 5366,2019-04-25,04:00:00,7,3,4,FMN GV 16 Berchem TOT
54,Posthofbrug 5366,2019-04-25,05:00:00,12,5,7,FMN GV 16 Berchem TOT
54,Posthofbrug 5366,2019-04-25,06:00:00,112,74,38,FMN GV 16 Berchem TOT
54,Posthofbrug 5366,2019-04-25,07:00:00,353,233,120,FMN GV 16 Berchem TOT
54,Posthofbrug 5366,2019-04-25,08:00:00,615,370,245,FMN GV 16 Berchem TOT
54,Posthofbrug 5366,2019-04-25,09:00:00,167,109,58,FMN GV 16 Berchem TOT
54,Posthofbrug 5366,2019-04-25,10:00:00,100,64,36,FMN GV 16 Berchem TOT
54,Posthofbrug 5366,2019-04-25,11:00:00,74,47,27,FMN GV 16 Berchem TOT
54,Posthofbrug 5366,2019-04-25,12:00:00,155,85,70,FMN GV 16 Berchem TOT
54,Posthofbrug 5366,2019-04-25,13:00:00,101,63,38,FMN GV 16 Berchem TOT
54,Posthofbrug 5366,2019-04-25,14:00:00,64,35,29,FMN GV 16 Berchem TOT
54,Posthofbrug 5366,2019-04-25,15:00:00,165,88,77,FMN GV 16 Berchem TOT
54,Posthofbrug 5366,2019-04-25,16:00:00,336,171,165,FMN GV 16 Berchem TOT
54,Posthofbrug 5366,2019-04-25,17:00:00,443,232,211,FMN GV 16 Berchem TOT
54,Posthofbrug 5366,2019-04-25,18:00:00,294,136,158,FMN GV 16 Berchem TOT
54,Posthofbrug 5366,2019-04-25,19:00:00,150,82,68,FMN GV 16 Berchem TOT
54,Posthofbrug 5366,2019-04-25,20:00:00,92,51,41,FMN GV 16 Berchem TOT
54,Posthofbrug 5366,2019-04-25,21:00:00,80,53,27,FMN GV 16 Berchem TOT
54,Posthofbrug 5366,2019-04-25,22:00:00,70,23,47,FMN GV 16 Berchem TOT
54,Posthofbrug 5366,2019-04-25,23:00:00,50,21,29,FMN GV 16 Berchem TOT
54,Posthofbrug 5366,2019-04-26,00:00:00,25,10,15,FMN GV 16 Berchem TOT
54,Posthofbrug 5366,2019-04-26,01:00:00,8,3,5,FMN GV 16 Berchem TOT
54,Posthofbrug 5366,2019-04-26,02:00:00,5,3,2,FMN GV 16 Berchem TOT
54,Posthofbrug 5366,2019-04-26,03:00:00,5,2,3,FMN GV 16 Berchem TOT
54,Posthofbrug 5366,2019-04-26,04:00:00,5,4,1,FMN GV 16 Berchem TOT
54,Posthofbrug 5366,2019-04-26,05:00:00,23,13,10,FMN GV 16 Berchem TOT
54,Posthofbrug 5366,2019-04-26,06:00:00,77,57,20,FMN GV 16 Berchem TOT
54,Posthofbrug 5366,2019-04-26,07:00:00,335,216,119,FMN GV 16 Berchem TOT
54,Posthofbrug 5366,2019-04-26,08:00:00,587,375,212,FMN GV 16 Berchem TOT
54,Posthofbrug 5366,2019-04-26,09:00:00,178,114,64,FMN GV 16 Berchem TOT
54,Posthofbrug 5366,2019-04-26,10:00:00,98,67,31,FMN GV 16 Berchem TOT
54,Posthofbrug 5366,2019-04-26,11:00:00,131,73,58,FMN GV 16 Berchem TOT
54,Posthofbrug 5366,2019-04-26,12:00:00,160,105,55,FMN GV 16 Berchem TOT
54,Posthofbrug 5366,2019-04-26,13:00:00,173,102,71,FMN GV 16 Berchem TOT
54,Posthofbrug 5366,2019-04-26,14:00:00,131,73,58,FMN GV 16 Berchem TOT
54,Posthofbrug 5366,2019-04-26,15:00:00,236,121,115,FMN GV 16 Berchem TOT
54,Posthofbrug 5366,2019-04-26,16:00:00,426,211,215,FMN GV 16 Berchem TOT
54,Posthofbrug 5366,2019-04-26,17:00:00,445,234,211,FMN GV 16 Berchem TOT
54,Posthofbrug 5366,2019-04-26,18:00:00,279,135,144,FMN GV 16 Berchem TOT
54,Posthofbrug 5366,2019-04-26,19:00:00,160,80,80,FMN GV 16 Berchem TOT
54,Posthofbrug 5366,2019-04-26,20:00:00,110,61,49,FMN GV 16 Berchem TOT
54,Posthofbrug 5366,2019-04-26,21:00:00,73,45,28,FMN GV 16 Berchem TOT
54,Posthofbrug 5366,2019-04-26,22:00:00,72,29,43,FMN GV 16 Berchem TOT
54,Posthofbrug 5366,2019-04-26,23:00:00,72,32,40,FMN GV 16 Berchem TOT
54,Posthofbrug 5366,2019-04-27,00:00:00,59,26,33,FMN GV 16 Berchem TOT
54,Posthofbrug 5366,2019-04-27,01:00:00,41,20,21,FMN GV 16 Berchem TOT
54,Posthofbrug 5366,2019-04-27,02:00:00,14,6,8,FMN GV 16 Berchem TOT
54,Posthofbrug 5366,2019-04-27,03:00:00,13,5,8,FMN GV 16 Berchem TOT
54,Posthofbrug 5366,2019-04-27,04:00:00,22,8,14,FMN GV 16 Berchem TOT
54,Posthofbrug 5366,2019-04-27,05:00:00,15,6,9,FMN GV 16 Berchem TOT
54,Posthofbrug 5366,2019-04-27,06:00:00,19,12,7,FMN GV 16 Berchem TOT
54,Posthofbrug 5366,2019-04-27,07:00:00,21,14,7,FMN GV 16 Berchem TOT
54,Posthofbrug 5366,2019-04-27,08:00:00,35,19,16,FMN GV 16 Berchem TOT
54,Posthofbrug 5366,2019-04-27,09:00:00,73,49,24,FMN GV 16 Berchem TOT
54,Posthofbrug 5366,2019-04-27,10:00:00,83,57,26,FMN GV 16 Berchem TOT
54,Posthofbrug 5366,2019-04-27,11:00:00,65,43,22,FMN GV 16 Berchem TOT
54,Posthofbrug 5366,2019-04-27,12:00:00,88,64,24,FMN GV 16 Berchem TOT
54,Posthofbrug 5366,2019-04-27,13:00:00,115,71,44,FMN GV 16 Berchem TOT
54,Posthofbrug 5366,2019-04-27,14:00:00,82,55,27,FMN GV 16 Berchem TOT
54,Posthofbrug 5366,2019-04-27,15:00:00,61,42,19,FMN GV 16 Berchem TOT
54,Posthofbrug 5366,2019-04-27,16:00:00,91,53,38,FMN GV 16 Berchem TOT
54,Posthofbrug 5366,2019-04-27,17:00:00,91,40,51,FMN GV 16 Berchem TOT
54,Posthofbrug 5366,2019-04-27,18:00:00,100,45,55,FMN GV 16 Berchem TOT
54,Posthofbrug 5366,2019-04-27,19:00:00,75,46,29,FMN GV 16 Berchem TOT
54,Posthofbrug 5366,2019-04-27,20:00:00,46,25,21,FMN GV 16 Berchem TOT
54,Posthofbrug 5366,2019-04-27,21:00:00,50,24,26,FMN GV 16 Berchem TOT
54,Posthofbrug 5366,2019-04-27,22:00:00,49,22,27,FMN GV 16 Berchem TOT
54,Posthofbrug 5366,2019-04-27,23:00:00,37,14,23,FMN GV 16 Berchem TOT
54,Posthofbrug 5366,2019-04-28,00:00:00,29,18,11,FMN GV 16 Berchem TOT
54,Posthofbrug 5366,2019-04-28,01:00:00,26,12,14,FMN GV 16 Berchem TOT
54,Posthofbrug 5366,2019-04-28,02:00:00,11,8,3,FMN GV 16 Berchem TOT
54,Posthofbrug 5366,2019-04-28,03:00:00,6,3,3,FMN GV 16 Berchem TOT
54,Posthofbrug 5366,2019-04-28,04:00:00,12,6,6,FMN GV 16 Berchem TOT
54,Posthofbrug 5366,2019-04-28,05:00:00,11,9,2,FMN GV 16 Berchem TOT
54,Posthofbrug 5366,2019-04-28,06:00:00,12,9,3,FMN GV 16 Berchem TOT
54,Posthofbrug 5366,2019-04-28,07:00:00,18,10,8,FMN GV 16 Berchem TOT
54,Posthofbrug 5366,2019-04-28,08:00:00,28,14,14,FMN GV 16 Berchem TOT
54,Posthofbrug 5366,2019-04-28,09:00:00,70,39,31,FMN GV 16 Berchem TOT
54,Posthofbrug 5366,2019-04-28,10:00:00,102,66,36,FMN GV 16 Berchem TOT
54,Posthofbrug 5366,2019-04-28,11:00:00,125,81,44,FMN GV 16 Berchem TOT
54,Posthofbrug 5366,2019-04-28,12:00:00,107,66,41,FMN GV 16 Berchem TOT
54,Posthofbrug 5366,2019-04-28,13:00:00,145,93,52,FMN GV 16 Berchem TOT
54,Posthofbrug 5366,2019-04-28,14:00:00,95,52,43,FMN GV 16 Berchem TOT
54,Posthofbrug 5366,2019-04-28,15:00:00,93,54,39,FMN GV 16 Berchem TOT
54,Posthofbrug 5366,2019-04-28,16:00:00,106,51,55,FMN GV 16 Berchem TOT
54,Posthofbrug 5366,2019-04-28,17:00:00,130,50,80,FMN GV 16 Berchem TOT
54,Posthofbrug 5366,2019-04-28,18:00:00,132,49,83,FMN GV 16 Berchem TOT
54,Posthofbrug 5366,2019-04-28,19:00:00,86,40,46,FMN GV 16 Berchem TOT
54,Posthofbrug 5366,2019-04-28,20:00:00,47,26,21,FMN GV 16 Berchem TOT
54,Posthofbrug 5366,2019-04-28,21:00:00,61,25,36,FMN GV 16 Berchem TOT
54,Posthofbrug 5366,2019-04-28,22:00:00,44,20,24,FMN GV 16 Berchem TOT
54,Posthofbrug 5366,2019-04-28,23:00:00,13,5,8,FMN GV 16 Berchem TOT
54,Posthofbrug 5366,2019-04-29,00:00:00,5,4,1,FMN GV 16 Berchem TOT
54,Posthofbrug 5366,2019-04-29,01:00:00,2,1,1,FMN GV 16 Berchem TOT
54,Posthofbrug 5366,2019-04-29,02:00:00,1,0,1,FMN GV 16 Berchem TOT
54,Posthofbrug 5366,2019-04-29,03:00:00,4,2,2,FMN GV 16 Berchem TOT
54,Posthofbrug 5366,2019-04-29,04:00:00,6,5,1,FMN GV 16 Berchem TOT
54,Posthofbrug 5366,2019-04-29,05:00:00,15,11,4,FMN GV 16 Berchem TOT
54,Posthofbrug 5366,2019-04-29,06:00:00,100,77,23,FMN GV 16 Berchem TOT
54,Posthofbrug 5366,2019-04-29,07:00:00,390,273,117,FMN GV 16 Berchem TOT
54,Posthofbrug 5366,2019-04-29,08:00:00,680,430,250,FMN GV 16 Berchem TOT
54,Posthofbrug 5366,2019-04-29,09:00:00,219,140,79,FMN GV 16 Berchem TOT
54,Posthofbrug 5366,2019-04-29,10:00:00,118,72,46,FMN GV 16 Berchem TOT
54,Posthofbrug 5366,2019-04-29,11:00:00,92,54,38,FMN GV 16 Berchem TOT
54,Posthofbrug 5366,2019-04-29,12:00:00,159,100,59,FMN GV 16 Berchem TOT
54,Posthofbrug 5366,2019-04-29,13:00:00,143,92,51,FMN GV 16 Berchem TOT
54,Posthofbrug 5366,2019-04-29,14:00:00,108,63,45,FMN GV 16 Berchem TOT
54,Posthofbrug 5366,2019-04-29,15:00:00,192,101,91,FMN GV 16 Berchem TOT
54,Posthofbrug 5366,2019-04-29,16:00:00,435,223,212,FMN GV 16 Berchem TOT
54,Posthofbrug 5366,2019-04-29,17:00:00,582,299,283,FMN GV 16 Berchem TOT
54,Posthofbrug 5366,2019-04-29,18:00:00,381,181,200,FMN GV 16 Berchem TOT
54,Posthofbrug 5366,2019-04-29,19:00:00,170,96,74,FMN GV 16 Berchem TOT
54,Posthofbrug 5366,2019-04-29,20:00:00,101,53,48,FMN GV 16 Berchem TOT
54,Posthofbrug 5366,2019-04-29,21:00:00,68,47,21,FMN GV 16 Berchem TOT
54,Posthofbrug 5366,2019-04-29,22:00:00,63,35,28,FMN GV 16 Berchem TOT
54,Posthofbrug 5366,2019-04-29,23:00:00,30,10,20,FMN GV 16 Berchem TOT
54,Posthofbrug 5366,2019-04-30,00:00:00,14,7,7,FMN GV 16 Berchem TOT
54,Posthofbrug 5366,2019-04-30,01:00:00,3,1,2,FMN GV 16 Berchem TOT
54,Posthofbrug 5366,2019-04-30,02:00:00,1,0,1,FMN GV 16 Berchem TOT
54,Posthofbrug 5366,2019-04-30,03:00:00,6,4,2,FMN GV 16 Berchem TOT
54,Posthofbrug 5366,2019-04-30,04:00:00,7,1,6,FMN GV 16 Berchem TOT
54,Posthofbrug 5366,2019-04-30,05:00:00,17,12,5,FMN GV 16 Berchem TOT
54,Posthofbrug 5366,2019-04-30,06:00:00,129,82,47,FMN GV 16 Berchem TOT
54,Posthofbrug 5366,2019-04-30,07:00:00,427,275,152,FMN GV 16 Berchem TOT
54,Posthofbrug 5366,2019-04-30,08:00:00,725,463,262,FMN GV 16 Berchem TOT
54,Posthofbrug 5366,2019-04-30,09:00:00,209,147,62,FMN GV 16 Berchem TOT
54,Posthofbrug 5366,2019-04-30,10:00:00,106,72,34,FMN GV 16 Berchem TOT
54,Posthofbrug 5366,2019-04-30,11:00:00,85,49,36,FMN GV 16 Berchem TOT
54,Posthofbrug 5366,2019-04-30,12:00:00,159,95,64,FMN GV 16 Berchem TOT
54,Posthofbrug 5366,2019-04-30,13:00:00,161,86,75,FMN GV 16 Berchem TOT
54,Posthofbrug 5366,2019-04-30,14:00:00,136,82,54,FMN GV 16 Berchem TOT
54,Posthofbrug 5366,2019-04-30,15:00:00,220,109,111,FMN GV 16 Berchem TOT
54,Posthofbrug 5366,2019-04-30,16:00:00,463,251,212,FMN GV 16 Berchem TOT
54,Posthofbrug 5366,2019-04-30,17:00:00,544,303,241,FMN GV 16 Berchem TOT
54,Posthofbrug 5366,2019-04-30,18:00:00,398,193,205,FMN GV 16 Berchem TOT
54,Posthofbrug 5366,2019-04-30,19:00:00,196,90,106,FMN GV 16 Berchem TOT
54,Posthofbrug 5366,2019-04-30,20:00:00,133,89,44,FMN GV 16 Berchem TOT
54,Posthofbrug 5366,2019-04-30,21:00:00,97,48,49,FMN GV 16 Berchem TOT
54,Posthofbrug 5366,2019-04-30,22:00:00,89,40,49,FMN GV 16 Berchem TOT
54,Posthofbrug 5366,2019-04-30,23:00:00,53,27,26,FMN GV 16 Berchem TOT
54,Posthofbrug 5366,2019-05-01,00:00:00,57,29,28,FMN GV 16 Berchem TOT
54,Posthofbrug 5366,2019-05-01,01:00:00,36,17,19,FMN GV 16 Berchem TOT
54,Posthofbrug 5366,2019-05-01,02:00:00,28,12,16,FMN GV 16 Berchem TOT
54,Posthofbrug 5366,2019-05-01,03:00:00,19,6,13,FMN GV 16 Berchem TOT
54,Posthofbrug 5366,2019-05-01,04:00:00,22,11,11,FMN GV 16 Berchem TOT
54,Posthofbrug 5366,2019-05-01,05:00:00,17,6,11,FMN GV 16 Berchem TOT
54,Posthofbrug 5366,2019-05-01,06:00:00,31,19,12,FMN GV 16 Berchem TOT
54,Posthofbrug 5366,2019-05-01,07:00:00,20,6,14,FMN GV 16 Berchem TOT
54,Posthofbrug 5366,2019-05-01,08:00:00,7,5,2,FMN GV 16 Berchem TOT
54,Posthofbrug 5366,2019-05-01,09:00:00,8,5,3,FMN GV 16 Berchem TOT
54,Posthofbrug 5366,2019-05-01,10:00:00,114,64,50,FMN GV 16 Berchem TOT
54,Posthofbrug 5366,2019-05-01,11:00:00,125,73,52,FMN GV 16 Berchem TOT
54,Posthofbrug 5366,2019-05-01,12:00:00,136,83,53,FMN GV 16 Berchem TOT
54,Posthofbrug 5366,2019-05-01,13:00:00,177,123,54,FMN GV 16 Berchem TOT
54,Posthofbrug 5366,2019-05-01,14:00:00,189,96,93,FMN GV 16 Berchem TOT
54,Posthofbrug 5366,2019-05-01,15:00:00,134,72,62,FMN GV 16 Berchem TOT
54,Posthofbrug 5366,2019-05-01,16:00:00,174,102,72,FMN GV 16 Berchem TOT
54,Posthofbrug 5366,2019-05-01,17:00:00,139,69,70,FMN GV 16 Berchem TOT
54,Posthofbrug 5366,2019-05-01,18:00:00,121,78,43,FMN GV 16 Berchem TOT
54,Posthofbrug 5366,2019-05-01,19:00:00,123,75,48,FMN GV 16 Berchem TOT
54,Posthofbrug 5366,2019-05-01,20:00:00,75,35,40,FMN GV 16 Berchem TOT
54,Posthofbrug 5366,2019-05-01,21:00:00,65,26,39,FMN GV 16 Berchem TOT
54,Posthofbrug 5366,2019-05-01,22:00:00,50,23,27,FMN GV 16 Berchem TOT
54,Posthofbrug 5366,2019-05-01,23:00:00,47,17,30,FMN GV 16 Berchem TOT
54,Posthofbrug 5366,2019-05-02,00:00:00,10,5,5,FMN GV 16 Berchem TOT
54,Posthofbrug 5366,2019-05-02,01:00:00,4,0,4,FMN GV 16 Berchem TOT
54,Posthofbrug 5366,2019-05-02,02:00:00,0,0,0,FMN GV 16 Berchem TOT
54,Posthofbrug 5366,2019-05-02,03:00:00,8,4,4,FMN GV 16 Berchem TOT
54,Posthofbrug 5366,2019-05-02,04:00:00,8,6,2,FMN GV 16 Berchem TOT
54,Posthofbrug 5366,2019-05-02,05:00:00,27,17,10,FMN GV 16 Berchem TOT
54,Posthofbrug 5366,2019-05-02,06:00:00,85,62,23,FMN GV 16 Berchem TOT
54,Posthofbrug 5366,2019-05-02,07:00:00,382,264,118,FMN GV 16 Berchem TOT
54,Posthofbrug 5366,2019-05-02,08:00:00,675,445,230,FMN GV 16 Berchem TOT
54,Posthofbrug 5366,2019-05-02,09:00:00,207,121,86,FMN GV 16 Berchem TOT
54,Posthofbrug 5366,2019-05-02,10:00:00,114,73,41,FMN GV 16 Berchem TOT
54,Posthofbrug 5366,2019-05-02,11:00:00,91,55,36,FMN GV 16 Berchem TOT
54,Posthofbrug 5366,2019-05-02,12:00:00,124,76,48,FMN GV 16 Berchem TOT
54,Posthofbrug 5366,2019-05-02,13:00:00,85,57,28,FMN GV 16 Berchem TOT
54,Posthofbrug 5366,2019-05-02,14:00:00,67,32,35,FMN GV 16 Berchem TOT
54,Posthofbrug 5366,2019-05-02,15:00:00,172,86,86,FMN GV 16 Berchem TOT
54,Posthofbrug 5366,2019-05-02,16:00:00,339,206,133,FMN GV 16 Berchem TOT
54,Posthofbrug 5366,2019-05-02,17:00:00,449,234,215,FMN GV 16 Berchem TOT
54,Posthofbrug 5366,2019-05-02,18:00:00,313,158,155,FMN GV 16 Berchem TOT
54,Posthofbrug 5366,2019-05-02,19:00:00,137,70,67,FMN GV 16 Berchem TOT
54,Posthofbrug 5366,2019-05-02,20:00:00,84,56,28,FMN GV 16 Berchem TOT
54,Posthofbrug 5366,2019-05-02,21:00:00,62,35,27,FMN GV 16 Berchem TOT
54,Posthofbrug 5366,2019-05-02,22:00:00,59,34,25,FMN GV 16 Berchem TOT
54,Posthofbrug 5366,2019-05-02,23:00:00,34,13,21,FMN GV 16 Berchem TOT
54,Posthofbrug 5366,2019-05-03,00:00:00,20,10,10,FMN GV 16 Berchem TOT
54,Posthofbrug 5366,2019-05-03,01:00:00,5,1,4,FMN GV 16 Berchem TOT
54,Posthofbrug 5366,2019-05-03,02:00:00,8,2,6,FMN GV 16 Berchem TOT
54,Posthofbrug 5366,2019-05-03,03:00:00,3,0,3,FMN GV 16 Berchem TOT
54,Posthofbrug 5366,2019-05-03,04:00:00,6,6,0,FMN GV 16 Berchem TOT
54,Posthofbrug 5366,2019-05-03,05:00:00,20,12,8,FMN GV 16 Berchem TOT
54,Posthofbrug 5366,2019-05-03,06:00:00,76,54,22,FMN GV 16 Berchem TOT
54,Posthofbrug 5366,2019-05-03,07:00:00,337,240,97,FMN GV 16 Berchem TOT
54,Posthofbrug 5366,2019-05-03,08:00:00,560,365,195,FMN GV 16 Berchem TOT
54,Posthofbrug 5366,2019-05-03,09:00:00,213,134,79,FMN GV 16 Berchem TOT
54,Posthofbrug 5366,2019-05-03,10:00:00,121,77,44,FMN GV 16 Berchem TOT
54,Posthofbrug 5366,2019-05-03,11:00:00,90,55,35,FMN GV 16 Berchem TOT
54,Posthofbrug 5366,2019-05-03,12:00:00,164,97,67,FMN GV 16 Berchem TOT
54,Posthofbrug 5366,2019-05-03,13:00:00,131,77,54,FMN GV 16 Berchem TOT
54,Posthofbrug 5366,2019-05-03,14:00:00,145,92,53,FMN GV 16 Berchem TOT
54,Posthofbrug 5366,2019-05-03,15:00:00,207,112,95,FMN GV 16 Berchem TOT
54,Posthofbrug 5366,2019-05-03,16:00:00,349,187,162,FMN GV 16 Berchem TOT
54,Posthofbrug 5366,2019-05-03,17:00:00,439,224,215,FMN GV 16 Berchem TOT
54,Posthofbrug 5366,2019-05-03,18:00:00,237,139,98,FMN GV 16 Berchem TOT
54,Posthofbrug 5366,2019-05-03,19:00:00,151,82,69,FMN GV 16 Berchem TOT
54,Posthofbrug 5366,2019-05-03,20:00:00,88,54,34,FMN GV 16 Berchem TOT
54,Posthofbrug 5366,2019-05-03,21:00:00,41,18,23,FMN GV 16 Berchem TOT
54,Posthofbrug 5366,2019-05-03,22:00:00,57,27,30,FMN GV 16 Berchem TOT
54,Posthofbrug 5366,2019-05-03,23:00:00,52,25,27,FMN GV 16 Berchem TOT
54,Posthofbrug 5366,2019-05-04,00:00:00,42,23,19,FMN GV 16 Berchem TOT
54,Posthofbrug 5366,2019-05-04,01:00:00,21,7,14,FMN GV 16 Berchem TOT
54,Posthofbrug 5366,2019-05-04,02:00:00,13,3,10,FMN GV 16 Berchem TOT
54,Posthofbrug 5366,2019-05-04,03:00:00,4,1,3,FMN GV 16 Berchem TOT
54,Posthofbrug 5366,2019-05-04,04:00:00,11,4,7,FMN GV 16 Berchem TOT
54,Posthofbrug 5366,2019-05-04,05:00:00,13,7,6,FMN GV 16 Berchem TOT
54,Posthofbrug 5366,2019-05-04,06:00:00,16,9,7,FMN GV 16 Berchem TOT
54,Posthofbrug 5366,2019-05-04,07:00:00,24,9,15,FMN GV 16 Berchem TOT
54,Posthofbrug 5366,2019-05-04,08:00:00,45,29,16,FMN GV 16 Berchem TOT
54,Posthofbrug 5366,2019-05-04,09:00:00,77,46,31,FMN GV 16 Berchem TOT
54,Posthofbrug 5366,2019-05-04,10:00:00,74,49,25,FMN GV 16 Berchem TOT
54,Posthofbrug 5366,2019-05-04,11:00:00,66,42,24,FMN GV 16 Berchem TOT
54,Posthofbrug 5366,2019-05-04,12:00:00,81,62,19,FMN GV 16 Berchem TOT
54,Posthofbrug 5366,2019-05-04,13:00:00,81,48,33,FMN GV 16 Berchem TOT
54,Posthofbrug 5366,2019-05-04,14:00:00,58,36,22,FMN GV 16 Berchem TOT
54,Posthofbrug 5366,2019-05-04,15:00:00,66,38,28,FMN GV 16 Berchem TOT
54,Posthofbrug 5366,2019-05-04,16:00:00,60,30,30,FMN GV 16 Berchem TOT
54,Posthofbrug 5366,2019-05-04,17:00:00,80,39,41,FMN GV 16 Berchem TOT
54,Posthofbrug 5366,2019-05-04,18:00:00,64,35,29,FMN GV 16 Berchem TOT
54,Posthofbrug 5366,2019-05-04,19:00:00,66,40,26,FMN GV 16 Berchem TOT
54,Posthofbrug 5366,2019-05-04,20:00:00,40,24,16,FMN GV 16 Berchem TOT
54,Posthofbrug 5366,2019-05-04,21:00:00,34,18,16,FMN GV 16 Berchem TOT
54,Posthofbrug 5366,2019-05-04,22:00:00,45,17,28,FMN GV 16 Berchem TOT
54,Posthofbrug 5366,2019-05-04,23:00:00,25,10,15,FMN GV 16 Berchem TOT
54,Posthofbrug 5366,2019-05-05,00:00:00,25,14,11,FMN GV 16 Berchem TOT
54,Posthofbrug 5366,2019-05-05,01:00:00,11,7,4,FMN GV 16 Berchem TOT
54,Posthofbrug 5366,2019-05-05,02:00:00,12,6,6,FMN GV 16 Berchem TOT
54,Posthofbrug 5366,2019-05-05,03:00:00,5,2,3,FMN GV 16 Berchem TOT
54,Posthofbrug 5366,2019-05-05,04:00:00,10,5,5,FMN GV 16 Berchem TOT
54,Posthofbrug 5366,2019-05-05,05:00:00,10,7,3,FMN GV 16 Berchem TOT
54,Posthofbrug 5366,2019-05-05,06:00:00,11,9,2,FMN GV 16 Berchem TOT
54,Posthofbrug 5366,2019-05-05,07:00:00,20,12,8,FMN GV 16 Berchem TOT
54,Posthofbrug 5366,2019-05-05,08:00:00,26,17,9,FMN GV 16 Berchem TOT
54,Posthofbrug 5366,2019-05-05,09:00:00,63,36,27,FMN GV 16 Berchem TOT
54,Posthofbrug 5366,2019-05-05,10:00:00,36,25,11,FMN GV 16 Berchem TOT
54,Posthofbrug 5366,2019-05-05,11:00:00,60,29,31,FMN GV 16 Berchem TOT
54,Posthofbrug 5366,2019-05-05,12:00:00,65,46,19,FMN GV 16 Berchem TOT
54,Posthofbrug 5366,2019-05-05,13:00:00,75,55,20,FMN GV 16 Berchem TOT
54,Posthofbrug 5366,2019-05-05,14:00:00,76,41,35,FMN GV 16 Berchem TOT
54,Posthofbrug 5366,2019-05-05,15:00:00,65,36,29,FMN GV 16 Berchem TOT
54,Posthofbrug 5366,2019-05-05,16:00:00,65,40,25,FMN GV 16 Berchem TOT
54,Posthofbrug 5366,2019-05-05,17:00:00,90,45,45,FMN GV 16 Berchem TOT
54,Posthofbrug 5366,2019-05-05,18:00:00,85,46,39,FMN GV 16 Berchem TOT
54,Posthofbrug 5366,2019-05-05,19:00:00,54,32,22,FMN GV 16 Berchem TOT
54,Posthofbrug 5366,2019-05-05,20:00:00,61,42,19,FMN GV 16 Berchem TOT
54,Posthofbrug 5366,2019-05-05,21:00:00,30,17,13,FMN GV 16 Berchem TOT
54,Posthofbrug 5366,2019-05-05,22:00:00,42,25,17,FMN GV 16 Berchem TOT
54,Posthofbrug 5366,2019-05-05,23:00:00,14,3,11,FMN GV 16 Berchem TOT
54,Posthofbrug 5366,2019-05-06,00:00:00,6,4,2,FMN GV 16 Berchem TOT
54,Posthofbrug 5366,2019-05-06,01:00:00,2,1,1,FMN GV 16 Berchem TOT
54,Posthofbrug 5366,2019-05-06,02:00:00,2,1,1,FMN GV 16 Berchem TOT
54,Posthofbrug 5366,2019-05-06,03:00:00,1,1,0,FMN GV 16 Berchem TOT
54,Posthofbrug 5366,2019-05-06,04:00:00,7,4,3,FMN GV 16 Berchem TOT
54,Posthofbrug 5366,2019-05-06,05:00:00,25,18,7,FMN GV 16 Berchem TOT
54,Posthofbrug 5366,2019-05-06,06:00:00,105,87,18,FMN GV 16 Berchem TOT
54,Posthofbrug 5366,2019-05-06,07:00:00,415,304,111,FMN GV 16 Berchem TOT
54,Posthofbrug 5366,2019-05-06,08:00:00,685,458,227,FMN GV 16 Berchem TOT
54,Posthofbrug 5366,2019-05-06,09:00:00,215,152,63,FMN GV 16 Berchem TOT
54,Posthofbrug 5366,2019-05-06,10:00:00,94,59,35,FMN GV 16 Berchem TOT
54,Posthofbrug 5366,2019-05-06,11:00:00,97,65,32,FMN GV 16 Berchem TOT
54,Posthofbrug 5366,2019-05-06,12:00:00,126,66,60,FMN GV 16 Berchem TOT
54,Posthofbrug 5366,2019-05-06,13:00:00,99,48,51,FMN GV 16 Berchem TOT
54,Posthofbrug 5366,2019-05-06,14:00:00,80,29,51,FMN GV 16 Berchem TOT
54,Posthofbrug 5366,2019-05-06,15:00:00,163,48,115,FMN GV 16 Berchem TOT
54,Posthofbrug 5366,2019-05-06,16:00:00,384,125,259,FMN GV 16 Berchem TOT
54,Posthofbrug 5366,2019-05-06,17:00:00,537,161,376,FMN GV 16 Berchem TOT
54,Posthofbrug 5366,2019-05-06,18:00:00,346,111,235,FMN GV 16 Berchem TOT
54,Posthofbrug 5366,2019-05-06,19:00:00,145,53,92,FMN GV 16 Berchem TOT
54,Posthofbrug 5366,2019-05-06,20:00:00,71,32,39,FMN GV 16 Berchem TOT
54,Posthofbrug 5366,2019-05-06,21:00:00,61,24,37,FMN GV 16 Berchem TOT
54,Posthofbrug 5366,2019-05-06,22:00:00,59,17,42,FMN GV 16 Berchem TOT
54,Posthofbrug 5366,2019-05-06,23:00:00,27,6,21,FMN GV 16 Berchem TOT
54,Posthofbrug 5366,2019-05-07,00:00:00,19,2,17,FMN GV 16 Berchem TOT
54,Posthofbrug 5366,2019-05-07,01:00:00,4,2,2,FMN GV 16 Berchem TOT
54,Posthofbrug 5366,2019-05-07,02:00:00,1,0,1,FMN GV 16 Berchem TOT
54,Posthofbrug 5366,2019-05-07,03:00:00,0,0,0,FMN GV 16 Berchem TOT
54,Posthofbrug 5366,2019-05-07,04:00:00,10,7,3,FMN GV 16 Berchem TOT
54,Posthofbrug 5366,2019-05-07,05:00:00,27,20,7,FMN GV 16 Berchem TOT
54,Posthofbrug 5366,2019-05-07,06:00:00,126,94,32,FMN GV 16 Berchem TOT
54,Posthofbrug 5366,2019-05-07,07:00:00,428,312,116,FMN GV 16 Berchem TOT
54,Posthofbrug 5366,2019-05-07,08:00:00,740,487,253,FMN GV 16 Berchem TOT
54,Posthofbrug 5366,2019-05-07,09:00:00,225,158,67,FMN GV 16 Berchem TOT
54,Posthofbrug 5366,2019-05-07,10:00:00,99,63,36,FMN GV 16 Berchem TOT
54,Posthofbrug 5366,2019-05-07,11:00:00,87,53,34,FMN GV 16 Berchem TOT
54,Posthofbrug 5366,2019-05-07,12:00:00,138,78,60,FMN GV 16 Berchem TOT
54,Posthofbrug 5366,2019-05-07,13:00:00,140,65,75,FMN GV 16 Berchem TOT
54,Posthofbrug 5366,2019-05-07,14:00:00,101,47,54,FMN GV 16 Berchem TOT
54,Posthofbrug 5366,2019-05-07,15:00:00,202,79,123,FMN GV 16 Berchem TOT
54,Posthofbrug 5366,2019-05-07,16:00:00,425,140,285,FMN GV 16 Berchem TOT
54,Posthofbrug 5366,2019-05-07,17:00:00,570,197,373,FMN GV 16 Berchem TOT
54,Posthofbrug 5366,2019-05-07,18:00:00,373,109,264,FMN GV 16 Berchem TOT
54,Posthofbrug 5366,2019-05-07,19:00:00,163,59,104,FMN GV 16 Berchem TOT
54,Posthofbrug 5366,2019-05-07,20:00:00,103,53,50,FMN GV 16 Berchem TOT
54,Posthofbrug 5366,2019-05-07,21:00:00,80,35,45,FMN GV 16 Berchem TOT
54,Posthofbrug 5366,2019-05-07,22:00:00,52,19,33,FMN GV 16 Berchem TOT
54,Posthofbrug 5366,2019-05-07,23:00:00,42,15,27,FMN GV 16 Berchem TOT
54,Posthofbrug 5366,2019-05-08,00:00:00,17,4,13,FMN GV 16 Berchem TOT
54,Posthofbrug 5366,2019-05-08,01:00:00,7,2,5,FMN GV 16 Berchem TOT
54,Posthofbrug 5366,2019-05-08,02:00:00,1,1,0,FMN GV 16 Berchem TOT
54,Posthofbrug 5366,2019-05-08,03:00:00,6,5,1,FMN GV 16 Berchem TOT
54,Posthofbrug 5366,2019-05-08,04:00:00,5,3,2,FMN GV 16 Berchem TOT
54,Posthofbrug 5366,2019-05-08,05:00:00,27,21,6,FMN GV 16 Berchem TOT
54,Posthofbrug 5366,2019-05-08,06:00:00,80,62,18,FMN GV 16 Berchem TOT
54,Posthofbrug 5366,2019-05-08,07:00:00,307,208,99,FMN GV 16 Berchem TOT
54,Posthofbrug 5366,2019-05-08,08:00:00,573,353,220,FMN GV 16 Berchem TOT
54,Posthofbrug 5366,2019-05-08,09:00:00,151,92,59,FMN GV 16 Berchem TOT
54,Posthofbrug 5366,2019-05-08,10:00:00,71,44,27,FMN GV 16 Berchem TOT
54,Posthofbrug 5366,2019-05-08,11:00:00,74,35,39,FMN GV 16 Berchem TOT
54,Posthofbrug 5366,2019-05-08,12:00:00,164,71,93,FMN GV 16 Berchem TOT
54,Posthofbrug 5366,2019-05-08,13:00:00,102,47,55,FMN GV 16 Berchem TOT
54,Posthofbrug 5366,2019-05-08,14:00:00,83,37,46,FMN GV 16 Berchem TOT
54,Posthofbrug 5366,2019-05-08,15:00:00,117,46,71,FMN GV 16 Berchem TOT
54,Posthofbrug 5366,2019-05-08,16:00:00,262,119,143,FMN GV 16 Berchem TOT
54,Posthofbrug 5366,2019-05-08,17:00:00,413,167,246,FMN GV 16 Berchem TOT
54,Posthofbrug 5366,2019-05-08,18:00:00,270,93,177,FMN GV 16 Berchem TOT
54,Posthofbrug 5366,2019-05-08,19:00:00,137,66,71,FMN GV 16 Berchem TOT
54,Posthofbrug 5366,2019-05-08,20:00:00,65,36,29,FMN GV 16 Berchem TOT
54,Posthofbrug 5366,2019-05-08,21:00:00,66,21,45,FMN GV 16 Berchem TOT
54,Posthofbrug 5366,2019-05-08,22:00:00,71,18,53,FMN GV 16 Berchem TOT
54,Posthofbrug 5366,2019-05-08,23:00:00,33,9,24,FMN GV 16 Berchem TOT
54,Posthofbrug 5366,2019-05-09,00:00:00,12,4,8,FMN GV 16 Berchem TOT
54,Posthofbrug 5366,2019-05-09,01:00:00,3,0,3,FMN GV 16 Berchem TOT
54,Posthofbrug 5366,2019-05-09,02:00:00,3,0,3,FMN GV 16 Berchem TOT
54,Posthofbrug 5366,2019-05-09,03:00:00,3,3,0,FMN GV 16 Berchem TOT
54,Posthofbrug 5366,2019-05-09,04:00:00,4,2,2,FMN GV 16 Berchem TOT
54,Posthofbrug 5366,2019-05-09,05:00:00,22,14,8,FMN GV 16 Berchem TOT
54,Posthofbrug 5366,2019-05-09,06:00:00,96,69,27,FMN GV 16 Berchem TOT
54,Posthofbrug 5366,2019-05-09,07:00:00,361,265,96,FMN GV 16 Berchem TOT
54,Posthofbrug 5366,2019-05-09,08:00:00,666,441,225,FMN GV 16 Berchem TOT
54,Posthofbrug 5366,2019-05-09,09:00:00,193,132,61,FMN GV 16 Berchem TOT
54,Posthofbrug 5366,2019-05-09,10:00:00,90,54,36,FMN GV 16 Berchem TOT
54,Posthofbrug 5366,2019-05-09,11:00:00,75,43,32,FMN GV 16 Berchem TOT
54,Posthofbrug 5366,2019-05-09,12:00:00,128,70,58,FMN GV 16 Berchem TOT
54,Posthofbrug 5366,2019-05-09,13:00:00,126,62,64,FMN GV 16 Berchem TOT
54,Posthofbrug 5366,2019-05-09,14:00:00,91,42,49,FMN GV 16 Berchem TOT
54,Posthofbrug 5366,2019-05-09,15:00:00,210,88,122,FMN GV 16 Berchem TOT
54,Posthofbrug 5366,2019-05-09,16:00:00,323,117,206,FMN GV 16 Berchem TOT
54,Posthofbrug 5366,2019-05-09,17:00:00,490,190,300,FMN GV 16 Berchem TOT
54,Posthofbrug 5366,2019-05-09,18:00:00,325,95,230,FMN GV 16 Berchem TOT
54,Posthofbrug 5366,2019-05-09,19:00:00,134,47,87,FMN GV 16 Berchem TOT
54,Posthofbrug 5366,2019-05-09,20:00:00,95,41,54,FMN GV 16 Berchem TOT
54,Posthofbrug 5366,2019-05-09,21:00:00,50,20,30,FMN GV 16 Berchem TOT
54,Posthofbrug 5366,2019-05-09,22:00:00,48,26,22,FMN GV 16 Berchem TOT
54,Posthofbrug 5366,2019-05-09,23:00:00,32,7,25,FMN GV 16 Berchem TOT
54,Posthofbrug 5366,2019-05-10,00:00:00,15,1,14,FMN GV 16 Berchem TOT
54,Posthofbrug 5366,2019-05-10,01:00:00,6,1,5,FMN GV 16 Berchem TOT
54,Posthofbrug 5366,2019-05-10,02:00:00,2,0,2,FMN GV 16 Berchem TOT
54,Posthofbrug 5366,2019-05-10,03:00:00,2,1,1,FMN GV 16 Berchem TOT
54,Posthofbrug 5366,2019-05-10,04:00:00,9,4,5,FMN GV 16 Berchem TOT
54,Posthofbrug 5366,2019-05-10,05:00:00,18,12,6,FMN GV 16 Berchem TOT
54,Posthofbrug 5366,2019-05-10,06:00:00,81,65,16,FMN GV 16 Berchem TOT
54,Posthofbrug 5366,2019-05-10,07:00:00,279,211,68,FMN GV 16 Berchem TOT
54,Posthofbrug 5366,2019-05-10,08:00:00,449,295,154,FMN GV 16 Berchem TOT
54,Posthofbrug 5366,2019-05-10,09:00:00,185,126,59,FMN GV 16 Berchem TOT
54,Posthofbrug 5366,2019-05-10,10:00:00,75,47,28,FMN GV 16 Berchem TOT
54,Posthofbrug 5366,2019-05-10,11:00:00,63,39,24,FMN GV 16 Berchem TOT
54,Posthofbrug 5366,2019-05-10,12:00:00,135,78,57,FMN GV 16 Berchem TOT
54,Posthofbrug 5366,2019-05-10,13:00:00,91,43,48,FMN GV 16 Berchem TOT
54,Posthofbrug 5366,2019-05-10,14:00:00,103,42,61,FMN GV 16 Berchem TOT
54,Posthofbrug 5366,2019-05-10,15:00:00,195,72,123,FMN GV 16 Berchem TOT
54,Posthofbrug 5366,2019-05-10,16:00:00,308,118,190,FMN GV 16 Berchem TOT
54,Posthofbrug 5366,2019-05-10,17:00:00,373,139,234,FMN GV 16 Berchem TOT
54,Posthofbrug 5366,2019-05-10,18:00:00,216,72,144,FMN GV 16 Berchem TOT
54,Posthofbrug 5366,2019-05-10,19:00:00,116,63,53,FMN GV 16 Berchem TOT
54,Posthofbrug 5366,2019-05-10,20:00:00,96,45,51,FMN GV 16 Berchem TOT
54,Posthofbrug 5366,2019-05-10,21:00:00,54,35,19,FMN GV 16 Berchem TOT
54,Posthofbrug 5366,2019-05-10,22:00:00,53,24,29,FMN GV 16 Berchem TOT
54,Posthofbrug 5366,2019-05-10,23:00:00,39,13,26,FMN GV 16 Berchem TOT
54,Posthofbrug 5366,2019-05-11,00:00:00,51,20,31,FMN GV 16 Berchem TOT
54,Posthofbrug 5366,2019-05-11,01:00:00,22,6,16,FMN GV 16 Berchem TOT
54,Posthofbrug 5366,2019-05-11,02:00:00,17,2,15,FMN GV 16 Berchem TOT
54,Posthofbrug 5366,2019-05-11,03:00:00,6,3,3,FMN GV 16 Berchem TOT
54,Posthofbrug 5366,2019-05-11,04:00:00,15,3,12,FMN GV 16 Berchem TOT
54,Posthofbrug 5366,2019-05-11,05:00:00,5,2,3,FMN GV 16 Berchem TOT
54,Posthofbrug 5366,2019-05-11,06:00:00,13,9,4,FMN GV 16 Berchem TOT
54,Posthofbrug 5366,2019-05-11,07:00:00,21,11,10,FMN GV 16 Berchem TOT
54,Posthofbrug 5366,2019-05-11,08:00:00,42,22,20,FMN GV 16 Berchem TOT
54,Posthofbrug 5366,2019-05-11,09:00:00,98,57,41,FMN GV 16 Berchem TOT
54,Posthofbrug 5366,2019-05-11,10:00:00,95,58,37,FMN GV 16 Berchem TOT
54,Posthofbrug 5366,2019-05-11,11:00:00,115,74,41,FMN GV 16 Berchem TOT
54,Posthofbrug 5366,2019-05-11,12:00:00,112,66,46,FMN GV 16 Berchem TOT
54,Posthofbrug 5366,2019-05-11,13:00:00,97,60,37,FMN GV 16 Berchem TOT
54,Posthofbrug 5366,2019-05-11,14:00:00,156,93,63,FMN GV 16 Berchem TOT
54,Posthofbrug 5366,2019-05-11,15:00:00,143,83,60,FMN GV 16 Berchem TOT
54,Posthofbrug 5366,2019-05-11,16:00:00,112,50,62,FMN GV 16 Berchem TOT
54,Posthofbrug 5366,2019-05-11,17:00:00,145,67,78,FMN GV 16 Berchem TOT
54,Posthofbrug 5366,2019-05-11,18:00:00,107,49,58,FMN GV 16 Berchem TOT
54,Posthofbrug 5366,2019-05-11,19:00:00,74,35,39,FMN GV 16 Berchem TOT
54,Posthofbrug 5366,2019-05-11,20:00:00,47,24,23,FMN GV 16 Berchem TOT
54,Posthofbrug 5366,2019-05-11,21:00:00,46,20,26,FMN GV 16 Berchem TOT
54,Posthofbrug 5366,2019-05-11,22:00:00,47,20,27,FMN GV 16 Berchem TOT
54,Posthofbrug 5366,2019-05-11,23:00:00,34,13,21,FMN GV 16 Berchem TOT
54,Posthofbrug 5366,2019-05-12,00:00:00,25,7,18,FMN GV 16 Berchem TOT
54,Posthofbrug 5366,2019-05-12,01:00:00,19,5,14,FMN GV 16 Berchem TOT
54,Posthofbrug 5366,2019-05-12,02:00:00,8,3,5,FMN GV 16 Berchem TOT
54,Posthofbrug 5366,2019-05-12,03:00:00,14,2,12,FMN GV 16 Berchem TOT
54,Posthofbrug 5366,2019-05-12,04:00:00,17,4,13,FMN GV 16 Berchem TOT
54,Posthofbrug 5366,2019-05-12,05:00:00,6,1,5,FMN GV 16 Berchem TOT
54,Posthofbrug 5366,2019-05-12,06:00:00,13,7,6,FMN GV 16 Berchem TOT
54,Posthofbrug 5366,2019-05-12,07:00:00,22,12,10,FMN GV 16 Berchem TOT
54,Posthofbrug 5366,2019-05-12,08:00:00,31,17,14,FMN GV 16 Berchem TOT
54,Posthofbrug 5366,2019-05-12,09:00:00,85,55,30,FMN GV 16 Berchem TOT
54,Posthofbrug 5366,2019-05-12,10:00:00,79,48,31,FMN GV 16 Berchem TOT
54,Posthofbrug 5366,2019-05-12,11:00:00,90,51,39,FMN GV 16 Berchem TOT
54,Posthofbrug 5366,2019-05-12,12:00:00,158,73,85,FMN GV 16 Berchem TOT
54,Posthofbrug 5366,2019-05-12,13:00:00,296,236,60,FMN GV 16 Berchem TOT
54,Posthofbrug 5366,2019-05-12,14:00:00,146,92,54,FMN GV 16 Berchem TOT
54,Posthofbrug 5366,2019-05-12,15:00:00,116,59,57,FMN GV 16 Berchem TOT
54,Posthofbrug 5366,2019-05-12,16:00:00,207,56,151,FMN GV 16 Berchem TOT
54,Posthofbrug 5366,2019-05-12,17:00:00,175,51,124,FMN GV 16 Berchem TOT
54,Posthofbrug 5366,2019-05-12,18:00:00,156,66,90,FMN GV 16 Berchem TOT
54,Posthofbrug 5366,2019-05-12,19:00:00,69,30,39,FMN GV 16 Berchem TOT
54,Posthofbrug 5366,2019-05-12,20:00:00,62,39,23,FMN GV 16 Berchem TOT
54,Posthofbrug 5366,2019-05-12,21:00:00,37,23,14,FMN GV 16 Berchem TOT
54,Posthofbrug 5366,2019-05-12,22:00:00,29,13,16,FMN GV 16 Berchem TOT
54,Posthofbrug 5366,2019-05-12,23:00:00,17,5,12,FMN GV 16 Berchem TOT
54,Posthofbrug 5366,2019-05-13,00:00:00,10,5,5,FMN GV 16 Berchem TOT
54,Posthofbrug 5366,2019-05-13,01:00:00,1,1,0,FMN GV 16 Berchem TOT
54,Posthofbrug 5366,2019-05-13,02:00:00,1,0,1,FMN GV 16 Berchem TOT
54,Posthofbrug 5366,2019-05-13,03:00:00,6,4,2,FMN GV 16 Berchem TOT
54,Posthofbrug 5366,2019-05-13,04:00:00,7,6,1,FMN GV 16 Berchem TOT
54,Posthofbrug 5366,2019-05-13,05:00:00,21,9,12,FMN GV 16 Berchem TOT
54,Posthofbrug 5366,2019-05-13,06:00:00,102,79,23,FMN GV 16 Berchem TOT
54,Posthofbrug 5366,2019-05-13,07:00:00,411,317,94,FMN GV 16 Berchem TOT
54,Posthofbrug 5366,2019-05-13,08:00:00,757,509,248,FMN GV 16 Berchem TOT
54,Posthofbrug 5366,2019-05-13,09:00:00,264,176,88,FMN GV 16 Berchem TOT
54,Posthofbrug 5366,2019-05-13,10:00:00,122,76,46,FMN GV 16 Berchem TOT
54,Posthofbrug 5366,2019-05-13,11:00:00,99,69,30,FMN GV 16 Berchem TOT
54,Posthofbrug 5366,2019-05-13,12:00:00,165,100,65,FMN GV 16 Berchem TOT
54,Posthofbrug 5366,2019-05-13,13:00:00,155,87,68,FMN GV 16 Berchem TOT
54,Posthofbrug 5366,2019-05-13,14:00:00,133,59,74,FMN GV 16 Berchem TOT
54,Posthofbrug 5366,2019-05-13,15:00:00,230,80,150,FMN GV 16 Berchem TOT
54,Posthofbrug 5366,2019-05-13,16:00:00,499,169,330,FMN GV 16 Berchem TOT
54,Posthofbrug 5366,2019-05-13,17:00:00,581,186,395,FMN GV 16 Berchem TOT
54,Posthofbrug 5366,2019-05-13,18:00:00,366,129,237,FMN GV 16 Berchem TOT
54,Posthofbrug 5366,2019-05-13,19:00:00,161,64,97,FMN GV 16 Berchem TOT
54,Posthofbrug 5366,2019-05-13,20:00:00,97,53,44,FMN GV 16 Berchem TOT
54,Posthofbrug 5366,2019-05-13,21:00:00,80,36,44,FMN GV 16 Berchem TOT
54,Posthofbrug 5366,2019-05-13,22:00:00,61,14,47,FMN GV 16 Berchem TOT
54,Posthofbrug 5366,2019-05-13,23:00:00,31,5,26,FMN GV 16 Berchem TOT
54,Posthofbrug 5366,2019-05-14,00:00:00,17,5,12,FMN GV 16 Berchem TOT
54,Posthofbrug 5366,2019-05-14,01:00:00,9,0,9,FMN GV 16 Berchem TOT
54,Posthofbrug 5366,2019-05-14,02:00:00,2,0,2,FMN GV 16 Berchem TOT
54,Posthofbrug 5366,2019-05-14,03:00:00,3,2,1,FMN GV 16 Berchem TOT
54,Posthofbrug 5366,2019-05-14,04:00:00,6,4,2,FMN GV 16 Berchem TOT
54,Posthofbrug 5366,2019-05-14,05:00:00,21,16,5,FMN GV 16 Berchem TOT
54,Posthofbrug 5366,2019-05-14,06:00:00,141,112,29,FMN GV 16 Berchem TOT
54,Posthofbrug 5366,2019-05-14,07:00:00,454,330,124,FMN GV 16 Berchem TOT
54,Posthofbrug 5366,2019-05-14,08:00:00,805,543,262,FMN GV 16 Berchem TOT
54,Posthofbrug 5366,2019-05-14,09:00:00,324,208,116,FMN GV 16 Berchem TOT
54,Posthofbrug 5366,2019-05-14,10:00:00,155,105,50,FMN GV 16 Berchem TOT
54,Posthofbrug 5366,2019-05-14,11:00:00,112,69,43,FMN GV 16 Berchem TOT
54,Posthofbrug 5366,2019-05-14,12:00:00,177,105,72,FMN GV 16 Berchem TOT
54,Posthofbrug 5366,2019-05-14,13:00:00,180,86,94,FMN GV 16 Berchem TOT
54,Posthofbrug 5366,2019-05-14,14:00:00,127,51,76,FMN GV 16 Berchem TOT
54,Posthofbrug 5366,2019-05-14,15:00:00,240,94,146,FMN GV 16 Berchem TOT
54,Posthofbrug 5366,2019-05-14,16:00:00,469,161,308,FMN GV 16 Berchem TOT
54,Posthofbrug 5366,2019-05-14,17:00:00,605,204,401,FMN GV 16 Berchem TOT
54,Posthofbrug 5366,2019-05-14,18:00:00,417,128,289,FMN GV 16 Berchem TOT
54,Posthofbrug 5366,2019-05-14,19:00:00,181,70,111,FMN GV 16 Berchem TOT
54,Posthofbrug 5366,2019-05-14,20:00:00,121,52,69,FMN GV 16 Berchem TOT
54,Posthofbrug 5366,2019-05-14,21:00:00,100,45,55,FMN GV 16 Berchem TOT
54,Posthofbrug 5366,2019-05-14,22:00:00,72,21,51,FMN GV 16 Berchem TOT
54,Posthofbrug 5366,2019-05-14,23:00:00,38,12,26,FMN GV 16 Berchem TOT
54,Posthofbrug 5366,2019-05-15,00:00:00,20,10,10,FMN GV 16 Berchem TOT
54,Posthofbrug 5366,2019-05-15,01:00:00,4,1,3,FMN GV 16 Berchem TOT
54,Posthofbrug 5366,2019-05-15,02:00:00,4,2,2,FMN GV 16 Berchem TOT
54,Posthofbrug 5366,2019-05-15,03:00:00,3,2,1,FMN GV 16 Berchem TOT
54,Posthofbrug 5366,2019-05-15,04:00:00,10,7,3,FMN GV 16 Berchem TOT
54,Posthofbrug 5366,2019-05-15,05:00:00,22,14,8,FMN GV 16 Berchem TOT
54,Posthofbrug 5366,2019-05-15,06:00:00,115,92,23,FMN GV 16 Berchem TOT
54,Posthofbrug 5366,2019-05-15,07:00:00,385,277,108,FMN GV 16 Berchem TOT
54,Posthofbrug 5366,2019-05-15,08:00:00,642,425,217,FMN GV 16 Berchem TOT
54,Posthofbrug 5366,2019-05-15,09:00:00,205,132,73,FMN GV 16 Berchem TOT
54,Posthofbrug 5366,2019-05-15,10:00:00,114,76,38,FMN GV 16 Berchem TOT
54,Posthofbrug 5366,2019-05-15,11:00:00,122,72,50,FMN GV 16 Berchem TOT
54,Posthofbrug 5366,2019-05-15,12:00:00,230,110,120,FMN GV 16 Berchem TOT
54,Posthofbrug 5366,2019-05-15,13:00:00,190,100,90,FMN GV 16 Berchem TOT
54,Posthofbrug 5366,2019-05-15,14:00:00,180,99,81,FMN GV 16 Berchem TOT
54,Posthofbrug 5366,2019-05-15,15:00:00,182,61,121,FMN GV 16 Berchem TOT
54,Posthofbrug 5366,2019-05-15,16:00:00,374,139,235,FMN GV 16 Berchem TOT
54,Posthofbrug 5366,2019-05-15,17:00:00,573,214,359,FMN GV 16 Berchem TOT
54,Posthofbrug 5366,2019-05-15,18:00:00,369,129,240,FMN GV 16 Berchem TOT
54,Posthofbrug 5366,2019-05-15,19:00:00,198,69,129,FMN GV 16 Berchem TOT
54,Posthofbrug 5366,2019-05-15,20:00:00,90,43,47,FMN GV 16 Berchem TOT
54,Posthofbrug 5366,2019-05-15,21:00:00,87,37,50,FMN GV 16 Berchem TOT
54,Posthofbrug 5366,2019-05-15,22:00:00,75,19,56,FMN GV 16 Berchem TOT
54,Posthofbrug 5366,2019-05-15,23:00:00,45,13,32,FMN GV 16 Berchem TOT
54,Posthofbrug 5366,2019-05-16,00:00:00,21,3,18,FMN GV 16 Berchem TOT
54,Posthofbrug 5366,2019-05-16,01:00:00,6,2,4,FMN GV 16 Berchem TOT
54,Posthofbrug 5366,2019-05-16,02:00:00,3,0,3,FMN GV 16 Berchem TOT
54,Posthofbrug 5366,2019-05-16,03:00:00,2,0,2,FMN GV 16 Berchem TOT
54,Posthofbrug 5366,2019-05-16,04:00:00,11,10,1,FMN GV 16 Berchem TOT
54,Posthofbrug 5366,2019-05-16,05:00:00,20,16,4,FMN GV 16 Berchem TOT
54,Posthofbrug 5366,2019-05-16,06:00:00,114,85,29,FMN GV 16 Berchem TOT
54,Posthofbrug 5366,2019-05-16,07:00:00,373,277,96,FMN GV 16 Berchem TOT
54,Posthofbrug 5366,2019-05-16,08:00:00,704,456,248,FMN GV 16 Berchem TOT
54,Posthofbrug 5366,2019-05-16,09:00:00,231,159,72,FMN GV 16 Berchem TOT
54,Posthofbrug 5366,2019-05-16,10:00:00,131,85,46,FMN GV 16 Berchem TOT
54,Posthofbrug 5366,2019-05-16,11:00:00,126,85,41,FMN GV 16 Berchem TOT
54,Posthofbrug 5366,2019-05-16,12:00:00,159,84,75,FMN GV 16 Berchem TOT
54,Posthofbrug 5366,2019-05-16,13:00:00,158,78,80,FMN GV 16 Berchem TOT
54,Posthofbrug 5366,2019-05-16,14:00:00,144,62,82,FMN GV 16 Berchem TOT
54,Posthofbrug 5366,2019-05-16,15:00:00,242,87,155,FMN GV 16 Berchem TOT
54,Posthofbrug 5366,2019-05-16,16:00:00,441,154,287,FMN GV 16 Berchem TOT
54,Posthofbrug 5366,2019-05-16,17:00:00,560,198,362,FMN GV 16 Berchem TOT
54,Posthofbrug 5366,2019-05-16,18:00:00,359,110,249,FMN GV 16 Berchem TOT
54,Posthofbrug 5366,2019-05-16,19:00:00,176,73,103,FMN GV 16 Berchem TOT
54,Posthofbrug 5366,2019-05-16,20:00:00,107,47,60,FMN GV 16 Berchem TOT
54,Posthofbrug 5366,2019-05-16,21:00:00,82,29,53,FMN GV 16 Berchem TOT
54,Posthofbrug 5366,2019-05-16,22:00:00,86,32,54,FMN GV 16 Berchem TOT
54,Posthofbrug 5366,2019-05-16,23:00:00,43,9,34,FMN GV 16 Berchem TOT
54,Posthofbrug 5366,2019-05-17,00:00:00,27,3,24,FMN GV 16 Berchem TOT
54,Posthofbrug 5366,2019-05-17,01:00:00,6,0,6,FMN GV 16 Berchem TOT
54,Posthofbrug 5366,2019-05-17,02:00:00,6,3,3,FMN GV 16 Berchem TOT
54,Posthofbrug 5366,2019-05-17,03:00:00,6,4,2,FMN GV 16 Berchem TOT
54,Posthofbrug 5366,2019-05-17,04:00:00,10,7,3,FMN GV 16 Berchem TOT
54,Posthofbrug 5366,2019-05-17,05:00:00,17,10,7,FMN GV 16 Berchem TOT
54,Posthofbrug 5366,2019-05-17,06:00:00,84,72,12,FMN GV 16 Berchem TOT
54,Posthofbrug 5366,2019-05-17,07:00:00,298,218,80,FMN GV 16 Berchem TOT
54,Posthofbrug 5366,2019-05-17,08:00:00,553,371,182,FMN GV 16 Berchem TOT
54,Posthofbrug 5366,2019-05-17,09:00:00,188,123,65,FMN GV 16 Berchem TOT
54,Posthofbrug 5366,2019-05-17,10:00:00,120,81,39,FMN GV 16 Berchem TOT
54,Posthofbrug 5366,2019-05-17,11:00:00,110,65,45,FMN GV 16 Berchem TOT
54,Posthofbrug 5366,2019-05-17,12:00:00,174,87,87,FMN GV 16 Berchem TOT
54,Posthofbrug 5366,2019-05-17,13:00:00,122,58,64,FMN GV 16 Berchem TOT
54,Posthofbrug 5366,2019-05-17,14:00:00,148,65,83,FMN GV 16 Berchem TOT
54,Posthofbrug 5366,2019-05-17,15:00:00,215,72,143,FMN GV 16 Berchem TOT
54,Posthofbrug 5366,2019-05-17,16:00:00,397,145,252,FMN GV 16 Berchem TOT
54,Posthofbrug 5366,2019-05-17,17:00:00,415,151,264,FMN GV 16 Berchem TOT
54,Posthofbrug 5366,2019-05-17,18:00:00,236,82,154,FMN GV 16 Berchem TOT
54,Posthofbrug 5366,2019-05-17,19:00:00,174,79,95,FMN GV 16 Berchem TOT
54,Posthofbrug 5366,2019-05-17,20:00:00,48,20,28,FMN GV 16 Berchem TOT
54,Posthofbrug 5366,2019-05-17,21:00:00,62,35,27,FMN GV 16 Berchem TOT
54,Posthofbrug 5366,2019-05-17,22:00:00,61,27,34,FMN GV 16 Berchem TOT
54,Posthofbrug 5366,2019-05-17,23:00:00,52,12,40,FMN GV 16 Berchem TOT
54,Posthofbrug 5366,2019-05-18,00:00:00,46,19,27,FMN GV 16 Berchem TOT
54,Posthofbrug 5366,2019-05-18,01:00:00,25,6,19,FMN GV 16 Berchem TOT
54,Posthofbrug 5366,2019-05-18,02:00:00,12,2,10,FMN GV 16 Berchem TOT
54,Posthofbrug 5366,2019-05-18,03:00:00,9,1,8,FMN GV 16 Berchem TOT
54,Posthofbrug 5366,2019-05-18,04:00:00,12,5,7,FMN GV 16 Berchem TOT
54,Posthofbrug 5366,2019-05-18,05:00:00,10,4,6,FMN GV 16 Berchem TOT
54,Posthofbrug 5366,2019-05-18,06:00:00,15,8,7,FMN GV 16 Berchem TOT
54,Posthofbrug 5366,2019-05-18,07:00:00,24,14,10,FMN GV 16 Berchem TOT
54,Posthofbrug 5366,2019-05-18,08:00:00,52,39,13,FMN GV 16 Berchem TOT
54,Posthofbrug 5366,2019-05-18,09:00:00,103,64,39,FMN GV 16 Berchem TOT
54,Posthofbrug 5366,2019-05-18,10:00:00,118,73,45,FMN GV 16 Berchem TOT
54,Posthofbrug 5366,2019-05-18,11:00:00,105,58,47,FMN GV 16 Berchem TOT
54,Posthofbrug 5366,2019-05-18,12:00:00,130,78,52,FMN GV 16 Berchem TOT
54,Posthofbrug 5366,2019-05-18,13:00:00,155,102,53,FMN GV 16 Berchem TOT
54,Posthofbrug 5366,2019-05-18,14:00:00,167,91,76,FMN GV 16 Berchem TOT
54,Posthofbrug 5366,2019-05-18,15:00:00,130,63,67,FMN GV 16 Berchem TOT
54,Posthofbrug 5366,2019-05-18,16:00:00,156,75,81,FMN GV 16 Berchem TOT
54,Posthofbrug 5366,2019-05-18,17:00:00,166,72,94,FMN GV 16 Berchem TOT
54,Posthofbrug 5366,2019-05-18,18:00:00,132,71,61,FMN GV 16 Berchem TOT
54,Posthofbrug 5366,2019-05-18,19:00:00,109,44,65,FMN GV 16 Berchem TOT
54,Posthofbrug 5366,2019-05-18,20:00:00,87,41,46,FMN GV 16 Berchem TOT
54,Posthofbrug 5366,2019-05-18,21:00:00,60,30,30,FMN GV 16 Berchem TOT
54,Posthofbrug 5366,2019-05-18,22:00:00,53,15,38,FMN GV 16 Berchem TOT
54,Posthofbrug 5366,2019-05-18,23:00:00,36,17,19,FMN GV 16 Berchem TOT
54,Posthofbrug 5366,2019-05-19,00:00:00,44,22,22,FMN GV 16 Berchem TOT
54,Posthofbrug 5366,2019-05-19,01:00:00,36,19,17,FMN GV 16 Berchem TOT
54,Posthofbrug 5366,2019-05-19,02:00:00,28,8,20,FMN GV 16 Berchem TOT
54,Posthofbrug 5366,2019-05-19,03:00:00,10,1,9,FMN GV 16 Berchem TOT
54,Posthofbrug 5366,2019-05-19,04:00:00,17,4,13,FMN GV 16 Berchem TOT
54,Posthofbrug 5366,2019-05-19,05:00:00,11,8,3,FMN GV 16 Berchem TOT
54,Posthofbrug 5366,2019-05-19,06:00:00,12,9,3,FMN GV 16 Berchem TOT
54,Posthofbrug 5366,2019-05-19,07:00:00,12,6,6,FMN GV 16 Berchem TOT
54,Posthofbrug 5366,2019-05-19,08:00:00,31,21,10,FMN GV 16 Berchem TOT
54,Posthofbrug 5366,2019-05-19,09:00:00,49,27,22,FMN GV 16 Berchem TOT
54,Posthofbrug 5366,2019-05-19,10:00:00,84,49,35,FMN GV 16 Berchem TOT
54,Posthofbrug 5366,2019-05-19,11:00:00,97,49,48,FMN GV 16 Berchem TOT
54,Posthofbrug 5366,2019-05-19,12:00:00,125,79,46,FMN GV 16 Berchem TOT
54,Posthofbrug 5366,2019-05-19,13:00:00,112,57,55,FMN GV 16 Berchem TOT
54,Posthofbrug 5366,2019-05-19,14:00:00,138,75,63,FMN GV 16 Berchem TOT
54,Posthofbrug 5366,2019-05-19,15:00:00,130,58,72,FMN GV 16 Berchem TOT
54,Posthofbrug 5366,2019-05-19,16:00:00,106,51,55,FMN GV 16 Berchem TOT
54,Posthofbrug 5366,2019-05-19,17:00:00,139,59,80,FMN GV 16 Berchem TOT
54,Posthofbrug 5366,2019-05-19,18:00:00,118,38,80,FMN GV 16 Berchem TOT
54,Posthofbrug 5366,2019-05-19,19:00:00,57,27,30,FMN GV 16 Berchem TOT
54,Posthofbrug 5366,2019-05-19,20:00:00,51,31,20,FMN GV 16 Berchem TOT
54,Posthofbrug 5366,2019-05-19,21:00:00,55,21,34,FMN GV 16 Berchem TOT
54,Posthofbrug 5366,2019-05-19,22:00:00,36,14,22,FMN GV 16 Berchem TOT
54,Posthofbrug 5366,2019-05-19,23:00:00,10,4,6,FMN GV 16 Berchem TOT
54,Posthofbrug 5366,2019-05-20,00:00:00,7,2,5,FMN GV 16 Berchem TOT
54,Posthofbrug 5366,2019-05-20,01:00:00,1,0,1,FMN GV 16 Berchem TOT
54,Posthofbrug 5366,2019-05-20,02:00:00,0,0,0,FMN GV 16 Berchem TOT
54,Posthofbrug 5366,2019-05-20,03:00:00,1,1,0,FMN GV 16 Berchem TOT
54,Posthofbrug 5366,2019-05-20,04:00:00,8,6,2,FMN GV 16 Berchem TOT
54,Posthofbrug 5366,2019-05-20,05:00:00,13,6,7,FMN GV 16 Berchem TOT
54,Posthofbrug 5366,2019-05-20,06:00:00,106,94,12,FMN GV 16 Berchem TOT
54,Posthofbrug 5366,2019-05-20,07:00:00,388,271,117,FMN GV 16 Berchem TOT
54,Posthofbrug 5366,2019-05-20,08:00:00,685,434,251,FMN GV 16 Berchem TOT
54,Posthofbrug 5366,2019-05-20,09:00:00,214,143,71,FMN GV 16 Berchem TOT
54,Posthofbrug 5366,2019-05-20,10:00:00,83,62,21,FMN GV 16 Berchem TOT
54,Posthofbrug 5366,2019-05-20,11:00:00,83,46,37,FMN GV 16 Berchem TOT
54,Posthofbrug 5366,2019-05-20,12:00:00,106,58,48,FMN GV 16 Berchem TOT
54,Posthofbrug 5366,2019-05-20,13:00:00,112,66,46,FMN GV 16 Berchem TOT
54,Posthofbrug 5366,2019-05-20,14:00:00,86,44,42,FMN GV 16 Berchem TOT
54,Posthofbrug 5366,2019-05-20,15:00:00,177,67,110,FMN GV 16 Berchem TOT
54,Posthofbrug 5366,2019-05-20,16:00:00,384,128,256,FMN GV 16 Berchem TOT
54,Posthofbrug 5366,2019-05-20,17:00:00,531,182,349,FMN GV 16 Berchem TOT
54,Posthofbrug 5366,2019-05-20,18:00:00,311,101,210,FMN GV 16 Berchem TOT
54,Posthofbrug 5366,2019-05-20,19:00:00,134,54,80,FMN GV 16 Berchem TOT
54,Posthofbrug 5366,2019-05-20,20:00:00,56,21,35,FMN GV 16 Berchem TOT
54,Posthofbrug 5366,2019-05-20,21:00:00,63,25,38,FMN GV 16 Berchem TOT
54,Posthofbrug 5366,2019-05-20,22:00:00,62,18,44,FMN GV 16 Berchem TOT
54,Posthofbrug 5366,2019-05-20,23:00:00,35,11,24,FMN GV 16 Berchem TOT
54,Posthofbrug 5366,2019-05-21,00:00:00,5,1,4,FMN GV 16 Berchem TOT
54,Posthofbrug 5366,2019-05-21,01:00:00,7,2,5,FMN GV 16 Berchem TOT
54,Posthofbrug 5366,2019-05-21,02:00:00,3,0,3,FMN GV 16 Berchem TOT
54,Posthofbrug 5366,2019-05-21,03:00:00,2,2,0,FMN GV 16 Berchem TOT
54,Posthofbrug 5366,2019-05-21,04:00:00,7,4,3,FMN GV 16 Berchem TOT
54,Posthofbrug 5366,2019-05-21,05:00:00,17,9,8,FMN GV 16 Berchem TOT
54,Posthofbrug 5366,2019-05-21,06:00:00,104,84,20,FMN GV 16 Berchem TOT
54,Posthofbrug 5366,2019-05-21,07:00:00,399,299,100,FMN GV 16 Berchem TOT
54,Posthofbrug 5366,2019-05-21,08:00:00,702,465,237,FMN GV 16 Berchem TOT
54,Posthofbrug 5366,2019-05-21,09:00:00,240,152,88,FMN GV 16 Berchem TOT
54,Posthofbrug 5366,2019-05-21,10:00:00,100,71,29,FMN GV 16 Berchem TOT
54,Posthofbrug 5366,2019-05-21,11:00:00,92,60,32,FMN GV 16 Berchem TOT
54,Posthofbrug 5366,2019-05-21,12:00:00,128,75,53,FMN GV 16 Berchem TOT
54,Posthofbrug 5366,2019-05-21,13:00:00,135,72,63,FMN GV 16 Berchem TOT
54,Posthofbrug 5366,2019-05-21,14:00:00,127,49,78,FMN GV 16 Berchem TOT
54,Posthofbrug 5366,2019-05-21,15:00:00,236,99,137,FMN GV 16 Berchem TOT
54,Posthofbrug 5366,2019-05-21,16:00:00,443,169,274,FMN GV 16 Berchem TOT
54,Posthofbrug 5366,2019-05-21,17:00:00,578,188,390,FMN GV 16 Berchem TOT
54,Posthofbrug 5366,2019-05-21,18:00:00,348,115,233,FMN GV 16 Berchem TOT
54,Posthofbrug 5366,2019-05-21,19:00:00,178,65,113,FMN GV 16 Berchem TOT
54,Posthofbrug 5366,2019-05-21,20:00:00,87,29,58,FMN GV 16 Berchem TOT
54,Posthofbrug 5366,2019-05-21,21:00:00,84,40,44,FMN GV 16 Berchem TOT
54,Posthofbrug 5366,2019-05-21,22:00:00,71,21,50,FMN GV 16 Berchem TOT
54,Posthofbrug 5366,2019-05-21,23:00:00,38,14,24,FMN GV 16 Berchem TOT
54,Posthofbrug 5366,2019-05-22,00:00:00,19,5,14,FMN GV 16 Berchem TOT
54,Posthofbrug 5366,2019-05-22,01:00:00,1,0,1,FMN GV 16 Berchem TOT
54,Posthofbrug 5366,2019-05-22,02:00:00,11,5,6,FMN GV 16 Berchem TOT
54,Posthofbrug 5366,2019-05-22,03:00:00,1,1,0,FMN GV 16 Berchem TOT
54,Posthofbrug 5366,2019-05-22,04:00:00,6,3,3,FMN GV 16 Berchem TOT
54,Posthofbrug 5366,2019-05-22,05:00:00,23,15,8,FMN GV 16 Berchem TOT
54,Posthofbrug 5366,2019-05-22,06:00:00,97,82,15,FMN GV 16 Berchem TOT
54,Posthofbrug 5366,2019-05-22,07:00:00,397,271,126,FMN GV 16 Berchem TOT
54,Posthofbrug 5366,2019-05-22,08:00:00,611,403,208,FMN GV 16 Berchem TOT
54,Posthofbrug 5366,2019-05-22,09:00:00,236,153,83,FMN GV 16 Berchem TOT
54,Posthofbrug 5366,2019-05-22,10:00:00,131,76,55,FMN GV 16 Berchem TOT
54,Posthofbrug 5366,2019-05-22,11:00:00,114,54,60,FMN GV 16 Berchem TOT
54,Posthofbrug 5366,2019-05-22,12:00:00,267,132,135,FMN GV 16 Berchem TOT
54,Posthofbrug 5366,2019-05-22,13:00:00,206,103,103,FMN GV 16 Berchem TOT
54,Posthofbrug 5366,2019-05-22,14:00:00,168,59,109,FMN GV 16 Berchem TOT
54,Posthofbrug 5366,2019-05-22,15:00:00,200,76,124,FMN GV 16 Berchem TOT
54,Posthofbrug 5366,2019-05-22,16:00:00,361,173,188,FMN GV 16 Berchem TOT
54,Posthofbrug 5366,2019-05-22,17:00:00,545,186,359,FMN GV 16 Berchem TOT
54,Posthofbrug 5366,2019-05-22,18:00:00,373,144,229,FMN GV 16 Berchem TOT
54,Posthofbrug 5366,2019-05-22,19:00:00,175,73,102,FMN GV 16 Berchem TOT
54,Posthofbrug 5366,2019-05-22,20:00:00,145,72,73,FMN GV 16 Berchem TOT
54,Posthofbrug 5366,2019-05-22,21:00:00,81,34,47,FMN GV 16 Berchem TOT
54,Posthofbrug 5366,2019-05-22,22:00:00,78,24,54,FMN GV 16 Berchem TOT
54,Posthofbrug 5366,2019-05-22,23:00:00,52,14,38,FMN GV 16 Berchem TOT
54,Posthofbrug 5366,2019-05-23,00:00:00,32,6,26,FMN GV 16 Berchem TOT
54,Posthofbrug 5366,2019-05-23,01:00:00,5,0,5,FMN GV 16 Berchem TOT
54,Posthofbrug 5366,2019-05-23,02:00:00,4,2,2,FMN GV 16 Berchem TOT
54,Posthofbrug 5366,2019-05-23,03:00:00,0,0,0,FMN GV 16 Berchem TOT
54,Posthofbrug 5366,2019-05-23,04:00:00,9,7,2,FMN GV 16 Berchem TOT
54,Posthofbrug 5366,2019-05-23,05:00:00,19,10,9,FMN GV 16 Berchem TOT
54,Posthofbrug 5366,2019-05-23,06:00:00,102,77,25,FMN GV 16 Berchem TOT
54,Posthofbrug 5366,2019-05-23,07:00:00,382,286,96,FMN GV 16 Berchem TOT
54,Posthofbrug 5366,2019-05-23,08:00:00,669,448,221,FMN GV 16 Berchem TOT
54,Posthofbrug 5366,2019-05-23,09:00:00,251,167,84,FMN GV 16 Berchem TOT
54,Posthofbrug 5366,2019-05-23,10:00:00,158,93,65,FMN GV 16 Berchem TOT
54,Posthofbrug 5366,2019-05-23,11:00:00,127,83,44,FMN GV 16 Berchem TOT
54,Posthofbrug 5366,2019-05-23,12:00:00,176,95,81,FMN GV 16 Berchem TOT
54,Posthofbrug 5366,2019-05-23,13:00:00,153,77,76,FMN GV 16 Berchem TOT
54,Posthofbrug 5366,2019-05-23,14:00:00,154,62,92,FMN GV 16 Berchem TOT
54,Posthofbrug 5366,2019-05-23,15:00:00,244,96,148,FMN GV 16 Berchem TOT
54,Posthofbrug 5366,2019-05-23,16:00:00,447,163,284,FMN GV 16 Berchem TOT
54,Posthofbrug 5366,2019-05-23,17:00:00,535,185,350,FMN GV 16 Berchem TOT
54,Posthofbrug 5366,2019-05-23,18:00:00,385,140,245,FMN GV 16 Berchem TOT
54,Posthofbrug 5366,2019-05-23,19:00:00,197,84,113,FMN GV 16 Berchem TOT
54,Posthofbrug 5366,2019-05-23,20:00:00,115,48,67,FMN GV 16 Berchem TOT
54,Posthofbrug 5366,2019-05-23,21:00:00,81,36,45,FMN GV 16 Berchem TOT
54,Posthofbrug 5366,2019-05-23,22:00:00,89,20,69,FMN GV 16 Berchem TOT
54,Posthofbrug 5366,2019-05-23,23:00:00,55,19,36,FMN GV 16 Berchem TOT
54,Posthofbrug 5366,2019-05-24,00:00:00,31,7,24,FMN GV 16 Berchem TOT
54,Posthofbrug 5366,2019-05-24,01:00:00,14,3,11,FMN GV 16 Berchem TOT
54,Posthofbrug 5366,2019-05-24,02:00:00,5,0,5,FMN GV 16 Berchem TOT
54,Posthofbrug 5366,2019-05-24,03:00:00,4,3,1,FMN GV 16 Berchem TOT
54,Posthofbrug 5366,2019-05-24,04:00:00,12,6,6,FMN GV 16 Berchem TOT
54,Posthofbrug 5366,2019-05-24,05:00:00,15,10,5,FMN GV 16 Berchem TOT
54,Posthofbrug 5366,2019-05-24,06:00:00,91,75,16,FMN GV 16 Berchem TOT
54,Posthofbrug 5366,2019-05-24,07:00:00,355,252,103,FMN GV 16 Berchem TOT
54,Posthofbrug 5366,2019-05-24,08:00:00,595,386,209,FMN GV 16 Berchem TOT
54,Posthofbrug 5366,2019-05-24,09:00:00,223,155,68,FMN GV 16 Berchem TOT
54,Posthofbrug 5366,2019-05-24,10:00:00,80,50,30,FMN GV 16 Berchem TOT
54,Posthofbrug 5366,2019-05-24,11:00:00,135,93,42,FMN GV 16 Berchem TOT
54,Posthofbrug 5366,2019-05-24,12:00:00,187,91,96,FMN GV 16 Berchem TOT
54,Posthofbrug 5366,2019-05-24,13:00:00,161,80,81,FMN GV 16 Berchem TOT
54,Posthofbrug 5366,2019-05-24,14:00:00,172,76,96,FMN GV 16 Berchem TOT
54,Posthofbrug 5366,2019-05-24,15:00:00,266,85,181,FMN GV 16 Berchem TOT
54,Posthofbrug 5366,2019-05-24,16:00:00,448,194,254,FMN GV 16 Berchem TOT
54,Posthofbrug 5366,2019-05-24,17:00:00,489,179,310,FMN GV 16 Berchem TOT
54,Posthofbrug 5366,2019-05-24,18:00:00,293,120,173,FMN GV 16 Berchem TOT
54,Posthofbrug 5366,2019-05-24,19:00:00,211,109,102,FMN GV 16 Berchem TOT
54,Posthofbrug 5366,2019-05-24,20:00:00,132,64,68,FMN GV 16 Berchem TOT
54,Posthofbrug 5366,2019-05-24,21:00:00,73,34,39,FMN GV 16 Berchem TOT
54,Posthofbrug 5366,2019-05-24,22:00:00,94,35,59,FMN GV 16 Berchem TOT
54,Posthofbrug 5366,2019-05-24,23:00:00,67,24,43,FMN GV 16 Berchem TOT
54,Posthofbrug 5366,2019-05-25,00:00:00,76,23,53,FMN GV 16 Berchem TOT
54,Posthofbrug 5366,2019-05-25,01:00:00,28,14,14,FMN GV 16 Berchem TOT
54,Posthofbrug 5366,2019-05-25,02:00:00,17,4,13,FMN GV 16 Berchem TOT
54,Posthofbrug 5366,2019-05-25,03:00:00,11,4,7,FMN GV 16 Berchem TOT
54,Posthofbrug 5366,2019-05-25,04:00:00,11,8,3,FMN GV 16 Berchem TOT
54,Posthofbrug 5366,2019-05-25,05:00:00,5,3,2,FMN GV 16 Berchem TOT
54,Posthofbrug 5366,2019-05-25,06:00:00,12,8,4,FMN GV 16 Berchem TOT
54,Posthofbrug 5366,2019-05-25,07:00:00,30,20,10,FMN GV 16 Berchem TOT
54,Posthofbrug 5366,2019-05-25,08:00:00,45,30,15,FMN GV 16 Berchem TOT
54,Posthofbrug 5366,2019-05-25,09:00:00,100,61,39,FMN GV 16 Berchem TOT
54,Posthofbrug 5366,2019-05-25,10:00:00,81,45,36,FMN GV 16 Berchem TOT
54,Posthofbrug 5366,2019-05-25,11:00:00,91,52,39,FMN GV 16 Berchem TOT
54,Posthofbrug 5366,2019-05-25,12:00:00,194,125,69,FMN GV 16 Berchem TOT
54,Posthofbrug 5366,2019-05-25,13:00:00,168,88,80,FMN GV 16 Berchem TOT
54,Posthofbrug 5366,2019-05-25,14:00:00,154,96,58,FMN GV 16 Berchem TOT
54,Posthofbrug 5366,2019-05-25,15:00:00,119,54,65,FMN GV 16 Berchem TOT
54,Posthofbrug 5366,2019-05-25,16:00:00,148,71,77,FMN GV 16 Berchem TOT
54,Posthofbrug 5366,2019-05-25,17:00:00,153,69,84,FMN GV 16 Berchem TOT
54,Posthofbrug 5366,2019-05-25,18:00:00,121,49,72,FMN GV 16 Berchem TOT
54,Posthofbrug 5366,2019-05-25,19:00:00,95,45,50,FMN GV 16 Berchem TOT
54,Posthofbrug 5366,2019-05-25,20:00:00,72,33,39,FMN GV 16 Berchem TOT
54,Posthofbrug 5366,2019-05-25,21:00:00,67,28,39,FMN GV 16 Berchem TOT
54,Posthofbrug 5366,2019-05-25,22:00:00,69,32,37,FMN GV 16 Berchem TOT
54,Posthofbrug 5366,2019-05-25,23:00:00,57,18,39,FMN GV 16 Berchem TOT
54,Posthofbrug 5366,2019-05-26,00:00:00,49,15,34,FMN GV 16 Berchem TOT
54,Posthofbrug 5366,2019-05-26,01:00:00,25,8,17,FMN GV 16 Berchem TOT
54,Posthofbrug 5366,2019-05-26,02:00:00,11,7,4,FMN GV 16 Berchem TOT
54,Posthofbrug 5366,2019-05-26,03:00:00,19,3,16,FMN GV 16 Berchem TOT
54,Posthofbrug 5366,2019-05-26,04:00:00,8,4,4,FMN GV 16 Berchem TOT
54,Posthofbrug 5366,2019-05-26,05:00:00,12,9,3,FMN GV 16 Berchem TOT
54,Posthofbrug 5366,2019-05-26,06:00:00,10,4,6,FMN GV 16 Berchem TOT
54,Posthofbrug 5366,2019-05-26,07:00:00,17,5,12,FMN GV 16 Berchem TOT
54,Posthofbrug 5366,2019-05-26,08:00:00,27,15,12,FMN GV 16 Berchem TOT
54,Posthofbrug 5366,2019-05-26,09:00:00,60,29,31,FMN GV 16 Berchem TOT
54,Posthofbrug 5366,2019-05-26,10:00:00,88,53,35,FMN GV 16 Berchem TOT
54,Posthofbrug 5366,2019-05-26,11:00:00,102,53,49,FMN GV 16 Berchem TOT
54,Posthofbrug 5366,2019-05-26,12:00:00,116,72,44,FMN GV 16 Berchem TOT
54,Posthofbrug 5366,2019-05-26,13:00:00,117,71,46,FMN GV 16 Berchem TOT
54,Posthofbrug 5366,2019-05-26,14:00:00,149,87,62,FMN GV 16 Berchem TOT
54,Posthofbrug 5366,2019-05-26,15:00:00,126,57,69,FMN GV 16 Berchem TOT
54,Posthofbrug 5366,2019-05-26,16:00:00,124,72,52,FMN GV 16 Berchem TOT
54,Posthofbrug 5366,2019-05-26,17:00:00,139,65,74,FMN GV 16 Berchem TOT
54,Posthofbrug 5366,2019-05-26,18:00:00,103,46,57,FMN GV 16 Berchem TOT
54,Posthofbrug 5366,2019-05-26,19:00:00,81,45,36,FMN GV 16 Berchem TOT
54,Posthofbrug 5366,2019-05-26,20:00:00,63,40,23,FMN GV 16 Berchem TOT
54,Posthofbrug 5366,2019-05-26,21:00:00,75,43,32,FMN GV 16 Berchem TOT
54,Posthofbrug 5366,2019-05-26,22:00:00,36,13,23,FMN GV 16 Berchem TOT
54,Posthofbrug 5366,2019-05-26,23:00:00,23,6,17,FMN GV 16 Berchem TOT
54,Posthofbrug 5366,2019-05-27,00:00:00,13,4,9,FMN GV 16 Berchem TOT
54,Posthofbrug 5366,2019-05-27,01:00:00,6,2,4,FMN GV 16 Berchem TOT
54,Posthofbrug 5366,2019-05-27,02:00:00,4,1,3,FMN GV 16 Berchem TOT
54,Posthofbrug 5366,2019-05-27,03:00:00,0,0,0,FMN GV 16 Berchem TOT
54,Posthofbrug 5366,2019-05-27,04:00:00,8,8,0,FMN GV 16 Berchem TOT
54,Posthofbrug 5366,2019-05-27,05:00:00,19,12,7,FMN GV 16 Berchem TOT
54,Posthofbrug 5366,2019-05-27,06:00:00,108,92,16,FMN GV 16 Berchem TOT
54,Posthofbrug 5366,2019-05-27,07:00:00,360,251,109,FMN GV 16 Berchem TOT
54,Posthofbrug 5366,2019-05-27,08:00:00,679,474,205,FMN GV 16 Berchem TOT
54,Posthofbrug 5366,2019-05-27,09:00:00,280,181,99,FMN GV 16 Berchem TOT
54,Posthofbrug 5366,2019-05-27,10:00:00,108,72,36,FMN GV 16 Berchem TOT
54,Posthofbrug 5366,2019-05-27,11:00:00,140,89,51,FMN GV 16 Berchem TOT
54,Posthofbrug 5366,2019-05-27,12:00:00,137,73,64,FMN GV 16 Berchem TOT
54,Posthofbrug 5366,2019-05-27,13:00:00,140,68,72,FMN GV 16 Berchem TOT
54,Posthofbrug 5366,2019-05-27,14:00:00,140,48,92,FMN GV 16 Berchem TOT
54,Posthofbrug 5366,2019-05-27,15:00:00,218,90,128,FMN GV 16 Berchem TOT
54,Posthofbrug 5366,2019-05-27,16:00:00,448,160,288,FMN GV 16 Berchem TOT
54,Posthofbrug 5366,2019-05-27,17:00:00,539,189,350,FMN GV 16 Berchem TOT
54,Posthofbrug 5366,2019-05-27,18:00:00,332,104,228,FMN GV 16 Berchem TOT
54,Posthofbrug 5366,2019-05-27,19:00:00,145,57,88,FMN GV 16 Berchem TOT
54,Posthofbrug 5366,2019-05-27,20:00:00,94,38,56,FMN GV 16 Berchem TOT
54,Posthofbrug 5366,2019-05-27,21:00:00,60,28,32,FMN GV 16 Berchem TOT
54,Posthofbrug 5366,2019-05-27,22:00:00,64,22,42,FMN GV 16 Berchem TOT
54,Posthofbrug 5366,2019-05-27,23:00:00,21,6,15,FMN GV 16 Berchem TOT
54,Posthofbrug 5366,2019-05-28,00:00:00,17,5,12,FMN GV 16 Berchem TOT
54,Posthofbrug 5366,2019-05-28,01:00:00,1,0,1,FMN GV 16 Berchem TOT
54,Posthofbrug 5366,2019-05-28,02:00:00,1,0,1,FMN GV 16 Berchem TOT
54,Posthofbrug 5366,2019-05-28,03:00:00,2,1,1,FMN GV 16 Berchem TOT
54,Posthofbrug 5366,2019-05-28,04:00:00,7,7,0,FMN GV 16 Berchem TOT
54,Posthofbrug 5366,2019-05-28,05:00:00,23,15,8,FMN GV 16 Berchem TOT
54,Posthofbrug 5366,2019-05-28,06:00:00,108,91,17,FMN GV 16 Berchem TOT
54,Posthofbrug 5366,2019-05-28,07:00:00,337,243,94,FMN GV 16 Berchem TOT
54,Posthofbrug 5366,2019-05-28,08:00:00,591,398,193,FMN GV 16 Berchem TOT
54,Posthofbrug 5366,2019-05-28,09:00:00,215,150,65,FMN GV 16 Berchem TOT
54,Posthofbrug 5366,2019-05-28,10:00:00,94,61,33,FMN GV 16 Berchem TOT
54,Posthofbrug 5366,2019-05-28,11:00:00,58,37,21,FMN GV 16 Berchem TOT
54,Posthofbrug 5366,2019-05-28,12:00:00,84,42,42,FMN GV 16 Berchem TOT
54,Posthofbrug 5366,2019-05-28,13:00:00,99,51,48,FMN GV 16 Berchem TOT
54,Posthofbrug 5366,2019-05-28,14:00:00,74,30,44,FMN GV 16 Berchem TOT
54,Posthofbrug 5366,2019-05-28,15:00:00,141,55,86,FMN GV 16 Berchem TOT
54,Posthofbrug 5366,2019-05-28,16:00:00,326,127,199,FMN GV 16 Berchem TOT
54,Posthofbrug 5366,2019-05-28,17:00:00,440,153,287,FMN GV 16 Berchem TOT
54,Posthofbrug 5366,2019-05-28,18:00:00,262,70,192,FMN GV 16 Berchem TOT
54,Posthofbrug 5366,2019-05-28,19:00:00,144,55,89,FMN GV 16 Berchem TOT
54,Posthofbrug 5366,2019-05-28,20:00:00,85,29,56,FMN GV 16 Berchem TOT
54,Posthofbrug 5366,2019-05-28,21:00:00,82,45,37,FMN GV 16 Berchem TOT
54,Posthofbrug 5366,2019-05-28,22:00:00,62,16,46,FMN GV 16 Berchem TOT
54,Posthofbrug 5366,2019-05-28,23:00:00,34,10,24,FMN GV 16 Berchem TOT
54,Posthofbrug 5366,2019-05-29,00:00:00,24,6,18,FMN GV 16 Berchem TOT
54,Posthofbrug 5366,2019-05-29,01:00:00,3,1,2,FMN GV 16 Berchem TOT
54,Posthofbrug 5366,2019-05-29,02:00:00,4,2,2,FMN GV 16 Berchem TOT
54,Posthofbrug 5366,2019-05-29,03:00:00,2,0,2,FMN GV 16 Berchem TOT
54,Posthofbrug 5366,2019-05-29,04:00:00,4,3,1,FMN GV 16 Berchem TOT
54,Posthofbrug 5366,2019-05-29,05:00:00,18,15,3,FMN GV 16 Berchem TOT
54,Posthofbrug 5366,2019-05-29,06:00:00,92,78,14,FMN GV 16 Berchem TOT
54,Posthofbrug 5366,2019-05-29,07:00:00,321,215,106,FMN GV 16 Berchem TOT
54,Posthofbrug 5366,2019-05-29,08:00:00,546,347,199,FMN GV 16 Berchem TOT
54,Posthofbrug 5366,2019-05-29,09:00:00,207,140,67,FMN GV 16 Berchem TOT
54,Posthofbrug 5366,2019-05-29,10:00:00,97,58,39,FMN GV 16 Berchem TOT
54,Posthofbrug 5366,2019-05-29,11:00:00,134,65,69,FMN GV 16 Berchem TOT
54,Posthofbrug 5366,2019-05-29,12:00:00,264,139,125,FMN GV 16 Berchem TOT
54,Posthofbrug 5366,2019-05-29,13:00:00,161,73,88,FMN GV 16 Berchem TOT
54,Posthofbrug 5366,2019-05-29,14:00:00,131,66,65,FMN GV 16 Berchem TOT
54,Posthofbrug 5366,2019-05-29,15:00:00,167,62,105,FMN GV 16 Berchem TOT
54,Posthofbrug 5366,2019-05-29,16:00:00,330,137,193,FMN GV 16 Berchem TOT
54,Posthofbrug 5366,2019-05-29,17:00:00,452,181,271,FMN GV 16 Berchem TOT
54,Posthofbrug 5366,2019-05-29,18:00:00,306,108,198,FMN GV 16 Berchem TOT
54,Posthofbrug 5366,2019-05-29,19:00:00,185,82,103,FMN GV 16 Berchem TOT
54,Posthofbrug 5366,2019-05-29,20:00:00,111,53,58,FMN GV 16 Berchem TOT
54,Posthofbrug 5366,2019-05-29,21:00:00,73,29,44,FMN GV 16 Berchem TOT
54,Posthofbrug 5366,2019-05-29,22:00:00,66,24,42,FMN GV 16 Berchem TOT
54,Posthofbrug 5366,2019-05-29,23:00:00,63,17,46,FMN GV 16 Berchem TOT
54,Posthofbrug 5366,2019-05-30,00:00:00,62,21,41,FMN GV 16 Berchem TOT
54,Posthofbrug 5366,2019-05-30,01:00:00,30,8,22,FMN GV 16 Berchem TOT
54,Posthofbrug 5366,2019-05-30,02:00:00,14,6,8,FMN GV 16 Berchem TOT
54,Posthofbrug 5366,2019-05-30,03:00:00,12,3,9,FMN GV 16 Berchem TOT
54,Posthofbrug 5366,2019-05-30,04:00:00,13,6,7,FMN GV 16 Berchem TOT
54,Posthofbrug 5366,2019-05-30,05:00:00,26,13,13,FMN GV 16 Berchem TOT
54,Posthofbrug 5366,2019-05-30,06:00:00,15,14,1,FMN GV 16 Berchem TOT
54,Posthofbrug 5366,2019-05-30,07:00:00,23,14,9,FMN GV 16 Berchem TOT
54,Posthofbrug 5366,2019-05-30,08:00:00,19,13,6,FMN GV 16 Berchem TOT
54,Posthofbrug 5366,2019-05-30,09:00:00,53,27,26,FMN GV 16 Berchem TOT
54,Posthofbrug 5366,2019-05-30,10:00:00,97,72,25,FMN GV 16 Berchem TOT
54,Posthofbrug 5366,2019-05-30,11:00:00,62,41,21,FMN GV 16 Berchem TOT
54,Posthofbrug 5366,2019-05-30,12:00:00,71,38,33,FMN GV 16 Berchem TOT
54,Posthofbrug 5366,2019-05-30,13:00:00,125,61,64,FMN GV 16 Berchem TOT
54,Posthofbrug 5366,2019-05-30,14:00:00,150,70,80,FMN GV 16 Berchem TOT
54,Posthofbrug 5366,2019-05-30,15:00:00,165,51,114,FMN GV 16 Berchem TOT
54,Posthofbrug 5366,2019-05-30,16:00:00,126,53,73,FMN GV 16 Berchem TOT
54,Posthofbrug 5366,2019-05-30,17:00:00,131,60,71,FMN GV 16 Berchem TOT
54,Posthofbrug 5366,2019-05-30,18:00:00,104,43,61,FMN GV 16 Berchem TOT
54,Posthofbrug 5366,2019-05-30,19:00:00,109,75,34,FMN GV 16 Berchem TOT
54,Posthofbrug 5366,2019-05-30,20:00:00,66,32,34,FMN GV 16 Berchem TOT
54,Posthofbrug 5366,2019-05-30,21:00:00,56,34,22,FMN GV 16 Berchem TOT
54,Posthofbrug 5366,2019-05-30,22:00:00,65,30,35,FMN GV 16 Berchem TOT
54,Posthofbrug 5366,2019-05-30,23:00:00,47,23,24,FMN GV 16 Berchem TOT
54,Posthofbrug 5366,2019-05-31,00:00:00,44,25,19,FMN GV 16 Berchem TOT
54,Posthofbrug 5366,2019-05-31,01:00:00,32,19,13,FMN GV 16 Berchem TOT
54,Posthofbrug 5366,2019-05-31,02:00:00,3,2,1,FMN GV 16 Berchem TOT
54,Posthofbrug 5366,2019-05-31,03:00:00,7,1,6,FMN GV 16 Berchem TOT
54,Posthofbrug 5366,2019-05-31,04:00:00,9,7,2,FMN GV 16 Berchem TOT
54,Posthofbrug 5366,2019-05-31,05:00:00,10,7,3,FMN GV 16 Berchem TOT
54,Posthofbrug 5366,2019-05-31,06:00:00,31,24,7,FMN GV 16 Berchem TOT
54,Posthofbrug 5366,2019-05-31,07:00:00,102,78,24,FMN GV 16 Berchem TOT
54,Posthofbrug 5366,2019-05-31,08:00:00,139,105,34,FMN GV 16 Berchem TOT
54,Posthofbrug 5366,2019-05-31,09:00:00,100,72,28,FMN GV 16 Berchem TOT
54,Posthofbrug 5366,2019-05-31,10:00:00,119,80,39,FMN GV 16 Berchem TOT
54,Posthofbrug 5366,2019-05-31,11:00:00,105,61,44,FMN GV 16 Berchem TOT
54,Posthofbrug 5366,2019-05-31,12:00:00,121,80,41,FMN GV 16 Berchem TOT
54,Posthofbrug 5366,2019-05-31,13:00:00,150,100,50,FMN GV 16 Berchem TOT
54,Posthofbrug 5366,2019-05-31,14:00:00,128,65,63,FMN GV 16 Berchem TOT
54,Posthofbrug 5366,2019-05-31,15:00:00,169,70,99,FMN GV 16 Berchem TOT
54,Posthofbrug 5366,2019-05-31,16:00:00,176,77,99,FMN GV 16 Berchem TOT
54,Posthofbrug 5366,2019-05-31,17:00:00,216,81,135,FMN GV 16 Berchem TOT
54,Posthofbrug 5366,2019-05-31,18:00:00,146,57,89,FMN GV 16 Berchem TOT
54,Posthofbrug 5366,2019-05-31,19:00:00,123,48,75,FMN GV 16 Berchem TOT
54,Posthofbrug 5366,2019-05-31,20:00:00,87,46,41,FMN GV 16 Berchem TOT
54,Posthofbrug 5366,2019-05-31,21:00:00,64,35,29,FMN GV 16 Berchem TOT
54,Posthofbrug 5366,2019-05-31,22:00:00,63,18,45,FMN GV 16 Berchem TOT
54,Posthofbrug 5366,2019-05-31,23:00:00,48,10,38,FMN GV 16 Berchem TOT
54,Posthofbrug 5366,2019-06-01,00:00:00,31,5,26,FMN GV 16 Berchem TOT
54,Posthofbrug 5366,2019-06-01,01:00:00,24,4,20,FMN GV 16 Berchem TOT
54,Posthofbrug 5366,2019-06-01,02:00:00,11,4,7,FMN GV 16 Berchem TOT
54,Posthofbrug 5366,2019-06-01,03:00:00,21,15,6,FMN GV 16 Berchem TOT
54,Posthofbrug 5366,2019-06-01,04:00:00,8,4,4,FMN GV 16 Berchem TOT
54,Posthofbrug 5366,2019-06-01,05:00:00,11,7,4,FMN GV 16 Berchem TOT
54,Posthofbrug 5366,2019-06-01,06:00:00,11,8,3,FMN GV 16 Berchem TOT
54,Posthofbrug 5366,2019-06-01,07:00:00,18,11,7,FMN GV 16 Berchem TOT
54,Posthofbrug 5366,2019-06-01,08:00:00,38,27,11,FMN GV 16 Berchem TOT
54,Posthofbrug 5366,2019-06-01,09:00:00,89,66,23,FMN GV 16 Berchem TOT
54,Posthofbrug 5366,2019-06-01,10:00:00,101,59,42,FMN GV 16 Berchem TOT
54,Posthofbrug 5366,2019-06-01,11:00:00,128,79,49,FMN GV 16 Berchem TOT
54,Posthofbrug 5366,2019-06-01,12:00:00,162,92,70,FMN GV 16 Berchem TOT
54,Posthofbrug 5366,2019-06-01,13:00:00,161,86,75,FMN GV 16 Berchem TOT
54,Posthofbrug 5366,2019-06-01,14:00:00,168,98,70,FMN GV 16 Berchem TOT
54,Posthofbrug 5366,2019-06-01,15:00:00,170,93,77,FMN GV 16 Berchem TOT
54,Posthofbrug 5366,2019-06-01,16:00:00,155,70,85,FMN GV 16 Berchem TOT
54,Posthofbrug 5366,2019-06-01,17:00:00,140,68,72,FMN GV 16 Berchem TOT
54,Posthofbrug 5366,2019-06-01,18:00:00,136,64,72,FMN GV 16 Berchem TOT
54,Posthofbrug 5366,2019-06-01,19:00:00,105,60,45,FMN GV 16 Berchem TOT
54,Posthofbrug 5366,2019-06-01,20:00:00,89,51,38,FMN GV 16 Berchem TOT
54,Posthofbrug 5366,2019-06-01,21:00:00,80,40,40,FMN GV 16 Berchem TOT
54,Posthofbrug 5366,2019-06-01,22:00:00,69,21,48,FMN GV 16 Berchem TOT
54,Posthofbrug 5366,2019-06-01,23:00:00,62,22,40,FMN GV 16 Berchem TOT
54,Posthofbrug 5366,2019-06-02,00:00:00,53,20,33,FMN GV 16 Berchem TOT
54,Posthofbrug 5366,2019-06-02,01:00:00,30,4,26,FMN GV 16 Berchem TOT
54,Posthofbrug 5366,2019-06-02,02:00:00,22,6,16,FMN GV 16 Berchem TOT
54,Posthofbrug 5366,2019-06-02,03:00:00,8,2,6,FMN GV 16 Berchem TOT
54,Posthofbrug 5366,2019-06-02,04:00:00,7,3,4,FMN GV 16 Berchem TOT
54,Posthofbrug 5366,2019-06-02,05:00:00,5,2,3,FMN GV 16 Berchem TOT
54,Posthofbrug 5366,2019-06-02,06:00:00,9,8,1,FMN GV 16 Berchem TOT
54,Posthofbrug 5366,2019-06-02,07:00:00,17,11,6,FMN GV 16 Berchem TOT
54,Posthofbrug 5366,2019-06-02,08:00:00,30,16,14,FMN GV 16 Berchem TOT
54,Posthofbrug 5366,2019-06-02,09:00:00,75,47,28,FMN GV 16 Berchem TOT
54,Posthofbrug 5366,2019-06-02,10:00:00,104,68,36,FMN GV 16 Berchem TOT
54,Posthofbrug 5366,2019-06-02,11:00:00,143,86,57,FMN GV 16 Berchem TOT
54,Posthofbrug 5366,2019-06-02,12:00:00,153,80,73,FMN GV 16 Berchem TOT
54,Posthofbrug 5366,2019-06-02,13:00:00,147,83,64,FMN GV 16 Berchem TOT
54,Posthofbrug 5366,2019-06-02,14:00:00,139,75,64,FMN GV 16 Berchem TOT
54,Posthofbrug 5366,2019-06-02,15:00:00,181,90,91,FMN GV 16 Berchem TOT
54,Posthofbrug 5366,2019-06-02,16:00:00,121,49,72,FMN GV 16 Berchem TOT
54,Posthofbrug 5366,2019-06-02,17:00:00,122,53,69,FMN GV 16 Berchem TOT
54,Posthofbrug 5366,2019-06-02,18:00:00,95,45,50,FMN GV 16 Berchem TOT
54,Posthofbrug 5366,2019-06-02,19:00:00,92,39,53,FMN GV 16 Berchem TOT
54,Posthofbrug 5366,2019-06-02,20:00:00,73,38,35,FMN GV 16 Berchem TOT
54,Posthofbrug 5366,2019-06-02,21:00:00,54,20,34,FMN GV 16 Berchem TOT
54,Posthofbrug 5366,2019-06-02,22:00:00,37,18,19,FMN GV 16 Berchem TOT
54,Posthofbrug 5366,2019-06-02,23:00:00,24,8,16,FMN GV 16 Berchem TOT
54,Posthofbrug 5366,2019-06-03,00:00:00,15,6,9,FMN GV 16 Berchem TOT
54,Posthofbrug 5366,2019-06-03,01:00:00,3,0,3,FMN GV 16 Berchem TOT
54,Posthofbrug 5366,2019-06-03,02:00:00,2,0,2,FMN GV 16 Berchem TOT
54,Posthofbrug 5366,2019-06-03,03:00:00,2,2,0,FMN GV 16 Berchem TOT
54,Posthofbrug 5366,2019-06-03,04:00:00,5,3,2,FMN GV 16 Berchem TOT
54,Posthofbrug 5366,2019-06-03,05:00:00,16,9,7,FMN GV 16 Berchem TOT
54,Posthofbrug 5366,2019-06-03,06:00:00,109,92,17,FMN GV 16 Berchem TOT
54,Posthofbrug 5366,2019-06-03,07:00:00,344,248,96,FMN GV 16 Berchem TOT
54,Posthofbrug 5366,2019-06-03,08:00:00,635,441,194,FMN GV 16 Berchem TOT
54,Posthofbrug 5366,2019-06-03,09:00:00,221,151,70,FMN GV 16 Berchem TOT
54,Posthofbrug 5366,2019-06-03,10:00:00,100,61,39,FMN GV 16 Berchem TOT
54,Posthofbrug 5366,2019-06-03,11:00:00,113,67,46,FMN GV 16 Berchem TOT
54,Posthofbrug 5366,2019-06-03,12:00:00,130,67,63,FMN GV 16 Berchem TOT
54,Posthofbrug 5366,2019-06-03,13:00:00,120,73,47,FMN GV 16 Berchem TOT
54,Posthofbrug 5366,2019-06-03,14:00:00,102,34,68,FMN GV 16 Berchem TOT
54,Posthofbrug 5366,2019-06-03,15:00:00,185,76,109,FMN GV 16 Berchem TOT
54,Posthofbrug 5366,2019-06-03,16:00:00,380,123,257,FMN GV 16 Berchem TOT
54,Posthofbrug 5366,2019-06-03,17:00:00,528,180,348,FMN GV 16 Berchem TOT
54,Posthofbrug 5366,2019-06-03,18:00:00,328,97,231,FMN GV 16 Berchem TOT
54,Posthofbrug 5366,2019-06-03,19:00:00,137,49,88,FMN GV 16 Berchem TOT
54,Posthofbrug 5366,2019-06-03,20:00:00,90,40,50,FMN GV 16 Berchem TOT
54,Posthofbrug 5366,2019-06-03,21:00:00,72,29,43,FMN GV 16 Berchem TOT
54,Posthofbrug 5366,2019-06-03,22:00:00,54,17,37,FMN GV 16 Berchem TOT
54,Posthofbrug 5366,2019-06-03,23:00:00,28,6,22,FMN GV 16 Berchem TOT
54,Posthofbrug 5366,2019-06-04,00:00:00,15,4,11,FMN GV 16 Berchem TOT
54,Posthofbrug 5366,2019-06-04,01:00:00,5,0,5,FMN GV 16 Berchem TOT
54,Posthofbrug 5366,2019-06-04,02:00:00,1,0,1,FMN GV 16 Berchem TOT
54,Posthofbrug 5366,2019-06-04,03:00:00,2,2,0,FMN GV 16 Berchem TOT
54,Posthofbrug 5366,2019-06-04,04:00:00,6,3,3,FMN GV 16 Berchem TOT
54,Posthofbrug 5366,2019-06-04,05:00:00,15,9,6,FMN GV 16 Berchem TOT
54,Posthofbrug 5366,2019-06-04,06:00:00,99,79,20,FMN GV 16 Berchem TOT
54,Posthofbrug 5366,2019-06-04,07:00:00,362,255,107,FMN GV 16 Berchem TOT
54,Posthofbrug 5366,2019-06-04,08:00:00,600,407,193,FMN GV 16 Berchem TOT
54,Posthofbrug 5366,2019-06-04,09:00:00,214,159,55,FMN GV 16 Berchem TOT
54,Posthofbrug 5366,2019-06-04,10:00:00,113,66,47,FMN GV 16 Berchem TOT
54,Posthofbrug 5366,2019-06-04,11:00:00,77,40,37,FMN GV 16 Berchem TOT
54,Posthofbrug 5366,2019-06-04,12:00:00,140,77,63,FMN GV 16 Berchem TOT
54,Posthofbrug 5366,2019-06-04,13:00:00,110,65,45,FMN GV 16 Berchem TOT
54,Posthofbrug 5366,2019-06-04,14:00:00,88,35,53,FMN GV 16 Berchem TOT
54,Posthofbrug 5366,2019-06-04,15:00:00,200,86,114,FMN GV 16 Berchem TOT
54,Posthofbrug 5366,2019-06-04,16:00:00,394,132,262,FMN GV 16 Berchem TOT
54,Posthofbrug 5366,2019-06-04,17:00:00,548,179,369,FMN GV 16 Berchem TOT
54,Posthofbrug 5366,2019-06-04,18:00:00,309,99,210,FMN GV 16 Berchem TOT
54,Posthofbrug 5366,2019-06-04,19:00:00,136,47,89,FMN GV 16 Berchem TOT
54,Posthofbrug 5366,2019-06-04,20:00:00,95,43,52,FMN GV 16 Berchem TOT
54,Posthofbrug 5366,2019-06-04,21:00:00,37,16,21,FMN GV 16 Berchem TOT
54,Posthofbrug 5366,2019-06-04,22:00:00,56,15,41,FMN GV 16 Berchem TOT
54,Posthofbrug 5366,2019-06-04,23:00:00,30,13,17,FMN GV 16 Berchem TOT
54,Posthofbrug 5366,2019-06-05,00:00:00,15,2,13,FMN GV 16 Berchem TOT
54,Posthofbrug 5366,2019-06-05,01:00:00,1,0,1,FMN GV 16 Berchem TOT
54,Posthofbrug 5366,2019-06-05,02:00:00,4,0,4,FMN GV 16 Berchem TOT
54,Posthofbrug 5366,2019-06-05,03:00:00,1,1,0,FMN GV 16 Berchem TOT
54,Posthofbrug 5366,2019-06-05,04:00:00,6,4,2,FMN GV 16 Berchem TOT
54,Posthofbrug 5366,2019-06-05,05:00:00,20,13,7,FMN GV 16 Berchem TOT
54,Posthofbrug 5366,2019-06-05,06:00:00,69,59,10,FMN GV 16 Berchem TOT
54,Posthofbrug 5366,2019-06-05,07:00:00,287,221,66,FMN GV 16 Berchem TOT
54,Posthofbrug 5366,2019-06-05,08:00:00,373,242,131,FMN GV 16 Berchem TOT
54,Posthofbrug 5366,2019-06-05,09:00:00,133,88,45,FMN GV 16 Berchem TOT
54,Posthofbrug 5366,2019-06-05,10:00:00,72,43,29,FMN GV 16 Berchem TOT
54,Posthofbrug 5366,2019-06-05,11:00:00,65,30,35,FMN GV 16 Berchem TOT
54,Posthofbrug 5366,2019-06-05,12:00:00,127,48,79,FMN GV 16 Berchem TOT
54,Posthofbrug 5366,2019-06-05,13:00:00,94,40,54,FMN GV 16 Berchem TOT
54,Posthofbrug 5366,2019-06-05,14:00:00,68,32,36,FMN GV 16 Berchem TOT
54,Posthofbrug 5366,2019-06-05,15:00:00,110,53,57,FMN GV 16 Berchem TOT
54,Posthofbrug 5366,2019-06-05,16:00:00,246,104,142,FMN GV 16 Berchem TOT
54,Posthofbrug 5366,2019-06-05,17:00:00,376,148,228,FMN GV 16 Berchem TOT
54,Posthofbrug 5366,2019-06-05,18:00:00,223,71,152,FMN GV 16 Berchem TOT
54,Posthofbrug 5366,2019-06-05,19:00:00,109,32,77,FMN GV 16 Berchem TOT
54,Posthofbrug 5366,2019-06-05,20:00:00,75,33,42,FMN GV 16 Berchem TOT
54,Posthofbrug 5366,2019-06-05,21:00:00,69,28,41,FMN GV 16 Berchem TOT
54,Posthofbrug 5366,2019-06-05,22:00:00,37,16,21,FMN GV 16 Berchem TOT
54,Posthofbrug 5366,2019-06-05,23:00:00,25,5,20,FMN GV 16 Berchem TOT
54,Posthofbrug 5366,2019-06-06,00:00:00,12,5,7,FMN GV 16 Berchem TOT
54,Posthofbrug 5366,2019-06-06,01:00:00,3,0,3,FMN GV 16 Berchem TOT
54,Posthofbrug 5366,2019-06-06,02:00:00,3,0,3,FMN GV 16 Berchem TOT
54,Posthofbrug 5366,2019-06-06,03:00:00,2,0,2,FMN GV 16 Berchem TOT
54,Posthofbrug 5366,2019-06-06,04:00:00,5,5,0,FMN GV 16 Berchem TOT
54,Posthofbrug 5366,2019-06-06,05:00:00,18,10,8,FMN GV 16 Berchem TOT
54,Posthofbrug 5366,2019-06-06,06:00:00,85,69,16,FMN GV 16 Berchem TOT
54,Posthofbrug 5366,2019-06-06,07:00:00,318,244,74,FMN GV 16 Berchem TOT
54,Posthofbrug 5366,2019-06-06,08:00:00,537,374,163,FMN GV 16 Berchem TOT
54,Posthofbrug 5366,2019-06-06,09:00:00,243,161,82,FMN GV 16 Berchem TOT
54,Posthofbrug 5366,2019-06-06,10:00:00,106,60,46,FMN GV 16 Berchem TOT
54,Posthofbrug 5366,2019-06-06,11:00:00,94,65,29,FMN GV 16 Berchem TOT
54,Posthofbrug 5366,2019-06-06,12:00:00,145,79,66,FMN GV 16 Berchem TOT
54,Posthofbrug 5366,2019-06-06,13:00:00,138,63,75,FMN GV 16 Berchem TOT
54,Posthofbrug 5366,2019-06-06,14:00:00,113,46,67,FMN GV 16 Berchem TOT
54,Posthofbrug 5366,2019-06-06,15:00:00,194,75,119,FMN GV 16 Berchem TOT
54,Posthofbrug 5366,2019-06-06,16:00:00,411,155,256,FMN GV 16 Berchem TOT
54,Posthofbrug 5366,2019-06-06,17:00:00,501,186,315,FMN GV 16 Berchem TOT
54,Posthofbrug 5366,2019-06-06,18:00:00,343,111,232,FMN GV 16 Berchem TOT
54,Posthofbrug 5366,2019-06-06,19:00:00,138,52,86,FMN GV 16 Berchem TOT
54,Posthofbrug 5366,2019-06-06,20:00:00,93,46,47,FMN GV 16 Berchem TOT
54,Posthofbrug 5366,2019-06-06,21:00:00,79,35,44,FMN GV 16 Berchem TOT
54,Posthofbrug 5366,2019-06-06,22:00:00,85,25,60,FMN GV 16 Berchem TOT
54,Posthofbrug 5366,2019-06-06,23:00:00,38,9,29,FMN GV 16 Berchem TOT
54,Posthofbrug 5366,2019-06-07,00:00:00,21,4,17,FMN GV 16 Berchem TOT
54,Posthofbrug 5366,2019-06-07,01:00:00,7,0,7,FMN GV 16 Berchem TOT
54,Posthofbrug 5366,2019-06-07,02:00:00,3,0,3,FMN GV 16 Berchem TOT
54,Posthofbrug 5366,2019-06-07,03:00:00,3,1,2,FMN GV 16 Berchem TOT
54,Posthofbrug 5366,2019-06-07,04:00:00,4,3,1,FMN GV 16 Berchem TOT
54,Posthofbrug 5366,2019-06-07,05:00:00,14,10,4,FMN GV 16 Berchem TOT
54,Posthofbrug 5366,2019-06-07,06:00:00,73,60,13,FMN GV 16 Berchem TOT
54,Posthofbrug 5366,2019-06-07,07:00:00,309,218,91,FMN GV 16 Berchem TOT
54,Posthofbrug 5366,2019-06-07,08:00:00,512,343,169,FMN GV 16 Berchem TOT
54,Posthofbrug 5366,2019-06-07,09:00:00,192,131,61,FMN GV 16 Berchem TOT
54,Posthofbrug 5366,2019-06-07,10:00:00,100,65,35,FMN GV 16 Berchem TOT
54,Posthofbrug 5366,2019-06-07,11:00:00,115,58,57,FMN GV 16 Berchem TOT
54,Posthofbrug 5366,2019-06-07,12:00:00,155,80,75,FMN GV 16 Berchem TOT
54,Posthofbrug 5366,2019-06-07,13:00:00,158,58,100,FMN GV 16 Berchem TOT
54,Posthofbrug 5366,2019-06-07,14:00:00,167,62,105,FMN GV 16 Berchem TOT
54,Posthofbrug 5366,2019-06-07,15:00:00,222,73,149,FMN GV 16 Berchem TOT
54,Posthofbrug 5366,2019-06-07,16:00:00,300,101,199,FMN GV 16 Berchem TOT
54,Posthofbrug 5366,2019-06-07,17:00:00,305,108,197,FMN GV 16 Berchem TOT
54,Posthofbrug 5366,2019-06-07,18:00:00,190,66,124,FMN GV 16 Berchem TOT
54,Posthofbrug 5366,2019-06-07,19:00:00,119,52,67,FMN GV 16 Berchem TOT
54,Posthofbrug 5366,2019-06-07,20:00:00,76,35,41,FMN GV 16 Berchem TOT
54,Posthofbrug 5366,2019-06-07,21:00:00,50,28,22,FMN GV 16 Berchem TOT
54,Posthofbrug 5366,2019-06-07,22:00:00,61,23,38,FMN GV 16 Berchem TOT
54,Posthofbrug 5366,2019-06-07,23:00:00,58,16,42,FMN GV 16 Berchem TOT
54,Posthofbrug 5366,2019-06-08,00:00:00,34,8,26,FMN GV 16 Berchem TOT
54,Posthofbrug 5366,2019-06-08,01:00:00,19,6,13,FMN GV 16 Berchem TOT
54,Posthofbrug 5366,2019-06-08,02:00:00,17,8,9,FMN GV 16 Berchem TOT
54,Posthofbrug 5366,2019-06-08,03:00:00,6,4,2,FMN GV 16 Berchem TOT
54,Posthofbrug 5366,2019-06-08,04:00:00,10,2,8,FMN GV 16 Berchem TOT
54,Posthofbrug 5366,2019-06-08,05:00:00,9,2,7,FMN GV 16 Berchem TOT
54,Posthofbrug 5366,2019-06-08,06:00:00,8,7,1,FMN GV 16 Berchem TOT
54,Posthofbrug 5366,2019-06-08,07:00:00,20,12,8,FMN GV 16 Berchem TOT
54,Posthofbrug 5366,2019-06-08,08:00:00,23,16,7,FMN GV 16 Berchem TOT
54,Posthofbrug 5366,2019-06-08,09:00:00,47,31,16,FMN GV 16 Berchem TOT
54,Posthofbrug 5366,2019-06-08,10:00:00,47,22,25,FMN GV 16 Berchem TOT
54,Posthofbrug 5366,2019-06-08,11:00:00,59,30,29,FMN GV 16 Berchem TOT
54,Posthofbrug 5366,2019-06-08,12:00:00,59,41,18,FMN GV 16 Berchem TOT
54,Posthofbrug 5366,2019-06-08,13:00:00,65,41,24,FMN GV 16 Berchem TOT
54,Posthofbrug 5366,2019-06-08,14:00:00,40,27,13,FMN GV 16 Berchem TOT
54,Posthofbrug 5366,2019-06-08,15:00:00,66,36,30,FMN GV 16 Berchem TOT
54,Posthofbrug 5366,2019-06-08,16:00:00,51,24,27,FMN GV 16 Berchem TOT
54,Posthofbrug 5366,2019-06-08,17:00:00,62,26,36,FMN GV 16 Berchem TOT
54,Posthofbrug 5366,2019-06-08,18:00:00,87,49,38,FMN GV 16 Berchem TOT
54,Posthofbrug 5366,2019-06-08,19:00:00,62,32,30,FMN GV 16 Berchem TOT
54,Posthofbrug 5366,2019-06-08,20:00:00,50,24,26,FMN GV 16 Berchem TOT
54,Posthofbrug 5366,2019-06-08,21:00:00,30,12,18,FMN GV 16 Berchem TOT
54,Posthofbrug 5366,2019-06-08,22:00:00,32,18,14,FMN GV 16 Berchem TOT
54,Posthofbrug 5366,2019-06-08,23:00:00,46,11,35,FMN GV 16 Berchem TOT
54,Posthofbrug 5366,2019-06-09,00:00:00,27,8,19,FMN GV 16 Berchem TOT
54,Posthofbrug 5366,2019-06-09,01:00:00,11,4,7,FMN GV 16 Berchem TOT
54,Posthofbrug 5366,2019-06-09,02:00:00,10,3,7,FMN GV 16 Berchem TOT
54,Posthofbrug 5366,2019-06-09,03:00:00,10,3,7,FMN GV 16 Berchem TOT
54,Posthofbrug 5366,2019-06-09,04:00:00,8,4,4,FMN GV 16 Berchem TOT
54,Posthofbrug 5366,2019-06-09,05:00:00,11,7,4,FMN GV 16 Berchem TOT
54,Posthofbrug 5366,2019-06-09,06:00:00,6,6,0,FMN GV 16 Berchem TOT
54,Posthofbrug 5366,2019-06-09,07:00:00,11,6,5,FMN GV 16 Berchem TOT
54,Posthofbrug 5366,2019-06-09,08:00:00,30,13,17,FMN GV 16 Berchem TOT
54,Posthofbrug 5366,2019-06-09,09:00:00,66,43,23,FMN GV 16 Berchem TOT
54,Posthofbrug 5366,2019-06-09,10:00:00,86,43,43,FMN GV 16 Berchem TOT
54,Posthofbrug 5366,2019-06-09,11:00:00,109,68,41,FMN GV 16 Berchem TOT
54,Posthofbrug 5366,2019-06-09,12:00:00,144,71,73,FMN GV 16 Berchem TOT
54,Posthofbrug 5366,2019-06-09,13:00:00,100,49,51,FMN GV 16 Berchem TOT
54,Posthofbrug 5366,2019-06-09,14:00:00,149,79,70,FMN GV 16 Berchem TOT
54,Posthofbrug 5366,2019-06-09,15:00:00,128,57,71,FMN GV 16 Berchem TOT
54,Posthofbrug 5366,2019-06-09,16:00:00,122,49,73,FMN GV 16 Berchem TOT
54,Posthofbrug 5366,2019-06-09,17:00:00,117,52,65,FMN GV 16 Berchem TOT
54,Posthofbrug 5366,2019-06-09,18:00:00,95,55,40,FMN GV 16 Berchem TOT
54,Posthofbrug 5366,2019-06-09,19:00:00,72,30,42,FMN GV 16 Berchem TOT
54,Posthofbrug 5366,2019-06-09,20:00:00,48,17,31,FMN GV 16 Berchem TOT
54,Posthofbrug 5366,2019-06-09,21:00:00,60,25,35,FMN GV 16 Berchem TOT
54,Posthofbrug 5366,2019-06-09,22:00:00,43,18,25,FMN GV 16 Berchem TOT
54,Posthofbrug 5366,2019-06-09,23:00:00,26,9,17,FMN GV 16 Berchem TOT
54,Posthofbrug 5366,2019-06-10,00:00:00,22,11,11,FMN GV 16 Berchem TOT
54,Posthofbrug 5366,2019-06-10,01:00:00,18,7,11,FMN GV 16 Berchem TOT
54,Posthofbrug 5366,2019-06-10,02:00:00,7,1,6,FMN GV 16 Berchem TOT
54,Posthofbrug 5366,2019-06-10,03:00:00,9,0,9,FMN GV 16 Berchem TOT
54,Posthofbrug 5366,2019-06-10,04:00:00,4,2,2,FMN GV 16 Berchem TOT
54,Posthofbrug 5366,2019-06-10,05:00:00,3,2,1,FMN GV 16 Berchem TOT
54,Posthofbrug 5366,2019-06-10,06:00:00,10,6,4,FMN GV 16 Berchem TOT
54,Posthofbrug 5366,2019-06-10,07:00:00,14,13,1,FMN GV 16 Berchem TOT
54,Posthofbrug 5366,2019-06-10,08:00:00,35,20,15,FMN GV 16 Berchem TOT
54,Posthofbrug 5366,2019-06-10,09:00:00,66,38,28,FMN GV 16 Berchem TOT
54,Posthofbrug 5366,2019-06-10,10:00:00,100,51,49,FMN GV 16 Berchem TOT
54,Posthofbrug 5366,2019-06-10,11:00:00,94,52,42,FMN GV 16 Berchem TOT
54,Posthofbrug 5366,2019-06-10,12:00:00,105,61,44,FMN GV 16 Berchem TOT
54,Posthofbrug 5366,2019-06-10,13:00:00,118,72,46,FMN GV 16 Berchem TOT
54,Posthofbrug 5366,2019-06-10,14:00:00,107,61,46,FMN GV 16 Berchem TOT
54,Posthofbrug 5366,2019-06-10,15:00:00,96,51,45,FMN GV 16 Berchem TOT
54,Posthofbrug 5366,2019-06-10,16:00:00,74,31,43,FMN GV 16 Berchem TOT
54,Posthofbrug 5366,2019-06-10,17:00:00,78,46,32,FMN GV 16 Berchem TOT
54,Posthofbrug 5366,2019-06-10,18:00:00,93,41,52,FMN GV 16 Berchem TOT
54,Posthofbrug 5366,2019-06-10,19:00:00,61,29,32,FMN GV 16 Berchem TOT
54,Posthofbrug 5366,2019-06-10,20:00:00,35,23,12,FMN GV 16 Berchem TOT
54,Posthofbrug 5366,2019-06-10,21:00:00,19,7,12,FMN GV 16 Berchem TOT
54,Posthofbrug 5366,2019-06-10,22:00:00,27,14,13,FMN GV 16 Berchem TOT
54,Posthofbrug 5366,2019-06-10,23:00:00,21,6,15,FMN GV 16 Berchem TOT
54,Posthofbrug 5366,2019-06-11,00:00:00,9,2,7,FMN GV 16 Berchem TOT
54,Posthofbrug 5366,2019-06-11,01:00:00,2,0,2,FMN GV 16 Berchem TOT
54,Posthofbrug 5366,2019-06-11,02:00:00,2,0,2,FMN GV 16 Berchem TOT
54,Posthofbrug 5366,2019-06-11,03:00:00,2,2,0,FMN GV 16 Berchem TOT
54,Posthofbrug 5366,2019-06-11,04:00:00,9,7,2,FMN GV 16 Berchem TOT
54,Posthofbrug 5366,2019-06-11,05:00:00,22,12,10,FMN GV 16 Berchem TOT
54,Posthofbrug 5366,2019-06-11,06:00:00,99,81,18,FMN GV 16 Berchem TOT
54,Posthofbrug 5366,2019-06-11,07:00:00,392,292,100,FMN GV 16 Berchem TOT
54,Posthofbrug 5366,2019-06-11,08:00:00,619,425,194,FMN GV 16 Berchem TOT
54,Posthofbrug 5366,2019-06-11,09:00:00,211,131,80,FMN GV 16 Berchem TOT
54,Posthofbrug 5366,2019-06-11,10:00:00,108,70,38,FMN GV 16 Berchem TOT
54,Posthofbrug 5366,2019-06-11,11:00:00,121,68,53,FMN GV 16 Berchem TOT
54,Posthofbrug 5366,2019-06-11,12:00:00,196,105,91,FMN GV 16 Berchem TOT
54,Posthofbrug 5366,2019-06-11,13:00:00,169,78,91,FMN GV 16 Berchem TOT
54,Posthofbrug 5366,2019-06-11,14:00:00,115,50,65,FMN GV 16 Berchem TOT
54,Posthofbrug 5366,2019-06-11,15:00:00,206,81,125,FMN GV 16 Berchem TOT
54,Posthofbrug 5366,2019-06-11,16:00:00,420,165,255,FMN GV 16 Berchem TOT
54,Posthofbrug 5366,2019-06-11,17:00:00,563,179,384,FMN GV 16 Berchem TOT
54,Posthofbrug 5366,2019-06-11,18:00:00,308,97,211,FMN GV 16 Berchem TOT
54,Posthofbrug 5366,2019-06-11,19:00:00,135,48,87,FMN GV 16 Berchem TOT
54,Posthofbrug 5366,2019-06-11,20:00:00,83,44,39,FMN GV 16 Berchem TOT
54,Posthofbrug 5366,2019-06-11,21:00:00,69,31,38,FMN GV 16 Berchem TOT
54,Posthofbrug 5366,2019-06-11,22:00:00,54,14,40,FMN GV 16 Berchem TOT
54,Posthofbrug 5366,2019-06-11,23:00:00,44,12,32,FMN GV 16 Berchem TOT
54,Posthofbrug 5366,2019-06-12,00:00:00,17,4,13,FMN GV 16 Berchem TOT
54,Posthofbrug 5366,2019-06-12,01:00:00,7,2,5,FMN GV 16 Berchem TOT
54,Posthofbrug 5366,2019-06-12,02:00:00,3,1,2,FMN GV 16 Berchem TOT
54,Posthofbrug 5366,2019-06-12,03:00:00,2,0,2,FMN GV 16 Berchem TOT
54,Posthofbrug 5366,2019-06-12,04:00:00,9,7,2,FMN GV 16 Berchem TOT
54,Posthofbrug 5366,2019-06-12,05:00:00,12,9,3,FMN GV 16 Berchem TOT
54,Posthofbrug 5366,2019-06-12,06:00:00,81,70,11,FMN GV 16 Berchem TOT
54,Posthofbrug 5366,2019-06-12,07:00:00,278,208,70,FMN GV 16 Berchem TOT
54,Posthofbrug 5366,2019-06-12,08:00:00,394,251,143,FMN GV 16 Berchem TOT
54,Posthofbrug 5366,2019-06-12,09:00:00,124,80,44,FMN GV 16 Berchem TOT
54,Posthofbrug 5366,2019-06-12,10:00:00,59,38,21,FMN GV 16 Berchem TOT
54,Posthofbrug 5366,2019-06-12,11:00:00,69,34,35,FMN GV 16 Berchem TOT
54,Posthofbrug 5366,2019-06-12,12:00:00,117,61,56,FMN GV 16 Berchem TOT
54,Posthofbrug 5366,2019-06-12,13:00:00,77,39,38,FMN GV 16 Berchem TOT
54,Posthofbrug 5366,2019-06-12,14:00:00,68,28,40,FMN GV 16 Berchem TOT
54,Posthofbrug 5366,2019-06-12,15:00:00,91,40,51,FMN GV 16 Berchem TOT
54,Posthofbrug 5366,2019-06-12,16:00:00,203,88,115,FMN GV 16 Berchem TOT
54,Posthofbrug 5366,2019-06-12,17:00:00,356,146,210,FMN GV 16 Berchem TOT
54,Posthofbrug 5366,2019-06-12,18:00:00,235,81,154,FMN GV 16 Berchem TOT
54,Posthofbrug 5366,2019-06-12,19:00:00,98,34,64,FMN GV 16 Berchem TOT
54,Posthofbrug 5366,2019-06-12,20:00:00,71,32,39,FMN GV 16 Berchem TOT
54,Posthofbrug 5366,2019-06-12,21:00:00,49,24,25,FMN GV 16 Berchem TOT
54,Posthofbrug 5366,2019-06-12,22:00:00,51,23,28,FMN GV 16 Berchem TOT
54,Posthofbrug 5366,2019-06-12,23:00:00,27,6,21,FMN GV 16 Berchem TOT
54,Posthofbrug 5366,2019-06-13,00:00:00,19,3,16,FMN GV 16 Berchem TOT
54,Posthofbrug 5366,2019-06-13,01:00:00,6,4,2,FMN GV 16 Berchem TOT
54,Posthofbrug 5366,2019-06-13,02:00:00,2,0,2,FMN GV 16 Berchem TOT
54,Posthofbrug 5366,2019-06-13,03:00:00,11,6,5,FMN GV 16 Berchem TOT
54,Posthofbrug 5366,2019-06-13,04:00:00,6,5,1,FMN GV 16 Berchem TOT
54,Posthofbrug 5366,2019-06-13,05:00:00,19,14,5,FMN GV 16 Berchem TOT
54,Posthofbrug 5366,2019-06-13,06:00:00,102,89,13,FMN GV 16 Berchem TOT
54,Posthofbrug 5366,2019-06-13,07:00:00,400,276,124,FMN GV 16 Berchem TOT
54,Posthofbrug 5366,2019-06-13,08:00:00,581,374,207,FMN GV 16 Berchem TOT
54,Posthofbrug 5366,2019-06-13,09:00:00,215,149,66,FMN GV 16 Berchem TOT
54,Posthofbrug 5366,2019-06-13,10:00:00,113,69,44,FMN GV 16 Berchem TOT
54,Posthofbrug 5366,2019-06-13,11:00:00,120,62,58,FMN GV 16 Berchem TOT
54,Posthofbrug 5366,2019-06-13,12:00:00,140,69,71,FMN GV 16 Berchem TOT
54,Posthofbrug 5366,2019-06-13,13:00:00,116,42,74,FMN GV 16 Berchem TOT
54,Posthofbrug 5366,2019-06-13,14:00:00,81,29,52,FMN GV 16 Berchem TOT
54,Posthofbrug 5366,2019-06-13,15:00:00,160,56,104,FMN GV 16 Berchem TOT
54,Posthofbrug 5366,2019-06-13,16:00:00,337,116,221,FMN GV 16 Berchem TOT
54,Posthofbrug 5366,2019-06-13,17:00:00,469,160,309,FMN GV 16 Berchem TOT
54,Posthofbrug 5366,2019-06-13,18:00:00,294,99,195,FMN GV 16 Berchem TOT
54,Posthofbrug 5366,2019-06-13,19:00:00,112,39,73,FMN GV 16 Berchem TOT
54,Posthofbrug 5366,2019-06-13,20:00:00,77,25,52,FMN GV 16 Berchem TOT
54,Posthofbrug 5366,2019-06-13,21:00:00,38,22,16,FMN GV 16 Berchem TOT
54,Posthofbrug 5366,2019-06-13,22:00:00,59,18,41,FMN GV 16 Berchem TOT
54,Posthofbrug 5366,2019-06-13,23:00:00,33,9,24,FMN GV 16 Berchem TOT
54,Posthofbrug 5366,2019-06-14,00:00:00,23,7,16,FMN GV 16 Berchem TOT
54,Posthofbrug 5366,2019-06-14,01:00:00,8,1,7,FMN GV 16 Berchem TOT
54,Posthofbrug 5366,2019-06-14,02:00:00,1,0,1,FMN GV 16 Berchem TOT
54,Posthofbrug 5366,2019-06-14,03:00:00,5,4,1,FMN GV 16 Berchem TOT
54,Posthofbrug 5366,2019-06-14,04:00:00,11,7,4,FMN GV 16 Berchem TOT
54,Posthofbrug 5366,2019-06-14,05:00:00,22,18,4,FMN GV 16 Berchem TOT
54,Posthofbrug 5366,2019-06-14,06:00:00,80,64,16,FMN GV 16 Berchem TOT
54,Posthofbrug 5366,2019-06-14,07:00:00,317,231,86,FMN GV 16 Berchem TOT
54,Posthofbrug 5366,2019-06-14,08:00:00,486,325,161,FMN GV 16 Berchem TOT
54,Posthofbrug 5366,2019-06-14,09:00:00,150,102,48,FMN GV 16 Berchem TOT
54,Posthofbrug 5366,2019-06-14,10:00:00,98,66,32,FMN GV 16 Berchem TOT
54,Posthofbrug 5366,2019-06-14,11:00:00,108,58,50,FMN GV 16 Berchem TOT
54,Posthofbrug 5366,2019-06-14,12:00:00,173,101,72,FMN GV 16 Berchem TOT
54,Posthofbrug 5366,2019-06-14,13:00:00,176,81,95,FMN GV 16 Berchem TOT
54,Posthofbrug 5366,2019-06-14,14:00:00,144,70,74,FMN GV 16 Berchem TOT
54,Posthofbrug 5366,2019-06-14,15:00:00,252,110,142,FMN GV 16 Berchem TOT
54,Posthofbrug 5366,2019-06-14,16:00:00,348,156,192,FMN GV 16 Berchem TOT
54,Posthofbrug 5366,2019-06-14,17:00:00,433,171,262,FMN GV 16 Berchem TOT
54,Posthofbrug 5366,2019-06-14,18:00:00,269,94,175,FMN GV 16 Berchem TOT
54,Posthofbrug 5366,2019-06-14,19:00:00,158,71,87,FMN GV 16 Berchem TOT
54,Posthofbrug 5366,2019-06-14,20:00:00,124,69,55,FMN GV 16 Berchem TOT
54,Posthofbrug 5366,2019-06-14,21:00:00,77,37,40,FMN GV 16 Berchem TOT
54,Posthofbrug 5366,2019-06-14,22:00:00,83,30,53,FMN GV 16 Berchem TOT
54,Posthofbrug 5366,2019-06-14,23:00:00,78,23,55,FMN GV 16 Berchem TOT
54,Posthofbrug 5366,2019-06-15,00:00:00,56,18,38,FMN GV 16 Berchem TOT
54,Posthofbrug 5366,2019-06-15,01:00:00,35,9,26,FMN GV 16 Berchem TOT
54,Posthofbrug 5366,2019-06-15,02:00:00,15,2,13,FMN GV 16 Berchem TOT
54,Posthofbrug 5366,2019-06-15,03:00:00,16,4,12,FMN GV 16 Berchem TOT
54,Posthofbrug 5366,2019-06-15,04:00:00,15,8,7,FMN GV 16 Berchem TOT
54,Posthofbrug 5366,2019-06-15,05:00:00,9,5,4,FMN GV 16 Berchem TOT
54,Posthofbrug 5366,2019-06-15,06:00:00,11,10,1,FMN GV 16 Berchem TOT
54,Posthofbrug 5366,2019-06-15,07:00:00,21,12,9,FMN GV 16 Berchem TOT
54,Posthofbrug 5366,2019-06-15,08:00:00,22,20,2,FMN GV 16 Berchem TOT
54,Posthofbrug 5366,2019-06-15,09:00:00,66,46,20,FMN GV 16 Berchem TOT
54,Posthofbrug 5366,2019-06-15,10:00:00,71,45,26,FMN GV 16 Berchem TOT
54,Posthofbrug 5366,2019-06-15,11:00:00,43,25,18,FMN GV 16 Berchem TOT
54,Posthofbrug 5366,2019-06-15,12:00:00,72,40,32,FMN GV 16 Berchem TOT
54,Posthofbrug 5366,2019-06-15,13:00:00,82,50,32,FMN GV 16 Berchem TOT
54,Posthofbrug 5366,2019-06-15,14:00:00,105,57,48,FMN GV 16 Berchem TOT
54,Posthofbrug 5366,2019-06-15,15:00:00,89,40,49,FMN GV 16 Berchem TOT
54,Posthofbrug 5366,2019-06-15,16:00:00,106,39,67,FMN GV 16 Berchem TOT
54,Posthofbrug 5366,2019-06-15,17:00:00,110,50,60,FMN GV 16 Berchem TOT
54,Posthofbrug 5366,2019-06-15,18:00:00,108,57,51,FMN GV 16 Berchem TOT
54,Posthofbrug 5366,2019-06-15,19:00:00,83,43,40,FMN GV 16 Berchem TOT
54,Posthofbrug 5366,2019-06-15,20:00:00,52,25,27,FMN GV 16 Berchem TOT
54,Posthofbrug 5366,2019-06-15,21:00:00,53,29,24,FMN GV 16 Berchem TOT
54,Posthofbrug 5366,2019-06-15,22:00:00,43,18,25,FMN GV 16 Berchem TOT
54,Posthofbrug 5366,2019-06-15,23:00:00,37,13,24,FMN GV 16 Berchem TOT
54,Posthofbrug 5366,2019-06-16,00:00:00,35,14,21,FMN GV 16 Berchem TOT
54,Posthofbrug 5366,2019-06-16,01:00:00,22,6,16,FMN GV 16 Berchem TOT
54,Posthofbrug 5366,2019-06-16,02:00:00,30,13,17,FMN GV 16 Berchem TOT
54,Posthofbrug 5366,2019-06-16,03:00:00,13,4,9,FMN GV 16 Berchem TOT
54,Posthofbrug 5366,2019-06-16,04:00:00,9,3,6,FMN GV 16 Berchem TOT
54,Posthofbrug 5366,2019-06-16,05:00:00,11,4,7,FMN GV 16 Berchem TOT
54,Posthofbrug 5366,2019-06-16,06:00:00,10,8,2,FMN GV 16 Berchem TOT
54,Posthofbrug 5366,2019-06-16,07:00:00,19,10,9,FMN GV 16 Berchem TOT
54,Posthofbrug 5366,2019-06-16,08:00:00,49,22,27,FMN GV 16 Berchem TOT
54,Posthofbrug 5366,2019-06-16,09:00:00,75,48,27,FMN GV 16 Berchem TOT
54,Posthofbrug 5366,2019-06-16,10:00:00,96,61,35,FMN GV 16 Berchem TOT
54,Posthofbrug 5366,2019-06-16,11:00:00,121,60,61,FMN GV 16 Berchem TOT
54,Posthofbrug 5366,2019-06-16,12:00:00,140,73,67,FMN GV 16 Berchem TOT
54,Posthofbrug 5366,2019-06-16,13:00:00,128,64,64,FMN GV 16 Berchem TOT
54,Posthofbrug 5366,2019-06-16,14:00:00,191,96,95,FMN GV 16 Berchem TOT
54,Posthofbrug 5366,2019-06-16,15:00:00,154,72,82,FMN GV 16 Berchem TOT
54,Posthofbrug 5366,2019-06-16,16:00:00,145,61,84,FMN GV 16 Berchem TOT
54,Posthofbrug 5366,2019-06-16,17:00:00,152,75,77,FMN GV 16 Berchem TOT
54,Posthofbrug 5366,2019-06-16,18:00:00,102,56,46,FMN GV 16 Berchem TOT
54,Posthofbrug 5366,2019-06-16,19:00:00,61,39,22,FMN GV 16 Berchem TOT
54,Posthofbrug 5366,2019-06-16,20:00:00,67,25,42,FMN GV 16 Berchem TOT
54,Posthofbrug 5366,2019-06-16,21:00:00,65,31,34,FMN GV 16 Berchem TOT
54,Posthofbrug 5366,2019-06-16,22:00:00,57,31,26,FMN GV 16 Berchem TOT
54,Posthofbrug 5366,2019-06-16,23:00:00,23,10,13,FMN GV 16 Berchem TOT
54,Posthofbrug 5366,2019-06-17,00:00:00,11,4,7,FMN GV 16 Berchem TOT
54,Posthofbrug 5366,2019-06-17,01:00:00,5,1,4,FMN GV 16 Berchem TOT
54,Posthofbrug 5366,2019-06-17,02:00:00,5,1,4,FMN GV 16 Berchem TOT
54,Posthofbrug 5366,2019-06-17,03:00:00,3,1,2,FMN GV 16 Berchem TOT
54,Posthofbrug 5366,2019-06-17,04:00:00,7,6,1,FMN GV 16 Berchem TOT
54,Posthofbrug 5366,2019-06-17,05:00:00,27,20,7,FMN GV 16 Berchem TOT
54,Posthofbrug 5366,2019-06-17,06:00:00,104,88,16,FMN GV 16 Berchem TOT
54,Posthofbrug 5366,2019-06-17,07:00:00,410,299,111,FMN GV 16 Berchem TOT
54,Posthofbrug 5366,2019-06-17,08:00:00,687,460,227,FMN GV 16 Berchem TOT
54,Posthofbrug 5366,2019-06-17,09:00:00,202,138,64,FMN GV 16 Berchem TOT
54,Posthofbrug 5366,2019-06-17,10:00:00,110,59,51,FMN GV 16 Berchem TOT
54,Posthofbrug 5366,2019-06-17,11:00:00,118,70,48,FMN GV 16 Berchem TOT
54,Posthofbrug 5366,2019-06-17,12:00:00,206,118,88,FMN GV 16 Berchem TOT
54,Posthofbrug 5366,2019-06-17,13:00:00,164,77,87,FMN GV 16 Berchem TOT
54,Posthofbrug 5366,2019-06-17,14:00:00,148,59,89,FMN GV 16 Berchem TOT
54,Posthofbrug 5366,2019-06-17,15:00:00,227,78,149,FMN GV 16 Berchem TOT
54,Posthofbrug 5366,2019-06-17,16:00:00,389,158,231,FMN GV 16 Berchem TOT
54,Posthofbrug 5366,2019-06-17,17:00:00,611,222,389,FMN GV 16 Berchem TOT
54,Posthofbrug 5366,2019-06-17,18:00:00,346,113,233,FMN GV 16 Berchem TOT
54,Posthofbrug 5366,2019-06-17,19:00:00,171,63,108,FMN GV 16 Berchem TOT
54,Posthofbrug 5366,2019-06-17,20:00:00,108,49,59,FMN GV 16 Berchem TOT
54,Posthofbrug 5366,2019-06-17,21:00:00,93,42,51,FMN GV 16 Berchem TOT
54,Posthofbrug 5366,2019-06-17,22:00:00,67,22,45,FMN GV 16 Berchem TOT
54,Posthofbrug 5366,2019-06-17,23:00:00,30,6,24,FMN GV 16 Berchem TOT
54,Posthofbrug 5366,2019-06-18,00:00:00,12,3,9,FMN GV 16 Berchem TOT
54,Posthofbrug 5366,2019-06-18,01:00:00,3,0,3,FMN GV 16 Berchem TOT
54,Posthofbrug 5366,2019-06-18,02:00:00,6,1,5,FMN GV 16 Berchem TOT
54,Posthofbrug 5366,2019-06-18,03:00:00,2,2,0,FMN GV 16 Berchem TOT
54,Posthofbrug 5366,2019-06-18,04:00:00,11,9,2,FMN GV 16 Berchem TOT
54,Posthofbrug 5366,2019-06-18,05:00:00,21,18,3,FMN GV 16 Berchem TOT
54,Posthofbrug 5366,2019-06-18,06:00:00,121,89,32,FMN GV 16 Berchem TOT
54,Posthofbrug 5366,2019-06-18,07:00:00,435,314,121,FMN GV 16 Berchem TOT
54,Posthofbrug 5366,2019-06-18,08:00:00,725,510,215,FMN GV 16 Berchem TOT
54,Posthofbrug 5366,2019-06-18,09:00:00,267,171,96,FMN GV 16 Berchem TOT
54,Posthofbrug 5366,2019-06-18,10:00:00,122,75,47,FMN GV 16 Berchem TOT
54,Posthofbrug 5366,2019-06-18,11:00:00,139,81,58,FMN GV 16 Berchem TOT
54,Posthofbrug 5366,2019-06-18,12:00:00,203,95,108,FMN GV 16 Berchem TOT
54,Posthofbrug 5366,2019-06-18,13:00:00,174,81,93,FMN GV 16 Berchem TOT
54,Posthofbrug 5366,2019-06-18,14:00:00,156,62,94,FMN GV 16 Berchem TOT
54,Posthofbrug 5366,2019-06-18,15:00:00,223,95,128,FMN GV 16 Berchem TOT
54,Posthofbrug 5366,2019-06-18,16:00:00,465,173,292,FMN GV 16 Berchem TOT
54,Posthofbrug 5366,2019-06-18,17:00:00,622,219,403,FMN GV 16 Berchem TOT
54,Posthofbrug 5366,2019-06-18,18:00:00,361,120,241,FMN GV 16 Berchem TOT
54,Posthofbrug 5366,2019-06-18,19:00:00,202,83,119,FMN GV 16 Berchem TOT
54,Posthofbrug 5366,2019-06-18,20:00:00,120,54,66,FMN GV 16 Berchem TOT
54,Posthofbrug 5366,2019-06-18,21:00:00,101,42,59,FMN GV 16 Berchem TOT
54,Posthofbrug 5366,2019-06-18,22:00:00,78,24,54,FMN GV 16 Berchem TOT
54,Posthofbrug 5366,2019-06-18,23:00:00,50,15,35,FMN GV 16 Berchem TOT
54,Posthofbrug 5366,2019-06-19,00:00:00,28,7,21,FMN GV 16 Berchem TOT
54,Posthofbrug 5366,2019-06-19,01:00:00,8,1,7,FMN GV 16 Berchem TOT
54,Posthofbrug 5366,2019-06-19,02:00:00,8,0,8,FMN GV 16 Berchem TOT
54,Posthofbrug 5366,2019-06-19,03:00:00,4,3,1,FMN GV 16 Berchem TOT
54,Posthofbrug 5366,2019-06-19,04:00:00,9,5,4,FMN GV 16 Berchem TOT
54,Posthofbrug 5366,2019-06-19,05:00:00,18,14,4,FMN GV 16 Berchem TOT
54,Posthofbrug 5366,2019-06-19,06:00:00,104,84,20,FMN GV 16 Berchem TOT
54,Posthofbrug 5366,2019-06-19,07:00:00,360,260,100,FMN GV 16 Berchem TOT
54,Posthofbrug 5366,2019-06-19,08:00:00,430,291,139,FMN GV 16 Berchem TOT
54,Posthofbrug 5366,2019-06-19,09:00:00,167,101,66,FMN GV 16 Berchem TOT
54,Posthofbrug 5366,2019-06-19,10:00:00,93,55,38,FMN GV 16 Berchem TOT
54,Posthofbrug 5366,2019-06-19,11:00:00,109,54,55,FMN GV 16 Berchem TOT
54,Posthofbrug 5366,2019-06-19,12:00:00,198,86,112,FMN GV 16 Berchem TOT
54,Posthofbrug 5366,2019-06-19,13:00:00,113,56,57,FMN GV 16 Berchem TOT
54,Posthofbrug 5366,2019-06-19,14:00:00,122,56,66,FMN GV 16 Berchem TOT
54,Posthofbrug 5366,2019-06-19,15:00:00,144,67,77,FMN GV 16 Berchem TOT
54,Posthofbrug 5366,2019-06-19,16:00:00,281,108,173,FMN GV 16 Berchem TOT
54,Posthofbrug 5366,2019-06-19,17:00:00,423,151,272,FMN GV 16 Berchem TOT
54,Posthofbrug 5366,2019-06-19,18:00:00,172,61,111,FMN GV 16 Berchem TOT
54,Posthofbrug 5366,2019-06-19,19:00:00,137,42,95,FMN GV 16 Berchem TOT
54,Posthofbrug 5366,2019-06-19,20:00:00,75,27,48,FMN GV 16 Berchem TOT
54,Posthofbrug 5366,2019-06-19,21:00:00,41,17,24,FMN GV 16 Berchem TOT
54,Posthofbrug 5366,2019-06-19,22:00:00,54,21,33,FMN GV 16 Berchem TOT
54,Posthofbrug 5366,2019-06-19,23:00:00,32,7,25,FMN GV 16 Berchem TOT
54,Posthofbrug 5366,2019-06-20,00:00:00,11,3,8,FMN GV 16 Berchem TOT
54,Posthofbrug 5366,2019-06-20,01:00:00,13,0,13,FMN GV 16 Berchem TOT
54,Posthofbrug 5366,2019-06-20,02:00:00,0,0,0,FMN GV 16 Berchem TOT
54,Posthofbrug 5366,2019-06-20,03:00:00,3,2,1,FMN GV 16 Berchem TOT
54,Posthofbrug 5366,2019-06-20,04:00:00,7,4,3,FMN GV 16 Berchem TOT
54,Posthofbrug 5366,2019-06-20,05:00:00,17,12,5,FMN GV 16 Berchem TOT
54,Posthofbrug 5366,2019-06-20,06:00:00,96,78,18,FMN GV 16 Berchem TOT
54,Posthofbrug 5366,2019-06-20,07:00:00,371,251,120,FMN GV 16 Berchem TOT
54,Posthofbrug 5366,2019-06-20,08:00:00,609,418,191,FMN GV 16 Berchem TOT
54,Posthofbrug 5366,2019-06-20,09:00:00,222,137,85,FMN GV 16 Berchem TOT
54,Posthofbrug 5366,2019-06-20,10:00:00,120,77,43,FMN GV 16 Berchem TOT
54,Posthofbrug 5366,2019-06-20,11:00:00,136,56,80,FMN GV 16 Berchem TOT
54,Posthofbrug 5366,2019-06-20,12:00:00,152,90,62,FMN GV 16 Berchem TOT
54,Posthofbrug 5366,2019-06-20,13:00:00,157,87,70,FMN GV 16 Berchem TOT
54,Posthofbrug 5366,2019-06-20,14:00:00,108,59,49,FMN GV 16 Berchem TOT
54,Posthofbrug 5366,2019-06-20,15:00:00,214,77,137,FMN GV 16 Berchem TOT
54,Posthofbrug 5366,2019-06-20,16:00:00,370,144,226,FMN GV 16 Berchem TOT
54,Posthofbrug 5366,2019-06-20,17:00:00,523,193,330,FMN GV 16 Berchem TOT
54,Posthofbrug 5366,2019-06-20,18:00:00,334,100,234,FMN GV 16 Berchem TOT
54,Posthofbrug 5366,2019-06-20,19:00:00,178,77,101,FMN GV 16 Berchem TOT
54,Posthofbrug 5366,2019-06-20,20:00:00,112,44,68,FMN GV 16 Berchem TOT
54,Posthofbrug 5366,2019-06-20,21:00:00,100,44,56,FMN GV 16 Berchem TOT
54,Posthofbrug 5366,2019-06-20,22:00:00,75,33,42,FMN GV 16 Berchem TOT
54,Posthofbrug 5366,2019-06-20,23:00:00,55,16,39,FMN GV 16 Berchem TOT
54,Posthofbrug 5366,2019-06-21,00:00:00,32,6,26,FMN GV 16 Berchem TOT
54,Posthofbrug 5366,2019-06-21,01:00:00,8,2,6,FMN GV 16 Berchem TOT
54,Posthofbrug 5366,2019-06-21,02:00:00,3,1,2,FMN GV 16 Berchem TOT
54,Posthofbrug 5366,2019-06-21,03:00:00,8,3,5,FMN GV 16 Berchem TOT
54,Posthofbrug 5366,2019-06-21,04:00:00,7,6,1,FMN GV 16 Berchem TOT
54,Posthofbrug 5366,2019-06-21,05:00:00,21,17,4,FMN GV 16 Berchem TOT
54,Posthofbrug 5366,2019-06-21,06:00:00,81,64,17,FMN GV 16 Berchem TOT
54,Posthofbrug 5366,2019-06-21,07:00:00,328,241,87,FMN GV 16 Berchem TOT
54,Posthofbrug 5366,2019-06-21,08:00:00,544,348,196,FMN GV 16 Berchem TOT
54,Posthofbrug 5366,2019-06-21,09:00:00,244,164,80,FMN GV 16 Berchem TOT
54,Posthofbrug 5366,2019-06-21,10:00:00,114,75,39,FMN GV 16 Berchem TOT
54,Posthofbrug 5366,2019-06-21,11:00:00,131,79,52,FMN GV 16 Berchem TOT
54,Posthofbrug 5366,2019-06-21,12:00:00,224,124,100,FMN GV 16 Berchem TOT
54,Posthofbrug 5366,2019-06-21,13:00:00,205,108,97,FMN GV 16 Berchem TOT
54,Posthofbrug 5366,2019-06-21,14:00:00,190,89,101,FMN GV 16 Berchem TOT
54,Posthofbrug 5366,2019-06-21,15:00:00,260,106,154,FMN GV 16 Berchem TOT
54,Posthofbrug 5366,2019-06-21,16:00:00,424,168,256,FMN GV 16 Berchem TOT
54,Posthofbrug 5366,2019-06-21,17:00:00,470,197,273,FMN GV 16 Berchem TOT
54,Posthofbrug 5366,2019-06-21,18:00:00,324,143,181,FMN GV 16 Berchem TOT
54,Posthofbrug 5366,2019-06-21,19:00:00,186,87,99,FMN GV 16 Berchem TOT
54,Posthofbrug 5366,2019-06-21,20:00:00,121,59,62,FMN GV 16 Berchem TOT
54,Posthofbrug 5366,2019-06-21,21:00:00,85,34,51,FMN GV 16 Berchem TOT
54,Posthofbrug 5366,2019-06-21,22:00:00,86,20,66,FMN GV 16 Berchem TOT
54,Posthofbrug 5366,2019-06-21,23:00:00,71,18,53,FMN GV 16 Berchem TOT
54,Posthofbrug 5366,2019-06-22,00:00:00,66,32,34,FMN GV 16 Berchem TOT
54,Posthofbrug 5366,2019-06-22,01:00:00,39,16,23,FMN GV 16 Berchem TOT
54,Posthofbrug 5366,2019-06-22,02:00:00,24,5,19,FMN GV 16 Berchem TOT
54,Posthofbrug 5366,2019-06-22,03:00:00,19,5,14,FMN GV 16 Berchem TOT
54,Posthofbrug 5366,2019-06-22,04:00:00,11,3,8,FMN GV 16 Berchem TOT
54,Posthofbrug 5366,2019-06-22,05:00:00,18,9,9,FMN GV 16 Berchem TOT
54,Posthofbrug 5366,2019-06-22,06:00:00,19,7,12,FMN GV 16 Berchem TOT
54,Posthofbrug 5366,2019-06-22,07:00:00,29,20,9,FMN GV 16 Berchem TOT
54,Posthofbrug 5366,2019-06-22,08:00:00,57,36,21,FMN GV 16 Berchem TOT
54,Posthofbrug 5366,2019-06-22,09:00:00,102,69,33,FMN GV 16 Berchem TOT
54,Posthofbrug 5366,2019-06-22,10:00:00,157,103,54,FMN GV 16 Berchem TOT
54,Posthofbrug 5366,2019-06-22,11:00:00,122,85,37,FMN GV 16 Berchem TOT
54,Posthofbrug 5366,2019-06-22,12:00:00,170,104,66,FMN GV 16 Berchem TOT
54,Posthofbrug 5366,2019-06-22,13:00:00,183,104,79,FMN GV 16 Berchem TOT
54,Posthofbrug 5366,2019-06-22,14:00:00,200,104,96,FMN GV 16 Berchem TOT
54,Posthofbrug 5366,2019-06-22,15:00:00,172,99,73,FMN GV 16 Berchem TOT
54,Posthofbrug 5366,2019-06-22,16:00:00,216,96,120,FMN GV 16 Berchem TOT
54,Posthofbrug 5366,2019-06-22,17:00:00,183,83,100,FMN GV 16 Berchem TOT
54,Posthofbrug 5366,2019-06-22,18:00:00,141,68,73,FMN GV 16 Berchem TOT
54,Posthofbrug 5366,2019-06-22,19:00:00,104,55,49,FMN GV 16 Berchem TOT
54,Posthofbrug 5366,2019-06-22,20:00:00,85,35,50,FMN GV 16 Berchem TOT
54,Posthofbrug 5366,2019-06-22,21:00:00,73,37,36,FMN GV 16 Berchem TOT
54,Posthofbrug 5366,2019-06-22,22:00:00,65,22,43,FMN GV 16 Berchem TOT
54,Posthofbrug 5366,2019-06-22,23:00:00,61,27,34,FMN GV 16 Berchem TOT
54,Posthofbrug 5366,2019-06-23,00:00:00,49,17,32,FMN GV 16 Berchem TOT
54,Posthofbrug 5366,2019-06-23,01:00:00,15,7,8,FMN GV 16 Berchem TOT
54,Posthofbrug 5366,2019-06-23,02:00:00,18,8,10,FMN GV 16 Berchem TOT
54,Posthofbrug 5366,2019-06-23,03:00:00,13,1,12,FMN GV 16 Berchem TOT
54,Posthofbrug 5366,2019-06-23,04:00:00,26,5,21,FMN GV 16 Berchem TOT
54,Posthofbrug 5366,2019-06-23,05:00:00,9,5,4,FMN GV 16 Berchem TOT
54,Posthofbrug 5366,2019-06-23,06:00:00,23,16,7,FMN GV 16 Berchem TOT
54,Posthofbrug 5366,2019-06-23,07:00:00,33,20,13,FMN GV 16 Berchem TOT
54,Posthofbrug 5366,2019-06-23,08:00:00,53,40,13,FMN GV 16 Berchem TOT
54,Posthofbrug 5366,2019-06-23,09:00:00,83,55,28,FMN GV 16 Berchem TOT
54,Posthofbrug 5366,2019-06-23,10:00:00,125,75,50,FMN GV 16 Berchem TOT
54,Posthofbrug 5366,2019-06-23,11:00:00,123,76,47,FMN GV 16 Berchem TOT
54,Posthofbrug 5366,2019-06-23,12:00:00,190,88,102,FMN GV 16 Berchem TOT
54,Posthofbrug 5366,2019-06-23,13:00:00,152,78,74,FMN GV 16 Berchem TOT
54,Posthofbrug 5366,2019-06-23,14:00:00,304,116,188,FMN GV 16 Berchem TOT
54,Posthofbrug 5366,2019-06-23,15:00:00,173,81,92,FMN GV 16 Berchem TOT
54,Posthofbrug 5366,2019-06-23,16:00:00,181,115,66,FMN GV 16 Berchem TOT
54,Posthofbrug 5366,2019-06-23,17:00:00,151,65,86,FMN GV 16 Berchem TOT
54,Posthofbrug 5366,2019-06-23,18:00:00,122,48,74,FMN GV 16 Berchem TOT
54,Posthofbrug 5366,2019-06-23,19:00:00,98,30,68,FMN GV 16 Berchem TOT
54,Posthofbrug 5366,2019-06-23,20:00:00,92,51,41,FMN GV 16 Berchem TOT
54,Posthofbrug 5366,2019-06-23,21:00:00,89,45,44,FMN GV 16 Berchem TOT
54,Posthofbrug 5366,2019-06-23,22:00:00,62,31,31,FMN GV 16 Berchem TOT
54,Posthofbrug 5366,2019-06-23,23:00:00,27,11,16,FMN GV 16 Berchem TOT
54,Posthofbrug 5366,2019-06-24,00:00:00,16,5,11,FMN GV 16 Berchem TOT
54,Posthofbrug 5366,2019-06-24,01:00:00,5,2,3,FMN GV 16 Berchem TOT
54,Posthofbrug 5366,2019-06-24,02:00:00,8,4,4,FMN GV 16 Berchem TOT
54,Posthofbrug 5366,2019-06-24,03:00:00,3,1,2,FMN GV 16 Berchem TOT
54,Posthofbrug 5366,2019-06-24,04:00:00,5,2,3,FMN GV 16 Berchem TOT
54,Posthofbrug 5366,2019-06-24,05:00:00,25,16,9,FMN GV 16 Berchem TOT
54,Posthofbrug 5366,2019-06-24,06:00:00,114,99,15,FMN GV 16 Berchem TOT
54,Posthofbrug 5366,2019-06-24,07:00:00,420,304,116,FMN GV 16 Berchem TOT
54,Posthofbrug 5366,2019-06-24,08:00:00,677,435,242,FMN GV 16 Berchem TOT
54,Posthofbrug 5366,2019-06-24,09:00:00,275,179,96,FMN GV 16 Berchem TOT
54,Posthofbrug 5366,2019-06-24,10:00:00,100,74,26,FMN GV 16 Berchem TOT
54,Posthofbrug 5366,2019-06-24,11:00:00,141,85,56,FMN GV 16 Berchem TOT
54,Posthofbrug 5366,2019-06-24,12:00:00,141,68,73,FMN GV 16 Berchem TOT
54,Posthofbrug 5366,2019-06-24,13:00:00,151,72,79,FMN GV 16 Berchem TOT
54,Posthofbrug 5366,2019-06-24,14:00:00,133,69,64,FMN GV 16 Berchem TOT
54,Posthofbrug 5366,2019-06-24,15:00:00,240,88,152,FMN GV 16 Berchem TOT
54,Posthofbrug 5366,2019-06-24,16:00:00,404,139,265,FMN GV 16 Berchem TOT
54,Posthofbrug 5366,2019-06-24,17:00:00,576,189,387,FMN GV 16 Berchem TOT
54,Posthofbrug 5366,2019-06-24,18:00:00,377,136,241,FMN GV 16 Berchem TOT
54,Posthofbrug 5366,2019-06-24,19:00:00,192,75,117,FMN GV 16 Berchem TOT
54,Posthofbrug 5366,2019-06-24,20:00:00,129,63,66,FMN GV 16 Berchem TOT
54,Posthofbrug 5366,2019-06-24,21:00:00,102,46,56,FMN GV 16 Berchem TOT
54,Posthofbrug 5366,2019-06-24,22:00:00,92,39,53,FMN GV 16 Berchem TOT
54,Posthofbrug 5366,2019-06-24,23:00:00,43,15,28,FMN GV 16 Berchem TOT
54,Posthofbrug 5366,2019-06-25,00:00:00,29,8,21,FMN GV 16 Berchem TOT
54,Posthofbrug 5366,2019-06-25,01:00:00,13,2,11,FMN GV 16 Berchem TOT
54,Posthofbrug 5366,2019-06-25,02:00:00,10,0,10,FMN GV 16 Berchem TOT
54,Posthofbrug 5366,2019-06-25,03:00:00,6,2,4,FMN GV 16 Berchem TOT
54,Posthofbrug 5366,2019-06-25,04:00:00,16,3,13,FMN GV 16 Berchem TOT
54,Posthofbrug 5366,2019-06-25,05:00:00,38,28,10,FMN GV 16 Berchem TOT
54,Posthofbrug 5366,2019-06-25,06:00:00,121,96,25,FMN GV 16 Berchem TOT
54,Posthofbrug 5366,2019-06-25,07:00:00,399,308,91,FMN GV 16 Berchem TOT
54,Posthofbrug 5366,2019-06-25,08:00:00,629,412,217,FMN GV 16 Berchem TOT
54,Posthofbrug 5366,2019-06-25,09:00:00,237,165,72,FMN GV 16 Berchem TOT
54,Posthofbrug 5366,2019-06-25,10:00:00,152,96,56,FMN GV 16 Berchem TOT
54,Posthofbrug 5366,2019-06-25,11:00:00,103,63,40,FMN GV 16 Berchem TOT
54,Posthofbrug 5366,2019-06-25,12:00:00,147,79,68,FMN GV 16 Berchem TOT
54,Posthofbrug 5366,2019-06-25,13:00:00,147,73,74,FMN GV 16 Berchem TOT
54,Posthofbrug 5366,2019-06-25,14:00:00,136,52,84,FMN GV 16 Berchem TOT
54,Posthofbrug 5366,2019-06-25,15:00:00,226,70,156,FMN GV 16 Berchem TOT
54,Posthofbrug 5366,2019-06-25,16:00:00,379,138,241,FMN GV 16 Berchem TOT
54,Posthofbrug 5366,2019-06-25,17:00:00,557,211,346,FMN GV 16 Berchem TOT
54,Posthofbrug 5366,2019-06-25,18:00:00,337,118,219,FMN GV 16 Berchem TOT
54,Posthofbrug 5366,2019-06-25,19:00:00,178,72,106,FMN GV 16 Berchem TOT
54,Posthofbrug 5366,2019-06-25,20:00:00,115,39,76,FMN GV 16 Berchem TOT
54,Posthofbrug 5366,2019-06-25,21:00:00,91,39,52,FMN GV 16 Berchem TOT
54,Posthofbrug 5366,2019-06-25,22:00:00,79,27,52,FMN GV 16 Berchem TOT
54,Posthofbrug 5366,2019-06-25,23:00:00,75,32,43,FMN GV 16 Berchem TOT
54,Posthofbrug 5366,2019-06-26,00:00:00,32,8,24,FMN GV 16 Berchem TOT
54,Posthofbrug 5366,2019-06-26,01:00:00,20,11,9,FMN GV 16 Berchem TOT
54,Posthofbrug 5366,2019-06-26,02:00:00,12,5,7,FMN GV 16 Berchem TOT
54,Posthofbrug 5366,2019-06-26,03:00:00,7,2,5,FMN GV 16 Berchem TOT
54,Posthofbrug 5366,2019-06-26,04:00:00,24,8,16,FMN GV 16 Berchem TOT
54,Posthofbrug 5366,2019-06-26,05:00:00,23,16,7,FMN GV 16 Berchem TOT
54,Posthofbrug 5366,2019-06-26,06:00:00,106,85,21,FMN GV 16 Berchem TOT
54,Posthofbrug 5366,2019-06-26,07:00:00,328,244,84,FMN GV 16 Berchem TOT
54,Posthofbrug 5366,2019-06-26,08:00:00,476,301,175,FMN GV 16 Berchem TOT
54,Posthofbrug 5366,2019-06-26,09:00:00,211,147,64,FMN GV 16 Berchem TOT
54,Posthofbrug 5366,2019-06-26,10:00:00,94,63,31,FMN GV 16 Berchem TOT
54,Posthofbrug 5366,2019-06-26,11:00:00,125,72,53,FMN GV 16 Berchem TOT
54,Posthofbrug 5366,2019-06-26,12:00:00,208,97,111,FMN GV 16 Berchem TOT
54,Posthofbrug 5366,2019-06-26,13:00:00,177,87,90,FMN GV 16 Berchem TOT
54,Posthofbrug 5366,2019-06-26,14:00:00,139,75,64,FMN GV 16 Berchem TOT
54,Posthofbrug 5366,2019-06-26,15:00:00,176,82,94,FMN GV 16 Berchem TOT
54,Posthofbrug 5366,2019-06-26,16:00:00,348,152,196,FMN GV 16 Berchem TOT
54,Posthofbrug 5366,2019-06-26,17:00:00,526,213,313,FMN GV 16 Berchem TOT
54,Posthofbrug 5366,2019-06-26,18:00:00,392,146,246,FMN GV 16 Berchem TOT
54,Posthofbrug 5366,2019-06-26,19:00:00,158,66,92,FMN GV 16 Berchem TOT
54,Posthofbrug 5366,2019-06-26,20:00:00,108,48,60,FMN GV 16 Berchem TOT
54,Posthofbrug 5366,2019-06-26,21:00:00,119,53,66,FMN GV 16 Berchem TOT
54,Posthofbrug 5366,2019-06-26,22:00:00,75,33,42,FMN GV 16 Berchem TOT
54,Posthofbrug 5366,2019-06-26,23:00:00,67,24,43,FMN GV 16 Berchem TOT
54,Posthofbrug 5366,2019-06-27,00:00:00,34,7,27,FMN GV 16 Berchem TOT
54,Posthofbrug 5366,2019-06-27,01:00:00,25,5,20,FMN GV 16 Berchem TOT
54,Posthofbrug 5366,2019-06-27,02:00:00,10,2,8,FMN GV 16 Berchem TOT
54,Posthofbrug 5366,2019-06-27,03:00:00,5,3,2,FMN GV 16 Berchem TOT
54,Posthofbrug 5366,2019-06-27,04:00:00,7,6,1,FMN GV 16 Berchem TOT
54,Posthofbrug 5366,2019-06-27,05:00:00,32,24,8,FMN GV 16 Berchem TOT
54,Posthofbrug 5366,2019-06-27,06:00:00,84,62,22,FMN GV 16 Berchem TOT
54,Posthofbrug 5366,2019-06-27,07:00:00,315,228,87,FMN GV 16 Berchem TOT
54,Posthofbrug 5366,2019-06-27,08:00:00,549,377,172,FMN GV 16 Berchem TOT
54,Posthofbrug 5366,2019-06-27,09:00:00,225,144,81,FMN GV 16 Berchem TOT
54,Posthofbrug 5366,2019-06-27,10:00:00,146,106,40,FMN GV 16 Berchem TOT
54,Posthofbrug 5366,2019-06-27,11:00:00,115,68,47,FMN GV 16 Berchem TOT
54,Posthofbrug 5366,2019-06-27,12:00:00,181,92,89,FMN GV 16 Berchem TOT
54,Posthofbrug 5366,2019-06-27,13:00:00,142,63,79,FMN GV 16 Berchem TOT
54,Posthofbrug 5366,2019-06-27,14:00:00,159,66,93,FMN GV 16 Berchem TOT
54,Posthofbrug 5366,2019-06-27,15:00:00,250,103,147,FMN GV 16 Berchem TOT
54,Posthofbrug 5366,2019-06-27,16:00:00,428,173,255,FMN GV 16 Berchem TOT
54,Posthofbrug 5366,2019-06-27,17:00:00,513,185,328,FMN GV 16 Berchem TOT
54,Posthofbrug 5366,2019-06-27,18:00:00,366,125,241,FMN GV 16 Berchem TOT
54,Posthofbrug 5366,2019-06-27,19:00:00,182,80,102,FMN GV 16 Berchem TOT
54,Posthofbrug 5366,2019-06-27,20:00:00,136,56,80,FMN GV 16 Berchem TOT
54,Posthofbrug 5366,2019-06-27,21:00:00,91,37,54,FMN GV 16 Berchem TOT
54,Posthofbrug 5366,2019-06-27,22:00:00,99,28,71,FMN GV 16 Berchem TOT
54,Posthofbrug 5366,2019-06-27,23:00:00,61,22,39,FMN GV 16 Berchem TOT
54,Posthofbrug 5366,2019-06-28,00:00:00,35,5,30,FMN GV 16 Berchem TOT
54,Posthofbrug 5366,2019-06-28,01:00:00,9,1,8,FMN GV 16 Berchem TOT
54,Posthofbrug 5366,2019-06-28,02:00:00,10,1,9,FMN GV 16 Berchem TOT
54,Posthofbrug 5366,2019-06-28,03:00:00,9,0,9,FMN GV 16 Berchem TOT
54,Posthofbrug 5366,2019-06-28,04:00:00,11,7,4,FMN GV 16 Berchem TOT
54,Posthofbrug 5366,2019-06-28,05:00:00,18,12,6,FMN GV 16 Berchem TOT
54,Posthofbrug 5366,2019-06-28,06:00:00,68,56,12,FMN GV 16 Berchem TOT
54,Posthofbrug 5366,2019-06-28,07:00:00,221,168,53,FMN GV 16 Berchem TOT
54,Posthofbrug 5366,2019-06-28,08:00:00,422,268,154,FMN GV 16 Berchem TOT
54,Posthofbrug 5366,2019-06-28,09:00:00,204,139,65,FMN GV 16 Berchem TOT
54,Posthofbrug 5366,2019-06-28,10:00:00,118,77,41,FMN GV 16 Berchem TOT
54,Posthofbrug 5366,2019-06-28,11:00:00,142,77,65,FMN GV 16 Berchem TOT
54,Posthofbrug 5366,2019-06-28,12:00:00,192,108,84,FMN GV 16 Berchem TOT
54,Posthofbrug 5366,2019-06-28,13:00:00,164,80,84,FMN GV 16 Berchem TOT
54,Posthofbrug 5366,2019-06-28,14:00:00,132,62,70,FMN GV 16 Berchem TOT
54,Posthofbrug 5366,2019-06-28,15:00:00,225,86,139,FMN GV 16 Berchem TOT
54,Posthofbrug 5366,2019-06-28,16:00:00,342,143,199,FMN GV 16 Berchem TOT
54,Posthofbrug 5366,2019-06-28,17:00:00,417,161,256,FMN GV 16 Berchem TOT
54,Posthofbrug 5366,2019-06-28,18:00:00,264,114,150,FMN GV 16 Berchem TOT
54,Posthofbrug 5366,2019-06-28,19:00:00,149,81,68,FMN GV 16 Berchem TOT
54,Posthofbrug 5366,2019-06-28,20:00:00,108,47,61,FMN GV 16 Berchem TOT
54,Posthofbrug 5366,2019-06-28,21:00:00,98,31,67,FMN GV 16 Berchem TOT
54,Posthofbrug 5366,2019-06-28,22:00:00,82,34,48,FMN GV 16 Berchem TOT
54,Posthofbrug 5366,2019-06-28,23:00:00,65,22,43,FMN GV 16 Berchem TOT
54,Posthofbrug 5366,2019-06-29,00:00:00,47,19,28,FMN GV 16 Berchem TOT
54,Posthofbrug 5366,2019-06-29,01:00:00,40,12,28,FMN GV 16 Berchem TOT
54,Posthofbrug 5366,2019-06-29,02:00:00,19,5,14,FMN GV 16 Berchem TOT
54,Posthofbrug 5366,2019-06-29,03:00:00,15,1,14,FMN GV 16 Berchem TOT
54,Posthofbrug 5366,2019-06-29,04:00:00,12,5,7,FMN GV 16 Berchem TOT
54,Posthofbrug 5366,2019-06-29,05:00:00,14,8,6,FMN GV 16 Berchem TOT
54,Posthofbrug 5366,2019-06-29,06:00:00,13,8,5,FMN GV 16 Berchem TOT
54,Posthofbrug 5366,2019-06-29,07:00:00,22,13,9,FMN GV 16 Berchem TOT
54,Posthofbrug 5366,2019-06-29,08:00:00,53,37,16,FMN GV 16 Berchem TOT
54,Posthofbrug 5366,2019-06-29,09:00:00,96,67,29,FMN GV 16 Berchem TOT
54,Posthofbrug 5366,2019-06-29,10:00:00,126,84,42,FMN GV 16 Berchem TOT
54,Posthofbrug 5366,2019-06-29,11:00:00,117,78,39,FMN GV 16 Berchem TOT
54,Posthofbrug 5366,2019-06-29,12:00:00,111,61,50,FMN GV 16 Berchem TOT
54,Posthofbrug 5366,2019-06-29,13:00:00,133,55,78,FMN GV 16 Berchem TOT
54,Posthofbrug 5366,2019-06-29,14:00:00,128,73,55,FMN GV 16 Berchem TOT
54,Posthofbrug 5366,2019-06-29,15:00:00,150,80,70,FMN GV 16 Berchem TOT
54,Posthofbrug 5366,2019-06-29,16:00:00,120,42,78,FMN GV 16 Berchem TOT
54,Posthofbrug 5366,2019-06-29,17:00:00,120,57,63,FMN GV 16 Berchem TOT
54,Posthofbrug 5366,2019-06-29,18:00:00,141,47,94,FMN GV 16 Berchem TOT
54,Posthofbrug 5366,2019-06-29,19:00:00,100,61,39,FMN GV 16 Berchem TOT
54,Posthofbrug 5366,2019-06-29,20:00:00,64,39,25,FMN GV 16 Berchem TOT
54,Posthofbrug 5366,2019-06-29,21:00:00,80,45,35,FMN GV 16 Berchem TOT
54,Posthofbrug 5366,2019-06-29,22:00:00,61,29,32,FMN GV 16 Berchem TOT
54,Posthofbrug 5366,2019-06-29,23:00:00,41,14,27,FMN GV 16 Berchem TOT
54,Posthofbrug 5366,2019-06-30,00:00:00,32,12,20,FMN GV 16 Berchem TOT
54,Posthofbrug 5366,2019-06-30,01:00:00,18,8,10,FMN GV 16 Berchem TOT
54,Posthofbrug 5366,2019-06-30,02:00:00,16,4,12,FMN GV 16 Berchem TOT
54,Posthofbrug 5366,2019-06-30,03:00:00,15,5,10,FMN GV 16 Berchem TOT
54,Posthofbrug 5366,2019-06-30,04:00:00,16,1,15,FMN GV 16 Berchem TOT
54,Posthofbrug 5366,2019-06-30,05:00:00,10,6,4,FMN GV 16 Berchem TOT
54,Posthofbrug 5366,2019-06-30,06:00:00,12,8,4,FMN GV 16 Berchem TOT
54,Posthofbrug 5366,2019-06-30,07:00:00,12,8,4,FMN GV 16 Berchem TOT
54,Posthofbrug 5366,2019-06-30,08:00:00,37,28,9,FMN GV 16 Berchem TOT
54,Posthofbrug 5366,2019-06-30,09:00:00,76,44,32,FMN GV 16 Berchem TOT
54,Posthofbrug 5366,2019-06-30,10:00:00,86,59,27,FMN GV 16 Berchem TOT
54,Posthofbrug 5366,2019-06-30,11:00:00,117,76,41,FMN GV 16 Berchem TOT
54,Posthofbrug 5366,2019-06-30,12:00:00,102,62,40,FMN GV 16 Berchem TOT
54,Posthofbrug 5366,2019-06-30,13:00:00,154,80,74,FMN GV 16 Berchem TOT
54,Posthofbrug 5366,2019-06-30,14:00:00,144,79,65,FMN GV 16 Berchem TOT
54,Posthofbrug 5366,2019-06-30,15:00:00,153,90,63,FMN GV 16 Berchem TOT
54,Posthofbrug 5366,2019-06-30,16:00:00,98,34,64,FMN GV 16 Berchem TOT
54,Posthofbrug 5366,2019-06-30,17:00:00,135,70,65,FMN GV 16 Berchem TOT
54,Posthofbrug 5366,2019-06-30,18:00:00,146,59,87,FMN GV 16 Berchem TOT
54,Posthofbrug 5366,2019-06-30,19:00:00,89,52,37,FMN GV 16 Berchem TOT
54,Posthofbrug 5366,2019-06-30,20:00:00,75,44,31,FMN GV 16 Berchem TOT
54,Posthofbrug 5366,2019-06-30,21:00:00,67,36,31,FMN GV 16 Berchem TOT
54,Posthofbrug 5366,2019-06-30,22:00:00,54,22,32,FMN GV 16 Berchem TOT
54,Posthofbrug 5366,2019-06-30,23:00:00,34,12,22,FMN GV 16 Berchem TOT
54,Posthofbrug 5366,2019-07-01,00:00:00,11,3,8,FMN GV 16 Berchem TOT
54,Posthofbrug 5366,2019-07-01,01:00:00,3,1,2,FMN GV 16 Berchem TOT
54,Posthofbrug 5366,2019-07-01,02:00:00,4,1,3,FMN GV 16 Berchem TOT
54,Posthofbrug 5366,2019-07-01,03:00:00,1,1,0,FMN GV 16 Berchem TOT
54,Posthofbrug 5366,2019-07-01,04:00:00,9,6,3,FMN GV 16 Berchem TOT
54,Posthofbrug 5366,2019-07-01,05:00:00,16,13,3,FMN GV 16 Berchem TOT
54,Posthofbrug 5366,2019-07-01,06:00:00,74,68,6,FMN GV 16 Berchem TOT
54,Posthofbrug 5366,2019-07-01,07:00:00,242,158,84,FMN GV 16 Berchem TOT
54,Posthofbrug 5366,2019-07-01,08:00:00,433,290,143,FMN GV 16 Berchem TOT
54,Posthofbrug 5366,2019-07-01,09:00:00,213,144,69,FMN GV 16 Berchem TOT
54,Posthofbrug 5366,2019-07-01,10:00:00,98,75,23,FMN GV 16 Berchem TOT
54,Posthofbrug 5366,2019-07-01,11:00:00,125,63,62,FMN GV 16 Berchem TOT
54,Posthofbrug 5366,2019-07-01,12:00:00,141,84,57,FMN GV 16 Berchem TOT
54,Posthofbrug 5366,2019-07-01,13:00:00,169,95,74,FMN GV 16 Berchem TOT
54,Posthofbrug 5366,2019-07-01,14:00:00,124,59,65,FMN GV 16 Berchem TOT
54,Posthofbrug 5366,2019-07-01,15:00:00,172,60,112,FMN GV 16 Berchem TOT
54,Posthofbrug 5366,2019-07-01,16:00:00,352,150,202,FMN GV 16 Berchem TOT
54,Posthofbrug 5366,2019-07-01,17:00:00,501,187,314,FMN GV 16 Berchem TOT
54,Posthofbrug 5366,2019-07-01,18:00:00,322,116,206,FMN GV 16 Berchem TOT
54,Posthofbrug 5366,2019-07-01,19:00:00,171,69,102,FMN GV 16 Berchem TOT
54,Posthofbrug 5366,2019-07-01,20:00:00,116,54,62,FMN GV 16 Berchem TOT
54,Posthofbrug 5366,2019-07-01,21:00:00,57,20,37,FMN GV 16 Berchem TOT
54,Posthofbrug 5366,2019-07-01,22:00:00,56,23,33,FMN GV 16 Berchem TOT
54,Posthofbrug 5366,2019-07-01,23:00:00,29,7,22,FMN GV 16 Berchem TOT
54,Posthofbrug 5366,2019-07-02,00:00:00,13,1,12,FMN GV 16 Berchem TOT
54,Posthofbrug 5366,2019-07-02,01:00:00,8,4,4,FMN GV 16 Berchem TOT
54,Posthofbrug 5366,2019-07-02,02:00:00,3,1,2,FMN GV 16 Berchem TOT
54,Posthofbrug 5366,2019-07-02,03:00:00,5,4,1,FMN GV 16 Berchem TOT
54,Posthofbrug 5366,2019-07-02,04:00:00,2,2,0,FMN GV 16 Berchem TOT
54,Posthofbrug 5366,2019-07-02,05:00:00,17,9,8,FMN GV 16 Berchem TOT
54,Posthofbrug 5366,2019-07-02,06:00:00,84,65,19,FMN GV 16 Berchem TOT
54,Posthofbrug 5366,2019-07-02,07:00:00,260,190,70,FMN GV 16 Berchem TOT
54,Posthofbrug 5366,2019-07-02,08:00:00,450,270,180,FMN GV 16 Berchem TOT
54,Posthofbrug 5366,2019-07-02,09:00:00,234,159,75,FMN GV 16 Berchem TOT
54,Posthofbrug 5366,2019-07-02,10:00:00,108,65,43,FMN GV 16 Berchem TOT
54,Posthofbrug 5366,2019-07-02,11:00:00,105,69,36,FMN GV 16 Berchem TOT
54,Posthofbrug 5366,2019-07-02,12:00:00,134,83,51,FMN GV 16 Berchem TOT
54,Posthofbrug 5366,2019-07-02,13:00:00,131,66,65,FMN GV 16 Berchem TOT
54,Posthofbrug 5366,2019-07-02,14:00:00,128,67,61,FMN GV 16 Berchem TOT
54,Posthofbrug 5366,2019-07-02,15:00:00,180,60,120,FMN GV 16 Berchem TOT
54,Posthofbrug 5366,2019-07-02,16:00:00,376,164,212,FMN GV 16 Berchem TOT
54,Posthofbrug 5366,2019-07-02,17:00:00,518,185,333,FMN GV 16 Berchem TOT
54,Posthofbrug 5366,2019-07-02,18:00:00,343,135,208,FMN GV 16 Berchem TOT
54,Posthofbrug 5366,2019-07-02,19:00:00,154,54,100,FMN GV 16 Berchem TOT
54,Posthofbrug 5366,2019-07-02,20:00:00,96,43,53,FMN GV 16 Berchem TOT
54,Posthofbrug 5366,2019-07-02,21:00:00,75,27,48,FMN GV 16 Berchem TOT
54,Posthofbrug 5366,2019-07-02,22:00:00,71,17,54,FMN GV 16 Berchem TOT
54,Posthofbrug 5366,2019-07-02,23:00:00,37,10,27,FMN GV 16 Berchem TOT
54,Posthofbrug 5366,2019-07-03,00:00:00,18,6,12,FMN GV 16 Berchem TOT
54,Posthofbrug 5366,2019-07-03,01:00:00,4,1,3,FMN GV 16 Berchem TOT
54,Posthofbrug 5366,2019-07-03,02:00:00,5,3,2,FMN GV 16 Berchem TOT
54,Posthofbrug 5366,2019-07-03,03:00:00,1,1,0,FMN GV 16 Berchem TOT
54,Posthofbrug 5366,2019-07-03,04:00:00,4,3,1,FMN GV 16 Berchem TOT
54,Posthofbrug 5366,2019-07-03,05:00:00,14,12,2,FMN GV 16 Berchem TOT
54,Posthofbrug 5366,2019-07-03,06:00:00,85,68,17,FMN GV 16 Berchem TOT
54,Posthofbrug 5366,2019-07-03,07:00:00,205,146,59,FMN GV 16 Berchem TOT
54,Posthofbrug 5366,2019-07-03,08:00:00,399,255,144,FMN GV 16 Berchem TOT
54,Posthofbrug 5366,2019-07-03,09:00:00,216,141,75,FMN GV 16 Berchem TOT
54,Posthofbrug 5366,2019-07-03,10:00:00,121,80,41,FMN GV 16 Berchem TOT
54,Posthofbrug 5366,2019-07-03,11:00:00,113,60,53,FMN GV 16 Berchem TOT
54,Posthofbrug 5366,2019-07-03,12:00:00,141,82,59,FMN GV 16 Berchem TOT
54,Posthofbrug 5366,2019-07-03,13:00:00,148,76,72,FMN GV 16 Berchem TOT
54,Posthofbrug 5366,2019-07-03,14:00:00,132,60,72,FMN GV 16 Berchem TOT
54,Posthofbrug 5366,2019-07-03,15:00:00,143,56,87,FMN GV 16 Berchem TOT
54,Posthofbrug 5366,2019-07-03,16:00:00,358,149,209,FMN GV 16 Berchem TOT
54,Posthofbrug 5366,2019-07-03,17:00:00,489,172,317,FMN GV 16 Berchem TOT
54,Posthofbrug 5366,2019-07-03,18:00:00,328,132,196,FMN GV 16 Berchem TOT
54,Posthofbrug 5366,2019-07-03,19:00:00,158,79,79,FMN GV 16 Berchem TOT
54,Posthofbrug 5366,2019-07-03,20:00:00,79,42,37,FMN GV 16 Berchem TOT
54,Posthofbrug 5366,2019-07-03,21:00:00,83,42,41,FMN GV 16 Berchem TOT
54,Posthofbrug 5366,2019-07-03,22:00:00,76,31,45,FMN GV 16 Berchem TOT
54,Posthofbrug 5366,2019-07-03,23:00:00,66,18,48,FMN GV 16 Berchem TOT
54,Posthofbrug 5366,2019-07-04,00:00:00,21,7,14,FMN GV 16 Berchem TOT
54,Posthofbrug 5366,2019-07-04,01:00:00,9,3,6,FMN GV 16 Berchem TOT
54,Posthofbrug 5366,2019-07-04,02:00:00,7,0,7,FMN GV 16 Berchem TOT
54,Posthofbrug 5366,2019-07-04,03:00:00,4,2,2,FMN GV 16 Berchem TOT
54,Posthofbrug 5366,2019-07-04,04:00:00,3,2,1,FMN GV 16 Berchem TOT
54,Posthofbrug 5366,2019-07-04,05:00:00,16,10,6,FMN GV 16 Berchem TOT
54,Posthofbrug 5366,2019-07-04,06:00:00,79,66,13,FMN GV 16 Berchem TOT
54,Posthofbrug 5366,2019-07-04,07:00:00,223,160,63,FMN GV 16 Berchem TOT
54,Posthofbrug 5366,2019-07-04,08:00:00,384,260,124,FMN GV 16 Berchem TOT
54,Posthofbrug 5366,2019-07-04,09:00:00,201,131,70,FMN GV 16 Berchem TOT
54,Posthofbrug 5366,2019-07-04,10:00:00,95,62,33,FMN GV 16 Berchem TOT
54,Posthofbrug 5366,2019-07-04,11:00:00,103,67,36,FMN GV 16 Berchem TOT
54,Posthofbrug 5366,2019-07-04,12:00:00,138,76,62,FMN GV 16 Berchem TOT
54,Posthofbrug 5366,2019-07-04,13:00:00,144,58,86,FMN GV 16 Berchem TOT
54,Posthofbrug 5366,2019-07-04,14:00:00,128,63,65,FMN GV 16 Berchem TOT
54,Posthofbrug 5366,2019-07-04,15:00:00,182,75,107,FMN GV 16 Berchem TOT
54,Posthofbrug 5366,2019-07-04,16:00:00,355,119,236,FMN GV 16 Berchem TOT
54,Posthofbrug 5366,2019-07-04,17:00:00,470,197,273,FMN GV 16 Berchem TOT
54,Posthofbrug 5366,2019-07-04,18:00:00,334,123,211,FMN GV 16 Berchem TOT
54,Posthofbrug 5366,2019-07-04,19:00:00,149,67,82,FMN GV 16 Berchem TOT
54,Posthofbrug 5366,2019-07-04,20:00:00,98,36,62,FMN GV 16 Berchem TOT
54,Posthofbrug 5366,2019-07-04,21:00:00,79,31,48,FMN GV 16 Berchem TOT
54,Posthofbrug 5366,2019-07-04,22:00:00,71,28,43,FMN GV 16 Berchem TOT
54,Posthofbrug 5366,2019-07-04,23:00:00,65,23,42,FMN GV 16 Berchem TOT
54,Posthofbrug 5366,2019-07-05,00:00:00,30,7,23,FMN GV 16 Berchem TOT
54,Posthofbrug 5366,2019-07-05,01:00:00,7,3,4,FMN GV 16 Berchem TOT
54,Posthofbrug 5366,2019-07-05,02:00:00,6,0,6,FMN GV 16 Berchem TOT
54,Posthofbrug 5366,2019-07-05,03:00:00,4,1,3,FMN GV 16 Berchem TOT
54,Posthofbrug 5366,2019-07-05,04:00:00,3,1,2,FMN GV 16 Berchem TOT
54,Posthofbrug 5366,2019-07-05,05:00:00,18,14,4,FMN GV 16 Berchem TOT
54,Posthofbrug 5366,2019-07-05,06:00:00,56,49,7,FMN GV 16 Berchem TOT
54,Posthofbrug 5366,2019-07-05,07:00:00,217,155,62,FMN GV 16 Berchem TOT
54,Posthofbrug 5366,2019-07-05,08:00:00,358,225,133,FMN GV 16 Berchem TOT
54,Posthofbrug 5366,2019-07-05,09:00:00,195,137,58,FMN GV 16 Berchem TOT
54,Posthofbrug 5366,2019-07-05,10:00:00,100,69,31,FMN GV 16 Berchem TOT
54,Posthofbrug 5366,2019-07-05,11:00:00,138,84,54,FMN GV 16 Berchem TOT
54,Posthofbrug 5366,2019-07-05,12:00:00,136,82,54,FMN GV 16 Berchem TOT
54,Posthofbrug 5366,2019-07-05,13:00:00,189,101,88,FMN GV 16 Berchem TOT
54,Posthofbrug 5366,2019-07-05,14:00:00,141,67,74,FMN GV 16 Berchem TOT
54,Posthofbrug 5366,2019-07-05,15:00:00,203,100,103,FMN GV 16 Berchem TOT
54,Posthofbrug 5366,2019-07-05,16:00:00,349,143,206,FMN GV 16 Berchem TOT
54,Posthofbrug 5366,2019-07-05,17:00:00,358,152,206,FMN GV 16 Berchem TOT
54,Posthofbrug 5366,2019-07-05,18:00:00,279,134,145,FMN GV 16 Berchem TOT
54,Posthofbrug 5366,2019-07-05,19:00:00,132,62,70,FMN GV 16 Berchem TOT
54,Posthofbrug 5366,2019-07-05,20:00:00,85,43,42,FMN GV 16 Berchem TOT
54,Posthofbrug 5366,2019-07-05,21:00:00,52,21,31,FMN GV 16 Berchem TOT
54,Posthofbrug 5366,2019-07-05,22:00:00,59,19,40,FMN GV 16 Berchem TOT
54,Posthofbrug 5366,2019-07-05,23:00:00,50,11,39,FMN GV 16 Berchem TOT
54,Posthofbrug 5366,2019-07-06,00:00:00,38,11,27,FMN GV 16 Berchem TOT
54,Posthofbrug 5366,2019-07-06,01:00:00,20,3,17,FMN GV 16 Berchem TOT
54,Posthofbrug 5366,2019-07-06,02:00:00,13,4,9,FMN GV 16 Berchem TOT
54,Posthofbrug 5366,2019-07-06,03:00:00,9,2,7,FMN GV 16 Berchem TOT
54,Posthofbrug 5366,2019-07-06,04:00:00,12,4,8,FMN GV 16 Berchem TOT
54,Posthofbrug 5366,2019-07-06,05:00:00,9,4,5,FMN GV 16 Berchem TOT
54,Posthofbrug 5366,2019-07-06,06:00:00,8,6,2,FMN GV 16 Berchem TOT
54,Posthofbrug 5366,2019-07-06,07:00:00,9,6,3,FMN GV 16 Berchem TOT
54,Posthofbrug 5366,2019-07-06,08:00:00,40,23,17,FMN GV 16 Berchem TOT
54,Posthofbrug 5366,2019-07-06,09:00:00,65,51,14,FMN GV 16 Berchem TOT
54,Posthofbrug 5366,2019-07-06,10:00:00,111,67,44,FMN GV 16 Berchem TOT
54,Posthofbrug 5366,2019-07-06,11:00:00,117,75,42,FMN GV 16 Berchem TOT
54,Posthofbrug 5366,2019-07-06,12:00:00,135,77,58,FMN GV 16 Berchem TOT
54,Posthofbrug 5366,2019-07-06,13:00:00,113,78,35,FMN GV 16 Berchem TOT
54,Posthofbrug 5366,2019-07-06,14:00:00,130,76,54,FMN GV 16 Berchem TOT
54,Posthofbrug 5366,2019-07-06,15:00:00,139,85,54,FMN GV 16 Berchem TOT
54,Posthofbrug 5366,2019-07-06,16:00:00,137,58,79,FMN GV 16 Berchem TOT
54,Posthofbrug 5366,2019-07-06,17:00:00,127,42,85,FMN GV 16 Berchem TOT
54,Posthofbrug 5366,2019-07-06,18:00:00,124,46,78,FMN GV 16 Berchem TOT
54,Posthofbrug 5366,2019-07-06,19:00:00,85,41,44,FMN GV 16 Berchem TOT
54,Posthofbrug 5366,2019-07-06,20:00:00,64,41,23,FMN GV 16 Berchem TOT
54,Posthofbrug 5366,2019-07-06,21:00:00,51,19,32,FMN GV 16 Berchem TOT
54,Posthofbrug 5366,2019-07-06,22:00:00,41,6,35,FMN GV 16 Berchem TOT
54,Posthofbrug 5366,2019-07-06,23:00:00,45,9,36,FMN GV 16 Berchem TOT
54,Posthofbrug 5366,2019-07-07,00:00:00,24,9,15,FMN GV 16 Berchem TOT
54,Posthofbrug 5366,2019-07-07,01:00:00,21,4,17,FMN GV 16 Berchem TOT
54,Posthofbrug 5366,2019-07-07,02:00:00,7,1,6,FMN GV 16 Berchem TOT
54,Posthofbrug 5366,2019-07-07,03:00:00,6,3,3,FMN GV 16 Berchem TOT
54,Posthofbrug 5366,2019-07-07,04:00:00,7,0,7,FMN GV 16 Berchem TOT
54,Posthofbrug 5366,2019-07-07,05:00:00,8,3,5,FMN GV 16 Berchem TOT
54,Posthofbrug 5366,2019-07-07,06:00:00,8,6,2,FMN GV 16 Berchem TOT
54,Posthofbrug 5366,2019-07-07,07:00:00,16,6,10,FMN GV 16 Berchem TOT
54,Posthofbrug 5366,2019-07-07,08:00:00,29,17,12,FMN GV 16 Berchem TOT
54,Posthofbrug 5366,2019-07-07,09:00:00,74,54,20,FMN GV 16 Berchem TOT
54,Posthofbrug 5366,2019-07-07,10:00:00,81,51,30,FMN GV 16 Berchem TOT
54,Posthofbrug 5366,2019-07-07,11:00:00,119,73,46,FMN GV 16 Berchem TOT
54,Posthofbrug 5366,2019-07-07,12:00:00,135,87,48,FMN GV 16 Berchem TOT
54,Posthofbrug 5366,2019-07-07,13:00:00,172,117,55,FMN GV 16 Berchem TOT
54,Posthofbrug 5366,2019-07-07,14:00:00,167,96,71,FMN GV 16 Berchem TOT
54,Posthofbrug 5366,2019-07-07,15:00:00,177,88,89,FMN GV 16 Berchem TOT
54,Posthofbrug 5366,2019-07-07,16:00:00,122,41,81,FMN GV 16 Berchem TOT
54,Posthofbrug 5366,2019-07-07,17:00:00,170,53,117,FMN GV 16 Berchem TOT
54,Posthofbrug 5366,2019-07-07,18:00:00,129,53,76,FMN GV 16 Berchem TOT
54,Posthofbrug 5366,2019-07-07,19:00:00,80,32,48,FMN GV 16 Berchem TOT
54,Posthofbrug 5366,2019-07-07,20:00:00,62,27,35,FMN GV 16 Berchem TOT
54,Posthofbrug 5366,2019-07-07,21:00:00,50,21,29,FMN GV 16 Berchem TOT
54,Posthofbrug 5366,2019-07-07,22:00:00,52,16,36,FMN GV 16 Berchem TOT
54,Posthofbrug 5366,2019-07-07,23:00:00,17,5,12,FMN GV 16 Berchem TOT
54,Posthofbrug 5366,2019-07-08,00:00:00,16,3,13,FMN GV 16 Berchem TOT
54,Posthofbrug 5366,2019-07-08,01:00:00,3,0,3,FMN GV 16 Berchem TOT
54,Posthofbrug 5366,2019-07-08,02:00:00,1,1,0,FMN GV 16 Berchem TOT
54,Posthofbrug 5366,2019-07-08,03:00:00,3,0,3,FMN GV 16 Berchem TOT
54,Posthofbrug 5366,2019-07-08,04:00:00,6,6,0,FMN GV 16 Berchem TOT
54,Posthofbrug 5366,2019-07-08,05:00:00,14,13,1,FMN GV 16 Berchem TOT
54,Posthofbrug 5366,2019-07-08,06:00:00,77,68,9,FMN GV 16 Berchem TOT
54,Posthofbrug 5366,2019-07-08,07:00:00,215,155,60,FMN GV 16 Berchem TOT
54,Posthofbrug 5366,2019-07-08,08:00:00,357,230,127,FMN GV 16 Berchem TOT
54,Posthofbrug 5366,2019-07-08,09:00:00,187,121,66,FMN GV 16 Berchem TOT
54,Posthofbrug 5366,2019-07-08,10:00:00,81,49,32,FMN GV 16 Berchem TOT
54,Posthofbrug 5366,2019-07-08,11:00:00,89,66,23,FMN GV 16 Berchem TOT
54,Posthofbrug 5366,2019-07-08,12:00:00,100,56,44,FMN GV 16 Berchem TOT
54,Posthofbrug 5366,2019-07-08,13:00:00,101,57,44,FMN GV 16 Berchem TOT
54,Posthofbrug 5366,2019-07-08,14:00:00,107,51,56,FMN GV 16 Berchem TOT
54,Posthofbrug 5366,2019-07-08,15:00:00,157,69,88,FMN GV 16 Berchem TOT
54,Posthofbrug 5366,2019-07-08,16:00:00,290,117,173,FMN GV 16 Berchem TOT
54,Posthofbrug 5366,2019-07-08,17:00:00,418,160,258,FMN GV 16 Berchem TOT
54,Posthofbrug 5366,2019-07-08,18:00:00,265,83,182,FMN GV 16 Berchem TOT
54,Posthofbrug 5366,2019-07-08,19:00:00,97,37,60,FMN GV 16 Berchem TOT
54,Posthofbrug 5366,2019-07-08,20:00:00,67,27,40,FMN GV 16 Berchem TOT
54,Posthofbrug 5366,2019-07-08,21:00:00,45,18,27,FMN GV 16 Berchem TOT
54,Posthofbrug 5366,2019-07-08,22:00:00,33,14,19,FMN GV 16 Berchem TOT
54,Posthofbrug 5366,2019-07-08,23:00:00,28,12,16,FMN GV 16 Berchem TOT
54,Posthofbrug 5366,2019-07-09,00:00:00,16,3,13,FMN GV 16 Berchem TOT
54,Posthofbrug 5366,2019-07-09,01:00:00,6,0,6,FMN GV 16 Berchem TOT
54,Posthofbrug 5366,2019-07-09,02:00:00,5,2,3,FMN GV 16 Berchem TOT
54,Posthofbrug 5366,2019-07-09,03:00:00,4,2,2,FMN GV 16 Berchem TOT
54,Posthofbrug 5366,2019-07-09,04:00:00,6,6,0,FMN GV 16 Berchem TOT
54,Posthofbrug 5366,2019-07-09,05:00:00,18,14,4,FMN GV 16 Berchem TOT
54,Posthofbrug 5366,2019-07-09,06:00:00,91,73,18,FMN GV 16 Berchem TOT
54,Posthofbrug 5366,2019-07-09,07:00:00,238,164,74,FMN GV 16 Berchem TOT
54,Posthofbrug 5366,2019-07-09,08:00:00,397,261,136,FMN GV 16 Berchem TOT
54,Posthofbrug 5366,2019-07-09,09:00:00,215,137,78,FMN GV 16 Berchem TOT
54,Posthofbrug 5366,2019-07-09,10:00:00,86,50,36,FMN GV 16 Berchem TOT
54,Posthofbrug 5366,2019-07-09,11:00:00,94,55,39,FMN GV 16 Berchem TOT
54,Posthofbrug 5366,2019-07-09,12:00:00,137,83,54,FMN GV 16 Berchem TOT
54,Posthofbrug 5366,2019-07-09,13:00:00,138,77,61,FMN GV 16 Berchem TOT
54,Posthofbrug 5366,2019-07-09,14:00:00,111,63,48,FMN GV 16 Berchem TOT
54,Posthofbrug 5366,2019-07-09,15:00:00,167,70,97,FMN GV 16 Berchem TOT
54,Posthofbrug 5366,2019-07-09,16:00:00,357,159,198,FMN GV 16 Berchem TOT
54,Posthofbrug 5366,2019-07-09,17:00:00,471,171,300,FMN GV 16 Berchem TOT
54,Posthofbrug 5366,2019-07-09,18:00:00,310,105,205,FMN GV 16 Berchem TOT
54,Posthofbrug 5366,2019-07-09,19:00:00,144,56,88,FMN GV 16 Berchem TOT
54,Posthofbrug 5366,2019-07-09,20:00:00,111,49,62,FMN GV 16 Berchem TOT
54,Posthofbrug 5366,2019-07-09,21:00:00,56,24,32,FMN GV 16 Berchem TOT
54,Posthofbrug 5366,2019-07-09,22:00:00,60,18,42,FMN GV 16 Berchem TOT
54,Posthofbrug 5366,2019-07-09,23:00:00,43,11,32,FMN GV 16 Berchem TOT
54,Posthofbrug 5366,2019-07-10,00:00:00,33,5,28,FMN GV 16 Berchem TOT
54,Posthofbrug 5366,2019-07-10,01:00:00,11,10,1,FMN GV 16 Berchem TOT
54,Posthofbrug 5366,2019-07-10,02:00:00,6,3,3,FMN GV 16 Berchem TOT
54,Posthofbrug 5366,2019-07-10,03:00:00,6,1,5,FMN GV 16 Berchem TOT
54,Posthofbrug 5366,2019-07-10,04:00:00,10,9,1,FMN GV 16 Berchem TOT
54,Posthofbrug 5366,2019-07-10,05:00:00,17,15,2,FMN GV 16 Berchem TOT
54,Posthofbrug 5366,2019-07-10,06:00:00,73,63,10,FMN GV 16 Berchem TOT
54,Posthofbrug 5366,2019-07-10,07:00:00,235,169,66,FMN GV 16 Berchem TOT
54,Posthofbrug 5366,2019-07-10,08:00:00,418,257,161,FMN GV 16 Berchem TOT
54,Posthofbrug 5366,2019-07-10,09:00:00,288,102,186,FMN GV 16 Berchem TOT
54,Posthofbrug 5366,2019-07-10,10:00:00,88,54,34,FMN GV 16 Berchem TOT
54,Posthofbrug 5366,2019-07-10,11:00:00,92,54,38,FMN GV 16 Berchem TOT
54,Posthofbrug 5366,2019-07-10,12:00:00,135,67,68,FMN GV 16 Berchem TOT
54,Posthofbrug 5366,2019-07-10,13:00:00,132,55,77,FMN GV 16 Berchem TOT
54,Posthofbrug 5366,2019-07-10,14:00:00,103,53,50,FMN GV 16 Berchem TOT
54,Posthofbrug 5366,2019-07-10,15:00:00,146,69,77,FMN GV 16 Berchem TOT
54,Posthofbrug 5366,2019-07-10,16:00:00,294,156,138,FMN GV 16 Berchem TOT
54,Posthofbrug 5366,2019-07-10,17:00:00,383,141,242,FMN GV 16 Berchem TOT
54,Posthofbrug 5366,2019-07-10,18:00:00,296,106,190,FMN GV 16 Berchem TOT
54,Posthofbrug 5366,2019-07-10,19:00:00,112,51,61,FMN GV 16 Berchem TOT
54,Posthofbrug 5366,2019-07-10,20:00:00,93,54,39,FMN GV 16 Berchem TOT
54,Posthofbrug 5366,2019-07-10,21:00:00,62,34,28,FMN GV 16 Berchem TOT
54,Posthofbrug 5366,2019-07-10,22:00:00,49,25,24,FMN GV 16 Berchem TOT
54,Posthofbrug 5366,2019-07-10,23:00:00,65,24,41,FMN GV 16 Berchem TOT
54,Posthofbrug 5366,2019-07-11,00:00:00,23,5,18,FMN GV 16 Berchem TOT
54,Posthofbrug 5366,2019-07-11,01:00:00,14,2,12,FMN GV 16 Berchem TOT
54,Posthofbrug 5366,2019-07-11,02:00:00,3,1,2,FMN GV 16 Berchem TOT
54,Posthofbrug 5366,2019-07-11,03:00:00,6,1,5,FMN GV 16 Berchem TOT
54,Posthofbrug 5366,2019-07-11,04:00:00,6,5,1,FMN GV 16 Berchem TOT
54,Posthofbrug 5366,2019-07-11,05:00:00,17,15,2,FMN GV 16 Berchem TOT
54,Posthofbrug 5366,2019-07-11,06:00:00,65,54,11,FMN GV 16 Berchem TOT
54,Posthofbrug 5366,2019-07-11,07:00:00,182,127,55,FMN GV 16 Berchem TOT
54,Posthofbrug 5366,2019-07-11,08:00:00,275,173,102,FMN GV 16 Berchem TOT
54,Posthofbrug 5366,2019-07-11,09:00:00,153,93,60,FMN GV 16 Berchem TOT
54,Posthofbrug 5366,2019-07-11,10:00:00,83,58,25,FMN GV 16 Berchem TOT
54,Posthofbrug 5366,2019-07-11,11:00:00,83,50,33,FMN GV 16 Berchem TOT
54,Posthofbrug 5366,2019-07-11,12:00:00,100,63,37,FMN GV 16 Berchem TOT
54,Posthofbrug 5366,2019-07-11,13:00:00,117,66,51,FMN GV 16 Berchem TOT
54,Posthofbrug 5366,2019-07-11,14:00:00,114,60,54,FMN GV 16 Berchem TOT
54,Posthofbrug 5366,2019-07-11,15:00:00,131,56,75,FMN GV 16 Berchem TOT
54,Posthofbrug 5366,2019-07-11,16:00:00,233,111,122,FMN GV 16 Berchem TOT
54,Posthofbrug 5366,2019-07-11,17:00:00,338,137,201,FMN GV 16 Berchem TOT
54,Posthofbrug 5366,2019-07-11,18:00:00,279,118,161,FMN GV 16 Berchem TOT
54,Posthofbrug 5366,2019-07-11,19:00:00,115,50,65,FMN GV 16 Berchem TOT
54,Posthofbrug 5366,2019-07-11,20:00:00,80,42,38,FMN GV 16 Berchem TOT
54,Posthofbrug 5366,2019-07-11,21:00:00,73,34,39,FMN GV 16 Berchem TOT
54,Posthofbrug 5366,2019-07-11,22:00:00,63,21,42,FMN GV 16 Berchem TOT
54,Posthofbrug 5366,2019-07-11,23:00:00,43,7,36,FMN GV 16 Berchem TOT
54,Posthofbrug 5366,2019-07-12,00:00:00,36,12,24,FMN GV 16 Berchem TOT
54,Posthofbrug 5366,2019-07-12,01:00:00,12,1,11,FMN GV 16 Berchem TOT
54,Posthofbrug 5366,2019-07-12,02:00:00,4,1,3,FMN GV 16 Berchem TOT
54,Posthofbrug 5366,2019-07-12,03:00:00,7,3,4,FMN GV 16 Berchem TOT
54,Posthofbrug 5366,2019-07-12,04:00:00,9,7,2,FMN GV 16 Berchem TOT
54,Posthofbrug 5366,2019-07-12,05:00:00,17,10,7,FMN GV 16 Berchem TOT
54,Posthofbrug 5366,2019-07-12,06:00:00,60,50,10,FMN GV 16 Berchem TOT
54,Posthofbrug 5366,2019-07-12,07:00:00,155,105,50,FMN GV 16 Berchem TOT
54,Posthofbrug 5366,2019-07-12,08:00:00,251,157,94,FMN GV 16 Berchem TOT
54,Posthofbrug 5366,2019-07-12,09:00:00,155,87,68,FMN GV 16 Berchem TOT
54,Posthofbrug 5366,2019-07-12,10:00:00,68,46,22,FMN GV 16 Berchem TOT
54,Posthofbrug 5366,2019-07-12,11:00:00,101,63,38,FMN GV 16 Berchem TOT
54,Posthofbrug 5366,2019-07-12,12:00:00,72,33,39,FMN GV 16 Berchem TOT
54,Posthofbrug 5366,2019-07-12,13:00:00,106,55,51,FMN GV 16 Berchem TOT
54,Posthofbrug 5366,2019-07-12,14:00:00,70,30,40,FMN GV 16 Berchem TOT
54,Posthofbrug 5366,2019-07-12,15:00:00,118,48,70,FMN GV 16 Berchem TOT
54,Posthofbrug 5366,2019-07-12,16:00:00,193,96,97,FMN GV 16 Berchem TOT
54,Posthofbrug 5366,2019-07-12,17:00:00,256,118,138,FMN GV 16 Berchem TOT
54,Posthofbrug 5366,2019-07-12,18:00:00,174,70,104,FMN GV 16 Berchem TOT
54,Posthofbrug 5366,2019-07-12,19:00:00,91,52,39,FMN GV 16 Berchem TOT
54,Posthofbrug 5366,2019-07-12,20:00:00,58,28,30,FMN GV 16 Berchem TOT
54,Posthofbrug 5366,2019-07-12,21:00:00,49,24,25,FMN GV 16 Berchem TOT
54,Posthofbrug 5366,2019-07-12,22:00:00,56,20,36,FMN GV 16 Berchem TOT
54,Posthofbrug 5366,2019-07-12,23:00:00,35,11,24,FMN GV 16 Berchem TOT
54,Posthofbrug 5366,2019-07-13,00:00:00,29,12,17,FMN GV 16 Berchem TOT
54,Posthofbrug 5366,2019-07-13,01:00:00,14,5,9,FMN GV 16 Berchem TOT
54,Posthofbrug 5366,2019-07-13,02:00:00,11,1,10,FMN GV 16 Berchem TOT
54,Posthofbrug 5366,2019-07-13,03:00:00,8,1,7,FMN GV 16 Berchem TOT
54,Posthofbrug 5366,2019-07-13,04:00:00,11,5,6,FMN GV 16 Berchem TOT
54,Posthofbrug 5366,2019-07-13,05:00:00,6,5,1,FMN GV 16 Berchem TOT
54,Posthofbrug 5366,2019-07-13,06:00:00,10,6,4,FMN GV 16 Berchem TOT
54,Posthofbrug 5366,2019-07-13,07:00:00,19,14,5,FMN GV 16 Berchem TOT
54,Posthofbrug 5366,2019-07-13,08:00:00,28,22,6,FMN GV 16 Berchem TOT
54,Posthofbrug 5366,2019-07-13,09:00:00,30,25,5,FMN GV 16 Berchem TOT
54,Posthofbrug 5366,2019-07-13,10:00:00,47,33,14,FMN GV 16 Berchem TOT
54,Posthofbrug 5366,2019-07-13,11:00:00,56,29,27,FMN GV 16 Berchem TOT
54,Posthofbrug 5366,2019-07-13,12:00:00,73,51,22,FMN GV 16 Berchem TOT
54,Posthofbrug 5366,2019-07-13,13:00:00,81,51,30,FMN GV 16 Berchem TOT
54,Posthofbrug 5366,2019-07-13,14:00:00,114,57,57,FMN GV 16 Berchem TOT
54,Posthofbrug 5366,2019-07-13,15:00:00,88,39,49,FMN GV 16 Berchem TOT
54,Posthofbrug 5366,2019-07-13,16:00:00,84,36,48,FMN GV 16 Berchem TOT
54,Posthofbrug 5366,2019-07-13,17:00:00,89,36,53,FMN GV 16 Berchem TOT
54,Posthofbrug 5366,2019-07-13,18:00:00,96,42,54,FMN GV 16 Berchem TOT
54,Posthofbrug 5366,2019-07-13,19:00:00,69,28,41,FMN GV 16 Berchem TOT
54,Posthofbrug 5366,2019-07-13,20:00:00,59,26,33,FMN GV 16 Berchem TOT
54,Posthofbrug 5366,2019-07-13,21:00:00,33,13,20,FMN GV 16 Berchem TOT
54,Posthofbrug 5366,2019-07-13,22:00:00,34,14,20,FMN GV 16 Berchem TOT
54,Posthofbrug 5366,2019-07-13,23:00:00,29,13,16,FMN GV 16 Berchem TOT
54,Posthofbrug 5366,2019-07-14,00:00:00,19,7,12,FMN GV 16 Berchem TOT
54,Posthofbrug 5366,2019-07-14,01:00:00,19,9,10,FMN GV 16 Berchem TOT
54,Posthofbrug 5366,2019-07-14,02:00:00,4,1,3,FMN GV 16 Berchem TOT
54,Posthofbrug 5366,2019-07-14,03:00:00,11,3,8,FMN GV 16 Berchem TOT
54,Posthofbrug 5366,2019-07-14,04:00:00,7,3,4,FMN GV 16 Berchem TOT
54,Posthofbrug 5366,2019-07-14,05:00:00,8,1,7,FMN GV 16 Berchem TOT
54,Posthofbrug 5366,2019-07-14,06:00:00,7,2,5,FMN GV 16 Berchem TOT
54,Posthofbrug 5366,2019-07-14,07:00:00,8,3,5,FMN GV 16 Berchem TOT
54,Posthofbrug 5366,2019-07-14,08:00:00,21,13,8,FMN GV 16 Berchem TOT
54,Posthofbrug 5366,2019-07-14,09:00:00,47,29,18,FMN GV 16 Berchem TOT
54,Posthofbrug 5366,2019-07-14,10:00:00,62,38,24,FMN GV 16 Berchem TOT
54,Posthofbrug 5366,2019-07-14,11:00:00,76,37,39,FMN GV 16 Berchem TOT
54,Posthofbrug 5366,2019-07-14,12:00:00,74,43,31,FMN GV 16 Berchem TOT
54,Posthofbrug 5366,2019-07-14,13:00:00,62,34,28,FMN GV 16 Berchem TOT
54,Posthofbrug 5366,2019-07-14,14:00:00,95,47,48,FMN GV 16 Berchem TOT
54,Posthofbrug 5366,2019-07-14,15:00:00,104,49,55,FMN GV 16 Berchem TOT
54,Posthofbrug 5366,2019-07-14,16:00:00,118,48,70,FMN GV 16 Berchem TOT
54,Posthofbrug 5366,2019-07-14,17:00:00,92,50,42,FMN GV 16 Berchem TOT
54,Posthofbrug 5366,2019-07-14,18:00:00,73,34,39,FMN GV 16 Berchem TOT
54,Posthofbrug 5366,2019-07-14,19:00:00,56,23,33,FMN GV 16 Berchem TOT
54,Posthofbrug 5366,2019-07-14,20:00:00,53,21,32,FMN GV 16 Berchem TOT
54,Posthofbrug 5366,2019-07-14,21:00:00,40,24,16,FMN GV 16 Berchem TOT
54,Posthofbrug 5366,2019-07-14,22:00:00,29,12,17,FMN GV 16 Berchem TOT
54,Posthofbrug 5366,2019-07-14,23:00:00,16,3,13,FMN GV 16 Berchem TOT
54,Posthofbrug 5366,2019-07-15,00:00:00,9,2,7,FMN GV 16 Berchem TOT
54,Posthofbrug 5366,2019-07-15,01:00:00,8,4,4,FMN GV 16 Berchem TOT
54,Posthofbrug 5366,2019-07-15,02:00:00,3,1,2,FMN GV 16 Berchem TOT
54,Posthofbrug 5366,2019-07-15,03:00:00,2,1,1,FMN GV 16 Berchem TOT
54,Posthofbrug 5366,2019-07-15,04:00:00,10,9,1,FMN GV 16 Berchem TOT
54,Posthofbrug 5366,2019-07-15,05:00:00,13,13,0,FMN GV 16 Berchem TOT
54,Posthofbrug 5366,2019-07-15,06:00:00,77,61,16,FMN GV 16 Berchem TOT
54,Posthofbrug 5366,2019-07-15,07:00:00,244,174,70,FMN GV 16 Berchem TOT
54,Posthofbrug 5366,2019-07-15,08:00:00,347,230,117,FMN GV 16 Berchem TOT
54,Posthofbrug 5366,2019-07-15,09:00:00,169,118,51,FMN GV 16 Berchem TOT
54,Posthofbrug 5366,2019-07-15,10:00:00,81,42,39,FMN GV 16 Berchem TOT
54,Posthofbrug 5366,2019-07-15,11:00:00,68,40,28,FMN GV 16 Berchem TOT
54,Posthofbrug 5366,2019-07-15,12:00:00,95,62,33,FMN GV 16 Berchem TOT
54,Posthofbrug 5366,2019-07-15,13:00:00,81,44,37,FMN GV 16 Berchem TOT
54,Posthofbrug 5366,2019-07-15,14:00:00,99,47,52,FMN GV 16 Berchem TOT
54,Posthofbrug 5366,2019-07-15,15:00:00,119,51,68,FMN GV 16 Berchem TOT
54,Posthofbrug 5366,2019-07-15,16:00:00,299,115,184,FMN GV 16 Berchem TOT
54,Posthofbrug 5366,2019-07-15,17:00:00,371,138,233,FMN GV 16 Berchem TOT
54,Posthofbrug 5366,2019-07-15,18:00:00,242,95,147,FMN GV 16 Berchem TOT
54,Posthofbrug 5366,2019-07-15,19:00:00,122,52,70,FMN GV 16 Berchem TOT
54,Posthofbrug 5366,2019-07-15,20:00:00,64,29,35,FMN GV 16 Berchem TOT
54,Posthofbrug 5366,2019-07-15,21:00:00,40,18,22,FMN GV 16 Berchem TOT
54,Posthofbrug 5366,2019-07-15,22:00:00,33,17,16,FMN GV 16 Berchem TOT
54,Posthofbrug 5366,2019-07-15,23:00:00,20,2,18,FMN GV 16 Berchem TOT
54,Posthofbrug 5366,2019-07-16,00:00:00,12,1,11,FMN GV 16 Berchem TOT
54,Posthofbrug 5366,2019-07-16,01:00:00,3,1,2,FMN GV 16 Berchem TOT
54,Posthofbrug 5366,2019-07-16,02:00:00,3,3,0,FMN GV 16 Berchem TOT
54,Posthofbrug 5366,2019-07-16,03:00:00,5,1,4,FMN GV 16 Berchem TOT
54,Posthofbrug 5366,2019-07-16,04:00:00,7,5,2,FMN GV 16 Berchem TOT
54,Posthofbrug 5366,2019-07-16,05:00:00,11,8,3,FMN GV 16 Berchem TOT
54,Posthofbrug 5366,2019-07-16,06:00:00,90,72,18,FMN GV 16 Berchem TOT
54,Posthofbrug 5366,2019-07-16,07:00:00,302,217,85,FMN GV 16 Berchem TOT
54,Posthofbrug 5366,2019-07-16,08:00:00,377,230,147,FMN GV 16 Berchem TOT
54,Posthofbrug 5366,2019-07-16,09:00:00,172,109,63,FMN GV 16 Berchem TOT
54,Posthofbrug 5366,2019-07-16,10:00:00,90,53,37,FMN GV 16 Berchem TOT
54,Posthofbrug 5366,2019-07-16,11:00:00,91,58,33,FMN GV 16 Berchem TOT
54,Posthofbrug 5366,2019-07-16,12:00:00,127,80,47,FMN GV 16 Berchem TOT
54,Posthofbrug 5366,2019-07-16,13:00:00,107,58,49,FMN GV 16 Berchem TOT
54,Posthofbrug 5366,2019-07-16,14:00:00,111,57,54,FMN GV 16 Berchem TOT
54,Posthofbrug 5366,2019-07-16,15:00:00,143,63,80,FMN GV 16 Berchem TOT
54,Posthofbrug 5366,2019-07-16,16:00:00,313,134,179,FMN GV 16 Berchem TOT
54,Posthofbrug 5366,2019-07-16,17:00:00,456,177,279,FMN GV 16 Berchem TOT
54,Posthofbrug 5366,2019-07-16,18:00:00,269,80,189,FMN GV 16 Berchem TOT
54,Posthofbrug 5366,2019-07-16,19:00:00,153,69,84,FMN GV 16 Berchem TOT
54,Posthofbrug 5366,2019-07-16,20:00:00,81,37,44,FMN GV 16 Berchem TOT
54,Posthofbrug 5366,2019-07-16,21:00:00,77,39,38,FMN GV 16 Berchem TOT
54,Posthofbrug 5366,2019-07-16,22:00:00,66,24,42,FMN GV 16 Berchem TOT
54,Posthofbrug 5366,2019-07-16,23:00:00,36,11,25,FMN GV 16 Berchem TOT
54,Posthofbrug 5366,2019-07-17,00:00:00,26,11,15,FMN GV 16 Berchem TOT
54,Posthofbrug 5366,2019-07-17,01:00:00,7,2,5,FMN GV 16 Berchem TOT
54,Posthofbrug 5366,2019-07-17,02:00:00,9,2,7,FMN GV 16 Berchem TOT
54,Posthofbrug 5366,2019-07-17,03:00:00,2,0,2,FMN GV 16 Berchem TOT
54,Posthofbrug 5366,2019-07-17,04:00:00,7,4,3,FMN GV 16 Berchem TOT
54,Posthofbrug 5366,2019-07-17,05:00:00,9,8,1,FMN GV 16 Berchem TOT
54,Posthofbrug 5366,2019-07-17,06:00:00,61,47,14,FMN GV 16 Berchem TOT
54,Posthofbrug 5366,2019-07-17,07:00:00,250,164,86,FMN GV 16 Berchem TOT
54,Posthofbrug 5366,2019-07-17,08:00:00,369,243,126,FMN GV 16 Berchem TOT
54,Posthofbrug 5366,2019-07-17,09:00:00,175,104,71,FMN GV 16 Berchem TOT
54,Posthofbrug 5366,2019-07-17,10:00:00,132,84,48,FMN GV 16 Berchem TOT
54,Posthofbrug 5366,2019-07-17,11:00:00,110,65,45,FMN GV 16 Berchem TOT
54,Posthofbrug 5366,2019-07-17,12:00:00,144,87,57,FMN GV 16 Berchem TOT
54,Posthofbrug 5366,2019-07-17,13:00:00,162,97,65,FMN GV 16 Berchem TOT
54,Posthofbrug 5366,2019-07-17,14:00:00,142,80,62,FMN GV 16 Berchem TOT
54,Posthofbrug 5366,2019-07-17,15:00:00,150,76,74,FMN GV 16 Berchem TOT
54,Posthofbrug 5366,2019-07-17,16:00:00,312,122,190,FMN GV 16 Berchem TOT
54,Posthofbrug 5366,2019-07-17,17:00:00,437,178,259,FMN GV 16 Berchem TOT
54,Posthofbrug 5366,2019-07-17,18:00:00,276,87,189,FMN GV 16 Berchem TOT
54,Posthofbrug 5366,2019-07-17,19:00:00,143,64,79,FMN GV 16 Berchem TOT
54,Posthofbrug 5366,2019-07-17,20:00:00,92,38,54,FMN GV 16 Berchem TOT
54,Posthofbrug 5366,2019-07-17,21:00:00,77,29,48,FMN GV 16 Berchem TOT
54,Posthofbrug 5366,2019-07-17,22:00:00,58,16,42,FMN GV 16 Berchem TOT
54,Posthofbrug 5366,2019-07-17,23:00:00,47,11,36,FMN GV 16 Berchem TOT
54,Posthofbrug 5366,2019-07-18,00:00:00,17,12,5,FMN GV 16 Berchem TOT
54,Posthofbrug 5366,2019-07-18,01:00:00,7,4,3,FMN GV 16 Berchem TOT
54,Posthofbrug 5366,2019-07-18,02:00:00,8,3,5,FMN GV 16 Berchem TOT
54,Posthofbrug 5366,2019-07-18,03:00:00,3,1,2,FMN GV 16 Berchem TOT
54,Posthofbrug 5366,2019-07-18,04:00:00,8,7,1,FMN GV 16 Berchem TOT
54,Posthofbrug 5366,2019-07-18,05:00:00,18,12,6,FMN GV 16 Berchem TOT
54,Posthofbrug 5366,2019-07-18,06:00:00,68,56,12,FMN GV 16 Berchem TOT
54,Posthofbrug 5366,2019-07-18,07:00:00,233,167,66,FMN GV 16 Berchem TOT
54,Posthofbrug 5366,2019-07-18,08:00:00,386,240,146,FMN GV 16 Berchem TOT
54,Posthofbrug 5366,2019-07-18,09:00:00,144,98,46,FMN GV 16 Berchem TOT
54,Posthofbrug 5366,2019-07-18,10:00:00,96,52,44,FMN GV 16 Berchem TOT
54,Posthofbrug 5366,2019-07-18,11:00:00,136,102,34,FMN GV 16 Berchem TOT
54,Posthofbrug 5366,2019-07-18,12:00:00,126,65,61,FMN GV 16 Berchem TOT
54,Posthofbrug 5366,2019-07-18,13:00:00,134,67,67,FMN GV 16 Berchem TOT
54,Posthofbrug 5366,2019-07-18,14:00:00,127,73,54,FMN GV 16 Berchem TOT
54,Posthofbrug 5366,2019-07-18,15:00:00,136,58,78,FMN GV 16 Berchem TOT
54,Posthofbrug 5366,2019-07-18,16:00:00,285,130,155,FMN GV 16 Berchem TOT
54,Posthofbrug 5366,2019-07-18,17:00:00,384,152,232,FMN GV 16 Berchem TOT
54,Posthofbrug 5366,2019-07-18,18:00:00,228,70,158,FMN GV 16 Berchem TOT
54,Posthofbrug 5366,2019-07-18,19:00:00,107,49,58,FMN GV 16 Berchem TOT
54,Posthofbrug 5366,2019-07-18,20:00:00,80,33,47,FMN GV 16 Berchem TOT
54,Posthofbrug 5366,2019-07-18,21:00:00,66,26,40,FMN GV 16 Berchem TOT
54,Posthofbrug 5366,2019-07-18,22:00:00,52,14,38,FMN GV 16 Berchem TOT
54,Posthofbrug 5366,2019-07-18,23:00:00,44,14,30,FMN GV 16 Berchem TOT
54,Posthofbrug 5366,2019-07-19,00:00:00,17,5,12,FMN GV 16 Berchem TOT
54,Posthofbrug 5366,2019-07-19,01:00:00,17,5,12,FMN GV 16 Berchem TOT
54,Posthofbrug 5366,2019-07-19,02:00:00,4,0,4,FMN GV 16 Berchem TOT
54,Posthofbrug 5366,2019-07-19,03:00:00,2,0,2,FMN GV 16 Berchem TOT
54,Posthofbrug 5366,2019-07-19,04:00:00,13,9,4,FMN GV 16 Berchem TOT
54,Posthofbrug 5366,2019-07-19,05:00:00,15,13,2,FMN GV 16 Berchem TOT
54,Posthofbrug 5366,2019-07-19,06:00:00,55,44,11,FMN GV 16 Berchem TOT
54,Posthofbrug 5366,2019-07-19,07:00:00,191,132,59,FMN GV 16 Berchem TOT
54,Posthofbrug 5366,2019-07-19,08:00:00,310,199,111,FMN GV 16 Berchem TOT
54,Posthofbrug 5366,2019-07-19,09:00:00,139,99,40,FMN GV 16 Berchem TOT
54,Posthofbrug 5366,2019-07-19,10:00:00,100,66,34,FMN GV 16 Berchem TOT
54,Posthofbrug 5366,2019-07-19,11:00:00,120,70,50,FMN GV 16 Berchem TOT
54,Posthofbrug 5366,2019-07-19,12:00:00,150,86,64,FMN GV 16 Berchem TOT
54,Posthofbrug 5366,2019-07-19,13:00:00,161,83,78,FMN GV 16 Berchem TOT
54,Posthofbrug 5366,2019-07-19,14:00:00,169,99,70,FMN GV 16 Berchem TOT
54,Posthofbrug 5366,2019-07-19,15:00:00,185,75,110,FMN GV 16 Berchem TOT
54,Posthofbrug 5366,2019-07-19,16:00:00,283,127,156,FMN GV 16 Berchem TOT
54,Posthofbrug 5366,2019-07-19,17:00:00,313,127,186,FMN GV 16 Berchem TOT
54,Posthofbrug 5366,2019-07-19,18:00:00,229,86,143,FMN GV 16 Berchem TOT
54,Posthofbrug 5366,2019-07-19,19:00:00,141,73,68,FMN GV 16 Berchem TOT
54,Posthofbrug 5366,2019-07-19,20:00:00,105,55,50,FMN GV 16 Berchem TOT
54,Posthofbrug 5366,2019-07-19,21:00:00,59,28,31,FMN GV 16 Berchem TOT
54,Posthofbrug 5366,2019-07-19,22:00:00,68,22,46,FMN GV 16 Berchem TOT
54,Posthofbrug 5366,2019-07-19,23:00:00,58,17,41,FMN GV 16 Berchem TOT
54,Posthofbrug 5366,2019-07-20,00:00:00,28,4,24,FMN GV 16 Berchem TOT
54,Posthofbrug 5366,2019-07-20,01:00:00,22,3,19,FMN GV 16 Berchem TOT
54,Posthofbrug 5366,2019-07-20,02:00:00,24,4,20,FMN GV 16 Berchem TOT
54,Posthofbrug 5366,2019-07-20,03:00:00,14,2,12,FMN GV 16 Berchem TOT
54,Posthofbrug 5366,2019-07-20,04:00:00,8,2,6,FMN GV 16 Berchem TOT
54,Posthofbrug 5366,2019-07-20,05:00:00,7,5,2,FMN GV 16 Berchem TOT
54,Posthofbrug 5366,2019-07-20,06:00:00,23,11,12,FMN GV 16 Berchem TOT
54,Posthofbrug 5366,2019-07-20,07:00:00,14,7,7,FMN GV 16 Berchem TOT
54,Posthofbrug 5366,2019-07-20,08:00:00,26,13,13,FMN GV 16 Berchem TOT
54,Posthofbrug 5366,2019-07-20,09:00:00,38,24,14,FMN GV 16 Berchem TOT
54,Posthofbrug 5366,2019-07-20,10:00:00,42,35,7,FMN GV 16 Berchem TOT
54,Posthofbrug 5366,2019-07-20,11:00:00,64,39,25,FMN GV 16 Berchem TOT
54,Posthofbrug 5366,2019-07-20,12:00:00,52,30,22,FMN GV 16 Berchem TOT
54,Posthofbrug 5366,2019-07-20,13:00:00,60,39,21,FMN GV 16 Berchem TOT
54,Posthofbrug 5366,2019-07-20,14:00:00,78,46,32,FMN GV 16 Berchem TOT
54,Posthofbrug 5366,2019-07-20,15:00:00,72,38,34,FMN GV 16 Berchem TOT
54,Posthofbrug 5366,2019-07-20,16:00:00,88,44,44,FMN GV 16 Berchem TOT
54,Posthofbrug 5366,2019-07-20,17:00:00,98,52,46,FMN GV 16 Berchem TOT
54,Posthofbrug 5366,2019-07-20,18:00:00,95,39,56,FMN GV 16 Berchem TOT
54,Posthofbrug 5366,2019-07-20,19:00:00,63,41,22,FMN GV 16 Berchem TOT
54,Posthofbrug 5366,2019-07-20,20:00:00,70,28,42,FMN GV 16 Berchem TOT
54,Posthofbrug 5366,2019-07-20,21:00:00,58,16,42,FMN GV 16 Berchem TOT
54,Posthofbrug 5366,2019-07-20,22:00:00,36,16,20,FMN GV 16 Berchem TOT
54,Posthofbrug 5366,2019-07-20,23:00:00,45,16,29,FMN GV 16 Berchem TOT
54,Posthofbrug 5366,2019-07-21,00:00:00,39,10,29,FMN GV 16 Berchem TOT
54,Posthofbrug 5366,2019-07-21,01:00:00,20,9,11,FMN GV 16 Berchem TOT
54,Posthofbrug 5366,2019-07-21,02:00:00,13,3,10,FMN GV 16 Berchem TOT
54,Posthofbrug 5366,2019-07-21,03:00:00,7,1,6,FMN GV 16 Berchem TOT
54,Posthofbrug 5366,2019-07-21,04:00:00,11,4,7,FMN GV 16 Berchem TOT
54,Posthofbrug 5366,2019-07-21,05:00:00,8,4,4,FMN GV 16 Berchem TOT
54,Posthofbrug 5366,2019-07-21,06:00:00,14,10,4,FMN GV 16 Berchem TOT
54,Posthofbrug 5366,2019-07-21,07:00:00,11,8,3,FMN GV 16 Berchem TOT
54,Posthofbrug 5366,2019-07-21,08:00:00,16,11,5,FMN GV 16 Berchem TOT
54,Posthofbrug 5366,2019-07-21,09:00:00,60,35,25,FMN GV 16 Berchem TOT
54,Posthofbrug 5366,2019-07-21,10:00:00,97,67,30,FMN GV 16 Berchem TOT
54,Posthofbrug 5366,2019-07-21,11:00:00,114,70,44,FMN GV 16 Berchem TOT
54,Posthofbrug 5366,2019-07-21,12:00:00,125,78,47,FMN GV 16 Berchem TOT
54,Posthofbrug 5366,2019-07-21,13:00:00,154,81,73,FMN GV 16 Berchem TOT
54,Posthofbrug 5366,2019-07-21,14:00:00,171,92,79,FMN GV 16 Berchem TOT
54,Posthofbrug 5366,2019-07-21,15:00:00,139,66,73,FMN GV 16 Berchem TOT
54,Posthofbrug 5366,2019-07-21,16:00:00,134,45,89,FMN GV 16 Berchem TOT
54,Posthofbrug 5366,2019-07-21,17:00:00,127,54,73,FMN GV 16 Berchem TOT
54,Posthofbrug 5366,2019-07-21,18:00:00,115,53,62,FMN GV 16 Berchem TOT
54,Posthofbrug 5366,2019-07-21,19:00:00,74,38,36,FMN GV 16 Berchem TOT
54,Posthofbrug 5366,2019-07-21,20:00:00,86,41,45,FMN GV 16 Berchem TOT
54,Posthofbrug 5366,2019-07-21,21:00:00,62,28,34,FMN GV 16 Berchem TOT
54,Posthofbrug 5366,2019-07-21,22:00:00,41,15,26,FMN GV 16 Berchem TOT
54,Posthofbrug 5366,2019-07-21,23:00:00,27,10,17,FMN GV 16 Berchem TOT
54,Posthofbrug 5366,2019-07-22,00:00:00,15,6,9,FMN GV 16 Berchem TOT
54,Posthofbrug 5366,2019-07-22,01:00:00,11,6,5,FMN GV 16 Berchem TOT
54,Posthofbrug 5366,2019-07-22,02:00:00,7,3,4,FMN GV 16 Berchem TOT
54,Posthofbrug 5366,2019-07-22,03:00:00,13,4,9,FMN GV 16 Berchem TOT
54,Posthofbrug 5366,2019-07-22,04:00:00,6,4,2,FMN GV 16 Berchem TOT
54,Posthofbrug 5366,2019-07-22,05:00:00,13,9,4,FMN GV 16 Berchem TOT
54,Posthofbrug 5366,2019-07-22,06:00:00,55,43,12,FMN GV 16 Berchem TOT
54,Posthofbrug 5366,2019-07-22,07:00:00,213,170,43,FMN GV 16 Berchem TOT
54,Posthofbrug 5366,2019-07-22,08:00:00,335,226,109,FMN GV 16 Berchem TOT
54,Posthofbrug 5366,2019-07-22,09:00:00,191,130,61,FMN GV 16 Berchem TOT
54,Posthofbrug 5366,2019-07-22,10:00:00,111,76,35,FMN GV 16 Berchem TOT
54,Posthofbrug 5366,2019-07-22,11:00:00,122,82,40,FMN GV 16 Berchem TOT
54,Posthofbrug 5366,2019-07-22,12:00:00,146,96,50,FMN GV 16 Berchem TOT
54,Posthofbrug 5366,2019-07-22,13:00:00,125,64,61,FMN GV 16 Berchem TOT
54,Posthofbrug 5366,2019-07-22,14:00:00,93,41,52,FMN GV 16 Berchem TOT
54,Posthofbrug 5366,2019-07-22,15:00:00,159,71,88,FMN GV 16 Berchem TOT
54,Posthofbrug 5366,2019-07-22,16:00:00,295,111,184,FMN GV 16 Berchem TOT
54,Posthofbrug 5366,2019-07-22,17:00:00,427,156,271,FMN GV 16 Berchem TOT
54,Posthofbrug 5366,2019-07-22,18:00:00,265,95,170,FMN GV 16 Berchem TOT
54,Posthofbrug 5366,2019-07-22,19:00:00,120,49,71,FMN GV 16 Berchem TOT
54,Posthofbrug 5366,2019-07-22,20:00:00,78,35,43,FMN GV 16 Berchem TOT
54,Posthofbrug 5366,2019-07-22,21:00:00,58,25,33,FMN GV 16 Berchem TOT
54,Posthofbrug 5366,2019-07-22,22:00:00,49,16,33,FMN GV 16 Berchem TOT
54,Posthofbrug 5366,2019-07-22,23:00:00,35,13,22,FMN GV 16 Berchem TOT
54,Posthofbrug 5366,2019-07-23,00:00:00,23,5,18,FMN GV 16 Berchem TOT
54,Posthofbrug 5366,2019-07-23,01:00:00,8,3,5,FMN GV 16 Berchem TOT
54,Posthofbrug 5366,2019-07-23,02:00:00,5,2,3,FMN GV 16 Berchem TOT
54,Posthofbrug 5366,2019-07-23,03:00:00,3,0,3,FMN GV 16 Berchem TOT
54,Posthofbrug 5366,2019-07-23,04:00:00,15,11,4,FMN GV 16 Berchem TOT
54,Posthofbrug 5366,2019-07-23,05:00:00,18,10,8,FMN GV 16 Berchem TOT
54,Posthofbrug 5366,2019-07-23,06:00:00,85,67,18,FMN GV 16 Berchem TOT
54,Posthofbrug 5366,2019-07-23,07:00:00,258,198,60,FMN GV 16 Berchem TOT
54,Posthofbrug 5366,2019-07-23,08:00:00,384,248,136,FMN GV 16 Berchem TOT
54,Posthofbrug 5366,2019-07-23,09:00:00,177,120,57,FMN GV 16 Berchem TOT
54,Posthofbrug 5366,2019-07-23,10:00:00,95,57,38,FMN GV 16 Berchem TOT
54,Posthofbrug 5366,2019-07-23,11:00:00,96,57,39,FMN GV 16 Berchem TOT
54,Posthofbrug 5366,2019-07-23,12:00:00,134,79,55,FMN GV 16 Berchem TOT
54,Posthofbrug 5366,2019-07-23,13:00:00,101,55,46,FMN GV 16 Berchem TOT
54,Posthofbrug 5366,2019-07-23,14:00:00,86,45,41,FMN GV 16 Berchem TOT
54,Posthofbrug 5366,2019-07-23,15:00:00,144,55,89,FMN GV 16 Berchem TOT
54,Posthofbrug 5366,2019-07-23,16:00:00,298,131,167,FMN GV 16 Berchem TOT
54,Posthofbrug 5366,2019-07-23,17:00:00,399,144,255,FMN GV 16 Berchem TOT
54,Posthofbrug 5366,2019-07-23,18:00:00,273,91,182,FMN GV 16 Berchem TOT
54,Posthofbrug 5366,2019-07-23,19:00:00,121,43,78,FMN GV 16 Berchem TOT
54,Posthofbrug 5366,2019-07-23,20:00:00,84,41,43,FMN GV 16 Berchem TOT
54,Posthofbrug 5366,2019-07-23,21:00:00,79,37,42,FMN GV 16 Berchem TOT
54,Posthofbrug 5366,2019-07-23,22:00:00,67,25,42,FMN GV 16 Berchem TOT
54,Posthofbrug 5366,2019-07-23,23:00:00,46,15,31,FMN GV 16 Berchem TOT
54,Posthofbrug 5366,2019-07-24,00:00:00,25,10,15,FMN GV 16 Berchem TOT
54,Posthofbrug 5366,2019-07-24,01:00:00,14,8,6,FMN GV 16 Berchem TOT
54,Posthofbrug 5366,2019-07-24,02:00:00,15,8,7,FMN GV 16 Berchem TOT
54,Posthofbrug 5366,2019-07-24,03:00:00,3,1,2,FMN GV 16 Berchem TOT
54,Posthofbrug 5366,2019-07-24,04:00:00,9,7,2,FMN GV 16 Berchem TOT
54,Posthofbrug 5366,2019-07-24,05:00:00,22,15,7,FMN GV 16 Berchem TOT
54,Posthofbrug 5366,2019-07-24,06:00:00,73,58,15,FMN GV 16 Berchem TOT
54,Posthofbrug 5366,2019-07-24,07:00:00,220,156,64,FMN GV 16 Berchem TOT
54,Posthofbrug 5366,2019-07-24,08:00:00,284,181,103,FMN GV 16 Berchem TOT
54,Posthofbrug 5366,2019-07-24,09:00:00,166,93,73,FMN GV 16 Berchem TOT
54,Posthofbrug 5366,2019-07-24,10:00:00,104,68,36,FMN GV 16 Berchem TOT
54,Posthofbrug 5366,2019-07-24,11:00:00,76,44,32,FMN GV 16 Berchem TOT
54,Posthofbrug 5366,2019-07-24,12:00:00,82,38,44,FMN GV 16 Berchem TOT
54,Posthofbrug 5366,2019-07-24,13:00:00,68,33,35,FMN GV 16 Berchem TOT
54,Posthofbrug 5366,2019-07-24,14:00:00,89,32,57,FMN GV 16 Berchem TOT
54,Posthofbrug 5366,2019-07-24,15:00:00,103,42,61,FMN GV 16 Berchem TOT
54,Posthofbrug 5366,2019-07-24,16:00:00,219,91,128,FMN GV 16 Berchem TOT
54,Posthofbrug 5366,2019-07-24,17:00:00,283,124,159,FMN GV 16 Berchem TOT
54,Posthofbrug 5366,2019-07-24,18:00:00,196,69,127,FMN GV 16 Berchem TOT
54,Posthofbrug 5366,2019-07-24,19:00:00,82,39,43,FMN GV 16 Berchem TOT
54,Posthofbrug 5366,2019-07-24,20:00:00,73,36,37,FMN GV 16 Berchem TOT
54,Posthofbrug 5366,2019-07-24,21:00:00,45,26,19,FMN GV 16 Berchem TOT
54,Posthofbrug 5366,2019-07-24,22:00:00,59,31,28,FMN GV 16 Berchem TOT
54,Posthofbrug 5366,2019-07-24,23:00:00,42,15,27,FMN GV 16 Berchem TOT
54,Posthofbrug 5366,2019-07-25,00:00:00,19,9,10,FMN GV 16 Berchem TOT
54,Posthofbrug 5366,2019-07-25,01:00:00,9,1,8,FMN GV 16 Berchem TOT
54,Posthofbrug 5366,2019-07-25,02:00:00,8,4,4,FMN GV 16 Berchem TOT
54,Posthofbrug 5366,2019-07-25,03:00:00,2,2,0,FMN GV 16 Berchem TOT
54,Posthofbrug 5366,2019-07-25,04:00:00,9,6,3,FMN GV 16 Berchem TOT
54,Posthofbrug 5366,2019-07-25,05:00:00,21,15,6,FMN GV 16 Berchem TOT
54,Posthofbrug 5366,2019-07-25,06:00:00,66,51,15,FMN GV 16 Berchem TOT
54,Posthofbrug 5366,2019-07-25,07:00:00,206,161,45,FMN GV 16 Berchem TOT
54,Posthofbrug 5366,2019-07-25,08:00:00,278,182,96,FMN GV 16 Berchem TOT
54,Posthofbrug 5366,2019-07-25,09:00:00,141,83,58,FMN GV 16 Berchem TOT
54,Posthofbrug 5366,2019-07-25,10:00:00,58,32,26,FMN GV 16 Berchem TOT
54,Posthofbrug 5366,2019-07-25,11:00:00,64,35,29,FMN GV 16 Berchem TOT
54,Posthofbrug 5366,2019-07-25,12:00:00,68,41,27,FMN GV 16 Berchem TOT
54,Posthofbrug 5366,2019-07-25,13:00:00,80,43,37,FMN GV 16 Berchem TOT
54,Posthofbrug 5366,2019-07-25,14:00:00,64,32,32,FMN GV 16 Berchem TOT
54,Posthofbrug 5366,2019-07-25,15:00:00,99,37,62,FMN GV 16 Berchem TOT
54,Posthofbrug 5366,2019-07-25,16:00:00,189,88,101,FMN GV 16 Berchem TOT
54,Posthofbrug 5366,2019-07-25,17:00:00,282,113,169,FMN GV 16 Berchem TOT
54,Posthofbrug 5366,2019-07-25,18:00:00,157,56,101,FMN GV 16 Berchem TOT
54,Posthofbrug 5366,2019-07-25,19:00:00,105,30,75,FMN GV 16 Berchem TOT
54,Posthofbrug 5366,2019-07-25,20:00:00,83,27,56,FMN GV 16 Berchem TOT
54,Posthofbrug 5366,2019-07-25,21:00:00,60,31,29,FMN GV 16 Berchem TOT
54,Posthofbrug 5366,2019-07-25,22:00:00,55,20,35,FMN GV 16 Berchem TOT
54,Posthofbrug 5366,2019-07-25,23:00:00,56,17,39,FMN GV 16 Berchem TOT
54,Posthofbrug 5366,2019-07-26,00:00:00,36,19,17,FMN GV 16 Berchem TOT
54,Posthofbrug 5366,2019-07-26,01:00:00,22,14,8,FMN GV 16 Berchem TOT
54,Posthofbrug 5366,2019-07-26,02:00:00,21,16,5,FMN GV 16 Berchem TOT
54,Posthofbrug 5366,2019-07-26,03:00:00,7,3,4,FMN GV 16 Berchem TOT
54,Posthofbrug 5366,2019-07-26,04:00:00,1,0,1,FMN GV 16 Berchem TOT
54,Posthofbrug 5366,2019-07-26,05:00:00,20,16,4,FMN GV 16 Berchem TOT
54,Posthofbrug 5366,2019-07-26,06:00:00,38,30,8,FMN GV 16 Berchem TOT
54,Posthofbrug 5366,2019-07-26,07:00:00,155,113,42,FMN GV 16 Berchem TOT
54,Posthofbrug 5366,2019-07-26,08:00:00,234,158,76,FMN GV 16 Berchem TOT
54,Posthofbrug 5366,2019-07-26,09:00:00,115,74,41,FMN GV 16 Berchem TOT
54,Posthofbrug 5366,2019-07-26,10:00:00,81,49,32,FMN GV 16 Berchem TOT
54,Posthofbrug 5366,2019-07-26,11:00:00,69,44,25,FMN GV 16 Berchem TOT
54,Posthofbrug 5366,2019-07-26,12:00:00,91,48,43,FMN GV 16 Berchem TOT
54,Posthofbrug 5366,2019-07-26,13:00:00,97,35,62,FMN GV 16 Berchem TOT
54,Posthofbrug 5366,2019-07-26,14:00:00,93,43,50,FMN GV 16 Berchem TOT
54,Posthofbrug 5366,2019-07-26,15:00:00,112,51,61,FMN GV 16 Berchem TOT
54,Posthofbrug 5366,2019-07-26,16:00:00,189,88,101,FMN GV 16 Berchem TOT
54,Posthofbrug 5366,2019-07-26,17:00:00,244,102,142,FMN GV 16 Berchem TOT
54,Posthofbrug 5366,2019-07-26,18:00:00,186,69,117,FMN GV 16 Berchem TOT
54,Posthofbrug 5366,2019-07-26,19:00:00,124,51,73,FMN GV 16 Berchem TOT
54,Posthofbrug 5366,2019-07-26,20:00:00,69,29,40,FMN GV 16 Berchem TOT
54,Posthofbrug 5366,2019-07-26,21:00:00,53,17,36,FMN GV 16 Berchem TOT
54,Posthofbrug 5366,2019-07-26,22:00:00,49,17,32,FMN GV 16 Berchem TOT
54,Posthofbrug 5366,2019-07-26,23:00:00,41,22,19,FMN GV 16 Berchem TOT
54,Posthofbrug 5366,2019-07-27,00:00:00,32,22,10,FMN GV 16 Berchem TOT
54,Posthofbrug 5366,2019-07-27,01:00:00,36,21,15,FMN GV 16 Berchem TOT
54,Posthofbrug 5366,2019-07-27,02:00:00,71,53,18,FMN GV 16 Berchem TOT
54,Posthofbrug 5366,2019-07-27,03:00:00,14,11,3,FMN GV 16 Berchem TOT
54,Posthofbrug 5366,2019-07-27,04:00:00,20,11,9,FMN GV 16 Berchem TOT
54,Posthofbrug 5366,2019-07-27,05:00:00,6,3,3,FMN GV 16 Berchem TOT
54,Posthofbrug 5366,2019-07-27,06:00:00,17,10,7,FMN GV 16 Berchem TOT
54,Posthofbrug 5366,2019-07-27,07:00:00,12,7,5,FMN GV 16 Berchem TOT
54,Posthofbrug 5366,2019-07-27,08:00:00,31,20,11,FMN GV 16 Berchem TOT
54,Posthofbrug 5366,2019-07-27,09:00:00,53,41,12,FMN GV 16 Berchem TOT
54,Posthofbrug 5366,2019-07-27,10:00:00,72,50,22,FMN GV 16 Berchem TOT
54,Posthofbrug 5366,2019-07-27,11:00:00,62,47,15,FMN GV 16 Berchem TOT
54,Posthofbrug 5366,2019-07-27,12:00:00,48,27,21,FMN GV 16 Berchem TOT
54,Posthofbrug 5366,2019-07-27,13:00:00,37,17,20,FMN GV 16 Berchem TOT
54,Posthofbrug 5366,2019-07-27,14:00:00,27,12,15,FMN GV 16 Berchem TOT
54,Posthofbrug 5366,2019-07-27,15:00:00,59,22,37,FMN GV 16 Berchem TOT
54,Posthofbrug 5366,2019-07-27,16:00:00,38,18,20,FMN GV 16 Berchem TOT
54,Posthofbrug 5366,2019-07-27,17:00:00,67,31,36,FMN GV 16 Berchem TOT
54,Posthofbrug 5366,2019-07-27,18:00:00,54,15,39,FMN GV 16 Berchem TOT
54,Posthofbrug 5366,2019-07-27,19:00:00,27,8,19,FMN GV 16 Berchem TOT
54,Posthofbrug 5366,2019-07-27,20:00:00,21,3,18,FMN GV 16 Berchem TOT
54,Posthofbrug 5366,2019-07-27,21:00:00,27,9,18,FMN GV 16 Berchem TOT
54,Posthofbrug 5366,2019-07-27,22:00:00,18,9,9,FMN GV 16 Berchem TOT
54,Posthofbrug 5366,2019-07-27,23:00:00,30,20,10,FMN GV 16 Berchem TOT
54,Posthofbrug 5366,2019-07-28,00:00:00,27,17,10,FMN GV 16 Berchem TOT
54,Posthofbrug 5366,2019-07-28,01:00:00,23,16,7,FMN GV 16 Berchem TOT
54,Posthofbrug 5366,2019-07-28,02:00:00,11,4,7,FMN GV 16 Berchem TOT
54,Posthofbrug 5366,2019-07-28,03:00:00,25,20,5,FMN GV 16 Berchem TOT
54,Posthofbrug 5366,2019-07-28,04:00:00,17,16,1,FMN GV 16 Berchem TOT
54,Posthofbrug 5366,2019-07-28,05:00:00,7,5,2,FMN GV 16 Berchem TOT
54,Posthofbrug 5366,2019-07-28,06:00:00,7,7,0,FMN GV 16 Berchem TOT
54,Posthofbrug 5366,2019-07-28,07:00:00,10,1,9,FMN GV 16 Berchem TOT
54,Posthofbrug 5366,2019-07-28,08:00:00,14,10,4,FMN GV 16 Berchem TOT
54,Posthofbrug 5366,2019-07-28,09:00:00,20,9,11,FMN GV 16 Berchem TOT
54,Posthofbrug 5366,2019-07-28,10:00:00,25,14,11,FMN GV 16 Berchem TOT
54,Posthofbrug 5366,2019-07-28,11:00:00,30,17,13,FMN GV 16 Berchem TOT
54,Posthofbrug 5366,2019-07-28,12:00:00,32,19,13,FMN GV 16 Berchem TOT
54,Posthofbrug 5366,2019-07-28,13:00:00,13,7,6,FMN GV 16 Berchem TOT
54,Posthofbrug 5366,2019-07-28,14:00:00,21,9,12,FMN GV 16 Berchem TOT
54,Posthofbrug 5366,2019-07-28,15:00:00,33,10,23,FMN GV 16 Berchem TOT
54,Posthofbrug 5366,2019-07-28,16:00:00,36,16,20,FMN GV 16 Berchem TOT
54,Posthofbrug 5366,2019-07-28,17:00:00,34,17,17,FMN GV 16 Berchem TOT
54,Posthofbrug 5366,2019-07-28,18:00:00,42,21,21,FMN GV 16 Berchem TOT
54,Posthofbrug 5366,2019-07-28,19:00:00,33,10,23,FMN GV 16 Berchem TOT
54,Posthofbrug 5366,2019-07-28,20:00:00,37,18,19,FMN GV 16 Berchem TOT
54,Posthofbrug 5366,2019-07-28,21:00:00,16,7,9,FMN GV 16 Berchem TOT
54,Posthofbrug 5366,2019-07-28,22:00:00,24,14,10,FMN GV 16 Berchem TOT
54,Posthofbrug 5366,2019-07-28,23:00:00,33,22,11,FMN GV 16 Berchem TOT
54,Posthofbrug 5366,2019-07-29,00:00:00,23,16,7,FMN GV 16 Berchem TOT
54,Posthofbrug 5366,2019-07-29,01:00:00,4,3,1,FMN GV 16 Berchem TOT
54,Posthofbrug 5366,2019-07-29,02:00:00,1,1,0,FMN GV 16 Berchem TOT
54,Posthofbrug 5366,2019-07-29,03:00:00,6,4,2,FMN GV 16 Berchem TOT
54,Posthofbrug 5366,2019-07-29,04:00:00,7,6,1,FMN GV 16 Berchem TOT
54,Posthofbrug 5366,2019-07-29,05:00:00,13,12,1,FMN GV 16 Berchem TOT
54,Posthofbrug 5366,2019-07-29,06:00:00,59,50,9,FMN GV 16 Berchem TOT
54,Posthofbrug 5366,2019-07-29,07:00:00,175,132,43,FMN GV 16 Berchem TOT
54,Posthofbrug 5366,2019-07-29,08:00:00,302,212,90,FMN GV 16 Berchem TOT
54,Posthofbrug 5366,2019-07-29,09:00:00,179,120,59,FMN GV 16 Berchem TOT
54,Posthofbrug 5366,2019-07-29,10:00:00,83,47,36,FMN GV 16 Berchem TOT
54,Posthofbrug 5366,2019-07-29,11:00:00,108,72,36,FMN GV 16 Berchem TOT
54,Posthofbrug 5366,2019-07-29,12:00:00,154,99,55,FMN GV 16 Berchem TOT
54,Posthofbrug 5366,2019-07-29,13:00:00,182,112,70,FMN GV 16 Berchem TOT
54,Posthofbrug 5366,2019-07-29,14:00:00,130,60,70,FMN GV 16 Berchem TOT
54,Posthofbrug 5366,2019-07-29,15:00:00,162,67,95,FMN GV 16 Berchem TOT
54,Posthofbrug 5366,2019-07-29,16:00:00,319,132,187,FMN GV 16 Berchem TOT
54,Posthofbrug 5366,2019-07-29,17:00:00,433,126,307,FMN GV 16 Berchem TOT
54,Posthofbrug 5366,2019-07-29,18:00:00,290,87,203,FMN GV 16 Berchem TOT
54,Posthofbrug 5366,2019-07-29,19:00:00,128,52,76,FMN GV 16 Berchem TOT
54,Posthofbrug 5366,2019-07-29,20:00:00,74,37,37,FMN GV 16 Berchem TOT
54,Posthofbrug 5366,2019-07-29,21:00:00,64,26,38,FMN GV 16 Berchem TOT
54,Posthofbrug 5366,2019-07-29,22:00:00,46,19,27,FMN GV 16 Berchem TOT
54,Posthofbrug 5366,2019-07-29,23:00:00,44,13,31,FMN GV 16 Berchem TOT
54,Posthofbrug 5366,2019-07-30,00:00:00,17,5,12,FMN GV 16 Berchem TOT
54,Posthofbrug 5366,2019-07-30,01:00:00,8,4,4,FMN GV 16 Berchem TOT
54,Posthofbrug 5366,2019-07-30,02:00:00,4,1,3,FMN GV 16 Berchem TOT
54,Posthofbrug 5366,2019-07-30,03:00:00,9,4,5,FMN GV 16 Berchem TOT
54,Posthofbrug 5366,2019-07-30,04:00:00,5,4,1,FMN GV 16 Berchem TOT
54,Posthofbrug 5366,2019-07-30,05:00:00,16,12,4,FMN GV 16 Berchem TOT
54,Posthofbrug 5366,2019-07-30,06:00:00,71,62,9,FMN GV 16 Berchem TOT
54,Posthofbrug 5366,2019-07-30,07:00:00,228,177,51,FMN GV 16 Berchem TOT
54,Posthofbrug 5366,2019-07-30,08:00:00,353,229,124,FMN GV 16 Berchem TOT
54,Posthofbrug 5366,2019-07-30,09:00:00,169,107,62,FMN GV 16 Berchem TOT
54,Posthofbrug 5366,2019-07-30,10:00:00,94,63,31,FMN GV 16 Berchem TOT
54,Posthofbrug 5366,2019-07-30,11:00:00,101,49,52,FMN GV 16 Berchem TOT
54,Posthofbrug 5366,2019-07-30,12:00:00,125,83,42,FMN GV 16 Berchem TOT
54,Posthofbrug 5366,2019-07-30,13:00:00,111,58,53,FMN GV 16 Berchem TOT
54,Posthofbrug 5366,2019-07-30,14:00:00,135,69,66,FMN GV 16 Berchem TOT
54,Posthofbrug 5366,2019-07-30,15:00:00,165,76,89,FMN GV 16 Berchem TOT
54,Posthofbrug 5366,2019-07-30,16:00:00,336,140,196,FMN GV 16 Berchem TOT
54,Posthofbrug 5366,2019-07-30,17:00:00,451,167,284,FMN GV 16 Berchem TOT
54,Posthofbrug 5366,2019-07-30,18:00:00,303,104,199,FMN GV 16 Berchem TOT
54,Posthofbrug 5366,2019-07-30,19:00:00,137,69,68,FMN GV 16 Berchem TOT
54,Posthofbrug 5366,2019-07-30,20:00:00,105,58,47,FMN GV 16 Berchem TOT
54,Posthofbrug 5366,2019-07-30,21:00:00,67,33,34,FMN GV 16 Berchem TOT
54,Posthofbrug 5366,2019-07-30,22:00:00,71,17,54,FMN GV 16 Berchem TOT
54,Posthofbrug 5366,2019-07-30,23:00:00,54,9,45,FMN GV 16 Berchem TOT
54,Posthofbrug 5366,2019-07-31,00:00:00,29,9,20,FMN GV 16 Berchem TOT
54,Posthofbrug 5366,2019-07-31,01:00:00,5,3,2,FMN GV 16 Berchem TOT
54,Posthofbrug 5366,2019-07-31,02:00:00,5,1,4,FMN GV 16 Berchem TOT
54,Posthofbrug 5366,2019-07-31,03:00:00,2,0,2,FMN GV 16 Berchem TOT
54,Posthofbrug 5366,2019-07-31,04:00:00,9,7,2,FMN GV 16 Berchem TOT
54,Posthofbrug 5366,2019-07-31,05:00:00,15,11,4,FMN GV 16 Berchem TOT
54,Posthofbrug 5366,2019-07-31,06:00:00,75,63,12,FMN GV 16 Berchem TOT
54,Posthofbrug 5366,2019-07-31,07:00:00,206,148,58,FMN GV 16 Berchem TOT
54,Posthofbrug 5366,2019-07-31,08:00:00,304,201,103,FMN GV 16 Berchem TOT
54,Posthofbrug 5366,2019-07-31,09:00:00,132,93,39,FMN GV 16 Berchem TOT
54,Posthofbrug 5366,2019-07-31,10:00:00,82,58,24,FMN GV 16 Berchem TOT
54,Posthofbrug 5366,2019-07-31,11:00:00,55,30,25,FMN GV 16 Berchem TOT
54,Posthofbrug 5366,2019-07-31,12:00:00,113,63,50,FMN GV 16 Berchem TOT
54,Posthofbrug 5366,2019-07-31,13:00:00,89,50,39,FMN GV 16 Berchem TOT
54,Posthofbrug 5366,2019-07-31,14:00:00,110,53,57,FMN GV 16 Berchem TOT
54,Posthofbrug 5366,2019-07-31,15:00:00,118,57,61,FMN GV 16 Berchem TOT
54,Posthofbrug 5366,2019-07-31,16:00:00,268,112,156,FMN GV 16 Berchem TOT
54,Posthofbrug 5366,2019-07-31,17:00:00,375,133,242,FMN GV 16 Berchem TOT
54,Posthofbrug 5366,2019-07-31,18:00:00,199,71,128,FMN GV 16 Berchem TOT
54,Posthofbrug 5366,2019-07-31,19:00:00,88,31,57,FMN GV 16 Berchem TOT
54,Posthofbrug 5366,2019-07-31,20:00:00,72,38,34,FMN GV 16 Berchem TOT
54,Posthofbrug 5366,2019-07-31,21:00:00,44,14,30,FMN GV 16 Berchem TOT
54,Posthofbrug 5366,2019-07-31,22:00:00,62,18,44,FMN GV 16 Berchem TOT
54,Posthofbrug 5366,2019-07-31,23:00:00,44,15,29,FMN GV 16 Berchem TOT
54,Posthofbrug 5366,2019-08-01,00:00:00,11,3,8,FMN GV 16 Berchem TOT
54,Posthofbrug 5366,2019-08-01,01:00:00,14,4,10,FMN GV 16 Berchem TOT
54,Posthofbrug 5366,2019-08-01,02:00:00,4,2,2,FMN GV 16 Berchem TOT
54,Posthofbrug 5366,2019-08-01,03:00:00,2,1,1,FMN GV 16 Berchem TOT
54,Posthofbrug 5366,2019-08-01,04:00:00,6,5,1,FMN GV 16 Berchem TOT
54,Posthofbrug 5366,2019-08-01,05:00:00,12,7,5,FMN GV 16 Berchem TOT
54,Posthofbrug 5366,2019-08-01,06:00:00,68,61,7,FMN GV 16 Berchem TOT
54,Posthofbrug 5366,2019-08-01,07:00:00,210,154,56,FMN GV 16 Berchem TOT
54,Posthofbrug 5366,2019-08-01,08:00:00,336,223,113,FMN GV 16 Berchem TOT
54,Posthofbrug 5366,2019-08-01,09:00:00,146,90,56,FMN GV 16 Berchem TOT
54,Posthofbrug 5366,2019-08-01,10:00:00,95,62,33,FMN GV 16 Berchem TOT
54,Posthofbrug 5366,2019-08-01,11:00:00,102,66,36,FMN GV 16 Berchem TOT
54,Posthofbrug 5366,2019-08-01,12:00:00,123,73,50,FMN GV 16 Berchem TOT
54,Posthofbrug 5366,2019-08-01,13:00:00,127,67,60,FMN GV 16 Berchem TOT
54,Posthofbrug 5366,2019-08-01,14:00:00,103,57,46,FMN GV 16 Berchem TOT
54,Posthofbrug 5366,2019-08-01,15:00:00,144,57,87,FMN GV 16 Berchem TOT
54,Posthofbrug 5366,2019-08-01,16:00:00,270,110,160,FMN GV 16 Berchem TOT
54,Posthofbrug 5366,2019-08-01,17:00:00,400,155,245,FMN GV 16 Berchem TOT
54,Posthofbrug 5366,2019-08-01,18:00:00,241,85,156,FMN GV 16 Berchem TOT
54,Posthofbrug 5366,2019-08-01,19:00:00,129,49,80,FMN GV 16 Berchem TOT
54,Posthofbrug 5366,2019-08-01,20:00:00,91,42,49,FMN GV 16 Berchem TOT
54,Posthofbrug 5366,2019-08-01,21:00:00,82,35,47,FMN GV 16 Berchem TOT
54,Posthofbrug 5366,2019-08-01,22:00:00,53,14,39,FMN GV 16 Berchem TOT
54,Posthofbrug 5366,2019-08-01,23:00:00,48,11,37,FMN GV 16 Berchem TOT
54,Posthofbrug 5366,2019-08-02,00:00:00,40,7,33,FMN GV 16 Berchem TOT
54,Posthofbrug 5366,2019-08-02,01:00:00,6,1,5,FMN GV 16 Berchem TOT
54,Posthofbrug 5366,2019-08-02,02:00:00,7,4,3,FMN GV 16 Berchem TOT
54,Posthofbrug 5366,2019-08-02,03:00:00,5,4,1,FMN GV 16 Berchem TOT
54,Posthofbrug 5366,2019-08-02,04:00:00,8,4,4,FMN GV 16 Berchem TOT
54,Posthofbrug 5366,2019-08-02,05:00:00,18,9,9,FMN GV 16 Berchem TOT
54,Posthofbrug 5366,2019-08-02,06:00:00,50,42,8,FMN GV 16 Berchem TOT
54,Posthofbrug 5366,2019-08-02,07:00:00,167,108,59,FMN GV 16 Berchem TOT
54,Posthofbrug 5366,2019-08-02,08:00:00,305,189,116,FMN GV 16 Berchem TOT
54,Posthofbrug 5366,2019-08-02,09:00:00,148,91,57,FMN GV 16 Berchem TOT
54,Posthofbrug 5366,2019-08-02,10:00:00,71,50,21,FMN GV 16 Berchem TOT
54,Posthofbrug 5366,2019-08-02,11:00:00,79,43,36,FMN GV 16 Berchem TOT
54,Posthofbrug 5366,2019-08-02,12:00:00,84,46,38,FMN GV 16 Berchem TOT
54,Posthofbrug 5366,2019-08-02,13:00:00,102,58,44,FMN GV 16 Berchem TOT
54,Posthofbrug 5366,2019-08-02,14:00:00,87,46,41,FMN GV 16 Berchem TOT
54,Posthofbrug 5366,2019-08-02,15:00:00,125,55,70,FMN GV 16 Berchem TOT
54,Posthofbrug 5366,2019-08-02,16:00:00,262,117,145,FMN GV 16 Berchem TOT
54,Posthofbrug 5366,2019-08-02,17:00:00,294,117,177,FMN GV 16 Berchem TOT
54,Posthofbrug 5366,2019-08-02,18:00:00,187,92,95,FMN GV 16 Berchem TOT
54,Posthofbrug 5366,2019-08-02,19:00:00,85,55,30,FMN GV 16 Berchem TOT
54,Posthofbrug 5366,2019-08-02,20:00:00,100,48,52,FMN GV 16 Berchem TOT
54,Posthofbrug 5366,2019-08-02,21:00:00,62,39,23,FMN GV 16 Berchem TOT
54,Posthofbrug 5366,2019-08-02,22:00:00,37,12,25,FMN GV 16 Berchem TOT
54,Posthofbrug 5366,2019-08-02,23:00:00,38,11,27,FMN GV 16 Berchem TOT
54,Posthofbrug 5366,2019-08-03,00:00:00,29,5,24,FMN GV 16 Berchem TOT
54,Posthofbrug 5366,2019-08-03,01:00:00,29,3,26,FMN GV 16 Berchem TOT
54,Posthofbrug 5366,2019-08-03,02:00:00,25,3,22,FMN GV 16 Berchem TOT
54,Posthofbrug 5366,2019-08-03,03:00:00,16,4,12,FMN GV 16 Berchem TOT
54,Posthofbrug 5366,2019-08-03,04:00:00,13,5,8,FMN GV 16 Berchem TOT
54,Posthofbrug 5366,2019-08-03,05:00:00,13,8,5,FMN GV 16 Berchem TOT
54,Posthofbrug 5366,2019-08-03,06:00:00,8,6,2,FMN GV 16 Berchem TOT
54,Posthofbrug 5366,2019-08-03,07:00:00,11,9,2,FMN GV 16 Berchem TOT
54,Posthofbrug 5366,2019-08-03,08:00:00,43,26,17,FMN GV 16 Berchem TOT
54,Posthofbrug 5366,2019-08-03,09:00:00,46,29,17,FMN GV 16 Berchem TOT
54,Posthofbrug 5366,2019-08-03,10:00:00,62,48,14,FMN GV 16 Berchem TOT
54,Posthofbrug 5366,2019-08-03,11:00:00,70,44,26,FMN GV 16 Berchem TOT
54,Posthofbrug 5366,2019-08-03,12:00:00,100,69,31,FMN GV 16 Berchem TOT
54,Posthofbrug 5366,2019-08-03,13:00:00,92,55,37,FMN GV 16 Berchem TOT
54,Posthofbrug 5366,2019-08-03,14:00:00,128,64,64,FMN GV 16 Berchem TOT
54,Posthofbrug 5366,2019-08-03,15:00:00,133,70,63,FMN GV 16 Berchem TOT
54,Posthofbrug 5366,2019-08-03,16:00:00,96,46,50,FMN GV 16 Berchem TOT
54,Posthofbrug 5366,2019-08-03,17:00:00,104,53,51,FMN GV 16 Berchem TOT
54,Posthofbrug 5366,2019-08-03,18:00:00,122,57,65,FMN GV 16 Berchem TOT
54,Posthofbrug 5366,2019-08-03,19:00:00,69,40,29,FMN GV 16 Berchem TOT
54,Posthofbrug 5366,2019-08-03,20:00:00,52,38,14,FMN GV 16 Berchem TOT
54,Posthofbrug 5366,2019-08-03,21:00:00,46,27,19,FMN GV 16 Berchem TOT
54,Posthofbrug 5366,2019-08-03,22:00:00,55,18,37,FMN GV 16 Berchem TOT
54,Posthofbrug 5366,2019-08-03,23:00:00,38,15,23,FMN GV 16 Berchem TOT
54,Posthofbrug 5366,2019-08-04,00:00:00,50,13,37,FMN GV 16 Berchem TOT
54,Posthofbrug 5366,2019-08-04,01:00:00,24,4,20,FMN GV 16 Berchem TOT
54,Posthofbrug 5366,2019-08-04,02:00:00,26,2,24,FMN GV 16 Berchem TOT
54,Posthofbrug 5366,2019-08-04,03:00:00,12,5,7,FMN GV 16 Berchem TOT
54,Posthofbrug 5366,2019-08-04,04:00:00,11,5,6,FMN GV 16 Berchem TOT
54,Posthofbrug 5366,2019-08-04,05:00:00,6,3,3,FMN GV 16 Berchem TOT
54,Posthofbrug 5366,2019-08-04,06:00:00,17,8,9,FMN GV 16 Berchem TOT
54,Posthofbrug 5366,2019-08-04,07:00:00,9,3,6,FMN GV 16 Berchem TOT
54,Posthofbrug 5366,2019-08-04,08:00:00,25,16,9,FMN GV 16 Berchem TOT
54,Posthofbrug 5366,2019-08-04,09:00:00,57,27,30,FMN GV 16 Berchem TOT
54,Posthofbrug 5366,2019-08-04,10:00:00,99,66,33,FMN GV 16 Berchem TOT
54,Posthofbrug 5366,2019-08-04,11:00:00,126,88,38,FMN GV 16 Berchem TOT
54,Posthofbrug 5366,2019-08-04,12:00:00,143,76,67,FMN GV 16 Berchem TOT
54,Posthofbrug 5366,2019-08-04,13:00:00,164,108,56,FMN GV 16 Berchem TOT
54,Posthofbrug 5366,2019-08-04,14:00:00,210,109,101,FMN GV 16 Berchem TOT
54,Posthofbrug 5366,2019-08-04,15:00:00,201,98,103,FMN GV 16 Berchem TOT
54,Posthofbrug 5366,2019-08-04,16:00:00,191,86,105,FMN GV 16 Berchem TOT
54,Posthofbrug 5366,2019-08-04,17:00:00,160,61,99,FMN GV 16 Berchem TOT
54,Posthofbrug 5366,2019-08-04,18:00:00,116,53,63,FMN GV 16 Berchem TOT
54,Posthofbrug 5366,2019-08-04,19:00:00,107,51,56,FMN GV 16 Berchem TOT
54,Posthofbrug 5366,2019-08-04,20:00:00,80,34,46,FMN GV 16 Berchem TOT
54,Posthofbrug 5366,2019-08-04,21:00:00,63,24,39,FMN GV 16 Berchem TOT
54,Posthofbrug 5366,2019-08-04,22:00:00,45,20,25,FMN GV 16 Berchem TOT
54,Posthofbrug 5366,2019-08-04,23:00:00,27,7,20,FMN GV 16 Berchem TOT
54,Posthofbrug 5366,2019-08-05,00:00:00,17,5,12,FMN GV 16 Berchem TOT
54,Posthofbrug 5366,2019-08-05,01:00:00,8,2,6,FMN GV 16 Berchem TOT
54,Posthofbrug 5366,2019-08-05,02:00:00,3,1,2,FMN GV 16 Berchem TOT
54,Posthofbrug 5366,2019-08-05,03:00:00,0,0,0,FMN GV 16 Berchem TOT
54,Posthofbrug 5366,2019-08-05,04:00:00,6,5,1,FMN GV 16 Berchem TOT
54,Posthofbrug 5366,2019-08-05,05:00:00,23,16,7,FMN GV 16 Berchem TOT
54,Posthofbrug 5366,2019-08-05,06:00:00,93,74,19,FMN GV 16 Berchem TOT
54,Posthofbrug 5366,2019-08-05,07:00:00,257,181,76,FMN GV 16 Berchem TOT
54,Posthofbrug 5366,2019-08-05,08:00:00,455,266,189,FMN GV 16 Berchem TOT
54,Posthofbrug 5366,2019-08-05,09:00:00,214,135,79,FMN GV 16 Berchem TOT
54,Posthofbrug 5366,2019-08-05,10:00:00,67,39,28,FMN GV 16 Berchem TOT
54,Posthofbrug 5366,2019-08-05,11:00:00,91,68,23,FMN GV 16 Berchem TOT
54,Posthofbrug 5366,2019-08-05,12:00:00,105,63,42,FMN GV 16 Berchem TOT
54,Posthofbrug 5366,2019-08-05,13:00:00,134,69,65,FMN GV 16 Berchem TOT
54,Posthofbrug 5366,2019-08-05,14:00:00,123,79,44,FMN GV 16 Berchem TOT
54,Posthofbrug 5366,2019-08-05,15:00:00,143,64,79,FMN GV 16 Berchem TOT
54,Posthofbrug 5366,2019-08-05,16:00:00,324,146,178,FMN GV 16 Berchem TOT
54,Posthofbrug 5366,2019-08-05,17:00:00,471,166,305,FMN GV 16 Berchem TOT
54,Posthofbrug 5366,2019-08-05,18:00:00,302,116,186,FMN GV 16 Berchem TOT
54,Posthofbrug 5366,2019-08-05,19:00:00,116,48,68,FMN GV 16 Berchem TOT
54,Posthofbrug 5366,2019-08-05,20:00:00,93,43,50,FMN GV 16 Berchem TOT
54,Posthofbrug 5366,2019-08-05,21:00:00,65,26,39,FMN GV 16 Berchem TOT
54,Posthofbrug 5366,2019-08-05,22:00:00,65,30,35,FMN GV 16 Berchem TOT
54,Posthofbrug 5366,2019-08-05,23:00:00,27,7,20,FMN GV 16 Berchem TOT
54,Posthofbrug 5366,2019-08-06,00:00:00,12,1,11,FMN GV 16 Berchem TOT
54,Posthofbrug 5366,2019-08-06,01:00:00,4,2,2,FMN GV 16 Berchem TOT
54,Posthofbrug 5366,2019-08-06,02:00:00,10,1,9,FMN GV 16 Berchem TOT
54,Posthofbrug 5366,2019-08-06,03:00:00,5,1,4,FMN GV 16 Berchem TOT
54,Posthofbrug 5366,2019-08-06,04:00:00,8,6,2,FMN GV 16 Berchem TOT
54,Posthofbrug 5366,2019-08-06,05:00:00,11,7,4,FMN GV 16 Berchem TOT
54,Posthofbrug 5366,2019-08-06,06:00:00,91,75,16,FMN GV 16 Berchem TOT
54,Posthofbrug 5366,2019-08-06,07:00:00,267,195,72,FMN GV 16 Berchem TOT
54,Posthofbrug 5366,2019-08-06,08:00:00,385,253,132,FMN GV 16 Berchem TOT
54,Posthofbrug 5366,2019-08-06,09:00:00,198,122,76,FMN GV 16 Berchem TOT
54,Posthofbrug 5366,2019-08-06,10:00:00,109,80,29,FMN GV 16 Berchem TOT
54,Posthofbrug 5366,2019-08-06,11:00:00,109,66,43,FMN GV 16 Berchem TOT
54,Posthofbrug 5366,2019-08-06,12:00:00,117,72,45,FMN GV 16 Berchem TOT
54,Posthofbrug 5366,2019-08-06,13:00:00,132,69,63,FMN GV 16 Berchem TOT
54,Posthofbrug 5366,2019-08-06,14:00:00,99,49,50,FMN GV 16 Berchem TOT
54,Posthofbrug 5366,2019-08-06,15:00:00,158,65,93,FMN GV 16 Berchem TOT
54,Posthofbrug 5366,2019-08-06,16:00:00,336,144,192,FMN GV 16 Berchem TOT
54,Posthofbrug 5366,2019-08-06,17:00:00,433,158,275,FMN GV 16 Berchem TOT
54,Posthofbrug 5366,2019-08-06,18:00:00,293,108,185,FMN GV 16 Berchem TOT
54,Posthofbrug 5366,2019-08-06,19:00:00,117,49,68,FMN GV 16 Berchem TOT
54,Posthofbrug 5366,2019-08-06,20:00:00,93,35,58,FMN GV 16 Berchem TOT
54,Posthofbrug 5366,2019-08-06,21:00:00,91,48,43,FMN GV 16 Berchem TOT
54,Posthofbrug 5366,2019-08-06,22:00:00,72,22,50,FMN GV 16 Berchem TOT
54,Posthofbrug 5366,2019-08-06,23:00:00,40,21,19,FMN GV 16 Berchem TOT
54,Posthofbrug 5366,2019-08-07,00:00:00,22,13,9,FMN GV 16 Berchem TOT
54,Posthofbrug 5366,2019-08-07,01:00:00,8,1,7,FMN GV 16 Berchem TOT
54,Posthofbrug 5366,2019-08-07,02:00:00,5,1,4,FMN GV 16 Berchem TOT
54,Posthofbrug 5366,2019-08-07,03:00:00,4,2,2,FMN GV 16 Berchem TOT
54,Posthofbrug 5366,2019-08-07,04:00:00,7,7,0,FMN GV 16 Berchem TOT
54,Posthofbrug 5366,2019-08-07,05:00:00,9,8,1,FMN GV 16 Berchem TOT
54,Posthofbrug 5366,2019-08-07,06:00:00,73,62,11,FMN GV 16 Berchem TOT
54,Posthofbrug 5366,2019-08-07,07:00:00,219,150,69,FMN GV 16 Berchem TOT
54,Posthofbrug 5366,2019-08-07,08:00:00,393,253,140,FMN GV 16 Berchem TOT
54,Posthofbrug 5366,2019-08-07,09:00:00,182,119,63,FMN GV 16 Berchem TOT
54,Posthofbrug 5366,2019-08-07,10:00:00,79,57,22,FMN GV 16 Berchem TOT
54,Posthofbrug 5366,2019-08-07,11:00:00,101,58,43,FMN GV 16 Berchem TOT
54,Posthofbrug 5366,2019-08-07,12:00:00,127,81,46,FMN GV 16 Berchem TOT
54,Posthofbrug 5366,2019-08-07,13:00:00,134,82,52,FMN GV 16 Berchem TOT
54,Posthofbrug 5366,2019-08-07,14:00:00,131,76,55,FMN GV 16 Berchem TOT
54,Posthofbrug 5366,2019-08-07,15:00:00,147,80,67,FMN GV 16 Berchem TOT
54,Posthofbrug 5366,2019-08-07,16:00:00,299,129,170,FMN GV 16 Berchem TOT
54,Posthofbrug 5366,2019-08-07,17:00:00,449,182,267,FMN GV 16 Berchem TOT
54,Posthofbrug 5366,2019-08-07,18:00:00,273,104,169,FMN GV 16 Berchem TOT
54,Posthofbrug 5366,2019-08-07,19:00:00,137,65,72,FMN GV 16 Berchem TOT
54,Posthofbrug 5366,2019-08-07,20:00:00,85,35,50,FMN GV 16 Berchem TOT
54,Posthofbrug 5366,2019-08-07,21:00:00,70,34,36,FMN GV 16 Berchem TOT
54,Posthofbrug 5366,2019-08-07,22:00:00,65,28,37,FMN GV 16 Berchem TOT
54,Posthofbrug 5366,2019-08-07,23:00:00,48,19,29,FMN GV 16 Berchem TOT
54,Posthofbrug 5366,2019-08-08,00:00:00,16,3,13,FMN GV 16 Berchem TOT
54,Posthofbrug 5366,2019-08-08,01:00:00,10,4,6,FMN GV 16 Berchem TOT
54,Posthofbrug 5366,2019-08-08,02:00:00,6,1,5,FMN GV 16 Berchem TOT
54,Posthofbrug 5366,2019-08-08,03:00:00,5,1,4,FMN GV 16 Berchem TOT
54,Posthofbrug 5366,2019-08-08,04:00:00,12,10,2,FMN GV 16 Berchem TOT
54,Posthofbrug 5366,2019-08-08,05:00:00,12,7,5,FMN GV 16 Berchem TOT
54,Posthofbrug 5366,2019-08-08,06:00:00,79,67,12,FMN GV 16 Berchem TOT
54,Posthofbrug 5366,2019-08-08,07:00:00,218,163,55,FMN GV 16 Berchem TOT
54,Posthofbrug 5366,2019-08-08,08:00:00,380,250,130,FMN GV 16 Berchem TOT
54,Posthofbrug 5366,2019-08-08,09:00:00,193,126,67,FMN GV 16 Berchem TOT
54,Posthofbrug 5366,2019-08-08,10:00:00,85,62,23,FMN GV 16 Berchem TOT
54,Posthofbrug 5366,2019-08-08,11:00:00,102,66,36,FMN GV 16 Berchem TOT
54,Posthofbrug 5366,2019-08-08,12:00:00,133,83,50,FMN GV 16 Berchem TOT
54,Posthofbrug 5366,2019-08-08,13:00:00,150,87,63,FMN GV 16 Berchem TOT
54,Posthofbrug 5366,2019-08-08,14:00:00,143,73,70,FMN GV 16 Berchem TOT
54,Posthofbrug 5366,2019-08-08,15:00:00,172,94,78,FMN GV 16 Berchem TOT
54,Posthofbrug 5366,2019-08-08,16:00:00,341,162,179,FMN GV 16 Berchem TOT
54,Posthofbrug 5366,2019-08-08,17:00:00,491,197,294,FMN GV 16 Berchem TOT
54,Posthofbrug 5366,2019-08-08,18:00:00,263,90,173,FMN GV 16 Berchem TOT
54,Posthofbrug 5366,2019-08-08,19:00:00,149,64,85,FMN GV 16 Berchem TOT
54,Posthofbrug 5366,2019-08-08,20:00:00,121,59,62,FMN GV 16 Berchem TOT
54,Posthofbrug 5366,2019-08-08,21:00:00,83,44,39,FMN GV 16 Berchem TOT
54,Posthofbrug 5366,2019-08-08,22:00:00,61,23,38,FMN GV 16 Berchem TOT
54,Posthofbrug 5366,2019-08-08,23:00:00,54,11,43,FMN GV 16 Berchem TOT
54,Posthofbrug 5366,2019-08-09,00:00:00,44,10,34,FMN GV 16 Berchem TOT
54,Posthofbrug 5366,2019-08-09,01:00:00,14,4,10,FMN GV 16 Berchem TOT
54,Posthofbrug 5366,2019-08-09,02:00:00,3,0,3,FMN GV 16 Berchem TOT
54,Posthofbrug 5366,2019-08-09,03:00:00,2,1,1,FMN GV 16 Berchem TOT
54,Posthofbrug 5366,2019-08-09,04:00:00,7,6,1,FMN GV 16 Berchem TOT
54,Posthofbrug 5366,2019-08-09,05:00:00,9,4,5,FMN GV 16 Berchem TOT
54,Posthofbrug 5366,2019-08-09,06:00:00,54,48,6,FMN GV 16 Berchem TOT
54,Posthofbrug 5366,2019-08-09,07:00:00,135,87,48,FMN GV 16 Berchem TOT
54,Posthofbrug 5366,2019-08-09,08:00:00,248,146,102,FMN GV 16 Berchem TOT
54,Posthofbrug 5366,2019-08-09,09:00:00,132,85,47,FMN GV 16 Berchem TOT
54,Posthofbrug 5366,2019-08-09,10:00:00,34,25,9,FMN GV 16 Berchem TOT
54,Posthofbrug 5366,2019-08-09,11:00:00,22,8,14,FMN GV 16 Berchem TOT
54,Posthofbrug 5366,2019-08-09,12:00:00,49,27,22,FMN GV 16 Berchem TOT
54,Posthofbrug 5366,2019-08-09,13:00:00,50,25,25,FMN GV 16 Berchem TOT
54,Posthofbrug 5366,2019-08-09,14:00:00,52,23,29,FMN GV 16 Berchem TOT
54,Posthofbrug 5366,2019-08-09,15:00:00,104,49,55,FMN GV 16 Berchem TOT
54,Posthofbrug 5366,2019-08-09,16:00:00,200,98,102,FMN GV 16 Berchem TOT
54,Posthofbrug 5366,2019-08-09,17:00:00,251,108,143,FMN GV 16 Berchem TOT
54,Posthofbrug 5366,2019-08-09,18:00:00,151,59,92,FMN GV 16 Berchem TOT
54,Posthofbrug 5366,2019-08-09,19:00:00,96,40,56,FMN GV 16 Berchem TOT
54,Posthofbrug 5366,2019-08-09,20:00:00,70,33,37,FMN GV 16 Berchem TOT
54,Posthofbrug 5366,2019-08-09,21:00:00,52,27,25,FMN GV 16 Berchem TOT
54,Posthofbrug 5366,2019-08-09,22:00:00,58,27,31,FMN GV 16 Berchem TOT
54,Posthofbrug 5366,2019-08-09,23:00:00,37,12,25,FMN GV 16 Berchem TOT
54,Posthofbrug 5366,2019-08-10,00:00:00,32,7,25,FMN GV 16 Berchem TOT
54,Posthofbrug 5366,2019-08-10,01:00:00,36,9,27,FMN GV 16 Berchem TOT
54,Posthofbrug 5366,2019-08-10,02:00:00,6,2,4,FMN GV 16 Berchem TOT
54,Posthofbrug 5366,2019-08-10,03:00:00,15,4,11,FMN GV 16 Berchem TOT
54,Posthofbrug 5366,2019-08-10,04:00:00,21,8,13,FMN GV 16 Berchem TOT
54,Posthofbrug 5366,2019-08-10,05:00:00,11,6,5,FMN GV 16 Berchem TOT
54,Posthofbrug 5366,2019-08-10,06:00:00,11,9,2,FMN GV 16 Berchem TOT
54,Posthofbrug 5366,2019-08-10,07:00:00,22,16,6,FMN GV 16 Berchem TOT
54,Posthofbrug 5366,2019-08-10,08:00:00,30,21,9,FMN GV 16 Berchem TOT
54,Posthofbrug 5366,2019-08-10,09:00:00,40,29,11,FMN GV 16 Berchem TOT
54,Posthofbrug 5366,2019-08-10,10:00:00,75,60,15,FMN GV 16 Berchem TOT
54,Posthofbrug 5366,2019-08-10,11:00:00,60,32,28,FMN GV 16 Berchem TOT
54,Posthofbrug 5366,2019-08-10,12:00:00,86,50,36,FMN GV 16 Berchem TOT
54,Posthofbrug 5366,2019-08-10,13:00:00,111,79,32,FMN GV 16 Berchem TOT
54,Posthofbrug 5366,2019-08-10,14:00:00,83,48,35,FMN GV 16 Berchem TOT
54,Posthofbrug 5366,2019-08-10,15:00:00,108,58,50,FMN GV 16 Berchem TOT
54,Posthofbrug 5366,2019-08-10,16:00:00,98,46,52,FMN GV 16 Berchem TOT
54,Posthofbrug 5366,2019-08-10,17:00:00,109,42,67,FMN GV 16 Berchem TOT
54,Posthofbrug 5366,2019-08-10,18:00:00,99,54,45,FMN GV 16 Berchem TOT
54,Posthofbrug 5366,2019-08-10,19:00:00,70,42,28,FMN GV 16 Berchem TOT
54,Posthofbrug 5366,2019-08-10,20:00:00,54,28,26,FMN GV 16 Berchem TOT
54,Posthofbrug 5366,2019-08-10,21:00:00,61,28,33,FMN GV 16 Berchem TOT
54,Posthofbrug 5366,2019-08-10,22:00:00,50,24,26,FMN GV 16 Berchem TOT
54,Posthofbrug 5366,2019-08-10,23:00:00,47,20,27,FMN GV 16 Berchem TOT
54,Posthofbrug 5366,2019-08-11,00:00:00,21,6,15,FMN GV 16 Berchem TOT
54,Posthofbrug 5366,2019-08-11,01:00:00,23,8,15,FMN GV 16 Berchem TOT
54,Posthofbrug 5366,2019-08-11,02:00:00,8,3,5,FMN GV 16 Berchem TOT
54,Posthofbrug 5366,2019-08-11,03:00:00,10,1,9,FMN GV 16 Berchem TOT
54,Posthofbrug 5366,2019-08-11,04:00:00,4,1,3,FMN GV 16 Berchem TOT
54,Posthofbrug 5366,2019-08-11,05:00:00,7,4,3,FMN GV 16 Berchem TOT
54,Posthofbrug 5366,2019-08-11,06:00:00,18,8,10,FMN GV 16 Berchem TOT
54,Posthofbrug 5366,2019-08-11,07:00:00,17,10,7,FMN GV 16 Berchem TOT
54,Posthofbrug 5366,2019-08-11,08:00:00,24,13,11,FMN GV 16 Berchem TOT
54,Posthofbrug 5366,2019-08-11,09:00:00,50,25,25,FMN GV 16 Berchem TOT
54,Posthofbrug 5366,2019-08-11,10:00:00,91,63,28,FMN GV 16 Berchem TOT
54,Posthofbrug 5366,2019-08-11,11:00:00,96,65,31,FMN GV 16 Berchem TOT
54,Posthofbrug 5366,2019-08-11,12:00:00,143,85,58,FMN GV 16 Berchem TOT
54,Posthofbrug 5366,2019-08-11,13:00:00,111,72,39,FMN GV 16 Berchem TOT
54,Posthofbrug 5366,2019-08-11,14:00:00,155,104,51,FMN GV 16 Berchem TOT
54,Posthofbrug 5366,2019-08-11,15:00:00,133,80,53,FMN GV 16 Berchem TOT
54,Posthofbrug 5366,2019-08-11,16:00:00,120,49,71,FMN GV 16 Berchem TOT
54,Posthofbrug 5366,2019-08-11,17:00:00,83,37,46,FMN GV 16 Berchem TOT
54,Posthofbrug 5366,2019-08-11,18:00:00,96,51,45,FMN GV 16 Berchem TOT
54,Posthofbrug 5366,2019-08-11,19:00:00,72,22,50,FMN GV 16 Berchem TOT
54,Posthofbrug 5366,2019-08-11,20:00:00,49,23,26,FMN GV 16 Berchem TOT
54,Posthofbrug 5366,2019-08-11,21:00:00,46,19,27,FMN GV 16 Berchem TOT
54,Posthofbrug 5366,2019-08-11,22:00:00,30,12,18,FMN GV 16 Berchem TOT
54,Posthofbrug 5366,2019-08-11,23:00:00,20,7,13,FMN GV 16 Berchem TOT
54,Posthofbrug 5366,2019-08-12,00:00:00,12,2,10,FMN GV 16 Berchem TOT
54,Posthofbrug 5366,2019-08-12,01:00:00,3,1,2,FMN GV 16 Berchem TOT
54,Posthofbrug 5366,2019-08-12,02:00:00,3,1,2,FMN GV 16 Berchem TOT
54,Posthofbrug 5366,2019-08-12,03:00:00,2,1,1,FMN GV 16 Berchem TOT
54,Posthofbrug 5366,2019-08-12,04:00:00,5,3,2,FMN GV 16 Berchem TOT
54,Posthofbrug 5366,2019-08-12,05:00:00,9,8,1,FMN GV 16 Berchem TOT
54,Posthofbrug 5366,2019-08-12,06:00:00,66,58,8,FMN GV 16 Berchem TOT
54,Posthofbrug 5366,2019-08-12,07:00:00,221,161,60,FMN GV 16 Berchem TOT
54,Posthofbrug 5366,2019-08-12,08:00:00,348,209,139,FMN GV 16 Berchem TOT
54,Posthofbrug 5366,2019-08-12,09:00:00,156,105,51,FMN GV 16 Berchem TOT
54,Posthofbrug 5366,2019-08-12,10:00:00,93,63,30,FMN GV 16 Berchem TOT
54,Posthofbrug 5366,2019-08-12,11:00:00,92,58,34,FMN GV 16 Berchem TOT
54,Posthofbrug 5366,2019-08-12,12:00:00,110,71,39,FMN GV 16 Berchem TOT
54,Posthofbrug 5366,2019-08-12,13:00:00,119,67,52,FMN GV 16 Berchem TOT
54,Posthofbrug 5366,2019-08-12,14:00:00,107,60,47,FMN GV 16 Berchem TOT
54,Posthofbrug 5366,2019-08-12,15:00:00,95,37,58,FMN GV 16 Berchem TOT
54,Posthofbrug 5366,2019-08-12,16:00:00,215,104,111,FMN GV 16 Berchem TOT
54,Posthofbrug 5366,2019-08-12,17:00:00,387,139,248,FMN GV 16 Berchem TOT
54,Posthofbrug 5366,2019-08-12,18:00:00,204,68,136,FMN GV 16 Berchem TOT
54,Posthofbrug 5366,2019-08-12,19:00:00,79,21,58,FMN GV 16 Berchem TOT
54,Posthofbrug 5366,2019-08-12,20:00:00,62,37,25,FMN GV 16 Berchem TOT
54,Posthofbrug 5366,2019-08-12,21:00:00,22,12,10,FMN GV 16 Berchem TOT
54,Posthofbrug 5366,2019-08-12,22:00:00,31,7,24,FMN GV 16 Berchem TOT
54,Posthofbrug 5366,2019-08-12,23:00:00,13,2,11,FMN GV 16 Berchem TOT
54,Posthofbrug 5366,2019-08-13,00:00:00,9,1,8,FMN GV 16 Berchem TOT
54,Posthofbrug 5366,2019-08-13,01:00:00,7,3,4,FMN GV 16 Berchem TOT
54,Posthofbrug 5366,2019-08-13,02:00:00,5,3,2,FMN GV 16 Berchem TOT
54,Posthofbrug 5366,2019-08-13,03:00:00,3,2,1,FMN GV 16 Berchem TOT
54,Posthofbrug 5366,2019-08-13,04:00:00,5,4,1,FMN GV 16 Berchem TOT
54,Posthofbrug 5366,2019-08-13,05:00:00,15,13,2,FMN GV 16 Berchem TOT
54,Posthofbrug 5366,2019-08-13,06:00:00,67,55,12,FMN GV 16 Berchem TOT
54,Posthofbrug 5366,2019-08-13,07:00:00,226,164,62,FMN GV 16 Berchem TOT
54,Posthofbrug 5366,2019-08-13,08:00:00,371,247,124,FMN GV 16 Berchem TOT
54,Posthofbrug 5366,2019-08-13,09:00:00,152,98,54,FMN GV 16 Berchem TOT
54,Posthofbrug 5366,2019-08-13,10:00:00,100,60,40,FMN GV 16 Berchem TOT
54,Posthofbrug 5366,2019-08-13,11:00:00,119,82,37,FMN GV 16 Berchem TOT
54,Posthofbrug 5366,2019-08-13,12:00:00,136,95,41,FMN GV 16 Berchem TOT
54,Posthofbrug 5366,2019-08-13,13:00:00,117,72,45,FMN GV 16 Berchem TOT
54,Posthofbrug 5366,2019-08-13,14:00:00,61,25,36,FMN GV 16 Berchem TOT
54,Posthofbrug 5366,2019-08-13,15:00:00,100,47,53,FMN GV 16 Berchem TOT
54,Posthofbrug 5366,2019-08-13,16:00:00,281,145,136,FMN GV 16 Berchem TOT
54,Posthofbrug 5366,2019-08-13,17:00:00,381,147,234,FMN GV 16 Berchem TOT
54,Posthofbrug 5366,2019-08-13,18:00:00,217,78,139,FMN GV 16 Berchem TOT
54,Posthofbrug 5366,2019-08-13,19:00:00,113,41,72,FMN GV 16 Berchem TOT
54,Posthofbrug 5366,2019-08-13,20:00:00,61,31,30,FMN GV 16 Berchem TOT
54,Posthofbrug 5366,2019-08-13,21:00:00,72,25,47,FMN GV 16 Berchem TOT
54,Posthofbrug 5366,2019-08-13,22:00:00,42,18,24,FMN GV 16 Berchem TOT
54,Posthofbrug 5366,2019-08-13,23:00:00,41,13,28,FMN GV 16 Berchem TOT
54,Posthofbrug 5366,2019-08-14,00:00:00,11,6,5,FMN GV 16 Berchem TOT
54,Posthofbrug 5366,2019-08-14,01:00:00,3,2,1,FMN GV 16 Berchem TOT
54,Posthofbrug 5366,2019-08-14,02:00:00,3,2,1,FMN GV 16 Berchem TOT
54,Posthofbrug 5366,2019-08-14,03:00:00,8,2,6,FMN GV 16 Berchem TOT
54,Posthofbrug 5366,2019-08-14,04:00:00,5,2,3,FMN GV 16 Berchem TOT
54,Posthofbrug 5366,2019-08-14,05:00:00,16,12,4,FMN GV 16 Berchem TOT
54,Posthofbrug 5366,2019-08-14,06:00:00,73,60,13,FMN GV 16 Berchem TOT
54,Posthofbrug 5366,2019-08-14,07:00:00,183,132,51,FMN GV 16 Berchem TOT
54,Posthofbrug 5366,2019-08-14,08:00:00,319,215,104,FMN GV 16 Berchem TOT
54,Posthofbrug 5366,2019-08-14,09:00:00,178,123,55,FMN GV 16 Berchem TOT
54,Posthofbrug 5366,2019-08-14,10:00:00,95,51,44,FMN GV 16 Berchem TOT
54,Posthofbrug 5366,2019-08-14,11:00:00,120,69,51,FMN GV 16 Berchem TOT
54,Posthofbrug 5366,2019-08-14,12:00:00,138,81,57,FMN GV 16 Berchem TOT
54,Posthofbrug 5366,2019-08-14,13:00:00,132,80,52,FMN GV 16 Berchem TOT
54,Posthofbrug 5366,2019-08-14,14:00:00,131,76,55,FMN GV 16 Berchem TOT
54,Posthofbrug 5366,2019-08-14,15:00:00,149,80,69,FMN GV 16 Berchem TOT
54,Posthofbrug 5366,2019-08-14,16:00:00,248,107,141,FMN GV 16 Berchem TOT
54,Posthofbrug 5366,2019-08-14,17:00:00,360,147,213,FMN GV 16 Berchem TOT
54,Posthofbrug 5366,2019-08-14,18:00:00,188,67,121,FMN GV 16 Berchem TOT
54,Posthofbrug 5366,2019-08-14,19:00:00,103,43,60,FMN GV 16 Berchem TOT
54,Posthofbrug 5366,2019-08-14,20:00:00,51,34,17,FMN GV 16 Berchem TOT
54,Posthofbrug 5366,2019-08-14,21:00:00,46,28,18,FMN GV 16 Berchem TOT
54,Posthofbrug 5366,2019-08-14,22:00:00,35,23,12,FMN GV 16 Berchem TOT
54,Posthofbrug 5366,2019-08-14,23:00:00,40,8,32,FMN GV 16 Berchem TOT
54,Posthofbrug 5366,2019-08-15,00:00:00,38,18,20,FMN GV 16 Berchem TOT
54,Posthofbrug 5366,2019-08-15,01:00:00,19,7,12,FMN GV 16 Berchem TOT
54,Posthofbrug 5366,2019-08-15,02:00:00,17,5,12,FMN GV 16 Berchem TOT
54,Posthofbrug 5366,2019-08-15,03:00:00,9,5,4,FMN GV 16 Berchem TOT
54,Posthofbrug 5366,2019-08-15,04:00:00,10,7,3,FMN GV 16 Berchem TOT
54,Posthofbrug 5366,2019-08-15,05:00:00,11,8,3,FMN GV 16 Berchem TOT
54,Posthofbrug 5366,2019-08-15,06:00:00,11,7,4,FMN GV 16 Berchem TOT
54,Posthofbrug 5366,2019-08-15,07:00:00,11,5,6,FMN GV 16 Berchem TOT
54,Posthofbrug 5366,2019-08-15,08:00:00,30,19,11,FMN GV 16 Berchem TOT
54,Posthofbrug 5366,2019-08-15,09:00:00,40,25,15,FMN GV 16 Berchem TOT
54,Posthofbrug 5366,2019-08-15,10:00:00,45,34,11,FMN GV 16 Berchem TOT
54,Posthofbrug 5366,2019-08-15,11:00:00,47,27,20,FMN GV 16 Berchem TOT
54,Posthofbrug 5366,2019-08-15,12:00:00,56,34,22,FMN GV 16 Berchem TOT
54,Posthofbrug 5366,2019-08-15,13:00:00,84,53,31,FMN GV 16 Berchem TOT
54,Posthofbrug 5366,2019-08-15,14:00:00,110,61,49,FMN GV 16 Berchem TOT
54,Posthofbrug 5366,2019-08-15,15:00:00,90,51,39,FMN GV 16 Berchem TOT
54,Posthofbrug 5366,2019-08-15,16:00:00,75,36,39,FMN GV 16 Berchem TOT
54,Posthofbrug 5366,2019-08-15,17:00:00,98,52,46,FMN GV 16 Berchem TOT
54,Posthofbrug 5366,2019-08-15,18:00:00,88,49,39,FMN GV 16 Berchem TOT
54,Posthofbrug 5366,2019-08-15,19:00:00,74,42,32,FMN GV 16 Berchem TOT
54,Posthofbrug 5366,2019-08-15,20:00:00,62,27,35,FMN GV 16 Berchem TOT
54,Posthofbrug 5366,2019-08-15,21:00:00,62,21,41,FMN GV 16 Berchem TOT
54,Posthofbrug 5366,2019-08-15,22:00:00,42,21,21,FMN GV 16 Berchem TOT
54,Posthofbrug 5366,2019-08-15,23:00:00,33,21,12,FMN GV 16 Berchem TOT
54,Posthofbrug 5366,2019-08-16,00:00:00,12,5,7,FMN GV 16 Berchem TOT
54,Posthofbrug 5366,2019-08-16,01:00:00,19,10,9,FMN GV 16 Berchem TOT
54,Posthofbrug 5366,2019-08-16,02:00:00,5,3,2,FMN GV 16 Berchem TOT
54,Posthofbrug 5366,2019-08-16,03:00:00,0,0,0,FMN GV 16 Berchem TOT
54,Posthofbrug 5366,2019-08-16,04:00:00,16,11,5,FMN GV 16 Berchem TOT
54,Posthofbrug 5366,2019-08-16,05:00:00,8,6,2,FMN GV 16 Berchem TOT
54,Posthofbrug 5366,2019-08-16,06:00:00,42,33,9,FMN GV 16 Berchem TOT
54,Posthofbrug 5366,2019-08-16,07:00:00,99,70,29,FMN GV 16 Berchem TOT
54,Posthofbrug 5366,2019-08-16,08:00:00,144,99,45,FMN GV 16 Berchem TOT
54,Posthofbrug 5366,2019-08-16,09:00:00,103,71,32,FMN GV 16 Berchem TOT
54,Posthofbrug 5366,2019-08-16,10:00:00,78,51,27,FMN GV 16 Berchem TOT
54,Posthofbrug 5366,2019-08-16,11:00:00,124,82,42,FMN GV 16 Berchem TOT
54,Posthofbrug 5366,2019-08-16,12:00:00,119,71,48,FMN GV 16 Berchem TOT
54,Posthofbrug 5366,2019-08-16,13:00:00,143,89,54,FMN GV 16 Berchem TOT
54,Posthofbrug 5366,2019-08-16,14:00:00,142,81,61,FMN GV 16 Berchem TOT
54,Posthofbrug 5366,2019-08-16,15:00:00,154,84,70,FMN GV 16 Berchem TOT
54,Posthofbrug 5366,2019-08-16,16:00:00,216,109,107,FMN GV 16 Berchem TOT
54,Posthofbrug 5366,2019-08-16,17:00:00,202,88,114,FMN GV 16 Berchem TOT
54,Posthofbrug 5366,2019-08-16,18:00:00,170,86,84,FMN GV 16 Berchem TOT
54,Posthofbrug 5366,2019-08-16,19:00:00,108,66,42,FMN GV 16 Berchem TOT
54,Posthofbrug 5366,2019-08-16,20:00:00,90,49,41,FMN GV 16 Berchem TOT
54,Posthofbrug 5366,2019-08-16,21:00:00,50,27,23,FMN GV 16 Berchem TOT
54,Posthofbrug 5366,2019-08-16,22:00:00,49,22,27,FMN GV 16 Berchem TOT
54,Posthofbrug 5366,2019-08-16,23:00:00,49,15,34,FMN GV 16 Berchem TOT
54,Posthofbrug 5366,2019-08-17,00:00:00,30,7,23,FMN GV 16 Berchem TOT
54,Posthofbrug 5366,2019-08-17,01:00:00,38,8,30,FMN GV 16 Berchem TOT
54,Posthofbrug 5366,2019-08-17,02:00:00,11,1,10,FMN GV 16 Berchem TOT
54,Posthofbrug 5366,2019-08-17,03:00:00,21,2,19,FMN GV 16 Berchem TOT
54,Posthofbrug 5366,2019-08-17,04:00:00,12,6,6,FMN GV 16 Berchem TOT
54,Posthofbrug 5366,2019-08-17,05:00:00,11,5,6,FMN GV 16 Berchem TOT
54,Posthofbrug 5366,2019-08-17,06:00:00,17,13,4,FMN GV 16 Berchem TOT
54,Posthofbrug 5366,2019-08-17,07:00:00,13,10,3,FMN GV 16 Berchem TOT
54,Posthofbrug 5366,2019-08-17,08:00:00,36,24,12,FMN GV 16 Berchem TOT
54,Posthofbrug 5366,2019-08-17,09:00:00,45,26,19,FMN GV 16 Berchem TOT
54,Posthofbrug 5366,2019-08-17,10:00:00,46,31,15,FMN GV 16 Berchem TOT
54,Posthofbrug 5366,2019-08-17,11:00:00,44,23,21,FMN GV 16 Berchem TOT
54,Posthofbrug 5366,2019-08-17,12:00:00,50,29,21,FMN GV 16 Berchem TOT
54,Posthofbrug 5366,2019-08-17,13:00:00,76,46,30,FMN GV 16 Berchem TOT
54,Posthofbrug 5366,2019-08-17,14:00:00,58,33,25,FMN GV 16 Berchem TOT
54,Posthofbrug 5366,2019-08-17,15:00:00,77,39,38,FMN GV 16 Berchem TOT
54,Posthofbrug 5366,2019-08-17,16:00:00,66,40,26,FMN GV 16 Berchem TOT
54,Posthofbrug 5366,2019-08-17,17:00:00,67,34,33,FMN GV 16 Berchem TOT
54,Posthofbrug 5366,2019-08-17,18:00:00,94,43,51,FMN GV 16 Berchem TOT
54,Posthofbrug 5366,2019-08-17,19:00:00,42,21,21,FMN GV 16 Berchem TOT
54,Posthofbrug 5366,2019-08-17,20:00:00,37,20,17,FMN GV 16 Berchem TOT
54,Posthofbrug 5366,2019-08-17,21:00:00,41,19,22,FMN GV 16 Berchem TOT
54,Posthofbrug 5366,2019-08-17,22:00:00,26,10,16,FMN GV 16 Berchem TOT
54,Posthofbrug 5366,2019-08-17,23:00:00,27,10,17,FMN GV 16 Berchem TOT
54,Posthofbrug 5366,2019-08-18,00:00:00,19,5,14,FMN GV 16 Berchem TOT
54,Posthofbrug 5366,2019-08-18,01:00:00,20,5,15,FMN GV 16 Berchem TOT
54,Posthofbrug 5366,2019-08-18,02:00:00,7,1,6,FMN GV 16 Berchem TOT
54,Posthofbrug 5366,2019-08-18,03:00:00,8,1,7,FMN GV 16 Berchem TOT
54,Posthofbrug 5366,2019-08-18,04:00:00,6,4,2,FMN GV 16 Berchem TOT
54,Posthofbrug 5366,2019-08-18,05:00:00,8,5,3,FMN GV 16 Berchem TOT
54,Posthofbrug 5366,2019-08-18,06:00:00,13,8,5,FMN GV 16 Berchem TOT
54,Posthofbrug 5366,2019-08-18,07:00:00,7,4,3,FMN GV 16 Berchem TOT
54,Posthofbrug 5366,2019-08-18,08:00:00,19,7,12,FMN GV 16 Berchem TOT
54,Posthofbrug 5366,2019-08-18,09:00:00,11,6,5,FMN GV 16 Berchem TOT
54,Posthofbrug 5366,2019-08-18,10:00:00,22,10,12,FMN GV 16 Berchem TOT
54,Posthofbrug 5366,2019-08-18,11:00:00,24,15,9,FMN GV 16 Berchem TOT
54,Posthofbrug 5366,2019-08-18,12:00:00,49,30,19,FMN GV 16 Berchem TOT
54,Posthofbrug 5366,2019-08-18,13:00:00,40,31,9,FMN GV 16 Berchem TOT
54,Posthofbrug 5366,2019-08-18,14:00:00,73,44,29,FMN GV 16 Berchem TOT
54,Posthofbrug 5366,2019-08-18,15:00:00,76,45,31,FMN GV 16 Berchem TOT
54,Posthofbrug 5366,2019-08-18,16:00:00,65,43,22,FMN GV 16 Berchem TOT
54,Posthofbrug 5366,2019-08-18,17:00:00,88,41,47,FMN GV 16 Berchem TOT
54,Posthofbrug 5366,2019-08-18,18:00:00,77,37,40,FMN GV 16 Berchem TOT
54,Posthofbrug 5366,2019-08-18,19:00:00,53,21,32,FMN GV 16 Berchem TOT
54,Posthofbrug 5366,2019-08-18,20:00:00,59,26,33,FMN GV 16 Berchem TOT
54,Posthofbrug 5366,2019-08-18,21:00:00,51,28,23,FMN GV 16 Berchem TOT
54,Posthofbrug 5366,2019-08-18,22:00:00,27,16,11,FMN GV 16 Berchem TOT
54,Posthofbrug 5366,2019-08-18,23:00:00,21,6,15,FMN GV 16 Berchem TOT
54,Posthofbrug 5366,2019-08-19,00:00:00,14,2,12,FMN GV 16 Berchem TOT
54,Posthofbrug 5366,2019-08-19,01:00:00,2,1,1,FMN GV 16 Berchem TOT
54,Posthofbrug 5366,2019-08-19,02:00:00,7,2,5,FMN GV 16 Berchem TOT
54,Posthofbrug 5366,2019-08-19,03:00:00,2,1,1,FMN GV 16 Berchem TOT
54,Posthofbrug 5366,2019-08-19,04:00:00,15,12,3,FMN GV 16 Berchem TOT
54,Posthofbrug 5366,2019-08-19,05:00:00,15,13,2,FMN GV 16 Berchem TOT
54,Posthofbrug 5366,2019-08-19,06:00:00,90,78,12,FMN GV 16 Berchem TOT
54,Posthofbrug 5366,2019-08-19,07:00:00,277,212,65,FMN GV 16 Berchem TOT
54,Posthofbrug 5366,2019-08-19,08:00:00,464,324,140,FMN GV 16 Berchem TOT
54,Posthofbrug 5366,2019-08-19,09:00:00,201,140,61,FMN GV 16 Berchem TOT
54,Posthofbrug 5366,2019-08-19,10:00:00,96,65,31,FMN GV 16 Berchem TOT
54,Posthofbrug 5366,2019-08-19,11:00:00,117,77,40,FMN GV 16 Berchem TOT
54,Posthofbrug 5366,2019-08-19,12:00:00,133,83,50,FMN GV 16 Berchem TOT
54,Posthofbrug 5366,2019-08-19,13:00:00,131,74,57,FMN GV 16 Berchem TOT
54,Posthofbrug 5366,2019-08-19,14:00:00,143,74,69,FMN GV 16 Berchem TOT
54,Posthofbrug 5366,2019-08-19,15:00:00,192,92,100,FMN GV 16 Berchem TOT
54,Posthofbrug 5366,2019-08-19,16:00:00,337,156,181,FMN GV 16 Berchem TOT
54,Posthofbrug 5366,2019-08-19,17:00:00,503,198,305,FMN GV 16 Berchem TOT
54,Posthofbrug 5366,2019-08-19,18:00:00,344,108,236,FMN GV 16 Berchem TOT
54,Posthofbrug 5366,2019-08-19,19:00:00,144,61,83,FMN GV 16 Berchem TOT
54,Posthofbrug 5366,2019-08-19,20:00:00,97,53,44,FMN GV 16 Berchem TOT
54,Posthofbrug 5366,2019-08-19,21:00:00,69,34,35,FMN GV 16 Berchem TOT
54,Posthofbrug 5366,2019-08-19,22:00:00,57,23,34,FMN GV 16 Berchem TOT
54,Posthofbrug 5366,2019-08-19,23:00:00,22,5,17,FMN GV 16 Berchem TOT
54,Posthofbrug 5366,2019-08-20,00:00:00,29,12,17,FMN GV 16 Berchem TOT
54,Posthofbrug 5366,2019-08-20,01:00:00,7,1,6,FMN GV 16 Berchem TOT
54,Posthofbrug 5366,2019-08-20,02:00:00,5,0,5,FMN GV 16 Berchem TOT
54,Posthofbrug 5366,2019-08-20,03:00:00,2,1,1,FMN GV 16 Berchem TOT
54,Posthofbrug 5366,2019-08-20,04:00:00,8,5,3,FMN GV 16 Berchem TOT
54,Posthofbrug 5366,2019-08-20,05:00:00,18,15,3,FMN GV 16 Berchem TOT
54,Posthofbrug 5366,2019-08-20,06:00:00,125,101,24,FMN GV 16 Berchem TOT
54,Posthofbrug 5366,2019-08-20,07:00:00,337,242,95,FMN GV 16 Berchem TOT
54,Posthofbrug 5366,2019-08-20,08:00:00,522,364,158,FMN GV 16 Berchem TOT
54,Posthofbrug 5366,2019-08-20,09:00:00,240,174,66,FMN GV 16 Berchem TOT
54,Posthofbrug 5366,2019-08-20,10:00:00,123,89,34,FMN GV 16 Berchem TOT
54,Posthofbrug 5366,2019-08-20,11:00:00,124,89,35,FMN GV 16 Berchem TOT
54,Posthofbrug 5366,2019-08-20,12:00:00,189,117,72,FMN GV 16 Berchem TOT
54,Posthofbrug 5366,2019-08-20,13:00:00,154,93,61,FMN GV 16 Berchem TOT
54,Posthofbrug 5366,2019-08-20,14:00:00,140,78,62,FMN GV 16 Berchem TOT
54,Posthofbrug 5366,2019-08-20,15:00:00,199,95,104,FMN GV 16 Berchem TOT
54,Posthofbrug 5366,2019-08-20,16:00:00,400,164,236,FMN GV 16 Berchem TOT
54,Posthofbrug 5366,2019-08-20,17:00:00,565,206,359,FMN GV 16 Berchem TOT
54,Posthofbrug 5366,2019-08-20,18:00:00,376,123,253,FMN GV 16 Berchem TOT
54,Posthofbrug 5366,2019-08-20,19:00:00,161,68,93,FMN GV 16 Berchem TOT
54,Posthofbrug 5366,2019-08-20,20:00:00,107,55,52,FMN GV 16 Berchem TOT
54,Posthofbrug 5366,2019-08-20,21:00:00,92,46,46,FMN GV 16 Berchem TOT
54,Posthofbrug 5366,2019-08-20,22:00:00,67,30,37,FMN GV 16 Berchem TOT
54,Posthofbrug 5366,2019-08-20,23:00:00,56,17,39,FMN GV 16 Berchem TOT
54,Posthofbrug 5366,2019-08-21,00:00:00,23,7,16,FMN GV 16 Berchem TOT
54,Posthofbrug 5366,2019-08-21,01:00:00,11,0,11,FMN GV 16 Berchem TOT
54,Posthofbrug 5366,2019-08-21,02:00:00,5,4,1,FMN GV 16 Berchem TOT
54,Posthofbrug 5366,2019-08-21,03:00:00,4,0,4,FMN GV 16 Berchem TOT
54,Posthofbrug 5366,2019-08-21,04:00:00,10,6,4,FMN GV 16 Berchem TOT
54,Posthofbrug 5366,2019-08-21,05:00:00,18,13,5,FMN GV 16 Berchem TOT
54,Posthofbrug 5366,2019-08-21,06:00:00,103,82,21,FMN GV 16 Berchem TOT
54,Posthofbrug 5366,2019-08-21,07:00:00,274,192,82,FMN GV 16 Berchem TOT
54,Posthofbrug 5366,2019-08-21,08:00:00,485,334,151,FMN GV 16 Berchem TOT
54,Posthofbrug 5366,2019-08-21,09:00:00,233,155,78,FMN GV 16 Berchem TOT
54,Posthofbrug 5366,2019-08-21,10:00:00,109,71,38,FMN GV 16 Berchem TOT
54,Posthofbrug 5366,2019-08-21,11:00:00,137,91,46,FMN GV 16 Berchem TOT
54,Posthofbrug 5366,2019-08-21,12:00:00,186,100,86,FMN GV 16 Berchem TOT
54,Posthofbrug 5366,2019-08-21,13:00:00,177,93,84,FMN GV 16 Berchem TOT
54,Posthofbrug 5366,2019-08-21,14:00:00,170,93,77,FMN GV 16 Berchem TOT
54,Posthofbrug 5366,2019-08-21,15:00:00,203,92,111,FMN GV 16 Berchem TOT
54,Posthofbrug 5366,2019-08-21,16:00:00,396,186,210,FMN GV 16 Berchem TOT
54,Posthofbrug 5366,2019-08-21,17:00:00,537,197,340,FMN GV 16 Berchem TOT
54,Posthofbrug 5366,2019-08-21,18:00:00,351,127,224,FMN GV 16 Berchem TOT
54,Posthofbrug 5366,2019-08-21,19:00:00,192,105,87,FMN GV 16 Berchem TOT
54,Posthofbrug 5366,2019-08-21,20:00:00,102,60,42,FMN GV 16 Berchem TOT
54,Posthofbrug 5366,2019-08-21,21:00:00,73,26,47,FMN GV 16 Berchem TOT
54,Posthofbrug 5366,2019-08-21,22:00:00,68,20,48,FMN GV 16 Berchem TOT
54,Posthofbrug 5366,2019-08-21,23:00:00,53,28,25,FMN GV 16 Berchem TOT
54,Posthofbrug 5366,2019-08-22,00:00:00,26,7,19,FMN GV 16 Berchem TOT
54,Posthofbrug 5366,2019-08-22,01:00:00,7,2,5,FMN GV 16 Berchem TOT
54,Posthofbrug 5366,2019-08-22,02:00:00,11,4,7,FMN GV 16 Berchem TOT
54,Posthofbrug 5366,2019-08-22,03:00:00,0,0,0,FMN GV 16 Berchem TOT
54,Posthofbrug 5366,2019-08-22,04:00:00,14,10,4,FMN GV 16 Berchem TOT
54,Posthofbrug 5366,2019-08-22,05:00:00,20,11,9,FMN GV 16 Berchem TOT
54,Posthofbrug 5366,2019-08-22,06:00:00,96,74,22,FMN GV 16 Berchem TOT
54,Posthofbrug 5366,2019-08-22,07:00:00,294,209,85,FMN GV 16 Berchem TOT
54,Posthofbrug 5366,2019-08-22,08:00:00,493,348,145,FMN GV 16 Berchem TOT
54,Posthofbrug 5366,2019-08-22,09:00:00,257,183,74,FMN GV 16 Berchem TOT
54,Posthofbrug 5366,2019-08-22,10:00:00,127,85,42,FMN GV 16 Berchem TOT
54,Posthofbrug 5366,2019-08-22,11:00:00,160,89,71,FMN GV 16 Berchem TOT
54,Posthofbrug 5366,2019-08-22,12:00:00,172,108,64,FMN GV 16 Berchem TOT
54,Posthofbrug 5366,2019-08-22,13:00:00,165,85,80,FMN GV 16 Berchem TOT
54,Posthofbrug 5366,2019-08-22,14:00:00,181,84,97,FMN GV 16 Berchem TOT
54,Posthofbrug 5366,2019-08-22,15:00:00,193,95,98,FMN GV 16 Berchem TOT
54,Posthofbrug 5366,2019-08-22,16:00:00,448,209,239,FMN GV 16 Berchem TOT
54,Posthofbrug 5366,2019-08-22,17:00:00,563,227,336,FMN GV 16 Berchem TOT
54,Posthofbrug 5366,2019-08-22,18:00:00,375,133,242,FMN GV 16 Berchem TOT
54,Posthofbrug 5366,2019-08-22,19:00:00,194,87,107,FMN GV 16 Berchem TOT
54,Posthofbrug 5366,2019-08-22,20:00:00,129,59,70,FMN GV 16 Berchem TOT
54,Posthofbrug 5366,2019-08-22,21:00:00,75,37,38,FMN GV 16 Berchem TOT
54,Posthofbrug 5366,2019-08-22,22:00:00,91,38,53,FMN GV 16 Berchem TOT
54,Posthofbrug 5366,2019-08-22,23:00:00,66,17,49,FMN GV 16 Berchem TOT
54,Posthofbrug 5366,2019-08-23,00:00:00,22,6,16,FMN GV 16 Berchem TOT
54,Posthofbrug 5366,2019-08-23,01:00:00,15,4,11,FMN GV 16 Berchem TOT
54,Posthofbrug 5366,2019-08-23,02:00:00,10,2,8,FMN GV 16 Berchem TOT
54,Posthofbrug 5366,2019-08-23,03:00:00,6,2,4,FMN GV 16 Berchem TOT
54,Posthofbrug 5366,2019-08-23,04:00:00,8,7,1,FMN GV 16 Berchem TOT
54,Posthofbrug 5366,2019-08-23,05:00:00,19,10,9,FMN GV 16 Berchem TOT
54,Posthofbrug 5366,2019-08-23,06:00:00,70,54,16,FMN GV 16 Berchem TOT
54,Posthofbrug 5366,2019-08-23,07:00:00,234,162,72,FMN GV 16 Berchem TOT
54,Posthofbrug 5366,2019-08-23,08:00:00,421,278,143,FMN GV 16 Berchem TOT
54,Posthofbrug 5366,2019-08-23,09:00:00,191,128,63,FMN GV 16 Berchem TOT
54,Posthofbrug 5366,2019-08-23,10:00:00,136,84,52,FMN GV 16 Berchem TOT
54,Posthofbrug 5366,2019-08-23,11:00:00,128,79,49,FMN GV 16 Berchem TOT
54,Posthofbrug 5366,2019-08-23,12:00:00,215,130,85,FMN GV 16 Berchem TOT
54,Posthofbrug 5366,2019-08-23,13:00:00,178,100,78,FMN GV 16 Berchem TOT
54,Posthofbrug 5366,2019-08-23,14:00:00,202,100,102,FMN GV 16 Berchem TOT
54,Posthofbrug 5366,2019-08-23,15:00:00,263,111,152,FMN GV 16 Berchem TOT
54,Posthofbrug 5366,2019-08-23,16:00:00,416,176,240,FMN GV 16 Berchem TOT
54,Posthofbrug 5366,2019-08-23,17:00:00,446,177,269,FMN GV 16 Berchem TOT
54,Posthofbrug 5366,2019-08-23,18:00:00,300,124,176,FMN GV 16 Berchem TOT
54,Posthofbrug 5366,2019-08-23,19:00:00,150,71,79,FMN GV 16 Berchem TOT
54,Posthofbrug 5366,2019-08-23,20:00:00,120,58,62,FMN GV 16 Berchem TOT
54,Posthofbrug 5366,2019-08-23,21:00:00,98,54,44,FMN GV 16 Berchem TOT
54,Posthofbrug 5366,2019-08-23,22:00:00,75,19,56,FMN GV 16 Berchem TOT
54,Posthofbrug 5366,2019-08-23,23:00:00,73,17,56,FMN GV 16 Berchem TOT
54,Posthofbrug 5366,2019-08-24,00:00:00,59,20,39,FMN GV 16 Berchem TOT
54,Posthofbrug 5366,2019-08-24,01:00:00,30,9,21,FMN GV 16 Berchem TOT
54,Posthofbrug 5366,2019-08-24,02:00:00,35,13,22,FMN GV 16 Berchem TOT
54,Posthofbrug 5366,2019-08-24,03:00:00,13,4,9,FMN GV 16 Berchem TOT
54,Posthofbrug 5366,2019-08-24,04:00:00,16,6,10,FMN GV 16 Berchem TOT
54,Posthofbrug 5366,2019-08-24,05:00:00,10,7,3,FMN GV 16 Berchem TOT
54,Posthofbrug 5366,2019-08-24,06:00:00,18,9,9,FMN GV 16 Berchem TOT
54,Posthofbrug 5366,2019-08-24,07:00:00,22,19,3,FMN GV 16 Berchem TOT
54,Posthofbrug 5366,2019-08-24,08:00:00,61,44,17,FMN GV 16 Berchem TOT
54,Posthofbrug 5366,2019-08-24,09:00:00,95,64,31,FMN GV 16 Berchem TOT
54,Posthofbrug 5366,2019-08-24,10:00:00,138,89,49,FMN GV 16 Berchem TOT
54,Posthofbrug 5366,2019-08-24,11:00:00,173,102,71,FMN GV 16 Berchem TOT
54,Posthofbrug 5366,2019-08-24,12:00:00,186,106,80,FMN GV 16 Berchem TOT
54,Posthofbrug 5366,2019-08-24,13:00:00,152,80,72,FMN GV 16 Berchem TOT
54,Posthofbrug 5366,2019-08-24,14:00:00,193,102,91,FMN GV 16 Berchem TOT
54,Posthofbrug 5366,2019-08-24,15:00:00,183,91,92,FMN GV 16 Berchem TOT
54,Posthofbrug 5366,2019-08-24,16:00:00,185,86,99,FMN GV 16 Berchem TOT
54,Posthofbrug 5366,2019-08-24,17:00:00,133,72,61,FMN GV 16 Berchem TOT
54,Posthofbrug 5366,2019-08-24,18:00:00,160,85,75,FMN GV 16 Berchem TOT
54,Posthofbrug 5366,2019-08-24,19:00:00,112,61,51,FMN GV 16 Berchem TOT
54,Posthofbrug 5366,2019-08-24,20:00:00,93,48,45,FMN GV 16 Berchem TOT
54,Posthofbrug 5366,2019-08-24,21:00:00,83,48,35,FMN GV 16 Berchem TOT
54,Posthofbrug 5366,2019-08-24,22:00:00,60,23,37,FMN GV 16 Berchem TOT
54,Posthofbrug 5366,2019-08-24,23:00:00,53,17,36,FMN GV 16 Berchem TOT
54,Posthofbrug 5366,2019-08-25,00:00:00,50,12,38,FMN GV 16 Berchem TOT
54,Posthofbrug 5366,2019-08-25,01:00:00,29,11,18,FMN GV 16 Berchem TOT
54,Posthofbrug 5366,2019-08-25,02:00:00,21,2,19,FMN GV 16 Berchem TOT
54,Posthofbrug 5366,2019-08-25,03:00:00,25,11,14,FMN GV 16 Berchem TOT
54,Posthofbrug 5366,2019-08-25,04:00:00,8,4,4,FMN GV 16 Berchem TOT
54,Posthofbrug 5366,2019-08-25,05:00:00,10,4,6,FMN GV 16 Berchem TOT
54,Posthofbrug 5366,2019-08-25,06:00:00,16,10,6,FMN GV 16 Berchem TOT
54,Posthofbrug 5366,2019-08-25,07:00:00,15,10,5,FMN GV 16 Berchem TOT
54,Posthofbrug 5366,2019-08-25,08:00:00,32,19,13,FMN GV 16 Berchem TOT
54,Posthofbrug 5366,2019-08-25,09:00:00,68,42,26,FMN GV 16 Berchem TOT
54,Posthofbrug 5366,2019-08-25,10:00:00,117,76,41,FMN GV 16 Berchem TOT
54,Posthofbrug 5366,2019-08-25,11:00:00,202,144,58,FMN GV 16 Berchem TOT
54,Posthofbrug 5366,2019-08-25,12:00:00,201,124,77,FMN GV 16 Berchem TOT
54,Posthofbrug 5366,2019-08-25,13:00:00,191,103,88,FMN GV 16 Berchem TOT
54,Posthofbrug 5366,2019-08-25,14:00:00,230,130,100,FMN GV 16 Berchem TOT
54,Posthofbrug 5366,2019-08-25,15:00:00,188,92,96,FMN GV 16 Berchem TOT
54,Posthofbrug 5366,2019-08-25,16:00:00,166,88,78,FMN GV 16 Berchem TOT
54,Posthofbrug 5366,2019-08-25,17:00:00,172,70,102,FMN GV 16 Berchem TOT
54,Posthofbrug 5366,2019-08-25,18:00:00,157,71,86,FMN GV 16 Berchem TOT
54,Posthofbrug 5366,2019-08-25,19:00:00,110,55,55,FMN GV 16 Berchem TOT
54,Posthofbrug 5366,2019-08-25,20:00:00,104,55,49,FMN GV 16 Berchem TOT
54,Posthofbrug 5366,2019-08-25,21:00:00,104,50,54,FMN GV 16 Berchem TOT
54,Posthofbrug 5366,2019-08-25,22:00:00,71,26,45,FMN GV 16 Berchem TOT
54,Posthofbrug 5366,2019-08-25,23:00:00,38,16,22,FMN GV 16 Berchem TOT
54,Posthofbrug 5366,2019-08-26,00:00:00,13,4,9,FMN GV 16 Berchem TOT
54,Posthofbrug 5366,2019-08-26,01:00:00,10,3,7,FMN GV 16 Berchem TOT
54,Posthofbrug 5366,2019-08-26,02:00:00,3,0,3,FMN GV 16 Berchem TOT
54,Posthofbrug 5366,2019-08-26,03:00:00,4,2,2,FMN GV 16 Berchem TOT
54,Posthofbrug 5366,2019-08-26,04:00:00,3,2,1,FMN GV 16 Berchem TOT
54,Posthofbrug 5366,2019-08-26,05:00:00,16,11,5,FMN GV 16 Berchem TOT
54,Posthofbrug 5366,2019-08-26,06:00:00,119,92,27,FMN GV 16 Berchem TOT
54,Posthofbrug 5366,2019-08-26,07:00:00,320,237,83,FMN GV 16 Berchem TOT
54,Posthofbrug 5366,2019-08-26,08:00:00,534,376,158,FMN GV 16 Berchem TOT
54,Posthofbrug 5366,2019-08-26,09:00:00,256,190,66,FMN GV 16 Berchem TOT
54,Posthofbrug 5366,2019-08-26,10:00:00,110,75,35,FMN GV 16 Berchem TOT
54,Posthofbrug 5366,2019-08-26,11:00:00,150,102,48,FMN GV 16 Berchem TOT
54,Posthofbrug 5366,2019-08-26,12:00:00,146,89,57,FMN GV 16 Berchem TOT
54,Posthofbrug 5366,2019-08-26,13:00:00,145,75,70,FMN GV 16 Berchem TOT
54,Posthofbrug 5366,2019-08-26,14:00:00,168,97,71,FMN GV 16 Berchem TOT
54,Posthofbrug 5366,2019-08-26,15:00:00,201,77,124,FMN GV 16 Berchem TOT
54,Posthofbrug 5366,2019-08-26,16:00:00,430,173,257,FMN GV 16 Berchem TOT
54,Posthofbrug 5366,2019-08-26,17:00:00,568,200,368,FMN GV 16 Berchem TOT
54,Posthofbrug 5366,2019-08-26,18:00:00,345,116,229,FMN GV 16 Berchem TOT
54,Posthofbrug 5366,2019-08-26,19:00:00,175,68,107,FMN GV 16 Berchem TOT
54,Posthofbrug 5366,2019-08-26,20:00:00,136,61,75,FMN GV 16 Berchem TOT
54,Posthofbrug 5366,2019-08-26,21:00:00,80,46,34,FMN GV 16 Berchem TOT
54,Posthofbrug 5366,2019-08-26,22:00:00,94,37,57,FMN GV 16 Berchem TOT
54,Posthofbrug 5366,2019-08-26,23:00:00,52,16,36,FMN GV 16 Berchem TOT
54,Posthofbrug 5366,2019-08-27,00:00:00,21,2,19,FMN GV 16 Berchem TOT
54,Posthofbrug 5366,2019-08-27,01:00:00,11,0,11,FMN GV 16 Berchem TOT
54,Posthofbrug 5366,2019-08-27,02:00:00,8,4,4,FMN GV 16 Berchem TOT
54,Posthofbrug 5366,2019-08-27,03:00:00,2,1,1,FMN GV 16 Berchem TOT
54,Posthofbrug 5366,2019-08-27,04:00:00,5,4,1,FMN GV 16 Berchem TOT
54,Posthofbrug 5366,2019-08-27,05:00:00,22,14,8,FMN GV 16 Berchem TOT
54,Posthofbrug 5366,2019-08-27,06:00:00,124,94,30,FMN GV 16 Berchem TOT
54,Posthofbrug 5366,2019-08-27,07:00:00,352,257,95,FMN GV 16 Berchem TOT
54,Posthofbrug 5366,2019-08-27,08:00:00,568,372,196,FMN GV 16 Berchem TOT
54,Posthofbrug 5366,2019-08-27,09:00:00,279,204,75,FMN GV 16 Berchem TOT
54,Posthofbrug 5366,2019-08-27,10:00:00,141,95,46,FMN GV 16 Berchem TOT
54,Posthofbrug 5366,2019-08-27,11:00:00,121,88,33,FMN GV 16 Berchem TOT
54,Posthofbrug 5366,2019-08-27,12:00:00,146,85,61,FMN GV 16 Berchem TOT
54,Posthofbrug 5366,2019-08-27,13:00:00,153,71,82,FMN GV 16 Berchem TOT
54,Posthofbrug 5366,2019-08-27,14:00:00,150,73,77,FMN GV 16 Berchem TOT
54,Posthofbrug 5366,2019-08-27,15:00:00,225,92,133,FMN GV 16 Berchem TOT
54,Posthofbrug 5366,2019-08-27,16:00:00,440,178,262,FMN GV 16 Berchem TOT
54,Posthofbrug 5366,2019-08-27,17:00:00,584,224,360,FMN GV 16 Berchem TOT
54,Posthofbrug 5366,2019-08-27,18:00:00,391,146,245,FMN GV 16 Berchem TOT
54,Posthofbrug 5366,2019-08-27,19:00:00,201,85,116,FMN GV 16 Berchem TOT
54,Posthofbrug 5366,2019-08-27,20:00:00,159,78,81,FMN GV 16 Berchem TOT
54,Posthofbrug 5366,2019-08-27,21:00:00,125,71,54,FMN GV 16 Berchem TOT
54,Posthofbrug 5366,2019-08-27,22:00:00,103,40,63,FMN GV 16 Berchem TOT
54,Posthofbrug 5366,2019-08-27,23:00:00,64,27,37,FMN GV 16 Berchem TOT
54,Posthofbrug 5366,2019-08-28,00:00:00,37,14,23,FMN GV 16 Berchem TOT
54,Posthofbrug 5366,2019-08-28,01:00:00,12,2,10,FMN GV 16 Berchem TOT
54,Posthofbrug 5366,2019-08-28,02:00:00,6,1,5,FMN GV 16 Berchem TOT
54,Posthofbrug 5366,2019-08-28,03:00:00,6,4,2,FMN GV 16 Berchem TOT
54,Posthofbrug 5366,2019-08-28,04:00:00,15,11,4,FMN GV 16 Berchem TOT
54,Posthofbrug 5366,2019-08-28,05:00:00,25,15,10,FMN GV 16 Berchem TOT
54,Posthofbrug 5366,2019-08-28,06:00:00,100,78,22,FMN GV 16 Berchem TOT
54,Posthofbrug 5366,2019-08-28,07:00:00,351,258,93,FMN GV 16 Berchem TOT
54,Posthofbrug 5366,2019-08-28,08:00:00,428,294,134,FMN GV 16 Berchem TOT
54,Posthofbrug 5366,2019-08-28,09:00:00,228,140,88,FMN GV 16 Berchem TOT
54,Posthofbrug 5366,2019-08-28,10:00:00,106,67,39,FMN GV 16 Berchem TOT
54,Posthofbrug 5366,2019-08-28,11:00:00,110,69,41,FMN GV 16 Berchem TOT
54,Posthofbrug 5366,2019-08-28,12:00:00,168,98,70,FMN GV 16 Berchem TOT
54,Posthofbrug 5366,2019-08-28,13:00:00,167,94,73,FMN GV 16 Berchem TOT
54,Posthofbrug 5366,2019-08-28,14:00:00,159,89,70,FMN GV 16 Berchem TOT
54,Posthofbrug 5366,2019-08-28,15:00:00,214,103,111,FMN GV 16 Berchem TOT
54,Posthofbrug 5366,2019-08-28,16:00:00,411,206,205,FMN GV 16 Berchem TOT
54,Posthofbrug 5366,2019-08-28,17:00:00,515,196,319,FMN GV 16 Berchem TOT
54,Posthofbrug 5366,2019-08-28,18:00:00,367,130,237,FMN GV 16 Berchem TOT
54,Posthofbrug 5366,2019-08-28,19:00:00,171,73,98,FMN GV 16 Berchem TOT
54,Posthofbrug 5366,2019-08-28,20:00:00,102,54,48,FMN GV 16 Berchem TOT
54,Posthofbrug 5366,2019-08-28,21:00:00,90,42,48,FMN GV 16 Berchem TOT
54,Posthofbrug 5366,2019-08-28,22:00:00,84,32,52,FMN GV 16 Berchem TOT
54,Posthofbrug 5366,2019-08-28,23:00:00,51,15,36,FMN GV 16 Berchem TOT
54,Posthofbrug 5366,2019-08-29,00:00:00,32,15,17,FMN GV 16 Berchem TOT
54,Posthofbrug 5366,2019-08-29,01:00:00,14,4,10,FMN GV 16 Berchem TOT
54,Posthofbrug 5366,2019-08-29,02:00:00,4,0,4,FMN GV 16 Berchem TOT
54,Posthofbrug 5366,2019-08-29,03:00:00,1,1,0,FMN GV 16 Berchem TOT
54,Posthofbrug 5366,2019-08-29,04:00:00,5,4,1,FMN GV 16 Berchem TOT
54,Posthofbrug 5366,2019-08-29,05:00:00,26,17,9,FMN GV 16 Berchem TOT
54,Posthofbrug 5366,2019-08-29,06:00:00,89,70,19,FMN GV 16 Berchem TOT
54,Posthofbrug 5366,2019-08-29,07:00:00,324,237,87,FMN GV 16 Berchem TOT
54,Posthofbrug 5366,2019-08-29,08:00:00,607,430,177,FMN GV 16 Berchem TOT
54,Posthofbrug 5366,2019-08-29,09:00:00,305,203,102,FMN GV 16 Berchem TOT
54,Posthofbrug 5366,2019-08-29,10:00:00,91,67,24,FMN GV 16 Berchem TOT
54,Posthofbrug 5366,2019-08-29,11:00:00,118,73,45,FMN GV 16 Berchem TOT
54,Posthofbrug 5366,2019-08-29,12:00:00,163,97,66,FMN GV 16 Berchem TOT
54,Posthofbrug 5366,2019-08-29,13:00:00,159,93,66,FMN GV 16 Berchem TOT
54,Posthofbrug 5366,2019-08-29,14:00:00,162,88,74,FMN GV 16 Berchem TOT
54,Posthofbrug 5366,2019-08-29,15:00:00,209,89,120,FMN GV 16 Berchem TOT
54,Posthofbrug 5366,2019-08-29,16:00:00,400,173,227,FMN GV 16 Berchem TOT
54,Posthofbrug 5366,2019-08-29,17:00:00,582,215,367,FMN GV 16 Berchem TOT
54,Posthofbrug 5366,2019-08-29,18:00:00,394,146,248,FMN GV 16 Berchem TOT
54,Posthofbrug 5366,2019-08-29,19:00:00,201,94,107,FMN GV 16 Berchem TOT
54,Posthofbrug 5366,2019-08-29,20:00:00,112,64,48,FMN GV 16 Berchem TOT
54,Posthofbrug 5366,2019-08-29,21:00:00,97,40,57,FMN GV 16 Berchem TOT
54,Posthofbrug 5366,2019-08-29,22:00:00,101,39,62,FMN GV 16 Berchem TOT
54,Posthofbrug 5366,2019-08-29,23:00:00,62,28,34,FMN GV 16 Berchem TOT
54,Posthofbrug 5366,2019-08-30,00:00:00,41,6,35,FMN GV 16 Berchem TOT
54,Posthofbrug 5366,2019-08-30,01:00:00,13,6,7,FMN GV 16 Berchem TOT
54,Posthofbrug 5366,2019-08-30,02:00:00,12,7,5,FMN GV 16 Berchem TOT
54,Posthofbrug 5366,2019-08-30,03:00:00,11,1,10,FMN GV 16 Berchem TOT
54,Posthofbrug 5366,2019-08-30,04:00:00,11,8,3,FMN GV 16 Berchem TOT
54,Posthofbrug 5366,2019-08-30,05:00:00,24,16,8,FMN GV 16 Berchem TOT
54,Posthofbrug 5366,2019-08-30,06:00:00,76,61,15,FMN GV 16 Berchem TOT
54,Posthofbrug 5366,2019-08-30,07:00:00,275,201,74,FMN GV 16 Berchem TOT
54,Posthofbrug 5366,2019-08-30,08:00:00,485,317,168,FMN GV 16 Berchem TOT
54,Posthofbrug 5366,2019-08-30,09:00:00,242,191,51,FMN GV 16 Berchem TOT
54,Posthofbrug 5366,2019-08-30,10:00:00,119,71,48,FMN GV 16 Berchem TOT
54,Posthofbrug 5366,2019-08-30,11:00:00,125,81,44,FMN GV 16 Berchem TOT
54,Posthofbrug 5366,2019-08-30,12:00:00,220,139,81,FMN GV 16 Berchem TOT
54,Posthofbrug 5366,2019-08-30,13:00:00,167,88,79,FMN GV 16 Berchem TOT
54,Posthofbrug 5366,2019-08-30,14:00:00,183,90,93,FMN GV 16 Berchem TOT
54,Posthofbrug 5366,2019-08-30,15:00:00,270,117,153,FMN GV 16 Berchem TOT
54,Posthofbrug 5366,2019-08-30,16:00:00,423,189,234,FMN GV 16 Berchem TOT
54,Posthofbrug 5366,2019-08-30,17:00:00,461,193,268,FMN GV 16 Berchem TOT
54,Posthofbrug 5366,2019-08-30,18:00:00,294,122,172,FMN GV 16 Berchem TOT
54,Posthofbrug 5366,2019-08-30,19:00:00,227,130,97,FMN GV 16 Berchem TOT
54,Posthofbrug 5366,2019-08-30,20:00:00,134,75,59,FMN GV 16 Berchem TOT
54,Posthofbrug 5366,2019-08-30,21:00:00,107,55,52,FMN GV 16 Berchem TOT
54,Posthofbrug 5366,2019-08-30,22:00:00,85,42,43,FMN GV 16 Berchem TOT
54,Posthofbrug 5366,2019-08-30,23:00:00,92,24,68,FMN GV 16 Berchem TOT
54,Posthofbrug 5366,2019-08-31,00:00:00,62,19,43,FMN GV 16 Berchem TOT
54,Posthofbrug 5366,2019-08-31,01:00:00,41,14,27,FMN GV 16 Berchem TOT
54,Posthofbrug 5366,2019-08-31,02:00:00,31,9,22,FMN GV 16 Berchem TOT
54,Posthofbrug 5366,2019-08-31,03:00:00,40,3,37,FMN GV 16 Berchem TOT
54,Posthofbrug 5366,2019-08-31,04:00:00,22,6,16,FMN GV 16 Berchem TOT
54,Posthofbrug 5366,2019-08-31,05:00:00,10,4,6,FMN GV 16 Berchem TOT
54,Posthofbrug 5366,2019-08-31,06:00:00,26,14,12,FMN GV 16 Berchem TOT
54,Posthofbrug 5366,2019-08-31,07:00:00,26,14,12,FMN GV 16 Berchem TOT
54,Posthofbrug 5366,2019-08-31,08:00:00,53,35,18,FMN GV 16 Berchem TOT
54,Posthofbrug 5366,2019-08-31,09:00:00,94,67,27,FMN GV 16 Berchem TOT
54,Posthofbrug 5366,2019-08-31,10:00:00,115,72,43,FMN GV 16 Berchem TOT
54,Posthofbrug 5366,2019-08-31,11:00:00,150,104,46,FMN GV 16 Berchem TOT
54,Posthofbrug 5366,2019-08-31,12:00:00,162,92,70,FMN GV 16 Berchem TOT
54,Posthofbrug 5366,2019-08-31,13:00:00,201,110,91,FMN GV 16 Berchem TOT
54,Posthofbrug 5366,2019-08-31,14:00:00,187,105,82,FMN GV 16 Berchem TOT
54,Posthofbrug 5366,2019-08-31,15:00:00,201,100,101,FMN GV 16 Berchem TOT
54,Posthofbrug 5366,2019-08-31,16:00:00,182,92,90,FMN GV 16 Berchem TOT
54,Posthofbrug 5366,2019-08-31,17:00:00,169,85,84,FMN GV 16 Berchem TOT
54,Posthofbrug 5366,2019-08-31,18:00:00,186,79,107,FMN GV 16 Berchem TOT
54,Posthofbrug 5366,2019-08-31,19:00:00,111,57,54,FMN GV 16 Berchem TOT
54,Posthofbrug 5366,2019-08-31,20:00:00,105,63,42,FMN GV 16 Berchem TOT
54,Posthofbrug 5366,2019-08-31,21:00:00,76,29,47,FMN GV 16 Berchem TOT
54,Posthofbrug 5366,2019-08-31,22:00:00,83,51,32,FMN GV 16 Berchem TOT
54,Posthofbrug 5366,2019-08-31,23:00:00,63,27,36,FMN GV 16 Berchem TOT
54,Posthofbrug 5366,2019-09-01,00:00:00,67,21,46,FMN GV 16 Berchem TOT
54,Posthofbrug 5366,2019-09-01,01:00:00,34,11,23,FMN GV 16 Berchem TOT
54,Posthofbrug 5366,2019-09-01,02:00:00,27,4,23,FMN GV 16 Berchem TOT
54,Posthofbrug 5366,2019-09-01,03:00:00,21,4,17,FMN GV 16 Berchem TOT
54,Posthofbrug 5366,2019-09-01,04:00:00,13,5,8,FMN GV 16 Berchem TOT
54,Posthofbrug 5366,2019-09-01,05:00:00,14,9,5,FMN GV 16 Berchem TOT
54,Posthofbrug 5366,2019-09-01,06:00:00,7,5,2,FMN GV 16 Berchem TOT
54,Posthofbrug 5366,2019-09-01,07:00:00,12,5,7,FMN GV 16 Berchem TOT
54,Posthofbrug 5366,2019-09-01,08:00:00,29,22,7,FMN GV 16 Berchem TOT
54,Posthofbrug 5366,2019-09-01,09:00:00,50,24,26,FMN GV 16 Berchem TOT
54,Posthofbrug 5366,2019-09-01,10:00:00,95,55,40,FMN GV 16 Berchem TOT
54,Posthofbrug 5366,2019-09-01,11:00:00,96,57,39,FMN GV 16 Berchem TOT
54,Posthofbrug 5366,2019-09-01,12:00:00,118,66,52,FMN GV 16 Berchem TOT
54,Posthofbrug 5366,2019-09-01,13:00:00,156,99,57,FMN GV 16 Berchem TOT
54,Posthofbrug 5366,2019-09-01,14:00:00,207,131,76,FMN GV 16 Berchem TOT
54,Posthofbrug 5366,2019-09-01,15:00:00,184,86,98,FMN GV 16 Berchem TOT
54,Posthofbrug 5366,2019-09-01,16:00:00,181,93,88,FMN GV 16 Berchem TOT
54,Posthofbrug 5366,2019-09-01,17:00:00,173,92,81,FMN GV 16 Berchem TOT
54,Posthofbrug 5366,2019-09-01,18:00:00,130,62,68,FMN GV 16 Berchem TOT
54,Posthofbrug 5366,2019-09-01,19:00:00,114,48,66,FMN GV 16 Berchem TOT
54,Posthofbrug 5366,2019-09-01,20:00:00,60,23,37,FMN GV 16 Berchem TOT
54,Posthofbrug 5366,2019-09-01,21:00:00,68,20,48,FMN GV 16 Berchem TOT
54,Posthofbrug 5366,2019-09-01,22:00:00,31,17,14,FMN GV 16 Berchem TOT
54,Posthofbrug 5366,2019-09-01,23:00:00,19,11,8,FMN GV 16 Berchem TOT
54,Posthofbrug 5366,2019-09-02,00:00:00,11,3,8,FMN GV 16 Berchem TOT
54,Posthofbrug 5366,2019-09-02,01:00:00,3,1,2,FMN GV 16 Berchem TOT
54,Posthofbrug 5366,2019-09-02,02:00:00,5,1,4,FMN GV 16 Berchem TOT
54,Posthofbrug 5366,2019-09-02,03:00:00,2,2,0,FMN GV 16 Berchem TOT
54,Posthofbrug 5366,2019-09-02,04:00:00,5,4,1,FMN GV 16 Berchem TOT
54,Posthofbrug 5366,2019-09-02,05:00:00,19,11,8,FMN GV 16 Berchem TOT
54,Posthofbrug 5366,2019-09-02,06:00:00,108,86,22,FMN GV 16 Berchem TOT
54,Posthofbrug 5366,2019-09-02,07:00:00,421,330,91,FMN GV 16 Berchem TOT
54,Posthofbrug 5366,2019-09-02,08:00:00,663,464,199,FMN GV 16 Berchem TOT
54,Posthofbrug 5366,2019-09-02,09:00:00,301,215,86,FMN GV 16 Berchem TOT
54,Posthofbrug 5366,2019-09-02,10:00:00,117,87,30,FMN GV 16 Berchem TOT
54,Posthofbrug 5366,2019-09-02,11:00:00,115,74,41,FMN GV 16 Berchem TOT
54,Posthofbrug 5366,2019-09-02,12:00:00,174,98,76,FMN GV 16 Berchem TOT
54,Posthofbrug 5366,2019-09-02,13:00:00,164,83,81,FMN GV 16 Berchem TOT
54,Posthofbrug 5366,2019-09-02,14:00:00,201,93,108,FMN GV 16 Berchem TOT
54,Posthofbrug 5366,2019-09-02,15:00:00,289,120,169,FMN GV 16 Berchem TOT
54,Posthofbrug 5366,2019-09-02,16:00:00,512,189,323,FMN GV 16 Berchem TOT
54,Posthofbrug 5366,2019-09-02,17:00:00,617,233,384,FMN GV 16 Berchem TOT
54,Posthofbrug 5366,2019-09-02,18:00:00,390,130,260,FMN GV 16 Berchem TOT
54,Posthofbrug 5366,2019-09-02,19:00:00,189,93,96,FMN GV 16 Berchem TOT
54,Posthofbrug 5366,2019-09-02,20:00:00,96,54,42,FMN GV 16 Berchem TOT
54,Posthofbrug 5366,2019-09-02,21:00:00,81,41,40,FMN GV 16 Berchem TOT
54,Posthofbrug 5366,2019-09-02,22:00:00,50,27,23,FMN GV 16 Berchem TOT
54,Posthofbrug 5366,2019-09-02,23:00:00,31,9,22,FMN GV 16 Berchem TOT
54,Posthofbrug 5366,2019-09-03,00:00:00,16,2,14,FMN GV 16 Berchem TOT
54,Posthofbrug 5366,2019-09-03,01:00:00,9,2,7,FMN GV 16 Berchem TOT
54,Posthofbrug 5366,2019-09-03,02:00:00,7,2,5,FMN GV 16 Berchem TOT
54,Posthofbrug 5366,2019-09-03,03:00:00,3,1,2,FMN GV 16 Berchem TOT
54,Posthofbrug 5366,2019-09-03,04:00:00,4,3,1,FMN GV 16 Berchem TOT
54,Posthofbrug 5366,2019-09-03,05:00:00,27,15,12,FMN GV 16 Berchem TOT
54,Posthofbrug 5366,2019-09-03,06:00:00,134,106,28,FMN GV 16 Berchem TOT
54,Posthofbrug 5366,2019-09-03,07:00:00,486,366,120,FMN GV 16 Berchem TOT
54,Posthofbrug 5366,2019-09-03,08:00:00,753,528,225,FMN GV 16 Berchem TOT
54,Posthofbrug 5366,2019-09-03,09:00:00,293,218,75,FMN GV 16 Berchem TOT
54,Posthofbrug 5366,2019-09-03,10:00:00,124,90,34,FMN GV 16 Berchem TOT
54,Posthofbrug 5366,2019-09-03,11:00:00,131,81,50,FMN GV 16 Berchem TOT
54,Posthofbrug 5366,2019-09-03,12:00:00,194,109,85,FMN GV 16 Berchem TOT
54,Posthofbrug 5366,2019-09-03,13:00:00,166,94,72,FMN GV 16 Berchem TOT
54,Posthofbrug 5366,2019-09-03,14:00:00,122,59,63,FMN GV 16 Berchem TOT
54,Posthofbrug 5366,2019-09-03,15:00:00,251,104,147,FMN GV 16 Berchem TOT
54,Posthofbrug 5366,2019-09-03,16:00:00,515,201,314,FMN GV 16 Berchem TOT
54,Posthofbrug 5366,2019-09-03,17:00:00,662,205,457,FMN GV 16 Berchem TOT
54,Posthofbrug 5366,2019-09-03,18:00:00,409,130,279,FMN GV 16 Berchem TOT
54,Posthofbrug 5366,2019-09-03,19:00:00,197,72,125,FMN GV 16 Berchem TOT
54,Posthofbrug 5366,2019-09-03,20:00:00,116,58,58,FMN GV 16 Berchem TOT
54,Posthofbrug 5366,2019-09-03,21:00:00,104,58,46,FMN GV 16 Berchem TOT
54,Posthofbrug 5366,2019-09-03,22:00:00,89,35,54,FMN GV 16 Berchem TOT
54,Posthofbrug 5366,2019-09-03,23:00:00,44,21,23,FMN GV 16 Berchem TOT
54,Posthofbrug 5366,2019-09-04,00:00:00,23,9,14,FMN GV 16 Berchem TOT
54,Posthofbrug 5366,2019-09-04,01:00:00,9,0,9,FMN GV 16 Berchem TOT
54,Posthofbrug 5366,2019-09-04,02:00:00,8,5,3,FMN GV 16 Berchem TOT
54,Posthofbrug 5366,2019-09-04,03:00:00,5,3,2,FMN GV 16 Berchem TOT
54,Posthofbrug 5366,2019-09-04,04:00:00,9,7,2,FMN GV 16 Berchem TOT
54,Posthofbrug 5366,2019-09-04,05:00:00,26,17,9,FMN GV 16 Berchem TOT
54,Posthofbrug 5366,2019-09-04,06:00:00,112,89,23,FMN GV 16 Berchem TOT
54,Posthofbrug 5366,2019-09-04,07:00:00,403,294,109,FMN GV 16 Berchem TOT
54,Posthofbrug 5366,2019-09-04,08:00:00,583,401,182,FMN GV 16 Berchem TOT
54,Posthofbrug 5366,2019-09-04,09:00:00,258,179,79,FMN GV 16 Berchem TOT
54,Posthofbrug 5366,2019-09-04,10:00:00,99,66,33,FMN GV 16 Berchem TOT
54,Posthofbrug 5366,2019-09-04,11:00:00,127,58,69,FMN GV 16 Berchem TOT
54,Posthofbrug 5366,2019-09-04,12:00:00,258,125,133,FMN GV 16 Berchem TOT
54,Posthofbrug 5366,2019-09-04,13:00:00,185,90,95,FMN GV 16 Berchem TOT
54,Posthofbrug 5366,2019-09-04,14:00:00,121,58,63,FMN GV 16 Berchem TOT
54,Posthofbrug 5366,2019-09-04,15:00:00,116,46,70,FMN GV 16 Berchem TOT
54,Posthofbrug 5366,2019-09-04,16:00:00,235,99,136,FMN GV 16 Berchem TOT
54,Posthofbrug 5366,2019-09-04,17:00:00,455,163,292,FMN GV 16 Berchem TOT
54,Posthofbrug 5366,2019-09-04,18:00:00,310,103,207,FMN GV 16 Berchem TOT
54,Posthofbrug 5366,2019-09-04,19:00:00,145,64,81,FMN GV 16 Berchem TOT
54,Posthofbrug 5366,2019-09-04,20:00:00,92,46,46,FMN GV 16 Berchem TOT
54,Posthofbrug 5366,2019-09-04,21:00:00,61,31,30,FMN GV 16 Berchem TOT
54,Posthofbrug 5366,2019-09-04,22:00:00,67,27,40,FMN GV 16 Berchem TOT
54,Posthofbrug 5366,2019-09-04,23:00:00,37,18,19,FMN GV 16 Berchem TOT
54,Posthofbrug 5366,2019-09-05,00:00:00,23,12,11,FMN GV 16 Berchem TOT
54,Posthofbrug 5366,2019-09-05,01:00:00,19,3,16,FMN GV 16 Berchem TOT
54,Posthofbrug 5366,2019-09-05,02:00:00,5,0,5,FMN GV 16 Berchem TOT
54,Posthofbrug 5366,2019-09-05,03:00:00,5,1,4,FMN GV 16 Berchem TOT
54,Posthofbrug 5366,2019-09-05,04:00:00,18,7,11,FMN GV 16 Berchem TOT
54,Posthofbrug 5366,2019-09-05,05:00:00,24,16,8,FMN GV 16 Berchem TOT
54,Posthofbrug 5366,2019-09-05,06:00:00,105,87,18,FMN GV 16 Berchem TOT
54,Posthofbrug 5366,2019-09-05,07:00:00,416,324,92,FMN GV 16 Berchem TOT
54,Posthofbrug 5366,2019-09-05,08:00:00,606,427,179,FMN GV 16 Berchem TOT
54,Posthofbrug 5366,2019-09-05,09:00:00,196,136,60,FMN GV 16 Berchem TOT
54,Posthofbrug 5366,2019-09-05,10:00:00,66,47,19,FMN GV 16 Berchem TOT
54,Posthofbrug 5366,2019-09-05,11:00:00,74,52,22,FMN GV 16 Berchem TOT
54,Posthofbrug 5366,2019-09-05,12:00:00,104,63,41,FMN GV 16 Berchem TOT
54,Posthofbrug 5366,2019-09-05,13:00:00,104,57,47,FMN GV 16 Berchem TOT
54,Posthofbrug 5366,2019-09-05,14:00:00,91,32,59,FMN GV 16 Berchem TOT
54,Posthofbrug 5366,2019-09-05,15:00:00,188,70,118,FMN GV 16 Berchem TOT
54,Posthofbrug 5366,2019-09-05,16:00:00,372,155,217,FMN GV 16 Berchem TOT
54,Posthofbrug 5366,2019-09-05,17:00:00,556,195,361,FMN GV 16 Berchem TOT
54,Posthofbrug 5366,2019-09-05,18:00:00,291,100,191,FMN GV 16 Berchem TOT
54,Posthofbrug 5366,2019-09-05,19:00:00,145,64,81,FMN GV 16 Berchem TOT
54,Posthofbrug 5366,2019-09-05,20:00:00,94,32,62,FMN GV 16 Berchem TOT
54,Posthofbrug 5366,2019-09-05,21:00:00,80,26,54,FMN GV 16 Berchem TOT
54,Posthofbrug 5366,2019-09-05,22:00:00,63,19,44,FMN GV 16 Berchem TOT
54,Posthofbrug 5366,2019-09-05,23:00:00,25,10,15,FMN GV 16 Berchem TOT
54,Posthofbrug 5366,2019-09-06,00:00:00,26,10,16,FMN GV 16 Berchem TOT
54,Posthofbrug 5366,2019-09-06,01:00:00,13,2,11,FMN GV 16 Berchem TOT
54,Posthofbrug 5366,2019-09-06,02:00:00,9,1,8,FMN GV 16 Berchem TOT
54,Posthofbrug 5366,2019-09-06,03:00:00,1,0,1,FMN GV 16 Berchem TOT
54,Posthofbrug 5366,2019-09-06,04:00:00,8,5,3,FMN GV 16 Berchem TOT
54,Posthofbrug 5366,2019-09-06,05:00:00,23,16,7,FMN GV 16 Berchem TOT
54,Posthofbrug 5366,2019-09-06,06:00:00,92,73,19,FMN GV 16 Berchem TOT
54,Posthofbrug 5366,2019-09-06,07:00:00,345,253,92,FMN GV 16 Berchem TOT
54,Posthofbrug 5366,2019-09-06,08:00:00,592,419,173,FMN GV 16 Berchem TOT
54,Posthofbrug 5366,2019-09-06,09:00:00,221,155,66,FMN GV 16 Berchem TOT
54,Posthofbrug 5366,2019-09-06,10:00:00,92,61,31,FMN GV 16 Berchem TOT
54,Posthofbrug 5366,2019-09-06,11:00:00,127,79,48,FMN GV 16 Berchem TOT
54,Posthofbrug 5366,2019-09-06,12:00:00,172,96,76,FMN GV 16 Berchem TOT
54,Posthofbrug 5366,2019-09-06,13:00:00,190,96,94,FMN GV 16 Berchem TOT
54,Posthofbrug 5366,2019-09-06,14:00:00,176,97,79,FMN GV 16 Berchem TOT
54,Posthofbrug 5366,2019-09-06,15:00:00,282,127,155,FMN GV 16 Berchem TOT
54,Posthofbrug 5366,2019-09-06,16:00:00,443,196,247,FMN GV 16 Berchem TOT
54,Posthofbrug 5366,2019-09-06,17:00:00,473,152,321,FMN GV 16 Berchem TOT
54,Posthofbrug 5366,2019-09-06,18:00:00,302,125,177,FMN GV 16 Berchem TOT
54,Posthofbrug 5366,2019-09-06,19:00:00,117,46,71,FMN GV 16 Berchem TOT
54,Posthofbrug 5366,2019-09-06,20:00:00,90,46,44,FMN GV 16 Berchem TOT
54,Posthofbrug 5366,2019-09-06,21:00:00,71,38,33,FMN GV 16 Berchem TOT
54,Posthofbrug 5366,2019-09-06,22:00:00,61,19,42,FMN GV 16 Berchem TOT
54,Posthofbrug 5366,2019-09-06,23:00:00,50,22,28,FMN GV 16 Berchem TOT
54,Posthofbrug 5366,2019-09-07,00:00:00,66,25,41,FMN GV 16 Berchem TOT
54,Posthofbrug 5366,2019-09-07,01:00:00,40,8,32,FMN GV 16 Berchem TOT
54,Posthofbrug 5366,2019-09-07,02:00:00,16,5,11,FMN GV 16 Berchem TOT
54,Posthofbrug 5366,2019-09-07,03:00:00,11,4,7,FMN GV 16 Berchem TOT
54,Posthofbrug 5366,2019-09-07,04:00:00,19,4,15,FMN GV 16 Berchem TOT
54,Posthofbrug 5366,2019-09-07,05:00:00,13,6,7,FMN GV 16 Berchem TOT
54,Posthofbrug 5366,2019-09-07,06:00:00,12,5,7,FMN GV 16 Berchem TOT
54,Posthofbrug 5366,2019-09-07,07:00:00,29,20,9,FMN GV 16 Berchem TOT
54,Posthofbrug 5366,2019-09-07,08:00:00,51,29,22,FMN GV 16 Berchem TOT
54,Posthofbrug 5366,2019-09-07,09:00:00,84,62,22,FMN GV 16 Berchem TOT
54,Posthofbrug 5366,2019-09-07,10:00:00,120,77,43,FMN GV 16 Berchem TOT
54,Posthofbrug 5366,2019-09-07,11:00:00,140,99,41,FMN GV 16 Berchem TOT
54,Posthofbrug 5366,2019-09-07,12:00:00,132,77,55,FMN GV 16 Berchem TOT
54,Posthofbrug 5366,2019-09-07,13:00:00,109,72,37,FMN GV 16 Berchem TOT
54,Posthofbrug 5366,2019-09-07,14:00:00,102,54,48,FMN GV 16 Berchem TOT
54,Posthofbrug 5366,2019-09-07,15:00:00,109,51,58,FMN GV 16 Berchem TOT
54,Posthofbrug 5366,2019-09-07,16:00:00,128,69,59,FMN GV 16 Berchem TOT
54,Posthofbrug 5366,2019-09-07,17:00:00,152,73,79,FMN GV 16 Berchem TOT
54,Posthofbrug 5366,2019-09-07,18:00:00,98,41,57,FMN GV 16 Berchem TOT
54,Posthofbrug 5366,2019-09-07,19:00:00,88,49,39,FMN GV 16 Berchem TOT
54,Posthofbrug 5366,2019-09-07,20:00:00,67,37,30,FMN GV 16 Berchem TOT
54,Posthofbrug 5366,2019-09-07,21:00:00,71,40,31,FMN GV 16 Berchem TOT
54,Posthofbrug 5366,2019-09-07,22:00:00,55,22,33,FMN GV 16 Berchem TOT
54,Posthofbrug 5366,2019-09-07,23:00:00,30,5,25,FMN GV 16 Berchem TOT
54,Posthofbrug 5366,2019-09-08,00:00:00,54,9,45,FMN GV 16 Berchem TOT
54,Posthofbrug 5366,2019-09-08,01:00:00,24,5,19,FMN GV 16 Berchem TOT
54,Posthofbrug 5366,2019-09-08,02:00:00,13,6,7,FMN GV 16 Berchem TOT
54,Posthofbrug 5366,2019-09-08,03:00:00,10,3,7,FMN GV 16 Berchem TOT
54,Posthofbrug 5366,2019-09-08,04:00:00,12,9,3,FMN GV 16 Berchem TOT
54,Posthofbrug 5366,2019-09-08,05:00:00,21,17,4,FMN GV 16 Berchem TOT
54,Posthofbrug 5366,2019-09-08,06:00:00,12,8,4,FMN GV 16 Berchem TOT
54,Posthofbrug 5366,2019-09-08,07:00:00,16,9,7,FMN GV 16 Berchem TOT
54,Posthofbrug 5366,2019-09-08,08:00:00,35,23,12,FMN GV 16 Berchem TOT
54,Posthofbrug 5366,2019-09-08,09:00:00,95,53,42,FMN GV 16 Berchem TOT
54,Posthofbrug 5366,2019-09-08,10:00:00,116,76,40,FMN GV 16 Berchem TOT
54,Posthofbrug 5366,2019-09-08,11:00:00,184,132,52,FMN GV 16 Berchem TOT
54,Posthofbrug 5366,2019-09-08,12:00:00,194,116,78,FMN GV 16 Berchem TOT
54,Posthofbrug 5366,2019-09-08,13:00:00,197,125,72,FMN GV 16 Berchem TOT
54,Posthofbrug 5366,2019-09-08,14:00:00,208,110,98,FMN GV 16 Berchem TOT
54,Posthofbrug 5366,2019-09-08,15:00:00,96,18,78,FMN GV 16 Berchem TOT
54,Posthofbrug 5366,2019-09-08,16:00:00,200,99,101,FMN GV 16 Berchem TOT
54,Posthofbrug 5366,2019-09-08,17:00:00,190,68,122,FMN GV 16 Berchem TOT
54,Posthofbrug 5366,2019-09-08,18:00:00,161,67,94,FMN GV 16 Berchem TOT
54,Posthofbrug 5366,2019-09-08,19:00:00,125,45,80,FMN GV 16 Berchem TOT
54,Posthofbrug 5366,2019-09-08,20:00:00,85,42,43,FMN GV 16 Berchem TOT
54,Posthofbrug 5366,2019-09-08,21:00:00,47,20,27,FMN GV 16 Berchem TOT
54,Posthofbrug 5366,2019-09-08,22:00:00,57,16,41,FMN GV 16 Berchem TOT
54,Posthofbrug 5366,2019-09-08,23:00:00,20,7,13,FMN GV 16 Berchem TOT
54,Posthofbrug 5366,2019-09-09,00:00:00,12,3,9,FMN GV 16 Berchem TOT
54,Posthofbrug 5366,2019-09-09,01:00:00,7,3,4,FMN GV 16 Berchem TOT
54,Posthofbrug 5366,2019-09-09,02:00:00,3,0,3,FMN GV 16 Berchem TOT
54,Posthofbrug 5366,2019-09-09,03:00:00,4,2,2,FMN GV 16 Berchem TOT
54,Posthofbrug 5366,2019-09-09,04:00:00,12,11,1,FMN GV 16 Berchem TOT
54,Posthofbrug 5366,2019-09-09,05:00:00,23,18,5,FMN GV 16 Berchem TOT
54,Posthofbrug 5366,2019-09-09,06:00:00,130,110,20,FMN GV 16 Berchem TOT
54,Posthofbrug 5366,2019-09-09,07:00:00,431,323,108,FMN GV 16 Berchem TOT
54,Posthofbrug 5366,2019-09-09,08:00:00,779,545,234,FMN GV 16 Berchem TOT
54,Posthofbrug 5366,2019-09-09,09:00:00,234,168,66,FMN GV 16 Berchem TOT
54,Posthofbrug 5366,2019-09-09,10:00:00,115,72,43,FMN GV 16 Berchem TOT
54,Posthofbrug 5366,2019-09-09,11:00:00,121,82,39,FMN GV 16 Berchem TOT
54,Posthofbrug 5366,2019-09-09,12:00:00,163,94,69,FMN GV 16 Berchem TOT
54,Posthofbrug 5366,2019-09-09,13:00:00,141,65,76,FMN GV 16 Berchem TOT
54,Posthofbrug 5366,2019-09-09,14:00:00,150,76,74,FMN GV 16 Berchem TOT
54,Posthofbrug 5366,2019-09-09,15:00:00,227,87,140,FMN GV 16 Berchem TOT
54,Posthofbrug 5366,2019-09-09,16:00:00,507,198,309,FMN GV 16 Berchem TOT
54,Posthofbrug 5366,2019-09-09,17:00:00,648,235,413,FMN GV 16 Berchem TOT
54,Posthofbrug 5366,2019-09-09,18:00:00,379,144,235,FMN GV 16 Berchem TOT
54,Posthofbrug 5366,2019-09-09,19:00:00,155,55,100,FMN GV 16 Berchem TOT
54,Posthofbrug 5366,2019-09-09,20:00:00,102,51,51,FMN GV 16 Berchem TOT
54,Posthofbrug 5366,2019-09-09,21:00:00,78,25,53,FMN GV 16 Berchem TOT
54,Posthofbrug 5366,2019-09-09,22:00:00,62,32,30,FMN GV 16 Berchem TOT
54,Posthofbrug 5366,2019-09-09,23:00:00,40,15,25,FMN GV 16 Berchem TOT
54,Posthofbrug 5366,2019-09-10,00:00:00,15,5,10,FMN GV 16 Berchem TOT
54,Posthofbrug 5366,2019-09-10,01:00:00,4,0,4,FMN GV 16 Berchem TOT
54,Posthofbrug 5366,2019-09-10,02:00:00,5,2,3,FMN GV 16 Berchem TOT
54,Posthofbrug 5366,2019-09-10,03:00:00,2,1,1,FMN GV 16 Berchem TOT
54,Posthofbrug 5366,2019-09-10,04:00:00,8,7,1,FMN GV 16 Berchem TOT
54,Posthofbrug 5366,2019-09-10,05:00:00,29,21,8,FMN GV 16 Berchem TOT
54,Posthofbrug 5366,2019-09-10,06:00:00,140,115,25,FMN GV 16 Berchem TOT
54,Posthofbrug 5366,2019-09-10,07:00:00,461,338,123,FMN GV 16 Berchem TOT
54,Posthofbrug 5366,2019-09-10,08:00:00,743,507,236,FMN GV 16 Berchem TOT
54,Posthofbrug 5366,2019-09-10,09:00:00,238,170,68,FMN GV 16 Berchem TOT
54,Posthofbrug 5366,2019-09-10,10:00:00,132,91,41,FMN GV 16 Berchem TOT
54,Posthofbrug 5366,2019-09-10,11:00:00,111,67,44,FMN GV 16 Berchem TOT
54,Posthofbrug 5366,2019-09-10,12:00:00,198,119,79,FMN GV 16 Berchem TOT
54,Posthofbrug 5366,2019-09-10,13:00:00,158,86,72,FMN GV 16 Berchem TOT
54,Posthofbrug 5366,2019-09-10,14:00:00,175,84,91,FMN GV 16 Berchem TOT
54,Posthofbrug 5366,2019-09-10,15:00:00,252,105,147,FMN GV 16 Berchem TOT
54,Posthofbrug 5366,2019-09-10,16:00:00,549,214,335,FMN GV 16 Berchem TOT
54,Posthofbrug 5366,2019-09-10,17:00:00,638,235,403,FMN GV 16 Berchem TOT
54,Posthofbrug 5366,2019-09-10,18:00:00,380,144,236,FMN GV 16 Berchem TOT
54,Posthofbrug 5366,2019-09-10,19:00:00,232,92,140,FMN GV 16 Berchem TOT
54,Posthofbrug 5366,2019-09-10,20:00:00,106,50,56,FMN GV 16 Berchem TOT
54,Posthofbrug 5366,2019-09-10,21:00:00,91,42,49,FMN GV 16 Berchem TOT
54,Posthofbrug 5366,2019-09-10,22:00:00,77,27,50,FMN GV 16 Berchem TOT
54,Posthofbrug 5366,2019-09-10,23:00:00,44,16,28,FMN GV 16 Berchem TOT
54,Posthofbrug 5366,2019-09-11,00:00:00,15,5,10,FMN GV 16 Berchem TOT
54,Posthofbrug 5366,2019-09-11,01:00:00,9,2,7,FMN GV 16 Berchem TOT
54,Posthofbrug 5366,2019-09-11,02:00:00,3,1,2,FMN GV 16 Berchem TOT
54,Posthofbrug 5366,2019-09-11,03:00:00,7,2,5,FMN GV 16 Berchem TOT
54,Posthofbrug 5366,2019-09-11,04:00:00,4,4,0,FMN GV 16 Berchem TOT
54,Posthofbrug 5366,2019-09-11,05:00:00,27,20,7,FMN GV 16 Berchem TOT
54,Posthofbrug 5366,2019-09-11,06:00:00,115,93,22,FMN GV 16 Berchem TOT
54,Posthofbrug 5366,2019-09-11,07:00:00,414,311,103,FMN GV 16 Berchem TOT
54,Posthofbrug 5366,2019-09-11,08:00:00,554,370,184,FMN GV 16 Berchem TOT
54,Posthofbrug 5366,2019-09-11,09:00:00,192,124,68,FMN GV 16 Berchem TOT
54,Posthofbrug 5366,2019-09-11,10:00:00,81,48,33,FMN GV 16 Berchem TOT
54,Posthofbrug 5366,2019-09-11,11:00:00,82,48,34,FMN GV 16 Berchem TOT
54,Posthofbrug 5366,2019-09-11,12:00:00,195,94,101,FMN GV 16 Berchem TOT
54,Posthofbrug 5366,2019-09-11,13:00:00,138,61,77,FMN GV 16 Berchem TOT
54,Posthofbrug 5366,2019-09-11,14:00:00,126,59,67,FMN GV 16 Berchem TOT
54,Posthofbrug 5366,2019-09-11,15:00:00,140,65,75,FMN GV 16 Berchem TOT
54,Posthofbrug 5366,2019-09-11,16:00:00,294,145,149,FMN GV 16 Berchem TOT
54,Posthofbrug 5366,2019-09-11,17:00:00,425,175,250,FMN GV 16 Berchem TOT
54,Posthofbrug 5366,2019-09-11,18:00:00,290,101,189,FMN GV 16 Berchem TOT
54,Posthofbrug 5366,2019-09-11,19:00:00,122,45,77,FMN GV 16 Berchem TOT
54,Posthofbrug 5366,2019-09-11,20:00:00,83,46,37,FMN GV 16 Berchem TOT
54,Posthofbrug 5366,2019-09-11,21:00:00,46,20,26,FMN GV 16 Berchem TOT
54,Posthofbrug 5366,2019-09-11,22:00:00,61,24,37,FMN GV 16 Berchem TOT
54,Posthofbrug 5366,2019-09-11,23:00:00,37,15,22,FMN GV 16 Berchem TOT
54,Posthofbrug 5366,2019-09-12,00:00:00,10,5,5,FMN GV 16 Berchem TOT
54,Posthofbrug 5366,2019-09-12,01:00:00,7,1,6,FMN GV 16 Berchem TOT
54,Posthofbrug 5366,2019-09-12,02:00:00,4,1,3,FMN GV 16 Berchem TOT
54,Posthofbrug 5366,2019-09-12,03:00:00,5,3,2,FMN GV 16 Berchem TOT
54,Posthofbrug 5366,2019-09-12,04:00:00,8,6,2,FMN GV 16 Berchem TOT
54,Posthofbrug 5366,2019-09-12,05:00:00,31,21,10,FMN GV 16 Berchem TOT
54,Posthofbrug 5366,2019-09-12,06:00:00,113,92,21,FMN GV 16 Berchem TOT
54,Posthofbrug 5366,2019-09-12,07:00:00,459,348,111,FMN GV 16 Berchem TOT
54,Posthofbrug 5366,2019-09-12,08:00:00,715,500,215,FMN GV 16 Berchem TOT
54,Posthofbrug 5366,2019-09-12,09:00:00,252,184,68,FMN GV 16 Berchem TOT
54,Posthofbrug 5366,2019-09-12,10:00:00,119,74,45,FMN GV 16 Berchem TOT
54,Posthofbrug 5366,2019-09-12,11:00:00,129,78,51,FMN GV 16 Berchem TOT
54,Posthofbrug 5366,2019-09-12,12:00:00,195,106,89,FMN GV 16 Berchem TOT
54,Posthofbrug 5366,2019-09-12,13:00:00,170,105,65,FMN GV 16 Berchem TOT
54,Posthofbrug 5366,2019-09-12,14:00:00,169,87,82,FMN GV 16 Berchem TOT
54,Posthofbrug 5366,2019-09-12,15:00:00,261,114,147,FMN GV 16 Berchem TOT
54,Posthofbrug 5366,2019-09-12,16:00:00,522,203,319,FMN GV 16 Berchem TOT
54,Posthofbrug 5366,2019-09-12,17:00:00,629,230,399,FMN GV 16 Berchem TOT
54,Posthofbrug 5366,2019-09-12,18:00:00,376,126,250,FMN GV 16 Berchem TOT
54,Posthofbrug 5366,2019-09-12,19:00:00,209,98,111,FMN GV 16 Berchem TOT
54,Posthofbrug 5366,2019-09-12,20:00:00,117,56,61,FMN GV 16 Berchem TOT
54,Posthofbrug 5366,2019-09-12,21:00:00,102,42,60,FMN GV 16 Berchem TOT
54,Posthofbrug 5366,2019-09-12,22:00:00,85,29,56,FMN GV 16 Berchem TOT
54,Posthofbrug 5366,2019-09-12,23:00:00,51,21,30,FMN GV 16 Berchem TOT
54,Posthofbrug 5366,2019-09-13,00:00:00,31,8,23,FMN GV 16 Berchem TOT
54,Posthofbrug 5366,2019-09-13,01:00:00,10,3,7,FMN GV 16 Berchem TOT
54,Posthofbrug 5366,2019-09-13,02:00:00,10,2,8,FMN GV 16 Berchem TOT
54,Posthofbrug 5366,2019-09-13,03:00:00,5,0,5,FMN GV 16 Berchem TOT
54,Posthofbrug 5366,2019-09-13,04:00:00,10,9,1,FMN GV 16 Berchem TOT
54,Posthofbrug 5366,2019-09-13,05:00:00,19,13,6,FMN GV 16 Berchem TOT
54,Posthofbrug 5366,2019-09-13,06:00:00,113,85,28,FMN GV 16 Berchem TOT
54,Posthofbrug 5366,2019-09-13,07:00:00,371,272,99,FMN GV 16 Berchem TOT
54,Posthofbrug 5366,2019-09-13,08:00:00,607,436,171,FMN GV 16 Berchem TOT
54,Posthofbrug 5366,2019-09-13,09:00:00,216,150,66,FMN GV 16 Berchem TOT
54,Posthofbrug 5366,2019-09-13,10:00:00,83,56,27,FMN GV 16 Berchem TOT
54,Posthofbrug 5366,2019-09-13,11:00:00,97,64,33,FMN GV 16 Berchem TOT
54,Posthofbrug 5366,2019-09-13,12:00:00,158,92,66,FMN GV 16 Berchem TOT
54,Posthofbrug 5366,2019-09-13,13:00:00,159,84,75,FMN GV 16 Berchem TOT
54,Posthofbrug 5366,2019-09-13,14:00:00,172,84,88,FMN GV 16 Berchem TOT
54,Posthofbrug 5366,2019-09-13,15:00:00,269,113,156,FMN GV 16 Berchem TOT
54,Posthofbrug 5366,2019-09-13,16:00:00,445,193,252,FMN GV 16 Berchem TOT
54,Posthofbrug 5366,2019-09-13,17:00:00,463,184,279,FMN GV 16 Berchem TOT
54,Posthofbrug 5366,2019-09-13,18:00:00,307,124,183,FMN GV 16 Berchem TOT
54,Posthofbrug 5366,2019-09-13,19:00:00,159,78,81,FMN GV 16 Berchem TOT
54,Posthofbrug 5366,2019-09-13,20:00:00,135,79,56,FMN GV 16 Berchem TOT
54,Posthofbrug 5366,2019-09-13,21:00:00,71,35,36,FMN GV 16 Berchem TOT
54,Posthofbrug 5366,2019-09-13,22:00:00,54,24,30,FMN GV 16 Berchem TOT
54,Posthofbrug 5366,2019-09-13,23:00:00,64,16,48,FMN GV 16 Berchem TOT
54,Posthofbrug 5366,2019-09-14,00:00:00,63,20,43,FMN GV 16 Berchem TOT
54,Posthofbrug 5366,2019-09-14,01:00:00,42,23,19,FMN GV 16 Berchem TOT
54,Posthofbrug 5366,2019-09-14,02:00:00,29,16,13,FMN GV 16 Berchem TOT
54,Posthofbrug 5366,2019-09-14,03:00:00,20,8,12,FMN GV 16 Berchem TOT
54,Posthofbrug 5366,2019-09-14,04:00:00,21,10,11,FMN GV 16 Berchem TOT
54,Posthofbrug 5366,2019-09-14,05:00:00,15,6,9,FMN GV 16 Berchem TOT
54,Posthofbrug 5366,2019-09-14,06:00:00,22,11,11,FMN GV 16 Berchem TOT
54,Posthofbrug 5366,2019-09-14,07:00:00,25,14,11,FMN GV 16 Berchem TOT
54,Posthofbrug 5366,2019-09-14,08:00:00,63,42,21,FMN GV 16 Berchem TOT
54,Posthofbrug 5366,2019-09-14,09:00:00,116,86,30,FMN GV 16 Berchem TOT
54,Posthofbrug 5366,2019-09-14,10:00:00,138,82,56,FMN GV 16 Berchem TOT
54,Posthofbrug 5366,2019-09-14,11:00:00,160,103,57,FMN GV 16 Berchem TOT
54,Posthofbrug 5366,2019-09-14,12:00:00,216,126,90,FMN GV 16 Berchem TOT
54,Posthofbrug 5366,2019-09-14,13:00:00,228,156,72,FMN GV 16 Berchem TOT
54,Posthofbrug 5366,2019-09-14,14:00:00,222,134,88,FMN GV 16 Berchem TOT
54,Posthofbrug 5366,2019-09-14,15:00:00,199,117,82,FMN GV 16 Berchem TOT
54,Posthofbrug 5366,2019-09-14,16:00:00,206,93,113,FMN GV 16 Berchem TOT
54,Posthofbrug 5366,2019-09-14,17:00:00,199,78,121,FMN GV 16 Berchem TOT
54,Posthofbrug 5366,2019-09-14,18:00:00,161,89,72,FMN GV 16 Berchem TOT
54,Posthofbrug 5366,2019-09-14,19:00:00,137,73,64,FMN GV 16 Berchem TOT
54,Posthofbrug 5366,2019-09-14,20:00:00,85,48,37,FMN GV 16 Berchem TOT
54,Posthofbrug 5366,2019-09-14,21:00:00,57,29,28,FMN GV 16 Berchem TOT
54,Posthofbrug 5366,2019-09-14,22:00:00,51,30,21,FMN GV 16 Berchem TOT
54,Posthofbrug 5366,2019-09-14,23:00:00,48,22,26,FMN GV 16 Berchem TOT
54,Posthofbrug 5366,2019-09-15,00:00:00,38,15,23,FMN GV 16 Berchem TOT
54,Posthofbrug 5366,2019-09-15,01:00:00,29,12,17,FMN GV 16 Berchem TOT
54,Posthofbrug 5366,2019-09-15,02:00:00,12,4,8,FMN GV 16 Berchem TOT
54,Posthofbrug 5366,2019-09-15,03:00:00,14,2,12,FMN GV 16 Berchem TOT
54,Posthofbrug 5366,2019-09-15,04:00:00,12,3,9,FMN GV 16 Berchem TOT
54,Posthofbrug 5366,2019-09-15,05:00:00,21,11,10,FMN GV 16 Berchem TOT
54,Posthofbrug 5366,2019-09-15,06:00:00,15,9,6,FMN GV 16 Berchem TOT
54,Posthofbrug 5366,2019-09-15,07:00:00,19,14,5,FMN GV 16 Berchem TOT
54,Posthofbrug 5366,2019-09-15,08:00:00,40,22,18,FMN GV 16 Berchem TOT
54,Posthofbrug 5366,2019-09-15,09:00:00,103,69,34,FMN GV 16 Berchem TOT
54,Posthofbrug 5366,2019-09-15,10:00:00,149,103,46,FMN GV 16 Berchem TOT
54,Posthofbrug 5366,2019-09-15,11:00:00,242,184,58,FMN GV 16 Berchem TOT
54,Posthofbrug 5366,2019-09-15,12:00:00,271,184,87,FMN GV 16 Berchem TOT
54,Posthofbrug 5366,2019-09-15,13:00:00,281,210,71,FMN GV 16 Berchem TOT
54,Posthofbrug 5366,2019-09-15,14:00:00,377,249,128,FMN GV 16 Berchem TOT
54,Posthofbrug 5366,2019-09-15,15:00:00,277,128,149,FMN GV 16 Berchem TOT
54,Posthofbrug 5366,2019-09-15,16:00:00,269,105,164,FMN GV 16 Berchem TOT
54,Posthofbrug 5366,2019-09-15,17:00:00,292,94,198,FMN GV 16 Berchem TOT
54,Posthofbrug 5366,2019-09-15,18:00:00,192,77,115,FMN GV 16 Berchem TOT
54,Posthofbrug 5366,2019-09-15,19:00:00,141,51,90,FMN GV 16 Berchem TOT
54,Posthofbrug 5366,2019-09-15,20:00:00,120,56,64,FMN GV 16 Berchem TOT
54,Posthofbrug 5366,2019-09-15,21:00:00,62,34,28,FMN GV 16 Berchem TOT
54,Posthofbrug 5366,2019-09-15,22:00:00,44,20,24,FMN GV 16 Berchem TOT
54,Posthofbrug 5366,2019-09-15,23:00:00,23,12,11,FMN GV 16 Berchem TOT
54,Posthofbrug 5366,2019-09-16,00:00:00,5,0,5,FMN GV 16 Berchem TOT
54,Posthofbrug 5366,2019-09-16,01:00:00,10,3,7,FMN GV 16 Berchem TOT
54,Posthofbrug 5366,2019-09-16,02:00:00,3,2,1,FMN GV 16 Berchem TOT
54,Posthofbrug 5366,2019-09-16,03:00:00,1,0,1,FMN GV 16 Berchem TOT
54,Posthofbrug 5366,2019-09-16,04:00:00,8,7,1,FMN GV 16 Berchem TOT
54,Posthofbrug 5366,2019-09-16,05:00:00,27,20,7,FMN GV 16 Berchem TOT
54,Posthofbrug 5366,2019-09-16,06:00:00,138,112,26,FMN GV 16 Berchem TOT
54,Posthofbrug 5366,2019-09-16,07:00:00,478,370,108,FMN GV 16 Berchem TOT
54,Posthofbrug 5366,2019-09-16,08:00:00,699,486,213,FMN GV 16 Berchem TOT
54,Posthofbrug 5366,2019-09-16,09:00:00,227,159,68,FMN GV 16 Berchem TOT
54,Posthofbrug 5366,2019-09-16,10:00:00,117,83,34,FMN GV 16 Berchem TOT
54,Posthofbrug 5366,2019-09-16,11:00:00,112,74,38,FMN GV 16 Berchem TOT
54,Posthofbrug 5366,2019-09-16,12:00:00,152,83,69,FMN GV 16 Berchem TOT
54,Posthofbrug 5366,2019-09-16,13:00:00,134,72,62,FMN GV 16 Berchem TOT
54,Posthofbrug 5366,2019-09-16,14:00:00,140,61,79,FMN GV 16 Berchem TOT
54,Posthofbrug 5366,2019-09-16,15:00:00,268,92,176,FMN GV 16 Berchem TOT
54,Posthofbrug 5366,2019-09-16,16:00:00,432,152,280,FMN GV 16 Berchem TOT
54,Posthofbrug 5366,2019-09-16,17:00:00,615,185,430,FMN GV 16 Berchem TOT
54,Posthofbrug 5366,2019-09-16,18:00:00,333,115,218,FMN GV 16 Berchem TOT
54,Posthofbrug 5366,2019-09-16,19:00:00,171,62,109,FMN GV 16 Berchem TOT
54,Posthofbrug 5366,2019-09-16,20:00:00,105,48,57,FMN GV 16 Berchem TOT
54,Posthofbrug 5366,2019-09-16,21:00:00,77,31,46,FMN GV 16 Berchem TOT
54,Posthofbrug 5366,2019-09-16,22:00:00,63,25,38,FMN GV 16 Berchem TOT
54,Posthofbrug 5366,2019-09-16,23:00:00,28,10,18,FMN GV 16 Berchem TOT
54,Posthofbrug 5366,2019-09-17,00:00:00,13,7,6,FMN GV 16 Berchem TOT
54,Posthofbrug 5366,2019-09-17,01:00:00,6,1,5,FMN GV 16 Berchem TOT
54,Posthofbrug 5366,2019-09-17,02:00:00,5,0,5,FMN GV 16 Berchem TOT
54,Posthofbrug 5366,2019-09-17,03:00:00,0,0,0,FMN GV 16 Berchem TOT
54,Posthofbrug 5366,2019-09-17,04:00:00,8,7,1,FMN GV 16 Berchem TOT
54,Posthofbrug 5366,2019-09-17,05:00:00,28,22,6,FMN GV 16 Berchem TOT
54,Posthofbrug 5366,2019-09-17,06:00:00,150,124,26,FMN GV 16 Berchem TOT
54,Posthofbrug 5366,2019-09-17,07:00:00,483,352,131,FMN GV 16 Berchem TOT
54,Posthofbrug 5366,2019-09-17,08:00:00,730,505,225,FMN GV 16 Berchem TOT
54,Posthofbrug 5366,2019-09-17,09:00:00,247,173,74,FMN GV 16 Berchem TOT
54,Posthofbrug 5366,2019-09-17,10:00:00,116,82,34,FMN GV 16 Berchem TOT
54,Posthofbrug 5366,2019-09-17,11:00:00,112,70,42,FMN GV 16 Berchem TOT
54,Posthofbrug 5366,2019-09-17,12:00:00,170,100,70,FMN GV 16 Berchem TOT
54,Posthofbrug 5366,2019-09-17,13:00:00,166,85,81,FMN GV 16 Berchem TOT
54,Posthofbrug 5366,2019-09-17,14:00:00,123,48,75,FMN GV 16 Berchem TOT
54,Posthofbrug 5366,2019-09-17,15:00:00,274,106,168,FMN GV 16 Berchem TOT
54,Posthofbrug 5366,2019-09-17,16:00:00,489,175,314,FMN GV 16 Berchem TOT
54,Posthofbrug 5366,2019-09-17,17:00:00,617,221,396,FMN GV 16 Berchem TOT
54,Posthofbrug 5366,2019-09-17,18:00:00,377,142,235,FMN GV 16 Berchem TOT
54,Posthofbrug 5366,2019-09-17,19:00:00,164,56,108,FMN GV 16 Berchem TOT
54,Posthofbrug 5366,2019-09-17,20:00:00,108,42,66,FMN GV 16 Berchem TOT
54,Posthofbrug 5366,2019-09-17,21:00:00,81,38,43,FMN GV 16 Berchem TOT
54,Posthofbrug 5366,2019-09-17,22:00:00,69,33,36,FMN GV 16 Berchem TOT
54,Posthofbrug 5366,2019-09-17,23:00:00,47,20,27,FMN GV 16 Berchem TOT
54,Posthofbrug 5366,2019-09-18,00:00:00,19,5,14,FMN GV 16 Berchem TOT
54,Posthofbrug 5366,2019-09-18,01:00:00,7,1,6,FMN GV 16 Berchem TOT
54,Posthofbrug 5366,2019-09-18,02:00:00,4,0,4,FMN GV 16 Berchem TOT
54,Posthofbrug 5366,2019-09-18,03:00:00,10,3,7,FMN GV 16 Berchem TOT
54,Posthofbrug 5366,2019-09-18,04:00:00,13,10,3,FMN GV 16 Berchem TOT
54,Posthofbrug 5366,2019-09-18,05:00:00,23,16,7,FMN GV 16 Berchem TOT
54,Posthofbrug 5366,2019-09-18,06:00:00,119,95,24,FMN GV 16 Berchem TOT
54,Posthofbrug 5366,2019-09-18,07:00:00,432,311,121,FMN GV 16 Berchem TOT
54,Posthofbrug 5366,2019-09-18,08:00:00,639,447,192,FMN GV 16 Berchem TOT
54,Posthofbrug 5366,2019-09-18,09:00:00,239,149,90,FMN GV 16 Berchem TOT
54,Posthofbrug 5366,2019-09-18,10:00:00,93,53,40,FMN GV 16 Berchem TOT
54,Posthofbrug 5366,2019-09-18,11:00:00,141,83,58,FMN GV 16 Berchem TOT
54,Posthofbrug 5366,2019-09-18,12:00:00,296,151,145,FMN GV 16 Berchem TOT
54,Posthofbrug 5366,2019-09-18,13:00:00,214,91,123,FMN GV 16 Berchem TOT
54,Posthofbrug 5366,2019-09-18,14:00:00,147,67,80,FMN GV 16 Berchem TOT
54,Posthofbrug 5366,2019-09-18,15:00:00,227,93,134,FMN GV 16 Berchem TOT
54,Posthofbrug 5366,2019-09-18,16:00:00,324,126,198,FMN GV 16 Berchem TOT
54,Posthofbrug 5366,2019-09-18,17:00:00,552,206,346,FMN GV 16 Berchem TOT
54,Posthofbrug 5366,2019-09-18,18:00:00,351,120,231,FMN GV 16 Berchem TOT
54,Posthofbrug 5366,2019-09-18,19:00:00,136,57,79,FMN GV 16 Berchem TOT
54,Posthofbrug 5366,2019-09-18,20:00:00,106,55,51,FMN GV 16 Berchem TOT
54,Posthofbrug 5366,2019-09-18,21:00:00,57,22,35,FMN GV 16 Berchem TOT
54,Posthofbrug 5366,2019-09-18,22:00:00,84,24,60,FMN GV 16 Berchem TOT
54,Posthofbrug 5366,2019-09-18,23:00:00,40,11,29,FMN GV 16 Berchem TOT
54,Posthofbrug 5366,2019-09-19,00:00:00,14,6,8,FMN GV 16 Berchem TOT
54,Posthofbrug 5366,2019-09-19,01:00:00,7,1,6,FMN GV 16 Berchem TOT
54,Posthofbrug 5366,2019-09-19,02:00:00,6,2,4,FMN GV 16 Berchem TOT
54,Posthofbrug 5366,2019-09-19,03:00:00,3,2,1,FMN GV 16 Berchem TOT
54,Posthofbrug 5366,2019-09-19,04:00:00,9,7,2,FMN GV 16 Berchem TOT
54,Posthofbrug 5366,2019-09-19,05:00:00,25,18,7,FMN GV 16 Berchem TOT
54,Posthofbrug 5366,2019-09-19,06:00:00,134,107,27,FMN GV 16 Berchem TOT
54,Posthofbrug 5366,2019-09-19,07:00:00,464,348,116,FMN GV 16 Berchem TOT
54,Posthofbrug 5366,2019-09-19,08:00:00,724,500,224,FMN GV 16 Berchem TOT
54,Posthofbrug 5366,2019-09-19,09:00:00,272,193,79,FMN GV 16 Berchem TOT
54,Posthofbrug 5366,2019-09-19,10:00:00,105,68,37,FMN GV 16 Berchem TOT
54,Posthofbrug 5366,2019-09-19,11:00:00,111,58,53,FMN GV 16 Berchem TOT
54,Posthofbrug 5366,2019-09-19,12:00:00,182,106,76,FMN GV 16 Berchem TOT
54,Posthofbrug 5366,2019-09-19,13:00:00,170,82,88,FMN GV 16 Berchem TOT
54,Posthofbrug 5366,2019-09-19,14:00:00,153,66,87,FMN GV 16 Berchem TOT
54,Posthofbrug 5366,2019-09-19,15:00:00,232,79,153,FMN GV 16 Berchem TOT
54,Posthofbrug 5366,2019-09-19,16:00:00,503,182,321,FMN GV 16 Berchem TOT
54,Posthofbrug 5366,2019-09-19,17:00:00,608,208,400,FMN GV 16 Berchem TOT
54,Posthofbrug 5366,2019-09-19,18:00:00,377,153,224,FMN GV 16 Berchem TOT
54,Posthofbrug 5366,2019-09-19,19:00:00,193,84,109,FMN GV 16 Berchem TOT
54,Posthofbrug 5366,2019-09-19,20:00:00,110,50,60,FMN GV 16 Berchem TOT
54,Posthofbrug 5366,2019-09-19,21:00:00,85,38,47,FMN GV 16 Berchem TOT
54,Posthofbrug 5366,2019-09-19,22:00:00,84,24,60,FMN GV 16 Berchem TOT
54,Posthofbrug 5366,2019-09-19,23:00:00,57,12,45,FMN GV 16 Berchem TOT
54,Posthofbrug 5366,2019-09-20,00:00:00,29,6,23,FMN GV 16 Berchem TOT
54,Posthofbrug 5366,2019-09-20,01:00:00,15,7,8,FMN GV 16 Berchem TOT
54,Posthofbrug 5366,2019-09-20,02:00:00,7,1,6,FMN GV 16 Berchem TOT
54,Posthofbrug 5366,2019-09-20,03:00:00,4,3,1,FMN GV 16 Berchem TOT
54,Posthofbrug 5366,2019-09-20,04:00:00,17,11,6,FMN GV 16 Berchem TOT
54,Posthofbrug 5366,2019-09-20,05:00:00,27,17,10,FMN GV 16 Berchem TOT
54,Posthofbrug 5366,2019-09-20,06:00:00,101,79,22,FMN GV 16 Berchem TOT
54,Posthofbrug 5366,2019-09-20,07:00:00,392,313,79,FMN GV 16 Berchem TOT
54,Posthofbrug 5366,2019-09-20,08:00:00,616,445,171,FMN GV 16 Berchem TOT
54,Posthofbrug 5366,2019-09-20,09:00:00,206,147,59,FMN GV 16 Berchem TOT
54,Posthofbrug 5366,2019-09-20,10:00:00,115,79,36,FMN GV 16 Berchem TOT
54,Posthofbrug 5366,2019-09-20,11:00:00,117,72,45,FMN GV 16 Berchem TOT
54,Posthofbrug 5366,2019-09-20,12:00:00,203,103,100,FMN GV 16 Berchem TOT
54,Posthofbrug 5366,2019-09-20,13:00:00,179,70,109,FMN GV 16 Berchem TOT
54,Posthofbrug 5366,2019-09-20,14:00:00,196,80,116,FMN GV 16 Berchem TOT
54,Posthofbrug 5366,2019-09-20,15:00:00,265,97,168,FMN GV 16 Berchem TOT
54,Posthofbrug 5366,2019-09-20,16:00:00,427,153,274,FMN GV 16 Berchem TOT
54,Posthofbrug 5366,2019-09-20,17:00:00,482,169,313,FMN GV 16 Berchem TOT
54,Posthofbrug 5366,2019-09-20,18:00:00,283,107,176,FMN GV 16 Berchem TOT
54,Posthofbrug 5366,2019-09-20,19:00:00,163,78,85,FMN GV 16 Berchem TOT
54,Posthofbrug 5366,2019-09-20,20:00:00,89,45,44,FMN GV 16 Berchem TOT
54,Posthofbrug 5366,2019-09-20,21:00:00,87,46,41,FMN GV 16 Berchem TOT
54,Posthofbrug 5366,2019-09-20,22:00:00,63,25,38,FMN GV 16 Berchem TOT
54,Posthofbrug 5366,2019-09-20,23:00:00,63,13,50,FMN GV 16 Berchem TOT
54,Posthofbrug 5366,2019-09-21,00:00:00,51,12,39,FMN GV 16 Berchem TOT
54,Posthofbrug 5366,2019-09-21,01:00:00,38,15,23,FMN GV 16 Berchem TOT
54,Posthofbrug 5366,2019-09-21,02:00:00,20,5,15,FMN GV 16 Berchem TOT
54,Posthofbrug 5366,2019-09-21,03:00:00,16,1,15,FMN GV 16 Berchem TOT
54,Posthofbrug 5366,2019-09-21,04:00:00,17,6,11,FMN GV 16 Berchem TOT
54,Posthofbrug 5366,2019-09-21,05:00:00,16,8,8,FMN GV 16 Berchem TOT
54,Posthofbrug 5366,2019-09-21,06:00:00,16,6,10,FMN GV 16 Berchem TOT
54,Posthofbrug 5366,2019-09-21,07:00:00,29,20,9,FMN GV 16 Berchem TOT
54,Posthofbrug 5366,2019-09-21,08:00:00,53,34,19,FMN GV 16 Berchem TOT
54,Posthofbrug 5366,2019-09-21,09:00:00,76,53,23,FMN GV 16 Berchem TOT
54,Posthofbrug 5366,2019-09-21,10:00:00,117,72,45,FMN GV 16 Berchem TOT
54,Posthofbrug 5366,2019-09-21,11:00:00,146,99,47,FMN GV 16 Berchem TOT
54,Posthofbrug 5366,2019-09-21,12:00:00,160,95,65,FMN GV 16 Berchem TOT
54,Posthofbrug 5366,2019-09-21,13:00:00,167,90,77,FMN GV 16 Berchem TOT
54,Posthofbrug 5366,2019-09-21,14:00:00,221,130,91,FMN GV 16 Berchem TOT
54,Posthofbrug 5366,2019-09-21,15:00:00,224,106,118,FMN GV 16 Berchem TOT
54,Posthofbrug 5366,2019-09-21,16:00:00,182,83,99,FMN GV 16 Berchem TOT
54,Posthofbrug 5366,2019-09-21,17:00:00,201,90,111,FMN GV 16 Berchem TOT
54,Posthofbrug 5366,2019-09-21,18:00:00,148,68,80,FMN GV 16 Berchem TOT
54,Posthofbrug 5366,2019-09-21,19:00:00,86,49,37,FMN GV 16 Berchem TOT
54,Posthofbrug 5366,2019-09-21,20:00:00,107,53,54,FMN GV 16 Berchem TOT
54,Posthofbrug 5366,2019-09-21,21:00:00,83,49,34,FMN GV 16 Berchem TOT
54,Posthofbrug 5366,2019-09-21,22:00:00,45,19,26,FMN GV 16 Berchem TOT
54,Posthofbrug 5366,2019-09-21,23:00:00,66,32,34,FMN GV 16 Berchem TOT
54,Posthofbrug 5366,2019-09-22,00:00:00,54,25,29,FMN GV 16 Berchem TOT
54,Posthofbrug 5366,2019-09-22,01:00:00,27,10,17,FMN GV 16 Berchem TOT
54,Posthofbrug 5366,2019-09-22,02:00:00,18,3,15,FMN GV 16 Berchem TOT
54,Posthofbrug 5366,2019-09-22,03:00:00,22,6,16,FMN GV 16 Berchem TOT
54,Posthofbrug 5366,2019-09-22,04:00:00,21,13,8,FMN GV 16 Berchem TOT
54,Posthofbrug 5366,2019-09-22,05:00:00,6,3,3,FMN GV 16 Berchem TOT
54,Posthofbrug 5366,2019-09-22,06:00:00,11,6,5,FMN GV 16 Berchem TOT
54,Posthofbrug 5366,2019-09-22,07:00:00,18,9,9,FMN GV 16 Berchem TOT
54,Posthofbrug 5366,2019-09-22,08:00:00,40,25,15,FMN GV 16 Berchem TOT
54,Posthofbrug 5366,2019-09-22,09:00:00,83,53,30,FMN GV 16 Berchem TOT
54,Posthofbrug 5366,2019-09-22,10:00:00,109,70,39,FMN GV 16 Berchem TOT
54,Posthofbrug 5366,2019-09-22,11:00:00,162,109,53,FMN GV 16 Berchem TOT
54,Posthofbrug 5366,2019-09-22,12:00:00,175,109,66,FMN GV 16 Berchem TOT
54,Posthofbrug 5366,2019-09-22,13:00:00,170,93,77,FMN GV 16 Berchem TOT
54,Posthofbrug 5366,2019-09-22,14:00:00,207,116,91,FMN GV 16 Berchem TOT
54,Posthofbrug 5366,2019-09-22,15:00:00,187,82,105,FMN GV 16 Berchem TOT
54,Posthofbrug 5366,2019-09-22,16:00:00,188,70,118,FMN GV 16 Berchem TOT
54,Posthofbrug 5366,2019-09-22,17:00:00,143,58,85,FMN GV 16 Berchem TOT
54,Posthofbrug 5366,2019-09-22,18:00:00,114,47,67,FMN GV 16 Berchem TOT
54,Posthofbrug 5366,2019-09-22,19:00:00,74,26,48,FMN GV 16 Berchem TOT
54,Posthofbrug 5366,2019-09-22,20:00:00,47,18,29,FMN GV 16 Berchem TOT
54,Posthofbrug 5366,2019-09-22,21:00:00,44,19,25,FMN GV 16 Berchem TOT
54,Posthofbrug 5366,2019-09-22,22:00:00,36,14,22,FMN GV 16 Berchem TOT
54,Posthofbrug 5366,2019-09-22,23:00:00,10,1,9,FMN GV 16 Berchem TOT
54,Posthofbrug 5366,2019-09-23,00:00:00,6,2,4,FMN GV 16 Berchem TOT
54,Posthofbrug 5366,2019-09-23,01:00:00,3,0,3,FMN GV 16 Berchem TOT
54,Posthofbrug 5366,2019-09-23,02:00:00,1,1,0,FMN GV 16 Berchem TOT
54,Posthofbrug 5366,2019-09-23,03:00:00,3,2,1,FMN GV 16 Berchem TOT
54,Posthofbrug 5366,2019-09-23,04:00:00,11,10,1,FMN GV 16 Berchem TOT
54,Posthofbrug 5366,2019-09-23,05:00:00,19,16,3,FMN GV 16 Berchem TOT
54,Posthofbrug 5366,2019-09-23,06:00:00,118,100,18,FMN GV 16 Berchem TOT
54,Posthofbrug 5366,2019-09-23,07:00:00,444,327,117,FMN GV 16 Berchem TOT
54,Posthofbrug 5366,2019-09-23,08:00:00,759,540,219,FMN GV 16 Berchem TOT
54,Posthofbrug 5366,2019-09-23,09:00:00,268,186,82,FMN GV 16 Berchem TOT
54,Posthofbrug 5366,2019-09-23,10:00:00,93,67,26,FMN GV 16 Berchem TOT
54,Posthofbrug 5366,2019-09-23,11:00:00,97,64,33,FMN GV 16 Berchem TOT
54,Posthofbrug 5366,2019-09-23,12:00:00,205,129,76,FMN GV 16 Berchem TOT
54,Posthofbrug 5366,2019-09-23,13:00:00,150,91,59,FMN GV 16 Berchem TOT
54,Posthofbrug 5366,2019-09-23,14:00:00,146,76,70,FMN GV 16 Berchem TOT
54,Posthofbrug 5366,2019-09-23,15:00:00,225,86,139,FMN GV 16 Berchem TOT
54,Posthofbrug 5366,2019-09-23,16:00:00,448,160,288,FMN GV 16 Berchem TOT
54,Posthofbrug 5366,2019-09-23,17:00:00,644,209,435,FMN GV 16 Berchem TOT
54,Posthofbrug 5366,2019-09-23,18:00:00,389,118,271,FMN GV 16 Berchem TOT
54,Posthofbrug 5366,2019-09-23,19:00:00,210,77,133,FMN GV 16 Berchem TOT
54,Posthofbrug 5366,2019-09-23,20:00:00,106,48,58,FMN GV 16 Berchem TOT
54,Posthofbrug 5366,2019-09-23,21:00:00,82,31,51,FMN GV 16 Berchem TOT
54,Posthofbrug 5366,2019-09-23,22:00:00,75,27,48,FMN GV 16 Berchem TOT
54,Posthofbrug 5366,2019-09-23,23:00:00,38,9,29,FMN GV 16 Berchem TOT
54,Posthofbrug 5366,2019-09-24,00:00:00,14,4,10,FMN GV 16 Berchem TOT
54,Posthofbrug 5366,2019-09-24,01:00:00,8,0,8,FMN GV 16 Berchem TOT
54,Posthofbrug 5366,2019-09-24,02:00:00,7,1,6,FMN GV 16 Berchem TOT
54,Posthofbrug 5366,2019-09-24,03:00:00,5,0,5,FMN GV 16 Berchem TOT
54,Posthofbrug 5366,2019-09-24,04:00:00,6,4,2,FMN GV 16 Berchem TOT
54,Posthofbrug 5366,2019-09-24,05:00:00,24,15,9,FMN GV 16 Berchem TOT
54,Posthofbrug 5366,2019-09-24,06:00:00,128,100,28,FMN GV 16 Berchem TOT
54,Posthofbrug 5366,2019-09-24,07:00:00,497,356,141,FMN GV 16 Berchem TOT
54,Posthofbrug 5366,2019-09-24,08:00:00,716,489,227,FMN GV 16 Berchem TOT
54,Posthofbrug 5366,2019-09-24,09:00:00,212,148,64,FMN GV 16 Berchem TOT
54,Posthofbrug 5366,2019-09-24,10:00:00,110,57,53,FMN GV 16 Berchem TOT
54,Posthofbrug 5366,2019-09-24,11:00:00,74,43,31,FMN GV 16 Berchem TOT
54,Posthofbrug 5366,2019-09-24,12:00:00,124,69,55,FMN GV 16 Berchem TOT
54,Posthofbrug 5366,2019-09-24,13:00:00,129,65,64,FMN GV 16 Berchem TOT
54,Posthofbrug 5366,2019-09-24,14:00:00,93,37,56,FMN GV 16 Berchem TOT
54,Posthofbrug 5366,2019-09-24,15:00:00,164,77,87,FMN GV 16 Berchem TOT
54,Posthofbrug 5366,2019-09-24,16:00:00,331,146,185,FMN GV 16 Berchem TOT
54,Posthofbrug 5366,2019-09-24,17:00:00,478,163,315,FMN GV 16 Berchem TOT
54,Posthofbrug 5366,2019-09-24,18:00:00,291,88,203,FMN GV 16 Berchem TOT
54,Posthofbrug 5366,2019-09-24,19:00:00,157,56,101,FMN GV 16 Berchem TOT
54,Posthofbrug 5366,2019-09-24,20:00:00,73,32,41,FMN GV 16 Berchem TOT
54,Posthofbrug 5366,2019-09-24,21:00:00,65,35,30,FMN GV 16 Berchem TOT
54,Posthofbrug 5366,2019-09-24,22:00:00,70,30,40,FMN GV 16 Berchem TOT
54,Posthofbrug 5366,2019-09-24,23:00:00,30,12,18,FMN GV 16 Berchem TOT
54,Posthofbrug 5366,2019-09-25,00:00:00,17,5,12,FMN GV 16 Berchem TOT
54,Posthofbrug 5366,2019-09-25,01:00:00,8,1,7,FMN GV 16 Berchem TOT
54,Posthofbrug 5366,2019-09-25,02:00:00,6,0,6,FMN GV 16 Berchem TOT
54,Posthofbrug 5366,2019-09-25,03:00:00,0,0,0,FMN GV 16 Berchem TOT
54,Posthofbrug 5366,2019-09-25,04:00:00,4,3,1,FMN GV 16 Berchem TOT
54,Posthofbrug 5366,2019-09-25,05:00:00,20,15,5,FMN GV 16 Berchem TOT
54,Posthofbrug 5366,2019-09-25,06:00:00,94,78,16,FMN GV 16 Berchem TOT
54,Posthofbrug 5366,2019-09-25,07:00:00,340,239,101,FMN GV 16 Berchem TOT
54,Posthofbrug 5366,2019-09-25,08:00:00,545,376,169,FMN GV 16 Berchem TOT
54,Posthofbrug 5366,2019-09-25,09:00:00,192,131,61,FMN GV 16 Berchem TOT
54,Posthofbrug 5366,2019-09-25,10:00:00,100,66,34,FMN GV 16 Berchem TOT
54,Posthofbrug 5366,2019-09-25,11:00:00,94,48,46,FMN GV 16 Berchem TOT
54,Posthofbrug 5366,2019-09-25,12:00:00,198,108,90,FMN GV 16 Berchem TOT
54,Posthofbrug 5366,2019-09-25,13:00:00,164,73,91,FMN GV 16 Berchem TOT
54,Posthofbrug 5366,2019-09-25,14:00:00,126,54,72,FMN GV 16 Berchem TOT
54,Posthofbrug 5366,2019-09-25,15:00:00,140,49,91,FMN GV 16 Berchem TOT
54,Posthofbrug 5366,2019-09-25,16:00:00,314,144,170,FMN GV 16 Berchem TOT
54,Posthofbrug 5366,2019-09-25,17:00:00,435,182,253,FMN GV 16 Berchem TOT
54,Posthofbrug 5366,2019-09-25,18:00:00,278,93,185,FMN GV 16 Berchem TOT
54,Posthofbrug 5366,2019-09-25,19:00:00,130,46,84,FMN GV 16 Berchem TOT
54,Posthofbrug 5366,2019-09-25,20:00:00,76,48,28,FMN GV 16 Berchem TOT
54,Posthofbrug 5366,2019-09-25,21:00:00,56,23,33,FMN GV 16 Berchem TOT
54,Posthofbrug 5366,2019-09-25,22:00:00,60,10,50,FMN GV 16 Berchem TOT
54,Posthofbrug 5366,2019-09-25,23:00:00,39,7,32,FMN GV 16 Berchem TOT
54,Posthofbrug 5366,2019-09-26,00:00:00,18,7,11,FMN GV 16 Berchem TOT
54,Posthofbrug 5366,2019-09-26,01:00:00,9,0,9,FMN GV 16 Berchem TOT
54,Posthofbrug 5366,2019-09-26,02:00:00,2,0,2,FMN GV 16 Berchem TOT
54,Posthofbrug 5366,2019-09-26,03:00:00,3,0,3,FMN GV 16 Berchem TOT
54,Posthofbrug 5366,2019-09-26,04:00:00,7,5,2,FMN GV 16 Berchem TOT
54,Posthofbrug 5366,2019-09-26,05:00:00,22,11,11,FMN GV 16 Berchem TOT
54,Posthofbrug 5366,2019-09-26,06:00:00,98,76,22,FMN GV 16 Berchem TOT
54,Posthofbrug 5366,2019-09-26,07:00:00,358,267,91,FMN GV 16 Berchem TOT
54,Posthofbrug 5366,2019-09-26,08:00:00,6,4,2,FMN GV 16 Berchem TOT
54,Posthofbrug 5366,2019-09-26,09:00:00,0,0,0,FMN GV 16 Berchem TOT
54,Posthofbrug 5366,2019-09-26,10:00:00,8,6,2,FMN GV 16 Berchem TOT
54,Posthofbrug 5366,2019-09-26,11:00:00,47,35,12,FMN GV 16 Berchem TOT
54,Posthofbrug 5366,2019-09-26,12:00:00,127,74,53,FMN GV 16 Berchem TOT
54,Posthofbrug 5366,2019-09-26,13:00:00,114,54,60,FMN GV 16 Berchem TOT
54,Posthofbrug 5366,2019-09-26,14:00:00,76,41,35,FMN GV 16 Berchem TOT
54,Posthofbrug 5366,2019-09-26,15:00:00,177,82,95,FMN GV 16 Berchem TOT
54,Posthofbrug 5366,2019-09-26,16:00:00,351,131,220,FMN GV 16 Berchem TOT
54,Posthofbrug 5366,2019-09-26,17:00:00,441,173,268,FMN GV 16 Berchem TOT
54,Posthofbrug 5366,2019-09-26,18:00:00,263,89,174,FMN GV 16 Berchem TOT
54,Posthofbrug 5366,2019-09-26,19:00:00,144,56,88,FMN GV 16 Berchem TOT
54,Posthofbrug 5366,2019-09-26,20:00:00,79,26,53,FMN GV 16 Berchem TOT
54,Posthofbrug 5366,2019-09-26,21:00:00,63,22,41,FMN GV 16 Berchem TOT
54,Posthofbrug 5366,2019-09-26,22:00:00,83,27,56,FMN GV 16 Berchem TOT
54,Posthofbrug 5366,2019-09-26,23:00:00,47,19,28,FMN GV 16 Berchem TOT
54,Posthofbrug 5366,2019-09-27,00:00:00,29,5,24,FMN GV 16 Berchem TOT
54,Posthofbrug 5366,2019-09-27,01:00:00,12,0,12,FMN GV 16 Berchem TOT
54,Posthofbrug 5366,2019-09-27,02:00:00,8,0,8,FMN GV 16 Berchem TOT
54,Posthofbrug 5366,2019-09-27,03:00:00,10,1,9,FMN GV 16 Berchem TOT
54,Posthofbrug 5366,2019-09-27,04:00:00,12,8,4,FMN GV 16 Berchem TOT
54,Posthofbrug 5366,2019-09-27,05:00:00,22,12,10,FMN GV 16 Berchem TOT
54,Posthofbrug 5366,2019-09-27,06:00:00,86,73,13,FMN GV 16 Berchem TOT
54,Posthofbrug 5366,2019-09-27,07:00:00,337,242,95,FMN GV 16 Berchem TOT
54,Posthofbrug 5366,2019-09-27,08:00:00,561,380,181,FMN GV 16 Berchem TOT
54,Posthofbrug 5366,2019-09-27,09:00:00,234,176,58,FMN GV 16 Berchem TOT
54,Posthofbrug 5366,2019-09-27,10:00:00,134,77,57,FMN GV 16 Berchem TOT
54,Posthofbrug 5366,2019-09-27,11:00:00,104,65,39,FMN GV 16 Berchem TOT
54,Posthofbrug 5366,2019-09-27,12:00:00,159,76,83,FMN GV 16 Berchem TOT
54,Posthofbrug 5366,2019-09-27,13:00:00,162,83,79,FMN GV 16 Berchem TOT
54,Posthofbrug 5366,2019-09-27,14:00:00,176,69,107,FMN GV 16 Berchem TOT
54,Posthofbrug 5366,2019-09-27,15:00:00,230,83,147,FMN GV 16 Berchem TOT
54,Posthofbrug 5366,2019-09-27,16:00:00,383,149,234,FMN GV 16 Berchem TOT
54,Posthofbrug 5366,2019-09-27,17:00:00,381,136,245,FMN GV 16 Berchem TOT
54,Posthofbrug 5366,2019-09-27,18:00:00,260,107,153,FMN GV 16 Berchem TOT
54,Posthofbrug 5366,2019-09-27,19:00:00,146,67,79,FMN GV 16 Berchem TOT
54,Posthofbrug 5366,2019-09-27,20:00:00,90,42,48,FMN GV 16 Berchem TOT
54,Posthofbrug 5366,2019-09-27,21:00:00,69,40,29,FMN GV 16 Berchem TOT
54,Posthofbrug 5366,2019-09-27,22:00:00,62,24,38,FMN GV 16 Berchem TOT
54,Posthofbrug 5366,2019-09-27,23:00:00,56,12,44,FMN GV 16 Berchem TOT
54,Posthofbrug 5366,2019-09-28,00:00:00,48,11,37,FMN GV 16 Berchem TOT
54,Posthofbrug 5366,2019-09-28,01:00:00,26,5,21,FMN GV 16 Berchem TOT
54,Posthofbrug 5366,2019-09-28,02:00:00,20,3,17,FMN GV 16 Berchem TOT
54,Posthofbrug 5366,2019-09-28,03:00:00,25,9,16,FMN GV 16 Berchem TOT
54,Posthofbrug 5366,2019-09-28,04:00:00,23,8,15,FMN GV 16 Berchem TOT
54,Posthofbrug 5366,2019-09-28,05:00:00,11,5,6,FMN GV 16 Berchem TOT
54,Posthofbrug 5366,2019-09-28,06:00:00,13,11,2,FMN GV 16 Berchem TOT
54,Posthofbrug 5366,2019-09-28,07:00:00,22,13,9,FMN GV 16 Berchem TOT
54,Posthofbrug 5366,2019-09-28,08:00:00,52,34,18,FMN GV 16 Berchem TOT
54,Posthofbrug 5366,2019-09-28,09:00:00,80,57,23,FMN GV 16 Berchem TOT
54,Posthofbrug 5366,2019-09-28,10:00:00,78,51,27,FMN GV 16 Berchem TOT
54,Posthofbrug 5366,2019-09-28,11:00:00,86,55,31,FMN GV 16 Berchem TOT
54,Posthofbrug 5366,2019-09-28,12:00:00,78,43,35,FMN GV 16 Berchem TOT
54,Posthofbrug 5366,2019-09-28,13:00:00,90,50,40,FMN GV 16 Berchem TOT
54,Posthofbrug 5366,2019-09-28,14:00:00,74,36,38,FMN GV 16 Berchem TOT
54,Posthofbrug 5366,2019-09-28,15:00:00,104,55,49,FMN GV 16 Berchem TOT
54,Posthofbrug 5366,2019-09-28,16:00:00,85,30,55,FMN GV 16 Berchem TOT
54,Posthofbrug 5366,2019-09-28,17:00:00,113,49,64,FMN GV 16 Berchem TOT
54,Posthofbrug 5366,2019-09-28,18:00:00,118,61,57,FMN GV 16 Berchem TOT
54,Posthofbrug 5366,2019-09-28,19:00:00,84,38,46,FMN GV 16 Berchem TOT
54,Posthofbrug 5366,2019-09-28,20:00:00,71,41,30,FMN GV 16 Berchem TOT
54,Posthofbrug 5366,2019-09-28,21:00:00,50,25,25,FMN GV 16 Berchem TOT
54,Posthofbrug 5366,2019-09-28,22:00:00,45,21,24,FMN GV 16 Berchem TOT
54,Posthofbrug 5366,2019-09-28,23:00:00,65,24,41,FMN GV 16 Berchem TOT
54,Posthofbrug 5366,2019-09-29,00:00:00,31,10,21,FMN GV 16 Berchem TOT
54,Posthofbrug 5366,2019-09-29,01:00:00,38,5,33,FMN GV 16 Berchem TOT
54,Posthofbrug 5366,2019-09-29,02:00:00,49,16,33,FMN GV 16 Berchem TOT
54,Posthofbrug 5366,2019-09-29,03:00:00,21,5,16,FMN GV 16 Berchem TOT
54,Posthofbrug 5366,2019-09-29,04:00:00,18,3,15,FMN GV 16 Berchem TOT
54,Posthofbrug 5366,2019-09-29,05:00:00,10,6,4,FMN GV 16 Berchem TOT
54,Posthofbrug 5366,2019-09-29,06:00:00,17,15,2,FMN GV 16 Berchem TOT
54,Posthofbrug 5366,2019-09-29,07:00:00,9,8,1,FMN GV 16 Berchem TOT
54,Posthofbrug 5366,2019-09-29,08:00:00,24,14,10,FMN GV 16 Berchem TOT
54,Posthofbrug 5366,2019-09-29,09:00:00,34,26,8,FMN GV 16 Berchem TOT
54,Posthofbrug 5366,2019-09-29,10:00:00,56,38,18,FMN GV 16 Berchem TOT
54,Posthofbrug 5366,2019-09-29,11:00:00,51,27,24,FMN GV 16 Berchem TOT
54,Posthofbrug 5366,2019-09-29,12:00:00,57,36,21,FMN GV 16 Berchem TOT
54,Posthofbrug 5366,2019-09-29,13:00:00,61,36,25,FMN GV 16 Berchem TOT
54,Posthofbrug 5366,2019-09-29,14:00:00,58,27,31,FMN GV 16 Berchem TOT
54,Posthofbrug 5366,2019-09-29,15:00:00,53,16,37,FMN GV 16 Berchem TOT
54,Posthofbrug 5366,2019-09-29,16:00:00,35,13,22,FMN GV 16 Berchem TOT
54,Posthofbrug 5366,2019-09-29,17:00:00,70,23,47,FMN GV 16 Berchem TOT
54,Posthofbrug 5366,2019-09-29,18:00:00,41,22,19,FMN GV 16 Berchem TOT
54,Posthofbrug 5366,2019-09-29,19:00:00,51,26,25,FMN GV 16 Berchem TOT
54,Posthofbrug 5366,2019-09-29,20:00:00,37,17,20,FMN GV 16 Berchem TOT
54,Posthofbrug 5366,2019-09-29,21:00:00,23,11,12,FMN GV 16 Berchem TOT
54,Posthofbrug 5366,2019-09-29,22:00:00,29,16,13,FMN GV 16 Berchem TOT
54,Posthofbrug 5366,2019-09-29,23:00:00,18,3,15,FMN GV 16 Berchem TOT
54,Posthofbrug 5366,2019-09-30,00:00:00,8,5,3,FMN GV 16 Berchem TOT
54,Posthofbrug 5366,2019-09-30,01:00:00,3,0,3,FMN GV 16 Berchem TOT
54,Posthofbrug 5366,2019-09-30,02:00:00,2,1,1,FMN GV 16 Berchem TOT
54,Posthofbrug 5366,2019-09-30,03:00:00,4,2,2,FMN GV 16 Berchem TOT
54,Posthofbrug 5366,2019-09-30,04:00:00,6,5,1,FMN GV 16 Berchem TOT
54,Posthofbrug 5366,2019-09-30,05:00:00,28,25,3,FMN GV 16 Berchem TOT
54,Posthofbrug 5366,2019-09-30,06:00:00,101,79,22,FMN GV 16 Berchem TOT
54,Posthofbrug 5366,2019-09-30,07:00:00,402,294,108,FMN GV 16 Berchem TOT
54,Posthofbrug 5366,2019-09-30,08:00:00,690,476,214,FMN GV 16 Berchem TOT
54,Posthofbrug 5366,2019-09-30,09:00:00,231,159,72,FMN GV 16 Berchem TOT
54,Posthofbrug 5366,2019-09-30,10:00:00,109,84,25,FMN GV 16 Berchem TOT
54,Posthofbrug 5366,2019-09-30,11:00:00,98,59,39,FMN GV 16 Berchem TOT
54,Posthofbrug 5366,2019-09-30,12:00:00,150,85,65,FMN GV 16 Berchem TOT
54,Posthofbrug 5366,2019-09-30,13:00:00,145,70,75,FMN GV 16 Berchem TOT
54,Posthofbrug 5366,2019-09-30,14:00:00,127,51,76,FMN GV 16 Berchem TOT
54,Posthofbrug 5366,2019-09-30,15:00:00,235,115,120,FMN GV 16 Berchem TOT
54,Posthofbrug 5366,2019-09-30,16:00:00,454,172,282,FMN GV 16 Berchem TOT
54,Posthofbrug 5366,2019-09-30,17:00:00,592,216,376,FMN GV 16 Berchem TOT
54,Posthofbrug 5366,2019-09-30,18:00:00,370,119,251,FMN GV 16 Berchem TOT
54,Posthofbrug 5366,2019-09-30,19:00:00,189,77,112,FMN GV 16 Berchem TOT
54,Posthofbrug 5366,2019-09-30,20:00:00,83,44,39,FMN GV 16 Berchem TOT
54,Posthofbrug 5366,2019-09-30,21:00:00,85,36,49,FMN GV 16 Berchem TOT
54,Posthofbrug 5366,2019-09-30,22:00:00,63,23,40,FMN GV 16 Berchem TOT
54,Posthofbrug 5366,2019-09-30,23:00:00,28,7,21,FMN GV 16 Berchem TOT
54,Posthofbrug 5366,2019-10-01,00:00:00,12,2,10,FMN GV 16 Berchem TOT
54,Posthofbrug 5366,2019-10-01,01:00:00,3,0,3,FMN GV 16 Berchem TOT
54,Posthofbrug 5366,2019-10-01,02:00:00,5,0,5,FMN GV 16 Berchem TOT
54,Posthofbrug 5366,2019-10-01,03:00:00,5,2,3,FMN GV 16 Berchem TOT
54,Posthofbrug 5366,2019-10-01,04:00:00,8,7,1,FMN GV 16 Berchem TOT
54,Posthofbrug 5366,2019-10-01,05:00:00,26,19,7,FMN GV 16 Berchem TOT
54,Posthofbrug 5366,2019-10-01,06:00:00,91,74,17,FMN GV 16 Berchem TOT
54,Posthofbrug 5366,2019-10-01,07:00:00,372,290,82,FMN GV 16 Berchem TOT
54,Posthofbrug 5366,2019-10-01,08:00:00,461,325,136,FMN GV 16 Berchem TOT
54,Posthofbrug 5366,2019-10-01,09:00:00,178,126,52,FMN GV 16 Berchem TOT
54,Posthofbrug 5366,2019-10-01,10:00:00,78,54,24,FMN GV 16 Berchem TOT
54,Posthofbrug 5366,2019-10-01,11:00:00,66,42,24,FMN GV 16 Berchem TOT
54,Posthofbrug 5366,2019-10-01,12:00:00,89,51,38,FMN GV 16 Berchem TOT
54,Posthofbrug 5366,2019-10-01,13:00:00,115,57,58,FMN GV 16 Berchem TOT
54,Posthofbrug 5366,2019-10-01,14:00:00,78,36,42,FMN GV 16 Berchem TOT
54,Posthofbrug 5366,2019-10-01,15:00:00,154,50,104,FMN GV 16 Berchem TOT
54,Posthofbrug 5366,2019-10-01,16:00:00,320,123,197,FMN GV 16 Berchem TOT
54,Posthofbrug 5366,2019-10-01,17:00:00,424,154,270,FMN GV 16 Berchem TOT
54,Posthofbrug 5366,2019-10-01,18:00:00,287,101,186,FMN GV 16 Berchem TOT
54,Posthofbrug 5366,2019-10-01,19:00:00,143,52,91,FMN GV 16 Berchem TOT
54,Posthofbrug 5366,2019-10-01,20:00:00,68,30,38,FMN GV 16 Berchem TOT
54,Posthofbrug 5366,2019-10-01,21:00:00,69,31,38,FMN GV 16 Berchem TOT
54,Posthofbrug 5366,2019-10-01,22:00:00,59,21,38,FMN GV 16 Berchem TOT
54,Posthofbrug 5366,2019-10-01,23:00:00,49,21,28,FMN GV 16 Berchem TOT
54,Posthofbrug 5366,2019-10-02,00:00:00,18,4,14,FMN GV 16 Berchem TOT
54,Posthofbrug 5366,2019-10-02,01:00:00,7,0,7,FMN GV 16 Berchem TOT
54,Posthofbrug 5366,2019-10-02,02:00:00,4,2,2,FMN GV 16 Berchem TOT
54,Posthofbrug 5366,2019-10-02,03:00:00,2,1,1,FMN GV 16 Berchem TOT
54,Posthofbrug 5366,2019-10-02,04:00:00,6,6,0,FMN GV 16 Berchem TOT
54,Posthofbrug 5366,2019-10-02,05:00:00,22,14,8,FMN GV 16 Berchem TOT
54,Posthofbrug 5366,2019-10-02,06:00:00,129,106,23,FMN GV 16 Berchem TOT
54,Posthofbrug 5366,2019-10-02,07:00:00,436,310,126,FMN GV 16 Berchem TOT
54,Posthofbrug 5366,2019-10-02,08:00:00,615,418,197,FMN GV 16 Berchem TOT
54,Posthofbrug 5366,2019-10-02,09:00:00,221,152,69,FMN GV 16 Berchem TOT
54,Posthofbrug 5366,2019-10-02,10:00:00,127,85,42,FMN GV 16 Berchem TOT
54,Posthofbrug 5366,2019-10-02,11:00:00,134,78,56,FMN GV 16 Berchem TOT
54,Posthofbrug 5366,2019-10-02,12:00:00,248,126,122,FMN GV 16 Berchem TOT
54,Posthofbrug 5366,2019-10-02,13:00:00,189,87,102,FMN GV 16 Berchem TOT
54,Posthofbrug 5366,2019-10-02,14:00:00,127,54,73,FMN GV 16 Berchem TOT
54,Posthofbrug 5366,2019-10-02,15:00:00,123,56,67,FMN GV 16 Berchem TOT
54,Posthofbrug 5366,2019-10-02,16:00:00,290,139,151,FMN GV 16 Berchem TOT
54,Posthofbrug 5366,2019-10-02,17:00:00,470,209,261,FMN GV 16 Berchem TOT
54,Posthofbrug 5366,2019-10-02,18:00:00,327,118,209,FMN GV 16 Berchem TOT
54,Posthofbrug 5366,2019-10-02,19:00:00,168,64,104,FMN GV 16 Berchem TOT
54,Posthofbrug 5366,2019-10-02,20:00:00,111,50,61,FMN GV 16 Berchem TOT
54,Posthofbrug 5366,2019-10-02,21:00:00,70,25,45,FMN GV 16 Berchem TOT
54,Posthofbrug 5366,2019-10-02,22:00:00,74,29,45,FMN GV 16 Berchem TOT
54,Posthofbrug 5366,2019-10-02,23:00:00,42,22,20,FMN GV 16 Berchem TOT
54,Posthofbrug 5366,2019-10-03,00:00:00,16,6,10,FMN GV 16 Berchem TOT
54,Posthofbrug 5366,2019-10-03,01:00:00,2,0,2,FMN GV 16 Berchem TOT
54,Posthofbrug 5366,2019-10-03,02:00:00,5,0,5,FMN GV 16 Berchem TOT
54,Posthofbrug 5366,2019-10-03,03:00:00,2,1,1,FMN GV 16 Berchem TOT
54,Posthofbrug 5366,2019-10-03,04:00:00,8,8,0,FMN GV 16 Berchem TOT
54,Posthofbrug 5366,2019-10-03,05:00:00,23,15,8,FMN GV 16 Berchem TOT
54,Posthofbrug 5366,2019-10-03,06:00:00,96,80,16,FMN GV 16 Berchem TOT
54,Posthofbrug 5366,2019-10-03,07:00:00,428,324,104,FMN GV 16 Berchem TOT
54,Posthofbrug 5366,2019-10-03,08:00:00,681,463,218,FMN GV 16 Berchem TOT
54,Posthofbrug 5366,2019-10-03,09:00:00,252,167,85,FMN GV 16 Berchem TOT
54,Posthofbrug 5366,2019-10-03,10:00:00,106,68,38,FMN GV 16 Berchem TOT
54,Posthofbrug 5366,2019-10-03,11:00:00,75,45,30,FMN GV 16 Berchem TOT
54,Posthofbrug 5366,2019-10-03,12:00:00,134,80,54,FMN GV 16 Berchem TOT
54,Posthofbrug 5366,2019-10-03,13:00:00,125,77,48,FMN GV 16 Berchem TOT
54,Posthofbrug 5366,2019-10-03,14:00:00,89,36,53,FMN GV 16 Berchem TOT
54,Posthofbrug 5366,2019-10-03,15:00:00,192,80,112,FMN GV 16 Berchem TOT
54,Posthofbrug 5366,2019-10-03,16:00:00,392,153,239,FMN GV 16 Berchem TOT
54,Posthofbrug 5366,2019-10-03,17:00:00,518,195,323,FMN GV 16 Berchem TOT
54,Posthofbrug 5366,2019-10-03,18:00:00,320,97,223,FMN GV 16 Berchem TOT
54,Posthofbrug 5366,2019-10-03,19:00:00,152,58,94,FMN GV 16 Berchem TOT
54,Posthofbrug 5366,2019-10-03,20:00:00,84,36,48,FMN GV 16 Berchem TOT
54,Posthofbrug 5366,2019-10-03,21:00:00,82,39,43,FMN GV 16 Berchem TOT
54,Posthofbrug 5366,2019-10-03,22:00:00,87,27,60,FMN GV 16 Berchem TOT
54,Posthofbrug 5366,2019-10-03,23:00:00,42,13,29,FMN GV 16 Berchem TOT
54,Posthofbrug 5366,2019-10-04,00:00:00,22,2,20,FMN GV 16 Berchem TOT
54,Posthofbrug 5366,2019-10-04,01:00:00,16,4,12,FMN GV 16 Berchem TOT
54,Posthofbrug 5366,2019-10-04,02:00:00,10,1,9,FMN GV 16 Berchem TOT
54,Posthofbrug 5366,2019-10-04,03:00:00,3,0,3,FMN GV 16 Berchem TOT
54,Posthofbrug 5366,2019-10-04,04:00:00,8,7,1,FMN GV 16 Berchem TOT
54,Posthofbrug 5366,2019-10-04,05:00:00,17,13,4,FMN GV 16 Berchem TOT
54,Posthofbrug 5366,2019-10-04,06:00:00,69,59,10,FMN GV 16 Berchem TOT
54,Posthofbrug 5366,2019-10-04,07:00:00,290,220,70,FMN GV 16 Berchem TOT
54,Posthofbrug 5366,2019-10-04,08:00:00,503,355,148,FMN GV 16 Berchem TOT
54,Posthofbrug 5366,2019-10-04,09:00:00,173,106,67,FMN GV 16 Berchem TOT
54,Posthofbrug 5366,2019-10-04,10:00:00,112,73,39,FMN GV 16 Berchem TOT
54,Posthofbrug 5366,2019-10-04,11:00:00,80,49,31,FMN GV 16 Berchem TOT
54,Posthofbrug 5366,2019-10-04,12:00:00,139,79,60,FMN GV 16 Berchem TOT
54,Posthofbrug 5366,2019-10-04,13:00:00,113,41,72,FMN GV 16 Berchem TOT
54,Posthofbrug 5366,2019-10-04,14:00:00,84,32,52,FMN GV 16 Berchem TOT
54,Posthofbrug 5366,2019-10-04,15:00:00,184,70,114,FMN GV 16 Berchem TOT
54,Posthofbrug 5366,2019-10-04,16:00:00,266,125,141,FMN GV 16 Berchem TOT
54,Posthofbrug 5366,2019-10-04,17:00:00,333,144,189,FMN GV 16 Berchem TOT
54,Posthofbrug 5366,2019-10-04,18:00:00,197,75,122,FMN GV 16 Berchem TOT
54,Posthofbrug 5366,2019-10-04,19:00:00,97,43,54,FMN GV 16 Berchem TOT
54,Posthofbrug 5366,2019-10-04,20:00:00,88,58,30,FMN GV 16 Berchem TOT
54,Posthofbrug 5366,2019-10-04,21:00:00,45,19,26,FMN GV 16 Berchem TOT
54,Posthofbrug 5366,2019-10-04,22:00:00,51,10,41,FMN GV 16 Berchem TOT
54,Posthofbrug 5366,2019-10-04,23:00:00,42,17,25,FMN GV 16 Berchem TOT
54,Posthofbrug 5366,2019-10-05,00:00:00,38,11,27,FMN GV 16 Berchem TOT
54,Posthofbrug 5366,2019-10-05,01:00:00,24,8,16,FMN GV 16 Berchem TOT
54,Posthofbrug 5366,2019-10-05,02:00:00,8,3,5,FMN GV 16 Berchem TOT
54,Posthofbrug 5366,2019-10-05,03:00:00,19,6,13,FMN GV 16 Berchem TOT
54,Posthofbrug 5366,2019-10-05,04:00:00,15,7,8,FMN GV 16 Berchem TOT
54,Posthofbrug 5366,2019-10-05,05:00:00,17,7,10,FMN GV 16 Berchem TOT
54,Posthofbrug 5366,2019-10-05,06:00:00,21,12,9,FMN GV 16 Berchem TOT
54,Posthofbrug 5366,2019-10-05,07:00:00,21,14,7,FMN GV 16 Berchem TOT
54,Posthofbrug 5366,2019-10-05,08:00:00,47,29,18,FMN GV 16 Berchem TOT
54,Posthofbrug 5366,2019-10-05,09:00:00,82,51,31,FMN GV 16 Berchem TOT
54,Posthofbrug 5366,2019-10-05,10:00:00,105,69,36,FMN GV 16 Berchem TOT
54,Posthofbrug 5366,2019-10-05,11:00:00,112,80,32,FMN GV 16 Berchem TOT
54,Posthofbrug 5366,2019-10-05,12:00:00,115,72,43,FMN GV 16 Berchem TOT
54,Posthofbrug 5366,2019-10-05,13:00:00,123,73,50,FMN GV 16 Berchem TOT
54,Posthofbrug 5366,2019-10-05,14:00:00,184,112,72,FMN GV 16 Berchem TOT
54,Posthofbrug 5366,2019-10-05,15:00:00,139,62,77,FMN GV 16 Berchem TOT
54,Posthofbrug 5366,2019-10-05,16:00:00,127,51,76,FMN GV 16 Berchem TOT
54,Posthofbrug 5366,2019-10-05,17:00:00,168,87,81,FMN GV 16 Berchem TOT
54,Posthofbrug 5366,2019-10-05,18:00:00,95,33,62,FMN GV 16 Berchem TOT
54,Posthofbrug 5366,2019-10-05,19:00:00,93,53,40,FMN GV 16 Berchem TOT
54,Posthofbrug 5366,2019-10-05,20:00:00,69,33,36,FMN GV 16 Berchem TOT
54,Posthofbrug 5366,2019-10-05,21:00:00,66,27,39,FMN GV 16 Berchem TOT
54,Posthofbrug 5366,2019-10-05,22:00:00,29,12,17,FMN GV 16 Berchem TOT
54,Posthofbrug 5366,2019-10-05,23:00:00,46,16,30,FMN GV 16 Berchem TOT
54,Posthofbrug 5366,2019-10-06,00:00:00,43,15,28,FMN GV 16 Berchem TOT
54,Posthofbrug 5366,2019-10-06,01:00:00,34,12,22,FMN GV 16 Berchem TOT
54,Posthofbrug 5366,2019-10-06,02:00:00,20,9,11,FMN GV 16 Berchem TOT
54,Posthofbrug 5366,2019-10-06,03:00:00,15,4,11,FMN GV 16 Berchem TOT
54,Posthofbrug 5366,2019-10-06,04:00:00,10,2,8,FMN GV 16 Berchem TOT
54,Posthofbrug 5366,2019-10-06,05:00:00,7,3,4,FMN GV 16 Berchem TOT
54,Posthofbrug 5366,2019-10-06,06:00:00,10,8,2,FMN GV 16 Berchem TOT
54,Posthofbrug 5366,2019-10-06,07:00:00,10,6,4,FMN GV 16 Berchem TOT
54,Posthofbrug 5366,2019-10-06,08:00:00,19,10,9,FMN GV 16 Berchem TOT
54,Posthofbrug 5366,2019-10-06,09:00:00,47,28,19,FMN GV 16 Berchem TOT
54,Posthofbrug 5366,2019-10-06,10:00:00,47,27,20,FMN GV 16 Berchem TOT
54,Posthofbrug 5366,2019-10-06,11:00:00,31,15,16,FMN GV 16 Berchem TOT
54,Posthofbrug 5366,2019-10-06,12:00:00,66,33,33,FMN GV 16 Berchem TOT
54,Posthofbrug 5366,2019-10-06,13:00:00,51,29,22,FMN GV 16 Berchem TOT
54,Posthofbrug 5366,2019-10-06,14:00:00,48,25,23,FMN GV 16 Berchem TOT
54,Posthofbrug 5366,2019-10-06,15:00:00,42,22,20,FMN GV 16 Berchem TOT
54,Posthofbrug 5366,2019-10-06,16:00:00,38,20,18,FMN GV 16 Berchem TOT
54,Posthofbrug 5366,2019-10-06,17:00:00,55,30,25,FMN GV 16 Berchem TOT
54,Posthofbrug 5366,2019-10-06,18:00:00,37,17,20,FMN GV 16 Berchem TOT
54,Posthofbrug 5366,2019-10-06,19:00:00,39,15,24,FMN GV 16 Berchem TOT
54,Posthofbrug 5366,2019-10-06,20:00:00,36,12,24,FMN GV 16 Berchem TOT
54,Posthofbrug 5366,2019-10-06,21:00:00,25,11,14,FMN GV 16 Berchem TOT
54,Posthofbrug 5366,2019-10-06,22:00:00,24,6,18,FMN GV 16 Berchem TOT
54,Posthofbrug 5366,2019-10-06,23:00:00,19,3,16,FMN GV 16 Berchem TOT
54,Posthofbrug 5366,2019-10-07,00:00:00,6,0,6,FMN GV 16 Berchem TOT
54,Posthofbrug 5366,2019-10-07,01:00:00,4,0,4,FMN GV 16 Berchem TOT
54,Posthofbrug 5366,2019-10-07,02:00:00,2,1,1,FMN GV 16 Berchem TOT
54,Posthofbrug 5366,2019-10-07,03:00:00,4,2,2,FMN GV 16 Berchem TOT
54,Posthofbrug 5366,2019-10-07,04:00:00,8,7,1,FMN GV 16 Berchem TOT
54,Posthofbrug 5366,2019-10-07,05:00:00,17,11,6,FMN GV 16 Berchem TOT
54,Posthofbrug 5366,2019-10-07,06:00:00,116,99,17,FMN GV 16 Berchem TOT
54,Posthofbrug 5366,2019-10-07,07:00:00,396,301,95,FMN GV 16 Berchem TOT
54,Posthofbrug 5366,2019-10-07,08:00:00,740,489,251,FMN GV 16 Berchem TOT
54,Posthofbrug 5366,2019-10-07,09:00:00,233,168,65,FMN GV 16 Berchem TOT
54,Posthofbrug 5366,2019-10-07,10:00:00,114,81,33,FMN GV 16 Berchem TOT
54,Posthofbrug 5366,2019-10-07,11:00:00,99,71,28,FMN GV 16 Berchem TOT
54,Posthofbrug 5366,2019-10-07,12:00:00,140,86,54,FMN GV 16 Berchem TOT
54,Posthofbrug 5366,2019-10-07,13:00:00,140,67,73,FMN GV 16 Berchem TOT
54,Posthofbrug 5366,2019-10-07,14:00:00,103,38,65,FMN GV 16 Berchem TOT
54,Posthofbrug 5366,2019-10-07,15:00:00,191,85,106,FMN GV 16 Berchem TOT
54,Posthofbrug 5366,2019-10-07,16:00:00,423,171,252,FMN GV 16 Berchem TOT
54,Posthofbrug 5366,2019-10-07,17:00:00,543,175,368,FMN GV 16 Berchem TOT
54,Posthofbrug 5366,2019-10-07,18:00:00,365,125,240,FMN GV 16 Berchem TOT
54,Posthofbrug 5366,2019-10-07,19:00:00,162,59,103,FMN GV 16 Berchem TOT
54,Posthofbrug 5366,2019-10-07,20:00:00,82,40,42,FMN GV 16 Berchem TOT
54,Posthofbrug 5366,2019-10-07,21:00:00,68,31,37,FMN GV 16 Berchem TOT
54,Posthofbrug 5366,2019-10-07,22:00:00,75,29,46,FMN GV 16 Berchem TOT
54,Posthofbrug 5366,2019-10-07,23:00:00,26,8,18,FMN GV 16 Berchem TOT
54,Posthofbrug 5366,2019-10-08,00:00:00,20,5,15,FMN GV 16 Berchem TOT
54,Posthofbrug 5366,2019-10-08,01:00:00,8,1,7,FMN GV 16 Berchem TOT
54,Posthofbrug 5366,2019-10-08,02:00:00,1,1,0,FMN GV 16 Berchem TOT
54,Posthofbrug 5366,2019-10-08,03:00:00,1,1,0,FMN GV 16 Berchem TOT
54,Posthofbrug 5366,2019-10-08,04:00:00,8,6,2,FMN GV 16 Berchem TOT
54,Posthofbrug 5366,2019-10-08,05:00:00,20,14,6,FMN GV 16 Berchem TOT
54,Posthofbrug 5366,2019-10-08,06:00:00,107,93,14,FMN GV 16 Berchem TOT
54,Posthofbrug 5366,2019-10-08,07:00:00,403,291,112,FMN GV 16 Berchem TOT
54,Posthofbrug 5366,2019-10-08,08:00:00,614,421,193,FMN GV 16 Berchem TOT
54,Posthofbrug 5366,2019-10-08,09:00:00,243,170,73,FMN GV 16 Berchem TOT
54,Posthofbrug 5366,2019-10-08,10:00:00,75,54,21,FMN GV 16 Berchem TOT
54,Posthofbrug 5366,2019-10-08,11:00:00,67,44,23,FMN GV 16 Berchem TOT
54,Posthofbrug 5366,2019-10-08,12:00:00,149,80,69,FMN GV 16 Berchem TOT
54,Posthofbrug 5366,2019-10-08,13:00:00,117,59,58,FMN GV 16 Berchem TOT
54,Posthofbrug 5366,2019-10-08,14:00:00,114,52,62,FMN GV 16 Berchem TOT
54,Posthofbrug 5366,2019-10-08,15:00:00,189,79,110,FMN GV 16 Berchem TOT
54,Posthofbrug 5366,2019-10-08,16:00:00,380,156,224,FMN GV 16 Berchem TOT
54,Posthofbrug 5366,2019-10-08,17:00:00,523,190,333,FMN GV 16 Berchem TOT
54,Posthofbrug 5366,2019-10-08,18:00:00,342,110,232,FMN GV 16 Berchem TOT
54,Posthofbrug 5366,2019-10-08,19:00:00,165,65,100,FMN GV 16 Berchem TOT
54,Posthofbrug 5366,2019-10-08,20:00:00,79,40,39,FMN GV 16 Berchem TOT
54,Posthofbrug 5366,2019-10-08,21:00:00,77,31,46,FMN GV 16 Berchem TOT
54,Posthofbrug 5366,2019-10-08,22:00:00,78,34,44,FMN GV 16 Berchem TOT
54,Posthofbrug 5366,2019-10-08,23:00:00,48,21,27,FMN GV 16 Berchem TOT
54,Posthofbrug 5366,2019-10-09,00:00:00,18,5,13,FMN GV 16 Berchem TOT
54,Posthofbrug 5366,2019-10-09,01:00:00,8,6,2,FMN GV 16 Berchem TOT
54,Posthofbrug 5366,2019-10-09,02:00:00,4,2,2,FMN GV 16 Berchem TOT
54,Posthofbrug 5366,2019-10-09,03:00:00,3,1,2,FMN GV 16 Berchem TOT
54,Posthofbrug 5366,2019-10-09,04:00:00,8,6,2,FMN GV 16 Berchem TOT
54,Posthofbrug 5366,2019-10-09,05:00:00,25,15,10,FMN GV 16 Berchem TOT
54,Posthofbrug 5366,2019-10-09,06:00:00,107,85,22,FMN GV 16 Berchem TOT
54,Posthofbrug 5366,2019-10-09,07:00:00,352,261,91,FMN GV 16 Berchem TOT
54,Posthofbrug 5366,2019-10-09,08:00:00,578,378,200,FMN GV 16 Berchem TOT
54,Posthofbrug 5366,2019-10-09,09:00:00,201,139,62,FMN GV 16 Berchem TOT
54,Posthofbrug 5366,2019-10-09,10:00:00,77,54,23,FMN GV 16 Berchem TOT
54,Posthofbrug 5366,2019-10-09,11:00:00,75,44,31,FMN GV 16 Berchem TOT
54,Posthofbrug 5366,2019-10-09,12:00:00,188,92,96,FMN GV 16 Berchem TOT
54,Posthofbrug 5366,2019-10-09,13:00:00,132,66,66,FMN GV 16 Berchem TOT
54,Posthofbrug 5366,2019-10-09,14:00:00,107,48,59,FMN GV 16 Berchem TOT
54,Posthofbrug 5366,2019-10-09,15:00:00,167,81,86,FMN GV 16 Berchem TOT
54,Posthofbrug 5366,2019-10-09,16:00:00,307,132,175,FMN GV 16 Berchem TOT
54,Posthofbrug 5366,2019-10-09,17:00:00,432,201,231,FMN GV 16 Berchem TOT
54,Posthofbrug 5366,2019-10-09,18:00:00,294,98,196,FMN GV 16 Berchem TOT
54,Posthofbrug 5366,2019-10-09,19:00:00,139,54,85,FMN GV 16 Berchem TOT
54,Posthofbrug 5366,2019-10-09,20:00:00,89,44,45,FMN GV 16 Berchem TOT
54,Posthofbrug 5366,2019-10-09,21:00:00,71,29,42,FMN GV 16 Berchem TOT
54,Posthofbrug 5366,2019-10-09,22:00:00,67,33,34,FMN GV 16 Berchem TOT
54,Posthofbrug 5366,2019-10-09,23:00:00,51,20,31,FMN GV 16 Berchem TOT
54,Posthofbrug 5366,2019-10-10,00:00:00,19,10,9,FMN GV 16 Berchem TOT
54,Posthofbrug 5366,2019-10-10,01:00:00,3,0,3,FMN GV 16 Berchem TOT
54,Posthofbrug 5366,2019-10-10,02:00:00,9,1,8,FMN GV 16 Berchem TOT
54,Posthofbrug 5366,2019-10-10,03:00:00,3,0,3,FMN GV 16 Berchem TOT
54,Posthofbrug 5366,2019-10-10,04:00:00,9,4,5,FMN GV 16 Berchem TOT
54,Posthofbrug 5366,2019-10-10,05:00:00,26,18,8,FMN GV 16 Berchem TOT
54,Posthofbrug 5366,2019-10-10,06:00:00,98,81,17,FMN GV 16 Berchem TOT
54,Posthofbrug 5366,2019-10-10,07:00:00,440,330,110,FMN GV 16 Berchem TOT
54,Posthofbrug 5366,2019-10-10,08:00:00,696,475,221,FMN GV 16 Berchem TOT
54,Posthofbrug 5366,2019-10-10,09:00:00,265,181,84,FMN GV 16 Berchem TOT
54,Posthofbrug 5366,2019-10-10,10:00:00,142,97,45,FMN GV 16 Berchem TOT
54,Posthofbrug 5366,2019-10-10,11:00:00,105,65,40,FMN GV 16 Berchem TOT
54,Posthofbrug 5366,2019-10-10,12:00:00,153,81,72,FMN GV 16 Berchem TOT
54,Posthofbrug 5366,2019-10-10,13:00:00,157,86,71,FMN GV 16 Berchem TOT
54,Posthofbrug 5366,2019-10-10,14:00:00,129,64,65,FMN GV 16 Berchem TOT
54,Posthofbrug 5366,2019-10-10,15:00:00,240,97,143,FMN GV 16 Berchem TOT
54,Posthofbrug 5366,2019-10-10,16:00:00,431,160,271,FMN GV 16 Berchem TOT
54,Posthofbrug 5366,2019-10-10,17:00:00,551,199,352,FMN GV 16 Berchem TOT
54,Posthofbrug 5366,2019-10-10,18:00:00,343,127,216,FMN GV 16 Berchem TOT
54,Posthofbrug 5366,2019-10-10,19:00:00,161,75,86,FMN GV 16 Berchem TOT
54,Posthofbrug 5366,2019-10-10,20:00:00,91,36,55,FMN GV 16 Berchem TOT
54,Posthofbrug 5366,2019-10-10,21:00:00,93,28,65,FMN GV 16 Berchem TOT
54,Posthofbrug 5366,2019-10-10,22:00:00,71,21,50,FMN GV 16 Berchem TOT
54,Posthofbrug 5366,2019-10-10,23:00:00,67,17,50,FMN GV 16 Berchem TOT
54,Posthofbrug 5366,2019-10-11,00:00:00,31,8,23,FMN GV 16 Berchem TOT
54,Posthofbrug 5366,2019-10-11,01:00:00,9,1,8,FMN GV 16 Berchem TOT
54,Posthofbrug 5366,2019-10-11,02:00:00,9,4,5,FMN GV 16 Berchem TOT
54,Posthofbrug 5366,2019-10-11,03:00:00,3,2,1,FMN GV 16 Berchem TOT
54,Posthofbrug 5366,2019-10-11,04:00:00,12,6,6,FMN GV 16 Berchem TOT
54,Posthofbrug 5366,2019-10-11,05:00:00,28,19,9,FMN GV 16 Berchem TOT
54,Posthofbrug 5366,2019-10-11,06:00:00,94,71,23,FMN GV 16 Berchem TOT
54,Posthofbrug 5366,2019-10-11,07:00:00,358,251,107,FMN GV 16 Berchem TOT
54,Posthofbrug 5366,2019-10-11,08:00:00,566,406,160,FMN GV 16 Berchem TOT
54,Posthofbrug 5366,2019-10-11,09:00:00,208,139,69,FMN GV 16 Berchem TOT
54,Posthofbrug 5366,2019-10-11,10:00:00,82,52,30,FMN GV 16 Berchem TOT
54,Posthofbrug 5366,2019-10-11,11:00:00,95,62,33,FMN GV 16 Berchem TOT
54,Posthofbrug 5366,2019-10-11,12:00:00,151,74,77,FMN GV 16 Berchem TOT
54,Posthofbrug 5366,2019-10-11,13:00:00,136,59,77,FMN GV 16 Berchem TOT
54,Posthofbrug 5366,2019-10-11,14:00:00,120,52,68,FMN GV 16 Berchem TOT
54,Posthofbrug 5366,2019-10-11,15:00:00,192,88,104,FMN GV 16 Berchem TOT
54,Posthofbrug 5366,2019-10-11,16:00:00,364,153,211,FMN GV 16 Berchem TOT
54,Posthofbrug 5366,2019-10-11,17:00:00,392,150,242,FMN GV 16 Berchem TOT
54,Posthofbrug 5366,2019-10-11,18:00:00,242,96,146,FMN GV 16 Berchem TOT
54,Posthofbrug 5366,2019-10-11,19:00:00,125,65,60,FMN GV 16 Berchem TOT
54,Posthofbrug 5366,2019-10-11,20:00:00,65,31,34,FMN GV 16 Berchem TOT
54,Posthofbrug 5366,2019-10-11,21:00:00,52,27,25,FMN GV 16 Berchem TOT
54,Posthofbrug 5366,2019-10-11,22:00:00,45,17,28,FMN GV 16 Berchem TOT
54,Posthofbrug 5366,2019-10-11,23:00:00,48,18,30,FMN GV 16 Berchem TOT
54,Posthofbrug 5366,2019-10-12,00:00:00,44,10,34,FMN GV 16 Berchem TOT
54,Posthofbrug 5366,2019-10-12,01:00:00,43,18,25,FMN GV 16 Berchem TOT
54,Posthofbrug 5366,2019-10-12,02:00:00,29,8,21,FMN GV 16 Berchem TOT
54,Posthofbrug 5366,2019-10-12,03:00:00,10,0,10,FMN GV 16 Berchem TOT
54,Posthofbrug 5366,2019-10-12,04:00:00,15,4,11,FMN GV 16 Berchem TOT
54,Posthofbrug 5366,2019-10-12,05:00:00,13,3,10,FMN GV 16 Berchem TOT
54,Posthofbrug 5366,2019-10-12,06:00:00,21,16,5,FMN GV 16 Berchem TOT
54,Posthofbrug 5366,2019-10-12,07:00:00,25,15,10,FMN GV 16 Berchem TOT
54,Posthofbrug 5366,2019-10-12,08:00:00,57,27,30,FMN GV 16 Berchem TOT
54,Posthofbrug 5366,2019-10-12,09:00:00,84,53,31,FMN GV 16 Berchem TOT
54,Posthofbrug 5366,2019-10-12,10:00:00,93,57,36,FMN GV 16 Berchem TOT
54,Posthofbrug 5366,2019-10-12,11:00:00,133,92,41,FMN GV 16 Berchem TOT
54,Posthofbrug 5366,2019-10-12,12:00:00,131,78,53,FMN GV 16 Berchem TOT
54,Posthofbrug 5366,2019-10-12,13:00:00,150,91,59,FMN GV 16 Berchem TOT
54,Posthofbrug 5366,2019-10-12,14:00:00,145,82,63,FMN GV 16 Berchem TOT
54,Posthofbrug 5366,2019-10-12,15:00:00,113,43,70,FMN GV 16 Berchem TOT
54,Posthofbrug 5366,2019-10-12,16:00:00,120,55,65,FMN GV 16 Berchem TOT
54,Posthofbrug 5366,2019-10-12,17:00:00,119,44,75,FMN GV 16 Berchem TOT
54,Posthofbrug 5366,2019-10-12,18:00:00,143,84,59,FMN GV 16 Berchem TOT
54,Posthofbrug 5366,2019-10-12,19:00:00,94,58,36,FMN GV 16 Berchem TOT
54,Posthofbrug 5366,2019-10-12,20:00:00,73,44,29,FMN GV 16 Berchem TOT
54,Posthofbrug 5366,2019-10-12,21:00:00,54,16,38,FMN GV 16 Berchem TOT
54,Posthofbrug 5366,2019-10-12,22:00:00,42,19,23,FMN GV 16 Berchem TOT
54,Posthofbrug 5366,2019-10-12,23:00:00,73,30,43,FMN GV 16 Berchem TOT
54,Posthofbrug 5366,2019-10-13,00:00:00,48,19,29,FMN GV 16 Berchem TOT
54,Posthofbrug 5366,2019-10-13,01:00:00,30,14,16,FMN GV 16 Berchem TOT
54,Posthofbrug 5366,2019-10-13,02:00:00,26,13,13,FMN GV 16 Berchem TOT
54,Posthofbrug 5366,2019-10-13,03:00:00,15,2,13,FMN GV 16 Berchem TOT
54,Posthofbrug 5366,2019-10-13,04:00:00,10,3,7,FMN GV 16 Berchem TOT
54,Posthofbrug 5366,2019-10-13,05:00:00,12,5,7,FMN GV 16 Berchem TOT
54,Posthofbrug 5366,2019-10-13,06:00:00,10,5,5,FMN GV 16 Berchem TOT
54,Posthofbrug 5366,2019-10-13,07:00:00,18,13,5,FMN GV 16 Berchem TOT
54,Posthofbrug 5366,2019-10-13,08:00:00,30,18,12,FMN GV 16 Berchem TOT
54,Posthofbrug 5366,2019-10-13,09:00:00,61,46,15,FMN GV 16 Berchem TOT
54,Posthofbrug 5366,2019-10-13,10:00:00,90,49,41,FMN GV 16 Berchem TOT
54,Posthofbrug 5366,2019-10-13,11:00:00,92,58,34,FMN GV 16 Berchem TOT
54,Posthofbrug 5366,2019-10-13,12:00:00,127,64,63,FMN GV 16 Berchem TOT
54,Posthofbrug 5366,2019-10-13,13:00:00,150,74,76,FMN GV 16 Berchem TOT
54,Posthofbrug 5366,2019-10-13,14:00:00,155,86,69,FMN GV 16 Berchem TOT
54,Posthofbrug 5366,2019-10-13,15:00:00,119,55,64,FMN GV 16 Berchem TOT
54,Posthofbrug 5366,2019-10-13,16:00:00,118,42,76,FMN GV 16 Berchem TOT
54,Posthofbrug 5366,2019-10-13,17:00:00,130,62,68,FMN GV 16 Berchem TOT
54,Posthofbrug 5366,2019-10-13,18:00:00,79,35,44,FMN GV 16 Berchem TOT
54,Posthofbrug 5366,2019-10-13,19:00:00,52,30,22,FMN GV 16 Berchem TOT
54,Posthofbrug 5366,2019-10-13,20:00:00,53,26,27,FMN GV 16 Berchem TOT
54,Posthofbrug 5366,2019-10-13,21:00:00,28,14,14,FMN GV 16 Berchem TOT
54,Posthofbrug 5366,2019-10-13,22:00:00,36,17,19,FMN GV 16 Berchem TOT
54,Posthofbrug 5366,2019-10-13,23:00:00,18,6,12,FMN GV 16 Berchem TOT
54,Posthofbrug 5366,2019-10-14,00:00:00,12,6,6,FMN GV 16 Berchem TOT
54,Posthofbrug 5366,2019-10-14,01:00:00,4,2,2,FMN GV 16 Berchem TOT
54,Posthofbrug 5366,2019-10-14,02:00:00,1,0,1,FMN GV 16 Berchem TOT
54,Posthofbrug 5366,2019-10-14,03:00:00,3,0,3,FMN GV 16 Berchem TOT
54,Posthofbrug 5366,2019-10-14,04:00:00,7,6,1,FMN GV 16 Berchem TOT
54,Posthofbrug 5366,2019-10-14,05:00:00,24,14,10,FMN GV 16 Berchem TOT
54,Posthofbrug 5366,2019-10-14,06:00:00,122,102,20,FMN GV 16 Berchem TOT
54,Posthofbrug 5366,2019-10-14,07:00:00,438,314,124,FMN GV 16 Berchem TOT
54,Posthofbrug 5366,2019-10-14,08:00:00,739,498,241,FMN GV 16 Berchem TOT
54,Posthofbrug 5366,2019-10-14,09:00:00,267,196,71,FMN GV 16 Berchem TOT
54,Posthofbrug 5366,2019-10-14,10:00:00,103,66,37,FMN GV 16 Berchem TOT
54,Posthofbrug 5366,2019-10-14,11:00:00,99,61,38,FMN GV 16 Berchem TOT
54,Posthofbrug 5366,2019-10-14,12:00:00,140,86,54,FMN GV 16 Berchem TOT
54,Posthofbrug 5366,2019-10-14,13:00:00,160,74,86,FMN GV 16 Berchem TOT
54,Posthofbrug 5366,2019-10-14,14:00:00,108,41,67,FMN GV 16 Berchem TOT
54,Posthofbrug 5366,2019-10-14,15:00:00,226,96,130,FMN GV 16 Berchem TOT
54,Posthofbrug 5366,2019-10-14,16:00:00,466,186,280,FMN GV 16 Berchem TOT
54,Posthofbrug 5366,2019-10-14,17:00:00,547,194,353,FMN GV 16 Berchem TOT
54,Posthofbrug 5366,2019-10-14,18:00:00,360,98,262,FMN GV 16 Berchem TOT
54,Posthofbrug 5366,2019-10-14,19:00:00,184,68,116,FMN GV 16 Berchem TOT
54,Posthofbrug 5366,2019-10-14,20:00:00,84,45,39,FMN GV 16 Berchem TOT
54,Posthofbrug 5366,2019-10-14,21:00:00,74,26,48,FMN GV 16 Berchem TOT
54,Posthofbrug 5366,2019-10-14,22:00:00,64,24,40,FMN GV 16 Berchem TOT
54,Posthofbrug 5366,2019-10-14,23:00:00,29,6,23,FMN GV 16 Berchem TOT
54,Posthofbrug 5366,2019-10-15,00:00:00,20,13,7,FMN GV 16 Berchem TOT
54,Posthofbrug 5366,2019-10-15,01:00:00,3,0,3,FMN GV 16 Berchem TOT
54,Posthofbrug 5366,2019-10-15,02:00:00,4,0,4,FMN GV 16 Berchem TOT
54,Posthofbrug 5366,2019-10-15,03:00:00,1,1,0,FMN GV 16 Berchem TOT
54,Posthofbrug 5366,2019-10-15,04:00:00,12,4,8,FMN GV 16 Berchem TOT
54,Posthofbrug 5366,2019-10-15,05:00:00,21,14,7,FMN GV 16 Berchem TOT
54,Posthofbrug 5366,2019-10-15,06:00:00,128,110,18,FMN GV 16 Berchem TOT
54,Posthofbrug 5366,2019-10-15,07:00:00,389,279,110,FMN GV 16 Berchem TOT
54,Posthofbrug 5366,2019-10-15,08:00:00,755,518,237,FMN GV 16 Berchem TOT
54,Posthofbrug 5366,2019-10-15,09:00:00,220,161,59,FMN GV 16 Berchem TOT
54,Posthofbrug 5366,2019-10-15,10:00:00,94,71,23,FMN GV 16 Berchem TOT
54,Posthofbrug 5366,2019-10-15,11:00:00,92,68,24,FMN GV 16 Berchem TOT
54,Posthofbrug 5366,2019-10-15,12:00:00,142,87,55,FMN GV 16 Berchem TOT
54,Posthofbrug 5366,2019-10-15,13:00:00,131,71,60,FMN GV 16 Berchem TOT
54,Posthofbrug 5366,2019-10-15,14:00:00,99,45,54,FMN GV 16 Berchem TOT
54,Posthofbrug 5366,2019-10-15,15:00:00,190,85,105,FMN GV 16 Berchem TOT
54,Posthofbrug 5366,2019-10-15,16:00:00,402,143,259,FMN GV 16 Berchem TOT
54,Posthofbrug 5366,2019-10-15,17:00:00,529,193,336,FMN GV 16 Berchem TOT
54,Posthofbrug 5366,2019-10-15,18:00:00,369,126,243,FMN GV 16 Berchem TOT
54,Posthofbrug 5366,2019-10-15,19:00:00,159,66,93,FMN GV 16 Berchem TOT
54,Posthofbrug 5366,2019-10-15,20:00:00,79,35,44,FMN GV 16 Berchem TOT
54,Posthofbrug 5366,2019-10-15,21:00:00,85,34,51,FMN GV 16 Berchem TOT
54,Posthofbrug 5366,2019-10-15,22:00:00,62,27,35,FMN GV 16 Berchem TOT
54,Posthofbrug 5366,2019-10-15,23:00:00,44,16,28,FMN GV 16 Berchem TOT
54,Posthofbrug 5366,2019-10-16,00:00:00,14,3,11,FMN GV 16 Berchem TOT
54,Posthofbrug 5366,2019-10-16,01:00:00,5,1,4,FMN GV 16 Berchem TOT
54,Posthofbrug 5366,2019-10-16,02:00:00,7,2,5,FMN GV 16 Berchem TOT
54,Posthofbrug 5366,2019-10-16,03:00:00,9,3,6,FMN GV 16 Berchem TOT
54,Posthofbrug 5366,2019-10-16,04:00:00,10,5,5,FMN GV 16 Berchem TOT
54,Posthofbrug 5366,2019-10-16,05:00:00,21,11,10,FMN GV 16 Berchem TOT
54,Posthofbrug 5366,2019-10-16,06:00:00,114,97,17,FMN GV 16 Berchem TOT
54,Posthofbrug 5366,2019-10-16,07:00:00,382,267,115,FMN GV 16 Berchem TOT
54,Posthofbrug 5366,2019-10-16,08:00:00,603,391,212,FMN GV 16 Berchem TOT
54,Posthofbrug 5366,2019-10-16,09:00:00,215,156,59,FMN GV 16 Berchem TOT
54,Posthofbrug 5366,2019-10-16,10:00:00,76,52,24,FMN GV 16 Berchem TOT
54,Posthofbrug 5366,2019-10-16,11:00:00,97,51,46,FMN GV 16 Berchem TOT
54,Posthofbrug 5366,2019-10-16,12:00:00,223,109,114,FMN GV 16 Berchem TOT
54,Posthofbrug 5366,2019-10-16,13:00:00,126,54,72,FMN GV 16 Berchem TOT
54,Posthofbrug 5366,2019-10-16,14:00:00,108,49,59,FMN GV 16 Berchem TOT
54,Posthofbrug 5366,2019-10-16,15:00:00,151,67,84,FMN GV 16 Berchem TOT
54,Posthofbrug 5366,2019-10-16,16:00:00,314,156,158,FMN GV 16 Berchem TOT
54,Posthofbrug 5366,2019-10-16,17:00:00,380,166,214,FMN GV 16 Berchem TOT
54,Posthofbrug 5366,2019-10-16,18:00:00,238,79,159,FMN GV 16 Berchem TOT
54,Posthofbrug 5366,2019-10-16,19:00:00,117,46,71,FMN GV 16 Berchem TOT
54,Posthofbrug 5366,2019-10-16,20:00:00,55,27,28,FMN GV 16 Berchem TOT
54,Posthofbrug 5366,2019-10-16,21:00:00,62,25,37,FMN GV 16 Berchem TOT
54,Posthofbrug 5366,2019-10-16,22:00:00,38,15,23,FMN GV 16 Berchem TOT
54,Posthofbrug 5366,2019-10-16,23:00:00,34,8,26,FMN GV 16 Berchem TOT
54,Posthofbrug 5366,2019-10-17,00:00:00,11,2,9,FMN GV 16 Berchem TOT
54,Posthofbrug 5366,2019-10-17,01:00:00,8,4,4,FMN GV 16 Berchem TOT
54,Posthofbrug 5366,2019-10-17,02:00:00,6,3,3,FMN GV 16 Berchem TOT
54,Posthofbrug 5366,2019-10-17,03:00:00,1,1,0,FMN GV 16 Berchem TOT
54,Posthofbrug 5366,2019-10-17,04:00:00,7,6,1,FMN GV 16 Berchem TOT
54,Posthofbrug 5366,2019-10-17,05:00:00,16,11,5,FMN GV 16 Berchem TOT
54,Posthofbrug 5366,2019-10-17,06:00:00,98,84,14,FMN GV 16 Berchem TOT
54,Posthofbrug 5366,2019-10-17,07:00:00,403,296,107,FMN GV 16 Berchem TOT
54,Posthofbrug 5366,2019-10-17,08:00:00,696,476,220,FMN GV 16 Berchem TOT
54,Posthofbrug 5366,2019-10-17,09:00:00,255,174,81,FMN GV 16 Berchem TOT
54,Posthofbrug 5366,2019-10-17,10:00:00,106,78,28,FMN GV 16 Berchem TOT
54,Posthofbrug 5366,2019-10-17,11:00:00,99,62,37,FMN GV 16 Berchem TOT
54,Posthofbrug 5366,2019-10-17,12:00:00,147,90,57,FMN GV 16 Berchem TOT
54,Posthofbrug 5366,2019-10-17,13:00:00,132,70,62,FMN GV 16 Berchem TOT
54,Posthofbrug 5366,2019-10-17,14:00:00,146,61,85,FMN GV 16 Berchem TOT
54,Posthofbrug 5366,2019-10-17,15:00:00,215,91,124,FMN GV 16 Berchem TOT
54,Posthofbrug 5366,2019-10-17,16:00:00,417,159,258,FMN GV 16 Berchem TOT
54,Posthofbrug 5366,2019-10-17,17:00:00,536,186,350,FMN GV 16 Berchem TOT
54,Posthofbrug 5366,2019-10-17,18:00:00,338,100,238,FMN GV 16 Berchem TOT
54,Posthofbrug 5366,2019-10-17,19:00:00,173,69,104,FMN GV 16 Berchem TOT
54,Posthofbrug 5366,2019-10-17,20:00:00,88,45,43,FMN GV 16 Berchem TOT
54,Posthofbrug 5366,2019-10-17,21:00:00,81,41,40,FMN GV 16 Berchem TOT
54,Posthofbrug 5366,2019-10-17,22:00:00,86,29,57,FMN GV 16 Berchem TOT
54,Posthofbrug 5366,2019-10-17,23:00:00,50,14,36,FMN GV 16 Berchem TOT
54,Posthofbrug 5366,2019-10-18,00:00:00,34,7,27,FMN GV 16 Berchem TOT
54,Posthofbrug 5366,2019-10-18,01:00:00,16,7,9,FMN GV 16 Berchem TOT
54,Posthofbrug 5366,2019-10-18,02:00:00,23,11,12,FMN GV 16 Berchem TOT
54,Posthofbrug 5366,2019-10-18,03:00:00,6,3,3,FMN GV 16 Berchem TOT
54,Posthofbrug 5366,2019-10-18,04:00:00,12,7,5,FMN GV 16 Berchem TOT
54,Posthofbrug 5366,2019-10-18,05:00:00,32,17,15,FMN GV 16 Berchem TOT
54,Posthofbrug 5366,2019-10-18,06:00:00,105,89,16,FMN GV 16 Berchem TOT
54,Posthofbrug 5366,2019-10-18,07:00:00,355,244,111,FMN GV 16 Berchem TOT
54,Posthofbrug 5366,2019-10-18,08:00:00,547,381,166,FMN GV 16 Berchem TOT
54,Posthofbrug 5366,2019-10-18,09:00:00,213,145,68,FMN GV 16 Berchem TOT
54,Posthofbrug 5366,2019-10-18,10:00:00,65,39,26,FMN GV 16 Berchem TOT
54,Posthofbrug 5366,2019-10-18,11:00:00,93,65,28,FMN GV 16 Berchem TOT
54,Posthofbrug 5366,2019-10-18,12:00:00,122,60,62,FMN GV 16 Berchem TOT
54,Posthofbrug 5366,2019-10-18,13:00:00,116,42,74,FMN GV 16 Berchem TOT
54,Posthofbrug 5366,2019-10-18,14:00:00,105,44,61,FMN GV 16 Berchem TOT
54,Posthofbrug 5366,2019-10-18,15:00:00,202,88,114,FMN GV 16 Berchem TOT
54,Posthofbrug 5366,2019-10-18,16:00:00,339,147,192,FMN GV 16 Berchem TOT
54,Posthofbrug 5366,2019-10-18,17:00:00,394,153,241,FMN GV 16 Berchem TOT
54,Posthofbrug 5366,2019-10-18,18:00:00,248,96,152,FMN GV 16 Berchem TOT
54,Posthofbrug 5366,2019-10-18,19:00:00,136,80,56,FMN GV 16 Berchem TOT
54,Posthofbrug 5366,2019-10-18,20:00:00,91,57,34,FMN GV 16 Berchem TOT
54,Posthofbrug 5366,2019-10-18,21:00:00,72,43,29,FMN GV 16 Berchem TOT
54,Posthofbrug 5366,2019-10-18,22:00:00,75,39,36,FMN GV 16 Berchem TOT
54,Posthofbrug 5366,2019-10-18,23:00:00,60,25,35,FMN GV 16 Berchem TOT
54,Posthofbrug 5366,2019-10-19,00:00:00,80,43,37,FMN GV 16 Berchem TOT
54,Posthofbrug 5366,2019-10-19,01:00:00,47,6,41,FMN GV 16 Berchem TOT
54,Posthofbrug 5366,2019-10-19,02:00:00,44,5,39,FMN GV 16 Berchem TOT
54,Posthofbrug 5366,2019-10-19,03:00:00,38,3,35,FMN GV 16 Berchem TOT
54,Posthofbrug 5366,2019-10-19,04:00:00,33,5,28,FMN GV 16 Berchem TOT
54,Posthofbrug 5366,2019-10-19,05:00:00,18,4,14,FMN GV 16 Berchem TOT
54,Posthofbrug 5366,2019-10-19,06:00:00,17,9,8,FMN GV 16 Berchem TOT
54,Posthofbrug 5366,2019-10-19,07:00:00,28,20,8,FMN GV 16 Berchem TOT
54,Posthofbrug 5366,2019-10-19,08:00:00,33,19,14,FMN GV 16 Berchem TOT
54,Posthofbrug 5366,2019-10-19,09:00:00,34,27,7,FMN GV 16 Berchem TOT
54,Posthofbrug 5366,2019-10-19,10:00:00,47,27,20,FMN GV 16 Berchem TOT
54,Posthofbrug 5366,2019-10-19,11:00:00,76,51,25,FMN GV 16 Berchem TOT
54,Posthofbrug 5366,2019-10-19,12:00:00,72,38,34,FMN GV 16 Berchem TOT
54,Posthofbrug 5366,2019-10-19,13:00:00,103,62,41,FMN GV 16 Berchem TOT
54,Posthofbrug 5366,2019-10-19,14:00:00,102,57,45,FMN GV 16 Berchem TOT
54,Posthofbrug 5366,2019-10-19,15:00:00,98,49,49,FMN GV 16 Berchem TOT
54,Posthofbrug 5366,2019-10-19,16:00:00,86,52,34,FMN GV 16 Berchem TOT
54,Posthofbrug 5366,2019-10-19,17:00:00,110,65,45,FMN GV 16 Berchem TOT
54,Posthofbrug 5366,2019-10-19,18:00:00,119,56,63,FMN GV 16 Berchem TOT
54,Posthofbrug 5366,2019-10-19,19:00:00,82,61,21,FMN GV 16 Berchem TOT
54,Posthofbrug 5366,2019-10-19,20:00:00,60,36,24,FMN GV 16 Berchem TOT
54,Posthofbrug 5366,2019-10-19,21:00:00,54,24,30,FMN GV 16 Berchem TOT
54,Posthofbrug 5366,2019-10-19,22:00:00,47,24,23,FMN GV 16 Berchem TOT
54,Posthofbrug 5366,2019-10-19,23:00:00,46,17,29,FMN GV 16 Berchem TOT
54,Posthofbrug 5366,2019-10-20,00:00:00,39,10,29,FMN GV 16 Berchem TOT
54,Posthofbrug 5366,2019-10-20,01:00:00,26,5,21,FMN GV 16 Berchem TOT
54,Posthofbrug 5366,2019-10-20,02:00:00,37,8,29,FMN GV 16 Berchem TOT
54,Posthofbrug 5366,2019-10-20,03:00:00,18,5,13,FMN GV 16 Berchem TOT
54,Posthofbrug 5366,2019-10-20,04:00:00,15,2,13,FMN GV 16 Berchem TOT
54,Posthofbrug 5366,2019-10-20,05:00:00,9,2,7,FMN GV 16 Berchem TOT
54,Posthofbrug 5366,2019-10-20,06:00:00,14,9,5,FMN GV 16 Berchem TOT
54,Posthofbrug 5366,2019-10-20,07:00:00,12,6,6,FMN GV 16 Berchem TOT
54,Posthofbrug 5366,2019-10-20,08:00:00,35,20,15,FMN GV 16 Berchem TOT
54,Posthofbrug 5366,2019-10-20,09:00:00,70,34,36,FMN GV 16 Berchem TOT
54,Posthofbrug 5366,2019-10-20,10:00:00,65,50,15,FMN GV 16 Berchem TOT
54,Posthofbrug 5366,2019-10-20,11:00:00,49,28,21,FMN GV 16 Berchem TOT
54,Posthofbrug 5366,2019-10-20,12:00:00,75,46,29,FMN GV 16 Berchem TOT
54,Posthofbrug 5366,2019-10-20,13:00:00,57,29,28,FMN GV 16 Berchem TOT
54,Posthofbrug 5366,2019-10-20,14:00:00,79,40,39,FMN GV 16 Berchem TOT
54,Posthofbrug 5366,2019-10-20,15:00:00,56,23,33,FMN GV 16 Berchem TOT
54,Posthofbrug 5366,2019-10-20,16:00:00,67,32,35,FMN GV 16 Berchem TOT
54,Posthofbrug 5366,2019-10-20,17:00:00,87,33,54,FMN GV 16 Berchem TOT
54,Posthofbrug 5366,2019-10-20,18:00:00,66,34,32,FMN GV 16 Berchem TOT
54,Posthofbrug 5366,2019-10-20,19:00:00,45,17,28,FMN GV 16 Berchem TOT
54,Posthofbrug 5366,2019-10-20,20:00:00,47,26,21,FMN GV 16 Berchem TOT
54,Posthofbrug 5366,2019-10-20,21:00:00,23,15,8,FMN GV 16 Berchem TOT
54,Posthofbrug 5366,2019-10-20,22:00:00,32,14,18,FMN GV 16 Berchem TOT
54,Posthofbrug 5366,2019-10-20,23:00:00,19,2,17,FMN GV 16 Berchem TOT
54,Posthofbrug 5366,2019-10-21,00:00:00,7,3,4,FMN GV 16 Berchem TOT
54,Posthofbrug 5366,2019-10-21,01:00:00,3,1,2,FMN GV 16 Berchem TOT
54,Posthofbrug 5366,2019-10-21,02:00:00,3,1,2,FMN GV 16 Berchem TOT
54,Posthofbrug 5366,2019-10-21,03:00:00,2,2,0,FMN GV 16 Berchem TOT
54,Posthofbrug 5366,2019-10-21,04:00:00,8,8,0,FMN GV 16 Berchem TOT
54,Posthofbrug 5366,2019-10-21,05:00:00,13,7,6,FMN GV 16 Berchem TOT
54,Posthofbrug 5366,2019-10-21,06:00:00,90,69,21,FMN GV 16 Berchem TOT
54,Posthofbrug 5366,2019-10-21,07:00:00,392,288,104,FMN GV 16 Berchem TOT
54,Posthofbrug 5366,2019-10-21,08:00:00,675,460,215,FMN GV 16 Berchem TOT
54,Posthofbrug 5366,2019-10-21,09:00:00,236,169,67,FMN GV 16 Berchem TOT
54,Posthofbrug 5366,2019-10-21,10:00:00,95,65,30,FMN GV 16 Berchem TOT
54,Posthofbrug 5366,2019-10-21,11:00:00,70,49,21,FMN GV 16 Berchem TOT
54,Posthofbrug 5366,2019-10-21,12:00:00,122,76,46,FMN GV 16 Berchem TOT
54,Posthofbrug 5366,2019-10-21,13:00:00,127,66,61,FMN GV 16 Berchem TOT
54,Posthofbrug 5366,2019-10-21,14:00:00,98,41,57,FMN GV 16 Berchem TOT
54,Posthofbrug 5366,2019-10-21,15:00:00,193,75,118,FMN GV 16 Berchem TOT
54,Posthofbrug 5366,2019-10-21,16:00:00,409,156,253,FMN GV 16 Berchem TOT
54,Posthofbrug 5366,2019-10-21,17:00:00,459,168,291,FMN GV 16 Berchem TOT
54,Posthofbrug 5366,2019-10-21,18:00:00,296,105,191,FMN GV 16 Berchem TOT
54,Posthofbrug 5366,2019-10-21,19:00:00,158,62,96,FMN GV 16 Berchem TOT
54,Posthofbrug 5366,2019-10-21,20:00:00,64,31,33,FMN GV 16 Berchem TOT
54,Posthofbrug 5366,2019-10-21,21:00:00,50,18,32,FMN GV 16 Berchem TOT
54,Posthofbrug 5366,2019-10-21,22:00:00,65,25,40,FMN GV 16 Berchem TOT
54,Posthofbrug 5366,2019-10-21,23:00:00,23,8,15,FMN GV 16 Berchem TOT
54,Posthofbrug 5366,2019-10-22,00:00:00,10,5,5,FMN GV 16 Berchem TOT
54,Posthofbrug 5366,2019-10-22,01:00:00,4,1,3,FMN GV 16 Berchem TOT
54,Posthofbrug 5366,2019-10-22,02:00:00,2,0,2,FMN GV 16 Berchem TOT
54,Posthofbrug 5366,2019-10-22,03:00:00,4,1,3,FMN GV 16 Berchem TOT
54,Posthofbrug 5366,2019-10-22,04:00:00,6,4,2,FMN GV 16 Berchem TOT
54,Posthofbrug 5366,2019-10-22,05:00:00,19,13,6,FMN GV 16 Berchem TOT
54,Posthofbrug 5366,2019-10-22,06:00:00,125,101,24,FMN GV 16 Berchem TOT
54,Posthofbrug 5366,2019-10-22,07:00:00,427,321,106,FMN GV 16 Berchem TOT
54,Posthofbrug 5366,2019-10-22,08:00:00,716,511,205,FMN GV 16 Berchem TOT
54,Posthofbrug 5366,2019-10-22,09:00:00,266,196,70,FMN GV 16 Berchem TOT
54,Posthofbrug 5366,2019-10-22,10:00:00,108,74,34,FMN GV 16 Berchem TOT
54,Posthofbrug 5366,2019-10-22,11:00:00,85,55,30,FMN GV 16 Berchem TOT
54,Posthofbrug 5366,2019-10-22,12:00:00,157,82,75,FMN GV 16 Berchem TOT
54,Posthofbrug 5366,2019-10-22,13:00:00,157,72,85,FMN GV 16 Berchem TOT
54,Posthofbrug 5366,2019-10-22,14:00:00,108,56,52,FMN GV 16 Berchem TOT
54,Posthofbrug 5366,2019-10-22,15:00:00,240,108,132,FMN GV 16 Berchem TOT
54,Posthofbrug 5366,2019-10-22,16:00:00,445,160,285,FMN GV 16 Berchem TOT
54,Posthofbrug 5366,2019-10-22,17:00:00,508,190,318,FMN GV 16 Berchem TOT
54,Posthofbrug 5366,2019-10-22,18:00:00,387,138,249,FMN GV 16 Berchem TOT
54,Posthofbrug 5366,2019-10-22,19:00:00,169,57,112,FMN GV 16 Berchem TOT
54,Posthofbrug 5366,2019-10-22,20:00:00,88,29,59,FMN GV 16 Berchem TOT
54,Posthofbrug 5366,2019-10-22,21:00:00,66,35,31,FMN GV 16 Berchem TOT
54,Posthofbrug 5366,2019-10-22,22:00:00,76,17,59,FMN GV 16 Berchem TOT
54,Posthofbrug 5366,2019-10-22,23:00:00,48,16,32,FMN GV 16 Berchem TOT
54,Posthofbrug 5366,2019-10-23,00:00:00,13,2,11,FMN GV 16 Berchem TOT
54,Posthofbrug 5366,2019-10-23,01:00:00,8,3,5,FMN GV 16 Berchem TOT
54,Posthofbrug 5366,2019-10-23,02:00:00,6,0,6,FMN GV 16 Berchem TOT
54,Posthofbrug 5366,2019-10-23,03:00:00,4,3,1,FMN GV 16 Berchem TOT
54,Posthofbrug 5366,2019-10-23,04:00:00,7,6,1,FMN GV 16 Berchem TOT
54,Posthofbrug 5366,2019-10-23,05:00:00,24,17,7,FMN GV 16 Berchem TOT
54,Posthofbrug 5366,2019-10-23,06:00:00,136,110,26,FMN GV 16 Berchem TOT
54,Posthofbrug 5366,2019-10-23,07:00:00,396,293,103,FMN GV 16 Berchem TOT
54,Posthofbrug 5366,2019-10-23,08:00:00,565,388,177,FMN GV 16 Berchem TOT
54,Posthofbrug 5366,2019-10-23,09:00:00,243,170,73,FMN GV 16 Berchem TOT
54,Posthofbrug 5366,2019-10-23,10:00:00,106,77,29,FMN GV 16 Berchem TOT
54,Posthofbrug 5366,2019-10-23,11:00:00,113,62,51,FMN GV 16 Berchem TOT
54,Posthofbrug 5366,2019-10-23,12:00:00,223,94,129,FMN GV 16 Berchem TOT
54,Posthofbrug 5366,2019-10-23,13:00:00,205,99,106,FMN GV 16 Berchem TOT
54,Posthofbrug 5366,2019-10-23,14:00:00,131,73,58,FMN GV 16 Berchem TOT
54,Posthofbrug 5366,2019-10-23,15:00:00,194,79,115,FMN GV 16 Berchem TOT
54,Posthofbrug 5366,2019-10-23,16:00:00,341,149,192,FMN GV 16 Berchem TOT
54,Posthofbrug 5366,2019-10-23,17:00:00,514,207,307,FMN GV 16 Berchem TOT
54,Posthofbrug 5366,2019-10-23,18:00:00,334,120,214,FMN GV 16 Berchem TOT
54,Posthofbrug 5366,2019-10-23,19:00:00,157,66,91,FMN GV 16 Berchem TOT
54,Posthofbrug 5366,2019-10-23,20:00:00,106,58,48,FMN GV 16 Berchem TOT
54,Posthofbrug 5366,2019-10-23,21:00:00,67,29,38,FMN GV 16 Berchem TOT
54,Posthofbrug 5366,2019-10-23,22:00:00,61,25,36,FMN GV 16 Berchem TOT
54,Posthofbrug 5366,2019-10-23,23:00:00,56,15,41,FMN GV 16 Berchem TOT
54,Posthofbrug 5366,2019-10-24,00:00:00,27,6,21,FMN GV 16 Berchem TOT
54,Posthofbrug 5366,2019-10-24,01:00:00,12,4,8,FMN GV 16 Berchem TOT
54,Posthofbrug 5366,2019-10-24,02:00:00,4,0,4,FMN GV 16 Berchem TOT
54,Posthofbrug 5366,2019-10-24,03:00:00,6,4,2,FMN GV 16 Berchem TOT
54,Posthofbrug 5366,2019-10-24,04:00:00,11,9,2,FMN GV 16 Berchem TOT
54,Posthofbrug 5366,2019-10-24,05:00:00,24,18,6,FMN GV 16 Berchem TOT
54,Posthofbrug 5366,2019-10-24,06:00:00,115,92,23,FMN GV 16 Berchem TOT
54,Posthofbrug 5366,2019-10-24,07:00:00,434,322,112,FMN GV 16 Berchem TOT
54,Posthofbrug 5366,2019-10-24,08:00:00,727,507,220,FMN GV 16 Berchem TOT
54,Posthofbrug 5366,2019-10-24,09:00:00,281,206,75,FMN GV 16 Berchem TOT
54,Posthofbrug 5366,2019-10-24,10:00:00,130,87,43,FMN GV 16 Berchem TOT
54,Posthofbrug 5366,2019-10-24,11:00:00,102,66,36,FMN GV 16 Berchem TOT
54,Posthofbrug 5366,2019-10-24,12:00:00,174,98,76,FMN GV 16 Berchem TOT
54,Posthofbrug 5366,2019-10-24,13:00:00,167,93,74,FMN GV 16 Berchem TOT
54,Posthofbrug 5366,2019-10-24,14:00:00,137,55,82,FMN GV 16 Berchem TOT
54,Posthofbrug 5366,2019-10-24,15:00:00,247,96,151,FMN GV 16 Berchem TOT
54,Posthofbrug 5366,2019-10-24,16:00:00,431,154,277,FMN GV 16 Berchem TOT
54,Posthofbrug 5366,2019-10-24,17:00:00,601,230,371,FMN GV 16 Berchem TOT
54,Posthofbrug 5366,2019-10-24,18:00:00,378,119,259,FMN GV 16 Berchem TOT
54,Posthofbrug 5366,2019-10-24,19:00:00,174,63,111,FMN GV 16 Berchem TOT
54,Posthofbrug 5366,2019-10-24,20:00:00,115,66,49,FMN GV 16 Berchem TOT
54,Posthofbrug 5366,2019-10-24,21:00:00,96,33,63,FMN GV 16 Berchem TOT
54,Posthofbrug 5366,2019-10-24,22:00:00,87,27,60,FMN GV 16 Berchem TOT
54,Posthofbrug 5366,2019-10-24,23:00:00,63,26,37,FMN GV 16 Berchem TOT
54,Posthofbrug 5366,2019-10-25,00:00:00,24,7,17,FMN GV 16 Berchem TOT
54,Posthofbrug 5366,2019-10-25,01:00:00,16,9,7,FMN GV 16 Berchem TOT
54,Posthofbrug 5366,2019-10-25,02:00:00,3,1,2,FMN GV 16 Berchem TOT
54,Posthofbrug 5366,2019-10-25,03:00:00,6,2,4,FMN GV 16 Berchem TOT
54,Posthofbrug 5366,2019-10-25,04:00:00,15,10,5,FMN GV 16 Berchem TOT
54,Posthofbrug 5366,2019-10-25,05:00:00,45,24,21,FMN GV 16 Berchem TOT
54,Posthofbrug 5366,2019-10-25,06:00:00,87,69,18,FMN GV 16 Berchem TOT
54,Posthofbrug 5366,2019-10-25,07:00:00,372,278,94,FMN GV 16 Berchem TOT
54,Posthofbrug 5366,2019-10-25,08:00:00,574,408,166,FMN GV 16 Berchem TOT
54,Posthofbrug 5366,2019-10-25,09:00:00,218,150,68,FMN GV 16 Berchem TOT
54,Posthofbrug 5366,2019-10-25,10:00:00,106,55,51,FMN GV 16 Berchem TOT
54,Posthofbrug 5366,2019-10-25,11:00:00,105,75,30,FMN GV 16 Berchem TOT
54,Posthofbrug 5366,2019-10-25,12:00:00,173,91,82,FMN GV 16 Berchem TOT
54,Posthofbrug 5366,2019-10-25,13:00:00,176,81,95,FMN GV 16 Berchem TOT
54,Posthofbrug 5366,2019-10-25,14:00:00,168,70,98,FMN GV 16 Berchem TOT
54,Posthofbrug 5366,2019-10-25,15:00:00,239,102,137,FMN GV 16 Berchem TOT
54,Posthofbrug 5366,2019-10-25,16:00:00,425,163,262,FMN GV 16 Berchem TOT
54,Posthofbrug 5366,2019-10-25,17:00:00,433,166,267,FMN GV 16 Berchem TOT
54,Posthofbrug 5366,2019-10-25,18:00:00,319,123,196,FMN GV 16 Berchem TOT
54,Posthofbrug 5366,2019-10-25,19:00:00,180,91,89,FMN GV 16 Berchem TOT
54,Posthofbrug 5366,2019-10-25,20:00:00,75,39,36,FMN GV 16 Berchem TOT
54,Posthofbrug 5366,2019-10-25,21:00:00,74,30,44,FMN GV 16 Berchem TOT
54,Posthofbrug 5366,2019-10-25,22:00:00,62,30,32,FMN GV 16 Berchem TOT
54,Posthofbrug 5366,2019-10-25,23:00:00,69,22,47,FMN GV 16 Berchem TOT
54,Posthofbrug 5366,2019-10-26,00:00:00,52,10,42,FMN GV 16 Berchem TOT
54,Posthofbrug 5366,2019-10-26,01:00:00,51,15,36,FMN GV 16 Berchem TOT
54,Posthofbrug 5366,2019-10-26,02:00:00,35,3,32,FMN GV 16 Berchem TOT
54,Posthofbrug 5366,2019-10-26,03:00:00,17,5,12,FMN GV 16 Berchem TOT
54,Posthofbrug 5366,2019-10-26,04:00:00,18,9,9,FMN GV 16 Berchem TOT
54,Posthofbrug 5366,2019-10-26,05:00:00,5,4,1,FMN GV 16 Berchem TOT
54,Posthofbrug 5366,2019-10-26,06:00:00,11,7,4,FMN GV 16 Berchem TOT
54,Posthofbrug 5366,2019-10-26,07:00:00,23,13,10,FMN GV 16 Berchem TOT
54,Posthofbrug 5366,2019-10-26,08:00:00,50,24,26,FMN GV 16 Berchem TOT
54,Posthofbrug 5366,2019-10-26,09:00:00,84,56,28,FMN GV 16 Berchem TOT
54,Posthofbrug 5366,2019-10-26,10:00:00,103,73,30,FMN GV 16 Berchem TOT
54,Posthofbrug 5366,2019-10-26,11:00:00,131,90,41,FMN GV 16 Berchem TOT
54,Posthofbrug 5366,2019-10-26,12:00:00,138,73,65,FMN GV 16 Berchem TOT
54,Posthofbrug 5366,2019-10-26,13:00:00,137,73,64,FMN GV 16 Berchem TOT
54,Posthofbrug 5366,2019-10-26,14:00:00,147,83,64,FMN GV 16 Berchem TOT
54,Posthofbrug 5366,2019-10-26,15:00:00,111,49,62,FMN GV 16 Berchem TOT
54,Posthofbrug 5366,2019-10-26,16:00:00,155,70,85,FMN GV 16 Berchem TOT
54,Posthofbrug 5366,2019-10-26,17:00:00,125,58,67,FMN GV 16 Berchem TOT
54,Posthofbrug 5366,2019-10-26,18:00:00,134,68,66,FMN GV 16 Berchem TOT
54,Posthofbrug 5366,2019-10-26,19:00:00,100,61,39,FMN GV 16 Berchem TOT
54,Posthofbrug 5366,2019-10-26,20:00:00,58,27,31,FMN GV 16 Berchem TOT
54,Posthofbrug 5366,2019-10-26,21:00:00,44,27,17,FMN GV 16 Berchem TOT
54,Posthofbrug 5366,2019-10-26,22:00:00,59,24,35,FMN GV 16 Berchem TOT
54,Posthofbrug 5366,2019-10-26,23:00:00,68,21,47,FMN GV 16 Berchem TOT
54,Posthofbrug 5366,2019-10-27,00:00:00,47,18,29,FMN GV 16 Berchem TOT
54,Posthofbrug 5366,2019-10-27,01:00:00,25,7,18,FMN GV 16 Berchem TOT
54,Posthofbrug 5366,2019-10-27,02:00:00,43,10,33,FMN GV 16 Berchem TOT
54,Posthofbrug 5366,2019-10-27,03:00:00,23,6,17,FMN GV 16 Berchem TOT
54,Posthofbrug 5366,2019-10-27,04:00:00,12,6,6,FMN GV 16 Berchem TOT
54,Posthofbrug 5366,2019-10-27,05:00:00,6,1,5,FMN GV 16 Berchem TOT
54,Posthofbrug 5366,2019-10-27,06:00:00,11,8,3,FMN GV 16 Berchem TOT
54,Posthofbrug 5366,2019-10-27,07:00:00,13,9,4,FMN GV 16 Berchem TOT
54,Posthofbrug 5366,2019-10-27,08:00:00,31,18,13,FMN GV 16 Berchem TOT
54,Posthofbrug 5366,2019-10-27,09:00:00,55,34,21,FMN GV 16 Berchem TOT
54,Posthofbrug 5366,2019-10-27,10:00:00,85,58,27,FMN GV 16 Berchem TOT
54,Posthofbrug 5366,2019-10-27,11:00:00,90,45,45,FMN GV 16 Berchem TOT
54,Posthofbrug 5366,2019-10-27,12:00:00,85,54,31,FMN GV 16 Berchem TOT
54,Posthofbrug 5366,2019-10-27,13:00:00,95,56,39,FMN GV 16 Berchem TOT
54,Posthofbrug 5366,2019-10-27,14:00:00,73,36,37,FMN GV 16 Berchem TOT
54,Posthofbrug 5366,2019-10-27,15:00:00,96,41,55,FMN GV 16 Berchem TOT
54,Posthofbrug 5366,2019-10-27,16:00:00,87,37,50,FMN GV 16 Berchem TOT
54,Posthofbrug 5366,2019-10-27,17:00:00,111,51,60,FMN GV 16 Berchem TOT
54,Posthofbrug 5366,2019-10-27,18:00:00,69,32,37,FMN GV 16 Berchem TOT
54,Posthofbrug 5366,2019-10-27,19:00:00,46,23,23,FMN GV 16 Berchem TOT
54,Posthofbrug 5366,2019-10-27,20:00:00,51,28,23,FMN GV 16 Berchem TOT
54,Posthofbrug 5366,2019-10-27,21:00:00,30,17,13,FMN GV 16 Berchem TOT
54,Posthofbrug 5366,2019-10-27,22:00:00,28,9,19,FMN GV 16 Berchem TOT
54,Posthofbrug 5366,2019-10-27,23:00:00,24,9,15,FMN GV 16 Berchem TOT
54,Posthofbrug 5366,2019-10-28,00:00:00,17,0,17,FMN GV 16 Berchem TOT
54,Posthofbrug 5366,2019-10-28,01:00:00,4,1,3,FMN GV 16 Berchem TOT
54,Posthofbrug 5366,2019-10-28,02:00:00,4,3,1,FMN GV 16 Berchem TOT
54,Posthofbrug 5366,2019-10-28,03:00:00,1,1,0,FMN GV 16 Berchem TOT
54,Posthofbrug 5366,2019-10-28,04:00:00,11,9,2,FMN GV 16 Berchem TOT
54,Posthofbrug 5366,2019-10-28,05:00:00,18,13,5,FMN GV 16 Berchem TOT
54,Posthofbrug 5366,2019-10-28,06:00:00,111,93,18,FMN GV 16 Berchem TOT
54,Posthofbrug 5366,2019-10-28,07:00:00,281,208,73,FMN GV 16 Berchem TOT
54,Posthofbrug 5366,2019-10-28,08:00:00,518,342,176,FMN GV 16 Berchem TOT
54,Posthofbrug 5366,2019-10-28,09:00:00,209,137,72,FMN GV 16 Berchem TOT
54,Posthofbrug 5366,2019-10-28,10:00:00,98,66,32,FMN GV 16 Berchem TOT
54,Posthofbrug 5366,2019-10-28,11:00:00,87,60,27,FMN GV 16 Berchem TOT
54,Posthofbrug 5366,2019-10-28,12:00:00,110,57,53,FMN GV 16 Berchem TOT
54,Posthofbrug 5366,2019-10-28,13:00:00,115,58,57,FMN GV 16 Berchem TOT
54,Posthofbrug 5366,2019-10-28,14:00:00,94,47,47,FMN GV 16 Berchem TOT
54,Posthofbrug 5366,2019-10-28,15:00:00,161,62,99,FMN GV 16 Berchem TOT
54,Posthofbrug 5366,2019-10-28,16:00:00,279,116,163,FMN GV 16 Berchem TOT
54,Posthofbrug 5366,2019-10-28,17:00:00,448,169,279,FMN GV 16 Berchem TOT
54,Posthofbrug 5366,2019-10-28,18:00:00,259,101,158,FMN GV 16 Berchem TOT
54,Posthofbrug 5366,2019-10-28,19:00:00,107,36,71,FMN GV 16 Berchem TOT
54,Posthofbrug 5366,2019-10-28,20:00:00,59,27,32,FMN GV 16 Berchem TOT
54,Posthofbrug 5366,2019-10-28,21:00:00,46,18,28,FMN GV 16 Berchem TOT
54,Posthofbrug 5366,2019-10-28,22:00:00,39,17,22,FMN GV 16 Berchem TOT
54,Posthofbrug 5366,2019-10-28,23:00:00,29,11,18,FMN GV 16 Berchem TOT
54,Posthofbrug 5366,2019-10-29,00:00:00,17,5,12,FMN GV 16 Berchem TOT
54,Posthofbrug 5366,2019-10-29,01:00:00,2,1,1,FMN GV 16 Berchem TOT
54,Posthofbrug 5366,2019-10-29,02:00:00,7,1,6,FMN GV 16 Berchem TOT
54,Posthofbrug 5366,2019-10-29,03:00:00,3,2,1,FMN GV 16 Berchem TOT
54,Posthofbrug 5366,2019-10-29,04:00:00,7,6,1,FMN GV 16 Berchem TOT
54,Posthofbrug 5366,2019-10-29,05:00:00,26,17,9,FMN GV 16 Berchem TOT
54,Posthofbrug 5366,2019-10-29,06:00:00,114,86,28,FMN GV 16 Berchem TOT
54,Posthofbrug 5366,2019-10-29,07:00:00,345,259,86,FMN GV 16 Berchem TOT
54,Posthofbrug 5366,2019-10-29,08:00:00,485,334,151,FMN GV 16 Berchem TOT
54,Posthofbrug 5366,2019-10-29,09:00:00,216,153,63,FMN GV 16 Berchem TOT
54,Posthofbrug 5366,2019-10-29,10:00:00,113,83,30,FMN GV 16 Berchem TOT
54,Posthofbrug 5366,2019-10-29,11:00:00,85,52,33,FMN GV 16 Berchem TOT
54,Posthofbrug 5366,2019-10-29,12:00:00,144,85,59,FMN GV 16 Berchem TOT
54,Posthofbrug 5366,2019-10-29,13:00:00,144,78,66,FMN GV 16 Berchem TOT
54,Posthofbrug 5366,2019-10-29,14:00:00,117,56,61,FMN GV 16 Berchem TOT
54,Posthofbrug 5366,2019-10-29,15:00:00,174,72,102,FMN GV 16 Berchem TOT
54,Posthofbrug 5366,2019-10-29,16:00:00,337,126,211,FMN GV 16 Berchem TOT
54,Posthofbrug 5366,2019-10-29,17:00:00,432,192,240,FMN GV 16 Berchem TOT
54,Posthofbrug 5366,2019-10-29,18:00:00,292,108,184,FMN GV 16 Berchem TOT
54,Posthofbrug 5366,2019-10-29,19:00:00,128,43,85,FMN GV 16 Berchem TOT
54,Posthofbrug 5366,2019-10-29,20:00:00,67,21,46,FMN GV 16 Berchem TOT
54,Posthofbrug 5366,2019-10-29,21:00:00,79,34,45,FMN GV 16 Berchem TOT
54,Posthofbrug 5366,2019-10-29,22:00:00,62,22,40,FMN GV 16 Berchem TOT
54,Posthofbrug 5366,2019-10-29,23:00:00,33,10,23,FMN GV 16 Berchem TOT
54,Posthofbrug 5366,2019-10-30,00:00:00,20,3,17,FMN GV 16 Berchem TOT
54,Posthofbrug 5366,2019-10-30,01:00:00,14,2,12,FMN GV 16 Berchem TOT
54,Posthofbrug 5366,2019-10-30,02:00:00,7,2,5,FMN GV 16 Berchem TOT
54,Posthofbrug 5366,2019-10-30,03:00:00,2,1,1,FMN GV 16 Berchem TOT
54,Posthofbrug 5366,2019-10-30,04:00:00,10,8,2,FMN GV 16 Berchem TOT
54,Posthofbrug 5366,2019-10-30,05:00:00,14,11,3,FMN GV 16 Berchem TOT
54,Posthofbrug 5366,2019-10-30,06:00:00,95,79,16,FMN GV 16 Berchem TOT
54,Posthofbrug 5366,2019-10-30,07:00:00,265,189,76,FMN GV 16 Berchem TOT
54,Posthofbrug 5366,2019-10-30,08:00:00,383,258,125,FMN GV 16 Berchem TOT
54,Posthofbrug 5366,2019-10-30,09:00:00,174,117,57,FMN GV 16 Berchem TOT
54,Posthofbrug 5366,2019-10-30,10:00:00,90,60,30,FMN GV 16 Berchem TOT
54,Posthofbrug 5366,2019-10-30,11:00:00,73,45,28,FMN GV 16 Berchem TOT
54,Posthofbrug 5366,2019-10-30,12:00:00,118,77,41,FMN GV 16 Berchem TOT
54,Posthofbrug 5366,2019-10-30,13:00:00,129,68,61,FMN GV 16 Berchem TOT
54,Posthofbrug 5366,2019-10-30,14:00:00,113,62,51,FMN GV 16 Berchem TOT
54,Posthofbrug 5366,2019-10-30,15:00:00,144,67,77,FMN GV 16 Berchem TOT
54,Posthofbrug 5366,2019-10-30,16:00:00,268,105,163,FMN GV 16 Berchem TOT
54,Posthofbrug 5366,2019-10-30,17:00:00,334,134,200,FMN GV 16 Berchem TOT
54,Posthofbrug 5366,2019-10-30,18:00:00,256,87,169,FMN GV 16 Berchem TOT
54,Posthofbrug 5366,2019-10-30,19:00:00,116,52,64,FMN GV 16 Berchem TOT
54,Posthofbrug 5366,2019-10-30,20:00:00,75,34,41,FMN GV 16 Berchem TOT
54,Posthofbrug 5366,2019-10-30,21:00:00,31,15,16,FMN GV 16 Berchem TOT
54,Posthofbrug 5366,2019-10-30,22:00:00,64,21,43,FMN GV 16 Berchem TOT
54,Posthofbrug 5366,2019-10-30,23:00:00,30,11,19,FMN GV 16 Berchem TOT
54,Posthofbrug 5366,2019-10-31,00:00:00,21,3,18,FMN GV 16 Berchem TOT
54,Posthofbrug 5366,2019-10-31,01:00:00,5,0,5,FMN GV 16 Berchem TOT
54,Posthofbrug 5366,2019-10-31,02:00:00,5,2,3,FMN GV 16 Berchem TOT
54,Posthofbrug 5366,2019-10-31,03:00:00,2,0,2,FMN GV 16 Berchem TOT
54,Posthofbrug 5366,2019-10-31,04:00:00,10,9,1,FMN GV 16 Berchem TOT
54,Posthofbrug 5366,2019-10-31,05:00:00,16,10,6,FMN GV 16 Berchem TOT
54,Posthofbrug 5366,2019-10-31,06:00:00,64,52,12,FMN GV 16 Berchem TOT
54,Posthofbrug 5366,2019-10-31,07:00:00,217,150,67,FMN GV 16 Berchem TOT
54,Posthofbrug 5366,2019-10-31,08:00:00,347,228,119,FMN GV 16 Berchem TOT
54,Posthofbrug 5366,2019-10-31,09:00:00,168,99,69,FMN GV 16 Berchem TOT
54,Posthofbrug 5366,2019-10-31,10:00:00,79,59,20,FMN GV 16 Berchem TOT
54,Posthofbrug 5366,2019-10-31,11:00:00,84,54,30,FMN GV 16 Berchem TOT
54,Posthofbrug 5366,2019-10-31,12:00:00,128,84,44,FMN GV 16 Berchem TOT
54,Posthofbrug 5366,2019-10-31,13:00:00,103,62,41,FMN GV 16 Berchem TOT
54,Posthofbrug 5366,2019-10-31,14:00:00,93,50,43,FMN GV 16 Berchem TOT
54,Posthofbrug 5366,2019-10-31,15:00:00,146,80,66,FMN GV 16 Berchem TOT
54,Posthofbrug 5366,2019-10-31,16:00:00,241,123,118,FMN GV 16 Berchem TOT
54,Posthofbrug 5366,2019-10-31,17:00:00,321,135,186,FMN GV 16 Berchem TOT
54,Posthofbrug 5366,2019-10-31,18:00:00,239,100,139,FMN GV 16 Berchem TOT
54,Posthofbrug 5366,2019-10-31,19:00:00,113,44,69,FMN GV 16 Berchem TOT
54,Posthofbrug 5366,2019-10-31,20:00:00,77,41,36,FMN GV 16 Berchem TOT
54,Posthofbrug 5366,2019-10-31,21:00:00,77,49,28,FMN GV 16 Berchem TOT
54,Posthofbrug 5366,2019-10-31,22:00:00,49,28,21,FMN GV 16 Berchem TOT
54,Posthofbrug 5366,2019-10-31,23:00:00,44,12,32,FMN GV 16 Berchem TOT
54,Posthofbrug 5366,2019-11-01,00:00:00,28,11,17,FMN GV 16 Berchem TOT
54,Posthofbrug 5366,2019-11-01,01:00:00,31,13,18,FMN GV 16 Berchem TOT
54,Posthofbrug 5366,2019-11-01,02:00:00,34,12,22,FMN GV 16 Berchem TOT
54,Posthofbrug 5366,2019-11-01,03:00:00,22,4,18,FMN GV 16 Berchem TOT
54,Posthofbrug 5366,2019-11-01,04:00:00,22,6,16,FMN GV 16 Berchem TOT
54,Posthofbrug 5366,2019-11-01,05:00:00,9,2,7,FMN GV 16 Berchem TOT
54,Posthofbrug 5366,2019-11-01,06:00:00,15,8,7,FMN GV 16 Berchem TOT
54,Posthofbrug 5366,2019-11-01,07:00:00,28,8,20,FMN GV 16 Berchem TOT
54,Posthofbrug 5366,2019-11-01,08:00:00,11,6,5,FMN GV 16 Berchem TOT
54,Posthofbrug 5366,2019-11-01,09:00:00,14,10,4,FMN GV 16 Berchem TOT
54,Posthofbrug 5366,2019-11-01,10:00:00,26,16,10,FMN GV 16 Berchem TOT
54,Posthofbrug 5366,2019-11-01,11:00:00,15,7,8,FMN GV 16 Berchem TOT
54,Posthofbrug 5366,2019-11-01,12:00:00,29,23,6,FMN GV 16 Berchem TOT
54,Posthofbrug 5366,2019-11-01,13:00:00,26,13,13,FMN GV 16 Berchem TOT
54,Posthofbrug 5366,2019-11-01,14:00:00,52,37,15,FMN GV 16 Berchem TOT
54,Posthofbrug 5366,2019-11-01,15:00:00,36,14,22,FMN GV 16 Berchem TOT
54,Posthofbrug 5366,2019-11-01,16:00:00,57,27,30,FMN GV 16 Berchem TOT
54,Posthofbrug 5366,2019-11-01,17:00:00,51,16,35,FMN GV 16 Berchem TOT
54,Posthofbrug 5366,2019-11-01,18:00:00,46,27,19,FMN GV 16 Berchem TOT
54,Posthofbrug 5366,2019-11-01,19:00:00,48,34,14,FMN GV 16 Berchem TOT
54,Posthofbrug 5366,2019-11-01,20:00:00,22,10,12,FMN GV 16 Berchem TOT
54,Posthofbrug 5366,2019-11-01,21:00:00,36,19,17,FMN GV 16 Berchem TOT
54,Posthofbrug 5366,2019-11-01,22:00:00,21,8,13,FMN GV 16 Berchem TOT
54,Posthofbrug 5366,2019-11-01,23:00:00,24,4,20,FMN GV 16 Berchem TOT
54,Posthofbrug 5366,2019-11-02,00:00:00,19,2,17,FMN GV 16 Berchem TOT
54,Posthofbrug 5366,2019-11-02,01:00:00,15,6,9,FMN GV 16 Berchem TOT
54,Posthofbrug 5366,2019-11-02,02:00:00,13,5,8,FMN GV 16 Berchem TOT
54,Posthofbrug 5366,2019-11-02,03:00:00,11,4,7,FMN GV 16 Berchem TOT
54,Posthofbrug 5366,2019-11-02,04:00:00,6,4,2,FMN GV 16 Berchem TOT
54,Posthofbrug 5366,2019-11-02,05:00:00,9,7,2,FMN GV 16 Berchem TOT
54,Posthofbrug 5366,2019-11-02,06:00:00,8,4,4,FMN GV 16 Berchem TOT
54,Posthofbrug 5366,2019-11-02,07:00:00,17,12,5,FMN GV 16 Berchem TOT
54,Posthofbrug 5366,2019-11-02,08:00:00,27,16,11,FMN GV 16 Berchem TOT
54,Posthofbrug 5366,2019-11-02,09:00:00,32,24,8,FMN GV 16 Berchem TOT
54,Posthofbrug 5366,2019-11-02,10:00:00,31,21,10,FMN GV 16 Berchem TOT
54,Posthofbrug 5366,2019-11-02,11:00:00,63,41,22,FMN GV 16 Berchem TOT
54,Posthofbrug 5366,2019-11-02,12:00:00,80,55,25,FMN GV 16 Berchem TOT
54,Posthofbrug 5366,2019-11-02,13:00:00,66,33,33,FMN GV 16 Berchem TOT
54,Posthofbrug 5366,2019-11-02,14:00:00,84,46,38,FMN GV 16 Berchem TOT
54,Posthofbrug 5366,2019-11-02,15:00:00,71,36,35,FMN GV 16 Berchem TOT
54,Posthofbrug 5366,2019-11-02,16:00:00,89,35,54,FMN GV 16 Berchem TOT
54,Posthofbrug 5366,2019-11-02,17:00:00,79,40,39,FMN GV 16 Berchem TOT
54,Posthofbrug 5366,2019-11-02,18:00:00,79,40,39,FMN GV 16 Berchem TOT
54,Posthofbrug 5366,2019-11-02,19:00:00,60,33,27,FMN GV 16 Berchem TOT
54,Posthofbrug 5366,2019-11-02,20:00:00,48,31,17,FMN GV 16 Berchem TOT
54,Posthofbrug 5366,2019-11-02,21:00:00,38,16,22,FMN GV 16 Berchem TOT
54,Posthofbrug 5366,2019-11-02,22:00:00,32,13,19,FMN GV 16 Berchem TOT
54,Posthofbrug 5366,2019-11-02,23:00:00,48,14,34,FMN GV 16 Berchem TOT
54,Posthofbrug 5366,2019-11-03,00:00:00,29,11,18,FMN GV 16 Berchem TOT
54,Posthofbrug 5366,2019-11-03,01:00:00,19,4,15,FMN GV 16 Berchem TOT
54,Posthofbrug 5366,2019-11-03,02:00:00,7,1,6,FMN GV 16 Berchem TOT
54,Posthofbrug 5366,2019-11-03,03:00:00,11,3,8,FMN GV 16 Berchem TOT
54,Posthofbrug 5366,2019-11-03,04:00:00,11,2,9,FMN GV 16 Berchem TOT
54,Posthofbrug 5366,2019-11-03,05:00:00,17,9,8,FMN GV 16 Berchem TOT
54,Posthofbrug 5366,2019-11-03,06:00:00,6,4,2,FMN GV 16 Berchem TOT
54,Posthofbrug 5366,2019-11-03,07:00:00,9,4,5,FMN GV 16 Berchem TOT
54,Posthofbrug 5366,2019-11-03,08:00:00,33,17,16,FMN GV 16 Berchem TOT
54,Posthofbrug 5366,2019-11-03,09:00:00,38,23,15,FMN GV 16 Berchem TOT
54,Posthofbrug 5366,2019-11-03,10:00:00,90,59,31,FMN GV 16 Berchem TOT
54,Posthofbrug 5366,2019-11-03,11:00:00,48,32,16,FMN GV 16 Berchem TOT
54,Posthofbrug 5366,2019-11-03,12:00:00,54,31,23,FMN GV 16 Berchem TOT
54,Posthofbrug 5366,2019-11-03,13:00:00,44,22,22,FMN GV 16 Berchem TOT
54,Posthofbrug 5366,2019-11-03,14:00:00,44,22,22,FMN GV 16 Berchem TOT
54,Posthofbrug 5366,2019-11-03,15:00:00,33,20,13,FMN GV 16 Berchem TOT
54,Posthofbrug 5366,2019-11-03,16:00:00,38,16,22,FMN GV 16 Berchem TOT
54,Posthofbrug 5366,2019-11-03,17:00:00,56,27,29,FMN GV 16 Berchem TOT
54,Posthofbrug 5366,2019-11-03,18:00:00,48,24,24,FMN GV 16 Berchem TOT
54,Posthofbrug 5366,2019-11-03,19:00:00,33,11,22,FMN GV 16 Berchem TOT
54,Posthofbrug 5366,2019-11-03,20:00:00,38,16,22,FMN GV 16 Berchem TOT
54,Posthofbrug 5366,2019-11-03,21:00:00,17,7,10,FMN GV 16 Berchem TOT
54,Posthofbrug 5366,2019-11-03,22:00:00,23,13,10,FMN GV 16 Berchem TOT
54,Posthofbrug 5366,2019-11-03,23:00:00,12,1,11,FMN GV 16 Berchem TOT
54,Posthofbrug 5366,2019-11-04,00:00:00,3,2,1,FMN GV 16 Berchem TOT
54,Posthofbrug 5366,2019-11-04,01:00:00,1,0,1,FMN GV 16 Berchem TOT
54,Posthofbrug 5366,2019-11-04,02:00:00,2,1,1,FMN GV 16 Berchem TOT
54,Posthofbrug 5366,2019-11-04,03:00:00,1,1,0,FMN GV 16 Berchem TOT
54,Posthofbrug 5366,2019-11-04,04:00:00,12,9,3,FMN GV 16 Berchem TOT
54,Posthofbrug 5366,2019-11-04,05:00:00,21,16,5,FMN GV 16 Berchem TOT
54,Posthofbrug 5366,2019-11-04,06:00:00,109,90,19,FMN GV 16 Berchem TOT
54,Posthofbrug 5366,2019-11-04,07:00:00,386,294,92,FMN GV 16 Berchem TOT
54,Posthofbrug 5366,2019-11-04,08:00:00,667,453,214,FMN GV 16 Berchem TOT
54,Posthofbrug 5366,2019-11-04,09:00:00,205,148,57,FMN GV 16 Berchem TOT
54,Posthofbrug 5366,2019-11-04,10:00:00,96,62,34,FMN GV 16 Berchem TOT
54,Posthofbrug 5366,2019-11-04,11:00:00,79,49,30,FMN GV 16 Berchem TOT
54,Posthofbrug 5366,2019-11-04,12:00:00,103,67,36,FMN GV 16 Berchem TOT
54,Posthofbrug 5366,2019-11-04,13:00:00,115,49,66,FMN GV 16 Berchem TOT
54,Posthofbrug 5366,2019-11-04,14:00:00,107,60,47,FMN GV 16 Berchem TOT
54,Posthofbrug 5366,2019-11-04,15:00:00,182,62,120,FMN GV 16 Berchem TOT
54,Posthofbrug 5366,2019-11-04,16:00:00,350,135,215,FMN GV 16 Berchem TOT
54,Posthofbrug 5366,2019-11-04,17:00:00,428,171,257,FMN GV 16 Berchem TOT
54,Posthofbrug 5366,2019-11-04,18:00:00,287,98,189,FMN GV 16 Berchem TOT
54,Posthofbrug 5366,2019-11-04,19:00:00,133,51,82,FMN GV 16 Berchem TOT
54,Posthofbrug 5366,2019-11-04,20:00:00,79,40,39,FMN GV 16 Berchem TOT
54,Posthofbrug 5366,2019-11-04,21:00:00,43,15,28,FMN GV 16 Berchem TOT
54,Posthofbrug 5366,2019-11-04,22:00:00,53,24,29,FMN GV 16 Berchem TOT
54,Posthofbrug 5366,2019-11-04,23:00:00,31,8,23,FMN GV 16 Berchem TOT
54,Posthofbrug 5366,2019-11-05,00:00:00,11,3,8,FMN GV 16 Berchem TOT
54,Posthofbrug 5366,2019-11-05,01:00:00,8,1,7,FMN GV 16 Berchem TOT
54,Posthofbrug 5366,2019-11-05,02:00:00,2,1,1,FMN GV 16 Berchem TOT
54,Posthofbrug 5366,2019-11-05,03:00:00,4,1,3,FMN GV 16 Berchem TOT
54,Posthofbrug 5366,2019-11-05,04:00:00,9,8,1,FMN GV 16 Berchem TOT
54,Posthofbrug 5366,2019-11-05,05:00:00,20,15,5,FMN GV 16 Berchem TOT
54,Posthofbrug 5366,2019-11-05,06:00:00,121,102,19,FMN GV 16 Berchem TOT
54,Posthofbrug 5366,2019-11-05,07:00:00,426,316,110,FMN GV 16 Berchem TOT
54,Posthofbrug 5366,2019-11-05,08:00:00,704,489,215,FMN GV 16 Berchem TOT
54,Posthofbrug 5366,2019-11-05,09:00:00,204,151,53,FMN GV 16 Berchem TOT
54,Posthofbrug 5366,2019-11-05,10:00:00,102,70,32,FMN GV 16 Berchem TOT
54,Posthofbrug 5366,2019-11-05,11:00:00,96,64,32,FMN GV 16 Berchem TOT
54,Posthofbrug 5366,2019-11-05,12:00:00,146,77,69,FMN GV 16 Berchem TOT
54,Posthofbrug 5366,2019-11-05,13:00:00,128,60,68,FMN GV 16 Berchem TOT
54,Posthofbrug 5366,2019-11-05,14:00:00,121,51,70,FMN GV 16 Berchem TOT
54,Posthofbrug 5366,2019-11-05,15:00:00,202,77,125,FMN GV 16 Berchem TOT
54,Posthofbrug 5366,2019-11-05,16:00:00,406,157,249,FMN GV 16 Berchem TOT
54,Posthofbrug 5366,2019-11-05,17:00:00,481,163,318,FMN GV 16 Berchem TOT
54,Posthofbrug 5366,2019-11-05,18:00:00,352,127,225,FMN GV 16 Berchem TOT
54,Posthofbrug 5366,2019-11-05,19:00:00,146,53,93,FMN GV 16 Berchem TOT
54,Posthofbrug 5366,2019-11-05,20:00:00,89,41,48,FMN GV 16 Berchem TOT
54,Posthofbrug 5366,2019-11-05,21:00:00,90,49,41,FMN GV 16 Berchem TOT
54,Posthofbrug 5366,2019-11-05,22:00:00,69,23,46,FMN GV 16 Berchem TOT
54,Posthofbrug 5366,2019-11-05,23:00:00,45,15,30,FMN GV 16 Berchem TOT
54,Posthofbrug 5366,2019-11-06,00:00:00,16,3,13,FMN GV 16 Berchem TOT
54,Posthofbrug 5366,2019-11-06,01:00:00,3,1,2,FMN GV 16 Berchem TOT
54,Posthofbrug 5366,2019-11-06,02:00:00,6,1,5,FMN GV 16 Berchem TOT
54,Posthofbrug 5366,2019-11-06,03:00:00,3,1,2,FMN GV 16 Berchem TOT
54,Posthofbrug 5366,2019-11-06,04:00:00,7,4,3,FMN GV 16 Berchem TOT
54,Posthofbrug 5366,2019-11-06,05:00:00,20,15,5,FMN GV 16 Berchem TOT
54,Posthofbrug 5366,2019-11-06,06:00:00,100,84,16,FMN GV 16 Berchem TOT
54,Posthofbrug 5366,2019-11-06,07:00:00,350,261,89,FMN GV 16 Berchem TOT
54,Posthofbrug 5366,2019-11-06,08:00:00,570,374,196,FMN GV 16 Berchem TOT
54,Posthofbrug 5366,2019-11-06,09:00:00,182,117,65,FMN GV 16 Berchem TOT
54,Posthofbrug 5366,2019-11-06,10:00:00,86,57,29,FMN GV 16 Berchem TOT
54,Posthofbrug 5366,2019-11-06,11:00:00,91,59,32,FMN GV 16 Berchem TOT
54,Posthofbrug 5366,2019-11-06,12:00:00,189,105,84,FMN GV 16 Berchem TOT
54,Posthofbrug 5366,2019-11-06,13:00:00,147,73,74,FMN GV 16 Berchem TOT
54,Posthofbrug 5366,2019-11-06,14:00:00,127,55,72,FMN GV 16 Berchem TOT
54,Posthofbrug 5366,2019-11-06,15:00:00,160,77,83,FMN GV 16 Berchem TOT
54,Posthofbrug 5366,2019-11-06,16:00:00,272,129,143,FMN GV 16 Berchem TOT
54,Posthofbrug 5366,2019-11-06,17:00:00,429,152,277,FMN GV 16 Berchem TOT
54,Posthofbrug 5366,2019-11-06,18:00:00,252,88,164,FMN GV 16 Berchem TOT
54,Posthofbrug 5366,2019-11-06,19:00:00,135,56,79,FMN GV 16 Berchem TOT
54,Posthofbrug 5366,2019-11-06,20:00:00,71,36,35,FMN GV 16 Berchem TOT
54,Posthofbrug 5366,2019-11-06,21:00:00,56,19,37,FMN GV 16 Berchem TOT
54,Posthofbrug 5366,2019-11-06,22:00:00,47,23,24,FMN GV 16 Berchem TOT
54,Posthofbrug 5366,2019-11-06,23:00:00,25,7,18,FMN GV 16 Berchem TOT
54,Posthofbrug 5366,2019-11-07,00:00:00,23,6,17,FMN GV 16 Berchem TOT
54,Posthofbrug 5366,2019-11-07,01:00:00,5,0,5,FMN GV 16 Berchem TOT
54,Posthofbrug 5366,2019-11-07,02:00:00,3,1,2,FMN GV 16 Berchem TOT
54,Posthofbrug 5366,2019-11-07,03:00:00,1,0,1,FMN GV 16 Berchem TOT
54,Posthofbrug 5366,2019-11-07,04:00:00,10,7,3,FMN GV 16 Berchem TOT
54,Posthofbrug 5366,2019-11-07,05:00:00,15,13,2,FMN GV 16 Berchem TOT
54,Posthofbrug 5366,2019-11-07,06:00:00,86,71,15,FMN GV 16 Berchem TOT
54,Posthofbrug 5366,2019-11-07,07:00:00,345,264,81,FMN GV 16 Berchem TOT
54,Posthofbrug 5366,2019-11-07,08:00:00,611,442,169,FMN GV 16 Berchem TOT
54,Posthofbrug 5366,2019-11-07,09:00:00,203,139,64,FMN GV 16 Berchem TOT
54,Posthofbrug 5366,2019-11-07,10:00:00,62,44,18,FMN GV 16 Berchem TOT
54,Posthofbrug 5366,2019-11-07,11:00:00,60,37,23,FMN GV 16 Berchem TOT
54,Posthofbrug 5366,2019-11-07,12:00:00,67,36,31,FMN GV 16 Berchem TOT
54,Posthofbrug 5366,2019-11-07,13:00:00,92,50,42,FMN GV 16 Berchem TOT
54,Posthofbrug 5366,2019-11-07,14:00:00,87,38,49,FMN GV 16 Berchem TOT
54,Posthofbrug 5366,2019-11-07,15:00:00,172,78,94,FMN GV 16 Berchem TOT
54,Posthofbrug 5366,2019-11-07,16:00:00,290,114,176,FMN GV 16 Berchem TOT
54,Posthofbrug 5366,2019-11-07,17:00:00,380,143,237,FMN GV 16 Berchem TOT
54,Posthofbrug 5366,2019-11-07,18:00:00,293,106,187,FMN GV 16 Berchem TOT
54,Posthofbrug 5366,2019-11-07,19:00:00,136,58,78,FMN GV 16 Berchem TOT
54,Posthofbrug 5366,2019-11-07,20:00:00,69,34,35,FMN GV 16 Berchem TOT
54,Posthofbrug 5366,2019-11-07,21:00:00,56,25,31,FMN GV 16 Berchem TOT
54,Posthofbrug 5366,2019-11-07,22:00:00,58,14,44,FMN GV 16 Berchem TOT
54,Posthofbrug 5366,2019-11-07,23:00:00,48,11,37,FMN GV 16 Berchem TOT
54,Posthofbrug 5366,2019-11-08,00:00:00,24,2,22,FMN GV 16 Berchem TOT
54,Posthofbrug 5366,2019-11-08,01:00:00,10,4,6,FMN GV 16 Berchem TOT
54,Posthofbrug 5366,2019-11-08,02:00:00,6,2,4,FMN GV 16 Berchem TOT
54,Posthofbrug 5366,2019-11-08,03:00:00,1,0,1,FMN GV 16 Berchem TOT
54,Posthofbrug 5366,2019-11-08,04:00:00,8,6,2,FMN GV 16 Berchem TOT
54,Posthofbrug 5366,2019-11-08,05:00:00,22,13,9,FMN GV 16 Berchem TOT
54,Posthofbrug 5366,2019-11-08,06:00:00,71,56,15,FMN GV 16 Berchem TOT
54,Posthofbrug 5366,2019-11-08,07:00:00,304,241,63,FMN GV 16 Berchem TOT
54,Posthofbrug 5366,2019-11-08,08:00:00,571,420,151,FMN GV 16 Berchem TOT
54,Posthofbrug 5366,2019-11-08,09:00:00,216,154,62,FMN GV 16 Berchem TOT
54,Posthofbrug 5366,2019-11-08,10:00:00,103,70,33,FMN GV 16 Berchem TOT
54,Posthofbrug 5366,2019-11-08,11:00:00,105,61,44,FMN GV 16 Berchem TOT
54,Posthofbrug 5366,2019-11-08,12:00:00,144,88,56,FMN GV 16 Berchem TOT
54,Posthofbrug 5366,2019-11-08,13:00:00,129,65,64,FMN GV 16 Berchem TOT
54,Posthofbrug 5366,2019-11-08,14:00:00,132,56,76,FMN GV 16 Berchem TOT
54,Posthofbrug 5366,2019-11-08,15:00:00,201,91,110,FMN GV 16 Berchem TOT
54,Posthofbrug 5366,2019-11-08,16:00:00,370,151,219,FMN GV 16 Berchem TOT
54,Posthofbrug 5366,2019-11-08,17:00:00,394,169,225,FMN GV 16 Berchem TOT
54,Posthofbrug 5366,2019-11-08,18:00:00,237,95,142,FMN GV 16 Berchem TOT
54,Posthofbrug 5366,2019-11-08,19:00:00,120,48,72,FMN GV 16 Berchem TOT
54,Posthofbrug 5366,2019-11-08,20:00:00,72,38,34,FMN GV 16 Berchem TOT
54,Posthofbrug 5366,2019-11-08,21:00:00,42,26,16,FMN GV 16 Berchem TOT
54,Posthofbrug 5366,2019-11-08,22:00:00,46,23,23,FMN GV 16 Berchem TOT
54,Posthofbrug 5366,2019-11-08,23:00:00,50,10,40,FMN GV 16 Berchem TOT
54,Posthofbrug 5366,2019-11-09,00:00:00,53,14,39,FMN GV 16 Berchem TOT
54,Posthofbrug 5366,2019-11-09,01:00:00,16,2,14,FMN GV 16 Berchem TOT
54,Posthofbrug 5366,2019-11-09,02:00:00,30,7,23,FMN GV 16 Berchem TOT
54,Posthofbrug 5366,2019-11-09,03:00:00,8,0,8,FMN GV 16 Berchem TOT
54,Posthofbrug 5366,2019-11-09,04:00:00,12,1,11,FMN GV 16 Berchem TOT
54,Posthofbrug 5366,2019-11-09,05:00:00,11,5,6,FMN GV 16 Berchem TOT
54,Posthofbrug 5366,2019-11-09,06:00:00,14,9,5,FMN GV 16 Berchem TOT
54,Posthofbrug 5366,2019-11-09,07:00:00,18,10,8,FMN GV 16 Berchem TOT
54,Posthofbrug 5366,2019-11-09,08:00:00,40,24,16,FMN GV 16 Berchem TOT
54,Posthofbrug 5366,2019-11-09,09:00:00,75,50,25,FMN GV 16 Berchem TOT
54,Posthofbrug 5366,2019-11-09,10:00:00,79,59,20,FMN GV 16 Berchem TOT
54,Posthofbrug 5366,2019-11-09,11:00:00,93,63,30,FMN GV 16 Berchem TOT
54,Posthofbrug 5366,2019-11-09,12:00:00,100,60,40,FMN GV 16 Berchem TOT
54,Posthofbrug 5366,2019-11-09,13:00:00,122,83,39,FMN GV 16 Berchem TOT
54,Posthofbrug 5366,2019-11-09,14:00:00,115,69,46,FMN GV 16 Berchem TOT
54,Posthofbrug 5366,2019-11-09,15:00:00,119,51,68,FMN GV 16 Berchem TOT
54,Posthofbrug 5366,2019-11-09,16:00:00,110,55,55,FMN GV 16 Berchem TOT
54,Posthofbrug 5366,2019-11-09,17:00:00,131,61,70,FMN GV 16 Berchem TOT
54,Posthofbrug 5366,2019-11-09,18:00:00,92,47,45,FMN GV 16 Berchem TOT
54,Posthofbrug 5366,2019-11-09,19:00:00,84,51,33,FMN GV 16 Berchem TOT
54,Posthofbrug 5366,2019-11-09,20:00:00,81,30,51,FMN GV 16 Berchem TOT
54,Posthofbrug 5366,2019-11-09,21:00:00,37,22,15,FMN GV 16 Berchem TOT
54,Posthofbrug 5366,2019-11-09,22:00:00,41,20,21,FMN GV 16 Berchem TOT
54,Posthofbrug 5366,2019-11-09,23:00:00,41,21,20,FMN GV 16 Berchem TOT
54,Posthofbrug 5366,2019-11-10,00:00:00,39,10,29,FMN GV 16 Berchem TOT
54,Posthofbrug 5366,2019-11-10,01:00:00,34,14,20,FMN GV 16 Berchem TOT
54,Posthofbrug 5366,2019-11-10,02:00:00,19,7,12,FMN GV 16 Berchem TOT
54,Posthofbrug 5366,2019-11-10,03:00:00,10,4,6,FMN GV 16 Berchem TOT
54,Posthofbrug 5366,2019-11-10,04:00:00,14,3,11,FMN GV 16 Berchem TOT
54,Posthofbrug 5366,2019-11-10,05:00:00,9,5,4,FMN GV 16 Berchem TOT
54,Posthofbrug 5366,2019-11-10,06:00:00,12,7,5,FMN GV 16 Berchem TOT
54,Posthofbrug 5366,2019-11-10,07:00:00,16,9,7,FMN GV 16 Berchem TOT
54,Posthofbrug 5366,2019-11-10,08:00:00,25,17,8,FMN GV 16 Berchem TOT
54,Posthofbrug 5366,2019-11-10,09:00:00,53,25,28,FMN GV 16 Berchem TOT
54,Posthofbrug 5366,2019-11-10,10:00:00,67,37,30,FMN GV 16 Berchem TOT
54,Posthofbrug 5366,2019-11-10,11:00:00,96,60,36,FMN GV 16 Berchem TOT
54,Posthofbrug 5366,2019-11-10,12:00:00,89,52,37,FMN GV 16 Berchem TOT
54,Posthofbrug 5366,2019-11-10,13:00:00,82,40,42,FMN GV 16 Berchem TOT
54,Posthofbrug 5366,2019-11-10,14:00:00,117,61,56,FMN GV 16 Berchem TOT
54,Posthofbrug 5366,2019-11-10,15:00:00,98,42,56,FMN GV 16 Berchem TOT
54,Posthofbrug 5366,2019-11-10,16:00:00,78,35,43,FMN GV 16 Berchem TOT
54,Posthofbrug 5366,2019-11-10,17:00:00,113,58,55,FMN GV 16 Berchem TOT
54,Posthofbrug 5366,2019-11-10,18:00:00,55,34,21,FMN GV 16 Berchem TOT
54,Posthofbrug 5366,2019-11-10,19:00:00,57,36,21,FMN GV 16 Berchem TOT
54,Posthofbrug 5366,2019-11-10,20:00:00,52,28,24,FMN GV 16 Berchem TOT
54,Posthofbrug 5366,2019-11-10,21:00:00,39,23,16,FMN GV 16 Berchem TOT
54,Posthofbrug 5366,2019-11-10,22:00:00,37,23,14,FMN GV 16 Berchem TOT
54,Posthofbrug 5366,2019-11-10,23:00:00,35,13,22,FMN GV 16 Berchem TOT
54,Posthofbrug 5366,2019-11-11,00:00:00,16,5,11,FMN GV 16 Berchem TOT
54,Posthofbrug 5366,2019-11-11,01:00:00,13,2,11,FMN GV 16 Berchem TOT
54,Posthofbrug 5366,2019-11-11,02:00:00,13,3,10,FMN GV 16 Berchem TOT
54,Posthofbrug 5366,2019-11-11,03:00:00,9,3,6,FMN GV 16 Berchem TOT
54,Posthofbrug 5366,2019-11-11,04:00:00,6,3,3,FMN GV 16 Berchem TOT
54,Posthofbrug 5366,2019-11-11,05:00:00,26,10,16,FMN GV 16 Berchem TOT
54,Posthofbrug 5366,2019-11-11,06:00:00,19,11,8,FMN GV 16 Berchem TOT
54,Posthofbrug 5366,2019-11-11,07:00:00,36,15,21,FMN GV 16 Berchem TOT
54,Posthofbrug 5366,2019-11-11,08:00:00,28,16,12,FMN GV 16 Berchem TOT
54,Posthofbrug 5366,2019-11-11,09:00:00,34,23,11,FMN GV 16 Berchem TOT
54,Posthofbrug 5366,2019-11-11,10:00:00,46,30,16,FMN GV 16 Berchem TOT
54,Posthofbrug 5366,2019-11-11,11:00:00,49,33,16,FMN GV 16 Berchem TOT
54,Posthofbrug 5366,2019-11-11,12:00:00,46,27,19,FMN GV 16 Berchem TOT
54,Posthofbrug 5366,2019-11-11,13:00:00,37,25,12,FMN GV 16 Berchem TOT
54,Posthofbrug 5366,2019-11-11,14:00:00,22,9,13,FMN GV 16 Berchem TOT
54,Posthofbrug 5366,2019-11-11,15:00:00,20,8,12,FMN GV 16 Berchem TOT
54,Posthofbrug 5366,2019-11-11,16:00:00,36,10,26,FMN GV 16 Berchem TOT
54,Posthofbrug 5366,2019-11-11,17:00:00,36,17,19,FMN GV 16 Berchem TOT
54,Posthofbrug 5366,2019-11-11,18:00:00,33,13,20,FMN GV 16 Berchem TOT
54,Posthofbrug 5366,2019-11-11,19:00:00,32,13,19,FMN GV 16 Berchem TOT
54,Posthofbrug 5366,2019-11-11,20:00:00,36,18,18,FMN GV 16 Berchem TOT
54,Posthofbrug 5366,2019-11-11,21:00:00,21,12,9,FMN GV 16 Berchem TOT
54,Posthofbrug 5366,2019-11-11,22:00:00,14,7,7,FMN GV 16 Berchem TOT
54,Posthofbrug 5366,2019-11-11,23:00:00,10,3,7,FMN GV 16 Berchem TOT
54,Posthofbrug 5366,2019-11-12,00:00:00,5,0,5,FMN GV 16 Berchem TOT
54,Posthofbrug 5366,2019-11-12,01:00:00,2,0,2,FMN GV 16 Berchem TOT
54,Posthofbrug 5366,2019-11-12,02:00:00,3,1,2,FMN GV 16 Berchem TOT
54,Posthofbrug 5366,2019-11-12,03:00:00,1,0,1,FMN GV 16 Berchem TOT
54,Posthofbrug 5366,2019-11-12,04:00:00,4,4,0,FMN GV 16 Berchem TOT
54,Posthofbrug 5366,2019-11-12,05:00:00,14,13,1,FMN GV 16 Berchem TOT
54,Posthofbrug 5366,2019-11-12,06:00:00,90,78,12,FMN GV 16 Berchem TOT
54,Posthofbrug 5366,2019-11-12,07:00:00,377,289,88,FMN GV 16 Berchem TOT
54,Posthofbrug 5366,2019-11-12,08:00:00,586,427,159,FMN GV 16 Berchem TOT
54,Posthofbrug 5366,2019-11-12,09:00:00,197,143,54,FMN GV 16 Berchem TOT
54,Posthofbrug 5366,2019-11-12,10:00:00,77,59,18,FMN GV 16 Berchem TOT
54,Posthofbrug 5366,2019-11-12,11:00:00,60,37,23,FMN GV 16 Berchem TOT
54,Posthofbrug 5366,2019-11-12,12:00:00,112,65,47,FMN GV 16 Berchem TOT
54,Posthofbrug 5366,2019-11-12,13:00:00,114,60,54,FMN GV 16 Berchem TOT
54,Posthofbrug 5366,2019-11-12,14:00:00,94,52,42,FMN GV 16 Berchem TOT
54,Posthofbrug 5366,2019-11-12,15:00:00,163,63,100,FMN GV 16 Berchem TOT
54,Posthofbrug 5366,2019-11-12,16:00:00,351,122,229,FMN GV 16 Berchem TOT
54,Posthofbrug 5366,2019-11-12,17:00:00,405,151,254,FMN GV 16 Berchem TOT
54,Posthofbrug 5366,2019-11-12,18:00:00,277,97,180,FMN GV 16 Berchem TOT
54,Posthofbrug 5366,2019-11-12,19:00:00,125,44,81,FMN GV 16 Berchem TOT
54,Posthofbrug 5366,2019-11-12,20:00:00,56,22,34,FMN GV 16 Berchem TOT
54,Posthofbrug 5366,2019-11-12,21:00:00,59,30,29,FMN GV 16 Berchem TOT
54,Posthofbrug 5366,2019-11-12,22:00:00,51,22,29,FMN GV 16 Berchem TOT
54,Posthofbrug 5366,2019-11-12,23:00:00,46,12,34,FMN GV 16 Berchem TOT
54,Posthofbrug 5366,2019-11-13,00:00:00,11,4,7,FMN GV 16 Berchem TOT
54,Posthofbrug 5366,2019-11-13,01:00:00,1,1,0,FMN GV 16 Berchem TOT
54,Posthofbrug 5366,2019-11-13,02:00:00,6,1,5,FMN GV 16 Berchem TOT
54,Posthofbrug 5366,2019-11-13,03:00:00,0,0,0,FMN GV 16 Berchem TOT
54,Posthofbrug 5366,2019-11-13,04:00:00,7,3,4,FMN GV 16 Berchem TOT
54,Posthofbrug 5366,2019-11-13,05:00:00,16,11,5,FMN GV 16 Berchem TOT
54,Posthofbrug 5366,2019-11-13,06:00:00,102,80,22,FMN GV 16 Berchem TOT
54,Posthofbrug 5366,2019-11-13,07:00:00,348,262,86,FMN GV 16 Berchem TOT
54,Posthofbrug 5366,2019-11-13,08:00:00,545,375,170,FMN GV 16 Berchem TOT
54,Posthofbrug 5366,2019-11-13,09:00:00,195,140,55,FMN GV 16 Berchem TOT
54,Posthofbrug 5366,2019-11-13,10:00:00,71,48,23,FMN GV 16 Berchem TOT
54,Posthofbrug 5366,2019-11-13,11:00:00,94,56,38,FMN GV 16 Berchem TOT
54,Posthofbrug 5366,2019-11-13,12:00:00,198,101,97,FMN GV 16 Berchem TOT
54,Posthofbrug 5366,2019-11-13,13:00:00,149,76,73,FMN GV 16 Berchem TOT
54,Posthofbrug 5366,2019-11-13,14:00:00,125,65,60,FMN GV 16 Berchem TOT
54,Posthofbrug 5366,2019-11-13,15:00:00,125,61,64,FMN GV 16 Berchem TOT
54,Posthofbrug 5366,2019-11-13,16:00:00,257,104,153,FMN GV 16 Berchem TOT
54,Posthofbrug 5366,2019-11-13,17:00:00,411,168,243,FMN GV 16 Berchem TOT
54,Posthofbrug 5366,2019-11-13,18:00:00,238,91,147,FMN GV 16 Berchem TOT
54,Posthofbrug 5366,2019-11-13,19:00:00,123,39,84,FMN GV 16 Berchem TOT
54,Posthofbrug 5366,2019-11-13,20:00:00,95,47,48,FMN GV 16 Berchem TOT
54,Posthofbrug 5366,2019-11-13,21:00:00,49,28,21,FMN GV 16 Berchem TOT
54,Posthofbrug 5366,2019-11-13,22:00:00,56,23,33,FMN GV 16 Berchem TOT
54,Posthofbrug 5366,2019-11-13,23:00:00,48,19,29,FMN GV 16 Berchem TOT
54,Posthofbrug 5366,2019-11-14,00:00:00,16,2,14,FMN GV 16 Berchem TOT
54,Posthofbrug 5366,2019-11-14,01:00:00,8,0,8,FMN GV 16 Berchem TOT
54,Posthofbrug 5366,2019-11-14,02:00:00,1,0,1,FMN GV 16 Berchem TOT
54,Posthofbrug 5366,2019-11-14,03:00:00,5,0,5,FMN GV 16 Berchem TOT
54,Posthofbrug 5366,2019-11-14,04:00:00,12,6,6,FMN GV 16 Berchem TOT
54,Posthofbrug 5366,2019-11-14,05:00:00,17,11,6,FMN GV 16 Berchem TOT
54,Posthofbrug 5366,2019-11-14,06:00:00,84,66,18,FMN GV 16 Berchem TOT
54,Posthofbrug 5366,2019-11-14,07:00:00,326,249,77,FMN GV 16 Berchem TOT
54,Posthofbrug 5366,2019-11-14,08:00:00,585,411,174,FMN GV 16 Berchem TOT
54,Posthofbrug 5366,2019-11-14,09:00:00,212,149,63,FMN GV 16 Berchem TOT
54,Posthofbrug 5366,2019-11-14,10:00:00,89,66,23,FMN GV 16 Berchem TOT
54,Posthofbrug 5366,2019-11-14,11:00:00,67,45,22,FMN GV 16 Berchem TOT
54,Posthofbrug 5366,2019-11-14,12:00:00,102,62,40,FMN GV 16 Berchem TOT
54,Posthofbrug 5366,2019-11-14,13:00:00,94,53,41,FMN GV 16 Berchem TOT
54,Posthofbrug 5366,2019-11-14,14:00:00,99,43,56,FMN GV 16 Berchem TOT
54,Posthofbrug 5366,2019-11-14,15:00:00,170,72,98,FMN GV 16 Berchem TOT
54,Posthofbrug 5366,2019-11-14,16:00:00,283,109,174,FMN GV 16 Berchem TOT
54,Posthofbrug 5366,2019-11-14,17:00:00,419,176,243,FMN GV 16 Berchem TOT
54,Posthofbrug 5366,2019-11-14,18:00:00,252,93,159,FMN GV 16 Berchem TOT
54,Posthofbrug 5366,2019-11-14,19:00:00,130,53,77,FMN GV 16 Berchem TOT
54,Posthofbrug 5366,2019-11-14,20:00:00,98,47,51,FMN GV 16 Berchem TOT
54,Posthofbrug 5366,2019-11-14,21:00:00,50,18,32,FMN GV 16 Berchem TOT
54,Posthofbrug 5366,2019-11-14,22:00:00,57,24,33,FMN GV 16 Berchem TOT
54,Posthofbrug 5366,2019-11-14,23:00:00,33,11,22,FMN GV 16 Berchem TOT
54,Posthofbrug 5366,2019-11-15,00:00:00,27,5,22,FMN GV 16 Berchem TOT
54,Posthofbrug 5366,2019-11-15,01:00:00,14,2,12,FMN GV 16 Berchem TOT
54,Posthofbrug 5366,2019-11-15,02:00:00,5,1,4,FMN GV 16 Berchem TOT
54,Posthofbrug 5366,2019-11-15,03:00:00,4,0,4,FMN GV 16 Berchem TOT
54,Posthofbrug 5366,2019-11-15,04:00:00,4,2,2,FMN GV 16 Berchem TOT
54,Posthofbrug 5366,2019-11-15,05:00:00,27,15,12,FMN GV 16 Berchem TOT
54,Posthofbrug 5366,2019-11-15,06:00:00,81,67,14,FMN GV 16 Berchem TOT
54,Posthofbrug 5366,2019-11-15,07:00:00,265,195,70,FMN GV 16 Berchem TOT
54,Posthofbrug 5366,2019-11-15,08:00:00,485,338,147,FMN GV 16 Berchem TOT
54,Posthofbrug 5366,2019-11-15,09:00:00,156,112,44,FMN GV 16 Berchem TOT
54,Posthofbrug 5366,2019-11-15,10:00:00,72,53,19,FMN GV 16 Berchem TOT
54,Posthofbrug 5366,2019-11-15,11:00:00,71,43,28,FMN GV 16 Berchem TOT
54,Posthofbrug 5366,2019-11-15,12:00:00,99,45,54,FMN GV 16 Berchem TOT
54,Posthofbrug 5366,2019-11-15,13:00:00,95,42,53,FMN GV 16 Berchem TOT
54,Posthofbrug 5366,2019-11-15,14:00:00,95,29,66,FMN GV 16 Berchem TOT
54,Posthofbrug 5366,2019-11-15,15:00:00,166,73,93,FMN GV 16 Berchem TOT
54,Posthofbrug 5366,2019-11-15,16:00:00,282,132,150,FMN GV 16 Berchem TOT
54,Posthofbrug 5366,2019-11-15,17:00:00,297,107,190,FMN GV 16 Berchem TOT
54,Posthofbrug 5366,2019-11-15,18:00:00,201,94,107,FMN GV 16 Berchem TOT
54,Posthofbrug 5366,2019-11-15,19:00:00,91,49,42,FMN GV 16 Berchem TOT
54,Posthofbrug 5366,2019-11-15,20:00:00,62,32,30,FMN GV 16 Berchem TOT
54,Posthofbrug 5366,2019-11-15,21:00:00,45,20,25,FMN GV 16 Berchem TOT
54,Posthofbrug 5366,2019-11-15,22:00:00,42,19,23,FMN GV 16 Berchem TOT
54,Posthofbrug 5366,2019-11-15,23:00:00,39,11,28,FMN GV 16 Berchem TOT
54,Posthofbrug 5366,2019-11-16,00:00:00,41,12,29,FMN GV 16 Berchem TOT
54,Posthofbrug 5366,2019-11-16,01:00:00,26,10,16,FMN GV 16 Berchem TOT
54,Posthofbrug 5366,2019-11-16,02:00:00,23,6,17,FMN GV 16 Berchem TOT
54,Posthofbrug 5366,2019-11-16,03:00:00,13,3,10,FMN GV 16 Berchem TOT
54,Posthofbrug 5366,2019-11-16,04:00:00,6,3,3,FMN GV 16 Berchem TOT
54,Posthofbrug 5366,2019-11-16,05:00:00,12,7,5,FMN GV 16 Berchem TOT
54,Posthofbrug 5366,2019-11-16,06:00:00,20,13,7,FMN GV 16 Berchem TOT
54,Posthofbrug 5366,2019-11-16,07:00:00,23,17,6,FMN GV 16 Berchem TOT
54,Posthofbrug 5366,2019-11-16,08:00:00,36,25,11,FMN GV 16 Berchem TOT
54,Posthofbrug 5366,2019-11-16,09:00:00,49,38,11,FMN GV 16 Berchem TOT
54,Posthofbrug 5366,2019-11-16,10:00:00,74,53,21,FMN GV 16 Berchem TOT
54,Posthofbrug 5366,2019-11-16,11:00:00,75,43,32,FMN GV 16 Berchem TOT
54,Posthofbrug 5366,2019-11-16,12:00:00,76,52,24,FMN GV 16 Berchem TOT
54,Posthofbrug 5366,2019-11-16,13:00:00,112,78,34,FMN GV 16 Berchem TOT
54,Posthofbrug 5366,2019-11-16,14:00:00,119,83,36,FMN GV 16 Berchem TOT
54,Posthofbrug 5366,2019-11-16,15:00:00,109,63,46,FMN GV 16 Berchem TOT
54,Posthofbrug 5366,2019-11-16,16:00:00,108,33,75,FMN GV 16 Berchem TOT
54,Posthofbrug 5366,2019-11-16,17:00:00,117,49,68,FMN GV 16 Berchem TOT
54,Posthofbrug 5366,2019-11-16,18:00:00,98,54,44,FMN GV 16 Berchem TOT
54,Posthofbrug 5366,2019-11-16,19:00:00,66,40,26,FMN GV 16 Berchem TOT
54,Posthofbrug 5366,2019-11-16,20:00:00,60,31,29,FMN GV 16 Berchem TOT
54,Posthofbrug 5366,2019-11-16,21:00:00,36,25,11,FMN GV 16 Berchem TOT
54,Posthofbrug 5366,2019-11-16,22:00:00,45,24,21,FMN GV 16 Berchem TOT
54,Posthofbrug 5366,2019-11-16,23:00:00,37,12,25,FMN GV 16 Berchem TOT
54,Posthofbrug 5366,2019-11-17,00:00:00,50,18,32,FMN GV 16 Berchem TOT
54,Posthofbrug 5366,2019-11-17,01:00:00,23,9,14,FMN GV 16 Berchem TOT
54,Posthofbrug 5366,2019-11-17,02:00:00,25,5,20,FMN GV 16 Berchem TOT
54,Posthofbrug 5366,2019-11-17,03:00:00,15,0,15,FMN GV 16 Berchem TOT
54,Posthofbrug 5366,2019-11-17,04:00:00,15,2,13,FMN GV 16 Berchem TOT
54,Posthofbrug 5366,2019-11-17,05:00:00,25,6,19,FMN GV 16 Berchem TOT
54,Posthofbrug 5366,2019-11-17,06:00:00,9,5,4,FMN GV 16 Berchem TOT
54,Posthofbrug 5366,2019-11-17,07:00:00,19,12,7,FMN GV 16 Berchem TOT
54,Posthofbrug 5366,2019-11-17,08:00:00,22,14,8,FMN GV 16 Berchem TOT
54,Posthofbrug 5366,2019-11-17,09:00:00,39,25,14,FMN GV 16 Berchem TOT
54,Posthofbrug 5366,2019-11-17,10:00:00,57,39,18,FMN GV 16 Berchem TOT
54,Posthofbrug 5366,2019-11-17,11:00:00,64,45,19,FMN GV 16 Berchem TOT
54,Posthofbrug 5366,2019-11-17,12:00:00,112,64,48,FMN GV 16 Berchem TOT
54,Posthofbrug 5366,2019-11-17,13:00:00,113,67,46,FMN GV 16 Berchem TOT
54,Posthofbrug 5366,2019-11-17,14:00:00,110,63,47,FMN GV 16 Berchem TOT
54,Posthofbrug 5366,2019-11-17,15:00:00,86,45,41,FMN GV 16 Berchem TOT
54,Posthofbrug 5366,2019-11-17,16:00:00,83,40,43,FMN GV 16 Berchem TOT
54,Posthofbrug 5366,2019-11-17,17:00:00,80,32,48,FMN GV 16 Berchem TOT
54,Posthofbrug 5366,2019-11-17,18:00:00,55,25,30,FMN GV 16 Berchem TOT
54,Posthofbrug 5366,2019-11-17,19:00:00,40,15,25,FMN GV 16 Berchem TOT
54,Posthofbrug 5366,2019-11-17,20:00:00,36,16,20,FMN GV 16 Berchem TOT
54,Posthofbrug 5366,2019-11-17,21:00:00,49,26,23,FMN GV 16 Berchem TOT
54,Posthofbrug 5366,2019-11-17,22:00:00,23,13,10,FMN GV 16 Berchem TOT
54,Posthofbrug 5366,2019-11-17,23:00:00,13,5,8,FMN GV 16 Berchem TOT
54,Posthofbrug 5366,2019-11-18,00:00:00,8,1,7,FMN GV 16 Berchem TOT
54,Posthofbrug 5366,2019-11-18,01:00:00,4,1,3,FMN GV 16 Berchem TOT
54,Posthofbrug 5366,2019-11-18,02:00:00,2,1,1,FMN GV 16 Berchem TOT
54,Posthofbrug 5366,2019-11-18,03:00:00,3,1,2,FMN GV 16 Berchem TOT
54,Posthofbrug 5366,2019-11-18,04:00:00,10,9,1,FMN GV 16 Berchem TOT
54,Posthofbrug 5366,2019-11-18,05:00:00,18,12,6,FMN GV 16 Berchem TOT
54,Posthofbrug 5366,2019-11-18,06:00:00,88,73,15,FMN GV 16 Berchem TOT
54,Posthofbrug 5366,2019-11-18,07:00:00,337,253,84,FMN GV 16 Berchem TOT
54,Posthofbrug 5366,2019-11-18,08:00:00,616,454,162,FMN GV 16 Berchem TOT
54,Posthofbrug 5366,2019-11-18,09:00:00,198,136,62,FMN GV 16 Berchem TOT
54,Posthofbrug 5366,2019-11-18,10:00:00,74,51,23,FMN GV 16 Berchem TOT
54,Posthofbrug 5366,2019-11-18,11:00:00,64,44,20,FMN GV 16 Berchem TOT
54,Posthofbrug 5366,2019-11-18,12:00:00,120,59,61,FMN GV 16 Berchem TOT
54,Posthofbrug 5366,2019-11-18,13:00:00,83,39,44,FMN GV 16 Berchem TOT
54,Posthofbrug 5366,2019-11-18,14:00:00,59,23,36,FMN GV 16 Berchem TOT
54,Posthofbrug 5366,2019-11-18,15:00:00,149,73,76,FMN GV 16 Berchem TOT
54,Posthofbrug 5366,2019-11-18,16:00:00,270,98,172,FMN GV 16 Berchem TOT
54,Posthofbrug 5366,2019-11-18,17:00:00,403,164,239,FMN GV 16 Berchem TOT
54,Posthofbrug 5366,2019-11-18,18:00:00,271,96,175,FMN GV 16 Berchem TOT
54,Posthofbrug 5366,2019-11-18,19:00:00,120,50,70,FMN GV 16 Berchem TOT
54,Posthofbrug 5366,2019-11-18,20:00:00,56,34,22,FMN GV 16 Berchem TOT
54,Posthofbrug 5366,2019-11-18,21:00:00,49,16,33,FMN GV 16 Berchem TOT
54,Posthofbrug 5366,2019-11-18,22:00:00,53,26,27,FMN GV 16 Berchem TOT
54,Posthofbrug 5366,2019-11-18,23:00:00,23,8,15,FMN GV 16 Berchem TOT
54,Posthofbrug 5366,2019-11-19,00:00:00,15,5,10,FMN GV 16 Berchem TOT
54,Posthofbrug 5366,2019-11-19,01:00:00,4,1,3,FMN GV 16 Berchem TOT
54,Posthofbrug 5366,2019-11-19,02:00:00,2,2,0,FMN GV 16 Berchem TOT
54,Posthofbrug 5366,2019-11-19,03:00:00,2,0,2,FMN GV 16 Berchem TOT
54,Posthofbrug 5366,2019-11-19,04:00:00,7,6,1,FMN GV 16 Berchem TOT
54,Posthofbrug 5366,2019-11-19,05:00:00,21,9,12,FMN GV 16 Berchem TOT
54,Posthofbrug 5366,2019-11-19,06:00:00,124,100,24,FMN GV 16 Berchem TOT
54,Posthofbrug 5366,2019-11-19,07:00:00,407,303,104,FMN GV 16 Berchem TOT
54,Posthofbrug 5366,2019-11-19,08:00:00,619,442,177,FMN GV 16 Berchem TOT
54,Posthofbrug 5366,2019-11-19,09:00:00,220,157,63,FMN GV 16 Berchem TOT
54,Posthofbrug 5366,2019-11-19,10:00:00,79,57,22,FMN GV 16 Berchem TOT
54,Posthofbrug 5366,2019-11-19,11:00:00,91,66,25,FMN GV 16 Berchem TOT
54,Posthofbrug 5366,2019-11-19,12:00:00,129,74,55,FMN GV 16 Berchem TOT
54,Posthofbrug 5366,2019-11-19,13:00:00,131,75,56,FMN GV 16 Berchem TOT
54,Posthofbrug 5366,2019-11-19,14:00:00,103,50,53,FMN GV 16 Berchem TOT
54,Posthofbrug 5366,2019-11-19,15:00:00,165,79,86,FMN GV 16 Berchem TOT
54,Posthofbrug 5366,2019-11-19,16:00:00,331,143,188,FMN GV 16 Berchem TOT
54,Posthofbrug 5366,2019-11-19,17:00:00,496,186,310,FMN GV 16 Berchem TOT
54,Posthofbrug 5366,2019-11-19,18:00:00,313,104,209,FMN GV 16 Berchem TOT
54,Posthofbrug 5366,2019-11-19,19:00:00,137,52,85,FMN GV 16 Berchem TOT
54,Posthofbrug 5366,2019-11-19,20:00:00,71,22,49,FMN GV 16 Berchem TOT
54,Posthofbrug 5366,2019-11-19,21:00:00,91,49,42,FMN GV 16 Berchem TOT
54,Posthofbrug 5366,2019-11-19,22:00:00,71,32,39,FMN GV 16 Berchem TOT
54,Posthofbrug 5366,2019-11-19,23:00:00,34,10,24,FMN GV 16 Berchem TOT
54,Posthofbrug 5366,2019-11-20,00:00:00,18,5,13,FMN GV 16 Berchem TOT
54,Posthofbrug 5366,2019-11-20,01:00:00,10,0,10,FMN GV 16 Berchem TOT
54,Posthofbrug 5366,2019-11-20,02:00:00,2,0,2,FMN GV 16 Berchem TOT
54,Posthofbrug 5366,2019-11-20,03:00:00,9,1,8,FMN GV 16 Berchem TOT
54,Posthofbrug 5366,2019-11-20,04:00:00,11,8,3,FMN GV 16 Berchem TOT
54,Posthofbrug 5366,2019-11-20,05:00:00,20,11,9,FMN GV 16 Berchem TOT
54,Posthofbrug 5366,2019-11-20,06:00:00,95,79,16,FMN GV 16 Berchem TOT
54,Posthofbrug 5366,2019-11-20,07:00:00,343,257,86,FMN GV 16 Berchem TOT
54,Posthofbrug 5366,2019-11-20,08:00:00,516,377,139,FMN GV 16 Berchem TOT
54,Posthofbrug 5366,2019-11-20,09:00:00,183,130,53,FMN GV 16 Berchem TOT
54,Posthofbrug 5366,2019-11-20,10:00:00,82,64,18,FMN GV 16 Berchem TOT
54,Posthofbrug 5366,2019-11-20,11:00:00,99,58,41,FMN GV 16 Berchem TOT
54,Posthofbrug 5366,2019-11-20,12:00:00,163,85,78,FMN GV 16 Berchem TOT
54,Posthofbrug 5366,2019-11-20,13:00:00,134,74,60,FMN GV 16 Berchem TOT
54,Posthofbrug 5366,2019-11-20,14:00:00,117,61,56,FMN GV 16 Berchem TOT
54,Posthofbrug 5366,2019-11-20,15:00:00,148,78,70,FMN GV 16 Berchem TOT
54,Posthofbrug 5366,2019-11-20,16:00:00,241,117,124,FMN GV 16 Berchem TOT
54,Posthofbrug 5366,2019-11-20,17:00:00,358,133,225,FMN GV 16 Berchem TOT
54,Posthofbrug 5366,2019-11-20,18:00:00,230,75,155,FMN GV 16 Berchem TOT
54,Posthofbrug 5366,2019-11-20,19:00:00,127,54,73,FMN GV 16 Berchem TOT
54,Posthofbrug 5366,2019-11-20,20:00:00,69,40,29,FMN GV 16 Berchem TOT
54,Posthofbrug 5366,2019-11-20,21:00:00,50,20,30,FMN GV 16 Berchem TOT
54,Posthofbrug 5366,2019-11-20,22:00:00,56,19,37,FMN GV 16 Berchem TOT
54,Posthofbrug 5366,2019-11-20,23:00:00,36,12,24,FMN GV 16 Berchem TOT
54,Posthofbrug 5366,2019-11-21,00:00:00,16,4,12,FMN GV 16 Berchem TOT
54,Posthofbrug 5366,2019-11-21,01:00:00,11,7,4,FMN GV 16 Berchem TOT
54,Posthofbrug 5366,2019-11-21,02:00:00,3,0,3,FMN GV 16 Berchem TOT
54,Posthofbrug 5366,2019-11-21,03:00:00,4,2,2,FMN GV 16 Berchem TOT
54,Posthofbrug 5366,2019-11-21,04:00:00,7,5,2,FMN GV 16 Berchem TOT
54,Posthofbrug 5366,2019-11-21,05:00:00,15,11,4,FMN GV 16 Berchem TOT
54,Posthofbrug 5366,2019-11-21,06:00:00,85,76,9,FMN GV 16 Berchem TOT
54,Posthofbrug 5366,2019-11-21,07:00:00,344,265,79,FMN GV 16 Berchem TOT
54,Posthofbrug 5366,2019-11-21,08:00:00,615,443,172,FMN GV 16 Berchem TOT
54,Posthofbrug 5366,2019-11-21,09:00:00,204,147,57,FMN GV 16 Berchem TOT
54,Posthofbrug 5366,2019-11-21,10:00:00,81,60,21,FMN GV 16 Berchem TOT
54,Posthofbrug 5366,2019-11-21,11:00:00,80,49,31,FMN GV 16 Berchem TOT
54,Posthofbrug 5366,2019-11-21,12:00:00,89,46,43,FMN GV 16 Berchem TOT
54,Posthofbrug 5366,2019-11-21,13:00:00,114,64,50,FMN GV 16 Berchem TOT
54,Posthofbrug 5366,2019-11-21,14:00:00,85,37,48,FMN GV 16 Berchem TOT
54,Posthofbrug 5366,2019-11-21,15:00:00,123,57,66,FMN GV 16 Berchem TOT
54,Posthofbrug 5366,2019-11-21,16:00:00,306,122,184,FMN GV 16 Berchem TOT
54,Posthofbrug 5366,2019-11-21,17:00:00,401,139,262,FMN GV 16 Berchem TOT
54,Posthofbrug 5366,2019-11-21,18:00:00,261,100,161,FMN GV 16 Berchem TOT
54,Posthofbrug 5366,2019-11-21,19:00:00,139,65,74,FMN GV 16 Berchem TOT
54,Posthofbrug 5366,2019-11-21,20:00:00,64,28,36,FMN GV 16 Berchem TOT
54,Posthofbrug 5366,2019-11-21,21:00:00,64,28,36,FMN GV 16 Berchem TOT
54,Posthofbrug 5366,2019-11-21,22:00:00,51,15,36,FMN GV 16 Berchem TOT
54,Posthofbrug 5366,2019-11-21,23:00:00,47,12,35,FMN GV 16 Berchem TOT
54,Posthofbrug 5366,2019-11-22,00:00:00,19,3,16,FMN GV 16 Berchem TOT
54,Posthofbrug 5366,2019-11-22,01:00:00,9,4,5,FMN GV 16 Berchem TOT
54,Posthofbrug 5366,2019-11-22,02:00:00,7,2,5,FMN GV 16 Berchem TOT
54,Posthofbrug 5366,2019-11-22,03:00:00,2,0,2,FMN GV 16 Berchem TOT
54,Posthofbrug 5366,2019-11-22,04:00:00,8,7,1,FMN GV 16 Berchem TOT
54,Posthofbrug 5366,2019-11-22,05:00:00,18,13,5,FMN GV 16 Berchem TOT
54,Posthofbrug 5366,2019-11-22,06:00:00,66,54,12,FMN GV 16 Berchem TOT
54,Posthofbrug 5366,2019-11-22,07:00:00,293,223,70,FMN GV 16 Berchem TOT
54,Posthofbrug 5366,2019-11-22,08:00:00,498,363,135,FMN GV 16 Berchem TOT
54,Posthofbrug 5366,2019-11-22,09:00:00,190,136,54,FMN GV 16 Berchem TOT
54,Posthofbrug 5366,2019-11-22,10:00:00,97,62,35,FMN GV 16 Berchem TOT
54,Posthofbrug 5366,2019-11-22,11:00:00,92,58,34,FMN GV 16 Berchem TOT
54,Posthofbrug 5366,2019-11-22,12:00:00,114,67,47,FMN GV 16 Berchem TOT
54,Posthofbrug 5366,2019-11-22,13:00:00,119,67,52,FMN GV 16 Berchem TOT
54,Posthofbrug 5366,2019-11-22,14:00:00,134,59,75,FMN GV 16 Berchem TOT
54,Posthofbrug 5366,2019-11-22,15:00:00,170,75,95,FMN GV 16 Berchem TOT
54,Posthofbrug 5366,2019-11-22,16:00:00,293,118,175,FMN GV 16 Berchem TOT
54,Posthofbrug 5366,2019-11-22,17:00:00,328,120,208,FMN GV 16 Berchem TOT
54,Posthofbrug 5366,2019-11-22,18:00:00,224,92,132,FMN GV 16 Berchem TOT
54,Posthofbrug 5366,2019-11-22,19:00:00,111,55,56,FMN GV 16 Berchem TOT
54,Posthofbrug 5366,2019-11-22,20:00:00,55,26,29,FMN GV 16 Berchem TOT
54,Posthofbrug 5366,2019-11-22,21:00:00,41,22,19,FMN GV 16 Berchem TOT
54,Posthofbrug 5366,2019-11-22,22:00:00,51,27,24,FMN GV 16 Berchem TOT
54,Posthofbrug 5366,2019-11-22,23:00:00,41,14,27,FMN GV 16 Berchem TOT
54,Posthofbrug 5366,2019-11-23,00:00:00,54,25,29,FMN GV 16 Berchem TOT
54,Posthofbrug 5366,2019-11-23,01:00:00,31,7,24,FMN GV 16 Berchem TOT
54,Posthofbrug 5366,2019-11-23,02:00:00,20,6,14,FMN GV 16 Berchem TOT
54,Posthofbrug 5366,2019-11-23,03:00:00,9,2,7,FMN GV 16 Berchem TOT
54,Posthofbrug 5366,2019-11-23,04:00:00,16,7,9,FMN GV 16 Berchem TOT
54,Posthofbrug 5366,2019-11-23,05:00:00,14,5,9,FMN GV 16 Berchem TOT
54,Posthofbrug 5366,2019-11-23,06:00:00,12,7,5,FMN GV 16 Berchem TOT
54,Posthofbrug 5366,2019-11-23,07:00:00,41,20,21,FMN GV 16 Berchem TOT
54,Posthofbrug 5366,2019-11-23,08:00:00,60,30,30,FMN GV 16 Berchem TOT
54,Posthofbrug 5366,2019-11-23,09:00:00,80,58,22,FMN GV 16 Berchem TOT
54,Posthofbrug 5366,2019-11-23,10:00:00,65,43,22,FMN GV 16 Berchem TOT
54,Posthofbrug 5366,2019-11-23,11:00:00,81,49,32,FMN GV 16 Berchem TOT
54,Posthofbrug 5366,2019-11-23,12:00:00,76,46,30,FMN GV 16 Berchem TOT
54,Posthofbrug 5366,2019-11-23,13:00:00,75,43,32,FMN GV 16 Berchem TOT
54,Posthofbrug 5366,2019-11-23,14:00:00,110,65,45,FMN GV 16 Berchem TOT
54,Posthofbrug 5366,2019-11-23,15:00:00,86,41,45,FMN GV 16 Berchem TOT
54,Posthofbrug 5366,2019-11-23,16:00:00,80,32,48,FMN GV 16 Berchem TOT
54,Posthofbrug 5366,2019-11-23,17:00:00,100,50,50,FMN GV 16 Berchem TOT
54,Posthofbrug 5366,2019-11-23,18:00:00,84,42,42,FMN GV 16 Berchem TOT
54,Posthofbrug 5366,2019-11-23,19:00:00,61,39,22,FMN GV 16 Berchem TOT
54,Posthofbrug 5366,2019-11-23,20:00:00,66,37,29,FMN GV 16 Berchem TOT
54,Posthofbrug 5366,2019-11-23,21:00:00,41,20,21,FMN GV 16 Berchem TOT
54,Posthofbrug 5366,2019-11-23,22:00:00,33,15,18,FMN GV 16 Berchem TOT
54,Posthofbrug 5366,2019-11-23,23:00:00,23,4,19,FMN GV 16 Berchem TOT
54,Posthofbrug 5366,2019-11-24,00:00:00,35,8,27,FMN GV 16 Berchem TOT
54,Posthofbrug 5366,2019-11-24,01:00:00,24,5,19,FMN GV 16 Berchem TOT
54,Posthofbrug 5366,2019-11-24,02:00:00,12,1,11,FMN GV 16 Berchem TOT
54,Posthofbrug 5366,2019-11-24,03:00:00,12,2,10,FMN GV 16 Berchem TOT
54,Posthofbrug 5366,2019-11-24,04:00:00,13,1,12,FMN GV 16 Berchem TOT
54,Posthofbrug 5366,2019-11-24,05:00:00,10,7,3,FMN GV 16 Berchem TOT
54,Posthofbrug 5366,2019-11-24,06:00:00,8,6,2,FMN GV 16 Berchem TOT
54,Posthofbrug 5366,2019-11-24,07:00:00,9,5,4,FMN GV 16 Berchem TOT
54,Posthofbrug 5366,2019-11-24,08:00:00,21,13,8,FMN GV 16 Berchem TOT
54,Posthofbrug 5366,2019-11-24,09:00:00,48,32,16,FMN GV 16 Berchem TOT
54,Posthofbrug 5366,2019-11-24,10:00:00,73,44,29,FMN GV 16 Berchem TOT
54,Posthofbrug 5366,2019-11-24,11:00:00,64,38,26,FMN GV 16 Berchem TOT
54,Posthofbrug 5366,2019-11-24,12:00:00,81,47,34,FMN GV 16 Berchem TOT
54,Posthofbrug 5366,2019-11-24,13:00:00,102,65,37,FMN GV 16 Berchem TOT
54,Posthofbrug 5366,2019-11-24,14:00:00,113,63,50,FMN GV 16 Berchem TOT
54,Posthofbrug 5366,2019-11-24,15:00:00,104,59,45,FMN GV 16 Berchem TOT
54,Posthofbrug 5366,2019-11-24,16:00:00,94,37,57,FMN GV 16 Berchem TOT
54,Posthofbrug 5366,2019-11-24,17:00:00,95,32,63,FMN GV 16 Berchem TOT
54,Posthofbrug 5366,2019-11-24,18:00:00,44,18,26,FMN GV 16 Berchem TOT
54,Posthofbrug 5366,2019-11-24,19:00:00,26,9,17,FMN GV 16 Berchem TOT
54,Posthofbrug 5366,2019-11-24,20:00:00,38,20,18,FMN GV 16 Berchem TOT
54,Posthofbrug 5366,2019-11-24,21:00:00,29,19,10,FMN GV 16 Berchem TOT
54,Posthofbrug 5366,2019-11-24,22:00:00,34,17,17,FMN GV 16 Berchem TOT
54,Posthofbrug 5366,2019-11-24,23:00:00,13,1,12,FMN GV 16 Berchem TOT
54,Posthofbrug 5366,2019-11-25,00:00:00,6,1,5,FMN GV 16 Berchem TOT
54,Posthofbrug 5366,2019-11-25,01:00:00,3,1,2,FMN GV 16 Berchem TOT
54,Posthofbrug 5366,2019-11-25,02:00:00,0,0,0,FMN GV 16 Berchem TOT
54,Posthofbrug 5366,2019-11-25,03:00:00,2,1,1,FMN GV 16 Berchem TOT
54,Posthofbrug 5366,2019-11-25,04:00:00,2,2,0,FMN GV 16 Berchem TOT
54,Posthofbrug 5366,2019-11-25,05:00:00,28,18,10,FMN GV 16 Berchem TOT
54,Posthofbrug 5366,2019-11-25,06:00:00,95,79,16,FMN GV 16 Berchem TOT
54,Posthofbrug 5366,2019-11-25,07:00:00,373,283,90,FMN GV 16 Berchem TOT
54,Posthofbrug 5366,2019-11-25,08:00:00,606,433,173,FMN GV 16 Berchem TOT
54,Posthofbrug 5366,2019-11-25,09:00:00,235,174,61,FMN GV 16 Berchem TOT
54,Posthofbrug 5366,2019-11-25,10:00:00,87,61,26,FMN GV 16 Berchem TOT
54,Posthofbrug 5366,2019-11-25,11:00:00,93,61,32,FMN GV 16 Berchem TOT
54,Posthofbrug 5366,2019-11-25,12:00:00,142,82,60,FMN GV 16 Berchem TOT
54,Posthofbrug 5366,2019-11-25,13:00:00,131,55,76,FMN GV 16 Berchem TOT
54,Posthofbrug 5366,2019-11-25,14:00:00,104,48,56,FMN GV 16 Berchem TOT
54,Posthofbrug 5366,2019-11-25,15:00:00,184,69,115,FMN GV 16 Berchem TOT
54,Posthofbrug 5366,2019-11-25,16:00:00,383,152,231,FMN GV 16 Berchem TOT
54,Posthofbrug 5366,2019-11-25,17:00:00,418,153,265,FMN GV 16 Berchem TOT
54,Posthofbrug 5366,2019-11-25,18:00:00,275,90,185,FMN GV 16 Berchem TOT
54,Posthofbrug 5366,2019-11-25,19:00:00,120,45,75,FMN GV 16 Berchem TOT
54,Posthofbrug 5366,2019-11-25,20:00:00,50,33,17,FMN GV 16 Berchem TOT
54,Posthofbrug 5366,2019-11-25,21:00:00,47,21,26,FMN GV 16 Berchem TOT
54,Posthofbrug 5366,2019-11-25,22:00:00,53,17,36,FMN GV 16 Berchem TOT
54,Posthofbrug 5366,2019-11-25,23:00:00,25,7,18,FMN GV 16 Berchem TOT
54,Posthofbrug 5366,2019-11-26,00:00:00,7,0,7,FMN GV 16 Berchem TOT
54,Posthofbrug 5366,2019-11-26,01:00:00,2,0,2,FMN GV 16 Berchem TOT
54,Posthofbrug 5366,2019-11-26,02:00:00,4,0,4,FMN GV 16 Berchem TOT
54,Posthofbrug 5366,2019-11-26,03:00:00,3,3,0,FMN GV 16 Berchem TOT
54,Posthofbrug 5366,2019-11-26,04:00:00,5,5,0,FMN GV 16 Berchem TOT
54,Posthofbrug 5366,2019-11-26,05:00:00,20,14,6,FMN GV 16 Berchem TOT
54,Posthofbrug 5366,2019-11-26,06:00:00,118,102,16,FMN GV 16 Berchem TOT
54,Posthofbrug 5366,2019-11-26,07:00:00,374,290,84,FMN GV 16 Berchem TOT
54,Posthofbrug 5366,2019-11-26,08:00:00,652,458,194,FMN GV 16 Berchem TOT
54,Posthofbrug 5366,2019-11-26,09:00:00,198,135,63,FMN GV 16 Berchem TOT
54,Posthofbrug 5366,2019-11-26,10:00:00,91,55,36,FMN GV 16 Berchem TOT
54,Posthofbrug 5366,2019-11-26,11:00:00,77,50,27,FMN GV 16 Berchem TOT
54,Posthofbrug 5366,2019-11-26,12:00:00,136,59,77,FMN GV 16 Berchem TOT
54,Posthofbrug 5366,2019-11-26,13:00:00,116,63,53,FMN GV 16 Berchem TOT
54,Posthofbrug 5366,2019-11-26,14:00:00,84,33,51,FMN GV 16 Berchem TOT
54,Posthofbrug 5366,2019-11-26,15:00:00,187,80,107,FMN GV 16 Berchem TOT
54,Posthofbrug 5366,2019-11-26,16:00:00,341,142,199,FMN GV 16 Berchem TOT
54,Posthofbrug 5366,2019-11-26,17:00:00,464,172,292,FMN GV 16 Berchem TOT
54,Posthofbrug 5366,2019-11-26,18:00:00,264,94,170,FMN GV 16 Berchem TOT
54,Posthofbrug 5366,2019-11-26,19:00:00,134,40,94,FMN GV 16 Berchem TOT
54,Posthofbrug 5366,2019-11-26,20:00:00,83,34,49,FMN GV 16 Berchem TOT
54,Posthofbrug 5366,2019-11-26,21:00:00,63,33,30,FMN GV 16 Berchem TOT
54,Posthofbrug 5366,2019-11-26,22:00:00,72,29,43,FMN GV 16 Berchem TOT
54,Posthofbrug 5366,2019-11-26,23:00:00,42,11,31,FMN GV 16 Berchem TOT
54,Posthofbrug 5366,2019-11-27,00:00:00,11,2,9,FMN GV 16 Berchem TOT
54,Posthofbrug 5366,2019-11-27,01:00:00,10,6,4,FMN GV 16 Berchem TOT
54,Posthofbrug 5366,2019-11-27,02:00:00,3,3,0,FMN GV 16 Berchem TOT
54,Posthofbrug 5366,2019-11-27,03:00:00,6,1,5,FMN GV 16 Berchem TOT
54,Posthofbrug 5366,2019-11-27,04:00:00,6,4,2,FMN GV 16 Berchem TOT
54,Posthofbrug 5366,2019-11-27,05:00:00,18,10,8,FMN GV 16 Berchem TOT
54,Posthofbrug 5366,2019-11-27,06:00:00,87,71,16,FMN GV 16 Berchem TOT
54,Posthofbrug 5366,2019-11-27,07:00:00,335,246,89,FMN GV 16 Berchem TOT
54,Posthofbrug 5366,2019-11-27,08:00:00,500,345,155,FMN GV 16 Berchem TOT
54,Posthofbrug 5366,2019-11-27,09:00:00,198,134,64,FMN GV 16 Berchem TOT
54,Posthofbrug 5366,2019-11-27,10:00:00,71,51,20,FMN GV 16 Berchem TOT
54,Posthofbrug 5366,2019-11-27,11:00:00,95,52,43,FMN GV 16 Berchem TOT
54,Posthofbrug 5366,2019-11-27,12:00:00,178,92,86,FMN GV 16 Berchem TOT
54,Posthofbrug 5366,2019-11-27,13:00:00,132,56,76,FMN GV 16 Berchem TOT
54,Posthofbrug 5366,2019-11-27,14:00:00,82,39,43,FMN GV 16 Berchem TOT
54,Posthofbrug 5366,2019-11-27,15:00:00,115,56,59,FMN GV 16 Berchem TOT
54,Posthofbrug 5366,2019-11-27,16:00:00,249,112,137,FMN GV 16 Berchem TOT
54,Posthofbrug 5366,2019-11-27,17:00:00,373,149,224,FMN GV 16 Berchem TOT
54,Posthofbrug 5366,2019-11-27,18:00:00,212,82,130,FMN GV 16 Berchem TOT
54,Posthofbrug 5366,2019-11-27,19:00:00,111,41,70,FMN GV 16 Berchem TOT
54,Posthofbrug 5366,2019-11-27,20:00:00,66,32,34,FMN GV 16 Berchem TOT
54,Posthofbrug 5366,2019-11-27,21:00:00,45,16,29,FMN GV 16 Berchem TOT
54,Posthofbrug 5366,2019-11-27,22:00:00,50,13,37,FMN GV 16 Berchem TOT
54,Posthofbrug 5366,2019-11-27,23:00:00,33,15,18,FMN GV 16 Berchem TOT
54,Posthofbrug 5366,2019-11-28,00:00:00,8,3,5,FMN GV 16 Berchem TOT
54,Posthofbrug 5366,2019-11-28,01:00:00,4,0,4,FMN GV 16 Berchem TOT
54,Posthofbrug 5366,2019-11-28,02:00:00,5,1,4,FMN GV 16 Berchem TOT
54,Posthofbrug 5366,2019-11-28,03:00:00,4,1,3,FMN GV 16 Berchem TOT
54,Posthofbrug 5366,2019-11-28,04:00:00,6,3,3,FMN GV 16 Berchem TOT
54,Posthofbrug 5366,2019-11-28,05:00:00,17,12,5,FMN GV 16 Berchem TOT
54,Posthofbrug 5366,2019-11-28,06:00:00,83,73,10,FMN GV 16 Berchem TOT
54,Posthofbrug 5366,2019-11-28,07:00:00,332,265,67,FMN GV 16 Berchem TOT
54,Posthofbrug 5366,2019-11-28,08:00:00,583,399,184,FMN GV 16 Berchem TOT
54,Posthofbrug 5366,2019-11-28,09:00:00,193,133,60,FMN GV 16 Berchem TOT
54,Posthofbrug 5366,2019-11-28,10:00:00,81,55,26,FMN GV 16 Berchem TOT
54,Posthofbrug 5366,2019-11-28,11:00:00,55,41,14,FMN GV 16 Berchem TOT
54,Posthofbrug 5366,2019-11-28,12:00:00,84,46,38,FMN GV 16 Berchem TOT
54,Posthofbrug 5366,2019-11-28,13:00:00,89,44,45,FMN GV 16 Berchem TOT
54,Posthofbrug 5366,2019-11-28,14:00:00,64,29,35,FMN GV 16 Berchem TOT
54,Posthofbrug 5366,2019-11-28,15:00:00,119,58,61,FMN GV 16 Berchem TOT
54,Posthofbrug 5366,2019-11-28,16:00:00,299,112,187,FMN GV 16 Berchem TOT
54,Posthofbrug 5366,2019-11-28,17:00:00,357,142,215,FMN GV 16 Berchem TOT
54,Posthofbrug 5366,2019-11-28,18:00:00,233,93,140,FMN GV 16 Berchem TOT
54,Posthofbrug 5366,2019-11-28,19:00:00,103,27,76,FMN GV 16 Berchem TOT
54,Posthofbrug 5366,2019-11-28,20:00:00,61,35,26,FMN GV 16 Berchem TOT
54,Posthofbrug 5366,2019-11-28,21:00:00,43,18,25,FMN GV 16 Berchem TOT
54,Posthofbrug 5366,2019-11-28,22:00:00,44,13,31,FMN GV 16 Berchem TOT
54,Posthofbrug 5366,2019-11-28,23:00:00,39,7,32,FMN GV 16 Berchem TOT
54,Posthofbrug 5366,2019-11-29,00:00:00,13,2,11,FMN GV 16 Berchem TOT
54,Posthofbrug 5366,2019-11-29,01:00:00,7,2,5,FMN GV 16 Berchem TOT
54,Posthofbrug 5366,2019-11-29,02:00:00,6,1,5,FMN GV 16 Berchem TOT
54,Posthofbrug 5366,2019-11-29,03:00:00,5,2,3,FMN GV 16 Berchem TOT
54,Posthofbrug 5366,2019-11-29,04:00:00,6,6,0,FMN GV 16 Berchem TOT
54,Posthofbrug 5366,2019-11-29,05:00:00,27,20,7,FMN GV 16 Berchem TOT
54,Posthofbrug 5366,2019-11-29,06:00:00,73,63,10,FMN GV 16 Berchem TOT
54,Posthofbrug 5366,2019-11-29,07:00:00,308,247,61,FMN GV 16 Berchem TOT
54,Posthofbrug 5366,2019-11-29,08:00:00,495,352,143,FMN GV 16 Berchem TOT
54,Posthofbrug 5366,2019-11-29,09:00:00,207,156,51,FMN GV 16 Berchem TOT
54,Posthofbrug 5366,2019-11-29,10:00:00,94,68,26,FMN GV 16 Berchem TOT
54,Posthofbrug 5366,2019-11-29,11:00:00,78,52,26,FMN GV 16 Berchem TOT
54,Posthofbrug 5366,2019-11-29,12:00:00,136,76,60,FMN GV 16 Berchem TOT
54,Posthofbrug 5366,2019-11-29,13:00:00,154,87,67,FMN GV 16 Berchem TOT
54,Posthofbrug 5366,2019-11-29,14:00:00,123,56,67,FMN GV 16 Berchem TOT
54,Posthofbrug 5366,2019-11-29,15:00:00,177,87,90,FMN GV 16 Berchem TOT
54,Posthofbrug 5366,2019-11-29,16:00:00,320,130,190,FMN GV 16 Berchem TOT
54,Posthofbrug 5366,2019-11-29,17:00:00,345,129,216,FMN GV 16 Berchem TOT
54,Posthofbrug 5366,2019-11-29,18:00:00,192,73,119,FMN GV 16 Berchem TOT
54,Posthofbrug 5366,2019-11-29,19:00:00,127,54,73,FMN GV 16 Berchem TOT
54,Posthofbrug 5366,2019-11-29,20:00:00,74,45,29,FMN GV 16 Berchem TOT
54,Posthofbrug 5366,2019-11-29,21:00:00,39,20,19,FMN GV 16 Berchem TOT
54,Posthofbrug 5366,2019-11-29,22:00:00,56,23,33,FMN GV 16 Berchem TOT
54,Posthofbrug 5366,2019-11-29,23:00:00,49,15,34,FMN GV 16 Berchem TOT
54,Posthofbrug 5366,2019-11-30,00:00:00,57,23,34,FMN GV 16 Berchem TOT
54,Posthofbrug 5366,2019-11-30,01:00:00,26,8,18,FMN GV 16 Berchem TOT
54,Posthofbrug 5366,2019-11-30,02:00:00,22,3,19,FMN GV 16 Berchem TOT
54,Posthofbrug 5366,2019-11-30,03:00:00,19,3,16,FMN GV 16 Berchem TOT
54,Posthofbrug 5366,2019-11-30,04:00:00,9,6,3,FMN GV 16 Berchem TOT
54,Posthofbrug 5366,2019-11-30,05:00:00,11,7,4,FMN GV 16 Berchem TOT
54,Posthofbrug 5366,2019-11-30,06:00:00,13,10,3,FMN GV 16 Berchem TOT
54,Posthofbrug 5366,2019-11-30,07:00:00,23,19,4,FMN GV 16 Berchem TOT
54,Posthofbrug 5366,2019-11-30,08:00:00,48,29,19,FMN GV 16 Berchem TOT
54,Posthofbrug 5366,2019-11-30,09:00:00,68,47,21,FMN GV 16 Berchem TOT
54,Posthofbrug 5366,2019-11-30,10:00:00,57,32,25,FMN GV 16 Berchem TOT
54,Posthofbrug 5366,2019-11-30,11:00:00,113,76,37,FMN GV 16 Berchem TOT
54,Posthofbrug 5366,2019-11-30,12:00:00,84,48,36,FMN GV 16 Berchem TOT
54,Posthofbrug 5366,2019-11-30,13:00:00,137,91,46,FMN GV 16 Berchem TOT
54,Posthofbrug 5366,2019-11-30,14:00:00,132,69,63,FMN GV 16 Berchem TOT
54,Posthofbrug 5366,2019-11-30,15:00:00,92,43,49,FMN GV 16 Berchem TOT
54,Posthofbrug 5366,2019-11-30,16:00:00,99,51,48,FMN GV 16 Berchem TOT
54,Posthofbrug 5366,2019-11-30,17:00:00,109,49,60,FMN GV 16 Berchem TOT
54,Posthofbrug 5366,2019-11-30,18:00:00,93,44,49,FMN GV 16 Berchem TOT
54,Posthofbrug 5366,2019-11-30,19:00:00,78,34,44,FMN GV 16 Berchem TOT
54,Posthofbrug 5366,2019-11-30,20:00:00,50,37,13,FMN GV 16 Berchem TOT
54,Posthofbrug 5366,2019-11-30,21:00:00,47,27,20,FMN GV 16 Berchem TOT
54,Posthofbrug 5366,2019-11-30,22:00:00,56,33,23,FMN GV 16 Berchem TOT
54,Posthofbrug 5366,2019-11-30,23:00:00,43,8,35,FMN GV 16 Berchem TOT
54,Posthofbrug 5366,2019-12-01,00:00:00,48,23,25,FMN GV 16 Berchem TOT
54,Posthofbrug 5366,2019-12-01,01:00:00,21,4,17,FMN GV 16 Berchem TOT
54,Posthofbrug 5366,2019-12-01,02:00:00,17,5,12,FMN GV 16 Berchem TOT
54,Posthofbrug 5366,2019-12-01,03:00:00,10,3,7,FMN GV 16 Berchem TOT
54,Posthofbrug 5366,2019-12-01,04:00:00,12,6,6,FMN GV 16 Berchem TOT
54,Posthofbrug 5366,2019-12-01,05:00:00,13,7,6,FMN GV 16 Berchem TOT
54,Posthofbrug 5366,2019-12-01,06:00:00,8,3,5,FMN GV 16 Berchem TOT
54,Posthofbrug 5366,2019-12-01,07:00:00,12,7,5,FMN GV 16 Berchem TOT
54,Posthofbrug 5366,2019-12-01,08:00:00,21,9,12,FMN GV 16 Berchem TOT
54,Posthofbrug 5366,2019-12-01,09:00:00,54,38,16,FMN GV 16 Berchem TOT
54,Posthofbrug 5366,2019-12-01,10:00:00,66,44,22,FMN GV 16 Berchem TOT
54,Posthofbrug 5366,2019-12-01,11:00:00,72,46,26,FMN GV 16 Berchem TOT
54,Posthofbrug 5366,2019-12-01,12:00:00,78,46,32,FMN GV 16 Berchem TOT
54,Posthofbrug 5366,2019-12-01,13:00:00,76,50,26,FMN GV 16 Berchem TOT
54,Posthofbrug 5366,2019-12-01,14:00:00,88,54,34,FMN GV 16 Berchem TOT
54,Posthofbrug 5366,2019-12-01,15:00:00,69,38,31,FMN GV 16 Berchem TOT
54,Posthofbrug 5366,2019-12-01,16:00:00,78,46,32,FMN GV 16 Berchem TOT
54,Posthofbrug 5366,2019-12-01,17:00:00,66,24,42,FMN GV 16 Berchem TOT
54,Posthofbrug 5366,2019-12-01,18:00:00,70,30,40,FMN GV 16 Berchem TOT
54,Posthofbrug 5366,2019-12-01,19:00:00,39,18,21,FMN GV 16 Berchem TOT
54,Posthofbrug 5366,2019-12-01,20:00:00,35,17,18,FMN GV 16 Berchem TOT
54,Posthofbrug 5366,2019-12-01,21:00:00,35,17,18,FMN GV 16 Berchem TOT
54,Posthofbrug 5366,2019-12-01,22:00:00,26,9,17,FMN GV 16 Berchem TOT
54,Posthofbrug 5366,2019-12-01,23:00:00,16,10,6,FMN GV 16 Berchem TOT
54,Posthofbrug 5366,2019-12-02,00:00:00,6,5,1,FMN GV 16 Berchem TOT
54,Posthofbrug 5366,2019-12-02,01:00:00,3,1,2,FMN GV 16 Berchem TOT
54,Posthofbrug 5366,2019-12-02,02:00:00,2,0,2,FMN GV 16 Berchem TOT
54,Posthofbrug 5366,2019-12-02,03:00:00,3,1,2,FMN GV 16 Berchem TOT
54,Posthofbrug 5366,2019-12-02,04:00:00,9,9,0,FMN GV 16 Berchem TOT
54,Posthofbrug 5366,2019-12-02,05:00:00,14,10,4,FMN GV 16 Berchem TOT
54,Posthofbrug 5366,2019-12-02,06:00:00,98,88,10,FMN GV 16 Berchem TOT
54,Posthofbrug 5366,2019-12-02,07:00:00,341,252,89,FMN GV 16 Berchem TOT
54,Posthofbrug 5366,2019-12-02,08:00:00,581,422,159,FMN GV 16 Berchem TOT
54,Posthofbrug 5366,2019-12-02,09:00:00,209,151,58,FMN GV 16 Berchem TOT
54,Posthofbrug 5366,2019-12-02,10:00:00,86,62,24,FMN GV 16 Berchem TOT
54,Posthofbrug 5366,2019-12-02,11:00:00,95,65,30,FMN GV 16 Berchem TOT
54,Posthofbrug 5366,2019-12-02,12:00:00,105,59,46,FMN GV 16 Berchem TOT
54,Posthofbrug 5366,2019-12-02,13:00:00,100,51,49,FMN GV 16 Berchem TOT
54,Posthofbrug 5366,2019-12-02,14:00:00,89,44,45,FMN GV 16 Berchem TOT
54,Posthofbrug 5366,2019-12-02,15:00:00,157,69,88,FMN GV 16 Berchem TOT
54,Posthofbrug 5366,2019-12-02,16:00:00,321,121,200,FMN GV 16 Berchem TOT
54,Posthofbrug 5366,2019-12-02,17:00:00,417,166,251,FMN GV 16 Berchem TOT
54,Posthofbrug 5366,2019-12-02,18:00:00,259,83,176,FMN GV 16 Berchem TOT
54,Posthofbrug 5366,2019-12-02,19:00:00,118,53,65,FMN GV 16 Berchem TOT
54,Posthofbrug 5366,2019-12-02,20:00:00,66,29,37,FMN GV 16 Berchem TOT
54,Posthofbrug 5366,2019-12-02,21:00:00,42,18,24,FMN GV 16 Berchem TOT
54,Posthofbrug 5366,2019-12-02,22:00:00,37,13,24,FMN GV 16 Berchem TOT
54,Posthofbrug 5366,2019-12-02,23:00:00,28,16,12,FMN GV 16 Berchem TOT
54,Posthofbrug 5366,2019-12-03,00:00:00,15,3,12,FMN GV 16 Berchem TOT
54,Posthofbrug 5366,2019-12-03,01:00:00,6,0,6,FMN GV 16 Berchem TOT
54,Posthofbrug 5366,2019-12-03,02:00:00,3,0,3,FMN GV 16 Berchem TOT
54,Posthofbrug 5366,2019-12-03,03:00:00,3,1,2,FMN GV 16 Berchem TOT
54,Posthofbrug 5366,2019-12-03,04:00:00,5,5,0,FMN GV 16 Berchem TOT
54,Posthofbrug 5366,2019-12-03,05:00:00,15,11,4,FMN GV 16 Berchem TOT
54,Posthofbrug 5366,2019-12-03,06:00:00,116,97,19,FMN GV 16 Berchem TOT
54,Posthofbrug 5366,2019-12-03,07:00:00,356,289,67,FMN GV 16 Berchem TOT
54,Posthofbrug 5366,2019-12-03,08:00:00,622,459,163,FMN GV 16 Berchem TOT
54,Posthofbrug 5366,2019-12-03,09:00:00,210,151,59,FMN GV 16 Berchem TOT
54,Posthofbrug 5366,2019-12-03,10:00:00,86,57,29,FMN GV 16 Berchem TOT
54,Posthofbrug 5366,2019-12-03,11:00:00,92,64,28,FMN GV 16 Berchem TOT
54,Posthofbrug 5366,2019-12-03,12:00:00,124,78,46,FMN GV 16 Berchem TOT
54,Posthofbrug 5366,2019-12-03,13:00:00,136,72,64,FMN GV 16 Berchem TOT
54,Posthofbrug 5366,2019-12-03,14:00:00,102,41,61,FMN GV 16 Berchem TOT
54,Posthofbrug 5366,2019-12-03,15:00:00,160,65,95,FMN GV 16 Berchem TOT
54,Posthofbrug 5366,2019-12-03,16:00:00,337,135,202,FMN GV 16 Berchem TOT
54,Posthofbrug 5366,2019-12-03,17:00:00,419,167,252,FMN GV 16 Berchem TOT
54,Posthofbrug 5366,2019-12-03,18:00:00,303,125,178,FMN GV 16 Berchem TOT
54,Posthofbrug 5366,2019-12-03,19:00:00,112,37,75,FMN GV 16 Berchem TOT
54,Posthofbrug 5366,2019-12-03,20:00:00,76,33,43,FMN GV 16 Berchem TOT
54,Posthofbrug 5366,2019-12-03,21:00:00,43,19,24,FMN GV 16 Berchem TOT
54,Posthofbrug 5366,2019-12-03,22:00:00,49,18,31,FMN GV 16 Berchem TOT
54,Posthofbrug 5366,2019-12-03,23:00:00,36,11,25,FMN GV 16 Berchem TOT
54,Posthofbrug 5366,2019-12-04,00:00:00,16,3,13,FMN GV 16 Berchem TOT
54,Posthofbrug 5366,2019-12-04,01:00:00,4,2,2,FMN GV 16 Berchem TOT
54,Posthofbrug 5366,2019-12-04,02:00:00,3,1,2,FMN GV 16 Berchem TOT
54,Posthofbrug 5366,2019-12-04,03:00:00,1,0,1,FMN GV 16 Berchem TOT
54,Posthofbrug 5366,2019-12-04,04:00:00,7,5,2,FMN GV 16 Berchem TOT
54,Posthofbrug 5366,2019-12-04,05:00:00,20,18,2,FMN GV 16 Berchem TOT
54,Posthofbrug 5366,2019-12-04,06:00:00,82,70,12,FMN GV 16 Berchem TOT
54,Posthofbrug 5366,2019-12-04,07:00:00,294,222,72,FMN GV 16 Berchem TOT
54,Posthofbrug 5366,2019-12-04,08:00:00,509,381,128,FMN GV 16 Berchem TOT
54,Posthofbrug 5366,2019-12-04,09:00:00,189,131,58,FMN GV 16 Berchem TOT
54,Posthofbrug 5366,2019-12-04,10:00:00,78,59,19,FMN GV 16 Berchem TOT
54,Posthofbrug 5366,2019-12-04,11:00:00,87,49,38,FMN GV 16 Berchem TOT
54,Posthofbrug 5366,2019-12-04,12:00:00,206,88,118,FMN GV 16 Berchem TOT
54,Posthofbrug 5366,2019-12-04,13:00:00,129,65,64,FMN GV 16 Berchem TOT
54,Posthofbrug 5366,2019-12-04,14:00:00,110,50,60,FMN GV 16 Berchem TOT
54,Posthofbrug 5366,2019-12-04,15:00:00,152,68,84,FMN GV 16 Berchem TOT
54,Posthofbrug 5366,2019-12-04,16:00:00,264,134,130,FMN GV 16 Berchem TOT
54,Posthofbrug 5366,2019-12-04,17:00:00,363,146,217,FMN GV 16 Berchem TOT
54,Posthofbrug 5366,2019-12-04,18:00:00,236,91,145,FMN GV 16 Berchem TOT
54,Posthofbrug 5366,2019-12-04,19:00:00,112,40,72,FMN GV 16 Berchem TOT
54,Posthofbrug 5366,2019-12-04,20:00:00,63,32,31,FMN GV 16 Berchem TOT
54,Posthofbrug 5366,2019-12-04,21:00:00,44,16,28,FMN GV 16 Berchem TOT
54,Posthofbrug 5366,2019-12-04,22:00:00,46,15,31,FMN GV 16 Berchem TOT
54,Posthofbrug 5366,2019-12-04,23:00:00,35,6,29,FMN GV 16 Berchem TOT
54,Posthofbrug 5366,2019-12-05,00:00:00,10,2,8,FMN GV 16 Berchem TOT
54,Posthofbrug 5366,2019-12-05,01:00:00,8,1,7,FMN GV 16 Berchem TOT
54,Posthofbrug 5366,2019-12-05,02:00:00,2,0,2,FMN GV 16 Berchem TOT
54,Posthofbrug 5366,2019-12-05,03:00:00,5,0,5,FMN GV 16 Berchem TOT
54,Posthofbrug 5366,2019-12-05,04:00:00,4,3,1,FMN GV 16 Berchem TOT
54,Posthofbrug 5366,2019-12-05,05:00:00,16,13,3,FMN GV 16 Berchem TOT
54,Posthofbrug 5366,2019-12-05,06:00:00,91,78,13,FMN GV 16 Berchem TOT
54,Posthofbrug 5366,2019-12-05,07:00:00,308,234,74,FMN GV 16 Berchem TOT
54,Posthofbrug 5366,2019-12-05,08:00:00,524,377,147,FMN GV 16 Berchem TOT
54,Posthofbrug 5366,2019-12-05,09:00:00,196,129,67,FMN GV 16 Berchem TOT
54,Posthofbrug 5366,2019-12-05,10:00:00,92,58,34,FMN GV 16 Berchem TOT
54,Posthofbrug 5366,2019-12-05,11:00:00,62,43,19,FMN GV 16 Berchem TOT
54,Posthofbrug 5366,2019-12-05,12:00:00,105,56,49,FMN GV 16 Berchem TOT
54,Posthofbrug 5366,2019-12-05,13:00:00,94,56,38,FMN GV 16 Berchem TOT
54,Posthofbrug 5366,2019-12-05,14:00:00,90,45,45,FMN GV 16 Berchem TOT
54,Posthofbrug 5366,2019-12-05,15:00:00,150,71,79,FMN GV 16 Berchem TOT
54,Posthofbrug 5366,2019-12-05,16:00:00,288,142,146,FMN GV 16 Berchem TOT
54,Posthofbrug 5366,2019-12-05,17:00:00,360,146,214,FMN GV 16 Berchem TOT
54,Posthofbrug 5366,2019-12-05,18:00:00,257,88,169,FMN GV 16 Berchem TOT
54,Posthofbrug 5366,2019-12-05,19:00:00,130,59,71,FMN GV 16 Berchem TOT
54,Posthofbrug 5366,2019-12-05,20:00:00,80,33,47,FMN GV 16 Berchem TOT
54,Posthofbrug 5366,2019-12-05,21:00:00,53,23,30,FMN GV 16 Berchem TOT
54,Posthofbrug 5366,2019-12-05,22:00:00,63,21,42,FMN GV 16 Berchem TOT
54,Posthofbrug 5366,2019-12-05,23:00:00,42,13,29,FMN GV 16 Berchem TOT
54,Posthofbrug 5366,2019-12-06,00:00:00,24,2,22,FMN GV 16 Berchem TOT
54,Posthofbrug 5366,2019-12-06,01:00:00,2,1,1,FMN GV 16 Berchem TOT
54,Posthofbrug 5366,2019-12-06,02:00:00,1,0,1,FMN GV 16 Berchem TOT
54,Posthofbrug 5366,2019-12-06,03:00:00,2,2,0,FMN GV 16 Berchem TOT
54,Posthofbrug 5366,2019-12-06,04:00:00,13,9,4,FMN GV 16 Berchem TOT
54,Posthofbrug 5366,2019-12-06,05:00:00,11,8,3,FMN GV 16 Berchem TOT
54,Posthofbrug 5366,2019-12-06,06:00:00,55,44,11,FMN GV 16 Berchem TOT
54,Posthofbrug 5366,2019-12-06,07:00:00,255,190,65,FMN GV 16 Berchem TOT
54,Posthofbrug 5366,2019-12-06,08:00:00,405,304,101,FMN GV 16 Berchem TOT
54,Posthofbrug 5366,2019-12-06,09:00:00,138,98,40,FMN GV 16 Berchem TOT
54,Posthofbrug 5366,2019-12-06,10:00:00,50,24,26,FMN GV 16 Berchem TOT
54,Posthofbrug 5366,2019-12-06,11:00:00,72,50,22,FMN GV 16 Berchem TOT
54,Posthofbrug 5366,2019-12-06,12:00:00,80,48,32,FMN GV 16 Berchem TOT
54,Posthofbrug 5366,2019-12-06,13:00:00,83,41,42,FMN GV 16 Berchem TOT
54,Posthofbrug 5366,2019-12-06,14:00:00,65,23,42,FMN GV 16 Berchem TOT
54,Posthofbrug 5366,2019-12-06,15:00:00,117,57,60,FMN GV 16 Berchem TOT
54,Posthofbrug 5366,2019-12-06,16:00:00,232,121,111,FMN GV 16 Berchem TOT
54,Posthofbrug 5366,2019-12-06,17:00:00,254,97,157,FMN GV 16 Berchem TOT
54,Posthofbrug 5366,2019-12-06,18:00:00,144,56,88,FMN GV 16 Berchem TOT
54,Posthofbrug 5366,2019-12-06,19:00:00,80,40,40,FMN GV 16 Berchem TOT
54,Posthofbrug 5366,2019-12-06,20:00:00,41,16,25,FMN GV 16 Berchem TOT
54,Posthofbrug 5366,2019-12-06,21:00:00,45,22,23,FMN GV 16 Berchem TOT
54,Posthofbrug 5366,2019-12-06,22:00:00,30,15,15,FMN GV 16 Berchem TOT
54,Posthofbrug 5366,2019-12-06,23:00:00,33,11,22,FMN GV 16 Berchem TOT
54,Posthofbrug 5366,2019-12-07,00:00:00,36,13,23,FMN GV 16 Berchem TOT
54,Posthofbrug 5366,2019-12-07,01:00:00,30,8,22,FMN GV 16 Berchem TOT
54,Posthofbrug 5366,2019-12-07,02:00:00,14,8,6,FMN GV 16 Berchem TOT
54,Posthofbrug 5366,2019-12-07,03:00:00,15,3,12,FMN GV 16 Berchem TOT
54,Posthofbrug 5366,2019-12-07,04:00:00,11,6,5,FMN GV 16 Berchem TOT
54,Posthofbrug 5366,2019-12-07,05:00:00,3,3,0,FMN GV 16 Berchem TOT
54,Posthofbrug 5366,2019-12-07,06:00:00,13,11,2,FMN GV 16 Berchem TOT
54,Posthofbrug 5366,2019-12-07,07:00:00,20,12,8,FMN GV 16 Berchem TOT
54,Posthofbrug 5366,2019-12-07,08:00:00,34,22,12,FMN GV 16 Berchem TOT
54,Posthofbrug 5366,2019-12-07,09:00:00,48,32,16,FMN GV 16 Berchem TOT
54,Posthofbrug 5366,2019-12-07,10:00:00,59,43,16,FMN GV 16 Berchem TOT
54,Posthofbrug 5366,2019-12-07,11:00:00,80,56,24,FMN GV 16 Berchem TOT
54,Posthofbrug 5366,2019-12-07,12:00:00,71,48,23,FMN GV 16 Berchem TOT
54,Posthofbrug 5366,2019-12-07,13:00:00,84,56,28,FMN GV 16 Berchem TOT
54,Posthofbrug 5366,2019-12-07,14:00:00,99,64,35,FMN GV 16 Berchem TOT
54,Posthofbrug 5366,2019-12-07,15:00:00,87,50,37,FMN GV 16 Berchem TOT
54,Posthofbrug 5366,2019-12-07,16:00:00,100,41,59,FMN GV 16 Berchem TOT
54,Posthofbrug 5366,2019-12-07,17:00:00,83,45,38,FMN GV 16 Berchem TOT
54,Posthofbrug 5366,2019-12-07,18:00:00,55,29,26,FMN GV 16 Berchem TOT
54,Posthofbrug 5366,2019-12-07,19:00:00,72,47,25,FMN GV 16 Berchem TOT
54,Posthofbrug 5366,2019-12-07,20:00:00,68,47,21,FMN GV 16 Berchem TOT
54,Posthofbrug 5366,2019-12-07,21:00:00,52,27,25,FMN GV 16 Berchem TOT
54,Posthofbrug 5366,2019-12-07,22:00:00,30,12,18,FMN GV 16 Berchem TOT
54,Posthofbrug 5366,2019-12-07,23:00:00,45,16,29,FMN GV 16 Berchem TOT
54,Posthofbrug 5366,2019-12-08,00:00:00,46,21,25,FMN GV 16 Berchem TOT
54,Posthofbrug 5366,2019-12-08,01:00:00,28,13,15,FMN GV 16 Berchem TOT
54,Posthofbrug 5366,2019-12-08,02:00:00,19,2,17,FMN GV 16 Berchem TOT
54,Posthofbrug 5366,2019-12-08,03:00:00,14,2,12,FMN GV 16 Berchem TOT
54,Posthofbrug 5366,2019-12-08,04:00:00,14,3,11,FMN GV 16 Berchem TOT
54,Posthofbrug 5366,2019-12-08,05:00:00,6,1,5,FMN GV 16 Berchem TOT
54,Posthofbrug 5366,2019-12-08,06:00:00,8,5,3,FMN GV 16 Berchem TOT
54,Posthofbrug 5366,2019-12-08,07:00:00,7,4,3,FMN GV 16 Berchem TOT
54,Posthofbrug 5366,2019-12-08,08:00:00,11,7,4,FMN GV 16 Berchem TOT
54,Posthofbrug 5366,2019-12-08,09:00:00,31,23,8,FMN GV 16 Berchem TOT
54,Posthofbrug 5366,2019-12-08,10:00:00,35,23,12,FMN GV 16 Berchem TOT
54,Posthofbrug 5366,2019-12-08,11:00:00,33,20,13,FMN GV 16 Berchem TOT
54,Posthofbrug 5366,2019-12-08,12:00:00,56,39,17,FMN GV 16 Berchem TOT
54,Posthofbrug 5366,2019-12-08,13:00:00,72,45,27,FMN GV 16 Berchem TOT
54,Posthofbrug 5366,2019-12-08,14:00:00,58,37,21,FMN GV 16 Berchem TOT
54,Posthofbrug 5366,2019-12-08,15:00:00,72,36,36,FMN GV 16 Berchem TOT
54,Posthofbrug 5366,2019-12-08,16:00:00,49,20,29,FMN GV 16 Berchem TOT
54,Posthofbrug 5366,2019-12-08,17:00:00,58,29,29,FMN GV 16 Berchem TOT
54,Posthofbrug 5366,2019-12-08,18:00:00,48,16,32,FMN GV 16 Berchem TOT
54,Posthofbrug 5366,2019-12-08,19:00:00,25,6,19,FMN GV 16 Berchem TOT
54,Posthofbrug 5366,2019-12-08,20:00:00,36,23,13,FMN GV 16 Berchem TOT
54,Posthofbrug 5366,2019-12-08,21:00:00,23,13,10,FMN GV 16 Berchem TOT
54,Posthofbrug 5366,2019-12-08,22:00:00,25,11,14,FMN GV 16 Berchem TOT
54,Posthofbrug 5366,2019-12-08,23:00:00,14,5,9,FMN GV 16 Berchem TOT
54,Posthofbrug 5366,2019-12-09,00:00:00,7,3,4,FMN GV 16 Berchem TOT
54,Posthofbrug 5366,2019-12-09,01:00:00,1,0,1,FMN GV 16 Berchem TOT
54,Posthofbrug 5366,2019-12-09,02:00:00,2,1,1,FMN GV 16 Berchem TOT
54,Posthofbrug 5366,2019-12-09,03:00:00,2,1,1,FMN GV 16 Berchem TOT
54,Posthofbrug 5366,2019-12-09,04:00:00,6,5,1,FMN GV 16 Berchem TOT
54,Posthofbrug 5366,2019-12-09,05:00:00,13,8,5,FMN GV 16 Berchem TOT
54,Posthofbrug 5366,2019-12-09,06:00:00,62,54,8,FMN GV 16 Berchem TOT
54,Posthofbrug 5366,2019-12-09,07:00:00,279,211,68,FMN GV 16 Berchem TOT
54,Posthofbrug 5366,2019-12-09,08:00:00,461,357,104,FMN GV 16 Berchem TOT
54,Posthofbrug 5366,2019-12-09,09:00:00,162,108,54,FMN GV 16 Berchem TOT
54,Posthofbrug 5366,2019-12-09,10:00:00,66,38,28,FMN GV 16 Berchem TOT
54,Posthofbrug 5366,2019-12-09,11:00:00,72,46,26,FMN GV 16 Berchem TOT
54,Posthofbrug 5366,2019-12-09,12:00:00,87,52,35,FMN GV 16 Berchem TOT
54,Posthofbrug 5366,2019-12-09,13:00:00,78,41,37,FMN GV 16 Berchem TOT
54,Posthofbrug 5366,2019-12-09,14:00:00,54,18,36,FMN GV 16 Berchem TOT
54,Posthofbrug 5366,2019-12-09,15:00:00,114,55,59,FMN GV 16 Berchem TOT
54,Posthofbrug 5366,2019-12-09,16:00:00,201,91,110,FMN GV 16 Berchem TOT
54,Posthofbrug 5366,2019-12-09,17:00:00,313,131,182,FMN GV 16 Berchem TOT
54,Posthofbrug 5366,2019-12-09,18:00:00,213,77,136,FMN GV 16 Berchem TOT
54,Posthofbrug 5366,2019-12-09,19:00:00,92,38,54,FMN GV 16 Berchem TOT
54,Posthofbrug 5366,2019-12-09,20:00:00,59,23,36,FMN GV 16 Berchem TOT
54,Posthofbrug 5366,2019-12-09,21:00:00,42,14,28,FMN GV 16 Berchem TOT
54,Posthofbrug 5366,2019-12-09,22:00:00,35,21,14,FMN GV 16 Berchem TOT
54,Posthofbrug 5366,2019-12-09,23:00:00,17,4,13,FMN GV 16 Berchem TOT
54,Posthofbrug 5366,2019-12-10,00:00:00,11,3,8,FMN GV 16 Berchem TOT
54,Posthofbrug 5366,2019-12-10,01:00:00,2,1,1,FMN GV 16 Berchem TOT
54,Posthofbrug 5366,2019-12-10,02:00:00,1,0,1,FMN GV 16 Berchem TOT
54,Posthofbrug 5366,2019-12-10,03:00:00,4,1,3,FMN GV 16 Berchem TOT
54,Posthofbrug 5366,2019-12-10,04:00:00,5,5,0,FMN GV 16 Berchem TOT
54,Posthofbrug 5366,2019-12-10,05:00:00,20,15,5,FMN GV 16 Berchem TOT
54,Posthofbrug 5366,2019-12-10,06:00:00,95,82,13,FMN GV 16 Berchem TOT
54,Posthofbrug 5366,2019-12-10,07:00:00,341,252,89,FMN GV 16 Berchem TOT
54,Posthofbrug 5366,2019-12-10,08:00:00,561,425,136,FMN GV 16 Berchem TOT
54,Posthofbrug 5366,2019-12-10,09:00:00,208,147,61,FMN GV 16 Berchem TOT
54,Posthofbrug 5366,2019-12-10,10:00:00,96,56,40,FMN GV 16 Berchem TOT
54,Posthofbrug 5366,2019-12-10,11:00:00,74,52,22,FMN GV 16 Berchem TOT
54,Posthofbrug 5366,2019-12-10,12:00:00,135,85,50,FMN GV 16 Berchem TOT
54,Posthofbrug 5366,2019-12-10,13:00:00,122,51,71,FMN GV 16 Berchem TOT
54,Posthofbrug 5366,2019-12-10,14:00:00,91,44,47,FMN GV 16 Berchem TOT
54,Posthofbrug 5366,2019-12-10,15:00:00,151,73,78,FMN GV 16 Berchem TOT
54,Posthofbrug 5366,2019-12-10,16:00:00,297,124,173,FMN GV 16 Berchem TOT
54,Posthofbrug 5366,2019-12-10,17:00:00,393,156,237,FMN GV 16 Berchem TOT
54,Posthofbrug 5366,2019-12-10,18:00:00,254,92,162,FMN GV 16 Berchem TOT
54,Posthofbrug 5366,2019-12-10,19:00:00,117,42,75,FMN GV 16 Berchem TOT
54,Posthofbrug 5366,2019-12-10,20:00:00,58,22,36,FMN GV 16 Berchem TOT
54,Posthofbrug 5366,2019-12-10,21:00:00,48,31,17,FMN GV 16 Berchem TOT
54,Posthofbrug 5366,2019-12-10,22:00:00,70,26,44,FMN GV 16 Berchem TOT
54,Posthofbrug 5366,2019-12-10,23:00:00,29,13,16,FMN GV 16 Berchem TOT
54,Posthofbrug 5366,2019-12-11,00:00:00,13,2,11,FMN GV 16 Berchem TOT
54,Posthofbrug 5366,2019-12-11,01:00:00,14,4,10,FMN GV 16 Berchem TOT
54,Posthofbrug 5366,2019-12-11,02:00:00,5,0,5,FMN GV 16 Berchem TOT
54,Posthofbrug 5366,2019-12-11,03:00:00,2,0,2,FMN GV 16 Berchem TOT
54,Posthofbrug 5366,2019-12-11,04:00:00,7,4,3,FMN GV 16 Berchem TOT
54,Posthofbrug 5366,2019-12-11,05:00:00,17,12,5,FMN GV 16 Berchem TOT
54,Posthofbrug 5366,2019-12-11,06:00:00,89,80,9,FMN GV 16 Berchem TOT
54,Posthofbrug 5366,2019-12-11,07:00:00,295,226,69,FMN GV 16 Berchem TOT
54,Posthofbrug 5366,2019-12-11,08:00:00,487,354,133,FMN GV 16 Berchem TOT
54,Posthofbrug 5366,2019-12-11,09:00:00,185,121,64,FMN GV 16 Berchem TOT
54,Posthofbrug 5366,2019-12-11,10:00:00,74,53,21,FMN GV 16 Berchem TOT
54,Posthofbrug 5366,2019-12-11,11:00:00,85,51,34,FMN GV 16 Berchem TOT
54,Posthofbrug 5366,2019-12-11,12:00:00,166,86,80,FMN GV 16 Berchem TOT
54,Posthofbrug 5366,2019-12-11,13:00:00,113,67,46,FMN GV 16 Berchem TOT
54,Posthofbrug 5366,2019-12-11,14:00:00,81,44,37,FMN GV 16 Berchem TOT
54,Posthofbrug 5366,2019-12-11,15:00:00,118,55,63,FMN GV 16 Berchem TOT
54,Posthofbrug 5366,2019-12-11,16:00:00,189,82,107,FMN GV 16 Berchem TOT
54,Posthofbrug 5366,2019-12-11,17:00:00,346,153,193,FMN GV 16 Berchem TOT
54,Posthofbrug 5366,2019-12-11,18:00:00,233,89,144,FMN GV 16 Berchem TOT
54,Posthofbrug 5366,2019-12-11,19:00:00,99,40,59,FMN GV 16 Berchem TOT
54,Posthofbrug 5366,2019-12-11,20:00:00,61,32,29,FMN GV 16 Berchem TOT
54,Posthofbrug 5366,2019-12-11,21:00:00,57,25,32,FMN GV 16 Berchem TOT
54,Posthofbrug 5366,2019-12-11,22:00:00,48,15,33,FMN GV 16 Berchem TOT
54,Posthofbrug 5366,2019-12-11,23:00:00,40,19,21,FMN GV 16 Berchem TOT
54,Posthofbrug 5366,2019-12-12,00:00:00,15,2,13,FMN GV 16 Berchem TOT
54,Posthofbrug 5366,2019-12-12,01:00:00,9,3,6,FMN GV 16 Berchem TOT
54,Posthofbrug 5366,2019-12-12,02:00:00,3,2,1,FMN GV 16 Berchem TOT
54,Posthofbrug 5366,2019-12-12,03:00:00,3,0,3,FMN GV 16 Berchem TOT
54,Posthofbrug 5366,2019-12-12,04:00:00,7,7,0,FMN GV 16 Berchem TOT
54,Posthofbrug 5366,2019-12-12,05:00:00,18,14,4,FMN GV 16 Berchem TOT
54,Posthofbrug 5366,2019-12-12,06:00:00,83,67,16,FMN GV 16 Berchem TOT
54,Posthofbrug 5366,2019-12-12,07:00:00,323,254,69,FMN GV 16 Berchem TOT
54,Posthofbrug 5366,2019-12-12,08:00:00,547,402,145,FMN GV 16 Berchem TOT
54,Posthofbrug 5366,2019-12-12,09:00:00,206,155,51,FMN GV 16 Berchem TOT
54,Posthofbrug 5366,2019-12-12,10:00:00,105,76,29,FMN GV 16 Berchem TOT
54,Posthofbrug 5366,2019-12-12,11:00:00,92,60,32,FMN GV 16 Berchem TOT
54,Posthofbrug 5366,2019-12-12,12:00:00,135,78,57,FMN GV 16 Berchem TOT
54,Posthofbrug 5366,2019-12-12,13:00:00,122,68,54,FMN GV 16 Berchem TOT
54,Posthofbrug 5366,2019-12-12,14:00:00,98,41,57,FMN GV 16 Berchem TOT
54,Posthofbrug 5366,2019-12-12,15:00:00,154,67,87,FMN GV 16 Berchem TOT
54,Posthofbrug 5366,2019-12-12,16:00:00,250,117,133,FMN GV 16 Berchem TOT
54,Posthofbrug 5366,2019-12-12,17:00:00,349,126,223,FMN GV 16 Berchem TOT
54,Posthofbrug 5366,2019-12-12,18:00:00,233,84,149,FMN GV 16 Berchem TOT
54,Posthofbrug 5366,2019-12-12,19:00:00,111,41,70,FMN GV 16 Berchem TOT
54,Posthofbrug 5366,2019-12-12,20:00:00,68,29,39,FMN GV 16 Berchem TOT
54,Posthofbrug 5366,2019-12-12,21:00:00,53,26,27,FMN GV 16 Berchem TOT
54,Posthofbrug 5366,2019-12-12,22:00:00,51,13,38,FMN GV 16 Berchem TOT
54,Posthofbrug 5366,2019-12-12,23:00:00,48,10,38,FMN GV 16 Berchem TOT
54,Posthofbrug 5366,2019-12-13,00:00:00,26,6,20,FMN GV 16 Berchem TOT
54,Posthofbrug 5366,2019-12-13,01:00:00,9,0,9,FMN GV 16 Berchem TOT
54,Posthofbrug 5366,2019-12-13,02:00:00,6,0,6,FMN GV 16 Berchem TOT
54,Posthofbrug 5366,2019-12-13,03:00:00,3,0,3,FMN GV 16 Berchem TOT
54,Posthofbrug 5366,2019-12-13,04:00:00,6,4,2,FMN GV 16 Berchem TOT
54,Posthofbrug 5366,2019-12-13,05:00:00,17,12,5,FMN GV 16 Berchem TOT
54,Posthofbrug 5366,2019-12-13,06:00:00,55,49,6,FMN GV 16 Berchem TOT
54,Posthofbrug 5366,2019-12-13,07:00:00,238,180,58,FMN GV 16 Berchem TOT
54,Posthofbrug 5366,2019-12-13,08:00:00,404,279,125,FMN GV 16 Berchem TOT
54,Posthofbrug 5366,2019-12-13,09:00:00,159,116,43,FMN GV 16 Berchem TOT
54,Posthofbrug 5366,2019-12-13,10:00:00,64,42,22,FMN GV 16 Berchem TOT
54,Posthofbrug 5366,2019-12-13,11:00:00,84,63,21,FMN GV 16 Berchem TOT
54,Posthofbrug 5366,2019-12-13,12:00:00,92,57,35,FMN GV 16 Berchem TOT
54,Posthofbrug 5366,2019-12-13,13:00:00,89,42,47,FMN GV 16 Berchem TOT
54,Posthofbrug 5366,2019-12-13,14:00:00,70,36,34,FMN GV 16 Berchem TOT
54,Posthofbrug 5366,2019-12-13,15:00:00,144,61,83,FMN GV 16 Berchem TOT
54,Posthofbrug 5366,2019-12-13,16:00:00,197,96,101,FMN GV 16 Berchem TOT
54,Posthofbrug 5366,2019-12-13,17:00:00,233,92,141,FMN GV 16 Berchem TOT
54,Posthofbrug 5366,2019-12-13,18:00:00,186,87,99,FMN GV 16 Berchem TOT
54,Posthofbrug 5366,2019-12-13,19:00:00,86,39,47,FMN GV 16 Berchem TOT
54,Posthofbrug 5366,2019-12-13,20:00:00,64,36,28,FMN GV 16 Berchem TOT
54,Posthofbrug 5366,2019-12-13,21:00:00,54,28,26,FMN GV 16 Berchem TOT
54,Posthofbrug 5366,2019-12-13,22:00:00,46,20,26,FMN GV 16 Berchem TOT
54,Posthofbrug 5366,2019-12-13,23:00:00,28,8,20,FMN GV 16 Berchem TOT
54,Posthofbrug 5366,2019-12-14,00:00:00,40,9,31,FMN GV 16 Berchem TOT
54,Posthofbrug 5366,2019-12-14,01:00:00,26,4,22,FMN GV 16 Berchem TOT
54,Posthofbrug 5366,2019-12-14,02:00:00,12,4,8,FMN GV 16 Berchem TOT
54,Posthofbrug 5366,2019-12-14,03:00:00,14,0,14,FMN GV 16 Berchem TOT
54,Posthofbrug 5366,2019-12-14,04:00:00,6,3,3,FMN GV 16 Berchem TOT
54,Posthofbrug 5366,2019-12-14,05:00:00,6,1,5,FMN GV 16 Berchem TOT
54,Posthofbrug 5366,2019-12-14,06:00:00,14,9,5,FMN GV 16 Berchem TOT
54,Posthofbrug 5366,2019-12-14,07:00:00,21,16,5,FMN GV 16 Berchem TOT
54,Posthofbrug 5366,2019-12-14,08:00:00,29,22,7,FMN GV 16 Berchem TOT
54,Posthofbrug 5366,2019-12-14,09:00:00,52,34,18,FMN GV 16 Berchem TOT
54,Posthofbrug 5366,2019-12-14,10:00:00,57,42,15,FMN GV 16 Berchem TOT
54,Posthofbrug 5366,2019-12-14,11:00:00,61,41,20,FMN GV 16 Berchem TOT
54,Posthofbrug 5366,2019-12-14,12:00:00,71,47,24,FMN GV 16 Berchem TOT
54,Posthofbrug 5366,2019-12-14,13:00:00,42,24,18,FMN GV 16 Berchem TOT
54,Posthofbrug 5366,2019-12-14,14:00:00,63,40,23,FMN GV 16 Berchem TOT
54,Posthofbrug 5366,2019-12-14,15:00:00,38,20,18,FMN GV 16 Berchem TOT
54,Posthofbrug 5366,2019-12-14,16:00:00,66,25,41,FMN GV 16 Berchem TOT
54,Posthofbrug 5366,2019-12-14,17:00:00,72,42,30,FMN GV 16 Berchem TOT
54,Posthofbrug 5366,2019-12-14,18:00:00,54,33,21,FMN GV 16 Berchem TOT
54,Posthofbrug 5366,2019-12-14,19:00:00,61,38,23,FMN GV 16 Berchem TOT
54,Posthofbrug 5366,2019-12-14,20:00:00,43,25,18,FMN GV 16 Berchem TOT
54,Posthofbrug 5366,2019-12-14,21:00:00,31,13,18,FMN GV 16 Berchem TOT
54,Posthofbrug 5366,2019-12-14,22:00:00,32,19,13,FMN GV 16 Berchem TOT
54,Posthofbrug 5366,2019-12-14,23:00:00,34,12,22,FMN GV 16 Berchem TOT
54,Posthofbrug 5366,2019-12-15,00:00:00,36,11,25,FMN GV 16 Berchem TOT
54,Posthofbrug 5366,2019-12-15,01:00:00,23,5,18,FMN GV 16 Berchem TOT
54,Posthofbrug 5366,2019-12-15,02:00:00,16,3,13,FMN GV 16 Berchem TOT
54,Posthofbrug 5366,2019-12-15,03:00:00,3,2,1,FMN GV 16 Berchem TOT
54,Posthofbrug 5366,2019-12-15,04:00:00,13,2,11,FMN GV 16 Berchem TOT
54,Posthofbrug 5366,2019-12-15,05:00:00,5,2,3,FMN GV 16 Berchem TOT
54,Posthofbrug 5366,2019-12-15,06:00:00,2,2,0,FMN GV 16 Berchem TOT
54,Posthofbrug 5366,2019-12-15,07:00:00,16,10,6,FMN GV 16 Berchem TOT
54,Posthofbrug 5366,2019-12-15,08:00:00,18,9,9,FMN GV 16 Berchem TOT
54,Posthofbrug 5366,2019-12-15,09:00:00,36,22,14,FMN GV 16 Berchem TOT
54,Posthofbrug 5366,2019-12-15,10:00:00,53,43,10,FMN GV 16 Berchem TOT
54,Posthofbrug 5366,2019-12-15,11:00:00,80,50,30,FMN GV 16 Berchem TOT
54,Posthofbrug 5366,2019-12-15,12:00:00,79,51,28,FMN GV 16 Berchem TOT
54,Posthofbrug 5366,2019-12-15,13:00:00,96,58,38,FMN GV 16 Berchem TOT
54,Posthofbrug 5366,2019-12-15,14:00:00,85,50,35,FMN GV 16 Berchem TOT
54,Posthofbrug 5366,2019-12-15,15:00:00,79,54,25,FMN GV 16 Berchem TOT
54,Posthofbrug 5366,2019-12-15,16:00:00,73,31,42,FMN GV 16 Berchem TOT
54,Posthofbrug 5366,2019-12-15,17:00:00,58,17,41,FMN GV 16 Berchem TOT
54,Posthofbrug 5366,2019-12-15,18:00:00,41,16,25,FMN GV 16 Berchem TOT
54,Posthofbrug 5366,2019-12-15,19:00:00,45,24,21,FMN GV 16 Berchem TOT
54,Posthofbrug 5366,2019-12-15,20:00:00,36,23,13,FMN GV 16 Berchem TOT
54,Posthofbrug 5366,2019-12-15,21:00:00,22,14,8,FMN GV 16 Berchem TOT
54,Posthofbrug 5366,2019-12-15,22:00:00,22,9,13,FMN GV 16 Berchem TOT
54,Posthofbrug 5366,2019-12-15,23:00:00,14,6,8,FMN GV 16 Berchem TOT
54,Posthofbrug 5366,2019-12-16,00:00:00,19,4,15,FMN GV 16 Berchem TOT
54,Posthofbrug 5366,2019-12-16,01:00:00,2,0,2,FMN GV 16 Berchem TOT
54,Posthofbrug 5366,2019-12-16,02:00:00,1,0,1,FMN GV 16 Berchem TOT
54,Posthofbrug 5366,2019-12-16,03:00:00,2,0,2,FMN GV 16 Berchem TOT
54,Posthofbrug 5366,2019-12-16,04:00:00,7,6,1,FMN GV 16 Berchem TOT
54,Posthofbrug 5366,2019-12-16,05:00:00,19,16,3,FMN GV 16 Berchem TOT
54,Posthofbrug 5366,2019-12-16,06:00:00,93,78,15,FMN GV 16 Berchem TOT
54,Posthofbrug 5366,2019-12-16,07:00:00,318,246,72,FMN GV 16 Berchem TOT
54,Posthofbrug 5366,2019-12-16,08:00:00,542,399,143,FMN GV 16 Berchem TOT
54,Posthofbrug 5366,2019-12-16,09:00:00,191,135,56,FMN GV 16 Berchem TOT
54,Posthofbrug 5366,2019-12-16,10:00:00,79,55,24,FMN GV 16 Berchem TOT
54,Posthofbrug 5366,2019-12-16,11:00:00,84,60,24,FMN GV 16 Berchem TOT
54,Posthofbrug 5366,2019-12-16,12:00:00,97,56,41,FMN GV 16 Berchem TOT
54,Posthofbrug 5366,2019-12-16,13:00:00,95,47,48,FMN GV 16 Berchem TOT
54,Posthofbrug 5366,2019-12-16,14:00:00,81,31,50,FMN GV 16 Berchem TOT
54,Posthofbrug 5366,2019-12-16,15:00:00,142,51,91,FMN GV 16 Berchem TOT
54,Posthofbrug 5366,2019-12-16,16:00:00,260,97,163,FMN GV 16 Berchem TOT
54,Posthofbrug 5366,2019-12-16,17:00:00,358,148,210,FMN GV 16 Berchem TOT
54,Posthofbrug 5366,2019-12-16,18:00:00,240,78,162,FMN GV 16 Berchem TOT
54,Posthofbrug 5366,2019-12-16,19:00:00,106,39,67,FMN GV 16 Berchem TOT
54,Posthofbrug 5366,2019-12-16,20:00:00,68,18,50,FMN GV 16 Berchem TOT
54,Posthofbrug 5366,2019-12-16,21:00:00,35,15,20,FMN GV 16 Berchem TOT
54,Posthofbrug 5366,2019-12-16,22:00:00,46,14,32,FMN GV 16 Berchem TOT
54,Posthofbrug 5366,2019-12-16,23:00:00,38,10,28,FMN GV 16 Berchem TOT
54,Posthofbrug 5366,2019-12-17,00:00:00,5,1,4,FMN GV 16 Berchem TOT
54,Posthofbrug 5366,2019-12-17,01:00:00,7,2,5,FMN GV 16 Berchem TOT
54,Posthofbrug 5366,2019-12-17,02:00:00,1,0,1,FMN GV 16 Berchem TOT
54,Posthofbrug 5366,2019-12-17,03:00:00,5,0,5,FMN GV 16 Berchem TOT
54,Posthofbrug 5366,2019-12-17,04:00:00,7,6,1,FMN GV 16 Berchem TOT
54,Posthofbrug 5366,2019-12-17,05:00:00,19,16,3,FMN GV 16 Berchem TOT
54,Posthofbrug 5366,2019-12-17,06:00:00,94,77,17,FMN GV 16 Berchem TOT
54,Posthofbrug 5366,2019-12-17,07:00:00,366,281,85,FMN GV 16 Berchem TOT
54,Posthofbrug 5366,2019-12-17,08:00:00,588,424,164,FMN GV 16 Berchem TOT
54,Posthofbrug 5366,2019-12-17,09:00:00,224,158,66,FMN GV 16 Berchem TOT
54,Posthofbrug 5366,2019-12-17,10:00:00,116,76,40,FMN GV 16 Berchem TOT
54,Posthofbrug 5366,2019-12-17,11:00:00,94,63,31,FMN GV 16 Berchem TOT
54,Posthofbrug 5366,2019-12-17,12:00:00,169,97,72,FMN GV 16 Berchem TOT
54,Posthofbrug 5366,2019-12-17,13:00:00,130,75,55,FMN GV 16 Berchem TOT
54,Posthofbrug 5366,2019-12-17,14:00:00,132,69,63,FMN GV 16 Berchem TOT
54,Posthofbrug 5366,2019-12-17,15:00:00,202,88,114,FMN GV 16 Berchem TOT
54,Posthofbrug 5366,2019-12-17,16:00:00,318,113,205,FMN GV 16 Berchem TOT
54,Posthofbrug 5366,2019-12-17,17:00:00,455,164,291,FMN GV 16 Berchem TOT
54,Posthofbrug 5366,2019-12-17,18:00:00,300,123,177,FMN GV 16 Berchem TOT
54,Posthofbrug 5366,2019-12-17,19:00:00,139,44,95,FMN GV 16 Berchem TOT
54,Posthofbrug 5366,2019-12-17,20:00:00,64,30,34,FMN GV 16 Berchem TOT
54,Posthofbrug 5366,2019-12-17,21:00:00,77,33,44,FMN GV 16 Berchem TOT
54,Posthofbrug 5366,2019-12-17,22:00:00,74,27,47,FMN GV 16 Berchem TOT
54,Posthofbrug 5366,2019-12-17,23:00:00,47,14,33,FMN GV 16 Berchem TOT
54,Posthofbrug 5366,2019-12-18,00:00:00,38,11,27,FMN GV 16 Berchem TOT
54,Posthofbrug 5366,2019-12-18,01:00:00,9,2,7,FMN GV 16 Berchem TOT
54,Posthofbrug 5366,2019-12-18,02:00:00,7,1,6,FMN GV 16 Berchem TOT
54,Posthofbrug 5366,2019-12-18,03:00:00,6,2,4,FMN GV 16 Berchem TOT
54,Posthofbrug 5366,2019-12-18,04:00:00,7,3,4,FMN GV 16 Berchem TOT
54,Posthofbrug 5366,2019-12-18,05:00:00,23,18,5,FMN GV 16 Berchem TOT
54,Posthofbrug 5366,2019-12-18,06:00:00,90,76,14,FMN GV 16 Berchem TOT
54,Posthofbrug 5366,2019-12-18,07:00:00,288,228,60,FMN GV 16 Berchem TOT
54,Posthofbrug 5366,2019-12-18,08:00:00,514,368,146,FMN GV 16 Berchem TOT
54,Posthofbrug 5366,2019-12-18,09:00:00,201,146,55,FMN GV 16 Berchem TOT
54,Posthofbrug 5366,2019-12-18,10:00:00,109,75,34,FMN GV 16 Berchem TOT
54,Posthofbrug 5366,2019-12-18,11:00:00,118,74,44,FMN GV 16 Berchem TOT
54,Posthofbrug 5366,2019-12-18,12:00:00,170,87,83,FMN GV 16 Berchem TOT
54,Posthofbrug 5366,2019-12-18,13:00:00,158,78,80,FMN GV 16 Berchem TOT
54,Posthofbrug 5366,2019-12-18,14:00:00,113,56,57,FMN GV 16 Berchem TOT
54,Posthofbrug 5366,2019-12-18,15:00:00,160,65,95,FMN GV 16 Berchem TOT
54,Posthofbrug 5366,2019-12-18,16:00:00,234,104,130,FMN GV 16 Berchem TOT
54,Posthofbrug 5366,2019-12-18,17:00:00,334,151,183,FMN GV 16 Berchem TOT
54,Posthofbrug 5366,2019-12-18,18:00:00,257,104,153,FMN GV 16 Berchem TOT
54,Posthofbrug 5366,2019-12-18,19:00:00,130,60,70,FMN GV 16 Berchem TOT
54,Posthofbrug 5366,2019-12-18,20:00:00,67,32,35,FMN GV 16 Berchem TOT
54,Posthofbrug 5366,2019-12-18,21:00:00,77,33,44,FMN GV 16 Berchem TOT
54,Posthofbrug 5366,2019-12-18,22:00:00,64,22,42,FMN GV 16 Berchem TOT
54,Posthofbrug 5366,2019-12-18,23:00:00,48,21,27,FMN GV 16 Berchem TOT
54,Posthofbrug 5366,2019-12-19,00:00:00,25,8,17,FMN GV 16 Berchem TOT
54,Posthofbrug 5366,2019-12-19,01:00:00,7,2,5,FMN GV 16 Berchem TOT
54,Posthofbrug 5366,2019-12-19,02:00:00,2,1,1,FMN GV 16 Berchem TOT
54,Posthofbrug 5366,2019-12-19,03:00:00,4,1,3,FMN GV 16 Berchem TOT
54,Posthofbrug 5366,2019-12-19,04:00:00,15,4,11,FMN GV 16 Berchem TOT
54,Posthofbrug 5366,2019-12-19,05:00:00,11,8,3,FMN GV 16 Berchem TOT
54,Posthofbrug 5366,2019-12-19,06:00:00,81,70,11,FMN GV 16 Berchem TOT
54,Posthofbrug 5366,2019-12-19,07:00:00,274,229,45,FMN GV 16 Berchem TOT
54,Posthofbrug 5366,2019-12-19,08:00:00,552,431,121,FMN GV 16 Berchem TOT
54,Posthofbrug 5366,2019-12-19,09:00:00,217,162,55,FMN GV 16 Berchem TOT
54,Posthofbrug 5366,2019-12-19,10:00:00,107,72,35,FMN GV 16 Berchem TOT
54,Posthofbrug 5366,2019-12-19,11:00:00,129,85,44,FMN GV 16 Berchem TOT
54,Posthofbrug 5366,2019-12-19,12:00:00,138,81,57,FMN GV 16 Berchem TOT
54,Posthofbrug 5366,2019-12-19,13:00:00,119,61,58,FMN GV 16 Berchem TOT
54,Posthofbrug 5366,2019-12-19,14:00:00,123,60,63,FMN GV 16 Berchem TOT
54,Posthofbrug 5366,2019-12-19,15:00:00,204,82,122,FMN GV 16 Berchem TOT
54,Posthofbrug 5366,2019-12-19,16:00:00,316,108,208,FMN GV 16 Berchem TOT
54,Posthofbrug 5366,2019-12-19,17:00:00,367,132,235,FMN GV 16 Berchem TOT
54,Posthofbrug 5366,2019-12-19,18:00:00,208,77,131,FMN GV 16 Berchem TOT
54,Posthofbrug 5366,2019-12-19,19:00:00,132,58,74,FMN GV 16 Berchem TOT
54,Posthofbrug 5366,2019-12-19,20:00:00,88,37,51,FMN GV 16 Berchem TOT
54,Posthofbrug 5366,2019-12-19,21:00:00,61,17,44,FMN GV 16 Berchem TOT
54,Posthofbrug 5366,2019-12-19,22:00:00,88,24,64,FMN GV 16 Berchem TOT
54,Posthofbrug 5366,2019-12-19,23:00:00,60,17,43,FMN GV 16 Berchem TOT
54,Posthofbrug 5366,2019-12-20,00:00:00,35,6,29,FMN GV 16 Berchem TOT
54,Posthofbrug 5366,2019-12-20,01:00:00,13,2,11,FMN GV 16 Berchem TOT
54,Posthofbrug 5366,2019-12-20,02:00:00,16,7,9,FMN GV 16 Berchem TOT
54,Posthofbrug 5366,2019-12-20,03:00:00,8,1,7,FMN GV 16 Berchem TOT
54,Posthofbrug 5366,2019-12-20,04:00:00,9,6,3,FMN GV 16 Berchem TOT
54,Posthofbrug 5366,2019-12-20,05:00:00,15,8,7,FMN GV 16 Berchem TOT
54,Posthofbrug 5366,2019-12-20,06:00:00,61,57,4,FMN GV 16 Berchem TOT
54,Posthofbrug 5366,2019-12-20,07:00:00,234,179,55,FMN GV 16 Berchem TOT
54,Posthofbrug 5366,2019-12-20,08:00:00,399,287,112,FMN GV 16 Berchem TOT
54,Posthofbrug 5366,2019-12-20,09:00:00,168,131,37,FMN GV 16 Berchem TOT
54,Posthofbrug 5366,2019-12-20,10:00:00,69,49,20,FMN GV 16 Berchem TOT
54,Posthofbrug 5366,2019-12-20,11:00:00,84,59,25,FMN GV 16 Berchem TOT
54,Posthofbrug 5366,2019-12-20,12:00:00,72,43,29,FMN GV 16 Berchem TOT
54,Posthofbrug 5366,2019-12-20,13:00:00,100,47,53,FMN GV 16 Berchem TOT
54,Posthofbrug 5366,2019-12-20,14:00:00,89,44,45,FMN GV 16 Berchem TOT
54,Posthofbrug 5366,2019-12-20,15:00:00,161,73,88,FMN GV 16 Berchem TOT
54,Posthofbrug 5366,2019-12-20,16:00:00,209,91,118,FMN GV 16 Berchem TOT
54,Posthofbrug 5366,2019-12-20,17:00:00,239,92,147,FMN GV 16 Berchem TOT
54,Posthofbrug 5366,2019-12-20,18:00:00,167,79,88,FMN GV 16 Berchem TOT
54,Posthofbrug 5366,2019-12-20,19:00:00,106,56,50,FMN GV 16 Berchem TOT
54,Posthofbrug 5366,2019-12-20,20:00:00,69,36,33,FMN GV 16 Berchem TOT
54,Posthofbrug 5366,2019-12-20,21:00:00,52,34,18,FMN GV 16 Berchem TOT
54,Posthofbrug 5366,2019-12-20,22:00:00,60,16,44,FMN GV 16 Berchem TOT
54,Posthofbrug 5366,2019-12-20,23:00:00,61,16,45,FMN GV 16 Berchem TOT
54,Posthofbrug 5366,2019-12-21,00:00:00,40,23,17,FMN GV 16 Berchem TOT
54,Posthofbrug 5366,2019-12-21,01:00:00,24,3,21,FMN GV 16 Berchem TOT
54,Posthofbrug 5366,2019-12-21,02:00:00,35,6,29,FMN GV 16 Berchem TOT
54,Posthofbrug 5366,2019-12-21,03:00:00,21,10,11,FMN GV 16 Berchem TOT
54,Posthofbrug 5366,2019-12-21,04:00:00,12,5,7,FMN GV 16 Berchem TOT
54,Posthofbrug 5366,2019-12-21,05:00:00,11,2,9,FMN GV 16 Berchem TOT
54,Posthofbrug 5366,2019-12-21,06:00:00,18,15,3,FMN GV 16 Berchem TOT
54,Posthofbrug 5366,2019-12-21,07:00:00,22,15,7,FMN GV 16 Berchem TOT
54,Posthofbrug 5366,2019-12-21,08:00:00,32,18,14,FMN GV 16 Berchem TOT
54,Posthofbrug 5366,2019-12-21,09:00:00,42,36,6,FMN GV 16 Berchem TOT
54,Posthofbrug 5366,2019-12-21,10:00:00,75,56,19,FMN GV 16 Berchem TOT
54,Posthofbrug 5366,2019-12-21,11:00:00,71,49,22,FMN GV 16 Berchem TOT
54,Posthofbrug 5366,2019-12-21,12:00:00,98,60,38,FMN GV 16 Berchem TOT
54,Posthofbrug 5366,2019-12-21,13:00:00,86,52,34,FMN GV 16 Berchem TOT
54,Posthofbrug 5366,2019-12-21,14:00:00,96,61,35,FMN GV 16 Berchem TOT
54,Posthofbrug 5366,2019-12-21,15:00:00,89,54,35,FMN GV 16 Berchem TOT
54,Posthofbrug 5366,2019-12-21,16:00:00,77,37,40,FMN GV 16 Berchem TOT
54,Posthofbrug 5366,2019-12-21,17:00:00,78,36,42,FMN GV 16 Berchem TOT
54,Posthofbrug 5366,2019-12-21,18:00:00,98,55,43,FMN GV 16 Berchem TOT
54,Posthofbrug 5366,2019-12-21,19:00:00,71,45,26,FMN GV 16 Berchem TOT
54,Posthofbrug 5366,2019-12-21,20:00:00,39,22,17,FMN GV 16 Berchem TOT
54,Posthofbrug 5366,2019-12-21,21:00:00,42,20,22,FMN GV 16 Berchem TOT
54,Posthofbrug 5366,2019-12-21,22:00:00,47,17,30,FMN GV 16 Berchem TOT
54,Posthofbrug 5366,2019-12-21,23:00:00,23,7,16,FMN GV 16 Berchem TOT
54,Posthofbrug 5366,2019-12-22,00:00:00,31,4,27,FMN GV 16 Berchem TOT
54,Posthofbrug 5366,2019-12-22,01:00:00,14,4,10,FMN GV 16 Berchem TOT
54,Posthofbrug 5366,2019-12-22,02:00:00,15,0,15,FMN GV 16 Berchem TOT
54,Posthofbrug 5366,2019-12-22,03:00:00,9,0,9,FMN GV 16 Berchem TOT
54,Posthofbrug 5366,2019-12-22,04:00:00,4,3,1,FMN GV 16 Berchem TOT
54,Posthofbrug 5366,2019-12-22,05:00:00,6,1,5,FMN GV 16 Berchem TOT
54,Posthofbrug 5366,2019-12-22,06:00:00,11,7,4,FMN GV 16 Berchem TOT
54,Posthofbrug 5366,2019-12-22,07:00:00,10,6,4,FMN GV 16 Berchem TOT
54,Posthofbrug 5366,2019-12-22,08:00:00,13,6,7,FMN GV 16 Berchem TOT
54,Posthofbrug 5366,2019-12-22,09:00:00,22,14,8,FMN GV 16 Berchem TOT
54,Posthofbrug 5366,2019-12-22,10:00:00,38,27,11,FMN GV 16 Berchem TOT
54,Posthofbrug 5366,2019-12-22,11:00:00,48,34,14,FMN GV 16 Berchem TOT
54,Posthofbrug 5366,2019-12-22,12:00:00,55,32,23,FMN GV 16 Berchem TOT
54,Posthofbrug 5366,2019-12-22,13:00:00,46,29,17,FMN GV 16 Berchem TOT
54,Posthofbrug 5366,2019-12-22,14:00:00,39,23,16,FMN GV 16 Berchem TOT
54,Posthofbrug 5366,2019-12-22,15:00:00,34,7,27,FMN GV 16 Berchem TOT
54,Posthofbrug 5366,2019-12-22,16:00:00,35,17,18,FMN GV 16 Berchem TOT
54,Posthofbrug 5366,2019-12-22,17:00:00,41,26,15,FMN GV 16 Berchem TOT
54,Posthofbrug 5366,2019-12-22,18:00:00,45,20,25,FMN GV 16 Berchem TOT
54,Posthofbrug 5366,2019-12-22,19:00:00,42,24,18,FMN GV 16 Berchem TOT
54,Posthofbrug 5366,2019-12-22,20:00:00,41,20,21,FMN GV 16 Berchem TOT
54,Posthofbrug 5366,2019-12-22,21:00:00,20,8,12,FMN GV 16 Berchem TOT
54,Posthofbrug 5366,2019-12-22,22:00:00,27,12,15,FMN GV 16 Berchem TOT
54,Posthofbrug 5366,2019-12-22,23:00:00,15,5,10,FMN GV 16 Berchem TOT
54,Posthofbrug 5366,2019-12-23,00:00:00,8,6,2,FMN GV 16 Berchem TOT
54,Posthofbrug 5366,2019-12-23,01:00:00,5,1,4,FMN GV 16 Berchem TOT
54,Posthofbrug 5366,2019-12-23,02:00:00,2,0,2,FMN GV 16 Berchem TOT
54,Posthofbrug 5366,2019-12-23,03:00:00,2,1,1,FMN GV 16 Berchem TOT
54,Posthofbrug 5366,2019-12-23,04:00:00,7,6,1,FMN GV 16 Berchem TOT
54,Posthofbrug 5366,2019-12-23,05:00:00,9,9,0,FMN GV 16 Berchem TOT
54,Posthofbrug 5366,2019-12-23,06:00:00,56,46,10,FMN GV 16 Berchem TOT
54,Posthofbrug 5366,2019-12-23,07:00:00,144,98,46,FMN GV 16 Berchem TOT
54,Posthofbrug 5366,2019-12-23,08:00:00,236,172,64,FMN GV 16 Berchem TOT
54,Posthofbrug 5366,2019-12-23,09:00:00,133,95,38,FMN GV 16 Berchem TOT
54,Posthofbrug 5366,2019-12-23,10:00:00,79,56,23,FMN GV 16 Berchem TOT
54,Posthofbrug 5366,2019-12-23,11:00:00,73,52,21,FMN GV 16 Berchem TOT
54,Posthofbrug 5366,2019-12-23,12:00:00,63,40,23,FMN GV 16 Berchem TOT
54,Posthofbrug 5366,2019-12-23,13:00:00,68,32,36,FMN GV 16 Berchem TOT
54,Posthofbrug 5366,2019-12-23,14:00:00,65,40,25,FMN GV 16 Berchem TOT
54,Posthofbrug 5366,2019-12-23,15:00:00,82,44,38,FMN GV 16 Berchem TOT
54,Posthofbrug 5366,2019-12-23,16:00:00,165,75,90,FMN GV 16 Berchem TOT
54,Posthofbrug 5366,2019-12-23,17:00:00,203,89,114,FMN GV 16 Berchem TOT
54,Posthofbrug 5366,2019-12-23,18:00:00,158,58,100,FMN GV 16 Berchem TOT
54,Posthofbrug 5366,2019-12-23,19:00:00,69,30,39,FMN GV 16 Berchem TOT
54,Posthofbrug 5366,2019-12-23,20:00:00,62,32,30,FMN GV 16 Berchem TOT
54,Posthofbrug 5366,2019-12-23,21:00:00,25,12,13,FMN GV 16 Berchem TOT
54,Posthofbrug 5366,2019-12-23,22:00:00,29,8,21,FMN GV 16 Berchem TOT
54,Posthofbrug 5366,2019-12-23,23:00:00,34,14,20,FMN GV 16 Berchem TOT
54,Posthofbrug 5366,2019-12-24,00:00:00,23,10,13,FMN GV 16 Berchem TOT
54,Posthofbrug 5366,2019-12-24,01:00:00,11,4,7,FMN GV 16 Berchem TOT
54,Posthofbrug 5366,2019-12-24,02:00:00,3,0,3,FMN GV 16 Berchem TOT
54,Posthofbrug 5366,2019-12-24,03:00:00,3,1,2,FMN GV 16 Berchem TOT
54,Posthofbrug 5366,2019-12-24,04:00:00,8,6,2,FMN GV 16 Berchem TOT
54,Posthofbrug 5366,2019-12-24,05:00:00,9,6,3,FMN GV 16 Berchem TOT
54,Posthofbrug 5366,2019-12-24,06:00:00,42,31,11,FMN GV 16 Berchem TOT
54,Posthofbrug 5366,2019-12-24,07:00:00,100,70,30,FMN GV 16 Berchem TOT
54,Posthofbrug 5366,2019-12-24,08:00:00,144,106,38,FMN GV 16 Berchem TOT
54,Posthofbrug 5366,2019-12-24,09:00:00,80,53,27,FMN GV 16 Berchem TOT
54,Posthofbrug 5366,2019-12-24,10:00:00,48,33,15,FMN GV 16 Berchem TOT
54,Posthofbrug 5366,2019-12-24,11:00:00,56,31,25,FMN GV 16 Berchem TOT
54,Posthofbrug 5366,2019-12-24,12:00:00,86,47,39,FMN GV 16 Berchem TOT
54,Posthofbrug 5366,2019-12-24,13:00:00,77,37,40,FMN GV 16 Berchem TOT
54,Posthofbrug 5366,2019-12-24,14:00:00,64,25,39,FMN GV 16 Berchem TOT
54,Posthofbrug 5366,2019-12-24,15:00:00,126,65,61,FMN GV 16 Berchem TOT
54,Posthofbrug 5366,2019-12-24,16:00:00,135,49,86,FMN GV 16 Berchem TOT
54,Posthofbrug 5366,2019-12-24,17:00:00,80,24,56,FMN GV 16 Berchem TOT
54,Posthofbrug 5366,2019-12-24,18:00:00,33,13,20,FMN GV 16 Berchem TOT
54,Posthofbrug 5366,2019-12-24,19:00:00,18,6,12,FMN GV 16 Berchem TOT
54,Posthofbrug 5366,2019-12-24,20:00:00,5,2,3,FMN GV 16 Berchem TOT
54,Posthofbrug 5366,2019-12-24,21:00:00,21,10,11,FMN GV 16 Berchem TOT
54,Posthofbrug 5366,2019-12-24,22:00:00,18,10,8,FMN GV 16 Berchem TOT
54,Posthofbrug 5366,2019-12-24,23:00:00,33,23,10,FMN GV 16 Berchem TOT
54,Posthofbrug 5366,2019-12-25,00:00:00,21,16,5,FMN GV 16 Berchem TOT
54,Posthofbrug 5366,2019-12-25,01:00:00,10,7,3,FMN GV 16 Berchem TOT
54,Posthofbrug 5366,2019-12-25,02:00:00,6,5,1,FMN GV 16 Berchem TOT
54,Posthofbrug 5366,2019-12-25,03:00:00,9,8,1,FMN GV 16 Berchem TOT
54,Posthofbrug 5366,2019-12-25,04:00:00,7,3,4,FMN GV 16 Berchem TOT
54,Posthofbrug 5366,2019-12-25,05:00:00,6,4,2,FMN GV 16 Berchem TOT
54,Posthofbrug 5366,2019-12-25,06:00:00,5,4,1,FMN GV 16 Berchem TOT
54,Posthofbrug 5366,2019-12-25,07:00:00,6,4,2,FMN GV 16 Berchem TOT
54,Posthofbrug 5366,2019-12-25,08:00:00,6,4,2,FMN GV 16 Berchem TOT
54,Posthofbrug 5366,2019-12-25,09:00:00,35,27,8,FMN GV 16 Berchem TOT
54,Posthofbrug 5366,2019-12-25,10:00:00,22,12,10,FMN GV 16 Berchem TOT
54,Posthofbrug 5366,2019-12-25,11:00:00,38,14,24,FMN GV 16 Berchem TOT
54,Posthofbrug 5366,2019-12-25,12:00:00,43,26,17,FMN GV 16 Berchem TOT
54,Posthofbrug 5366,2019-12-25,13:00:00,60,39,21,FMN GV 16 Berchem TOT
54,Posthofbrug 5366,2019-12-25,14:00:00,54,26,28,FMN GV 16 Berchem TOT
54,Posthofbrug 5366,2019-12-25,15:00:00,50,28,22,FMN GV 16 Berchem TOT
54,Posthofbrug 5366,2019-12-25,16:00:00,53,26,27,FMN GV 16 Berchem TOT
54,Posthofbrug 5366,2019-12-25,17:00:00,49,20,29,FMN GV 16 Berchem TOT
54,Posthofbrug 5366,2019-12-25,18:00:00,35,16,19,FMN GV 16 Berchem TOT
54,Posthofbrug 5366,2019-12-25,19:00:00,22,9,13,FMN GV 16 Berchem TOT
54,Posthofbrug 5366,2019-12-25,20:00:00,19,14,5,FMN GV 16 Berchem TOT
54,Posthofbrug 5366,2019-12-25,21:00:00,20,12,8,FMN GV 16 Berchem TOT
54,Posthofbrug 5366,2019-12-25,22:00:00,28,13,15,FMN GV 16 Berchem TOT
54,Posthofbrug 5366,2019-12-25,23:00:00,20,10,10,FMN GV 16 Berchem TOT
54,Posthofbrug 5366,2019-12-26,00:00:00,25,17,8,FMN GV 16 Berchem TOT
54,Posthofbrug 5366,2019-12-26,01:00:00,6,2,4,FMN GV 16 Berchem TOT
54,Posthofbrug 5366,2019-12-26,02:00:00,1,0,1,FMN GV 16 Berchem TOT
54,Posthofbrug 5366,2019-12-26,03:00:00,1,0,1,FMN GV 16 Berchem TOT
54,Posthofbrug 5366,2019-12-26,04:00:00,13,7,6,FMN GV 16 Berchem TOT
54,Posthofbrug 5366,2019-12-26,05:00:00,11,9,2,FMN GV 16 Berchem TOT
54,Posthofbrug 5366,2019-12-26,06:00:00,21,17,4,FMN GV 16 Berchem TOT
54,Posthofbrug 5366,2019-12-26,07:00:00,60,45,15,FMN GV 16 Berchem TOT
54,Posthofbrug 5366,2019-12-26,08:00:00,79,59,20,FMN GV 16 Berchem TOT
54,Posthofbrug 5366,2019-12-26,09:00:00,44,33,11,FMN GV 16 Berchem TOT
54,Posthofbrug 5366,2019-12-26,10:00:00,36,24,12,FMN GV 16 Berchem TOT
54,Posthofbrug 5366,2019-12-26,11:00:00,54,36,18,FMN GV 16 Berchem TOT
54,Posthofbrug 5366,2019-12-26,12:00:00,57,33,24,FMN GV 16 Berchem TOT
54,Posthofbrug 5366,2019-12-26,13:00:00,68,46,22,FMN GV 16 Berchem TOT
54,Posthofbrug 5366,2019-12-26,14:00:00,68,36,32,FMN GV 16 Berchem TOT
54,Posthofbrug 5366,2019-12-26,15:00:00,44,19,25,FMN GV 16 Berchem TOT
54,Posthofbrug 5366,2019-12-26,16:00:00,78,30,48,FMN GV 16 Berchem TOT
54,Posthofbrug 5366,2019-12-26,17:00:00,94,35,59,FMN GV 16 Berchem TOT
54,Posthofbrug 5366,2019-12-26,18:00:00,72,26,46,FMN GV 16 Berchem TOT
54,Posthofbrug 5366,2019-12-26,19:00:00,52,29,23,FMN GV 16 Berchem TOT
54,Posthofbrug 5366,2019-12-26,20:00:00,35,12,23,FMN GV 16 Berchem TOT
54,Posthofbrug 5366,2019-12-26,21:00:00,12,5,7,FMN GV 16 Berchem TOT
54,Posthofbrug 5366,2019-12-26,22:00:00,31,18,13,FMN GV 16 Berchem TOT
54,Posthofbrug 5366,2019-12-26,23:00:00,16,7,9,FMN GV 16 Berchem TOT
54,Posthofbrug 5366,2019-12-27,00:00:00,20,8,12,FMN GV 16 Berchem TOT
54,Posthofbrug 5366,2019-12-27,01:00:00,10,3,7,FMN GV 16 Berchem TOT
54,Posthofbrug 5366,2019-12-27,02:00:00,9,6,3,FMN GV 16 Berchem TOT
54,Posthofbrug 5366,2019-12-27,03:00:00,11,4,7,FMN GV 16 Berchem TOT
54,Posthofbrug 5366,2019-12-27,04:00:00,10,8,2,FMN GV 16 Berchem TOT
54,Posthofbrug 5366,2019-12-27,05:00:00,10,8,2,FMN GV 16 Berchem TOT
54,Posthofbrug 5366,2019-12-27,06:00:00,30,26,4,FMN GV 16 Berchem TOT
54,Posthofbrug 5366,2019-12-27,07:00:00,68,48,20,FMN GV 16 Berchem TOT
54,Posthofbrug 5366,2019-12-27,08:00:00,119,85,34,FMN GV 16 Berchem TOT
54,Posthofbrug 5366,2019-12-27,09:00:00,100,68,32,FMN GV 16 Berchem TOT
54,Posthofbrug 5366,2019-12-27,10:00:00,55,39,16,FMN GV 16 Berchem TOT
54,Posthofbrug 5366,2019-12-27,11:00:00,87,62,25,FMN GV 16 Berchem TOT
54,Posthofbrug 5366,2019-12-27,12:00:00,78,49,29,FMN GV 16 Berchem TOT
54,Posthofbrug 5366,2019-12-27,13:00:00,70,39,31,FMN GV 16 Berchem TOT
54,Posthofbrug 5366,2019-12-27,14:00:00,76,42,34,FMN GV 16 Berchem TOT
54,Posthofbrug 5366,2019-12-27,15:00:00,99,48,51,FMN GV 16 Berchem TOT
54,Posthofbrug 5366,2019-12-27,16:00:00,112,53,59,FMN GV 16 Berchem TOT
54,Posthofbrug 5366,2019-12-27,17:00:00,136,57,79,FMN GV 16 Berchem TOT
54,Posthofbrug 5366,2019-12-27,18:00:00,89,45,44,FMN GV 16 Berchem TOT
54,Posthofbrug 5366,2019-12-27,19:00:00,53,28,25,FMN GV 16 Berchem TOT
54,Posthofbrug 5366,2019-12-27,20:00:00,62,37,25,FMN GV 16 Berchem TOT
54,Posthofbrug 5366,2019-12-27,21:00:00,44,17,27,FMN GV 16 Berchem TOT
54,Posthofbrug 5366,2019-12-27,22:00:00,25,11,14,FMN GV 16 Berchem TOT
54,Posthofbrug 5366,2019-12-27,23:00:00,39,16,23,FMN GV 16 Berchem TOT
54,Posthofbrug 5366,2019-12-28,00:00:00,37,11,26,FMN GV 16 Berchem TOT
54,Posthofbrug 5366,2019-12-28,01:00:00,19,3,16,FMN GV 16 Berchem TOT
54,Posthofbrug 5366,2019-12-28,02:00:00,19,2,17,FMN GV 16 Berchem TOT
54,Posthofbrug 5366,2019-12-28,03:00:00,15,3,12,FMN GV 16 Berchem TOT
54,Posthofbrug 5366,2019-12-28,04:00:00,12,5,7,FMN GV 16 Berchem TOT
54,Posthofbrug 5366,2019-12-28,05:00:00,8,3,5,FMN GV 16 Berchem TOT
54,Posthofbrug 5366,2019-12-28,06:00:00,15,8,7,FMN GV 16 Berchem TOT
54,Posthofbrug 5366,2019-12-28,07:00:00,21,11,10,FMN GV 16 Berchem TOT
54,Posthofbrug 5366,2019-12-28,08:00:00,31,18,13,FMN GV 16 Berchem TOT
54,Posthofbrug 5366,2019-12-28,09:00:00,45,31,14,FMN GV 16 Berchem TOT
54,Posthofbrug 5366,2019-12-28,10:00:00,48,36,12,FMN GV 16 Berchem TOT
54,Posthofbrug 5366,2019-12-28,11:00:00,73,53,20,FMN GV 16 Berchem TOT
54,Posthofbrug 5366,2019-12-28,12:00:00,77,53,24,FMN GV 16 Berchem TOT
54,Posthofbrug 5366,2019-12-28,13:00:00,83,57,26,FMN GV 16 Berchem TOT
54,Posthofbrug 5366,2019-12-28,14:00:00,94,60,34,FMN GV 16 Berchem TOT
54,Posthofbrug 5366,2019-12-28,15:00:00,102,54,48,FMN GV 16 Berchem TOT
54,Posthofbrug 5366,2019-12-28,16:00:00,76,29,47,FMN GV 16 Berchem TOT
54,Posthofbrug 5366,2019-12-28,17:00:00,61,23,38,FMN GV 16 Berchem TOT
54,Posthofbrug 5366,2019-12-28,18:00:00,64,29,35,FMN GV 16 Berchem TOT
54,Posthofbrug 5366,2019-12-28,19:00:00,64,25,39,FMN GV 16 Berchem TOT
54,Posthofbrug 5366,2019-12-28,20:00:00,42,29,13,FMN GV 16 Berchem TOT
54,Posthofbrug 5366,2019-12-28,21:00:00,30,12,18,FMN GV 16 Berchem TOT
54,Posthofbrug 5366,2019-12-28,22:00:00,41,16,25,FMN GV 16 Berchem TOT
54,Posthofbrug 5366,2019-12-28,23:00:00,22,3,19,FMN GV 16 Berchem TOT
54,Posthofbrug 5366,2019-12-29,00:00:00,22,5,17,FMN GV 16 Berchem TOT
54,Posthofbrug 5366,2019-12-29,01:00:00,13,4,9,FMN GV 16 Berchem TOT
54,Posthofbrug 5366,2019-12-29,02:00:00,11,1,10,FMN GV 16 Berchem TOT
54,Posthofbrug 5366,2019-12-29,03:00:00,6,2,4,FMN GV 16 Berchem TOT
54,Posthofbrug 5366,2019-12-29,04:00:00,6,2,4,FMN GV 16 Berchem TOT
54,Posthofbrug 5366,2019-12-29,05:00:00,6,3,3,FMN GV 16 Berchem TOT
54,Posthofbrug 5366,2019-12-29,06:00:00,5,2,3,FMN GV 16 Berchem TOT
54,Posthofbrug 5366,2019-12-29,07:00:00,10,4,6,FMN GV 16 Berchem TOT
54,Posthofbrug 5366,2019-12-29,08:00:00,14,7,7,FMN GV 16 Berchem TOT
54,Posthofbrug 5366,2019-12-29,09:00:00,28,19,9,FMN GV 16 Berchem TOT
54,Posthofbrug 5366,2019-12-29,10:00:00,65,50,15,FMN GV 16 Berchem TOT
54,Posthofbrug 5366,2019-12-29,11:00:00,60,42,18,FMN GV 16 Berchem TOT
54,Posthofbrug 5366,2019-12-29,12:00:00,49,34,15,FMN GV 16 Berchem TOT
54,Posthofbrug 5366,2019-12-29,13:00:00,79,52,27,FMN GV 16 Berchem TOT
54,Posthofbrug 5366,2019-12-29,14:00:00,83,58,25,FMN GV 16 Berchem TOT
54,Posthofbrug 5366,2019-12-29,15:00:00,87,53,34,FMN GV 16 Berchem TOT
54,Posthofbrug 5366,2019-12-29,16:00:00,65,28,37,FMN GV 16 Berchem TOT
54,Posthofbrug 5366,2019-12-29,17:00:00,74,34,40,FMN GV 16 Berchem TOT
54,Posthofbrug 5366,2019-12-29,18:00:00,72,32,40,FMN GV 16 Berchem TOT
54,Posthofbrug 5366,2019-12-29,19:00:00,37,16,21,FMN GV 16 Berchem TOT
54,Posthofbrug 5366,2019-12-29,20:00:00,26,12,14,FMN GV 16 Berchem TOT
54,Posthofbrug 5366,2019-12-29,21:00:00,25,9,16,FMN GV 16 Berchem TOT
54,Posthofbrug 5366,2019-12-29,22:00:00,41,10,31,FMN GV 16 Berchem TOT
54,Posthofbrug 5366,2019-12-29,23:00:00,19,8,11,FMN GV 16 Berchem TOT
54,Posthofbrug 5366,2019-12-30,00:00:00,24,12,12,FMN GV 16 Berchem TOT
54,Posthofbrug 5366,2019-12-30,01:00:00,5,1,4,FMN GV 16 Berchem TOT
54,Posthofbrug 5366,2019-12-30,02:00:00,2,1,1,FMN GV 16 Berchem TOT
54,Posthofbrug 5366,2019-12-30,03:00:00,6,4,2,FMN GV 16 Berchem TOT
54,Posthofbrug 5366,2019-12-30,04:00:00,9,8,1,FMN GV 16 Berchem TOT
54,Posthofbrug 5366,2019-12-30,05:00:00,6,2,4,FMN GV 16 Berchem TOT
54,Posthofbrug 5366,2019-12-30,06:00:00,35,27,8,FMN GV 16 Berchem TOT
54,Posthofbrug 5366,2019-12-30,07:00:00,95,71,24,FMN GV 16 Berchem TOT
54,Posthofbrug 5366,2019-12-30,08:00:00,140,102,38,FMN GV 16 Berchem TOT
54,Posthofbrug 5366,2019-12-30,09:00:00,79,56,23,FMN GV 16 Berchem TOT
54,Posthofbrug 5366,2019-12-30,10:00:00,74,57,17,FMN GV 16 Berchem TOT
54,Posthofbrug 5366,2019-12-30,11:00:00,70,42,28,FMN GV 16 Berchem TOT
54,Posthofbrug 5366,2019-12-30,12:00:00,77,49,28,FMN GV 16 Berchem TOT
54,Posthofbrug 5366,2019-12-30,13:00:00,103,64,39,FMN GV 16 Berchem TOT
54,Posthofbrug 5366,2019-12-30,14:00:00,85,55,30,FMN GV 16 Berchem TOT
54,Posthofbrug 5366,2019-12-30,15:00:00,113,53,60,FMN GV 16 Berchem TOT
54,Posthofbrug 5366,2019-12-30,16:00:00,107,51,56,FMN GV 16 Berchem TOT
54,Posthofbrug 5366,2019-12-30,17:00:00,186,77,109,FMN GV 16 Berchem TOT
54,Posthofbrug 5366,2019-12-30,18:00:00,108,36,72,FMN GV 16 Berchem TOT
54,Posthofbrug 5366,2019-12-30,19:00:00,56,23,33,FMN GV 16 Berchem TOT
54,Posthofbrug 5366,2019-12-30,20:00:00,36,19,17,FMN GV 16 Berchem TOT
54,Posthofbrug 5366,2019-12-30,21:00:00,30,16,14,FMN GV 16 Berchem TOT
54,Posthofbrug 5366,2019-12-30,22:00:00,22,6,16,FMN GV 16 Berchem TOT
54,Posthofbrug 5366,2019-12-30,23:00:00,30,12,18,FMN GV 16 Berchem TOT
54,Posthofbrug 5366,2019-12-31,00:00:00,9,2,7,FMN GV 16 Berchem TOT
54,Posthofbrug 5366,2019-12-31,01:00:00,7,5,2,FMN GV 16 Berchem TOT
54,Posthofbrug 5366,2019-12-31,02:00:00,5,1,4,FMN GV 16 Berchem TOT
54,Posthofbrug 5366,2019-12-31,03:00:00,4,2,2,FMN GV 16 Berchem TOT
54,Posthofbrug 5366,2019-12-31,04:00:00,9,9,0,FMN GV 16 Berchem TOT
54,Posthofbrug 5366,2019-12-31,05:00:00,7,5,2,FMN GV 16 Berchem TOT
54,Posthofbrug 5366,2019-12-31,06:00:00,24,18,6,FMN GV 16 Berchem TOT
54,Posthofbrug 5366,2019-12-31,07:00:00,67,50,17,FMN GV 16 Berchem TOT
54,Posthofbrug 5366,2019-12-31,08:00:00,112,79,33,FMN GV 16 Berchem TOT
54,Posthofbrug 5366,2019-12-31,09:00:00,64,43,21,FMN GV 16 Berchem TOT
54,Posthofbrug 5366,2019-12-31,10:00:00,67,41,26,FMN GV 16 Berchem TOT
54,Posthofbrug 5366,2019-12-31,11:00:00,45,25,20,FMN GV 16 Berchem TOT
54,Posthofbrug 5366,2019-12-31,12:00:00,74,44,30,FMN GV 16 Berchem TOT
54,Posthofbrug 5366,2019-12-31,13:00:00,71,45,26,FMN GV 16 Berchem TOT
54,Posthofbrug 5366,2019-12-31,14:00:00,67,36,31,FMN GV 16 Berchem TOT
54,Posthofbrug 5366,2019-12-31,15:00:00,92,44,48,FMN GV 16 Berchem TOT
54,Posthofbrug 5366,2019-12-31,16:00:00,125,50,75,FMN GV 16 Berchem TOT
54,Posthofbrug 5366,2019-12-31,17:00:00,86,43,43,FMN GV 16 Berchem TOT
54,Posthofbrug 5366,2019-12-31,18:00:00,114,74,40,FMN GV 16 Berchem TOT
54,Posthofbrug 5366,2019-12-31,19:00:00,50,35,15,FMN GV 16 Berchem TOT
54,Posthofbrug 5366,2019-12-31,20:00:00,24,16,8,FMN GV 16 Berchem TOT
54,Posthofbrug 5366,2019-12-31,21:00:00,17,5,12,FMN GV 16 Berchem TOT
54,Posthofbrug 5366,2019-12-31,22:00:00,35,27,8,FMN GV 16 Berchem TOT
54,Posthofbrug 5366,2019-12-31,23:00:00,37,35,2,FMN GV 16 Berchem TOT
54,Posthofbrug 5366,2020-01-01,00:00:00,13,7,6,FMN GV 16 Berchem TOT
54,Posthofbrug 5366,2020-01-01,01:00:00,59,32,27,FMN GV 16 Berchem TOT
54,Posthofbrug 5366,2020-01-01,02:00:00,62,27,35,FMN GV 16 Berchem TOT
54,Posthofbrug 5366,2020-01-01,03:00:00,45,20,25,FMN GV 16 Berchem TOT
54,Posthofbrug 5366,2020-01-01,04:00:00,37,8,29,FMN GV 16 Berchem TOT
54,Posthofbrug 5366,2020-01-01,05:00:00,55,8,47,FMN GV 16 Berchem TOT
54,Posthofbrug 5366,2020-01-01,06:00:00,36,8,28,FMN GV 16 Berchem TOT
54,Posthofbrug 5366,2020-01-01,07:00:00,12,7,5,FMN GV 16 Berchem TOT
54,Posthofbrug 5366,2020-01-01,08:00:00,7,1,6,FMN GV 16 Berchem TOT
54,Posthofbrug 5366,2020-01-01,09:00:00,10,8,2,FMN GV 16 Berchem TOT
54,Posthofbrug 5366,2020-01-01,10:00:00,20,14,6,FMN GV 16 Berchem TOT
54,Posthofbrug 5366,2020-01-01,11:00:00,36,24,12,FMN GV 16 Berchem TOT
54,Posthofbrug 5366,2020-01-01,12:00:00,34,14,20,FMN GV 16 Berchem TOT
54,Posthofbrug 5366,2020-01-01,13:00:00,32,17,15,FMN GV 16 Berchem TOT
54,Posthofbrug 5366,2020-01-01,14:00:00,67,41,26,FMN GV 16 Berchem TOT
54,Posthofbrug 5366,2020-01-01,15:00:00,59,29,30,FMN GV 16 Berchem TOT
54,Posthofbrug 5366,2020-01-01,16:00:00,54,26,28,FMN GV 16 Berchem TOT
54,Posthofbrug 5366,2020-01-01,17:00:00,53,18,35,FMN GV 16 Berchem TOT
54,Posthofbrug 5366,2020-01-01,18:00:00,40,13,27,FMN GV 16 Berchem TOT
54,Posthofbrug 5366,2020-01-01,19:00:00,26,11,15,FMN GV 16 Berchem TOT
54,Posthofbrug 5366,2020-01-01,20:00:00,21,7,14,FMN GV 16 Berchem TOT
54,Posthofbrug 5366,2020-01-01,21:00:00,31,12,19,FMN GV 16 Berchem TOT
54,Posthofbrug 5366,2020-01-01,22:00:00,12,7,5,FMN GV 16 Berchem TOT
54,Posthofbrug 5366,2020-01-01,23:00:00,13,7,6,FMN GV 16 Berchem TOT
54,Posthofbrug 5366,2020-01-02,00:00:00,4,1,3,FMN GV 16 Berchem TOT
54,Posthofbrug 5366,2020-01-02,01:00:00,3,1,2,FMN GV 16 Berchem TOT
54,Posthofbrug 5366,2020-01-02,02:00:00,5,2,3,FMN GV 16 Berchem TOT
54,Posthofbrug 5366,2020-01-02,03:00:00,7,2,5,FMN GV 16 Berchem TOT
54,Posthofbrug 5366,2020-01-02,04:00:00,6,5,1,FMN GV 16 Berchem TOT
54,Posthofbrug 5366,2020-01-02,05:00:00,11,7,4,FMN GV 16 Berchem TOT
54,Posthofbrug 5366,2020-01-02,06:00:00,41,35,6,FMN GV 16 Berchem TOT
54,Posthofbrug 5366,2020-01-02,07:00:00,148,103,45,FMN GV 16 Berchem TOT
54,Posthofbrug 5366,2020-01-02,08:00:00,216,135,81,FMN GV 16 Berchem TOT
54,Posthofbrug 5366,2020-01-02,09:00:00,104,82,22,FMN GV 16 Berchem TOT
54,Posthofbrug 5366,2020-01-02,10:00:00,55,41,14,FMN GV 16 Berchem TOT
54,Posthofbrug 5366,2020-01-02,11:00:00,50,41,9,FMN GV 16 Berchem TOT
54,Posthofbrug 5366,2020-01-02,12:00:00,80,52,28,FMN GV 16 Berchem TOT
54,Posthofbrug 5366,2020-01-02,13:00:00,65,37,28,FMN GV 16 Berchem TOT
54,Posthofbrug 5366,2020-01-02,14:00:00,75,44,31,FMN GV 16 Berchem TOT
54,Posthofbrug 5366,2020-01-02,15:00:00,76,40,36,FMN GV 16 Berchem TOT
54,Posthofbrug 5366,2020-01-02,16:00:00,151,82,69,FMN GV 16 Berchem TOT
54,Posthofbrug 5366,2020-01-02,17:00:00,191,81,110,FMN GV 16 Berchem TOT
54,Posthofbrug 5366,2020-01-02,18:00:00,121,46,75,FMN GV 16 Berchem TOT
54,Posthofbrug 5366,2020-01-02,19:00:00,64,30,34,FMN GV 16 Berchem TOT
54,Posthofbrug 5366,2020-01-02,20:00:00,46,16,30,FMN GV 16 Berchem TOT
54,Posthofbrug 5366,2020-01-02,21:00:00,44,20,24,FMN GV 16 Berchem TOT
54,Posthofbrug 5366,2020-01-02,22:00:00,29,11,18,FMN GV 16 Berchem TOT
54,Posthofbrug 5366,2020-01-02,23:00:00,21,8,13,FMN GV 16 Berchem TOT
54,Posthofbrug 5366,2020-01-03,00:00:00,11,1,10,FMN GV 16 Berchem TOT
54,Posthofbrug 5366,2020-01-03,01:00:00,5,1,4,FMN GV 16 Berchem TOT
54,Posthofbrug 5366,2020-01-03,02:00:00,8,1,7,FMN GV 16 Berchem TOT
54,Posthofbrug 5366,2020-01-03,03:00:00,2,0,2,FMN GV 16 Berchem TOT
54,Posthofbrug 5366,2020-01-03,04:00:00,8,7,1,FMN GV 16 Berchem TOT
54,Posthofbrug 5366,2020-01-03,05:00:00,5,4,1,FMN GV 16 Berchem TOT
54,Posthofbrug 5366,2020-01-03,06:00:00,49,38,11,FMN GV 16 Berchem TOT
54,Posthofbrug 5366,2020-01-03,07:00:00,136,102,34,FMN GV 16 Berchem TOT
54,Posthofbrug 5366,2020-01-03,08:00:00,192,136,56,FMN GV 16 Berchem TOT
54,Posthofbrug 5366,2020-01-03,09:00:00,94,70,24,FMN GV 16 Berchem TOT
54,Posthofbrug 5366,2020-01-03,10:00:00,82,64,18,FMN GV 16 Berchem TOT
54,Posthofbrug 5366,2020-01-03,11:00:00,60,43,17,FMN GV 16 Berchem TOT
54,Posthofbrug 5366,2020-01-03,12:00:00,49,25,24,FMN GV 16 Berchem TOT
54,Posthofbrug 5366,2020-01-03,13:00:00,84,45,39,FMN GV 16 Berchem TOT
54,Posthofbrug 5366,2020-01-03,14:00:00,88,53,35,FMN GV 16 Berchem TOT
54,Posthofbrug 5366,2020-01-03,15:00:00,82,47,35,FMN GV 16 Berchem TOT
54,Posthofbrug 5366,2020-01-03,16:00:00,173,79,94,FMN GV 16 Berchem TOT
54,Posthofbrug 5366,2020-01-03,17:00:00,225,94,131,FMN GV 16 Berchem TOT
54,Posthofbrug 5366,2020-01-03,18:00:00,128,47,81,FMN GV 16 Berchem TOT
54,Posthofbrug 5366,2020-01-03,19:00:00,71,30,41,FMN GV 16 Berchem TOT
54,Posthofbrug 5366,2020-01-03,20:00:00,53,22,31,FMN GV 16 Berchem TOT
54,Posthofbrug 5366,2020-01-03,21:00:00,45,26,19,FMN GV 16 Berchem TOT
54,Posthofbrug 5366,2020-01-03,22:00:00,35,10,25,FMN GV 16 Berchem TOT
54,Posthofbrug 5366,2020-01-03,23:00:00,43,13,30,FMN GV 16 Berchem TOT
54,Posthofbrug 5366,2020-01-04,00:00:00,29,7,22,FMN GV 16 Berchem TOT
54,Posthofbrug 5366,2020-01-04,01:00:00,17,2,15,FMN GV 16 Berchem TOT
54,Posthofbrug 5366,2020-01-04,02:00:00,18,4,14,FMN GV 16 Berchem TOT
54,Posthofbrug 5366,2020-01-04,03:00:00,11,2,9,FMN GV 16 Berchem TOT
54,Posthofbrug 5366,2020-01-04,04:00:00,3,3,0,FMN GV 16 Berchem TOT
54,Posthofbrug 5366,2020-01-04,05:00:00,7,3,4,FMN GV 16 Berchem TOT
54,Posthofbrug 5366,2020-01-04,06:00:00,12,8,4,FMN GV 16 Berchem TOT
54,Posthofbrug 5366,2020-01-04,07:00:00,11,10,1,FMN GV 16 Berchem TOT
54,Posthofbrug 5366,2020-01-04,08:00:00,43,32,11,FMN GV 16 Berchem TOT
54,Posthofbrug 5366,2020-01-04,09:00:00,42,32,10,FMN GV 16 Berchem TOT
54,Posthofbrug 5366,2020-01-04,10:00:00,69,41,28,FMN GV 16 Berchem TOT
54,Posthofbrug 5366,2020-01-04,11:00:00,74,44,30,FMN GV 16 Berchem TOT
54,Posthofbrug 5366,2020-01-04,12:00:00,81,52,29,FMN GV 16 Berchem TOT
54,Posthofbrug 5366,2020-01-04,13:00:00,116,80,36,FMN GV 16 Berchem TOT
54,Posthofbrug 5366,2020-01-04,14:00:00,105,72,33,FMN GV 16 Berchem TOT
54,Posthofbrug 5366,2020-01-04,15:00:00,73,32,41,FMN GV 16 Berchem TOT
54,Posthofbrug 5366,2020-01-04,16:00:00,89,43,46,FMN GV 16 Berchem TOT
54,Posthofbrug 5366,2020-01-04,17:00:00,86,32,54,FMN GV 16 Berchem TOT
54,Posthofbrug 5366,2020-01-04,18:00:00,66,38,28,FMN GV 16 Berchem TOT
54,Posthofbrug 5366,2020-01-04,19:00:00,47,29,18,FMN GV 16 Berchem TOT
54,Posthofbrug 5366,2020-01-04,20:00:00,39,21,18,FMN GV 16 Berchem TOT
54,Posthofbrug 5366,2020-01-04,21:00:00,40,22,18,FMN GV 16 Berchem TOT
54,Posthofbrug 5366,2020-01-04,22:00:00,48,23,25,FMN GV 16 Berchem TOT
54,Posthofbrug 5366,2020-01-04,23:00:00,33,12,21,FMN GV 16 Berchem TOT
54,Posthofbrug 5366,2020-01-05,00:00:00,24,2,22,FMN GV 16 Berchem TOT
54,Posthofbrug 5366,2020-01-05,01:00:00,19,3,16,FMN GV 16 Berchem TOT
54,Posthofbrug 5366,2020-01-05,02:00:00,16,2,14,FMN GV 16 Berchem TOT
54,Posthofbrug 5366,2020-01-05,03:00:00,13,2,11,FMN GV 16 Berchem TOT
54,Posthofbrug 5366,2020-01-05,04:00:00,7,1,6,FMN GV 16 Berchem TOT
54,Posthofbrug 5366,2020-01-05,05:00:00,9,6,3,FMN GV 16 Berchem TOT
54,Posthofbrug 5366,2020-01-05,06:00:00,9,7,2,FMN GV 16 Berchem TOT
54,Posthofbrug 5366,2020-01-05,07:00:00,7,3,4,FMN GV 16 Berchem TOT
54,Posthofbrug 5366,2020-01-05,08:00:00,24,14,10,FMN GV 16 Berchem TOT
54,Posthofbrug 5366,2020-01-05,09:00:00,28,21,7,FMN GV 16 Berchem TOT
54,Posthofbrug 5366,2020-01-05,10:00:00,45,35,10,FMN GV 16 Berchem TOT
54,Posthofbrug 5366,2020-01-05,11:00:00,58,32,26,FMN GV 16 Berchem TOT
54,Posthofbrug 5366,2020-01-05,12:00:00,62,43,19,FMN GV 16 Berchem TOT
54,Posthofbrug 5366,2020-01-05,13:00:00,76,42,34,FMN GV 16 Berchem TOT
54,Posthofbrug 5366,2020-01-05,14:00:00,105,66,39,FMN GV 16 Berchem TOT
54,Posthofbrug 5366,2020-01-05,15:00:00,87,44,43,FMN GV 16 Berchem TOT
54,Posthofbrug 5366,2020-01-05,16:00:00,58,20,38,FMN GV 16 Berchem TOT
54,Posthofbrug 5366,2020-01-05,17:00:00,91,32,59,FMN GV 16 Berchem TOT
54,Posthofbrug 5366,2020-01-05,18:00:00,40,22,18,FMN GV 16 Berchem TOT
54,Posthofbrug 5366,2020-01-05,19:00:00,37,12,25,FMN GV 16 Berchem TOT
54,Posthofbrug 5366,2020-01-05,20:00:00,38,19,19,FMN GV 16 Berchem TOT
54,Posthofbrug 5366,2020-01-05,21:00:00,20,10,10,FMN GV 16 Berchem TOT
54,Posthofbrug 5366,2020-01-05,22:00:00,18,7,11,FMN GV 16 Berchem TOT
54,Posthofbrug 5366,2020-01-05,23:00:00,14,5,9,FMN GV 16 Berchem TOT
54,Posthofbrug 5366,2020-01-06,00:00:00,8,5,3,FMN GV 16 Berchem TOT
54,Posthofbrug 5366,2020-01-06,01:00:00,5,3,2,FMN GV 16 Berchem TOT
54,Posthofbrug 5366,2020-01-06,02:00:00,3,0,3,FMN GV 16 Berchem TOT
54,Posthofbrug 5366,2020-01-06,03:00:00,2,1,1,FMN GV 16 Berchem TOT
54,Posthofbrug 5366,2020-01-06,04:00:00,12,9,3,FMN GV 16 Berchem TOT
54,Posthofbrug 5366,2020-01-06,05:00:00,20,16,4,FMN GV 16 Berchem TOT
54,Posthofbrug 5366,2020-01-06,06:00:00,109,91,18,FMN GV 16 Berchem TOT
54,Posthofbrug 5366,2020-01-06,07:00:00,390,311,79,FMN GV 16 Berchem TOT
54,Posthofbrug 5366,2020-01-06,08:00:00,637,483,154,FMN GV 16 Berchem TOT
54,Posthofbrug 5366,2020-01-06,09:00:00,192,140,52,FMN GV 16 Berchem TOT
54,Posthofbrug 5366,2020-01-06,10:00:00,76,56,20,FMN GV 16 Berchem TOT
54,Posthofbrug 5366,2020-01-06,11:00:00,75,39,36,FMN GV 16 Berchem TOT
54,Posthofbrug 5366,2020-01-06,12:00:00,107,60,47,FMN GV 16 Berchem TOT
54,Posthofbrug 5366,2020-01-06,13:00:00,96,55,41,FMN GV 16 Berchem TOT
54,Posthofbrug 5366,2020-01-06,14:00:00,94,46,48,FMN GV 16 Berchem TOT
54,Posthofbrug 5366,2020-01-06,15:00:00,184,70,114,FMN GV 16 Berchem TOT
54,Posthofbrug 5366,2020-01-06,16:00:00,333,131,202,FMN GV 16 Berchem TOT
54,Posthofbrug 5366,2020-01-06,17:00:00,452,168,284,FMN GV 16 Berchem TOT
54,Posthofbrug 5366,2020-01-06,18:00:00,266,92,174,FMN GV 16 Berchem TOT
54,Posthofbrug 5366,2020-01-06,19:00:00,111,50,61,FMN GV 16 Berchem TOT
54,Posthofbrug 5366,2020-01-06,20:00:00,50,21,29,FMN GV 16 Berchem TOT
54,Posthofbrug 5366,2020-01-06,21:00:00,48,19,29,FMN GV 16 Berchem TOT
54,Posthofbrug 5366,2020-01-06,22:00:00,34,10,24,FMN GV 16 Berchem TOT
54,Posthofbrug 5366,2020-01-06,23:00:00,18,3,15,FMN GV 16 Berchem TOT
54,Posthofbrug 5366,2020-01-07,00:00:00,9,3,6,FMN GV 16 Berchem TOT
54,Posthofbrug 5366,2020-01-07,01:00:00,4,0,4,FMN GV 16 Berchem TOT
54,Posthofbrug 5366,2020-01-07,02:00:00,3,0,3,FMN GV 16 Berchem TOT
54,Posthofbrug 5366,2020-01-07,03:00:00,2,1,1,FMN GV 16 Berchem TOT
54,Posthofbrug 5366,2020-01-07,04:00:00,7,7,0,FMN GV 16 Berchem TOT
54,Posthofbrug 5366,2020-01-07,05:00:00,13,13,0,FMN GV 16 Berchem TOT
54,Posthofbrug 5366,2020-01-07,06:00:00,107,92,15,FMN GV 16 Berchem TOT
54,Posthofbrug 5366,2020-01-07,07:00:00,403,324,79,FMN GV 16 Berchem TOT
54,Posthofbrug 5366,2020-01-07,08:00:00,628,464,164,FMN GV 16 Berchem TOT
54,Posthofbrug 5366,2020-01-07,09:00:00,206,150,56,FMN GV 16 Berchem TOT
54,Posthofbrug 5366,2020-01-07,10:00:00,74,58,16,FMN GV 16 Berchem TOT
54,Posthofbrug 5366,2020-01-07,11:00:00,119,76,43,FMN GV 16 Berchem TOT
54,Posthofbrug 5366,2020-01-07,12:00:00,125,70,55,FMN GV 16 Berchem TOT
54,Posthofbrug 5366,2020-01-07,13:00:00,94,49,45,FMN GV 16 Berchem TOT
54,Posthofbrug 5366,2020-01-07,14:00:00,62,31,31,FMN GV 16 Berchem TOT
54,Posthofbrug 5366,2020-01-07,15:00:00,148,50,98,FMN GV 16 Berchem TOT
54,Posthofbrug 5366,2020-01-07,16:00:00,320,133,187,FMN GV 16 Berchem TOT
54,Posthofbrug 5366,2020-01-07,17:00:00,433,138,295,FMN GV 16 Berchem TOT
54,Posthofbrug 5366,2020-01-07,18:00:00,260,86,174,FMN GV 16 Berchem TOT
54,Posthofbrug 5366,2020-01-07,19:00:00,134,54,80,FMN GV 16 Berchem TOT
54,Posthofbrug 5366,2020-01-07,20:00:00,47,18,29,FMN GV 16 Berchem TOT
54,Posthofbrug 5366,2020-01-07,21:00:00,57,25,32,FMN GV 16 Berchem TOT
54,Posthofbrug 5366,2020-01-07,22:00:00,54,31,23,FMN GV 16 Berchem TOT
54,Posthofbrug 5366,2020-01-07,23:00:00,18,7,11,FMN GV 16 Berchem TOT
54,Posthofbrug 5366,2020-01-08,00:00:00,9,3,6,FMN GV 16 Berchem TOT
54,Posthofbrug 5366,2020-01-08,01:00:00,4,1,3,FMN GV 16 Berchem TOT
54,Posthofbrug 5366,2020-01-08,02:00:00,5,1,4,FMN GV 16 Berchem TOT
54,Posthofbrug 5366,2020-01-08,03:00:00,3,2,1,FMN GV 16 Berchem TOT
54,Posthofbrug 5366,2020-01-08,04:00:00,9,9,0,FMN GV 16 Berchem TOT
54,Posthofbrug 5366,2020-01-08,05:00:00,17,15,2,FMN GV 16 Berchem TOT
54,Posthofbrug 5366,2020-01-08,06:00:00,89,76,13,FMN GV 16 Berchem TOT
54,Posthofbrug 5366,2020-01-08,07:00:00,334,257,77,FMN GV 16 Berchem TOT
54,Posthofbrug 5366,2020-01-08,08:00:00,523,361,162,FMN GV 16 Berchem TOT
54,Posthofbrug 5366,2020-01-08,09:00:00,177,124,53,FMN GV 16 Berchem TOT
54,Posthofbrug 5366,2020-01-08,10:00:00,76,54,22,FMN GV 16 Berchem TOT
54,Posthofbrug 5366,2020-01-08,11:00:00,80,47,33,FMN GV 16 Berchem TOT
54,Posthofbrug 5366,2020-01-08,12:00:00,162,82,80,FMN GV 16 Berchem TOT
54,Posthofbrug 5366,2020-01-08,13:00:00,117,56,61,FMN GV 16 Berchem TOT
54,Posthofbrug 5366,2020-01-08,14:00:00,99,39,60,FMN GV 16 Berchem TOT
54,Posthofbrug 5366,2020-01-08,15:00:00,111,57,54,FMN GV 16 Berchem TOT
54,Posthofbrug 5366,2020-01-08,16:00:00,248,124,124,FMN GV 16 Berchem TOT
54,Posthofbrug 5366,2020-01-08,17:00:00,357,151,206,FMN GV 16 Berchem TOT
54,Posthofbrug 5366,2020-01-08,18:00:00,247,92,155,FMN GV 16 Berchem TOT
54,Posthofbrug 5366,2020-01-08,19:00:00,107,37,70,FMN GV 16 Berchem TOT
54,Posthofbrug 5366,2020-01-08,20:00:00,47,27,20,FMN GV 16 Berchem TOT
54,Posthofbrug 5366,2020-01-08,21:00:00,37,20,17,FMN GV 16 Berchem TOT
54,Posthofbrug 5366,2020-01-08,22:00:00,37,13,24,FMN GV 16 Berchem TOT
54,Posthofbrug 5366,2020-01-08,23:00:00,25,10,15,FMN GV 16 Berchem TOT
54,Posthofbrug 5366,2020-01-09,00:00:00,18,4,14,FMN GV 16 Berchem TOT
54,Posthofbrug 5366,2020-01-09,01:00:00,3,1,2,FMN GV 16 Berchem TOT
54,Posthofbrug 5366,2020-01-09,02:00:00,4,0,4,FMN GV 16 Berchem TOT
54,Posthofbrug 5366,2020-01-09,03:00:00,3,3,0,FMN GV 16 Berchem TOT
54,Posthofbrug 5366,2020-01-09,04:00:00,8,6,2,FMN GV 16 Berchem TOT
54,Posthofbrug 5366,2020-01-09,05:00:00,20,18,2,FMN GV 16 Berchem TOT
54,Posthofbrug 5366,2020-01-09,06:00:00,92,84,8,FMN GV 16 Berchem TOT
54,Posthofbrug 5366,2020-01-09,07:00:00,343,258,85,FMN GV 16 Berchem TOT
54,Posthofbrug 5366,2020-01-09,08:00:00,589,435,154,FMN GV 16 Berchem TOT
54,Posthofbrug 5366,2020-01-09,09:00:00,192,138,54,FMN GV 16 Berchem TOT
54,Posthofbrug 5366,2020-01-09,10:00:00,84,63,21,FMN GV 16 Berchem TOT
54,Posthofbrug 5366,2020-01-09,11:00:00,70,46,24,FMN GV 16 Berchem TOT
54,Posthofbrug 5366,2020-01-09,12:00:00,76,36,40,FMN GV 16 Berchem TOT
54,Posthofbrug 5366,2020-01-09,13:00:00,96,48,48,FMN GV 16 Berchem TOT
54,Posthofbrug 5366,2020-01-09,14:00:00,73,32,41,FMN GV 16 Berchem TOT
54,Posthofbrug 5366,2020-01-09,15:00:00,152,62,90,FMN GV 16 Berchem TOT
54,Posthofbrug 5366,2020-01-09,16:00:00,280,117,163,FMN GV 16 Berchem TOT
54,Posthofbrug 5366,2020-01-09,17:00:00,409,127,282,FMN GV 16 Berchem TOT
54,Posthofbrug 5366,2020-01-09,18:00:00,238,81,157,FMN GV 16 Berchem TOT
54,Posthofbrug 5366,2020-01-09,19:00:00,128,62,66,FMN GV 16 Berchem TOT
54,Posthofbrug 5366,2020-01-09,20:00:00,68,35,33,FMN GV 16 Berchem TOT
54,Posthofbrug 5366,2020-01-09,21:00:00,58,14,44,FMN GV 16 Berchem TOT
54,Posthofbrug 5366,2020-01-09,22:00:00,49,21,28,FMN GV 16 Berchem TOT
54,Posthofbrug 5366,2020-01-09,23:00:00,35,10,25,FMN GV 16 Berchem TOT
54,Posthofbrug 5366,2020-01-10,00:00:00,17,7,10,FMN GV 16 Berchem TOT
54,Posthofbrug 5366,2020-01-10,01:00:00,7,1,6,FMN GV 16 Berchem TOT
54,Posthofbrug 5366,2020-01-10,02:00:00,3,0,3,FMN GV 16 Berchem TOT
54,Posthofbrug 5366,2020-01-10,03:00:00,6,3,3,FMN GV 16 Berchem TOT
54,Posthofbrug 5366,2020-01-10,04:00:00,7,6,1,FMN GV 16 Berchem TOT
54,Posthofbrug 5366,2020-01-10,05:00:00,18,17,1,FMN GV 16 Berchem TOT
54,Posthofbrug 5366,2020-01-10,06:00:00,69,62,7,FMN GV 16 Berchem TOT
54,Posthofbrug 5366,2020-01-10,07:00:00,316,237,79,FMN GV 16 Berchem TOT
54,Posthofbrug 5366,2020-01-10,08:00:00,512,377,135,FMN GV 16 Berchem TOT
54,Posthofbrug 5366,2020-01-10,09:00:00,177,126,51,FMN GV 16 Berchem TOT
54,Posthofbrug 5366,2020-01-10,10:00:00,106,77,29,FMN GV 16 Berchem TOT
54,Posthofbrug 5366,2020-01-10,11:00:00,84,57,27,FMN GV 16 Berchem TOT
54,Posthofbrug 5366,2020-01-10,12:00:00,122,66,56,FMN GV 16 Berchem TOT
54,Posthofbrug 5366,2020-01-10,13:00:00,105,59,46,FMN GV 16 Berchem TOT
54,Posthofbrug 5366,2020-01-10,14:00:00,110,52,58,FMN GV 16 Berchem TOT
54,Posthofbrug 5366,2020-01-10,15:00:00,173,84,89,FMN GV 16 Berchem TOT
54,Posthofbrug 5366,2020-01-10,16:00:00,243,99,144,FMN GV 16 Berchem TOT
54,Posthofbrug 5366,2020-01-10,17:00:00,356,148,208,FMN GV 16 Berchem TOT
54,Posthofbrug 5366,2020-01-10,18:00:00,206,77,129,FMN GV 16 Berchem TOT
54,Posthofbrug 5366,2020-01-10,19:00:00,112,53,59,FMN GV 16 Berchem TOT
54,Posthofbrug 5366,2020-01-10,20:00:00,85,56,29,FMN GV 16 Berchem TOT
54,Posthofbrug 5366,2020-01-10,21:00:00,63,39,24,FMN GV 16 Berchem TOT
54,Posthofbrug 5366,2020-01-10,22:00:00,43,14,29,FMN GV 16 Berchem TOT
54,Posthofbrug 5366,2020-01-10,23:00:00,46,11,35,FMN GV 16 Berchem TOT
54,Posthofbrug 5366,2020-01-11,00:00:00,44,9,35,FMN GV 16 Berchem TOT
54,Posthofbrug 5366,2020-01-11,01:00:00,37,10,27,FMN GV 16 Berchem TOT
54,Posthofbrug 5366,2020-01-11,02:00:00,25,7,18,FMN GV 16 Berchem TOT
54,Posthofbrug 5366,2020-01-11,03:00:00,17,4,13,FMN GV 16 Berchem TOT
54,Posthofbrug 5366,2020-01-11,04:00:00,14,4,10,FMN GV 16 Berchem TOT
54,Posthofbrug 5366,2020-01-11,05:00:00,14,11,3,FMN GV 16 Berchem TOT
54,Posthofbrug 5366,2020-01-11,06:00:00,11,10,1,FMN GV 16 Berchem TOT
54,Posthofbrug 5366,2020-01-11,07:00:00,12,9,3,FMN GV 16 Berchem TOT
54,Posthofbrug 5366,2020-01-11,08:00:00,37,30,7,FMN GV 16 Berchem TOT
54,Posthofbrug 5366,2020-01-11,09:00:00,90,61,29,FMN GV 16 Berchem TOT
54,Posthofbrug 5366,2020-01-11,10:00:00,77,53,24,FMN GV 16 Berchem TOT
54,Posthofbrug 5366,2020-01-11,11:00:00,90,59,31,FMN GV 16 Berchem TOT
54,Posthofbrug 5366,2020-01-11,12:00:00,106,62,44,FMN GV 16 Berchem TOT
54,Posthofbrug 5366,2020-01-11,13:00:00,92,53,39,FMN GV 16 Berchem TOT
54,Posthofbrug 5366,2020-01-11,14:00:00,94,47,47,FMN GV 16 Berchem TOT
54,Posthofbrug 5366,2020-01-11,15:00:00,93,44,49,FMN GV 16 Berchem TOT
54,Posthofbrug 5366,2020-01-11,16:00:00,118,50,68,FMN GV 16 Berchem TOT
54,Posthofbrug 5366,2020-01-11,17:00:00,95,46,49,FMN GV 16 Berchem TOT
54,Posthofbrug 5366,2020-01-11,18:00:00,84,38,46,FMN GV 16 Berchem TOT
54,Posthofbrug 5366,2020-01-11,19:00:00,79,56,23,FMN GV 16 Berchem TOT
54,Posthofbrug 5366,2020-01-11,20:00:00,29,21,8,FMN GV 16 Berchem TOT
54,Posthofbrug 5366,2020-01-11,21:00:00,39,25,14,FMN GV 16 Berchem TOT
54,Posthofbrug 5366,2020-01-11,22:00:00,43,28,15,FMN GV 16 Berchem TOT
54,Posthofbrug 5366,2020-01-11,23:00:00,31,11,20,FMN GV 16 Berchem TOT
54,Posthofbrug 5366,2020-01-12,00:00:00,23,7,16,FMN GV 16 Berchem TOT
54,Posthofbrug 5366,2020-01-12,01:00:00,26,12,14,FMN GV 16 Berchem TOT
54,Posthofbrug 5366,2020-01-12,02:00:00,13,4,9,FMN GV 16 Berchem TOT
54,Posthofbrug 5366,2020-01-12,03:00:00,10,2,8,FMN GV 16 Berchem TOT
54,Posthofbrug 5366,2020-01-12,04:00:00,8,6,2,FMN GV 16 Berchem TOT
54,Posthofbrug 5366,2020-01-12,05:00:00,4,3,1,FMN GV 16 Berchem TOT
54,Posthofbrug 5366,2020-01-12,06:00:00,11,7,4,FMN GV 16 Berchem TOT
54,Posthofbrug 5366,2020-01-12,07:00:00,9,4,5,FMN GV 16 Berchem TOT
54,Posthofbrug 5366,2020-01-12,08:00:00,19,12,7,FMN GV 16 Berchem TOT
54,Posthofbrug 5366,2020-01-12,09:00:00,67,31,36,FMN GV 16 Berchem TOT
54,Posthofbrug 5366,2020-01-12,10:00:00,62,44,18,FMN GV 16 Berchem TOT
54,Posthofbrug 5366,2020-01-12,11:00:00,53,37,16,FMN GV 16 Berchem TOT
54,Posthofbrug 5366,2020-01-12,12:00:00,50,38,12,FMN GV 16 Berchem TOT
54,Posthofbrug 5366,2020-01-12,13:00:00,76,51,25,FMN GV 16 Berchem TOT
54,Posthofbrug 5366,2020-01-12,14:00:00,73,42,31,FMN GV 16 Berchem TOT
54,Posthofbrug 5366,2020-01-12,15:00:00,69,48,21,FMN GV 16 Berchem TOT
54,Posthofbrug 5366,2020-01-12,16:00:00,68,29,39,FMN GV 16 Berchem TOT
54,Posthofbrug 5366,2020-01-12,17:00:00,77,28,49,FMN GV 16 Berchem TOT
54,Posthofbrug 5366,2020-01-12,18:00:00,53,27,26,FMN GV 16 Berchem TOT
54,Posthofbrug 5366,2020-01-12,19:00:00,40,21,19,FMN GV 16 Berchem TOT
54,Posthofbrug 5366,2020-01-12,20:00:00,24,13,11,FMN GV 16 Berchem TOT
54,Posthofbrug 5366,2020-01-12,21:00:00,37,18,19,FMN GV 16 Berchem TOT
54,Posthofbrug 5366,2020-01-12,22:00:00,24,12,12,FMN GV 16 Berchem TOT
54,Posthofbrug 5366,2020-01-12,23:00:00,12,3,9,FMN GV 16 Berchem TOT
54,Posthofbrug 5366,2020-01-13,00:00:00,7,2,5,FMN GV 16 Berchem TOT
54,Posthofbrug 5366,2020-01-13,01:00:00,7,1,6,FMN GV 16 Berchem TOT
54,Posthofbrug 5366,2020-01-13,02:00:00,0,0,0,FMN GV 16 Berchem TOT
54,Posthofbrug 5366,2020-01-13,03:00:00,0,0,0,FMN GV 16 Berchem TOT
54,Posthofbrug 5366,2020-01-13,04:00:00,3,3,0,FMN GV 16 Berchem TOT
54,Posthofbrug 5366,2020-01-13,05:00:00,16,13,3,FMN GV 16 Berchem TOT
54,Posthofbrug 5366,2020-01-13,06:00:00,95,80,15,FMN GV 16 Berchem TOT
54,Posthofbrug 5366,2020-01-13,07:00:00,393,295,98,FMN GV 16 Berchem TOT
54,Posthofbrug 5366,2020-01-13,08:00:00,634,470,164,FMN GV 16 Berchem TOT
54,Posthofbrug 5366,2020-01-13,09:00:00,212,149,63,FMN GV 16 Berchem TOT
54,Posthofbrug 5366,2020-01-13,10:00:00,79,56,23,FMN GV 16 Berchem TOT
54,Posthofbrug 5366,2020-01-13,11:00:00,87,57,30,FMN GV 16 Berchem TOT
54,Posthofbrug 5366,2020-01-13,12:00:00,111,68,43,FMN GV 16 Berchem TOT
54,Posthofbrug 5366,2020-01-13,13:00:00,94,39,55,FMN GV 16 Berchem TOT
54,Posthofbrug 5366,2020-01-13,14:00:00,94,38,56,FMN GV 16 Berchem TOT
54,Posthofbrug 5366,2020-01-13,15:00:00,189,73,116,FMN GV 16 Berchem TOT
54,Posthofbrug 5366,2020-01-13,16:00:00,298,123,175,FMN GV 16 Berchem TOT
54,Posthofbrug 5366,2020-01-13,17:00:00,456,158,298,FMN GV 16 Berchem TOT
54,Posthofbrug 5366,2020-01-13,18:00:00,257,77,180,FMN GV 16 Berchem TOT
54,Posthofbrug 5366,2020-01-13,19:00:00,111,48,63,FMN GV 16 Berchem TOT
54,Posthofbrug 5366,2020-01-13,20:00:00,46,23,23,FMN GV 16 Berchem TOT
54,Posthofbrug 5366,2020-01-13,21:00:00,36,17,19,FMN GV 16 Berchem TOT
54,Posthofbrug 5366,2020-01-13,22:00:00,52,20,32,FMN GV 16 Berchem TOT
54,Posthofbrug 5366,2020-01-13,23:00:00,22,7,15,FMN GV 16 Berchem TOT
54,Posthofbrug 5366,2020-01-14,00:00:00,7,2,5,FMN GV 16 Berchem TOT
54,Posthofbrug 5366,2020-01-14,01:00:00,4,0,4,FMN GV 16 Berchem TOT
54,Posthofbrug 5366,2020-01-14,02:00:00,1,0,1,FMN GV 16 Berchem TOT
54,Posthofbrug 5366,2020-01-14,03:00:00,1,0,1,FMN GV 16 Berchem TOT
54,Posthofbrug 5366,2020-01-14,04:00:00,4,4,0,FMN GV 16 Berchem TOT
54,Posthofbrug 5366,2020-01-14,05:00:00,14,13,1,FMN GV 16 Berchem TOT
54,Posthofbrug 5366,2020-01-14,06:00:00,97,85,12,FMN GV 16 Berchem TOT
54,Posthofbrug 5366,2020-01-14,07:00:00,352,264,88,FMN GV 16 Berchem TOT
54,Posthofbrug 5366,2020-01-14,08:00:00,566,417,149,FMN GV 16 Berchem TOT
54,Posthofbrug 5366,2020-01-14,09:00:00,181,126,55,FMN GV 16 Berchem TOT
54,Posthofbrug 5366,2020-01-14,10:00:00,58,38,20,FMN GV 16 Berchem TOT
54,Posthofbrug 5366,2020-01-14,11:00:00,57,40,17,FMN GV 16 Berchem TOT
54,Posthofbrug 5366,2020-01-14,12:00:00,91,57,34,FMN GV 16 Berchem TOT
54,Posthofbrug 5366,2020-01-14,13:00:00,78,44,34,FMN GV 16 Berchem TOT
54,Posthofbrug 5366,2020-01-14,14:00:00,60,27,33,FMN GV 16 Berchem TOT
54,Posthofbrug 5366,2020-01-14,15:00:00,137,63,74,FMN GV 16 Berchem TOT
54,Posthofbrug 5366,2020-01-14,16:00:00,317,133,184,FMN GV 16 Berchem TOT
54,Posthofbrug 5366,2020-01-14,17:00:00,417,177,240,FMN GV 16 Berchem TOT
54,Posthofbrug 5366,2020-01-14,18:00:00,281,96,185,FMN GV 16 Berchem TOT
54,Posthofbrug 5366,2020-01-14,19:00:00,112,40,72,FMN GV 16 Berchem TOT
54,Posthofbrug 5366,2020-01-14,20:00:00,60,18,42,FMN GV 16 Berchem TOT
54,Posthofbrug 5366,2020-01-14,21:00:00,53,24,29,FMN GV 16 Berchem TOT
54,Posthofbrug 5366,2020-01-14,22:00:00,54,21,33,FMN GV 16 Berchem TOT
54,Posthofbrug 5366,2020-01-14,23:00:00,22,10,12,FMN GV 16 Berchem TOT
54,Posthofbrug 5366,2020-01-15,00:00:00,13,3,10,FMN GV 16 Berchem TOT
54,Posthofbrug 5366,2020-01-15,01:00:00,3,2,1,FMN GV 16 Berchem TOT
54,Posthofbrug 5366,2020-01-15,02:00:00,0,0,0,FMN GV 16 Berchem TOT
54,Posthofbrug 5366,2020-01-15,03:00:00,3,1,2,FMN GV 16 Berchem TOT
54,Posthofbrug 5366,2020-01-15,04:00:00,7,6,1,FMN GV 16 Berchem TOT
54,Posthofbrug 5366,2020-01-15,05:00:00,11,10,1,FMN GV 16 Berchem TOT
54,Posthofbrug 5366,2020-01-15,06:00:00,87,71,16,FMN GV 16 Berchem TOT
54,Posthofbrug 5366,2020-01-15,07:00:00,342,249,93,FMN GV 16 Berchem TOT
54,Posthofbrug 5366,2020-01-15,08:00:00,536,368,168,FMN GV 16 Berchem TOT
54,Posthofbrug 5366,2020-01-15,09:00:00,165,113,52,FMN GV 16 Berchem TOT
54,Posthofbrug 5366,2020-01-15,10:00:00,65,40,25,FMN GV 16 Berchem TOT
54,Posthofbrug 5366,2020-01-15,11:00:00,70,32,38,FMN GV 16 Berchem TOT
54,Posthofbrug 5366,2020-01-15,12:00:00,191,84,107,FMN GV 16 Berchem TOT
54,Posthofbrug 5366,2020-01-15,13:00:00,107,52,55,FMN GV 16 Berchem TOT
54,Posthofbrug 5366,2020-01-15,14:00:00,72,32,40,FMN GV 16 Berchem TOT
54,Posthofbrug 5366,2020-01-15,15:00:00,100,38,62,FMN GV 16 Berchem TOT
54,Posthofbrug 5366,2020-01-15,16:00:00,225,122,103,FMN GV 16 Berchem TOT
54,Posthofbrug 5366,2020-01-15,17:00:00,347,136,211,FMN GV 16 Berchem TOT
54,Posthofbrug 5366,2020-01-15,18:00:00,224,74,150,FMN GV 16 Berchem TOT
54,Posthofbrug 5366,2020-01-15,19:00:00,111,49,62,FMN GV 16 Berchem TOT
54,Posthofbrug 5366,2020-01-15,20:00:00,51,17,34,FMN GV 16 Berchem TOT
54,Posthofbrug 5366,2020-01-15,21:00:00,44,23,21,FMN GV 16 Berchem TOT
54,Posthofbrug 5366,2020-01-15,22:00:00,39,15,24,FMN GV 16 Berchem TOT
54,Posthofbrug 5366,2020-01-15,23:00:00,18,5,13,FMN GV 16 Berchem TOT
54,Posthofbrug 5366,2020-01-16,00:00:00,8,5,3,FMN GV 16 Berchem TOT
54,Posthofbrug 5366,2020-01-16,01:00:00,3,0,3,FMN GV 16 Berchem TOT
54,Posthofbrug 5366,2020-01-16,02:00:00,0,0,0,FMN GV 16 Berchem TOT
54,Posthofbrug 5366,2020-01-16,03:00:00,4,2,2,FMN GV 16 Berchem TOT
54,Posthofbrug 5366,2020-01-16,04:00:00,7,6,1,FMN GV 16 Berchem TOT
54,Posthofbrug 5366,2020-01-16,05:00:00,12,11,1,FMN GV 16 Berchem TOT
54,Posthofbrug 5366,2020-01-16,06:00:00,91,75,16,FMN GV 16 Berchem TOT
54,Posthofbrug 5366,2020-01-16,07:00:00,351,272,79,FMN GV 16 Berchem TOT
54,Posthofbrug 5366,2020-01-16,08:00:00,570,450,120,FMN GV 16 Berchem TOT
54,Posthofbrug 5366,2020-01-16,09:00:00,228,166,62,FMN GV 16 Berchem TOT
54,Posthofbrug 5366,2020-01-16,10:00:00,80,61,19,FMN GV 16 Berchem TOT
54,Posthofbrug 5366,2020-01-16,11:00:00,81,55,26,FMN GV 16 Berchem TOT
54,Posthofbrug 5366,2020-01-16,12:00:00,108,52,56,FMN GV 16 Berchem TOT
54,Posthofbrug 5366,2020-01-16,13:00:00,125,68,57,FMN GV 16 Berchem TOT
54,Posthofbrug 5366,2020-01-16,14:00:00,107,49,58,FMN GV 16 Berchem TOT
54,Posthofbrug 5366,2020-01-16,15:00:00,138,66,72,FMN GV 16 Berchem TOT
54,Posthofbrug 5366,2020-01-16,16:00:00,329,135,194,FMN GV 16 Berchem TOT
54,Posthofbrug 5366,2020-01-16,17:00:00,401,150,251,FMN GV 16 Berchem TOT
54,Posthofbrug 5366,2020-01-16,18:00:00,249,103,146,FMN GV 16 Berchem TOT
54,Posthofbrug 5366,2020-01-16,19:00:00,125,60,65,FMN GV 16 Berchem TOT
54,Posthofbrug 5366,2020-01-16,20:00:00,65,38,27,FMN GV 16 Berchem TOT
54,Posthofbrug 5366,2020-01-16,21:00:00,58,23,35,FMN GV 16 Berchem TOT
54,Posthofbrug 5366,2020-01-16,22:00:00,66,18,48,FMN GV 16 Berchem TOT
54,Posthofbrug 5366,2020-01-16,23:00:00,38,8,30,FMN GV 16 Berchem TOT
54,Posthofbrug 5366,2020-01-17,00:00:00,7,0,7,FMN GV 16 Berchem TOT
54,Posthofbrug 5366,2020-01-17,01:00:00,8,1,7,FMN GV 16 Berchem TOT
54,Posthofbrug 5366,2020-01-17,02:00:00,3,1,2,FMN GV 16 Berchem TOT
54,Posthofbrug 5366,2020-01-17,03:00:00,3,1,2,FMN GV 16 Berchem TOT
54,Posthofbrug 5366,2020-01-17,04:00:00,5,5,0,FMN GV 16 Berchem TOT
54,Posthofbrug 5366,2020-01-17,05:00:00,13,12,1,FMN GV 16 Berchem TOT
54,Posthofbrug 5366,2020-01-17,06:00:00,66,55,11,FMN GV 16 Berchem TOT
54,Posthofbrug 5366,2020-01-17,07:00:00,291,228,63,FMN GV 16 Berchem TOT
54,Posthofbrug 5366,2020-01-17,08:00:00,465,361,104,FMN GV 16 Berchem TOT
54,Posthofbrug 5366,2020-01-17,09:00:00,159,112,47,FMN GV 16 Berchem TOT
54,Posthofbrug 5366,2020-01-17,10:00:00,62,40,22,FMN GV 16 Berchem TOT
54,Posthofbrug 5366,2020-01-17,11:00:00,73,47,26,FMN GV 16 Berchem TOT
54,Posthofbrug 5366,2020-01-17,12:00:00,91,57,34,FMN GV 16 Berchem TOT
54,Posthofbrug 5366,2020-01-17,13:00:00,103,65,38,FMN GV 16 Berchem TOT
54,Posthofbrug 5366,2020-01-17,14:00:00,83,40,43,FMN GV 16 Berchem TOT
54,Posthofbrug 5366,2020-01-17,15:00:00,157,63,94,FMN GV 16 Berchem TOT
54,Posthofbrug 5366,2020-01-17,16:00:00,238,111,127,FMN GV 16 Berchem TOT
54,Posthofbrug 5366,2020-01-17,17:00:00,303,120,183,FMN GV 16 Berchem TOT
54,Posthofbrug 5366,2020-01-17,18:00:00,209,86,123,FMN GV 16 Berchem TOT
54,Posthofbrug 5366,2020-01-17,19:00:00,89,35,54,FMN GV 16 Berchem TOT
54,Posthofbrug 5366,2020-01-17,20:00:00,68,40,28,FMN GV 16 Berchem TOT
54,Posthofbrug 5366,2020-01-17,21:00:00,47,23,24,FMN GV 16 Berchem TOT
54,Posthofbrug 5366,2020-01-17,22:00:00,46,16,30,FMN GV 16 Berchem TOT
54,Posthofbrug 5366,2020-01-17,23:00:00,40,12,28,FMN GV 16 Berchem TOT
54,Posthofbrug 5366,2020-01-18,00:00:00,35,8,27,FMN GV 16 Berchem TOT
54,Posthofbrug 5366,2020-01-18,01:00:00,25,10,15,FMN GV 16 Berchem TOT
54,Posthofbrug 5366,2020-01-18,02:00:00,12,4,8,FMN GV 16 Berchem TOT
54,Posthofbrug 5366,2020-01-18,03:00:00,16,3,13,FMN GV 16 Berchem TOT
54,Posthofbrug 5366,2020-01-18,04:00:00,16,6,10,FMN GV 16 Berchem TOT
54,Posthofbrug 5366,2020-01-18,05:00:00,9,6,3,FMN GV 16 Berchem TOT
54,Posthofbrug 5366,2020-01-18,06:00:00,13,10,3,FMN GV 16 Berchem TOT
54,Posthofbrug 5366,2020-01-18,07:00:00,16,13,3,FMN GV 16 Berchem TOT
54,Posthofbrug 5366,2020-01-18,08:00:00,40,24,16,FMN GV 16 Berchem TOT
54,Posthofbrug 5366,2020-01-18,09:00:00,45,32,13,FMN GV 16 Berchem TOT
54,Posthofbrug 5366,2020-01-18,10:00:00,60,40,20,FMN GV 16 Berchem TOT
54,Posthofbrug 5366,2020-01-18,11:00:00,81,52,29,FMN GV 16 Berchem TOT
54,Posthofbrug 5366,2020-01-18,12:00:00,119,74,45,FMN GV 16 Berchem TOT
54,Posthofbrug 5366,2020-01-18,13:00:00,120,80,40,FMN GV 16 Berchem TOT
54,Posthofbrug 5366,2020-01-18,14:00:00,147,80,67,FMN GV 16 Berchem TOT
54,Posthofbrug 5366,2020-01-18,15:00:00,95,48,47,FMN GV 16 Berchem TOT
54,Posthofbrug 5366,2020-01-18,16:00:00,78,41,37,FMN GV 16 Berchem TOT
54,Posthofbrug 5366,2020-01-18,17:00:00,100,38,62,FMN GV 16 Berchem TOT
54,Posthofbrug 5366,2020-01-18,18:00:00,89,40,49,FMN GV 16 Berchem TOT
54,Posthofbrug 5366,2020-01-18,19:00:00,73,38,35,FMN GV 16 Berchem TOT
54,Posthofbrug 5366,2020-01-18,20:00:00,54,43,11,FMN GV 16 Berchem TOT
54,Posthofbrug 5366,2020-01-18,21:00:00,38,21,17,FMN GV 16 Berchem TOT
54,Posthofbrug 5366,2020-01-18,22:00:00,29,14,15,FMN GV 16 Berchem TOT
54,Posthofbrug 5366,2020-01-18,23:00:00,39,14,25,FMN GV 16 Berchem TOT
54,Posthofbrug 5366,2020-01-19,00:00:00,32,15,17,FMN GV 16 Berchem TOT
54,Posthofbrug 5366,2020-01-19,01:00:00,21,10,11,FMN GV 16 Berchem TOT
54,Posthofbrug 5366,2020-01-19,02:00:00,12,2,10,FMN GV 16 Berchem TOT
54,Posthofbrug 5366,2020-01-19,03:00:00,11,2,9,FMN GV 16 Berchem TOT
54,Posthofbrug 5366,2020-01-19,04:00:00,22,9,13,FMN GV 16 Berchem TOT
54,Posthofbrug 5366,2020-01-19,05:00:00,8,3,5,FMN GV 16 Berchem TOT
54,Posthofbrug 5366,2020-01-19,06:00:00,10,7,3,FMN GV 16 Berchem TOT
54,Posthofbrug 5366,2020-01-19,07:00:00,12,6,6,FMN GV 16 Berchem TOT
54,Posthofbrug 5366,2020-01-19,08:00:00,22,13,9,FMN GV 16 Berchem TOT
54,Posthofbrug 5366,2020-01-19,09:00:00,44,28,16,FMN GV 16 Berchem TOT
54,Posthofbrug 5366,2020-01-19,10:00:00,55,44,11,FMN GV 16 Berchem TOT
54,Posthofbrug 5366,2020-01-19,11:00:00,59,37,22,FMN GV 16 Berchem TOT
54,Posthofbrug 5366,2020-01-19,12:00:00,83,44,39,FMN GV 16 Berchem TOT
54,Posthofbrug 5366,2020-01-19,13:00:00,71,39,32,FMN GV 16 Berchem TOT
54,Posthofbrug 5366,2020-01-19,14:00:00,111,57,54,FMN GV 16 Berchem TOT
54,Posthofbrug 5366,2020-01-19,15:00:00,86,48,38,FMN GV 16 Berchem TOT
54,Posthofbrug 5366,2020-01-19,16:00:00,78,39,39,FMN GV 16 Berchem TOT
54,Posthofbrug 5366,2020-01-19,17:00:00,80,41,39,FMN GV 16 Berchem TOT
54,Posthofbrug 5366,2020-01-19,18:00:00,50,25,25,FMN GV 16 Berchem TOT
54,Posthofbrug 5366,2020-01-19,19:00:00,29,9,20,FMN GV 16 Berchem TOT
54,Posthofbrug 5366,2020-01-19,20:00:00,27,15,12,FMN GV 16 Berchem TOT
54,Posthofbrug 5366,2020-01-19,21:00:00,24,12,12,FMN GV 16 Berchem TOT
54,Posthofbrug 5366,2020-01-19,22:00:00,15,4,11,FMN GV 16 Berchem TOT
54,Posthofbrug 5366,2020-01-19,23:00:00,15,6,9,FMN GV 16 Berchem TOT
54,Posthofbrug 5366,2020-01-20,00:00:00,4,0,4,FMN GV 16 Berchem TOT
54,Posthofbrug 5366,2020-01-20,01:00:00,1,0,1,FMN GV 16 Berchem TOT
54,Posthofbrug 5366,2020-01-20,02:00:00,1,1,0,FMN GV 16 Berchem TOT
54,Posthofbrug 5366,2020-01-20,03:00:00,6,4,2,FMN GV 16 Berchem TOT
54,Posthofbrug 5366,2020-01-20,04:00:00,5,5,0,FMN GV 16 Berchem TOT
54,Posthofbrug 5366,2020-01-20,05:00:00,15,10,5,FMN GV 16 Berchem TOT
54,Posthofbrug 5366,2020-01-20,06:00:00,84,75,9,FMN GV 16 Berchem TOT
54,Posthofbrug 5366,2020-01-20,07:00:00,320,249,71,FMN GV 16 Berchem TOT
54,Posthofbrug 5366,2020-01-20,08:00:00,556,433,123,FMN GV 16 Berchem TOT
54,Posthofbrug 5366,2020-01-20,09:00:00,180,142,38,FMN GV 16 Berchem TOT
54,Posthofbrug 5366,2020-01-20,10:00:00,61,43,18,FMN GV 16 Berchem TOT
54,Posthofbrug 5366,2020-01-20,11:00:00,58,46,12,FMN GV 16 Berchem TOT
54,Posthofbrug 5366,2020-01-20,12:00:00,95,49,46,FMN GV 16 Berchem TOT
54,Posthofbrug 5366,2020-01-20,13:00:00,85,35,50,FMN GV 16 Berchem TOT
54,Posthofbrug 5366,2020-01-20,14:00:00,83,42,41,FMN GV 16 Berchem TOT
54,Posthofbrug 5366,2020-01-20,15:00:00,159,79,80,FMN GV 16 Berchem TOT
54,Posthofbrug 5366,2020-01-20,16:00:00,313,141,172,FMN GV 16 Berchem TOT
54,Posthofbrug 5366,2020-01-20,17:00:00,390,145,245,FMN GV 16 Berchem TOT
54,Posthofbrug 5366,2020-01-20,18:00:00,265,107,158,FMN GV 16 Berchem TOT
54,Posthofbrug 5366,2020-01-20,19:00:00,141,65,76,FMN GV 16 Berchem TOT
54,Posthofbrug 5366,2020-01-20,20:00:00,60,29,31,FMN GV 16 Berchem TOT
54,Posthofbrug 5366,2020-01-20,21:00:00,54,22,32,FMN GV 16 Berchem TOT
54,Posthofbrug 5366,2020-01-20,22:00:00,52,14,38,FMN GV 16 Berchem TOT
54,Posthofbrug 5366,2020-01-20,23:00:00,21,5,16,FMN GV 16 Berchem TOT
54,Posthofbrug 5366,2020-01-21,00:00:00,8,2,6,FMN GV 16 Berchem TOT
54,Posthofbrug 5366,2020-01-21,01:00:00,2,0,2,FMN GV 16 Berchem TOT
54,Posthofbrug 5366,2020-01-21,02:00:00,4,0,4,FMN GV 16 Berchem TOT
54,Posthofbrug 5366,2020-01-21,03:00:00,2,2,0,FMN GV 16 Berchem TOT
54,Posthofbrug 5366,2020-01-21,04:00:00,6,6,0,FMN GV 16 Berchem TOT
54,Posthofbrug 5366,2020-01-21,05:00:00,12,10,2,FMN GV 16 Berchem TOT
54,Posthofbrug 5366,2020-01-21,06:00:00,102,86,16,FMN GV 16 Berchem TOT
54,Posthofbrug 5366,2020-01-21,07:00:00,314,241,73,FMN GV 16 Berchem TOT
54,Posthofbrug 5366,2020-01-21,08:00:00,580,427,153,FMN GV 16 Berchem TOT
54,Posthofbrug 5366,2020-01-21,09:00:00,195,129,66,FMN GV 16 Berchem TOT
54,Posthofbrug 5366,2020-01-21,10:00:00,68,51,17,FMN GV 16 Berchem TOT
54,Posthofbrug 5366,2020-01-21,11:00:00,53,32,21,FMN GV 16 Berchem TOT
54,Posthofbrug 5366,2020-01-21,12:00:00,115,68,47,FMN GV 16 Berchem TOT
54,Posthofbrug 5366,2020-01-21,13:00:00,116,61,55,FMN GV 16 Berchem TOT
54,Posthofbrug 5366,2020-01-21,14:00:00,87,34,53,FMN GV 16 Berchem TOT
54,Posthofbrug 5366,2020-01-21,15:00:00,146,76,70,FMN GV 16 Berchem TOT
54,Posthofbrug 5366,2020-01-21,16:00:00,298,125,173,FMN GV 16 Berchem TOT
54,Posthofbrug 5366,2020-01-21,17:00:00,414,161,253,FMN GV 16 Berchem TOT
54,Posthofbrug 5366,2020-01-21,18:00:00,261,84,177,FMN GV 16 Berchem TOT
54,Posthofbrug 5366,2020-01-21,19:00:00,101,39,62,FMN GV 16 Berchem TOT
54,Posthofbrug 5366,2020-01-21,20:00:00,60,28,32,FMN GV 16 Berchem TOT
54,Posthofbrug 5366,2020-01-21,21:00:00,54,25,29,FMN GV 16 Berchem TOT
54,Posthofbrug 5366,2020-01-21,22:00:00,65,24,41,FMN GV 16 Berchem TOT
54,Posthofbrug 5366,2020-01-21,23:00:00,21,7,14,FMN GV 16 Berchem TOT
54,Posthofbrug 5366,2020-01-22,00:00:00,10,3,7,FMN GV 16 Berchem TOT
54,Posthofbrug 5366,2020-01-22,01:00:00,2,1,1,FMN GV 16 Berchem TOT
54,Posthofbrug 5366,2020-01-22,02:00:00,1,0,1,FMN GV 16 Berchem TOT
54,Posthofbrug 5366,2020-01-22,03:00:00,0,0,0,FMN GV 16 Berchem TOT
54,Posthofbrug 5366,2020-01-22,04:00:00,5,3,2,FMN GV 16 Berchem TOT
54,Posthofbrug 5366,2020-01-22,05:00:00,15,11,4,FMN GV 16 Berchem TOT
54,Posthofbrug 5366,2020-01-22,06:00:00,80,67,13,FMN GV 16 Berchem TOT
54,Posthofbrug 5366,2020-01-22,07:00:00,309,239,70,FMN GV 16 Berchem TOT
54,Posthofbrug 5366,2020-01-22,08:00:00,449,346,103,FMN GV 16 Berchem TOT
54,Posthofbrug 5366,2020-01-22,09:00:00,165,114,51,FMN GV 16 Berchem TOT
54,Posthofbrug 5366,2020-01-22,10:00:00,49,34,15,FMN GV 16 Berchem TOT
54,Posthofbrug 5366,2020-01-22,11:00:00,54,29,25,FMN GV 16 Berchem TOT
54,Posthofbrug 5366,2020-01-22,12:00:00,162,84,78,FMN GV 16 Berchem TOT
54,Posthofbrug 5366,2020-01-22,13:00:00,118,59,59,FMN GV 16 Berchem TOT
54,Posthofbrug 5366,2020-01-22,14:00:00,88,39,49,FMN GV 16 Berchem TOT
54,Posthofbrug 5366,2020-01-22,15:00:00,123,64,59,FMN GV 16 Berchem TOT
54,Posthofbrug 5366,2020-01-22,16:00:00,209,115,94,FMN GV 16 Berchem TOT
54,Posthofbrug 5366,2020-01-22,17:00:00,316,144,172,FMN GV 16 Berchem TOT
54,Posthofbrug 5366,2020-01-22,18:00:00,219,75,144,FMN GV 16 Berchem TOT
54,Posthofbrug 5366,2020-01-22,19:00:00,79,30,49,FMN GV 16 Berchem TOT
54,Posthofbrug 5366,2020-01-22,20:00:00,50,18,32,FMN GV 16 Berchem TOT
54,Posthofbrug 5366,2020-01-22,21:00:00,46,19,27,FMN GV 16 Berchem TOT
54,Posthofbrug 5366,2020-01-22,22:00:00,41,15,26,FMN GV 16 Berchem TOT
54,Posthofbrug 5366,2020-01-22,23:00:00,37,13,24,FMN GV 16 Berchem TOT
54,Posthofbrug 5366,2020-01-23,00:00:00,12,4,8,FMN GV 16 Berchem TOT
54,Posthofbrug 5366,2020-01-23,01:00:00,7,1,6,FMN GV 16 Berchem TOT
54,Posthofbrug 5366,2020-01-23,02:00:00,3,0,3,FMN GV 16 Berchem TOT
54,Posthofbrug 5366,2020-01-23,03:00:00,2,2,0,FMN GV 16 Berchem TOT
54,Posthofbrug 5366,2020-01-23,04:00:00,7,7,0,FMN GV 16 Berchem TOT
54,Posthofbrug 5366,2020-01-23,05:00:00,12,10,2,FMN GV 16 Berchem TOT
54,Posthofbrug 5366,2020-01-23,06:00:00,97,76,21,FMN GV 16 Berchem TOT
54,Posthofbrug 5366,2020-01-23,07:00:00,313,234,79,FMN GV 16 Berchem TOT
54,Posthofbrug 5366,2020-01-23,08:00:00,520,386,134,FMN GV 16 Berchem TOT
54,Posthofbrug 5366,2020-01-23,09:00:00,179,126,53,FMN GV 16 Berchem TOT
54,Posthofbrug 5366,2020-01-23,10:00:00,68,48,20,FMN GV 16 Berchem TOT
54,Posthofbrug 5366,2020-01-23,11:00:00,72,50,22,FMN GV 16 Berchem TOT
54,Posthofbrug 5366,2020-01-23,12:00:00,104,66,38,FMN GV 16 Berchem TOT
54,Posthofbrug 5366,2020-01-23,13:00:00,119,58,61,FMN GV 16 Berchem TOT
54,Posthofbrug 5366,2020-01-23,14:00:00,85,36,49,FMN GV 16 Berchem TOT
54,Posthofbrug 5366,2020-01-23,15:00:00,175,93,82,FMN GV 16 Berchem TOT
54,Posthofbrug 5366,2020-01-23,16:00:00,289,135,154,FMN GV 16 Berchem TOT
54,Posthofbrug 5366,2020-01-23,17:00:00,367,129,238,FMN GV 16 Berchem TOT
54,Posthofbrug 5366,2020-01-23,18:00:00,230,83,147,FMN GV 16 Berchem TOT
54,Posthofbrug 5366,2020-01-23,19:00:00,119,48,71,FMN GV 16 Berchem TOT
54,Posthofbrug 5366,2020-01-23,20:00:00,63,24,39,FMN GV 16 Berchem TOT
54,Posthofbrug 5366,2020-01-23,21:00:00,49,24,25,FMN GV 16 Berchem TOT
54,Posthofbrug 5366,2020-01-23,22:00:00,62,18,44,FMN GV 16 Berchem TOT
54,Posthofbrug 5366,2020-01-23,23:00:00,38,13,25,FMN GV 16 Berchem TOT
54,Posthofbrug 5366,2020-01-24,00:00:00,19,6,13,FMN GV 16 Berchem TOT
54,Posthofbrug 5366,2020-01-24,01:00:00,5,2,3,FMN GV 16 Berchem TOT
54,Posthofbrug 5366,2020-01-24,02:00:00,15,0,15,FMN GV 16 Berchem TOT
54,Posthofbrug 5366,2020-01-24,03:00:00,6,0,6,FMN GV 16 Berchem TOT
54,Posthofbrug 5366,2020-01-24,04:00:00,17,9,8,FMN GV 16 Berchem TOT
54,Posthofbrug 5366,2020-01-24,05:00:00,13,8,5,FMN GV 16 Berchem TOT
54,Posthofbrug 5366,2020-01-24,06:00:00,59,46,13,FMN GV 16 Berchem TOT
54,Posthofbrug 5366,2020-01-24,07:00:00,251,186,65,FMN GV 16 Berchem TOT
54,Posthofbrug 5366,2020-01-24,08:00:00,463,345,118,FMN GV 16 Berchem TOT
54,Posthofbrug 5366,2020-01-24,09:00:00,143,95,48,FMN GV 16 Berchem TOT
54,Posthofbrug 5366,2020-01-24,10:00:00,73,58,15,FMN GV 16 Berchem TOT
54,Posthofbrug 5366,2020-01-24,11:00:00,60,32,28,FMN GV 16 Berchem TOT
54,Posthofbrug 5366,2020-01-24,12:00:00,112,67,45,FMN GV 16 Berchem TOT
54,Posthofbrug 5366,2020-01-24,13:00:00,69,36,33,FMN GV 16 Berchem TOT
54,Posthofbrug 5366,2020-01-24,14:00:00,86,43,43,FMN GV 16 Berchem TOT
54,Posthofbrug 5366,2020-01-24,15:00:00,98,45,53,FMN GV 16 Berchem TOT
54,Posthofbrug 5366,2020-01-24,16:00:00,261,123,138,FMN GV 16 Berchem TOT
54,Posthofbrug 5366,2020-01-24,17:00:00,270,119,151,FMN GV 16 Berchem TOT
54,Posthofbrug 5366,2020-01-24,18:00:00,187,83,104,FMN GV 16 Berchem TOT
54,Posthofbrug 5366,2020-01-24,19:00:00,123,64,59,FMN GV 16 Berchem TOT
54,Posthofbrug 5366,2020-01-24,20:00:00,63,45,18,FMN GV 16 Berchem TOT
54,Posthofbrug 5366,2020-01-24,21:00:00,59,31,28,FMN GV 16 Berchem TOT
54,Posthofbrug 5366,2020-01-24,22:00:00,43,11,32,FMN GV 16 Berchem TOT
54,Posthofbrug 5366,2020-01-24,23:00:00,44,20,24,FMN GV 16 Berchem TOT
54,Posthofbrug 5366,2020-01-25,00:00:00,34,6,28,FMN GV 16 Berchem TOT
54,Posthofbrug 5366,2020-01-25,01:00:00,30,5,25,FMN GV 16 Berchem TOT
54,Posthofbrug 5366,2020-01-25,02:00:00,18,4,14,FMN GV 16 Berchem TOT
54,Posthofbrug 5366,2020-01-25,03:00:00,7,0,7,FMN GV 16 Berchem TOT
54,Posthofbrug 5366,2020-01-25,04:00:00,10,6,4,FMN GV 16 Berchem TOT
54,Posthofbrug 5366,2020-01-25,05:00:00,9,5,4,FMN GV 16 Berchem TOT
54,Posthofbrug 5366,2020-01-25,06:00:00,10,6,4,FMN GV 16 Berchem TOT
54,Posthofbrug 5366,2020-01-25,07:00:00,16,11,5,FMN GV 16 Berchem TOT
54,Posthofbrug 5366,2020-01-25,08:00:00,32,21,11,FMN GV 16 Berchem TOT
54,Posthofbrug 5366,2020-01-25,09:00:00,58,40,18,FMN GV 16 Berchem TOT
54,Posthofbrug 5366,2020-01-25,10:00:00,70,38,32,FMN GV 16 Berchem TOT
54,Posthofbrug 5366,2020-01-25,11:00:00,66,35,31,FMN GV 16 Berchem TOT
54,Posthofbrug 5366,2020-01-25,12:00:00,71,47,24,FMN GV 16 Berchem TOT
54,Posthofbrug 5366,2020-01-25,13:00:00,78,54,24,FMN GV 16 Berchem TOT
54,Posthofbrug 5366,2020-01-25,14:00:00,70,46,24,FMN GV 16 Berchem TOT
54,Posthofbrug 5366,2020-01-25,15:00:00,79,44,35,FMN GV 16 Berchem TOT
54,Posthofbrug 5366,2020-01-25,16:00:00,76,40,36,FMN GV 16 Berchem TOT
54,Posthofbrug 5366,2020-01-25,17:00:00,67,31,36,FMN GV 16 Berchem TOT
54,Posthofbrug 5366,2020-01-25,18:00:00,55,22,33,FMN GV 16 Berchem TOT
54,Posthofbrug 5366,2020-01-25,19:00:00,62,40,22,FMN GV 16 Berchem TOT
54,Posthofbrug 5366,2020-01-25,20:00:00,37,27,10,FMN GV 16 Berchem TOT
54,Posthofbrug 5366,2020-01-25,21:00:00,27,17,10,FMN GV 16 Berchem TOT
54,Posthofbrug 5366,2020-01-25,22:00:00,20,5,15,FMN GV 16 Berchem TOT
54,Posthofbrug 5366,2020-01-25,23:00:00,29,5,24,FMN GV 16 Berchem TOT
54,Posthofbrug 5366,2020-01-26,00:00:00,30,12,18,FMN GV 16 Berchem TOT
54,Posthofbrug 5366,2020-01-26,01:00:00,19,11,8,FMN GV 16 Berchem TOT
54,Posthofbrug 5366,2020-01-26,02:00:00,7,2,5,FMN GV 16 Berchem TOT
54,Posthofbrug 5366,2020-01-26,03:00:00,8,3,5,FMN GV 16 Berchem TOT
54,Posthofbrug 5366,2020-01-26,04:00:00,11,3,8,FMN GV 16 Berchem TOT
54,Posthofbrug 5366,2020-01-26,05:00:00,6,6,0,FMN GV 16 Berchem TOT
54,Posthofbrug 5366,2020-01-26,06:00:00,11,9,2,FMN GV 16 Berchem TOT
54,Posthofbrug 5366,2020-01-26,07:00:00,10,6,4,FMN GV 16 Berchem TOT
54,Posthofbrug 5366,2020-01-26,08:00:00,26,11,15,FMN GV 16 Berchem TOT
54,Posthofbrug 5366,2020-01-26,09:00:00,48,26,22,FMN GV 16 Berchem TOT
54,Posthofbrug 5366,2020-01-26,10:00:00,50,28,22,FMN GV 16 Berchem TOT
54,Posthofbrug 5366,2020-01-26,11:00:00,60,36,24,FMN GV 16 Berchem TOT
54,Posthofbrug 5366,2020-01-26,12:00:00,99,70,29,FMN GV 16 Berchem TOT
54,Posthofbrug 5366,2020-01-26,13:00:00,74,45,29,FMN GV 16 Berchem TOT
54,Posthofbrug 5366,2020-01-26,14:00:00,100,73,27,FMN GV 16 Berchem TOT
54,Posthofbrug 5366,2020-01-26,15:00:00,90,50,40,FMN GV 16 Berchem TOT
54,Posthofbrug 5366,2020-01-26,16:00:00,74,30,44,FMN GV 16 Berchem TOT
54,Posthofbrug 5366,2020-01-26,17:00:00,72,35,37,FMN GV 16 Berchem TOT
54,Posthofbrug 5366,2020-01-26,18:00:00,44,18,26,FMN GV 16 Berchem TOT
54,Posthofbrug 5366,2020-01-26,19:00:00,45,21,24,FMN GV 16 Berchem TOT
54,Posthofbrug 5366,2020-01-26,20:00:00,28,11,17,FMN GV 16 Berchem TOT
54,Posthofbrug 5366,2020-01-26,21:00:00,24,13,11,FMN GV 16 Berchem TOT
54,Posthofbrug 5366,2020-01-26,22:00:00,15,6,9,FMN GV 16 Berchem TOT
54,Posthofbrug 5366,2020-01-26,23:00:00,10,2,8,FMN GV 16 Berchem TOT
54,Posthofbrug 5366,2020-01-27,00:00:00,2,0,2,FMN GV 16 Berchem TOT
54,Posthofbrug 5366,2020-01-27,01:00:00,2,0,2,FMN GV 16 Berchem TOT
54,Posthofbrug 5366,2020-01-27,02:00:00,0,0,0,FMN GV 16 Berchem TOT
54,Posthofbrug 5366,2020-01-27,03:00:00,2,1,1,FMN GV 16 Berchem TOT
54,Posthofbrug 5366,2020-01-27,04:00:00,8,7,1,FMN GV 16 Berchem TOT
54,Posthofbrug 5366,2020-01-27,05:00:00,17,15,2,FMN GV 16 Berchem TOT
54,Posthofbrug 5366,2020-01-27,06:00:00,95,80,15,FMN GV 16 Berchem TOT
54,Posthofbrug 5366,2020-01-27,07:00:00,313,242,71,FMN GV 16 Berchem TOT
54,Posthofbrug 5366,2020-01-27,08:00:00,518,389,129,FMN GV 16 Berchem TOT
54,Posthofbrug 5366,2020-01-27,09:00:00,169,115,54,FMN GV 16 Berchem TOT
54,Posthofbrug 5366,2020-01-27,10:00:00,74,54,20,FMN GV 16 Berchem TOT
54,Posthofbrug 5366,2020-01-27,11:00:00,61,44,17,FMN GV 16 Berchem TOT
54,Posthofbrug 5366,2020-01-27,12:00:00,80,46,34,FMN GV 16 Berchem TOT
54,Posthofbrug 5366,2020-01-27,13:00:00,86,46,40,FMN GV 16 Berchem TOT
54,Posthofbrug 5366,2020-01-27,14:00:00,78,39,39,FMN GV 16 Berchem TOT
54,Posthofbrug 5366,2020-01-27,15:00:00,151,63,88,FMN GV 16 Berchem TOT
54,Posthofbrug 5366,2020-01-27,16:00:00,297,138,159,FMN GV 16 Berchem TOT
54,Posthofbrug 5366,2020-01-27,17:00:00,346,134,212,FMN GV 16 Berchem TOT
54,Posthofbrug 5366,2020-01-27,18:00:00,223,77,146,FMN GV 16 Berchem TOT
54,Posthofbrug 5366,2020-01-27,19:00:00,114,49,65,FMN GV 16 Berchem TOT
54,Posthofbrug 5366,2020-01-27,20:00:00,39,18,21,FMN GV 16 Berchem TOT
54,Posthofbrug 5366,2020-01-27,21:00:00,40,21,19,FMN GV 16 Berchem TOT
54,Posthofbrug 5366,2020-01-27,22:00:00,32,15,17,FMN GV 16 Berchem TOT
54,Posthofbrug 5366,2020-01-27,23:00:00,17,4,13,FMN GV 16 Berchem TOT
54,Posthofbrug 5366,2020-01-28,00:00:00,9,4,5,FMN GV 16 Berchem TOT
54,Posthofbrug 5366,2020-01-28,01:00:00,1,0,1,FMN GV 16 Berchem TOT
54,Posthofbrug 5366,2020-01-28,02:00:00,3,0,3,FMN GV 16 Berchem TOT
54,Posthofbrug 5366,2020-01-28,03:00:00,3,2,1,FMN GV 16 Berchem TOT
54,Posthofbrug 5366,2020-01-28,04:00:00,6,4,2,FMN GV 16 Berchem TOT
54,Posthofbrug 5366,2020-01-28,05:00:00,12,12,0,FMN GV 16 Berchem TOT
54,Posthofbrug 5366,2020-01-28,06:00:00,83,72,11,FMN GV 16 Berchem TOT
54,Posthofbrug 5366,2020-01-28,07:00:00,285,230,55,FMN GV 16 Berchem TOT
54,Posthofbrug 5366,2020-01-28,08:00:00,512,387,125,FMN GV 16 Berchem TOT
54,Posthofbrug 5366,2020-01-28,09:00:00,157,116,41,FMN GV 16 Berchem TOT
54,Posthofbrug 5366,2020-01-28,10:00:00,61,43,18,FMN GV 16 Berchem TOT
54,Posthofbrug 5366,2020-01-28,11:00:00,58,39,19,FMN GV 16 Berchem TOT
54,Posthofbrug 5366,2020-01-28,12:00:00,60,39,21,FMN GV 16 Berchem TOT
54,Posthofbrug 5366,2020-01-28,13:00:00,80,53,27,FMN GV 16 Berchem TOT
54,Posthofbrug 5366,2020-01-28,14:00:00,61,28,33,FMN GV 16 Berchem TOT
54,Posthofbrug 5366,2020-01-28,15:00:00,118,59,59,FMN GV 16 Berchem TOT
54,Posthofbrug 5366,2020-01-28,16:00:00,262,115,147,FMN GV 16 Berchem TOT
54,Posthofbrug 5366,2020-01-28,17:00:00,340,139,201,FMN GV 16 Berchem TOT
54,Posthofbrug 5366,2020-01-28,18:00:00,225,86,139,FMN GV 16 Berchem TOT
54,Posthofbrug 5366,2020-01-28,19:00:00,106,38,68,FMN GV 16 Berchem TOT
54,Posthofbrug 5366,2020-01-28,20:00:00,61,27,34,FMN GV 16 Berchem TOT
54,Posthofbrug 5366,2020-01-28,21:00:00,51,22,29,FMN GV 16 Berchem TOT
54,Posthofbrug 5366,2020-01-28,22:00:00,43,16,27,FMN GV 16 Berchem TOT
54,Posthofbrug 5366,2020-01-28,23:00:00,15,6,9,FMN GV 16 Berchem TOT
54,Posthofbrug 5366,2020-01-29,00:00:00,11,5,6,FMN GV 16 Berchem TOT
54,Posthofbrug 5366,2020-01-29,01:00:00,4,1,3,FMN GV 16 Berchem TOT
54,Posthofbrug 5366,2020-01-29,02:00:00,6,2,4,FMN GV 16 Berchem TOT
54,Posthofbrug 5366,2020-01-29,03:00:00,3,0,3,FMN GV 16 Berchem TOT
54,Posthofbrug 5366,2020-01-29,04:00:00,6,4,2,FMN GV 16 Berchem TOT
54,Posthofbrug 5366,2020-01-29,05:00:00,22,20,2,FMN GV 16 Berchem TOT
54,Posthofbrug 5366,2020-01-29,06:00:00,90,76,14,FMN GV 16 Berchem TOT
54,Posthofbrug 5366,2020-01-29,07:00:00,290,231,59,FMN GV 16 Berchem TOT
54,Posthofbrug 5366,2020-01-29,08:00:00,436,305,131,FMN GV 16 Berchem TOT
54,Posthofbrug 5366,2020-01-29,09:00:00,158,117,41,FMN GV 16 Berchem TOT
54,Posthofbrug 5366,2020-01-29,10:00:00,60,43,17,FMN GV 16 Berchem TOT
54,Posthofbrug 5366,2020-01-29,11:00:00,81,51,30,FMN GV 16 Berchem TOT
54,Posthofbrug 5366,2020-01-29,12:00:00,135,67,68,FMN GV 16 Berchem TOT
54,Posthofbrug 5366,2020-01-29,13:00:00,119,69,50,FMN GV 16 Berchem TOT
54,Posthofbrug 5366,2020-01-29,14:00:00,85,51,34,FMN GV 16 Berchem TOT
54,Posthofbrug 5366,2020-01-29,15:00:00,101,53,48,FMN GV 16 Berchem TOT
54,Posthofbrug 5366,2020-01-29,16:00:00,220,105,115,FMN GV 16 Berchem TOT
54,Posthofbrug 5366,2020-01-29,17:00:00,352,139,213,FMN GV 16 Berchem TOT
54,Posthofbrug 5366,2020-01-29,18:00:00,219,90,129,FMN GV 16 Berchem TOT
54,Posthofbrug 5366,2020-01-29,19:00:00,95,39,56,FMN GV 16 Berchem TOT
54,Posthofbrug 5366,2020-01-29,20:00:00,65,35,30,FMN GV 16 Berchem TOT
54,Posthofbrug 5366,2020-01-29,21:00:00,38,15,23,FMN GV 16 Berchem TOT
54,Posthofbrug 5366,2020-01-29,22:00:00,41,12,29,FMN GV 16 Berchem TOT
54,Posthofbrug 5366,2020-01-29,23:00:00,27,9,18,FMN GV 16 Berchem TOT
54,Posthofbrug 5366,2020-01-30,00:00:00,13,6,7,FMN GV 16 Berchem TOT
54,Posthofbrug 5366,2020-01-30,01:00:00,10,1,9,FMN GV 16 Berchem TOT
54,Posthofbrug 5366,2020-01-30,02:00:00,2,0,2,FMN GV 16 Berchem TOT
54,Posthofbrug 5366,2020-01-30,03:00:00,6,0,6,FMN GV 16 Berchem TOT
54,Posthofbrug 5366,2020-01-30,04:00:00,6,6,0,FMN GV 16 Berchem TOT
54,Posthofbrug 5366,2020-01-30,05:00:00,15,13,2,FMN GV 16 Berchem TOT
54,Posthofbrug 5366,2020-01-30,06:00:00,91,78,13,FMN GV 16 Berchem TOT
54,Posthofbrug 5366,2020-01-30,07:00:00,325,249,76,FMN GV 16 Berchem TOT
54,Posthofbrug 5366,2020-01-30,08:00:00,520,378,142,FMN GV 16 Berchem TOT
54,Posthofbrug 5366,2020-01-30,09:00:00,192,144,48,FMN GV 16 Berchem TOT
54,Posthofbrug 5366,2020-01-30,10:00:00,65,47,18,FMN GV 16 Berchem TOT
54,Posthofbrug 5366,2020-01-30,11:00:00,70,54,16,FMN GV 16 Berchem TOT
54,Posthofbrug 5366,2020-01-30,12:00:00,94,58,36,FMN GV 16 Berchem TOT
54,Posthofbrug 5366,2020-01-30,13:00:00,91,44,47,FMN GV 16 Berchem TOT
54,Posthofbrug 5366,2020-01-30,14:00:00,83,37,46,FMN GV 16 Berchem TOT
54,Posthofbrug 5366,2020-01-30,15:00:00,153,67,86,FMN GV 16 Berchem TOT
54,Posthofbrug 5366,2020-01-30,16:00:00,280,132,148,FMN GV 16 Berchem TOT
54,Posthofbrug 5366,2020-01-30,17:00:00,363,150,213,FMN GV 16 Berchem TOT
54,Posthofbrug 5366,2020-01-30,18:00:00,214,96,118,FMN GV 16 Berchem TOT
54,Posthofbrug 5366,2020-01-30,19:00:00,111,49,62,FMN GV 16 Berchem TOT
54,Posthofbrug 5366,2020-01-30,20:00:00,58,30,28,FMN GV 16 Berchem TOT
54,Posthofbrug 5366,2020-01-30,21:00:00,48,25,23,FMN GV 16 Berchem TOT
54,Posthofbrug 5366,2020-01-30,22:00:00,54,14,40,FMN GV 16 Berchem TOT
54,Posthofbrug 5366,2020-01-30,23:00:00,49,14,35,FMN GV 16 Berchem TOT
54,Posthofbrug 5366,2020-01-31,00:00:00,24,8,16,FMN GV 16 Berchem TOT
54,Posthofbrug 5366,2020-01-31,01:00:00,9,0,9,FMN GV 16 Berchem TOT
54,Posthofbrug 5366,2020-01-31,02:00:00,13,5,8,FMN GV 16 Berchem TOT
54,Posthofbrug 5366,2020-01-31,03:00:00,7,0,7,FMN GV 16 Berchem TOT
54,Posthofbrug 5366,2020-01-31,04:00:00,5,4,1,FMN GV 16 Berchem TOT
54,Posthofbrug 5366,2020-01-31,05:00:00,12,8,4,FMN GV 16 Berchem TOT
54,Posthofbrug 5366,2020-01-31,06:00:00,79,64,15,FMN GV 16 Berchem TOT
54,Posthofbrug 5366,2020-01-31,07:00:00,204,158,46,FMN GV 16 Berchem TOT
54,Posthofbrug 5366,2020-01-31,08:00:00,424,310,114,FMN GV 16 Berchem TOT
54,Posthofbrug 5366,2020-01-31,09:00:00,168,125,43,FMN GV 16 Berchem TOT
54,Posthofbrug 5366,2020-01-31,10:00:00,84,61,23,FMN GV 16 Berchem TOT
54,Posthofbrug 5366,2020-01-31,11:00:00,64,48,16,FMN GV 16 Berchem TOT
54,Posthofbrug 5366,2020-01-31,12:00:00,109,68,41,FMN GV 16 Berchem TOT
54,Posthofbrug 5366,2020-01-31,13:00:00,90,40,50,FMN GV 16 Berchem TOT
54,Posthofbrug 5366,2020-01-31,14:00:00,103,43,60,FMN GV 16 Berchem TOT
54,Posthofbrug 5366,2020-01-31,15:00:00,172,86,86,FMN GV 16 Berchem TOT
54,Posthofbrug 5366,2020-01-31,16:00:00,248,118,130,FMN GV 16 Berchem TOT
54,Posthofbrug 5366,2020-01-31,17:00:00,289,123,166,FMN GV 16 Berchem TOT
54,Posthofbrug 5366,2020-01-31,18:00:00,206,82,124,FMN GV 16 Berchem TOT
54,Posthofbrug 5366,2020-01-31,19:00:00,97,44,53,FMN GV 16 Berchem TOT
54,Posthofbrug 5366,2020-01-31,20:00:00,51,26,25,FMN GV 16 Berchem TOT
54,Posthofbrug 5366,2020-01-31,21:00:00,36,21,15,FMN GV 16 Berchem TOT
54,Posthofbrug 5366,2020-01-31,22:00:00,46,16,30,FMN GV 16 Berchem TOT
54,Posthofbrug 5366,2020-01-31,23:00:00,58,21,37,FMN GV 16 Berchem TOT
54,Posthofbrug 5366,2020-02-01,00:00:00,40,10,30,FMN GV 16 Berchem TOT
54,Posthofbrug 5366,2020-02-01,01:00:00,22,9,13,FMN GV 16 Berchem TOT
54,Posthofbrug 5366,2020-02-01,02:00:00,21,8,13,FMN GV 16 Berchem TOT
54,Posthofbrug 5366,2020-02-01,03:00:00,12,1,11,FMN GV 16 Berchem TOT
54,Posthofbrug 5366,2020-02-01,04:00:00,7,2,5,FMN GV 16 Berchem TOT
54,Posthofbrug 5366,2020-02-01,05:00:00,4,3,1,FMN GV 16 Berchem TOT
54,Posthofbrug 5366,2020-02-01,06:00:00,18,9,9,FMN GV 16 Berchem TOT
54,Posthofbrug 5366,2020-02-01,07:00:00,19,11,8,FMN GV 16 Berchem TOT
54,Posthofbrug 5366,2020-02-01,08:00:00,18,9,9,FMN GV 16 Berchem TOT
54,Posthofbrug 5366,2020-02-01,09:00:00,44,31,13,FMN GV 16 Berchem TOT
54,Posthofbrug 5366,2020-02-01,10:00:00,67,49,18,FMN GV 16 Berchem TOT
54,Posthofbrug 5366,2020-02-01,11:00:00,87,58,29,FMN GV 16 Berchem TOT
54,Posthofbrug 5366,2020-02-01,12:00:00,73,37,36,FMN GV 16 Berchem TOT
54,Posthofbrug 5366,2020-02-01,13:00:00,77,53,24,FMN GV 16 Berchem TOT
54,Posthofbrug 5366,2020-02-01,14:00:00,56,36,20,FMN GV 16 Berchem TOT
54,Posthofbrug 5366,2020-02-01,15:00:00,62,36,26,FMN GV 16 Berchem TOT
54,Posthofbrug 5366,2020-02-01,16:00:00,67,34,33,FMN GV 16 Berchem TOT
54,Posthofbrug 5366,2020-02-01,17:00:00,71,36,35,FMN GV 16 Berchem TOT
54,Posthofbrug 5366,2020-02-01,18:00:00,92,56,36,FMN GV 16 Berchem TOT
54,Posthofbrug 5366,2020-02-01,19:00:00,77,50,27,FMN GV 16 Berchem TOT
54,Posthofbrug 5366,2020-02-01,20:00:00,57,37,20,FMN GV 16 Berchem TOT
54,Posthofbrug 5366,2020-02-01,21:00:00,44,34,10,FMN GV 16 Berchem TOT
54,Posthofbrug 5366,2020-02-01,22:00:00,47,26,21,FMN GV 16 Berchem TOT
54,Posthofbrug 5366,2020-02-01,23:00:00,55,22,33,FMN GV 16 Berchem TOT
54,Posthofbrug 5366,2020-02-02,00:00:00,29,11,18,FMN GV 16 Berchem TOT
54,Posthofbrug 5366,2020-02-02,01:00:00,26,9,17,FMN GV 16 Berchem TOT
54,Posthofbrug 5366,2020-02-02,02:00:00,12,4,8,FMN GV 16 Berchem TOT
54,Posthofbrug 5366,2020-02-02,03:00:00,17,4,13,FMN GV 16 Berchem TOT
54,Posthofbrug 5366,2020-02-02,04:00:00,7,0,7,FMN GV 16 Berchem TOT
54,Posthofbrug 5366,2020-02-02,05:00:00,9,5,4,FMN GV 16 Berchem TOT
54,Posthofbrug 5366,2020-02-02,06:00:00,18,12,6,FMN GV 16 Berchem TOT
54,Posthofbrug 5366,2020-02-02,07:00:00,10,3,7,FMN GV 16 Berchem TOT
54,Posthofbrug 5366,2020-02-02,08:00:00,16,10,6,FMN GV 16 Berchem TOT
54,Posthofbrug 5366,2020-02-02,09:00:00,20,12,8,FMN GV 16 Berchem TOT
54,Posthofbrug 5366,2020-02-02,10:00:00,17,15,2,FMN GV 16 Berchem TOT
54,Posthofbrug 5366,2020-02-02,11:00:00,34,25,9,FMN GV 16 Berchem TOT
54,Posthofbrug 5366,2020-02-02,12:00:00,39,19,20,FMN GV 16 Berchem TOT
54,Posthofbrug 5366,2020-02-02,13:00:00,54,28,26,FMN GV 16 Berchem TOT
54,Posthofbrug 5366,2020-02-02,14:00:00,65,38,27,FMN GV 16 Berchem TOT
54,Posthofbrug 5366,2020-02-02,15:00:00,43,27,16,FMN GV 16 Berchem TOT
54,Posthofbrug 5366,2020-02-02,16:00:00,57,34,23,FMN GV 16 Berchem TOT
54,Posthofbrug 5366,2020-02-02,17:00:00,63,23,40,FMN GV 16 Berchem TOT
54,Posthofbrug 5366,2020-02-02,18:00:00,55,27,28,FMN GV 16 Berchem TOT
54,Posthofbrug 5366,2020-02-02,19:00:00,35,15,20,FMN GV 16 Berchem TOT
54,Posthofbrug 5366,2020-02-02,20:00:00,24,14,10,FMN GV 16 Berchem TOT
54,Posthofbrug 5366,2020-02-02,21:00:00,32,22,10,FMN GV 16 Berchem TOT
54,Posthofbrug 5366,2020-02-02,22:00:00,12,6,6,FMN GV 16 Berchem TOT
54,Posthofbrug 5366,2020-02-02,23:00:00,11,3,8,FMN GV 16 Berchem TOT
54,Posthofbrug 5366,2020-02-03,00:00:00,6,2,4,FMN GV 16 Berchem TOT
54,Posthofbrug 5366,2020-02-03,01:00:00,6,2,4,FMN GV 16 Berchem TOT
54,Posthofbrug 5366,2020-02-03,02:00:00,2,0,2,FMN GV 16 Berchem TOT
54,Posthofbrug 5366,2020-02-03,03:00:00,4,3,1,FMN GV 16 Berchem TOT
54,Posthofbrug 5366,2020-02-03,04:00:00,6,6,0,FMN GV 16 Berchem TOT
54,Posthofbrug 5366,2020-02-03,05:00:00,16,16,0,FMN GV 16 Berchem TOT
54,Posthofbrug 5366,2020-02-03,06:00:00,84,73,11,FMN GV 16 Berchem TOT
54,Posthofbrug 5366,2020-02-03,07:00:00,346,261,85,FMN GV 16 Berchem TOT
54,Posthofbrug 5366,2020-02-03,08:00:00,565,438,127,FMN GV 16 Berchem TOT
54,Posthofbrug 5366,2020-02-03,09:00:00,187,134,53,FMN GV 16 Berchem TOT
54,Posthofbrug 5366,2020-02-03,10:00:00,87,62,25,FMN GV 16 Berchem TOT
54,Posthofbrug 5366,2020-02-03,11:00:00,80,61,19,FMN GV 16 Berchem TOT
54,Posthofbrug 5366,2020-02-03,12:00:00,119,73,46,FMN GV 16 Berchem TOT
54,Posthofbrug 5366,2020-02-03,13:00:00,91,46,45,FMN GV 16 Berchem TOT
54,Posthofbrug 5366,2020-02-03,14:00:00,81,32,49,FMN GV 16 Berchem TOT
54,Posthofbrug 5366,2020-02-03,15:00:00,153,71,82,FMN GV 16 Berchem TOT
54,Posthofbrug 5366,2020-02-03,16:00:00,296,125,171,FMN GV 16 Berchem TOT
54,Posthofbrug 5366,2020-02-03,17:00:00,437,160,277,FMN GV 16 Berchem TOT
54,Posthofbrug 5366,2020-02-03,18:00:00,206,87,119,FMN GV 16 Berchem TOT
54,Posthofbrug 5366,2020-02-03,19:00:00,109,41,68,FMN GV 16 Berchem TOT
54,Posthofbrug 5366,2020-02-03,20:00:00,45,19,26,FMN GV 16 Berchem TOT
54,Posthofbrug 5366,2020-02-03,21:00:00,36,14,22,FMN GV 16 Berchem TOT
54,Posthofbrug 5366,2020-02-03,22:00:00,35,15,20,FMN GV 16 Berchem TOT
54,Posthofbrug 5366,2020-02-03,23:00:00,16,4,12,FMN GV 16 Berchem TOT
54,Posthofbrug 5366,2020-02-04,00:00:00,11,3,8,FMN GV 16 Berchem TOT
54,Posthofbrug 5366,2020-02-04,01:00:00,3,1,2,FMN GV 16 Berchem TOT
54,Posthofbrug 5366,2020-02-04,02:00:00,2,1,1,FMN GV 16 Berchem TOT
54,Posthofbrug 5366,2020-02-04,03:00:00,1,1,0,FMN GV 16 Berchem TOT
54,Posthofbrug 5366,2020-02-04,04:00:00,6,5,1,FMN GV 16 Berchem TOT
54,Posthofbrug 5366,2020-02-04,05:00:00,17,16,1,FMN GV 16 Berchem TOT
54,Posthofbrug 5366,2020-02-04,06:00:00,80,69,11,FMN GV 16 Berchem TOT
54,Posthofbrug 5366,2020-02-04,07:00:00,316,255,61,FMN GV 16 Berchem TOT
54,Posthofbrug 5366,2020-02-04,08:00:00,485,370,115,FMN GV 16 Berchem TOT
54,Posthofbrug 5366,2020-02-04,09:00:00,176,128,48,FMN GV 16 Berchem TOT
54,Posthofbrug 5366,2020-02-04,10:00:00,59,43,16,FMN GV 16 Berchem TOT
54,Posthofbrug 5366,2020-02-04,11:00:00,62,41,21,FMN GV 16 Berchem TOT
54,Posthofbrug 5366,2020-02-04,12:00:00,95,67,28,FMN GV 16 Berchem TOT
54,Posthofbrug 5366,2020-02-04,13:00:00,67,40,27,FMN GV 16 Berchem TOT
54,Posthofbrug 5366,2020-02-04,14:00:00,67,27,40,FMN GV 16 Berchem TOT
54,Posthofbrug 5366,2020-02-04,15:00:00,109,48,61,FMN GV 16 Berchem TOT
54,Posthofbrug 5366,2020-02-04,16:00:00,269,108,161,FMN GV 16 Berchem TOT
54,Posthofbrug 5366,2020-02-04,17:00:00,317,127,190,FMN GV 16 Berchem TOT
54,Posthofbrug 5366,2020-02-04,18:00:00,211,71,140,FMN GV 16 Berchem TOT
54,Posthofbrug 5366,2020-02-04,19:00:00,99,43,56,FMN GV 16 Berchem TOT
54,Posthofbrug 5366,2020-02-04,20:00:00,61,23,38,FMN GV 16 Berchem TOT
54,Posthofbrug 5366,2020-02-04,21:00:00,34,17,17,FMN GV 16 Berchem TOT
54,Posthofbrug 5366,2020-02-04,22:00:00,39,14,25,FMN GV 16 Berchem TOT
54,Posthofbrug 5366,2020-02-04,23:00:00,26,8,18,FMN GV 16 Berchem TOT
54,Posthofbrug 5366,2020-02-05,00:00:00,16,10,6,FMN GV 16 Berchem TOT
54,Posthofbrug 5366,2020-02-05,01:00:00,3,0,3,FMN GV 16 Berchem TOT
54,Posthofbrug 5366,2020-02-05,02:00:00,2,0,2,FMN GV 16 Berchem TOT
54,Posthofbrug 5366,2020-02-05,03:00:00,3,1,2,FMN GV 16 Berchem TOT
54,Posthofbrug 5366,2020-02-05,04:00:00,6,6,0,FMN GV 16 Berchem TOT
54,Posthofbrug 5366,2020-02-05,05:00:00,14,13,1,FMN GV 16 Berchem TOT
54,Posthofbrug 5366,2020-02-05,06:00:00,82,68,14,FMN GV 16 Berchem TOT
54,Posthofbrug 5366,2020-02-05,07:00:00,284,217,67,FMN GV 16 Berchem TOT
54,Posthofbrug 5366,2020-02-05,08:00:00,462,343,119,FMN GV 16 Berchem TOT
54,Posthofbrug 5366,2020-02-05,09:00:00,156,114,42,FMN GV 16 Berchem TOT
54,Posthofbrug 5366,2020-02-05,10:00:00,67,37,30,FMN GV 16 Berchem TOT
54,Posthofbrug 5366,2020-02-05,11:00:00,73,46,27,FMN GV 16 Berchem TOT
54,Posthofbrug 5366,2020-02-05,12:00:00,152,79,73,FMN GV 16 Berchem TOT
54,Posthofbrug 5366,2020-02-05,13:00:00,130,67,63,FMN GV 16 Berchem TOT
54,Posthofbrug 5366,2020-02-05,14:00:00,91,43,48,FMN GV 16 Berchem TOT
54,Posthofbrug 5366,2020-02-05,15:00:00,130,55,75,FMN GV 16 Berchem TOT
54,Posthofbrug 5366,2020-02-05,16:00:00,237,118,119,FMN GV 16 Berchem TOT
54,Posthofbrug 5366,2020-02-05,17:00:00,375,163,212,FMN GV 16 Berchem TOT
54,Posthofbrug 5366,2020-02-05,18:00:00,248,97,151,FMN GV 16 Berchem TOT
54,Posthofbrug 5366,2020-02-05,19:00:00,91,38,53,FMN GV 16 Berchem TOT
54,Posthofbrug 5366,2020-02-05,20:00:00,61,31,30,FMN GV 16 Berchem TOT
54,Posthofbrug 5366,2020-02-05,21:00:00,42,23,19,FMN GV 16 Berchem TOT
54,Posthofbrug 5366,2020-02-05,22:00:00,47,14,33,FMN GV 16 Berchem TOT
54,Posthofbrug 5366,2020-02-05,23:00:00,24,4,20,FMN GV 16 Berchem TOT
54,Posthofbrug 5366,2020-02-06,00:00:00,13,3,10,FMN GV 16 Berchem TOT
54,Posthofbrug 5366,2020-02-06,01:00:00,3,1,2,FMN GV 16 Berchem TOT
54,Posthofbrug 5366,2020-02-06,02:00:00,5,0,5,FMN GV 16 Berchem TOT
54,Posthofbrug 5366,2020-02-06,03:00:00,5,0,5,FMN GV 16 Berchem TOT
54,Posthofbrug 5366,2020-02-06,04:00:00,7,6,1,FMN GV 16 Berchem TOT
54,Posthofbrug 5366,2020-02-06,05:00:00,17,13,4,FMN GV 16 Berchem TOT
54,Posthofbrug 5366,2020-02-06,06:00:00,92,72,20,FMN GV 16 Berchem TOT
54,Posthofbrug 5366,2020-02-06,07:00:00,330,268,62,FMN GV 16 Berchem TOT
54,Posthofbrug 5366,2020-02-06,08:00:00,547,404,143,FMN GV 16 Berchem TOT
54,Posthofbrug 5366,2020-02-06,09:00:00,208,160,48,FMN GV 16 Berchem TOT
54,Posthofbrug 5366,2020-02-06,10:00:00,77,54,23,FMN GV 16 Berchem TOT
54,Posthofbrug 5366,2020-02-06,11:00:00,66,46,20,FMN GV 16 Berchem TOT
54,Posthofbrug 5366,2020-02-06,12:00:00,115,75,40,FMN GV 16 Berchem TOT
54,Posthofbrug 5366,2020-02-06,13:00:00,109,58,51,FMN GV 16 Berchem TOT
54,Posthofbrug 5366,2020-02-06,14:00:00,99,46,53,FMN GV 16 Berchem TOT
54,Posthofbrug 5366,2020-02-06,15:00:00,175,80,95,FMN GV 16 Berchem TOT
54,Posthofbrug 5366,2020-02-06,16:00:00,319,129,190,FMN GV 16 Berchem TOT
54,Posthofbrug 5366,2020-02-06,17:00:00,426,155,271,FMN GV 16 Berchem TOT
54,Posthofbrug 5366,2020-02-06,18:00:00,229,74,155,FMN GV 16 Berchem TOT
54,Posthofbrug 5366,2020-02-06,19:00:00,134,54,80,FMN GV 16 Berchem TOT
54,Posthofbrug 5366,2020-02-06,20:00:00,67,35,32,FMN GV 16 Berchem TOT
54,Posthofbrug 5366,2020-02-06,21:00:00,40,19,21,FMN GV 16 Berchem TOT
54,Posthofbrug 5366,2020-02-06,22:00:00,51,9,42,FMN GV 16 Berchem TOT
54,Posthofbrug 5366,2020-02-06,23:00:00,38,11,27,FMN GV 16 Berchem TOT
54,Posthofbrug 5366,2020-02-07,00:00:00,10,3,7,FMN GV 16 Berchem TOT
54,Posthofbrug 5366,2020-02-07,01:00:00,7,0,7,FMN GV 16 Berchem TOT
54,Posthofbrug 5366,2020-02-07,02:00:00,6,4,2,FMN GV 16 Berchem TOT
54,Posthofbrug 5366,2020-02-07,03:00:00,2,2,0,FMN GV 16 Berchem TOT
54,Posthofbrug 5366,2020-02-07,04:00:00,7,5,2,FMN GV 16 Berchem TOT
54,Posthofbrug 5366,2020-02-07,05:00:00,16,12,4,FMN GV 16 Berchem TOT
54,Posthofbrug 5366,2020-02-07,06:00:00,69,59,10,FMN GV 16 Berchem TOT
54,Posthofbrug 5366,2020-02-07,07:00:00,252,200,52,FMN GV 16 Berchem TOT
54,Posthofbrug 5366,2020-02-07,08:00:00,454,341,113,FMN GV 16 Berchem TOT
54,Posthofbrug 5366,2020-02-07,09:00:00,157,114,43,FMN GV 16 Berchem TOT
54,Posthofbrug 5366,2020-02-07,10:00:00,65,48,17,FMN GV 16 Berchem TOT
54,Posthofbrug 5366,2020-02-07,11:00:00,83,53,30,FMN GV 16 Berchem TOT
54,Posthofbrug 5366,2020-02-07,12:00:00,134,79,55,FMN GV 16 Berchem TOT
54,Posthofbrug 5366,2020-02-07,13:00:00,126,80,46,FMN GV 16 Berchem TOT
54,Posthofbrug 5366,2020-02-07,14:00:00,137,67,70,FMN GV 16 Berchem TOT
54,Posthofbrug 5366,2020-02-07,15:00:00,157,71,86,FMN GV 16 Berchem TOT
54,Posthofbrug 5366,2020-02-07,16:00:00,297,126,171,FMN GV 16 Berchem TOT
54,Posthofbrug 5366,2020-02-07,17:00:00,316,137,179,FMN GV 16 Berchem TOT
54,Posthofbrug 5366,2020-02-07,18:00:00,171,66,105,FMN GV 16 Berchem TOT
54,Posthofbrug 5366,2020-02-07,19:00:00,92,33,59,FMN GV 16 Berchem TOT
54,Posthofbrug 5366,2020-02-07,20:00:00,64,35,29,FMN GV 16 Berchem TOT
54,Posthofbrug 5366,2020-02-07,21:00:00,41,25,16,FMN GV 16 Berchem TOT
54,Posthofbrug 5366,2020-02-07,22:00:00,45,22,23,FMN GV 16 Berchem TOT
54,Posthofbrug 5366,2020-02-07,23:00:00,42,14,28,FMN GV 16 Berchem TOT
54,Posthofbrug 5366,2020-02-08,00:00:00,31,11,20,FMN GV 16 Berchem TOT
54,Posthofbrug 5366,2020-02-08,01:00:00,23,4,19,FMN GV 16 Berchem TOT
54,Posthofbrug 5366,2020-02-08,02:00:00,10,1,9,FMN GV 16 Berchem TOT
54,Posthofbrug 5366,2020-02-08,03:00:00,9,2,7,FMN GV 16 Berchem TOT
54,Posthofbrug 5366,2020-02-08,04:00:00,15,6,9,FMN GV 16 Berchem TOT
54,Posthofbrug 5366,2020-02-08,05:00:00,8,2,6,FMN GV 16 Berchem TOT
54,Posthofbrug 5366,2020-02-08,06:00:00,18,6,12,FMN GV 16 Berchem TOT
54,Posthofbrug 5366,2020-02-08,07:00:00,19,12,7,FMN GV 16 Berchem TOT
54,Posthofbrug 5366,2020-02-08,08:00:00,42,29,13,FMN GV 16 Berchem TOT
54,Posthofbrug 5366,2020-02-08,09:00:00,58,49,9,FMN GV 16 Berchem TOT
54,Posthofbrug 5366,2020-02-08,10:00:00,66,40,26,FMN GV 16 Berchem TOT
54,Posthofbrug 5366,2020-02-08,11:00:00,65,40,25,FMN GV 16 Berchem TOT
54,Posthofbrug 5366,2020-02-08,12:00:00,57,30,27,FMN GV 16 Berchem TOT
54,Posthofbrug 5366,2020-02-08,13:00:00,69,44,25,FMN GV 16 Berchem TOT
54,Posthofbrug 5366,2020-02-08,14:00:00,80,48,32,FMN GV 16 Berchem TOT
54,Posthofbrug 5366,2020-02-08,15:00:00,38,15,23,FMN GV 16 Berchem TOT
54,Posthofbrug 5366,2020-02-08,16:00:00,44,23,21,FMN GV 16 Berchem TOT
54,Posthofbrug 5366,2020-02-08,17:00:00,55,30,25,FMN GV 16 Berchem TOT
54,Posthofbrug 5366,2020-02-08,18:00:00,48,33,15,FMN GV 16 Berchem TOT
54,Posthofbrug 5366,2020-02-08,19:00:00,47,30,17,FMN GV 16 Berchem TOT
54,Posthofbrug 5366,2020-02-08,20:00:00,35,23,12,FMN GV 16 Berchem TOT
54,Posthofbrug 5366,2020-02-08,21:00:00,30,12,18,FMN GV 16 Berchem TOT
54,Posthofbrug 5366,2020-02-08,22:00:00,18,6,12,FMN GV 16 Berchem TOT
54,Posthofbrug 5366,2020-02-08,23:00:00,36,11,25,FMN GV 16 Berchem TOT
54,Posthofbrug 5366,2020-02-09,00:00:00,13,1,12,FMN GV 16 Berchem TOT
54,Posthofbrug 5366,2020-02-09,01:00:00,16,6,10,FMN GV 16 Berchem TOT
54,Posthofbrug 5366,2020-02-09,02:00:00,11,5,6,FMN GV 16 Berchem TOT
54,Posthofbrug 5366,2020-02-09,03:00:00,7,2,5,FMN GV 16 Berchem TOT
54,Posthofbrug 5366,2020-02-09,04:00:00,1,1,0,FMN GV 16 Berchem TOT
54,Posthofbrug 5366,2020-02-09,05:00:00,4,2,2,FMN GV 16 Berchem TOT
54,Posthofbrug 5366,2020-02-09,06:00:00,6,2,4,FMN GV 16 Berchem TOT
54,Posthofbrug 5366,2020-02-09,07:00:00,16,10,6,FMN GV 16 Berchem TOT
54,Posthofbrug 5366,2020-02-09,08:00:00,9,6,3,FMN GV 16 Berchem TOT
54,Posthofbrug 5366,2020-02-09,09:00:00,33,20,13,FMN GV 16 Berchem TOT
54,Posthofbrug 5366,2020-02-09,10:00:00,31,20,11,FMN GV 16 Berchem TOT
54,Posthofbrug 5366,2020-02-09,11:00:00,34,20,14,FMN GV 16 Berchem TOT
54,Posthofbrug 5366,2020-02-09,12:00:00,24,6,18,FMN GV 16 Berchem TOT
54,Posthofbrug 5366,2020-02-09,13:00:00,24,12,12,FMN GV 16 Berchem TOT
54,Posthofbrug 5366,2020-02-09,14:00:00,31,18,13,FMN GV 16 Berchem TOT
54,Posthofbrug 5366,2020-02-09,15:00:00,41,21,20,FMN GV 16 Berchem TOT
54,Posthofbrug 5366,2020-02-09,16:00:00,41,12,29,FMN GV 16 Berchem TOT
54,Posthofbrug 5366,2020-02-09,17:00:00,38,12,26,FMN GV 16 Berchem TOT
54,Posthofbrug 5366,2020-02-09,18:00:00,22,8,14,FMN GV 16 Berchem TOT
54,Posthofbrug 5366,2020-02-09,19:00:00,12,7,5,FMN GV 16 Berchem TOT
54,Posthofbrug 5366,2020-02-09,20:00:00,3,1,2,FMN GV 16 Berchem TOT
54,Posthofbrug 5366,2020-02-09,21:00:00,4,2,2,FMN GV 16 Berchem TOT
54,Posthofbrug 5366,2020-02-09,22:00:00,8,3,5,FMN GV 16 Berchem TOT
54,Posthofbrug 5366,2020-02-09,23:00:00,10,1,9,FMN GV 16 Berchem TOT
54,Posthofbrug 5366,2020-02-10,00:00:00,4,2,2,FMN GV 16 Berchem TOT
54,Posthofbrug 5366,2020-02-10,01:00:00,5,3,2,FMN GV 16 Berchem TOT
54,Posthofbrug 5366,2020-02-10,02:00:00,0,0,0,FMN GV 16 Berchem TOT
54,Posthofbrug 5366,2020-02-10,03:00:00,0,0,0,FMN GV 16 Berchem TOT
54,Posthofbrug 5366,2020-02-10,04:00:00,7,5,2,FMN GV 16 Berchem TOT
54,Posthofbrug 5366,2020-02-10,05:00:00,15,11,4,FMN GV 16 Berchem TOT
54,Posthofbrug 5366,2020-02-10,06:00:00,59,50,9,FMN GV 16 Berchem TOT
54,Posthofbrug 5366,2020-02-10,07:00:00,202,159,43,FMN GV 16 Berchem TOT
54,Posthofbrug 5366,2020-02-10,08:00:00,398,288,110,FMN GV 16 Berchem TOT
54,Posthofbrug 5366,2020-02-10,09:00:00,139,93,46,FMN GV 16 Berchem TOT
54,Posthofbrug 5366,2020-02-10,10:00:00,63,43,20,FMN GV 16 Berchem TOT
54,Posthofbrug 5366,2020-02-10,11:00:00,49,33,16,FMN GV 16 Berchem TOT
54,Posthofbrug 5366,2020-02-10,12:00:00,70,41,29,FMN GV 16 Berchem TOT
54,Posthofbrug 5366,2020-02-10,13:00:00,72,34,38,FMN GV 16 Berchem TOT
54,Posthofbrug 5366,2020-02-10,14:00:00,58,34,24,FMN GV 16 Berchem TOT
54,Posthofbrug 5366,2020-02-10,15:00:00,102,43,59,FMN GV 16 Berchem TOT
54,Posthofbrug 5366,2020-02-10,16:00:00,201,97,104,FMN GV 16 Berchem TOT
54,Posthofbrug 5366,2020-02-10,17:00:00,265,109,156,FMN GV 16 Berchem TOT
54,Posthofbrug 5366,2020-02-10,18:00:00,181,73,108,FMN GV 16 Berchem TOT
54,Posthofbrug 5366,2020-02-10,19:00:00,83,31,52,FMN GV 16 Berchem TOT
54,Posthofbrug 5366,2020-02-10,20:00:00,32,15,17,FMN GV 16 Berchem TOT
54,Posthofbrug 5366,2020-02-10,21:00:00,38,18,20,FMN GV 16 Berchem TOT
54,Posthofbrug 5366,2020-02-10,22:00:00,33,5,28,FMN GV 16 Berchem TOT
54,Posthofbrug 5366,2020-02-10,23:00:00,18,4,14,FMN GV 16 Berchem TOT
54,Posthofbrug 5366,2020-02-11,00:00:00,9,2,7,FMN GV 16 Berchem TOT
54,Posthofbrug 5366,2020-02-11,01:00:00,2,0,2,FMN GV 16 Berchem TOT
54,Posthofbrug 5366,2020-02-11,02:00:00,2,0,2,FMN GV 16 Berchem TOT
54,Posthofbrug 5366,2020-02-11,03:00:00,1,1,0,FMN GV 16 Berchem TOT
54,Posthofbrug 5366,2020-02-11,04:00:00,6,5,1,FMN GV 16 Berchem TOT
54,Posthofbrug 5366,2020-02-11,05:00:00,11,10,1,FMN GV 16 Berchem TOT
54,Posthofbrug 5366,2020-02-11,06:00:00,78,68,10,FMN GV 16 Berchem TOT
54,Posthofbrug 5366,2020-02-11,07:00:00,300,228,72,FMN GV 16 Berchem TOT
54,Posthofbrug 5366,2020-02-11,08:00:00,542,398,144,FMN GV 16 Berchem TOT
54,Posthofbrug 5366,2020-02-11,09:00:00,184,130,54,FMN GV 16 Berchem TOT
54,Posthofbrug 5366,2020-02-11,10:00:00,75,54,21,FMN GV 16 Berchem TOT
54,Posthofbrug 5366,2020-02-11,11:00:00,74,52,22,FMN GV 16 Berchem TOT
54,Posthofbrug 5366,2020-02-11,12:00:00,101,56,45,FMN GV 16 Berchem TOT
54,Posthofbrug 5366,2020-02-11,13:00:00,88,50,38,FMN GV 16 Berchem TOT
54,Posthofbrug 5366,2020-02-11,14:00:00,79,38,41,FMN GV 16 Berchem TOT
54,Posthofbrug 5366,2020-02-11,15:00:00,146,66,80,FMN GV 16 Berchem TOT
54,Posthofbrug 5366,2020-02-11,16:00:00,279,124,155,FMN GV 16 Berchem TOT
54,Posthofbrug 5366,2020-02-11,17:00:00,397,142,255,FMN GV 16 Berchem TOT
54,Posthofbrug 5366,2020-02-11,18:00:00,265,99,166,FMN GV 16 Berchem TOT
54,Posthofbrug 5366,2020-02-11,19:00:00,112,43,69,FMN GV 16 Berchem TOT
54,Posthofbrug 5366,2020-02-11,20:00:00,54,28,26,FMN GV 16 Berchem TOT
54,Posthofbrug 5366,2020-02-11,21:00:00,62,24,38,FMN GV 16 Berchem TOT
54,Posthofbrug 5366,2020-02-11,22:00:00,51,28,23,FMN GV 16 Berchem TOT
54,Posthofbrug 5366,2020-02-11,23:00:00,22,5,17,FMN GV 16 Berchem TOT
54,Posthofbrug 5366,2020-02-12,00:00:00,17,5,12,FMN GV 16 Berchem TOT
54,Posthofbrug 5366,2020-02-12,01:00:00,3,1,2,FMN GV 16 Berchem TOT
54,Posthofbrug 5366,2020-02-12,02:00:00,4,0,4,FMN GV 16 Berchem TOT
54,Posthofbrug 5366,2020-02-12,03:00:00,2,0,2,FMN GV 16 Berchem TOT
54,Posthofbrug 5366,2020-02-12,04:00:00,7,5,2,FMN GV 16 Berchem TOT
54,Posthofbrug 5366,2020-02-12,05:00:00,14,12,2,FMN GV 16 Berchem TOT
54,Posthofbrug 5366,2020-02-12,06:00:00,78,63,15,FMN GV 16 Berchem TOT
54,Posthofbrug 5366,2020-02-12,07:00:00,310,238,72,FMN GV 16 Berchem TOT
54,Posthofbrug 5366,2020-02-12,08:00:00,505,363,142,FMN GV 16 Berchem TOT
54,Posthofbrug 5366,2020-02-12,09:00:00,169,118,51,FMN GV 16 Berchem TOT
54,Posthofbrug 5366,2020-02-12,10:00:00,57,40,17,FMN GV 16 Berchem TOT
54,Posthofbrug 5366,2020-02-12,11:00:00,81,46,35,FMN GV 16 Berchem TOT
54,Posthofbrug 5366,2020-02-12,12:00:00,208,106,102,FMN GV 16 Berchem TOT
54,Posthofbrug 5366,2020-02-12,13:00:00,133,61,72,FMN GV 16 Berchem TOT
54,Posthofbrug 5366,2020-02-12,14:00:00,109,50,59,FMN GV 16 Berchem TOT
54,Posthofbrug 5366,2020-02-12,15:00:00,148,69,79,FMN GV 16 Berchem TOT
54,Posthofbrug 5366,2020-02-12,16:00:00,243,110,133,FMN GV 16 Berchem TOT
54,Posthofbrug 5366,2020-02-12,17:00:00,390,169,221,FMN GV 16 Berchem TOT
54,Posthofbrug 5366,2020-02-12,18:00:00,263,90,173,FMN GV 16 Berchem TOT
54,Posthofbrug 5366,2020-02-12,19:00:00,121,56,65,FMN GV 16 Berchem TOT
54,Posthofbrug 5366,2020-02-12,20:00:00,68,33,35,FMN GV 16 Berchem TOT
54,Posthofbrug 5366,2020-02-12,21:00:00,38,18,20,FMN GV 16 Berchem TOT
54,Posthofbrug 5366,2020-02-12,22:00:00,54,20,34,FMN GV 16 Berchem TOT
54,Posthofbrug 5366,2020-02-12,23:00:00,36,13,23,FMN GV 16 Berchem TOT
54,Posthofbrug 5366,2020-02-13,00:00:00,16,6,10,FMN GV 16 Berchem TOT
54,Posthofbrug 5366,2020-02-13,01:00:00,6,1,5,FMN GV 16 Berchem TOT
54,Posthofbrug 5366,2020-02-13,02:00:00,4,1,3,FMN GV 16 Berchem TOT
54,Posthofbrug 5366,2020-02-13,03:00:00,4,0,4,FMN GV 16 Berchem TOT
54,Posthofbrug 5366,2020-02-13,04:00:00,9,6,3,FMN GV 16 Berchem TOT
54,Posthofbrug 5366,2020-02-13,05:00:00,15,14,1,FMN GV 16 Berchem TOT
54,Posthofbrug 5366,2020-02-13,06:00:00,86,74,12,FMN GV 16 Berchem TOT
54,Posthofbrug 5366,2020-02-13,07:00:00,286,229,57,FMN GV 16 Berchem TOT
54,Posthofbrug 5366,2020-02-13,08:00:00,424,328,96,FMN GV 16 Berchem TOT
54,Posthofbrug 5366,2020-02-13,09:00:00,122,87,35,FMN GV 16 Berchem TOT
54,Posthofbrug 5366,2020-02-13,10:00:00,39,25,14,FMN GV 16 Berchem TOT
54,Posthofbrug 5366,2020-02-13,11:00:00,48,34,14,FMN GV 16 Berchem TOT
54,Posthofbrug 5366,2020-02-13,12:00:00,69,36,33,FMN GV 16 Berchem TOT
54,Posthofbrug 5366,2020-02-13,13:00:00,77,48,29,FMN GV 16 Berchem TOT
54,Posthofbrug 5366,2020-02-13,14:00:00,79,46,33,FMN GV 16 Berchem TOT
54,Posthofbrug 5366,2020-02-13,15:00:00,125,59,66,FMN GV 16 Berchem TOT
54,Posthofbrug 5366,2020-02-13,16:00:00,234,102,132,FMN GV 16 Berchem TOT
54,Posthofbrug 5366,2020-02-13,17:00:00,280,127,153,FMN GV 16 Berchem TOT
54,Posthofbrug 5366,2020-02-13,18:00:00,187,66,121,FMN GV 16 Berchem TOT
54,Posthofbrug 5366,2020-02-13,19:00:00,92,31,61,FMN GV 16 Berchem TOT
54,Posthofbrug 5366,2020-02-13,20:00:00,60,32,28,FMN GV 16 Berchem TOT
54,Posthofbrug 5366,2020-02-13,21:00:00,42,14,28,FMN GV 16 Berchem TOT
54,Posthofbrug 5366,2020-02-13,22:00:00,40,17,23,FMN GV 16 Berchem TOT
54,Posthofbrug 5366,2020-02-13,23:00:00,33,7,26,FMN GV 16 Berchem TOT
54,Posthofbrug 5366,2020-02-14,00:00:00,14,5,9,FMN GV 16 Berchem TOT
54,Posthofbrug 5366,2020-02-14,01:00:00,11,1,10,FMN GV 16 Berchem TOT
54,Posthofbrug 5366,2020-02-14,02:00:00,7,2,5,FMN GV 16 Berchem TOT
54,Posthofbrug 5366,2020-02-14,03:00:00,5,0,5,FMN GV 16 Berchem TOT
54,Posthofbrug 5366,2020-02-14,04:00:00,7,5,2,FMN GV 16 Berchem TOT
54,Posthofbrug 5366,2020-02-14,05:00:00,20,13,7,FMN GV 16 Berchem TOT
54,Posthofbrug 5366,2020-02-14,06:00:00,62,52,10,FMN GV 16 Berchem TOT
54,Posthofbrug 5366,2020-02-14,07:00:00,305,235,70,FMN GV 16 Berchem TOT
54,Posthofbrug 5366,2020-02-14,08:00:00,498,376,122,FMN GV 16 Berchem TOT
54,Posthofbrug 5366,2020-02-14,09:00:00,186,139,47,FMN GV 16 Berchem TOT
54,Posthofbrug 5366,2020-02-14,10:00:00,85,58,27,FMN GV 16 Berchem TOT
54,Posthofbrug 5366,2020-02-14,11:00:00,91,69,22,FMN GV 16 Berchem TOT
54,Posthofbrug 5366,2020-02-14,12:00:00,116,60,56,FMN GV 16 Berchem TOT
54,Posthofbrug 5366,2020-02-14,13:00:00,116,69,47,FMN GV 16 Berchem TOT
54,Posthofbrug 5366,2020-02-14,14:00:00,105,38,67,FMN GV 16 Berchem TOT
54,Posthofbrug 5366,2020-02-14,15:00:00,203,94,109,FMN GV 16 Berchem TOT
54,Posthofbrug 5366,2020-02-14,16:00:00,336,152,184,FMN GV 16 Berchem TOT
54,Posthofbrug 5366,2020-02-14,17:00:00,344,127,217,FMN GV 16 Berchem TOT
54,Posthofbrug 5366,2020-02-14,18:00:00,234,103,131,FMN GV 16 Berchem TOT
54,Posthofbrug 5366,2020-02-14,19:00:00,110,55,55,FMN GV 16 Berchem TOT
54,Posthofbrug 5366,2020-02-14,20:00:00,50,28,22,FMN GV 16 Berchem TOT
54,Posthofbrug 5366,2020-02-14,21:00:00,36,14,22,FMN GV 16 Berchem TOT
54,Posthofbrug 5366,2020-02-14,22:00:00,47,22,25,FMN GV 16 Berchem TOT
54,Posthofbrug 5366,2020-02-14,23:00:00,40,15,25,FMN GV 16 Berchem TOT
54,Posthofbrug 5366,2020-02-15,00:00:00,49,15,34,FMN GV 16 Berchem TOT
54,Posthofbrug 5366,2020-02-15,01:00:00,24,7,17,FMN GV 16 Berchem TOT
54,Posthofbrug 5366,2020-02-15,02:00:00,19,5,14,FMN GV 16 Berchem TOT
54,Posthofbrug 5366,2020-02-15,03:00:00,7,2,5,FMN GV 16 Berchem TOT
54,Posthofbrug 5366,2020-02-15,04:00:00,14,8,6,FMN GV 16 Berchem TOT
54,Posthofbrug 5366,2020-02-15,05:00:00,4,3,1,FMN GV 16 Berchem TOT
54,Posthofbrug 5366,2020-02-15,06:00:00,15,9,6,FMN GV 16 Berchem TOT
54,Posthofbrug 5366,2020-02-15,07:00:00,27,18,9,FMN GV 16 Berchem TOT
54,Posthofbrug 5366,2020-02-15,08:00:00,44,26,18,FMN GV 16 Berchem TOT
54,Posthofbrug 5366,2020-02-15,09:00:00,75,57,18,FMN GV 16 Berchem TOT
54,Posthofbrug 5366,2020-02-15,10:00:00,97,65,32,FMN GV 16 Berchem TOT
54,Posthofbrug 5366,2020-02-15,11:00:00,74,52,22,FMN GV 16 Berchem TOT
54,Posthofbrug 5366,2020-02-15,12:00:00,110,66,44,FMN GV 16 Berchem TOT
54,Posthofbrug 5366,2020-02-15,13:00:00,126,80,46,FMN GV 16 Berchem TOT
54,Posthofbrug 5366,2020-02-15,14:00:00,110,63,47,FMN GV 16 Berchem TOT
54,Posthofbrug 5366,2020-02-15,15:00:00,89,48,41,FMN GV 16 Berchem TOT
54,Posthofbrug 5366,2020-02-15,16:00:00,84,40,44,FMN GV 16 Berchem TOT
54,Posthofbrug 5366,2020-02-15,17:00:00,100,36,64,FMN GV 16 Berchem TOT
54,Posthofbrug 5366,2020-02-15,18:00:00,101,48,53,FMN GV 16 Berchem TOT
54,Posthofbrug 5366,2020-02-15,19:00:00,83,37,46,FMN GV 16 Berchem TOT
54,Posthofbrug 5366,2020-02-15,20:00:00,49,28,21,FMN GV 16 Berchem TOT
54,Posthofbrug 5366,2020-02-15,21:00:00,40,22,18,FMN GV 16 Berchem TOT
54,Posthofbrug 5366,2020-02-15,22:00:00,38,13,25,FMN GV 16 Berchem TOT
54,Posthofbrug 5366,2020-02-15,23:00:00,40,20,20,FMN GV 16 Berchem TOT
54,Posthofbrug 5366,2020-02-16,00:00:00,47,20,27,FMN GV 16 Berchem TOT
54,Posthofbrug 5366,2020-02-16,01:00:00,32,18,14,FMN GV 16 Berchem TOT
54,Posthofbrug 5366,2020-02-16,02:00:00,17,7,10,FMN GV 16 Berchem TOT
54,Posthofbrug 5366,2020-02-16,03:00:00,5,0,5,FMN GV 16 Berchem TOT
54,Posthofbrug 5366,2020-02-16,04:00:00,12,3,9,FMN GV 16 Berchem TOT
54,Posthofbrug 5366,2020-02-16,05:00:00,9,7,2,FMN GV 16 Berchem TOT
54,Posthofbrug 5366,2020-02-16,06:00:00,14,7,7,FMN GV 16 Berchem TOT
54,Posthofbrug 5366,2020-02-16,07:00:00,16,11,5,FMN GV 16 Berchem TOT
54,Posthofbrug 5366,2020-02-16,08:00:00,16,7,9,FMN GV 16 Berchem TOT
54,Posthofbrug 5366,2020-02-16,09:00:00,32,16,16,FMN GV 16 Berchem TOT
54,Posthofbrug 5366,2020-02-16,10:00:00,34,23,11,FMN GV 16 Berchem TOT
54,Posthofbrug 5366,2020-02-16,11:00:00,51,26,25,FMN GV 16 Berchem TOT
54,Posthofbrug 5366,2020-02-16,12:00:00,56,25,31,FMN GV 16 Berchem TOT
54,Posthofbrug 5366,2020-02-16,13:00:00,49,35,14,FMN GV 16 Berchem TOT
54,Posthofbrug 5366,2020-02-16,14:00:00,52,27,25,FMN GV 16 Berchem TOT
54,Posthofbrug 5366,2020-02-16,15:00:00,55,25,30,FMN GV 16 Berchem TOT
54,Posthofbrug 5366,2020-02-16,16:00:00,47,22,25,FMN GV 16 Berchem TOT
54,Posthofbrug 5366,2020-02-16,17:00:00,59,22,37,FMN GV 16 Berchem TOT
54,Posthofbrug 5366,2020-02-16,18:00:00,35,13,22,FMN GV 16 Berchem TOT
54,Posthofbrug 5366,2020-02-16,19:00:00,23,17,6,FMN GV 16 Berchem TOT
54,Posthofbrug 5366,2020-02-16,20:00:00,8,5,3,FMN GV 16 Berchem TOT
54,Posthofbrug 5366,2020-02-16,21:00:00,10,8,2,FMN GV 16 Berchem TOT
54,Posthofbrug 5366,2020-02-16,22:00:00,19,8,11,FMN GV 16 Berchem TOT
54,Posthofbrug 5366,2020-02-16,23:00:00,6,3,3,FMN GV 16 Berchem TOT
54,Posthofbrug 5366,2020-02-17,00:00:00,2,0,2,FMN GV 16 Berchem TOT
54,Posthofbrug 5366,2020-02-17,01:00:00,1,0,1,FMN GV 16 Berchem TOT
54,Posthofbrug 5366,2020-02-17,02:00:00,1,1,0,FMN GV 16 Berchem TOT
54,Posthofbrug 5366,2020-02-17,03:00:00,0,0,0,FMN GV 16 Berchem TOT
54,Posthofbrug 5366,2020-02-17,04:00:00,6,6,0,FMN GV 16 Berchem TOT
54,Posthofbrug 5366,2020-02-17,05:00:00,17,16,1,FMN GV 16 Berchem TOT
54,Posthofbrug 5366,2020-02-17,06:00:00,94,78,16,FMN GV 16 Berchem TOT
54,Posthofbrug 5366,2020-02-17,07:00:00,323,244,79,FMN GV 16 Berchem TOT
54,Posthofbrug 5366,2020-02-17,08:00:00,614,447,167,FMN GV 16 Berchem TOT
54,Posthofbrug 5366,2020-02-17,09:00:00,187,136,51,FMN GV 16 Berchem TOT
54,Posthofbrug 5366,2020-02-17,10:00:00,88,62,26,FMN GV 16 Berchem TOT
54,Posthofbrug 5366,2020-02-17,11:00:00,86,56,30,FMN GV 16 Berchem TOT
54,Posthofbrug 5366,2020-02-17,12:00:00,134,72,62,FMN GV 16 Berchem TOT
54,Posthofbrug 5366,2020-02-17,13:00:00,104,50,54,FMN GV 16 Berchem TOT
54,Posthofbrug 5366,2020-02-17,14:00:00,90,39,51,FMN GV 16 Berchem TOT
54,Posthofbrug 5366,2020-02-17,15:00:00,146,55,91,FMN GV 16 Berchem TOT
54,Posthofbrug 5366,2020-02-17,16:00:00,268,111,157,FMN GV 16 Berchem TOT
54,Posthofbrug 5366,2020-02-17,17:00:00,428,158,270,FMN GV 16 Berchem TOT
54,Posthofbrug 5366,2020-02-17,18:00:00,241,76,165,FMN GV 16 Berchem TOT
54,Posthofbrug 5366,2020-02-17,19:00:00,106,38,68,FMN GV 16 Berchem TOT
54,Posthofbrug 5366,2020-02-17,20:00:00,53,27,26,FMN GV 16 Berchem TOT
54,Posthofbrug 5366,2020-02-17,21:00:00,34,11,23,FMN GV 16 Berchem TOT
54,Posthofbrug 5366,2020-02-17,22:00:00,41,12,29,FMN GV 16 Berchem TOT
54,Posthofbrug 5366,2020-02-17,23:00:00,24,9,15,FMN GV 16 Berchem TOT
54,Posthofbrug 5366,2020-02-18,00:00:00,8,2,6,FMN GV 16 Berchem TOT
54,Posthofbrug 5366,2020-02-18,01:00:00,2,0,2,FMN GV 16 Berchem TOT
54,Posthofbrug 5366,2020-02-18,02:00:00,0,0,0,FMN GV 16 Berchem TOT
54,Posthofbrug 5366,2020-02-18,03:00:00,3,0,3,FMN GV 16 Berchem TOT
54,Posthofbrug 5366,2020-02-18,04:00:00,4,3,1,FMN GV 16 Berchem TOT
54,Posthofbrug 5366,2020-02-18,05:00:00,19,18,1,FMN GV 16 Berchem TOT
54,Posthofbrug 5366,2020-02-18,06:00:00,105,88,17,FMN GV 16 Berchem TOT
54,Posthofbrug 5366,2020-02-18,07:00:00,353,270,83,FMN GV 16 Berchem TOT
54,Posthofbrug 5366,2020-02-18,08:00:00,626,444,182,FMN GV 16 Berchem TOT
54,Posthofbrug 5366,2020-02-18,09:00:00,205,139,66,FMN GV 16 Berchem TOT
54,Posthofbrug 5366,2020-02-18,10:00:00,73,53,20,FMN GV 16 Berchem TOT
54,Posthofbrug 5366,2020-02-18,11:00:00,57,42,15,FMN GV 16 Berchem TOT
54,Posthofbrug 5366,2020-02-18,12:00:00,134,84,50,FMN GV 16 Berchem TOT
54,Posthofbrug 5366,2020-02-18,13:00:00,112,47,65,FMN GV 16 Berchem TOT
54,Posthofbrug 5366,2020-02-18,14:00:00,73,34,39,FMN GV 16 Berchem TOT
54,Posthofbrug 5366,2020-02-18,15:00:00,145,57,88,FMN GV 16 Berchem TOT
54,Posthofbrug 5366,2020-02-18,16:00:00,372,134,238,FMN GV 16 Berchem TOT
54,Posthofbrug 5366,2020-02-18,17:00:00,440,179,261,FMN GV 16 Berchem TOT
54,Posthofbrug 5366,2020-02-18,18:00:00,296,112,184,FMN GV 16 Berchem TOT
54,Posthofbrug 5366,2020-02-18,19:00:00,137,52,85,FMN GV 16 Berchem TOT
54,Posthofbrug 5366,2020-02-18,20:00:00,51,19,32,FMN GV 16 Berchem TOT
54,Posthofbrug 5366,2020-02-18,21:00:00,63,29,34,FMN GV 16 Berchem TOT
54,Posthofbrug 5366,2020-02-18,22:00:00,50,16,34,FMN GV 16 Berchem TOT
54,Posthofbrug 5366,2020-02-18,23:00:00,28,8,20,FMN GV 16 Berchem TOT
54,Posthofbrug 5366,2020-02-19,00:00:00,6,2,4,FMN GV 16 Berchem TOT
54,Posthofbrug 5366,2020-02-19,01:00:00,7,4,3,FMN GV 16 Berchem TOT
54,Posthofbrug 5366,2020-02-19,02:00:00,2,0,2,FMN GV 16 Berchem TOT
54,Posthofbrug 5366,2020-02-19,03:00:00,1,1,0,FMN GV 16 Berchem TOT
54,Posthofbrug 5366,2020-02-19,04:00:00,5,4,1,FMN GV 16 Berchem TOT
54,Posthofbrug 5366,2020-02-19,05:00:00,9,9,0,FMN GV 16 Berchem TOT
54,Posthofbrug 5366,2020-02-19,06:00:00,84,67,17,FMN GV 16 Berchem TOT
54,Posthofbrug 5366,2020-02-19,07:00:00,307,246,61,FMN GV 16 Berchem TOT
54,Posthofbrug 5366,2020-02-19,08:00:00,543,384,159,FMN GV 16 Berchem TOT
54,Posthofbrug 5366,2020-02-19,09:00:00,171,119,52,FMN GV 16 Berchem TOT
54,Posthofbrug 5366,2020-02-19,10:00:00,57,46,11,FMN GV 16 Berchem TOT
54,Posthofbrug 5366,2020-02-19,11:00:00,85,54,31,FMN GV 16 Berchem TOT
54,Posthofbrug 5366,2020-02-19,12:00:00,221,106,115,FMN GV 16 Berchem TOT
54,Posthofbrug 5366,2020-02-19,13:00:00,145,67,78,FMN GV 16 Berchem TOT
54,Posthofbrug 5366,2020-02-19,14:00:00,92,31,61,FMN GV 16 Berchem TOT
54,Posthofbrug 5366,2020-02-19,15:00:00,109,56,53,FMN GV 16 Berchem TOT
54,Posthofbrug 5366,2020-02-19,16:00:00,253,104,149,FMN GV 16 Berchem TOT
54,Posthofbrug 5366,2020-02-19,17:00:00,394,159,235,FMN GV 16 Berchem TOT
54,Posthofbrug 5366,2020-02-19,18:00:00,277,109,168,FMN GV 16 Berchem TOT
54,Posthofbrug 5366,2020-02-19,19:00:00,111,43,68,FMN GV 16 Berchem TOT
54,Posthofbrug 5366,2020-02-19,20:00:00,56,28,28,FMN GV 16 Berchem TOT
54,Posthofbrug 5366,2020-02-19,21:00:00,48,22,26,FMN GV 16 Berchem TOT
54,Posthofbrug 5366,2020-02-19,22:00:00,50,14,36,FMN GV 16 Berchem TOT
54,Posthofbrug 5366,2020-02-19,23:00:00,35,12,23,FMN GV 16 Berchem TOT
54,Posthofbrug 5366,2020-02-20,00:00:00,12,6,6,FMN GV 16 Berchem TOT
54,Posthofbrug 5366,2020-02-20,01:00:00,3,0,3,FMN GV 16 Berchem TOT
54,Posthofbrug 5366,2020-02-20,02:00:00,3,0,3,FMN GV 16 Berchem TOT
54,Posthofbrug 5366,2020-02-20,03:00:00,3,0,3,FMN GV 16 Berchem TOT
54,Posthofbrug 5366,2020-02-20,04:00:00,10,3,7,FMN GV 16 Berchem TOT
54,Posthofbrug 5366,2020-02-20,05:00:00,15,10,5,FMN GV 16 Berchem TOT
54,Posthofbrug 5366,2020-02-20,06:00:00,105,86,19,FMN GV 16 Berchem TOT
54,Posthofbrug 5366,2020-02-20,07:00:00,313,240,73,FMN GV 16 Berchem TOT
54,Posthofbrug 5366,2020-02-20,08:00:00,571,424,147,FMN GV 16 Berchem TOT
54,Posthofbrug 5366,2020-02-20,09:00:00,197,143,54,FMN GV 16 Berchem TOT
54,Posthofbrug 5366,2020-02-20,10:00:00,113,71,42,FMN GV 16 Berchem TOT
54,Posthofbrug 5366,2020-02-20,11:00:00,84,64,20,FMN GV 16 Berchem TOT
54,Posthofbrug 5366,2020-02-20,12:00:00,126,72,54,FMN GV 16 Berchem TOT
54,Posthofbrug 5366,2020-02-20,13:00:00,90,44,46,FMN GV 16 Berchem TOT
54,Posthofbrug 5366,2020-02-20,14:00:00,82,34,48,FMN GV 16 Berchem TOT
54,Posthofbrug 5366,2020-02-20,15:00:00,171,69,102,FMN GV 16 Berchem TOT
54,Posthofbrug 5366,2020-02-20,16:00:00,311,119,192,FMN GV 16 Berchem TOT
54,Posthofbrug 5366,2020-02-20,17:00:00,422,163,259,FMN GV 16 Berchem TOT
54,Posthofbrug 5366,2020-02-20,18:00:00,235,84,151,FMN GV 16 Berchem TOT
54,Posthofbrug 5366,2020-02-20,19:00:00,105,44,61,FMN GV 16 Berchem TOT
54,Posthofbrug 5366,2020-02-20,20:00:00,62,28,34,FMN GV 16 Berchem TOT
54,Posthofbrug 5366,2020-02-20,21:00:00,38,14,24,FMN GV 16 Berchem TOT
54,Posthofbrug 5366,2020-02-20,22:00:00,49,8,41,FMN GV 16 Berchem TOT
54,Posthofbrug 5366,2020-02-20,23:00:00,22,0,22,FMN GV 16 Berchem TOT
54,Posthofbrug 5366,2020-02-21,00:00:00,12,6,6,FMN GV 16 Berchem TOT
54,Posthofbrug 5366,2020-02-21,01:00:00,4,1,3,FMN GV 16 Berchem TOT
54,Posthofbrug 5366,2020-02-21,02:00:00,4,2,2,FMN GV 16 Berchem TOT
54,Posthofbrug 5366,2020-02-21,03:00:00,2,0,2,FMN GV 16 Berchem TOT
54,Posthofbrug 5366,2020-02-21,04:00:00,8,6,2,FMN GV 16 Berchem TOT
54,Posthofbrug 5366,2020-02-21,05:00:00,11,8,3,FMN GV 16 Berchem TOT
54,Posthofbrug 5366,2020-02-21,06:00:00,77,64,13,FMN GV 16 Berchem TOT
54,Posthofbrug 5366,2020-02-21,07:00:00,272,217,55,FMN GV 16 Berchem TOT
54,Posthofbrug 5366,2020-02-21,08:00:00,493,377,116,FMN GV 16 Berchem TOT
54,Posthofbrug 5366,2020-02-21,09:00:00,184,135,49,FMN GV 16 Berchem TOT
54,Posthofbrug 5366,2020-02-21,10:00:00,91,62,29,FMN GV 16 Berchem TOT
54,Posthofbrug 5366,2020-02-21,11:00:00,77,45,32,FMN GV 16 Berchem TOT
54,Posthofbrug 5366,2020-02-21,12:00:00,112,57,55,FMN GV 16 Berchem TOT
54,Posthofbrug 5366,2020-02-21,13:00:00,139,74,65,FMN GV 16 Berchem TOT
54,Posthofbrug 5366,2020-02-21,14:00:00,116,52,64,FMN GV 16 Berchem TOT
54,Posthofbrug 5366,2020-02-21,15:00:00,191,79,112,FMN GV 16 Berchem TOT
54,Posthofbrug 5366,2020-02-21,16:00:00,307,128,179,FMN GV 16 Berchem TOT
54,Posthofbrug 5366,2020-02-21,17:00:00,360,139,221,FMN GV 16 Berchem TOT
54,Posthofbrug 5366,2020-02-21,18:00:00,192,96,96,FMN GV 16 Berchem TOT
54,Posthofbrug 5366,2020-02-21,19:00:00,118,64,54,FMN GV 16 Berchem TOT
54,Posthofbrug 5366,2020-02-21,20:00:00,53,30,23,FMN GV 16 Berchem TOT
54,Posthofbrug 5366,2020-02-21,21:00:00,43,20,23,FMN GV 16 Berchem TOT
54,Posthofbrug 5366,2020-02-21,22:00:00,56,24,32,FMN GV 16 Berchem TOT
54,Posthofbrug 5366,2020-02-21,23:00:00,48,10,38,FMN GV 16 Berchem TOT
54,Posthofbrug 5366,2020-02-22,00:00:00,34,10,24,FMN GV 16 Berchem TOT
54,Posthofbrug 5366,2020-02-22,01:00:00,24,5,19,FMN GV 16 Berchem TOT
54,Posthofbrug 5366,2020-02-22,02:00:00,17,3,14,FMN GV 16 Berchem TOT
54,Posthofbrug 5366,2020-02-22,03:00:00,17,2,15,FMN GV 16 Berchem TOT
54,Posthofbrug 5366,2020-02-22,04:00:00,8,2,6,FMN GV 16 Berchem TOT
54,Posthofbrug 5366,2020-02-22,05:00:00,7,2,5,FMN GV 16 Berchem TOT
54,Posthofbrug 5366,2020-02-22,06:00:00,14,9,5,FMN GV 16 Berchem TOT
54,Posthofbrug 5366,2020-02-22,07:00:00,13,9,4,FMN GV 16 Berchem TOT
54,Posthofbrug 5366,2020-02-22,08:00:00,38,22,16,FMN GV 16 Berchem TOT
54,Posthofbrug 5366,2020-02-22,09:00:00,60,40,20,FMN GV 16 Berchem TOT
54,Posthofbrug 5366,2020-02-22,10:00:00,68,49,19,FMN GV 16 Berchem TOT
54,Posthofbrug 5366,2020-02-22,11:00:00,71,42,29,FMN GV 16 Berchem TOT
54,Posthofbrug 5366,2020-02-22,12:00:00,72,41,31,FMN GV 16 Berchem TOT
54,Posthofbrug 5366,2020-02-22,13:00:00,64,41,23,FMN GV 16 Berchem TOT
54,Posthofbrug 5366,2020-02-22,14:00:00,65,39,26,FMN GV 16 Berchem TOT
54,Posthofbrug 5366,2020-02-22,15:00:00,39,26,13,FMN GV 16 Berchem TOT
54,Posthofbrug 5366,2020-02-22,16:00:00,46,23,23,FMN GV 16 Berchem TOT
54,Posthofbrug 5366,2020-02-22,17:00:00,61,33,28,FMN GV 16 Berchem TOT
54,Posthofbrug 5366,2020-02-22,18:00:00,53,26,27,FMN GV 16 Berchem TOT
54,Posthofbrug 5366,2020-02-22,19:00:00,53,28,25,FMN GV 16 Berchem TOT
54,Posthofbrug 5366,2020-02-22,20:00:00,33,20,13,FMN GV 16 Berchem TOT
54,Posthofbrug 5366,2020-02-22,21:00:00,34,22,12,FMN GV 16 Berchem TOT
54,Posthofbrug 5366,2020-02-22,22:00:00,39,22,17,FMN GV 16 Berchem TOT
54,Posthofbrug 5366,2020-02-22,23:00:00,27,13,14,FMN GV 16 Berchem TOT
54,Posthofbrug 5366,2020-02-23,00:00:00,35,20,15,FMN GV 16 Berchem TOT
54,Posthofbrug 5366,2020-02-23,01:00:00,14,4,10,FMN GV 16 Berchem TOT
54,Posthofbrug 5366,2020-02-23,02:00:00,8,2,6,FMN GV 16 Berchem TOT
54,Posthofbrug 5366,2020-02-23,03:00:00,9,0,9,FMN GV 16 Berchem TOT
54,Posthofbrug 5366,2020-02-23,04:00:00,6,0,6,FMN GV 16 Berchem TOT
54,Posthofbrug 5366,2020-02-23,05:00:00,4,2,2,FMN GV 16 Berchem TOT
54,Posthofbrug 5366,2020-02-23,06:00:00,11,6,5,FMN GV 16 Berchem TOT
54,Posthofbrug 5366,2020-02-23,07:00:00,9,6,3,FMN GV 16 Berchem TOT
54,Posthofbrug 5366,2020-02-23,08:00:00,10,7,3,FMN GV 16 Berchem TOT
54,Posthofbrug 5366,2020-02-23,09:00:00,35,21,14,FMN GV 16 Berchem TOT
54,Posthofbrug 5366,2020-02-23,10:00:00,19,14,5,FMN GV 16 Berchem TOT
54,Posthofbrug 5366,2020-02-23,11:00:00,31,23,8,FMN GV 16 Berchem TOT
54,Posthofbrug 5366,2020-02-23,12:00:00,27,13,14,FMN GV 16 Berchem TOT
54,Posthofbrug 5366,2020-02-23,13:00:00,24,16,8,FMN GV 16 Berchem TOT
54,Posthofbrug 5366,2020-02-23,14:00:00,35,25,10,FMN GV 16 Berchem TOT
54,Posthofbrug 5366,2020-02-23,15:00:00,28,12,16,FMN GV 16 Berchem TOT
54,Posthofbrug 5366,2020-02-23,16:00:00,25,12,13,FMN GV 16 Berchem TOT
54,Posthofbrug 5366,2020-02-23,17:00:00,36,12,24,FMN GV 16 Berchem TOT
54,Posthofbrug 5366,2020-02-23,18:00:00,44,19,25,FMN GV 16 Berchem TOT
54,Posthofbrug 5366,2020-02-23,19:00:00,31,19,12,FMN GV 16 Berchem TOT
54,Posthofbrug 5366,2020-02-23,20:00:00,15,4,11,FMN GV 16 Berchem TOT
54,Posthofbrug 5366,2020-02-23,21:00:00,26,17,9,FMN GV 16 Berchem TOT
54,Posthofbrug 5366,2020-02-23,22:00:00,20,10,10,FMN GV 16 Berchem TOT
54,Posthofbrug 5366,2020-02-23,23:00:00,5,0,5,FMN GV 16 Berchem TOT
54,Posthofbrug 5366,2020-02-24,00:00:00,5,1,4,FMN GV 16 Berchem TOT
54,Posthofbrug 5366,2020-02-24,01:00:00,6,1,5,FMN GV 16 Berchem TOT
54,Posthofbrug 5366,2020-02-24,02:00:00,3,0,3,FMN GV 16 Berchem TOT
54,Posthofbrug 5366,2020-02-24,03:00:00,1,1,0,FMN GV 16 Berchem TOT
54,Posthofbrug 5366,2020-02-24,04:00:00,6,5,1,FMN GV 16 Berchem TOT
54,Posthofbrug 5366,2020-02-24,05:00:00,9,9,0,FMN GV 16 Berchem TOT
54,Posthofbrug 5366,2020-02-24,06:00:00,79,66,13,FMN GV 16 Berchem TOT
54,Posthofbrug 5366,2020-02-24,07:00:00,207,151,56,FMN GV 16 Berchem TOT
54,Posthofbrug 5366,2020-02-24,08:00:00,311,202,109,FMN GV 16 Berchem TOT
54,Posthofbrug 5366,2020-02-24,09:00:00,145,101,44,FMN GV 16 Berchem TOT
54,Posthofbrug 5366,2020-02-24,10:00:00,70,51,19,FMN GV 16 Berchem TOT
54,Posthofbrug 5366,2020-02-24,11:00:00,40,23,17,FMN GV 16 Berchem TOT
54,Posthofbrug 5366,2020-02-24,12:00:00,59,35,24,FMN GV 16 Berchem TOT
54,Posthofbrug 5366,2020-02-24,13:00:00,51,25,26,FMN GV 16 Berchem TOT
54,Posthofbrug 5366,2020-02-24,14:00:00,47,21,26,FMN GV 16 Berchem TOT
54,Posthofbrug 5366,2020-02-24,15:00:00,92,41,51,FMN GV 16 Berchem TOT
54,Posthofbrug 5366,2020-02-24,16:00:00,179,88,91,FMN GV 16 Berchem TOT
54,Posthofbrug 5366,2020-02-24,17:00:00,256,106,150,FMN GV 16 Berchem TOT
54,Posthofbrug 5366,2020-02-24,18:00:00,166,61,105,FMN GV 16 Berchem TOT
54,Posthofbrug 5366,2020-02-24,19:00:00,83,36,47,FMN GV 16 Berchem TOT
54,Posthofbrug 5366,2020-02-24,20:00:00,47,23,24,FMN GV 16 Berchem TOT
54,Posthofbrug 5366,2020-02-24,21:00:00,29,14,15,FMN GV 16 Berchem TOT
54,Posthofbrug 5366,2020-02-24,22:00:00,38,11,27,FMN GV 16 Berchem TOT
54,Posthofbrug 5366,2020-02-24,23:00:00,11,7,4,FMN GV 16 Berchem TOT
54,Posthofbrug 5366,2020-02-25,00:00:00,7,1,6,FMN GV 16 Berchem TOT
54,Posthofbrug 5366,2020-02-25,01:00:00,3,1,2,FMN GV 16 Berchem TOT
54,Posthofbrug 5366,2020-02-25,02:00:00,3,0,3,FMN GV 16 Berchem TOT
54,Posthofbrug 5366,2020-02-25,03:00:00,2,1,1,FMN GV 16 Berchem TOT
54,Posthofbrug 5366,2020-02-25,04:00:00,8,7,1,FMN GV 16 Berchem TOT
54,Posthofbrug 5366,2020-02-25,05:00:00,11,11,0,FMN GV 16 Berchem TOT
54,Posthofbrug 5366,2020-02-25,06:00:00,97,77,20,FMN GV 16 Berchem TOT
54,Posthofbrug 5366,2020-02-25,07:00:00,232,164,68,FMN GV 16 Berchem TOT
54,Posthofbrug 5366,2020-02-25,08:00:00,391,258,133,FMN GV 16 Berchem TOT
54,Posthofbrug 5366,2020-02-25,09:00:00,181,128,53,FMN GV 16 Berchem TOT
54,Posthofbrug 5366,2020-02-25,10:00:00,83,53,30,FMN GV 16 Berchem TOT
54,Posthofbrug 5366,2020-02-25,11:00:00,81,51,30,FMN GV 16 Berchem TOT
54,Posthofbrug 5366,2020-02-25,12:00:00,86,58,28,FMN GV 16 Berchem TOT
54,Posthofbrug 5366,2020-02-25,13:00:00,92,56,36,FMN GV 16 Berchem TOT
54,Posthofbrug 5366,2020-02-25,14:00:00,68,39,29,FMN GV 16 Berchem TOT
54,Posthofbrug 5366,2020-02-25,15:00:00,109,47,62,FMN GV 16 Berchem TOT
54,Posthofbrug 5366,2020-02-25,16:00:00,199,85,114,FMN GV 16 Berchem TOT
54,Posthofbrug 5366,2020-02-25,17:00:00,286,120,166,FMN GV 16 Berchem TOT
54,Posthofbrug 5366,2020-02-25,18:00:00,219,78,141,FMN GV 16 Berchem TOT
54,Posthofbrug 5366,2020-02-25,19:00:00,99,34,65,FMN GV 16 Berchem TOT
54,Posthofbrug 5366,2020-02-25,20:00:00,50,20,30,FMN GV 16 Berchem TOT
54,Posthofbrug 5366,2020-02-25,21:00:00,29,13,16,FMN GV 16 Berchem TOT
54,Posthofbrug 5366,2020-02-25,22:00:00,27,9,18,FMN GV 16 Berchem TOT
54,Posthofbrug 5366,2020-02-25,23:00:00,22,5,17,FMN GV 16 Berchem TOT
54,Posthofbrug 5366,2020-02-26,00:00:00,17,5,12,FMN GV 16 Berchem TOT
54,Posthofbrug 5366,2020-02-26,01:00:00,5,2,3,FMN GV 16 Berchem TOT
54,Posthofbrug 5366,2020-02-26,02:00:00,4,1,3,FMN GV 16 Berchem TOT
54,Posthofbrug 5366,2020-02-26,03:00:00,1,1,0,FMN GV 16 Berchem TOT
54,Posthofbrug 5366,2020-02-26,04:00:00,6,5,1,FMN GV 16 Berchem TOT
54,Posthofbrug 5366,2020-02-26,05:00:00,12,10,2,FMN GV 16 Berchem TOT
54,Posthofbrug 5366,2020-02-26,06:00:00,62,49,13,FMN GV 16 Berchem TOT
54,Posthofbrug 5366,2020-02-26,07:00:00,179,144,35,FMN GV 16 Berchem TOT
54,Posthofbrug 5366,2020-02-26,08:00:00,292,190,102,FMN GV 16 Berchem TOT
54,Posthofbrug 5366,2020-02-26,09:00:00,137,89,48,FMN GV 16 Berchem TOT
54,Posthofbrug 5366,2020-02-26,10:00:00,44,29,15,FMN GV 16 Berchem TOT
54,Posthofbrug 5366,2020-02-26,11:00:00,47,34,13,FMN GV 16 Berchem TOT
54,Posthofbrug 5366,2020-02-26,12:00:00,61,32,29,FMN GV 16 Berchem TOT
54,Posthofbrug 5366,2020-02-26,13:00:00,56,31,25,FMN GV 16 Berchem TOT
54,Posthofbrug 5366,2020-02-26,14:00:00,45,27,18,FMN GV 16 Berchem TOT
54,Posthofbrug 5366,2020-02-26,15:00:00,97,44,53,FMN GV 16 Berchem TOT
54,Posthofbrug 5366,2020-02-26,16:00:00,158,82,76,FMN GV 16 Berchem TOT
54,Posthofbrug 5366,2020-02-26,17:00:00,264,112,152,FMN GV 16 Berchem TOT
54,Posthofbrug 5366,2020-02-26,18:00:00,156,70,86,FMN GV 16 Berchem TOT
54,Posthofbrug 5366,2020-02-26,19:00:00,59,23,36,FMN GV 16 Berchem TOT
54,Posthofbrug 5366,2020-02-26,20:00:00,31,12,19,FMN GV 16 Berchem TOT
54,Posthofbrug 5366,2020-02-26,21:00:00,17,8,9,FMN GV 16 Berchem TOT
54,Posthofbrug 5366,2020-02-26,22:00:00,17,1,16,FMN GV 16 Berchem TOT
54,Posthofbrug 5366,2020-02-26,23:00:00,27,13,14,FMN GV 16 Berchem TOT
54,Posthofbrug 5366,2020-02-27,00:00:00,17,8,9,FMN GV 16 Berchem TOT
54,Posthofbrug 5366,2020-02-27,01:00:00,7,2,5,FMN GV 16 Berchem TOT
54,Posthofbrug 5366,2020-02-27,02:00:00,13,6,7,FMN GV 16 Berchem TOT
54,Posthofbrug 5366,2020-02-27,03:00:00,7,3,4,FMN GV 16 Berchem TOT
54,Posthofbrug 5366,2020-02-27,04:00:00,8,3,5,FMN GV 16 Berchem TOT
54,Posthofbrug 5366,2020-02-27,05:00:00,8,7,1,FMN GV 16 Berchem TOT
54,Posthofbrug 5366,2020-02-27,06:00:00,60,50,10,FMN GV 16 Berchem TOT
54,Posthofbrug 5366,2020-02-27,07:00:00,194,148,46,FMN GV 16 Berchem TOT
54,Posthofbrug 5366,2020-02-27,08:00:00,325,198,127,FMN GV 16 Berchem TOT
54,Posthofbrug 5366,2020-02-27,09:00:00,129,88,41,FMN GV 16 Berchem TOT
54,Posthofbrug 5366,2020-02-27,10:00:00,50,38,12,FMN GV 16 Berchem TOT
54,Posthofbrug 5366,2020-02-27,11:00:00,32,21,11,FMN GV 16 Berchem TOT
54,Posthofbrug 5366,2020-02-27,12:00:00,41,23,18,FMN GV 16 Berchem TOT
54,Posthofbrug 5366,2020-02-27,13:00:00,42,26,16,FMN GV 16 Berchem TOT
54,Posthofbrug 5366,2020-02-27,14:00:00,35,19,16,FMN GV 16 Berchem TOT
54,Posthofbrug 5366,2020-02-27,15:00:00,56,24,32,FMN GV 16 Berchem TOT
54,Posthofbrug 5366,2020-02-27,16:00:00,156,77,79,FMN GV 16 Berchem TOT
54,Posthofbrug 5366,2020-02-27,17:00:00,246,108,138,FMN GV 16 Berchem TOT
54,Posthofbrug 5366,2020-02-27,18:00:00,163,62,101,FMN GV 16 Berchem TOT
54,Posthofbrug 5366,2020-02-27,19:00:00,76,23,53,FMN GV 16 Berchem TOT
54,Posthofbrug 5366,2020-02-27,20:00:00,37,19,18,FMN GV 16 Berchem TOT
54,Posthofbrug 5366,2020-02-27,21:00:00,30,15,15,FMN GV 16 Berchem TOT
54,Posthofbrug 5366,2020-02-27,22:00:00,25,11,14,FMN GV 16 Berchem TOT
54,Posthofbrug 5366,2020-02-27,23:00:00,19,5,14,FMN GV 16 Berchem TOT
54,Posthofbrug 5366,2020-02-28,00:00:00,11,3,8,FMN GV 16 Berchem TOT
54,Posthofbrug 5366,2020-02-28,01:00:00,8,1,7,FMN GV 16 Berchem TOT
54,Posthofbrug 5366,2020-02-28,02:00:00,2,2,0,FMN GV 16 Berchem TOT
54,Posthofbrug 5366,2020-02-28,03:00:00,0,0,0,FMN GV 16 Berchem TOT
54,Posthofbrug 5366,2020-02-28,04:00:00,6,2,4,FMN GV 16 Berchem TOT
54,Posthofbrug 5366,2020-02-28,05:00:00,10,6,4,FMN GV 16 Berchem TOT
54,Posthofbrug 5366,2020-02-28,06:00:00,38,33,5,FMN GV 16 Berchem TOT
54,Posthofbrug 5366,2020-02-28,07:00:00,108,81,27,FMN GV 16 Berchem TOT
54,Posthofbrug 5366,2020-02-28,08:00:00,215,135,80,FMN GV 16 Berchem TOT
54,Posthofbrug 5366,2020-02-28,09:00:00,124,82,42,FMN GV 16 Berchem TOT
54,Posthofbrug 5366,2020-02-28,10:00:00,69,41,28,FMN GV 16 Berchem TOT
54,Posthofbrug 5366,2020-02-28,11:00:00,67,49,18,FMN GV 16 Berchem TOT
54,Posthofbrug 5366,2020-02-28,12:00:00,94,54,40,FMN GV 16 Berchem TOT
54,Posthofbrug 5366,2020-02-28,13:00:00,78,36,42,FMN GV 16 Berchem TOT
54,Posthofbrug 5366,2020-02-28,14:00:00,83,41,42,FMN GV 16 Berchem TOT
54,Posthofbrug 5366,2020-02-28,15:00:00,98,42,56,FMN GV 16 Berchem TOT
54,Posthofbrug 5366,2020-02-28,16:00:00,172,75,97,FMN GV 16 Berchem TOT
54,Posthofbrug 5366,2020-02-28,17:00:00,206,90,116,FMN GV 16 Berchem TOT
54,Posthofbrug 5366,2020-02-28,18:00:00,138,64,74,FMN GV 16 Berchem TOT
54,Posthofbrug 5366,2020-02-28,19:00:00,65,23,42,FMN GV 16 Berchem TOT
54,Posthofbrug 5366,2020-02-28,20:00:00,38,17,21,FMN GV 16 Berchem TOT
54,Posthofbrug 5366,2020-02-28,21:00:00,31,13,18,FMN GV 16 Berchem TOT
54,Posthofbrug 5366,2020-02-28,22:00:00,28,11,17,FMN GV 16 Berchem TOT
54,Posthofbrug 5366,2020-02-28,23:00:00,32,11,21,FMN GV 16 Berchem TOT
54,Posthofbrug 5366,2020-02-29,00:00:00,12,5,7,FMN GV 16 Berchem TOT
54,Posthofbrug 5366,2020-02-29,01:00:00,15,4,11,FMN GV 16 Berchem TOT
54,Posthofbrug 5366,2020-02-29,02:00:00,25,7,18,FMN GV 16 Berchem TOT
54,Posthofbrug 5366,2020-02-29,03:00:00,13,2,11,FMN GV 16 Berchem TOT
54,Posthofbrug 5366,2020-02-29,04:00:00,13,3,10,FMN GV 16 Berchem TOT
54,Posthofbrug 5366,2020-02-29,05:00:00,6,2,4,FMN GV 16 Berchem TOT
54,Posthofbrug 5366,2020-02-29,06:00:00,10,7,3,FMN GV 16 Berchem TOT
54,Posthofbrug 5366,2020-02-29,07:00:00,11,9,2,FMN GV 16 Berchem TOT
54,Posthofbrug 5366,2020-02-29,08:00:00,31,23,8,FMN GV 16 Berchem TOT
54,Posthofbrug 5366,2020-02-29,09:00:00,38,26,12,FMN GV 16 Berchem TOT
54,Posthofbrug 5366,2020-02-29,10:00:00,68,47,21,FMN GV 16 Berchem TOT
54,Posthofbrug 5366,2020-02-29,11:00:00,68,41,27,FMN GV 16 Berchem TOT
54,Posthofbrug 5366,2020-02-29,12:00:00,58,35,23,FMN GV 16 Berchem TOT
54,Posthofbrug 5366,2020-02-29,13:00:00,54,26,28,FMN GV 16 Berchem TOT
54,Posthofbrug 5366,2020-02-29,14:00:00,35,23,12,FMN GV 16 Berchem TOT
54,Posthofbrug 5366,2020-02-29,15:00:00,39,21,18,FMN GV 16 Berchem TOT
54,Posthofbrug 5366,2020-02-29,16:00:00,45,17,28,FMN GV 16 Berchem TOT
54,Posthofbrug 5366,2020-02-29,17:00:00,62,31,31,FMN GV 16 Berchem TOT
54,Posthofbrug 5366,2020-02-29,18:00:00,65,35,30,FMN GV 16 Berchem TOT
54,Posthofbrug 5366,2020-02-29,19:00:00,30,21,9,FMN GV 16 Berchem TOT
54,Posthofbrug 5366,2020-02-29,20:00:00,41,28,13,FMN GV 16 Berchem TOT
54,Posthofbrug 5366,2020-02-29,21:00:00,20,12,8,FMN GV 16 Berchem TOT
54,Posthofbrug 5366,2020-02-29,22:00:00,30,13,17,FMN GV 16 Berchem TOT
54,Posthofbrug 5366,2020-02-29,23:00:00,25,10,15,FMN GV 16 Berchem TOT
54,Posthofbrug 5366,2020-03-01,00:00:00,37,10,27,FMN GV 16 Berchem TOT
54,Posthofbrug 5366,2020-03-01,01:00:00,14,6,8,FMN GV 16 Berchem TOT
54,Posthofbrug 5366,2020-03-01,02:00:00,16,2,14,FMN GV 16 Berchem TOT
54,Posthofbrug 5366,2020-03-01,03:00:00,13,3,10,FMN GV 16 Berchem TOT
54,Posthofbrug 5366,2020-03-01,04:00:00,9,1,8,FMN GV 16 Berchem TOT
54,Posthofbrug 5366,2020-03-01,05:00:00,9,4,5,FMN GV 16 Berchem TOT
54,Posthofbrug 5366,2020-03-01,06:00:00,12,6,6,FMN GV 16 Berchem TOT
54,Posthofbrug 5366,2020-03-01,07:00:00,10,8,2,FMN GV 16 Berchem TOT
54,Posthofbrug 5366,2020-03-01,08:00:00,28,11,17,FMN GV 16 Berchem TOT
54,Posthofbrug 5366,2020-03-01,09:00:00,33,16,17,FMN GV 16 Berchem TOT
54,Posthofbrug 5366,2020-03-01,10:00:00,63,53,10,FMN GV 16 Berchem TOT
54,Posthofbrug 5366,2020-03-01,11:00:00,54,27,27,FMN GV 16 Berchem TOT
54,Posthofbrug 5366,2020-03-01,12:00:00,69,39,30,FMN GV 16 Berchem TOT
54,Posthofbrug 5366,2020-03-01,13:00:00,69,45,24,FMN GV 16 Berchem TOT
54,Posthofbrug 5366,2020-03-01,14:00:00,81,47,34,FMN GV 16 Berchem TOT
54,Posthofbrug 5366,2020-03-01,15:00:00,68,30,38,FMN GV 16 Berchem TOT
54,Posthofbrug 5366,2020-03-01,16:00:00,64,22,42,FMN GV 16 Berchem TOT
54,Posthofbrug 5366,2020-03-01,17:00:00,67,22,45,FMN GV 16 Berchem TOT
54,Posthofbrug 5366,2020-03-01,18:00:00,52,23,29,FMN GV 16 Berchem TOT
54,Posthofbrug 5366,2020-03-01,19:00:00,20,8,12,FMN GV 16 Berchem TOT
54,Posthofbrug 5366,2020-03-01,20:00:00,34,17,17,FMN GV 16 Berchem TOT
54,Posthofbrug 5366,2020-03-01,21:00:00,34,17,17,FMN GV 16 Berchem TOT
54,Posthofbrug 5366,2020-03-01,22:00:00,25,13,12,FMN GV 16 Berchem TOT
54,Posthofbrug 5366,2020-03-01,23:00:00,8,1,7,FMN GV 16 Berchem TOT
54,Posthofbrug 5366,2020-03-02,00:00:00,2,0,2,FMN GV 16 Berchem TOT
54,Posthofbrug 5366,2020-03-02,01:00:00,1,0,1,FMN GV 16 Berchem TOT
54,Posthofbrug 5366,2020-03-02,02:00:00,0,0,0,FMN GV 16 Berchem TOT
54,Posthofbrug 5366,2020-03-02,03:00:00,2,1,1,FMN GV 16 Berchem TOT
54,Posthofbrug 5366,2020-03-02,04:00:00,6,5,1,FMN GV 16 Berchem TOT
54,Posthofbrug 5366,2020-03-02,05:00:00,17,15,2,FMN GV 16 Berchem TOT
54,Posthofbrug 5366,2020-03-02,06:00:00,84,71,13,FMN GV 16 Berchem TOT
54,Posthofbrug 5366,2020-03-02,07:00:00,311,235,76,FMN GV 16 Berchem TOT
54,Posthofbrug 5366,2020-03-02,08:00:00,513,380,133,FMN GV 16 Berchem TOT
54,Posthofbrug 5366,2020-03-02,09:00:00,178,129,49,FMN GV 16 Berchem TOT
54,Posthofbrug 5366,2020-03-02,10:00:00,69,54,15,FMN GV 16 Berchem TOT
54,Posthofbrug 5366,2020-03-02,11:00:00,64,44,20,FMN GV 16 Berchem TOT
54,Posthofbrug 5366,2020-03-02,12:00:00,83,49,34,FMN GV 16 Berchem TOT
54,Posthofbrug 5366,2020-03-02,13:00:00,75,42,33,FMN GV 16 Berchem TOT
54,Posthofbrug 5366,2020-03-02,14:00:00,54,28,26,FMN GV 16 Berchem TOT
54,Posthofbrug 5366,2020-03-02,15:00:00,115,51,64,FMN GV 16 Berchem TOT
54,Posthofbrug 5366,2020-03-02,16:00:00,281,121,160,FMN GV 16 Berchem TOT
54,Posthofbrug 5366,2020-03-02,17:00:00,378,140,238,FMN GV 16 Berchem TOT
54,Posthofbrug 5366,2020-03-02,18:00:00,235,79,156,FMN GV 16 Berchem TOT
54,Posthofbrug 5366,2020-03-02,19:00:00,115,32,83,FMN GV 16 Berchem TOT
54,Posthofbrug 5366,2020-03-02,20:00:00,42,16,26,FMN GV 16 Berchem TOT
54,Posthofbrug 5366,2020-03-02,21:00:00,31,13,18,FMN GV 16 Berchem TOT
54,Posthofbrug 5366,2020-03-02,22:00:00,32,16,16,FMN GV 16 Berchem TOT
54,Posthofbrug 5366,2020-03-02,23:00:00,17,1,16,FMN GV 16 Berchem TOT
54,Posthofbrug 5366,2020-03-03,00:00:00,7,2,5,FMN GV 16 Berchem TOT
54,Posthofbrug 5366,2020-03-03,01:00:00,3,1,2,FMN GV 16 Berchem TOT
54,Posthofbrug 5366,2020-03-03,02:00:00,2,2,0,FMN GV 16 Berchem TOT
54,Posthofbrug 5366,2020-03-03,03:00:00,2,1,1,FMN GV 16 Berchem TOT
54,Posthofbrug 5366,2020-03-03,04:00:00,6,5,1,FMN GV 16 Berchem TOT
54,Posthofbrug 5366,2020-03-03,05:00:00,21,16,5,FMN GV 16 Berchem TOT
54,Posthofbrug 5366,2020-03-03,06:00:00,96,82,14,FMN GV 16 Berchem TOT
54,Posthofbrug 5366,2020-03-03,07:00:00,316,239,77,FMN GV 16 Berchem TOT
54,Posthofbrug 5366,2020-03-03,08:00:00,536,401,135,FMN GV 16 Berchem TOT
54,Posthofbrug 5366,2020-03-03,09:00:00,174,132,42,FMN GV 16 Berchem TOT
54,Posthofbrug 5366,2020-03-03,10:00:00,86,64,22,FMN GV 16 Berchem TOT
54,Posthofbrug 5366,2020-03-03,11:00:00,78,44,34,FMN GV 16 Berchem TOT
54,Posthofbrug 5366,2020-03-03,12:00:00,131,85,46,FMN GV 16 Berchem TOT
54,Posthofbrug 5366,2020-03-03,13:00:00,103,49,54,FMN GV 16 Berchem TOT
54,Posthofbrug 5366,2020-03-03,14:00:00,80,36,44,FMN GV 16 Berchem TOT
54,Posthofbrug 5366,2020-03-03,15:00:00,158,70,88,FMN GV 16 Berchem TOT
54,Posthofbrug 5366,2020-03-03,16:00:00,356,141,215,FMN GV 16 Berchem TOT
54,Posthofbrug 5366,2020-03-03,17:00:00,399,173,226,FMN GV 16 Berchem TOT
54,Posthofbrug 5366,2020-03-03,18:00:00,278,101,177,FMN GV 16 Berchem TOT
54,Posthofbrug 5366,2020-03-03,19:00:00,125,50,75,FMN GV 16 Berchem TOT
54,Posthofbrug 5366,2020-03-03,20:00:00,57,24,33,FMN GV 16 Berchem TOT
54,Posthofbrug 5366,2020-03-03,21:00:00,60,25,35,FMN GV 16 Berchem TOT
54,Posthofbrug 5366,2020-03-03,22:00:00,46,18,28,FMN GV 16 Berchem TOT
54,Posthofbrug 5366,2020-03-03,23:00:00,32,8,24,FMN GV 16 Berchem TOT
54,Posthofbrug 5366,2020-03-04,00:00:00,18,3,15,FMN GV 16 Berchem TOT
54,Posthofbrug 5366,2020-03-04,01:00:00,2,0,2,FMN GV 16 Berchem TOT
54,Posthofbrug 5366,2020-03-04,02:00:00,3,1,2,FMN GV 16 Berchem TOT
54,Posthofbrug 5366,2020-03-04,03:00:00,1,1,0,FMN GV 16 Berchem TOT
54,Posthofbrug 5366,2020-03-04,04:00:00,11,8,3,FMN GV 16 Berchem TOT
54,Posthofbrug 5366,2020-03-04,05:00:00,17,13,4,FMN GV 16 Berchem TOT
54,Posthofbrug 5366,2020-03-04,06:00:00,83,71,12,FMN GV 16 Berchem TOT
54,Posthofbrug 5366,2020-03-04,07:00:00,292,217,75,FMN GV 16 Berchem TOT
54,Posthofbrug 5366,2020-03-04,08:00:00,523,388,135,FMN GV 16 Berchem TOT
54,Posthofbrug 5366,2020-03-04,09:00:00,160,119,41,FMN GV 16 Berchem TOT
54,Posthofbrug 5366,2020-03-04,10:00:00,71,45,26,FMN GV 16 Berchem TOT
54,Posthofbrug 5366,2020-03-04,11:00:00,90,51,39,FMN GV 16 Berchem TOT
54,Posthofbrug 5366,2020-03-04,12:00:00,217,106,111,FMN GV 16 Berchem TOT
54,Posthofbrug 5366,2020-03-04,13:00:00,137,59,78,FMN GV 16 Berchem TOT
54,Posthofbrug 5366,2020-03-04,14:00:00,96,42,54,FMN GV 16 Berchem TOT
54,Posthofbrug 5366,2020-03-04,15:00:00,123,54,69,FMN GV 16 Berchem TOT
54,Posthofbrug 5366,2020-03-04,16:00:00,257,109,148,FMN GV 16 Berchem TOT
54,Posthofbrug 5366,2020-03-04,17:00:00,394,160,234,FMN GV 16 Berchem TOT
54,Posthofbrug 5366,2020-03-04,18:00:00,261,101,160,FMN GV 16 Berchem TOT
54,Posthofbrug 5366,2020-03-04,19:00:00,125,54,71,FMN GV 16 Berchem TOT
54,Posthofbrug 5366,2020-03-04,20:00:00,60,30,30,FMN GV 16 Berchem TOT
54,Posthofbrug 5366,2020-03-04,21:00:00,54,25,29,FMN GV 16 Berchem TOT
54,Posthofbrug 5366,2020-03-04,22:00:00,72,26,46,FMN GV 16 Berchem TOT
54,Posthofbrug 5366,2020-03-04,23:00:00,19,4,15,FMN GV 16 Berchem TOT
54,Posthofbrug 5366,2020-03-05,00:00:00,21,8,13,FMN GV 16 Berchem TOT
54,Posthofbrug 5366,2020-03-05,01:00:00,4,1,3,FMN GV 16 Berchem TOT
54,Posthofbrug 5366,2020-03-05,02:00:00,0,0,0,FMN GV 16 Berchem TOT
54,Posthofbrug 5366,2020-03-05,03:00:00,0,0,0,FMN GV 16 Berchem TOT
54,Posthofbrug 5366,2020-03-05,04:00:00,6,3,3,FMN GV 16 Berchem TOT
54,Posthofbrug 5366,2020-03-05,05:00:00,14,11,3,FMN GV 16 Berchem TOT
54,Posthofbrug 5366,2020-03-05,06:00:00,79,64,15,FMN GV 16 Berchem TOT
54,Posthofbrug 5366,2020-03-05,07:00:00,307,228,79,FMN GV 16 Berchem TOT
54,Posthofbrug 5366,2020-03-05,08:00:00,499,366,133,FMN GV 16 Berchem TOT
54,Posthofbrug 5366,2020-03-05,09:00:00,184,129,55,FMN GV 16 Berchem TOT
54,Posthofbrug 5366,2020-03-05,10:00:00,74,55,19,FMN GV 16 Berchem TOT
54,Posthofbrug 5366,2020-03-05,11:00:00,54,37,17,FMN GV 16 Berchem TOT
54,Posthofbrug 5366,2020-03-05,12:00:00,72,32,40,FMN GV 16 Berchem TOT
54,Posthofbrug 5366,2020-03-05,13:00:00,71,36,35,FMN GV 16 Berchem TOT
54,Posthofbrug 5366,2020-03-05,14:00:00,48,19,29,FMN GV 16 Berchem TOT
54,Posthofbrug 5366,2020-03-05,15:00:00,93,48,45,FMN GV 16 Berchem TOT
54,Posthofbrug 5366,2020-03-05,16:00:00,240,84,156,FMN GV 16 Berchem TOT
54,Posthofbrug 5366,2020-03-05,17:00:00,285,124,161,FMN GV 16 Berchem TOT
54,Posthofbrug 5366,2020-03-05,18:00:00,173,56,117,FMN GV 16 Berchem TOT
54,Posthofbrug 5366,2020-03-05,19:00:00,75,26,49,FMN GV 16 Berchem TOT
54,Posthofbrug 5366,2020-03-05,20:00:00,56,23,33,FMN GV 16 Berchem TOT
54,Posthofbrug 5366,2020-03-05,21:00:00,38,20,18,FMN GV 16 Berchem TOT
54,Posthofbrug 5366,2020-03-05,22:00:00,33,13,20,FMN GV 16 Berchem TOT
54,Posthofbrug 5366,2020-03-05,23:00:00,21,6,15,FMN GV 16 Berchem TOT
54,Posthofbrug 5366,2020-03-06,00:00:00,6,0,6,FMN GV 16 Berchem TOT
54,Posthofbrug 5366,2020-03-06,01:00:00,8,3,5,FMN GV 16 Berchem TOT
54,Posthofbrug 5366,2020-03-06,02:00:00,2,1,1,FMN GV 16 Berchem TOT
54,Posthofbrug 5366,2020-03-06,03:00:00,4,0,4,FMN GV 16 Berchem TOT
54,Posthofbrug 5366,2020-03-06,04:00:00,4,3,1,FMN GV 16 Berchem TOT
54,Posthofbrug 5366,2020-03-06,05:00:00,10,6,4,FMN GV 16 Berchem TOT
54,Posthofbrug 5366,2020-03-06,06:00:00,59,43,16,FMN GV 16 Berchem TOT
54,Posthofbrug 5366,2020-03-06,07:00:00,245,182,63,FMN GV 16 Berchem TOT
54,Posthofbrug 5366,2020-03-06,08:00:00,421,329,92,FMN GV 16 Berchem TOT
54,Posthofbrug 5366,2020-03-06,09:00:00,153,109,44,FMN GV 16 Berchem TOT
54,Posthofbrug 5366,2020-03-06,10:00:00,74,51,23,FMN GV 16 Berchem TOT
54,Posthofbrug 5366,2020-03-06,11:00:00,60,41,19,FMN GV 16 Berchem TOT
54,Posthofbrug 5366,2020-03-06,12:00:00,98,44,54,FMN GV 16 Berchem TOT
54,Posthofbrug 5366,2020-03-06,13:00:00,77,41,36,FMN GV 16 Berchem TOT
54,Posthofbrug 5366,2020-03-06,14:00:00,82,39,43,FMN GV 16 Berchem TOT
54,Posthofbrug 5366,2020-03-06,15:00:00,139,63,76,FMN GV 16 Berchem TOT
54,Posthofbrug 5366,2020-03-06,16:00:00,244,94,150,FMN GV 16 Berchem TOT
54,Posthofbrug 5366,2020-03-06,17:00:00,301,129,172,FMN GV 16 Berchem TOT
54,Posthofbrug 5366,2020-03-06,18:00:00,186,67,119,FMN GV 16 Berchem TOT
54,Posthofbrug 5366,2020-03-06,19:00:00,110,42,68,FMN GV 16 Berchem TOT
54,Posthofbrug 5366,2020-03-06,20:00:00,39,18,21,FMN GV 16 Berchem TOT
54,Posthofbrug 5366,2020-03-06,21:00:00,46,27,19,FMN GV 16 Berchem TOT
54,Posthofbrug 5366,2020-03-06,22:00:00,41,19,22,FMN GV 16 Berchem TOT
54,Posthofbrug 5366,2020-03-06,23:00:00,25,7,18,FMN GV 16 Berchem TOT
54,Posthofbrug 5366,2020-03-07,00:00:00,28,12,16,FMN GV 16 Berchem TOT
54,Posthofbrug 5366,2020-03-07,01:00:00,23,7,16,FMN GV 16 Berchem TOT
54,Posthofbrug 5366,2020-03-07,02:00:00,24,4,20,FMN GV 16 Berchem TOT
54,Posthofbrug 5366,2020-03-07,03:00:00,16,12,4,FMN GV 16 Berchem TOT
54,Posthofbrug 5366,2020-03-07,04:00:00,8,6,2,FMN GV 16 Berchem TOT
54,Posthofbrug 5366,2020-03-07,05:00:00,11,5,6,FMN GV 16 Berchem TOT
54,Posthofbrug 5366,2020-03-07,06:00:00,12,9,3,FMN GV 16 Berchem TOT
54,Posthofbrug 5366,2020-03-07,07:00:00,17,9,8,FMN GV 16 Berchem TOT
54,Posthofbrug 5366,2020-03-07,08:00:00,48,28,20,FMN GV 16 Berchem TOT
54,Posthofbrug 5366,2020-03-07,09:00:00,50,28,22,FMN GV 16 Berchem TOT
54,Posthofbrug 5366,2020-03-07,10:00:00,75,57,18,FMN GV 16 Berchem TOT
54,Posthofbrug 5366,2020-03-07,11:00:00,114,65,49,FMN GV 16 Berchem TOT
54,Posthofbrug 5366,2020-03-07,12:00:00,115,76,39,FMN GV 16 Berchem TOT
54,Posthofbrug 5366,2020-03-07,13:00:00,121,71,50,FMN GV 16 Berchem TOT
54,Posthofbrug 5366,2020-03-07,14:00:00,151,92,59,FMN GV 16 Berchem TOT
54,Posthofbrug 5366,2020-03-07,15:00:00,100,48,52,FMN GV 16 Berchem TOT
54,Posthofbrug 5366,2020-03-07,16:00:00,126,56,70,FMN GV 16 Berchem TOT
54,Posthofbrug 5366,2020-03-07,17:00:00,102,53,49,FMN GV 16 Berchem TOT
54,Posthofbrug 5366,2020-03-07,18:00:00,70,28,42,FMN GV 16 Berchem TOT
54,Posthofbrug 5366,2020-03-07,19:00:00,77,45,32,FMN GV 16 Berchem TOT
54,Posthofbrug 5366,2020-03-07,20:00:00,49,28,21,FMN GV 16 Berchem TOT
54,Posthofbrug 5366,2020-03-07,21:00:00,40,25,15,FMN GV 16 Berchem TOT
54,Posthofbrug 5366,2020-03-07,22:00:00,47,29,18,FMN GV 16 Berchem TOT
54,Posthofbrug 5366,2020-03-07,23:00:00,26,9,17,FMN GV 16 Berchem TOT
54,Posthofbrug 5366,2020-03-08,00:00:00,48,29,19,FMN GV 16 Berchem TOT
54,Posthofbrug 5366,2020-03-08,01:00:00,30,11,19,FMN GV 16 Berchem TOT
54,Posthofbrug 5366,2020-03-08,02:00:00,23,4,19,FMN GV 16 Berchem TOT
54,Posthofbrug 5366,2020-03-08,03:00:00,18,3,15,FMN GV 16 Berchem TOT
54,Posthofbrug 5366,2020-03-08,04:00:00,12,1,11,FMN GV 16 Berchem TOT
54,Posthofbrug 5366,2020-03-08,05:00:00,9,5,4,FMN GV 16 Berchem TOT
54,Posthofbrug 5366,2020-03-08,06:00:00,15,7,8,FMN GV 16 Berchem TOT
54,Posthofbrug 5366,2020-03-08,07:00:00,8,5,3,FMN GV 16 Berchem TOT
54,Posthofbrug 5366,2020-03-08,08:00:00,30,21,9,FMN GV 16 Berchem TOT
54,Posthofbrug 5366,2020-03-08,09:00:00,33,20,13,FMN GV 16 Berchem TOT
54,Posthofbrug 5366,2020-03-08,10:00:00,38,25,13,FMN GV 16 Berchem TOT
54,Posthofbrug 5366,2020-03-08,11:00:00,31,14,17,FMN GV 16 Berchem TOT
54,Posthofbrug 5366,2020-03-08,12:00:00,42,29,13,FMN GV 16 Berchem TOT
54,Posthofbrug 5366,2020-03-08,13:00:00,38,23,15,FMN GV 16 Berchem TOT
54,Posthofbrug 5366,2020-03-08,14:00:00,49,26,23,FMN GV 16 Berchem TOT
54,Posthofbrug 5366,2020-03-08,15:00:00,36,23,13,FMN GV 16 Berchem TOT
54,Posthofbrug 5366,2020-03-08,16:00:00,29,15,14,FMN GV 16 Berchem TOT
54,Posthofbrug 5366,2020-03-08,17:00:00,36,10,26,FMN GV 16 Berchem TOT
54,Posthofbrug 5366,2020-03-08,18:00:00,29,14,15,FMN GV 16 Berchem TOT
54,Posthofbrug 5366,2020-03-08,19:00:00,32,17,15,FMN GV 16 Berchem TOT
54,Posthofbrug 5366,2020-03-08,20:00:00,24,14,10,FMN GV 16 Berchem TOT
54,Posthofbrug 5366,2020-03-08,21:00:00,12,9,3,FMN GV 16 Berchem TOT
54,Posthofbrug 5366,2020-03-08,22:00:00,19,6,13,FMN GV 16 Berchem TOT
54,Posthofbrug 5366,2020-03-08,23:00:00,14,6,8,FMN GV 16 Berchem TOT
54,Posthofbrug 5366,2020-03-09,00:00:00,3,1,2,FMN GV 16 Berchem TOT
54,Posthofbrug 5366,2020-03-09,01:00:00,3,1,2,FMN GV 16 Berchem TOT
54,Posthofbrug 5366,2020-03-09,02:00:00,0,0,0,FMN GV 16 Berchem TOT
54,Posthofbrug 5366,2020-03-09,03:00:00,1,1,0,FMN GV 16 Berchem TOT
54,Posthofbrug 5366,2020-03-09,04:00:00,6,5,1,FMN GV 16 Berchem TOT
54,Posthofbrug 5366,2020-03-09,05:00:00,24,21,3,FMN GV 16 Berchem TOT
54,Posthofbrug 5366,2020-03-09,06:00:00,91,74,17,FMN GV 16 Berchem TOT
54,Posthofbrug 5366,2020-03-09,07:00:00,326,247,79,FMN GV 16 Berchem TOT
54,Posthofbrug 5366,2020-03-09,08:00:00,525,394,131,FMN GV 16 Berchem TOT
54,Posthofbrug 5366,2020-03-09,09:00:00,195,152,43,FMN GV 16 Berchem TOT
54,Posthofbrug 5366,2020-03-09,10:00:00,68,48,20,FMN GV 16 Berchem TOT
54,Posthofbrug 5366,2020-03-09,11:00:00,71,48,23,FMN GV 16 Berchem TOT
54,Posthofbrug 5366,2020-03-09,12:00:00,102,72,30,FMN GV 16 Berchem TOT
54,Posthofbrug 5366,2020-03-09,13:00:00,96,51,45,FMN GV 16 Berchem TOT
54,Posthofbrug 5366,2020-03-09,14:00:00,76,37,39,FMN GV 16 Berchem TOT
54,Posthofbrug 5366,2020-03-09,15:00:00,149,69,80,FMN GV 16 Berchem TOT
54,Posthofbrug 5366,2020-03-09,16:00:00,295,122,173,FMN GV 16 Berchem TOT
54,Posthofbrug 5366,2020-03-09,17:00:00,446,146,300,FMN GV 16 Berchem TOT
54,Posthofbrug 5366,2020-03-09,18:00:00,275,110,165,FMN GV 16 Berchem TOT
54,Posthofbrug 5366,2020-03-09,19:00:00,108,48,60,FMN GV 16 Berchem TOT
54,Posthofbrug 5366,2020-03-09,20:00:00,51,32,19,FMN GV 16 Berchem TOT
54,Posthofbrug 5366,2020-03-09,21:00:00,48,19,29,FMN GV 16 Berchem TOT
54,Posthofbrug 5366,2020-03-09,22:00:00,58,20,38,FMN GV 16 Berchem TOT
54,Posthofbrug 5366,2020-03-09,23:00:00,26,7,19,FMN GV 16 Berchem TOT
54,Posthofbrug 5366,2020-03-10,00:00:00,4,0,4,FMN GV 16 Berchem TOT
54,Posthofbrug 5366,2020-03-10,01:00:00,0,0,0,FMN GV 16 Berchem TOT
54,Posthofbrug 5366,2020-03-10,02:00:00,1,0,1,FMN GV 16 Berchem TOT
54,Posthofbrug 5366,2020-03-10,03:00:00,4,3,1,FMN GV 16 Berchem TOT
54,Posthofbrug 5366,2020-03-10,04:00:00,7,4,3,FMN GV 16 Berchem TOT
54,Posthofbrug 5366,2020-03-10,05:00:00,14,13,1,FMN GV 16 Berchem TOT
54,Posthofbrug 5366,2020-03-10,06:00:00,78,69,9,FMN GV 16 Berchem TOT
54,Posthofbrug 5366,2020-03-10,07:00:00,268,214,54,FMN GV 16 Berchem TOT
54,Posthofbrug 5366,2020-03-10,08:00:00,490,361,129,FMN GV 16 Berchem TOT
54,Posthofbrug 5366,2020-03-10,09:00:00,129,97,32,FMN GV 16 Berchem TOT
54,Posthofbrug 5366,2020-03-10,10:00:00,54,37,17,FMN GV 16 Berchem TOT
54,Posthofbrug 5366,2020-03-10,11:00:00,39,23,16,FMN GV 16 Berchem TOT
54,Posthofbrug 5366,2020-03-10,12:00:00,82,55,27,FMN GV 16 Berchem TOT
54,Posthofbrug 5366,2020-03-10,13:00:00,54,28,26,FMN GV 16 Berchem TOT
54,Posthofbrug 5366,2020-03-10,14:00:00,59,30,29,FMN GV 16 Berchem TOT
54,Posthofbrug 5366,2020-03-10,15:00:00,111,52,59,FMN GV 16 Berchem TOT
54,Posthofbrug 5366,2020-03-10,16:00:00,255,92,163,FMN GV 16 Berchem TOT
54,Posthofbrug 5366,2020-03-10,17:00:00,339,128,211,FMN GV 16 Berchem TOT
54,Posthofbrug 5366,2020-03-10,18:00:00,242,91,151,FMN GV 16 Berchem TOT
54,Posthofbrug 5366,2020-03-10,19:00:00,101,36,65,FMN GV 16 Berchem TOT
54,Posthofbrug 5366,2020-03-10,20:00:00,53,26,27,FMN GV 16 Berchem TOT
54,Posthofbrug 5366,2020-03-10,21:00:00,53,21,32,FMN GV 16 Berchem TOT
54,Posthofbrug 5366,2020-03-10,22:00:00,47,21,26,FMN GV 16 Berchem TOT
54,Posthofbrug 5366,2020-03-10,23:00:00,28,6,22,FMN GV 16 Berchem TOT
54,Posthofbrug 5366,2020-03-11,00:00:00,14,2,12,FMN GV 16 Berchem TOT
54,Posthofbrug 5366,2020-03-11,01:00:00,3,0,3,FMN GV 16 Berchem TOT
54,Posthofbrug 5366,2020-03-11,02:00:00,2,0,2,FMN GV 16 Berchem TOT
54,Posthofbrug 5366,2020-03-11,03:00:00,1,0,1,FMN GV 16 Berchem TOT
54,Posthofbrug 5366,2020-03-11,04:00:00,7,5,2,FMN GV 16 Berchem TOT
54,Posthofbrug 5366,2020-03-11,05:00:00,11,10,1,FMN GV 16 Berchem TOT
54,Posthofbrug 5366,2020-03-11,06:00:00,89,73,16,FMN GV 16 Berchem TOT
54,Posthofbrug 5366,2020-03-11,07:00:00,285,216,69,FMN GV 16 Berchem TOT
54,Posthofbrug 5366,2020-03-11,08:00:00,442,325,117,FMN GV 16 Berchem TOT
54,Posthofbrug 5366,2020-03-11,09:00:00,136,95,41,FMN GV 16 Berchem TOT
54,Posthofbrug 5366,2020-03-11,10:00:00,60,46,14,FMN GV 16 Berchem TOT
54,Posthofbrug 5366,2020-03-11,11:00:00,53,25,28,FMN GV 16 Berchem TOT
54,Posthofbrug 5366,2020-03-11,12:00:00,125,61,64,FMN GV 16 Berchem TOT
54,Posthofbrug 5366,2020-03-11,13:00:00,85,45,40,FMN GV 16 Berchem TOT
54,Posthofbrug 5366,2020-03-11,14:00:00,83,42,41,FMN GV 16 Berchem TOT
54,Posthofbrug 5366,2020-03-11,15:00:00,113,58,55,FMN GV 16 Berchem TOT
54,Posthofbrug 5366,2020-03-11,16:00:00,201,93,108,FMN GV 16 Berchem TOT
54,Posthofbrug 5366,2020-03-11,17:00:00,314,136,178,FMN GV 16 Berchem TOT
54,Posthofbrug 5366,2020-03-11,18:00:00,246,88,158,FMN GV 16 Berchem TOT
54,Posthofbrug 5366,2020-03-11,19:00:00,108,54,54,FMN GV 16 Berchem TOT
54,Posthofbrug 5366,2020-03-11,20:00:00,43,24,19,FMN GV 16 Berchem TOT
54,Posthofbrug 5366,2020-03-11,21:00:00,34,13,21,FMN GV 16 Berchem TOT
54,Posthofbrug 5366,2020-03-11,22:00:00,43,13,30,FMN GV 16 Berchem TOT
54,Posthofbrug 5366,2020-03-11,23:00:00,19,2,17,FMN GV 16 Berchem TOT
54,Posthofbrug 5366,2020-03-12,00:00:00,17,10,7,FMN GV 16 Berchem TOT
54,Posthofbrug 5366,2020-03-12,01:00:00,3,2,1,FMN GV 16 Berchem TOT
54,Posthofbrug 5366,2020-03-12,02:00:00,2,0,2,FMN GV 16 Berchem TOT
54,Posthofbrug 5366,2020-03-12,03:00:00,3,1,2,FMN GV 16 Berchem TOT
54,Posthofbrug 5366,2020-03-12,04:00:00,13,3,10,FMN GV 16 Berchem TOT
54,Posthofbrug 5366,2020-03-12,05:00:00,10,6,4,FMN GV 16 Berchem TOT
54,Posthofbrug 5366,2020-03-12,06:00:00,88,75,13,FMN GV 16 Berchem TOT
54,Posthofbrug 5366,2020-03-12,07:00:00,278,214,64,FMN GV 16 Berchem TOT
54,Posthofbrug 5366,2020-03-12,08:00:00,539,414,125,FMN GV 16 Berchem TOT
54,Posthofbrug 5366,2020-03-12,09:00:00,184,139,45,FMN GV 16 Berchem TOT
54,Posthofbrug 5366,2020-03-12,10:00:00,97,64,33,FMN GV 16 Berchem TOT
54,Posthofbrug 5366,2020-03-12,11:00:00,85,57,28,FMN GV 16 Berchem TOT
54,Posthofbrug 5366,2020-03-12,12:00:00,116,64,52,FMN GV 16 Berchem TOT
54,Posthofbrug 5366,2020-03-12,13:00:00,114,59,55,FMN GV 16 Berchem TOT
54,Posthofbrug 5366,2020-03-12,14:00:00,114,48,66,FMN GV 16 Berchem TOT
54,Posthofbrug 5366,2020-03-12,15:00:00,132,56,76,FMN GV 16 Berchem TOT
54,Posthofbrug 5366,2020-03-12,16:00:00,304,105,199,FMN GV 16 Berchem TOT
54,Posthofbrug 5366,2020-03-12,17:00:00,322,115,207,FMN GV 16 Berchem TOT
54,Posthofbrug 5366,2020-03-12,18:00:00,230,76,154,FMN GV 16 Berchem TOT
54,Posthofbrug 5366,2020-03-12,19:00:00,108,38,70,FMN GV 16 Berchem TOT
54,Posthofbrug 5366,2020-03-12,20:00:00,64,34,30,FMN GV 16 Berchem TOT
54,Posthofbrug 5366,2020-03-12,21:00:00,49,22,27,FMN GV 16 Berchem TOT
54,Posthofbrug 5366,2020-03-12,22:00:00,38,12,26,FMN GV 16 Berchem TOT
54,Posthofbrug 5366,2020-03-12,23:00:00,14,5,9,FMN GV 16 Berchem TOT
54,Posthofbrug 5366,2020-03-13,00:00:00,15,5,10,FMN GV 16 Berchem TOT
54,Posthofbrug 5366,2020-03-13,01:00:00,4,0,4,FMN GV 16 Berchem TOT
54,Posthofbrug 5366,2020-03-13,02:00:00,6,0,6,FMN GV 16 Berchem TOT
54,Posthofbrug 5366,2020-03-13,03:00:00,1,1,0,FMN GV 16 Berchem TOT
54,Posthofbrug 5366,2020-03-13,04:00:00,5,5,0,FMN GV 16 Berchem TOT
54,Posthofbrug 5366,2020-03-13,05:00:00,9,7,2,FMN GV 16 Berchem TOT
54,Posthofbrug 5366,2020-03-13,06:00:00,66,52,14,FMN GV 16 Berchem TOT
54,Posthofbrug 5366,2020-03-13,07:00:00,231,174,57,FMN GV 16 Berchem TOT
54,Posthofbrug 5366,2020-03-13,08:00:00,321,245,76,FMN GV 16 Berchem TOT
54,Posthofbrug 5366,2020-03-13,09:00:00,124,91,33,FMN GV 16 Berchem TOT
54,Posthofbrug 5366,2020-03-13,10:00:00,48,39,9,FMN GV 16 Berchem TOT
54,Posthofbrug 5366,2020-03-13,11:00:00,66,53,13,FMN GV 16 Berchem TOT
54,Posthofbrug 5366,2020-03-13,12:00:00,74,49,25,FMN GV 16 Berchem TOT
54,Posthofbrug 5366,2020-03-13,13:00:00,71,36,35,FMN GV 16 Berchem TOT
54,Posthofbrug 5366,2020-03-13,14:00:00,86,53,33,FMN GV 16 Berchem TOT
54,Posthofbrug 5366,2020-03-13,15:00:00,83,52,31,FMN GV 16 Berchem TOT
54,Posthofbrug 5366,2020-03-13,16:00:00,230,81,149,FMN GV 16 Berchem TOT
54,Posthofbrug 5366,2020-03-13,17:00:00,235,82,153,FMN GV 16 Berchem TOT
54,Posthofbrug 5366,2020-03-13,18:00:00,169,66,103,FMN GV 16 Berchem TOT
54,Posthofbrug 5366,2020-03-13,19:00:00,82,41,41,FMN GV 16 Berchem TOT
54,Posthofbrug 5366,2020-03-13,20:00:00,70,41,29,FMN GV 16 Berchem TOT
54,Posthofbrug 5366,2020-03-13,21:00:00,44,20,24,FMN GV 16 Berchem TOT
54,Posthofbrug 5366,2020-03-13,22:00:00,26,8,18,FMN GV 16 Berchem TOT
54,Posthofbrug 5366,2020-03-13,23:00:00,14,4,10,FMN GV 16 Berchem TOT
54,Posthofbrug 5366,2020-03-14,00:00:00,25,6,19,FMN GV 16 Berchem TOT
54,Posthofbrug 5366,2020-03-14,01:00:00,17,3,14,FMN GV 16 Berchem TOT
54,Posthofbrug 5366,2020-03-14,02:00:00,13,4,9,FMN GV 16 Berchem TOT
54,Posthofbrug 5366,2020-03-14,03:00:00,7,3,4,FMN GV 16 Berchem TOT
54,Posthofbrug 5366,2020-03-14,04:00:00,3,3,0,FMN GV 16 Berchem TOT
54,Posthofbrug 5366,2020-03-14,05:00:00,6,6,0,FMN GV 16 Berchem TOT
54,Posthofbrug 5366,2020-03-14,06:00:00,13,9,4,FMN GV 16 Berchem TOT
54,Posthofbrug 5366,2020-03-14,07:00:00,13,10,3,FMN GV 16 Berchem TOT
54,Posthofbrug 5366,2020-03-14,08:00:00,21,8,13,FMN GV 16 Berchem TOT
54,Posthofbrug 5366,2020-03-14,09:00:00,32,22,10,FMN GV 16 Berchem TOT
54,Posthofbrug 5366,2020-03-14,10:00:00,55,30,25,FMN GV 16 Berchem TOT
54,Posthofbrug 5366,2020-03-14,11:00:00,68,38,30,FMN GV 16 Berchem TOT
54,Posthofbrug 5366,2020-03-14,12:00:00,69,43,26,FMN GV 16 Berchem TOT
54,Posthofbrug 5366,2020-03-14,13:00:00,85,54,31,FMN GV 16 Berchem TOT
54,Posthofbrug 5366,2020-03-14,14:00:00,105,58,47,FMN GV 16 Berchem TOT
54,Posthofbrug 5366,2020-03-14,15:00:00,80,44,36,FMN GV 16 Berchem TOT
54,Posthofbrug 5366,2020-03-14,16:00:00,66,36,30,FMN GV 16 Berchem TOT
54,Posthofbrug 5366,2020-03-14,17:00:00,66,39,27,FMN GV 16 Berchem TOT
54,Posthofbrug 5366,2020-03-14,18:00:00,44,23,21,FMN GV 16 Berchem TOT
54,Posthofbrug 5366,2020-03-14,19:00:00,27,11,16,FMN GV 16 Berchem TOT
54,Posthofbrug 5366,2020-03-14,20:00:00,20,13,7,FMN GV 16 Berchem TOT
54,Posthofbrug 5366,2020-03-14,21:00:00,20,12,8,FMN GV 16 Berchem TOT
54,Posthofbrug 5366,2020-03-14,22:00:00,14,5,9,FMN GV 16 Berchem TOT
54,Posthofbrug 5366,2020-03-14,23:00:00,10,6,4,FMN GV 16 Berchem TOT
54,Posthofbrug 5366,2020-03-15,00:00:00,9,4,5,FMN GV 16 Berchem TOT
54,Posthofbrug 5366,2020-03-15,01:00:00,9,1,8,FMN GV 16 Berchem TOT
54,Posthofbrug 5366,2020-03-15,02:00:00,2,0,2,FMN GV 16 Berchem TOT
54,Posthofbrug 5366,2020-03-15,03:00:00,4,2,2,FMN GV 16 Berchem TOT
54,Posthofbrug 5366,2020-03-15,04:00:00,3,1,2,FMN GV 16 Berchem TOT
54,Posthofbrug 5366,2020-03-15,05:00:00,3,2,1,FMN GV 16 Berchem TOT
54,Posthofbrug 5366,2020-03-15,06:00:00,14,13,1,FMN GV 16 Berchem TOT
54,Posthofbrug 5366,2020-03-15,07:00:00,13,7,6,FMN GV 16 Berchem TOT
54,Posthofbrug 5366,2020-03-15,08:00:00,14,9,5,FMN GV 16 Berchem TOT
54,Posthofbrug 5366,2020-03-15,09:00:00,24,13,11,FMN GV 16 Berchem TOT
54,Posthofbrug 5366,2020-03-15,10:00:00,46,26,20,FMN GV 16 Berchem TOT
54,Posthofbrug 5366,2020-03-15,11:00:00,68,30,38,FMN GV 16 Berchem TOT
54,Posthofbrug 5366,2020-03-15,12:00:00,65,34,31,FMN GV 16 Berchem TOT
54,Posthofbrug 5366,2020-03-15,13:00:00,85,54,31,FMN GV 16 Berchem TOT
54,Posthofbrug 5366,2020-03-15,14:00:00,86,50,36,FMN GV 16 Berchem TOT
54,Posthofbrug 5366,2020-03-15,15:00:00,63,34,29,FMN GV 16 Berchem TOT
54,Posthofbrug 5366,2020-03-15,16:00:00,67,37,30,FMN GV 16 Berchem TOT
54,Posthofbrug 5366,2020-03-15,17:00:00,82,45,37,FMN GV 16 Berchem TOT
54,Posthofbrug 5366,2020-03-15,18:00:00,50,27,23,FMN GV 16 Berchem TOT
54,Posthofbrug 5366,2020-03-15,19:00:00,23,10,13,FMN GV 16 Berchem TOT
54,Posthofbrug 5366,2020-03-15,20:00:00,22,18,4,FMN GV 16 Berchem TOT
54,Posthofbrug 5366,2020-03-15,21:00:00,14,6,8,FMN GV 16 Berchem TOT
54,Posthofbrug 5366,2020-03-15,22:00:00,21,15,6,FMN GV 16 Berchem TOT
54,Posthofbrug 5366,2020-03-15,23:00:00,10,4,6,FMN GV 16 Berchem TOT
54,Posthofbrug 5366,2020-03-16,00:00:00,1,0,1,FMN GV 16 Berchem TOT
54,Posthofbrug 5366,2020-03-16,01:00:00,1,0,1,FMN GV 16 Berchem TOT
54,Posthofbrug 5366,2020-03-16,02:00:00,1,1,0,FMN GV 16 Berchem TOT
54,Posthofbrug 5366,2020-03-16,03:00:00,1,0,1,FMN GV 16 Berchem TOT
54,Posthofbrug 5366,2020-03-16,04:00:00,4,3,1,FMN GV 16 Berchem TOT
54,Posthofbrug 5366,2020-03-16,05:00:00,21,18,3,FMN GV 16 Berchem TOT
54,Posthofbrug 5366,2020-03-16,06:00:00,69,58,11,FMN GV 16 Berchem TOT
54,Posthofbrug 5366,2020-03-16,07:00:00,185,144,41,FMN GV 16 Berchem TOT
54,Posthofbrug 5366,2020-03-16,08:00:00,226,180,46,FMN GV 16 Berchem TOT
54,Posthofbrug 5366,2020-03-16,09:00:00,110,85,25,FMN GV 16 Berchem TOT
54,Posthofbrug 5366,2020-03-16,10:00:00,49,33,16,FMN GV 16 Berchem TOT
54,Posthofbrug 5366,2020-03-16,11:00:00,58,36,22,FMN GV 16 Berchem TOT
54,Posthofbrug 5366,2020-03-16,12:00:00,78,29,49,FMN GV 16 Berchem TOT
54,Posthofbrug 5366,2020-03-16,13:00:00,105,43,62,FMN GV 16 Berchem TOT
54,Posthofbrug 5366,2020-03-16,14:00:00,87,46,41,FMN GV 16 Berchem TOT
54,Posthofbrug 5366,2020-03-16,15:00:00,118,55,63,FMN GV 16 Berchem TOT
54,Posthofbrug 5366,2020-03-16,16:00:00,176,69,107,FMN GV 16 Berchem TOT
54,Posthofbrug 5366,2020-03-16,17:00:00,209,70,139,FMN GV 16 Berchem TOT
54,Posthofbrug 5366,2020-03-16,18:00:00,130,46,84,FMN GV 16 Berchem TOT
54,Posthofbrug 5366,2020-03-16,19:00:00,64,27,37,FMN GV 16 Berchem TOT
54,Posthofbrug 5366,2020-03-16,20:00:00,27,10,17,FMN GV 16 Berchem TOT
54,Posthofbrug 5366,2020-03-16,21:00:00,14,5,9,FMN GV 16 Berchem TOT
54,Posthofbrug 5366,2020-03-16,22:00:00,13,4,9,FMN GV 16 Berchem TOT
54,Posthofbrug 5366,2020-03-16,23:00:00,8,1,7,FMN GV 16 Berchem TOT
54,Posthofbrug 5366,2020-03-17,00:00:00,4,1,3,FMN GV 16 Berchem TOT
54,Posthofbrug 5366,2020-03-17,01:00:00,3,0,3,FMN GV 16 Berchem TOT
54,Posthofbrug 5366,2020-03-17,02:00:00,3,2,1,FMN GV 16 Berchem TOT
54,Posthofbrug 5366,2020-03-17,03:00:00,2,1,1,FMN GV 16 Berchem TOT
54,Posthofbrug 5366,2020-03-17,04:00:00,2,1,1,FMN GV 16 Berchem TOT
54,Posthofbrug 5366,2020-03-17,05:00:00,15,11,4,FMN GV 16 Berchem TOT
54,Posthofbrug 5366,2020-03-17,06:00:00,59,46,13,FMN GV 16 Berchem TOT
54,Posthofbrug 5366,2020-03-17,07:00:00,144,113,31,FMN GV 16 Berchem TOT
54,Posthofbrug 5366,2020-03-17,08:00:00,144,124,20,FMN GV 16 Berchem TOT
54,Posthofbrug 5366,2020-03-17,09:00:00,74,64,10,FMN GV 16 Berchem TOT
54,Posthofbrug 5366,2020-03-17,10:00:00,62,36,26,FMN GV 16 Berchem TOT
54,Posthofbrug 5366,2020-03-17,11:00:00,74,38,36,FMN GV 16 Berchem TOT
54,Posthofbrug 5366,2020-03-17,12:00:00,80,42,38,FMN GV 16 Berchem TOT
54,Posthofbrug 5366,2020-03-17,13:00:00,74,39,35,FMN GV 16 Berchem TOT
54,Posthofbrug 5366,2020-03-17,14:00:00,111,45,66,FMN GV 16 Berchem TOT
54,Posthofbrug 5366,2020-03-17,15:00:00,139,70,69,FMN GV 16 Berchem TOT
54,Posthofbrug 5366,2020-03-17,16:00:00,166,63,103,FMN GV 16 Berchem TOT
54,Posthofbrug 5366,2020-03-17,17:00:00,186,74,112,FMN GV 16 Berchem TOT
54,Posthofbrug 5366,2020-03-17,18:00:00,106,46,60,FMN GV 16 Berchem TOT
54,Posthofbrug 5366,2020-03-17,19:00:00,51,23,28,FMN GV 16 Berchem TOT
54,Posthofbrug 5366,2020-03-17,20:00:00,18,7,11,FMN GV 16 Berchem TOT
54,Posthofbrug 5366,2020-03-17,21:00:00,12,6,6,FMN GV 16 Berchem TOT
54,Posthofbrug 5366,2020-03-17,22:00:00,14,7,7,FMN GV 16 Berchem TOT
54,Posthofbrug 5366,2020-03-17,23:00:00,6,6,0,FMN GV 16 Berchem TOT
54,Posthofbrug 5366,2020-03-18,00:00:00,2,0,2,FMN GV 16 Berchem TOT
54,Posthofbrug 5366,2020-03-18,01:00:00,3,0,3,FMN GV 16 Berchem TOT
54,Posthofbrug 5366,2020-03-18,02:00:00,1,0,1,FMN GV 16 Berchem TOT
54,Posthofbrug 5366,2020-03-18,03:00:00,0,0,0,FMN GV 16 Berchem TOT
54,Posthofbrug 5366,2020-03-18,04:00:00,6,4,2,FMN GV 16 Berchem TOT
54,Posthofbrug 5366,2020-03-18,05:00:00,11,8,3,FMN GV 16 Berchem TOT
54,Posthofbrug 5366,2020-03-18,06:00:00,43,33,10,FMN GV 16 Berchem TOT
54,Posthofbrug 5366,2020-03-18,07:00:00,97,68,29,FMN GV 16 Berchem TOT
54,Posthofbrug 5366,2020-03-18,08:00:00,105,82,23,FMN GV 16 Berchem TOT
54,Posthofbrug 5366,2020-03-18,09:00:00,49,40,9,FMN GV 16 Berchem TOT
54,Posthofbrug 5366,2020-03-18,10:00:00,63,35,28,FMN GV 16 Berchem TOT
54,Posthofbrug 5366,2020-03-18,11:00:00,73,35,38,FMN GV 16 Berchem TOT
54,Posthofbrug 5366,2020-03-18,12:00:00,74,32,42,FMN GV 16 Berchem TOT
54,Posthofbrug 5366,2020-03-18,13:00:00,63,31,32,FMN GV 16 Berchem TOT
54,Posthofbrug 5366,2020-03-18,14:00:00,75,36,39,FMN GV 16 Berchem TOT
54,Posthofbrug 5366,2020-03-18,15:00:00,100,52,48,FMN GV 16 Berchem TOT
54,Posthofbrug 5366,2020-03-18,16:00:00,155,64,91,FMN GV 16 Berchem TOT
54,Posthofbrug 5366,2020-03-18,17:00:00,147,65,82,FMN GV 16 Berchem TOT
54,Posthofbrug 5366,2020-03-18,18:00:00,73,38,35,FMN GV 16 Berchem TOT
54,Posthofbrug 5366,2020-03-18,19:00:00,41,28,13,FMN GV 16 Berchem TOT
54,Posthofbrug 5366,2020-03-18,20:00:00,21,13,8,FMN GV 16 Berchem TOT
54,Posthofbrug 5366,2020-03-18,21:00:00,10,2,8,FMN GV 16 Berchem TOT
54,Posthofbrug 5366,2020-03-18,22:00:00,10,3,7,FMN GV 16 Berchem TOT
54,Posthofbrug 5366,2020-03-18,23:00:00,6,4,2,FMN GV 16 Berchem TOT
54,Posthofbrug 5366,2020-03-19,00:00:00,3,1,2,FMN GV 16 Berchem TOT
54,Posthofbrug 5366,2020-03-19,01:00:00,0,0,0,FMN GV 16 Berchem TOT
54,Posthofbrug 5366,2020-03-19,02:00:00,0,0,0,FMN GV 16 Berchem TOT
54,Posthofbrug 5366,2020-03-19,03:00:00,2,0,2,FMN GV 16 Berchem TOT
54,Posthofbrug 5366,2020-03-19,04:00:00,5,5,0,FMN GV 16 Berchem TOT
54,Posthofbrug 5366,2020-03-19,05:00:00,15,13,2,FMN GV 16 Berchem TOT
54,Posthofbrug 5366,2020-03-19,06:00:00,46,35,11,FMN GV 16 Berchem TOT
54,Posthofbrug 5366,2020-03-19,07:00:00,95,74,21,FMN GV 16 Berchem TOT
54,Posthofbrug 5366,2020-03-19,08:00:00,76,56,20,FMN GV 16 Berchem TOT
54,Posthofbrug 5366,2020-03-19,09:00:00,32,18,14,FMN GV 16 Berchem TOT
54,Posthofbrug 5366,2020-03-19,10:00:00,26,22,4,FMN GV 16 Berchem TOT
54,Posthofbrug 5366,2020-03-19,11:00:00,36,24,12,FMN GV 16 Berchem TOT
54,Posthofbrug 5366,2020-03-19,12:00:00,61,34,27,FMN GV 16 Berchem TOT
54,Posthofbrug 5366,2020-03-19,13:00:00,59,29,30,FMN GV 16 Berchem TOT
54,Posthofbrug 5366,2020-03-19,14:00:00,80,39,41,FMN GV 16 Berchem TOT
54,Posthofbrug 5366,2020-03-19,15:00:00,100,46,54,FMN GV 16 Berchem TOT
54,Posthofbrug 5366,2020-03-19,16:00:00,91,31,60,FMN GV 16 Berchem TOT
54,Posthofbrug 5366,2020-03-19,17:00:00,117,38,79,FMN GV 16 Berchem TOT
54,Posthofbrug 5366,2020-03-19,18:00:00,98,52,46,FMN GV 16 Berchem TOT
54,Posthofbrug 5366,2020-03-19,19:00:00,30,11,19,FMN GV 16 Berchem TOT
54,Posthofbrug 5366,2020-03-19,20:00:00,28,16,12,FMN GV 16 Berchem TOT
54,Posthofbrug 5366,2020-03-19,21:00:00,10,5,5,FMN GV 16 Berchem TOT
54,Posthofbrug 5366,2020-03-19,22:00:00,10,5,5,FMN GV 16 Berchem TOT
54,Posthofbrug 5366,2020-03-19,23:00:00,2,1,1,FMN GV 16 Berchem TOT
54,Posthofbrug 5366,2020-03-20,00:00:00,0,0,0,FMN GV 16 Berchem TOT
54,Posthofbrug 5366,2020-03-20,01:00:00,3,1,2,FMN GV 16 Berchem TOT
54,Posthofbrug 5366,2020-03-20,02:00:00,2,1,1,FMN GV 16 Berchem TOT
54,Posthofbrug 5366,2020-03-20,03:00:00,0,0,0,FMN GV 16 Berchem TOT
54,Posthofbrug 5366,2020-03-20,04:00:00,3,2,1,FMN GV 16 Berchem TOT
54,Posthofbrug 5366,2020-03-20,05:00:00,12,10,2,FMN GV 16 Berchem TOT
54,Posthofbrug 5366,2020-03-20,06:00:00,27,19,8,FMN GV 16 Berchem TOT
54,Posthofbrug 5366,2020-03-20,07:00:00,69,54,15,FMN GV 16 Berchem TOT
54,Posthofbrug 5366,2020-03-20,08:00:00,71,51,20,FMN GV 16 Berchem TOT
54,Posthofbrug 5366,2020-03-20,09:00:00,34,22,12,FMN GV 16 Berchem TOT
54,Posthofbrug 5366,2020-03-20,10:00:00,30,21,9,FMN GV 16 Berchem TOT
54,Posthofbrug 5366,2020-03-20,11:00:00,31,19,12,FMN GV 16 Berchem TOT
54,Posthofbrug 5366,2020-03-20,12:00:00,47,31,16,FMN GV 16 Berchem TOT
54,Posthofbrug 5366,2020-03-20,13:00:00,37,23,14,FMN GV 16 Berchem TOT
54,Posthofbrug 5366,2020-03-20,14:00:00,44,15,29,FMN GV 16 Berchem TOT
54,Posthofbrug 5366,2020-03-20,15:00:00,49,22,27,FMN GV 16 Berchem TOT
54,Posthofbrug 5366,2020-03-20,16:00:00,79,39,40,FMN GV 16 Berchem TOT
54,Posthofbrug 5366,2020-03-20,17:00:00,71,19,52,FMN GV 16 Berchem TOT
54,Posthofbrug 5366,2020-03-20,18:00:00,46,20,26,FMN GV 16 Berchem TOT
54,Posthofbrug 5366,2020-03-20,19:00:00,16,7,9,FMN GV 16 Berchem TOT
54,Posthofbrug 5366,2020-03-20,20:00:00,17,7,10,FMN GV 16 Berchem TOT
54,Posthofbrug 5366,2020-03-20,21:00:00,11,5,6,FMN GV 16 Berchem TOT
54,Posthofbrug 5366,2020-03-20,22:00:00,10,3,7,FMN GV 16 Berchem TOT
54,Posthofbrug 5366,2020-03-20,23:00:00,1,0,1,FMN GV 16 Berchem TOT
54,Posthofbrug 5366,2020-03-21,00:00:00,2,1,1,FMN GV 16 Berchem TOT
54,Posthofbrug 5366,2020-03-21,01:00:00,3,1,2,FMN GV 16 Berchem TOT
54,Posthofbrug 5366,2020-03-21,02:00:00,1,1,0,FMN GV 16 Berchem TOT
54,Posthofbrug 5366,2020-03-21,03:00:00,1,0,1,FMN GV 16 Berchem TOT
54,Posthofbrug 5366,2020-03-21,04:00:00,4,3,1,FMN GV 16 Berchem TOT
54,Posthofbrug 5366,2020-03-21,05:00:00,2,1,1,FMN GV 16 Berchem TOT
54,Posthofbrug 5366,2020-03-21,06:00:00,5,5,0,FMN GV 16 Berchem TOT
54,Posthofbrug 5366,2020-03-21,07:00:00,11,7,4,FMN GV 16 Berchem TOT
54,Posthofbrug 5366,2020-03-21,08:00:00,22,11,11,FMN GV 16 Berchem TOT
54,Posthofbrug 5366,2020-03-21,09:00:00,32,17,15,FMN GV 16 Berchem TOT
54,Posthofbrug 5366,2020-03-21,10:00:00,52,26,26,FMN GV 16 Berchem TOT
54,Posthofbrug 5366,2020-03-21,11:00:00,77,38,39,FMN GV 16 Berchem TOT
54,Posthofbrug 5366,2020-03-21,12:00:00,103,52,51,FMN GV 16 Berchem TOT
54,Posthofbrug 5366,2020-03-21,13:00:00,128,66,62,FMN GV 16 Berchem TOT
54,Posthofbrug 5366,2020-03-21,14:00:00,184,89,95,FMN GV 16 Berchem TOT
54,Posthofbrug 5366,2020-03-21,15:00:00,122,72,50,FMN GV 16 Berchem TOT
54,Posthofbrug 5366,2020-03-21,16:00:00,124,79,45,FMN GV 16 Berchem TOT
54,Posthofbrug 5366,2020-03-21,17:00:00,90,53,37,FMN GV 16 Berchem TOT
54,Posthofbrug 5366,2020-03-21,18:00:00,49,34,15,FMN GV 16 Berchem TOT
54,Posthofbrug 5366,2020-03-21,19:00:00,16,9,7,FMN GV 16 Berchem TOT
54,Posthofbrug 5366,2020-03-21,20:00:00,11,5,6,FMN GV 16 Berchem TOT
54,Posthofbrug 5366,2020-03-21,21:00:00,10,4,6,FMN GV 16 Berchem TOT
54,Posthofbrug 5366,2020-03-21,22:00:00,7,1,6,FMN GV 16 Berchem TOT
54,Posthofbrug 5366,2020-03-21,23:00:00,4,3,1,FMN GV 16 Berchem TOT
54,Posthofbrug 5366,2020-03-22,00:00:00,3,1,2,FMN GV 16 Berchem TOT
54,Posthofbrug 5366,2020-03-22,01:00:00,2,2,0,FMN GV 16 Berchem TOT
54,Posthofbrug 5366,2020-03-22,02:00:00,1,0,1,FMN GV 16 Berchem TOT
54,Posthofbrug 5366,2020-03-22,03:00:00,2,1,1,FMN GV 16 Berchem TOT
54,Posthofbrug 5366,2020-03-22,04:00:00,1,1,0,FMN GV 16 Berchem TOT
54,Posthofbrug 5366,2020-03-22,05:00:00,4,3,1,FMN GV 16 Berchem TOT
54,Posthofbrug 5366,2020-03-22,06:00:00,4,3,1,FMN GV 16 Berchem TOT
54,Posthofbrug 5366,2020-03-22,07:00:00,8,4,4,FMN GV 16 Berchem TOT
54,Posthofbrug 5366,2020-03-22,08:00:00,16,8,8,FMN GV 16 Berchem TOT
54,Posthofbrug 5366,2020-03-22,09:00:00,33,16,17,FMN GV 16 Berchem TOT
54,Posthofbrug 5366,2020-03-22,10:00:00,47,17,30,FMN GV 16 Berchem TOT
54,Posthofbrug 5366,2020-03-22,11:00:00,94,40,54,FMN GV 16 Berchem TOT
54,Posthofbrug 5366,2020-03-22,12:00:00,103,55,48,FMN GV 16 Berchem TOT
54,Posthofbrug 5366,2020-03-22,13:00:00,161,82,79,FMN GV 16 Berchem TOT
54,Posthofbrug 5366,2020-03-22,14:00:00,228,111,117,FMN GV 16 Berchem TOT
54,Posthofbrug 5366,2020-03-22,15:00:00,154,88,66,FMN GV 16 Berchem TOT
54,Posthofbrug 5366,2020-03-22,16:00:00,171,104,67,FMN GV 16 Berchem TOT
54,Posthofbrug 5366,2020-03-22,17:00:00,115,75,40,FMN GV 16 Berchem TOT
54,Posthofbrug 5366,2020-03-22,18:00:00,55,40,15,FMN GV 16 Berchem TOT
54,Posthofbrug 5366,2020-03-22,19:00:00,24,16,8,FMN GV 16 Berchem TOT
54,Posthofbrug 5366,2020-03-22,20:00:00,15,8,7,FMN GV 16 Berchem TOT
54,Posthofbrug 5366,2020-03-22,21:00:00,9,4,5,FMN GV 16 Berchem TOT
54,Posthofbrug 5366,2020-03-22,22:00:00,4,2,2,FMN GV 16 Berchem TOT
54,Posthofbrug 5366,2020-03-22,23:00:00,4,1,3,FMN GV 16 Berchem TOT
54,Posthofbrug 5366,2020-03-23,00:00:00,2,1,1,FMN GV 16 Berchem TOT
54,Posthofbrug 5366,2020-03-23,01:00:00,1,1,0,FMN GV 16 Berchem TOT
54,Posthofbrug 5366,2020-03-23,02:00:00,1,0,1,FMN GV 16 Berchem TOT
54,Posthofbrug 5366,2020-03-23,03:00:00,2,0,2,FMN GV 16 Berchem TOT
54,Posthofbrug 5366,2020-03-23,04:00:00,7,5,2,FMN GV 16 Berchem TOT
54,Posthofbrug 5366,2020-03-23,05:00:00,9,7,2,FMN GV 16 Berchem TOT
54,Posthofbrug 5366,2020-03-23,06:00:00,30,23,7,FMN GV 16 Berchem TOT
54,Posthofbrug 5366,2020-03-23,07:00:00,68,53,15,FMN GV 16 Berchem TOT
54,Posthofbrug 5366,2020-03-23,08:00:00,96,70,26,FMN GV 16 Berchem TOT
54,Posthofbrug 5366,2020-03-23,09:00:00,39,28,11,FMN GV 16 Berchem TOT
54,Posthofbrug 5366,2020-03-23,10:00:00,38,24,14,FMN GV 16 Berchem TOT
54,Posthofbrug 5366,2020-03-23,11:00:00,46,27,19,FMN GV 16 Berchem TOT
54,Posthofbrug 5366,2020-03-23,12:00:00,66,34,32,FMN GV 16 Berchem TOT
54,Posthofbrug 5366,2020-03-23,13:00:00,66,22,44,FMN GV 16 Berchem TOT
54,Posthofbrug 5366,2020-03-23,14:00:00,96,49,47,FMN GV 16 Berchem TOT
54,Posthofbrug 5366,2020-03-23,15:00:00,86,42,44,FMN GV 16 Berchem TOT
54,Posthofbrug 5366,2020-03-23,16:00:00,85,39,46,FMN GV 16 Berchem TOT
54,Posthofbrug 5366,2020-03-23,17:00:00,104,41,63,FMN GV 16 Berchem TOT
54,Posthofbrug 5366,2020-03-23,18:00:00,86,36,50,FMN GV 16 Berchem TOT
54,Posthofbrug 5366,2020-03-23,19:00:00,27,10,17,FMN GV 16 Berchem TOT
54,Posthofbrug 5366,2020-03-23,20:00:00,20,12,8,FMN GV 16 Berchem TOT
54,Posthofbrug 5366,2020-03-23,21:00:00,6,2,4,FMN GV 16 Berchem TOT
54,Posthofbrug 5366,2020-03-23,22:00:00,7,3,4,FMN GV 16 Berchem TOT
54,Posthofbrug 5366,2020-03-23,23:00:00,2,0,2,FMN GV 16 Berchem TOT
54,Posthofbrug 5366,2020-03-24,00:00:00,1,1,0,FMN GV 16 Berchem TOT
54,Posthofbrug 5366,2020-03-24,01:00:00,1,0,1,FMN GV 16 Berchem TOT
54,Posthofbrug 5366,2020-03-24,02:00:00,2,0,2,FMN GV 16 Berchem TOT
54,Posthofbrug 5366,2020-03-24,03:00:00,1,1,0,FMN GV 16 Berchem TOT
54,Posthofbrug 5366,2020-03-24,04:00:00,6,4,2,FMN GV 16 Berchem TOT
54,Posthofbrug 5366,2020-03-24,05:00:00,5,3,2,FMN GV 16 Berchem TOT
54,Posthofbrug 5366,2020-03-24,06:00:00,27,22,5,FMN GV 16 Berchem TOT
54,Posthofbrug 5366,2020-03-24,07:00:00,63,45,18,FMN GV 16 Berchem TOT
54,Posthofbrug 5366,2020-03-24,08:00:00,93,73,20,FMN GV 16 Berchem TOT
54,Posthofbrug 5366,2020-03-24,09:00:00,27,16,11,FMN GV 16 Berchem TOT
54,Posthofbrug 5366,2020-03-24,10:00:00,33,19,14,FMN GV 16 Berchem TOT
54,Posthofbrug 5366,2020-03-24,11:00:00,59,34,25,FMN GV 16 Berchem TOT
54,Posthofbrug 5366,2020-03-24,12:00:00,62,36,26,FMN GV 16 Berchem TOT
54,Posthofbrug 5366,2020-03-24,13:00:00,74,45,29,FMN GV 16 Berchem TOT
54,Posthofbrug 5366,2020-03-24,14:00:00,119,53,66,FMN GV 16 Berchem TOT
54,Posthofbrug 5366,2020-03-24,15:00:00,104,48,56,FMN GV 16 Berchem TOT
54,Posthofbrug 5366,2020-03-24,16:00:00,131,57,74,FMN GV 16 Berchem TOT
54,Posthofbrug 5366,2020-03-24,17:00:00,136,50,86,FMN GV 16 Berchem TOT
54,Posthofbrug 5366,2020-03-24,18:00:00,87,55,32,FMN GV 16 Berchem TOT
54,Posthofbrug 5366,2020-03-24,19:00:00,37,22,15,FMN GV 16 Berchem TOT
54,Posthofbrug 5366,2020-03-24,20:00:00,22,11,11,FMN GV 16 Berchem TOT
54,Posthofbrug 5366,2020-03-24,21:00:00,10,4,6,FMN GV 16 Berchem TOT
54,Posthofbrug 5366,2020-03-24,22:00:00,10,5,5,FMN GV 16 Berchem TOT
54,Posthofbrug 5366,2020-03-24,23:00:00,3,0,3,FMN GV 16 Berchem TOT
54,Posthofbrug 5366,2020-03-25,00:00:00,2,2,0,FMN GV 16 Berchem TOT
54,Posthofbrug 5366,2020-03-25,01:00:00,1,1,0,FMN GV 16 Berchem TOT
54,Posthofbrug 5366,2020-03-25,02:00:00,1,0,1,FMN GV 16 Berchem TOT
54,Posthofbrug 5366,2020-03-25,03:00:00,1,1,0,FMN GV 16 Berchem TOT
54,Posthofbrug 5366,2020-03-25,04:00:00,6,4,2,FMN GV 16 Berchem TOT
54,Posthofbrug 5366,2020-03-25,05:00:00,6,4,2,FMN GV 16 Berchem TOT
54,Posthofbrug 5366,2020-03-25,06:00:00,28,23,5,FMN GV 16 Berchem TOT
54,Posthofbrug 5366,2020-03-25,07:00:00,66,43,23,FMN GV 16 Berchem TOT
54,Posthofbrug 5366,2020-03-25,08:00:00,61,44,17,FMN GV 16 Berchem TOT
54,Posthofbrug 5366,2020-03-25,09:00:00,35,23,12,FMN GV 16 Berchem TOT
54,Posthofbrug 5366,2020-03-25,10:00:00,47,22,25,FMN GV 16 Berchem TOT
54,Posthofbrug 5366,2020-03-25,11:00:00,56,30,26,FMN GV 16 Berchem TOT
54,Posthofbrug 5366,2020-03-25,12:00:00,79,39,40,FMN GV 16 Berchem TOT
54,Posthofbrug 5366,2020-03-25,13:00:00,81,37,44,FMN GV 16 Berchem TOT
54,Posthofbrug 5366,2020-03-25,14:00:00,104,52,52,FMN GV 16 Berchem TOT
54,Posthofbrug 5366,2020-03-25,15:00:00,154,82,72,FMN GV 16 Berchem TOT
54,Posthofbrug 5366,2020-03-25,16:00:00,118,56,62,FMN GV 16 Berchem TOT
54,Posthofbrug 5366,2020-03-25,17:00:00,176,91,85,FMN GV 16 Berchem TOT
54,Posthofbrug 5366,2020-03-25,18:00:00,93,53,40,FMN GV 16 Berchem TOT
54,Posthofbrug 5366,2020-03-25,19:00:00,39,18,21,FMN GV 16 Berchem TOT
54,Posthofbrug 5366,2020-03-25,20:00:00,17,8,9,FMN GV 16 Berchem TOT
54,Posthofbrug 5366,2020-03-25,21:00:00,25,11,14,FMN GV 16 Berchem TOT
54,Posthofbrug 5366,2020-03-25,22:00:00,11,6,5,FMN GV 16 Berchem TOT
54,Posthofbrug 5366,2020-03-25,23:00:00,5,4,1,FMN GV 16 Berchem TOT
54,Posthofbrug 5366,2020-03-26,00:00:00,15,7,8,FMN GV 16 Berchem TOT
54,Posthofbrug 5366,2020-03-26,01:00:00,1,0,1,FMN GV 16 Berchem TOT
54,Posthofbrug 5366,2020-03-26,02:00:00,0,0,0,FMN GV 16 Berchem TOT
54,Posthofbrug 5366,2020-03-26,03:00:00,2,2,0,FMN GV 16 Berchem TOT
54,Posthofbrug 5366,2020-03-26,04:00:00,7,5,2,FMN GV 16 Berchem TOT
54,Posthofbrug 5366,2020-03-26,05:00:00,9,6,3,FMN GV 16 Berchem TOT
54,Posthofbrug 5366,2020-03-26,06:00:00,16,10,6,FMN GV 16 Berchem TOT
54,Posthofbrug 5366,2020-03-26,07:00:00,73,51,22,FMN GV 16 Berchem TOT
54,Posthofbrug 5366,2020-03-26,08:00:00,70,57,13,FMN GV 16 Berchem TOT
54,Posthofbrug 5366,2020-03-26,09:00:00,42,28,14,FMN GV 16 Berchem TOT
54,Posthofbrug 5366,2020-03-26,10:00:00,54,36,18,FMN GV 16 Berchem TOT
54,Posthofbrug 5366,2020-03-26,11:00:00,51,29,22,FMN GV 16 Berchem TOT
54,Posthofbrug 5366,2020-03-26,12:00:00,55,27,28,FMN GV 16 Berchem TOT
54,Posthofbrug 5366,2020-03-26,13:00:00,77,39,38,FMN GV 16 Berchem TOT
54,Posthofbrug 5366,2020-03-26,14:00:00,103,46,57,FMN GV 16 Berchem TOT
54,Posthofbrug 5366,2020-03-26,15:00:00,96,45,51,FMN GV 16 Berchem TOT
54,Posthofbrug 5366,2020-03-26,16:00:00,112,51,61,FMN GV 16 Berchem TOT
54,Posthofbrug 5366,2020-03-26,17:00:00,137,65,72,FMN GV 16 Berchem TOT
54,Posthofbrug 5366,2020-03-26,18:00:00,82,38,44,FMN GV 16 Berchem TOT
54,Posthofbrug 5366,2020-03-26,19:00:00,47,27,20,FMN GV 16 Berchem TOT
54,Posthofbrug 5366,2020-03-26,20:00:00,24,14,10,FMN GV 16 Berchem TOT
54,Posthofbrug 5366,2020-03-26,21:00:00,17,6,11,FMN GV 16 Berchem TOT
54,Posthofbrug 5366,2020-03-26,22:00:00,18,6,12,FMN GV 16 Berchem TOT
54,Posthofbrug 5366,2020-03-26,23:00:00,7,6,1,FMN GV 16 Berchem TOT
54,Posthofbrug 5366,2020-03-27,00:00:00,2,2,0,FMN GV 16 Berchem TOT
54,Posthofbrug 5366,2020-03-27,01:00:00,4,1,3,FMN GV 16 Berchem TOT
54,Posthofbrug 5366,2020-03-27,02:00:00,0,0,0,FMN GV 16 Berchem TOT
54,Posthofbrug 5366,2020-03-27,03:00:00,0,0,0,FMN GV 16 Berchem TOT
54,Posthofbrug 5366,2020-03-27,04:00:00,4,3,1,FMN GV 16 Berchem TOT
54,Posthofbrug 5366,2020-03-27,05:00:00,9,8,1,FMN GV 16 Berchem TOT
54,Posthofbrug 5366,2020-03-27,06:00:00,26,21,5,FMN GV 16 Berchem TOT
54,Posthofbrug 5366,2020-03-27,07:00:00,53,33,20,FMN GV 16 Berchem TOT
54,Posthofbrug 5366,2020-03-27,08:00:00,54,40,14,FMN GV 16 Berchem TOT
54,Posthofbrug 5366,2020-03-27,09:00:00,39,28,11,FMN GV 16 Berchem TOT
54,Posthofbrug 5366,2020-03-27,10:00:00,53,27,26,FMN GV 16 Berchem TOT
54,Posthofbrug 5366,2020-03-27,11:00:00,61,37,24,FMN GV 16 Berchem TOT
54,Posthofbrug 5366,2020-03-27,12:00:00,79,42,37,FMN GV 16 Berchem TOT
54,Posthofbrug 5366,2020-03-27,13:00:00,75,43,32,FMN GV 16 Berchem TOT
54,Posthofbrug 5366,2020-03-27,14:00:00,95,51,44,FMN GV 16 Berchem TOT
54,Posthofbrug 5366,2020-03-27,15:00:00,108,57,51,FMN GV 16 Berchem TOT
54,Posthofbrug 5366,2020-03-27,16:00:00,143,70,73,FMN GV 16 Berchem TOT
54,Posthofbrug 5366,2020-03-27,17:00:00,117,58,59,FMN GV 16 Berchem TOT
54,Posthofbrug 5366,2020-03-27,18:00:00,89,47,42,FMN GV 16 Berchem TOT
54,Posthofbrug 5366,2020-03-27,19:00:00,37,14,23,FMN GV 16 Berchem TOT
54,Posthofbrug 5366,2020-03-27,20:00:00,25,15,10,FMN GV 16 Berchem TOT
54,Posthofbrug 5366,2020-03-27,21:00:00,25,15,10,FMN GV 16 Berchem TOT
54,Posthofbrug 5366,2020-03-27,22:00:00,13,2,11,FMN GV 16 Berchem TOT
54,Posthofbrug 5366,2020-03-27,23:00:00,12,7,5,FMN GV 16 Berchem TOT
54,Posthofbrug 5366,2020-03-28,00:00:00,3,2,1,FMN GV 16 Berchem TOT
54,Posthofbrug 5366,2020-03-28,01:00:00,2,1,1,FMN GV 16 Berchem TOT
54,Posthofbrug 5366,2020-03-28,02:00:00,0,0,0,FMN GV 16 Berchem TOT
54,Posthofbrug 5366,2020-03-28,03:00:00,0,0,0,FMN GV 16 Berchem TOT
54,Posthofbrug 5366,2020-03-28,04:00:00,2,2,0,FMN GV 16 Berchem TOT
54,Posthofbrug 5366,2020-03-28,05:00:00,5,3,2,FMN GV 16 Berchem TOT
54,Posthofbrug 5366,2020-03-28,06:00:00,16,12,4,FMN GV 16 Berchem TOT
54,Posthofbrug 5366,2020-03-28,07:00:00,18,12,6,FMN GV 16 Berchem TOT
54,Posthofbrug 5366,2020-03-28,08:00:00,18,9,9,FMN GV 16 Berchem TOT
54,Posthofbrug 5366,2020-03-28,09:00:00,35,16,19,FMN GV 16 Berchem TOT
54,Posthofbrug 5366,2020-03-28,10:00:00,79,28,51,FMN GV 16 Berchem TOT
54,Posthofbrug 5366,2020-03-28,11:00:00,101,44,57,FMN GV 16 Berchem TOT
54,Posthofbrug 5366,2020-03-28,12:00:00,113,65,48,FMN GV 16 Berchem TOT
54,Posthofbrug 5366,2020-03-28,13:00:00,183,85,98,FMN GV 16 Berchem TOT
54,Posthofbrug 5366,2020-03-28,14:00:00,211,100,111,FMN GV 16 Berchem TOT
54,Posthofbrug 5366,2020-03-28,15:00:00,218,115,103,FMN GV 16 Berchem TOT
54,Posthofbrug 5366,2020-03-28,16:00:00,152,97,55,FMN GV 16 Berchem TOT
54,Posthofbrug 5366,2020-03-28,17:00:00,139,115,24,FMN GV 16 Berchem TOT
54,Posthofbrug 5366,2020-03-28,18:00:00,74,55,19,FMN GV 16 Berchem TOT
54,Posthofbrug 5366,2020-03-28,19:00:00,31,18,13,FMN GV 16 Berchem TOT
54,Posthofbrug 5366,2020-03-28,20:00:00,22,13,9,FMN GV 16 Berchem TOT
54,Posthofbrug 5366,2020-03-28,21:00:00,6,2,4,FMN GV 16 Berchem TOT
54,Posthofbrug 5366,2020-03-28,22:00:00,10,3,7,FMN GV 16 Berchem TOT
54,Posthofbrug 5366,2020-03-28,23:00:00,5,3,2,FMN GV 16 Berchem TOT
54,Posthofbrug 5366,2020-03-29,00:00:00,1,0,1,FMN GV 16 Berchem TOT
54,Posthofbrug 5366,2020-03-29,01:00:00,2,0,2,FMN GV 16 Berchem TOT
54,Posthofbrug 5366,2020-03-29,02:00:00,0,0,0,FMN GV 16 Berchem TOT
54,Posthofbrug 5366,2020-03-29,03:00:00,0,0,0,FMN GV 16 Berchem TOT
54,Posthofbrug 5366,2020-03-29,04:00:00,0,0,0,FMN GV 16 Berchem TOT
54,Posthofbrug 5366,2020-03-29,05:00:00,3,3,0,FMN GV 16 Berchem TOT
54,Posthofbrug 5366,2020-03-29,06:00:00,6,4,2,FMN GV 16 Berchem TOT
54,Posthofbrug 5366,2020-03-29,07:00:00,14,5,9,FMN GV 16 Berchem TOT
54,Posthofbrug 5366,2020-03-29,08:00:00,8,4,4,FMN GV 16 Berchem TOT
54,Posthofbrug 5366,2020-03-29,09:00:00,15,7,8,FMN GV 16 Berchem TOT
54,Posthofbrug 5366,2020-03-29,10:00:00,53,27,26,FMN GV 16 Berchem TOT
54,Posthofbrug 5366,2020-03-29,11:00:00,60,25,35,FMN GV 16 Berchem TOT
54,Posthofbrug 5366,2020-03-29,12:00:00,60,42,18,FMN GV 16 Berchem TOT
54,Posthofbrug 5366,2020-03-29,13:00:00,51,32,19,FMN GV 16 Berchem TOT
54,Posthofbrug 5366,2020-03-29,14:00:00,45,26,19,FMN GV 16 Berchem TOT
54,Posthofbrug 5366,2020-03-29,15:00:00,58,27,31,FMN GV 16 Berchem TOT
54,Posthofbrug 5366,2020-03-29,16:00:00,68,37,31,FMN GV 16 Berchem TOT
54,Posthofbrug 5366,2020-03-29,17:00:00,48,27,21,FMN GV 16 Berchem TOT
54,Posthofbrug 5366,2020-03-29,18:00:00,33,24,9,FMN GV 16 Berchem TOT
54,Posthofbrug 5366,2020-03-29,19:00:00,20,10,10,FMN GV 16 Berchem TOT
54,Posthofbrug 5366,2020-03-29,20:00:00,15,7,8,FMN GV 16 Berchem TOT
54,Posthofbrug 5366,2020-03-29,21:00:00,13,10,3,FMN GV 16 Berchem TOT
54,Posthofbrug 5366,2020-03-29,22:00:00,6,3,3,FMN GV 16 Berchem TOT
54,Posthofbrug 5366,2020-03-29,23:00:00,4,3,1,FMN GV 16 Berchem TOT
54,Posthofbrug 5366,2020-03-30,00:00:00,1,1,0,FMN GV 16 Berchem TOT
54,Posthofbrug 5366,2020-03-30,01:00:00,2,1,1,FMN GV 16 Berchem TOT
54,Posthofbrug 5366,2020-03-30,02:00:00,0,0,0,FMN GV 16 Berchem TOT
54,Posthofbrug 5366,2020-03-30,03:00:00,0,0,0,FMN GV 16 Berchem TOT
54,Posthofbrug 5366,2020-03-30,04:00:00,4,2,2,FMN GV 16 Berchem TOT
54,Posthofbrug 5366,2020-03-30,05:00:00,7,6,1,FMN GV 16 Berchem TOT
54,Posthofbrug 5366,2020-03-30,06:00:00,23,17,6,FMN GV 16 Berchem TOT
54,Posthofbrug 5366,2020-03-30,07:00:00,54,40,14,FMN GV 16 Berchem TOT
54,Posthofbrug 5366,2020-03-30,08:00:00,81,58,23,FMN GV 16 Berchem TOT
54,Posthofbrug 5366,2020-03-30,09:00:00,30,19,11,FMN GV 16 Berchem TOT
54,Posthofbrug 5366,2020-03-30,10:00:00,37,28,9,FMN GV 16 Berchem TOT
54,Posthofbrug 5366,2020-03-30,11:00:00,33,23,10,FMN GV 16 Berchem TOT
54,Posthofbrug 5366,2020-03-30,12:00:00,43,23,20,FMN GV 16 Berchem TOT
54,Posthofbrug 5366,2020-03-30,13:00:00,60,27,33,FMN GV 16 Berchem TOT
54,Posthofbrug 5366,2020-03-30,14:00:00,52,16,36,FMN GV 16 Berchem TOT
54,Posthofbrug 5366,2020-03-30,15:00:00,69,34,35,FMN GV 16 Berchem TOT
54,Posthofbrug 5366,2020-03-30,16:00:00,76,44,32,FMN GV 16 Berchem TOT
54,Posthofbrug 5366,2020-03-30,17:00:00,93,41,52,FMN GV 16 Berchem TOT
54,Posthofbrug 5366,2020-03-30,18:00:00,54,24,30,FMN GV 16 Berchem TOT
54,Posthofbrug 5366,2020-03-30,19:00:00,36,13,23,FMN GV 16 Berchem TOT
54,Posthofbrug 5366,2020-03-30,20:00:00,19,11,8,FMN GV 16 Berchem TOT
54,Posthofbrug 5366,2020-03-30,21:00:00,10,5,5,FMN GV 16 Berchem TOT
54,Posthofbrug 5366,2020-03-30,22:00:00,11,2,9,FMN GV 16 Berchem TOT
54,Posthofbrug 5366,2020-03-30,23:00:00,5,2,3,FMN GV 16 Berchem TOT
54,Posthofbrug 5366,2020-03-31,00:00:00,7,3,4,FMN GV 16 Berchem TOT
54,Posthofbrug 5366,2020-03-31,01:00:00,1,0,1,FMN GV 16 Berchem TOT
54,Posthofbrug 5366,2020-03-31,02:00:00,0,0,0,FMN GV 16 Berchem TOT
54,Posthofbrug 5366,2020-03-31,03:00:00,9,4,5,FMN GV 16 Berchem TOT
54,Posthofbrug 5366,2020-03-31,04:00:00,6,5,1,FMN GV 16 Berchem TOT
54,Posthofbrug 5366,2020-03-31,05:00:00,9,6,3,FMN GV 16 Berchem TOT
54,Posthofbrug 5366,2020-03-31,06:00:00,30,25,5,FMN GV 16 Berchem TOT
54,Posthofbrug 5366,2020-03-31,07:00:00,72,52,20,FMN GV 16 Berchem TOT
54,Posthofbrug 5366,2020-03-31,08:00:00,74,59,15,FMN GV 16 Berchem TOT
54,Posthofbrug 5366,2020-03-31,09:00:00,33,25,8,FMN GV 16 Berchem TOT
54,Posthofbrug 5366,2020-03-31,10:00:00,36,25,11,FMN GV 16 Berchem TOT
54,Posthofbrug 5366,2020-03-31,11:00:00,39,22,17,FMN GV 16 Berchem TOT
54,Posthofbrug 5366,2020-03-31,12:00:00,59,24,35,FMN GV 16 Berchem TOT
54,Posthofbrug 5366,2020-03-31,13:00:00,71,35,36,FMN GV 16 Berchem TOT
54,Posthofbrug 5366,2020-03-31,14:00:00,83,52,31,FMN GV 16 Berchem TOT
54,Posthofbrug 5366,2020-03-31,15:00:00,112,50,62,FMN GV 16 Berchem TOT
54,Posthofbrug 5366,2020-03-31,16:00:00,128,62,66,FMN GV 16 Berchem TOT
54,Posthofbrug 5366,2020-03-31,17:00:00,150,51,99,FMN GV 16 Berchem TOT
54,Posthofbrug 5366,2020-03-31,18:00:00,81,40,41,FMN GV 16 Berchem TOT
54,Posthofbrug 5366,2020-03-31,19:00:00,61,45,16,FMN GV 16 Berchem TOT
54,Posthofbrug 5366,2020-03-31,20:00:00,25,11,14,FMN GV 16 Berchem TOT
54,Posthofbrug 5366,2020-03-31,21:00:00,11,5,6,FMN GV 16 Berchem TOT
54,Posthofbrug 5366,2020-03-31,22:00:00,11,3,8,FMN GV 16 Berchem TOT
54,Posthofbrug 5366,2020-03-31,23:00:00,1,0,1,FMN GV 16 Berchem TOT
54,Posthofbrug 5366,2020-04-01,00:00:00,2,0,2,FMN GV 16 Berchem TOT
54,Posthofbrug 5366,2020-04-01,01:00:00,0,0,0,FMN GV 16 Berchem TOT
54,Posthofbrug 5366,2020-04-01,02:00:00,1,1,0,FMN GV 16 Berchem TOT
54,Posthofbrug 5366,2020-04-01,03:00:00,1,1,0,FMN GV 16 Berchem TOT
54,Posthofbrug 5366,2020-04-01,04:00:00,4,3,1,FMN GV 16 Berchem TOT
54,Posthofbrug 5366,2020-04-01,05:00:00,7,5,2,FMN GV 16 Berchem TOT
54,Posthofbrug 5366,2020-04-01,06:00:00,26,19,7,FMN GV 16 Berchem TOT
54,Posthofbrug 5366,2020-04-01,07:00:00,61,44,17,FMN GV 16 Berchem TOT
54,Posthofbrug 5366,2020-04-01,08:00:00,66,53,13,FMN GV 16 Berchem TOT
54,Posthofbrug 5366,2020-04-01,09:00:00,30,19,11,FMN GV 16 Berchem TOT
54,Posthofbrug 5366,2020-04-01,10:00:00,44,33,11,FMN GV 16 Berchem TOT
54,Posthofbrug 5366,2020-04-01,11:00:00,42,21,21,FMN GV 16 Berchem TOT
54,Posthofbrug 5366,2020-04-01,12:00:00,67,37,30,FMN GV 16 Berchem TOT
54,Posthofbrug 5366,2020-04-01,13:00:00,107,65,42,FMN GV 16 Berchem TOT
54,Posthofbrug 5366,2020-04-01,14:00:00,118,58,60,FMN GV 16 Berchem TOT
54,Posthofbrug 5366,2020-04-01,15:00:00,133,66,67,FMN GV 16 Berchem TOT
54,Posthofbrug 5366,2020-04-01,16:00:00,158,77,81,FMN GV 16 Berchem TOT
54,Posthofbrug 5366,2020-04-01,17:00:00,122,54,68,FMN GV 16 Berchem TOT
54,Posthofbrug 5366,2020-04-01,18:00:00,109,65,44,FMN GV 16 Berchem TOT
54,Posthofbrug 5366,2020-04-01,19:00:00,54,21,33,FMN GV 16 Berchem TOT
54,Posthofbrug 5366,2020-04-01,20:00:00,45,29,16,FMN GV 16 Berchem TOT
54,Posthofbrug 5366,2020-04-01,21:00:00,11,8,3,FMN GV 16 Berchem TOT
54,Posthofbrug 5366,2020-04-01,22:00:00,8,5,3,FMN GV 16 Berchem TOT
54,Posthofbrug 5366,2020-04-01,23:00:00,3,2,1,FMN GV 16 Berchem TOT
54,Posthofbrug 5366,2020-04-02,00:00:00,1,1,0,FMN GV 16 Berchem TOT
54,Posthofbrug 5366,2020-04-02,01:00:00,7,3,4,FMN GV 16 Berchem TOT
54,Posthofbrug 5366,2020-04-02,02:00:00,1,0,1,FMN GV 16 Berchem TOT
54,Posthofbrug 5366,2020-04-02,03:00:00,1,1,0,FMN GV 16 Berchem TOT
54,Posthofbrug 5366,2020-04-02,04:00:00,4,3,1,FMN GV 16 Berchem TOT
54,Posthofbrug 5366,2020-04-02,05:00:00,10,8,2,FMN GV 16 Berchem TOT
54,Posthofbrug 5366,2020-04-02,06:00:00,26,17,9,FMN GV 16 Berchem TOT
54,Posthofbrug 5366,2020-04-02,07:00:00,65,46,19,FMN GV 16 Berchem TOT
54,Posthofbrug 5366,2020-04-02,08:00:00,60,46,14,FMN GV 16 Berchem TOT
54,Posthofbrug 5366,2020-04-02,09:00:00,35,24,11,FMN GV 16 Berchem TOT
54,Posthofbrug 5366,2020-04-02,10:00:00,30,20,10,FMN GV 16 Berchem TOT
54,Posthofbrug 5366,2020-04-02,11:00:00,46,26,20,FMN GV 16 Berchem TOT
54,Posthofbrug 5366,2020-04-02,12:00:00,57,27,30,FMN GV 16 Berchem TOT
54,Posthofbrug 5366,2020-04-02,13:00:00,62,30,32,FMN GV 16 Berchem TOT
54,Posthofbrug 5366,2020-04-02,14:00:00,81,51,30,FMN GV 16 Berchem TOT
54,Posthofbrug 5366,2020-04-02,15:00:00,84,49,35,FMN GV 16 Berchem TOT
54,Posthofbrug 5366,2020-04-02,16:00:00,119,65,54,FMN GV 16 Berchem TOT
54,Posthofbrug 5366,2020-04-02,17:00:00,124,41,83,FMN GV 16 Berchem TOT
54,Posthofbrug 5366,2020-04-02,18:00:00,72,31,41,FMN GV 16 Berchem TOT
54,Posthofbrug 5366,2020-04-02,19:00:00,45,23,22,FMN GV 16 Berchem TOT
54,Posthofbrug 5366,2020-04-02,20:00:00,26,16,10,FMN GV 16 Berchem TOT
54,Posthofbrug 5366,2020-04-02,21:00:00,11,3,8,FMN GV 16 Berchem TOT
54,Posthofbrug 5366,2020-04-02,22:00:00,4,3,1,FMN GV 16 Berchem TOT
54,Posthofbrug 5366,2020-04-02,23:00:00,4,2,2,FMN GV 16 Berchem TOT
54,Posthofbrug 5366,2020-04-03,00:00:00,2,1,1,FMN GV 16 Berchem TOT
54,Posthofbrug 5366,2020-04-03,01:00:00,11,4,7,FMN GV 16 Berchem TOT
54,Posthofbrug 5366,2020-04-03,02:00:00,1,1,0,FMN GV 16 Berchem TOT
54,Posthofbrug 5366,2020-04-03,03:00:00,2,1,1,FMN GV 16 Berchem TOT
54,Posthofbrug 5366,2020-04-03,04:00:00,3,2,1,FMN GV 16 Berchem TOT
54,Posthofbrug 5366,2020-04-03,05:00:00,11,11,0,FMN GV 16 Berchem TOT
54,Posthofbrug 5366,2020-04-03,06:00:00,24,15,9,FMN GV 16 Berchem TOT
54,Posthofbrug 5366,2020-04-03,07:00:00,55,37,18,FMN GV 16 Berchem TOT
54,Posthofbrug 5366,2020-04-03,08:00:00,70,54,16,FMN GV 16 Berchem TOT
54,Posthofbrug 5366,2020-04-03,09:00:00,29,21,8,FMN GV 16 Berchem TOT
54,Posthofbrug 5366,2020-04-03,10:00:00,34,24,10,FMN GV 16 Berchem TOT
54,Posthofbrug 5366,2020-04-03,11:00:00,42,25,17,FMN GV 16 Berchem TOT
54,Posthofbrug 5366,2020-04-03,12:00:00,51,25,26,FMN GV 16 Berchem TOT
54,Posthofbrug 5366,2020-04-03,13:00:00,64,33,31,FMN GV 16 Berchem TOT
54,Posthofbrug 5366,2020-04-03,14:00:00,75,38,37,FMN GV 16 Berchem TOT
54,Posthofbrug 5366,2020-04-03,15:00:00,86,42,44,FMN GV 16 Berchem TOT
54,Posthofbrug 5366,2020-04-03,16:00:00,121,59,62,FMN GV 16 Berchem TOT
54,Posthofbrug 5366,2020-04-03,17:00:00,108,40,68,FMN GV 16 Berchem TOT
54,Posthofbrug 5366,2020-04-03,18:00:00,69,41,28,FMN GV 16 Berchem TOT
54,Posthofbrug 5366,2020-04-03,19:00:00,48,29,19,FMN GV 16 Berchem TOT
54,Posthofbrug 5366,2020-04-03,20:00:00,19,10,9,FMN GV 16 Berchem TOT
54,Posthofbrug 5366,2020-04-03,21:00:00,13,5,8,FMN GV 16 Berchem TOT
54,Posthofbrug 5366,2020-04-03,22:00:00,9,3,6,FMN GV 16 Berchem TOT
54,Posthofbrug 5366,2020-04-03,23:00:00,2,1,1,FMN GV 16 Berchem TOT
54,Posthofbrug 5366,2020-04-04,00:00:00,3,1,2,FMN GV 16 Berchem TOT
54,Posthofbrug 5366,2020-04-04,01:00:00,3,0,3,FMN GV 16 Berchem TOT
54,Posthofbrug 5366,2020-04-04,02:00:00,0,0,0,FMN GV 16 Berchem TOT
54,Posthofbrug 5366,2020-04-04,03:00:00,0,0,0,FMN GV 16 Berchem TOT
54,Posthofbrug 5366,2020-04-04,04:00:00,1,1,0,FMN GV 16 Berchem TOT
54,Posthofbrug 5366,2020-04-04,05:00:00,6,4,2,FMN GV 16 Berchem TOT
54,Posthofbrug 5366,2020-04-04,06:00:00,8,5,3,FMN GV 16 Berchem TOT
54,Posthofbrug 5366,2020-04-04,07:00:00,12,3,9,FMN GV 16 Berchem TOT
54,Posthofbrug 5366,2020-04-04,08:00:00,26,11,15,FMN GV 16 Berchem TOT
54,Posthofbrug 5366,2020-04-04,09:00:00,22,11,11,FMN GV 16 Berchem TOT
54,Posthofbrug 5366,2020-04-04,10:00:00,46,18,28,FMN GV 16 Berchem TOT
54,Posthofbrug 5366,2020-04-04,11:00:00,83,42,41,FMN GV 16 Berchem TOT
54,Posthofbrug 5366,2020-04-04,12:00:00,101,50,51,FMN GV 16 Berchem TOT
54,Posthofbrug 5366,2020-04-04,13:00:00,149,71,78,FMN GV 16 Berchem TOT
54,Posthofbrug 5366,2020-04-04,14:00:00,187,87,100,FMN GV 16 Berchem TOT
54,Posthofbrug 5366,2020-04-04,15:00:00,191,94,97,FMN GV 16 Berchem TOT
54,Posthofbrug 5366,2020-04-04,16:00:00,194,116,78,FMN GV 16 Berchem TOT
54,Posthofbrug 5366,2020-04-04,17:00:00,127,84,43,FMN GV 16 Berchem TOT
54,Posthofbrug 5366,2020-04-04,18:00:00,81,57,24,FMN GV 16 Berchem TOT
54,Posthofbrug 5366,2020-04-04,19:00:00,41,20,21,FMN GV 16 Berchem TOT
54,Posthofbrug 5366,2020-04-04,20:00:00,25,18,7,FMN GV 16 Berchem TOT
54,Posthofbrug 5366,2020-04-04,21:00:00,19,11,8,FMN GV 16 Berchem TOT
54,Posthofbrug 5366,2020-04-04,22:00:00,7,3,4,FMN GV 16 Berchem TOT
54,Posthofbrug 5366,2020-04-04,23:00:00,4,3,1,FMN GV 16 Berchem TOT
54,Posthofbrug 5366,2020-04-05,00:00:00,4,2,2,FMN GV 16 Berchem TOT
54,Posthofbrug 5366,2020-04-05,01:00:00,0,0,0,FMN GV 16 Berchem TOT
54,Posthofbrug 5366,2020-04-05,02:00:00,0,0,0,FMN GV 16 Berchem TOT
54,Posthofbrug 5366,2020-04-05,03:00:00,1,0,1,FMN GV 16 Berchem TOT
54,Posthofbrug 5366,2020-04-05,04:00:00,0,0,0,FMN GV 16 Berchem TOT
54,Posthofbrug 5366,2020-04-05,05:00:00,4,3,1,FMN GV 16 Berchem TOT
54,Posthofbrug 5366,2020-04-05,06:00:00,11,8,3,FMN GV 16 Berchem TOT
54,Posthofbrug 5366,2020-04-05,07:00:00,12,8,4,FMN GV 16 Berchem TOT
54,Posthofbrug 5366,2020-04-05,08:00:00,24,16,8,FMN GV 16 Berchem TOT
54,Posthofbrug 5366,2020-04-05,09:00:00,52,20,32,FMN GV 16 Berchem TOT
54,Posthofbrug 5366,2020-04-05,10:00:00,120,42,78,FMN GV 16 Berchem TOT
54,Posthofbrug 5366,2020-04-05,11:00:00,163,58,105,FMN GV 16 Berchem TOT
54,Posthofbrug 5366,2020-04-05,12:00:00,199,94,105,FMN GV 16 Berchem TOT
54,Posthofbrug 5366,2020-04-05,13:00:00,274,106,168,FMN GV 16 Berchem TOT
54,Posthofbrug 5366,2020-04-05,14:00:00,323,167,156,FMN GV 16 Berchem TOT
54,Posthofbrug 5366,2020-04-05,15:00:00,277,154,123,FMN GV 16 Berchem TOT
54,Posthofbrug 5366,2020-04-05,16:00:00,229,132,97,FMN GV 16 Berchem TOT
54,Posthofbrug 5366,2020-04-05,17:00:00,203,146,57,FMN GV 16 Berchem TOT
54,Posthofbrug 5366,2020-04-05,18:00:00,141,101,40,FMN GV 16 Berchem TOT
54,Posthofbrug 5366,2020-04-05,19:00:00,86,59,27,FMN GV 16 Berchem TOT
54,Posthofbrug 5366,2020-04-05,20:00:00,44,30,14,FMN GV 16 Berchem TOT
54,Posthofbrug 5366,2020-04-05,21:00:00,17,11,6,FMN GV 16 Berchem TOT
54,Posthofbrug 5366,2020-04-05,22:00:00,20,12,8,FMN GV 16 Berchem TOT
54,Posthofbrug 5366,2020-04-05,23:00:00,6,3,3,FMN GV 16 Berchem TOT
54,Posthofbrug 5366,2020-04-06,00:00:00,1,0,1,FMN GV 16 Berchem TOT
54,Posthofbrug 5366,2020-04-06,01:00:00,1,0,1,FMN GV 16 Berchem TOT
54,Posthofbrug 5366,2020-04-06,02:00:00,0,0,0,FMN GV 16 Berchem TOT
54,Posthofbrug 5366,2020-04-06,03:00:00,0,0,0,FMN GV 16 Berchem TOT
54,Posthofbrug 5366,2020-04-06,04:00:00,6,5,1,FMN GV 16 Berchem TOT
54,Posthofbrug 5366,2020-04-06,05:00:00,11,9,2,FMN GV 16 Berchem TOT
54,Posthofbrug 5366,2020-04-06,06:00:00,39,31,8,FMN GV 16 Berchem TOT
54,Posthofbrug 5366,2020-04-06,07:00:00,70,46,24,FMN GV 16 Berchem TOT
54,Posthofbrug 5366,2020-04-06,08:00:00,100,76,24,FMN GV 16 Berchem TOT
54,Posthofbrug 5366,2020-04-06,09:00:00,45,24,21,FMN GV 16 Berchem TOT
54,Posthofbrug 5366,2020-04-06,10:00:00,57,31,26,FMN GV 16 Berchem TOT
54,Posthofbrug 5366,2020-04-06,11:00:00,85,47,38,FMN GV 16 Berchem TOT
54,Posthofbrug 5366,2020-04-06,12:00:00,88,56,32,FMN GV 16 Berchem TOT
54,Posthofbrug 5366,2020-04-06,13:00:00,120,69,51,FMN GV 16 Berchem TOT
54,Posthofbrug 5366,2020-04-06,14:00:00,148,74,74,FMN GV 16 Berchem TOT
54,Posthofbrug 5366,2020-04-06,15:00:00,120,49,71,FMN GV 16 Berchem TOT
54,Posthofbrug 5366,2020-04-06,16:00:00,159,61,98,FMN GV 16 Berchem TOT
54,Posthofbrug 5366,2020-04-06,17:00:00,195,100,95,FMN GV 16 Berchem TOT
54,Posthofbrug 5366,2020-04-06,18:00:00,83,36,47,FMN GV 16 Berchem TOT
54,Posthofbrug 5366,2020-04-06,19:00:00,51,30,21,FMN GV 16 Berchem TOT
54,Posthofbrug 5366,2020-04-06,20:00:00,28,19,9,FMN GV 16 Berchem TOT
54,Posthofbrug 5366,2020-04-06,21:00:00,15,9,6,FMN GV 16 Berchem TOT
54,Posthofbrug 5366,2020-04-06,22:00:00,11,5,6,FMN GV 16 Berchem TOT
54,Posthofbrug 5366,2020-04-06,23:00:00,1,0,1,FMN GV 16 Berchem TOT
54,Posthofbrug 5366,2020-04-07,00:00:00,1,0,1,FMN GV 16 Berchem TOT
54,Posthofbrug 5366,2020-04-07,01:00:00,3,1,2,FMN GV 16 Berchem TOT
54,Posthofbrug 5366,2020-04-07,02:00:00,1,0,1,FMN GV 16 Berchem TOT
54,Posthofbrug 5366,2020-04-07,03:00:00,0,0,0,FMN GV 16 Berchem TOT
54,Posthofbrug 5366,2020-04-07,04:00:00,6,2,4,FMN GV 16 Berchem TOT
54,Posthofbrug 5366,2020-04-07,05:00:00,9,8,1,FMN GV 16 Berchem TOT
54,Posthofbrug 5366,2020-04-07,06:00:00,32,27,5,FMN GV 16 Berchem TOT
54,Posthofbrug 5366,2020-04-07,07:00:00,77,50,27,FMN GV 16 Berchem TOT
54,Posthofbrug 5366,2020-04-07,08:00:00,91,70,21,FMN GV 16 Berchem TOT
54,Posthofbrug 5366,2020-04-07,09:00:00,53,44,9,FMN GV 16 Berchem TOT
54,Posthofbrug 5366,2020-04-07,10:00:00,62,42,20,FMN GV 16 Berchem TOT
54,Posthofbrug 5366,2020-04-07,11:00:00,93,59,34,FMN GV 16 Berchem TOT
54,Posthofbrug 5366,2020-04-07,12:00:00,85,41,44,FMN GV 16 Berchem TOT
54,Posthofbrug 5366,2020-04-07,13:00:00,125,76,49,FMN GV 16 Berchem TOT
54,Posthofbrug 5366,2020-04-07,14:00:00,154,90,64,FMN GV 16 Berchem TOT
54,Posthofbrug 5366,2020-04-07,15:00:00,176,87,89,FMN GV 16 Berchem TOT
54,Posthofbrug 5366,2020-04-07,16:00:00,241,112,129,FMN GV 16 Berchem TOT
54,Posthofbrug 5366,2020-04-07,17:00:00,175,78,97,FMN GV 16 Berchem TOT
54,Posthofbrug 5366,2020-04-07,18:00:00,128,73,55,FMN GV 16 Berchem TOT
54,Posthofbrug 5366,2020-04-07,19:00:00,64,35,29,FMN GV 16 Berchem TOT
54,Posthofbrug 5366,2020-04-07,20:00:00,47,28,19,FMN GV 16 Berchem TOT
54,Posthofbrug 5366,2020-04-07,21:00:00,17,8,9,FMN GV 16 Berchem TOT
54,Posthofbrug 5366,2020-04-07,22:00:00,21,8,13,FMN GV 16 Berchem TOT
54,Posthofbrug 5366,2020-04-07,23:00:00,7,2,5,FMN GV 16 Berchem TOT
54,Posthofbrug 5366,2020-04-08,00:00:00,1,1,0,FMN GV 16 Berchem TOT
54,Posthofbrug 5366,2020-04-08,01:00:00,0,0,0,FMN GV 16 Berchem TOT
54,Posthofbrug 5366,2020-04-08,02:00:00,0,0,0,FMN GV 16 Berchem TOT
54,Posthofbrug 5366,2020-04-08,03:00:00,0,0,0,FMN GV 16 Berchem TOT
54,Posthofbrug 5366,2020-04-08,04:00:00,3,2,1,FMN GV 16 Berchem TOT
54,Posthofbrug 5366,2020-04-08,05:00:00,12,10,2,FMN GV 16 Berchem TOT
54,Posthofbrug 5366,2020-04-08,06:00:00,38,27,11,FMN GV 16 Berchem TOT
54,Posthofbrug 5366,2020-04-08,07:00:00,76,53,23,FMN GV 16 Berchem TOT
54,Posthofbrug 5366,2020-04-08,08:00:00,87,60,27,FMN GV 16 Berchem TOT
54,Posthofbrug 5366,2020-04-08,09:00:00,38,25,13,FMN GV 16 Berchem TOT
54,Posthofbrug 5366,2020-04-08,10:00:00,99,51,48,FMN GV 16 Berchem TOT
54,Posthofbrug 5366,2020-04-08,11:00:00,78,38,40,FMN GV 16 Berchem TOT
54,Posthofbrug 5366,2020-04-08,12:00:00,96,49,47,FMN GV 16 Berchem TOT
54,Posthofbrug 5366,2020-04-08,13:00:00,147,78,69,FMN GV 16 Berchem TOT
54,Posthofbrug 5366,2020-04-08,14:00:00,218,90,128,FMN GV 16 Berchem TOT
54,Posthofbrug 5366,2020-04-08,15:00:00,216,106,110,FMN GV 16 Berchem TOT
54,Posthofbrug 5366,2020-04-08,16:00:00,228,111,117,FMN GV 16 Berchem TOT
54,Posthofbrug 5366,2020-04-08,17:00:00,201,90,111,FMN GV 16 Berchem TOT
54,Posthofbrug 5366,2020-04-08,18:00:00,167,101,66,FMN GV 16 Berchem TOT
54,Posthofbrug 5366,2020-04-08,19:00:00,88,43,45,FMN GV 16 Berchem TOT
54,Posthofbrug 5366,2020-04-08,20:00:00,58,38,20,FMN GV 16 Berchem TOT
54,Posthofbrug 5366,2020-04-08,21:00:00,30,15,15,FMN GV 16 Berchem TOT
54,Posthofbrug 5366,2020-04-08,22:00:00,26,10,16,FMN GV 16 Berchem TOT
54,Posthofbrug 5366,2020-04-08,23:00:00,1,1,0,FMN GV 16 Berchem TOT
54,Posthofbrug 5366,2020-04-09,00:00:00,2,2,0,FMN GV 16 Berchem TOT
54,Posthofbrug 5366,2020-04-09,01:00:00,1,1,0,FMN GV 16 Berchem TOT
54,Posthofbrug 5366,2020-04-09,02:00:00,0,0,0,FMN GV 16 Berchem TOT
54,Posthofbrug 5366,2020-04-09,03:00:00,0,0,0,FMN GV 16 Berchem TOT
54,Posthofbrug 5366,2020-04-09,04:00:00,3,2,1,FMN GV 16 Berchem TOT
54,Posthofbrug 5366,2020-04-09,05:00:00,14,11,3,FMN GV 16 Berchem TOT
54,Posthofbrug 5366,2020-04-09,06:00:00,35,25,10,FMN GV 16 Berchem TOT
54,Posthofbrug 5366,2020-04-09,07:00:00,79,53,26,FMN GV 16 Berchem TOT
54,Posthofbrug 5366,2020-04-09,08:00:00,108,80,28,FMN GV 16 Berchem TOT
54,Posthofbrug 5366,2020-04-09,09:00:00,67,41,26,FMN GV 16 Berchem TOT
54,Posthofbrug 5366,2020-04-09,10:00:00,58,30,28,FMN GV 16 Berchem TOT
54,Posthofbrug 5366,2020-04-09,11:00:00,83,45,38,FMN GV 16 Berchem TOT
54,Posthofbrug 5366,2020-04-09,12:00:00,82,51,31,FMN GV 16 Berchem TOT
54,Posthofbrug 5366,2020-04-09,13:00:00,132,84,48,FMN GV 16 Berchem TOT
54,Posthofbrug 5366,2020-04-09,14:00:00,131,64,67,FMN GV 16 Berchem TOT
54,Posthofbrug 5366,2020-04-09,15:00:00,179,81,98,FMN GV 16 Berchem TOT
54,Posthofbrug 5366,2020-04-09,16:00:00,200,103,97,FMN GV 16 Berchem TOT
54,Posthofbrug 5366,2020-04-09,17:00:00,185,82,103,FMN GV 16 Berchem TOT
54,Posthofbrug 5366,2020-04-09,18:00:00,119,69,50,FMN GV 16 Berchem TOT
54,Posthofbrug 5366,2020-04-09,19:00:00,73,44,29,FMN GV 16 Berchem TOT
54,Posthofbrug 5366,2020-04-09,20:00:00,52,30,22,FMN GV 16 Berchem TOT
54,Posthofbrug 5366,2020-04-09,21:00:00,17,9,8,FMN GV 16 Berchem TOT
54,Posthofbrug 5366,2020-04-09,22:00:00,21,7,14,FMN GV 16 Berchem TOT
54,Posthofbrug 5366,2020-04-09,23:00:00,3,1,2,FMN GV 16 Berchem TOT
54,Posthofbrug 5366,2020-04-10,00:00:00,2,1,1,FMN GV 16 Berchem TOT
54,Posthofbrug 5366,2020-04-10,01:00:00,2,2,0,FMN GV 16 Berchem TOT
54,Posthofbrug 5366,2020-04-10,02:00:00,2,0,2,FMN GV 16 Berchem TOT
54,Posthofbrug 5366,2020-04-10,03:00:00,1,0,1,FMN GV 16 Berchem TOT
54,Posthofbrug 5366,2020-04-10,04:00:00,5,3,2,FMN GV 16 Berchem TOT
54,Posthofbrug 5366,2020-04-10,05:00:00,9,6,3,FMN GV 16 Berchem TOT
54,Posthofbrug 5366,2020-04-10,06:00:00,26,21,5,FMN GV 16 Berchem TOT
54,Posthofbrug 5366,2020-04-10,07:00:00,61,39,22,FMN GV 16 Berchem TOT
54,Posthofbrug 5366,2020-04-10,08:00:00,68,53,15,FMN GV 16 Berchem TOT
54,Posthofbrug 5366,2020-04-10,09:00:00,45,29,16,FMN GV 16 Berchem TOT
54,Posthofbrug 5366,2020-04-10,10:00:00,80,43,37,FMN GV 16 Berchem TOT
54,Posthofbrug 5366,2020-04-10,11:00:00,119,58,61,FMN GV 16 Berchem TOT
54,Posthofbrug 5366,2020-04-10,12:00:00,138,69,69,FMN GV 16 Berchem TOT
54,Posthofbrug 5366,2020-04-10,13:00:00,164,99,65,FMN GV 16 Berchem TOT
54,Posthofbrug 5366,2020-04-10,14:00:00,183,94,89,FMN GV 16 Berchem TOT
54,Posthofbrug 5366,2020-04-10,15:00:00,225,108,117,FMN GV 16 Berchem TOT
54,Posthofbrug 5366,2020-04-10,16:00:00,232,114,118,FMN GV 16 Berchem TOT
54,Posthofbrug 5366,2020-04-10,17:00:00,200,107,93,FMN GV 16 Berchem TOT
54,Posthofbrug 5366,2020-04-10,18:00:00,137,72,65,FMN GV 16 Berchem TOT
54,Posthofbrug 5366,2020-04-10,19:00:00,81,53,28,FMN GV 16 Berchem TOT
54,Posthofbrug 5366,2020-04-10,20:00:00,41,23,18,FMN GV 16 Berchem TOT
54,Posthofbrug 5366,2020-04-10,21:00:00,28,10,18,FMN GV 16 Berchem TOT
54,Posthofbrug 5366,2020-04-10,22:00:00,18,13,5,FMN GV 16 Berchem TOT
54,Posthofbrug 5366,2020-04-10,23:00:00,15,7,8,FMN GV 16 Berchem TOT
54,Posthofbrug 5366,2020-04-11,00:00:00,1,1,0,FMN GV 16 Berchem TOT
54,Posthofbrug 5366,2020-04-11,01:00:00,3,1,2,FMN GV 16 Berchem TOT
54,Posthofbrug 5366,2020-04-11,02:00:00,0,0,0,FMN GV 16 Berchem TOT
54,Posthofbrug 5366,2020-04-11,03:00:00,0,0,0,FMN GV 16 Berchem TOT
54,Posthofbrug 5366,2020-04-11,04:00:00,2,2,0,FMN GV 16 Berchem TOT
54,Posthofbrug 5366,2020-04-11,05:00:00,2,2,0,FMN GV 16 Berchem TOT
54,Posthofbrug 5366,2020-04-11,06:00:00,9,9,0,FMN GV 16 Berchem TOT
54,Posthofbrug 5366,2020-04-11,07:00:00,16,9,7,FMN GV 16 Berchem TOT
54,Posthofbrug 5366,2020-04-11,08:00:00,25,11,14,FMN GV 16 Berchem TOT
54,Posthofbrug 5366,2020-04-11,09:00:00,55,27,28,FMN GV 16 Berchem TOT
54,Posthofbrug 5366,2020-04-11,10:00:00,97,34,63,FMN GV 16 Berchem TOT
54,Posthofbrug 5366,2020-04-11,11:00:00,157,78,79,FMN GV 16 Berchem TOT
54,Posthofbrug 5366,2020-04-11,12:00:00,170,89,81,FMN GV 16 Berchem TOT
54,Posthofbrug 5366,2020-04-11,13:00:00,273,143,130,FMN GV 16 Berchem TOT
54,Posthofbrug 5366,2020-04-11,14:00:00,340,153,187,FMN GV 16 Berchem TOT
54,Posthofbrug 5366,2020-04-11,15:00:00,309,160,149,FMN GV 16 Berchem TOT
54,Posthofbrug 5366,2020-04-11,16:00:00,304,179,125,FMN GV 16 Berchem TOT
54,Posthofbrug 5366,2020-04-11,17:00:00,202,131,71,FMN GV 16 Berchem TOT
54,Posthofbrug 5366,2020-04-11,18:00:00,165,102,63,FMN GV 16 Berchem TOT
54,Posthofbrug 5366,2020-04-11,19:00:00,91,66,25,FMN GV 16 Berchem TOT
54,Posthofbrug 5366,2020-04-11,20:00:00,54,35,19,FMN GV 16 Berchem TOT
54,Posthofbrug 5366,2020-04-11,21:00:00,21,14,7,FMN GV 16 Berchem TOT
54,Posthofbrug 5366,2020-04-11,22:00:00,23,11,12,FMN GV 16 Berchem TOT
54,Posthofbrug 5366,2020-04-11,23:00:00,6,3,3,FMN GV 16 Berchem TOT
54,Posthofbrug 5366,2020-04-12,00:00:00,4,2,2,FMN GV 16 Berchem TOT
54,Posthofbrug 5366,2020-04-12,01:00:00,8,5,3,FMN GV 16 Berchem TOT
54,Posthofbrug 5366,2020-04-12,02:00:00,0,0,0,FMN GV 16 Berchem TOT
54,Posthofbrug 5366,2020-04-12,03:00:00,1,1,0,FMN GV 16 Berchem TOT
54,Posthofbrug 5366,2020-04-12,04:00:00,2,2,0,FMN GV 16 Berchem TOT
54,Posthofbrug 5366,2020-04-12,05:00:00,3,3,0,FMN GV 16 Berchem TOT
54,Posthofbrug 5366,2020-04-12,06:00:00,10,9,1,FMN GV 16 Berchem TOT
54,Posthofbrug 5366,2020-04-12,07:00:00,13,7,6,FMN GV 16 Berchem TOT
54,Posthofbrug 5366,2020-04-12,08:00:00,16,13,3,FMN GV 16 Berchem TOT
54,Posthofbrug 5366,2020-04-12,09:00:00,60,21,39,FMN GV 16 Berchem TOT
54,Posthofbrug 5366,2020-04-12,10:00:00,118,50,68,FMN GV 16 Berchem TOT
54,Posthofbrug 5366,2020-04-12,11:00:00,164,80,84,FMN GV 16 Berchem TOT
54,Posthofbrug 5366,2020-04-12,12:00:00,213,113,100,FMN GV 16 Berchem TOT
54,Posthofbrug 5366,2020-04-12,13:00:00,258,123,135,FMN GV 16 Berchem TOT
54,Posthofbrug 5366,2020-04-12,14:00:00,262,120,142,FMN GV 16 Berchem TOT
54,Posthofbrug 5366,2020-04-12,15:00:00,273,141,132,FMN GV 16 Berchem TOT
54,Posthofbrug 5366,2020-04-12,16:00:00,208,114,94,FMN GV 16 Berchem TOT
54,Posthofbrug 5366,2020-04-12,17:00:00,218,154,64,FMN GV 16 Berchem TOT
54,Posthofbrug 5366,2020-04-12,18:00:00,147,89,58,FMN GV 16 Berchem TOT
54,Posthofbrug 5366,2020-04-12,19:00:00,107,57,50,FMN GV 16 Berchem TOT
54,Posthofbrug 5366,2020-04-12,20:00:00,56,35,21,FMN GV 16 Berchem TOT
54,Posthofbrug 5366,2020-04-12,21:00:00,27,13,14,FMN GV 16 Berchem TOT
54,Posthofbrug 5366,2020-04-12,22:00:00,13,4,9,FMN GV 16 Berchem TOT
54,Posthofbrug 5366,2020-04-12,23:00:00,10,8,2,FMN GV 16 Berchem TOT
54,Posthofbrug 5366,2020-04-13,00:00:00,4,2,2,FMN GV 16 Berchem TOT
54,Posthofbrug 5366,2020-04-13,01:00:00,1,1,0,FMN GV 16 Berchem TOT
54,Posthofbrug 5366,2020-04-13,02:00:00,0,0,0,FMN GV 16 Berchem TOT
54,Posthofbrug 5366,2020-04-13,03:00:00,0,0,0,FMN GV 16 Berchem TOT
54,Posthofbrug 5366,2020-04-13,04:00:00,0,0,0,FMN GV 16 Berchem TOT
54,Posthofbrug 5366,2020-04-13,05:00:00,4,1,3,FMN GV 16 Berchem TOT
54,Posthofbrug 5366,2020-04-13,06:00:00,8,6,2,FMN GV 16 Berchem TOT
54,Posthofbrug 5366,2020-04-13,07:00:00,9,3,6,FMN GV 16 Berchem TOT
54,Posthofbrug 5366,2020-04-13,08:00:00,14,7,7,FMN GV 16 Berchem TOT
54,Posthofbrug 5366,2020-04-13,09:00:00,28,16,12,FMN GV 16 Berchem TOT
54,Posthofbrug 5366,2020-04-13,10:00:00,37,14,23,FMN GV 16 Berchem TOT
54,Posthofbrug 5366,2020-04-13,11:00:00,87,38,49,FMN GV 16 Berchem TOT
54,Posthofbrug 5366,2020-04-13,12:00:00,58,35,23,FMN GV 16 Berchem TOT
54,Posthofbrug 5366,2020-04-13,13:00:00,77,41,36,FMN GV 16 Berchem TOT
54,Posthofbrug 5366,2020-04-13,14:00:00,136,65,71,FMN GV 16 Berchem TOT
54,Posthofbrug 5366,2020-04-13,15:00:00,140,72,68,FMN GV 16 Berchem TOT
54,Posthofbrug 5366,2020-04-13,16:00:00,116,66,50,FMN GV 16 Berchem TOT
54,Posthofbrug 5366,2020-04-13,17:00:00,109,68,41,FMN GV 16 Berchem TOT
54,Posthofbrug 5366,2020-04-13,18:00:00,51,37,14,FMN GV 16 Berchem TOT
54,Posthofbrug 5366,2020-04-13,19:00:00,42,19,23,FMN GV 16 Berchem TOT
54,Posthofbrug 5366,2020-04-13,20:00:00,34,26,8,FMN GV 16 Berchem TOT
54,Posthofbrug 5366,2020-04-13,21:00:00,16,9,7,FMN GV 16 Berchem TOT
54,Posthofbrug 5366,2020-04-13,22:00:00,9,2,7,FMN GV 16 Berchem TOT
54,Posthofbrug 5366,2020-04-13,23:00:00,3,3,0,FMN GV 16 Berchem TOT
54,Posthofbrug 5366,2020-04-14,00:00:00,2,0,2,FMN GV 16 Berchem TOT
54,Posthofbrug 5366,2020-04-14,01:00:00,0,0,0,FMN GV 16 Berchem TOT
54,Posthofbrug 5366,2020-04-14,02:00:00,1,1,0,FMN GV 16 Berchem TOT
54,Posthofbrug 5366,2020-04-14,03:00:00,0,0,0,FMN GV 16 Berchem TOT
54,Posthofbrug 5366,2020-04-14,04:00:00,1,0,1,FMN GV 16 Berchem TOT
54,Posthofbrug 5366,2020-04-14,05:00:00,9,8,1,FMN GV 16 Berchem TOT
54,Posthofbrug 5366,2020-04-14,06:00:00,33,23,10,FMN GV 16 Berchem TOT
54,Posthofbrug 5366,2020-04-14,07:00:00,60,39,21,FMN GV 16 Berchem TOT
54,Posthofbrug 5366,2020-04-14,08:00:00,88,65,23,FMN GV 16 Berchem TOT
54,Posthofbrug 5366,2020-04-14,09:00:00,44,30,14,FMN GV 16 Berchem TOT
54,Posthofbrug 5366,2020-04-14,10:00:00,36,20,16,FMN GV 16 Berchem TOT
54,Posthofbrug 5366,2020-04-14,11:00:00,41,22,19,FMN GV 16 Berchem TOT
54,Posthofbrug 5366,2020-04-14,12:00:00,47,31,16,FMN GV 16 Berchem TOT
54,Posthofbrug 5366,2020-04-14,13:00:00,56,30,26,FMN GV 16 Berchem TOT
54,Posthofbrug 5366,2020-04-14,14:00:00,99,48,51,FMN GV 16 Berchem TOT
54,Posthofbrug 5366,2020-04-14,15:00:00,92,36,56,FMN GV 16 Berchem TOT
54,Posthofbrug 5366,2020-04-14,16:00:00,122,55,67,FMN GV 16 Berchem TOT
54,Posthofbrug 5366,2020-04-14,17:00:00,131,59,72,FMN GV 16 Berchem TOT
54,Posthofbrug 5366,2020-04-14,18:00:00,84,39,45,FMN GV 16 Berchem TOT
54,Posthofbrug 5366,2020-04-14,19:00:00,46,27,19,FMN GV 16 Berchem TOT
54,Posthofbrug 5366,2020-04-14,20:00:00,41,19,22,FMN GV 16 Berchem TOT
54,Posthofbrug 5366,2020-04-14,21:00:00,27,16,11,FMN GV 16 Berchem TOT
54,Posthofbrug 5366,2020-04-14,22:00:00,18,5,13,FMN GV 16 Berchem TOT
54,Posthofbrug 5366,2020-04-14,23:00:00,5,3,2,FMN GV 16 Berchem TOT
54,Posthofbrug 5366,2020-04-15,00:00:00,1,0,1,FMN GV 16 Berchem TOT
54,Posthofbrug 5366,2020-04-15,01:00:00,0,0,0,FMN GV 16 Berchem TOT
54,Posthofbrug 5366,2020-04-15,02:00:00,0,0,0,FMN GV 16 Berchem TOT
54,Posthofbrug 5366,2020-04-15,03:00:00,0,0,0,FMN GV 16 Berchem TOT
54,Posthofbrug 5366,2020-04-15,04:00:00,3,2,1,FMN GV 16 Berchem TOT
54,Posthofbrug 5366,2020-04-15,05:00:00,8,7,1,FMN GV 16 Berchem TOT
54,Posthofbrug 5366,2020-04-15,06:00:00,32,22,10,FMN GV 16 Berchem TOT
54,Posthofbrug 5366,2020-04-15,07:00:00,55,38,17,FMN GV 16 Berchem TOT
54,Posthofbrug 5366,2020-04-15,08:00:00,68,54,14,FMN GV 16 Berchem TOT
54,Posthofbrug 5366,2020-04-15,09:00:00,46,30,16,FMN GV 16 Berchem TOT
54,Posthofbrug 5366,2020-04-15,10:00:00,64,39,25,FMN GV 16 Berchem TOT
54,Posthofbrug 5366,2020-04-15,11:00:00,60,35,25,FMN GV 16 Berchem TOT
54,Posthofbrug 5366,2020-04-15,12:00:00,89,53,36,FMN GV 16 Berchem TOT
54,Posthofbrug 5366,2020-04-15,13:00:00,101,44,57,FMN GV 16 Berchem TOT
54,Posthofbrug 5366,2020-04-15,14:00:00,146,75,71,FMN GV 16 Berchem TOT
54,Posthofbrug 5366,2020-04-15,15:00:00,129,79,50,FMN GV 16 Berchem TOT
54,Posthofbrug 5366,2020-04-15,16:00:00,170,80,90,FMN GV 16 Berchem TOT
54,Posthofbrug 5366,2020-04-15,17:00:00,188,80,108,FMN GV 16 Berchem TOT
54,Posthofbrug 5366,2020-04-15,18:00:00,121,76,45,FMN GV 16 Berchem TOT
54,Posthofbrug 5366,2020-04-15,19:00:00,78,42,36,FMN GV 16 Berchem TOT
54,Posthofbrug 5366,2020-04-15,20:00:00,55,28,27,FMN GV 16 Berchem TOT
54,Posthofbrug 5366,2020-04-15,21:00:00,28,20,8,FMN GV 16 Berchem TOT
54,Posthofbrug 5366,2020-04-15,22:00:00,22,10,12,FMN GV 16 Berchem TOT
54,Posthofbrug 5366,2020-04-15,23:00:00,7,3,4,FMN GV 16 Berchem TOT
54,Posthofbrug 5366,2020-04-16,00:00:00,3,2,1,FMN GV 16 Berchem TOT
54,Posthofbrug 5366,2020-04-16,01:00:00,1,1,0,FMN GV 16 Berchem TOT
54,Posthofbrug 5366,2020-04-16,02:00:00,1,0,1,FMN GV 16 Berchem TOT
54,Posthofbrug 5366,2020-04-16,03:00:00,0,0,0,FMN GV 16 Berchem TOT
54,Posthofbrug 5366,2020-04-16,04:00:00,8,6,2,FMN GV 16 Berchem TOT
54,Posthofbrug 5366,2020-04-16,05:00:00,8,7,1,FMN GV 16 Berchem TOT
54,Posthofbrug 5366,2020-04-16,06:00:00,17,9,8,FMN GV 16 Berchem TOT
54,Posthofbrug 5366,2020-04-16,07:00:00,8,0,8,FMN GV 16 Berchem TOT
54,Posthofbrug 5366,2020-04-16,08:00:00,3,0,3,FMN GV 16 Berchem TOT
54,Posthofbrug 5366,2020-04-16,09:00:00,3,1,2,FMN GV 16 Berchem TOT
54,Posthofbrug 5366,2020-04-16,10:00:00,12,2,10,FMN GV 16 Berchem TOT
54,Posthofbrug 5366,2020-04-16,11:00:00,5,0,5,FMN GV 16 Berchem TOT
54,Posthofbrug 5366,2020-04-16,12:00:00,6,0,6,FMN GV 16 Berchem TOT
54,Posthofbrug 5366,2020-04-16,13:00:00,2,0,2,FMN GV 16 Berchem TOT
54,Posthofbrug 5366,2020-04-16,14:00:00,2,0,2,FMN GV 16 Berchem TOT
54,Posthofbrug 5366,2020-04-16,15:00:00,7,1,6,FMN GV 16 Berchem TOT
54,Posthofbrug 5366,2020-04-16,16:00:00,77,35,42,FMN GV 16 Berchem TOT
54,Posthofbrug 5366,2020-04-16,17:00:00,245,126,119,FMN GV 16 Berchem TOT
54,Posthofbrug 5366,2020-04-16,18:00:00,160,92,68,FMN GV 16 Berchem TOT
54,Posthofbrug 5366,2020-04-16,19:00:00,114,79,35,FMN GV 16 Berchem TOT
54,Posthofbrug 5366,2020-04-16,20:00:00,74,50,24,FMN GV 16 Berchem TOT
54,Posthofbrug 5366,2020-04-16,21:00:00,27,17,10,FMN GV 16 Berchem TOT
54,Posthofbrug 5366,2020-04-16,22:00:00,22,8,14,FMN GV 16 Berchem TOT
54,Posthofbrug 5366,2020-04-16,23:00:00,5,1,4,FMN GV 16 Berchem TOT
54,Posthofbrug 5366,2020-04-17,00:00:00,5,3,2,FMN GV 16 Berchem TOT
54,Posthofbrug 5366,2020-04-17,01:00:00,0,0,0,FMN GV 16 Berchem TOT
54,Posthofbrug 5366,2020-04-17,02:00:00,0,0,0,FMN GV 16 Berchem TOT
54,Posthofbrug 5366,2020-04-17,03:00:00,23,12,11,FMN GV 16 Berchem TOT
54,Posthofbrug 5366,2020-04-17,04:00:00,6,5,1,FMN GV 16 Berchem TOT
54,Posthofbrug 5366,2020-04-17,05:00:00,10,9,1,FMN GV 16 Berchem TOT
54,Posthofbrug 5366,2020-04-17,06:00:00,35,26,9,FMN GV 16 Berchem TOT
54,Posthofbrug 5366,2020-04-17,07:00:00,57,33,24,FMN GV 16 Berchem TOT
54,Posthofbrug 5366,2020-04-17,08:00:00,82,64,18,FMN GV 16 Berchem TOT
54,Posthofbrug 5366,2020-04-17,09:00:00,53,33,20,FMN GV 16 Berchem TOT
54,Posthofbrug 5366,2020-04-17,10:00:00,88,48,40,FMN GV 16 Berchem TOT
54,Posthofbrug 5366,2020-04-17,11:00:00,104,48,56,FMN GV 16 Berchem TOT
54,Posthofbrug 5366,2020-04-17,12:00:00,137,67,70,FMN GV 16 Berchem TOT
54,Posthofbrug 5366,2020-04-17,13:00:00,149,81,68,FMN GV 16 Berchem TOT
54,Posthofbrug 5366,2020-04-17,14:00:00,168,83,85,FMN GV 16 Berchem TOT
54,Posthofbrug 5366,2020-04-17,15:00:00,209,90,119,FMN GV 16 Berchem TOT
54,Posthofbrug 5366,2020-04-17,16:00:00,216,104,112,FMN GV 16 Berchem TOT
54,Posthofbrug 5366,2020-04-17,17:00:00,228,99,129,FMN GV 16 Berchem TOT
54,Posthofbrug 5366,2020-04-17,18:00:00,176,93,83,FMN GV 16 Berchem TOT
54,Posthofbrug 5366,2020-04-17,19:00:00,80,52,28,FMN GV 16 Berchem TOT
54,Posthofbrug 5366,2020-04-17,20:00:00,55,31,24,FMN GV 16 Berchem TOT
54,Posthofbrug 5366,2020-04-17,21:00:00,29,16,13,FMN GV 16 Berchem TOT
54,Posthofbrug 5366,2020-04-17,22:00:00,20,11,9,FMN GV 16 Berchem TOT
54,Posthofbrug 5366,2020-04-17,23:00:00,14,7,7,FMN GV 16 Berchem TOT
54,Posthofbrug 5366,2020-04-18,00:00:00,5,3,2,FMN GV 16 Berchem TOT
54,Posthofbrug 5366,2020-04-18,01:00:00,2,0,2,FMN GV 16 Berchem TOT
54,Posthofbrug 5366,2020-04-18,02:00:00,2,1,1,FMN GV 16 Berchem TOT
54,Posthofbrug 5366,2020-04-18,03:00:00,0,0,0,FMN GV 16 Berchem TOT
54,Posthofbrug 5366,2020-04-18,04:00:00,6,6,0,FMN GV 16 Berchem TOT
54,Posthofbrug 5366,2020-04-18,05:00:00,3,3,0,FMN GV 16 Berchem TOT
54,Posthofbrug 5366,2020-04-18,06:00:00,9,8,1,FMN GV 16 Berchem TOT
54,Posthofbrug 5366,2020-04-18,07:00:00,18,10,8,FMN GV 16 Berchem TOT
54,Posthofbrug 5366,2020-04-18,08:00:00,16,11,5,FMN GV 16 Berchem TOT
54,Posthofbrug 5366,2020-04-18,09:00:00,47,23,24,FMN GV 16 Berchem TOT
54,Posthofbrug 5366,2020-04-18,10:00:00,57,36,21,FMN GV 16 Berchem TOT
54,Posthofbrug 5366,2020-04-18,11:00:00,82,47,35,FMN GV 16 Berchem TOT
54,Posthofbrug 5366,2020-04-18,12:00:00,33,16,17,FMN GV 16 Berchem TOT
54,Posthofbrug 5366,2020-04-18,13:00:00,28,18,10,FMN GV 16 Berchem TOT
54,Posthofbrug 5366,2020-04-18,14:00:00,93,45,48,FMN GV 16 Berchem TOT
54,Posthofbrug 5366,2020-04-18,15:00:00,103,44,59,FMN GV 16 Berchem TOT
54,Posthofbrug 5366,2020-04-18,16:00:00,134,70,64,FMN GV 16 Berchem TOT
54,Posthofbrug 5366,2020-04-18,17:00:00,111,60,51,FMN GV 16 Berchem TOT
54,Posthofbrug 5366,2020-04-18,18:00:00,78,44,34,FMN GV 16 Berchem TOT
54,Posthofbrug 5366,2020-04-18,19:00:00,40,22,18,FMN GV 16 Berchem TOT
54,Posthofbrug 5366,2020-04-18,20:00:00,31,14,17,FMN GV 16 Berchem TOT
54,Posthofbrug 5366,2020-04-18,21:00:00,21,13,8,FMN GV 16 Berchem TOT
54,Posthofbrug 5366,2020-04-18,22:00:00,10,1,9,FMN GV 16 Berchem TOT
54,Posthofbrug 5366,2020-04-18,23:00:00,4,1,3,FMN GV 16 Berchem TOT
54,Posthofbrug 5366,2020-04-19,00:00:00,1,0,1,FMN GV 16 Berchem TOT
54,Posthofbrug 5366,2020-04-19,01:00:00,2,1,1,FMN GV 16 Berchem TOT
54,Posthofbrug 5366,2020-04-19,02:00:00,1,0,1,FMN GV 16 Berchem TOT
54,Posthofbrug 5366,2020-04-19,03:00:00,1,0,1,FMN GV 16 Berchem TOT
54,Posthofbrug 5366,2020-04-19,04:00:00,3,3,0,FMN GV 16 Berchem TOT
54,Posthofbrug 5366,2020-04-19,05:00:00,5,4,1,FMN GV 16 Berchem TOT
54,Posthofbrug 5366,2020-04-19,06:00:00,12,9,3,FMN GV 16 Berchem TOT
54,Posthofbrug 5366,2020-04-19,07:00:00,15,6,9,FMN GV 16 Berchem TOT
54,Posthofbrug 5366,2020-04-19,08:00:00,35,11,24,FMN GV 16 Berchem TOT
54,Posthofbrug 5366,2020-04-19,09:00:00,82,27,55,FMN GV 16 Berchem TOT
54,Posthofbrug 5366,2020-04-19,10:00:00,124,52,72,FMN GV 16 Berchem TOT
54,Posthofbrug 5366,2020-04-19,11:00:00,163,69,94,FMN GV 16 Berchem TOT
54,Posthofbrug 5366,2020-04-19,12:00:00,142,72,70,FMN GV 16 Berchem TOT
54,Posthofbrug 5366,2020-04-19,13:00:00,231,127,104,FMN GV 16 Berchem TOT
54,Posthofbrug 5366,2020-04-19,14:00:00,304,132,172,FMN GV 16 Berchem TOT
54,Posthofbrug 5366,2020-04-19,15:00:00,308,144,164,FMN GV 16 Berchem TOT
54,Posthofbrug 5366,2020-04-19,16:00:00,284,155,129,FMN GV 16 Berchem TOT
54,Posthofbrug 5366,2020-04-19,17:00:00,251,157,94,FMN GV 16 Berchem TOT
54,Posthofbrug 5366,2020-04-19,18:00:00,177,130,47,FMN GV 16 Berchem TOT
54,Posthofbrug 5366,2020-04-19,19:00:00,77,58,19,FMN GV 16 Berchem TOT
54,Posthofbrug 5366,2020-04-19,20:00:00,62,32,30,FMN GV 16 Berchem TOT
54,Posthofbrug 5366,2020-04-19,21:00:00,29,19,10,FMN GV 16 Berchem TOT
54,Posthofbrug 5366,2020-04-19,22:00:00,19,12,7,FMN GV 16 Berchem TOT
54,Posthofbrug 5366,2020-04-19,23:00:00,6,3,3,FMN GV 16 Berchem TOT
54,Posthofbrug 5366,2020-04-27,00:00:00,1,1,0,FMN GV 16 Berchem TOT
54,Posthofbrug 5366,2020-04-27,01:00:00,0,0,0,FMN GV 16 Berchem TOT
54,Posthofbrug 5366,2020-04-27,02:00:00,0,0,0,FMN GV 16 Berchem TOT
54,Posthofbrug 5366,2020-04-27,03:00:00,0,0,0,FMN GV 16 Berchem TOT
54,Posthofbrug 5366,2020-04-27,04:00:00,1,1,0,FMN GV 16 Berchem TOT
54,Posthofbrug 5366,2020-04-27,05:00:00,0,0,0,FMN GV 16 Berchem TOT
54,Posthofbrug 5366,2020-04-27,06:00:00,4,2,2,FMN GV 16 Berchem TOT
54,Posthofbrug 5366,2020-04-27,07:00:00,4,1,3,FMN GV 16 Berchem TOT
54,Posthofbrug 5366,2020-04-27,08:00:00,6,4,2,FMN GV 16 Berchem TOT
54,Posthofbrug 5366,2020-04-27,09:00:00,2,1,1,FMN GV 16 Berchem TOT
54,Posthofbrug 5366,2020-04-27,10:00:00,0,0,0,FMN GV 16 Berchem TOT
54,Posthofbrug 5366,2020-04-27,11:00:00,3,3,0,FMN GV 16 Berchem TOT
54,Posthofbrug 5366,2020-04-27,12:00:00,8,5,3,FMN GV 16 Berchem TOT
54,Posthofbrug 5366,2020-04-27,13:00:00,3,2,1,FMN GV 16 Berchem TOT
54,Posthofbrug 5366,2020-04-27,14:00:00,7,6,1,FMN GV 16 Berchem TOT
54,Posthofbrug 5366,2020-04-27,15:00:00,4,2,2,FMN GV 16 Berchem TOT
54,Posthofbrug 5366,2020-04-27,16:00:00,17,9,8,FMN GV 16 Berchem TOT
54,Posthofbrug 5366,2020-04-27,17:00:00,8,4,4,FMN GV 16 Berchem TOT
54,Posthofbrug 5366,2020-04-27,18:00:00,4,1,3,FMN GV 16 Berchem TOT
54,Posthofbrug 5366,2020-04-27,19:00:00,3,2,1,FMN GV 16 Berchem TOT
54,Posthofbrug 5366,2020-04-27,20:00:00,1,1,0,FMN GV 16 Berchem TOT
54,Posthofbrug 5366,2020-04-27,21:00:00,4,1,3,FMN GV 16 Berchem TOT
54,Posthofbrug 5366,2020-04-27,22:00:00,4,0,4,FMN GV 16 Berchem TOT
54,Posthofbrug 5366,2020-04-27,23:00:00,0,0,0,FMN GV 16 Berchem TOT
54,Posthofbrug 5366,2020-04-28,00:00:00,0,0,0,FMN GV 16 Berchem TOT
54,Posthofbrug 5366,2020-04-28,01:00:00,0,0,0,FMN GV 16 Berchem TOT
54,Posthofbrug 5366,2020-04-28,02:00:00,2,1,1,FMN GV 16 Berchem TOT
54,Posthofbrug 5366,2020-04-28,03:00:00,0,0,0,FMN GV 16 Berchem TOT
54,Posthofbrug 5366,2020-04-28,04:00:00,0,0,0,FMN GV 16 Berchem TOT
54,Posthofbrug 5366,2020-04-28,05:00:00,0,0,0,FMN GV 16 Berchem TOT
54,Posthofbrug 5366,2020-04-28,06:00:00,5,3,2,FMN GV 16 Berchem TOT
54,Posthofbrug 5366,2020-04-28,07:00:00,10,7,3,FMN GV 16 Berchem TOT
54,Posthofbrug 5366,2020-04-28,08:00:00,13,9,4,FMN GV 16 Berchem TOT
54,Posthofbrug 5366,2020-04-28,09:00:00,4,3,1,FMN GV 16 Berchem TOT
54,Posthofbrug 5366,2020-04-28,10:00:00,0,0,0,FMN GV 16 Berchem TOT
54,Posthofbrug 5366,2020-04-28,11:00:00,1,1,0,FMN GV 16 Berchem TOT
54,Posthofbrug 5366,2020-04-28,12:00:00,0,0,0,FMN GV 16 Berchem TOT
54,Posthofbrug 5366,2020-04-28,13:00:00,1,0,1,FMN GV 16 Berchem TOT
54,Posthofbrug 5366,2020-04-28,14:00:00,3,2,1,FMN GV 16 Berchem TOT
54,Posthofbrug 5366,2020-04-28,15:00:00,1,1,0,FMN GV 16 Berchem TOT
54,Posthofbrug 5366,2020-04-28,16:00:00,5,3,2,FMN GV 16 Berchem TOT
54,Posthofbrug 5366,2020-04-28,17:00:00,8,4,4,FMN GV 16 Berchem TOT
54,Posthofbrug 5366,2020-04-28,18:00:00,7,1,6,FMN GV 16 Berchem TOT
54,Posthofbrug 5366,2020-04-28,19:00:00,1,1,0,FMN GV 16 Berchem TOT
54,Posthofbrug 5366,2020-04-28,20:00:00,3,1,2,FMN GV 16 Berchem TOT
54,Posthofbrug 5366,2020-04-28,21:00:00,2,1,1,FMN GV 16 Berchem TOT
54,Posthofbrug 5366,2020-04-28,22:00:00,2,1,1,FMN GV 16 Berchem TOT
54,Posthofbrug 5366,2020-04-28,23:00:00,1,1,0,FMN GV 16 Berchem TOT
54,Posthofbrug 5366,2020-04-29,00:00:00,0,0,0,FMN GV 16 Berchem TOT
54,Posthofbrug 5366,2020-04-29,01:00:00,0,0,0,FMN GV 16 Berchem TOT
54,Posthofbrug 5366,2020-04-29,02:00:00,0,0,0,FMN GV 16 Berchem TOT
54,Posthofbrug 5366,2020-04-29,03:00:00,0,0,0,FMN GV 16 Berchem TOT
54,Posthofbrug 5366,2020-04-29,04:00:00,0,0,0,FMN GV 16 Berchem TOT
54,Posthofbrug 5366,2020-04-29,05:00:00,0,0,0,FMN GV 16 Berchem TOT
54,Posthofbrug 5366,2020-04-29,06:00:00,4,4,0,FMN GV 16 Berchem TOT
54,Posthofbrug 5366,2020-04-29,07:00:00,7,3,4,FMN GV 16 Berchem TOT
54,Posthofbrug 5366,2020-04-29,08:00:00,35,24,11,FMN GV 16 Berchem TOT
54,Posthofbrug 5366,2020-04-29,09:00:00,39,29,10,FMN GV 16 Berchem TOT
54,Posthofbrug 5366,2020-04-29,10:00:00,40,26,14,FMN GV 16 Berchem TOT
54,Posthofbrug 5366,2020-04-29,11:00:00,53,30,23,FMN GV 16 Berchem TOT
54,Posthofbrug 5366,2020-04-29,12:00:00,65,28,37,FMN GV 16 Berchem TOT
54,Posthofbrug 5366,2020-04-29,13:00:00,83,55,28,FMN GV 16 Berchem TOT
54,Posthofbrug 5366,2020-04-29,14:00:00,101,51,50,FMN GV 16 Berchem TOT
54,Posthofbrug 5366,2020-04-29,15:00:00,141,66,75,FMN GV 16 Berchem TOT
54,Posthofbrug 5366,2020-04-29,16:00:00,127,46,81,FMN GV 16 Berchem TOT
54,Posthofbrug 5366,2020-04-29,17:00:00,138,58,80,FMN GV 16 Berchem TOT
54,Posthofbrug 5366,2020-04-29,18:00:00,94,46,48,FMN GV 16 Berchem TOT
54,Posthofbrug 5366,2020-04-29,19:00:00,56,33,23,FMN GV 16 Berchem TOT
54,Posthofbrug 5366,2020-04-29,20:00:00,34,18,16,FMN GV 16 Berchem TOT
54,Posthofbrug 5366,2020-04-29,21:00:00,19,12,7,FMN GV 16 Berchem TOT
54,Posthofbrug 5366,2020-04-29,22:00:00,10,5,5,FMN GV 16 Berchem TOT
54,Posthofbrug 5366,2020-04-29,23:00:00,3,2,1,FMN GV 16 Berchem TOT
54,Posthofbrug 5366,2020-04-30,00:00:00,5,2,3,FMN GV 16 Berchem TOT
54,Posthofbrug 5366,2020-04-30,01:00:00,2,0,2,FMN GV 16 Berchem TOT
54,Posthofbrug 5366,2020-04-30,02:00:00,3,0,3,FMN GV 16 Berchem TOT
54,Posthofbrug 5366,2020-04-30,03:00:00,1,0,1,FMN GV 16 Berchem TOT
54,Posthofbrug 5366,2020-04-30,04:00:00,3,3,0,FMN GV 16 Berchem TOT
54,Posthofbrug 5366,2020-04-30,05:00:00,10,7,3,FMN GV 16 Berchem TOT
54,Posthofbrug 5366,2020-04-30,06:00:00,26,20,6,FMN GV 16 Berchem TOT
54,Posthofbrug 5366,2020-04-30,07:00:00,66,48,18,FMN GV 16 Berchem TOT
54,Posthofbrug 5366,2020-04-30,08:00:00,71,54,17,FMN GV 16 Berchem TOT
54,Posthofbrug 5366,2020-04-30,09:00:00,60,42,18,FMN GV 16 Berchem TOT
54,Posthofbrug 5366,2020-04-30,10:00:00,57,31,26,FMN GV 16 Berchem TOT
54,Posthofbrug 5366,2020-04-30,11:00:00,78,48,30,FMN GV 16 Berchem TOT
54,Posthofbrug 5366,2020-04-30,12:00:00,51,30,21,FMN GV 16 Berchem TOT
54,Posthofbrug 5366,2020-04-30,13:00:00,81,44,37,FMN GV 16 Berchem TOT
54,Posthofbrug 5366,2020-04-30,14:00:00,110,58,52,FMN GV 16 Berchem TOT
54,Posthofbrug 5366,2020-04-30,15:00:00,114,57,57,FMN GV 16 Berchem TOT
54,Posthofbrug 5366,2020-04-30,16:00:00,129,61,68,FMN GV 16 Berchem TOT
54,Posthofbrug 5366,2020-04-30,17:00:00,158,64,94,FMN GV 16 Berchem TOT
54,Posthofbrug 5366,2020-04-30,18:00:00,109,59,50,FMN GV 16 Berchem TOT
54,Posthofbrug 5366,2020-04-30,19:00:00,44,20,24,FMN GV 16 Berchem TOT
54,Posthofbrug 5366,2020-04-30,20:00:00,37,20,17,FMN GV 16 Berchem TOT
54,Posthofbrug 5366,2020-04-30,21:00:00,8,5,3,FMN GV 16 Berchem TOT
54,Posthofbrug 5366,2020-04-30,22:00:00,23,8,15,FMN GV 16 Berchem TOT
54,Posthofbrug 5366,2020-04-30,23:00:00,10,3,7,FMN GV 16 Berchem TOT
54,Posthofbrug 5366,2020-05-01,00:00:00,4,4,0,FMN GV 16 Berchem TOT
54,Posthofbrug 5366,2020-05-01,01:00:00,3,2,1,FMN GV 16 Berchem TOT
54,Posthofbrug 5366,2020-05-01,02:00:00,0,0,0,FMN GV 16 Berchem TOT
54,Posthofbrug 5366,2020-05-01,03:00:00,1,0,1,FMN GV 16 Berchem TOT
54,Posthofbrug 5366,2020-05-01,04:00:00,3,3,0,FMN GV 16 Berchem TOT
54,Posthofbrug 5366,2020-05-01,05:00:00,2,1,1,FMN GV 16 Berchem TOT
54,Posthofbrug 5366,2020-05-01,06:00:00,11,7,4,FMN GV 16 Berchem TOT
54,Posthofbrug 5366,2020-05-01,07:00:00,9,4,5,FMN GV 16 Berchem TOT
54,Posthofbrug 5366,2020-05-01,08:00:00,25,10,15,FMN GV 16 Berchem TOT
54,Posthofbrug 5366,2020-05-01,09:00:00,39,17,22,FMN GV 16 Berchem TOT
54,Posthofbrug 5366,2020-05-01,10:00:00,46,25,21,FMN GV 16 Berchem TOT
54,Posthofbrug 5366,2020-05-01,11:00:00,66,36,30,FMN GV 16 Berchem TOT
54,Posthofbrug 5366,2020-05-01,12:00:00,103,53,50,FMN GV 16 Berchem TOT
54,Posthofbrug 5366,2020-05-01,13:00:00,75,39,36,FMN GV 16 Berchem TOT
54,Posthofbrug 5366,2020-05-01,14:00:00,72,38,34,FMN GV 16 Berchem TOT
54,Posthofbrug 5366,2020-05-01,15:00:00,84,46,38,FMN GV 16 Berchem TOT
54,Posthofbrug 5366,2020-05-01,16:00:00,86,53,33,FMN GV 16 Berchem TOT
54,Posthofbrug 5366,2020-05-01,17:00:00,68,34,34,FMN GV 16 Berchem TOT
54,Posthofbrug 5366,2020-05-01,18:00:00,61,26,35,FMN GV 16 Berchem TOT
54,Posthofbrug 5366,2020-05-01,19:00:00,35,15,20,FMN GV 16 Berchem TOT
54,Posthofbrug 5366,2020-05-01,20:00:00,20,9,11,FMN GV 16 Berchem TOT
54,Posthofbrug 5366,2020-05-01,21:00:00,20,12,8,FMN GV 16 Berchem TOT
54,Posthofbrug 5366,2020-05-01,22:00:00,10,3,7,FMN GV 16 Berchem TOT
54,Posthofbrug 5366,2020-05-01,23:00:00,3,2,1,FMN GV 16 Berchem TOT
54,Posthofbrug 5366,2020-05-02,00:00:00,2,2,0,FMN GV 16 Berchem TOT
54,Posthofbrug 5366,2020-05-02,01:00:00,4,2,2,FMN GV 16 Berchem TOT
54,Posthofbrug 5366,2020-05-02,02:00:00,2,1,1,FMN GV 16 Berchem TOT
54,Posthofbrug 5366,2020-05-02,03:00:00,2,1,1,FMN GV 16 Berchem TOT
54,Posthofbrug 5366,2020-05-02,04:00:00,3,3,0,FMN GV 16 Berchem TOT
54,Posthofbrug 5366,2020-05-02,05:00:00,10,4,6,FMN GV 16 Berchem TOT
54,Posthofbrug 5366,2020-05-02,06:00:00,12,9,3,FMN GV 16 Berchem TOT
54,Posthofbrug 5366,2020-05-02,07:00:00,11,6,5,FMN GV 16 Berchem TOT
54,Posthofbrug 5366,2020-05-02,08:00:00,17,8,9,FMN GV 16 Berchem TOT
54,Posthofbrug 5366,2020-05-02,09:00:00,17,9,8,FMN GV 16 Berchem TOT
54,Posthofbrug 5366,2020-05-02,10:00:00,43,24,19,FMN GV 16 Berchem TOT
54,Posthofbrug 5366,2020-05-02,11:00:00,52,26,26,FMN GV 16 Berchem TOT
54,Posthofbrug 5366,2020-05-02,12:00:00,59,30,29,FMN GV 16 Berchem TOT
54,Posthofbrug 5366,2020-05-02,13:00:00,96,48,48,FMN GV 16 Berchem TOT
54,Posthofbrug 5366,2020-05-02,14:00:00,148,80,68,FMN GV 16 Berchem TOT
54,Posthofbrug 5366,2020-05-02,15:00:00,230,132,98,FMN GV 16 Berchem TOT
54,Posthofbrug 5366,2020-05-02,16:00:00,215,93,122,FMN GV 16 Berchem TOT
54,Posthofbrug 5366,2020-05-02,17:00:00,184,101,83,FMN GV 16 Berchem TOT
54,Posthofbrug 5366,2020-05-02,18:00:00,97,64,33,FMN GV 16 Berchem TOT
54,Posthofbrug 5366,2020-05-02,19:00:00,73,41,32,FMN GV 16 Berchem TOT
54,Posthofbrug 5366,2020-05-02,20:00:00,54,30,24,FMN GV 16 Berchem TOT
54,Posthofbrug 5366,2020-05-02,21:00:00,33,22,11,FMN GV 16 Berchem TOT
54,Posthofbrug 5366,2020-05-02,22:00:00,24,13,11,FMN GV 16 Berchem TOT
54,Posthofbrug 5366,2020-05-02,23:00:00,16,6,10,FMN GV 16 Berchem TOT
54,Posthofbrug 5366,2020-05-03,00:00:00,4,3,1,FMN GV 16 Berchem TOT
54,Posthofbrug 5366,2020-05-03,01:00:00,4,3,1,FMN GV 16 Berchem TOT
54,Posthofbrug 5366,2020-05-03,02:00:00,3,1,2,FMN GV 16 Berchem TOT
54,Posthofbrug 5366,2020-05-03,03:00:00,2,0,2,FMN GV 16 Berchem TOT
54,Posthofbrug 5366,2020-05-03,04:00:00,3,3,0,FMN GV 16 Berchem TOT
54,Posthofbrug 5366,2020-05-03,05:00:00,6,3,3,FMN GV 16 Berchem TOT
54,Posthofbrug 5366,2020-05-03,06:00:00,14,12,2,FMN GV 16 Berchem TOT
54,Posthofbrug 5366,2020-05-03,07:00:00,18,10,8,FMN GV 16 Berchem TOT
54,Posthofbrug 5366,2020-05-03,08:00:00,42,18,24,FMN GV 16 Berchem TOT
54,Posthofbrug 5366,2020-05-03,09:00:00,110,40,70,FMN GV 16 Berchem TOT
54,Posthofbrug 5366,2020-05-03,10:00:00,151,71,80,FMN GV 16 Berchem TOT
54,Posthofbrug 5366,2020-05-03,11:00:00,289,123,166,FMN GV 16 Berchem TOT
54,Posthofbrug 5366,2020-05-03,12:00:00,240,120,120,FMN GV 16 Berchem TOT
54,Posthofbrug 5366,2020-05-03,13:00:00,320,186,134,FMN GV 16 Berchem TOT
54,Posthofbrug 5366,2020-05-03,14:00:00,450,199,251,FMN GV 16 Berchem TOT
54,Posthofbrug 5366,2020-05-03,15:00:00,393,204,189,FMN GV 16 Berchem TOT
54,Posthofbrug 5366,2020-05-03,16:00:00,366,182,184,FMN GV 16 Berchem TOT
54,Posthofbrug 5366,2020-05-03,17:00:00,267,160,107,FMN GV 16 Berchem TOT
54,Posthofbrug 5366,2020-05-03,18:00:00,164,95,69,FMN GV 16 Berchem TOT
54,Posthofbrug 5366,2020-05-03,19:00:00,96,59,37,FMN GV 16 Berchem TOT
54,Posthofbrug 5366,2020-05-03,20:00:00,54,38,16,FMN GV 16 Berchem TOT
54,Posthofbrug 5366,2020-05-03,21:00:00,21,14,7,FMN GV 16 Berchem TOT
54,Posthofbrug 5366,2020-05-03,22:00:00,22,11,11,FMN GV 16 Berchem TOT
54,Posthofbrug 5366,2020-05-03,23:00:00,8,4,4,FMN GV 16 Berchem TOT
54,Posthofbrug 5366,2020-05-04,00:00:00,4,2,2,FMN GV 16 Berchem TOT
54,Posthofbrug 5366,2020-05-04,01:00:00,1,0,1,FMN GV 16 Berchem TOT
54,Posthofbrug 5366,2020-05-04,02:00:00,2,0,2,FMN GV 16 Berchem TOT
54,Posthofbrug 5366,2020-05-04,03:00:00,0,0,0,FMN GV 16 Berchem TOT
54,Posthofbrug 5366,2020-05-04,04:00:00,6,4,2,FMN GV 16 Berchem TOT
54,Posthofbrug 5366,2020-05-04,05:00:00,14,11,3,FMN GV 16 Berchem TOT
54,Posthofbrug 5366,2020-05-04,06:00:00,41,29,12,FMN GV 16 Berchem TOT
54,Posthofbrug 5366,2020-05-04,07:00:00,103,77,26,FMN GV 16 Berchem TOT
54,Posthofbrug 5366,2020-05-04,08:00:00,125,99,26,FMN GV 16 Berchem TOT
54,Posthofbrug 5366,2020-05-04,09:00:00,52,33,19,FMN GV 16 Berchem TOT
54,Posthofbrug 5366,2020-05-04,10:00:00,49,23,26,FMN GV 16 Berchem TOT
54,Posthofbrug 5366,2020-05-04,11:00:00,59,34,25,FMN GV 16 Berchem TOT
54,Posthofbrug 5366,2020-05-04,12:00:00,61,30,31,FMN GV 16 Berchem TOT
54,Posthofbrug 5366,2020-05-04,13:00:00,95,48,47,FMN GV 16 Berchem TOT
54,Posthofbrug 5366,2020-05-04,14:00:00,95,47,48,FMN GV 16 Berchem TOT
54,Posthofbrug 5366,2020-05-04,15:00:00,127,64,63,FMN GV 16 Berchem TOT
54,Posthofbrug 5366,2020-05-04,16:00:00,176,63,113,FMN GV 16 Berchem TOT
54,Posthofbrug 5366,2020-05-04,17:00:00,215,86,129,FMN GV 16 Berchem TOT
54,Posthofbrug 5366,2020-05-04,18:00:00,139,62,77,FMN GV 16 Berchem TOT
54,Posthofbrug 5366,2020-05-04,19:00:00,104,55,49,FMN GV 16 Berchem TOT
54,Posthofbrug 5366,2020-05-04,20:00:00,68,36,32,FMN GV 16 Berchem TOT
54,Posthofbrug 5366,2020-05-04,21:00:00,44,25,19,FMN GV 16 Berchem TOT
54,Posthofbrug 5366,2020-05-04,22:00:00,14,4,10,FMN GV 16 Berchem TOT
54,Posthofbrug 5366,2020-05-04,23:00:00,9,5,4,FMN GV 16 Berchem TOT
54,Posthofbrug 5366,2020-05-05,00:00:00,7,4,3,FMN GV 16 Berchem TOT
54,Posthofbrug 5366,2020-05-05,01:00:00,1,0,1,FMN GV 16 Berchem TOT
54,Posthofbrug 5366,2020-05-05,02:00:00,3,1,2,FMN GV 16 Berchem TOT
54,Posthofbrug 5366,2020-05-05,03:00:00,0,0,0,FMN GV 16 Berchem TOT
54,Posthofbrug 5366,2020-05-05,04:00:00,9,6,3,FMN GV 16 Berchem TOT
54,Posthofbrug 5366,2020-05-05,05:00:00,15,13,2,FMN GV 16 Berchem TOT
54,Posthofbrug 5366,2020-05-05,06:00:00,51,39,12,FMN GV 16 Berchem TOT
54,Posthofbrug 5366,2020-05-05,07:00:00,117,88,29,FMN GV 16 Berchem TOT
54,Posthofbrug 5366,2020-05-05,08:00:00,188,149,39,FMN GV 16 Berchem TOT
54,Posthofbrug 5366,2020-05-05,09:00:00,101,76,25,FMN GV 16 Berchem TOT
54,Posthofbrug 5366,2020-05-05,10:00:00,57,35,22,FMN GV 16 Berchem TOT
54,Posthofbrug 5366,2020-05-05,11:00:00,70,37,33,FMN GV 16 Berchem TOT
54,Posthofbrug 5366,2020-05-05,12:00:00,84,52,32,FMN GV 16 Berchem TOT
54,Posthofbrug 5366,2020-05-05,13:00:00,113,50,63,FMN GV 16 Berchem TOT
54,Posthofbrug 5366,2020-05-05,14:00:00,147,65,82,FMN GV 16 Berchem TOT
54,Posthofbrug 5366,2020-05-05,15:00:00,175,77,98,FMN GV 16 Berchem TOT
54,Posthofbrug 5366,2020-05-05,16:00:00,260,100,160,FMN GV 16 Berchem TOT
54,Posthofbrug 5366,2020-05-05,17:00:00,247,84,163,FMN GV 16 Berchem TOT
54,Posthofbrug 5366,2020-05-05,18:00:00,181,72,109,FMN GV 16 Berchem TOT
54,Posthofbrug 5366,2020-05-05,19:00:00,104,63,41,FMN GV 16 Berchem TOT
54,Posthofbrug 5366,2020-05-05,20:00:00,70,52,18,FMN GV 16 Berchem TOT
54,Posthofbrug 5366,2020-05-05,21:00:00,37,21,16,FMN GV 16 Berchem TOT
54,Posthofbrug 5366,2020-05-05,22:00:00,27,14,13,FMN GV 16 Berchem TOT
54,Posthofbrug 5366,2020-05-05,23:00:00,11,4,7,FMN GV 16 Berchem TOT
54,Posthofbrug 5366,2020-05-06,00:00:00,7,3,4,FMN GV 16 Berchem TOT
54,Posthofbrug 5366,2020-05-06,01:00:00,2,0,2,FMN GV 16 Berchem TOT
54,Posthofbrug 5366,2020-05-06,02:00:00,2,1,1,FMN GV 16 Berchem TOT
54,Posthofbrug 5366,2020-05-06,03:00:00,0,0,0,FMN GV 16 Berchem TOT
54,Posthofbrug 5366,2020-05-06,04:00:00,10,7,3,FMN GV 16 Berchem TOT
54,Posthofbrug 5366,2020-05-06,05:00:00,14,11,3,FMN GV 16 Berchem TOT
54,Posthofbrug 5366,2020-05-06,06:00:00,56,42,14,FMN GV 16 Berchem TOT
54,Posthofbrug 5366,2020-05-06,07:00:00,122,86,36,FMN GV 16 Berchem TOT
54,Posthofbrug 5366,2020-05-06,08:00:00,146,110,36,FMN GV 16 Berchem TOT
54,Posthofbrug 5366,2020-05-06,09:00:00,78,51,27,FMN GV 16 Berchem TOT
54,Posthofbrug 5366,2020-05-06,10:00:00,79,42,37,FMN GV 16 Berchem TOT
54,Posthofbrug 5366,2020-05-06,11:00:00,107,59,48,FMN GV 16 Berchem TOT
54,Posthofbrug 5366,2020-05-06,12:00:00,138,71,67,FMN GV 16 Berchem TOT
54,Posthofbrug 5366,2020-05-06,13:00:00,169,95,74,FMN GV 16 Berchem TOT
54,Posthofbrug 5366,2020-05-06,14:00:00,181,82,99,FMN GV 16 Berchem TOT
54,Posthofbrug 5366,2020-05-06,15:00:00,176,81,95,FMN GV 16 Berchem TOT
54,Posthofbrug 5366,2020-05-06,16:00:00,286,110,176,FMN GV 16 Berchem TOT
54,Posthofbrug 5366,2020-05-06,17:00:00,307,130,177,FMN GV 16 Berchem TOT
54,Posthofbrug 5366,2020-05-06,18:00:00,213,113,100,FMN GV 16 Berchem TOT
54,Posthofbrug 5366,2020-05-06,19:00:00,132,66,66,FMN GV 16 Berchem TOT
54,Posthofbrug 5366,2020-05-06,20:00:00,103,60,43,FMN GV 16 Berchem TOT
54,Posthofbrug 5366,2020-05-06,21:00:00,55,27,28,FMN GV 16 Berchem TOT
54,Posthofbrug 5366,2020-05-06,22:00:00,40,16,24,FMN GV 16 Berchem TOT
54,Posthofbrug 5366,2020-05-06,23:00:00,19,9,10,FMN GV 16 Berchem TOT
54,Posthofbrug 5366,2020-05-07,00:00:00,10,4,6,FMN GV 16 Berchem TOT
54,Posthofbrug 5366,2020-05-07,01:00:00,2,1,1,FMN GV 16 Berchem TOT
54,Posthofbrug 5366,2020-05-07,02:00:00,0,0,0,FMN GV 16 Berchem TOT
54,Posthofbrug 5366,2020-05-07,03:00:00,3,1,2,FMN GV 16 Berchem TOT
54,Posthofbrug 5366,2020-05-07,04:00:00,7,3,4,FMN GV 16 Berchem TOT
54,Posthofbrug 5366,2020-05-07,05:00:00,15,13,2,FMN GV 16 Berchem TOT
54,Posthofbrug 5366,2020-05-07,06:00:00,63,43,20,FMN GV 16 Berchem TOT
54,Posthofbrug 5366,2020-05-07,07:00:00,116,89,27,FMN GV 16 Berchem TOT
54,Posthofbrug 5366,2020-05-07,08:00:00,164,113,51,FMN GV 16 Berchem TOT
54,Posthofbrug 5366,2020-05-07,09:00:00,100,68,32,FMN GV 16 Berchem TOT
54,Posthofbrug 5366,2020-05-07,10:00:00,90,42,48,FMN GV 16 Berchem TOT
54,Posthofbrug 5366,2020-05-07,11:00:00,103,55,48,FMN GV 16 Berchem TOT
54,Posthofbrug 5366,2020-05-07,12:00:00,116,60,56,FMN GV 16 Berchem TOT
54,Posthofbrug 5366,2020-05-07,13:00:00,159,86,73,FMN GV 16 Berchem TOT
54,Posthofbrug 5366,2020-05-07,14:00:00,246,120,126,FMN GV 16 Berchem TOT
54,Posthofbrug 5366,2020-05-07,15:00:00,229,87,142,FMN GV 16 Berchem TOT
54,Posthofbrug 5366,2020-05-07,16:00:00,307,136,171,FMN GV 16 Berchem TOT
54,Posthofbrug 5366,2020-05-07,17:00:00,295,113,182,FMN GV 16 Berchem TOT
54,Posthofbrug 5366,2020-05-07,18:00:00,204,94,110,FMN GV 16 Berchem TOT
54,Posthofbrug 5366,2020-05-07,19:00:00,124,57,67,FMN GV 16 Berchem TOT
54,Posthofbrug 5366,2020-05-07,20:00:00,99,62,37,FMN GV 16 Berchem TOT
54,Posthofbrug 5366,2020-05-07,21:00:00,58,35,23,FMN GV 16 Berchem TOT
54,Posthofbrug 5366,2020-05-07,22:00:00,52,25,27,FMN GV 16 Berchem TOT
54,Posthofbrug 5366,2020-05-07,23:00:00,26,13,13,FMN GV 16 Berchem TOT
54,Posthofbrug 5366,2020-05-08,00:00:00,11,3,8,FMN GV 16 Berchem TOT
54,Posthofbrug 5366,2020-05-08,01:00:00,4,3,1,FMN GV 16 Berchem TOT
54,Posthofbrug 5366,2020-05-08,02:00:00,5,2,3,FMN GV 16 Berchem TOT
54,Posthofbrug 5366,2020-05-08,03:00:00,1,1,0,FMN GV 16 Berchem TOT
54,Posthofbrug 5366,2020-05-08,04:00:00,6,4,2,FMN GV 16 Berchem TOT
54,Posthofbrug 5366,2020-05-08,05:00:00,14,12,2,FMN GV 16 Berchem TOT
54,Posthofbrug 5366,2020-05-08,06:00:00,58,38,20,FMN GV 16 Berchem TOT
54,Posthofbrug 5366,2020-05-08,07:00:00,98,70,28,FMN GV 16 Berchem TOT
54,Posthofbrug 5366,2020-05-08,08:00:00,156,110,46,FMN GV 16 Berchem TOT
54,Posthofbrug 5366,2020-05-08,09:00:00,97,62,35,FMN GV 16 Berchem TOT
54,Posthofbrug 5366,2020-05-08,10:00:00,106,55,51,FMN GV 16 Berchem TOT
54,Posthofbrug 5366,2020-05-08,11:00:00,97,51,46,FMN GV 16 Berchem TOT
54,Posthofbrug 5366,2020-05-08,12:00:00,147,64,83,FMN GV 16 Berchem TOT
54,Posthofbrug 5366,2020-05-08,13:00:00,206,99,107,FMN GV 16 Berchem TOT
54,Posthofbrug 5366,2020-05-08,14:00:00,211,100,111,FMN GV 16 Berchem TOT
54,Posthofbrug 5366,2020-05-08,15:00:00,216,87,129,FMN GV 16 Berchem TOT
54,Posthofbrug 5366,2020-05-08,16:00:00,262,122,140,FMN GV 16 Berchem TOT
54,Posthofbrug 5366,2020-05-08,17:00:00,241,134,107,FMN GV 16 Berchem TOT
54,Posthofbrug 5366,2020-05-08,18:00:00,163,89,74,FMN GV 16 Berchem TOT
54,Posthofbrug 5366,2020-05-08,19:00:00,125,58,67,FMN GV 16 Berchem TOT
54,Posthofbrug 5366,2020-05-08,20:00:00,103,59,44,FMN GV 16 Berchem TOT
54,Posthofbrug 5366,2020-05-08,21:00:00,61,36,25,FMN GV 16 Berchem TOT
54,Posthofbrug 5366,2020-05-08,22:00:00,45,28,17,FMN GV 16 Berchem TOT
54,Posthofbrug 5366,2020-05-08,23:00:00,29,19,10,FMN GV 16 Berchem TOT
54,Posthofbrug 5366,2020-05-09,00:00:00,18,13,5,FMN GV 16 Berchem TOT
54,Posthofbrug 5366,2020-05-09,01:00:00,10,1,9,FMN GV 16 Berchem TOT
54,Posthofbrug 5366,2020-05-09,02:00:00,2,0,2,FMN GV 16 Berchem TOT
54,Posthofbrug 5366,2020-05-09,03:00:00,1,0,1,FMN GV 16 Berchem TOT
54,Posthofbrug 5366,2020-05-09,04:00:00,3,1,2,FMN GV 16 Berchem TOT
54,Posthofbrug 5366,2020-05-09,05:00:00,10,8,2,FMN GV 16 Berchem TOT
54,Posthofbrug 5366,2020-05-09,06:00:00,10,8,2,FMN GV 16 Berchem TOT
54,Posthofbrug 5366,2020-05-09,07:00:00,27,13,14,FMN GV 16 Berchem TOT
54,Posthofbrug 5366,2020-05-09,08:00:00,42,15,27,FMN GV 16 Berchem TOT
54,Posthofbrug 5366,2020-05-09,09:00:00,89,28,61,FMN GV 16 Berchem TOT
54,Posthofbrug 5366,2020-05-09,10:00:00,165,88,77,FMN GV 16 Berchem TOT
54,Posthofbrug 5366,2020-05-09,11:00:00,209,124,85,FMN GV 16 Berchem TOT
54,Posthofbrug 5366,2020-05-09,12:00:00,240,108,132,FMN GV 16 Berchem TOT
54,Posthofbrug 5366,2020-05-09,13:00:00,372,167,205,FMN GV 16 Berchem TOT
54,Posthofbrug 5366,2020-05-09,14:00:00,406,209,197,FMN GV 16 Berchem TOT
54,Posthofbrug 5366,2020-05-09,15:00:00,380,181,199,FMN GV 16 Berchem TOT
54,Posthofbrug 5366,2020-05-09,16:00:00,361,184,177,FMN GV 16 Berchem TOT
54,Posthofbrug 5366,2020-05-09,17:00:00,306,179,127,FMN GV 16 Berchem TOT
54,Posthofbrug 5366,2020-05-09,18:00:00,210,137,73,FMN GV 16 Berchem TOT
54,Posthofbrug 5366,2020-05-09,19:00:00,169,109,60,FMN GV 16 Berchem TOT
54,Posthofbrug 5366,2020-05-09,20:00:00,90,60,30,FMN GV 16 Berchem TOT
54,Posthofbrug 5366,2020-05-09,21:00:00,76,51,25,FMN GV 16 Berchem TOT
54,Posthofbrug 5366,2020-05-09,22:00:00,56,34,22,FMN GV 16 Berchem TOT
54,Posthofbrug 5366,2020-05-09,23:00:00,35,18,17,FMN GV 16 Berchem TOT
54,Posthofbrug 5366,2020-05-10,00:00:00,37,21,16,FMN GV 16 Berchem TOT
54,Posthofbrug 5366,2020-05-10,01:00:00,7,6,1,FMN GV 16 Berchem TOT
54,Posthofbrug 5366,2020-05-10,02:00:00,6,3,3,FMN GV 16 Berchem TOT
54,Posthofbrug 5366,2020-05-10,03:00:00,4,2,2,FMN GV 16 Berchem TOT
54,Posthofbrug 5366,2020-05-10,04:00:00,2,1,1,FMN GV 16 Berchem TOT
54,Posthofbrug 5366,2020-05-10,05:00:00,5,3,2,FMN GV 16 Berchem TOT
54,Posthofbrug 5366,2020-05-10,06:00:00,17,13,4,FMN GV 16 Berchem TOT
54,Posthofbrug 5366,2020-05-10,07:00:00,24,15,9,FMN GV 16 Berchem TOT
54,Posthofbrug 5366,2020-05-10,08:00:00,28,15,13,FMN GV 16 Berchem TOT
54,Posthofbrug 5366,2020-05-10,09:00:00,46,13,33,FMN GV 16 Berchem TOT
54,Posthofbrug 5366,2020-05-10,10:00:00,100,53,47,FMN GV 16 Berchem TOT
54,Posthofbrug 5366,2020-05-10,11:00:00,127,71,56,FMN GV 16 Berchem TOT
54,Posthofbrug 5366,2020-05-10,12:00:00,135,69,66,FMN GV 16 Berchem TOT
54,Posthofbrug 5366,2020-05-10,13:00:00,143,80,63,FMN GV 16 Berchem TOT
54,Posthofbrug 5366,2020-05-10,14:00:00,183,91,92,FMN GV 16 Berchem TOT
54,Posthofbrug 5366,2020-05-10,15:00:00,198,97,101,FMN GV 16 Berchem TOT
54,Posthofbrug 5366,2020-05-10,16:00:00,89,47,42,FMN GV 16 Berchem TOT
54,Posthofbrug 5366,2020-05-10,17:00:00,50,30,20,FMN GV 16 Berchem TOT
54,Posthofbrug 5366,2020-05-10,18:00:00,55,37,18,FMN GV 16 Berchem TOT
54,Posthofbrug 5366,2020-05-10,19:00:00,46,25,21,FMN GV 16 Berchem TOT
54,Posthofbrug 5366,2020-05-10,20:00:00,35,23,12,FMN GV 16 Berchem TOT
54,Posthofbrug 5366,2020-05-10,21:00:00,28,20,8,FMN GV 16 Berchem TOT
54,Posthofbrug 5366,2020-05-10,22:00:00,18,14,4,FMN GV 16 Berchem TOT
54,Posthofbrug 5366,2020-05-10,23:00:00,8,5,3,FMN GV 16 Berchem TOT
54,Posthofbrug 5366,2020-05-11,00:00:00,4,3,1,FMN GV 16 Berchem TOT
54,Posthofbrug 5366,2020-05-11,01:00:00,1,0,1,FMN GV 16 Berchem TOT
54,Posthofbrug 5366,2020-05-11,02:00:00,0,0,0,FMN GV 16 Berchem TOT
54,Posthofbrug 5366,2020-05-11,03:00:00,0,0,0,FMN GV 16 Berchem TOT
54,Posthofbrug 5366,2020-05-11,04:00:00,4,2,2,FMN GV 16 Berchem TOT
54,Posthofbrug 5366,2020-05-11,05:00:00,12,10,2,FMN GV 16 Berchem TOT
54,Posthofbrug 5366,2020-05-11,06:00:00,46,35,11,FMN GV 16 Berchem TOT
54,Posthofbrug 5366,2020-05-11,07:00:00,129,101,28,FMN GV 16 Berchem TOT
54,Posthofbrug 5366,2020-05-11,08:00:00,172,133,39,FMN GV 16 Berchem TOT
54,Posthofbrug 5366,2020-05-11,09:00:00,80,62,18,FMN GV 16 Berchem TOT
54,Posthofbrug 5366,2020-05-11,10:00:00,61,34,27,FMN GV 16 Berchem TOT
54,Posthofbrug 5366,2020-05-11,11:00:00,57,30,27,FMN GV 16 Berchem TOT
54,Posthofbrug 5366,2020-05-11,12:00:00,78,41,37,FMN GV 16 Berchem TOT
54,Posthofbrug 5366,2020-05-11,13:00:00,72,36,36,FMN GV 16 Berchem TOT
54,Posthofbrug 5366,2020-05-11,14:00:00,88,31,57,FMN GV 16 Berchem TOT
54,Posthofbrug 5366,2020-05-11,15:00:00,133,54,79,FMN GV 16 Berchem TOT
54,Posthofbrug 5366,2020-05-11,16:00:00,162,66,96,FMN GV 16 Berchem TOT
54,Posthofbrug 5366,2020-05-11,17:00:00,172,57,115,FMN GV 16 Berchem TOT
54,Posthofbrug 5366,2020-05-11,18:00:00,137,56,81,FMN GV 16 Berchem TOT
54,Posthofbrug 5366,2020-05-11,19:00:00,88,47,41,FMN GV 16 Berchem TOT
54,Posthofbrug 5366,2020-05-11,20:00:00,53,30,23,FMN GV 16 Berchem TOT
54,Posthofbrug 5366,2020-05-11,21:00:00,35,26,9,FMN GV 16 Berchem TOT
54,Posthofbrug 5366,2020-05-11,22:00:00,29,13,16,FMN GV 16 Berchem TOT
54,Posthofbrug 5366,2020-05-11,23:00:00,12,9,3,FMN GV 16 Berchem TOT
54,Posthofbrug 5366,2020-05-12,00:00:00,5,2,3,FMN GV 16 Berchem TOT
54,Posthofbrug 5366,2020-05-12,01:00:00,4,1,3,FMN GV 16 Berchem TOT
54,Posthofbrug 5366,2020-05-12,02:00:00,0,0,0,FMN GV 16 Berchem TOT
54,Posthofbrug 5366,2020-05-12,03:00:00,0,0,0,FMN GV 16 Berchem TOT
54,Posthofbrug 5366,2020-05-12,04:00:00,5,4,1,FMN GV 16 Berchem TOT
54,Posthofbrug 5366,2020-05-12,05:00:00,14,13,1,FMN GV 16 Berchem TOT
54,Posthofbrug 5366,2020-05-12,06:00:00,57,37,20,FMN GV 16 Berchem TOT
54,Posthofbrug 5366,2020-05-12,07:00:00,143,104,39,FMN GV 16 Berchem TOT
54,Posthofbrug 5366,2020-05-12,08:00:00,199,146,53,FMN GV 16 Berchem TOT
54,Posthofbrug 5366,2020-05-12,09:00:00,83,58,25,FMN GV 16 Berchem TOT
54,Posthofbrug 5366,2020-05-12,10:00:00,65,41,24,FMN GV 16 Berchem TOT
54,Posthofbrug 5366,2020-05-12,11:00:00,72,38,34,FMN GV 16 Berchem TOT
54,Posthofbrug 5366,2020-05-12,12:00:00,86,42,44,FMN GV 16 Berchem TOT
54,Posthofbrug 5366,2020-05-12,13:00:00,90,48,42,FMN GV 16 Berchem TOT
54,Posthofbrug 5366,2020-05-12,14:00:00,120,50,70,FMN GV 16 Berchem TOT
54,Posthofbrug 5366,2020-05-12,15:00:00,126,58,68,FMN GV 16 Berchem TOT
54,Posthofbrug 5366,2020-05-12,16:00:00,180,76,104,FMN GV 16 Berchem TOT
54,Posthofbrug 5366,2020-05-12,17:00:00,201,64,137,FMN GV 16 Berchem TOT
54,Posthofbrug 5366,2020-05-12,18:00:00,152,71,81,FMN GV 16 Berchem TOT
54,Posthofbrug 5366,2020-05-12,19:00:00,91,45,46,FMN GV 16 Berchem TOT
54,Posthofbrug 5366,2020-05-12,20:00:00,60,41,19,FMN GV 16 Berchem TOT
54,Posthofbrug 5366,2020-05-12,21:00:00,34,20,14,FMN GV 16 Berchem TOT
54,Posthofbrug 5366,2020-05-12,22:00:00,36,13,23,FMN GV 16 Berchem TOT
54,Posthofbrug 5366,2020-05-12,23:00:00,10,3,7,FMN GV 16 Berchem TOT
54,Posthofbrug 5366,2020-05-13,00:00:00,7,5,2,FMN GV 16 Berchem TOT
54,Posthofbrug 5366,2020-05-13,01:00:00,5,1,4,FMN GV 16 Berchem TOT
54,Posthofbrug 5366,2020-05-13,02:00:00,1,0,1,FMN GV 16 Berchem TOT
54,Posthofbrug 5366,2020-05-13,03:00:00,0,0,0,FMN GV 16 Berchem TOT
54,Posthofbrug 5366,2020-05-13,04:00:00,13,10,3,FMN GV 16 Berchem TOT
54,Posthofbrug 5366,2020-05-13,05:00:00,16,10,6,FMN GV 16 Berchem TOT
54,Posthofbrug 5366,2020-05-13,06:00:00,62,46,16,FMN GV 16 Berchem TOT
54,Posthofbrug 5366,2020-05-13,07:00:00,137,94,43,FMN GV 16 Berchem TOT
54,Posthofbrug 5366,2020-05-13,08:00:00,167,127,40,FMN GV 16 Berchem TOT
54,Posthofbrug 5366,2020-05-13,09:00:00,92,61,31,FMN GV 16 Berchem TOT
54,Posthofbrug 5366,2020-05-13,10:00:00,74,38,36,FMN GV 16 Berchem TOT
54,Posthofbrug 5366,2020-05-13,11:00:00,84,48,36,FMN GV 16 Berchem TOT
54,Posthofbrug 5366,2020-05-13,12:00:00,131,66,65,FMN GV 16 Berchem TOT
54,Posthofbrug 5366,2020-05-13,13:00:00,136,74,62,FMN GV 16 Berchem TOT
54,Posthofbrug 5366,2020-05-13,14:00:00,120,55,65,FMN GV 16 Berchem TOT
54,Posthofbrug 5366,2020-05-13,15:00:00,122,51,71,FMN GV 16 Berchem TOT
54,Posthofbrug 5366,2020-05-13,16:00:00,168,65,103,FMN GV 16 Berchem TOT
54,Posthofbrug 5366,2020-05-13,17:00:00,213,84,129,FMN GV 16 Berchem TOT
54,Posthofbrug 5366,2020-05-13,18:00:00,187,75,112,FMN GV 16 Berchem TOT
54,Posthofbrug 5366,2020-05-13,19:00:00,103,50,53,FMN GV 16 Berchem TOT
54,Posthofbrug 5366,2020-05-13,20:00:00,59,38,21,FMN GV 16 Berchem TOT
54,Posthofbrug 5366,2020-05-13,21:00:00,39,21,18,FMN GV 16 Berchem TOT
54,Posthofbrug 5366,2020-05-13,22:00:00,29,10,19,FMN GV 16 Berchem TOT
54,Posthofbrug 5366,2020-05-13,23:00:00,11,5,6,FMN GV 16 Berchem TOT
54,Posthofbrug 5366,2020-05-14,00:00:00,4,4,0,FMN GV 16 Berchem TOT
54,Posthofbrug 5366,2020-05-14,01:00:00,12,4,8,FMN GV 16 Berchem TOT
54,Posthofbrug 5366,2020-05-14,02:00:00,0,0,0,FMN GV 16 Berchem TOT
54,Posthofbrug 5366,2020-05-14,03:00:00,1,0,1,FMN GV 16 Berchem TOT
54,Posthofbrug 5366,2020-05-14,04:00:00,11,9,2,FMN GV 16 Berchem TOT
54,Posthofbrug 5366,2020-05-14,05:00:00,18,13,5,FMN GV 16 Berchem TOT
54,Posthofbrug 5366,2020-05-14,06:00:00,57,43,14,FMN GV 16 Berchem TOT
54,Posthofbrug 5366,2020-05-14,07:00:00,141,106,35,FMN GV 16 Berchem TOT
54,Posthofbrug 5366,2020-05-14,08:00:00,184,141,43,FMN GV 16 Berchem TOT
54,Posthofbrug 5366,2020-05-14,09:00:00,109,79,30,FMN GV 16 Berchem TOT
54,Posthofbrug 5366,2020-05-14,10:00:00,72,56,16,FMN GV 16 Berchem TOT
54,Posthofbrug 5366,2020-05-14,11:00:00,83,41,42,FMN GV 16 Berchem TOT
54,Posthofbrug 5366,2020-05-14,12:00:00,110,60,50,FMN GV 16 Berchem TOT
54,Posthofbrug 5366,2020-05-14,13:00:00,117,64,53,FMN GV 16 Berchem TOT
54,Posthofbrug 5366,2020-05-14,14:00:00,144,73,71,FMN GV 16 Berchem TOT
54,Posthofbrug 5366,2020-05-14,15:00:00,187,71,116,FMN GV 16 Berchem TOT
54,Posthofbrug 5366,2020-05-14,16:00:00,241,94,147,FMN GV 16 Berchem TOT
54,Posthofbrug 5366,2020-05-14,17:00:00,278,107,171,FMN GV 16 Berchem TOT
54,Posthofbrug 5366,2020-05-14,18:00:00,214,84,130,FMN GV 16 Berchem TOT
54,Posthofbrug 5366,2020-05-14,19:00:00,131,62,69,FMN GV 16 Berchem TOT
54,Posthofbrug 5366,2020-05-14,20:00:00,67,45,22,FMN GV 16 Berchem TOT
54,Posthofbrug 5366,2020-05-14,21:00:00,73,35,38,FMN GV 16 Berchem TOT
54,Posthofbrug 5366,2020-05-14,22:00:00,39,20,19,FMN GV 16 Berchem TOT
54,Posthofbrug 5366,2020-05-14,23:00:00,13,7,6,FMN GV 16 Berchem TOT
54,Posthofbrug 5366,2020-05-15,00:00:00,9,6,3,FMN GV 16 Berchem TOT
54,Posthofbrug 5366,2020-05-15,01:00:00,5,1,4,FMN GV 16 Berchem TOT
54,Posthofbrug 5366,2020-05-15,02:00:00,3,3,0,FMN GV 16 Berchem TOT
54,Posthofbrug 5366,2020-05-15,03:00:00,0,0,0,FMN GV 16 Berchem TOT
54,Posthofbrug 5366,2020-05-15,04:00:00,8,4,4,FMN GV 16 Berchem TOT
54,Posthofbrug 5366,2020-05-15,05:00:00,13,12,1,FMN GV 16 Berchem TOT
54,Posthofbrug 5366,2020-05-15,06:00:00,52,40,12,FMN GV 16 Berchem TOT
54,Posthofbrug 5366,2020-05-15,07:00:00,160,124,36,FMN GV 16 Berchem TOT
54,Posthofbrug 5366,2020-05-15,08:00:00,175,133,42,FMN GV 16 Berchem TOT
54,Posthofbrug 5366,2020-05-15,09:00:00,125,94,31,FMN GV 16 Berchem TOT
54,Posthofbrug 5366,2020-05-15,10:00:00,92,42,50,FMN GV 16 Berchem TOT
54,Posthofbrug 5366,2020-05-15,11:00:00,114,70,44,FMN GV 16 Berchem TOT
54,Posthofbrug 5366,2020-05-15,12:00:00,155,75,80,FMN GV 16 Berchem TOT
54,Posthofbrug 5366,2020-05-15,13:00:00,148,76,72,FMN GV 16 Berchem TOT
54,Posthofbrug 5366,2020-05-15,14:00:00,200,106,94,FMN GV 16 Berchem TOT
54,Posthofbrug 5366,2020-05-15,15:00:00,228,98,130,FMN GV 16 Berchem TOT
54,Posthofbrug 5366,2020-05-15,16:00:00,296,116,180,FMN GV 16 Berchem TOT
54,Posthofbrug 5366,2020-05-15,17:00:00,250,109,141,FMN GV 16 Berchem TOT
54,Posthofbrug 5366,2020-05-15,18:00:00,172,70,102,FMN GV 16 Berchem TOT
54,Posthofbrug 5366,2020-05-15,19:00:00,99,55,44,FMN GV 16 Berchem TOT
54,Posthofbrug 5366,2020-05-15,20:00:00,51,31,20,FMN GV 16 Berchem TOT
54,Posthofbrug 5366,2020-05-15,21:00:00,59,31,28,FMN GV 16 Berchem TOT
54,Posthofbrug 5366,2020-05-15,22:00:00,46,22,24,FMN GV 16 Berchem TOT
54,Posthofbrug 5366,2020-05-15,23:00:00,21,12,9,FMN GV 16 Berchem TOT
54,Posthofbrug 5366,2020-05-16,00:00:00,12,9,3,FMN GV 16 Berchem TOT
54,Posthofbrug 5366,2020-05-16,01:00:00,8,4,4,FMN GV 16 Berchem TOT
54,Posthofbrug 5366,2020-05-16,02:00:00,7,3,4,FMN GV 16 Berchem TOT
54,Posthofbrug 5366,2020-05-16,03:00:00,1,1,0,FMN GV 16 Berchem TOT
54,Posthofbrug 5366,2020-05-16,04:00:00,17,8,9,FMN GV 16 Berchem TOT
54,Posthofbrug 5366,2020-05-16,05:00:00,6,4,2,FMN GV 16 Berchem TOT
54,Posthofbrug 5366,2020-05-16,06:00:00,13,11,2,FMN GV 16 Berchem TOT
54,Posthofbrug 5366,2020-05-16,07:00:00,25,12,13,FMN GV 16 Berchem TOT
54,Posthofbrug 5366,2020-05-16,08:00:00,42,23,19,FMN GV 16 Berchem TOT
54,Posthofbrug 5366,2020-05-16,09:00:00,99,47,52,FMN GV 16 Berchem TOT
54,Posthofbrug 5366,2020-05-16,10:00:00,108,58,50,FMN GV 16 Berchem TOT
54,Posthofbrug 5366,2020-05-16,11:00:00,173,104,69,FMN GV 16 Berchem TOT
54,Posthofbrug 5366,2020-05-16,12:00:00,212,129,83,FMN GV 16 Berchem TOT
54,Posthofbrug 5366,2020-05-16,13:00:00,166,79,87,FMN GV 16 Berchem TOT
54,Posthofbrug 5366,2020-05-16,14:00:00,262,133,129,FMN GV 16 Berchem TOT
54,Posthofbrug 5366,2020-05-16,15:00:00,357,194,163,FMN GV 16 Berchem TOT
54,Posthofbrug 5366,2020-05-16,16:00:00,209,85,124,FMN GV 16 Berchem TOT
54,Posthofbrug 5366,2020-05-16,17:00:00,209,114,95,FMN GV 16 Berchem TOT
54,Posthofbrug 5366,2020-05-16,18:00:00,183,110,73,FMN GV 16 Berchem TOT
54,Posthofbrug 5366,2020-05-16,19:00:00,103,52,51,FMN GV 16 Berchem TOT
54,Posthofbrug 5366,2020-05-16,20:00:00,60,31,29,FMN GV 16 Berchem TOT
54,Posthofbrug 5366,2020-05-16,21:00:00,54,40,14,FMN GV 16 Berchem TOT
54,Posthofbrug 5366,2020-05-16,22:00:00,47,23,24,FMN GV 16 Berchem TOT
54,Posthofbrug 5366,2020-05-16,23:00:00,35,12,23,FMN GV 16 Berchem TOT
54,Posthofbrug 5366,2020-05-17,00:00:00,13,4,9,FMN GV 16 Berchem TOT
54,Posthofbrug 5366,2020-05-17,01:00:00,8,3,5,FMN GV 16 Berchem TOT
54,Posthofbrug 5366,2020-05-17,02:00:00,7,5,2,FMN GV 16 Berchem TOT
54,Posthofbrug 5366,2020-05-17,03:00:00,4,1,3,FMN GV 16 Berchem TOT
54,Posthofbrug 5366,2020-05-17,04:00:00,4,4,0,FMN GV 16 Berchem TOT
54,Posthofbrug 5366,2020-05-17,05:00:00,9,7,2,FMN GV 16 Berchem TOT
54,Posthofbrug 5366,2020-05-17,06:00:00,11,4,7,FMN GV 16 Berchem TOT
54,Posthofbrug 5366,2020-05-17,07:00:00,18,12,6,FMN GV 16 Berchem TOT
54,Posthofbrug 5366,2020-05-17,08:00:00,48,17,31,FMN GV 16 Berchem TOT
54,Posthofbrug 5366,2020-05-17,09:00:00,88,37,51,FMN GV 16 Berchem TOT
54,Posthofbrug 5366,2020-05-17,10:00:00,167,79,88,FMN GV 16 Berchem TOT
54,Posthofbrug 5366,2020-05-17,11:00:00,215,99,116,FMN GV 16 Berchem TOT
54,Posthofbrug 5366,2020-05-17,12:00:00,271,124,147,FMN GV 16 Berchem TOT
54,Posthofbrug 5366,2020-05-17,13:00:00,296,155,141,FMN GV 16 Berchem TOT
54,Posthofbrug 5366,2020-05-17,14:00:00,355,166,189,FMN GV 16 Berchem TOT
54,Posthofbrug 5366,2020-05-17,15:00:00,332,171,161,FMN GV 16 Berchem TOT
54,Posthofbrug 5366,2020-05-17,16:00:00,308,175,133,FMN GV 16 Berchem TOT
54,Posthofbrug 5366,2020-05-17,17:00:00,271,152,119,FMN GV 16 Berchem TOT
54,Posthofbrug 5366,2020-05-17,18:00:00,182,117,65,FMN GV 16 Berchem TOT
54,Posthofbrug 5366,2020-05-17,19:00:00,126,73,53,FMN GV 16 Berchem TOT
54,Posthofbrug 5366,2020-05-17,20:00:00,107,72,35,FMN GV 16 Berchem TOT
54,Posthofbrug 5366,2020-05-17,21:00:00,83,59,24,FMN GV 16 Berchem TOT
54,Posthofbrug 5366,2020-05-17,22:00:00,69,39,30,FMN GV 16 Berchem TOT
54,Posthofbrug 5366,2020-05-17,23:00:00,18,14,4,FMN GV 16 Berchem TOT
54,Posthofbrug 5366,2020-05-18,00:00:00,3,1,2,FMN GV 16 Berchem TOT
54,Posthofbrug 5366,2020-05-18,01:00:00,6,1,5,FMN GV 16 Berchem TOT
54,Posthofbrug 5366,2020-05-18,02:00:00,0,0,0,FMN GV 16 Berchem TOT
54,Posthofbrug 5366,2020-05-18,03:00:00,4,2,2,FMN GV 16 Berchem TOT
54,Posthofbrug 5366,2020-05-18,04:00:00,11,9,2,FMN GV 16 Berchem TOT
54,Posthofbrug 5366,2020-05-18,05:00:00,18,15,3,FMN GV 16 Berchem TOT
54,Posthofbrug 5366,2020-05-18,06:00:00,66,54,12,FMN GV 16 Berchem TOT
54,Posthofbrug 5366,2020-05-18,07:00:00,192,143,49,FMN GV 16 Berchem TOT
54,Posthofbrug 5366,2020-05-18,08:00:00,261,194,67,FMN GV 16 Berchem TOT
54,Posthofbrug 5366,2020-05-18,09:00:00,140,102,38,FMN GV 16 Berchem TOT
54,Posthofbrug 5366,2020-05-18,10:00:00,97,59,38,FMN GV 16 Berchem TOT
54,Posthofbrug 5366,2020-05-18,11:00:00,110,51,59,FMN GV 16 Berchem TOT
54,Posthofbrug 5366,2020-05-18,12:00:00,154,83,71,FMN GV 16 Berchem TOT
54,Posthofbrug 5366,2020-05-18,13:00:00,170,83,87,FMN GV 16 Berchem TOT
54,Posthofbrug 5366,2020-05-18,14:00:00,187,85,102,FMN GV 16 Berchem TOT
54,Posthofbrug 5366,2020-05-18,15:00:00,233,94,139,FMN GV 16 Berchem TOT
54,Posthofbrug 5366,2020-05-18,16:00:00,284,108,176,FMN GV 16 Berchem TOT
54,Posthofbrug 5366,2020-05-18,17:00:00,300,103,197,FMN GV 16 Berchem TOT
54,Posthofbrug 5366,2020-05-18,18:00:00,225,93,132,FMN GV 16 Berchem TOT
54,Posthofbrug 5366,2020-05-18,19:00:00,133,56,77,FMN GV 16 Berchem TOT
54,Posthofbrug 5366,2020-05-18,20:00:00,93,47,46,FMN GV 16 Berchem TOT
54,Posthofbrug 5366,2020-05-18,21:00:00,66,43,23,FMN GV 16 Berchem TOT
54,Posthofbrug 5366,2020-05-18,22:00:00,50,16,34,FMN GV 16 Berchem TOT
54,Posthofbrug 5366,2020-05-18,23:00:00,13,6,7,FMN GV 16 Berchem TOT
54,Posthofbrug 5366,2020-05-19,00:00:00,5,1,4,FMN GV 16 Berchem TOT
54,Posthofbrug 5366,2020-05-19,01:00:00,5,2,3,FMN GV 16 Berchem TOT
54,Posthofbrug 5366,2020-05-19,02:00:00,1,0,1,FMN GV 16 Berchem TOT
54,Posthofbrug 5366,2020-05-19,03:00:00,3,0,3,FMN GV 16 Berchem TOT
54,Posthofbrug 5366,2020-05-19,04:00:00,8,4,4,FMN GV 16 Berchem TOT
54,Posthofbrug 5366,2020-05-19,05:00:00,14,10,4,FMN GV 16 Berchem TOT
54,Posthofbrug 5366,2020-05-19,06:00:00,77,60,17,FMN GV 16 Berchem TOT
54,Posthofbrug 5366,2020-05-19,07:00:00,217,161,56,FMN GV 16 Berchem TOT
54,Posthofbrug 5366,2020-05-19,08:00:00,263,191,72,FMN GV 16 Berchem TOT
54,Posthofbrug 5366,2020-05-19,09:00:00,145,103,42,FMN GV 16 Berchem TOT
54,Posthofbrug 5366,2020-05-19,10:00:00,114,67,47,FMN GV 16 Berchem TOT
54,Posthofbrug 5366,2020-05-19,11:00:00,138,65,73,FMN GV 16 Berchem TOT
54,Posthofbrug 5366,2020-05-19,12:00:00,171,86,85,FMN GV 16 Berchem TOT
54,Posthofbrug 5366,2020-05-19,13:00:00,175,95,80,FMN GV 16 Berchem TOT
54,Posthofbrug 5366,2020-05-19,14:00:00,229,112,117,FMN GV 16 Berchem TOT
54,Posthofbrug 5366,2020-05-19,15:00:00,271,116,155,FMN GV 16 Berchem TOT
54,Posthofbrug 5366,2020-05-19,16:00:00,303,108,195,FMN GV 16 Berchem TOT
54,Posthofbrug 5366,2020-05-19,17:00:00,350,126,224,FMN GV 16 Berchem TOT
54,Posthofbrug 5366,2020-05-19,18:00:00,270,87,183,FMN GV 16 Berchem TOT
54,Posthofbrug 5366,2020-05-19,19:00:00,189,75,114,FMN GV 16 Berchem TOT
54,Posthofbrug 5366,2020-05-19,20:00:00,131,63,68,FMN GV 16 Berchem TOT
54,Posthofbrug 5366,2020-05-19,21:00:00,75,48,27,FMN GV 16 Berchem TOT
54,Posthofbrug 5366,2020-05-19,22:00:00,117,65,52,FMN GV 16 Berchem TOT
54,Posthofbrug 5366,2020-05-19,23:00:00,31,17,14,FMN GV 16 Berchem TOT
54,Posthofbrug 5366,2020-05-20,00:00:00,11,6,5,FMN GV 16 Berchem TOT
54,Posthofbrug 5366,2020-05-20,01:00:00,6,2,4,FMN GV 16 Berchem TOT
54,Posthofbrug 5366,2020-05-20,02:00:00,1,1,0,FMN GV 16 Berchem TOT
54,Posthofbrug 5366,2020-05-20,03:00:00,3,2,1,FMN GV 16 Berchem TOT
54,Posthofbrug 5366,2020-05-20,04:00:00,5,2,3,FMN GV 16 Berchem TOT
54,Posthofbrug 5366,2020-05-20,05:00:00,18,16,2,FMN GV 16 Berchem TOT
54,Posthofbrug 5366,2020-05-20,06:00:00,66,43,23,FMN GV 16 Berchem TOT
54,Posthofbrug 5366,2020-05-20,07:00:00,196,146,50,FMN GV 16 Berchem TOT
54,Posthofbrug 5366,2020-05-20,08:00:00,237,182,55,FMN GV 16 Berchem TOT
54,Posthofbrug 5366,2020-05-20,09:00:00,147,105,42,FMN GV 16 Berchem TOT
54,Posthofbrug 5366,2020-05-20,10:00:00,127,78,49,FMN GV 16 Berchem TOT
54,Posthofbrug 5366,2020-05-20,11:00:00,155,82,73,FMN GV 16 Berchem TOT
54,Posthofbrug 5366,2020-05-20,12:00:00,198,94,104,FMN GV 16 Berchem TOT
54,Posthofbrug 5366,2020-05-20,13:00:00,185,109,76,FMN GV 16 Berchem TOT
54,Posthofbrug 5366,2020-05-20,14:00:00,243,112,131,FMN GV 16 Berchem TOT
54,Posthofbrug 5366,2020-05-20,15:00:00,239,94,145,FMN GV 16 Berchem TOT
54,Posthofbrug 5366,2020-05-20,16:00:00,309,127,182,FMN GV 16 Berchem TOT
54,Posthofbrug 5366,2020-05-20,17:00:00,359,115,244,FMN GV 16 Berchem TOT
54,Posthofbrug 5366,2020-05-20,18:00:00,279,116,163,FMN GV 16 Berchem TOT
54,Posthofbrug 5366,2020-05-20,19:00:00,171,72,99,FMN GV 16 Berchem TOT
54,Posthofbrug 5366,2020-05-20,20:00:00,122,59,63,FMN GV 16 Berchem TOT
54,Posthofbrug 5366,2020-05-20,21:00:00,72,49,23,FMN GV 16 Berchem TOT
54,Posthofbrug 5366,2020-05-20,22:00:00,79,40,39,FMN GV 16 Berchem TOT
54,Posthofbrug 5366,2020-05-20,23:00:00,41,22,19,FMN GV 16 Berchem TOT
54,Posthofbrug 5366,2020-05-21,00:00:00,36,14,22,FMN GV 16 Berchem TOT
54,Posthofbrug 5366,2020-05-21,01:00:00,16,6,10,FMN GV 16 Berchem TOT
54,Posthofbrug 5366,2020-05-21,02:00:00,5,1,4,FMN GV 16 Berchem TOT
54,Posthofbrug 5366,2020-05-21,03:00:00,1,0,1,FMN GV 16 Berchem TOT
54,Posthofbrug 5366,2020-05-21,04:00:00,2,1,1,FMN GV 16 Berchem TOT
54,Posthofbrug 5366,2020-05-21,05:00:00,7,5,2,FMN GV 16 Berchem TOT
54,Posthofbrug 5366,2020-05-21,06:00:00,10,7,3,FMN GV 16 Berchem TOT
54,Posthofbrug 5366,2020-05-21,07:00:00,31,15,16,FMN GV 16 Berchem TOT
54,Posthofbrug 5366,2020-05-21,08:00:00,71,21,50,FMN GV 16 Berchem TOT
54,Posthofbrug 5366,2020-05-21,09:00:00,124,55,69,FMN GV 16 Berchem TOT
54,Posthofbrug 5366,2020-05-21,10:00:00,222,100,122,FMN GV 16 Berchem TOT
54,Posthofbrug 5366,2020-05-21,11:00:00,283,157,126,FMN GV 16 Berchem TOT
54,Posthofbrug 5366,2020-05-21,12:00:00,310,168,142,FMN GV 16 Berchem TOT
54,Posthofbrug 5366,2020-05-21,13:00:00,347,187,160,FMN GV 16 Berchem TOT
54,Posthofbrug 5366,2020-05-21,14:00:00,384,189,195,FMN GV 16 Berchem TOT
54,Posthofbrug 5366,2020-05-21,15:00:00,363,179,184,FMN GV 16 Berchem TOT
54,Posthofbrug 5366,2020-05-21,16:00:00,299,134,165,FMN GV 16 Berchem TOT
54,Posthofbrug 5366,2020-05-21,17:00:00,270,126,144,FMN GV 16 Berchem TOT
54,Posthofbrug 5366,2020-05-21,18:00:00,218,127,91,FMN GV 16 Berchem TOT
54,Posthofbrug 5366,2020-05-21,19:00:00,154,97,57,FMN GV 16 Berchem TOT
54,Posthofbrug 5366,2020-05-21,20:00:00,130,71,59,FMN GV 16 Berchem TOT
54,Posthofbrug 5366,2020-05-21,21:00:00,127,83,44,FMN GV 16 Berchem TOT
54,Posthofbrug 5366,2020-05-21,22:00:00,88,56,32,FMN GV 16 Berchem TOT
54,Posthofbrug 5366,2020-05-21,23:00:00,47,27,20,FMN GV 16 Berchem TOT
54,Posthofbrug 5366,2020-05-22,00:00:00,38,25,13,FMN GV 16 Berchem TOT
54,Posthofbrug 5366,2020-05-22,01:00:00,22,12,10,FMN GV 16 Berchem TOT
54,Posthofbrug 5366,2020-05-22,02:00:00,6,0,6,FMN GV 16 Berchem TOT
54,Posthofbrug 5366,2020-05-22,03:00:00,4,2,2,FMN GV 16 Berchem TOT
54,Posthofbrug 5366,2020-05-22,04:00:00,4,4,0,FMN GV 16 Berchem TOT
54,Posthofbrug 5366,2020-05-22,05:00:00,12,10,2,FMN GV 16 Berchem TOT
54,Posthofbrug 5366,2020-05-22,06:00:00,33,24,9,FMN GV 16 Berchem TOT
54,Posthofbrug 5366,2020-05-22,07:00:00,67,48,19,FMN GV 16 Berchem TOT
54,Posthofbrug 5366,2020-05-22,08:00:00,98,63,35,FMN GV 16 Berchem TOT
54,Posthofbrug 5366,2020-05-22,09:00:00,123,83,40,FMN GV 16 Berchem TOT
54,Posthofbrug 5366,2020-05-22,10:00:00,122,70,52,FMN GV 16 Berchem TOT
54,Posthofbrug 5366,2020-05-22,11:00:00,177,103,74,FMN GV 16 Berchem TOT
54,Posthofbrug 5366,2020-05-22,12:00:00,179,108,71,FMN GV 16 Berchem TOT
54,Posthofbrug 5366,2020-05-22,13:00:00,252,132,120,FMN GV 16 Berchem TOT
54,Posthofbrug 5366,2020-05-22,14:00:00,220,101,119,FMN GV 16 Berchem TOT
54,Posthofbrug 5366,2020-05-22,15:00:00,219,105,114,FMN GV 16 Berchem TOT
54,Posthofbrug 5366,2020-05-22,16:00:00,179,78,101,FMN GV 16 Berchem TOT
54,Posthofbrug 5366,2020-05-22,17:00:00,190,74,116,FMN GV 16 Berchem TOT
54,Posthofbrug 5366,2020-05-22,18:00:00,156,60,96,FMN GV 16 Berchem TOT
54,Posthofbrug 5366,2020-05-22,19:00:00,90,45,45,FMN GV 16 Berchem TOT
54,Posthofbrug 5366,2020-05-22,20:00:00,59,35,24,FMN GV 16 Berchem TOT
54,Posthofbrug 5366,2020-05-22,21:00:00,60,38,22,FMN GV 16 Berchem TOT
54,Posthofbrug 5366,2020-05-22,22:00:00,37,15,22,FMN GV 16 Berchem TOT
54,Posthofbrug 5366,2020-05-22,23:00:00,24,11,13,FMN GV 16 Berchem TOT
54,Posthofbrug 5366,2020-05-23,00:00:00,8,4,4,FMN GV 16 Berchem TOT
54,Posthofbrug 5366,2020-05-23,01:00:00,10,4,6,FMN GV 16 Berchem TOT
54,Posthofbrug 5366,2020-05-23,02:00:00,11,1,10,FMN GV 16 Berchem TOT
54,Posthofbrug 5366,2020-05-23,03:00:00,2,2,0,FMN GV 16 Berchem TOT
54,Posthofbrug 5366,2020-05-23,04:00:00,6,4,2,FMN GV 16 Berchem TOT
54,Posthofbrug 5366,2020-05-23,05:00:00,5,5,0,FMN GV 16 Berchem TOT
54,Posthofbrug 5366,2020-05-23,06:00:00,10,7,3,FMN GV 16 Berchem TOT
54,Posthofbrug 5366,2020-05-23,07:00:00,28,18,10,FMN GV 16 Berchem TOT
54,Posthofbrug 5366,2020-05-23,08:00:00,57,36,21,FMN GV 16 Berchem TOT
54,Posthofbrug 5366,2020-05-23,09:00:00,81,49,32,FMN GV 16 Berchem TOT
54,Posthofbrug 5366,2020-05-23,10:00:00,151,91,60,FMN GV 16 Berchem TOT
54,Posthofbrug 5366,2020-05-23,11:00:00,138,71,67,FMN GV 16 Berchem TOT
54,Posthofbrug 5366,2020-05-23,12:00:00,177,89,88,FMN GV 16 Berchem TOT
54,Posthofbrug 5366,2020-05-23,13:00:00,203,107,96,FMN GV 16 Berchem TOT
54,Posthofbrug 5366,2020-05-23,14:00:00,269,152,117,FMN GV 16 Berchem TOT
54,Posthofbrug 5366,2020-05-23,15:00:00,234,104,130,FMN GV 16 Berchem TOT
54,Posthofbrug 5366,2020-05-23,16:00:00,239,99,140,FMN GV 16 Berchem TOT
54,Posthofbrug 5366,2020-05-23,17:00:00,182,74,108,FMN GV 16 Berchem TOT
54,Posthofbrug 5366,2020-05-23,18:00:00,142,70,72,FMN GV 16 Berchem TOT
54,Posthofbrug 5366,2020-05-23,19:00:00,117,58,59,FMN GV 16 Berchem TOT
54,Posthofbrug 5366,2020-05-23,20:00:00,67,40,27,FMN GV 16 Berchem TOT
54,Posthofbrug 5366,2020-05-23,21:00:00,53,31,22,FMN GV 16 Berchem TOT
54,Posthofbrug 5366,2020-05-23,22:00:00,36,21,15,FMN GV 16 Berchem TOT
54,Posthofbrug 5366,2020-05-23,23:00:00,31,12,19,FMN GV 16 Berchem TOT
54,Posthofbrug 5366,2020-05-24,00:00:00,30,8,22,FMN GV 16 Berchem TOT
54,Posthofbrug 5366,2020-05-24,01:00:00,10,5,5,FMN GV 16 Berchem TOT
54,Posthofbrug 5366,2020-05-24,02:00:00,3,1,2,FMN GV 16 Berchem TOT
54,Posthofbrug 5366,2020-05-24,03:00:00,5,1,4,FMN GV 16 Berchem TOT
54,Posthofbrug 5366,2020-05-24,04:00:00,5,5,0,FMN GV 16 Berchem TOT
54,Posthofbrug 5366,2020-05-24,05:00:00,4,4,0,FMN GV 16 Berchem TOT
54,Posthofbrug 5366,2020-05-24,06:00:00,9,8,1,FMN GV 16 Berchem TOT
54,Posthofbrug 5366,2020-05-24,07:00:00,31,17,14,FMN GV 16 Berchem TOT
54,Posthofbrug 5366,2020-05-24,08:00:00,60,22,38,FMN GV 16 Berchem TOT
54,Posthofbrug 5366,2020-05-24,09:00:00,112,63,49,FMN GV 16 Berchem TOT
54,Posthofbrug 5366,2020-05-24,10:00:00,136,85,51,FMN GV 16 Berchem TOT
54,Posthofbrug 5366,2020-05-24,11:00:00,146,76,70,FMN GV 16 Berchem TOT
54,Posthofbrug 5366,2020-05-24,12:00:00,169,77,92,FMN GV 16 Berchem TOT
54,Posthofbrug 5366,2020-05-24,13:00:00,228,128,100,FMN GV 16 Berchem TOT
54,Posthofbrug 5366,2020-05-24,14:00:00,215,115,100,FMN GV 16 Berchem TOT
54,Posthofbrug 5366,2020-05-24,15:00:00,218,118,100,FMN GV 16 Berchem TOT
54,Posthofbrug 5366,2020-05-24,16:00:00,404,203,201,FMN GV 16 Berchem TOT
54,Posthofbrug 5366,2020-05-24,17:00:00,175,83,92,FMN GV 16 Berchem TOT
54,Posthofbrug 5366,2020-05-24,18:00:00,128,63,65,FMN GV 16 Berchem TOT
54,Posthofbrug 5366,2020-05-24,19:00:00,94,59,35,FMN GV 16 Berchem TOT
54,Posthofbrug 5366,2020-05-24,20:00:00,58,36,22,FMN GV 16 Berchem TOT
54,Posthofbrug 5366,2020-05-24,21:00:00,53,34,19,FMN GV 16 Berchem TOT
54,Posthofbrug 5366,2020-05-24,22:00:00,33,22,11,FMN GV 16 Berchem TOT
54,Posthofbrug 5366,2020-05-24,23:00:00,13,7,6,FMN GV 16 Berchem TOT
54,Posthofbrug 5366,2020-05-25,00:00:00,3,2,1,FMN GV 16 Berchem TOT
54,Posthofbrug 5366,2020-05-25,01:00:00,4,2,2,FMN GV 16 Berchem TOT
54,Posthofbrug 5366,2020-05-25,02:00:00,2,2,0,FMN GV 16 Berchem TOT
54,Posthofbrug 5366,2020-05-25,03:00:00,1,1,0,FMN GV 16 Berchem TOT
54,Posthofbrug 5366,2020-05-25,04:00:00,9,7,2,FMN GV 16 Berchem TOT
54,Posthofbrug 5366,2020-05-25,05:00:00,17,13,4,FMN GV 16 Berchem TOT
54,Posthofbrug 5366,2020-05-25,06:00:00,68,51,17,FMN GV 16 Berchem TOT
54,Posthofbrug 5366,2020-05-25,07:00:00,193,144,49,FMN GV 16 Berchem TOT
54,Posthofbrug 5366,2020-05-25,08:00:00,302,221,81,FMN GV 16 Berchem TOT
54,Posthofbrug 5366,2020-05-25,09:00:00,151,109,42,FMN GV 16 Berchem TOT
54,Posthofbrug 5366,2020-05-25,10:00:00,87,56,31,FMN GV 16 Berchem TOT
54,Posthofbrug 5366,2020-05-25,11:00:00,130,67,63,FMN GV 16 Berchem TOT
54,Posthofbrug 5366,2020-05-25,12:00:00,132,71,61,FMN GV 16 Berchem TOT
54,Posthofbrug 5366,2020-05-25,13:00:00,163,94,69,FMN GV 16 Berchem TOT
54,Posthofbrug 5366,2020-05-25,14:00:00,189,89,100,FMN GV 16 Berchem TOT
54,Posthofbrug 5366,2020-05-25,15:00:00,236,102,134,FMN GV 16 Berchem TOT
54,Posthofbrug 5366,2020-05-25,16:00:00,254,72,182,FMN GV 16 Berchem TOT
54,Posthofbrug 5366,2020-05-25,17:00:00,291,112,179,FMN GV 16 Berchem TOT
54,Posthofbrug 5366,2020-05-25,18:00:00,254,93,161,FMN GV 16 Berchem TOT
54,Posthofbrug 5366,2020-05-25,19:00:00,157,64,93,FMN GV 16 Berchem TOT
54,Posthofbrug 5366,2020-05-25,20:00:00,88,50,38,FMN GV 16 Berchem TOT
54,Posthofbrug 5366,2020-05-25,21:00:00,65,38,27,FMN GV 16 Berchem TOT
54,Posthofbrug 5366,2020-05-25,22:00:00,42,24,18,FMN GV 16 Berchem TOT
54,Posthofbrug 5366,2020-05-25,23:00:00,29,12,17,FMN GV 16 Berchem TOT
54,Posthofbrug 5366,2020-05-26,00:00:00,11,6,5,FMN GV 16 Berchem TOT
54,Posthofbrug 5366,2020-05-26,01:00:00,3,1,2,FMN GV 16 Berchem TOT
54,Posthofbrug 5366,2020-05-26,02:00:00,2,1,1,FMN GV 16 Berchem TOT
54,Posthofbrug 5366,2020-05-26,03:00:00,1,0,1,FMN GV 16 Berchem TOT
54,Posthofbrug 5366,2020-05-26,04:00:00,11,9,2,FMN GV 16 Berchem TOT
54,Posthofbrug 5366,2020-05-26,05:00:00,22,15,7,FMN GV 16 Berchem TOT
54,Posthofbrug 5366,2020-05-26,06:00:00,98,74,24,FMN GV 16 Berchem TOT
54,Posthofbrug 5366,2020-05-26,07:00:00,227,173,54,FMN GV 16 Berchem TOT
54,Posthofbrug 5366,2020-05-26,08:00:00,303,211,92,FMN GV 16 Berchem TOT
54,Posthofbrug 5366,2020-05-26,09:00:00,171,132,39,FMN GV 16 Berchem TOT
54,Posthofbrug 5366,2020-05-26,10:00:00,106,67,39,FMN GV 16 Berchem TOT
54,Posthofbrug 5366,2020-05-26,11:00:00,117,60,57,FMN GV 16 Berchem TOT
54,Posthofbrug 5366,2020-05-26,12:00:00,182,93,89,FMN GV 16 Berchem TOT
54,Posthofbrug 5366,2020-05-26,13:00:00,209,128,81,FMN GV 16 Berchem TOT
54,Posthofbrug 5366,2020-05-26,14:00:00,192,92,100,FMN GV 16 Berchem TOT
54,Posthofbrug 5366,2020-05-26,15:00:00,235,99,136,FMN GV 16 Berchem TOT
54,Posthofbrug 5366,2020-05-26,16:00:00,330,106,224,FMN GV 16 Berchem TOT
54,Posthofbrug 5366,2020-05-26,17:00:00,356,128,228,FMN GV 16 Berchem TOT
54,Posthofbrug 5366,2020-05-26,18:00:00,313,110,203,FMN GV 16 Berchem TOT
54,Posthofbrug 5366,2020-05-26,19:00:00,149,58,91,FMN GV 16 Berchem TOT
54,Posthofbrug 5366,2020-05-26,20:00:00,126,63,63,FMN GV 16 Berchem TOT
54,Posthofbrug 5366,2020-05-26,21:00:00,78,60,18,FMN GV 16 Berchem TOT
54,Posthofbrug 5366,2020-05-26,22:00:00,60,38,22,FMN GV 16 Berchem TOT
54,Posthofbrug 5366,2020-05-26,23:00:00,25,11,14,FMN GV 16 Berchem TOT
54,Posthofbrug 5366,2020-05-27,00:00:00,14,7,7,FMN GV 16 Berchem TOT
54,Posthofbrug 5366,2020-05-27,01:00:00,4,2,2,FMN GV 16 Berchem TOT
54,Posthofbrug 5366,2020-05-27,02:00:00,5,0,5,FMN GV 16 Berchem TOT
54,Posthofbrug 5366,2020-05-27,03:00:00,2,0,2,FMN GV 16 Berchem TOT
54,Posthofbrug 5366,2020-05-27,04:00:00,10,6,4,FMN GV 16 Berchem TOT
54,Posthofbrug 5366,2020-05-27,05:00:00,17,12,5,FMN GV 16 Berchem TOT
54,Posthofbrug 5366,2020-05-27,06:00:00,71,56,15,FMN GV 16 Berchem TOT
54,Posthofbrug 5366,2020-05-27,07:00:00,218,159,59,FMN GV 16 Berchem TOT
54,Posthofbrug 5366,2020-05-27,08:00:00,266,204,62,FMN GV 16 Berchem TOT
54,Posthofbrug 5366,2020-05-27,09:00:00,166,111,55,FMN GV 16 Berchem TOT
54,Posthofbrug 5366,2020-05-27,10:00:00,123,84,39,FMN GV 16 Berchem TOT
54,Posthofbrug 5366,2020-05-27,11:00:00,134,75,59,FMN GV 16 Berchem TOT
54,Posthofbrug 5366,2020-05-27,12:00:00,212,110,102,FMN GV 16 Berchem TOT
54,Posthofbrug 5366,2020-05-27,13:00:00,251,146,105,FMN GV 16 Berchem TOT
54,Posthofbrug 5366,2020-05-27,14:00:00,204,91,113,FMN GV 16 Berchem TOT
54,Posthofbrug 5366,2020-05-27,15:00:00,254,98,156,FMN GV 16 Berchem TOT
54,Posthofbrug 5366,2020-05-27,16:00:00,274,101,173,FMN GV 16 Berchem TOT
54,Posthofbrug 5366,2020-05-27,17:00:00,383,121,262,FMN GV 16 Berchem TOT
54,Posthofbrug 5366,2020-05-27,18:00:00,283,109,174,FMN GV 16 Berchem TOT
54,Posthofbrug 5366,2020-05-27,19:00:00,167,77,90,FMN GV 16 Berchem TOT
54,Posthofbrug 5366,2020-05-27,20:00:00,132,73,59,FMN GV 16 Berchem TOT
54,Posthofbrug 5366,2020-05-27,21:00:00,90,55,35,FMN GV 16 Berchem TOT
54,Posthofbrug 5366,2020-05-27,22:00:00,62,35,27,FMN GV 16 Berchem TOT
54,Posthofbrug 5366,2020-05-27,23:00:00,24,12,12,FMN GV 16 Berchem TOT
54,Posthofbrug 5366,2020-05-28,00:00:00,14,9,5,FMN GV 16 Berchem TOT
54,Posthofbrug 5366,2020-05-28,01:00:00,7,2,5,FMN GV 16 Berchem TOT
54,Posthofbrug 5366,2020-05-28,02:00:00,4,0,4,FMN GV 16 Berchem TOT
54,Posthofbrug 5366,2020-05-28,03:00:00,1,1,0,FMN GV 16 Berchem TOT
54,Posthofbrug 5366,2020-05-28,04:00:00,7,4,3,FMN GV 16 Berchem TOT
54,Posthofbrug 5366,2020-05-28,05:00:00,24,20,4,FMN GV 16 Berchem TOT
54,Posthofbrug 5366,2020-05-28,06:00:00,82,66,16,FMN GV 16 Berchem TOT
54,Posthofbrug 5366,2020-05-28,07:00:00,233,174,59,FMN GV 16 Berchem TOT
54,Posthofbrug 5366,2020-05-28,08:00:00,276,207,69,FMN GV 16 Berchem TOT
54,Posthofbrug 5366,2020-05-28,09:00:00,155,122,33,FMN GV 16 Berchem TOT
54,Posthofbrug 5366,2020-05-28,10:00:00,96,68,28,FMN GV 16 Berchem TOT
54,Posthofbrug 5366,2020-05-28,11:00:00,116,60,56,FMN GV 16 Berchem TOT
54,Posthofbrug 5366,2020-05-28,12:00:00,172,82,90,FMN GV 16 Berchem TOT
54,Posthofbrug 5366,2020-05-28,13:00:00,178,90,88,FMN GV 16 Berchem TOT
54,Posthofbrug 5366,2020-05-28,14:00:00,201,111,90,FMN GV 16 Berchem TOT
54,Posthofbrug 5366,2020-05-28,15:00:00,227,85,142,FMN GV 16 Berchem TOT
54,Posthofbrug 5366,2020-05-28,16:00:00,301,102,199,FMN GV 16 Berchem TOT
54,Posthofbrug 5366,2020-05-28,17:00:00,340,119,221,FMN GV 16 Berchem TOT
54,Posthofbrug 5366,2020-05-28,18:00:00,279,120,159,FMN GV 16 Berchem TOT
54,Posthofbrug 5366,2020-05-28,19:00:00,168,88,80,FMN GV 16 Berchem TOT
54,Posthofbrug 5366,2020-05-28,20:00:00,121,60,61,FMN GV 16 Berchem TOT
54,Posthofbrug 5366,2020-05-28,21:00:00,124,78,46,FMN GV 16 Berchem TOT
54,Posthofbrug 5366,2020-05-28,22:00:00,78,35,43,FMN GV 16 Berchem TOT
54,Posthofbrug 5366,2020-05-28,23:00:00,32,19,13,FMN GV 16 Berchem TOT
54,Posthofbrug 5366,2020-05-29,00:00:00,18,8,10,FMN GV 16 Berchem TOT
54,Posthofbrug 5366,2020-05-29,01:00:00,7,4,3,FMN GV 16 Berchem TOT
54,Posthofbrug 5366,2020-05-29,02:00:00,4,0,4,FMN GV 16 Berchem TOT
54,Posthofbrug 5366,2020-05-29,03:00:00,4,2,2,FMN GV 16 Berchem TOT
54,Posthofbrug 5366,2020-05-29,04:00:00,7,5,2,FMN GV 16 Berchem TOT
54,Posthofbrug 5366,2020-05-29,05:00:00,21,16,5,FMN GV 16 Berchem TOT
54,Posthofbrug 5366,2020-05-29,06:00:00,66,52,14,FMN GV 16 Berchem TOT
54,Posthofbrug 5366,2020-05-29,07:00:00,198,150,48,FMN GV 16 Berchem TOT
54,Posthofbrug 5366,2020-05-29,08:00:00,256,194,62,FMN GV 16 Berchem TOT
54,Posthofbrug 5366,2020-05-29,09:00:00,150,102,48,FMN GV 16 Berchem TOT
54,Posthofbrug 5366,2020-05-29,10:00:00,149,96,53,FMN GV 16 Berchem TOT
54,Posthofbrug 5366,2020-05-29,11:00:00,134,78,56,FMN GV 16 Berchem TOT
54,Posthofbrug 5366,2020-05-29,12:00:00,211,112,99,FMN GV 16 Berchem TOT
54,Posthofbrug 5366,2020-05-29,13:00:00,226,108,118,FMN GV 16 Berchem TOT
54,Posthofbrug 5366,2020-05-29,14:00:00,269,141,128,FMN GV 16 Berchem TOT
54,Posthofbrug 5366,2020-05-29,15:00:00,246,109,137,FMN GV 16 Berchem TOT
54,Posthofbrug 5366,2020-05-29,16:00:00,319,117,202,FMN GV 16 Berchem TOT
54,Posthofbrug 5366,2020-05-29,17:00:00,308,94,214,FMN GV 16 Berchem TOT
54,Posthofbrug 5366,2020-05-29,18:00:00,246,109,137,FMN GV 16 Berchem TOT
54,Posthofbrug 5366,2020-05-29,19:00:00,161,68,93,FMN GV 16 Berchem TOT
54,Posthofbrug 5366,2020-05-29,20:00:00,114,59,55,FMN GV 16 Berchem TOT
54,Posthofbrug 5366,2020-05-29,21:00:00,64,35,29,FMN GV 16 Berchem TOT
54,Posthofbrug 5366,2020-05-29,22:00:00,57,23,34,FMN GV 16 Berchem TOT
54,Posthofbrug 5366,2020-05-29,23:00:00,41,22,19,FMN GV 16 Berchem TOT
54,Posthofbrug 5366,2020-05-30,00:00:00,38,9,29,FMN GV 16 Berchem TOT
54,Posthofbrug 5366,2020-05-30,01:00:00,13,6,7,FMN GV 16 Berchem TOT
54,Posthofbrug 5366,2020-05-30,02:00:00,21,11,10,FMN GV 16 Berchem TOT
54,Posthofbrug 5366,2020-05-30,03:00:00,5,4,1,FMN GV 16 Berchem TOT
54,Posthofbrug 5366,2020-05-30,04:00:00,7,5,2,FMN GV 16 Berchem TOT
54,Posthofbrug 5366,2020-05-30,05:00:00,11,5,6,FMN GV 16 Berchem TOT
54,Posthofbrug 5366,2020-05-30,06:00:00,23,17,6,FMN GV 16 Berchem TOT
54,Posthofbrug 5366,2020-05-30,07:00:00,30,15,15,FMN GV 16 Berchem TOT
54,Posthofbrug 5366,2020-05-30,08:00:00,85,39,46,FMN GV 16 Berchem TOT
54,Posthofbrug 5366,2020-05-30,09:00:00,132,69,63,FMN GV 16 Berchem TOT
54,Posthofbrug 5366,2020-05-30,10:00:00,156,86,70,FMN GV 16 Berchem TOT
54,Posthofbrug 5366,2020-05-30,11:00:00,190,117,73,FMN GV 16 Berchem TOT
54,Posthofbrug 5366,2020-05-30,12:00:00,252,141,111,FMN GV 16 Berchem TOT
54,Posthofbrug 5366,2020-05-30,13:00:00,276,135,141,FMN GV 16 Berchem TOT
54,Posthofbrug 5366,2020-05-30,14:00:00,304,170,134,FMN GV 16 Berchem TOT
54,Posthofbrug 5366,2020-05-30,15:00:00,279,132,147,FMN GV 16 Berchem TOT
54,Posthofbrug 5366,2020-05-30,16:00:00,249,95,154,FMN GV 16 Berchem TOT
54,Posthofbrug 5366,2020-05-30,17:00:00,274,109,165,FMN GV 16 Berchem TOT
54,Posthofbrug 5366,2020-05-30,18:00:00,195,103,92,FMN GV 16 Berchem TOT
54,Posthofbrug 5366,2020-05-30,19:00:00,158,90,68,FMN GV 16 Berchem TOT
54,Posthofbrug 5366,2020-05-30,20:00:00,107,59,48,FMN GV 16 Berchem TOT
54,Posthofbrug 5366,2020-05-30,21:00:00,116,56,60,FMN GV 16 Berchem TOT
54,Posthofbrug 5366,2020-05-30,22:00:00,66,37,29,FMN GV 16 Berchem TOT
54,Posthofbrug 5366,2020-05-30,23:00:00,48,28,20,FMN GV 16 Berchem TOT
54,Posthofbrug 5366,2020-05-31,00:00:00,43,15,28,FMN GV 16 Berchem TOT
54,Posthofbrug 5366,2020-05-31,01:00:00,18,16,2,FMN GV 16 Berchem TOT
54,Posthofbrug 5366,2020-05-31,02:00:00,4,3,1,FMN GV 16 Berchem TOT
54,Posthofbrug 5366,2020-05-31,03:00:00,11,7,4,FMN GV 16 Berchem TOT
54,Posthofbrug 5366,2020-05-31,04:00:00,1,1,0,FMN GV 16 Berchem TOT
54,Posthofbrug 5366,2020-05-31,05:00:00,10,7,3,FMN GV 16 Berchem TOT
54,Posthofbrug 5366,2020-05-31,06:00:00,11,9,2,FMN GV 16 Berchem TOT
54,Posthofbrug 5366,2020-05-31,07:00:00,27,14,13,FMN GV 16 Berchem TOT
54,Posthofbrug 5366,2020-05-31,08:00:00,65,36,29,FMN GV 16 Berchem TOT
54,Posthofbrug 5366,2020-05-31,09:00:00,148,62,86,FMN GV 16 Berchem TOT
54,Posthofbrug 5366,2020-05-31,10:00:00,167,97,70,FMN GV 16 Berchem TOT
54,Posthofbrug 5366,2020-05-31,11:00:00,247,122,125,FMN GV 16 Berchem TOT
54,Posthofbrug 5366,2020-05-31,12:00:00,252,130,122,FMN GV 16 Berchem TOT
54,Posthofbrug 5366,2020-05-31,13:00:00,291,153,138,FMN GV 16 Berchem TOT
54,Posthofbrug 5366,2020-05-31,14:00:00,333,180,153,FMN GV 16 Berchem TOT
54,Posthofbrug 5366,2020-05-31,15:00:00,337,140,197,FMN GV 16 Berchem TOT
54,Posthofbrug 5366,2020-05-31,16:00:00,312,115,197,FMN GV 16 Berchem TOT
54,Posthofbrug 5366,2020-05-31,17:00:00,278,141,137,FMN GV 16 Berchem TOT
54,Posthofbrug 5366,2020-05-31,18:00:00,210,133,77,FMN GV 16 Berchem TOT
54,Posthofbrug 5366,2020-05-31,19:00:00,155,97,58,FMN GV 16 Berchem TOT
54,Posthofbrug 5366,2020-05-31,20:00:00,142,78,64,FMN GV 16 Berchem TOT
54,Posthofbrug 5366,2020-05-31,21:00:00,82,51,31,FMN GV 16 Berchem TOT
54,Posthofbrug 5366,2020-05-31,22:00:00,72,45,27,FMN GV 16 Berchem TOT
54,Posthofbrug 5366,2020-05-31,23:00:00,47,18,29,FMN GV 16 Berchem TOT
54,Posthofbrug 5366,2020-06-01,00:00:00,22,13,9,FMN GV 16 Berchem TOT
54,Posthofbrug 5366,2020-06-01,01:00:00,11,8,3,FMN GV 16 Berchem TOT
54,Posthofbrug 5366,2020-06-01,02:00:00,8,7,1,FMN GV 16 Berchem TOT
54,Posthofbrug 5366,2020-06-01,03:00:00,1,0,1,FMN GV 16 Berchem TOT
54,Posthofbrug 5366,2020-06-01,04:00:00,6,3,3,FMN GV 16 Berchem TOT
54,Posthofbrug 5366,2020-06-01,05:00:00,5,3,2,FMN GV 16 Berchem TOT
54,Posthofbrug 5366,2020-06-01,06:00:00,22,13,9,FMN GV 16 Berchem TOT
54,Posthofbrug 5366,2020-06-01,07:00:00,16,7,9,FMN GV 16 Berchem TOT
54,Posthofbrug 5366,2020-06-01,08:00:00,55,25,30,FMN GV 16 Berchem TOT
54,Posthofbrug 5366,2020-06-01,09:00:00,121,58,63,FMN GV 16 Berchem TOT
54,Posthofbrug 5366,2020-06-01,10:00:00,156,62,94,FMN GV 16 Berchem TOT
54,Posthofbrug 5366,2020-06-01,11:00:00,215,113,102,FMN GV 16 Berchem TOT
54,Posthofbrug 5366,2020-06-01,12:00:00,244,131,113,FMN GV 16 Berchem TOT
54,Posthofbrug 5366,2020-06-01,13:00:00,257,147,110,FMN GV 16 Berchem TOT
54,Posthofbrug 5366,2020-06-01,14:00:00,318,161,157,FMN GV 16 Berchem TOT
54,Posthofbrug 5366,2020-06-01,15:00:00,317,127,190,FMN GV 16 Berchem TOT
54,Posthofbrug 5366,2020-06-01,16:00:00,283,125,158,FMN GV 16 Berchem TOT
54,Posthofbrug 5366,2020-06-01,17:00:00,261,141,120,FMN GV 16 Berchem TOT
54,Posthofbrug 5366,2020-06-01,18:00:00,200,120,80,FMN GV 16 Berchem TOT
54,Posthofbrug 5366,2020-06-01,19:00:00,147,85,62,FMN GV 16 Berchem TOT
54,Posthofbrug 5366,2020-06-01,20:00:00,116,64,52,FMN GV 16 Berchem TOT
54,Posthofbrug 5366,2020-06-01,21:00:00,89,58,31,FMN GV 16 Berchem TOT
54,Posthofbrug 5366,2020-06-01,22:00:00,75,41,34,FMN GV 16 Berchem TOT
54,Posthofbrug 5366,2020-06-01,23:00:00,20,11,9,FMN GV 16 Berchem TOT
54,Posthofbrug 5366,2020-06-02,00:00:00,17,6,11,FMN GV 16 Berchem TOT
54,Posthofbrug 5366,2020-06-02,01:00:00,2,0,2,FMN GV 16 Berchem TOT
54,Posthofbrug 5366,2020-06-02,02:00:00,3,2,1,FMN GV 16 Berchem TOT
54,Posthofbrug 5366,2020-06-02,03:00:00,1,1,0,FMN GV 16 Berchem TOT
54,Posthofbrug 5366,2020-06-02,04:00:00,12,8,4,FMN GV 16 Berchem TOT
54,Posthofbrug 5366,2020-06-02,05:00:00,19,16,3,FMN GV 16 Berchem TOT
54,Posthofbrug 5366,2020-06-02,06:00:00,93,68,25,FMN GV 16 Berchem TOT
54,Posthofbrug 5366,2020-06-02,07:00:00,250,176,74,FMN GV 16 Berchem TOT
54,Posthofbrug 5366,2020-06-02,08:00:00,368,270,98,FMN GV 16 Berchem TOT
54,Posthofbrug 5366,2020-06-02,09:00:00,176,131,45,FMN GV 16 Berchem TOT
54,Posthofbrug 5366,2020-06-02,10:00:00,119,71,48,FMN GV 16 Berchem TOT
54,Posthofbrug 5366,2020-06-02,11:00:00,115,65,50,FMN GV 16 Berchem TOT
54,Posthofbrug 5366,2020-06-02,12:00:00,154,77,77,FMN GV 16 Berchem TOT
54,Posthofbrug 5366,2020-06-02,13:00:00,175,103,72,FMN GV 16 Berchem TOT
54,Posthofbrug 5366,2020-06-02,14:00:00,156,79,77,FMN GV 16 Berchem TOT
54,Posthofbrug 5366,2020-06-02,15:00:00,191,80,111,FMN GV 16 Berchem TOT
54,Posthofbrug 5366,2020-06-02,16:00:00,335,89,246,FMN GV 16 Berchem TOT
54,Posthofbrug 5366,2020-06-02,17:00:00,335,123,212,FMN GV 16 Berchem TOT
54,Posthofbrug 5366,2020-06-02,18:00:00,247,87,160,FMN GV 16 Berchem TOT
54,Posthofbrug 5366,2020-06-02,19:00:00,153,58,95,FMN GV 16 Berchem TOT
54,Posthofbrug 5366,2020-06-02,20:00:00,147,94,53,FMN GV 16 Berchem TOT
54,Posthofbrug 5366,2020-06-02,21:00:00,94,67,27,FMN GV 16 Berchem TOT
54,Posthofbrug 5366,2020-06-02,22:00:00,59,33,26,FMN GV 16 Berchem TOT
54,Posthofbrug 5366,2020-06-02,23:00:00,28,15,13,FMN GV 16 Berchem TOT
54,Posthofbrug 5366,2020-06-03,00:00:00,7,3,4,FMN GV 16 Berchem TOT
54,Posthofbrug 5366,2020-06-03,01:00:00,2,1,1,FMN GV 16 Berchem TOT
54,Posthofbrug 5366,2020-06-03,02:00:00,1,1,0,FMN GV 16 Berchem TOT
54,Posthofbrug 5366,2020-06-03,03:00:00,4,2,2,FMN GV 16 Berchem TOT
54,Posthofbrug 5366,2020-06-03,04:00:00,10,7,3,FMN GV 16 Berchem TOT
54,Posthofbrug 5366,2020-06-03,05:00:00,18,13,5,FMN GV 16 Berchem TOT
54,Posthofbrug 5366,2020-06-03,06:00:00,99,72,27,FMN GV 16 Berchem TOT
54,Posthofbrug 5366,2020-06-03,07:00:00,235,174,61,FMN GV 16 Berchem TOT
54,Posthofbrug 5366,2020-06-03,08:00:00,295,237,58,FMN GV 16 Berchem TOT
54,Posthofbrug 5366,2020-06-03,09:00:00,166,113,53,FMN GV 16 Berchem TOT
54,Posthofbrug 5366,2020-06-03,10:00:00,140,88,52,FMN GV 16 Berchem TOT
54,Posthofbrug 5366,2020-06-03,11:00:00,138,70,68,FMN GV 16 Berchem TOT
54,Posthofbrug 5366,2020-06-03,12:00:00,209,104,105,FMN GV 16 Berchem TOT
54,Posthofbrug 5366,2020-06-03,13:00:00,199,113,86,FMN GV 16 Berchem TOT
54,Posthofbrug 5366,2020-06-03,14:00:00,206,110,96,FMN GV 16 Berchem TOT
54,Posthofbrug 5366,2020-06-03,15:00:00,243,103,140,FMN GV 16 Berchem TOT
54,Posthofbrug 5366,2020-06-03,16:00:00,318,117,201,FMN GV 16 Berchem TOT
54,Posthofbrug 5366,2020-06-03,17:00:00,304,110,194,FMN GV 16 Berchem TOT
54,Posthofbrug 5366,2020-06-03,18:00:00,265,86,179,FMN GV 16 Berchem TOT
54,Posthofbrug 5366,2020-06-03,19:00:00,194,69,125,FMN GV 16 Berchem TOT
54,Posthofbrug 5366,2020-06-03,20:00:00,128,60,68,FMN GV 16 Berchem TOT
54,Posthofbrug 5366,2020-06-03,21:00:00,104,64,40,FMN GV 16 Berchem TOT
54,Posthofbrug 5366,2020-06-03,22:00:00,65,32,33,FMN GV 16 Berchem TOT
54,Posthofbrug 5366,2020-06-03,23:00:00,39,17,22,FMN GV 16 Berchem TOT
54,Posthofbrug 5366,2020-06-04,00:00:00,18,7,11,FMN GV 16 Berchem TOT
54,Posthofbrug 5366,2020-06-04,01:00:00,5,1,4,FMN GV 16 Berchem TOT
54,Posthofbrug 5366,2020-06-04,02:00:00,3,1,2,FMN GV 16 Berchem TOT
54,Posthofbrug 5366,2020-06-04,03:00:00,4,2,2,FMN GV 16 Berchem TOT
54,Posthofbrug 5366,2020-06-04,04:00:00,6,3,3,FMN GV 16 Berchem TOT
54,Posthofbrug 5366,2020-06-04,05:00:00,14,12,2,FMN GV 16 Berchem TOT
54,Posthofbrug 5366,2020-06-04,06:00:00,80,61,19,FMN GV 16 Berchem TOT
54,Posthofbrug 5366,2020-06-04,07:00:00,230,163,67,FMN GV 16 Berchem TOT
54,Posthofbrug 5366,2020-06-04,08:00:00,306,239,67,FMN GV 16 Berchem TOT
54,Posthofbrug 5366,2020-06-04,09:00:00,138,94,44,FMN GV 16 Berchem TOT
54,Posthofbrug 5366,2020-06-04,10:00:00,74,48,26,FMN GV 16 Berchem TOT
54,Posthofbrug 5366,2020-06-04,11:00:00,75,38,37,FMN GV 16 Berchem TOT
54,Posthofbrug 5366,2020-06-04,12:00:00,102,54,48,FMN GV 16 Berchem TOT
54,Posthofbrug 5366,2020-06-04,13:00:00,122,69,53,FMN GV 16 Berchem TOT
54,Posthofbrug 5366,2020-06-04,14:00:00,103,46,57,FMN GV 16 Berchem TOT
54,Posthofbrug 5366,2020-06-04,15:00:00,157,72,85,FMN GV 16 Berchem TOT
54,Posthofbrug 5366,2020-06-04,16:00:00,240,90,150,FMN GV 16 Berchem TOT
54,Posthofbrug 5366,2020-06-04,17:00:00,233,71,162,FMN GV 16 Berchem TOT
54,Posthofbrug 5366,2020-06-04,18:00:00,174,53,121,FMN GV 16 Berchem TOT
54,Posthofbrug 5366,2020-06-04,19:00:00,127,51,76,FMN GV 16 Berchem TOT
54,Posthofbrug 5366,2020-06-04,20:00:00,70,29,41,FMN GV 16 Berchem TOT
54,Posthofbrug 5366,2020-06-04,21:00:00,55,28,27,FMN GV 16 Berchem TOT
54,Posthofbrug 5366,2020-06-04,22:00:00,57,28,29,FMN GV 16 Berchem TOT
54,Posthofbrug 5366,2020-06-04,23:00:00,25,13,12,FMN GV 16 Berchem TOT
54,Posthofbrug 5366,2020-06-05,00:00:00,9,7,2,FMN GV 16 Berchem TOT
54,Posthofbrug 5366,2020-06-05,01:00:00,3,2,1,FMN GV 16 Berchem TOT
54,Posthofbrug 5366,2020-06-05,02:00:00,3,0,3,FMN GV 16 Berchem TOT
54,Posthofbrug 5366,2020-06-05,03:00:00,2,0,2,FMN GV 16 Berchem TOT
54,Posthofbrug 5366,2020-06-05,04:00:00,8,5,3,FMN GV 16 Berchem TOT
54,Posthofbrug 5366,2020-06-05,05:00:00,21,17,4,FMN GV 16 Berchem TOT
54,Posthofbrug 5366,2020-06-05,06:00:00,63,50,13,FMN GV 16 Berchem TOT
54,Posthofbrug 5366,2020-06-05,07:00:00,193,136,57,FMN GV 16 Berchem TOT
54,Posthofbrug 5366,2020-06-05,08:00:00,239,180,59,FMN GV 16 Berchem TOT
54,Posthofbrug 5366,2020-06-05,09:00:00,135,90,45,FMN GV 16 Berchem TOT
54,Posthofbrug 5366,2020-06-05,10:00:00,60,35,25,FMN GV 16 Berchem TOT
54,Posthofbrug 5366,2020-06-05,11:00:00,52,25,27,FMN GV 16 Berchem TOT
54,Posthofbrug 5366,2020-06-05,12:00:00,108,58,50,FMN GV 16 Berchem TOT
54,Posthofbrug 5366,2020-06-05,13:00:00,101,53,48,FMN GV 16 Berchem TOT
54,Posthofbrug 5366,2020-06-05,14:00:00,100,52,48,FMN GV 16 Berchem TOT
54,Posthofbrug 5366,2020-06-05,15:00:00,124,56,68,FMN GV 16 Berchem TOT
54,Posthofbrug 5366,2020-06-05,16:00:00,172,44,128,FMN GV 16 Berchem TOT
54,Posthofbrug 5366,2020-06-05,17:00:00,169,52,117,FMN GV 16 Berchem TOT
54,Posthofbrug 5366,2020-06-05,18:00:00,168,53,115,FMN GV 16 Berchem TOT
54,Posthofbrug 5366,2020-06-05,19:00:00,80,37,43,FMN GV 16 Berchem TOT
54,Posthofbrug 5366,2020-06-05,20:00:00,51,23,28,FMN GV 16 Berchem TOT
54,Posthofbrug 5366,2020-06-05,21:00:00,47,25,22,FMN GV 16 Berchem TOT
54,Posthofbrug 5366,2020-06-05,22:00:00,31,16,15,FMN GV 16 Berchem TOT
54,Posthofbrug 5366,2020-06-05,23:00:00,26,8,18,FMN GV 16 Berchem TOT
54,Posthofbrug 5366,2020-06-06,00:00:00,7,3,4,FMN GV 16 Berchem TOT
54,Posthofbrug 5366,2020-06-06,01:00:00,9,3,6,FMN GV 16 Berchem TOT
54,Posthofbrug 5366,2020-06-06,02:00:00,8,4,4,FMN GV 16 Berchem TOT
54,Posthofbrug 5366,2020-06-06,03:00:00,2,0,2,FMN GV 16 Berchem TOT
54,Posthofbrug 5366,2020-06-06,04:00:00,9,5,4,FMN GV 16 Berchem TOT
54,Posthofbrug 5366,2020-06-06,05:00:00,6,6,0,FMN GV 16 Berchem TOT
54,Posthofbrug 5366,2020-06-06,06:00:00,13,10,3,FMN GV 16 Berchem TOT
54,Posthofbrug 5366,2020-06-06,07:00:00,30,19,11,FMN GV 16 Berchem TOT
54,Posthofbrug 5366,2020-06-06,08:00:00,40,18,22,FMN GV 16 Berchem TOT
54,Posthofbrug 5366,2020-06-06,09:00:00,91,53,38,FMN GV 16 Berchem TOT
54,Posthofbrug 5366,2020-06-06,10:00:00,103,66,37,FMN GV 16 Berchem TOT
54,Posthofbrug 5366,2020-06-06,11:00:00,144,90,54,FMN GV 16 Berchem TOT
54,Posthofbrug 5366,2020-06-06,12:00:00,128,75,53,FMN GV 16 Berchem TOT
54,Posthofbrug 5366,2020-06-06,13:00:00,137,75,62,FMN GV 16 Berchem TOT
54,Posthofbrug 5366,2020-06-06,14:00:00,203,100,103,FMN GV 16 Berchem TOT
54,Posthofbrug 5366,2020-06-06,15:00:00,184,95,89,FMN GV 16 Berchem TOT
54,Posthofbrug 5366,2020-06-06,16:00:00,164,82,82,FMN GV 16 Berchem TOT
54,Posthofbrug 5366,2020-06-06,17:00:00,141,57,84,FMN GV 16 Berchem TOT
54,Posthofbrug 5366,2020-06-06,18:00:00,157,73,84,FMN GV 16 Berchem TOT
54,Posthofbrug 5366,2020-06-06,19:00:00,65,34,31,FMN GV 16 Berchem TOT
54,Posthofbrug 5366,2020-06-06,20:00:00,62,35,27,FMN GV 16 Berchem TOT
54,Posthofbrug 5366,2020-06-06,21:00:00,26,15,11,FMN GV 16 Berchem TOT
54,Posthofbrug 5366,2020-06-06,22:00:00,52,30,22,FMN GV 16 Berchem TOT
54,Posthofbrug 5366,2020-06-06,23:00:00,24,8,16,FMN GV 16 Berchem TOT
54,Posthofbrug 5366,2020-06-07,00:00:00,19,9,10,FMN GV 16 Berchem TOT
54,Posthofbrug 5366,2020-06-07,01:00:00,10,2,8,FMN GV 16 Berchem TOT
54,Posthofbrug 5366,2020-06-07,02:00:00,5,0,5,FMN GV 16 Berchem TOT
54,Posthofbrug 5366,2020-06-07,03:00:00,3,1,2,FMN GV 16 Berchem TOT
54,Posthofbrug 5366,2020-06-07,04:00:00,6,2,4,FMN GV 16 Berchem TOT
54,Posthofbrug 5366,2020-06-07,05:00:00,2,2,0,FMN GV 16 Berchem TOT
54,Posthofbrug 5366,2020-06-07,06:00:00,15,12,3,FMN GV 16 Berchem TOT
54,Posthofbrug 5366,2020-06-07,07:00:00,22,8,14,FMN GV 16 Berchem TOT
54,Posthofbrug 5366,2020-06-07,08:00:00,60,30,30,FMN GV 16 Berchem TOT
54,Posthofbrug 5366,2020-06-07,09:00:00,81,49,32,FMN GV 16 Berchem TOT
54,Posthofbrug 5366,2020-06-07,10:00:00,97,56,41,FMN GV 16 Berchem TOT
54,Posthofbrug 5366,2020-06-07,11:00:00,132,75,57,FMN GV 16 Berchem TOT
54,Posthofbrug 5366,2020-06-07,12:00:00,189,123,66,FMN GV 16 Berchem TOT
54,Posthofbrug 5366,2020-06-07,13:00:00,179,113,66,FMN GV 16 Berchem TOT
54,Posthofbrug 5366,2020-06-07,14:00:00,206,106,100,FMN GV 16 Berchem TOT
54,Posthofbrug 5366,2020-06-07,15:00:00,240,118,122,FMN GV 16 Berchem TOT
54,Posthofbrug 5366,2020-06-07,16:00:00,201,79,122,FMN GV 16 Berchem TOT
54,Posthofbrug 5366,2020-06-07,17:00:00,204,84,120,FMN GV 16 Berchem TOT
54,Posthofbrug 5366,2020-06-07,18:00:00,121,56,65,FMN GV 16 Berchem TOT
54,Posthofbrug 5366,2020-06-07,19:00:00,91,42,49,FMN GV 16 Berchem TOT
54,Posthofbrug 5366,2020-06-07,20:00:00,78,38,40,FMN GV 16 Berchem TOT
54,Posthofbrug 5366,2020-06-07,21:00:00,69,46,23,FMN GV 16 Berchem TOT
54,Posthofbrug 5366,2020-06-07,22:00:00,43,24,19,FMN GV 16 Berchem TOT
54,Posthofbrug 5366,2020-06-07,23:00:00,24,12,12,FMN GV 16 Berchem TOT
54,Posthofbrug 5366,2020-06-08,00:00:00,5,1,4,FMN GV 16 Berchem TOT
54,Posthofbrug 5366,2020-06-08,01:00:00,6,2,4,FMN GV 16 Berchem TOT
54,Posthofbrug 5366,2020-06-08,02:00:00,3,2,1,FMN GV 16 Berchem TOT
54,Posthofbrug 5366,2020-06-08,03:00:00,3,2,1,FMN GV 16 Berchem TOT
54,Posthofbrug 5366,2020-06-08,04:00:00,9,5,4,FMN GV 16 Berchem TOT
54,Posthofbrug 5366,2020-06-08,05:00:00,20,19,1,FMN GV 16 Berchem TOT
54,Posthofbrug 5366,2020-06-08,06:00:00,78,63,15,FMN GV 16 Berchem TOT
54,Posthofbrug 5366,2020-06-08,07:00:00,249,185,64,FMN GV 16 Berchem TOT
54,Posthofbrug 5366,2020-06-08,08:00:00,335,253,82,FMN GV 16 Berchem TOT
54,Posthofbrug 5366,2020-06-08,09:00:00,125,96,29,FMN GV 16 Berchem TOT
54,Posthofbrug 5366,2020-06-08,10:00:00,45,30,15,FMN GV 16 Berchem TOT
54,Posthofbrug 5366,2020-06-08,11:00:00,56,28,28,FMN GV 16 Berchem TOT
54,Posthofbrug 5366,2020-06-08,12:00:00,94,48,46,FMN GV 16 Berchem TOT
54,Posthofbrug 5366,2020-06-08,13:00:00,82,39,43,FMN GV 16 Berchem TOT
54,Posthofbrug 5366,2020-06-08,14:00:00,82,37,45,FMN GV 16 Berchem TOT
54,Posthofbrug 5366,2020-06-08,15:00:00,152,62,90,FMN GV 16 Berchem TOT
54,Posthofbrug 5366,2020-06-08,16:00:00,219,66,153,FMN GV 16 Berchem TOT
54,Posthofbrug 5366,2020-06-08,17:00:00,223,65,158,FMN GV 16 Berchem TOT
54,Posthofbrug 5366,2020-06-08,18:00:00,188,66,122,FMN GV 16 Berchem TOT
54,Posthofbrug 5366,2020-06-08,19:00:00,100,39,61,FMN GV 16 Berchem TOT
54,Posthofbrug 5366,2020-06-08,20:00:00,69,39,30,FMN GV 16 Berchem TOT
54,Posthofbrug 5366,2020-06-08,21:00:00,49,26,23,FMN GV 16 Berchem TOT
54,Posthofbrug 5366,2020-06-08,22:00:00,43,15,28,FMN GV 16 Berchem TOT
54,Posthofbrug 5366,2020-06-08,23:00:00,31,11,20,FMN GV 16 Berchem TOT
54,Posthofbrug 5366,2020-06-09,00:00:00,5,1,4,FMN GV 16 Berchem TOT
54,Posthofbrug 5366,2020-06-09,01:00:00,7,0,7,FMN GV 16 Berchem TOT
54,Posthofbrug 5366,2020-06-09,02:00:00,2,1,1,FMN GV 16 Berchem TOT
54,Posthofbrug 5366,2020-06-09,03:00:00,0,0,0,FMN GV 16 Berchem TOT
54,Posthofbrug 5366,2020-06-09,04:00:00,7,6,1,FMN GV 16 Berchem TOT
54,Posthofbrug 5366,2020-06-09,05:00:00,22,17,5,FMN GV 16 Berchem TOT
54,Posthofbrug 5366,2020-06-09,06:00:00,83,67,16,FMN GV 16 Berchem TOT
54,Posthofbrug 5366,2020-06-09,07:00:00,274,200,74,FMN GV 16 Berchem TOT
54,Posthofbrug 5366,2020-06-09,08:00:00,409,317,92,FMN GV 16 Berchem TOT
54,Posthofbrug 5366,2020-06-09,09:00:00,137,100,37,FMN GV 16 Berchem TOT
54,Posthofbrug 5366,2020-06-09,10:00:00,86,52,34,FMN GV 16 Berchem TOT
54,Posthofbrug 5366,2020-06-09,11:00:00,113,56,57,FMN GV 16 Berchem TOT
54,Posthofbrug 5366,2020-06-09,12:00:00,164,87,77,FMN GV 16 Berchem TOT
54,Posthofbrug 5366,2020-06-09,13:00:00,161,88,73,FMN GV 16 Berchem TOT
54,Posthofbrug 5366,2020-06-09,14:00:00,129,66,63,FMN GV 16 Berchem TOT
54,Posthofbrug 5366,2020-06-09,15:00:00,232,78,154,FMN GV 16 Berchem TOT
54,Posthofbrug 5366,2020-06-09,16:00:00,293,94,199,FMN GV 16 Berchem TOT
54,Posthofbrug 5366,2020-06-09,17:00:00,347,113,234,FMN GV 16 Berchem TOT
54,Posthofbrug 5366,2020-06-09,18:00:00,264,100,164,FMN GV 16 Berchem TOT
54,Posthofbrug 5366,2020-06-09,19:00:00,149,66,83,FMN GV 16 Berchem TOT
54,Posthofbrug 5366,2020-06-09,20:00:00,133,69,64,FMN GV 16 Berchem TOT
54,Posthofbrug 5366,2020-06-09,21:00:00,94,45,49,FMN GV 16 Berchem TOT
54,Posthofbrug 5366,2020-06-09,22:00:00,61,30,31,FMN GV 16 Berchem TOT
54,Posthofbrug 5366,2020-06-09,23:00:00,32,11,21,FMN GV 16 Berchem TOT
54,Posthofbrug 5366,2020-06-10,00:00:00,21,7,14,FMN GV 16 Berchem TOT
54,Posthofbrug 5366,2020-06-10,01:00:00,14,2,12,FMN GV 16 Berchem TOT
54,Posthofbrug 5366,2020-06-10,02:00:00,10,3,7,FMN GV 16 Berchem TOT
54,Posthofbrug 5366,2020-06-10,03:00:00,1,1,0,FMN GV 16 Berchem TOT
54,Posthofbrug 5366,2020-06-10,04:00:00,13,11,2,FMN GV 16 Berchem TOT
54,Posthofbrug 5366,2020-06-10,05:00:00,21,15,6,FMN GV 16 Berchem TOT
54,Posthofbrug 5366,2020-06-10,06:00:00,82,63,19,FMN GV 16 Berchem TOT
54,Posthofbrug 5366,2020-06-10,07:00:00,284,210,74,FMN GV 16 Berchem TOT
54,Posthofbrug 5366,2020-06-10,08:00:00,330,251,79,FMN GV 16 Berchem TOT
54,Posthofbrug 5366,2020-06-10,09:00:00,139,96,43,FMN GV 16 Berchem TOT
54,Posthofbrug 5366,2020-06-10,10:00:00,94,57,37,FMN GV 16 Berchem TOT
54,Posthofbrug 5366,2020-06-10,11:00:00,143,66,77,FMN GV 16 Berchem TOT
54,Posthofbrug 5366,2020-06-10,12:00:00,198,114,84,FMN GV 16 Berchem TOT
54,Posthofbrug 5366,2020-06-10,13:00:00,173,78,95,FMN GV 16 Berchem TOT
54,Posthofbrug 5366,2020-06-10,14:00:00,164,74,90,FMN GV 16 Berchem TOT
54,Posthofbrug 5366,2020-06-10,15:00:00,185,75,110,FMN GV 16 Berchem TOT
54,Posthofbrug 5366,2020-06-10,16:00:00,252,79,173,FMN GV 16 Berchem TOT
54,Posthofbrug 5366,2020-06-10,17:00:00,346,109,237,FMN GV 16 Berchem TOT
54,Posthofbrug 5366,2020-06-10,18:00:00,232,85,147,FMN GV 16 Berchem TOT
54,Posthofbrug 5366,2020-06-10,19:00:00,158,76,82,FMN GV 16 Berchem TOT
54,Posthofbrug 5366,2020-06-10,20:00:00,121,66,55,FMN GV 16 Berchem TOT
54,Posthofbrug 5366,2020-06-10,21:00:00,101,52,49,FMN GV 16 Berchem TOT
54,Posthofbrug 5366,2020-06-10,22:00:00,50,25,25,FMN GV 16 Berchem TOT
54,Posthofbrug 5366,2020-06-10,23:00:00,33,15,18,FMN GV 16 Berchem TOT
54,Posthofbrug 5366,2020-06-11,00:00:00,27,9,18,FMN GV 16 Berchem TOT
54,Posthofbrug 5366,2020-06-11,01:00:00,7,0,7,FMN GV 16 Berchem TOT
54,Posthofbrug 5366,2020-06-11,02:00:00,2,2,0,FMN GV 16 Berchem TOT
54,Posthofbrug 5366,2020-06-11,03:00:00,1,0,1,FMN GV 16 Berchem TOT
54,Posthofbrug 5366,2020-06-11,04:00:00,13,11,2,FMN GV 16 Berchem TOT
54,Posthofbrug 5366,2020-06-11,05:00:00,16,15,1,FMN GV 16 Berchem TOT
54,Posthofbrug 5366,2020-06-11,06:00:00,87,67,20,FMN GV 16 Berchem TOT
54,Posthofbrug 5366,2020-06-11,07:00:00,266,197,69,FMN GV 16 Berchem TOT
54,Posthofbrug 5366,2020-06-11,08:00:00,425,310,115,FMN GV 16 Berchem TOT
54,Posthofbrug 5366,2020-06-11,09:00:00,172,134,38,FMN GV 16 Berchem TOT
54,Posthofbrug 5366,2020-06-11,10:00:00,119,84,35,FMN GV 16 Berchem TOT
54,Posthofbrug 5366,2020-06-11,11:00:00,137,80,57,FMN GV 16 Berchem TOT
54,Posthofbrug 5366,2020-06-11,12:00:00,177,90,87,FMN GV 16 Berchem TOT
54,Posthofbrug 5366,2020-06-11,13:00:00,178,88,90,FMN GV 16 Berchem TOT
54,Posthofbrug 5366,2020-06-11,14:00:00,161,71,90,FMN GV 16 Berchem TOT
54,Posthofbrug 5366,2020-06-11,15:00:00,178,62,116,FMN GV 16 Berchem TOT
54,Posthofbrug 5366,2020-06-11,16:00:00,265,92,173,FMN GV 16 Berchem TOT
54,Posthofbrug 5366,2020-06-11,17:00:00,331,102,229,FMN GV 16 Berchem TOT
54,Posthofbrug 5366,2020-06-11,18:00:00,270,94,176,FMN GV 16 Berchem TOT
54,Posthofbrug 5366,2020-06-11,19:00:00,168,83,85,FMN GV 16 Berchem TOT
54,Posthofbrug 5366,2020-06-11,20:00:00,117,62,55,FMN GV 16 Berchem TOT
54,Posthofbrug 5366,2020-06-11,21:00:00,98,56,42,FMN GV 16 Berchem TOT
54,Posthofbrug 5366,2020-06-11,22:00:00,73,34,39,FMN GV 16 Berchem TOT
54,Posthofbrug 5366,2020-06-11,23:00:00,30,12,18,FMN GV 16 Berchem TOT
54,Posthofbrug 5366,2020-06-12,00:00:00,45,6,39,FMN GV 16 Berchem TOT
54,Posthofbrug 5366,2020-06-12,01:00:00,11,4,7,FMN GV 16 Berchem TOT
54,Posthofbrug 5366,2020-06-12,02:00:00,12,5,7,FMN GV 16 Berchem TOT
54,Posthofbrug 5366,2020-06-12,03:00:00,0,0,0,FMN GV 16 Berchem TOT
54,Posthofbrug 5366,2020-06-12,04:00:00,13,8,5,FMN GV 16 Berchem TOT
54,Posthofbrug 5366,2020-06-12,05:00:00,15,14,1,FMN GV 16 Berchem TOT
54,Posthofbrug 5366,2020-06-12,06:00:00,81,63,18,FMN GV 16 Berchem TOT
54,Posthofbrug 5366,2020-06-12,07:00:00,248,180,68,FMN GV 16 Berchem TOT
54,Posthofbrug 5366,2020-06-12,08:00:00,330,248,82,FMN GV 16 Berchem TOT
54,Posthofbrug 5366,2020-06-12,09:00:00,175,134,41,FMN GV 16 Berchem TOT
54,Posthofbrug 5366,2020-06-12,10:00:00,131,91,40,FMN GV 16 Berchem TOT
54,Posthofbrug 5366,2020-06-12,11:00:00,185,96,89,FMN GV 16 Berchem TOT
54,Posthofbrug 5366,2020-06-12,12:00:00,204,116,88,FMN GV 16 Berchem TOT
54,Posthofbrug 5366,2020-06-12,13:00:00,204,113,91,FMN GV 16 Berchem TOT
54,Posthofbrug 5366,2020-06-12,14:00:00,202,84,118,FMN GV 16 Berchem TOT
54,Posthofbrug 5366,2020-06-12,15:00:00,297,117,180,FMN GV 16 Berchem TOT
54,Posthofbrug 5366,2020-06-12,16:00:00,295,92,203,FMN GV 16 Berchem TOT
54,Posthofbrug 5366,2020-06-12,17:00:00,266,86,180,FMN GV 16 Berchem TOT
54,Posthofbrug 5366,2020-06-12,18:00:00,207,86,121,FMN GV 16 Berchem TOT
54,Posthofbrug 5366,2020-06-12,19:00:00,129,56,73,FMN GV 16 Berchem TOT
54,Posthofbrug 5366,2020-06-12,20:00:00,123,67,56,FMN GV 16 Berchem TOT
54,Posthofbrug 5366,2020-06-12,21:00:00,59,21,38,FMN GV 16 Berchem TOT
54,Posthofbrug 5366,2020-06-12,22:00:00,29,11,18,FMN GV 16 Berchem TOT
54,Posthofbrug 5366,2020-06-12,23:00:00,52,13,39,FMN GV 16 Berchem TOT
54,Posthofbrug 5366,2020-06-13,00:00:00,35,11,24,FMN GV 16 Berchem TOT
54,Posthofbrug 5366,2020-06-13,01:00:00,57,24,33,FMN GV 16 Berchem TOT
54,Posthofbrug 5366,2020-06-13,02:00:00,9,3,6,FMN GV 16 Berchem TOT
54,Posthofbrug 5366,2020-06-13,03:00:00,10,1,9,FMN GV 16 Berchem TOT
54,Posthofbrug 5366,2020-06-13,04:00:00,13,6,7,FMN GV 16 Berchem TOT
54,Posthofbrug 5366,2020-06-13,05:00:00,5,2,3,FMN GV 16 Berchem TOT
54,Posthofbrug 5366,2020-06-13,06:00:00,22,14,8,FMN GV 16 Berchem TOT
54,Posthofbrug 5366,2020-06-13,07:00:00,43,21,22,FMN GV 16 Berchem TOT
54,Posthofbrug 5366,2020-06-13,08:00:00,84,47,37,FMN GV 16 Berchem TOT
54,Posthofbrug 5366,2020-06-13,09:00:00,122,78,44,FMN GV 16 Berchem TOT
54,Posthofbrug 5366,2020-06-13,10:00:00,176,97,79,FMN GV 16 Berchem TOT
54,Posthofbrug 5366,2020-06-13,11:00:00,216,118,98,FMN GV 16 Berchem TOT
54,Posthofbrug 5366,2020-06-13,12:00:00,225,108,117,FMN GV 16 Berchem TOT
54,Posthofbrug 5366,2020-06-13,13:00:00,217,132,85,FMN GV 16 Berchem TOT
54,Posthofbrug 5366,2020-06-13,14:00:00,265,146,119,FMN GV 16 Berchem TOT
54,Posthofbrug 5366,2020-06-13,15:00:00,249,146,103,FMN GV 16 Berchem TOT
54,Posthofbrug 5366,2020-06-13,16:00:00,252,110,142,FMN GV 16 Berchem TOT
54,Posthofbrug 5366,2020-06-13,17:00:00,262,112,150,FMN GV 16 Berchem TOT
54,Posthofbrug 5366,2020-06-13,18:00:00,232,122,110,FMN GV 16 Berchem TOT
54,Posthofbrug 5366,2020-06-13,19:00:00,137,71,66,FMN GV 16 Berchem TOT
54,Posthofbrug 5366,2020-06-13,20:00:00,118,63,55,FMN GV 16 Berchem TOT
54,Posthofbrug 5366,2020-06-13,21:00:00,126,64,62,FMN GV 16 Berchem TOT
54,Posthofbrug 5366,2020-06-13,22:00:00,77,32,45,FMN GV 16 Berchem TOT
54,Posthofbrug 5366,2020-06-13,23:00:00,74,36,38,FMN GV 16 Berchem TOT
54,Posthofbrug 5366,2020-06-14,00:00:00,82,33,49,FMN GV 16 Berchem TOT
54,Posthofbrug 5366,2020-06-14,01:00:00,66,28,38,FMN GV 16 Berchem TOT
54,Posthofbrug 5366,2020-06-14,02:00:00,29,10,19,FMN GV 16 Berchem TOT
54,Posthofbrug 5366,2020-06-14,03:00:00,11,6,5,FMN GV 16 Berchem TOT
54,Posthofbrug 5366,2020-06-14,04:00:00,3,2,1,FMN GV 16 Berchem TOT
54,Posthofbrug 5366,2020-06-14,05:00:00,13,8,5,FMN GV 16 Berchem TOT
54,Posthofbrug 5366,2020-06-14,06:00:00,15,11,4,FMN GV 16 Berchem TOT
54,Posthofbrug 5366,2020-06-14,07:00:00,24,10,14,FMN GV 16 Berchem TOT
54,Posthofbrug 5366,2020-06-14,08:00:00,58,31,27,FMN GV 16 Berchem TOT
54,Posthofbrug 5366,2020-06-14,09:00:00,115,66,49,FMN GV 16 Berchem TOT
54,Posthofbrug 5366,2020-06-14,10:00:00,190,108,82,FMN GV 16 Berchem TOT
54,Posthofbrug 5366,2020-06-14,11:00:00,181,101,80,FMN GV 16 Berchem TOT
54,Posthofbrug 5366,2020-06-14,12:00:00,231,110,121,FMN GV 16 Berchem TOT
54,Posthofbrug 5366,2020-06-14,13:00:00,253,142,111,FMN GV 16 Berchem TOT
54,Posthofbrug 5366,2020-06-14,14:00:00,344,173,171,FMN GV 16 Berchem TOT
54,Posthofbrug 5366,2020-06-14,15:00:00,271,130,141,FMN GV 16 Berchem TOT
54,Posthofbrug 5366,2020-06-14,16:00:00,251,123,128,FMN GV 16 Berchem TOT
54,Posthofbrug 5366,2020-06-14,17:00:00,239,109,130,FMN GV 16 Berchem TOT
54,Posthofbrug 5366,2020-06-14,18:00:00,185,121,64,FMN GV 16 Berchem TOT
54,Posthofbrug 5366,2020-06-14,19:00:00,129,71,58,FMN GV 16 Berchem TOT
54,Posthofbrug 5366,2020-06-14,20:00:00,111,67,44,FMN GV 16 Berchem TOT
54,Posthofbrug 5366,2020-06-14,21:00:00,88,41,47,FMN GV 16 Berchem TOT
54,Posthofbrug 5366,2020-06-14,22:00:00,46,27,19,FMN GV 16 Berchem TOT
54,Posthofbrug 5366,2020-06-14,23:00:00,43,23,20,FMN GV 16 Berchem TOT
54,Posthofbrug 5366,2020-06-15,00:00:00,18,6,12,FMN GV 16 Berchem TOT
54,Posthofbrug 5366,2020-06-15,01:00:00,6,2,4,FMN GV 16 Berchem TOT
54,Posthofbrug 5366,2020-06-15,02:00:00,7,3,4,FMN GV 16 Berchem TOT
54,Posthofbrug 5366,2020-06-15,03:00:00,3,1,2,FMN GV 16 Berchem TOT
54,Posthofbrug 5366,2020-06-15,04:00:00,13,10,3,FMN GV 16 Berchem TOT
54,Posthofbrug 5366,2020-06-15,05:00:00,17,14,3,FMN GV 16 Berchem TOT
54,Posthofbrug 5366,2020-06-15,06:00:00,103,87,16,FMN GV 16 Berchem TOT
54,Posthofbrug 5366,2020-06-15,07:00:00,272,208,64,FMN GV 16 Berchem TOT
54,Posthofbrug 5366,2020-06-15,08:00:00,418,323,95,FMN GV 16 Berchem TOT
54,Posthofbrug 5366,2020-06-15,09:00:00,194,142,52,FMN GV 16 Berchem TOT
54,Posthofbrug 5366,2020-06-15,10:00:00,112,71,41,FMN GV 16 Berchem TOT
54,Posthofbrug 5366,2020-06-15,11:00:00,144,78,66,FMN GV 16 Berchem TOT
54,Posthofbrug 5366,2020-06-15,12:00:00,192,98,94,FMN GV 16 Berchem TOT
54,Posthofbrug 5366,2020-06-15,13:00:00,160,81,79,FMN GV 16 Berchem TOT
54,Posthofbrug 5366,2020-06-15,14:00:00,169,69,100,FMN GV 16 Berchem TOT
54,Posthofbrug 5366,2020-06-15,15:00:00,239,83,156,FMN GV 16 Berchem TOT
54,Posthofbrug 5366,2020-06-15,16:00:00,335,121,214,FMN GV 16 Berchem TOT
54,Posthofbrug 5366,2020-06-15,17:00:00,397,141,256,FMN GV 16 Berchem TOT
54,Posthofbrug 5366,2020-06-15,18:00:00,271,82,189,FMN GV 16 Berchem TOT
54,Posthofbrug 5366,2020-06-15,19:00:00,164,64,100,FMN GV 16 Berchem TOT
54,Posthofbrug 5366,2020-06-15,20:00:00,123,60,63,FMN GV 16 Berchem TOT
54,Posthofbrug 5366,2020-06-15,21:00:00,81,41,40,FMN GV 16 Berchem TOT
54,Posthofbrug 5366,2020-06-15,22:00:00,83,39,44,FMN GV 16 Berchem TOT
54,Posthofbrug 5366,2020-06-15,23:00:00,36,12,24,FMN GV 16 Berchem TOT
54,Posthofbrug 5366,2020-06-16,00:00:00,10,5,5,FMN GV 16 Berchem TOT
54,Posthofbrug 5366,2020-06-16,01:00:00,11,6,5,FMN GV 16 Berchem TOT
54,Posthofbrug 5366,2020-06-16,02:00:00,2,1,1,FMN GV 16 Berchem TOT
54,Posthofbrug 5366,2020-06-16,03:00:00,3,1,2,FMN GV 16 Berchem TOT
54,Posthofbrug 5366,2020-06-16,04:00:00,9,6,3,FMN GV 16 Berchem TOT
54,Posthofbrug 5366,2020-06-16,05:00:00,20,15,5,FMN GV 16 Berchem TOT
54,Posthofbrug 5366,2020-06-16,06:00:00,90,69,21,FMN GV 16 Berchem TOT
54,Posthofbrug 5366,2020-06-16,07:00:00,293,212,81,FMN GV 16 Berchem TOT
54,Posthofbrug 5366,2020-06-16,08:00:00,438,324,114,FMN GV 16 Berchem TOT
54,Posthofbrug 5366,2020-06-16,09:00:00,216,157,59,FMN GV 16 Berchem TOT
54,Posthofbrug 5366,2020-06-16,10:00:00,126,88,38,FMN GV 16 Berchem TOT
54,Posthofbrug 5366,2020-06-16,11:00:00,151,93,58,FMN GV 16 Berchem TOT
54,Posthofbrug 5366,2020-06-16,12:00:00,173,87,86,FMN GV 16 Berchem TOT
54,Posthofbrug 5366,2020-06-16,13:00:00,155,75,80,FMN GV 16 Berchem TOT
54,Posthofbrug 5366,2020-06-16,14:00:00,168,74,94,FMN GV 16 Berchem TOT
54,Posthofbrug 5366,2020-06-16,15:00:00,243,84,159,FMN GV 16 Berchem TOT
54,Posthofbrug 5366,2020-06-16,16:00:00,323,101,222,FMN GV 16 Berchem TOT
54,Posthofbrug 5366,2020-06-16,17:00:00,360,109,251,FMN GV 16 Berchem TOT
54,Posthofbrug 5366,2020-06-16,18:00:00,214,65,149,FMN GV 16 Berchem TOT
54,Posthofbrug 5366,2020-06-16,19:00:00,178,79,99,FMN GV 16 Berchem TOT
54,Posthofbrug 5366,2020-06-16,20:00:00,128,60,68,FMN GV 16 Berchem TOT
54,Posthofbrug 5366,2020-06-16,21:00:00,97,60,37,FMN GV 16 Berchem TOT
54,Posthofbrug 5366,2020-06-16,22:00:00,77,32,45,FMN GV 16 Berchem TOT
54,Posthofbrug 5366,2020-06-16,23:00:00,42,20,22,FMN GV 16 Berchem TOT
54,Posthofbrug 5366,2020-06-17,00:00:00,23,10,13,FMN GV 16 Berchem TOT
54,Posthofbrug 5366,2020-06-17,01:00:00,13,4,9,FMN GV 16 Berchem TOT
54,Posthofbrug 5366,2020-06-17,02:00:00,4,2,2,FMN GV 16 Berchem TOT
54,Posthofbrug 5366,2020-06-17,03:00:00,5,1,4,FMN GV 16 Berchem TOT
54,Posthofbrug 5366,2020-06-17,04:00:00,11,7,4,FMN GV 16 Berchem TOT
54,Posthofbrug 5366,2020-06-17,05:00:00,21,16,5,FMN GV 16 Berchem TOT
54,Posthofbrug 5366,2020-06-17,06:00:00,83,63,20,FMN GV 16 Berchem TOT
54,Posthofbrug 5366,2020-06-17,07:00:00,255,179,76,FMN GV 16 Berchem TOT
54,Posthofbrug 5366,2020-06-17,08:00:00,337,250,87,FMN GV 16 Berchem TOT
54,Posthofbrug 5366,2020-06-17,09:00:00,141,97,44,FMN GV 16 Berchem TOT
54,Posthofbrug 5366,2020-06-17,10:00:00,135,78,57,FMN GV 16 Berchem TOT
54,Posthofbrug 5366,2020-06-17,11:00:00,127,67,60,FMN GV 16 Berchem TOT
54,Posthofbrug 5366,2020-06-17,12:00:00,184,73,111,FMN GV 16 Berchem TOT
54,Posthofbrug 5366,2020-06-17,13:00:00,147,76,71,FMN GV 16 Berchem TOT
54,Posthofbrug 5366,2020-06-17,14:00:00,155,66,89,FMN GV 16 Berchem TOT
54,Posthofbrug 5366,2020-06-17,15:00:00,176,60,116,FMN GV 16 Berchem TOT
54,Posthofbrug 5366,2020-06-17,16:00:00,137,46,91,FMN GV 16 Berchem TOT
54,Posthofbrug 5366,2020-06-17,17:00:00,223,78,145,FMN GV 16 Berchem TOT
54,Posthofbrug 5366,2020-06-17,18:00:00,147,44,103,FMN GV 16 Berchem TOT
54,Posthofbrug 5366,2020-06-17,19:00:00,59,14,45,FMN GV 16 Berchem TOT
54,Posthofbrug 5366,2020-06-17,20:00:00,41,21,20,FMN GV 16 Berchem TOT
54,Posthofbrug 5366,2020-06-17,21:00:00,39,20,19,FMN GV 16 Berchem TOT
54,Posthofbrug 5366,2020-06-17,22:00:00,18,5,13,FMN GV 16 Berchem TOT
54,Posthofbrug 5366,2020-06-17,23:00:00,18,5,13,FMN GV 16 Berchem TOT
54,Posthofbrug 5366,2020-06-18,00:00:00,12,3,9,FMN GV 16 Berchem TOT
54,Posthofbrug 5366,2020-06-18,01:00:00,5,0,5,FMN GV 16 Berchem TOT
54,Posthofbrug 5366,2020-06-18,02:00:00,1,0,1,FMN GV 16 Berchem TOT
54,Posthofbrug 5366,2020-06-18,03:00:00,1,1,0,FMN GV 16 Berchem TOT
54,Posthofbrug 5366,2020-06-18,04:00:00,4,2,2,FMN GV 16 Berchem TOT
54,Posthofbrug 5366,2020-06-18,05:00:00,20,14,6,FMN GV 16 Berchem TOT
54,Posthofbrug 5366,2020-06-18,06:00:00,76,56,20,FMN GV 16 Berchem TOT
54,Posthofbrug 5366,2020-06-18,07:00:00,259,192,67,FMN GV 16 Berchem TOT
54,Posthofbrug 5366,2020-06-18,08:00:00,384,288,96,FMN GV 16 Berchem TOT
54,Posthofbrug 5366,2020-06-18,09:00:00,170,115,55,FMN GV 16 Berchem TOT
54,Posthofbrug 5366,2020-06-18,10:00:00,117,76,41,FMN GV 16 Berchem TOT
54,Posthofbrug 5366,2020-06-18,11:00:00,126,74,52,FMN GV 16 Berchem TOT
54,Posthofbrug 5366,2020-06-18,12:00:00,165,95,70,FMN GV 16 Berchem TOT
54,Posthofbrug 5366,2020-06-18,13:00:00,149,82,67,FMN GV 16 Berchem TOT
54,Posthofbrug 5366,2020-06-18,14:00:00,170,78,92,FMN GV 16 Berchem TOT
54,Posthofbrug 5366,2020-06-18,15:00:00,226,92,134,FMN GV 16 Berchem TOT
54,Posthofbrug 5366,2020-06-18,16:00:00,272,89,183,FMN GV 16 Berchem TOT
54,Posthofbrug 5366,2020-06-18,17:00:00,338,104,234,FMN GV 16 Berchem TOT
54,Posthofbrug 5366,2020-06-18,18:00:00,244,74,170,FMN GV 16 Berchem TOT
54,Posthofbrug 5366,2020-06-18,19:00:00,161,73,88,FMN GV 16 Berchem TOT
54,Posthofbrug 5366,2020-06-18,20:00:00,98,53,45,FMN GV 16 Berchem TOT
54,Posthofbrug 5366,2020-06-18,21:00:00,90,48,42,FMN GV 16 Berchem TOT
54,Posthofbrug 5366,2020-06-18,22:00:00,77,37,40,FMN GV 16 Berchem TOT
54,Posthofbrug 5366,2020-06-18,23:00:00,54,24,30,FMN GV 16 Berchem TOT
54,Posthofbrug 5366,2020-06-19,00:00:00,30,11,19,FMN GV 16 Berchem TOT
54,Posthofbrug 5366,2020-06-19,01:00:00,21,5,16,FMN GV 16 Berchem TOT
54,Posthofbrug 5366,2020-06-19,02:00:00,9,1,8,FMN GV 16 Berchem TOT
54,Posthofbrug 5366,2020-06-19,03:00:00,5,2,3,FMN GV 16 Berchem TOT
54,Posthofbrug 5366,2020-06-19,04:00:00,8,4,4,FMN GV 16 Berchem TOT
54,Posthofbrug 5366,2020-06-19,05:00:00,18,14,4,FMN GV 16 Berchem TOT
54,Posthofbrug 5366,2020-06-19,06:00:00,82,58,24,FMN GV 16 Berchem TOT
54,Posthofbrug 5366,2020-06-19,07:00:00,250,183,67,FMN GV 16 Berchem TOT
54,Posthofbrug 5366,2020-06-19,08:00:00,367,272,95,FMN GV 16 Berchem TOT
54,Posthofbrug 5366,2020-06-19,09:00:00,177,129,48,FMN GV 16 Berchem TOT
54,Posthofbrug 5366,2020-06-19,10:00:00,144,92,52,FMN GV 16 Berchem TOT
54,Posthofbrug 5366,2020-06-19,11:00:00,153,88,65,FMN GV 16 Berchem TOT
54,Posthofbrug 5366,2020-06-19,12:00:00,181,94,87,FMN GV 16 Berchem TOT
54,Posthofbrug 5366,2020-06-19,13:00:00,215,115,100,FMN GV 16 Berchem TOT
54,Posthofbrug 5366,2020-06-19,14:00:00,212,96,116,FMN GV 16 Berchem TOT
54,Posthofbrug 5366,2020-06-19,15:00:00,268,86,182,FMN GV 16 Berchem TOT
54,Posthofbrug 5366,2020-06-19,16:00:00,308,111,197,FMN GV 16 Berchem TOT
54,Posthofbrug 5366,2020-06-19,17:00:00,341,124,217,FMN GV 16 Berchem TOT
54,Posthofbrug 5366,2020-06-19,18:00:00,268,113,155,FMN GV 16 Berchem TOT
54,Posthofbrug 5366,2020-06-19,19:00:00,158,75,83,FMN GV 16 Berchem TOT
54,Posthofbrug 5366,2020-06-19,20:00:00,145,89,56,FMN GV 16 Berchem TOT
54,Posthofbrug 5366,2020-06-19,21:00:00,79,37,42,FMN GV 16 Berchem TOT
54,Posthofbrug 5366,2020-06-19,22:00:00,65,32,33,FMN GV 16 Berchem TOT
54,Posthofbrug 5366,2020-06-19,23:00:00,66,27,39,FMN GV 16 Berchem TOT
54,Posthofbrug 5366,2020-06-20,00:00:00,64,26,38,FMN GV 16 Berchem TOT
54,Posthofbrug 5366,2020-06-20,01:00:00,94,18,76,FMN GV 16 Berchem TOT
54,Posthofbrug 5366,2020-06-20,02:00:00,21,4,17,FMN GV 16 Berchem TOT
54,Posthofbrug 5366,2020-06-20,03:00:00,19,8,11,FMN GV 16 Berchem TOT
54,Posthofbrug 5366,2020-06-20,04:00:00,11,5,6,FMN GV 16 Berchem TOT
54,Posthofbrug 5366,2020-06-20,05:00:00,17,14,3,FMN GV 16 Berchem TOT
54,Posthofbrug 5366,2020-06-20,06:00:00,17,11,6,FMN GV 16 Berchem TOT
54,Posthofbrug 5366,2020-06-20,07:00:00,36,26,10,FMN GV 16 Berchem TOT
54,Posthofbrug 5366,2020-06-20,08:00:00,50,26,24,FMN GV 16 Berchem TOT
54,Posthofbrug 5366,2020-06-20,09:00:00,131,89,42,FMN GV 16 Berchem TOT
54,Posthofbrug 5366,2020-06-20,10:00:00,174,87,87,FMN GV 16 Berchem TOT
54,Posthofbrug 5366,2020-06-20,11:00:00,183,110,73,FMN GV 16 Berchem TOT
54,Posthofbrug 5366,2020-06-20,12:00:00,173,95,78,FMN GV 16 Berchem TOT
54,Posthofbrug 5366,2020-06-20,13:00:00,201,120,81,FMN GV 16 Berchem TOT
54,Posthofbrug 5366,2020-06-20,14:00:00,261,155,106,FMN GV 16 Berchem TOT
54,Posthofbrug 5366,2020-06-20,15:00:00,225,127,98,FMN GV 16 Berchem TOT
54,Posthofbrug 5366,2020-06-20,16:00:00,272,128,144,FMN GV 16 Berchem TOT
54,Posthofbrug 5366,2020-06-20,17:00:00,245,103,142,FMN GV 16 Berchem TOT
54,Posthofbrug 5366,2020-06-20,18:00:00,246,131,115,FMN GV 16 Berchem TOT
54,Posthofbrug 5366,2020-06-20,19:00:00,148,86,62,FMN GV 16 Berchem TOT
54,Posthofbrug 5366,2020-06-20,20:00:00,104,50,54,FMN GV 16 Berchem TOT
54,Posthofbrug 5366,2020-06-20,21:00:00,97,43,54,FMN GV 16 Berchem TOT
54,Posthofbrug 5366,2020-06-20,22:00:00,75,38,37,FMN GV 16 Berchem TOT
54,Posthofbrug 5366,2020-06-20,23:00:00,83,26,57,FMN GV 16 Berchem TOT
54,Posthofbrug 5366,2020-06-21,00:00:00,35,17,18,FMN GV 16 Berchem TOT
54,Posthofbrug 5366,2020-06-21,01:00:00,76,27,49,FMN GV 16 Berchem TOT
54,Posthofbrug 5366,2020-06-21,02:00:00,15,8,7,FMN GV 16 Berchem TOT
54,Posthofbrug 5366,2020-06-21,03:00:00,19,8,11,FMN GV 16 Berchem TOT
54,Posthofbrug 5366,2020-06-21,04:00:00,17,5,12,FMN GV 16 Berchem TOT
54,Posthofbrug 5366,2020-06-21,05:00:00,11,9,2,FMN GV 16 Berchem TOT
54,Posthofbrug 5366,2020-06-21,06:00:00,12,10,2,FMN GV 16 Berchem TOT
54,Posthofbrug 5366,2020-06-21,07:00:00,32,14,18,FMN GV 16 Berchem TOT
54,Posthofbrug 5366,2020-06-21,08:00:00,60,27,33,FMN GV 16 Berchem TOT
54,Posthofbrug 5366,2020-06-21,09:00:00,109,68,41,FMN GV 16 Berchem TOT
54,Posthofbrug 5366,2020-06-21,10:00:00,155,74,81,FMN GV 16 Berchem TOT
54,Posthofbrug 5366,2020-06-21,11:00:00,181,110,71,FMN GV 16 Berchem TOT
54,Posthofbrug 5366,2020-06-21,12:00:00,274,172,102,FMN GV 16 Berchem TOT
54,Posthofbrug 5366,2020-06-21,13:00:00,226,105,121,FMN GV 16 Berchem TOT
54,Posthofbrug 5366,2020-06-21,14:00:00,233,118,115,FMN GV 16 Berchem TOT
54,Posthofbrug 5366,2020-06-21,15:00:00,207,103,104,FMN GV 16 Berchem TOT
54,Posthofbrug 5366,2020-06-21,16:00:00,248,120,128,FMN GV 16 Berchem TOT
54,Posthofbrug 5366,2020-06-21,17:00:00,184,84,100,FMN GV 16 Berchem TOT
54,Posthofbrug 5366,2020-06-21,18:00:00,140,81,59,FMN GV 16 Berchem TOT
54,Posthofbrug 5366,2020-06-21,19:00:00,80,52,28,FMN GV 16 Berchem TOT
54,Posthofbrug 5366,2020-06-21,20:00:00,86,53,33,FMN GV 16 Berchem TOT
54,Posthofbrug 5366,2020-06-21,21:00:00,74,43,31,FMN GV 16 Berchem TOT
54,Posthofbrug 5366,2020-06-21,22:00:00,45,20,25,FMN GV 16 Berchem TOT
54,Posthofbrug 5366,2020-06-21,23:00:00,22,5,17,FMN GV 16 Berchem TOT
54,Posthofbrug 5366,2020-06-22,00:00:00,5,1,4,FMN GV 16 Berchem TOT
54,Posthofbrug 5366,2020-06-22,01:00:00,7,2,5,FMN GV 16 Berchem TOT
54,Posthofbrug 5366,2020-06-22,02:00:00,6,2,4,FMN GV 16 Berchem TOT
54,Posthofbrug 5366,2020-06-22,03:00:00,4,2,2,FMN GV 16 Berchem TOT
54,Posthofbrug 5366,2020-06-22,04:00:00,11,7,4,FMN GV 16 Berchem TOT
54,Posthofbrug 5366,2020-06-22,05:00:00,24,20,4,FMN GV 16 Berchem TOT
54,Posthofbrug 5366,2020-06-22,06:00:00,84,66,18,FMN GV 16 Berchem TOT
54,Posthofbrug 5366,2020-06-22,07:00:00,308,244,64,FMN GV 16 Berchem TOT
54,Posthofbrug 5366,2020-06-22,08:00:00,481,357,124,FMN GV 16 Berchem TOT
54,Posthofbrug 5366,2020-06-22,09:00:00,208,156,52,FMN GV 16 Berchem TOT
54,Posthofbrug 5366,2020-06-22,10:00:00,147,96,51,FMN GV 16 Berchem TOT
54,Posthofbrug 5366,2020-06-22,11:00:00,158,94,64,FMN GV 16 Berchem TOT
54,Posthofbrug 5366,2020-06-22,12:00:00,185,92,93,FMN GV 16 Berchem TOT
54,Posthofbrug 5366,2020-06-22,13:00:00,159,86,73,FMN GV 16 Berchem TOT
54,Posthofbrug 5366,2020-06-22,14:00:00,182,85,97,FMN GV 16 Berchem TOT
54,Posthofbrug 5366,2020-06-22,15:00:00,259,103,156,FMN GV 16 Berchem TOT
54,Posthofbrug 5366,2020-06-22,16:00:00,338,105,233,FMN GV 16 Berchem TOT
54,Posthofbrug 5366,2020-06-22,17:00:00,399,133,266,FMN GV 16 Berchem TOT
54,Posthofbrug 5366,2020-06-22,18:00:00,299,95,204,FMN GV 16 Berchem TOT
54,Posthofbrug 5366,2020-06-22,19:00:00,176,85,91,FMN GV 16 Berchem TOT
54,Posthofbrug 5366,2020-06-22,20:00:00,108,51,57,FMN GV 16 Berchem TOT
54,Posthofbrug 5366,2020-06-22,21:00:00,104,50,54,FMN GV 16 Berchem TOT
54,Posthofbrug 5366,2020-06-22,22:00:00,85,36,49,FMN GV 16 Berchem TOT
54,Posthofbrug 5366,2020-06-22,23:00:00,36,15,21,FMN GV 16 Berchem TOT
54,Posthofbrug 5366,2020-06-23,00:00:00,14,2,12,FMN GV 16 Berchem TOT
54,Posthofbrug 5366,2020-06-23,01:00:00,14,2,12,FMN GV 16 Berchem TOT
54,Posthofbrug 5366,2020-06-23,02:00:00,1,0,1,FMN GV 16 Berchem TOT
54,Posthofbrug 5366,2020-06-23,03:00:00,3,0,3,FMN GV 16 Berchem TOT
54,Posthofbrug 5366,2020-06-23,04:00:00,22,12,10,FMN GV 16 Berchem TOT
54,Posthofbrug 5366,2020-06-23,05:00:00,20,14,6,FMN GV 16 Berchem TOT
54,Posthofbrug 5366,2020-06-23,06:00:00,98,74,24,FMN GV 16 Berchem TOT
54,Posthofbrug 5366,2020-06-23,07:00:00,342,258,84,FMN GV 16 Berchem TOT
54,Posthofbrug 5366,2020-06-23,08:00:00,459,336,123,FMN GV 16 Berchem TOT
54,Posthofbrug 5366,2020-06-23,09:00:00,237,178,59,FMN GV 16 Berchem TOT
54,Posthofbrug 5366,2020-06-23,10:00:00,123,76,47,FMN GV 16 Berchem TOT
54,Posthofbrug 5366,2020-06-23,11:00:00,160,87,73,FMN GV 16 Berchem TOT
54,Posthofbrug 5366,2020-06-23,12:00:00,181,97,84,FMN GV 16 Berchem TOT
54,Posthofbrug 5366,2020-06-23,13:00:00,217,117,100,FMN GV 16 Berchem TOT
54,Posthofbrug 5366,2020-06-23,14:00:00,177,73,104,FMN GV 16 Berchem TOT
54,Posthofbrug 5366,2020-06-23,15:00:00,273,108,165,FMN GV 16 Berchem TOT
54,Posthofbrug 5366,2020-06-23,16:00:00,347,115,232,FMN GV 16 Berchem TOT
54,Posthofbrug 5366,2020-06-23,17:00:00,429,131,298,FMN GV 16 Berchem TOT
54,Posthofbrug 5366,2020-06-23,18:00:00,331,90,241,FMN GV 16 Berchem TOT
54,Posthofbrug 5366,2020-06-23,19:00:00,212,99,113,FMN GV 16 Berchem TOT
54,Posthofbrug 5366,2020-06-23,20:00:00,139,68,71,FMN GV 16 Berchem TOT
54,Posthofbrug 5366,2020-06-23,21:00:00,150,94,56,FMN GV 16 Berchem TOT
54,Posthofbrug 5366,2020-06-23,22:00:00,124,67,57,FMN GV 16 Berchem TOT
54,Posthofbrug 5366,2020-06-23,23:00:00,71,35,36,FMN GV 16 Berchem TOT
54,Posthofbrug 5366,2020-06-24,00:00:00,25,11,14,FMN GV 16 Berchem TOT
54,Posthofbrug 5366,2020-06-24,01:00:00,25,10,15,FMN GV 16 Berchem TOT
54,Posthofbrug 5366,2020-06-24,02:00:00,12,1,11,FMN GV 16 Berchem TOT
54,Posthofbrug 5366,2020-06-24,03:00:00,4,2,2,FMN GV 16 Berchem TOT
54,Posthofbrug 5366,2020-06-24,04:00:00,14,6,8,FMN GV 16 Berchem TOT
54,Posthofbrug 5366,2020-06-24,05:00:00,28,23,5,FMN GV 16 Berchem TOT
54,Posthofbrug 5366,2020-06-24,06:00:00,81,63,18,FMN GV 16 Berchem TOT
54,Posthofbrug 5366,2020-06-24,07:00:00,302,222,80,FMN GV 16 Berchem TOT
54,Posthofbrug 5366,2020-06-24,08:00:00,378,272,106,FMN GV 16 Berchem TOT
54,Posthofbrug 5366,2020-06-24,09:00:00,195,143,52,FMN GV 16 Berchem TOT
54,Posthofbrug 5366,2020-06-24,10:00:00,144,90,54,FMN GV 16 Berchem TOT
54,Posthofbrug 5366,2020-06-24,11:00:00,167,99,68,FMN GV 16 Berchem TOT
54,Posthofbrug 5366,2020-06-24,12:00:00,201,84,117,FMN GV 16 Berchem TOT
54,Posthofbrug 5366,2020-06-24,13:00:00,181,81,100,FMN GV 16 Berchem TOT
54,Posthofbrug 5366,2020-06-24,14:00:00,204,97,107,FMN GV 16 Berchem TOT
54,Posthofbrug 5366,2020-06-24,15:00:00,241,109,132,FMN GV 16 Berchem TOT
54,Posthofbrug 5366,2020-06-24,16:00:00,298,96,202,FMN GV 16 Berchem TOT
54,Posthofbrug 5366,2020-06-24,17:00:00,388,131,257,FMN GV 16 Berchem TOT
54,Posthofbrug 5366,2020-06-24,18:00:00,321,132,189,FMN GV 16 Berchem TOT
54,Posthofbrug 5366,2020-06-24,19:00:00,210,106,104,FMN GV 16 Berchem TOT
54,Posthofbrug 5366,2020-06-24,20:00:00,150,67,83,FMN GV 16 Berchem TOT
54,Posthofbrug 5366,2020-06-24,21:00:00,157,87,70,FMN GV 16 Berchem TOT
54,Posthofbrug 5366,2020-06-24,22:00:00,151,79,72,FMN GV 16 Berchem TOT
54,Posthofbrug 5366,2020-06-24,23:00:00,98,32,66,FMN GV 16 Berchem TOT
54,Posthofbrug 5366,2020-06-25,00:00:00,41,16,25,FMN GV 16 Berchem TOT
54,Posthofbrug 5366,2020-06-25,01:00:00,28,5,23,FMN GV 16 Berchem TOT
54,Posthofbrug 5366,2020-06-25,02:00:00,7,0,7,FMN GV 16 Berchem TOT
54,Posthofbrug 5366,2020-06-25,03:00:00,9,1,8,FMN GV 16 Berchem TOT
54,Posthofbrug 5366,2020-06-25,04:00:00,16,7,9,FMN GV 16 Berchem TOT
54,Posthofbrug 5366,2020-06-25,05:00:00,23,21,2,FMN GV 16 Berchem TOT
54,Posthofbrug 5366,2020-06-25,06:00:00,97,75,22,FMN GV 16 Berchem TOT
54,Posthofbrug 5366,2020-06-25,07:00:00,338,244,94,FMN GV 16 Berchem TOT
54,Posthofbrug 5366,2020-06-25,08:00:00,475,345,130,FMN GV 16 Berchem TOT
54,Posthofbrug 5366,2020-06-25,09:00:00,236,165,71,FMN GV 16 Berchem TOT
54,Posthofbrug 5366,2020-06-25,10:00:00,154,104,50,FMN GV 16 Berchem TOT
54,Posthofbrug 5366,2020-06-25,11:00:00,149,92,57,FMN GV 16 Berchem TOT
54,Posthofbrug 5366,2020-06-25,12:00:00,212,117,95,FMN GV 16 Berchem TOT
54,Posthofbrug 5366,2020-06-25,13:00:00,166,83,83,FMN GV 16 Berchem TOT
54,Posthofbrug 5366,2020-06-25,14:00:00,168,75,93,FMN GV 16 Berchem TOT
54,Posthofbrug 5366,2020-06-25,15:00:00,255,114,141,FMN GV 16 Berchem TOT
54,Posthofbrug 5366,2020-06-25,16:00:00,302,114,188,FMN GV 16 Berchem TOT
54,Posthofbrug 5366,2020-06-25,17:00:00,439,125,314,FMN GV 16 Berchem TOT
54,Posthofbrug 5366,2020-06-25,18:00:00,380,131,249,FMN GV 16 Berchem TOT
54,Posthofbrug 5366,2020-06-25,19:00:00,216,91,125,FMN GV 16 Berchem TOT
54,Posthofbrug 5366,2020-06-25,20:00:00,140,73,67,FMN GV 16 Berchem TOT
54,Posthofbrug 5366,2020-06-25,21:00:00,128,69,59,FMN GV 16 Berchem TOT
54,Posthofbrug 5366,2020-06-25,22:00:00,117,57,60,FMN GV 16 Berchem TOT
54,Posthofbrug 5366,2020-06-25,23:00:00,111,38,73,FMN GV 16 Berchem TOT
54,Posthofbrug 5366,2020-06-26,00:00:00,54,21,33,FMN GV 16 Berchem TOT
54,Posthofbrug 5366,2020-06-26,01:00:00,36,12,24,FMN GV 16 Berchem TOT
54,Posthofbrug 5366,2020-06-26,02:00:00,21,4,17,FMN GV 16 Berchem TOT
54,Posthofbrug 5366,2020-06-26,03:00:00,4,1,3,FMN GV 16 Berchem TOT
54,Posthofbrug 5366,2020-06-26,04:00:00,11,8,3,FMN GV 16 Berchem TOT
54,Posthofbrug 5366,2020-06-26,05:00:00,22,17,5,FMN GV 16 Berchem TOT
54,Posthofbrug 5366,2020-06-26,06:00:00,89,67,22,FMN GV 16 Berchem TOT
54,Posthofbrug 5366,2020-06-26,07:00:00,229,160,69,FMN GV 16 Berchem TOT
54,Posthofbrug 5366,2020-06-26,08:00:00,353,264,89,FMN GV 16 Berchem TOT
54,Posthofbrug 5366,2020-06-26,09:00:00,213,157,56,FMN GV 16 Berchem TOT
54,Posthofbrug 5366,2020-06-26,10:00:00,155,103,52,FMN GV 16 Berchem TOT
54,Posthofbrug 5366,2020-06-26,11:00:00,149,80,69,FMN GV 16 Berchem TOT
54,Posthofbrug 5366,2020-06-26,12:00:00,206,104,102,FMN GV 16 Berchem TOT
54,Posthofbrug 5366,2020-06-26,13:00:00,181,92,89,FMN GV 16 Berchem TOT
54,Posthofbrug 5366,2020-06-26,14:00:00,173,63,110,FMN GV 16 Berchem TOT
54,Posthofbrug 5366,2020-06-26,15:00:00,249,86,163,FMN GV 16 Berchem TOT
54,Posthofbrug 5366,2020-06-26,16:00:00,270,111,159,FMN GV 16 Berchem TOT
54,Posthofbrug 5366,2020-06-26,17:00:00,295,97,198,FMN GV 16 Berchem TOT
54,Posthofbrug 5366,2020-06-26,18:00:00,216,90,126,FMN GV 16 Berchem TOT
54,Posthofbrug 5366,2020-06-26,19:00:00,159,69,90,FMN GV 16 Berchem TOT
54,Posthofbrug 5366,2020-06-26,20:00:00,99,48,51,FMN GV 16 Berchem TOT
54,Posthofbrug 5366,2020-06-26,21:00:00,73,35,38,FMN GV 16 Berchem TOT
54,Posthofbrug 5366,2020-06-26,22:00:00,60,27,33,FMN GV 16 Berchem TOT
54,Posthofbrug 5366,2020-06-26,23:00:00,73,29,44,FMN GV 16 Berchem TOT
54,Posthofbrug 5366,2020-06-27,00:00:00,66,31,35,FMN GV 16 Berchem TOT
54,Posthofbrug 5366,2020-06-27,01:00:00,62,24,38,FMN GV 16 Berchem TOT
54,Posthofbrug 5366,2020-06-27,02:00:00,29,10,19,FMN GV 16 Berchem TOT
54,Posthofbrug 5366,2020-06-27,03:00:00,18,5,13,FMN GV 16 Berchem TOT
54,Posthofbrug 5366,2020-06-27,04:00:00,13,5,8,FMN GV 16 Berchem TOT
54,Posthofbrug 5366,2020-06-27,05:00:00,17,12,5,FMN GV 16 Berchem TOT
54,Posthofbrug 5366,2020-06-27,06:00:00,22,17,5,FMN GV 16 Berchem TOT
54,Posthofbrug 5366,2020-06-27,07:00:00,26,15,11,FMN GV 16 Berchem TOT
54,Posthofbrug 5366,2020-06-27,08:00:00,57,42,15,FMN GV 16 Berchem TOT
54,Posthofbrug 5366,2020-06-27,09:00:00,123,94,29,FMN GV 16 Berchem TOT
54,Posthofbrug 5366,2020-06-27,10:00:00,134,82,52,FMN GV 16 Berchem TOT
54,Posthofbrug 5366,2020-06-27,11:00:00,151,83,68,FMN GV 16 Berchem TOT
54,Posthofbrug 5366,2020-06-27,12:00:00,142,82,60,FMN GV 16 Berchem TOT
54,Posthofbrug 5366,2020-06-27,13:00:00,153,85,68,FMN GV 16 Berchem TOT
54,Posthofbrug 5366,2020-06-27,14:00:00,196,131,65,FMN GV 16 Berchem TOT
54,Posthofbrug 5366,2020-06-27,15:00:00,123,46,77,FMN GV 16 Berchem TOT
54,Posthofbrug 5366,2020-06-27,16:00:00,206,100,106,FMN GV 16 Berchem TOT
54,Posthofbrug 5366,2020-06-27,17:00:00,147,68,79,FMN GV 16 Berchem TOT
54,Posthofbrug 5366,2020-06-27,18:00:00,135,59,76,FMN GV 16 Berchem TOT
54,Posthofbrug 5366,2020-06-27,19:00:00,105,53,52,FMN GV 16 Berchem TOT
54,Posthofbrug 5366,2020-06-27,20:00:00,85,45,40,FMN GV 16 Berchem TOT
54,Posthofbrug 5366,2020-06-27,21:00:00,74,37,37,FMN GV 16 Berchem TOT
54,Posthofbrug 5366,2020-06-27,22:00:00,48,27,21,FMN GV 16 Berchem TOT
54,Posthofbrug 5366,2020-06-27,23:00:00,46,19,27,FMN GV 16 Berchem TOT
54,Posthofbrug 5366,2020-06-28,00:00:00,35,14,21,FMN GV 16 Berchem TOT
54,Posthofbrug 5366,2020-06-28,01:00:00,45,18,27,FMN GV 16 Berchem TOT
54,Posthofbrug 5366,2020-06-28,02:00:00,25,7,18,FMN GV 16 Berchem TOT
54,Posthofbrug 5366,2020-06-28,03:00:00,6,1,5,FMN GV 16 Berchem TOT
54,Posthofbrug 5366,2020-06-28,04:00:00,9,5,4,FMN GV 16 Berchem TOT
54,Posthofbrug 5366,2020-06-28,05:00:00,18,7,11,FMN GV 16 Berchem TOT
54,Posthofbrug 5366,2020-06-28,06:00:00,11,10,1,FMN GV 16 Berchem TOT
54,Posthofbrug 5366,2020-06-28,07:00:00,25,14,11,FMN GV 16 Berchem TOT
54,Posthofbrug 5366,2020-06-28,08:00:00,46,19,27,FMN GV 16 Berchem TOT
54,Posthofbrug 5366,2020-06-28,09:00:00,96,51,45,FMN GV 16 Berchem TOT
54,Posthofbrug 5366,2020-06-28,10:00:00,114,58,56,FMN GV 16 Berchem TOT
54,Posthofbrug 5366,2020-06-28,11:00:00,144,90,54,FMN GV 16 Berchem TOT
54,Posthofbrug 5366,2020-06-28,12:00:00,169,97,72,FMN GV 16 Berchem TOT
54,Posthofbrug 5366,2020-06-28,13:00:00,160,86,74,FMN GV 16 Berchem TOT
54,Posthofbrug 5366,2020-06-28,14:00:00,209,120,89,FMN GV 16 Berchem TOT
54,Posthofbrug 5366,2020-06-28,15:00:00,196,83,113,FMN GV 16 Berchem TOT
54,Posthofbrug 5366,2020-06-28,16:00:00,190,95,95,FMN GV 16 Berchem TOT
54,Posthofbrug 5366,2020-06-28,17:00:00,152,87,65,FMN GV 16 Berchem TOT
54,Posthofbrug 5366,2020-06-28,18:00:00,141,69,72,FMN GV 16 Berchem TOT
54,Posthofbrug 5366,2020-06-28,19:00:00,112,49,63,FMN GV 16 Berchem TOT
54,Posthofbrug 5366,2020-06-28,20:00:00,108,65,43,FMN GV 16 Berchem TOT
54,Posthofbrug 5366,2020-06-28,21:00:00,87,51,36,FMN GV 16 Berchem TOT
54,Posthofbrug 5366,2020-06-28,22:00:00,68,37,31,FMN GV 16 Berchem TOT
54,Posthofbrug 5366,2020-06-28,23:00:00,29,15,14,FMN GV 16 Berchem TOT
54,Posthofbrug 5366,2020-06-29,00:00:00,26,11,15,FMN GV 16 Berchem TOT
54,Posthofbrug 5366,2020-06-29,01:00:00,9,3,6,FMN GV 16 Berchem TOT
54,Posthofbrug 5366,2020-06-29,02:00:00,3,1,2,FMN GV 16 Berchem TOT
54,Posthofbrug 5366,2020-06-29,03:00:00,11,2,9,FMN GV 16 Berchem TOT
54,Posthofbrug 5366,2020-06-29,04:00:00,18,13,5,FMN GV 16 Berchem TOT
54,Posthofbrug 5366,2020-06-29,05:00:00,16,13,3,FMN GV 16 Berchem TOT
54,Posthofbrug 5366,2020-06-29,06:00:00,89,69,20,FMN GV 16 Berchem TOT
54,Posthofbrug 5366,2020-06-29,07:00:00,276,207,69,FMN GV 16 Berchem TOT
54,Posthofbrug 5366,2020-06-29,08:00:00,448,330,118,FMN GV 16 Berchem TOT
54,Posthofbrug 5366,2020-06-29,09:00:00,184,147,37,FMN GV 16 Berchem TOT
54,Posthofbrug 5366,2020-06-29,10:00:00,127,84,43,FMN GV 16 Berchem TOT
54,Posthofbrug 5366,2020-06-29,11:00:00,129,76,53,FMN GV 16 Berchem TOT
54,Posthofbrug 5366,2020-06-29,12:00:00,163,87,76,FMN GV 16 Berchem TOT
54,Posthofbrug 5366,2020-06-29,13:00:00,184,114,70,FMN GV 16 Berchem TOT
54,Posthofbrug 5366,2020-06-29,14:00:00,181,80,101,FMN GV 16 Berchem TOT
54,Posthofbrug 5366,2020-06-29,15:00:00,254,93,161,FMN GV 16 Berchem TOT
54,Posthofbrug 5366,2020-06-29,16:00:00,313,111,202,FMN GV 16 Berchem TOT
54,Posthofbrug 5366,2020-06-29,17:00:00,397,114,283,FMN GV 16 Berchem TOT
54,Posthofbrug 5366,2020-06-29,18:00:00,271,92,179,FMN GV 16 Berchem TOT
54,Posthofbrug 5366,2020-06-29,19:00:00,158,60,98,FMN GV 16 Berchem TOT
54,Posthofbrug 5366,2020-06-29,20:00:00,123,57,66,FMN GV 16 Berchem TOT
54,Posthofbrug 5366,2020-06-29,21:00:00,77,37,40,FMN GV 16 Berchem TOT
54,Posthofbrug 5366,2020-06-29,22:00:00,86,38,48,FMN GV 16 Berchem TOT
54,Posthofbrug 5366,2020-06-29,23:00:00,34,9,25,FMN GV 16 Berchem TOT
54,Posthofbrug 5366,2020-06-30,00:00:00,19,4,15,FMN GV 16 Berchem TOT
54,Posthofbrug 5366,2020-06-30,01:00:00,9,1,8,FMN GV 16 Berchem TOT
54,Posthofbrug 5366,2020-06-30,02:00:00,4,2,2,FMN GV 16 Berchem TOT
54,Posthofbrug 5366,2020-06-30,03:00:00,5,3,2,FMN GV 16 Berchem TOT
54,Posthofbrug 5366,2020-06-30,04:00:00,10,6,4,FMN GV 16 Berchem TOT
54,Posthofbrug 5366,2020-06-30,05:00:00,25,14,11,FMN GV 16 Berchem TOT
54,Posthofbrug 5366,2020-06-30,06:00:00,84,67,17,FMN GV 16 Berchem TOT
54,Posthofbrug 5366,2020-06-30,07:00:00,279,199,80,FMN GV 16 Berchem TOT
54,Posthofbrug 5366,2020-06-30,08:00:00,428,309,119,FMN GV 16 Berchem TOT
54,Posthofbrug 5366,2020-06-30,09:00:00,186,126,60,FMN GV 16 Berchem TOT
54,Posthofbrug 5366,2020-06-30,10:00:00,130,91,39,FMN GV 16 Berchem TOT
54,Posthofbrug 5366,2020-06-30,11:00:00,130,74,56,FMN GV 16 Berchem TOT
54,Posthofbrug 5366,2020-06-30,12:00:00,194,106,88,FMN GV 16 Berchem TOT
54,Posthofbrug 5366,2020-06-30,13:00:00,152,81,71,FMN GV 16 Berchem TOT
54,Posthofbrug 5366,2020-06-30,14:00:00,155,72,83,FMN GV 16 Berchem TOT
54,Posthofbrug 5366,2020-06-30,15:00:00,180,54,126,FMN GV 16 Berchem TOT
54,Posthofbrug 5366,2020-06-30,16:00:00,225,74,151,FMN GV 16 Berchem TOT
54,Posthofbrug 5366,2020-06-30,17:00:00,317,122,195,FMN GV 16 Berchem TOT
54,Posthofbrug 5366,2020-06-30,18:00:00,229,68,161,FMN GV 16 Berchem TOT
54,Posthofbrug 5366,2020-06-30,19:00:00,122,49,73,FMN GV 16 Berchem TOT
54,Posthofbrug 5366,2020-06-30,20:00:00,93,40,53,FMN GV 16 Berchem TOT
54,Posthofbrug 5366,2020-06-30,21:00:00,59,28,31,FMN GV 16 Berchem TOT
54,Posthofbrug 5366,2020-06-30,22:00:00,59,25,34,FMN GV 16 Berchem TOT
54,Posthofbrug 5366,2020-06-30,23:00:00,30,10,20,FMN GV 16 Berchem TOT
54,Posthofbrug 5366,2020-07-01,00:00:00,16,5,11,FMN GV 16 Berchem TOT
54,Posthofbrug 5366,2020-07-01,01:00:00,12,5,7,FMN GV 16 Berchem TOT
54,Posthofbrug 5366,2020-07-01,02:00:00,4,0,4,FMN GV 16 Berchem TOT
54,Posthofbrug 5366,2020-07-01,03:00:00,6,5,1,FMN GV 16 Berchem TOT
54,Posthofbrug 5366,2020-07-01,04:00:00,17,9,8,FMN GV 16 Berchem TOT
54,Posthofbrug 5366,2020-07-01,05:00:00,10,9,1,FMN GV 16 Berchem TOT
54,Posthofbrug 5366,2020-07-01,06:00:00,68,55,13,FMN GV 16 Berchem TOT
54,Posthofbrug 5366,2020-07-01,07:00:00,164,119,45,FMN GV 16 Berchem TOT
54,Posthofbrug 5366,2020-07-01,08:00:00,209,140,69,FMN GV 16 Berchem TOT
54,Posthofbrug 5366,2020-07-01,09:00:00,83,65,18,FMN GV 16 Berchem TOT
54,Posthofbrug 5366,2020-07-01,10:00:00,45,31,14,FMN GV 16 Berchem TOT
54,Posthofbrug 5366,2020-07-01,11:00:00,68,43,25,FMN GV 16 Berchem TOT
54,Posthofbrug 5366,2020-07-01,12:00:00,93,50,43,FMN GV 16 Berchem TOT
54,Posthofbrug 5366,2020-07-01,13:00:00,85,43,42,FMN GV 16 Berchem TOT
54,Posthofbrug 5366,2020-07-01,14:00:00,101,41,60,FMN GV 16 Berchem TOT
54,Posthofbrug 5366,2020-07-01,15:00:00,151,70,81,FMN GV 16 Berchem TOT
54,Posthofbrug 5366,2020-07-01,16:00:00,184,75,109,FMN GV 16 Berchem TOT
54,Posthofbrug 5366,2020-07-01,17:00:00,267,100,167,FMN GV 16 Berchem TOT
54,Posthofbrug 5366,2020-07-01,18:00:00,250,106,144,FMN GV 16 Berchem TOT
54,Posthofbrug 5366,2020-07-01,19:00:00,150,65,85,FMN GV 16 Berchem TOT
54,Posthofbrug 5366,2020-07-01,20:00:00,116,72,44,FMN GV 16 Berchem TOT
54,Posthofbrug 5366,2020-07-01,21:00:00,139,84,55,FMN GV 16 Berchem TOT
54,Posthofbrug 5366,2020-07-01,22:00:00,66,33,33,FMN GV 16 Berchem TOT
54,Posthofbrug 5366,2020-07-01,23:00:00,54,19,35,FMN GV 16 Berchem TOT
54,Posthofbrug 5366,2020-07-02,00:00:00,40,14,26,FMN GV 16 Berchem TOT
54,Posthofbrug 5366,2020-07-02,01:00:00,21,4,17,FMN GV 16 Berchem TOT
54,Posthofbrug 5366,2020-07-02,02:00:00,4,2,2,FMN GV 16 Berchem TOT
54,Posthofbrug 5366,2020-07-02,03:00:00,5,0,5,FMN GV 16 Berchem TOT
54,Posthofbrug 5366,2020-07-02,04:00:00,12,7,5,FMN GV 16 Berchem TOT
54,Posthofbrug 5366,2020-07-02,05:00:00,24,16,8,FMN GV 16 Berchem TOT
54,Posthofbrug 5366,2020-07-02,06:00:00,101,75,26,FMN GV 16 Berchem TOT
54,Posthofbrug 5366,2020-07-02,07:00:00,247,174,73,FMN GV 16 Berchem TOT
54,Posthofbrug 5366,2020-07-02,08:00:00,353,254,99,FMN GV 16 Berchem TOT
54,Posthofbrug 5366,2020-07-02,09:00:00,181,132,49,FMN GV 16 Berchem TOT
54,Posthofbrug 5366,2020-07-02,10:00:00,124,91,33,FMN GV 16 Berchem TOT
54,Posthofbrug 5366,2020-07-02,11:00:00,111,67,44,FMN GV 16 Berchem TOT
54,Posthofbrug 5366,2020-07-02,12:00:00,139,77,62,FMN GV 16 Berchem TOT
54,Posthofbrug 5366,2020-07-02,13:00:00,145,74,71,FMN GV 16 Berchem TOT
54,Posthofbrug 5366,2020-07-02,14:00:00,177,86,91,FMN GV 16 Berchem TOT
54,Posthofbrug 5366,2020-07-02,15:00:00,208,92,116,FMN GV 16 Berchem TOT
54,Posthofbrug 5366,2020-07-02,16:00:00,254,92,162,FMN GV 16 Berchem TOT
54,Posthofbrug 5366,2020-07-02,17:00:00,392,134,258,FMN GV 16 Berchem TOT
54,Posthofbrug 5366,2020-07-02,18:00:00,305,112,193,FMN GV 16 Berchem TOT
54,Posthofbrug 5366,2020-07-02,19:00:00,168,75,93,FMN GV 16 Berchem TOT
54,Posthofbrug 5366,2020-07-02,20:00:00,122,68,54,FMN GV 16 Berchem TOT
54,Posthofbrug 5366,2020-07-02,21:00:00,108,45,63,FMN GV 16 Berchem TOT
54,Posthofbrug 5366,2020-07-02,22:00:00,107,40,67,FMN GV 16 Berchem TOT
54,Posthofbrug 5366,2020-07-02,23:00:00,66,32,34,FMN GV 16 Berchem TOT
54,Posthofbrug 5366,2020-07-03,00:00:00,56,17,39,FMN GV 16 Berchem TOT
54,Posthofbrug 5366,2020-07-03,01:00:00,19,2,17,FMN GV 16 Berchem TOT
54,Posthofbrug 5366,2020-07-03,02:00:00,11,2,9,FMN GV 16 Berchem TOT
54,Posthofbrug 5366,2020-07-03,03:00:00,6,3,3,FMN GV 16 Berchem TOT
54,Posthofbrug 5366,2020-07-03,04:00:00,11,5,6,FMN GV 16 Berchem TOT
54,Posthofbrug 5366,2020-07-03,05:00:00,25,17,8,FMN GV 16 Berchem TOT
54,Posthofbrug 5366,2020-07-03,06:00:00,93,72,21,FMN GV 16 Berchem TOT
54,Posthofbrug 5366,2020-07-03,07:00:00,186,126,60,FMN GV 16 Berchem TOT
54,Posthofbrug 5366,2020-07-03,08:00:00,296,219,77,FMN GV 16 Berchem TOT
54,Posthofbrug 5366,2020-07-03,09:00:00,204,152,52,FMN GV 16 Berchem TOT
54,Posthofbrug 5366,2020-07-03,10:00:00,121,78,43,FMN GV 16 Berchem TOT
54,Posthofbrug 5366,2020-07-03,11:00:00,144,85,59,FMN GV 16 Berchem TOT
54,Posthofbrug 5366,2020-07-03,12:00:00,162,83,79,FMN GV 16 Berchem TOT
54,Posthofbrug 5366,2020-07-03,13:00:00,168,91,77,FMN GV 16 Berchem TOT
54,Posthofbrug 5366,2020-07-03,14:00:00,200,82,118,FMN GV 16 Berchem TOT
54,Posthofbrug 5366,2020-07-03,15:00:00,225,96,129,FMN GV 16 Berchem TOT
54,Posthofbrug 5366,2020-07-03,16:00:00,304,119,185,FMN GV 16 Berchem TOT
54,Posthofbrug 5366,2020-07-03,17:00:00,327,139,188,FMN GV 16 Berchem TOT
54,Posthofbrug 5366,2020-07-03,18:00:00,264,133,131,FMN GV 16 Berchem TOT
54,Posthofbrug 5366,2020-07-03,19:00:00,227,126,101,FMN GV 16 Berchem TOT
54,Posthofbrug 5366,2020-07-03,20:00:00,125,62,63,FMN GV 16 Berchem TOT
54,Posthofbrug 5366,2020-07-03,21:00:00,92,31,61,FMN GV 16 Berchem TOT
54,Posthofbrug 5366,2020-07-03,22:00:00,80,45,35,FMN GV 16 Berchem TOT
54,Posthofbrug 5366,2020-07-03,23:00:00,73,20,53,FMN GV 16 Berchem TOT
54,Posthofbrug 5366,2020-07-04,00:00:00,74,17,57,FMN GV 16 Berchem TOT
54,Posthofbrug 5366,2020-07-04,01:00:00,67,21,46,FMN GV 16 Berchem TOT
54,Posthofbrug 5366,2020-07-04,02:00:00,20,11,9,FMN GV 16 Berchem TOT
54,Posthofbrug 5366,2020-07-04,03:00:00,17,5,12,FMN GV 16 Berchem TOT
54,Posthofbrug 5366,2020-07-04,04:00:00,12,3,9,FMN GV 16 Berchem TOT
54,Posthofbrug 5366,2020-07-04,05:00:00,13,6,7,FMN GV 16 Berchem TOT
54,Posthofbrug 5366,2020-07-04,06:00:00,19,11,8,FMN GV 16 Berchem TOT
54,Posthofbrug 5366,2020-07-04,07:00:00,25,11,14,FMN GV 16 Berchem TOT
54,Posthofbrug 5366,2020-07-04,08:00:00,37,26,11,FMN GV 16 Berchem TOT
54,Posthofbrug 5366,2020-07-04,09:00:00,68,42,26,FMN GV 16 Berchem TOT
54,Posthofbrug 5366,2020-07-04,10:00:00,90,55,35,FMN GV 16 Berchem TOT
54,Posthofbrug 5366,2020-07-04,11:00:00,99,65,34,FMN GV 16 Berchem TOT
54,Posthofbrug 5366,2020-07-04,12:00:00,121,58,63,FMN GV 16 Berchem TOT
54,Posthofbrug 5366,2020-07-04,13:00:00,132,86,46,FMN GV 16 Berchem TOT
54,Posthofbrug 5366,2020-07-04,14:00:00,119,64,55,FMN GV 16 Berchem TOT
54,Posthofbrug 5366,2020-07-04,15:00:00,107,49,58,FMN GV 16 Berchem TOT
54,Posthofbrug 5366,2020-07-04,16:00:00,134,57,77,FMN GV 16 Berchem TOT
54,Posthofbrug 5366,2020-07-04,17:00:00,121,51,70,FMN GV 16 Berchem TOT
54,Posthofbrug 5366,2020-07-04,18:00:00,106,57,49,FMN GV 16 Berchem TOT
54,Posthofbrug 5366,2020-07-04,19:00:00,79,45,34,FMN GV 16 Berchem TOT
54,Posthofbrug 5366,2020-07-04,20:00:00,45,23,22,FMN GV 16 Berchem TOT
54,Posthofbrug 5366,2020-07-04,21:00:00,43,21,22,FMN GV 16 Berchem TOT
54,Posthofbrug 5366,2020-07-04,22:00:00,48,19,29,FMN GV 16 Berchem TOT
54,Posthofbrug 5366,2020-07-04,23:00:00,47,9,38,FMN GV 16 Berchem TOT
54,Posthofbrug 5366,2020-07-05,00:00:00,38,10,28,FMN GV 16 Berchem TOT
54,Posthofbrug 5366,2020-07-05,01:00:00,44,10,34,FMN GV 16 Berchem TOT
54,Posthofbrug 5366,2020-07-05,02:00:00,13,5,8,FMN GV 16 Berchem TOT
54,Posthofbrug 5366,2020-07-05,03:00:00,17,10,7,FMN GV 16 Berchem TOT
54,Posthofbrug 5366,2020-07-05,04:00:00,6,3,3,FMN GV 16 Berchem TOT
54,Posthofbrug 5366,2020-07-05,05:00:00,5,3,2,FMN GV 16 Berchem TOT
54,Posthofbrug 5366,2020-07-05,06:00:00,21,17,4,FMN GV 16 Berchem TOT
54,Posthofbrug 5366,2020-07-05,07:00:00,21,13,8,FMN GV 16 Berchem TOT
54,Posthofbrug 5366,2020-07-05,08:00:00,35,16,19,FMN GV 16 Berchem TOT
54,Posthofbrug 5366,2020-07-05,09:00:00,111,43,68,FMN GV 16 Berchem TOT
54,Posthofbrug 5366,2020-07-05,10:00:00,78,59,19,FMN GV 16 Berchem TOT
54,Posthofbrug 5366,2020-07-05,11:00:00,89,49,40,FMN GV 16 Berchem TOT
54,Posthofbrug 5366,2020-07-05,12:00:00,92,53,39,FMN GV 16 Berchem TOT
54,Posthofbrug 5366,2020-07-05,13:00:00,118,64,54,FMN GV 16 Berchem TOT
54,Posthofbrug 5366,2020-07-05,14:00:00,141,88,53,FMN GV 16 Berchem TOT
54,Posthofbrug 5366,2020-07-05,15:00:00,148,88,60,FMN GV 16 Berchem TOT
54,Posthofbrug 5366,2020-07-05,16:00:00,137,69,68,FMN GV 16 Berchem TOT
54,Posthofbrug 5366,2020-07-05,17:00:00,155,55,100,FMN GV 16 Berchem TOT
54,Posthofbrug 5366,2020-07-05,18:00:00,121,65,56,FMN GV 16 Berchem TOT
54,Posthofbrug 5366,2020-07-05,19:00:00,88,54,34,FMN GV 16 Berchem TOT
54,Posthofbrug 5366,2020-07-05,20:00:00,83,44,39,FMN GV 16 Berchem TOT
54,Posthofbrug 5366,2020-07-05,21:00:00,67,36,31,FMN GV 16 Berchem TOT
54,Posthofbrug 5366,2020-07-05,22:00:00,51,26,25,FMN GV 16 Berchem TOT
54,Posthofbrug 5366,2020-07-05,23:00:00,33,13,20,FMN GV 16 Berchem TOT
54,Posthofbrug 5366,2020-07-06,00:00:00,15,6,9,FMN GV 16 Berchem TOT
54,Posthofbrug 5366,2020-07-06,01:00:00,5,0,5,FMN GV 16 Berchem TOT
54,Posthofbrug 5366,2020-07-06,02:00:00,5,1,4,FMN GV 16 Berchem TOT
54,Posthofbrug 5366,2020-07-06,03:00:00,6,4,2,FMN GV 16 Berchem TOT
54,Posthofbrug 5366,2020-07-06,04:00:00,7,4,3,FMN GV 16 Berchem TOT
54,Posthofbrug 5366,2020-07-06,05:00:00,16,12,4,FMN GV 16 Berchem TOT
54,Posthofbrug 5366,2020-07-06,06:00:00,77,65,12,FMN GV 16 Berchem TOT
54,Posthofbrug 5366,2020-07-06,07:00:00,208,151,57,FMN GV 16 Berchem TOT
54,Posthofbrug 5366,2020-07-06,08:00:00,373,279,94,FMN GV 16 Berchem TOT
54,Posthofbrug 5366,2020-07-06,09:00:00,179,127,52,FMN GV 16 Berchem TOT
54,Posthofbrug 5366,2020-07-06,10:00:00,104,69,35,FMN GV 16 Berchem TOT
54,Posthofbrug 5366,2020-07-06,11:00:00,98,56,42,FMN GV 16 Berchem TOT
54,Posthofbrug 5366,2020-07-06,12:00:00,110,55,55,FMN GV 16 Berchem TOT
54,Posthofbrug 5366,2020-07-06,13:00:00,118,77,41,FMN GV 16 Berchem TOT
54,Posthofbrug 5366,2020-07-06,14:00:00,103,50,53,FMN GV 16 Berchem TOT
54,Posthofbrug 5366,2020-07-06,15:00:00,175,54,121,FMN GV 16 Berchem TOT
54,Posthofbrug 5366,2020-07-06,16:00:00,252,110,142,FMN GV 16 Berchem TOT
54,Posthofbrug 5366,2020-07-06,17:00:00,369,118,251,FMN GV 16 Berchem TOT
54,Posthofbrug 5366,2020-07-06,18:00:00,252,74,178,FMN GV 16 Berchem TOT
54,Posthofbrug 5366,2020-07-06,19:00:00,178,77,101,FMN GV 16 Berchem TOT
54,Posthofbrug 5366,2020-07-06,20:00:00,71,38,33,FMN GV 16 Berchem TOT
54,Posthofbrug 5366,2020-07-06,21:00:00,71,28,43,FMN GV 16 Berchem TOT
54,Posthofbrug 5366,2020-07-06,22:00:00,52,21,31,FMN GV 16 Berchem TOT
54,Posthofbrug 5366,2020-07-06,23:00:00,37,13,24,FMN GV 16 Berchem TOT
54,Posthofbrug 5366,2020-07-07,00:00:00,19,6,13,FMN GV 16 Berchem TOT
54,Posthofbrug 5366,2020-07-07,01:00:00,6,2,4,FMN GV 16 Berchem TOT
54,Posthofbrug 5366,2020-07-07,02:00:00,10,2,8,FMN GV 16 Berchem TOT
54,Posthofbrug 5366,2020-07-07,03:00:00,4,2,2,FMN GV 16 Berchem TOT
54,Posthofbrug 5366,2020-07-07,04:00:00,10,7,3,FMN GV 16 Berchem TOT
54,Posthofbrug 5366,2020-07-07,05:00:00,31,22,9,FMN GV 16 Berchem TOT
54,Posthofbrug 5366,2020-07-07,06:00:00,73,59,14,FMN GV 16 Berchem TOT
54,Posthofbrug 5366,2020-07-07,07:00:00,261,186,75,FMN GV 16 Berchem TOT
54,Posthofbrug 5366,2020-07-07,08:00:00,375,278,97,FMN GV 16 Berchem TOT
54,Posthofbrug 5366,2020-07-07,09:00:00,193,140,53,FMN GV 16 Berchem TOT
54,Posthofbrug 5366,2020-07-07,10:00:00,147,99,48,FMN GV 16 Berchem TOT
54,Posthofbrug 5366,2020-07-07,11:00:00,119,76,43,FMN GV 16 Berchem TOT
54,Posthofbrug 5366,2020-07-07,12:00:00,140,82,58,FMN GV 16 Berchem TOT
54,Posthofbrug 5366,2020-07-07,13:00:00,154,78,76,FMN GV 16 Berchem TOT
54,Posthofbrug 5366,2020-07-07,14:00:00,166,86,80,FMN GV 16 Berchem TOT
54,Posthofbrug 5366,2020-07-07,15:00:00,192,98,94,FMN GV 16 Berchem TOT
54,Posthofbrug 5366,2020-07-07,16:00:00,301,110,191,FMN GV 16 Berchem TOT
54,Posthofbrug 5366,2020-07-07,17:00:00,414,134,280,FMN GV 16 Berchem TOT
54,Posthofbrug 5366,2020-07-07,18:00:00,326,113,213,FMN GV 16 Berchem TOT
54,Posthofbrug 5366,2020-07-07,19:00:00,189,90,99,FMN GV 16 Berchem TOT
54,Posthofbrug 5366,2020-07-07,20:00:00,121,55,66,FMN GV 16 Berchem TOT
54,Posthofbrug 5366,2020-07-07,21:00:00,132,78,54,FMN GV 16 Berchem TOT
54,Posthofbrug 5366,2020-07-07,22:00:00,95,42,53,FMN GV 16 Berchem TOT
54,Posthofbrug 5366,2020-07-07,23:00:00,59,33,26,FMN GV 16 Berchem TOT
54,Posthofbrug 5366,2020-07-08,00:00:00,25,15,10,FMN GV 16 Berchem TOT
54,Posthofbrug 5366,2020-07-08,01:00:00,12,2,10,FMN GV 16 Berchem TOT
54,Posthofbrug 5366,2020-07-08,02:00:00,5,1,4,FMN GV 16 Berchem TOT
54,Posthofbrug 5366,2020-07-08,03:00:00,5,3,2,FMN GV 16 Berchem TOT
54,Posthofbrug 5366,2020-07-08,04:00:00,8,7,1,FMN GV 16 Berchem TOT
54,Posthofbrug 5366,2020-07-08,05:00:00,27,23,4,FMN GV 16 Berchem TOT
54,Posthofbrug 5366,2020-07-08,06:00:00,54,46,8,FMN GV 16 Berchem TOT
54,Posthofbrug 5366,2020-07-08,07:00:00,151,99,52,FMN GV 16 Berchem TOT
54,Posthofbrug 5366,2020-07-08,08:00:00,215,143,72,FMN GV 16 Berchem TOT
54,Posthofbrug 5366,2020-07-08,09:00:00,111,74,37,FMN GV 16 Berchem TOT
54,Posthofbrug 5366,2020-07-08,10:00:00,47,29,18,FMN GV 16 Berchem TOT
54,Posthofbrug 5366,2020-07-08,11:00:00,74,58,16,FMN GV 16 Berchem TOT
54,Posthofbrug 5366,2020-07-08,12:00:00,71,38,33,FMN GV 16 Berchem TOT
54,Posthofbrug 5366,2020-07-08,13:00:00,65,33,32,FMN GV 16 Berchem TOT
54,Posthofbrug 5366,2020-07-08,14:00:00,77,35,42,FMN GV 16 Berchem TOT
54,Posthofbrug 5366,2020-07-08,15:00:00,84,37,47,FMN GV 16 Berchem TOT
54,Posthofbrug 5366,2020-07-08,16:00:00,136,69,67,FMN GV 16 Berchem TOT
54,Posthofbrug 5366,2020-07-08,17:00:00,210,77,133,FMN GV 16 Berchem TOT
54,Posthofbrug 5366,2020-07-08,18:00:00,174,61,113,FMN GV 16 Berchem TOT
54,Posthofbrug 5366,2020-07-08,19:00:00,81,37,44,FMN GV 16 Berchem TOT
54,Posthofbrug 5366,2020-07-08,20:00:00,64,38,26,FMN GV 16 Berchem TOT
54,Posthofbrug 5366,2020-07-08,21:00:00,45,27,18,FMN GV 16 Berchem TOT
54,Posthofbrug 5366,2020-07-08,22:00:00,53,22,31,FMN GV 16 Berchem TOT
54,Posthofbrug 5366,2020-07-08,23:00:00,32,11,21,FMN GV 16 Berchem TOT
54,Posthofbrug 5366,2020-07-09,00:00:00,15,4,11,FMN GV 16 Berchem TOT
54,Posthofbrug 5366,2020-07-09,01:00:00,21,1,20,FMN GV 16 Berchem TOT
54,Posthofbrug 5366,2020-07-09,02:00:00,0,0,0,FMN GV 16 Berchem TOT
54,Posthofbrug 5366,2020-07-09,03:00:00,5,4,1,FMN GV 16 Berchem TOT
54,Posthofbrug 5366,2020-07-09,04:00:00,12,8,4,FMN GV 16 Berchem TOT
54,Posthofbrug 5366,2020-07-09,05:00:00,23,20,3,FMN GV 16 Berchem TOT
54,Posthofbrug 5366,2020-07-09,06:00:00,69,56,13,FMN GV 16 Berchem TOT
54,Posthofbrug 5366,2020-07-09,07:00:00,177,122,55,FMN GV 16 Berchem TOT
54,Posthofbrug 5366,2020-07-09,08:00:00,330,226,104,FMN GV 16 Berchem TOT
54,Posthofbrug 5366,2020-07-09,09:00:00,141,105,36,FMN GV 16 Berchem TOT
54,Posthofbrug 5366,2020-07-09,10:00:00,60,39,21,FMN GV 16 Berchem TOT
54,Posthofbrug 5366,2020-07-09,11:00:00,86,48,38,FMN GV 16 Berchem TOT
54,Posthofbrug 5366,2020-07-09,12:00:00,110,66,44,FMN GV 16 Berchem TOT
54,Posthofbrug 5366,2020-07-09,13:00:00,117,70,47,FMN GV 16 Berchem TOT
54,Posthofbrug 5366,2020-07-09,14:00:00,97,47,50,FMN GV 16 Berchem TOT
54,Posthofbrug 5366,2020-07-09,15:00:00,132,59,73,FMN GV 16 Berchem TOT
54,Posthofbrug 5366,2020-07-09,16:00:00,234,94,140,FMN GV 16 Berchem TOT
54,Posthofbrug 5366,2020-07-09,17:00:00,313,120,193,FMN GV 16 Berchem TOT
54,Posthofbrug 5366,2020-07-09,18:00:00,297,111,186,FMN GV 16 Berchem TOT
54,Posthofbrug 5366,2020-07-09,19:00:00,163,71,92,FMN GV 16 Berchem TOT
54,Posthofbrug 5366,2020-07-09,20:00:00,107,54,53,FMN GV 16 Berchem TOT
54,Posthofbrug 5366,2020-07-09,21:00:00,92,46,46,FMN GV 16 Berchem TOT
54,Posthofbrug 5366,2020-07-09,22:00:00,66,28,38,FMN GV 16 Berchem TOT
54,Posthofbrug 5366,2020-07-09,23:00:00,52,13,39,FMN GV 16 Berchem TOT
54,Posthofbrug 5366,2020-07-10,00:00:00,48,13,35,FMN GV 16 Berchem TOT
54,Posthofbrug 5366,2020-07-10,01:00:00,24,5,19,FMN GV 16 Berchem TOT
54,Posthofbrug 5366,2020-07-10,02:00:00,15,6,9,FMN GV 16 Berchem TOT
54,Posthofbrug 5366,2020-07-10,03:00:00,5,5,0,FMN GV 16 Berchem TOT
54,Posthofbrug 5366,2020-07-10,04:00:00,15,9,6,FMN GV 16 Berchem TOT
54,Posthofbrug 5366,2020-07-10,05:00:00,21,18,3,FMN GV 16 Berchem TOT
54,Posthofbrug 5366,2020-07-10,06:00:00,71,54,17,FMN GV 16 Berchem TOT
54,Posthofbrug 5366,2020-07-10,07:00:00,148,96,52,FMN GV 16 Berchem TOT
54,Posthofbrug 5366,2020-07-10,08:00:00,223,161,62,FMN GV 16 Berchem TOT
54,Posthofbrug 5366,2020-07-10,09:00:00,133,99,34,FMN GV 16 Berchem TOT
54,Posthofbrug 5366,2020-07-10,10:00:00,70,52,18,FMN GV 16 Berchem TOT
54,Posthofbrug 5366,2020-07-10,11:00:00,93,53,40,FMN GV 16 Berchem TOT
54,Posthofbrug 5366,2020-07-10,12:00:00,100,55,45,FMN GV 16 Berchem TOT
54,Posthofbrug 5366,2020-07-10,13:00:00,138,69,69,FMN GV 16 Berchem TOT
54,Posthofbrug 5366,2020-07-10,14:00:00,129,57,72,FMN GV 16 Berchem TOT
54,Posthofbrug 5366,2020-07-10,15:00:00,175,65,110,FMN GV 16 Berchem TOT
54,Posthofbrug 5366,2020-07-10,16:00:00,241,116,125,FMN GV 16 Berchem TOT
54,Posthofbrug 5366,2020-07-10,17:00:00,249,101,148,FMN GV 16 Berchem TOT
54,Posthofbrug 5366,2020-07-10,18:00:00,226,100,126,FMN GV 16 Berchem TOT
54,Posthofbrug 5366,2020-07-10,19:00:00,153,83,70,FMN GV 16 Berchem TOT
54,Posthofbrug 5366,2020-07-10,20:00:00,95,52,43,FMN GV 16 Berchem TOT
54,Posthofbrug 5366,2020-07-10,21:00:00,93,48,45,FMN GV 16 Berchem TOT
54,Posthofbrug 5366,2020-07-10,22:00:00,74,27,47,FMN GV 16 Berchem TOT
54,Posthofbrug 5366,2020-07-10,23:00:00,62,16,46,FMN GV 16 Berchem TOT
54,Posthofbrug 5366,2020-07-11,00:00:00,49,15,34,FMN GV 16 Berchem TOT
54,Posthofbrug 5366,2020-07-11,01:00:00,38,16,22,FMN GV 16 Berchem TOT
54,Posthofbrug 5366,2020-07-11,02:00:00,17,8,9,FMN GV 16 Berchem TOT
54,Posthofbrug 5366,2020-07-11,03:00:00,15,3,12,FMN GV 16 Berchem TOT
54,Posthofbrug 5366,2020-07-11,04:00:00,12,9,3,FMN GV 16 Berchem TOT
54,Posthofbrug 5366,2020-07-11,05:00:00,19,8,11,FMN GV 16 Berchem TOT
54,Posthofbrug 5366,2020-07-11,06:00:00,12,9,3,FMN GV 16 Berchem TOT
54,Posthofbrug 5366,2020-07-11,07:00:00,33,16,17,FMN GV 16 Berchem TOT
54,Posthofbrug 5366,2020-07-11,08:00:00,67,36,31,FMN GV 16 Berchem TOT
54,Posthofbrug 5366,2020-07-11,09:00:00,100,58,42,FMN GV 16 Berchem TOT
54,Posthofbrug 5366,2020-07-11,10:00:00,131,85,46,FMN GV 16 Berchem TOT
54,Posthofbrug 5366,2020-07-11,11:00:00,154,83,71,FMN GV 16 Berchem TOT
54,Posthofbrug 5366,2020-07-11,12:00:00,146,88,58,FMN GV 16 Berchem TOT
54,Posthofbrug 5366,2020-07-11,13:00:00,157,82,75,FMN GV 16 Berchem TOT
54,Posthofbrug 5366,2020-07-11,14:00:00,187,108,79,FMN GV 16 Berchem TOT
54,Posthofbrug 5366,2020-07-11,15:00:00,209,120,89,FMN GV 16 Berchem TOT
54,Posthofbrug 5366,2020-07-11,16:00:00,177,100,77,FMN GV 16 Berchem TOT
54,Posthofbrug 5366,2020-07-11,17:00:00,170,76,94,FMN GV 16 Berchem TOT
54,Posthofbrug 5366,2020-07-11,18:00:00,188,104,84,FMN GV 16 Berchem TOT
54,Posthofbrug 5366,2020-07-11,19:00:00,117,52,65,FMN GV 16 Berchem TOT
54,Posthofbrug 5366,2020-07-11,20:00:00,89,54,35,FMN GV 16 Berchem TOT
54,Posthofbrug 5366,2020-07-11,21:00:00,64,19,45,FMN GV 16 Berchem TOT
54,Posthofbrug 5366,2020-07-11,22:00:00,77,35,42,FMN GV 16 Berchem TOT
54,Posthofbrug 5366,2020-07-11,23:00:00,58,22,36,FMN GV 16 Berchem TOT
54,Posthofbrug 5366,2020-07-12,00:00:00,41,22,19,FMN GV 16 Berchem TOT
54,Posthofbrug 5366,2020-07-12,01:00:00,47,17,30,FMN GV 16 Berchem TOT
54,Posthofbrug 5366,2020-07-12,02:00:00,16,9,7,FMN GV 16 Berchem TOT
54,Posthofbrug 5366,2020-07-12,03:00:00,13,4,9,FMN GV 16 Berchem TOT
54,Posthofbrug 5366,2020-07-12,04:00:00,5,4,1,FMN GV 16 Berchem TOT
54,Posthofbrug 5366,2020-07-12,05:00:00,10,5,5,FMN GV 16 Berchem TOT
54,Posthofbrug 5366,2020-07-12,06:00:00,15,13,2,FMN GV 16 Berchem TOT
54,Posthofbrug 5366,2020-07-12,07:00:00,31,18,13,FMN GV 16 Berchem TOT
54,Posthofbrug 5366,2020-07-12,08:00:00,37,19,18,FMN GV 16 Berchem TOT
54,Posthofbrug 5366,2020-07-12,09:00:00,97,57,40,FMN GV 16 Berchem TOT
54,Posthofbrug 5366,2020-07-12,10:00:00,108,64,44,FMN GV 16 Berchem TOT
54,Posthofbrug 5366,2020-07-12,11:00:00,139,76,63,FMN GV 16 Berchem TOT
54,Posthofbrug 5366,2020-07-12,12:00:00,180,110,70,FMN GV 16 Berchem TOT
54,Posthofbrug 5366,2020-07-12,13:00:00,188,113,75,FMN GV 16 Berchem TOT
54,Posthofbrug 5366,2020-07-12,14:00:00,259,143,116,FMN GV 16 Berchem TOT
54,Posthofbrug 5366,2020-07-12,15:00:00,207,87,120,FMN GV 16 Berchem TOT
54,Posthofbrug 5366,2020-07-12,16:00:00,230,113,117,FMN GV 16 Berchem TOT
54,Posthofbrug 5366,2020-07-12,17:00:00,225,101,124,FMN GV 16 Berchem TOT
54,Posthofbrug 5366,2020-07-12,18:00:00,148,68,80,FMN GV 16 Berchem TOT
54,Posthofbrug 5366,2020-07-12,19:00:00,126,66,60,FMN GV 16 Berchem TOT
54,Posthofbrug 5366,2020-07-12,20:00:00,111,43,68,FMN GV 16 Berchem TOT
54,Posthofbrug 5366,2020-07-12,21:00:00,92,36,56,FMN GV 16 Berchem TOT
54,Posthofbrug 5366,2020-07-12,22:00:00,71,45,26,FMN GV 16 Berchem TOT
54,Posthofbrug 5366,2020-07-12,23:00:00,25,7,18,FMN GV 16 Berchem TOT
54,Posthofbrug 5366,2020-07-13,00:00:00,20,6,14,FMN GV 16 Berchem TOT
54,Posthofbrug 5366,2020-07-13,01:00:00,13,5,8,FMN GV 16 Berchem TOT
54,Posthofbrug 5366,2020-07-13,02:00:00,4,1,3,FMN GV 16 Berchem TOT
54,Posthofbrug 5366,2020-07-13,03:00:00,2,0,2,FMN GV 16 Berchem TOT
54,Posthofbrug 5366,2020-07-13,04:00:00,12,7,5,FMN GV 16 Berchem TOT
54,Posthofbrug 5366,2020-07-13,05:00:00,21,16,5,FMN GV 16 Berchem TOT
54,Posthofbrug 5366,2020-07-13,06:00:00,94,73,21,FMN GV 16 Berchem TOT
54,Posthofbrug 5366,2020-07-13,07:00:00,202,139,63,FMN GV 16 Berchem TOT
54,Posthofbrug 5366,2020-07-13,08:00:00,326,238,88,FMN GV 16 Berchem TOT
54,Posthofbrug 5366,2020-07-13,09:00:00,187,143,44,FMN GV 16 Berchem TOT
54,Posthofbrug 5366,2020-07-13,10:00:00,106,57,49,FMN GV 16 Berchem TOT
54,Posthofbrug 5366,2020-07-13,11:00:00,138,104,34,FMN GV 16 Berchem TOT
54,Posthofbrug 5366,2020-07-13,12:00:00,161,86,75,FMN GV 16 Berchem TOT
54,Posthofbrug 5366,2020-07-13,13:00:00,195,122,73,FMN GV 16 Berchem TOT
54,Posthofbrug 5366,2020-07-13,14:00:00,196,92,104,FMN GV 16 Berchem TOT
54,Posthofbrug 5366,2020-07-13,15:00:00,220,104,116,FMN GV 16 Berchem TOT
54,Posthofbrug 5366,2020-07-13,16:00:00,315,123,192,FMN GV 16 Berchem TOT
54,Posthofbrug 5366,2020-07-13,17:00:00,377,125,252,FMN GV 16 Berchem TOT
54,Posthofbrug 5366,2020-07-13,18:00:00,253,89,164,FMN GV 16 Berchem TOT
54,Posthofbrug 5366,2020-07-13,19:00:00,193,79,114,FMN GV 16 Berchem TOT
54,Posthofbrug 5366,2020-07-13,20:00:00,109,53,56,FMN GV 16 Berchem TOT
54,Posthofbrug 5366,2020-07-13,21:00:00,99,49,50,FMN GV 16 Berchem TOT
54,Posthofbrug 5366,2020-07-13,22:00:00,73,28,45,FMN GV 16 Berchem TOT
54,Posthofbrug 5366,2020-07-13,23:00:00,56,16,40,FMN GV 16 Berchem TOT
54,Posthofbrug 5366,2020-07-14,00:00:00,16,8,8,FMN GV 16 Berchem TOT
54,Posthofbrug 5366,2020-07-14,01:00:00,24,2,22,FMN GV 16 Berchem TOT
54,Posthofbrug 5366,2020-07-14,02:00:00,3,1,2,FMN GV 16 Berchem TOT
54,Posthofbrug 5366,2020-07-14,03:00:00,3,0,3,FMN GV 16 Berchem TOT
54,Posthofbrug 5366,2020-07-14,04:00:00,11,5,6,FMN GV 16 Berchem TOT
54,Posthofbrug 5366,2020-07-14,05:00:00,21,18,3,FMN GV 16 Berchem TOT
54,Posthofbrug 5366,2020-07-14,06:00:00,72,59,13,FMN GV 16 Berchem TOT
54,Posthofbrug 5366,2020-07-14,07:00:00,184,124,60,FMN GV 16 Berchem TOT
54,Posthofbrug 5366,2020-07-14,08:00:00,294,212,82,FMN GV 16 Berchem TOT
54,Posthofbrug 5366,2020-07-14,09:00:00,137,96,41,FMN GV 16 Berchem TOT
54,Posthofbrug 5366,2020-07-14,10:00:00,60,48,12,FMN GV 16 Berchem TOT
54,Posthofbrug 5366,2020-07-14,11:00:00,81,46,35,FMN GV 16 Berchem TOT
54,Posthofbrug 5366,2020-07-14,12:00:00,72,54,18,FMN GV 16 Berchem TOT
54,Posthofbrug 5366,2020-07-14,13:00:00,88,45,43,FMN GV 16 Berchem TOT
54,Posthofbrug 5366,2020-07-14,14:00:00,53,23,30,FMN GV 16 Berchem TOT
54,Posthofbrug 5366,2020-07-14,15:00:00,117,51,66,FMN GV 16 Berchem TOT
54,Posthofbrug 5366,2020-07-14,16:00:00,212,72,140,FMN GV 16 Berchem TOT
54,Posthofbrug 5366,2020-07-14,17:00:00,276,99,177,FMN GV 16 Berchem TOT
54,Posthofbrug 5366,2020-07-14,18:00:00,198,85,113,FMN GV 16 Berchem TOT
54,Posthofbrug 5366,2020-07-14,19:00:00,114,49,65,FMN GV 16 Berchem TOT
54,Posthofbrug 5366,2020-07-14,20:00:00,66,17,49,FMN GV 16 Berchem TOT
54,Posthofbrug 5366,2020-07-14,21:00:00,61,29,32,FMN GV 16 Berchem TOT
54,Posthofbrug 5366,2020-07-14,22:00:00,64,39,25,FMN GV 16 Berchem TOT
54,Posthofbrug 5366,2020-07-14,23:00:00,31,9,22,FMN GV 16 Berchem TOT
54,Posthofbrug 5366,2020-07-15,00:00:00,19,8,11,FMN GV 16 Berchem TOT
54,Posthofbrug 5366,2020-07-15,01:00:00,8,1,7,FMN GV 16 Berchem TOT
54,Posthofbrug 5366,2020-07-15,02:00:00,4,2,2,FMN GV 16 Berchem TOT
54,Posthofbrug 5366,2020-07-15,03:00:00,4,2,2,FMN GV 16 Berchem TOT
54,Posthofbrug 5366,2020-07-15,04:00:00,7,5,2,FMN GV 16 Berchem TOT
54,Posthofbrug 5366,2020-07-15,05:00:00,19,17,2,FMN GV 16 Berchem TOT
54,Posthofbrug 5366,2020-07-15,06:00:00,80,61,19,FMN GV 16 Berchem TOT
54,Posthofbrug 5366,2020-07-15,07:00:00,208,137,71,FMN GV 16 Berchem TOT
54,Posthofbrug 5366,2020-07-15,08:00:00,290,198,92,FMN GV 16 Berchem TOT
54,Posthofbrug 5366,2020-07-15,09:00:00,167,128,39,FMN GV 16 Berchem TOT
54,Posthofbrug 5366,2020-07-15,10:00:00,144,86,58,FMN GV 16 Berchem TOT
54,Posthofbrug 5366,2020-07-15,11:00:00,139,86,53,FMN GV 16 Berchem TOT
54,Posthofbrug 5366,2020-07-15,12:00:00,166,92,74,FMN GV 16 Berchem TOT
54,Posthofbrug 5366,2020-07-15,13:00:00,131,79,52,FMN GV 16 Berchem TOT
54,Posthofbrug 5366,2020-07-15,14:00:00,156,80,76,FMN GV 16 Berchem TOT
54,Posthofbrug 5366,2020-07-15,15:00:00,159,73,86,FMN GV 16 Berchem TOT
54,Posthofbrug 5366,2020-07-15,16:00:00,261,97,164,FMN GV 16 Berchem TOT
54,Posthofbrug 5366,2020-07-15,17:00:00,276,98,178,FMN GV 16 Berchem TOT
54,Posthofbrug 5366,2020-07-15,18:00:00,245,96,149,FMN GV 16 Berchem TOT
54,Posthofbrug 5366,2020-07-15,19:00:00,159,62,97,FMN GV 16 Berchem TOT
54,Posthofbrug 5366,2020-07-15,20:00:00,116,66,50,FMN GV 16 Berchem TOT
54,Posthofbrug 5366,2020-07-15,21:00:00,72,38,34,FMN GV 16 Berchem TOT
54,Posthofbrug 5366,2020-07-15,22:00:00,71,28,43,FMN GV 16 Berchem TOT
54,Posthofbrug 5366,2020-07-15,23:00:00,52,17,35,FMN GV 16 Berchem TOT
54,Posthofbrug 5366,2020-07-16,00:00:00,26,10,16,FMN GV 16 Berchem TOT
54,Posthofbrug 5366,2020-07-16,01:00:00,11,3,8,FMN GV 16 Berchem TOT
54,Posthofbrug 5366,2020-07-16,02:00:00,3,1,2,FMN GV 16 Berchem TOT
54,Posthofbrug 5366,2020-07-16,03:00:00,10,2,8,FMN GV 16 Berchem TOT
54,Posthofbrug 5366,2020-07-16,04:00:00,12,10,2,FMN GV 16 Berchem TOT
54,Posthofbrug 5366,2020-07-16,05:00:00,15,12,3,FMN GV 16 Berchem TOT
54,Posthofbrug 5366,2020-07-16,06:00:00,69,49,20,FMN GV 16 Berchem TOT
54,Posthofbrug 5366,2020-07-16,07:00:00,159,114,45,FMN GV 16 Berchem TOT
54,Posthofbrug 5366,2020-07-16,08:00:00,273,191,82,FMN GV 16 Berchem TOT
54,Posthofbrug 5366,2020-07-16,09:00:00,112,83,29,FMN GV 16 Berchem TOT
54,Posthofbrug 5366,2020-07-16,10:00:00,60,39,21,FMN GV 16 Berchem TOT
54,Posthofbrug 5366,2020-07-16,11:00:00,67,40,27,FMN GV 16 Berchem TOT
54,Posthofbrug 5366,2020-07-16,12:00:00,73,42,31,FMN GV 16 Berchem TOT
54,Posthofbrug 5366,2020-07-16,13:00:00,92,61,31,FMN GV 16 Berchem TOT
54,Posthofbrug 5366,2020-07-16,14:00:00,77,28,49,FMN GV 16 Berchem TOT
54,Posthofbrug 5366,2020-07-16,15:00:00,109,53,56,FMN GV 16 Berchem TOT
54,Posthofbrug 5366,2020-07-16,16:00:00,196,78,118,FMN GV 16 Berchem TOT
54,Posthofbrug 5366,2020-07-16,17:00:00,274,107,167,FMN GV 16 Berchem TOT
54,Posthofbrug 5366,2020-07-16,18:00:00,177,75,102,FMN GV 16 Berchem TOT
54,Posthofbrug 5366,2020-07-16,19:00:00,121,50,71,FMN GV 16 Berchem TOT
54,Posthofbrug 5366,2020-07-16,20:00:00,91,46,45,FMN GV 16 Berchem TOT
54,Posthofbrug 5366,2020-07-16,21:00:00,89,47,42,FMN GV 16 Berchem TOT
54,Posthofbrug 5366,2020-07-16,22:00:00,56,23,33,FMN GV 16 Berchem TOT
54,Posthofbrug 5366,2020-07-16,23:00:00,52,15,37,FMN GV 16 Berchem TOT
54,Posthofbrug 5366,2020-07-17,00:00:00,38,11,27,FMN GV 16 Berchem TOT
54,Posthofbrug 5366,2020-07-17,01:00:00,16,3,13,FMN GV 16 Berchem TOT
54,Posthofbrug 5366,2020-07-17,02:00:00,9,1,8,FMN GV 16 Berchem TOT
54,Posthofbrug 5366,2020-07-17,03:00:00,4,3,1,FMN GV 16 Berchem TOT
54,Posthofbrug 5366,2020-07-17,04:00:00,11,9,2,FMN GV 16 Berchem TOT
54,Posthofbrug 5366,2020-07-17,05:00:00,15,13,2,FMN GV 16 Berchem TOT
54,Posthofbrug 5366,2020-07-17,06:00:00,75,59,16,FMN GV 16 Berchem TOT
54,Posthofbrug 5366,2020-07-17,07:00:00,135,91,44,FMN GV 16 Berchem TOT
54,Posthofbrug 5366,2020-07-17,08:00:00,217,144,73,FMN GV 16 Berchem TOT
54,Posthofbrug 5366,2020-07-17,09:00:00,149,113,36,FMN GV 16 Berchem TOT
54,Posthofbrug 5366,2020-07-17,10:00:00,108,73,35,FMN GV 16 Berchem TOT
54,Posthofbrug 5366,2020-07-17,11:00:00,114,73,41,FMN GV 16 Berchem TOT
54,Posthofbrug 5366,2020-07-17,12:00:00,126,68,58,FMN GV 16 Berchem TOT
54,Posthofbrug 5366,2020-07-17,13:00:00,137,88,49,FMN GV 16 Berchem TOT
54,Posthofbrug 5366,2020-07-17,14:00:00,134,62,72,FMN GV 16 Berchem TOT
54,Posthofbrug 5366,2020-07-17,15:00:00,173,68,105,FMN GV 16 Berchem TOT
54,Posthofbrug 5366,2020-07-17,16:00:00,232,82,150,FMN GV 16 Berchem TOT
54,Posthofbrug 5366,2020-07-17,17:00:00,299,118,181,FMN GV 16 Berchem TOT
54,Posthofbrug 5366,2020-07-17,18:00:00,214,111,103,FMN GV 16 Berchem TOT
54,Posthofbrug 5366,2020-07-17,19:00:00,133,48,85,FMN GV 16 Berchem TOT
54,Posthofbrug 5366,2020-07-17,20:00:00,91,55,36,FMN GV 16 Berchem TOT
54,Posthofbrug 5366,2020-07-17,21:00:00,84,31,53,FMN GV 16 Berchem TOT
54,Posthofbrug 5366,2020-07-17,22:00:00,70,23,47,FMN GV 16 Berchem TOT
54,Posthofbrug 5366,2020-07-17,23:00:00,62,24,38,FMN GV 16 Berchem TOT
54,Posthofbrug 5366,2020-07-18,00:00:00,58,17,41,FMN GV 16 Berchem TOT
54,Posthofbrug 5366,2020-07-18,01:00:00,45,14,31,FMN GV 16 Berchem TOT
54,Posthofbrug 5366,2020-07-18,02:00:00,14,3,11,FMN GV 16 Berchem TOT
54,Posthofbrug 5366,2020-07-18,03:00:00,8,3,5,FMN GV 16 Berchem TOT
54,Posthofbrug 5366,2020-07-18,04:00:00,14,6,8,FMN GV 16 Berchem TOT
54,Posthofbrug 5366,2020-07-18,05:00:00,6,2,4,FMN GV 16 Berchem TOT
54,Posthofbrug 5366,2020-07-18,06:00:00,17,9,8,FMN GV 16 Berchem TOT
54,Posthofbrug 5366,2020-07-18,07:00:00,35,23,12,FMN GV 16 Berchem TOT
54,Posthofbrug 5366,2020-07-18,08:00:00,56,42,14,FMN GV 16 Berchem TOT
54,Posthofbrug 5366,2020-07-18,09:00:00,79,52,27,FMN GV 16 Berchem TOT
54,Posthofbrug 5366,2020-07-18,10:00:00,132,72,60,FMN GV 16 Berchem TOT
54,Posthofbrug 5366,2020-07-18,11:00:00,146,92,54,FMN GV 16 Berchem TOT
54,Posthofbrug 5366,2020-07-18,12:00:00,145,84,61,FMN GV 16 Berchem TOT
54,Posthofbrug 5366,2020-07-18,13:00:00,179,97,82,FMN GV 16 Berchem TOT
54,Posthofbrug 5366,2020-07-18,14:00:00,198,96,102,FMN GV 16 Berchem TOT
54,Posthofbrug 5366,2020-07-18,15:00:00,168,85,83,FMN GV 16 Berchem TOT
54,Posthofbrug 5366,2020-07-18,16:00:00,176,82,94,FMN GV 16 Berchem TOT
54,Posthofbrug 5366,2020-07-18,17:00:00,183,78,105,FMN GV 16 Berchem TOT
54,Posthofbrug 5366,2020-07-18,18:00:00,136,63,73,FMN GV 16 Berchem TOT
54,Posthofbrug 5366,2020-07-18,19:00:00,114,47,67,FMN GV 16 Berchem TOT
54,Posthofbrug 5366,2020-07-18,20:00:00,83,50,33,FMN GV 16 Berchem TOT
54,Posthofbrug 5366,2020-07-18,21:00:00,76,36,40,FMN GV 16 Berchem TOT
54,Posthofbrug 5366,2020-07-18,22:00:00,87,32,55,FMN GV 16 Berchem TOT
54,Posthofbrug 5366,2020-07-18,23:00:00,49,27,22,FMN GV 16 Berchem TOT
54,Posthofbrug 5366,2020-07-19,00:00:00,41,13,28,FMN GV 16 Berchem TOT
54,Posthofbrug 5366,2020-07-19,01:00:00,32,11,21,FMN GV 16 Berchem TOT
54,Posthofbrug 5366,2020-07-19,02:00:00,16,6,10,FMN GV 16 Berchem TOT
54,Posthofbrug 5366,2020-07-19,03:00:00,15,6,9,FMN GV 16 Berchem TOT
54,Posthofbrug 5366,2020-07-19,04:00:00,5,3,2,FMN GV 16 Berchem TOT
54,Posthofbrug 5366,2020-07-19,05:00:00,10,7,3,FMN GV 16 Berchem TOT
54,Posthofbrug 5366,2020-07-19,06:00:00,12,8,4,FMN GV 16 Berchem TOT
54,Posthofbrug 5366,2020-07-19,07:00:00,26,11,15,FMN GV 16 Berchem TOT
54,Posthofbrug 5366,2020-07-19,08:00:00,40,19,21,FMN GV 16 Berchem TOT
54,Posthofbrug 5366,2020-07-19,09:00:00,92,54,38,FMN GV 16 Berchem TOT
54,Posthofbrug 5366,2020-07-19,10:00:00,138,72,66,FMN GV 16 Berchem TOT
54,Posthofbrug 5366,2020-07-19,11:00:00,162,82,80,FMN GV 16 Berchem TOT
54,Posthofbrug 5366,2020-07-19,12:00:00,175,106,69,FMN GV 16 Berchem TOT
54,Posthofbrug 5366,2020-07-19,13:00:00,171,89,82,FMN GV 16 Berchem TOT
54,Posthofbrug 5366,2020-07-19,14:00:00,183,112,71,FMN GV 16 Berchem TOT
54,Posthofbrug 5366,2020-07-19,15:00:00,189,86,103,FMN GV 16 Berchem TOT
54,Posthofbrug 5366,2020-07-19,16:00:00,179,79,100,FMN GV 16 Berchem TOT
54,Posthofbrug 5366,2020-07-19,17:00:00,173,91,82,FMN GV 16 Berchem TOT
54,Posthofbrug 5366,2020-07-19,18:00:00,136,77,59,FMN GV 16 Berchem TOT
54,Posthofbrug 5366,2020-07-19,19:00:00,97,39,58,FMN GV 16 Berchem TOT
54,Posthofbrug 5366,2020-07-19,20:00:00,128,65,63,FMN GV 16 Berchem TOT
54,Posthofbrug 5366,2020-07-19,21:00:00,84,43,41,FMN GV 16 Berchem TOT
54,Posthofbrug 5366,2020-07-19,22:00:00,52,28,24,FMN GV 16 Berchem TOT
54,Posthofbrug 5366,2020-07-19,23:00:00,23,8,15,FMN GV 16 Berchem TOT
54,Posthofbrug 5366,2020-07-20,00:00:00,9,4,5,FMN GV 16 Berchem TOT
54,Posthofbrug 5366,2020-07-20,01:00:00,8,3,5,FMN GV 16 Berchem TOT
54,Posthofbrug 5366,2020-07-20,02:00:00,5,0,5,FMN GV 16 Berchem TOT
54,Posthofbrug 5366,2020-07-20,03:00:00,7,5,2,FMN GV 16 Berchem TOT
54,Posthofbrug 5366,2020-07-20,04:00:00,7,4,3,FMN GV 16 Berchem TOT
54,Posthofbrug 5366,2020-07-20,05:00:00,10,6,4,FMN GV 16 Berchem TOT
54,Posthofbrug 5366,2020-07-20,06:00:00,47,36,11,FMN GV 16 Berchem TOT
54,Posthofbrug 5366,2020-07-20,07:00:00,96,68,28,FMN GV 16 Berchem TOT
54,Posthofbrug 5366,2020-07-20,08:00:00,151,113,38,FMN GV 16 Berchem TOT
54,Posthofbrug 5366,2020-07-20,09:00:00,128,88,40,FMN GV 16 Berchem TOT
54,Posthofbrug 5366,2020-07-20,10:00:00,90,54,36,FMN GV 16 Berchem TOT
54,Posthofbrug 5366,2020-07-20,11:00:00,124,74,50,FMN GV 16 Berchem TOT
54,Posthofbrug 5366,2020-07-20,12:00:00,117,63,54,FMN GV 16 Berchem TOT
54,Posthofbrug 5366,2020-07-20,13:00:00,142,84,58,FMN GV 16 Berchem TOT
54,Posthofbrug 5366,2020-07-20,14:00:00,136,72,64,FMN GV 16 Berchem TOT
54,Posthofbrug 5366,2020-07-20,15:00:00,163,66,97,FMN GV 16 Berchem TOT
54,Posthofbrug 5366,2020-07-20,16:00:00,206,88,118,FMN GV 16 Berchem TOT
54,Posthofbrug 5366,2020-07-20,17:00:00,256,120,136,FMN GV 16 Berchem TOT
54,Posthofbrug 5366,2020-07-20,18:00:00,174,64,110,FMN GV 16 Berchem TOT
54,Posthofbrug 5366,2020-07-20,19:00:00,117,46,71,FMN GV 16 Berchem TOT
54,Posthofbrug 5366,2020-07-20,20:00:00,76,45,31,FMN GV 16 Berchem TOT
54,Posthofbrug 5366,2020-07-20,21:00:00,44,27,17,FMN GV 16 Berchem TOT
54,Posthofbrug 5366,2020-07-20,22:00:00,49,23,26,FMN GV 16 Berchem TOT
54,Posthofbrug 5366,2020-07-20,23:00:00,32,17,15,FMN GV 16 Berchem TOT
54,Posthofbrug 5366,2020-07-21,00:00:00,22,7,15,FMN GV 16 Berchem TOT
54,Posthofbrug 5366,2020-07-21,01:00:00,15,4,11,FMN GV 16 Berchem TOT
54,Posthofbrug 5366,2020-07-21,02:00:00,11,4,7,FMN GV 16 Berchem TOT
54,Posthofbrug 5366,2020-07-21,03:00:00,6,1,5,FMN GV 16 Berchem TOT
54,Posthofbrug 5366,2020-07-21,04:00:00,2,0,2,FMN GV 16 Berchem TOT
54,Posthofbrug 5366,2020-07-21,05:00:00,17,9,8,FMN GV 16 Berchem TOT
54,Posthofbrug 5366,2020-07-21,06:00:00,21,11,10,FMN GV 16 Berchem TOT
54,Posthofbrug 5366,2020-07-21,07:00:00,31,19,12,FMN GV 16 Berchem TOT
54,Posthofbrug 5366,2020-07-21,08:00:00,36,23,13,FMN GV 16 Berchem TOT
54,Posthofbrug 5366,2020-07-21,09:00:00,61,33,28,FMN GV 16 Berchem TOT
54,Posthofbrug 5366,2020-07-21,10:00:00,101,56,45,FMN GV 16 Berchem TOT
54,Posthofbrug 5366,2020-07-21,11:00:00,128,71,57,FMN GV 16 Berchem TOT
54,Posthofbrug 5366,2020-07-21,12:00:00,129,64,65,FMN GV 16 Berchem TOT
54,Posthofbrug 5366,2020-07-21,13:00:00,165,93,72,FMN GV 16 Berchem TOT
54,Posthofbrug 5366,2020-07-21,14:00:00,182,79,103,FMN GV 16 Berchem TOT
54,Posthofbrug 5366,2020-07-21,15:00:00,178,68,110,FMN GV 16 Berchem TOT
54,Posthofbrug 5366,2020-07-21,16:00:00,174,72,102,FMN GV 16 Berchem TOT
54,Posthofbrug 5366,2020-07-21,17:00:00,174,98,76,FMN GV 16 Berchem TOT
54,Posthofbrug 5366,2020-07-21,18:00:00,133,80,53,FMN GV 16 Berchem TOT
54,Posthofbrug 5366,2020-07-21,19:00:00,102,53,49,FMN GV 16 Berchem TOT
54,Posthofbrug 5366,2020-07-21,20:00:00,99,65,34,FMN GV 16 Berchem TOT
54,Posthofbrug 5366,2020-07-21,21:00:00,77,38,39,FMN GV 16 Berchem TOT
54,Posthofbrug 5366,2020-07-21,22:00:00,55,30,25,FMN GV 16 Berchem TOT
54,Posthofbrug 5366,2020-07-21,23:00:00,34,16,18,FMN GV 16 Berchem TOT
54,Posthofbrug 5366,2020-07-22,00:00:00,16,4,12,FMN GV 16 Berchem TOT
54,Posthofbrug 5366,2020-07-22,01:00:00,9,4,5,FMN GV 16 Berchem TOT
54,Posthofbrug 5366,2020-07-22,02:00:00,2,0,2,FMN GV 16 Berchem TOT
54,Posthofbrug 5366,2020-07-22,03:00:00,2,2,0,FMN GV 16 Berchem TOT
54,Posthofbrug 5366,2020-07-22,04:00:00,10,5,5,FMN GV 16 Berchem TOT
54,Posthofbrug 5366,2020-07-22,05:00:00,21,16,5,FMN GV 16 Berchem TOT
54,Posthofbrug 5366,2020-07-22,06:00:00,87,62,25,FMN GV 16 Berchem TOT
54,Posthofbrug 5366,2020-07-22,07:00:00,183,137,46,FMN GV 16 Berchem TOT
54,Posthofbrug 5366,2020-07-22,08:00:00,251,186,65,FMN GV 16 Berchem TOT
54,Posthofbrug 5366,2020-07-22,09:00:00,143,105,38,FMN GV 16 Berchem TOT
54,Posthofbrug 5366,2020-07-22,10:00:00,140,79,61,FMN GV 16 Berchem TOT
54,Posthofbrug 5366,2020-07-22,11:00:00,137,80,57,FMN GV 16 Berchem TOT
54,Posthofbrug 5366,2020-07-22,12:00:00,107,63,44,FMN GV 16 Berchem TOT
54,Posthofbrug 5366,2020-07-22,13:00:00,143,75,68,FMN GV 16 Berchem TOT
54,Posthofbrug 5366,2020-07-22,14:00:00,164,81,83,FMN GV 16 Berchem TOT
54,Posthofbrug 5366,2020-07-22,15:00:00,143,58,85,FMN GV 16 Berchem TOT
54,Posthofbrug 5366,2020-07-22,16:00:00,252,91,161,FMN GV 16 Berchem TOT
54,Posthofbrug 5366,2020-07-22,17:00:00,635,272,363,FMN GV 16 Berchem TOT
54,Posthofbrug 5366,2020-07-22,18:00:00,284,107,177,FMN GV 16 Berchem TOT
54,Posthofbrug 5366,2020-07-22,19:00:00,145,69,76,FMN GV 16 Berchem TOT
54,Posthofbrug 5366,2020-07-22,20:00:00,118,63,55,FMN GV 16 Berchem TOT
54,Posthofbrug 5366,2020-07-22,21:00:00,93,51,42,FMN GV 16 Berchem TOT
54,Posthofbrug 5366,2020-07-22,22:00:00,73,30,43,FMN GV 16 Berchem TOT
54,Posthofbrug 5366,2020-07-22,23:00:00,34,14,20,FMN GV 16 Berchem TOT
54,Posthofbrug 5366,2020-07-23,00:00:00,26,6,20,FMN GV 16 Berchem TOT
54,Posthofbrug 5366,2020-07-23,01:00:00,5,1,4,FMN GV 16 Berchem TOT
54,Posthofbrug 5366,2020-07-23,02:00:00,1,0,1,FMN GV 16 Berchem TOT
54,Posthofbrug 5366,2020-07-23,03:00:00,5,2,3,FMN GV 16 Berchem TOT
54,Posthofbrug 5366,2020-07-23,04:00:00,9,5,4,FMN GV 16 Berchem TOT
54,Posthofbrug 5366,2020-07-23,05:00:00,24,18,6,FMN GV 16 Berchem TOT
54,Posthofbrug 5366,2020-07-23,06:00:00,74,57,17,FMN GV 16 Berchem TOT
54,Posthofbrug 5366,2020-07-23,07:00:00,197,135,62,FMN GV 16 Berchem TOT
54,Posthofbrug 5366,2020-07-23,08:00:00,290,215,75,FMN GV 16 Berchem TOT
54,Posthofbrug 5366,2020-07-23,09:00:00,162,135,27,FMN GV 16 Berchem TOT
54,Posthofbrug 5366,2020-07-23,10:00:00,102,55,47,FMN GV 16 Berchem TOT
54,Posthofbrug 5366,2020-07-23,11:00:00,141,81,60,FMN GV 16 Berchem TOT
54,Posthofbrug 5366,2020-07-23,12:00:00,145,78,67,FMN GV 16 Berchem TOT
54,Posthofbrug 5366,2020-07-23,13:00:00,145,93,52,FMN GV 16 Berchem TOT
54,Posthofbrug 5366,2020-07-23,14:00:00,156,75,81,FMN GV 16 Berchem TOT
54,Posthofbrug 5366,2020-07-23,15:00:00,190,88,102,FMN GV 16 Berchem TOT
54,Posthofbrug 5366,2020-07-23,16:00:00,279,109,170,FMN GV 16 Berchem TOT
54,Posthofbrug 5366,2020-07-23,17:00:00,326,110,216,FMN GV 16 Berchem TOT
54,Posthofbrug 5366,2020-07-23,18:00:00,269,119,150,FMN GV 16 Berchem TOT
54,Posthofbrug 5366,2020-07-23,19:00:00,168,56,112,FMN GV 16 Berchem TOT
54,Posthofbrug 5366,2020-07-23,20:00:00,110,62,48,FMN GV 16 Berchem TOT
54,Posthofbrug 5366,2020-07-23,21:00:00,76,43,33,FMN GV 16 Berchem TOT
54,Posthofbrug 5366,2020-07-23,22:00:00,78,37,41,FMN GV 16 Berchem TOT
54,Posthofbrug 5366,2020-07-23,23:00:00,58,20,38,FMN GV 16 Berchem TOT
54,Posthofbrug 5366,2020-07-24,00:00:00,38,12,26,FMN GV 16 Berchem TOT
54,Posthofbrug 5366,2020-07-24,01:00:00,20,5,15,FMN GV 16 Berchem TOT
54,Posthofbrug 5366,2020-07-24,02:00:00,2,0,2,FMN GV 16 Berchem TOT
54,Posthofbrug 5366,2020-07-24,03:00:00,0,0,0,FMN GV 16 Berchem TOT
54,Posthofbrug 5366,2020-07-24,04:00:00,8,5,3,FMN GV 16 Berchem TOT
54,Posthofbrug 5366,2020-07-24,05:00:00,17,13,4,FMN GV 16 Berchem TOT
54,Posthofbrug 5366,2020-07-24,06:00:00,57,46,11,FMN GV 16 Berchem TOT
54,Posthofbrug 5366,2020-07-24,07:00:00,134,95,39,FMN GV 16 Berchem TOT
54,Posthofbrug 5366,2020-07-24,08:00:00,229,154,75,FMN GV 16 Berchem TOT
54,Posthofbrug 5366,2020-07-24,09:00:00,111,78,33,FMN GV 16 Berchem TOT
54,Posthofbrug 5366,2020-07-24,10:00:00,83,56,27,FMN GV 16 Berchem TOT
54,Posthofbrug 5366,2020-07-24,11:00:00,99,60,39,FMN GV 16 Berchem TOT
54,Posthofbrug 5366,2020-07-24,12:00:00,116,68,48,FMN GV 16 Berchem TOT
54,Posthofbrug 5366,2020-07-24,13:00:00,96,59,37,FMN GV 16 Berchem TOT
54,Posthofbrug 5366,2020-07-24,14:00:00,110,61,49,FMN GV 16 Berchem TOT
54,Posthofbrug 5366,2020-07-24,15:00:00,102,38,64,FMN GV 16 Berchem TOT
54,Posthofbrug 5366,2020-07-24,16:00:00,174,74,100,FMN GV 16 Berchem TOT
54,Posthofbrug 5366,2020-07-24,17:00:00,222,95,127,FMN GV 16 Berchem TOT
54,Posthofbrug 5366,2020-07-24,18:00:00,172,63,109,FMN GV 16 Berchem TOT
54,Posthofbrug 5366,2020-07-24,19:00:00,92,40,52,FMN GV 16 Berchem TOT
54,Posthofbrug 5366,2020-07-24,20:00:00,60,26,34,FMN GV 16 Berchem TOT
54,Posthofbrug 5366,2020-07-24,21:00:00,47,25,22,FMN GV 16 Berchem TOT
54,Posthofbrug 5366,2020-07-24,22:00:00,51,22,29,FMN GV 16 Berchem TOT
54,Posthofbrug 5366,2020-07-24,23:00:00,27,8,19,FMN GV 16 Berchem TOT
54,Posthofbrug 5366,2020-07-25,00:00:00,45,10,35,FMN GV 16 Berchem TOT
54,Posthofbrug 5366,2020-07-25,01:00:00,43,8,35,FMN GV 16 Berchem TOT
54,Posthofbrug 5366,2020-07-25,02:00:00,15,7,8,FMN GV 16 Berchem TOT
54,Posthofbrug 5366,2020-07-25,03:00:00,6,3,3,FMN GV 16 Berchem TOT
54,Posthofbrug 5366,2020-07-25,04:00:00,2,1,1,FMN GV 16 Berchem TOT
54,Posthofbrug 5366,2020-07-25,05:00:00,12,6,6,FMN GV 16 Berchem TOT
54,Posthofbrug 5366,2020-07-25,06:00:00,10,8,2,FMN GV 16 Berchem TOT
54,Posthofbrug 5366,2020-07-25,07:00:00,22,12,10,FMN GV 16 Berchem TOT
54,Posthofbrug 5366,2020-07-25,08:00:00,40,22,18,FMN GV 16 Berchem TOT
54,Posthofbrug 5366,2020-07-25,09:00:00,72,51,21,FMN GV 16 Berchem TOT
54,Posthofbrug 5366,2020-07-25,10:00:00,76,44,32,FMN GV 16 Berchem TOT
54,Posthofbrug 5366,2020-07-25,11:00:00,86,51,35,FMN GV 16 Berchem TOT
54,Posthofbrug 5366,2020-07-25,12:00:00,103,49,54,FMN GV 16 Berchem TOT
54,Posthofbrug 5366,2020-07-25,13:00:00,86,52,34,FMN GV 16 Berchem TOT
54,Posthofbrug 5366,2020-07-25,14:00:00,117,70,47,FMN GV 16 Berchem TOT
54,Posthofbrug 5366,2020-07-25,15:00:00,127,55,72,FMN GV 16 Berchem TOT
54,Posthofbrug 5366,2020-07-25,16:00:00,120,52,68,FMN GV 16 Berchem TOT
54,Posthofbrug 5366,2020-07-25,17:00:00,112,49,63,FMN GV 16 Berchem TOT
54,Posthofbrug 5366,2020-07-25,18:00:00,93,42,51,FMN GV 16 Berchem TOT
54,Posthofbrug 5366,2020-07-25,19:00:00,58,19,39,FMN GV 16 Berchem TOT
54,Posthofbrug 5366,2020-07-25,20:00:00,60,40,20,FMN GV 16 Berchem TOT
54,Posthofbrug 5366,2020-07-25,21:00:00,42,16,26,FMN GV 16 Berchem TOT
54,Posthofbrug 5366,2020-07-25,22:00:00,22,10,12,FMN GV 16 Berchem TOT
54,Posthofbrug 5366,2020-07-25,23:00:00,14,8,6,FMN GV 16 Berchem TOT
54,Posthofbrug 5366,2020-07-26,00:00:00,14,1,13,FMN GV 16 Berchem TOT
54,Posthofbrug 5366,2020-07-26,01:00:00,27,12,15,FMN GV 16 Berchem TOT
54,Posthofbrug 5366,2020-07-26,02:00:00,10,4,6,FMN GV 16 Berchem TOT
54,Posthofbrug 5366,2020-07-26,03:00:00,6,3,3,FMN GV 16 Berchem TOT
54,Posthofbrug 5366,2020-07-26,04:00:00,5,2,3,FMN GV 16 Berchem TOT
54,Posthofbrug 5366,2020-07-26,05:00:00,6,4,2,FMN GV 16 Berchem TOT
54,Posthofbrug 5366,2020-07-26,06:00:00,10,7,3,FMN GV 16 Berchem TOT
54,Posthofbrug 5366,2020-07-26,07:00:00,24,10,14,FMN GV 16 Berchem TOT
54,Posthofbrug 5366,2020-07-26,08:00:00,47,26,21,FMN GV 16 Berchem TOT
54,Posthofbrug 5366,2020-07-26,09:00:00,51,22,29,FMN GV 16 Berchem TOT
54,Posthofbrug 5366,2020-07-26,10:00:00,66,29,37,FMN GV 16 Berchem TOT
54,Posthofbrug 5366,2020-07-26,11:00:00,109,71,38,FMN GV 16 Berchem TOT
54,Posthofbrug 5366,2020-07-26,12:00:00,101,58,43,FMN GV 16 Berchem TOT
54,Posthofbrug 5366,2020-07-26,13:00:00,104,46,58,FMN GV 16 Berchem TOT
54,Posthofbrug 5366,2020-07-26,14:00:00,151,65,86,FMN GV 16 Berchem TOT
54,Posthofbrug 5366,2020-07-26,15:00:00,135,66,69,FMN GV 16 Berchem TOT
54,Posthofbrug 5366,2020-07-26,16:00:00,131,68,63,FMN GV 16 Berchem TOT
54,Posthofbrug 5366,2020-07-26,17:00:00,125,61,64,FMN GV 16 Berchem TOT
54,Posthofbrug 5366,2020-07-26,18:00:00,95,57,38,FMN GV 16 Berchem TOT
54,Posthofbrug 5366,2020-07-26,19:00:00,85,32,53,FMN GV 16 Berchem TOT
54,Posthofbrug 5366,2020-07-26,20:00:00,80,47,33,FMN GV 16 Berchem TOT
54,Posthofbrug 5366,2020-07-26,21:00:00,49,30,19,FMN GV 16 Berchem TOT
54,Posthofbrug 5366,2020-07-26,22:00:00,36,14,22,FMN GV 16 Berchem TOT
54,Posthofbrug 5366,2020-07-26,23:00:00,35,9,26,FMN GV 16 Berchem TOT
54,Posthofbrug 5366,2020-07-27,00:00:00,17,6,11,FMN GV 16 Berchem TOT
54,Posthofbrug 5366,2020-07-27,01:00:00,3,1,2,FMN GV 16 Berchem TOT
54,Posthofbrug 5366,2020-07-27,02:00:00,5,1,4,FMN GV 16 Berchem TOT
54,Posthofbrug 5366,2020-07-27,03:00:00,1,0,1,FMN GV 16 Berchem TOT
54,Posthofbrug 5366,2020-07-27,04:00:00,13,11,2,FMN GV 16 Berchem TOT
54,Posthofbrug 5366,2020-07-27,05:00:00,22,15,7,FMN GV 16 Berchem TOT
54,Posthofbrug 5366,2020-07-27,06:00:00,50,36,14,FMN GV 16 Berchem TOT
54,Posthofbrug 5366,2020-07-27,07:00:00,149,103,46,FMN GV 16 Berchem TOT
54,Posthofbrug 5366,2020-07-27,08:00:00,216,159,57,FMN GV 16 Berchem TOT
54,Posthofbrug 5366,2020-07-27,09:00:00,99,80,19,FMN GV 16 Berchem TOT
54,Posthofbrug 5366,2020-07-27,10:00:00,39,26,13,FMN GV 16 Berchem TOT
54,Posthofbrug 5366,2020-07-27,11:00:00,42,24,18,FMN GV 16 Berchem TOT
54,Posthofbrug 5366,2020-07-27,12:00:00,91,55,36,FMN GV 16 Berchem TOT
54,Posthofbrug 5366,2020-07-27,13:00:00,92,51,41,FMN GV 16 Berchem TOT
54,Posthofbrug 5366,2020-07-27,14:00:00,106,48,58,FMN GV 16 Berchem TOT
54,Posthofbrug 5366,2020-07-27,15:00:00,129,59,70,FMN GV 16 Berchem TOT
54,Posthofbrug 5366,2020-07-27,16:00:00,195,71,124,FMN GV 16 Berchem TOT
54,Posthofbrug 5366,2020-07-27,17:00:00,279,107,172,FMN GV 16 Berchem TOT
54,Posthofbrug 5366,2020-07-27,18:00:00,189,58,131,FMN GV 16 Berchem TOT
54,Posthofbrug 5366,2020-07-27,19:00:00,98,39,59,FMN GV 16 Berchem TOT
54,Posthofbrug 5366,2020-07-27,20:00:00,79,38,41,FMN GV 16 Berchem TOT
54,Posthofbrug 5366,2020-07-27,21:00:00,63,40,23,FMN GV 16 Berchem TOT
54,Posthofbrug 5366,2020-07-27,22:00:00,56,23,33,FMN GV 16 Berchem TOT
54,Posthofbrug 5366,2020-07-27,23:00:00,21,8,13,FMN GV 16 Berchem TOT
54,Posthofbrug 5366,2020-07-28,00:00:00,11,9,2,FMN GV 16 Berchem TOT
54,Posthofbrug 5366,2020-07-28,01:00:00,12,3,9,FMN GV 16 Berchem TOT
54,Posthofbrug 5366,2020-07-28,02:00:00,2,1,1,FMN GV 16 Berchem TOT
54,Posthofbrug 5366,2020-07-28,03:00:00,3,0,3,FMN GV 16 Berchem TOT
54,Posthofbrug 5366,2020-07-28,04:00:00,12,9,3,FMN GV 16 Berchem TOT
54,Posthofbrug 5366,2020-07-28,05:00:00,18,14,4,FMN GV 16 Berchem TOT
54,Posthofbrug 5366,2020-07-28,06:00:00,60,47,13,FMN GV 16 Berchem TOT
54,Posthofbrug 5366,2020-07-28,07:00:00,163,116,47,FMN GV 16 Berchem TOT
54,Posthofbrug 5366,2020-07-28,08:00:00,206,148,58,FMN GV 16 Berchem TOT
54,Posthofbrug 5366,2020-07-28,09:00:00,103,82,21,FMN GV 16 Berchem TOT
54,Posthofbrug 5366,2020-07-28,10:00:00,93,56,37,FMN GV 16 Berchem TOT
54,Posthofbrug 5366,2020-07-28,11:00:00,101,46,55,FMN GV 16 Berchem TOT
54,Posthofbrug 5366,2020-07-28,12:00:00,114,67,47,FMN GV 16 Berchem TOT
54,Posthofbrug 5366,2020-07-28,13:00:00,112,57,55,FMN GV 16 Berchem TOT
54,Posthofbrug 5366,2020-07-28,14:00:00,143,62,81,FMN GV 16 Berchem TOT
54,Posthofbrug 5366,2020-07-28,15:00:00,139,67,72,FMN GV 16 Berchem TOT
54,Posthofbrug 5366,2020-07-28,16:00:00,195,79,116,FMN GV 16 Berchem TOT
54,Posthofbrug 5366,2020-07-28,17:00:00,233,77,156,FMN GV 16 Berchem TOT
54,Posthofbrug 5366,2020-07-28,18:00:00,213,74,139,FMN GV 16 Berchem TOT
54,Posthofbrug 5366,2020-07-28,19:00:00,112,53,59,FMN GV 16 Berchem TOT
54,Posthofbrug 5366,2020-07-28,20:00:00,75,31,44,FMN GV 16 Berchem TOT
54,Posthofbrug 5366,2020-07-28,21:00:00,64,35,29,FMN GV 16 Berchem TOT
54,Posthofbrug 5366,2020-07-28,22:00:00,59,27,32,FMN GV 16 Berchem TOT
54,Posthofbrug 5366,2020-07-28,23:00:00,38,26,12,FMN GV 16 Berchem TOT
54,Posthofbrug 5366,2020-07-29,00:00:00,4,3,1,FMN GV 16 Berchem TOT
54,Posthofbrug 5366,2020-07-29,01:00:00,4,1,3,FMN GV 16 Berchem TOT
54,Posthofbrug 5366,2020-07-29,02:00:00,6,4,2,FMN GV 16 Berchem TOT
54,Posthofbrug 5366,2020-07-29,03:00:00,4,1,3,FMN GV 16 Berchem TOT
54,Posthofbrug 5366,2020-07-29,04:00:00,11,7,4,FMN GV 16 Berchem TOT
54,Posthofbrug 5366,2020-07-29,05:00:00,17,12,5,FMN GV 16 Berchem TOT
54,Posthofbrug 5366,2020-07-29,06:00:00,56,47,9,FMN GV 16 Berchem TOT
54,Posthofbrug 5366,2020-07-29,07:00:00,107,79,28,FMN GV 16 Berchem TOT
54,Posthofbrug 5366,2020-07-29,08:00:00,171,122,49,FMN GV 16 Berchem TOT
54,Posthofbrug 5366,2020-07-29,09:00:00,107,80,27,FMN GV 16 Berchem TOT
54,Posthofbrug 5366,2020-07-29,10:00:00,70,48,22,FMN GV 16 Berchem TOT
54,Posthofbrug 5366,2020-07-29,11:00:00,74,42,32,FMN GV 16 Berchem TOT
54,Posthofbrug 5366,2020-07-29,12:00:00,101,48,53,FMN GV 16 Berchem TOT
54,Posthofbrug 5366,2020-07-29,13:00:00,94,58,36,FMN GV 16 Berchem TOT
54,Posthofbrug 5366,2020-07-29,14:00:00,104,45,59,FMN GV 16 Berchem TOT
54,Posthofbrug 5366,2020-07-29,15:00:00,121,51,70,FMN GV 16 Berchem TOT
54,Posthofbrug 5366,2020-07-29,16:00:00,178,62,116,FMN GV 16 Berchem TOT
54,Posthofbrug 5366,2020-07-29,17:00:00,203,67,136,FMN GV 16 Berchem TOT
54,Posthofbrug 5366,2020-07-29,18:00:00,183,72,111,FMN GV 16 Berchem TOT
54,Posthofbrug 5366,2020-07-29,19:00:00,99,46,53,FMN GV 16 Berchem TOT
54,Posthofbrug 5366,2020-07-29,20:00:00,108,50,58,FMN GV 16 Berchem TOT
54,Posthofbrug 5366,2020-07-29,21:00:00,57,29,28,FMN GV 16 Berchem TOT
54,Posthofbrug 5366,2020-07-29,22:00:00,74,31,43,FMN GV 16 Berchem TOT
54,Posthofbrug 5366,2020-07-29,23:00:00,39,15,24,FMN GV 16 Berchem TOT
54,Posthofbrug 5366,2020-07-30,00:00:00,5,3,2,FMN GV 16 Berchem TOT
54,Posthofbrug 5366,2020-07-30,01:00:00,0,0,0,FMN GV 16 Berchem TOT
54,Posthofbrug 5366,2020-07-30,02:00:00,3,0,3,FMN GV 16 Berchem TOT
54,Posthofbrug 5366,2020-07-30,03:00:00,2,0,2,FMN GV 16 Berchem TOT
54,Posthofbrug 5366,2020-07-30,04:00:00,9,7,2,FMN GV 16 Berchem TOT
54,Posthofbrug 5366,2020-07-30,05:00:00,18,12,6,FMN GV 16 Berchem TOT
54,Posthofbrug 5366,2020-07-30,06:00:00,58,42,16,FMN GV 16 Berchem TOT
54,Posthofbrug 5366,2020-07-30,07:00:00,127,86,41,FMN GV 16 Berchem TOT
54,Posthofbrug 5366,2020-07-30,08:00:00,170,125,45,FMN GV 16 Berchem TOT
54,Posthofbrug 5366,2020-07-30,09:00:00,103,75,28,FMN GV 16 Berchem TOT
54,Posthofbrug 5366,2020-07-30,10:00:00,81,45,36,FMN GV 16 Berchem TOT
54,Posthofbrug 5366,2020-07-30,11:00:00,61,39,22,FMN GV 16 Berchem TOT
54,Posthofbrug 5366,2020-07-30,12:00:00,84,53,31,FMN GV 16 Berchem TOT
54,Posthofbrug 5366,2020-07-30,13:00:00,113,59,54,FMN GV 16 Berchem TOT
54,Posthofbrug 5366,2020-07-30,14:00:00,116,52,64,FMN GV 16 Berchem TOT
54,Posthofbrug 5366,2020-07-30,15:00:00,132,60,72,FMN GV 16 Berchem TOT
54,Posthofbrug 5366,2020-07-30,16:00:00,176,82,94,FMN GV 16 Berchem TOT
54,Posthofbrug 5366,2020-07-30,17:00:00,220,74,146,FMN GV 16 Berchem TOT
54,Posthofbrug 5366,2020-07-30,18:00:00,193,67,126,FMN GV 16 Berchem TOT
54,Posthofbrug 5366,2020-07-30,19:00:00,124,52,72,FMN GV 16 Berchem TOT
54,Posthofbrug 5366,2020-07-30,20:00:00,96,46,50,FMN GV 16 Berchem TOT
54,Posthofbrug 5366,2020-07-30,21:00:00,88,54,34,FMN GV 16 Berchem TOT
54,Posthofbrug 5366,2020-07-30,22:00:00,84,43,41,FMN GV 16 Berchem TOT
54,Posthofbrug 5366,2020-07-30,23:00:00,44,19,25,FMN GV 16 Berchem TOT
54,Posthofbrug 5366,2020-07-31,00:00:00,1,1,0,FMN GV 16 Berchem TOT
54,Posthofbrug 5366,2020-07-31,01:00:00,1,0,1,FMN GV 16 Berchem TOT
54,Posthofbrug 5366,2020-07-31,02:00:00,0,0,0,FMN GV 16 Berchem TOT
54,Posthofbrug 5366,2020-07-31,03:00:00,1,0,1,FMN GV 16 Berchem TOT
54,Posthofbrug 5366,2020-07-31,04:00:00,10,8,2,FMN GV 16 Berchem TOT
54,Posthofbrug 5366,2020-07-31,05:00:00,21,15,6,FMN GV 16 Berchem TOT
54,Posthofbrug 5366,2020-07-31,06:00:00,43,34,9,FMN GV 16 Berchem TOT
54,Posthofbrug 5366,2020-07-31,07:00:00,101,69,32,FMN GV 16 Berchem TOT
54,Posthofbrug 5366,2020-07-31,08:00:00,169,125,44,FMN GV 16 Berchem TOT
54,Posthofbrug 5366,2020-07-31,09:00:00,99,68,31,FMN GV 16 Berchem TOT
54,Posthofbrug 5366,2020-07-31,10:00:00,103,64,39,FMN GV 16 Berchem TOT
54,Posthofbrug 5366,2020-07-31,11:00:00,90,46,44,FMN GV 16 Berchem TOT
54,Posthofbrug 5366,2020-07-31,12:00:00,100,51,49,FMN GV 16 Berchem TOT
54,Posthofbrug 5366,2020-07-31,13:00:00,89,37,52,FMN GV 16 Berchem TOT
54,Posthofbrug 5366,2020-07-31,14:00:00,89,31,58,FMN GV 16 Berchem TOT
54,Posthofbrug 5366,2020-07-31,15:00:00,96,35,61,FMN GV 16 Berchem TOT
54,Posthofbrug 5366,2020-07-31,16:00:00,134,48,86,FMN GV 16 Berchem TOT
54,Posthofbrug 5366,2020-07-31,17:00:00,152,59,93,FMN GV 16 Berchem TOT
54,Posthofbrug 5366,2020-07-31,18:00:00,137,59,78,FMN GV 16 Berchem TOT
54,Posthofbrug 5366,2020-07-31,19:00:00,93,39,54,FMN GV 16 Berchem TOT
54,Posthofbrug 5366,2020-07-31,20:00:00,74,42,32,FMN GV 16 Berchem TOT
54,Posthofbrug 5366,2020-07-31,21:00:00,75,42,33,FMN GV 16 Berchem TOT
54,Posthofbrug 5366,2020-07-31,22:00:00,89,40,49,FMN GV 16 Berchem TOT
54,Posthofbrug 5366,2020-07-31,23:00:00,72,34,38,FMN GV 16 Berchem TOT
54,Posthofbrug 5366,2020-08-01,00:00:00,1,1,0,FMN GV 16 Berchem TOT
54,Posthofbrug 5366,2020-08-01,01:00:00,2,0,2,FMN GV 16 Berchem TOT
54,Posthofbrug 5366,2020-08-01,02:00:00,0,0,0,FMN GV 16 Berchem TOT
54,Posthofbrug 5366,2020-08-01,03:00:00,1,0,1,FMN GV 16 Berchem TOT
54,Posthofbrug 5366,2020-08-01,04:00:00,5,5,0,FMN GV 16 Berchem TOT
54,Posthofbrug 5366,2020-08-01,05:00:00,10,7,3,FMN GV 16 Berchem TOT
54,Posthofbrug 5366,2020-08-01,06:00:00,18,15,3,FMN GV 16 Berchem TOT
54,Posthofbrug 5366,2020-08-01,07:00:00,27,16,11,FMN GV 16 Berchem TOT
54,Posthofbrug 5366,2020-08-01,08:00:00,51,25,26,FMN GV 16 Berchem TOT
54,Posthofbrug 5366,2020-08-01,09:00:00,63,47,16,FMN GV 16 Berchem TOT
54,Posthofbrug 5366,2020-08-01,10:00:00,85,45,40,FMN GV 16 Berchem TOT
54,Posthofbrug 5366,2020-08-01,11:00:00,93,63,30,FMN GV 16 Berchem TOT
54,Posthofbrug 5366,2020-08-01,12:00:00,98,52,46,FMN GV 16 Berchem TOT
54,Posthofbrug 5366,2020-08-01,13:00:00,149,78,71,FMN GV 16 Berchem TOT
54,Posthofbrug 5366,2020-08-01,14:00:00,96,55,41,FMN GV 16 Berchem TOT
54,Posthofbrug 5366,2020-08-01,15:00:00,155,67,88,FMN GV 16 Berchem TOT
54,Posthofbrug 5366,2020-08-01,16:00:00,124,60,64,FMN GV 16 Berchem TOT
54,Posthofbrug 5366,2020-08-01,17:00:00,151,69,82,FMN GV 16 Berchem TOT
54,Posthofbrug 5366,2020-08-01,18:00:00,121,54,67,FMN GV 16 Berchem TOT
54,Posthofbrug 5366,2020-08-01,19:00:00,86,44,42,FMN GV 16 Berchem TOT
54,Posthofbrug 5366,2020-08-01,20:00:00,86,52,34,FMN GV 16 Berchem TOT
54,Posthofbrug 5366,2020-08-01,21:00:00,53,29,24,FMN GV 16 Berchem TOT
54,Posthofbrug 5366,2020-08-01,22:00:00,66,41,25,FMN GV 16 Berchem TOT
54,Posthofbrug 5366,2020-08-01,23:00:00,74,27,47,FMN GV 16 Berchem TOT
54,Posthofbrug 5366,2020-08-02,00:00:00,0,0,0,FMN GV 16 Berchem TOT
54,Posthofbrug 5366,2020-08-02,01:00:00,4,1,3,FMN GV 16 Berchem TOT
54,Posthofbrug 5366,2020-08-02,02:00:00,0,0,0,FMN GV 16 Berchem TOT
54,Posthofbrug 5366,2020-08-02,03:00:00,3,2,1,FMN GV 16 Berchem TOT
54,Posthofbrug 5366,2020-08-02,04:00:00,5,3,2,FMN GV 16 Berchem TOT
54,Posthofbrug 5366,2020-08-02,05:00:00,6,4,2,FMN GV 16 Berchem TOT
54,Posthofbrug 5366,2020-08-02,06:00:00,12,10,2,FMN GV 16 Berchem TOT
54,Posthofbrug 5366,2020-08-02,07:00:00,26,13,13,FMN GV 16 Berchem TOT
54,Posthofbrug 5366,2020-08-02,08:00:00,31,17,14,FMN GV 16 Berchem TOT
54,Posthofbrug 5366,2020-08-02,09:00:00,55,24,31,FMN GV 16 Berchem TOT
54,Posthofbrug 5366,2020-08-02,10:00:00,84,33,51,FMN GV 16 Berchem TOT
54,Posthofbrug 5366,2020-08-02,11:00:00,107,71,36,FMN GV 16 Berchem TOT
54,Posthofbrug 5366,2020-08-02,12:00:00,115,77,38,FMN GV 16 Berchem TOT
54,Posthofbrug 5366,2020-08-02,13:00:00,117,65,52,FMN GV 16 Berchem TOT
54,Posthofbrug 5366,2020-08-02,14:00:00,147,93,54,FMN GV 16 Berchem TOT
54,Posthofbrug 5366,2020-08-02,15:00:00,133,72,61,FMN GV 16 Berchem TOT
54,Posthofbrug 5366,2020-08-02,16:00:00,149,84,65,FMN GV 16 Berchem TOT
54,Posthofbrug 5366,2020-08-02,17:00:00,144,67,77,FMN GV 16 Berchem TOT
54,Posthofbrug 5366,2020-08-02,18:00:00,103,63,40,FMN GV 16 Berchem TOT
54,Posthofbrug 5366,2020-08-02,19:00:00,78,41,37,FMN GV 16 Berchem TOT
54,Posthofbrug 5366,2020-08-02,20:00:00,69,37,32,FMN GV 16 Berchem TOT
54,Posthofbrug 5366,2020-08-02,21:00:00,56,39,17,FMN GV 16 Berchem TOT
54,Posthofbrug 5366,2020-08-02,22:00:00,57,24,33,FMN GV 16 Berchem TOT
54,Posthofbrug 5366,2020-08-02,23:00:00,29,10,19,FMN GV 16 Berchem TOT
54,Posthofbrug 5366,2020-08-03,00:00:00,4,2,2,FMN GV 16 Berchem TOT
54,Posthofbrug 5366,2020-08-03,01:00:00,1,0,1,FMN GV 16 Berchem TOT
54,Posthofbrug 5366,2020-08-03,02:00:00,2,2,0,FMN GV 16 Berchem TOT
54,Posthofbrug 5366,2020-08-03,03:00:00,4,3,1,FMN GV 16 Berchem TOT
54,Posthofbrug 5366,2020-08-03,04:00:00,11,7,4,FMN GV 16 Berchem TOT
54,Posthofbrug 5366,2020-08-03,05:00:00,13,9,4,FMN GV 16 Berchem TOT
54,Posthofbrug 5366,2020-08-03,06:00:00,69,53,16,FMN GV 16 Berchem TOT
54,Posthofbrug 5366,2020-08-03,07:00:00,136,95,41,FMN GV 16 Berchem TOT
54,Posthofbrug 5366,2020-08-03,08:00:00,164,123,41,FMN GV 16 Berchem TOT
54,Posthofbrug 5366,2020-08-03,09:00:00,93,65,28,FMN GV 16 Berchem TOT
54,Posthofbrug 5366,2020-08-03,10:00:00,86,58,28,FMN GV 16 Berchem TOT
54,Posthofbrug 5366,2020-08-03,11:00:00,76,46,30,FMN GV 16 Berchem TOT
54,Posthofbrug 5366,2020-08-03,12:00:00,102,45,57,FMN GV 16 Berchem TOT
54,Posthofbrug 5366,2020-08-03,13:00:00,108,75,33,FMN GV 16 Berchem TOT
54,Posthofbrug 5366,2020-08-03,14:00:00,122,54,68,FMN GV 16 Berchem TOT
54,Posthofbrug 5366,2020-08-03,15:00:00,117,38,79,FMN GV 16 Berchem TOT
54,Posthofbrug 5366,2020-08-03,16:00:00,159,59,100,FMN GV 16 Berchem TOT
54,Posthofbrug 5366,2020-08-03,17:00:00,195,73,122,FMN GV 16 Berchem TOT
54,Posthofbrug 5366,2020-08-03,18:00:00,137,41,96,FMN GV 16 Berchem TOT
54,Posthofbrug 5366,2020-08-03,19:00:00,64,23,41,FMN GV 16 Berchem TOT
54,Posthofbrug 5366,2020-08-03,20:00:00,53,32,21,FMN GV 16 Berchem TOT
54,Posthofbrug 5366,2020-08-03,21:00:00,44,21,23,FMN GV 16 Berchem TOT
54,Posthofbrug 5366,2020-08-03,22:00:00,44,18,26,FMN GV 16 Berchem TOT
54,Posthofbrug 5366,2020-08-03,23:00:00,22,6,16,FMN GV 16 Berchem TOT
54,Posthofbrug 5366,2020-08-04,00:00:00,0,0,0,FMN GV 16 Berchem TOT
54,Posthofbrug 5366,2020-08-04,01:00:00,0,0,0,FMN GV 16 Berchem TOT
54,Posthofbrug 5366,2020-08-04,02:00:00,0,0,0,FMN GV 16 Berchem TOT
54,Posthofbrug 5366,2020-08-04,03:00:00,0,0,0,FMN GV 16 Berchem TOT
54,Posthofbrug 5366,2020-08-04,04:00:00,9,7,2,FMN GV 16 Berchem TOT
54,Posthofbrug 5366,2020-08-04,05:00:00,14,12,2,FMN GV 16 Berchem TOT
54,Posthofbrug 5366,2020-08-04,06:00:00,69,54,15,FMN GV 16 Berchem TOT
54,Posthofbrug 5366,2020-08-04,07:00:00,169,118,51,FMN GV 16 Berchem TOT
54,Posthofbrug 5366,2020-08-04,08:00:00,174,127,47,FMN GV 16 Berchem TOT
54,Posthofbrug 5366,2020-08-04,09:00:00,111,79,32,FMN GV 16 Berchem TOT
54,Posthofbrug 5366,2020-08-04,10:00:00,110,70,40,FMN GV 16 Berchem TOT
54,Posthofbrug 5366,2020-08-04,11:00:00,88,51,37,FMN GV 16 Berchem TOT
54,Posthofbrug 5366,2020-08-04,12:00:00,147,83,64,FMN GV 16 Berchem TOT
54,Posthofbrug 5366,2020-08-04,13:00:00,112,69,43,FMN GV 16 Berchem TOT
54,Posthofbrug 5366,2020-08-04,14:00:00,104,49,55,FMN GV 16 Berchem TOT
54,Posthofbrug 5366,2020-08-04,15:00:00,143,53,90,FMN GV 16 Berchem TOT
54,Posthofbrug 5366,2020-08-04,16:00:00,227,99,128,FMN GV 16 Berchem TOT
54,Posthofbrug 5366,2020-08-04,17:00:00,275,98,177,FMN GV 16 Berchem TOT
54,Posthofbrug 5366,2020-08-04,18:00:00,204,81,123,FMN GV 16 Berchem TOT
54,Posthofbrug 5366,2020-08-04,19:00:00,127,67,60,FMN GV 16 Berchem TOT
54,Posthofbrug 5366,2020-08-04,20:00:00,109,55,54,FMN GV 16 Berchem TOT
54,Posthofbrug 5366,2020-08-04,21:00:00,79,44,35,FMN GV 16 Berchem TOT
54,Posthofbrug 5366,2020-08-04,22:00:00,86,32,54,FMN GV 16 Berchem TOT
54,Posthofbrug 5366,2020-08-04,23:00:00,47,23,24,FMN GV 16 Berchem TOT
54,Posthofbrug 5366,2020-08-05,00:00:00,2,1,1,FMN GV 16 Berchem TOT
54,Posthofbrug 5366,2020-08-05,01:00:00,1,0,1,FMN GV 16 Berchem TOT
54,Posthofbrug 5366,2020-08-05,02:00:00,0,0,0,FMN GV 16 Berchem TOT
54,Posthofbrug 5366,2020-08-05,03:00:00,0,0,0,FMN GV 16 Berchem TOT
54,Posthofbrug 5366,2020-08-05,04:00:00,12,10,2,FMN GV 16 Berchem TOT
54,Posthofbrug 5366,2020-08-05,05:00:00,19,16,3,FMN GV 16 Berchem TOT
54,Posthofbrug 5366,2020-08-05,06:00:00,64,47,17,FMN GV 16 Berchem TOT
54,Posthofbrug 5366,2020-08-05,07:00:00,152,106,46,FMN GV 16 Berchem TOT
54,Posthofbrug 5366,2020-08-05,08:00:00,181,118,63,FMN GV 16 Berchem TOT
54,Posthofbrug 5366,2020-08-05,09:00:00,133,97,36,FMN GV 16 Berchem TOT
54,Posthofbrug 5366,2020-08-05,10:00:00,88,59,29,FMN GV 16 Berchem TOT
54,Posthofbrug 5366,2020-08-05,11:00:00,95,51,44,FMN GV 16 Berchem TOT
54,Posthofbrug 5366,2020-08-05,12:00:00,101,54,47,FMN GV 16 Berchem TOT
54,Posthofbrug 5366,2020-08-05,13:00:00,122,73,49,FMN GV 16 Berchem TOT
54,Posthofbrug 5366,2020-08-05,14:00:00,137,76,61,FMN GV 16 Berchem TOT
54,Posthofbrug 5366,2020-08-05,15:00:00,140,55,85,FMN GV 16 Berchem TOT
54,Posthofbrug 5366,2020-08-05,16:00:00,223,99,124,FMN GV 16 Berchem TOT
54,Posthofbrug 5366,2020-08-05,17:00:00,239,85,154,FMN GV 16 Berchem TOT
54,Posthofbrug 5366,2020-08-05,18:00:00,237,96,141,FMN GV 16 Berchem TOT
54,Posthofbrug 5366,2020-08-05,19:00:00,147,61,86,FMN GV 16 Berchem TOT
54,Posthofbrug 5366,2020-08-05,20:00:00,98,50,48,FMN GV 16 Berchem TOT
54,Posthofbrug 5366,2020-08-05,21:00:00,84,45,39,FMN GV 16 Berchem TOT
54,Posthofbrug 5366,2020-08-05,22:00:00,84,44,40,FMN GV 16 Berchem TOT
54,Posthofbrug 5366,2020-08-05,23:00:00,40,21,19,FMN GV 16 Berchem TOT
54,Posthofbrug 5366,2020-08-06,00:00:00,4,1,3,FMN GV 16 Berchem TOT
54,Posthofbrug 5366,2020-08-06,01:00:00,3,1,2,FMN GV 16 Berchem TOT
54,Posthofbrug 5366,2020-08-06,02:00:00,1,1,0,FMN GV 16 Berchem TOT
54,Posthofbrug 5366,2020-08-06,03:00:00,2,1,1,FMN GV 16 Berchem TOT
54,Posthofbrug 5366,2020-08-06,04:00:00,13,10,3,FMN GV 16 Berchem TOT
54,Posthofbrug 5366,2020-08-06,05:00:00,19,16,3,FMN GV 16 Berchem TOT
54,Posthofbrug 5366,2020-08-06,06:00:00,73,57,16,FMN GV 16 Berchem TOT
54,Posthofbrug 5366,2020-08-06,07:00:00,140,89,51,FMN GV 16 Berchem TOT
54,Posthofbrug 5366,2020-08-06,08:00:00,192,130,62,FMN GV 16 Berchem TOT
54,Posthofbrug 5366,2020-08-06,09:00:00,115,76,39,FMN GV 16 Berchem TOT
54,Posthofbrug 5366,2020-08-06,10:00:00,105,63,42,FMN GV 16 Berchem TOT
54,Posthofbrug 5366,2020-08-06,11:00:00,88,46,42,FMN GV 16 Berchem TOT
54,Posthofbrug 5366,2020-08-06,12:00:00,121,71,50,FMN GV 16 Berchem TOT
54,Posthofbrug 5366,2020-08-06,13:00:00,90,48,42,FMN GV 16 Berchem TOT
54,Posthofbrug 5366,2020-08-06,14:00:00,106,46,60,FMN GV 16 Berchem TOT
54,Posthofbrug 5366,2020-08-06,15:00:00,105,34,71,FMN GV 16 Berchem TOT
54,Posthofbrug 5366,2020-08-06,16:00:00,140,51,89,FMN GV 16 Berchem TOT
54,Posthofbrug 5366,2020-08-06,17:00:00,181,71,110,FMN GV 16 Berchem TOT
54,Posthofbrug 5366,2020-08-06,18:00:00,180,70,110,FMN GV 16 Berchem TOT
54,Posthofbrug 5366,2020-08-06,19:00:00,104,47,57,FMN GV 16 Berchem TOT
54,Posthofbrug 5366,2020-08-06,20:00:00,109,55,54,FMN GV 16 Berchem TOT
54,Posthofbrug 5366,2020-08-06,21:00:00,84,54,30,FMN GV 16 Berchem TOT
54,Posthofbrug 5366,2020-08-06,22:00:00,75,34,41,FMN GV 16 Berchem TOT
54,Posthofbrug 5366,2020-08-06,23:00:00,63,23,40,FMN GV 16 Berchem TOT
54,Posthofbrug 5366,2020-08-07,00:00:00,5,1,4,FMN GV 16 Berchem TOT
54,Posthofbrug 5366,2020-08-07,01:00:00,1,0,1,FMN GV 16 Berchem TOT
54,Posthofbrug 5366,2020-08-07,02:00:00,3,1,2,FMN GV 16 Berchem TOT
54,Posthofbrug 5366,2020-08-07,03:00:00,0,0,0,FMN GV 16 Berchem TOT
54,Posthofbrug 5366,2020-08-07,04:00:00,10,8,2,FMN GV 16 Berchem TOT
54,Posthofbrug 5366,2020-08-07,05:00:00,15,12,3,FMN GV 16 Berchem TOT
54,Posthofbrug 5366,2020-08-07,06:00:00,66,50,16,FMN GV 16 Berchem TOT
54,Posthofbrug 5366,2020-08-07,07:00:00,119,77,42,FMN GV 16 Berchem TOT
54,Posthofbrug 5366,2020-08-07,08:00:00,170,112,58,FMN GV 16 Berchem TOT
54,Posthofbrug 5366,2020-08-07,09:00:00,119,83,36,FMN GV 16 Berchem TOT
54,Posthofbrug 5366,2020-08-07,10:00:00,98,57,41,FMN GV 16 Berchem TOT
54,Posthofbrug 5366,2020-08-07,11:00:00,87,51,36,FMN GV 16 Berchem TOT
54,Posthofbrug 5366,2020-08-07,12:00:00,88,51,37,FMN GV 16 Berchem TOT
54,Posthofbrug 5366,2020-08-07,13:00:00,89,42,47,FMN GV 16 Berchem TOT
54,Posthofbrug 5366,2020-08-07,14:00:00,101,51,50,FMN GV 16 Berchem TOT
54,Posthofbrug 5366,2020-08-07,15:00:00,118,51,67,FMN GV 16 Berchem TOT
54,Posthofbrug 5366,2020-08-07,16:00:00,166,65,101,FMN GV 16 Berchem TOT
54,Posthofbrug 5366,2020-08-07,17:00:00,155,57,98,FMN GV 16 Berchem TOT
54,Posthofbrug 5366,2020-08-07,18:00:00,139,51,88,FMN GV 16 Berchem TOT
54,Posthofbrug 5366,2020-08-07,19:00:00,131,49,82,FMN GV 16 Berchem TOT
54,Posthofbrug 5366,2020-08-07,20:00:00,72,44,28,FMN GV 16 Berchem TOT
54,Posthofbrug 5366,2020-08-07,21:00:00,70,44,26,FMN GV 16 Berchem TOT
54,Posthofbrug 5366,2020-08-07,22:00:00,71,35,36,FMN GV 16 Berchem TOT
54,Posthofbrug 5366,2020-08-07,23:00:00,47,20,27,FMN GV 16 Berchem TOT
54,Posthofbrug 5366,2020-08-08,00:00:00,23,14,9,FMN GV 16 Berchem TOT
54,Posthofbrug 5366,2020-08-08,01:00:00,24,9,15,FMN GV 16 Berchem TOT
54,Posthofbrug 5366,2020-08-08,02:00:00,9,3,6,FMN GV 16 Berchem TOT
54,Posthofbrug 5366,2020-08-08,03:00:00,10,5,5,FMN GV 16 Berchem TOT
54,Posthofbrug 5366,2020-08-08,04:00:00,5,3,2,FMN GV 16 Berchem TOT
54,Posthofbrug 5366,2020-08-08,05:00:00,8,4,4,FMN GV 16 Berchem TOT
54,Posthofbrug 5366,2020-08-08,06:00:00,27,19,8,FMN GV 16 Berchem TOT
54,Posthofbrug 5366,2020-08-08,07:00:00,30,15,15,FMN GV 16 Berchem TOT
54,Posthofbrug 5366,2020-08-08,08:00:00,72,47,25,FMN GV 16 Berchem TOT
54,Posthofbrug 5366,2020-08-08,09:00:00,73,56,17,FMN GV 16 Berchem TOT
54,Posthofbrug 5366,2020-08-08,10:00:00,119,66,53,FMN GV 16 Berchem TOT
54,Posthofbrug 5366,2020-08-08,11:00:00,118,66,52,FMN GV 16 Berchem TOT
54,Posthofbrug 5366,2020-08-08,12:00:00,103,50,53,FMN GV 16 Berchem TOT
54,Posthofbrug 5366,2020-08-08,13:00:00,86,33,53,FMN GV 16 Berchem TOT
54,Posthofbrug 5366,2020-08-08,14:00:00,89,36,53,FMN GV 16 Berchem TOT
54,Posthofbrug 5366,2020-08-08,15:00:00,77,35,42,FMN GV 16 Berchem TOT
54,Posthofbrug 5366,2020-08-08,16:00:00,65,25,40,FMN GV 16 Berchem TOT
54,Posthofbrug 5366,2020-08-08,17:00:00,73,37,36,FMN GV 16 Berchem TOT
54,Posthofbrug 5366,2020-08-08,18:00:00,82,37,45,FMN GV 16 Berchem TOT
54,Posthofbrug 5366,2020-08-08,19:00:00,55,23,32,FMN GV 16 Berchem TOT
54,Posthofbrug 5366,2020-08-08,20:00:00,65,38,27,FMN GV 16 Berchem TOT
54,Posthofbrug 5366,2020-08-08,21:00:00,51,29,22,FMN GV 16 Berchem TOT
54,Posthofbrug 5366,2020-08-08,22:00:00,78,33,45,FMN GV 16 Berchem TOT
54,Posthofbrug 5366,2020-08-08,23:00:00,64,24,40,FMN GV 16 Berchem TOT
54,Posthofbrug 5366,2020-08-09,00:00:00,21,9,12,FMN GV 16 Berchem TOT
54,Posthofbrug 5366,2020-08-09,01:00:00,19,12,7,FMN GV 16 Berchem TOT
54,Posthofbrug 5366,2020-08-09,02:00:00,7,6,1,FMN GV 16 Berchem TOT
54,Posthofbrug 5366,2020-08-09,03:00:00,3,2,1,FMN GV 16 Berchem TOT
54,Posthofbrug 5366,2020-08-09,04:00:00,4,2,2,FMN GV 16 Berchem TOT
54,Posthofbrug 5366,2020-08-09,05:00:00,10,7,3,FMN GV 16 Berchem TOT
54,Posthofbrug 5366,2020-08-09,06:00:00,18,13,5,FMN GV 16 Berchem TOT
54,Posthofbrug 5366,2020-08-09,07:00:00,36,19,17,FMN GV 16 Berchem TOT
54,Posthofbrug 5366,2020-08-09,08:00:00,64,38,26,FMN GV 16 Berchem TOT
54,Posthofbrug 5366,2020-08-09,09:00:00,91,42,49,FMN GV 16 Berchem TOT
54,Posthofbrug 5366,2020-08-09,10:00:00,74,42,32,FMN GV 16 Berchem TOT
54,Posthofbrug 5366,2020-08-09,11:00:00,99,49,50,FMN GV 16 Berchem TOT
54,Posthofbrug 5366,2020-08-09,12:00:00,90,37,53,FMN GV 16 Berchem TOT
54,Posthofbrug 5366,2020-08-09,13:00:00,83,43,40,FMN GV 16 Berchem TOT
54,Posthofbrug 5366,2020-08-09,14:00:00,79,48,31,FMN GV 16 Berchem TOT
54,Posthofbrug 5366,2020-08-09,15:00:00,77,36,41,FMN GV 16 Berchem TOT
54,Posthofbrug 5366,2020-08-09,16:00:00,67,29,38,FMN GV 16 Berchem TOT
54,Posthofbrug 5366,2020-08-09,17:00:00,73,28,45,FMN GV 16 Berchem TOT
54,Posthofbrug 5366,2020-08-09,18:00:00,69,37,32,FMN GV 16 Berchem TOT
54,Posthofbrug 5366,2020-08-09,19:00:00,68,32,36,FMN GV 16 Berchem TOT
54,Posthofbrug 5366,2020-08-09,20:00:00,87,49,38,FMN GV 16 Berchem TOT
54,Posthofbrug 5366,2020-08-09,21:00:00,66,41,25,FMN GV 16 Berchem TOT
54,Posthofbrug 5366,2020-08-09,22:00:00,86,48,38,FMN GV 16 Berchem TOT
54,Posthofbrug 5366,2020-08-09,23:00:00,37,16,21,FMN GV 16 Berchem TOT
54,Posthofbrug 5366,2020-08-10,00:00:00,8,4,4,FMN GV 16 Berchem TOT
54,Posthofbrug 5366,2020-08-10,01:00:00,16,9,7,FMN GV 16 Berchem TOT
54,Posthofbrug 5366,2020-08-10,02:00:00,2,0,2,FMN GV 16 Berchem TOT
54,Posthofbrug 5366,2020-08-10,03:00:00,4,1,3,FMN GV 16 Berchem TOT
54,Posthofbrug 5366,2020-08-10,04:00:00,10,7,3,FMN GV 16 Berchem TOT
54,Posthofbrug 5366,2020-08-10,05:00:00,12,10,2,FMN GV 16 Berchem TOT
54,Posthofbrug 5366,2020-08-10,06:00:00,77,61,16,FMN GV 16 Berchem TOT
54,Posthofbrug 5366,2020-08-10,07:00:00,117,84,33,FMN GV 16 Berchem TOT
54,Posthofbrug 5366,2020-08-10,08:00:00,179,130,49,FMN GV 16 Berchem TOT
54,Posthofbrug 5366,2020-08-10,09:00:00,121,79,42,FMN GV 16 Berchem TOT
54,Posthofbrug 5366,2020-08-10,10:00:00,71,40,31,FMN GV 16 Berchem TOT
54,Posthofbrug 5366,2020-08-10,11:00:00,58,39,19,FMN GV 16 Berchem TOT
54,Posthofbrug 5366,2020-08-10,12:00:00,79,40,39,FMN GV 16 Berchem TOT
54,Posthofbrug 5366,2020-08-10,13:00:00,69,38,31,FMN GV 16 Berchem TOT
54,Posthofbrug 5366,2020-08-10,14:00:00,80,44,36,FMN GV 16 Berchem TOT
54,Posthofbrug 5366,2020-08-10,15:00:00,85,34,51,FMN GV 16 Berchem TOT
54,Posthofbrug 5366,2020-08-10,16:00:00,141,54,87,FMN GV 16 Berchem TOT
54,Posthofbrug 5366,2020-08-10,17:00:00,197,65,132,FMN GV 16 Berchem TOT
54,Posthofbrug 5366,2020-08-10,18:00:00,162,58,104,FMN GV 16 Berchem TOT
54,Posthofbrug 5366,2020-08-10,19:00:00,104,35,69,FMN GV 16 Berchem TOT
54,Posthofbrug 5366,2020-08-10,20:00:00,82,40,42,FMN GV 16 Berchem TOT
54,Posthofbrug 5366,2020-08-10,21:00:00,65,40,25,FMN GV 16 Berchem TOT
54,Posthofbrug 5366,2020-08-10,22:00:00,84,47,37,FMN GV 16 Berchem TOT
54,Posthofbrug 5366,2020-08-10,23:00:00,34,13,21,FMN GV 16 Berchem TOT
54,Posthofbrug 5366,2020-08-11,00:00:00,13,8,5,FMN GV 16 Berchem TOT
54,Posthofbrug 5366,2020-08-11,01:00:00,7,0,7,FMN GV 16 Berchem TOT
54,Posthofbrug 5366,2020-08-11,02:00:00,7,4,3,FMN GV 16 Berchem TOT
54,Posthofbrug 5366,2020-08-11,03:00:00,5,2,3,FMN GV 16 Berchem TOT
54,Posthofbrug 5366,2020-08-11,04:00:00,12,9,3,FMN GV 16 Berchem TOT
54,Posthofbrug 5366,2020-08-11,05:00:00,19,13,6,FMN GV 16 Berchem TOT
54,Posthofbrug 5366,2020-08-11,06:00:00,75,50,25,FMN GV 16 Berchem TOT
54,Posthofbrug 5366,2020-08-11,07:00:00,135,92,43,FMN GV 16 Berchem TOT
54,Posthofbrug 5366,2020-08-11,08:00:00,198,148,50,FMN GV 16 Berchem TOT
54,Posthofbrug 5366,2020-08-11,09:00:00,117,86,31,FMN GV 16 Berchem TOT
54,Posthofbrug 5366,2020-08-11,10:00:00,78,51,27,FMN GV 16 Berchem TOT
54,Posthofbrug 5366,2020-08-11,11:00:00,56,28,28,FMN GV 16 Berchem TOT
54,Posthofbrug 5366,2020-08-11,12:00:00,96,54,42,FMN GV 16 Berchem TOT
54,Posthofbrug 5366,2020-08-11,13:00:00,89,39,50,FMN GV 16 Berchem TOT
54,Posthofbrug 5366,2020-08-11,14:00:00,116,63,53,FMN GV 16 Berchem TOT
54,Posthofbrug 5366,2020-08-11,15:00:00,106,39,67,FMN GV 16 Berchem TOT
54,Posthofbrug 5366,2020-08-11,16:00:00,151,58,93,FMN GV 16 Berchem TOT
54,Posthofbrug 5366,2020-08-11,17:00:00,201,64,137,FMN GV 16 Berchem TOT
54,Posthofbrug 5366,2020-08-11,18:00:00,147,51,96,FMN GV 16 Berchem TOT
54,Posthofbrug 5366,2020-08-11,19:00:00,121,45,76,FMN GV 16 Berchem TOT
54,Posthofbrug 5366,2020-08-11,20:00:00,107,57,50,FMN GV 16 Berchem TOT
54,Posthofbrug 5366,2020-08-11,21:00:00,43,29,14,FMN GV 16 Berchem TOT
54,Posthofbrug 5366,2020-08-11,22:00:00,40,25,15,FMN GV 16 Berchem TOT
54,Posthofbrug 5366,2020-08-11,23:00:00,24,11,13,FMN GV 16 Berchem TOT
54,Posthofbrug 5366,2020-08-12,00:00:00,8,0,8,FMN GV 16 Berchem TOT
54,Posthofbrug 5366,2020-08-12,01:00:00,6,3,3,FMN GV 16 Berchem TOT
54,Posthofbrug 5366,2020-08-12,02:00:00,4,2,2,FMN GV 16 Berchem TOT
54,Posthofbrug 5366,2020-08-12,03:00:00,1,0,1,FMN GV 16 Berchem TOT
54,Posthofbrug 5366,2020-08-12,04:00:00,9,7,2,FMN GV 16 Berchem TOT
54,Posthofbrug 5366,2020-08-12,05:00:00,17,12,5,FMN GV 16 Berchem TOT
54,Posthofbrug 5366,2020-08-12,06:00:00,70,49,21,FMN GV 16 Berchem TOT
54,Posthofbrug 5366,2020-08-12,07:00:00,155,94,61,FMN GV 16 Berchem TOT
54,Posthofbrug 5366,2020-08-12,08:00:00,163,115,48,FMN GV 16 Berchem TOT
54,Posthofbrug 5366,2020-08-12,09:00:00,127,82,45,FMN GV 16 Berchem TOT
54,Posthofbrug 5366,2020-08-12,10:00:00,98,59,39,FMN GV 16 Berchem TOT
54,Posthofbrug 5366,2020-08-12,11:00:00,91,59,32,FMN GV 16 Berchem TOT
54,Posthofbrug 5366,2020-08-12,12:00:00,93,37,56,FMN GV 16 Berchem TOT
54,Posthofbrug 5366,2020-08-12,13:00:00,78,38,40,FMN GV 16 Berchem TOT
54,Posthofbrug 5366,2020-08-12,14:00:00,80,38,42,FMN GV 16 Berchem TOT
54,Posthofbrug 5366,2020-08-12,15:00:00,121,56,65,FMN GV 16 Berchem TOT
54,Posthofbrug 5366,2020-08-12,16:00:00,149,62,87,FMN GV 16 Berchem TOT
54,Posthofbrug 5366,2020-08-12,17:00:00,204,76,128,FMN GV 16 Berchem TOT
54,Posthofbrug 5366,2020-08-12,18:00:00,168,72,96,FMN GV 16 Berchem TOT
54,Posthofbrug 5366,2020-08-12,19:00:00,123,52,71,FMN GV 16 Berchem TOT
54,Posthofbrug 5366,2020-08-12,20:00:00,92,55,37,FMN GV 16 Berchem TOT
54,Posthofbrug 5366,2020-08-12,21:00:00,93,58,35,FMN GV 16 Berchem TOT
54,Posthofbrug 5366,2020-08-12,22:00:00,70,30,40,FMN GV 16 Berchem TOT
54,Posthofbrug 5366,2020-08-12,23:00:00,49,25,24,FMN GV 16 Berchem TOT
54,Posthofbrug 5366,2020-08-13,00:00:00,21,6,15,FMN GV 16 Berchem TOT
54,Posthofbrug 5366,2020-08-13,01:00:00,19,4,15,FMN GV 16 Berchem TOT
54,Posthofbrug 5366,2020-08-13,02:00:00,2,0,2,FMN GV 16 Berchem TOT
54,Posthofbrug 5366,2020-08-13,03:00:00,1,0,1,FMN GV 16 Berchem TOT
54,Posthofbrug 5366,2020-08-13,04:00:00,13,10,3,FMN GV 16 Berchem TOT
54,Posthofbrug 5366,2020-08-13,05:00:00,18,14,4,FMN GV 16 Berchem TOT
54,Posthofbrug 5366,2020-08-13,06:00:00,61,42,19,FMN GV 16 Berchem TOT
54,Posthofbrug 5366,2020-08-13,07:00:00,126,81,45,FMN GV 16 Berchem TOT
54,Posthofbrug 5366,2020-08-13,08:00:00,167,112,55,FMN GV 16 Berchem TOT
54,Posthofbrug 5366,2020-08-13,09:00:00,127,94,33,FMN GV 16 Berchem TOT
54,Posthofbrug 5366,2020-08-13,10:00:00,95,61,34,FMN GV 16 Berchem TOT
54,Posthofbrug 5366,2020-08-13,11:00:00,106,61,45,FMN GV 16 Berchem TOT
54,Posthofbrug 5366,2020-08-13,12:00:00,79,40,39,FMN GV 16 Berchem TOT
54,Posthofbrug 5366,2020-08-13,13:00:00,91,38,53,FMN GV 16 Berchem TOT
54,Posthofbrug 5366,2020-08-13,14:00:00,105,50,55,FMN GV 16 Berchem TOT
54,Posthofbrug 5366,2020-08-13,15:00:00,124,59,65,FMN GV 16 Berchem TOT
54,Posthofbrug 5366,2020-08-13,16:00:00,156,57,99,FMN GV 16 Berchem TOT
54,Posthofbrug 5366,2020-08-13,17:00:00,238,85,153,FMN GV 16 Berchem TOT
54,Posthofbrug 5366,2020-08-13,18:00:00,143,54,89,FMN GV 16 Berchem TOT
54,Posthofbrug 5366,2020-08-13,19:00:00,80,30,50,FMN GV 16 Berchem TOT
54,Posthofbrug 5366,2020-08-13,20:00:00,67,38,29,FMN GV 16 Berchem TOT
54,Posthofbrug 5366,2020-08-13,21:00:00,64,36,28,FMN GV 16 Berchem TOT
54,Posthofbrug 5366,2020-08-13,22:00:00,51,27,24,FMN GV 16 Berchem TOT
54,Posthofbrug 5366,2020-08-13,23:00:00,34,15,19,FMN GV 16 Berchem TOT
54,Posthofbrug 5366,2020-08-14,00:00:00,23,8,15,FMN GV 16 Berchem TOT
54,Posthofbrug 5366,2020-08-14,01:00:00,19,2,17,FMN GV 16 Berchem TOT
54,Posthofbrug 5366,2020-08-14,02:00:00,0,0,0,FMN GV 16 Berchem TOT
54,Posthofbrug 5366,2020-08-14,03:00:00,2,2,0,FMN GV 16 Berchem TOT
54,Posthofbrug 5366,2020-08-14,04:00:00,13,11,2,FMN GV 16 Berchem TOT
54,Posthofbrug 5366,2020-08-14,05:00:00,17,15,2,FMN GV 16 Berchem TOT
54,Posthofbrug 5366,2020-08-14,06:00:00,68,38,30,FMN GV 16 Berchem TOT
54,Posthofbrug 5366,2020-08-14,07:00:00,135,81,54,FMN GV 16 Berchem TOT
54,Posthofbrug 5366,2020-08-14,08:00:00,189,120,69,FMN GV 16 Berchem TOT
54,Posthofbrug 5366,2020-08-14,09:00:00,126,90,36,FMN GV 16 Berchem TOT
54,Posthofbrug 5366,2020-08-14,10:00:00,101,66,35,FMN GV 16 Berchem TOT
54,Posthofbrug 5366,2020-08-14,11:00:00,101,50,51,FMN GV 16 Berchem TOT
54,Posthofbrug 5366,2020-08-14,12:00:00,128,63,65,FMN GV 16 Berchem TOT
54,Posthofbrug 5366,2020-08-14,13:00:00,128,58,70,FMN GV 16 Berchem TOT
54,Posthofbrug 5366,2020-08-14,14:00:00,86,39,47,FMN GV 16 Berchem TOT
54,Posthofbrug 5366,2020-08-14,15:00:00,130,63,67,FMN GV 16 Berchem TOT
54,Posthofbrug 5366,2020-08-14,16:00:00,172,82,90,FMN GV 16 Berchem TOT
54,Posthofbrug 5366,2020-08-14,17:00:00,198,75,123,FMN GV 16 Berchem TOT
54,Posthofbrug 5366,2020-08-14,18:00:00,155,67,88,FMN GV 16 Berchem TOT
54,Posthofbrug 5366,2020-08-14,19:00:00,103,57,46,FMN GV 16 Berchem TOT
54,Posthofbrug 5366,2020-08-14,20:00:00,104,47,57,FMN GV 16 Berchem TOT
54,Posthofbrug 5366,2020-08-14,21:00:00,77,38,39,FMN GV 16 Berchem TOT
54,Posthofbrug 5366,2020-08-14,22:00:00,71,31,40,FMN GV 16 Berchem TOT
54,Posthofbrug 5366,2020-08-14,23:00:00,29,12,17,FMN GV 16 Berchem TOT
54,Posthofbrug 5366,2020-08-15,00:00:00,23,8,15,FMN GV 16 Berchem TOT
54,Posthofbrug 5366,2020-08-15,01:00:00,24,9,15,FMN GV 16 Berchem TOT
54,Posthofbrug 5366,2020-08-15,02:00:00,3,0,3,FMN GV 16 Berchem TOT
54,Posthofbrug 5366,2020-08-15,03:00:00,1,0,1,FMN GV 16 Berchem TOT
54,Posthofbrug 5366,2020-08-15,04:00:00,5,4,1,FMN GV 16 Berchem TOT
54,Posthofbrug 5366,2020-08-15,05:00:00,6,4,2,FMN GV 16 Berchem TOT
54,Posthofbrug 5366,2020-08-15,06:00:00,21,17,4,FMN GV 16 Berchem TOT
54,Posthofbrug 5366,2020-08-15,07:00:00,37,23,14,FMN GV 16 Berchem TOT
54,Posthofbrug 5366,2020-08-15,08:00:00,48,28,20,FMN GV 16 Berchem TOT
54,Posthofbrug 5366,2020-08-15,09:00:00,116,64,52,FMN GV 16 Berchem TOT
54,Posthofbrug 5366,2020-08-15,10:00:00,134,78,56,FMN GV 16 Berchem TOT
54,Posthofbrug 5366,2020-08-15,11:00:00,135,69,66,FMN GV 16 Berchem TOT
54,Posthofbrug 5366,2020-08-15,12:00:00,141,69,72,FMN GV 16 Berchem TOT
54,Posthofbrug 5366,2020-08-15,13:00:00,155,76,79,FMN GV 16 Berchem TOT
54,Posthofbrug 5366,2020-08-15,14:00:00,155,69,86,FMN GV 16 Berchem TOT
54,Posthofbrug 5366,2020-08-15,15:00:00,166,81,85,FMN GV 16 Berchem TOT
54,Posthofbrug 5366,2020-08-15,16:00:00,148,77,71,FMN GV 16 Berchem TOT
54,Posthofbrug 5366,2020-08-15,17:00:00,172,94,78,FMN GV 16 Berchem TOT
54,Posthofbrug 5366,2020-08-15,18:00:00,86,48,38,FMN GV 16 Berchem TOT
54,Posthofbrug 5366,2020-08-15,19:00:00,78,35,43,FMN GV 16 Berchem TOT
54,Posthofbrug 5366,2020-08-15,20:00:00,67,39,28,FMN GV 16 Berchem TOT
54,Posthofbrug 5366,2020-08-15,21:00:00,68,45,23,FMN GV 16 Berchem TOT
54,Posthofbrug 5366,2020-08-15,22:00:00,60,30,30,FMN GV 16 Berchem TOT
54,Posthofbrug 5366,2020-08-15,23:00:00,39,20,19,FMN GV 16 Berchem TOT
54,Posthofbrug 5366,2020-08-16,00:00:00,34,16,18,FMN GV 16 Berchem TOT
54,Posthofbrug 5366,2020-08-16,01:00:00,32,11,21,FMN GV 16 Berchem TOT
54,Posthofbrug 5366,2020-08-16,02:00:00,2,0,2,FMN GV 16 Berchem TOT
54,Posthofbrug 5366,2020-08-16,03:00:00,1,1,0,FMN GV 16 Berchem TOT
54,Posthofbrug 5366,2020-08-16,04:00:00,3,3,0,FMN GV 16 Berchem TOT
54,Posthofbrug 5366,2020-08-16,05:00:00,4,3,1,FMN GV 16 Berchem TOT
54,Posthofbrug 5366,2020-08-16,06:00:00,11,10,1,FMN GV 16 Berchem TOT
54,Posthofbrug 5366,2020-08-16,07:00:00,30,15,15,FMN GV 16 Berchem TOT
54,Posthofbrug 5366,2020-08-16,08:00:00,69,33,36,FMN GV 16 Berchem TOT
54,Posthofbrug 5366,2020-08-16,09:00:00,92,55,37,FMN GV 16 Berchem TOT
54,Posthofbrug 5366,2020-08-16,10:00:00,141,69,72,FMN GV 16 Berchem TOT
54,Posthofbrug 5366,2020-08-16,11:00:00,140,66,74,FMN GV 16 Berchem TOT
54,Posthofbrug 5366,2020-08-16,12:00:00,151,95,56,FMN GV 16 Berchem TOT
54,Posthofbrug 5366,2020-08-16,13:00:00,150,84,66,FMN GV 16 Berchem TOT
54,Posthofbrug 5366,2020-08-16,14:00:00,210,112,98,FMN GV 16 Berchem TOT
54,Posthofbrug 5366,2020-08-16,15:00:00,90,44,46,FMN GV 16 Berchem TOT
54,Posthofbrug 5366,2020-08-16,16:00:00,155,66,89,FMN GV 16 Berchem TOT
54,Posthofbrug 5366,2020-08-16,17:00:00,69,48,21,FMN GV 16 Berchem TOT
54,Posthofbrug 5366,2020-08-16,18:00:00,105,47,58,FMN GV 16 Berchem TOT
54,Posthofbrug 5366,2020-08-16,19:00:00,69,27,42,FMN GV 16 Berchem TOT
54,Posthofbrug 5366,2020-08-16,20:00:00,70,38,32,FMN GV 16 Berchem TOT
54,Posthofbrug 5366,2020-08-16,21:00:00,49,31,18,FMN GV 16 Berchem TOT
54,Posthofbrug 5366,2020-08-16,22:00:00,46,22,24,FMN GV 16 Berchem TOT
54,Posthofbrug 5366,2020-08-16,23:00:00,19,9,10,FMN GV 16 Berchem TOT
54,Posthofbrug 5366,2020-08-17,00:00:00,18,4,14,FMN GV 16 Berchem TOT
54,Posthofbrug 5366,2020-08-17,01:00:00,10,4,6,FMN GV 16 Berchem TOT
54,Posthofbrug 5366,2020-08-17,02:00:00,0,0,0,FMN GV 16 Berchem TOT
54,Posthofbrug 5366,2020-08-17,03:00:00,3,2,1,FMN GV 16 Berchem TOT
54,Posthofbrug 5366,2020-08-17,04:00:00,11,9,2,FMN GV 16 Berchem TOT
54,Posthofbrug 5366,2020-08-17,05:00:00,8,5,3,FMN GV 16 Berchem TOT
54,Posthofbrug 5366,2020-08-17,06:00:00,50,38,12,FMN GV 16 Berchem TOT
54,Posthofbrug 5366,2020-08-17,07:00:00,158,110,48,FMN GV 16 Berchem TOT
54,Posthofbrug 5366,2020-08-17,08:00:00,208,138,70,FMN GV 16 Berchem TOT
54,Posthofbrug 5366,2020-08-17,09:00:00,124,89,35,FMN GV 16 Berchem TOT
54,Posthofbrug 5366,2020-08-17,10:00:00,127,68,59,FMN GV 16 Berchem TOT
54,Posthofbrug 5366,2020-08-17,11:00:00,106,68,38,FMN GV 16 Berchem TOT
54,Posthofbrug 5366,2020-08-17,12:00:00,148,73,75,FMN GV 16 Berchem TOT
54,Posthofbrug 5366,2020-08-17,13:00:00,116,63,53,FMN GV 16 Berchem TOT
54,Posthofbrug 5366,2020-08-17,14:00:00,134,67,67,FMN GV 16 Berchem TOT
54,Posthofbrug 5366,2020-08-17,15:00:00,135,48,87,FMN GV 16 Berchem TOT
54,Posthofbrug 5366,2020-08-17,16:00:00,187,82,105,FMN GV 16 Berchem TOT
54,Posthofbrug 5366,2020-08-17,17:00:00,219,79,140,FMN GV 16 Berchem TOT
54,Posthofbrug 5366,2020-08-17,18:00:00,220,85,135,FMN GV 16 Berchem TOT
54,Posthofbrug 5366,2020-08-17,19:00:00,103,44,59,FMN GV 16 Berchem TOT
54,Posthofbrug 5366,2020-08-17,20:00:00,101,55,46,FMN GV 16 Berchem TOT
54,Posthofbrug 5366,2020-08-17,21:00:00,63,40,23,FMN GV 16 Berchem TOT
54,Posthofbrug 5366,2020-08-17,22:00:00,50,27,23,FMN GV 16 Berchem TOT
54,Posthofbrug 5366,2020-08-17,23:00:00,19,11,8,FMN GV 16 Berchem TOT
54,Posthofbrug 5366,2020-08-18,00:00:00,15,4,11,FMN GV 16 Berchem TOT
54,Posthofbrug 5366,2020-08-18,01:00:00,19,1,18,FMN GV 16 Berchem TOT
54,Posthofbrug 5366,2020-08-18,02:00:00,0,0,0,FMN GV 16 Berchem TOT
54,Posthofbrug 5366,2020-08-18,03:00:00,0,0,0,FMN GV 16 Berchem TOT
54,Posthofbrug 5366,2020-08-18,04:00:00,10,8,2,FMN GV 16 Berchem TOT
54,Posthofbrug 5366,2020-08-18,05:00:00,22,16,6,FMN GV 16 Berchem TOT
54,Posthofbrug 5366,2020-08-18,06:00:00,57,40,17,FMN GV 16 Berchem TOT
54,Posthofbrug 5366,2020-08-18,07:00:00,205,138,67,FMN GV 16 Berchem TOT
54,Posthofbrug 5366,2020-08-18,08:00:00,249,171,78,FMN GV 16 Berchem TOT
54,Posthofbrug 5366,2020-08-18,09:00:00,160,125,35,FMN GV 16 Berchem TOT
54,Posthofbrug 5366,2020-08-18,10:00:00,114,74,40,FMN GV 16 Berchem TOT
54,Posthofbrug 5366,2020-08-18,11:00:00,102,45,57,FMN GV 16 Berchem TOT
54,Posthofbrug 5366,2020-08-18,12:00:00,114,58,56,FMN GV 16 Berchem TOT
54,Posthofbrug 5366,2020-08-18,13:00:00,144,88,56,FMN GV 16 Berchem TOT
54,Posthofbrug 5366,2020-08-18,14:00:00,146,78,68,FMN GV 16 Berchem TOT
54,Posthofbrug 5366,2020-08-18,15:00:00,171,74,97,FMN GV 16 Berchem TOT
54,Posthofbrug 5366,2020-08-18,16:00:00,213,95,118,FMN GV 16 Berchem TOT
54,Posthofbrug 5366,2020-08-18,17:00:00,260,84,176,FMN GV 16 Berchem TOT
54,Posthofbrug 5366,2020-08-18,18:00:00,254,94,160,FMN GV 16 Berchem TOT
54,Posthofbrug 5366,2020-08-18,19:00:00,149,63,86,FMN GV 16 Berchem TOT
54,Posthofbrug 5366,2020-08-18,20:00:00,120,78,42,FMN GV 16 Berchem TOT
54,Posthofbrug 5366,2020-08-18,21:00:00,95,59,36,FMN GV 16 Berchem TOT
54,Posthofbrug 5366,2020-08-18,22:00:00,70,33,37,FMN GV 16 Berchem TOT
54,Posthofbrug 5366,2020-08-18,23:00:00,48,25,23,FMN GV 16 Berchem TOT
54,Posthofbrug 5366,2020-08-19,00:00:00,24,5,19,FMN GV 16 Berchem TOT
54,Posthofbrug 5366,2020-08-19,01:00:00,10,1,9,FMN GV 16 Berchem TOT
54,Posthofbrug 5366,2020-08-19,02:00:00,3,3,0,FMN GV 16 Berchem TOT
54,Posthofbrug 5366,2020-08-19,03:00:00,1,0,1,FMN GV 16 Berchem TOT
54,Posthofbrug 5366,2020-08-19,04:00:00,8,6,2,FMN GV 16 Berchem TOT
54,Posthofbrug 5366,2020-08-19,05:00:00,28,18,10,FMN GV 16 Berchem TOT
54,Posthofbrug 5366,2020-08-19,06:00:00,65,44,21,FMN GV 16 Berchem TOT
54,Posthofbrug 5366,2020-08-19,07:00:00,167,104,63,FMN GV 16 Berchem TOT
54,Posthofbrug 5366,2020-08-19,08:00:00,197,143,54,FMN GV 16 Berchem TOT
54,Posthofbrug 5366,2020-08-19,09:00:00,159,104,55,FMN GV 16 Berchem TOT
54,Posthofbrug 5366,2020-08-19,10:00:00,117,79,38,FMN GV 16 Berchem TOT
54,Posthofbrug 5366,2020-08-19,11:00:00,101,63,38,FMN GV 16 Berchem TOT
54,Posthofbrug 5366,2020-08-19,12:00:00,131,75,56,FMN GV 16 Berchem TOT
54,Posthofbrug 5366,2020-08-19,13:00:00,157,94,63,FMN GV 16 Berchem TOT
54,Posthofbrug 5366,2020-08-19,14:00:00,170,83,87,FMN GV 16 Berchem TOT
54,Posthofbrug 5366,2020-08-19,15:00:00,163,65,98,FMN GV 16 Berchem TOT
54,Posthofbrug 5366,2020-08-19,16:00:00,222,81,141,FMN GV 16 Berchem TOT
54,Posthofbrug 5366,2020-08-19,17:00:00,296,100,196,FMN GV 16 Berchem TOT
54,Posthofbrug 5366,2020-08-19,18:00:00,217,85,132,FMN GV 16 Berchem TOT
54,Posthofbrug 5366,2020-08-19,19:00:00,107,52,55,FMN GV 16 Berchem TOT
54,Posthofbrug 5366,2020-08-19,20:00:00,80,43,37,FMN GV 16 Berchem TOT
54,Posthofbrug 5366,2020-08-19,21:00:00,56,35,21,FMN GV 16 Berchem TOT
54,Posthofbrug 5366,2020-08-19,22:00:00,40,18,22,FMN GV 16 Berchem TOT
54,Posthofbrug 5366,2020-08-19,23:00:00,25,10,15,FMN GV 16 Berchem TOT
54,Posthofbrug 5366,2020-08-20,00:00:00,15,3,12,FMN GV 16 Berchem TOT
54,Posthofbrug 5366,2020-08-20,01:00:00,16,2,14,FMN GV 16 Berchem TOT
54,Posthofbrug 5366,2020-08-20,02:00:00,0,0,0,FMN GV 16 Berchem TOT
54,Posthofbrug 5366,2020-08-20,03:00:00,1,0,1,FMN GV 16 Berchem TOT
54,Posthofbrug 5366,2020-08-20,04:00:00,9,8,1,FMN GV 16 Berchem TOT
54,Posthofbrug 5366,2020-08-20,05:00:00,28,19,9,FMN GV 16 Berchem TOT
54,Posthofbrug 5366,2020-08-20,06:00:00,60,41,19,FMN GV 16 Berchem TOT
54,Posthofbrug 5366,2020-08-20,07:00:00,184,104,80,FMN GV 16 Berchem TOT
54,Posthofbrug 5366,2020-08-20,08:00:00,260,190,70,FMN GV 16 Berchem TOT
54,Posthofbrug 5366,2020-08-20,09:00:00,142,100,42,FMN GV 16 Berchem TOT
54,Posthofbrug 5366,2020-08-20,10:00:00,135,89,46,FMN GV 16 Berchem TOT
54,Posthofbrug 5366,2020-08-20,11:00:00,99,53,46,FMN GV 16 Berchem TOT
54,Posthofbrug 5366,2020-08-20,12:00:00,121,63,58,FMN GV 16 Berchem TOT
54,Posthofbrug 5366,2020-08-20,13:00:00,132,73,59,FMN GV 16 Berchem TOT
54,Posthofbrug 5366,2020-08-20,14:00:00,135,56,79,FMN GV 16 Berchem TOT
54,Posthofbrug 5366,2020-08-20,15:00:00,159,72,87,FMN GV 16 Berchem TOT
54,Posthofbrug 5366,2020-08-20,16:00:00,198,90,108,FMN GV 16 Berchem TOT
54,Posthofbrug 5366,2020-08-20,17:00:00,322,120,202,FMN GV 16 Berchem TOT
54,Posthofbrug 5366,2020-08-20,18:00:00,214,86,128,FMN GV 16 Berchem TOT
54,Posthofbrug 5366,2020-08-20,19:00:00,161,67,94,FMN GV 16 Berchem TOT
54,Posthofbrug 5366,2020-08-20,20:00:00,134,74,60,FMN GV 16 Berchem TOT
54,Posthofbrug 5366,2020-08-20,21:00:00,84,45,39,FMN GV 16 Berchem TOT
54,Posthofbrug 5366,2020-08-20,22:00:00,75,32,43,FMN GV 16 Berchem TOT
54,Posthofbrug 5366,2020-08-20,23:00:00,57,31,26,FMN GV 16 Berchem TOT
54,Posthofbrug 5366,2020-08-21,00:00:00,30,16,14,FMN GV 16 Berchem TOT
54,Posthofbrug 5366,2020-08-21,01:00:00,29,6,23,FMN GV 16 Berchem TOT
54,Posthofbrug 5366,2020-08-21,02:00:00,4,2,2,FMN GV 16 Berchem TOT
54,Posthofbrug 5366,2020-08-21,03:00:00,1,0,1,FMN GV 16 Berchem TOT
54,Posthofbrug 5366,2020-08-21,04:00:00,13,10,3,FMN GV 16 Berchem TOT
54,Posthofbrug 5366,2020-08-21,05:00:00,16,14,2,FMN GV 16 Berchem TOT
54,Posthofbrug 5366,2020-08-21,06:00:00,60,43,17,FMN GV 16 Berchem TOT
54,Posthofbrug 5366,2020-08-21,07:00:00,124,86,38,FMN GV 16 Berchem TOT
54,Posthofbrug 5366,2020-08-21,08:00:00,173,121,52,FMN GV 16 Berchem TOT
54,Posthofbrug 5366,2020-08-21,09:00:00,124,87,37,FMN GV 16 Berchem TOT
54,Posthofbrug 5366,2020-08-21,10:00:00,95,58,37,FMN GV 16 Berchem TOT
54,Posthofbrug 5366,2020-08-21,11:00:00,113,72,41,FMN GV 16 Berchem TOT
54,Posthofbrug 5366,2020-08-21,12:00:00,164,86,78,FMN GV 16 Berchem TOT
54,Posthofbrug 5366,2020-08-21,13:00:00,154,83,71,FMN GV 16 Berchem TOT
54,Posthofbrug 5366,2020-08-21,14:00:00,169,83,86,FMN GV 16 Berchem TOT
54,Posthofbrug 5366,2020-08-21,15:00:00,163,69,94,FMN GV 16 Berchem TOT
54,Posthofbrug 5366,2020-08-21,16:00:00,195,87,108,FMN GV 16 Berchem TOT
54,Posthofbrug 5366,2020-08-21,17:00:00,253,88,165,FMN GV 16 Berchem TOT
54,Posthofbrug 5366,2020-08-21,18:00:00,170,65,105,FMN GV 16 Berchem TOT
54,Posthofbrug 5366,2020-08-21,19:00:00,145,85,60,FMN GV 16 Berchem TOT
54,Posthofbrug 5366,2020-08-21,20:00:00,119,68,51,FMN GV 16 Berchem TOT
54,Posthofbrug 5366,2020-08-21,21:00:00,77,45,32,FMN GV 16 Berchem TOT
54,Posthofbrug 5366,2020-08-21,22:00:00,64,24,40,FMN GV 16 Berchem TOT
54,Posthofbrug 5366,2020-08-21,23:00:00,57,25,32,FMN GV 16 Berchem TOT
54,Posthofbrug 5366,2020-08-22,00:00:00,35,16,19,FMN GV 16 Berchem TOT
54,Posthofbrug 5366,2020-08-22,01:00:00,74,25,49,FMN GV 16 Berchem TOT
54,Posthofbrug 5366,2020-08-22,02:00:00,2,2,0,FMN GV 16 Berchem TOT
54,Posthofbrug 5366,2020-08-22,03:00:00,2,2,0,FMN GV 16 Berchem TOT
54,Posthofbrug 5366,2020-08-22,04:00:00,4,4,0,FMN GV 16 Berchem TOT
54,Posthofbrug 5366,2020-08-22,05:00:00,13,7,6,FMN GV 16 Berchem TOT
54,Posthofbrug 5366,2020-08-22,06:00:00,22,17,5,FMN GV 16 Berchem TOT
54,Posthofbrug 5366,2020-08-22,07:00:00,28,16,12,FMN GV 16 Berchem TOT
54,Posthofbrug 5366,2020-08-22,08:00:00,42,19,23,FMN GV 16 Berchem TOT
54,Posthofbrug 5366,2020-08-22,09:00:00,71,48,23,FMN GV 16 Berchem TOT
54,Posthofbrug 5366,2020-08-22,10:00:00,133,74,59,FMN GV 16 Berchem TOT
54,Posthofbrug 5366,2020-08-22,11:00:00,139,69,70,FMN GV 16 Berchem TOT
54,Posthofbrug 5366,2020-08-22,12:00:00,159,93,66,FMN GV 16 Berchem TOT
54,Posthofbrug 5366,2020-08-22,13:00:00,158,104,54,FMN GV 16 Berchem TOT
54,Posthofbrug 5366,2020-08-22,14:00:00,136,72,64,FMN GV 16 Berchem TOT
54,Posthofbrug 5366,2020-08-22,15:00:00,126,54,72,FMN GV 16 Berchem TOT
54,Posthofbrug 5366,2020-08-22,16:00:00,153,91,62,FMN GV 16 Berchem TOT
54,Posthofbrug 5366,2020-08-22,17:00:00,131,61,70,FMN GV 16 Berchem TOT
54,Posthofbrug 5366,2020-08-22,18:00:00,143,56,87,FMN GV 16 Berchem TOT
54,Posthofbrug 5366,2020-08-22,19:00:00,104,47,57,FMN GV 16 Berchem TOT
54,Posthofbrug 5366,2020-08-22,20:00:00,101,55,46,FMN GV 16 Berchem TOT
54,Posthofbrug 5366,2020-08-22,21:00:00,61,38,23,FMN GV 16 Berchem TOT
54,Posthofbrug 5366,2020-08-22,22:00:00,60,23,37,FMN GV 16 Berchem TOT
54,Posthofbrug 5366,2020-08-22,23:00:00,41,18,23,FMN GV 16 Berchem TOT
54,Posthofbrug 5366,2020-08-23,00:00:00,32,5,27,FMN GV 16 Berchem TOT
54,Posthofbrug 5366,2020-08-23,01:00:00,41,16,25,FMN GV 16 Berchem TOT
54,Posthofbrug 5366,2020-08-23,02:00:00,3,0,3,FMN GV 16 Berchem TOT
54,Posthofbrug 5366,2020-08-23,03:00:00,3,1,2,FMN GV 16 Berchem TOT
54,Posthofbrug 5366,2020-08-23,04:00:00,3,2,1,FMN GV 16 Berchem TOT
54,Posthofbrug 5366,2020-08-23,05:00:00,11,5,6,FMN GV 16 Berchem TOT
54,Posthofbrug 5366,2020-08-23,06:00:00,13,9,4,FMN GV 16 Berchem TOT
54,Posthofbrug 5366,2020-08-23,07:00:00,25,14,11,FMN GV 16 Berchem TOT
54,Posthofbrug 5366,2020-08-23,08:00:00,37,15,22,FMN GV 16 Berchem TOT
54,Posthofbrug 5366,2020-08-23,09:00:00,75,50,25,FMN GV 16 Berchem TOT
54,Posthofbrug 5366,2020-08-23,10:00:00,80,45,35,FMN GV 16 Berchem TOT
54,Posthofbrug 5366,2020-08-23,11:00:00,74,40,34,FMN GV 16 Berchem TOT
54,Posthofbrug 5366,2020-08-23,12:00:00,97,47,50,FMN GV 16 Berchem TOT
54,Posthofbrug 5366,2020-08-23,13:00:00,150,77,73,FMN GV 16 Berchem TOT
54,Posthofbrug 5366,2020-08-23,14:00:00,134,73,61,FMN GV 16 Berchem TOT
54,Posthofbrug 5366,2020-08-23,15:00:00,145,67,78,FMN GV 16 Berchem TOT
54,Posthofbrug 5366,2020-08-23,16:00:00,143,78,65,FMN GV 16 Berchem TOT
54,Posthofbrug 5366,2020-08-23,17:00:00,158,59,99,FMN GV 16 Berchem TOT
54,Posthofbrug 5366,2020-08-23,18:00:00,142,69,73,FMN GV 16 Berchem TOT
54,Posthofbrug 5366,2020-08-23,19:00:00,81,49,32,FMN GV 16 Berchem TOT
54,Posthofbrug 5366,2020-08-23,20:00:00,76,45,31,FMN GV 16 Berchem TOT
54,Posthofbrug 5366,2020-08-23,21:00:00,59,34,25,FMN GV 16 Berchem TOT
54,Posthofbrug 5366,2020-08-23,22:00:00,23,12,11,FMN GV 16 Berchem TOT
54,Posthofbrug 5366,2020-08-23,23:00:00,21,14,7,FMN GV 16 Berchem TOT
54,Posthofbrug 5366,2020-08-24,00:00:00,6,2,4,FMN GV 16 Berchem TOT
54,Posthofbrug 5366,2020-08-24,01:00:00,6,0,6,FMN GV 16 Berchem TOT
54,Posthofbrug 5366,2020-08-24,02:00:00,1,0,1,FMN GV 16 Berchem TOT
54,Posthofbrug 5366,2020-08-24,03:00:00,2,2,0,FMN GV 16 Berchem TOT
54,Posthofbrug 5366,2020-08-24,04:00:00,8,6,2,FMN GV 16 Berchem TOT
54,Posthofbrug 5366,2020-08-24,05:00:00,22,17,5,FMN GV 16 Berchem TOT
54,Posthofbrug 5366,2020-08-24,06:00:00,72,52,20,FMN GV 16 Berchem TOT
54,Posthofbrug 5366,2020-08-24,07:00:00,190,146,44,FMN GV 16 Berchem TOT
54,Posthofbrug 5366,2020-08-24,08:00:00,262,184,78,FMN GV 16 Berchem TOT
54,Posthofbrug 5366,2020-08-24,09:00:00,171,126,45,FMN GV 16 Berchem TOT
54,Posthofbrug 5366,2020-08-24,10:00:00,105,71,34,FMN GV 16 Berchem TOT
54,Posthofbrug 5366,2020-08-24,11:00:00,85,50,35,FMN GV 16 Berchem TOT
54,Posthofbrug 5366,2020-08-24,12:00:00,114,62,52,FMN GV 16 Berchem TOT
54,Posthofbrug 5366,2020-08-24,13:00:00,158,88,70,FMN GV 16 Berchem TOT
54,Posthofbrug 5366,2020-08-24,14:00:00,129,73,56,FMN GV 16 Berchem TOT
54,Posthofbrug 5366,2020-08-24,15:00:00,162,56,106,FMN GV 16 Berchem TOT
54,Posthofbrug 5366,2020-08-24,16:00:00,261,103,158,FMN GV 16 Berchem TOT
54,Posthofbrug 5366,2020-08-24,17:00:00,261,73,188,FMN GV 16 Berchem TOT
54,Posthofbrug 5366,2020-08-24,18:00:00,189,68,121,FMN GV 16 Berchem TOT
54,Posthofbrug 5366,2020-08-24,19:00:00,113,59,54,FMN GV 16 Berchem TOT
54,Posthofbrug 5366,2020-08-24,20:00:00,105,60,45,FMN GV 16 Berchem TOT
54,Posthofbrug 5366,2020-08-24,21:00:00,69,39,30,FMN GV 16 Berchem TOT
54,Posthofbrug 5366,2020-08-24,22:00:00,54,17,37,FMN GV 16 Berchem TOT
54,Posthofbrug 5366,2020-08-24,23:00:00,27,11,16,FMN GV 16 Berchem TOT
54,Posthofbrug 5366,2020-08-25,00:00:00,16,6,10,FMN GV 16 Berchem TOT
54,Posthofbrug 5366,2020-08-25,01:00:00,20,2,18,FMN GV 16 Berchem TOT
54,Posthofbrug 5366,2020-08-25,02:00:00,1,1,0,FMN GV 16 Berchem TOT
54,Posthofbrug 5366,2020-08-25,03:00:00,1,0,1,FMN GV 16 Berchem TOT
54,Posthofbrug 5366,2020-08-25,04:00:00,7,4,3,FMN GV 16 Berchem TOT
54,Posthofbrug 5366,2020-08-25,05:00:00,20,15,5,FMN GV 16 Berchem TOT
54,Posthofbrug 5366,2020-08-25,06:00:00,76,58,18,FMN GV 16 Berchem TOT
54,Posthofbrug 5366,2020-08-25,07:00:00,195,137,58,FMN GV 16 Berchem TOT
54,Posthofbrug 5366,2020-08-25,08:00:00,299,217,82,FMN GV 16 Berchem TOT
54,Posthofbrug 5366,2020-08-25,09:00:00,129,90,39,FMN GV 16 Berchem TOT
54,Posthofbrug 5366,2020-08-25,10:00:00,82,58,24,FMN GV 16 Berchem TOT
54,Posthofbrug 5366,2020-08-25,11:00:00,92,59,33,FMN GV 16 Berchem TOT
54,Posthofbrug 5366,2020-08-25,12:00:00,86,54,32,FMN GV 16 Berchem TOT
54,Posthofbrug 5366,2020-08-25,13:00:00,82,42,40,FMN GV 16 Berchem TOT
54,Posthofbrug 5366,2020-08-25,14:00:00,97,42,55,FMN GV 16 Berchem TOT
54,Posthofbrug 5366,2020-08-25,15:00:00,152,58,94,FMN GV 16 Berchem TOT
54,Posthofbrug 5366,2020-08-25,16:00:00,241,94,147,FMN GV 16 Berchem TOT
54,Posthofbrug 5366,2020-08-25,17:00:00,275,78,197,FMN GV 16 Berchem TOT
54,Posthofbrug 5366,2020-08-25,18:00:00,211,68,143,FMN GV 16 Berchem TOT
54,Posthofbrug 5366,2020-08-25,19:00:00,129,47,82,FMN GV 16 Berchem TOT
54,Posthofbrug 5366,2020-08-25,20:00:00,90,54,36,FMN GV 16 Berchem TOT
54,Posthofbrug 5366,2020-08-25,21:00:00,86,43,43,FMN GV 16 Berchem TOT
54,Posthofbrug 5366,2020-08-25,22:00:00,59,29,30,FMN GV 16 Berchem TOT
54,Posthofbrug 5366,2020-08-25,23:00:00,36,17,19,FMN GV 16 Berchem TOT
54,Posthofbrug 5366,2020-08-26,00:00:00,17,5,12,FMN GV 16 Berchem TOT
54,Posthofbrug 5366,2020-08-26,01:00:00,17,3,14,FMN GV 16 Berchem TOT
54,Posthofbrug 5366,2020-08-26,02:00:00,1,0,1,FMN GV 16 Berchem TOT
54,Posthofbrug 5366,2020-08-26,03:00:00,1,0,1,FMN GV 16 Berchem TOT
54,Posthofbrug 5366,2020-08-26,04:00:00,8,6,2,FMN GV 16 Berchem TOT
54,Posthofbrug 5366,2020-08-26,05:00:00,10,7,3,FMN GV 16 Berchem TOT
54,Posthofbrug 5366,2020-08-26,06:00:00,57,39,18,FMN GV 16 Berchem TOT
54,Posthofbrug 5366,2020-08-26,07:00:00,178,130,48,FMN GV 16 Berchem TOT
54,Posthofbrug 5366,2020-08-26,08:00:00,218,166,52,FMN GV 16 Berchem TOT
54,Posthofbrug 5366,2020-08-26,09:00:00,136,95,41,FMN GV 16 Berchem TOT
54,Posthofbrug 5366,2020-08-26,10:00:00,84,47,37,FMN GV 16 Berchem TOT
54,Posthofbrug 5366,2020-08-26,11:00:00,103,67,36,FMN GV 16 Berchem TOT
54,Posthofbrug 5366,2020-08-26,12:00:00,110,49,61,FMN GV 16 Berchem TOT
54,Posthofbrug 5366,2020-08-26,13:00:00,121,79,42,FMN GV 16 Berchem TOT
54,Posthofbrug 5366,2020-08-26,14:00:00,88,47,41,FMN GV 16 Berchem TOT
54,Posthofbrug 5366,2020-08-26,15:00:00,132,59,73,FMN GV 16 Berchem TOT
54,Posthofbrug 5366,2020-08-26,16:00:00,195,70,125,FMN GV 16 Berchem TOT
54,Posthofbrug 5366,2020-08-26,17:00:00,238,89,149,FMN GV 16 Berchem TOT
54,Posthofbrug 5366,2020-08-26,18:00:00,176,47,129,FMN GV 16 Berchem TOT
54,Posthofbrug 5366,2020-08-26,19:00:00,117,43,74,FMN GV 16 Berchem TOT
54,Posthofbrug 5366,2020-08-26,20:00:00,75,46,29,FMN GV 16 Berchem TOT
54,Posthofbrug 5366,2020-08-26,21:00:00,63,37,26,FMN GV 16 Berchem TOT
54,Posthofbrug 5366,2020-08-26,22:00:00,57,15,42,FMN GV 16 Berchem TOT
54,Posthofbrug 5366,2020-08-26,23:00:00,34,14,20,FMN GV 16 Berchem TOT
54,Posthofbrug 5366,2020-08-27,00:00:00,15,6,9,FMN GV 16 Berchem TOT
54,Posthofbrug 5366,2020-08-27,01:00:00,16,4,12,FMN GV 16 Berchem TOT
54,Posthofbrug 5366,2020-08-27,02:00:00,3,0,3,FMN GV 16 Berchem TOT
54,Posthofbrug 5366,2020-08-27,03:00:00,6,1,5,FMN GV 16 Berchem TOT
54,Posthofbrug 5366,2020-08-27,04:00:00,8,4,4,FMN GV 16 Berchem TOT
54,Posthofbrug 5366,2020-08-27,05:00:00,17,14,3,FMN GV 16 Berchem TOT
54,Posthofbrug 5366,2020-08-27,06:00:00,85,64,21,FMN GV 16 Berchem TOT
54,Posthofbrug 5366,2020-08-27,07:00:00,198,140,58,FMN GV 16 Berchem TOT
54,Posthofbrug 5366,2020-08-27,08:00:00,313,233,80,FMN GV 16 Berchem TOT
54,Posthofbrug 5366,2020-08-27,09:00:00,190,139,51,FMN GV 16 Berchem TOT
54,Posthofbrug 5366,2020-08-27,10:00:00,109,74,35,FMN GV 16 Berchem TOT
54,Posthofbrug 5366,2020-08-27,11:00:00,150,94,56,FMN GV 16 Berchem TOT
54,Posthofbrug 5366,2020-08-27,12:00:00,133,68,65,FMN GV 16 Berchem TOT
54,Posthofbrug 5366,2020-08-27,13:00:00,189,112,77,FMN GV 16 Berchem TOT
54,Posthofbrug 5366,2020-08-27,14:00:00,180,93,87,FMN GV 16 Berchem TOT
54,Posthofbrug 5366,2020-08-27,15:00:00,211,89,122,FMN GV 16 Berchem TOT
54,Posthofbrug 5366,2020-08-27,16:00:00,288,102,186,FMN GV 16 Berchem TOT
54,Posthofbrug 5366,2020-08-27,17:00:00,353,112,241,FMN GV 16 Berchem TOT
54,Posthofbrug 5366,2020-08-27,18:00:00,247,87,160,FMN GV 16 Berchem TOT
54,Posthofbrug 5366,2020-08-27,19:00:00,155,62,93,FMN GV 16 Berchem TOT
54,Posthofbrug 5366,2020-08-27,20:00:00,109,60,49,FMN GV 16 Berchem TOT
54,Posthofbrug 5366,2020-08-27,21:00:00,62,32,30,FMN GV 16 Berchem TOT
54,Posthofbrug 5366,2020-08-27,22:00:00,58,28,30,FMN GV 16 Berchem TOT
54,Posthofbrug 5366,2020-08-27,23:00:00,40,25,15,FMN GV 16 Berchem TOT
54,Posthofbrug 5366,2020-08-28,00:00:00,23,8,15,FMN GV 16 Berchem TOT
54,Posthofbrug 5366,2020-08-28,01:00:00,10,1,9,FMN GV 16 Berchem TOT
54,Posthofbrug 5366,2020-08-28,02:00:00,10,7,3,FMN GV 16 Berchem TOT
54,Posthofbrug 5366,2020-08-28,03:00:00,2,0,2,FMN GV 16 Berchem TOT
54,Posthofbrug 5366,2020-08-28,04:00:00,11,8,3,FMN GV 16 Berchem TOT
54,Posthofbrug 5366,2020-08-28,05:00:00,12,8,4,FMN GV 16 Berchem TOT
54,Posthofbrug 5366,2020-08-28,06:00:00,58,42,16,FMN GV 16 Berchem TOT
54,Posthofbrug 5366,2020-08-28,07:00:00,150,95,55,FMN GV 16 Berchem TOT
54,Posthofbrug 5366,2020-08-28,08:00:00,238,178,60,FMN GV 16 Berchem TOT
54,Posthofbrug 5366,2020-08-28,09:00:00,146,109,37,FMN GV 16 Berchem TOT
54,Posthofbrug 5366,2020-08-28,10:00:00,113,78,35,FMN GV 16 Berchem TOT
54,Posthofbrug 5366,2020-08-28,11:00:00,131,72,59,FMN GV 16 Berchem TOT
54,Posthofbrug 5366,2020-08-28,12:00:00,124,70,54,FMN GV 16 Berchem TOT
54,Posthofbrug 5366,2020-08-28,13:00:00,135,71,64,FMN GV 16 Berchem TOT
54,Posthofbrug 5366,2020-08-28,14:00:00,137,70,67,FMN GV 16 Berchem TOT
54,Posthofbrug 5366,2020-08-28,15:00:00,175,65,110,FMN GV 16 Berchem TOT
54,Posthofbrug 5366,2020-08-28,16:00:00,204,85,119,FMN GV 16 Berchem TOT
54,Posthofbrug 5366,2020-08-28,17:00:00,238,74,164,FMN GV 16 Berchem TOT
54,Posthofbrug 5366,2020-08-28,18:00:00,190,76,114,FMN GV 16 Berchem TOT
54,Posthofbrug 5366,2020-08-28,19:00:00,135,72,63,FMN GV 16 Berchem TOT
54,Posthofbrug 5366,2020-08-28,20:00:00,93,59,34,FMN GV 16 Berchem TOT
54,Posthofbrug 5366,2020-08-28,21:00:00,72,35,37,FMN GV 16 Berchem TOT
54,Posthofbrug 5366,2020-08-28,22:00:00,64,32,32,FMN GV 16 Berchem TOT
54,Posthofbrug 5366,2020-08-28,23:00:00,38,14,24,FMN GV 16 Berchem TOT
54,Posthofbrug 5366,2020-08-29,00:00:00,42,19,23,FMN GV 16 Berchem TOT
54,Posthofbrug 5366,2020-08-29,01:00:00,39,14,25,FMN GV 16 Berchem TOT
54,Posthofbrug 5366,2020-08-29,02:00:00,29,3,26,FMN GV 16 Berchem TOT
54,Posthofbrug 5366,2020-08-29,03:00:00,9,2,7,FMN GV 16 Berchem TOT
54,Posthofbrug 5366,2020-08-29,04:00:00,8,3,5,FMN GV 16 Berchem TOT
54,Posthofbrug 5366,2020-08-29,05:00:00,7,4,3,FMN GV 16 Berchem TOT
54,Posthofbrug 5366,2020-08-29,06:00:00,23,14,9,FMN GV 16 Berchem TOT
54,Posthofbrug 5366,2020-08-29,07:00:00,26,19,7,FMN GV 16 Berchem TOT
54,Posthofbrug 5366,2020-08-29,08:00:00,56,26,30,FMN GV 16 Berchem TOT
54,Posthofbrug 5366,2020-08-29,09:00:00,85,63,22,FMN GV 16 Berchem TOT
54,Posthofbrug 5366,2020-08-29,10:00:00,115,60,55,FMN GV 16 Berchem TOT
54,Posthofbrug 5366,2020-08-29,11:00:00,128,83,45,FMN GV 16 Berchem TOT
54,Posthofbrug 5366,2020-08-29,12:00:00,120,63,57,FMN GV 16 Berchem TOT
54,Posthofbrug 5366,2020-08-29,13:00:00,140,75,65,FMN GV 16 Berchem TOT
54,Posthofbrug 5366,2020-08-29,14:00:00,158,92,66,FMN GV 16 Berchem TOT
54,Posthofbrug 5366,2020-08-29,15:00:00,171,98,73,FMN GV 16 Berchem TOT
54,Posthofbrug 5366,2020-08-29,16:00:00,153,73,80,FMN GV 16 Berchem TOT
54,Posthofbrug 5366,2020-08-29,17:00:00,143,60,83,FMN GV 16 Berchem TOT
54,Posthofbrug 5366,2020-08-29,18:00:00,97,54,43,FMN GV 16 Berchem TOT
54,Posthofbrug 5366,2020-08-29,19:00:00,94,46,48,FMN GV 16 Berchem TOT
54,Posthofbrug 5366,2020-08-29,20:00:00,72,45,27,FMN GV 16 Berchem TOT
54,Posthofbrug 5366,2020-08-29,21:00:00,69,38,31,FMN GV 16 Berchem TOT
54,Posthofbrug 5366,2020-08-29,22:00:00,55,21,34,FMN GV 16 Berchem TOT
54,Posthofbrug 5366,2020-08-29,23:00:00,49,12,37,FMN GV 16 Berchem TOT
54,Posthofbrug 5366,2020-08-30,00:00:00,36,11,25,FMN GV 16 Berchem TOT
54,Posthofbrug 5366,2020-08-30,01:00:00,38,4,34,FMN GV 16 Berchem TOT
54,Posthofbrug 5366,2020-08-30,02:00:00,8,1,7,FMN GV 16 Berchem TOT
54,Posthofbrug 5366,2020-08-30,03:00:00,13,2,11,FMN GV 16 Berchem TOT
54,Posthofbrug 5366,2020-08-30,04:00:00,13,6,7,FMN GV 16 Berchem TOT
54,Posthofbrug 5366,2020-08-30,05:00:00,6,2,4,FMN GV 16 Berchem TOT
54,Posthofbrug 5366,2020-08-30,06:00:00,13,11,2,FMN GV 16 Berchem TOT
54,Posthofbrug 5366,2020-08-30,07:00:00,20,10,10,FMN GV 16 Berchem TOT
54,Posthofbrug 5366,2020-08-30,08:00:00,53,30,23,FMN GV 16 Berchem TOT
54,Posthofbrug 5366,2020-08-30,09:00:00,91,59,32,FMN GV 16 Berchem TOT
54,Posthofbrug 5366,2020-08-30,10:00:00,102,55,47,FMN GV 16 Berchem TOT
54,Posthofbrug 5366,2020-08-30,11:00:00,136,70,66,FMN GV 16 Berchem TOT
54,Posthofbrug 5366,2020-08-30,12:00:00,122,61,61,FMN GV 16 Berchem TOT
54,Posthofbrug 5366,2020-08-30,13:00:00,88,52,36,FMN GV 16 Berchem TOT
54,Posthofbrug 5366,2020-08-30,14:00:00,93,44,49,FMN GV 16 Berchem TOT
54,Posthofbrug 5366,2020-08-30,15:00:00,134,60,74,FMN GV 16 Berchem TOT
54,Posthofbrug 5366,2020-08-30,16:00:00,77,45,32,FMN GV 16 Berchem TOT
54,Posthofbrug 5366,2020-08-30,17:00:00,82,35,47,FMN GV 16 Berchem TOT
54,Posthofbrug 5366,2020-08-30,18:00:00,84,38,46,FMN GV 16 Berchem TOT
54,Posthofbrug 5366,2020-08-30,19:00:00,76,37,39,FMN GV 16 Berchem TOT
54,Posthofbrug 5366,2020-08-30,20:00:00,63,32,31,FMN GV 16 Berchem TOT
54,Posthofbrug 5366,2020-08-30,21:00:00,49,30,19,FMN GV 16 Berchem TOT
54,Posthofbrug 5366,2020-08-30,22:00:00,41,21,20,FMN GV 16 Berchem TOT
54,Posthofbrug 5366,2020-08-30,23:00:00,27,12,15,FMN GV 16 Berchem TOT
54,Posthofbrug 5366,2020-08-31,00:00:00,9,3,6,FMN GV 16 Berchem TOT
54,Posthofbrug 5366,2020-08-31,01:00:00,10,3,7,FMN GV 16 Berchem TOT
54,Posthofbrug 5366,2020-08-31,02:00:00,2,1,1,FMN GV 16 Berchem TOT
54,Posthofbrug 5366,2020-08-31,03:00:00,1,0,1,FMN GV 16 Berchem TOT
54,Posthofbrug 5366,2020-08-31,04:00:00,11,8,3,FMN GV 16 Berchem TOT
54,Posthofbrug 5366,2020-08-31,05:00:00,27,23,4,FMN GV 16 Berchem TOT
54,Posthofbrug 5366,2020-08-31,06:00:00,71,54,17,FMN GV 16 Berchem TOT
54,Posthofbrug 5366,2020-08-31,07:00:00,204,146,58,FMN GV 16 Berchem TOT
54,Posthofbrug 5366,2020-08-31,08:00:00,329,251,78,FMN GV 16 Berchem TOT
54,Posthofbrug 5366,2020-08-31,09:00:00,167,127,40,FMN GV 16 Berchem TOT
54,Posthofbrug 5366,2020-08-31,10:00:00,124,87,37,FMN GV 16 Berchem TOT
54,Posthofbrug 5366,2020-08-31,11:00:00,116,69,47,FMN GV 16 Berchem TOT
54,Posthofbrug 5366,2020-08-31,12:00:00,168,92,76,FMN GV 16 Berchem TOT
54,Posthofbrug 5366,2020-08-31,13:00:00,178,100,78,FMN GV 16 Berchem TOT
54,Posthofbrug 5366,2020-08-31,14:00:00,169,82,87,FMN GV 16 Berchem TOT
54,Posthofbrug 5366,2020-08-31,15:00:00,186,77,109,FMN GV 16 Berchem TOT
54,Posthofbrug 5366,2020-08-31,16:00:00,289,91,198,FMN GV 16 Berchem TOT
54,Posthofbrug 5366,2020-08-31,17:00:00,366,111,255,FMN GV 16 Berchem TOT
54,Posthofbrug 5366,2020-08-31,18:00:00,263,87,176,FMN GV 16 Berchem TOT
54,Posthofbrug 5366,2020-08-31,19:00:00,143,64,79,FMN GV 16 Berchem TOT
54,Posthofbrug 5366,2020-08-31,20:00:00,103,59,44,FMN GV 16 Berchem TOT
54,Posthofbrug 5366,2020-08-31,21:00:00,75,36,39,FMN GV 16 Berchem TOT
54,Posthofbrug 5366,2020-08-31,22:00:00,55,18,37,FMN GV 16 Berchem TOT
54,Posthofbrug 5366,2020-08-31,23:00:00,30,11,19,FMN GV 16 Berchem TOT
54,Posthofbrug 5366,2020-09-01,00:00:00,17,2,15,FMN GV 16 Berchem TOT
54,Posthofbrug 5366,2020-09-01,01:00:00,12,1,11,FMN GV 16 Berchem TOT
54,Posthofbrug 5366,2020-09-01,02:00:00,3,0,3,FMN GV 16 Berchem TOT
54,Posthofbrug 5366,2020-09-01,03:00:00,2,1,1,FMN GV 16 Berchem TOT
54,Posthofbrug 5366,2020-09-01,04:00:00,12,10,2,FMN GV 16 Berchem TOT
54,Posthofbrug 5366,2020-09-01,05:00:00,24,18,6,FMN GV 16 Berchem TOT
54,Posthofbrug 5366,2020-09-01,06:00:00,87,70,17,FMN GV 16 Berchem TOT
54,Posthofbrug 5366,2020-09-01,07:00:00,334,254,80,FMN GV 16 Berchem TOT
54,Posthofbrug 5366,2020-09-01,08:00:00,523,405,118,FMN GV 16 Berchem TOT
54,Posthofbrug 5366,2020-09-01,09:00:00,244,179,65,FMN GV 16 Berchem TOT
54,Posthofbrug 5366,2020-09-01,10:00:00,118,72,46,FMN GV 16 Berchem TOT
54,Posthofbrug 5366,2020-09-01,11:00:00,114,62,52,FMN GV 16 Berchem TOT
54,Posthofbrug 5366,2020-09-01,12:00:00,172,83,89,FMN GV 16 Berchem TOT
54,Posthofbrug 5366,2020-09-01,13:00:00,157,96,61,FMN GV 16 Berchem TOT
54,Posthofbrug 5366,2020-09-01,14:00:00,166,67,99,FMN GV 16 Berchem TOT
54,Posthofbrug 5366,2020-09-01,15:00:00,235,74,161,FMN GV 16 Berchem TOT
54,Posthofbrug 5366,2020-09-01,16:00:00,347,94,253,FMN GV 16 Berchem TOT
54,Posthofbrug 5366,2020-09-01,17:00:00,409,119,290,FMN GV 16 Berchem TOT
54,Posthofbrug 5366,2020-09-01,18:00:00,308,108,200,FMN GV 16 Berchem TOT
54,Posthofbrug 5366,2020-09-01,19:00:00,159,63,96,FMN GV 16 Berchem TOT
54,Posthofbrug 5366,2020-09-01,20:00:00,126,68,58,FMN GV 16 Berchem TOT
54,Posthofbrug 5366,2020-09-01,21:00:00,107,50,57,FMN GV 16 Berchem TOT
54,Posthofbrug 5366,2020-09-01,22:00:00,76,40,36,FMN GV 16 Berchem TOT
54,Posthofbrug 5366,2020-09-01,23:00:00,39,24,15,FMN GV 16 Berchem TOT
54,Posthofbrug 5366,2020-09-02,00:00:00,20,8,12,FMN GV 16 Berchem TOT
54,Posthofbrug 5366,2020-09-02,01:00:00,13,2,11,FMN GV 16 Berchem TOT
54,Posthofbrug 5366,2020-09-02,02:00:00,0,0,0,FMN GV 16 Berchem TOT
54,Posthofbrug 5366,2020-09-02,03:00:00,5,3,2,FMN GV 16 Berchem TOT
54,Posthofbrug 5366,2020-09-02,04:00:00,14,9,5,FMN GV 16 Berchem TOT
54,Posthofbrug 5366,2020-09-02,05:00:00,30,23,7,FMN GV 16 Berchem TOT
54,Posthofbrug 5366,2020-09-02,06:00:00,89,72,17,FMN GV 16 Berchem TOT
54,Posthofbrug 5366,2020-09-02,07:00:00,348,256,92,FMN GV 16 Berchem TOT
54,Posthofbrug 5366,2020-09-02,08:00:00,470,352,118,FMN GV 16 Berchem TOT
54,Posthofbrug 5366,2020-09-02,09:00:00,168,123,45,FMN GV 16 Berchem TOT
54,Posthofbrug 5366,2020-09-02,10:00:00,120,73,47,FMN GV 16 Berchem TOT
54,Posthofbrug 5366,2020-09-02,11:00:00,141,82,59,FMN GV 16 Berchem TOT
54,Posthofbrug 5366,2020-09-02,12:00:00,284,115,169,FMN GV 16 Berchem TOT
54,Posthofbrug 5366,2020-09-02,13:00:00,201,81,120,FMN GV 16 Berchem TOT
54,Posthofbrug 5366,2020-09-02,14:00:00,160,83,77,FMN GV 16 Berchem TOT
54,Posthofbrug 5366,2020-09-02,15:00:00,196,80,116,FMN GV 16 Berchem TOT
54,Posthofbrug 5366,2020-09-02,16:00:00,289,107,182,FMN GV 16 Berchem TOT
54,Posthofbrug 5366,2020-09-02,17:00:00,389,134,255,FMN GV 16 Berchem TOT
54,Posthofbrug 5366,2020-09-02,18:00:00,305,106,199,FMN GV 16 Berchem TOT
54,Posthofbrug 5366,2020-09-02,19:00:00,184,86,98,FMN GV 16 Berchem TOT
54,Posthofbrug 5366,2020-09-02,20:00:00,135,79,56,FMN GV 16 Berchem TOT
54,Posthofbrug 5366,2020-09-02,21:00:00,80,52,28,FMN GV 16 Berchem TOT
54,Posthofbrug 5366,2020-09-02,22:00:00,75,31,44,FMN GV 16 Berchem TOT
54,Posthofbrug 5366,2020-09-02,23:00:00,41,12,29,FMN GV 16 Berchem TOT
54,Posthofbrug 5366,2020-09-03,00:00:00,17,3,14,FMN GV 16 Berchem TOT
54,Posthofbrug 5366,2020-09-03,01:00:00,25,3,22,FMN GV 16 Berchem TOT
54,Posthofbrug 5366,2020-09-03,02:00:00,8,0,8,FMN GV 16 Berchem TOT
54,Posthofbrug 5366,2020-09-03,03:00:00,7,3,4,FMN GV 16 Berchem TOT
54,Posthofbrug 5366,2020-09-03,04:00:00,12,9,3,FMN GV 16 Berchem TOT
54,Posthofbrug 5366,2020-09-03,05:00:00,24,17,7,FMN GV 16 Berchem TOT
54,Posthofbrug 5366,2020-09-03,06:00:00,91,69,22,FMN GV 16 Berchem TOT
54,Posthofbrug 5366,2020-09-03,07:00:00,314,236,78,FMN GV 16 Berchem TOT
54,Posthofbrug 5366,2020-09-03,08:00:00,451,344,107,FMN GV 16 Berchem TOT
54,Posthofbrug 5366,2020-09-03,09:00:00,158,110,48,FMN GV 16 Berchem TOT
54,Posthofbrug 5366,2020-09-03,10:00:00,77,50,27,FMN GV 16 Berchem TOT
54,Posthofbrug 5366,2020-09-03,11:00:00,60,40,20,FMN GV 16 Berchem TOT
54,Posthofbrug 5366,2020-09-03,12:00:00,111,66,45,FMN GV 16 Berchem TOT
54,Posthofbrug 5366,2020-09-03,13:00:00,125,59,66,FMN GV 16 Berchem TOT
54,Posthofbrug 5366,2020-09-03,14:00:00,123,65,58,FMN GV 16 Berchem TOT
54,Posthofbrug 5366,2020-09-03,15:00:00,210,79,131,FMN GV 16 Berchem TOT
54,Posthofbrug 5366,2020-09-03,16:00:00,306,101,205,FMN GV 16 Berchem TOT
54,Posthofbrug 5366,2020-09-03,17:00:00,365,104,261,FMN GV 16 Berchem TOT
54,Posthofbrug 5366,2020-09-03,18:00:00,279,92,187,FMN GV 16 Berchem TOT
54,Posthofbrug 5366,2020-09-03,19:00:00,150,57,93,FMN GV 16 Berchem TOT
54,Posthofbrug 5366,2020-09-03,20:00:00,118,81,37,FMN GV 16 Berchem TOT
54,Posthofbrug 5366,2020-09-03,21:00:00,67,36,31,FMN GV 16 Berchem TOT
54,Posthofbrug 5366,2020-09-03,22:00:00,72,38,34,FMN GV 16 Berchem TOT
54,Posthofbrug 5366,2020-09-03,23:00:00,33,9,24,FMN GV 16 Berchem TOT
54,Posthofbrug 5366,2020-09-04,00:00:00,22,7,15,FMN GV 16 Berchem TOT
54,Posthofbrug 5366,2020-09-04,01:00:00,10,1,9,FMN GV 16 Berchem TOT
54,Posthofbrug 5366,2020-09-04,02:00:00,11,3,8,FMN GV 16 Berchem TOT
54,Posthofbrug 5366,2020-09-04,03:00:00,5,0,5,FMN GV 16 Berchem TOT
54,Posthofbrug 5366,2020-09-04,04:00:00,13,12,1,FMN GV 16 Berchem TOT
54,Posthofbrug 5366,2020-09-04,05:00:00,27,21,6,FMN GV 16 Berchem TOT
54,Posthofbrug 5366,2020-09-04,06:00:00,74,59,15,FMN GV 16 Berchem TOT
54,Posthofbrug 5366,2020-09-04,07:00:00,253,190,63,FMN GV 16 Berchem TOT
54,Posthofbrug 5366,2020-09-04,08:00:00,423,321,102,FMN GV 16 Berchem TOT
54,Posthofbrug 5366,2020-09-04,09:00:00,174,145,29,FMN GV 16 Berchem TOT
54,Posthofbrug 5366,2020-09-04,10:00:00,100,68,32,FMN GV 16 Berchem TOT
54,Posthofbrug 5366,2020-09-04,11:00:00,121,68,53,FMN GV 16 Berchem TOT
54,Posthofbrug 5366,2020-09-04,12:00:00,137,70,67,FMN GV 16 Berchem TOT
54,Posthofbrug 5366,2020-09-04,13:00:00,154,86,68,FMN GV 16 Berchem TOT
54,Posthofbrug 5366,2020-09-04,14:00:00,155,75,80,FMN GV 16 Berchem TOT
54,Posthofbrug 5366,2020-09-04,15:00:00,267,98,169,FMN GV 16 Berchem TOT
54,Posthofbrug 5366,2020-09-04,16:00:00,329,101,228,FMN GV 16 Berchem TOT
54,Posthofbrug 5366,2020-09-04,17:00:00,340,114,226,FMN GV 16 Berchem TOT
54,Posthofbrug 5366,2020-09-04,18:00:00,260,97,163,FMN GV 16 Berchem TOT
54,Posthofbrug 5366,2020-09-04,19:00:00,168,75,93,FMN GV 16 Berchem TOT
54,Posthofbrug 5366,2020-09-04,20:00:00,132,88,44,FMN GV 16 Berchem TOT
54,Posthofbrug 5366,2020-09-04,21:00:00,92,45,47,FMN GV 16 Berchem TOT
54,Posthofbrug 5366,2020-09-04,22:00:00,76,31,45,FMN GV 16 Berchem TOT
54,Posthofbrug 5366,2020-09-04,23:00:00,47,17,30,FMN GV 16 Berchem TOT
54,Posthofbrug 5366,2020-09-05,00:00:00,48,12,36,FMN GV 16 Berchem TOT
54,Posthofbrug 5366,2020-09-05,01:00:00,72,17,55,FMN GV 16 Berchem TOT
54,Posthofbrug 5366,2020-09-05,02:00:00,14,4,10,FMN GV 16 Berchem TOT
54,Posthofbrug 5366,2020-09-05,03:00:00,22,6,16,FMN GV 16 Berchem TOT
54,Posthofbrug 5366,2020-09-05,04:00:00,5,5,0,FMN GV 16 Berchem TOT
54,Posthofbrug 5366,2020-09-05,05:00:00,6,3,3,FMN GV 16 Berchem TOT
54,Posthofbrug 5366,2020-09-05,06:00:00,18,10,8,FMN GV 16 Berchem TOT
54,Posthofbrug 5366,2020-09-05,07:00:00,37,22,15,FMN GV 16 Berchem TOT
54,Posthofbrug 5366,2020-09-05,08:00:00,80,33,47,FMN GV 16 Berchem TOT
54,Posthofbrug 5366,2020-09-05,09:00:00,101,61,40,FMN GV 16 Berchem TOT
54,Posthofbrug 5366,2020-09-05,10:00:00,121,71,50,FMN GV 16 Berchem TOT
54,Posthofbrug 5366,2020-09-05,11:00:00,157,84,73,FMN GV 16 Berchem TOT
54,Posthofbrug 5366,2020-09-05,12:00:00,162,88,74,FMN GV 16 Berchem TOT
54,Posthofbrug 5366,2020-09-05,13:00:00,206,115,91,FMN GV 16 Berchem TOT
54,Posthofbrug 5366,2020-09-05,14:00:00,204,105,99,FMN GV 16 Berchem TOT
54,Posthofbrug 5366,2020-09-05,15:00:00,202,103,99,FMN GV 16 Berchem TOT
54,Posthofbrug 5366,2020-09-05,16:00:00,172,75,97,FMN GV 16 Berchem TOT
54,Posthofbrug 5366,2020-09-05,17:00:00,198,103,95,FMN GV 16 Berchem TOT
54,Posthofbrug 5366,2020-09-05,18:00:00,135,68,67,FMN GV 16 Berchem TOT
54,Posthofbrug 5366,2020-09-05,19:00:00,124,64,60,FMN GV 16 Berchem TOT
54,Posthofbrug 5366,2020-09-05,20:00:00,115,60,55,FMN GV 16 Berchem TOT
54,Posthofbrug 5366,2020-09-05,21:00:00,80,45,35,FMN GV 16 Berchem TOT
54,Posthofbrug 5366,2020-09-05,22:00:00,68,35,33,FMN GV 16 Berchem TOT
54,Posthofbrug 5366,2020-09-05,23:00:00,54,22,32,FMN GV 16 Berchem TOT
54,Posthofbrug 5366,2020-09-06,00:00:00,53,19,34,FMN GV 16 Berchem TOT
54,Posthofbrug 5366,2020-09-06,01:00:00,42,14,28,FMN GV 16 Berchem TOT
54,Posthofbrug 5366,2020-09-06,02:00:00,14,2,12,FMN GV 16 Berchem TOT
54,Posthofbrug 5366,2020-09-06,03:00:00,8,4,4,FMN GV 16 Berchem TOT
54,Posthofbrug 5366,2020-09-06,04:00:00,8,6,2,FMN GV 16 Berchem TOT
54,Posthofbrug 5366,2020-09-06,05:00:00,4,2,2,FMN GV 16 Berchem TOT
54,Posthofbrug 5366,2020-09-06,06:00:00,21,15,6,FMN GV 16 Berchem TOT
54,Posthofbrug 5366,2020-09-06,07:00:00,23,14,9,FMN GV 16 Berchem TOT
54,Posthofbrug 5366,2020-09-06,08:00:00,55,26,29,FMN GV 16 Berchem TOT
54,Posthofbrug 5366,2020-09-06,09:00:00,115,70,45,FMN GV 16 Berchem TOT
54,Posthofbrug 5366,2020-09-06,10:00:00,159,88,71,FMN GV 16 Berchem TOT
54,Posthofbrug 5366,2020-09-06,11:00:00,196,141,55,FMN GV 16 Berchem TOT
54,Posthofbrug 5366,2020-09-06,12:00:00,215,136,79,FMN GV 16 Berchem TOT
54,Posthofbrug 5366,2020-09-06,13:00:00,202,105,97,FMN GV 16 Berchem TOT
54,Posthofbrug 5366,2020-09-06,14:00:00,272,163,109,FMN GV 16 Berchem TOT
54,Posthofbrug 5366,2020-09-06,15:00:00,225,101,124,FMN GV 16 Berchem TOT
54,Posthofbrug 5366,2020-09-06,16:00:00,229,110,119,FMN GV 16 Berchem TOT
54,Posthofbrug 5366,2020-09-06,17:00:00,200,85,115,FMN GV 16 Berchem TOT
54,Posthofbrug 5366,2020-09-06,18:00:00,145,66,79,FMN GV 16 Berchem TOT
54,Posthofbrug 5366,2020-09-06,19:00:00,96,51,45,FMN GV 16 Berchem TOT
54,Posthofbrug 5366,2020-09-06,20:00:00,92,58,34,FMN GV 16 Berchem TOT
54,Posthofbrug 5366,2020-09-06,21:00:00,53,25,28,FMN GV 16 Berchem TOT
54,Posthofbrug 5366,2020-09-06,22:00:00,60,23,37,FMN GV 16 Berchem TOT
54,Posthofbrug 5366,2020-09-06,23:00:00,13,5,8,FMN GV 16 Berchem TOT
54,Posthofbrug 5366,2020-09-07,00:00:00,10,6,4,FMN GV 16 Berchem TOT
54,Posthofbrug 5366,2020-09-07,01:00:00,7,1,6,FMN GV 16 Berchem TOT
54,Posthofbrug 5366,2020-09-07,02:00:00,4,2,2,FMN GV 16 Berchem TOT
54,Posthofbrug 5366,2020-09-07,03:00:00,10,3,7,FMN GV 16 Berchem TOT
54,Posthofbrug 5366,2020-09-07,04:00:00,6,5,1,FMN GV 16 Berchem TOT
54,Posthofbrug 5366,2020-09-07,05:00:00,23,19,4,FMN GV 16 Berchem TOT
54,Posthofbrug 5366,2020-09-07,06:00:00,104,82,22,FMN GV 16 Berchem TOT
54,Posthofbrug 5366,2020-09-07,07:00:00,360,272,88,FMN GV 16 Berchem TOT
54,Posthofbrug 5366,2020-09-07,08:00:00,518,404,114,FMN GV 16 Berchem TOT
54,Posthofbrug 5366,2020-09-07,09:00:00,174,133,41,FMN GV 16 Berchem TOT
54,Posthofbrug 5366,2020-09-07,10:00:00,96,71,25,FMN GV 16 Berchem TOT
54,Posthofbrug 5366,2020-09-07,11:00:00,93,54,39,FMN GV 16 Berchem TOT
54,Posthofbrug 5366,2020-09-07,12:00:00,142,90,52,FMN GV 16 Berchem TOT
54,Posthofbrug 5366,2020-09-07,13:00:00,130,70,60,FMN GV 16 Berchem TOT
54,Posthofbrug 5366,2020-09-07,14:00:00,150,67,83,FMN GV 16 Berchem TOT
54,Posthofbrug 5366,2020-09-07,15:00:00,264,98,166,FMN GV 16 Berchem TOT
54,Posthofbrug 5366,2020-09-07,16:00:00,372,98,274,FMN GV 16 Berchem TOT
54,Posthofbrug 5366,2020-09-07,17:00:00,474,139,335,FMN GV 16 Berchem TOT
54,Posthofbrug 5366,2020-09-07,18:00:00,318,105,213,FMN GV 16 Berchem TOT
54,Posthofbrug 5366,2020-09-07,19:00:00,151,67,84,FMN GV 16 Berchem TOT
54,Posthofbrug 5366,2020-09-07,20:00:00,115,67,48,FMN GV 16 Berchem TOT
54,Posthofbrug 5366,2020-09-07,21:00:00,82,45,37,FMN GV 16 Berchem TOT
54,Posthofbrug 5366,2020-09-07,22:00:00,57,19,38,FMN GV 16 Berchem TOT
54,Posthofbrug 5366,2020-09-07,23:00:00,26,4,22,FMN GV 16 Berchem TOT
54,Posthofbrug 5366,2020-09-08,00:00:00,8,2,6,FMN GV 16 Berchem TOT
54,Posthofbrug 5366,2020-09-08,01:00:00,13,0,13,FMN GV 16 Berchem TOT
54,Posthofbrug 5366,2020-09-08,02:00:00,2,0,2,FMN GV 16 Berchem TOT
54,Posthofbrug 5366,2020-09-08,03:00:00,1,0,1,FMN GV 16 Berchem TOT
54,Posthofbrug 5366,2020-09-08,04:00:00,10,8,2,FMN GV 16 Berchem TOT
54,Posthofbrug 5366,2020-09-08,05:00:00,23,18,5,FMN GV 16 Berchem TOT
54,Posthofbrug 5366,2020-09-08,06:00:00,108,80,28,FMN GV 16 Berchem TOT
54,Posthofbrug 5366,2020-09-08,07:00:00,374,289,85,FMN GV 16 Berchem TOT
54,Posthofbrug 5366,2020-09-08,08:00:00,536,419,117,FMN GV 16 Berchem TOT
54,Posthofbrug 5366,2020-09-08,09:00:00,208,158,50,FMN GV 16 Berchem TOT
54,Posthofbrug 5366,2020-09-08,10:00:00,77,56,21,FMN GV 16 Berchem TOT
54,Posthofbrug 5366,2020-09-08,11:00:00,118,66,52,FMN GV 16 Berchem TOT
54,Posthofbrug 5366,2020-09-08,12:00:00,148,75,73,FMN GV 16 Berchem TOT
54,Posthofbrug 5366,2020-09-08,13:00:00,106,53,53,FMN GV 16 Berchem TOT
54,Posthofbrug 5366,2020-09-08,14:00:00,147,60,87,FMN GV 16 Berchem TOT
54,Posthofbrug 5366,2020-09-08,15:00:00,237,79,158,FMN GV 16 Berchem TOT
54,Posthofbrug 5366,2020-09-08,16:00:00,404,122,282,FMN GV 16 Berchem TOT
54,Posthofbrug 5366,2020-09-08,17:00:00,433,140,293,FMN GV 16 Berchem TOT
54,Posthofbrug 5366,2020-09-08,18:00:00,286,99,187,FMN GV 16 Berchem TOT
54,Posthofbrug 5366,2020-09-08,19:00:00,183,70,113,FMN GV 16 Berchem TOT
54,Posthofbrug 5366,2020-09-08,20:00:00,125,72,53,FMN GV 16 Berchem TOT
54,Posthofbrug 5366,2020-09-08,21:00:00,79,42,37,FMN GV 16 Berchem TOT
54,Posthofbrug 5366,2020-09-08,22:00:00,75,37,38,FMN GV 16 Berchem TOT
54,Posthofbrug 5366,2020-09-08,23:00:00,37,14,23,FMN GV 16 Berchem TOT
54,Posthofbrug 5366,2020-09-09,00:00:00,24,3,21,FMN GV 16 Berchem TOT
54,Posthofbrug 5366,2020-09-09,01:00:00,9,3,6,FMN GV 16 Berchem TOT
54,Posthofbrug 5366,2020-09-09,02:00:00,9,5,4,FMN GV 16 Berchem TOT
54,Posthofbrug 5366,2020-09-09,03:00:00,3,1,2,FMN GV 16 Berchem TOT
54,Posthofbrug 5366,2020-09-09,04:00:00,10,7,3,FMN GV 16 Berchem TOT
54,Posthofbrug 5366,2020-09-09,05:00:00,19,13,6,FMN GV 16 Berchem TOT
54,Posthofbrug 5366,2020-09-09,06:00:00,99,73,26,FMN GV 16 Berchem TOT
54,Posthofbrug 5366,2020-09-09,07:00:00,306,236,70,FMN GV 16 Berchem TOT
54,Posthofbrug 5366,2020-09-09,08:00:00,483,372,111,FMN GV 16 Berchem TOT
54,Posthofbrug 5366,2020-09-09,09:00:00,177,116,61,FMN GV 16 Berchem TOT
54,Posthofbrug 5366,2020-09-09,10:00:00,97,59,38,FMN GV 16 Berchem TOT
54,Posthofbrug 5366,2020-09-09,11:00:00,92,49,43,FMN GV 16 Berchem TOT
54,Posthofbrug 5366,2020-09-09,12:00:00,247,112,135,FMN GV 16 Berchem TOT
54,Posthofbrug 5366,2020-09-09,13:00:00,183,79,104,FMN GV 16 Berchem TOT
54,Posthofbrug 5366,2020-09-09,14:00:00,166,82,84,FMN GV 16 Berchem TOT
54,Posthofbrug 5366,2020-09-09,15:00:00,190,78,112,FMN GV 16 Berchem TOT
54,Posthofbrug 5366,2020-09-09,16:00:00,278,105,173,FMN GV 16 Berchem TOT
54,Posthofbrug 5366,2020-09-09,17:00:00,375,121,254,FMN GV 16 Berchem TOT
54,Posthofbrug 5366,2020-09-09,18:00:00,275,98,177,FMN GV 16 Berchem TOT
54,Posthofbrug 5366,2020-09-09,19:00:00,172,86,86,FMN GV 16 Berchem TOT
54,Posthofbrug 5366,2020-09-09,20:00:00,109,69,40,FMN GV 16 Berchem TOT
54,Posthofbrug 5366,2020-09-09,21:00:00,69,33,36,FMN GV 16 Berchem TOT
54,Posthofbrug 5366,2020-09-09,22:00:00,88,41,47,FMN GV 16 Berchem TOT
54,Posthofbrug 5366,2020-09-09,23:00:00,45,11,34,FMN GV 16 Berchem TOT
54,Posthofbrug 5366,2020-09-10,00:00:00,18,3,15,FMN GV 16 Berchem TOT
54,Posthofbrug 5366,2020-09-10,01:00:00,8,3,5,FMN GV 16 Berchem TOT
54,Posthofbrug 5366,2020-09-10,02:00:00,1,0,1,FMN GV 16 Berchem TOT
54,Posthofbrug 5366,2020-09-10,03:00:00,6,2,4,FMN GV 16 Berchem TOT
54,Posthofbrug 5366,2020-09-10,04:00:00,14,10,4,FMN GV 16 Berchem TOT
54,Posthofbrug 5366,2020-09-10,05:00:00,19,13,6,FMN GV 16 Berchem TOT
54,Posthofbrug 5366,2020-09-10,06:00:00,93,67,26,FMN GV 16 Berchem TOT
54,Posthofbrug 5366,2020-09-10,07:00:00,327,237,90,FMN GV 16 Berchem TOT
54,Posthofbrug 5366,2020-09-10,08:00:00,544,423,121,FMN GV 16 Berchem TOT
54,Posthofbrug 5366,2020-09-10,09:00:00,195,153,42,FMN GV 16 Berchem TOT
54,Posthofbrug 5366,2020-09-10,10:00:00,126,74,52,FMN GV 16 Berchem TOT
54,Posthofbrug 5366,2020-09-10,11:00:00,130,75,55,FMN GV 16 Berchem TOT
54,Posthofbrug 5366,2020-09-10,12:00:00,157,90,67,FMN GV 16 Berchem TOT
54,Posthofbrug 5366,2020-09-10,13:00:00,151,73,78,FMN GV 16 Berchem TOT
54,Posthofbrug 5366,2020-09-10,14:00:00,180,81,99,FMN GV 16 Berchem TOT
54,Posthofbrug 5366,2020-09-10,15:00:00,249,110,139,FMN GV 16 Berchem TOT
54,Posthofbrug 5366,2020-09-10,16:00:00,365,122,243,FMN GV 16 Berchem TOT
54,Posthofbrug 5366,2020-09-10,17:00:00,454,143,311,FMN GV 16 Berchem TOT
54,Posthofbrug 5366,2020-09-10,18:00:00,364,117,247,FMN GV 16 Berchem TOT
54,Posthofbrug 5366,2020-09-10,19:00:00,223,101,122,FMN GV 16 Berchem TOT
54,Posthofbrug 5366,2020-09-10,20:00:00,157,87,70,FMN GV 16 Berchem TOT
54,Posthofbrug 5366,2020-09-10,21:00:00,90,44,46,FMN GV 16 Berchem TOT
54,Posthofbrug 5366,2020-09-10,22:00:00,72,35,37,FMN GV 16 Berchem TOT
54,Posthofbrug 5366,2020-09-10,23:00:00,48,17,31,FMN GV 16 Berchem TOT
54,Posthofbrug 5366,2020-09-11,00:00:00,32,13,19,FMN GV 16 Berchem TOT
54,Posthofbrug 5366,2020-09-11,01:00:00,23,3,20,FMN GV 16 Berchem TOT
54,Posthofbrug 5366,2020-09-11,02:00:00,4,1,3,FMN GV 16 Berchem TOT
54,Posthofbrug 5366,2020-09-11,03:00:00,4,1,3,FMN GV 16 Berchem TOT
54,Posthofbrug 5366,2020-09-11,04:00:00,13,7,6,FMN GV 16 Berchem TOT
54,Posthofbrug 5366,2020-09-11,05:00:00,17,14,3,FMN GV 16 Berchem TOT
54,Posthofbrug 5366,2020-09-11,06:00:00,98,74,24,FMN GV 16 Berchem TOT
54,Posthofbrug 5366,2020-09-11,07:00:00,274,200,74,FMN GV 16 Berchem TOT
54,Posthofbrug 5366,2020-09-11,08:00:00,439,325,114,FMN GV 16 Berchem TOT
54,Posthofbrug 5366,2020-09-11,09:00:00,190,150,40,FMN GV 16 Berchem TOT
54,Posthofbrug 5366,2020-09-11,10:00:00,108,67,41,FMN GV 16 Berchem TOT
54,Posthofbrug 5366,2020-09-11,11:00:00,138,83,55,FMN GV 16 Berchem TOT
54,Posthofbrug 5366,2020-09-11,12:00:00,181,85,96,FMN GV 16 Berchem TOT
54,Posthofbrug 5366,2020-09-11,13:00:00,142,75,67,FMN GV 16 Berchem TOT
54,Posthofbrug 5366,2020-09-11,14:00:00,162,81,81,FMN GV 16 Berchem TOT
54,Posthofbrug 5366,2020-09-11,15:00:00,257,100,157,FMN GV 16 Berchem TOT
54,Posthofbrug 5366,2020-09-11,16:00:00,348,126,222,FMN GV 16 Berchem TOT
54,Posthofbrug 5366,2020-09-11,17:00:00,376,136,240,FMN GV 16 Berchem TOT
54,Posthofbrug 5366,2020-09-11,18:00:00,244,97,147,FMN GV 16 Berchem TOT
54,Posthofbrug 5366,2020-09-11,19:00:00,207,90,117,FMN GV 16 Berchem TOT
54,Posthofbrug 5366,2020-09-11,20:00:00,156,82,74,FMN GV 16 Berchem TOT
54,Posthofbrug 5366,2020-09-11,21:00:00,74,42,32,FMN GV 16 Berchem TOT
54,Posthofbrug 5366,2020-09-11,22:00:00,87,41,46,FMN GV 16 Berchem TOT
54,Posthofbrug 5366,2020-09-11,23:00:00,66,21,45,FMN GV 16 Berchem TOT
54,Posthofbrug 5366,2020-09-12,00:00:00,70,30,40,FMN GV 16 Berchem TOT
54,Posthofbrug 5366,2020-09-12,01:00:00,54,9,45,FMN GV 16 Berchem TOT
54,Posthofbrug 5366,2020-09-12,02:00:00,13,4,9,FMN GV 16 Berchem TOT
54,Posthofbrug 5366,2020-09-12,03:00:00,14,3,11,FMN GV 16 Berchem TOT
54,Posthofbrug 5366,2020-09-12,04:00:00,26,6,20,FMN GV 16 Berchem TOT
54,Posthofbrug 5366,2020-09-12,05:00:00,7,7,0,FMN GV 16 Berchem TOT
54,Posthofbrug 5366,2020-09-12,06:00:00,15,8,7,FMN GV 16 Berchem TOT
54,Posthofbrug 5366,2020-09-12,07:00:00,38,23,15,FMN GV 16 Berchem TOT
54,Posthofbrug 5366,2020-09-12,08:00:00,56,33,23,FMN GV 16 Berchem TOT
54,Posthofbrug 5366,2020-09-12,09:00:00,96,68,28,FMN GV 16 Berchem TOT
54,Posthofbrug 5366,2020-09-12,10:00:00,142,108,34,FMN GV 16 Berchem TOT
54,Posthofbrug 5366,2020-09-12,11:00:00,163,88,75,FMN GV 16 Berchem TOT
54,Posthofbrug 5366,2020-09-12,12:00:00,145,76,69,FMN GV 16 Berchem TOT
54,Posthofbrug 5366,2020-09-12,13:00:00,224,139,85,FMN GV 16 Berchem TOT
54,Posthofbrug 5366,2020-09-12,14:00:00,209,109,100,FMN GV 16 Berchem TOT
54,Posthofbrug 5366,2020-09-12,15:00:00,191,119,72,FMN GV 16 Berchem TOT
54,Posthofbrug 5366,2020-09-12,16:00:00,183,86,97,FMN GV 16 Berchem TOT
54,Posthofbrug 5366,2020-09-12,17:00:00,202,80,122,FMN GV 16 Berchem TOT
54,Posthofbrug 5366,2020-09-12,18:00:00,171,90,81,FMN GV 16 Berchem TOT
54,Posthofbrug 5366,2020-09-12,19:00:00,137,73,64,FMN GV 16 Berchem TOT
54,Posthofbrug 5366,2020-09-12,20:00:00,107,49,58,FMN GV 16 Berchem TOT
54,Posthofbrug 5366,2020-09-12,21:00:00,82,50,32,FMN GV 16 Berchem TOT
54,Posthofbrug 5366,2020-09-12,22:00:00,75,42,33,FMN GV 16 Berchem TOT
54,Posthofbrug 5366,2020-09-12,23:00:00,39,12,27,FMN GV 16 Berchem TOT
54,Posthofbrug 5366,2020-09-13,00:00:00,53,18,35,FMN GV 16 Berchem TOT
54,Posthofbrug 5366,2020-09-13,01:00:00,45,13,32,FMN GV 16 Berchem TOT
54,Posthofbrug 5366,2020-09-13,02:00:00,17,1,16,FMN GV 16 Berchem TOT
54,Posthofbrug 5366,2020-09-13,03:00:00,7,2,5,FMN GV 16 Berchem TOT
54,Posthofbrug 5366,2020-09-13,04:00:00,13,7,6,FMN GV 16 Berchem TOT
54,Posthofbrug 5366,2020-09-13,05:00:00,5,5,0,FMN GV 16 Berchem TOT
54,Posthofbrug 5366,2020-09-13,06:00:00,13,11,2,FMN GV 16 Berchem TOT
54,Posthofbrug 5366,2020-09-13,07:00:00,27,7,20,FMN GV 16 Berchem TOT
54,Posthofbrug 5366,2020-09-13,08:00:00,45,24,21,FMN GV 16 Berchem TOT
54,Posthofbrug 5366,2020-09-13,09:00:00,115,63,52,FMN GV 16 Berchem TOT
54,Posthofbrug 5366,2020-09-13,10:00:00,132,78,54,FMN GV 16 Berchem TOT
54,Posthofbrug 5366,2020-09-13,11:00:00,132,71,61,FMN GV 16 Berchem TOT
54,Posthofbrug 5366,2020-09-13,12:00:00,208,111,97,FMN GV 16 Berchem TOT
54,Posthofbrug 5366,2020-09-13,13:00:00,217,130,87,FMN GV 16 Berchem TOT
54,Posthofbrug 5366,2020-09-13,14:00:00,302,180,122,FMN GV 16 Berchem TOT
54,Posthofbrug 5366,2020-09-13,15:00:00,216,106,110,FMN GV 16 Berchem TOT
54,Posthofbrug 5366,2020-09-13,16:00:00,232,120,112,FMN GV 16 Berchem TOT
54,Posthofbrug 5366,2020-09-13,17:00:00,206,96,110,FMN GV 16 Berchem TOT
54,Posthofbrug 5366,2020-09-13,18:00:00,153,71,82,FMN GV 16 Berchem TOT
54,Posthofbrug 5366,2020-09-13,19:00:00,111,60,51,FMN GV 16 Berchem TOT
54,Posthofbrug 5366,2020-09-13,20:00:00,98,56,42,FMN GV 16 Berchem TOT
54,Posthofbrug 5366,2020-09-13,21:00:00,63,36,27,FMN GV 16 Berchem TOT
54,Posthofbrug 5366,2020-09-13,22:00:00,51,24,27,FMN GV 16 Berchem TOT
54,Posthofbrug 5366,2020-09-13,23:00:00,26,9,17,FMN GV 16 Berchem TOT
54,Posthofbrug 5366,2020-09-14,00:00:00,14,6,8,FMN GV 16 Berchem TOT
54,Posthofbrug 5366,2020-09-14,01:00:00,8,1,7,FMN GV 16 Berchem TOT
54,Posthofbrug 5366,2020-09-14,02:00:00,5,2,3,FMN GV 16 Berchem TOT
54,Posthofbrug 5366,2020-09-14,03:00:00,2,0,2,FMN GV 16 Berchem TOT
54,Posthofbrug 5366,2020-09-14,04:00:00,8,7,1,FMN GV 16 Berchem TOT
54,Posthofbrug 5366,2020-09-14,05:00:00,26,18,8,FMN GV 16 Berchem TOT
54,Posthofbrug 5366,2020-09-14,06:00:00,94,72,22,FMN GV 16 Berchem TOT
54,Posthofbrug 5366,2020-09-14,07:00:00,338,257,81,FMN GV 16 Berchem TOT
54,Posthofbrug 5366,2020-09-14,08:00:00,538,405,133,FMN GV 16 Berchem TOT
54,Posthofbrug 5366,2020-09-14,09:00:00,244,195,49,FMN GV 16 Berchem TOT
54,Posthofbrug 5366,2020-09-14,10:00:00,101,75,26,FMN GV 16 Berchem TOT
54,Posthofbrug 5366,2020-09-14,11:00:00,144,83,61,FMN GV 16 Berchem TOT
54,Posthofbrug 5366,2020-09-14,12:00:00,150,72,78,FMN GV 16 Berchem TOT
54,Posthofbrug 5366,2020-09-14,13:00:00,140,74,66,FMN GV 16 Berchem TOT
54,Posthofbrug 5366,2020-09-14,14:00:00,182,79,103,FMN GV 16 Berchem TOT
54,Posthofbrug 5366,2020-09-14,15:00:00,238,100,138,FMN GV 16 Berchem TOT
54,Posthofbrug 5366,2020-09-14,16:00:00,386,122,264,FMN GV 16 Berchem TOT
54,Posthofbrug 5366,2020-09-14,17:00:00,486,149,337,FMN GV 16 Berchem TOT
54,Posthofbrug 5366,2020-09-14,18:00:00,333,98,235,FMN GV 16 Berchem TOT
54,Posthofbrug 5366,2020-09-14,19:00:00,163,62,101,FMN GV 16 Berchem TOT
54,Posthofbrug 5366,2020-09-14,20:00:00,145,65,80,FMN GV 16 Berchem TOT
54,Posthofbrug 5366,2020-09-14,21:00:00,83,42,41,FMN GV 16 Berchem TOT
54,Posthofbrug 5366,2020-09-14,22:00:00,97,33,64,FMN GV 16 Berchem TOT
54,Posthofbrug 5366,2020-09-14,23:00:00,39,17,22,FMN GV 16 Berchem TOT
54,Posthofbrug 5366,2020-09-15,00:00:00,17,6,11,FMN GV 16 Berchem TOT
54,Posthofbrug 5366,2020-09-15,01:00:00,14,0,14,FMN GV 16 Berchem TOT
54,Posthofbrug 5366,2020-09-15,02:00:00,4,1,3,FMN GV 16 Berchem TOT
54,Posthofbrug 5366,2020-09-15,03:00:00,6,1,5,FMN GV 16 Berchem TOT
54,Posthofbrug 5366,2020-09-15,04:00:00,10,7,3,FMN GV 16 Berchem TOT
54,Posthofbrug 5366,2020-09-15,05:00:00,35,24,11,FMN GV 16 Berchem TOT
54,Posthofbrug 5366,2020-09-15,06:00:00,117,93,24,FMN GV 16 Berchem TOT
54,Posthofbrug 5366,2020-09-15,07:00:00,371,273,98,FMN GV 16 Berchem TOT
54,Posthofbrug 5366,2020-09-15,08:00:00,591,463,128,FMN GV 16 Berchem TOT
54,Posthofbrug 5366,2020-09-15,09:00:00,212,155,57,FMN GV 16 Berchem TOT
54,Posthofbrug 5366,2020-09-15,10:00:00,116,91,25,FMN GV 16 Berchem TOT
54,Posthofbrug 5366,2020-09-15,11:00:00,141,80,61,FMN GV 16 Berchem TOT
54,Posthofbrug 5366,2020-09-15,12:00:00,176,80,96,FMN GV 16 Berchem TOT
54,Posthofbrug 5366,2020-09-15,13:00:00,168,82,86,FMN GV 16 Berchem TOT
54,Posthofbrug 5366,2020-09-15,14:00:00,134,55,79,FMN GV 16 Berchem TOT
54,Posthofbrug 5366,2020-09-15,15:00:00,250,90,160,FMN GV 16 Berchem TOT
54,Posthofbrug 5366,2020-09-15,16:00:00,368,130,238,FMN GV 16 Berchem TOT
54,Posthofbrug 5366,2020-09-15,17:00:00,452,140,312,FMN GV 16 Berchem TOT
54,Posthofbrug 5366,2020-09-15,18:00:00,314,86,228,FMN GV 16 Berchem TOT
54,Posthofbrug 5366,2020-09-15,19:00:00,227,101,126,FMN GV 16 Berchem TOT
54,Posthofbrug 5366,2020-09-15,20:00:00,151,77,74,FMN GV 16 Berchem TOT
54,Posthofbrug 5366,2020-09-15,21:00:00,117,53,64,FMN GV 16 Berchem TOT
54,Posthofbrug 5366,2020-09-15,22:00:00,105,54,51,FMN GV 16 Berchem TOT
54,Posthofbrug 5366,2020-09-15,23:00:00,52,20,32,FMN GV 16 Berchem TOT
54,Posthofbrug 5366,2020-09-16,00:00:00,30,8,22,FMN GV 16 Berchem TOT
54,Posthofbrug 5366,2020-09-16,01:00:00,16,8,8,FMN GV 16 Berchem TOT
54,Posthofbrug 5366,2020-09-16,02:00:00,7,2,5,FMN GV 16 Berchem TOT
54,Posthofbrug 5366,2020-09-16,03:00:00,4,2,2,FMN GV 16 Berchem TOT
54,Posthofbrug 5366,2020-09-16,04:00:00,11,6,5,FMN GV 16 Berchem TOT
54,Posthofbrug 5366,2020-09-16,05:00:00,35,27,8,FMN GV 16 Berchem TOT
54,Posthofbrug 5366,2020-09-16,06:00:00,107,85,22,FMN GV 16 Berchem TOT
54,Posthofbrug 5366,2020-09-16,07:00:00,365,265,100,FMN GV 16 Berchem TOT
54,Posthofbrug 5366,2020-09-16,08:00:00,486,369,117,FMN GV 16 Berchem TOT
54,Posthofbrug 5366,2020-09-16,09:00:00,190,130,60,FMN GV 16 Berchem TOT
54,Posthofbrug 5366,2020-09-16,10:00:00,120,74,46,FMN GV 16 Berchem TOT
54,Posthofbrug 5366,2020-09-16,11:00:00,147,75,72,FMN GV 16 Berchem TOT
54,Posthofbrug 5366,2020-09-16,12:00:00,263,130,133,FMN GV 16 Berchem TOT
54,Posthofbrug 5366,2020-09-16,13:00:00,205,88,117,FMN GV 16 Berchem TOT
54,Posthofbrug 5366,2020-09-16,14:00:00,173,79,94,FMN GV 16 Berchem TOT
54,Posthofbrug 5366,2020-09-16,15:00:00,186,85,101,FMN GV 16 Berchem TOT
54,Posthofbrug 5366,2020-09-16,16:00:00,297,99,198,FMN GV 16 Berchem TOT
54,Posthofbrug 5366,2020-09-16,17:00:00,402,134,268,FMN GV 16 Berchem TOT
54,Posthofbrug 5366,2020-09-16,18:00:00,346,122,224,FMN GV 16 Berchem TOT
54,Posthofbrug 5366,2020-09-16,19:00:00,215,98,117,FMN GV 16 Berchem TOT
54,Posthofbrug 5366,2020-09-16,20:00:00,120,67,53,FMN GV 16 Berchem TOT
54,Posthofbrug 5366,2020-09-16,21:00:00,101,39,62,FMN GV 16 Berchem TOT
54,Posthofbrug 5366,2020-09-16,22:00:00,101,42,59,FMN GV 16 Berchem TOT
54,Posthofbrug 5366,2020-09-16,23:00:00,46,15,31,FMN GV 16 Berchem TOT
54,Posthofbrug 5366,2020-09-17,00:00:00,22,9,13,FMN GV 16 Berchem TOT
54,Posthofbrug 5366,2020-09-17,01:00:00,14,1,13,FMN GV 16 Berchem TOT
54,Posthofbrug 5366,2020-09-17,02:00:00,2,1,1,FMN GV 16 Berchem TOT
54,Posthofbrug 5366,2020-09-17,03:00:00,10,4,6,FMN GV 16 Berchem TOT
54,Posthofbrug 5366,2020-09-17,04:00:00,9,5,4,FMN GV 16 Berchem TOT
54,Posthofbrug 5366,2020-09-17,05:00:00,33,25,8,FMN GV 16 Berchem TOT
54,Posthofbrug 5366,2020-09-17,06:00:00,99,78,21,FMN GV 16 Berchem TOT
54,Posthofbrug 5366,2020-09-17,07:00:00,374,263,111,FMN GV 16 Berchem TOT
54,Posthofbrug 5366,2020-09-17,08:00:00,569,440,129,FMN GV 16 Berchem TOT
54,Posthofbrug 5366,2020-09-17,09:00:00,204,149,55,FMN GV 16 Berchem TOT
54,Posthofbrug 5366,2020-09-17,10:00:00,127,84,43,FMN GV 16 Berchem TOT
54,Posthofbrug 5366,2020-09-17,11:00:00,121,65,56,FMN GV 16 Berchem TOT
54,Posthofbrug 5366,2020-09-17,12:00:00,165,98,67,FMN GV 16 Berchem TOT
54,Posthofbrug 5366,2020-09-17,13:00:00,151,90,61,FMN GV 16 Berchem TOT
54,Posthofbrug 5366,2020-09-17,14:00:00,166,82,84,FMN GV 16 Berchem TOT
54,Posthofbrug 5366,2020-09-17,15:00:00,254,86,168,FMN GV 16 Berchem TOT
54,Posthofbrug 5366,2020-09-17,16:00:00,382,141,241,FMN GV 16 Berchem TOT
54,Posthofbrug 5366,2020-09-17,17:00:00,478,151,327,FMN GV 16 Berchem TOT
54,Posthofbrug 5366,2020-09-17,18:00:00,365,117,248,FMN GV 16 Berchem TOT
54,Posthofbrug 5366,2020-09-17,19:00:00,179,80,99,FMN GV 16 Berchem TOT
54,Posthofbrug 5366,2020-09-17,20:00:00,140,64,76,FMN GV 16 Berchem TOT
54,Posthofbrug 5366,2020-09-17,21:00:00,98,38,60,FMN GV 16 Berchem TOT
54,Posthofbrug 5366,2020-09-17,22:00:00,113,46,67,FMN GV 16 Berchem TOT
54,Posthofbrug 5366,2020-09-17,23:00:00,46,16,30,FMN GV 16 Berchem TOT
54,Posthofbrug 5366,2020-09-18,00:00:00,34,15,19,FMN GV 16 Berchem TOT
54,Posthofbrug 5366,2020-09-18,01:00:00,20,6,14,FMN GV 16 Berchem TOT
54,Posthofbrug 5366,2020-09-18,02:00:00,5,0,5,FMN GV 16 Berchem TOT
54,Posthofbrug 5366,2020-09-18,03:00:00,0,0,0,FMN GV 16 Berchem TOT
54,Posthofbrug 5366,2020-09-18,04:00:00,8,6,2,FMN GV 16 Berchem TOT
54,Posthofbrug 5366,2020-09-18,05:00:00,26,19,7,FMN GV 16 Berchem TOT
54,Posthofbrug 5366,2020-09-18,06:00:00,80,62,18,FMN GV 16 Berchem TOT
54,Posthofbrug 5366,2020-09-18,07:00:00,289,207,82,FMN GV 16 Berchem TOT
54,Posthofbrug 5366,2020-09-18,08:00:00,470,361,109,FMN GV 16 Berchem TOT
54,Posthofbrug 5366,2020-09-18,09:00:00,220,169,51,FMN GV 16 Berchem TOT
54,Posthofbrug 5366,2020-09-18,10:00:00,117,79,38,FMN GV 16 Berchem TOT
54,Posthofbrug 5366,2020-09-18,11:00:00,136,83,53,FMN GV 16 Berchem TOT
54,Posthofbrug 5366,2020-09-18,12:00:00,162,100,62,FMN GV 16 Berchem TOT
54,Posthofbrug 5366,2020-09-18,13:00:00,172,94,78,FMN GV 16 Berchem TOT
54,Posthofbrug 5366,2020-09-18,14:00:00,175,78,97,FMN GV 16 Berchem TOT
54,Posthofbrug 5366,2020-09-18,15:00:00,286,118,168,FMN GV 16 Berchem TOT
54,Posthofbrug 5366,2020-09-18,16:00:00,373,125,248,FMN GV 16 Berchem TOT
54,Posthofbrug 5366,2020-09-18,17:00:00,371,133,238,FMN GV 16 Berchem TOT
54,Posthofbrug 5366,2020-09-18,18:00:00,305,126,179,FMN GV 16 Berchem TOT
54,Posthofbrug 5366,2020-09-18,19:00:00,158,75,83,FMN GV 16 Berchem TOT
54,Posthofbrug 5366,2020-09-18,20:00:00,118,64,54,FMN GV 16 Berchem TOT
54,Posthofbrug 5366,2020-09-18,21:00:00,102,54,48,FMN GV 16 Berchem TOT
54,Posthofbrug 5366,2020-09-18,22:00:00,98,32,66,FMN GV 16 Berchem TOT
54,Posthofbrug 5366,2020-09-18,23:00:00,62,17,45,FMN GV 16 Berchem TOT
54,Posthofbrug 5366,2020-09-19,00:00:00,69,29,40,FMN GV 16 Berchem TOT
54,Posthofbrug 5366,2020-09-19,01:00:00,54,20,34,FMN GV 16 Berchem TOT
54,Posthofbrug 5366,2020-09-19,02:00:00,17,1,16,FMN GV 16 Berchem TOT
54,Posthofbrug 5366,2020-09-19,03:00:00,17,3,14,FMN GV 16 Berchem TOT
54,Posthofbrug 5366,2020-09-19,04:00:00,11,6,5,FMN GV 16 Berchem TOT
54,Posthofbrug 5366,2020-09-19,05:00:00,16,9,7,FMN GV 16 Berchem TOT
54,Posthofbrug 5366,2020-09-19,06:00:00,26,21,5,FMN GV 16 Berchem TOT
54,Posthofbrug 5366,2020-09-19,07:00:00,25,16,9,FMN GV 16 Berchem TOT
54,Posthofbrug 5366,2020-09-19,08:00:00,74,41,33,FMN GV 16 Berchem TOT
54,Posthofbrug 5366,2020-09-19,09:00:00,97,55,42,FMN GV 16 Berchem TOT
54,Posthofbrug 5366,2020-09-19,10:00:00,185,117,68,FMN GV 16 Berchem TOT
54,Posthofbrug 5366,2020-09-19,11:00:00,173,109,64,FMN GV 16 Berchem TOT
54,Posthofbrug 5366,2020-09-19,12:00:00,152,79,73,FMN GV 16 Berchem TOT
54,Posthofbrug 5366,2020-09-19,13:00:00,216,111,105,FMN GV 16 Berchem TOT
54,Posthofbrug 5366,2020-09-19,14:00:00,252,136,116,FMN GV 16 Berchem TOT
54,Posthofbrug 5366,2020-09-19,15:00:00,221,102,119,FMN GV 16 Berchem TOT
54,Posthofbrug 5366,2020-09-19,16:00:00,242,109,133,FMN GV 16 Berchem TOT
54,Posthofbrug 5366,2020-09-19,17:00:00,205,89,116,FMN GV 16 Berchem TOT
54,Posthofbrug 5366,2020-09-19,18:00:00,212,108,104,FMN GV 16 Berchem TOT
54,Posthofbrug 5366,2020-09-19,19:00:00,137,65,72,FMN GV 16 Berchem TOT
54,Posthofbrug 5366,2020-09-19,20:00:00,111,61,50,FMN GV 16 Berchem TOT
54,Posthofbrug 5366,2020-09-19,21:00:00,81,39,42,FMN GV 16 Berchem TOT
54,Posthofbrug 5366,2020-09-19,22:00:00,102,45,57,FMN GV 16 Berchem TOT
54,Posthofbrug 5366,2020-09-19,23:00:00,61,26,35,FMN GV 16 Berchem TOT
54,Posthofbrug 5366,2020-09-20,00:00:00,51,15,36,FMN GV 16 Berchem TOT
54,Posthofbrug 5366,2020-09-20,01:00:00,39,12,27,FMN GV 16 Berchem TOT
54,Posthofbrug 5366,2020-09-20,02:00:00,10,2,8,FMN GV 16 Berchem TOT
54,Posthofbrug 5366,2020-09-20,03:00:00,13,6,7,FMN GV 16 Berchem TOT
54,Posthofbrug 5366,2020-09-20,04:00:00,9,4,5,FMN GV 16 Berchem TOT
54,Posthofbrug 5366,2020-09-20,05:00:00,6,4,2,FMN GV 16 Berchem TOT
54,Posthofbrug 5366,2020-09-20,06:00:00,9,6,3,FMN GV 16 Berchem TOT
54,Posthofbrug 5366,2020-09-20,07:00:00,24,12,12,FMN GV 16 Berchem TOT
54,Posthofbrug 5366,2020-09-20,08:00:00,70,44,26,FMN GV 16 Berchem TOT
54,Posthofbrug 5366,2020-09-20,09:00:00,121,66,55,FMN GV 16 Berchem TOT
54,Posthofbrug 5366,2020-09-20,10:00:00,148,83,65,FMN GV 16 Berchem TOT
54,Posthofbrug 5366,2020-09-20,11:00:00,212,133,79,FMN GV 16 Berchem TOT
54,Posthofbrug 5366,2020-09-20,12:00:00,279,165,114,FMN GV 16 Berchem TOT
54,Posthofbrug 5366,2020-09-20,13:00:00,321,202,119,FMN GV 16 Berchem TOT
54,Posthofbrug 5366,2020-09-20,14:00:00,338,209,129,FMN GV 16 Berchem TOT
54,Posthofbrug 5366,2020-09-20,15:00:00,303,147,156,FMN GV 16 Berchem TOT
54,Posthofbrug 5366,2020-09-20,16:00:00,260,109,151,FMN GV 16 Berchem TOT
54,Posthofbrug 5366,2020-09-20,17:00:00,299,115,184,FMN GV 16 Berchem TOT
54,Posthofbrug 5366,2020-09-20,18:00:00,206,89,117,FMN GV 16 Berchem TOT
54,Posthofbrug 5366,2020-09-20,19:00:00,151,58,93,FMN GV 16 Berchem TOT
54,Posthofbrug 5366,2020-09-20,20:00:00,108,51,57,FMN GV 16 Berchem TOT
54,Posthofbrug 5366,2020-09-20,21:00:00,89,58,31,FMN GV 16 Berchem TOT
54,Posthofbrug 5366,2020-09-20,22:00:00,51,24,27,FMN GV 16 Berchem TOT
54,Posthofbrug 5366,2020-09-20,23:00:00,25,11,14,FMN GV 16 Berchem TOT
54,Posthofbrug 5366,2020-09-21,00:00:00,13,4,9,FMN GV 16 Berchem TOT
54,Posthofbrug 5366,2020-09-21,01:00:00,9,1,8,FMN GV 16 Berchem TOT
54,Posthofbrug 5366,2020-09-21,02:00:00,4,1,3,FMN GV 16 Berchem TOT
54,Posthofbrug 5366,2020-09-21,03:00:00,1,1,0,FMN GV 16 Berchem TOT
54,Posthofbrug 5366,2020-09-21,04:00:00,9,7,2,FMN GV 16 Berchem TOT
54,Posthofbrug 5366,2020-09-21,05:00:00,27,20,7,FMN GV 16 Berchem TOT
54,Posthofbrug 5366,2020-09-21,06:00:00,101,82,19,FMN GV 16 Berchem TOT
54,Posthofbrug 5366,2020-09-21,07:00:00,355,268,87,FMN GV 16 Berchem TOT
54,Posthofbrug 5366,2020-09-21,08:00:00,553,428,125,FMN GV 16 Berchem TOT
54,Posthofbrug 5366,2020-09-21,09:00:00,217,160,57,FMN GV 16 Berchem TOT
54,Posthofbrug 5366,2020-09-21,10:00:00,96,65,31,FMN GV 16 Berchem TOT
54,Posthofbrug 5366,2020-09-21,11:00:00,103,57,46,FMN GV 16 Berchem TOT
54,Posthofbrug 5366,2020-09-21,12:00:00,218,119,99,FMN GV 16 Berchem TOT
54,Posthofbrug 5366,2020-09-21,13:00:00,183,105,78,FMN GV 16 Berchem TOT
54,Posthofbrug 5366,2020-09-21,14:00:00,185,79,106,FMN GV 16 Berchem TOT
54,Posthofbrug 5366,2020-09-21,15:00:00,255,99,156,FMN GV 16 Berchem TOT
54,Posthofbrug 5366,2020-09-21,16:00:00,369,119,250,FMN GV 16 Berchem TOT
54,Posthofbrug 5366,2020-09-21,17:00:00,470,127,343,FMN GV 16 Berchem TOT
54,Posthofbrug 5366,2020-09-21,18:00:00,367,126,241,FMN GV 16 Berchem TOT
54,Posthofbrug 5366,2020-09-21,19:00:00,194,81,113,FMN GV 16 Berchem TOT
54,Posthofbrug 5366,2020-09-21,20:00:00,129,67,62,FMN GV 16 Berchem TOT
54,Posthofbrug 5366,2020-09-21,21:00:00,80,47,33,FMN GV 16 Berchem TOT
54,Posthofbrug 5366,2020-09-21,22:00:00,87,33,54,FMN GV 16 Berchem TOT
54,Posthofbrug 5366,2020-09-21,23:00:00,33,13,20,FMN GV 16 Berchem TOT
54,Posthofbrug 5366,2020-09-22,00:00:00,15,5,10,FMN GV 16 Berchem TOT
54,Posthofbrug 5366,2020-09-22,01:00:00,11,0,11,FMN GV 16 Berchem TOT
54,Posthofbrug 5366,2020-09-22,02:00:00,3,0,3,FMN GV 16 Berchem TOT
54,Posthofbrug 5366,2020-09-22,03:00:00,2,1,1,FMN GV 16 Berchem TOT
54,Posthofbrug 5366,2020-09-22,04:00:00,9,7,2,FMN GV 16 Berchem TOT
54,Posthofbrug 5366,2020-09-22,05:00:00,32,24,8,FMN GV 16 Berchem TOT
54,Posthofbrug 5366,2020-09-22,06:00:00,115,94,21,FMN GV 16 Berchem TOT
54,Posthofbrug 5366,2020-09-22,07:00:00,380,273,107,FMN GV 16 Berchem TOT
54,Posthofbrug 5366,2020-09-22,08:00:00,598,459,139,FMN GV 16 Berchem TOT
54,Posthofbrug 5366,2020-09-22,09:00:00,237,166,71,FMN GV 16 Berchem TOT
54,Posthofbrug 5366,2020-09-22,10:00:00,142,100,42,FMN GV 16 Berchem TOT
54,Posthofbrug 5366,2020-09-22,11:00:00,147,91,56,FMN GV 16 Berchem TOT
54,Posthofbrug 5366,2020-09-22,12:00:00,171,104,67,FMN GV 16 Berchem TOT
54,Posthofbrug 5366,2020-09-22,13:00:00,174,94,80,FMN GV 16 Berchem TOT
54,Posthofbrug 5366,2020-09-22,14:00:00,178,68,110,FMN GV 16 Berchem TOT
54,Posthofbrug 5366,2020-09-22,15:00:00,255,100,155,FMN GV 16 Berchem TOT
54,Posthofbrug 5366,2020-09-22,16:00:00,400,114,286,FMN GV 16 Berchem TOT
54,Posthofbrug 5366,2020-09-22,17:00:00,487,138,349,FMN GV 16 Berchem TOT
54,Posthofbrug 5366,2020-09-22,18:00:00,372,139,233,FMN GV 16 Berchem TOT
54,Posthofbrug 5366,2020-09-22,19:00:00,203,84,119,FMN GV 16 Berchem TOT
54,Posthofbrug 5366,2020-09-22,20:00:00,155,87,68,FMN GV 16 Berchem TOT
54,Posthofbrug 5366,2020-09-22,21:00:00,99,38,61,FMN GV 16 Berchem TOT
54,Posthofbrug 5366,2020-09-22,22:00:00,109,43,66,FMN GV 16 Berchem TOT
54,Posthofbrug 5366,2020-09-22,23:00:00,43,16,27,FMN GV 16 Berchem TOT
54,Posthofbrug 5366,2020-09-23,00:00:00,25,6,19,FMN GV 16 Berchem TOT
54,Posthofbrug 5366,2020-09-23,01:00:00,21,2,19,FMN GV 16 Berchem TOT
54,Posthofbrug 5366,2020-09-23,02:00:00,2,0,2,FMN GV 16 Berchem TOT
54,Posthofbrug 5366,2020-09-23,03:00:00,3,2,1,FMN GV 16 Berchem TOT
54,Posthofbrug 5366,2020-09-23,04:00:00,9,5,4,FMN GV 16 Berchem TOT
54,Posthofbrug 5366,2020-09-23,05:00:00,32,23,9,FMN GV 16 Berchem TOT
54,Posthofbrug 5366,2020-09-23,06:00:00,87,66,21,FMN GV 16 Berchem TOT
54,Posthofbrug 5366,2020-09-23,07:00:00,342,251,91,FMN GV 16 Berchem TOT
54,Posthofbrug 5366,2020-09-23,08:00:00,495,383,112,FMN GV 16 Berchem TOT
54,Posthofbrug 5366,2020-09-23,09:00:00,187,132,55,FMN GV 16 Berchem TOT
54,Posthofbrug 5366,2020-09-23,10:00:00,135,91,44,FMN GV 16 Berchem TOT
54,Posthofbrug 5366,2020-09-23,11:00:00,138,73,65,FMN GV 16 Berchem TOT
54,Posthofbrug 5366,2020-09-23,12:00:00,297,137,160,FMN GV 16 Berchem TOT
54,Posthofbrug 5366,2020-09-23,13:00:00,193,86,107,FMN GV 16 Berchem TOT
54,Posthofbrug 5366,2020-09-23,14:00:00,145,57,88,FMN GV 16 Berchem TOT
54,Posthofbrug 5366,2020-09-23,15:00:00,207,83,124,FMN GV 16 Berchem TOT
54,Posthofbrug 5366,2020-09-23,16:00:00,293,98,195,FMN GV 16 Berchem TOT
54,Posthofbrug 5366,2020-09-23,17:00:00,357,116,241,FMN GV 16 Berchem TOT
54,Posthofbrug 5366,2020-09-23,18:00:00,301,101,200,FMN GV 16 Berchem TOT
54,Posthofbrug 5366,2020-09-23,19:00:00,161,70,91,FMN GV 16 Berchem TOT
54,Posthofbrug 5366,2020-09-23,20:00:00,100,54,46,FMN GV 16 Berchem TOT
54,Posthofbrug 5366,2020-09-23,21:00:00,64,28,36,FMN GV 16 Berchem TOT
54,Posthofbrug 5366,2020-09-23,22:00:00,74,30,44,FMN GV 16 Berchem TOT
54,Posthofbrug 5366,2020-09-23,23:00:00,33,12,21,FMN GV 16 Berchem TOT
54,Posthofbrug 5366,2020-09-24,00:00:00,27,6,21,FMN GV 16 Berchem TOT
54,Posthofbrug 5366,2020-09-24,01:00:00,13,4,9,FMN GV 16 Berchem TOT
54,Posthofbrug 5366,2020-09-24,02:00:00,5,0,5,FMN GV 16 Berchem TOT
54,Posthofbrug 5366,2020-09-24,03:00:00,2,2,0,FMN GV 16 Berchem TOT
54,Posthofbrug 5366,2020-09-24,04:00:00,7,5,2,FMN GV 16 Berchem TOT
54,Posthofbrug 5366,2020-09-24,05:00:00,27,20,7,FMN GV 16 Berchem TOT
54,Posthofbrug 5366,2020-09-24,06:00:00,89,65,24,FMN GV 16 Berchem TOT
54,Posthofbrug 5366,2020-09-24,07:00:00,337,252,85,FMN GV 16 Berchem TOT
54,Posthofbrug 5366,2020-09-24,08:00:00,544,425,119,FMN GV 16 Berchem TOT
54,Posthofbrug 5366,2020-09-24,09:00:00,183,130,53,FMN GV 16 Berchem TOT
54,Posthofbrug 5366,2020-09-24,10:00:00,100,62,38,FMN GV 16 Berchem TOT
54,Posthofbrug 5366,2020-09-24,11:00:00,110,66,44,FMN GV 16 Berchem TOT
54,Posthofbrug 5366,2020-09-24,12:00:00,153,93,60,FMN GV 16 Berchem TOT
54,Posthofbrug 5366,2020-09-24,13:00:00,139,67,72,FMN GV 16 Berchem TOT
54,Posthofbrug 5366,2020-09-24,14:00:00,145,55,90,FMN GV 16 Berchem TOT
54,Posthofbrug 5366,2020-09-24,15:00:00,191,65,126,FMN GV 16 Berchem TOT
54,Posthofbrug 5366,2020-09-24,16:00:00,346,129,217,FMN GV 16 Berchem TOT
54,Posthofbrug 5366,2020-09-24,17:00:00,379,105,274,FMN GV 16 Berchem TOT
54,Posthofbrug 5366,2020-09-24,18:00:00,262,80,182,FMN GV 16 Berchem TOT
54,Posthofbrug 5366,2020-09-24,19:00:00,148,51,97,FMN GV 16 Berchem TOT
54,Posthofbrug 5366,2020-09-24,20:00:00,97,46,51,FMN GV 16 Berchem TOT
54,Posthofbrug 5366,2020-09-24,21:00:00,76,35,41,FMN GV 16 Berchem TOT
54,Posthofbrug 5366,2020-09-24,22:00:00,57,18,39,FMN GV 16 Berchem TOT
54,Posthofbrug 5366,2020-09-24,23:00:00,28,14,14,FMN GV 16 Berchem TOT
54,Posthofbrug 5366,2020-09-25,00:00:00,26,7,19,FMN GV 16 Berchem TOT
54,Posthofbrug 5366,2020-09-25,01:00:00,17,0,17,FMN GV 16 Berchem TOT
54,Posthofbrug 5366,2020-09-25,02:00:00,2,0,2,FMN GV 16 Berchem TOT
54,Posthofbrug 5366,2020-09-25,03:00:00,2,1,1,FMN GV 16 Berchem TOT
54,Posthofbrug 5366,2020-09-25,04:00:00,9,6,3,FMN GV 16 Berchem TOT
54,Posthofbrug 5366,2020-09-25,05:00:00,20,14,6,FMN GV 16 Berchem TOT
54,Posthofbrug 5366,2020-09-25,06:00:00,72,54,18,FMN GV 16 Berchem TOT
54,Posthofbrug 5366,2020-09-25,07:00:00,278,201,77,FMN GV 16 Berchem TOT
54,Posthofbrug 5366,2020-09-25,08:00:00,454,348,106,FMN GV 16 Berchem TOT
54,Posthofbrug 5366,2020-09-25,09:00:00,159,121,38,FMN GV 16 Berchem TOT
54,Posthofbrug 5366,2020-09-25,10:00:00,85,54,31,FMN GV 16 Berchem TOT
54,Posthofbrug 5366,2020-09-25,11:00:00,99,59,40,FMN GV 16 Berchem TOT
54,Posthofbrug 5366,2020-09-25,12:00:00,151,78,73,FMN GV 16 Berchem TOT
54,Posthofbrug 5366,2020-09-25,13:00:00,139,68,71,FMN GV 16 Berchem TOT
54,Posthofbrug 5366,2020-09-25,14:00:00,115,51,64,FMN GV 16 Berchem TOT
54,Posthofbrug 5366,2020-09-25,15:00:00,182,65,117,FMN GV 16 Berchem TOT
54,Posthofbrug 5366,2020-09-25,16:00:00,276,96,180,FMN GV 16 Berchem TOT
54,Posthofbrug 5366,2020-09-25,17:00:00,287,81,206,FMN GV 16 Berchem TOT
54,Posthofbrug 5366,2020-09-25,18:00:00,169,61,108,FMN GV 16 Berchem TOT
54,Posthofbrug 5366,2020-09-25,19:00:00,75,26,49,FMN GV 16 Berchem TOT
54,Posthofbrug 5366,2020-09-25,20:00:00,49,27,22,FMN GV 16 Berchem TOT
54,Posthofbrug 5366,2020-09-25,21:00:00,25,15,10,FMN GV 16 Berchem TOT
54,Posthofbrug 5366,2020-09-25,22:00:00,39,18,21,FMN GV 16 Berchem TOT
54,Posthofbrug 5366,2020-09-25,23:00:00,38,11,27,FMN GV 16 Berchem TOT
54,Posthofbrug 5366,2020-09-26,00:00:00,16,7,9,FMN GV 16 Berchem TOT
54,Posthofbrug 5366,2020-09-26,01:00:00,23,3,20,FMN GV 16 Berchem TOT
54,Posthofbrug 5366,2020-09-26,02:00:00,6,2,4,FMN GV 16 Berchem TOT
54,Posthofbrug 5366,2020-09-26,03:00:00,9,4,5,FMN GV 16 Berchem TOT
54,Posthofbrug 5366,2020-09-26,04:00:00,7,3,4,FMN GV 16 Berchem TOT
54,Posthofbrug 5366,2020-09-26,05:00:00,7,5,2,FMN GV 16 Berchem TOT
54,Posthofbrug 5366,2020-09-26,06:00:00,4,4,0,FMN GV 16 Berchem TOT
54,Posthofbrug 5366,2020-09-26,07:00:00,13,8,5,FMN GV 16 Berchem TOT
54,Posthofbrug 5366,2020-09-26,08:00:00,30,16,14,FMN GV 16 Berchem TOT
54,Posthofbrug 5366,2020-09-26,09:00:00,69,51,18,FMN GV 16 Berchem TOT
54,Posthofbrug 5366,2020-09-26,10:00:00,44,20,24,FMN GV 16 Berchem TOT
54,Posthofbrug 5366,2020-09-26,11:00:00,65,33,32,FMN GV 16 Berchem TOT
54,Posthofbrug 5366,2020-09-26,12:00:00,60,27,33,FMN GV 16 Berchem TOT
54,Posthofbrug 5366,2020-09-26,13:00:00,104,64,40,FMN GV 16 Berchem TOT
54,Posthofbrug 5366,2020-09-26,14:00:00,126,76,50,FMN GV 16 Berchem TOT
54,Posthofbrug 5366,2020-09-26,15:00:00,105,48,57,FMN GV 16 Berchem TOT
54,Posthofbrug 5366,2020-09-26,16:00:00,145,72,73,FMN GV 16 Berchem TOT
54,Posthofbrug 5366,2020-09-26,17:00:00,114,41,73,FMN GV 16 Berchem TOT
54,Posthofbrug 5366,2020-09-26,18:00:00,109,58,51,FMN GV 16 Berchem TOT
54,Posthofbrug 5366,2020-09-26,19:00:00,89,53,36,FMN GV 16 Berchem TOT
54,Posthofbrug 5366,2020-09-26,20:00:00,48,25,23,FMN GV 16 Berchem TOT
54,Posthofbrug 5366,2020-09-26,21:00:00,40,21,19,FMN GV 16 Berchem TOT
54,Posthofbrug 5366,2020-09-26,22:00:00,30,19,11,FMN GV 16 Berchem TOT
54,Posthofbrug 5366,2020-09-26,23:00:00,40,16,24,FMN GV 16 Berchem TOT
54,Posthofbrug 5366,2020-09-27,00:00:00,25,4,21,FMN GV 16 Berchem TOT
54,Posthofbrug 5366,2020-09-27,01:00:00,25,4,21,FMN GV 16 Berchem TOT
54,Posthofbrug 5366,2020-09-27,02:00:00,7,1,6,FMN GV 16 Berchem TOT
54,Posthofbrug 5366,2020-09-27,03:00:00,2,0,2,FMN GV 16 Berchem TOT
54,Posthofbrug 5366,2020-09-27,04:00:00,6,1,5,FMN GV 16 Berchem TOT
54,Posthofbrug 5366,2020-09-27,05:00:00,6,4,2,FMN GV 16 Berchem TOT
54,Posthofbrug 5366,2020-09-27,06:00:00,15,14,1,FMN GV 16 Berchem TOT
54,Posthofbrug 5366,2020-09-27,07:00:00,23,11,12,FMN GV 16 Berchem TOT
54,Posthofbrug 5366,2020-09-27,08:00:00,115,13,102,FMN GV 16 Berchem TOT
54,Posthofbrug 5366,2020-09-27,09:00:00,164,41,123,FMN GV 16 Berchem TOT
54,Posthofbrug 5366,2020-09-27,10:00:00,188,41,147,FMN GV 16 Berchem TOT
54,Posthofbrug 5366,2020-09-27,11:00:00,270,52,218,FMN GV 16 Berchem TOT
54,Posthofbrug 5366,2020-09-27,12:00:00,295,82,213,FMN GV 16 Berchem TOT
54,Posthofbrug 5366,2020-09-27,13:00:00,180,68,112,FMN GV 16 Berchem TOT
54,Posthofbrug 5366,2020-09-27,14:00:00,163,74,89,FMN GV 16 Berchem TOT
54,Posthofbrug 5366,2020-09-27,15:00:00,145,65,80,FMN GV 16 Berchem TOT
54,Posthofbrug 5366,2020-09-27,16:00:00,138,70,68,FMN GV 16 Berchem TOT
54,Posthofbrug 5366,2020-09-27,17:00:00,119,47,72,FMN GV 16 Berchem TOT
54,Posthofbrug 5366,2020-09-27,18:00:00,115,57,58,FMN GV 16 Berchem TOT
54,Posthofbrug 5366,2020-09-27,19:00:00,75,37,38,FMN GV 16 Berchem TOT
54,Posthofbrug 5366,2020-09-27,20:00:00,71,40,31,FMN GV 16 Berchem TOT
54,Posthofbrug 5366,2020-09-27,21:00:00,47,26,21,FMN GV 16 Berchem TOT
54,Posthofbrug 5366,2020-09-27,22:00:00,49,29,20,FMN GV 16 Berchem TOT
54,Posthofbrug 5366,2020-09-27,23:00:00,18,13,5,FMN GV 16 Berchem TOT
54,Posthofbrug 5366,2020-09-28,00:00:00,10,3,7,FMN GV 16 Berchem TOT
54,Posthofbrug 5366,2020-09-28,01:00:00,5,0,5,FMN GV 16 Berchem TOT
54,Posthofbrug 5366,2020-09-28,02:00:00,2,1,1,FMN GV 16 Berchem TOT
54,Posthofbrug 5366,2020-09-28,03:00:00,1,1,0,FMN GV 16 Berchem TOT
54,Posthofbrug 5366,2020-09-28,04:00:00,10,7,3,FMN GV 16 Berchem TOT
54,Posthofbrug 5366,2020-09-28,05:00:00,29,19,10,FMN GV 16 Berchem TOT
54,Posthofbrug 5366,2020-09-28,06:00:00,80,66,14,FMN GV 16 Berchem TOT
54,Posthofbrug 5366,2020-09-28,07:00:00,251,192,59,FMN GV 16 Berchem TOT
54,Posthofbrug 5366,2020-09-28,08:00:00,357,274,83,FMN GV 16 Berchem TOT
54,Posthofbrug 5366,2020-09-28,09:00:00,107,80,27,FMN GV 16 Berchem TOT
54,Posthofbrug 5366,2020-09-28,10:00:00,73,52,21,FMN GV 16 Berchem TOT
54,Posthofbrug 5366,2020-09-28,11:00:00,54,35,19,FMN GV 16 Berchem TOT
54,Posthofbrug 5366,2020-09-28,12:00:00,105,50,55,FMN GV 16 Berchem TOT
54,Posthofbrug 5366,2020-09-28,13:00:00,81,36,45,FMN GV 16 Berchem TOT
54,Posthofbrug 5366,2020-09-28,14:00:00,71,28,43,FMN GV 16 Berchem TOT
54,Posthofbrug 5366,2020-09-28,15:00:00,155,62,93,FMN GV 16 Berchem TOT
54,Posthofbrug 5366,2020-09-28,16:00:00,221,59,162,FMN GV 16 Berchem TOT
54,Posthofbrug 5366,2020-09-28,17:00:00,269,76,193,FMN GV 16 Berchem TOT
54,Posthofbrug 5366,2020-09-28,18:00:00,196,62,134,FMN GV 16 Berchem TOT
54,Posthofbrug 5366,2020-09-28,19:00:00,104,41,63,FMN GV 16 Berchem TOT
54,Posthofbrug 5366,2020-09-28,20:00:00,54,19,35,FMN GV 16 Berchem TOT
54,Posthofbrug 5366,2020-09-28,21:00:00,46,27,19,FMN GV 16 Berchem TOT
54,Posthofbrug 5366,2020-09-28,22:00:00,27,7,20,FMN GV 16 Berchem TOT
54,Posthofbrug 5366,2020-09-28,23:00:00,26,13,13,FMN GV 16 Berchem TOT
54,Posthofbrug 5366,2020-09-29,00:00:00,9,3,6,FMN GV 16 Berchem TOT
54,Posthofbrug 5366,2020-09-29,01:00:00,1,0,1,FMN GV 16 Berchem TOT
54,Posthofbrug 5366,2020-09-29,02:00:00,5,0,5,FMN GV 16 Berchem TOT
54,Posthofbrug 5366,2020-09-29,03:00:00,1,1,0,FMN GV 16 Berchem TOT
54,Posthofbrug 5366,2020-09-29,04:00:00,6,5,1,FMN GV 16 Berchem TOT
54,Posthofbrug 5366,2020-09-29,05:00:00,28,24,4,FMN GV 16 Berchem TOT
54,Posthofbrug 5366,2020-09-29,06:00:00,85,65,20,FMN GV 16 Berchem TOT
54,Posthofbrug 5366,2020-09-29,07:00:00,371,267,104,FMN GV 16 Berchem TOT
54,Posthofbrug 5366,2020-09-29,08:00:00,563,442,121,FMN GV 16 Berchem TOT
54,Posthofbrug 5366,2020-09-29,09:00:00,193,143,50,FMN GV 16 Berchem TOT
54,Posthofbrug 5366,2020-09-29,10:00:00,114,80,34,FMN GV 16 Berchem TOT
54,Posthofbrug 5366,2020-09-29,11:00:00,103,60,43,FMN GV 16 Berchem TOT
54,Posthofbrug 5366,2020-09-29,12:00:00,188,89,99,FMN GV 16 Berchem TOT
54,Posthofbrug 5366,2020-09-29,13:00:00,155,85,70,FMN GV 16 Berchem TOT
54,Posthofbrug 5366,2020-09-29,14:00:00,144,57,87,FMN GV 16 Berchem TOT
54,Posthofbrug 5366,2020-09-29,15:00:00,245,98,147,FMN GV 16 Berchem TOT
54,Posthofbrug 5366,2020-09-29,16:00:00,359,111,248,FMN GV 16 Berchem TOT
54,Posthofbrug 5366,2020-09-29,17:00:00,489,140,349,FMN GV 16 Berchem TOT
54,Posthofbrug 5366,2020-09-29,18:00:00,296,100,196,FMN GV 16 Berchem TOT
54,Posthofbrug 5366,2020-09-29,19:00:00,171,61,110,FMN GV 16 Berchem TOT
54,Posthofbrug 5366,2020-09-29,20:00:00,100,40,60,FMN GV 16 Berchem TOT
54,Posthofbrug 5366,2020-09-29,21:00:00,71,30,41,FMN GV 16 Berchem TOT
54,Posthofbrug 5366,2020-09-29,22:00:00,72,35,37,FMN GV 16 Berchem TOT
54,Posthofbrug 5366,2020-09-29,23:00:00,39,11,28,FMN GV 16 Berchem TOT
54,Posthofbrug 5366,2020-09-30,00:00:00,10,2,8,FMN GV 16 Berchem TOT
54,Posthofbrug 5366,2020-09-30,01:00:00,15,3,12,FMN GV 16 Berchem TOT
54,Posthofbrug 5366,2020-09-30,02:00:00,5,1,4,FMN GV 16 Berchem TOT
54,Posthofbrug 5366,2020-09-30,03:00:00,1,1,0,FMN GV 16 Berchem TOT
54,Posthofbrug 5366,2020-09-30,04:00:00,11,8,3,FMN GV 16 Berchem TOT
54,Posthofbrug 5366,2020-09-30,05:00:00,33,24,9,FMN GV 16 Berchem TOT
54,Posthofbrug 5366,2020-09-30,06:00:00,80,62,18,FMN GV 16 Berchem TOT
54,Posthofbrug 5366,2020-09-30,07:00:00,347,258,89,FMN GV 16 Berchem TOT
54,Posthofbrug 5366,2020-09-30,08:00:00,485,359,126,FMN GV 16 Berchem TOT
54,Posthofbrug 5366,2020-09-30,09:00:00,200,152,48,FMN GV 16 Berchem TOT
54,Posthofbrug 5366,2020-09-30,10:00:00,127,72,55,FMN GV 16 Berchem TOT
54,Posthofbrug 5366,2020-09-30,11:00:00,138,65,73,FMN GV 16 Berchem TOT
54,Posthofbrug 5366,2020-09-30,12:00:00,279,131,148,FMN GV 16 Berchem TOT
54,Posthofbrug 5366,2020-09-30,13:00:00,175,74,101,FMN GV 16 Berchem TOT
54,Posthofbrug 5366,2020-09-30,14:00:00,167,76,91,FMN GV 16 Berchem TOT
54,Posthofbrug 5366,2020-09-30,15:00:00,171,79,92,FMN GV 16 Berchem TOT
54,Posthofbrug 5366,2020-09-30,16:00:00,272,101,171,FMN GV 16 Berchem TOT
54,Posthofbrug 5366,2020-09-30,17:00:00,384,116,268,FMN GV 16 Berchem TOT
54,Posthofbrug 5366,2020-09-30,18:00:00,289,122,167,FMN GV 16 Berchem TOT
54,Posthofbrug 5366,2020-09-30,19:00:00,193,96,97,FMN GV 16 Berchem TOT
54,Posthofbrug 5366,2020-09-30,20:00:00,115,62,53,FMN GV 16 Berchem TOT
54,Posthofbrug 5366,2020-09-30,21:00:00,89,40,49,FMN GV 16 Berchem TOT
54,Posthofbrug 5366,2020-09-30,22:00:00,77,37,40,FMN GV 16 Berchem TOT
54,Posthofbrug 5366,2020-09-30,23:00:00,48,18,30,FMN GV 16 Berchem TOT
54,Posthofbrug 5366,2020-10-01,00:00:00,20,3,17,FMN GV 16 Berchem TOT
54,Posthofbrug 5366,2020-10-01,01:00:00,28,6,22,FMN GV 16 Berchem TOT
54,Posthofbrug 5366,2020-10-01,02:00:00,3,0,3,FMN GV 16 Berchem TOT
54,Posthofbrug 5366,2020-10-01,03:00:00,1,0,1,FMN GV 16 Berchem TOT
54,Posthofbrug 5366,2020-10-01,04:00:00,4,4,0,FMN GV 16 Berchem TOT
54,Posthofbrug 5366,2020-10-01,05:00:00,26,18,8,FMN GV 16 Berchem TOT
54,Posthofbrug 5366,2020-10-01,06:00:00,86,72,14,FMN GV 16 Berchem TOT
54,Posthofbrug 5366,2020-10-01,07:00:00,287,215,72,FMN GV 16 Berchem TOT
54,Posthofbrug 5366,2020-10-01,08:00:00,506,360,146,FMN GV 16 Berchem TOT
54,Posthofbrug 5366,2020-10-01,09:00:00,155,113,42,FMN GV 16 Berchem TOT
54,Posthofbrug 5366,2020-10-01,10:00:00,95,70,25,FMN GV 16 Berchem TOT
54,Posthofbrug 5366,2020-10-01,11:00:00,59,24,35,FMN GV 16 Berchem TOT
54,Posthofbrug 5366,2020-10-01,12:00:00,119,68,51,FMN GV 16 Berchem TOT
54,Posthofbrug 5366,2020-10-01,13:00:00,120,62,58,FMN GV 16 Berchem TOT
54,Posthofbrug 5366,2020-10-01,14:00:00,95,28,67,FMN GV 16 Berchem TOT
54,Posthofbrug 5366,2020-10-01,15:00:00,129,51,78,FMN GV 16 Berchem TOT
54,Posthofbrug 5366,2020-10-01,16:00:00,275,92,183,FMN GV 16 Berchem TOT
54,Posthofbrug 5366,2020-10-01,17:00:00,360,118,242,FMN GV 16 Berchem TOT
54,Posthofbrug 5366,2020-10-01,18:00:00,257,80,177,FMN GV 16 Berchem TOT
54,Posthofbrug 5366,2020-10-01,19:00:00,167,64,103,FMN GV 16 Berchem TOT
54,Posthofbrug 5366,2020-10-01,20:00:00,91,43,48,FMN GV 16 Berchem TOT
54,Posthofbrug 5366,2020-10-01,21:00:00,60,32,28,FMN GV 16 Berchem TOT
54,Posthofbrug 5366,2020-10-01,22:00:00,72,29,43,FMN GV 16 Berchem TOT
54,Posthofbrug 5366,2020-10-01,23:00:00,35,11,24,FMN GV 16 Berchem TOT
54,Posthofbrug 5366,2020-10-02,00:00:00,25,10,15,FMN GV 16 Berchem TOT
54,Posthofbrug 5366,2020-10-02,01:00:00,25,5,20,FMN GV 16 Berchem TOT
54,Posthofbrug 5366,2020-10-02,02:00:00,1,0,1,FMN GV 16 Berchem TOT
54,Posthofbrug 5366,2020-10-02,03:00:00,3,1,2,FMN GV 16 Berchem TOT
54,Posthofbrug 5366,2020-10-02,04:00:00,8,5,3,FMN GV 16 Berchem TOT
54,Posthofbrug 5366,2020-10-02,05:00:00,19,14,5,FMN GV 16 Berchem TOT
54,Posthofbrug 5366,2020-10-02,06:00:00,72,60,12,FMN GV 16 Berchem TOT
54,Posthofbrug 5366,2020-10-02,07:00:00,262,190,72,FMN GV 16 Berchem TOT
54,Posthofbrug 5366,2020-10-02,08:00:00,396,292,104,FMN GV 16 Berchem TOT
54,Posthofbrug 5366,2020-10-02,09:00:00,172,126,46,FMN GV 16 Berchem TOT
54,Posthofbrug 5366,2020-10-02,10:00:00,93,56,37,FMN GV 16 Berchem TOT
54,Posthofbrug 5366,2020-10-02,11:00:00,71,38,33,FMN GV 16 Berchem TOT
54,Posthofbrug 5366,2020-10-02,12:00:00,121,66,55,FMN GV 16 Berchem TOT
54,Posthofbrug 5366,2020-10-02,13:00:00,122,55,67,FMN GV 16 Berchem TOT
54,Posthofbrug 5366,2020-10-02,14:00:00,114,57,57,FMN GV 16 Berchem TOT
54,Posthofbrug 5366,2020-10-02,15:00:00,178,61,117,FMN GV 16 Berchem TOT
54,Posthofbrug 5366,2020-10-02,16:00:00,234,88,146,FMN GV 16 Berchem TOT
54,Posthofbrug 5366,2020-10-02,17:00:00,329,113,216,FMN GV 16 Berchem TOT
54,Posthofbrug 5366,2020-10-02,18:00:00,215,82,133,FMN GV 16 Berchem TOT
54,Posthofbrug 5366,2020-10-02,19:00:00,110,50,60,FMN GV 16 Berchem TOT
54,Posthofbrug 5366,2020-10-02,20:00:00,75,45,30,FMN GV 16 Berchem TOT
54,Posthofbrug 5366,2020-10-02,21:00:00,49,22,27,FMN GV 16 Berchem TOT
54,Posthofbrug 5366,2020-10-02,22:00:00,48,26,22,FMN GV 16 Berchem TOT
54,Posthofbrug 5366,2020-10-02,23:00:00,43,13,30,FMN GV 16 Berchem TOT
54,Posthofbrug 5366,2020-10-03,00:00:00,26,5,21,FMN GV 16 Berchem TOT
54,Posthofbrug 5366,2020-10-03,01:00:00,42,7,35,FMN GV 16 Berchem TOT
54,Posthofbrug 5366,2020-10-03,02:00:00,17,1,16,FMN GV 16 Berchem TOT
54,Posthofbrug 5366,2020-10-03,03:00:00,15,5,10,FMN GV 16 Berchem TOT
54,Posthofbrug 5366,2020-10-03,04:00:00,8,3,5,FMN GV 16 Berchem TOT
54,Posthofbrug 5366,2020-10-03,05:00:00,9,5,4,FMN GV 16 Berchem TOT
54,Posthofbrug 5366,2020-10-03,06:00:00,13,8,5,FMN GV 16 Berchem TOT
54,Posthofbrug 5366,2020-10-03,07:00:00,16,8,8,FMN GV 16 Berchem TOT
54,Posthofbrug 5366,2020-10-03,08:00:00,40,24,16,FMN GV 16 Berchem TOT
54,Posthofbrug 5366,2020-10-03,09:00:00,67,43,24,FMN GV 16 Berchem TOT
54,Posthofbrug 5366,2020-10-03,10:00:00,72,39,33,FMN GV 16 Berchem TOT
54,Posthofbrug 5366,2020-10-03,11:00:00,85,54,31,FMN GV 16 Berchem TOT
54,Posthofbrug 5366,2020-10-03,12:00:00,93,59,34,FMN GV 16 Berchem TOT
54,Posthofbrug 5366,2020-10-03,13:00:00,96,56,40,FMN GV 16 Berchem TOT
54,Posthofbrug 5366,2020-10-03,14:00:00,115,55,60,FMN GV 16 Berchem TOT
54,Posthofbrug 5366,2020-10-03,15:00:00,101,56,45,FMN GV 16 Berchem TOT
54,Posthofbrug 5366,2020-10-03,16:00:00,87,49,38,FMN GV 16 Berchem TOT
54,Posthofbrug 5366,2020-10-03,17:00:00,130,61,69,FMN GV 16 Berchem TOT
54,Posthofbrug 5366,2020-10-03,18:00:00,126,73,53,FMN GV 16 Berchem TOT
54,Posthofbrug 5366,2020-10-03,19:00:00,97,55,42,FMN GV 16 Berchem TOT
54,Posthofbrug 5366,2020-10-03,20:00:00,78,49,29,FMN GV 16 Berchem TOT
54,Posthofbrug 5366,2020-10-03,21:00:00,51,24,27,FMN GV 16 Berchem TOT
54,Posthofbrug 5366,2020-10-03,22:00:00,45,18,27,FMN GV 16 Berchem TOT
54,Posthofbrug 5366,2020-10-03,23:00:00,37,13,24,FMN GV 16 Berchem TOT
54,Posthofbrug 5366,2020-10-04,00:00:00,55,28,27,FMN GV 16 Berchem TOT
54,Posthofbrug 5366,2020-10-04,01:00:00,73,27,46,FMN GV 16 Berchem TOT
54,Posthofbrug 5366,2020-10-04,02:00:00,20,10,10,FMN GV 16 Berchem TOT
54,Posthofbrug 5366,2020-10-04,03:00:00,12,2,10,FMN GV 16 Berchem TOT
54,Posthofbrug 5366,2020-10-04,04:00:00,4,3,1,FMN GV 16 Berchem TOT
54,Posthofbrug 5366,2020-10-04,05:00:00,6,3,3,FMN GV 16 Berchem TOT
54,Posthofbrug 5366,2020-10-04,06:00:00,11,9,2,FMN GV 16 Berchem TOT
54,Posthofbrug 5366,2020-10-04,07:00:00,18,11,7,FMN GV 16 Berchem TOT
54,Posthofbrug 5366,2020-10-04,08:00:00,22,11,11,FMN GV 16 Berchem TOT
54,Posthofbrug 5366,2020-10-04,09:00:00,64,37,27,FMN GV 16 Berchem TOT
54,Posthofbrug 5366,2020-10-04,10:00:00,84,49,35,FMN GV 16 Berchem TOT
54,Posthofbrug 5366,2020-10-04,11:00:00,74,46,28,FMN GV 16 Berchem TOT
54,Posthofbrug 5366,2020-10-04,12:00:00,82,46,36,FMN GV 16 Berchem TOT
54,Posthofbrug 5366,2020-10-04,13:00:00,111,56,55,FMN GV 16 Berchem TOT
54,Posthofbrug 5366,2020-10-04,14:00:00,146,79,67,FMN GV 16 Berchem TOT
54,Posthofbrug 5366,2020-10-04,15:00:00,100,48,52,FMN GV 16 Berchem TOT
54,Posthofbrug 5366,2020-10-04,16:00:00,115,47,68,FMN GV 16 Berchem TOT
54,Posthofbrug 5366,2020-10-04,17:00:00,124,55,69,FMN GV 16 Berchem TOT
54,Posthofbrug 5366,2020-10-04,18:00:00,111,55,56,FMN GV 16 Berchem TOT
54,Posthofbrug 5366,2020-10-04,19:00:00,56,27,29,FMN GV 16 Berchem TOT
54,Posthofbrug 5366,2020-10-04,20:00:00,51,28,23,FMN GV 16 Berchem TOT
54,Posthofbrug 5366,2020-10-04,21:00:00,44,26,18,FMN GV 16 Berchem TOT
54,Posthofbrug 5366,2020-10-04,22:00:00,34,22,12,FMN GV 16 Berchem TOT
54,Posthofbrug 5366,2020-10-04,23:00:00,9,5,4,FMN GV 16 Berchem TOT
54,Posthofbrug 5366,2020-10-05,00:00:00,12,5,7,FMN GV 16 Berchem TOT
54,Posthofbrug 5366,2020-10-05,01:00:00,7,3,4,FMN GV 16 Berchem TOT
54,Posthofbrug 5366,2020-10-05,02:00:00,2,0,2,FMN GV 16 Berchem TOT
54,Posthofbrug 5366,2020-10-05,03:00:00,3,3,0,FMN GV 16 Berchem TOT
54,Posthofbrug 5366,2020-10-05,04:00:00,8,6,2,FMN GV 16 Berchem TOT
54,Posthofbrug 5366,2020-10-05,05:00:00,18,11,7,FMN GV 16 Berchem TOT
54,Posthofbrug 5366,2020-10-05,06:00:00,58,48,10,FMN GV 16 Berchem TOT
54,Posthofbrug 5366,2020-10-05,07:00:00,274,208,66,FMN GV 16 Berchem TOT
54,Posthofbrug 5366,2020-10-05,08:00:00,450,333,117,FMN GV 16 Berchem TOT
54,Posthofbrug 5366,2020-10-05,09:00:00,154,108,46,FMN GV 16 Berchem TOT
54,Posthofbrug 5366,2020-10-05,10:00:00,109,70,39,FMN GV 16 Berchem TOT
54,Posthofbrug 5366,2020-10-05,11:00:00,104,56,48,FMN GV 16 Berchem TOT
54,Posthofbrug 5366,2020-10-05,12:00:00,153,90,63,FMN GV 16 Berchem TOT
54,Posthofbrug 5366,2020-10-05,13:00:00,139,76,63,FMN GV 16 Berchem TOT
54,Posthofbrug 5366,2020-10-05,14:00:00,93,34,59,FMN GV 16 Berchem TOT
54,Posthofbrug 5366,2020-10-05,15:00:00,157,66,91,FMN GV 16 Berchem TOT
54,Posthofbrug 5366,2020-10-05,16:00:00,306,110,196,FMN GV 16 Berchem TOT
54,Posthofbrug 5366,2020-10-05,17:00:00,334,113,221,FMN GV 16 Berchem TOT
54,Posthofbrug 5366,2020-10-05,18:00:00,240,73,167,FMN GV 16 Berchem TOT
54,Posthofbrug 5366,2020-10-05,19:00:00,121,52,69,FMN GV 16 Berchem TOT
54,Posthofbrug 5366,2020-10-05,20:00:00,105,54,51,FMN GV 16 Berchem TOT
54,Posthofbrug 5366,2020-10-05,21:00:00,60,28,32,FMN GV 16 Berchem TOT
54,Posthofbrug 5366,2020-10-05,22:00:00,56,26,30,FMN GV 16 Berchem TOT
54,Posthofbrug 5366,2020-10-05,23:00:00,22,5,17,FMN GV 16 Berchem TOT
54,Posthofbrug 5366,2020-10-06,00:00:00,11,0,11,FMN GV 16 Berchem TOT
54,Posthofbrug 5366,2020-10-06,01:00:00,4,1,3,FMN GV 16 Berchem TOT
54,Posthofbrug 5366,2020-10-06,02:00:00,2,0,2,FMN GV 16 Berchem TOT
54,Posthofbrug 5366,2020-10-06,03:00:00,7,0,7,FMN GV 16 Berchem TOT
54,Posthofbrug 5366,2020-10-06,04:00:00,8,6,2,FMN GV 16 Berchem TOT
54,Posthofbrug 5366,2020-10-06,05:00:00,27,22,5,FMN GV 16 Berchem TOT
54,Posthofbrug 5366,2020-10-06,06:00:00,82,68,14,FMN GV 16 Berchem TOT
54,Posthofbrug 5366,2020-10-06,07:00:00,325,246,79,FMN GV 16 Berchem TOT
54,Posthofbrug 5366,2020-10-06,08:00:00,515,377,138,FMN GV 16 Berchem TOT
54,Posthofbrug 5366,2020-10-06,09:00:00,184,141,43,FMN GV 16 Berchem TOT
54,Posthofbrug 5366,2020-10-06,10:00:00,93,57,36,FMN GV 16 Berchem TOT
54,Posthofbrug 5366,2020-10-06,11:00:00,74,41,33,FMN GV 16 Berchem TOT
54,Posthofbrug 5366,2020-10-06,12:00:00,130,66,64,FMN GV 16 Berchem TOT
54,Posthofbrug 5366,2020-10-06,13:00:00,108,59,49,FMN GV 16 Berchem TOT
54,Posthofbrug 5366,2020-10-06,14:00:00,91,39,52,FMN GV 16 Berchem TOT
54,Posthofbrug 5366,2020-10-06,15:00:00,175,49,126,FMN GV 16 Berchem TOT
54,Posthofbrug 5366,2020-10-06,16:00:00,331,113,218,FMN GV 16 Berchem TOT
54,Posthofbrug 5366,2020-10-06,17:00:00,386,129,257,FMN GV 16 Berchem TOT
54,Posthofbrug 5366,2020-10-06,18:00:00,281,84,197,FMN GV 16 Berchem TOT
54,Posthofbrug 5366,2020-10-06,19:00:00,146,58,88,FMN GV 16 Berchem TOT
54,Posthofbrug 5366,2020-10-06,20:00:00,103,40,63,FMN GV 16 Berchem TOT
54,Posthofbrug 5366,2020-10-06,21:00:00,71,34,37,FMN GV 16 Berchem TOT
54,Posthofbrug 5366,2020-10-06,22:00:00,78,39,39,FMN GV 16 Berchem TOT
54,Posthofbrug 5366,2020-10-06,23:00:00,35,14,21,FMN GV 16 Berchem TOT
54,Posthofbrug 5366,2020-10-07,00:00:00,16,5,11,FMN GV 16 Berchem TOT
54,Posthofbrug 5366,2020-10-07,01:00:00,22,4,18,FMN GV 16 Berchem TOT
54,Posthofbrug 5366,2020-10-07,02:00:00,0,0,0,FMN GV 16 Berchem TOT
54,Posthofbrug 5366,2020-10-07,03:00:00,3,1,2,FMN GV 16 Berchem TOT
54,Posthofbrug 5366,2020-10-07,04:00:00,5,4,1,FMN GV 16 Berchem TOT
54,Posthofbrug 5366,2020-10-07,05:00:00,26,18,8,FMN GV 16 Berchem TOT
54,Posthofbrug 5366,2020-10-07,06:00:00,88,73,15,FMN GV 16 Berchem TOT
54,Posthofbrug 5366,2020-10-07,07:00:00,308,223,85,FMN GV 16 Berchem TOT
54,Posthofbrug 5366,2020-10-07,08:00:00,490,357,133,FMN GV 16 Berchem TOT
54,Posthofbrug 5366,2020-10-07,09:00:00,161,113,48,FMN GV 16 Berchem TOT
54,Posthofbrug 5366,2020-10-07,10:00:00,110,63,47,FMN GV 16 Berchem TOT
54,Posthofbrug 5366,2020-10-07,11:00:00,93,45,48,FMN GV 16 Berchem TOT
54,Posthofbrug 5366,2020-10-07,12:00:00,282,124,158,FMN GV 16 Berchem TOT
54,Posthofbrug 5366,2020-10-07,13:00:00,174,74,100,FMN GV 16 Berchem TOT
54,Posthofbrug 5366,2020-10-07,14:00:00,124,54,70,FMN GV 16 Berchem TOT
54,Posthofbrug 5366,2020-10-07,15:00:00,148,54,94,FMN GV 16 Berchem TOT
54,Posthofbrug 5366,2020-10-07,16:00:00,272,109,163,FMN GV 16 Berchem TOT
54,Posthofbrug 5366,2020-10-07,17:00:00,392,134,258,FMN GV 16 Berchem TOT
54,Posthofbrug 5366,2020-10-07,18:00:00,298,126,172,FMN GV 16 Berchem TOT
54,Posthofbrug 5366,2020-10-07,19:00:00,151,63,88,FMN GV 16 Berchem TOT
54,Posthofbrug 5366,2020-10-07,20:00:00,97,55,42,FMN GV 16 Berchem TOT
54,Posthofbrug 5366,2020-10-07,21:00:00,75,26,49,FMN GV 16 Berchem TOT
54,Posthofbrug 5366,2020-10-07,22:00:00,69,35,34,FMN GV 16 Berchem TOT
54,Posthofbrug 5366,2020-10-07,23:00:00,44,11,33,FMN GV 16 Berchem TOT
54,Posthofbrug 5366,2020-10-08,00:00:00,24,8,16,FMN GV 16 Berchem TOT
54,Posthofbrug 5366,2020-10-08,01:00:00,23,2,21,FMN GV 16 Berchem TOT
54,Posthofbrug 5366,2020-10-08,02:00:00,1,0,1,FMN GV 16 Berchem TOT
54,Posthofbrug 5366,2020-10-08,03:00:00,4,1,3,FMN GV 16 Berchem TOT
54,Posthofbrug 5366,2020-10-08,04:00:00,14,10,4,FMN GV 16 Berchem TOT
54,Posthofbrug 5366,2020-10-08,05:00:00,22,14,8,FMN GV 16 Berchem TOT
54,Posthofbrug 5366,2020-10-08,06:00:00,73,64,9,FMN GV 16 Berchem TOT
54,Posthofbrug 5366,2020-10-08,07:00:00,318,227,91,FMN GV 16 Berchem TOT
54,Posthofbrug 5366,2020-10-08,08:00:00,493,359,134,FMN GV 16 Berchem TOT
54,Posthofbrug 5366,2020-10-08,09:00:00,187,152,35,FMN GV 16 Berchem TOT
54,Posthofbrug 5366,2020-10-08,10:00:00,96,63,33,FMN GV 16 Berchem TOT
54,Posthofbrug 5366,2020-10-08,11:00:00,73,43,30,FMN GV 16 Berchem TOT
54,Posthofbrug 5366,2020-10-08,12:00:00,125,75,50,FMN GV 16 Berchem TOT
54,Posthofbrug 5366,2020-10-08,13:00:00,126,53,73,FMN GV 16 Berchem TOT
54,Posthofbrug 5366,2020-10-08,14:00:00,109,43,66,FMN GV 16 Berchem TOT
54,Posthofbrug 5366,2020-10-08,15:00:00,186,76,110,FMN GV 16 Berchem TOT
54,Posthofbrug 5366,2020-10-08,16:00:00,290,85,205,FMN GV 16 Berchem TOT
54,Posthofbrug 5366,2020-10-08,17:00:00,359,117,242,FMN GV 16 Berchem TOT
54,Posthofbrug 5366,2020-10-08,18:00:00,272,89,183,FMN GV 16 Berchem TOT
54,Posthofbrug 5366,2020-10-08,19:00:00,125,50,75,FMN GV 16 Berchem TOT
54,Posthofbrug 5366,2020-10-08,20:00:00,93,34,59,FMN GV 16 Berchem TOT
54,Posthofbrug 5366,2020-10-08,21:00:00,75,34,41,FMN GV 16 Berchem TOT
54,Posthofbrug 5366,2020-10-08,22:00:00,59,28,31,FMN GV 16 Berchem TOT
54,Posthofbrug 5366,2020-10-08,23:00:00,22,10,12,FMN GV 16 Berchem TOT
54,Posthofbrug 5366,2020-10-09,00:00:00,26,4,22,FMN GV 16 Berchem TOT
54,Posthofbrug 5366,2020-10-09,01:00:00,19,5,14,FMN GV 16 Berchem TOT
54,Posthofbrug 5366,2020-10-09,02:00:00,85,38,47,FMN GV 16 Berchem TOT
54,Posthofbrug 5366,2020-10-09,03:00:00,3,0,3,FMN GV 16 Berchem TOT
54,Posthofbrug 5366,2020-10-09,04:00:00,9,8,1,FMN GV 16 Berchem TOT
54,Posthofbrug 5366,2020-10-09,05:00:00,19,11,8,FMN GV 16 Berchem TOT
54,Posthofbrug 5366,2020-10-09,06:00:00,76,58,18,FMN GV 16 Berchem TOT
54,Posthofbrug 5366,2020-10-09,07:00:00,310,223,87,FMN GV 16 Berchem TOT
54,Posthofbrug 5366,2020-10-09,08:00:00,443,340,103,FMN GV 16 Berchem TOT
54,Posthofbrug 5366,2020-10-09,09:00:00,213,154,59,FMN GV 16 Berchem TOT
54,Posthofbrug 5366,2020-10-09,10:00:00,137,101,36,FMN GV 16 Berchem TOT
54,Posthofbrug 5366,2020-10-09,11:00:00,142,83,59,FMN GV 16 Berchem TOT
54,Posthofbrug 5366,2020-10-09,12:00:00,214,117,97,FMN GV 16 Berchem TOT
54,Posthofbrug 5366,2020-10-09,13:00:00,172,81,91,FMN GV 16 Berchem TOT
54,Posthofbrug 5366,2020-10-09,14:00:00,183,92,91,FMN GV 16 Berchem TOT
54,Posthofbrug 5366,2020-10-09,15:00:00,239,74,165,FMN GV 16 Berchem TOT
54,Posthofbrug 5366,2020-10-09,16:00:00,368,113,255,FMN GV 16 Berchem TOT
54,Posthofbrug 5366,2020-10-09,17:00:00,332,113,219,FMN GV 16 Berchem TOT
54,Posthofbrug 5366,2020-10-09,18:00:00,291,115,176,FMN GV 16 Berchem TOT
54,Posthofbrug 5366,2020-10-09,19:00:00,182,80,102,FMN GV 16 Berchem TOT
54,Posthofbrug 5366,2020-10-09,20:00:00,102,58,44,FMN GV 16 Berchem TOT
54,Posthofbrug 5366,2020-10-09,21:00:00,59,38,21,FMN GV 16 Berchem TOT
54,Posthofbrug 5366,2020-10-09,22:00:00,66,18,48,FMN GV 16 Berchem TOT
54,Posthofbrug 5366,2020-10-09,23:00:00,71,14,57,FMN GV 16 Berchem TOT
54,Posthofbrug 5366,2020-10-10,00:00:00,34,7,27,FMN GV 16 Berchem TOT
54,Posthofbrug 5366,2020-10-10,01:00:00,23,8,15,FMN GV 16 Berchem TOT
54,Posthofbrug 5366,2020-10-10,02:00:00,14,6,8,FMN GV 16 Berchem TOT
54,Posthofbrug 5366,2020-10-10,03:00:00,8,2,6,FMN GV 16 Berchem TOT
54,Posthofbrug 5366,2020-10-10,04:00:00,5,4,1,FMN GV 16 Berchem TOT
54,Posthofbrug 5366,2020-10-10,05:00:00,8,7,1,FMN GV 16 Berchem TOT
54,Posthofbrug 5366,2020-10-10,06:00:00,20,13,7,FMN GV 16 Berchem TOT
54,Posthofbrug 5366,2020-10-10,07:00:00,25,15,10,FMN GV 16 Berchem TOT
54,Posthofbrug 5366,2020-10-10,08:00:00,62,35,27,FMN GV 16 Berchem TOT
54,Posthofbrug 5366,2020-10-10,09:00:00,118,69,49,FMN GV 16 Berchem TOT
54,Posthofbrug 5366,2020-10-10,10:00:00,166,107,59,FMN GV 16 Berchem TOT
54,Posthofbrug 5366,2020-10-10,11:00:00,149,93,56,FMN GV 16 Berchem TOT
54,Posthofbrug 5366,2020-10-10,12:00:00,141,72,69,FMN GV 16 Berchem TOT
54,Posthofbrug 5366,2020-10-10,13:00:00,180,91,89,FMN GV 16 Berchem TOT
54,Posthofbrug 5366,2020-10-10,14:00:00,126,70,56,FMN GV 16 Berchem TOT
54,Posthofbrug 5366,2020-10-10,15:00:00,131,61,70,FMN GV 16 Berchem TOT
54,Posthofbrug 5366,2020-10-10,16:00:00,140,55,85,FMN GV 16 Berchem TOT
54,Posthofbrug 5366,2020-10-10,17:00:00,119,58,61,FMN GV 16 Berchem TOT
54,Posthofbrug 5366,2020-10-10,18:00:00,98,55,43,FMN GV 16 Berchem TOT
54,Posthofbrug 5366,2020-10-10,19:00:00,68,45,23,FMN GV 16 Berchem TOT
54,Posthofbrug 5366,2020-10-10,20:00:00,39,20,19,FMN GV 16 Berchem TOT
54,Posthofbrug 5366,2020-10-10,21:00:00,42,14,28,FMN GV 16 Berchem TOT
54,Posthofbrug 5366,2020-10-10,22:00:00,38,13,25,FMN GV 16 Berchem TOT
54,Posthofbrug 5366,2020-10-10,23:00:00,41,17,24,FMN GV 16 Berchem TOT
54,Posthofbrug 5366,2020-10-11,00:00:00,34,10,24,FMN GV 16 Berchem TOT
54,Posthofbrug 5366,2020-10-11,01:00:00,15,7,8,FMN GV 16 Berchem TOT
54,Posthofbrug 5366,2020-10-11,02:00:00,5,1,4,FMN GV 16 Berchem TOT
54,Posthofbrug 5366,2020-10-11,03:00:00,7,4,3,FMN GV 16 Berchem TOT
54,Posthofbrug 5366,2020-10-11,04:00:00,6,4,2,FMN GV 16 Berchem TOT
54,Posthofbrug 5366,2020-10-11,05:00:00,5,2,3,FMN GV 16 Berchem TOT
54,Posthofbrug 5366,2020-10-11,06:00:00,16,13,3,FMN GV 16 Berchem TOT
54,Posthofbrug 5366,2020-10-11,07:00:00,18,10,8,FMN GV 16 Berchem TOT
54,Posthofbrug 5366,2020-10-11,08:00:00,33,13,20,FMN GV 16 Berchem TOT
54,Posthofbrug 5366,2020-10-11,09:00:00,55,32,23,FMN GV 16 Berchem TOT
54,Posthofbrug 5366,2020-10-11,10:00:00,76,42,34,FMN GV 16 Berchem TOT
54,Posthofbrug 5366,2020-10-11,11:00:00,86,47,39,FMN GV 16 Berchem TOT
54,Posthofbrug 5366,2020-10-11,12:00:00,140,77,63,FMN GV 16 Berchem TOT
54,Posthofbrug 5366,2020-10-11,13:00:00,146,87,59,FMN GV 16 Berchem TOT
54,Posthofbrug 5366,2020-10-11,14:00:00,128,79,49,FMN GV 16 Berchem TOT
54,Posthofbrug 5366,2020-10-11,15:00:00,121,54,67,FMN GV 16 Berchem TOT
54,Posthofbrug 5366,2020-10-11,16:00:00,122,58,64,FMN GV 16 Berchem TOT
54,Posthofbrug 5366,2020-10-11,17:00:00,147,73,74,FMN GV 16 Berchem TOT
54,Posthofbrug 5366,2020-10-11,18:00:00,110,40,70,FMN GV 16 Berchem TOT
54,Posthofbrug 5366,2020-10-11,19:00:00,65,34,31,FMN GV 16 Berchem TOT
54,Posthofbrug 5366,2020-10-11,20:00:00,51,23,28,FMN GV 16 Berchem TOT
54,Posthofbrug 5366,2020-10-11,21:00:00,33,14,19,FMN GV 16 Berchem TOT
54,Posthofbrug 5366,2020-10-11,22:00:00,48,30,18,FMN GV 16 Berchem TOT
54,Posthofbrug 5366,2020-10-11,23:00:00,25,9,16,FMN GV 16 Berchem TOT
54,Posthofbrug 5366,2020-10-12,00:00:00,10,5,5,FMN GV 16 Berchem TOT
54,Posthofbrug 5366,2020-10-12,01:00:00,5,1,4,FMN GV 16 Berchem TOT
54,Posthofbrug 5366,2020-10-12,02:00:00,4,0,4,FMN GV 16 Berchem TOT
54,Posthofbrug 5366,2020-10-12,03:00:00,2,1,1,FMN GV 16 Berchem TOT
54,Posthofbrug 5366,2020-10-12,04:00:00,11,9,2,FMN GV 16 Berchem TOT
54,Posthofbrug 5366,2020-10-12,05:00:00,28,21,7,FMN GV 16 Berchem TOT
54,Posthofbrug 5366,2020-10-12,06:00:00,94,80,14,FMN GV 16 Berchem TOT
54,Posthofbrug 5366,2020-10-12,07:00:00,316,236,80,FMN GV 16 Berchem TOT
54,Posthofbrug 5366,2020-10-12,08:00:00,474,360,114,FMN GV 16 Berchem TOT
54,Posthofbrug 5366,2020-10-12,09:00:00,175,119,56,FMN GV 16 Berchem TOT
54,Posthofbrug 5366,2020-10-12,10:00:00,101,70,31,FMN GV 16 Berchem TOT
54,Posthofbrug 5366,2020-10-12,11:00:00,91,60,31,FMN GV 16 Berchem TOT
54,Posthofbrug 5366,2020-10-12,12:00:00,146,86,60,FMN GV 16 Berchem TOT
54,Posthofbrug 5366,2020-10-12,13:00:00,124,61,63,FMN GV 16 Berchem TOT
54,Posthofbrug 5366,2020-10-12,14:00:00,121,54,67,FMN GV 16 Berchem TOT
54,Posthofbrug 5366,2020-10-12,15:00:00,194,67,127,FMN GV 16 Berchem TOT
54,Posthofbrug 5366,2020-10-12,16:00:00,343,91,252,FMN GV 16 Berchem TOT
54,Posthofbrug 5366,2020-10-12,17:00:00,424,127,297,FMN GV 16 Berchem TOT
54,Posthofbrug 5366,2020-10-12,18:00:00,278,92,186,FMN GV 16 Berchem TOT
54,Posthofbrug 5366,2020-10-12,19:00:00,138,59,79,FMN GV 16 Berchem TOT
54,Posthofbrug 5366,2020-10-12,20:00:00,73,38,35,FMN GV 16 Berchem TOT
54,Posthofbrug 5366,2020-10-12,21:00:00,67,30,37,FMN GV 16 Berchem TOT
54,Posthofbrug 5366,2020-10-12,22:00:00,50,20,30,FMN GV 16 Berchem TOT
54,Posthofbrug 5366,2020-10-12,23:00:00,30,8,22,FMN GV 16 Berchem TOT
54,Posthofbrug 5366,2020-10-13,00:00:00,3,0,3,FMN GV 16 Berchem TOT
54,Posthofbrug 5366,2020-10-13,01:00:00,10,2,8,FMN GV 16 Berchem TOT
54,Posthofbrug 5366,2020-10-13,02:00:00,2,0,2,FMN GV 16 Berchem TOT
54,Posthofbrug 5366,2020-10-13,03:00:00,3,2,1,FMN GV 16 Berchem TOT
54,Posthofbrug 5366,2020-10-13,04:00:00,6,5,1,FMN GV 16 Berchem TOT
54,Posthofbrug 5366,2020-10-13,05:00:00,34,27,7,FMN GV 16 Berchem TOT
54,Posthofbrug 5366,2020-10-13,06:00:00,91,71,20,FMN GV 16 Berchem TOT
54,Posthofbrug 5366,2020-10-13,07:00:00,363,267,96,FMN GV 16 Berchem TOT
54,Posthofbrug 5366,2020-10-13,08:00:00,501,364,137,FMN GV 16 Berchem TOT
54,Posthofbrug 5366,2020-10-13,09:00:00,214,164,50,FMN GV 16 Berchem TOT
54,Posthofbrug 5366,2020-10-13,10:00:00,114,79,35,FMN GV 16 Berchem TOT
54,Posthofbrug 5366,2020-10-13,11:00:00,95,56,39,FMN GV 16 Berchem TOT
54,Posthofbrug 5366,2020-10-13,12:00:00,161,86,75,FMN GV 16 Berchem TOT
54,Posthofbrug 5366,2020-10-13,13:00:00,136,67,69,FMN GV 16 Berchem TOT
54,Posthofbrug 5366,2020-10-13,14:00:00,125,50,75,FMN GV 16 Berchem TOT
54,Posthofbrug 5366,2020-10-13,15:00:00,198,72,126,FMN GV 16 Berchem TOT
54,Posthofbrug 5366,2020-10-13,16:00:00,340,112,228,FMN GV 16 Berchem TOT
54,Posthofbrug 5366,2020-10-13,17:00:00,420,130,290,FMN GV 16 Berchem TOT
54,Posthofbrug 5366,2020-10-13,18:00:00,275,79,196,FMN GV 16 Berchem TOT
54,Posthofbrug 5366,2020-10-13,19:00:00,159,63,96,FMN GV 16 Berchem TOT
54,Posthofbrug 5366,2020-10-13,20:00:00,77,36,41,FMN GV 16 Berchem TOT
54,Posthofbrug 5366,2020-10-13,21:00:00,74,35,39,FMN GV 16 Berchem TOT
54,Posthofbrug 5366,2020-10-13,22:00:00,70,36,34,FMN GV 16 Berchem TOT
54,Posthofbrug 5366,2020-10-13,23:00:00,42,9,33,FMN GV 16 Berchem TOT
54,Posthofbrug 5366,2020-10-14,00:00:00,18,8,10,FMN GV 16 Berchem TOT
54,Posthofbrug 5366,2020-10-14,01:00:00,6,0,6,FMN GV 16 Berchem TOT
54,Posthofbrug 5366,2020-10-14,02:00:00,3,1,2,FMN GV 16 Berchem TOT
54,Posthofbrug 5366,2020-10-14,03:00:00,0,0,0,FMN GV 16 Berchem TOT
54,Posthofbrug 5366,2020-10-14,04:00:00,9,8,1,FMN GV 16 Berchem TOT
54,Posthofbrug 5366,2020-10-14,05:00:00,30,24,6,FMN GV 16 Berchem TOT
54,Posthofbrug 5366,2020-10-14,06:00:00,86,70,16,FMN GV 16 Berchem TOT
54,Posthofbrug 5366,2020-10-14,07:00:00,332,243,89,FMN GV 16 Berchem TOT
54,Posthofbrug 5366,2020-10-14,08:00:00,460,336,124,FMN GV 16 Berchem TOT
54,Posthofbrug 5366,2020-10-14,09:00:00,183,126,57,FMN GV 16 Berchem TOT
54,Posthofbrug 5366,2020-10-14,10:00:00,111,69,42,FMN GV 16 Berchem TOT
54,Posthofbrug 5366,2020-10-14,11:00:00,127,63,64,FMN GV 16 Berchem TOT
54,Posthofbrug 5366,2020-10-14,12:00:00,227,100,127,FMN GV 16 Berchem TOT
54,Posthofbrug 5366,2020-10-14,13:00:00,190,86,104,FMN GV 16 Berchem TOT
54,Posthofbrug 5366,2020-10-14,14:00:00,153,61,92,FMN GV 16 Berchem TOT
54,Posthofbrug 5366,2020-10-14,15:00:00,166,72,94,FMN GV 16 Berchem TOT
54,Posthofbrug 5366,2020-10-14,16:00:00,251,82,169,FMN GV 16 Berchem TOT
54,Posthofbrug 5366,2020-10-14,17:00:00,364,144,220,FMN GV 16 Berchem TOT
54,Posthofbrug 5366,2020-10-14,18:00:00,275,99,176,FMN GV 16 Berchem TOT
54,Posthofbrug 5366,2020-10-14,19:00:00,151,65,86,FMN GV 16 Berchem TOT
54,Posthofbrug 5366,2020-10-14,20:00:00,101,53,48,FMN GV 16 Berchem TOT
54,Posthofbrug 5366,2020-10-14,21:00:00,48,23,25,FMN GV 16 Berchem TOT
54,Posthofbrug 5366,2020-10-14,22:00:00,71,30,41,FMN GV 16 Berchem TOT
54,Posthofbrug 5366,2020-10-14,23:00:00,36,8,28,FMN GV 16 Berchem TOT
54,Posthofbrug 5366,2020-10-15,00:00:00,9,3,6,FMN GV 16 Berchem TOT
54,Posthofbrug 5366,2020-10-15,01:00:00,10,1,9,FMN GV 16 Berchem TOT
54,Posthofbrug 5366,2020-10-15,02:00:00,2,1,1,FMN GV 16 Berchem TOT
54,Posthofbrug 5366,2020-10-15,03:00:00,4,1,3,FMN GV 16 Berchem TOT
54,Posthofbrug 5366,2020-10-15,04:00:00,9,9,0,FMN GV 16 Berchem TOT
54,Posthofbrug 5366,2020-10-15,05:00:00,29,23,6,FMN GV 16 Berchem TOT
54,Posthofbrug 5366,2020-10-15,06:00:00,75,60,15,FMN GV 16 Berchem TOT
54,Posthofbrug 5366,2020-10-15,07:00:00,320,226,94,FMN GV 16 Berchem TOT
54,Posthofbrug 5366,2020-10-15,08:00:00,537,392,145,FMN GV 16 Berchem TOT
54,Posthofbrug 5366,2020-10-15,09:00:00,205,152,53,FMN GV 16 Berchem TOT
54,Posthofbrug 5366,2020-10-15,10:00:00,113,74,39,FMN GV 16 Berchem TOT
54,Posthofbrug 5366,2020-10-15,11:00:00,101,63,38,FMN GV 16 Berchem TOT
54,Posthofbrug 5366,2020-10-15,12:00:00,146,80,66,FMN GV 16 Berchem TOT
54,Posthofbrug 5366,2020-10-15,13:00:00,158,85,73,FMN GV 16 Berchem TOT
54,Posthofbrug 5366,2020-10-15,14:00:00,122,51,71,FMN GV 16 Berchem TOT
54,Posthofbrug 5366,2020-10-15,15:00:00,234,84,150,FMN GV 16 Berchem TOT
54,Posthofbrug 5366,2020-10-15,16:00:00,329,97,232,FMN GV 16 Berchem TOT
54,Posthofbrug 5366,2020-10-15,17:00:00,415,151,264,FMN GV 16 Berchem TOT
54,Posthofbrug 5366,2020-10-15,18:00:00,281,99,182,FMN GV 16 Berchem TOT
54,Posthofbrug 5366,2020-10-15,19:00:00,180,76,104,FMN GV 16 Berchem TOT
54,Posthofbrug 5366,2020-10-15,20:00:00,90,44,46,FMN GV 16 Berchem TOT
54,Posthofbrug 5366,2020-10-15,21:00:00,79,31,48,FMN GV 16 Berchem TOT
54,Posthofbrug 5366,2020-10-15,22:00:00,73,34,39,FMN GV 16 Berchem TOT
54,Posthofbrug 5366,2020-10-15,23:00:00,56,23,33,FMN GV 16 Berchem TOT
54,Posthofbrug 5366,2020-10-16,00:00:00,17,4,13,FMN GV 16 Berchem TOT
54,Posthofbrug 5366,2020-10-16,01:00:00,12,3,9,FMN GV 16 Berchem TOT
54,Posthofbrug 5366,2020-10-16,02:00:00,7,0,7,FMN GV 16 Berchem TOT
54,Posthofbrug 5366,2020-10-16,03:00:00,1,0,1,FMN GV 16 Berchem TOT
54,Posthofbrug 5366,2020-10-16,04:00:00,4,4,0,FMN GV 16 Berchem TOT
54,Posthofbrug 5366,2020-10-16,05:00:00,21,18,3,FMN GV 16 Berchem TOT
54,Posthofbrug 5366,2020-10-16,06:00:00,68,50,18,FMN GV 16 Berchem TOT
54,Posthofbrug 5366,2020-10-16,07:00:00,248,177,71,FMN GV 16 Berchem TOT
54,Posthofbrug 5366,2020-10-16,08:00:00,431,327,104,FMN GV 16 Berchem TOT
54,Posthofbrug 5366,2020-10-16,09:00:00,179,141,38,FMN GV 16 Berchem TOT
54,Posthofbrug 5366,2020-10-16,10:00:00,110,71,39,FMN GV 16 Berchem TOT
54,Posthofbrug 5366,2020-10-16,11:00:00,108,67,41,FMN GV 16 Berchem TOT
54,Posthofbrug 5366,2020-10-16,12:00:00,177,87,90,FMN GV 16 Berchem TOT
54,Posthofbrug 5366,2020-10-16,13:00:00,155,75,80,FMN GV 16 Berchem TOT
54,Posthofbrug 5366,2020-10-16,14:00:00,173,75,98,FMN GV 16 Berchem TOT
54,Posthofbrug 5366,2020-10-16,15:00:00,212,85,127,FMN GV 16 Berchem TOT
54,Posthofbrug 5366,2020-10-16,16:00:00,292,103,189,FMN GV 16 Berchem TOT
54,Posthofbrug 5366,2020-10-16,17:00:00,322,112,210,FMN GV 16 Berchem TOT
54,Posthofbrug 5366,2020-10-16,18:00:00,277,113,164,FMN GV 16 Berchem TOT
54,Posthofbrug 5366,2020-10-16,19:00:00,135,58,77,FMN GV 16 Berchem TOT
54,Posthofbrug 5366,2020-10-16,20:00:00,97,45,52,FMN GV 16 Berchem TOT
54,Posthofbrug 5366,2020-10-16,21:00:00,71,37,34,FMN GV 16 Berchem TOT
54,Posthofbrug 5366,2020-10-16,22:00:00,61,19,42,FMN GV 16 Berchem TOT
54,Posthofbrug 5366,2020-10-16,23:00:00,58,19,39,FMN GV 16 Berchem TOT
54,Posthofbrug 5366,2020-10-17,00:00:00,43,7,36,FMN GV 16 Berchem TOT
54,Posthofbrug 5366,2020-10-17,01:00:00,42,13,29,FMN GV 16 Berchem TOT
54,Posthofbrug 5366,2020-10-17,02:00:00,12,2,10,FMN GV 16 Berchem TOT
54,Posthofbrug 5366,2020-10-17,03:00:00,12,2,10,FMN GV 16 Berchem TOT
54,Posthofbrug 5366,2020-10-17,04:00:00,8,4,4,FMN GV 16 Berchem TOT
54,Posthofbrug 5366,2020-10-17,05:00:00,11,7,4,FMN GV 16 Berchem TOT
54,Posthofbrug 5366,2020-10-17,06:00:00,29,17,12,FMN GV 16 Berchem TOT
54,Posthofbrug 5366,2020-10-17,07:00:00,21,12,9,FMN GV 16 Berchem TOT
54,Posthofbrug 5366,2020-10-17,08:00:00,57,26,31,FMN GV 16 Berchem TOT
54,Posthofbrug 5366,2020-10-17,09:00:00,103,53,50,FMN GV 16 Berchem TOT
54,Posthofbrug 5366,2020-10-17,10:00:00,133,82,51,FMN GV 16 Berchem TOT
54,Posthofbrug 5366,2020-10-17,11:00:00,137,87,50,FMN GV 16 Berchem TOT
54,Posthofbrug 5366,2020-10-17,12:00:00,159,98,61,FMN GV 16 Berchem TOT
54,Posthofbrug 5366,2020-10-17,13:00:00,173,99,74,FMN GV 16 Berchem TOT
54,Posthofbrug 5366,2020-10-17,14:00:00,202,109,93,FMN GV 16 Berchem TOT
54,Posthofbrug 5366,2020-10-17,15:00:00,198,100,98,FMN GV 16 Berchem TOT
54,Posthofbrug 5366,2020-10-17,16:00:00,154,69,85,FMN GV 16 Berchem TOT
54,Posthofbrug 5366,2020-10-17,17:00:00,179,90,89,FMN GV 16 Berchem TOT
54,Posthofbrug 5366,2020-10-17,18:00:00,157,86,71,FMN GV 16 Berchem TOT
54,Posthofbrug 5366,2020-10-17,19:00:00,113,70,43,FMN GV 16 Berchem TOT
54,Posthofbrug 5366,2020-10-17,20:00:00,65,29,36,FMN GV 16 Berchem TOT
54,Posthofbrug 5366,2020-10-17,21:00:00,43,21,22,FMN GV 16 Berchem TOT
54,Posthofbrug 5366,2020-10-17,22:00:00,56,24,32,FMN GV 16 Berchem TOT
54,Posthofbrug 5366,2020-10-17,23:00:00,50,17,33,FMN GV 16 Berchem TOT
54,Posthofbrug 5366,2020-10-18,00:00:00,37,6,31,FMN GV 16 Berchem TOT
54,Posthofbrug 5366,2020-10-18,01:00:00,38,9,29,FMN GV 16 Berchem TOT
54,Posthofbrug 5366,2020-10-18,02:00:00,16,0,16,FMN GV 16 Berchem TOT
54,Posthofbrug 5366,2020-10-18,03:00:00,18,8,10,FMN GV 16 Berchem TOT
54,Posthofbrug 5366,2020-10-18,04:00:00,10,2,8,FMN GV 16 Berchem TOT
54,Posthofbrug 5366,2020-10-18,05:00:00,5,4,1,FMN GV 16 Berchem TOT
54,Posthofbrug 5366,2020-10-18,06:00:00,14,9,5,FMN GV 16 Berchem TOT
54,Posthofbrug 5366,2020-10-18,07:00:00,14,6,8,FMN GV 16 Berchem TOT
54,Posthofbrug 5366,2020-10-18,08:00:00,39,25,14,FMN GV 16 Berchem TOT
54,Posthofbrug 5366,2020-10-18,09:00:00,82,48,34,FMN GV 16 Berchem TOT
54,Posthofbrug 5366,2020-10-18,10:00:00,149,104,45,FMN GV 16 Berchem TOT
54,Posthofbrug 5366,2020-10-18,11:00:00,129,75,54,FMN GV 16 Berchem TOT
54,Posthofbrug 5366,2020-10-18,12:00:00,163,78,85,FMN GV 16 Berchem TOT
54,Posthofbrug 5366,2020-10-18,13:00:00,144,83,61,FMN GV 16 Berchem TOT
54,Posthofbrug 5366,2020-10-18,14:00:00,124,58,66,FMN GV 16 Berchem TOT
54,Posthofbrug 5366,2020-10-18,15:00:00,111,44,67,FMN GV 16 Berchem TOT
54,Posthofbrug 5366,2020-10-18,16:00:00,172,78,94,FMN GV 16 Berchem TOT
54,Posthofbrug 5366,2020-10-18,17:00:00,152,76,76,FMN GV 16 Berchem TOT
54,Posthofbrug 5366,2020-10-18,18:00:00,96,46,50,FMN GV 16 Berchem TOT
54,Posthofbrug 5366,2020-10-18,19:00:00,69,36,33,FMN GV 16 Berchem TOT
54,Posthofbrug 5366,2020-10-18,20:00:00,61,30,31,FMN GV 16 Berchem TOT
54,Posthofbrug 5366,2020-10-18,21:00:00,37,21,16,FMN GV 16 Berchem TOT
54,Posthofbrug 5366,2020-10-18,22:00:00,43,20,23,FMN GV 16 Berchem TOT
54,Posthofbrug 5366,2020-10-18,23:00:00,26,8,18,FMN GV 16 Berchem TOT
54,Posthofbrug 5366,2020-10-19,00:00:00,7,4,3,FMN GV 16 Berchem TOT
54,Posthofbrug 5366,2020-10-19,01:00:00,12,8,4,FMN GV 16 Berchem TOT
54,Posthofbrug 5366,2020-10-19,02:00:00,9,1,8,FMN GV 16 Berchem TOT
54,Posthofbrug 5366,2020-10-19,03:00:00,3,2,1,FMN GV 16 Berchem TOT
54,Posthofbrug 5366,2020-10-19,04:00:00,9,8,1,FMN GV 16 Berchem TOT
54,Posthofbrug 5366,2020-10-19,05:00:00,24,14,10,FMN GV 16 Berchem TOT
54,Posthofbrug 5366,2020-10-19,06:00:00,75,65,10,FMN GV 16 Berchem TOT
54,Posthofbrug 5366,2020-10-19,07:00:00,269,197,72,FMN GV 16 Berchem TOT
54,Posthofbrug 5366,2020-10-19,08:00:00,456,334,122,FMN GV 16 Berchem TOT
54,Posthofbrug 5366,2020-10-19,09:00:00,165,119,46,FMN GV 16 Berchem TOT
54,Posthofbrug 5366,2020-10-19,10:00:00,109,72,37,FMN GV 16 Berchem TOT
54,Posthofbrug 5366,2020-10-19,11:00:00,94,48,46,FMN GV 16 Berchem TOT
54,Posthofbrug 5366,2020-10-19,12:00:00,159,79,80,FMN GV 16 Berchem TOT
54,Posthofbrug 5366,2020-10-19,13:00:00,125,62,63,FMN GV 16 Berchem TOT
54,Posthofbrug 5366,2020-10-19,14:00:00,120,66,54,FMN GV 16 Berchem TOT
54,Posthofbrug 5366,2020-10-19,15:00:00,209,78,131,FMN GV 16 Berchem TOT
54,Posthofbrug 5366,2020-10-19,16:00:00,325,102,223,FMN GV 16 Berchem TOT
54,Posthofbrug 5366,2020-10-19,17:00:00,370,123,247,FMN GV 16 Berchem TOT
54,Posthofbrug 5366,2020-10-19,18:00:00,240,71,169,FMN GV 16 Berchem TOT
54,Posthofbrug 5366,2020-10-19,19:00:00,112,40,72,FMN GV 16 Berchem TOT
54,Posthofbrug 5366,2020-10-19,20:00:00,92,52,40,FMN GV 16 Berchem TOT
54,Posthofbrug 5366,2020-10-19,21:00:00,53,33,20,FMN GV 16 Berchem TOT
54,Posthofbrug 5366,2020-10-19,22:00:00,37,10,27,FMN GV 16 Berchem TOT
54,Posthofbrug 5366,2020-10-19,23:00:00,22,11,11,FMN GV 16 Berchem TOT
54,Posthofbrug 5366,2020-10-20,00:00:00,2,1,1,FMN GV 16 Berchem TOT
54,Posthofbrug 5366,2020-10-20,01:00:00,4,1,3,FMN GV 16 Berchem TOT
54,Posthofbrug 5366,2020-10-20,02:00:00,0,0,0,FMN GV 16 Berchem TOT
54,Posthofbrug 5366,2020-10-20,03:00:00,2,2,0,FMN GV 16 Berchem TOT
54,Posthofbrug 5366,2020-10-20,04:00:00,7,6,1,FMN GV 16 Berchem TOT
54,Posthofbrug 5366,2020-10-20,05:00:00,23,13,10,FMN GV 16 Berchem TOT
54,Posthofbrug 5366,2020-10-20,06:00:00,86,68,18,FMN GV 16 Berchem TOT
54,Posthofbrug 5366,2020-10-20,07:00:00,296,214,82,FMN GV 16 Berchem TOT
54,Posthofbrug 5366,2020-10-20,08:00:00,437,322,115,FMN GV 16 Berchem TOT
54,Posthofbrug 5366,2020-10-20,09:00:00,172,132,40,FMN GV 16 Berchem TOT
54,Posthofbrug 5366,2020-10-20,10:00:00,100,61,39,FMN GV 16 Berchem TOT
54,Posthofbrug 5366,2020-10-20,11:00:00,72,40,32,FMN GV 16 Berchem TOT
54,Posthofbrug 5366,2020-10-20,12:00:00,134,84,50,FMN GV 16 Berchem TOT
54,Posthofbrug 5366,2020-10-20,13:00:00,112,62,50,FMN GV 16 Berchem TOT
54,Posthofbrug 5366,2020-10-20,14:00:00,111,53,58,FMN GV 16 Berchem TOT
54,Posthofbrug 5366,2020-10-20,15:00:00,185,60,125,FMN GV 16 Berchem TOT
54,Posthofbrug 5366,2020-10-20,16:00:00,302,99,203,FMN GV 16 Berchem TOT
54,Posthofbrug 5366,2020-10-20,17:00:00,329,84,245,FMN GV 16 Berchem TOT
54,Posthofbrug 5366,2020-10-20,18:00:00,220,73,147,FMN GV 16 Berchem TOT
54,Posthofbrug 5366,2020-10-20,19:00:00,93,32,61,FMN GV 16 Berchem TOT
54,Posthofbrug 5366,2020-10-20,20:00:00,58,25,33,FMN GV 16 Berchem TOT
54,Posthofbrug 5366,2020-10-20,21:00:00,60,36,24,FMN GV 16 Berchem TOT
54,Posthofbrug 5366,2020-10-20,22:00:00,54,23,31,FMN GV 16 Berchem TOT
54,Posthofbrug 5366,2020-10-20,23:00:00,39,19,20,FMN GV 16 Berchem TOT
54,Posthofbrug 5366,2020-10-21,00:00:00,1,1,0,FMN GV 16 Berchem TOT
54,Posthofbrug 5366,2020-10-21,01:00:00,0,0,0,FMN GV 16 Berchem TOT
54,Posthofbrug 5366,2020-10-21,02:00:00,0,0,0,FMN GV 16 Berchem TOT
54,Posthofbrug 5366,2020-10-21,03:00:00,1,1,0,FMN GV 16 Berchem TOT
54,Posthofbrug 5366,2020-10-21,04:00:00,7,6,1,FMN GV 16 Berchem TOT
54,Posthofbrug 5366,2020-10-21,05:00:00,24,17,7,FMN GV 16 Berchem TOT
54,Posthofbrug 5366,2020-10-21,06:00:00,67,53,14,FMN GV 16 Berchem TOT
54,Posthofbrug 5366,2020-10-21,07:00:00,201,143,58,FMN GV 16 Berchem TOT
54,Posthofbrug 5366,2020-10-21,08:00:00,278,194,84,FMN GV 16 Berchem TOT
54,Posthofbrug 5366,2020-10-21,09:00:00,108,81,27,FMN GV 16 Berchem TOT
54,Posthofbrug 5366,2020-10-21,10:00:00,72,40,32,FMN GV 16 Berchem TOT
54,Posthofbrug 5366,2020-10-21,11:00:00,70,34,36,FMN GV 16 Berchem TOT
54,Posthofbrug 5366,2020-10-21,12:00:00,210,104,106,FMN GV 16 Berchem TOT
54,Posthofbrug 5366,2020-10-21,13:00:00,180,71,109,FMN GV 16 Berchem TOT
54,Posthofbrug 5366,2020-10-21,14:00:00,118,56,62,FMN GV 16 Berchem TOT
54,Posthofbrug 5366,2020-10-21,15:00:00,116,54,62,FMN GV 16 Berchem TOT
54,Posthofbrug 5366,2020-10-21,16:00:00,200,69,131,FMN GV 16 Berchem TOT
54,Posthofbrug 5366,2020-10-21,17:00:00,248,89,159,FMN GV 16 Berchem TOT
54,Posthofbrug 5366,2020-10-21,18:00:00,186,70,116,FMN GV 16 Berchem TOT
54,Posthofbrug 5366,2020-10-21,19:00:00,116,48,68,FMN GV 16 Berchem TOT
54,Posthofbrug 5366,2020-10-21,20:00:00,63,34,29,FMN GV 16 Berchem TOT
54,Posthofbrug 5366,2020-10-21,21:00:00,43,24,19,FMN GV 16 Berchem TOT
54,Posthofbrug 5366,2020-10-21,22:00:00,42,21,21,FMN GV 16 Berchem TOT
54,Posthofbrug 5366,2020-10-21,23:00:00,25,8,17,FMN GV 16 Berchem TOT
54,Posthofbrug 5366,2020-10-22,00:00:00,1,0,1,FMN GV 16 Berchem TOT
54,Posthofbrug 5366,2020-10-22,01:00:00,2,2,0,FMN GV 16 Berchem TOT
54,Posthofbrug 5366,2020-10-22,02:00:00,2,0,2,FMN GV 16 Berchem TOT
54,Posthofbrug 5366,2020-10-22,03:00:00,2,2,0,FMN GV 16 Berchem TOT
54,Posthofbrug 5366,2020-10-22,04:00:00,9,7,2,FMN GV 16 Berchem TOT
54,Posthofbrug 5366,2020-10-22,05:00:00,27,17,10,FMN GV 16 Berchem TOT
54,Posthofbrug 5366,2020-10-22,06:00:00,87,69,18,FMN GV 16 Berchem TOT
54,Posthofbrug 5366,2020-10-22,07:00:00,290,212,78,FMN GV 16 Berchem TOT
54,Posthofbrug 5366,2020-10-22,08:00:00,447,320,127,FMN GV 16 Berchem TOT
54,Posthofbrug 5366,2020-10-22,09:00:00,170,131,39,FMN GV 16 Berchem TOT
54,Posthofbrug 5366,2020-10-22,10:00:00,130,89,41,FMN GV 16 Berchem TOT
54,Posthofbrug 5366,2020-10-22,11:00:00,108,57,51,FMN GV 16 Berchem TOT
54,Posthofbrug 5366,2020-10-22,12:00:00,164,78,86,FMN GV 16 Berchem TOT
54,Posthofbrug 5366,2020-10-22,13:00:00,150,85,65,FMN GV 16 Berchem TOT
54,Posthofbrug 5366,2020-10-22,14:00:00,129,65,64,FMN GV 16 Berchem TOT
54,Posthofbrug 5366,2020-10-22,15:00:00,212,80,132,FMN GV 16 Berchem TOT
54,Posthofbrug 5366,2020-10-22,16:00:00,306,85,221,FMN GV 16 Berchem TOT
54,Posthofbrug 5366,2020-10-22,17:00:00,329,94,235,FMN GV 16 Berchem TOT
54,Posthofbrug 5366,2020-10-22,18:00:00,240,74,166,FMN GV 16 Berchem TOT
54,Posthofbrug 5366,2020-10-22,19:00:00,143,72,71,FMN GV 16 Berchem TOT
54,Posthofbrug 5366,2020-10-22,20:00:00,82,34,48,FMN GV 16 Berchem TOT
54,Posthofbrug 5366,2020-10-22,21:00:00,65,31,34,FMN GV 16 Berchem TOT
54,Posthofbrug 5366,2020-10-22,22:00:00,61,34,27,FMN GV 16 Berchem TOT
54,Posthofbrug 5366,2020-10-22,23:00:00,32,10,22,FMN GV 16 Berchem TOT
54,Posthofbrug 5366,2020-10-23,00:00:00,0,0,0,FMN GV 16 Berchem TOT
54,Posthofbrug 5366,2020-10-23,01:00:00,1,1,0,FMN GV 16 Berchem TOT
54,Posthofbrug 5366,2020-10-23,02:00:00,2,0,2,FMN GV 16 Berchem TOT
54,Posthofbrug 5366,2020-10-23,03:00:00,0,0,0,FMN GV 16 Berchem TOT
54,Posthofbrug 5366,2020-10-23,04:00:00,3,3,0,FMN GV 16 Berchem TOT
54,Posthofbrug 5366,2020-10-23,05:00:00,28,19,9,FMN GV 16 Berchem TOT
54,Posthofbrug 5366,2020-10-23,06:00:00,77,63,14,FMN GV 16 Berchem TOT
54,Posthofbrug 5366,2020-10-23,07:00:00,256,181,75,FMN GV 16 Berchem TOT
54,Posthofbrug 5366,2020-10-23,08:00:00,374,280,94,FMN GV 16 Berchem TOT
54,Posthofbrug 5366,2020-10-23,09:00:00,161,119,42,FMN GV 16 Berchem TOT
54,Posthofbrug 5366,2020-10-23,10:00:00,90,63,27,FMN GV 16 Berchem TOT
54,Posthofbrug 5366,2020-10-23,11:00:00,138,63,75,FMN GV 16 Berchem TOT
54,Posthofbrug 5366,2020-10-23,12:00:00,170,82,88,FMN GV 16 Berchem TOT
54,Posthofbrug 5366,2020-10-23,13:00:00,154,71,83,FMN GV 16 Berchem TOT
54,Posthofbrug 5366,2020-10-23,14:00:00,165,78,87,FMN GV 16 Berchem TOT
54,Posthofbrug 5366,2020-10-23,15:00:00,210,83,127,FMN GV 16 Berchem TOT
54,Posthofbrug 5366,2020-10-23,16:00:00,326,108,218,FMN GV 16 Berchem TOT
54,Posthofbrug 5366,2020-10-23,17:00:00,321,112,209,FMN GV 16 Berchem TOT
54,Posthofbrug 5366,2020-10-23,18:00:00,239,78,161,FMN GV 16 Berchem TOT
54,Posthofbrug 5366,2020-10-23,19:00:00,110,55,55,FMN GV 16 Berchem TOT
54,Posthofbrug 5366,2020-10-23,20:00:00,71,34,37,FMN GV 16 Berchem TOT
54,Posthofbrug 5366,2020-10-23,21:00:00,47,25,22,FMN GV 16 Berchem TOT
54,Posthofbrug 5366,2020-10-23,22:00:00,65,25,40,FMN GV 16 Berchem TOT
54,Posthofbrug 5366,2020-10-23,23:00:00,61,31,30,FMN GV 16 Berchem TOT
54,Posthofbrug 5366,2020-10-24,00:00:00,5,1,4,FMN GV 16 Berchem TOT
54,Posthofbrug 5366,2020-10-24,01:00:00,1,0,1,FMN GV 16 Berchem TOT
54,Posthofbrug 5366,2020-10-24,02:00:00,1,1,0,FMN GV 16 Berchem TOT
54,Posthofbrug 5366,2020-10-24,03:00:00,2,1,1,FMN GV 16 Berchem TOT
54,Posthofbrug 5366,2020-10-24,04:00:00,4,4,0,FMN GV 16 Berchem TOT
54,Posthofbrug 5366,2020-10-24,05:00:00,13,8,5,FMN GV 16 Berchem TOT
54,Posthofbrug 5366,2020-10-24,06:00:00,18,15,3,FMN GV 16 Berchem TOT
54,Posthofbrug 5366,2020-10-24,07:00:00,33,17,16,FMN GV 16 Berchem TOT
54,Posthofbrug 5366,2020-10-24,08:00:00,58,35,23,FMN GV 16 Berchem TOT
54,Posthofbrug 5366,2020-10-24,09:00:00,90,60,30,FMN GV 16 Berchem TOT
54,Posthofbrug 5366,2020-10-24,10:00:00,112,68,44,FMN GV 16 Berchem TOT
54,Posthofbrug 5366,2020-10-24,11:00:00,122,70,52,FMN GV 16 Berchem TOT
54,Posthofbrug 5366,2020-10-24,12:00:00,117,56,61,FMN GV 16 Berchem TOT
54,Posthofbrug 5366,2020-10-24,13:00:00,179,111,68,FMN GV 16 Berchem TOT
54,Posthofbrug 5366,2020-10-24,14:00:00,179,100,79,FMN GV 16 Berchem TOT
54,Posthofbrug 5366,2020-10-24,15:00:00,162,78,84,FMN GV 16 Berchem TOT
54,Posthofbrug 5366,2020-10-24,16:00:00,153,72,81,FMN GV 16 Berchem TOT
54,Posthofbrug 5366,2020-10-24,17:00:00,152,68,84,FMN GV 16 Berchem TOT
54,Posthofbrug 5366,2020-10-24,18:00:00,115,55,60,FMN GV 16 Berchem TOT
54,Posthofbrug 5366,2020-10-24,19:00:00,60,26,34,FMN GV 16 Berchem TOT
54,Posthofbrug 5366,2020-10-24,20:00:00,42,17,25,FMN GV 16 Berchem TOT
54,Posthofbrug 5366,2020-10-24,21:00:00,44,21,23,FMN GV 16 Berchem TOT
54,Posthofbrug 5366,2020-10-24,22:00:00,41,16,25,FMN GV 16 Berchem TOT
54,Posthofbrug 5366,2020-10-24,23:00:00,47,16,31,FMN GV 16 Berchem TOT
54,Posthofbrug 5366,2020-10-25,00:00:00,12,7,5,FMN GV 16 Berchem TOT
54,Posthofbrug 5366,2020-10-25,01:00:00,0,0,0,FMN GV 16 Berchem TOT
54,Posthofbrug 5366,2020-10-25,02:00:00,3,1,2,FMN GV 16 Berchem TOT
54,Posthofbrug 5366,2020-10-25,03:00:00,1,0,1,FMN GV 16 Berchem TOT
54,Posthofbrug 5366,2020-10-25,04:00:00,1,1,0,FMN GV 16 Berchem TOT
54,Posthofbrug 5366,2020-10-25,05:00:00,10,8,2,FMN GV 16 Berchem TOT
54,Posthofbrug 5366,2020-10-25,06:00:00,19,16,3,FMN GV 16 Berchem TOT
54,Posthofbrug 5366,2020-10-25,07:00:00,17,9,8,FMN GV 16 Berchem TOT
54,Posthofbrug 5366,2020-10-25,08:00:00,42,26,16,FMN GV 16 Berchem TOT
54,Posthofbrug 5366,2020-10-25,09:00:00,81,41,40,FMN GV 16 Berchem TOT
54,Posthofbrug 5366,2020-10-25,10:00:00,61,23,38,FMN GV 16 Berchem TOT
54,Posthofbrug 5366,2020-10-25,11:00:00,73,34,39,FMN GV 16 Berchem TOT
54,Posthofbrug 5366,2020-10-25,12:00:00,120,66,54,FMN GV 16 Berchem TOT
54,Posthofbrug 5366,2020-10-25,13:00:00,105,51,54,FMN GV 16 Berchem TOT
54,Posthofbrug 5366,2020-10-25,14:00:00,116,64,52,FMN GV 16 Berchem TOT
54,Posthofbrug 5366,2020-10-25,15:00:00,104,48,56,FMN GV 16 Berchem TOT
54,Posthofbrug 5366,2020-10-25,16:00:00,105,42,63,FMN GV 16 Berchem TOT
54,Posthofbrug 5366,2020-10-25,17:00:00,92,49,43,FMN GV 16 Berchem TOT
54,Posthofbrug 5366,2020-10-25,18:00:00,69,28,41,FMN GV 16 Berchem TOT
54,Posthofbrug 5366,2020-10-25,19:00:00,48,21,27,FMN GV 16 Berchem TOT
54,Posthofbrug 5366,2020-10-25,20:00:00,45,29,16,FMN GV 16 Berchem TOT
54,Posthofbrug 5366,2020-10-25,21:00:00,22,16,6,FMN GV 16 Berchem TOT
54,Posthofbrug 5366,2020-10-25,22:00:00,27,15,12,FMN GV 16 Berchem TOT
54,Posthofbrug 5366,2020-10-25,23:00:00,18,12,6,FMN GV 16 Berchem TOT
54,Posthofbrug 5366,2020-10-26,00:00:00,1,0,1,FMN GV 16 Berchem TOT
54,Posthofbrug 5366,2020-10-26,01:00:00,0,0,0,FMN GV 16 Berchem TOT
54,Posthofbrug 5366,2020-10-26,02:00:00,0,0,0,FMN GV 16 Berchem TOT
54,Posthofbrug 5366,2020-10-26,03:00:00,1,1,0,FMN GV 16 Berchem TOT
54,Posthofbrug 5366,2020-10-26,04:00:00,9,8,1,FMN GV 16 Berchem TOT
54,Posthofbrug 5366,2020-10-26,05:00:00,29,20,9,FMN GV 16 Berchem TOT
54,Posthofbrug 5366,2020-10-26,06:00:00,86,70,16,FMN GV 16 Berchem TOT
54,Posthofbrug 5366,2020-10-26,07:00:00,312,237,75,FMN GV 16 Berchem TOT
54,Posthofbrug 5366,2020-10-26,08:00:00,392,311,81,FMN GV 16 Berchem TOT
54,Posthofbrug 5366,2020-10-26,09:00:00,155,113,42,FMN GV 16 Berchem TOT
54,Posthofbrug 5366,2020-10-26,10:00:00,83,47,36,FMN GV 16 Berchem TOT
54,Posthofbrug 5366,2020-10-26,11:00:00,64,34,30,FMN GV 16 Berchem TOT
54,Posthofbrug 5366,2020-10-26,12:00:00,149,72,77,FMN GV 16 Berchem TOT
54,Posthofbrug 5366,2020-10-26,13:00:00,126,64,62,FMN GV 16 Berchem TOT
54,Posthofbrug 5366,2020-10-26,14:00:00,120,43,77,FMN GV 16 Berchem TOT
54,Posthofbrug 5366,2020-10-26,15:00:00,213,95,118,FMN GV 16 Berchem TOT
54,Posthofbrug 5366,2020-10-26,16:00:00,334,101,233,FMN GV 16 Berchem TOT
54,Posthofbrug 5366,2020-10-26,17:00:00,346,100,246,FMN GV 16 Berchem TOT
54,Posthofbrug 5366,2020-10-26,18:00:00,202,64,138,FMN GV 16 Berchem TOT
54,Posthofbrug 5366,2020-10-26,19:00:00,105,40,65,FMN GV 16 Berchem TOT
54,Posthofbrug 5366,2020-10-26,20:00:00,65,41,24,FMN GV 16 Berchem TOT
54,Posthofbrug 5366,2020-10-26,21:00:00,50,22,28,FMN GV 16 Berchem TOT
54,Posthofbrug 5366,2020-10-26,22:00:00,33,14,19,FMN GV 16 Berchem TOT
54,Posthofbrug 5366,2020-10-26,23:00:00,13,5,8,FMN GV 16 Berchem TOT
54,Posthofbrug 5366,2020-10-27,00:00:00,3,0,3,FMN GV 16 Berchem TOT
54,Posthofbrug 5366,2020-10-27,01:00:00,1,0,1,FMN GV 16 Berchem TOT
54,Posthofbrug 5366,2020-10-27,02:00:00,0,0,0,FMN GV 16 Berchem TOT
54,Posthofbrug 5366,2020-10-27,03:00:00,1,1,0,FMN GV 16 Berchem TOT
54,Posthofbrug 5366,2020-10-27,04:00:00,7,5,2,FMN GV 16 Berchem TOT
54,Posthofbrug 5366,2020-10-27,05:00:00,34,23,11,FMN GV 16 Berchem TOT
54,Posthofbrug 5366,2020-10-27,06:00:00,81,64,17,FMN GV 16 Berchem TOT
54,Posthofbrug 5366,2020-10-27,07:00:00,304,212,92,FMN GV 16 Berchem TOT
54,Posthofbrug 5366,2020-10-27,08:00:00,384,297,87,FMN GV 16 Berchem TOT
54,Posthofbrug 5366,2020-10-27,09:00:00,154,117,37,FMN GV 16 Berchem TOT
54,Posthofbrug 5366,2020-10-27,10:00:00,84,49,35,FMN GV 16 Berchem TOT
54,Posthofbrug 5366,2020-10-27,11:00:00,85,34,51,FMN GV 16 Berchem TOT
54,Posthofbrug 5366,2020-10-27,12:00:00,117,64,53,FMN GV 16 Berchem TOT
54,Posthofbrug 5366,2020-10-27,13:00:00,116,65,51,FMN GV 16 Berchem TOT
54,Posthofbrug 5366,2020-10-27,14:00:00,93,40,53,FMN GV 16 Berchem TOT
54,Posthofbrug 5366,2020-10-27,15:00:00,183,60,123,FMN GV 16 Berchem TOT
54,Posthofbrug 5366,2020-10-27,16:00:00,296,86,210,FMN GV 16 Berchem TOT
54,Posthofbrug 5366,2020-10-27,17:00:00,304,82,222,FMN GV 16 Berchem TOT
54,Posthofbrug 5366,2020-10-27,18:00:00,191,58,133,FMN GV 16 Berchem TOT
54,Posthofbrug 5366,2020-10-27,19:00:00,103,38,65,FMN GV 16 Berchem TOT
54,Posthofbrug 5366,2020-10-27,20:00:00,51,20,31,FMN GV 16 Berchem TOT
54,Posthofbrug 5366,2020-10-27,21:00:00,65,42,23,FMN GV 16 Berchem TOT
54,Posthofbrug 5366,2020-10-27,22:00:00,42,22,20,FMN GV 16 Berchem TOT
54,Posthofbrug 5366,2020-10-27,23:00:00,20,9,11,FMN GV 16 Berchem TOT
54,Posthofbrug 5366,2020-10-28,00:00:00,1,0,1,FMN GV 16 Berchem TOT
54,Posthofbrug 5366,2020-10-28,01:00:00,0,0,0,FMN GV 16 Berchem TOT
54,Posthofbrug 5366,2020-10-28,02:00:00,1,0,1,FMN GV 16 Berchem TOT
54,Posthofbrug 5366,2020-10-28,03:00:00,0,0,0,FMN GV 16 Berchem TOT
54,Posthofbrug 5366,2020-10-28,04:00:00,8,7,1,FMN GV 16 Berchem TOT
54,Posthofbrug 5366,2020-10-28,05:00:00,18,11,7,FMN GV 16 Berchem TOT
54,Posthofbrug 5366,2020-10-28,06:00:00,74,60,14,FMN GV 16 Berchem TOT
54,Posthofbrug 5366,2020-10-28,07:00:00,237,164,73,FMN GV 16 Berchem TOT
54,Posthofbrug 5366,2020-10-28,08:00:00,334,248,86,FMN GV 16 Berchem TOT
54,Posthofbrug 5366,2020-10-28,09:00:00,119,83,36,FMN GV 16 Berchem TOT
54,Posthofbrug 5366,2020-10-28,10:00:00,93,58,35,FMN GV 16 Berchem TOT
54,Posthofbrug 5366,2020-10-28,11:00:00,94,43,51,FMN GV 16 Berchem TOT
54,Posthofbrug 5366,2020-10-28,12:00:00,225,108,117,FMN GV 16 Berchem TOT
54,Posthofbrug 5366,2020-10-28,13:00:00,145,63,82,FMN GV 16 Berchem TOT
54,Posthofbrug 5366,2020-10-28,14:00:00,109,55,54,FMN GV 16 Berchem TOT
54,Posthofbrug 5366,2020-10-28,15:00:00,147,56,91,FMN GV 16 Berchem TOT
54,Posthofbrug 5366,2020-10-28,16:00:00,182,68,114,FMN GV 16 Berchem TOT
54,Posthofbrug 5366,2020-10-28,17:00:00,242,84,158,FMN GV 16 Berchem TOT
54,Posthofbrug 5366,2020-10-28,18:00:00,153,52,101,FMN GV 16 Berchem TOT
54,Posthofbrug 5366,2020-10-28,19:00:00,69,20,49,FMN GV 16 Berchem TOT
54,Posthofbrug 5366,2020-10-28,20:00:00,34,18,16,FMN GV 16 Berchem TOT
54,Posthofbrug 5366,2020-10-28,21:00:00,27,16,11,FMN GV 16 Berchem TOT
54,Posthofbrug 5366,2020-10-28,22:00:00,31,15,16,FMN GV 16 Berchem TOT
54,Posthofbrug 5366,2020-10-28,23:00:00,23,5,18,FMN GV 16 Berchem TOT
54,Posthofbrug 5366,2020-10-29,00:00:00,3,1,2,FMN GV 16 Berchem TOT
54,Posthofbrug 5366,2020-10-29,01:00:00,1,0,1,FMN GV 16 Berchem TOT
54,Posthofbrug 5366,2020-10-29,02:00:00,1,0,1,FMN GV 16 Berchem TOT
54,Posthofbrug 5366,2020-10-29,03:00:00,0,0,0,FMN GV 16 Berchem TOT
54,Posthofbrug 5366,2020-10-29,04:00:00,6,5,1,FMN GV 16 Berchem TOT
54,Posthofbrug 5366,2020-10-29,05:00:00,24,16,8,FMN GV 16 Berchem TOT
54,Posthofbrug 5366,2020-10-29,06:00:00,60,51,9,FMN GV 16 Berchem TOT
54,Posthofbrug 5366,2020-10-29,07:00:00,233,166,67,FMN GV 16 Berchem TOT
54,Posthofbrug 5366,2020-10-29,08:00:00,347,261,86,FMN GV 16 Berchem TOT
54,Posthofbrug 5366,2020-10-29,09:00:00,139,106,33,FMN GV 16 Berchem TOT
54,Posthofbrug 5366,2020-10-29,10:00:00,95,53,42,FMN GV 16 Berchem TOT
54,Posthofbrug 5366,2020-10-29,11:00:00,93,47,46,FMN GV 16 Berchem TOT
54,Posthofbrug 5366,2020-10-29,12:00:00,133,67,66,FMN GV 16 Berchem TOT
54,Posthofbrug 5366,2020-10-29,13:00:00,104,58,46,FMN GV 16 Berchem TOT
54,Posthofbrug 5366,2020-10-29,14:00:00,102,46,56,FMN GV 16 Berchem TOT
54,Posthofbrug 5366,2020-10-29,15:00:00,155,56,99,FMN GV 16 Berchem TOT
54,Posthofbrug 5366,2020-10-29,16:00:00,242,75,167,FMN GV 16 Berchem TOT
54,Posthofbrug 5366,2020-10-29,17:00:00,270,75,195,FMN GV 16 Berchem TOT
54,Posthofbrug 5366,2020-10-29,18:00:00,139,41,98,FMN GV 16 Berchem TOT
54,Posthofbrug 5366,2020-10-29,19:00:00,81,25,56,FMN GV 16 Berchem TOT
54,Posthofbrug 5366,2020-10-29,20:00:00,41,21,20,FMN GV 16 Berchem TOT
54,Posthofbrug 5366,2020-10-29,21:00:00,42,21,21,FMN GV 16 Berchem TOT
54,Posthofbrug 5366,2020-10-29,22:00:00,28,9,19,FMN GV 16 Berchem TOT
54,Posthofbrug 5366,2020-10-29,23:00:00,14,3,11,FMN GV 16 Berchem TOT
54,Posthofbrug 5366,2020-10-30,00:00:00,3,0,3,FMN GV 16 Berchem TOT
54,Posthofbrug 5366,2020-10-30,01:00:00,1,0,1,FMN GV 16 Berchem TOT
54,Posthofbrug 5366,2020-10-30,02:00:00,1,0,1,FMN GV 16 Berchem TOT
54,Posthofbrug 5366,2020-10-30,03:00:00,1,1,0,FMN GV 16 Berchem TOT
54,Posthofbrug 5366,2020-10-30,04:00:00,12,10,2,FMN GV 16 Berchem TOT
54,Posthofbrug 5366,2020-10-30,05:00:00,23,16,7,FMN GV 16 Berchem TOT
54,Posthofbrug 5366,2020-10-30,06:00:00,64,54,10,FMN GV 16 Berchem TOT
54,Posthofbrug 5366,2020-10-30,07:00:00,211,163,48,FMN GV 16 Berchem TOT
54,Posthofbrug 5366,2020-10-30,08:00:00,298,215,83,FMN GV 16 Berchem TOT
54,Posthofbrug 5366,2020-10-30,09:00:00,132,99,33,FMN GV 16 Berchem TOT
54,Posthofbrug 5366,2020-10-30,10:00:00,101,61,40,FMN GV 16 Berchem TOT
54,Posthofbrug 5366,2020-10-30,11:00:00,99,35,64,FMN GV 16 Berchem TOT
54,Posthofbrug 5366,2020-10-30,12:00:00,107,48,59,FMN GV 16 Berchem TOT
54,Posthofbrug 5366,2020-10-30,13:00:00,126,64,62,FMN GV 16 Berchem TOT
54,Posthofbrug 5366,2020-10-30,14:00:00,136,65,71,FMN GV 16 Berchem TOT
54,Posthofbrug 5366,2020-10-30,15:00:00,193,76,117,FMN GV 16 Berchem TOT
54,Posthofbrug 5366,2020-10-30,16:00:00,216,73,143,FMN GV 16 Berchem TOT
54,Posthofbrug 5366,2020-10-30,17:00:00,248,74,174,FMN GV 16 Berchem TOT
54,Posthofbrug 5366,2020-10-30,18:00:00,166,62,104,FMN GV 16 Berchem TOT
54,Posthofbrug 5366,2020-10-30,19:00:00,79,32,47,FMN GV 16 Berchem TOT
54,Posthofbrug 5366,2020-10-30,20:00:00,55,31,24,FMN GV 16 Berchem TOT
54,Posthofbrug 5366,2020-10-30,21:00:00,37,15,22,FMN GV 16 Berchem TOT
54,Posthofbrug 5366,2020-10-30,22:00:00,30,18,12,FMN GV 16 Berchem TOT
54,Posthofbrug 5366,2020-10-30,23:00:00,36,14,22,FMN GV 16 Berchem TOT
54,Posthofbrug 5366,2020-10-31,00:00:00,8,4,4,FMN GV 16 Berchem TOT
54,Posthofbrug 5366,2020-10-31,01:00:00,3,0,3,FMN GV 16 Berchem TOT
54,Posthofbrug 5366,2020-10-31,02:00:00,2,0,2,FMN GV 16 Berchem TOT
54,Posthofbrug 5366,2020-10-31,03:00:00,0,0,0,FMN GV 16 Berchem TOT
54,Posthofbrug 5366,2020-10-31,04:00:00,5,5,0,FMN GV 16 Berchem TOT
54,Posthofbrug 5366,2020-10-31,05:00:00,10,5,5,FMN GV 16 Berchem TOT
54,Posthofbrug 5366,2020-10-31,06:00:00,10,6,4,FMN GV 16 Berchem TOT
54,Posthofbrug 5366,2020-10-31,07:00:00,12,6,6,FMN GV 16 Berchem TOT
54,Posthofbrug 5366,2020-10-31,08:00:00,56,28,28,FMN GV 16 Berchem TOT
54,Posthofbrug 5366,2020-10-31,09:00:00,109,78,31,FMN GV 16 Berchem TOT
54,Posthofbrug 5366,2020-10-31,10:00:00,176,99,77,FMN GV 16 Berchem TOT
54,Posthofbrug 5366,2020-10-31,11:00:00,171,87,84,FMN GV 16 Berchem TOT
54,Posthofbrug 5366,2020-10-31,12:00:00,222,122,100,FMN GV 16 Berchem TOT
54,Posthofbrug 5366,2020-10-31,13:00:00,217,123,94,FMN GV 16 Berchem TOT
54,Posthofbrug 5366,2020-10-31,14:00:00,232,114,118,FMN GV 16 Berchem TOT
54,Posthofbrug 5366,2020-10-31,15:00:00,249,123,126,FMN GV 16 Berchem TOT
54,Posthofbrug 5366,2020-10-31,16:00:00,184,89,95,FMN GV 16 Berchem TOT
54,Posthofbrug 5366,2020-10-31,17:00:00,164,63,101,FMN GV 16 Berchem TOT
54,Posthofbrug 5366,2020-10-31,18:00:00,74,28,46,FMN GV 16 Berchem TOT
54,Posthofbrug 5366,2020-10-31,19:00:00,51,21,30,FMN GV 16 Berchem TOT
54,Posthofbrug 5366,2020-10-31,20:00:00,32,19,13,FMN GV 16 Berchem TOT
54,Posthofbrug 5366,2020-10-31,21:00:00,16,9,7,FMN GV 16 Berchem TOT
54,Posthofbrug 5366,2020-10-31,22:00:00,22,8,14,FMN GV 16 Berchem TOT
54,Posthofbrug 5366,2020-10-31,23:00:00,30,16,14,FMN GV 16 Berchem TOT
54,Posthofbrug 5366,2020-11-01,00:00:00,6,6,0,FMN GV 16 Berchem TOT
54,Posthofbrug 5366,2020-11-01,01:00:00,0,0,0,FMN GV 16 Berchem TOT
54,Posthofbrug 5366,2020-11-01,02:00:00,3,0,3,FMN GV 16 Berchem TOT
54,Posthofbrug 5366,2020-11-01,03:00:00,2,0,2,FMN GV 16 Berchem TOT
54,Posthofbrug 5366,2020-11-01,04:00:00,6,4,2,FMN GV 16 Berchem TOT
54,Posthofbrug 5366,2020-11-01,05:00:00,4,3,1,FMN GV 16 Berchem TOT
54,Posthofbrug 5366,2020-11-01,06:00:00,7,4,3,FMN GV 16 Berchem TOT
54,Posthofbrug 5366,2020-11-01,07:00:00,6,5,1,FMN GV 16 Berchem TOT
54,Posthofbrug 5366,2020-11-01,08:00:00,21,11,10,FMN GV 16 Berchem TOT
54,Posthofbrug 5366,2020-11-01,09:00:00,66,30,36,FMN GV 16 Berchem TOT
54,Posthofbrug 5366,2020-11-01,10:00:00,92,44,48,FMN GV 16 Berchem TOT
54,Posthofbrug 5366,2020-11-01,11:00:00,78,47,31,FMN GV 16 Berchem TOT
54,Posthofbrug 5366,2020-11-01,12:00:00,82,43,39,FMN GV 16 Berchem TOT
54,Posthofbrug 5366,2020-11-01,13:00:00,65,34,31,FMN GV 16 Berchem TOT
54,Posthofbrug 5366,2020-11-01,14:00:00,65,37,28,FMN GV 16 Berchem TOT
54,Posthofbrug 5366,2020-11-01,15:00:00,85,44,41,FMN GV 16 Berchem TOT
54,Posthofbrug 5366,2020-11-01,16:00:00,70,33,37,FMN GV 16 Berchem TOT
54,Posthofbrug 5366,2020-11-01,17:00:00,74,47,27,FMN GV 16 Berchem TOT
54,Posthofbrug 5366,2020-11-01,18:00:00,59,29,30,FMN GV 16 Berchem TOT
54,Posthofbrug 5366,2020-11-01,19:00:00,29,10,19,FMN GV 16 Berchem TOT
54,Posthofbrug 5366,2020-11-01,20:00:00,30,18,12,FMN GV 16 Berchem TOT
54,Posthofbrug 5366,2020-11-01,21:00:00,25,19,6,FMN GV 16 Berchem TOT
54,Posthofbrug 5366,2020-11-01,22:00:00,23,12,11,FMN GV 16 Berchem TOT
54,Posthofbrug 5366,2020-11-01,23:00:00,16,8,8,FMN GV 16 Berchem TOT
54,Posthofbrug 5366,2020-11-02,00:00:00,5,0,5,FMN GV 16 Berchem TOT
54,Posthofbrug 5366,2020-11-02,01:00:00,0,0,0,FMN GV 16 Berchem TOT
54,Posthofbrug 5366,2020-11-02,02:00:00,1,0,1,FMN GV 16 Berchem TOT
54,Posthofbrug 5366,2020-11-02,03:00:00,0,0,0,FMN GV 16 Berchem TOT
54,Posthofbrug 5366,2020-11-02,04:00:00,12,10,2,FMN GV 16 Berchem TOT
54,Posthofbrug 5366,2020-11-02,05:00:00,23,12,11,FMN GV 16 Berchem TOT
54,Posthofbrug 5366,2020-11-02,06:00:00,44,35,9,FMN GV 16 Berchem TOT
54,Posthofbrug 5366,2020-11-02,07:00:00,95,63,32,FMN GV 16 Berchem TOT
54,Posthofbrug 5366,2020-11-02,08:00:00,152,97,55,FMN GV 16 Berchem TOT
54,Posthofbrug 5366,2020-11-02,09:00:00,74,47,27,FMN GV 16 Berchem TOT
54,Posthofbrug 5366,2020-11-02,10:00:00,59,37,22,FMN GV 16 Berchem TOT
54,Posthofbrug 5366,2020-11-02,11:00:00,57,31,26,FMN GV 16 Berchem TOT
54,Posthofbrug 5366,2020-11-02,12:00:00,73,38,35,FMN GV 16 Berchem TOT
54,Posthofbrug 5366,2020-11-02,13:00:00,65,32,33,FMN GV 16 Berchem TOT
54,Posthofbrug 5366,2020-11-02,14:00:00,70,39,31,FMN GV 16 Berchem TOT
54,Posthofbrug 5366,2020-11-02,15:00:00,83,33,50,FMN GV 16 Berchem TOT
54,Posthofbrug 5366,2020-11-02,16:00:00,117,42,75,FMN GV 16 Berchem TOT
54,Posthofbrug 5366,2020-11-02,17:00:00,142,55,87,FMN GV 16 Berchem TOT
54,Posthofbrug 5366,2020-11-02,18:00:00,76,21,55,FMN GV 16 Berchem TOT
54,Posthofbrug 5366,2020-11-02,19:00:00,62,23,39,FMN GV 16 Berchem TOT
54,Posthofbrug 5366,2020-11-02,20:00:00,66,32,34,FMN GV 16 Berchem TOT
54,Posthofbrug 5366,2020-11-02,21:00:00,21,12,9,FMN GV 16 Berchem TOT
54,Posthofbrug 5366,2020-11-02,22:00:00,11,3,8,FMN GV 16 Berchem TOT
54,Posthofbrug 5366,2020-11-02,23:00:00,13,6,7,FMN GV 16 Berchem TOT
54,Posthofbrug 5366,2020-11-03,00:00:00,1,0,1,FMN GV 16 Berchem TOT
54,Posthofbrug 5366,2020-11-03,01:00:00,1,1,0,FMN GV 16 Berchem TOT
54,Posthofbrug 5366,2020-11-03,02:00:00,1,0,1,FMN GV 16 Berchem TOT
54,Posthofbrug 5366,2020-11-03,03:00:00,3,2,1,FMN GV 16 Berchem TOT
54,Posthofbrug 5366,2020-11-03,04:00:00,12,8,4,FMN GV 16 Berchem TOT
54,Posthofbrug 5366,2020-11-03,05:00:00,28,16,12,FMN GV 16 Berchem TOT
54,Posthofbrug 5366,2020-11-03,06:00:00,64,50,14,FMN GV 16 Berchem TOT
54,Posthofbrug 5366,2020-11-03,07:00:00,135,94,41,FMN GV 16 Berchem TOT
54,Posthofbrug 5366,2020-11-03,08:00:00,170,108,62,FMN GV 16 Berchem TOT
54,Posthofbrug 5366,2020-11-03,09:00:00,120,80,40,FMN GV 16 Berchem TOT
54,Posthofbrug 5366,2020-11-03,10:00:00,81,44,37,FMN GV 16 Berchem TOT
54,Posthofbrug 5366,2020-11-03,11:00:00,79,36,43,FMN GV 16 Berchem TOT
54,Posthofbrug 5366,2020-11-03,12:00:00,94,57,37,FMN GV 16 Berchem TOT
54,Posthofbrug 5366,2020-11-03,13:00:00,111,51,60,FMN GV 16 Berchem TOT
54,Posthofbrug 5366,2020-11-03,14:00:00,125,58,67,FMN GV 16 Berchem TOT
54,Posthofbrug 5366,2020-11-03,15:00:00,141,74,67,FMN GV 16 Berchem TOT
54,Posthofbrug 5366,2020-11-03,16:00:00,211,76,135,FMN GV 16 Berchem TOT
54,Posthofbrug 5366,2020-11-03,17:00:00,208,80,128,FMN GV 16 Berchem TOT
54,Posthofbrug 5366,2020-11-03,18:00:00,117,45,72,FMN GV 16 Berchem TOT
54,Posthofbrug 5366,2020-11-03,19:00:00,62,22,40,FMN GV 16 Berchem TOT
54,Posthofbrug 5366,2020-11-03,20:00:00,59,30,29,FMN GV 16 Berchem TOT
54,Posthofbrug 5366,2020-11-03,21:00:00,17,13,4,FMN GV 16 Berchem TOT
54,Posthofbrug 5366,2020-11-03,22:00:00,28,14,14,FMN GV 16 Berchem TOT
54,Posthofbrug 5366,2020-11-03,23:00:00,21,10,11,FMN GV 16 Berchem TOT
54,Posthofbrug 5366,2020-11-04,00:00:00,1,0,1,FMN GV 16 Berchem TOT
54,Posthofbrug 5366,2020-11-04,01:00:00,1,0,1,FMN GV 16 Berchem TOT
54,Posthofbrug 5366,2020-11-04,02:00:00,1,0,1,FMN GV 16 Berchem TOT
54,Posthofbrug 5366,2020-11-04,03:00:00,1,1,0,FMN GV 16 Berchem TOT
54,Posthofbrug 5366,2020-11-04,04:00:00,12,9,3,FMN GV 16 Berchem TOT
54,Posthofbrug 5366,2020-11-04,05:00:00,26,16,10,FMN GV 16 Berchem TOT
54,Posthofbrug 5366,2020-11-04,06:00:00,62,46,16,FMN GV 16 Berchem TOT
54,Posthofbrug 5366,2020-11-04,07:00:00,126,85,41,FMN GV 16 Berchem TOT
54,Posthofbrug 5366,2020-11-04,08:00:00,172,111,61,FMN GV 16 Berchem TOT
54,Posthofbrug 5366,2020-11-04,09:00:00,115,68,47,FMN GV 16 Berchem TOT
54,Posthofbrug 5366,2020-11-04,10:00:00,107,71,36,FMN GV 16 Berchem TOT
54,Posthofbrug 5366,2020-11-04,11:00:00,79,41,38,FMN GV 16 Berchem TOT
54,Posthofbrug 5366,2020-11-04,12:00:00,110,56,54,FMN GV 16 Berchem TOT
54,Posthofbrug 5366,2020-11-04,13:00:00,102,42,60,FMN GV 16 Berchem TOT
54,Posthofbrug 5366,2020-11-04,14:00:00,188,77,111,FMN GV 16 Berchem TOT
54,Posthofbrug 5366,2020-11-04,15:00:00,153,69,84,FMN GV 16 Berchem TOT
54,Posthofbrug 5366,2020-11-04,16:00:00,212,91,121,FMN GV 16 Berchem TOT
54,Posthofbrug 5366,2020-11-04,17:00:00,243,112,131,FMN GV 16 Berchem TOT
54,Posthofbrug 5366,2020-11-04,18:00:00,158,51,107,FMN GV 16 Berchem TOT
54,Posthofbrug 5366,2020-11-04,19:00:00,73,32,41,FMN GV 16 Berchem TOT
54,Posthofbrug 5366,2020-11-04,20:00:00,53,30,23,FMN GV 16 Berchem TOT
54,Posthofbrug 5366,2020-11-04,21:00:00,34,18,16,FMN GV 16 Berchem TOT
54,Posthofbrug 5366,2020-11-04,22:00:00,22,13,9,FMN GV 16 Berchem TOT
54,Posthofbrug 5366,2020-11-04,23:00:00,13,7,6,FMN GV 16 Berchem TOT
54,Posthofbrug 5366,2020-11-05,00:00:00,5,0,5,FMN GV 16 Berchem TOT
54,Posthofbrug 5366,2020-11-05,01:00:00,0,0,0,FMN GV 16 Berchem TOT
54,Posthofbrug 5366,2020-11-05,02:00:00,2,0,2,FMN GV 16 Berchem TOT
54,Posthofbrug 5366,2020-11-05,03:00:00,2,2,0,FMN GV 16 Berchem TOT
54,Posthofbrug 5366,2020-11-05,04:00:00,9,8,1,FMN GV 16 Berchem TOT
54,Posthofbrug 5366,2020-11-05,05:00:00,28,16,12,FMN GV 16 Berchem TOT
54,Posthofbrug 5366,2020-11-05,06:00:00,57,43,14,FMN GV 16 Berchem TOT
54,Posthofbrug 5366,2020-11-05,07:00:00,121,86,35,FMN GV 16 Berchem TOT
54,Posthofbrug 5366,2020-11-05,08:00:00,184,126,58,FMN GV 16 Berchem TOT
54,Posthofbrug 5366,2020-11-05,09:00:00,101,71,30,FMN GV 16 Berchem TOT
54,Posthofbrug 5366,2020-11-05,10:00:00,78,49,29,FMN GV 16 Berchem TOT
54,Posthofbrug 5366,2020-11-05,11:00:00,87,44,43,FMN GV 16 Berchem TOT
54,Posthofbrug 5366,2020-11-05,12:00:00,104,62,42,FMN GV 16 Berchem TOT
54,Posthofbrug 5366,2020-11-05,13:00:00,141,70,71,FMN GV 16 Berchem TOT
54,Posthofbrug 5366,2020-11-05,14:00:00,144,73,71,FMN GV 16 Berchem TOT
54,Posthofbrug 5366,2020-11-05,15:00:00,171,71,100,FMN GV 16 Berchem TOT
54,Posthofbrug 5366,2020-11-05,16:00:00,252,113,139,FMN GV 16 Berchem TOT
54,Posthofbrug 5366,2020-11-05,17:00:00,225,88,137,FMN GV 16 Berchem TOT
54,Posthofbrug 5366,2020-11-05,18:00:00,108,39,69,FMN GV 16 Berchem TOT
54,Posthofbrug 5366,2020-11-05,19:00:00,62,22,40,FMN GV 16 Berchem TOT
54,Posthofbrug 5366,2020-11-05,20:00:00,47,28,19,FMN GV 16 Berchem TOT
54,Posthofbrug 5366,2020-11-05,21:00:00,36,19,17,FMN GV 16 Berchem TOT
54,Posthofbrug 5366,2020-11-05,22:00:00,33,17,16,FMN GV 16 Berchem TOT
54,Posthofbrug 5366,2020-11-05,23:00:00,27,11,16,FMN GV 16 Berchem TOT
54,Posthofbrug 5366,2020-11-06,00:00:00,1,0,1,FMN GV 16 Berchem TOT
54,Posthofbrug 5366,2020-11-06,01:00:00,0,0,0,FMN GV 16 Berchem TOT
54,Posthofbrug 5366,2020-11-06,02:00:00,1,0,1,FMN GV 16 Berchem TOT
54,Posthofbrug 5366,2020-11-06,03:00:00,0,0,0,FMN GV 16 Berchem TOT
54,Posthofbrug 5366,2020-11-06,04:00:00,9,6,3,FMN GV 16 Berchem TOT
54,Posthofbrug 5366,2020-11-06,05:00:00,16,9,7,FMN GV 16 Berchem TOT
54,Posthofbrug 5366,2020-11-06,06:00:00,51,39,12,FMN GV 16 Berchem TOT
54,Posthofbrug 5366,2020-11-06,07:00:00,98,71,27,FMN GV 16 Berchem TOT
54,Posthofbrug 5366,2020-11-06,08:00:00,149,98,51,FMN GV 16 Berchem TOT
54,Posthofbrug 5366,2020-11-06,09:00:00,113,77,36,FMN GV 16 Berchem TOT
54,Posthofbrug 5366,2020-11-06,10:00:00,69,40,29,FMN GV 16 Berchem TOT
54,Posthofbrug 5366,2020-11-06,11:00:00,114,61,53,FMN GV 16 Berchem TOT
54,Posthofbrug 5366,2020-11-06,12:00:00,118,55,63,FMN GV 16 Berchem TOT
54,Posthofbrug 5366,2020-11-06,13:00:00,139,68,71,FMN GV 16 Berchem TOT
54,Posthofbrug 5366,2020-11-06,14:00:00,167,83,84,FMN GV 16 Berchem TOT
54,Posthofbrug 5366,2020-11-06,15:00:00,205,84,121,FMN GV 16 Berchem TOT
54,Posthofbrug 5366,2020-11-06,16:00:00,195,95,100,FMN GV 16 Berchem TOT
54,Posthofbrug 5366,2020-11-06,17:00:00,202,79,123,FMN GV 16 Berchem TOT
54,Posthofbrug 5366,2020-11-06,18:00:00,103,41,62,FMN GV 16 Berchem TOT
54,Posthofbrug 5366,2020-11-06,19:00:00,64,26,38,FMN GV 16 Berchem TOT
54,Posthofbrug 5366,2020-11-06,20:00:00,28,19,9,FMN GV 16 Berchem TOT
54,Posthofbrug 5366,2020-11-06,21:00:00,28,19,9,FMN GV 16 Berchem TOT
54,Posthofbrug 5366,2020-11-06,22:00:00,29,10,19,FMN GV 16 Berchem TOT
54,Posthofbrug 5366,2020-11-06,23:00:00,37,19,18,FMN GV 16 Berchem TOT
54,Posthofbrug 5366,2020-11-07,00:00:00,3,1,2,FMN GV 16 Berchem TOT
54,Posthofbrug 5366,2020-11-07,01:00:00,1,0,1,FMN GV 16 Berchem TOT
54,Posthofbrug 5366,2020-11-07,02:00:00,1,0,1,FMN GV 16 Berchem TOT
54,Posthofbrug 5366,2020-11-07,03:00:00,3,0,3,FMN GV 16 Berchem TOT
54,Posthofbrug 5366,2020-11-07,04:00:00,4,4,0,FMN GV 16 Berchem TOT
54,Posthofbrug 5366,2020-11-07,05:00:00,5,3,2,FMN GV 16 Berchem TOT
54,Posthofbrug 5366,2020-11-07,06:00:00,18,11,7,FMN GV 16 Berchem TOT
54,Posthofbrug 5366,2020-11-07,07:00:00,23,15,8,FMN GV 16 Berchem TOT
54,Posthofbrug 5366,2020-11-07,08:00:00,39,15,24,FMN GV 16 Berchem TOT
54,Posthofbrug 5366,2020-11-07,09:00:00,88,40,48,FMN GV 16 Berchem TOT
54,Posthofbrug 5366,2020-11-07,10:00:00,108,63,45,FMN GV 16 Berchem TOT
54,Posthofbrug 5366,2020-11-07,11:00:00,144,84,60,FMN GV 16 Berchem TOT
54,Posthofbrug 5366,2020-11-07,12:00:00,162,81,81,FMN GV 16 Berchem TOT
54,Posthofbrug 5366,2020-11-07,13:00:00,227,117,110,FMN GV 16 Berchem TOT
54,Posthofbrug 5366,2020-11-07,14:00:00,244,104,140,FMN GV 16 Berchem TOT
54,Posthofbrug 5366,2020-11-07,15:00:00,178,81,97,FMN GV 16 Berchem TOT
54,Posthofbrug 5366,2020-11-07,16:00:00,223,125,98,FMN GV 16 Berchem TOT
54,Posthofbrug 5366,2020-11-07,17:00:00,162,77,85,FMN GV 16 Berchem TOT
54,Posthofbrug 5366,2020-11-07,18:00:00,81,40,41,FMN GV 16 Berchem TOT
54,Posthofbrug 5366,2020-11-07,19:00:00,37,16,21,FMN GV 16 Berchem TOT
54,Posthofbrug 5366,2020-11-07,20:00:00,44,25,19,FMN GV 16 Berchem TOT
54,Posthofbrug 5366,2020-11-07,21:00:00,36,21,15,FMN GV 16 Berchem TOT
54,Posthofbrug 5366,2020-11-07,22:00:00,27,18,9,FMN GV 16 Berchem TOT
54,Posthofbrug 5366,2020-11-07,23:00:00,52,31,21,FMN GV 16 Berchem TOT
54,Posthofbrug 5366,2020-11-08,00:00:00,3,0,3,FMN GV 16 Berchem TOT
54,Posthofbrug 5366,2020-11-08,01:00:00,0,0,0,FMN GV 16 Berchem TOT
54,Posthofbrug 5366,2020-11-08,02:00:00,1,0,1,FMN GV 16 Berchem TOT
54,Posthofbrug 5366,2020-11-08,03:00:00,0,0,0,FMN GV 16 Berchem TOT
54,Posthofbrug 5366,2020-11-08,04:00:00,1,0,1,FMN GV 16 Berchem TOT
54,Posthofbrug 5366,2020-11-08,05:00:00,3,1,2,FMN GV 16 Berchem TOT
54,Posthofbrug 5366,2020-11-08,06:00:00,17,12,5,FMN GV 16 Berchem TOT
54,Posthofbrug 5366,2020-11-08,07:00:00,12,6,6,FMN GV 16 Berchem TOT
54,Posthofbrug 5366,2020-11-08,08:00:00,35,15,20,FMN GV 16 Berchem TOT
54,Posthofbrug 5366,2020-11-08,09:00:00,61,32,29,FMN GV 16 Berchem TOT
54,Posthofbrug 5366,2020-11-08,10:00:00,90,44,46,FMN GV 16 Berchem TOT
54,Posthofbrug 5366,2020-11-08,11:00:00,115,53,62,FMN GV 16 Berchem TOT
54,Posthofbrug 5366,2020-11-08,12:00:00,151,82,69,FMN GV 16 Berchem TOT
54,Posthofbrug 5366,2020-11-08,13:00:00,186,85,101,FMN GV 16 Berchem TOT
54,Posthofbrug 5366,2020-11-08,14:00:00,199,96,103,FMN GV 16 Berchem TOT
54,Posthofbrug 5366,2020-11-08,15:00:00,171,86,85,FMN GV 16 Berchem TOT
54,Posthofbrug 5366,2020-11-08,16:00:00,149,71,78,FMN GV 16 Berchem TOT
54,Posthofbrug 5366,2020-11-08,17:00:00,164,98,66,FMN GV 16 Berchem TOT
54,Posthofbrug 5366,2020-11-08,18:00:00,74,38,36,FMN GV 16 Berchem TOT
54,Posthofbrug 5366,2020-11-08,19:00:00,35,18,17,FMN GV 16 Berchem TOT
54,Posthofbrug 5366,2020-11-08,20:00:00,32,17,15,FMN GV 16 Berchem TOT
54,Posthofbrug 5366,2020-11-08,21:00:00,26,18,8,FMN GV 16 Berchem TOT
54,Posthofbrug 5366,2020-11-08,22:00:00,35,19,16,FMN GV 16 Berchem TOT
54,Posthofbrug 5366,2020-11-08,23:00:00,12,5,7,FMN GV 16 Berchem TOT
54,Posthofbrug 5366,2020-11-09,00:00:00,2,1,1,FMN GV 16 Berchem TOT
54,Posthofbrug 5366,2020-11-09,01:00:00,1,0,1,FMN GV 16 Berchem TOT
54,Posthofbrug 5366,2020-11-09,02:00:00,2,0,2,FMN GV 16 Berchem TOT
54,Posthofbrug 5366,2020-11-09,03:00:00,0,0,0,FMN GV 16 Berchem TOT
54,Posthofbrug 5366,2020-11-09,04:00:00,8,6,2,FMN GV 16 Berchem TOT
54,Posthofbrug 5366,2020-11-09,05:00:00,22,13,9,FMN GV 16 Berchem TOT
54,Posthofbrug 5366,2020-11-09,06:00:00,71,52,19,FMN GV 16 Berchem TOT
54,Posthofbrug 5366,2020-11-09,07:00:00,143,103,40,FMN GV 16 Berchem TOT
54,Posthofbrug 5366,2020-11-09,08:00:00,212,160,52,FMN GV 16 Berchem TOT
54,Posthofbrug 5366,2020-11-09,09:00:00,131,79,52,FMN GV 16 Berchem TOT
54,Posthofbrug 5366,2020-11-09,10:00:00,83,56,27,FMN GV 16 Berchem TOT
54,Posthofbrug 5366,2020-11-09,11:00:00,92,37,55,FMN GV 16 Berchem TOT
54,Posthofbrug 5366,2020-11-09,12:00:00,111,65,46,FMN GV 16 Berchem TOT
54,Posthofbrug 5366,2020-11-09,13:00:00,123,59,64,FMN GV 16 Berchem TOT
54,Posthofbrug 5366,2020-11-09,14:00:00,117,65,52,FMN GV 16 Berchem TOT
54,Posthofbrug 5366,2020-11-09,15:00:00,153,75,78,FMN GV 16 Berchem TOT
54,Posthofbrug 5366,2020-11-09,16:00:00,213,74,139,FMN GV 16 Berchem TOT
54,Posthofbrug 5366,2020-11-09,17:00:00,226,85,141,FMN GV 16 Berchem TOT
54,Posthofbrug 5366,2020-11-09,18:00:00,147,55,92,FMN GV 16 Berchem TOT
54,Posthofbrug 5366,2020-11-09,19:00:00,72,25,47,FMN GV 16 Berchem TOT
54,Posthofbrug 5366,2020-11-09,20:00:00,59,26,33,FMN GV 16 Berchem TOT
54,Posthofbrug 5366,2020-11-09,21:00:00,32,17,15,FMN GV 16 Berchem TOT
54,Posthofbrug 5366,2020-11-09,22:00:00,24,12,12,FMN GV 16 Berchem TOT
54,Posthofbrug 5366,2020-11-09,23:00:00,24,10,14,FMN GV 16 Berchem TOT
54,Posthofbrug 5366,2020-11-10,00:00:00,4,0,4,FMN GV 16 Berchem TOT
54,Posthofbrug 5366,2020-11-10,01:00:00,1,0,1,FMN GV 16 Berchem TOT
54,Posthofbrug 5366,2020-11-10,02:00:00,2,0,2,FMN GV 16 Berchem TOT
54,Posthofbrug 5366,2020-11-10,03:00:00,1,1,0,FMN GV 16 Berchem TOT
54,Posthofbrug 5366,2020-11-10,04:00:00,8,8,0,FMN GV 16 Berchem TOT
54,Posthofbrug 5366,2020-11-10,05:00:00,19,11,8,FMN GV 16 Berchem TOT
54,Posthofbrug 5366,2020-11-10,06:00:00,60,47,13,FMN GV 16 Berchem TOT
54,Posthofbrug 5366,2020-11-10,07:00:00,147,97,50,FMN GV 16 Berchem TOT
54,Posthofbrug 5366,2020-11-10,08:00:00,188,137,51,FMN GV 16 Berchem TOT
54,Posthofbrug 5366,2020-11-10,09:00:00,139,98,41,FMN GV 16 Berchem TOT
54,Posthofbrug 5366,2020-11-10,10:00:00,80,47,33,FMN GV 16 Berchem TOT
54,Posthofbrug 5366,2020-11-10,11:00:00,98,53,45,FMN GV 16 Berchem TOT
54,Posthofbrug 5366,2020-11-10,12:00:00,119,57,62,FMN GV 16 Berchem TOT
54,Posthofbrug 5366,2020-11-10,13:00:00,114,59,55,FMN GV 16 Berchem TOT
54,Posthofbrug 5366,2020-11-10,14:00:00,131,70,61,FMN GV 16 Berchem TOT
54,Posthofbrug 5366,2020-11-10,15:00:00,130,57,73,FMN GV 16 Berchem TOT
54,Posthofbrug 5366,2020-11-10,16:00:00,122,44,78,FMN GV 16 Berchem TOT
54,Posthofbrug 5366,2020-11-10,17:00:00,184,65,119,FMN GV 16 Berchem TOT
54,Posthofbrug 5366,2020-11-10,18:00:00,120,45,75,FMN GV 16 Berchem TOT
54,Posthofbrug 5366,2020-11-10,19:00:00,71,24,47,FMN GV 16 Berchem TOT
54,Posthofbrug 5366,2020-11-10,20:00:00,55,31,24,FMN GV 16 Berchem TOT
54,Posthofbrug 5366,2020-11-10,21:00:00,30,15,15,FMN GV 16 Berchem TOT
54,Posthofbrug 5366,2020-11-10,22:00:00,25,15,10,FMN GV 16 Berchem TOT
54,Posthofbrug 5366,2020-11-10,23:00:00,25,14,11,FMN GV 16 Berchem TOT
54,Posthofbrug 5366,2020-11-11,00:00:00,5,1,4,FMN GV 16 Berchem TOT
54,Posthofbrug 5366,2020-11-11,01:00:00,1,0,1,FMN GV 16 Berchem TOT
54,Posthofbrug 5366,2020-11-11,02:00:00,1,0,1,FMN GV 16 Berchem TOT
54,Posthofbrug 5366,2020-11-11,03:00:00,1,1,0,FMN GV 16 Berchem TOT
54,Posthofbrug 5366,2020-11-11,04:00:00,2,2,0,FMN GV 16 Berchem TOT
54,Posthofbrug 5366,2020-11-11,05:00:00,6,6,0,FMN GV 16 Berchem TOT
54,Posthofbrug 5366,2020-11-11,06:00:00,19,13,6,FMN GV 16 Berchem TOT
54,Posthofbrug 5366,2020-11-11,07:00:00,26,14,12,FMN GV 16 Berchem TOT
54,Posthofbrug 5366,2020-11-11,08:00:00,34,20,14,FMN GV 16 Berchem TOT
54,Posthofbrug 5366,2020-11-11,09:00:00,56,27,29,FMN GV 16 Berchem TOT
54,Posthofbrug 5366,2020-11-11,10:00:00,95,42,53,FMN GV 16 Berchem TOT
54,Posthofbrug 5366,2020-11-11,11:00:00,123,67,56,FMN GV 16 Berchem TOT
54,Posthofbrug 5366,2020-11-11,12:00:00,131,65,66,FMN GV 16 Berchem TOT
54,Posthofbrug 5366,2020-11-11,13:00:00,159,89,70,FMN GV 16 Berchem TOT
54,Posthofbrug 5366,2020-11-11,14:00:00,175,79,96,FMN GV 16 Berchem TOT
54,Posthofbrug 5366,2020-11-11,15:00:00,198,103,95,FMN GV 16 Berchem TOT
54,Posthofbrug 5366,2020-11-11,16:00:00,202,109,93,FMN GV 16 Berchem TOT
54,Posthofbrug 5366,2020-11-11,17:00:00,127,86,41,FMN GV 16 Berchem TOT
54,Posthofbrug 5366,2020-11-11,18:00:00,65,31,34,FMN GV 16 Berchem TOT
54,Posthofbrug 5366,2020-11-11,19:00:00,59,21,38,FMN GV 16 Berchem TOT
54,Posthofbrug 5366,2020-11-11,20:00:00,39,20,19,FMN GV 16 Berchem TOT
54,Posthofbrug 5366,2020-11-11,21:00:00,32,14,18,FMN GV 16 Berchem TOT
54,Posthofbrug 5366,2020-11-11,22:00:00,29,16,13,FMN GV 16 Berchem TOT
54,Posthofbrug 5366,2020-11-11,23:00:00,23,13,10,FMN GV 16 Berchem TOT
54,Posthofbrug 5366,2020-11-12,00:00:00,2,0,2,FMN GV 16 Berchem TOT
54,Posthofbrug 5366,2020-11-12,01:00:00,0,0,0,FMN GV 16 Berchem TOT
54,Posthofbrug 5366,2020-11-12,02:00:00,1,0,1,FMN GV 16 Berchem TOT
54,Posthofbrug 5366,2020-11-12,03:00:00,0,0,0,FMN GV 16 Berchem TOT
54,Posthofbrug 5366,2020-11-12,04:00:00,10,9,1,FMN GV 16 Berchem TOT
54,Posthofbrug 5366,2020-11-12,05:00:00,21,10,11,FMN GV 16 Berchem TOT
54,Posthofbrug 5366,2020-11-12,06:00:00,59,43,16,FMN GV 16 Berchem TOT
54,Posthofbrug 5366,2020-11-12,07:00:00,123,82,41,FMN GV 16 Berchem TOT
54,Posthofbrug 5366,2020-11-12,08:00:00,197,142,55,FMN GV 16 Berchem TOT
54,Posthofbrug 5366,2020-11-12,09:00:00,109,62,47,FMN GV 16 Berchem TOT
54,Posthofbrug 5366,2020-11-12,10:00:00,79,55,24,FMN GV 16 Berchem TOT
54,Posthofbrug 5366,2020-11-12,11:00:00,85,40,45,FMN GV 16 Berchem TOT
54,Posthofbrug 5366,2020-11-12,12:00:00,114,65,49,FMN GV 16 Berchem TOT
54,Posthofbrug 5366,2020-11-12,13:00:00,124,60,64,FMN GV 16 Berchem TOT
54,Posthofbrug 5366,2020-11-12,14:00:00,127,69,58,FMN GV 16 Berchem TOT
54,Posthofbrug 5366,2020-11-12,15:00:00,137,64,73,FMN GV 16 Berchem TOT
54,Posthofbrug 5366,2020-11-12,16:00:00,195,81,114,FMN GV 16 Berchem TOT
54,Posthofbrug 5366,2020-11-12,17:00:00,206,75,131,FMN GV 16 Berchem TOT
54,Posthofbrug 5366,2020-11-12,18:00:00,126,50,76,FMN GV 16 Berchem TOT
54,Posthofbrug 5366,2020-11-12,19:00:00,80,32,48,FMN GV 16 Berchem TOT
54,Posthofbrug 5366,2020-11-12,20:00:00,63,30,33,FMN GV 16 Berchem TOT
54,Posthofbrug 5366,2020-11-12,21:00:00,37,24,13,FMN GV 16 Berchem TOT
54,Posthofbrug 5366,2020-11-12,22:00:00,37,16,21,FMN GV 16 Berchem TOT
54,Posthofbrug 5366,2020-11-12,23:00:00,27,9,18,FMN GV 16 Berchem TOT
54,Posthofbrug 5366,2020-11-13,00:00:00,4,1,3,FMN GV 16 Berchem TOT
54,Posthofbrug 5366,2020-11-13,01:00:00,0,0,0,FMN GV 16 Berchem TOT
54,Posthofbrug 5366,2020-11-13,02:00:00,1,0,1,FMN GV 16 Berchem TOT
54,Posthofbrug 5366,2020-11-13,03:00:00,3,2,1,FMN GV 16 Berchem TOT
54,Posthofbrug 5366,2020-11-13,04:00:00,7,7,0,FMN GV 16 Berchem TOT
54,Posthofbrug 5366,2020-11-13,05:00:00,16,11,5,FMN GV 16 Berchem TOT
54,Posthofbrug 5366,2020-11-13,06:00:00,56,40,16,FMN GV 16 Berchem TOT
54,Posthofbrug 5366,2020-11-13,07:00:00,113,81,32,FMN GV 16 Berchem TOT
54,Posthofbrug 5366,2020-11-13,08:00:00,169,107,62,FMN GV 16 Berchem TOT
54,Posthofbrug 5366,2020-11-13,09:00:00,126,88,38,FMN GV 16 Berchem TOT
54,Posthofbrug 5366,2020-11-13,10:00:00,81,49,32,FMN GV 16 Berchem TOT
54,Posthofbrug 5366,2020-11-13,11:00:00,98,57,41,FMN GV 16 Berchem TOT
54,Posthofbrug 5366,2020-11-13,12:00:00,115,52,63,FMN GV 16 Berchem TOT
54,Posthofbrug 5366,2020-11-13,13:00:00,115,56,59,FMN GV 16 Berchem TOT
54,Posthofbrug 5366,2020-11-13,14:00:00,104,46,58,FMN GV 16 Berchem TOT
54,Posthofbrug 5366,2020-11-13,15:00:00,139,61,78,FMN GV 16 Berchem TOT
54,Posthofbrug 5366,2020-11-13,16:00:00,152,68,84,FMN GV 16 Berchem TOT
54,Posthofbrug 5366,2020-11-13,17:00:00,184,74,110,FMN GV 16 Berchem TOT
54,Posthofbrug 5366,2020-11-13,18:00:00,111,44,67,FMN GV 16 Berchem TOT
54,Posthofbrug 5366,2020-11-13,19:00:00,53,23,30,FMN GV 16 Berchem TOT
54,Posthofbrug 5366,2020-11-13,20:00:00,54,22,32,FMN GV 16 Berchem TOT
54,Posthofbrug 5366,2020-11-13,21:00:00,15,3,12,FMN GV 16 Berchem TOT
54,Posthofbrug 5366,2020-11-13,22:00:00,40,17,23,FMN GV 16 Berchem TOT
54,Posthofbrug 5366,2020-11-13,23:00:00,43,20,23,FMN GV 16 Berchem TOT
54,Posthofbrug 5366,2020-11-14,00:00:00,20,12,8,FMN GV 16 Berchem TOT
54,Posthofbrug 5366,2020-11-14,01:00:00,1,0,1,FMN GV 16 Berchem TOT
54,Posthofbrug 5366,2020-11-14,02:00:00,0,0,0,FMN GV 16 Berchem TOT
54,Posthofbrug 5366,2020-11-14,03:00:00,0,0,0,FMN GV 16 Berchem TOT
54,Posthofbrug 5366,2020-11-14,04:00:00,3,3,0,FMN GV 16 Berchem TOT
54,Posthofbrug 5366,2020-11-14,05:00:00,10,5,5,FMN GV 16 Berchem TOT
54,Posthofbrug 5366,2020-11-14,06:00:00,17,11,6,FMN GV 16 Berchem TOT
54,Posthofbrug 5366,2020-11-14,07:00:00,8,6,2,FMN GV 16 Berchem TOT
54,Posthofbrug 5366,2020-11-14,08:00:00,44,23,21,FMN GV 16 Berchem TOT
54,Posthofbrug 5366,2020-11-14,09:00:00,81,37,44,FMN GV 16 Berchem TOT
54,Posthofbrug 5366,2020-11-14,10:00:00,138,82,56,FMN GV 16 Berchem TOT
54,Posthofbrug 5366,2020-11-14,11:00:00,154,74,80,FMN GV 16 Berchem TOT
54,Posthofbrug 5366,2020-11-14,12:00:00,154,77,77,FMN GV 16 Berchem TOT
54,Posthofbrug 5366,2020-11-14,13:00:00,192,97,95,FMN GV 16 Berchem TOT
54,Posthofbrug 5366,2020-11-14,14:00:00,209,104,105,FMN GV 16 Berchem TOT
54,Posthofbrug 5366,2020-11-14,15:00:00,197,107,90,FMN GV 16 Berchem TOT
54,Posthofbrug 5366,2020-11-14,16:00:00,186,94,92,FMN GV 16 Berchem TOT
54,Posthofbrug 5366,2020-11-14,17:00:00,130,67,63,FMN GV 16 Berchem TOT
54,Posthofbrug 5366,2020-11-14,18:00:00,78,43,35,FMN GV 16 Berchem TOT
54,Posthofbrug 5366,2020-11-14,19:00:00,63,31,32,FMN GV 16 Berchem TOT
54,Posthofbrug 5366,2020-11-14,20:00:00,33,19,14,FMN GV 16 Berchem TOT
54,Posthofbrug 5366,2020-11-14,21:00:00,39,25,14,FMN GV 16 Berchem TOT
54,Posthofbrug 5366,2020-11-14,22:00:00,27,13,14,FMN GV 16 Berchem TOT
54,Posthofbrug 5366,2020-11-14,23:00:00,22,12,10,FMN GV 16 Berchem TOT
54,Posthofbrug 5366,2020-11-15,00:00:00,6,4,2,FMN GV 16 Berchem TOT
54,Posthofbrug 5366,2020-11-15,01:00:00,4,2,2,FMN GV 16 Berchem TOT
54,Posthofbrug 5366,2020-11-15,02:00:00,1,0,1,FMN GV 16 Berchem TOT
54,Posthofbrug 5366,2020-11-15,03:00:00,1,0,1,FMN GV 16 Berchem TOT
54,Posthofbrug 5366,2020-11-15,04:00:00,3,2,1,FMN GV 16 Berchem TOT
54,Posthofbrug 5366,2020-11-15,05:00:00,4,1,3,FMN GV 16 Berchem TOT
54,Posthofbrug 5366,2020-11-15,06:00:00,13,8,5,FMN GV 16 Berchem TOT
54,Posthofbrug 5366,2020-11-15,07:00:00,7,3,4,FMN GV 16 Berchem TOT
54,Posthofbrug 5366,2020-11-15,08:00:00,38,15,23,FMN GV 16 Berchem TOT
54,Posthofbrug 5366,2020-11-15,09:00:00,69,38,31,FMN GV 16 Berchem TOT
54,Posthofbrug 5366,2020-11-15,10:00:00,105,60,45,FMN GV 16 Berchem TOT
54,Posthofbrug 5366,2020-11-15,11:00:00,134,79,55,FMN GV 16 Berchem TOT
54,Posthofbrug 5366,2020-11-15,12:00:00,84,49,35,FMN GV 16 Berchem TOT
54,Posthofbrug 5366,2020-11-15,13:00:00,44,22,22,FMN GV 16 Berchem TOT
54,Posthofbrug 5366,2020-11-15,14:00:00,38,15,23,FMN GV 16 Berchem TOT
54,Posthofbrug 5366,2020-11-15,15:00:00,24,14,10,FMN GV 16 Berchem TOT
54,Posthofbrug 5366,2020-11-15,16:00:00,50,35,15,FMN GV 16 Berchem TOT
54,Posthofbrug 5366,2020-11-15,17:00:00,31,13,18,FMN GV 16 Berchem TOT
54,Posthofbrug 5366,2020-11-15,18:00:00,41,18,23,FMN GV 16 Berchem TOT
54,Posthofbrug 5366,2020-11-15,19:00:00,16,8,8,FMN GV 16 Berchem TOT
54,Posthofbrug 5366,2020-11-15,20:00:00,21,14,7,FMN GV 16 Berchem TOT
54,Posthofbrug 5366,2020-11-15,21:00:00,17,12,5,FMN GV 16 Berchem TOT
54,Posthofbrug 5366,2020-11-15,22:00:00,18,13,5,FMN GV 16 Berchem TOT
54,Posthofbrug 5366,2020-11-15,23:00:00,15,5,10,FMN GV 16 Berchem TOT
54,Posthofbrug 5366,2020-11-16,00:00:00,0,0,0,FMN GV 16 Berchem TOT
54,Posthofbrug 5366,2020-11-16,01:00:00,1,0,1,FMN GV 16 Berchem TOT
54,Posthofbrug 5366,2020-11-16,02:00:00,3,0,3,FMN GV 16 Berchem TOT
54,Posthofbrug 5366,2020-11-16,03:00:00,2,2,0,FMN GV 16 Berchem TOT
54,Posthofbrug 5366,2020-11-16,04:00:00,13,11,2,FMN GV 16 Berchem TOT
54,Posthofbrug 5366,2020-11-16,05:00:00,22,14,8,FMN GV 16 Berchem TOT
54,Posthofbrug 5366,2020-11-16,06:00:00,72,57,15,FMN GV 16 Berchem TOT
54,Posthofbrug 5366,2020-11-16,07:00:00,238,178,60,FMN GV 16 Berchem TOT
54,Posthofbrug 5366,2020-11-16,08:00:00,343,253,90,FMN GV 16 Berchem TOT
54,Posthofbrug 5366,2020-11-16,09:00:00,104,77,27,FMN GV 16 Berchem TOT
54,Posthofbrug 5366,2020-11-16,10:00:00,67,37,30,FMN GV 16 Berchem TOT
54,Posthofbrug 5366,2020-11-16,11:00:00,79,45,34,FMN GV 16 Berchem TOT
54,Posthofbrug 5366,2020-11-16,12:00:00,105,53,52,FMN GV 16 Berchem TOT
54,Posthofbrug 5366,2020-11-16,13:00:00,76,43,33,FMN GV 16 Berchem TOT
54,Posthofbrug 5366,2020-11-16,14:00:00,102,43,59,FMN GV 16 Berchem TOT
54,Posthofbrug 5366,2020-11-16,15:00:00,186,74,112,FMN GV 16 Berchem TOT
54,Posthofbrug 5366,2020-11-16,16:00:00,269,88,181,FMN GV 16 Berchem TOT
54,Posthofbrug 5366,2020-11-16,17:00:00,249,84,165,FMN GV 16 Berchem TOT
54,Posthofbrug 5366,2020-11-16,18:00:00,143,50,93,FMN GV 16 Berchem TOT
54,Posthofbrug 5366,2020-11-16,19:00:00,72,35,37,FMN GV 16 Berchem TOT
54,Posthofbrug 5366,2020-11-16,20:00:00,48,27,21,FMN GV 16 Berchem TOT
54,Posthofbrug 5366,2020-11-16,21:00:00,28,14,14,FMN GV 16 Berchem TOT
54,Posthofbrug 5366,2020-11-16,22:00:00,43,12,31,FMN GV 16 Berchem TOT
54,Posthofbrug 5366,2020-11-16,23:00:00,16,9,7,FMN GV 16 Berchem TOT
54,Posthofbrug 5366,2020-11-17,00:00:00,3,1,2,FMN GV 16 Berchem TOT
54,Posthofbrug 5366,2020-11-17,01:00:00,0,0,0,FMN GV 16 Berchem TOT
54,Posthofbrug 5366,2020-11-17,02:00:00,1,0,1,FMN GV 16 Berchem TOT
54,Posthofbrug 5366,2020-11-17,03:00:00,1,1,0,FMN GV 16 Berchem TOT
54,Posthofbrug 5366,2020-11-17,04:00:00,7,6,1,FMN GV 16 Berchem TOT
54,Posthofbrug 5366,2020-11-17,05:00:00,24,15,9,FMN GV 16 Berchem TOT
54,Posthofbrug 5366,2020-11-17,06:00:00,83,63,20,FMN GV 16 Berchem TOT
54,Posthofbrug 5366,2020-11-17,07:00:00,262,195,67,FMN GV 16 Berchem TOT
54,Posthofbrug 5366,2020-11-17,08:00:00,360,268,92,FMN GV 16 Berchem TOT
54,Posthofbrug 5366,2020-11-17,09:00:00,136,95,41,FMN GV 16 Berchem TOT
54,Posthofbrug 5366,2020-11-17,10:00:00,79,46,33,FMN GV 16 Berchem TOT
54,Posthofbrug 5366,2020-11-17,11:00:00,76,36,40,FMN GV 16 Berchem TOT
54,Posthofbrug 5366,2020-11-17,12:00:00,123,68,55,FMN GV 16 Berchem TOT
54,Posthofbrug 5366,2020-11-17,13:00:00,97,47,50,FMN GV 16 Berchem TOT
54,Posthofbrug 5366,2020-11-17,14:00:00,120,50,70,FMN GV 16 Berchem TOT
54,Posthofbrug 5366,2020-11-17,15:00:00,199,75,124,FMN GV 16 Berchem TOT
54,Posthofbrug 5366,2020-11-17,16:00:00,286,98,188,FMN GV 16 Berchem TOT
54,Posthofbrug 5366,2020-11-17,17:00:00,271,80,191,FMN GV 16 Berchem TOT
54,Posthofbrug 5366,2020-11-17,18:00:00,153,60,93,FMN GV 16 Berchem TOT
54,Posthofbrug 5366,2020-11-17,19:00:00,85,34,51,FMN GV 16 Berchem TOT
54,Posthofbrug 5366,2020-11-17,20:00:00,48,22,26,FMN GV 16 Berchem TOT
54,Posthofbrug 5366,2020-11-17,21:00:00,32,19,13,FMN GV 16 Berchem TOT
54,Posthofbrug 5366,2020-11-17,22:00:00,42,20,22,FMN GV 16 Berchem TOT
54,Posthofbrug 5366,2020-11-17,23:00:00,17,9,8,FMN GV 16 Berchem TOT
54,Posthofbrug 5366,2020-11-18,00:00:00,3,0,3,FMN GV 16 Berchem TOT
54,Posthofbrug 5366,2020-11-18,01:00:00,0,0,0,FMN GV 16 Berchem TOT
54,Posthofbrug 5366,2020-11-18,02:00:00,1,0,1,FMN GV 16 Berchem TOT
54,Posthofbrug 5366,2020-11-18,03:00:00,1,1,0,FMN GV 16 Berchem TOT
54,Posthofbrug 5366,2020-11-18,04:00:00,7,5,2,FMN GV 16 Berchem TOT
54,Posthofbrug 5366,2020-11-18,05:00:00,21,15,6,FMN GV 16 Berchem TOT
54,Posthofbrug 5366,2020-11-18,06:00:00,88,69,19,FMN GV 16 Berchem TOT
54,Posthofbrug 5366,2020-11-18,07:00:00,240,173,67,FMN GV 16 Berchem TOT
54,Posthofbrug 5366,2020-11-18,08:00:00,325,238,87,FMN GV 16 Berchem TOT
54,Posthofbrug 5366,2020-11-18,09:00:00,143,98,45,FMN GV 16 Berchem TOT
54,Posthofbrug 5366,2020-11-18,10:00:00,101,52,49,FMN GV 16 Berchem TOT
54,Posthofbrug 5366,2020-11-18,11:00:00,116,60,56,FMN GV 16 Berchem TOT
54,Posthofbrug 5366,2020-11-18,12:00:00,242,98,144,FMN GV 16 Berchem TOT
54,Posthofbrug 5366,2020-11-18,13:00:00,201,80,121,FMN GV 16 Berchem TOT
54,Posthofbrug 5366,2020-11-18,14:00:00,197,97,100,FMN GV 16 Berchem TOT
54,Posthofbrug 5366,2020-11-18,15:00:00,217,110,107,FMN GV 16 Berchem TOT
54,Posthofbrug 5366,2020-11-18,16:00:00,260,112,148,FMN GV 16 Berchem TOT
54,Posthofbrug 5366,2020-11-18,17:00:00,298,121,177,FMN GV 16 Berchem TOT
54,Posthofbrug 5366,2020-11-18,18:00:00,178,77,101,FMN GV 16 Berchem TOT
54,Posthofbrug 5366,2020-11-18,19:00:00,87,36,51,FMN GV 16 Berchem TOT
54,Posthofbrug 5366,2020-11-18,20:00:00,70,41,29,FMN GV 16 Berchem TOT
54,Posthofbrug 5366,2020-11-18,21:00:00,31,16,15,FMN GV 16 Berchem TOT
54,Posthofbrug 5366,2020-11-18,22:00:00,39,15,24,FMN GV 16 Berchem TOT
54,Posthofbrug 5366,2020-11-18,23:00:00,27,12,15,FMN GV 16 Berchem TOT
54,Posthofbrug 5366,2020-11-19,00:00:00,0,0,0,FMN GV 16 Berchem TOT
54,Posthofbrug 5366,2020-11-19,01:00:00,0,0,0,FMN GV 16 Berchem TOT
54,Posthofbrug 5366,2020-11-19,02:00:00,1,0,1,FMN GV 16 Berchem TOT
54,Posthofbrug 5366,2020-11-19,03:00:00,0,0,0,FMN GV 16 Berchem TOT
54,Posthofbrug 5366,2020-11-19,04:00:00,10,8,2,FMN GV 16 Berchem TOT
54,Posthofbrug 5366,2020-11-19,05:00:00,18,9,9,FMN GV 16 Berchem TOT
54,Posthofbrug 5366,2020-11-19,06:00:00,74,54,20,FMN GV 16 Berchem TOT
54,Posthofbrug 5366,2020-11-19,07:00:00,222,155,67,FMN GV 16 Berchem TOT
54,Posthofbrug 5366,2020-11-19,08:00:00,323,234,89,FMN GV 16 Berchem TOT
54,Posthofbrug 5366,2020-11-19,09:00:00,113,86,27,FMN GV 16 Berchem TOT
54,Posthofbrug 5366,2020-11-19,10:00:00,63,34,29,FMN GV 16 Berchem TOT
54,Posthofbrug 5366,2020-11-19,11:00:00,64,31,33,FMN GV 16 Berchem TOT
54,Posthofbrug 5366,2020-11-19,12:00:00,110,55,55,FMN GV 16 Berchem TOT
54,Posthofbrug 5366,2020-11-19,13:00:00,81,44,37,FMN GV 16 Berchem TOT
54,Posthofbrug 5366,2020-11-19,14:00:00,80,31,49,FMN GV 16 Berchem TOT
54,Posthofbrug 5366,2020-11-19,15:00:00,124,40,84,FMN GV 16 Berchem TOT
54,Posthofbrug 5366,2020-11-19,16:00:00,237,76,161,FMN GV 16 Berchem TOT
54,Posthofbrug 5366,2020-11-19,17:00:00,229,78,151,FMN GV 16 Berchem TOT
54,Posthofbrug 5366,2020-11-19,18:00:00,148,58,90,FMN GV 16 Berchem TOT
54,Posthofbrug 5366,2020-11-19,19:00:00,97,37,60,FMN GV 16 Berchem TOT
54,Posthofbrug 5366,2020-11-19,20:00:00,54,27,27,FMN GV 16 Berchem TOT
54,Posthofbrug 5366,2020-11-19,21:00:00,32,10,22,FMN GV 16 Berchem TOT
54,Posthofbrug 5366,2020-11-19,22:00:00,35,15,20,FMN GV 16 Berchem TOT
54,Posthofbrug 5366,2020-11-19,23:00:00,17,4,13,FMN GV 16 Berchem TOT
54,Posthofbrug 5366,2020-11-20,00:00:00,5,0,5,FMN GV 16 Berchem TOT
54,Posthofbrug 5366,2020-11-20,01:00:00,1,1,0,FMN GV 16 Berchem TOT
54,Posthofbrug 5366,2020-11-20,02:00:00,1,0,1,FMN GV 16 Berchem TOT
54,Posthofbrug 5366,2020-11-20,03:00:00,0,0,0,FMN GV 16 Berchem TOT
54,Posthofbrug 5366,2020-11-20,04:00:00,4,3,1,FMN GV 16 Berchem TOT
54,Posthofbrug 5366,2020-11-20,05:00:00,24,15,9,FMN GV 16 Berchem TOT
54,Posthofbrug 5366,2020-11-20,06:00:00,61,44,17,FMN GV 16 Berchem TOT
54,Posthofbrug 5366,2020-11-20,07:00:00,228,167,61,FMN GV 16 Berchem TOT
54,Posthofbrug 5366,2020-11-20,08:00:00,319,230,89,FMN GV 16 Berchem TOT
54,Posthofbrug 5366,2020-11-20,09:00:00,129,91,38,FMN GV 16 Berchem TOT
54,Posthofbrug 5366,2020-11-20,10:00:00,91,59,32,FMN GV 16 Berchem TOT
54,Posthofbrug 5366,2020-11-20,11:00:00,102,46,56,FMN GV 16 Berchem TOT
54,Posthofbrug 5366,2020-11-20,12:00:00,137,61,76,FMN GV 16 Berchem TOT
54,Posthofbrug 5366,2020-11-20,13:00:00,147,87,60,FMN GV 16 Berchem TOT
54,Posthofbrug 5366,2020-11-20,14:00:00,144,63,81,FMN GV 16 Berchem TOT
54,Posthofbrug 5366,2020-11-20,15:00:00,224,78,146,FMN GV 16 Berchem TOT
54,Posthofbrug 5366,2020-11-20,16:00:00,265,86,179,FMN GV 16 Berchem TOT
54,Posthofbrug 5366,2020-11-20,17:00:00,206,88,118,FMN GV 16 Berchem TOT
54,Posthofbrug 5366,2020-11-20,18:00:00,161,57,104,FMN GV 16 Berchem TOT
54,Posthofbrug 5366,2020-11-20,19:00:00,84,28,56,FMN GV 16 Berchem TOT
54,Posthofbrug 5366,2020-11-20,20:00:00,54,29,25,FMN GV 16 Berchem TOT
54,Posthofbrug 5366,2020-11-20,21:00:00,33,19,14,FMN GV 16 Berchem TOT
54,Posthofbrug 5366,2020-11-20,22:00:00,43,19,24,FMN GV 16 Berchem TOT
54,Posthofbrug 5366,2020-11-20,23:00:00,40,21,19,FMN GV 16 Berchem TOT
54,Posthofbrug 5366,2020-11-21,00:00:00,7,3,4,FMN GV 16 Berchem TOT
54,Posthofbrug 5366,2020-11-21,01:00:00,4,2,2,FMN GV 16 Berchem TOT
54,Posthofbrug 5366,2020-11-21,02:00:00,3,1,2,FMN GV 16 Berchem TOT
54,Posthofbrug 5366,2020-11-21,03:00:00,0,0,0,FMN GV 16 Berchem TOT
54,Posthofbrug 5366,2020-11-21,04:00:00,3,2,1,FMN GV 16 Berchem TOT
54,Posthofbrug 5366,2020-11-21,05:00:00,8,4,4,FMN GV 16 Berchem TOT
54,Posthofbrug 5366,2020-11-21,06:00:00,12,8,4,FMN GV 16 Berchem TOT
54,Posthofbrug 5366,2020-11-21,07:00:00,17,9,8,FMN GV 16 Berchem TOT
54,Posthofbrug 5366,2020-11-21,08:00:00,36,15,21,FMN GV 16 Berchem TOT
54,Posthofbrug 5366,2020-11-21,09:00:00,81,38,43,FMN GV 16 Berchem TOT
54,Posthofbrug 5366,2020-11-21,10:00:00,111,63,48,FMN GV 16 Berchem TOT
54,Posthofbrug 5366,2020-11-21,11:00:00,137,72,65,FMN GV 16 Berchem TOT
54,Posthofbrug 5366,2020-11-21,12:00:00,132,75,57,FMN GV 16 Berchem TOT
54,Posthofbrug 5366,2020-11-21,13:00:00,168,83,85,FMN GV 16 Berchem TOT
54,Posthofbrug 5366,2020-11-21,14:00:00,195,108,87,FMN GV 16 Berchem TOT
54,Posthofbrug 5366,2020-11-21,15:00:00,166,78,88,FMN GV 16 Berchem TOT
54,Posthofbrug 5366,2020-11-21,16:00:00,141,80,61,FMN GV 16 Berchem TOT
54,Posthofbrug 5366,2020-11-21,17:00:00,102,52,50,FMN GV 16 Berchem TOT
54,Posthofbrug 5366,2020-11-21,18:00:00,85,44,41,FMN GV 16 Berchem TOT
54,Posthofbrug 5366,2020-11-21,19:00:00,40,18,22,FMN GV 16 Berchem TOT
54,Posthofbrug 5366,2020-11-21,20:00:00,39,21,18,FMN GV 16 Berchem TOT
54,Posthofbrug 5366,2020-11-21,21:00:00,28,11,17,FMN GV 16 Berchem TOT
54,Posthofbrug 5366,2020-11-21,22:00:00,26,19,7,FMN GV 16 Berchem TOT
54,Posthofbrug 5366,2020-11-21,23:00:00,38,22,16,FMN GV 16 Berchem TOT
54,Posthofbrug 5366,2020-11-22,00:00:00,4,3,1,FMN GV 16 Berchem TOT
54,Posthofbrug 5366,2020-11-22,01:00:00,2,1,1,FMN GV 16 Berchem TOT
54,Posthofbrug 5366,2020-11-22,02:00:00,2,0,2,FMN GV 16 Berchem TOT
54,Posthofbrug 5366,2020-11-22,03:00:00,0,0,0,FMN GV 16 Berchem TOT
54,Posthofbrug 5366,2020-11-22,04:00:00,3,1,2,FMN GV 16 Berchem TOT
54,Posthofbrug 5366,2020-11-22,05:00:00,9,7,2,FMN GV 16 Berchem TOT
54,Posthofbrug 5366,2020-11-22,06:00:00,17,13,4,FMN GV 16 Berchem TOT
54,Posthofbrug 5366,2020-11-22,07:00:00,19,12,7,FMN GV 16 Berchem TOT
54,Posthofbrug 5366,2020-11-22,08:00:00,37,15,22,FMN GV 16 Berchem TOT
54,Posthofbrug 5366,2020-11-22,09:00:00,61,25,36,FMN GV 16 Berchem TOT
54,Posthofbrug 5366,2020-11-22,10:00:00,62,27,35,FMN GV 16 Berchem TOT
54,Posthofbrug 5366,2020-11-22,11:00:00,54,27,27,FMN GV 16 Berchem TOT
54,Posthofbrug 5366,2020-11-22,12:00:00,86,43,43,FMN GV 16 Berchem TOT
54,Posthofbrug 5366,2020-11-22,13:00:00,60,34,26,FMN GV 16 Berchem TOT
54,Posthofbrug 5366,2020-11-22,14:00:00,89,36,53,FMN GV 16 Berchem TOT
54,Posthofbrug 5366,2020-11-22,15:00:00,82,40,42,FMN GV 16 Berchem TOT
54,Posthofbrug 5366,2020-11-22,16:00:00,66,36,30,FMN GV 16 Berchem TOT
54,Posthofbrug 5366,2020-11-22,17:00:00,66,38,28,FMN GV 16 Berchem TOT
54,Posthofbrug 5366,2020-11-22,18:00:00,54,29,25,FMN GV 16 Berchem TOT
54,Posthofbrug 5366,2020-11-22,19:00:00,49,23,26,FMN GV 16 Berchem TOT
54,Posthofbrug 5366,2020-11-22,20:00:00,33,20,13,FMN GV 16 Berchem TOT
54,Posthofbrug 5366,2020-11-22,21:00:00,20,11,9,FMN GV 16 Berchem TOT
54,Posthofbrug 5366,2020-11-22,22:00:00,21,11,10,FMN GV 16 Berchem TOT
54,Posthofbrug 5366,2020-11-22,23:00:00,19,11,8,FMN GV 16 Berchem TOT
54,Posthofbrug 5366,2020-11-23,00:00:00,3,2,1,FMN GV 16 Berchem TOT
54,Posthofbrug 5366,2020-11-23,01:00:00,1,1,0,FMN GV 16 Berchem TOT
54,Posthofbrug 5366,2020-11-23,02:00:00,1,0,1,FMN GV 16 Berchem TOT
54,Posthofbrug 5366,2020-11-23,03:00:00,3,3,0,FMN GV 16 Berchem TOT
54,Posthofbrug 5366,2020-11-23,04:00:00,5,4,1,FMN GV 16 Berchem TOT
54,Posthofbrug 5366,2020-11-23,05:00:00,25,17,8,FMN GV 16 Berchem TOT
54,Posthofbrug 5366,2020-11-23,06:00:00,68,59,9,FMN GV 16 Berchem TOT
54,Posthofbrug 5366,2020-11-23,07:00:00,262,197,65,FMN GV 16 Berchem TOT
54,Posthofbrug 5366,2020-11-23,08:00:00,339,255,84,FMN GV 16 Berchem TOT
54,Posthofbrug 5366,2020-11-23,09:00:00,121,89,32,FMN GV 16 Berchem TOT
54,Posthofbrug 5366,2020-11-23,10:00:00,72,43,29,FMN GV 16 Berchem TOT
54,Posthofbrug 5366,2020-11-23,11:00:00,86,38,48,FMN GV 16 Berchem TOT
54,Posthofbrug 5366,2020-11-23,12:00:00,114,60,54,FMN GV 16 Berchem TOT
54,Posthofbrug 5366,2020-11-23,13:00:00,129,72,57,FMN GV 16 Berchem TOT
54,Posthofbrug 5366,2020-11-23,14:00:00,124,47,77,FMN GV 16 Berchem TOT
54,Posthofbrug 5366,2020-11-23,15:00:00,206,85,121,FMN GV 16 Berchem TOT
54,Posthofbrug 5366,2020-11-23,16:00:00,297,98,199,FMN GV 16 Berchem TOT
54,Posthofbrug 5366,2020-11-23,17:00:00,252,86,166,FMN GV 16 Berchem TOT
54,Posthofbrug 5366,2020-11-23,18:00:00,128,34,94,FMN GV 16 Berchem TOT
54,Posthofbrug 5366,2020-11-23,19:00:00,69,35,34,FMN GV 16 Berchem TOT
54,Posthofbrug 5366,2020-11-23,20:00:00,51,28,23,FMN GV 16 Berchem TOT
54,Posthofbrug 5366,2020-11-23,21:00:00,30,14,16,FMN GV 16 Berchem TOT
54,Posthofbrug 5366,2020-11-23,22:00:00,30,10,20,FMN GV 16 Berchem TOT
54,Posthofbrug 5366,2020-11-23,23:00:00,16,6,10,FMN GV 16 Berchem TOT
54,Posthofbrug 5366,2020-11-24,00:00:00,1,1,0,FMN GV 16 Berchem TOT
54,Posthofbrug 5366,2020-11-24,01:00:00,2,0,2,FMN GV 16 Berchem TOT
54,Posthofbrug 5366,2020-11-24,02:00:00,1,0,1,FMN GV 16 Berchem TOT
54,Posthofbrug 5366,2020-11-24,03:00:00,1,1,0,FMN GV 16 Berchem TOT
54,Posthofbrug 5366,2020-11-24,04:00:00,11,10,1,FMN GV 16 Berchem TOT
54,Posthofbrug 5366,2020-11-24,05:00:00,26,16,10,FMN GV 16 Berchem TOT
54,Posthofbrug 5366,2020-11-24,06:00:00,94,74,20,FMN GV 16 Berchem TOT
54,Posthofbrug 5366,2020-11-24,07:00:00,268,190,78,FMN GV 16 Berchem TOT
54,Posthofbrug 5366,2020-11-24,08:00:00,375,271,104,FMN GV 16 Berchem TOT
54,Posthofbrug 5366,2020-11-24,09:00:00,130,97,33,FMN GV 16 Berchem TOT
54,Posthofbrug 5366,2020-11-24,10:00:00,70,44,26,FMN GV 16 Berchem TOT
54,Posthofbrug 5366,2020-11-24,11:00:00,75,35,40,FMN GV 16 Berchem TOT
54,Posthofbrug 5366,2020-11-24,12:00:00,152,84,68,FMN GV 16 Berchem TOT
54,Posthofbrug 5366,2020-11-24,13:00:00,132,63,69,FMN GV 16 Berchem TOT
54,Posthofbrug 5366,2020-11-24,14:00:00,128,62,66,FMN GV 16 Berchem TOT
54,Posthofbrug 5366,2020-11-24,15:00:00,207,80,127,FMN GV 16 Berchem TOT
54,Posthofbrug 5366,2020-11-24,16:00:00,306,103,203,FMN GV 16 Berchem TOT
54,Posthofbrug 5366,2020-11-24,17:00:00,271,81,190,FMN GV 16 Berchem TOT
54,Posthofbrug 5366,2020-11-24,18:00:00,158,51,107,FMN GV 16 Berchem TOT
54,Posthofbrug 5366,2020-11-24,19:00:00,95,40,55,FMN GV 16 Berchem TOT
54,Posthofbrug 5366,2020-11-24,20:00:00,64,37,27,FMN GV 16 Berchem TOT
54,Posthofbrug 5366,2020-11-24,21:00:00,38,18,20,FMN GV 16 Berchem TOT
54,Posthofbrug 5366,2020-11-24,22:00:00,42,25,17,FMN GV 16 Berchem TOT
54,Posthofbrug 5366,2020-11-24,23:00:00,30,13,17,FMN GV 16 Berchem TOT
54,Posthofbrug 5366,2020-11-25,00:00:00,5,0,5,FMN GV 16 Berchem TOT
54,Posthofbrug 5366,2020-11-25,01:00:00,2,0,2,FMN GV 16 Berchem TOT
54,Posthofbrug 5366,2020-11-25,02:00:00,1,0,1,FMN GV 16 Berchem TOT
54,Posthofbrug 5366,2020-11-25,03:00:00,1,1,0,FMN GV 16 Berchem TOT
54,Posthofbrug 5366,2020-11-25,04:00:00,10,9,1,FMN GV 16 Berchem TOT
54,Posthofbrug 5366,2020-11-25,05:00:00,25,16,9,FMN GV 16 Berchem TOT
54,Posthofbrug 5366,2020-11-25,06:00:00,90,70,20,FMN GV 16 Berchem TOT
54,Posthofbrug 5366,2020-11-25,07:00:00,220,155,65,FMN GV 16 Berchem TOT
54,Posthofbrug 5366,2020-11-25,08:00:00,326,248,78,FMN GV 16 Berchem TOT
54,Posthofbrug 5366,2020-11-25,09:00:00,118,80,38,FMN GV 16 Berchem TOT
54,Posthofbrug 5366,2020-11-25,10:00:00,86,49,37,FMN GV 16 Berchem TOT
54,Posthofbrug 5366,2020-11-25,11:00:00,102,55,47,FMN GV 16 Berchem TOT
54,Posthofbrug 5366,2020-11-25,12:00:00,203,96,107,FMN GV 16 Berchem TOT
54,Posthofbrug 5366,2020-11-25,13:00:00,197,79,118,FMN GV 16 Berchem TOT
54,Posthofbrug 5366,2020-11-25,14:00:00,147,58,89,FMN GV 16 Berchem TOT
54,Posthofbrug 5366,2020-11-25,15:00:00,177,83,94,FMN GV 16 Berchem TOT
54,Posthofbrug 5366,2020-11-25,16:00:00,228,76,152,FMN GV 16 Berchem TOT
54,Posthofbrug 5366,2020-11-25,17:00:00,228,87,141,FMN GV 16 Berchem TOT
54,Posthofbrug 5366,2020-11-25,18:00:00,181,77,104,FMN GV 16 Berchem TOT
54,Posthofbrug 5366,2020-11-25,19:00:00,77,31,46,FMN GV 16 Berchem TOT
54,Posthofbrug 5366,2020-11-25,20:00:00,55,33,22,FMN GV 16 Berchem TOT
54,Posthofbrug 5366,2020-11-25,21:00:00,40,23,17,FMN GV 16 Berchem TOT
54,Posthofbrug 5366,2020-11-25,22:00:00,37,19,18,FMN GV 16 Berchem TOT
54,Posthofbrug 5366,2020-11-25,23:00:00,20,4,16,FMN GV 16 Berchem TOT
54,Posthofbrug 5366,2020-11-26,00:00:00,9,1,8,FMN GV 16 Berchem TOT
54,Posthofbrug 5366,2020-11-26,01:00:00,0,0,0,FMN GV 16 Berchem TOT
54,Posthofbrug 5366,2020-11-26,02:00:00,1,0,1,FMN GV 16 Berchem TOT
54,Posthofbrug 5366,2020-11-26,03:00:00,1,1,0,FMN GV 16 Berchem TOT
54,Posthofbrug 5366,2020-11-26,04:00:00,10,8,2,FMN GV 16 Berchem TOT
54,Posthofbrug 5366,2020-11-26,05:00:00,22,13,9,FMN GV 16 Berchem TOT
54,Posthofbrug 5366,2020-11-26,06:00:00,83,67,16,FMN GV 16 Berchem TOT
54,Posthofbrug 5366,2020-11-26,07:00:00,255,186,69,FMN GV 16 Berchem TOT
54,Posthofbrug 5366,2020-11-26,08:00:00,358,262,96,FMN GV 16 Berchem TOT
54,Posthofbrug 5366,2020-11-26,09:00:00,134,101,33,FMN GV 16 Berchem TOT
54,Posthofbrug 5366,2020-11-26,10:00:00,90,54,36,FMN GV 16 Berchem TOT
54,Posthofbrug 5366,2020-11-26,11:00:00,90,54,36,FMN GV 16 Berchem TOT
54,Posthofbrug 5366,2020-11-26,12:00:00,137,75,62,FMN GV 16 Berchem TOT
54,Posthofbrug 5366,2020-11-26,13:00:00,107,54,53,FMN GV 16 Berchem TOT
54,Posthofbrug 5366,2020-11-26,14:00:00,132,62,70,FMN GV 16 Berchem TOT
54,Posthofbrug 5366,2020-11-26,15:00:00,187,78,109,FMN GV 16 Berchem TOT
54,Posthofbrug 5366,2020-11-26,16:00:00,260,67,193,FMN GV 16 Berchem TOT
54,Posthofbrug 5366,2020-11-26,17:00:00,296,111,185,FMN GV 16 Berchem TOT
54,Posthofbrug 5366,2020-11-26,18:00:00,165,49,116,FMN GV 16 Berchem TOT
54,Posthofbrug 5366,2020-11-26,19:00:00,90,44,46,FMN GV 16 Berchem TOT
54,Posthofbrug 5366,2020-11-26,20:00:00,65,33,32,FMN GV 16 Berchem TOT
54,Posthofbrug 5366,2020-11-26,21:00:00,32,13,19,FMN GV 16 Berchem TOT
54,Posthofbrug 5366,2020-11-26,22:00:00,40,16,24,FMN GV 16 Berchem TOT
54,Posthofbrug 5366,2020-11-26,23:00:00,30,14,16,FMN GV 16 Berchem TOT
54,Posthofbrug 5366,2020-11-27,00:00:00,3,1,2,FMN GV 16 Berchem TOT
54,Posthofbrug 5366,2020-11-27,01:00:00,0,0,0,FMN GV 16 Berchem TOT
54,Posthofbrug 5366,2020-11-27,02:00:00,3,1,2,FMN GV 16 Berchem TOT
54,Posthofbrug 5366,2020-11-27,03:00:00,2,2,0,FMN GV 16 Berchem TOT
54,Posthofbrug 5366,2020-11-27,04:00:00,7,6,1,FMN GV 16 Berchem TOT
54,Posthofbrug 5366,2020-11-27,05:00:00,18,12,6,FMN GV 16 Berchem TOT
54,Posthofbrug 5366,2020-11-27,06:00:00,62,52,10,FMN GV 16 Berchem TOT
54,Posthofbrug 5366,2020-11-27,07:00:00,203,148,55,FMN GV 16 Berchem TOT
54,Posthofbrug 5366,2020-11-27,08:00:00,323,249,74,FMN GV 16 Berchem TOT
54,Posthofbrug 5366,2020-11-27,09:00:00,114,76,38,FMN GV 16 Berchem TOT
54,Posthofbrug 5366,2020-11-27,10:00:00,103,51,52,FMN GV 16 Berchem TOT
54,Posthofbrug 5366,2020-11-27,11:00:00,69,44,25,FMN GV 16 Berchem TOT
54,Posthofbrug 5366,2020-11-27,12:00:00,130,66,64,FMN GV 16 Berchem TOT
54,Posthofbrug 5366,2020-11-27,13:00:00,141,74,67,FMN GV 16 Berchem TOT
54,Posthofbrug 5366,2020-11-27,14:00:00,118,48,70,FMN GV 16 Berchem TOT
54,Posthofbrug 5366,2020-11-27,15:00:00,167,71,96,FMN GV 16 Berchem TOT
54,Posthofbrug 5366,2020-11-27,16:00:00,273,96,177,FMN GV 16 Berchem TOT
54,Posthofbrug 5366,2020-11-27,17:00:00,209,76,133,FMN GV 16 Berchem TOT
54,Posthofbrug 5366,2020-11-27,18:00:00,159,68,91,FMN GV 16 Berchem TOT
54,Posthofbrug 5366,2020-11-27,19:00:00,75,30,45,FMN GV 16 Berchem TOT
54,Posthofbrug 5366,2020-11-27,20:00:00,62,29,33,FMN GV 16 Berchem TOT
54,Posthofbrug 5366,2020-11-27,21:00:00,20,12,8,FMN GV 16 Berchem TOT
54,Posthofbrug 5366,2020-11-27,22:00:00,34,14,20,FMN GV 16 Berchem TOT
54,Posthofbrug 5366,2020-11-27,23:00:00,55,24,31,FMN GV 16 Berchem TOT
54,Posthofbrug 5366,2020-11-28,00:00:00,9,2,7,FMN GV 16 Berchem TOT
54,Posthofbrug 5366,2020-11-28,01:00:00,0,0,0,FMN GV 16 Berchem TOT
54,Posthofbrug 5366,2020-11-28,02:00:00,2,0,2,FMN GV 16 Berchem TOT
54,Posthofbrug 5366,2020-11-28,03:00:00,1,1,0,FMN GV 16 Berchem TOT
54,Posthofbrug 5366,2020-11-28,04:00:00,3,2,1,FMN GV 16 Berchem TOT
54,Posthofbrug 5366,2020-11-28,05:00:00,9,4,5,FMN GV 16 Berchem TOT
54,Posthofbrug 5366,2020-11-28,06:00:00,17,9,8,FMN GV 16 Berchem TOT
54,Posthofbrug 5366,2020-11-28,07:00:00,15,9,6,FMN GV 16 Berchem TOT
54,Posthofbrug 5366,2020-11-28,08:00:00,44,22,22,FMN GV 16 Berchem TOT
54,Posthofbrug 5366,2020-11-28,09:00:00,85,48,37,FMN GV 16 Berchem TOT
54,Posthofbrug 5366,2020-11-28,10:00:00,118,67,51,FMN GV 16 Berchem TOT
54,Posthofbrug 5366,2020-11-28,11:00:00,121,65,56,FMN GV 16 Berchem TOT
54,Posthofbrug 5366,2020-11-28,12:00:00,129,65,64,FMN GV 16 Berchem TOT
54,Posthofbrug 5366,2020-11-28,13:00:00,216,111,105,FMN GV 16 Berchem TOT
54,Posthofbrug 5366,2020-11-28,14:00:00,227,110,117,FMN GV 16 Berchem TOT
54,Posthofbrug 5366,2020-11-28,15:00:00,152,82,70,FMN GV 16 Berchem TOT
54,Posthofbrug 5366,2020-11-28,16:00:00,186,91,95,FMN GV 16 Berchem TOT
54,Posthofbrug 5366,2020-11-28,17:00:00,109,61,48,FMN GV 16 Berchem TOT
54,Posthofbrug 5366,2020-11-28,18:00:00,73,32,41,FMN GV 16 Berchem TOT
54,Posthofbrug 5366,2020-11-28,19:00:00,60,30,30,FMN GV 16 Berchem TOT
54,Posthofbrug 5366,2020-11-28,20:00:00,52,27,25,FMN GV 16 Berchem TOT
54,Posthofbrug 5366,2020-11-28,21:00:00,38,22,16,FMN GV 16 Berchem TOT
54,Posthofbrug 5366,2020-11-28,22:00:00,34,20,14,FMN GV 16 Berchem TOT
54,Posthofbrug 5366,2020-11-28,23:00:00,50,27,23,FMN GV 16 Berchem TOT
54,Posthofbrug 5366,2020-11-29,00:00:00,5,1,4,FMN GV 16 Berchem TOT
54,Posthofbrug 5366,2020-11-29,01:00:00,2,0,2,FMN GV 16 Berchem TOT
54,Posthofbrug 5366,2020-11-29,02:00:00,1,0,1,FMN GV 16 Berchem TOT
54,Posthofbrug 5366,2020-11-29,03:00:00,3,1,2,FMN GV 16 Berchem TOT
54,Posthofbrug 5366,2020-11-29,04:00:00,2,2,0,FMN GV 16 Berchem TOT
54,Posthofbrug 5366,2020-11-29,05:00:00,8,5,3,FMN GV 16 Berchem TOT
54,Posthofbrug 5366,2020-11-29,06:00:00,13,7,6,FMN GV 16 Berchem TOT
54,Posthofbrug 5366,2020-11-29,07:00:00,13,5,8,FMN GV 16 Berchem TOT
54,Posthofbrug 5366,2020-11-29,08:00:00,40,18,22,FMN GV 16 Berchem TOT
54,Posthofbrug 5366,2020-11-29,09:00:00,62,39,23,FMN GV 16 Berchem TOT
54,Posthofbrug 5366,2020-11-29,10:00:00,74,41,33,FMN GV 16 Berchem TOT
54,Posthofbrug 5366,2020-11-29,11:00:00,98,50,48,FMN GV 16 Berchem TOT
54,Posthofbrug 5366,2020-11-29,12:00:00,111,53,58,FMN GV 16 Berchem TOT
54,Posthofbrug 5366,2020-11-29,13:00:00,108,44,64,FMN GV 16 Berchem TOT
54,Posthofbrug 5366,2020-11-29,14:00:00,119,66,53,FMN GV 16 Berchem TOT
54,Posthofbrug 5366,2020-11-29,15:00:00,102,49,53,FMN GV 16 Berchem TOT
54,Posthofbrug 5366,2020-11-29,16:00:00,145,72,73,FMN GV 16 Berchem TOT
54,Posthofbrug 5366,2020-11-29,17:00:00,81,45,36,FMN GV 16 Berchem TOT
54,Posthofbrug 5366,2020-11-29,18:00:00,54,27,27,FMN GV 16 Berchem TOT
54,Posthofbrug 5366,2020-11-29,19:00:00,36,14,22,FMN GV 16 Berchem TOT
54,Posthofbrug 5366,2020-11-29,20:00:00,42,29,13,FMN GV 16 Berchem TOT
54,Posthofbrug 5366,2020-11-29,21:00:00,16,9,7,FMN GV 16 Berchem TOT
54,Posthofbrug 5366,2020-11-29,22:00:00,23,13,10,FMN GV 16 Berchem TOT
54,Posthofbrug 5366,2020-11-29,23:00:00,10,6,4,FMN GV 16 Berchem TOT
54,Posthofbrug 5366,2020-11-30,00:00:00,1,0,1,FMN GV 16 Berchem TOT
54,Posthofbrug 5366,2020-11-30,01:00:00,0,0,0,FMN GV 16 Berchem TOT
54,Posthofbrug 5366,2020-11-30,02:00:00,0,0,0,FMN GV 16 Berchem TOT
54,Posthofbrug 5366,2020-11-30,03:00:00,0,0,0,FMN GV 16 Berchem TOT
54,Posthofbrug 5366,2020-11-30,04:00:00,19,11,8,FMN GV 16 Berchem TOT
54,Posthofbrug 5366,2020-11-30,05:00:00,22,14,8,FMN GV 16 Berchem TOT
54,Posthofbrug 5366,2020-11-30,06:00:00,67,53,14,FMN GV 16 Berchem TOT
54,Posthofbrug 5366,2020-11-30,07:00:00,232,175,57,FMN GV 16 Berchem TOT
54,Posthofbrug 5366,2020-11-30,08:00:00,315,239,76,FMN GV 16 Berchem TOT
54,Posthofbrug 5366,2020-11-30,09:00:00,112,79,33,FMN GV 16 Berchem TOT
54,Posthofbrug 5366,2020-11-30,10:00:00,68,43,25,FMN GV 16 Berchem TOT
54,Posthofbrug 5366,2020-11-30,11:00:00,59,31,28,FMN GV 16 Berchem TOT
54,Posthofbrug 5366,2020-11-30,12:00:00,119,55,64,FMN GV 16 Berchem TOT
54,Posthofbrug 5366,2020-11-30,13:00:00,95,52,43,FMN GV 16 Berchem TOT
54,Posthofbrug 5366,2020-11-30,14:00:00,79,41,38,FMN GV 16 Berchem TOT
54,Posthofbrug 5366,2020-11-30,15:00:00,158,61,97,FMN GV 16 Berchem TOT
54,Posthofbrug 5366,2020-11-30,16:00:00,213,60,153,FMN GV 16 Berchem TOT
54,Posthofbrug 5366,2020-11-30,17:00:00,237,78,159,FMN GV 16 Berchem TOT
54,Posthofbrug 5366,2020-11-30,18:00:00,113,44,69,FMN GV 16 Berchem TOT
54,Posthofbrug 5366,2020-11-30,19:00:00,64,28,36,FMN GV 16 Berchem TOT
54,Posthofbrug 5366,2020-11-30,20:00:00,28,14,14,FMN GV 16 Berchem TOT
54,Posthofbrug 5366,2020-11-30,21:00:00,30,10,20,FMN GV 16 Berchem TOT
54,Posthofbrug 5366,2020-11-30,22:00:00,17,10,7,FMN GV 16 Berchem TOT
54,Posthofbrug 5366,2020-11-30,23:00:00,11,6,5,FMN GV 16 Berchem TOT
54,Posthofbrug 5366,2020-12-01,00:00:00,2,0,2,FMN GV 16 Berchem TOT
54,Posthofbrug 5366,2020-12-01,01:00:00,1,1,0,FMN GV 16 Berchem TOT
54,Posthofbrug 5366,2020-12-01,02:00:00,0,0,0,FMN GV 16 Berchem TOT
54,Posthofbrug 5366,2020-12-01,03:00:00,2,2,0,FMN GV 16 Berchem TOT
54,Posthofbrug 5366,2020-12-01,04:00:00,9,7,2,FMN GV 16 Berchem TOT
54,Posthofbrug 5366,2020-12-01,05:00:00,23,14,9,FMN GV 16 Berchem TOT
54,Posthofbrug 5366,2020-12-01,06:00:00,61,47,14,FMN GV 16 Berchem TOT
54,Posthofbrug 5366,2020-12-01,07:00:00,221,166,55,FMN GV 16 Berchem TOT
54,Posthofbrug 5366,2020-12-01,08:00:00,326,240,86,FMN GV 16 Berchem TOT
54,Posthofbrug 5366,2020-12-01,09:00:00,115,92,23,FMN GV 16 Berchem TOT
54,Posthofbrug 5366,2020-12-01,10:00:00,73,50,23,FMN GV 16 Berchem TOT
54,Posthofbrug 5366,2020-12-01,11:00:00,61,31,30,FMN GV 16 Berchem TOT
54,Posthofbrug 5366,2020-12-01,12:00:00,113,58,55,FMN GV 16 Berchem TOT
54,Posthofbrug 5366,2020-12-01,13:00:00,110,65,45,FMN GV 16 Berchem TOT
54,Posthofbrug 5366,2020-12-01,14:00:00,107,39,68,FMN GV 16 Berchem TOT
54,Posthofbrug 5366,2020-12-01,15:00:00,168,62,106,FMN GV 16 Berchem TOT
54,Posthofbrug 5366,2020-12-01,16:00:00,239,75,164,FMN GV 16 Berchem TOT
54,Posthofbrug 5366,2020-12-01,17:00:00,255,85,170,FMN GV 16 Berchem TOT
54,Posthofbrug 5366,2020-12-01,18:00:00,162,43,119,FMN GV 16 Berchem TOT
54,Posthofbrug 5366,2020-12-01,19:00:00,81,29,52,FMN GV 16 Berchem TOT
54,Posthofbrug 5366,2020-12-01,20:00:00,44,25,19,FMN GV 16 Berchem TOT
54,Posthofbrug 5366,2020-12-01,21:00:00,32,17,15,FMN GV 16 Berchem TOT
54,Posthofbrug 5366,2020-12-01,22:00:00,39,22,17,FMN GV 16 Berchem TOT
54,Posthofbrug 5366,2020-12-01,23:00:00,16,6,10,FMN GV 16 Berchem TOT
54,Posthofbrug 5366,2020-12-02,00:00:00,2,0,2,FMN GV 16 Berchem TOT
54,Posthofbrug 5366,2020-12-02,01:00:00,1,0,1,FMN GV 16 Berchem TOT
54,Posthofbrug 5366,2020-12-02,02:00:00,1,0,1,FMN GV 16 Berchem TOT
54,Posthofbrug 5366,2020-12-02,03:00:00,0,0,0,FMN GV 16 Berchem TOT
54,Posthofbrug 5366,2020-12-02,04:00:00,11,9,2,FMN GV 16 Berchem TOT
54,Posthofbrug 5366,2020-12-02,05:00:00,21,13,8,FMN GV 16 Berchem TOT
54,Posthofbrug 5366,2020-12-02,06:00:00,83,63,20,FMN GV 16 Berchem TOT
54,Posthofbrug 5366,2020-12-02,07:00:00,241,182,59,FMN GV 16 Berchem TOT
54,Posthofbrug 5366,2020-12-02,08:00:00,343,260,83,FMN GV 16 Berchem TOT
54,Posthofbrug 5366,2020-12-02,09:00:00,146,92,54,FMN GV 16 Berchem TOT
54,Posthofbrug 5366,2020-12-02,10:00:00,94,53,41,FMN GV 16 Berchem TOT
54,Posthofbrug 5366,2020-12-02,11:00:00,107,58,49,FMN GV 16 Berchem TOT
54,Posthofbrug 5366,2020-12-02,12:00:00,220,102,118,FMN GV 16 Berchem TOT
54,Posthofbrug 5366,2020-12-02,13:00:00,152,69,83,FMN GV 16 Berchem TOT
54,Posthofbrug 5366,2020-12-02,14:00:00,149,82,67,FMN GV 16 Berchem TOT
54,Posthofbrug 5366,2020-12-02,15:00:00,155,65,90,FMN GV 16 Berchem TOT
54,Posthofbrug 5366,2020-12-02,16:00:00,187,59,128,FMN GV 16 Berchem TOT
54,Posthofbrug 5366,2020-12-02,17:00:00,279,99,180,FMN GV 16 Berchem TOT
54,Posthofbrug 5366,2020-12-02,18:00:00,164,61,103,FMN GV 16 Berchem TOT
54,Posthofbrug 5366,2020-12-02,19:00:00,79,34,45,FMN GV 16 Berchem TOT
54,Posthofbrug 5366,2020-12-02,20:00:00,78,38,40,FMN GV 16 Berchem TOT
54,Posthofbrug 5366,2020-12-02,21:00:00,35,19,16,FMN GV 16 Berchem TOT
54,Posthofbrug 5366,2020-12-02,22:00:00,49,24,25,FMN GV 16 Berchem TOT
54,Posthofbrug 5366,2020-12-02,23:00:00,20,8,12,FMN GV 16 Berchem TOT
54,Posthofbrug 5366,2020-12-03,00:00:00,1,1,0,FMN GV 16 Berchem TOT
54,Posthofbrug 5366,2020-12-03,01:00:00,0,0,0,FMN GV 16 Berchem TOT
54,Posthofbrug 5366,2020-12-03,02:00:00,2,0,2,FMN GV 16 Berchem TOT
54,Posthofbrug 5366,2020-12-03,03:00:00,1,1,0,FMN GV 16 Berchem TOT
54,Posthofbrug 5366,2020-12-03,04:00:00,12,10,2,FMN GV 16 Berchem TOT
54,Posthofbrug 5366,2020-12-03,05:00:00,20,8,12,FMN GV 16 Berchem TOT
54,Posthofbrug 5366,2020-12-03,06:00:00,73,54,19,FMN GV 16 Berchem TOT
54,Posthofbrug 5366,2020-12-03,07:00:00,230,168,62,FMN GV 16 Berchem TOT
54,Posthofbrug 5366,2020-12-03,08:00:00,356,262,94,FMN GV 16 Berchem TOT
54,Posthofbrug 5366,2020-12-03,09:00:00,137,95,42,FMN GV 16 Berchem TOT
54,Posthofbrug 5366,2020-12-03,10:00:00,81,52,29,FMN GV 16 Berchem TOT
54,Posthofbrug 5366,2020-12-03,11:00:00,92,46,46,FMN GV 16 Berchem TOT
54,Posthofbrug 5366,2020-12-03,12:00:00,127,66,61,FMN GV 16 Berchem TOT
54,Posthofbrug 5366,2020-12-03,13:00:00,116,53,63,FMN GV 16 Berchem TOT
54,Posthofbrug 5366,2020-12-03,14:00:00,78,30,48,FMN GV 16 Berchem TOT
54,Posthofbrug 5366,2020-12-03,15:00:00,154,62,92,FMN GV 16 Berchem TOT
54,Posthofbrug 5366,2020-12-03,16:00:00,199,65,134,FMN GV 16 Berchem TOT
54,Posthofbrug 5366,2020-12-03,17:00:00,248,80,168,FMN GV 16 Berchem TOT
54,Posthofbrug 5366,2020-12-03,18:00:00,140,47,93,FMN GV 16 Berchem TOT
54,Posthofbrug 5366,2020-12-03,19:00:00,83,29,54,FMN GV 16 Berchem TOT
54,Posthofbrug 5366,2020-12-03,20:00:00,49,24,25,FMN GV 16 Berchem TOT
54,Posthofbrug 5366,2020-12-03,21:00:00,29,12,17,FMN GV 16 Berchem TOT
54,Posthofbrug 5366,2020-12-03,22:00:00,37,21,16,FMN GV 16 Berchem TOT
54,Posthofbrug 5366,2020-12-03,23:00:00,26,12,14,FMN GV 16 Berchem TOT
54,Posthofbrug 5366,2020-12-04,00:00:00,3,2,1,FMN GV 16 Berchem TOT
54,Posthofbrug 5366,2020-12-04,01:00:00,0,0,0,FMN GV 16 Berchem TOT
54,Posthofbrug 5366,2020-12-04,02:00:00,1,0,1,FMN GV 16 Berchem TOT
54,Posthofbrug 5366,2020-12-04,03:00:00,1,1,0,FMN GV 16 Berchem TOT
54,Posthofbrug 5366,2020-12-04,04:00:00,13,11,2,FMN GV 16 Berchem TOT
54,Posthofbrug 5366,2020-12-04,05:00:00,17,8,9,FMN GV 16 Berchem TOT
54,Posthofbrug 5366,2020-12-04,06:00:00,70,52,18,FMN GV 16 Berchem TOT
54,Posthofbrug 5366,2020-12-04,07:00:00,190,148,42,FMN GV 16 Berchem TOT
54,Posthofbrug 5366,2020-12-04,08:00:00,272,197,75,FMN GV 16 Berchem TOT
54,Posthofbrug 5366,2020-12-04,09:00:00,124,87,37,FMN GV 16 Berchem TOT
54,Posthofbrug 5366,2020-12-04,10:00:00,83,56,27,FMN GV 16 Berchem TOT
54,Posthofbrug 5366,2020-12-04,11:00:00,87,53,34,FMN GV 16 Berchem TOT
54,Posthofbrug 5366,2020-12-04,12:00:00,129,72,57,FMN GV 16 Berchem TOT
54,Posthofbrug 5366,2020-12-04,13:00:00,124,69,55,FMN GV 16 Berchem TOT
54,Posthofbrug 5366,2020-12-04,14:00:00,133,66,67,FMN GV 16 Berchem TOT
54,Posthofbrug 5366,2020-12-04,15:00:00,178,81,97,FMN GV 16 Berchem TOT
54,Posthofbrug 5366,2020-12-04,16:00:00,245,81,164,FMN GV 16 Berchem TOT
54,Posthofbrug 5366,2020-12-04,17:00:00,215,54,161,FMN GV 16 Berchem TOT
54,Posthofbrug 5366,2020-12-04,18:00:00,153,56,97,FMN GV 16 Berchem TOT
54,Posthofbrug 5366,2020-12-04,19:00:00,89,31,58,FMN GV 16 Berchem TOT
54,Posthofbrug 5366,2020-12-04,20:00:00,42,17,25,FMN GV 16 Berchem TOT
54,Posthofbrug 5366,2020-12-04,21:00:00,37,10,27,FMN GV 16 Berchem TOT
54,Posthofbrug 5366,2020-12-04,22:00:00,34,15,19,FMN GV 16 Berchem TOT
54,Posthofbrug 5366,2020-12-04,23:00:00,47,27,20,FMN GV 16 Berchem TOT
54,Posthofbrug 5366,2020-12-05,00:00:00,13,3,10,FMN GV 16 Berchem TOT
54,Posthofbrug 5366,2020-12-05,01:00:00,2,1,1,FMN GV 16 Berchem TOT
54,Posthofbrug 5366,2020-12-05,02:00:00,1,0,1,FMN GV 16 Berchem TOT
54,Posthofbrug 5366,2020-12-05,03:00:00,1,0,1,FMN GV 16 Berchem TOT
54,Posthofbrug 5366,2020-12-05,04:00:00,3,3,0,FMN GV 16 Berchem TOT
54,Posthofbrug 5366,2020-12-05,05:00:00,13,8,5,FMN GV 16 Berchem TOT
54,Posthofbrug 5366,2020-12-05,06:00:00,11,8,3,FMN GV 16 Berchem TOT
54,Posthofbrug 5366,2020-12-05,07:00:00,25,13,12,FMN GV 16 Berchem TOT
54,Posthofbrug 5366,2020-12-05,08:00:00,45,31,14,FMN GV 16 Berchem TOT
54,Posthofbrug 5366,2020-12-05,09:00:00,83,47,36,FMN GV 16 Berchem TOT
54,Posthofbrug 5366,2020-12-05,10:00:00,147,80,67,FMN GV 16 Berchem TOT
54,Posthofbrug 5366,2020-12-05,11:00:00,118,64,54,FMN GV 16 Berchem TOT
54,Posthofbrug 5366,2020-12-05,12:00:00,139,72,67,FMN GV 16 Berchem TOT
54,Posthofbrug 5366,2020-12-05,13:00:00,161,85,76,FMN GV 16 Berchem TOT
54,Posthofbrug 5366,2020-12-05,14:00:00,129,50,79,FMN GV 16 Berchem TOT
54,Posthofbrug 5366,2020-12-05,15:00:00,160,70,90,FMN GV 16 Berchem TOT
54,Posthofbrug 5366,2020-12-05,16:00:00,133,70,63,FMN GV 16 Berchem TOT
54,Posthofbrug 5366,2020-12-05,17:00:00,105,49,56,FMN GV 16 Berchem TOT
54,Posthofbrug 5366,2020-12-05,18:00:00,80,38,42,FMN GV 16 Berchem TOT
54,Posthofbrug 5366,2020-12-05,19:00:00,42,21,21,FMN GV 16 Berchem TOT
54,Posthofbrug 5366,2020-12-05,20:00:00,49,23,26,FMN GV 16 Berchem TOT
54,Posthofbrug 5366,2020-12-05,21:00:00,23,9,14,FMN GV 16 Berchem TOT
54,Posthofbrug 5366,2020-12-05,22:00:00,30,19,11,FMN GV 16 Berchem TOT
54,Posthofbrug 5366,2020-12-05,23:00:00,50,24,26,FMN GV 16 Berchem TOT
54,Posthofbrug 5366,2020-12-06,00:00:00,11,7,4,FMN GV 16 Berchem TOT
54,Posthofbrug 5366,2020-12-06,01:00:00,3,1,2,FMN GV 16 Berchem TOT
54,Posthofbrug 5366,2020-12-06,02:00:00,2,2,0,FMN GV 16 Berchem TOT
54,Posthofbrug 5366,2020-12-06,03:00:00,6,2,4,FMN GV 16 Berchem TOT
54,Posthofbrug 5366,2020-12-06,04:00:00,0,0,0,FMN GV 16 Berchem TOT
54,Posthofbrug 5366,2020-12-06,05:00:00,9,7,2,FMN GV 16 Berchem TOT
54,Posthofbrug 5366,2020-12-06,06:00:00,8,6,2,FMN GV 16 Berchem TOT
54,Posthofbrug 5366,2020-12-06,07:00:00,12,8,4,FMN GV 16 Berchem TOT
54,Posthofbrug 5366,2020-12-06,08:00:00,31,18,13,FMN GV 16 Berchem TOT
54,Posthofbrug 5366,2020-12-06,09:00:00,56,29,27,FMN GV 16 Berchem TOT
54,Posthofbrug 5366,2020-12-06,10:00:00,64,34,30,FMN GV 16 Berchem TOT
54,Posthofbrug 5366,2020-12-06,11:00:00,94,52,42,FMN GV 16 Berchem TOT
54,Posthofbrug 5366,2020-12-06,12:00:00,106,57,49,FMN GV 16 Berchem TOT
54,Posthofbrug 5366,2020-12-06,13:00:00,112,64,48,FMN GV 16 Berchem TOT
54,Posthofbrug 5366,2020-12-06,14:00:00,92,48,44,FMN GV 16 Berchem TOT
54,Posthofbrug 5366,2020-12-06,15:00:00,111,68,43,FMN GV 16 Berchem TOT
54,Posthofbrug 5366,2020-12-06,16:00:00,100,41,59,FMN GV 16 Berchem TOT
54,Posthofbrug 5366,2020-12-06,17:00:00,70,35,35,FMN GV 16 Berchem TOT
54,Posthofbrug 5366,2020-12-06,18:00:00,45,22,23,FMN GV 16 Berchem TOT
54,Posthofbrug 5366,2020-12-06,19:00:00,51,27,24,FMN GV 16 Berchem TOT
54,Posthofbrug 5366,2020-12-06,20:00:00,27,18,9,FMN GV 16 Berchem TOT
54,Posthofbrug 5366,2020-12-06,21:00:00,24,12,12,FMN GV 16 Berchem TOT
54,Posthofbrug 5366,2020-12-06,22:00:00,17,10,7,FMN GV 16 Berchem TOT
54,Posthofbrug 5366,2020-12-06,23:00:00,15,7,8,FMN GV 16 Berchem TOT
54,Posthofbrug 5366,2020-12-07,00:00:00,2,1,1,FMN GV 16 Berchem TOT
54,Posthofbrug 5366,2020-12-07,01:00:00,1,0,1,FMN GV 16 Berchem TOT
54,Posthofbrug 5366,2020-12-07,02:00:00,0,0,0,FMN GV 16 Berchem TOT
54,Posthofbrug 5366,2020-12-07,03:00:00,0,0,0,FMN GV 16 Berchem TOT
54,Posthofbrug 5366,2020-12-07,04:00:00,6,5,1,FMN GV 16 Berchem TOT
54,Posthofbrug 5366,2020-12-07,05:00:00,20,12,8,FMN GV 16 Berchem TOT
54,Posthofbrug 5366,2020-12-07,06:00:00,72,61,11,FMN GV 16 Berchem TOT
54,Posthofbrug 5366,2020-12-07,07:00:00,226,171,55,FMN GV 16 Berchem TOT
54,Posthofbrug 5366,2020-12-07,08:00:00,342,266,76,FMN GV 16 Berchem TOT
54,Posthofbrug 5366,2020-12-07,09:00:00,122,85,37,FMN GV 16 Berchem TOT
54,Posthofbrug 5366,2020-12-07,10:00:00,68,49,19,FMN GV 16 Berchem TOT
54,Posthofbrug 5366,2020-12-07,11:00:00,88,49,39,FMN GV 16 Berchem TOT
54,Posthofbrug 5366,2020-12-07,12:00:00,109,53,56,FMN GV 16 Berchem TOT
54,Posthofbrug 5366,2020-12-07,13:00:00,91,45,46,FMN GV 16 Berchem TOT
54,Posthofbrug 5366,2020-12-07,14:00:00,97,37,60,FMN GV 16 Berchem TOT
54,Posthofbrug 5366,2020-12-07,15:00:00,144,51,93,FMN GV 16 Berchem TOT
54,Posthofbrug 5366,2020-12-07,16:00:00,220,58,162,FMN GV 16 Berchem TOT
54,Posthofbrug 5366,2020-12-07,17:00:00,235,80,155,FMN GV 16 Berchem TOT
54,Posthofbrug 5366,2020-12-07,18:00:00,122,36,86,FMN GV 16 Berchem TOT
54,Posthofbrug 5366,2020-12-07,19:00:00,70,27,43,FMN GV 16 Berchem TOT
54,Posthofbrug 5366,2020-12-07,20:00:00,26,12,14,FMN GV 16 Berchem TOT
54,Posthofbrug 5366,2020-12-07,21:00:00,28,14,14,FMN GV 16 Berchem TOT
54,Posthofbrug 5366,2020-12-07,22:00:00,25,11,14,FMN GV 16 Berchem TOT
54,Posthofbrug 5366,2020-12-07,23:00:00,14,9,5,FMN GV 16 Berchem TOT
54,Posthofbrug 5366,2020-12-08,00:00:00,3,1,2,FMN GV 16 Berchem TOT
54,Posthofbrug 5366,2020-12-08,01:00:00,0,0,0,FMN GV 16 Berchem TOT
54,Posthofbrug 5366,2020-12-08,02:00:00,0,0,0,FMN GV 16 Berchem TOT
54,Posthofbrug 5366,2020-12-08,03:00:00,6,2,4,FMN GV 16 Berchem TOT
54,Posthofbrug 5366,2020-12-08,04:00:00,6,4,2,FMN GV 16 Berchem TOT
54,Posthofbrug 5366,2020-12-08,05:00:00,15,10,5,FMN GV 16 Berchem TOT
54,Posthofbrug 5366,2020-12-08,06:00:00,68,53,15,FMN GV 16 Berchem TOT
54,Posthofbrug 5366,2020-12-08,07:00:00,238,182,56,FMN GV 16 Berchem TOT
54,Posthofbrug 5366,2020-12-08,08:00:00,342,254,88,FMN GV 16 Berchem TOT
54,Posthofbrug 5366,2020-12-08,09:00:00,158,111,47,FMN GV 16 Berchem TOT
54,Posthofbrug 5366,2020-12-08,10:00:00,86,62,24,FMN GV 16 Berchem TOT
54,Posthofbrug 5366,2020-12-08,11:00:00,89,47,42,FMN GV 16 Berchem TOT
54,Posthofbrug 5366,2020-12-08,12:00:00,144,81,63,FMN GV 16 Berchem TOT
54,Posthofbrug 5366,2020-12-08,13:00:00,136,72,64,FMN GV 16 Berchem TOT
54,Posthofbrug 5366,2020-12-08,14:00:00,112,49,63,FMN GV 16 Berchem TOT
54,Posthofbrug 5366,2020-12-08,15:00:00,178,64,114,FMN GV 16 Berchem TOT
54,Posthofbrug 5366,2020-12-08,16:00:00,262,86,176,FMN GV 16 Berchem TOT
54,Posthofbrug 5366,2020-12-08,17:00:00,241,67,174,FMN GV 16 Berchem TOT
54,Posthofbrug 5366,2020-12-08,18:00:00,165,54,111,FMN GV 16 Berchem TOT
54,Posthofbrug 5366,2020-12-08,19:00:00,64,24,40,FMN GV 16 Berchem TOT
54,Posthofbrug 5366,2020-12-08,20:00:00,51,28,23,FMN GV 16 Berchem TOT
54,Posthofbrug 5366,2020-12-08,21:00:00,32,14,18,FMN GV 16 Berchem TOT
54,Posthofbrug 5366,2020-12-08,22:00:00,31,17,14,FMN GV 16 Berchem TOT
54,Posthofbrug 5366,2020-12-08,23:00:00,16,4,12,FMN GV 16 Berchem TOT
54,Posthofbrug 5366,2020-12-09,00:00:00,1,0,1,FMN GV 16 Berchem TOT
54,Posthofbrug 5366,2020-12-09,01:00:00,0,0,0,FMN GV 16 Berchem TOT
54,Posthofbrug 5366,2020-12-09,02:00:00,1,0,1,FMN GV 16 Berchem TOT
54,Posthofbrug 5366,2020-12-09,03:00:00,1,1,0,FMN GV 16 Berchem TOT
54,Posthofbrug 5366,2020-12-09,04:00:00,7,6,1,FMN GV 16 Berchem TOT
54,Posthofbrug 5366,2020-12-09,05:00:00,18,11,7,FMN GV 16 Berchem TOT
54,Posthofbrug 5366,2020-12-09,06:00:00,63,55,8,FMN GV 16 Berchem TOT
54,Posthofbrug 5366,2020-12-09,07:00:00,222,164,58,FMN GV 16 Berchem TOT
54,Posthofbrug 5366,2020-12-09,08:00:00,314,227,87,FMN GV 16 Berchem TOT
54,Posthofbrug 5366,2020-12-09,09:00:00,133,101,32,FMN GV 16 Berchem TOT
54,Posthofbrug 5366,2020-12-09,10:00:00,87,53,34,FMN GV 16 Berchem TOT
54,Posthofbrug 5366,2020-12-09,11:00:00,101,45,56,FMN GV 16 Berchem TOT
54,Posthofbrug 5366,2020-12-09,12:00:00,203,82,121,FMN GV 16 Berchem TOT
54,Posthofbrug 5366,2020-12-09,13:00:00,144,61,83,FMN GV 16 Berchem TOT
54,Posthofbrug 5366,2020-12-09,14:00:00,104,42,62,FMN GV 16 Berchem TOT
54,Posthofbrug 5366,2020-12-09,15:00:00,134,52,82,FMN GV 16 Berchem TOT
54,Posthofbrug 5366,2020-12-09,16:00:00,196,74,122,FMN GV 16 Berchem TOT
54,Posthofbrug 5366,2020-12-09,17:00:00,218,79,139,FMN GV 16 Berchem TOT
54,Posthofbrug 5366,2020-12-09,18:00:00,167,53,114,FMN GV 16 Berchem TOT
54,Posthofbrug 5366,2020-12-09,19:00:00,96,41,55,FMN GV 16 Berchem TOT
54,Posthofbrug 5366,2020-12-09,20:00:00,59,35,24,FMN GV 16 Berchem TOT
54,Posthofbrug 5366,2020-12-09,21:00:00,34,20,14,FMN GV 16 Berchem TOT
54,Posthofbrug 5366,2020-12-09,22:00:00,37,10,27,FMN GV 16 Berchem TOT
54,Posthofbrug 5366,2020-12-09,23:00:00,26,10,16,FMN GV 16 Berchem TOT
54,Posthofbrug 5366,2020-12-10,00:00:00,3,3,0,FMN GV 16 Berchem TOT
54,Posthofbrug 5366,2020-12-10,01:00:00,0,0,0,FMN GV 16 Berchem TOT
54,Posthofbrug 5366,2020-12-10,02:00:00,1,0,1,FMN GV 16 Berchem TOT
54,Posthofbrug 5366,2020-12-10,03:00:00,2,1,1,FMN GV 16 Berchem TOT
54,Posthofbrug 5366,2020-12-10,04:00:00,11,6,5,FMN GV 16 Berchem TOT
54,Posthofbrug 5366,2020-12-10,05:00:00,21,15,6,FMN GV 16 Berchem TOT
54,Posthofbrug 5366,2020-12-10,06:00:00,58,47,11,FMN GV 16 Berchem TOT
54,Posthofbrug 5366,2020-12-10,07:00:00,241,189,52,FMN GV 16 Berchem TOT
54,Posthofbrug 5366,2020-12-10,08:00:00,340,254,86,FMN GV 16 Berchem TOT
54,Posthofbrug 5366,2020-12-10,09:00:00,148,104,44,FMN GV 16 Berchem TOT
54,Posthofbrug 5366,2020-12-10,10:00:00,93,51,42,FMN GV 16 Berchem TOT
54,Posthofbrug 5366,2020-12-10,11:00:00,93,50,43,FMN GV 16 Berchem TOT
54,Posthofbrug 5366,2020-12-10,12:00:00,138,72,66,FMN GV 16 Berchem TOT
54,Posthofbrug 5366,2020-12-10,13:00:00,152,75,77,FMN GV 16 Berchem TOT
54,Posthofbrug 5366,2020-12-10,14:00:00,119,48,71,FMN GV 16 Berchem TOT
54,Posthofbrug 5366,2020-12-10,15:00:00,167,56,111,FMN GV 16 Berchem TOT
54,Posthofbrug 5366,2020-12-10,16:00:00,217,67,150,FMN GV 16 Berchem TOT
54,Posthofbrug 5366,2020-12-10,17:00:00,251,77,174,FMN GV 16 Berchem TOT
54,Posthofbrug 5366,2020-12-10,18:00:00,199,61,138,FMN GV 16 Berchem TOT
54,Posthofbrug 5366,2020-12-10,19:00:00,82,36,46,FMN GV 16 Berchem TOT
54,Posthofbrug 5366,2020-12-10,20:00:00,60,33,27,FMN GV 16 Berchem TOT
54,Posthofbrug 5366,2020-12-10,21:00:00,31,16,15,FMN GV 16 Berchem TOT
54,Posthofbrug 5366,2020-12-10,22:00:00,43,17,26,FMN GV 16 Berchem TOT
54,Posthofbrug 5366,2020-12-10,23:00:00,24,13,11,FMN GV 16 Berchem TOT
54,Posthofbrug 5366,2020-12-11,00:00:00,3,1,2,FMN GV 16 Berchem TOT
54,Posthofbrug 5366,2020-12-11,01:00:00,0,0,0,FMN GV 16 Berchem TOT
54,Posthofbrug 5366,2020-12-11,02:00:00,4,3,1,FMN GV 16 Berchem TOT
54,Posthofbrug 5366,2020-12-11,03:00:00,4,2,2,FMN GV 16 Berchem TOT
54,Posthofbrug 5366,2020-12-11,04:00:00,5,3,2,FMN GV 16 Berchem TOT
54,Posthofbrug 5366,2020-12-11,05:00:00,13,9,4,FMN GV 16 Berchem TOT
54,Posthofbrug 5366,2020-12-11,06:00:00,48,38,10,FMN GV 16 Berchem TOT
54,Posthofbrug 5366,2020-12-11,07:00:00,176,135,41,FMN GV 16 Berchem TOT
54,Posthofbrug 5366,2020-12-11,08:00:00,275,203,72,FMN GV 16 Berchem TOT
54,Posthofbrug 5366,2020-12-11,09:00:00,125,86,39,FMN GV 16 Berchem TOT
54,Posthofbrug 5366,2020-12-11,10:00:00,70,38,32,FMN GV 16 Berchem TOT
54,Posthofbrug 5366,2020-12-11,11:00:00,68,35,33,FMN GV 16 Berchem TOT
54,Posthofbrug 5366,2020-12-11,12:00:00,102,54,48,FMN GV 16 Berchem TOT
54,Posthofbrug 5366,2020-12-11,13:00:00,83,43,40,FMN GV 16 Berchem TOT
54,Posthofbrug 5366,2020-12-11,14:00:00,80,34,46,FMN GV 16 Berchem TOT
54,Posthofbrug 5366,2020-12-11,15:00:00,116,48,68,FMN GV 16 Berchem TOT
54,Posthofbrug 5366,2020-12-11,16:00:00,170,62,108,FMN GV 16 Berchem TOT
54,Posthofbrug 5366,2020-12-11,17:00:00,195,65,130,FMN GV 16 Berchem TOT
54,Posthofbrug 5366,2020-12-11,18:00:00,111,32,79,FMN GV 16 Berchem TOT
54,Posthofbrug 5366,2020-12-11,19:00:00,71,26,45,FMN GV 16 Berchem TOT
54,Posthofbrug 5366,2020-12-11,20:00:00,40,22,18,FMN GV 16 Berchem TOT
54,Posthofbrug 5366,2020-12-11,21:00:00,23,11,12,FMN GV 16 Berchem TOT
54,Posthofbrug 5366,2020-12-11,22:00:00,31,18,13,FMN GV 16 Berchem TOT
54,Posthofbrug 5366,2020-12-11,23:00:00,38,16,22,FMN GV 16 Berchem TOT
54,Posthofbrug 5366,2020-12-12,00:00:00,5,1,4,FMN GV 16 Berchem TOT
54,Posthofbrug 5366,2020-12-12,01:00:00,1,0,1,FMN GV 16 Berchem TOT
54,Posthofbrug 5366,2020-12-12,02:00:00,2,0,2,FMN GV 16 Berchem TOT
54,Posthofbrug 5366,2020-12-12,03:00:00,0,0,0,FMN GV 16 Berchem TOT
54,Posthofbrug 5366,2020-12-12,04:00:00,3,2,1,FMN GV 16 Berchem TOT
54,Posthofbrug 5366,2020-12-12,05:00:00,8,4,4,FMN GV 16 Berchem TOT
54,Posthofbrug 5366,2020-12-12,06:00:00,10,6,4,FMN GV 16 Berchem TOT
54,Posthofbrug 5366,2020-12-12,07:00:00,11,7,4,FMN GV 16 Berchem TOT
54,Posthofbrug 5366,2020-12-12,08:00:00,33,22,11,FMN GV 16 Berchem TOT
54,Posthofbrug 5366,2020-12-12,09:00:00,66,45,21,FMN GV 16 Berchem TOT
54,Posthofbrug 5366,2020-12-12,10:00:00,79,43,36,FMN GV 16 Berchem TOT
54,Posthofbrug 5366,2020-12-12,11:00:00,98,54,44,FMN GV 16 Berchem TOT
54,Posthofbrug 5366,2020-12-12,12:00:00,113,64,49,FMN GV 16 Berchem TOT
54,Posthofbrug 5366,2020-12-12,13:00:00,138,71,67,FMN GV 16 Berchem TOT
54,Posthofbrug 5366,2020-12-12,14:00:00,105,60,45,FMN GV 16 Berchem TOT
54,Posthofbrug 5366,2020-12-12,15:00:00,109,47,62,FMN GV 16 Berchem TOT
54,Posthofbrug 5366,2020-12-12,16:00:00,113,48,65,FMN GV 16 Berchem TOT
54,Posthofbrug 5366,2020-12-12,17:00:00,111,44,67,FMN GV 16 Berchem TOT
54,Posthofbrug 5366,2020-12-12,18:00:00,61,24,37,FMN GV 16 Berchem TOT
54,Posthofbrug 5366,2020-12-12,19:00:00,37,17,20,FMN GV 16 Berchem TOT
54,Posthofbrug 5366,2020-12-12,20:00:00,25,12,13,FMN GV 16 Berchem TOT
54,Posthofbrug 5366,2020-12-12,21:00:00,20,12,8,FMN GV 16 Berchem TOT
54,Posthofbrug 5366,2020-12-12,22:00:00,30,15,15,FMN GV 16 Berchem TOT
54,Posthofbrug 5366,2020-12-12,23:00:00,45,25,20,FMN GV 16 Berchem TOT
54,Posthofbrug 5366,2020-12-13,00:00:00,4,1,3,FMN GV 16 Berchem TOT
54,Posthofbrug 5366,2020-12-13,01:00:00,1,0,1,FMN GV 16 Berchem TOT
54,Posthofbrug 5366,2020-12-13,02:00:00,0,0,0,FMN GV 16 Berchem TOT
54,Posthofbrug 5366,2020-12-13,03:00:00,0,0,0,FMN GV 16 Berchem TOT
54,Posthofbrug 5366,2020-12-13,04:00:00,0,0,0,FMN GV 16 Berchem TOT
54,Posthofbrug 5366,2020-12-13,05:00:00,9,6,3,FMN GV 16 Berchem TOT
54,Posthofbrug 5366,2020-12-13,06:00:00,7,4,3,FMN GV 16 Berchem TOT
54,Posthofbrug 5366,2020-12-13,07:00:00,9,4,5,FMN GV 16 Berchem TOT
54,Posthofbrug 5366,2020-12-13,08:00:00,35,22,13,FMN GV 16 Berchem TOT
54,Posthofbrug 5366,2020-12-13,09:00:00,63,35,28,FMN GV 16 Berchem TOT
54,Posthofbrug 5366,2020-12-13,10:00:00,88,37,51,FMN GV 16 Berchem TOT
54,Posthofbrug 5366,2020-12-13,11:00:00,128,69,59,FMN GV 16 Berchem TOT
54,Posthofbrug 5366,2020-12-13,12:00:00,132,81,51,FMN GV 16 Berchem TOT
54,Posthofbrug 5366,2020-12-13,13:00:00,158,85,73,FMN GV 16 Berchem TOT
54,Posthofbrug 5366,2020-12-13,14:00:00,132,74,58,FMN GV 16 Berchem TOT
54,Posthofbrug 5366,2020-12-13,15:00:00,107,47,60,FMN GV 16 Berchem TOT
54,Posthofbrug 5366,2020-12-13,16:00:00,107,53,54,FMN GV 16 Berchem TOT
54,Posthofbrug 5366,2020-12-13,17:00:00,87,43,44,FMN GV 16 Berchem TOT
54,Posthofbrug 5366,2020-12-13,18:00:00,72,28,44,FMN GV 16 Berchem TOT
54,Posthofbrug 5366,2020-12-13,19:00:00,37,17,20,FMN GV 16 Berchem TOT
54,Posthofbrug 5366,2020-12-13,20:00:00,35,24,11,FMN GV 16 Berchem TOT
54,Posthofbrug 5366,2020-12-13,21:00:00,28,19,9,FMN GV 16 Berchem TOT
54,Posthofbrug 5366,2020-12-13,22:00:00,18,11,7,FMN GV 16 Berchem TOT
54,Posthofbrug 5366,2020-12-13,23:00:00,11,4,7,FMN GV 16 Berchem TOT
54,Posthofbrug 5366,2020-12-14,00:00:00,4,1,3,FMN GV 16 Berchem TOT
54,Posthofbrug 5366,2020-12-14,01:00:00,2,1,1,FMN GV 16 Berchem TOT
54,Posthofbrug 5366,2020-12-14,02:00:00,0,0,0,FMN GV 16 Berchem TOT
54,Posthofbrug 5366,2020-12-14,03:00:00,1,1,0,FMN GV 16 Berchem TOT
54,Posthofbrug 5366,2020-12-14,04:00:00,13,12,1,FMN GV 16 Berchem TOT
54,Posthofbrug 5366,2020-12-14,05:00:00,16,7,9,FMN GV 16 Berchem TOT
54,Posthofbrug 5366,2020-12-14,06:00:00,70,56,14,FMN GV 16 Berchem TOT
54,Posthofbrug 5366,2020-12-14,07:00:00,207,159,48,FMN GV 16 Berchem TOT
54,Posthofbrug 5366,2020-12-14,08:00:00,304,230,74,FMN GV 16 Berchem TOT
54,Posthofbrug 5366,2020-12-14,09:00:00,116,86,30,FMN GV 16 Berchem TOT
54,Posthofbrug 5366,2020-12-14,10:00:00,78,53,25,FMN GV 16 Berchem TOT
54,Posthofbrug 5366,2020-12-14,11:00:00,93,51,42,FMN GV 16 Berchem TOT
54,Posthofbrug 5366,2020-12-14,12:00:00,123,79,44,FMN GV 16 Berchem TOT
54,Posthofbrug 5366,2020-12-14,13:00:00,121,71,50,FMN GV 16 Berchem TOT
54,Posthofbrug 5366,2020-12-14,14:00:00,140,58,82,FMN GV 16 Berchem TOT
54,Posthofbrug 5366,2020-12-14,15:00:00,157,61,96,FMN GV 16 Berchem TOT
54,Posthofbrug 5366,2020-12-14,16:00:00,230,78,152,FMN GV 16 Berchem TOT
54,Posthofbrug 5366,2020-12-14,17:00:00,230,69,161,FMN GV 16 Berchem TOT
54,Posthofbrug 5366,2020-12-14,18:00:00,140,56,84,FMN GV 16 Berchem TOT
54,Posthofbrug 5366,2020-12-14,19:00:00,61,19,42,FMN GV 16 Berchem TOT
54,Posthofbrug 5366,2020-12-14,20:00:00,43,18,25,FMN GV 16 Berchem TOT
54,Posthofbrug 5366,2020-12-14,21:00:00,40,16,24,FMN GV 16 Berchem TOT
54,Posthofbrug 5366,2020-12-14,22:00:00,14,4,10,FMN GV 16 Berchem TOT
54,Posthofbrug 5366,2020-12-14,23:00:00,15,8,7,FMN GV 16 Berchem TOT
54,Posthofbrug 5366,2020-12-15,00:00:00,6,1,5,FMN GV 16 Berchem TOT
54,Posthofbrug 5366,2020-12-15,01:00:00,2,1,1,FMN GV 16 Berchem TOT
54,Posthofbrug 5366,2020-12-15,02:00:00,0,0,0,FMN GV 16 Berchem TOT
54,Posthofbrug 5366,2020-12-15,03:00:00,1,1,0,FMN GV 16 Berchem TOT
54,Posthofbrug 5366,2020-12-15,04:00:00,10,8,2,FMN GV 16 Berchem TOT
54,Posthofbrug 5366,2020-12-15,05:00:00,17,9,8,FMN GV 16 Berchem TOT
54,Posthofbrug 5366,2020-12-15,06:00:00,66,51,15,FMN GV 16 Berchem TOT
54,Posthofbrug 5366,2020-12-15,07:00:00,216,154,62,FMN GV 16 Berchem TOT
54,Posthofbrug 5366,2020-12-15,08:00:00,324,248,76,FMN GV 16 Berchem TOT
54,Posthofbrug 5366,2020-12-15,09:00:00,149,116,33,FMN GV 16 Berchem TOT
54,Posthofbrug 5366,2020-12-15,10:00:00,84,50,34,FMN GV 16 Berchem TOT
54,Posthofbrug 5366,2020-12-15,11:00:00,67,34,33,FMN GV 16 Berchem TOT
54,Posthofbrug 5366,2020-12-15,12:00:00,107,50,57,FMN GV 16 Berchem TOT
54,Posthofbrug 5366,2020-12-15,13:00:00,86,48,38,FMN GV 16 Berchem TOT
54,Posthofbrug 5366,2020-12-15,14:00:00,112,61,51,FMN GV 16 Berchem TOT
54,Posthofbrug 5366,2020-12-15,15:00:00,183,70,113,FMN GV 16 Berchem TOT
54,Posthofbrug 5366,2020-12-15,16:00:00,230,79,151,FMN GV 16 Berchem TOT
54,Posthofbrug 5366,2020-12-15,17:00:00,240,81,159,FMN GV 16 Berchem TOT
54,Posthofbrug 5366,2020-12-15,18:00:00,167,52,115,FMN GV 16 Berchem TOT
54,Posthofbrug 5366,2020-12-15,19:00:00,101,36,65,FMN GV 16 Berchem TOT
54,Posthofbrug 5366,2020-12-15,20:00:00,48,25,23,FMN GV 16 Berchem TOT
54,Posthofbrug 5366,2020-12-15,21:00:00,41,21,20,FMN GV 16 Berchem TOT
54,Posthofbrug 5366,2020-12-15,22:00:00,38,18,20,FMN GV 16 Berchem TOT
54,Posthofbrug 5366,2020-12-15,23:00:00,18,7,11,FMN GV 16 Berchem TOT
54,Posthofbrug 5366,2020-12-16,00:00:00,3,1,2,FMN GV 16 Berchem TOT
54,Posthofbrug 5366,2020-12-16,01:00:00,0,0,0,FMN GV 16 Berchem TOT
54,Posthofbrug 5366,2020-12-16,02:00:00,1,1,0,FMN GV 16 Berchem TOT
54,Posthofbrug 5366,2020-12-16,03:00:00,1,1,0,FMN GV 16 Berchem TOT
54,Posthofbrug 5366,2020-12-16,04:00:00,12,12,0,FMN GV 16 Berchem TOT
54,Posthofbrug 5366,2020-12-16,05:00:00,22,14,8,FMN GV 16 Berchem TOT
54,Posthofbrug 5366,2020-12-16,06:00:00,61,48,13,FMN GV 16 Berchem TOT
54,Posthofbrug 5366,2020-12-16,07:00:00,197,144,53,FMN GV 16 Berchem TOT
54,Posthofbrug 5366,2020-12-16,08:00:00,271,197,74,FMN GV 16 Berchem TOT
54,Posthofbrug 5366,2020-12-16,09:00:00,149,102,47,FMN GV 16 Berchem TOT
54,Posthofbrug 5366,2020-12-16,10:00:00,76,53,23,FMN GV 16 Berchem TOT
54,Posthofbrug 5366,2020-12-16,11:00:00,124,56,68,FMN GV 16 Berchem TOT
54,Posthofbrug 5366,2020-12-16,12:00:00,197,105,92,FMN GV 16 Berchem TOT
54,Posthofbrug 5366,2020-12-16,13:00:00,170,88,82,FMN GV 16 Berchem TOT
54,Posthofbrug 5366,2020-12-16,14:00:00,151,62,89,FMN GV 16 Berchem TOT
54,Posthofbrug 5366,2020-12-16,15:00:00,189,76,113,FMN GV 16 Berchem TOT
54,Posthofbrug 5366,2020-12-16,16:00:00,211,80,131,FMN GV 16 Berchem TOT
54,Posthofbrug 5366,2020-12-16,17:00:00,256,84,172,FMN GV 16 Berchem TOT
54,Posthofbrug 5366,2020-12-16,18:00:00,174,61,113,FMN GV 16 Berchem TOT
54,Posthofbrug 5366,2020-12-16,19:00:00,86,38,48,FMN GV 16 Berchem TOT
54,Posthofbrug 5366,2020-12-16,20:00:00,68,30,38,FMN GV 16 Berchem TOT
54,Posthofbrug 5366,2020-12-16,21:00:00,35,23,12,FMN GV 16 Berchem TOT
54,Posthofbrug 5366,2020-12-16,22:00:00,37,12,25,FMN GV 16 Berchem TOT
54,Posthofbrug 5366,2020-12-16,23:00:00,30,19,11,FMN GV 16 Berchem TOT
54,Posthofbrug 5366,2020-12-17,00:00:00,8,1,7,FMN GV 16 Berchem TOT
54,Posthofbrug 5366,2020-12-17,01:00:00,2,1,1,FMN GV 16 Berchem TOT
54,Posthofbrug 5366,2020-12-17,02:00:00,1,0,1,FMN GV 16 Berchem TOT
54,Posthofbrug 5366,2020-12-17,03:00:00,1,1,0,FMN GV 16 Berchem TOT
54,Posthofbrug 5366,2020-12-17,04:00:00,13,11,2,FMN GV 16 Berchem TOT
54,Posthofbrug 5366,2020-12-17,05:00:00,17,11,6,FMN GV 16 Berchem TOT
54,Posthofbrug 5366,2020-12-17,06:00:00,56,38,18,FMN GV 16 Berchem TOT
54,Posthofbrug 5366,2020-12-17,07:00:00,196,150,46,FMN GV 16 Berchem TOT
54,Posthofbrug 5366,2020-12-17,08:00:00,332,259,73,FMN GV 16 Berchem TOT
54,Posthofbrug 5366,2020-12-17,09:00:00,164,125,39,FMN GV 16 Berchem TOT
54,Posthofbrug 5366,2020-12-17,10:00:00,129,86,43,FMN GV 16 Berchem TOT
54,Posthofbrug 5366,2020-12-17,11:00:00,110,61,49,FMN GV 16 Berchem TOT
54,Posthofbrug 5366,2020-12-17,12:00:00,117,63,54,FMN GV 16 Berchem TOT
54,Posthofbrug 5366,2020-12-17,13:00:00,151,87,64,FMN GV 16 Berchem TOT
54,Posthofbrug 5366,2020-12-17,14:00:00,164,76,88,FMN GV 16 Berchem TOT
54,Posthofbrug 5366,2020-12-17,15:00:00,182,61,121,FMN GV 16 Berchem TOT
54,Posthofbrug 5366,2020-12-17,16:00:00,245,86,159,FMN GV 16 Berchem TOT
54,Posthofbrug 5366,2020-12-17,17:00:00,265,80,185,FMN GV 16 Berchem TOT
54,Posthofbrug 5366,2020-12-17,18:00:00,182,64,118,FMN GV 16 Berchem TOT
54,Posthofbrug 5366,2020-12-17,19:00:00,99,47,52,FMN GV 16 Berchem TOT
54,Posthofbrug 5366,2020-12-17,20:00:00,74,30,44,FMN GV 16 Berchem TOT
54,Posthofbrug 5366,2020-12-17,21:00:00,44,17,27,FMN GV 16 Berchem TOT
54,Posthofbrug 5366,2020-12-17,22:00:00,38,17,21,FMN GV 16 Berchem TOT
54,Posthofbrug 5366,2020-12-17,23:00:00,25,9,16,FMN GV 16 Berchem TOT
54,Posthofbrug 5366,2020-12-18,00:00:00,7,2,5,FMN GV 16 Berchem TOT
54,Posthofbrug 5366,2020-12-18,01:00:00,2,1,1,FMN GV 16 Berchem TOT
54,Posthofbrug 5366,2020-12-18,02:00:00,0,0,0,FMN GV 16 Berchem TOT
54,Posthofbrug 5366,2020-12-18,03:00:00,1,1,0,FMN GV 16 Berchem TOT
54,Posthofbrug 5366,2020-12-18,04:00:00,6,4,2,FMN GV 16 Berchem TOT
54,Posthofbrug 5366,2020-12-18,05:00:00,16,12,4,FMN GV 16 Berchem TOT
54,Posthofbrug 5366,2020-12-18,06:00:00,49,36,13,FMN GV 16 Berchem TOT
54,Posthofbrug 5366,2020-12-18,07:00:00,165,120,45,FMN GV 16 Berchem TOT
54,Posthofbrug 5366,2020-12-18,08:00:00,276,210,66,FMN GV 16 Berchem TOT
54,Posthofbrug 5366,2020-12-18,09:00:00,119,90,29,FMN GV 16 Berchem TOT
54,Posthofbrug 5366,2020-12-18,10:00:00,94,61,33,FMN GV 16 Berchem TOT
54,Posthofbrug 5366,2020-12-18,11:00:00,156,87,69,FMN GV 16 Berchem TOT
54,Posthofbrug 5366,2020-12-18,12:00:00,172,86,86,FMN GV 16 Berchem TOT
54,Posthofbrug 5366,2020-12-18,13:00:00,193,102,91,FMN GV 16 Berchem TOT
54,Posthofbrug 5366,2020-12-18,14:00:00,187,84,103,FMN GV 16 Berchem TOT
54,Posthofbrug 5366,2020-12-18,15:00:00,261,90,171,FMN GV 16 Berchem TOT
54,Posthofbrug 5366,2020-12-18,16:00:00,235,102,133,FMN GV 16 Berchem TOT
54,Posthofbrug 5366,2020-12-18,17:00:00,224,70,154,FMN GV 16 Berchem TOT
54,Posthofbrug 5366,2020-12-18,18:00:00,160,63,97,FMN GV 16 Berchem TOT
54,Posthofbrug 5366,2020-12-18,19:00:00,90,36,54,FMN GV 16 Berchem TOT
54,Posthofbrug 5366,2020-12-18,20:00:00,50,15,35,FMN GV 16 Berchem TOT
54,Posthofbrug 5366,2020-12-18,21:00:00,36,15,21,FMN GV 16 Berchem TOT
54,Posthofbrug 5366,2020-12-18,22:00:00,46,21,25,FMN GV 16 Berchem TOT
54,Posthofbrug 5366,2020-12-18,23:00:00,63,23,40,FMN GV 16 Berchem TOT
54,Posthofbrug 5366,2020-12-19,00:00:00,11,8,3,FMN GV 16 Berchem TOT
54,Posthofbrug 5366,2020-12-19,01:00:00,3,2,1,FMN GV 16 Berchem TOT
54,Posthofbrug 5366,2020-12-19,02:00:00,1,0,1,FMN GV 16 Berchem TOT
54,Posthofbrug 5366,2020-12-19,03:00:00,1,0,1,FMN GV 16 Berchem TOT
54,Posthofbrug 5366,2020-12-19,04:00:00,4,4,0,FMN GV 16 Berchem TOT
54,Posthofbrug 5366,2020-12-19,05:00:00,6,3,3,FMN GV 16 Berchem TOT
54,Posthofbrug 5366,2020-12-19,06:00:00,8,6,2,FMN GV 16 Berchem TOT
54,Posthofbrug 5366,2020-12-19,07:00:00,21,11,10,FMN GV 16 Berchem TOT
54,Posthofbrug 5366,2020-12-19,08:00:00,43,26,17,FMN GV 16 Berchem TOT
54,Posthofbrug 5366,2020-12-19,09:00:00,85,58,27,FMN GV 16 Berchem TOT
54,Posthofbrug 5366,2020-12-19,10:00:00,130,80,50,FMN GV 16 Berchem TOT
54,Posthofbrug 5366,2020-12-19,11:00:00,104,61,43,FMN GV 16 Berchem TOT
54,Posthofbrug 5366,2020-12-19,12:00:00,114,54,60,FMN GV 16 Berchem TOT
54,Posthofbrug 5366,2020-12-19,13:00:00,118,72,46,FMN GV 16 Berchem TOT
54,Posthofbrug 5366,2020-12-19,14:00:00,113,65,48,FMN GV 16 Berchem TOT
54,Posthofbrug 5366,2020-12-19,15:00:00,114,56,58,FMN GV 16 Berchem TOT
54,Posthofbrug 5366,2020-12-19,16:00:00,116,63,53,FMN GV 16 Berchem TOT
54,Posthofbrug 5366,2020-12-19,17:00:00,114,48,66,FMN GV 16 Berchem TOT
54,Posthofbrug 5366,2020-12-19,18:00:00,63,28,35,FMN GV 16 Berchem TOT
54,Posthofbrug 5366,2020-12-19,19:00:00,61,24,37,FMN GV 16 Berchem TOT
54,Posthofbrug 5366,2020-12-19,20:00:00,40,15,25,FMN GV 16 Berchem TOT
54,Posthofbrug 5366,2020-12-19,21:00:00,32,18,14,FMN GV 16 Berchem TOT
54,Posthofbrug 5366,2020-12-19,22:00:00,23,11,12,FMN GV 16 Berchem TOT
54,Posthofbrug 5366,2020-12-19,23:00:00,45,27,18,FMN GV 16 Berchem TOT
54,Posthofbrug 5366,2020-12-20,00:00:00,11,3,8,FMN GV 16 Berchem TOT
54,Posthofbrug 5366,2020-12-20,01:00:00,0,0,0,FMN GV 16 Berchem TOT
54,Posthofbrug 5366,2020-12-20,02:00:00,0,0,0,FMN GV 16 Berchem TOT
54,Posthofbrug 5366,2020-12-20,03:00:00,1,1,0,FMN GV 16 Berchem TOT
54,Posthofbrug 5366,2020-12-20,04:00:00,4,3,1,FMN GV 16 Berchem TOT
54,Posthofbrug 5366,2020-12-20,05:00:00,9,3,6,FMN GV 16 Berchem TOT
54,Posthofbrug 5366,2020-12-20,06:00:00,19,17,2,FMN GV 16 Berchem TOT
54,Posthofbrug 5366,2020-12-20,07:00:00,17,11,6,FMN GV 16 Berchem TOT
54,Posthofbrug 5366,2020-12-20,08:00:00,38,23,15,FMN GV 16 Berchem TOT
54,Posthofbrug 5366,2020-12-20,09:00:00,63,31,32,FMN GV 16 Berchem TOT
54,Posthofbrug 5366,2020-12-20,10:00:00,95,50,45,FMN GV 16 Berchem TOT
54,Posthofbrug 5366,2020-12-20,11:00:00,107,73,34,FMN GV 16 Berchem TOT
54,Posthofbrug 5366,2020-12-20,12:00:00,130,79,51,FMN GV 16 Berchem TOT
54,Posthofbrug 5366,2020-12-20,13:00:00,155,89,66,FMN GV 16 Berchem TOT
54,Posthofbrug 5366,2020-12-20,14:00:00,169,101,68,FMN GV 16 Berchem TOT
54,Posthofbrug 5366,2020-12-20,15:00:00,129,67,62,FMN GV 16 Berchem TOT
54,Posthofbrug 5366,2020-12-20,16:00:00,150,85,65,FMN GV 16 Berchem TOT
54,Posthofbrug 5366,2020-12-20,17:00:00,116,56,60,FMN GV 16 Berchem TOT
54,Posthofbrug 5366,2020-12-20,18:00:00,79,27,52,FMN GV 16 Berchem TOT
54,Posthofbrug 5366,2020-12-20,19:00:00,42,19,23,FMN GV 16 Berchem TOT
54,Posthofbrug 5366,2020-12-20,20:00:00,28,15,13,FMN GV 16 Berchem TOT
54,Posthofbrug 5366,2020-12-20,21:00:00,31,19,12,FMN GV 16 Berchem TOT
54,Posthofbrug 5366,2020-12-20,22:00:00,33,16,17,FMN GV 16 Berchem TOT
54,Posthofbrug 5366,2020-12-20,23:00:00,30,14,16,FMN GV 16 Berchem TOT
54,Posthofbrug 5366,2020-12-21,00:00:00,1,0,1,FMN GV 16 Berchem TOT
54,Posthofbrug 5366,2020-12-21,01:00:00,0,0,0,FMN GV 16 Berchem TOT
54,Posthofbrug 5366,2020-12-21,02:00:00,1,0,1,FMN GV 16 Berchem TOT
54,Posthofbrug 5366,2020-12-21,03:00:00,1,1,0,FMN GV 16 Berchem TOT
54,Posthofbrug 5366,2020-12-21,04:00:00,5,3,2,FMN GV 16 Berchem TOT
54,Posthofbrug 5366,2020-12-21,05:00:00,13,8,5,FMN GV 16 Berchem TOT
54,Posthofbrug 5366,2020-12-21,06:00:00,40,28,12,FMN GV 16 Berchem TOT
54,Posthofbrug 5366,2020-12-21,07:00:00,109,71,38,FMN GV 16 Berchem TOT
54,Posthofbrug 5366,2020-12-21,08:00:00,157,110,47,FMN GV 16 Berchem TOT
54,Posthofbrug 5366,2020-12-21,09:00:00,65,54,11,FMN GV 16 Berchem TOT
54,Posthofbrug 5366,2020-12-21,10:00:00,72,49,23,FMN GV 16 Berchem TOT
54,Posthofbrug 5366,2020-12-21,11:00:00,72,43,29,FMN GV 16 Berchem TOT
54,Posthofbrug 5366,2020-12-21,12:00:00,57,28,29,FMN GV 16 Berchem TOT
54,Posthofbrug 5366,2020-12-21,13:00:00,71,36,35,FMN GV 16 Berchem TOT
54,Posthofbrug 5366,2020-12-21,14:00:00,54,30,24,FMN GV 16 Berchem TOT
54,Posthofbrug 5366,2020-12-21,15:00:00,65,29,36,FMN GV 16 Berchem TOT
54,Posthofbrug 5366,2020-12-21,16:00:00,108,39,69,FMN GV 16 Berchem TOT
54,Posthofbrug 5366,2020-12-21,17:00:00,149,60,89,FMN GV 16 Berchem TOT
54,Posthofbrug 5366,2020-12-21,18:00:00,97,37,60,FMN GV 16 Berchem TOT
54,Posthofbrug 5366,2020-12-21,19:00:00,43,13,30,FMN GV 16 Berchem TOT
54,Posthofbrug 5366,2020-12-21,20:00:00,30,13,17,FMN GV 16 Berchem TOT
54,Posthofbrug 5366,2020-12-21,21:00:00,29,9,20,FMN GV 16 Berchem TOT
54,Posthofbrug 5366,2020-12-21,22:00:00,13,8,5,FMN GV 16 Berchem TOT
54,Posthofbrug 5366,2020-12-21,23:00:00,14,6,8,FMN GV 16 Berchem TOT
54,Posthofbrug 5366,2020-12-22,00:00:00,5,3,2,FMN GV 16 Berchem TOT
54,Posthofbrug 5366,2020-12-22,01:00:00,0,0,0,FMN GV 16 Berchem TOT
54,Posthofbrug 5366,2020-12-22,02:00:00,1,0,1,FMN GV 16 Berchem TOT
54,Posthofbrug 5366,2020-12-22,03:00:00,0,0,0,FMN GV 16 Berchem TOT
54,Posthofbrug 5366,2020-12-22,04:00:00,9,6,3,FMN GV 16 Berchem TOT
54,Posthofbrug 5366,2020-12-22,05:00:00,15,9,6,FMN GV 16 Berchem TOT
54,Posthofbrug 5366,2020-12-22,06:00:00,38,33,5,FMN GV 16 Berchem TOT
54,Posthofbrug 5366,2020-12-22,07:00:00,105,74,31,FMN GV 16 Berchem TOT
54,Posthofbrug 5366,2020-12-22,08:00:00,146,107,39,FMN GV 16 Berchem TOT
54,Posthofbrug 5366,2020-12-22,09:00:00,82,67,15,FMN GV 16 Berchem TOT
54,Posthofbrug 5366,2020-12-22,10:00:00,93,59,34,FMN GV 16 Berchem TOT
54,Posthofbrug 5366,2020-12-22,11:00:00,112,55,57,FMN GV 16 Berchem TOT
54,Posthofbrug 5366,2020-12-22,12:00:00,134,81,53,FMN GV 16 Berchem TOT
54,Posthofbrug 5366,2020-12-22,13:00:00,145,79,66,FMN GV 16 Berchem TOT
54,Posthofbrug 5366,2020-12-22,14:00:00,139,77,62,FMN GV 16 Berchem TOT
54,Posthofbrug 5366,2020-12-22,15:00:00,126,51,75,FMN GV 16 Berchem TOT
54,Posthofbrug 5366,2020-12-22,16:00:00,163,62,101,FMN GV 16 Berchem TOT
54,Posthofbrug 5366,2020-12-22,17:00:00,174,59,115,FMN GV 16 Berchem TOT
54,Posthofbrug 5366,2020-12-22,18:00:00,131,46,85,FMN GV 16 Berchem TOT
54,Posthofbrug 5366,2020-12-22,19:00:00,69,29,40,FMN GV 16 Berchem TOT
54,Posthofbrug 5366,2020-12-22,20:00:00,41,25,16,FMN GV 16 Berchem TOT
54,Posthofbrug 5366,2020-12-22,21:00:00,26,9,17,FMN GV 16 Berchem TOT
54,Posthofbrug 5366,2020-12-22,22:00:00,36,26,10,FMN GV 16 Berchem TOT
54,Posthofbrug 5366,2020-12-22,23:00:00,25,12,13,FMN GV 16 Berchem TOT
54,Posthofbrug 5366,2020-12-23,00:00:00,2,0,2,FMN GV 16 Berchem TOT
54,Posthofbrug 5366,2020-12-23,01:00:00,0,0,0,FMN GV 16 Berchem TOT
54,Posthofbrug 5366,2020-12-23,02:00:00,0,0,0,FMN GV 16 Berchem TOT
54,Posthofbrug 5366,2020-12-23,03:00:00,1,1,0,FMN GV 16 Berchem TOT
54,Posthofbrug 5366,2020-12-23,04:00:00,6,4,2,FMN GV 16 Berchem TOT
54,Posthofbrug 5366,2020-12-23,05:00:00,14,9,5,FMN GV 16 Berchem TOT
54,Posthofbrug 5366,2020-12-23,06:00:00,29,22,7,FMN GV 16 Berchem TOT
54,Posthofbrug 5366,2020-12-23,07:00:00,81,55,26,FMN GV 16 Berchem TOT
54,Posthofbrug 5366,2020-12-23,08:00:00,128,92,36,FMN GV 16 Berchem TOT
54,Posthofbrug 5366,2020-12-23,09:00:00,80,51,29,FMN GV 16 Berchem TOT
54,Posthofbrug 5366,2020-12-23,10:00:00,50,34,16,FMN GV 16 Berchem TOT
54,Posthofbrug 5366,2020-12-23,11:00:00,35,18,17,FMN GV 16 Berchem TOT
54,Posthofbrug 5366,2020-12-23,12:00:00,51,20,31,FMN GV 16 Berchem TOT
54,Posthofbrug 5366,2020-12-23,13:00:00,71,41,30,FMN GV 16 Berchem TOT
54,Posthofbrug 5366,2020-12-23,14:00:00,101,55,46,FMN GV 16 Berchem TOT
54,Posthofbrug 5366,2020-12-23,15:00:00,82,38,44,FMN GV 16 Berchem TOT
54,Posthofbrug 5366,2020-12-23,16:00:00,114,51,63,FMN GV 16 Berchem TOT
54,Posthofbrug 5366,2020-12-23,17:00:00,128,50,78,FMN GV 16 Berchem TOT
54,Posthofbrug 5366,2020-12-23,18:00:00,96,32,64,FMN GV 16 Berchem TOT
54,Posthofbrug 5366,2020-12-23,19:00:00,47,16,31,FMN GV 16 Berchem TOT
54,Posthofbrug 5366,2020-12-23,20:00:00,47,22,25,FMN GV 16 Berchem TOT
54,Posthofbrug 5366,2020-12-23,21:00:00,21,14,7,FMN GV 16 Berchem TOT
54,Posthofbrug 5366,2020-12-23,22:00:00,32,13,19,FMN GV 16 Berchem TOT
54,Posthofbrug 5366,2020-12-23,23:00:00,30,11,19,FMN GV 16 Berchem TOT
54,Posthofbrug 5366,2020-12-24,00:00:00,5,3,2,FMN GV 16 Berchem TOT
54,Posthofbrug 5366,2020-12-24,01:00:00,0,0,0,FMN GV 16 Berchem TOT
54,Posthofbrug 5366,2020-12-24,02:00:00,0,0,0,FMN GV 16 Berchem TOT
54,Posthofbrug 5366,2020-12-24,03:00:00,0,0,0,FMN GV 16 Berchem TOT
54,Posthofbrug 5366,2020-12-24,04:00:00,4,4,0,FMN GV 16 Berchem TOT
54,Posthofbrug 5366,2020-12-24,05:00:00,10,4,6,FMN GV 16 Berchem TOT
54,Posthofbrug 5366,2020-12-24,06:00:00,28,25,3,FMN GV 16 Berchem TOT
54,Posthofbrug 5366,2020-12-24,07:00:00,71,50,21,FMN GV 16 Berchem TOT
54,Posthofbrug 5366,2020-12-24,08:00:00,80,56,24,FMN GV 16 Berchem TOT
54,Posthofbrug 5366,2020-12-24,09:00:00,66,46,20,FMN GV 16 Berchem TOT
54,Posthofbrug 5366,2020-12-24,10:00:00,43,25,18,FMN GV 16 Berchem TOT
54,Posthofbrug 5366,2020-12-24,11:00:00,69,42,27,FMN GV 16 Berchem TOT
54,Posthofbrug 5366,2020-12-24,12:00:00,91,43,48,FMN GV 16 Berchem TOT
54,Posthofbrug 5366,2020-12-24,13:00:00,103,58,45,FMN GV 16 Berchem TOT
54,Posthofbrug 5366,2020-12-24,14:00:00,120,43,77,FMN GV 16 Berchem TOT
54,Posthofbrug 5366,2020-12-24,15:00:00,98,38,60,FMN GV 16 Berchem TOT
54,Posthofbrug 5366,2020-12-24,16:00:00,118,58,60,FMN GV 16 Berchem TOT
54,Posthofbrug 5366,2020-12-24,17:00:00,81,26,55,FMN GV 16 Berchem TOT
54,Posthofbrug 5366,2020-12-24,18:00:00,45,17,28,FMN GV 16 Berchem TOT
54,Posthofbrug 5366,2020-12-24,19:00:00,18,6,12,FMN GV 16 Berchem TOT
54,Posthofbrug 5366,2020-12-24,20:00:00,21,13,8,FMN GV 16 Berchem TOT
54,Posthofbrug 5366,2020-12-24,21:00:00,12,9,3,FMN GV 16 Berchem TOT
54,Posthofbrug 5366,2020-12-24,22:00:00,16,8,8,FMN GV 16 Berchem TOT
54,Posthofbrug 5366,2020-12-24,23:00:00,52,41,11,FMN GV 16 Berchem TOT
54,Posthofbrug 5366,2020-12-25,00:00:00,3,1,2,FMN GV 16 Berchem TOT
54,Posthofbrug 5366,2020-12-25,01:00:00,0,0,0,FMN GV 16 Berchem TOT
54,Posthofbrug 5366,2020-12-25,02:00:00,2,1,1,FMN GV 16 Berchem TOT
54,Posthofbrug 5366,2020-12-25,03:00:00,0,0,0,FMN GV 16 Berchem TOT
54,Posthofbrug 5366,2020-12-25,04:00:00,1,1,0,FMN GV 16 Berchem TOT
54,Posthofbrug 5366,2020-12-25,05:00:00,8,7,1,FMN GV 16 Berchem TOT
54,Posthofbrug 5366,2020-12-25,06:00:00,9,5,4,FMN GV 16 Berchem TOT
54,Posthofbrug 5366,2020-12-25,07:00:00,9,7,2,FMN GV 16 Berchem TOT
54,Posthofbrug 5366,2020-12-25,08:00:00,14,8,6,FMN GV 16 Berchem TOT
54,Posthofbrug 5366,2020-12-25,09:00:00,20,7,13,FMN GV 16 Berchem TOT
54,Posthofbrug 5366,2020-12-25,10:00:00,40,24,16,FMN GV 16 Berchem TOT
54,Posthofbrug 5366,2020-12-25,11:00:00,84,47,37,FMN GV 16 Berchem TOT
54,Posthofbrug 5366,2020-12-25,12:00:00,101,55,46,FMN GV 16 Berchem TOT
54,Posthofbrug 5366,2020-12-25,13:00:00,139,69,70,FMN GV 16 Berchem TOT
54,Posthofbrug 5366,2020-12-25,14:00:00,117,67,50,FMN GV 16 Berchem TOT
54,Posthofbrug 5366,2020-12-25,15:00:00,118,62,56,FMN GV 16 Berchem TOT
54,Posthofbrug 5366,2020-12-25,16:00:00,123,75,48,FMN GV 16 Berchem TOT
54,Posthofbrug 5366,2020-12-25,17:00:00,82,46,36,FMN GV 16 Berchem TOT
54,Posthofbrug 5366,2020-12-25,18:00:00,37,20,17,FMN GV 16 Berchem TOT
54,Posthofbrug 5366,2020-12-25,19:00:00,27,18,9,FMN GV 16 Berchem TOT
54,Posthofbrug 5366,2020-12-25,20:00:00,17,8,9,FMN GV 16 Berchem TOT
54,Posthofbrug 5366,2020-12-25,21:00:00,30,19,11,FMN GV 16 Berchem TOT
54,Posthofbrug 5366,2020-12-25,22:00:00,29,20,9,FMN GV 16 Berchem TOT
54,Posthofbrug 5366,2020-12-25,23:00:00,40,28,12,FMN GV 16 Berchem TOT
54,Posthofbrug 5366,2020-12-26,00:00:00,2,0,2,FMN GV 16 Berchem TOT
54,Posthofbrug 5366,2020-12-26,01:00:00,0,0,0,FMN GV 16 Berchem TOT
54,Posthofbrug 5366,2020-12-26,02:00:00,1,0,1,FMN GV 16 Berchem TOT
54,Posthofbrug 5366,2020-12-26,03:00:00,1,0,1,FMN GV 16 Berchem TOT
54,Posthofbrug 5366,2020-12-26,04:00:00,4,4,0,FMN GV 16 Berchem TOT
54,Posthofbrug 5366,2020-12-26,05:00:00,4,1,3,FMN GV 16 Berchem TOT
54,Posthofbrug 5366,2020-12-26,06:00:00,9,7,2,FMN GV 16 Berchem TOT
54,Posthofbrug 5366,2020-12-26,07:00:00,14,8,6,FMN GV 16 Berchem TOT
54,Posthofbrug 5366,2020-12-26,08:00:00,28,18,10,FMN GV 16 Berchem TOT
54,Posthofbrug 5366,2020-12-26,09:00:00,52,37,15,FMN GV 16 Berchem TOT
54,Posthofbrug 5366,2020-12-26,10:00:00,89,58,31,FMN GV 16 Berchem TOT
54,Posthofbrug 5366,2020-12-26,11:00:00,86,52,34,FMN GV 16 Berchem TOT
54,Posthofbrug 5366,2020-12-26,12:00:00,105,64,41,FMN GV 16 Berchem TOT
54,Posthofbrug 5366,2020-12-26,13:00:00,96,55,41,FMN GV 16 Berchem TOT
54,Posthofbrug 5366,2020-12-26,14:00:00,145,95,50,FMN GV 16 Berchem TOT
54,Posthofbrug 5366,2020-12-26,15:00:00,109,35,74,FMN GV 16 Berchem TOT
54,Posthofbrug 5366,2020-12-26,16:00:00,88,40,48,FMN GV 16 Berchem TOT
54,Posthofbrug 5366,2020-12-26,17:00:00,79,30,49,FMN GV 16 Berchem TOT
54,Posthofbrug 5366,2020-12-26,18:00:00,74,31,43,FMN GV 16 Berchem TOT
54,Posthofbrug 5366,2020-12-26,19:00:00,43,31,12,FMN GV 16 Berchem TOT
54,Posthofbrug 5366,2020-12-26,20:00:00,30,16,14,FMN GV 16 Berchem TOT
54,Posthofbrug 5366,2020-12-26,21:00:00,23,15,8,FMN GV 16 Berchem TOT
54,Posthofbrug 5366,2020-12-26,22:00:00,19,15,4,FMN GV 16 Berchem TOT
54,Posthofbrug 5366,2020-12-26,23:00:00,35,18,17,FMN GV 16 Berchem TOT
54,Posthofbrug 5366,2020-12-27,00:00:00,8,5,3,FMN GV 16 Berchem TOT
54,Posthofbrug 5366,2020-12-27,01:00:00,2,2,0,FMN GV 16 Berchem TOT
54,Posthofbrug 5366,2020-12-27,02:00:00,2,0,2,FMN GV 16 Berchem TOT
54,Posthofbrug 5366,2020-12-27,03:00:00,2,0,2,FMN GV 16 Berchem TOT
54,Posthofbrug 5366,2020-12-27,04:00:00,2,0,2,FMN GV 16 Berchem TOT
54,Posthofbrug 5366,2020-12-27,05:00:00,6,3,3,FMN GV 16 Berchem TOT
54,Posthofbrug 5366,2020-12-27,06:00:00,3,3,0,FMN GV 16 Berchem TOT
54,Posthofbrug 5366,2020-12-27,07:00:00,6,5,1,FMN GV 16 Berchem TOT
54,Posthofbrug 5366,2020-12-27,08:00:00,22,15,7,FMN GV 16 Berchem TOT
54,Posthofbrug 5366,2020-12-27,09:00:00,23,6,17,FMN GV 16 Berchem TOT
54,Posthofbrug 5366,2020-12-27,10:00:00,19,13,6,FMN GV 16 Berchem TOT
54,Posthofbrug 5366,2020-12-27,11:00:00,25,13,12,FMN GV 16 Berchem TOT
54,Posthofbrug 5366,2020-12-27,12:00:00,24,11,13,FMN GV 16 Berchem TOT
54,Posthofbrug 5366,2020-12-27,13:00:00,19,10,9,FMN GV 16 Berchem TOT
54,Posthofbrug 5366,2020-12-27,14:00:00,12,3,9,FMN GV 16 Berchem TOT
54,Posthofbrug 5366,2020-12-27,15:00:00,15,8,7,FMN GV 16 Berchem TOT
54,Posthofbrug 5366,2020-12-27,16:00:00,26,10,16,FMN GV 16 Berchem TOT
54,Posthofbrug 5366,2020-12-27,17:00:00,28,11,17,FMN GV 16 Berchem TOT
54,Posthofbrug 5366,2020-12-27,18:00:00,35,20,15,FMN GV 16 Berchem TOT
54,Posthofbrug 5366,2020-12-27,19:00:00,26,14,12,FMN GV 16 Berchem TOT
54,Posthofbrug 5366,2020-12-27,20:00:00,18,14,4,FMN GV 16 Berchem TOT
54,Posthofbrug 5366,2020-12-27,21:00:00,13,6,7,FMN GV 16 Berchem TOT
54,Posthofbrug 5366,2020-12-27,22:00:00,18,16,2,FMN GV 16 Berchem TOT
54,Posthofbrug 5366,2020-12-27,23:00:00,14,5,9,FMN GV 16 Berchem TOT
54,Posthofbrug 5366,2020-12-28,00:00:00,1,0,1,FMN GV 16 Berchem TOT
54,Posthofbrug 5366,2020-12-28,01:00:00,1,1,0,FMN GV 16 Berchem TOT
54,Posthofbrug 5366,2020-12-28,02:00:00,1,0,1,FMN GV 16 Berchem TOT
54,Posthofbrug 5366,2020-12-28,03:00:00,0,0,0,FMN GV 16 Berchem TOT
54,Posthofbrug 5366,2020-12-28,04:00:00,7,6,1,FMN GV 16 Berchem TOT
54,Posthofbrug 5366,2020-12-28,05:00:00,11,6,5,FMN GV 16 Berchem TOT
54,Posthofbrug 5366,2020-12-28,06:00:00,40,33,7,FMN GV 16 Berchem TOT
54,Posthofbrug 5366,2020-12-28,07:00:00,75,59,16,FMN GV 16 Berchem TOT
54,Posthofbrug 5366,2020-12-28,08:00:00,87,60,27,FMN GV 16 Berchem TOT
54,Posthofbrug 5366,2020-12-28,09:00:00,78,51,27,FMN GV 16 Berchem TOT
54,Posthofbrug 5366,2020-12-28,10:00:00,91,63,28,FMN GV 16 Berchem TOT
54,Posthofbrug 5366,2020-12-28,11:00:00,96,44,52,FMN GV 16 Berchem TOT
54,Posthofbrug 5366,2020-12-28,12:00:00,117,65,52,FMN GV 16 Berchem TOT
54,Posthofbrug 5366,2020-12-28,13:00:00,112,63,49,FMN GV 16 Berchem TOT
54,Posthofbrug 5366,2020-12-28,14:00:00,95,40,55,FMN GV 16 Berchem TOT
54,Posthofbrug 5366,2020-12-28,15:00:00,119,70,49,FMN GV 16 Berchem TOT
54,Posthofbrug 5366,2020-12-28,16:00:00,114,46,68,FMN GV 16 Berchem TOT
54,Posthofbrug 5366,2020-12-28,17:00:00,142,41,101,FMN GV 16 Berchem TOT
54,Posthofbrug 5366,2020-12-28,18:00:00,91,35,56,FMN GV 16 Berchem TOT
54,Posthofbrug 5366,2020-12-28,19:00:00,48,15,33,FMN GV 16 Berchem TOT
54,Posthofbrug 5366,2020-12-28,20:00:00,51,26,25,FMN GV 16 Berchem TOT
54,Posthofbrug 5366,2020-12-28,21:00:00,31,12,19,FMN GV 16 Berchem TOT
54,Posthofbrug 5366,2020-12-28,22:00:00,15,5,10,FMN GV 16 Berchem TOT
54,Posthofbrug 5366,2020-12-28,23:00:00,24,8,16,FMN GV 16 Berchem TOT
54,Posthofbrug 5366,2020-12-29,00:00:00,2,2,0,FMN GV 16 Berchem TOT
54,Posthofbrug 5366,2020-12-29,01:00:00,0,0,0,FMN GV 16 Berchem TOT
54,Posthofbrug 5366,2020-12-29,02:00:00,0,0,0,FMN GV 16 Berchem TOT
54,Posthofbrug 5366,2020-12-29,03:00:00,1,1,0,FMN GV 16 Berchem TOT
54,Posthofbrug 5366,2020-12-29,04:00:00,5,4,1,FMN GV 16 Berchem TOT
54,Posthofbrug 5366,2020-12-29,05:00:00,19,12,7,FMN GV 16 Berchem TOT
54,Posthofbrug 5366,2020-12-29,06:00:00,31,23,8,FMN GV 16 Berchem TOT
54,Posthofbrug 5366,2020-12-29,07:00:00,61,49,12,FMN GV 16 Berchem TOT
54,Posthofbrug 5366,2020-12-29,08:00:00,93,69,24,FMN GV 16 Berchem TOT
54,Posthofbrug 5366,2020-12-29,09:00:00,94,64,30,FMN GV 16 Berchem TOT
54,Posthofbrug 5366,2020-12-29,10:00:00,82,54,28,FMN GV 16 Berchem TOT
54,Posthofbrug 5366,2020-12-29,11:00:00,69,37,32,FMN GV 16 Berchem TOT
54,Posthofbrug 5366,2020-12-29,12:00:00,91,53,38,FMN GV 16 Berchem TOT
54,Posthofbrug 5366,2020-12-29,13:00:00,109,64,45,FMN GV 16 Berchem TOT
54,Posthofbrug 5366,2020-12-29,14:00:00,128,77,51,FMN GV 16 Berchem TOT
54,Posthofbrug 5366,2020-12-29,15:00:00,128,46,82,FMN GV 16 Berchem TOT
54,Posthofbrug 5366,2020-12-29,16:00:00,171,66,105,FMN GV 16 Berchem TOT
54,Posthofbrug 5366,2020-12-29,17:00:00,128,44,84,FMN GV 16 Berchem TOT
54,Posthofbrug 5366,2020-12-29,18:00:00,97,33,64,FMN GV 16 Berchem TOT
54,Posthofbrug 5366,2020-12-29,19:00:00,62,29,33,FMN GV 16 Berchem TOT
54,Posthofbrug 5366,2020-12-29,20:00:00,43,24,19,FMN GV 16 Berchem TOT
54,Posthofbrug 5366,2020-12-29,21:00:00,24,10,14,FMN GV 16 Berchem TOT
54,Posthofbrug 5366,2020-12-29,22:00:00,18,7,11,FMN GV 16 Berchem TOT
54,Posthofbrug 5366,2020-12-29,23:00:00,30,11,19,FMN GV 16 Berchem TOT
54,Posthofbrug 5366,2020-12-30,00:00:00,2,1,1,FMN GV 16 Berchem TOT
54,Posthofbrug 5366,2020-12-30,01:00:00,0,0,0,FMN GV 16 Berchem TOT
54,Posthofbrug 5366,2020-12-30,02:00:00,1,1,0,FMN GV 16 Berchem TOT
54,Posthofbrug 5366,2020-12-30,03:00:00,0,0,0,FMN GV 16 Berchem TOT
54,Posthofbrug 5366,2020-12-30,04:00:00,7,5,2,FMN GV 16 Berchem TOT
54,Posthofbrug 5366,2020-12-30,05:00:00,13,10,3,FMN GV 16 Berchem TOT
54,Posthofbrug 5366,2020-12-30,06:00:00,33,24,9,FMN GV 16 Berchem TOT
54,Posthofbrug 5366,2020-12-30,07:00:00,61,42,19,FMN GV 16 Berchem TOT
54,Posthofbrug 5366,2020-12-30,08:00:00,101,73,28,FMN GV 16 Berchem TOT
54,Posthofbrug 5366,2020-12-30,09:00:00,72,53,19,FMN GV 16 Berchem TOT
54,Posthofbrug 5366,2020-12-30,10:00:00,69,30,39,FMN GV 16 Berchem TOT
54,Posthofbrug 5366,2020-12-30,11:00:00,86,54,32,FMN GV 16 Berchem TOT
54,Posthofbrug 5366,2020-12-30,12:00:00,82,50,32,FMN GV 16 Berchem TOT
54,Posthofbrug 5366,2020-12-30,13:00:00,129,79,50,FMN GV 16 Berchem TOT
54,Posthofbrug 5366,2020-12-30,14:00:00,126,65,61,FMN GV 16 Berchem TOT
54,Posthofbrug 5366,2020-12-30,15:00:00,134,63,71,FMN GV 16 Berchem TOT
54,Posthofbrug 5366,2020-12-30,16:00:00,130,48,82,FMN GV 16 Berchem TOT
54,Posthofbrug 5366,2020-12-30,17:00:00,159,67,92,FMN GV 16 Berchem TOT
54,Posthofbrug 5366,2020-12-30,18:00:00,88,28,60,FMN GV 16 Berchem TOT
54,Posthofbrug 5366,2020-12-30,19:00:00,64,32,32,FMN GV 16 Berchem TOT
54,Posthofbrug 5366,2020-12-30,20:00:00,52,26,26,FMN GV 16 Berchem TOT
54,Posthofbrug 5366,2020-12-30,21:00:00,15,8,7,FMN GV 16 Berchem TOT
54,Posthofbrug 5366,2020-12-30,22:00:00,30,14,16,FMN GV 16 Berchem TOT
54,Posthofbrug 5366,2020-12-30,23:00:00,30,15,15,FMN GV 16 Berchem TOT
54,Posthofbrug 5366,2020-12-31,00:00:00,2,1,1,FMN GV 16 Berchem TOT
54,Posthofbrug 5366,2020-12-31,01:00:00,0,0,0,FMN GV 16 Berchem TOT
54,Posthofbrug 5366,2020-12-31,02:00:00,1,1,0,FMN GV 16 Berchem TOT
54,Posthofbrug 5366,2020-12-31,03:00:00,0,0,0,FMN GV 16 Berchem TOT
54,Posthofbrug 5366,2020-12-31,04:00:00,6,4,2,FMN GV 16 Berchem TOT
54,Posthofbrug 5366,2020-12-31,05:00:00,8,6,2,FMN GV 16 Berchem TOT
54,Posthofbrug 5366,2020-12-31,06:00:00,17,11,6,FMN GV 16 Berchem TOT
54,Posthofbrug 5366,2020-12-31,07:00:00,44,30,14,FMN GV 16 Berchem TOT
54,Posthofbrug 5366,2020-12-31,08:00:00,64,45,19,FMN GV 16 Berchem TOT
54,Posthofbrug 5366,2020-12-31,09:00:00,58,46,12,FMN GV 16 Berchem TOT
54,Posthofbrug 5366,2020-12-31,10:00:00,66,40,26,FMN GV 16 Berchem TOT
54,Posthofbrug 5366,2020-12-31,11:00:00,76,47,29,FMN GV 16 Berchem TOT
54,Posthofbrug 5366,2020-12-31,12:00:00,94,48,46,FMN GV 16 Berchem TOT
54,Posthofbrug 5366,2020-12-31,13:00:00,91,54,37,FMN GV 16 Berchem TOT
54,Posthofbrug 5366,2020-12-31,14:00:00,114,50,64,FMN GV 16 Berchem TOT
54,Posthofbrug 5366,2020-12-31,15:00:00,149,59,90,FMN GV 16 Berchem TOT
54,Posthofbrug 5366,2020-12-31,16:00:00,112,50,62,FMN GV 16 Berchem TOT
54,Posthofbrug 5366,2020-12-31,17:00:00,97,48,49,FMN GV 16 Berchem TOT
54,Posthofbrug 5366,2020-12-31,18:00:00,69,36,33,FMN GV 16 Berchem TOT
54,Posthofbrug 5366,2020-12-31,19:00:00,26,15,11,FMN GV 16 Berchem TOT
54,Posthofbrug 5366,2020-12-31,20:00:00,34,9,25,FMN GV 16 Berchem TOT
54,Posthofbrug 5366,2020-12-31,21:00:00,17,12,5,FMN GV 16 Berchem TOT
54,Posthofbrug 5366,2020-12-31,22:00:00,22,15,7,FMN GV 16 Berchem TOT
54,Posthofbrug 5366,2020-12-31,23:00:00,38,18,20,FMN GV 16 Berchem TOT
54,Posthofbrug 5366,2021-01-01,00:00:00,5,4,1,FMN GV 16 Berchem TOT
54,Posthofbrug 5366,2021-01-01,01:00:00,4,2,2,FMN GV 16 Berchem TOT
54,Posthofbrug 5366,2021-01-01,02:00:00,3,2,1,FMN GV 16 Berchem TOT
54,Posthofbrug 5366,2021-01-01,03:00:00,0,0,0,FMN GV 16 Berchem TOT
54,Posthofbrug 5366,2021-01-01,04:00:00,3,3,0,FMN GV 16 Berchem TOT
54,Posthofbrug 5366,2021-01-01,05:00:00,12,7,5,FMN GV 16 Berchem TOT
54,Posthofbrug 5366,2021-01-01,06:00:00,22,12,10,FMN GV 16 Berchem TOT
54,Posthofbrug 5366,2021-01-01,07:00:00,13,9,4,FMN GV 16 Berchem TOT
54,Posthofbrug 5366,2021-01-01,08:00:00,3,0,3,FMN GV 16 Berchem TOT
54,Posthofbrug 5366,2021-01-01,09:00:00,10,5,5,FMN GV 16 Berchem TOT
54,Posthofbrug 5366,2021-01-01,10:00:00,20,8,12,FMN GV 16 Berchem TOT
54,Posthofbrug 5366,2021-01-01,11:00:00,37,19,18,FMN GV 16 Berchem TOT
54,Posthofbrug 5366,2021-01-01,12:00:00,55,29,26,FMN GV 16 Berchem TOT
54,Posthofbrug 5366,2021-01-01,13:00:00,87,54,33,FMN GV 16 Berchem TOT
54,Posthofbrug 5366,2021-01-01,14:00:00,91,44,47,FMN GV 16 Berchem TOT
54,Posthofbrug 5366,2021-01-01,15:00:00,91,41,50,FMN GV 16 Berchem TOT
54,Posthofbrug 5366,2021-01-01,16:00:00,82,41,41,FMN GV 16 Berchem TOT
54,Posthofbrug 5366,2021-01-01,17:00:00,60,40,20,FMN GV 16 Berchem TOT
54,Posthofbrug 5366,2021-01-01,18:00:00,39,15,24,FMN GV 16 Berchem TOT
54,Posthofbrug 5366,2021-01-01,19:00:00,31,10,21,FMN GV 16 Berchem TOT
54,Posthofbrug 5366,2021-01-01,20:00:00,37,21,16,FMN GV 16 Berchem TOT
54,Posthofbrug 5366,2021-01-01,21:00:00,21,13,8,FMN GV 16 Berchem TOT
54,Posthofbrug 5366,2021-01-01,22:00:00,27,16,11,FMN GV 16 Berchem TOT
54,Posthofbrug 5366,2021-01-01,23:00:00,24,16,8,FMN GV 16 Berchem TOT
54,Posthofbrug 5366,2021-01-02,00:00:00,2,0,2,FMN GV 16 Berchem TOT
54,Posthofbrug 5366,2021-01-02,01:00:00,0,0,0,FMN GV 16 Berchem TOT
54,Posthofbrug 5366,2021-01-02,02:00:00,2,0,2,FMN GV 16 Berchem TOT
54,Posthofbrug 5366,2021-01-02,03:00:00,0,0,0,FMN GV 16 Berchem TOT
54,Posthofbrug 5366,2021-01-02,04:00:00,1,1,0,FMN GV 16 Berchem TOT
54,Posthofbrug 5366,2021-01-02,05:00:00,5,3,2,FMN GV 16 Berchem TOT
54,Posthofbrug 5366,2021-01-02,06:00:00,17,13,4,FMN GV 16 Berchem TOT
54,Posthofbrug 5366,2021-01-02,07:00:00,11,9,2,FMN GV 16 Berchem TOT
54,Posthofbrug 5366,2021-01-02,08:00:00,17,14,3,FMN GV 16 Berchem TOT
54,Posthofbrug 5366,2021-01-02,09:00:00,45,26,19,FMN GV 16 Berchem TOT
54,Posthofbrug 5366,2021-01-02,10:00:00,81,52,29,FMN GV 16 Berchem TOT
54,Posthofbrug 5366,2021-01-02,11:00:00,107,61,46,FMN GV 16 Berchem TOT
54,Posthofbrug 5366,2021-01-02,12:00:00,105,60,45,FMN GV 16 Berchem TOT
54,Posthofbrug 5366,2021-01-02,13:00:00,117,61,56,FMN GV 16 Berchem TOT
54,Posthofbrug 5366,2021-01-02,14:00:00,131,82,49,FMN GV 16 Berchem TOT
54,Posthofbrug 5366,2021-01-02,15:00:00,131,63,68,FMN GV 16 Berchem TOT
54,Posthofbrug 5366,2021-01-02,16:00:00,118,57,61,FMN GV 16 Berchem TOT
54,Posthofbrug 5366,2021-01-02,17:00:00,82,49,33,FMN GV 16 Berchem TOT
54,Posthofbrug 5366,2021-01-02,18:00:00,93,39,54,FMN GV 16 Berchem TOT
54,Posthofbrug 5366,2021-01-02,19:00:00,45,14,31,FMN GV 16 Berchem TOT
54,Posthofbrug 5366,2021-01-02,20:00:00,22,8,14,FMN GV 16 Berchem TOT
54,Posthofbrug 5366,2021-01-02,21:00:00,28,16,12,FMN GV 16 Berchem TOT
54,Posthofbrug 5366,2021-01-02,22:00:00,29,18,11,FMN GV 16 Berchem TOT
54,Posthofbrug 5366,2021-01-02,23:00:00,29,12,17,FMN GV 16 Berchem TOT
54,Posthofbrug 5366,2021-01-03,00:00:00,1,1,0,FMN GV 16 Berchem TOT
54,Posthofbrug 5366,2021-01-03,01:00:00,0,0,0,FMN GV 16 Berchem TOT
54,Posthofbrug 5366,2021-01-03,02:00:00,1,0,1,FMN GV 16 Berchem TOT
54,Posthofbrug 5366,2021-01-03,03:00:00,1,1,0,FMN GV 16 Berchem TOT
54,Posthofbrug 5366,2021-01-03,04:00:00,1,1,0,FMN GV 16 Berchem TOT
54,Posthofbrug 5366,2021-01-03,05:00:00,6,5,1,FMN GV 16 Berchem TOT
54,Posthofbrug 5366,2021-01-03,06:00:00,14,11,3,FMN GV 16 Berchem TOT
54,Posthofbrug 5366,2021-01-03,07:00:00,17,7,10,FMN GV 16 Berchem TOT
54,Posthofbrug 5366,2021-01-03,08:00:00,21,8,13,FMN GV 16 Berchem TOT
54,Posthofbrug 5366,2021-01-03,09:00:00,42,25,17,FMN GV 16 Berchem TOT
54,Posthofbrug 5366,2021-01-03,10:00:00,59,32,27,FMN GV 16 Berchem TOT
54,Posthofbrug 5366,2021-01-03,11:00:00,77,50,27,FMN GV 16 Berchem TOT
54,Posthofbrug 5366,2021-01-03,12:00:00,121,79,42,FMN GV 16 Berchem TOT
54,Posthofbrug 5366,2021-01-03,13:00:00,105,56,49,FMN GV 16 Berchem TOT
54,Posthofbrug 5366,2021-01-03,14:00:00,124,67,57,FMN GV 16 Berchem TOT
54,Posthofbrug 5366,2021-01-03,15:00:00,100,37,63,FMN GV 16 Berchem TOT
54,Posthofbrug 5366,2021-01-03,16:00:00,113,45,68,FMN GV 16 Berchem TOT
54,Posthofbrug 5366,2021-01-03,17:00:00,67,29,38,FMN GV 16 Berchem TOT
54,Posthofbrug 5366,2021-01-03,18:00:00,65,29,36,FMN GV 16 Berchem TOT
54,Posthofbrug 5366,2021-01-03,19:00:00,27,12,15,FMN GV 16 Berchem TOT
54,Posthofbrug 5366,2021-01-03,20:00:00,32,17,15,FMN GV 16 Berchem TOT
54,Posthofbrug 5366,2021-01-03,21:00:00,19,11,8,FMN GV 16 Berchem TOT
54,Posthofbrug 5366,2021-01-03,22:00:00,18,10,8,FMN GV 16 Berchem TOT
54,Posthofbrug 5366,2021-01-03,23:00:00,13,7,6,FMN GV 16 Berchem TOT
54,Posthofbrug 5366,2021-01-04,00:00:00,3,0,3,FMN GV 16 Berchem TOT
54,Posthofbrug 5366,2021-01-04,01:00:00,0,0,0,FMN GV 16 Berchem TOT
54,Posthofbrug 5366,2021-01-04,02:00:00,0,0,0,FMN GV 16 Berchem TOT
54,Posthofbrug 5366,2021-01-04,03:00:00,1,1,0,FMN GV 16 Berchem TOT
54,Posthofbrug 5366,2021-01-04,04:00:00,5,4,1,FMN GV 16 Berchem TOT
54,Posthofbrug 5366,2021-01-04,05:00:00,15,11,4,FMN GV 16 Berchem TOT
54,Posthofbrug 5366,2021-01-04,06:00:00,71,59,12,FMN GV 16 Berchem TOT
54,Posthofbrug 5366,2021-01-04,07:00:00,234,178,56,FMN GV 16 Berchem TOT
54,Posthofbrug 5366,2021-01-04,08:00:00,313,239,74,FMN GV 16 Berchem TOT
54,Posthofbrug 5366,2021-01-04,09:00:00,104,71,33,FMN GV 16 Berchem TOT
54,Posthofbrug 5366,2021-01-04,10:00:00,58,42,16,FMN GV 16 Berchem TOT
54,Posthofbrug 5366,2021-01-04,11:00:00,55,27,28,FMN GV 16 Berchem TOT
54,Posthofbrug 5366,2021-01-04,12:00:00,97,47,50,FMN GV 16 Berchem TOT
54,Posthofbrug 5366,2021-01-04,13:00:00,79,34,45,FMN GV 16 Berchem TOT
54,Posthofbrug 5366,2021-01-04,14:00:00,106,51,55,FMN GV 16 Berchem TOT
54,Posthofbrug 5366,2021-01-04,15:00:00,145,53,92,FMN GV 16 Berchem TOT
54,Posthofbrug 5366,2021-01-04,16:00:00,214,52,162,FMN GV 16 Berchem TOT
54,Posthofbrug 5366,2021-01-04,17:00:00,221,78,143,FMN GV 16 Berchem TOT
54,Posthofbrug 5366,2021-01-04,18:00:00,127,39,88,FMN GV 16 Berchem TOT
54,Posthofbrug 5366,2021-01-04,19:00:00,60,28,32,FMN GV 16 Berchem TOT
54,Posthofbrug 5366,2021-01-04,20:00:00,31,19,12,FMN GV 16 Berchem TOT
54,Posthofbrug 5366,2021-01-04,21:00:00,21,9,12,FMN GV 16 Berchem TOT
54,Posthofbrug 5366,2021-01-04,22:00:00,20,9,11,FMN GV 16 Berchem TOT
54,Posthofbrug 5366,2021-01-04,23:00:00,13,3,10,FMN GV 16 Berchem TOT
54,Posthofbrug 5366,2021-01-05,00:00:00,1,1,0,FMN GV 16 Berchem TOT
54,Posthofbrug 5366,2021-01-05,01:00:00,1,0,1,FMN GV 16 Berchem TOT
54,Posthofbrug 5366,2021-01-05,02:00:00,0,0,0,FMN GV 16 Berchem TOT
54,Posthofbrug 5366,2021-01-05,03:00:00,0,0,0,FMN GV 16 Berchem TOT
54,Posthofbrug 5366,2021-01-05,04:00:00,10,8,2,FMN GV 16 Berchem TOT
54,Posthofbrug 5366,2021-01-05,05:00:00,21,13,8,FMN GV 16 Berchem TOT
54,Posthofbrug 5366,2021-01-05,06:00:00,75,64,11,FMN GV 16 Berchem TOT
54,Posthofbrug 5366,2021-01-05,07:00:00,242,177,65,FMN GV 16 Berchem TOT
54,Posthofbrug 5366,2021-01-05,08:00:00,336,256,80,FMN GV 16 Berchem TOT
54,Posthofbrug 5366,2021-01-05,09:00:00,131,108,23,FMN GV 16 Berchem TOT
54,Posthofbrug 5366,2021-01-05,10:00:00,80,55,25,FMN GV 16 Berchem TOT
54,Posthofbrug 5366,2021-01-05,11:00:00,77,39,38,FMN GV 16 Berchem TOT
54,Posthofbrug 5366,2021-01-05,12:00:00,120,67,53,FMN GV 16 Berchem TOT
54,Posthofbrug 5366,2021-01-05,13:00:00,96,50,46,FMN GV 16 Berchem TOT
54,Posthofbrug 5366,2021-01-05,14:00:00,110,47,63,FMN GV 16 Berchem TOT
54,Posthofbrug 5366,2021-01-05,15:00:00,176,76,100,FMN GV 16 Berchem TOT
54,Posthofbrug 5366,2021-01-05,16:00:00,250,77,173,FMN GV 16 Berchem TOT
54,Posthofbrug 5366,2021-01-05,17:00:00,270,74,196,FMN GV 16 Berchem TOT
54,Posthofbrug 5366,2021-01-05,18:00:00,151,52,99,FMN GV 16 Berchem TOT
54,Posthofbrug 5366,2021-01-05,19:00:00,66,18,48,FMN GV 16 Berchem TOT
54,Posthofbrug 5366,2021-01-05,20:00:00,39,19,20,FMN GV 16 Berchem TOT
54,Posthofbrug 5366,2021-01-05,21:00:00,28,17,11,FMN GV 16 Berchem TOT
54,Posthofbrug 5366,2021-01-05,22:00:00,36,13,23,FMN GV 16 Berchem TOT
54,Posthofbrug 5366,2021-01-05,23:00:00,15,7,8,FMN GV 16 Berchem TOT
54,Posthofbrug 5366,2021-01-06,00:00:00,4,0,4,FMN GV 16 Berchem TOT
54,Posthofbrug 5366,2021-01-06,01:00:00,1,1,0,FMN GV 16 Berchem TOT
54,Posthofbrug 5366,2021-01-06,02:00:00,0,0,0,FMN GV 16 Berchem TOT
54,Posthofbrug 5366,2021-01-06,03:00:00,1,1,0,FMN GV 16 Berchem TOT
54,Posthofbrug 5366,2021-01-06,04:00:00,10,7,3,FMN GV 16 Berchem TOT
54,Posthofbrug 5366,2021-01-06,05:00:00,19,13,6,FMN GV 16 Berchem TOT
54,Posthofbrug 5366,2021-01-06,06:00:00,65,53,12,FMN GV 16 Berchem TOT
54,Posthofbrug 5366,2021-01-06,07:00:00,223,162,61,FMN GV 16 Berchem TOT
54,Posthofbrug 5366,2021-01-06,08:00:00,298,235,63,FMN GV 16 Berchem TOT
54,Posthofbrug 5366,2021-01-06,09:00:00,96,62,34,FMN GV 16 Berchem TOT
54,Posthofbrug 5366,2021-01-06,10:00:00,68,46,22,FMN GV 16 Berchem TOT
54,Posthofbrug 5366,2021-01-06,11:00:00,87,36,51,FMN GV 16 Berchem TOT
54,Posthofbrug 5366,2021-01-06,12:00:00,183,65,118,FMN GV 16 Berchem TOT
54,Posthofbrug 5366,2021-01-06,13:00:00,147,67,80,FMN GV 16 Berchem TOT
54,Posthofbrug 5366,2021-01-06,14:00:00,111,50,61,FMN GV 16 Berchem TOT
54,Posthofbrug 5366,2021-01-06,15:00:00,131,49,82,FMN GV 16 Berchem TOT
54,Posthofbrug 5366,2021-01-06,16:00:00,172,63,109,FMN GV 16 Berchem TOT
54,Posthofbrug 5366,2021-01-06,17:00:00,226,79,147,FMN GV 16 Berchem TOT
54,Posthofbrug 5366,2021-01-06,18:00:00,140,51,89,FMN GV 16 Berchem TOT
54,Posthofbrug 5366,2021-01-06,19:00:00,73,35,38,FMN GV 16 Berchem TOT
54,Posthofbrug 5366,2021-01-06,20:00:00,46,30,16,FMN GV 16 Berchem TOT
54,Posthofbrug 5366,2021-01-06,21:00:00,14,7,7,FMN GV 16 Berchem TOT
54,Posthofbrug 5366,2021-01-06,22:00:00,41,20,21,FMN GV 16 Berchem TOT
54,Posthofbrug 5366,2021-01-06,23:00:00,20,11,9,FMN GV 16 Berchem TOT
54,Posthofbrug 5366,2021-01-07,00:00:00,5,2,3,FMN GV 16 Berchem TOT
54,Posthofbrug 5366,2021-01-07,01:00:00,1,0,1,FMN GV 16 Berchem TOT
54,Posthofbrug 5366,2021-01-07,02:00:00,2,0,2,FMN GV 16 Berchem TOT
54,Posthofbrug 5366,2021-01-07,03:00:00,2,2,0,FMN GV 16 Berchem TOT
54,Posthofbrug 5366,2021-01-07,04:00:00,8,6,2,FMN GV 16 Berchem TOT
54,Posthofbrug 5366,2021-01-07,05:00:00,12,8,4,FMN GV 16 Berchem TOT
54,Posthofbrug 5366,2021-01-07,06:00:00,56,45,11,FMN GV 16 Berchem TOT
54,Posthofbrug 5366,2021-01-07,07:00:00,182,129,53,FMN GV 16 Berchem TOT
54,Posthofbrug 5366,2021-01-07,08:00:00,257,202,55,FMN GV 16 Berchem TOT
54,Posthofbrug 5366,2021-01-07,09:00:00,106,75,31,FMN GV 16 Berchem TOT
54,Posthofbrug 5366,2021-01-07,10:00:00,59,36,23,FMN GV 16 Berchem TOT
54,Posthofbrug 5366,2021-01-07,11:00:00,54,28,26,FMN GV 16 Berchem TOT
54,Posthofbrug 5366,2021-01-07,12:00:00,101,49,52,FMN GV 16 Berchem TOT
54,Posthofbrug 5366,2021-01-07,13:00:00,87,48,39,FMN GV 16 Berchem TOT
54,Posthofbrug 5366,2021-01-07,14:00:00,66,31,35,FMN GV 16 Berchem TOT
54,Posthofbrug 5366,2021-01-07,15:00:00,115,44,71,FMN GV 16 Berchem TOT
54,Posthofbrug 5366,2021-01-07,16:00:00,186,61,125,FMN GV 16 Berchem TOT
54,Posthofbrug 5366,2021-01-07,17:00:00,215,65,150,FMN GV 16 Berchem TOT
54,Posthofbrug 5366,2021-01-07,18:00:00,135,46,89,FMN GV 16 Berchem TOT
54,Posthofbrug 5366,2021-01-07,19:00:00,68,27,41,FMN GV 16 Berchem TOT
54,Posthofbrug 5366,2021-01-07,20:00:00,39,23,16,FMN GV 16 Berchem TOT
54,Posthofbrug 5366,2021-01-07,21:00:00,19,9,10,FMN GV 16 Berchem TOT
54,Posthofbrug 5366,2021-01-07,22:00:00,32,15,17,FMN GV 16 Berchem TOT
54,Posthofbrug 5366,2021-01-07,23:00:00,18,7,11,FMN GV 16 Berchem TOT
54,Posthofbrug 5366,2021-01-08,00:00:00,2,0,2,FMN GV 16 Berchem TOT
54,Posthofbrug 5366,2021-01-08,01:00:00,1,0,1,FMN GV 16 Berchem TOT
54,Posthofbrug 5366,2021-01-08,02:00:00,2,0,2,FMN GV 16 Berchem TOT
54,Posthofbrug 5366,2021-01-08,03:00:00,1,1,0,FMN GV 16 Berchem TOT
54,Posthofbrug 5366,2021-01-08,04:00:00,10,7,3,FMN GV 16 Berchem TOT
54,Posthofbrug 5366,2021-01-08,05:00:00,11,5,6,FMN GV 16 Berchem TOT
54,Posthofbrug 5366,2021-01-08,06:00:00,49,38,11,FMN GV 16 Berchem TOT
54,Posthofbrug 5366,2021-01-08,07:00:00,157,110,47,FMN GV 16 Berchem TOT
54,Posthofbrug 5366,2021-01-08,08:00:00,279,202,77,FMN GV 16 Berchem TOT
54,Posthofbrug 5366,2021-01-08,09:00:00,101,75,26,FMN GV 16 Berchem TOT
54,Posthofbrug 5366,2021-01-08,10:00:00,56,35,21,FMN GV 16 Berchem TOT
54,Posthofbrug 5366,2021-01-08,11:00:00,58,28,30,FMN GV 16 Berchem TOT
54,Posthofbrug 5366,2021-01-08,12:00:00,108,56,52,FMN GV 16 Berchem TOT
54,Posthofbrug 5366,2021-01-08,13:00:00,118,61,57,FMN GV 16 Berchem TOT
54,Posthofbrug 5366,2021-01-08,14:00:00,87,39,48,FMN GV 16 Berchem TOT
54,Posthofbrug 5366,2021-01-08,15:00:00,132,56,76,FMN GV 16 Berchem TOT
54,Posthofbrug 5366,2021-01-08,16:00:00,181,58,123,FMN GV 16 Berchem TOT
54,Posthofbrug 5366,2021-01-08,17:00:00,201,76,125,FMN GV 16 Berchem TOT
54,Posthofbrug 5366,2021-01-08,18:00:00,145,48,97,FMN GV 16 Berchem TOT
54,Posthofbrug 5366,2021-01-08,19:00:00,63,26,37,FMN GV 16 Berchem TOT
54,Posthofbrug 5366,2021-01-08,20:00:00,43,25,18,FMN GV 16 Berchem TOT
54,Posthofbrug 5366,2021-01-08,21:00:00,36,14,22,FMN GV 16 Berchem TOT
54,Posthofbrug 5366,2021-01-08,22:00:00,35,15,20,FMN GV 16 Berchem TOT
54,Posthofbrug 5366,2021-01-08,23:00:00,35,16,19,FMN GV 16 Berchem TOT
54,Posthofbrug 5366,2021-01-09,00:00:00,10,3,7,FMN GV 16 Berchem TOT
54,Posthofbrug 5366,2021-01-09,01:00:00,2,0,2,FMN GV 16 Berchem TOT
54,Posthofbrug 5366,2021-01-09,02:00:00,1,0,1,FMN GV 16 Berchem TOT
54,Posthofbrug 5366,2021-01-09,03:00:00,0,0,0,FMN GV 16 Berchem TOT
54,Posthofbrug 5366,2021-01-09,04:00:00,3,2,1,FMN GV 16 Berchem TOT
54,Posthofbrug 5366,2021-01-09,05:00:00,7,5,2,FMN GV 16 Berchem TOT
54,Posthofbrug 5366,2021-01-09,06:00:00,13,9,4,FMN GV 16 Berchem TOT
54,Posthofbrug 5366,2021-01-09,07:00:00,10,4,6,FMN GV 16 Berchem TOT
54,Posthofbrug 5366,2021-01-09,08:00:00,29,15,14,FMN GV 16 Berchem TOT
54,Posthofbrug 5366,2021-01-09,09:00:00,72,39,33,FMN GV 16 Berchem TOT
54,Posthofbrug 5366,2021-01-09,10:00:00,61,42,19,FMN GV 16 Berchem TOT
54,Posthofbrug 5366,2021-01-09,11:00:00,92,57,35,FMN GV 16 Berchem TOT
54,Posthofbrug 5366,2021-01-09,12:00:00,106,53,53,FMN GV 16 Berchem TOT
54,Posthofbrug 5366,2021-01-09,13:00:00,152,85,67,FMN GV 16 Berchem TOT
54,Posthofbrug 5366,2021-01-09,14:00:00,142,95,47,FMN GV 16 Berchem TOT
54,Posthofbrug 5366,2021-01-09,15:00:00,140,67,73,FMN GV 16 Berchem TOT
54,Posthofbrug 5366,2021-01-09,16:00:00,112,52,60,FMN GV 16 Berchem TOT
54,Posthofbrug 5366,2021-01-09,17:00:00,72,30,42,FMN GV 16 Berchem TOT
54,Posthofbrug 5366,2021-01-09,18:00:00,86,50,36,FMN GV 16 Berchem TOT
54,Posthofbrug 5366,2021-01-09,19:00:00,59,22,37,FMN GV 16 Berchem TOT
54,Posthofbrug 5366,2021-01-09,20:00:00,35,13,22,FMN GV 16 Berchem TOT
54,Posthofbrug 5366,2021-01-09,21:00:00,15,5,10,FMN GV 16 Berchem TOT
54,Posthofbrug 5366,2021-01-09,22:00:00,33,15,18,FMN GV 16 Berchem TOT
54,Posthofbrug 5366,2021-01-09,23:00:00,37,18,19,FMN GV 16 Berchem TOT
54,Posthofbrug 5366,2021-01-10,00:00:00,9,6,3,FMN GV 16 Berchem TOT
54,Posthofbrug 5366,2021-01-10,01:00:00,1,1,0,FMN GV 16 Berchem TOT
54,Posthofbrug 5366,2021-01-10,02:00:00,1,0,1,FMN GV 16 Berchem TOT
54,Posthofbrug 5366,2021-01-10,03:00:00,2,1,1,FMN GV 16 Berchem TOT
54,Posthofbrug 5366,2021-01-10,04:00:00,0,0,0,FMN GV 16 Berchem TOT
54,Posthofbrug 5366,2021-01-10,05:00:00,3,2,1,FMN GV 16 Berchem TOT
54,Posthofbrug 5366,2021-01-10,06:00:00,8,5,3,FMN GV 16 Berchem TOT
54,Posthofbrug 5366,2021-01-10,07:00:00,8,5,3,FMN GV 16 Berchem TOT
54,Posthofbrug 5366,2021-01-10,08:00:00,23,12,11,FMN GV 16 Berchem TOT
54,Posthofbrug 5366,2021-01-10,09:00:00,53,31,22,FMN GV 16 Berchem TOT
54,Posthofbrug 5366,2021-01-10,10:00:00,47,31,16,FMN GV 16 Berchem TOT
54,Posthofbrug 5366,2021-01-10,11:00:00,72,35,37,FMN GV 16 Berchem TOT
54,Posthofbrug 5366,2021-01-10,12:00:00,107,55,52,FMN GV 16 Berchem TOT
54,Posthofbrug 5366,2021-01-10,13:00:00,124,61,63,FMN GV 16 Berchem TOT
54,Posthofbrug 5366,2021-01-10,14:00:00,141,72,69,FMN GV 16 Berchem TOT
54,Posthofbrug 5366,2021-01-10,15:00:00,101,57,44,FMN GV 16 Berchem TOT
54,Posthofbrug 5366,2021-01-10,16:00:00,83,50,33,FMN GV 16 Berchem TOT
54,Posthofbrug 5366,2021-01-10,17:00:00,86,39,47,FMN GV 16 Berchem TOT
54,Posthofbrug 5366,2021-01-10,18:00:00,59,27,32,FMN GV 16 Berchem TOT
54,Posthofbrug 5366,2021-01-10,19:00:00,36,16,20,FMN GV 16 Berchem TOT
54,Posthofbrug 5366,2021-01-10,20:00:00,31,15,16,FMN GV 16 Berchem TOT
54,Posthofbrug 5366,2021-01-10,21:00:00,19,6,13,FMN GV 16 Berchem TOT
54,Posthofbrug 5366,2021-01-10,22:00:00,20,13,7,FMN GV 16 Berchem TOT
54,Posthofbrug 5366,2021-01-10,23:00:00,13,6,7,FMN GV 16 Berchem TOT
54,Posthofbrug 5366,2021-01-11,00:00:00,4,2,2,FMN GV 16 Berchem TOT
54,Posthofbrug 5366,2021-01-11,01:00:00,0,0,0,FMN GV 16 Berchem TOT
54,Posthofbrug 5366,2021-01-11,02:00:00,0,0,0,FMN GV 16 Berchem TOT
54,Posthofbrug 5366,2021-01-11,03:00:00,0,0,0,FMN GV 16 Berchem TOT
54,Posthofbrug 5366,2021-01-11,04:00:00,5,4,1,FMN GV 16 Berchem TOT
54,Posthofbrug 5366,2021-01-11,05:00:00,16,10,6,FMN GV 16 Berchem TOT
54,Posthofbrug 5366,2021-01-11,06:00:00,56,49,7,FMN GV 16 Berchem TOT
54,Posthofbrug 5366,2021-01-11,07:00:00,242,177,65,FMN GV 16 Berchem TOT
54,Posthofbrug 5366,2021-01-11,08:00:00,338,254,84,FMN GV 16 Berchem TOT
54,Posthofbrug 5366,2021-01-11,09:00:00,119,88,31,FMN GV 16 Berchem TOT
54,Posthofbrug 5366,2021-01-11,10:00:00,60,37,23,FMN GV 16 Berchem TOT
54,Posthofbrug 5366,2021-01-11,11:00:00,75,39,36,FMN GV 16 Berchem TOT
54,Posthofbrug 5366,2021-01-11,12:00:00,120,51,69,FMN GV 16 Berchem TOT
54,Posthofbrug 5366,2021-01-11,13:00:00,85,48,37,FMN GV 16 Berchem TOT
54,Posthofbrug 5366,2021-01-11,14:00:00,92,51,41,FMN GV 16 Berchem TOT
54,Posthofbrug 5366,2021-01-11,15:00:00,172,58,114,FMN GV 16 Berchem TOT
54,Posthofbrug 5366,2021-01-11,16:00:00,273,78,195,FMN GV 16 Berchem TOT
54,Posthofbrug 5366,2021-01-11,17:00:00,227,74,153,FMN GV 16 Berchem TOT
54,Posthofbrug 5366,2021-01-11,18:00:00,142,49,93,FMN GV 16 Berchem TOT
54,Posthofbrug 5366,2021-01-11,19:00:00,68,23,45,FMN GV 16 Berchem TOT
54,Posthofbrug 5366,2021-01-11,20:00:00,32,15,17,FMN GV 16 Berchem TOT
54,Posthofbrug 5366,2021-01-11,21:00:00,30,16,14,FMN GV 16 Berchem TOT
54,Posthofbrug 5366,2021-01-11,22:00:00,26,10,16,FMN GV 16 Berchem TOT
54,Posthofbrug 5366,2021-01-11,23:00:00,17,5,12,FMN GV 16 Berchem TOT
54,Posthofbrug 5366,2021-01-12,00:00:00,1,0,1,FMN GV 16 Berchem TOT
54,Posthofbrug 5366,2021-01-12,01:00:00,0,0,0,FMN GV 16 Berchem TOT
54,Posthofbrug 5366,2021-01-12,02:00:00,0,0,0,FMN GV 16 Berchem TOT
54,Posthofbrug 5366,2021-01-12,03:00:00,1,0,1,FMN GV 16 Berchem TOT
54,Posthofbrug 5366,2021-01-12,04:00:00,9,7,2,FMN GV 16 Berchem TOT
54,Posthofbrug 5366,2021-01-12,05:00:00,16,9,7,FMN GV 16 Berchem TOT
54,Posthofbrug 5366,2021-01-12,06:00:00,47,41,6,FMN GV 16 Berchem TOT
54,Posthofbrug 5366,2021-01-12,07:00:00,160,115,45,FMN GV 16 Berchem TOT
54,Posthofbrug 5366,2021-01-12,08:00:00,252,182,70,FMN GV 16 Berchem TOT
54,Posthofbrug 5366,2021-01-12,09:00:00,87,65,22,FMN GV 16 Berchem TOT
54,Posthofbrug 5366,2021-01-12,10:00:00,52,33,19,FMN GV 16 Berchem TOT
54,Posthofbrug 5366,2021-01-12,11:00:00,61,33,28,FMN GV 16 Berchem TOT
54,Posthofbrug 5366,2021-01-12,12:00:00,77,45,32,FMN GV 16 Berchem TOT
54,Posthofbrug 5366,2021-01-12,13:00:00,88,41,47,FMN GV 16 Berchem TOT
54,Posthofbrug 5366,2021-01-12,14:00:00,86,36,50,FMN GV 16 Berchem TOT
54,Posthofbrug 5366,2021-01-12,15:00:00,130,53,77,FMN GV 16 Berchem TOT
54,Posthofbrug 5366,2021-01-12,16:00:00,212,75,137,FMN GV 16 Berchem TOT
54,Posthofbrug 5366,2021-01-12,17:00:00,228,68,160,FMN GV 16 Berchem TOT
54,Posthofbrug 5366,2021-01-12,18:00:00,121,44,77,FMN GV 16 Berchem TOT
54,Posthofbrug 5366,2021-01-12,19:00:00,85,35,50,FMN GV 16 Berchem TOT
54,Posthofbrug 5366,2021-01-12,20:00:00,37,16,21,FMN GV 16 Berchem TOT
54,Posthofbrug 5366,2021-01-12,21:00:00,29,15,14,FMN GV 16 Berchem TOT
54,Posthofbrug 5366,2021-01-12,22:00:00,38,17,21,FMN GV 16 Berchem TOT
54,Posthofbrug 5366,2021-01-12,23:00:00,19,5,14,FMN GV 16 Berchem TOT
54,Posthofbrug 5366,2021-01-13,00:00:00,2,0,2,FMN GV 16 Berchem TOT
54,Posthofbrug 5366,2021-01-13,01:00:00,0,0,0,FMN GV 16 Berchem TOT
54,Posthofbrug 5366,2021-01-13,02:00:00,0,0,0,FMN GV 16 Berchem TOT
54,Posthofbrug 5366,2021-01-13,03:00:00,3,2,1,FMN GV 16 Berchem TOT
54,Posthofbrug 5366,2021-01-13,04:00:00,8,7,1,FMN GV 16 Berchem TOT
54,Posthofbrug 5366,2021-01-13,05:00:00,14,7,7,FMN GV 16 Berchem TOT
54,Posthofbrug 5366,2021-01-13,06:00:00,60,48,12,FMN GV 16 Berchem TOT
54,Posthofbrug 5366,2021-01-13,07:00:00,188,146,42,FMN GV 16 Berchem TOT
54,Posthofbrug 5366,2021-01-13,08:00:00,293,214,79,FMN GV 16 Berchem TOT
54,Posthofbrug 5366,2021-01-13,09:00:00,111,73,38,FMN GV 16 Berchem TOT
54,Posthofbrug 5366,2021-01-13,10:00:00,65,42,23,FMN GV 16 Berchem TOT
54,Posthofbrug 5366,2021-01-13,11:00:00,108,53,55,FMN GV 16 Berchem TOT
54,Posthofbrug 5366,2021-01-13,12:00:00,174,72,102,FMN GV 16 Berchem TOT
54,Posthofbrug 5366,2021-01-13,13:00:00,133,63,70,FMN GV 16 Berchem TOT
54,Posthofbrug 5366,2021-01-13,14:00:00,100,47,53,FMN GV 16 Berchem TOT
54,Posthofbrug 5366,2021-01-13,15:00:00,155,72,83,FMN GV 16 Berchem TOT
54,Posthofbrug 5366,2021-01-13,16:00:00,180,66,114,FMN GV 16 Berchem TOT
54,Posthofbrug 5366,2021-01-13,17:00:00,269,96,173,FMN GV 16 Berchem TOT
54,Posthofbrug 5366,2021-01-13,18:00:00,172,64,108,FMN GV 16 Berchem TOT
54,Posthofbrug 5366,2021-01-13,19:00:00,55,17,38,FMN GV 16 Berchem TOT
54,Posthofbrug 5366,2021-01-13,20:00:00,53,30,23,FMN GV 16 Berchem TOT
54,Posthofbrug 5366,2021-01-13,21:00:00,25,12,13,FMN GV 16 Berchem TOT
54,Posthofbrug 5366,2021-01-13,22:00:00,35,12,23,FMN GV 16 Berchem TOT
54,Posthofbrug 5366,2021-01-13,23:00:00,18,7,11,FMN GV 16 Berchem TOT
54,Posthofbrug 5366,2021-01-14,00:00:00,3,1,2,FMN GV 16 Berchem TOT
54,Posthofbrug 5366,2021-01-14,01:00:00,0,0,0,FMN GV 16 Berchem TOT
54,Posthofbrug 5366,2021-01-14,02:00:00,1,0,1,FMN GV 16 Berchem TOT
54,Posthofbrug 5366,2021-01-14,03:00:00,0,0,0,FMN GV 16 Berchem TOT
54,Posthofbrug 5366,2021-01-14,04:00:00,6,3,3,FMN GV 16 Berchem TOT
54,Posthofbrug 5366,2021-01-14,05:00:00,17,10,7,FMN GV 16 Berchem TOT
54,Posthofbrug 5366,2021-01-14,06:00:00,50,37,13,FMN GV 16 Berchem TOT
54,Posthofbrug 5366,2021-01-14,07:00:00,184,143,41,FMN GV 16 Berchem TOT
54,Posthofbrug 5366,2021-01-14,08:00:00,275,205,70,FMN GV 16 Berchem TOT
54,Posthofbrug 5366,2021-01-14,09:00:00,110,87,23,FMN GV 16 Berchem TOT
54,Posthofbrug 5366,2021-01-14,10:00:00,56,32,24,FMN GV 16 Berchem TOT
54,Posthofbrug 5366,2021-01-14,11:00:00,56,28,28,FMN GV 16 Berchem TOT
54,Posthofbrug 5366,2021-01-14,12:00:00,98,60,38,FMN GV 16 Berchem TOT
54,Posthofbrug 5366,2021-01-14,13:00:00,80,45,35,FMN GV 16 Berchem TOT
54,Posthofbrug 5366,2021-01-14,14:00:00,98,40,58,FMN GV 16 Berchem TOT
54,Posthofbrug 5366,2021-01-14,15:00:00,123,54,69,FMN GV 16 Berchem TOT
54,Posthofbrug 5366,2021-01-14,16:00:00,175,46,129,FMN GV 16 Berchem TOT
54,Posthofbrug 5366,2021-01-14,17:00:00,229,76,153,FMN GV 16 Berchem TOT
54,Posthofbrug 5366,2021-01-14,18:00:00,160,49,111,FMN GV 16 Berchem TOT
54,Posthofbrug 5366,2021-01-14,19:00:00,67,25,42,FMN GV 16 Berchem TOT
54,Posthofbrug 5366,2021-01-14,20:00:00,31,12,19,FMN GV 16 Berchem TOT
54,Posthofbrug 5366,2021-01-14,21:00:00,33,19,14,FMN GV 16 Berchem TOT
54,Posthofbrug 5366,2021-01-14,22:00:00,40,18,22,FMN GV 16 Berchem TOT
54,Posthofbrug 5366,2021-01-14,23:00:00,21,6,15,FMN GV 16 Berchem TOT
54,Posthofbrug 5366,2021-01-15,00:00:00,2,0,2,FMN GV 16 Berchem TOT
54,Posthofbrug 5366,2021-01-15,01:00:00,1,0,1,FMN GV 16 Berchem TOT
54,Posthofbrug 5366,2021-01-15,02:00:00,1,0,1,FMN GV 16 Berchem TOT
54,Posthofbrug 5366,2021-01-15,03:00:00,9,5,4,FMN GV 16 Berchem TOT
54,Posthofbrug 5366,2021-01-15,04:00:00,5,3,2,FMN GV 16 Berchem TOT
54,Posthofbrug 5366,2021-01-15,05:00:00,12,8,4,FMN GV 16 Berchem TOT
54,Posthofbrug 5366,2021-01-15,06:00:00,64,44,20,FMN GV 16 Berchem TOT
54,Posthofbrug 5366,2021-01-15,07:00:00,183,130,53,FMN GV 16 Berchem TOT
54,Posthofbrug 5366,2021-01-15,08:00:00,258,194,64,FMN GV 16 Berchem TOT
54,Posthofbrug 5366,2021-01-15,09:00:00,104,88,16,FMN GV 16 Berchem TOT
54,Posthofbrug 5366,2021-01-15,10:00:00,65,33,32,FMN GV 16 Berchem TOT
54,Posthofbrug 5366,2021-01-15,11:00:00,85,59,26,FMN GV 16 Berchem TOT
54,Posthofbrug 5366,2021-01-15,12:00:00,107,54,53,FMN GV 16 Berchem TOT
54,Posthofbrug 5366,2021-01-15,13:00:00,101,56,45,FMN GV 16 Berchem TOT
54,Posthofbrug 5366,2021-01-15,14:00:00,96,44,52,FMN GV 16 Berchem TOT
54,Posthofbrug 5366,2021-01-15,15:00:00,159,61,98,FMN GV 16 Berchem TOT
54,Posthofbrug 5366,2021-01-15,16:00:00,212,65,147,FMN GV 16 Berchem TOT
54,Posthofbrug 5366,2021-01-15,17:00:00,190,52,138,FMN GV 16 Berchem TOT
54,Posthofbrug 5366,2021-01-15,18:00:00,147,55,92,FMN GV 16 Berchem TOT
54,Posthofbrug 5366,2021-01-15,19:00:00,57,20,37,FMN GV 16 Berchem TOT
54,Posthofbrug 5366,2021-01-15,20:00:00,45,22,23,FMN GV 16 Berchem TOT
54,Posthofbrug 5366,2021-01-15,21:00:00,28,9,19,FMN GV 16 Berchem TOT
54,Posthofbrug 5366,2021-01-15,22:00:00,33,16,17,FMN GV 16 Berchem TOT
54,Posthofbrug 5366,2021-01-15,23:00:00,52,25,27,FMN GV 16 Berchem TOT
54,Posthofbrug 5366,2021-01-16,00:00:00,8,6,2,FMN GV 16 Berchem TOT
54,Posthofbrug 5366,2021-01-16,01:00:00,0,0,0,FMN GV 16 Berchem TOT
54,Posthofbrug 5366,2021-01-16,02:00:00,2,0,2,FMN GV 16 Berchem TOT
54,Posthofbrug 5366,2021-01-16,03:00:00,4,4,0,FMN GV 16 Berchem TOT
54,Posthofbrug 5366,2021-01-16,04:00:00,3,3,0,FMN GV 16 Berchem TOT
54,Posthofbrug 5366,2021-01-16,05:00:00,9,8,1,FMN GV 16 Berchem TOT
54,Posthofbrug 5366,2021-01-16,06:00:00,14,10,4,FMN GV 16 Berchem TOT
54,Posthofbrug 5366,2021-01-16,07:00:00,21,12,9,FMN GV 16 Berchem TOT
54,Posthofbrug 5366,2021-01-16,08:00:00,35,21,14,FMN GV 16 Berchem TOT
54,Posthofbrug 5366,2021-01-16,09:00:00,70,41,29,FMN GV 16 Berchem TOT
54,Posthofbrug 5366,2021-01-16,10:00:00,96,60,36,FMN GV 16 Berchem TOT
54,Posthofbrug 5366,2021-01-16,11:00:00,94,56,38,FMN GV 16 Berchem TOT
54,Posthofbrug 5366,2021-01-16,12:00:00,89,51,38,FMN GV 16 Berchem TOT
54,Posthofbrug 5366,2021-01-16,13:00:00,84,46,38,FMN GV 16 Berchem TOT
54,Posthofbrug 5366,2021-01-16,14:00:00,87,41,46,FMN GV 16 Berchem TOT
54,Posthofbrug 5366,2021-01-16,15:00:00,75,32,43,FMN GV 16 Berchem TOT
54,Posthofbrug 5366,2021-01-16,16:00:00,39,17,22,FMN GV 16 Berchem TOT
54,Posthofbrug 5366,2021-01-16,17:00:00,46,16,30,FMN GV 16 Berchem TOT
54,Posthofbrug 5366,2021-01-16,18:00:00,47,12,35,FMN GV 16 Berchem TOT
54,Posthofbrug 5366,2021-01-16,19:00:00,24,9,15,FMN GV 16 Berchem TOT
54,Posthofbrug 5366,2021-01-16,20:00:00,12,3,9,FMN GV 16 Berchem TOT
54,Posthofbrug 5366,2021-01-16,21:00:00,9,6,3,FMN GV 16 Berchem TOT
54,Posthofbrug 5366,2021-01-16,22:00:00,24,12,12,FMN GV 16 Berchem TOT
54,Posthofbrug 5366,2021-01-16,23:00:00,14,5,9,FMN GV 16 Berchem TOT
54,Posthofbrug 5366,2021-01-17,00:00:00,4,2,2,FMN GV 16 Berchem TOT
54,Posthofbrug 5366,2021-01-17,01:00:00,1,1,0,FMN GV 16 Berchem TOT
54,Posthofbrug 5366,2021-01-17,02:00:00,1,0,1,FMN GV 16 Berchem TOT
54,Posthofbrug 5366,2021-01-17,03:00:00,1,0,1,FMN GV 16 Berchem TOT
54,Posthofbrug 5366,2021-01-17,04:00:00,0,0,0,FMN GV 16 Berchem TOT
54,Posthofbrug 5366,2021-01-17,05:00:00,5,3,2,FMN GV 16 Berchem TOT
54,Posthofbrug 5366,2021-01-17,06:00:00,11,11,0,FMN GV 16 Berchem TOT
54,Posthofbrug 5366,2021-01-17,07:00:00,6,5,1,FMN GV 16 Berchem TOT
54,Posthofbrug 5366,2021-01-17,08:00:00,20,10,10,FMN GV 16 Berchem TOT
54,Posthofbrug 5366,2021-01-17,09:00:00,34,21,13,FMN GV 16 Berchem TOT
54,Posthofbrug 5366,2021-01-17,10:00:00,43,26,17,FMN GV 16 Berchem TOT
54,Posthofbrug 5366,2021-01-17,11:00:00,57,29,28,FMN GV 16 Berchem TOT
54,Posthofbrug 5366,2021-01-17,12:00:00,101,53,48,FMN GV 16 Berchem TOT
54,Posthofbrug 5366,2021-01-17,13:00:00,90,41,49,FMN GV 16 Berchem TOT
54,Posthofbrug 5366,2021-01-17,14:00:00,106,49,57,FMN GV 16 Berchem TOT
54,Posthofbrug 5366,2021-01-17,15:00:00,96,61,35,FMN GV 16 Berchem TOT
54,Posthofbrug 5366,2021-01-17,16:00:00,105,62,43,FMN GV 16 Berchem TOT
54,Posthofbrug 5366,2021-01-17,17:00:00,78,35,43,FMN GV 16 Berchem TOT
54,Posthofbrug 5366,2021-01-17,18:00:00,39,13,26,FMN GV 16 Berchem TOT
54,Posthofbrug 5366,2021-01-17,19:00:00,39,16,23,FMN GV 16 Berchem TOT
54,Posthofbrug 5366,2021-01-17,20:00:00,28,16,12,FMN GV 16 Berchem TOT
54,Posthofbrug 5366,2021-01-17,21:00:00,32,21,11,FMN GV 16 Berchem TOT
54,Posthofbrug 5366,2021-01-17,22:00:00,21,11,10,FMN GV 16 Berchem TOT
54,Posthofbrug 5366,2021-01-17,23:00:00,17,7,10,FMN GV 16 Berchem TOT
54,Posthofbrug 5366,2021-01-18,00:00:00,4,2,2,FMN GV 16 Berchem TOT
54,Posthofbrug 5366,2021-01-18,01:00:00,0,0,0,FMN GV 16 Berchem TOT
54,Posthofbrug 5366,2021-01-18,02:00:00,0,0,0,FMN GV 16 Berchem TOT
54,Posthofbrug 5366,2021-01-18,03:00:00,1,1,0,FMN GV 16 Berchem TOT
54,Posthofbrug 5366,2021-01-18,04:00:00,9,7,2,FMN GV 16 Berchem TOT
54,Posthofbrug 5366,2021-01-18,05:00:00,19,13,6,FMN GV 16 Berchem TOT
54,Posthofbrug 5366,2021-01-18,06:00:00,61,52,9,FMN GV 16 Berchem TOT
54,Posthofbrug 5366,2021-01-18,07:00:00,225,161,64,FMN GV 16 Berchem TOT
54,Posthofbrug 5366,2021-01-18,08:00:00,312,244,68,FMN GV 16 Berchem TOT
54,Posthofbrug 5366,2021-01-18,09:00:00,131,90,41,FMN GV 16 Berchem TOT
54,Posthofbrug 5366,2021-01-18,10:00:00,72,45,27,FMN GV 16 Berchem TOT
54,Posthofbrug 5366,2021-01-18,11:00:00,90,54,36,FMN GV 16 Berchem TOT
54,Posthofbrug 5366,2021-01-18,12:00:00,88,49,39,FMN GV 16 Berchem TOT
54,Posthofbrug 5366,2021-01-18,13:00:00,106,56,50,FMN GV 16 Berchem TOT
54,Posthofbrug 5366,2021-01-18,14:00:00,101,38,63,FMN GV 16 Berchem TOT
54,Posthofbrug 5366,2021-01-18,15:00:00,167,68,99,FMN GV 16 Berchem TOT
54,Posthofbrug 5366,2021-01-18,16:00:00,244,65,179,FMN GV 16 Berchem TOT
54,Posthofbrug 5366,2021-01-18,17:00:00,226,76,150,FMN GV 16 Berchem TOT
54,Posthofbrug 5366,2021-01-18,18:00:00,145,46,99,FMN GV 16 Berchem TOT
54,Posthofbrug 5366,2021-01-18,19:00:00,76,31,45,FMN GV 16 Berchem TOT
54,Posthofbrug 5366,2021-01-18,20:00:00,34,21,13,FMN GV 16 Berchem TOT
54,Posthofbrug 5366,2021-01-18,21:00:00,30,12,18,FMN GV 16 Berchem TOT
54,Posthofbrug 5366,2021-01-18,22:00:00,33,13,20,FMN GV 16 Berchem TOT
54,Posthofbrug 5366,2021-01-18,23:00:00,9,1,8,FMN GV 16 Berchem TOT
54,Posthofbrug 5366,2021-01-19,00:00:00,1,0,1,FMN GV 16 Berchem TOT
54,Posthofbrug 5366,2021-01-19,01:00:00,0,0,0,FMN GV 16 Berchem TOT
54,Posthofbrug 5366,2021-01-19,02:00:00,0,0,0,FMN GV 16 Berchem TOT
54,Posthofbrug 5366,2021-01-19,03:00:00,1,0,1,FMN GV 16 Berchem TOT
54,Posthofbrug 5366,2021-01-19,04:00:00,8,8,0,FMN GV 16 Berchem TOT
54,Posthofbrug 5366,2021-01-19,05:00:00,19,13,6,FMN GV 16 Berchem TOT
54,Posthofbrug 5366,2021-01-19,06:00:00,56,46,10,FMN GV 16 Berchem TOT
54,Posthofbrug 5366,2021-01-19,07:00:00,159,123,36,FMN GV 16 Berchem TOT
54,Posthofbrug 5366,2021-01-19,08:00:00,235,171,64,FMN GV 16 Berchem TOT
54,Posthofbrug 5366,2021-01-19,09:00:00,93,63,30,FMN GV 16 Berchem TOT
54,Posthofbrug 5366,2021-01-19,10:00:00,51,38,13,FMN GV 16 Berchem TOT
54,Posthofbrug 5366,2021-01-19,11:00:00,65,34,31,FMN GV 16 Berchem TOT
54,Posthofbrug 5366,2021-01-19,12:00:00,81,41,40,FMN GV 16 Berchem TOT
54,Posthofbrug 5366,2021-01-19,13:00:00,78,46,32,FMN GV 16 Berchem TOT
54,Posthofbrug 5366,2021-01-19,14:00:00,65,28,37,FMN GV 16 Berchem TOT
54,Posthofbrug 5366,2021-01-19,15:00:00,120,37,83,FMN GV 16 Berchem TOT
54,Posthofbrug 5366,2021-01-19,16:00:00,165,62,103,FMN GV 16 Berchem TOT
54,Posthofbrug 5366,2021-01-19,17:00:00,208,61,147,FMN GV 16 Berchem TOT
54,Posthofbrug 5366,2021-01-19,18:00:00,123,44,79,FMN GV 16 Berchem TOT
54,Posthofbrug 5366,2021-01-19,19:00:00,55,17,38,FMN GV 16 Berchem TOT
54,Posthofbrug 5366,2021-01-19,20:00:00,45,20,25,FMN GV 16 Berchem TOT
54,Posthofbrug 5366,2021-01-19,21:00:00,23,10,13,FMN GV 16 Berchem TOT
54,Posthofbrug 5366,2021-01-19,22:00:00,30,15,15,FMN GV 16 Berchem TOT
54,Posthofbrug 5366,2021-01-19,23:00:00,20,4,16,FMN GV 16 Berchem TOT
54,Posthofbrug 5366,2021-01-20,00:00:00,1,1,0,FMN GV 16 Berchem TOT
54,Posthofbrug 5366,2021-01-20,01:00:00,0,0,0,FMN GV 16 Berchem TOT
54,Posthofbrug 5366,2021-01-20,02:00:00,1,0,1,FMN GV 16 Berchem TOT
54,Posthofbrug 5366,2021-01-20,03:00:00,0,0,0,FMN GV 16 Berchem TOT
54,Posthofbrug 5366,2021-01-20,04:00:00,7,6,1,FMN GV 16 Berchem TOT
54,Posthofbrug 5366,2021-01-20,05:00:00,17,11,6,FMN GV 16 Berchem TOT
54,Posthofbrug 5366,2021-01-20,06:00:00,65,54,11,FMN GV 16 Berchem TOT
54,Posthofbrug 5366,2021-01-20,07:00:00,195,154,41,FMN GV 16 Berchem TOT
54,Posthofbrug 5366,2021-01-20,08:00:00,277,205,72,FMN GV 16 Berchem TOT
54,Posthofbrug 5366,2021-01-20,09:00:00,113,79,34,FMN GV 16 Berchem TOT
54,Posthofbrug 5366,2021-01-20,10:00:00,85,49,36,FMN GV 16 Berchem TOT
54,Posthofbrug 5366,2021-01-20,11:00:00,98,55,43,FMN GV 16 Berchem TOT
54,Posthofbrug 5366,2021-01-20,12:00:00,185,73,112,FMN GV 16 Berchem TOT
54,Posthofbrug 5366,2021-01-20,13:00:00,130,54,76,FMN GV 16 Berchem TOT
54,Posthofbrug 5366,2021-01-20,14:00:00,88,41,47,FMN GV 16 Berchem TOT
54,Posthofbrug 5366,2021-01-20,15:00:00,140,52,88,FMN GV 16 Berchem TOT
54,Posthofbrug 5366,2021-01-20,16:00:00,168,55,113,FMN GV 16 Berchem TOT
54,Posthofbrug 5366,2021-01-20,17:00:00,241,84,157,FMN GV 16 Berchem TOT
54,Posthofbrug 5366,2021-01-20,18:00:00,151,58,93,FMN GV 16 Berchem TOT
54,Posthofbrug 5366,2021-01-20,19:00:00,88,32,56,FMN GV 16 Berchem TOT
54,Posthofbrug 5366,2021-01-20,20:00:00,45,27,18,FMN GV 16 Berchem TOT
54,Posthofbrug 5366,2021-01-20,21:00:00,31,12,19,FMN GV 16 Berchem TOT
54,Posthofbrug 5366,2021-01-20,22:00:00,34,11,23,FMN GV 16 Berchem TOT
54,Posthofbrug 5366,2021-01-20,23:00:00,20,7,13,FMN GV 16 Berchem TOT
54,Posthofbrug 5366,2021-01-21,00:00:00,2,0,2,FMN GV 16 Berchem TOT
54,Posthofbrug 5366,2021-01-21,01:00:00,1,0,1,FMN GV 16 Berchem TOT
54,Posthofbrug 5366,2021-01-21,02:00:00,2,0,2,FMN GV 16 Berchem TOT
54,Posthofbrug 5366,2021-01-21,03:00:00,8,0,8,FMN GV 16 Berchem TOT
54,Posthofbrug 5366,2021-01-21,04:00:00,11,7,4,FMN GV 16 Berchem TOT
54,Posthofbrug 5366,2021-01-21,05:00:00,10,5,5,FMN GV 16 Berchem TOT
54,Posthofbrug 5366,2021-01-21,06:00:00,59,50,9,FMN GV 16 Berchem TOT
54,Posthofbrug 5366,2021-01-21,07:00:00,214,153,61,FMN GV 16 Berchem TOT
54,Posthofbrug 5366,2021-01-21,08:00:00,281,210,71,FMN GV 16 Berchem TOT
54,Posthofbrug 5366,2021-01-21,09:00:00,134,102,32,FMN GV 16 Berchem TOT
54,Posthofbrug 5366,2021-01-21,10:00:00,90,61,29,FMN GV 16 Berchem TOT
54,Posthofbrug 5366,2021-01-21,11:00:00,83,40,43,FMN GV 16 Berchem TOT
54,Posthofbrug 5366,2021-01-21,12:00:00,111,49,62,FMN GV 16 Berchem TOT
54,Posthofbrug 5366,2021-01-21,13:00:00,104,55,49,FMN GV 16 Berchem TOT
54,Posthofbrug 5366,2021-01-21,14:00:00,93,45,48,FMN GV 16 Berchem TOT
54,Posthofbrug 5366,2021-01-21,15:00:00,141,54,87,FMN GV 16 Berchem TOT
54,Posthofbrug 5366,2021-01-21,16:00:00,242,68,174,FMN GV 16 Berchem TOT
54,Posthofbrug 5366,2021-01-21,17:00:00,241,72,169,FMN GV 16 Berchem TOT
54,Posthofbrug 5366,2021-01-21,18:00:00,142,44,98,FMN GV 16 Berchem TOT
54,Posthofbrug 5366,2021-01-21,19:00:00,56,22,34,FMN GV 16 Berchem TOT
54,Posthofbrug 5366,2021-01-21,20:00:00,26,12,14,FMN GV 16 Berchem TOT
54,Posthofbrug 5366,2021-01-21,21:00:00,37,18,19,FMN GV 16 Berchem TOT
54,Posthofbrug 5366,2021-01-21,22:00:00,27,10,17,FMN GV 16 Berchem TOT
54,Posthofbrug 5366,2021-01-21,23:00:00,13,4,9,FMN GV 16 Berchem TOT
54,Posthofbrug 5366,2021-01-22,00:00:00,2,1,1,FMN GV 16 Berchem TOT
54,Posthofbrug 5366,2021-01-22,01:00:00,1,1,0,FMN GV 16 Berchem TOT
54,Posthofbrug 5366,2021-01-22,02:00:00,0,0,0,FMN GV 16 Berchem TOT
54,Posthofbrug 5366,2021-01-22,03:00:00,1,1,0,FMN GV 16 Berchem TOT
54,Posthofbrug 5366,2021-01-22,04:00:00,9,8,1,FMN GV 16 Berchem TOT
54,Posthofbrug 5366,2021-01-22,05:00:00,18,8,10,FMN GV 16 Berchem TOT
54,Posthofbrug 5366,2021-01-22,06:00:00,64,57,7,FMN GV 16 Berchem TOT
54,Posthofbrug 5366,2021-01-22,07:00:00,175,128,47,FMN GV 16 Berchem TOT
54,Posthofbrug 5366,2021-01-22,08:00:00,311,227,84,FMN GV 16 Berchem TOT
54,Posthofbrug 5366,2021-01-22,09:00:00,113,83,30,FMN GV 16 Berchem TOT
54,Posthofbrug 5366,2021-01-22,10:00:00,75,47,28,FMN GV 16 Berchem TOT
54,Posthofbrug 5366,2021-01-22,11:00:00,75,44,31,FMN GV 16 Berchem TOT
54,Posthofbrug 5366,2021-01-22,12:00:00,100,51,49,FMN GV 16 Berchem TOT
54,Posthofbrug 5366,2021-01-22,13:00:00,134,71,63,FMN GV 16 Berchem TOT
54,Posthofbrug 5366,2021-01-22,14:00:00,128,57,71,FMN GV 16 Berchem TOT
54,Posthofbrug 5366,2021-01-22,15:00:00,187,87,100,FMN GV 16 Berchem TOT
54,Posthofbrug 5366,2021-01-22,16:00:00,236,78,158,FMN GV 16 Berchem TOT
54,Posthofbrug 5366,2021-01-22,17:00:00,219,77,142,FMN GV 16 Berchem TOT
54,Posthofbrug 5366,2021-01-22,18:00:00,156,56,100,FMN GV 16 Berchem TOT
54,Posthofbrug 5366,2021-01-22,19:00:00,84,29,55,FMN GV 16 Berchem TOT
54,Posthofbrug 5366,2021-01-22,20:00:00,54,23,31,FMN GV 16 Berchem TOT
54,Posthofbrug 5366,2021-01-22,21:00:00,40,15,25,FMN GV 16 Berchem TOT
54,Posthofbrug 5366,2021-01-22,22:00:00,34,15,19,FMN GV 16 Berchem TOT
54,Posthofbrug 5366,2021-01-22,23:00:00,50,26,24,FMN GV 16 Berchem TOT
54,Posthofbrug 5366,2021-01-23,00:00:00,7,4,3,FMN GV 16 Berchem TOT
54,Posthofbrug 5366,2021-01-23,01:00:00,2,1,1,FMN GV 16 Berchem TOT
54,Posthofbrug 5366,2021-01-23,02:00:00,1,0,1,FMN GV 16 Berchem TOT
54,Posthofbrug 5366,2021-01-23,03:00:00,0,0,0,FMN GV 16 Berchem TOT
54,Posthofbrug 5366,2021-01-23,04:00:00,6,6,0,FMN GV 16 Berchem TOT
54,Posthofbrug 5366,2021-01-23,05:00:00,8,6,2,FMN GV 16 Berchem TOT
54,Posthofbrug 5366,2021-01-23,06:00:00,11,7,4,FMN GV 16 Berchem TOT
54,Posthofbrug 5366,2021-01-23,07:00:00,18,10,8,FMN GV 16 Berchem TOT
54,Posthofbrug 5366,2021-01-23,08:00:00,30,15,15,FMN GV 16 Berchem TOT
54,Posthofbrug 5366,2021-01-23,09:00:00,89,56,33,FMN GV 16 Berchem TOT
54,Posthofbrug 5366,2021-01-23,10:00:00,89,55,34,FMN GV 16 Berchem TOT
54,Posthofbrug 5366,2021-01-23,11:00:00,122,85,37,FMN GV 16 Berchem TOT
54,Posthofbrug 5366,2021-01-23,12:00:00,110,48,62,FMN GV 16 Berchem TOT
54,Posthofbrug 5366,2021-01-23,13:00:00,130,73,57,FMN GV 16 Berchem TOT
54,Posthofbrug 5366,2021-01-23,14:00:00,127,54,73,FMN GV 16 Berchem TOT
54,Posthofbrug 5366,2021-01-23,15:00:00,84,35,49,FMN GV 16 Berchem TOT
54,Posthofbrug 5366,2021-01-23,16:00:00,64,28,36,FMN GV 16 Berchem TOT
54,Posthofbrug 5366,2021-01-23,17:00:00,62,19,43,FMN GV 16 Berchem TOT
54,Posthofbrug 5366,2021-01-23,18:00:00,46,19,27,FMN GV 16 Berchem TOT
54,Posthofbrug 5366,2021-01-23,19:00:00,43,16,27,FMN GV 16 Berchem TOT
54,Posthofbrug 5366,2021-01-23,20:00:00,20,13,7,FMN GV 16 Berchem TOT
54,Posthofbrug 5366,2021-01-23,21:00:00,16,10,6,FMN GV 16 Berchem TOT
54,Posthofbrug 5366,2021-01-23,22:00:00,22,10,12,FMN GV 16 Berchem TOT
54,Posthofbrug 5366,2021-01-23,23:00:00,18,10,8,FMN GV 16 Berchem TOT
54,Posthofbrug 5366,2021-01-24,00:00:00,6,2,4,FMN GV 16 Berchem TOT
54,Posthofbrug 5366,2021-01-24,01:00:00,2,0,2,FMN GV 16 Berchem TOT
54,Posthofbrug 5366,2021-01-24,02:00:00,2,2,0,FMN GV 16 Berchem TOT
54,Posthofbrug 5366,2021-01-24,03:00:00,4,0,4,FMN GV 16 Berchem TOT
54,Posthofbrug 5366,2021-01-24,04:00:00,4,4,0,FMN GV 16 Berchem TOT
54,Posthofbrug 5366,2021-01-24,05:00:00,4,3,1,FMN GV 16 Berchem TOT
54,Posthofbrug 5366,2021-01-24,06:00:00,4,3,1,FMN GV 16 Berchem TOT
54,Posthofbrug 5366,2021-01-24,07:00:00,10,7,3,FMN GV 16 Berchem TOT
54,Posthofbrug 5366,2021-01-24,08:00:00,21,10,11,FMN GV 16 Berchem TOT
54,Posthofbrug 5366,2021-01-24,09:00:00,52,26,26,FMN GV 16 Berchem TOT
54,Posthofbrug 5366,2021-01-24,10:00:00,71,45,26,FMN GV 16 Berchem TOT
54,Posthofbrug 5366,2021-01-24,11:00:00,109,63,46,FMN GV 16 Berchem TOT
54,Posthofbrug 5366,2021-01-24,12:00:00,115,61,54,FMN GV 16 Berchem TOT
54,Posthofbrug 5366,2021-01-24,13:00:00,123,72,51,FMN GV 16 Berchem TOT
54,Posthofbrug 5366,2021-01-24,14:00:00,115,56,59,FMN GV 16 Berchem TOT
54,Posthofbrug 5366,2021-01-24,15:00:00,105,53,52,FMN GV 16 Berchem TOT
54,Posthofbrug 5366,2021-01-24,16:00:00,105,51,54,FMN GV 16 Berchem TOT
54,Posthofbrug 5366,2021-01-24,17:00:00,90,47,43,FMN GV 16 Berchem TOT
54,Posthofbrug 5366,2021-01-24,18:00:00,62,26,36,FMN GV 16 Berchem TOT
54,Posthofbrug 5366,2021-01-24,19:00:00,29,14,15,FMN GV 16 Berchem TOT
54,Posthofbrug 5366,2021-01-24,20:00:00,27,15,12,FMN GV 16 Berchem TOT
54,Posthofbrug 5366,2021-01-24,21:00:00,15,11,4,FMN GV 16 Berchem TOT
54,Posthofbrug 5366,2021-01-24,22:00:00,24,17,7,FMN GV 16 Berchem TOT
54,Posthofbrug 5366,2021-01-24,23:00:00,8,4,4,FMN GV 16 Berchem TOT
54,Posthofbrug 5366,2021-01-25,00:00:00,7,2,5,FMN GV 16 Berchem TOT
54,Posthofbrug 5366,2021-01-25,01:00:00,1,0,1,FMN GV 16 Berchem TOT
54,Posthofbrug 5366,2021-01-25,02:00:00,0,0,0,FMN GV 16 Berchem TOT
54,Posthofbrug 5366,2021-01-25,03:00:00,1,1,0,FMN GV 16 Berchem TOT
54,Posthofbrug 5366,2021-01-25,04:00:00,10,9,1,FMN GV 16 Berchem TOT
54,Posthofbrug 5366,2021-01-25,05:00:00,13,9,4,FMN GV 16 Berchem TOT
54,Posthofbrug 5366,2021-01-25,06:00:00,55,50,5,FMN GV 16 Berchem TOT
54,Posthofbrug 5366,2021-01-25,07:00:00,203,140,63,FMN GV 16 Berchem TOT
54,Posthofbrug 5366,2021-01-25,08:00:00,280,219,61,FMN GV 16 Berchem TOT
54,Posthofbrug 5366,2021-01-25,09:00:00,109,80,29,FMN GV 16 Berchem TOT
54,Posthofbrug 5366,2021-01-25,10:00:00,60,42,18,FMN GV 16 Berchem TOT
54,Posthofbrug 5366,2021-01-25,11:00:00,61,36,25,FMN GV 16 Berchem TOT
54,Posthofbrug 5366,2021-01-25,12:00:00,136,76,60,FMN GV 16 Berchem TOT
54,Posthofbrug 5366,2021-01-25,13:00:00,99,66,33,FMN GV 16 Berchem TOT
54,Posthofbrug 5366,2021-01-25,14:00:00,95,52,43,FMN GV 16 Berchem TOT
54,Posthofbrug 5366,2021-01-25,15:00:00,154,56,98,FMN GV 16 Berchem TOT
54,Posthofbrug 5366,2021-01-25,16:00:00,229,54,175,FMN GV 16 Berchem TOT
54,Posthofbrug 5366,2021-01-25,17:00:00,238,71,167,FMN GV 16 Berchem TOT
54,Posthofbrug 5366,2021-01-25,18:00:00,145,49,96,FMN GV 16 Berchem TOT
54,Posthofbrug 5366,2021-01-25,19:00:00,75,28,47,FMN GV 16 Berchem TOT
54,Posthofbrug 5366,2021-01-25,20:00:00,34,16,18,FMN GV 16 Berchem TOT
54,Posthofbrug 5366,2021-01-25,21:00:00,23,11,12,FMN GV 16 Berchem TOT
54,Posthofbrug 5366,2021-01-25,22:00:00,24,10,14,FMN GV 16 Berchem TOT
54,Posthofbrug 5366,2021-01-25,23:00:00,17,5,12,FMN GV 16 Berchem TOT
54,Posthofbrug 5366,2021-01-26,00:00:00,1,0,1,FMN GV 16 Berchem TOT
54,Posthofbrug 5366,2021-01-26,01:00:00,1,0,1,FMN GV 16 Berchem TOT
54,Posthofbrug 5366,2021-01-26,02:00:00,1,0,1,FMN GV 16 Berchem TOT
54,Posthofbrug 5366,2021-01-26,03:00:00,0,0,0,FMN GV 16 Berchem TOT
54,Posthofbrug 5366,2021-01-26,04:00:00,10,9,1,FMN GV 16 Berchem TOT
54,Posthofbrug 5366,2021-01-26,05:00:00,16,10,6,FMN GV 16 Berchem TOT
54,Posthofbrug 5366,2021-01-26,06:00:00,80,62,18,FMN GV 16 Berchem TOT
54,Posthofbrug 5366,2021-01-26,07:00:00,212,162,50,FMN GV 16 Berchem TOT
54,Posthofbrug 5366,2021-01-26,08:00:00,295,223,72,FMN GV 16 Berchem TOT
54,Posthofbrug 5366,2021-01-26,09:00:00,112,80,32,FMN GV 16 Berchem TOT
54,Posthofbrug 5366,2021-01-26,10:00:00,72,48,24,FMN GV 16 Berchem TOT
54,Posthofbrug 5366,2021-01-26,11:00:00,71,38,33,FMN GV 16 Berchem TOT
54,Posthofbrug 5366,2021-01-26,12:00:00,112,59,53,FMN GV 16 Berchem TOT
54,Posthofbrug 5366,2021-01-26,13:00:00,132,78,54,FMN GV 16 Berchem TOT
54,Posthofbrug 5366,2021-01-26,14:00:00,109,56,53,FMN GV 16 Berchem TOT
54,Posthofbrug 5366,2021-01-26,15:00:00,198,60,138,FMN GV 16 Berchem TOT
54,Posthofbrug 5366,2021-01-26,16:00:00,250,92,158,FMN GV 16 Berchem TOT
54,Posthofbrug 5366,2021-01-26,17:00:00,243,73,170,FMN GV 16 Berchem TOT
54,Posthofbrug 5366,2021-01-26,18:00:00,170,58,112,FMN GV 16 Berchem TOT
54,Posthofbrug 5366,2021-01-26,19:00:00,67,27,40,FMN GV 16 Berchem TOT
54,Posthofbrug 5366,2021-01-26,20:00:00,36,16,20,FMN GV 16 Berchem TOT
54,Posthofbrug 5366,2021-01-26,21:00:00,28,9,19,FMN GV 16 Berchem TOT
54,Posthofbrug 5366,2021-01-26,22:00:00,38,14,24,FMN GV 16 Berchem TOT
54,Posthofbrug 5366,2021-01-26,23:00:00,19,7,12,FMN GV 16 Berchem TOT
54,Posthofbrug 5366,2021-01-27,00:00:00,2,0,2,FMN GV 16 Berchem TOT
54,Posthofbrug 5366,2021-01-27,01:00:00,0,0,0,FMN GV 16 Berchem TOT
54,Posthofbrug 5366,2021-01-27,02:00:00,0,0,0,FMN GV 16 Berchem TOT
54,Posthofbrug 5366,2021-01-27,03:00:00,0,0,0,FMN GV 16 Berchem TOT
54,Posthofbrug 5366,2021-01-27,04:00:00,6,5,1,FMN GV 16 Berchem TOT
54,Posthofbrug 5366,2021-01-27,05:00:00,24,18,6,FMN GV 16 Berchem TOT
54,Posthofbrug 5366,2021-01-27,06:00:00,63,48,15,FMN GV 16 Berchem TOT
54,Posthofbrug 5366,2021-01-27,07:00:00,197,144,53,FMN GV 16 Berchem TOT
54,Posthofbrug 5366,2021-01-27,08:00:00,259,198,61,FMN GV 16 Berchem TOT
54,Posthofbrug 5366,2021-01-27,09:00:00,102,70,32,FMN GV 16 Berchem TOT
54,Posthofbrug 5366,2021-01-27,10:00:00,59,40,19,FMN GV 16 Berchem TOT
54,Posthofbrug 5366,2021-01-27,11:00:00,82,47,35,FMN GV 16 Berchem TOT
54,Posthofbrug 5366,2021-01-27,12:00:00,143,51,92,FMN GV 16 Berchem TOT
54,Posthofbrug 5366,2021-01-27,13:00:00,110,48,62,FMN GV 16 Berchem TOT
54,Posthofbrug 5366,2021-01-27,14:00:00,103,59,44,FMN GV 16 Berchem TOT
54,Posthofbrug 5366,2021-01-27,15:00:00,123,46,77,FMN GV 16 Berchem TOT
54,Posthofbrug 5366,2021-01-27,16:00:00,170,63,107,FMN GV 16 Berchem TOT
54,Posthofbrug 5366,2021-01-27,17:00:00,225,84,141,FMN GV 16 Berchem TOT
54,Posthofbrug 5366,2021-01-27,18:00:00,145,58,87,FMN GV 16 Berchem TOT
54,Posthofbrug 5366,2021-01-27,19:00:00,79,31,48,FMN GV 16 Berchem TOT
54,Posthofbrug 5366,2021-01-27,20:00:00,50,29,21,FMN GV 16 Berchem TOT
54,Posthofbrug 5366,2021-01-27,21:00:00,25,20,5,FMN GV 16 Berchem TOT
54,Posthofbrug 5366,2021-01-27,22:00:00,29,7,22,FMN GV 16 Berchem TOT
54,Posthofbrug 5366,2021-01-27,23:00:00,20,11,9,FMN GV 16 Berchem TOT
54,Posthofbrug 5366,2021-01-28,00:00:00,5,2,3,FMN GV 16 Berchem TOT
54,Posthofbrug 5366,2021-01-28,01:00:00,0,0,0,FMN GV 16 Berchem TOT
54,Posthofbrug 5366,2021-01-28,02:00:00,0,0,0,FMN GV 16 Berchem TOT
54,Posthofbrug 5366,2021-01-28,03:00:00,1,0,1,FMN GV 16 Berchem TOT
54,Posthofbrug 5366,2021-01-28,04:00:00,10,10,0,FMN GV 16 Berchem TOT
54,Posthofbrug 5366,2021-01-28,05:00:00,15,9,6,FMN GV 16 Berchem TOT
54,Posthofbrug 5366,2021-01-28,06:00:00,54,40,14,FMN GV 16 Berchem TOT
54,Posthofbrug 5366,2021-01-28,07:00:00,164,120,44,FMN GV 16 Berchem TOT
54,Posthofbrug 5366,2021-01-28,08:00:00,216,166,50,FMN GV 16 Berchem TOT
54,Posthofbrug 5366,2021-01-28,09:00:00,81,58,23,FMN GV 16 Berchem TOT
54,Posthofbrug 5366,2021-01-28,10:00:00,42,32,10,FMN GV 16 Berchem TOT
54,Posthofbrug 5366,2021-01-28,11:00:00,36,18,18,FMN GV 16 Berchem TOT
54,Posthofbrug 5366,2021-01-28,12:00:00,64,35,29,FMN GV 16 Berchem TOT
54,Posthofbrug 5366,2021-01-28,13:00:00,78,43,35,FMN GV 16 Berchem TOT
54,Posthofbrug 5366,2021-01-28,14:00:00,66,27,39,FMN GV 16 Berchem TOT
54,Posthofbrug 5366,2021-01-28,15:00:00,104,34,70,FMN GV 16 Berchem TOT
54,Posthofbrug 5366,2021-01-28,16:00:00,177,57,120,FMN GV 16 Berchem TOT
54,Posthofbrug 5366,2021-01-28,17:00:00,150,47,103,FMN GV 16 Berchem TOT
54,Posthofbrug 5366,2021-01-28,18:00:00,120,34,86,FMN GV 16 Berchem TOT
54,Posthofbrug 5366,2021-01-28,19:00:00,66,28,38,FMN GV 16 Berchem TOT
54,Posthofbrug 5366,2021-01-28,20:00:00,52,29,23,FMN GV 16 Berchem TOT
54,Posthofbrug 5366,2021-01-28,21:00:00,28,17,11,FMN GV 16 Berchem TOT
54,Posthofbrug 5366,2021-01-28,22:00:00,24,10,14,FMN GV 16 Berchem TOT
54,Posthofbrug 5366,2021-01-28,23:00:00,24,8,16,FMN GV 16 Berchem TOT
54,Posthofbrug 5366,2021-01-29,00:00:00,8,3,5,FMN GV 16 Berchem TOT
54,Posthofbrug 5366,2021-01-29,01:00:00,1,1,0,FMN GV 16 Berchem TOT
54,Posthofbrug 5366,2021-01-29,02:00:00,1,0,1,FMN GV 16 Berchem TOT
54,Posthofbrug 5366,2021-01-29,03:00:00,1,1,0,FMN GV 16 Berchem TOT
54,Posthofbrug 5366,2021-01-29,04:00:00,9,8,1,FMN GV 16 Berchem TOT
54,Posthofbrug 5366,2021-01-29,05:00:00,13,7,6,FMN GV 16 Berchem TOT
54,Posthofbrug 5366,2021-01-29,06:00:00,56,43,13,FMN GV 16 Berchem TOT
54,Posthofbrug 5366,2021-01-29,07:00:00,159,122,37,FMN GV 16 Berchem TOT
54,Posthofbrug 5366,2021-01-29,08:00:00,259,191,68,FMN GV 16 Berchem TOT
54,Posthofbrug 5366,2021-01-29,09:00:00,107,80,27,FMN GV 16 Berchem TOT
54,Posthofbrug 5366,2021-01-29,10:00:00,92,52,40,FMN GV 16 Berchem TOT
54,Posthofbrug 5366,2021-01-29,11:00:00,74,42,32,FMN GV 16 Berchem TOT
54,Posthofbrug 5366,2021-01-29,12:00:00,118,59,59,FMN GV 16 Berchem TOT
54,Posthofbrug 5366,2021-01-29,13:00:00,115,62,53,FMN GV 16 Berchem TOT
54,Posthofbrug 5366,2021-01-29,14:00:00,89,33,56,FMN GV 16 Berchem TOT
54,Posthofbrug 5366,2021-01-29,15:00:00,157,61,96,FMN GV 16 Berchem TOT
54,Posthofbrug 5366,2021-01-29,16:00:00,198,78,120,FMN GV 16 Berchem TOT
54,Posthofbrug 5366,2021-01-29,17:00:00,179,60,119,FMN GV 16 Berchem TOT
54,Posthofbrug 5366,2021-01-29,18:00:00,155,61,94,FMN GV 16 Berchem TOT
54,Posthofbrug 5366,2021-01-29,19:00:00,78,35,43,FMN GV 16 Berchem TOT
54,Posthofbrug 5366,2021-01-29,20:00:00,49,21,28,FMN GV 16 Berchem TOT
54,Posthofbrug 5366,2021-01-29,21:00:00,36,15,21,FMN GV 16 Berchem TOT
54,Posthofbrug 5366,2021-01-29,22:00:00,32,12,20,FMN GV 16 Berchem TOT
54,Posthofbrug 5366,2021-01-29,23:00:00,29,12,17,FMN GV 16 Berchem TOT
54,Posthofbrug 5366,2021-01-30,00:00:00,19,7,12,FMN GV 16 Berchem TOT
54,Posthofbrug 5366,2021-01-30,01:00:00,0,0,0,FMN GV 16 Berchem TOT
54,Posthofbrug 5366,2021-01-30,02:00:00,1,0,1,FMN GV 16 Berchem TOT
54,Posthofbrug 5366,2021-01-30,03:00:00,1,0,1,FMN GV 16 Berchem TOT
54,Posthofbrug 5366,2021-01-30,04:00:00,0,0,0,FMN GV 16 Berchem TOT
54,Posthofbrug 5366,2021-01-30,05:00:00,8,6,2,FMN GV 16 Berchem TOT
54,Posthofbrug 5366,2021-01-30,06:00:00,14,9,5,FMN GV 16 Berchem TOT
54,Posthofbrug 5366,2021-01-30,07:00:00,12,8,4,FMN GV 16 Berchem TOT
54,Posthofbrug 5366,2021-01-30,08:00:00,30,16,14,FMN GV 16 Berchem TOT
54,Posthofbrug 5366,2021-01-30,09:00:00,46,31,15,FMN GV 16 Berchem TOT
54,Posthofbrug 5366,2021-01-30,10:00:00,53,31,22,FMN GV 16 Berchem TOT
54,Posthofbrug 5366,2021-01-30,11:00:00,51,28,23,FMN GV 16 Berchem TOT
54,Posthofbrug 5366,2021-01-30,12:00:00,43,14,29,FMN GV 16 Berchem TOT
54,Posthofbrug 5366,2021-01-30,13:00:00,56,31,25,FMN GV 16 Berchem TOT
54,Posthofbrug 5366,2021-01-30,14:00:00,81,46,35,FMN GV 16 Berchem TOT
54,Posthofbrug 5366,2021-01-30,15:00:00,58,34,24,FMN GV 16 Berchem TOT
54,Posthofbrug 5366,2021-01-30,16:00:00,55,25,30,FMN GV 16 Berchem TOT
54,Posthofbrug 5366,2021-01-30,17:00:00,55,24,31,FMN GV 16 Berchem TOT
54,Posthofbrug 5366,2021-01-30,18:00:00,48,26,22,FMN GV 16 Berchem TOT
54,Posthofbrug 5366,2021-01-30,19:00:00,31,18,13,FMN GV 16 Berchem TOT
54,Posthofbrug 5366,2021-01-30,20:00:00,35,18,17,FMN GV 16 Berchem TOT
54,Posthofbrug 5366,2021-01-30,21:00:00,20,8,12,FMN GV 16 Berchem TOT
54,Posthofbrug 5366,2021-01-30,22:00:00,15,7,8,FMN GV 16 Berchem TOT
54,Posthofbrug 5366,2021-01-30,23:00:00,35,15,20,FMN GV 16 Berchem TOT
54,Posthofbrug 5366,2021-01-31,00:00:00,28,14,14,FMN GV 16 Berchem TOT
54,Posthofbrug 5366,2021-01-31,01:00:00,2,0,2,FMN GV 16 Berchem TOT
54,Posthofbrug 5366,2021-01-31,02:00:00,1,1,0,FMN GV 16 Berchem TOT
54,Posthofbrug 5366,2021-01-31,03:00:00,7,3,4,FMN GV 16 Berchem TOT
54,Posthofbrug 5366,2021-01-31,04:00:00,0,0,0,FMN GV 16 Berchem TOT
54,Posthofbrug 5366,2021-01-31,05:00:00,8,5,3,FMN GV 16 Berchem TOT
54,Posthofbrug 5366,2021-01-31,06:00:00,10,6,4,FMN GV 16 Berchem TOT
54,Posthofbrug 5366,2021-01-31,07:00:00,14,8,6,FMN GV 16 Berchem TOT
54,Posthofbrug 5366,2021-01-31,08:00:00,28,14,14,FMN GV 16 Berchem TOT
54,Posthofbrug 5366,2021-01-31,09:00:00,54,31,23,FMN GV 16 Berchem TOT
54,Posthofbrug 5366,2021-01-31,10:00:00,72,42,30,FMN GV 16 Berchem TOT
54,Posthofbrug 5366,2021-01-31,11:00:00,93,62,31,FMN GV 16 Berchem TOT
54,Posthofbrug 5366,2021-01-31,12:00:00,119,67,52,FMN GV 16 Berchem TOT
54,Posthofbrug 5366,2021-01-31,13:00:00,158,78,80,FMN GV 16 Berchem TOT
54,Posthofbrug 5366,2021-01-31,14:00:00,144,73,71,FMN GV 16 Berchem TOT
54,Posthofbrug 5366,2021-01-31,15:00:00,119,69,50,FMN GV 16 Berchem TOT
54,Posthofbrug 5366,2021-01-31,16:00:00,110,44,66,FMN GV 16 Berchem TOT
54,Posthofbrug 5366,2021-01-31,17:00:00,60,23,37,FMN GV 16 Berchem TOT
54,Posthofbrug 5366,2021-01-31,18:00:00,70,20,50,FMN GV 16 Berchem TOT
54,Posthofbrug 5366,2021-01-31,19:00:00,37,17,20,FMN GV 16 Berchem TOT
54,Posthofbrug 5366,2021-01-31,20:00:00,36,28,8,FMN GV 16 Berchem TOT
54,Posthofbrug 5366,2021-01-31,21:00:00,13,8,5,FMN GV 16 Berchem TOT
54,Posthofbrug 5366,2021-01-31,22:00:00,11,6,5,FMN GV 16 Berchem TOT
54,Posthofbrug 5366,2021-01-31,23:00:00,12,6,6,FMN GV 16 Berchem TOT
54,Posthofbrug 5366,2021-02-01,00:00:00,3,2,1,FMN GV 16 Berchem TOT
54,Posthofbrug 5366,2021-02-01,01:00:00,0,0,0,FMN GV 16 Berchem TOT
54,Posthofbrug 5366,2021-02-01,02:00:00,0,0,0,FMN GV 16 Berchem TOT
54,Posthofbrug 5366,2021-02-01,03:00:00,3,2,1,FMN GV 16 Berchem TOT
54,Posthofbrug 5366,2021-02-01,04:00:00,3,3,0,FMN GV 16 Berchem TOT
54,Posthofbrug 5366,2021-02-01,05:00:00,21,16,5,FMN GV 16 Berchem TOT
54,Posthofbrug 5366,2021-02-01,06:00:00,58,47,11,FMN GV 16 Berchem TOT
54,Posthofbrug 5366,2021-02-01,07:00:00,214,164,50,FMN GV 16 Berchem TOT
54,Posthofbrug 5366,2021-02-01,08:00:00,300,230,70,FMN GV 16 Berchem TOT
54,Posthofbrug 5366,2021-02-01,09:00:00,114,89,25,FMN GV 16 Berchem TOT
54,Posthofbrug 5366,2021-02-01,10:00:00,72,48,24,FMN GV 16 Berchem TOT
54,Posthofbrug 5366,2021-02-01,11:00:00,67,31,36,FMN GV 16 Berchem TOT
54,Posthofbrug 5366,2021-02-01,12:00:00,95,48,47,FMN GV 16 Berchem TOT
54,Posthofbrug 5366,2021-02-01,13:00:00,89,45,44,FMN GV 16 Berchem TOT
54,Posthofbrug 5366,2021-02-01,14:00:00,91,42,49,FMN GV 16 Berchem TOT
54,Posthofbrug 5366,2021-02-01,15:00:00,133,53,80,FMN GV 16 Berchem TOT
54,Posthofbrug 5366,2021-02-01,16:00:00,233,71,162,FMN GV 16 Berchem TOT
54,Posthofbrug 5366,2021-02-01,17:00:00,263,70,193,FMN GV 16 Berchem TOT
54,Posthofbrug 5366,2021-02-01,18:00:00,137,39,98,FMN GV 16 Berchem TOT
54,Posthofbrug 5366,2021-02-01,19:00:00,87,38,49,FMN GV 16 Berchem TOT
54,Posthofbrug 5366,2021-02-01,20:00:00,36,22,14,FMN GV 16 Berchem TOT
54,Posthofbrug 5366,2021-02-01,21:00:00,26,13,13,FMN GV 16 Berchem TOT
54,Posthofbrug 5366,2021-02-01,22:00:00,19,8,11,FMN GV 16 Berchem TOT
54,Posthofbrug 5366,2021-02-01,23:00:00,23,5,18,FMN GV 16 Berchem TOT
54,Posthofbrug 5366,2021-02-02,00:00:00,0,0,0,FMN GV 16 Berchem TOT
54,Posthofbrug 5366,2021-02-02,01:00:00,1,1,0,FMN GV 16 Berchem TOT
54,Posthofbrug 5366,2021-02-02,02:00:00,0,0,0,FMN GV 16 Berchem TOT
54,Posthofbrug 5366,2021-02-02,03:00:00,1,1,0,FMN GV 16 Berchem TOT
54,Posthofbrug 5366,2021-02-02,04:00:00,9,8,1,FMN GV 16 Berchem TOT
54,Posthofbrug 5366,2021-02-02,05:00:00,15,9,6,FMN GV 16 Berchem TOT
54,Posthofbrug 5366,2021-02-02,06:00:00,65,56,9,FMN GV 16 Berchem TOT
54,Posthofbrug 5366,2021-02-02,07:00:00,190,147,43,FMN GV 16 Berchem TOT
54,Posthofbrug 5366,2021-02-02,08:00:00,235,178,57,FMN GV 16 Berchem TOT
54,Posthofbrug 5366,2021-02-02,09:00:00,100,74,26,FMN GV 16 Berchem TOT
54,Posthofbrug 5366,2021-02-02,10:00:00,40,28,12,FMN GV 16 Berchem TOT
54,Posthofbrug 5366,2021-02-02,11:00:00,50,27,23,FMN GV 16 Berchem TOT
54,Posthofbrug 5366,2021-02-02,12:00:00,71,37,34,FMN GV 16 Berchem TOT
54,Posthofbrug 5366,2021-02-02,13:00:00,66,34,32,FMN GV 16 Berchem TOT
54,Posthofbrug 5366,2021-02-02,14:00:00,87,42,45,FMN GV 16 Berchem TOT
54,Posthofbrug 5366,2021-02-02,15:00:00,123,42,81,FMN GV 16 Berchem TOT
54,Posthofbrug 5366,2021-02-02,16:00:00,202,65,137,FMN GV 16 Berchem TOT
54,Posthofbrug 5366,2021-02-02,17:00:00,210,62,148,FMN GV 16 Berchem TOT
54,Posthofbrug 5366,2021-02-02,18:00:00,150,51,99,FMN GV 16 Berchem TOT
54,Posthofbrug 5366,2021-02-02,19:00:00,59,22,37,FMN GV 16 Berchem TOT
54,Posthofbrug 5366,2021-02-02,20:00:00,45,18,27,FMN GV 16 Berchem TOT
54,Posthofbrug 5366,2021-02-02,21:00:00,28,16,12,FMN GV 16 Berchem TOT
54,Posthofbrug 5366,2021-02-02,22:00:00,29,14,15,FMN GV 16 Berchem TOT
54,Posthofbrug 5366,2021-02-02,23:00:00,24,10,14,FMN GV 16 Berchem TOT
54,Posthofbrug 5366,2021-02-03,00:00:00,2,2,0,FMN GV 16 Berchem TOT
54,Posthofbrug 5366,2021-02-03,01:00:00,1,1,0,FMN GV 16 Berchem TOT
54,Posthofbrug 5366,2021-02-03,02:00:00,0,0,0,FMN GV 16 Berchem TOT
54,Posthofbrug 5366,2021-02-03,03:00:00,1,1,0,FMN GV 16 Berchem TOT
54,Posthofbrug 5366,2021-02-03,04:00:00,3,2,1,FMN GV 16 Berchem TOT
54,Posthofbrug 5366,2021-02-03,05:00:00,17,14,3,FMN GV 16 Berchem TOT
54,Posthofbrug 5366,2021-02-03,06:00:00,71,56,15,FMN GV 16 Berchem TOT
54,Posthofbrug 5366,2021-02-03,07:00:00,165,114,51,FMN GV 16 Berchem TOT
54,Posthofbrug 5366,2021-02-03,08:00:00,220,164,56,FMN GV 16 Berchem TOT
54,Posthofbrug 5366,2021-02-03,09:00:00,70,47,23,FMN GV 16 Berchem TOT
54,Posthofbrug 5366,2021-02-03,10:00:00,25,14,11,FMN GV 16 Berchem TOT
54,Posthofbrug 5366,2021-02-03,11:00:00,36,13,23,FMN GV 16 Berchem TOT
54,Posthofbrug 5366,2021-02-03,12:00:00,99,44,55,FMN GV 16 Berchem TOT
54,Posthofbrug 5366,2021-02-03,13:00:00,75,29,46,FMN GV 16 Berchem TOT
54,Posthofbrug 5366,2021-02-03,14:00:00,55,19,36,FMN GV 16 Berchem TOT
54,Posthofbrug 5366,2021-02-03,15:00:00,81,34,47,FMN GV 16 Berchem TOT
54,Posthofbrug 5366,2021-02-03,16:00:00,100,30,70,FMN GV 16 Berchem TOT
54,Posthofbrug 5366,2021-02-03,17:00:00,160,61,99,FMN GV 16 Berchem TOT
54,Posthofbrug 5366,2021-02-03,18:00:00,128,53,75,FMN GV 16 Berchem TOT
54,Posthofbrug 5366,2021-02-03,19:00:00,49,24,25,FMN GV 16 Berchem TOT
54,Posthofbrug 5366,2021-02-03,20:00:00,43,20,23,FMN GV 16 Berchem TOT
54,Posthofbrug 5366,2021-02-03,21:00:00,17,5,12,FMN GV 16 Berchem TOT
54,Posthofbrug 5366,2021-02-03,22:00:00,19,7,12,FMN GV 16 Berchem TOT
54,Posthofbrug 5366,2021-02-03,23:00:00,16,7,9,FMN GV 16 Berchem TOT
54,Posthofbrug 5366,2021-02-04,00:00:00,1,0,1,FMN GV 16 Berchem TOT
54,Posthofbrug 5366,2021-02-04,01:00:00,1,0,1,FMN GV 16 Berchem TOT
54,Posthofbrug 5366,2021-02-04,02:00:00,1,0,1,FMN GV 16 Berchem TOT
54,Posthofbrug 5366,2021-02-04,03:00:00,0,0,0,FMN GV 16 Berchem TOT
54,Posthofbrug 5366,2021-02-04,04:00:00,4,3,1,FMN GV 16 Berchem TOT
54,Posthofbrug 5366,2021-02-04,05:00:00,18,13,5,FMN GV 16 Berchem TOT
54,Posthofbrug 5366,2021-02-04,06:00:00,65,51,14,FMN GV 16 Berchem TOT
54,Posthofbrug 5366,2021-02-04,07:00:00,223,164,59,FMN GV 16 Berchem TOT
54,Posthofbrug 5366,2021-02-04,08:00:00,320,239,81,FMN GV 16 Berchem TOT
54,Posthofbrug 5366,2021-02-04,09:00:00,142,106,36,FMN GV 16 Berchem TOT
54,Posthofbrug 5366,2021-02-04,10:00:00,90,53,37,FMN GV 16 Berchem TOT
54,Posthofbrug 5366,2021-02-04,11:00:00,101,55,46,FMN GV 16 Berchem TOT
54,Posthofbrug 5366,2021-02-04,12:00:00,142,87,55,FMN GV 16 Berchem TOT
54,Posthofbrug 5366,2021-02-04,13:00:00,163,96,67,FMN GV 16 Berchem TOT
54,Posthofbrug 5366,2021-02-04,14:00:00,148,61,87,FMN GV 16 Berchem TOT
54,Posthofbrug 5366,2021-02-04,15:00:00,177,79,98,FMN GV 16 Berchem TOT
54,Posthofbrug 5366,2021-02-04,16:00:00,291,95,196,FMN GV 16 Berchem TOT
54,Posthofbrug 5366,2021-02-04,17:00:00,272,82,190,FMN GV 16 Berchem TOT
54,Posthofbrug 5366,2021-02-04,18:00:00,181,61,120,FMN GV 16 Berchem TOT
54,Posthofbrug 5366,2021-02-04,19:00:00,93,41,52,FMN GV 16 Berchem TOT
54,Posthofbrug 5366,2021-02-04,20:00:00,73,39,34,FMN GV 16 Berchem TOT
54,Posthofbrug 5366,2021-02-04,21:00:00,44,22,22,FMN GV 16 Berchem TOT
54,Posthofbrug 5366,2021-02-04,22:00:00,45,15,30,FMN GV 16 Berchem TOT
54,Posthofbrug 5366,2021-02-04,23:00:00,35,10,25,FMN GV 16 Berchem TOT
54,Posthofbrug 5366,2021-02-05,00:00:00,7,3,4,FMN GV 16 Berchem TOT
54,Posthofbrug 5366,2021-02-05,01:00:00,2,0,2,FMN GV 16 Berchem TOT
54,Posthofbrug 5366,2021-02-05,02:00:00,1,0,1,FMN GV 16 Berchem TOT
54,Posthofbrug 5366,2021-02-05,03:00:00,2,2,0,FMN GV 16 Berchem TOT
54,Posthofbrug 5366,2021-02-05,04:00:00,8,7,1,FMN GV 16 Berchem TOT
54,Posthofbrug 5366,2021-02-05,05:00:00,16,13,3,FMN GV 16 Berchem TOT
54,Posthofbrug 5366,2021-02-05,06:00:00,64,44,20,FMN GV 16 Berchem TOT
54,Posthofbrug 5366,2021-02-05,07:00:00,186,139,47,FMN GV 16 Berchem TOT
54,Posthofbrug 5366,2021-02-05,08:00:00,309,228,81,FMN GV 16 Berchem TOT
54,Posthofbrug 5366,2021-02-05,09:00:00,116,86,30,FMN GV 16 Berchem TOT
54,Posthofbrug 5366,2021-02-05,10:00:00,87,57,30,FMN GV 16 Berchem TOT
54,Posthofbrug 5366,2021-02-05,11:00:00,102,56,46,FMN GV 16 Berchem TOT
54,Posthofbrug 5366,2021-02-05,12:00:00,120,63,57,FMN GV 16 Berchem TOT
54,Posthofbrug 5366,2021-02-05,13:00:00,135,73,62,FMN GV 16 Berchem TOT
54,Posthofbrug 5366,2021-02-05,14:00:00,127,63,64,FMN GV 16 Berchem TOT
54,Posthofbrug 5366,2021-02-05,15:00:00,189,78,111,FMN GV 16 Berchem TOT
54,Posthofbrug 5366,2021-02-05,16:00:00,264,80,184,FMN GV 16 Berchem TOT
54,Posthofbrug 5366,2021-02-05,17:00:00,259,83,176,FMN GV 16 Berchem TOT
54,Posthofbrug 5366,2021-02-05,18:00:00,166,61,105,FMN GV 16 Berchem TOT
54,Posthofbrug 5366,2021-02-05,19:00:00,82,40,42,FMN GV 16 Berchem TOT
54,Posthofbrug 5366,2021-02-05,20:00:00,66,36,30,FMN GV 16 Berchem TOT
54,Posthofbrug 5366,2021-02-05,21:00:00,27,16,11,FMN GV 16 Berchem TOT
54,Posthofbrug 5366,2021-02-05,22:00:00,37,17,20,FMN GV 16 Berchem TOT
54,Posthofbrug 5366,2021-02-05,23:00:00,80,34,46,FMN GV 16 Berchem TOT
54,Posthofbrug 5366,2021-02-06,00:00:00,6,3,3,FMN GV 16 Berchem TOT
54,Posthofbrug 5366,2021-02-06,01:00:00,4,1,3,FMN GV 16 Berchem TOT
54,Posthofbrug 5366,2021-02-06,02:00:00,0,0,0,FMN GV 16 Berchem TOT
54,Posthofbrug 5366,2021-02-06,03:00:00,0,0,0,FMN GV 16 Berchem TOT
54,Posthofbrug 5366,2021-02-06,04:00:00,3,2,1,FMN GV 16 Berchem TOT
54,Posthofbrug 5366,2021-02-06,05:00:00,6,3,3,FMN GV 16 Berchem TOT
54,Posthofbrug 5366,2021-02-06,06:00:00,10,7,3,FMN GV 16 Berchem TOT
54,Posthofbrug 5366,2021-02-06,07:00:00,30,13,17,FMN GV 16 Berchem TOT
54,Posthofbrug 5366,2021-02-06,08:00:00,31,20,11,FMN GV 16 Berchem TOT
54,Posthofbrug 5366,2021-02-06,09:00:00,89,49,40,FMN GV 16 Berchem TOT
54,Posthofbrug 5366,2021-02-06,10:00:00,93,59,34,FMN GV 16 Berchem TOT
54,Posthofbrug 5366,2021-02-06,11:00:00,97,59,38,FMN GV 16 Berchem TOT
54,Posthofbrug 5366,2021-02-06,12:00:00,115,51,64,FMN GV 16 Berchem TOT
54,Posthofbrug 5366,2021-02-06,13:00:00,126,72,54,FMN GV 16 Berchem TOT
54,Posthofbrug 5366,2021-02-06,14:00:00,104,65,39,FMN GV 16 Berchem TOT
54,Posthofbrug 5366,2021-02-06,15:00:00,121,54,67,FMN GV 16 Berchem TOT
54,Posthofbrug 5366,2021-02-06,16:00:00,91,49,42,FMN GV 16 Berchem TOT
54,Posthofbrug 5366,2021-02-06,17:00:00,82,35,47,FMN GV 16 Berchem TOT
54,Posthofbrug 5366,2021-02-06,18:00:00,73,22,51,FMN GV 16 Berchem TOT
54,Posthofbrug 5366,2021-02-06,19:00:00,29,11,18,FMN GV 16 Berchem TOT
54,Posthofbrug 5366,2021-02-06,20:00:00,37,19,18,FMN GV 16 Berchem TOT
54,Posthofbrug 5366,2021-02-06,21:00:00,14,12,2,FMN GV 16 Berchem TOT
54,Posthofbrug 5366,2021-02-06,22:00:00,23,10,13,FMN GV 16 Berchem TOT
54,Posthofbrug 5366,2021-02-06,23:00:00,33,14,19,FMN GV 16 Berchem TOT
54,Posthofbrug 5366,2021-02-07,00:00:00,10,3,7,FMN GV 16 Berchem TOT
54,Posthofbrug 5366,2021-02-07,01:00:00,0,0,0,FMN GV 16 Berchem TOT
54,Posthofbrug 5366,2021-02-07,02:00:00,0,0,0,FMN GV 16 Berchem TOT
54,Posthofbrug 5366,2021-02-07,03:00:00,0,0,0,FMN GV 16 Berchem TOT
54,Posthofbrug 5366,2021-02-07,04:00:00,0,0,0,FMN GV 16 Berchem TOT
54,Posthofbrug 5366,2021-02-07,05:00:00,4,3,1,FMN GV 16 Berchem TOT
54,Posthofbrug 5366,2021-02-07,06:00:00,6,5,1,FMN GV 16 Berchem TOT
54,Posthofbrug 5366,2021-02-07,07:00:00,6,3,3,FMN GV 16 Berchem TOT
54,Posthofbrug 5366,2021-02-07,08:00:00,15,10,5,FMN GV 16 Berchem TOT
54,Posthofbrug 5366,2021-02-07,09:00:00,18,8,10,FMN GV 16 Berchem TOT
54,Posthofbrug 5366,2021-02-07,10:00:00,19,12,7,FMN GV 16 Berchem TOT
54,Posthofbrug 5366,2021-02-07,11:00:00,19,8,11,FMN GV 16 Berchem TOT
54,Posthofbrug 5366,2021-02-07,12:00:00,32,17,15,FMN GV 16 Berchem TOT
54,Posthofbrug 5366,2021-02-07,13:00:00,18,12,6,FMN GV 16 Berchem TOT
54,Posthofbrug 5366,2021-02-07,14:00:00,18,13,5,FMN GV 16 Berchem TOT
54,Posthofbrug 5366,2021-02-07,15:00:00,13,7,6,FMN GV 16 Berchem TOT
54,Posthofbrug 5366,2021-02-07,16:00:00,23,13,10,FMN GV 16 Berchem TOT
54,Posthofbrug 5366,2021-02-07,17:00:00,21,12,9,FMN GV 16 Berchem TOT
54,Posthofbrug 5366,2021-02-07,18:00:00,15,7,8,FMN GV 16 Berchem TOT
54,Posthofbrug 5366,2021-02-07,19:00:00,8,7,1,FMN GV 16 Berchem TOT
54,Posthofbrug 5366,2021-02-07,20:00:00,5,5,0,FMN GV 16 Berchem TOT
54,Posthofbrug 5366,2021-02-07,21:00:00,3,2,1,FMN GV 16 Berchem TOT
54,Posthofbrug 5366,2021-02-07,22:00:00,1,0,1,FMN GV 16 Berchem TOT
54,Posthofbrug 5366,2021-02-07,23:00:00,5,4,1,FMN GV 16 Berchem TOT
54,Posthofbrug 5366,2021-02-08,00:00:00,1,1,0,FMN GV 16 Berchem TOT
54,Posthofbrug 5366,2021-02-08,01:00:00,1,0,1,FMN GV 16 Berchem TOT
54,Posthofbrug 5366,2021-02-08,02:00:00,0,0,0,FMN GV 16 Berchem TOT
54,Posthofbrug 5366,2021-02-08,03:00:00,0,0,0,FMN GV 16 Berchem TOT
54,Posthofbrug 5366,2021-02-08,04:00:00,3,3,0,FMN GV 16 Berchem TOT
54,Posthofbrug 5366,2021-02-08,05:00:00,6,4,2,FMN GV 16 Berchem TOT
54,Posthofbrug 5366,2021-02-08,06:00:00,21,19,2,FMN GV 16 Berchem TOT
54,Posthofbrug 5366,2021-02-08,07:00:00,49,36,13,FMN GV 16 Berchem TOT
54,Posthofbrug 5366,2021-02-08,08:00:00,69,56,13,FMN GV 16 Berchem TOT
54,Posthofbrug 5366,2021-02-08,09:00:00,23,21,2,FMN GV 16 Berchem TOT
54,Posthofbrug 5366,2021-02-08,10:00:00,24,17,7,FMN GV 16 Berchem TOT
54,Posthofbrug 5366,2021-02-08,11:00:00,11,6,5,FMN GV 16 Berchem TOT
54,Posthofbrug 5366,2021-02-08,12:00:00,36,24,12,FMN GV 16 Berchem TOT
54,Posthofbrug 5366,2021-02-08,13:00:00,14,9,5,FMN GV 16 Berchem TOT
54,Posthofbrug 5366,2021-02-08,14:00:00,33,16,17,FMN GV 16 Berchem TOT
54,Posthofbrug 5366,2021-02-08,15:00:00,24,10,14,FMN GV 16 Berchem TOT
54,Posthofbrug 5366,2021-02-08,16:00:00,70,21,49,FMN GV 16 Berchem TOT
54,Posthofbrug 5366,2021-02-08,17:00:00,83,29,54,FMN GV 16 Berchem TOT
54,Posthofbrug 5366,2021-02-08,18:00:00,53,22,31,FMN GV 16 Berchem TOT
54,Posthofbrug 5366,2021-02-08,19:00:00,16,5,11,FMN GV 16 Berchem TOT
54,Posthofbrug 5366,2021-02-08,20:00:00,13,5,8,FMN GV 16 Berchem TOT
54,Posthofbrug 5366,2021-02-08,21:00:00,7,4,3,FMN GV 16 Berchem TOT
54,Posthofbrug 5366,2021-02-08,22:00:00,14,6,8,FMN GV 16 Berchem TOT
54,Posthofbrug 5366,2021-02-08,23:00:00,5,3,2,FMN GV 16 Berchem TOT
54,Posthofbrug 5366,2021-02-09,00:00:00,0,0,0,FMN GV 16 Berchem TOT
54,Posthofbrug 5366,2021-02-09,01:00:00,0,0,0,FMN GV 16 Berchem TOT
54,Posthofbrug 5366,2021-02-09,02:00:00,0,0,0,FMN GV 16 Berchem TOT
54,Posthofbrug 5366,2021-02-09,03:00:00,17,8,9,FMN GV 16 Berchem TOT
54,Posthofbrug 5366,2021-02-09,04:00:00,4,4,0,FMN GV 16 Berchem TOT
54,Posthofbrug 5366,2021-02-09,05:00:00,8,6,2,FMN GV 16 Berchem TOT
54,Posthofbrug 5366,2021-02-09,06:00:00,18,17,1,FMN GV 16 Berchem TOT
54,Posthofbrug 5366,2021-02-09,07:00:00,47,30,17,FMN GV 16 Berchem TOT
54,Posthofbrug 5366,2021-02-09,08:00:00,85,56,29,FMN GV 16 Berchem TOT
54,Posthofbrug 5366,2021-02-09,09:00:00,44,34,10,FMN GV 16 Berchem TOT
54,Posthofbrug 5366,2021-02-09,10:00:00,17,9,8,FMN GV 16 Berchem TOT
54,Posthofbrug 5366,2021-02-09,11:00:00,20,11,9,FMN GV 16 Berchem TOT
54,Posthofbrug 5366,2021-02-09,12:00:00,20,12,8,FMN GV 16 Berchem TOT
54,Posthofbrug 5366,2021-02-09,13:00:00,43,23,20,FMN GV 16 Berchem TOT
54,Posthofbrug 5366,2021-02-09,14:00:00,47,23,24,FMN GV 16 Berchem TOT
54,Posthofbrug 5366,2021-02-09,15:00:00,75,25,50,FMN GV 16 Berchem TOT
54,Posthofbrug 5366,2021-02-09,16:00:00,67,29,38,FMN GV 16 Berchem TOT
54,Posthofbrug 5366,2021-02-09,17:00:00,100,36,64,FMN GV 16 Berchem TOT
54,Posthofbrug 5366,2021-02-09,18:00:00,66,20,46,FMN GV 16 Berchem TOT
54,Posthofbrug 5366,2021-02-09,19:00:00,29,9,20,FMN GV 16 Berchem TOT
54,Posthofbrug 5366,2021-02-09,20:00:00,16,7,9,FMN GV 16 Berchem TOT
54,Posthofbrug 5366,2021-02-09,21:00:00,10,7,3,FMN GV 16 Berchem TOT
54,Posthofbrug 5366,2021-02-09,22:00:00,20,7,13,FMN GV 16 Berchem TOT
54,Posthofbrug 5366,2021-02-09,23:00:00,29,11,18,FMN GV 16 Berchem TOT
54,Posthofbrug 5366,2021-02-10,00:00:00,4,1,3,FMN GV 16 Berchem TOT
54,Posthofbrug 5366,2021-02-10,01:00:00,1,1,0,FMN GV 16 Berchem TOT
54,Posthofbrug 5366,2021-02-10,02:00:00,0,0,0,FMN GV 16 Berchem TOT
54,Posthofbrug 5366,2021-02-10,03:00:00,1,1,0,FMN GV 16 Berchem TOT
54,Posthofbrug 5366,2021-02-10,04:00:00,6,6,0,FMN GV 16 Berchem TOT
54,Posthofbrug 5366,2021-02-10,05:00:00,9,7,2,FMN GV 16 Berchem TOT
54,Posthofbrug 5366,2021-02-10,06:00:00,32,21,11,FMN GV 16 Berchem TOT
54,Posthofbrug 5366,2021-02-10,07:00:00,85,62,23,FMN GV 16 Berchem TOT
54,Posthofbrug 5366,2021-02-10,08:00:00,119,81,38,FMN GV 16 Berchem TOT
54,Posthofbrug 5366,2021-02-10,09:00:00,47,29,18,FMN GV 16 Berchem TOT
54,Posthofbrug 5366,2021-02-10,10:00:00,24,16,8,FMN GV 16 Berchem TOT
54,Posthofbrug 5366,2021-02-10,11:00:00,40,24,16,FMN GV 16 Berchem TOT
54,Posthofbrug 5366,2021-02-10,12:00:00,77,35,42,FMN GV 16 Berchem TOT
54,Posthofbrug 5366,2021-02-10,13:00:00,64,31,33,FMN GV 16 Berchem TOT
54,Posthofbrug 5366,2021-02-10,14:00:00,46,19,27,FMN GV 16 Berchem TOT
54,Posthofbrug 5366,2021-02-10,15:00:00,76,39,37,FMN GV 16 Berchem TOT
54,Posthofbrug 5366,2021-02-10,16:00:00,74,25,49,FMN GV 16 Berchem TOT
54,Posthofbrug 5366,2021-02-10,17:00:00,95,39,56,FMN GV 16 Berchem TOT
54,Posthofbrug 5366,2021-02-10,18:00:00,76,28,48,FMN GV 16 Berchem TOT
54,Posthofbrug 5366,2021-02-10,19:00:00,34,13,21,FMN GV 16 Berchem TOT
54,Posthofbrug 5366,2021-02-10,20:00:00,31,17,14,FMN GV 16 Berchem TOT
54,Posthofbrug 5366,2021-02-10,21:00:00,17,8,9,FMN GV 16 Berchem TOT
54,Posthofbrug 5366,2021-02-10,22:00:00,17,7,10,FMN GV 16 Berchem TOT
54,Posthofbrug 5366,2021-02-10,23:00:00,29,11,18,FMN GV 16 Berchem TOT
54,Posthofbrug 5366,2021-02-11,00:00:00,1,0,1,FMN GV 16 Berchem TOT
54,Posthofbrug 5366,2021-02-11,01:00:00,0,0,0,FMN GV 16 Berchem TOT
54,Posthofbrug 5366,2021-02-11,02:00:00,0,0,0,FMN GV 16 Berchem TOT
54,Posthofbrug 5366,2021-02-11,03:00:00,0,0,0,FMN GV 16 Berchem TOT
54,Posthofbrug 5366,2021-02-11,04:00:00,3,3,0,FMN GV 16 Berchem TOT
54,Posthofbrug 5366,2021-02-11,05:00:00,6,3,3,FMN GV 16 Berchem TOT
54,Posthofbrug 5366,2021-02-11,06:00:00,29,22,7,FMN GV 16 Berchem TOT
54,Posthofbrug 5366,2021-02-11,07:00:00,96,70,26,FMN GV 16 Berchem TOT
54,Posthofbrug 5366,2021-02-11,08:00:00,139,97,42,FMN GV 16 Berchem TOT
54,Posthofbrug 5366,2021-02-11,09:00:00,61,51,10,FMN GV 16 Berchem TOT
54,Posthofbrug 5366,2021-02-11,10:00:00,30,19,11,FMN GV 16 Berchem TOT
54,Posthofbrug 5366,2021-02-11,11:00:00,34,15,19,FMN GV 16 Berchem TOT
54,Posthofbrug 5366,2021-02-11,12:00:00,47,24,23,FMN GV 16 Berchem TOT
54,Posthofbrug 5366,2021-02-11,13:00:00,56,34,22,FMN GV 16 Berchem TOT
54,Posthofbrug 5366,2021-02-11,14:00:00,47,23,24,FMN GV 16 Berchem TOT
54,Posthofbrug 5366,2021-02-11,15:00:00,79,27,52,FMN GV 16 Berchem TOT
54,Posthofbrug 5366,2021-02-11,16:00:00,112,41,71,FMN GV 16 Berchem TOT
54,Posthofbrug 5366,2021-02-11,17:00:00,134,39,95,FMN GV 16 Berchem TOT
54,Posthofbrug 5366,2021-02-11,18:00:00,94,33,61,FMN GV 16 Berchem TOT
54,Posthofbrug 5366,2021-02-11,19:00:00,47,17,30,FMN GV 16 Berchem TOT
54,Posthofbrug 5366,2021-02-11,20:00:00,15,7,8,FMN GV 16 Berchem TOT
54,Posthofbrug 5366,2021-02-11,21:00:00,19,12,7,FMN GV 16 Berchem TOT
54,Posthofbrug 5366,2021-02-11,22:00:00,24,9,15,FMN GV 16 Berchem TOT
54,Posthofbrug 5366,2021-02-11,23:00:00,12,2,10,FMN GV 16 Berchem TOT
54,Posthofbrug 5366,2021-02-12,00:00:00,7,5,2,FMN GV 16 Berchem TOT
54,Posthofbrug 5366,2021-02-12,01:00:00,0,0,0,FMN GV 16 Berchem TOT
54,Posthofbrug 5366,2021-02-12,02:00:00,0,0,0,FMN GV 16 Berchem TOT
54,Posthofbrug 5366,2021-02-12,03:00:00,0,0,0,FMN GV 16 Berchem TOT
54,Posthofbrug 5366,2021-02-12,04:00:00,5,5,0,FMN GV 16 Berchem TOT
54,Posthofbrug 5366,2021-02-12,05:00:00,9,3,6,FMN GV 16 Berchem TOT
54,Posthofbrug 5366,2021-02-12,06:00:00,34,27,7,FMN GV 16 Berchem TOT
54,Posthofbrug 5366,2021-02-12,07:00:00,95,67,28,FMN GV 16 Berchem TOT
54,Posthofbrug 5366,2021-02-12,08:00:00,150,111,39,FMN GV 16 Berchem TOT
54,Posthofbrug 5366,2021-02-12,09:00:00,57,40,17,FMN GV 16 Berchem TOT
54,Posthofbrug 5366,2021-02-12,10:00:00,47,29,18,FMN GV 16 Berchem TOT
54,Posthofbrug 5366,2021-02-12,11:00:00,35,23,12,FMN GV 16 Berchem TOT
54,Posthofbrug 5366,2021-02-12,12:00:00,65,25,40,FMN GV 16 Berchem TOT
54,Posthofbrug 5366,2021-02-12,13:00:00,65,37,28,FMN GV 16 Berchem TOT
54,Posthofbrug 5366,2021-02-12,14:00:00,71,44,27,FMN GV 16 Berchem TOT
54,Posthofbrug 5366,2021-02-12,15:00:00,105,46,59,FMN GV 16 Berchem TOT
54,Posthofbrug 5366,2021-02-12,16:00:00,108,30,78,FMN GV 16 Berchem TOT
54,Posthofbrug 5366,2021-02-12,17:00:00,118,40,78,FMN GV 16 Berchem TOT
54,Posthofbrug 5366,2021-02-12,18:00:00,97,41,56,FMN GV 16 Berchem TOT
54,Posthofbrug 5366,2021-02-12,19:00:00,54,27,27,FMN GV 16 Berchem TOT
54,Posthofbrug 5366,2021-02-12,20:00:00,30,14,16,FMN GV 16 Berchem TOT
54,Posthofbrug 5366,2021-02-12,21:00:00,19,8,11,FMN GV 16 Berchem TOT
54,Posthofbrug 5366,2021-02-12,22:00:00,27,10,17,FMN GV 16 Berchem TOT
54,Posthofbrug 5366,2021-02-12,23:00:00,45,21,24,FMN GV 16 Berchem TOT
54,Posthofbrug 5366,2021-02-13,00:00:00,10,4,6,FMN GV 16 Berchem TOT
54,Posthofbrug 5366,2021-02-13,01:00:00,1,0,1,FMN GV 16 Berchem TOT
54,Posthofbrug 5366,2021-02-13,02:00:00,1,0,1,FMN GV 16 Berchem TOT
54,Posthofbrug 5366,2021-02-13,03:00:00,0,0,0,FMN GV 16 Berchem TOT
54,Posthofbrug 5366,2021-02-13,04:00:00,3,2,1,FMN GV 16 Berchem TOT
54,Posthofbrug 5366,2021-02-13,05:00:00,3,2,1,FMN GV 16 Berchem TOT
54,Posthofbrug 5366,2021-02-13,06:00:00,16,11,5,FMN GV 16 Berchem TOT
54,Posthofbrug 5366,2021-02-13,07:00:00,14,7,7,FMN GV 16 Berchem TOT
54,Posthofbrug 5366,2021-02-13,08:00:00,33,19,14,FMN GV 16 Berchem TOT
54,Posthofbrug 5366,2021-02-13,09:00:00,47,29,18,FMN GV 16 Berchem TOT
54,Posthofbrug 5366,2021-02-13,10:00:00,48,22,26,FMN GV 16 Berchem TOT
54,Posthofbrug 5366,2021-02-13,11:00:00,70,47,23,FMN GV 16 Berchem TOT
54,Posthofbrug 5366,2021-02-13,12:00:00,62,31,31,FMN GV 16 Berchem TOT
54,Posthofbrug 5366,2021-02-13,13:00:00,97,52,45,FMN GV 16 Berchem TOT
54,Posthofbrug 5366,2021-02-13,14:00:00,86,37,49,FMN GV 16 Berchem TOT
54,Posthofbrug 5366,2021-02-13,15:00:00,69,37,32,FMN GV 16 Berchem TOT
54,Posthofbrug 5366,2021-02-13,16:00:00,72,30,42,FMN GV 16 Berchem TOT
54,Posthofbrug 5366,2021-02-13,17:00:00,81,34,47,FMN GV 16 Berchem TOT
54,Posthofbrug 5366,2021-02-13,18:00:00,47,20,27,FMN GV 16 Berchem TOT
54,Posthofbrug 5366,2021-02-13,19:00:00,33,9,24,FMN GV 16 Berchem TOT
54,Posthofbrug 5366,2021-02-13,20:00:00,24,15,9,FMN GV 16 Berchem TOT
54,Posthofbrug 5366,2021-02-13,21:00:00,18,15,3,FMN GV 16 Berchem TOT
54,Posthofbrug 5366,2021-02-13,22:00:00,17,8,9,FMN GV 16 Berchem TOT
54,Posthofbrug 5366,2021-02-13,23:00:00,29,14,15,FMN GV 16 Berchem TOT
54,Posthofbrug 5366,2021-02-14,00:00:00,20,12,8,FMN GV 16 Berchem TOT
54,Posthofbrug 5366,2021-02-14,01:00:00,0,0,0,FMN GV 16 Berchem TOT
54,Posthofbrug 5366,2021-02-14,02:00:00,2,0,2,FMN GV 16 Berchem TOT
54,Posthofbrug 5366,2021-02-14,03:00:00,1,1,0,FMN GV 16 Berchem TOT
54,Posthofbrug 5366,2021-02-14,04:00:00,0,0,0,FMN GV 16 Berchem TOT
54,Posthofbrug 5366,2021-02-14,05:00:00,5,4,1,FMN GV 16 Berchem TOT
54,Posthofbrug 5366,2021-02-14,06:00:00,16,11,5,FMN GV 16 Berchem TOT
54,Posthofbrug 5366,2021-02-14,07:00:00,11,9,2,FMN GV 16 Berchem TOT
54,Posthofbrug 5366,2021-02-14,08:00:00,23,15,8,FMN GV 16 Berchem TOT
54,Posthofbrug 5366,2021-02-14,09:00:00,48,32,16,FMN GV 16 Berchem TOT
54,Posthofbrug 5366,2021-02-14,10:00:00,64,40,24,FMN GV 16 Berchem TOT
54,Posthofbrug 5366,2021-02-14,11:00:00,54,35,19,FMN GV 16 Berchem TOT
54,Posthofbrug 5366,2021-02-14,12:00:00,83,39,44,FMN GV 16 Berchem TOT
54,Posthofbrug 5366,2021-02-14,13:00:00,81,41,40,FMN GV 16 Berchem TOT
54,Posthofbrug 5366,2021-02-14,14:00:00,55,25,30,FMN GV 16 Berchem TOT
54,Posthofbrug 5366,2021-02-14,15:00:00,68,31,37,FMN GV 16 Berchem TOT
54,Posthofbrug 5366,2021-02-14,16:00:00,73,37,36,FMN GV 16 Berchem TOT
54,Posthofbrug 5366,2021-02-14,17:00:00,61,23,38,FMN GV 16 Berchem TOT
54,Posthofbrug 5366,2021-02-14,18:00:00,56,26,30,FMN GV 16 Berchem TOT
54,Posthofbrug 5366,2021-02-14,19:00:00,24,8,16,FMN GV 16 Berchem TOT
54,Posthofbrug 5366,2021-02-14,20:00:00,22,8,14,FMN GV 16 Berchem TOT
54,Posthofbrug 5366,2021-02-14,21:00:00,22,12,10,FMN GV 16 Berchem TOT
54,Posthofbrug 5366,2021-02-14,22:00:00,18,11,7,FMN GV 16 Berchem TOT
54,Posthofbrug 5366,2021-02-14,23:00:00,13,4,9,FMN GV 16 Berchem TOT
54,Posthofbrug 5366,2021-02-15,00:00:00,5,1,4,FMN GV 16 Berchem TOT
54,Posthofbrug 5366,2021-02-15,01:00:00,0,0,0,FMN GV 16 Berchem TOT
54,Posthofbrug 5366,2021-02-15,02:00:00,0,0,0,FMN GV 16 Berchem TOT
54,Posthofbrug 5366,2021-02-15,03:00:00,1,0,1,FMN GV 16 Berchem TOT
54,Posthofbrug 5366,2021-02-15,04:00:00,8,5,3,FMN GV 16 Berchem TOT
54,Posthofbrug 5366,2021-02-15,05:00:00,13,7,6,FMN GV 16 Berchem TOT
54,Posthofbrug 5366,2021-02-15,06:00:00,38,31,7,FMN GV 16 Berchem TOT
54,Posthofbrug 5366,2021-02-15,07:00:00,103,65,38,FMN GV 16 Berchem TOT
54,Posthofbrug 5366,2021-02-15,08:00:00,145,104,41,FMN GV 16 Berchem TOT
54,Posthofbrug 5366,2021-02-15,09:00:00,83,62,21,FMN GV 16 Berchem TOT
54,Posthofbrug 5366,2021-02-15,10:00:00,42,29,13,FMN GV 16 Berchem TOT
54,Posthofbrug 5366,2021-02-15,11:00:00,42,26,16,FMN GV 16 Berchem TOT
54,Posthofbrug 5366,2021-02-15,12:00:00,43,20,23,FMN GV 16 Berchem TOT
54,Posthofbrug 5366,2021-02-15,13:00:00,60,35,25,FMN GV 16 Berchem TOT
54,Posthofbrug 5366,2021-02-15,14:00:00,50,22,28,FMN GV 16 Berchem TOT
54,Posthofbrug 5366,2021-02-15,15:00:00,67,23,44,FMN GV 16 Berchem TOT
54,Posthofbrug 5366,2021-02-15,16:00:00,120,45,75,FMN GV 16 Berchem TOT
54,Posthofbrug 5366,2021-02-15,17:00:00,169,61,108,FMN GV 16 Berchem TOT
54,Posthofbrug 5366,2021-02-15,18:00:00,124,32,92,FMN GV 16 Berchem TOT
54,Posthofbrug 5366,2021-02-15,19:00:00,65,30,35,FMN GV 16 Berchem TOT
54,Posthofbrug 5366,2021-02-15,20:00:00,39,21,18,FMN GV 16 Berchem TOT
54,Posthofbrug 5366,2021-02-15,21:00:00,26,21,5,FMN GV 16 Berchem TOT
54,Posthofbrug 5366,2021-02-15,22:00:00,20,10,10,FMN GV 16 Berchem TOT
54,Posthofbrug 5366,2021-02-15,23:00:00,11,3,8,FMN GV 16 Berchem TOT
54,Posthofbrug 5366,2021-02-16,00:00:00,8,4,4,FMN GV 16 Berchem TOT
54,Posthofbrug 5366,2021-02-16,01:00:00,3,2,1,FMN GV 16 Berchem TOT
54,Posthofbrug 5366,2021-02-16,02:00:00,0,0,0,FMN GV 16 Berchem TOT
54,Posthofbrug 5366,2021-02-16,03:00:00,1,0,1,FMN GV 16 Berchem TOT
54,Posthofbrug 5366,2021-02-16,04:00:00,2,2,0,FMN GV 16 Berchem TOT
54,Posthofbrug 5366,2021-02-16,05:00:00,17,10,7,FMN GV 16 Berchem TOT
54,Posthofbrug 5366,2021-02-16,06:00:00,62,49,13,FMN GV 16 Berchem TOT
54,Posthofbrug 5366,2021-02-16,07:00:00,131,93,38,FMN GV 16 Berchem TOT
54,Posthofbrug 5366,2021-02-16,08:00:00,203,153,50,FMN GV 16 Berchem TOT
54,Posthofbrug 5366,2021-02-16,09:00:00,110,83,27,FMN GV 16 Berchem TOT
54,Posthofbrug 5366,2021-02-16,10:00:00,71,45,26,FMN GV 16 Berchem TOT
54,Posthofbrug 5366,2021-02-16,11:00:00,65,33,32,FMN GV 16 Berchem TOT
54,Posthofbrug 5366,2021-02-16,12:00:00,97,55,42,FMN GV 16 Berchem TOT
54,Posthofbrug 5366,2021-02-16,13:00:00,139,81,58,FMN GV 16 Berchem TOT
54,Posthofbrug 5366,2021-02-16,14:00:00,94,44,50,FMN GV 16 Berchem TOT
54,Posthofbrug 5366,2021-02-16,15:00:00,141,56,85,FMN GV 16 Berchem TOT
54,Posthofbrug 5366,2021-02-16,16:00:00,188,67,121,FMN GV 16 Berchem TOT
54,Posthofbrug 5366,2021-02-16,17:00:00,212,69,143,FMN GV 16 Berchem TOT
54,Posthofbrug 5366,2021-02-16,18:00:00,134,45,89,FMN GV 16 Berchem TOT
54,Posthofbrug 5366,2021-02-16,19:00:00,64,29,35,FMN GV 16 Berchem TOT
54,Posthofbrug 5366,2021-02-16,20:00:00,41,21,20,FMN GV 16 Berchem TOT
54,Posthofbrug 5366,2021-02-16,21:00:00,29,17,12,FMN GV 16 Berchem TOT
54,Posthofbrug 5366,2021-02-16,22:00:00,31,12,19,FMN GV 16 Berchem TOT
54,Posthofbrug 5366,2021-02-16,23:00:00,26,12,14,FMN GV 16 Berchem TOT
54,Posthofbrug 5366,2021-02-17,00:00:00,6,4,2,FMN GV 16 Berchem TOT
54,Posthofbrug 5366,2021-02-17,01:00:00,2,1,1,FMN GV 16 Berchem TOT
54,Posthofbrug 5366,2021-02-17,02:00:00,0,0,0,FMN GV 16 Berchem TOT
54,Posthofbrug 5366,2021-02-17,03:00:00,0,0,0,FMN GV 16 Berchem TOT
54,Posthofbrug 5366,2021-02-17,04:00:00,8,5,3,FMN GV 16 Berchem TOT
54,Posthofbrug 5366,2021-02-17,05:00:00,19,14,5,FMN GV 16 Berchem TOT
54,Posthofbrug 5366,2021-02-17,06:00:00,57,44,13,FMN GV 16 Berchem TOT
54,Posthofbrug 5366,2021-02-17,07:00:00,131,85,46,FMN GV 16 Berchem TOT
54,Posthofbrug 5366,2021-02-17,08:00:00,179,116,63,FMN GV 16 Berchem TOT
54,Posthofbrug 5366,2021-02-17,09:00:00,136,101,35,FMN GV 16 Berchem TOT
54,Posthofbrug 5366,2021-02-17,10:00:00,85,57,28,FMN GV 16 Berchem TOT
54,Posthofbrug 5366,2021-02-17,11:00:00,102,54,48,FMN GV 16 Berchem TOT
54,Posthofbrug 5366,2021-02-17,12:00:00,117,68,49,FMN GV 16 Berchem TOT
54,Posthofbrug 5366,2021-02-17,13:00:00,109,61,48,FMN GV 16 Berchem TOT
54,Posthofbrug 5366,2021-02-17,14:00:00,121,62,59,FMN GV 16 Berchem TOT
54,Posthofbrug 5366,2021-02-17,15:00:00,126,55,71,FMN GV 16 Berchem TOT
54,Posthofbrug 5366,2021-02-17,16:00:00,191,72,119,FMN GV 16 Berchem TOT
54,Posthofbrug 5366,2021-02-17,17:00:00,243,95,148,FMN GV 16 Berchem TOT
54,Posthofbrug 5366,2021-02-17,18:00:00,143,43,100,FMN GV 16 Berchem TOT
54,Posthofbrug 5366,2021-02-17,19:00:00,102,46,56,FMN GV 16 Berchem TOT
54,Posthofbrug 5366,2021-02-17,20:00:00,69,38,31,FMN GV 16 Berchem TOT
54,Posthofbrug 5366,2021-02-17,21:00:00,14,9,5,FMN GV 16 Berchem TOT
54,Posthofbrug 5366,2021-02-17,22:00:00,29,13,16,FMN GV 16 Berchem TOT
54,Posthofbrug 5366,2021-02-17,23:00:00,37,14,23,FMN GV 16 Berchem TOT
54,Posthofbrug 5366,2021-02-18,00:00:00,7,3,4,FMN GV 16 Berchem TOT
54,Posthofbrug 5366,2021-02-18,01:00:00,4,1,3,FMN GV 16 Berchem TOT
54,Posthofbrug 5366,2021-02-18,02:00:00,0,0,0,FMN GV 16 Berchem TOT
54,Posthofbrug 5366,2021-02-18,03:00:00,0,0,0,FMN GV 16 Berchem TOT
54,Posthofbrug 5366,2021-02-18,04:00:00,7,5,2,FMN GV 16 Berchem TOT
54,Posthofbrug 5366,2021-02-18,05:00:00,13,8,5,FMN GV 16 Berchem TOT
54,Posthofbrug 5366,2021-02-18,06:00:00,51,36,15,FMN GV 16 Berchem TOT
54,Posthofbrug 5366,2021-02-18,07:00:00,135,95,40,FMN GV 16 Berchem TOT
54,Posthofbrug 5366,2021-02-18,08:00:00,216,148,68,FMN GV 16 Berchem TOT
54,Posthofbrug 5366,2021-02-18,09:00:00,122,83,39,FMN GV 16 Berchem TOT
54,Posthofbrug 5366,2021-02-18,10:00:00,81,61,20,FMN GV 16 Berchem TOT
54,Posthofbrug 5366,2021-02-18,11:00:00,63,32,31,FMN GV 16 Berchem TOT
54,Posthofbrug 5366,2021-02-18,12:00:00,119,61,58,FMN GV 16 Berchem TOT
54,Posthofbrug 5366,2021-02-18,13:00:00,79,43,36,FMN GV 16 Berchem TOT
54,Posthofbrug 5366,2021-02-18,14:00:00,79,33,46,FMN GV 16 Berchem TOT
54,Posthofbrug 5366,2021-02-18,15:00:00,79,34,45,FMN GV 16 Berchem TOT
54,Posthofbrug 5366,2021-02-18,16:00:00,130,45,85,FMN GV 16 Berchem TOT
54,Posthofbrug 5366,2021-02-18,17:00:00,180,73,107,FMN GV 16 Berchem TOT
54,Posthofbrug 5366,2021-02-18,18:00:00,129,45,84,FMN GV 16 Berchem TOT
54,Posthofbrug 5366,2021-02-18,19:00:00,60,22,38,FMN GV 16 Berchem TOT
54,Posthofbrug 5366,2021-02-18,20:00:00,46,18,28,FMN GV 16 Berchem TOT
54,Posthofbrug 5366,2021-02-18,21:00:00,31,12,19,FMN GV 16 Berchem TOT
54,Posthofbrug 5366,2021-02-18,22:00:00,32,15,17,FMN GV 16 Berchem TOT
54,Posthofbrug 5366,2021-02-18,23:00:00,25,9,16,FMN GV 16 Berchem TOT
54,Posthofbrug 5366,2021-02-19,00:00:00,9,3,6,FMN GV 16 Berchem TOT
54,Posthofbrug 5366,2021-02-19,01:00:00,0,0,0,FMN GV 16 Berchem TOT
54,Posthofbrug 5366,2021-02-19,02:00:00,2,0,2,FMN GV 16 Berchem TOT
54,Posthofbrug 5366,2021-02-19,03:00:00,0,0,0,FMN GV 16 Berchem TOT
54,Posthofbrug 5366,2021-02-19,04:00:00,12,10,2,FMN GV 16 Berchem TOT
54,Posthofbrug 5366,2021-02-19,05:00:00,14,9,5,FMN GV 16 Berchem TOT
54,Posthofbrug 5366,2021-02-19,06:00:00,47,39,8,FMN GV 16 Berchem TOT
54,Posthofbrug 5366,2021-02-19,07:00:00,107,75,32,FMN GV 16 Berchem TOT
54,Posthofbrug 5366,2021-02-19,08:00:00,186,123,63,FMN GV 16 Berchem TOT
54,Posthofbrug 5366,2021-02-19,09:00:00,154,109,45,FMN GV 16 Berchem TOT
54,Posthofbrug 5366,2021-02-19,10:00:00,113,71,42,FMN GV 16 Berchem TOT
54,Posthofbrug 5366,2021-02-19,11:00:00,95,59,36,FMN GV 16 Berchem TOT
54,Posthofbrug 5366,2021-02-19,12:00:00,160,86,74,FMN GV 16 Berchem TOT
54,Posthofbrug 5366,2021-02-19,13:00:00,156,94,62,FMN GV 16 Berchem TOT
54,Posthofbrug 5366,2021-02-19,14:00:00,148,71,77,FMN GV 16 Berchem TOT
54,Posthofbrug 5366,2021-02-19,15:00:00,172,74,98,FMN GV 16 Berchem TOT
54,Posthofbrug 5366,2021-02-19,16:00:00,201,80,121,FMN GV 16 Berchem TOT
54,Posthofbrug 5366,2021-02-19,17:00:00,245,89,156,FMN GV 16 Berchem TOT
54,Posthofbrug 5366,2021-02-19,18:00:00,142,55,87,FMN GV 16 Berchem TOT
54,Posthofbrug 5366,2021-02-19,19:00:00,97,40,57,FMN GV 16 Berchem TOT
54,Posthofbrug 5366,2021-02-19,20:00:00,69,32,37,FMN GV 16 Berchem TOT
54,Posthofbrug 5366,2021-02-19,21:00:00,32,15,17,FMN GV 16 Berchem TOT
54,Posthofbrug 5366,2021-02-19,22:00:00,43,17,26,FMN GV 16 Berchem TOT
54,Posthofbrug 5366,2021-02-19,23:00:00,54,24,30,FMN GV 16 Berchem TOT
54,Posthofbrug 5366,2021-02-20,00:00:00,12,11,1,FMN GV 16 Berchem TOT
54,Posthofbrug 5366,2021-02-20,01:00:00,2,1,1,FMN GV 16 Berchem TOT
54,Posthofbrug 5366,2021-02-20,02:00:00,1,0,1,FMN GV 16 Berchem TOT
54,Posthofbrug 5366,2021-02-20,03:00:00,0,0,0,FMN GV 16 Berchem TOT
54,Posthofbrug 5366,2021-02-20,04:00:00,5,4,1,FMN GV 16 Berchem TOT
54,Posthofbrug 5366,2021-02-20,05:00:00,15,9,6,FMN GV 16 Berchem TOT
54,Posthofbrug 5366,2021-02-20,06:00:00,15,8,7,FMN GV 16 Berchem TOT
54,Posthofbrug 5366,2021-02-20,07:00:00,20,10,10,FMN GV 16 Berchem TOT
54,Posthofbrug 5366,2021-02-20,08:00:00,42,22,20,FMN GV 16 Berchem TOT
54,Posthofbrug 5366,2021-02-20,09:00:00,119,70,49,FMN GV 16 Berchem TOT
54,Posthofbrug 5366,2021-02-20,10:00:00,135,83,52,FMN GV 16 Berchem TOT
54,Posthofbrug 5366,2021-02-20,11:00:00,181,107,74,FMN GV 16 Berchem TOT
54,Posthofbrug 5366,2021-02-20,12:00:00,215,121,94,FMN GV 16 Berchem TOT
54,Posthofbrug 5366,2021-02-20,13:00:00,293,159,134,FMN GV 16 Berchem TOT
54,Posthofbrug 5366,2021-02-20,14:00:00,297,150,147,FMN GV 16 Berchem TOT
54,Posthofbrug 5366,2021-02-20,15:00:00,242,119,123,FMN GV 16 Berchem TOT
54,Posthofbrug 5366,2021-02-20,16:00:00,187,87,100,FMN GV 16 Berchem TOT
54,Posthofbrug 5366,2021-02-20,17:00:00,221,111,110,FMN GV 16 Berchem TOT
54,Posthofbrug 5366,2021-02-20,18:00:00,146,74,72,FMN GV 16 Berchem TOT
54,Posthofbrug 5366,2021-02-20,19:00:00,68,23,45,FMN GV 16 Berchem TOT
54,Posthofbrug 5366,2021-02-20,20:00:00,51,27,24,FMN GV 16 Berchem TOT
54,Posthofbrug 5366,2021-02-20,21:00:00,36,14,22,FMN GV 16 Berchem TOT
54,Posthofbrug 5366,2021-02-20,22:00:00,41,15,26,FMN GV 16 Berchem TOT
54,Posthofbrug 5366,2021-02-20,23:00:00,76,48,28,FMN GV 16 Berchem TOT
54,Posthofbrug 5366,2021-02-21,00:00:00,11,2,9,FMN GV 16 Berchem TOT
54,Posthofbrug 5366,2021-02-21,01:00:00,0,0,0,FMN GV 16 Berchem TOT
54,Posthofbrug 5366,2021-02-21,02:00:00,3,1,2,FMN GV 16 Berchem TOT
54,Posthofbrug 5366,2021-02-21,03:00:00,2,2,0,FMN GV 16 Berchem TOT
54,Posthofbrug 5366,2021-02-21,04:00:00,1,1,0,FMN GV 16 Berchem TOT
54,Posthofbrug 5366,2021-02-21,05:00:00,11,6,5,FMN GV 16 Berchem TOT
54,Posthofbrug 5366,2021-02-21,06:00:00,11,7,4,FMN GV 16 Berchem TOT
54,Posthofbrug 5366,2021-02-21,07:00:00,19,11,8,FMN GV 16 Berchem TOT
54,Posthofbrug 5366,2021-02-21,08:00:00,55,24,31,FMN GV 16 Berchem TOT
54,Posthofbrug 5366,2021-02-21,09:00:00,129,67,62,FMN GV 16 Berchem TOT
54,Posthofbrug 5366,2021-02-21,10:00:00,175,79,96,FMN GV 16 Berchem TOT
54,Posthofbrug 5366,2021-02-21,11:00:00,183,111,72,FMN GV 16 Berchem TOT
54,Posthofbrug 5366,2021-02-21,12:00:00,248,152,96,FMN GV 16 Berchem TOT
54,Posthofbrug 5366,2021-02-21,13:00:00,322,167,155,FMN GV 16 Berchem TOT
54,Posthofbrug 5366,2021-02-21,14:00:00,328,156,172,FMN GV 16 Berchem TOT
54,Posthofbrug 5366,2021-02-21,15:00:00,252,114,138,FMN GV 16 Berchem TOT
54,Posthofbrug 5366,2021-02-21,16:00:00,246,109,137,FMN GV 16 Berchem TOT
54,Posthofbrug 5366,2021-02-21,17:00:00,212,112,100,FMN GV 16 Berchem TOT
54,Posthofbrug 5366,2021-02-21,18:00:00,146,78,68,FMN GV 16 Berchem TOT
54,Posthofbrug 5366,2021-02-21,19:00:00,75,40,35,FMN GV 16 Berchem TOT
54,Posthofbrug 5366,2021-02-21,20:00:00,59,29,30,FMN GV 16 Berchem TOT
54,Posthofbrug 5366,2021-02-21,21:00:00,35,18,17,FMN GV 16 Berchem TOT
54,Posthofbrug 5366,2021-02-21,22:00:00,28,10,18,FMN GV 16 Berchem TOT
54,Posthofbrug 5366,2021-02-21,23:00:00,21,7,14,FMN GV 16 Berchem TOT
54,Posthofbrug 5366,2021-02-22,00:00:00,3,0,3,FMN GV 16 Berchem TOT
54,Posthofbrug 5366,2021-02-22,01:00:00,1,1,0,FMN GV 16 Berchem TOT
54,Posthofbrug 5366,2021-02-22,02:00:00,1,0,1,FMN GV 16 Berchem TOT
54,Posthofbrug 5366,2021-02-22,03:00:00,0,0,0,FMN GV 16 Berchem TOT
54,Posthofbrug 5366,2021-02-22,04:00:00,13,12,1,FMN GV 16 Berchem TOT
54,Posthofbrug 5366,2021-02-22,05:00:00,18,15,3,FMN GV 16 Berchem TOT
54,Posthofbrug 5366,2021-02-22,06:00:00,85,68,17,FMN GV 16 Berchem TOT
54,Posthofbrug 5366,2021-02-22,07:00:00,290,223,67,FMN GV 16 Berchem TOT
54,Posthofbrug 5366,2021-02-22,08:00:00,373,274,99,FMN GV 16 Berchem TOT
54,Posthofbrug 5366,2021-02-22,09:00:00,172,129,43,FMN GV 16 Berchem TOT
54,Posthofbrug 5366,2021-02-22,10:00:00,86,53,33,FMN GV 16 Berchem TOT
54,Posthofbrug 5366,2021-02-22,11:00:00,92,56,36,FMN GV 16 Berchem TOT
54,Posthofbrug 5366,2021-02-22,12:00:00,111,61,50,FMN GV 16 Berchem TOT
54,Posthofbrug 5366,2021-02-22,13:00:00,115,68,47,FMN GV 16 Berchem TOT
54,Posthofbrug 5366,2021-02-22,14:00:00,145,58,87,FMN GV 16 Berchem TOT
54,Posthofbrug 5366,2021-02-22,15:00:00,218,96,122,FMN GV 16 Berchem TOT
54,Posthofbrug 5366,2021-02-22,16:00:00,317,93,224,FMN GV 16 Berchem TOT
54,Posthofbrug 5366,2021-02-22,17:00:00,329,104,225,FMN GV 16 Berchem TOT
54,Posthofbrug 5366,2021-02-22,18:00:00,195,69,126,FMN GV 16 Berchem TOT
54,Posthofbrug 5366,2021-02-22,19:00:00,102,43,59,FMN GV 16 Berchem TOT
54,Posthofbrug 5366,2021-02-22,20:00:00,75,40,35,FMN GV 16 Berchem TOT
54,Posthofbrug 5366,2021-02-22,21:00:00,45,26,19,FMN GV 16 Berchem TOT
54,Posthofbrug 5366,2021-02-22,22:00:00,40,19,21,FMN GV 16 Berchem TOT
54,Posthofbrug 5366,2021-02-22,23:00:00,25,12,13,FMN GV 16 Berchem TOT
54,Posthofbrug 5366,2021-02-23,00:00:00,4,1,3,FMN GV 16 Berchem TOT
54,Posthofbrug 5366,2021-02-23,01:00:00,1,0,1,FMN GV 16 Berchem TOT
54,Posthofbrug 5366,2021-02-23,02:00:00,0,0,0,FMN GV 16 Berchem TOT
54,Posthofbrug 5366,2021-02-23,03:00:00,1,1,0,FMN GV 16 Berchem TOT
54,Posthofbrug 5366,2021-02-23,04:00:00,12,11,1,FMN GV 16 Berchem TOT
54,Posthofbrug 5366,2021-02-23,05:00:00,17,10,7,FMN GV 16 Berchem TOT
54,Posthofbrug 5366,2021-02-23,06:00:00,109,83,26,FMN GV 16 Berchem TOT
54,Posthofbrug 5366,2021-02-23,07:00:00,300,224,76,FMN GV 16 Berchem TOT
54,Posthofbrug 5366,2021-02-23,08:00:00,362,267,95,FMN GV 16 Berchem TOT
54,Posthofbrug 5366,2021-02-23,09:00:00,159,127,32,FMN GV 16 Berchem TOT
54,Posthofbrug 5366,2021-02-23,10:00:00,93,62,31,FMN GV 16 Berchem TOT
54,Posthofbrug 5366,2021-02-23,11:00:00,84,39,45,FMN GV 16 Berchem TOT
54,Posthofbrug 5366,2021-02-23,12:00:00,144,80,64,FMN GV 16 Berchem TOT
54,Posthofbrug 5366,2021-02-23,13:00:00,171,93,78,FMN GV 16 Berchem TOT
54,Posthofbrug 5366,2021-02-23,14:00:00,130,58,72,FMN GV 16 Berchem TOT
54,Posthofbrug 5366,2021-02-23,15:00:00,213,77,136,FMN GV 16 Berchem TOT
54,Posthofbrug 5366,2021-02-23,16:00:00,343,102,241,FMN GV 16 Berchem TOT
54,Posthofbrug 5366,2021-02-23,17:00:00,376,111,265,FMN GV 16 Berchem TOT
54,Posthofbrug 5366,2021-02-23,18:00:00,229,96,133,FMN GV 16 Berchem TOT
54,Posthofbrug 5366,2021-02-23,19:00:00,80,36,44,FMN GV 16 Berchem TOT
54,Posthofbrug 5366,2021-02-23,20:00:00,67,38,29,FMN GV 16 Berchem TOT
54,Posthofbrug 5366,2021-02-23,21:00:00,46,26,20,FMN GV 16 Berchem TOT
54,Posthofbrug 5366,2021-02-23,22:00:00,44,18,26,FMN GV 16 Berchem TOT
54,Posthofbrug 5366,2021-02-23,23:00:00,25,10,15,FMN GV 16 Berchem TOT
54,Posthofbrug 5366,2021-02-24,00:00:00,2,0,2,FMN GV 16 Berchem TOT
54,Posthofbrug 5366,2021-02-24,01:00:00,2,1,1,FMN GV 16 Berchem TOT
54,Posthofbrug 5366,2021-02-24,02:00:00,0,0,0,FMN GV 16 Berchem TOT
54,Posthofbrug 5366,2021-02-24,03:00:00,1,1,0,FMN GV 16 Berchem TOT
54,Posthofbrug 5366,2021-02-24,04:00:00,11,8,3,FMN GV 16 Berchem TOT
54,Posthofbrug 5366,2021-02-24,05:00:00,22,16,6,FMN GV 16 Berchem TOT
54,Posthofbrug 5366,2021-02-24,06:00:00,91,70,21,FMN GV 16 Berchem TOT
54,Posthofbrug 5366,2021-02-24,07:00:00,258,187,71,FMN GV 16 Berchem TOT
54,Posthofbrug 5366,2021-02-24,08:00:00,381,276,105,FMN GV 16 Berchem TOT
54,Posthofbrug 5366,2021-02-24,09:00:00,180,127,53,FMN GV 16 Berchem TOT
54,Posthofbrug 5366,2021-02-24,10:00:00,127,85,42,FMN GV 16 Berchem TOT
54,Posthofbrug 5366,2021-02-24,11:00:00,153,73,80,FMN GV 16 Berchem TOT
54,Posthofbrug 5366,2021-02-24,12:00:00,259,115,144,FMN GV 16 Berchem TOT
54,Posthofbrug 5366,2021-02-24,13:00:00,265,119,146,FMN GV 16 Berchem TOT
54,Posthofbrug 5366,2021-02-24,14:00:00,232,106,126,FMN GV 16 Berchem TOT
54,Posthofbrug 5366,2021-02-24,15:00:00,239,118,121,FMN GV 16 Berchem TOT
54,Posthofbrug 5366,2021-02-24,16:00:00,320,94,226,FMN GV 16 Berchem TOT
54,Posthofbrug 5366,2021-02-24,17:00:00,345,134,211,FMN GV 16 Berchem TOT
54,Posthofbrug 5366,2021-02-24,18:00:00,261,112,149,FMN GV 16 Berchem TOT
54,Posthofbrug 5366,2021-02-24,19:00:00,101,46,55,FMN GV 16 Berchem TOT
54,Posthofbrug 5366,2021-02-24,20:00:00,107,45,62,FMN GV 16 Berchem TOT
54,Posthofbrug 5366,2021-02-24,21:00:00,38,11,27,FMN GV 16 Berchem TOT
54,Posthofbrug 5366,2021-02-24,22:00:00,48,22,26,FMN GV 16 Berchem TOT
54,Posthofbrug 5366,2021-02-24,23:00:00,37,12,25,FMN GV 16 Berchem TOT
54,Posthofbrug 5366,2021-02-25,00:00:00,11,5,6,FMN GV 16 Berchem TOT
54,Posthofbrug 5366,2021-02-25,01:00:00,2,1,1,FMN GV 16 Berchem TOT
54,Posthofbrug 5366,2021-02-25,02:00:00,2,1,1,FMN GV 16 Berchem TOT
54,Posthofbrug 5366,2021-02-25,03:00:00,1,1,0,FMN GV 16 Berchem TOT
54,Posthofbrug 5366,2021-02-25,04:00:00,13,11,2,FMN GV 16 Berchem TOT
54,Posthofbrug 5366,2021-02-25,05:00:00,24,17,7,FMN GV 16 Berchem TOT
54,Posthofbrug 5366,2021-02-25,06:00:00,83,63,20,FMN GV 16 Berchem TOT
54,Posthofbrug 5366,2021-02-25,07:00:00,280,202,78,FMN GV 16 Berchem TOT
54,Posthofbrug 5366,2021-02-25,08:00:00,379,277,102,FMN GV 16 Berchem TOT
54,Posthofbrug 5366,2021-02-25,09:00:00,135,103,32,FMN GV 16 Berchem TOT
54,Posthofbrug 5366,2021-02-25,10:00:00,101,65,36,FMN GV 16 Berchem TOT
54,Posthofbrug 5366,2021-02-25,11:00:00,106,47,59,FMN GV 16 Berchem TOT
54,Posthofbrug 5366,2021-02-25,12:00:00,168,90,78,FMN GV 16 Berchem TOT
54,Posthofbrug 5366,2021-02-25,13:00:00,156,81,75,FMN GV 16 Berchem TOT
54,Posthofbrug 5366,2021-02-25,14:00:00,149,66,83,FMN GV 16 Berchem TOT
54,Posthofbrug 5366,2021-02-25,15:00:00,186,65,121,FMN GV 16 Berchem TOT
54,Posthofbrug 5366,2021-02-25,16:00:00,267,83,184,FMN GV 16 Berchem TOT
54,Posthofbrug 5366,2021-02-25,17:00:00,307,96,211,FMN GV 16 Berchem TOT
54,Posthofbrug 5366,2021-02-25,18:00:00,182,72,110,FMN GV 16 Berchem TOT
54,Posthofbrug 5366,2021-02-25,19:00:00,81,36,45,FMN GV 16 Berchem TOT
54,Posthofbrug 5366,2021-02-25,20:00:00,49,18,31,FMN GV 16 Berchem TOT
54,Posthofbrug 5366,2021-02-25,21:00:00,34,11,23,FMN GV 16 Berchem TOT
54,Posthofbrug 5366,2021-02-25,22:00:00,40,16,24,FMN GV 16 Berchem TOT
54,Posthofbrug 5366,2021-02-25,23:00:00,19,8,11,FMN GV 16 Berchem TOT
54,Posthofbrug 5366,2021-02-26,00:00:00,4,3,1,FMN GV 16 Berchem TOT
54,Posthofbrug 5366,2021-02-26,01:00:00,1,1,0,FMN GV 16 Berchem TOT
54,Posthofbrug 5366,2021-02-26,02:00:00,3,0,3,FMN GV 16 Berchem TOT
54,Posthofbrug 5366,2021-02-26,03:00:00,1,1,0,FMN GV 16 Berchem TOT
54,Posthofbrug 5366,2021-02-26,04:00:00,14,13,1,FMN GV 16 Berchem TOT
54,Posthofbrug 5366,2021-02-26,05:00:00,22,15,7,FMN GV 16 Berchem TOT
54,Posthofbrug 5366,2021-02-26,06:00:00,58,41,17,FMN GV 16 Berchem TOT
54,Posthofbrug 5366,2021-02-26,07:00:00,230,169,61,FMN GV 16 Berchem TOT
54,Posthofbrug 5366,2021-02-26,08:00:00,341,243,98,FMN GV 16 Berchem TOT
54,Posthofbrug 5366,2021-02-26,09:00:00,131,95,36,FMN GV 16 Berchem TOT
54,Posthofbrug 5366,2021-02-26,10:00:00,120,74,46,FMN GV 16 Berchem TOT
54,Posthofbrug 5366,2021-02-26,11:00:00,99,57,42,FMN GV 16 Berchem TOT
54,Posthofbrug 5366,2021-02-26,12:00:00,154,75,79,FMN GV 16 Berchem TOT
54,Posthofbrug 5366,2021-02-26,13:00:00,168,84,84,FMN GV 16 Berchem TOT
54,Posthofbrug 5366,2021-02-26,14:00:00,160,78,82,FMN GV 16 Berchem TOT
54,Posthofbrug 5366,2021-02-26,15:00:00,229,88,141,FMN GV 16 Berchem TOT
54,Posthofbrug 5366,2021-02-26,16:00:00,320,103,217,FMN GV 16 Berchem TOT
54,Posthofbrug 5366,2021-02-26,17:00:00,271,100,171,FMN GV 16 Berchem TOT
54,Posthofbrug 5366,2021-02-26,18:00:00,212,80,132,FMN GV 16 Berchem TOT
54,Posthofbrug 5366,2021-02-26,19:00:00,104,48,56,FMN GV 16 Berchem TOT
54,Posthofbrug 5366,2021-02-26,20:00:00,66,37,29,FMN GV 16 Berchem TOT
54,Posthofbrug 5366,2021-02-26,21:00:00,33,20,13,FMN GV 16 Berchem TOT
54,Posthofbrug 5366,2021-02-26,22:00:00,28,6,22,FMN GV 16 Berchem TOT
54,Posthofbrug 5366,2021-02-26,23:00:00,76,29,47,FMN GV 16 Berchem TOT
54,Posthofbrug 5366,2021-02-27,00:00:00,13,2,11,FMN GV 16 Berchem TOT
54,Posthofbrug 5366,2021-02-27,01:00:00,2,1,1,FMN GV 16 Berchem TOT
54,Posthofbrug 5366,2021-02-27,02:00:00,2,1,1,FMN GV 16 Berchem TOT
54,Posthofbrug 5366,2021-02-27,03:00:00,3,3,0,FMN GV 16 Berchem TOT
54,Posthofbrug 5366,2021-02-27,04:00:00,3,3,0,FMN GV 16 Berchem TOT
54,Posthofbrug 5366,2021-02-27,05:00:00,10,4,6,FMN GV 16 Berchem TOT
54,Posthofbrug 5366,2021-02-27,06:00:00,16,9,7,FMN GV 16 Berchem TOT
54,Posthofbrug 5366,2021-02-27,07:00:00,21,13,8,FMN GV 16 Berchem TOT
54,Posthofbrug 5366,2021-02-27,08:00:00,47,24,23,FMN GV 16 Berchem TOT
54,Posthofbrug 5366,2021-02-27,09:00:00,94,59,35,FMN GV 16 Berchem TOT
54,Posthofbrug 5366,2021-02-27,10:00:00,110,59,51,FMN GV 16 Berchem TOT
54,Posthofbrug 5366,2021-02-27,11:00:00,110,62,48,FMN GV 16 Berchem TOT
54,Posthofbrug 5366,2021-02-27,12:00:00,115,68,47,FMN GV 16 Berchem TOT
54,Posthofbrug 5366,2021-02-27,13:00:00,177,97,80,FMN GV 16 Berchem TOT
54,Posthofbrug 5366,2021-02-27,14:00:00,155,88,67,FMN GV 16 Berchem TOT
54,Posthofbrug 5366,2021-02-27,15:00:00,141,66,75,FMN GV 16 Berchem TOT
54,Posthofbrug 5366,2021-02-27,16:00:00,147,69,78,FMN GV 16 Berchem TOT
54,Posthofbrug 5366,2021-02-27,17:00:00,165,67,98,FMN GV 16 Berchem TOT
54,Posthofbrug 5366,2021-02-27,18:00:00,117,60,57,FMN GV 16 Berchem TOT
54,Posthofbrug 5366,2021-02-27,19:00:00,66,30,36,FMN GV 16 Berchem TOT
54,Posthofbrug 5366,2021-02-27,20:00:00,49,22,27,FMN GV 16 Berchem TOT
54,Posthofbrug 5366,2021-02-27,21:00:00,37,15,22,FMN GV 16 Berchem TOT
54,Posthofbrug 5366,2021-02-27,22:00:00,36,16,20,FMN GV 16 Berchem TOT
54,Posthofbrug 5366,2021-02-27,23:00:00,57,22,35,FMN GV 16 Berchem TOT
54,Posthofbrug 5366,2021-02-28,00:00:00,7,3,4,FMN GV 16 Berchem TOT
54,Posthofbrug 5366,2021-02-28,01:00:00,1,1,0,FMN GV 16 Berchem TOT
54,Posthofbrug 5366,2021-02-28,02:00:00,1,1,0,FMN GV 16 Berchem TOT
54,Posthofbrug 5366,2021-02-28,03:00:00,4,3,1,FMN GV 16 Berchem TOT
54,Posthofbrug 5366,2021-02-28,04:00:00,2,2,0,FMN GV 16 Berchem TOT
54,Posthofbrug 5366,2021-02-28,05:00:00,7,5,2,FMN GV 16 Berchem TOT
54,Posthofbrug 5366,2021-02-28,06:00:00,8,6,2,FMN GV 16 Berchem TOT
54,Posthofbrug 5366,2021-02-28,07:00:00,16,10,6,FMN GV 16 Berchem TOT
54,Posthofbrug 5366,2021-02-28,08:00:00,51,29,22,FMN GV 16 Berchem TOT
54,Posthofbrug 5366,2021-02-28,09:00:00,105,52,53,FMN GV 16 Berchem TOT
54,Posthofbrug 5366,2021-02-28,10:00:00,102,48,54,FMN GV 16 Berchem TOT
54,Posthofbrug 5366,2021-02-28,11:00:00,165,82,83,FMN GV 16 Berchem TOT
54,Posthofbrug 5366,2021-02-28,12:00:00,185,109,76,FMN GV 16 Berchem TOT
54,Posthofbrug 5366,2021-02-28,13:00:00,230,134,96,FMN GV 16 Berchem TOT
54,Posthofbrug 5366,2021-02-28,14:00:00,253,133,120,FMN GV 16 Berchem TOT
54,Posthofbrug 5366,2021-02-28,15:00:00,198,91,107,FMN GV 16 Berchem TOT
54,Posthofbrug 5366,2021-02-28,16:00:00,197,94,103,FMN GV 16 Berchem TOT
54,Posthofbrug 5366,2021-02-28,17:00:00,191,80,111,FMN GV 16 Berchem TOT
54,Posthofbrug 5366,2021-02-28,18:00:00,144,65,79,FMN GV 16 Berchem TOT
54,Posthofbrug 5366,2021-02-28,19:00:00,49,24,25,FMN GV 16 Berchem TOT
54,Posthofbrug 5366,2021-02-28,20:00:00,55,24,31,FMN GV 16 Berchem TOT
54,Posthofbrug 5366,2021-02-28,21:00:00,29,19,10,FMN GV 16 Berchem TOT
54,Posthofbrug 5366,2021-02-28,22:00:00,22,12,10,FMN GV 16 Berchem TOT
54,Posthofbrug 5366,2021-02-28,23:00:00,19,9,10,FMN GV 16 Berchem TOT
54,Posthofbrug 5366,2021-03-01,00:00:00,2,0,2,FMN GV 16 Berchem TOT
54,Posthofbrug 5366,2021-03-01,01:00:00,2,2,0,FMN GV 16 Berchem TOT
54,Posthofbrug 5366,2021-03-01,02:00:00,0,0,0,FMN GV 16 Berchem TOT
54,Posthofbrug 5366,2021-03-01,03:00:00,1,1,0,FMN GV 16 Berchem TOT
54,Posthofbrug 5366,2021-03-01,04:00:00,11,10,1,FMN GV 16 Berchem TOT
54,Posthofbrug 5366,2021-03-01,05:00:00,22,15,7,FMN GV 16 Berchem TOT
54,Posthofbrug 5366,2021-03-01,06:00:00,69,56,13,FMN GV 16 Berchem TOT
54,Posthofbrug 5366,2021-03-01,07:00:00,273,209,64,FMN GV 16 Berchem TOT
54,Posthofbrug 5366,2021-03-01,08:00:00,339,255,84,FMN GV 16 Berchem TOT
54,Posthofbrug 5366,2021-03-01,09:00:00,146,102,44,FMN GV 16 Berchem TOT
54,Posthofbrug 5366,2021-03-01,10:00:00,87,53,34,FMN GV 16 Berchem TOT
54,Posthofbrug 5366,2021-03-01,11:00:00,68,30,38,FMN GV 16 Berchem TOT
54,Posthofbrug 5366,2021-03-01,12:00:00,99,48,51,FMN GV 16 Berchem TOT
54,Posthofbrug 5366,2021-03-01,13:00:00,124,69,55,FMN GV 16 Berchem TOT
54,Posthofbrug 5366,2021-03-01,14:00:00,126,57,69,FMN GV 16 Berchem TOT
54,Posthofbrug 5366,2021-03-01,15:00:00,212,74,138,FMN GV 16 Berchem TOT
54,Posthofbrug 5366,2021-03-01,16:00:00,277,66,211,FMN GV 16 Berchem TOT
54,Posthofbrug 5366,2021-03-01,17:00:00,307,108,199,FMN GV 16 Berchem TOT
54,Posthofbrug 5366,2021-03-01,18:00:00,200,68,132,FMN GV 16 Berchem TOT
54,Posthofbrug 5366,2021-03-01,19:00:00,82,34,48,FMN GV 16 Berchem TOT
54,Posthofbrug 5366,2021-03-01,20:00:00,56,29,27,FMN GV 16 Berchem TOT
54,Posthofbrug 5366,2021-03-01,21:00:00,33,15,18,FMN GV 16 Berchem TOT
54,Posthofbrug 5366,2021-03-01,22:00:00,31,14,17,FMN GV 16 Berchem TOT
54,Posthofbrug 5366,2021-03-01,23:00:00,10,6,4,FMN GV 16 Berchem TOT
54,Posthofbrug 5366,2021-03-02,00:00:00,2,0,2,FMN GV 16 Berchem TOT
54,Posthofbrug 5366,2021-03-02,01:00:00,1,0,1,FMN GV 16 Berchem TOT
54,Posthofbrug 5366,2021-03-02,02:00:00,0,0,0,FMN GV 16 Berchem TOT
54,Posthofbrug 5366,2021-03-02,03:00:00,4,4,0,FMN GV 16 Berchem TOT
54,Posthofbrug 5366,2021-03-02,04:00:00,10,9,1,FMN GV 16 Berchem TOT
54,Posthofbrug 5366,2021-03-02,05:00:00,24,15,9,FMN GV 16 Berchem TOT
54,Posthofbrug 5366,2021-03-02,06:00:00,88,72,16,FMN GV 16 Berchem TOT
54,Posthofbrug 5366,2021-03-02,07:00:00,277,215,62,FMN GV 16 Berchem TOT
54,Posthofbrug 5366,2021-03-02,08:00:00,378,275,103,FMN GV 16 Berchem TOT
54,Posthofbrug 5366,2021-03-02,09:00:00,149,115,34,FMN GV 16 Berchem TOT
54,Posthofbrug 5366,2021-03-02,10:00:00,93,57,36,FMN GV 16 Berchem TOT
54,Posthofbrug 5366,2021-03-02,11:00:00,100,50,50,FMN GV 16 Berchem TOT
54,Posthofbrug 5366,2021-03-02,12:00:00,152,84,68,FMN GV 16 Berchem TOT
54,Posthofbrug 5366,2021-03-02,13:00:00,174,102,72,FMN GV 16 Berchem TOT
54,Posthofbrug 5366,2021-03-02,14:00:00,154,71,83,FMN GV 16 Berchem TOT
54,Posthofbrug 5366,2021-03-02,15:00:00,251,98,153,FMN GV 16 Berchem TOT
54,Posthofbrug 5366,2021-03-02,16:00:00,347,110,237,FMN GV 16 Berchem TOT
54,Posthofbrug 5366,2021-03-02,17:00:00,321,101,220,FMN GV 16 Berchem TOT
54,Posthofbrug 5366,2021-03-02,18:00:00,226,84,142,FMN GV 16 Berchem TOT
54,Posthofbrug 5366,2021-03-02,19:00:00,114,46,68,FMN GV 16 Berchem TOT
54,Posthofbrug 5366,2021-03-02,20:00:00,68,36,32,FMN GV 16 Berchem TOT
54,Posthofbrug 5366,2021-03-02,21:00:00,47,29,18,FMN GV 16 Berchem TOT
54,Posthofbrug 5366,2021-03-02,22:00:00,49,18,31,FMN GV 16 Berchem TOT
54,Posthofbrug 5366,2021-03-02,23:00:00,36,16,20,FMN GV 16 Berchem TOT
54,Posthofbrug 5366,2021-03-03,00:00:00,5,1,4,FMN GV 16 Berchem TOT
54,Posthofbrug 5366,2021-03-03,01:00:00,1,0,1,FMN GV 16 Berchem TOT
54,Posthofbrug 5366,2021-03-03,02:00:00,1,0,1,FMN GV 16 Berchem TOT
54,Posthofbrug 5366,2021-03-03,03:00:00,0,0,0,FMN GV 16 Berchem TOT
54,Posthofbrug 5366,2021-03-03,04:00:00,10,9,1,FMN GV 16 Berchem TOT
54,Posthofbrug 5366,2021-03-03,05:00:00,24,17,7,FMN GV 16 Berchem TOT
54,Posthofbrug 5366,2021-03-03,06:00:00,80,67,13,FMN GV 16 Berchem TOT
54,Posthofbrug 5366,2021-03-03,07:00:00,255,173,82,FMN GV 16 Berchem TOT
54,Posthofbrug 5366,2021-03-03,08:00:00,359,273,86,FMN GV 16 Berchem TOT
54,Posthofbrug 5366,2021-03-03,09:00:00,145,100,45,FMN GV 16 Berchem TOT
54,Posthofbrug 5366,2021-03-03,10:00:00,97,62,35,FMN GV 16 Berchem TOT
54,Posthofbrug 5366,2021-03-03,11:00:00,124,71,53,FMN GV 16 Berchem TOT
54,Posthofbrug 5366,2021-03-03,12:00:00,267,132,135,FMN GV 16 Berchem TOT
54,Posthofbrug 5366,2021-03-03,13:00:00,199,91,108,FMN GV 16 Berchem TOT
54,Posthofbrug 5366,2021-03-03,14:00:00,205,103,102,FMN GV 16 Berchem TOT
54,Posthofbrug 5366,2021-03-03,15:00:00,201,92,109,FMN GV 16 Berchem TOT
54,Posthofbrug 5366,2021-03-03,16:00:00,262,103,159,FMN GV 16 Berchem TOT
54,Posthofbrug 5366,2021-03-03,17:00:00,350,125,225,FMN GV 16 Berchem TOT
54,Posthofbrug 5366,2021-03-03,18:00:00,261,107,154,FMN GV 16 Berchem TOT
54,Posthofbrug 5366,2021-03-03,19:00:00,105,49,56,FMN GV 16 Berchem TOT
54,Posthofbrug 5366,2021-03-03,20:00:00,80,38,42,FMN GV 16 Berchem TOT
54,Posthofbrug 5366,2021-03-03,21:00:00,36,20,16,FMN GV 16 Berchem TOT
54,Posthofbrug 5366,2021-03-03,22:00:00,32,14,18,FMN GV 16 Berchem TOT
54,Posthofbrug 5366,2021-03-03,23:00:00,24,3,21,FMN GV 16 Berchem TOT
54,Posthofbrug 5366,2021-03-04,00:00:00,4,0,4,FMN GV 16 Berchem TOT
54,Posthofbrug 5366,2021-03-04,01:00:00,0,0,0,FMN GV 16 Berchem TOT
54,Posthofbrug 5366,2021-03-04,02:00:00,1,0,1,FMN GV 16 Berchem TOT
54,Posthofbrug 5366,2021-03-04,03:00:00,0,0,0,FMN GV 16 Berchem TOT
54,Posthofbrug 5366,2021-03-04,04:00:00,10,8,2,FMN GV 16 Berchem TOT
54,Posthofbrug 5366,2021-03-04,05:00:00,23,19,4,FMN GV 16 Berchem TOT
54,Posthofbrug 5366,2021-03-04,06:00:00,60,44,16,FMN GV 16 Berchem TOT
54,Posthofbrug 5366,2021-03-04,07:00:00,216,158,58,FMN GV 16 Berchem TOT
54,Posthofbrug 5366,2021-03-04,08:00:00,319,232,87,FMN GV 16 Berchem TOT
54,Posthofbrug 5366,2021-03-04,09:00:00,105,80,25,FMN GV 16 Berchem TOT
54,Posthofbrug 5366,2021-03-04,10:00:00,56,38,18,FMN GV 16 Berchem TOT
54,Posthofbrug 5366,2021-03-04,11:00:00,52,22,30,FMN GV 16 Berchem TOT
54,Posthofbrug 5366,2021-03-04,12:00:00,93,51,42,FMN GV 16 Berchem TOT
54,Posthofbrug 5366,2021-03-04,13:00:00,78,42,36,FMN GV 16 Berchem TOT
54,Posthofbrug 5366,2021-03-04,14:00:00,84,33,51,FMN GV 16 Berchem TOT
54,Posthofbrug 5366,2021-03-04,15:00:00,132,51,81,FMN GV 16 Berchem TOT
54,Posthofbrug 5366,2021-03-04,16:00:00,218,70,148,FMN GV 16 Berchem TOT
54,Posthofbrug 5366,2021-03-04,17:00:00,223,66,157,FMN GV 16 Berchem TOT
54,Posthofbrug 5366,2021-03-04,18:00:00,170,55,115,FMN GV 16 Berchem TOT
54,Posthofbrug 5366,2021-03-04,19:00:00,89,38,51,FMN GV 16 Berchem TOT
54,Posthofbrug 5366,2021-03-04,20:00:00,51,27,24,FMN GV 16 Berchem TOT
54,Posthofbrug 5366,2021-03-04,21:00:00,48,26,22,FMN GV 16 Berchem TOT
54,Posthofbrug 5366,2021-03-04,22:00:00,28,13,15,FMN GV 16 Berchem TOT
54,Posthofbrug 5366,2021-03-04,23:00:00,22,6,16,FMN GV 16 Berchem TOT
54,Posthofbrug 5366,2021-03-05,00:00:00,2,1,1,FMN GV 16 Berchem TOT
54,Posthofbrug 5366,2021-03-05,01:00:00,1,0,1,FMN GV 16 Berchem TOT
54,Posthofbrug 5366,2021-03-05,02:00:00,1,1,0,FMN GV 16 Berchem TOT
54,Posthofbrug 5366,2021-03-05,03:00:00,1,1,0,FMN GV 16 Berchem TOT
54,Posthofbrug 5366,2021-03-05,04:00:00,6,6,0,FMN GV 16 Berchem TOT
54,Posthofbrug 5366,2021-03-05,05:00:00,15,10,5,FMN GV 16 Berchem TOT
54,Posthofbrug 5366,2021-03-05,06:00:00,75,64,11,FMN GV 16 Berchem TOT
54,Posthofbrug 5366,2021-03-05,07:00:00,202,139,63,FMN GV 16 Berchem TOT
54,Posthofbrug 5366,2021-03-05,08:00:00,329,234,95,FMN GV 16 Berchem TOT
54,Posthofbrug 5366,2021-03-05,09:00:00,159,108,51,FMN GV 16 Berchem TOT
54,Posthofbrug 5366,2021-03-05,10:00:00,100,69,31,FMN GV 16 Berchem TOT
54,Posthofbrug 5366,2021-03-05,11:00:00,84,49,35,FMN GV 16 Berchem TOT
54,Posthofbrug 5366,2021-03-05,12:00:00,154,84,70,FMN GV 16 Berchem TOT
54,Posthofbrug 5366,2021-03-05,13:00:00,153,87,66,FMN GV 16 Berchem TOT
54,Posthofbrug 5366,2021-03-05,14:00:00,160,74,86,FMN GV 16 Berchem TOT
54,Posthofbrug 5366,2021-03-05,15:00:00,217,85,132,FMN GV 16 Berchem TOT
54,Posthofbrug 5366,2021-03-05,16:00:00,303,112,191,FMN GV 16 Berchem TOT
54,Posthofbrug 5366,2021-03-05,17:00:00,260,96,164,FMN GV 16 Berchem TOT
54,Posthofbrug 5366,2021-03-05,18:00:00,199,76,123,FMN GV 16 Berchem TOT
54,Posthofbrug 5366,2021-03-05,19:00:00,89,38,51,FMN GV 16 Berchem TOT
54,Posthofbrug 5366,2021-03-05,20:00:00,77,40,37,FMN GV 16 Berchem TOT
54,Posthofbrug 5366,2021-03-05,21:00:00,44,21,23,FMN GV 16 Berchem TOT
54,Posthofbrug 5366,2021-03-05,22:00:00,34,11,23,FMN GV 16 Berchem TOT
54,Posthofbrug 5366,2021-03-05,23:00:00,64,29,35,FMN GV 16 Berchem TOT
54,Posthofbrug 5366,2021-03-06,00:00:00,14,12,2,FMN GV 16 Berchem TOT
54,Posthofbrug 5366,2021-03-06,01:00:00,3,1,2,FMN GV 16 Berchem TOT
54,Posthofbrug 5366,2021-03-06,02:00:00,0,0,0,FMN GV 16 Berchem TOT
54,Posthofbrug 5366,2021-03-06,03:00:00,1,0,1,FMN GV 16 Berchem TOT
54,Posthofbrug 5366,2021-03-06,04:00:00,2,1,1,FMN GV 16 Berchem TOT
54,Posthofbrug 5366,2021-03-06,05:00:00,6,2,4,FMN GV 16 Berchem TOT
54,Posthofbrug 5366,2021-03-06,06:00:00,24,15,9,FMN GV 16 Berchem TOT
54,Posthofbrug 5366,2021-03-06,07:00:00,21,13,8,FMN GV 16 Berchem TOT
54,Posthofbrug 5366,2021-03-06,08:00:00,47,28,19,FMN GV 16 Berchem TOT
54,Posthofbrug 5366,2021-03-06,09:00:00,98,50,48,FMN GV 16 Berchem TOT
54,Posthofbrug 5366,2021-03-06,10:00:00,110,60,50,FMN GV 16 Berchem TOT
54,Posthofbrug 5366,2021-03-06,11:00:00,175,107,68,FMN GV 16 Berchem TOT
54,Posthofbrug 5366,2021-03-06,12:00:00,168,88,80,FMN GV 16 Berchem TOT
54,Posthofbrug 5366,2021-03-06,13:00:00,194,108,86,FMN GV 16 Berchem TOT
54,Posthofbrug 5366,2021-03-06,14:00:00,222,142,80,FMN GV 16 Berchem TOT
54,Posthofbrug 5366,2021-03-06,15:00:00,189,84,105,FMN GV 16 Berchem TOT
54,Posthofbrug 5366,2021-03-06,16:00:00,146,75,71,FMN GV 16 Berchem TOT
54,Posthofbrug 5366,2021-03-06,17:00:00,192,93,99,FMN GV 16 Berchem TOT
54,Posthofbrug 5366,2021-03-06,18:00:00,114,47,67,FMN GV 16 Berchem TOT
54,Posthofbrug 5366,2021-03-06,19:00:00,104,43,61,FMN GV 16 Berchem TOT
54,Posthofbrug 5366,2021-03-06,20:00:00,58,33,25,FMN GV 16 Berchem TOT
54,Posthofbrug 5366,2021-03-06,21:00:00,28,14,14,FMN GV 16 Berchem TOT
54,Posthofbrug 5366,2021-03-06,22:00:00,32,14,18,FMN GV 16 Berchem TOT
54,Posthofbrug 5366,2021-03-06,23:00:00,59,25,34,FMN GV 16 Berchem TOT
54,Posthofbrug 5366,2021-03-07,00:00:00,17,10,7,FMN GV 16 Berchem TOT
54,Posthofbrug 5366,2021-03-07,01:00:00,3,0,3,FMN GV 16 Berchem TOT
54,Posthofbrug 5366,2021-03-07,02:00:00,2,0,2,FMN GV 16 Berchem TOT
54,Posthofbrug 5366,2021-03-07,03:00:00,0,0,0,FMN GV 16 Berchem TOT
54,Posthofbrug 5366,2021-03-07,04:00:00,2,1,1,FMN GV 16 Berchem TOT
54,Posthofbrug 5366,2021-03-07,05:00:00,6,3,3,FMN GV 16 Berchem TOT
54,Posthofbrug 5366,2021-03-07,06:00:00,14,8,6,FMN GV 16 Berchem TOT
54,Posthofbrug 5366,2021-03-07,07:00:00,20,12,8,FMN GV 16 Berchem TOT
54,Posthofbrug 5366,2021-03-07,08:00:00,38,19,19,FMN GV 16 Berchem TOT
54,Posthofbrug 5366,2021-03-07,09:00:00,91,48,43,FMN GV 16 Berchem TOT
54,Posthofbrug 5366,2021-03-07,10:00:00,140,66,74,FMN GV 16 Berchem TOT
54,Posthofbrug 5366,2021-03-07,11:00:00,112,65,47,FMN GV 16 Berchem TOT
54,Posthofbrug 5366,2021-03-07,12:00:00,175,104,71,FMN GV 16 Berchem TOT
54,Posthofbrug 5366,2021-03-07,13:00:00,193,120,73,FMN GV 16 Berchem TOT
54,Posthofbrug 5366,2021-03-07,14:00:00,229,113,116,FMN GV 16 Berchem TOT
54,Posthofbrug 5366,2021-03-07,15:00:00,158,82,76,FMN GV 16 Berchem TOT
54,Posthofbrug 5366,2021-03-07,16:00:00,141,77,64,FMN GV 16 Berchem TOT
54,Posthofbrug 5366,2021-03-07,17:00:00,160,71,89,FMN GV 16 Berchem TOT
54,Posthofbrug 5366,2021-03-07,18:00:00,73,32,41,FMN GV 16 Berchem TOT
54,Posthofbrug 5366,2021-03-07,19:00:00,63,21,42,FMN GV 16 Berchem TOT
54,Posthofbrug 5366,2021-03-07,20:00:00,41,27,14,FMN GV 16 Berchem TOT
54,Posthofbrug 5366,2021-03-07,21:00:00,25,16,9,FMN GV 16 Berchem TOT
54,Posthofbrug 5366,2021-03-07,22:00:00,21,10,11,FMN GV 16 Berchem TOT
54,Posthofbrug 5366,2021-03-07,23:00:00,9,3,6,FMN GV 16 Berchem TOT
54,Posthofbrug 5366,2021-03-08,00:00:00,3,0,3,FMN GV 16 Berchem TOT
54,Posthofbrug 5366,2021-03-08,01:00:00,2,1,1,FMN GV 16 Berchem TOT
54,Posthofbrug 5366,2021-03-08,02:00:00,1,1,0,FMN GV 16 Berchem TOT
54,Posthofbrug 5366,2021-03-08,03:00:00,0,0,0,FMN GV 16 Berchem TOT
54,Posthofbrug 5366,2021-03-08,04:00:00,14,9,5,FMN GV 16 Berchem TOT
54,Posthofbrug 5366,2021-03-08,05:00:00,23,18,5,FMN GV 16 Berchem TOT
54,Posthofbrug 5366,2021-03-08,06:00:00,76,62,14,FMN GV 16 Berchem TOT
54,Posthofbrug 5366,2021-03-08,07:00:00,259,188,71,FMN GV 16 Berchem TOT
54,Posthofbrug 5366,2021-03-08,08:00:00,354,273,81,FMN GV 16 Berchem TOT
54,Posthofbrug 5366,2021-03-08,09:00:00,140,93,47,FMN GV 16 Berchem TOT
54,Posthofbrug 5366,2021-03-08,10:00:00,82,59,23,FMN GV 16 Berchem TOT
54,Posthofbrug 5366,2021-03-08,11:00:00,78,52,26,FMN GV 16 Berchem TOT
54,Posthofbrug 5366,2021-03-08,12:00:00,139,58,81,FMN GV 16 Berchem TOT
54,Posthofbrug 5366,2021-03-08,13:00:00,111,59,52,FMN GV 16 Berchem TOT
54,Posthofbrug 5366,2021-03-08,14:00:00,122,64,58,FMN GV 16 Berchem TOT
54,Posthofbrug 5366,2021-03-08,15:00:00,195,80,115,FMN GV 16 Berchem TOT
54,Posthofbrug 5366,2021-03-08,16:00:00,277,86,191,FMN GV 16 Berchem TOT
54,Posthofbrug 5366,2021-03-08,17:00:00,307,105,202,FMN GV 16 Berchem TOT
54,Posthofbrug 5366,2021-03-08,18:00:00,205,76,129,FMN GV 16 Berchem TOT
54,Posthofbrug 5366,2021-03-08,19:00:00,83,35,48,FMN GV 16 Berchem TOT
54,Posthofbrug 5366,2021-03-08,20:00:00,53,26,27,FMN GV 16 Berchem TOT
54,Posthofbrug 5366,2021-03-08,21:00:00,31,17,14,FMN GV 16 Berchem TOT
54,Posthofbrug 5366,2021-03-08,22:00:00,43,19,24,FMN GV 16 Berchem TOT
54,Posthofbrug 5366,2021-03-08,23:00:00,20,9,11,FMN GV 16 Berchem TOT
54,Posthofbrug 5366,2021-03-09,00:00:00,1,0,1,FMN GV 16 Berchem TOT
54,Posthofbrug 5366,2021-03-09,01:00:00,0,0,0,FMN GV 16 Berchem TOT
54,Posthofbrug 5366,2021-03-09,02:00:00,1,0,1,FMN GV 16 Berchem TOT
54,Posthofbrug 5366,2021-03-09,03:00:00,2,1,1,FMN GV 16 Berchem TOT
54,Posthofbrug 5366,2021-03-09,04:00:00,10,8,2,FMN GV 16 Berchem TOT
54,Posthofbrug 5366,2021-03-09,05:00:00,21,15,6,FMN GV 16 Berchem TOT
54,Posthofbrug 5366,2021-03-09,06:00:00,75,59,16,FMN GV 16 Berchem TOT
54,Posthofbrug 5366,2021-03-09,07:00:00,248,178,70,FMN GV 16 Berchem TOT
54,Posthofbrug 5366,2021-03-09,08:00:00,356,273,83,FMN GV 16 Berchem TOT
54,Posthofbrug 5366,2021-03-09,09:00:00,145,108,37,FMN GV 16 Berchem TOT
54,Posthofbrug 5366,2021-03-09,10:00:00,64,40,24,FMN GV 16 Berchem TOT
54,Posthofbrug 5366,2021-03-09,11:00:00,62,31,31,FMN GV 16 Berchem TOT
54,Posthofbrug 5366,2021-03-09,12:00:00,111,65,46,FMN GV 16 Berchem TOT
54,Posthofbrug 5366,2021-03-09,13:00:00,79,47,32,FMN GV 16 Berchem TOT
54,Posthofbrug 5366,2021-03-09,14:00:00,88,36,52,FMN GV 16 Berchem TOT
54,Posthofbrug 5366,2021-03-09,15:00:00,156,59,97,FMN GV 16 Berchem TOT
54,Posthofbrug 5366,2021-03-09,16:00:00,238,77,161,FMN GV 16 Berchem TOT
54,Posthofbrug 5366,2021-03-09,17:00:00,298,91,207,FMN GV 16 Berchem TOT
54,Posthofbrug 5366,2021-03-09,18:00:00,154,61,93,FMN GV 16 Berchem TOT
54,Posthofbrug 5366,2021-03-09,19:00:00,67,31,36,FMN GV 16 Berchem TOT
54,Posthofbrug 5366,2021-03-09,20:00:00,52,24,28,FMN GV 16 Berchem TOT
54,Posthofbrug 5366,2021-03-09,21:00:00,36,12,24,FMN GV 16 Berchem TOT
54,Posthofbrug 5366,2021-03-09,22:00:00,33,12,21,FMN GV 16 Berchem TOT
54,Posthofbrug 5366,2021-03-09,23:00:00,22,6,16,FMN GV 16 Berchem TOT
54,Posthofbrug 5366,2021-03-10,00:00:00,1,1,0,FMN GV 16 Berchem TOT
54,Posthofbrug 5366,2021-03-10,01:00:00,0,0,0,FMN GV 16 Berchem TOT
54,Posthofbrug 5366,2021-03-10,02:00:00,1,0,1,FMN GV 16 Berchem TOT
54,Posthofbrug 5366,2021-03-10,03:00:00,1,1,0,FMN GV 16 Berchem TOT
54,Posthofbrug 5366,2021-03-10,04:00:00,10,8,2,FMN GV 16 Berchem TOT
54,Posthofbrug 5366,2021-03-10,05:00:00,20,15,5,FMN GV 16 Berchem TOT
54,Posthofbrug 5366,2021-03-10,06:00:00,81,62,19,FMN GV 16 Berchem TOT
54,Posthofbrug 5366,2021-03-10,07:00:00,231,164,67,FMN GV 16 Berchem TOT
54,Posthofbrug 5366,2021-03-10,08:00:00,315,216,99,FMN GV 16 Berchem TOT
54,Posthofbrug 5366,2021-03-10,09:00:00,123,79,44,FMN GV 16 Berchem TOT
54,Posthofbrug 5366,2021-03-10,10:00:00,75,52,23,FMN GV 16 Berchem TOT
54,Posthofbrug 5366,2021-03-10,11:00:00,96,43,53,FMN GV 16 Berchem TOT
54,Posthofbrug 5366,2021-03-10,12:00:00,199,81,118,FMN GV 16 Berchem TOT
54,Posthofbrug 5366,2021-03-10,13:00:00,137,65,72,FMN GV 16 Berchem TOT
54,Posthofbrug 5366,2021-03-10,14:00:00,112,50,62,FMN GV 16 Berchem TOT
54,Posthofbrug 5366,2021-03-10,15:00:00,144,60,84,FMN GV 16 Berchem TOT
54,Posthofbrug 5366,2021-03-10,16:00:00,164,55,109,FMN GV 16 Berchem TOT
54,Posthofbrug 5366,2021-03-10,17:00:00,229,85,144,FMN GV 16 Berchem TOT
54,Posthofbrug 5366,2021-03-10,18:00:00,154,54,100,FMN GV 16 Berchem TOT
54,Posthofbrug 5366,2021-03-10,19:00:00,62,25,37,FMN GV 16 Berchem TOT
54,Posthofbrug 5366,2021-03-10,20:00:00,45,24,21,FMN GV 16 Berchem TOT
54,Posthofbrug 5366,2021-03-10,21:00:00,33,20,13,FMN GV 16 Berchem TOT
54,Posthofbrug 5366,2021-03-10,22:00:00,40,8,32,FMN GV 16 Berchem TOT
54,Posthofbrug 5366,2021-03-10,23:00:00,16,6,10,FMN GV 16 Berchem TOT
54,Posthofbrug 5366,2021-03-11,00:00:00,3,3,0,FMN GV 16 Berchem TOT
54,Posthofbrug 5366,2021-03-11,01:00:00,0,0,0,FMN GV 16 Berchem TOT
54,Posthofbrug 5366,2021-03-11,02:00:00,0,0,0,FMN GV 16 Berchem TOT
54,Posthofbrug 5366,2021-03-11,03:00:00,2,2,0,FMN GV 16 Berchem TOT
54,Posthofbrug 5366,2021-03-11,04:00:00,8,7,1,FMN GV 16 Berchem TOT
54,Posthofbrug 5366,2021-03-11,05:00:00,18,12,6,FMN GV 16 Berchem TOT
54,Posthofbrug 5366,2021-03-11,06:00:00,60,47,13,FMN GV 16 Berchem TOT
54,Posthofbrug 5366,2021-03-11,07:00:00,192,138,54,FMN GV 16 Berchem TOT
54,Posthofbrug 5366,2021-03-11,08:00:00,239,178,61,FMN GV 16 Berchem TOT
54,Posthofbrug 5366,2021-03-11,09:00:00,102,73,29,FMN GV 16 Berchem TOT
54,Posthofbrug 5366,2021-03-11,10:00:00,33,20,13,FMN GV 16 Berchem TOT
54,Posthofbrug 5366,2021-03-11,11:00:00,47,26,21,FMN GV 16 Berchem TOT
54,Posthofbrug 5366,2021-03-11,12:00:00,87,52,35,FMN GV 16 Berchem TOT
54,Posthofbrug 5366,2021-03-11,13:00:00,81,40,41,FMN GV 16 Berchem TOT
54,Posthofbrug 5366,2021-03-11,14:00:00,68,35,33,FMN GV 16 Berchem TOT
54,Posthofbrug 5366,2021-03-11,15:00:00,115,40,75,FMN GV 16 Berchem TOT
54,Posthofbrug 5366,2021-03-11,16:00:00,188,55,133,FMN GV 16 Berchem TOT
54,Posthofbrug 5366,2021-03-11,17:00:00,198,64,134,FMN GV 16 Berchem TOT
54,Posthofbrug 5366,2021-03-11,18:00:00,150,47,103,FMN GV 16 Berchem TOT
54,Posthofbrug 5366,2021-03-11,19:00:00,71,27,44,FMN GV 16 Berchem TOT
54,Posthofbrug 5366,2021-03-11,20:00:00,54,31,23,FMN GV 16 Berchem TOT
54,Posthofbrug 5366,2021-03-11,21:00:00,30,16,14,FMN GV 16 Berchem TOT
54,Posthofbrug 5366,2021-03-11,22:00:00,32,15,17,FMN GV 16 Berchem TOT
54,Posthofbrug 5366,2021-03-11,23:00:00,35,11,24,FMN GV 16 Berchem TOT
54,Posthofbrug 5366,2021-03-12,00:00:00,1,1,0,FMN GV 16 Berchem TOT
54,Posthofbrug 5366,2021-03-12,01:00:00,0,0,0,FMN GV 16 Berchem TOT
54,Posthofbrug 5366,2021-03-12,02:00:00,0,0,0,FMN GV 16 Berchem TOT
54,Posthofbrug 5366,2021-03-12,03:00:00,1,0,1,FMN GV 16 Berchem TOT
54,Posthofbrug 5366,2021-03-12,04:00:00,7,7,0,FMN GV 16 Berchem TOT
54,Posthofbrug 5366,2021-03-12,05:00:00,22,17,5,FMN GV 16 Berchem TOT
54,Posthofbrug 5366,2021-03-12,06:00:00,68,55,13,FMN GV 16 Berchem TOT
54,Posthofbrug 5366,2021-03-12,07:00:00,187,124,63,FMN GV 16 Berchem TOT
54,Posthofbrug 5366,2021-03-12,08:00:00,286,208,78,FMN GV 16 Berchem TOT
54,Posthofbrug 5366,2021-03-12,09:00:00,125,87,38,FMN GV 16 Berchem TOT
54,Posthofbrug 5366,2021-03-12,10:00:00,60,47,13,FMN GV 16 Berchem TOT
54,Posthofbrug 5366,2021-03-12,11:00:00,90,49,41,FMN GV 16 Berchem TOT
54,Posthofbrug 5366,2021-03-12,12:00:00,118,62,56,FMN GV 16 Berchem TOT
54,Posthofbrug 5366,2021-03-12,13:00:00,88,47,41,FMN GV 16 Berchem TOT
54,Posthofbrug 5366,2021-03-12,14:00:00,69,33,36,FMN GV 16 Berchem TOT
54,Posthofbrug 5366,2021-03-12,15:00:00,109,38,71,FMN GV 16 Berchem TOT
54,Posthofbrug 5366,2021-03-12,16:00:00,179,50,129,FMN GV 16 Berchem TOT
54,Posthofbrug 5366,2021-03-12,17:00:00,217,79,138,FMN GV 16 Berchem TOT
54,Posthofbrug 5366,2021-03-12,18:00:00,147,67,80,FMN GV 16 Berchem TOT
54,Posthofbrug 5366,2021-03-12,19:00:00,85,45,40,FMN GV 16 Berchem TOT
54,Posthofbrug 5366,2021-03-12,20:00:00,64,25,39,FMN GV 16 Berchem TOT
54,Posthofbrug 5366,2021-03-12,21:00:00,28,11,17,FMN GV 16 Berchem TOT
54,Posthofbrug 5366,2021-03-12,22:00:00,43,24,19,FMN GV 16 Berchem TOT
54,Posthofbrug 5366,2021-03-12,23:00:00,46,22,24,FMN GV 16 Berchem TOT
54,Posthofbrug 5366,2021-03-13,00:00:00,16,6,10,FMN GV 16 Berchem TOT
54,Posthofbrug 5366,2021-03-13,01:00:00,3,2,1,FMN GV 16 Berchem TOT
54,Posthofbrug 5366,2021-03-13,02:00:00,1,0,1,FMN GV 16 Berchem TOT
54,Posthofbrug 5366,2021-03-13,03:00:00,2,2,0,FMN GV 16 Berchem TOT
54,Posthofbrug 5366,2021-03-13,04:00:00,6,2,4,FMN GV 16 Berchem TOT
54,Posthofbrug 5366,2021-03-13,05:00:00,5,3,2,FMN GV 16 Berchem TOT
54,Posthofbrug 5366,2021-03-13,06:00:00,11,9,2,FMN GV 16 Berchem TOT
54,Posthofbrug 5366,2021-03-13,07:00:00,25,17,8,FMN GV 16 Berchem TOT
54,Posthofbrug 5366,2021-03-13,08:00:00,29,20,9,FMN GV 16 Berchem TOT
54,Posthofbrug 5366,2021-03-13,09:00:00,60,41,19,FMN GV 16 Berchem TOT
54,Posthofbrug 5366,2021-03-13,10:00:00,75,42,33,FMN GV 16 Berchem TOT
54,Posthofbrug 5366,2021-03-13,11:00:00,83,51,32,FMN GV 16 Berchem TOT
54,Posthofbrug 5366,2021-03-13,12:00:00,49,28,21,FMN GV 16 Berchem TOT
54,Posthofbrug 5366,2021-03-13,13:00:00,80,45,35,FMN GV 16 Berchem TOT
54,Posthofbrug 5366,2021-03-13,14:00:00,81,48,33,FMN GV 16 Berchem TOT
54,Posthofbrug 5366,2021-03-13,15:00:00,68,38,30,FMN GV 16 Berchem TOT
54,Posthofbrug 5366,2021-03-13,16:00:00,60,27,33,FMN GV 16 Berchem TOT
54,Posthofbrug 5366,2021-03-13,17:00:00,70,34,36,FMN GV 16 Berchem TOT
54,Posthofbrug 5366,2021-03-13,18:00:00,59,26,33,FMN GV 16 Berchem TOT
54,Posthofbrug 5366,2021-03-13,19:00:00,37,20,17,FMN GV 16 Berchem TOT
54,Posthofbrug 5366,2021-03-13,20:00:00,37,16,21,FMN GV 16 Berchem TOT
54,Posthofbrug 5366,2021-03-13,21:00:00,15,7,8,FMN GV 16 Berchem TOT
54,Posthofbrug 5366,2021-03-13,22:00:00,22,12,10,FMN GV 16 Berchem TOT
54,Posthofbrug 5366,2021-03-13,23:00:00,43,16,27,FMN GV 16 Berchem TOT
54,Posthofbrug 5366,2021-03-14,00:00:00,4,2,2,FMN GV 16 Berchem TOT
54,Posthofbrug 5366,2021-03-14,01:00:00,1,0,1,FMN GV 16 Berchem TOT
54,Posthofbrug 5366,2021-03-14,02:00:00,0,0,0,FMN GV 16 Berchem TOT
54,Posthofbrug 5366,2021-03-14,03:00:00,0,0,0,FMN GV 16 Berchem TOT
54,Posthofbrug 5366,2021-03-14,04:00:00,2,2,0,FMN GV 16 Berchem TOT
54,Posthofbrug 5366,2021-03-14,05:00:00,3,2,1,FMN GV 16 Berchem TOT
54,Posthofbrug 5366,2021-03-14,06:00:00,16,13,3,FMN GV 16 Berchem TOT
54,Posthofbrug 5366,2021-03-14,07:00:00,24,19,5,FMN GV 16 Berchem TOT
54,Posthofbrug 5366,2021-03-14,08:00:00,23,9,14,FMN GV 16 Berchem TOT
54,Posthofbrug 5366,2021-03-14,09:00:00,42,25,17,FMN GV 16 Berchem TOT
54,Posthofbrug 5366,2021-03-14,10:00:00,66,40,26,FMN GV 16 Berchem TOT
54,Posthofbrug 5366,2021-03-14,11:00:00,67,35,32,FMN GV 16 Berchem TOT
54,Posthofbrug 5366,2021-03-14,12:00:00,90,49,41,FMN GV 16 Berchem TOT
54,Posthofbrug 5366,2021-03-14,13:00:00,87,48,39,FMN GV 16 Berchem TOT
54,Posthofbrug 5366,2021-03-14,14:00:00,113,45,68,FMN GV 16 Berchem TOT
54,Posthofbrug 5366,2021-03-14,15:00:00,127,59,68,FMN GV 16 Berchem TOT
54,Posthofbrug 5366,2021-03-14,16:00:00,96,49,47,FMN GV 16 Berchem TOT
54,Posthofbrug 5366,2021-03-14,17:00:00,86,43,43,FMN GV 16 Berchem TOT
54,Posthofbrug 5366,2021-03-14,18:00:00,58,29,29,FMN GV 16 Berchem TOT
54,Posthofbrug 5366,2021-03-14,19:00:00,46,19,27,FMN GV 16 Berchem TOT
54,Posthofbrug 5366,2021-03-14,20:00:00,32,17,15,FMN GV 16 Berchem TOT
54,Posthofbrug 5366,2021-03-14,21:00:00,34,19,15,FMN GV 16 Berchem TOT
54,Posthofbrug 5366,2021-03-14,22:00:00,19,14,5,FMN GV 16 Berchem TOT
54,Posthofbrug 5366,2021-03-14,23:00:00,13,5,8,FMN GV 16 Berchem TOT
54,Posthofbrug 5366,2021-03-15,00:00:00,4,3,1,FMN GV 16 Berchem TOT
54,Posthofbrug 5366,2021-03-15,01:00:00,1,0,1,FMN GV 16 Berchem TOT
54,Posthofbrug 5366,2021-03-15,02:00:00,1,0,1,FMN GV 16 Berchem TOT
54,Posthofbrug 5366,2021-03-15,03:00:00,2,1,1,FMN GV 16 Berchem TOT
54,Posthofbrug 5366,2021-03-15,04:00:00,9,7,2,FMN GV 16 Berchem TOT
54,Posthofbrug 5366,2021-03-15,05:00:00,17,14,3,FMN GV 16 Berchem TOT
54,Posthofbrug 5366,2021-03-15,06:00:00,70,58,12,FMN GV 16 Berchem TOT
54,Posthofbrug 5366,2021-03-15,07:00:00,235,181,54,FMN GV 16 Berchem TOT
54,Posthofbrug 5366,2021-03-15,08:00:00,336,255,81,FMN GV 16 Berchem TOT
54,Posthofbrug 5366,2021-03-15,09:00:00,107,76,31,FMN GV 16 Berchem TOT
54,Posthofbrug 5366,2021-03-15,10:00:00,71,52,19,FMN GV 16 Berchem TOT
54,Posthofbrug 5366,2021-03-15,11:00:00,82,52,30,FMN GV 16 Berchem TOT
54,Posthofbrug 5366,2021-03-15,12:00:00,122,50,72,FMN GV 16 Berchem TOT
54,Posthofbrug 5366,2021-03-15,13:00:00,85,45,40,FMN GV 16 Berchem TOT
54,Posthofbrug 5366,2021-03-15,14:00:00,82,35,47,FMN GV 16 Berchem TOT
54,Posthofbrug 5366,2021-03-15,15:00:00,162,62,100,FMN GV 16 Berchem TOT
54,Posthofbrug 5366,2021-03-15,16:00:00,219,79,140,FMN GV 16 Berchem TOT
54,Posthofbrug 5366,2021-03-15,17:00:00,241,73,168,FMN GV 16 Berchem TOT
54,Posthofbrug 5366,2021-03-15,18:00:00,181,60,121,FMN GV 16 Berchem TOT
54,Posthofbrug 5366,2021-03-15,19:00:00,75,31,44,FMN GV 16 Berchem TOT
54,Posthofbrug 5366,2021-03-15,20:00:00,42,19,23,FMN GV 16 Berchem TOT
54,Posthofbrug 5366,2021-03-15,21:00:00,42,23,19,FMN GV 16 Berchem TOT
54,Posthofbrug 5366,2021-03-15,22:00:00,36,17,19,FMN GV 16 Berchem TOT
54,Posthofbrug 5366,2021-03-15,23:00:00,10,1,9,FMN GV 16 Berchem TOT
54,Posthofbrug 5366,2021-03-16,00:00:00,3,2,1,FMN GV 16 Berchem TOT
54,Posthofbrug 5366,2021-03-16,01:00:00,0,0,0,FMN GV 16 Berchem TOT
54,Posthofbrug 5366,2021-03-16,02:00:00,1,0,1,FMN GV 16 Berchem TOT
54,Posthofbrug 5366,2021-03-16,03:00:00,3,2,1,FMN GV 16 Berchem TOT
54,Posthofbrug 5366,2021-03-16,04:00:00,7,6,1,FMN GV 16 Berchem TOT
54,Posthofbrug 5366,2021-03-16,05:00:00,26,21,5,FMN GV 16 Berchem TOT
54,Posthofbrug 5366,2021-03-16,06:00:00,67,53,14,FMN GV 16 Berchem TOT
54,Posthofbrug 5366,2021-03-16,07:00:00,242,174,68,FMN GV 16 Berchem TOT
54,Posthofbrug 5366,2021-03-16,08:00:00,325,245,80,FMN GV 16 Berchem TOT
54,Posthofbrug 5366,2021-03-16,09:00:00,97,76,21,FMN GV 16 Berchem TOT
54,Posthofbrug 5366,2021-03-16,10:00:00,49,31,18,FMN GV 16 Berchem TOT
54,Posthofbrug 5366,2021-03-16,11:00:00,56,27,29,FMN GV 16 Berchem TOT
54,Posthofbrug 5366,2021-03-16,12:00:00,84,49,35,FMN GV 16 Berchem TOT
54,Posthofbrug 5366,2021-03-16,13:00:00,72,27,45,FMN GV 16 Berchem TOT
54,Posthofbrug 5366,2021-03-16,14:00:00,48,18,30,FMN GV 16 Berchem TOT
54,Posthofbrug 5366,2021-03-16,15:00:00,109,35,74,FMN GV 16 Berchem TOT
54,Posthofbrug 5366,2021-03-16,16:00:00,222,72,150,FMN GV 16 Berchem TOT
54,Posthofbrug 5366,2021-03-16,17:00:00,221,54,167,FMN GV 16 Berchem TOT
54,Posthofbrug 5366,2021-03-16,18:00:00,135,46,89,FMN GV 16 Berchem TOT
54,Posthofbrug 5366,2021-03-16,19:00:00,65,27,38,FMN GV 16 Berchem TOT
54,Posthofbrug 5366,2021-03-16,20:00:00,40,19,21,FMN GV 16 Berchem TOT
54,Posthofbrug 5366,2021-03-16,21:00:00,25,9,16,FMN GV 16 Berchem TOT
54,Posthofbrug 5366,2021-03-16,22:00:00,31,13,18,FMN GV 16 Berchem TOT
54,Posthofbrug 5366,2021-03-16,23:00:00,9,3,6,FMN GV 16 Berchem TOT
54,Posthofbrug 5366,2021-03-17,00:00:00,0,0,0,FMN GV 16 Berchem TOT
54,Posthofbrug 5366,2021-03-17,01:00:00,0,0,0,FMN GV 16 Berchem TOT
54,Posthofbrug 5366,2021-03-17,02:00:00,0,0,0,FMN GV 16 Berchem TOT
54,Posthofbrug 5366,2021-03-17,03:00:00,2,1,1,FMN GV 16 Berchem TOT
54,Posthofbrug 5366,2021-03-17,04:00:00,5,4,1,FMN GV 16 Berchem TOT
54,Posthofbrug 5366,2021-03-17,05:00:00,15,11,4,FMN GV 16 Berchem TOT
54,Posthofbrug 5366,2021-03-17,06:00:00,71,57,14,FMN GV 16 Berchem TOT
54,Posthofbrug 5366,2021-03-17,07:00:00,201,139,62,FMN GV 16 Berchem TOT
54,Posthofbrug 5366,2021-03-17,08:00:00,301,219,82,FMN GV 16 Berchem TOT
54,Posthofbrug 5366,2021-03-17,09:00:00,112,80,32,FMN GV 16 Berchem TOT
54,Posthofbrug 5366,2021-03-17,10:00:00,62,35,27,FMN GV 16 Berchem TOT
54,Posthofbrug 5366,2021-03-17,11:00:00,78,39,39,FMN GV 16 Berchem TOT
54,Posthofbrug 5366,2021-03-17,12:00:00,166,79,87,FMN GV 16 Berchem TOT
54,Posthofbrug 5366,2021-03-17,13:00:00,134,57,77,FMN GV 16 Berchem TOT
54,Posthofbrug 5366,2021-03-17,14:00:00,101,49,52,FMN GV 16 Berchem TOT
54,Posthofbrug 5366,2021-03-17,15:00:00,126,61,65,FMN GV 16 Berchem TOT
54,Posthofbrug 5366,2021-03-17,16:00:00,206,68,138,FMN GV 16 Berchem TOT
54,Posthofbrug 5366,2021-03-17,17:00:00,215,78,137,FMN GV 16 Berchem TOT
54,Posthofbrug 5366,2021-03-17,18:00:00,178,68,110,FMN GV 16 Berchem TOT
54,Posthofbrug 5366,2021-03-17,19:00:00,83,38,45,FMN GV 16 Berchem TOT
54,Posthofbrug 5366,2021-03-17,20:00:00,74,41,33,FMN GV 16 Berchem TOT
54,Posthofbrug 5366,2021-03-17,21:00:00,36,21,15,FMN GV 16 Berchem TOT
54,Posthofbrug 5366,2021-03-17,22:00:00,32,11,21,FMN GV 16 Berchem TOT
54,Posthofbrug 5366,2021-03-17,23:00:00,25,10,15,FMN GV 16 Berchem TOT
54,Posthofbrug 5366,2021-03-18,00:00:00,7,3,4,FMN GV 16 Berchem TOT
54,Posthofbrug 5366,2021-03-18,01:00:00,0,0,0,FMN GV 16 Berchem TOT
54,Posthofbrug 5366,2021-03-18,02:00:00,1,0,1,FMN GV 16 Berchem TOT
54,Posthofbrug 5366,2021-03-18,03:00:00,2,1,1,FMN GV 16 Berchem TOT
54,Posthofbrug 5366,2021-03-18,04:00:00,9,8,1,FMN GV 16 Berchem TOT
54,Posthofbrug 5366,2021-03-18,05:00:00,15,9,6,FMN GV 16 Berchem TOT
54,Posthofbrug 5366,2021-03-18,06:00:00,68,54,14,FMN GV 16 Berchem TOT
54,Posthofbrug 5366,2021-03-18,07:00:00,227,167,60,FMN GV 16 Berchem TOT
54,Posthofbrug 5366,2021-03-18,08:00:00,346,260,86,FMN GV 16 Berchem TOT
54,Posthofbrug 5366,2021-03-18,09:00:00,111,77,34,FMN GV 16 Berchem TOT
54,Posthofbrug 5366,2021-03-18,10:00:00,68,43,25,FMN GV 16 Berchem TOT
54,Posthofbrug 5366,2021-03-18,11:00:00,70,32,38,FMN GV 16 Berchem TOT
54,Posthofbrug 5366,2021-03-18,12:00:00,114,63,51,FMN GV 16 Berchem TOT
54,Posthofbrug 5366,2021-03-18,13:00:00,76,37,39,FMN GV 16 Berchem TOT
54,Posthofbrug 5366,2021-03-18,14:00:00,80,35,45,FMN GV 16 Berchem TOT
54,Posthofbrug 5366,2021-03-18,15:00:00,161,52,109,FMN GV 16 Berchem TOT
54,Posthofbrug 5366,2021-03-18,16:00:00,212,73,139,FMN GV 16 Berchem TOT
54,Posthofbrug 5366,2021-03-18,17:00:00,273,85,188,FMN GV 16 Berchem TOT
54,Posthofbrug 5366,2021-03-18,18:00:00,175,59,116,FMN GV 16 Berchem TOT
54,Posthofbrug 5366,2021-03-18,19:00:00,87,44,43,FMN GV 16 Berchem TOT
54,Posthofbrug 5366,2021-03-18,20:00:00,64,44,20,FMN GV 16 Berchem TOT
54,Posthofbrug 5366,2021-03-18,21:00:00,37,20,17,FMN GV 16 Berchem TOT
54,Posthofbrug 5366,2021-03-18,22:00:00,37,14,23,FMN GV 16 Berchem TOT
54,Posthofbrug 5366,2021-03-18,23:00:00,28,9,19,FMN GV 16 Berchem TOT
54,Posthofbrug 5366,2021-03-19,00:00:00,6,2,4,FMN GV 16 Berchem TOT
54,Posthofbrug 5366,2021-03-19,01:00:00,1,0,1,FMN GV 16 Berchem TOT
54,Posthofbrug 5366,2021-03-19,02:00:00,1,0,1,FMN GV 16 Berchem TOT
54,Posthofbrug 5366,2021-03-19,03:00:00,1,0,1,FMN GV 16 Berchem TOT
54,Posthofbrug 5366,2021-03-19,04:00:00,10,10,0,FMN GV 16 Berchem TOT
54,Posthofbrug 5366,2021-03-19,05:00:00,16,13,3,FMN GV 16 Berchem TOT
54,Posthofbrug 5366,2021-03-19,06:00:00,64,50,14,FMN GV 16 Berchem TOT
54,Posthofbrug 5366,2021-03-19,07:00:00,186,128,58,FMN GV 16 Berchem TOT
54,Posthofbrug 5366,2021-03-19,08:00:00,313,232,81,FMN GV 16 Berchem TOT
54,Posthofbrug 5366,2021-03-19,09:00:00,137,97,40,FMN GV 16 Berchem TOT
54,Posthofbrug 5366,2021-03-19,10:00:00,108,72,36,FMN GV 16 Berchem TOT
54,Posthofbrug 5366,2021-03-19,11:00:00,121,67,54,FMN GV 16 Berchem TOT
54,Posthofbrug 5366,2021-03-19,12:00:00,150,76,74,FMN GV 16 Berchem TOT
54,Posthofbrug 5366,2021-03-19,13:00:00,165,104,61,FMN GV 16 Berchem TOT
54,Posthofbrug 5366,2021-03-19,14:00:00,147,65,82,FMN GV 16 Berchem TOT
54,Posthofbrug 5366,2021-03-19,15:00:00,221,87,134,FMN GV 16 Berchem TOT
54,Posthofbrug 5366,2021-03-19,16:00:00,253,91,162,FMN GV 16 Berchem TOT
54,Posthofbrug 5366,2021-03-19,17:00:00,315,103,212,FMN GV 16 Berchem TOT
54,Posthofbrug 5366,2021-03-19,18:00:00,213,80,133,FMN GV 16 Berchem TOT
54,Posthofbrug 5366,2021-03-19,19:00:00,80,40,40,FMN GV 16 Berchem TOT
54,Posthofbrug 5366,2021-03-19,20:00:00,82,45,37,FMN GV 16 Berchem TOT
54,Posthofbrug 5366,2021-03-19,21:00:00,43,23,20,FMN GV 16 Berchem TOT
54,Posthofbrug 5366,2021-03-19,22:00:00,45,19,26,FMN GV 16 Berchem TOT
54,Posthofbrug 5366,2021-03-19,23:00:00,89,37,52,FMN GV 16 Berchem TOT
54,Posthofbrug 5366,2021-03-20,00:00:00,25,16,9,FMN GV 16 Berchem TOT
54,Posthofbrug 5366,2021-03-20,01:00:00,0,0,0,FMN GV 16 Berchem TOT
54,Posthofbrug 5366,2021-03-20,02:00:00,0,0,0,FMN GV 16 Berchem TOT
54,Posthofbrug 5366,2021-03-20,03:00:00,0,0,0,FMN GV 16 Berchem TOT
54,Posthofbrug 5366,2021-03-20,04:00:00,5,4,1,FMN GV 16 Berchem TOT
54,Posthofbrug 5366,2021-03-20,05:00:00,10,6,4,FMN GV 16 Berchem TOT
54,Posthofbrug 5366,2021-03-20,06:00:00,16,10,6,FMN GV 16 Berchem TOT
54,Posthofbrug 5366,2021-03-20,07:00:00,41,19,22,FMN GV 16 Berchem TOT
54,Posthofbrug 5366,2021-03-20,08:00:00,38,26,12,FMN GV 16 Berchem TOT
54,Posthofbrug 5366,2021-03-20,09:00:00,109,76,33,FMN GV 16 Berchem TOT
54,Posthofbrug 5366,2021-03-20,10:00:00,129,80,49,FMN GV 16 Berchem TOT
54,Posthofbrug 5366,2021-03-20,11:00:00,163,93,70,FMN GV 16 Berchem TOT
54,Posthofbrug 5366,2021-03-20,12:00:00,168,99,69,FMN GV 16 Berchem TOT
54,Posthofbrug 5366,2021-03-20,13:00:00,237,136,101,FMN GV 16 Berchem TOT
54,Posthofbrug 5366,2021-03-20,14:00:00,213,115,98,FMN GV 16 Berchem TOT
54,Posthofbrug 5366,2021-03-20,15:00:00,172,81,91,FMN GV 16 Berchem TOT
54,Posthofbrug 5366,2021-03-20,16:00:00,177,89,88,FMN GV 16 Berchem TOT
54,Posthofbrug 5366,2021-03-20,17:00:00,176,67,109,FMN GV 16 Berchem TOT
54,Posthofbrug 5366,2021-03-20,18:00:00,122,60,62,FMN GV 16 Berchem TOT
54,Posthofbrug 5366,2021-03-20,19:00:00,62,20,42,FMN GV 16 Berchem TOT
54,Posthofbrug 5366,2021-03-20,20:00:00,62,22,40,FMN GV 16 Berchem TOT
54,Posthofbrug 5366,2021-03-20,21:00:00,39,17,22,FMN GV 16 Berchem TOT
54,Posthofbrug 5366,2021-03-20,22:00:00,31,13,18,FMN GV 16 Berchem TOT
54,Posthofbrug 5366,2021-03-20,23:00:00,65,35,30,FMN GV 16 Berchem TOT
54,Posthofbrug 5366,2021-03-21,00:00:00,13,7,6,FMN GV 16 Berchem TOT
54,Posthofbrug 5366,2021-03-21,01:00:00,4,2,2,FMN GV 16 Berchem TOT
54,Posthofbrug 5366,2021-03-21,02:00:00,1,0,1,FMN GV 16 Berchem TOT
54,Posthofbrug 5366,2021-03-21,03:00:00,3,2,1,FMN GV 16 Berchem TOT
54,Posthofbrug 5366,2021-03-21,04:00:00,1,1,0,FMN GV 16 Berchem TOT
54,Posthofbrug 5366,2021-03-21,05:00:00,7,7,0,FMN GV 16 Berchem TOT
54,Posthofbrug 5366,2021-03-21,06:00:00,12,8,4,FMN GV 16 Berchem TOT
54,Posthofbrug 5366,2021-03-21,07:00:00,34,18,16,FMN GV 16 Berchem TOT
54,Posthofbrug 5366,2021-03-21,08:00:00,51,22,29,FMN GV 16 Berchem TOT
54,Posthofbrug 5366,2021-03-21,09:00:00,105,60,45,FMN GV 16 Berchem TOT
54,Posthofbrug 5366,2021-03-21,10:00:00,125,62,63,FMN GV 16 Berchem TOT
54,Posthofbrug 5366,2021-03-21,11:00:00,109,56,53,FMN GV 16 Berchem TOT
54,Posthofbrug 5366,2021-03-21,12:00:00,170,107,63,FMN GV 16 Berchem TOT
54,Posthofbrug 5366,2021-03-21,13:00:00,149,75,74,FMN GV 16 Berchem TOT
54,Posthofbrug 5366,2021-03-21,14:00:00,135,70,65,FMN GV 16 Berchem TOT
54,Posthofbrug 5366,2021-03-21,15:00:00,123,65,58,FMN GV 16 Berchem TOT
54,Posthofbrug 5366,2021-03-21,16:00:00,161,78,83,FMN GV 16 Berchem TOT
54,Posthofbrug 5366,2021-03-21,17:00:00,124,71,53,FMN GV 16 Berchem TOT
54,Posthofbrug 5366,2021-03-21,18:00:00,52,21,31,FMN GV 16 Berchem TOT
54,Posthofbrug 5366,2021-03-21,19:00:00,44,20,24,FMN GV 16 Berchem TOT
54,Posthofbrug 5366,2021-03-21,20:00:00,37,26,11,FMN GV 16 Berchem TOT
54,Posthofbrug 5366,2021-03-21,21:00:00,25,14,11,FMN GV 16 Berchem TOT
54,Posthofbrug 5366,2021-03-21,22:00:00,24,12,12,FMN GV 16 Berchem TOT
54,Posthofbrug 5366,2021-03-21,23:00:00,26,10,16,FMN GV 16 Berchem TOT
54,Posthofbrug 5366,2021-03-22,00:00:00,4,0,4,FMN GV 16 Berchem TOT
54,Posthofbrug 5366,2021-03-22,01:00:00,0,0,0,FMN GV 16 Berchem TOT
54,Posthofbrug 5366,2021-03-22,02:00:00,2,0,2,FMN GV 16 Berchem TOT
54,Posthofbrug 5366,2021-03-22,03:00:00,2,2,0,FMN GV 16 Berchem TOT
54,Posthofbrug 5366,2021-03-22,04:00:00,7,6,1,FMN GV 16 Berchem TOT
54,Posthofbrug 5366,2021-03-22,05:00:00,16,11,5,FMN GV 16 Berchem TOT
54,Posthofbrug 5366,2021-03-22,06:00:00,71,61,10,FMN GV 16 Berchem TOT
54,Posthofbrug 5366,2021-03-22,07:00:00,279,207,72,FMN GV 16 Berchem TOT
54,Posthofbrug 5366,2021-03-22,08:00:00,346,263,83,FMN GV 16 Berchem TOT
54,Posthofbrug 5366,2021-03-22,09:00:00,132,90,42,FMN GV 16 Berchem TOT
54,Posthofbrug 5366,2021-03-22,10:00:00,87,51,36,FMN GV 16 Berchem TOT
54,Posthofbrug 5366,2021-03-22,11:00:00,82,46,36,FMN GV 16 Berchem TOT
54,Posthofbrug 5366,2021-03-22,12:00:00,116,58,58,FMN GV 16 Berchem TOT
54,Posthofbrug 5366,2021-03-22,13:00:00,105,57,48,FMN GV 16 Berchem TOT
54,Posthofbrug 5366,2021-03-22,14:00:00,90,36,54,FMN GV 16 Berchem TOT
54,Posthofbrug 5366,2021-03-22,15:00:00,173,64,109,FMN GV 16 Berchem TOT
54,Posthofbrug 5366,2021-03-22,16:00:00,225,72,153,FMN GV 16 Berchem TOT
54,Posthofbrug 5366,2021-03-22,17:00:00,275,87,188,FMN GV 16 Berchem TOT
54,Posthofbrug 5366,2021-03-22,18:00:00,205,70,135,FMN GV 16 Berchem TOT
54,Posthofbrug 5366,2021-03-22,19:00:00,96,42,54,FMN GV 16 Berchem TOT
54,Posthofbrug 5366,2021-03-22,20:00:00,55,26,29,FMN GV 16 Berchem TOT
54,Posthofbrug 5366,2021-03-22,21:00:00,73,39,34,FMN GV 16 Berchem TOT
54,Posthofbrug 5366,2021-03-22,22:00:00,31,12,19,FMN GV 16 Berchem TOT
54,Posthofbrug 5366,2021-03-22,23:00:00,23,10,13,FMN GV 16 Berchem TOT
54,Posthofbrug 5366,2021-03-23,00:00:00,5,1,4,FMN GV 16 Berchem TOT
54,Posthofbrug 5366,2021-03-23,01:00:00,2,1,1,FMN GV 16 Berchem TOT
54,Posthofbrug 5366,2021-03-23,02:00:00,0,0,0,FMN GV 16 Berchem TOT
54,Posthofbrug 5366,2021-03-23,03:00:00,1,1,0,FMN GV 16 Berchem TOT
54,Posthofbrug 5366,2021-03-23,04:00:00,10,9,1,FMN GV 16 Berchem TOT
54,Posthofbrug 5366,2021-03-23,05:00:00,19,13,6,FMN GV 16 Berchem TOT
54,Posthofbrug 5366,2021-03-23,06:00:00,81,66,15,FMN GV 16 Berchem TOT
54,Posthofbrug 5366,2021-03-23,07:00:00,264,193,71,FMN GV 16 Berchem TOT
54,Posthofbrug 5366,2021-03-23,08:00:00,354,264,90,FMN GV 16 Berchem TOT
54,Posthofbrug 5366,2021-03-23,09:00:00,125,95,30,FMN GV 16 Berchem TOT
54,Posthofbrug 5366,2021-03-23,10:00:00,88,66,22,FMN GV 16 Berchem TOT
54,Posthofbrug 5366,2021-03-23,11:00:00,78,45,33,FMN GV 16 Berchem TOT
54,Posthofbrug 5366,2021-03-23,12:00:00,135,70,65,FMN GV 16 Berchem TOT
54,Posthofbrug 5366,2021-03-23,13:00:00,136,70,66,FMN GV 16 Berchem TOT
54,Posthofbrug 5366,2021-03-23,14:00:00,118,59,59,FMN GV 16 Berchem TOT
54,Posthofbrug 5366,2021-03-23,15:00:00,195,75,120,FMN GV 16 Berchem TOT
54,Posthofbrug 5366,2021-03-23,16:00:00,285,98,187,FMN GV 16 Berchem TOT
54,Posthofbrug 5366,2021-03-23,17:00:00,306,90,216,FMN GV 16 Berchem TOT
54,Posthofbrug 5366,2021-03-23,18:00:00,215,73,142,FMN GV 16 Berchem TOT
54,Posthofbrug 5366,2021-03-23,19:00:00,125,56,69,FMN GV 16 Berchem TOT
54,Posthofbrug 5366,2021-03-23,20:00:00,70,35,35,FMN GV 16 Berchem TOT
54,Posthofbrug 5366,2021-03-23,21:00:00,46,25,21,FMN GV 16 Berchem TOT
54,Posthofbrug 5366,2021-03-23,22:00:00,50,28,22,FMN GV 16 Berchem TOT
54,Posthofbrug 5366,2021-03-23,23:00:00,24,9,15,FMN GV 16 Berchem TOT
54,Posthofbrug 5366,2021-03-24,00:00:00,3,0,3,FMN GV 16 Berchem TOT
54,Posthofbrug 5366,2021-03-24,01:00:00,0,0,0,FMN GV 16 Berchem TOT
54,Posthofbrug 5366,2021-03-24,02:00:00,1,0,1,FMN GV 16 Berchem TOT
54,Posthofbrug 5366,2021-03-24,03:00:00,0,0,0,FMN GV 16 Berchem TOT
54,Posthofbrug 5366,2021-03-24,04:00:00,8,7,1,FMN GV 16 Berchem TOT
54,Posthofbrug 5366,2021-03-24,05:00:00,25,21,4,FMN GV 16 Berchem TOT
54,Posthofbrug 5366,2021-03-24,06:00:00,90,69,21,FMN GV 16 Berchem TOT
54,Posthofbrug 5366,2021-03-24,07:00:00,240,173,67,FMN GV 16 Berchem TOT
54,Posthofbrug 5366,2021-03-24,08:00:00,354,259,95,FMN GV 16 Berchem TOT
54,Posthofbrug 5366,2021-03-24,09:00:00,162,111,51,FMN GV 16 Berchem TOT
54,Posthofbrug 5366,2021-03-24,10:00:00,92,55,37,FMN GV 16 Berchem TOT
54,Posthofbrug 5366,2021-03-24,11:00:00,136,65,71,FMN GV 16 Berchem TOT
54,Posthofbrug 5366,2021-03-24,12:00:00,228,103,125,FMN GV 16 Berchem TOT
54,Posthofbrug 5366,2021-03-24,13:00:00,200,95,105,FMN GV 16 Berchem TOT
54,Posthofbrug 5366,2021-03-24,14:00:00,185,95,90,FMN GV 16 Berchem TOT
54,Posthofbrug 5366,2021-03-24,15:00:00,188,84,104,FMN GV 16 Berchem TOT
54,Posthofbrug 5366,2021-03-24,16:00:00,305,112,193,FMN GV 16 Berchem TOT
54,Posthofbrug 5366,2021-03-24,17:00:00,332,112,220,FMN GV 16 Berchem TOT
54,Posthofbrug 5366,2021-03-24,18:00:00,227,79,148,FMN GV 16 Berchem TOT
54,Posthofbrug 5366,2021-03-24,19:00:00,102,47,55,FMN GV 16 Berchem TOT
54,Posthofbrug 5366,2021-03-24,20:00:00,93,51,42,FMN GV 16 Berchem TOT
54,Posthofbrug 5366,2021-03-24,21:00:00,34,17,17,FMN GV 16 Berchem TOT
54,Posthofbrug 5366,2021-03-24,22:00:00,41,18,23,FMN GV 16 Berchem TOT
54,Posthofbrug 5366,2021-03-24,23:00:00,49,15,34,FMN GV 16 Berchem TOT
54,Posthofbrug 5366,2021-03-25,00:00:00,4,3,1,FMN GV 16 Berchem TOT
54,Posthofbrug 5366,2021-03-25,01:00:00,1,1,0,FMN GV 16 Berchem TOT
54,Posthofbrug 5366,2021-03-25,02:00:00,1,0,1,FMN GV 16 Berchem TOT
54,Posthofbrug 5366,2021-03-25,03:00:00,3,2,1,FMN GV 16 Berchem TOT
54,Posthofbrug 5366,2021-03-25,04:00:00,14,9,5,FMN GV 16 Berchem TOT
54,Posthofbrug 5366,2021-03-25,05:00:00,26,17,9,FMN GV 16 Berchem TOT
54,Posthofbrug 5366,2021-03-25,06:00:00,81,66,15,FMN GV 16 Berchem TOT
54,Posthofbrug 5366,2021-03-25,07:00:00,261,181,80,FMN GV 16 Berchem TOT
54,Posthofbrug 5366,2021-03-25,08:00:00,330,261,69,FMN GV 16 Berchem TOT
54,Posthofbrug 5366,2021-03-25,09:00:00,133,97,36,FMN GV 16 Berchem TOT
54,Posthofbrug 5366,2021-03-25,10:00:00,94,58,36,FMN GV 16 Berchem TOT
54,Posthofbrug 5366,2021-03-25,11:00:00,77,47,30,FMN GV 16 Berchem TOT
54,Posthofbrug 5366,2021-03-25,12:00:00,160,82,78,FMN GV 16 Berchem TOT
54,Posthofbrug 5366,2021-03-25,13:00:00,125,70,55,FMN GV 16 Berchem TOT
54,Posthofbrug 5366,2021-03-25,14:00:00,145,58,87,FMN GV 16 Berchem TOT
54,Posthofbrug 5366,2021-03-25,15:00:00,183,58,125,FMN GV 16 Berchem TOT
54,Posthofbrug 5366,2021-03-25,16:00:00,296,98,198,FMN GV 16 Berchem TOT
54,Posthofbrug 5366,2021-03-25,17:00:00,277,96,181,FMN GV 16 Berchem TOT
54,Posthofbrug 5366,2021-03-25,18:00:00,221,82,139,FMN GV 16 Berchem TOT
54,Posthofbrug 5366,2021-03-25,19:00:00,107,56,51,FMN GV 16 Berchem TOT
54,Posthofbrug 5366,2021-03-25,20:00:00,72,42,30,FMN GV 16 Berchem TOT
54,Posthofbrug 5366,2021-03-25,21:00:00,35,14,21,FMN GV 16 Berchem TOT
54,Posthofbrug 5366,2021-03-25,22:00:00,52,28,24,FMN GV 16 Berchem TOT
54,Posthofbrug 5366,2021-03-25,23:00:00,42,16,26,FMN GV 16 Berchem TOT
54,Posthofbrug 5366,2021-03-26,00:00:00,9,2,7,FMN GV 16 Berchem TOT
54,Posthofbrug 5366,2021-03-26,01:00:00,3,0,3,FMN GV 16 Berchem TOT
54,Posthofbrug 5366,2021-03-26,02:00:00,1,0,1,FMN GV 16 Berchem TOT
54,Posthofbrug 5366,2021-03-26,03:00:00,1,1,0,FMN GV 16 Berchem TOT
54,Posthofbrug 5366,2021-03-26,04:00:00,11,10,1,FMN GV 16 Berchem TOT
54,Posthofbrug 5366,2021-03-26,05:00:00,16,9,7,FMN GV 16 Berchem TOT
54,Posthofbrug 5366,2021-03-26,06:00:00,75,55,20,FMN GV 16 Berchem TOT
54,Posthofbrug 5366,2021-03-26,07:00:00,214,156,58,FMN GV 16 Berchem TOT
54,Posthofbrug 5366,2021-03-26,08:00:00,338,248,90,FMN GV 16 Berchem TOT
54,Posthofbrug 5366,2021-03-26,09:00:00,146,97,49,FMN GV 16 Berchem TOT
54,Posthofbrug 5366,2021-03-26,10:00:00,104,62,42,FMN GV 16 Berchem TOT
54,Posthofbrug 5366,2021-03-26,11:00:00,126,76,50,FMN GV 16 Berchem TOT
54,Posthofbrug 5366,2021-03-26,12:00:00,162,73,89,FMN GV 16 Berchem TOT
54,Posthofbrug 5366,2021-03-26,13:00:00,173,83,90,FMN GV 16 Berchem TOT
54,Posthofbrug 5366,2021-03-26,14:00:00,162,63,99,FMN GV 16 Berchem TOT
54,Posthofbrug 5366,2021-03-26,15:00:00,229,98,131,FMN GV 16 Berchem TOT
54,Posthofbrug 5366,2021-03-26,16:00:00,237,98,139,FMN GV 16 Berchem TOT
54,Posthofbrug 5366,2021-03-26,17:00:00,257,87,170,FMN GV 16 Berchem TOT
54,Posthofbrug 5366,2021-03-26,18:00:00,193,59,134,FMN GV 16 Berchem TOT
54,Posthofbrug 5366,2021-03-26,19:00:00,116,58,58,FMN GV 16 Berchem TOT
54,Posthofbrug 5366,2021-03-26,20:00:00,84,41,43,FMN GV 16 Berchem TOT
54,Posthofbrug 5366,2021-03-26,21:00:00,47,18,29,FMN GV 16 Berchem TOT
54,Posthofbrug 5366,2021-03-26,22:00:00,50,29,21,FMN GV 16 Berchem TOT
54,Posthofbrug 5366,2021-03-26,23:00:00,65,30,35,FMN GV 16 Berchem TOT
54,Posthofbrug 5366,2021-03-27,00:00:00,20,5,15,FMN GV 16 Berchem TOT
54,Posthofbrug 5366,2021-03-27,01:00:00,5,0,5,FMN GV 16 Berchem TOT
54,Posthofbrug 5366,2021-03-27,02:00:00,3,0,3,FMN GV 16 Berchem TOT
54,Posthofbrug 5366,2021-03-27,03:00:00,1,0,1,FMN GV 16 Berchem TOT
54,Posthofbrug 5366,2021-03-27,04:00:00,2,1,1,FMN GV 16 Berchem TOT
54,Posthofbrug 5366,2021-03-27,05:00:00,8,4,4,FMN GV 16 Berchem TOT
54,Posthofbrug 5366,2021-03-27,06:00:00,14,8,6,FMN GV 16 Berchem TOT
54,Posthofbrug 5366,2021-03-27,07:00:00,22,17,5,FMN GV 16 Berchem TOT
54,Posthofbrug 5366,2021-03-27,08:00:00,41,26,15,FMN GV 16 Berchem TOT
54,Posthofbrug 5366,2021-03-27,09:00:00,65,35,30,FMN GV 16 Berchem TOT
54,Posthofbrug 5366,2021-03-27,10:00:00,97,52,45,FMN GV 16 Berchem TOT
54,Posthofbrug 5366,2021-03-27,11:00:00,100,58,42,FMN GV 16 Berchem TOT
54,Posthofbrug 5366,2021-03-27,12:00:00,94,61,33,FMN GV 16 Berchem TOT
54,Posthofbrug 5366,2021-03-27,13:00:00,146,77,69,FMN GV 16 Berchem TOT
54,Posthofbrug 5366,2021-03-27,14:00:00,171,96,75,FMN GV 16 Berchem TOT
54,Posthofbrug 5366,2021-03-27,15:00:00,138,68,70,FMN GV 16 Berchem TOT
54,Posthofbrug 5366,2021-03-27,16:00:00,113,56,57,FMN GV 16 Berchem TOT
54,Posthofbrug 5366,2021-03-27,17:00:00,150,68,82,FMN GV 16 Berchem TOT
54,Posthofbrug 5366,2021-03-27,18:00:00,89,40,49,FMN GV 16 Berchem TOT
54,Posthofbrug 5366,2021-03-27,19:00:00,59,25,34,FMN GV 16 Berchem TOT
54,Posthofbrug 5366,2021-03-27,20:00:00,48,28,20,FMN GV 16 Berchem TOT
54,Posthofbrug 5366,2021-03-27,21:00:00,24,12,12,FMN GV 16 Berchem TOT
54,Posthofbrug 5366,2021-03-27,22:00:00,39,19,20,FMN GV 16 Berchem TOT
54,Posthofbrug 5366,2021-03-27,23:00:00,51,27,24,FMN GV 16 Berchem TOT
54,Posthofbrug 5366,2021-03-28,00:00:00,9,2,7,FMN GV 16 Berchem TOT
54,Posthofbrug 5366,2021-03-28,01:00:00,2,0,2,FMN GV 16 Berchem TOT
54,Posthofbrug 5366,2021-03-28,02:00:00,0,0,0,FMN GV 16 Berchem TOT
54,Posthofbrug 5366,2021-03-28,03:00:00,3,0,3,FMN GV 16 Berchem TOT
54,Posthofbrug 5366,2021-03-28,04:00:00,2,1,1,FMN GV 16 Berchem TOT
54,Posthofbrug 5366,2021-03-28,05:00:00,5,3,2,FMN GV 16 Berchem TOT
54,Posthofbrug 5366,2021-03-28,06:00:00,16,11,5,FMN GV 16 Berchem TOT
54,Posthofbrug 5366,2021-03-28,07:00:00,23,10,13,FMN GV 16 Berchem TOT
54,Posthofbrug 5366,2021-03-28,08:00:00,32,19,13,FMN GV 16 Berchem TOT
54,Posthofbrug 5366,2021-03-28,09:00:00,109,48,61,FMN GV 16 Berchem TOT
54,Posthofbrug 5366,2021-03-28,10:00:00,112,53,59,FMN GV 16 Berchem TOT
54,Posthofbrug 5366,2021-03-28,11:00:00,125,46,79,FMN GV 16 Berchem TOT
54,Posthofbrug 5366,2021-03-28,12:00:00,182,106,76,FMN GV 16 Berchem TOT
54,Posthofbrug 5366,2021-03-28,13:00:00,166,100,66,FMN GV 16 Berchem TOT
54,Posthofbrug 5366,2021-03-28,14:00:00,158,77,81,FMN GV 16 Berchem TOT
54,Posthofbrug 5366,2021-03-28,15:00:00,161,92,69,FMN GV 16 Berchem TOT
54,Posthofbrug 5366,2021-03-28,16:00:00,125,60,65,FMN GV 16 Berchem TOT
54,Posthofbrug 5366,2021-03-28,17:00:00,161,78,83,FMN GV 16 Berchem TOT
54,Posthofbrug 5366,2021-03-28,18:00:00,101,53,48,FMN GV 16 Berchem TOT
54,Posthofbrug 5366,2021-03-28,19:00:00,77,32,45,FMN GV 16 Berchem TOT
54,Posthofbrug 5366,2021-03-28,20:00:00,37,23,14,FMN GV 16 Berchem TOT
54,Posthofbrug 5366,2021-03-28,21:00:00,34,19,15,FMN GV 16 Berchem TOT
54,Posthofbrug 5366,2021-03-28,22:00:00,20,12,8,FMN GV 16 Berchem TOT
54,Posthofbrug 5366,2021-03-28,23:00:00,19,15,4,FMN GV 16 Berchem TOT
54,Posthofbrug 5366,2021-03-29,00:00:00,1,0,1,FMN GV 16 Berchem TOT
54,Posthofbrug 5366,2021-03-29,01:00:00,1,0,1,FMN GV 16 Berchem TOT
54,Posthofbrug 5366,2021-03-29,02:00:00,1,0,1,FMN GV 16 Berchem TOT
54,Posthofbrug 5366,2021-03-29,03:00:00,3,3,0,FMN GV 16 Berchem TOT
54,Posthofbrug 5366,2021-03-29,04:00:00,5,4,1,FMN GV 16 Berchem TOT
54,Posthofbrug 5366,2021-03-29,05:00:00,15,9,6,FMN GV 16 Berchem TOT
54,Posthofbrug 5366,2021-03-29,06:00:00,62,42,20,FMN GV 16 Berchem TOT
54,Posthofbrug 5366,2021-03-29,07:00:00,185,129,56,FMN GV 16 Berchem TOT
54,Posthofbrug 5366,2021-03-29,08:00:00,266,199,67,FMN GV 16 Berchem TOT
54,Posthofbrug 5366,2021-03-29,09:00:00,157,109,48,FMN GV 16 Berchem TOT
54,Posthofbrug 5366,2021-03-29,10:00:00,104,61,43,FMN GV 16 Berchem TOT
54,Posthofbrug 5366,2021-03-29,11:00:00,99,56,43,FMN GV 16 Berchem TOT
54,Posthofbrug 5366,2021-03-29,12:00:00,141,71,70,FMN GV 16 Berchem TOT
54,Posthofbrug 5366,2021-03-29,13:00:00,184,117,67,FMN GV 16 Berchem TOT
54,Posthofbrug 5366,2021-03-29,14:00:00,178,80,98,FMN GV 16 Berchem TOT
54,Posthofbrug 5366,2021-03-29,15:00:00,171,71,100,FMN GV 16 Berchem TOT
54,Posthofbrug 5366,2021-03-29,16:00:00,303,84,219,FMN GV 16 Berchem TOT
54,Posthofbrug 5366,2021-03-29,17:00:00,351,132,219,FMN GV 16 Berchem TOT
54,Posthofbrug 5366,2021-03-29,18:00:00,255,114,141,FMN GV 16 Berchem TOT
54,Posthofbrug 5366,2021-03-29,19:00:00,146,82,64,FMN GV 16 Berchem TOT
54,Posthofbrug 5366,2021-03-29,20:00:00,92,50,42,FMN GV 16 Berchem TOT
54,Posthofbrug 5366,2021-03-29,21:00:00,50,26,24,FMN GV 16 Berchem TOT
54,Posthofbrug 5366,2021-03-29,22:00:00,45,25,20,FMN GV 16 Berchem TOT
54,Posthofbrug 5366,2021-03-29,23:00:00,40,17,23,FMN GV 16 Berchem TOT
54,Posthofbrug 5366,2021-03-30,00:00:00,10,3,7,FMN GV 16 Berchem TOT
54,Posthofbrug 5366,2021-03-30,01:00:00,3,2,1,FMN GV 16 Berchem TOT
54,Posthofbrug 5366,2021-03-30,02:00:00,0,0,0,FMN GV 16 Berchem TOT
54,Posthofbrug 5366,2021-03-30,03:00:00,1,1,0,FMN GV 16 Berchem TOT
54,Posthofbrug 5366,2021-03-30,04:00:00,10,9,1,FMN GV 16 Berchem TOT
54,Posthofbrug 5366,2021-03-30,05:00:00,25,14,11,FMN GV 16 Berchem TOT
54,Posthofbrug 5366,2021-03-30,06:00:00,90,64,26,FMN GV 16 Berchem TOT
54,Posthofbrug 5366,2021-03-30,07:00:00,211,148,63,FMN GV 16 Berchem TOT
54,Posthofbrug 5366,2021-03-30,08:00:00,278,202,76,FMN GV 16 Berchem TOT
54,Posthofbrug 5366,2021-03-30,09:00:00,179,134,45,FMN GV 16 Berchem TOT
54,Posthofbrug 5366,2021-03-30,10:00:00,99,51,48,FMN GV 16 Berchem TOT
54,Posthofbrug 5366,2021-03-30,11:00:00,139,73,66,FMN GV 16 Berchem TOT
54,Posthofbrug 5366,2021-03-30,12:00:00,145,71,74,FMN GV 16 Berchem TOT
54,Posthofbrug 5366,2021-03-30,13:00:00,234,126,108,FMN GV 16 Berchem TOT
54,Posthofbrug 5366,2021-03-30,14:00:00,174,89,85,FMN GV 16 Berchem TOT
54,Posthofbrug 5366,2021-03-30,15:00:00,233,102,131,FMN GV 16 Berchem TOT
54,Posthofbrug 5366,2021-03-30,16:00:00,336,130,206,FMN GV 16 Berchem TOT
54,Posthofbrug 5366,2021-03-30,17:00:00,386,152,234,FMN GV 16 Berchem TOT
54,Posthofbrug 5366,2021-03-30,18:00:00,285,110,175,FMN GV 16 Berchem TOT
54,Posthofbrug 5366,2021-03-30,19:00:00,191,90,101,FMN GV 16 Berchem TOT
54,Posthofbrug 5366,2021-03-30,20:00:00,102,55,47,FMN GV 16 Berchem TOT
54,Posthofbrug 5366,2021-03-30,21:00:00,64,33,31,FMN GV 16 Berchem TOT
54,Posthofbrug 5366,2021-03-30,22:00:00,66,25,41,FMN GV 16 Berchem TOT
54,Posthofbrug 5366,2021-03-30,23:00:00,64,23,41,FMN GV 16 Berchem TOT
54,Posthofbrug 5366,2021-03-31,00:00:00,8,3,5,FMN GV 16 Berchem TOT
54,Posthofbrug 5366,2021-03-31,01:00:00,5,3,2,FMN GV 16 Berchem TOT
54,Posthofbrug 5366,2021-03-31,02:00:00,0,0,0,FMN GV 16 Berchem TOT
54,Posthofbrug 5366,2021-03-31,03:00:00,4,3,1,FMN GV 16 Berchem TOT
54,Posthofbrug 5366,2021-03-31,04:00:00,8,7,1,FMN GV 16 Berchem TOT
54,Posthofbrug 5366,2021-03-31,05:00:00,20,14,6,FMN GV 16 Berchem TOT
54,Posthofbrug 5366,2021-03-31,06:00:00,90,65,25,FMN GV 16 Berchem TOT
54,Posthofbrug 5366,2021-03-31,07:00:00,169,112,57,FMN GV 16 Berchem TOT
54,Posthofbrug 5366,2021-03-31,08:00:00,262,187,75,FMN GV 16 Berchem TOT
54,Posthofbrug 5366,2021-03-31,09:00:00,164,116,48,FMN GV 16 Berchem TOT
54,Posthofbrug 5366,2021-03-31,10:00:00,117,69,48,FMN GV 16 Berchem TOT
54,Posthofbrug 5366,2021-03-31,11:00:00,150,78,72,FMN GV 16 Berchem TOT
54,Posthofbrug 5366,2021-03-31,12:00:00,209,114,95,FMN GV 16 Berchem TOT
54,Posthofbrug 5366,2021-03-31,13:00:00,245,130,115,FMN GV 16 Berchem TOT
54,Posthofbrug 5366,2021-03-31,14:00:00,184,78,106,FMN GV 16 Berchem TOT
54,Posthofbrug 5366,2021-03-31,15:00:00,264,122,142,FMN GV 16 Berchem TOT
54,Posthofbrug 5366,2021-03-31,16:00:00,331,136,195,FMN GV 16 Berchem TOT
54,Posthofbrug 5366,2021-03-31,17:00:00,366,158,208,FMN GV 16 Berchem TOT
54,Posthofbrug 5366,2021-03-31,18:00:00,291,141,150,FMN GV 16 Berchem TOT
54,Posthofbrug 5366,2021-03-31,19:00:00,180,102,78,FMN GV 16 Berchem TOT
54,Posthofbrug 5366,2021-03-31,20:00:00,126,72,54,FMN GV 16 Berchem TOT
54,Posthofbrug 5366,2021-03-31,21:00:00,74,35,39,FMN GV 16 Berchem TOT
54,Posthofbrug 5366,2021-03-31,22:00:00,49,29,20,FMN GV 16 Berchem TOT
54,Posthofbrug 5366,2021-03-31,23:00:00,67,26,41,FMN GV 16 Berchem TOT
54,Posthofbrug 5366,2021-04-01,00:00:00,3,1,2,FMN GV 16 Berchem TOT
54,Posthofbrug 5366,2021-04-01,01:00:00,3,2,1,FMN GV 16 Berchem TOT
54,Posthofbrug 5366,2021-04-01,02:00:00,0,0,0,FMN GV 16 Berchem TOT
54,Posthofbrug 5366,2021-04-01,03:00:00,1,0,1,FMN GV 16 Berchem TOT
54,Posthofbrug 5366,2021-04-01,04:00:00,11,9,2,FMN GV 16 Berchem TOT
54,Posthofbrug 5366,2021-04-01,05:00:00,18,14,4,FMN GV 16 Berchem TOT
54,Posthofbrug 5366,2021-04-01,06:00:00,80,56,24,FMN GV 16 Berchem TOT
54,Posthofbrug 5366,2021-04-01,07:00:00,174,124,50,FMN GV 16 Berchem TOT
54,Posthofbrug 5366,2021-04-01,08:00:00,254,193,61,FMN GV 16 Berchem TOT
54,Posthofbrug 5366,2021-04-01,09:00:00,162,114,48,FMN GV 16 Berchem TOT
54,Posthofbrug 5366,2021-04-01,10:00:00,102,63,39,FMN GV 16 Berchem TOT
54,Posthofbrug 5366,2021-04-01,11:00:00,98,58,40,FMN GV 16 Berchem TOT
54,Posthofbrug 5366,2021-04-01,12:00:00,172,92,80,FMN GV 16 Berchem TOT
54,Posthofbrug 5366,2021-04-01,13:00:00,212,126,86,FMN GV 16 Berchem TOT
54,Posthofbrug 5366,2021-04-01,14:00:00,192,93,99,FMN GV 16 Berchem TOT
54,Posthofbrug 5366,2021-04-01,15:00:00,240,100,140,FMN GV 16 Berchem TOT
54,Posthofbrug 5366,2021-04-01,16:00:00,318,114,204,FMN GV 16 Berchem TOT
54,Posthofbrug 5366,2021-04-01,17:00:00,376,154,222,FMN GV 16 Berchem TOT
54,Posthofbrug 5366,2021-04-01,18:00:00,274,129,145,FMN GV 16 Berchem TOT
54,Posthofbrug 5366,2021-04-01,19:00:00,169,91,78,FMN GV 16 Berchem TOT
54,Posthofbrug 5366,2021-04-01,20:00:00,97,66,31,FMN GV 16 Berchem TOT
54,Posthofbrug 5366,2021-04-01,21:00:00,66,30,36,FMN GV 16 Berchem TOT
54,Posthofbrug 5366,2021-04-01,22:00:00,63,27,36,FMN GV 16 Berchem TOT
54,Posthofbrug 5366,2021-04-01,23:00:00,53,13,40,FMN GV 16 Berchem TOT
54,Posthofbrug 5366,2021-04-02,00:00:00,3,1,2,FMN GV 16 Berchem TOT
54,Posthofbrug 5366,2021-04-02,01:00:00,2,1,1,FMN GV 16 Berchem TOT
54,Posthofbrug 5366,2021-04-02,02:00:00,1,0,1,FMN GV 16 Berchem TOT
54,Posthofbrug 5366,2021-04-02,03:00:00,1,1,0,FMN GV 16 Berchem TOT
54,Posthofbrug 5366,2021-04-02,04:00:00,8,6,2,FMN GV 16 Berchem TOT
54,Posthofbrug 5366,2021-04-02,05:00:00,18,14,4,FMN GV 16 Berchem TOT
54,Posthofbrug 5366,2021-04-02,06:00:00,58,41,17,FMN GV 16 Berchem TOT
54,Posthofbrug 5366,2021-04-02,07:00:00,135,91,44,FMN GV 16 Berchem TOT
54,Posthofbrug 5366,2021-04-02,08:00:00,197,136,61,FMN GV 16 Berchem TOT
54,Posthofbrug 5366,2021-04-02,09:00:00,139,95,44,FMN GV 16 Berchem TOT
54,Posthofbrug 5366,2021-04-02,10:00:00,116,70,46,FMN GV 16 Berchem TOT
54,Posthofbrug 5366,2021-04-02,11:00:00,105,55,50,FMN GV 16 Berchem TOT
54,Posthofbrug 5366,2021-04-02,12:00:00,149,71,78,FMN GV 16 Berchem TOT
54,Posthofbrug 5366,2021-04-02,13:00:00,141,74,67,FMN GV 16 Berchem TOT
54,Posthofbrug 5366,2021-04-02,14:00:00,138,76,62,FMN GV 16 Berchem TOT
54,Posthofbrug 5366,2021-04-02,15:00:00,188,77,111,FMN GV 16 Berchem TOT
54,Posthofbrug 5366,2021-04-02,16:00:00,206,73,133,FMN GV 16 Berchem TOT
54,Posthofbrug 5366,2021-04-02,17:00:00,254,107,147,FMN GV 16 Berchem TOT
54,Posthofbrug 5366,2021-04-02,18:00:00,185,78,107,FMN GV 16 Berchem TOT
54,Posthofbrug 5366,2021-04-02,19:00:00,110,50,60,FMN GV 16 Berchem TOT
54,Posthofbrug 5366,2021-04-02,20:00:00,88,41,47,FMN GV 16 Berchem TOT
54,Posthofbrug 5366,2021-04-02,21:00:00,34,19,15,FMN GV 16 Berchem TOT
54,Posthofbrug 5366,2021-04-02,22:00:00,39,18,21,FMN GV 16 Berchem TOT
54,Posthofbrug 5366,2021-04-02,23:00:00,51,21,30,FMN GV 16 Berchem TOT
54,Posthofbrug 5366,2021-04-03,00:00:00,6,3,3,FMN GV 16 Berchem TOT
54,Posthofbrug 5366,2021-04-03,01:00:00,4,4,0,FMN GV 16 Berchem TOT
54,Posthofbrug 5366,2021-04-03,02:00:00,4,0,4,FMN GV 16 Berchem TOT
54,Posthofbrug 5366,2021-04-03,03:00:00,0,0,0,FMN GV 16 Berchem TOT
54,Posthofbrug 5366,2021-04-03,04:00:00,5,4,1,FMN GV 16 Berchem TOT
54,Posthofbrug 5366,2021-04-03,05:00:00,12,6,6,FMN GV 16 Berchem TOT
54,Posthofbrug 5366,2021-04-03,06:00:00,23,15,8,FMN GV 16 Berchem TOT
54,Posthofbrug 5366,2021-04-03,07:00:00,27,12,15,FMN GV 16 Berchem TOT
54,Posthofbrug 5366,2021-04-03,08:00:00,34,20,14,FMN GV 16 Berchem TOT
54,Posthofbrug 5366,2021-04-03,09:00:00,85,48,37,FMN GV 16 Berchem TOT
54,Posthofbrug 5366,2021-04-03,10:00:00,105,61,44,FMN GV 16 Berchem TOT
54,Posthofbrug 5366,2021-04-03,11:00:00,103,58,45,FMN GV 16 Berchem TOT
54,Posthofbrug 5366,2021-04-03,12:00:00,131,79,52,FMN GV 16 Berchem TOT
54,Posthofbrug 5366,2021-04-03,13:00:00,159,77,82,FMN GV 16 Berchem TOT
54,Posthofbrug 5366,2021-04-03,14:00:00,189,100,89,FMN GV 16 Berchem TOT
54,Posthofbrug 5366,2021-04-03,15:00:00,174,77,97,FMN GV 16 Berchem TOT
54,Posthofbrug 5366,2021-04-03,16:00:00,159,78,81,FMN GV 16 Berchem TOT
54,Posthofbrug 5366,2021-04-03,17:00:00,147,58,89,FMN GV 16 Berchem TOT
54,Posthofbrug 5366,2021-04-03,18:00:00,116,65,51,FMN GV 16 Berchem TOT
54,Posthofbrug 5366,2021-04-03,19:00:00,69,28,41,FMN GV 16 Berchem TOT
54,Posthofbrug 5366,2021-04-03,20:00:00,39,24,15,FMN GV 16 Berchem TOT
54,Posthofbrug 5366,2021-04-03,21:00:00,33,15,18,FMN GV 16 Berchem TOT
54,Posthofbrug 5366,2021-04-03,22:00:00,34,20,14,FMN GV 16 Berchem TOT
54,Posthofbrug 5366,2021-04-03,23:00:00,37,19,18,FMN GV 16 Berchem TOT
54,Posthofbrug 5366,2021-04-04,00:00:00,6,1,5,FMN GV 16 Berchem TOT
54,Posthofbrug 5366,2021-04-04,01:00:00,1,0,1,FMN GV 16 Berchem TOT
54,Posthofbrug 5366,2021-04-04,02:00:00,1,0,1,FMN GV 16 Berchem TOT
54,Posthofbrug 5366,2021-04-04,03:00:00,1,1,0,FMN GV 16 Berchem TOT
54,Posthofbrug 5366,2021-04-04,04:00:00,1,0,1,FMN GV 16 Berchem TOT
54,Posthofbrug 5366,2021-04-04,05:00:00,6,3,3,FMN GV 16 Berchem TOT
54,Posthofbrug 5366,2021-04-04,06:00:00,13,9,4,FMN GV 16 Berchem TOT
54,Posthofbrug 5366,2021-04-04,07:00:00,17,9,8,FMN GV 16 Berchem TOT
54,Posthofbrug 5366,2021-04-04,08:00:00,36,15,21,FMN GV 16 Berchem TOT
54,Posthofbrug 5366,2021-04-04,09:00:00,80,37,43,FMN GV 16 Berchem TOT
54,Posthofbrug 5366,2021-04-04,10:00:00,119,57,62,FMN GV 16 Berchem TOT
54,Posthofbrug 5366,2021-04-04,11:00:00,136,57,79,FMN GV 16 Berchem TOT
54,Posthofbrug 5366,2021-04-04,12:00:00,107,59,48,FMN GV 16 Berchem TOT
54,Posthofbrug 5366,2021-04-04,13:00:00,119,65,54,FMN GV 16 Berchem TOT
54,Posthofbrug 5366,2021-04-04,14:00:00,132,69,63,FMN GV 16 Berchem TOT
54,Posthofbrug 5366,2021-04-04,15:00:00,109,66,43,FMN GV 16 Berchem TOT
54,Posthofbrug 5366,2021-04-04,16:00:00,100,49,51,FMN GV 16 Berchem TOT
54,Posthofbrug 5366,2021-04-04,17:00:00,120,71,49,FMN GV 16 Berchem TOT
54,Posthofbrug 5366,2021-04-04,18:00:00,97,60,37,FMN GV 16 Berchem TOT
54,Posthofbrug 5366,2021-04-04,19:00:00,72,39,33,FMN GV 16 Berchem TOT
54,Posthofbrug 5366,2021-04-04,20:00:00,51,28,23,FMN GV 16 Berchem TOT
54,Posthofbrug 5366,2021-04-04,21:00:00,31,20,11,FMN GV 16 Berchem TOT
54,Posthofbrug 5366,2021-04-04,22:00:00,39,23,16,FMN GV 16 Berchem TOT
54,Posthofbrug 5366,2021-04-04,23:00:00,39,12,27,FMN GV 16 Berchem TOT
54,Posthofbrug 5366,2021-04-05,00:00:00,13,7,6,FMN GV 16 Berchem TOT
54,Posthofbrug 5366,2021-04-05,01:00:00,2,2,0,FMN GV 16 Berchem TOT
54,Posthofbrug 5366,2021-04-05,02:00:00,0,0,0,FMN GV 16 Berchem TOT
54,Posthofbrug 5366,2021-04-05,03:00:00,1,1,0,FMN GV 16 Berchem TOT
54,Posthofbrug 5366,2021-04-05,04:00:00,2,2,0,FMN GV 16 Berchem TOT
54,Posthofbrug 5366,2021-04-05,05:00:00,8,4,4,FMN GV 16 Berchem TOT
54,Posthofbrug 5366,2021-04-05,06:00:00,8,7,1,FMN GV 16 Berchem TOT
54,Posthofbrug 5366,2021-04-05,07:00:00,12,5,7,FMN GV 16 Berchem TOT
54,Posthofbrug 5366,2021-04-05,08:00:00,17,10,7,FMN GV 16 Berchem TOT
54,Posthofbrug 5366,2021-04-05,09:00:00,26,11,15,FMN GV 16 Berchem TOT
54,Posthofbrug 5366,2021-04-05,10:00:00,31,14,17,FMN GV 16 Berchem TOT
54,Posthofbrug 5366,2021-04-05,11:00:00,53,18,35,FMN GV 16 Berchem TOT
54,Posthofbrug 5366,2021-04-05,12:00:00,52,31,21,FMN GV 16 Berchem TOT
54,Posthofbrug 5366,2021-04-05,13:00:00,70,39,31,FMN GV 16 Berchem TOT
54,Posthofbrug 5366,2021-04-05,14:00:00,68,33,35,FMN GV 16 Berchem TOT
54,Posthofbrug 5366,2021-04-05,15:00:00,73,42,31,FMN GV 16 Berchem TOT
54,Posthofbrug 5366,2021-04-05,16:00:00,60,34,26,FMN GV 16 Berchem TOT
54,Posthofbrug 5366,2021-04-05,17:00:00,69,35,34,FMN GV 16 Berchem TOT
54,Posthofbrug 5366,2021-04-05,18:00:00,51,25,26,FMN GV 16 Berchem TOT
54,Posthofbrug 5366,2021-04-05,19:00:00,29,15,14,FMN GV 16 Berchem TOT
54,Posthofbrug 5366,2021-04-05,20:00:00,17,7,10,FMN GV 16 Berchem TOT
54,Posthofbrug 5366,2021-04-05,21:00:00,32,22,10,FMN GV 16 Berchem TOT
54,Posthofbrug 5366,2021-04-05,22:00:00,30,16,14,FMN GV 16 Berchem TOT
54,Posthofbrug 5366,2021-04-05,23:00:00,20,10,10,FMN GV 16 Berchem TOT
54,Posthofbrug 5366,2021-04-06,00:00:00,3,1,2,FMN GV 16 Berchem TOT
54,Posthofbrug 5366,2021-04-06,01:00:00,1,1,0,FMN GV 16 Berchem TOT
54,Posthofbrug 5366,2021-04-06,02:00:00,1,0,1,FMN GV 16 Berchem TOT
54,Posthofbrug 5366,2021-04-06,03:00:00,5,4,1,FMN GV 16 Berchem TOT
54,Posthofbrug 5366,2021-04-06,04:00:00,5,5,0,FMN GV 16 Berchem TOT
54,Posthofbrug 5366,2021-04-06,05:00:00,25,13,12,FMN GV 16 Berchem TOT
54,Posthofbrug 5366,2021-04-06,06:00:00,41,34,7,FMN GV 16 Berchem TOT
54,Posthofbrug 5366,2021-04-06,07:00:00,88,62,26,FMN GV 16 Berchem TOT
54,Posthofbrug 5366,2021-04-06,08:00:00,129,96,33,FMN GV 16 Berchem TOT
54,Posthofbrug 5366,2021-04-06,09:00:00,84,61,23,FMN GV 16 Berchem TOT
54,Posthofbrug 5366,2021-04-06,10:00:00,29,16,13,FMN GV 16 Berchem TOT
54,Posthofbrug 5366,2021-04-06,11:00:00,33,12,21,FMN GV 16 Berchem TOT
54,Posthofbrug 5366,2021-04-06,12:00:00,38,24,14,FMN GV 16 Berchem TOT
54,Posthofbrug 5366,2021-04-06,13:00:00,39,25,14,FMN GV 16 Berchem TOT
54,Posthofbrug 5366,2021-04-06,14:00:00,35,16,19,FMN GV 16 Berchem TOT
54,Posthofbrug 5366,2021-04-06,15:00:00,40,18,22,FMN GV 16 Berchem TOT
54,Posthofbrug 5366,2021-04-06,16:00:00,86,31,55,FMN GV 16 Berchem TOT
54,Posthofbrug 5366,2021-04-06,17:00:00,121,34,87,FMN GV 16 Berchem TOT
54,Posthofbrug 5366,2021-04-06,18:00:00,105,36,69,FMN GV 16 Berchem TOT
54,Posthofbrug 5366,2021-04-06,19:00:00,38,14,24,FMN GV 16 Berchem TOT
54,Posthofbrug 5366,2021-04-06,20:00:00,25,16,9,FMN GV 16 Berchem TOT
54,Posthofbrug 5366,2021-04-06,21:00:00,11,8,3,FMN GV 16 Berchem TOT
54,Posthofbrug 5366,2021-04-06,22:00:00,15,8,7,FMN GV 16 Berchem TOT
54,Posthofbrug 5366,2021-04-06,23:00:00,10,4,6,FMN GV 16 Berchem TOT
54,Posthofbrug 5366,2021-04-07,00:00:00,5,3,2,FMN GV 16 Berchem TOT
54,Posthofbrug 5366,2021-04-07,01:00:00,1,0,1,FMN GV 16 Berchem TOT
54,Posthofbrug 5366,2021-04-07,02:00:00,0,0,0,FMN GV 16 Berchem TOT
54,Posthofbrug 5366,2021-04-07,03:00:00,0,0,0,FMN GV 16 Berchem TOT
54,Posthofbrug 5366,2021-04-07,04:00:00,6,6,0,FMN GV 16 Berchem TOT
54,Posthofbrug 5366,2021-04-07,05:00:00,10,4,6,FMN GV 16 Berchem TOT
54,Posthofbrug 5366,2021-04-07,06:00:00,45,33,12,FMN GV 16 Berchem TOT
54,Posthofbrug 5366,2021-04-07,07:00:00,70,46,24,FMN GV 16 Berchem TOT
54,Posthofbrug 5366,2021-04-07,08:00:00,120,82,38,FMN GV 16 Berchem TOT
54,Posthofbrug 5366,2021-04-07,09:00:00,54,38,16,FMN GV 16 Berchem TOT
54,Posthofbrug 5366,2021-04-07,10:00:00,27,20,7,FMN GV 16 Berchem TOT
54,Posthofbrug 5366,2021-04-07,11:00:00,34,24,10,FMN GV 16 Berchem TOT
54,Posthofbrug 5366,2021-04-07,12:00:00,65,32,33,FMN GV 16 Berchem TOT
54,Posthofbrug 5366,2021-04-07,13:00:00,55,34,21,FMN GV 16 Berchem TOT
54,Posthofbrug 5366,2021-04-07,14:00:00,57,31,26,FMN GV 16 Berchem TOT
54,Posthofbrug 5366,2021-04-07,15:00:00,62,28,34,FMN GV 16 Berchem TOT
54,Posthofbrug 5366,2021-04-07,16:00:00,104,38,66,FMN GV 16 Berchem TOT
54,Posthofbrug 5366,2021-04-07,17:00:00,145,49,96,FMN GV 16 Berchem TOT
54,Posthofbrug 5366,2021-04-07,18:00:00,123,48,75,FMN GV 16 Berchem TOT
54,Posthofbrug 5366,2021-04-07,19:00:00,57,24,33,FMN GV 16 Berchem TOT
54,Posthofbrug 5366,2021-04-07,20:00:00,53,33,20,FMN GV 16 Berchem TOT
54,Posthofbrug 5366,2021-04-07,21:00:00,34,20,14,FMN GV 16 Berchem TOT
54,Posthofbrug 5366,2021-04-07,22:00:00,20,8,12,FMN GV 16 Berchem TOT
54,Posthofbrug 5366,2021-04-07,23:00:00,10,4,6,FMN GV 16 Berchem TOT
54,Posthofbrug 5366,2021-04-08,00:00:00,5,3,2,FMN GV 16 Berchem TOT
54,Posthofbrug 5366,2021-04-08,01:00:00,0,0,0,FMN GV 16 Berchem TOT
54,Posthofbrug 5366,2021-04-08,02:00:00,2,1,1,FMN GV 16 Berchem TOT
54,Posthofbrug 5366,2021-04-08,03:00:00,1,1,0,FMN GV 16 Berchem TOT
54,Posthofbrug 5366,2021-04-08,04:00:00,7,7,0,FMN GV 16 Berchem TOT
54,Posthofbrug 5366,2021-04-08,05:00:00,12,5,7,FMN GV 16 Berchem TOT
54,Posthofbrug 5366,2021-04-08,06:00:00,51,41,10,FMN GV 16 Berchem TOT
54,Posthofbrug 5366,2021-04-08,07:00:00,130,83,47,FMN GV 16 Berchem TOT
54,Posthofbrug 5366,2021-04-08,08:00:00,188,134,54,FMN GV 16 Berchem TOT
54,Posthofbrug 5366,2021-04-08,09:00:00,106,81,25,FMN GV 16 Berchem TOT
54,Posthofbrug 5366,2021-04-08,10:00:00,57,39,18,FMN GV 16 Berchem TOT
54,Posthofbrug 5366,2021-04-08,11:00:00,75,51,24,FMN GV 16 Berchem TOT
54,Posthofbrug 5366,2021-04-08,12:00:00,101,59,42,FMN GV 16 Berchem TOT
54,Posthofbrug 5366,2021-04-08,13:00:00,126,67,59,FMN GV 16 Berchem TOT
54,Posthofbrug 5366,2021-04-08,14:00:00,120,65,55,FMN GV 16 Berchem TOT
54,Posthofbrug 5366,2021-04-08,15:00:00,136,50,86,FMN GV 16 Berchem TOT
54,Posthofbrug 5366,2021-04-08,16:00:00,182,73,109,FMN GV 16 Berchem TOT
54,Posthofbrug 5366,2021-04-08,17:00:00,258,90,168,FMN GV 16 Berchem TOT
54,Posthofbrug 5366,2021-04-08,18:00:00,188,73,115,FMN GV 16 Berchem TOT
54,Posthofbrug 5366,2021-04-08,19:00:00,108,60,48,FMN GV 16 Berchem TOT
54,Posthofbrug 5366,2021-04-08,20:00:00,84,50,34,FMN GV 16 Berchem TOT
54,Posthofbrug 5366,2021-04-08,21:00:00,46,27,19,FMN GV 16 Berchem TOT
54,Posthofbrug 5366,2021-04-08,22:00:00,39,21,18,FMN GV 16 Berchem TOT
54,Posthofbrug 5366,2021-04-08,23:00:00,38,17,21,FMN GV 16 Berchem TOT
54,Posthofbrug 5366,2021-04-09,00:00:00,5,4,1,FMN GV 16 Berchem TOT
54,Posthofbrug 5366,2021-04-09,01:00:00,0,0,0,FMN GV 16 Berchem TOT
54,Posthofbrug 5366,2021-04-09,02:00:00,1,0,1,FMN GV 16 Berchem TOT
54,Posthofbrug 5366,2021-04-09,03:00:00,1,0,1,FMN GV 16 Berchem TOT
54,Posthofbrug 5366,2021-04-09,04:00:00,5,4,1,FMN GV 16 Berchem TOT
54,Posthofbrug 5366,2021-04-09,05:00:00,20,12,8,FMN GV 16 Berchem TOT
54,Posthofbrug 5366,2021-04-09,06:00:00,47,36,11,FMN GV 16 Berchem TOT
54,Posthofbrug 5366,2021-04-09,07:00:00,116,79,37,FMN GV 16 Berchem TOT
54,Posthofbrug 5366,2021-04-09,08:00:00,169,111,58,FMN GV 16 Berchem TOT
54,Posthofbrug 5366,2021-04-09,09:00:00,127,87,40,FMN GV 16 Berchem TOT
54,Posthofbrug 5366,2021-04-09,10:00:00,107,59,48,FMN GV 16 Berchem TOT
54,Posthofbrug 5366,2021-04-09,11:00:00,86,57,29,FMN GV 16 Berchem TOT
54,Posthofbrug 5366,2021-04-09,12:00:00,137,83,54,FMN GV 16 Berchem TOT
54,Posthofbrug 5366,2021-04-09,13:00:00,178,100,78,FMN GV 16 Berchem TOT
54,Posthofbrug 5366,2021-04-09,14:00:00,183,82,101,FMN GV 16 Berchem TOT
54,Posthofbrug 5366,2021-04-09,15:00:00,191,76,115,FMN GV 16 Berchem TOT
54,Posthofbrug 5366,2021-04-09,16:00:00,254,103,151,FMN GV 16 Berchem TOT
54,Posthofbrug 5366,2021-04-09,17:00:00,206,88,118,FMN GV 16 Berchem TOT
54,Posthofbrug 5366,2021-04-09,18:00:00,152,61,91,FMN GV 16 Berchem TOT
54,Posthofbrug 5366,2021-04-09,19:00:00,110,52,58,FMN GV 16 Berchem TOT
54,Posthofbrug 5366,2021-04-09,20:00:00,74,43,31,FMN GV 16 Berchem TOT
54,Posthofbrug 5366,2021-04-09,21:00:00,42,22,20,FMN GV 16 Berchem TOT
54,Posthofbrug 5366,2021-04-09,22:00:00,34,19,15,FMN GV 16 Berchem TOT
54,Posthofbrug 5366,2021-04-09,23:00:00,78,38,40,FMN GV 16 Berchem TOT
54,Posthofbrug 5366,2021-04-10,00:00:00,9,6,3,FMN GV 16 Berchem TOT
54,Posthofbrug 5366,2021-04-10,01:00:00,2,1,1,FMN GV 16 Berchem TOT
54,Posthofbrug 5366,2021-04-10,02:00:00,3,1,2,FMN GV 16 Berchem TOT
54,Posthofbrug 5366,2021-04-10,03:00:00,1,1,0,FMN GV 16 Berchem TOT
54,Posthofbrug 5366,2021-04-10,04:00:00,2,1,1,FMN GV 16 Berchem TOT
54,Posthofbrug 5366,2021-04-10,05:00:00,6,4,2,FMN GV 16 Berchem TOT
54,Posthofbrug 5366,2021-04-10,06:00:00,9,6,3,FMN GV 16 Berchem TOT
54,Posthofbrug 5366,2021-04-10,07:00:00,19,9,10,FMN GV 16 Berchem TOT
54,Posthofbrug 5366,2021-04-10,08:00:00,33,18,15,FMN GV 16 Berchem TOT
54,Posthofbrug 5366,2021-04-10,09:00:00,58,42,16,FMN GV 16 Berchem TOT
54,Posthofbrug 5366,2021-04-10,10:00:00,48,32,16,FMN GV 16 Berchem TOT
54,Posthofbrug 5366,2021-04-10,11:00:00,66,28,38,FMN GV 16 Berchem TOT
54,Posthofbrug 5366,2021-04-10,12:00:00,68,37,31,FMN GV 16 Berchem TOT
54,Posthofbrug 5366,2021-04-10,13:00:00,61,31,30,FMN GV 16 Berchem TOT
54,Posthofbrug 5366,2021-04-10,14:00:00,46,23,23,FMN GV 16 Berchem TOT
54,Posthofbrug 5366,2021-04-10,15:00:00,49,30,19,FMN GV 16 Berchem TOT
54,Posthofbrug 5366,2021-04-10,16:00:00,43,22,21,FMN GV 16 Berchem TOT
54,Posthofbrug 5366,2021-04-10,17:00:00,50,18,32,FMN GV 16 Berchem TOT
54,Posthofbrug 5366,2021-04-10,18:00:00,46,23,23,FMN GV 16 Berchem TOT
54,Posthofbrug 5366,2021-04-10,19:00:00,19,6,13,FMN GV 16 Berchem TOT
54,Posthofbrug 5366,2021-04-10,20:00:00,17,5,12,FMN GV 16 Berchem TOT
54,Posthofbrug 5366,2021-04-10,21:00:00,12,5,7,FMN GV 16 Berchem TOT
54,Posthofbrug 5366,2021-04-10,22:00:00,15,7,8,FMN GV 16 Berchem TOT
54,Posthofbrug 5366,2021-04-10,23:00:00,25,18,7,FMN GV 16 Berchem TOT
54,Posthofbrug 5366,2021-04-11,00:00:00,5,3,2,FMN GV 16 Berchem TOT
54,Posthofbrug 5366,2021-04-11,01:00:00,4,1,3,FMN GV 16 Berchem TOT
54,Posthofbrug 5366,2021-04-11,02:00:00,0,0,0,FMN GV 16 Berchem TOT
54,Posthofbrug 5366,2021-04-11,03:00:00,1,0,1,FMN GV 16 Berchem TOT
54,Posthofbrug 5366,2021-04-11,04:00:00,1,1,0,FMN GV 16 Berchem TOT
54,Posthofbrug 5366,2021-04-11,05:00:00,13,9,4,FMN GV 16 Berchem TOT
54,Posthofbrug 5366,2021-04-11,06:00:00,12,8,4,FMN GV 16 Berchem TOT
54,Posthofbrug 5366,2021-04-11,07:00:00,8,5,3,FMN GV 16 Berchem TOT
54,Posthofbrug 5366,2021-04-11,08:00:00,38,18,20,FMN GV 16 Berchem TOT
54,Posthofbrug 5366,2021-04-11,09:00:00,52,25,27,FMN GV 16 Berchem TOT
54,Posthofbrug 5366,2021-04-11,10:00:00,85,42,43,FMN GV 16 Berchem TOT
54,Posthofbrug 5366,2021-04-11,11:00:00,79,43,36,FMN GV 16 Berchem TOT
54,Posthofbrug 5366,2021-04-11,12:00:00,101,55,46,FMN GV 16 Berchem TOT
54,Posthofbrug 5366,2021-04-11,13:00:00,104,50,54,FMN GV 16 Berchem TOT
54,Posthofbrug 5366,2021-04-11,14:00:00,145,71,74,FMN GV 16 Berchem TOT
54,Posthofbrug 5366,2021-04-11,15:00:00,138,70,68,FMN GV 16 Berchem TOT
54,Posthofbrug 5366,2021-04-11,16:00:00,107,67,40,FMN GV 16 Berchem TOT
54,Posthofbrug 5366,2021-04-11,17:00:00,107,58,49,FMN GV 16 Berchem TOT
54,Posthofbrug 5366,2021-04-11,18:00:00,89,39,50,FMN GV 16 Berchem TOT
54,Posthofbrug 5366,2021-04-11,19:00:00,57,25,32,FMN GV 16 Berchem TOT
54,Posthofbrug 5366,2021-04-11,20:00:00,53,34,19,FMN GV 16 Berchem TOT
54,Posthofbrug 5366,2021-04-11,21:00:00,35,16,19,FMN GV 16 Berchem TOT
54,Posthofbrug 5366,2021-04-11,22:00:00,24,15,9,FMN GV 16 Berchem TOT
54,Posthofbrug 5366,2021-04-11,23:00:00,28,7,21,FMN GV 16 Berchem TOT
54,Posthofbrug 5366,2021-04-12,00:00:00,1,1,0,FMN GV 16 Berchem TOT
54,Posthofbrug 5366,2021-04-12,01:00:00,2,1,1,FMN GV 16 Berchem TOT
54,Posthofbrug 5366,2021-04-12,02:00:00,0,0,0,FMN GV 16 Berchem TOT
54,Posthofbrug 5366,2021-04-12,03:00:00,1,1,0,FMN GV 16 Berchem TOT
54,Posthofbrug 5366,2021-04-12,04:00:00,7,7,0,FMN GV 16 Berchem TOT
54,Posthofbrug 5366,2021-04-12,05:00:00,14,8,6,FMN GV 16 Berchem TOT
54,Posthofbrug 5366,2021-04-12,06:00:00,51,42,9,FMN GV 16 Berchem TOT
54,Posthofbrug 5366,2021-04-12,07:00:00,143,94,49,FMN GV 16 Berchem TOT
54,Posthofbrug 5366,2021-04-12,08:00:00,208,156,52,FMN GV 16 Berchem TOT
54,Posthofbrug 5366,2021-04-12,09:00:00,107,81,26,FMN GV 16 Berchem TOT
54,Posthofbrug 5366,2021-04-12,10:00:00,102,74,28,FMN GV 16 Berchem TOT
54,Posthofbrug 5366,2021-04-12,11:00:00,50,20,30,FMN GV 16 Berchem TOT
54,Posthofbrug 5366,2021-04-12,12:00:00,84,39,45,FMN GV 16 Berchem TOT
54,Posthofbrug 5366,2021-04-12,13:00:00,57,33,24,FMN GV 16 Berchem TOT
54,Posthofbrug 5366,2021-04-12,14:00:00,84,41,43,FMN GV 16 Berchem TOT
54,Posthofbrug 5366,2021-04-12,15:00:00,96,34,62,FMN GV 16 Berchem TOT
54,Posthofbrug 5366,2021-04-12,16:00:00,137,50,87,FMN GV 16 Berchem TOT
54,Posthofbrug 5366,2021-04-12,17:00:00,244,83,161,FMN GV 16 Berchem TOT
54,Posthofbrug 5366,2021-04-12,18:00:00,157,60,97,FMN GV 16 Berchem TOT
54,Posthofbrug 5366,2021-04-12,19:00:00,108,48,60,FMN GV 16 Berchem TOT
54,Posthofbrug 5366,2021-04-12,20:00:00,73,46,27,FMN GV 16 Berchem TOT
54,Posthofbrug 5366,2021-04-12,21:00:00,32,20,12,FMN GV 16 Berchem TOT
54,Posthofbrug 5366,2021-04-12,22:00:00,36,16,20,FMN GV 16 Berchem TOT
54,Posthofbrug 5366,2021-04-12,23:00:00,26,7,19,FMN GV 16 Berchem TOT
54,Posthofbrug 5366,2021-04-13,00:00:00,3,0,3,FMN GV 16 Berchem TOT
54,Posthofbrug 5366,2021-04-13,01:00:00,3,0,3,FMN GV 16 Berchem TOT
54,Posthofbrug 5366,2021-04-13,02:00:00,0,0,0,FMN GV 16 Berchem TOT
54,Posthofbrug 5366,2021-04-13,03:00:00,1,1,0,FMN GV 16 Berchem TOT
54,Posthofbrug 5366,2021-04-13,04:00:00,8,7,1,FMN GV 16 Berchem TOT
54,Posthofbrug 5366,2021-04-13,05:00:00,11,8,3,FMN GV 16 Berchem TOT
54,Posthofbrug 5366,2021-04-13,06:00:00,70,49,21,FMN GV 16 Berchem TOT
54,Posthofbrug 5366,2021-04-13,07:00:00,157,108,49,FMN GV 16 Berchem TOT
54,Posthofbrug 5366,2021-04-13,08:00:00,221,159,62,FMN GV 16 Berchem TOT
54,Posthofbrug 5366,2021-04-13,09:00:00,131,95,36,FMN GV 16 Berchem TOT
54,Posthofbrug 5366,2021-04-13,10:00:00,85,51,34,FMN GV 16 Berchem TOT
54,Posthofbrug 5366,2021-04-13,11:00:00,110,66,44,FMN GV 16 Berchem TOT
54,Posthofbrug 5366,2021-04-13,12:00:00,115,68,47,FMN GV 16 Berchem TOT
54,Posthofbrug 5366,2021-04-13,13:00:00,149,87,62,FMN GV 16 Berchem TOT
54,Posthofbrug 5366,2021-04-13,14:00:00,113,73,40,FMN GV 16 Berchem TOT
54,Posthofbrug 5366,2021-04-13,15:00:00,142,62,80,FMN GV 16 Berchem TOT
54,Posthofbrug 5366,2021-04-13,16:00:00,249,89,160,FMN GV 16 Berchem TOT
54,Posthofbrug 5366,2021-04-13,17:00:00,259,86,173,FMN GV 16 Berchem TOT
54,Posthofbrug 5366,2021-04-13,18:00:00,206,79,127,FMN GV 16 Berchem TOT
54,Posthofbrug 5366,2021-04-13,19:00:00,122,60,62,FMN GV 16 Berchem TOT
54,Posthofbrug 5366,2021-04-13,20:00:00,99,47,52,FMN GV 16 Berchem TOT
54,Posthofbrug 5366,2021-04-13,21:00:00,47,28,19,FMN GV 16 Berchem TOT
54,Posthofbrug 5366,2021-04-13,22:00:00,39,19,20,FMN GV 16 Berchem TOT
54,Posthofbrug 5366,2021-04-13,23:00:00,28,12,16,FMN GV 16 Berchem TOT
54,Posthofbrug 5366,2021-04-14,00:00:00,7,1,6,FMN GV 16 Berchem TOT
54,Posthofbrug 5366,2021-04-14,01:00:00,0,0,0,FMN GV 16 Berchem TOT
54,Posthofbrug 5366,2021-04-14,02:00:00,0,0,0,FMN GV 16 Berchem TOT
54,Posthofbrug 5366,2021-04-14,03:00:00,1,1,0,FMN GV 16 Berchem TOT
54,Posthofbrug 5366,2021-04-14,04:00:00,7,7,0,FMN GV 16 Berchem TOT
54,Posthofbrug 5366,2021-04-14,05:00:00,15,9,6,FMN GV 16 Berchem TOT
54,Posthofbrug 5366,2021-04-14,06:00:00,71,45,26,FMN GV 16 Berchem TOT
54,Posthofbrug 5366,2021-04-14,07:00:00,154,106,48,FMN GV 16 Berchem TOT
54,Posthofbrug 5366,2021-04-14,08:00:00,213,147,66,FMN GV 16 Berchem TOT
54,Posthofbrug 5366,2021-04-14,09:00:00,172,112,60,FMN GV 16 Berchem TOT
54,Posthofbrug 5366,2021-04-14,10:00:00,99,60,39,FMN GV 16 Berchem TOT
54,Posthofbrug 5366,2021-04-14,11:00:00,110,62,48,FMN GV 16 Berchem TOT
54,Posthofbrug 5366,2021-04-14,12:00:00,124,64,60,FMN GV 16 Berchem TOT
54,Posthofbrug 5366,2021-04-14,13:00:00,108,62,46,FMN GV 16 Berchem TOT
54,Posthofbrug 5366,2021-04-14,14:00:00,103,52,51,FMN GV 16 Berchem TOT
54,Posthofbrug 5366,2021-04-14,15:00:00,160,64,96,FMN GV 16 Berchem TOT
54,Posthofbrug 5366,2021-04-14,16:00:00,182,69,113,FMN GV 16 Berchem TOT
54,Posthofbrug 5366,2021-04-14,17:00:00,251,76,175,FMN GV 16 Berchem TOT
54,Posthofbrug 5366,2021-04-14,18:00:00,168,67,101,FMN GV 16 Berchem TOT
54,Posthofbrug 5366,2021-04-14,19:00:00,95,58,37,FMN GV 16 Berchem TOT
54,Posthofbrug 5366,2021-04-14,20:00:00,75,48,27,FMN GV 16 Berchem TOT
54,Posthofbrug 5366,2021-04-14,21:00:00,26,12,14,FMN GV 16 Berchem TOT
54,Posthofbrug 5366,2021-04-14,22:00:00,26,14,12,FMN GV 16 Berchem TOT
54,Posthofbrug 5366,2021-04-14,23:00:00,33,18,15,FMN GV 16 Berchem TOT
54,Posthofbrug 5366,2021-04-15,00:00:00,12,2,10,FMN GV 16 Berchem TOT
54,Posthofbrug 5366,2021-04-15,01:00:00,1,0,1,FMN GV 16 Berchem TOT
54,Posthofbrug 5366,2021-04-15,02:00:00,1,0,1,FMN GV 16 Berchem TOT
54,Posthofbrug 5366,2021-04-15,03:00:00,0,0,0,FMN GV 16 Berchem TOT
54,Posthofbrug 5366,2021-04-15,04:00:00,9,8,1,FMN GV 16 Berchem TOT
54,Posthofbrug 5366,2021-04-15,05:00:00,15,13,2,FMN GV 16 Berchem TOT
54,Posthofbrug 5366,2021-04-15,06:00:00,68,48,20,FMN GV 16 Berchem TOT
54,Posthofbrug 5366,2021-04-15,07:00:00,158,108,50,FMN GV 16 Berchem TOT
54,Posthofbrug 5366,2021-04-15,08:00:00,205,146,59,FMN GV 16 Berchem TOT
54,Posthofbrug 5366,2021-04-15,09:00:00,135,101,34,FMN GV 16 Berchem TOT
54,Posthofbrug 5366,2021-04-15,10:00:00,94,63,31,FMN GV 16 Berchem TOT
54,Posthofbrug 5366,2021-04-15,11:00:00,74,48,26,FMN GV 16 Berchem TOT
54,Posthofbrug 5366,2021-04-15,12:00:00,118,61,57,FMN GV 16 Berchem TOT
54,Posthofbrug 5366,2021-04-15,13:00:00,114,61,53,FMN GV 16 Berchem TOT
54,Posthofbrug 5366,2021-04-15,14:00:00,129,65,64,FMN GV 16 Berchem TOT
54,Posthofbrug 5366,2021-04-15,15:00:00,147,57,90,FMN GV 16 Berchem TOT
54,Posthofbrug 5366,2021-04-15,16:00:00,230,79,151,FMN GV 16 Berchem TOT
54,Posthofbrug 5366,2021-04-15,17:00:00,256,89,167,FMN GV 16 Berchem TOT
54,Posthofbrug 5366,2021-04-15,18:00:00,184,65,119,FMN GV 16 Berchem TOT
54,Posthofbrug 5366,2021-04-15,19:00:00,131,69,62,FMN GV 16 Berchem TOT
54,Posthofbrug 5366,2021-04-15,20:00:00,88,57,31,FMN GV 16 Berchem TOT
54,Posthofbrug 5366,2021-04-15,21:00:00,45,28,17,FMN GV 16 Berchem TOT
54,Posthofbrug 5366,2021-04-15,22:00:00,43,22,21,FMN GV 16 Berchem TOT
54,Posthofbrug 5366,2021-04-15,23:00:00,41,15,26,FMN GV 16 Berchem TOT
54,Posthofbrug 5366,2021-04-16,00:00:00,9,2,7,FMN GV 16 Berchem TOT
54,Posthofbrug 5366,2021-04-16,01:00:00,1,0,1,FMN GV 16 Berchem TOT
54,Posthofbrug 5366,2021-04-16,02:00:00,0,0,0,FMN GV 16 Berchem TOT
54,Posthofbrug 5366,2021-04-16,03:00:00,1,1,0,FMN GV 16 Berchem TOT
54,Posthofbrug 5366,2021-04-16,04:00:00,13,9,4,FMN GV 16 Berchem TOT
54,Posthofbrug 5366,2021-04-16,05:00:00,14,10,4,FMN GV 16 Berchem TOT
54,Posthofbrug 5366,2021-04-16,06:00:00,55,37,18,FMN GV 16 Berchem TOT
54,Posthofbrug 5366,2021-04-16,07:00:00,113,70,43,FMN GV 16 Berchem TOT
54,Posthofbrug 5366,2021-04-16,08:00:00,183,127,56,FMN GV 16 Berchem TOT
54,Posthofbrug 5366,2021-04-16,09:00:00,138,106,32,FMN GV 16 Berchem TOT
54,Posthofbrug 5366,2021-04-16,10:00:00,72,46,26,FMN GV 16 Berchem TOT
54,Posthofbrug 5366,2021-04-16,11:00:00,100,56,44,FMN GV 16 Berchem TOT
54,Posthofbrug 5366,2021-04-16,12:00:00,147,74,73,FMN GV 16 Berchem TOT
54,Posthofbrug 5366,2021-04-16,13:00:00,166,83,83,FMN GV 16 Berchem TOT
54,Posthofbrug 5366,2021-04-16,14:00:00,179,87,92,FMN GV 16 Berchem TOT
54,Posthofbrug 5366,2021-04-16,15:00:00,181,75,106,FMN GV 16 Berchem TOT
54,Posthofbrug 5366,2021-04-16,16:00:00,207,88,119,FMN GV 16 Berchem TOT
54,Posthofbrug 5366,2021-04-16,17:00:00,240,72,168,FMN GV 16 Berchem TOT
54,Posthofbrug 5366,2021-04-16,18:00:00,201,91,110,FMN GV 16 Berchem TOT
54,Posthofbrug 5366,2021-04-16,19:00:00,110,51,59,FMN GV 16 Berchem TOT
54,Posthofbrug 5366,2021-04-16,20:00:00,88,43,45,FMN GV 16 Berchem TOT
54,Posthofbrug 5366,2021-04-16,21:00:00,46,28,18,FMN GV 16 Berchem TOT
54,Posthofbrug 5366,2021-04-16,22:00:00,30,15,15,FMN GV 16 Berchem TOT
54,Posthofbrug 5366,2021-04-16,23:00:00,49,27,22,FMN GV 16 Berchem TOT
54,Posthofbrug 5366,2021-04-17,00:00:00,32,19,13,FMN GV 16 Berchem TOT
54,Posthofbrug 5366,2021-04-17,01:00:00,2,2,0,FMN GV 16 Berchem TOT
54,Posthofbrug 5366,2021-04-17,02:00:00,2,2,0,FMN GV 16 Berchem TOT
54,Posthofbrug 5366,2021-04-17,03:00:00,0,0,0,FMN GV 16 Berchem TOT
54,Posthofbrug 5366,2021-04-17,04:00:00,4,2,2,FMN GV 16 Berchem TOT
54,Posthofbrug 5366,2021-04-17,05:00:00,13,7,6,FMN GV 16 Berchem TOT
54,Posthofbrug 5366,2021-04-17,06:00:00,17,8,9,FMN GV 16 Berchem TOT
54,Posthofbrug 5366,2021-04-17,07:00:00,29,14,15,FMN GV 16 Berchem TOT
54,Posthofbrug 5366,2021-04-17,08:00:00,54,31,23,FMN GV 16 Berchem TOT
54,Posthofbrug 5366,2021-04-17,09:00:00,114,81,33,FMN GV 16 Berchem TOT
54,Posthofbrug 5366,2021-04-17,10:00:00,131,75,56,FMN GV 16 Berchem TOT
54,Posthofbrug 5366,2021-04-17,11:00:00,148,91,57,FMN GV 16 Berchem TOT
54,Posthofbrug 5366,2021-04-17,12:00:00,184,98,86,FMN GV 16 Berchem TOT
54,Posthofbrug 5366,2021-04-17,13:00:00,233,123,110,FMN GV 16 Berchem TOT
54,Posthofbrug 5366,2021-04-17,14:00:00,231,108,123,FMN GV 16 Berchem TOT
54,Posthofbrug 5366,2021-04-17,15:00:00,198,95,103,FMN GV 16 Berchem TOT
54,Posthofbrug 5366,2021-04-17,16:00:00,214,103,111,FMN GV 16 Berchem TOT
54,Posthofbrug 5366,2021-04-17,17:00:00,169,77,92,FMN GV 16 Berchem TOT
54,Posthofbrug 5366,2021-04-17,18:00:00,116,54,62,FMN GV 16 Berchem TOT
54,Posthofbrug 5366,2021-04-17,19:00:00,108,61,47,FMN GV 16 Berchem TOT
54,Posthofbrug 5366,2021-04-17,20:00:00,67,38,29,FMN GV 16 Berchem TOT
54,Posthofbrug 5366,2021-04-17,21:00:00,47,30,17,FMN GV 16 Berchem TOT
54,Posthofbrug 5366,2021-04-17,22:00:00,39,24,15,FMN GV 16 Berchem TOT
54,Posthofbrug 5366,2021-04-17,23:00:00,54,25,29,FMN GV 16 Berchem TOT
54,Posthofbrug 5366,2021-04-18,00:00:00,15,10,5,FMN GV 16 Berchem TOT
54,Posthofbrug 5366,2021-04-18,01:00:00,4,0,4,FMN GV 16 Berchem TOT
54,Posthofbrug 5366,2021-04-18,02:00:00,0,0,0,FMN GV 16 Berchem TOT
54,Posthofbrug 5366,2021-04-18,03:00:00,0,0,0,FMN GV 16 Berchem TOT
54,Posthofbrug 5366,2021-04-18,04:00:00,3,1,2,FMN GV 16 Berchem TOT
54,Posthofbrug 5366,2021-04-18,05:00:00,12,9,3,FMN GV 16 Berchem TOT
54,Posthofbrug 5366,2021-04-18,06:00:00,15,7,8,FMN GV 16 Berchem TOT
54,Posthofbrug 5366,2021-04-18,07:00:00,19,12,7,FMN GV 16 Berchem TOT
54,Posthofbrug 5366,2021-04-18,08:00:00,46,24,22,FMN GV 16 Berchem TOT
54,Posthofbrug 5366,2021-04-18,09:00:00,115,51,64,FMN GV 16 Berchem TOT
54,Posthofbrug 5366,2021-04-18,10:00:00,152,78,74,FMN GV 16 Berchem TOT
54,Posthofbrug 5366,2021-04-18,11:00:00,175,87,88,FMN GV 16 Berchem TOT
54,Posthofbrug 5366,2021-04-18,12:00:00,196,99,97,FMN GV 16 Berchem TOT
54,Posthofbrug 5366,2021-04-18,13:00:00,248,138,110,FMN GV 16 Berchem TOT
54,Posthofbrug 5366,2021-04-18,14:00:00,243,136,107,FMN GV 16 Berchem TOT
54,Posthofbrug 5366,2021-04-18,15:00:00,209,104,105,FMN GV 16 Berchem TOT
54,Posthofbrug 5366,2021-04-18,16:00:00,192,90,102,FMN GV 16 Berchem TOT
54,Posthofbrug 5366,2021-04-18,17:00:00,211,114,97,FMN GV 16 Berchem TOT
54,Posthofbrug 5366,2021-04-18,18:00:00,178,97,81,FMN GV 16 Berchem TOT
54,Posthofbrug 5366,2021-04-18,19:00:00,83,41,42,FMN GV 16 Berchem TOT
54,Posthofbrug 5366,2021-04-18,20:00:00,59,35,24,FMN GV 16 Berchem TOT
54,Posthofbrug 5366,2021-04-18,21:00:00,45,33,12,FMN GV 16 Berchem TOT
54,Posthofbrug 5366,2021-04-18,22:00:00,21,12,9,FMN GV 16 Berchem TOT
54,Posthofbrug 5366,2021-04-18,23:00:00,32,12,20,FMN GV 16 Berchem TOT
54,Posthofbrug 5366,2021-04-19,00:00:00,6,0,6,FMN GV 16 Berchem TOT
54,Posthofbrug 5366,2021-04-19,01:00:00,1,0,1,FMN GV 16 Berchem TOT
54,Posthofbrug 5366,2021-04-19,02:00:00,0,0,0,FMN GV 16 Berchem TOT
54,Posthofbrug 5366,2021-04-19,03:00:00,1,1,0,FMN GV 16 Berchem TOT
54,Posthofbrug 5366,2021-04-19,04:00:00,8,7,1,FMN GV 16 Berchem TOT
54,Posthofbrug 5366,2021-04-19,05:00:00,21,18,3,FMN GV 16 Berchem TOT
54,Posthofbrug 5366,2021-04-19,06:00:00,78,68,10,FMN GV 16 Berchem TOT
54,Posthofbrug 5366,2021-04-19,07:00:00,279,204,75,FMN GV 16 Berchem TOT
54,Posthofbrug 5366,2021-04-19,08:00:00,385,290,95,FMN GV 16 Berchem TOT
54,Posthofbrug 5366,2021-04-19,09:00:00,146,101,45,FMN GV 16 Berchem TOT
54,Posthofbrug 5366,2021-04-19,10:00:00,119,88,31,FMN GV 16 Berchem TOT
54,Posthofbrug 5366,2021-04-19,11:00:00,98,49,49,FMN GV 16 Berchem TOT
54,Posthofbrug 5366,2021-04-19,12:00:00,127,67,60,FMN GV 16 Berchem TOT
54,Posthofbrug 5366,2021-04-19,13:00:00,98,39,59,FMN GV 16 Berchem TOT
54,Posthofbrug 5366,2021-04-19,14:00:00,116,48,68,FMN GV 16 Berchem TOT
54,Posthofbrug 5366,2021-04-19,15:00:00,160,57,103,FMN GV 16 Berchem TOT
54,Posthofbrug 5366,2021-04-19,16:00:00,296,72,224,FMN GV 16 Berchem TOT
54,Posthofbrug 5366,2021-04-19,17:00:00,280,84,196,FMN GV 16 Berchem TOT
54,Posthofbrug 5366,2021-04-19,18:00:00,194,73,121,FMN GV 16 Berchem TOT
54,Posthofbrug 5366,2021-04-19,19:00:00,105,45,60,FMN GV 16 Berchem TOT
54,Posthofbrug 5366,2021-04-19,20:00:00,67,34,33,FMN GV 16 Berchem TOT
54,Posthofbrug 5366,2021-04-19,21:00:00,34,20,14,FMN GV 16 Berchem TOT
54,Posthofbrug 5366,2021-04-19,22:00:00,30,13,17,FMN GV 16 Berchem TOT
54,Posthofbrug 5366,2021-04-19,23:00:00,19,14,5,FMN GV 16 Berchem TOT
54,Posthofbrug 5366,2021-04-20,00:00:00,3,1,2,FMN GV 16 Berchem TOT
54,Posthofbrug 5366,2021-04-20,01:00:00,2,2,0,FMN GV 16 Berchem TOT
54,Posthofbrug 5366,2021-04-20,02:00:00,1,0,1,FMN GV 16 Berchem TOT
54,Posthofbrug 5366,2021-04-20,03:00:00,0,0,0,FMN GV 16 Berchem TOT
54,Posthofbrug 5366,2021-04-20,04:00:00,10,9,1,FMN GV 16 Berchem TOT
54,Posthofbrug 5366,2021-04-20,05:00:00,18,15,3,FMN GV 16 Berchem TOT
54,Posthofbrug 5366,2021-04-20,06:00:00,93,71,22,FMN GV 16 Berchem TOT
54,Posthofbrug 5366,2021-04-20,07:00:00,315,232,83,FMN GV 16 Berchem TOT
54,Posthofbrug 5366,2021-04-20,08:00:00,400,299,101,FMN GV 16 Berchem TOT
54,Posthofbrug 5366,2021-04-20,09:00:00,196,160,36,FMN GV 16 Berchem TOT
54,Posthofbrug 5366,2021-04-20,10:00:00,110,77,33,FMN GV 16 Berchem TOT
54,Posthofbrug 5366,2021-04-20,11:00:00,101,58,43,FMN GV 16 Berchem TOT
54,Posthofbrug 5366,2021-04-20,12:00:00,156,92,64,FMN GV 16 Berchem TOT
54,Posthofbrug 5366,2021-04-20,13:00:00,179,83,96,FMN GV 16 Berchem TOT
54,Posthofbrug 5366,2021-04-20,14:00:00,152,74,78,FMN GV 16 Berchem TOT
54,Posthofbrug 5366,2021-04-20,15:00:00,247,74,173,FMN GV 16 Berchem TOT
54,Posthofbrug 5366,2021-04-20,16:00:00,346,111,235,FMN GV 16 Berchem TOT
54,Posthofbrug 5366,2021-04-20,17:00:00,389,126,263,FMN GV 16 Berchem TOT
54,Posthofbrug 5366,2021-04-20,18:00:00,273,93,180,FMN GV 16 Berchem TOT
54,Posthofbrug 5366,2021-04-20,19:00:00,143,73,70,FMN GV 16 Berchem TOT
54,Posthofbrug 5366,2021-04-20,20:00:00,106,71,35,FMN GV 16 Berchem TOT
54,Posthofbrug 5366,2021-04-20,21:00:00,63,32,31,FMN GV 16 Berchem TOT
54,Posthofbrug 5366,2021-04-20,22:00:00,46,25,21,FMN GV 16 Berchem TOT
54,Posthofbrug 5366,2021-04-20,23:00:00,36,14,22,FMN GV 16 Berchem TOT
54,Posthofbrug 5366,2021-04-21,00:00:00,4,1,3,FMN GV 16 Berchem TOT
54,Posthofbrug 5366,2021-04-21,01:00:00,1,0,1,FMN GV 16 Berchem TOT
54,Posthofbrug 5366,2021-04-21,02:00:00,1,0,1,FMN GV 16 Berchem TOT
54,Posthofbrug 5366,2021-04-21,03:00:00,1,1,0,FMN GV 16 Berchem TOT
54,Posthofbrug 5366,2021-04-21,04:00:00,6,5,1,FMN GV 16 Berchem TOT
54,Posthofbrug 5366,2021-04-21,05:00:00,21,17,4,FMN GV 16 Berchem TOT
54,Posthofbrug 5366,2021-04-21,06:00:00,90,68,22,FMN GV 16 Berchem TOT
54,Posthofbrug 5366,2021-04-21,07:00:00,276,198,78,FMN GV 16 Berchem TOT
54,Posthofbrug 5366,2021-04-21,08:00:00,368,272,96,FMN GV 16 Berchem TOT
54,Posthofbrug 5366,2021-04-21,09:00:00,157,110,47,FMN GV 16 Berchem TOT
54,Posthofbrug 5366,2021-04-21,10:00:00,81,54,27,FMN GV 16 Berchem TOT
54,Posthofbrug 5366,2021-04-21,11:00:00,117,57,60,FMN GV 16 Berchem TOT
54,Posthofbrug 5366,2021-04-21,12:00:00,263,115,148,FMN GV 16 Berchem TOT
54,Posthofbrug 5366,2021-04-21,13:00:00,211,110,101,FMN GV 16 Berchem TOT
54,Posthofbrug 5366,2021-04-21,14:00:00,156,74,82,FMN GV 16 Berchem TOT
54,Posthofbrug 5366,2021-04-21,15:00:00,198,79,119,FMN GV 16 Berchem TOT
54,Posthofbrug 5366,2021-04-21,16:00:00,254,97,157,FMN GV 16 Berchem TOT
54,Posthofbrug 5366,2021-04-21,17:00:00,342,113,229,FMN GV 16 Berchem TOT
54,Posthofbrug 5366,2021-04-21,18:00:00,255,102,153,FMN GV 16 Berchem TOT
54,Posthofbrug 5366,2021-04-21,19:00:00,149,82,67,FMN GV 16 Berchem TOT
54,Posthofbrug 5366,2021-04-21,20:00:00,102,68,34,FMN GV 16 Berchem TOT
54,Posthofbrug 5366,2021-04-21,21:00:00,53,24,29,FMN GV 16 Berchem TOT
54,Posthofbrug 5366,2021-04-21,22:00:00,52,20,32,FMN GV 16 Berchem TOT
54,Posthofbrug 5366,2021-04-21,23:00:00,26,10,16,FMN GV 16 Berchem TOT
54,Posthofbrug 5366,2021-04-22,00:00:00,7,6,1,FMN GV 16 Berchem TOT
54,Posthofbrug 5366,2021-04-22,01:00:00,1,0,1,FMN GV 16 Berchem TOT
54,Posthofbrug 5366,2021-04-22,02:00:00,2,0,2,FMN GV 16 Berchem TOT
54,Posthofbrug 5366,2021-04-22,03:00:00,1,1,0,FMN GV 16 Berchem TOT
54,Posthofbrug 5366,2021-04-22,04:00:00,9,8,1,FMN GV 16 Berchem TOT
54,Posthofbrug 5366,2021-04-22,05:00:00,26,23,3,FMN GV 16 Berchem TOT
54,Posthofbrug 5366,2021-04-22,06:00:00,90,67,23,FMN GV 16 Berchem TOT
54,Posthofbrug 5366,2021-04-22,07:00:00,291,215,76,FMN GV 16 Berchem TOT
54,Posthofbrug 5366,2021-04-22,08:00:00,398,309,89,FMN GV 16 Berchem TOT
54,Posthofbrug 5366,2021-04-22,09:00:00,157,117,40,FMN GV 16 Berchem TOT
54,Posthofbrug 5366,2021-04-22,10:00:00,90,64,26,FMN GV 16 Berchem TOT
54,Posthofbrug 5366,2021-04-22,11:00:00,110,59,51,FMN GV 16 Berchem TOT
54,Posthofbrug 5366,2021-04-22,12:00:00,143,73,70,FMN GV 16 Berchem TOT
54,Posthofbrug 5366,2021-04-22,13:00:00,157,82,75,FMN GV 16 Berchem TOT
54,Posthofbrug 5366,2021-04-22,14:00:00,161,72,89,FMN GV 16 Berchem TOT
54,Posthofbrug 5366,2021-04-22,15:00:00,196,79,117,FMN GV 16 Berchem TOT
54,Posthofbrug 5366,2021-04-22,16:00:00,332,97,235,FMN GV 16 Berchem TOT
54,Posthofbrug 5366,2021-04-22,17:00:00,416,129,287,FMN GV 16 Berchem TOT
54,Posthofbrug 5366,2021-04-22,18:00:00,250,92,158,FMN GV 16 Berchem TOT
54,Posthofbrug 5366,2021-04-22,19:00:00,157,74,83,FMN GV 16 Berchem TOT
54,Posthofbrug 5366,2021-04-22,20:00:00,101,59,42,FMN GV 16 Berchem TOT
54,Posthofbrug 5366,2021-04-22,21:00:00,70,43,27,FMN GV 16 Berchem TOT
54,Posthofbrug 5366,2021-04-22,22:00:00,52,26,26,FMN GV 16 Berchem TOT
54,Posthofbrug 5366,2021-04-22,23:00:00,58,19,39,FMN GV 16 Berchem TOT
54,Posthofbrug 5366,2021-04-23,00:00:00,8,2,6,FMN GV 16 Berchem TOT
54,Posthofbrug 5366,2021-04-23,01:00:00,0,0,0,FMN GV 16 Berchem TOT
54,Posthofbrug 5366,2021-04-23,02:00:00,1,0,1,FMN GV 16 Berchem TOT
54,Posthofbrug 5366,2021-04-23,03:00:00,0,0,0,FMN GV 16 Berchem TOT
54,Posthofbrug 5366,2021-04-23,04:00:00,9,7,2,FMN GV 16 Berchem TOT
54,Posthofbrug 5366,2021-04-23,05:00:00,17,12,5,FMN GV 16 Berchem TOT
54,Posthofbrug 5366,2021-04-23,06:00:00,69,52,17,FMN GV 16 Berchem TOT
54,Posthofbrug 5366,2021-04-23,07:00:00,266,197,69,FMN GV 16 Berchem TOT
54,Posthofbrug 5366,2021-04-23,08:00:00,360,257,103,FMN GV 16 Berchem TOT
54,Posthofbrug 5366,2021-04-23,09:00:00,174,135,39,FMN GV 16 Berchem TOT
54,Posthofbrug 5366,2021-04-23,10:00:00,108,68,40,FMN GV 16 Berchem TOT
54,Posthofbrug 5366,2021-04-23,11:00:00,122,57,65,FMN GV 16 Berchem TOT
54,Posthofbrug 5366,2021-04-23,12:00:00,176,94,82,FMN GV 16 Berchem TOT
54,Posthofbrug 5366,2021-04-23,13:00:00,149,83,66,FMN GV 16 Berchem TOT
54,Posthofbrug 5366,2021-04-23,14:00:00,187,86,101,FMN GV 16 Berchem TOT
54,Posthofbrug 5366,2021-04-23,15:00:00,246,98,148,FMN GV 16 Berchem TOT
54,Posthofbrug 5366,2021-04-23,16:00:00,274,101,173,FMN GV 16 Berchem TOT
54,Posthofbrug 5366,2021-04-23,17:00:00,308,102,206,FMN GV 16 Berchem TOT
54,Posthofbrug 5366,2021-04-23,18:00:00,227,95,132,FMN GV 16 Berchem TOT
54,Posthofbrug 5366,2021-04-23,19:00:00,126,64,62,FMN GV 16 Berchem TOT
54,Posthofbrug 5366,2021-04-23,20:00:00,83,47,36,FMN GV 16 Berchem TOT
54,Posthofbrug 5366,2021-04-23,21:00:00,51,31,20,FMN GV 16 Berchem TOT
54,Posthofbrug 5366,2021-04-23,22:00:00,56,36,20,FMN GV 16 Berchem TOT
54,Posthofbrug 5366,2021-04-23,23:00:00,78,26,52,FMN GV 16 Berchem TOT
54,Posthofbrug 5366,2021-04-24,00:00:00,34,18,16,FMN GV 16 Berchem TOT
54,Posthofbrug 5366,2021-04-24,01:00:00,5,3,2,FMN GV 16 Berchem TOT
54,Posthofbrug 5366,2021-04-24,02:00:00,4,0,4,FMN GV 16 Berchem TOT
54,Posthofbrug 5366,2021-04-24,03:00:00,3,0,3,FMN GV 16 Berchem TOT
54,Posthofbrug 5366,2021-04-24,04:00:00,2,1,1,FMN GV 16 Berchem TOT
54,Posthofbrug 5366,2021-04-24,05:00:00,12,7,5,FMN GV 16 Berchem TOT
54,Posthofbrug 5366,2021-04-24,06:00:00,21,14,7,FMN GV 16 Berchem TOT
54,Posthofbrug 5366,2021-04-24,07:00:00,39,20,19,FMN GV 16 Berchem TOT
54,Posthofbrug 5366,2021-04-24,08:00:00,51,27,24,FMN GV 16 Berchem TOT
54,Posthofbrug 5366,2021-04-24,09:00:00,118,72,46,FMN GV 16 Berchem TOT
54,Posthofbrug 5366,2021-04-24,10:00:00,148,80,68,FMN GV 16 Berchem TOT
54,Posthofbrug 5366,2021-04-24,11:00:00,154,83,71,FMN GV 16 Berchem TOT
54,Posthofbrug 5366,2021-04-24,12:00:00,166,85,81,FMN GV 16 Berchem TOT
54,Posthofbrug 5366,2021-04-24,13:00:00,215,129,86,FMN GV 16 Berchem TOT
54,Posthofbrug 5366,2021-04-24,14:00:00,276,141,135,FMN GV 16 Berchem TOT
54,Posthofbrug 5366,2021-04-24,15:00:00,213,104,109,FMN GV 16 Berchem TOT
54,Posthofbrug 5366,2021-04-24,16:00:00,221,123,98,FMN GV 16 Berchem TOT
54,Posthofbrug 5366,2021-04-24,17:00:00,201,91,110,FMN GV 16 Berchem TOT
54,Posthofbrug 5366,2021-04-24,18:00:00,187,80,107,FMN GV 16 Berchem TOT
54,Posthofbrug 5366,2021-04-24,19:00:00,103,61,42,FMN GV 16 Berchem TOT
54,Posthofbrug 5366,2021-04-24,20:00:00,74,40,34,FMN GV 16 Berchem TOT
54,Posthofbrug 5366,2021-04-24,21:00:00,55,32,23,FMN GV 16 Berchem TOT
54,Posthofbrug 5366,2021-04-24,22:00:00,59,28,31,FMN GV 16 Berchem TOT
54,Posthofbrug 5366,2021-04-24,23:00:00,64,28,36,FMN GV 16 Berchem TOT
54,Posthofbrug 5366,2021-04-25,00:00:00,23,15,8,FMN GV 16 Berchem TOT
54,Posthofbrug 5366,2021-04-25,01:00:00,4,1,3,FMN GV 16 Berchem TOT
54,Posthofbrug 5366,2021-04-25,02:00:00,4,3,1,FMN GV 16 Berchem TOT
54,Posthofbrug 5366,2021-04-25,03:00:00,3,1,2,FMN GV 16 Berchem TOT
54,Posthofbrug 5366,2021-04-25,04:00:00,1,1,0,FMN GV 16 Berchem TOT
54,Posthofbrug 5366,2021-04-25,05:00:00,8,3,5,FMN GV 16 Berchem TOT
54,Posthofbrug 5366,2021-04-25,06:00:00,21,15,6,FMN GV 16 Berchem TOT
54,Posthofbrug 5366,2021-04-25,07:00:00,30,15,15,FMN GV 16 Berchem TOT
54,Posthofbrug 5366,2021-04-25,08:00:00,48,21,27,FMN GV 16 Berchem TOT
54,Posthofbrug 5366,2021-04-25,09:00:00,86,52,34,FMN GV 16 Berchem TOT
54,Posthofbrug 5366,2021-04-25,10:00:00,148,74,74,FMN GV 16 Berchem TOT
54,Posthofbrug 5366,2021-04-25,11:00:00,147,67,80,FMN GV 16 Berchem TOT
54,Posthofbrug 5366,2021-04-25,12:00:00,148,82,66,FMN GV 16 Berchem TOT
54,Posthofbrug 5366,2021-04-25,13:00:00,182,95,87,FMN GV 16 Berchem TOT
54,Posthofbrug 5366,2021-04-25,14:00:00,249,126,123,FMN GV 16 Berchem TOT
54,Posthofbrug 5366,2021-04-25,15:00:00,205,97,108,FMN GV 16 Berchem TOT
54,Posthofbrug 5366,2021-04-25,16:00:00,170,84,86,FMN GV 16 Berchem TOT
54,Posthofbrug 5366,2021-04-25,17:00:00,210,102,108,FMN GV 16 Berchem TOT
54,Posthofbrug 5366,2021-04-25,18:00:00,129,69,60,FMN GV 16 Berchem TOT
54,Posthofbrug 5366,2021-04-25,19:00:00,94,55,39,FMN GV 16 Berchem TOT
54,Posthofbrug 5366,2021-04-25,20:00:00,81,50,31,FMN GV 16 Berchem TOT
54,Posthofbrug 5366,2021-04-25,21:00:00,47,28,19,FMN GV 16 Berchem TOT
54,Posthofbrug 5366,2021-04-25,22:00:00,31,22,9,FMN GV 16 Berchem TOT
54,Posthofbrug 5366,2021-04-25,23:00:00,21,9,12,FMN GV 16 Berchem TOT
54,Posthofbrug 5366,2021-04-26,00:00:00,6,2,4,FMN GV 16 Berchem TOT
54,Posthofbrug 5366,2021-04-26,01:00:00,2,1,1,FMN GV 16 Berchem TOT
54,Posthofbrug 5366,2021-04-26,02:00:00,2,1,1,FMN GV 16 Berchem TOT
54,Posthofbrug 5366,2021-04-26,03:00:00,0,0,0,FMN GV 16 Berchem TOT
54,Posthofbrug 5366,2021-04-26,04:00:00,9,7,2,FMN GV 16 Berchem TOT
54,Posthofbrug 5366,2021-04-26,05:00:00,22,17,5,FMN GV 16 Berchem TOT
54,Posthofbrug 5366,2021-04-26,06:00:00,78,59,19,FMN GV 16 Berchem TOT
54,Posthofbrug 5366,2021-04-26,07:00:00,295,221,74,FMN GV 16 Berchem TOT
54,Posthofbrug 5366,2021-04-26,08:00:00,409,303,106,FMN GV 16 Berchem TOT
54,Posthofbrug 5366,2021-04-26,09:00:00,146,112,34,FMN GV 16 Berchem TOT
54,Posthofbrug 5366,2021-04-26,10:00:00,78,57,21,FMN GV 16 Berchem TOT
54,Posthofbrug 5366,2021-04-26,11:00:00,98,59,39,FMN GV 16 Berchem TOT
54,Posthofbrug 5366,2021-04-26,12:00:00,187,84,103,FMN GV 16 Berchem TOT
54,Posthofbrug 5366,2021-04-26,13:00:00,111,62,49,FMN GV 16 Berchem TOT
54,Posthofbrug 5366,2021-04-26,14:00:00,141,67,74,FMN GV 16 Berchem TOT
54,Posthofbrug 5366,2021-04-26,15:00:00,198,74,124,FMN GV 16 Berchem TOT
54,Posthofbrug 5366,2021-04-26,16:00:00,373,106,267,FMN GV 16 Berchem TOT
54,Posthofbrug 5366,2021-04-26,17:00:00,351,129,222,FMN GV 16 Berchem TOT
54,Posthofbrug 5366,2021-04-26,18:00:00,238,82,156,FMN GV 16 Berchem TOT
54,Posthofbrug 5366,2021-04-26,19:00:00,125,63,62,FMN GV 16 Berchem TOT
54,Posthofbrug 5366,2021-04-26,20:00:00,95,44,51,FMN GV 16 Berchem TOT
54,Posthofbrug 5366,2021-04-26,21:00:00,44,24,20,FMN GV 16 Berchem TOT
54,Posthofbrug 5366,2021-04-26,22:00:00,41,19,22,FMN GV 16 Berchem TOT
54,Posthofbrug 5366,2021-04-26,23:00:00,31,15,16,FMN GV 16 Berchem TOT
54,Posthofbrug 5366,2021-04-27,00:00:00,9,3,6,FMN GV 16 Berchem TOT
54,Posthofbrug 5366,2021-04-27,01:00:00,0,0,0,FMN GV 16 Berchem TOT
54,Posthofbrug 5366,2021-04-27,02:00:00,1,0,1,FMN GV 16 Berchem TOT
54,Posthofbrug 5366,2021-04-27,03:00:00,2,2,0,FMN GV 16 Berchem TOT
54,Posthofbrug 5366,2021-04-27,04:00:00,10,9,1,FMN GV 16 Berchem TOT
54,Posthofbrug 5366,2021-04-27,05:00:00,27,17,10,FMN GV 16 Berchem TOT
54,Posthofbrug 5366,2021-04-27,06:00:00,90,67,23,FMN GV 16 Berchem TOT
54,Posthofbrug 5366,2021-04-27,07:00:00,327,255,72,FMN GV 16 Berchem TOT
54,Posthofbrug 5366,2021-04-27,08:00:00,425,322,103,FMN GV 16 Berchem TOT
54,Posthofbrug 5366,2021-04-27,09:00:00,189,149,40,FMN GV 16 Berchem TOT
54,Posthofbrug 5366,2021-04-27,10:00:00,88,61,27,FMN GV 16 Berchem TOT
54,Posthofbrug 5366,2021-04-27,11:00:00,97,56,41,FMN GV 16 Berchem TOT
54,Posthofbrug 5366,2021-04-27,12:00:00,181,88,93,FMN GV 16 Berchem TOT
54,Posthofbrug 5366,2021-04-27,13:00:00,165,97,68,FMN GV 16 Berchem TOT
54,Posthofbrug 5366,2021-04-27,14:00:00,157,82,75,FMN GV 16 Berchem TOT
54,Posthofbrug 5366,2021-04-27,15:00:00,249,94,155,FMN GV 16 Berchem TOT
54,Posthofbrug 5366,2021-04-27,16:00:00,359,121,238,FMN GV 16 Berchem TOT
54,Posthofbrug 5366,2021-04-27,17:00:00,416,130,286,FMN GV 16 Berchem TOT
54,Posthofbrug 5366,2021-04-27,18:00:00,276,94,182,FMN GV 16 Berchem TOT
54,Posthofbrug 5366,2021-04-27,19:00:00,166,79,87,FMN GV 16 Berchem TOT
54,Posthofbrug 5366,2021-04-27,20:00:00,94,50,44,FMN GV 16 Berchem TOT
54,Posthofbrug 5366,2021-04-27,21:00:00,74,45,29,FMN GV 16 Berchem TOT
54,Posthofbrug 5366,2021-04-27,22:00:00,61,22,39,FMN GV 16 Berchem TOT
54,Posthofbrug 5366,2021-04-27,23:00:00,35,17,18,FMN GV 16 Berchem TOT
54,Posthofbrug 5366,2021-04-28,00:00:00,12,3,9,FMN GV 16 Berchem TOT
54,Posthofbrug 5366,2021-04-28,01:00:00,3,2,1,FMN GV 16 Berchem TOT
54,Posthofbrug 5366,2021-04-28,02:00:00,0,0,0,FMN GV 16 Berchem TOT
54,Posthofbrug 5366,2021-04-28,03:00:00,3,3,0,FMN GV 16 Berchem TOT
54,Posthofbrug 5366,2021-04-28,04:00:00,9,6,3,FMN GV 16 Berchem TOT
54,Posthofbrug 5366,2021-04-28,05:00:00,20,18,2,FMN GV 16 Berchem TOT
54,Posthofbrug 5366,2021-04-28,06:00:00,95,79,16,FMN GV 16 Berchem TOT
54,Posthofbrug 5366,2021-04-28,07:00:00,280,201,79,FMN GV 16 Berchem TOT
54,Posthofbrug 5366,2021-04-28,08:00:00,400,284,116,FMN GV 16 Berchem TOT
54,Posthofbrug 5366,2021-04-28,09:00:00,205,149,56,FMN GV 16 Berchem TOT
54,Posthofbrug 5366,2021-04-28,10:00:00,99,60,39,FMN GV 16 Berchem TOT
54,Posthofbrug 5366,2021-04-28,11:00:00,142,85,57,FMN GV 16 Berchem TOT
54,Posthofbrug 5366,2021-04-28,12:00:00,286,122,164,FMN GV 16 Berchem TOT
54,Posthofbrug 5366,2021-04-28,13:00:00,212,100,112,FMN GV 16 Berchem TOT
54,Posthofbrug 5366,2021-04-28,14:00:00,194,89,105,FMN GV 16 Berchem TOT
54,Posthofbrug 5366,2021-04-28,15:00:00,215,87,128,FMN GV 16 Berchem TOT
54,Posthofbrug 5366,2021-04-28,16:00:00,314,124,190,FMN GV 16 Berchem TOT
54,Posthofbrug 5366,2021-04-28,17:00:00,392,140,252,FMN GV 16 Berchem TOT
54,Posthofbrug 5366,2021-04-28,18:00:00,268,110,158,FMN GV 16 Berchem TOT
54,Posthofbrug 5366,2021-04-28,19:00:00,168,89,79,FMN GV 16 Berchem TOT
54,Posthofbrug 5366,2021-04-28,20:00:00,109,60,49,FMN GV 16 Berchem TOT
54,Posthofbrug 5366,2021-04-28,21:00:00,55,29,26,FMN GV 16 Berchem TOT
54,Posthofbrug 5366,2021-04-28,22:00:00,55,19,36,FMN GV 16 Berchem TOT
54,Posthofbrug 5366,2021-04-28,23:00:00,37,16,21,FMN GV 16 Berchem TOT
54,Posthofbrug 5366,2021-04-29,00:00:00,2,2,0,FMN GV 16 Berchem TOT
54,Posthofbrug 5366,2021-04-29,01:00:00,1,0,1,FMN GV 16 Berchem TOT
54,Posthofbrug 5366,2021-04-29,02:00:00,2,1,1,FMN GV 16 Berchem TOT
54,Posthofbrug 5366,2021-04-29,03:00:00,1,1,0,FMN GV 16 Berchem TOT
54,Posthofbrug 5366,2021-04-29,04:00:00,2,1,1,FMN GV 16 Berchem TOT
54,Posthofbrug 5366,2021-04-29,05:00:00,19,16,3,FMN GV 16 Berchem TOT
54,Posthofbrug 5366,2021-04-29,06:00:00,76,60,16,FMN GV 16 Berchem TOT
54,Posthofbrug 5366,2021-04-29,07:00:00,234,177,57,FMN GV 16 Berchem TOT
54,Posthofbrug 5366,2021-04-29,08:00:00,356,282,74,FMN GV 16 Berchem TOT
54,Posthofbrug 5366,2021-04-29,09:00:00,129,94,35,FMN GV 16 Berchem TOT
54,Posthofbrug 5366,2021-04-29,10:00:00,45,29,16,FMN GV 16 Berchem TOT
54,Posthofbrug 5366,2021-04-29,11:00:00,63,35,28,FMN GV 16 Berchem TOT
54,Posthofbrug 5366,2021-04-29,12:00:00,104,57,47,FMN GV 16 Berchem TOT
54,Posthofbrug 5366,2021-04-29,13:00:00,118,63,55,FMN GV 16 Berchem TOT
54,Posthofbrug 5366,2021-04-29,14:00:00,62,21,41,FMN GV 16 Berchem TOT
54,Posthofbrug 5366,2021-04-29,15:00:00,134,49,85,FMN GV 16 Berchem TOT
54,Posthofbrug 5366,2021-04-29,16:00:00,276,87,189,FMN GV 16 Berchem TOT
54,Posthofbrug 5366,2021-04-29,17:00:00,274,81,193,FMN GV 16 Berchem TOT
54,Posthofbrug 5366,2021-04-29,18:00:00,192,62,130,FMN GV 16 Berchem TOT
54,Posthofbrug 5366,2021-04-29,19:00:00,109,48,61,FMN GV 16 Berchem TOT
54,Posthofbrug 5366,2021-04-29,20:00:00,90,56,34,FMN GV 16 Berchem TOT
54,Posthofbrug 5366,2021-04-29,21:00:00,33,19,14,FMN GV 16 Berchem TOT
54,Posthofbrug 5366,2021-04-29,22:00:00,47,22,25,FMN GV 16 Berchem TOT
54,Posthofbrug 5366,2021-04-29,23:00:00,31,14,17,FMN GV 16 Berchem TOT
54,Posthofbrug 5366,2021-04-30,00:00:00,11,4,7,FMN GV 16 Berchem TOT
54,Posthofbrug 5366,2021-04-30,01:00:00,0,0,0,FMN GV 16 Berchem TOT
54,Posthofbrug 5366,2021-04-30,02:00:00,1,0,1,FMN GV 16 Berchem TOT
54,Posthofbrug 5366,2021-04-30,03:00:00,1,0,1,FMN GV 16 Berchem TOT
54,Posthofbrug 5366,2021-04-30,04:00:00,4,3,1,FMN GV 16 Berchem TOT
54,Posthofbrug 5366,2021-04-30,05:00:00,13,12,1,FMN GV 16 Berchem TOT
54,Posthofbrug 5366,2021-04-30,06:00:00,69,54,15,FMN GV 16 Berchem TOT
54,Posthofbrug 5366,2021-04-30,07:00:00,231,165,66,FMN GV 16 Berchem TOT
54,Posthofbrug 5366,2021-04-30,08:00:00,362,253,109,FMN GV 16 Berchem TOT
54,Posthofbrug 5366,2021-04-30,09:00:00,155,112,43,FMN GV 16 Berchem TOT
54,Posthofbrug 5366,2021-04-30,10:00:00,121,78,43,FMN GV 16 Berchem TOT
54,Posthofbrug 5366,2021-04-30,11:00:00,114,58,56,FMN GV 16 Berchem TOT
54,Posthofbrug 5366,2021-04-30,12:00:00,159,70,89,FMN GV 16 Berchem TOT
54,Posthofbrug 5366,2021-04-30,13:00:00,148,78,70,FMN GV 16 Berchem TOT
54,Posthofbrug 5366,2021-04-30,14:00:00,131,59,72,FMN GV 16 Berchem TOT
54,Posthofbrug 5366,2021-04-30,15:00:00,219,83,136,FMN GV 16 Berchem TOT
54,Posthofbrug 5366,2021-04-30,16:00:00,279,104,175,FMN GV 16 Berchem TOT
54,Posthofbrug 5366,2021-04-30,17:00:00,312,95,217,FMN GV 16 Berchem TOT
54,Posthofbrug 5366,2021-04-30,18:00:00,213,85,128,FMN GV 16 Berchem TOT
54,Posthofbrug 5366,2021-04-30,19:00:00,104,41,63,FMN GV 16 Berchem TOT
54,Posthofbrug 5366,2021-04-30,20:00:00,84,55,29,FMN GV 16 Berchem TOT
54,Posthofbrug 5366,2021-04-30,21:00:00,43,26,17,FMN GV 16 Berchem TOT
54,Posthofbrug 5366,2021-04-30,22:00:00,40,15,25,FMN GV 16 Berchem TOT
54,Posthofbrug 5366,2021-04-30,23:00:00,75,36,39,FMN GV 16 Berchem TOT
54,Posthofbrug 5366,2021-05-01,00:00:00,25,11,14,FMN GV 16 Berchem TOT
54,Posthofbrug 5366,2021-05-01,01:00:00,9,8,1,FMN GV 16 Berchem TOT
54,Posthofbrug 5366,2021-05-01,02:00:00,5,1,4,FMN GV 16 Berchem TOT
54,Posthofbrug 5366,2021-05-01,03:00:00,2,0,2,FMN GV 16 Berchem TOT
54,Posthofbrug 5366,2021-05-01,04:00:00,2,1,1,FMN GV 16 Berchem TOT
54,Posthofbrug 5366,2021-05-01,05:00:00,10,4,6,FMN GV 16 Berchem TOT
54,Posthofbrug 5366,2021-05-01,06:00:00,16,12,4,FMN GV 16 Berchem TOT
54,Posthofbrug 5366,2021-05-01,07:00:00,23,17,6,FMN GV 16 Berchem TOT
54,Posthofbrug 5366,2021-05-01,08:00:00,59,31,28,FMN GV 16 Berchem TOT
54,Posthofbrug 5366,2021-05-01,09:00:00,124,74,50,FMN GV 16 Berchem TOT
54,Posthofbrug 5366,2021-05-01,10:00:00,124,57,67,FMN GV 16 Berchem TOT
54,Posthofbrug 5366,2021-05-01,11:00:00,135,64,71,FMN GV 16 Berchem TOT
54,Posthofbrug 5366,2021-05-01,12:00:00,133,68,65,FMN GV 16 Berchem TOT
54,Posthofbrug 5366,2021-05-01,13:00:00,172,98,74,FMN GV 16 Berchem TOT
54,Posthofbrug 5366,2021-05-01,14:00:00,183,116,67,FMN GV 16 Berchem TOT
54,Posthofbrug 5366,2021-05-01,15:00:00,228,102,126,FMN GV 16 Berchem TOT
54,Posthofbrug 5366,2021-05-01,16:00:00,139,73,66,FMN GV 16 Berchem TOT
54,Posthofbrug 5366,2021-05-01,17:00:00,153,73,80,FMN GV 16 Berchem TOT
54,Posthofbrug 5366,2021-05-01,18:00:00,145,75,70,FMN GV 16 Berchem TOT
54,Posthofbrug 5366,2021-05-01,19:00:00,86,38,48,FMN GV 16 Berchem TOT
54,Posthofbrug 5366,2021-05-01,20:00:00,72,37,35,FMN GV 16 Berchem TOT
54,Posthofbrug 5366,2021-05-01,21:00:00,47,30,17,FMN GV 16 Berchem TOT
54,Posthofbrug 5366,2021-05-01,22:00:00,51,21,30,FMN GV 16 Berchem TOT
54,Posthofbrug 5366,2021-05-01,23:00:00,79,38,41,FMN GV 16 Berchem TOT
54,Posthofbrug 5366,2021-05-02,00:00:00,19,10,9,FMN GV 16 Berchem TOT
54,Posthofbrug 5366,2021-05-02,01:00:00,3,0,3,FMN GV 16 Berchem TOT
54,Posthofbrug 5366,2021-05-02,02:00:00,3,1,2,FMN GV 16 Berchem TOT
54,Posthofbrug 5366,2021-05-02,03:00:00,1,0,1,FMN GV 16 Berchem TOT
54,Posthofbrug 5366,2021-05-02,04:00:00,1,1,0,FMN GV 16 Berchem TOT
54,Posthofbrug 5366,2021-05-02,05:00:00,10,6,4,FMN GV 16 Berchem TOT
54,Posthofbrug 5366,2021-05-02,06:00:00,7,5,2,FMN GV 16 Berchem TOT
54,Posthofbrug 5366,2021-05-02,07:00:00,22,15,7,FMN GV 16 Berchem TOT
54,Posthofbrug 5366,2021-05-02,08:00:00,46,16,30,FMN GV 16 Berchem TOT
54,Posthofbrug 5366,2021-05-02,09:00:00,130,82,48,FMN GV 16 Berchem TOT
54,Posthofbrug 5366,2021-05-02,10:00:00,144,77,67,FMN GV 16 Berchem TOT
54,Posthofbrug 5366,2021-05-02,11:00:00,141,79,62,FMN GV 16 Berchem TOT
54,Posthofbrug 5366,2021-05-02,12:00:00,176,102,74,FMN GV 16 Berchem TOT
54,Posthofbrug 5366,2021-05-02,13:00:00,170,93,77,FMN GV 16 Berchem TOT
54,Posthofbrug 5366,2021-05-02,14:00:00,206,92,114,FMN GV 16 Berchem TOT
54,Posthofbrug 5366,2021-05-02,15:00:00,157,73,84,FMN GV 16 Berchem TOT
54,Posthofbrug 5366,2021-05-02,16:00:00,157,61,96,FMN GV 16 Berchem TOT
54,Posthofbrug 5366,2021-05-02,17:00:00,135,72,63,FMN GV 16 Berchem TOT
54,Posthofbrug 5366,2021-05-02,18:00:00,128,70,58,FMN GV 16 Berchem TOT
54,Posthofbrug 5366,2021-05-02,19:00:00,86,48,38,FMN GV 16 Berchem TOT
54,Posthofbrug 5366,2021-05-02,20:00:00,66,45,21,FMN GV 16 Berchem TOT
54,Posthofbrug 5366,2021-05-02,21:00:00,43,25,18,FMN GV 16 Berchem TOT
54,Posthofbrug 5366,2021-05-02,22:00:00,31,18,13,FMN GV 16 Berchem TOT
54,Posthofbrug 5366,2021-05-02,23:00:00,16,4,12,FMN GV 16 Berchem TOT
54,Posthofbrug 5366,2021-05-03,00:00:00,2,2,0,FMN GV 16 Berchem TOT
54,Posthofbrug 5366,2021-05-03,01:00:00,1,1,0,FMN GV 16 Berchem TOT
54,Posthofbrug 5366,2021-05-03,02:00:00,0,0,0,FMN GV 16 Berchem TOT
54,Posthofbrug 5366,2021-05-03,03:00:00,0,0,0,FMN GV 16 Berchem TOT
54,Posthofbrug 5366,2021-05-03,04:00:00,5,4,1,FMN GV 16 Berchem TOT
54,Posthofbrug 5366,2021-05-03,05:00:00,18,15,3,FMN GV 16 Berchem TOT
54,Posthofbrug 5366,2021-05-03,06:00:00,70,59,11,FMN GV 16 Berchem TOT
54,Posthofbrug 5366,2021-05-03,07:00:00,249,184,65,FMN GV 16 Berchem TOT
54,Posthofbrug 5366,2021-05-03,08:00:00,377,297,80,FMN GV 16 Berchem TOT
54,Posthofbrug 5366,2021-05-03,09:00:00,153,106,47,FMN GV 16 Berchem TOT
54,Posthofbrug 5366,2021-05-03,10:00:00,100,65,35,FMN GV 16 Berchem TOT
54,Posthofbrug 5366,2021-05-03,11:00:00,121,72,49,FMN GV 16 Berchem TOT
54,Posthofbrug 5366,2021-05-03,12:00:00,165,76,89,FMN GV 16 Berchem TOT
54,Posthofbrug 5366,2021-05-03,13:00:00,121,70,51,FMN GV 16 Berchem TOT
54,Posthofbrug 5366,2021-05-03,14:00:00,101,39,62,FMN GV 16 Berchem TOT
54,Posthofbrug 5366,2021-05-03,15:00:00,175,60,115,FMN GV 16 Berchem TOT
54,Posthofbrug 5366,2021-05-03,16:00:00,282,77,205,FMN GV 16 Berchem TOT
54,Posthofbrug 5366,2021-05-03,17:00:00,331,103,228,FMN GV 16 Berchem TOT
54,Posthofbrug 5366,2021-05-03,18:00:00,213,80,133,FMN GV 16 Berchem TOT
54,Posthofbrug 5366,2021-05-03,19:00:00,121,50,71,FMN GV 16 Berchem TOT
54,Posthofbrug 5366,2021-05-03,20:00:00,77,44,33,FMN GV 16 Berchem TOT
54,Posthofbrug 5366,2021-05-03,21:00:00,48,25,23,FMN GV 16 Berchem TOT
54,Posthofbrug 5366,2021-05-03,22:00:00,40,23,17,FMN GV 16 Berchem TOT
54,Posthofbrug 5366,2021-05-03,23:00:00,28,18,10,FMN GV 16 Berchem TOT
54,Posthofbrug 5366,2021-05-04,00:00:00,6,1,5,FMN GV 16 Berchem TOT
54,Posthofbrug 5366,2021-05-04,01:00:00,1,0,1,FMN GV 16 Berchem TOT
54,Posthofbrug 5366,2021-05-04,02:00:00,1,0,1,FMN GV 16 Berchem TOT
54,Posthofbrug 5366,2021-05-04,03:00:00,0,0,0,FMN GV 16 Berchem TOT
54,Posthofbrug 5366,2021-05-04,04:00:00,6,5,1,FMN GV 16 Berchem TOT
54,Posthofbrug 5366,2021-05-04,05:00:00,17,9,8,FMN GV 16 Berchem TOT
54,Posthofbrug 5366,2021-05-04,06:00:00,64,55,9,FMN GV 16 Berchem TOT
54,Posthofbrug 5366,2021-05-04,07:00:00,174,133,41,FMN GV 16 Berchem TOT
54,Posthofbrug 5366,2021-05-04,08:00:00,286,210,76,FMN GV 16 Berchem TOT
54,Posthofbrug 5366,2021-05-04,09:00:00,128,99,29,FMN GV 16 Berchem TOT
54,Posthofbrug 5366,2021-05-04,10:00:00,57,35,22,FMN GV 16 Berchem TOT
54,Posthofbrug 5366,2021-05-04,11:00:00,41,22,19,FMN GV 16 Berchem TOT
54,Posthofbrug 5366,2021-05-04,12:00:00,103,49,54,FMN GV 16 Berchem TOT
54,Posthofbrug 5366,2021-05-04,13:00:00,70,35,35,FMN GV 16 Berchem TOT
54,Posthofbrug 5366,2021-05-04,14:00:00,48,21,27,FMN GV 16 Berchem TOT
54,Posthofbrug 5366,2021-05-04,15:00:00,131,43,88,FMN GV 16 Berchem TOT
54,Posthofbrug 5366,2021-05-04,16:00:00,198,53,145,FMN GV 16 Berchem TOT
54,Posthofbrug 5366,2021-05-04,17:00:00,206,65,141,FMN GV 16 Berchem TOT
54,Posthofbrug 5366,2021-05-04,18:00:00,149,48,101,FMN GV 16 Berchem TOT
54,Posthofbrug 5366,2021-05-04,19:00:00,54,28,26,FMN GV 16 Berchem TOT
54,Posthofbrug 5366,2021-05-04,20:00:00,43,18,25,FMN GV 16 Berchem TOT
54,Posthofbrug 5366,2021-05-04,21:00:00,50,32,18,FMN GV 16 Berchem TOT
54,Posthofbrug 5366,2021-05-04,22:00:00,33,15,18,FMN GV 16 Berchem TOT
54,Posthofbrug 5366,2021-05-04,23:00:00,12,5,7,FMN GV 16 Berchem TOT
54,Posthofbrug 5366,2021-05-05,00:00:00,2,0,2,FMN GV 16 Berchem TOT
54,Posthofbrug 5366,2021-05-05,01:00:00,0,0,0,FMN GV 16 Berchem TOT
54,Posthofbrug 5366,2021-05-05,02:00:00,0,0,0,FMN GV 16 Berchem TOT
54,Posthofbrug 5366,2021-05-05,03:00:00,1,0,1,FMN GV 16 Berchem TOT
54,Posthofbrug 5366,2021-05-05,04:00:00,7,7,0,FMN GV 16 Berchem TOT
54,Posthofbrug 5366,2021-05-05,05:00:00,14,11,3,FMN GV 16 Berchem TOT
54,Posthofbrug 5366,2021-05-05,06:00:00,72,58,14,FMN GV 16 Berchem TOT
54,Posthofbrug 5366,2021-05-05,07:00:00,191,142,49,FMN GV 16 Berchem TOT
54,Posthofbrug 5366,2021-05-05,08:00:00,279,204,75,FMN GV 16 Berchem TOT
54,Posthofbrug 5366,2021-05-05,09:00:00,124,90,34,FMN GV 16 Berchem TOT
54,Posthofbrug 5366,2021-05-05,10:00:00,64,42,22,FMN GV 16 Berchem TOT
54,Posthofbrug 5366,2021-05-05,11:00:00,92,35,57,FMN GV 16 Berchem TOT
54,Posthofbrug 5366,2021-05-05,12:00:00,161,75,86,FMN GV 16 Berchem TOT
54,Posthofbrug 5366,2021-05-05,13:00:00,114,52,62,FMN GV 16 Berchem TOT
54,Posthofbrug 5366,2021-05-05,14:00:00,102,56,46,FMN GV 16 Berchem TOT
54,Posthofbrug 5366,2021-05-05,15:00:00,112,39,73,FMN GV 16 Berchem TOT
54,Posthofbrug 5366,2021-05-05,16:00:00,212,67,145,FMN GV 16 Berchem TOT
54,Posthofbrug 5366,2021-05-05,17:00:00,289,98,191,FMN GV 16 Berchem TOT
54,Posthofbrug 5366,2021-05-05,18:00:00,193,73,120,FMN GV 16 Berchem TOT
54,Posthofbrug 5366,2021-05-05,19:00:00,130,52,78,FMN GV 16 Berchem TOT
54,Posthofbrug 5366,2021-05-05,20:00:00,105,64,41,FMN GV 16 Berchem TOT
54,Posthofbrug 5366,2021-05-05,21:00:00,45,18,27,FMN GV 16 Berchem TOT
54,Posthofbrug 5366,2021-05-05,22:00:00,36,10,26,FMN GV 16 Berchem TOT
54,Posthofbrug 5366,2021-05-05,23:00:00,25,13,12,FMN GV 16 Berchem TOT
54,Posthofbrug 5366,2021-05-06,00:00:00,10,6,4,FMN GV 16 Berchem TOT
54,Posthofbrug 5366,2021-05-06,01:00:00,0,0,0,FMN GV 16 Berchem TOT
54,Posthofbrug 5366,2021-05-06,02:00:00,0,0,0,FMN GV 16 Berchem TOT
54,Posthofbrug 5366,2021-05-06,03:00:00,1,0,1,FMN GV 16 Berchem TOT
54,Posthofbrug 5366,2021-05-06,04:00:00,4,3,1,FMN GV 16 Berchem TOT
54,Posthofbrug 5366,2021-05-06,05:00:00,20,13,7,FMN GV 16 Berchem TOT
54,Posthofbrug 5366,2021-05-06,06:00:00,75,61,14,FMN GV 16 Berchem TOT
54,Posthofbrug 5366,2021-05-06,07:00:00,254,189,65,FMN GV 16 Berchem TOT
54,Posthofbrug 5366,2021-05-06,08:00:00,347,256,91,FMN GV 16 Berchem TOT
54,Posthofbrug 5366,2021-05-06,09:00:00,147,106,41,FMN GV 16 Berchem TOT
54,Posthofbrug 5366,2021-05-06,10:00:00,88,49,39,FMN GV 16 Berchem TOT
54,Posthofbrug 5366,2021-05-06,11:00:00,84,49,35,FMN GV 16 Berchem TOT
54,Posthofbrug 5366,2021-05-06,12:00:00,136,72,64,FMN GV 16 Berchem TOT
54,Posthofbrug 5366,2021-05-06,13:00:00,118,71,47,FMN GV 16 Berchem TOT
54,Posthofbrug 5366,2021-05-06,14:00:00,91,41,50,FMN GV 16 Berchem TOT
54,Posthofbrug 5366,2021-05-06,15:00:00,180,80,100,FMN GV 16 Berchem TOT
54,Posthofbrug 5366,2021-05-06,16:00:00,285,86,199,FMN GV 16 Berchem TOT
54,Posthofbrug 5366,2021-05-06,17:00:00,264,81,183,FMN GV 16 Berchem TOT
54,Posthofbrug 5366,2021-05-06,18:00:00,202,79,123,FMN GV 16 Berchem TOT
54,Posthofbrug 5366,2021-05-06,19:00:00,86,27,59,FMN GV 16 Berchem TOT
54,Posthofbrug 5366,2021-05-06,20:00:00,73,36,37,FMN GV 16 Berchem TOT
54,Posthofbrug 5366,2021-05-06,21:00:00,47,27,20,FMN GV 16 Berchem TOT
54,Posthofbrug 5366,2021-05-06,22:00:00,43,19,24,FMN GV 16 Berchem TOT
54,Posthofbrug 5366,2021-05-06,23:00:00,25,11,14,FMN GV 16 Berchem TOT
54,Posthofbrug 5366,2021-05-07,00:00:00,20,10,10,FMN GV 16 Berchem TOT
54,Posthofbrug 5366,2021-05-07,01:00:00,2,0,2,FMN GV 16 Berchem TOT
54,Posthofbrug 5366,2021-05-07,02:00:00,4,0,4,FMN GV 16 Berchem TOT
54,Posthofbrug 5366,2021-05-07,03:00:00,0,0,0,FMN GV 16 Berchem TOT
54,Posthofbrug 5366,2021-05-07,04:00:00,6,4,2,FMN GV 16 Berchem TOT
54,Posthofbrug 5366,2021-05-07,05:00:00,9,7,2,FMN GV 16 Berchem TOT
54,Posthofbrug 5366,2021-05-07,06:00:00,69,56,13,FMN GV 16 Berchem TOT
54,Posthofbrug 5366,2021-05-07,07:00:00,217,156,61,FMN GV 16 Berchem TOT
54,Posthofbrug 5366,2021-05-07,08:00:00,348,269,79,FMN GV 16 Berchem TOT
54,Posthofbrug 5366,2021-05-07,09:00:00,167,129,38,FMN GV 16 Berchem TOT
54,Posthofbrug 5366,2021-05-07,10:00:00,95,52,43,FMN GV 16 Berchem TOT
54,Posthofbrug 5366,2021-05-07,11:00:00,109,64,45,FMN GV 16 Berchem TOT
54,Posthofbrug 5366,2021-05-07,12:00:00,146,74,72,FMN GV 16 Berchem TOT
54,Posthofbrug 5366,2021-05-07,13:00:00,157,76,81,FMN GV 16 Berchem TOT
54,Posthofbrug 5366,2021-05-07,14:00:00,136,61,75,FMN GV 16 Berchem TOT
54,Posthofbrug 5366,2021-05-07,15:00:00,199,69,130,FMN GV 16 Berchem TOT
54,Posthofbrug 5366,2021-05-07,16:00:00,301,98,203,FMN GV 16 Berchem TOT
54,Posthofbrug 5366,2021-05-07,17:00:00,264,88,176,FMN GV 16 Berchem TOT
54,Posthofbrug 5366,2021-05-07,18:00:00,201,71,130,FMN GV 16 Berchem TOT
54,Posthofbrug 5366,2021-05-07,19:00:00,131,53,78,FMN GV 16 Berchem TOT
54,Posthofbrug 5366,2021-05-07,20:00:00,94,60,34,FMN GV 16 Berchem TOT
54,Posthofbrug 5366,2021-05-07,21:00:00,48,23,25,FMN GV 16 Berchem TOT
54,Posthofbrug 5366,2021-05-07,22:00:00,53,30,23,FMN GV 16 Berchem TOT
54,Posthofbrug 5366,2021-05-07,23:00:00,33,17,16,FMN GV 16 Berchem TOT
54,Posthofbrug 5366,2021-05-08,00:00:00,32,14,18,FMN GV 16 Berchem TOT
54,Posthofbrug 5366,2021-05-08,01:00:00,25,9,16,FMN GV 16 Berchem TOT
54,Posthofbrug 5366,2021-05-08,02:00:00,12,5,7,FMN GV 16 Berchem TOT
54,Posthofbrug 5366,2021-05-08,03:00:00,10,5,5,FMN GV 16 Berchem TOT
54,Posthofbrug 5366,2021-05-08,04:00:00,6,3,3,FMN GV 16 Berchem TOT
54,Posthofbrug 5366,2021-05-08,05:00:00,12,5,7,FMN GV 16 Berchem TOT
54,Posthofbrug 5366,2021-05-08,06:00:00,21,15,6,FMN GV 16 Berchem TOT
54,Posthofbrug 5366,2021-05-08,07:00:00,32,20,12,FMN GV 16 Berchem TOT
54,Posthofbrug 5366,2021-05-08,08:00:00,58,36,22,FMN GV 16 Berchem TOT
54,Posthofbrug 5366,2021-05-08,09:00:00,103,65,38,FMN GV 16 Berchem TOT
54,Posthofbrug 5366,2021-05-08,10:00:00,123,77,46,FMN GV 16 Berchem TOT
54,Posthofbrug 5366,2021-05-08,11:00:00,116,64,52,FMN GV 16 Berchem TOT
54,Posthofbrug 5366,2021-05-08,12:00:00,98,50,48,FMN GV 16 Berchem TOT
54,Posthofbrug 5366,2021-05-08,13:00:00,110,57,53,FMN GV 16 Berchem TOT
54,Posthofbrug 5366,2021-05-08,14:00:00,120,66,54,FMN GV 16 Berchem TOT
54,Posthofbrug 5366,2021-05-08,15:00:00,127,67,60,FMN GV 16 Berchem TOT
54,Posthofbrug 5366,2021-05-08,16:00:00,133,81,52,FMN GV 16 Berchem TOT
54,Posthofbrug 5366,2021-05-08,17:00:00,161,82,79,FMN GV 16 Berchem TOT
54,Posthofbrug 5366,2021-05-08,18:00:00,142,75,67,FMN GV 16 Berchem TOT
54,Posthofbrug 5366,2021-05-08,19:00:00,117,62,55,FMN GV 16 Berchem TOT
54,Posthofbrug 5366,2021-05-08,20:00:00,84,43,41,FMN GV 16 Berchem TOT
54,Posthofbrug 5366,2021-05-08,21:00:00,54,24,30,FMN GV 16 Berchem TOT
54,Posthofbrug 5366,2021-05-08,22:00:00,85,43,42,FMN GV 16 Berchem TOT
54,Posthofbrug 5366,2021-05-08,23:00:00,71,27,44,FMN GV 16 Berchem TOT
54,Posthofbrug 5366,2021-05-09,00:00:00,62,20,42,FMN GV 16 Berchem TOT
54,Posthofbrug 5366,2021-05-09,01:00:00,50,28,22,FMN GV 16 Berchem TOT
54,Posthofbrug 5366,2021-05-09,02:00:00,22,9,13,FMN GV 16 Berchem TOT
54,Posthofbrug 5366,2021-05-09,03:00:00,9,0,9,FMN GV 16 Berchem TOT
54,Posthofbrug 5366,2021-05-09,04:00:00,5,4,1,FMN GV 16 Berchem TOT
54,Posthofbrug 5366,2021-05-09,05:00:00,14,9,5,FMN GV 16 Berchem TOT
54,Posthofbrug 5366,2021-05-09,06:00:00,20,19,1,FMN GV 16 Berchem TOT
54,Posthofbrug 5366,2021-05-09,07:00:00,25,10,15,FMN GV 16 Berchem TOT
54,Posthofbrug 5366,2021-05-09,08:00:00,47,26,21,FMN GV 16 Berchem TOT
54,Posthofbrug 5366,2021-05-09,09:00:00,83,27,56,FMN GV 16 Berchem TOT
54,Posthofbrug 5366,2021-05-09,10:00:00,114,57,57,FMN GV 16 Berchem TOT
54,Posthofbrug 5366,2021-05-09,11:00:00,165,83,82,FMN GV 16 Berchem TOT
54,Posthofbrug 5366,2021-05-09,12:00:00,190,96,94,FMN GV 16 Berchem TOT
54,Posthofbrug 5366,2021-05-09,13:00:00,162,82,80,FMN GV 16 Berchem TOT
54,Posthofbrug 5366,2021-05-09,14:00:00,224,105,119,FMN GV 16 Berchem TOT
54,Posthofbrug 5366,2021-05-09,15:00:00,180,83,97,FMN GV 16 Berchem TOT
54,Posthofbrug 5366,2021-05-09,16:00:00,205,98,107,FMN GV 16 Berchem TOT
54,Posthofbrug 5366,2021-05-09,17:00:00,202,107,95,FMN GV 16 Berchem TOT
54,Posthofbrug 5366,2021-05-09,18:00:00,149,83,66,FMN GV 16 Berchem TOT
54,Posthofbrug 5366,2021-05-09,19:00:00,100,55,45,FMN GV 16 Berchem TOT
54,Posthofbrug 5366,2021-05-09,20:00:00,89,51,38,FMN GV 16 Berchem TOT
54,Posthofbrug 5366,2021-05-09,21:00:00,49,25,24,FMN GV 16 Berchem TOT
54,Posthofbrug 5366,2021-05-09,22:00:00,46,22,24,FMN GV 16 Berchem TOT
54,Posthofbrug 5366,2021-05-09,23:00:00,27,12,15,FMN GV 16 Berchem TOT
54,Posthofbrug 5366,2021-05-10,00:00:00,7,4,3,FMN GV 16 Berchem TOT
54,Posthofbrug 5366,2021-05-10,01:00:00,8,5,3,FMN GV 16 Berchem TOT
54,Posthofbrug 5366,2021-05-10,02:00:00,3,0,3,FMN GV 16 Berchem TOT
54,Posthofbrug 5366,2021-05-10,03:00:00,2,2,0,FMN GV 16 Berchem TOT
54,Posthofbrug 5366,2021-05-10,04:00:00,8,7,1,FMN GV 16 Berchem TOT
54,Posthofbrug 5366,2021-05-10,05:00:00,25,20,5,FMN GV 16 Berchem TOT
54,Posthofbrug 5366,2021-05-10,06:00:00,66,52,14,FMN GV 16 Berchem TOT
54,Posthofbrug 5366,2021-05-10,07:00:00,247,182,65,FMN GV 16 Berchem TOT
54,Posthofbrug 5366,2021-05-10,08:00:00,374,272,102,FMN GV 16 Berchem TOT
54,Posthofbrug 5366,2021-05-10,09:00:00,123,87,36,FMN GV 16 Berchem TOT
54,Posthofbrug 5366,2021-05-10,10:00:00,55,38,17,FMN GV 16 Berchem TOT
54,Posthofbrug 5366,2021-05-10,11:00:00,55,37,18,FMN GV 16 Berchem TOT
54,Posthofbrug 5366,2021-05-10,12:00:00,99,51,48,FMN GV 16 Berchem TOT
54,Posthofbrug 5366,2021-05-10,13:00:00,121,68,53,FMN GV 16 Berchem TOT
54,Posthofbrug 5366,2021-05-10,14:00:00,86,44,42,FMN GV 16 Berchem TOT
54,Posthofbrug 5366,2021-05-10,15:00:00,166,62,104,FMN GV 16 Berchem TOT
54,Posthofbrug 5366,2021-05-10,16:00:00,307,89,218,FMN GV 16 Berchem TOT
54,Posthofbrug 5366,2021-05-10,17:00:00,289,88,201,FMN GV 16 Berchem TOT
54,Posthofbrug 5366,2021-05-10,18:00:00,233,87,146,FMN GV 16 Berchem TOT
54,Posthofbrug 5366,2021-05-10,19:00:00,111,62,49,FMN GV 16 Berchem TOT
54,Posthofbrug 5366,2021-05-10,20:00:00,80,49,31,FMN GV 16 Berchem TOT
54,Posthofbrug 5366,2021-05-10,21:00:00,54,25,29,FMN GV 16 Berchem TOT
54,Posthofbrug 5366,2021-05-10,22:00:00,53,26,27,FMN GV 16 Berchem TOT
54,Posthofbrug 5366,2021-05-10,23:00:00,25,10,15,FMN GV 16 Berchem TOT
54,Posthofbrug 5366,2021-05-11,00:00:00,9,3,6,FMN GV 16 Berchem TOT
54,Posthofbrug 5366,2021-05-11,01:00:00,5,0,5,FMN GV 16 Berchem TOT
54,Posthofbrug 5366,2021-05-11,02:00:00,1,0,1,FMN GV 16 Berchem TOT
54,Posthofbrug 5366,2021-05-11,03:00:00,3,0,3,FMN GV 16 Berchem TOT
54,Posthofbrug 5366,2021-05-11,04:00:00,9,8,1,FMN GV 16 Berchem TOT
54,Posthofbrug 5366,2021-05-11,05:00:00,22,16,6,FMN GV 16 Berchem TOT
54,Posthofbrug 5366,2021-05-11,06:00:00,91,73,18,FMN GV 16 Berchem TOT
54,Posthofbrug 5366,2021-05-11,07:00:00,291,219,72,FMN GV 16 Berchem TOT
54,Posthofbrug 5366,2021-05-11,08:00:00,393,303,90,FMN GV 16 Berchem TOT
54,Posthofbrug 5366,2021-05-11,09:00:00,176,137,39,FMN GV 16 Berchem TOT
54,Posthofbrug 5366,2021-05-11,10:00:00,94,53,41,FMN GV 16 Berchem TOT
54,Posthofbrug 5366,2021-05-11,11:00:00,96,56,40,FMN GV 16 Berchem TOT
54,Posthofbrug 5366,2021-05-11,12:00:00,130,75,55,FMN GV 16 Berchem TOT
54,Posthofbrug 5366,2021-05-11,13:00:00,129,68,61,FMN GV 16 Berchem TOT
54,Posthofbrug 5366,2021-05-11,14:00:00,109,49,60,FMN GV 16 Berchem TOT
54,Posthofbrug 5366,2021-05-11,15:00:00,186,61,125,FMN GV 16 Berchem TOT
54,Posthofbrug 5366,2021-05-11,16:00:00,263,83,180,FMN GV 16 Berchem TOT
54,Posthofbrug 5366,2021-05-11,17:00:00,293,79,214,FMN GV 16 Berchem TOT
54,Posthofbrug 5366,2021-05-11,18:00:00,198,61,137,FMN GV 16 Berchem TOT
54,Posthofbrug 5366,2021-05-11,19:00:00,108,44,64,FMN GV 16 Berchem TOT
54,Posthofbrug 5366,2021-05-11,20:00:00,61,23,38,FMN GV 16 Berchem TOT
54,Posthofbrug 5366,2021-05-11,21:00:00,43,26,17,FMN GV 16 Berchem TOT
54,Posthofbrug 5366,2021-05-11,22:00:00,40,19,21,FMN GV 16 Berchem TOT
54,Posthofbrug 5366,2021-05-11,23:00:00,20,13,7,FMN GV 16 Berchem TOT
54,Posthofbrug 5366,2021-05-12,00:00:00,9,5,4,FMN GV 16 Berchem TOT
54,Posthofbrug 5366,2021-05-12,01:00:00,3,0,3,FMN GV 16 Berchem TOT
54,Posthofbrug 5366,2021-05-12,02:00:00,0,0,0,FMN GV 16 Berchem TOT
54,Posthofbrug 5366,2021-05-12,03:00:00,0,0,0,FMN GV 16 Berchem TOT
54,Posthofbrug 5366,2021-05-12,04:00:00,8,7,1,FMN GV 16 Berchem TOT
54,Posthofbrug 5366,2021-05-12,05:00:00,23,18,5,FMN GV 16 Berchem TOT
54,Posthofbrug 5366,2021-05-12,06:00:00,91,71,20,FMN GV 16 Berchem TOT
54,Posthofbrug 5366,2021-05-12,07:00:00,244,181,63,FMN GV 16 Berchem TOT
54,Posthofbrug 5366,2021-05-12,08:00:00,343,248,95,FMN GV 16 Berchem TOT
54,Posthofbrug 5366,2021-05-12,09:00:00,169,136,33,FMN GV 16 Berchem TOT
54,Posthofbrug 5366,2021-05-12,10:00:00,118,74,44,FMN GV 16 Berchem TOT
54,Posthofbrug 5366,2021-05-12,11:00:00,131,71,60,FMN GV 16 Berchem TOT
54,Posthofbrug 5366,2021-05-12,12:00:00,265,125,140,FMN GV 16 Berchem TOT
54,Posthofbrug 5366,2021-05-12,13:00:00,152,66,86,FMN GV 16 Berchem TOT
54,Posthofbrug 5366,2021-05-12,14:00:00,159,77,82,FMN GV 16 Berchem TOT
54,Posthofbrug 5366,2021-05-12,15:00:00,189,89,100,FMN GV 16 Berchem TOT
54,Posthofbrug 5366,2021-05-12,16:00:00,245,84,161,FMN GV 16 Berchem TOT
54,Posthofbrug 5366,2021-05-12,17:00:00,290,109,181,FMN GV 16 Berchem TOT
54,Posthofbrug 5366,2021-05-12,18:00:00,261,93,168,FMN GV 16 Berchem TOT
54,Posthofbrug 5366,2021-05-12,19:00:00,165,74,91,FMN GV 16 Berchem TOT
54,Posthofbrug 5366,2021-05-12,20:00:00,117,66,51,FMN GV 16 Berchem TOT
54,Posthofbrug 5366,2021-05-12,21:00:00,70,28,42,FMN GV 16 Berchem TOT
54,Posthofbrug 5366,2021-05-12,22:00:00,78,26,52,FMN GV 16 Berchem TOT
54,Posthofbrug 5366,2021-05-12,23:00:00,36,20,16,FMN GV 16 Berchem TOT
54,Posthofbrug 5366,2021-05-13,00:00:00,30,8,22,FMN GV 16 Berchem TOT
54,Posthofbrug 5366,2021-05-13,01:00:00,35,10,25,FMN GV 16 Berchem TOT
54,Posthofbrug 5366,2021-05-13,02:00:00,27,8,19,FMN GV 16 Berchem TOT
54,Posthofbrug 5366,2021-05-13,03:00:00,6,1,5,FMN GV 16 Berchem TOT
54,Posthofbrug 5366,2021-05-13,04:00:00,7,3,4,FMN GV 16 Berchem TOT
54,Posthofbrug 5366,2021-05-13,05:00:00,5,3,2,FMN GV 16 Berchem TOT
54,Posthofbrug 5366,2021-05-13,06:00:00,26,20,6,FMN GV 16 Berchem TOT
54,Posthofbrug 5366,2021-05-13,07:00:00,31,19,12,FMN GV 16 Berchem TOT
54,Posthofbrug 5366,2021-05-13,08:00:00,53,31,22,FMN GV 16 Berchem TOT
54,Posthofbrug 5366,2021-05-13,09:00:00,116,69,47,FMN GV 16 Berchem TOT
54,Posthofbrug 5366,2021-05-13,10:00:00,133,63,70,FMN GV 16 Berchem TOT
54,Posthofbrug 5366,2021-05-13,11:00:00,119,52,67,FMN GV 16 Berchem TOT
54,Posthofbrug 5366,2021-05-13,12:00:00,123,76,47,FMN GV 16 Berchem TOT
54,Posthofbrug 5366,2021-05-13,13:00:00,153,82,71,FMN GV 16 Berchem TOT
54,Posthofbrug 5366,2021-05-13,14:00:00,151,77,74,FMN GV 16 Berchem TOT
54,Posthofbrug 5366,2021-05-13,15:00:00,135,51,84,FMN GV 16 Berchem TOT
54,Posthofbrug 5366,2021-05-13,16:00:00,117,63,54,FMN GV 16 Berchem TOT
54,Posthofbrug 5366,2021-05-13,17:00:00,138,80,58,FMN GV 16 Berchem TOT
54,Posthofbrug 5366,2021-05-13,18:00:00,123,78,45,FMN GV 16 Berchem TOT
54,Posthofbrug 5366,2021-05-13,19:00:00,92,35,57,FMN GV 16 Berchem TOT
54,Posthofbrug 5366,2021-05-13,20:00:00,55,35,20,FMN GV 16 Berchem TOT
54,Posthofbrug 5366,2021-05-13,21:00:00,64,33,31,FMN GV 16 Berchem TOT
54,Posthofbrug 5366,2021-05-13,22:00:00,71,31,40,FMN GV 16 Berchem TOT
54,Posthofbrug 5366,2021-05-13,23:00:00,41,15,26,FMN GV 16 Berchem TOT
54,Posthofbrug 5366,2021-05-14,00:00:00,34,11,23,FMN GV 16 Berchem TOT
54,Posthofbrug 5366,2021-05-14,01:00:00,11,2,9,FMN GV 16 Berchem TOT
54,Posthofbrug 5366,2021-05-14,02:00:00,10,3,7,FMN GV 16 Berchem TOT
54,Posthofbrug 5366,2021-05-14,03:00:00,3,1,2,FMN GV 16 Berchem TOT
54,Posthofbrug 5366,2021-05-14,04:00:00,10,8,2,FMN GV 16 Berchem TOT
54,Posthofbrug 5366,2021-05-14,05:00:00,7,4,3,FMN GV 16 Berchem TOT
54,Posthofbrug 5366,2021-05-14,06:00:00,31,23,8,FMN GV 16 Berchem TOT
54,Posthofbrug 5366,2021-05-14,07:00:00,62,40,22,FMN GV 16 Berchem TOT
54,Posthofbrug 5366,2021-05-14,08:00:00,98,65,33,FMN GV 16 Berchem TOT
54,Posthofbrug 5366,2021-05-14,09:00:00,127,87,40,FMN GV 16 Berchem TOT
54,Posthofbrug 5366,2021-05-14,10:00:00,113,76,37,FMN GV 16 Berchem TOT
54,Posthofbrug 5366,2021-05-14,11:00:00,158,99,59,FMN GV 16 Berchem TOT
54,Posthofbrug 5366,2021-05-14,12:00:00,164,92,72,FMN GV 16 Berchem TOT
54,Posthofbrug 5366,2021-05-14,13:00:00,132,68,64,FMN GV 16 Berchem TOT
54,Posthofbrug 5366,2021-05-14,14:00:00,100,49,51,FMN GV 16 Berchem TOT
54,Posthofbrug 5366,2021-05-14,15:00:00,101,31,70,FMN GV 16 Berchem TOT
54,Posthofbrug 5366,2021-05-14,16:00:00,130,53,77,FMN GV 16 Berchem TOT
54,Posthofbrug 5366,2021-05-14,17:00:00,142,59,83,FMN GV 16 Berchem TOT
54,Posthofbrug 5366,2021-05-14,18:00:00,162,77,85,FMN GV 16 Berchem TOT
54,Posthofbrug 5366,2021-05-14,19:00:00,57,24,33,FMN GV 16 Berchem TOT
54,Posthofbrug 5366,2021-05-14,20:00:00,57,34,23,FMN GV 16 Berchem TOT
54,Posthofbrug 5366,2021-05-14,21:00:00,47,18,29,FMN GV 16 Berchem TOT
54,Posthofbrug 5366,2021-05-14,22:00:00,58,27,31,FMN GV 16 Berchem TOT
54,Posthofbrug 5366,2021-05-14,23:00:00,38,8,30,FMN GV 16 Berchem TOT
54,Posthofbrug 5366,2021-05-15,00:00:00,34,8,26,FMN GV 16 Berchem TOT
54,Posthofbrug 5366,2021-05-15,01:00:00,30,7,23,FMN GV 16 Berchem TOT
54,Posthofbrug 5366,2021-05-15,02:00:00,13,6,7,FMN GV 16 Berchem TOT
54,Posthofbrug 5366,2021-05-15,03:00:00,10,6,4,FMN GV 16 Berchem TOT
54,Posthofbrug 5366,2021-05-15,04:00:00,5,1,4,FMN GV 16 Berchem TOT
54,Posthofbrug 5366,2021-05-15,05:00:00,11,7,4,FMN GV 16 Berchem TOT
54,Posthofbrug 5366,2021-05-15,06:00:00,16,12,4,FMN GV 16 Berchem TOT
54,Posthofbrug 5366,2021-05-15,07:00:00,29,17,12,FMN GV 16 Berchem TOT
54,Posthofbrug 5366,2021-05-15,08:00:00,57,39,18,FMN GV 16 Berchem TOT
54,Posthofbrug 5366,2021-05-15,09:00:00,93,53,40,FMN GV 16 Berchem TOT
54,Posthofbrug 5366,2021-05-15,10:00:00,91,55,36,FMN GV 16 Berchem TOT
54,Posthofbrug 5366,2021-05-15,11:00:00,90,62,28,FMN GV 16 Berchem TOT
54,Posthofbrug 5366,2021-05-15,12:00:00,74,47,27,FMN GV 16 Berchem TOT
54,Posthofbrug 5366,2021-05-15,13:00:00,90,43,47,FMN GV 16 Berchem TOT
54,Posthofbrug 5366,2021-05-15,14:00:00,87,43,44,FMN GV 16 Berchem TOT
54,Posthofbrug 5366,2021-05-15,15:00:00,97,50,47,FMN GV 16 Berchem TOT
54,Posthofbrug 5366,2021-05-15,16:00:00,94,38,56,FMN GV 16 Berchem TOT
54,Posthofbrug 5366,2021-05-15,17:00:00,117,50,67,FMN GV 16 Berchem TOT
54,Posthofbrug 5366,2021-05-15,18:00:00,84,34,50,FMN GV 16 Berchem TOT
54,Posthofbrug 5366,2021-05-15,19:00:00,63,24,39,FMN GV 16 Berchem TOT
54,Posthofbrug 5366,2021-05-15,20:00:00,54,30,24,FMN GV 16 Berchem TOT
54,Posthofbrug 5366,2021-05-15,21:00:00,35,19,16,FMN GV 16 Berchem TOT
54,Posthofbrug 5366,2021-05-15,22:00:00,46,27,19,FMN GV 16 Berchem TOT
54,Posthofbrug 5366,2021-05-15,23:00:00,28,10,18,FMN GV 16 Berchem TOT
54,Posthofbrug 5366,2021-05-16,00:00:00,14,6,8,FMN GV 16 Berchem TOT
54,Posthofbrug 5366,2021-05-16,01:00:00,22,13,9,FMN GV 16 Berchem TOT
54,Posthofbrug 5366,2021-05-16,02:00:00,8,3,5,FMN GV 16 Berchem TOT
54,Posthofbrug 5366,2021-05-16,03:00:00,4,4,0,FMN GV 16 Berchem TOT
54,Posthofbrug 5366,2021-05-16,04:00:00,5,0,5,FMN GV 16 Berchem TOT
54,Posthofbrug 5366,2021-05-16,05:00:00,14,6,8,FMN GV 16 Berchem TOT
54,Posthofbrug 5366,2021-05-16,06:00:00,7,6,1,FMN GV 16 Berchem TOT
54,Posthofbrug 5366,2021-05-16,07:00:00,24,14,10,FMN GV 16 Berchem TOT
54,Posthofbrug 5366,2021-05-16,08:00:00,63,30,33,FMN GV 16 Berchem TOT
54,Posthofbrug 5366,2021-05-16,09:00:00,86,48,38,FMN GV 16 Berchem TOT
54,Posthofbrug 5366,2021-05-16,10:00:00,96,59,37,FMN GV 16 Berchem TOT
54,Posthofbrug 5366,2021-05-16,11:00:00,117,58,59,FMN GV 16 Berchem TOT
54,Posthofbrug 5366,2021-05-16,12:00:00,122,65,57,FMN GV 16 Berchem TOT
54,Posthofbrug 5366,2021-05-16,13:00:00,104,54,50,FMN GV 16 Berchem TOT
54,Posthofbrug 5366,2021-05-16,14:00:00,108,60,48,FMN GV 16 Berchem TOT
54,Posthofbrug 5366,2021-05-16,15:00:00,58,28,30,FMN GV 16 Berchem TOT
54,Posthofbrug 5366,2021-05-16,16:00:00,79,49,30,FMN GV 16 Berchem TOT
54,Posthofbrug 5366,2021-05-16,17:00:00,75,39,36,FMN GV 16 Berchem TOT
54,Posthofbrug 5366,2021-05-16,18:00:00,88,47,41,FMN GV 16 Berchem TOT
54,Posthofbrug 5366,2021-05-16,19:00:00,73,34,39,FMN GV 16 Berchem TOT
54,Posthofbrug 5366,2021-05-16,20:00:00,55,32,23,FMN GV 16 Berchem TOT
54,Posthofbrug 5366,2021-05-16,21:00:00,59,42,17,FMN GV 16 Berchem TOT
54,Posthofbrug 5366,2021-05-16,22:00:00,32,9,23,FMN GV 16 Berchem TOT
54,Posthofbrug 5366,2021-05-16,23:00:00,15,5,10,FMN GV 16 Berchem TOT
54,Posthofbrug 5366,2021-05-17,00:00:00,4,3,1,FMN GV 16 Berchem TOT
54,Posthofbrug 5366,2021-05-17,01:00:00,9,5,4,FMN GV 16 Berchem TOT
54,Posthofbrug 5366,2021-05-17,02:00:00,0,0,0,FMN GV 16 Berchem TOT
54,Posthofbrug 5366,2021-05-17,03:00:00,6,2,4,FMN GV 16 Berchem TOT
54,Posthofbrug 5366,2021-05-17,04:00:00,6,6,0,FMN GV 16 Berchem TOT
54,Posthofbrug 5366,2021-05-17,05:00:00,15,11,4,FMN GV 16 Berchem TOT
54,Posthofbrug 5366,2021-05-17,06:00:00,77,67,10,FMN GV 16 Berchem TOT
54,Posthofbrug 5366,2021-05-17,07:00:00,250,175,75,FMN GV 16 Berchem TOT
54,Posthofbrug 5366,2021-05-17,08:00:00,296,230,66,FMN GV 16 Berchem TOT
54,Posthofbrug 5366,2021-05-17,09:00:00,98,71,27,FMN GV 16 Berchem TOT
54,Posthofbrug 5366,2021-05-17,10:00:00,43,30,13,FMN GV 16 Berchem TOT
54,Posthofbrug 5366,2021-05-17,11:00:00,55,30,25,FMN GV 16 Berchem TOT
54,Posthofbrug 5366,2021-05-17,12:00:00,80,40,40,FMN GV 16 Berchem TOT
54,Posthofbrug 5366,2021-05-17,13:00:00,74,39,35,FMN GV 16 Berchem TOT
54,Posthofbrug 5366,2021-05-17,14:00:00,76,36,40,FMN GV 16 Berchem TOT
54,Posthofbrug 5366,2021-05-17,15:00:00,165,52,113,FMN GV 16 Berchem TOT
54,Posthofbrug 5366,2021-05-17,16:00:00,251,74,177,FMN GV 16 Berchem TOT
54,Posthofbrug 5366,2021-05-17,17:00:00,252,86,166,FMN GV 16 Berchem TOT
54,Posthofbrug 5366,2021-05-17,18:00:00,187,55,132,FMN GV 16 Berchem TOT
54,Posthofbrug 5366,2021-05-17,19:00:00,98,45,53,FMN GV 16 Berchem TOT
54,Posthofbrug 5366,2021-05-17,20:00:00,78,49,29,FMN GV 16 Berchem TOT
54,Posthofbrug 5366,2021-05-17,21:00:00,63,34,29,FMN GV 16 Berchem TOT
54,Posthofbrug 5366,2021-05-17,22:00:00,35,16,19,FMN GV 16 Berchem TOT
54,Posthofbrug 5366,2021-05-17,23:00:00,16,6,10,FMN GV 16 Berchem TOT
54,Posthofbrug 5366,2021-05-18,00:00:00,5,1,4,FMN GV 16 Berchem TOT
54,Posthofbrug 5366,2021-05-18,01:00:00,4,2,2,FMN GV 16 Berchem TOT
54,Posthofbrug 5366,2021-05-18,02:00:00,1,0,1,FMN GV 16 Berchem TOT
54,Posthofbrug 5366,2021-05-18,03:00:00,2,2,0,FMN GV 16 Berchem TOT
54,Posthofbrug 5366,2021-05-18,04:00:00,10,9,1,FMN GV 16 Berchem TOT
54,Posthofbrug 5366,2021-05-18,05:00:00,18,12,6,FMN GV 16 Berchem TOT
54,Posthofbrug 5366,2021-05-18,06:00:00,88,71,17,FMN GV 16 Berchem TOT
54,Posthofbrug 5366,2021-05-18,07:00:00,274,207,67,FMN GV 16 Berchem TOT
54,Posthofbrug 5366,2021-05-18,08:00:00,381,291,90,FMN GV 16 Berchem TOT
54,Posthofbrug 5366,2021-05-18,09:00:00,156,115,41,FMN GV 16 Berchem TOT
54,Posthofbrug 5366,2021-05-18,10:00:00,67,44,23,FMN GV 16 Berchem TOT
54,Posthofbrug 5366,2021-05-18,11:00:00,70,45,25,FMN GV 16 Berchem TOT
54,Posthofbrug 5366,2021-05-18,12:00:00,115,73,42,FMN GV 16 Berchem TOT
54,Posthofbrug 5366,2021-05-18,13:00:00,127,64,63,FMN GV 16 Berchem TOT
54,Posthofbrug 5366,2021-05-18,14:00:00,136,53,83,FMN GV 16 Berchem TOT
54,Posthofbrug 5366,2021-05-18,15:00:00,222,88,134,FMN GV 16 Berchem TOT
54,Posthofbrug 5366,2021-05-18,16:00:00,336,129,207,FMN GV 16 Berchem TOT
54,Posthofbrug 5366,2021-05-18,17:00:00,347,97,250,FMN GV 16 Berchem TOT
54,Posthofbrug 5366,2021-05-18,18:00:00,223,77,146,FMN GV 16 Berchem TOT
54,Posthofbrug 5366,2021-05-18,19:00:00,178,79,99,FMN GV 16 Berchem TOT
54,Posthofbrug 5366,2021-05-18,20:00:00,133,80,53,FMN GV 16 Berchem TOT
54,Posthofbrug 5366,2021-05-18,21:00:00,75,48,27,FMN GV 16 Berchem TOT
54,Posthofbrug 5366,2021-05-18,22:00:00,80,33,47,FMN GV 16 Berchem TOT
54,Posthofbrug 5366,2021-05-18,23:00:00,34,16,18,FMN GV 16 Berchem TOT
54,Posthofbrug 5366,2021-05-19,00:00:00,19,7,12,FMN GV 16 Berchem TOT
54,Posthofbrug 5366,2021-05-19,01:00:00,5,1,4,FMN GV 16 Berchem TOT
54,Posthofbrug 5366,2021-05-19,02:00:00,1,1,0,FMN GV 16 Berchem TOT
54,Posthofbrug 5366,2021-05-19,03:00:00,1,1,0,FMN GV 16 Berchem TOT
54,Posthofbrug 5366,2021-05-19,04:00:00,12,10,2,FMN GV 16 Berchem TOT
54,Posthofbrug 5366,2021-05-19,05:00:00,21,13,8,FMN GV 16 Berchem TOT
54,Posthofbrug 5366,2021-05-19,06:00:00,90,74,16,FMN GV 16 Berchem TOT
54,Posthofbrug 5366,2021-05-19,07:00:00,266,195,71,FMN GV 16 Berchem TOT
54,Posthofbrug 5366,2021-05-19,08:00:00,331,244,87,FMN GV 16 Berchem TOT
54,Posthofbrug 5366,2021-05-19,09:00:00,139,98,41,FMN GV 16 Berchem TOT
54,Posthofbrug 5366,2021-05-19,10:00:00,104,72,32,FMN GV 16 Berchem TOT
54,Posthofbrug 5366,2021-05-19,11:00:00,91,50,41,FMN GV 16 Berchem TOT
54,Posthofbrug 5366,2021-05-19,12:00:00,207,80,127,FMN GV 16 Berchem TOT
54,Posthofbrug 5366,2021-05-19,13:00:00,136,60,76,FMN GV 16 Berchem TOT
54,Posthofbrug 5366,2021-05-19,14:00:00,116,53,63,FMN GV 16 Berchem TOT
54,Posthofbrug 5366,2021-05-19,15:00:00,137,48,89,FMN GV 16 Berchem TOT
54,Posthofbrug 5366,2021-05-19,16:00:00,205,76,129,FMN GV 16 Berchem TOT
54,Posthofbrug 5366,2021-05-19,17:00:00,259,81,178,FMN GV 16 Berchem TOT
54,Posthofbrug 5366,2021-05-19,18:00:00,201,85,116,FMN GV 16 Berchem TOT
54,Posthofbrug 5366,2021-05-19,19:00:00,113,52,61,FMN GV 16 Berchem TOT
54,Posthofbrug 5366,2021-05-19,20:00:00,90,50,40,FMN GV 16 Berchem TOT
54,Posthofbrug 5366,2021-05-19,21:00:00,55,29,26,FMN GV 16 Berchem TOT
54,Posthofbrug 5366,2021-05-19,22:00:00,56,25,31,FMN GV 16 Berchem TOT
54,Posthofbrug 5366,2021-05-19,23:00:00,19,12,7,FMN GV 16 Berchem TOT
54,Posthofbrug 5366,2021-05-20,00:00:00,11,3,8,FMN GV 16 Berchem TOT
54,Posthofbrug 5366,2021-05-20,01:00:00,5,1,4,FMN GV 16 Berchem TOT
54,Posthofbrug 5366,2021-05-20,02:00:00,4,0,4,FMN GV 16 Berchem TOT
54,Posthofbrug 5366,2021-05-20,03:00:00,2,1,1,FMN GV 16 Berchem TOT
54,Posthofbrug 5366,2021-05-20,04:00:00,16,9,7,FMN GV 16 Berchem TOT
54,Posthofbrug 5366,2021-05-20,05:00:00,20,11,9,FMN GV 16 Berchem TOT
54,Posthofbrug 5366,2021-05-20,06:00:00,97,75,22,FMN GV 16 Berchem TOT
54,Posthofbrug 5366,2021-05-20,07:00:00,285,224,61,FMN GV 16 Berchem TOT
54,Posthofbrug 5366,2021-05-20,08:00:00,409,313,96,FMN GV 16 Berchem TOT
54,Posthofbrug 5366,2021-05-20,09:00:00,254,203,51,FMN GV 16 Berchem TOT
54,Posthofbrug 5366,2021-05-20,10:00:00,130,78,52,FMN GV 16 Berchem TOT
54,Posthofbrug 5366,2021-05-20,11:00:00,144,100,44,FMN GV 16 Berchem TOT
54,Posthofbrug 5366,2021-05-20,12:00:00,175,92,83,FMN GV 16 Berchem TOT
54,Posthofbrug 5366,2021-05-20,13:00:00,175,92,83,FMN GV 16 Berchem TOT
54,Posthofbrug 5366,2021-05-20,14:00:00,192,68,124,FMN GV 16 Berchem TOT
54,Posthofbrug 5366,2021-05-20,15:00:00,270,77,193,FMN GV 16 Berchem TOT
54,Posthofbrug 5366,2021-05-20,16:00:00,323,86,237,FMN GV 16 Berchem TOT
54,Posthofbrug 5366,2021-05-20,17:00:00,338,98,240,FMN GV 16 Berchem TOT
54,Posthofbrug 5366,2021-05-20,18:00:00,254,83,171,FMN GV 16 Berchem TOT
54,Posthofbrug 5366,2021-05-20,19:00:00,140,64,76,FMN GV 16 Berchem TOT
54,Posthofbrug 5366,2021-05-20,20:00:00,127,68,59,FMN GV 16 Berchem TOT
54,Posthofbrug 5366,2021-05-20,21:00:00,84,45,39,FMN GV 16 Berchem TOT
54,Posthofbrug 5366,2021-05-20,22:00:00,87,35,52,FMN GV 16 Berchem TOT
54,Posthofbrug 5366,2021-05-20,23:00:00,24,10,14,FMN GV 16 Berchem TOT
54,Posthofbrug 5366,2021-05-21,00:00:00,12,7,5,FMN GV 16 Berchem TOT
54,Posthofbrug 5366,2021-05-21,01:00:00,7,3,4,FMN GV 16 Berchem TOT
54,Posthofbrug 5366,2021-05-21,02:00:00,4,0,4,FMN GV 16 Berchem TOT
54,Posthofbrug 5366,2021-05-21,03:00:00,2,1,1,FMN GV 16 Berchem TOT
54,Posthofbrug 5366,2021-05-21,04:00:00,13,9,4,FMN GV 16 Berchem TOT
54,Posthofbrug 5366,2021-05-21,05:00:00,15,11,4,FMN GV 16 Berchem TOT
54,Posthofbrug 5366,2021-05-21,06:00:00,77,61,16,FMN GV 16 Berchem TOT
54,Posthofbrug 5366,2021-05-21,07:00:00,213,152,61,FMN GV 16 Berchem TOT
54,Posthofbrug 5366,2021-05-21,08:00:00,359,257,102,FMN GV 16 Berchem TOT
54,Posthofbrug 5366,2021-05-21,09:00:00,114,73,41,FMN GV 16 Berchem TOT
54,Posthofbrug 5366,2021-05-21,10:00:00,80,53,27,FMN GV 16 Berchem TOT
54,Posthofbrug 5366,2021-05-21,11:00:00,98,62,36,FMN GV 16 Berchem TOT
54,Posthofbrug 5366,2021-05-21,12:00:00,131,65,66,FMN GV 16 Berchem TOT
54,Posthofbrug 5366,2021-05-21,13:00:00,111,54,57,FMN GV 16 Berchem TOT
54,Posthofbrug 5366,2021-05-21,14:00:00,97,29,68,FMN GV 16 Berchem TOT
54,Posthofbrug 5366,2021-05-21,15:00:00,191,85,106,FMN GV 16 Berchem TOT
54,Posthofbrug 5366,2021-05-21,16:00:00,219,78,141,FMN GV 16 Berchem TOT
54,Posthofbrug 5366,2021-05-21,17:00:00,233,83,150,FMN GV 16 Berchem TOT
54,Posthofbrug 5366,2021-05-21,18:00:00,202,76,126,FMN GV 16 Berchem TOT
54,Posthofbrug 5366,2021-05-21,19:00:00,114,65,49,FMN GV 16 Berchem TOT
54,Posthofbrug 5366,2021-05-21,20:00:00,98,44,54,FMN GV 16 Berchem TOT
54,Posthofbrug 5366,2021-05-21,21:00:00,75,49,26,FMN GV 16 Berchem TOT
54,Posthofbrug 5366,2021-05-21,22:00:00,69,32,37,FMN GV 16 Berchem TOT
54,Posthofbrug 5366,2021-05-21,23:00:00,39,20,19,FMN GV 16 Berchem TOT
54,Posthofbrug 5366,2021-05-22,00:00:00,35,12,23,FMN GV 16 Berchem TOT
54,Posthofbrug 5366,2021-05-22,01:00:00,31,5,26,FMN GV 16 Berchem TOT
54,Posthofbrug 5366,2021-05-22,02:00:00,18,4,14,FMN GV 16 Berchem TOT
54,Posthofbrug 5366,2021-05-22,03:00:00,5,1,4,FMN GV 16 Berchem TOT
54,Posthofbrug 5366,2021-05-22,04:00:00,3,1,2,FMN GV 16 Berchem TOT
54,Posthofbrug 5366,2021-05-22,05:00:00,10,6,4,FMN GV 16 Berchem TOT
54,Posthofbrug 5366,2021-05-22,06:00:00,8,5,3,FMN GV 16 Berchem TOT
54,Posthofbrug 5366,2021-05-22,07:00:00,25,14,11,FMN GV 16 Berchem TOT
54,Posthofbrug 5366,2021-05-22,08:00:00,33,18,15,FMN GV 16 Berchem TOT
54,Posthofbrug 5366,2021-05-22,09:00:00,52,32,20,FMN GV 16 Berchem TOT
54,Posthofbrug 5366,2021-05-22,10:00:00,43,24,19,FMN GV 16 Berchem TOT
54,Posthofbrug 5366,2021-05-22,11:00:00,59,35,24,FMN GV 16 Berchem TOT
54,Posthofbrug 5366,2021-05-22,12:00:00,43,17,26,FMN GV 16 Berchem TOT
54,Posthofbrug 5366,2021-05-22,13:00:00,45,26,19,FMN GV 16 Berchem TOT
54,Posthofbrug 5366,2021-05-22,14:00:00,71,37,34,FMN GV 16 Berchem TOT
54,Posthofbrug 5366,2021-05-22,15:00:00,80,42,38,FMN GV 16 Berchem TOT
54,Posthofbrug 5366,2021-05-22,16:00:00,71,38,33,FMN GV 16 Berchem TOT
54,Posthofbrug 5366,2021-05-22,17:00:00,59,22,37,FMN GV 16 Berchem TOT
54,Posthofbrug 5366,2021-05-22,18:00:00,50,24,26,FMN GV 16 Berchem TOT
54,Posthofbrug 5366,2021-05-22,19:00:00,38,22,16,FMN GV 16 Berchem TOT
54,Posthofbrug 5366,2021-05-22,20:00:00,26,13,13,FMN GV 16 Berchem TOT
54,Posthofbrug 5366,2021-05-22,21:00:00,22,12,10,FMN GV 16 Berchem TOT
54,Posthofbrug 5366,2021-05-22,22:00:00,23,14,9,FMN GV 16 Berchem TOT
54,Posthofbrug 5366,2021-05-22,23:00:00,24,16,8,FMN GV 16 Berchem TOT
54,Posthofbrug 5366,2021-05-23,00:00:00,8,3,5,FMN GV 16 Berchem TOT
54,Posthofbrug 5366,2021-05-23,01:00:00,19,10,9,FMN GV 16 Berchem TOT
54,Posthofbrug 5366,2021-05-23,02:00:00,12,5,7,FMN GV 16 Berchem TOT
54,Posthofbrug 5366,2021-05-23,03:00:00,3,0,3,FMN GV 16 Berchem TOT
54,Posthofbrug 5366,2021-05-23,04:00:00,1,1,0,FMN GV 16 Berchem TOT
54,Posthofbrug 5366,2021-05-23,05:00:00,6,5,1,FMN GV 16 Berchem TOT
54,Posthofbrug 5366,2021-05-23,06:00:00,11,10,1,FMN GV 16 Berchem TOT
54,Posthofbrug 5366,2021-05-23,07:00:00,28,14,14,FMN GV 16 Berchem TOT
54,Posthofbrug 5366,2021-05-23,08:00:00,47,20,27,FMN GV 16 Berchem TOT
54,Posthofbrug 5366,2021-05-23,09:00:00,115,56,59,FMN GV 16 Berchem TOT
54,Posthofbrug 5366,2021-05-23,10:00:00,138,82,56,FMN GV 16 Berchem TOT
54,Posthofbrug 5366,2021-05-23,11:00:00,150,76,74,FMN GV 16 Berchem TOT
54,Posthofbrug 5366,2021-05-23,12:00:00,163,91,72,FMN GV 16 Berchem TOT
54,Posthofbrug 5366,2021-05-23,13:00:00,163,90,73,FMN GV 16 Berchem TOT
54,Posthofbrug 5366,2021-05-23,14:00:00,222,116,106,FMN GV 16 Berchem TOT
54,Posthofbrug 5366,2021-05-23,15:00:00,155,79,76,FMN GV 16 Berchem TOT
54,Posthofbrug 5366,2021-05-23,16:00:00,152,79,73,FMN GV 16 Berchem TOT
54,Posthofbrug 5366,2021-05-23,17:00:00,153,76,77,FMN GV 16 Berchem TOT
54,Posthofbrug 5366,2021-05-23,18:00:00,145,72,73,FMN GV 16 Berchem TOT
54,Posthofbrug 5366,2021-05-23,19:00:00,95,45,50,FMN GV 16 Berchem TOT
54,Posthofbrug 5366,2021-05-23,20:00:00,78,39,39,FMN GV 16 Berchem TOT
54,Posthofbrug 5366,2021-05-23,21:00:00,59,30,29,FMN GV 16 Berchem TOT
54,Posthofbrug 5366,2021-05-23,22:00:00,66,27,39,FMN GV 16 Berchem TOT
54,Posthofbrug 5366,2021-05-23,23:00:00,24,13,11,FMN GV 16 Berchem TOT
54,Posthofbrug 5366,2021-05-24,00:00:00,35,12,23,FMN GV 16 Berchem TOT
54,Posthofbrug 5366,2021-05-24,01:00:00,16,9,7,FMN GV 16 Berchem TOT
54,Posthofbrug 5366,2021-05-24,02:00:00,13,4,9,FMN GV 16 Berchem TOT
54,Posthofbrug 5366,2021-05-24,03:00:00,7,3,4,FMN GV 16 Berchem TOT
54,Posthofbrug 5366,2021-05-24,04:00:00,5,2,3,FMN GV 16 Berchem TOT
54,Posthofbrug 5366,2021-05-24,05:00:00,7,5,2,FMN GV 16 Berchem TOT
54,Posthofbrug 5366,2021-05-24,06:00:00,12,10,2,FMN GV 16 Berchem TOT
54,Posthofbrug 5366,2021-05-24,07:00:00,14,8,6,FMN GV 16 Berchem TOT
54,Posthofbrug 5366,2021-05-24,08:00:00,19,10,9,FMN GV 16 Berchem TOT
54,Posthofbrug 5366,2021-05-24,09:00:00,39,22,17,FMN GV 16 Berchem TOT
54,Posthofbrug 5366,2021-05-24,10:00:00,29,18,11,FMN GV 16 Berchem TOT
54,Posthofbrug 5366,2021-05-24,11:00:00,27,18,9,FMN GV 16 Berchem TOT
54,Posthofbrug 5366,2021-05-24,12:00:00,32,10,22,FMN GV 16 Berchem TOT
54,Posthofbrug 5366,2021-05-24,13:00:00,64,38,26,FMN GV 16 Berchem TOT
54,Posthofbrug 5366,2021-05-24,14:00:00,98,53,45,FMN GV 16 Berchem TOT
54,Posthofbrug 5366,2021-05-24,15:00:00,101,45,56,FMN GV 16 Berchem TOT
54,Posthofbrug 5366,2021-05-24,16:00:00,110,49,61,FMN GV 16 Berchem TOT
54,Posthofbrug 5366,2021-05-24,17:00:00,91,44,47,FMN GV 16 Berchem TOT
54,Posthofbrug 5366,2021-05-24,18:00:00,65,23,42,FMN GV 16 Berchem TOT
54,Posthofbrug 5366,2021-05-24,19:00:00,50,25,25,FMN GV 16 Berchem TOT
54,Posthofbrug 5366,2021-05-24,20:00:00,51,28,23,FMN GV 16 Berchem TOT
54,Posthofbrug 5366,2021-05-24,21:00:00,53,27,26,FMN GV 16 Berchem TOT
54,Posthofbrug 5366,2021-05-24,22:00:00,25,14,11,FMN GV 16 Berchem TOT
54,Posthofbrug 5366,2021-05-24,23:00:00,7,2,5,FMN GV 16 Berchem TOT
54,Posthofbrug 5366,2021-05-25,00:00:00,9,4,5,FMN GV 16 Berchem TOT
54,Posthofbrug 5366,2021-05-25,01:00:00,8,2,6,FMN GV 16 Berchem TOT
54,Posthofbrug 5366,2021-05-25,02:00:00,1,0,1,FMN GV 16 Berchem TOT
54,Posthofbrug 5366,2021-05-25,03:00:00,1,1,0,FMN GV 16 Berchem TOT
54,Posthofbrug 5366,2021-05-25,04:00:00,5,3,2,FMN GV 16 Berchem TOT
54,Posthofbrug 5366,2021-05-25,05:00:00,17,12,5,FMN GV 16 Berchem TOT
54,Posthofbrug 5366,2021-05-25,06:00:00,65,54,11,FMN GV 16 Berchem TOT
54,Posthofbrug 5366,2021-05-25,07:00:00,205,149,56,FMN GV 16 Berchem TOT
54,Posthofbrug 5366,2021-05-25,08:00:00,288,207,81,FMN GV 16 Berchem TOT
54,Posthofbrug 5366,2021-05-25,09:00:00,105,81,24,FMN GV 16 Berchem TOT
54,Posthofbrug 5366,2021-05-25,10:00:00,77,48,29,FMN GV 16 Berchem TOT
54,Posthofbrug 5366,2021-05-25,11:00:00,53,28,25,FMN GV 16 Berchem TOT
54,Posthofbrug 5366,2021-05-25,12:00:00,78,33,45,FMN GV 16 Berchem TOT
54,Posthofbrug 5366,2021-05-25,13:00:00,75,41,34,FMN GV 16 Berchem TOT
54,Posthofbrug 5366,2021-05-25,14:00:00,63,23,40,FMN GV 16 Berchem TOT
54,Posthofbrug 5366,2021-05-25,15:00:00,134,38,96,FMN GV 16 Berchem TOT
54,Posthofbrug 5366,2021-05-25,16:00:00,217,82,135,FMN GV 16 Berchem TOT
54,Posthofbrug 5366,2021-05-25,17:00:00,224,64,160,FMN GV 16 Berchem TOT
54,Posthofbrug 5366,2021-05-25,18:00:00,144,42,102,FMN GV 16 Berchem TOT
54,Posthofbrug 5366,2021-05-25,19:00:00,98,36,62,FMN GV 16 Berchem TOT
54,Posthofbrug 5366,2021-05-25,20:00:00,50,26,24,FMN GV 16 Berchem TOT
54,Posthofbrug 5366,2021-05-25,21:00:00,49,32,17,FMN GV 16 Berchem TOT
54,Posthofbrug 5366,2021-05-25,22:00:00,46,25,21,FMN GV 16 Berchem TOT
54,Posthofbrug 5366,2021-05-25,23:00:00,26,15,11,FMN GV 16 Berchem TOT
54,Posthofbrug 5366,2021-05-26,00:00:00,6,2,4,FMN GV 16 Berchem TOT
54,Posthofbrug 5366,2021-05-26,01:00:00,3,2,1,FMN GV 16 Berchem TOT
54,Posthofbrug 5366,2021-05-26,02:00:00,2,0,2,FMN GV 16 Berchem TOT
54,Posthofbrug 5366,2021-05-26,03:00:00,1,1,0,FMN GV 16 Berchem TOT
54,Posthofbrug 5366,2021-05-26,04:00:00,6,5,1,FMN GV 16 Berchem TOT
54,Posthofbrug 5366,2021-05-26,05:00:00,13,11,2,FMN GV 16 Berchem TOT
54,Posthofbrug 5366,2021-05-26,06:00:00,87,75,12,FMN GV 16 Berchem TOT
54,Posthofbrug 5366,2021-05-26,07:00:00,279,202,77,FMN GV 16 Berchem TOT
54,Posthofbrug 5366,2021-05-26,08:00:00,349,257,92,FMN GV 16 Berchem TOT
54,Posthofbrug 5366,2021-05-26,09:00:00,159,113,46,FMN GV 16 Berchem TOT
54,Posthofbrug 5366,2021-05-26,10:00:00,83,59,24,FMN GV 16 Berchem TOT
54,Posthofbrug 5366,2021-05-26,11:00:00,128,53,75,FMN GV 16 Berchem TOT
54,Posthofbrug 5366,2021-05-26,12:00:00,224,94,130,FMN GV 16 Berchem TOT
54,Posthofbrug 5366,2021-05-26,13:00:00,160,67,93,FMN GV 16 Berchem TOT
54,Posthofbrug 5366,2021-05-26,14:00:00,131,79,52,FMN GV 16 Berchem TOT
54,Posthofbrug 5366,2021-05-26,15:00:00,149,53,96,FMN GV 16 Berchem TOT
54,Posthofbrug 5366,2021-05-26,16:00:00,228,83,145,FMN GV 16 Berchem TOT
54,Posthofbrug 5366,2021-05-26,17:00:00,264,99,165,FMN GV 16 Berchem TOT
54,Posthofbrug 5366,2021-05-26,18:00:00,261,90,171,FMN GV 16 Berchem TOT
54,Posthofbrug 5366,2021-05-26,19:00:00,146,69,77,FMN GV 16 Berchem TOT
54,Posthofbrug 5366,2021-05-26,20:00:00,80,47,33,FMN GV 16 Berchem TOT
54,Posthofbrug 5366,2021-05-26,21:00:00,45,26,19,FMN GV 16 Berchem TOT
54,Posthofbrug 5366,2021-05-26,22:00:00,68,31,37,FMN GV 16 Berchem TOT
54,Posthofbrug 5366,2021-05-26,23:00:00,32,12,20,FMN GV 16 Berchem TOT
54,Posthofbrug 5366,2021-05-27,00:00:00,14,8,6,FMN GV 16 Berchem TOT
54,Posthofbrug 5366,2021-05-27,01:00:00,6,4,2,FMN GV 16 Berchem TOT
54,Posthofbrug 5366,2021-05-27,02:00:00,6,1,5,FMN GV 16 Berchem TOT
54,Posthofbrug 5366,2021-05-27,03:00:00,3,1,2,FMN GV 16 Berchem TOT
54,Posthofbrug 5366,2021-05-27,04:00:00,6,3,3,FMN GV 16 Berchem TOT
54,Posthofbrug 5366,2021-05-27,05:00:00,25,20,5,FMN GV 16 Berchem TOT
54,Posthofbrug 5366,2021-05-27,06:00:00,86,70,16,FMN GV 16 Berchem TOT
54,Posthofbrug 5366,2021-05-27,07:00:00,282,210,72,FMN GV 16 Berchem TOT
54,Posthofbrug 5366,2021-05-27,08:00:00,413,323,90,FMN GV 16 Berchem TOT
54,Posthofbrug 5366,2021-05-27,09:00:00,175,132,43,FMN GV 16 Berchem TOT
54,Posthofbrug 5366,2021-05-27,10:00:00,81,59,22,FMN GV 16 Berchem TOT
54,Posthofbrug 5366,2021-05-27,11:00:00,112,66,46,FMN GV 16 Berchem TOT
54,Posthofbrug 5366,2021-05-27,12:00:00,133,69,64,FMN GV 16 Berchem TOT
54,Posthofbrug 5366,2021-05-27,13:00:00,114,66,48,FMN GV 16 Berchem TOT
54,Posthofbrug 5366,2021-05-27,14:00:00,136,52,84,FMN GV 16 Berchem TOT
54,Posthofbrug 5366,2021-05-27,15:00:00,199,56,143,FMN GV 16 Berchem TOT
54,Posthofbrug 5366,2021-05-27,16:00:00,340,104,236,FMN GV 16 Berchem TOT
54,Posthofbrug 5366,2021-05-27,17:00:00,314,91,223,FMN GV 16 Berchem TOT
54,Posthofbrug 5366,2021-05-27,18:00:00,262,91,171,FMN GV 16 Berchem TOT
54,Posthofbrug 5366,2021-05-27,19:00:00,156,75,81,FMN GV 16 Berchem TOT
54,Posthofbrug 5366,2021-05-27,20:00:00,117,67,50,FMN GV 16 Berchem TOT
54,Posthofbrug 5366,2021-05-27,21:00:00,61,40,21,FMN GV 16 Berchem TOT
54,Posthofbrug 5366,2021-05-27,22:00:00,86,41,45,FMN GV 16 Berchem TOT
54,Posthofbrug 5366,2021-05-27,23:00:00,30,13,17,FMN GV 16 Berchem TOT
54,Posthofbrug 5366,2021-05-28,00:00:00,14,8,6,FMN GV 16 Berchem TOT
54,Posthofbrug 5366,2021-05-28,01:00:00,6,2,4,FMN GV 16 Berchem TOT
54,Posthofbrug 5366,2021-05-28,02:00:00,0,0,0,FMN GV 16 Berchem TOT
54,Posthofbrug 5366,2021-05-28,03:00:00,2,1,1,FMN GV 16 Berchem TOT
54,Posthofbrug 5366,2021-05-28,04:00:00,7,4,3,FMN GV 16 Berchem TOT
54,Posthofbrug 5366,2021-05-28,05:00:00,23,20,3,FMN GV 16 Berchem TOT
54,Posthofbrug 5366,2021-05-28,06:00:00,75,58,17,FMN GV 16 Berchem TOT
54,Posthofbrug 5366,2021-05-28,07:00:00,267,196,71,FMN GV 16 Berchem TOT
54,Posthofbrug 5366,2021-05-28,08:00:00,397,297,100,FMN GV 16 Berchem TOT
54,Posthofbrug 5366,2021-05-28,09:00:00,174,133,41,FMN GV 16 Berchem TOT
54,Posthofbrug 5366,2021-05-28,10:00:00,94,53,41,FMN GV 16 Berchem TOT
54,Posthofbrug 5366,2021-05-28,11:00:00,174,126,48,FMN GV 16 Berchem TOT
54,Posthofbrug 5366,2021-05-28,12:00:00,169,82,87,FMN GV 16 Berchem TOT
54,Posthofbrug 5366,2021-05-28,13:00:00,154,73,81,FMN GV 16 Berchem TOT
54,Posthofbrug 5366,2021-05-28,14:00:00,189,65,124,FMN GV 16 Berchem TOT
54,Posthofbrug 5366,2021-05-28,15:00:00,247,97,150,FMN GV 16 Berchem TOT
54,Posthofbrug 5366,2021-05-28,16:00:00,324,116,208,FMN GV 16 Berchem TOT
54,Posthofbrug 5366,2021-05-28,17:00:00,332,115,217,FMN GV 16 Berchem TOT
54,Posthofbrug 5366,2021-05-28,18:00:00,300,115,185,FMN GV 16 Berchem TOT
54,Posthofbrug 5366,2021-05-28,19:00:00,168,83,85,FMN GV 16 Berchem TOT
54,Posthofbrug 5366,2021-05-28,20:00:00,126,67,59,FMN GV 16 Berchem TOT
54,Posthofbrug 5366,2021-05-28,21:00:00,81,44,37,FMN GV 16 Berchem TOT
54,Posthofbrug 5366,2021-05-28,22:00:00,118,44,74,FMN GV 16 Berchem TOT
54,Posthofbrug 5366,2021-05-28,23:00:00,67,33,34,FMN GV 16 Berchem TOT
54,Posthofbrug 5366,2021-05-29,00:00:00,58,33,25,FMN GV 16 Berchem TOT
54,Posthofbrug 5366,2021-05-29,01:00:00,30,9,21,FMN GV 16 Berchem TOT
54,Posthofbrug 5366,2021-05-29,02:00:00,13,5,8,FMN GV 16 Berchem TOT
54,Posthofbrug 5366,2021-05-29,03:00:00,5,1,4,FMN GV 16 Berchem TOT
54,Posthofbrug 5366,2021-05-29,04:00:00,7,5,2,FMN GV 16 Berchem TOT
54,Posthofbrug 5366,2021-05-29,05:00:00,9,4,5,FMN GV 16 Berchem TOT
54,Posthofbrug 5366,2021-05-29,06:00:00,16,13,3,FMN GV 16 Berchem TOT
54,Posthofbrug 5366,2021-05-29,07:00:00,45,23,22,FMN GV 16 Berchem TOT
54,Posthofbrug 5366,2021-05-29,08:00:00,64,32,32,FMN GV 16 Berchem TOT
54,Posthofbrug 5366,2021-05-29,09:00:00,132,86,46,FMN GV 16 Berchem TOT
54,Posthofbrug 5366,2021-05-29,10:00:00,165,112,53,FMN GV 16 Berchem TOT
54,Posthofbrug 5366,2021-05-29,11:00:00,185,92,93,FMN GV 16 Berchem TOT
54,Posthofbrug 5366,2021-05-29,12:00:00,218,138,80,FMN GV 16 Berchem TOT
54,Posthofbrug 5366,2021-05-29,13:00:00,259,148,111,FMN GV 16 Berchem TOT
54,Posthofbrug 5366,2021-05-29,14:00:00,234,119,115,FMN GV 16 Berchem TOT
54,Posthofbrug 5366,2021-05-29,15:00:00,207,97,110,FMN GV 16 Berchem TOT
54,Posthofbrug 5366,2021-05-29,16:00:00,239,125,114,FMN GV 16 Berchem TOT
54,Posthofbrug 5366,2021-05-29,17:00:00,206,99,107,FMN GV 16 Berchem TOT
54,Posthofbrug 5366,2021-05-29,18:00:00,188,89,99,FMN GV 16 Berchem TOT
54,Posthofbrug 5366,2021-05-29,19:00:00,129,61,68,FMN GV 16 Berchem TOT
54,Posthofbrug 5366,2021-05-29,20:00:00,129,68,61,FMN GV 16 Berchem TOT
54,Posthofbrug 5366,2021-05-29,21:00:00,78,39,39,FMN GV 16 Berchem TOT
54,Posthofbrug 5366,2021-05-29,22:00:00,98,50,48,FMN GV 16 Berchem TOT
54,Posthofbrug 5366,2021-05-29,23:00:00,90,46,44,FMN GV 16 Berchem TOT
54,Posthofbrug 5366,2021-05-30,00:00:00,38,17,21,FMN GV 16 Berchem TOT
54,Posthofbrug 5366,2021-05-30,01:00:00,24,12,12,FMN GV 16 Berchem TOT
54,Posthofbrug 5366,2021-05-30,02:00:00,20,5,15,FMN GV 16 Berchem TOT
54,Posthofbrug 5366,2021-05-30,03:00:00,7,1,6,FMN GV 16 Berchem TOT
54,Posthofbrug 5366,2021-05-30,04:00:00,4,0,4,FMN GV 16 Berchem TOT
54,Posthofbrug 5366,2021-05-30,05:00:00,17,9,8,FMN GV 16 Berchem TOT
54,Posthofbrug 5366,2021-05-30,06:00:00,17,11,6,FMN GV 16 Berchem TOT
54,Posthofbrug 5366,2021-05-30,07:00:00,28,12,16,FMN GV 16 Berchem TOT
54,Posthofbrug 5366,2021-05-30,08:00:00,63,29,34,FMN GV 16 Berchem TOT
54,Posthofbrug 5366,2021-05-30,09:00:00,123,78,45,FMN GV 16 Berchem TOT
54,Posthofbrug 5366,2021-05-30,10:00:00,190,119,71,FMN GV 16 Berchem TOT
54,Posthofbrug 5366,2021-05-30,11:00:00,213,108,105,FMN GV 16 Berchem TOT
54,Posthofbrug 5366,2021-05-30,12:00:00,247,124,123,FMN GV 16 Berchem TOT
54,Posthofbrug 5366,2021-05-30,13:00:00,298,155,143,FMN GV 16 Berchem TOT
54,Posthofbrug 5366,2021-05-30,14:00:00,280,143,137,FMN GV 16 Berchem TOT
54,Posthofbrug 5366,2021-05-30,15:00:00,265,122,143,FMN GV 16 Berchem TOT
54,Posthofbrug 5366,2021-05-30,16:00:00,288,134,154,FMN GV 16 Berchem TOT
54,Posthofbrug 5366,2021-05-30,17:00:00,255,129,126,FMN GV 16 Berchem TOT
54,Posthofbrug 5366,2021-05-30,18:00:00,226,95,131,FMN GV 16 Berchem TOT
54,Posthofbrug 5366,2021-05-30,19:00:00,130,66,64,FMN GV 16 Berchem TOT
54,Posthofbrug 5366,2021-05-30,20:00:00,106,63,43,FMN GV 16 Berchem TOT
54,Posthofbrug 5366,2021-05-30,21:00:00,117,57,60,FMN GV 16 Berchem TOT
54,Posthofbrug 5366,2021-05-30,22:00:00,77,42,35,FMN GV 16 Berchem TOT
54,Posthofbrug 5366,2021-05-30,23:00:00,26,13,13,FMN GV 16 Berchem TOT
54,Posthofbrug 5366,2021-05-31,00:00:00,18,10,8,FMN GV 16 Berchem TOT
54,Posthofbrug 5366,2021-05-31,01:00:00,7,3,4,FMN GV 16 Berchem TOT
54,Posthofbrug 5366,2021-05-31,02:00:00,1,1,0,FMN GV 16 Berchem TOT
54,Posthofbrug 5366,2021-05-31,03:00:00,2,2,0,FMN GV 16 Berchem TOT
54,Posthofbrug 5366,2021-05-31,04:00:00,9,8,1,FMN GV 16 Berchem TOT
54,Posthofbrug 5366,2021-05-31,05:00:00,29,23,6,FMN GV 16 Berchem TOT
54,Posthofbrug 5366,2021-05-31,06:00:00,96,83,13,FMN GV 16 Berchem TOT
54,Posthofbrug 5366,2021-05-31,07:00:00,322,239,83,FMN GV 16 Berchem TOT
54,Posthofbrug 5366,2021-05-31,08:00:00,463,330,133,FMN GV 16 Berchem TOT
54,Posthofbrug 5366,2021-05-31,09:00:00,199,145,54,FMN GV 16 Berchem TOT
54,Posthofbrug 5366,2021-05-31,10:00:00,142,88,54,FMN GV 16 Berchem TOT
54,Posthofbrug 5366,2021-05-31,11:00:00,120,70,50,FMN GV 16 Berchem TOT
54,Posthofbrug 5366,2021-05-31,12:00:00,193,93,100,FMN GV 16 Berchem TOT
54,Posthofbrug 5366,2021-05-31,13:00:00,131,75,56,FMN GV 16 Berchem TOT
54,Posthofbrug 5366,2021-05-31,14:00:00,138,62,76,FMN GV 16 Berchem TOT
54,Posthofbrug 5366,2021-05-31,15:00:00,278,97,181,FMN GV 16 Berchem TOT
54,Posthofbrug 5366,2021-05-31,16:00:00,421,124,297,FMN GV 16 Berchem TOT
54,Posthofbrug 5366,2021-05-31,17:00:00,397,118,279,FMN GV 16 Berchem TOT
54,Posthofbrug 5366,2021-05-31,18:00:00,264,93,171,FMN GV 16 Berchem TOT
54,Posthofbrug 5366,2021-05-31,19:00:00,162,62,100,FMN GV 16 Berchem TOT
54,Posthofbrug 5366,2021-05-31,20:00:00,141,78,63,FMN GV 16 Berchem TOT
54,Posthofbrug 5366,2021-05-31,21:00:00,90,53,37,FMN GV 16 Berchem TOT
54,Posthofbrug 5366,2021-05-31,22:00:00,78,36,42,FMN GV 16 Berchem TOT
54,Posthofbrug 5366,2021-05-31,23:00:00,23,14,9,FMN GV 16 Berchem TOT
54,Posthofbrug 5366,2021-06-01,00:00:00,18,8,10,FMN GV 16 Berchem TOT
54,Posthofbrug 5366,2021-06-01,01:00:00,3,0,3,FMN GV 16 Berchem TOT
54,Posthofbrug 5366,2021-06-01,02:00:00,4,2,2,FMN GV 16 Berchem TOT
54,Posthofbrug 5366,2021-06-01,03:00:00,3,1,2,FMN GV 16 Berchem TOT
54,Posthofbrug 5366,2021-06-01,04:00:00,14,13,1,FMN GV 16 Berchem TOT
54,Posthofbrug 5366,2021-06-01,05:00:00,29,21,8,FMN GV 16 Berchem TOT
54,Posthofbrug 5366,2021-06-01,06:00:00,129,99,30,FMN GV 16 Berchem TOT
54,Posthofbrug 5366,2021-06-01,07:00:00,346,256,90,FMN GV 16 Berchem TOT
54,Posthofbrug 5366,2021-06-01,08:00:00,476,363,113,FMN GV 16 Berchem TOT
54,Posthofbrug 5366,2021-06-01,09:00:00,191,144,47,FMN GV 16 Berchem TOT
54,Posthofbrug 5366,2021-06-01,10:00:00,145,92,53,FMN GV 16 Berchem TOT
54,Posthofbrug 5366,2021-06-01,11:00:00,128,72,56,FMN GV 16 Berchem TOT
54,Posthofbrug 5366,2021-06-01,12:00:00,177,92,85,FMN GV 16 Berchem TOT
54,Posthofbrug 5366,2021-06-01,13:00:00,179,91,88,FMN GV 16 Berchem TOT
54,Posthofbrug 5366,2021-06-01,14:00:00,181,76,105,FMN GV 16 Berchem TOT
54,Posthofbrug 5366,2021-06-01,15:00:00,274,89,185,FMN GV 16 Berchem TOT
54,Posthofbrug 5366,2021-06-01,16:00:00,418,131,287,FMN GV 16 Berchem TOT
54,Posthofbrug 5366,2021-06-01,17:00:00,463,151,312,FMN GV 16 Berchem TOT
54,Posthofbrug 5366,2021-06-01,18:00:00,355,122,233,FMN GV 16 Berchem TOT
54,Posthofbrug 5366,2021-06-01,19:00:00,196,81,115,FMN GV 16 Berchem TOT
54,Posthofbrug 5366,2021-06-01,20:00:00,139,87,52,FMN GV 16 Berchem TOT
54,Posthofbrug 5366,2021-06-01,21:00:00,105,66,39,FMN GV 16 Berchem TOT
54,Posthofbrug 5366,2021-06-01,22:00:00,125,54,71,FMN GV 16 Berchem TOT
54,Posthofbrug 5366,2021-06-01,23:00:00,47,23,24,FMN GV 16 Berchem TOT
54,Posthofbrug 5366,2021-06-02,00:00:00,17,5,12,FMN GV 16 Berchem TOT
54,Posthofbrug 5366,2021-06-02,01:00:00,6,1,5,FMN GV 16 Berchem TOT
54,Posthofbrug 5366,2021-06-02,02:00:00,6,0,6,FMN GV 16 Berchem TOT
54,Posthofbrug 5366,2021-06-02,03:00:00,2,1,1,FMN GV 16 Berchem TOT
54,Posthofbrug 5366,2021-06-02,04:00:00,16,12,4,FMN GV 16 Berchem TOT
54,Posthofbrug 5366,2021-06-02,05:00:00,35,25,10,FMN GV 16 Berchem TOT
54,Posthofbrug 5366,2021-06-02,06:00:00,107,85,22,FMN GV 16 Berchem TOT
54,Posthofbrug 5366,2021-06-02,07:00:00,302,224,78,FMN GV 16 Berchem TOT
54,Posthofbrug 5366,2021-06-02,08:00:00,438,312,126,FMN GV 16 Berchem TOT
54,Posthofbrug 5366,2021-06-02,09:00:00,193,139,54,FMN GV 16 Berchem TOT
54,Posthofbrug 5366,2021-06-02,10:00:00,124,76,48,FMN GV 16 Berchem TOT
54,Posthofbrug 5366,2021-06-02,11:00:00,147,78,69,FMN GV 16 Berchem TOT
54,Posthofbrug 5366,2021-06-02,12:00:00,276,115,161,FMN GV 16 Berchem TOT
54,Posthofbrug 5366,2021-06-02,13:00:00,205,94,111,FMN GV 16 Berchem TOT
54,Posthofbrug 5366,2021-06-02,14:00:00,177,71,106,FMN GV 16 Berchem TOT
54,Posthofbrug 5366,2021-06-02,15:00:00,200,76,124,FMN GV 16 Berchem TOT
54,Posthofbrug 5366,2021-06-02,16:00:00,329,127,202,FMN GV 16 Berchem TOT
54,Posthofbrug 5366,2021-06-02,17:00:00,379,125,254,FMN GV 16 Berchem TOT
54,Posthofbrug 5366,2021-06-02,18:00:00,328,121,207,FMN GV 16 Berchem TOT
54,Posthofbrug 5366,2021-06-02,19:00:00,222,105,117,FMN GV 16 Berchem TOT
54,Posthofbrug 5366,2021-06-02,20:00:00,136,64,72,FMN GV 16 Berchem TOT
54,Posthofbrug 5366,2021-06-02,21:00:00,109,53,56,FMN GV 16 Berchem TOT
54,Posthofbrug 5366,2021-06-02,22:00:00,153,59,94,FMN GV 16 Berchem TOT
54,Posthofbrug 5366,2021-06-02,23:00:00,37,13,24,FMN GV 16 Berchem TOT
54,Posthofbrug 5366,2021-06-03,00:00:00,18,6,12,FMN GV 16 Berchem TOT
54,Posthofbrug 5366,2021-06-03,01:00:00,11,6,5,FMN GV 16 Berchem TOT
54,Posthofbrug 5366,2021-06-03,02:00:00,0,0,0,FMN GV 16 Berchem TOT
54,Posthofbrug 5366,2021-06-03,03:00:00,8,4,4,FMN GV 16 Berchem TOT
54,Posthofbrug 5366,2021-06-03,04:00:00,9,6,3,FMN GV 16 Berchem TOT
54,Posthofbrug 5366,2021-06-03,05:00:00,20,16,4,FMN GV 16 Berchem TOT
54,Posthofbrug 5366,2021-06-03,06:00:00,101,76,25,FMN GV 16 Berchem TOT
54,Posthofbrug 5366,2021-06-03,07:00:00,292,215,77,FMN GV 16 Berchem TOT
54,Posthofbrug 5366,2021-06-03,08:00:00,444,327,117,FMN GV 16 Berchem TOT
54,Posthofbrug 5366,2021-06-03,09:00:00,192,142,50,FMN GV 16 Berchem TOT
54,Posthofbrug 5366,2021-06-03,10:00:00,99,71,28,FMN GV 16 Berchem TOT
54,Posthofbrug 5366,2021-06-03,11:00:00,97,50,47,FMN GV 16 Berchem TOT
54,Posthofbrug 5366,2021-06-03,12:00:00,151,73,78,FMN GV 16 Berchem TOT
54,Posthofbrug 5366,2021-06-03,13:00:00,139,73,66,FMN GV 16 Berchem TOT
54,Posthofbrug 5366,2021-06-03,14:00:00,120,44,76,FMN GV 16 Berchem TOT
54,Posthofbrug 5366,2021-06-03,15:00:00,218,79,139,FMN GV 16 Berchem TOT
54,Posthofbrug 5366,2021-06-03,16:00:00,311,103,208,FMN GV 16 Berchem TOT
54,Posthofbrug 5366,2021-06-03,17:00:00,357,123,234,FMN GV 16 Berchem TOT
54,Posthofbrug 5366,2021-06-03,18:00:00,253,83,170,FMN GV 16 Berchem TOT
54,Posthofbrug 5366,2021-06-03,19:00:00,187,83,104,FMN GV 16 Berchem TOT
54,Posthofbrug 5366,2021-06-03,20:00:00,126,68,58,FMN GV 16 Berchem TOT
54,Posthofbrug 5366,2021-06-03,21:00:00,111,63,48,FMN GV 16 Berchem TOT
54,Posthofbrug 5366,2021-06-03,22:00:00,91,38,53,FMN GV 16 Berchem TOT
54,Posthofbrug 5366,2021-06-03,23:00:00,42,24,18,FMN GV 16 Berchem TOT
54,Posthofbrug 5366,2021-06-04,00:00:00,10,3,7,FMN GV 16 Berchem TOT
54,Posthofbrug 5366,2021-06-04,01:00:00,9,0,9,FMN GV 16 Berchem TOT
54,Posthofbrug 5366,2021-06-04,02:00:00,4,0,4,FMN GV 16 Berchem TOT
54,Posthofbrug 5366,2021-06-04,03:00:00,3,3,0,FMN GV 16 Berchem TOT
54,Posthofbrug 5366,2021-06-04,04:00:00,11,9,2,FMN GV 16 Berchem TOT
54,Posthofbrug 5366,2021-06-04,05:00:00,20,17,3,FMN GV 16 Berchem TOT
54,Posthofbrug 5366,2021-06-04,06:00:00,88,66,22,FMN GV 16 Berchem TOT
54,Posthofbrug 5366,2021-06-04,07:00:00,251,169,82,FMN GV 16 Berchem TOT
54,Posthofbrug 5366,2021-06-04,08:00:00,419,304,115,FMN GV 16 Berchem TOT
54,Posthofbrug 5366,2021-06-04,09:00:00,179,119,60,FMN GV 16 Berchem TOT
54,Posthofbrug 5366,2021-06-04,10:00:00,125,90,35,FMN GV 16 Berchem TOT
54,Posthofbrug 5366,2021-06-04,11:00:00,129,65,64,FMN GV 16 Berchem TOT
54,Posthofbrug 5366,2021-06-04,12:00:00,157,86,71,FMN GV 16 Berchem TOT
54,Posthofbrug 5366,2021-06-04,13:00:00,174,76,98,FMN GV 16 Berchem TOT
54,Posthofbrug 5366,2021-06-04,14:00:00,178,70,108,FMN GV 16 Berchem TOT
54,Posthofbrug 5366,2021-06-04,15:00:00,222,81,141,FMN GV 16 Berchem TOT
54,Posthofbrug 5366,2021-06-04,16:00:00,212,62,150,FMN GV 16 Berchem TOT
54,Posthofbrug 5366,2021-06-04,17:00:00,237,93,144,FMN GV 16 Berchem TOT
54,Posthofbrug 5366,2021-06-04,18:00:00,186,78,108,FMN GV 16 Berchem TOT
54,Posthofbrug 5366,2021-06-04,19:00:00,101,37,64,FMN GV 16 Berchem TOT
54,Posthofbrug 5366,2021-06-04,20:00:00,53,27,26,FMN GV 16 Berchem TOT
54,Posthofbrug 5366,2021-06-04,21:00:00,38,17,21,FMN GV 16 Berchem TOT
54,Posthofbrug 5366,2021-06-04,22:00:00,66,24,42,FMN GV 16 Berchem TOT
54,Posthofbrug 5366,2021-06-04,23:00:00,36,13,23,FMN GV 16 Berchem TOT
54,Posthofbrug 5366,2021-06-05,00:00:00,26,11,15,FMN GV 16 Berchem TOT
54,Posthofbrug 5366,2021-06-05,01:00:00,17,6,11,FMN GV 16 Berchem TOT
54,Posthofbrug 5366,2021-06-05,02:00:00,14,3,11,FMN GV 16 Berchem TOT
54,Posthofbrug 5366,2021-06-05,03:00:00,5,1,4,FMN GV 16 Berchem TOT
54,Posthofbrug 5366,2021-06-05,04:00:00,10,7,3,FMN GV 16 Berchem TOT
54,Posthofbrug 5366,2021-06-05,05:00:00,7,3,4,FMN GV 16 Berchem TOT
54,Posthofbrug 5366,2021-06-05,06:00:00,11,9,2,FMN GV 16 Berchem TOT
54,Posthofbrug 5366,2021-06-05,07:00:00,27,21,6,FMN GV 16 Berchem TOT
54,Posthofbrug 5366,2021-06-05,08:00:00,60,32,28,FMN GV 16 Berchem TOT
54,Posthofbrug 5366,2021-06-05,09:00:00,105,77,28,FMN GV 16 Berchem TOT
54,Posthofbrug 5366,2021-06-05,10:00:00,119,70,49,FMN GV 16 Berchem TOT
54,Posthofbrug 5366,2021-06-05,11:00:00,126,78,48,FMN GV 16 Berchem TOT
54,Posthofbrug 5366,2021-06-05,12:00:00,145,76,69,FMN GV 16 Berchem TOT
54,Posthofbrug 5366,2021-06-05,13:00:00,155,87,68,FMN GV 16 Berchem TOT
54,Posthofbrug 5366,2021-06-05,14:00:00,179,80,99,FMN GV 16 Berchem TOT
54,Posthofbrug 5366,2021-06-05,15:00:00,174,82,92,FMN GV 16 Berchem TOT
54,Posthofbrug 5366,2021-06-05,16:00:00,138,56,82,FMN GV 16 Berchem TOT
54,Posthofbrug 5366,2021-06-05,17:00:00,178,98,80,FMN GV 16 Berchem TOT
54,Posthofbrug 5366,2021-06-05,18:00:00,131,69,62,FMN GV 16 Berchem TOT
54,Posthofbrug 5366,2021-06-05,19:00:00,79,43,36,FMN GV 16 Berchem TOT
54,Posthofbrug 5366,2021-06-05,20:00:00,63,25,38,FMN GV 16 Berchem TOT
54,Posthofbrug 5366,2021-06-05,21:00:00,50,30,20,FMN GV 16 Berchem TOT
54,Posthofbrug 5366,2021-06-05,22:00:00,65,34,31,FMN GV 16 Berchem TOT
54,Posthofbrug 5366,2021-06-05,23:00:00,55,23,32,FMN GV 16 Berchem TOT
54,Posthofbrug 5366,2021-06-06,00:00:00,30,16,14,FMN GV 16 Berchem TOT
54,Posthofbrug 5366,2021-06-06,01:00:00,20,15,5,FMN GV 16 Berchem TOT
54,Posthofbrug 5366,2021-06-06,02:00:00,12,3,9,FMN GV 16 Berchem TOT
54,Posthofbrug 5366,2021-06-06,03:00:00,8,3,5,FMN GV 16 Berchem TOT
54,Posthofbrug 5366,2021-06-06,04:00:00,2,1,1,FMN GV 16 Berchem TOT
54,Posthofbrug 5366,2021-06-06,05:00:00,6,3,3,FMN GV 16 Berchem TOT
54,Posthofbrug 5366,2021-06-06,06:00:00,14,12,2,FMN GV 16 Berchem TOT
54,Posthofbrug 5366,2021-06-06,07:00:00,35,22,13,FMN GV 16 Berchem TOT
54,Posthofbrug 5366,2021-06-06,08:00:00,54,26,28,FMN GV 16 Berchem TOT
54,Posthofbrug 5366,2021-06-06,09:00:00,152,78,74,FMN GV 16 Berchem TOT
54,Posthofbrug 5366,2021-06-06,10:00:00,178,103,75,FMN GV 16 Berchem TOT
54,Posthofbrug 5366,2021-06-06,11:00:00,227,137,90,FMN GV 16 Berchem TOT
54,Posthofbrug 5366,2021-06-06,12:00:00,225,130,95,FMN GV 16 Berchem TOT
54,Posthofbrug 5366,2021-06-06,13:00:00,265,148,117,FMN GV 16 Berchem TOT
54,Posthofbrug 5366,2021-06-06,14:00:00,276,135,141,FMN GV 16 Berchem TOT
54,Posthofbrug 5366,2021-06-06,15:00:00,300,145,155,FMN GV 16 Berchem TOT
54,Posthofbrug 5366,2021-06-06,16:00:00,260,96,164,FMN GV 16 Berchem TOT
54,Posthofbrug 5366,2021-06-06,17:00:00,254,103,151,FMN GV 16 Berchem TOT
54,Posthofbrug 5366,2021-06-06,18:00:00,170,83,87,FMN GV 16 Berchem TOT
54,Posthofbrug 5366,2021-06-06,19:00:00,132,76,56,FMN GV 16 Berchem TOT
54,Posthofbrug 5366,2021-06-06,20:00:00,115,69,46,FMN GV 16 Berchem TOT
54,Posthofbrug 5366,2021-06-06,21:00:00,112,62,50,FMN GV 16 Berchem TOT
54,Posthofbrug 5366,2021-06-06,22:00:00,92,52,40,FMN GV 16 Berchem TOT
54,Posthofbrug 5366,2021-06-06,23:00:00,37,13,24,FMN GV 16 Berchem TOT
54,Posthofbrug 5366,2021-06-07,00:00:00,15,10,5,FMN GV 16 Berchem TOT
54,Posthofbrug 5366,2021-06-07,01:00:00,5,2,3,FMN GV 16 Berchem TOT
54,Posthofbrug 5366,2021-06-07,02:00:00,2,0,2,FMN GV 16 Berchem TOT
54,Posthofbrug 5366,2021-06-07,03:00:00,2,1,1,FMN GV 16 Berchem TOT
54,Posthofbrug 5366,2021-06-07,04:00:00,9,6,3,FMN GV 16 Berchem TOT
54,Posthofbrug 5366,2021-06-07,05:00:00,28,18,10,FMN GV 16 Berchem TOT
54,Posthofbrug 5366,2021-06-07,06:00:00,125,102,23,FMN GV 16 Berchem TOT
54,Posthofbrug 5366,2021-06-07,07:00:00,309,229,80,FMN GV 16 Berchem TOT
54,Posthofbrug 5366,2021-06-07,08:00:00,481,357,124,FMN GV 16 Berchem TOT
54,Posthofbrug 5366,2021-06-07,09:00:00,192,124,68,FMN GV 16 Berchem TOT
54,Posthofbrug 5366,2021-06-07,10:00:00,130,85,45,FMN GV 16 Berchem TOT
54,Posthofbrug 5366,2021-06-07,11:00:00,124,77,47,FMN GV 16 Berchem TOT
54,Posthofbrug 5366,2021-06-07,12:00:00,176,87,89,FMN GV 16 Berchem TOT
54,Posthofbrug 5366,2021-06-07,13:00:00,150,86,64,FMN GV 16 Berchem TOT
54,Posthofbrug 5366,2021-06-07,14:00:00,150,58,92,FMN GV 16 Berchem TOT
54,Posthofbrug 5366,2021-06-07,15:00:00,278,114,164,FMN GV 16 Berchem TOT
54,Posthofbrug 5366,2021-06-07,16:00:00,383,119,264,FMN GV 16 Berchem TOT
54,Posthofbrug 5366,2021-06-07,17:00:00,404,135,269,FMN GV 16 Berchem TOT
54,Posthofbrug 5366,2021-06-07,18:00:00,289,96,193,FMN GV 16 Berchem TOT
54,Posthofbrug 5366,2021-06-07,19:00:00,176,70,106,FMN GV 16 Berchem TOT
54,Posthofbrug 5366,2021-06-07,20:00:00,124,59,65,FMN GV 16 Berchem TOT
54,Posthofbrug 5366,2021-06-07,21:00:00,88,46,42,FMN GV 16 Berchem TOT
54,Posthofbrug 5366,2021-06-07,22:00:00,90,40,50,FMN GV 16 Berchem TOT
54,Posthofbrug 5366,2021-06-07,23:00:00,36,17,19,FMN GV 16 Berchem TOT
54,Posthofbrug 5366,2021-06-08,00:00:00,8,5,3,FMN GV 16 Berchem TOT
54,Posthofbrug 5366,2021-06-08,01:00:00,6,2,4,FMN GV 16 Berchem TOT
54,Posthofbrug 5366,2021-06-08,02:00:00,4,0,4,FMN GV 16 Berchem TOT
54,Posthofbrug 5366,2021-06-08,03:00:00,3,3,0,FMN GV 16 Berchem TOT
54,Posthofbrug 5366,2021-06-08,04:00:00,11,8,3,FMN GV 16 Berchem TOT
54,Posthofbrug 5366,2021-06-08,05:00:00,28,22,6,FMN GV 16 Berchem TOT
54,Posthofbrug 5366,2021-06-08,06:00:00,144,121,23,FMN GV 16 Berchem TOT
54,Posthofbrug 5366,2021-06-08,07:00:00,342,259,83,FMN GV 16 Berchem TOT
54,Posthofbrug 5366,2021-06-08,08:00:00,517,394,123,FMN GV 16 Berchem TOT
54,Posthofbrug 5366,2021-06-08,09:00:00,214,151,63,FMN GV 16 Berchem TOT
54,Posthofbrug 5366,2021-06-08,10:00:00,138,80,58,FMN GV 16 Berchem TOT
54,Posthofbrug 5366,2021-06-08,11:00:00,171,87,84,FMN GV 16 Berchem TOT
54,Posthofbrug 5366,2021-06-08,12:00:00,178,97,81,FMN GV 16 Berchem TOT
54,Posthofbrug 5366,2021-06-08,13:00:00,158,91,67,FMN GV 16 Berchem TOT
54,Posthofbrug 5366,2021-06-08,14:00:00,175,77,98,FMN GV 16 Berchem TOT
54,Posthofbrug 5366,2021-06-08,15:00:00,282,96,186,FMN GV 16 Berchem TOT
54,Posthofbrug 5366,2021-06-08,16:00:00,390,118,272,FMN GV 16 Berchem TOT
54,Posthofbrug 5366,2021-06-08,17:00:00,431,135,296,FMN GV 16 Berchem TOT
54,Posthofbrug 5366,2021-06-08,18:00:00,337,117,220,FMN GV 16 Berchem TOT
54,Posthofbrug 5366,2021-06-08,19:00:00,163,65,98,FMN GV 16 Berchem TOT
54,Posthofbrug 5366,2021-06-08,20:00:00,159,72,87,FMN GV 16 Berchem TOT
54,Posthofbrug 5366,2021-06-08,21:00:00,118,59,59,FMN GV 16 Berchem TOT
54,Posthofbrug 5366,2021-06-08,22:00:00,137,69,68,FMN GV 16 Berchem TOT
54,Posthofbrug 5366,2021-06-08,23:00:00,36,16,20,FMN GV 16 Berchem TOT
54,Posthofbrug 5366,2021-06-09,00:00:00,16,5,11,FMN GV 16 Berchem TOT
54,Posthofbrug 5366,2021-06-09,01:00:00,3,1,2,FMN GV 16 Berchem TOT
54,Posthofbrug 5366,2021-06-09,02:00:00,0,0,0,FMN GV 16 Berchem TOT
54,Posthofbrug 5366,2021-06-09,03:00:00,5,4,1,FMN GV 16 Berchem TOT
54,Posthofbrug 5366,2021-06-09,04:00:00,8,7,1,FMN GV 16 Berchem TOT
54,Posthofbrug 5366,2021-06-09,05:00:00,32,20,12,FMN GV 16 Berchem TOT
54,Posthofbrug 5366,2021-06-09,06:00:00,114,82,32,FMN GV 16 Berchem TOT
54,Posthofbrug 5366,2021-06-09,07:00:00,310,224,86,FMN GV 16 Berchem TOT
54,Posthofbrug 5366,2021-06-09,08:00:00,468,348,120,FMN GV 16 Berchem TOT
54,Posthofbrug 5366,2021-06-09,09:00:00,204,150,54,FMN GV 16 Berchem TOT
54,Posthofbrug 5366,2021-06-09,10:00:00,128,86,42,FMN GV 16 Berchem TOT
54,Posthofbrug 5366,2021-06-09,11:00:00,148,72,76,FMN GV 16 Berchem TOT
54,Posthofbrug 5366,2021-06-09,12:00:00,300,137,163,FMN GV 16 Berchem TOT
54,Posthofbrug 5366,2021-06-09,13:00:00,182,85,97,FMN GV 16 Berchem TOT
54,Posthofbrug 5366,2021-06-09,14:00:00,173,76,97,FMN GV 16 Berchem TOT
54,Posthofbrug 5366,2021-06-09,15:00:00,188,73,115,FMN GV 16 Berchem TOT
54,Posthofbrug 5366,2021-06-09,16:00:00,321,104,217,FMN GV 16 Berchem TOT
54,Posthofbrug 5366,2021-06-09,17:00:00,417,137,280,FMN GV 16 Berchem TOT
54,Posthofbrug 5366,2021-06-09,18:00:00,350,155,195,FMN GV 16 Berchem TOT
54,Posthofbrug 5366,2021-06-09,19:00:00,208,103,105,FMN GV 16 Berchem TOT
54,Posthofbrug 5366,2021-06-09,20:00:00,116,63,53,FMN GV 16 Berchem TOT
54,Posthofbrug 5366,2021-06-09,21:00:00,104,43,61,FMN GV 16 Berchem TOT
54,Posthofbrug 5366,2021-06-09,22:00:00,115,52,63,FMN GV 16 Berchem TOT
54,Posthofbrug 5366,2021-06-09,23:00:00,81,35,46,FMN GV 16 Berchem TOT
54,Posthofbrug 5366,2021-06-10,00:00:00,30,9,21,FMN GV 16 Berchem TOT
54,Posthofbrug 5366,2021-06-10,01:00:00,11,2,9,FMN GV 16 Berchem TOT
54,Posthofbrug 5366,2021-06-10,02:00:00,3,1,2,FMN GV 16 Berchem TOT
54,Posthofbrug 5366,2021-06-10,03:00:00,4,4,0,FMN GV 16 Berchem TOT
54,Posthofbrug 5366,2021-06-10,04:00:00,8,4,4,FMN GV 16 Berchem TOT
54,Posthofbrug 5366,2021-06-10,05:00:00,31,19,12,FMN GV 16 Berchem TOT
54,Posthofbrug 5366,2021-06-10,06:00:00,114,88,26,FMN GV 16 Berchem TOT
54,Posthofbrug 5366,2021-06-10,07:00:00,343,259,84,FMN GV 16 Berchem TOT
54,Posthofbrug 5366,2021-06-10,08:00:00,560,408,152,FMN GV 16 Berchem TOT
54,Posthofbrug 5366,2021-06-10,09:00:00,232,168,64,FMN GV 16 Berchem TOT
54,Posthofbrug 5366,2021-06-10,10:00:00,139,88,51,FMN GV 16 Berchem TOT
54,Posthofbrug 5366,2021-06-10,11:00:00,151,85,66,FMN GV 16 Berchem TOT
54,Posthofbrug 5366,2021-06-10,12:00:00,186,102,84,FMN GV 16 Berchem TOT
54,Posthofbrug 5366,2021-06-10,13:00:00,169,79,90,FMN GV 16 Berchem TOT
54,Posthofbrug 5366,2021-06-10,14:00:00,172,84,88,FMN GV 16 Berchem TOT
54,Posthofbrug 5366,2021-06-10,15:00:00,267,85,182,FMN GV 16 Berchem TOT
54,Posthofbrug 5366,2021-06-10,16:00:00,406,131,275,FMN GV 16 Berchem TOT
54,Posthofbrug 5366,2021-06-10,17:00:00,420,137,283,FMN GV 16 Berchem TOT
54,Posthofbrug 5366,2021-06-10,18:00:00,328,118,210,FMN GV 16 Berchem TOT
54,Posthofbrug 5366,2021-06-10,19:00:00,210,103,107,FMN GV 16 Berchem TOT
54,Posthofbrug 5366,2021-06-10,20:00:00,150,77,73,FMN GV 16 Berchem TOT
54,Posthofbrug 5366,2021-06-10,21:00:00,141,59,82,FMN GV 16 Berchem TOT
54,Posthofbrug 5366,2021-06-10,22:00:00,130,47,83,FMN GV 16 Berchem TOT
54,Posthofbrug 5366,2021-06-10,23:00:00,67,29,38,FMN GV 16 Berchem TOT
54,Posthofbrug 5366,2021-06-11,00:00:00,39,16,23,FMN GV 16 Berchem TOT
54,Posthofbrug 5366,2021-06-11,01:00:00,7,2,5,FMN GV 16 Berchem TOT
54,Posthofbrug 5366,2021-06-11,02:00:00,3,2,1,FMN GV 16 Berchem TOT
54,Posthofbrug 5366,2021-06-11,03:00:00,2,1,1,FMN GV 16 Berchem TOT
54,Posthofbrug 5366,2021-06-11,04:00:00,16,12,4,FMN GV 16 Berchem TOT
54,Posthofbrug 5366,2021-06-11,05:00:00,29,18,11,FMN GV 16 Berchem TOT
54,Posthofbrug 5366,2021-06-11,06:00:00,108,82,26,FMN GV 16 Berchem TOT
54,Posthofbrug 5366,2021-06-11,07:00:00,307,222,85,FMN GV 16 Berchem TOT
54,Posthofbrug 5366,2021-06-11,08:00:00,459,346,113,FMN GV 16 Berchem TOT
54,Posthofbrug 5366,2021-06-11,09:00:00,181,127,54,FMN GV 16 Berchem TOT
54,Posthofbrug 5366,2021-06-11,10:00:00,153,93,60,FMN GV 16 Berchem TOT
54,Posthofbrug 5366,2021-06-11,11:00:00,167,95,72,FMN GV 16 Berchem TOT
54,Posthofbrug 5366,2021-06-11,12:00:00,200,100,100,FMN GV 16 Berchem TOT
54,Posthofbrug 5366,2021-06-11,13:00:00,204,99,105,FMN GV 16 Berchem TOT
54,Posthofbrug 5366,2021-06-11,14:00:00,182,66,116,FMN GV 16 Berchem TOT
54,Posthofbrug 5366,2021-06-11,15:00:00,315,118,197,FMN GV 16 Berchem TOT
54,Posthofbrug 5366,2021-06-11,16:00:00,353,121,232,FMN GV 16 Berchem TOT
54,Posthofbrug 5366,2021-06-11,17:00:00,378,137,241,FMN GV 16 Berchem TOT
54,Posthofbrug 5366,2021-06-11,18:00:00,284,138,146,FMN GV 16 Berchem TOT
54,Posthofbrug 5366,2021-06-11,19:00:00,206,109,97,FMN GV 16 Berchem TOT
54,Posthofbrug 5366,2021-06-11,20:00:00,139,68,71,FMN GV 16 Berchem TOT
54,Posthofbrug 5366,2021-06-11,21:00:00,118,57,61,FMN GV 16 Berchem TOT
54,Posthofbrug 5366,2021-06-11,22:00:00,119,49,70,FMN GV 16 Berchem TOT
54,Posthofbrug 5366,2021-06-11,23:00:00,126,38,88,FMN GV 16 Berchem TOT
54,Posthofbrug 5366,2021-06-12,00:00:00,80,36,44,FMN GV 16 Berchem TOT
54,Posthofbrug 5366,2021-06-12,01:00:00,42,11,31,FMN GV 16 Berchem TOT
54,Posthofbrug 5366,2021-06-12,02:00:00,22,3,19,FMN GV 16 Berchem TOT
54,Posthofbrug 5366,2021-06-12,03:00:00,11,3,8,FMN GV 16 Berchem TOT
54,Posthofbrug 5366,2021-06-12,04:00:00,16,9,7,FMN GV 16 Berchem TOT
54,Posthofbrug 5366,2021-06-12,05:00:00,12,7,5,FMN GV 16 Berchem TOT
54,Posthofbrug 5366,2021-06-12,06:00:00,19,14,5,FMN GV 16 Berchem TOT
54,Posthofbrug 5366,2021-06-12,07:00:00,28,12,16,FMN GV 16 Berchem TOT
54,Posthofbrug 5366,2021-06-12,08:00:00,80,51,29,FMN GV 16 Berchem TOT
54,Posthofbrug 5366,2021-06-12,09:00:00,127,85,42,FMN GV 16 Berchem TOT
54,Posthofbrug 5366,2021-06-12,10:00:00,151,89,62,FMN GV 16 Berchem TOT
54,Posthofbrug 5366,2021-06-12,11:00:00,152,85,67,FMN GV 16 Berchem TOT
54,Posthofbrug 5366,2021-06-12,12:00:00,170,80,90,FMN GV 16 Berchem TOT
54,Posthofbrug 5366,2021-06-12,13:00:00,205,115,90,FMN GV 16 Berchem TOT
54,Posthofbrug 5366,2021-06-12,14:00:00,222,124,98,FMN GV 16 Berchem TOT
54,Posthofbrug 5366,2021-06-12,15:00:00,216,118,98,FMN GV 16 Berchem TOT
54,Posthofbrug 5366,2021-06-12,16:00:00,189,83,106,FMN GV 16 Berchem TOT
54,Posthofbrug 5366,2021-06-12,17:00:00,204,88,116,FMN GV 16 Berchem TOT
54,Posthofbrug 5366,2021-06-12,18:00:00,176,97,79,FMN GV 16 Berchem TOT
54,Posthofbrug 5366,2021-06-12,19:00:00,146,82,64,FMN GV 16 Berchem TOT
54,Posthofbrug 5366,2021-06-12,20:00:00,136,85,51,FMN GV 16 Berchem TOT
54,Posthofbrug 5366,2021-06-12,21:00:00,65,37,28,FMN GV 16 Berchem TOT
54,Posthofbrug 5366,2021-06-12,22:00:00,69,30,39,FMN GV 16 Berchem TOT
54,Posthofbrug 5366,2021-06-12,23:00:00,109,50,59,FMN GV 16 Berchem TOT
54,Posthofbrug 5366,2021-06-13,00:00:00,86,32,54,FMN GV 16 Berchem TOT
54,Posthofbrug 5366,2021-06-13,01:00:00,39,10,29,FMN GV 16 Berchem TOT
54,Posthofbrug 5366,2021-06-13,02:00:00,34,16,18,FMN GV 16 Berchem TOT
54,Posthofbrug 5366,2021-06-13,03:00:00,15,9,6,FMN GV 16 Berchem TOT
54,Posthofbrug 5366,2021-06-13,04:00:00,13,11,2,FMN GV 16 Berchem TOT
54,Posthofbrug 5366,2021-06-13,05:00:00,12,9,3,FMN GV 16 Berchem TOT
54,Posthofbrug 5366,2021-06-13,06:00:00,13,10,3,FMN GV 16 Berchem TOT
54,Posthofbrug 5366,2021-06-13,07:00:00,31,17,14,FMN GV 16 Berchem TOT
54,Posthofbrug 5366,2021-06-13,08:00:00,50,31,19,FMN GV 16 Berchem TOT
54,Posthofbrug 5366,2021-06-13,09:00:00,124,71,53,FMN GV 16 Berchem TOT
54,Posthofbrug 5366,2021-06-13,10:00:00,140,78,62,FMN GV 16 Berchem TOT
54,Posthofbrug 5366,2021-06-13,11:00:00,175,89,86,FMN GV 16 Berchem TOT
54,Posthofbrug 5366,2021-06-13,12:00:00,179,103,76,FMN GV 16 Berchem TOT
54,Posthofbrug 5366,2021-06-13,13:00:00,236,136,100,FMN GV 16 Berchem TOT
54,Posthofbrug 5366,2021-06-13,14:00:00,267,135,132,FMN GV 16 Berchem TOT
54,Posthofbrug 5366,2021-06-13,15:00:00,200,99,101,FMN GV 16 Berchem TOT
54,Posthofbrug 5366,2021-06-13,16:00:00,237,104,133,FMN GV 16 Berchem TOT
54,Posthofbrug 5366,2021-06-13,17:00:00,217,116,101,FMN GV 16 Berchem TOT
54,Posthofbrug 5366,2021-06-13,18:00:00,175,87,88,FMN GV 16 Berchem TOT
54,Posthofbrug 5366,2021-06-13,19:00:00,107,52,55,FMN GV 16 Berchem TOT
54,Posthofbrug 5366,2021-06-13,20:00:00,122,70,52,FMN GV 16 Berchem TOT
54,Posthofbrug 5366,2021-06-13,21:00:00,116,69,47,FMN GV 16 Berchem TOT
54,Posthofbrug 5366,2021-06-13,22:00:00,82,46,36,FMN GV 16 Berchem TOT
54,Posthofbrug 5366,2021-06-13,23:00:00,43,20,23,FMN GV 16 Berchem TOT
54,Posthofbrug 5366,2021-06-14,00:00:00,17,6,11,FMN GV 16 Berchem TOT
54,Posthofbrug 5366,2021-06-14,01:00:00,10,3,7,FMN GV 16 Berchem TOT
54,Posthofbrug 5366,2021-06-14,02:00:00,35,19,16,FMN GV 16 Berchem TOT
54,Posthofbrug 5366,2021-06-14,03:00:00,3,2,1,FMN GV 16 Berchem TOT
54,Posthofbrug 5366,2021-06-14,04:00:00,19,17,2,FMN GV 16 Berchem TOT
54,Posthofbrug 5366,2021-06-14,05:00:00,23,15,8,FMN GV 16 Berchem TOT
54,Posthofbrug 5366,2021-06-14,06:00:00,101,81,20,FMN GV 16 Berchem TOT
54,Posthofbrug 5366,2021-06-14,07:00:00,363,272,91,FMN GV 16 Berchem TOT
54,Posthofbrug 5366,2021-06-14,08:00:00,516,387,129,FMN GV 16 Berchem TOT
54,Posthofbrug 5366,2021-06-14,09:00:00,188,129,59,FMN GV 16 Berchem TOT
54,Posthofbrug 5366,2021-06-14,10:00:00,141,75,66,FMN GV 16 Berchem TOT
54,Posthofbrug 5366,2021-06-14,11:00:00,146,92,54,FMN GV 16 Berchem TOT
54,Posthofbrug 5366,2021-06-14,12:00:00,177,80,97,FMN GV 16 Berchem TOT
54,Posthofbrug 5366,2021-06-14,13:00:00,147,75,72,FMN GV 16 Berchem TOT
54,Posthofbrug 5366,2021-06-14,14:00:00,172,67,105,FMN GV 16 Berchem TOT
54,Posthofbrug 5366,2021-06-14,15:00:00,221,86,135,FMN GV 16 Berchem TOT
54,Posthofbrug 5366,2021-06-14,16:00:00,349,95,254,FMN GV 16 Berchem TOT
54,Posthofbrug 5366,2021-06-14,17:00:00,405,136,269,FMN GV 16 Berchem TOT
54,Posthofbrug 5366,2021-06-14,18:00:00,275,106,169,FMN GV 16 Berchem TOT
54,Posthofbrug 5366,2021-06-14,19:00:00,183,76,107,FMN GV 16 Berchem TOT
54,Posthofbrug 5366,2021-06-14,20:00:00,136,73,63,FMN GV 16 Berchem TOT
54,Posthofbrug 5366,2021-06-14,21:00:00,107,52,55,FMN GV 16 Berchem TOT
54,Posthofbrug 5366,2021-06-14,22:00:00,92,46,46,FMN GV 16 Berchem TOT
54,Posthofbrug 5366,2021-06-14,23:00:00,46,22,24,FMN GV 16 Berchem TOT
54,Posthofbrug 5366,2021-06-15,00:00:00,12,5,7,FMN GV 16 Berchem TOT
54,Posthofbrug 5366,2021-06-15,01:00:00,8,3,5,FMN GV 16 Berchem TOT
54,Posthofbrug 5366,2021-06-15,02:00:00,3,1,2,FMN GV 16 Berchem TOT
54,Posthofbrug 5366,2021-06-15,03:00:00,3,2,1,FMN GV 16 Berchem TOT
54,Posthofbrug 5366,2021-06-15,04:00:00,11,9,2,FMN GV 16 Berchem TOT
54,Posthofbrug 5366,2021-06-15,05:00:00,29,19,10,FMN GV 16 Berchem TOT
54,Posthofbrug 5366,2021-06-15,06:00:00,128,105,23,FMN GV 16 Berchem TOT
54,Posthofbrug 5366,2021-06-15,07:00:00,365,286,79,FMN GV 16 Berchem TOT
54,Posthofbrug 5366,2021-06-15,08:00:00,535,416,119,FMN GV 16 Berchem TOT
54,Posthofbrug 5366,2021-06-15,09:00:00,201,142,59,FMN GV 16 Berchem TOT
54,Posthofbrug 5366,2021-06-15,10:00:00,152,96,56,FMN GV 16 Berchem TOT
54,Posthofbrug 5366,2021-06-15,11:00:00,132,66,66,FMN GV 16 Berchem TOT
54,Posthofbrug 5366,2021-06-15,12:00:00,183,88,95,FMN GV 16 Berchem TOT
54,Posthofbrug 5366,2021-06-15,13:00:00,171,95,76,FMN GV 16 Berchem TOT
54,Posthofbrug 5366,2021-06-15,14:00:00,173,71,102,FMN GV 16 Berchem TOT
54,Posthofbrug 5366,2021-06-15,15:00:00,287,91,196,FMN GV 16 Berchem TOT
54,Posthofbrug 5366,2021-06-15,16:00:00,332,113,219,FMN GV 16 Berchem TOT
54,Posthofbrug 5366,2021-06-15,17:00:00,463,147,316,FMN GV 16 Berchem TOT
54,Posthofbrug 5366,2021-06-15,18:00:00,324,110,214,FMN GV 16 Berchem TOT
54,Posthofbrug 5366,2021-06-15,19:00:00,216,87,129,FMN GV 16 Berchem TOT
54,Posthofbrug 5366,2021-06-15,20:00:00,130,58,72,FMN GV 16 Berchem TOT
54,Posthofbrug 5366,2021-06-15,21:00:00,111,48,63,FMN GV 16 Berchem TOT
54,Posthofbrug 5366,2021-06-15,22:00:00,90,50,40,FMN GV 16 Berchem TOT
54,Posthofbrug 5366,2021-06-15,23:00:00,78,33,45,FMN GV 16 Berchem TOT
54,Posthofbrug 5366,2021-06-16,00:00:00,26,9,17,FMN GV 16 Berchem TOT
54,Posthofbrug 5366,2021-06-16,01:00:00,18,5,13,FMN GV 16 Berchem TOT
54,Posthofbrug 5366,2021-06-16,02:00:00,2,1,1,FMN GV 16 Berchem TOT
54,Posthofbrug 5366,2021-06-16,03:00:00,4,1,3,FMN GV 16 Berchem TOT
54,Posthofbrug 5366,2021-06-16,04:00:00,9,6,3,FMN GV 16 Berchem TOT
54,Posthofbrug 5366,2021-06-16,05:00:00,30,16,14,FMN GV 16 Berchem TOT
54,Posthofbrug 5366,2021-06-16,06:00:00,113,87,26,FMN GV 16 Berchem TOT
54,Posthofbrug 5366,2021-06-16,07:00:00,373,273,100,FMN GV 16 Berchem TOT
54,Posthofbrug 5366,2021-06-16,08:00:00,479,354,125,FMN GV 16 Berchem TOT
54,Posthofbrug 5366,2021-06-16,09:00:00,222,152,70,FMN GV 16 Berchem TOT
54,Posthofbrug 5366,2021-06-16,10:00:00,135,74,61,FMN GV 16 Berchem TOT
54,Posthofbrug 5366,2021-06-16,11:00:00,162,80,82,FMN GV 16 Berchem TOT
54,Posthofbrug 5366,2021-06-16,12:00:00,278,119,159,FMN GV 16 Berchem TOT
54,Posthofbrug 5366,2021-06-16,13:00:00,193,88,105,FMN GV 16 Berchem TOT
54,Posthofbrug 5366,2021-06-16,14:00:00,154,80,74,FMN GV 16 Berchem TOT
54,Posthofbrug 5366,2021-06-16,15:00:00,216,72,144,FMN GV 16 Berchem TOT
54,Posthofbrug 5366,2021-06-16,16:00:00,273,89,184,FMN GV 16 Berchem TOT
54,Posthofbrug 5366,2021-06-16,17:00:00,401,157,244,FMN GV 16 Berchem TOT
54,Posthofbrug 5366,2021-06-16,18:00:00,308,120,188,FMN GV 16 Berchem TOT
54,Posthofbrug 5366,2021-06-16,19:00:00,180,91,89,FMN GV 16 Berchem TOT
54,Posthofbrug 5366,2021-06-16,20:00:00,136,74,62,FMN GV 16 Berchem TOT
54,Posthofbrug 5366,2021-06-16,21:00:00,85,40,45,FMN GV 16 Berchem TOT
54,Posthofbrug 5366,2021-06-16,22:00:00,117,57,60,FMN GV 16 Berchem TOT
54,Posthofbrug 5366,2021-06-16,23:00:00,81,26,55,FMN GV 16 Berchem TOT
54,Posthofbrug 5366,2021-06-17,00:00:00,34,9,25,FMN GV 16 Berchem TOT
54,Posthofbrug 5366,2021-06-17,01:00:00,14,5,9,FMN GV 16 Berchem TOT
54,Posthofbrug 5366,2021-06-17,02:00:00,4,0,4,FMN GV 16 Berchem TOT
54,Posthofbrug 5366,2021-06-17,03:00:00,3,3,0,FMN GV 16 Berchem TOT
54,Posthofbrug 5366,2021-06-17,04:00:00,8,4,4,FMN GV 16 Berchem TOT
54,Posthofbrug 5366,2021-06-17,05:00:00,31,21,10,FMN GV 16 Berchem TOT
54,Posthofbrug 5366,2021-06-17,06:00:00,95,68,27,FMN GV 16 Berchem TOT
54,Posthofbrug 5366,2021-06-17,07:00:00,313,228,85,FMN GV 16 Berchem TOT
54,Posthofbrug 5366,2021-06-17,08:00:00,510,373,137,FMN GV 16 Berchem TOT
54,Posthofbrug 5366,2021-06-17,09:00:00,204,132,72,FMN GV 16 Berchem TOT
54,Posthofbrug 5366,2021-06-17,10:00:00,116,69,47,FMN GV 16 Berchem TOT
54,Posthofbrug 5366,2021-06-17,11:00:00,150,77,73,FMN GV 16 Berchem TOT
54,Posthofbrug 5366,2021-06-17,12:00:00,168,81,87,FMN GV 16 Berchem TOT
54,Posthofbrug 5366,2021-06-17,13:00:00,122,59,63,FMN GV 16 Berchem TOT
54,Posthofbrug 5366,2021-06-17,14:00:00,152,66,86,FMN GV 16 Berchem TOT
54,Posthofbrug 5366,2021-06-17,15:00:00,233,95,138,FMN GV 16 Berchem TOT
54,Posthofbrug 5366,2021-06-17,16:00:00,335,110,225,FMN GV 16 Berchem TOT
54,Posthofbrug 5366,2021-06-17,17:00:00,435,158,277,FMN GV 16 Berchem TOT
54,Posthofbrug 5366,2021-06-17,18:00:00,181,66,115,FMN GV 16 Berchem TOT
54,Posthofbrug 5366,2021-06-17,19:00:00,108,54,54,FMN GV 16 Berchem TOT
54,Posthofbrug 5366,2021-06-17,20:00:00,124,63,61,FMN GV 16 Berchem TOT
54,Posthofbrug 5366,2021-06-17,21:00:00,80,35,45,FMN GV 16 Berchem TOT
54,Posthofbrug 5366,2021-06-17,22:00:00,109,48,61,FMN GV 16 Berchem TOT
54,Posthofbrug 5366,2021-06-17,23:00:00,101,40,61,FMN GV 16 Berchem TOT
54,Posthofbrug 5366,2021-06-18,00:00:00,35,12,23,FMN GV 16 Berchem TOT
54,Posthofbrug 5366,2021-06-18,01:00:00,16,5,11,FMN GV 16 Berchem TOT
54,Posthofbrug 5366,2021-06-18,02:00:00,3,0,3,FMN GV 16 Berchem TOT
54,Posthofbrug 5366,2021-06-18,03:00:00,8,2,6,FMN GV 16 Berchem TOT
54,Posthofbrug 5366,2021-06-18,04:00:00,7,6,1,FMN GV 16 Berchem TOT
54,Posthofbrug 5366,2021-06-18,05:00:00,19,8,11,FMN GV 16 Berchem TOT
54,Posthofbrug 5366,2021-06-18,06:00:00,63,47,16,FMN GV 16 Berchem TOT
54,Posthofbrug 5366,2021-06-18,07:00:00,264,195,69,FMN GV 16 Berchem TOT
54,Posthofbrug 5366,2021-06-18,08:00:00,388,288,100,FMN GV 16 Berchem TOT
54,Posthofbrug 5366,2021-06-18,09:00:00,170,115,55,FMN GV 16 Berchem TOT
54,Posthofbrug 5366,2021-06-18,10:00:00,135,81,54,FMN GV 16 Berchem TOT
54,Posthofbrug 5366,2021-06-18,11:00:00,149,77,72,FMN GV 16 Berchem TOT
54,Posthofbrug 5366,2021-06-18,12:00:00,209,104,105,FMN GV 16 Berchem TOT
54,Posthofbrug 5366,2021-06-18,13:00:00,190,94,96,FMN GV 16 Berchem TOT
54,Posthofbrug 5366,2021-06-18,14:00:00,15,5,10,FMN GV 16 Berchem TOT
54,Posthofbrug 5366,2021-06-18,15:00:00,0,0,0,FMN GV 16 Berchem TOT
54,Posthofbrug 5366,2021-06-18,16:00:00,0,0,0,FMN GV 16 Berchem TOT
54,Posthofbrug 5366,2021-06-18,17:00:00,0,0,0,FMN GV 16 Berchem TOT
54,Posthofbrug 5366,2021-06-18,18:00:00,0,0,0,FMN GV 16 Berchem TOT
54,Posthofbrug 5366,2021-06-18,19:00:00,0,0,0,FMN GV 16 Berchem TOT
54,Posthofbrug 5366,2021-06-18,20:00:00,0,0,0,FMN GV 16 Berchem TOT
54,Posthofbrug 5366,2021-06-18,21:00:00,0,0,0,FMN GV 16 Berchem TOT
54,Posthofbrug 5366,2021-06-18,22:00:00,82,29,53,FMN GV 16 Berchem TOT
54,Posthofbrug 5366,2021-06-18,23:00:00,100,40,60,FMN GV 16 Berchem TOT
54,Posthofbrug 5366,2021-06-19,00:00:00,69,30,39,FMN GV 16 Berchem TOT
54,Posthofbrug 5366,2021-06-19,01:00:00,19,5,14,FMN GV 16 Berchem TOT
54,Posthofbrug 5366,2021-06-19,02:00:00,25,6,19,FMN GV 16 Berchem TOT
54,Posthofbrug 5366,2021-06-19,03:00:00,13,4,9,FMN GV 16 Berchem TOT
54,Posthofbrug 5366,2021-06-19,04:00:00,9,5,4,FMN GV 16 Berchem TOT
54,Posthofbrug 5366,2021-06-19,05:00:00,13,7,6,FMN GV 16 Berchem TOT
54,Posthofbrug 5366,2021-06-19,06:00:00,46,36,10,FMN GV 16 Berchem TOT
54,Posthofbrug 5366,2021-06-19,07:00:00,31,24,7,FMN GV 16 Berchem TOT
54,Posthofbrug 5366,2021-06-19,08:00:00,56,31,25,FMN GV 16 Berchem TOT
54,Posthofbrug 5366,2021-06-19,09:00:00,135,94,41,FMN GV 16 Berchem TOT
54,Posthofbrug 5366,2021-06-19,10:00:00,180,117,63,FMN GV 16 Berchem TOT
54,Posthofbrug 5366,2021-06-19,11:00:00,180,108,72,FMN GV 16 Berchem TOT
54,Posthofbrug 5366,2021-06-19,12:00:00,3,0,3,FMN GV 16 Berchem TOT
54,Posthofbrug 5366,2021-06-19,13:00:00,0,0,0,FMN GV 16 Berchem TOT
54,Posthofbrug 5366,2021-06-19,14:00:00,0,0,0,FMN GV 16 Berchem TOT
54,Posthofbrug 5366,2021-06-19,15:00:00,0,0,0,FMN GV 16 Berchem TOT
54,Posthofbrug 5366,2021-06-19,16:00:00,0,0,0,FMN GV 16 Berchem TOT
54,Posthofbrug 5366,2021-06-19,17:00:00,0,0,0,FMN GV 16 Berchem TOT
54,Posthofbrug 5366,2021-06-19,18:00:00,0,0,0,FMN GV 16 Berchem TOT
54,Posthofbrug 5366,2021-06-19,19:00:00,0,0,0,FMN GV 16 Berchem TOT
54,Posthofbrug 5366,2021-06-19,20:00:00,75,38,37,FMN GV 16 Berchem TOT
54,Posthofbrug 5366,2021-06-19,21:00:00,68,28,40,FMN GV 16 Berchem TOT
54,Posthofbrug 5366,2021-06-19,22:00:00,101,32,69,FMN GV 16 Berchem TOT
54,Posthofbrug 5366,2021-06-19,23:00:00,71,20,51,FMN GV 16 Berchem TOT
54,Posthofbrug 5366,2021-06-20,00:00:00,24,6,18,FMN GV 16 Berchem TOT
54,Posthofbrug 5366,2021-06-20,01:00:00,28,15,13,FMN GV 16 Berchem TOT
54,Posthofbrug 5366,2021-06-20,02:00:00,13,4,9,FMN GV 16 Berchem TOT
54,Posthofbrug 5366,2021-06-20,03:00:00,16,7,9,FMN GV 16 Berchem TOT
54,Posthofbrug 5366,2021-06-20,04:00:00,10,1,9,FMN GV 16 Berchem TOT
54,Posthofbrug 5366,2021-06-20,05:00:00,9,7,2,FMN GV 16 Berchem TOT
54,Posthofbrug 5366,2021-06-20,06:00:00,13,11,2,FMN GV 16 Berchem TOT
54,Posthofbrug 5366,2021-06-20,07:00:00,25,14,11,FMN GV 16 Berchem TOT
54,Posthofbrug 5366,2021-06-20,08:00:00,39,23,16,FMN GV 16 Berchem TOT
54,Posthofbrug 5366,2021-06-20,09:00:00,108,58,50,FMN GV 16 Berchem TOT
54,Posthofbrug 5366,2021-06-20,10:00:00,134,68,66,FMN GV 16 Berchem TOT
54,Posthofbrug 5366,2021-06-20,11:00:00,166,87,79,FMN GV 16 Berchem TOT
54,Posthofbrug 5366,2021-06-20,12:00:00,178,111,67,FMN GV 16 Berchem TOT
54,Posthofbrug 5366,2021-06-20,13:00:00,212,109,103,FMN GV 16 Berchem TOT
54,Posthofbrug 5366,2021-06-20,14:00:00,225,121,104,FMN GV 16 Berchem TOT
54,Posthofbrug 5366,2021-06-20,15:00:00,182,91,91,FMN GV 16 Berchem TOT
54,Posthofbrug 5366,2021-06-20,16:00:00,175,69,106,FMN GV 16 Berchem TOT
54,Posthofbrug 5366,2021-06-20,17:00:00,234,130,104,FMN GV 16 Berchem TOT
54,Posthofbrug 5366,2021-06-20,18:00:00,162,76,86,FMN GV 16 Berchem TOT
54,Posthofbrug 5366,2021-06-20,19:00:00,110,64,46,FMN GV 16 Berchem TOT
54,Posthofbrug 5366,2021-06-20,20:00:00,78,53,25,FMN GV 16 Berchem TOT
54,Posthofbrug 5366,2021-06-20,21:00:00,90,46,44,FMN GV 16 Berchem TOT
54,Posthofbrug 5366,2021-06-20,22:00:00,81,34,47,FMN GV 16 Berchem TOT
54,Posthofbrug 5366,2021-06-20,23:00:00,26,8,18,FMN GV 16 Berchem TOT
54,Posthofbrug 5366,2021-06-21,00:00:00,18,4,14,FMN GV 16 Berchem TOT
54,Posthofbrug 5366,2021-06-21,01:00:00,8,3,5,FMN GV 16 Berchem TOT
54,Posthofbrug 5366,2021-06-21,02:00:00,1,1,0,FMN GV 16 Berchem TOT
54,Posthofbrug 5366,2021-06-21,03:00:00,5,3,2,FMN GV 16 Berchem TOT
54,Posthofbrug 5366,2021-06-21,04:00:00,2,1,1,FMN GV 16 Berchem TOT
54,Posthofbrug 5366,2021-06-21,05:00:00,20,14,6,FMN GV 16 Berchem TOT
54,Posthofbrug 5366,2021-06-21,06:00:00,68,47,21,FMN GV 16 Berchem TOT
54,Posthofbrug 5366,2021-06-21,07:00:00,224,167,57,FMN GV 16 Berchem TOT
54,Posthofbrug 5366,2021-06-21,08:00:00,342,262,80,FMN GV 16 Berchem TOT
54,Posthofbrug 5366,2021-06-21,09:00:00,99,65,34,FMN GV 16 Berchem TOT
54,Posthofbrug 5366,2021-06-21,10:00:00,78,49,29,FMN GV 16 Berchem TOT
54,Posthofbrug 5366,2021-06-21,11:00:00,84,51,33,FMN GV 16 Berchem TOT
54,Posthofbrug 5366,2021-06-21,12:00:00,119,65,54,FMN GV 16 Berchem TOT
54,Posthofbrug 5366,2021-06-21,13:00:00,116,66,50,FMN GV 16 Berchem TOT
54,Posthofbrug 5366,2021-06-21,14:00:00,96,36,60,FMN GV 16 Berchem TOT
54,Posthofbrug 5366,2021-06-21,15:00:00,151,67,84,FMN GV 16 Berchem TOT
54,Posthofbrug 5366,2021-06-21,16:00:00,14,4,10,FMN GV 16 Berchem TOT
54,Posthofbrug 5366,2021-06-21,17:00:00,0,0,0,FMN GV 16 Berchem TOT
54,Posthofbrug 5366,2021-06-21,18:00:00,0,0,0,FMN GV 16 Berchem TOT
54,Posthofbrug 5366,2021-06-21,19:00:00,0,0,0,FMN GV 16 Berchem TOT
54,Posthofbrug 5366,2021-06-21,20:00:00,88,56,32,FMN GV 16 Berchem TOT
54,Posthofbrug 5366,2021-06-21,21:00:00,55,33,22,FMN GV 16 Berchem TOT
54,Posthofbrug 5366,2021-06-21,22:00:00,33,12,21,FMN GV 16 Berchem TOT
54,Posthofbrug 5366,2021-06-21,23:00:00,97,49,48,FMN GV 16 Berchem TOT
54,Posthofbrug 5366,2021-06-22,00:00:00,38,19,19,FMN GV 16 Berchem TOT
54,Posthofbrug 5366,2021-06-22,01:00:00,14,3,11,FMN GV 16 Berchem TOT
54,Posthofbrug 5366,2021-06-22,02:00:00,3,0,3,FMN GV 16 Berchem TOT
54,Posthofbrug 5366,2021-06-22,03:00:00,1,1,0,FMN GV 16 Berchem TOT
54,Posthofbrug 5366,2021-06-22,04:00:00,6,4,2,FMN GV 16 Berchem TOT
54,Posthofbrug 5366,2021-06-22,05:00:00,28,19,9,FMN GV 16 Berchem TOT
54,Posthofbrug 5366,2021-06-22,06:00:00,75,59,16,FMN GV 16 Berchem TOT
54,Posthofbrug 5366,2021-06-22,07:00:00,280,216,64,FMN GV 16 Berchem TOT
54,Posthofbrug 5366,2021-06-22,08:00:00,443,350,93,FMN GV 16 Berchem TOT
54,Posthofbrug 5366,2021-06-22,09:00:00,181,127,54,FMN GV 16 Berchem TOT
54,Posthofbrug 5366,2021-06-22,10:00:00,95,54,41,FMN GV 16 Berchem TOT
54,Posthofbrug 5366,2021-06-22,11:00:00,91,47,44,FMN GV 16 Berchem TOT
54,Posthofbrug 5366,2021-06-22,12:00:00,131,65,66,FMN GV 16 Berchem TOT
54,Posthofbrug 5366,2021-06-22,13:00:00,91,40,51,FMN GV 16 Berchem TOT
54,Posthofbrug 5366,2021-06-22,14:00:00,103,50,53,FMN GV 16 Berchem TOT
54,Posthofbrug 5366,2021-06-22,15:00:00,164,54,110,FMN GV 16 Berchem TOT
54,Posthofbrug 5366,2021-06-22,16:00:00,275,87,188,FMN GV 16 Berchem TOT
54,Posthofbrug 5366,2021-06-22,17:00:00,330,104,226,FMN GV 16 Berchem TOT
54,Posthofbrug 5366,2021-06-22,18:00:00,243,83,160,FMN GV 16 Berchem TOT
54,Posthofbrug 5366,2021-06-22,19:00:00,137,57,80,FMN GV 16 Berchem TOT
54,Posthofbrug 5366,2021-06-22,20:00:00,82,39,43,FMN GV 16 Berchem TOT
54,Posthofbrug 5366,2021-06-22,21:00:00,55,27,28,FMN GV 16 Berchem TOT
54,Posthofbrug 5366,2021-06-22,22:00:00,72,32,40,FMN GV 16 Berchem TOT
54,Posthofbrug 5366,2021-06-22,23:00:00,59,29,30,FMN GV 16 Berchem TOT
54,Posthofbrug 5366,2021-06-23,00:00:00,24,3,21,FMN GV 16 Berchem TOT
54,Posthofbrug 5366,2021-06-23,01:00:00,4,0,4,FMN GV 16 Berchem TOT
54,Posthofbrug 5366,2021-06-23,02:00:00,5,2,3,FMN GV 16 Berchem TOT
54,Posthofbrug 5366,2021-06-23,03:00:00,4,1,3,FMN GV 16 Berchem TOT
54,Posthofbrug 5366,2021-06-23,04:00:00,7,5,2,FMN GV 16 Berchem TOT
54,Posthofbrug 5366,2021-06-23,05:00:00,21,15,6,FMN GV 16 Berchem TOT
54,Posthofbrug 5366,2021-06-23,06:00:00,85,62,23,FMN GV 16 Berchem TOT
54,Posthofbrug 5366,2021-06-23,07:00:00,280,209,71,FMN GV 16 Berchem TOT
54,Posthofbrug 5366,2021-06-23,08:00:00,391,288,103,FMN GV 16 Berchem TOT
54,Posthofbrug 5366,2021-06-23,09:00:00,182,136,46,FMN GV 16 Berchem TOT
54,Posthofbrug 5366,2021-06-23,10:00:00,128,83,45,FMN GV 16 Berchem TOT
54,Posthofbrug 5366,2021-06-23,11:00:00,148,66,82,FMN GV 16 Berchem TOT
54,Posthofbrug 5366,2021-06-23,12:00:00,290,121,169,FMN GV 16 Berchem TOT
54,Posthofbrug 5366,2021-06-23,13:00:00,208,115,93,FMN GV 16 Berchem TOT
54,Posthofbrug 5366,2021-06-23,14:00:00,160,93,67,FMN GV 16 Berchem TOT
54,Posthofbrug 5366,2021-06-23,15:00:00,192,83,109,FMN GV 16 Berchem TOT
54,Posthofbrug 5366,2021-06-23,16:00:00,296,104,192,FMN GV 16 Berchem TOT
54,Posthofbrug 5366,2021-06-23,17:00:00,366,128,238,FMN GV 16 Berchem TOT
54,Posthofbrug 5366,2021-06-23,18:00:00,280,112,168,FMN GV 16 Berchem TOT
54,Posthofbrug 5366,2021-06-23,19:00:00,184,87,97,FMN GV 16 Berchem TOT
54,Posthofbrug 5366,2021-06-23,20:00:00,115,61,54,FMN GV 16 Berchem TOT
54,Posthofbrug 5366,2021-06-23,21:00:00,96,49,47,FMN GV 16 Berchem TOT
54,Posthofbrug 5366,2021-06-23,22:00:00,102,35,67,FMN GV 16 Berchem TOT
54,Posthofbrug 5366,2021-06-23,23:00:00,81,26,55,FMN GV 16 Berchem TOT
54,Posthofbrug 5366,2021-06-24,00:00:00,26,7,19,FMN GV 16 Berchem TOT
54,Posthofbrug 5366,2021-06-24,01:00:00,28,3,25,FMN GV 16 Berchem TOT
54,Posthofbrug 5366,2021-06-24,02:00:00,18,3,15,FMN GV 16 Berchem TOT
54,Posthofbrug 5366,2021-06-24,03:00:00,5,3,2,FMN GV 16 Berchem TOT
54,Posthofbrug 5366,2021-06-24,04:00:00,14,8,6,FMN GV 16 Berchem TOT
54,Posthofbrug 5366,2021-06-24,05:00:00,24,17,7,FMN GV 16 Berchem TOT
54,Posthofbrug 5366,2021-06-24,06:00:00,92,72,20,FMN GV 16 Berchem TOT
54,Posthofbrug 5366,2021-06-24,07:00:00,310,229,81,FMN GV 16 Berchem TOT
54,Posthofbrug 5366,2021-06-24,08:00:00,472,360,112,FMN GV 16 Berchem TOT
54,Posthofbrug 5366,2021-06-24,09:00:00,276,166,110,FMN GV 16 Berchem TOT
54,Posthofbrug 5366,2021-06-24,10:00:00,130,89,41,FMN GV 16 Berchem TOT
54,Posthofbrug 5366,2021-06-24,11:00:00,123,65,58,FMN GV 16 Berchem TOT
54,Posthofbrug 5366,2021-06-24,12:00:00,232,134,98,FMN GV 16 Berchem TOT
54,Posthofbrug 5366,2021-06-24,13:00:00,181,97,84,FMN GV 16 Berchem TOT
54,Posthofbrug 5366,2021-06-24,14:00:00,266,152,114,FMN GV 16 Berchem TOT
54,Posthofbrug 5366,2021-06-24,15:00:00,236,78,158,FMN GV 16 Berchem TOT
54,Posthofbrug 5366,2021-06-24,16:00:00,360,124,236,FMN GV 16 Berchem TOT
54,Posthofbrug 5366,2021-06-24,17:00:00,451,149,302,FMN GV 16 Berchem TOT
54,Posthofbrug 5366,2021-06-24,18:00:00,328,127,201,FMN GV 16 Berchem TOT
54,Posthofbrug 5366,2021-06-24,19:00:00,197,89,108,FMN GV 16 Berchem TOT
54,Posthofbrug 5366,2021-06-24,20:00:00,128,77,51,FMN GV 16 Berchem TOT
54,Posthofbrug 5366,2021-06-24,21:00:00,128,52,76,FMN GV 16 Berchem TOT
54,Posthofbrug 5366,2021-06-24,22:00:00,117,42,75,FMN GV 16 Berchem TOT
54,Posthofbrug 5366,2021-06-24,23:00:00,90,20,70,FMN GV 16 Berchem TOT
54,Posthofbrug 5366,2021-06-25,00:00:00,37,12,25,FMN GV 16 Berchem TOT
54,Posthofbrug 5366,2021-06-25,01:00:00,13,2,11,FMN GV 16 Berchem TOT
54,Posthofbrug 5366,2021-06-25,02:00:00,11,2,9,FMN GV 16 Berchem TOT
54,Posthofbrug 5366,2021-06-25,03:00:00,6,1,5,FMN GV 16 Berchem TOT
54,Posthofbrug 5366,2021-06-25,04:00:00,6,5,1,FMN GV 16 Berchem TOT
54,Posthofbrug 5366,2021-06-25,05:00:00,28,21,7,FMN GV 16 Berchem TOT
54,Posthofbrug 5366,2021-06-25,06:00:00,61,49,12,FMN GV 16 Berchem TOT
54,Posthofbrug 5366,2021-06-25,07:00:00,253,184,69,FMN GV 16 Berchem TOT
54,Posthofbrug 5366,2021-06-25,08:00:00,392,305,87,FMN GV 16 Berchem TOT
54,Posthofbrug 5366,2021-06-25,09:00:00,202,126,76,FMN GV 16 Berchem TOT
54,Posthofbrug 5366,2021-06-25,10:00:00,121,84,37,FMN GV 16 Berchem TOT
54,Posthofbrug 5366,2021-06-25,11:00:00,143,83,60,FMN GV 16 Berchem TOT
54,Posthofbrug 5366,2021-06-25,12:00:00,197,108,89,FMN GV 16 Berchem TOT
54,Posthofbrug 5366,2021-06-25,13:00:00,191,104,87,FMN GV 16 Berchem TOT
54,Posthofbrug 5366,2021-06-25,14:00:00,197,95,102,FMN GV 16 Berchem TOT
54,Posthofbrug 5366,2021-06-25,15:00:00,246,92,154,FMN GV 16 Berchem TOT
54,Posthofbrug 5366,2021-06-25,16:00:00,293,98,195,FMN GV 16 Berchem TOT
54,Posthofbrug 5366,2021-06-25,17:00:00,296,115,181,FMN GV 16 Berchem TOT
54,Posthofbrug 5366,2021-06-25,18:00:00,196,87,109,FMN GV 16 Berchem TOT
54,Posthofbrug 5366,2021-06-25,19:00:00,129,50,79,FMN GV 16 Berchem TOT
54,Posthofbrug 5366,2021-06-25,20:00:00,86,46,40,FMN GV 16 Berchem TOT
54,Posthofbrug 5366,2021-06-25,21:00:00,70,30,40,FMN GV 16 Berchem TOT
54,Posthofbrug 5366,2021-06-25,22:00:00,78,41,37,FMN GV 16 Berchem TOT
54,Posthofbrug 5366,2021-06-25,23:00:00,81,19,62,FMN GV 16 Berchem TOT
54,Posthofbrug 5366,2021-06-26,00:00:00,39,16,23,FMN GV 16 Berchem TOT
54,Posthofbrug 5366,2021-06-26,01:00:00,13,5,8,FMN GV 16 Berchem TOT
54,Posthofbrug 5366,2021-06-26,02:00:00,21,4,17,FMN GV 16 Berchem TOT
54,Posthofbrug 5366,2021-06-26,03:00:00,21,9,12,FMN GV 16 Berchem TOT
54,Posthofbrug 5366,2021-06-26,04:00:00,5,5,0,FMN GV 16 Berchem TOT
54,Posthofbrug 5366,2021-06-26,05:00:00,10,6,4,FMN GV 16 Berchem TOT
54,Posthofbrug 5366,2021-06-26,06:00:00,14,9,5,FMN GV 16 Berchem TOT
54,Posthofbrug 5366,2021-06-26,07:00:00,34,22,12,FMN GV 16 Berchem TOT
54,Posthofbrug 5366,2021-06-26,08:00:00,56,40,16,FMN GV 16 Berchem TOT
54,Posthofbrug 5366,2021-06-26,09:00:00,127,96,31,FMN GV 16 Berchem TOT
54,Posthofbrug 5366,2021-06-26,10:00:00,141,80,61,FMN GV 16 Berchem TOT
54,Posthofbrug 5366,2021-06-26,11:00:00,177,95,82,FMN GV 16 Berchem TOT
54,Posthofbrug 5366,2021-06-26,12:00:00,147,73,74,FMN GV 16 Berchem TOT
54,Posthofbrug 5366,2021-06-26,13:00:00,172,95,77,FMN GV 16 Berchem TOT
54,Posthofbrug 5366,2021-06-26,14:00:00,217,104,113,FMN GV 16 Berchem TOT
54,Posthofbrug 5366,2021-06-26,15:00:00,188,90,98,FMN GV 16 Berchem TOT
54,Posthofbrug 5366,2021-06-26,16:00:00,188,81,107,FMN GV 16 Berchem TOT
54,Posthofbrug 5366,2021-06-26,17:00:00,149,60,89,FMN GV 16 Berchem TOT
54,Posthofbrug 5366,2021-06-26,18:00:00,145,81,64,FMN GV 16 Berchem TOT
54,Posthofbrug 5366,2021-06-26,19:00:00,119,65,54,FMN GV 16 Berchem TOT
54,Posthofbrug 5366,2021-06-26,20:00:00,103,54,49,FMN GV 16 Berchem TOT
54,Posthofbrug 5366,2021-06-26,21:00:00,58,25,33,FMN GV 16 Berchem TOT
54,Posthofbrug 5366,2021-06-26,22:00:00,79,42,37,FMN GV 16 Berchem TOT
54,Posthofbrug 5366,2021-06-26,23:00:00,89,30,59,FMN GV 16 Berchem TOT
54,Posthofbrug 5366,2021-06-27,00:00:00,69,27,42,FMN GV 16 Berchem TOT
54,Posthofbrug 5366,2021-06-27,01:00:00,27,12,15,FMN GV 16 Berchem TOT
54,Posthofbrug 5366,2021-06-27,02:00:00,23,10,13,FMN GV 16 Berchem TOT
54,Posthofbrug 5366,2021-06-27,03:00:00,16,1,15,FMN GV 16 Berchem TOT
54,Posthofbrug 5366,2021-06-27,04:00:00,12,9,3,FMN GV 16 Berchem TOT
54,Posthofbrug 5366,2021-06-27,05:00:00,14,10,4,FMN GV 16 Berchem TOT
54,Posthofbrug 5366,2021-06-27,06:00:00,21,14,7,FMN GV 16 Berchem TOT
54,Posthofbrug 5366,2021-06-27,07:00:00,20,9,11,FMN GV 16 Berchem TOT
54,Posthofbrug 5366,2021-06-27,08:00:00,59,33,26,FMN GV 16 Berchem TOT
54,Posthofbrug 5366,2021-06-27,09:00:00,115,55,60,FMN GV 16 Berchem TOT
54,Posthofbrug 5366,2021-06-27,10:00:00,165,91,74,FMN GV 16 Berchem TOT
54,Posthofbrug 5366,2021-06-27,11:00:00,151,82,69,FMN GV 16 Berchem TOT
54,Posthofbrug 5366,2021-06-27,12:00:00,223,137,86,FMN GV 16 Berchem TOT
54,Posthofbrug 5366,2021-06-27,13:00:00,210,94,116,FMN GV 16 Berchem TOT
54,Posthofbrug 5366,2021-06-27,14:00:00,190,89,101,FMN GV 16 Berchem TOT
54,Posthofbrug 5366,2021-06-27,15:00:00,197,95,102,FMN GV 16 Berchem TOT
54,Posthofbrug 5366,2021-06-27,16:00:00,133,80,53,FMN GV 16 Berchem TOT
54,Posthofbrug 5366,2021-06-27,17:00:00,102,45,57,FMN GV 16 Berchem TOT
54,Posthofbrug 5366,2021-06-27,18:00:00,119,47,72,FMN GV 16 Berchem TOT
54,Posthofbrug 5366,2021-06-27,19:00:00,62,32,30,FMN GV 16 Berchem TOT
54,Posthofbrug 5366,2021-06-27,20:00:00,114,71,43,FMN GV 16 Berchem TOT
54,Posthofbrug 5366,2021-06-27,21:00:00,30,18,12,FMN GV 16 Berchem TOT
54,Posthofbrug 5366,2021-06-27,22:00:00,23,12,11,FMN GV 16 Berchem TOT
54,Posthofbrug 5366,2021-06-27,23:00:00,112,45,67,FMN GV 16 Berchem TOT
54,Posthofbrug 5366,2021-06-28,00:00:00,49,26,23,FMN GV 16 Berchem TOT
54,Posthofbrug 5366,2021-06-28,01:00:00,31,18,13,FMN GV 16 Berchem TOT
54,Posthofbrug 5366,2021-06-28,02:00:00,12,4,8,FMN GV 16 Berchem TOT
54,Posthofbrug 5366,2021-06-28,03:00:00,9,4,5,FMN GV 16 Berchem TOT
54,Posthofbrug 5366,2021-06-28,04:00:00,10,6,4,FMN GV 16 Berchem TOT
54,Posthofbrug 5366,2021-06-28,05:00:00,20,14,6,FMN GV 16 Berchem TOT
54,Posthofbrug 5366,2021-06-28,06:00:00,90,68,22,FMN GV 16 Berchem TOT
54,Posthofbrug 5366,2021-06-28,07:00:00,269,209,60,FMN GV 16 Berchem TOT
54,Posthofbrug 5366,2021-06-28,08:00:00,411,304,107,FMN GV 16 Berchem TOT
54,Posthofbrug 5366,2021-06-28,09:00:00,205,128,77,FMN GV 16 Berchem TOT
54,Posthofbrug 5366,2021-06-28,10:00:00,95,66,29,FMN GV 16 Berchem TOT
54,Posthofbrug 5366,2021-06-28,11:00:00,78,46,32,FMN GV 16 Berchem TOT
54,Posthofbrug 5366,2021-06-28,12:00:00,131,68,63,FMN GV 16 Berchem TOT
54,Posthofbrug 5366,2021-06-28,13:00:00,97,56,41,FMN GV 16 Berchem TOT
54,Posthofbrug 5366,2021-06-28,14:00:00,146,77,69,FMN GV 16 Berchem TOT
54,Posthofbrug 5366,2021-06-28,15:00:00,173,69,104,FMN GV 16 Berchem TOT
54,Posthofbrug 5366,2021-06-28,16:00:00,19,2,17,FMN GV 16 Berchem TOT
54,Posthofbrug 5366,2021-06-28,17:00:00,0,0,0,FMN GV 16 Berchem TOT
54,Posthofbrug 5366,2021-06-28,18:00:00,243,91,152,FMN GV 16 Berchem TOT
54,Posthofbrug 5366,2021-06-28,19:00:00,174,83,91,FMN GV 16 Berchem TOT
54,Posthofbrug 5366,2021-06-28,20:00:00,140,66,74,FMN GV 16 Berchem TOT
54,Posthofbrug 5366,2021-06-28,21:00:00,111,54,57,FMN GV 16 Berchem TOT
54,Posthofbrug 5366,2021-06-28,22:00:00,98,39,59,FMN GV 16 Berchem TOT
54,Posthofbrug 5366,2021-06-28,23:00:00,60,22,38,FMN GV 16 Berchem TOT
54,Posthofbrug 5366,2021-06-29,00:00:00,36,15,21,FMN GV 16 Berchem TOT
54,Posthofbrug 5366,2021-06-29,01:00:00,15,3,12,FMN GV 16 Berchem TOT
54,Posthofbrug 5366,2021-06-29,02:00:00,4,0,4,FMN GV 16 Berchem TOT
54,Posthofbrug 5366,2021-06-29,03:00:00,8,3,5,FMN GV 16 Berchem TOT
54,Posthofbrug 5366,2021-06-29,04:00:00,11,6,5,FMN GV 16 Berchem TOT
54,Posthofbrug 5366,2021-06-29,05:00:00,27,18,9,FMN GV 16 Berchem TOT
54,Posthofbrug 5366,2021-06-29,06:00:00,93,72,21,FMN GV 16 Berchem TOT
54,Posthofbrug 5366,2021-06-29,07:00:00,272,207,65,FMN GV 16 Berchem TOT
54,Posthofbrug 5366,2021-06-29,08:00:00,443,353,90,FMN GV 16 Berchem TOT
54,Posthofbrug 5366,2021-06-29,09:00:00,321,215,106,FMN GV 16 Berchem TOT
54,Posthofbrug 5366,2021-06-29,10:00:00,118,83,35,FMN GV 16 Berchem TOT
54,Posthofbrug 5366,2021-06-29,11:00:00,133,68,65,FMN GV 16 Berchem TOT
54,Posthofbrug 5366,2021-06-29,12:00:00,154,81,73,FMN GV 16 Berchem TOT
54,Posthofbrug 5366,2021-06-29,13:00:00,167,98,69,FMN GV 16 Berchem TOT
54,Posthofbrug 5366,2021-06-29,14:00:00,210,117,93,FMN GV 16 Berchem TOT
54,Posthofbrug 5366,2021-06-29,15:00:00,255,64,191,FMN GV 16 Berchem TOT
54,Posthofbrug 5366,2021-06-29,16:00:00,290,89,201,FMN GV 16 Berchem TOT
54,Posthofbrug 5366,2021-06-29,17:00:00,380,135,245,FMN GV 16 Berchem TOT
54,Posthofbrug 5366,2021-06-29,18:00:00,287,100,187,FMN GV 16 Berchem TOT
54,Posthofbrug 5366,2021-06-29,19:00:00,158,67,91,FMN GV 16 Berchem TOT
54,Posthofbrug 5366,2021-06-29,20:00:00,135,62,73,FMN GV 16 Berchem TOT
54,Posthofbrug 5366,2021-06-29,21:00:00,92,53,39,FMN GV 16 Berchem TOT
54,Posthofbrug 5366,2021-06-29,22:00:00,76,31,45,FMN GV 16 Berchem TOT
54,Posthofbrug 5366,2021-06-29,23:00:00,61,22,39,FMN GV 16 Berchem TOT
54,Posthofbrug 5366,2021-06-30,00:00:00,18,5,13,FMN GV 16 Berchem TOT
54,Posthofbrug 5366,2021-06-30,01:00:00,17,2,15,FMN GV 16 Berchem TOT
54,Posthofbrug 5366,2021-06-30,02:00:00,11,2,9,FMN GV 16 Berchem TOT
54,Posthofbrug 5366,2021-06-30,03:00:00,3,0,3,FMN GV 16 Berchem TOT
54,Posthofbrug 5366,2021-06-30,04:00:00,8,8,0,FMN GV 16 Berchem TOT
54,Posthofbrug 5366,2021-06-30,05:00:00,13,7,6,FMN GV 16 Berchem TOT
54,Posthofbrug 5366,2021-06-30,06:00:00,73,47,26,FMN GV 16 Berchem TOT
54,Posthofbrug 5366,2021-06-30,07:00:00,179,129,50,FMN GV 16 Berchem TOT
54,Posthofbrug 5366,2021-06-30,08:00:00,270,196,74,FMN GV 16 Berchem TOT
54,Posthofbrug 5366,2021-06-30,09:00:00,143,105,38,FMN GV 16 Berchem TOT
54,Posthofbrug 5366,2021-06-30,10:00:00,85,52,33,FMN GV 16 Berchem TOT
54,Posthofbrug 5366,2021-06-30,11:00:00,79,43,36,FMN GV 16 Berchem TOT
54,Posthofbrug 5366,2021-06-30,12:00:00,112,60,52,FMN GV 16 Berchem TOT
54,Posthofbrug 5366,2021-06-30,13:00:00,103,48,55,FMN GV 16 Berchem TOT
54,Posthofbrug 5366,2021-06-30,14:00:00,75,32,43,FMN GV 16 Berchem TOT
54,Posthofbrug 5366,2021-06-30,15:00:00,116,44,72,FMN GV 16 Berchem TOT
54,Posthofbrug 5366,2021-06-30,16:00:00,183,71,112,FMN GV 16 Berchem TOT
54,Posthofbrug 5366,2021-06-30,17:00:00,204,86,118,FMN GV 16 Berchem TOT
54,Posthofbrug 5366,2021-06-30,18:00:00,176,64,112,FMN GV 16 Berchem TOT
54,Posthofbrug 5366,2021-06-30,19:00:00,114,51,63,FMN GV 16 Berchem TOT
54,Posthofbrug 5366,2021-06-30,20:00:00,73,43,30,FMN GV 16 Berchem TOT
54,Posthofbrug 5366,2021-06-30,21:00:00,53,24,29,FMN GV 16 Berchem TOT
54,Posthofbrug 5366,2021-06-30,22:00:00,76,24,52,FMN GV 16 Berchem TOT
54,Posthofbrug 5366,2021-06-30,23:00:00,25,7,18,FMN GV 16 Berchem TOT
54,Posthofbrug 5366,2021-07-01,00:00:00,30,14,16,FMN GV 16 Berchem TOT
54,Posthofbrug 5366,2021-07-01,01:00:00,16,2,14,FMN GV 16 Berchem TOT
54,Posthofbrug 5366,2021-07-01,02:00:00,10,4,6,FMN GV 16 Berchem TOT
54,Posthofbrug 5366,2021-07-01,03:00:00,8,3,5,FMN GV 16 Berchem TOT
54,Posthofbrug 5366,2021-07-01,04:00:00,8,6,2,FMN GV 16 Berchem TOT
54,Posthofbrug 5366,2021-07-01,05:00:00,25,19,6,FMN GV 16 Berchem TOT
54,Posthofbrug 5366,2021-07-01,06:00:00,92,72,20,FMN GV 16 Berchem TOT
54,Posthofbrug 5366,2021-07-01,07:00:00,224,160,64,FMN GV 16 Berchem TOT
54,Posthofbrug 5366,2021-07-01,08:00:00,362,270,92,FMN GV 16 Berchem TOT
54,Posthofbrug 5366,2021-07-01,09:00:00,179,135,44,FMN GV 16 Berchem TOT
54,Posthofbrug 5366,2021-07-01,10:00:00,120,91,29,FMN GV 16 Berchem TOT
54,Posthofbrug 5366,2021-07-01,11:00:00,122,72,50,FMN GV 16 Berchem TOT
54,Posthofbrug 5366,2021-07-01,12:00:00,142,70,72,FMN GV 16 Berchem TOT
54,Posthofbrug 5366,2021-07-01,13:00:00,140,73,67,FMN GV 16 Berchem TOT
54,Posthofbrug 5366,2021-07-01,14:00:00,156,81,75,FMN GV 16 Berchem TOT
54,Posthofbrug 5366,2021-07-01,15:00:00,208,77,131,FMN GV 16 Berchem TOT
54,Posthofbrug 5366,2021-07-01,16:00:00,293,103,190,FMN GV 16 Berchem TOT
54,Posthofbrug 5366,2021-07-01,17:00:00,374,127,247,FMN GV 16 Berchem TOT
54,Posthofbrug 5366,2021-07-01,18:00:00,17,5,12,FMN GV 16 Berchem TOT
54,Posthofbrug 5366,2021-07-01,19:00:00,0,0,0,FMN GV 16 Berchem TOT
54,Posthofbrug 5366,2021-07-01,20:00:00,0,0,0,FMN GV 16 Berchem TOT
54,Posthofbrug 5366,2021-07-01,21:00:00,0,0,0,FMN GV 16 Berchem TOT
54,Posthofbrug 5366,2021-07-01,22:00:00,75,30,45,FMN GV 16 Berchem TOT
54,Posthofbrug 5366,2021-07-01,23:00:00,50,13,37,FMN GV 16 Berchem TOT
54,Posthofbrug 5366,2021-07-02,00:00:00,47,16,31,FMN GV 16 Berchem TOT
54,Posthofbrug 5366,2021-07-02,01:00:00,31,5,26,FMN GV 16 Berchem TOT
54,Posthofbrug 5366,2021-07-02,02:00:00,6,1,5,FMN GV 16 Berchem TOT
54,Posthofbrug 5366,2021-07-02,03:00:00,4,3,1,FMN GV 16 Berchem TOT
54,Posthofbrug 5366,2021-07-02,04:00:00,9,8,1,FMN GV 16 Berchem TOT
54,Posthofbrug 5366,2021-07-02,05:00:00,22,16,6,FMN GV 16 Berchem TOT
54,Posthofbrug 5366,2021-07-02,06:00:00,70,51,19,FMN GV 16 Berchem TOT
54,Posthofbrug 5366,2021-07-02,07:00:00,183,121,62,FMN GV 16 Berchem TOT
54,Posthofbrug 5366,2021-07-02,08:00:00,307,227,80,FMN GV 16 Berchem TOT
54,Posthofbrug 5366,2021-07-02,09:00:00,184,130,54,FMN GV 16 Berchem TOT
54,Posthofbrug 5366,2021-07-02,10:00:00,150,96,54,FMN GV 16 Berchem TOT
54,Posthofbrug 5366,2021-07-02,11:00:00,148,83,65,FMN GV 16 Berchem TOT
54,Posthofbrug 5366,2021-07-02,12:00:00,165,91,74,FMN GV 16 Berchem TOT
54,Posthofbrug 5366,2021-07-02,13:00:00,186,91,95,FMN GV 16 Berchem TOT
54,Posthofbrug 5366,2021-07-02,14:00:00,219,112,107,FMN GV 16 Berchem TOT
54,Posthofbrug 5366,2021-07-02,15:00:00,218,102,116,FMN GV 16 Berchem TOT
54,Posthofbrug 5366,2021-07-02,16:00:00,288,119,169,FMN GV 16 Berchem TOT
54,Posthofbrug 5366,2021-07-02,17:00:00,364,174,190,FMN GV 16 Berchem TOT
54,Posthofbrug 5366,2021-07-02,18:00:00,256,96,160,FMN GV 16 Berchem TOT
54,Posthofbrug 5366,2021-07-02,19:00:00,173,90,83,FMN GV 16 Berchem TOT
54,Posthofbrug 5366,2021-07-02,20:00:00,158,71,87,FMN GV 16 Berchem TOT
54,Posthofbrug 5366,2021-07-02,21:00:00,38,15,23,FMN GV 16 Berchem TOT
54,Posthofbrug 5366,2021-07-02,22:00:00,46,21,25,FMN GV 16 Berchem TOT
54,Posthofbrug 5366,2021-07-02,23:00:00,130,62,68,FMN GV 16 Berchem TOT
54,Posthofbrug 5366,2021-07-03,00:00:00,97,37,60,FMN GV 16 Berchem TOT
54,Posthofbrug 5366,2021-07-03,01:00:00,77,37,40,FMN GV 16 Berchem TOT
54,Posthofbrug 5366,2021-07-03,02:00:00,69,13,56,FMN GV 16 Berchem TOT
54,Posthofbrug 5366,2021-07-03,03:00:00,31,16,15,FMN GV 16 Berchem TOT
54,Posthofbrug 5366,2021-07-03,04:00:00,16,5,11,FMN GV 16 Berchem TOT
54,Posthofbrug 5366,2021-07-03,05:00:00,13,7,6,FMN GV 16 Berchem TOT
54,Posthofbrug 5366,2021-07-03,06:00:00,22,13,9,FMN GV 16 Berchem TOT
54,Posthofbrug 5366,2021-07-03,07:00:00,35,25,10,FMN GV 16 Berchem TOT
54,Posthofbrug 5366,2021-07-03,08:00:00,38,20,18,FMN GV 16 Berchem TOT
54,Posthofbrug 5366,2021-07-03,09:00:00,91,60,31,FMN GV 16 Berchem TOT
54,Posthofbrug 5366,2021-07-03,10:00:00,117,80,37,FMN GV 16 Berchem TOT
54,Posthofbrug 5366,2021-07-03,11:00:00,137,80,57,FMN GV 16 Berchem TOT
54,Posthofbrug 5366,2021-07-03,12:00:00,142,88,54,FMN GV 16 Berchem TOT
54,Posthofbrug 5366,2021-07-03,13:00:00,203,118,85,FMN GV 16 Berchem TOT
54,Posthofbrug 5366,2021-07-03,14:00:00,150,72,78,FMN GV 16 Berchem TOT
54,Posthofbrug 5366,2021-07-03,15:00:00,151,75,76,FMN GV 16 Berchem TOT
54,Posthofbrug 5366,2021-07-03,16:00:00,122,46,76,FMN GV 16 Berchem TOT
54,Posthofbrug 5366,2021-07-03,17:00:00,91,32,59,FMN GV 16 Berchem TOT
54,Posthofbrug 5366,2021-07-03,18:00:00,100,47,53,FMN GV 16 Berchem TOT
54,Posthofbrug 5366,2021-07-03,19:00:00,70,35,35,FMN GV 16 Berchem TOT
54,Posthofbrug 5366,2021-07-03,20:00:00,73,28,45,FMN GV 16 Berchem TOT
54,Posthofbrug 5366,2021-07-03,21:00:00,59,29,30,FMN GV 16 Berchem TOT
54,Posthofbrug 5366,2021-07-03,22:00:00,57,24,33,FMN GV 16 Berchem TOT
54,Posthofbrug 5366,2021-07-03,23:00:00,32,11,21,FMN GV 16 Berchem TOT
54,Posthofbrug 5366,2021-07-04,00:00:00,24,11,13,FMN GV 16 Berchem TOT
54,Posthofbrug 5366,2021-07-04,01:00:00,17,5,12,FMN GV 16 Berchem TOT
54,Posthofbrug 5366,2021-07-04,02:00:00,6,1,5,FMN GV 16 Berchem TOT
54,Posthofbrug 5366,2021-07-04,03:00:00,2,0,2,FMN GV 16 Berchem TOT
54,Posthofbrug 5366,2021-07-04,04:00:00,8,3,5,FMN GV 16 Berchem TOT
54,Posthofbrug 5366,2021-07-04,05:00:00,13,4,9,FMN GV 16 Berchem TOT
54,Posthofbrug 5366,2021-07-04,06:00:00,16,12,4,FMN GV 16 Berchem TOT
54,Posthofbrug 5366,2021-07-04,07:00:00,21,12,9,FMN GV 16 Berchem TOT
54,Posthofbrug 5366,2021-07-04,08:00:00,23,13,10,FMN GV 16 Berchem TOT
54,Posthofbrug 5366,2021-07-04,09:00:00,85,62,23,FMN GV 16 Berchem TOT
54,Posthofbrug 5366,2021-07-04,10:00:00,120,70,50,FMN GV 16 Berchem TOT
54,Posthofbrug 5366,2021-07-04,11:00:00,131,87,44,FMN GV 16 Berchem TOT
54,Posthofbrug 5366,2021-07-04,12:00:00,115,64,51,FMN GV 16 Berchem TOT
54,Posthofbrug 5366,2021-07-04,13:00:00,54,31,23,FMN GV 16 Berchem TOT
54,Posthofbrug 5366,2021-07-04,14:00:00,53,14,39,FMN GV 16 Berchem TOT
54,Posthofbrug 5366,2021-07-04,15:00:00,50,21,29,FMN GV 16 Berchem TOT
54,Posthofbrug 5366,2021-07-04,16:00:00,79,32,47,FMN GV 16 Berchem TOT
54,Posthofbrug 5366,2021-07-04,17:00:00,97,38,59,FMN GV 16 Berchem TOT
54,Posthofbrug 5366,2021-07-04,18:00:00,98,53,45,FMN GV 16 Berchem TOT
54,Posthofbrug 5366,2021-07-04,19:00:00,78,36,42,FMN GV 16 Berchem TOT
54,Posthofbrug 5366,2021-07-04,20:00:00,70,33,37,FMN GV 16 Berchem TOT
54,Posthofbrug 5366,2021-07-04,21:00:00,63,42,21,FMN GV 16 Berchem TOT
54,Posthofbrug 5366,2021-07-04,22:00:00,64,39,25,FMN GV 16 Berchem TOT
54,Posthofbrug 5366,2021-07-04,23:00:00,45,21,24,FMN GV 16 Berchem TOT
54,Posthofbrug 5366,2021-07-05,00:00:00,18,4,14,FMN GV 16 Berchem TOT
54,Posthofbrug 5366,2021-07-05,01:00:00,14,5,9,FMN GV 16 Berchem TOT
54,Posthofbrug 5366,2021-07-05,02:00:00,5,0,5,FMN GV 16 Berchem TOT
54,Posthofbrug 5366,2021-07-05,03:00:00,0,0,0,FMN GV 16 Berchem TOT
54,Posthofbrug 5366,2021-07-05,04:00:00,11,10,1,FMN GV 16 Berchem TOT
54,Posthofbrug 5366,2021-07-05,05:00:00,15,11,4,FMN GV 16 Berchem TOT
54,Posthofbrug 5366,2021-07-05,06:00:00,93,74,19,FMN GV 16 Berchem TOT
54,Posthofbrug 5366,2021-07-05,07:00:00,191,139,52,FMN GV 16 Berchem TOT
54,Posthofbrug 5366,2021-07-05,08:00:00,298,221,77,FMN GV 16 Berchem TOT
54,Posthofbrug 5366,2021-07-05,09:00:00,133,98,35,FMN GV 16 Berchem TOT
54,Posthofbrug 5366,2021-07-05,10:00:00,76,57,19,FMN GV 16 Berchem TOT
54,Posthofbrug 5366,2021-07-05,11:00:00,81,49,32,FMN GV 16 Berchem TOT
54,Posthofbrug 5366,2021-07-05,12:00:00,107,56,51,FMN GV 16 Berchem TOT
54,Posthofbrug 5366,2021-07-05,13:00:00,119,72,47,FMN GV 16 Berchem TOT
54,Posthofbrug 5366,2021-07-05,14:00:00,74,33,41,FMN GV 16 Berchem TOT
54,Posthofbrug 5366,2021-07-05,15:00:00,110,42,68,FMN GV 16 Berchem TOT
54,Posthofbrug 5366,2021-07-05,16:00:00,237,80,157,FMN GV 16 Berchem TOT
54,Posthofbrug 5366,2021-07-05,17:00:00,325,106,219,FMN GV 16 Berchem TOT
54,Posthofbrug 5366,2021-07-05,18:00:00,233,82,151,FMN GV 16 Berchem TOT
54,Posthofbrug 5366,2021-07-05,19:00:00,122,52,70,FMN GV 16 Berchem TOT
54,Posthofbrug 5366,2021-07-05,20:00:00,84,47,37,FMN GV 16 Berchem TOT
54,Posthofbrug 5366,2021-07-05,21:00:00,70,37,33,FMN GV 16 Berchem TOT
54,Posthofbrug 5366,2021-07-05,22:00:00,59,23,36,FMN GV 16 Berchem TOT
54,Posthofbrug 5366,2021-07-05,23:00:00,36,12,24,FMN GV 16 Berchem TOT
54,Posthofbrug 5366,2021-07-06,00:00:00,36,7,29,FMN GV 16 Berchem TOT
54,Posthofbrug 5366,2021-07-06,01:00:00,7,4,3,FMN GV 16 Berchem TOT
54,Posthofbrug 5366,2021-07-06,02:00:00,5,2,3,FMN GV 16 Berchem TOT
54,Posthofbrug 5366,2021-07-06,03:00:00,2,1,1,FMN GV 16 Berchem TOT
54,Posthofbrug 5366,2021-07-06,04:00:00,11,7,4,FMN GV 16 Berchem TOT
54,Posthofbrug 5366,2021-07-06,05:00:00,19,13,6,FMN GV 16 Berchem TOT
54,Posthofbrug 5366,2021-07-06,06:00:00,90,71,19,FMN GV 16 Berchem TOT
54,Posthofbrug 5366,2021-07-06,07:00:00,211,159,52,FMN GV 16 Berchem TOT
54,Posthofbrug 5366,2021-07-06,08:00:00,334,237,97,FMN GV 16 Berchem TOT
54,Posthofbrug 5366,2021-07-06,09:00:00,166,136,30,FMN GV 16 Berchem TOT
54,Posthofbrug 5366,2021-07-06,10:00:00,77,51,26,FMN GV 16 Berchem TOT
54,Posthofbrug 5366,2021-07-06,11:00:00,80,50,30,FMN GV 16 Berchem TOT
54,Posthofbrug 5366,2021-07-06,12:00:00,102,51,51,FMN GV 16 Berchem TOT
54,Posthofbrug 5366,2021-07-06,13:00:00,103,66,37,FMN GV 16 Berchem TOT
54,Posthofbrug 5366,2021-07-06,14:00:00,106,47,59,FMN GV 16 Berchem TOT
54,Posthofbrug 5366,2021-07-06,15:00:00,111,42,69,FMN GV 16 Berchem TOT
54,Posthofbrug 5366,2021-07-06,16:00:00,209,77,132,FMN GV 16 Berchem TOT
54,Posthofbrug 5366,2021-07-06,17:00:00,330,98,232,FMN GV 16 Berchem TOT
54,Posthofbrug 5366,2021-07-06,18:00:00,258,70,188,FMN GV 16 Berchem TOT
54,Posthofbrug 5366,2021-07-06,19:00:00,131,59,72,FMN GV 16 Berchem TOT
54,Posthofbrug 5366,2021-07-06,20:00:00,98,46,52,FMN GV 16 Berchem TOT
54,Posthofbrug 5366,2021-07-06,21:00:00,77,41,36,FMN GV 16 Berchem TOT
54,Posthofbrug 5366,2021-07-06,22:00:00,96,46,50,FMN GV 16 Berchem TOT
54,Posthofbrug 5366,2021-07-06,23:00:00,49,18,31,FMN GV 16 Berchem TOT
54,Posthofbrug 5366,2021-07-07,00:00:00,31,9,22,FMN GV 16 Berchem TOT
54,Posthofbrug 5366,2021-07-07,01:00:00,9,4,5,FMN GV 16 Berchem TOT
54,Posthofbrug 5366,2021-07-07,02:00:00,3,2,1,FMN GV 16 Berchem TOT
54,Posthofbrug 5366,2021-07-07,03:00:00,3,2,1,FMN GV 16 Berchem TOT
54,Posthofbrug 5366,2021-07-07,04:00:00,8,6,2,FMN GV 16 Berchem TOT
54,Posthofbrug 5366,2021-07-07,05:00:00,17,12,5,FMN GV 16 Berchem TOT
54,Posthofbrug 5366,2021-07-07,06:00:00,76,58,18,FMN GV 16 Berchem TOT
54,Posthofbrug 5366,2021-07-07,07:00:00,204,146,58,FMN GV 16 Berchem TOT
54,Posthofbrug 5366,2021-07-07,08:00:00,340,236,104,FMN GV 16 Berchem TOT
54,Posthofbrug 5366,2021-07-07,09:00:00,199,144,55,FMN GV 16 Berchem TOT
54,Posthofbrug 5366,2021-07-07,10:00:00,114,77,37,FMN GV 16 Berchem TOT
54,Posthofbrug 5366,2021-07-07,11:00:00,123,74,49,FMN GV 16 Berchem TOT
54,Posthofbrug 5366,2021-07-07,12:00:00,143,88,55,FMN GV 16 Berchem TOT
54,Posthofbrug 5366,2021-07-07,13:00:00,141,76,65,FMN GV 16 Berchem TOT
54,Posthofbrug 5366,2021-07-07,14:00:00,110,56,54,FMN GV 16 Berchem TOT
54,Posthofbrug 5366,2021-07-07,15:00:00,186,80,106,FMN GV 16 Berchem TOT
54,Posthofbrug 5366,2021-07-07,16:00:00,304,112,192,FMN GV 16 Berchem TOT
54,Posthofbrug 5366,2021-07-07,17:00:00,389,153,236,FMN GV 16 Berchem TOT
54,Posthofbrug 5366,2021-07-07,18:00:00,33,16,17,FMN GV 16 Berchem TOT
54,Posthofbrug 5366,2021-07-07,19:00:00,0,0,0,FMN GV 16 Berchem TOT
54,Posthofbrug 5366,2021-07-07,20:00:00,0,0,0,FMN GV 16 Berchem TOT
54,Posthofbrug 5366,2021-07-07,21:00:00,0,0,0,FMN GV 16 Berchem TOT
54,Posthofbrug 5366,2021-07-07,22:00:00,71,29,42,FMN GV 16 Berchem TOT
54,Posthofbrug 5366,2021-07-07,23:00:00,68,23,45,FMN GV 16 Berchem TOT
54,Posthofbrug 5366,2021-07-08,00:00:00,45,8,37,FMN GV 16 Berchem TOT
54,Posthofbrug 5366,2021-07-08,01:00:00,19,6,13,FMN GV 16 Berchem TOT
54,Posthofbrug 5366,2021-07-08,02:00:00,11,2,9,FMN GV 16 Berchem TOT
54,Posthofbrug 5366,2021-07-08,03:00:00,9,4,5,FMN GV 16 Berchem TOT
54,Posthofbrug 5366,2021-07-08,04:00:00,7,6,1,FMN GV 16 Berchem TOT
54,Posthofbrug 5366,2021-07-08,05:00:00,25,20,5,FMN GV 16 Berchem TOT
54,Posthofbrug 5366,2021-07-08,06:00:00,76,56,20,FMN GV 16 Berchem TOT
54,Posthofbrug 5366,2021-07-08,07:00:00,210,149,61,FMN GV 16 Berchem TOT
54,Posthofbrug 5366,2021-07-08,08:00:00,364,266,98,FMN GV 16 Berchem TOT
54,Posthofbrug 5366,2021-07-08,09:00:00,188,153,35,FMN GV 16 Berchem TOT
54,Posthofbrug 5366,2021-07-08,10:00:00,134,84,50,FMN GV 16 Berchem TOT
54,Posthofbrug 5366,2021-07-08,11:00:00,106,60,46,FMN GV 16 Berchem TOT
54,Posthofbrug 5366,2021-07-08,12:00:00,124,69,55,FMN GV 16 Berchem TOT
54,Posthofbrug 5366,2021-07-08,13:00:00,125,70,55,FMN GV 16 Berchem TOT
54,Posthofbrug 5366,2021-07-08,14:00:00,124,69,55,FMN GV 16 Berchem TOT
54,Posthofbrug 5366,2021-07-08,15:00:00,155,57,98,FMN GV 16 Berchem TOT
54,Posthofbrug 5366,2021-07-08,16:00:00,15,2,13,FMN GV 16 Berchem TOT
54,Posthofbrug 5366,2021-07-08,17:00:00,0,0,0,FMN GV 16 Berchem TOT
54,Posthofbrug 5366,2021-07-08,18:00:00,0,0,0,FMN GV 16 Berchem TOT
54,Posthofbrug 5366,2021-07-08,19:00:00,0,0,0,FMN GV 16 Berchem TOT
54,Posthofbrug 5366,2021-07-08,20:00:00,0,0,0,FMN GV 16 Berchem TOT
54,Posthofbrug 5366,2021-07-08,21:00:00,0,0,0,FMN GV 16 Berchem TOT
54,Posthofbrug 5366,2021-07-08,22:00:00,74,28,46,FMN GV 16 Berchem TOT
54,Posthofbrug 5366,2021-07-08,23:00:00,67,17,50,FMN GV 16 Berchem TOT
54,Posthofbrug 5366,2021-07-09,00:00:00,45,16,29,FMN GV 16 Berchem TOT
54,Posthofbrug 5366,2021-07-09,01:00:00,19,3,16,FMN GV 16 Berchem TOT
54,Posthofbrug 5366,2021-07-09,02:00:00,8,0,8,FMN GV 16 Berchem TOT
54,Posthofbrug 5366,2021-07-09,03:00:00,0,0,0,FMN GV 16 Berchem TOT
54,Posthofbrug 5366,2021-07-09,04:00:00,12,4,8,FMN GV 16 Berchem TOT
54,Posthofbrug 5366,2021-07-09,05:00:00,11,9,2,FMN GV 16 Berchem TOT
54,Posthofbrug 5366,2021-07-09,06:00:00,78,65,13,FMN GV 16 Berchem TOT
54,Posthofbrug 5366,2021-07-09,07:00:00,183,127,56,FMN GV 16 Berchem TOT
54,Posthofbrug 5366,2021-07-09,08:00:00,283,200,83,FMN GV 16 Berchem TOT
54,Posthofbrug 5366,2021-07-09,09:00:00,145,108,37,FMN GV 16 Berchem TOT
54,Posthofbrug 5366,2021-07-09,10:00:00,132,86,46,FMN GV 16 Berchem TOT
54,Posthofbrug 5366,2021-07-09,11:00:00,124,70,54,FMN GV 16 Berchem TOT
54,Posthofbrug 5366,2021-07-09,12:00:00,165,97,68,FMN GV 16 Berchem TOT
54,Posthofbrug 5366,2021-07-09,13:00:00,154,87,67,FMN GV 16 Berchem TOT
54,Posthofbrug 5366,2021-07-09,14:00:00,168,94,74,FMN GV 16 Berchem TOT
54,Posthofbrug 5366,2021-07-09,15:00:00,198,88,110,FMN GV 16 Berchem TOT
54,Posthofbrug 5366,2021-07-09,16:00:00,281,130,151,FMN GV 16 Berchem TOT
54,Posthofbrug 5366,2021-07-09,17:00:00,326,128,198,FMN GV 16 Berchem TOT
54,Posthofbrug 5366,2021-07-09,18:00:00,245,103,142,FMN GV 16 Berchem TOT
54,Posthofbrug 5366,2021-07-09,19:00:00,165,81,84,FMN GV 16 Berchem TOT
54,Posthofbrug 5366,2021-07-09,20:00:00,110,61,49,FMN GV 16 Berchem TOT
54,Posthofbrug 5366,2021-07-09,21:00:00,86,46,40,FMN GV 16 Berchem TOT
54,Posthofbrug 5366,2021-07-09,22:00:00,73,29,44,FMN GV 16 Berchem TOT
54,Posthofbrug 5366,2021-07-09,23:00:00,70,26,44,FMN GV 16 Berchem TOT
54,Posthofbrug 5366,2021-07-10,00:00:00,62,20,42,FMN GV 16 Berchem TOT
54,Posthofbrug 5366,2021-07-10,01:00:00,48,15,33,FMN GV 16 Berchem TOT
54,Posthofbrug 5366,2021-07-10,02:00:00,16,1,15,FMN GV 16 Berchem TOT
54,Posthofbrug 5366,2021-07-10,03:00:00,14,3,11,FMN GV 16 Berchem TOT
54,Posthofbrug 5366,2021-07-10,04:00:00,9,3,6,FMN GV 16 Berchem TOT
54,Posthofbrug 5366,2021-07-10,05:00:00,14,8,6,FMN GV 16 Berchem TOT
54,Posthofbrug 5366,2021-07-10,06:00:00,14,10,4,FMN GV 16 Berchem TOT
54,Posthofbrug 5366,2021-07-10,07:00:00,21,12,9,FMN GV 16 Berchem TOT
54,Posthofbrug 5366,2021-07-10,08:00:00,52,29,23,FMN GV 16 Berchem TOT
54,Posthofbrug 5366,2021-07-10,09:00:00,80,55,25,FMN GV 16 Berchem TOT
54,Posthofbrug 5366,2021-07-10,10:00:00,141,92,49,FMN GV 16 Berchem TOT
54,Posthofbrug 5366,2021-07-10,11:00:00,113,67,46,FMN GV 16 Berchem TOT
54,Posthofbrug 5366,2021-07-10,12:00:00,131,78,53,FMN GV 16 Berchem TOT
54,Posthofbrug 5366,2021-07-10,13:00:00,119,70,49,FMN GV 16 Berchem TOT
54,Posthofbrug 5366,2021-07-10,14:00:00,122,67,55,FMN GV 16 Berchem TOT
54,Posthofbrug 5366,2021-07-10,15:00:00,130,60,70,FMN GV 16 Berchem TOT
54,Posthofbrug 5366,2021-07-10,16:00:00,95,48,47,FMN GV 16 Berchem TOT
54,Posthofbrug 5366,2021-07-10,17:00:00,88,21,67,FMN GV 16 Berchem TOT
54,Posthofbrug 5366,2021-07-10,18:00:00,66,26,40,FMN GV 16 Berchem TOT
54,Posthofbrug 5366,2021-07-10,19:00:00,47,25,22,FMN GV 16 Berchem TOT
54,Posthofbrug 5366,2021-07-10,20:00:00,34,15,19,FMN GV 16 Berchem TOT
54,Posthofbrug 5366,2021-07-10,21:00:00,41,26,15,FMN GV 16 Berchem TOT
54,Posthofbrug 5366,2021-07-10,22:00:00,39,15,24,FMN GV 16 Berchem TOT
54,Posthofbrug 5366,2021-07-10,23:00:00,38,26,12,FMN GV 16 Berchem TOT
54,Posthofbrug 5366,2021-07-11,00:00:00,21,9,12,FMN GV 16 Berchem TOT
54,Posthofbrug 5366,2021-07-11,01:00:00,29,6,23,FMN GV 16 Berchem TOT
54,Posthofbrug 5366,2021-07-11,02:00:00,10,1,9,FMN GV 16 Berchem TOT
54,Posthofbrug 5366,2021-07-11,03:00:00,5,2,3,FMN GV 16 Berchem TOT
54,Posthofbrug 5366,2021-07-11,04:00:00,6,5,1,FMN GV 16 Berchem TOT
54,Posthofbrug 5366,2021-07-11,05:00:00,7,5,2,FMN GV 16 Berchem TOT
54,Posthofbrug 5366,2021-07-11,06:00:00,17,14,3,FMN GV 16 Berchem TOT
54,Posthofbrug 5366,2021-07-11,07:00:00,15,11,4,FMN GV 16 Berchem TOT
54,Posthofbrug 5366,2021-07-11,08:00:00,37,20,17,FMN GV 16 Berchem TOT
54,Posthofbrug 5366,2021-07-11,09:00:00,92,56,36,FMN GV 16 Berchem TOT
54,Posthofbrug 5366,2021-07-11,10:00:00,130,65,65,FMN GV 16 Berchem TOT
54,Posthofbrug 5366,2021-07-11,11:00:00,143,87,56,FMN GV 16 Berchem TOT
54,Posthofbrug 5366,2021-07-11,12:00:00,203,114,89,FMN GV 16 Berchem TOT
54,Posthofbrug 5366,2021-07-11,13:00:00,190,94,96,FMN GV 16 Berchem TOT
54,Posthofbrug 5366,2021-07-11,14:00:00,202,110,92,FMN GV 16 Berchem TOT
54,Posthofbrug 5366,2021-07-11,15:00:00,180,92,88,FMN GV 16 Berchem TOT
54,Posthofbrug 5366,2021-07-11,16:00:00,181,85,96,FMN GV 16 Berchem TOT
54,Posthofbrug 5366,2021-07-11,17:00:00,157,82,75,FMN GV 16 Berchem TOT
54,Posthofbrug 5366,2021-07-11,18:00:00,184,80,104,FMN GV 16 Berchem TOT
54,Posthofbrug 5366,2021-07-11,19:00:00,120,64,56,FMN GV 16 Berchem TOT
54,Posthofbrug 5366,2021-07-11,20:00:00,104,50,54,FMN GV 16 Berchem TOT
54,Posthofbrug 5366,2021-07-11,21:00:00,75,36,39,FMN GV 16 Berchem TOT
54,Posthofbrug 5366,2021-07-11,22:00:00,46,24,22,FMN GV 16 Berchem TOT
54,Posthofbrug 5366,2021-07-11,23:00:00,27,15,12,FMN GV 16 Berchem TOT
54,Posthofbrug 5366,2021-07-12,00:00:00,64,28,36,FMN GV 16 Berchem TOT
54,Posthofbrug 5366,2021-07-12,01:00:00,24,7,17,FMN GV 16 Berchem TOT
54,Posthofbrug 5366,2021-07-12,02:00:00,7,1,6,FMN GV 16 Berchem TOT
54,Posthofbrug 5366,2021-07-12,03:00:00,11,6,5,FMN GV 16 Berchem TOT
54,Posthofbrug 5366,2021-07-12,04:00:00,8,6,2,FMN GV 16 Berchem TOT
54,Posthofbrug 5366,2021-07-12,05:00:00,17,13,4,FMN GV 16 Berchem TOT
54,Posthofbrug 5366,2021-07-12,06:00:00,63,50,13,FMN GV 16 Berchem TOT
54,Posthofbrug 5366,2021-07-12,07:00:00,213,155,58,FMN GV 16 Berchem TOT
54,Posthofbrug 5366,2021-07-12,08:00:00,288,197,91,FMN GV 16 Berchem TOT
54,Posthofbrug 5366,2021-07-12,09:00:00,134,103,31,FMN GV 16 Berchem TOT
54,Posthofbrug 5366,2021-07-12,10:00:00,129,78,51,FMN GV 16 Berchem TOT
54,Posthofbrug 5366,2021-07-12,11:00:00,112,64,48,FMN GV 16 Berchem TOT
54,Posthofbrug 5366,2021-07-12,12:00:00,131,75,56,FMN GV 16 Berchem TOT
54,Posthofbrug 5366,2021-07-12,13:00:00,115,71,44,FMN GV 16 Berchem TOT
54,Posthofbrug 5366,2021-07-12,14:00:00,140,68,72,FMN GV 16 Berchem TOT
54,Posthofbrug 5366,2021-07-12,15:00:00,163,87,76,FMN GV 16 Berchem TOT
54,Posthofbrug 5366,2021-07-12,16:00:00,196,63,133,FMN GV 16 Berchem TOT
54,Posthofbrug 5366,2021-07-12,17:00:00,337,107,230,FMN GV 16 Berchem TOT
54,Posthofbrug 5366,2021-07-12,18:00:00,228,69,159,FMN GV 16 Berchem TOT
54,Posthofbrug 5366,2021-07-12,19:00:00,102,45,57,FMN GV 16 Berchem TOT
54,Posthofbrug 5366,2021-07-12,20:00:00,100,44,56,FMN GV 16 Berchem TOT
54,Posthofbrug 5366,2021-07-12,21:00:00,67,30,37,FMN GV 16 Berchem TOT
54,Posthofbrug 5366,2021-07-12,22:00:00,63,25,38,FMN GV 16 Berchem TOT
54,Posthofbrug 5366,2021-07-12,23:00:00,41,15,26,FMN GV 16 Berchem TOT
54,Posthofbrug 5366,2021-07-13,00:00:00,21,5,16,FMN GV 16 Berchem TOT
54,Posthofbrug 5366,2021-07-13,01:00:00,17,6,11,FMN GV 16 Berchem TOT
54,Posthofbrug 5366,2021-07-13,02:00:00,3,1,2,FMN GV 16 Berchem TOT
54,Posthofbrug 5366,2021-07-13,03:00:00,4,3,1,FMN GV 16 Berchem TOT
54,Posthofbrug 5366,2021-07-13,04:00:00,7,6,1,FMN GV 16 Berchem TOT
54,Posthofbrug 5366,2021-07-13,05:00:00,12,8,4,FMN GV 16 Berchem TOT
54,Posthofbrug 5366,2021-07-13,06:00:00,70,55,15,FMN GV 16 Berchem TOT
54,Posthofbrug 5366,2021-07-13,07:00:00,188,135,53,FMN GV 16 Berchem TOT
54,Posthofbrug 5366,2021-07-13,08:00:00,264,184,80,FMN GV 16 Berchem TOT
54,Posthofbrug 5366,2021-07-13,09:00:00,131,103,28,FMN GV 16 Berchem TOT
54,Posthofbrug 5366,2021-07-13,10:00:00,85,56,29,FMN GV 16 Berchem TOT
54,Posthofbrug 5366,2021-07-13,11:00:00,80,47,33,FMN GV 16 Berchem TOT
54,Posthofbrug 5366,2021-07-13,12:00:00,105,62,43,FMN GV 16 Berchem TOT
54,Posthofbrug 5366,2021-07-13,13:00:00,95,44,51,FMN GV 16 Berchem TOT
54,Posthofbrug 5366,2021-07-13,14:00:00,70,37,33,FMN GV 16 Berchem TOT
54,Posthofbrug 5366,2021-07-13,15:00:00,125,50,75,FMN GV 16 Berchem TOT
54,Posthofbrug 5366,2021-07-13,16:00:00,188,78,110,FMN GV 16 Berchem TOT
54,Posthofbrug 5366,2021-07-13,17:00:00,283,96,187,FMN GV 16 Berchem TOT
54,Posthofbrug 5366,2021-07-13,18:00:00,168,61,107,FMN GV 16 Berchem TOT
54,Posthofbrug 5366,2021-07-13,19:00:00,116,48,68,FMN GV 16 Berchem TOT
54,Posthofbrug 5366,2021-07-13,20:00:00,81,35,46,FMN GV 16 Berchem TOT
54,Posthofbrug 5366,2021-07-13,21:00:00,73,36,37,FMN GV 16 Berchem TOT
54,Posthofbrug 5366,2021-07-13,22:00:00,58,28,30,FMN GV 16 Berchem TOT
54,Posthofbrug 5366,2021-07-13,23:00:00,22,10,12,FMN GV 16 Berchem TOT
54,Posthofbrug 5366,2021-07-14,00:00:00,21,6,15,FMN GV 16 Berchem TOT
54,Posthofbrug 5366,2021-07-14,01:00:00,17,4,13,FMN GV 16 Berchem TOT
54,Posthofbrug 5366,2021-07-14,02:00:00,4,0,4,FMN GV 16 Berchem TOT
54,Posthofbrug 5366,2021-07-14,03:00:00,2,0,2,FMN GV 16 Berchem TOT
54,Posthofbrug 5366,2021-07-14,04:00:00,10,7,3,FMN GV 16 Berchem TOT
54,Posthofbrug 5366,2021-07-14,05:00:00,18,13,5,FMN GV 16 Berchem TOT
54,Posthofbrug 5366,2021-07-14,06:00:00,60,49,11,FMN GV 16 Berchem TOT
54,Posthofbrug 5366,2021-07-14,07:00:00,154,110,44,FMN GV 16 Berchem TOT
54,Posthofbrug 5366,2021-07-14,08:00:00,228,151,77,FMN GV 16 Berchem TOT
54,Posthofbrug 5366,2021-07-14,09:00:00,135,103,32,FMN GV 16 Berchem TOT
54,Posthofbrug 5366,2021-07-14,10:00:00,2,2,0,FMN GV 16 Berchem TOT
54,Posthofbrug 5366,2021-07-14,11:00:00,0,0,0,FMN GV 16 Berchem TOT
54,Posthofbrug 5366,2021-07-14,12:00:00,0,0,0,FMN GV 16 Berchem TOT
54,Posthofbrug 5366,2021-07-14,13:00:00,0,0,0,FMN GV 16 Berchem TOT
54,Posthofbrug 5366,2021-07-14,14:00:00,0,0,0,FMN GV 16 Berchem TOT
54,Posthofbrug 5366,2021-07-14,15:00:00,0,0,0,FMN GV 16 Berchem TOT
54,Posthofbrug 5366,2021-07-14,16:00:00,0,0,0,FMN GV 16 Berchem TOT
54,Posthofbrug 5366,2021-07-14,17:00:00,0,0,0,FMN GV 16 Berchem TOT
54,Posthofbrug 5366,2021-07-14,18:00:00,166,65,101,FMN GV 16 Berchem TOT
54,Posthofbrug 5366,2021-07-14,19:00:00,93,41,52,FMN GV 16 Berchem TOT
54,Posthofbrug 5366,2021-07-14,20:00:00,69,39,30,FMN GV 16 Berchem TOT
54,Posthofbrug 5366,2021-07-14,21:00:00,38,21,17,FMN GV 16 Berchem TOT
54,Posthofbrug 5366,2021-07-14,22:00:00,60,26,34,FMN GV 16 Berchem TOT
54,Posthofbrug 5366,2021-07-14,23:00:00,35,13,22,FMN GV 16 Berchem TOT
54,Posthofbrug 5366,2021-07-15,00:00:00,10,3,7,FMN GV 16 Berchem TOT
54,Posthofbrug 5366,2021-07-15,01:00:00,19,2,17,FMN GV 16 Berchem TOT
54,Posthofbrug 5366,2021-07-15,02:00:00,15,1,14,FMN GV 16 Berchem TOT
54,Posthofbrug 5366,2021-07-15,03:00:00,2,1,1,FMN GV 16 Berchem TOT
54,Posthofbrug 5366,2021-07-15,04:00:00,6,2,4,FMN GV 16 Berchem TOT
54,Posthofbrug 5366,2021-07-15,05:00:00,13,7,6,FMN GV 16 Berchem TOT
54,Posthofbrug 5366,2021-07-15,06:00:00,45,34,11,FMN GV 16 Berchem TOT
54,Posthofbrug 5366,2021-07-15,07:00:00,146,110,36,FMN GV 16 Berchem TOT
54,Posthofbrug 5366,2021-07-15,08:00:00,201,141,60,FMN GV 16 Berchem TOT
54,Posthofbrug 5366,2021-07-15,09:00:00,96,68,28,FMN GV 16 Berchem TOT
54,Posthofbrug 5366,2021-07-15,10:00:00,31,19,12,FMN GV 16 Berchem TOT
54,Posthofbrug 5366,2021-07-15,11:00:00,46,23,23,FMN GV 16 Berchem TOT
54,Posthofbrug 5366,2021-07-15,12:00:00,73,42,31,FMN GV 16 Berchem TOT
54,Posthofbrug 5366,2021-07-15,13:00:00,46,23,23,FMN GV 16 Berchem TOT
54,Posthofbrug 5366,2021-07-15,14:00:00,56,26,30,FMN GV 16 Berchem TOT
54,Posthofbrug 5366,2021-07-15,15:00:00,69,29,40,FMN GV 16 Berchem TOT
54,Posthofbrug 5366,2021-07-15,16:00:00,137,65,72,FMN GV 16 Berchem TOT
54,Posthofbrug 5366,2021-07-15,17:00:00,172,58,114,FMN GV 16 Berchem TOT
54,Posthofbrug 5366,2021-07-15,18:00:00,101,28,73,FMN GV 16 Berchem TOT
54,Posthofbrug 5366,2021-07-15,19:00:00,53,15,38,FMN GV 16 Berchem TOT
54,Posthofbrug 5366,2021-07-15,20:00:00,32,15,17,FMN GV 16 Berchem TOT
54,Posthofbrug 5366,2021-07-15,21:00:00,29,15,14,FMN GV 16 Berchem TOT
54,Posthofbrug 5366,2021-07-15,22:00:00,25,12,13,FMN GV 16 Berchem TOT
54,Posthofbrug 5366,2021-07-15,23:00:00,39,13,26,FMN GV 16 Berchem TOT
54,Posthofbrug 5366,2021-07-16,00:00:00,16,6,10,FMN GV 16 Berchem TOT
54,Posthofbrug 5366,2021-07-16,01:00:00,8,2,6,FMN GV 16 Berchem TOT
54,Posthofbrug 5366,2021-07-16,02:00:00,5,1,4,FMN GV 16 Berchem TOT
54,Posthofbrug 5366,2021-07-16,03:00:00,3,2,1,FMN GV 16 Berchem TOT
54,Posthofbrug 5366,2021-07-16,04:00:00,10,7,3,FMN GV 16 Berchem TOT
54,Posthofbrug 5366,2021-07-16,05:00:00,16,12,4,FMN GV 16 Berchem TOT
54,Posthofbrug 5366,2021-07-16,06:00:00,61,41,20,FMN GV 16 Berchem TOT
54,Posthofbrug 5366,2021-07-16,07:00:00,148,100,48,FMN GV 16 Berchem TOT
54,Posthofbrug 5366,2021-07-16,08:00:00,211,155,56,FMN GV 16 Berchem TOT
54,Posthofbrug 5366,2021-07-16,09:00:00,128,103,25,FMN GV 16 Berchem TOT
54,Posthofbrug 5366,2021-07-16,10:00:00,119,69,50,FMN GV 16 Berchem TOT
54,Posthofbrug 5366,2021-07-16,11:00:00,137,78,59,FMN GV 16 Berchem TOT
54,Posthofbrug 5366,2021-07-16,12:00:00,136,80,56,FMN GV 16 Berchem TOT
54,Posthofbrug 5366,2021-07-16,13:00:00,149,78,71,FMN GV 16 Berchem TOT
54,Posthofbrug 5366,2021-07-16,14:00:00,167,88,79,FMN GV 16 Berchem TOT
54,Posthofbrug 5366,2021-07-16,15:00:00,173,82,91,FMN GV 16 Berchem TOT
54,Posthofbrug 5366,2021-07-16,16:00:00,242,92,150,FMN GV 16 Berchem TOT
54,Posthofbrug 5366,2021-07-16,17:00:00,272,133,139,FMN GV 16 Berchem TOT
54,Posthofbrug 5366,2021-07-16,18:00:00,188,90,98,FMN GV 16 Berchem TOT
54,Posthofbrug 5366,2021-07-16,19:00:00,159,65,94,FMN GV 16 Berchem TOT
54,Posthofbrug 5366,2021-07-16,20:00:00,106,50,56,FMN GV 16 Berchem TOT
54,Posthofbrug 5366,2021-07-16,21:00:00,84,49,35,FMN GV 16 Berchem TOT
54,Posthofbrug 5366,2021-07-16,22:00:00,90,37,53,FMN GV 16 Berchem TOT
54,Posthofbrug 5366,2021-07-16,23:00:00,55,21,34,FMN GV 16 Berchem TOT
54,Posthofbrug 5366,2021-07-17,00:00:00,54,16,38,FMN GV 16 Berchem TOT
54,Posthofbrug 5366,2021-07-17,01:00:00,36,10,26,FMN GV 16 Berchem TOT
54,Posthofbrug 5366,2021-07-17,02:00:00,12,4,8,FMN GV 16 Berchem TOT
54,Posthofbrug 5366,2021-07-17,03:00:00,10,3,7,FMN GV 16 Berchem TOT
54,Posthofbrug 5366,2021-07-17,04:00:00,16,3,13,FMN GV 16 Berchem TOT
54,Posthofbrug 5366,2021-07-17,05:00:00,12,10,2,FMN GV 16 Berchem TOT
54,Posthofbrug 5366,2021-07-17,06:00:00,13,9,4,FMN GV 16 Berchem TOT
54,Posthofbrug 5366,2021-07-17,07:00:00,28,22,6,FMN GV 16 Berchem TOT
54,Posthofbrug 5366,2021-07-17,08:00:00,47,28,19,FMN GV 16 Berchem TOT
54,Posthofbrug 5366,2021-07-17,09:00:00,103,67,36,FMN GV 16 Berchem TOT
54,Posthofbrug 5366,2021-07-17,10:00:00,124,81,43,FMN GV 16 Berchem TOT
54,Posthofbrug 5366,2021-07-17,11:00:00,157,96,61,FMN GV 16 Berchem TOT
54,Posthofbrug 5366,2021-07-17,12:00:00,188,113,75,FMN GV 16 Berchem TOT
54,Posthofbrug 5366,2021-07-17,13:00:00,181,109,72,FMN GV 16 Berchem TOT
54,Posthofbrug 5366,2021-07-17,14:00:00,210,112,98,FMN GV 16 Berchem TOT
54,Posthofbrug 5366,2021-07-17,15:00:00,252,129,123,FMN GV 16 Berchem TOT
54,Posthofbrug 5366,2021-07-17,16:00:00,197,103,94,FMN GV 16 Berchem TOT
54,Posthofbrug 5366,2021-07-17,17:00:00,165,80,85,FMN GV 16 Berchem TOT
54,Posthofbrug 5366,2021-07-17,18:00:00,163,66,97,FMN GV 16 Berchem TOT
54,Posthofbrug 5366,2021-07-17,19:00:00,108,43,65,FMN GV 16 Berchem TOT
54,Posthofbrug 5366,2021-07-17,20:00:00,133,54,79,FMN GV 16 Berchem TOT
54,Posthofbrug 5366,2021-07-17,21:00:00,79,37,42,FMN GV 16 Berchem TOT
54,Posthofbrug 5366,2021-07-17,22:00:00,80,34,46,FMN GV 16 Berchem TOT
54,Posthofbrug 5366,2021-07-17,23:00:00,65,31,34,FMN GV 16 Berchem TOT
54,Posthofbrug 5366,2021-07-18,00:00:00,40,10,30,FMN GV 16 Berchem TOT
54,Posthofbrug 5366,2021-07-18,01:00:00,36,17,19,FMN GV 16 Berchem TOT
54,Posthofbrug 5366,2021-07-18,02:00:00,13,1,12,FMN GV 16 Berchem TOT
54,Posthofbrug 5366,2021-07-18,03:00:00,12,3,9,FMN GV 16 Berchem TOT
54,Posthofbrug 5366,2021-07-18,04:00:00,8,5,3,FMN GV 16 Berchem TOT
54,Posthofbrug 5366,2021-07-18,05:00:00,8,4,4,FMN GV 16 Berchem TOT
54,Posthofbrug 5366,2021-07-18,06:00:00,21,14,7,FMN GV 16 Berchem TOT
54,Posthofbrug 5366,2021-07-18,07:00:00,27,14,13,FMN GV 16 Berchem TOT
54,Posthofbrug 5366,2021-07-18,08:00:00,50,29,21,FMN GV 16 Berchem TOT
54,Posthofbrug 5366,2021-07-18,09:00:00,69,41,28,FMN GV 16 Berchem TOT
54,Posthofbrug 5366,2021-07-18,10:00:00,136,90,46,FMN GV 16 Berchem TOT
54,Posthofbrug 5366,2021-07-18,11:00:00,178,104,74,FMN GV 16 Berchem TOT
54,Posthofbrug 5366,2021-07-18,12:00:00,203,115,88,FMN GV 16 Berchem TOT
54,Posthofbrug 5366,2021-07-18,13:00:00,207,131,76,FMN GV 16 Berchem TOT
54,Posthofbrug 5366,2021-07-18,14:00:00,238,134,104,FMN GV 16 Berchem TOT
54,Posthofbrug 5366,2021-07-18,15:00:00,199,94,105,FMN GV 16 Berchem TOT
54,Posthofbrug 5366,2021-07-18,16:00:00,202,88,114,FMN GV 16 Berchem TOT
54,Posthofbrug 5366,2021-07-18,17:00:00,170,83,87,FMN GV 16 Berchem TOT
54,Posthofbrug 5366,2021-07-18,18:00:00,131,56,75,FMN GV 16 Berchem TOT
54,Posthofbrug 5366,2021-07-18,19:00:00,133,66,67,FMN GV 16 Berchem TOT
54,Posthofbrug 5366,2021-07-18,20:00:00,111,49,62,FMN GV 16 Berchem TOT
54,Posthofbrug 5366,2021-07-18,21:00:00,90,42,48,FMN GV 16 Berchem TOT
54,Posthofbrug 5366,2021-07-18,22:00:00,60,22,38,FMN GV 16 Berchem TOT
54,Posthofbrug 5366,2021-07-18,23:00:00,41,18,23,FMN GV 16 Berchem TOT
54,Posthofbrug 5366,2021-07-19,00:00:00,18,8,10,FMN GV 16 Berchem TOT
54,Posthofbrug 5366,2021-07-19,01:00:00,11,3,8,FMN GV 16 Berchem TOT
54,Posthofbrug 5366,2021-07-19,02:00:00,7,1,6,FMN GV 16 Berchem TOT
54,Posthofbrug 5366,2021-07-19,03:00:00,4,2,2,FMN GV 16 Berchem TOT
54,Posthofbrug 5366,2021-07-19,04:00:00,2,2,0,FMN GV 16 Berchem TOT
54,Posthofbrug 5366,2021-07-19,05:00:00,30,24,6,FMN GV 16 Berchem TOT
54,Posthofbrug 5366,2021-07-19,06:00:00,73,56,17,FMN GV 16 Berchem TOT
54,Posthofbrug 5366,2021-07-19,07:00:00,197,144,53,FMN GV 16 Berchem TOT
54,Posthofbrug 5366,2021-07-19,08:00:00,275,203,72,FMN GV 16 Berchem TOT
54,Posthofbrug 5366,2021-07-19,09:00:00,160,110,50,FMN GV 16 Berchem TOT
54,Posthofbrug 5366,2021-07-19,10:00:00,106,75,31,FMN GV 16 Berchem TOT
54,Posthofbrug 5366,2021-07-19,11:00:00,161,118,43,FMN GV 16 Berchem TOT
54,Posthofbrug 5366,2021-07-19,12:00:00,142,85,57,FMN GV 16 Berchem TOT
54,Posthofbrug 5366,2021-07-19,13:00:00,127,68,59,FMN GV 16 Berchem TOT
54,Posthofbrug 5366,2021-07-19,14:00:00,169,89,80,FMN GV 16 Berchem TOT
54,Posthofbrug 5366,2021-07-19,15:00:00,155,55,100,FMN GV 16 Berchem TOT
54,Posthofbrug 5366,2021-07-19,16:00:00,281,101,180,FMN GV 16 Berchem TOT
54,Posthofbrug 5366,2021-07-19,17:00:00,319,109,210,FMN GV 16 Berchem TOT
54,Posthofbrug 5366,2021-07-19,18:00:00,231,80,151,FMN GV 16 Berchem TOT
54,Posthofbrug 5366,2021-07-19,19:00:00,137,61,76,FMN GV 16 Berchem TOT
54,Posthofbrug 5366,2021-07-19,20:00:00,124,50,74,FMN GV 16 Berchem TOT
54,Posthofbrug 5366,2021-07-19,21:00:00,73,37,36,FMN GV 16 Berchem TOT
54,Posthofbrug 5366,2021-07-19,22:00:00,68,24,44,FMN GV 16 Berchem TOT
54,Posthofbrug 5366,2021-07-19,23:00:00,43,23,20,FMN GV 16 Berchem TOT
54,Posthofbrug 5366,2021-07-20,00:00:00,9,3,6,FMN GV 16 Berchem TOT
54,Posthofbrug 5366,2021-07-20,01:00:00,14,1,13,FMN GV 16 Berchem TOT
54,Posthofbrug 5366,2021-07-20,02:00:00,4,0,4,FMN GV 16 Berchem TOT
54,Posthofbrug 5366,2021-07-20,03:00:00,4,3,1,FMN GV 16 Berchem TOT
54,Posthofbrug 5366,2021-07-20,04:00:00,11,8,3,FMN GV 16 Berchem TOT
54,Posthofbrug 5366,2021-07-20,05:00:00,18,13,5,FMN GV 16 Berchem TOT
54,Posthofbrug 5366,2021-07-20,06:00:00,78,65,13,FMN GV 16 Berchem TOT
54,Posthofbrug 5366,2021-07-20,07:00:00,175,125,50,FMN GV 16 Berchem TOT
54,Posthofbrug 5366,2021-07-20,08:00:00,290,204,86,FMN GV 16 Berchem TOT
54,Posthofbrug 5366,2021-07-20,09:00:00,163,122,41,FMN GV 16 Berchem TOT
54,Posthofbrug 5366,2021-07-20,10:00:00,104,74,30,FMN GV 16 Berchem TOT
54,Posthofbrug 5366,2021-07-20,11:00:00,145,89,56,FMN GV 16 Berchem TOT
54,Posthofbrug 5366,2021-07-20,12:00:00,153,97,56,FMN GV 16 Berchem TOT
54,Posthofbrug 5366,2021-07-20,13:00:00,171,101,70,FMN GV 16 Berchem TOT
54,Posthofbrug 5366,2021-07-20,14:00:00,200,110,90,FMN GV 16 Berchem TOT
54,Posthofbrug 5366,2021-07-20,15:00:00,178,76,102,FMN GV 16 Berchem TOT
54,Posthofbrug 5366,2021-07-20,16:00:00,262,110,152,FMN GV 16 Berchem TOT
54,Posthofbrug 5366,2021-07-20,17:00:00,346,114,232,FMN GV 16 Berchem TOT
54,Posthofbrug 5366,2021-07-20,18:00:00,232,93,139,FMN GV 16 Berchem TOT
54,Posthofbrug 5366,2021-07-20,19:00:00,180,81,99,FMN GV 16 Berchem TOT
54,Posthofbrug 5366,2021-07-20,20:00:00,128,59,69,FMN GV 16 Berchem TOT
54,Posthofbrug 5366,2021-07-20,21:00:00,98,59,39,FMN GV 16 Berchem TOT
54,Posthofbrug 5366,2021-07-20,22:00:00,79,45,34,FMN GV 16 Berchem TOT
54,Posthofbrug 5366,2021-07-20,23:00:00,71,23,48,FMN GV 16 Berchem TOT
54,Posthofbrug 5366,2021-07-21,00:00:00,47,9,38,FMN GV 16 Berchem TOT
54,Posthofbrug 5366,2021-07-21,01:00:00,37,8,29,FMN GV 16 Berchem TOT
54,Posthofbrug 5366,2021-07-21,02:00:00,17,4,13,FMN GV 16 Berchem TOT
54,Posthofbrug 5366,2021-07-21,03:00:00,9,3,6,FMN GV 16 Berchem TOT
54,Posthofbrug 5366,2021-07-21,04:00:00,6,2,4,FMN GV 16 Berchem TOT
54,Posthofbrug 5366,2021-07-21,05:00:00,7,3,4,FMN GV 16 Berchem TOT
54,Posthofbrug 5366,2021-07-21,06:00:00,18,13,5,FMN GV 16 Berchem TOT
54,Posthofbrug 5366,2021-07-21,07:00:00,37,22,15,FMN GV 16 Berchem TOT
54,Posthofbrug 5366,2021-07-21,08:00:00,56,37,19,FMN GV 16 Berchem TOT
54,Posthofbrug 5366,2021-07-21,09:00:00,110,65,45,FMN GV 16 Berchem TOT
54,Posthofbrug 5366,2021-07-21,10:00:00,155,97,58,FMN GV 16 Berchem TOT
54,Posthofbrug 5366,2021-07-21,11:00:00,204,127,77,FMN GV 16 Berchem TOT
54,Posthofbrug 5366,2021-07-21,12:00:00,168,99,69,FMN GV 16 Berchem TOT
54,Posthofbrug 5366,2021-07-21,13:00:00,215,116,99,FMN GV 16 Berchem TOT
54,Posthofbrug 5366,2021-07-21,14:00:00,240,134,106,FMN GV 16 Berchem TOT
54,Posthofbrug 5366,2021-07-21,15:00:00,202,94,108,FMN GV 16 Berchem TOT
54,Posthofbrug 5366,2021-07-21,16:00:00,204,79,125,FMN GV 16 Berchem TOT
54,Posthofbrug 5366,2021-07-21,17:00:00,178,79,99,FMN GV 16 Berchem TOT
54,Posthofbrug 5366,2021-07-21,18:00:00,143,70,73,FMN GV 16 Berchem TOT
54,Posthofbrug 5366,2021-07-21,19:00:00,127,71,56,FMN GV 16 Berchem TOT
54,Posthofbrug 5366,2021-07-21,20:00:00,118,60,58,FMN GV 16 Berchem TOT
54,Posthofbrug 5366,2021-07-21,21:00:00,75,44,31,FMN GV 16 Berchem TOT
54,Posthofbrug 5366,2021-07-21,22:00:00,88,33,55,FMN GV 16 Berchem TOT
54,Posthofbrug 5366,2021-07-21,23:00:00,49,21,28,FMN GV 16 Berchem TOT
54,Posthofbrug 5366,2021-07-22,00:00:00,27,14,13,FMN GV 16 Berchem TOT
54,Posthofbrug 5366,2021-07-22,01:00:00,14,3,11,FMN GV 16 Berchem TOT
54,Posthofbrug 5366,2021-07-22,02:00:00,5,1,4,FMN GV 16 Berchem TOT
54,Posthofbrug 5366,2021-07-22,03:00:00,2,2,0,FMN GV 16 Berchem TOT
54,Posthofbrug 5366,2021-07-22,04:00:00,6,5,1,FMN GV 16 Berchem TOT
54,Posthofbrug 5366,2021-07-22,05:00:00,22,15,7,FMN GV 16 Berchem TOT
54,Posthofbrug 5366,2021-07-22,06:00:00,74,56,18,FMN GV 16 Berchem TOT
54,Posthofbrug 5366,2021-07-22,07:00:00,175,113,62,FMN GV 16 Berchem TOT
54,Posthofbrug 5366,2021-07-22,08:00:00,252,186,66,FMN GV 16 Berchem TOT
54,Posthofbrug 5366,2021-07-22,09:00:00,168,126,42,FMN GV 16 Berchem TOT
54,Posthofbrug 5366,2021-07-22,10:00:00,133,92,41,FMN GV 16 Berchem TOT
54,Posthofbrug 5366,2021-07-22,11:00:00,179,119,60,FMN GV 16 Berchem TOT
54,Posthofbrug 5366,2021-07-22,12:00:00,175,122,53,FMN GV 16 Berchem TOT
54,Posthofbrug 5366,2021-07-22,13:00:00,183,84,99,FMN GV 16 Berchem TOT
54,Posthofbrug 5366,2021-07-22,14:00:00,135,62,73,FMN GV 16 Berchem TOT
54,Posthofbrug 5366,2021-07-22,15:00:00,162,74,88,FMN GV 16 Berchem TOT
54,Posthofbrug 5366,2021-07-22,16:00:00,280,104,176,FMN GV 16 Berchem TOT
54,Posthofbrug 5366,2021-07-22,17:00:00,328,115,213,FMN GV 16 Berchem TOT
54,Posthofbrug 5366,2021-07-22,18:00:00,259,112,147,FMN GV 16 Berchem TOT
54,Posthofbrug 5366,2021-07-22,19:00:00,158,60,98,FMN GV 16 Berchem TOT
54,Posthofbrug 5366,2021-07-22,20:00:00,113,58,55,FMN GV 16 Berchem TOT
54,Posthofbrug 5366,2021-07-22,21:00:00,93,47,46,FMN GV 16 Berchem TOT
54,Posthofbrug 5366,2021-07-22,22:00:00,86,40,46,FMN GV 16 Berchem TOT
54,Posthofbrug 5366,2021-07-22,23:00:00,50,20,30,FMN GV 16 Berchem TOT
54,Posthofbrug 5366,2021-07-23,00:00:00,32,15,17,FMN GV 16 Berchem TOT
54,Posthofbrug 5366,2021-07-23,01:00:00,26,2,24,FMN GV 16 Berchem TOT
54,Posthofbrug 5366,2021-07-23,02:00:00,4,2,2,FMN GV 16 Berchem TOT
54,Posthofbrug 5366,2021-07-23,03:00:00,0,0,0,FMN GV 16 Berchem TOT
54,Posthofbrug 5366,2021-07-23,04:00:00,6,6,0,FMN GV 16 Berchem TOT
54,Posthofbrug 5366,2021-07-23,05:00:00,22,19,3,FMN GV 16 Berchem TOT
54,Posthofbrug 5366,2021-07-23,06:00:00,64,49,15,FMN GV 16 Berchem TOT
54,Posthofbrug 5366,2021-07-23,07:00:00,136,92,44,FMN GV 16 Berchem TOT
54,Posthofbrug 5366,2021-07-23,08:00:00,235,180,55,FMN GV 16 Berchem TOT
54,Posthofbrug 5366,2021-07-23,09:00:00,139,105,34,FMN GV 16 Berchem TOT
54,Posthofbrug 5366,2021-07-23,10:00:00,131,69,62,FMN GV 16 Berchem TOT
54,Posthofbrug 5366,2021-07-23,11:00:00,139,93,46,FMN GV 16 Berchem TOT
54,Posthofbrug 5366,2021-07-23,12:00:00,171,96,75,FMN GV 16 Berchem TOT
54,Posthofbrug 5366,2021-07-23,13:00:00,134,76,58,FMN GV 16 Berchem TOT
54,Posthofbrug 5366,2021-07-23,14:00:00,162,84,78,FMN GV 16 Berchem TOT
54,Posthofbrug 5366,2021-07-23,15:00:00,212,101,111,FMN GV 16 Berchem TOT
54,Posthofbrug 5366,2021-07-23,16:00:00,270,104,166,FMN GV 16 Berchem TOT
54,Posthofbrug 5366,2021-07-23,17:00:00,275,88,187,FMN GV 16 Berchem TOT
54,Posthofbrug 5366,2021-07-23,18:00:00,208,79,129,FMN GV 16 Berchem TOT
54,Posthofbrug 5366,2021-07-23,19:00:00,177,88,89,FMN GV 16 Berchem TOT
54,Posthofbrug 5366,2021-07-23,20:00:00,114,52,62,FMN GV 16 Berchem TOT
54,Posthofbrug 5366,2021-07-23,21:00:00,111,55,56,FMN GV 16 Berchem TOT
54,Posthofbrug 5366,2021-07-23,22:00:00,77,37,40,FMN GV 16 Berchem TOT
54,Posthofbrug 5366,2021-07-23,23:00:00,56,22,34,FMN GV 16 Berchem TOT
54,Posthofbrug 5366,2021-07-24,00:00:00,49,29,20,FMN GV 16 Berchem TOT
54,Posthofbrug 5366,2021-07-24,01:00:00,37,14,23,FMN GV 16 Berchem TOT
54,Posthofbrug 5366,2021-07-24,02:00:00,19,6,13,FMN GV 16 Berchem TOT
54,Posthofbrug 5366,2021-07-24,03:00:00,11,0,11,FMN GV 16 Berchem TOT
54,Posthofbrug 5366,2021-07-24,04:00:00,16,3,13,FMN GV 16 Berchem TOT
54,Posthofbrug 5366,2021-07-24,05:00:00,16,10,6,FMN GV 16 Berchem TOT
54,Posthofbrug 5366,2021-07-24,06:00:00,22,17,5,FMN GV 16 Berchem TOT
54,Posthofbrug 5366,2021-07-24,07:00:00,27,16,11,FMN GV 16 Berchem TOT
54,Posthofbrug 5366,2021-07-24,08:00:00,36,18,18,FMN GV 16 Berchem TOT
54,Posthofbrug 5366,2021-07-24,09:00:00,82,52,30,FMN GV 16 Berchem TOT
54,Posthofbrug 5366,2021-07-24,10:00:00,82,46,36,FMN GV 16 Berchem TOT
54,Posthofbrug 5366,2021-07-24,11:00:00,107,61,46,FMN GV 16 Berchem TOT
54,Posthofbrug 5366,2021-07-24,12:00:00,108,71,37,FMN GV 16 Berchem TOT
54,Posthofbrug 5366,2021-07-24,13:00:00,100,75,25,FMN GV 16 Berchem TOT
54,Posthofbrug 5366,2021-07-24,14:00:00,93,42,51,FMN GV 16 Berchem TOT
54,Posthofbrug 5366,2021-07-24,15:00:00,93,48,45,FMN GV 16 Berchem TOT
54,Posthofbrug 5366,2021-07-24,16:00:00,83,43,40,FMN GV 16 Berchem TOT
54,Posthofbrug 5366,2021-07-24,17:00:00,96,42,54,FMN GV 16 Berchem TOT
54,Posthofbrug 5366,2021-07-24,18:00:00,92,37,55,FMN GV 16 Berchem TOT
54,Posthofbrug 5366,2021-07-24,19:00:00,46,21,25,FMN GV 16 Berchem TOT
54,Posthofbrug 5366,2021-07-24,20:00:00,49,23,26,FMN GV 16 Berchem TOT
54,Posthofbrug 5366,2021-07-24,21:00:00,23,7,16,FMN GV 16 Berchem TOT
54,Posthofbrug 5366,2021-07-24,22:00:00,41,18,23,FMN GV 16 Berchem TOT
54,Posthofbrug 5366,2021-07-24,23:00:00,24,10,14,FMN GV 16 Berchem TOT
54,Posthofbrug 5366,2021-07-25,00:00:00,17,5,12,FMN GV 16 Berchem TOT
54,Posthofbrug 5366,2021-07-25,01:00:00,24,6,18,FMN GV 16 Berchem TOT
54,Posthofbrug 5366,2021-07-25,02:00:00,13,7,6,FMN GV 16 Berchem TOT
54,Posthofbrug 5366,2021-07-25,03:00:00,7,3,4,FMN GV 16 Berchem TOT
54,Posthofbrug 5366,2021-07-25,04:00:00,7,3,4,FMN GV 16 Berchem TOT
54,Posthofbrug 5366,2021-07-25,05:00:00,6,4,2,FMN GV 16 Berchem TOT
54,Posthofbrug 5366,2021-07-25,06:00:00,12,9,3,FMN GV 16 Berchem TOT
54,Posthofbrug 5366,2021-07-25,07:00:00,16,8,8,FMN GV 16 Berchem TOT
54,Posthofbrug 5366,2021-07-25,08:00:00,35,21,14,FMN GV 16 Berchem TOT
54,Posthofbrug 5366,2021-07-25,09:00:00,91,56,35,FMN GV 16 Berchem TOT
54,Posthofbrug 5366,2021-07-25,10:00:00,123,73,50,FMN GV 16 Berchem TOT
54,Posthofbrug 5366,2021-07-25,11:00:00,149,73,76,FMN GV 16 Berchem TOT
54,Posthofbrug 5366,2021-07-25,12:00:00,114,67,47,FMN GV 16 Berchem TOT
54,Posthofbrug 5366,2021-07-25,13:00:00,117,58,59,FMN GV 16 Berchem TOT
54,Posthofbrug 5366,2021-07-25,14:00:00,68,34,34,FMN GV 16 Berchem TOT
54,Posthofbrug 5366,2021-07-25,15:00:00,112,48,64,FMN GV 16 Berchem TOT
54,Posthofbrug 5366,2021-07-25,16:00:00,99,45,54,FMN GV 16 Berchem TOT
54,Posthofbrug 5366,2021-07-25,17:00:00,108,59,49,FMN GV 16 Berchem TOT
54,Posthofbrug 5366,2021-07-25,18:00:00,92,56,36,FMN GV 16 Berchem TOT
54,Posthofbrug 5366,2021-07-25,19:00:00,77,24,53,FMN GV 16 Berchem TOT
54,Posthofbrug 5366,2021-07-25,20:00:00,80,39,41,FMN GV 16 Berchem TOT
54,Posthofbrug 5366,2021-07-25,21:00:00,44,25,19,FMN GV 16 Berchem TOT
54,Posthofbrug 5366,2021-07-25,22:00:00,56,27,29,FMN GV 16 Berchem TOT
54,Posthofbrug 5366,2021-07-25,23:00:00,17,8,9,FMN GV 16 Berchem TOT
54,Posthofbrug 5366,2021-07-26,00:00:00,9,4,5,FMN GV 16 Berchem TOT
54,Posthofbrug 5366,2021-07-26,01:00:00,12,1,11,FMN GV 16 Berchem TOT
54,Posthofbrug 5366,2021-07-26,02:00:00,4,3,1,FMN GV 16 Berchem TOT
54,Posthofbrug 5366,2021-07-26,03:00:00,3,1,2,FMN GV 16 Berchem TOT
54,Posthofbrug 5366,2021-07-26,04:00:00,11,9,2,FMN GV 16 Berchem TOT
54,Posthofbrug 5366,2021-07-26,05:00:00,19,11,8,FMN GV 16 Berchem TOT
54,Posthofbrug 5366,2021-07-26,06:00:00,78,63,15,FMN GV 16 Berchem TOT
54,Posthofbrug 5366,2021-07-26,07:00:00,176,121,55,FMN GV 16 Berchem TOT
54,Posthofbrug 5366,2021-07-26,08:00:00,255,180,75,FMN GV 16 Berchem TOT
54,Posthofbrug 5366,2021-07-26,09:00:00,141,101,40,FMN GV 16 Berchem TOT
54,Posthofbrug 5366,2021-07-26,10:00:00,5,5,0,FMN GV 16 Berchem TOT
54,Posthofbrug 5366,2021-07-26,11:00:00,0,0,0,FMN GV 16 Berchem TOT
54,Posthofbrug 5366,2021-07-26,12:00:00,0,0,0,FMN GV 16 Berchem TOT
54,Posthofbrug 5366,2021-07-26,13:00:00,0,0,0,FMN GV 16 Berchem TOT
54,Posthofbrug 5366,2021-07-26,14:00:00,0,0,0,FMN GV 16 Berchem TOT
54,Posthofbrug 5366,2021-07-26,15:00:00,0,0,0,FMN GV 16 Berchem TOT
54,Posthofbrug 5366,2021-07-26,16:00:00,0,0,0,FMN GV 16 Berchem TOT
54,Posthofbrug 5366,2021-07-26,17:00:00,0,0,0,FMN GV 16 Berchem TOT
54,Posthofbrug 5366,2021-07-26,18:00:00,143,41,102,FMN GV 16 Berchem TOT
54,Posthofbrug 5366,2021-07-26,19:00:00,88,35,53,FMN GV 16 Berchem TOT
54,Posthofbrug 5366,2021-07-26,20:00:00,54,30,24,FMN GV 16 Berchem TOT
54,Posthofbrug 5366,2021-07-26,21:00:00,39,26,13,FMN GV 16 Berchem TOT
54,Posthofbrug 5366,2021-07-26,22:00:00,47,18,29,FMN GV 16 Berchem TOT
54,Posthofbrug 5366,2021-07-26,23:00:00,36,13,23,FMN GV 16 Berchem TOT
54,Posthofbrug 5366,2021-07-27,00:00:00,15,6,9,FMN GV 16 Berchem TOT
54,Posthofbrug 5366,2021-07-27,01:00:00,13,3,10,FMN GV 16 Berchem TOT
54,Posthofbrug 5366,2021-07-27,02:00:00,4,3,1,FMN GV 16 Berchem TOT
54,Posthofbrug 5366,2021-07-27,03:00:00,3,2,1,FMN GV 16 Berchem TOT
54,Posthofbrug 5366,2021-07-27,04:00:00,7,6,1,FMN GV 16 Berchem TOT
54,Posthofbrug 5366,2021-07-27,05:00:00,20,12,8,FMN GV 16 Berchem TOT
54,Posthofbrug 5366,2021-07-27,06:00:00,72,55,17,FMN GV 16 Berchem TOT
54,Posthofbrug 5366,2021-07-27,07:00:00,172,129,43,FMN GV 16 Berchem TOT
54,Posthofbrug 5366,2021-07-27,08:00:00,268,199,69,FMN GV 16 Berchem TOT
54,Posthofbrug 5366,2021-07-27,09:00:00,144,113,31,FMN GV 16 Berchem TOT
54,Posthofbrug 5366,2021-07-27,10:00:00,94,63,31,FMN GV 16 Berchem TOT
54,Posthofbrug 5366,2021-07-27,11:00:00,105,53,52,FMN GV 16 Berchem TOT
54,Posthofbrug 5366,2021-07-27,12:00:00,82,42,40,FMN GV 16 Berchem TOT
54,Posthofbrug 5366,2021-07-27,13:00:00,103,65,38,FMN GV 16 Berchem TOT
54,Posthofbrug 5366,2021-07-27,14:00:00,100,53,47,FMN GV 16 Berchem TOT
54,Posthofbrug 5366,2021-07-27,15:00:00,116,37,79,FMN GV 16 Berchem TOT
54,Posthofbrug 5366,2021-07-27,16:00:00,211,72,139,FMN GV 16 Berchem TOT
54,Posthofbrug 5366,2021-07-27,17:00:00,296,91,205,FMN GV 16 Berchem TOT
54,Posthofbrug 5366,2021-07-27,18:00:00,197,57,140,FMN GV 16 Berchem TOT
54,Posthofbrug 5366,2021-07-27,19:00:00,95,46,49,FMN GV 16 Berchem TOT
54,Posthofbrug 5366,2021-07-27,20:00:00,79,44,35,FMN GV 16 Berchem TOT
54,Posthofbrug 5366,2021-07-27,21:00:00,59,32,27,FMN GV 16 Berchem TOT
54,Posthofbrug 5366,2021-07-27,22:00:00,64,27,37,FMN GV 16 Berchem TOT
54,Posthofbrug 5366,2021-07-27,23:00:00,42,22,20,FMN GV 16 Berchem TOT
54,Posthofbrug 5366,2021-07-28,00:00:00,25,8,17,FMN GV 16 Berchem TOT
54,Posthofbrug 5366,2021-07-28,01:00:00,17,3,14,FMN GV 16 Berchem TOT
54,Posthofbrug 5366,2021-07-28,02:00:00,7,5,2,FMN GV 16 Berchem TOT
54,Posthofbrug 5366,2021-07-28,03:00:00,6,3,3,FMN GV 16 Berchem TOT
54,Posthofbrug 5366,2021-07-28,04:00:00,10,8,2,FMN GV 16 Berchem TOT
54,Posthofbrug 5366,2021-07-28,05:00:00,16,10,6,FMN GV 16 Berchem TOT
54,Posthofbrug 5366,2021-07-28,06:00:00,74,60,14,FMN GV 16 Berchem TOT
54,Posthofbrug 5366,2021-07-28,07:00:00,160,110,50,FMN GV 16 Berchem TOT
54,Posthofbrug 5366,2021-07-28,08:00:00,234,155,79,FMN GV 16 Berchem TOT
54,Posthofbrug 5366,2021-07-28,09:00:00,160,122,38,FMN GV 16 Berchem TOT
54,Posthofbrug 5366,2021-07-28,10:00:00,104,66,38,FMN GV 16 Berchem TOT
54,Posthofbrug 5366,2021-07-28,11:00:00,104,52,52,FMN GV 16 Berchem TOT
54,Posthofbrug 5366,2021-07-28,12:00:00,115,72,43,FMN GV 16 Berchem TOT
54,Posthofbrug 5366,2021-07-28,13:00:00,94,53,41,FMN GV 16 Berchem TOT
54,Posthofbrug 5366,2021-07-28,14:00:00,108,58,50,FMN GV 16 Berchem TOT
54,Posthofbrug 5366,2021-07-28,15:00:00,148,72,76,FMN GV 16 Berchem TOT
54,Posthofbrug 5366,2021-07-28,16:00:00,240,93,147,FMN GV 16 Berchem TOT
54,Posthofbrug 5366,2021-07-28,17:00:00,305,118,187,FMN GV 16 Berchem TOT
54,Posthofbrug 5366,2021-07-28,18:00:00,198,78,120,FMN GV 16 Berchem TOT
54,Posthofbrug 5366,2021-07-28,19:00:00,142,77,65,FMN GV 16 Berchem TOT
54,Posthofbrug 5366,2021-07-28,20:00:00,85,40,45,FMN GV 16 Berchem TOT
54,Posthofbrug 5366,2021-07-28,21:00:00,61,33,28,FMN GV 16 Berchem TOT
54,Posthofbrug 5366,2021-07-28,22:00:00,76,25,51,FMN GV 16 Berchem TOT
54,Posthofbrug 5366,2021-07-28,23:00:00,55,20,35,FMN GV 16 Berchem TOT
54,Posthofbrug 5366,2021-07-29,00:00:00,26,3,23,FMN GV 16 Berchem TOT
54,Posthofbrug 5366,2021-07-29,01:00:00,14,2,12,FMN GV 16 Berchem TOT
54,Posthofbrug 5366,2021-07-29,02:00:00,10,6,4,FMN GV 16 Berchem TOT
54,Posthofbrug 5366,2021-07-29,03:00:00,3,2,1,FMN GV 16 Berchem TOT
54,Posthofbrug 5366,2021-07-29,04:00:00,9,7,2,FMN GV 16 Berchem TOT
54,Posthofbrug 5366,2021-07-29,05:00:00,22,12,10,FMN GV 16 Berchem TOT
54,Posthofbrug 5366,2021-07-29,06:00:00,67,54,13,FMN GV 16 Berchem TOT
54,Posthofbrug 5366,2021-07-29,07:00:00,181,134,47,FMN GV 16 Berchem TOT
54,Posthofbrug 5366,2021-07-29,08:00:00,293,214,79,FMN GV 16 Berchem TOT
54,Posthofbrug 5366,2021-07-29,09:00:00,160,124,36,FMN GV 16 Berchem TOT
54,Posthofbrug 5366,2021-07-29,10:00:00,95,63,32,FMN GV 16 Berchem TOT
54,Posthofbrug 5366,2021-07-29,11:00:00,132,86,46,FMN GV 16 Berchem TOT
54,Posthofbrug 5366,2021-07-29,12:00:00,130,82,48,FMN GV 16 Berchem TOT
54,Posthofbrug 5366,2021-07-29,13:00:00,114,73,41,FMN GV 16 Berchem TOT
54,Posthofbrug 5366,2021-07-29,14:00:00,136,64,72,FMN GV 16 Berchem TOT
54,Posthofbrug 5366,2021-07-29,15:00:00,154,71,83,FMN GV 16 Berchem TOT
54,Posthofbrug 5366,2021-07-29,16:00:00,265,105,160,FMN GV 16 Berchem TOT
54,Posthofbrug 5366,2021-07-29,17:00:00,328,113,215,FMN GV 16 Berchem TOT
54,Posthofbrug 5366,2021-07-29,18:00:00,236,100,136,FMN GV 16 Berchem TOT
54,Posthofbrug 5366,2021-07-29,19:00:00,142,65,77,FMN GV 16 Berchem TOT
54,Posthofbrug 5366,2021-07-29,20:00:00,107,56,51,FMN GV 16 Berchem TOT
54,Posthofbrug 5366,2021-07-29,21:00:00,73,38,35,FMN GV 16 Berchem TOT
54,Posthofbrug 5366,2021-07-29,22:00:00,87,38,49,FMN GV 16 Berchem TOT
54,Posthofbrug 5366,2021-07-29,23:00:00,59,16,43,FMN GV 16 Berchem TOT
54,Posthofbrug 5366,2021-07-30,00:00:00,32,11,21,FMN GV 16 Berchem TOT
54,Posthofbrug 5366,2021-07-30,01:00:00,18,8,10,FMN GV 16 Berchem TOT
54,Posthofbrug 5366,2021-07-30,02:00:00,15,4,11,FMN GV 16 Berchem TOT
54,Posthofbrug 5366,2021-07-30,03:00:00,5,1,4,FMN GV 16 Berchem TOT
54,Posthofbrug 5366,2021-07-30,04:00:00,11,8,3,FMN GV 16 Berchem TOT
54,Posthofbrug 5366,2021-07-30,05:00:00,19,13,6,FMN GV 16 Berchem TOT
54,Posthofbrug 5366,2021-07-30,06:00:00,50,39,11,FMN GV 16 Berchem TOT
54,Posthofbrug 5366,2021-07-30,07:00:00,145,94,51,FMN GV 16 Berchem TOT
54,Posthofbrug 5366,2021-07-30,08:00:00,242,170,72,FMN GV 16 Berchem TOT
54,Posthofbrug 5366,2021-07-30,09:00:00,134,100,34,FMN GV 16 Berchem TOT
54,Posthofbrug 5366,2021-07-30,10:00:00,110,71,39,FMN GV 16 Berchem TOT
54,Posthofbrug 5366,2021-07-30,11:00:00,108,61,47,FMN GV 16 Berchem TOT
54,Posthofbrug 5366,2021-07-30,12:00:00,113,60,53,FMN GV 16 Berchem TOT
54,Posthofbrug 5366,2021-07-30,13:00:00,141,87,54,FMN GV 16 Berchem TOT
54,Posthofbrug 5366,2021-07-30,14:00:00,124,65,59,FMN GV 16 Berchem TOT
54,Posthofbrug 5366,2021-07-30,15:00:00,169,68,101,FMN GV 16 Berchem TOT
54,Posthofbrug 5366,2021-07-30,16:00:00,202,89,113,FMN GV 16 Berchem TOT
54,Posthofbrug 5366,2021-07-30,17:00:00,248,92,156,FMN GV 16 Berchem TOT
54,Posthofbrug 5366,2021-07-30,18:00:00,202,87,115,FMN GV 16 Berchem TOT
54,Posthofbrug 5366,2021-07-30,19:00:00,114,51,63,FMN GV 16 Berchem TOT
54,Posthofbrug 5366,2021-07-30,20:00:00,90,43,47,FMN GV 16 Berchem TOT
54,Posthofbrug 5366,2021-07-30,21:00:00,87,44,43,FMN GV 16 Berchem TOT
54,Posthofbrug 5366,2021-07-30,22:00:00,61,29,32,FMN GV 16 Berchem TOT
54,Posthofbrug 5366,2021-07-30,23:00:00,62,23,39,FMN GV 16 Berchem TOT
54,Posthofbrug 5366,2021-07-31,00:00:00,47,24,23,FMN GV 16 Berchem TOT
54,Posthofbrug 5366,2021-07-31,01:00:00,48,8,40,FMN GV 16 Berchem TOT
54,Posthofbrug 5366,2021-07-31,02:00:00,9,6,3,FMN GV 16 Berchem TOT
54,Posthofbrug 5366,2021-07-31,03:00:00,8,2,6,FMN GV 16 Berchem TOT
54,Posthofbrug 5366,2021-07-31,04:00:00,10,5,5,FMN GV 16 Berchem TOT
54,Posthofbrug 5366,2021-07-31,05:00:00,15,9,6,FMN GV 16 Berchem TOT
54,Posthofbrug 5366,2021-07-31,06:00:00,13,8,5,FMN GV 16 Berchem TOT
54,Posthofbrug 5366,2021-07-31,07:00:00,26,15,11,FMN GV 16 Berchem TOT
54,Posthofbrug 5366,2021-07-31,08:00:00,34,25,9,FMN GV 16 Berchem TOT
54,Posthofbrug 5366,2021-07-31,09:00:00,94,62,32,FMN GV 16 Berchem TOT
54,Posthofbrug 5366,2021-07-31,10:00:00,123,80,43,FMN GV 16 Berchem TOT
54,Posthofbrug 5366,2021-07-31,11:00:00,148,79,69,FMN GV 16 Berchem TOT
54,Posthofbrug 5366,2021-07-31,12:00:00,118,65,53,FMN GV 16 Berchem TOT
54,Posthofbrug 5366,2021-07-31,13:00:00,140,96,44,FMN GV 16 Berchem TOT
54,Posthofbrug 5366,2021-07-31,14:00:00,184,82,102,FMN GV 16 Berchem TOT
54,Posthofbrug 5366,2021-07-31,15:00:00,153,73,80,FMN GV 16 Berchem TOT
54,Posthofbrug 5366,2021-07-31,16:00:00,131,62,69,FMN GV 16 Berchem TOT
54,Posthofbrug 5366,2021-07-31,17:00:00,155,81,74,FMN GV 16 Berchem TOT
54,Posthofbrug 5366,2021-07-31,18:00:00,147,70,77,FMN GV 16 Berchem TOT
54,Posthofbrug 5366,2021-07-31,19:00:00,82,37,45,FMN GV 16 Berchem TOT
54,Posthofbrug 5366,2021-07-31,20:00:00,93,45,48,FMN GV 16 Berchem TOT
54,Posthofbrug 5366,2021-07-31,21:00:00,28,11,17,FMN GV 16 Berchem TOT
54,Posthofbrug 5366,2021-07-31,22:00:00,54,19,35,FMN GV 16 Berchem TOT
54,Posthofbrug 5366,2021-07-31,23:00:00,52,19,33,FMN GV 16 Berchem TOT
54,Posthofbrug 5366,2021-08-01,00:00:00,30,12,18,FMN GV 16 Berchem TOT
54,Posthofbrug 5366,2021-08-01,01:00:00,22,6,16,FMN GV 16 Berchem TOT
54,Posthofbrug 5366,2021-08-01,02:00:00,21,3,18,FMN GV 16 Berchem TOT
54,Posthofbrug 5366,2021-08-01,03:00:00,8,3,5,FMN GV 16 Berchem TOT
54,Posthofbrug 5366,2021-08-01,04:00:00,5,3,2,FMN GV 16 Berchem TOT
54,Posthofbrug 5366,2021-08-01,05:00:00,12,6,6,FMN GV 16 Berchem TOT
54,Posthofbrug 5366,2021-08-01,06:00:00,13,8,5,FMN GV 16 Berchem TOT
54,Posthofbrug 5366,2021-08-01,07:00:00,18,11,7,FMN GV 16 Berchem TOT
54,Posthofbrug 5366,2021-08-01,08:00:00,32,21,11,FMN GV 16 Berchem TOT
54,Posthofbrug 5366,2021-08-01,09:00:00,61,38,23,FMN GV 16 Berchem TOT
54,Posthofbrug 5366,2021-08-01,10:00:00,81,44,37,FMN GV 16 Berchem TOT
54,Posthofbrug 5366,2021-08-01,11:00:00,72,45,27,FMN GV 16 Berchem TOT
54,Posthofbrug 5366,2021-08-01,12:00:00,66,37,29,FMN GV 16 Berchem TOT
54,Posthofbrug 5366,2021-08-01,13:00:00,61,30,31,FMN GV 16 Berchem TOT
54,Posthofbrug 5366,2021-08-01,14:00:00,94,64,30,FMN GV 16 Berchem TOT
54,Posthofbrug 5366,2021-08-01,15:00:00,67,26,41,FMN GV 16 Berchem TOT
54,Posthofbrug 5366,2021-08-01,16:00:00,46,18,28,FMN GV 16 Berchem TOT
54,Posthofbrug 5366,2021-08-01,17:00:00,82,39,43,FMN GV 16 Berchem TOT
54,Posthofbrug 5366,2021-08-01,18:00:00,71,32,39,FMN GV 16 Berchem TOT
54,Posthofbrug 5366,2021-08-01,19:00:00,48,27,21,FMN GV 16 Berchem TOT
54,Posthofbrug 5366,2021-08-01,20:00:00,56,26,30,FMN GV 16 Berchem TOT
54,Posthofbrug 5366,2021-08-01,21:00:00,42,28,14,FMN GV 16 Berchem TOT
54,Posthofbrug 5366,2021-08-01,22:00:00,27,16,11,FMN GV 16 Berchem TOT
54,Posthofbrug 5366,2021-08-01,23:00:00,18,9,9,FMN GV 16 Berchem TOT
54,Posthofbrug 5366,2021-08-02,00:00:00,22,4,18,FMN GV 16 Berchem TOT
54,Posthofbrug 5366,2021-08-02,01:00:00,8,2,6,FMN GV 16 Berchem TOT
54,Posthofbrug 5366,2021-08-02,02:00:00,4,1,3,FMN GV 16 Berchem TOT
54,Posthofbrug 5366,2021-08-02,03:00:00,4,2,2,FMN GV 16 Berchem TOT
54,Posthofbrug 5366,2021-08-02,04:00:00,5,5,0,FMN GV 16 Berchem TOT
54,Posthofbrug 5366,2021-08-02,05:00:00,15,10,5,FMN GV 16 Berchem TOT
54,Posthofbrug 5366,2021-08-02,06:00:00,69,59,10,FMN GV 16 Berchem TOT
54,Posthofbrug 5366,2021-08-02,07:00:00,182,129,53,FMN GV 16 Berchem TOT
54,Posthofbrug 5366,2021-08-02,08:00:00,258,190,68,FMN GV 16 Berchem TOT
54,Posthofbrug 5366,2021-08-02,09:00:00,110,84,26,FMN GV 16 Berchem TOT
54,Posthofbrug 5366,2021-08-02,10:00:00,89,60,29,FMN GV 16 Berchem TOT
54,Posthofbrug 5366,2021-08-02,11:00:00,107,59,48,FMN GV 16 Berchem TOT
54,Posthofbrug 5366,2021-08-02,12:00:00,85,45,40,FMN GV 16 Berchem TOT
54,Posthofbrug 5366,2021-08-02,13:00:00,97,55,42,FMN GV 16 Berchem TOT
54,Posthofbrug 5366,2021-08-02,14:00:00,114,52,62,FMN GV 16 Berchem TOT
54,Posthofbrug 5366,2021-08-02,15:00:00,126,65,61,FMN GV 16 Berchem TOT
54,Posthofbrug 5366,2021-08-02,16:00:00,222,83,139,FMN GV 16 Berchem TOT
54,Posthofbrug 5366,2021-08-02,17:00:00,339,154,185,FMN GV 16 Berchem TOT
54,Posthofbrug 5366,2021-08-02,18:00:00,238,76,162,FMN GV 16 Berchem TOT
54,Posthofbrug 5366,2021-08-02,19:00:00,110,56,54,FMN GV 16 Berchem TOT
54,Posthofbrug 5366,2021-08-02,20:00:00,82,48,34,FMN GV 16 Berchem TOT
54,Posthofbrug 5366,2021-08-02,21:00:00,67,31,36,FMN GV 16 Berchem TOT
54,Posthofbrug 5366,2021-08-02,22:00:00,61,30,31,FMN GV 16 Berchem TOT
54,Posthofbrug 5366,2021-08-02,23:00:00,57,25,32,FMN GV 16 Berchem TOT
54,Posthofbrug 5366,2021-08-03,00:00:00,24,6,18,FMN GV 16 Berchem TOT
54,Posthofbrug 5366,2021-08-03,01:00:00,18,4,14,FMN GV 16 Berchem TOT
54,Posthofbrug 5366,2021-08-03,02:00:00,8,5,3,FMN GV 16 Berchem TOT
54,Posthofbrug 5366,2021-08-03,03:00:00,6,4,2,FMN GV 16 Berchem TOT
54,Posthofbrug 5366,2021-08-03,04:00:00,5,5,0,FMN GV 16 Berchem TOT
54,Posthofbrug 5366,2021-08-03,05:00:00,18,13,5,FMN GV 16 Berchem TOT
54,Posthofbrug 5366,2021-08-03,06:00:00,73,65,8,FMN GV 16 Berchem TOT
54,Posthofbrug 5366,2021-08-03,07:00:00,189,136,53,FMN GV 16 Berchem TOT
54,Posthofbrug 5366,2021-08-03,08:00:00,284,211,73,FMN GV 16 Berchem TOT
54,Posthofbrug 5366,2021-08-03,09:00:00,142,106,36,FMN GV 16 Berchem TOT
54,Posthofbrug 5366,2021-08-03,10:00:00,88,62,26,FMN GV 16 Berchem TOT
54,Posthofbrug 5366,2021-08-03,11:00:00,112,65,47,FMN GV 16 Berchem TOT
54,Posthofbrug 5366,2021-08-03,12:00:00,99,50,49,FMN GV 16 Berchem TOT
54,Posthofbrug 5366,2021-08-03,13:00:00,149,77,72,FMN GV 16 Berchem TOT
54,Posthofbrug 5366,2021-08-03,14:00:00,147,94,53,FMN GV 16 Berchem TOT
54,Posthofbrug 5366,2021-08-03,15:00:00,184,92,92,FMN GV 16 Berchem TOT
54,Posthofbrug 5366,2021-08-03,16:00:00,272,104,168,FMN GV 16 Berchem TOT
54,Posthofbrug 5366,2021-08-03,17:00:00,339,107,232,FMN GV 16 Berchem TOT
54,Posthofbrug 5366,2021-08-03,18:00:00,230,86,144,FMN GV 16 Berchem TOT
54,Posthofbrug 5366,2021-08-03,19:00:00,152,79,73,FMN GV 16 Berchem TOT
54,Posthofbrug 5366,2021-08-03,20:00:00,94,42,52,FMN GV 16 Berchem TOT
54,Posthofbrug 5366,2021-08-03,21:00:00,90,54,36,FMN GV 16 Berchem TOT
54,Posthofbrug 5366,2021-08-03,22:00:00,82,38,44,FMN GV 16 Berchem TOT
54,Posthofbrug 5366,2021-08-03,23:00:00,61,23,38,FMN GV 16 Berchem TOT
54,Posthofbrug 5366,2021-08-04,00:00:00,25,10,15,FMN GV 16 Berchem TOT
54,Posthofbrug 5366,2021-08-04,01:00:00,9,2,7,FMN GV 16 Berchem TOT
54,Posthofbrug 5366,2021-08-04,02:00:00,14,6,8,FMN GV 16 Berchem TOT
54,Posthofbrug 5366,2021-08-04,03:00:00,6,4,2,FMN GV 16 Berchem TOT
54,Posthofbrug 5366,2021-08-04,04:00:00,10,7,3,FMN GV 16 Berchem TOT
54,Posthofbrug 5366,2021-08-04,05:00:00,17,12,5,FMN GV 16 Berchem TOT
54,Posthofbrug 5366,2021-08-04,06:00:00,79,64,15,FMN GV 16 Berchem TOT
54,Posthofbrug 5366,2021-08-04,07:00:00,163,115,48,FMN GV 16 Berchem TOT
54,Posthofbrug 5366,2021-08-04,08:00:00,248,180,68,FMN GV 16 Berchem TOT
54,Posthofbrug 5366,2021-08-04,09:00:00,143,91,52,FMN GV 16 Berchem TOT
54,Posthofbrug 5366,2021-08-04,10:00:00,88,63,25,FMN GV 16 Berchem TOT
54,Posthofbrug 5366,2021-08-04,11:00:00,101,65,36,FMN GV 16 Berchem TOT
54,Posthofbrug 5366,2021-08-04,12:00:00,126,78,48,FMN GV 16 Berchem TOT
54,Posthofbrug 5366,2021-08-04,13:00:00,139,63,76,FMN GV 16 Berchem TOT
54,Posthofbrug 5366,2021-08-04,14:00:00,134,57,77,FMN GV 16 Berchem TOT
54,Posthofbrug 5366,2021-08-04,15:00:00,139,56,83,FMN GV 16 Berchem TOT
54,Posthofbrug 5366,2021-08-04,16:00:00,231,82,149,FMN GV 16 Berchem TOT
54,Posthofbrug 5366,2021-08-04,17:00:00,254,82,172,FMN GV 16 Berchem TOT
54,Posthofbrug 5366,2021-08-04,18:00:00,191,78,113,FMN GV 16 Berchem TOT
54,Posthofbrug 5366,2021-08-04,19:00:00,127,66,61,FMN GV 16 Berchem TOT
54,Posthofbrug 5366,2021-08-04,20:00:00,117,74,43,FMN GV 16 Berchem TOT
54,Posthofbrug 5366,2021-08-04,21:00:00,79,42,37,FMN GV 16 Berchem TOT
54,Posthofbrug 5366,2021-08-04,22:00:00,80,34,46,FMN GV 16 Berchem TOT
54,Posthofbrug 5366,2021-08-04,23:00:00,49,11,38,FMN GV 16 Berchem TOT
54,Posthofbrug 5366,2021-08-05,00:00:00,31,8,23,FMN GV 16 Berchem TOT
54,Posthofbrug 5366,2021-08-05,01:00:00,23,8,15,FMN GV 16 Berchem TOT
54,Posthofbrug 5366,2021-08-05,02:00:00,10,4,6,FMN GV 16 Berchem TOT
54,Posthofbrug 5366,2021-08-05,03:00:00,3,1,2,FMN GV 16 Berchem TOT
54,Posthofbrug 5366,2021-08-05,04:00:00,6,5,1,FMN GV 16 Berchem TOT
54,Posthofbrug 5366,2021-08-05,05:00:00,24,16,8,FMN GV 16 Berchem TOT
54,Posthofbrug 5366,2021-08-05,06:00:00,76,61,15,FMN GV 16 Berchem TOT
54,Posthofbrug 5366,2021-08-05,07:00:00,176,128,48,FMN GV 16 Berchem TOT
54,Posthofbrug 5366,2021-08-05,08:00:00,290,208,82,FMN GV 16 Berchem TOT
54,Posthofbrug 5366,2021-08-05,09:00:00,155,123,32,FMN GV 16 Berchem TOT
54,Posthofbrug 5366,2021-08-05,10:00:00,100,63,37,FMN GV 16 Berchem TOT
54,Posthofbrug 5366,2021-08-05,11:00:00,108,65,43,FMN GV 16 Berchem TOT
54,Posthofbrug 5366,2021-08-05,12:00:00,132,77,55,FMN GV 16 Berchem TOT
54,Posthofbrug 5366,2021-08-05,13:00:00,115,69,46,FMN GV 16 Berchem TOT
54,Posthofbrug 5366,2021-08-05,14:00:00,151,65,86,FMN GV 16 Berchem TOT
54,Posthofbrug 5366,2021-08-05,15:00:00,139,59,80,FMN GV 16 Berchem TOT
54,Posthofbrug 5366,2021-08-05,16:00:00,269,98,171,FMN GV 16 Berchem TOT
54,Posthofbrug 5366,2021-08-05,17:00:00,331,114,217,FMN GV 16 Berchem TOT
54,Posthofbrug 5366,2021-08-05,18:00:00,267,101,166,FMN GV 16 Berchem TOT
54,Posthofbrug 5366,2021-08-05,19:00:00,176,87,89,FMN GV 16 Berchem TOT
54,Posthofbrug 5366,2021-08-05,20:00:00,116,73,43,FMN GV 16 Berchem TOT
54,Posthofbrug 5366,2021-08-05,21:00:00,89,37,52,FMN GV 16 Berchem TOT
54,Posthofbrug 5366,2021-08-05,22:00:00,79,35,44,FMN GV 16 Berchem TOT
54,Posthofbrug 5366,2021-08-05,23:00:00,68,22,46,FMN GV 16 Berchem TOT
54,Posthofbrug 5366,2021-08-06,00:00:00,40,8,32,FMN GV 16 Berchem TOT
54,Posthofbrug 5366,2021-08-06,01:00:00,28,8,20,FMN GV 16 Berchem TOT
54,Posthofbrug 5366,2021-08-06,02:00:00,16,5,11,FMN GV 16 Berchem TOT
54,Posthofbrug 5366,2021-08-06,03:00:00,5,4,1,FMN GV 16 Berchem TOT
54,Posthofbrug 5366,2021-08-06,04:00:00,4,4,0,FMN GV 16 Berchem TOT
54,Posthofbrug 5366,2021-08-06,05:00:00,18,13,5,FMN GV 16 Berchem TOT
54,Posthofbrug 5366,2021-08-06,06:00:00,49,41,8,FMN GV 16 Berchem TOT
54,Posthofbrug 5366,2021-08-06,07:00:00,126,85,41,FMN GV 16 Berchem TOT
54,Posthofbrug 5366,2021-08-06,08:00:00,236,166,70,FMN GV 16 Berchem TOT
54,Posthofbrug 5366,2021-08-06,09:00:00,154,110,44,FMN GV 16 Berchem TOT
54,Posthofbrug 5366,2021-08-06,10:00:00,68,43,25,FMN GV 16 Berchem TOT
54,Posthofbrug 5366,2021-08-06,11:00:00,75,45,30,FMN GV 16 Berchem TOT
54,Posthofbrug 5366,2021-08-06,12:00:00,92,54,38,FMN GV 16 Berchem TOT
54,Posthofbrug 5366,2021-08-06,13:00:00,85,48,37,FMN GV 16 Berchem TOT
54,Posthofbrug 5366,2021-08-06,14:00:00,123,60,63,FMN GV 16 Berchem TOT
54,Posthofbrug 5366,2021-08-06,15:00:00,113,44,69,FMN GV 16 Berchem TOT
54,Posthofbrug 5366,2021-08-06,16:00:00,215,84,131,FMN GV 16 Berchem TOT
54,Posthofbrug 5366,2021-08-06,17:00:00,242,113,129,FMN GV 16 Berchem TOT
54,Posthofbrug 5366,2021-08-06,18:00:00,169,73,96,FMN GV 16 Berchem TOT
54,Posthofbrug 5366,2021-08-06,19:00:00,131,73,58,FMN GV 16 Berchem TOT
54,Posthofbrug 5366,2021-08-06,20:00:00,105,51,54,FMN GV 16 Berchem TOT
54,Posthofbrug 5366,2021-08-06,21:00:00,73,32,41,FMN GV 16 Berchem TOT
54,Posthofbrug 5366,2021-08-06,22:00:00,73,30,43,FMN GV 16 Berchem TOT
54,Posthofbrug 5366,2021-08-06,23:00:00,67,33,34,FMN GV 16 Berchem TOT
54,Posthofbrug 5366,2021-08-07,00:00:00,37,15,22,FMN GV 16 Berchem TOT
54,Posthofbrug 5366,2021-08-07,01:00:00,60,15,45,FMN GV 16 Berchem TOT
54,Posthofbrug 5366,2021-08-07,02:00:00,16,3,13,FMN GV 16 Berchem TOT
54,Posthofbrug 5366,2021-08-07,03:00:00,8,3,5,FMN GV 16 Berchem TOT
54,Posthofbrug 5366,2021-08-07,04:00:00,19,7,12,FMN GV 16 Berchem TOT
54,Posthofbrug 5366,2021-08-07,05:00:00,9,5,4,FMN GV 16 Berchem TOT
54,Posthofbrug 5366,2021-08-07,06:00:00,15,9,6,FMN GV 16 Berchem TOT
54,Posthofbrug 5366,2021-08-07,07:00:00,21,12,9,FMN GV 16 Berchem TOT
54,Posthofbrug 5366,2021-08-07,08:00:00,55,33,22,FMN GV 16 Berchem TOT
54,Posthofbrug 5366,2021-08-07,09:00:00,114,79,35,FMN GV 16 Berchem TOT
54,Posthofbrug 5366,2021-08-07,10:00:00,117,74,43,FMN GV 16 Berchem TOT
54,Posthofbrug 5366,2021-08-07,11:00:00,118,68,50,FMN GV 16 Berchem TOT
54,Posthofbrug 5366,2021-08-07,12:00:00,134,73,61,FMN GV 16 Berchem TOT
54,Posthofbrug 5366,2021-08-07,13:00:00,155,86,69,FMN GV 16 Berchem TOT
54,Posthofbrug 5366,2021-08-07,14:00:00,127,63,64,FMN GV 16 Berchem TOT
54,Posthofbrug 5366,2021-08-07,15:00:00,138,62,76,FMN GV 16 Berchem TOT
54,Posthofbrug 5366,2021-08-07,16:00:00,100,41,59,FMN GV 16 Berchem TOT
54,Posthofbrug 5366,2021-08-07,17:00:00,95,48,47,FMN GV 16 Berchem TOT
54,Posthofbrug 5366,2021-08-07,18:00:00,110,49,61,FMN GV 16 Berchem TOT
54,Posthofbrug 5366,2021-08-07,19:00:00,63,25,38,FMN GV 16 Berchem TOT
54,Posthofbrug 5366,2021-08-07,20:00:00,81,46,35,FMN GV 16 Berchem TOT
54,Posthofbrug 5366,2021-08-07,21:00:00,48,16,32,FMN GV 16 Berchem TOT
54,Posthofbrug 5366,2021-08-07,22:00:00,44,15,29,FMN GV 16 Berchem TOT
54,Posthofbrug 5366,2021-08-07,23:00:00,36,21,15,FMN GV 16 Berchem TOT
54,Posthofbrug 5366,2021-08-08,00:00:00,26,13,13,FMN GV 16 Berchem TOT
54,Posthofbrug 5366,2021-08-08,01:00:00,53,14,39,FMN GV 16 Berchem TOT
54,Posthofbrug 5366,2021-08-08,02:00:00,14,5,9,FMN GV 16 Berchem TOT
54,Posthofbrug 5366,2021-08-08,03:00:00,5,3,2,FMN GV 16 Berchem TOT
54,Posthofbrug 5366,2021-08-08,04:00:00,3,2,1,FMN GV 16 Berchem TOT
54,Posthofbrug 5366,2021-08-08,05:00:00,12,5,7,FMN GV 16 Berchem TOT
54,Posthofbrug 5366,2021-08-08,06:00:00,13,13,0,FMN GV 16 Berchem TOT
54,Posthofbrug 5366,2021-08-08,07:00:00,9,6,3,FMN GV 16 Berchem TOT
54,Posthofbrug 5366,2021-08-08,08:00:00,34,22,12,FMN GV 16 Berchem TOT
54,Posthofbrug 5366,2021-08-08,09:00:00,84,48,36,FMN GV 16 Berchem TOT
54,Posthofbrug 5366,2021-08-08,10:00:00,95,63,32,FMN GV 16 Berchem TOT
54,Posthofbrug 5366,2021-08-08,11:00:00,100,50,50,FMN GV 16 Berchem TOT
54,Posthofbrug 5366,2021-08-08,12:00:00,117,63,54,FMN GV 16 Berchem TOT
54,Posthofbrug 5366,2021-08-08,13:00:00,100,59,41,FMN GV 16 Berchem TOT
54,Posthofbrug 5366,2021-08-08,14:00:00,98,40,58,FMN GV 16 Berchem TOT
54,Posthofbrug 5366,2021-08-08,15:00:00,87,41,46,FMN GV 16 Berchem TOT
54,Posthofbrug 5366,2021-08-08,16:00:00,92,41,51,FMN GV 16 Berchem TOT
54,Posthofbrug 5366,2021-08-08,17:00:00,81,46,35,FMN GV 16 Berchem TOT
54,Posthofbrug 5366,2021-08-08,18:00:00,78,36,42,FMN GV 16 Berchem TOT
54,Posthofbrug 5366,2021-08-08,19:00:00,53,28,25,FMN GV 16 Berchem TOT
54,Posthofbrug 5366,2021-08-08,20:00:00,60,34,26,FMN GV 16 Berchem TOT
54,Posthofbrug 5366,2021-08-08,21:00:00,34,17,17,FMN GV 16 Berchem TOT
54,Posthofbrug 5366,2021-08-08,22:00:00,33,16,17,FMN GV 16 Berchem TOT
54,Posthofbrug 5366,2021-08-08,23:00:00,24,10,14,FMN GV 16 Berchem TOT
54,Posthofbrug 5366,2021-08-09,00:00:00,10,6,4,FMN GV 16 Berchem TOT
54,Posthofbrug 5366,2021-08-09,01:00:00,15,6,9,FMN GV 16 Berchem TOT
54,Posthofbrug 5366,2021-08-09,02:00:00,8,1,7,FMN GV 16 Berchem TOT
54,Posthofbrug 5366,2021-08-09,03:00:00,2,1,1,FMN GV 16 Berchem TOT
54,Posthofbrug 5366,2021-08-09,04:00:00,9,6,3,FMN GV 16 Berchem TOT
54,Posthofbrug 5366,2021-08-09,05:00:00,16,11,5,FMN GV 16 Berchem TOT
54,Posthofbrug 5366,2021-08-09,06:00:00,71,58,13,FMN GV 16 Berchem TOT
54,Posthofbrug 5366,2021-08-09,07:00:00,179,135,44,FMN GV 16 Berchem TOT
54,Posthofbrug 5366,2021-08-09,08:00:00,259,191,68,FMN GV 16 Berchem TOT
54,Posthofbrug 5366,2021-08-09,09:00:00,113,75,38,FMN GV 16 Berchem TOT
54,Posthofbrug 5366,2021-08-09,10:00:00,70,40,30,FMN GV 16 Berchem TOT
54,Posthofbrug 5366,2021-08-09,11:00:00,65,34,31,FMN GV 16 Berchem TOT
54,Posthofbrug 5366,2021-08-09,12:00:00,86,46,40,FMN GV 16 Berchem TOT
54,Posthofbrug 5366,2021-08-09,13:00:00,71,36,35,FMN GV 16 Berchem TOT
54,Posthofbrug 5366,2021-08-09,14:00:00,92,48,44,FMN GV 16 Berchem TOT
54,Posthofbrug 5366,2021-08-09,15:00:00,96,30,66,FMN GV 16 Berchem TOT
54,Posthofbrug 5366,2021-08-09,16:00:00,185,68,117,FMN GV 16 Berchem TOT
54,Posthofbrug 5366,2021-08-09,17:00:00,258,84,174,FMN GV 16 Berchem TOT
54,Posthofbrug 5366,2021-08-09,18:00:00,199,77,122,FMN GV 16 Berchem TOT
54,Posthofbrug 5366,2021-08-09,19:00:00,127,51,76,FMN GV 16 Berchem TOT
54,Posthofbrug 5366,2021-08-09,20:00:00,85,52,33,FMN GV 16 Berchem TOT
54,Posthofbrug 5366,2021-08-09,21:00:00,63,39,24,FMN GV 16 Berchem TOT
54,Posthofbrug 5366,2021-08-09,22:00:00,69,29,40,FMN GV 16 Berchem TOT
54,Posthofbrug 5366,2021-08-09,23:00:00,35,15,20,FMN GV 16 Berchem TOT
54,Posthofbrug 5366,2021-08-10,00:00:00,17,4,13,FMN GV 16 Berchem TOT
54,Posthofbrug 5366,2021-08-10,01:00:00,18,7,11,FMN GV 16 Berchem TOT
54,Posthofbrug 5366,2021-08-10,02:00:00,8,4,4,FMN GV 16 Berchem TOT
54,Posthofbrug 5366,2021-08-10,03:00:00,5,4,1,FMN GV 16 Berchem TOT
54,Posthofbrug 5366,2021-08-10,04:00:00,8,7,1,FMN GV 16 Berchem TOT
54,Posthofbrug 5366,2021-08-10,05:00:00,22,14,8,FMN GV 16 Berchem TOT
54,Posthofbrug 5366,2021-08-10,06:00:00,59,51,8,FMN GV 16 Berchem TOT
54,Posthofbrug 5366,2021-08-10,07:00:00,184,123,61,FMN GV 16 Berchem TOT
54,Posthofbrug 5366,2021-08-10,08:00:00,292,219,73,FMN GV 16 Berchem TOT
54,Posthofbrug 5366,2021-08-10,09:00:00,150,127,23,FMN GV 16 Berchem TOT
54,Posthofbrug 5366,2021-08-10,10:00:00,87,49,38,FMN GV 16 Berchem TOT
54,Posthofbrug 5366,2021-08-10,11:00:00,95,50,45,FMN GV 16 Berchem TOT
54,Posthofbrug 5366,2021-08-10,12:00:00,86,42,44,FMN GV 16 Berchem TOT
54,Posthofbrug 5366,2021-08-10,13:00:00,66,32,34,FMN GV 16 Berchem TOT
54,Posthofbrug 5366,2021-08-10,14:00:00,93,46,47,FMN GV 16 Berchem TOT
54,Posthofbrug 5366,2021-08-10,15:00:00,103,35,68,FMN GV 16 Berchem TOT
54,Posthofbrug 5366,2021-08-10,16:00:00,231,92,139,FMN GV 16 Berchem TOT
54,Posthofbrug 5366,2021-08-10,17:00:00,258,93,165,FMN GV 16 Berchem TOT
54,Posthofbrug 5366,2021-08-10,18:00:00,243,93,150,FMN GV 16 Berchem TOT
54,Posthofbrug 5366,2021-08-10,19:00:00,129,59,70,FMN GV 16 Berchem TOT
54,Posthofbrug 5366,2021-08-10,20:00:00,98,51,47,FMN GV 16 Berchem TOT
54,Posthofbrug 5366,2021-08-10,21:00:00,81,36,45,FMN GV 16 Berchem TOT
54,Posthofbrug 5366,2021-08-10,22:00:00,72,36,36,FMN GV 16 Berchem TOT
54,Posthofbrug 5366,2021-08-10,23:00:00,50,12,38,FMN GV 16 Berchem TOT
54,Posthofbrug 5366,2021-08-11,00:00:00,23,9,14,FMN GV 16 Berchem TOT
54,Posthofbrug 5366,2021-08-11,01:00:00,15,6,9,FMN GV 16 Berchem TOT
54,Posthofbrug 5366,2021-08-11,02:00:00,8,5,3,FMN GV 16 Berchem TOT
54,Posthofbrug 5366,2021-08-11,03:00:00,4,3,1,FMN GV 16 Berchem TOT
54,Posthofbrug 5366,2021-08-11,04:00:00,11,10,1,FMN GV 16 Berchem TOT
54,Posthofbrug 5366,2021-08-11,05:00:00,28,16,12,FMN GV 16 Berchem TOT
54,Posthofbrug 5366,2021-08-11,06:00:00,69,56,13,FMN GV 16 Berchem TOT
54,Posthofbrug 5366,2021-08-11,07:00:00,188,124,64,FMN GV 16 Berchem TOT
54,Posthofbrug 5366,2021-08-11,08:00:00,279,192,87,FMN GV 16 Berchem TOT
54,Posthofbrug 5366,2021-08-11,09:00:00,167,117,50,FMN GV 16 Berchem TOT
54,Posthofbrug 5366,2021-08-11,10:00:00,142,96,46,FMN GV 16 Berchem TOT
54,Posthofbrug 5366,2021-08-11,11:00:00,156,89,67,FMN GV 16 Berchem TOT
54,Posthofbrug 5366,2021-08-11,12:00:00,165,84,81,FMN GV 16 Berchem TOT
54,Posthofbrug 5366,2021-08-11,13:00:00,142,82,60,FMN GV 16 Berchem TOT
54,Posthofbrug 5366,2021-08-11,14:00:00,184,93,91,FMN GV 16 Berchem TOT
54,Posthofbrug 5366,2021-08-11,15:00:00,216,99,117,FMN GV 16 Berchem TOT
54,Posthofbrug 5366,2021-08-11,16:00:00,286,116,170,FMN GV 16 Berchem TOT
54,Posthofbrug 5366,2021-08-11,17:00:00,374,153,221,FMN GV 16 Berchem TOT
54,Posthofbrug 5366,2021-08-11,18:00:00,50,16,34,FMN GV 16 Berchem TOT
54,Posthofbrug 5366,2021-08-11,19:00:00,0,0,0,FMN GV 16 Berchem TOT
54,Posthofbrug 5366,2021-08-11,20:00:00,0,0,0,FMN GV 16 Berchem TOT
54,Posthofbrug 5366,2021-08-11,21:00:00,0,0,0,FMN GV 16 Berchem TOT
54,Posthofbrug 5366,2021-08-11,22:00:00,88,28,60,FMN GV 16 Berchem TOT
54,Posthofbrug 5366,2021-08-11,23:00:00,65,26,39,FMN GV 16 Berchem TOT
54,Posthofbrug 5366,2021-08-12,00:00:00,35,15,20,FMN GV 16 Berchem TOT
54,Posthofbrug 5366,2021-08-12,01:00:00,24,10,14,FMN GV 16 Berchem TOT
54,Posthofbrug 5366,2021-08-12,02:00:00,9,2,7,FMN GV 16 Berchem TOT
54,Posthofbrug 5366,2021-08-12,03:00:00,4,2,2,FMN GV 16 Berchem TOT
54,Posthofbrug 5366,2021-08-12,04:00:00,12,7,5,FMN GV 16 Berchem TOT
54,Posthofbrug 5366,2021-08-12,05:00:00,30,23,7,FMN GV 16 Berchem TOT
54,Posthofbrug 5366,2021-08-12,06:00:00,70,54,16,FMN GV 16 Berchem TOT
54,Posthofbrug 5366,2021-08-12,07:00:00,176,123,53,FMN GV 16 Berchem TOT
54,Posthofbrug 5366,2021-08-12,08:00:00,312,225,87,FMN GV 16 Berchem TOT
54,Posthofbrug 5366,2021-08-12,09:00:00,162,126,36,FMN GV 16 Berchem TOT
54,Posthofbrug 5366,2021-08-12,10:00:00,112,71,41,FMN GV 16 Berchem TOT
54,Posthofbrug 5366,2021-08-12,11:00:00,145,98,47,FMN GV 16 Berchem TOT
54,Posthofbrug 5366,2021-08-12,12:00:00,124,66,58,FMN GV 16 Berchem TOT
54,Posthofbrug 5366,2021-08-12,13:00:00,152,83,69,FMN GV 16 Berchem TOT
54,Posthofbrug 5366,2021-08-12,14:00:00,154,65,89,FMN GV 16 Berchem TOT
54,Posthofbrug 5366,2021-08-12,15:00:00,202,93,109,FMN GV 16 Berchem TOT
54,Posthofbrug 5366,2021-08-12,16:00:00,245,85,160,FMN GV 16 Berchem TOT
54,Posthofbrug 5366,2021-08-12,17:00:00,361,129,232,FMN GV 16 Berchem TOT
54,Posthofbrug 5366,2021-08-12,18:00:00,52,19,33,FMN GV 16 Berchem TOT
54,Posthofbrug 5366,2021-08-12,19:00:00,0,0,0,FMN GV 16 Berchem TOT
54,Posthofbrug 5366,2021-08-12,20:00:00,0,0,0,FMN GV 16 Berchem TOT
54,Posthofbrug 5366,2021-08-12,21:00:00,0,0,0,FMN GV 16 Berchem TOT
54,Posthofbrug 5366,2021-08-12,22:00:00,88,40,48,FMN GV 16 Berchem TOT
54,Posthofbrug 5366,2021-08-12,23:00:00,65,25,40,FMN GV 16 Berchem TOT
54,Posthofbrug 5366,2021-08-13,00:00:00,49,12,37,FMN GV 16 Berchem TOT
54,Posthofbrug 5366,2021-08-13,01:00:00,27,10,17,FMN GV 16 Berchem TOT
54,Posthofbrug 5366,2021-08-13,02:00:00,14,4,10,FMN GV 16 Berchem TOT
54,Posthofbrug 5366,2021-08-13,03:00:00,3,2,1,FMN GV 16 Berchem TOT
54,Posthofbrug 5366,2021-08-13,04:00:00,11,9,2,FMN GV 16 Berchem TOT
54,Posthofbrug 5366,2021-08-13,05:00:00,23,15,8,FMN GV 16 Berchem TOT
54,Posthofbrug 5366,2021-08-13,06:00:00,64,46,18,FMN GV 16 Berchem TOT
54,Posthofbrug 5366,2021-08-13,07:00:00,154,108,46,FMN GV 16 Berchem TOT
54,Posthofbrug 5366,2021-08-13,08:00:00,213,159,54,FMN GV 16 Berchem TOT
54,Posthofbrug 5366,2021-08-13,09:00:00,173,125,48,FMN GV 16 Berchem TOT
54,Posthofbrug 5366,2021-08-13,10:00:00,134,88,46,FMN GV 16 Berchem TOT
54,Posthofbrug 5366,2021-08-13,11:00:00,132,76,56,FMN GV 16 Berchem TOT
54,Posthofbrug 5366,2021-08-13,12:00:00,128,65,63,FMN GV 16 Berchem TOT
54,Posthofbrug 5366,2021-08-13,13:00:00,186,98,88,FMN GV 16 Berchem TOT
54,Posthofbrug 5366,2021-08-13,14:00:00,163,83,80,FMN GV 16 Berchem TOT
54,Posthofbrug 5366,2021-08-13,15:00:00,184,87,97,FMN GV 16 Berchem TOT
54,Posthofbrug 5366,2021-08-13,16:00:00,295,120,175,FMN GV 16 Berchem TOT
54,Posthofbrug 5366,2021-08-13,17:00:00,319,137,182,FMN GV 16 Berchem TOT
54,Posthofbrug 5366,2021-08-13,18:00:00,207,98,109,FMN GV 16 Berchem TOT
54,Posthofbrug 5366,2021-08-13,19:00:00,164,85,79,FMN GV 16 Berchem TOT
54,Posthofbrug 5366,2021-08-13,20:00:00,127,60,67,FMN GV 16 Berchem TOT
54,Posthofbrug 5366,2021-08-13,21:00:00,89,45,44,FMN GV 16 Berchem TOT
54,Posthofbrug 5366,2021-08-13,22:00:00,86,23,63,FMN GV 16 Berchem TOT
54,Posthofbrug 5366,2021-08-13,23:00:00,69,30,39,FMN GV 16 Berchem TOT
54,Posthofbrug 5366,2021-08-14,00:00:00,73,24,49,FMN GV 16 Berchem TOT
54,Posthofbrug 5366,2021-08-14,01:00:00,61,20,41,FMN GV 16 Berchem TOT
54,Posthofbrug 5366,2021-08-14,02:00:00,16,4,12,FMN GV 16 Berchem TOT
54,Posthofbrug 5366,2021-08-14,03:00:00,14,5,9,FMN GV 16 Berchem TOT
54,Posthofbrug 5366,2021-08-14,04:00:00,9,2,7,FMN GV 16 Berchem TOT
54,Posthofbrug 5366,2021-08-14,05:00:00,9,6,3,FMN GV 16 Berchem TOT
54,Posthofbrug 5366,2021-08-14,06:00:00,21,15,6,FMN GV 16 Berchem TOT
54,Posthofbrug 5366,2021-08-14,07:00:00,35,20,15,FMN GV 16 Berchem TOT
54,Posthofbrug 5366,2021-08-14,08:00:00,51,35,16,FMN GV 16 Berchem TOT
54,Posthofbrug 5366,2021-08-14,09:00:00,117,88,29,FMN GV 16 Berchem TOT
54,Posthofbrug 5366,2021-08-14,10:00:00,146,103,43,FMN GV 16 Berchem TOT
54,Posthofbrug 5366,2021-08-14,11:00:00,192,130,62,FMN GV 16 Berchem TOT
54,Posthofbrug 5366,2021-08-14,12:00:00,160,89,71,FMN GV 16 Berchem TOT
54,Posthofbrug 5366,2021-08-14,13:00:00,198,104,94,FMN GV 16 Berchem TOT
54,Posthofbrug 5366,2021-08-14,14:00:00,207,118,89,FMN GV 16 Berchem TOT
54,Posthofbrug 5366,2021-08-14,15:00:00,208,119,89,FMN GV 16 Berchem TOT
54,Posthofbrug 5366,2021-08-14,16:00:00,224,102,122,FMN GV 16 Berchem TOT
54,Posthofbrug 5366,2021-08-14,17:00:00,171,83,88,FMN GV 16 Berchem TOT
54,Posthofbrug 5366,2021-08-14,18:00:00,181,84,97,FMN GV 16 Berchem TOT
54,Posthofbrug 5366,2021-08-14,19:00:00,126,61,65,FMN GV 16 Berchem TOT
54,Posthofbrug 5366,2021-08-14,20:00:00,83,49,34,FMN GV 16 Berchem TOT
54,Posthofbrug 5366,2021-08-14,21:00:00,83,25,58,FMN GV 16 Berchem TOT
54,Posthofbrug 5366,2021-08-14,22:00:00,82,39,43,FMN GV 16 Berchem TOT
54,Posthofbrug 5366,2021-08-14,23:00:00,65,24,41,FMN GV 16 Berchem TOT
54,Posthofbrug 5366,2021-08-15,00:00:00,49,17,32,FMN GV 16 Berchem TOT
54,Posthofbrug 5366,2021-08-15,01:00:00,39,7,32,FMN GV 16 Berchem TOT
54,Posthofbrug 5366,2021-08-15,02:00:00,27,13,14,FMN GV 16 Berchem TOT
54,Posthofbrug 5366,2021-08-15,03:00:00,9,3,6,FMN GV 16 Berchem TOT
54,Posthofbrug 5366,2021-08-15,04:00:00,10,7,3,FMN GV 16 Berchem TOT
54,Posthofbrug 5366,2021-08-15,05:00:00,8,6,2,FMN GV 16 Berchem TOT
54,Posthofbrug 5366,2021-08-15,06:00:00,17,9,8,FMN GV 16 Berchem TOT
54,Posthofbrug 5366,2021-08-15,07:00:00,19,11,8,FMN GV 16 Berchem TOT
54,Posthofbrug 5366,2021-08-15,08:00:00,54,30,24,FMN GV 16 Berchem TOT
54,Posthofbrug 5366,2021-08-15,09:00:00,82,50,32,FMN GV 16 Berchem TOT
54,Posthofbrug 5366,2021-08-15,10:00:00,127,68,59,FMN GV 16 Berchem TOT
54,Posthofbrug 5366,2021-08-15,11:00:00,162,100,62,FMN GV 16 Berchem TOT
54,Posthofbrug 5366,2021-08-15,12:00:00,165,97,68,FMN GV 16 Berchem TOT
54,Posthofbrug 5366,2021-08-15,13:00:00,189,115,74,FMN GV 16 Berchem TOT
54,Posthofbrug 5366,2021-08-15,14:00:00,231,121,110,FMN GV 16 Berchem TOT
54,Posthofbrug 5366,2021-08-15,15:00:00,197,109,88,FMN GV 16 Berchem TOT
54,Posthofbrug 5366,2021-08-15,16:00:00,151,68,83,FMN GV 16 Berchem TOT
54,Posthofbrug 5366,2021-08-15,17:00:00,157,83,74,FMN GV 16 Berchem TOT
54,Posthofbrug 5366,2021-08-15,18:00:00,133,61,72,FMN GV 16 Berchem TOT
54,Posthofbrug 5366,2021-08-15,19:00:00,103,55,48,FMN GV 16 Berchem TOT
54,Posthofbrug 5366,2021-08-15,20:00:00,99,41,58,FMN GV 16 Berchem TOT
54,Posthofbrug 5366,2021-08-15,21:00:00,100,53,47,FMN GV 16 Berchem TOT
54,Posthofbrug 5366,2021-08-15,22:00:00,77,40,37,FMN GV 16 Berchem TOT
54,Posthofbrug 5366,2021-08-15,23:00:00,30,14,16,FMN GV 16 Berchem TOT
54,Posthofbrug 5366,2021-08-16,00:00:00,9,2,7,FMN GV 16 Berchem TOT
54,Posthofbrug 5366,2021-08-16,01:00:00,16,4,12,FMN GV 16 Berchem TOT
54,Posthofbrug 5366,2021-08-16,02:00:00,13,5,8,FMN GV 16 Berchem TOT
54,Posthofbrug 5366,2021-08-16,03:00:00,4,2,2,FMN GV 16 Berchem TOT
54,Posthofbrug 5366,2021-08-16,04:00:00,4,3,1,FMN GV 16 Berchem TOT
54,Posthofbrug 5366,2021-08-16,05:00:00,13,7,6,FMN GV 16 Berchem TOT
54,Posthofbrug 5366,2021-08-16,06:00:00,49,39,10,FMN GV 16 Berchem TOT
54,Posthofbrug 5366,2021-08-16,07:00:00,154,113,41,FMN GV 16 Berchem TOT
54,Posthofbrug 5366,2021-08-16,08:00:00,271,197,74,FMN GV 16 Berchem TOT
54,Posthofbrug 5366,2021-08-16,09:00:00,102,73,29,FMN GV 16 Berchem TOT
54,Posthofbrug 5366,2021-08-16,10:00:00,84,49,35,FMN GV 16 Berchem TOT
54,Posthofbrug 5366,2021-08-16,11:00:00,74,52,22,FMN GV 16 Berchem TOT
54,Posthofbrug 5366,2021-08-16,12:00:00,83,55,28,FMN GV 16 Berchem TOT
54,Posthofbrug 5366,2021-08-16,13:00:00,103,55,48,FMN GV 16 Berchem TOT
54,Posthofbrug 5366,2021-08-16,14:00:00,64,25,39,FMN GV 16 Berchem TOT
54,Posthofbrug 5366,2021-08-16,15:00:00,97,29,68,FMN GV 16 Berchem TOT
54,Posthofbrug 5366,2021-08-16,16:00:00,169,50,119,FMN GV 16 Berchem TOT
54,Posthofbrug 5366,2021-08-16,17:00:00,218,80,138,FMN GV 16 Berchem TOT
54,Posthofbrug 5366,2021-08-16,18:00:00,155,43,112,FMN GV 16 Berchem TOT
54,Posthofbrug 5366,2021-08-16,19:00:00,101,47,54,FMN GV 16 Berchem TOT
54,Posthofbrug 5366,2021-08-16,20:00:00,72,34,38,FMN GV 16 Berchem TOT
54,Posthofbrug 5366,2021-08-16,21:00:00,54,27,27,FMN GV 16 Berchem TOT
54,Posthofbrug 5366,2021-08-16,22:00:00,59,28,31,FMN GV 16 Berchem TOT
54,Posthofbrug 5366,2021-08-16,23:00:00,36,9,27,FMN GV 16 Berchem TOT
54,Posthofbrug 5366,2021-08-17,00:00:00,24,10,14,FMN GV 16 Berchem TOT
54,Posthofbrug 5366,2021-08-17,01:00:00,9,7,2,FMN GV 16 Berchem TOT
54,Posthofbrug 5366,2021-08-17,02:00:00,4,3,1,FMN GV 16 Berchem TOT
54,Posthofbrug 5366,2021-08-17,03:00:00,2,1,1,FMN GV 16 Berchem TOT
54,Posthofbrug 5366,2021-08-17,04:00:00,5,5,0,FMN GV 16 Berchem TOT
54,Posthofbrug 5366,2021-08-17,05:00:00,18,13,5,FMN GV 16 Berchem TOT
54,Posthofbrug 5366,2021-08-17,06:00:00,78,69,9,FMN GV 16 Berchem TOT
54,Posthofbrug 5366,2021-08-17,07:00:00,201,146,55,FMN GV 16 Berchem TOT
54,Posthofbrug 5366,2021-08-17,08:00:00,309,234,75,FMN GV 16 Berchem TOT
54,Posthofbrug 5366,2021-08-17,09:00:00,152,105,47,FMN GV 16 Berchem TOT
54,Posthofbrug 5366,2021-08-17,10:00:00,102,64,38,FMN GV 16 Berchem TOT
54,Posthofbrug 5366,2021-08-17,11:00:00,79,39,40,FMN GV 16 Berchem TOT
54,Posthofbrug 5366,2021-08-17,12:00:00,86,51,35,FMN GV 16 Berchem TOT
54,Posthofbrug 5366,2021-08-17,13:00:00,66,29,37,FMN GV 16 Berchem TOT
54,Posthofbrug 5366,2021-08-17,14:00:00,58,27,31,FMN GV 16 Berchem TOT
54,Posthofbrug 5366,2021-08-17,15:00:00,88,29,59,FMN GV 16 Berchem TOT
54,Posthofbrug 5366,2021-08-17,16:00:00,175,60,115,FMN GV 16 Berchem TOT
54,Posthofbrug 5366,2021-08-17,17:00:00,290,83,207,FMN GV 16 Berchem TOT
54,Posthofbrug 5366,2021-08-17,18:00:00,204,56,148,FMN GV 16 Berchem TOT
54,Posthofbrug 5366,2021-08-17,19:00:00,95,33,62,FMN GV 16 Berchem TOT
54,Posthofbrug 5366,2021-08-17,20:00:00,53,19,34,FMN GV 16 Berchem TOT
54,Posthofbrug 5366,2021-08-17,21:00:00,49,30,19,FMN GV 16 Berchem TOT
54,Posthofbrug 5366,2021-08-17,22:00:00,46,23,23,FMN GV 16 Berchem TOT
54,Posthofbrug 5366,2021-08-17,23:00:00,26,10,16,FMN GV 16 Berchem TOT
54,Posthofbrug 5366,2021-08-18,00:00:00,15,7,8,FMN GV 16 Berchem TOT
54,Posthofbrug 5366,2021-08-18,01:00:00,7,1,6,FMN GV 16 Berchem TOT
54,Posthofbrug 5366,2021-08-18,02:00:00,5,3,2,FMN GV 16 Berchem TOT
54,Posthofbrug 5366,2021-08-18,03:00:00,4,1,3,FMN GV 16 Berchem TOT
54,Posthofbrug 5366,2021-08-18,04:00:00,3,2,1,FMN GV 16 Berchem TOT
54,Posthofbrug 5366,2021-08-18,05:00:00,10,6,4,FMN GV 16 Berchem TOT
54,Posthofbrug 5366,2021-08-18,06:00:00,76,62,14,FMN GV 16 Berchem TOT
54,Posthofbrug 5366,2021-08-18,07:00:00,179,124,55,FMN GV 16 Berchem TOT
54,Posthofbrug 5366,2021-08-18,08:00:00,256,187,69,FMN GV 16 Berchem TOT
54,Posthofbrug 5366,2021-08-18,09:00:00,143,100,43,FMN GV 16 Berchem TOT
54,Posthofbrug 5366,2021-08-18,10:00:00,84,54,30,FMN GV 16 Berchem TOT
54,Posthofbrug 5366,2021-08-18,11:00:00,96,55,41,FMN GV 16 Berchem TOT
54,Posthofbrug 5366,2021-08-18,12:00:00,104,59,45,FMN GV 16 Berchem TOT
54,Posthofbrug 5366,2021-08-18,13:00:00,110,59,51,FMN GV 16 Berchem TOT
54,Posthofbrug 5366,2021-08-18,14:00:00,103,40,63,FMN GV 16 Berchem TOT
54,Posthofbrug 5366,2021-08-18,15:00:00,122,45,77,FMN GV 16 Berchem TOT
54,Posthofbrug 5366,2021-08-18,16:00:00,212,79,133,FMN GV 16 Berchem TOT
54,Posthofbrug 5366,2021-08-18,17:00:00,329,131,198,FMN GV 16 Berchem TOT
54,Posthofbrug 5366,2021-08-18,18:00:00,215,108,107,FMN GV 16 Berchem TOT
54,Posthofbrug 5366,2021-08-18,19:00:00,136,72,64,FMN GV 16 Berchem TOT
54,Posthofbrug 5366,2021-08-18,20:00:00,93,50,43,FMN GV 16 Berchem TOT
54,Posthofbrug 5366,2021-08-18,21:00:00,50,24,26,FMN GV 16 Berchem TOT
54,Posthofbrug 5366,2021-08-18,22:00:00,87,28,59,FMN GV 16 Berchem TOT
54,Posthofbrug 5366,2021-08-18,23:00:00,63,29,34,FMN GV 16 Berchem TOT
54,Posthofbrug 5366,2021-08-19,00:00:00,31,11,20,FMN GV 16 Berchem TOT
54,Posthofbrug 5366,2021-08-19,01:00:00,23,4,19,FMN GV 16 Berchem TOT
54,Posthofbrug 5366,2021-08-19,02:00:00,11,2,9,FMN GV 16 Berchem TOT
54,Posthofbrug 5366,2021-08-19,03:00:00,9,1,8,FMN GV 16 Berchem TOT
54,Posthofbrug 5366,2021-08-19,04:00:00,3,1,2,FMN GV 16 Berchem TOT
54,Posthofbrug 5366,2021-08-19,05:00:00,23,18,5,FMN GV 16 Berchem TOT
54,Posthofbrug 5366,2021-08-19,06:00:00,73,59,14,FMN GV 16 Berchem TOT
54,Posthofbrug 5366,2021-08-19,07:00:00,218,158,60,FMN GV 16 Berchem TOT
54,Posthofbrug 5366,2021-08-19,08:00:00,296,224,72,FMN GV 16 Berchem TOT
54,Posthofbrug 5366,2021-08-19,09:00:00,156,118,38,FMN GV 16 Berchem TOT
54,Posthofbrug 5366,2021-08-19,10:00:00,75,47,28,FMN GV 16 Berchem TOT
54,Posthofbrug 5366,2021-08-19,11:00:00,96,53,43,FMN GV 16 Berchem TOT
54,Posthofbrug 5366,2021-08-19,12:00:00,127,75,52,FMN GV 16 Berchem TOT
54,Posthofbrug 5366,2021-08-19,13:00:00,120,67,53,FMN GV 16 Berchem TOT
54,Posthofbrug 5366,2021-08-19,14:00:00,118,67,51,FMN GV 16 Berchem TOT
54,Posthofbrug 5366,2021-08-19,15:00:00,162,74,88,FMN GV 16 Berchem TOT
54,Posthofbrug 5366,2021-08-19,16:00:00,231,78,153,FMN GV 16 Berchem TOT
54,Posthofbrug 5366,2021-08-19,17:00:00,343,138,205,FMN GV 16 Berchem TOT
54,Posthofbrug 5366,2021-08-19,18:00:00,266,80,186,FMN GV 16 Berchem TOT
54,Posthofbrug 5366,2021-08-19,19:00:00,198,104,94,FMN GV 16 Berchem TOT
54,Posthofbrug 5366,2021-08-19,20:00:00,97,51,46,FMN GV 16 Berchem TOT
54,Posthofbrug 5366,2021-08-19,21:00:00,88,39,49,FMN GV 16 Berchem TOT
54,Posthofbrug 5366,2021-08-19,22:00:00,76,39,37,FMN GV 16 Berchem TOT
54,Posthofbrug 5366,2021-08-19,23:00:00,61,21,40,FMN GV 16 Berchem TOT
54,Posthofbrug 5366,2021-08-20,00:00:00,27,6,21,FMN GV 16 Berchem TOT
54,Posthofbrug 5366,2021-08-20,01:00:00,29,10,19,FMN GV 16 Berchem TOT
54,Posthofbrug 5366,2021-08-20,02:00:00,17,6,11,FMN GV 16 Berchem TOT
54,Posthofbrug 5366,2021-08-20,03:00:00,3,3,0,FMN GV 16 Berchem TOT
54,Posthofbrug 5366,2021-08-20,04:00:00,6,2,4,FMN GV 16 Berchem TOT
54,Posthofbrug 5366,2021-08-20,05:00:00,16,12,4,FMN GV 16 Berchem TOT
54,Posthofbrug 5366,2021-08-20,06:00:00,46,37,9,FMN GV 16 Berchem TOT
54,Posthofbrug 5366,2021-08-20,07:00:00,170,119,51,FMN GV 16 Berchem TOT
54,Posthofbrug 5366,2021-08-20,08:00:00,240,176,64,FMN GV 16 Berchem TOT
54,Posthofbrug 5366,2021-08-20,09:00:00,134,104,30,FMN GV 16 Berchem TOT
54,Posthofbrug 5366,2021-08-20,10:00:00,82,57,25,FMN GV 16 Berchem TOT
54,Posthofbrug 5366,2021-08-20,11:00:00,117,66,51,FMN GV 16 Berchem TOT
54,Posthofbrug 5366,2021-08-20,12:00:00,132,79,53,FMN GV 16 Berchem TOT
54,Posthofbrug 5366,2021-08-20,13:00:00,133,69,64,FMN GV 16 Berchem TOT
54,Posthofbrug 5366,2021-08-20,14:00:00,138,69,69,FMN GV 16 Berchem TOT
54,Posthofbrug 5366,2021-08-20,15:00:00,134,69,65,FMN GV 16 Berchem TOT
54,Posthofbrug 5366,2021-08-20,16:00:00,240,96,144,FMN GV 16 Berchem TOT
54,Posthofbrug 5366,2021-08-20,17:00:00,258,104,154,FMN GV 16 Berchem TOT
54,Posthofbrug 5366,2021-08-20,18:00:00,212,95,117,FMN GV 16 Berchem TOT
54,Posthofbrug 5366,2021-08-20,19:00:00,163,83,80,FMN GV 16 Berchem TOT
54,Posthofbrug 5366,2021-08-20,20:00:00,89,58,31,FMN GV 16 Berchem TOT
54,Posthofbrug 5366,2021-08-20,21:00:00,71,28,43,FMN GV 16 Berchem TOT
54,Posthofbrug 5366,2021-08-20,22:00:00,90,31,59,FMN GV 16 Berchem TOT
54,Posthofbrug 5366,2021-08-20,23:00:00,79,26,53,FMN GV 16 Berchem TOT
54,Posthofbrug 5366,2021-08-21,00:00:00,63,27,36,FMN GV 16 Berchem TOT
54,Posthofbrug 5366,2021-08-21,01:00:00,44,14,30,FMN GV 16 Berchem TOT
54,Posthofbrug 5366,2021-08-21,02:00:00,14,4,10,FMN GV 16 Berchem TOT
54,Posthofbrug 5366,2021-08-21,03:00:00,9,0,9,FMN GV 16 Berchem TOT
54,Posthofbrug 5366,2021-08-21,04:00:00,10,1,9,FMN GV 16 Berchem TOT
54,Posthofbrug 5366,2021-08-21,05:00:00,14,7,7,FMN GV 16 Berchem TOT
54,Posthofbrug 5366,2021-08-21,06:00:00,11,11,0,FMN GV 16 Berchem TOT
54,Posthofbrug 5366,2021-08-21,07:00:00,29,20,9,FMN GV 16 Berchem TOT
54,Posthofbrug 5366,2021-08-21,08:00:00,58,32,26,FMN GV 16 Berchem TOT
54,Posthofbrug 5366,2021-08-21,09:00:00,108,72,36,FMN GV 16 Berchem TOT
54,Posthofbrug 5366,2021-08-21,10:00:00,162,91,71,FMN GV 16 Berchem TOT
54,Posthofbrug 5366,2021-08-21,11:00:00,206,124,82,FMN GV 16 Berchem TOT
54,Posthofbrug 5366,2021-08-21,12:00:00,176,115,61,FMN GV 16 Berchem TOT
54,Posthofbrug 5366,2021-08-21,13:00:00,197,118,79,FMN GV 16 Berchem TOT
54,Posthofbrug 5366,2021-08-21,14:00:00,248,123,125,FMN GV 16 Berchem TOT
54,Posthofbrug 5366,2021-08-21,15:00:00,199,99,100,FMN GV 16 Berchem TOT
54,Posthofbrug 5366,2021-08-21,16:00:00,163,79,84,FMN GV 16 Berchem TOT
54,Posthofbrug 5366,2021-08-21,17:00:00,178,78,100,FMN GV 16 Berchem TOT
54,Posthofbrug 5366,2021-08-21,18:00:00,166,75,91,FMN GV 16 Berchem TOT
54,Posthofbrug 5366,2021-08-21,19:00:00,109,54,55,FMN GV 16 Berchem TOT
54,Posthofbrug 5366,2021-08-21,20:00:00,74,31,43,FMN GV 16 Berchem TOT
54,Posthofbrug 5366,2021-08-21,21:00:00,29,11,18,FMN GV 16 Berchem TOT
54,Posthofbrug 5366,2021-08-21,22:00:00,45,14,31,FMN GV 16 Berchem TOT
54,Posthofbrug 5366,2021-08-21,23:00:00,35,17,18,FMN GV 16 Berchem TOT
54,Posthofbrug 5366,2021-08-22,00:00:00,47,20,27,FMN GV 16 Berchem TOT
54,Posthofbrug 5366,2021-08-22,01:00:00,23,4,19,FMN GV 16 Berchem TOT
54,Posthofbrug 5366,2021-08-22,02:00:00,15,6,9,FMN GV 16 Berchem TOT
54,Posthofbrug 5366,2021-08-22,03:00:00,11,6,5,FMN GV 16 Berchem TOT
54,Posthofbrug 5366,2021-08-22,04:00:00,9,3,6,FMN GV 16 Berchem TOT
54,Posthofbrug 5366,2021-08-22,05:00:00,6,4,2,FMN GV 16 Berchem TOT
54,Posthofbrug 5366,2021-08-22,06:00:00,14,12,2,FMN GV 16 Berchem TOT
54,Posthofbrug 5366,2021-08-22,07:00:00,16,11,5,FMN GV 16 Berchem TOT
54,Posthofbrug 5366,2021-08-22,08:00:00,21,15,6,FMN GV 16 Berchem TOT
54,Posthofbrug 5366,2021-08-22,09:00:00,77,47,30,FMN GV 16 Berchem TOT
54,Posthofbrug 5366,2021-08-22,10:00:00,65,34,31,FMN GV 16 Berchem TOT
54,Posthofbrug 5366,2021-08-22,11:00:00,102,69,33,FMN GV 16 Berchem TOT
54,Posthofbrug 5366,2021-08-22,12:00:00,82,46,36,FMN GV 16 Berchem TOT
54,Posthofbrug 5366,2021-08-22,13:00:00,98,48,50,FMN GV 16 Berchem TOT
54,Posthofbrug 5366,2021-08-22,14:00:00,61,28,33,FMN GV 16 Berchem TOT
54,Posthofbrug 5366,2021-08-22,15:00:00,67,28,39,FMN GV 16 Berchem TOT
54,Posthofbrug 5366,2021-08-22,16:00:00,47,24,23,FMN GV 16 Berchem TOT
54,Posthofbrug 5366,2021-08-22,17:00:00,79,36,43,FMN GV 16 Berchem TOT
54,Posthofbrug 5366,2021-08-22,18:00:00,63,28,35,FMN GV 16 Berchem TOT
54,Posthofbrug 5366,2021-08-22,19:00:00,59,25,34,FMN GV 16 Berchem TOT
54,Posthofbrug 5366,2021-08-22,20:00:00,54,31,23,FMN GV 16 Berchem TOT
54,Posthofbrug 5366,2021-08-22,21:00:00,41,22,19,FMN GV 16 Berchem TOT
54,Posthofbrug 5366,2021-08-22,22:00:00,23,9,14,FMN GV 16 Berchem TOT
54,Posthofbrug 5366,2021-08-22,23:00:00,31,16,15,FMN GV 16 Berchem TOT
54,Posthofbrug 5366,2021-08-23,00:00:00,13,6,7,FMN GV 16 Berchem TOT
54,Posthofbrug 5366,2021-08-23,01:00:00,5,2,3,FMN GV 16 Berchem TOT
54,Posthofbrug 5366,2021-08-23,02:00:00,4,2,2,FMN GV 16 Berchem TOT
54,Posthofbrug 5366,2021-08-23,03:00:00,1,1,0,FMN GV 16 Berchem TOT
54,Posthofbrug 5366,2021-08-23,04:00:00,7,6,1,FMN GV 16 Berchem TOT
54,Posthofbrug 5366,2021-08-23,05:00:00,17,10,7,FMN GV 16 Berchem TOT
54,Posthofbrug 5366,2021-08-23,06:00:00,64,54,10,FMN GV 16 Berchem TOT
54,Posthofbrug 5366,2021-08-23,07:00:00,219,150,69,FMN GV 16 Berchem TOT
54,Posthofbrug 5366,2021-08-23,08:00:00,338,263,75,FMN GV 16 Berchem TOT
54,Posthofbrug 5366,2021-08-23,09:00:00,173,130,43,FMN GV 16 Berchem TOT
54,Posthofbrug 5366,2021-08-23,10:00:00,110,77,33,FMN GV 16 Berchem TOT
54,Posthofbrug 5366,2021-08-23,11:00:00,83,48,35,FMN GV 16 Berchem TOT
54,Posthofbrug 5366,2021-08-23,12:00:00,126,69,57,FMN GV 16 Berchem TOT
54,Posthofbrug 5366,2021-08-23,13:00:00,124,73,51,FMN GV 16 Berchem TOT
54,Posthofbrug 5366,2021-08-23,14:00:00,127,67,60,FMN GV 16 Berchem TOT
54,Posthofbrug 5366,2021-08-23,15:00:00,130,52,78,FMN GV 16 Berchem TOT
54,Posthofbrug 5366,2021-08-23,16:00:00,264,94,170,FMN GV 16 Berchem TOT
54,Posthofbrug 5366,2021-08-23,17:00:00,400,124,276,FMN GV 16 Berchem TOT
54,Posthofbrug 5366,2021-08-23,18:00:00,279,93,186,FMN GV 16 Berchem TOT
54,Posthofbrug 5366,2021-08-23,19:00:00,155,82,73,FMN GV 16 Berchem TOT
54,Posthofbrug 5366,2021-08-23,20:00:00,113,54,59,FMN GV 16 Berchem TOT
54,Posthofbrug 5366,2021-08-23,21:00:00,87,38,49,FMN GV 16 Berchem TOT
54,Posthofbrug 5366,2021-08-23,22:00:00,56,23,33,FMN GV 16 Berchem TOT
54,Posthofbrug 5366,2021-08-23,23:00:00,49,19,30,FMN GV 16 Berchem TOT
54,Posthofbrug 5366,2021-08-24,00:00:00,30,12,18,FMN GV 16 Berchem TOT
54,Posthofbrug 5366,2021-08-24,01:00:00,15,3,12,FMN GV 16 Berchem TOT
54,Posthofbrug 5366,2021-08-24,02:00:00,11,0,11,FMN GV 16 Berchem TOT
54,Posthofbrug 5366,2021-08-24,03:00:00,7,1,6,FMN GV 16 Berchem TOT
54,Posthofbrug 5366,2021-08-24,04:00:00,11,6,5,FMN GV 16 Berchem TOT
54,Posthofbrug 5366,2021-08-24,05:00:00,21,16,5,FMN GV 16 Berchem TOT
54,Posthofbrug 5366,2021-08-24,06:00:00,92,75,17,FMN GV 16 Berchem TOT
54,Posthofbrug 5366,2021-08-24,07:00:00,276,214,62,FMN GV 16 Berchem TOT
54,Posthofbrug 5366,2021-08-24,08:00:00,472,366,106,FMN GV 16 Berchem TOT
54,Posthofbrug 5366,2021-08-24,09:00:00,235,167,68,FMN GV 16 Berchem TOT
54,Posthofbrug 5366,2021-08-24,10:00:00,7,5,2,FMN GV 16 Berchem TOT
54,Posthofbrug 5366,2021-08-24,11:00:00,0,0,0,FMN GV 16 Berchem TOT
54,Posthofbrug 5366,2021-08-24,12:00:00,0,0,0,FMN GV 16 Berchem TOT
54,Posthofbrug 5366,2021-08-24,13:00:00,0,0,0,FMN GV 16 Berchem TOT
54,Posthofbrug 5366,2021-08-24,14:00:00,0,0,0,FMN GV 16 Berchem TOT
54,Posthofbrug 5366,2021-08-24,15:00:00,0,0,0,FMN GV 16 Berchem TOT
54,Posthofbrug 5366,2021-08-24,16:00:00,0,0,0,FMN GV 16 Berchem TOT
54,Posthofbrug 5366,2021-08-24,17:00:00,0,0,0,FMN GV 16 Berchem TOT
54,Posthofbrug 5366,2021-08-24,18:00:00,0,0,0,FMN GV 16 Berchem TOT
54,Posthofbrug 5366,2021-08-24,19:00:00,0,0,0,FMN GV 16 Berchem TOT
54,Posthofbrug 5366,2021-08-24,20:00:00,134,68,66,FMN GV 16 Berchem TOT
54,Posthofbrug 5366,2021-08-24,21:00:00,124,71,53,FMN GV 16 Berchem TOT
54,Posthofbrug 5366,2021-08-24,22:00:00,100,46,54,FMN GV 16 Berchem TOT
54,Posthofbrug 5366,2021-08-24,23:00:00,75,43,32,FMN GV 16 Berchem TOT
54,Posthofbrug 5366,2021-08-25,00:00:00,30,14,16,FMN GV 16 Berchem TOT
54,Posthofbrug 5366,2021-08-25,01:00:00,19,1,18,FMN GV 16 Berchem TOT
54,Posthofbrug 5366,2021-08-25,02:00:00,17,4,13,FMN GV 16 Berchem TOT
54,Posthofbrug 5366,2021-08-25,03:00:00,3,2,1,FMN GV 16 Berchem TOT
54,Posthofbrug 5366,2021-08-25,04:00:00,11,7,4,FMN GV 16 Berchem TOT
54,Posthofbrug 5366,2021-08-25,05:00:00,19,16,3,FMN GV 16 Berchem TOT
54,Posthofbrug 5366,2021-08-25,06:00:00,92,71,21,FMN GV 16 Berchem TOT
54,Posthofbrug 5366,2021-08-25,07:00:00,239,165,74,FMN GV 16 Berchem TOT
54,Posthofbrug 5366,2021-08-25,08:00:00,406,305,101,FMN GV 16 Berchem TOT
54,Posthofbrug 5366,2021-08-25,09:00:00,237,172,65,FMN GV 16 Berchem TOT
54,Posthofbrug 5366,2021-08-25,10:00:00,145,103,42,FMN GV 16 Berchem TOT
54,Posthofbrug 5366,2021-08-25,11:00:00,154,90,64,FMN GV 16 Berchem TOT
54,Posthofbrug 5366,2021-08-25,12:00:00,160,97,63,FMN GV 16 Berchem TOT
54,Posthofbrug 5366,2021-08-25,13:00:00,191,106,85,FMN GV 16 Berchem TOT
54,Posthofbrug 5366,2021-08-25,14:00:00,25,12,13,FMN GV 16 Berchem TOT
54,Posthofbrug 5366,2021-08-25,15:00:00,0,0,0,FMN GV 16 Berchem TOT
54,Posthofbrug 5366,2021-08-25,16:00:00,0,0,0,FMN GV 16 Berchem TOT
54,Posthofbrug 5366,2021-08-25,17:00:00,0,0,0,FMN GV 16 Berchem TOT
54,Posthofbrug 5366,2021-08-25,18:00:00,0,0,0,FMN GV 16 Berchem TOT
54,Posthofbrug 5366,2021-08-25,19:00:00,0,0,0,FMN GV 16 Berchem TOT
54,Posthofbrug 5366,2021-08-25,20:00:00,0,0,0,FMN GV 16 Berchem TOT
54,Posthofbrug 5366,2021-08-25,21:00:00,0,0,0,FMN GV 16 Berchem TOT
54,Posthofbrug 5366,2021-08-25,22:00:00,82,36,46,FMN GV 16 Berchem TOT
54,Posthofbrug 5366,2021-08-25,23:00:00,67,19,48,FMN GV 16 Berchem TOT
54,Posthofbrug 5366,2021-08-26,00:00:00,41,14,27,FMN GV 16 Berchem TOT
54,Posthofbrug 5366,2021-08-26,01:00:00,28,7,21,FMN GV 16 Berchem TOT
54,Posthofbrug 5366,2021-08-26,02:00:00,12,5,7,FMN GV 16 Berchem TOT
54,Posthofbrug 5366,2021-08-26,03:00:00,9,6,3,FMN GV 16 Berchem TOT
54,Posthofbrug 5366,2021-08-26,04:00:00,9,7,2,FMN GV 16 Berchem TOT
54,Posthofbrug 5366,2021-08-26,05:00:00,17,12,5,FMN GV 16 Berchem TOT
54,Posthofbrug 5366,2021-08-26,06:00:00,73,59,14,FMN GV 16 Berchem TOT
54,Posthofbrug 5366,2021-08-26,07:00:00,223,163,60,FMN GV 16 Berchem TOT
54,Posthofbrug 5366,2021-08-26,08:00:00,440,333,107,FMN GV 16 Berchem TOT
54,Posthofbrug 5366,2021-08-26,09:00:00,207,163,44,FMN GV 16 Berchem TOT
54,Posthofbrug 5366,2021-08-26,10:00:00,83,56,27,FMN GV 16 Berchem TOT
54,Posthofbrug 5366,2021-08-26,11:00:00,115,49,66,FMN GV 16 Berchem TOT
54,Posthofbrug 5366,2021-08-26,12:00:00,141,75,66,FMN GV 16 Berchem TOT
54,Posthofbrug 5366,2021-08-26,13:00:00,135,75,60,FMN GV 16 Berchem TOT
54,Posthofbrug 5366,2021-08-26,14:00:00,113,41,72,FMN GV 16 Berchem TOT
54,Posthofbrug 5366,2021-08-26,15:00:00,180,66,114,FMN GV 16 Berchem TOT
54,Posthofbrug 5366,2021-08-26,16:00:00,44,12,32,FMN GV 16 Berchem TOT
54,Posthofbrug 5366,2021-08-26,17:00:00,0,0,0,FMN GV 16 Berchem TOT
54,Posthofbrug 5366,2021-08-26,18:00:00,0,0,0,FMN GV 16 Berchem TOT
54,Posthofbrug 5366,2021-08-26,19:00:00,0,0,0,FMN GV 16 Berchem TOT
54,Posthofbrug 5366,2021-08-26,20:00:00,0,0,0,FMN GV 16 Berchem TOT
54,Posthofbrug 5366,2021-08-26,21:00:00,0,0,0,FMN GV 16 Berchem TOT
54,Posthofbrug 5366,2021-08-26,22:00:00,64,28,36,FMN GV 16 Berchem TOT
54,Posthofbrug 5366,2021-08-26,23:00:00,57,27,30,FMN GV 16 Berchem TOT
54,Posthofbrug 5366,2021-08-27,00:00:00,49,29,20,FMN GV 16 Berchem TOT
54,Posthofbrug 5366,2021-08-27,01:00:00,42,19,23,FMN GV 16 Berchem TOT
54,Posthofbrug 5366,2021-08-27,02:00:00,12,5,7,FMN GV 16 Berchem TOT
54,Posthofbrug 5366,2021-08-27,03:00:00,7,2,5,FMN GV 16 Berchem TOT
54,Posthofbrug 5366,2021-08-27,04:00:00,11,9,2,FMN GV 16 Berchem TOT
54,Posthofbrug 5366,2021-08-27,05:00:00,10,7,3,FMN GV 16 Berchem TOT
54,Posthofbrug 5366,2021-08-27,06:00:00,64,52,12,FMN GV 16 Berchem TOT
54,Posthofbrug 5366,2021-08-27,07:00:00,172,115,57,FMN GV 16 Berchem TOT
54,Posthofbrug 5366,2021-08-27,08:00:00,366,286,80,FMN GV 16 Berchem TOT
54,Posthofbrug 5366,2021-08-27,09:00:00,200,146,54,FMN GV 16 Berchem TOT
54,Posthofbrug 5366,2021-08-27,10:00:00,12,5,7,FMN GV 16 Berchem TOT
54,Posthofbrug 5366,2021-08-27,11:00:00,0,0,0,FMN GV 16 Berchem TOT
54,Posthofbrug 5366,2021-08-27,12:00:00,0,0,0,FMN GV 16 Berchem TOT
54,Posthofbrug 5366,2021-08-27,13:00:00,0,0,0,FMN GV 16 Berchem TOT
54,Posthofbrug 5366,2021-08-27,14:00:00,0,0,0,FMN GV 16 Berchem TOT
54,Posthofbrug 5366,2021-08-27,15:00:00,0,0,0,FMN GV 16 Berchem TOT
54,Posthofbrug 5366,2021-08-27,16:00:00,0,0,0,FMN GV 16 Berchem TOT
54,Posthofbrug 5366,2021-08-27,17:00:00,0,0,0,FMN GV 16 Berchem TOT
54,Posthofbrug 5366,2021-08-27,18:00:00,0,0,0,FMN GV 16 Berchem TOT
54,Posthofbrug 5366,2021-08-27,19:00:00,0,0,0,FMN GV 16 Berchem TOT
54,Posthofbrug 5366,2021-08-27,20:00:00,0,0,0,FMN GV 16 Berchem TOT
54,Posthofbrug 5366,2021-08-27,21:00:00,0,0,0,FMN GV 16 Berchem TOT
54,Posthofbrug 5366,2021-08-27,22:00:00,74,25,49,FMN GV 16 Berchem TOT
54,Posthofbrug 5366,2021-08-27,23:00:00,89,39,50,FMN GV 16 Berchem TOT
54,Posthofbrug 5366,2021-08-28,00:00:00,78,35,43,FMN GV 16 Berchem TOT
54,Posthofbrug 5366,2021-08-28,01:00:00,74,37,37,FMN GV 16 Berchem TOT
54,Posthofbrug 5366,2021-08-28,02:00:00,16,9,7,FMN GV 16 Berchem TOT
54,Posthofbrug 5366,2021-08-28,03:00:00,13,4,9,FMN GV 16 Berchem TOT
54,Posthofbrug 5366,2021-08-28,04:00:00,11,7,4,FMN GV 16 Berchem TOT
54,Posthofbrug 5366,2021-08-28,05:00:00,9,5,4,FMN GV 16 Berchem TOT
54,Posthofbrug 5366,2021-08-28,06:00:00,14,11,3,FMN GV 16 Berchem TOT
54,Posthofbrug 5366,2021-08-28,07:00:00,32,23,9,FMN GV 16 Berchem TOT
54,Posthofbrug 5366,2021-08-28,08:00:00,84,63,21,FMN GV 16 Berchem TOT
54,Posthofbrug 5366,2021-08-28,09:00:00,116,81,35,FMN GV 16 Berchem TOT
54,Posthofbrug 5366,2021-08-28,10:00:00,113,61,52,FMN GV 16 Berchem TOT
54,Posthofbrug 5366,2021-08-28,11:00:00,146,97,49,FMN GV 16 Berchem TOT
54,Posthofbrug 5366,2021-08-28,12:00:00,144,88,56,FMN GV 16 Berchem TOT
54,Posthofbrug 5366,2021-08-28,13:00:00,150,85,65,FMN GV 16 Berchem TOT
54,Posthofbrug 5366,2021-08-28,14:00:00,172,88,84,FMN GV 16 Berchem TOT
54,Posthofbrug 5366,2021-08-28,15:00:00,164,83,81,FMN GV 16 Berchem TOT
54,Posthofbrug 5366,2021-08-28,16:00:00,132,59,73,FMN GV 16 Berchem TOT
54,Posthofbrug 5366,2021-08-28,17:00:00,154,74,80,FMN GV 16 Berchem TOT
54,Posthofbrug 5366,2021-08-28,18:00:00,120,47,73,FMN GV 16 Berchem TOT
54,Posthofbrug 5366,2021-08-28,19:00:00,138,66,72,FMN GV 16 Berchem TOT
54,Posthofbrug 5366,2021-08-28,20:00:00,124,64,60,FMN GV 16 Berchem TOT
54,Posthofbrug 5366,2021-08-28,21:00:00,98,53,45,FMN GV 16 Berchem TOT
54,Posthofbrug 5366,2021-08-28,22:00:00,99,38,61,FMN GV 16 Berchem TOT
54,Posthofbrug 5366,2021-08-28,23:00:00,64,22,42,FMN GV 16 Berchem TOT
54,Posthofbrug 5366,2021-08-29,00:00:00,73,35,38,FMN GV 16 Berchem TOT
54,Posthofbrug 5366,2021-08-29,01:00:00,78,55,23,FMN GV 16 Berchem TOT
54,Posthofbrug 5366,2021-08-29,02:00:00,29,14,15,FMN GV 16 Berchem TOT
54,Posthofbrug 5366,2021-08-29,03:00:00,10,5,5,FMN GV 16 Berchem TOT
54,Posthofbrug 5366,2021-08-29,04:00:00,14,5,9,FMN GV 16 Berchem TOT
54,Posthofbrug 5366,2021-08-29,05:00:00,6,2,4,FMN GV 16 Berchem TOT
54,Posthofbrug 5366,2021-08-29,06:00:00,11,11,0,FMN GV 16 Berchem TOT
54,Posthofbrug 5366,2021-08-29,07:00:00,28,19,9,FMN GV 16 Berchem TOT
54,Posthofbrug 5366,2021-08-29,08:00:00,38,29,9,FMN GV 16 Berchem TOT
54,Posthofbrug 5366,2021-08-29,09:00:00,73,41,32,FMN GV 16 Berchem TOT
54,Posthofbrug 5366,2021-08-29,10:00:00,119,60,59,FMN GV 16 Berchem TOT
54,Posthofbrug 5366,2021-08-29,11:00:00,170,108,62,FMN GV 16 Berchem TOT
54,Posthofbrug 5366,2021-08-29,12:00:00,130,73,57,FMN GV 16 Berchem TOT
54,Posthofbrug 5366,2021-08-29,13:00:00,149,83,66,FMN GV 16 Berchem TOT
54,Posthofbrug 5366,2021-08-29,14:00:00,120,59,61,FMN GV 16 Berchem TOT
54,Posthofbrug 5366,2021-08-29,15:00:00,140,75,65,FMN GV 16 Berchem TOT
54,Posthofbrug 5366,2021-08-29,16:00:00,130,63,67,FMN GV 16 Berchem TOT
54,Posthofbrug 5366,2021-08-29,17:00:00,120,48,72,FMN GV 16 Berchem TOT
54,Posthofbrug 5366,2021-08-29,18:00:00,130,66,64,FMN GV 16 Berchem TOT
54,Posthofbrug 5366,2021-08-29,19:00:00,67,42,25,FMN GV 16 Berchem TOT
54,Posthofbrug 5366,2021-08-29,20:00:00,53,29,24,FMN GV 16 Berchem TOT
54,Posthofbrug 5366,2021-08-29,21:00:00,95,51,44,FMN GV 16 Berchem TOT
54,Posthofbrug 5366,2021-08-29,22:00:00,72,39,33,FMN GV 16 Berchem TOT
54,Posthofbrug 5366,2021-08-29,23:00:00,21,3,18,FMN GV 16 Berchem TOT
54,Posthofbrug 5366,2021-08-30,00:00:00,27,22,5,FMN GV 16 Berchem TOT
54,Posthofbrug 5366,2021-08-30,01:00:00,25,14,11,FMN GV 16 Berchem TOT
54,Posthofbrug 5366,2021-08-30,02:00:00,12,4,8,FMN GV 16 Berchem TOT
54,Posthofbrug 5366,2021-08-30,03:00:00,5,4,1,FMN GV 16 Berchem TOT
54,Posthofbrug 5366,2021-08-30,04:00:00,7,4,3,FMN GV 16 Berchem TOT
54,Posthofbrug 5366,2021-08-30,05:00:00,21,13,8,FMN GV 16 Berchem TOT
54,Posthofbrug 5366,2021-08-30,06:00:00,72,60,12,FMN GV 16 Berchem TOT
54,Posthofbrug 5366,2021-08-30,07:00:00,248,177,71,FMN GV 16 Berchem TOT
54,Posthofbrug 5366,2021-08-30,08:00:00,434,351,83,FMN GV 16 Berchem TOT
54,Posthofbrug 5366,2021-08-30,09:00:00,203,147,56,FMN GV 16 Berchem TOT
54,Posthofbrug 5366,2021-08-30,10:00:00,103,74,29,FMN GV 16 Berchem TOT
54,Posthofbrug 5366,2021-08-30,11:00:00,105,61,44,FMN GV 16 Berchem TOT
54,Posthofbrug 5366,2021-08-30,12:00:00,156,87,69,FMN GV 16 Berchem TOT
54,Posthofbrug 5366,2021-08-30,13:00:00,165,81,84,FMN GV 16 Berchem TOT
54,Posthofbrug 5366,2021-08-30,14:00:00,161,74,87,FMN GV 16 Berchem TOT
54,Posthofbrug 5366,2021-08-30,15:00:00,180,73,107,FMN GV 16 Berchem TOT
54,Posthofbrug 5366,2021-08-30,16:00:00,320,87,233,FMN GV 16 Berchem TOT
54,Posthofbrug 5366,2021-08-30,17:00:00,412,124,288,FMN GV 16 Berchem TOT
54,Posthofbrug 5366,2021-08-30,18:00:00,313,101,212,FMN GV 16 Berchem TOT
54,Posthofbrug 5366,2021-08-30,19:00:00,173,78,95,FMN GV 16 Berchem TOT
54,Posthofbrug 5366,2021-08-30,20:00:00,120,71,49,FMN GV 16 Berchem TOT
54,Posthofbrug 5366,2021-08-30,21:00:00,80,42,38,FMN GV 16 Berchem TOT
54,Posthofbrug 5366,2021-08-30,22:00:00,87,23,64,FMN GV 16 Berchem TOT
54,Posthofbrug 5366,2021-08-30,23:00:00,42,13,29,FMN GV 16 Berchem TOT
54,Posthofbrug 5366,2021-08-31,00:00:00,30,10,20,FMN GV 16 Berchem TOT
54,Posthofbrug 5366,2021-08-31,01:00:00,17,5,12,FMN GV 16 Berchem TOT
54,Posthofbrug 5366,2021-08-31,02:00:00,6,3,3,FMN GV 16 Berchem TOT
54,Posthofbrug 5366,2021-08-31,03:00:00,2,1,1,FMN GV 16 Berchem TOT
54,Posthofbrug 5366,2021-08-31,04:00:00,10,4,6,FMN GV 16 Berchem TOT
54,Posthofbrug 5366,2021-08-31,05:00:00,33,21,12,FMN GV 16 Berchem TOT
54,Posthofbrug 5366,2021-08-31,06:00:00,91,74,17,FMN GV 16 Berchem TOT
54,Posthofbrug 5366,2021-08-31,07:00:00,274,194,80,FMN GV 16 Berchem TOT
54,Posthofbrug 5366,2021-08-31,08:00:00,465,371,94,FMN GV 16 Berchem TOT
54,Posthofbrug 5366,2021-08-31,09:00:00,218,169,49,FMN GV 16 Berchem TOT
54,Posthofbrug 5366,2021-08-31,10:00:00,127,82,45,FMN GV 16 Berchem TOT
54,Posthofbrug 5366,2021-08-31,11:00:00,155,86,69,FMN GV 16 Berchem TOT
54,Posthofbrug 5366,2021-08-31,12:00:00,192,103,89,FMN GV 16 Berchem TOT
54,Posthofbrug 5366,2021-08-31,13:00:00,194,109,85,FMN GV 16 Berchem TOT
54,Posthofbrug 5366,2021-08-31,14:00:00,25,13,12,FMN GV 16 Berchem TOT
54,Posthofbrug 5366,2021-08-31,15:00:00,0,0,0,FMN GV 16 Berchem TOT
54,Posthofbrug 5366,2021-08-31,16:00:00,0,0,0,FMN GV 16 Berchem TOT
54,Posthofbrug 5366,2021-08-31,17:00:00,0,0,0,FMN GV 16 Berchem TOT
54,Posthofbrug 5366,2021-08-31,18:00:00,0,0,0,FMN GV 16 Berchem TOT
54,Posthofbrug 5366,2021-08-31,19:00:00,0,0,0,FMN GV 16 Berchem TOT
54,Posthofbrug 5366,2021-08-31,20:00:00,114,66,48,FMN GV 16 Berchem TOT
54,Posthofbrug 5366,2021-08-31,21:00:00,91,45,46,FMN GV 16 Berchem TOT
54,Posthofbrug 5366,2021-08-31,22:00:00,72,33,39,FMN GV 16 Berchem TOT
54,Posthofbrug 5366,2021-08-31,23:00:00,45,23,22,FMN GV 16 Berchem TOT
54,Posthofbrug 5366,2021-09-01,00:00:00,26,9,17,FMN GV 16 Berchem TOT
54,Posthofbrug 5366,2021-09-01,01:00:00,11,5,6,FMN GV 16 Berchem TOT
54,Posthofbrug 5366,2021-09-01,02:00:00,11,3,8,FMN GV 16 Berchem TOT
54,Posthofbrug 5366,2021-09-01,03:00:00,5,3,2,FMN GV 16 Berchem TOT
54,Posthofbrug 5366,2021-09-01,04:00:00,8,5,3,FMN GV 16 Berchem TOT
54,Posthofbrug 5366,2021-09-01,05:00:00,29,18,11,FMN GV 16 Berchem TOT
54,Posthofbrug 5366,2021-09-01,06:00:00,88,76,12,FMN GV 16 Berchem TOT
54,Posthofbrug 5366,2021-09-01,07:00:00,350,258,92,FMN GV 16 Berchem TOT
54,Posthofbrug 5366,2021-09-01,08:00:00,542,397,145,FMN GV 16 Berchem TOT
54,Posthofbrug 5366,2021-09-01,09:00:00,255,200,55,FMN GV 16 Berchem TOT
54,Posthofbrug 5366,2021-09-01,10:00:00,111,70,41,FMN GV 16 Berchem TOT
54,Posthofbrug 5366,2021-09-01,11:00:00,139,74,65,FMN GV 16 Berchem TOT
54,Posthofbrug 5366,2021-09-01,12:00:00,278,115,163,FMN GV 16 Berchem TOT
54,Posthofbrug 5366,2021-09-01,13:00:00,216,100,116,FMN GV 16 Berchem TOT
54,Posthofbrug 5366,2021-09-01,14:00:00,19,11,8,FMN GV 16 Berchem TOT
54,Posthofbrug 5366,2021-09-01,15:00:00,0,0,0,FMN GV 16 Berchem TOT
54,Posthofbrug 5366,2021-09-01,16:00:00,0,0,0,FMN GV 16 Berchem TOT
54,Posthofbrug 5366,2021-09-01,17:00:00,0,0,0,FMN GV 16 Berchem TOT
54,Posthofbrug 5366,2021-09-01,18:00:00,261,100,161,FMN GV 16 Berchem TOT
54,Posthofbrug 5366,2021-09-01,19:00:00,171,71,100,FMN GV 16 Berchem TOT
54,Posthofbrug 5366,2021-09-01,20:00:00,127,64,63,FMN GV 16 Berchem TOT
54,Posthofbrug 5366,2021-09-01,21:00:00,69,32,37,FMN GV 16 Berchem TOT
54,Posthofbrug 5366,2021-09-01,22:00:00,90,40,50,FMN GV 16 Berchem TOT
54,Posthofbrug 5366,2021-09-01,23:00:00,44,12,32,FMN GV 16 Berchem TOT
54,Posthofbrug 5366,2021-09-02,00:00:00,26,10,16,FMN GV 16 Berchem TOT
54,Posthofbrug 5366,2021-09-02,01:00:00,11,0,11,FMN GV 16 Berchem TOT
54,Posthofbrug 5366,2021-09-02,02:00:00,9,6,3,FMN GV 16 Berchem TOT
54,Posthofbrug 5366,2021-09-02,03:00:00,6,1,5,FMN GV 16 Berchem TOT
54,Posthofbrug 5366,2021-09-02,04:00:00,20,7,13,FMN GV 16 Berchem TOT
54,Posthofbrug 5366,2021-09-02,05:00:00,29,16,13,FMN GV 16 Berchem TOT
54,Posthofbrug 5366,2021-09-02,06:00:00,90,79,11,FMN GV 16 Berchem TOT
54,Posthofbrug 5366,2021-09-02,07:00:00,400,309,91,FMN GV 16 Berchem TOT
54,Posthofbrug 5366,2021-09-02,08:00:00,677,547,130,FMN GV 16 Berchem TOT
54,Posthofbrug 5366,2021-09-02,09:00:00,231,184,47,FMN GV 16 Berchem TOT
54,Posthofbrug 5366,2021-09-02,10:00:00,19,10,9,FMN GV 16 Berchem TOT
54,Posthofbrug 5366,2021-09-02,11:00:00,0,0,0,FMN GV 16 Berchem TOT
54,Posthofbrug 5366,2021-09-02,12:00:00,0,0,0,FMN GV 16 Berchem TOT
54,Posthofbrug 5366,2021-09-02,13:00:00,0,0,0,FMN GV 16 Berchem TOT
54,Posthofbrug 5366,2021-09-02,14:00:00,151,64,87,FMN GV 16 Berchem TOT
54,Posthofbrug 5366,2021-09-02,15:00:00,289,101,188,FMN GV 16 Berchem TOT
54,Posthofbrug 5366,2021-09-02,16:00:00,437,142,295,FMN GV 16 Berchem TOT
54,Posthofbrug 5366,2021-09-02,17:00:00,504,141,363,FMN GV 16 Berchem TOT
54,Posthofbrug 5366,2021-09-02,18:00:00,60,18,42,FMN GV 16 Berchem TOT
54,Posthofbrug 5366,2021-09-02,19:00:00,0,0,0,FMN GV 16 Berchem TOT
54,Posthofbrug 5366,2021-09-02,20:00:00,123,65,58,FMN GV 16 Berchem TOT
54,Posthofbrug 5366,2021-09-02,21:00:00,124,55,69,FMN GV 16 Berchem TOT
54,Posthofbrug 5366,2021-09-02,22:00:00,103,34,69,FMN GV 16 Berchem TOT
54,Posthofbrug 5366,2021-09-02,23:00:00,67,9,58,FMN GV 16 Berchem TOT
54,Posthofbrug 5366,2021-09-03,00:00:00,38,13,25,FMN GV 16 Berchem TOT
54,Posthofbrug 5366,2021-09-03,01:00:00,16,7,9,FMN GV 16 Berchem TOT
54,Posthofbrug 5366,2021-09-03,02:00:00,13,4,9,FMN GV 16 Berchem TOT
54,Posthofbrug 5366,2021-09-03,03:00:00,10,4,6,FMN GV 16 Berchem TOT
54,Posthofbrug 5366,2021-09-03,04:00:00,12,9,3,FMN GV 16 Berchem TOT
54,Posthofbrug 5366,2021-09-03,05:00:00,26,19,7,FMN GV 16 Berchem TOT
54,Posthofbrug 5366,2021-09-03,06:00:00,93,77,16,FMN GV 16 Berchem TOT
54,Posthofbrug 5366,2021-09-03,07:00:00,339,251,88,FMN GV 16 Berchem TOT
54,Posthofbrug 5366,2021-09-03,08:00:00,599,460,139,FMN GV 16 Berchem TOT
54,Posthofbrug 5366,2021-09-03,09:00:00,218,157,61,FMN GV 16 Berchem TOT
54,Posthofbrug 5366,2021-09-03,10:00:00,26,18,8,FMN GV 16 Berchem TOT
54,Posthofbrug 5366,2021-09-03,11:00:00,0,0,0,FMN GV 16 Berchem TOT
54,Posthofbrug 5366,2021-09-03,12:00:00,0,0,0,FMN GV 16 Berchem TOT
54,Posthofbrug 5366,2021-09-03,13:00:00,0,0,0,FMN GV 16 Berchem TOT
54,Posthofbrug 5366,2021-09-03,14:00:00,0,0,0,FMN GV 16 Berchem TOT
54,Posthofbrug 5366,2021-09-03,15:00:00,0,0,0,FMN GV 16 Berchem TOT
54,Posthofbrug 5366,2021-09-03,16:00:00,349,114,235,FMN GV 16 Berchem TOT
54,Posthofbrug 5366,2021-09-03,17:00:00,417,138,279,FMN GV 16 Berchem TOT
54,Posthofbrug 5366,2021-09-03,18:00:00,310,121,189,FMN GV 16 Berchem TOT
54,Posthofbrug 5366,2021-09-03,19:00:00,194,91,103,FMN GV 16 Berchem TOT
54,Posthofbrug 5366,2021-09-03,20:00:00,150,84,66,FMN GV 16 Berchem TOT
54,Posthofbrug 5366,2021-09-03,21:00:00,98,51,47,FMN GV 16 Berchem TOT
54,Posthofbrug 5366,2021-09-03,22:00:00,100,37,63,FMN GV 16 Berchem TOT
54,Posthofbrug 5366,2021-09-03,23:00:00,86,34,52,FMN GV 16 Berchem TOT
54,Posthofbrug 5366,2021-09-04,00:00:00,54,15,39,FMN GV 16 Berchem TOT
54,Posthofbrug 5366,2021-09-04,01:00:00,39,17,22,FMN GV 16 Berchem TOT
54,Posthofbrug 5366,2021-09-04,02:00:00,25,9,16,FMN GV 16 Berchem TOT
54,Posthofbrug 5366,2021-09-04,03:00:00,25,8,17,FMN GV 16 Berchem TOT
54,Posthofbrug 5366,2021-09-04,04:00:00,17,10,7,FMN GV 16 Berchem TOT
54,Posthofbrug 5366,2021-09-04,05:00:00,11,8,3,FMN GV 16 Berchem TOT
54,Posthofbrug 5366,2021-09-04,06:00:00,15,9,6,FMN GV 16 Berchem TOT
54,Posthofbrug 5366,2021-09-04,07:00:00,38,21,17,FMN GV 16 Berchem TOT
54,Posthofbrug 5366,2021-09-04,08:00:00,74,48,26,FMN GV 16 Berchem TOT
54,Posthofbrug 5366,2021-09-04,09:00:00,130,96,34,FMN GV 16 Berchem TOT
54,Posthofbrug 5366,2021-09-04,10:00:00,167,105,62,FMN GV 16 Berchem TOT
54,Posthofbrug 5366,2021-09-04,11:00:00,185,120,65,FMN GV 16 Berchem TOT
54,Posthofbrug 5366,2021-09-04,12:00:00,162,84,78,FMN GV 16 Berchem TOT
54,Posthofbrug 5366,2021-09-04,13:00:00,189,97,92,FMN GV 16 Berchem TOT
54,Posthofbrug 5366,2021-09-04,14:00:00,191,114,77,FMN GV 16 Berchem TOT
54,Posthofbrug 5366,2021-09-04,15:00:00,246,103,143,FMN GV 16 Berchem TOT
54,Posthofbrug 5366,2021-09-04,16:00:00,208,98,110,FMN GV 16 Berchem TOT
54,Posthofbrug 5366,2021-09-04,17:00:00,178,85,93,FMN GV 16 Berchem TOT
54,Posthofbrug 5366,2021-09-04,18:00:00,190,73,117,FMN GV 16 Berchem TOT
54,Posthofbrug 5366,2021-09-04,19:00:00,129,62,67,FMN GV 16 Berchem TOT
54,Posthofbrug 5366,2021-09-04,20:00:00,107,46,61,FMN GV 16 Berchem TOT
54,Posthofbrug 5366,2021-09-04,21:00:00,69,37,32,FMN GV 16 Berchem TOT
54,Posthofbrug 5366,2021-09-04,22:00:00,101,50,51,FMN GV 16 Berchem TOT
54,Posthofbrug 5366,2021-09-04,23:00:00,54,26,28,FMN GV 16 Berchem TOT
54,Posthofbrug 5366,2021-09-05,00:00:00,62,25,37,FMN GV 16 Berchem TOT
54,Posthofbrug 5366,2021-09-05,01:00:00,46,21,25,FMN GV 16 Berchem TOT
54,Posthofbrug 5366,2021-09-05,02:00:00,24,11,13,FMN GV 16 Berchem TOT
54,Posthofbrug 5366,2021-09-05,03:00:00,23,11,12,FMN GV 16 Berchem TOT
54,Posthofbrug 5366,2021-09-05,04:00:00,6,1,5,FMN GV 16 Berchem TOT
54,Posthofbrug 5366,2021-09-05,05:00:00,11,6,5,FMN GV 16 Berchem TOT
54,Posthofbrug 5366,2021-09-05,06:00:00,18,14,4,FMN GV 16 Berchem TOT
54,Posthofbrug 5366,2021-09-05,07:00:00,21,9,12,FMN GV 16 Berchem TOT
54,Posthofbrug 5366,2021-09-05,08:00:00,44,18,26,FMN GV 16 Berchem TOT
54,Posthofbrug 5366,2021-09-05,09:00:00,115,78,37,FMN GV 16 Berchem TOT
54,Posthofbrug 5366,2021-09-05,10:00:00,151,102,49,FMN GV 16 Berchem TOT
54,Posthofbrug 5366,2021-09-05,11:00:00,209,130,79,FMN GV 16 Berchem TOT
54,Posthofbrug 5366,2021-09-05,12:00:00,185,111,74,FMN GV 16 Berchem TOT
54,Posthofbrug 5366,2021-09-05,13:00:00,265,153,112,FMN GV 16 Berchem TOT
54,Posthofbrug 5366,2021-09-05,14:00:00,278,155,123,FMN GV 16 Berchem TOT
54,Posthofbrug 5366,2021-09-05,15:00:00,260,123,137,FMN GV 16 Berchem TOT
54,Posthofbrug 5366,2021-09-05,16:00:00,252,112,140,FMN GV 16 Berchem TOT
54,Posthofbrug 5366,2021-09-05,17:00:00,219,111,108,FMN GV 16 Berchem TOT
54,Posthofbrug 5366,2021-09-05,18:00:00,211,113,98,FMN GV 16 Berchem TOT
54,Posthofbrug 5366,2021-09-05,19:00:00,141,78,63,FMN GV 16 Berchem TOT
54,Posthofbrug 5366,2021-09-05,20:00:00,119,71,48,FMN GV 16 Berchem TOT
54,Posthofbrug 5366,2021-09-05,21:00:00,108,35,73,FMN GV 16 Berchem TOT
54,Posthofbrug 5366,2021-09-05,22:00:00,72,31,41,FMN GV 16 Berchem TOT
54,Posthofbrug 5366,2021-09-05,23:00:00,35,10,25,FMN GV 16 Berchem TOT
54,Posthofbrug 5366,2021-09-06,00:00:00,21,8,13,FMN GV 16 Berchem TOT
54,Posthofbrug 5366,2021-09-06,01:00:00,13,2,11,FMN GV 16 Berchem TOT
54,Posthofbrug 5366,2021-09-06,02:00:00,12,3,9,FMN GV 16 Berchem TOT
54,Posthofbrug 5366,2021-09-06,03:00:00,7,3,4,FMN GV 16 Berchem TOT
54,Posthofbrug 5366,2021-09-06,04:00:00,13,11,2,FMN GV 16 Berchem TOT
54,Posthofbrug 5366,2021-09-06,05:00:00,30,21,9,FMN GV 16 Berchem TOT
54,Posthofbrug 5366,2021-09-06,06:00:00,94,77,17,FMN GV 16 Berchem TOT
54,Posthofbrug 5366,2021-09-06,07:00:00,399,297,102,FMN GV 16 Berchem TOT
54,Posthofbrug 5366,2021-09-06,08:00:00,641,493,148,FMN GV 16 Berchem TOT
54,Posthofbrug 5366,2021-09-06,09:00:00,212,167,45,FMN GV 16 Berchem TOT
54,Posthofbrug 5366,2021-09-06,10:00:00,137,95,42,FMN GV 16 Berchem TOT
54,Posthofbrug 5366,2021-09-06,11:00:00,133,83,50,FMN GV 16 Berchem TOT
54,Posthofbrug 5366,2021-09-06,12:00:00,182,91,91,FMN GV 16 Berchem TOT
54,Posthofbrug 5366,2021-09-06,13:00:00,141,82,59,FMN GV 16 Berchem TOT
54,Posthofbrug 5366,2021-09-06,14:00:00,184,100,84,FMN GV 16 Berchem TOT
54,Posthofbrug 5366,2021-09-06,15:00:00,304,124,180,FMN GV 16 Berchem TOT
54,Posthofbrug 5366,2021-09-06,16:00:00,417,125,292,FMN GV 16 Berchem TOT
54,Posthofbrug 5366,2021-09-06,17:00:00,528,139,389,FMN GV 16 Berchem TOT
54,Posthofbrug 5366,2021-09-06,18:00:00,335,113,222,FMN GV 16 Berchem TOT
54,Posthofbrug 5366,2021-09-06,19:00:00,191,83,108,FMN GV 16 Berchem TOT
54,Posthofbrug 5366,2021-09-06,20:00:00,133,52,81,FMN GV 16 Berchem TOT
54,Posthofbrug 5366,2021-09-06,21:00:00,94,53,41,FMN GV 16 Berchem TOT
54,Posthofbrug 5366,2021-09-06,22:00:00,65,23,42,FMN GV 16 Berchem TOT
54,Posthofbrug 5366,2021-09-06,23:00:00,49,21,28,FMN GV 16 Berchem TOT
54,Posthofbrug 5366,2021-09-07,00:00:00,11,3,8,FMN GV 16 Berchem TOT
54,Posthofbrug 5366,2021-09-07,01:00:00,10,6,4,FMN GV 16 Berchem TOT
54,Posthofbrug 5366,2021-09-07,02:00:00,13,1,12,FMN GV 16 Berchem TOT
54,Posthofbrug 5366,2021-09-07,03:00:00,6,3,3,FMN GV 16 Berchem TOT
54,Posthofbrug 5366,2021-09-07,04:00:00,13,12,1,FMN GV 16 Berchem TOT
54,Posthofbrug 5366,2021-09-07,05:00:00,35,21,14,FMN GV 16 Berchem TOT
54,Posthofbrug 5366,2021-09-07,06:00:00,113,92,21,FMN GV 16 Berchem TOT
54,Posthofbrug 5366,2021-09-07,07:00:00,430,326,104,FMN GV 16 Berchem TOT
54,Posthofbrug 5366,2021-09-07,08:00:00,112,94,18,FMN GV 16 Berchem TOT
54,Posthofbrug 5366,2021-09-07,09:00:00,0,0,0,FMN GV 16 Berchem TOT
54,Posthofbrug 5366,2021-09-07,10:00:00,0,0,0,FMN GV 16 Berchem TOT
54,Posthofbrug 5366,2021-09-07,11:00:00,0,0,0,FMN GV 16 Berchem TOT
54,Posthofbrug 5366,2021-09-07,12:00:00,0,0,0,FMN GV 16 Berchem TOT
54,Posthofbrug 5366,2021-09-07,13:00:00,0,0,0,FMN GV 16 Berchem TOT
54,Posthofbrug 5366,2021-09-07,14:00:00,0,0,0,FMN GV 16 Berchem TOT
54,Posthofbrug 5366,2021-09-07,15:00:00,0,0,0,FMN GV 16 Berchem TOT
54,Posthofbrug 5366,2021-09-07,16:00:00,0,0,0,FMN GV 16 Berchem TOT
54,Posthofbrug 5366,2021-09-07,17:00:00,0,0,0,FMN GV 16 Berchem TOT
54,Posthofbrug 5366,2021-09-07,18:00:00,0,0,0,FMN GV 16 Berchem TOT
54,Posthofbrug 5366,2021-09-07,19:00:00,0,0,0,FMN GV 16 Berchem TOT
54,Posthofbrug 5366,2021-09-07,20:00:00,147,90,57,FMN GV 16 Berchem TOT
54,Posthofbrug 5366,2021-09-07,21:00:00,114,50,64,FMN GV 16 Berchem TOT
54,Posthofbrug 5366,2021-09-07,22:00:00,86,33,53,FMN GV 16 Berchem TOT
54,Posthofbrug 5366,2021-09-07,23:00:00,66,29,37,FMN GV 16 Berchem TOT
54,Posthofbrug 5366,2021-09-08,00:00:00,33,16,17,FMN GV 16 Berchem TOT
54,Posthofbrug 5366,2021-09-08,01:00:00,17,7,10,FMN GV 16 Berchem TOT
54,Posthofbrug 5366,2021-09-08,02:00:00,6,0,6,FMN GV 16 Berchem TOT
54,Posthofbrug 5366,2021-09-08,03:00:00,5,2,3,FMN GV 16 Berchem TOT
54,Posthofbrug 5366,2021-09-08,04:00:00,16,12,4,FMN GV 16 Berchem TOT
54,Posthofbrug 5366,2021-09-08,05:00:00,28,17,11,FMN GV 16 Berchem TOT
54,Posthofbrug 5366,2021-09-08,06:00:00,110,92,18,FMN GV 16 Berchem TOT
54,Posthofbrug 5366,2021-09-08,07:00:00,371,275,96,FMN GV 16 Berchem TOT
54,Posthofbrug 5366,2021-09-08,08:00:00,593,422,171,FMN GV 16 Berchem TOT
54,Posthofbrug 5366,2021-09-08,09:00:00,205,144,61,FMN GV 16 Berchem TOT
54,Posthofbrug 5366,2021-09-08,10:00:00,159,103,56,FMN GV 16 Berchem TOT
54,Posthofbrug 5366,2021-09-08,11:00:00,161,77,84,FMN GV 16 Berchem TOT
54,Posthofbrug 5366,2021-09-08,12:00:00,343,157,186,FMN GV 16 Berchem TOT
54,Posthofbrug 5366,2021-09-08,13:00:00,226,103,123,FMN GV 16 Berchem TOT
54,Posthofbrug 5366,2021-09-08,14:00:00,231,109,122,FMN GV 16 Berchem TOT
54,Posthofbrug 5366,2021-09-08,15:00:00,215,84,131,FMN GV 16 Berchem TOT
54,Posthofbrug 5366,2021-09-08,16:00:00,340,142,198,FMN GV 16 Berchem TOT
54,Posthofbrug 5366,2021-09-08,17:00:00,482,176,306,FMN GV 16 Berchem TOT
54,Posthofbrug 5366,2021-09-08,18:00:00,375,156,219,FMN GV 16 Berchem TOT
54,Posthofbrug 5366,2021-09-08,19:00:00,227,104,123,FMN GV 16 Berchem TOT
54,Posthofbrug 5366,2021-09-08,20:00:00,168,88,80,FMN GV 16 Berchem TOT
54,Posthofbrug 5366,2021-09-08,21:00:00,137,61,76,FMN GV 16 Berchem TOT
54,Posthofbrug 5366,2021-09-08,22:00:00,121,47,74,FMN GV 16 Berchem TOT
54,Posthofbrug 5366,2021-09-08,23:00:00,60,15,45,FMN GV 16 Berchem TOT
54,Posthofbrug 5366,2021-09-09,00:00:00,37,8,29,FMN GV 16 Berchem TOT
54,Posthofbrug 5366,2021-09-09,01:00:00,5,1,4,FMN GV 16 Berchem TOT
54,Posthofbrug 5366,2021-09-09,02:00:00,5,1,4,FMN GV 16 Berchem TOT
54,Posthofbrug 5366,2021-09-09,03:00:00,6,1,5,FMN GV 16 Berchem TOT
54,Posthofbrug 5366,2021-09-09,04:00:00,15,12,3,FMN GV 16 Berchem TOT
54,Posthofbrug 5366,2021-09-09,05:00:00,32,18,14,FMN GV 16 Berchem TOT
54,Posthofbrug 5366,2021-09-09,06:00:00,94,77,17,FMN GV 16 Berchem TOT
54,Posthofbrug 5366,2021-09-09,07:00:00,391,284,107,FMN GV 16 Berchem TOT
54,Posthofbrug 5366,2021-09-09,08:00:00,642,509,133,FMN GV 16 Berchem TOT
54,Posthofbrug 5366,2021-09-09,09:00:00,222,178,44,FMN GV 16 Berchem TOT
54,Posthofbrug 5366,2021-09-09,10:00:00,102,66,36,FMN GV 16 Berchem TOT
54,Posthofbrug 5366,2021-09-09,11:00:00,128,64,64,FMN GV 16 Berchem TOT
54,Posthofbrug 5366,2021-09-09,12:00:00,176,96,80,FMN GV 16 Berchem TOT
54,Posthofbrug 5366,2021-09-09,13:00:00,150,75,75,FMN GV 16 Berchem TOT
54,Posthofbrug 5366,2021-09-09,14:00:00,140,60,80,FMN GV 16 Berchem TOT
54,Posthofbrug 5366,2021-09-09,15:00:00,268,96,172,FMN GV 16 Berchem TOT
54,Posthofbrug 5366,2021-09-09,16:00:00,434,145,289,FMN GV 16 Berchem TOT
54,Posthofbrug 5366,2021-09-09,17:00:00,470,130,340,FMN GV 16 Berchem TOT
54,Posthofbrug 5366,2021-09-09,18:00:00,77,32,45,FMN GV 16 Berchem TOT
54,Posthofbrug 5366,2021-09-09,19:00:00,0,0,0,FMN GV 16 Berchem TOT
54,Posthofbrug 5366,2021-09-09,20:00:00,0,0,0,FMN GV 16 Berchem TOT
54,Posthofbrug 5366,2021-09-09,21:00:00,0,0,0,FMN GV 16 Berchem TOT
54,Posthofbrug 5366,2021-09-09,22:00:00,64,19,45,FMN GV 16 Berchem TOT
54,Posthofbrug 5366,2021-09-09,23:00:00,57,15,42,FMN GV 16 Berchem TOT
54,Posthofbrug 5366,2021-09-10,00:00:00,34,9,25,FMN GV 16 Berchem TOT
54,Posthofbrug 5366,2021-09-10,01:00:00,15,3,12,FMN GV 16 Berchem TOT
54,Posthofbrug 5366,2021-09-10,02:00:00,12,0,12,FMN GV 16 Berchem TOT
54,Posthofbrug 5366,2021-09-10,03:00:00,10,2,8,FMN GV 16 Berchem TOT
54,Posthofbrug 5366,2021-09-10,04:00:00,14,12,2,FMN GV 16 Berchem TOT
54,Posthofbrug 5366,2021-09-10,05:00:00,23,15,8,FMN GV 16 Berchem TOT
54,Posthofbrug 5366,2021-09-10,06:00:00,74,66,8,FMN GV 16 Berchem TOT
54,Posthofbrug 5366,2021-09-10,07:00:00,301,217,84,FMN GV 16 Berchem TOT
54,Posthofbrug 5366,2021-09-10,08:00:00,501,379,122,FMN GV 16 Berchem TOT
54,Posthofbrug 5366,2021-09-10,09:00:00,175,138,37,FMN GV 16 Berchem TOT
54,Posthofbrug 5366,2021-09-10,10:00:00,103,65,38,FMN GV 16 Berchem TOT
54,Posthofbrug 5366,2021-09-10,11:00:00,124,71,53,FMN GV 16 Berchem TOT
54,Posthofbrug 5366,2021-09-10,12:00:00,155,69,86,FMN GV 16 Berchem TOT
54,Posthofbrug 5366,2021-09-10,13:00:00,126,54,72,FMN GV 16 Berchem TOT
54,Posthofbrug 5366,2021-09-10,14:00:00,138,70,68,FMN GV 16 Berchem TOT
54,Posthofbrug 5366,2021-09-10,15:00:00,262,95,167,FMN GV 16 Berchem TOT
54,Posthofbrug 5366,2021-09-10,16:00:00,44,16,28,FMN GV 16 Berchem TOT
54,Posthofbrug 5366,2021-09-10,17:00:00,0,0,0,FMN GV 16 Berchem TOT
54,Posthofbrug 5366,2021-09-10,18:00:00,0,0,0,FMN GV 16 Berchem TOT
54,Posthofbrug 5366,2021-09-10,19:00:00,0,0,0,FMN GV 16 Berchem TOT
54,Posthofbrug 5366,2021-09-10,20:00:00,0,0,0,FMN GV 16 Berchem TOT
54,Posthofbrug 5366,2021-09-10,21:00:00,0,0,0,FMN GV 16 Berchem TOT
54,Posthofbrug 5366,2021-09-10,22:00:00,58,19,39,FMN GV 16 Berchem TOT
54,Posthofbrug 5366,2021-09-10,23:00:00,52,19,33,FMN GV 16 Berchem TOT
54,Posthofbrug 5366,2021-09-11,00:00:00,52,17,35,FMN GV 16 Berchem TOT
54,Posthofbrug 5366,2021-09-11,01:00:00,47,22,25,FMN GV 16 Berchem TOT
54,Posthofbrug 5366,2021-09-11,02:00:00,27,8,19,FMN GV 16 Berchem TOT
54,Posthofbrug 5366,2021-09-11,03:00:00,32,13,19,FMN GV 16 Berchem TOT
54,Posthofbrug 5366,2021-09-11,04:00:00,23,15,8,FMN GV 16 Berchem TOT
54,Posthofbrug 5366,2021-09-11,05:00:00,12,8,4,FMN GV 16 Berchem TOT
54,Posthofbrug 5366,2021-09-11,06:00:00,27,20,7,FMN GV 16 Berchem TOT
54,Posthofbrug 5366,2021-09-11,07:00:00,39,26,13,FMN GV 16 Berchem TOT
54,Posthofbrug 5366,2021-09-11,08:00:00,78,42,36,FMN GV 16 Berchem TOT
54,Posthofbrug 5366,2021-09-11,09:00:00,114,80,34,FMN GV 16 Berchem TOT
54,Posthofbrug 5366,2021-09-11,10:00:00,135,92,43,FMN GV 16 Berchem TOT
54,Posthofbrug 5366,2021-09-11,11:00:00,149,85,64,FMN GV 16 Berchem TOT
54,Posthofbrug 5366,2021-09-11,12:00:00,146,81,65,FMN GV 16 Berchem TOT
54,Posthofbrug 5366,2021-09-11,13:00:00,146,75,71,FMN GV 16 Berchem TOT
54,Posthofbrug 5366,2021-09-11,14:00:00,141,76,65,FMN GV 16 Berchem TOT
54,Posthofbrug 5366,2021-09-11,15:00:00,147,89,58,FMN GV 16 Berchem TOT
54,Posthofbrug 5366,2021-09-11,16:00:00,176,93,83,FMN GV 16 Berchem TOT
54,Posthofbrug 5366,2021-09-11,17:00:00,214,128,86,FMN GV 16 Berchem TOT
54,Posthofbrug 5366,2021-09-11,18:00:00,200,123,77,FMN GV 16 Berchem TOT
54,Posthofbrug 5366,2021-09-11,19:00:00,120,61,59,FMN GV 16 Berchem TOT
54,Posthofbrug 5366,2021-09-11,20:00:00,119,76,43,FMN GV 16 Berchem TOT
54,Posthofbrug 5366,2021-09-11,21:00:00,103,45,58,FMN GV 16 Berchem TOT
54,Posthofbrug 5366,2021-09-11,22:00:00,81,29,52,FMN GV 16 Berchem TOT
54,Posthofbrug 5366,2021-09-11,23:00:00,84,12,72,FMN GV 16 Berchem TOT
54,Posthofbrug 5366,2021-09-12,00:00:00,108,22,86,FMN GV 16 Berchem TOT
54,Posthofbrug 5366,2021-09-12,01:00:00,117,12,105,FMN GV 16 Berchem TOT
54,Posthofbrug 5366,2021-09-12,02:00:00,37,7,30,FMN GV 16 Berchem TOT
54,Posthofbrug 5366,2021-09-12,03:00:00,12,5,7,FMN GV 16 Berchem TOT
54,Posthofbrug 5366,2021-09-12,04:00:00,12,7,5,FMN GV 16 Berchem TOT
54,Posthofbrug 5366,2021-09-12,05:00:00,21,9,12,FMN GV 16 Berchem TOT
54,Posthofbrug 5366,2021-09-12,06:00:00,18,16,2,FMN GV 16 Berchem TOT
54,Posthofbrug 5366,2021-09-12,07:00:00,20,12,8,FMN GV 16 Berchem TOT
54,Posthofbrug 5366,2021-09-12,08:00:00,45,21,24,FMN GV 16 Berchem TOT
54,Posthofbrug 5366,2021-09-12,09:00:00,128,89,39,FMN GV 16 Berchem TOT
54,Posthofbrug 5366,2021-09-12,10:00:00,148,95,53,FMN GV 16 Berchem TOT
54,Posthofbrug 5366,2021-09-12,11:00:00,202,122,80,FMN GV 16 Berchem TOT
54,Posthofbrug 5366,2021-09-12,12:00:00,213,131,82,FMN GV 16 Berchem TOT
54,Posthofbrug 5366,2021-09-12,13:00:00,189,128,61,FMN GV 16 Berchem TOT
54,Posthofbrug 5366,2021-09-12,14:00:00,253,144,109,FMN GV 16 Berchem TOT
54,Posthofbrug 5366,2021-09-12,15:00:00,239,121,118,FMN GV 16 Berchem TOT
54,Posthofbrug 5366,2021-09-12,16:00:00,30,12,18,FMN GV 16 Berchem TOT
54,Posthofbrug 5366,2021-09-12,17:00:00,0,0,0,FMN GV 16 Berchem TOT
54,Posthofbrug 5366,2021-09-12,18:00:00,0,0,0,FMN GV 16 Berchem TOT
54,Posthofbrug 5366,2021-09-12,19:00:00,0,0,0,FMN GV 16 Berchem TOT
54,Posthofbrug 5366,2021-09-12,20:00:00,83,35,48,FMN GV 16 Berchem TOT
54,Posthofbrug 5366,2021-09-12,21:00:00,67,26,41,FMN GV 16 Berchem TOT
54,Posthofbrug 5366,2021-09-12,22:00:00,64,33,31,FMN GV 16 Berchem TOT
54,Posthofbrug 5366,2021-09-12,23:00:00,21,4,17,FMN GV 16 Berchem TOT
54,Posthofbrug 5366,2021-09-13,00:00:00,27,9,18,FMN GV 16 Berchem TOT
54,Posthofbrug 5366,2021-09-13,01:00:00,7,1,6,FMN GV 16 Berchem TOT
54,Posthofbrug 5366,2021-09-13,02:00:00,5,0,5,FMN GV 16 Berchem TOT
54,Posthofbrug 5366,2021-09-13,03:00:00,6,5,1,FMN GV 16 Berchem TOT
54,Posthofbrug 5366,2021-09-13,04:00:00,5,4,1,FMN GV 16 Berchem TOT
54,Posthofbrug 5366,2021-09-13,05:00:00,34,26,8,FMN GV 16 Berchem TOT
54,Posthofbrug 5366,2021-09-13,06:00:00,100,86,14,FMN GV 16 Berchem TOT
54,Posthofbrug 5366,2021-09-13,07:00:00,409,315,94,FMN GV 16 Berchem TOT
54,Posthofbrug 5366,2021-09-13,08:00:00,653,486,167,FMN GV 16 Berchem TOT
54,Posthofbrug 5366,2021-09-13,09:00:00,207,145,62,FMN GV 16 Berchem TOT
54,Posthofbrug 5366,2021-09-13,10:00:00,99,72,27,FMN GV 16 Berchem TOT
54,Posthofbrug 5366,2021-09-13,11:00:00,105,72,33,FMN GV 16 Berchem TOT
54,Posthofbrug 5366,2021-09-13,12:00:00,135,75,60,FMN GV 16 Berchem TOT
54,Posthofbrug 5366,2021-09-13,13:00:00,140,75,65,FMN GV 16 Berchem TOT
54,Posthofbrug 5366,2021-09-13,14:00:00,119,63,56,FMN GV 16 Berchem TOT
54,Posthofbrug 5366,2021-09-13,15:00:00,255,98,157,FMN GV 16 Berchem TOT
54,Posthofbrug 5366,2021-09-13,16:00:00,456,136,320,FMN GV 16 Berchem TOT
54,Posthofbrug 5366,2021-09-13,17:00:00,521,140,381,FMN GV 16 Berchem TOT
54,Posthofbrug 5366,2021-09-13,18:00:00,75,19,56,FMN GV 16 Berchem TOT
54,Posthofbrug 5366,2021-09-13,19:00:00,0,0,0,FMN GV 16 Berchem TOT
54,Posthofbrug 5366,2021-09-13,20:00:00,0,0,0,FMN GV 16 Berchem TOT
54,Posthofbrug 5366,2021-09-13,21:00:00,0,0,0,FMN GV 16 Berchem TOT
54,Posthofbrug 5366,2021-09-13,22:00:00,60,21,39,FMN GV 16 Berchem TOT
54,Posthofbrug 5366,2021-09-13,23:00:00,30,11,19,FMN GV 16 Berchem TOT
54,Posthofbrug 5366,2021-09-14,00:00:00,24,4,20,FMN GV 16 Berchem TOT
54,Posthofbrug 5366,2021-09-14,01:00:00,9,3,6,FMN GV 16 Berchem TOT
54,Posthofbrug 5366,2021-09-14,02:00:00,6,3,3,FMN GV 16 Berchem TOT
54,Posthofbrug 5366,2021-09-14,03:00:00,4,3,1,FMN GV 16 Berchem TOT
54,Posthofbrug 5366,2021-09-14,04:00:00,3,2,1,FMN GV 16 Berchem TOT
54,Posthofbrug 5366,2021-09-14,05:00:00,31,25,6,FMN GV 16 Berchem TOT
54,Posthofbrug 5366,2021-09-14,06:00:00,101,85,16,FMN GV 16 Berchem TOT
54,Posthofbrug 5366,2021-09-14,07:00:00,411,299,112,FMN GV 16 Berchem TOT
54,Posthofbrug 5366,2021-09-14,08:00:00,660,508,152,FMN GV 16 Berchem TOT
54,Posthofbrug 5366,2021-09-14,09:00:00,225,180,45,FMN GV 16 Berchem TOT
54,Posthofbrug 5366,2021-09-14,10:00:00,103,61,42,FMN GV 16 Berchem TOT
54,Posthofbrug 5366,2021-09-14,11:00:00,135,79,56,FMN GV 16 Berchem TOT
54,Posthofbrug 5366,2021-09-14,12:00:00,161,83,78,FMN GV 16 Berchem TOT
54,Posthofbrug 5366,2021-09-14,13:00:00,126,61,65,FMN GV 16 Berchem TOT
54,Posthofbrug 5366,2021-09-14,14:00:00,141,58,83,FMN GV 16 Berchem TOT
54,Posthofbrug 5366,2021-09-14,15:00:00,221,71,150,FMN GV 16 Berchem TOT
54,Posthofbrug 5366,2021-09-14,16:00:00,400,121,279,FMN GV 16 Berchem TOT
54,Posthofbrug 5366,2021-09-14,17:00:00,481,138,343,FMN GV 16 Berchem TOT
54,Posthofbrug 5366,2021-09-14,18:00:00,63,28,35,FMN GV 16 Berchem TOT
54,Posthofbrug 5366,2021-09-14,19:00:00,0,0,0,FMN GV 16 Berchem TOT
54,Posthofbrug 5366,2021-09-14,20:00:00,0,0,0,FMN GV 16 Berchem TOT
54,Posthofbrug 5366,2021-09-14,21:00:00,0,0,0,FMN GV 16 Berchem TOT
54,Posthofbrug 5366,2021-09-14,22:00:00,58,32,26,FMN GV 16 Berchem TOT
54,Posthofbrug 5366,2021-09-14,23:00:00,50,20,30,FMN GV 16 Berchem TOT
54,Posthofbrug 5366,2021-09-15,00:00:00,18,6,12,FMN GV 16 Berchem TOT
54,Posthofbrug 5366,2021-09-15,01:00:00,9,2,7,FMN GV 16 Berchem TOT
54,Posthofbrug 5366,2021-09-15,02:00:00,5,0,5,FMN GV 16 Berchem TOT
54,Posthofbrug 5366,2021-09-15,03:00:00,3,2,1,FMN GV 16 Berchem TOT
54,Posthofbrug 5366,2021-09-15,04:00:00,7,2,5,FMN GV 16 Berchem TOT
54,Posthofbrug 5366,2021-09-15,05:00:00,25,20,5,FMN GV 16 Berchem TOT
54,Posthofbrug 5366,2021-09-15,06:00:00,100,84,16,FMN GV 16 Berchem TOT
54,Posthofbrug 5366,2021-09-15,07:00:00,336,251,85,FMN GV 16 Berchem TOT
54,Posthofbrug 5366,2021-09-15,08:00:00,528,390,138,FMN GV 16 Berchem TOT
54,Posthofbrug 5366,2021-09-15,09:00:00,173,133,40,FMN GV 16 Berchem TOT
54,Posthofbrug 5366,2021-09-15,10:00:00,10,5,5,FMN GV 16 Berchem TOT
54,Posthofbrug 5366,2021-09-15,11:00:00,0,0,0,FMN GV 16 Berchem TOT
54,Posthofbrug 5366,2021-09-15,12:00:00,0,0,0,FMN GV 16 Berchem TOT
54,Posthofbrug 5366,2021-09-15,13:00:00,0,0,0,FMN GV 16 Berchem TOT
54,Posthofbrug 5366,2021-09-15,14:00:00,126,54,72,FMN GV 16 Berchem TOT
54,Posthofbrug 5366,2021-09-15,15:00:00,179,81,98,FMN GV 16 Berchem TOT
54,Posthofbrug 5366,2021-09-15,16:00:00,297,102,195,FMN GV 16 Berchem TOT
54,Posthofbrug 5366,2021-09-15,17:00:00,424,155,269,FMN GV 16 Berchem TOT
54,Posthofbrug 5366,2021-09-15,18:00:00,299,118,181,FMN GV 16 Berchem TOT
54,Posthofbrug 5366,2021-09-15,19:00:00,188,91,97,FMN GV 16 Berchem TOT
54,Posthofbrug 5366,2021-09-15,20:00:00,107,62,45,FMN GV 16 Berchem TOT
54,Posthofbrug 5366,2021-09-15,21:00:00,73,29,44,FMN GV 16 Berchem TOT
54,Posthofbrug 5366,2021-09-15,22:00:00,80,34,46,FMN GV 16 Berchem TOT
54,Posthofbrug 5366,2021-09-15,23:00:00,58,21,37,FMN GV 16 Berchem TOT
54,Posthofbrug 5366,2021-09-16,00:00:00,26,2,24,FMN GV 16 Berchem TOT
54,Posthofbrug 5366,2021-09-16,01:00:00,8,3,5,FMN GV 16 Berchem TOT
54,Posthofbrug 5366,2021-09-16,02:00:00,3,0,3,FMN GV 16 Berchem TOT
54,Posthofbrug 5366,2021-09-16,03:00:00,5,2,3,FMN GV 16 Berchem TOT
54,Posthofbrug 5366,2021-09-16,04:00:00,7,5,2,FMN GV 16 Berchem TOT
54,Posthofbrug 5366,2021-09-16,05:00:00,34,25,9,FMN GV 16 Berchem TOT
54,Posthofbrug 5366,2021-09-16,06:00:00,95,80,15,FMN GV 16 Berchem TOT
54,Posthofbrug 5366,2021-09-16,07:00:00,414,305,109,FMN GV 16 Berchem TOT
54,Posthofbrug 5366,2021-09-16,08:00:00,652,499,153,FMN GV 16 Berchem TOT
54,Posthofbrug 5366,2021-09-16,09:00:00,267,191,76,FMN GV 16 Berchem TOT
54,Posthofbrug 5366,2021-09-16,10:00:00,125,85,40,FMN GV 16 Berchem TOT
54,Posthofbrug 5366,2021-09-16,11:00:00,155,83,72,FMN GV 16 Berchem TOT
54,Posthofbrug 5366,2021-09-16,12:00:00,173,99,74,FMN GV 16 Berchem TOT
54,Posthofbrug 5366,2021-09-16,13:00:00,164,80,84,FMN GV 16 Berchem TOT
54,Posthofbrug 5366,2021-09-16,14:00:00,24,11,13,FMN GV 16 Berchem TOT
54,Posthofbrug 5366,2021-09-16,15:00:00,0,0,0,FMN GV 16 Berchem TOT
54,Posthofbrug 5366,2021-09-16,16:00:00,0,0,0,FMN GV 16 Berchem TOT
54,Posthofbrug 5366,2021-09-16,17:00:00,0,0,0,FMN GV 16 Berchem TOT
54,Posthofbrug 5366,2021-09-16,18:00:00,297,110,187,FMN GV 16 Berchem TOT
54,Posthofbrug 5366,2021-09-16,19:00:00,239,107,132,FMN GV 16 Berchem TOT
54,Posthofbrug 5366,2021-09-16,20:00:00,147,75,72,FMN GV 16 Berchem TOT
54,Posthofbrug 5366,2021-09-16,21:00:00,98,36,62,FMN GV 16 Berchem TOT
54,Posthofbrug 5366,2021-09-16,22:00:00,142,52,90,FMN GV 16 Berchem TOT
54,Posthofbrug 5366,2021-09-16,23:00:00,81,21,60,FMN GV 16 Berchem TOT
54,Posthofbrug 5366,2021-09-17,00:00:00,30,8,22,FMN GV 16 Berchem TOT
54,Posthofbrug 5366,2021-09-17,01:00:00,13,2,11,FMN GV 16 Berchem TOT
54,Posthofbrug 5366,2021-09-17,02:00:00,10,1,9,FMN GV 16 Berchem TOT
54,Posthofbrug 5366,2021-09-17,03:00:00,4,3,1,FMN GV 16 Berchem TOT
54,Posthofbrug 5366,2021-09-17,04:00:00,8,4,4,FMN GV 16 Berchem TOT
54,Posthofbrug 5366,2021-09-17,05:00:00,32,19,13,FMN GV 16 Berchem TOT
54,Posthofbrug 5366,2021-09-17,06:00:00,102,83,19,FMN GV 16 Berchem TOT
54,Posthofbrug 5366,2021-09-17,07:00:00,346,262,84,FMN GV 16 Berchem TOT
54,Posthofbrug 5366,2021-09-17,08:00:00,576,411,165,FMN GV 16 Berchem TOT
54,Posthofbrug 5366,2021-09-17,09:00:00,220,167,53,FMN GV 16 Berchem TOT
54,Posthofbrug 5366,2021-09-17,10:00:00,119,79,40,FMN GV 16 Berchem TOT
54,Posthofbrug 5366,2021-09-17,11:00:00,151,97,54,FMN GV 16 Berchem TOT
54,Posthofbrug 5366,2021-09-17,12:00:00,200,109,91,FMN GV 16 Berchem TOT
54,Posthofbrug 5366,2021-09-17,13:00:00,181,95,86,FMN GV 16 Berchem TOT
54,Posthofbrug 5366,2021-09-17,14:00:00,42,17,25,FMN GV 16 Berchem TOT
54,Posthofbrug 5366,2021-09-17,15:00:00,0,0,0,FMN GV 16 Berchem TOT
54,Posthofbrug 5366,2021-09-17,16:00:00,0,0,0,FMN GV 16 Berchem TOT
54,Posthofbrug 5366,2021-09-17,17:00:00,0,0,0,FMN GV 16 Berchem TOT
54,Posthofbrug 5366,2021-09-17,18:00:00,0,0,0,FMN GV 16 Berchem TOT
54,Posthofbrug 5366,2021-09-17,19:00:00,0,0,0,FMN GV 16 Berchem TOT
54,Posthofbrug 5366,2021-09-17,20:00:00,0,0,0,FMN GV 16 Berchem TOT
54,Posthofbrug 5366,2021-09-17,21:00:00,0,0,0,FMN GV 16 Berchem TOT
54,Posthofbrug 5366,2021-09-17,22:00:00,93,27,66,FMN GV 16 Berchem TOT
54,Posthofbrug 5366,2021-09-17,23:00:00,89,32,57,FMN GV 16 Berchem TOT
54,Posthofbrug 5366,2021-09-18,00:00:00,73,16,57,FMN GV 16 Berchem TOT
54,Posthofbrug 5366,2021-09-18,01:00:00,56,17,39,FMN GV 16 Berchem TOT
54,Posthofbrug 5366,2021-09-18,02:00:00,37,6,31,FMN GV 16 Berchem TOT
54,Posthofbrug 5366,2021-09-18,03:00:00,24,4,20,FMN GV 16 Berchem TOT
54,Posthofbrug 5366,2021-09-18,04:00:00,15,12,3,FMN GV 16 Berchem TOT
54,Posthofbrug 5366,2021-09-18,05:00:00,16,6,10,FMN GV 16 Berchem TOT
54,Posthofbrug 5366,2021-09-18,06:00:00,32,24,8,FMN GV 16 Berchem TOT
54,Posthofbrug 5366,2021-09-18,07:00:00,40,19,21,FMN GV 16 Berchem TOT
54,Posthofbrug 5366,2021-09-18,08:00:00,70,42,28,FMN GV 16 Berchem TOT
54,Posthofbrug 5366,2021-09-18,09:00:00,138,82,56,FMN GV 16 Berchem TOT
54,Posthofbrug 5366,2021-09-18,10:00:00,148,92,56,FMN GV 16 Berchem TOT
54,Posthofbrug 5366,2021-09-18,11:00:00,179,109,70,FMN GV 16 Berchem TOT
54,Posthofbrug 5366,2021-09-18,12:00:00,195,119,76,FMN GV 16 Berchem TOT
54,Posthofbrug 5366,2021-09-18,13:00:00,218,128,90,FMN GV 16 Berchem TOT
54,Posthofbrug 5366,2021-09-18,14:00:00,262,159,103,FMN GV 16 Berchem TOT
54,Posthofbrug 5366,2021-09-18,15:00:00,230,141,89,FMN GV 16 Berchem TOT
54,Posthofbrug 5366,2021-09-18,16:00:00,249,109,140,FMN GV 16 Berchem TOT
54,Posthofbrug 5366,2021-09-18,17:00:00,242,126,116,FMN GV 16 Berchem TOT
54,Posthofbrug 5366,2021-09-18,18:00:00,202,117,85,FMN GV 16 Berchem TOT
54,Posthofbrug 5366,2021-09-18,19:00:00,169,105,64,FMN GV 16 Berchem TOT
54,Posthofbrug 5366,2021-09-18,20:00:00,137,69,68,FMN GV 16 Berchem TOT
54,Posthofbrug 5366,2021-09-18,21:00:00,83,42,41,FMN GV 16 Berchem TOT
54,Posthofbrug 5366,2021-09-18,22:00:00,114,43,71,FMN GV 16 Berchem TOT
54,Posthofbrug 5366,2021-09-18,23:00:00,81,20,61,FMN GV 16 Berchem TOT
54,Posthofbrug 5366,2021-09-19,00:00:00,139,43,96,FMN GV 16 Berchem TOT
54,Posthofbrug 5366,2021-09-19,01:00:00,39,7,32,FMN GV 16 Berchem TOT
54,Posthofbrug 5366,2021-09-19,02:00:00,33,7,26,FMN GV 16 Berchem TOT
54,Posthofbrug 5366,2021-09-19,03:00:00,29,5,24,FMN GV 16 Berchem TOT
54,Posthofbrug 5366,2021-09-19,04:00:00,15,4,11,FMN GV 16 Berchem TOT
54,Posthofbrug 5366,2021-09-19,05:00:00,21,7,14,FMN GV 16 Berchem TOT
54,Posthofbrug 5366,2021-09-19,06:00:00,18,13,5,FMN GV 16 Berchem TOT
54,Posthofbrug 5366,2021-09-19,07:00:00,23,14,9,FMN GV 16 Berchem TOT
54,Posthofbrug 5366,2021-09-19,08:00:00,47,32,15,FMN GV 16 Berchem TOT
54,Posthofbrug 5366,2021-09-19,09:00:00,134,86,48,FMN GV 16 Berchem TOT
54,Posthofbrug 5366,2021-09-19,10:00:00,199,134,65,FMN GV 16 Berchem TOT
54,Posthofbrug 5366,2021-09-19,11:00:00,219,145,74,FMN GV 16 Berchem TOT
54,Posthofbrug 5366,2021-09-19,12:00:00,227,144,83,FMN GV 16 Berchem TOT
54,Posthofbrug 5366,2021-09-19,13:00:00,330,202,128,FMN GV 16 Berchem TOT
54,Posthofbrug 5366,2021-09-19,14:00:00,267,178,89,FMN GV 16 Berchem TOT
54,Posthofbrug 5366,2021-09-19,15:00:00,293,152,141,FMN GV 16 Berchem TOT
54,Posthofbrug 5366,2021-09-19,16:00:00,302,98,204,FMN GV 16 Berchem TOT
54,Posthofbrug 5366,2021-09-19,17:00:00,297,103,194,FMN GV 16 Berchem TOT
54,Posthofbrug 5366,2021-09-19,18:00:00,206,82,124,FMN GV 16 Berchem TOT
54,Posthofbrug 5366,2021-09-19,19:00:00,168,79,89,FMN GV 16 Berchem TOT
54,Posthofbrug 5366,2021-09-19,20:00:00,100,46,54,FMN GV 16 Berchem TOT
54,Posthofbrug 5366,2021-09-19,21:00:00,95,37,58,FMN GV 16 Berchem TOT
54,Posthofbrug 5366,2021-09-19,22:00:00,72,18,54,FMN GV 16 Berchem TOT
54,Posthofbrug 5366,2021-09-19,23:00:00,34,17,17,FMN GV 16 Berchem TOT
54,Posthofbrug 5366,2021-09-20,00:00:00,16,4,12,FMN GV 16 Berchem TOT
54,Posthofbrug 5366,2021-09-20,01:00:00,9,2,7,FMN GV 16 Berchem TOT
54,Posthofbrug 5366,2021-09-20,02:00:00,3,1,2,FMN GV 16 Berchem TOT
54,Posthofbrug 5366,2021-09-20,03:00:00,5,3,2,FMN GV 16 Berchem TOT
54,Posthofbrug 5366,2021-09-20,04:00:00,10,9,1,FMN GV 16 Berchem TOT
54,Posthofbrug 5366,2021-09-20,05:00:00,27,20,7,FMN GV 16 Berchem TOT
54,Posthofbrug 5366,2021-09-20,06:00:00,97,81,16,FMN GV 16 Berchem TOT
54,Posthofbrug 5366,2021-09-20,07:00:00,413,302,111,FMN GV 16 Berchem TOT
54,Posthofbrug 5366,2021-09-20,08:00:00,725,551,174,FMN GV 16 Berchem TOT
54,Posthofbrug 5366,2021-09-20,09:00:00,257,206,51,FMN GV 16 Berchem TOT
54,Posthofbrug 5366,2021-09-20,10:00:00,135,85,50,FMN GV 16 Berchem TOT
54,Posthofbrug 5366,2021-09-20,11:00:00,115,72,43,FMN GV 16 Berchem TOT
54,Posthofbrug 5366,2021-09-20,12:00:00,160,92,68,FMN GV 16 Berchem TOT
54,Posthofbrug 5366,2021-09-20,13:00:00,182,96,86,FMN GV 16 Berchem TOT
54,Posthofbrug 5366,2021-09-20,14:00:00,183,69,114,FMN GV 16 Berchem TOT
54,Posthofbrug 5366,2021-09-20,15:00:00,262,86,176,FMN GV 16 Berchem TOT
54,Posthofbrug 5366,2021-09-20,16:00:00,452,140,312,FMN GV 16 Berchem TOT
54,Posthofbrug 5366,2021-09-20,17:00:00,527,133,394,FMN GV 16 Berchem TOT
54,Posthofbrug 5366,2021-09-20,18:00:00,360,110,250,FMN GV 16 Berchem TOT
54,Posthofbrug 5366,2021-09-20,19:00:00,196,93,103,FMN GV 16 Berchem TOT
54,Posthofbrug 5366,2021-09-20,20:00:00,114,67,47,FMN GV 16 Berchem TOT
54,Posthofbrug 5366,2021-09-20,21:00:00,101,45,56,FMN GV 16 Berchem TOT
54,Posthofbrug 5366,2021-09-20,22:00:00,80,29,51,FMN GV 16 Berchem TOT
54,Posthofbrug 5366,2021-09-20,23:00:00,38,18,20,FMN GV 16 Berchem TOT
54,Posthofbrug 5366,2021-09-21,00:00:00,22,7,15,FMN GV 16 Berchem TOT
54,Posthofbrug 5366,2021-09-21,01:00:00,9,0,9,FMN GV 16 Berchem TOT
54,Posthofbrug 5366,2021-09-21,02:00:00,10,2,8,FMN GV 16 Berchem TOT
54,Posthofbrug 5366,2021-09-21,03:00:00,4,3,1,FMN GV 16 Berchem TOT
54,Posthofbrug 5366,2021-09-21,04:00:00,14,13,1,FMN GV 16 Berchem TOT
54,Posthofbrug 5366,2021-09-21,05:00:00,28,19,9,FMN GV 16 Berchem TOT
54,Posthofbrug 5366,2021-09-21,06:00:00,121,103,18,FMN GV 16 Berchem TOT
54,Posthofbrug 5366,2021-09-21,07:00:00,445,339,106,FMN GV 16 Berchem TOT
54,Posthofbrug 5366,2021-09-21,08:00:00,712,546,166,FMN GV 16 Berchem TOT
54,Posthofbrug 5366,2021-09-21,09:00:00,268,216,52,FMN GV 16 Berchem TOT
54,Posthofbrug 5366,2021-09-21,10:00:00,116,80,36,FMN GV 16 Berchem TOT
54,Posthofbrug 5366,2021-09-21,11:00:00,116,66,50,FMN GV 16 Berchem TOT
54,Posthofbrug 5366,2021-09-21,12:00:00,184,110,74,FMN GV 16 Berchem TOT
54,Posthofbrug 5366,2021-09-21,13:00:00,185,94,91,FMN GV 16 Berchem TOT
54,Posthofbrug 5366,2021-09-21,14:00:00,168,77,91,FMN GV 16 Berchem TOT
54,Posthofbrug 5366,2021-09-21,15:00:00,299,102,197,FMN GV 16 Berchem TOT
54,Posthofbrug 5366,2021-09-21,16:00:00,504,152,352,FMN GV 16 Berchem TOT
54,Posthofbrug 5366,2021-09-21,17:00:00,589,152,437,FMN GV 16 Berchem TOT
54,Posthofbrug 5366,2021-09-21,18:00:00,417,153,264,FMN GV 16 Berchem TOT
54,Posthofbrug 5366,2021-09-21,19:00:00,216,106,110,FMN GV 16 Berchem TOT
54,Posthofbrug 5366,2021-09-21,20:00:00,138,68,70,FMN GV 16 Berchem TOT
54,Posthofbrug 5366,2021-09-21,21:00:00,98,41,57,FMN GV 16 Berchem TOT
54,Posthofbrug 5366,2021-09-21,22:00:00,114,42,72,FMN GV 16 Berchem TOT
54,Posthofbrug 5366,2021-09-21,23:00:00,70,30,40,FMN GV 16 Berchem TOT
54,Posthofbrug 5366,2021-09-22,00:00:00,30,10,20,FMN GV 16 Berchem TOT
54,Posthofbrug 5366,2021-09-22,01:00:00,12,2,10,FMN GV 16 Berchem TOT
54,Posthofbrug 5366,2021-09-22,02:00:00,9,1,8,FMN GV 16 Berchem TOT
54,Posthofbrug 5366,2021-09-22,03:00:00,10,5,5,FMN GV 16 Berchem TOT
54,Posthofbrug 5366,2021-09-22,04:00:00,15,9,6,FMN GV 16 Berchem TOT
54,Posthofbrug 5366,2021-09-22,05:00:00,19,13,6,FMN GV 16 Berchem TOT
54,Posthofbrug 5366,2021-09-22,06:00:00,107,88,19,FMN GV 16 Berchem TOT
54,Posthofbrug 5366,2021-09-22,07:00:00,409,301,108,FMN GV 16 Berchem TOT
54,Posthofbrug 5366,2021-09-22,08:00:00,568,403,165,FMN GV 16 Berchem TOT
54,Posthofbrug 5366,2021-09-22,09:00:00,199,145,54,FMN GV 16 Berchem TOT
54,Posthofbrug 5366,2021-09-22,10:00:00,121,89,32,FMN GV 16 Berchem TOT
54,Posthofbrug 5366,2021-09-22,11:00:00,176,93,83,FMN GV 16 Berchem TOT
54,Posthofbrug 5366,2021-09-22,12:00:00,297,145,152,FMN GV 16 Berchem TOT
54,Posthofbrug 5366,2021-09-22,13:00:00,267,127,140,FMN GV 16 Berchem TOT
54,Posthofbrug 5366,2021-09-22,14:00:00,246,131,115,FMN GV 16 Berchem TOT
54,Posthofbrug 5366,2021-09-22,15:00:00,236,85,151,FMN GV 16 Berchem TOT
54,Posthofbrug 5366,2021-09-22,16:00:00,355,116,239,FMN GV 16 Berchem TOT
54,Posthofbrug 5366,2021-09-22,17:00:00,531,181,350,FMN GV 16 Berchem TOT
54,Posthofbrug 5366,2021-09-22,18:00:00,336,137,199,FMN GV 16 Berchem TOT
54,Posthofbrug 5366,2021-09-22,19:00:00,199,95,104,FMN GV 16 Berchem TOT
54,Posthofbrug 5366,2021-09-22,20:00:00,122,56,66,FMN GV 16 Berchem TOT
54,Posthofbrug 5366,2021-09-22,21:00:00,97,40,57,FMN GV 16 Berchem TOT
54,Posthofbrug 5366,2021-09-22,22:00:00,105,36,69,FMN GV 16 Berchem TOT
54,Posthofbrug 5366,2021-09-22,23:00:00,77,31,46,FMN GV 16 Berchem TOT
54,Posthofbrug 5366,2021-09-23,00:00:00,27,10,17,FMN GV 16 Berchem TOT
54,Posthofbrug 5366,2021-09-23,01:00:00,17,8,9,FMN GV 16 Berchem TOT
54,Posthofbrug 5366,2021-09-23,02:00:00,10,5,5,FMN GV 16 Berchem TOT
54,Posthofbrug 5366,2021-09-23,03:00:00,7,4,3,FMN GV 16 Berchem TOT
54,Posthofbrug 5366,2021-09-23,04:00:00,16,9,7,FMN GV 16 Berchem TOT
54,Posthofbrug 5366,2021-09-23,05:00:00,29,17,12,FMN GV 16 Berchem TOT
54,Posthofbrug 5366,2021-09-23,06:00:00,79,61,18,FMN GV 16 Berchem TOT
54,Posthofbrug 5366,2021-09-23,07:00:00,435,335,100,FMN GV 16 Berchem TOT
54,Posthofbrug 5366,2021-09-23,08:00:00,721,559,162,FMN GV 16 Berchem TOT
54,Posthofbrug 5366,2021-09-23,09:00:00,299,220,79,FMN GV 16 Berchem TOT
54,Posthofbrug 5366,2021-09-23,10:00:00,144,102,42,FMN GV 16 Berchem TOT
54,Posthofbrug 5366,2021-09-23,11:00:00,146,90,56,FMN GV 16 Berchem TOT
54,Posthofbrug 5366,2021-09-23,12:00:00,193,102,91,FMN GV 16 Berchem TOT
54,Posthofbrug 5366,2021-09-23,13:00:00,198,94,104,FMN GV 16 Berchem TOT
54,Posthofbrug 5366,2021-09-23,14:00:00,177,77,100,FMN GV 16 Berchem TOT
54,Posthofbrug 5366,2021-09-23,15:00:00,291,121,170,FMN GV 16 Berchem TOT
54,Posthofbrug 5366,2021-09-23,16:00:00,453,152,301,FMN GV 16 Berchem TOT
54,Posthofbrug 5366,2021-09-23,17:00:00,536,147,389,FMN GV 16 Berchem TOT
54,Posthofbrug 5366,2021-09-23,18:00:00,333,128,205,FMN GV 16 Berchem TOT
54,Posthofbrug 5366,2021-09-23,19:00:00,259,109,150,FMN GV 16 Berchem TOT
54,Posthofbrug 5366,2021-09-23,20:00:00,119,65,54,FMN GV 16 Berchem TOT
54,Posthofbrug 5366,2021-09-23,21:00:00,90,41,49,FMN GV 16 Berchem TOT
54,Posthofbrug 5366,2021-09-23,22:00:00,101,39,62,FMN GV 16 Berchem TOT
54,Posthofbrug 5366,2021-09-23,23:00:00,71,24,47,FMN GV 16 Berchem TOT
54,Posthofbrug 5366,2021-09-24,00:00:00,31,4,27,FMN GV 16 Berchem TOT
54,Posthofbrug 5366,2021-09-24,01:00:00,17,8,9,FMN GV 16 Berchem TOT
54,Posthofbrug 5366,2021-09-24,02:00:00,11,5,6,FMN GV 16 Berchem TOT
54,Posthofbrug 5366,2021-09-24,03:00:00,9,3,6,FMN GV 16 Berchem TOT
54,Posthofbrug 5366,2021-09-24,04:00:00,15,11,4,FMN GV 16 Berchem TOT
54,Posthofbrug 5366,2021-09-24,05:00:00,25,14,11,FMN GV 16 Berchem TOT
54,Posthofbrug 5366,2021-09-24,06:00:00,80,65,15,FMN GV 16 Berchem TOT
54,Posthofbrug 5366,2021-09-24,07:00:00,354,264,90,FMN GV 16 Berchem TOT
54,Posthofbrug 5366,2021-09-24,08:00:00,631,493,138,FMN GV 16 Berchem TOT
54,Posthofbrug 5366,2021-09-24,09:00:00,248,197,51,FMN GV 16 Berchem TOT
54,Posthofbrug 5366,2021-09-24,10:00:00,147,103,44,FMN GV 16 Berchem TOT
54,Posthofbrug 5366,2021-09-24,11:00:00,138,83,55,FMN GV 16 Berchem TOT
54,Posthofbrug 5366,2021-09-24,12:00:00,213,101,112,FMN GV 16 Berchem TOT
54,Posthofbrug 5366,2021-09-24,13:00:00,185,86,99,FMN GV 16 Berchem TOT
54,Posthofbrug 5366,2021-09-24,14:00:00,229,109,120,FMN GV 16 Berchem TOT
54,Posthofbrug 5366,2021-09-24,15:00:00,311,114,197,FMN GV 16 Berchem TOT
54,Posthofbrug 5366,2021-09-24,16:00:00,413,131,282,FMN GV 16 Berchem TOT
54,Posthofbrug 5366,2021-09-24,17:00:00,475,177,298,FMN GV 16 Berchem TOT
54,Posthofbrug 5366,2021-09-24,18:00:00,323,136,187,FMN GV 16 Berchem TOT
54,Posthofbrug 5366,2021-09-24,19:00:00,253,140,113,FMN GV 16 Berchem TOT
54,Posthofbrug 5366,2021-09-24,20:00:00,143,86,57,FMN GV 16 Berchem TOT
54,Posthofbrug 5366,2021-09-24,21:00:00,124,43,81,FMN GV 16 Berchem TOT
54,Posthofbrug 5366,2021-09-24,22:00:00,112,45,67,FMN GV 16 Berchem TOT
54,Posthofbrug 5366,2021-09-24,23:00:00,105,27,78,FMN GV 16 Berchem TOT
54,Posthofbrug 5366,2021-09-25,00:00:00,78,22,56,FMN GV 16 Berchem TOT
54,Posthofbrug 5366,2021-09-25,01:00:00,57,18,39,FMN GV 16 Berchem TOT
54,Posthofbrug 5366,2021-09-25,02:00:00,36,9,27,FMN GV 16 Berchem TOT
54,Posthofbrug 5366,2021-09-25,03:00:00,30,11,19,FMN GV 16 Berchem TOT
54,Posthofbrug 5366,2021-09-25,04:00:00,24,8,16,FMN GV 16 Berchem TOT
54,Posthofbrug 5366,2021-09-25,05:00:00,14,6,8,FMN GV 16 Berchem TOT
54,Posthofbrug 5366,2021-09-25,06:00:00,19,11,8,FMN GV 16 Berchem TOT
54,Posthofbrug 5366,2021-09-25,07:00:00,57,34,23,FMN GV 16 Berchem TOT
54,Posthofbrug 5366,2021-09-25,08:00:00,100,52,48,FMN GV 16 Berchem TOT
54,Posthofbrug 5366,2021-09-25,09:00:00,166,97,69,FMN GV 16 Berchem TOT
54,Posthofbrug 5366,2021-09-25,10:00:00,200,134,66,FMN GV 16 Berchem TOT
54,Posthofbrug 5366,2021-09-25,11:00:00,229,144,85,FMN GV 16 Berchem TOT
54,Posthofbrug 5366,2021-09-25,12:00:00,270,148,122,FMN GV 16 Berchem TOT
54,Posthofbrug 5366,2021-09-25,13:00:00,232,132,100,FMN GV 16 Berchem TOT
54,Posthofbrug 5366,2021-09-25,14:00:00,321,172,149,FMN GV 16 Berchem TOT
54,Posthofbrug 5366,2021-09-25,15:00:00,310,155,155,FMN GV 16 Berchem TOT
54,Posthofbrug 5366,2021-09-25,16:00:00,258,129,129,FMN GV 16 Berchem TOT
54,Posthofbrug 5366,2021-09-25,17:00:00,301,148,153,FMN GV 16 Berchem TOT
54,Posthofbrug 5366,2021-09-25,18:00:00,273,141,132,FMN GV 16 Berchem TOT
54,Posthofbrug 5366,2021-09-25,19:00:00,204,119,85,FMN GV 16 Berchem TOT
54,Posthofbrug 5366,2021-09-25,20:00:00,155,83,72,FMN GV 16 Berchem TOT
54,Posthofbrug 5366,2021-09-25,21:00:00,97,52,45,FMN GV 16 Berchem TOT
54,Posthofbrug 5366,2021-09-25,22:00:00,110,46,64,FMN GV 16 Berchem TOT
54,Posthofbrug 5366,2021-09-25,23:00:00,107,49,58,FMN GV 16 Berchem TOT
54,Posthofbrug 5366,2021-09-26,00:00:00,87,35,52,FMN GV 16 Berchem TOT
54,Posthofbrug 5366,2021-09-26,01:00:00,59,19,40,FMN GV 16 Berchem TOT
54,Posthofbrug 5366,2021-09-26,02:00:00,25,6,19,FMN GV 16 Berchem TOT
54,Posthofbrug 5366,2021-09-26,03:00:00,33,20,13,FMN GV 16 Berchem TOT
54,Posthofbrug 5366,2021-09-26,04:00:00,13,4,9,FMN GV 16 Berchem TOT
54,Posthofbrug 5366,2021-09-26,05:00:00,24,9,15,FMN GV 16 Berchem TOT
54,Posthofbrug 5366,2021-09-26,06:00:00,17,13,4,FMN GV 16 Berchem TOT
54,Posthofbrug 5366,2021-09-26,07:00:00,39,26,13,FMN GV 16 Berchem TOT
54,Posthofbrug 5366,2021-09-26,08:00:00,93,76,17,FMN GV 16 Berchem TOT
54,Posthofbrug 5366,2021-09-26,09:00:00,179,128,51,FMN GV 16 Berchem TOT
54,Posthofbrug 5366,2021-09-26,10:00:00,221,102,119,FMN GV 16 Berchem TOT
54,Posthofbrug 5366,2021-09-26,11:00:00,174,74,100,FMN GV 16 Berchem TOT
54,Posthofbrug 5366,2021-09-26,12:00:00,193,105,88,FMN GV 16 Berchem TOT
54,Posthofbrug 5366,2021-09-26,13:00:00,211,114,97,FMN GV 16 Berchem TOT
54,Posthofbrug 5366,2021-09-26,14:00:00,189,87,102,FMN GV 16 Berchem TOT
54,Posthofbrug 5366,2021-09-26,15:00:00,177,86,91,FMN GV 16 Berchem TOT
54,Posthofbrug 5366,2021-09-26,16:00:00,141,57,84,FMN GV 16 Berchem TOT
54,Posthofbrug 5366,2021-09-26,17:00:00,163,76,87,FMN GV 16 Berchem TOT
54,Posthofbrug 5366,2021-09-26,18:00:00,135,73,62,FMN GV 16 Berchem TOT
54,Posthofbrug 5366,2021-09-26,19:00:00,109,71,38,FMN GV 16 Berchem TOT
54,Posthofbrug 5366,2021-09-26,20:00:00,89,45,44,FMN GV 16 Berchem TOT
54,Posthofbrug 5366,2021-09-26,21:00:00,89,33,56,FMN GV 16 Berchem TOT
54,Posthofbrug 5366,2021-09-26,22:00:00,67,36,31,FMN GV 16 Berchem TOT
54,Posthofbrug 5366,2021-09-26,23:00:00,37,16,21,FMN GV 16 Berchem TOT
54,Posthofbrug 5366,2021-09-27,00:00:00,12,8,4,FMN GV 16 Berchem TOT
54,Posthofbrug 5366,2021-09-27,01:00:00,8,6,2,FMN GV 16 Berchem TOT
54,Posthofbrug 5366,2021-09-27,02:00:00,3,1,2,FMN GV 16 Berchem TOT
54,Posthofbrug 5366,2021-09-27,03:00:00,3,1,2,FMN GV 16 Berchem TOT
54,Posthofbrug 5366,2021-09-27,04:00:00,7,5,2,FMN GV 16 Berchem TOT
54,Posthofbrug 5366,2021-09-27,05:00:00,28,17,11,FMN GV 16 Berchem TOT
54,Posthofbrug 5366,2021-09-27,06:00:00,101,85,16,FMN GV 16 Berchem TOT
54,Posthofbrug 5366,2021-09-27,07:00:00,395,302,93,FMN GV 16 Berchem TOT
54,Posthofbrug 5366,2021-09-27,08:00:00,688,539,149,FMN GV 16 Berchem TOT
54,Posthofbrug 5366,2021-09-27,09:00:00,267,185,82,FMN GV 16 Berchem TOT
54,Posthofbrug 5366,2021-09-27,10:00:00,121,76,45,FMN GV 16 Berchem TOT
54,Posthofbrug 5366,2021-09-27,11:00:00,128,85,43,FMN GV 16 Berchem TOT
54,Posthofbrug 5366,2021-09-27,12:00:00,188,109,79,FMN GV 16 Berchem TOT
54,Posthofbrug 5366,2021-09-27,13:00:00,147,82,65,FMN GV 16 Berchem TOT
54,Posthofbrug 5366,2021-09-27,14:00:00,8,2,6,FMN GV 16 Berchem TOT
54,Posthofbrug 5366,2021-09-27,15:00:00,0,0,0,FMN GV 16 Berchem TOT
54,Posthofbrug 5366,2021-09-27,16:00:00,0,0,0,FMN GV 16 Berchem TOT
54,Posthofbrug 5366,2021-09-27,17:00:00,0,0,0,FMN GV 16 Berchem TOT
54,Posthofbrug 5366,2021-09-27,18:00:00,0,0,0,FMN GV 16 Berchem TOT
54,Posthofbrug 5366,2021-09-27,19:00:00,0,0,0,FMN GV 16 Berchem TOT
54,Posthofbrug 5366,2021-09-27,20:00:00,0,0,0,FMN GV 16 Berchem TOT
54,Posthofbrug 5366,2021-09-27,21:00:00,0,0,0,FMN GV 16 Berchem TOT
54,Posthofbrug 5366,2021-09-27,22:00:00,75,29,46,FMN GV 16 Berchem TOT
54,Posthofbrug 5366,2021-09-27,23:00:00,42,13,29,FMN GV 16 Berchem TOT
54,Posthofbrug 5366,2021-09-28,00:00:00,30,7,23,FMN GV 16 Berchem TOT
54,Posthofbrug 5366,2021-09-28,01:00:00,22,8,14,FMN GV 16 Berchem TOT
54,Posthofbrug 5366,2021-09-28,02:00:00,7,1,6,FMN GV 16 Berchem TOT
54,Posthofbrug 5366,2021-09-28,03:00:00,12,0,12,FMN GV 16 Berchem TOT
54,Posthofbrug 5366,2021-09-28,04:00:00,10,6,4,FMN GV 16 Berchem TOT
54,Posthofbrug 5366,2021-09-28,05:00:00,32,20,12,FMN GV 16 Berchem TOT
54,Posthofbrug 5366,2021-09-28,06:00:00,102,84,18,FMN GV 16 Berchem TOT
54,Posthofbrug 5366,2021-09-28,07:00:00,479,349,130,FMN GV 16 Berchem TOT
54,Posthofbrug 5366,2021-09-28,08:00:00,748,563,185,FMN GV 16 Berchem TOT
54,Posthofbrug 5366,2021-09-28,09:00:00,271,206,65,FMN GV 16 Berchem TOT
54,Posthofbrug 5366,2021-09-28,10:00:00,22,18,4,FMN GV 16 Berchem TOT
54,Posthofbrug 5366,2021-09-28,11:00:00,0,0,0,FMN GV 16 Berchem TOT
54,Posthofbrug 5366,2021-09-28,12:00:00,0,0,0,FMN GV 16 Berchem TOT
54,Posthofbrug 5366,2021-09-28,13:00:00,0,0,0,FMN GV 16 Berchem TOT
54,Posthofbrug 5366,2021-09-28,14:00:00,0,0,0,FMN GV 16 Berchem TOT
54,Posthofbrug 5366,2021-09-28,15:00:00,0,0,0,FMN GV 16 Berchem TOT
54,Posthofbrug 5366,2021-09-28,16:00:00,0,0,0,FMN GV 16 Berchem TOT
54,Posthofbrug 5366,2021-09-28,17:00:00,0,0,0,FMN GV 16 Berchem TOT
54,Posthofbrug 5366,2021-09-28,18:00:00,0,0,0,FMN GV 16 Berchem TOT
54,Posthofbrug 5366,2021-09-28,19:00:00,0,0,0,FMN GV 16 Berchem TOT
54,Posthofbrug 5366,2021-09-28,20:00:00,95,47,48,FMN GV 16 Berchem TOT
54,Posthofbrug 5366,2021-09-28,21:00:00,123,53,70,FMN GV 16 Berchem TOT
54,Posthofbrug 5366,2021-09-28,22:00:00,87,37,50,FMN GV 16 Berchem TOT
54,Posthofbrug 5366,2021-09-28,23:00:00,73,30,43,FMN GV 16 Berchem TOT
54,Posthofbrug 5366,2021-09-29,00:00:00,14,4,10,FMN GV 16 Berchem TOT
54,Posthofbrug 5366,2021-09-29,01:00:00,10,3,7,FMN GV 16 Berchem TOT
54,Posthofbrug 5366,2021-09-29,02:00:00,12,1,11,FMN GV 16 Berchem TOT
54,Posthofbrug 5366,2021-09-29,03:00:00,1,0,1,FMN GV 16 Berchem TOT
54,Posthofbrug 5366,2021-09-29,04:00:00,8,7,1,FMN GV 16 Berchem TOT
54,Posthofbrug 5366,2021-09-29,05:00:00,32,21,11,FMN GV 16 Berchem TOT
54,Posthofbrug 5366,2021-09-29,06:00:00,97,81,16,FMN GV 16 Berchem TOT
54,Posthofbrug 5366,2021-09-29,07:00:00,321,226,95,FMN GV 16 Berchem TOT
54,Posthofbrug 5366,2021-09-29,08:00:00,509,368,141,FMN GV 16 Berchem TOT
54,Posthofbrug 5366,2021-09-29,09:00:00,179,133,46,FMN GV 16 Berchem TOT
54,Posthofbrug 5366,2021-09-29,10:00:00,101,70,31,FMN GV 16 Berchem TOT
54,Posthofbrug 5366,2021-09-29,11:00:00,100,62,38,FMN GV 16 Berchem TOT
54,Posthofbrug 5366,2021-09-29,12:00:00,224,110,114,FMN GV 16 Berchem TOT
54,Posthofbrug 5366,2021-09-29,13:00:00,175,66,109,FMN GV 16 Berchem TOT
54,Posthofbrug 5366,2021-09-29,14:00:00,124,56,68,FMN GV 16 Berchem TOT
54,Posthofbrug 5366,2021-09-29,15:00:00,141,52,89,FMN GV 16 Berchem TOT
54,Posthofbrug 5366,2021-09-29,16:00:00,248,83,165,FMN GV 16 Berchem TOT
54,Posthofbrug 5366,2021-09-29,17:00:00,371,147,224,FMN GV 16 Berchem TOT
54,Posthofbrug 5366,2021-09-29,18:00:00,248,81,167,FMN GV 16 Berchem TOT
54,Posthofbrug 5366,2021-09-29,19:00:00,130,66,64,FMN GV 16 Berchem TOT
54,Posthofbrug 5366,2021-09-29,20:00:00,85,48,37,FMN GV 16 Berchem TOT
54,Posthofbrug 5366,2021-09-29,21:00:00,75,33,42,FMN GV 16 Berchem TOT
54,Posthofbrug 5366,2021-09-29,22:00:00,91,38,53,FMN GV 16 Berchem TOT
54,Posthofbrug 5366,2021-09-29,23:00:00,56,23,33,FMN GV 16 Berchem TOT
54,Posthofbrug 5366,2021-09-30,00:00:00,12,4,8,FMN GV 16 Berchem TOT
54,Posthofbrug 5366,2021-09-30,01:00:00,9,5,4,FMN GV 16 Berchem TOT
54,Posthofbrug 5366,2021-09-30,02:00:00,4,2,2,FMN GV 16 Berchem TOT
54,Posthofbrug 5366,2021-09-30,03:00:00,14,2,12,FMN GV 16 Berchem TOT
54,Posthofbrug 5366,2021-09-30,04:00:00,8,5,3,FMN GV 16 Berchem TOT
54,Posthofbrug 5366,2021-09-30,05:00:00,34,20,14,FMN GV 16 Berchem TOT
54,Posthofbrug 5366,2021-09-30,06:00:00,117,91,26,FMN GV 16 Berchem TOT
54,Posthofbrug 5366,2021-09-30,07:00:00,455,340,115,FMN GV 16 Berchem TOT
54,Posthofbrug 5366,2021-09-30,08:00:00,702,549,153,FMN GV 16 Berchem TOT
54,Posthofbrug 5366,2021-09-30,09:00:00,249,202,47,FMN GV 16 Berchem TOT
54,Posthofbrug 5366,2021-09-30,10:00:00,113,81,32,FMN GV 16 Berchem TOT
54,Posthofbrug 5366,2021-09-30,11:00:00,118,80,38,FMN GV 16 Berchem TOT
54,Posthofbrug 5366,2021-09-30,12:00:00,192,111,81,FMN GV 16 Berchem TOT
54,Posthofbrug 5366,2021-09-30,13:00:00,190,107,83,FMN GV 16 Berchem TOT
54,Posthofbrug 5366,2021-09-30,14:00:00,176,79,97,FMN GV 16 Berchem TOT
54,Posthofbrug 5366,2021-09-30,15:00:00,230,76,154,FMN GV 16 Berchem TOT
54,Posthofbrug 5366,2021-09-30,16:00:00,449,131,318,FMN GV 16 Berchem TOT
54,Posthofbrug 5366,2021-09-30,17:00:00,576,157,419,FMN GV 16 Berchem TOT
54,Posthofbrug 5366,2021-09-30,18:00:00,362,117,245,FMN GV 16 Berchem TOT
54,Posthofbrug 5366,2021-09-30,19:00:00,228,100,128,FMN GV 16 Berchem TOT
54,Posthofbrug 5366,2021-09-30,20:00:00,122,62,60,FMN GV 16 Berchem TOT
54,Posthofbrug 5366,2021-09-30,21:00:00,84,39,45,FMN GV 16 Berchem TOT
54,Posthofbrug 5366,2021-09-30,22:00:00,98,31,67,FMN GV 16 Berchem TOT
54,Posthofbrug 5366,2021-09-30,23:00:00,89,28,61,FMN GV 16 Berchem TOT
54,Posthofbrug 5366,2021-10-01,00:00:00,53,14,39,FMN GV 16 Berchem TOT
54,Posthofbrug 5366,2021-10-01,01:00:00,34,11,23,FMN GV 16 Berchem TOT
54,Posthofbrug 5366,2021-10-01,02:00:00,19,0,19,FMN GV 16 Berchem TOT
54,Posthofbrug 5366,2021-10-01,03:00:00,16,5,11,FMN GV 16 Berchem TOT
54,Posthofbrug 5366,2021-10-01,04:00:00,18,8,10,FMN GV 16 Berchem TOT
54,Posthofbrug 5366,2021-10-01,05:00:00,37,20,17,FMN GV 16 Berchem TOT
54,Posthofbrug 5366,2021-10-01,06:00:00,79,68,11,FMN GV 16 Berchem TOT
54,Posthofbrug 5366,2021-10-01,07:00:00,323,239,84,FMN GV 16 Berchem TOT
54,Posthofbrug 5366,2021-10-01,08:00:00,581,453,128,FMN GV 16 Berchem TOT
54,Posthofbrug 5366,2021-10-01,09:00:00,200,158,42,FMN GV 16 Berchem TOT
54,Posthofbrug 5366,2021-10-01,10:00:00,139,93,46,FMN GV 16 Berchem TOT
54,Posthofbrug 5366,2021-10-01,11:00:00,117,62,55,FMN GV 16 Berchem TOT
54,Posthofbrug 5366,2021-10-01,12:00:00,193,84,109,FMN GV 16 Berchem TOT
54,Posthofbrug 5366,2021-10-01,13:00:00,159,53,106,FMN GV 16 Berchem TOT
54,Posthofbrug 5366,2021-10-01,14:00:00,156,65,91,FMN GV 16 Berchem TOT
54,Posthofbrug 5366,2021-10-01,15:00:00,271,90,181,FMN GV 16 Berchem TOT
54,Posthofbrug 5366,2021-10-01,16:00:00,366,124,242,FMN GV 16 Berchem TOT
54,Posthofbrug 5366,2021-10-01,17:00:00,340,105,235,FMN GV 16 Berchem TOT
54,Posthofbrug 5366,2021-10-01,18:00:00,273,107,166,FMN GV 16 Berchem TOT
54,Posthofbrug 5366,2021-10-01,19:00:00,135,61,74,FMN GV 16 Berchem TOT
54,Posthofbrug 5366,2021-10-01,20:00:00,70,41,29,FMN GV 16 Berchem TOT
54,Posthofbrug 5366,2021-10-01,21:00:00,49,21,28,FMN GV 16 Berchem TOT
54,Posthofbrug 5366,2021-10-01,22:00:00,60,26,34,FMN GV 16 Berchem TOT
54,Posthofbrug 5366,2021-10-01,23:00:00,51,13,38,FMN GV 16 Berchem TOT
54,Posthofbrug 5366,2021-10-02,00:00:00,40,11,29,FMN GV 16 Berchem TOT
54,Posthofbrug 5366,2021-10-02,01:00:00,28,11,17,FMN GV 16 Berchem TOT
54,Posthofbrug 5366,2021-10-02,02:00:00,16,5,11,FMN GV 16 Berchem TOT
54,Posthofbrug 5366,2021-10-02,03:00:00,24,8,16,FMN GV 16 Berchem TOT
54,Posthofbrug 5366,2021-10-02,04:00:00,26,6,20,FMN GV 16 Berchem TOT
54,Posthofbrug 5366,2021-10-02,05:00:00,25,10,15,FMN GV 16 Berchem TOT
54,Posthofbrug 5366,2021-10-02,06:00:00,15,9,6,FMN GV 16 Berchem TOT
54,Posthofbrug 5366,2021-10-02,07:00:00,38,18,20,FMN GV 16 Berchem TOT
54,Posthofbrug 5366,2021-10-02,08:00:00,57,29,28,FMN GV 16 Berchem TOT
54,Posthofbrug 5366,2021-10-02,09:00:00,111,75,36,FMN GV 16 Berchem TOT
54,Posthofbrug 5366,2021-10-02,10:00:00,125,77,48,FMN GV 16 Berchem TOT
54,Posthofbrug 5366,2021-10-02,11:00:00,170,111,59,FMN GV 16 Berchem TOT
54,Posthofbrug 5366,2021-10-02,12:00:00,142,82,60,FMN GV 16 Berchem TOT
54,Posthofbrug 5366,2021-10-02,13:00:00,145,77,68,FMN GV 16 Berchem TOT
54,Posthofbrug 5366,2021-10-02,14:00:00,168,100,68,FMN GV 16 Berchem TOT
54,Posthofbrug 5366,2021-10-02,15:00:00,117,56,61,FMN GV 16 Berchem TOT
54,Posthofbrug 5366,2021-10-02,16:00:00,23,12,11,FMN GV 16 Berchem TOT
54,Posthofbrug 5366,2021-10-02,17:00:00,0,0,0,FMN GV 16 Berchem TOT
54,Posthofbrug 5366,2021-10-02,18:00:00,0,0,0,FMN GV 16 Berchem TOT
54,Posthofbrug 5366,2021-10-02,19:00:00,0,0,0,FMN GV 16 Berchem TOT
54,Posthofbrug 5366,2021-10-02,20:00:00,0,0,0,FMN GV 16 Berchem TOT
54,Posthofbrug 5366,2021-10-02,21:00:00,0,0,0,FMN GV 16 Berchem TOT
54,Posthofbrug 5366,2021-10-02,22:00:00,28,9,19,FMN GV 16 Berchem TOT
54,Posthofbrug 5366,2021-10-02,23:00:00,55,19,36,FMN GV 16 Berchem TOT
54,Posthofbrug 5366,2021-10-03,00:00:00,39,13,26,FMN GV 16 Berchem TOT
54,Posthofbrug 5366,2021-10-03,01:00:00,27,7,20,FMN GV 16 Berchem TOT
54,Posthofbrug 5366,2021-10-03,02:00:00,12,6,6,FMN GV 16 Berchem TOT
54,Posthofbrug 5366,2021-10-03,03:00:00,13,3,10,FMN GV 16 Berchem TOT
54,Posthofbrug 5366,2021-10-03,04:00:00,11,3,8,FMN GV 16 Berchem TOT
54,Posthofbrug 5366,2021-10-03,05:00:00,19,5,14,FMN GV 16 Berchem TOT
54,Posthofbrug 5366,2021-10-03,06:00:00,22,10,12,FMN GV 16 Berchem TOT
54,Posthofbrug 5366,2021-10-03,07:00:00,18,9,9,FMN GV 16 Berchem TOT
54,Posthofbrug 5366,2021-10-03,08:00:00,23,14,9,FMN GV 16 Berchem TOT
54,Posthofbrug 5366,2021-10-03,09:00:00,28,19,9,FMN GV 16 Berchem TOT
54,Posthofbrug 5366,2021-10-03,10:00:00,49,24,25,FMN GV 16 Berchem TOT
54,Posthofbrug 5366,2021-10-03,11:00:00,35,18,17,FMN GV 16 Berchem TOT
54,Posthofbrug 5366,2021-10-03,12:00:00,51,30,21,FMN GV 16 Berchem TOT
54,Posthofbrug 5366,2021-10-03,13:00:00,60,25,35,FMN GV 16 Berchem TOT
54,Posthofbrug 5366,2021-10-03,14:00:00,48,23,25,FMN GV 16 Berchem TOT
54,Posthofbrug 5366,2021-10-03,15:00:00,64,31,33,FMN GV 16 Berchem TOT
54,Posthofbrug 5366,2021-10-03,16:00:00,64,27,37,FMN GV 16 Berchem TOT
54,Posthofbrug 5366,2021-10-03,17:00:00,104,53,51,FMN GV 16 Berchem TOT
54,Posthofbrug 5366,2021-10-03,18:00:00,99,59,40,FMN GV 16 Berchem TOT
54,Posthofbrug 5366,2021-10-03,19:00:00,72,37,35,FMN GV 16 Berchem TOT
54,Posthofbrug 5366,2021-10-03,20:00:00,45,24,21,FMN GV 16 Berchem TOT
54,Posthofbrug 5366,2021-10-03,21:00:00,48,32,16,FMN GV 16 Berchem TOT
54,Posthofbrug 5366,2021-10-03,22:00:00,36,18,18,FMN GV 16 Berchem TOT
54,Posthofbrug 5366,2021-10-03,23:00:00,37,10,27,FMN GV 16 Berchem TOT
54,Posthofbrug 5366,2021-10-04,00:00:00,14,8,6,FMN GV 16 Berchem TOT
54,Posthofbrug 5366,2021-10-04,01:00:00,7,3,4,FMN GV 16 Berchem TOT
54,Posthofbrug 5366,2021-10-04,02:00:00,6,3,3,FMN GV 16 Berchem TOT
54,Posthofbrug 5366,2021-10-04,03:00:00,2,2,0,FMN GV 16 Berchem TOT
54,Posthofbrug 5366,2021-10-04,04:00:00,12,11,1,FMN GV 16 Berchem TOT
54,Posthofbrug 5366,2021-10-04,05:00:00,25,18,7,FMN GV 16 Berchem TOT
54,Posthofbrug 5366,2021-10-04,06:00:00,104,90,14,FMN GV 16 Berchem TOT
54,Posthofbrug 5366,2021-10-04,07:00:00,413,308,105,FMN GV 16 Berchem TOT
54,Posthofbrug 5366,2021-10-04,08:00:00,708,539,169,FMN GV 16 Berchem TOT
54,Posthofbrug 5366,2021-10-04,09:00:00,239,194,45,FMN GV 16 Berchem TOT
54,Posthofbrug 5366,2021-10-04,10:00:00,38,28,10,FMN GV 16 Berchem TOT
54,Posthofbrug 5366,2021-10-04,11:00:00,0,0,0,FMN GV 16 Berchem TOT
54,Posthofbrug 5366,2021-10-04,12:00:00,0,0,0,FMN GV 16 Berchem TOT
54,Posthofbrug 5366,2021-10-04,13:00:00,0,0,0,FMN GV 16 Berchem TOT
54,Posthofbrug 5366,2021-10-04,14:00:00,157,76,81,FMN GV 16 Berchem TOT
54,Posthofbrug 5366,2021-10-04,15:00:00,312,105,207,FMN GV 16 Berchem TOT
54,Posthofbrug 5366,2021-10-04,16:00:00,429,151,278,FMN GV 16 Berchem TOT
54,Posthofbrug 5366,2021-10-04,17:00:00,583,154,429,FMN GV 16 Berchem TOT
54,Posthofbrug 5366,2021-10-04,18:00:00,368,110,258,FMN GV 16 Berchem TOT
54,Posthofbrug 5366,2021-10-04,19:00:00,202,86,116,FMN GV 16 Berchem TOT
54,Posthofbrug 5366,2021-10-04,20:00:00,115,56,59,FMN GV 16 Berchem TOT
54,Posthofbrug 5366,2021-10-04,21:00:00,70,33,37,FMN GV 16 Berchem TOT
54,Posthofbrug 5366,2021-10-04,22:00:00,80,29,51,FMN GV 16 Berchem TOT
54,Posthofbrug 5366,2021-10-04,23:00:00,45,16,29,FMN GV 16 Berchem TOT
54,Posthofbrug 5366,2021-10-05,00:00:00,15,3,12,FMN GV 16 Berchem TOT
54,Posthofbrug 5366,2021-10-05,01:00:00,12,5,7,FMN GV 16 Berchem TOT
54,Posthofbrug 5366,2021-10-05,02:00:00,4,0,4,FMN GV 16 Berchem TOT
54,Posthofbrug 5366,2021-10-05,03:00:00,4,0,4,FMN GV 16 Berchem TOT
54,Posthofbrug 5366,2021-10-05,04:00:00,16,10,6,FMN GV 16 Berchem TOT
54,Posthofbrug 5366,2021-10-05,05:00:00,29,19,10,FMN GV 16 Berchem TOT
54,Posthofbrug 5366,2021-10-05,06:00:00,117,99,18,FMN GV 16 Berchem TOT
54,Posthofbrug 5366,2021-10-05,07:00:00,436,320,116,FMN GV 16 Berchem TOT
54,Posthofbrug 5366,2021-10-05,08:00:00,730,555,175,FMN GV 16 Berchem TOT
54,Posthofbrug 5366,2021-10-05,09:00:00,232,181,51,FMN GV 16 Berchem TOT
54,Posthofbrug 5366,2021-10-05,10:00:00,130,93,37,FMN GV 16 Berchem TOT
54,Posthofbrug 5366,2021-10-05,11:00:00,95,49,46,FMN GV 16 Berchem TOT
54,Posthofbrug 5366,2021-10-05,12:00:00,132,59,73,FMN GV 16 Berchem TOT
54,Posthofbrug 5366,2021-10-05,13:00:00,108,54,54,FMN GV 16 Berchem TOT
54,Posthofbrug 5366,2021-10-05,14:00:00,100,39,61,FMN GV 16 Berchem TOT
54,Posthofbrug 5366,2021-10-05,15:00:00,197,65,132,FMN GV 16 Berchem TOT
54,Posthofbrug 5366,2021-10-05,16:00:00,407,128,279,FMN GV 16 Berchem TOT
54,Posthofbrug 5366,2021-10-05,17:00:00,516,151,365,FMN GV 16 Berchem TOT
54,Posthofbrug 5366,2021-10-05,18:00:00,372,119,253,FMN GV 16 Berchem TOT
54,Posthofbrug 5366,2021-10-05,19:00:00,196,77,119,FMN GV 16 Berchem TOT
54,Posthofbrug 5366,2021-10-05,20:00:00,90,31,59,FMN GV 16 Berchem TOT
54,Posthofbrug 5366,2021-10-05,21:00:00,85,43,42,FMN GV 16 Berchem TOT
54,Posthofbrug 5366,2021-10-05,22:00:00,83,40,43,FMN GV 16 Berchem TOT
54,Posthofbrug 5366,2021-10-05,23:00:00,39,16,23,FMN GV 16 Berchem TOT
54,Posthofbrug 5366,2021-10-06,00:00:00,32,18,14,FMN GV 16 Berchem TOT
54,Posthofbrug 5366,2021-10-06,01:00:00,14,10,4,FMN GV 16 Berchem TOT
54,Posthofbrug 5366,2021-10-06,02:00:00,7,2,5,FMN GV 16 Berchem TOT
54,Posthofbrug 5366,2021-10-06,03:00:00,9,3,6,FMN GV 16 Berchem TOT
54,Posthofbrug 5366,2021-10-06,04:00:00,13,10,3,FMN GV 16 Berchem TOT
54,Posthofbrug 5366,2021-10-06,05:00:00,21,15,6,FMN GV 16 Berchem TOT
54,Posthofbrug 5366,2021-10-06,06:00:00,72,63,9,FMN GV 16 Berchem TOT
54,Posthofbrug 5366,2021-10-06,07:00:00,300,206,94,FMN GV 16 Berchem TOT
54,Posthofbrug 5366,2021-10-06,08:00:00,500,357,143,FMN GV 16 Berchem TOT
54,Posthofbrug 5366,2021-10-06,09:00:00,153,122,31,FMN GV 16 Berchem TOT
54,Posthofbrug 5366,2021-10-06,10:00:00,71,46,25,FMN GV 16 Berchem TOT
54,Posthofbrug 5366,2021-10-06,11:00:00,94,52,42,FMN GV 16 Berchem TOT
54,Posthofbrug 5366,2021-10-06,12:00:00,227,95,132,FMN GV 16 Berchem TOT
54,Posthofbrug 5366,2021-10-06,13:00:00,160,80,80,FMN GV 16 Berchem TOT
54,Posthofbrug 5366,2021-10-06,14:00:00,108,45,63,FMN GV 16 Berchem TOT
54,Posthofbrug 5366,2021-10-06,15:00:00,147,65,82,FMN GV 16 Berchem TOT
54,Posthofbrug 5366,2021-10-06,16:00:00,292,114,178,FMN GV 16 Berchem TOT
54,Posthofbrug 5366,2021-10-06,17:00:00,384,142,242,FMN GV 16 Berchem TOT
54,Posthofbrug 5366,2021-10-06,18:00:00,269,108,161,FMN GV 16 Berchem TOT
54,Posthofbrug 5366,2021-10-06,19:00:00,146,76,70,FMN GV 16 Berchem TOT
54,Posthofbrug 5366,2021-10-06,20:00:00,97,44,53,FMN GV 16 Berchem TOT
54,Posthofbrug 5366,2021-10-06,21:00:00,80,40,40,FMN GV 16 Berchem TOT
54,Posthofbrug 5366,2021-10-06,22:00:00,90,28,62,FMN GV 16 Berchem TOT
54,Posthofbrug 5366,2021-10-06,23:00:00,52,19,33,FMN GV 16 Berchem TOT
54,Posthofbrug 5366,2021-10-07,00:00:00,23,12,11,FMN GV 16 Berchem TOT
54,Posthofbrug 5366,2021-10-07,01:00:00,15,6,9,FMN GV 16 Berchem TOT
54,Posthofbrug 5366,2021-10-07,02:00:00,7,1,6,FMN GV 16 Berchem TOT
54,Posthofbrug 5366,2021-10-07,03:00:00,5,2,3,FMN GV 16 Berchem TOT
54,Posthofbrug 5366,2021-10-07,04:00:00,9,7,2,FMN GV 16 Berchem TOT
54,Posthofbrug 5366,2021-10-07,05:00:00,25,18,7,FMN GV 16 Berchem TOT
54,Posthofbrug 5366,2021-10-07,06:00:00,104,80,24,FMN GV 16 Berchem TOT
54,Posthofbrug 5366,2021-10-07,07:00:00,448,329,119,FMN GV 16 Berchem TOT
54,Posthofbrug 5366,2021-10-07,08:00:00,713,556,157,FMN GV 16 Berchem TOT
54,Posthofbrug 5366,2021-10-07,09:00:00,287,213,74,FMN GV 16 Berchem TOT
54,Posthofbrug 5366,2021-10-07,10:00:00,140,103,37,FMN GV 16 Berchem TOT
54,Posthofbrug 5366,2021-10-07,11:00:00,135,85,50,FMN GV 16 Berchem TOT
54,Posthofbrug 5366,2021-10-07,12:00:00,194,98,96,FMN GV 16 Berchem TOT
54,Posthofbrug 5366,2021-10-07,13:00:00,155,86,69,FMN GV 16 Berchem TOT
54,Posthofbrug 5366,2021-10-07,14:00:00,183,82,101,FMN GV 16 Berchem TOT
54,Posthofbrug 5366,2021-10-07,15:00:00,256,92,164,FMN GV 16 Berchem TOT
54,Posthofbrug 5366,2021-10-07,16:00:00,455,142,313,FMN GV 16 Berchem TOT
54,Posthofbrug 5366,2021-10-07,17:00:00,565,163,402,FMN GV 16 Berchem TOT
54,Posthofbrug 5366,2021-10-07,18:00:00,393,148,245,FMN GV 16 Berchem TOT
54,Posthofbrug 5366,2021-10-07,19:00:00,236,113,123,FMN GV 16 Berchem TOT
54,Posthofbrug 5366,2021-10-07,20:00:00,115,54,61,FMN GV 16 Berchem TOT
54,Posthofbrug 5366,2021-10-07,21:00:00,100,51,49,FMN GV 16 Berchem TOT
54,Posthofbrug 5366,2021-10-07,22:00:00,125,42,83,FMN GV 16 Berchem TOT
54,Posthofbrug 5366,2021-10-07,23:00:00,90,24,66,FMN GV 16 Berchem TOT
54,Posthofbrug 5366,2021-10-08,00:00:00,40,15,25,FMN GV 16 Berchem TOT
54,Posthofbrug 5366,2021-10-08,01:00:00,21,6,15,FMN GV 16 Berchem TOT
54,Posthofbrug 5366,2021-10-08,02:00:00,10,1,9,FMN GV 16 Berchem TOT
54,Posthofbrug 5366,2021-10-08,03:00:00,15,2,13,FMN GV 16 Berchem TOT
54,Posthofbrug 5366,2021-10-08,04:00:00,10,8,2,FMN GV 16 Berchem TOT
54,Posthofbrug 5366,2021-10-08,05:00:00,38,24,14,FMN GV 16 Berchem TOT
54,Posthofbrug 5366,2021-10-08,06:00:00,98,81,17,FMN GV 16 Berchem TOT
54,Posthofbrug 5366,2021-10-08,07:00:00,345,255,90,FMN GV 16 Berchem TOT
54,Posthofbrug 5366,2021-10-08,08:00:00,579,433,146,FMN GV 16 Berchem TOT
54,Posthofbrug 5366,2021-10-08,09:00:00,239,186,53,FMN GV 16 Berchem TOT
54,Posthofbrug 5366,2021-10-08,10:00:00,126,94,32,FMN GV 16 Berchem TOT
54,Posthofbrug 5366,2021-10-08,11:00:00,154,103,51,FMN GV 16 Berchem TOT
54,Posthofbrug 5366,2021-10-08,12:00:00,203,91,112,FMN GV 16 Berchem TOT
54,Posthofbrug 5366,2021-10-08,13:00:00,230,117,113,FMN GV 16 Berchem TOT
54,Posthofbrug 5366,2021-10-08,14:00:00,230,111,119,FMN GV 16 Berchem TOT
54,Posthofbrug 5366,2021-10-08,15:00:00,327,116,211,FMN GV 16 Berchem TOT
54,Posthofbrug 5366,2021-10-08,16:00:00,456,167,289,FMN GV 16 Berchem TOT
54,Posthofbrug 5366,2021-10-08,17:00:00,520,182,338,FMN GV 16 Berchem TOT
54,Posthofbrug 5366,2021-10-08,18:00:00,347,176,171,FMN GV 16 Berchem TOT
54,Posthofbrug 5366,2021-10-08,19:00:00,237,118,119,FMN GV 16 Berchem TOT
54,Posthofbrug 5366,2021-10-08,20:00:00,153,60,93,FMN GV 16 Berchem TOT
54,Posthofbrug 5366,2021-10-08,21:00:00,95,42,53,FMN GV 16 Berchem TOT
54,Posthofbrug 5366,2021-10-08,22:00:00,122,37,85,FMN GV 16 Berchem TOT
54,Posthofbrug 5366,2021-10-08,23:00:00,78,21,57,FMN GV 16 Berchem TOT
54,Posthofbrug 5366,2021-10-09,00:00:00,61,21,40,FMN GV 16 Berchem TOT
54,Posthofbrug 5366,2021-10-09,01:00:00,47,23,24,FMN GV 16 Berchem TOT
54,Posthofbrug 5366,2021-10-09,02:00:00,32,7,25,FMN GV 16 Berchem TOT
54,Posthofbrug 5366,2021-10-09,03:00:00,44,7,37,FMN GV 16 Berchem TOT
54,Posthofbrug 5366,2021-10-09,04:00:00,25,3,22,FMN GV 16 Berchem TOT
54,Posthofbrug 5366,2021-10-09,05:00:00,21,10,11,FMN GV 16 Berchem TOT
54,Posthofbrug 5366,2021-10-09,06:00:00,19,9,10,FMN GV 16 Berchem TOT
54,Posthofbrug 5366,2021-10-09,07:00:00,49,29,20,FMN GV 16 Berchem TOT
54,Posthofbrug 5366,2021-10-09,08:00:00,70,40,30,FMN GV 16 Berchem TOT
54,Posthofbrug 5366,2021-10-09,09:00:00,154,93,61,FMN GV 16 Berchem TOT
54,Posthofbrug 5366,2021-10-09,10:00:00,143,96,47,FMN GV 16 Berchem TOT
54,Posthofbrug 5366,2021-10-09,11:00:00,201,135,66,FMN GV 16 Berchem TOT
54,Posthofbrug 5366,2021-10-09,12:00:00,179,116,63,FMN GV 16 Berchem TOT
54,Posthofbrug 5366,2021-10-09,13:00:00,254,151,103,FMN GV 16 Berchem TOT
54,Posthofbrug 5366,2021-10-09,14:00:00,321,183,138,FMN GV 16 Berchem TOT
54,Posthofbrug 5366,2021-10-09,15:00:00,246,150,96,FMN GV 16 Berchem TOT
54,Posthofbrug 5366,2021-10-09,16:00:00,27,18,9,FMN GV 16 Berchem TOT
54,Posthofbrug 5366,2021-10-09,17:00:00,0,0,0,FMN GV 16 Berchem TOT
54,Posthofbrug 5366,2021-10-09,18:00:00,209,85,124,FMN GV 16 Berchem TOT
54,Posthofbrug 5366,2021-10-09,19:00:00,174,84,90,FMN GV 16 Berchem TOT
54,Posthofbrug 5366,2021-10-09,20:00:00,126,64,62,FMN GV 16 Berchem TOT
54,Posthofbrug 5366,2021-10-09,21:00:00,78,35,43,FMN GV 16 Berchem TOT
54,Posthofbrug 5366,2021-10-09,22:00:00,102,40,62,FMN GV 16 Berchem TOT
54,Posthofbrug 5366,2021-10-09,23:00:00,73,20,53,FMN GV 16 Berchem TOT
54,Posthofbrug 5366,2021-10-10,00:00:00,67,30,37,FMN GV 16 Berchem TOT
54,Posthofbrug 5366,2021-10-10,01:00:00,43,18,25,FMN GV 16 Berchem TOT
54,Posthofbrug 5366,2021-10-10,02:00:00,32,5,27,FMN GV 16 Berchem TOT
54,Posthofbrug 5366,2021-10-10,03:00:00,25,4,21,FMN GV 16 Berchem TOT
54,Posthofbrug 5366,2021-10-10,04:00:00,17,5,12,FMN GV 16 Berchem TOT
54,Posthofbrug 5366,2021-10-10,05:00:00,18,3,15,FMN GV 16 Berchem TOT
54,Posthofbrug 5366,2021-10-10,06:00:00,27,19,8,FMN GV 16 Berchem TOT
54,Posthofbrug 5366,2021-10-10,07:00:00,37,21,16,FMN GV 16 Berchem TOT
54,Posthofbrug 5366,2021-10-10,08:00:00,36,18,18,FMN GV 16 Berchem TOT
54,Posthofbrug 5366,2021-10-10,09:00:00,156,99,57,FMN GV 16 Berchem TOT
54,Posthofbrug 5366,2021-10-10,10:00:00,163,115,48,FMN GV 16 Berchem TOT
54,Posthofbrug 5366,2021-10-10,11:00:00,194,141,53,FMN GV 16 Berchem TOT
54,Posthofbrug 5366,2021-10-10,12:00:00,298,219,79,FMN GV 16 Berchem TOT
54,Posthofbrug 5366,2021-10-10,13:00:00,306,220,86,FMN GV 16 Berchem TOT
54,Posthofbrug 5366,2021-10-10,14:00:00,331,209,122,FMN GV 16 Berchem TOT
54,Posthofbrug 5366,2021-10-10,15:00:00,238,95,143,FMN GV 16 Berchem TOT
54,Posthofbrug 5366,2021-10-10,16:00:00,368,109,259,FMN GV 16 Berchem TOT
54,Posthofbrug 5366,2021-10-10,17:00:00,306,94,212,FMN GV 16 Berchem TOT
54,Posthofbrug 5366,2021-10-10,18:00:00,243,70,173,FMN GV 16 Berchem TOT
54,Posthofbrug 5366,2021-10-10,19:00:00,116,55,61,FMN GV 16 Berchem TOT
54,Posthofbrug 5366,2021-10-10,20:00:00,87,46,41,FMN GV 16 Berchem TOT
54,Posthofbrug 5366,2021-10-10,21:00:00,69,34,35,FMN GV 16 Berchem TOT
54,Posthofbrug 5366,2021-10-10,22:00:00,50,28,22,FMN GV 16 Berchem TOT
54,Posthofbrug 5366,2021-10-10,23:00:00,33,8,25,FMN GV 16 Berchem TOT
54,Posthofbrug 5366,2021-10-11,00:00:00,8,2,6,FMN GV 16 Berchem TOT
54,Posthofbrug 5366,2021-10-11,01:00:00,5,1,4,FMN GV 16 Berchem TOT
54,Posthofbrug 5366,2021-10-11,02:00:00,1,0,1,FMN GV 16 Berchem TOT
54,Posthofbrug 5366,2021-10-11,03:00:00,4,1,3,FMN GV 16 Berchem TOT
54,Posthofbrug 5366,2021-10-11,04:00:00,9,8,1,FMN GV 16 Berchem TOT
54,Posthofbrug 5366,2021-10-11,05:00:00,26,17,9,FMN GV 16 Berchem TOT
54,Posthofbrug 5366,2021-10-11,06:00:00,100,82,18,FMN GV 16 Berchem TOT
54,Posthofbrug 5366,2021-10-11,07:00:00,443,334,109,FMN GV 16 Berchem TOT
54,Posthofbrug 5366,2021-10-11,08:00:00,760,576,184,FMN GV 16 Berchem TOT
54,Posthofbrug 5366,2021-10-11,09:00:00,258,205,53,FMN GV 16 Berchem TOT
54,Posthofbrug 5366,2021-10-11,10:00:00,128,83,45,FMN GV 16 Berchem TOT
54,Posthofbrug 5366,2021-10-11,11:00:00,108,56,52,FMN GV 16 Berchem TOT
54,Posthofbrug 5366,2021-10-11,12:00:00,160,89,71,FMN GV 16 Berchem TOT
54,Posthofbrug 5366,2021-10-11,13:00:00,147,69,78,FMN GV 16 Berchem TOT
54,Posthofbrug 5366,2021-10-11,14:00:00,135,60,75,FMN GV 16 Berchem TOT
54,Posthofbrug 5366,2021-10-11,15:00:00,251,102,149,FMN GV 16 Berchem TOT
54,Posthofbrug 5366,2021-10-11,16:00:00,447,148,299,FMN GV 16 Berchem TOT
54,Posthofbrug 5366,2021-10-11,17:00:00,589,189,400,FMN GV 16 Berchem TOT
54,Posthofbrug 5366,2021-10-11,18:00:00,376,114,262,FMN GV 16 Berchem TOT
54,Posthofbrug 5366,2021-10-11,19:00:00,176,78,98,FMN GV 16 Berchem TOT
54,Posthofbrug 5366,2021-10-11,20:00:00,110,54,56,FMN GV 16 Berchem TOT
54,Posthofbrug 5366,2021-10-11,21:00:00,93,34,59,FMN GV 16 Berchem TOT
54,Posthofbrug 5366,2021-10-11,22:00:00,77,33,44,FMN GV 16 Berchem TOT
54,Posthofbrug 5366,2021-10-11,23:00:00,30,7,23,FMN GV 16 Berchem TOT
54,Posthofbrug 5366,2021-10-12,00:00:00,22,2,20,FMN GV 16 Berchem TOT
54,Posthofbrug 5366,2021-10-12,01:00:00,12,6,6,FMN GV 16 Berchem TOT
54,Posthofbrug 5366,2021-10-12,02:00:00,3,0,3,FMN GV 16 Berchem TOT
54,Posthofbrug 5366,2021-10-12,03:00:00,3,0,3,FMN GV 16 Berchem TOT
54,Posthofbrug 5366,2021-10-12,04:00:00,14,9,5,FMN GV 16 Berchem TOT
54,Posthofbrug 5366,2021-10-12,05:00:00,27,16,11,FMN GV 16 Berchem TOT
54,Posthofbrug 5366,2021-10-12,06:00:00,115,96,19,FMN GV 16 Berchem TOT
54,Posthofbrug 5366,2021-10-12,07:00:00,464,336,128,FMN GV 16 Berchem TOT
54,Posthofbrug 5366,2021-10-12,08:00:00,766,580,186,FMN GV 16 Berchem TOT
54,Posthofbrug 5366,2021-10-12,09:00:00,236,175,61,FMN GV 16 Berchem TOT
54,Posthofbrug 5366,2021-10-12,10:00:00,115,78,37,FMN GV 16 Berchem TOT
54,Posthofbrug 5366,2021-10-12,11:00:00,111,63,48,FMN GV 16 Berchem TOT
54,Posthofbrug 5366,2021-10-12,12:00:00,152,81,71,FMN GV 16 Berchem TOT
54,Posthofbrug 5366,2021-10-12,13:00:00,133,59,74,FMN GV 16 Berchem TOT
54,Posthofbrug 5366,2021-10-12,14:00:00,107,51,56,FMN GV 16 Berchem TOT
54,Posthofbrug 5366,2021-10-12,15:00:00,171,56,115,FMN GV 16 Berchem TOT
54,Posthofbrug 5366,2021-10-12,16:00:00,422,130,292,FMN GV 16 Berchem TOT
54,Posthofbrug 5366,2021-10-12,17:00:00,541,183,358,FMN GV 16 Berchem TOT
54,Posthofbrug 5366,2021-10-12,18:00:00,387,121,266,FMN GV 16 Berchem TOT
54,Posthofbrug 5366,2021-10-12,19:00:00,173,71,102,FMN GV 16 Berchem TOT
54,Posthofbrug 5366,2021-10-12,20:00:00,124,50,74,FMN GV 16 Berchem TOT
54,Posthofbrug 5366,2021-10-12,21:00:00,103,52,51,FMN GV 16 Berchem TOT
54,Posthofbrug 5366,2021-10-12,22:00:00,116,49,67,FMN GV 16 Berchem TOT
54,Posthofbrug 5366,2021-10-12,23:00:00,41,17,24,FMN GV 16 Berchem TOT
54,Posthofbrug 5366,2021-10-13,00:00:00,23,7,16,FMN GV 16 Berchem TOT
54,Posthofbrug 5366,2021-10-13,01:00:00,11,3,8,FMN GV 16 Berchem TOT
54,Posthofbrug 5366,2021-10-13,02:00:00,5,1,4,FMN GV 16 Berchem TOT
54,Posthofbrug 5366,2021-10-13,03:00:00,17,3,14,FMN GV 16 Berchem TOT
54,Posthofbrug 5366,2021-10-13,04:00:00,19,10,9,FMN GV 16 Berchem TOT
54,Posthofbrug 5366,2021-10-13,05:00:00,26,11,15,FMN GV 16 Berchem TOT
54,Posthofbrug 5366,2021-10-13,06:00:00,103,90,13,FMN GV 16 Berchem TOT
54,Posthofbrug 5366,2021-10-13,07:00:00,402,281,121,FMN GV 16 Berchem TOT
54,Posthofbrug 5366,2021-10-13,08:00:00,622,456,166,FMN GV 16 Berchem TOT
54,Posthofbrug 5366,2021-10-13,09:00:00,204,158,46,FMN GV 16 Berchem TOT
54,Posthofbrug 5366,2021-10-13,10:00:00,138,86,52,FMN GV 16 Berchem TOT
54,Posthofbrug 5366,2021-10-13,11:00:00,127,69,58,FMN GV 16 Berchem TOT
54,Posthofbrug 5366,2021-10-13,12:00:00,287,125,162,FMN GV 16 Berchem TOT
54,Posthofbrug 5366,2021-10-13,13:00:00,200,93,107,FMN GV 16 Berchem TOT
54,Posthofbrug 5366,2021-10-13,14:00:00,177,84,93,FMN GV 16 Berchem TOT
54,Posthofbrug 5366,2021-10-13,15:00:00,200,73,127,FMN GV 16 Berchem TOT
54,Posthofbrug 5366,2021-10-13,16:00:00,371,146,225,FMN GV 16 Berchem TOT
54,Posthofbrug 5366,2021-10-13,17:00:00,471,148,323,FMN GV 16 Berchem TOT
54,Posthofbrug 5366,2021-10-13,18:00:00,394,156,238,FMN GV 16 Berchem TOT
54,Posthofbrug 5366,2021-10-13,19:00:00,194,94,100,FMN GV 16 Berchem TOT
54,Posthofbrug 5366,2021-10-13,20:00:00,109,50,59,FMN GV 16 Berchem TOT
54,Posthofbrug 5366,2021-10-13,21:00:00,93,38,55,FMN GV 16 Berchem TOT
54,Posthofbrug 5366,2021-10-13,22:00:00,87,37,50,FMN GV 16 Berchem TOT
54,Posthofbrug 5366,2021-10-13,23:00:00,61,15,46,FMN GV 16 Berchem TOT
54,Posthofbrug 5366,2021-10-14,00:00:00,25,8,17,FMN GV 16 Berchem TOT
54,Posthofbrug 5366,2021-10-14,01:00:00,13,3,10,FMN GV 16 Berchem TOT
54,Posthofbrug 5366,2021-10-14,02:00:00,5,1,4,FMN GV 16 Berchem TOT
54,Posthofbrug 5366,2021-10-14,03:00:00,4,1,3,FMN GV 16 Berchem TOT
54,Posthofbrug 5366,2021-10-14,04:00:00,10,8,2,FMN GV 16 Berchem TOT
54,Posthofbrug 5366,2021-10-14,05:00:00,25,14,11,FMN GV 16 Berchem TOT
54,Posthofbrug 5366,2021-10-14,06:00:00,93,76,17,FMN GV 16 Berchem TOT
54,Posthofbrug 5366,2021-10-14,07:00:00,469,338,131,FMN GV 16 Berchem TOT
54,Posthofbrug 5366,2021-10-14,08:00:00,809,628,181,FMN GV 16 Berchem TOT
54,Posthofbrug 5366,2021-10-14,09:00:00,265,198,67,FMN GV 16 Berchem TOT
54,Posthofbrug 5366,2021-10-14,10:00:00,135,89,46,FMN GV 16 Berchem TOT
54,Posthofbrug 5366,2021-10-14,11:00:00,109,70,39,FMN GV 16 Berchem TOT
54,Posthofbrug 5366,2021-10-14,12:00:00,189,108,81,FMN GV 16 Berchem TOT
54,Posthofbrug 5366,2021-10-14,13:00:00,174,85,89,FMN GV 16 Berchem TOT
54,Posthofbrug 5366,2021-10-14,14:00:00,169,79,90,FMN GV 16 Berchem TOT
54,Posthofbrug 5366,2021-10-14,15:00:00,265,89,176,FMN GV 16 Berchem TOT
54,Posthofbrug 5366,2021-10-14,16:00:00,450,127,323,FMN GV 16 Berchem TOT
54,Posthofbrug 5366,2021-10-14,17:00:00,574,184,390,FMN GV 16 Berchem TOT
54,Posthofbrug 5366,2021-10-14,18:00:00,407,132,275,FMN GV 16 Berchem TOT
54,Posthofbrug 5366,2021-10-14,19:00:00,229,102,127,FMN GV 16 Berchem TOT
54,Posthofbrug 5366,2021-10-14,20:00:00,107,55,52,FMN GV 16 Berchem TOT
54,Posthofbrug 5366,2021-10-14,21:00:00,91,41,50,FMN GV 16 Berchem TOT
54,Posthofbrug 5366,2021-10-14,22:00:00,118,46,72,FMN GV 16 Berchem TOT
54,Posthofbrug 5366,2021-10-14,23:00:00,60,19,41,FMN GV 16 Berchem TOT
54,Posthofbrug 5366,2021-10-15,00:00:00,35,11,24,FMN GV 16 Berchem TOT
54,Posthofbrug 5366,2021-10-15,01:00:00,25,8,17,FMN GV 16 Berchem TOT
54,Posthofbrug 5366,2021-10-15,02:00:00,8,3,5,FMN GV 16 Berchem TOT
54,Posthofbrug 5366,2021-10-15,03:00:00,7,0,7,FMN GV 16 Berchem TOT
54,Posthofbrug 5366,2021-10-15,04:00:00,11,6,5,FMN GV 16 Berchem TOT
54,Posthofbrug 5366,2021-10-15,05:00:00,23,11,12,FMN GV 16 Berchem TOT
54,Posthofbrug 5366,2021-10-15,06:00:00,81,71,10,FMN GV 16 Berchem TOT
54,Posthofbrug 5366,2021-10-15,07:00:00,363,244,119,FMN GV 16 Berchem TOT
54,Posthofbrug 5366,2021-10-15,08:00:00,622,470,152,FMN GV 16 Berchem TOT
54,Posthofbrug 5366,2021-10-15,09:00:00,233,189,44,FMN GV 16 Berchem TOT
54,Posthofbrug 5366,2021-10-15,10:00:00,39,10,29,FMN GV 16 Berchem TOT
54,Posthofbrug 5366,2021-10-15,11:00:00,0,0,0,FMN GV 16 Berchem TOT
54,Posthofbrug 5366,2021-10-15,12:00:00,0,0,0,FMN GV 16 Berchem TOT
54,Posthofbrug 5366,2021-10-15,13:00:00,0,0,0,FMN GV 16 Berchem TOT
54,Posthofbrug 5366,2021-10-15,14:00:00,0,0,0,FMN GV 16 Berchem TOT
54,Posthofbrug 5366,2021-10-15,15:00:00,0,0,0,FMN GV 16 Berchem TOT
54,Posthofbrug 5366,2021-10-15,16:00:00,371,137,234,FMN GV 16 Berchem TOT
54,Posthofbrug 5366,2021-10-15,17:00:00,463,178,285,FMN GV 16 Berchem TOT
54,Posthofbrug 5366,2021-10-15,18:00:00,265,119,146,FMN GV 16 Berchem TOT
54,Posthofbrug 5366,2021-10-15,19:00:00,188,107,81,FMN GV 16 Berchem TOT
54,Posthofbrug 5366,2021-10-15,20:00:00,121,61,60,FMN GV 16 Berchem TOT
54,Posthofbrug 5366,2021-10-15,21:00:00,77,31,46,FMN GV 16 Berchem TOT
54,Posthofbrug 5366,2021-10-15,22:00:00,78,29,49,FMN GV 16 Berchem TOT
54,Posthofbrug 5366,2021-10-15,23:00:00,84,24,60,FMN GV 16 Berchem TOT
54,Posthofbrug 5366,2021-10-16,00:00:00,87,11,76,FMN GV 16 Berchem TOT
54,Posthofbrug 5366,2021-10-16,01:00:00,48,12,36,FMN GV 16 Berchem TOT
54,Posthofbrug 5366,2021-10-16,02:00:00,28,4,24,FMN GV 16 Berchem TOT
54,Posthofbrug 5366,2021-10-16,03:00:00,34,5,29,FMN GV 16 Berchem TOT
54,Posthofbrug 5366,2021-10-16,04:00:00,26,3,23,FMN GV 16 Berchem TOT
54,Posthofbrug 5366,2021-10-16,05:00:00,19,8,11,FMN GV 16 Berchem TOT
54,Posthofbrug 5366,2021-10-16,06:00:00,27,17,10,FMN GV 16 Berchem TOT
54,Posthofbrug 5366,2021-10-16,07:00:00,40,25,15,FMN GV 16 Berchem TOT
54,Posthofbrug 5366,2021-10-16,08:00:00,84,47,37,FMN GV 16 Berchem TOT
54,Posthofbrug 5366,2021-10-16,09:00:00,127,87,40,FMN GV 16 Berchem TOT
54,Posthofbrug 5366,2021-10-16,10:00:00,129,81,48,FMN GV 16 Berchem TOT
54,Posthofbrug 5366,2021-10-16,11:00:00,169,97,72,FMN GV 16 Berchem TOT
54,Posthofbrug 5366,2021-10-16,12:00:00,194,100,94,FMN GV 16 Berchem TOT
54,Posthofbrug 5366,2021-10-16,13:00:00,206,121,85,FMN GV 16 Berchem TOT
54,Posthofbrug 5366,2021-10-16,14:00:00,228,115,113,FMN GV 16 Berchem TOT
54,Posthofbrug 5366,2021-10-16,15:00:00,182,89,93,FMN GV 16 Berchem TOT
54,Posthofbrug 5366,2021-10-16,16:00:00,181,63,118,FMN GV 16 Berchem TOT
54,Posthofbrug 5366,2021-10-16,17:00:00,255,112,143,FMN GV 16 Berchem TOT
54,Posthofbrug 5366,2021-10-16,18:00:00,163,84,79,FMN GV 16 Berchem TOT
54,Posthofbrug 5366,2021-10-16,19:00:00,129,70,59,FMN GV 16 Berchem TOT
54,Posthofbrug 5366,2021-10-16,20:00:00,66,39,27,FMN GV 16 Berchem TOT
54,Posthofbrug 5366,2021-10-16,21:00:00,66,37,29,FMN GV 16 Berchem TOT
54,Posthofbrug 5366,2021-10-16,22:00:00,78,53,25,FMN GV 16 Berchem TOT
54,Posthofbrug 5366,2021-10-16,23:00:00,88,29,59,FMN GV 16 Berchem TOT
54,Posthofbrug 5366,2021-10-17,00:00:00,90,32,58,FMN GV 16 Berchem TOT
54,Posthofbrug 5366,2021-10-17,01:00:00,47,16,31,FMN GV 16 Berchem TOT
54,Posthofbrug 5366,2021-10-17,02:00:00,21,8,13,FMN GV 16 Berchem TOT
54,Posthofbrug 5366,2021-10-17,03:00:00,14,7,7,FMN GV 16 Berchem TOT
54,Posthofbrug 5366,2021-10-17,04:00:00,25,0,25,FMN GV 16 Berchem TOT
54,Posthofbrug 5366,2021-10-17,05:00:00,20,8,12,FMN GV 16 Berchem TOT
54,Posthofbrug 5366,2021-10-17,06:00:00,13,10,3,FMN GV 16 Berchem TOT
54,Posthofbrug 5366,2021-10-17,07:00:00,31,15,16,FMN GV 16 Berchem TOT
54,Posthofbrug 5366,2021-10-17,08:00:00,42,22,20,FMN GV 16 Berchem TOT
54,Posthofbrug 5366,2021-10-17,09:00:00,95,54,41,FMN GV 16 Berchem TOT
54,Posthofbrug 5366,2021-10-17,10:00:00,137,86,51,FMN GV 16 Berchem TOT
54,Posthofbrug 5366,2021-10-17,11:00:00,128,62,66,FMN GV 16 Berchem TOT
54,Posthofbrug 5366,2021-10-17,12:00:00,196,104,92,FMN GV 16 Berchem TOT
54,Posthofbrug 5366,2021-10-17,13:00:00,209,127,82,FMN GV 16 Berchem TOT
54,Posthofbrug 5366,2021-10-17,14:00:00,173,99,74,FMN GV 16 Berchem TOT
54,Posthofbrug 5366,2021-10-17,15:00:00,194,109,85,FMN GV 16 Berchem TOT
54,Posthofbrug 5366,2021-10-17,16:00:00,177,94,83,FMN GV 16 Berchem TOT
54,Posthofbrug 5366,2021-10-17,17:00:00,192,81,111,FMN GV 16 Berchem TOT
54,Posthofbrug 5366,2021-10-17,18:00:00,136,64,72,FMN GV 16 Berchem TOT
54,Posthofbrug 5366,2021-10-17,19:00:00,91,39,52,FMN GV 16 Berchem TOT
54,Posthofbrug 5366,2021-10-17,20:00:00,68,33,35,FMN GV 16 Berchem TOT
54,Posthofbrug 5366,2021-10-17,21:00:00,59,24,35,FMN GV 16 Berchem TOT
54,Posthofbrug 5366,2021-10-17,22:00:00,55,22,33,FMN GV 16 Berchem TOT
54,Posthofbrug 5366,2021-10-17,23:00:00,31,5,26,FMN GV 16 Berchem TOT
54,Posthofbrug 5366,2021-10-18,00:00:00,11,4,7,FMN GV 16 Berchem TOT
54,Posthofbrug 5366,2021-10-18,01:00:00,10,1,9,FMN GV 16 Berchem TOT
54,Posthofbrug 5366,2021-10-18,02:00:00,9,0,9,FMN GV 16 Berchem TOT
54,Posthofbrug 5366,2021-10-18,03:00:00,4,1,3,FMN GV 16 Berchem TOT
54,Posthofbrug 5366,2021-10-18,04:00:00,10,9,1,FMN GV 16 Berchem TOT
54,Posthofbrug 5366,2021-10-18,05:00:00,30,20,10,FMN GV 16 Berchem TOT
54,Posthofbrug 5366,2021-10-18,06:00:00,113,95,18,FMN GV 16 Berchem TOT
54,Posthofbrug 5366,2021-10-18,07:00:00,447,341,106,FMN GV 16 Berchem TOT
54,Posthofbrug 5366,2021-10-18,08:00:00,749,567,182,FMN GV 16 Berchem TOT
54,Posthofbrug 5366,2021-10-18,09:00:00,239,185,54,FMN GV 16 Berchem TOT
54,Posthofbrug 5366,2021-10-18,10:00:00,147,110,37,FMN GV 16 Berchem TOT
54,Posthofbrug 5366,2021-10-18,11:00:00,135,84,51,FMN GV 16 Berchem TOT
54,Posthofbrug 5366,2021-10-18,12:00:00,189,114,75,FMN GV 16 Berchem TOT
54,Posthofbrug 5366,2021-10-18,13:00:00,182,89,93,FMN GV 16 Berchem TOT
54,Posthofbrug 5366,2021-10-18,14:00:00,155,61,94,FMN GV 16 Berchem TOT
54,Posthofbrug 5366,2021-10-18,15:00:00,260,97,163,FMN GV 16 Berchem TOT
54,Posthofbrug 5366,2021-10-18,16:00:00,466,140,326,FMN GV 16 Berchem TOT
54,Posthofbrug 5366,2021-10-18,17:00:00,605,161,444,FMN GV 16 Berchem TOT
54,Posthofbrug 5366,2021-10-18,18:00:00,376,109,267,FMN GV 16 Berchem TOT
54,Posthofbrug 5366,2021-10-18,19:00:00,193,83,110,FMN GV 16 Berchem TOT
54,Posthofbrug 5366,2021-10-18,20:00:00,109,54,55,FMN GV 16 Berchem TOT
54,Posthofbrug 5366,2021-10-18,21:00:00,90,29,61,FMN GV 16 Berchem TOT
54,Posthofbrug 5366,2021-10-18,22:00:00,78,29,49,FMN GV 16 Berchem TOT
54,Posthofbrug 5366,2021-10-18,23:00:00,32,13,19,FMN GV 16 Berchem TOT
54,Posthofbrug 5366,2021-10-19,00:00:00,16,5,11,FMN GV 16 Berchem TOT
54,Posthofbrug 5366,2021-10-19,01:00:00,12,3,9,FMN GV 16 Berchem TOT
54,Posthofbrug 5366,2021-10-19,02:00:00,6,4,2,FMN GV 16 Berchem TOT
54,Posthofbrug 5366,2021-10-19,03:00:00,5,1,4,FMN GV 16 Berchem TOT
54,Posthofbrug 5366,2021-10-19,04:00:00,16,8,8,FMN GV 16 Berchem TOT
54,Posthofbrug 5366,2021-10-19,05:00:00,25,14,11,FMN GV 16 Berchem TOT
54,Posthofbrug 5366,2021-10-19,06:00:00,114,95,19,FMN GV 16 Berchem TOT
54,Posthofbrug 5366,2021-10-19,07:00:00,438,322,116,FMN GV 16 Berchem TOT
54,Posthofbrug 5366,2021-10-19,08:00:00,727,555,172,FMN GV 16 Berchem TOT
54,Posthofbrug 5366,2021-10-19,09:00:00,212,170,42,FMN GV 16 Berchem TOT
54,Posthofbrug 5366,2021-10-19,10:00:00,111,80,31,FMN GV 16 Berchem TOT
54,Posthofbrug 5366,2021-10-19,11:00:00,86,55,31,FMN GV 16 Berchem TOT
54,Posthofbrug 5366,2021-10-19,12:00:00,171,92,79,FMN GV 16 Berchem TOT
54,Posthofbrug 5366,2021-10-19,13:00:00,147,87,60,FMN GV 16 Berchem TOT
54,Posthofbrug 5366,2021-10-19,14:00:00,129,51,78,FMN GV 16 Berchem TOT
54,Posthofbrug 5366,2021-10-19,15:00:00,197,71,126,FMN GV 16 Berchem TOT
54,Posthofbrug 5366,2021-10-19,16:00:00,451,144,307,FMN GV 16 Berchem TOT
54,Posthofbrug 5366,2021-10-19,17:00:00,572,168,404,FMN GV 16 Berchem TOT
54,Posthofbrug 5366,2021-10-19,18:00:00,373,115,258,FMN GV 16 Berchem TOT
54,Posthofbrug 5366,2021-10-19,19:00:00,181,70,111,FMN GV 16 Berchem TOT
54,Posthofbrug 5366,2021-10-19,20:00:00,103,41,62,FMN GV 16 Berchem TOT
54,Posthofbrug 5366,2021-10-19,21:00:00,102,53,49,FMN GV 16 Berchem TOT
54,Posthofbrug 5366,2021-10-19,22:00:00,104,40,64,FMN GV 16 Berchem TOT
54,Posthofbrug 5366,2021-10-19,23:00:00,47,16,31,FMN GV 16 Berchem TOT
54,Posthofbrug 5366,2021-10-20,00:00:00,23,3,20,FMN GV 16 Berchem TOT
54,Posthofbrug 5366,2021-10-20,01:00:00,17,8,9,FMN GV 16 Berchem TOT
54,Posthofbrug 5366,2021-10-20,02:00:00,7,1,6,FMN GV 16 Berchem TOT
54,Posthofbrug 5366,2021-10-20,03:00:00,11,3,8,FMN GV 16 Berchem TOT
54,Posthofbrug 5366,2021-10-20,04:00:00,10,8,2,FMN GV 16 Berchem TOT
54,Posthofbrug 5366,2021-10-20,05:00:00,25,15,10,FMN GV 16 Berchem TOT
54,Posthofbrug 5366,2021-10-20,06:00:00,99,77,22,FMN GV 16 Berchem TOT
54,Posthofbrug 5366,2021-10-20,07:00:00,378,268,110,FMN GV 16 Berchem TOT
54,Posthofbrug 5366,2021-10-20,08:00:00,562,413,149,FMN GV 16 Berchem TOT
54,Posthofbrug 5366,2021-10-20,09:00:00,176,131,45,FMN GV 16 Berchem TOT
54,Posthofbrug 5366,2021-10-20,10:00:00,117,78,39,FMN GV 16 Berchem TOT
54,Posthofbrug 5366,2021-10-20,11:00:00,104,60,44,FMN GV 16 Berchem TOT
54,Posthofbrug 5366,2021-10-20,12:00:00,251,106,145,FMN GV 16 Berchem TOT
54,Posthofbrug 5366,2021-10-20,13:00:00,180,81,99,FMN GV 16 Berchem TOT
54,Posthofbrug 5366,2021-10-20,14:00:00,18,10,8,FMN GV 16 Berchem TOT
54,Posthofbrug 5366,2021-10-20,15:00:00,0,0,0,FMN GV 16 Berchem TOT
54,Posthofbrug 5366,2021-10-20,16:00:00,0,0,0,FMN GV 16 Berchem TOT
54,Posthofbrug 5366,2021-10-20,17:00:00,0,0,0,FMN GV 16 Berchem TOT
54,Posthofbrug 5366,2021-10-20,18:00:00,0,0,0,FMN GV 16 Berchem TOT
54,Posthofbrug 5366,2021-10-20,19:00:00,0,0,0,FMN GV 16 Berchem TOT
54,Posthofbrug 5366,2021-10-20,20:00:00,0,0,0,FMN GV 16 Berchem TOT
54,Posthofbrug 5366,2021-10-20,21:00:00,0,0,0,FMN GV 16 Berchem TOT
54,Posthofbrug 5366,2021-10-20,22:00:00,69,21,48,FMN GV 16 Berchem TOT
54,Posthofbrug 5366,2021-10-20,23:00:00,60,17,43,FMN GV 16 Berchem TOT
54,Posthofbrug 5366,2021-10-21,00:00:00,24,4,20,FMN GV 16 Berchem TOT
54,Posthofbrug 5366,2021-10-21,01:00:00,15,3,12,FMN GV 16 Berchem TOT
54,Posthofbrug 5366,2021-10-21,02:00:00,13,0,13,FMN GV 16 Berchem TOT
54,Posthofbrug 5366,2021-10-21,03:00:00,4,0,4,FMN GV 16 Berchem TOT
54,Posthofbrug 5366,2021-10-21,04:00:00,10,5,5,FMN GV 16 Berchem TOT
54,Posthofbrug 5366,2021-10-21,05:00:00,23,11,12,FMN GV 16 Berchem TOT
54,Posthofbrug 5366,2021-10-21,06:00:00,65,54,11,FMN GV 16 Berchem TOT
54,Posthofbrug 5366,2021-10-21,07:00:00,263,200,63,FMN GV 16 Berchem TOT
54,Posthofbrug 5366,2021-10-21,08:00:00,568,432,136,FMN GV 16 Berchem TOT
54,Posthofbrug 5366,2021-10-21,09:00:00,208,157,51,FMN GV 16 Berchem TOT
54,Posthofbrug 5366,2021-10-21,10:00:00,102,70,32,FMN GV 16 Berchem TOT
54,Posthofbrug 5366,2021-10-21,11:00:00,68,39,29,FMN GV 16 Berchem TOT
54,Posthofbrug 5366,2021-10-21,12:00:00,118,64,54,FMN GV 16 Berchem TOT
54,Posthofbrug 5366,2021-10-21,13:00:00,120,50,70,FMN GV 16 Berchem TOT
54,Posthofbrug 5366,2021-10-21,14:00:00,104,44,60,FMN GV 16 Berchem TOT
54,Posthofbrug 5366,2021-10-21,15:00:00,165,60,105,FMN GV 16 Berchem TOT
54,Posthofbrug 5366,2021-10-21,16:00:00,309,100,209,FMN GV 16 Berchem TOT
54,Posthofbrug 5366,2021-10-21,17:00:00,386,121,265,FMN GV 16 Berchem TOT
54,Posthofbrug 5366,2021-10-21,18:00:00,286,107,179,FMN GV 16 Berchem TOT
54,Posthofbrug 5366,2021-10-21,19:00:00,165,77,88,FMN GV 16 Berchem TOT
54,Posthofbrug 5366,2021-10-21,20:00:00,82,43,39,FMN GV 16 Berchem TOT
54,Posthofbrug 5366,2021-10-21,21:00:00,87,47,40,FMN GV 16 Berchem TOT
54,Posthofbrug 5366,2021-10-21,22:00:00,81,30,51,FMN GV 16 Berchem TOT
54,Posthofbrug 5366,2021-10-21,23:00:00,60,19,41,FMN GV 16 Berchem TOT
54,Posthofbrug 5366,2021-10-22,00:00:00,28,3,25,FMN GV 16 Berchem TOT
54,Posthofbrug 5366,2021-10-22,01:00:00,6,3,3,FMN GV 16 Berchem TOT
54,Posthofbrug 5366,2021-10-22,02:00:00,9,0,9,FMN GV 16 Berchem TOT
54,Posthofbrug 5366,2021-10-22,03:00:00,11,1,10,FMN GV 16 Berchem TOT
54,Posthofbrug 5366,2021-10-22,04:00:00,14,8,6,FMN GV 16 Berchem TOT
54,Posthofbrug 5366,2021-10-22,05:00:00,30,22,8,FMN GV 16 Berchem TOT
54,Posthofbrug 5366,2021-10-22,06:00:00,119,99,20,FMN GV 16 Berchem TOT
54,Posthofbrug 5366,2021-10-22,07:00:00,324,238,86,FMN GV 16 Berchem TOT
54,Posthofbrug 5366,2021-10-22,08:00:00,89,62,27,FMN GV 16 Berchem TOT
54,Posthofbrug 5366,2021-10-22,09:00:00,0,0,0,FMN GV 16 Berchem TOT
54,Posthofbrug 5366,2021-10-22,10:00:00,103,56,47,FMN GV 16 Berchem TOT
54,Posthofbrug 5366,2021-10-22,11:00:00,111,65,46,FMN GV 16 Berchem TOT
54,Posthofbrug 5366,2021-10-22,12:00:00,164,84,80,FMN GV 16 Berchem TOT
54,Posthofbrug 5366,2021-10-22,13:00:00,177,96,81,FMN GV 16 Berchem TOT
54,Posthofbrug 5366,2021-10-22,14:00:00,206,55,151,FMN GV 16 Berchem TOT
54,Posthofbrug 5366,2021-10-22,15:00:00,219,77,142,FMN GV 16 Berchem TOT
54,Posthofbrug 5366,2021-10-22,16:00:00,9,3,6,FMN GV 16 Berchem TOT
54,Posthofbrug 5366,2021-10-22,17:00:00,0,0,0,FMN GV 16 Berchem TOT
54,Posthofbrug 5366,2021-10-22,18:00:00,259,115,144,FMN GV 16 Berchem TOT
54,Posthofbrug 5366,2021-10-22,19:00:00,162,87,75,FMN GV 16 Berchem TOT
54,Posthofbrug 5366,2021-10-22,20:00:00,101,63,38,FMN GV 16 Berchem TOT
54,Posthofbrug 5366,2021-10-22,21:00:00,74,32,42,FMN GV 16 Berchem TOT
54,Posthofbrug 5366,2021-10-22,22:00:00,79,33,46,FMN GV 16 Berchem TOT
54,Posthofbrug 5366,2021-10-22,23:00:00,109,38,71,FMN GV 16 Berchem TOT
54,Posthofbrug 5366,2021-10-23,00:00:00,63,21,42,FMN GV 16 Berchem TOT
54,Posthofbrug 5366,2021-10-23,01:00:00,35,6,29,FMN GV 16 Berchem TOT
54,Posthofbrug 5366,2021-10-23,02:00:00,34,3,31,FMN GV 16 Berchem TOT
54,Posthofbrug 5366,2021-10-23,03:00:00,25,3,22,FMN GV 16 Berchem TOT
54,Posthofbrug 5366,2021-10-23,04:00:00,16,2,14,FMN GV 16 Berchem TOT
54,Posthofbrug 5366,2021-10-23,05:00:00,5,2,3,FMN GV 16 Berchem TOT
54,Posthofbrug 5366,2021-10-23,06:00:00,23,14,9,FMN GV 16 Berchem TOT
54,Posthofbrug 5366,2021-10-23,07:00:00,42,15,27,FMN GV 16 Berchem TOT
54,Posthofbrug 5366,2021-10-23,08:00:00,60,36,24,FMN GV 16 Berchem TOT
54,Posthofbrug 5366,2021-10-23,09:00:00,111,80,31,FMN GV 16 Berchem TOT
54,Posthofbrug 5366,2021-10-23,10:00:00,135,86,49,FMN GV 16 Berchem TOT
54,Posthofbrug 5366,2021-10-23,11:00:00,144,90,54,FMN GV 16 Berchem TOT
54,Posthofbrug 5366,2021-10-23,12:00:00,142,92,50,FMN GV 16 Berchem TOT
54,Posthofbrug 5366,2021-10-23,13:00:00,175,99,76,FMN GV 16 Berchem TOT
54,Posthofbrug 5366,2021-10-23,14:00:00,214,108,106,FMN GV 16 Berchem TOT
54,Posthofbrug 5366,2021-10-23,15:00:00,161,85,76,FMN GV 16 Berchem TOT
54,Posthofbrug 5366,2021-10-23,16:00:00,172,83,89,FMN GV 16 Berchem TOT
54,Posthofbrug 5366,2021-10-23,17:00:00,194,90,104,FMN GV 16 Berchem TOT
54,Posthofbrug 5366,2021-10-23,18:00:00,164,87,77,FMN GV 16 Berchem TOT
54,Posthofbrug 5366,2021-10-23,19:00:00,116,63,53,FMN GV 16 Berchem TOT
54,Posthofbrug 5366,2021-10-23,20:00:00,85,52,33,FMN GV 16 Berchem TOT
54,Posthofbrug 5366,2021-10-23,21:00:00,79,48,31,FMN GV 16 Berchem TOT
54,Posthofbrug 5366,2021-10-23,22:00:00,91,47,44,FMN GV 16 Berchem TOT
54,Posthofbrug 5366,2021-10-23,23:00:00,83,32,51,FMN GV 16 Berchem TOT
54,Posthofbrug 5366,2021-10-24,00:00:00,61,12,49,FMN GV 16 Berchem TOT
54,Posthofbrug 5366,2021-10-24,01:00:00,53,29,24,FMN GV 16 Berchem TOT
54,Posthofbrug 5366,2021-10-24,02:00:00,50,14,36,FMN GV 16 Berchem TOT
54,Posthofbrug 5366,2021-10-24,03:00:00,28,6,22,FMN GV 16 Berchem TOT
54,Posthofbrug 5366,2021-10-24,04:00:00,13,3,10,FMN GV 16 Berchem TOT
54,Posthofbrug 5366,2021-10-24,05:00:00,22,10,12,FMN GV 16 Berchem TOT
54,Posthofbrug 5366,2021-10-24,06:00:00,24,13,11,FMN GV 16 Berchem TOT
54,Posthofbrug 5366,2021-10-24,07:00:00,25,15,10,FMN GV 16 Berchem TOT
54,Posthofbrug 5366,2021-10-24,08:00:00,45,30,15,FMN GV 16 Berchem TOT
54,Posthofbrug 5366,2021-10-24,09:00:00,97,59,38,FMN GV 16 Berchem TOT
54,Posthofbrug 5366,2021-10-24,10:00:00,142,93,49,FMN GV 16 Berchem TOT
54,Posthofbrug 5366,2021-10-24,11:00:00,137,70,67,FMN GV 16 Berchem TOT
54,Posthofbrug 5366,2021-10-24,12:00:00,177,99,78,FMN GV 16 Berchem TOT
54,Posthofbrug 5366,2021-10-24,13:00:00,191,94,97,FMN GV 16 Berchem TOT
54,Posthofbrug 5366,2021-10-24,14:00:00,211,108,103,FMN GV 16 Berchem TOT
54,Posthofbrug 5366,2021-10-24,15:00:00,208,103,105,FMN GV 16 Berchem TOT
54,Posthofbrug 5366,2021-10-24,16:00:00,208,82,126,FMN GV 16 Berchem TOT
54,Posthofbrug 5366,2021-10-24,17:00:00,200,88,112,FMN GV 16 Berchem TOT
54,Posthofbrug 5366,2021-10-24,18:00:00,133,61,72,FMN GV 16 Berchem TOT
54,Posthofbrug 5366,2021-10-24,19:00:00,75,37,38,FMN GV 16 Berchem TOT
54,Posthofbrug 5366,2021-10-24,20:00:00,93,40,53,FMN GV 16 Berchem TOT
54,Posthofbrug 5366,2021-10-24,21:00:00,55,26,29,FMN GV 16 Berchem TOT
54,Posthofbrug 5366,2021-10-24,22:00:00,74,38,36,FMN GV 16 Berchem TOT
54,Posthofbrug 5366,2021-10-24,23:00:00,15,4,11,FMN GV 16 Berchem TOT
54,Posthofbrug 5366,2021-10-25,00:00:00,16,5,11,FMN GV 16 Berchem TOT
54,Posthofbrug 5366,2021-10-25,01:00:00,5,0,5,FMN GV 16 Berchem TOT
54,Posthofbrug 5366,2021-10-25,02:00:00,2,0,2,FMN GV 16 Berchem TOT
54,Posthofbrug 5366,2021-10-25,03:00:00,1,1,0,FMN GV 16 Berchem TOT
54,Posthofbrug 5366,2021-10-25,04:00:00,6,5,1,FMN GV 16 Berchem TOT
54,Posthofbrug 5366,2021-10-25,05:00:00,29,18,11,FMN GV 16 Berchem TOT
54,Posthofbrug 5366,2021-10-25,06:00:00,98,89,9,FMN GV 16 Berchem TOT
54,Posthofbrug 5366,2021-10-25,07:00:00,397,307,90,FMN GV 16 Berchem TOT
54,Posthofbrug 5366,2021-10-25,08:00:00,716,530,186,FMN GV 16 Berchem TOT
54,Posthofbrug 5366,2021-10-25,09:00:00,203,151,52,FMN GV 16 Berchem TOT
54,Posthofbrug 5366,2021-10-25,10:00:00,113,79,34,FMN GV 16 Berchem TOT
54,Posthofbrug 5366,2021-10-25,11:00:00,100,57,43,FMN GV 16 Berchem TOT
54,Posthofbrug 5366,2021-10-25,12:00:00,170,100,70,FMN GV 16 Berchem TOT
54,Posthofbrug 5366,2021-10-25,13:00:00,139,72,67,FMN GV 16 Berchem TOT
54,Posthofbrug 5366,2021-10-25,14:00:00,130,56,74,FMN GV 16 Berchem TOT
54,Posthofbrug 5366,2021-10-25,15:00:00,231,83,148,FMN GV 16 Berchem TOT
54,Posthofbrug 5366,2021-10-25,16:00:00,401,104,297,FMN GV 16 Berchem TOT
54,Posthofbrug 5366,2021-10-25,17:00:00,533,167,366,FMN GV 16 Berchem TOT
54,Posthofbrug 5366,2021-10-25,18:00:00,12,6,6,FMN GV 16 Berchem TOT
54,Posthofbrug 5366,2021-10-25,19:00:00,0,0,0,FMN GV 16 Berchem TOT
54,Posthofbrug 5366,2021-10-25,20:00:00,0,0,0,FMN GV 16 Berchem TOT
54,Posthofbrug 5366,2021-10-25,21:00:00,0,0,0,FMN GV 16 Berchem TOT
54,Posthofbrug 5366,2021-10-25,22:00:00,55,20,35,FMN GV 16 Berchem TOT
54,Posthofbrug 5366,2021-10-25,23:00:00,33,14,19,FMN GV 16 Berchem TOT
54,Posthofbrug 5366,2021-10-26,00:00:00,16,8,8,FMN GV 16 Berchem TOT
54,Posthofbrug 5366,2021-10-26,01:00:00,5,1,4,FMN GV 16 Berchem TOT
54,Posthofbrug 5366,2021-10-26,02:00:00,0,0,0,FMN GV 16 Berchem TOT
54,Posthofbrug 5366,2021-10-26,03:00:00,3,0,3,FMN GV 16 Berchem TOT
54,Posthofbrug 5366,2021-10-26,04:00:00,9,7,2,FMN GV 16 Berchem TOT
54,Posthofbrug 5366,2021-10-26,05:00:00,26,16,10,FMN GV 16 Berchem TOT
54,Posthofbrug 5366,2021-10-26,06:00:00,129,105,24,FMN GV 16 Berchem TOT
54,Posthofbrug 5366,2021-10-26,07:00:00,487,356,131,FMN GV 16 Berchem TOT
54,Posthofbrug 5366,2021-10-26,08:00:00,729,554,175,FMN GV 16 Berchem TOT
54,Posthofbrug 5366,2021-10-26,09:00:00,207,158,49,FMN GV 16 Berchem TOT
54,Posthofbrug 5366,2021-10-26,10:00:00,132,92,40,FMN GV 16 Berchem TOT
54,Posthofbrug 5366,2021-10-26,11:00:00,107,55,52,FMN GV 16 Berchem TOT
54,Posthofbrug 5366,2021-10-26,12:00:00,172,95,77,FMN GV 16 Berchem TOT
54,Posthofbrug 5366,2021-10-26,13:00:00,169,87,82,FMN GV 16 Berchem TOT
54,Posthofbrug 5366,2021-10-26,14:00:00,124,53,71,FMN GV 16 Berchem TOT
54,Posthofbrug 5366,2021-10-26,15:00:00,251,90,161,FMN GV 16 Berchem TOT
54,Posthofbrug 5366,2021-10-26,16:00:00,468,146,322,FMN GV 16 Berchem TOT
54,Posthofbrug 5366,2021-10-26,17:00:00,610,195,415,FMN GV 16 Berchem TOT
54,Posthofbrug 5366,2021-10-26,18:00:00,18,9,9,FMN GV 16 Berchem TOT
54,Posthofbrug 5366,2021-10-26,19:00:00,0,0,0,FMN GV 16 Berchem TOT
54,Posthofbrug 5366,2021-10-26,20:00:00,111,41,70,FMN GV 16 Berchem TOT
54,Posthofbrug 5366,2021-10-26,21:00:00,110,60,50,FMN GV 16 Berchem TOT
54,Posthofbrug 5366,2021-10-26,22:00:00,113,35,78,FMN GV 16 Berchem TOT
54,Posthofbrug 5366,2021-10-26,23:00:00,56,18,38,FMN GV 16 Berchem TOT
54,Posthofbrug 5366,2021-10-27,00:00:00,17,6,11,FMN GV 16 Berchem TOT
54,Posthofbrug 5366,2021-10-27,01:00:00,18,6,12,FMN GV 16 Berchem TOT
54,Posthofbrug 5366,2021-10-27,02:00:00,8,0,8,FMN GV 16 Berchem TOT
54,Posthofbrug 5366,2021-10-27,03:00:00,4,2,2,FMN GV 16 Berchem TOT
54,Posthofbrug 5366,2021-10-27,04:00:00,7,4,3,FMN GV 16 Berchem TOT
54,Posthofbrug 5366,2021-10-27,05:00:00,32,15,17,FMN GV 16 Berchem TOT
54,Posthofbrug 5366,2021-10-27,06:00:00,114,97,17,FMN GV 16 Berchem TOT
54,Posthofbrug 5366,2021-10-27,07:00:00,432,305,127,FMN GV 16 Berchem TOT
54,Posthofbrug 5366,2021-10-27,08:00:00,607,446,161,FMN GV 16 Berchem TOT
54,Posthofbrug 5366,2021-10-27,09:00:00,205,157,48,FMN GV 16 Berchem TOT
54,Posthofbrug 5366,2021-10-27,10:00:00,134,89,45,FMN GV 16 Berchem TOT
54,Posthofbrug 5366,2021-10-27,11:00:00,126,61,65,FMN GV 16 Berchem TOT
54,Posthofbrug 5366,2021-10-27,12:00:00,282,137,145,FMN GV 16 Berchem TOT
54,Posthofbrug 5366,2021-10-27,13:00:00,225,104,121,FMN GV 16 Berchem TOT
54,Posthofbrug 5366,2021-10-27,14:00:00,178,87,91,FMN GV 16 Berchem TOT
54,Posthofbrug 5366,2021-10-27,15:00:00,205,88,117,FMN GV 16 Berchem TOT
54,Posthofbrug 5366,2021-10-27,16:00:00,359,118,241,FMN GV 16 Berchem TOT
54,Posthofbrug 5366,2021-10-27,17:00:00,528,184,344,FMN GV 16 Berchem TOT
54,Posthofbrug 5366,2021-10-27,18:00:00,351,141,210,FMN GV 16 Berchem TOT
54,Posthofbrug 5366,2021-10-27,19:00:00,197,83,114,FMN GV 16 Berchem TOT
54,Posthofbrug 5366,2021-10-27,20:00:00,116,58,58,FMN GV 16 Berchem TOT
54,Posthofbrug 5366,2021-10-27,21:00:00,85,40,45,FMN GV 16 Berchem TOT
54,Posthofbrug 5366,2021-10-27,22:00:00,129,34,95,FMN GV 16 Berchem TOT
54,Posthofbrug 5366,2021-10-27,23:00:00,59,16,43,FMN GV 16 Berchem TOT
54,Posthofbrug 5366,2021-10-28,00:00:00,26,5,21,FMN GV 16 Berchem TOT
54,Posthofbrug 5366,2021-10-28,01:00:00,21,11,10,FMN GV 16 Berchem TOT
54,Posthofbrug 5366,2021-10-28,02:00:00,4,2,2,FMN GV 16 Berchem TOT
54,Posthofbrug 5366,2021-10-28,03:00:00,5,0,5,FMN GV 16 Berchem TOT
54,Posthofbrug 5366,2021-10-28,04:00:00,7,4,3,FMN GV 16 Berchem TOT
54,Posthofbrug 5366,2021-10-28,05:00:00,26,15,11,FMN GV 16 Berchem TOT
54,Posthofbrug 5366,2021-10-28,06:00:00,115,95,20,FMN GV 16 Berchem TOT
54,Posthofbrug 5366,2021-10-28,07:00:00,422,319,103,FMN GV 16 Berchem TOT
54,Posthofbrug 5366,2021-10-28,08:00:00,682,525,157,FMN GV 16 Berchem TOT
54,Posthofbrug 5366,2021-10-28,09:00:00,253,197,56,FMN GV 16 Berchem TOT
54,Posthofbrug 5366,2021-10-28,10:00:00,159,99,60,FMN GV 16 Berchem TOT
54,Posthofbrug 5366,2021-10-28,11:00:00,116,76,40,FMN GV 16 Berchem TOT
54,Posthofbrug 5366,2021-10-28,12:00:00,216,125,91,FMN GV 16 Berchem TOT
54,Posthofbrug 5366,2021-10-28,13:00:00,217,121,96,FMN GV 16 Berchem TOT
54,Posthofbrug 5366,2021-10-28,14:00:00,2,1,1,FMN GV 16 Berchem TOT
54,Posthofbrug 5366,2021-10-28,15:00:00,0,0,0,FMN GV 16 Berchem TOT
54,Posthofbrug 5366,2021-10-28,16:00:00,0,0,0,FMN GV 16 Berchem TOT
54,Posthofbrug 5366,2021-10-28,17:00:00,0,0,0,FMN GV 16 Berchem TOT
54,Posthofbrug 5366,2021-10-28,18:00:00,0,0,0,FMN GV 16 Berchem TOT
54,Posthofbrug 5366,2021-10-28,19:00:00,0,0,0,FMN GV 16 Berchem TOT
54,Posthofbrug 5366,2021-10-28,20:00:00,106,47,59,FMN GV 16 Berchem TOT
54,Posthofbrug 5366,2021-10-28,21:00:00,107,42,65,FMN GV 16 Berchem TOT
54,Posthofbrug 5366,2021-10-28,22:00:00,116,52,64,FMN GV 16 Berchem TOT
54,Posthofbrug 5366,2021-10-28,23:00:00,93,36,57,FMN GV 16 Berchem TOT
54,Posthofbrug 5366,2021-10-29,00:00:00,44,13,31,FMN GV 16 Berchem TOT
54,Posthofbrug 5366,2021-10-29,01:00:00,11,5,6,FMN GV 16 Berchem TOT
54,Posthofbrug 5366,2021-10-29,02:00:00,18,6,12,FMN GV 16 Berchem TOT
54,Posthofbrug 5366,2021-10-29,03:00:00,14,1,13,FMN GV 16 Berchem TOT
54,Posthofbrug 5366,2021-10-29,04:00:00,13,7,6,FMN GV 16 Berchem TOT
54,Posthofbrug 5366,2021-10-29,05:00:00,22,12,10,FMN GV 16 Berchem TOT
54,Posthofbrug 5366,2021-10-29,06:00:00,96,76,20,FMN GV 16 Berchem TOT
54,Posthofbrug 5366,2021-10-29,07:00:00,314,218,96,FMN GV 16 Berchem TOT
54,Posthofbrug 5366,2021-10-29,08:00:00,578,427,151,FMN GV 16 Berchem TOT
54,Posthofbrug 5366,2021-10-29,09:00:00,211,164,47,FMN GV 16 Berchem TOT
54,Posthofbrug 5366,2021-10-29,10:00:00,167,114,53,FMN GV 16 Berchem TOT
54,Posthofbrug 5366,2021-10-29,11:00:00,140,81,59,FMN GV 16 Berchem TOT
54,Posthofbrug 5366,2021-10-29,12:00:00,201,105,96,FMN GV 16 Berchem TOT
54,Posthofbrug 5366,2021-10-29,13:00:00,144,60,84,FMN GV 16 Berchem TOT
54,Posthofbrug 5366,2021-10-29,14:00:00,171,66,105,FMN GV 16 Berchem TOT
54,Posthofbrug 5366,2021-10-29,15:00:00,270,90,180,FMN GV 16 Berchem TOT
54,Posthofbrug 5366,2021-10-29,16:00:00,381,120,261,FMN GV 16 Berchem TOT
54,Posthofbrug 5366,2021-10-29,17:00:00,337,114,223,FMN GV 16 Berchem TOT
54,Posthofbrug 5366,2021-10-29,18:00:00,305,132,173,FMN GV 16 Berchem TOT
54,Posthofbrug 5366,2021-10-29,19:00:00,152,61,91,FMN GV 16 Berchem TOT
54,Posthofbrug 5366,2021-10-29,20:00:00,104,56,48,FMN GV 16 Berchem TOT
54,Posthofbrug 5366,2021-10-29,21:00:00,66,35,31,FMN GV 16 Berchem TOT
54,Posthofbrug 5366,2021-10-29,22:00:00,76,28,48,FMN GV 16 Berchem TOT
54,Posthofbrug 5366,2021-10-29,23:00:00,73,33,40,FMN GV 16 Berchem TOT
54,Posthofbrug 5366,2021-10-30,00:00:00,70,20,50,FMN GV 16 Berchem TOT
54,Posthofbrug 5366,2021-10-30,01:00:00,39,11,28,FMN GV 16 Berchem TOT
54,Posthofbrug 5366,2021-10-30,02:00:00,37,13,24,FMN GV 16 Berchem TOT
54,Posthofbrug 5366,2021-10-30,03:00:00,26,4,22,FMN GV 16 Berchem TOT
54,Posthofbrug 5366,2021-10-30,04:00:00,17,6,11,FMN GV 16 Berchem TOT
54,Posthofbrug 5366,2021-10-30,05:00:00,26,12,14,FMN GV 16 Berchem TOT
54,Posthofbrug 5366,2021-10-30,06:00:00,18,12,6,FMN GV 16 Berchem TOT
54,Posthofbrug 5366,2021-10-30,07:00:00,24,12,12,FMN GV 16 Berchem TOT
54,Posthofbrug 5366,2021-10-30,08:00:00,32,25,7,FMN GV 16 Berchem TOT
54,Posthofbrug 5366,2021-10-30,09:00:00,72,53,19,FMN GV 16 Berchem TOT
54,Posthofbrug 5366,2021-10-30,10:00:00,62,33,29,FMN GV 16 Berchem TOT
54,Posthofbrug 5366,2021-10-30,11:00:00,62,39,23,FMN GV 16 Berchem TOT
54,Posthofbrug 5366,2021-10-30,12:00:00,68,42,26,FMN GV 16 Berchem TOT
54,Posthofbrug 5366,2021-10-30,13:00:00,81,43,38,FMN GV 16 Berchem TOT
54,Posthofbrug 5366,2021-10-30,14:00:00,88,52,36,FMN GV 16 Berchem TOT
54,Posthofbrug 5366,2021-10-30,15:00:00,91,53,38,FMN GV 16 Berchem TOT
54,Posthofbrug 5366,2021-10-30,16:00:00,103,51,52,FMN GV 16 Berchem TOT
54,Posthofbrug 5366,2021-10-30,17:00:00,79,25,54,FMN GV 16 Berchem TOT
54,Posthofbrug 5366,2021-10-30,18:00:00,72,35,37,FMN GV 16 Berchem TOT
54,Posthofbrug 5366,2021-10-30,19:00:00,67,31,36,FMN GV 16 Berchem TOT
54,Posthofbrug 5366,2021-10-30,20:00:00,53,32,21,FMN GV 16 Berchem TOT
54,Posthofbrug 5366,2021-10-30,21:00:00,32,19,13,FMN GV 16 Berchem TOT
54,Posthofbrug 5366,2021-10-30,22:00:00,51,26,25,FMN GV 16 Berchem TOT
54,Posthofbrug 5366,2021-10-30,23:00:00,42,16,26,FMN GV 16 Berchem TOT
54,Posthofbrug 5366,2021-10-31,00:00:00,54,27,27,FMN GV 16 Berchem TOT
54,Posthofbrug 5366,2021-10-31,01:00:00,34,17,17,FMN GV 16 Berchem TOT
54,Posthofbrug 5366,2021-10-31,02:00:00,50,11,39,FMN GV 16 Berchem TOT
54,Posthofbrug 5366,2021-10-31,03:00:00,14,3,11,FMN GV 16 Berchem TOT
54,Posthofbrug 5366,2021-10-31,04:00:00,13,2,11,FMN GV 16 Berchem TOT
54,Posthofbrug 5366,2021-10-31,05:00:00,10,5,5,FMN GV 16 Berchem TOT
54,Posthofbrug 5366,2021-10-31,06:00:00,15,9,6,FMN GV 16 Berchem TOT
54,Posthofbrug 5366,2021-10-31,07:00:00,17,11,6,FMN GV 16 Berchem TOT
54,Posthofbrug 5366,2021-10-31,08:00:00,49,22,27,FMN GV 16 Berchem TOT
54,Posthofbrug 5366,2021-10-31,09:00:00,74,48,26,FMN GV 16 Berchem TOT
54,Posthofbrug 5366,2021-10-31,10:00:00,97,61,36,FMN GV 16 Berchem TOT
54,Posthofbrug 5366,2021-10-31,11:00:00,117,60,57,FMN GV 16 Berchem TOT
54,Posthofbrug 5366,2021-10-31,12:00:00,122,74,48,FMN GV 16 Berchem TOT
54,Posthofbrug 5366,2021-10-31,13:00:00,104,55,49,FMN GV 16 Berchem TOT
54,Posthofbrug 5366,2021-10-31,14:00:00,99,58,41,FMN GV 16 Berchem TOT
54,Posthofbrug 5366,2021-10-31,15:00:00,61,26,35,FMN GV 16 Berchem TOT
54,Posthofbrug 5366,2021-10-31,16:00:00,63,18,45,FMN GV 16 Berchem TOT
54,Posthofbrug 5366,2021-10-31,17:00:00,45,21,24,FMN GV 16 Berchem TOT
54,Posthofbrug 5366,2021-10-31,18:00:00,60,22,38,FMN GV 16 Berchem TOT
54,Posthofbrug 5366,2021-10-31,19:00:00,52,32,20,FMN GV 16 Berchem TOT
54,Posthofbrug 5366,2021-10-31,20:00:00,60,41,19,FMN GV 16 Berchem TOT
54,Posthofbrug 5366,2021-10-31,21:00:00,50,26,24,FMN GV 16 Berchem TOT
54,Posthofbrug 5366,2021-10-31,22:00:00,49,27,22,FMN GV 16 Berchem TOT
54,Posthofbrug 5366,2021-10-31,23:00:00,20,7,13,FMN GV 16 Berchem TOT
54,Posthofbrug 5366,2021-11-01,00:00:00,40,25,15,FMN GV 16 Berchem TOT
54,Posthofbrug 5366,2021-11-01,01:00:00,21,12,9,FMN GV 16 Berchem TOT
54,Posthofbrug 5366,2021-11-01,02:00:00,42,10,32,FMN GV 16 Berchem TOT
54,Posthofbrug 5366,2021-11-01,03:00:00,18,3,15,FMN GV 16 Berchem TOT
54,Posthofbrug 5366,2021-11-01,04:00:00,23,4,19,FMN GV 16 Berchem TOT
54,Posthofbrug 5366,2021-11-01,05:00:00,29,11,18,FMN GV 16 Berchem TOT
54,Posthofbrug 5366,2021-11-01,06:00:00,26,14,12,FMN GV 16 Berchem TOT
54,Posthofbrug 5366,2021-11-01,07:00:00,48,19,29,FMN GV 16 Berchem TOT
54,Posthofbrug 5366,2021-11-01,08:00:00,36,27,9,FMN GV 16 Berchem TOT
54,Posthofbrug 5366,2021-11-01,09:00:00,67,45,22,FMN GV 16 Berchem TOT
54,Posthofbrug 5366,2021-11-01,10:00:00,71,45,26,FMN GV 16 Berchem TOT
54,Posthofbrug 5366,2021-11-01,11:00:00,100,50,50,FMN GV 16 Berchem TOT
54,Posthofbrug 5366,2021-11-01,12:00:00,72,31,41,FMN GV 16 Berchem TOT
54,Posthofbrug 5366,2021-11-01,13:00:00,81,46,35,FMN GV 16 Berchem TOT
54,Posthofbrug 5366,2021-11-01,14:00:00,102,44,58,FMN GV 16 Berchem TOT
54,Posthofbrug 5366,2021-11-01,15:00:00,106,45,61,FMN GV 16 Berchem TOT
54,Posthofbrug 5366,2021-11-01,16:00:00,62,30,32,FMN GV 16 Berchem TOT
54,Posthofbrug 5366,2021-11-01,17:00:00,64,34,30,FMN GV 16 Berchem TOT
54,Posthofbrug 5366,2021-11-01,18:00:00,76,35,41,FMN GV 16 Berchem TOT
54,Posthofbrug 5366,2021-11-01,19:00:00,53,27,26,FMN GV 16 Berchem TOT
54,Posthofbrug 5366,2021-11-01,20:00:00,40,27,13,FMN GV 16 Berchem TOT
54,Posthofbrug 5366,2021-11-01,21:00:00,34,19,15,FMN GV 16 Berchem TOT
54,Posthofbrug 5366,2021-11-01,22:00:00,51,24,27,FMN GV 16 Berchem TOT
54,Posthofbrug 5366,2021-11-01,23:00:00,24,7,17,FMN GV 16 Berchem TOT
54,Posthofbrug 5366,2021-11-02,00:00:00,13,4,9,FMN GV 16 Berchem TOT
54,Posthofbrug 5366,2021-11-02,01:00:00,6,2,4,FMN GV 16 Berchem TOT
54,Posthofbrug 5366,2021-11-02,02:00:00,1,0,1,FMN GV 16 Berchem TOT
54,Posthofbrug 5366,2021-11-02,03:00:00,2,1,1,FMN GV 16 Berchem TOT
54,Posthofbrug 5366,2021-11-02,04:00:00,12,10,2,FMN GV 16 Berchem TOT
54,Posthofbrug 5366,2021-11-02,05:00:00,22,11,11,FMN GV 16 Berchem TOT
54,Posthofbrug 5366,2021-11-02,06:00:00,61,49,12,FMN GV 16 Berchem TOT
54,Posthofbrug 5366,2021-11-02,07:00:00,174,129,45,FMN GV 16 Berchem TOT
54,Posthofbrug 5366,2021-11-02,08:00:00,289,207,82,FMN GV 16 Berchem TOT
54,Posthofbrug 5366,2021-11-02,09:00:00,145,105,40,FMN GV 16 Berchem TOT
54,Posthofbrug 5366,2021-11-02,10:00:00,62,43,19,FMN GV 16 Berchem TOT
54,Posthofbrug 5366,2021-11-02,11:00:00,65,43,22,FMN GV 16 Berchem TOT
54,Posthofbrug 5366,2021-11-02,12:00:00,88,48,40,FMN GV 16 Berchem TOT
54,Posthofbrug 5366,2021-11-02,13:00:00,80,43,37,FMN GV 16 Berchem TOT
54,Posthofbrug 5366,2021-11-02,14:00:00,87,43,44,FMN GV 16 Berchem TOT
54,Posthofbrug 5366,2021-11-02,15:00:00,123,50,73,FMN GV 16 Berchem TOT
54,Posthofbrug 5366,2021-11-02,16:00:00,189,77,112,FMN GV 16 Berchem TOT
54,Posthofbrug 5366,2021-11-02,17:00:00,320,115,205,FMN GV 16 Berchem TOT
54,Posthofbrug 5366,2021-11-02,18:00:00,193,69,124,FMN GV 16 Berchem TOT
54,Posthofbrug 5366,2021-11-02,19:00:00,143,65,78,FMN GV 16 Berchem TOT
54,Posthofbrug 5366,2021-11-02,20:00:00,66,25,41,FMN GV 16 Berchem TOT
54,Posthofbrug 5366,2021-11-02,21:00:00,49,29,20,FMN GV 16 Berchem TOT
54,Posthofbrug 5366,2021-11-02,22:00:00,56,18,38,FMN GV 16 Berchem TOT
54,Posthofbrug 5366,2021-11-02,23:00:00,38,9,29,FMN GV 16 Berchem TOT
54,Posthofbrug 5366,2021-11-03,00:00:00,20,6,14,FMN GV 16 Berchem TOT
54,Posthofbrug 5366,2021-11-03,01:00:00,14,6,8,FMN GV 16 Berchem TOT
54,Posthofbrug 5366,2021-11-03,02:00:00,5,3,2,FMN GV 16 Berchem TOT
54,Posthofbrug 5366,2021-11-03,03:00:00,4,2,2,FMN GV 16 Berchem TOT
54,Posthofbrug 5366,2021-11-03,04:00:00,14,11,3,FMN GV 16 Berchem TOT
54,Posthofbrug 5366,2021-11-03,05:00:00,19,13,6,FMN GV 16 Berchem TOT
54,Posthofbrug 5366,2021-11-03,06:00:00,75,59,16,FMN GV 16 Berchem TOT
54,Posthofbrug 5366,2021-11-03,07:00:00,226,164,62,FMN GV 16 Berchem TOT
54,Posthofbrug 5366,2021-11-03,08:00:00,362,258,104,FMN GV 16 Berchem TOT
54,Posthofbrug 5366,2021-11-03,09:00:00,172,132,40,FMN GV 16 Berchem TOT
54,Posthofbrug 5366,2021-11-03,10:00:00,113,73,40,FMN GV 16 Berchem TOT
54,Posthofbrug 5366,2021-11-03,11:00:00,103,59,44,FMN GV 16 Berchem TOT
54,Posthofbrug 5366,2021-11-03,12:00:00,136,75,61,FMN GV 16 Berchem TOT
54,Posthofbrug 5366,2021-11-03,13:00:00,139,86,53,FMN GV 16 Berchem TOT
54,Posthofbrug 5366,2021-11-03,14:00:00,143,66,77,FMN GV 16 Berchem TOT
54,Posthofbrug 5366,2021-11-03,15:00:00,166,70,96,FMN GV 16 Berchem TOT
54,Posthofbrug 5366,2021-11-03,16:00:00,270,94,176,FMN GV 16 Berchem TOT
54,Posthofbrug 5366,2021-11-03,17:00:00,335,112,223,FMN GV 16 Berchem TOT
54,Posthofbrug 5366,2021-11-03,18:00:00,237,98,139,FMN GV 16 Berchem TOT
54,Posthofbrug 5366,2021-11-03,19:00:00,111,40,71,FMN GV 16 Berchem TOT
54,Posthofbrug 5366,2021-11-03,20:00:00,97,44,53,FMN GV 16 Berchem TOT
54,Posthofbrug 5366,2021-11-03,21:00:00,55,28,27,FMN GV 16 Berchem TOT
54,Posthofbrug 5366,2021-11-03,22:00:00,83,33,50,FMN GV 16 Berchem TOT
54,Posthofbrug 5366,2021-11-03,23:00:00,34,12,22,FMN GV 16 Berchem TOT
54,Posthofbrug 5366,2021-11-04,00:00:00,25,2,23,FMN GV 16 Berchem TOT
54,Posthofbrug 5366,2021-11-04,01:00:00,13,7,6,FMN GV 16 Berchem TOT
54,Posthofbrug 5366,2021-11-04,02:00:00,7,1,6,FMN GV 16 Berchem TOT
54,Posthofbrug 5366,2021-11-04,03:00:00,6,1,5,FMN GV 16 Berchem TOT
54,Posthofbrug 5366,2021-11-04,04:00:00,10,7,3,FMN GV 16 Berchem TOT
54,Posthofbrug 5366,2021-11-04,05:00:00,28,15,13,FMN GV 16 Berchem TOT
54,Posthofbrug 5366,2021-11-04,06:00:00,67,51,16,FMN GV 16 Berchem TOT
54,Posthofbrug 5366,2021-11-04,07:00:00,221,166,55,FMN GV 16 Berchem TOT
54,Posthofbrug 5366,2021-11-04,08:00:00,367,257,110,FMN GV 16 Berchem TOT
54,Posthofbrug 5366,2021-11-04,09:00:00,175,131,44,FMN GV 16 Berchem TOT
54,Posthofbrug 5366,2021-11-04,10:00:00,84,57,27,FMN GV 16 Berchem TOT
54,Posthofbrug 5366,2021-11-04,11:00:00,97,64,33,FMN GV 16 Berchem TOT
54,Posthofbrug 5366,2021-11-04,12:00:00,114,61,53,FMN GV 16 Berchem TOT
54,Posthofbrug 5366,2021-11-04,13:00:00,73,44,29,FMN GV 16 Berchem TOT
54,Posthofbrug 5366,2021-11-04,14:00:00,86,32,54,FMN GV 16 Berchem TOT
54,Posthofbrug 5366,2021-11-04,15:00:00,135,55,80,FMN GV 16 Berchem TOT
54,Posthofbrug 5366,2021-11-04,16:00:00,228,85,143,FMN GV 16 Berchem TOT
54,Posthofbrug 5366,2021-11-04,17:00:00,338,112,226,FMN GV 16 Berchem TOT
54,Posthofbrug 5366,2021-11-04,18:00:00,215,66,149,FMN GV 16 Berchem TOT
54,Posthofbrug 5366,2021-11-04,19:00:00,125,68,57,FMN GV 16 Berchem TOT
54,Posthofbrug 5366,2021-11-04,20:00:00,74,33,41,FMN GV 16 Berchem TOT
54,Posthofbrug 5366,2021-11-04,21:00:00,56,31,25,FMN GV 16 Berchem TOT
54,Posthofbrug 5366,2021-11-04,22:00:00,56,22,34,FMN GV 16 Berchem TOT
54,Posthofbrug 5366,2021-11-04,23:00:00,63,19,44,FMN GV 16 Berchem TOT
54,Posthofbrug 5366,2021-11-05,00:00:00,31,9,22,FMN GV 16 Berchem TOT
54,Posthofbrug 5366,2021-11-05,01:00:00,18,6,12,FMN GV 16 Berchem TOT
54,Posthofbrug 5366,2021-11-05,02:00:00,15,1,14,FMN GV 16 Berchem TOT
54,Posthofbrug 5366,2021-11-05,03:00:00,11,3,8,FMN GV 16 Berchem TOT
54,Posthofbrug 5366,2021-11-05,04:00:00,17,10,7,FMN GV 16 Berchem TOT
54,Posthofbrug 5366,2021-11-05,05:00:00,23,13,10,FMN GV 16 Berchem TOT
54,Posthofbrug 5366,2021-11-05,06:00:00,60,46,14,FMN GV 16 Berchem TOT
54,Posthofbrug 5366,2021-11-05,07:00:00,175,114,61,FMN GV 16 Berchem TOT
54,Posthofbrug 5366,2021-11-05,08:00:00,309,225,84,FMN GV 16 Berchem TOT
54,Posthofbrug 5366,2021-11-05,09:00:00,174,130,44,FMN GV 16 Berchem TOT
54,Posthofbrug 5366,2021-11-05,10:00:00,118,83,35,FMN GV 16 Berchem TOT
54,Posthofbrug 5366,2021-11-05,11:00:00,104,65,39,FMN GV 16 Berchem TOT
54,Posthofbrug 5366,2021-11-05,12:00:00,134,77,57,FMN GV 16 Berchem TOT
54,Posthofbrug 5366,2021-11-05,13:00:00,134,64,70,FMN GV 16 Berchem TOT
54,Posthofbrug 5366,2021-11-05,14:00:00,121,62,59,FMN GV 16 Berchem TOT
54,Posthofbrug 5366,2021-11-05,15:00:00,149,59,90,FMN GV 16 Berchem TOT
54,Posthofbrug 5366,2021-11-05,16:00:00,221,94,127,FMN GV 16 Berchem TOT
54,Posthofbrug 5366,2021-11-05,17:00:00,330,118,212,FMN GV 16 Berchem TOT
54,Posthofbrug 5366,2021-11-05,18:00:00,215,92,123,FMN GV 16 Berchem TOT
54,Posthofbrug 5366,2021-11-05,19:00:00,157,91,66,FMN GV 16 Berchem TOT
54,Posthofbrug 5366,2021-11-05,20:00:00,87,50,37,FMN GV 16 Berchem TOT
54,Posthofbrug 5366,2021-11-05,21:00:00,59,37,22,FMN GV 16 Berchem TOT
54,Posthofbrug 5366,2021-11-05,22:00:00,59,25,34,FMN GV 16 Berchem TOT
54,Posthofbrug 5366,2021-11-05,23:00:00,78,13,65,FMN GV 16 Berchem TOT
54,Posthofbrug 5366,2021-11-06,00:00:00,56,11,45,FMN GV 16 Berchem TOT
54,Posthofbrug 5366,2021-11-06,01:00:00,28,4,24,FMN GV 16 Berchem TOT
54,Posthofbrug 5366,2021-11-06,02:00:00,29,5,24,FMN GV 16 Berchem TOT
54,Posthofbrug 5366,2021-11-06,03:00:00,25,5,20,FMN GV 16 Berchem TOT
54,Posthofbrug 5366,2021-11-06,04:00:00,13,5,8,FMN GV 16 Berchem TOT
54,Posthofbrug 5366,2021-11-06,05:00:00,16,10,6,FMN GV 16 Berchem TOT
54,Posthofbrug 5366,2021-11-06,06:00:00,17,8,9,FMN GV 16 Berchem TOT
54,Posthofbrug 5366,2021-11-06,07:00:00,33,22,11,FMN GV 16 Berchem TOT
54,Posthofbrug 5366,2021-11-06,08:00:00,70,40,30,FMN GV 16 Berchem TOT
54,Posthofbrug 5366,2021-11-06,09:00:00,90,59,31,FMN GV 16 Berchem TOT
54,Posthofbrug 5366,2021-11-06,10:00:00,126,94,32,FMN GV 16 Berchem TOT
54,Posthofbrug 5366,2021-11-06,11:00:00,118,80,38,FMN GV 16 Berchem TOT
54,Posthofbrug 5366,2021-11-06,12:00:00,142,83,59,FMN GV 16 Berchem TOT
54,Posthofbrug 5366,2021-11-06,13:00:00,149,88,61,FMN GV 16 Berchem TOT
54,Posthofbrug 5366,2021-11-06,14:00:00,145,70,75,FMN GV 16 Berchem TOT
54,Posthofbrug 5366,2021-11-06,15:00:00,159,80,79,FMN GV 16 Berchem TOT
54,Posthofbrug 5366,2021-11-06,16:00:00,127,42,85,FMN GV 16 Berchem TOT
54,Posthofbrug 5366,2021-11-06,17:00:00,140,58,82,FMN GV 16 Berchem TOT
54,Posthofbrug 5366,2021-11-06,18:00:00,109,70,39,FMN GV 16 Berchem TOT
54,Posthofbrug 5366,2021-11-06,19:00:00,85,36,49,FMN GV 16 Berchem TOT
54,Posthofbrug 5366,2021-11-06,20:00:00,73,38,35,FMN GV 16 Berchem TOT
54,Posthofbrug 5366,2021-11-06,21:00:00,43,21,22,FMN GV 16 Berchem TOT
54,Posthofbrug 5366,2021-11-06,22:00:00,54,19,35,FMN GV 16 Berchem TOT
54,Posthofbrug 5366,2021-11-06,23:00:00,60,15,45,FMN GV 16 Berchem TOT
54,Posthofbrug 5366,2021-11-07,00:00:00,32,7,25,FMN GV 16 Berchem TOT
54,Posthofbrug 5366,2021-11-07,01:00:00,44,18,26,FMN GV 16 Berchem TOT
54,Posthofbrug 5366,2021-11-07,02:00:00,31,5,26,FMN GV 16 Berchem TOT
54,Posthofbrug 5366,2021-11-07,03:00:00,9,3,6,FMN GV 16 Berchem TOT
54,Posthofbrug 5366,2021-11-07,04:00:00,19,6,13,FMN GV 16 Berchem TOT
54,Posthofbrug 5366,2021-11-07,05:00:00,10,3,7,FMN GV 16 Berchem TOT
54,Posthofbrug 5366,2021-11-07,06:00:00,13,10,3,FMN GV 16 Berchem TOT
54,Posthofbrug 5366,2021-11-07,07:00:00,18,13,5,FMN GV 16 Berchem TOT
54,Posthofbrug 5366,2021-11-07,08:00:00,35,21,14,FMN GV 16 Berchem TOT
54,Posthofbrug 5366,2021-11-07,09:00:00,76,46,30,FMN GV 16 Berchem TOT
54,Posthofbrug 5366,2021-11-07,10:00:00,116,64,52,FMN GV 16 Berchem TOT
54,Posthofbrug 5366,2021-11-07,11:00:00,108,63,45,FMN GV 16 Berchem TOT
54,Posthofbrug 5366,2021-11-07,12:00:00,124,71,53,FMN GV 16 Berchem TOT
54,Posthofbrug 5366,2021-11-07,13:00:00,123,80,43,FMN GV 16 Berchem TOT
54,Posthofbrug 5366,2021-11-07,14:00:00,144,75,69,FMN GV 16 Berchem TOT
54,Posthofbrug 5366,2021-11-07,15:00:00,138,62,76,FMN GV 16 Berchem TOT
54,Posthofbrug 5366,2021-11-07,16:00:00,125,38,87,FMN GV 16 Berchem TOT
54,Posthofbrug 5366,2021-11-07,17:00:00,116,60,56,FMN GV 16 Berchem TOT
54,Posthofbrug 5366,2021-11-07,18:00:00,90,47,43,FMN GV 16 Berchem TOT
54,Posthofbrug 5366,2021-11-07,19:00:00,65,31,34,FMN GV 16 Berchem TOT
54,Posthofbrug 5366,2021-11-07,20:00:00,60,32,28,FMN GV 16 Berchem TOT
54,Posthofbrug 5366,2021-11-07,21:00:00,47,25,22,FMN GV 16 Berchem TOT
54,Posthofbrug 5366,2021-11-07,22:00:00,50,23,27,FMN GV 16 Berchem TOT
54,Posthofbrug 5366,2021-11-07,23:00:00,21,8,13,FMN GV 16 Berchem TOT
54,Posthofbrug 5366,2021-11-08,00:00:00,7,3,4,FMN GV 16 Berchem TOT
54,Posthofbrug 5366,2021-11-08,01:00:00,12,2,10,FMN GV 16 Berchem TOT
54,Posthofbrug 5366,2021-11-08,02:00:00,4,0,4,FMN GV 16 Berchem TOT
54,Posthofbrug 5366,2021-11-08,03:00:00,2,2,0,FMN GV 16 Berchem TOT
54,Posthofbrug 5366,2021-11-08,04:00:00,9,7,2,FMN GV 16 Berchem TOT
54,Posthofbrug 5366,2021-11-08,05:00:00,24,17,7,FMN GV 16 Berchem TOT
54,Posthofbrug 5366,2021-11-08,06:00:00,100,87,13,FMN GV 16 Berchem TOT
54,Posthofbrug 5366,2021-11-08,07:00:00,413,321,92,FMN GV 16 Berchem TOT
54,Posthofbrug 5366,2021-11-08,08:00:00,672,515,157,FMN GV 16 Berchem TOT
54,Posthofbrug 5366,2021-11-08,09:00:00,218,156,62,FMN GV 16 Berchem TOT
54,Posthofbrug 5366,2021-11-08,10:00:00,152,101,51,FMN GV 16 Berchem TOT
54,Posthofbrug 5366,2021-11-08,11:00:00,110,64,46,FMN GV 16 Berchem TOT
54,Posthofbrug 5366,2021-11-08,12:00:00,169,93,76,FMN GV 16 Berchem TOT
54,Posthofbrug 5366,2021-11-08,13:00:00,151,74,77,FMN GV 16 Berchem TOT
54,Posthofbrug 5366,2021-11-08,14:00:00,140,63,77,FMN GV 16 Berchem TOT
54,Posthofbrug 5366,2021-11-08,15:00:00,256,94,162,FMN GV 16 Berchem TOT
54,Posthofbrug 5366,2021-11-08,16:00:00,443,138,305,FMN GV 16 Berchem TOT
54,Posthofbrug 5366,2021-11-08,17:00:00,525,152,373,FMN GV 16 Berchem TOT
54,Posthofbrug 5366,2021-11-08,18:00:00,333,107,226,FMN GV 16 Berchem TOT
54,Posthofbrug 5366,2021-11-08,19:00:00,171,66,105,FMN GV 16 Berchem TOT
54,Posthofbrug 5366,2021-11-08,20:00:00,77,37,40,FMN GV 16 Berchem TOT
54,Posthofbrug 5366,2021-11-08,21:00:00,85,31,54,FMN GV 16 Berchem TOT
54,Posthofbrug 5366,2021-11-08,22:00:00,69,32,37,FMN GV 16 Berchem TOT
54,Posthofbrug 5366,2021-11-08,23:00:00,37,19,18,FMN GV 16 Berchem TOT
54,Posthofbrug 5366,2021-11-09,00:00:00,15,4,11,FMN GV 16 Berchem TOT
54,Posthofbrug 5366,2021-11-09,01:00:00,7,3,4,FMN GV 16 Berchem TOT
54,Posthofbrug 5366,2021-11-09,02:00:00,1,0,1,FMN GV 16 Berchem TOT
54,Posthofbrug 5366,2021-11-09,03:00:00,5,2,3,FMN GV 16 Berchem TOT
54,Posthofbrug 5366,2021-11-09,04:00:00,9,5,4,FMN GV 16 Berchem TOT
54,Posthofbrug 5366,2021-11-09,05:00:00,32,19,13,FMN GV 16 Berchem TOT
54,Posthofbrug 5366,2021-11-09,06:00:00,103,89,14,FMN GV 16 Berchem TOT
54,Posthofbrug 5366,2021-11-09,07:00:00,450,340,110,FMN GV 16 Berchem TOT
54,Posthofbrug 5366,2021-11-09,08:00:00,701,544,157,FMN GV 16 Berchem TOT
54,Posthofbrug 5366,2021-11-09,09:00:00,242,196,46,FMN GV 16 Berchem TOT
54,Posthofbrug 5366,2021-11-09,10:00:00,4,2,2,FMN GV 16 Berchem TOT
54,Posthofbrug 5366,2021-11-09,11:00:00,0,0,0,FMN GV 16 Berchem TOT
54,Posthofbrug 5366,2021-11-09,12:00:00,0,0,0,FMN GV 16 Berchem TOT
54,Posthofbrug 5366,2021-11-09,13:00:00,0,0,0,FMN GV 16 Berchem TOT
54,Posthofbrug 5366,2021-11-09,14:00:00,0,0,0,FMN GV 16 Berchem TOT
54,Posthofbrug 5366,2021-11-09,15:00:00,0,0,0,FMN GV 16 Berchem TOT
54,Posthofbrug 5366,2021-11-09,16:00:00,0,0,0,FMN GV 16 Berchem TOT
54,Posthofbrug 5366,2021-11-09,17:00:00,0,0,0,FMN GV 16 Berchem TOT
54,Posthofbrug 5366,2021-11-09,18:00:00,0,0,0,FMN GV 16 Berchem TOT
54,Posthofbrug 5366,2021-11-09,19:00:00,0,0,0,FMN GV 16 Berchem TOT
54,Posthofbrug 5366,2021-11-09,20:00:00,0,0,0,FMN GV 16 Berchem TOT
54,Posthofbrug 5366,2021-11-09,21:00:00,0,0,0,FMN GV 16 Berchem TOT
54,Posthofbrug 5366,2021-11-09,22:00:00,107,36,71,FMN GV 16 Berchem TOT
54,Posthofbrug 5366,2021-11-09,23:00:00,53,15,38,FMN GV 16 Berchem TOT
54,Posthofbrug 5366,2021-11-10,00:00:00,31,9,22,FMN GV 16 Berchem TOT
54,Posthofbrug 5366,2021-11-10,01:00:00,9,4,5,FMN GV 16 Berchem TOT
54,Posthofbrug 5366,2021-11-10,02:00:00,7,0,7,FMN GV 16 Berchem TOT
54,Posthofbrug 5366,2021-11-10,03:00:00,11,3,8,FMN GV 16 Berchem TOT
54,Posthofbrug 5366,2021-11-10,04:00:00,6,5,1,FMN GV 16 Berchem TOT
54,Posthofbrug 5366,2021-11-10,05:00:00,31,16,15,FMN GV 16 Berchem TOT
54,Posthofbrug 5366,2021-11-10,06:00:00,84,74,10,FMN GV 16 Berchem TOT
54,Posthofbrug 5366,2021-11-10,07:00:00,370,272,98,FMN GV 16 Berchem TOT
54,Posthofbrug 5366,2021-11-10,08:00:00,633,460,173,FMN GV 16 Berchem TOT
54,Posthofbrug 5366,2021-11-10,09:00:00,205,157,48,FMN GV 16 Berchem TOT
54,Posthofbrug 5366,2021-11-10,10:00:00,129,76,53,FMN GV 16 Berchem TOT
54,Posthofbrug 5366,2021-11-10,11:00:00,137,75,62,FMN GV 16 Berchem TOT
54,Posthofbrug 5366,2021-11-10,12:00:00,316,144,172,FMN GV 16 Berchem TOT
54,Posthofbrug 5366,2021-11-10,13:00:00,208,92,116,FMN GV 16 Berchem TOT
54,Posthofbrug 5366,2021-11-10,14:00:00,184,79,105,FMN GV 16 Berchem TOT
54,Posthofbrug 5366,2021-11-10,15:00:00,213,78,135,FMN GV 16 Berchem TOT
54,Posthofbrug 5366,2021-11-10,16:00:00,341,138,203,FMN GV 16 Berchem TOT
54,Posthofbrug 5366,2021-11-10,17:00:00,423,153,270,FMN GV 16 Berchem TOT
54,Posthofbrug 5366,2021-11-10,18:00:00,366,140,226,FMN GV 16 Berchem TOT
54,Posthofbrug 5366,2021-11-10,19:00:00,175,72,103,FMN GV 16 Berchem TOT
54,Posthofbrug 5366,2021-11-10,20:00:00,105,55,50,FMN GV 16 Berchem TOT
54,Posthofbrug 5366,2021-11-10,21:00:00,117,61,56,FMN GV 16 Berchem TOT
54,Posthofbrug 5366,2021-11-10,22:00:00,85,36,49,FMN GV 16 Berchem TOT
54,Posthofbrug 5366,2021-11-10,23:00:00,68,33,35,FMN GV 16 Berchem TOT
54,Posthofbrug 5366,2021-11-11,00:00:00,60,21,39,FMN GV 16 Berchem TOT
54,Posthofbrug 5366,2021-11-11,01:00:00,24,6,18,FMN GV 16 Berchem TOT
54,Posthofbrug 5366,2021-11-11,02:00:00,24,5,19,FMN GV 16 Berchem TOT
54,Posthofbrug 5366,2021-11-11,03:00:00,30,6,24,FMN GV 16 Berchem TOT
54,Posthofbrug 5366,2021-11-11,04:00:00,22,10,12,FMN GV 16 Berchem TOT
54,Posthofbrug 5366,2021-11-11,05:00:00,23,7,16,FMN GV 16 Berchem TOT
54,Posthofbrug 5366,2021-11-11,06:00:00,29,16,13,FMN GV 16 Berchem TOT
54,Posthofbrug 5366,2021-11-11,07:00:00,34,23,11,FMN GV 16 Berchem TOT
54,Posthofbrug 5366,2021-11-11,08:00:00,33,21,12,FMN GV 16 Berchem TOT
54,Posthofbrug 5366,2021-11-11,09:00:00,73,44,29,FMN GV 16 Berchem TOT
54,Posthofbrug 5366,2021-11-11,10:00:00,104,79,25,FMN GV 16 Berchem TOT
54,Posthofbrug 5366,2021-11-11,11:00:00,111,73,38,FMN GV 16 Berchem TOT
54,Posthofbrug 5366,2021-11-11,12:00:00,133,78,55,FMN GV 16 Berchem TOT
54,Posthofbrug 5366,2021-11-11,13:00:00,158,90,68,FMN GV 16 Berchem TOT
54,Posthofbrug 5366,2021-11-11,14:00:00,3,3,0,FMN GV 16 Berchem TOT
54,Posthofbrug 5366,2021-11-11,15:00:00,0,0,0,FMN GV 16 Berchem TOT
54,Posthofbrug 5366,2021-11-11,16:00:00,0,0,0,FMN GV 16 Berchem TOT
54,Posthofbrug 5366,2021-11-11,17:00:00,0,0,0,FMN GV 16 Berchem TOT
54,Posthofbrug 5366,2021-11-11,18:00:00,110,46,64,FMN GV 16 Berchem TOT
54,Posthofbrug 5366,2021-11-11,19:00:00,97,51,46,FMN GV 16 Berchem TOT
54,Posthofbrug 5366,2021-11-11,20:00:00,67,33,34,FMN GV 16 Berchem TOT
54,Posthofbrug 5366,2021-11-11,21:00:00,56,28,28,FMN GV 16 Berchem TOT
54,Posthofbrug 5366,2021-11-11,22:00:00,62,31,31,FMN GV 16 Berchem TOT
54,Posthofbrug 5366,2021-11-11,23:00:00,39,6,33,FMN GV 16 Berchem TOT
54,Posthofbrug 5366,2021-11-12,00:00:00,48,11,37,FMN GV 16 Berchem TOT
54,Posthofbrug 5366,2021-11-12,01:00:00,16,4,12,FMN GV 16 Berchem TOT
54,Posthofbrug 5366,2021-11-12,02:00:00,12,6,6,FMN GV 16 Berchem TOT
54,Posthofbrug 5366,2021-11-12,03:00:00,5,0,5,FMN GV 16 Berchem TOT
54,Posthofbrug 5366,2021-11-12,04:00:00,5,4,1,FMN GV 16 Berchem TOT
54,Posthofbrug 5366,2021-11-12,05:00:00,18,10,8,FMN GV 16 Berchem TOT
54,Posthofbrug 5366,2021-11-12,06:00:00,57,43,14,FMN GV 16 Berchem TOT
54,Posthofbrug 5366,2021-11-12,07:00:00,156,118,38,FMN GV 16 Berchem TOT
54,Posthofbrug 5366,2021-11-12,08:00:00,291,226,65,FMN GV 16 Berchem TOT
54,Posthofbrug 5366,2021-11-12,09:00:00,171,133,38,FMN GV 16 Berchem TOT
54,Posthofbrug 5366,2021-11-12,10:00:00,118,76,42,FMN GV 16 Berchem TOT
54,Posthofbrug 5366,2021-11-12,11:00:00,133,70,63,FMN GV 16 Berchem TOT
54,Posthofbrug 5366,2021-11-12,12:00:00,162,93,69,FMN GV 16 Berchem TOT
54,Posthofbrug 5366,2021-11-12,13:00:00,128,68,60,FMN GV 16 Berchem TOT
54,Posthofbrug 5366,2021-11-12,14:00:00,168,72,96,FMN GV 16 Berchem TOT
54,Posthofbrug 5366,2021-11-12,15:00:00,234,92,142,FMN GV 16 Berchem TOT
54,Posthofbrug 5366,2021-11-12,16:00:00,260,87,173,FMN GV 16 Berchem TOT
54,Posthofbrug 5366,2021-11-12,17:00:00,288,110,178,FMN GV 16 Berchem TOT
54,Posthofbrug 5366,2021-11-12,18:00:00,182,89,93,FMN GV 16 Berchem TOT
54,Posthofbrug 5366,2021-11-12,19:00:00,126,73,53,FMN GV 16 Berchem TOT
54,Posthofbrug 5366,2021-11-12,20:00:00,97,50,47,FMN GV 16 Berchem TOT
54,Posthofbrug 5366,2021-11-12,21:00:00,49,25,24,FMN GV 16 Berchem TOT
54,Posthofbrug 5366,2021-11-12,22:00:00,79,20,59,FMN GV 16 Berchem TOT
54,Posthofbrug 5366,2021-11-12,23:00:00,81,19,62,FMN GV 16 Berchem TOT
54,Posthofbrug 5366,2021-11-13,00:00:00,55,14,41,FMN GV 16 Berchem TOT
54,Posthofbrug 5366,2021-11-13,01:00:00,46,10,36,FMN GV 16 Berchem TOT
54,Posthofbrug 5366,2021-11-13,02:00:00,26,6,20,FMN GV 16 Berchem TOT
54,Posthofbrug 5366,2021-11-13,03:00:00,21,15,6,FMN GV 16 Berchem TOT
54,Posthofbrug 5366,2021-11-13,04:00:00,11,2,9,FMN GV 16 Berchem TOT
54,Posthofbrug 5366,2021-11-13,05:00:00,24,5,19,FMN GV 16 Berchem TOT
54,Posthofbrug 5366,2021-11-13,06:00:00,22,12,10,FMN GV 16 Berchem TOT
54,Posthofbrug 5366,2021-11-13,07:00:00,42,20,22,FMN GV 16 Berchem TOT
54,Posthofbrug 5366,2021-11-13,08:00:00,40,19,21,FMN GV 16 Berchem TOT
54,Posthofbrug 5366,2021-11-13,09:00:00,60,39,21,FMN GV 16 Berchem TOT
54,Posthofbrug 5366,2021-11-13,10:00:00,72,47,25,FMN GV 16 Berchem TOT
54,Posthofbrug 5366,2021-11-13,11:00:00,84,45,39,FMN GV 16 Berchem TOT
54,Posthofbrug 5366,2021-11-13,12:00:00,91,55,36,FMN GV 16 Berchem TOT
54,Posthofbrug 5366,2021-11-13,13:00:00,85,51,34,FMN GV 16 Berchem TOT
54,Posthofbrug 5366,2021-11-13,14:00:00,110,54,56,FMN GV 16 Berchem TOT
54,Posthofbrug 5366,2021-11-13,15:00:00,98,47,51,FMN GV 16 Berchem TOT
54,Posthofbrug 5366,2021-11-13,16:00:00,92,45,47,FMN GV 16 Berchem TOT
54,Posthofbrug 5366,2021-11-13,17:00:00,113,62,51,FMN GV 16 Berchem TOT
54,Posthofbrug 5366,2021-11-13,18:00:00,116,71,45,FMN GV 16 Berchem TOT
54,Posthofbrug 5366,2021-11-13,19:00:00,60,41,19,FMN GV 16 Berchem TOT
54,Posthofbrug 5366,2021-11-13,20:00:00,62,37,25,FMN GV 16 Berchem TOT
54,Posthofbrug 5366,2021-11-13,21:00:00,61,26,35,FMN GV 16 Berchem TOT
54,Posthofbrug 5366,2021-11-13,22:00:00,46,19,27,FMN GV 16 Berchem TOT
54,Posthofbrug 5366,2021-11-13,23:00:00,48,17,31,FMN GV 16 Berchem TOT
54,Posthofbrug 5366,2021-11-14,00:00:00,49,16,33,FMN GV 16 Berchem TOT
54,Posthofbrug 5366,2021-11-14,01:00:00,23,8,15,FMN GV 16 Berchem TOT
54,Posthofbrug 5366,2021-11-14,02:00:00,18,3,15,FMN GV 16 Berchem TOT
54,Posthofbrug 5366,2021-11-14,03:00:00,26,7,19,FMN GV 16 Berchem TOT
54,Posthofbrug 5366,2021-11-14,04:00:00,5,1,4,FMN GV 16 Berchem TOT
54,Posthofbrug 5366,2021-11-14,05:00:00,16,10,6,FMN GV 16 Berchem TOT
54,Posthofbrug 5366,2021-11-14,06:00:00,9,7,2,FMN GV 16 Berchem TOT
54,Posthofbrug 5366,2021-11-14,07:00:00,20,10,10,FMN GV 16 Berchem TOT
54,Posthofbrug 5366,2021-11-14,08:00:00,35,17,18,FMN GV 16 Berchem TOT
54,Posthofbrug 5366,2021-11-14,09:00:00,71,39,32,FMN GV 16 Berchem TOT
54,Posthofbrug 5366,2021-11-14,10:00:00,94,42,52,FMN GV 16 Berchem TOT
54,Posthofbrug 5366,2021-11-14,11:00:00,105,56,49,FMN GV 16 Berchem TOT
54,Posthofbrug 5366,2021-11-14,12:00:00,111,64,47,FMN GV 16 Berchem TOT
54,Posthofbrug 5366,2021-11-14,13:00:00,128,69,59,FMN GV 16 Berchem TOT
54,Posthofbrug 5366,2021-11-14,14:00:00,9,5,4,FMN GV 16 Berchem TOT
54,Posthofbrug 5366,2021-11-14,15:00:00,0,0,0,FMN GV 16 Berchem TOT
54,Posthofbrug 5366,2021-11-14,16:00:00,0,0,0,FMN GV 16 Berchem TOT
54,Posthofbrug 5366,2021-11-14,17:00:00,0,0,0,FMN GV 16 Berchem TOT
54,Posthofbrug 5366,2021-11-14,18:00:00,0,0,0,FMN GV 16 Berchem TOT
54,Posthofbrug 5366,2021-11-14,19:00:00,0,0,0,FMN GV 16 Berchem TOT
54,Posthofbrug 5366,2021-11-14,20:00:00,59,30,29,FMN GV 16 Berchem TOT
54,Posthofbrug 5366,2021-11-14,21:00:00,48,24,24,FMN GV 16 Berchem TOT
54,Posthofbrug 5366,2021-11-14,22:00:00,45,18,27,FMN GV 16 Berchem TOT
54,Posthofbrug 5366,2021-11-14,23:00:00,19,4,15,FMN GV 16 Berchem TOT
54,Posthofbrug 5366,2021-11-15,00:00:00,10,4,6,FMN GV 16 Berchem TOT
54,Posthofbrug 5366,2021-11-15,01:00:00,5,2,3,FMN GV 16 Berchem TOT
54,Posthofbrug 5366,2021-11-15,02:00:00,3,1,2,FMN GV 16 Berchem TOT
54,Posthofbrug 5366,2021-11-15,03:00:00,1,1,0,FMN GV 16 Berchem TOT
54,Posthofbrug 5366,2021-11-15,04:00:00,11,10,1,FMN GV 16 Berchem TOT
54,Posthofbrug 5366,2021-11-15,05:00:00,25,13,12,FMN GV 16 Berchem TOT
54,Posthofbrug 5366,2021-11-15,06:00:00,99,87,12,FMN GV 16 Berchem TOT
54,Posthofbrug 5366,2021-11-15,07:00:00,391,293,98,FMN GV 16 Berchem TOT
54,Posthofbrug 5366,2021-11-15,08:00:00,658,502,156,FMN GV 16 Berchem TOT
54,Posthofbrug 5366,2021-11-15,09:00:00,204,151,53,FMN GV 16 Berchem TOT
54,Posthofbrug 5366,2021-11-15,10:00:00,120,79,41,FMN GV 16 Berchem TOT
54,Posthofbrug 5366,2021-11-15,11:00:00,102,63,39,FMN GV 16 Berchem TOT
54,Posthofbrug 5366,2021-11-15,12:00:00,154,79,75,FMN GV 16 Berchem TOT
54,Posthofbrug 5366,2021-11-15,13:00:00,155,92,63,FMN GV 16 Berchem TOT
54,Posthofbrug 5366,2021-11-15,14:00:00,124,52,72,FMN GV 16 Berchem TOT
54,Posthofbrug 5366,2021-11-15,15:00:00,222,81,141,FMN GV 16 Berchem TOT
54,Posthofbrug 5366,2021-11-15,16:00:00,398,111,287,FMN GV 16 Berchem TOT
54,Posthofbrug 5366,2021-11-15,17:00:00,457,139,318,FMN GV 16 Berchem TOT
54,Posthofbrug 5366,2021-11-15,18:00:00,308,95,213,FMN GV 16 Berchem TOT
54,Posthofbrug 5366,2021-11-15,19:00:00,157,54,103,FMN GV 16 Berchem TOT
54,Posthofbrug 5366,2021-11-15,20:00:00,96,48,48,FMN GV 16 Berchem TOT
54,Posthofbrug 5366,2021-11-15,21:00:00,84,31,53,FMN GV 16 Berchem TOT
54,Posthofbrug 5366,2021-11-15,22:00:00,71,30,41,FMN GV 16 Berchem TOT
54,Posthofbrug 5366,2021-11-15,23:00:00,25,14,11,FMN GV 16 Berchem TOT
54,Posthofbrug 5366,2021-11-16,00:00:00,11,3,8,FMN GV 16 Berchem TOT
54,Posthofbrug 5366,2021-11-16,01:00:00,9,3,6,FMN GV 16 Berchem TOT
54,Posthofbrug 5366,2021-11-16,02:00:00,5,1,4,FMN GV 16 Berchem TOT
54,Posthofbrug 5366,2021-11-16,03:00:00,6,1,5,FMN GV 16 Berchem TOT
54,Posthofbrug 5366,2021-11-16,04:00:00,12,9,3,FMN GV 16 Berchem TOT
54,Posthofbrug 5366,2021-11-16,05:00:00,31,17,14,FMN GV 16 Berchem TOT
54,Posthofbrug 5366,2021-11-16,06:00:00,96,82,14,FMN GV 16 Berchem TOT
54,Posthofbrug 5366,2021-11-16,07:00:00,417,318,99,FMN GV 16 Berchem TOT
54,Posthofbrug 5366,2021-11-16,08:00:00,655,509,146,FMN GV 16 Berchem TOT
54,Posthofbrug 5366,2021-11-16,09:00:00,238,182,56,FMN GV 16 Berchem TOT
54,Posthofbrug 5366,2021-11-16,10:00:00,6,5,1,FMN GV 16 Berchem TOT
54,Posthofbrug 5366,2021-11-16,11:00:00,0,0,0,FMN GV 16 Berchem TOT
54,Posthofbrug 5366,2021-11-16,12:00:00,0,0,0,FMN GV 16 Berchem TOT
54,Posthofbrug 5366,2021-11-16,13:00:00,0,0,0,FMN GV 16 Berchem TOT
54,Posthofbrug 5366,2021-11-16,14:00:00,0,0,0,FMN GV 16 Berchem TOT
54,Posthofbrug 5366,2021-11-16,15:00:00,0,0,0,FMN GV 16 Berchem TOT
54,Posthofbrug 5366,2021-11-16,16:00:00,0,0,0,FMN GV 16 Berchem TOT
54,Posthofbrug 5366,2021-11-16,17:00:00,0,0,0,FMN GV 16 Berchem TOT
54,Posthofbrug 5366,2021-11-16,18:00:00,0,0,0,FMN GV 16 Berchem TOT
54,Posthofbrug 5366,2021-11-16,19:00:00,0,0,0,FMN GV 16 Berchem TOT
54,Posthofbrug 5366,2021-11-16,20:00:00,0,0,0,FMN GV 16 Berchem TOT
54,Posthofbrug 5366,2021-11-16,21:00:00,0,0,0,FMN GV 16 Berchem TOT
54,Posthofbrug 5366,2021-11-16,22:00:00,93,43,50,FMN GV 16 Berchem TOT
54,Posthofbrug 5366,2021-11-16,23:00:00,48,16,32,FMN GV 16 Berchem TOT
54,Posthofbrug 5366,2021-11-17,00:00:00,21,9,12,FMN GV 16 Berchem TOT
54,Posthofbrug 5366,2021-11-17,01:00:00,11,5,6,FMN GV 16 Berchem TOT
54,Posthofbrug 5366,2021-11-17,02:00:00,1,0,1,FMN GV 16 Berchem TOT
54,Posthofbrug 5366,2021-11-17,03:00:00,4,3,1,FMN GV 16 Berchem TOT
54,Posthofbrug 5366,2021-11-17,04:00:00,15,14,1,FMN GV 16 Berchem TOT
54,Posthofbrug 5366,2021-11-17,05:00:00,22,13,9,FMN GV 16 Berchem TOT
54,Posthofbrug 5366,2021-11-17,06:00:00,96,82,14,FMN GV 16 Berchem TOT
54,Posthofbrug 5366,2021-11-17,07:00:00,367,266,101,FMN GV 16 Berchem TOT
54,Posthofbrug 5366,2021-11-17,08:00:00,549,411,138,FMN GV 16 Berchem TOT
54,Posthofbrug 5366,2021-11-17,09:00:00,226,171,55,FMN GV 16 Berchem TOT
54,Posthofbrug 5366,2021-11-17,10:00:00,124,80,44,FMN GV 16 Berchem TOT
54,Posthofbrug 5366,2021-11-17,11:00:00,118,66,52,FMN GV 16 Berchem TOT
54,Posthofbrug 5366,2021-11-17,12:00:00,287,113,174,FMN GV 16 Berchem TOT
54,Posthofbrug 5366,2021-11-17,13:00:00,189,89,100,FMN GV 16 Berchem TOT
54,Posthofbrug 5366,2021-11-17,14:00:00,170,78,92,FMN GV 16 Berchem TOT
54,Posthofbrug 5366,2021-11-17,15:00:00,206,75,131,FMN GV 16 Berchem TOT
54,Posthofbrug 5366,2021-11-17,16:00:00,287,100,187,FMN GV 16 Berchem TOT
54,Posthofbrug 5366,2021-11-17,17:00:00,418,148,270,FMN GV 16 Berchem TOT
54,Posthofbrug 5366,2021-11-17,18:00:00,299,102,197,FMN GV 16 Berchem TOT
54,Posthofbrug 5366,2021-11-17,19:00:00,158,64,94,FMN GV 16 Berchem TOT
54,Posthofbrug 5366,2021-11-17,20:00:00,101,44,57,FMN GV 16 Berchem TOT
54,Posthofbrug 5366,2021-11-17,21:00:00,74,35,39,FMN GV 16 Berchem TOT
54,Posthofbrug 5366,2021-11-17,22:00:00,90,39,51,FMN GV 16 Berchem TOT
54,Posthofbrug 5366,2021-11-17,23:00:00,42,16,26,FMN GV 16 Berchem TOT
54,Posthofbrug 5366,2021-11-18,00:00:00,27,15,12,FMN GV 16 Berchem TOT
54,Posthofbrug 5366,2021-11-18,01:00:00,6,2,4,FMN GV 16 Berchem TOT
54,Posthofbrug 5366,2021-11-18,02:00:00,6,4,2,FMN GV 16 Berchem TOT
54,Posthofbrug 5366,2021-11-18,03:00:00,8,2,6,FMN GV 16 Berchem TOT
54,Posthofbrug 5366,2021-11-18,04:00:00,13,13,0,FMN GV 16 Berchem TOT
54,Posthofbrug 5366,2021-11-18,05:00:00,30,20,10,FMN GV 16 Berchem TOT
54,Posthofbrug 5366,2021-11-18,06:00:00,103,89,14,FMN GV 16 Berchem TOT
54,Posthofbrug 5366,2021-11-18,07:00:00,372,277,95,FMN GV 16 Berchem TOT
54,Posthofbrug 5366,2021-11-18,08:00:00,615,475,140,FMN GV 16 Berchem TOT
54,Posthofbrug 5366,2021-11-18,09:00:00,238,191,47,FMN GV 16 Berchem TOT
54,Posthofbrug 5366,2021-11-18,10:00:00,144,98,46,FMN GV 16 Berchem TOT
54,Posthofbrug 5366,2021-11-18,11:00:00,113,74,39,FMN GV 16 Berchem TOT
54,Posthofbrug 5366,2021-11-18,12:00:00,184,95,89,FMN GV 16 Berchem TOT
54,Posthofbrug 5366,2021-11-18,13:00:00,173,93,80,FMN GV 16 Berchem TOT
54,Posthofbrug 5366,2021-11-18,14:00:00,149,53,96,FMN GV 16 Berchem TOT
54,Posthofbrug 5366,2021-11-18,15:00:00,288,99,189,FMN GV 16 Berchem TOT
54,Posthofbrug 5366,2021-11-18,16:00:00,388,109,279,FMN GV 16 Berchem TOT
54,Posthofbrug 5366,2021-11-18,17:00:00,444,133,311,FMN GV 16 Berchem TOT
54,Posthofbrug 5366,2021-11-18,18:00:00,292,92,200,FMN GV 16 Berchem TOT
54,Posthofbrug 5366,2021-11-18,19:00:00,176,86,90,FMN GV 16 Berchem TOT
54,Posthofbrug 5366,2021-11-18,20:00:00,101,45,56,FMN GV 16 Berchem TOT
54,Posthofbrug 5366,2021-11-18,21:00:00,77,37,40,FMN GV 16 Berchem TOT
54,Posthofbrug 5366,2021-11-18,22:00:00,103,44,59,FMN GV 16 Berchem TOT
54,Posthofbrug 5366,2021-11-18,23:00:00,56,20,36,FMN GV 16 Berchem TOT
54,Posthofbrug 5366,2021-11-19,00:00:00,31,12,19,FMN GV 16 Berchem TOT
54,Posthofbrug 5366,2021-11-19,01:00:00,24,10,14,FMN GV 16 Berchem TOT
54,Posthofbrug 5366,2021-11-19,02:00:00,18,2,16,FMN GV 16 Berchem TOT
54,Posthofbrug 5366,2021-11-19,03:00:00,21,1,20,FMN GV 16 Berchem TOT
54,Posthofbrug 5366,2021-11-19,04:00:00,36,11,25,FMN GV 16 Berchem TOT
54,Posthofbrug 5366,2021-11-19,05:00:00,38,16,22,FMN GV 16 Berchem TOT
54,Posthofbrug 5366,2021-11-19,06:00:00,66,57,9,FMN GV 16 Berchem TOT
54,Posthofbrug 5366,2021-11-19,07:00:00,285,215,70,FMN GV 16 Berchem TOT
54,Posthofbrug 5366,2021-11-19,08:00:00,532,395,137,FMN GV 16 Berchem TOT
54,Posthofbrug 5366,2021-11-19,09:00:00,186,136,50,FMN GV 16 Berchem TOT
54,Posthofbrug 5366,2021-11-19,10:00:00,124,83,41,FMN GV 16 Berchem TOT
54,Posthofbrug 5366,2021-11-19,11:00:00,106,52,54,FMN GV 16 Berchem TOT
54,Posthofbrug 5366,2021-11-19,12:00:00,155,79,76,FMN GV 16 Berchem TOT
54,Posthofbrug 5366,2021-11-19,13:00:00,171,97,74,FMN GV 16 Berchem TOT
54,Posthofbrug 5366,2021-11-19,14:00:00,145,63,82,FMN GV 16 Berchem TOT
54,Posthofbrug 5366,2021-11-19,15:00:00,269,95,174,FMN GV 16 Berchem TOT
54,Posthofbrug 5366,2021-11-19,16:00:00,349,88,261,FMN GV 16 Berchem TOT
54,Posthofbrug 5366,2021-11-19,17:00:00,360,142,218,FMN GV 16 Berchem TOT
54,Posthofbrug 5366,2021-11-19,18:00:00,244,103,141,FMN GV 16 Berchem TOT
54,Posthofbrug 5366,2021-11-19,19:00:00,192,95,97,FMN GV 16 Berchem TOT
54,Posthofbrug 5366,2021-11-19,20:00:00,116,54,62,FMN GV 16 Berchem TOT
54,Posthofbrug 5366,2021-11-19,21:00:00,76,41,35,FMN GV 16 Berchem TOT
54,Posthofbrug 5366,2021-11-19,22:00:00,81,46,35,FMN GV 16 Berchem TOT
54,Posthofbrug 5366,2021-11-19,23:00:00,92,33,59,FMN GV 16 Berchem TOT
54,Posthofbrug 5366,2021-11-20,00:00:00,73,21,52,FMN GV 16 Berchem TOT
54,Posthofbrug 5366,2021-11-20,01:00:00,47,18,29,FMN GV 16 Berchem TOT
54,Posthofbrug 5366,2021-11-20,02:00:00,39,11,28,FMN GV 16 Berchem TOT
54,Posthofbrug 5366,2021-11-20,03:00:00,34,9,25,FMN GV 16 Berchem TOT
54,Posthofbrug 5366,2021-11-20,04:00:00,33,15,18,FMN GV 16 Berchem TOT
54,Posthofbrug 5366,2021-11-20,05:00:00,18,10,8,FMN GV 16 Berchem TOT
54,Posthofbrug 5366,2021-11-20,06:00:00,24,12,12,FMN GV 16 Berchem TOT
54,Posthofbrug 5366,2021-11-20,07:00:00,34,22,12,FMN GV 16 Berchem TOT
54,Posthofbrug 5366,2021-11-20,08:00:00,64,36,28,FMN GV 16 Berchem TOT
54,Posthofbrug 5366,2021-11-20,09:00:00,113,81,32,FMN GV 16 Berchem TOT
54,Posthofbrug 5366,2021-11-20,10:00:00,140,87,53,FMN GV 16 Berchem TOT
54,Posthofbrug 5366,2021-11-20,11:00:00,125,80,45,FMN GV 16 Berchem TOT
54,Posthofbrug 5366,2021-11-20,12:00:00,125,70,55,FMN GV 16 Berchem TOT
54,Posthofbrug 5366,2021-11-20,13:00:00,179,103,76,FMN GV 16 Berchem TOT
54,Posthofbrug 5366,2021-11-20,14:00:00,163,96,67,FMN GV 16 Berchem TOT
54,Posthofbrug 5366,2021-11-20,15:00:00,143,80,63,FMN GV 16 Berchem TOT
54,Posthofbrug 5366,2021-11-20,16:00:00,169,81,88,FMN GV 16 Berchem TOT
54,Posthofbrug 5366,2021-11-20,17:00:00,183,63,120,FMN GV 16 Berchem TOT
54,Posthofbrug 5366,2021-11-20,18:00:00,161,74,87,FMN GV 16 Berchem TOT
54,Posthofbrug 5366,2021-11-20,19:00:00,105,66,39,FMN GV 16 Berchem TOT
54,Posthofbrug 5366,2021-11-20,20:00:00,91,44,47,FMN GV 16 Berchem TOT
54,Posthofbrug 5366,2021-11-20,21:00:00,63,30,33,FMN GV 16 Berchem TOT
54,Posthofbrug 5366,2021-11-20,22:00:00,65,37,28,FMN GV 16 Berchem TOT
54,Posthofbrug 5366,2021-11-20,23:00:00,77,35,42,FMN GV 16 Berchem TOT
54,Posthofbrug 5366,2021-11-21,00:00:00,57,15,42,FMN GV 16 Berchem TOT
54,Posthofbrug 5366,2021-11-21,01:00:00,48,19,29,FMN GV 16 Berchem TOT
54,Posthofbrug 5366,2021-11-21,02:00:00,29,5,24,FMN GV 16 Berchem TOT
54,Posthofbrug 5366,2021-11-21,03:00:00,13,4,9,FMN GV 16 Berchem TOT
54,Posthofbrug 5366,2021-11-21,04:00:00,9,2,7,FMN GV 16 Berchem TOT
54,Posthofbrug 5366,2021-11-21,05:00:00,17,7,10,FMN GV 16 Berchem TOT
54,Posthofbrug 5366,2021-11-21,06:00:00,17,11,6,FMN GV 16 Berchem TOT
54,Posthofbrug 5366,2021-11-21,07:00:00,22,15,7,FMN GV 16 Berchem TOT
54,Posthofbrug 5366,2021-11-21,08:00:00,48,39,9,FMN GV 16 Berchem TOT
54,Posthofbrug 5366,2021-11-21,09:00:00,69,47,22,FMN GV 16 Berchem TOT
54,Posthofbrug 5366,2021-11-21,10:00:00,108,80,28,FMN GV 16 Berchem TOT
54,Posthofbrug 5366,2021-11-21,11:00:00,76,38,38,FMN GV 16 Berchem TOT
54,Posthofbrug 5366,2021-11-21,12:00:00,118,55,63,FMN GV 16 Berchem TOT
54,Posthofbrug 5366,2021-11-21,13:00:00,103,50,53,FMN GV 16 Berchem TOT
54,Posthofbrug 5366,2021-11-21,14:00:00,5,1,4,FMN GV 16 Berchem TOT
54,Posthofbrug 5366,2021-11-21,15:00:00,0,0,0,FMN GV 16 Berchem TOT
54,Posthofbrug 5366,2021-11-21,16:00:00,0,0,0,FMN GV 16 Berchem TOT
54,Posthofbrug 5366,2021-11-21,17:00:00,0,0,0,FMN GV 16 Berchem TOT
54,Posthofbrug 5366,2021-11-21,18:00:00,0,0,0,FMN GV 16 Berchem TOT
54,Posthofbrug 5366,2021-11-21,19:00:00,0,0,0,FMN GV 16 Berchem TOT
54,Posthofbrug 5366,2021-11-21,20:00:00,47,23,24,FMN GV 16 Berchem TOT
54,Posthofbrug 5366,2021-11-21,21:00:00,52,28,24,FMN GV 16 Berchem TOT
54,Posthofbrug 5366,2021-11-21,22:00:00,61,23,38,FMN GV 16 Berchem TOT
54,Posthofbrug 5366,2021-11-21,23:00:00,31,13,18,FMN GV 16 Berchem TOT
54,Posthofbrug 5366,2021-11-22,00:00:00,9,3,6,FMN GV 16 Berchem TOT
54,Posthofbrug 5366,2021-11-22,01:00:00,12,0,12,FMN GV 16 Berchem TOT
54,Posthofbrug 5366,2021-11-22,02:00:00,3,0,3,FMN GV 16 Berchem TOT
54,Posthofbrug 5366,2021-11-22,03:00:00,1,1,0,FMN GV 16 Berchem TOT
54,Posthofbrug 5366,2021-11-22,04:00:00,6,6,0,FMN GV 16 Berchem TOT
54,Posthofbrug 5366,2021-11-22,05:00:00,24,16,8,FMN GV 16 Berchem TOT
54,Posthofbrug 5366,2021-11-22,06:00:00,91,81,10,FMN GV 16 Berchem TOT
54,Posthofbrug 5366,2021-11-22,07:00:00,330,255,75,FMN GV 16 Berchem TOT
54,Posthofbrug 5366,2021-11-22,08:00:00,549,422,127,FMN GV 16 Berchem TOT
54,Posthofbrug 5366,2021-11-22,09:00:00,187,135,52,FMN GV 16 Berchem TOT
54,Posthofbrug 5366,2021-11-22,10:00:00,127,87,40,FMN GV 16 Berchem TOT
54,Posthofbrug 5366,2021-11-22,11:00:00,111,60,51,FMN GV 16 Berchem TOT
54,Posthofbrug 5366,2021-11-22,12:00:00,190,111,79,FMN GV 16 Berchem TOT
54,Posthofbrug 5366,2021-11-22,13:00:00,157,82,75,FMN GV 16 Berchem TOT
54,Posthofbrug 5366,2021-11-22,14:00:00,146,63,83,FMN GV 16 Berchem TOT
54,Posthofbrug 5366,2021-11-22,15:00:00,238,85,153,FMN GV 16 Berchem TOT
54,Posthofbrug 5366,2021-11-22,16:00:00,375,96,279,FMN GV 16 Berchem TOT
54,Posthofbrug 5366,2021-11-22,17:00:00,395,123,272,FMN GV 16 Berchem TOT
54,Posthofbrug 5366,2021-11-22,18:00:00,13,6,7,FMN GV 16 Berchem TOT
54,Posthofbrug 5366,2021-11-22,19:00:00,0,0,0,FMN GV 16 Berchem TOT
54,Posthofbrug 5366,2021-11-22,20:00:00,0,0,0,FMN GV 16 Berchem TOT
54,Posthofbrug 5366,2021-11-22,21:00:00,0,0,0,FMN GV 16 Berchem TOT
54,Posthofbrug 5366,2021-11-22,22:00:00,62,29,33,FMN GV 16 Berchem TOT
54,Posthofbrug 5366,2021-11-22,23:00:00,39,21,18,FMN GV 16 Berchem TOT
54,Posthofbrug 5366,2021-11-23,00:00:00,12,1,11,FMN GV 16 Berchem TOT
54,Posthofbrug 5366,2021-11-23,01:00:00,8,4,4,FMN GV 16 Berchem TOT
54,Posthofbrug 5366,2021-11-23,02:00:00,7,2,5,FMN GV 16 Berchem TOT
54,Posthofbrug 5366,2021-11-23,03:00:00,3,1,2,FMN GV 16 Berchem TOT
54,Posthofbrug 5366,2021-11-23,04:00:00,6,5,1,FMN GV 16 Berchem TOT
54,Posthofbrug 5366,2021-11-23,05:00:00,34,22,12,FMN GV 16 Berchem TOT
54,Posthofbrug 5366,2021-11-23,06:00:00,94,78,16,FMN GV 16 Berchem TOT
54,Posthofbrug 5366,2021-11-23,07:00:00,312,237,75,FMN GV 16 Berchem TOT
54,Posthofbrug 5366,2021-11-23,08:00:00,548,425,123,FMN GV 16 Berchem TOT
54,Posthofbrug 5366,2021-11-23,09:00:00,199,154,45,FMN GV 16 Berchem TOT
54,Posthofbrug 5366,2021-11-23,10:00:00,107,67,40,FMN GV 16 Berchem TOT
54,Posthofbrug 5366,2021-11-23,11:00:00,107,53,54,FMN GV 16 Berchem TOT
54,Posthofbrug 5366,2021-11-23,12:00:00,138,75,63,FMN GV 16 Berchem TOT
54,Posthofbrug 5366,2021-11-23,13:00:00,153,91,62,FMN GV 16 Berchem TOT
54,Posthofbrug 5366,2021-11-23,14:00:00,127,47,80,FMN GV 16 Berchem TOT
54,Posthofbrug 5366,2021-11-23,15:00:00,201,68,133,FMN GV 16 Berchem TOT
54,Posthofbrug 5366,2021-11-23,16:00:00,381,122,259,FMN GV 16 Berchem TOT
54,Posthofbrug 5366,2021-11-23,17:00:00,394,116,278,FMN GV 16 Berchem TOT
54,Posthofbrug 5366,2021-11-23,18:00:00,289,87,202,FMN GV 16 Berchem TOT
54,Posthofbrug 5366,2021-11-23,19:00:00,162,74,88,FMN GV 16 Berchem TOT
54,Posthofbrug 5366,2021-11-23,20:00:00,83,28,55,FMN GV 16 Berchem TOT
54,Posthofbrug 5366,2021-11-23,21:00:00,83,37,46,FMN GV 16 Berchem TOT
54,Posthofbrug 5366,2021-11-23,22:00:00,104,44,60,FMN GV 16 Berchem TOT
54,Posthofbrug 5366,2021-11-23,23:00:00,46,12,34,FMN GV 16 Berchem TOT
54,Posthofbrug 5366,2021-11-24,00:00:00,22,7,15,FMN GV 16 Berchem TOT
54,Posthofbrug 5366,2021-11-24,01:00:00,9,5,4,FMN GV 16 Berchem TOT
54,Posthofbrug 5366,2021-11-24,02:00:00,2,0,2,FMN GV 16 Berchem TOT
54,Posthofbrug 5366,2021-11-24,03:00:00,7,3,4,FMN GV 16 Berchem TOT
54,Posthofbrug 5366,2021-11-24,04:00:00,4,3,1,FMN GV 16 Berchem TOT
54,Posthofbrug 5366,2021-11-24,05:00:00,29,18,11,FMN GV 16 Berchem TOT
54,Posthofbrug 5366,2021-11-24,06:00:00,90,78,12,FMN GV 16 Berchem TOT
54,Posthofbrug 5366,2021-11-24,07:00:00,302,217,85,FMN GV 16 Berchem TOT
54,Posthofbrug 5366,2021-11-24,08:00:00,445,336,109,FMN GV 16 Berchem TOT
54,Posthofbrug 5366,2021-11-24,09:00:00,186,140,46,FMN GV 16 Berchem TOT
54,Posthofbrug 5366,2021-11-24,10:00:00,118,69,49,FMN GV 16 Berchem TOT
54,Posthofbrug 5366,2021-11-24,11:00:00,96,53,43,FMN GV 16 Berchem TOT
54,Posthofbrug 5366,2021-11-24,12:00:00,281,125,156,FMN GV 16 Berchem TOT
54,Posthofbrug 5366,2021-11-24,13:00:00,187,64,123,FMN GV 16 Berchem TOT
54,Posthofbrug 5366,2021-11-24,14:00:00,137,60,77,FMN GV 16 Berchem TOT
54,Posthofbrug 5366,2021-11-24,15:00:00,161,74,87,FMN GV 16 Berchem TOT
54,Posthofbrug 5366,2021-11-24,16:00:00,299,93,206,FMN GV 16 Berchem TOT
54,Posthofbrug 5366,2021-11-24,17:00:00,339,136,203,FMN GV 16 Berchem TOT
54,Posthofbrug 5366,2021-11-24,18:00:00,255,89,166,FMN GV 16 Berchem TOT
54,Posthofbrug 5366,2021-11-24,19:00:00,153,67,86,FMN GV 16 Berchem TOT
54,Posthofbrug 5366,2021-11-24,20:00:00,98,40,58,FMN GV 16 Berchem TOT
54,Posthofbrug 5366,2021-11-24,21:00:00,80,37,43,FMN GV 16 Berchem TOT
54,Posthofbrug 5366,2021-11-24,22:00:00,84,27,57,FMN GV 16 Berchem TOT
54,Posthofbrug 5366,2021-11-24,23:00:00,38,12,26,FMN GV 16 Berchem TOT
54,Posthofbrug 5366,2021-11-25,00:00:00,22,4,18,FMN GV 16 Berchem TOT
54,Posthofbrug 5366,2021-11-25,01:00:00,12,5,7,FMN GV 16 Berchem TOT
54,Posthofbrug 5366,2021-11-25,02:00:00,4,0,4,FMN GV 16 Berchem TOT
54,Posthofbrug 5366,2021-11-25,03:00:00,2,0,2,FMN GV 16 Berchem TOT
54,Posthofbrug 5366,2021-11-25,04:00:00,6,5,1,FMN GV 16 Berchem TOT
54,Posthofbrug 5366,2021-11-25,05:00:00,32,20,12,FMN GV 16 Berchem TOT
54,Posthofbrug 5366,2021-11-25,06:00:00,93,85,8,FMN GV 16 Berchem TOT
54,Posthofbrug 5366,2021-11-25,07:00:00,312,236,76,FMN GV 16 Berchem TOT
54,Posthofbrug 5366,2021-11-25,08:00:00,472,338,134,FMN GV 16 Berchem TOT
54,Posthofbrug 5366,2021-11-25,09:00:00,190,153,37,FMN GV 16 Berchem TOT
54,Posthofbrug 5366,2021-11-25,10:00:00,111,70,41,FMN GV 16 Berchem TOT
54,Posthofbrug 5366,2021-11-25,11:00:00,94,51,43,FMN GV 16 Berchem TOT
54,Posthofbrug 5366,2021-11-25,12:00:00,103,44,59,FMN GV 16 Berchem TOT
54,Posthofbrug 5366,2021-11-25,13:00:00,124,62,62,FMN GV 16 Berchem TOT
54,Posthofbrug 5366,2021-11-25,14:00:00,111,34,77,FMN GV 16 Berchem TOT
54,Posthofbrug 5366,2021-11-25,15:00:00,217,82,135,FMN GV 16 Berchem TOT
54,Posthofbrug 5366,2021-11-25,16:00:00,314,90,224,FMN GV 16 Berchem TOT
54,Posthofbrug 5366,2021-11-25,17:00:00,386,144,242,FMN GV 16 Berchem TOT
54,Posthofbrug 5366,2021-11-25,18:00:00,257,96,161,FMN GV 16 Berchem TOT
54,Posthofbrug 5366,2021-11-25,19:00:00,157,76,81,FMN GV 16 Berchem TOT
54,Posthofbrug 5366,2021-11-25,20:00:00,83,34,49,FMN GV 16 Berchem TOT
54,Posthofbrug 5366,2021-11-25,21:00:00,73,30,43,FMN GV 16 Berchem TOT
54,Posthofbrug 5366,2021-11-25,22:00:00,59,24,35,FMN GV 16 Berchem TOT
54,Posthofbrug 5366,2021-11-25,23:00:00,53,23,30,FMN GV 16 Berchem TOT
54,Posthofbrug 5366,2021-11-26,00:00:00,23,4,19,FMN GV 16 Berchem TOT
54,Posthofbrug 5366,2021-11-26,01:00:00,16,7,9,FMN GV 16 Berchem TOT
54,Posthofbrug 5366,2021-11-26,02:00:00,8,1,7,FMN GV 16 Berchem TOT
54,Posthofbrug 5366,2021-11-26,03:00:00,1,0,1,FMN GV 16 Berchem TOT
54,Posthofbrug 5366,2021-11-26,04:00:00,14,9,5,FMN GV 16 Berchem TOT
54,Posthofbrug 5366,2021-11-26,05:00:00,27,13,14,FMN GV 16 Berchem TOT
54,Posthofbrug 5366,2021-11-26,06:00:00,73,62,11,FMN GV 16 Berchem TOT
54,Posthofbrug 5366,2021-11-26,07:00:00,242,183,59,FMN GV 16 Berchem TOT
54,Posthofbrug 5366,2021-11-26,08:00:00,402,293,109,FMN GV 16 Berchem TOT
54,Posthofbrug 5366,2021-11-26,09:00:00,177,130,47,FMN GV 16 Berchem TOT
54,Posthofbrug 5366,2021-11-26,10:00:00,123,76,47,FMN GV 16 Berchem TOT
54,Posthofbrug 5366,2021-11-26,11:00:00,99,52,47,FMN GV 16 Berchem TOT
54,Posthofbrug 5366,2021-11-26,12:00:00,141,73,68,FMN GV 16 Berchem TOT
54,Posthofbrug 5366,2021-11-26,13:00:00,112,49,63,FMN GV 16 Berchem TOT
54,Posthofbrug 5366,2021-11-26,14:00:00,108,49,59,FMN GV 16 Berchem TOT
54,Posthofbrug 5366,2021-11-26,15:00:00,184,50,134,FMN GV 16 Berchem TOT
54,Posthofbrug 5366,2021-11-26,16:00:00,269,87,182,FMN GV 16 Berchem TOT
54,Posthofbrug 5366,2021-11-26,17:00:00,232,83,149,FMN GV 16 Berchem TOT
54,Posthofbrug 5366,2021-11-26,18:00:00,170,59,111,FMN GV 16 Berchem TOT
54,Posthofbrug 5366,2021-11-26,19:00:00,91,48,43,FMN GV 16 Berchem TOT
54,Posthofbrug 5366,2021-11-26,20:00:00,46,24,22,FMN GV 16 Berchem TOT
54,Posthofbrug 5366,2021-11-26,21:00:00,43,19,24,FMN GV 16 Berchem TOT
54,Posthofbrug 5366,2021-11-26,22:00:00,46,18,28,FMN GV 16 Berchem TOT
54,Posthofbrug 5366,2021-11-26,23:00:00,41,12,29,FMN GV 16 Berchem TOT
54,Posthofbrug 5366,2021-11-27,00:00:00,34,8,26,FMN GV 16 Berchem TOT
54,Posthofbrug 5366,2021-11-27,01:00:00,37,11,26,FMN GV 16 Berchem TOT
54,Posthofbrug 5366,2021-11-27,02:00:00,17,4,13,FMN GV 16 Berchem TOT
54,Posthofbrug 5366,2021-11-27,03:00:00,10,6,4,FMN GV 16 Berchem TOT
54,Posthofbrug 5366,2021-11-27,04:00:00,11,4,7,FMN GV 16 Berchem TOT
54,Posthofbrug 5366,2021-11-27,05:00:00,14,8,6,FMN GV 16 Berchem TOT
54,Posthofbrug 5366,2021-11-27,06:00:00,26,11,15,FMN GV 16 Berchem TOT
54,Posthofbrug 5366,2021-11-27,07:00:00,20,10,10,FMN GV 16 Berchem TOT
54,Posthofbrug 5366,2021-11-27,08:00:00,59,34,25,FMN GV 16 Berchem TOT
54,Posthofbrug 5366,2021-11-27,09:00:00,78,57,21,FMN GV 16 Berchem TOT
54,Posthofbrug 5366,2021-11-27,10:00:00,107,59,48,FMN GV 16 Berchem TOT
54,Posthofbrug 5366,2021-11-27,11:00:00,133,80,53,FMN GV 16 Berchem TOT
54,Posthofbrug 5366,2021-11-27,12:00:00,116,69,47,FMN GV 16 Berchem TOT
54,Posthofbrug 5366,2021-11-27,13:00:00,138,78,60,FMN GV 16 Berchem TOT
54,Posthofbrug 5366,2021-11-27,14:00:00,162,86,76,FMN GV 16 Berchem TOT
54,Posthofbrug 5366,2021-11-27,15:00:00,110,51,59,FMN GV 16 Berchem TOT
54,Posthofbrug 5366,2021-11-27,16:00:00,126,47,79,FMN GV 16 Berchem TOT
54,Posthofbrug 5366,2021-11-27,17:00:00,109,56,53,FMN GV 16 Berchem TOT
54,Posthofbrug 5366,2021-11-27,18:00:00,94,46,48,FMN GV 16 Berchem TOT
54,Posthofbrug 5366,2021-11-27,19:00:00,69,32,37,FMN GV 16 Berchem TOT
54,Posthofbrug 5366,2021-11-27,20:00:00,37,18,19,FMN GV 16 Berchem TOT
54,Posthofbrug 5366,2021-11-27,21:00:00,43,21,22,FMN GV 16 Berchem TOT
54,Posthofbrug 5366,2021-11-27,22:00:00,48,34,14,FMN GV 16 Berchem TOT
54,Posthofbrug 5366,2021-11-27,23:00:00,59,21,38,FMN GV 16 Berchem TOT
54,Posthofbrug 5366,2021-11-28,00:00:00,41,14,27,FMN GV 16 Berchem TOT
54,Posthofbrug 5366,2021-11-28,01:00:00,20,7,13,FMN GV 16 Berchem TOT
54,Posthofbrug 5366,2021-11-28,02:00:00,16,8,8,FMN GV 16 Berchem TOT
54,Posthofbrug 5366,2021-11-28,03:00:00,11,4,7,FMN GV 16 Berchem TOT
54,Posthofbrug 5366,2021-11-28,04:00:00,5,1,4,FMN GV 16 Berchem TOT
54,Posthofbrug 5366,2021-11-28,05:00:00,11,9,2,FMN GV 16 Berchem TOT
54,Posthofbrug 5366,2021-11-28,06:00:00,10,10,0,FMN GV 16 Berchem TOT
54,Posthofbrug 5366,2021-11-28,07:00:00,21,15,6,FMN GV 16 Berchem TOT
54,Posthofbrug 5366,2021-11-28,08:00:00,38,18,20,FMN GV 16 Berchem TOT
54,Posthofbrug 5366,2021-11-28,09:00:00,69,45,24,FMN GV 16 Berchem TOT
54,Posthofbrug 5366,2021-11-28,10:00:00,80,49,31,FMN GV 16 Berchem TOT
54,Posthofbrug 5366,2021-11-28,11:00:00,102,52,50,FMN GV 16 Berchem TOT
54,Posthofbrug 5366,2021-11-28,12:00:00,78,36,42,FMN GV 16 Berchem TOT
54,Posthofbrug 5366,2021-11-28,13:00:00,61,24,37,FMN GV 16 Berchem TOT
54,Posthofbrug 5366,2021-11-28,14:00:00,77,42,35,FMN GV 16 Berchem TOT
54,Posthofbrug 5366,2021-11-28,15:00:00,62,33,29,FMN GV 16 Berchem TOT
54,Posthofbrug 5366,2021-11-28,16:00:00,75,34,41,FMN GV 16 Berchem TOT
54,Posthofbrug 5366,2021-11-28,17:00:00,67,28,39,FMN GV 16 Berchem TOT
54,Posthofbrug 5366,2021-11-28,18:00:00,61,30,31,FMN GV 16 Berchem TOT
54,Posthofbrug 5366,2021-11-28,19:00:00,46,25,21,FMN GV 16 Berchem TOT
54,Posthofbrug 5366,2021-11-28,20:00:00,46,25,21,FMN GV 16 Berchem TOT
54,Posthofbrug 5366,2021-11-28,21:00:00,30,17,13,FMN GV 16 Berchem TOT
54,Posthofbrug 5366,2021-11-28,22:00:00,21,11,10,FMN GV 16 Berchem TOT
54,Posthofbrug 5366,2021-11-28,23:00:00,16,6,10,FMN GV 16 Berchem TOT
54,Posthofbrug 5366,2021-11-29,00:00:00,7,2,5,FMN GV 16 Berchem TOT
54,Posthofbrug 5366,2021-11-29,01:00:00,4,0,4,FMN GV 16 Berchem TOT
54,Posthofbrug 5366,2021-11-29,02:00:00,2,0,2,FMN GV 16 Berchem TOT
54,Posthofbrug 5366,2021-11-29,03:00:00,2,2,0,FMN GV 16 Berchem TOT
54,Posthofbrug 5366,2021-11-29,04:00:00,16,14,2,FMN GV 16 Berchem TOT
54,Posthofbrug 5366,2021-11-29,05:00:00,23,14,9,FMN GV 16 Berchem TOT
54,Posthofbrug 5366,2021-11-29,06:00:00,76,65,11,FMN GV 16 Berchem TOT
54,Posthofbrug 5366,2021-11-29,07:00:00,276,198,78,FMN GV 16 Berchem TOT
54,Posthofbrug 5366,2021-11-29,08:00:00,487,367,120,FMN GV 16 Berchem TOT
54,Posthofbrug 5366,2021-11-29,09:00:00,165,135,30,FMN GV 16 Berchem TOT
54,Posthofbrug 5366,2021-11-29,10:00:00,111,65,46,FMN GV 16 Berchem TOT
54,Posthofbrug 5366,2021-11-29,11:00:00,87,52,35,FMN GV 16 Berchem TOT
54,Posthofbrug 5366,2021-11-29,12:00:00,139,72,67,FMN GV 16 Berchem TOT
54,Posthofbrug 5366,2021-11-29,13:00:00,139,70,69,FMN GV 16 Berchem TOT
54,Posthofbrug 5366,2021-11-29,14:00:00,104,45,59,FMN GV 16 Berchem TOT
54,Posthofbrug 5366,2021-11-29,15:00:00,194,79,115,FMN GV 16 Berchem TOT
54,Posthofbrug 5366,2021-11-29,16:00:00,334,114,220,FMN GV 16 Berchem TOT
54,Posthofbrug 5366,2021-11-29,17:00:00,341,105,236,FMN GV 16 Berchem TOT
54,Posthofbrug 5366,2021-11-29,18:00:00,240,85,155,FMN GV 16 Berchem TOT
54,Posthofbrug 5366,2021-11-29,19:00:00,114,36,78,FMN GV 16 Berchem TOT
54,Posthofbrug 5366,2021-11-29,20:00:00,83,45,38,FMN GV 16 Berchem TOT
54,Posthofbrug 5366,2021-11-29,21:00:00,62,22,40,FMN GV 16 Berchem TOT
54,Posthofbrug 5366,2021-11-29,22:00:00,63,29,34,FMN GV 16 Berchem TOT
54,Posthofbrug 5366,2021-11-29,23:00:00,24,5,19,FMN GV 16 Berchem TOT
54,Posthofbrug 5366,2021-11-30,00:00:00,5,0,5,FMN GV 16 Berchem TOT
54,Posthofbrug 5366,2021-11-30,01:00:00,9,4,5,FMN GV 16 Berchem TOT
54,Posthofbrug 5366,2021-11-30,02:00:00,1,1,0,FMN GV 16 Berchem TOT
54,Posthofbrug 5366,2021-11-30,03:00:00,2,1,1,FMN GV 16 Berchem TOT
54,Posthofbrug 5366,2021-11-30,04:00:00,6,5,1,FMN GV 16 Berchem TOT
54,Posthofbrug 5366,2021-11-30,05:00:00,22,14,8,FMN GV 16 Berchem TOT
54,Posthofbrug 5366,2021-11-30,06:00:00,71,59,12,FMN GV 16 Berchem TOT
54,Posthofbrug 5366,2021-11-30,07:00:00,269,199,70,FMN GV 16 Berchem TOT
54,Posthofbrug 5366,2021-11-30,08:00:00,428,326,102,FMN GV 16 Berchem TOT
54,Posthofbrug 5366,2021-11-30,09:00:00,136,113,23,FMN GV 16 Berchem TOT
54,Posthofbrug 5366,2021-11-30,10:00:00,70,40,30,FMN GV 16 Berchem TOT
54,Posthofbrug 5366,2021-11-30,11:00:00,60,32,28,FMN GV 16 Berchem TOT
54,Posthofbrug 5366,2021-11-30,12:00:00,87,53,34,FMN GV 16 Berchem TOT
54,Posthofbrug 5366,2021-11-30,13:00:00,98,46,52,FMN GV 16 Berchem TOT
54,Posthofbrug 5366,2021-11-30,14:00:00,78,24,54,FMN GV 16 Berchem TOT
54,Posthofbrug 5366,2021-11-30,15:00:00,129,40,89,FMN GV 16 Berchem TOT
54,Posthofbrug 5366,2021-11-30,16:00:00,268,92,176,FMN GV 16 Berchem TOT
54,Posthofbrug 5366,2021-11-30,17:00:00,306,109,197,FMN GV 16 Berchem TOT
54,Posthofbrug 5366,2021-11-30,18:00:00,209,74,135,FMN GV 16 Berchem TOT
54,Posthofbrug 5366,2021-11-30,19:00:00,124,54,70,FMN GV 16 Berchem TOT
54,Posthofbrug 5366,2021-11-30,20:00:00,60,20,40,FMN GV 16 Berchem TOT
54,Posthofbrug 5366,2021-11-30,21:00:00,64,28,36,FMN GV 16 Berchem TOT
54,Posthofbrug 5366,2021-11-30,22:00:00,59,26,33,FMN GV 16 Berchem TOT
54,Posthofbrug 5366,2021-11-30,23:00:00,61,20,41,FMN GV 16 Berchem TOT
54,Posthofbrug 5366,2021-12-01,00:00:00,8,3,5,FMN GV 16 Berchem TOT
54,Posthofbrug 5366,2021-12-01,01:00:00,6,0,6,FMN GV 16 Berchem TOT
54,Posthofbrug 5366,2021-12-01,02:00:00,1,1,0,FMN GV 16 Berchem TOT
54,Posthofbrug 5366,2021-12-01,03:00:00,3,2,1,FMN GV 16 Berchem TOT
54,Posthofbrug 5366,2021-12-01,04:00:00,6,6,0,FMN GV 16 Berchem TOT
54,Posthofbrug 5366,2021-12-01,05:00:00,19,8,11,FMN GV 16 Berchem TOT
54,Posthofbrug 5366,2021-12-01,06:00:00,60,50,10,FMN GV 16 Berchem TOT
54,Posthofbrug 5366,2021-12-01,07:00:00,237,178,59,FMN GV 16 Berchem TOT
54,Posthofbrug 5366,2021-12-01,08:00:00,338,252,86,FMN GV 16 Berchem TOT
54,Posthofbrug 5366,2021-12-01,09:00:00,144,104,40,FMN GV 16 Berchem TOT
54,Posthofbrug 5366,2021-12-01,10:00:00,62,43,19,FMN GV 16 Berchem TOT
54,Posthofbrug 5366,2021-12-01,11:00:00,84,45,39,FMN GV 16 Berchem TOT
54,Posthofbrug 5366,2021-12-01,12:00:00,193,69,124,FMN GV 16 Berchem TOT
54,Posthofbrug 5366,2021-12-01,13:00:00,131,53,78,FMN GV 16 Berchem TOT
54,Posthofbrug 5366,2021-12-01,14:00:00,91,38,53,FMN GV 16 Berchem TOT
54,Posthofbrug 5366,2021-12-01,15:00:00,143,58,85,FMN GV 16 Berchem TOT
54,Posthofbrug 5366,2021-12-01,16:00:00,191,73,118,FMN GV 16 Berchem TOT
54,Posthofbrug 5366,2021-12-01,17:00:00,282,107,175,FMN GV 16 Berchem TOT
54,Posthofbrug 5366,2021-12-01,18:00:00,189,75,114,FMN GV 16 Berchem TOT
54,Posthofbrug 5366,2021-12-01,19:00:00,97,41,56,FMN GV 16 Berchem TOT
54,Posthofbrug 5366,2021-12-01,20:00:00,59,26,33,FMN GV 16 Berchem TOT
54,Posthofbrug 5366,2021-12-01,21:00:00,37,17,20,FMN GV 16 Berchem TOT
54,Posthofbrug 5366,2021-12-01,22:00:00,54,16,38,FMN GV 16 Berchem TOT
54,Posthofbrug 5366,2021-12-01,23:00:00,48,16,32,FMN GV 16 Berchem TOT
54,Posthofbrug 5366,2021-12-02,00:00:00,9,5,4,FMN GV 16 Berchem TOT
54,Posthofbrug 5366,2021-12-02,01:00:00,7,0,7,FMN GV 16 Berchem TOT
54,Posthofbrug 5366,2021-12-02,02:00:00,2,0,2,FMN GV 16 Berchem TOT
54,Posthofbrug 5366,2021-12-02,03:00:00,4,1,3,FMN GV 16 Berchem TOT
54,Posthofbrug 5366,2021-12-02,04:00:00,8,6,2,FMN GV 16 Berchem TOT
54,Posthofbrug 5366,2021-12-02,05:00:00,18,12,6,FMN GV 16 Berchem TOT
54,Posthofbrug 5366,2021-12-02,06:00:00,74,62,12,FMN GV 16 Berchem TOT
54,Posthofbrug 5366,2021-12-02,07:00:00,232,182,50,FMN GV 16 Berchem TOT
54,Posthofbrug 5366,2021-12-02,08:00:00,372,284,88,FMN GV 16 Berchem TOT
54,Posthofbrug 5366,2021-12-02,09:00:00,123,100,23,FMN GV 16 Berchem TOT
54,Posthofbrug 5366,2021-12-02,10:00:00,55,36,19,FMN GV 16 Berchem TOT
54,Posthofbrug 5366,2021-12-02,11:00:00,48,29,19,FMN GV 16 Berchem TOT
54,Posthofbrug 5366,2021-12-02,12:00:00,110,61,49,FMN GV 16 Berchem TOT
54,Posthofbrug 5366,2021-12-02,13:00:00,76,38,38,FMN GV 16 Berchem TOT
54,Posthofbrug 5366,2021-12-02,14:00:00,66,19,47,FMN GV 16 Berchem TOT
54,Posthofbrug 5366,2021-12-02,15:00:00,160,53,107,FMN GV 16 Berchem TOT
54,Posthofbrug 5366,2021-12-02,16:00:00,266,89,177,FMN GV 16 Berchem TOT
54,Posthofbrug 5366,2021-12-02,17:00:00,260,79,181,FMN GV 16 Berchem TOT
54,Posthofbrug 5366,2021-12-02,18:00:00,188,64,124,FMN GV 16 Berchem TOT
54,Posthofbrug 5366,2021-12-02,19:00:00,92,31,61,FMN GV 16 Berchem TOT
54,Posthofbrug 5366,2021-12-02,20:00:00,69,36,33,FMN GV 16 Berchem TOT
54,Posthofbrug 5366,2021-12-02,21:00:00,45,24,21,FMN GV 16 Berchem TOT
54,Posthofbrug 5366,2021-12-02,22:00:00,69,31,38,FMN GV 16 Berchem TOT
54,Posthofbrug 5366,2021-12-02,23:00:00,50,10,40,FMN GV 16 Berchem TOT
54,Posthofbrug 5366,2021-12-03,00:00:00,14,5,9,FMN GV 16 Berchem TOT
54,Posthofbrug 5366,2021-12-03,01:00:00,5,0,5,FMN GV 16 Berchem TOT
54,Posthofbrug 5366,2021-12-03,02:00:00,4,1,3,FMN GV 16 Berchem TOT
54,Posthofbrug 5366,2021-12-03,03:00:00,4,1,3,FMN GV 16 Berchem TOT
54,Posthofbrug 5366,2021-12-03,04:00:00,7,7,0,FMN GV 16 Berchem TOT
54,Posthofbrug 5366,2021-12-03,05:00:00,16,9,7,FMN GV 16 Berchem TOT
54,Posthofbrug 5366,2021-12-03,06:00:00,58,47,11,FMN GV 16 Berchem TOT
54,Posthofbrug 5366,2021-12-03,07:00:00,205,156,49,FMN GV 16 Berchem TOT
54,Posthofbrug 5366,2021-12-03,08:00:00,337,257,80,FMN GV 16 Berchem TOT
54,Posthofbrug 5366,2021-12-03,09:00:00,163,121,42,FMN GV 16 Berchem TOT
54,Posthofbrug 5366,2021-12-03,10:00:00,87,50,37,FMN GV 16 Berchem TOT
54,Posthofbrug 5366,2021-12-03,11:00:00,75,41,34,FMN GV 16 Berchem TOT
54,Posthofbrug 5366,2021-12-03,12:00:00,132,73,59,FMN GV 16 Berchem TOT
54,Posthofbrug 5366,2021-12-03,13:00:00,102,48,54,FMN GV 16 Berchem TOT
54,Posthofbrug 5366,2021-12-03,14:00:00,111,42,69,FMN GV 16 Berchem TOT
54,Posthofbrug 5366,2021-12-03,15:00:00,172,74,98,FMN GV 16 Berchem TOT
54,Posthofbrug 5366,2021-12-03,16:00:00,264,87,177,FMN GV 16 Berchem TOT
54,Posthofbrug 5366,2021-12-03,17:00:00,228,85,143,FMN GV 16 Berchem TOT
54,Posthofbrug 5366,2021-12-03,18:00:00,174,66,108,FMN GV 16 Berchem TOT
54,Posthofbrug 5366,2021-12-03,19:00:00,120,65,55,FMN GV 16 Berchem TOT
54,Posthofbrug 5366,2021-12-03,20:00:00,80,42,38,FMN GV 16 Berchem TOT
54,Posthofbrug 5366,2021-12-03,21:00:00,49,24,25,FMN GV 16 Berchem TOT
54,Posthofbrug 5366,2021-12-03,22:00:00,54,18,36,FMN GV 16 Berchem TOT
54,Posthofbrug 5366,2021-12-03,23:00:00,81,19,62,FMN GV 16 Berchem TOT
54,Posthofbrug 5366,2021-12-04,00:00:00,28,9,19,FMN GV 16 Berchem TOT
54,Posthofbrug 5366,2021-12-04,01:00:00,23,8,15,FMN GV 16 Berchem TOT
54,Posthofbrug 5366,2021-12-04,02:00:00,12,3,9,FMN GV 16 Berchem TOT
54,Posthofbrug 5366,2021-12-04,03:00:00,9,4,5,FMN GV 16 Berchem TOT
54,Posthofbrug 5366,2021-12-04,04:00:00,12,4,8,FMN GV 16 Berchem TOT
54,Posthofbrug 5366,2021-12-04,05:00:00,7,5,2,FMN GV 16 Berchem TOT
54,Posthofbrug 5366,2021-12-04,06:00:00,11,8,3,FMN GV 16 Berchem TOT
54,Posthofbrug 5366,2021-12-04,07:00:00,28,16,12,FMN GV 16 Berchem TOT
54,Posthofbrug 5366,2021-12-04,08:00:00,40,19,21,FMN GV 16 Berchem TOT
54,Posthofbrug 5366,2021-12-04,09:00:00,89,60,29,FMN GV 16 Berchem TOT
54,Posthofbrug 5366,2021-12-04,10:00:00,72,43,29,FMN GV 16 Berchem TOT
54,Posthofbrug 5366,2021-12-04,11:00:00,97,58,39,FMN GV 16 Berchem TOT
54,Posthofbrug 5366,2021-12-04,12:00:00,74,32,42,FMN GV 16 Berchem TOT
54,Posthofbrug 5366,2021-12-04,13:00:00,68,35,33,FMN GV 16 Berchem TOT
54,Posthofbrug 5366,2021-12-04,14:00:00,62,31,31,FMN GV 16 Berchem TOT
54,Posthofbrug 5366,2021-12-04,15:00:00,61,32,29,FMN GV 16 Berchem TOT
54,Posthofbrug 5366,2021-12-04,16:00:00,78,30,48,FMN GV 16 Berchem TOT
54,Posthofbrug 5366,2021-12-04,17:00:00,103,52,51,FMN GV 16 Berchem TOT
54,Posthofbrug 5366,2021-12-04,18:00:00,79,35,44,FMN GV 16 Berchem TOT
54,Posthofbrug 5366,2021-12-04,19:00:00,68,45,23,FMN GV 16 Berchem TOT
54,Posthofbrug 5366,2021-12-04,20:00:00,40,23,17,FMN GV 16 Berchem TOT
54,Posthofbrug 5366,2021-12-04,21:00:00,38,22,16,FMN GV 16 Berchem TOT
54,Posthofbrug 5366,2021-12-04,22:00:00,41,18,23,FMN GV 16 Berchem TOT
54,Posthofbrug 5366,2021-12-04,23:00:00,63,25,38,FMN GV 16 Berchem TOT
54,Posthofbrug 5366,2021-12-05,00:00:00,25,8,17,FMN GV 16 Berchem TOT
54,Posthofbrug 5366,2021-12-05,01:00:00,16,9,7,FMN GV 16 Berchem TOT
54,Posthofbrug 5366,2021-12-05,02:00:00,16,10,6,FMN GV 16 Berchem TOT
54,Posthofbrug 5366,2021-12-05,03:00:00,15,7,8,FMN GV 16 Berchem TOT
54,Posthofbrug 5366,2021-12-05,04:00:00,5,2,3,FMN GV 16 Berchem TOT
54,Posthofbrug 5366,2021-12-05,05:00:00,2,2,0,FMN GV 16 Berchem TOT
54,Posthofbrug 5366,2021-12-05,06:00:00,8,8,0,FMN GV 16 Berchem TOT
54,Posthofbrug 5366,2021-12-05,07:00:00,18,14,4,FMN GV 16 Berchem TOT
54,Posthofbrug 5366,2021-12-05,08:00:00,29,18,11,FMN GV 16 Berchem TOT
54,Posthofbrug 5366,2021-12-05,09:00:00,68,41,27,FMN GV 16 Berchem TOT
54,Posthofbrug 5366,2021-12-05,10:00:00,75,44,31,FMN GV 16 Berchem TOT
54,Posthofbrug 5366,2021-12-05,11:00:00,78,47,31,FMN GV 16 Berchem TOT
54,Posthofbrug 5366,2021-12-05,12:00:00,114,67,47,FMN GV 16 Berchem TOT
54,Posthofbrug 5366,2021-12-05,13:00:00,116,71,45,FMN GV 16 Berchem TOT
54,Posthofbrug 5366,2021-12-05,14:00:00,127,67,60,FMN GV 16 Berchem TOT
54,Posthofbrug 5366,2021-12-05,15:00:00,101,48,53,FMN GV 16 Berchem TOT
54,Posthofbrug 5366,2021-12-05,16:00:00,119,53,66,FMN GV 16 Berchem TOT
54,Posthofbrug 5366,2021-12-05,17:00:00,95,40,55,FMN GV 16 Berchem TOT
54,Posthofbrug 5366,2021-12-05,18:00:00,87,35,52,FMN GV 16 Berchem TOT
54,Posthofbrug 5366,2021-12-05,19:00:00,50,26,24,FMN GV 16 Berchem TOT
54,Posthofbrug 5366,2021-12-05,20:00:00,50,28,22,FMN GV 16 Berchem TOT
54,Posthofbrug 5366,2021-12-05,21:00:00,48,24,24,FMN GV 16 Berchem TOT
54,Posthofbrug 5366,2021-12-05,22:00:00,50,26,24,FMN GV 16 Berchem TOT
54,Posthofbrug 5366,2021-12-05,23:00:00,17,6,11,FMN GV 16 Berchem TOT
54,Posthofbrug 5366,2021-12-06,00:00:00,10,7,3,FMN GV 16 Berchem TOT
54,Posthofbrug 5366,2021-12-06,01:00:00,2,1,1,FMN GV 16 Berchem TOT
54,Posthofbrug 5366,2021-12-06,02:00:00,0,0,0,FMN GV 16 Berchem TOT
54,Posthofbrug 5366,2021-12-06,03:00:00,1,1,0,FMN GV 16 Berchem TOT
54,Posthofbrug 5366,2021-12-06,04:00:00,11,11,0,FMN GV 16 Berchem TOT
54,Posthofbrug 5366,2021-12-06,05:00:00,19,15,4,FMN GV 16 Berchem TOT
54,Posthofbrug 5366,2021-12-06,06:00:00,82,74,8,FMN GV 16 Berchem TOT
54,Posthofbrug 5366,2021-12-06,07:00:00,270,203,67,FMN GV 16 Berchem TOT
54,Posthofbrug 5366,2021-12-06,08:00:00,439,322,117,FMN GV 16 Berchem TOT
54,Posthofbrug 5366,2021-12-06,09:00:00,166,125,41,FMN GV 16 Berchem TOT
54,Posthofbrug 5366,2021-12-06,10:00:00,96,66,30,FMN GV 16 Berchem TOT
54,Posthofbrug 5366,2021-12-06,11:00:00,81,41,40,FMN GV 16 Berchem TOT
54,Posthofbrug 5366,2021-12-06,12:00:00,153,83,70,FMN GV 16 Berchem TOT
54,Posthofbrug 5366,2021-12-06,13:00:00,121,59,62,FMN GV 16 Berchem TOT
54,Posthofbrug 5366,2021-12-06,14:00:00,101,40,61,FMN GV 16 Berchem TOT
54,Posthofbrug 5366,2021-12-06,15:00:00,170,50,120,FMN GV 16 Berchem TOT
54,Posthofbrug 5366,2021-12-06,16:00:00,285,89,196,FMN GV 16 Berchem TOT
54,Posthofbrug 5366,2021-12-06,17:00:00,309,97,212,FMN GV 16 Berchem TOT
54,Posthofbrug 5366,2021-12-06,18:00:00,186,64,122,FMN GV 16 Berchem TOT
54,Posthofbrug 5366,2021-12-06,19:00:00,93,42,51,FMN GV 16 Berchem TOT
54,Posthofbrug 5366,2021-12-06,20:00:00,45,12,33,FMN GV 16 Berchem TOT
54,Posthofbrug 5366,2021-12-06,21:00:00,47,13,34,FMN GV 16 Berchem TOT
54,Posthofbrug 5366,2021-12-06,22:00:00,50,20,30,FMN GV 16 Berchem TOT
54,Posthofbrug 5366,2021-12-06,23:00:00,34,17,17,FMN GV 16 Berchem TOT
54,Posthofbrug 5366,2021-12-07,00:00:00,3,2,1,FMN GV 16 Berchem TOT
54,Posthofbrug 5366,2021-12-07,01:00:00,1,0,1,FMN GV 16 Berchem TOT
54,Posthofbrug 5366,2021-12-07,02:00:00,0,0,0,FMN GV 16 Berchem TOT
54,Posthofbrug 5366,2021-12-07,03:00:00,3,1,2,FMN GV 16 Berchem TOT
54,Posthofbrug 5366,2021-12-07,04:00:00,6,6,0,FMN GV 16 Berchem TOT
54,Posthofbrug 5366,2021-12-07,05:00:00,22,18,4,FMN GV 16 Berchem TOT
54,Posthofbrug 5366,2021-12-07,06:00:00,71,64,7,FMN GV 16 Berchem TOT
54,Posthofbrug 5366,2021-12-07,07:00:00,291,213,78,FMN GV 16 Berchem TOT
54,Posthofbrug 5366,2021-12-07,08:00:00,471,352,119,FMN GV 16 Berchem TOT
54,Posthofbrug 5366,2021-12-07,09:00:00,160,121,39,FMN GV 16 Berchem TOT
54,Posthofbrug 5366,2021-12-07,10:00:00,91,62,29,FMN GV 16 Berchem TOT
54,Posthofbrug 5366,2021-12-07,11:00:00,102,56,46,FMN GV 16 Berchem TOT
54,Posthofbrug 5366,2021-12-07,12:00:00,146,75,71,FMN GV 16 Berchem TOT
54,Posthofbrug 5366,2021-12-07,13:00:00,138,81,57,FMN GV 16 Berchem TOT
54,Posthofbrug 5366,2021-12-07,14:00:00,123,54,69,FMN GV 16 Berchem TOT
54,Posthofbrug 5366,2021-12-07,15:00:00,196,58,138,FMN GV 16 Berchem TOT
54,Posthofbrug 5366,2021-12-07,16:00:00,331,88,243,FMN GV 16 Berchem TOT
54,Posthofbrug 5366,2021-12-07,17:00:00,356,142,214,FMN GV 16 Berchem TOT
54,Posthofbrug 5366,2021-12-07,18:00:00,221,86,135,FMN GV 16 Berchem TOT
54,Posthofbrug 5366,2021-12-07,19:00:00,125,49,76,FMN GV 16 Berchem TOT
54,Posthofbrug 5366,2021-12-07,20:00:00,73,25,48,FMN GV 16 Berchem TOT
54,Posthofbrug 5366,2021-12-07,21:00:00,67,26,41,FMN GV 16 Berchem TOT
54,Posthofbrug 5366,2021-12-07,22:00:00,46,19,27,FMN GV 16 Berchem TOT
54,Posthofbrug 5366,2021-12-07,23:00:00,43,17,26,FMN GV 16 Berchem TOT
54,Posthofbrug 5366,2021-12-08,00:00:00,9,4,5,FMN GV 16 Berchem TOT
54,Posthofbrug 5366,2021-12-08,01:00:00,5,0,5,FMN GV 16 Berchem TOT
54,Posthofbrug 5366,2021-12-08,02:00:00,5,2,3,FMN GV 16 Berchem TOT
54,Posthofbrug 5366,2021-12-08,03:00:00,1,1,0,FMN GV 16 Berchem TOT
54,Posthofbrug 5366,2021-12-08,04:00:00,7,6,1,FMN GV 16 Berchem TOT
54,Posthofbrug 5366,2021-12-08,05:00:00,21,17,4,FMN GV 16 Berchem TOT
54,Posthofbrug 5366,2021-12-08,06:00:00,73,62,11,FMN GV 16 Berchem TOT
54,Posthofbrug 5366,2021-12-08,07:00:00,279,206,73,FMN GV 16 Berchem TOT
54,Posthofbrug 5366,2021-12-08,08:00:00,426,306,120,FMN GV 16 Berchem TOT
54,Posthofbrug 5366,2021-12-08,09:00:00,153,112,41,FMN GV 16 Berchem TOT
54,Posthofbrug 5366,2021-12-08,10:00:00,101,67,34,FMN GV 16 Berchem TOT
54,Posthofbrug 5366,2021-12-08,11:00:00,108,57,51,FMN GV 16 Berchem TOT
54,Posthofbrug 5366,2021-12-08,12:00:00,191,78,113,FMN GV 16 Berchem TOT
54,Posthofbrug 5366,2021-12-08,13:00:00,163,86,77,FMN GV 16 Berchem TOT
54,Posthofbrug 5366,2021-12-08,14:00:00,8,1,7,FMN GV 16 Berchem TOT
54,Posthofbrug 5366,2021-12-08,15:00:00,0,0,0,FMN GV 16 Berchem TOT
54,Posthofbrug 5366,2021-12-08,16:00:00,0,0,0,FMN GV 16 Berchem TOT
54,Posthofbrug 5366,2021-12-08,17:00:00,0,0,0,FMN GV 16 Berchem TOT
54,Posthofbrug 5366,2021-12-08,18:00:00,0,0,0,FMN GV 16 Berchem TOT
54,Posthofbrug 5366,2021-12-08,19:00:00,0,0,0,FMN GV 16 Berchem TOT
54,Posthofbrug 5366,2021-12-08,20:00:00,0,0,0,FMN GV 16 Berchem TOT
54,Posthofbrug 5366,2021-12-08,21:00:00,0,0,0,FMN GV 16 Berchem TOT
54,Posthofbrug 5366,2021-12-08,22:00:00,64,17,47,FMN GV 16 Berchem TOT
54,Posthofbrug 5366,2021-12-08,23:00:00,65,26,39,FMN GV 16 Berchem TOT
54,Posthofbrug 5366,2021-12-09,00:00:00,10,3,7,FMN GV 16 Berchem TOT
54,Posthofbrug 5366,2021-12-09,01:00:00,10,5,5,FMN GV 16 Berchem TOT
54,Posthofbrug 5366,2021-12-09,02:00:00,7,1,6,FMN GV 16 Berchem TOT
54,Posthofbrug 5366,2021-12-09,03:00:00,1,0,1,FMN GV 16 Berchem TOT
54,Posthofbrug 5366,2021-12-09,04:00:00,5,4,1,FMN GV 16 Berchem TOT
54,Posthofbrug 5366,2021-12-09,05:00:00,28,23,5,FMN GV 16 Berchem TOT
54,Posthofbrug 5366,2021-12-09,06:00:00,62,57,5,FMN GV 16 Berchem TOT
54,Posthofbrug 5366,2021-12-09,07:00:00,264,199,65,FMN GV 16 Berchem TOT
54,Posthofbrug 5366,2021-12-09,08:00:00,440,338,102,FMN GV 16 Berchem TOT
54,Posthofbrug 5366,2021-12-09,09:00:00,179,144,35,FMN GV 16 Berchem TOT
54,Posthofbrug 5366,2021-12-09,10:00:00,74,42,32,FMN GV 16 Berchem TOT
54,Posthofbrug 5366,2021-12-09,11:00:00,88,55,33,FMN GV 16 Berchem TOT
54,Posthofbrug 5366,2021-12-09,12:00:00,128,67,61,FMN GV 16 Berchem TOT
54,Posthofbrug 5366,2021-12-09,13:00:00,130,78,52,FMN GV 16 Berchem TOT
54,Posthofbrug 5366,2021-12-09,14:00:00,105,40,65,FMN GV 16 Berchem TOT
54,Posthofbrug 5366,2021-12-09,15:00:00,170,55,115,FMN GV 16 Berchem TOT
54,Posthofbrug 5366,2021-12-09,16:00:00,242,69,173,FMN GV 16 Berchem TOT
54,Posthofbrug 5366,2021-12-09,17:00:00,341,116,225,FMN GV 16 Berchem TOT
54,Posthofbrug 5366,2021-12-09,18:00:00,208,64,144,FMN GV 16 Berchem TOT
54,Posthofbrug 5366,2021-12-09,19:00:00,131,55,76,FMN GV 16 Berchem TOT
54,Posthofbrug 5366,2021-12-09,20:00:00,69,28,41,FMN GV 16 Berchem TOT
54,Posthofbrug 5366,2021-12-09,21:00:00,72,34,38,FMN GV 16 Berchem TOT
54,Posthofbrug 5366,2021-12-09,22:00:00,70,21,49,FMN GV 16 Berchem TOT
54,Posthofbrug 5366,2021-12-09,23:00:00,53,19,34,FMN GV 16 Berchem TOT
54,Posthofbrug 5366,2021-12-10,00:00:00,18,6,12,FMN GV 16 Berchem TOT
54,Posthofbrug 5366,2021-12-10,01:00:00,12,4,8,FMN GV 16 Berchem TOT
54,Posthofbrug 5366,2021-12-10,02:00:00,3,0,3,FMN GV 16 Berchem TOT
54,Posthofbrug 5366,2021-12-10,03:00:00,1,1,0,FMN GV 16 Berchem TOT
54,Posthofbrug 5366,2021-12-10,04:00:00,10,5,5,FMN GV 16 Berchem TOT
54,Posthofbrug 5366,2021-12-10,05:00:00,16,13,3,FMN GV 16 Berchem TOT
54,Posthofbrug 5366,2021-12-10,06:00:00,55,46,9,FMN GV 16 Berchem TOT
54,Posthofbrug 5366,2021-12-10,07:00:00,187,137,50,FMN GV 16 Berchem TOT
54,Posthofbrug 5366,2021-12-10,08:00:00,308,232,76,FMN GV 16 Berchem TOT
54,Posthofbrug 5366,2021-12-10,09:00:00,151,115,36,FMN GV 16 Berchem TOT
54,Posthofbrug 5366,2021-12-10,10:00:00,4,4,0,FMN GV 16 Berchem TOT
54,Posthofbrug 5366,2021-12-10,11:00:00,0,0,0,FMN GV 16 Berchem TOT
54,Posthofbrug 5366,2021-12-10,12:00:00,0,0,0,FMN GV 16 Berchem TOT
54,Posthofbrug 5366,2021-12-10,13:00:00,0,0,0,FMN GV 16 Berchem TOT
54,Posthofbrug 5366,2021-12-10,14:00:00,0,0,0,FMN GV 16 Berchem TOT
54,Posthofbrug 5366,2021-12-10,15:00:00,0,0,0,FMN GV 16 Berchem TOT
54,Posthofbrug 5366,2021-12-10,16:00:00,0,0,0,FMN GV 16 Berchem TOT
54,Posthofbrug 5366,2021-12-10,17:00:00,0,0,0,FMN GV 16 Berchem TOT
54,Posthofbrug 5366,2021-12-10,18:00:00,0,0,0,FMN GV 16 Berchem TOT
54,Posthofbrug 5366,2021-12-10,19:00:00,0,0,0,FMN GV 16 Berchem TOT
54,Posthofbrug 5366,2021-12-10,20:00:00,48,28,20,FMN GV 16 Berchem TOT
54,Posthofbrug 5366,2021-12-10,21:00:00,32,21,11,FMN GV 16 Berchem TOT
54,Posthofbrug 5366,2021-12-10,22:00:00,37,20,17,FMN GV 16 Berchem TOT
54,Posthofbrug 5366,2021-12-10,23:00:00,45,10,35,FMN GV 16 Berchem TOT
54,Posthofbrug 5366,2021-12-11,00:00:00,30,8,22,FMN GV 16 Berchem TOT
54,Posthofbrug 5366,2021-12-11,01:00:00,28,9,19,FMN GV 16 Berchem TOT
54,Posthofbrug 5366,2021-12-11,02:00:00,12,6,6,FMN GV 16 Berchem TOT
54,Posthofbrug 5366,2021-12-11,03:00:00,9,5,4,FMN GV 16 Berchem TOT
54,Posthofbrug 5366,2021-12-11,04:00:00,16,8,8,FMN GV 16 Berchem TOT
54,Posthofbrug 5366,2021-12-11,05:00:00,13,7,6,FMN GV 16 Berchem TOT
54,Posthofbrug 5366,2021-12-11,06:00:00,15,10,5,FMN GV 16 Berchem TOT
54,Posthofbrug 5366,2021-12-11,07:00:00,25,17,8,FMN GV 16 Berchem TOT
54,Posthofbrug 5366,2021-12-11,08:00:00,54,35,19,FMN GV 16 Berchem TOT
54,Posthofbrug 5366,2021-12-11,09:00:00,109,64,45,FMN GV 16 Berchem TOT
54,Posthofbrug 5366,2021-12-11,10:00:00,127,76,51,FMN GV 16 Berchem TOT
54,Posthofbrug 5366,2021-12-11,11:00:00,124,69,55,FMN GV 16 Berchem TOT
54,Posthofbrug 5366,2021-12-11,12:00:00,124,67,57,FMN GV 16 Berchem TOT
54,Posthofbrug 5366,2021-12-11,13:00:00,151,90,61,FMN GV 16 Berchem TOT
54,Posthofbrug 5366,2021-12-11,14:00:00,170,101,69,FMN GV 16 Berchem TOT
54,Posthofbrug 5366,2021-12-11,15:00:00,174,97,77,FMN GV 16 Berchem TOT
54,Posthofbrug 5366,2021-12-11,16:00:00,140,61,79,FMN GV 16 Berchem TOT
54,Posthofbrug 5366,2021-12-11,17:00:00,138,57,81,FMN GV 16 Berchem TOT
54,Posthofbrug 5366,2021-12-11,18:00:00,111,56,55,FMN GV 16 Berchem TOT
54,Posthofbrug 5366,2021-12-11,19:00:00,88,43,45,FMN GV 16 Berchem TOT
54,Posthofbrug 5366,2021-12-11,20:00:00,57,37,20,FMN GV 16 Berchem TOT
54,Posthofbrug 5366,2021-12-11,21:00:00,51,28,23,FMN GV 16 Berchem TOT
54,Posthofbrug 5366,2021-12-11,22:00:00,90,51,39,FMN GV 16 Berchem TOT
54,Posthofbrug 5366,2021-12-11,23:00:00,68,20,48,FMN GV 16 Berchem TOT
54,Posthofbrug 5366,2021-12-12,00:00:00,46,12,34,FMN GV 16 Berchem TOT
54,Posthofbrug 5366,2021-12-12,01:00:00,30,8,22,FMN GV 16 Berchem TOT
54,Posthofbrug 5366,2021-12-12,02:00:00,31,13,18,FMN GV 16 Berchem TOT
54,Posthofbrug 5366,2021-12-12,03:00:00,9,6,3,FMN GV 16 Berchem TOT
54,Posthofbrug 5366,2021-12-12,04:00:00,7,6,1,FMN GV 16 Berchem TOT
54,Posthofbrug 5366,2021-12-12,05:00:00,11,9,2,FMN GV 16 Berchem TOT
54,Posthofbrug 5366,2021-12-12,06:00:00,2,2,0,FMN GV 16 Berchem TOT
54,Posthofbrug 5366,2021-12-12,07:00:00,16,7,9,FMN GV 16 Berchem TOT
54,Posthofbrug 5366,2021-12-12,08:00:00,30,19,11,FMN GV 16 Berchem TOT
54,Posthofbrug 5366,2021-12-12,09:00:00,53,31,22,FMN GV 16 Berchem TOT
54,Posthofbrug 5366,2021-12-12,10:00:00,68,39,29,FMN GV 16 Berchem TOT
54,Posthofbrug 5366,2021-12-12,11:00:00,70,44,26,FMN GV 16 Berchem TOT
54,Posthofbrug 5366,2021-12-12,12:00:00,79,46,33,FMN GV 16 Berchem TOT
54,Posthofbrug 5366,2021-12-12,13:00:00,97,51,46,FMN GV 16 Berchem TOT
54,Posthofbrug 5366,2021-12-12,14:00:00,93,46,47,FMN GV 16 Berchem TOT
54,Posthofbrug 5366,2021-12-12,15:00:00,69,41,28,FMN GV 16 Berchem TOT
54,Posthofbrug 5366,2021-12-12,16:00:00,90,32,58,FMN GV 16 Berchem TOT
54,Posthofbrug 5366,2021-12-12,17:00:00,75,35,40,FMN GV 16 Berchem TOT
54,Posthofbrug 5366,2021-12-12,18:00:00,82,40,42,FMN GV 16 Berchem TOT
54,Posthofbrug 5366,2021-12-12,19:00:00,55,28,27,FMN GV 16 Berchem TOT
54,Posthofbrug 5366,2021-12-12,20:00:00,35,23,12,FMN GV 16 Berchem TOT
54,Posthofbrug 5366,2021-12-12,21:00:00,55,24,31,FMN GV 16 Berchem TOT
54,Posthofbrug 5366,2021-12-12,22:00:00,21,12,9,FMN GV 16 Berchem TOT
54,Posthofbrug 5366,2021-12-12,23:00:00,23,9,14,FMN GV 16 Berchem TOT
54,Posthofbrug 5366,2021-12-13,00:00:00,10,4,6,FMN GV 16 Berchem TOT
54,Posthofbrug 5366,2021-12-13,01:00:00,6,2,4,FMN GV 16 Berchem TOT
54,Posthofbrug 5366,2021-12-13,02:00:00,5,2,3,FMN GV 16 Berchem TOT
54,Posthofbrug 5366,2021-12-13,03:00:00,2,1,1,FMN GV 16 Berchem TOT
54,Posthofbrug 5366,2021-12-13,04:00:00,11,10,1,FMN GV 16 Berchem TOT
54,Posthofbrug 5366,2021-12-13,05:00:00,20,14,6,FMN GV 16 Berchem TOT
54,Posthofbrug 5366,2021-12-13,06:00:00,81,65,16,FMN GV 16 Berchem TOT
54,Posthofbrug 5366,2021-12-13,07:00:00,268,192,76,FMN GV 16 Berchem TOT
54,Posthofbrug 5366,2021-12-13,08:00:00,495,374,121,FMN GV 16 Berchem TOT
54,Posthofbrug 5366,2021-12-13,09:00:00,159,128,31,FMN GV 16 Berchem TOT
54,Posthofbrug 5366,2021-12-13,10:00:00,98,66,32,FMN GV 16 Berchem TOT
54,Posthofbrug 5366,2021-12-13,11:00:00,133,61,72,FMN GV 16 Berchem TOT
54,Posthofbrug 5366,2021-12-13,12:00:00,199,104,95,FMN GV 16 Berchem TOT
54,Posthofbrug 5366,2021-12-13,13:00:00,141,62,79,FMN GV 16 Berchem TOT
54,Posthofbrug 5366,2021-12-13,14:00:00,116,42,74,FMN GV 16 Berchem TOT
54,Posthofbrug 5366,2021-12-13,15:00:00,205,97,108,FMN GV 16 Berchem TOT
54,Posthofbrug 5366,2021-12-13,16:00:00,280,82,198,FMN GV 16 Berchem TOT
54,Posthofbrug 5366,2021-12-13,17:00:00,321,101,220,FMN GV 16 Berchem TOT
54,Posthofbrug 5366,2021-12-13,18:00:00,225,66,159,FMN GV 16 Berchem TOT
54,Posthofbrug 5366,2021-12-13,19:00:00,123,65,58,FMN GV 16 Berchem TOT
54,Posthofbrug 5366,2021-12-13,20:00:00,76,29,47,FMN GV 16 Berchem TOT
54,Posthofbrug 5366,2021-12-13,21:00:00,71,22,49,FMN GV 16 Berchem TOT
54,Posthofbrug 5366,2021-12-13,22:00:00,65,24,41,FMN GV 16 Berchem TOT
54,Posthofbrug 5366,2021-12-13,23:00:00,25,12,13,FMN GV 16 Berchem TOT
54,Posthofbrug 5366,2021-12-14,00:00:00,11,2,9,FMN GV 16 Berchem TOT
54,Posthofbrug 5366,2021-12-14,01:00:00,7,3,4,FMN GV 16 Berchem TOT
54,Posthofbrug 5366,2021-12-14,02:00:00,6,1,5,FMN GV 16 Berchem TOT
54,Posthofbrug 5366,2021-12-14,03:00:00,1,1,0,FMN GV 16 Berchem TOT
54,Posthofbrug 5366,2021-12-14,04:00:00,12,10,2,FMN GV 16 Berchem TOT
54,Posthofbrug 5366,2021-12-14,05:00:00,28,21,7,FMN GV 16 Berchem TOT
54,Posthofbrug 5366,2021-12-14,06:00:00,75,62,13,FMN GV 16 Berchem TOT
54,Posthofbrug 5366,2021-12-14,07:00:00,308,237,71,FMN GV 16 Berchem TOT
54,Posthofbrug 5366,2021-12-14,08:00:00,521,398,123,FMN GV 16 Berchem TOT
54,Posthofbrug 5366,2021-12-14,09:00:00,179,138,41,FMN GV 16 Berchem TOT
54,Posthofbrug 5366,2021-12-14,10:00:00,118,74,44,FMN GV 16 Berchem TOT
54,Posthofbrug 5366,2021-12-14,11:00:00,110,64,46,FMN GV 16 Berchem TOT
54,Posthofbrug 5366,2021-12-14,12:00:00,137,68,69,FMN GV 16 Berchem TOT
54,Posthofbrug 5366,2021-12-14,13:00:00,169,93,76,FMN GV 16 Berchem TOT
54,Posthofbrug 5366,2021-12-14,14:00:00,122,45,77,FMN GV 16 Berchem TOT
54,Posthofbrug 5366,2021-12-14,15:00:00,189,58,131,FMN GV 16 Berchem TOT
54,Posthofbrug 5366,2021-12-14,16:00:00,11,6,5,FMN GV 16 Berchem TOT
54,Posthofbrug 5366,2021-12-14,17:00:00,0,0,0,FMN GV 16 Berchem TOT
54,Posthofbrug 5366,2021-12-14,18:00:00,0,0,0,FMN GV 16 Berchem TOT
54,Posthofbrug 5366,2021-12-14,19:00:00,0,0,0,FMN GV 16 Berchem TOT
54,Posthofbrug 5366,2021-12-14,20:00:00,0,0,0,FMN GV 16 Berchem TOT
54,Posthofbrug 5366,2021-12-14,21:00:00,0,0,0,FMN GV 16 Berchem TOT
54,Posthofbrug 5366,2021-12-14,22:00:00,68,26,42,FMN GV 16 Berchem TOT
54,Posthofbrug 5366,2021-12-14,23:00:00,44,14,30,FMN GV 16 Berchem TOT
54,Posthofbrug 5366,2021-12-15,00:00:00,18,3,15,FMN GV 16 Berchem TOT
54,Posthofbrug 5366,2021-12-15,01:00:00,9,4,5,FMN GV 16 Berchem TOT
54,Posthofbrug 5366,2021-12-15,02:00:00,1,0,1,FMN GV 16 Berchem TOT
54,Posthofbrug 5366,2021-12-15,03:00:00,2,1,1,FMN GV 16 Berchem TOT
54,Posthofbrug 5366,2021-12-15,04:00:00,13,10,3,FMN GV 16 Berchem TOT
54,Posthofbrug 5366,2021-12-15,05:00:00,19,15,4,FMN GV 16 Berchem TOT
54,Posthofbrug 5366,2021-12-15,06:00:00,67,49,18,FMN GV 16 Berchem TOT
54,Posthofbrug 5366,2021-12-15,07:00:00,266,202,64,FMN GV 16 Berchem TOT
54,Posthofbrug 5366,2021-12-15,08:00:00,420,307,113,FMN GV 16 Berchem TOT
54,Posthofbrug 5366,2021-12-15,09:00:00,191,139,52,FMN GV 16 Berchem TOT
54,Posthofbrug 5366,2021-12-15,10:00:00,131,89,42,FMN GV 16 Berchem TOT
54,Posthofbrug 5366,2021-12-15,11:00:00,113,60,53,FMN GV 16 Berchem TOT
54,Posthofbrug 5366,2021-12-15,12:00:00,209,98,111,FMN GV 16 Berchem TOT
54,Posthofbrug 5366,2021-12-15,13:00:00,151,71,80,FMN GV 16 Berchem TOT
54,Posthofbrug 5366,2021-12-15,14:00:00,140,54,86,FMN GV 16 Berchem TOT
54,Posthofbrug 5366,2021-12-15,15:00:00,181,69,112,FMN GV 16 Berchem TOT
54,Posthofbrug 5366,2021-12-15,16:00:00,251,96,155,FMN GV 16 Berchem TOT
54,Posthofbrug 5366,2021-12-15,17:00:00,298,109,189,FMN GV 16 Berchem TOT
54,Posthofbrug 5366,2021-12-15,18:00:00,239,89,150,FMN GV 16 Berchem TOT
54,Posthofbrug 5366,2021-12-15,19:00:00,146,62,84,FMN GV 16 Berchem TOT
54,Posthofbrug 5366,2021-12-15,20:00:00,65,32,33,FMN GV 16 Berchem TOT
54,Posthofbrug 5366,2021-12-15,21:00:00,51,26,25,FMN GV 16 Berchem TOT
54,Posthofbrug 5366,2021-12-15,22:00:00,77,23,54,FMN GV 16 Berchem TOT
54,Posthofbrug 5366,2021-12-15,23:00:00,49,19,30,FMN GV 16 Berchem TOT
54,Posthofbrug 5366,2021-12-16,00:00:00,15,2,13,FMN GV 16 Berchem TOT
54,Posthofbrug 5366,2021-12-16,01:00:00,7,3,4,FMN GV 16 Berchem TOT
54,Posthofbrug 5366,2021-12-16,02:00:00,6,0,6,FMN GV 16 Berchem TOT
54,Posthofbrug 5366,2021-12-16,03:00:00,3,0,3,FMN GV 16 Berchem TOT
54,Posthofbrug 5366,2021-12-16,04:00:00,10,9,1,FMN GV 16 Berchem TOT
54,Posthofbrug 5366,2021-12-16,05:00:00,21,15,6,FMN GV 16 Berchem TOT
54,Posthofbrug 5366,2021-12-16,06:00:00,75,61,14,FMN GV 16 Berchem TOT
54,Posthofbrug 5366,2021-12-16,07:00:00,291,230,61,FMN GV 16 Berchem TOT
54,Posthofbrug 5366,2021-12-16,08:00:00,530,394,136,FMN GV 16 Berchem TOT
54,Posthofbrug 5366,2021-12-16,09:00:00,210,165,45,FMN GV 16 Berchem TOT
54,Posthofbrug 5366,2021-12-16,10:00:00,123,93,30,FMN GV 16 Berchem TOT
54,Posthofbrug 5366,2021-12-16,11:00:00,133,65,68,FMN GV 16 Berchem TOT
54,Posthofbrug 5366,2021-12-16,12:00:00,178,97,81,FMN GV 16 Berchem TOT
54,Posthofbrug 5366,2021-12-16,13:00:00,177,90,87,FMN GV 16 Berchem TOT
54,Posthofbrug 5366,2021-12-16,14:00:00,9,2,7,FMN GV 16 Berchem TOT
54,Posthofbrug 5366,2021-12-16,15:00:00,0,0,0,FMN GV 16 Berchem TOT
54,Posthofbrug 5366,2021-12-16,16:00:00,0,0,0,FMN GV 16 Berchem TOT
54,Posthofbrug 5366,2021-12-16,17:00:00,0,0,0,FMN GV 16 Berchem TOT
54,Posthofbrug 5366,2021-12-16,18:00:00,251,99,152,FMN GV 16 Berchem TOT
54,Posthofbrug 5366,2021-12-16,19:00:00,182,82,100,FMN GV 16 Berchem TOT
54,Posthofbrug 5366,2021-12-16,20:00:00,102,32,70,FMN GV 16 Berchem TOT
54,Posthofbrug 5366,2021-12-16,21:00:00,99,52,47,FMN GV 16 Berchem TOT
54,Posthofbrug 5366,2021-12-16,22:00:00,80,18,62,FMN GV 16 Berchem TOT
54,Posthofbrug 5366,2021-12-16,23:00:00,54,6,48,FMN GV 16 Berchem TOT
54,Posthofbrug 5366,2021-12-17,00:00:00,21,5,16,FMN GV 16 Berchem TOT
54,Posthofbrug 5366,2021-12-17,01:00:00,8,5,3,FMN GV 16 Berchem TOT
54,Posthofbrug 5366,2021-12-17,02:00:00,17,3,14,FMN GV 16 Berchem TOT
54,Posthofbrug 5366,2021-12-17,03:00:00,2,1,1,FMN GV 16 Berchem TOT
54,Posthofbrug 5366,2021-12-17,04:00:00,11,9,2,FMN GV 16 Berchem TOT
54,Posthofbrug 5366,2021-12-17,05:00:00,20,16,4,FMN GV 16 Berchem TOT
54,Posthofbrug 5366,2021-12-17,06:00:00,54,46,8,FMN GV 16 Berchem TOT
54,Posthofbrug 5366,2021-12-17,07:00:00,230,175,55,FMN GV 16 Berchem TOT
54,Posthofbrug 5366,2021-12-17,08:00:00,429,321,108,FMN GV 16 Berchem TOT
54,Posthofbrug 5366,2021-12-17,09:00:00,187,145,42,FMN GV 16 Berchem TOT
54,Posthofbrug 5366,2021-12-17,10:00:00,145,89,56,FMN GV 16 Berchem TOT
54,Posthofbrug 5366,2021-12-17,11:00:00,120,62,58,FMN GV 16 Berchem TOT
54,Posthofbrug 5366,2021-12-17,12:00:00,179,81,98,FMN GV 16 Berchem TOT
54,Posthofbrug 5366,2021-12-17,13:00:00,167,95,72,FMN GV 16 Berchem TOT
54,Posthofbrug 5366,2021-12-17,14:00:00,165,77,88,FMN GV 16 Berchem TOT
54,Posthofbrug 5366,2021-12-17,15:00:00,210,80,130,FMN GV 16 Berchem TOT
54,Posthofbrug 5366,2021-12-17,16:00:00,272,91,181,FMN GV 16 Berchem TOT
54,Posthofbrug 5366,2021-12-17,17:00:00,283,93,190,FMN GV 16 Berchem TOT
54,Posthofbrug 5366,2021-12-17,18:00:00,255,117,138,FMN GV 16 Berchem TOT
54,Posthofbrug 5366,2021-12-17,19:00:00,152,78,74,FMN GV 16 Berchem TOT
54,Posthofbrug 5366,2021-12-17,20:00:00,98,53,45,FMN GV 16 Berchem TOT
54,Posthofbrug 5366,2021-12-17,21:00:00,78,32,46,FMN GV 16 Berchem TOT
54,Posthofbrug 5366,2021-12-17,22:00:00,72,26,46,FMN GV 16 Berchem TOT
54,Posthofbrug 5366,2021-12-17,23:00:00,104,25,79,FMN GV 16 Berchem TOT
54,Posthofbrug 5366,2021-12-18,00:00:00,69,14,55,FMN GV 16 Berchem TOT
54,Posthofbrug 5366,2021-12-18,01:00:00,71,45,26,FMN GV 16 Berchem TOT
54,Posthofbrug 5366,2021-12-18,02:00:00,42,8,34,FMN GV 16 Berchem TOT
54,Posthofbrug 5366,2021-12-18,03:00:00,15,3,12,FMN GV 16 Berchem TOT
54,Posthofbrug 5366,2021-12-18,04:00:00,13,8,5,FMN GV 16 Berchem TOT
54,Posthofbrug 5366,2021-12-18,05:00:00,13,11,2,FMN GV 16 Berchem TOT
54,Posthofbrug 5366,2021-12-18,06:00:00,17,13,4,FMN GV 16 Berchem TOT
54,Posthofbrug 5366,2021-12-18,07:00:00,18,12,6,FMN GV 16 Berchem TOT
54,Posthofbrug 5366,2021-12-18,08:00:00,45,34,11,FMN GV 16 Berchem TOT
54,Posthofbrug 5366,2021-12-18,09:00:00,96,66,30,FMN GV 16 Berchem TOT
54,Posthofbrug 5366,2021-12-18,10:00:00,115,84,31,FMN GV 16 Berchem TOT
54,Posthofbrug 5366,2021-12-18,11:00:00,127,70,57,FMN GV 16 Berchem TOT
54,Posthofbrug 5366,2021-12-18,12:00:00,120,73,47,FMN GV 16 Berchem TOT
54,Posthofbrug 5366,2021-12-18,13:00:00,182,107,75,FMN GV 16 Berchem TOT
54,Posthofbrug 5366,2021-12-18,14:00:00,14,9,5,FMN GV 16 Berchem TOT
54,Posthofbrug 5366,2021-12-18,15:00:00,0,0,0,FMN GV 16 Berchem TOT
54,Posthofbrug 5366,2021-12-18,16:00:00,0,0,0,FMN GV 16 Berchem TOT
54,Posthofbrug 5366,2021-12-18,17:00:00,0,0,0,FMN GV 16 Berchem TOT
54,Posthofbrug 5366,2021-12-18,18:00:00,125,65,60,FMN GV 16 Berchem TOT
54,Posthofbrug 5366,2021-12-18,19:00:00,86,44,42,FMN GV 16 Berchem TOT
54,Posthofbrug 5366,2021-12-18,20:00:00,84,47,37,FMN GV 16 Berchem TOT
54,Posthofbrug 5366,2021-12-18,21:00:00,58,22,36,FMN GV 16 Berchem TOT
54,Posthofbrug 5366,2021-12-18,22:00:00,51,22,29,FMN GV 16 Berchem TOT
54,Posthofbrug 5366,2021-12-18,23:00:00,64,11,53,FMN GV 16 Berchem TOT
54,Posthofbrug 5366,2021-12-19,00:00:00,25,12,13,FMN GV 16 Berchem TOT
54,Posthofbrug 5366,2021-12-19,01:00:00,22,7,15,FMN GV 16 Berchem TOT
54,Posthofbrug 5366,2021-12-19,02:00:00,18,4,14,FMN GV 16 Berchem TOT
54,Posthofbrug 5366,2021-12-19,03:00:00,7,1,6,FMN GV 16 Berchem TOT
54,Posthofbrug 5366,2021-12-19,04:00:00,6,2,4,FMN GV 16 Berchem TOT
54,Posthofbrug 5366,2021-12-19,05:00:00,8,4,4,FMN GV 16 Berchem TOT
54,Posthofbrug 5366,2021-12-19,06:00:00,13,12,1,FMN GV 16 Berchem TOT
54,Posthofbrug 5366,2021-12-19,07:00:00,27,22,5,FMN GV 16 Berchem TOT
54,Posthofbrug 5366,2021-12-19,08:00:00,33,24,9,FMN GV 16 Berchem TOT
54,Posthofbrug 5366,2021-12-19,09:00:00,81,47,34,FMN GV 16 Berchem TOT
54,Posthofbrug 5366,2021-12-19,10:00:00,80,46,34,FMN GV 16 Berchem TOT
54,Posthofbrug 5366,2021-12-19,11:00:00,109,60,49,FMN GV 16 Berchem TOT
54,Posthofbrug 5366,2021-12-19,12:00:00,124,83,41,FMN GV 16 Berchem TOT
54,Posthofbrug 5366,2021-12-19,13:00:00,127,86,41,FMN GV 16 Berchem TOT
54,Posthofbrug 5366,2021-12-19,14:00:00,6,4,2,FMN GV 16 Berchem TOT
54,Posthofbrug 5366,2021-12-19,15:00:00,0,0,0,FMN GV 16 Berchem TOT
54,Posthofbrug 5366,2021-12-19,16:00:00,0,0,0,FMN GV 16 Berchem TOT
54,Posthofbrug 5366,2021-12-19,17:00:00,0,0,0,FMN GV 16 Berchem TOT
54,Posthofbrug 5366,2021-12-19,18:00:00,0,0,0,FMN GV 16 Berchem TOT
54,Posthofbrug 5366,2021-12-19,19:00:00,0,0,0,FMN GV 16 Berchem TOT
54,Posthofbrug 5366,2021-12-19,20:00:00,57,25,32,FMN GV 16 Berchem TOT
54,Posthofbrug 5366,2021-12-19,21:00:00,43,25,18,FMN GV 16 Berchem TOT
54,Posthofbrug 5366,2021-12-19,22:00:00,56,20,36,FMN GV 16 Berchem TOT
54,Posthofbrug 5366,2021-12-19,23:00:00,25,6,19,FMN GV 16 Berchem TOT
54,Posthofbrug 5366,2021-12-20,00:00:00,19,6,13,FMN GV 16 Berchem TOT
54,Posthofbrug 5366,2021-12-20,01:00:00,12,2,10,FMN GV 16 Berchem TOT
54,Posthofbrug 5366,2021-12-20,02:00:00,4,2,2,FMN GV 16 Berchem TOT
54,Posthofbrug 5366,2021-12-20,03:00:00,5,2,3,FMN GV 16 Berchem TOT
54,Posthofbrug 5366,2021-12-20,04:00:00,6,6,0,FMN GV 16 Berchem TOT
54,Posthofbrug 5366,2021-12-20,05:00:00,18,10,8,FMN GV 16 Berchem TOT
54,Posthofbrug 5366,2021-12-20,06:00:00,68,54,14,FMN GV 16 Berchem TOT
54,Posthofbrug 5366,2021-12-20,07:00:00,231,173,58,FMN GV 16 Berchem TOT
54,Posthofbrug 5366,2021-12-20,08:00:00,363,286,77,FMN GV 16 Berchem TOT
54,Posthofbrug 5366,2021-12-20,09:00:00,185,131,54,FMN GV 16 Berchem TOT
54,Posthofbrug 5366,2021-12-20,10:00:00,134,91,43,FMN GV 16 Berchem TOT
54,Posthofbrug 5366,2021-12-20,11:00:00,112,70,42,FMN GV 16 Berchem TOT
54,Posthofbrug 5366,2021-12-20,12:00:00,185,102,83,FMN GV 16 Berchem TOT
54,Posthofbrug 5366,2021-12-20,13:00:00,144,74,70,FMN GV 16 Berchem TOT
54,Posthofbrug 5366,2021-12-20,14:00:00,146,66,80,FMN GV 16 Berchem TOT
54,Posthofbrug 5366,2021-12-20,15:00:00,157,65,92,FMN GV 16 Berchem TOT
54,Posthofbrug 5366,2021-12-20,16:00:00,223,81,142,FMN GV 16 Berchem TOT
54,Posthofbrug 5366,2021-12-20,17:00:00,339,108,231,FMN GV 16 Berchem TOT
54,Posthofbrug 5366,2021-12-20,18:00:00,222,83,139,FMN GV 16 Berchem TOT
54,Posthofbrug 5366,2021-12-20,19:00:00,119,63,56,FMN GV 16 Berchem TOT
54,Posthofbrug 5366,2021-12-20,20:00:00,82,45,37,FMN GV 16 Berchem TOT
54,Posthofbrug 5366,2021-12-20,21:00:00,74,28,46,FMN GV 16 Berchem TOT
54,Posthofbrug 5366,2021-12-20,22:00:00,66,16,50,FMN GV 16 Berchem TOT
54,Posthofbrug 5366,2021-12-20,23:00:00,34,8,26,FMN GV 16 Berchem TOT
54,Posthofbrug 5366,2021-12-21,00:00:00,15,1,14,FMN GV 16 Berchem TOT
54,Posthofbrug 5366,2021-12-21,01:00:00,6,3,3,FMN GV 16 Berchem TOT
54,Posthofbrug 5366,2021-12-21,02:00:00,3,0,3,FMN GV 16 Berchem TOT
54,Posthofbrug 5366,2021-12-21,03:00:00,1,0,1,FMN GV 16 Berchem TOT
54,Posthofbrug 5366,2021-12-21,04:00:00,4,3,1,FMN GV 16 Berchem TOT
54,Posthofbrug 5366,2021-12-21,05:00:00,13,8,5,FMN GV 16 Berchem TOT
54,Posthofbrug 5366,2021-12-21,06:00:00,66,52,14,FMN GV 16 Berchem TOT
54,Posthofbrug 5366,2021-12-21,07:00:00,199,150,49,FMN GV 16 Berchem TOT
54,Posthofbrug 5366,2021-12-21,08:00:00,344,255,89,FMN GV 16 Berchem TOT
54,Posthofbrug 5366,2021-12-21,09:00:00,177,132,45,FMN GV 16 Berchem TOT
54,Posthofbrug 5366,2021-12-21,10:00:00,107,76,31,FMN GV 16 Berchem TOT
54,Posthofbrug 5366,2021-12-21,11:00:00,132,75,57,FMN GV 16 Berchem TOT
54,Posthofbrug 5366,2021-12-21,12:00:00,166,85,81,FMN GV 16 Berchem TOT
54,Posthofbrug 5366,2021-12-21,13:00:00,157,91,66,FMN GV 16 Berchem TOT
54,Posthofbrug 5366,2021-12-21,14:00:00,133,83,50,FMN GV 16 Berchem TOT
54,Posthofbrug 5366,2021-12-21,15:00:00,161,63,98,FMN GV 16 Berchem TOT
54,Posthofbrug 5366,2021-12-21,16:00:00,258,99,159,FMN GV 16 Berchem TOT
54,Posthofbrug 5366,2021-12-21,17:00:00,385,128,257,FMN GV 16 Berchem TOT
54,Posthofbrug 5366,2021-12-21,18:00:00,228,78,150,FMN GV 16 Berchem TOT
54,Posthofbrug 5366,2021-12-21,19:00:00,115,48,67,FMN GV 16 Berchem TOT
54,Posthofbrug 5366,2021-12-21,20:00:00,70,22,48,FMN GV 16 Berchem TOT
54,Posthofbrug 5366,2021-12-21,21:00:00,65,27,38,FMN GV 16 Berchem TOT
54,Posthofbrug 5366,2021-12-21,22:00:00,76,22,54,FMN GV 16 Berchem TOT
54,Posthofbrug 5366,2021-12-21,23:00:00,61,13,48,FMN GV 16 Berchem TOT
54,Posthofbrug 5366,2021-12-22,00:00:00,23,6,17,FMN GV 16 Berchem TOT
54,Posthofbrug 5366,2021-12-22,01:00:00,9,1,8,FMN GV 16 Berchem TOT
54,Posthofbrug 5366,2021-12-22,02:00:00,2,0,2,FMN GV 16 Berchem TOT
54,Posthofbrug 5366,2021-12-22,03:00:00,0,0,0,FMN GV 16 Berchem TOT
54,Posthofbrug 5366,2021-12-22,04:00:00,6,4,2,FMN GV 16 Berchem TOT
54,Posthofbrug 5366,2021-12-22,05:00:00,18,10,8,FMN GV 16 Berchem TOT
54,Posthofbrug 5366,2021-12-22,06:00:00,55,47,8,FMN GV 16 Berchem TOT
54,Posthofbrug 5366,2021-12-22,07:00:00,161,123,38,FMN GV 16 Berchem TOT
54,Posthofbrug 5366,2021-12-22,08:00:00,272,194,78,FMN GV 16 Berchem TOT
54,Posthofbrug 5366,2021-12-22,09:00:00,143,97,46,FMN GV 16 Berchem TOT
54,Posthofbrug 5366,2021-12-22,10:00:00,100,64,36,FMN GV 16 Berchem TOT
54,Posthofbrug 5366,2021-12-22,11:00:00,115,67,48,FMN GV 16 Berchem TOT
54,Posthofbrug 5366,2021-12-22,12:00:00,149,89,60,FMN GV 16 Berchem TOT
54,Posthofbrug 5366,2021-12-22,13:00:00,123,60,63,FMN GV 16 Berchem TOT
54,Posthofbrug 5366,2021-12-22,14:00:00,121,61,60,FMN GV 16 Berchem TOT
54,Posthofbrug 5366,2021-12-22,15:00:00,150,59,91,FMN GV 16 Berchem TOT
54,Posthofbrug 5366,2021-12-22,16:00:00,211,82,129,FMN GV 16 Berchem TOT
54,Posthofbrug 5366,2021-12-22,17:00:00,247,75,172,FMN GV 16 Berchem TOT
54,Posthofbrug 5366,2021-12-22,18:00:00,197,73,124,FMN GV 16 Berchem TOT
54,Posthofbrug 5366,2021-12-22,19:00:00,128,55,73,FMN GV 16 Berchem TOT
54,Posthofbrug 5366,2021-12-22,20:00:00,63,31,32,FMN GV 16 Berchem TOT
54,Posthofbrug 5366,2021-12-22,21:00:00,56,21,35,FMN GV 16 Berchem TOT
54,Posthofbrug 5366,2021-12-22,22:00:00,50,18,32,FMN GV 16 Berchem TOT
54,Posthofbrug 5366,2021-12-22,23:00:00,54,15,39,FMN GV 16 Berchem TOT
54,Posthofbrug 5366,2021-12-23,00:00:00,23,9,14,FMN GV 16 Berchem TOT
54,Posthofbrug 5366,2021-12-23,01:00:00,3,2,1,FMN GV 16 Berchem TOT
54,Posthofbrug 5366,2021-12-23,02:00:00,5,1,4,FMN GV 16 Berchem TOT
54,Posthofbrug 5366,2021-12-23,03:00:00,1,0,1,FMN GV 16 Berchem TOT
54,Posthofbrug 5366,2021-12-23,04:00:00,4,4,0,FMN GV 16 Berchem TOT
54,Posthofbrug 5366,2021-12-23,05:00:00,16,11,5,FMN GV 16 Berchem TOT
54,Posthofbrug 5366,2021-12-23,06:00:00,59,50,9,FMN GV 16 Berchem TOT
54,Posthofbrug 5366,2021-12-23,07:00:00,176,136,40,FMN GV 16 Berchem TOT
54,Posthofbrug 5366,2021-12-23,08:00:00,297,209,88,FMN GV 16 Berchem TOT
54,Posthofbrug 5366,2021-12-23,09:00:00,175,138,37,FMN GV 16 Berchem TOT
54,Posthofbrug 5366,2021-12-23,10:00:00,104,69,35,FMN GV 16 Berchem TOT
54,Posthofbrug 5366,2021-12-23,11:00:00,122,66,56,FMN GV 16 Berchem TOT
54,Posthofbrug 5366,2021-12-23,12:00:00,144,85,59,FMN GV 16 Berchem TOT
54,Posthofbrug 5366,2021-12-23,13:00:00,146,80,66,FMN GV 16 Berchem TOT
54,Posthofbrug 5366,2021-12-23,14:00:00,129,64,65,FMN GV 16 Berchem TOT
54,Posthofbrug 5366,2021-12-23,15:00:00,169,69,100,FMN GV 16 Berchem TOT
54,Posthofbrug 5366,2021-12-23,16:00:00,244,82,162,FMN GV 16 Berchem TOT
54,Posthofbrug 5366,2021-12-23,17:00:00,266,79,187,FMN GV 16 Berchem TOT
54,Posthofbrug 5366,2021-12-23,18:00:00,176,72,104,FMN GV 16 Berchem TOT
54,Posthofbrug 5366,2021-12-23,19:00:00,138,57,81,FMN GV 16 Berchem TOT
54,Posthofbrug 5366,2021-12-23,20:00:00,101,41,60,FMN GV 16 Berchem TOT
54,Posthofbrug 5366,2021-12-23,21:00:00,49,23,26,FMN GV 16 Berchem TOT
54,Posthofbrug 5366,2021-12-23,22:00:00,70,27,43,FMN GV 16 Berchem TOT
54,Posthofbrug 5366,2021-12-23,23:00:00,91,24,67,FMN GV 16 Berchem TOT
54,Posthofbrug 5366,2021-12-24,00:00:00,29,11,18,FMN GV 16 Berchem TOT
54,Posthofbrug 5366,2021-12-24,01:00:00,27,7,20,FMN GV 16 Berchem TOT
54,Posthofbrug 5366,2021-12-24,02:00:00,12,2,10,FMN GV 16 Berchem TOT
54,Posthofbrug 5366,2021-12-24,03:00:00,3,1,2,FMN GV 16 Berchem TOT
54,Posthofbrug 5366,2021-12-24,04:00:00,5,4,1,FMN GV 16 Berchem TOT
54,Posthofbrug 5366,2021-12-24,05:00:00,9,7,2,FMN GV 16 Berchem TOT
54,Posthofbrug 5366,2021-12-24,06:00:00,28,20,8,FMN GV 16 Berchem TOT
54,Posthofbrug 5366,2021-12-24,07:00:00,94,75,19,FMN GV 16 Berchem TOT
54,Posthofbrug 5366,2021-12-24,08:00:00,140,108,32,FMN GV 16 Berchem TOT
54,Posthofbrug 5366,2021-12-24,09:00:00,118,75,43,FMN GV 16 Berchem TOT
54,Posthofbrug 5366,2021-12-24,10:00:00,106,63,43,FMN GV 16 Berchem TOT
54,Posthofbrug 5366,2021-12-24,11:00:00,115,63,52,FMN GV 16 Berchem TOT
54,Posthofbrug 5366,2021-12-24,12:00:00,135,55,80,FMN GV 16 Berchem TOT
54,Posthofbrug 5366,2021-12-24,13:00:00,109,46,63,FMN GV 16 Berchem TOT
54,Posthofbrug 5366,2021-12-24,14:00:00,127,47,80,FMN GV 16 Berchem TOT
54,Posthofbrug 5366,2021-12-24,15:00:00,153,52,101,FMN GV 16 Berchem TOT
54,Posthofbrug 5366,2021-12-24,16:00:00,143,44,99,FMN GV 16 Berchem TOT
54,Posthofbrug 5366,2021-12-24,17:00:00,115,37,78,FMN GV 16 Berchem TOT
54,Posthofbrug 5366,2021-12-24,18:00:00,65,28,37,FMN GV 16 Berchem TOT
54,Posthofbrug 5366,2021-12-24,19:00:00,26,8,18,FMN GV 16 Berchem TOT
54,Posthofbrug 5366,2021-12-24,20:00:00,21,11,10,FMN GV 16 Berchem TOT
54,Posthofbrug 5366,2021-12-24,21:00:00,13,8,5,FMN GV 16 Berchem TOT
54,Posthofbrug 5366,2021-12-24,22:00:00,36,15,21,FMN GV 16 Berchem TOT
54,Posthofbrug 5366,2021-12-24,23:00:00,38,33,5,FMN GV 16 Berchem TOT
54,Posthofbrug 5366,2021-12-25,00:00:00,34,29,5,FMN GV 16 Berchem TOT
54,Posthofbrug 5366,2021-12-25,01:00:00,31,24,7,FMN GV 16 Berchem TOT
54,Posthofbrug 5366,2021-12-25,02:00:00,13,10,3,FMN GV 16 Berchem TOT
54,Posthofbrug 5366,2021-12-25,03:00:00,5,2,3,FMN GV 16 Berchem TOT
54,Posthofbrug 5366,2021-12-25,04:00:00,2,1,1,FMN GV 16 Berchem TOT
54,Posthofbrug 5366,2021-12-25,05:00:00,3,1,2,FMN GV 16 Berchem TOT
54,Posthofbrug 5366,2021-12-25,06:00:00,4,3,1,FMN GV 16 Berchem TOT
54,Posthofbrug 5366,2021-12-25,07:00:00,10,6,4,FMN GV 16 Berchem TOT
54,Posthofbrug 5366,2021-12-25,08:00:00,3,2,1,FMN GV 16 Berchem TOT
54,Posthofbrug 5366,2021-12-25,09:00:00,19,10,9,FMN GV 16 Berchem TOT
54,Posthofbrug 5366,2021-12-25,10:00:00,23,15,8,FMN GV 16 Berchem TOT
54,Posthofbrug 5366,2021-12-25,11:00:00,57,25,32,FMN GV 16 Berchem TOT
54,Posthofbrug 5366,2021-12-25,12:00:00,61,31,30,FMN GV 16 Berchem TOT
54,Posthofbrug 5366,2021-12-25,13:00:00,58,32,26,FMN GV 16 Berchem TOT
54,Posthofbrug 5366,2021-12-25,14:00:00,58,35,23,FMN GV 16 Berchem TOT
54,Posthofbrug 5366,2021-12-25,15:00:00,63,25,38,FMN GV 16 Berchem TOT
54,Posthofbrug 5366,2021-12-25,16:00:00,66,29,37,FMN GV 16 Berchem TOT
54,Posthofbrug 5366,2021-12-25,17:00:00,43,18,25,FMN GV 16 Berchem TOT
54,Posthofbrug 5366,2021-12-25,18:00:00,35,17,18,FMN GV 16 Berchem TOT
54,Posthofbrug 5366,2021-12-25,19:00:00,39,27,12,FMN GV 16 Berchem TOT
54,Posthofbrug 5366,2021-12-25,20:00:00,31,17,14,FMN GV 16 Berchem TOT
54,Posthofbrug 5366,2021-12-25,21:00:00,35,21,14,FMN GV 16 Berchem TOT
54,Posthofbrug 5366,2021-12-25,22:00:00,38,22,16,FMN GV 16 Berchem TOT
54,Posthofbrug 5366,2021-12-25,23:00:00,26,19,7,FMN GV 16 Berchem TOT
54,Posthofbrug 5366,2021-12-26,00:00:00,20,15,5,FMN GV 16 Berchem TOT
54,Posthofbrug 5366,2021-12-26,01:00:00,15,12,3,FMN GV 16 Berchem TOT
54,Posthofbrug 5366,2021-12-26,02:00:00,2,0,2,FMN GV 16 Berchem TOT
54,Posthofbrug 5366,2021-12-26,03:00:00,1,0,1,FMN GV 16 Berchem TOT
54,Posthofbrug 5366,2021-12-26,04:00:00,1,1,0,FMN GV 16 Berchem TOT
54,Posthofbrug 5366,2021-12-26,05:00:00,7,5,2,FMN GV 16 Berchem TOT
54,Posthofbrug 5366,2021-12-26,06:00:00,7,6,1,FMN GV 16 Berchem TOT
54,Posthofbrug 5366,2021-12-26,07:00:00,9,7,2,FMN GV 16 Berchem TOT
54,Posthofbrug 5366,2021-12-26,08:00:00,20,10,10,FMN GV 16 Berchem TOT
54,Posthofbrug 5366,2021-12-26,09:00:00,31,20,11,FMN GV 16 Berchem TOT
54,Posthofbrug 5366,2021-12-26,10:00:00,41,26,15,FMN GV 16 Berchem TOT
54,Posthofbrug 5366,2021-12-26,11:00:00,65,38,27,FMN GV 16 Berchem TOT
54,Posthofbrug 5366,2021-12-26,12:00:00,92,52,40,FMN GV 16 Berchem TOT
54,Posthofbrug 5366,2021-12-26,13:00:00,84,40,44,FMN GV 16 Berchem TOT
54,Posthofbrug 5366,2021-12-26,14:00:00,92,56,36,FMN GV 16 Berchem TOT
54,Posthofbrug 5366,2021-12-26,15:00:00,83,43,40,FMN GV 16 Berchem TOT
54,Posthofbrug 5366,2021-12-26,16:00:00,62,28,34,FMN GV 16 Berchem TOT
54,Posthofbrug 5366,2021-12-26,17:00:00,53,24,29,FMN GV 16 Berchem TOT
54,Posthofbrug 5366,2021-12-26,18:00:00,41,23,18,FMN GV 16 Berchem TOT
54,Posthofbrug 5366,2021-12-26,19:00:00,44,16,28,FMN GV 16 Berchem TOT
54,Posthofbrug 5366,2021-12-26,20:00:00,22,14,8,FMN GV 16 Berchem TOT
54,Posthofbrug 5366,2021-12-26,21:00:00,35,26,9,FMN GV 16 Berchem TOT
54,Posthofbrug 5366,2021-12-26,22:00:00,28,20,8,FMN GV 16 Berchem TOT
54,Posthofbrug 5366,2021-12-26,23:00:00,39,15,24,FMN GV 16 Berchem TOT
54,Posthofbrug 5366,2021-12-27,00:00:00,7,6,1,FMN GV 16 Berchem TOT
54,Posthofbrug 5366,2021-12-27,01:00:00,16,6,10,FMN GV 16 Berchem TOT
54,Posthofbrug 5366,2021-12-27,02:00:00,7,0,7,FMN GV 16 Berchem TOT
54,Posthofbrug 5366,2021-12-27,03:00:00,1,0,1,FMN GV 16 Berchem TOT
54,Posthofbrug 5366,2021-12-27,04:00:00,7,4,3,FMN GV 16 Berchem TOT
54,Posthofbrug 5366,2021-12-27,05:00:00,4,3,1,FMN GV 16 Berchem TOT
54,Posthofbrug 5366,2021-12-27,06:00:00,27,23,4,FMN GV 16 Berchem TOT
54,Posthofbrug 5366,2021-12-27,07:00:00,63,49,14,FMN GV 16 Berchem TOT
54,Posthofbrug 5366,2021-12-27,08:00:00,116,89,27,FMN GV 16 Berchem TOT
54,Posthofbrug 5366,2021-12-27,09:00:00,81,52,29,FMN GV 16 Berchem TOT
54,Posthofbrug 5366,2021-12-27,10:00:00,83,58,25,FMN GV 16 Berchem TOT
54,Posthofbrug 5366,2021-12-27,11:00:00,94,55,39,FMN GV 16 Berchem TOT
54,Posthofbrug 5366,2021-12-27,12:00:00,107,64,43,FMN GV 16 Berchem TOT
54,Posthofbrug 5366,2021-12-27,13:00:00,86,43,43,FMN GV 16 Berchem TOT
54,Posthofbrug 5366,2021-12-27,14:00:00,102,61,41,FMN GV 16 Berchem TOT
54,Posthofbrug 5366,2021-12-27,15:00:00,89,33,56,FMN GV 16 Berchem TOT
54,Posthofbrug 5366,2021-12-27,16:00:00,129,47,82,FMN GV 16 Berchem TOT
54,Posthofbrug 5366,2021-12-27,17:00:00,137,48,89,FMN GV 16 Berchem TOT
54,Posthofbrug 5366,2021-12-27,18:00:00,92,36,56,FMN GV 16 Berchem TOT
54,Posthofbrug 5366,2021-12-27,19:00:00,64,25,39,FMN GV 16 Berchem TOT
54,Posthofbrug 5366,2021-12-27,20:00:00,42,12,30,FMN GV 16 Berchem TOT
54,Posthofbrug 5366,2021-12-27,21:00:00,26,12,14,FMN GV 16 Berchem TOT
54,Posthofbrug 5366,2021-12-27,22:00:00,34,14,20,FMN GV 16 Berchem TOT
54,Posthofbrug 5366,2021-12-27,23:00:00,45,13,32,FMN GV 16 Berchem TOT
54,Posthofbrug 5366,2021-12-28,00:00:00,27,8,19,FMN GV 16 Berchem TOT
54,Posthofbrug 5366,2021-12-28,01:00:00,6,3,3,FMN GV 16 Berchem TOT
54,Posthofbrug 5366,2021-12-28,02:00:00,10,4,6,FMN GV 16 Berchem TOT
54,Posthofbrug 5366,2021-12-28,03:00:00,1,0,1,FMN GV 16 Berchem TOT
54,Posthofbrug 5366,2021-12-28,04:00:00,5,4,1,FMN GV 16 Berchem TOT
54,Posthofbrug 5366,2021-12-28,05:00:00,9,7,2,FMN GV 16 Berchem TOT
54,Posthofbrug 5366,2021-12-28,06:00:00,39,31,8,FMN GV 16 Berchem TOT
54,Posthofbrug 5366,2021-12-28,07:00:00,79,65,14,FMN GV 16 Berchem TOT
54,Posthofbrug 5366,2021-12-28,08:00:00,111,79,32,FMN GV 16 Berchem TOT
54,Posthofbrug 5366,2021-12-28,09:00:00,80,59,21,FMN GV 16 Berchem TOT
54,Posthofbrug 5366,2021-12-28,10:00:00,80,58,22,FMN GV 16 Berchem TOT
54,Posthofbrug 5366,2021-12-28,11:00:00,63,35,28,FMN GV 16 Berchem TOT
54,Posthofbrug 5366,2021-12-28,12:00:00,77,48,29,FMN GV 16 Berchem TOT
54,Posthofbrug 5366,2021-12-28,13:00:00,67,39,28,FMN GV 16 Berchem TOT
54,Posthofbrug 5366,2021-12-28,14:00:00,60,23,37,FMN GV 16 Berchem TOT
54,Posthofbrug 5366,2021-12-28,15:00:00,65,29,36,FMN GV 16 Berchem TOT
54,Posthofbrug 5366,2021-12-28,16:00:00,120,49,71,FMN GV 16 Berchem TOT
54,Posthofbrug 5366,2021-12-28,17:00:00,131,38,93,FMN GV 16 Berchem TOT
54,Posthofbrug 5366,2021-12-28,18:00:00,105,31,74,FMN GV 16 Berchem TOT
54,Posthofbrug 5366,2021-12-28,19:00:00,87,40,47,FMN GV 16 Berchem TOT
54,Posthofbrug 5366,2021-12-28,20:00:00,52,18,34,FMN GV 16 Berchem TOT
54,Posthofbrug 5366,2021-12-28,21:00:00,33,14,19,FMN GV 16 Berchem TOT
54,Posthofbrug 5366,2021-12-28,22:00:00,33,20,13,FMN GV 16 Berchem TOT
54,Posthofbrug 5366,2021-12-28,23:00:00,40,18,22,FMN GV 16 Berchem TOT
54,Posthofbrug 5366,2021-12-29,00:00:00,12,5,7,FMN GV 16 Berchem TOT
54,Posthofbrug 5366,2021-12-29,01:00:00,16,7,9,FMN GV 16 Berchem TOT
54,Posthofbrug 5366,2021-12-29,02:00:00,2,1,1,FMN GV 16 Berchem TOT
54,Posthofbrug 5366,2021-12-29,03:00:00,2,1,1,FMN GV 16 Berchem TOT
54,Posthofbrug 5366,2021-12-29,04:00:00,12,7,5,FMN GV 16 Berchem TOT
54,Posthofbrug 5366,2021-12-29,05:00:00,18,15,3,FMN GV 16 Berchem TOT
54,Posthofbrug 5366,2021-12-29,06:00:00,38,33,5,FMN GV 16 Berchem TOT
54,Posthofbrug 5366,2021-12-29,07:00:00,71,51,20,FMN GV 16 Berchem TOT
54,Posthofbrug 5366,2021-12-29,08:00:00,99,74,25,FMN GV 16 Berchem TOT
54,Posthofbrug 5366,2021-12-29,09:00:00,88,51,37,FMN GV 16 Berchem TOT
54,Posthofbrug 5366,2021-12-29,10:00:00,76,56,20,FMN GV 16 Berchem TOT
54,Posthofbrug 5366,2021-12-29,11:00:00,70,45,25,FMN GV 16 Berchem TOT
54,Posthofbrug 5366,2021-12-29,12:00:00,69,46,23,FMN GV 16 Berchem TOT
54,Posthofbrug 5366,2021-12-29,13:00:00,86,50,36,FMN GV 16 Berchem TOT
54,Posthofbrug 5366,2021-12-29,14:00:00,70,26,44,FMN GV 16 Berchem TOT
54,Posthofbrug 5366,2021-12-29,15:00:00,85,39,46,FMN GV 16 Berchem TOT
54,Posthofbrug 5366,2021-12-29,16:00:00,110,39,71,FMN GV 16 Berchem TOT
54,Posthofbrug 5366,2021-12-29,17:00:00,137,45,92,FMN GV 16 Berchem TOT
54,Posthofbrug 5366,2021-12-29,18:00:00,109,37,72,FMN GV 16 Berchem TOT
54,Posthofbrug 5366,2021-12-29,19:00:00,81,36,45,FMN GV 16 Berchem TOT
54,Posthofbrug 5366,2021-12-29,20:00:00,66,32,34,FMN GV 16 Berchem TOT
54,Posthofbrug 5366,2021-12-29,21:00:00,38,20,18,FMN GV 16 Berchem TOT
54,Posthofbrug 5366,2021-12-29,22:00:00,37,12,25,FMN GV 16 Berchem TOT
54,Posthofbrug 5366,2021-12-29,23:00:00,42,15,27,FMN GV 16 Berchem TOT
54,Posthofbrug 5366,2021-12-30,00:00:00,21,5,16,FMN GV 16 Berchem TOT
54,Posthofbrug 5366,2021-12-30,01:00:00,14,7,7,FMN GV 16 Berchem TOT
54,Posthofbrug 5366,2021-12-30,02:00:00,2,2,0,FMN GV 16 Berchem TOT
54,Posthofbrug 5366,2021-12-30,03:00:00,5,4,1,FMN GV 16 Berchem TOT
54,Posthofbrug 5366,2021-12-30,04:00:00,7,4,3,FMN GV 16 Berchem TOT
54,Posthofbrug 5366,2021-12-30,05:00:00,11,9,2,FMN GV 16 Berchem TOT
54,Posthofbrug 5366,2021-12-30,06:00:00,31,27,4,FMN GV 16 Berchem TOT
54,Posthofbrug 5366,2021-12-30,07:00:00,74,55,19,FMN GV 16 Berchem TOT
54,Posthofbrug 5366,2021-12-30,08:00:00,123,86,37,FMN GV 16 Berchem TOT
54,Posthofbrug 5366,2021-12-30,09:00:00,86,67,19,FMN GV 16 Berchem TOT
54,Posthofbrug 5366,2021-12-30,10:00:00,93,62,31,FMN GV 16 Berchem TOT
54,Posthofbrug 5366,2021-12-30,11:00:00,106,60,46,FMN GV 16 Berchem TOT
54,Posthofbrug 5366,2021-12-30,12:00:00,112,67,45,FMN GV 16 Berchem TOT
54,Posthofbrug 5366,2021-12-30,13:00:00,100,68,32,FMN GV 16 Berchem TOT
54,Posthofbrug 5366,2021-12-30,14:00:00,138,67,71,FMN GV 16 Berchem TOT
54,Posthofbrug 5366,2021-12-30,15:00:00,135,68,67,FMN GV 16 Berchem TOT
54,Posthofbrug 5366,2021-12-30,16:00:00,151,67,84,FMN GV 16 Berchem TOT
54,Posthofbrug 5366,2021-12-30,17:00:00,163,71,92,FMN GV 16 Berchem TOT
54,Posthofbrug 5366,2021-12-30,18:00:00,126,42,84,FMN GV 16 Berchem TOT
54,Posthofbrug 5366,2021-12-30,19:00:00,81,34,47,FMN GV 16 Berchem TOT
54,Posthofbrug 5366,2021-12-30,20:00:00,58,22,36,FMN GV 16 Berchem TOT
54,Posthofbrug 5366,2021-12-30,21:00:00,42,15,27,FMN GV 16 Berchem TOT
54,Posthofbrug 5366,2021-12-30,22:00:00,55,18,37,FMN GV 16 Berchem TOT
54,Posthofbrug 5366,2021-12-30,23:00:00,58,23,35,FMN GV 16 Berchem TOT
54,Posthofbrug 5366,2021-12-31,00:00:00,17,6,11,FMN GV 16 Berchem TOT
54,Posthofbrug 5366,2021-12-31,01:00:00,18,12,6,FMN GV 16 Berchem TOT
54,Posthofbrug 5366,2021-12-31,02:00:00,3,2,1,FMN GV 16 Berchem TOT
54,Posthofbrug 5366,2021-12-31,03:00:00,2,1,1,FMN GV 16 Berchem TOT
54,Posthofbrug 5366,2021-12-31,04:00:00,5,4,1,FMN GV 16 Berchem TOT
54,Posthofbrug 5366,2021-12-31,05:00:00,8,5,3,FMN GV 16 Berchem TOT
54,Posthofbrug 5366,2021-12-31,06:00:00,15,15,0,FMN GV 16 Berchem TOT
54,Posthofbrug 5366,2021-12-31,07:00:00,53,40,13,FMN GV 16 Berchem TOT
54,Posthofbrug 5366,2021-12-31,08:00:00,64,47,17,FMN GV 16 Berchem TOT
54,Posthofbrug 5366,2021-12-31,09:00:00,94,66,28,FMN GV 16 Berchem TOT
54,Posthofbrug 5366,2021-12-31,10:00:00,86,61,25,FMN GV 16 Berchem TOT
54,Posthofbrug 5366,2021-12-31,11:00:00,118,62,56,FMN GV 16 Berchem TOT
54,Posthofbrug 5366,2021-12-31,12:00:00,97,51,46,FMN GV 16 Berchem TOT
54,Posthofbrug 5366,2021-12-31,13:00:00,127,77,50,FMN GV 16 Berchem TOT
54,Posthofbrug 5366,2021-12-31,14:00:00,138,57,81,FMN GV 16 Berchem TOT
54,Posthofbrug 5366,2021-12-31,15:00:00,162,77,85,FMN GV 16 Berchem TOT
54,Posthofbrug 5366,2021-12-31,16:00:00,145,60,85,FMN GV 16 Berchem TOT
54,Posthofbrug 5366,2021-12-31,17:00:00,127,63,64,FMN GV 16 Berchem TOT
54,Posthofbrug 5366,2021-12-31,18:00:00,139,83,56,FMN GV 16 Berchem TOT
54,Posthofbrug 5366,2021-12-31,19:00:00,60,40,20,FMN GV 16 Berchem TOT
54,Posthofbrug 5366,2021-12-31,20:00:00,46,23,23,FMN GV 16 Berchem TOT
54,Posthofbrug 5366,2021-12-31,21:00:00,27,14,13,FMN GV 16 Berchem TOT
54,Posthofbrug 5366,2021-12-31,22:00:00,28,18,10,FMN GV 16 Berchem TOT
54,Posthofbrug 5366,2021-12-31,23:00:00,54,33,21,FMN GV 16 Berchem TOT
54,Posthofbrug 5366,2022-01-01,00:00:00,13,6,7,FMN GV 16 Berchem TOT
54,Posthofbrug 5366,2022-01-01,01:00:00,70,49,21,FMN GV 16 Berchem TOT
54,Posthofbrug 5366,2022-01-01,02:00:00,83,40,43,FMN GV 16 Berchem TOT
54,Posthofbrug 5366,2022-01-01,03:00:00,62,14,48,FMN GV 16 Berchem TOT
54,Posthofbrug 5366,2022-01-01,04:00:00,58,28,30,FMN GV 16 Berchem TOT
54,Posthofbrug 5366,2022-01-01,05:00:00,32,14,18,FMN GV 16 Berchem TOT
54,Posthofbrug 5366,2022-01-01,06:00:00,31,13,18,FMN GV 16 Berchem TOT
54,Posthofbrug 5366,2022-01-01,07:00:00,14,8,6,FMN GV 16 Berchem TOT
54,Posthofbrug 5366,2022-01-01,08:00:00,9,6,3,FMN GV 16 Berchem TOT
54,Posthofbrug 5366,2022-01-01,09:00:00,16,9,7,FMN GV 16 Berchem TOT
54,Posthofbrug 5366,2022-01-01,10:00:00,30,16,14,FMN GV 16 Berchem TOT
54,Posthofbrug 5366,2022-01-01,11:00:00,51,25,26,FMN GV 16 Berchem TOT
54,Posthofbrug 5366,2022-01-01,12:00:00,61,28,33,FMN GV 16 Berchem TOT
54,Posthofbrug 5366,2022-01-01,13:00:00,104,53,51,FMN GV 16 Berchem TOT
54,Posthofbrug 5366,2022-01-01,14:00:00,131,76,55,FMN GV 16 Berchem TOT
54,Posthofbrug 5366,2022-01-01,15:00:00,125,63,62,FMN GV 16 Berchem TOT
54,Posthofbrug 5366,2022-01-01,16:00:00,130,71,59,FMN GV 16 Berchem TOT
54,Posthofbrug 5366,2022-01-01,17:00:00,103,38,65,FMN GV 16 Berchem TOT
54,Posthofbrug 5366,2022-01-01,18:00:00,63,35,28,FMN GV 16 Berchem TOT
54,Posthofbrug 5366,2022-01-01,19:00:00,50,18,32,FMN GV 16 Berchem TOT
54,Posthofbrug 5366,2022-01-01,20:00:00,33,21,12,FMN GV 16 Berchem TOT
54,Posthofbrug 5366,2022-01-01,21:00:00,47,21,26,FMN GV 16 Berchem TOT
54,Posthofbrug 5366,2022-01-01,22:00:00,26,14,12,FMN GV 16 Berchem TOT
54,Posthofbrug 5366,2022-01-01,23:00:00,21,9,12,FMN GV 16 Berchem TOT
54,Posthofbrug 5366,2022-01-02,00:00:00,9,4,5,FMN GV 16 Berchem TOT
54,Posthofbrug 5366,2022-01-02,01:00:00,4,2,2,FMN GV 16 Berchem TOT
54,Posthofbrug 5366,2022-01-02,02:00:00,4,1,3,FMN GV 16 Berchem TOT
54,Posthofbrug 5366,2022-01-02,03:00:00,1,1,0,FMN GV 16 Berchem TOT
54,Posthofbrug 5366,2022-01-02,04:00:00,0,0,0,FMN GV 16 Berchem TOT
54,Posthofbrug 5366,2022-01-02,05:00:00,2,2,0,FMN GV 16 Berchem TOT
54,Posthofbrug 5366,2022-01-02,06:00:00,13,9,4,FMN GV 16 Berchem TOT
54,Posthofbrug 5366,2022-01-02,07:00:00,18,13,5,FMN GV 16 Berchem TOT
54,Posthofbrug 5366,2022-01-02,08:00:00,18,9,9,FMN GV 16 Berchem TOT
54,Posthofbrug 5366,2022-01-02,09:00:00,27,11,16,FMN GV 16 Berchem TOT
54,Posthofbrug 5366,2022-01-02,10:00:00,53,39,14,FMN GV 16 Berchem TOT
54,Posthofbrug 5366,2022-01-02,11:00:00,83,53,30,FMN GV 16 Berchem TOT
54,Posthofbrug 5366,2022-01-02,12:00:00,124,86,38,FMN GV 16 Berchem TOT
54,Posthofbrug 5366,2022-01-02,13:00:00,151,92,59,FMN GV 16 Berchem TOT
54,Posthofbrug 5366,2022-01-02,14:00:00,103,56,47,FMN GV 16 Berchem TOT
54,Posthofbrug 5366,2022-01-02,15:00:00,99,52,47,FMN GV 16 Berchem TOT
54,Posthofbrug 5366,2022-01-02,16:00:00,116,48,68,FMN GV 16 Berchem TOT
54,Posthofbrug 5366,2022-01-02,17:00:00,97,51,46,FMN GV 16 Berchem TOT
54,Posthofbrug 5366,2022-01-02,18:00:00,87,38,49,FMN GV 16 Berchem TOT
54,Posthofbrug 5366,2022-01-02,19:00:00,57,22,35,FMN GV 16 Berchem TOT
54,Posthofbrug 5366,2022-01-02,20:00:00,53,26,27,FMN GV 16 Berchem TOT
54,Posthofbrug 5366,2022-01-02,21:00:00,28,15,13,FMN GV 16 Berchem TOT
54,Posthofbrug 5366,2022-01-02,22:00:00,46,23,23,FMN GV 16 Berchem TOT
54,Posthofbrug 5366,2022-01-02,23:00:00,28,10,18,FMN GV 16 Berchem TOT
54,Posthofbrug 5366,2022-01-03,00:00:00,13,4,9,FMN GV 16 Berchem TOT
54,Posthofbrug 5366,2022-01-03,01:00:00,8,1,7,FMN GV 16 Berchem TOT
54,Posthofbrug 5366,2022-01-03,02:00:00,3,1,2,FMN GV 16 Berchem TOT
54,Posthofbrug 5366,2022-01-03,03:00:00,1,0,1,FMN GV 16 Berchem TOT
54,Posthofbrug 5366,2022-01-03,04:00:00,8,5,3,FMN GV 16 Berchem TOT
54,Posthofbrug 5366,2022-01-03,05:00:00,16,12,4,FMN GV 16 Berchem TOT
54,Posthofbrug 5366,2022-01-03,06:00:00,43,35,8,FMN GV 16 Berchem TOT
54,Posthofbrug 5366,2022-01-03,07:00:00,118,83,35,FMN GV 16 Berchem TOT
54,Posthofbrug 5366,2022-01-03,08:00:00,191,131,60,FMN GV 16 Berchem TOT
54,Posthofbrug 5366,2022-01-03,09:00:00,128,94,34,FMN GV 16 Berchem TOT
54,Posthofbrug 5366,2022-01-03,10:00:00,82,54,28,FMN GV 16 Berchem TOT
54,Posthofbrug 5366,2022-01-03,11:00:00,94,69,25,FMN GV 16 Berchem TOT
54,Posthofbrug 5366,2022-01-03,12:00:00,99,59,40,FMN GV 16 Berchem TOT
54,Posthofbrug 5366,2022-01-03,13:00:00,79,43,36,FMN GV 16 Berchem TOT
54,Posthofbrug 5366,2022-01-03,14:00:00,86,31,55,FMN GV 16 Berchem TOT
54,Posthofbrug 5366,2022-01-03,15:00:00,124,52,72,FMN GV 16 Berchem TOT
54,Posthofbrug 5366,2022-01-03,16:00:00,156,61,95,FMN GV 16 Berchem TOT
54,Posthofbrug 5366,2022-01-03,17:00:00,205,80,125,FMN GV 16 Berchem TOT
54,Posthofbrug 5366,2022-01-03,18:00:00,150,52,98,FMN GV 16 Berchem TOT
54,Posthofbrug 5366,2022-01-03,19:00:00,100,42,58,FMN GV 16 Berchem TOT
54,Posthofbrug 5366,2022-01-03,20:00:00,75,25,50,FMN GV 16 Berchem TOT
54,Posthofbrug 5366,2022-01-03,21:00:00,44,20,24,FMN GV 16 Berchem TOT
54,Posthofbrug 5366,2022-01-03,22:00:00,43,19,24,FMN GV 16 Berchem TOT
54,Posthofbrug 5366,2022-01-03,23:00:00,32,13,19,FMN GV 16 Berchem TOT
54,Posthofbrug 5366,2022-01-04,00:00:00,20,5,15,FMN GV 16 Berchem TOT
54,Posthofbrug 5366,2022-01-04,01:00:00,4,0,4,FMN GV 16 Berchem TOT
54,Posthofbrug 5366,2022-01-04,02:00:00,4,1,3,FMN GV 16 Berchem TOT
54,Posthofbrug 5366,2022-01-04,03:00:00,0,0,0,FMN GV 16 Berchem TOT
54,Posthofbrug 5366,2022-01-04,04:00:00,5,5,0,FMN GV 16 Berchem TOT
54,Posthofbrug 5366,2022-01-04,05:00:00,18,13,5,FMN GV 16 Berchem TOT
54,Posthofbrug 5366,2022-01-04,06:00:00,58,52,6,FMN GV 16 Berchem TOT
54,Posthofbrug 5366,2022-01-04,07:00:00,150,111,39,FMN GV 16 Berchem TOT
54,Posthofbrug 5366,2022-01-04,08:00:00,209,142,67,FMN GV 16 Berchem TOT
54,Posthofbrug 5366,2022-01-04,09:00:00,121,99,22,FMN GV 16 Berchem TOT
54,Posthofbrug 5366,2022-01-04,10:00:00,88,60,28,FMN GV 16 Berchem TOT
54,Posthofbrug 5366,2022-01-04,11:00:00,72,38,34,FMN GV 16 Berchem TOT
54,Posthofbrug 5366,2022-01-04,12:00:00,93,54,39,FMN GV 16 Berchem TOT
54,Posthofbrug 5366,2022-01-04,13:00:00,80,47,33,FMN GV 16 Berchem TOT
54,Posthofbrug 5366,2022-01-04,14:00:00,62,23,39,FMN GV 16 Berchem TOT
54,Posthofbrug 5366,2022-01-04,15:00:00,87,29,58,FMN GV 16 Berchem TOT
54,Posthofbrug 5366,2022-01-04,16:00:00,158,57,101,FMN GV 16 Berchem TOT
54,Posthofbrug 5366,2022-01-04,17:00:00,209,74,135,FMN GV 16 Berchem TOT
54,Posthofbrug 5366,2022-01-04,18:00:00,154,55,99,FMN GV 16 Berchem TOT
54,Posthofbrug 5366,2022-01-04,19:00:00,94,32,62,FMN GV 16 Berchem TOT
54,Posthofbrug 5366,2022-01-04,20:00:00,53,19,34,FMN GV 16 Berchem TOT
54,Posthofbrug 5366,2022-01-04,21:00:00,31,15,16,FMN GV 16 Berchem TOT
54,Posthofbrug 5366,2022-01-04,22:00:00,42,19,23,FMN GV 16 Berchem TOT
54,Posthofbrug 5366,2022-01-04,23:00:00,34,14,20,FMN GV 16 Berchem TOT
54,Posthofbrug 5366,2022-01-05,00:00:00,9,5,4,FMN GV 16 Berchem TOT
54,Posthofbrug 5366,2022-01-05,01:00:00,15,6,9,FMN GV 16 Berchem TOT
54,Posthofbrug 5366,2022-01-05,02:00:00,4,1,3,FMN GV 16 Berchem TOT
54,Posthofbrug 5366,2022-01-05,03:00:00,1,1,0,FMN GV 16 Berchem TOT
54,Posthofbrug 5366,2022-01-05,04:00:00,4,4,0,FMN GV 16 Berchem TOT
54,Posthofbrug 5366,2022-01-05,05:00:00,16,13,3,FMN GV 16 Berchem TOT
54,Posthofbrug 5366,2022-01-05,06:00:00,46,39,7,FMN GV 16 Berchem TOT
54,Posthofbrug 5366,2022-01-05,07:00:00,127,87,40,FMN GV 16 Berchem TOT
54,Posthofbrug 5366,2022-01-05,08:00:00,181,136,45,FMN GV 16 Berchem TOT
54,Posthofbrug 5366,2022-01-05,09:00:00,143,95,48,FMN GV 16 Berchem TOT
54,Posthofbrug 5366,2022-01-05,10:00:00,95,70,25,FMN GV 16 Berchem TOT
54,Posthofbrug 5366,2022-01-05,11:00:00,83,58,25,FMN GV 16 Berchem TOT
54,Posthofbrug 5366,2022-01-05,12:00:00,100,58,42,FMN GV 16 Berchem TOT
54,Posthofbrug 5366,2022-01-05,13:00:00,93,46,47,FMN GV 16 Berchem TOT
54,Posthofbrug 5366,2022-01-05,14:00:00,120,57,63,FMN GV 16 Berchem TOT
54,Posthofbrug 5366,2022-01-05,15:00:00,110,38,72,FMN GV 16 Berchem TOT
54,Posthofbrug 5366,2022-01-05,16:00:00,169,68,101,FMN GV 16 Berchem TOT
54,Posthofbrug 5366,2022-01-05,17:00:00,222,86,136,FMN GV 16 Berchem TOT
54,Posthofbrug 5366,2022-01-05,18:00:00,163,59,104,FMN GV 16 Berchem TOT
54,Posthofbrug 5366,2022-01-05,19:00:00,91,36,55,FMN GV 16 Berchem TOT
54,Posthofbrug 5366,2022-01-05,20:00:00,61,34,27,FMN GV 16 Berchem TOT
54,Posthofbrug 5366,2022-01-05,21:00:00,39,18,21,FMN GV 16 Berchem TOT
54,Posthofbrug 5366,2022-01-05,22:00:00,60,21,39,FMN GV 16 Berchem TOT
54,Posthofbrug 5366,2022-01-05,23:00:00,45,14,31,FMN GV 16 Berchem TOT
54,Posthofbrug 5366,2022-01-06,00:00:00,22,5,17,FMN GV 16 Berchem TOT
54,Posthofbrug 5366,2022-01-06,01:00:00,12,5,7,FMN GV 16 Berchem TOT
54,Posthofbrug 5366,2022-01-06,02:00:00,0,0,0,FMN GV 16 Berchem TOT
54,Posthofbrug 5366,2022-01-06,03:00:00,1,0,1,FMN GV 16 Berchem TOT
54,Posthofbrug 5366,2022-01-06,04:00:00,5,3,2,FMN GV 16 Berchem TOT
54,Posthofbrug 5366,2022-01-06,05:00:00,16,12,4,FMN GV 16 Berchem TOT
54,Posthofbrug 5366,2022-01-06,06:00:00,58,44,14,FMN GV 16 Berchem TOT
54,Posthofbrug 5366,2022-01-06,07:00:00,168,129,39,FMN GV 16 Berchem TOT
54,Posthofbrug 5366,2022-01-06,08:00:00,211,156,55,FMN GV 16 Berchem TOT
54,Posthofbrug 5366,2022-01-06,09:00:00,134,103,31,FMN GV 16 Berchem TOT
54,Posthofbrug 5366,2022-01-06,10:00:00,8,6,2,FMN GV 16 Berchem TOT
54,Posthofbrug 5366,2022-01-06,11:00:00,0,0,0,FMN GV 16 Berchem TOT
54,Posthofbrug 5366,2022-01-06,12:00:00,0,0,0,FMN GV 16 Berchem TOT
54,Posthofbrug 5366,2022-01-06,13:00:00,0,0,0,FMN GV 16 Berchem TOT
54,Posthofbrug 5366,2022-01-06,14:00:00,0,0,0,FMN GV 16 Berchem TOT
54,Posthofbrug 5366,2022-01-06,15:00:00,0,0,0,FMN GV 16 Berchem TOT
54,Posthofbrug 5366,2022-01-06,16:00:00,194,83,111,FMN GV 16 Berchem TOT
54,Posthofbrug 5366,2022-01-06,17:00:00,254,79,175,FMN GV 16 Berchem TOT
54,Posthofbrug 5366,2022-01-06,18:00:00,211,64,147,FMN GV 16 Berchem TOT
54,Posthofbrug 5366,2022-01-06,19:00:00,113,41,72,FMN GV 16 Berchem TOT
54,Posthofbrug 5366,2022-01-06,20:00:00,75,31,44,FMN GV 16 Berchem TOT
54,Posthofbrug 5366,2022-01-06,21:00:00,44,15,29,FMN GV 16 Berchem TOT
54,Posthofbrug 5366,2022-01-06,22:00:00,58,21,37,FMN GV 16 Berchem TOT
54,Posthofbrug 5366,2022-01-06,23:00:00,51,13,38,FMN GV 16 Berchem TOT
54,Posthofbrug 5366,2022-01-07,00:00:00,16,6,10,FMN GV 16 Berchem TOT
54,Posthofbrug 5366,2022-01-07,01:00:00,8,4,4,FMN GV 16 Berchem TOT
54,Posthofbrug 5366,2022-01-07,02:00:00,2,0,2,FMN GV 16 Berchem TOT
54,Posthofbrug 5366,2022-01-07,03:00:00,4,1,3,FMN GV 16 Berchem TOT
54,Posthofbrug 5366,2022-01-07,04:00:00,3,3,0,FMN GV 16 Berchem TOT
54,Posthofbrug 5366,2022-01-07,05:00:00,11,10,1,FMN GV 16 Berchem TOT
54,Posthofbrug 5366,2022-01-07,06:00:00,37,29,8,FMN GV 16 Berchem TOT
54,Posthofbrug 5366,2022-01-07,07:00:00,108,84,24,FMN GV 16 Berchem TOT
54,Posthofbrug 5366,2022-01-07,08:00:00,178,132,46,FMN GV 16 Berchem TOT
54,Posthofbrug 5366,2022-01-07,09:00:00,124,96,28,FMN GV 16 Berchem TOT
54,Posthofbrug 5366,2022-01-07,10:00:00,87,64,23,FMN GV 16 Berchem TOT
54,Posthofbrug 5366,2022-01-07,11:00:00,92,55,37,FMN GV 16 Berchem TOT
54,Posthofbrug 5366,2022-01-07,12:00:00,10,5,5,FMN GV 16 Berchem TOT
54,Posthofbrug 5366,2022-01-07,13:00:00,0,0,0,FMN GV 16 Berchem TOT
54,Posthofbrug 5366,2022-01-07,14:00:00,0,0,0,FMN GV 16 Berchem TOT
54,Posthofbrug 5366,2022-01-07,15:00:00,0,0,0,FMN GV 16 Berchem TOT
54,Posthofbrug 5366,2022-01-07,16:00:00,0,0,0,FMN GV 16 Berchem TOT
54,Posthofbrug 5366,2022-01-07,17:00:00,0,0,0,FMN GV 16 Berchem TOT
54,Posthofbrug 5366,2022-01-07,18:00:00,133,54,79,FMN GV 16 Berchem TOT
54,Posthofbrug 5366,2022-01-07,19:00:00,106,48,58,FMN GV 16 Berchem TOT
54,Posthofbrug 5366,2022-01-07,20:00:00,75,39,36,FMN GV 16 Berchem TOT
54,Posthofbrug 5366,2022-01-07,21:00:00,49,29,20,FMN GV 16 Berchem TOT
54,Posthofbrug 5366,2022-01-07,22:00:00,44,13,31,FMN GV 16 Berchem TOT
54,Posthofbrug 5366,2022-01-07,23:00:00,56,15,41,FMN GV 16 Berchem TOT
54,Posthofbrug 5366,2022-01-08,00:00:00,25,10,15,FMN GV 16 Berchem TOT
54,Posthofbrug 5366,2022-01-08,01:00:00,23,10,13,FMN GV 16 Berchem TOT
54,Posthofbrug 5366,2022-01-08,02:00:00,19,8,11,FMN GV 16 Berchem TOT
54,Posthofbrug 5366,2022-01-08,03:00:00,9,4,5,FMN GV 16 Berchem TOT
54,Posthofbrug 5366,2022-01-08,04:00:00,3,2,1,FMN GV 16 Berchem TOT
54,Posthofbrug 5366,2022-01-08,05:00:00,8,5,3,FMN GV 16 Berchem TOT
54,Posthofbrug 5366,2022-01-08,06:00:00,8,6,2,FMN GV 16 Berchem TOT
54,Posthofbrug 5366,2022-01-08,07:00:00,17,11,6,FMN GV 16 Berchem TOT
54,Posthofbrug 5366,2022-01-08,08:00:00,46,26,20,FMN GV 16 Berchem TOT
54,Posthofbrug 5366,2022-01-08,09:00:00,81,57,24,FMN GV 16 Berchem TOT
54,Posthofbrug 5366,2022-01-08,10:00:00,88,53,35,FMN GV 16 Berchem TOT
54,Posthofbrug 5366,2022-01-08,11:00:00,96,54,42,FMN GV 16 Berchem TOT
54,Posthofbrug 5366,2022-01-08,12:00:00,94,55,39,FMN GV 16 Berchem TOT
54,Posthofbrug 5366,2022-01-08,13:00:00,88,45,43,FMN GV 16 Berchem TOT
54,Posthofbrug 5366,2022-01-08,14:00:00,71,45,26,FMN GV 16 Berchem TOT
54,Posthofbrug 5366,2022-01-08,15:00:00,54,26,28,FMN GV 16 Berchem TOT
54,Posthofbrug 5366,2022-01-08,16:00:00,46,16,30,FMN GV 16 Berchem TOT
54,Posthofbrug 5366,2022-01-08,17:00:00,71,33,38,FMN GV 16 Berchem TOT
54,Posthofbrug 5366,2022-01-08,18:00:00,60,29,31,FMN GV 16 Berchem TOT
54,Posthofbrug 5366,2022-01-08,19:00:00,42,15,27,FMN GV 16 Berchem TOT
54,Posthofbrug 5366,2022-01-08,20:00:00,41,14,27,FMN GV 16 Berchem TOT
54,Posthofbrug 5366,2022-01-08,21:00:00,34,18,16,FMN GV 16 Berchem TOT
54,Posthofbrug 5366,2022-01-08,22:00:00,35,21,14,FMN GV 16 Berchem TOT
54,Posthofbrug 5366,2022-01-08,23:00:00,39,16,23,FMN GV 16 Berchem TOT
54,Posthofbrug 5366,2022-01-09,00:00:00,10,6,4,FMN GV 16 Berchem TOT
54,Posthofbrug 5366,2022-01-09,01:00:00,14,2,12,FMN GV 16 Berchem TOT
54,Posthofbrug 5366,2022-01-09,02:00:00,7,1,6,FMN GV 16 Berchem TOT
54,Posthofbrug 5366,2022-01-09,03:00:00,3,2,1,FMN GV 16 Berchem TOT
54,Posthofbrug 5366,2022-01-09,04:00:00,6,3,3,FMN GV 16 Berchem TOT
54,Posthofbrug 5366,2022-01-09,05:00:00,8,2,6,FMN GV 16 Berchem TOT
54,Posthofbrug 5366,2022-01-09,06:00:00,7,6,1,FMN GV 16 Berchem TOT
54,Posthofbrug 5366,2022-01-09,07:00:00,16,11,5,FMN GV 16 Berchem TOT
54,Posthofbrug 5366,2022-01-09,08:00:00,38,23,15,FMN GV 16 Berchem TOT
54,Posthofbrug 5366,2022-01-09,09:00:00,68,42,26,FMN GV 16 Berchem TOT
54,Posthofbrug 5366,2022-01-09,10:00:00,99,68,31,FMN GV 16 Berchem TOT
54,Posthofbrug 5366,2022-01-09,11:00:00,106,57,49,FMN GV 16 Berchem TOT
54,Posthofbrug 5366,2022-01-09,12:00:00,112,53,59,FMN GV 16 Berchem TOT
54,Posthofbrug 5366,2022-01-09,13:00:00,156,86,70,FMN GV 16 Berchem TOT
54,Posthofbrug 5366,2022-01-09,14:00:00,180,109,71,FMN GV 16 Berchem TOT
54,Posthofbrug 5366,2022-01-09,15:00:00,163,70,93,FMN GV 16 Berchem TOT
54,Posthofbrug 5366,2022-01-09,16:00:00,151,64,87,FMN GV 16 Berchem TOT
54,Posthofbrug 5366,2022-01-09,17:00:00,122,59,63,FMN GV 16 Berchem TOT
54,Posthofbrug 5366,2022-01-09,18:00:00,85,35,50,FMN GV 16 Berchem TOT
54,Posthofbrug 5366,2022-01-09,19:00:00,77,45,32,FMN GV 16 Berchem TOT
54,Posthofbrug 5366,2022-01-09,20:00:00,55,25,30,FMN GV 16 Berchem TOT
54,Posthofbrug 5366,2022-01-09,21:00:00,44,24,20,FMN GV 16 Berchem TOT
54,Posthofbrug 5366,2022-01-09,22:00:00,26,11,15,FMN GV 16 Berchem TOT
54,Posthofbrug 5366,2022-01-09,23:00:00,22,10,12,FMN GV 16 Berchem TOT
54,Posthofbrug 5366,2022-01-10,00:00:00,5,1,4,FMN GV 16 Berchem TOT
54,Posthofbrug 5366,2022-01-10,01:00:00,6,1,5,FMN GV 16 Berchem TOT
54,Posthofbrug 5366,2022-01-10,02:00:00,2,0,2,FMN GV 16 Berchem TOT
54,Posthofbrug 5366,2022-01-10,03:00:00,2,1,1,FMN GV 16 Berchem TOT
54,Posthofbrug 5366,2022-01-10,04:00:00,11,11,0,FMN GV 16 Berchem TOT
54,Posthofbrug 5366,2022-01-10,05:00:00,25,19,6,FMN GV 16 Berchem TOT
54,Posthofbrug 5366,2022-01-10,06:00:00,73,58,15,FMN GV 16 Berchem TOT
54,Posthofbrug 5366,2022-01-10,07:00:00,322,229,93,FMN GV 16 Berchem TOT
54,Posthofbrug 5366,2022-01-10,08:00:00,520,394,126,FMN GV 16 Berchem TOT
54,Posthofbrug 5366,2022-01-10,09:00:00,162,123,39,FMN GV 16 Berchem TOT
54,Posthofbrug 5366,2022-01-10,10:00:00,98,68,30,FMN GV 16 Berchem TOT
54,Posthofbrug 5366,2022-01-10,11:00:00,96,51,45,FMN GV 16 Berchem TOT
54,Posthofbrug 5366,2022-01-10,12:00:00,151,78,73,FMN GV 16 Berchem TOT
54,Posthofbrug 5366,2022-01-10,13:00:00,117,57,60,FMN GV 16 Berchem TOT
54,Posthofbrug 5366,2022-01-10,14:00:00,110,58,52,FMN GV 16 Berchem TOT
54,Posthofbrug 5366,2022-01-10,15:00:00,206,70,136,FMN GV 16 Berchem TOT
54,Posthofbrug 5366,2022-01-10,16:00:00,312,87,225,FMN GV 16 Berchem TOT
54,Posthofbrug 5366,2022-01-10,17:00:00,368,125,243,FMN GV 16 Berchem TOT
54,Posthofbrug 5366,2022-01-10,18:00:00,250,78,172,FMN GV 16 Berchem TOT
54,Posthofbrug 5366,2022-01-10,19:00:00,101,36,65,FMN GV 16 Berchem TOT
54,Posthofbrug 5366,2022-01-10,20:00:00,77,45,32,FMN GV 16 Berchem TOT
54,Posthofbrug 5366,2022-01-10,21:00:00,60,30,30,FMN GV 16 Berchem TOT
54,Posthofbrug 5366,2022-01-10,22:00:00,54,21,33,FMN GV 16 Berchem TOT
54,Posthofbrug 5366,2022-01-10,23:00:00,28,14,14,FMN GV 16 Berchem TOT
54,Posthofbrug 5366,2022-01-11,00:00:00,7,3,4,FMN GV 16 Berchem TOT
54,Posthofbrug 5366,2022-01-11,01:00:00,14,7,7,FMN GV 16 Berchem TOT
54,Posthofbrug 5366,2022-01-11,02:00:00,3,0,3,FMN GV 16 Berchem TOT
54,Posthofbrug 5366,2022-01-11,03:00:00,1,1,0,FMN GV 16 Berchem TOT
54,Posthofbrug 5366,2022-01-11,04:00:00,12,10,2,FMN GV 16 Berchem TOT
54,Posthofbrug 5366,2022-01-11,05:00:00,24,20,4,FMN GV 16 Berchem TOT
54,Posthofbrug 5366,2022-01-11,06:00:00,83,69,14,FMN GV 16 Berchem TOT
54,Posthofbrug 5366,2022-01-11,07:00:00,284,228,56,FMN GV 16 Berchem TOT
54,Posthofbrug 5366,2022-01-11,08:00:00,481,362,119,FMN GV 16 Berchem TOT
54,Posthofbrug 5366,2022-01-11,09:00:00,181,132,49,FMN GV 16 Berchem TOT
54,Posthofbrug 5366,2022-01-11,10:00:00,102,69,33,FMN GV 16 Berchem TOT
54,Posthofbrug 5366,2022-01-11,11:00:00,92,43,49,FMN GV 16 Berchem TOT
54,Posthofbrug 5366,2022-01-11,12:00:00,129,64,65,FMN GV 16 Berchem TOT
54,Posthofbrug 5366,2022-01-11,13:00:00,143,70,73,FMN GV 16 Berchem TOT
54,Posthofbrug 5366,2022-01-11,14:00:00,103,46,57,FMN GV 16 Berchem TOT
54,Posthofbrug 5366,2022-01-11,15:00:00,195,78,117,FMN GV 16 Berchem TOT
54,Posthofbrug 5366,2022-01-11,16:00:00,354,118,236,FMN GV 16 Berchem TOT
54,Posthofbrug 5366,2022-01-11,17:00:00,360,111,249,FMN GV 16 Berchem TOT
54,Posthofbrug 5366,2022-01-11,18:00:00,247,94,153,FMN GV 16 Berchem TOT
54,Posthofbrug 5366,2022-01-11,19:00:00,129,55,74,FMN GV 16 Berchem TOT
54,Posthofbrug 5366,2022-01-11,20:00:00,90,36,54,FMN GV 16 Berchem TOT
54,Posthofbrug 5366,2022-01-11,21:00:00,70,28,42,FMN GV 16 Berchem TOT
54,Posthofbrug 5366,2022-01-11,22:00:00,81,36,45,FMN GV 16 Berchem TOT
54,Posthofbrug 5366,2022-01-11,23:00:00,43,22,21,FMN GV 16 Berchem TOT
54,Posthofbrug 5366,2022-01-12,00:00:00,10,2,8,FMN GV 16 Berchem TOT
54,Posthofbrug 5366,2022-01-12,01:00:00,4,2,2,FMN GV 16 Berchem TOT
54,Posthofbrug 5366,2022-01-12,02:00:00,1,1,0,FMN GV 16 Berchem TOT
54,Posthofbrug 5366,2022-01-12,03:00:00,1,0,1,FMN GV 16 Berchem TOT
54,Posthofbrug 5366,2022-01-12,04:00:00,9,8,1,FMN GV 16 Berchem TOT
54,Posthofbrug 5366,2022-01-12,05:00:00,24,19,5,FMN GV 16 Berchem TOT
54,Posthofbrug 5366,2022-01-12,06:00:00,80,64,16,FMN GV 16 Berchem TOT
54,Posthofbrug 5366,2022-01-12,07:00:00,263,200,63,FMN GV 16 Berchem TOT
54,Posthofbrug 5366,2022-01-12,08:00:00,418,306,112,FMN GV 16 Berchem TOT
54,Posthofbrug 5366,2022-01-12,09:00:00,149,108,41,FMN GV 16 Berchem TOT
54,Posthofbrug 5366,2022-01-12,10:00:00,92,47,45,FMN GV 16 Berchem TOT
54,Posthofbrug 5366,2022-01-12,11:00:00,111,56,55,FMN GV 16 Berchem TOT
54,Posthofbrug 5366,2022-01-12,12:00:00,226,102,124,FMN GV 16 Berchem TOT
54,Posthofbrug 5366,2022-01-12,13:00:00,176,82,94,FMN GV 16 Berchem TOT
54,Posthofbrug 5366,2022-01-12,14:00:00,146,73,73,FMN GV 16 Berchem TOT
54,Posthofbrug 5366,2022-01-12,15:00:00,156,68,88,FMN GV 16 Berchem TOT
54,Posthofbrug 5366,2022-01-12,16:00:00,277,105,172,FMN GV 16 Berchem TOT
54,Posthofbrug 5366,2022-01-12,17:00:00,351,132,219,FMN GV 16 Berchem TOT
54,Posthofbrug 5366,2022-01-12,18:00:00,232,78,154,FMN GV 16 Berchem TOT
54,Posthofbrug 5366,2022-01-12,19:00:00,136,59,77,FMN GV 16 Berchem TOT
54,Posthofbrug 5366,2022-01-12,20:00:00,72,43,29,FMN GV 16 Berchem TOT
54,Posthofbrug 5366,2022-01-12,21:00:00,74,31,43,FMN GV 16 Berchem TOT
54,Posthofbrug 5366,2022-01-12,22:00:00,56,23,33,FMN GV 16 Berchem TOT
54,Posthofbrug 5366,2022-01-12,23:00:00,50,21,29,FMN GV 16 Berchem TOT
54,Posthofbrug 5366,2022-01-13,00:00:00,15,5,10,FMN GV 16 Berchem TOT
54,Posthofbrug 5366,2022-01-13,01:00:00,7,5,2,FMN GV 16 Berchem TOT
54,Posthofbrug 5366,2022-01-13,02:00:00,3,0,3,FMN GV 16 Berchem TOT
54,Posthofbrug 5366,2022-01-13,03:00:00,0,0,0,FMN GV 16 Berchem TOT
54,Posthofbrug 5366,2022-01-13,04:00:00,7,6,1,FMN GV 16 Berchem TOT
54,Posthofbrug 5366,2022-01-13,05:00:00,20,15,5,FMN GV 16 Berchem TOT
54,Posthofbrug 5366,2022-01-13,06:00:00,80,62,18,FMN GV 16 Berchem TOT
54,Posthofbrug 5366,2022-01-13,07:00:00,290,228,62,FMN GV 16 Berchem TOT
54,Posthofbrug 5366,2022-01-13,08:00:00,490,374,116,FMN GV 16 Berchem TOT
54,Posthofbrug 5366,2022-01-13,09:00:00,183,140,43,FMN GV 16 Berchem TOT
54,Posthofbrug 5366,2022-01-13,10:00:00,99,64,35,FMN GV 16 Berchem TOT
54,Posthofbrug 5366,2022-01-13,11:00:00,99,52,47,FMN GV 16 Berchem TOT
54,Posthofbrug 5366,2022-01-13,12:00:00,142,74,68,FMN GV 16 Berchem TOT
54,Posthofbrug 5366,2022-01-13,13:00:00,114,55,59,FMN GV 16 Berchem TOT
54,Posthofbrug 5366,2022-01-13,14:00:00,119,51,68,FMN GV 16 Berchem TOT
54,Posthofbrug 5366,2022-01-13,15:00:00,180,69,111,FMN GV 16 Berchem TOT
54,Posthofbrug 5366,2022-01-13,16:00:00,308,83,225,FMN GV 16 Berchem TOT
54,Posthofbrug 5366,2022-01-13,17:00:00,349,100,249,FMN GV 16 Berchem TOT
54,Posthofbrug 5366,2022-01-13,18:00:00,259,85,174,FMN GV 16 Berchem TOT
54,Posthofbrug 5366,2022-01-13,19:00:00,124,52,72,FMN GV 16 Berchem TOT
54,Posthofbrug 5366,2022-01-13,20:00:00,73,32,41,FMN GV 16 Berchem TOT
54,Posthofbrug 5366,2022-01-13,21:00:00,62,23,39,FMN GV 16 Berchem TOT
54,Posthofbrug 5366,2022-01-13,22:00:00,63,35,28,FMN GV 16 Berchem TOT
54,Posthofbrug 5366,2022-01-13,23:00:00,39,9,30,FMN GV 16 Berchem TOT
54,Posthofbrug 5366,2022-01-14,00:00:00,12,2,10,FMN GV 16 Berchem TOT
54,Posthofbrug 5366,2022-01-14,01:00:00,14,3,11,FMN GV 16 Berchem TOT
54,Posthofbrug 5366,2022-01-14,02:00:00,0,0,0,FMN GV 16 Berchem TOT
54,Posthofbrug 5366,2022-01-14,03:00:00,0,0,0,FMN GV 16 Berchem TOT
54,Posthofbrug 5366,2022-01-14,04:00:00,8,7,1,FMN GV 16 Berchem TOT
54,Posthofbrug 5366,2022-01-14,05:00:00,17,12,5,FMN GV 16 Berchem TOT
54,Posthofbrug 5366,2022-01-14,06:00:00,66,56,10,FMN GV 16 Berchem TOT
54,Posthofbrug 5366,2022-01-14,07:00:00,243,176,67,FMN GV 16 Berchem TOT
54,Posthofbrug 5366,2022-01-14,08:00:00,413,317,96,FMN GV 16 Berchem TOT
54,Posthofbrug 5366,2022-01-14,09:00:00,133,102,31,FMN GV 16 Berchem TOT
54,Posthofbrug 5366,2022-01-14,10:00:00,105,67,38,FMN GV 16 Berchem TOT
54,Posthofbrug 5366,2022-01-14,11:00:00,111,69,42,FMN GV 16 Berchem TOT
54,Posthofbrug 5366,2022-01-14,12:00:00,151,76,75,FMN GV 16 Berchem TOT
54,Posthofbrug 5366,2022-01-14,13:00:00,130,72,58,FMN GV 16 Berchem TOT
54,Posthofbrug 5366,2022-01-14,14:00:00,126,52,74,FMN GV 16 Berchem TOT
54,Posthofbrug 5366,2022-01-14,15:00:00,193,62,131,FMN GV 16 Berchem TOT
54,Posthofbrug 5366,2022-01-14,16:00:00,292,93,199,FMN GV 16 Berchem TOT
54,Posthofbrug 5366,2022-01-14,17:00:00,286,97,189,FMN GV 16 Berchem TOT
54,Posthofbrug 5366,2022-01-14,18:00:00,214,84,130,FMN GV 16 Berchem TOT
54,Posthofbrug 5366,2022-01-14,19:00:00,132,76,56,FMN GV 16 Berchem TOT
54,Posthofbrug 5366,2022-01-14,20:00:00,98,48,50,FMN GV 16 Berchem TOT
54,Posthofbrug 5366,2022-01-14,21:00:00,57,21,36,FMN GV 16 Berchem TOT
54,Posthofbrug 5366,2022-01-14,22:00:00,64,17,47,FMN GV 16 Berchem TOT
54,Posthofbrug 5366,2022-01-14,23:00:00,74,21,53,FMN GV 16 Berchem TOT
54,Posthofbrug 5366,2022-01-15,00:00:00,42,18,24,FMN GV 16 Berchem TOT
54,Posthofbrug 5366,2022-01-15,01:00:00,22,10,12,FMN GV 16 Berchem TOT
54,Posthofbrug 5366,2022-01-15,02:00:00,18,5,13,FMN GV 16 Berchem TOT
54,Posthofbrug 5366,2022-01-15,03:00:00,11,8,3,FMN GV 16 Berchem TOT
54,Posthofbrug 5366,2022-01-15,04:00:00,12,4,8,FMN GV 16 Berchem TOT
54,Posthofbrug 5366,2022-01-15,05:00:00,9,6,3,FMN GV 16 Berchem TOT
54,Posthofbrug 5366,2022-01-15,06:00:00,16,10,6,FMN GV 16 Berchem TOT
54,Posthofbrug 5366,2022-01-15,07:00:00,28,22,6,FMN GV 16 Berchem TOT
54,Posthofbrug 5366,2022-01-15,08:00:00,52,27,25,FMN GV 16 Berchem TOT
54,Posthofbrug 5366,2022-01-15,09:00:00,104,67,37,FMN GV 16 Berchem TOT
54,Posthofbrug 5366,2022-01-15,10:00:00,117,80,37,FMN GV 16 Berchem TOT
54,Posthofbrug 5366,2022-01-15,11:00:00,166,102,64,FMN GV 16 Berchem TOT
54,Posthofbrug 5366,2022-01-15,12:00:00,164,95,69,FMN GV 16 Berchem TOT
54,Posthofbrug 5366,2022-01-15,13:00:00,167,87,80,FMN GV 16 Berchem TOT
54,Posthofbrug 5366,2022-01-15,14:00:00,2,1,1,FMN GV 16 Berchem TOT
54,Posthofbrug 5366,2022-01-15,15:00:00,0,0,0,FMN GV 16 Berchem TOT
54,Posthofbrug 5366,2022-01-15,16:00:00,0,0,0,FMN GV 16 Berchem TOT
54,Posthofbrug 5366,2022-01-15,17:00:00,0,0,0,FMN GV 16 Berchem TOT
54,Posthofbrug 5366,2022-01-15,18:00:00,105,48,57,FMN GV 16 Berchem TOT
54,Posthofbrug 5366,2022-01-15,19:00:00,96,45,51,FMN GV 16 Berchem TOT
54,Posthofbrug 5366,2022-01-15,20:00:00,68,29,39,FMN GV 16 Berchem TOT
54,Posthofbrug 5366,2022-01-15,21:00:00,37,22,15,FMN GV 16 Berchem TOT
54,Posthofbrug 5366,2022-01-15,22:00:00,49,20,29,FMN GV 16 Berchem TOT
54,Posthofbrug 5366,2022-01-15,23:00:00,65,31,34,FMN GV 16 Berchem TOT
54,Posthofbrug 5366,2022-01-16,00:00:00,29,11,18,FMN GV 16 Berchem TOT
54,Posthofbrug 5366,2022-01-16,01:00:00,20,8,12,FMN GV 16 Berchem TOT
54,Posthofbrug 5366,2022-01-16,02:00:00,11,3,8,FMN GV 16 Berchem TOT
54,Posthofbrug 5366,2022-01-16,03:00:00,8,3,5,FMN GV 16 Berchem TOT
54,Posthofbrug 5366,2022-01-16,04:00:00,6,5,1,FMN GV 16 Berchem TOT
54,Posthofbrug 5366,2022-01-16,05:00:00,1,1,0,FMN GV 16 Berchem TOT
54,Posthofbrug 5366,2022-01-16,06:00:00,15,13,2,FMN GV 16 Berchem TOT
54,Posthofbrug 5366,2022-01-16,07:00:00,26,14,12,FMN GV 16 Berchem TOT
54,Posthofbrug 5366,2022-01-16,08:00:00,44,20,24,FMN GV 16 Berchem TOT
54,Posthofbrug 5366,2022-01-16,09:00:00,72,36,36,FMN GV 16 Berchem TOT
54,Posthofbrug 5366,2022-01-16,10:00:00,62,34,28,FMN GV 16 Berchem TOT
54,Posthofbrug 5366,2022-01-16,11:00:00,79,50,29,FMN GV 16 Berchem TOT
54,Posthofbrug 5366,2022-01-16,12:00:00,91,58,33,FMN GV 16 Berchem TOT
54,Posthofbrug 5366,2022-01-16,13:00:00,105,48,57,FMN GV 16 Berchem TOT
54,Posthofbrug 5366,2022-01-16,14:00:00,108,69,39,FMN GV 16 Berchem TOT
54,Posthofbrug 5366,2022-01-16,15:00:00,84,43,41,FMN GV 16 Berchem TOT
54,Posthofbrug 5366,2022-01-16,16:00:00,108,48,60,FMN GV 16 Berchem TOT
54,Posthofbrug 5366,2022-01-16,17:00:00,111,48,63,FMN GV 16 Berchem TOT
54,Posthofbrug 5366,2022-01-16,18:00:00,54,24,30,FMN GV 16 Berchem TOT
54,Posthofbrug 5366,2022-01-16,19:00:00,66,28,38,FMN GV 16 Berchem TOT
54,Posthofbrug 5366,2022-01-16,20:00:00,22,11,11,FMN GV 16 Berchem TOT
54,Posthofbrug 5366,2022-01-16,21:00:00,36,17,19,FMN GV 16 Berchem TOT
54,Posthofbrug 5366,2022-01-16,22:00:00,35,16,19,FMN GV 16 Berchem TOT
54,Posthofbrug 5366,2022-01-16,23:00:00,16,7,9,FMN GV 16 Berchem TOT
54,Posthofbrug 5366,2022-01-17,00:00:00,4,2,2,FMN GV 16 Berchem TOT
54,Posthofbrug 5366,2022-01-17,01:00:00,2,0,2,FMN GV 16 Berchem TOT
54,Posthofbrug 5366,2022-01-17,02:00:00,3,0,3,FMN GV 16 Berchem TOT
54,Posthofbrug 5366,2022-01-17,03:00:00,1,0,1,FMN GV 16 Berchem TOT
54,Posthofbrug 5366,2022-01-17,04:00:00,9,8,1,FMN GV 16 Berchem TOT
54,Posthofbrug 5366,2022-01-17,05:00:00,23,19,4,FMN GV 16 Berchem TOT
54,Posthofbrug 5366,2022-01-17,06:00:00,72,58,14,FMN GV 16 Berchem TOT
54,Posthofbrug 5366,2022-01-17,07:00:00,310,237,73,FMN GV 16 Berchem TOT
54,Posthofbrug 5366,2022-01-17,08:00:00,510,386,124,FMN GV 16 Berchem TOT
54,Posthofbrug 5366,2022-01-17,09:00:00,148,111,37,FMN GV 16 Berchem TOT
54,Posthofbrug 5366,2022-01-17,10:00:00,101,58,43,FMN GV 16 Berchem TOT
54,Posthofbrug 5366,2022-01-17,11:00:00,104,53,51,FMN GV 16 Berchem TOT
54,Posthofbrug 5366,2022-01-17,12:00:00,126,67,59,FMN GV 16 Berchem TOT
54,Posthofbrug 5366,2022-01-17,13:00:00,123,64,59,FMN GV 16 Berchem TOT
54,Posthofbrug 5366,2022-01-17,14:00:00,104,47,57,FMN GV 16 Berchem TOT
54,Posthofbrug 5366,2022-01-17,15:00:00,199,77,122,FMN GV 16 Berchem TOT
54,Posthofbrug 5366,2022-01-17,16:00:00,310,99,211,FMN GV 16 Berchem TOT
54,Posthofbrug 5366,2022-01-17,17:00:00,344,107,237,FMN GV 16 Berchem TOT
54,Posthofbrug 5366,2022-01-17,18:00:00,236,70,166,FMN GV 16 Berchem TOT
54,Posthofbrug 5366,2022-01-17,19:00:00,129,46,83,FMN GV 16 Berchem TOT
54,Posthofbrug 5366,2022-01-17,20:00:00,80,35,45,FMN GV 16 Berchem TOT
54,Posthofbrug 5366,2022-01-17,21:00:00,74,31,43,FMN GV 16 Berchem TOT
54,Posthofbrug 5366,2022-01-17,22:00:00,43,25,18,FMN GV 16 Berchem TOT
54,Posthofbrug 5366,2022-01-17,23:00:00,21,10,11,FMN GV 16 Berchem TOT
54,Posthofbrug 5366,2022-01-18,00:00:00,15,4,11,FMN GV 16 Berchem TOT
54,Posthofbrug 5366,2022-01-18,01:00:00,2,1,1,FMN GV 16 Berchem TOT
54,Posthofbrug 5366,2022-01-18,02:00:00,0,0,0,FMN GV 16 Berchem TOT
54,Posthofbrug 5366,2022-01-18,03:00:00,1,0,1,FMN GV 16 Berchem TOT
54,Posthofbrug 5366,2022-01-18,04:00:00,8,7,1,FMN GV 16 Berchem TOT
54,Posthofbrug 5366,2022-01-18,05:00:00,33,27,6,FMN GV 16 Berchem TOT
54,Posthofbrug 5366,2022-01-18,06:00:00,83,68,15,FMN GV 16 Berchem TOT
54,Posthofbrug 5366,2022-01-18,07:00:00,310,225,85,FMN GV 16 Berchem TOT
54,Posthofbrug 5366,2022-01-18,08:00:00,526,410,116,FMN GV 16 Berchem TOT
54,Posthofbrug 5366,2022-01-18,09:00:00,156,108,48,FMN GV 16 Berchem TOT
54,Posthofbrug 5366,2022-01-18,10:00:00,97,66,31,FMN GV 16 Berchem TOT
54,Posthofbrug 5366,2022-01-18,11:00:00,115,57,58,FMN GV 16 Berchem TOT
54,Posthofbrug 5366,2022-01-18,12:00:00,133,65,68,FMN GV 16 Berchem TOT
54,Posthofbrug 5366,2022-01-18,13:00:00,128,63,65,FMN GV 16 Berchem TOT
54,Posthofbrug 5366,2022-01-18,14:00:00,115,55,60,FMN GV 16 Berchem TOT
54,Posthofbrug 5366,2022-01-18,15:00:00,191,70,121,FMN GV 16 Berchem TOT
54,Posthofbrug 5366,2022-01-18,16:00:00,353,106,247,FMN GV 16 Berchem TOT
54,Posthofbrug 5366,2022-01-18,17:00:00,375,110,265,FMN GV 16 Berchem TOT
54,Posthofbrug 5366,2022-01-18,18:00:00,233,81,152,FMN GV 16 Berchem TOT
54,Posthofbrug 5366,2022-01-18,19:00:00,112,53,59,FMN GV 16 Berchem TOT
54,Posthofbrug 5366,2022-01-18,20:00:00,96,36,60,FMN GV 16 Berchem TOT
54,Posthofbrug 5366,2022-01-18,21:00:00,59,26,33,FMN GV 16 Berchem TOT
54,Posthofbrug 5366,2022-01-18,22:00:00,73,35,38,FMN GV 16 Berchem TOT
54,Posthofbrug 5366,2022-01-18,23:00:00,38,12,26,FMN GV 16 Berchem TOT
54,Posthofbrug 5366,2022-01-19,00:00:00,3,2,1,FMN GV 16 Berchem TOT
54,Posthofbrug 5366,2022-01-19,01:00:00,9,3,6,FMN GV 16 Berchem TOT
54,Posthofbrug 5366,2022-01-19,02:00:00,3,1,2,FMN GV 16 Berchem TOT
54,Posthofbrug 5366,2022-01-19,03:00:00,0,0,0,FMN GV 16 Berchem TOT
54,Posthofbrug 5366,2022-01-19,04:00:00,6,5,1,FMN GV 16 Berchem TOT
54,Posthofbrug 5366,2022-01-19,05:00:00,24,18,6,FMN GV 16 Berchem TOT
54,Posthofbrug 5366,2022-01-19,06:00:00,64,54,10,FMN GV 16 Berchem TOT
54,Posthofbrug 5366,2022-01-19,07:00:00,265,196,69,FMN GV 16 Berchem TOT
54,Posthofbrug 5366,2022-01-19,08:00:00,390,300,90,FMN GV 16 Berchem TOT
54,Posthofbrug 5366,2022-01-19,09:00:00,155,119,36,FMN GV 16 Berchem TOT
54,Posthofbrug 5366,2022-01-19,10:00:00,86,54,32,FMN GV 16 Berchem TOT
54,Posthofbrug 5366,2022-01-19,11:00:00,96,62,34,FMN GV 16 Berchem TOT
54,Posthofbrug 5366,2022-01-19,12:00:00,204,80,124,FMN GV 16 Berchem TOT
54,Posthofbrug 5366,2022-01-19,13:00:00,129,49,80,FMN GV 16 Berchem TOT
54,Posthofbrug 5366,2022-01-19,14:00:00,119,60,59,FMN GV 16 Berchem TOT
54,Posthofbrug 5366,2022-01-19,15:00:00,123,46,77,FMN GV 16 Berchem TOT
54,Posthofbrug 5366,2022-01-19,16:00:00,5,1,4,FMN GV 16 Berchem TOT
54,Posthofbrug 5366,2022-01-19,17:00:00,0,0,0,FMN GV 16 Berchem TOT
54,Posthofbrug 5366,2022-01-19,18:00:00,0,0,0,FMN GV 16 Berchem TOT
54,Posthofbrug 5366,2022-01-19,19:00:00,0,0,0,FMN GV 16 Berchem TOT
54,Posthofbrug 5366,2022-01-19,20:00:00,69,34,35,FMN GV 16 Berchem TOT
54,Posthofbrug 5366,2022-01-19,21:00:00,37,20,17,FMN GV 16 Berchem TOT
54,Posthofbrug 5366,2022-01-19,22:00:00,42,14,28,FMN GV 16 Berchem TOT
54,Posthofbrug 5366,2022-01-19,23:00:00,28,11,17,FMN GV 16 Berchem TOT
54,Posthofbrug 5366,2022-01-20,00:00:00,11,2,9,FMN GV 16 Berchem TOT
54,Posthofbrug 5366,2022-01-20,01:00:00,6,2,4,FMN GV 16 Berchem TOT
54,Posthofbrug 5366,2022-01-20,02:00:00,0,0,0,FMN GV 16 Berchem TOT
54,Posthofbrug 5366,2022-01-20,03:00:00,1,1,0,FMN GV 16 Berchem TOT
54,Posthofbrug 5366,2022-01-20,04:00:00,5,4,1,FMN GV 16 Berchem TOT
54,Posthofbrug 5366,2022-01-20,05:00:00,23,18,5,FMN GV 16 Berchem TOT
54,Posthofbrug 5366,2022-01-20,06:00:00,64,53,11,FMN GV 16 Berchem TOT
54,Posthofbrug 5366,2022-01-20,07:00:00,248,190,58,FMN GV 16 Berchem TOT
54,Posthofbrug 5366,2022-01-20,08:00:00,421,346,75,FMN GV 16 Berchem TOT
54,Posthofbrug 5366,2022-01-20,09:00:00,170,128,42,FMN GV 16 Berchem TOT
54,Posthofbrug 5366,2022-01-20,10:00:00,92,67,25,FMN GV 16 Berchem TOT
54,Posthofbrug 5366,2022-01-20,11:00:00,83,47,36,FMN GV 16 Berchem TOT
54,Posthofbrug 5366,2022-01-20,12:00:00,107,59,48,FMN GV 16 Berchem TOT
54,Posthofbrug 5366,2022-01-20,13:00:00,108,49,59,FMN GV 16 Berchem TOT
54,Posthofbrug 5366,2022-01-20,14:00:00,99,43,56,FMN GV 16 Berchem TOT
54,Posthofbrug 5366,2022-01-20,15:00:00,157,69,88,FMN GV 16 Berchem TOT
54,Posthofbrug 5366,2022-01-20,16:00:00,281,82,199,FMN GV 16 Berchem TOT
54,Posthofbrug 5366,2022-01-20,17:00:00,299,98,201,FMN GV 16 Berchem TOT
54,Posthofbrug 5366,2022-01-20,18:00:00,227,68,159,FMN GV 16 Berchem TOT
54,Posthofbrug 5366,2022-01-20,19:00:00,114,43,71,FMN GV 16 Berchem TOT
54,Posthofbrug 5366,2022-01-20,20:00:00,80,43,37,FMN GV 16 Berchem TOT
54,Posthofbrug 5366,2022-01-20,21:00:00,48,19,29,FMN GV 16 Berchem TOT
54,Posthofbrug 5366,2022-01-20,22:00:00,52,23,29,FMN GV 16 Berchem TOT
54,Posthofbrug 5366,2022-01-20,23:00:00,40,10,30,FMN GV 16 Berchem TOT
54,Posthofbrug 5366,2022-01-21,00:00:00,10,5,5,FMN GV 16 Berchem TOT
54,Posthofbrug 5366,2022-01-21,01:00:00,1,0,1,FMN GV 16 Berchem TOT
54,Posthofbrug 5366,2022-01-21,02:00:00,4,0,4,FMN GV 16 Berchem TOT
54,Posthofbrug 5366,2022-01-21,03:00:00,5,2,3,FMN GV 16 Berchem TOT
54,Posthofbrug 5366,2022-01-21,04:00:00,11,10,1,FMN GV 16 Berchem TOT
54,Posthofbrug 5366,2022-01-21,05:00:00,23,16,7,FMN GV 16 Berchem TOT
54,Posthofbrug 5366,2022-01-21,06:00:00,64,53,11,FMN GV 16 Berchem TOT
54,Posthofbrug 5366,2022-01-21,07:00:00,220,158,62,FMN GV 16 Berchem TOT
54,Posthofbrug 5366,2022-01-21,08:00:00,357,276,81,FMN GV 16 Berchem TOT
54,Posthofbrug 5366,2022-01-21,09:00:00,171,126,45,FMN GV 16 Berchem TOT
54,Posthofbrug 5366,2022-01-21,10:00:00,117,80,37,FMN GV 16 Berchem TOT
54,Posthofbrug 5366,2022-01-21,11:00:00,115,61,54,FMN GV 16 Berchem TOT
54,Posthofbrug 5366,2022-01-21,12:00:00,150,83,67,FMN GV 16 Berchem TOT
54,Posthofbrug 5366,2022-01-21,13:00:00,127,72,55,FMN GV 16 Berchem TOT
54,Posthofbrug 5366,2022-01-21,14:00:00,120,40,80,FMN GV 16 Berchem TOT
54,Posthofbrug 5366,2022-01-21,15:00:00,168,63,105,FMN GV 16 Berchem TOT
54,Posthofbrug 5366,2022-01-21,16:00:00,249,68,181,FMN GV 16 Berchem TOT
54,Posthofbrug 5366,2022-01-21,17:00:00,265,91,174,FMN GV 16 Berchem TOT
54,Posthofbrug 5366,2022-01-21,18:00:00,188,81,107,FMN GV 16 Berchem TOT
54,Posthofbrug 5366,2022-01-21,19:00:00,118,63,55,FMN GV 16 Berchem TOT
54,Posthofbrug 5366,2022-01-21,20:00:00,79,51,28,FMN GV 16 Berchem TOT
54,Posthofbrug 5366,2022-01-21,21:00:00,47,27,20,FMN GV 16 Berchem TOT
54,Posthofbrug 5366,2022-01-21,22:00:00,51,28,23,FMN GV 16 Berchem TOT
54,Posthofbrug 5366,2022-01-21,23:00:00,68,12,56,FMN GV 16 Berchem TOT
54,Posthofbrug 5366,2022-01-22,00:00:00,35,10,25,FMN GV 16 Berchem TOT
54,Posthofbrug 5366,2022-01-22,01:00:00,23,7,16,FMN GV 16 Berchem TOT
54,Posthofbrug 5366,2022-01-22,02:00:00,17,1,16,FMN GV 16 Berchem TOT
54,Posthofbrug 5366,2022-01-22,03:00:00,13,0,13,FMN GV 16 Berchem TOT
54,Posthofbrug 5366,2022-01-22,04:00:00,6,5,1,FMN GV 16 Berchem TOT
54,Posthofbrug 5366,2022-01-22,05:00:00,12,9,3,FMN GV 16 Berchem TOT
54,Posthofbrug 5366,2022-01-22,06:00:00,12,9,3,FMN GV 16 Berchem TOT
54,Posthofbrug 5366,2022-01-22,07:00:00,25,17,8,FMN GV 16 Berchem TOT
54,Posthofbrug 5366,2022-01-22,08:00:00,52,22,30,FMN GV 16 Berchem TOT
54,Posthofbrug 5366,2022-01-22,09:00:00,108,79,29,FMN GV 16 Berchem TOT
54,Posthofbrug 5366,2022-01-22,10:00:00,101,64,37,FMN GV 16 Berchem TOT
54,Posthofbrug 5366,2022-01-22,11:00:00,120,75,45,FMN GV 16 Berchem TOT
54,Posthofbrug 5366,2022-01-22,12:00:00,131,72,59,FMN GV 16 Berchem TOT
54,Posthofbrug 5366,2022-01-22,13:00:00,141,88,53,FMN GV 16 Berchem TOT
54,Posthofbrug 5366,2022-01-22,14:00:00,145,86,59,FMN GV 16 Berchem TOT
54,Posthofbrug 5366,2022-01-22,15:00:00,124,61,63,FMN GV 16 Berchem TOT
54,Posthofbrug 5366,2022-01-22,16:00:00,126,56,70,FMN GV 16 Berchem TOT
54,Posthofbrug 5366,2022-01-22,17:00:00,144,69,75,FMN GV 16 Berchem TOT
54,Posthofbrug 5366,2022-01-22,18:00:00,108,63,45,FMN GV 16 Berchem TOT
54,Posthofbrug 5366,2022-01-22,19:00:00,101,50,51,FMN GV 16 Berchem TOT
54,Posthofbrug 5366,2022-01-22,20:00:00,48,12,36,FMN GV 16 Berchem TOT
54,Posthofbrug 5366,2022-01-22,21:00:00,40,25,15,FMN GV 16 Berchem TOT
54,Posthofbrug 5366,2022-01-22,22:00:00,41,16,25,FMN GV 16 Berchem TOT
54,Posthofbrug 5366,2022-01-22,23:00:00,62,19,43,FMN GV 16 Berchem TOT
54,Posthofbrug 5366,2022-01-23,00:00:00,37,14,23,FMN GV 16 Berchem TOT
54,Posthofbrug 5366,2022-01-23,01:00:00,21,8,13,FMN GV 16 Berchem TOT
54,Posthofbrug 5366,2022-01-23,02:00:00,8,3,5,FMN GV 16 Berchem TOT
54,Posthofbrug 5366,2022-01-23,03:00:00,8,3,5,FMN GV 16 Berchem TOT
54,Posthofbrug 5366,2022-01-23,04:00:00,8,3,5,FMN GV 16 Berchem TOT
54,Posthofbrug 5366,2022-01-23,05:00:00,8,6,2,FMN GV 16 Berchem TOT
54,Posthofbrug 5366,2022-01-23,06:00:00,13,12,1,FMN GV 16 Berchem TOT
54,Posthofbrug 5366,2022-01-23,07:00:00,20,11,9,FMN GV 16 Berchem TOT
54,Posthofbrug 5366,2022-01-23,08:00:00,38,19,19,FMN GV 16 Berchem TOT
54,Posthofbrug 5366,2022-01-23,09:00:00,72,40,32,FMN GV 16 Berchem TOT
54,Posthofbrug 5366,2022-01-23,10:00:00,76,49,27,FMN GV 16 Berchem TOT
54,Posthofbrug 5366,2022-01-23,11:00:00,105,69,36,FMN GV 16 Berchem TOT
54,Posthofbrug 5366,2022-01-23,12:00:00,130,84,46,FMN GV 16 Berchem TOT
54,Posthofbrug 5366,2022-01-23,13:00:00,132,68,64,FMN GV 16 Berchem TOT
54,Posthofbrug 5366,2022-01-23,14:00:00,119,67,52,FMN GV 16 Berchem TOT
54,Posthofbrug 5366,2022-01-23,15:00:00,134,58,76,FMN GV 16 Berchem TOT
54,Posthofbrug 5366,2022-01-23,16:00:00,125,67,58,FMN GV 16 Berchem TOT
54,Posthofbrug 5366,2022-01-23,17:00:00,123,46,77,FMN GV 16 Berchem TOT
54,Posthofbrug 5366,2022-01-23,18:00:00,77,37,40,FMN GV 16 Berchem TOT
54,Posthofbrug 5366,2022-01-23,19:00:00,51,17,34,FMN GV 16 Berchem TOT
54,Posthofbrug 5366,2022-01-23,20:00:00,44,22,22,FMN GV 16 Berchem TOT
54,Posthofbrug 5366,2022-01-23,21:00:00,42,28,14,FMN GV 16 Berchem TOT
54,Posthofbrug 5366,2022-01-23,22:00:00,37,19,18,FMN GV 16 Berchem TOT
54,Posthofbrug 5366,2022-01-23,23:00:00,17,4,13,FMN GV 16 Berchem TOT
54,Posthofbrug 5366,2022-01-24,00:00:00,6,3,3,FMN GV 16 Berchem TOT
54,Posthofbrug 5366,2022-01-24,01:00:00,4,2,2,FMN GV 16 Berchem TOT
54,Posthofbrug 5366,2022-01-24,02:00:00,7,4,3,FMN GV 16 Berchem TOT
54,Posthofbrug 5366,2022-01-24,03:00:00,0,0,0,FMN GV 16 Berchem TOT
54,Posthofbrug 5366,2022-01-24,04:00:00,11,11,0,FMN GV 16 Berchem TOT
54,Posthofbrug 5366,2022-01-24,05:00:00,27,16,11,FMN GV 16 Berchem TOT
54,Posthofbrug 5366,2022-01-24,06:00:00,81,65,16,FMN GV 16 Berchem TOT
54,Posthofbrug 5366,2022-01-24,07:00:00,269,185,84,FMN GV 16 Berchem TOT
54,Posthofbrug 5366,2022-01-24,08:00:00,444,346,98,FMN GV 16 Berchem TOT
54,Posthofbrug 5366,2022-01-24,09:00:00,158,115,43,FMN GV 16 Berchem TOT
54,Posthofbrug 5366,2022-01-24,10:00:00,100,60,40,FMN GV 16 Berchem TOT
54,Posthofbrug 5366,2022-01-24,11:00:00,101,59,42,FMN GV 16 Berchem TOT
54,Posthofbrug 5366,2022-01-24,12:00:00,138,70,68,FMN GV 16 Berchem TOT
54,Posthofbrug 5366,2022-01-24,13:00:00,131,68,63,FMN GV 16 Berchem TOT
54,Posthofbrug 5366,2022-01-24,14:00:00,142,65,77,FMN GV 16 Berchem TOT
54,Posthofbrug 5366,2022-01-24,15:00:00,184,69,115,FMN GV 16 Berchem TOT
54,Posthofbrug 5366,2022-01-24,16:00:00,325,107,218,FMN GV 16 Berchem TOT
54,Posthofbrug 5366,2022-01-24,17:00:00,305,105,200,FMN GV 16 Berchem TOT
54,Posthofbrug 5366,2022-01-24,18:00:00,236,77,159,FMN GV 16 Berchem TOT
54,Posthofbrug 5366,2022-01-24,19:00:00,112,41,71,FMN GV 16 Berchem TOT
54,Posthofbrug 5366,2022-01-24,20:00:00,60,31,29,FMN GV 16 Berchem TOT
54,Posthofbrug 5366,2022-01-24,21:00:00,66,32,34,FMN GV 16 Berchem TOT
54,Posthofbrug 5366,2022-01-24,22:00:00,53,24,29,FMN GV 16 Berchem TOT
54,Posthofbrug 5366,2022-01-24,23:00:00,30,14,16,FMN GV 16 Berchem TOT
54,Posthofbrug 5366,2022-01-25,00:00:00,18,8,10,FMN GV 16 Berchem TOT
54,Posthofbrug 5366,2022-01-25,01:00:00,13,4,9,FMN GV 16 Berchem TOT
54,Posthofbrug 5366,2022-01-25,02:00:00,2,1,1,FMN GV 16 Berchem TOT
54,Posthofbrug 5366,2022-01-25,03:00:00,3,0,3,FMN GV 16 Berchem TOT
54,Posthofbrug 5366,2022-01-25,04:00:00,10,9,1,FMN GV 16 Berchem TOT
54,Posthofbrug 5366,2022-01-25,05:00:00,25,18,7,FMN GV 16 Berchem TOT
54,Posthofbrug 5366,2022-01-25,06:00:00,78,62,16,FMN GV 16 Berchem TOT
54,Posthofbrug 5366,2022-01-25,07:00:00,267,195,72,FMN GV 16 Berchem TOT
54,Posthofbrug 5366,2022-01-25,08:00:00,460,354,106,FMN GV 16 Berchem TOT
54,Posthofbrug 5366,2022-01-25,09:00:00,157,123,34,FMN GV 16 Berchem TOT
54,Posthofbrug 5366,2022-01-25,10:00:00,72,44,28,FMN GV 16 Berchem TOT
54,Posthofbrug 5366,2022-01-25,11:00:00,86,40,46,FMN GV 16 Berchem TOT
54,Posthofbrug 5366,2022-01-25,12:00:00,91,46,45,FMN GV 16 Berchem TOT
54,Posthofbrug 5366,2022-01-25,13:00:00,133,73,60,FMN GV 16 Berchem TOT
54,Posthofbrug 5366,2022-01-25,14:00:00,95,40,55,FMN GV 16 Berchem TOT
54,Posthofbrug 5366,2022-01-25,15:00:00,155,51,104,FMN GV 16 Berchem TOT
54,Posthofbrug 5366,2022-01-25,16:00:00,301,93,208,FMN GV 16 Berchem TOT
54,Posthofbrug 5366,2022-01-25,17:00:00,376,116,260,FMN GV 16 Berchem TOT
54,Posthofbrug 5366,2022-01-25,18:00:00,209,84,125,FMN GV 16 Berchem TOT
54,Posthofbrug 5366,2022-01-25,19:00:00,109,45,64,FMN GV 16 Berchem TOT
54,Posthofbrug 5366,2022-01-25,20:00:00,72,23,49,FMN GV 16 Berchem TOT
54,Posthofbrug 5366,2022-01-25,21:00:00,69,32,37,FMN GV 16 Berchem TOT
54,Posthofbrug 5366,2022-01-25,22:00:00,63,31,32,FMN GV 16 Berchem TOT
54,Posthofbrug 5366,2022-01-25,23:00:00,44,14,30,FMN GV 16 Berchem TOT
54,Posthofbrug 5366,2022-01-26,00:00:00,12,7,5,FMN GV 16 Berchem TOT
54,Posthofbrug 5366,2022-01-26,01:00:00,2,0,2,FMN GV 16 Berchem TOT
54,Posthofbrug 5366,2022-01-26,02:00:00,6,0,6,FMN GV 16 Berchem TOT
54,Posthofbrug 5366,2022-01-26,03:00:00,3,0,3,FMN GV 16 Berchem TOT
54,Posthofbrug 5366,2022-01-26,04:00:00,12,8,4,FMN GV 16 Berchem TOT
54,Posthofbrug 5366,2022-01-26,05:00:00,20,17,3,FMN GV 16 Berchem TOT
54,Posthofbrug 5366,2022-01-26,06:00:00,73,59,14,FMN GV 16 Berchem TOT
54,Posthofbrug 5366,2022-01-26,07:00:00,248,181,67,FMN GV 16 Berchem TOT
54,Posthofbrug 5366,2022-01-26,08:00:00,388,281,107,FMN GV 16 Berchem TOT
54,Posthofbrug 5366,2022-01-26,09:00:00,156,105,51,FMN GV 16 Berchem TOT
54,Posthofbrug 5366,2022-01-26,10:00:00,105,75,30,FMN GV 16 Berchem TOT
54,Posthofbrug 5366,2022-01-26,11:00:00,111,50,61,FMN GV 16 Berchem TOT
54,Posthofbrug 5366,2022-01-26,12:00:00,199,91,108,FMN GV 16 Berchem TOT
54,Posthofbrug 5366,2022-01-26,13:00:00,125,59,66,FMN GV 16 Berchem TOT
54,Posthofbrug 5366,2022-01-26,14:00:00,127,52,75,FMN GV 16 Berchem TOT
54,Posthofbrug 5366,2022-01-26,15:00:00,134,61,73,FMN GV 16 Berchem TOT
54,Posthofbrug 5366,2022-01-26,16:00:00,232,89,143,FMN GV 16 Berchem TOT
54,Posthofbrug 5366,2022-01-26,17:00:00,314,107,207,FMN GV 16 Berchem TOT
54,Posthofbrug 5366,2022-01-26,18:00:00,209,83,126,FMN GV 16 Berchem TOT
54,Posthofbrug 5366,2022-01-26,19:00:00,115,43,72,FMN GV 16 Berchem TOT
54,Posthofbrug 5366,2022-01-26,20:00:00,84,41,43,FMN GV 16 Berchem TOT
54,Posthofbrug 5366,2022-01-26,21:00:00,58,31,27,FMN GV 16 Berchem TOT
54,Posthofbrug 5366,2022-01-26,22:00:00,56,21,35,FMN GV 16 Berchem TOT
54,Posthofbrug 5366,2022-01-26,23:00:00,34,12,22,FMN GV 16 Berchem TOT
54,Posthofbrug 5366,2022-01-27,00:00:00,15,4,11,FMN GV 16 Berchem TOT
54,Posthofbrug 5366,2022-01-27,01:00:00,8,1,7,FMN GV 16 Berchem TOT
54,Posthofbrug 5366,2022-01-27,02:00:00,1,0,1,FMN GV 16 Berchem TOT
54,Posthofbrug 5366,2022-01-27,03:00:00,3,0,3,FMN GV 16 Berchem TOT
54,Posthofbrug 5366,2022-01-27,04:00:00,9,8,1,FMN GV 16 Berchem TOT
54,Posthofbrug 5366,2022-01-27,05:00:00,20,13,7,FMN GV 16 Berchem TOT
54,Posthofbrug 5366,2022-01-27,06:00:00,69,57,12,FMN GV 16 Berchem TOT
54,Posthofbrug 5366,2022-01-27,07:00:00,274,210,64,FMN GV 16 Berchem TOT
54,Posthofbrug 5366,2022-01-27,08:00:00,410,305,105,FMN GV 16 Berchem TOT
54,Posthofbrug 5366,2022-01-27,09:00:00,167,121,46,FMN GV 16 Berchem TOT
54,Posthofbrug 5366,2022-01-27,10:00:00,61,40,21,FMN GV 16 Berchem TOT
54,Posthofbrug 5366,2022-01-27,11:00:00,82,40,42,FMN GV 16 Berchem TOT
54,Posthofbrug 5366,2022-01-27,12:00:00,101,48,53,FMN GV 16 Berchem TOT
54,Posthofbrug 5366,2022-01-27,13:00:00,82,43,39,FMN GV 16 Berchem TOT
54,Posthofbrug 5366,2022-01-27,14:00:00,89,34,55,FMN GV 16 Berchem TOT
54,Posthofbrug 5366,2022-01-27,15:00:00,148,59,89,FMN GV 16 Berchem TOT
54,Posthofbrug 5366,2022-01-27,16:00:00,273,91,182,FMN GV 16 Berchem TOT
54,Posthofbrug 5366,2022-01-27,17:00:00,312,93,219,FMN GV 16 Berchem TOT
54,Posthofbrug 5366,2022-01-27,18:00:00,223,78,145,FMN GV 16 Berchem TOT
54,Posthofbrug 5366,2022-01-27,19:00:00,130,61,69,FMN GV 16 Berchem TOT
54,Posthofbrug 5366,2022-01-27,20:00:00,82,35,47,FMN GV 16 Berchem TOT
54,Posthofbrug 5366,2022-01-27,21:00:00,71,31,40,FMN GV 16 Berchem TOT
54,Posthofbrug 5366,2022-01-27,22:00:00,53,27,26,FMN GV 16 Berchem TOT
54,Posthofbrug 5366,2022-01-27,23:00:00,46,10,36,FMN GV 16 Berchem TOT
54,Posthofbrug 5366,2022-01-28,00:00:00,22,6,16,FMN GV 16 Berchem TOT
54,Posthofbrug 5366,2022-01-28,01:00:00,13,3,10,FMN GV 16 Berchem TOT
54,Posthofbrug 5366,2022-01-28,02:00:00,6,1,5,FMN GV 16 Berchem TOT
54,Posthofbrug 5366,2022-01-28,03:00:00,3,0,3,FMN GV 16 Berchem TOT
54,Posthofbrug 5366,2022-01-28,04:00:00,19,13,6,FMN GV 16 Berchem TOT
54,Posthofbrug 5366,2022-01-28,05:00:00,22,16,6,FMN GV 16 Berchem TOT
54,Posthofbrug 5366,2022-01-28,06:00:00,68,54,14,FMN GV 16 Berchem TOT
54,Posthofbrug 5366,2022-01-28,07:00:00,222,160,62,FMN GV 16 Berchem TOT
54,Posthofbrug 5366,2022-01-28,08:00:00,362,283,79,FMN GV 16 Berchem TOT
54,Posthofbrug 5366,2022-01-28,09:00:00,173,122,51,FMN GV 16 Berchem TOT
54,Posthofbrug 5366,2022-01-28,10:00:00,128,81,47,FMN GV 16 Berchem TOT
54,Posthofbrug 5366,2022-01-28,11:00:00,113,57,56,FMN GV 16 Berchem TOT
54,Posthofbrug 5366,2022-01-28,12:00:00,150,70,80,FMN GV 16 Berchem TOT
54,Posthofbrug 5366,2022-01-28,13:00:00,170,100,70,FMN GV 16 Berchem TOT
54,Posthofbrug 5366,2022-01-28,14:00:00,153,67,86,FMN GV 16 Berchem TOT
54,Posthofbrug 5366,2022-01-28,15:00:00,181,57,124,FMN GV 16 Berchem TOT
54,Posthofbrug 5366,2022-01-28,16:00:00,255,83,172,FMN GV 16 Berchem TOT
54,Posthofbrug 5366,2022-01-28,17:00:00,298,99,199,FMN GV 16 Berchem TOT
54,Posthofbrug 5366,2022-01-28,18:00:00,206,89,117,FMN GV 16 Berchem TOT
54,Posthofbrug 5366,2022-01-28,19:00:00,118,58,60,FMN GV 16 Berchem TOT
54,Posthofbrug 5366,2022-01-28,20:00:00,91,52,39,FMN GV 16 Berchem TOT
54,Posthofbrug 5366,2022-01-28,21:00:00,59,28,31,FMN GV 16 Berchem TOT
54,Posthofbrug 5366,2022-01-28,22:00:00,54,16,38,FMN GV 16 Berchem TOT
54,Posthofbrug 5366,2022-01-28,23:00:00,44,15,29,FMN GV 16 Berchem TOT
54,Posthofbrug 5366,2022-01-29,00:00:00,60,8,52,FMN GV 16 Berchem TOT
54,Posthofbrug 5366,2022-01-29,01:00:00,28,9,19,FMN GV 16 Berchem TOT
54,Posthofbrug 5366,2022-01-29,02:00:00,10,2,8,FMN GV 16 Berchem TOT
54,Posthofbrug 5366,2022-01-29,03:00:00,14,7,7,FMN GV 16 Berchem TOT
54,Posthofbrug 5366,2022-01-29,04:00:00,8,4,4,FMN GV 16 Berchem TOT
54,Posthofbrug 5366,2022-01-29,05:00:00,15,10,5,FMN GV 16 Berchem TOT
54,Posthofbrug 5366,2022-01-29,06:00:00,20,13,7,FMN GV 16 Berchem TOT
54,Posthofbrug 5366,2022-01-29,07:00:00,23,16,7,FMN GV 16 Berchem TOT
54,Posthofbrug 5366,2022-01-29,08:00:00,42,28,14,FMN GV 16 Berchem TOT
54,Posthofbrug 5366,2022-01-29,09:00:00,101,67,34,FMN GV 16 Berchem TOT
54,Posthofbrug 5366,2022-01-29,10:00:00,112,60,52,FMN GV 16 Berchem TOT
54,Posthofbrug 5366,2022-01-29,11:00:00,122,75,47,FMN GV 16 Berchem TOT
54,Posthofbrug 5366,2022-01-29,12:00:00,130,81,49,FMN GV 16 Berchem TOT
54,Posthofbrug 5366,2022-01-29,13:00:00,157,100,57,FMN GV 16 Berchem TOT
54,Posthofbrug 5366,2022-01-29,14:00:00,174,93,81,FMN GV 16 Berchem TOT
54,Posthofbrug 5366,2022-01-29,15:00:00,145,69,76,FMN GV 16 Berchem TOT
54,Posthofbrug 5366,2022-01-29,16:00:00,164,61,103,FMN GV 16 Berchem TOT
54,Posthofbrug 5366,2022-01-29,17:00:00,133,60,73,FMN GV 16 Berchem TOT
54,Posthofbrug 5366,2022-01-29,18:00:00,119,53,66,FMN GV 16 Berchem TOT
54,Posthofbrug 5366,2022-01-29,19:00:00,97,50,47,FMN GV 16 Berchem TOT
54,Posthofbrug 5366,2022-01-29,20:00:00,70,33,37,FMN GV 16 Berchem TOT
54,Posthofbrug 5366,2022-01-29,21:00:00,50,25,25,FMN GV 16 Berchem TOT
54,Posthofbrug 5366,2022-01-29,22:00:00,47,18,29,FMN GV 16 Berchem TOT
54,Posthofbrug 5366,2022-01-29,23:00:00,52,21,31,FMN GV 16 Berchem TOT
54,Posthofbrug 5366,2022-01-30,00:00:00,81,33,48,FMN GV 16 Berchem TOT
54,Posthofbrug 5366,2022-01-30,01:00:00,26,14,12,FMN GV 16 Berchem TOT
54,Posthofbrug 5366,2022-01-30,02:00:00,13,6,7,FMN GV 16 Berchem TOT
54,Posthofbrug 5366,2022-01-30,03:00:00,9,4,5,FMN GV 16 Berchem TOT
54,Posthofbrug 5366,2022-01-30,04:00:00,7,4,3,FMN GV 16 Berchem TOT
54,Posthofbrug 5366,2022-01-30,05:00:00,10,6,4,FMN GV 16 Berchem TOT
54,Posthofbrug 5366,2022-01-30,06:00:00,16,10,6,FMN GV 16 Berchem TOT
54,Posthofbrug 5366,2022-01-30,07:00:00,26,17,9,FMN GV 16 Berchem TOT
54,Posthofbrug 5366,2022-01-30,08:00:00,36,21,15,FMN GV 16 Berchem TOT
54,Posthofbrug 5366,2022-01-30,09:00:00,96,53,43,FMN GV 16 Berchem TOT
54,Posthofbrug 5366,2022-01-30,10:00:00,116,69,47,FMN GV 16 Berchem TOT
54,Posthofbrug 5366,2022-01-30,11:00:00,119,75,44,FMN GV 16 Berchem TOT
54,Posthofbrug 5366,2022-01-30,12:00:00,170,97,73,FMN GV 16 Berchem TOT
54,Posthofbrug 5366,2022-01-30,13:00:00,135,71,64,FMN GV 16 Berchem TOT
54,Posthofbrug 5366,2022-01-30,14:00:00,171,92,79,FMN GV 16 Berchem TOT
54,Posthofbrug 5366,2022-01-30,15:00:00,158,83,75,FMN GV 16 Berchem TOT
54,Posthofbrug 5366,2022-01-30,16:00:00,149,63,86,FMN GV 16 Berchem TOT
54,Posthofbrug 5366,2022-01-30,17:00:00,115,54,61,FMN GV 16 Berchem TOT
54,Posthofbrug 5366,2022-01-30,18:00:00,88,36,52,FMN GV 16 Berchem TOT
54,Posthofbrug 5366,2022-01-30,19:00:00,58,29,29,FMN GV 16 Berchem TOT
54,Posthofbrug 5366,2022-01-30,20:00:00,71,33,38,FMN GV 16 Berchem TOT
54,Posthofbrug 5366,2022-01-30,21:00:00,38,19,19,FMN GV 16 Berchem TOT
54,Posthofbrug 5366,2022-01-30,22:00:00,45,22,23,FMN GV 16 Berchem TOT
54,Posthofbrug 5366,2022-01-30,23:00:00,20,8,12,FMN GV 16 Berchem TOT
54,Posthofbrug 5366,2022-01-31,00:00:00,11,5,6,FMN GV 16 Berchem TOT
54,Posthofbrug 5366,2022-01-31,01:00:00,7,2,5,FMN GV 16 Berchem TOT
54,Posthofbrug 5366,2022-01-31,02:00:00,0,0,0,FMN GV 16 Berchem TOT
54,Posthofbrug 5366,2022-01-31,03:00:00,1,0,1,FMN GV 16 Berchem TOT
54,Posthofbrug 5366,2022-01-31,04:00:00,8,6,2,FMN GV 16 Berchem TOT
54,Posthofbrug 5366,2022-01-31,05:00:00,20,13,7,FMN GV 16 Berchem TOT
54,Posthofbrug 5366,2022-01-31,06:00:00,66,55,11,FMN GV 16 Berchem TOT
54,Posthofbrug 5366,2022-01-31,07:00:00,227,173,54,FMN GV 16 Berchem TOT
54,Posthofbrug 5366,2022-01-31,08:00:00,419,312,107,FMN GV 16 Berchem TOT
54,Posthofbrug 5366,2022-01-31,09:00:00,133,97,36,FMN GV 16 Berchem TOT
54,Posthofbrug 5366,2022-01-31,10:00:00,88,59,29,FMN GV 16 Berchem TOT
54,Posthofbrug 5366,2022-01-31,11:00:00,62,31,31,FMN GV 16 Berchem TOT
54,Posthofbrug 5366,2022-01-31,12:00:00,90,44,46,FMN GV 16 Berchem TOT
54,Posthofbrug 5366,2022-01-31,13:00:00,76,44,32,FMN GV 16 Berchem TOT
54,Posthofbrug 5366,2022-01-31,14:00:00,75,36,39,FMN GV 16 Berchem TOT
54,Posthofbrug 5366,2022-01-31,15:00:00,144,39,105,FMN GV 16 Berchem TOT
54,Posthofbrug 5366,2022-01-31,16:00:00,228,78,150,FMN GV 16 Berchem TOT
54,Posthofbrug 5366,2022-01-31,17:00:00,279,86,193,FMN GV 16 Berchem TOT
54,Posthofbrug 5366,2022-01-31,18:00:00,204,64,140,FMN GV 16 Berchem TOT
54,Posthofbrug 5366,2022-01-31,19:00:00,99,43,56,FMN GV 16 Berchem TOT
54,Posthofbrug 5366,2022-01-31,20:00:00,45,26,19,FMN GV 16 Berchem TOT
54,Posthofbrug 5366,2022-01-31,21:00:00,49,27,22,FMN GV 16 Berchem TOT
54,Posthofbrug 5366,2022-01-31,22:00:00,36,18,18,FMN GV 16 Berchem TOT
54,Posthofbrug 5366,2022-01-31,23:00:00,21,7,14,FMN GV 16 Berchem TOT
54,Posthofbrug 5366,2022-02-01,00:00:00,21,4,17,FMN GV 16 Berchem TOT
54,Posthofbrug 5366,2022-02-01,01:00:00,7,1,6,FMN GV 16 Berchem TOT
54,Posthofbrug 5366,2022-02-01,02:00:00,0,0,0,FMN GV 16 Berchem TOT
54,Posthofbrug 5366,2022-02-01,03:00:00,4,1,3,FMN GV 16 Berchem TOT
54,Posthofbrug 5366,2022-02-01,04:00:00,4,3,1,FMN GV 16 Berchem TOT
54,Posthofbrug 5366,2022-02-01,05:00:00,25,17,8,FMN GV 16 Berchem TOT
54,Posthofbrug 5366,2022-02-01,06:00:00,76,64,12,FMN GV 16 Berchem TOT
54,Posthofbrug 5366,2022-02-01,07:00:00,274,207,67,FMN GV 16 Berchem TOT
54,Posthofbrug 5366,2022-02-01,08:00:00,470,361,109,FMN GV 16 Berchem TOT
54,Posthofbrug 5366,2022-02-01,09:00:00,137,105,32,FMN GV 16 Berchem TOT
54,Posthofbrug 5366,2022-02-01,10:00:00,80,47,33,FMN GV 16 Berchem TOT
54,Posthofbrug 5366,2022-02-01,11:00:00,61,33,28,FMN GV 16 Berchem TOT
54,Posthofbrug 5366,2022-02-01,12:00:00,106,60,46,FMN GV 16 Berchem TOT
54,Posthofbrug 5366,2022-02-01,13:00:00,75,38,37,FMN GV 16 Berchem TOT
54,Posthofbrug 5366,2022-02-01,14:00:00,96,49,47,FMN GV 16 Berchem TOT
54,Posthofbrug 5366,2022-02-01,15:00:00,144,45,99,FMN GV 16 Berchem TOT
54,Posthofbrug 5366,2022-02-01,16:00:00,318,97,221,FMN GV 16 Berchem TOT
54,Posthofbrug 5366,2022-02-01,17:00:00,358,114,244,FMN GV 16 Berchem TOT
54,Posthofbrug 5366,2022-02-01,18:00:00,205,66,139,FMN GV 16 Berchem TOT
54,Posthofbrug 5366,2022-02-01,19:00:00,144,66,78,FMN GV 16 Berchem TOT
54,Posthofbrug 5366,2022-02-01,20:00:00,66,26,40,FMN GV 16 Berchem TOT
54,Posthofbrug 5366,2022-02-01,21:00:00,62,25,37,FMN GV 16 Berchem TOT
54,Posthofbrug 5366,2022-02-01,22:00:00,58,22,36,FMN GV 16 Berchem TOT
54,Posthofbrug 5366,2022-02-01,23:00:00,44,14,30,FMN GV 16 Berchem TOT
54,Posthofbrug 5366,2022-02-02,00:00:00,23,14,9,FMN GV 16 Berchem TOT
54,Posthofbrug 5366,2022-02-02,01:00:00,3,0,3,FMN GV 16 Berchem TOT
54,Posthofbrug 5366,2022-02-02,02:00:00,4,0,4,FMN GV 16 Berchem TOT
54,Posthofbrug 5366,2022-02-02,03:00:00,3,2,1,FMN GV 16 Berchem TOT
54,Posthofbrug 5366,2022-02-02,04:00:00,10,5,5,FMN GV 16 Berchem TOT
54,Posthofbrug 5366,2022-02-02,05:00:00,24,16,8,FMN GV 16 Berchem TOT
54,Posthofbrug 5366,2022-02-02,06:00:00,65,54,11,FMN GV 16 Berchem TOT
54,Posthofbrug 5366,2022-02-02,07:00:00,272,208,64,FMN GV 16 Berchem TOT
54,Posthofbrug 5366,2022-02-02,08:00:00,426,319,107,FMN GV 16 Berchem TOT
54,Posthofbrug 5366,2022-02-02,09:00:00,185,124,61,FMN GV 16 Berchem TOT
54,Posthofbrug 5366,2022-02-02,10:00:00,81,53,28,FMN GV 16 Berchem TOT
54,Posthofbrug 5366,2022-02-02,11:00:00,99,60,39,FMN GV 16 Berchem TOT
54,Posthofbrug 5366,2022-02-02,12:00:00,214,94,120,FMN GV 16 Berchem TOT
54,Posthofbrug 5366,2022-02-02,13:00:00,143,63,80,FMN GV 16 Berchem TOT
54,Posthofbrug 5366,2022-02-02,14:00:00,129,54,75,FMN GV 16 Berchem TOT
54,Posthofbrug 5366,2022-02-02,15:00:00,123,55,68,FMN GV 16 Berchem TOT
54,Posthofbrug 5366,2022-02-02,16:00:00,280,100,180,FMN GV 16 Berchem TOT
54,Posthofbrug 5366,2022-02-02,17:00:00,303,109,194,FMN GV 16 Berchem TOT
54,Posthofbrug 5366,2022-02-02,18:00:00,260,97,163,FMN GV 16 Berchem TOT
54,Posthofbrug 5366,2022-02-02,19:00:00,124,60,64,FMN GV 16 Berchem TOT
54,Posthofbrug 5366,2022-02-02,20:00:00,87,43,44,FMN GV 16 Berchem TOT
54,Posthofbrug 5366,2022-02-02,21:00:00,75,40,35,FMN GV 16 Berchem TOT
54,Posthofbrug 5366,2022-02-02,22:00:00,62,25,37,FMN GV 16 Berchem TOT
54,Posthofbrug 5366,2022-02-02,23:00:00,29,17,12,FMN GV 16 Berchem TOT
54,Posthofbrug 5366,2022-02-03,00:00:00,30,13,17,FMN GV 16 Berchem TOT
54,Posthofbrug 5366,2022-02-03,01:00:00,10,1,9,FMN GV 16 Berchem TOT
54,Posthofbrug 5366,2022-02-03,02:00:00,7,0,7,FMN GV 16 Berchem TOT
54,Posthofbrug 5366,2022-02-03,03:00:00,9,1,8,FMN GV 16 Berchem TOT
54,Posthofbrug 5366,2022-02-03,04:00:00,13,8,5,FMN GV 16 Berchem TOT
54,Posthofbrug 5366,2022-02-03,05:00:00,32,21,11,FMN GV 16 Berchem TOT
54,Posthofbrug 5366,2022-02-03,06:00:00,77,66,11,FMN GV 16 Berchem TOT
54,Posthofbrug 5366,2022-02-03,07:00:00,288,214,74,FMN GV 16 Berchem TOT
54,Posthofbrug 5366,2022-02-03,08:00:00,477,361,116,FMN GV 16 Berchem TOT
54,Posthofbrug 5366,2022-02-03,09:00:00,184,134,50,FMN GV 16 Berchem TOT
54,Posthofbrug 5366,2022-02-03,10:00:00,82,57,25,FMN GV 16 Berchem TOT
54,Posthofbrug 5366,2022-02-03,11:00:00,97,44,53,FMN GV 16 Berchem TOT
54,Posthofbrug 5366,2022-02-03,12:00:00,131,65,66,FMN GV 16 Berchem TOT
54,Posthofbrug 5366,2022-02-03,13:00:00,118,52,66,FMN GV 16 Berchem TOT
54,Posthofbrug 5366,2022-02-03,14:00:00,109,42,67,FMN GV 16 Berchem TOT
54,Posthofbrug 5366,2022-02-03,15:00:00,167,57,110,FMN GV 16 Berchem TOT
54,Posthofbrug 5366,2022-02-03,16:00:00,335,118,217,FMN GV 16 Berchem TOT
54,Posthofbrug 5366,2022-02-03,17:00:00,377,119,258,FMN GV 16 Berchem TOT
54,Posthofbrug 5366,2022-02-03,18:00:00,263,99,164,FMN GV 16 Berchem TOT
54,Posthofbrug 5366,2022-02-03,19:00:00,164,78,86,FMN GV 16 Berchem TOT
54,Posthofbrug 5366,2022-02-03,20:00:00,89,48,41,FMN GV 16 Berchem TOT
54,Posthofbrug 5366,2022-02-03,21:00:00,61,29,32,FMN GV 16 Berchem TOT
54,Posthofbrug 5366,2022-02-03,22:00:00,64,24,40,FMN GV 16 Berchem TOT
54,Posthofbrug 5366,2022-02-03,23:00:00,40,11,29,FMN GV 16 Berchem TOT
54,Posthofbrug 5366,2022-02-04,00:00:00,38,8,30,FMN GV 16 Berchem TOT
54,Posthofbrug 5366,2022-02-04,01:00:00,9,3,6,FMN GV 16 Berchem TOT
54,Posthofbrug 5366,2022-02-04,02:00:00,9,2,7,FMN GV 16 Berchem TOT
54,Posthofbrug 5366,2022-02-04,03:00:00,5,1,4,FMN GV 16 Berchem TOT
54,Posthofbrug 5366,2022-02-04,04:00:00,6,3,3,FMN GV 16 Berchem TOT
54,Posthofbrug 5366,2022-02-04,05:00:00,17,13,4,FMN GV 16 Berchem TOT
54,Posthofbrug 5366,2022-02-04,06:00:00,73,60,13,FMN GV 16 Berchem TOT
54,Posthofbrug 5366,2022-02-04,07:00:00,207,155,52,FMN GV 16 Berchem TOT
54,Posthofbrug 5366,2022-02-04,08:00:00,380,286,94,FMN GV 16 Berchem TOT
54,Posthofbrug 5366,2022-02-04,09:00:00,144,105,39,FMN GV 16 Berchem TOT
54,Posthofbrug 5366,2022-02-04,10:00:00,87,58,29,FMN GV 16 Berchem TOT
54,Posthofbrug 5366,2022-02-04,11:00:00,84,57,27,FMN GV 16 Berchem TOT
54,Posthofbrug 5366,2022-02-04,12:00:00,129,63,66,FMN GV 16 Berchem TOT
54,Posthofbrug 5366,2022-02-04,13:00:00,114,51,63,FMN GV 16 Berchem TOT
54,Posthofbrug 5366,2022-02-04,14:00:00,80,33,47,FMN GV 16 Berchem TOT
54,Posthofbrug 5366,2022-02-04,15:00:00,153,50,103,FMN GV 16 Berchem TOT
54,Posthofbrug 5366,2022-02-04,16:00:00,228,80,148,FMN GV 16 Berchem TOT
54,Posthofbrug 5366,2022-02-04,17:00:00,274,83,191,FMN GV 16 Berchem TOT
54,Posthofbrug 5366,2022-02-04,18:00:00,219,88,131,FMN GV 16 Berchem TOT
54,Posthofbrug 5366,2022-02-04,19:00:00,113,60,53,FMN GV 16 Berchem TOT
54,Posthofbrug 5366,2022-02-04,20:00:00,96,53,43,FMN GV 16 Berchem TOT
54,Posthofbrug 5366,2022-02-04,21:00:00,48,29,19,FMN GV 16 Berchem TOT
54,Posthofbrug 5366,2022-02-04,22:00:00,64,27,37,FMN GV 16 Berchem TOT
54,Posthofbrug 5366,2022-02-04,23:00:00,62,12,50,FMN GV 16 Berchem TOT
54,Posthofbrug 5366,2022-02-05,00:00:00,73,21,52,FMN GV 16 Berchem TOT
54,Posthofbrug 5366,2022-02-05,01:00:00,35,11,24,FMN GV 16 Berchem TOT
54,Posthofbrug 5366,2022-02-05,02:00:00,17,6,11,FMN GV 16 Berchem TOT
54,Posthofbrug 5366,2022-02-05,03:00:00,6,1,5,FMN GV 16 Berchem TOT
54,Posthofbrug 5366,2022-02-05,04:00:00,9,4,5,FMN GV 16 Berchem TOT
54,Posthofbrug 5366,2022-02-05,05:00:00,11,8,3,FMN GV 16 Berchem TOT
54,Posthofbrug 5366,2022-02-05,06:00:00,22,15,7,FMN GV 16 Berchem TOT
54,Posthofbrug 5366,2022-02-05,07:00:00,21,15,6,FMN GV 16 Berchem TOT
54,Posthofbrug 5366,2022-02-05,08:00:00,58,26,32,FMN GV 16 Berchem TOT
54,Posthofbrug 5366,2022-02-05,09:00:00,97,70,27,FMN GV 16 Berchem TOT
54,Posthofbrug 5366,2022-02-05,10:00:00,130,77,53,FMN GV 16 Berchem TOT
54,Posthofbrug 5366,2022-02-05,11:00:00,163,112,51,FMN GV 16 Berchem TOT
54,Posthofbrug 5366,2022-02-05,12:00:00,218,127,91,FMN GV 16 Berchem TOT
54,Posthofbrug 5366,2022-02-05,13:00:00,247,140,107,FMN GV 16 Berchem TOT
54,Posthofbrug 5366,2022-02-05,14:00:00,248,137,111,FMN GV 16 Berchem TOT
54,Posthofbrug 5366,2022-02-05,15:00:00,166,78,88,FMN GV 16 Berchem TOT
54,Posthofbrug 5366,2022-02-05,16:00:00,186,72,114,FMN GV 16 Berchem TOT
54,Posthofbrug 5366,2022-02-05,17:00:00,131,59,72,FMN GV 16 Berchem TOT
54,Posthofbrug 5366,2022-02-05,18:00:00,177,89,88,FMN GV 16 Berchem TOT
54,Posthofbrug 5366,2022-02-05,19:00:00,92,38,54,FMN GV 16 Berchem TOT
54,Posthofbrug 5366,2022-02-05,20:00:00,52,27,25,FMN GV 16 Berchem TOT
54,Posthofbrug 5366,2022-02-05,21:00:00,55,34,21,FMN GV 16 Berchem TOT
54,Posthofbrug 5366,2022-02-05,22:00:00,69,31,38,FMN GV 16 Berchem TOT
54,Posthofbrug 5366,2022-02-05,23:00:00,41,11,30,FMN GV 16 Berchem TOT
54,Posthofbrug 5366,2022-02-06,00:00:00,72,17,55,FMN GV 16 Berchem TOT
54,Posthofbrug 5366,2022-02-06,01:00:00,21,10,11,FMN GV 16 Berchem TOT
54,Posthofbrug 5366,2022-02-06,02:00:00,14,5,9,FMN GV 16 Berchem TOT
54,Posthofbrug 5366,2022-02-06,03:00:00,6,4,2,FMN GV 16 Berchem TOT
54,Posthofbrug 5366,2022-02-06,04:00:00,5,1,4,FMN GV 16 Berchem TOT
54,Posthofbrug 5366,2022-02-06,05:00:00,6,3,3,FMN GV 16 Berchem TOT
54,Posthofbrug 5366,2022-02-06,06:00:00,9,8,1,FMN GV 16 Berchem TOT
54,Posthofbrug 5366,2022-02-06,07:00:00,18,9,9,FMN GV 16 Berchem TOT
54,Posthofbrug 5366,2022-02-06,08:00:00,13,10,3,FMN GV 16 Berchem TOT
54,Posthofbrug 5366,2022-02-06,09:00:00,32,21,11,FMN GV 16 Berchem TOT
54,Posthofbrug 5366,2022-02-06,10:00:00,20,10,10,FMN GV 16 Berchem TOT
54,Posthofbrug 5366,2022-02-06,11:00:00,23,11,12,FMN GV 16 Berchem TOT
54,Posthofbrug 5366,2022-02-06,12:00:00,43,20,23,FMN GV 16 Berchem TOT
54,Posthofbrug 5366,2022-02-06,13:00:00,33,17,16,FMN GV 16 Berchem TOT
54,Posthofbrug 5366,2022-02-06,14:00:00,40,26,14,FMN GV 16 Berchem TOT
54,Posthofbrug 5366,2022-02-06,15:00:00,44,20,24,FMN GV 16 Berchem TOT
54,Posthofbrug 5366,2022-02-06,16:00:00,41,18,23,FMN GV 16 Berchem TOT
54,Posthofbrug 5366,2022-02-06,17:00:00,49,21,28,FMN GV 16 Berchem TOT
54,Posthofbrug 5366,2022-02-06,18:00:00,40,17,23,FMN GV 16 Berchem TOT
54,Posthofbrug 5366,2022-02-06,19:00:00,34,15,19,FMN GV 16 Berchem TOT
54,Posthofbrug 5366,2022-02-06,20:00:00,15,6,9,FMN GV 16 Berchem TOT
54,Posthofbrug 5366,2022-02-06,21:00:00,19,12,7,FMN GV 16 Berchem TOT
54,Posthofbrug 5366,2022-02-06,22:00:00,20,9,11,FMN GV 16 Berchem TOT
54,Posthofbrug 5366,2022-02-06,23:00:00,8,3,5,FMN GV 16 Berchem TOT
54,Posthofbrug 5366,2022-02-07,00:00:00,11,4,7,FMN GV 16 Berchem TOT
54,Posthofbrug 5366,2022-02-07,01:00:00,2,1,1,FMN GV 16 Berchem TOT
54,Posthofbrug 5366,2022-02-07,02:00:00,1,0,1,FMN GV 16 Berchem TOT
54,Posthofbrug 5366,2022-02-07,03:00:00,3,1,2,FMN GV 16 Berchem TOT
54,Posthofbrug 5366,2022-02-07,04:00:00,5,4,1,FMN GV 16 Berchem TOT
54,Posthofbrug 5366,2022-02-07,05:00:00,24,20,4,FMN GV 16 Berchem TOT
54,Posthofbrug 5366,2022-02-07,06:00:00,78,64,14,FMN GV 16 Berchem TOT
54,Posthofbrug 5366,2022-02-07,07:00:00,274,205,69,FMN GV 16 Berchem TOT
54,Posthofbrug 5366,2022-02-07,08:00:00,480,361,119,FMN GV 16 Berchem TOT
54,Posthofbrug 5366,2022-02-07,09:00:00,178,135,43,FMN GV 16 Berchem TOT
54,Posthofbrug 5366,2022-02-07,10:00:00,114,79,35,FMN GV 16 Berchem TOT
54,Posthofbrug 5366,2022-02-07,11:00:00,89,55,34,FMN GV 16 Berchem TOT
54,Posthofbrug 5366,2022-02-07,12:00:00,130,73,57,FMN GV 16 Berchem TOT
54,Posthofbrug 5366,2022-02-07,13:00:00,128,65,63,FMN GV 16 Berchem TOT
54,Posthofbrug 5366,2022-02-07,14:00:00,145,72,73,FMN GV 16 Berchem TOT
54,Posthofbrug 5366,2022-02-07,15:00:00,213,76,137,FMN GV 16 Berchem TOT
54,Posthofbrug 5366,2022-02-07,16:00:00,316,99,217,FMN GV 16 Berchem TOT
54,Posthofbrug 5366,2022-02-07,17:00:00,362,105,257,FMN GV 16 Berchem TOT
54,Posthofbrug 5366,2022-02-07,18:00:00,230,66,164,FMN GV 16 Berchem TOT
54,Posthofbrug 5366,2022-02-07,19:00:00,133,55,78,FMN GV 16 Berchem TOT
54,Posthofbrug 5366,2022-02-07,20:00:00,89,41,48,FMN GV 16 Berchem TOT
54,Posthofbrug 5366,2022-02-07,21:00:00,80,27,53,FMN GV 16 Berchem TOT
54,Posthofbrug 5366,2022-02-07,22:00:00,71,31,40,FMN GV 16 Berchem TOT
54,Posthofbrug 5366,2022-02-07,23:00:00,26,12,14,FMN GV 16 Berchem TOT
54,Posthofbrug 5366,2022-02-08,00:00:00,11,3,8,FMN GV 16 Berchem TOT
54,Posthofbrug 5366,2022-02-08,01:00:00,6,2,4,FMN GV 16 Berchem TOT
54,Posthofbrug 5366,2022-02-08,02:00:00,2,2,0,FMN GV 16 Berchem TOT
54,Posthofbrug 5366,2022-02-08,03:00:00,4,3,1,FMN GV 16 Berchem TOT
54,Posthofbrug 5366,2022-02-08,04:00:00,7,6,1,FMN GV 16 Berchem TOT
54,Posthofbrug 5366,2022-02-08,05:00:00,26,19,7,FMN GV 16 Berchem TOT
54,Posthofbrug 5366,2022-02-08,06:00:00,87,71,16,FMN GV 16 Berchem TOT
54,Posthofbrug 5366,2022-02-08,07:00:00,323,247,76,FMN GV 16 Berchem TOT
54,Posthofbrug 5366,2022-02-08,08:00:00,539,421,118,FMN GV 16 Berchem TOT
54,Posthofbrug 5366,2022-02-08,09:00:00,194,140,54,FMN GV 16 Berchem TOT
54,Posthofbrug 5366,2022-02-08,10:00:00,97,70,27,FMN GV 16 Berchem TOT
54,Posthofbrug 5366,2022-02-08,11:00:00,89,40,49,FMN GV 16 Berchem TOT
54,Posthofbrug 5366,2022-02-08,12:00:00,116,58,58,FMN GV 16 Berchem TOT
54,Posthofbrug 5366,2022-02-08,13:00:00,118,59,59,FMN GV 16 Berchem TOT
54,Posthofbrug 5366,2022-02-08,14:00:00,108,55,53,FMN GV 16 Berchem TOT
54,Posthofbrug 5366,2022-02-08,15:00:00,197,73,124,FMN GV 16 Berchem TOT
54,Posthofbrug 5366,2022-02-08,16:00:00,18,7,11,FMN GV 16 Berchem TOT
54,Posthofbrug 5366,2022-02-08,17:00:00,0,0,0,FMN GV 16 Berchem TOT
54,Posthofbrug 5366,2022-02-08,18:00:00,239,89,150,FMN GV 16 Berchem TOT
54,Posthofbrug 5366,2022-02-08,19:00:00,160,71,89,FMN GV 16 Berchem TOT
54,Posthofbrug 5366,2022-02-08,20:00:00,67,26,41,FMN GV 16 Berchem TOT
54,Posthofbrug 5366,2022-02-08,21:00:00,86,39,47,FMN GV 16 Berchem TOT
54,Posthofbrug 5366,2022-02-08,22:00:00,80,28,52,FMN GV 16 Berchem TOT
54,Posthofbrug 5366,2022-02-08,23:00:00,47,15,32,FMN GV 16 Berchem TOT
54,Posthofbrug 5366,2022-02-09,00:00:00,24,6,18,FMN GV 16 Berchem TOT
54,Posthofbrug 5366,2022-02-09,01:00:00,7,1,6,FMN GV 16 Berchem TOT
54,Posthofbrug 5366,2022-02-09,02:00:00,5,1,4,FMN GV 16 Berchem TOT
54,Posthofbrug 5366,2022-02-09,03:00:00,4,1,3,FMN GV 16 Berchem TOT
54,Posthofbrug 5366,2022-02-09,04:00:00,13,10,3,FMN GV 16 Berchem TOT
54,Posthofbrug 5366,2022-02-09,05:00:00,31,24,7,FMN GV 16 Berchem TOT
54,Posthofbrug 5366,2022-02-09,06:00:00,84,65,19,FMN GV 16 Berchem TOT
54,Posthofbrug 5366,2022-02-09,07:00:00,279,208,71,FMN GV 16 Berchem TOT
54,Posthofbrug 5366,2022-02-09,08:00:00,443,334,109,FMN GV 16 Berchem TOT
54,Posthofbrug 5366,2022-02-09,09:00:00,169,116,53,FMN GV 16 Berchem TOT
54,Posthofbrug 5366,2022-02-09,10:00:00,105,82,23,FMN GV 16 Berchem TOT
54,Posthofbrug 5366,2022-02-09,11:00:00,104,51,53,FMN GV 16 Berchem TOT
54,Posthofbrug 5366,2022-02-09,12:00:00,223,101,122,FMN GV 16 Berchem TOT
54,Posthofbrug 5366,2022-02-09,13:00:00,165,76,89,FMN GV 16 Berchem TOT
54,Posthofbrug 5366,2022-02-09,14:00:00,140,72,68,FMN GV 16 Berchem TOT
54,Posthofbrug 5366,2022-02-09,15:00:00,166,67,99,FMN GV 16 Berchem TOT
54,Posthofbrug 5366,2022-02-09,16:00:00,289,104,185,FMN GV 16 Berchem TOT
54,Posthofbrug 5366,2022-02-09,17:00:00,338,122,216,FMN GV 16 Berchem TOT
54,Posthofbrug 5366,2022-02-09,18:00:00,286,112,174,FMN GV 16 Berchem TOT
54,Posthofbrug 5366,2022-02-09,19:00:00,143,52,91,FMN GV 16 Berchem TOT
54,Posthofbrug 5366,2022-02-09,20:00:00,79,49,30,FMN GV 16 Berchem TOT
54,Posthofbrug 5366,2022-02-09,21:00:00,76,39,37,FMN GV 16 Berchem TOT
54,Posthofbrug 5366,2022-02-09,22:00:00,65,18,47,FMN GV 16 Berchem TOT
54,Posthofbrug 5366,2022-02-09,23:00:00,43,17,26,FMN GV 16 Berchem TOT
54,Posthofbrug 5366,2022-02-10,00:00:00,20,9,11,FMN GV 16 Berchem TOT
54,Posthofbrug 5366,2022-02-10,01:00:00,9,5,4,FMN GV 16 Berchem TOT
54,Posthofbrug 5366,2022-02-10,02:00:00,0,0,0,FMN GV 16 Berchem TOT
54,Posthofbrug 5366,2022-02-10,03:00:00,2,1,1,FMN GV 16 Berchem TOT
54,Posthofbrug 5366,2022-02-10,04:00:00,8,7,1,FMN GV 16 Berchem TOT
54,Posthofbrug 5366,2022-02-10,05:00:00,29,22,7,FMN GV 16 Berchem TOT
54,Posthofbrug 5366,2022-02-10,06:00:00,75,60,15,FMN GV 16 Berchem TOT
54,Posthofbrug 5366,2022-02-10,07:00:00,290,226,64,FMN GV 16 Berchem TOT
54,Posthofbrug 5366,2022-02-10,08:00:00,474,369,105,FMN GV 16 Berchem TOT
54,Posthofbrug 5366,2022-02-10,09:00:00,142,110,32,FMN GV 16 Berchem TOT
54,Posthofbrug 5366,2022-02-10,10:00:00,69,45,24,FMN GV 16 Berchem TOT
54,Posthofbrug 5366,2022-02-10,11:00:00,46,27,19,FMN GV 16 Berchem TOT
54,Posthofbrug 5366,2022-02-10,12:00:00,98,40,58,FMN GV 16 Berchem TOT
54,Posthofbrug 5366,2022-02-10,13:00:00,98,53,45,FMN GV 16 Berchem TOT
54,Posthofbrug 5366,2022-02-10,14:00:00,112,51,61,FMN GV 16 Berchem TOT
54,Posthofbrug 5366,2022-02-10,15:00:00,152,38,114,FMN GV 16 Berchem TOT
54,Posthofbrug 5366,2022-02-10,16:00:00,313,101,212,FMN GV 16 Berchem TOT
54,Posthofbrug 5366,2022-02-10,17:00:00,343,102,241,FMN GV 16 Berchem TOT
54,Posthofbrug 5366,2022-02-10,18:00:00,248,81,167,FMN GV 16 Berchem TOT
54,Posthofbrug 5366,2022-02-10,19:00:00,124,62,62,FMN GV 16 Berchem TOT
54,Posthofbrug 5366,2022-02-10,20:00:00,77,41,36,FMN GV 16 Berchem TOT
54,Posthofbrug 5366,2022-02-10,21:00:00,58,29,29,FMN GV 16 Berchem TOT
54,Posthofbrug 5366,2022-02-10,22:00:00,73,37,36,FMN GV 16 Berchem TOT
54,Posthofbrug 5366,2022-02-10,23:00:00,42,11,31,FMN GV 16 Berchem TOT
54,Posthofbrug 5366,2022-02-11,00:00:00,28,6,22,FMN GV 16 Berchem TOT
54,Posthofbrug 5366,2022-02-11,01:00:00,10,3,7,FMN GV 16 Berchem TOT
54,Posthofbrug 5366,2022-02-11,02:00:00,2,0,2,FMN GV 16 Berchem TOT
54,Posthofbrug 5366,2022-02-11,03:00:00,3,1,2,FMN GV 16 Berchem TOT
54,Posthofbrug 5366,2022-02-11,04:00:00,8,7,1,FMN GV 16 Berchem TOT
54,Posthofbrug 5366,2022-02-11,05:00:00,25,16,9,FMN GV 16 Berchem TOT
54,Posthofbrug 5366,2022-02-11,06:00:00,74,54,20,FMN GV 16 Berchem TOT
54,Posthofbrug 5366,2022-02-11,07:00:00,255,192,63,FMN GV 16 Berchem TOT
54,Posthofbrug 5366,2022-02-11,08:00:00,434,317,117,FMN GV 16 Berchem TOT
54,Posthofbrug 5366,2022-02-11,09:00:00,166,126,40,FMN GV 16 Berchem TOT
54,Posthofbrug 5366,2022-02-11,10:00:00,84,65,19,FMN GV 16 Berchem TOT
54,Posthofbrug 5366,2022-02-11,11:00:00,93,51,42,FMN GV 16 Berchem TOT
54,Posthofbrug 5366,2022-02-11,12:00:00,136,73,63,FMN GV 16 Berchem TOT
54,Posthofbrug 5366,2022-02-11,13:00:00,137,80,57,FMN GV 16 Berchem TOT
54,Posthofbrug 5366,2022-02-11,14:00:00,154,88,66,FMN GV 16 Berchem TOT
54,Posthofbrug 5366,2022-02-11,15:00:00,226,84,142,FMN GV 16 Berchem TOT
54,Posthofbrug 5366,2022-02-11,16:00:00,310,115,195,FMN GV 16 Berchem TOT
54,Posthofbrug 5366,2022-02-11,17:00:00,338,128,210,FMN GV 16 Berchem TOT
54,Posthofbrug 5366,2022-02-11,18:00:00,247,102,145,FMN GV 16 Berchem TOT
54,Posthofbrug 5366,2022-02-11,19:00:00,155,76,79,FMN GV 16 Berchem TOT
54,Posthofbrug 5366,2022-02-11,20:00:00,85,52,33,FMN GV 16 Berchem TOT
54,Posthofbrug 5366,2022-02-11,21:00:00,80,40,40,FMN GV 16 Berchem TOT
54,Posthofbrug 5366,2022-02-11,22:00:00,84,45,39,FMN GV 16 Berchem TOT
54,Posthofbrug 5366,2022-02-11,23:00:00,76,17,59,FMN GV 16 Berchem TOT
54,Posthofbrug 5366,2022-02-12,00:00:00,81,16,65,FMN GV 16 Berchem TOT
54,Posthofbrug 5366,2022-02-12,01:00:00,36,11,25,FMN GV 16 Berchem TOT
54,Posthofbrug 5366,2022-02-12,02:00:00,25,10,15,FMN GV 16 Berchem TOT
54,Posthofbrug 5366,2022-02-12,03:00:00,9,2,7,FMN GV 16 Berchem TOT
54,Posthofbrug 5366,2022-02-12,04:00:00,9,6,3,FMN GV 16 Berchem TOT
54,Posthofbrug 5366,2022-02-12,05:00:00,13,10,3,FMN GV 16 Berchem TOT
54,Posthofbrug 5366,2022-02-12,06:00:00,17,13,4,FMN GV 16 Berchem TOT
54,Posthofbrug 5366,2022-02-12,07:00:00,28,15,13,FMN GV 16 Berchem TOT
54,Posthofbrug 5366,2022-02-12,08:00:00,56,27,29,FMN GV 16 Berchem TOT
54,Posthofbrug 5366,2022-02-12,09:00:00,123,80,43,FMN GV 16 Berchem TOT
54,Posthofbrug 5366,2022-02-12,10:00:00,122,74,48,FMN GV 16 Berchem TOT
54,Posthofbrug 5366,2022-02-12,11:00:00,169,104,65,FMN GV 16 Berchem TOT
54,Posthofbrug 5366,2022-02-12,12:00:00,181,111,70,FMN GV 16 Berchem TOT
54,Posthofbrug 5366,2022-02-12,13:00:00,185,115,70,FMN GV 16 Berchem TOT
54,Posthofbrug 5366,2022-02-12,14:00:00,226,129,97,FMN GV 16 Berchem TOT
54,Posthofbrug 5366,2022-02-12,15:00:00,184,94,90,FMN GV 16 Berchem TOT
54,Posthofbrug 5366,2022-02-12,16:00:00,208,78,130,FMN GV 16 Berchem TOT
54,Posthofbrug 5366,2022-02-12,17:00:00,175,73,102,FMN GV 16 Berchem TOT
54,Posthofbrug 5366,2022-02-12,18:00:00,140,71,69,FMN GV 16 Berchem TOT
54,Posthofbrug 5366,2022-02-12,19:00:00,117,69,48,FMN GV 16 Berchem TOT
54,Posthofbrug 5366,2022-02-12,20:00:00,65,39,26,FMN GV 16 Berchem TOT
54,Posthofbrug 5366,2022-02-12,21:00:00,51,23,28,FMN GV 16 Berchem TOT
54,Posthofbrug 5366,2022-02-12,22:00:00,90,34,56,FMN GV 16 Berchem TOT
54,Posthofbrug 5366,2022-02-12,23:00:00,75,26,49,FMN GV 16 Berchem TOT
54,Posthofbrug 5366,2022-02-13,00:00:00,64,12,52,FMN GV 16 Berchem TOT
54,Posthofbrug 5366,2022-02-13,01:00:00,30,5,25,FMN GV 16 Berchem TOT
54,Posthofbrug 5366,2022-02-13,02:00:00,15,5,10,FMN GV 16 Berchem TOT
54,Posthofbrug 5366,2022-02-13,03:00:00,10,3,7,FMN GV 16 Berchem TOT
54,Posthofbrug 5366,2022-02-13,04:00:00,4,1,3,FMN GV 16 Berchem TOT
54,Posthofbrug 5366,2022-02-13,05:00:00,11,6,5,FMN GV 16 Berchem TOT
54,Posthofbrug 5366,2022-02-13,06:00:00,12,9,3,FMN GV 16 Berchem TOT
54,Posthofbrug 5366,2022-02-13,07:00:00,20,14,6,FMN GV 16 Berchem TOT
54,Posthofbrug 5366,2022-02-13,08:00:00,39,25,14,FMN GV 16 Berchem TOT
54,Posthofbrug 5366,2022-02-13,09:00:00,96,59,37,FMN GV 16 Berchem TOT
54,Posthofbrug 5366,2022-02-13,10:00:00,110,63,47,FMN GV 16 Berchem TOT
54,Posthofbrug 5366,2022-02-13,11:00:00,98,54,44,FMN GV 16 Berchem TOT
54,Posthofbrug 5366,2022-02-13,12:00:00,143,83,60,FMN GV 16 Berchem TOT
54,Posthofbrug 5366,2022-02-13,13:00:00,159,74,85,FMN GV 16 Berchem TOT
54,Posthofbrug 5366,2022-02-13,14:00:00,9,1,8,FMN GV 16 Berchem TOT
54,Posthofbrug 5366,2022-02-13,15:00:00,0,0,0,FMN GV 16 Berchem TOT
54,Posthofbrug 5366,2022-02-13,16:00:00,0,0,0,FMN GV 16 Berchem TOT
54,Posthofbrug 5366,2022-02-13,17:00:00,0,0,0,FMN GV 16 Berchem TOT
54,Posthofbrug 5366,2022-02-13,18:00:00,0,0,0,FMN GV 16 Berchem TOT
54,Posthofbrug 5366,2022-02-13,19:00:00,0,0,0,FMN GV 16 Berchem TOT
54,Posthofbrug 5366,2022-02-13,20:00:00,57,16,41,FMN GV 16 Berchem TOT
54,Posthofbrug 5366,2022-02-13,21:00:00,40,21,19,FMN GV 16 Berchem TOT
54,Posthofbrug 5366,2022-02-13,22:00:00,45,25,20,FMN GV 16 Berchem TOT
54,Posthofbrug 5366,2022-02-13,23:00:00,54,13,41,FMN GV 16 Berchem TOT
54,Posthofbrug 5366,2022-02-14,00:00:00,11,5,6,FMN GV 16 Berchem TOT
54,Posthofbrug 5366,2022-02-14,01:00:00,9,3,6,FMN GV 16 Berchem TOT
54,Posthofbrug 5366,2022-02-14,02:00:00,2,0,2,FMN GV 16 Berchem TOT
54,Posthofbrug 5366,2022-02-14,03:00:00,3,3,0,FMN GV 16 Berchem TOT
54,Posthofbrug 5366,2022-02-14,04:00:00,11,5,6,FMN GV 16 Berchem TOT
54,Posthofbrug 5366,2022-02-14,05:00:00,26,18,8,FMN GV 16 Berchem TOT
54,Posthofbrug 5366,2022-02-14,06:00:00,92,71,21,FMN GV 16 Berchem TOT
54,Posthofbrug 5366,2022-02-14,07:00:00,289,218,71,FMN GV 16 Berchem TOT
54,Posthofbrug 5366,2022-02-14,08:00:00,503,377,126,FMN GV 16 Berchem TOT
54,Posthofbrug 5366,2022-02-14,09:00:00,164,130,34,FMN GV 16 Berchem TOT
54,Posthofbrug 5366,2022-02-14,10:00:00,103,77,26,FMN GV 16 Berchem TOT
54,Posthofbrug 5366,2022-02-14,11:00:00,93,58,35,FMN GV 16 Berchem TOT
54,Posthofbrug 5366,2022-02-14,12:00:00,134,70,64,FMN GV 16 Berchem TOT
54,Posthofbrug 5366,2022-02-14,13:00:00,122,58,64,FMN GV 16 Berchem TOT
54,Posthofbrug 5366,2022-02-14,14:00:00,90,34,56,FMN GV 16 Berchem TOT
54,Posthofbrug 5366,2022-02-14,15:00:00,189,67,122,FMN GV 16 Berchem TOT
54,Posthofbrug 5366,2022-02-14,16:00:00,328,102,226,FMN GV 16 Berchem TOT
54,Posthofbrug 5366,2022-02-14,17:00:00,379,130,249,FMN GV 16 Berchem TOT
54,Posthofbrug 5366,2022-02-14,18:00:00,268,100,168,FMN GV 16 Berchem TOT
54,Posthofbrug 5366,2022-02-14,19:00:00,144,63,81,FMN GV 16 Berchem TOT
54,Posthofbrug 5366,2022-02-14,20:00:00,75,35,40,FMN GV 16 Berchem TOT
54,Posthofbrug 5366,2022-02-14,21:00:00,66,32,34,FMN GV 16 Berchem TOT
54,Posthofbrug 5366,2022-02-14,22:00:00,65,22,43,FMN GV 16 Berchem TOT
54,Posthofbrug 5366,2022-02-14,23:00:00,21,5,16,FMN GV 16 Berchem TOT
54,Posthofbrug 5366,2022-02-15,00:00:00,14,4,10,FMN GV 16 Berchem TOT
54,Posthofbrug 5366,2022-02-15,01:00:00,5,0,5,FMN GV 16 Berchem TOT
54,Posthofbrug 5366,2022-02-15,02:00:00,3,0,3,FMN GV 16 Berchem TOT
54,Posthofbrug 5366,2022-02-15,03:00:00,2,2,0,FMN GV 16 Berchem TOT
54,Posthofbrug 5366,2022-02-15,04:00:00,10,5,5,FMN GV 16 Berchem TOT
54,Posthofbrug 5366,2022-02-15,05:00:00,27,21,6,FMN GV 16 Berchem TOT
54,Posthofbrug 5366,2022-02-15,06:00:00,85,67,18,FMN GV 16 Berchem TOT
54,Posthofbrug 5366,2022-02-15,07:00:00,342,249,93,FMN GV 16 Berchem TOT
54,Posthofbrug 5366,2022-02-15,08:00:00,568,439,129,FMN GV 16 Berchem TOT
54,Posthofbrug 5366,2022-02-15,09:00:00,192,153,39,FMN GV 16 Berchem TOT
54,Posthofbrug 5366,2022-02-15,10:00:00,91,60,31,FMN GV 16 Berchem TOT
54,Posthofbrug 5366,2022-02-15,11:00:00,88,48,40,FMN GV 16 Berchem TOT
54,Posthofbrug 5366,2022-02-15,12:00:00,150,80,70,FMN GV 16 Berchem TOT
54,Posthofbrug 5366,2022-02-15,13:00:00,124,72,52,FMN GV 16 Berchem TOT
54,Posthofbrug 5366,2022-02-15,14:00:00,103,43,60,FMN GV 16 Berchem TOT
54,Posthofbrug 5366,2022-02-15,15:00:00,201,70,131,FMN GV 16 Berchem TOT
54,Posthofbrug 5366,2022-02-15,16:00:00,362,108,254,FMN GV 16 Berchem TOT
54,Posthofbrug 5366,2022-02-15,17:00:00,377,108,269,FMN GV 16 Berchem TOT
54,Posthofbrug 5366,2022-02-15,18:00:00,228,76,152,FMN GV 16 Berchem TOT
54,Posthofbrug 5366,2022-02-15,19:00:00,119,43,76,FMN GV 16 Berchem TOT
54,Posthofbrug 5366,2022-02-15,20:00:00,80,23,57,FMN GV 16 Berchem TOT
54,Posthofbrug 5366,2022-02-15,21:00:00,60,23,37,FMN GV 16 Berchem TOT
54,Posthofbrug 5366,2022-02-15,22:00:00,52,18,34,FMN GV 16 Berchem TOT
54,Posthofbrug 5366,2022-02-15,23:00:00,45,16,29,FMN GV 16 Berchem TOT
54,Posthofbrug 5366,2022-02-16,00:00:00,14,5,9,FMN GV 16 Berchem TOT
54,Posthofbrug 5366,2022-02-16,01:00:00,4,1,3,FMN GV 16 Berchem TOT
54,Posthofbrug 5366,2022-02-16,02:00:00,1,0,1,FMN GV 16 Berchem TOT
54,Posthofbrug 5366,2022-02-16,03:00:00,1,1,0,FMN GV 16 Berchem TOT
54,Posthofbrug 5366,2022-02-16,04:00:00,6,6,0,FMN GV 16 Berchem TOT
54,Posthofbrug 5366,2022-02-16,05:00:00,22,13,9,FMN GV 16 Berchem TOT
54,Posthofbrug 5366,2022-02-16,06:00:00,70,57,13,FMN GV 16 Berchem TOT
54,Posthofbrug 5366,2022-02-16,07:00:00,275,209,66,FMN GV 16 Berchem TOT
54,Posthofbrug 5366,2022-02-16,08:00:00,445,319,126,FMN GV 16 Berchem TOT
54,Posthofbrug 5366,2022-02-16,09:00:00,159,108,51,FMN GV 16 Berchem TOT
54,Posthofbrug 5366,2022-02-16,10:00:00,75,39,36,FMN GV 16 Berchem TOT
54,Posthofbrug 5366,2022-02-16,11:00:00,81,45,36,FMN GV 16 Berchem TOT
54,Posthofbrug 5366,2022-02-16,12:00:00,191,78,113,FMN GV 16 Berchem TOT
54,Posthofbrug 5366,2022-02-16,13:00:00,135,63,72,FMN GV 16 Berchem TOT
54,Posthofbrug 5366,2022-02-16,14:00:00,133,59,74,FMN GV 16 Berchem TOT
54,Posthofbrug 5366,2022-02-16,15:00:00,129,47,82,FMN GV 16 Berchem TOT
54,Posthofbrug 5366,2022-02-16,16:00:00,221,86,135,FMN GV 16 Berchem TOT
54,Posthofbrug 5366,2022-02-16,17:00:00,321,121,200,FMN GV 16 Berchem TOT
54,Posthofbrug 5366,2022-02-16,18:00:00,232,88,144,FMN GV 16 Berchem TOT
54,Posthofbrug 5366,2022-02-16,19:00:00,102,39,63,FMN GV 16 Berchem TOT
54,Posthofbrug 5366,2022-02-16,20:00:00,79,42,37,FMN GV 16 Berchem TOT
54,Posthofbrug 5366,2022-02-16,21:00:00,66,36,30,FMN GV 16 Berchem TOT
54,Posthofbrug 5366,2022-02-16,22:00:00,52,16,36,FMN GV 16 Berchem TOT
54,Posthofbrug 5366,2022-02-16,23:00:00,26,8,18,FMN GV 16 Berchem TOT
54,Posthofbrug 5366,2022-02-17,00:00:00,27,5,22,FMN GV 16 Berchem TOT
54,Posthofbrug 5366,2022-02-17,01:00:00,3,0,3,FMN GV 16 Berchem TOT
54,Posthofbrug 5366,2022-02-17,02:00:00,1,1,0,FMN GV 16 Berchem TOT
54,Posthofbrug 5366,2022-02-17,03:00:00,0,0,0,FMN GV 16 Berchem TOT
54,Posthofbrug 5366,2022-02-17,04:00:00,8,6,2,FMN GV 16 Berchem TOT
54,Posthofbrug 5366,2022-02-17,05:00:00,23,15,8,FMN GV 16 Berchem TOT
54,Posthofbrug 5366,2022-02-17,06:00:00,73,61,12,FMN GV 16 Berchem TOT
54,Posthofbrug 5366,2022-02-17,07:00:00,302,222,80,FMN GV 16 Berchem TOT
54,Posthofbrug 5366,2022-02-17,08:00:00,510,393,117,FMN GV 16 Berchem TOT
54,Posthofbrug 5366,2022-02-17,09:00:00,211,167,44,FMN GV 16 Berchem TOT
54,Posthofbrug 5366,2022-02-17,10:00:00,108,76,32,FMN GV 16 Berchem TOT
54,Posthofbrug 5366,2022-02-17,11:00:00,86,46,40,FMN GV 16 Berchem TOT
54,Posthofbrug 5366,2022-02-17,12:00:00,160,105,55,FMN GV 16 Berchem TOT
54,Posthofbrug 5366,2022-02-17,13:00:00,133,70,63,FMN GV 16 Berchem TOT
54,Posthofbrug 5366,2022-02-17,14:00:00,108,38,70,FMN GV 16 Berchem TOT
54,Posthofbrug 5366,2022-02-17,15:00:00,173,62,111,FMN GV 16 Berchem TOT
54,Posthofbrug 5366,2022-02-17,16:00:00,342,98,244,FMN GV 16 Berchem TOT
54,Posthofbrug 5366,2022-02-17,17:00:00,422,147,275,FMN GV 16 Berchem TOT
54,Posthofbrug 5366,2022-02-17,18:00:00,297,97,200,FMN GV 16 Berchem TOT
54,Posthofbrug 5366,2022-02-17,19:00:00,159,73,86,FMN GV 16 Berchem TOT
54,Posthofbrug 5366,2022-02-17,20:00:00,89,50,39,FMN GV 16 Berchem TOT
54,Posthofbrug 5366,2022-02-17,21:00:00,64,34,30,FMN GV 16 Berchem TOT
54,Posthofbrug 5366,2022-02-17,22:00:00,72,32,40,FMN GV 16 Berchem TOT
54,Posthofbrug 5366,2022-02-17,23:00:00,60,20,40,FMN GV 16 Berchem TOT
54,Posthofbrug 5366,2022-02-18,00:00:00,26,2,24,FMN GV 16 Berchem TOT
54,Posthofbrug 5366,2022-02-18,01:00:00,9,1,8,FMN GV 16 Berchem TOT
54,Posthofbrug 5366,2022-02-18,02:00:00,10,1,9,FMN GV 16 Berchem TOT
54,Posthofbrug 5366,2022-02-18,03:00:00,5,0,5,FMN GV 16 Berchem TOT
54,Posthofbrug 5366,2022-02-18,04:00:00,8,3,5,FMN GV 16 Berchem TOT
54,Posthofbrug 5366,2022-02-18,05:00:00,15,12,3,FMN GV 16 Berchem TOT
54,Posthofbrug 5366,2022-02-18,06:00:00,58,45,13,FMN GV 16 Berchem TOT
54,Posthofbrug 5366,2022-02-18,07:00:00,213,150,63,FMN GV 16 Berchem TOT
54,Posthofbrug 5366,2022-02-18,08:00:00,348,253,95,FMN GV 16 Berchem TOT
54,Posthofbrug 5366,2022-02-18,09:00:00,104,78,26,FMN GV 16 Berchem TOT
54,Posthofbrug 5366,2022-02-18,10:00:00,65,35,30,FMN GV 16 Berchem TOT
54,Posthofbrug 5366,2022-02-18,11:00:00,77,35,42,FMN GV 16 Berchem TOT
54,Posthofbrug 5366,2022-02-18,12:00:00,196,65,131,FMN GV 16 Berchem TOT
54,Posthofbrug 5366,2022-02-18,13:00:00,135,38,97,FMN GV 16 Berchem TOT
54,Posthofbrug 5366,2022-02-18,14:00:00,56,16,40,FMN GV 16 Berchem TOT
54,Posthofbrug 5366,2022-02-18,15:00:00,56,12,44,FMN GV 16 Berchem TOT
54,Posthofbrug 5366,2022-02-18,16:00:00,69,18,51,FMN GV 16 Berchem TOT
54,Posthofbrug 5366,2022-02-18,17:00:00,76,31,45,FMN GV 16 Berchem TOT
54,Posthofbrug 5366,2022-02-18,18:00:00,87,51,36,FMN GV 16 Berchem TOT
54,Posthofbrug 5366,2022-02-18,19:00:00,55,24,31,FMN GV 16 Berchem TOT
54,Posthofbrug 5366,2022-02-18,20:00:00,47,30,17,FMN GV 16 Berchem TOT
54,Posthofbrug 5366,2022-02-18,21:00:00,32,20,12,FMN GV 16 Berchem TOT
54,Posthofbrug 5366,2022-02-18,22:00:00,26,7,19,FMN GV 16 Berchem TOT
54,Posthofbrug 5366,2022-02-18,23:00:00,29,11,18,FMN GV 16 Berchem TOT
54,Posthofbrug 5366,2022-02-19,00:00:00,23,6,17,FMN GV 16 Berchem TOT
54,Posthofbrug 5366,2022-02-19,01:00:00,24,2,22,FMN GV 16 Berchem TOT
54,Posthofbrug 5366,2022-02-19,02:00:00,19,3,16,FMN GV 16 Berchem TOT
54,Posthofbrug 5366,2022-02-19,03:00:00,12,3,9,FMN GV 16 Berchem TOT
54,Posthofbrug 5366,2022-02-19,04:00:00,20,2,18,FMN GV 16 Berchem TOT
54,Posthofbrug 5366,2022-02-19,05:00:00,18,8,10,FMN GV 16 Berchem TOT
54,Posthofbrug 5366,2022-02-19,06:00:00,13,7,6,FMN GV 16 Berchem TOT
54,Posthofbrug 5366,2022-02-19,07:00:00,33,18,15,FMN GV 16 Berchem TOT
54,Posthofbrug 5366,2022-02-19,08:00:00,51,25,26,FMN GV 16 Berchem TOT
54,Posthofbrug 5366,2022-02-19,09:00:00,119,69,50,FMN GV 16 Berchem TOT
54,Posthofbrug 5366,2022-02-19,10:00:00,139,80,59,FMN GV 16 Berchem TOT
54,Posthofbrug 5366,2022-02-19,11:00:00,135,100,35,FMN GV 16 Berchem TOT
54,Posthofbrug 5366,2022-02-19,12:00:00,142,81,61,FMN GV 16 Berchem TOT
54,Posthofbrug 5366,2022-02-19,13:00:00,146,92,54,FMN GV 16 Berchem TOT
54,Posthofbrug 5366,2022-02-19,14:00:00,158,80,78,FMN GV 16 Berchem TOT
54,Posthofbrug 5366,2022-02-19,15:00:00,102,48,54,FMN GV 16 Berchem TOT
54,Posthofbrug 5366,2022-02-19,16:00:00,95,43,52,FMN GV 16 Berchem TOT
54,Posthofbrug 5366,2022-02-19,17:00:00,141,61,80,FMN GV 16 Berchem TOT
54,Posthofbrug 5366,2022-02-19,18:00:00,92,38,54,FMN GV 16 Berchem TOT
54,Posthofbrug 5366,2022-02-19,19:00:00,58,24,34,FMN GV 16 Berchem TOT
54,Posthofbrug 5366,2022-02-19,20:00:00,45,20,25,FMN GV 16 Berchem TOT
54,Posthofbrug 5366,2022-02-19,21:00:00,48,32,16,FMN GV 16 Berchem TOT
54,Posthofbrug 5366,2022-02-19,22:00:00,36,17,19,FMN GV 16 Berchem TOT
54,Posthofbrug 5366,2022-02-19,23:00:00,31,13,18,FMN GV 16 Berchem TOT
54,Posthofbrug 5366,2022-02-20,00:00:00,36,18,18,FMN GV 16 Berchem TOT
54,Posthofbrug 5366,2022-02-20,01:00:00,26,16,10,FMN GV 16 Berchem TOT
54,Posthofbrug 5366,2022-02-20,02:00:00,16,8,8,FMN GV 16 Berchem TOT
54,Posthofbrug 5366,2022-02-20,03:00:00,27,5,22,FMN GV 16 Berchem TOT
54,Posthofbrug 5366,2022-02-20,04:00:00,18,7,11,FMN GV 16 Berchem TOT
54,Posthofbrug 5366,2022-02-20,05:00:00,25,3,22,FMN GV 16 Berchem TOT
54,Posthofbrug 5366,2022-02-20,06:00:00,10,5,5,FMN GV 16 Berchem TOT
54,Posthofbrug 5366,2022-02-20,07:00:00,14,11,3,FMN GV 16 Berchem TOT
54,Posthofbrug 5366,2022-02-20,08:00:00,35,18,17,FMN GV 16 Berchem TOT
54,Posthofbrug 5366,2022-02-20,09:00:00,44,22,22,FMN GV 16 Berchem TOT
54,Posthofbrug 5366,2022-02-20,10:00:00,47,29,18,FMN GV 16 Berchem TOT
54,Posthofbrug 5366,2022-02-20,11:00:00,47,30,17,FMN GV 16 Berchem TOT
54,Posthofbrug 5366,2022-02-20,12:00:00,54,28,26,FMN GV 16 Berchem TOT
54,Posthofbrug 5366,2022-02-20,13:00:00,41,21,20,FMN GV 16 Berchem TOT
54,Posthofbrug 5366,2022-02-20,14:00:00,32,15,17,FMN GV 16 Berchem TOT
54,Posthofbrug 5366,2022-02-20,15:00:00,53,28,25,FMN GV 16 Berchem TOT
54,Posthofbrug 5366,2022-02-20,16:00:00,39,11,28,FMN GV 16 Berchem TOT
54,Posthofbrug 5366,2022-02-20,17:00:00,35,20,15,FMN GV 16 Berchem TOT
54,Posthofbrug 5366,2022-02-20,18:00:00,34,14,20,FMN GV 16 Berchem TOT
54,Posthofbrug 5366,2022-02-20,19:00:00,29,12,17,FMN GV 16 Berchem TOT
54,Posthofbrug 5366,2022-02-20,20:00:00,23,13,10,FMN GV 16 Berchem TOT
54,Posthofbrug 5366,2022-02-20,21:00:00,22,13,9,FMN GV 16 Berchem TOT
54,Posthofbrug 5366,2022-02-20,22:00:00,12,2,10,FMN GV 16 Berchem TOT
54,Posthofbrug 5366,2022-02-20,23:00:00,4,2,2,FMN GV 16 Berchem TOT
54,Posthofbrug 5366,2022-02-21,00:00:00,5,2,3,FMN GV 16 Berchem TOT
54,Posthofbrug 5366,2022-02-21,01:00:00,4,0,4,FMN GV 16 Berchem TOT
54,Posthofbrug 5366,2022-02-21,02:00:00,3,1,2,FMN GV 16 Berchem TOT
54,Posthofbrug 5366,2022-02-21,03:00:00,1,1,0,FMN GV 16 Berchem TOT
54,Posthofbrug 5366,2022-02-21,04:00:00,5,3,2,FMN GV 16 Berchem TOT
54,Posthofbrug 5366,2022-02-21,05:00:00,16,11,5,FMN GV 16 Berchem TOT
54,Posthofbrug 5366,2022-02-21,06:00:00,65,52,13,FMN GV 16 Berchem TOT
54,Posthofbrug 5366,2022-02-21,07:00:00,260,188,72,FMN GV 16 Berchem TOT
54,Posthofbrug 5366,2022-02-21,08:00:00,443,332,111,FMN GV 16 Berchem TOT
54,Posthofbrug 5366,2022-02-21,09:00:00,144,107,37,FMN GV 16 Berchem TOT
54,Posthofbrug 5366,2022-02-21,10:00:00,82,56,26,FMN GV 16 Berchem TOT
54,Posthofbrug 5366,2022-02-21,11:00:00,53,28,25,FMN GV 16 Berchem TOT
54,Posthofbrug 5366,2022-02-21,12:00:00,65,27,38,FMN GV 16 Berchem TOT
54,Posthofbrug 5366,2022-02-21,13:00:00,71,40,31,FMN GV 16 Berchem TOT
54,Posthofbrug 5366,2022-02-21,14:00:00,53,19,34,FMN GV 16 Berchem TOT
54,Posthofbrug 5366,2022-02-21,15:00:00,127,45,82,FMN GV 16 Berchem TOT
54,Posthofbrug 5366,2022-02-21,16:00:00,243,69,174,FMN GV 16 Berchem TOT
54,Posthofbrug 5366,2022-02-21,17:00:00,283,87,196,FMN GV 16 Berchem TOT
54,Posthofbrug 5366,2022-02-21,18:00:00,241,82,159,FMN GV 16 Berchem TOT
54,Posthofbrug 5366,2022-02-21,19:00:00,110,47,63,FMN GV 16 Berchem TOT
54,Posthofbrug 5366,2022-02-21,20:00:00,64,30,34,FMN GV 16 Berchem TOT
54,Posthofbrug 5366,2022-02-21,21:00:00,62,31,31,FMN GV 16 Berchem TOT
54,Posthofbrug 5366,2022-02-21,22:00:00,51,28,23,FMN GV 16 Berchem TOT
54,Posthofbrug 5366,2022-02-21,23:00:00,17,8,9,FMN GV 16 Berchem TOT
54,Posthofbrug 5366,2022-02-22,00:00:00,24,2,22,FMN GV 16 Berchem TOT
54,Posthofbrug 5366,2022-02-22,01:00:00,5,0,5,FMN GV 16 Berchem TOT
54,Posthofbrug 5366,2022-02-22,02:00:00,10,0,10,FMN GV 16 Berchem TOT
54,Posthofbrug 5366,2022-02-22,03:00:00,7,1,6,FMN GV 16 Berchem TOT
54,Posthofbrug 5366,2022-02-22,04:00:00,15,5,10,FMN GV 16 Berchem TOT
54,Posthofbrug 5366,2022-02-22,05:00:00,31,23,8,FMN GV 16 Berchem TOT
54,Posthofbrug 5366,2022-02-22,06:00:00,102,76,26,FMN GV 16 Berchem TOT
54,Posthofbrug 5366,2022-02-22,07:00:00,349,269,80,FMN GV 16 Berchem TOT
54,Posthofbrug 5366,2022-02-22,08:00:00,618,468,150,FMN GV 16 Berchem TOT
54,Posthofbrug 5366,2022-02-22,09:00:00,199,141,58,FMN GV 16 Berchem TOT
54,Posthofbrug 5366,2022-02-22,10:00:00,103,66,37,FMN GV 16 Berchem TOT
54,Posthofbrug 5366,2022-02-22,11:00:00,89,50,39,FMN GV 16 Berchem TOT
54,Posthofbrug 5366,2022-02-22,12:00:00,102,43,59,FMN GV 16 Berchem TOT
54,Posthofbrug 5366,2022-02-22,13:00:00,106,56,50,FMN GV 16 Berchem TOT
54,Posthofbrug 5366,2022-02-22,14:00:00,111,56,55,FMN GV 16 Berchem TOT
54,Posthofbrug 5366,2022-02-22,15:00:00,173,58,115,FMN GV 16 Berchem TOT
54,Posthofbrug 5366,2022-02-22,16:00:00,322,94,228,FMN GV 16 Berchem TOT
54,Posthofbrug 5366,2022-02-22,17:00:00,456,152,304,FMN GV 16 Berchem TOT
54,Posthofbrug 5366,2022-02-22,18:00:00,302,100,202,FMN GV 16 Berchem TOT
54,Posthofbrug 5366,2022-02-22,19:00:00,134,50,84,FMN GV 16 Berchem TOT
54,Posthofbrug 5366,2022-02-22,20:00:00,81,25,56,FMN GV 16 Berchem TOT
54,Posthofbrug 5366,2022-02-22,21:00:00,84,37,47,FMN GV 16 Berchem TOT
54,Posthofbrug 5366,2022-02-22,22:00:00,75,26,49,FMN GV 16 Berchem TOT
54,Posthofbrug 5366,2022-02-22,23:00:00,42,11,31,FMN GV 16 Berchem TOT
54,Posthofbrug 5366,2022-02-23,00:00:00,18,5,13,FMN GV 16 Berchem TOT
54,Posthofbrug 5366,2022-02-23,01:00:00,13,5,8,FMN GV 16 Berchem TOT
54,Posthofbrug 5366,2022-02-23,02:00:00,3,2,1,FMN GV 16 Berchem TOT
54,Posthofbrug 5366,2022-02-23,03:00:00,1,0,1,FMN GV 16 Berchem TOT
54,Posthofbrug 5366,2022-02-23,04:00:00,10,4,6,FMN GV 16 Berchem TOT
54,Posthofbrug 5366,2022-02-23,05:00:00,28,22,6,FMN GV 16 Berchem TOT
54,Posthofbrug 5366,2022-02-23,06:00:00,87,71,16,FMN GV 16 Berchem TOT
54,Posthofbrug 5366,2022-02-23,07:00:00,345,256,89,FMN GV 16 Berchem TOT
54,Posthofbrug 5366,2022-02-23,08:00:00,142,110,32,FMN GV 16 Berchem TOT
54,Posthofbrug 5366,2022-02-23,09:00:00,0,0,0,FMN GV 16 Berchem TOT
54,Posthofbrug 5366,2022-02-23,10:00:00,0,0,0,FMN GV 16 Berchem TOT
54,Posthofbrug 5366,2022-02-23,11:00:00,0,0,0,FMN GV 16 Berchem TOT
54,Posthofbrug 5366,2022-02-23,12:00:00,0,0,0,FMN GV 16 Berchem TOT
54,Posthofbrug 5366,2022-02-23,13:00:00,0,0,0,FMN GV 16 Berchem TOT
54,Posthofbrug 5366,2022-02-23,14:00:00,0,0,0,FMN GV 16 Berchem TOT
54,Posthofbrug 5366,2022-02-23,15:00:00,0,0,0,FMN GV 16 Berchem TOT
54,Posthofbrug 5366,2022-02-23,16:00:00,0,0,0,FMN GV 16 Berchem TOT
54,Posthofbrug 5366,2022-02-23,17:00:00,0,0,0,FMN GV 16 Berchem TOT
54,Posthofbrug 5366,2022-02-23,18:00:00,0,0,0,FMN GV 16 Berchem TOT
54,Posthofbrug 5366,2022-02-23,19:00:00,0,0,0,FMN GV 16 Berchem TOT
54,Posthofbrug 5366,2022-02-23,20:00:00,0,0,0,FMN GV 16 Berchem TOT
54,Posthofbrug 5366,2022-02-23,21:00:00,0,0,0,FMN GV 16 Berchem TOT
54,Posthofbrug 5366,2022-02-23,22:00:00,53,15,38,FMN GV 16 Berchem TOT
54,Posthofbrug 5366,2022-02-23,23:00:00,35,14,21,FMN GV 16 Berchem TOT
54,Posthofbrug 5366,2022-02-24,00:00:00,38,15,23,FMN GV 16 Berchem TOT
54,Posthofbrug 5366,2022-02-24,01:00:00,9,3,6,FMN GV 16 Berchem TOT
54,Posthofbrug 5366,2022-02-24,02:00:00,3,1,2,FMN GV 16 Berchem TOT
54,Posthofbrug 5366,2022-02-24,03:00:00,8,4,4,FMN GV 16 Berchem TOT
54,Posthofbrug 5366,2022-02-24,04:00:00,9,4,5,FMN GV 16 Berchem TOT
54,Posthofbrug 5366,2022-02-24,05:00:00,28,21,7,FMN GV 16 Berchem TOT
54,Posthofbrug 5366,2022-02-24,06:00:00,93,78,15,FMN GV 16 Berchem TOT
54,Posthofbrug 5366,2022-02-24,07:00:00,351,264,87,FMN GV 16 Berchem TOT
54,Posthofbrug 5366,2022-02-24,08:00:00,545,420,125,FMN GV 16 Berchem TOT
54,Posthofbrug 5366,2022-02-24,09:00:00,200,164,36,FMN GV 16 Berchem TOT
54,Posthofbrug 5366,2022-02-24,10:00:00,112,73,39,FMN GV 16 Berchem TOT
54,Posthofbrug 5366,2022-02-24,11:00:00,97,53,44,FMN GV 16 Berchem TOT
54,Posthofbrug 5366,2022-02-24,12:00:00,151,94,57,FMN GV 16 Berchem TOT
54,Posthofbrug 5366,2022-02-24,13:00:00,117,56,61,FMN GV 16 Berchem TOT
54,Posthofbrug 5366,2022-02-24,14:00:00,75,20,55,FMN GV 16 Berchem TOT
54,Posthofbrug 5366,2022-02-24,15:00:00,172,53,119,FMN GV 16 Berchem TOT
54,Posthofbrug 5366,2022-02-24,16:00:00,364,102,262,FMN GV 16 Berchem TOT
54,Posthofbrug 5366,2022-02-24,17:00:00,426,122,304,FMN GV 16 Berchem TOT
54,Posthofbrug 5366,2022-02-24,18:00:00,242,73,169,FMN GV 16 Berchem TOT
54,Posthofbrug 5366,2022-02-24,19:00:00,126,51,75,FMN GV 16 Berchem TOT
54,Posthofbrug 5366,2022-02-24,20:00:00,92,47,45,FMN GV 16 Berchem TOT
54,Posthofbrug 5366,2022-02-24,21:00:00,52,26,26,FMN GV 16 Berchem TOT
54,Posthofbrug 5366,2022-02-24,22:00:00,59,22,37,FMN GV 16 Berchem TOT
54,Posthofbrug 5366,2022-02-24,23:00:00,37,8,29,FMN GV 16 Berchem TOT
54,Posthofbrug 5366,2022-02-25,00:00:00,31,15,16,FMN GV 16 Berchem TOT
54,Posthofbrug 5366,2022-02-25,01:00:00,17,2,15,FMN GV 16 Berchem TOT
54,Posthofbrug 5366,2022-02-25,02:00:00,9,1,8,FMN GV 16 Berchem TOT
54,Posthofbrug 5366,2022-02-25,03:00:00,12,2,10,FMN GV 16 Berchem TOT
54,Posthofbrug 5366,2022-02-25,04:00:00,13,4,9,FMN GV 16 Berchem TOT
54,Posthofbrug 5366,2022-02-25,05:00:00,26,13,13,FMN GV 16 Berchem TOT
54,Posthofbrug 5366,2022-02-25,06:00:00,65,55,10,FMN GV 16 Berchem TOT
54,Posthofbrug 5366,2022-02-25,07:00:00,237,177,60,FMN GV 16 Berchem TOT
54,Posthofbrug 5366,2022-02-25,08:00:00,456,343,113,FMN GV 16 Berchem TOT
54,Posthofbrug 5366,2022-02-25,09:00:00,182,134,48,FMN GV 16 Berchem TOT
54,Posthofbrug 5366,2022-02-25,10:00:00,101,67,34,FMN GV 16 Berchem TOT
54,Posthofbrug 5366,2022-02-25,11:00:00,73,38,35,FMN GV 16 Berchem TOT
54,Posthofbrug 5366,2022-02-25,12:00:00,156,79,77,FMN GV 16 Berchem TOT
54,Posthofbrug 5366,2022-02-25,13:00:00,126,57,69,FMN GV 16 Berchem TOT
54,Posthofbrug 5366,2022-02-25,14:00:00,129,55,74,FMN GV 16 Berchem TOT
54,Posthofbrug 5366,2022-02-25,15:00:00,186,66,120,FMN GV 16 Berchem TOT
54,Posthofbrug 5366,2022-02-25,16:00:00,309,92,217,FMN GV 16 Berchem TOT
54,Posthofbrug 5366,2022-02-25,17:00:00,332,116,216,FMN GV 16 Berchem TOT
54,Posthofbrug 5366,2022-02-25,18:00:00,207,97,110,FMN GV 16 Berchem TOT
54,Posthofbrug 5366,2022-02-25,19:00:00,159,91,68,FMN GV 16 Berchem TOT
54,Posthofbrug 5366,2022-02-25,20:00:00,86,41,45,FMN GV 16 Berchem TOT
54,Posthofbrug 5366,2022-02-25,21:00:00,69,34,35,FMN GV 16 Berchem TOT
54,Posthofbrug 5366,2022-02-25,22:00:00,75,27,48,FMN GV 16 Berchem TOT
54,Posthofbrug 5366,2022-02-25,23:00:00,53,11,42,FMN GV 16 Berchem TOT
54,Posthofbrug 5366,2022-02-26,00:00:00,52,14,38,FMN GV 16 Berchem TOT
54,Posthofbrug 5366,2022-02-26,01:00:00,48,8,40,FMN GV 16 Berchem TOT
54,Posthofbrug 5366,2022-02-26,02:00:00,24,2,22,FMN GV 16 Berchem TOT
54,Posthofbrug 5366,2022-02-26,03:00:00,14,2,12,FMN GV 16 Berchem TOT
54,Posthofbrug 5366,2022-02-26,04:00:00,18,8,10,FMN GV 16 Berchem TOT
54,Posthofbrug 5366,2022-02-26,05:00:00,18,9,9,FMN GV 16 Berchem TOT
54,Posthofbrug 5366,2022-02-26,06:00:00,21,5,16,FMN GV 16 Berchem TOT
54,Posthofbrug 5366,2022-02-26,07:00:00,26,19,7,FMN GV 16 Berchem TOT
54,Posthofbrug 5366,2022-02-26,08:00:00,54,28,26,FMN GV 16 Berchem TOT
54,Posthofbrug 5366,2022-02-26,09:00:00,137,81,56,FMN GV 16 Berchem TOT
54,Posthofbrug 5366,2022-02-26,10:00:00,123,80,43,FMN GV 16 Berchem TOT
54,Posthofbrug 5366,2022-02-26,11:00:00,156,112,44,FMN GV 16 Berchem TOT
54,Posthofbrug 5366,2022-02-26,12:00:00,163,101,62,FMN GV 16 Berchem TOT
54,Posthofbrug 5366,2022-02-26,13:00:00,171,91,80,FMN GV 16 Berchem TOT
54,Posthofbrug 5366,2022-02-26,14:00:00,233,123,110,FMN GV 16 Berchem TOT
54,Posthofbrug 5366,2022-02-26,15:00:00,158,82,76,FMN GV 16 Berchem TOT
54,Posthofbrug 5366,2022-02-26,16:00:00,183,83,100,FMN GV 16 Berchem TOT
54,Posthofbrug 5366,2022-02-26,17:00:00,182,92,90,FMN GV 16 Berchem TOT
54,Posthofbrug 5366,2022-02-26,18:00:00,142,56,86,FMN GV 16 Berchem TOT
54,Posthofbrug 5366,2022-02-26,19:00:00,112,51,61,FMN GV 16 Berchem TOT
54,Posthofbrug 5366,2022-02-26,20:00:00,79,39,40,FMN GV 16 Berchem TOT
54,Posthofbrug 5366,2022-02-26,21:00:00,51,33,18,FMN GV 16 Berchem TOT
54,Posthofbrug 5366,2022-02-26,22:00:00,59,30,29,FMN GV 16 Berchem TOT
54,Posthofbrug 5366,2022-02-26,23:00:00,43,11,32,FMN GV 16 Berchem TOT
54,Posthofbrug 5366,2022-02-27,00:00:00,48,17,31,FMN GV 16 Berchem TOT
54,Posthofbrug 5366,2022-02-27,01:00:00,37,13,24,FMN GV 16 Berchem TOT
54,Posthofbrug 5366,2022-02-27,02:00:00,26,9,17,FMN GV 16 Berchem TOT
54,Posthofbrug 5366,2022-02-27,03:00:00,21,3,18,FMN GV 16 Berchem TOT
54,Posthofbrug 5366,2022-02-27,04:00:00,19,4,15,FMN GV 16 Berchem TOT
54,Posthofbrug 5366,2022-02-27,05:00:00,22,8,14,FMN GV 16 Berchem TOT
54,Posthofbrug 5366,2022-02-27,06:00:00,22,9,13,FMN GV 16 Berchem TOT
54,Posthofbrug 5366,2022-02-27,07:00:00,26,9,17,FMN GV 16 Berchem TOT
54,Posthofbrug 5366,2022-02-27,08:00:00,32,16,16,FMN GV 16 Berchem TOT
54,Posthofbrug 5366,2022-02-27,09:00:00,89,52,37,FMN GV 16 Berchem TOT
54,Posthofbrug 5366,2022-02-27,10:00:00,131,86,45,FMN GV 16 Berchem TOT
54,Posthofbrug 5366,2022-02-27,11:00:00,167,117,50,FMN GV 16 Berchem TOT
54,Posthofbrug 5366,2022-02-27,12:00:00,142,64,78,FMN GV 16 Berchem TOT
54,Posthofbrug 5366,2022-02-27,13:00:00,135,64,71,FMN GV 16 Berchem TOT
54,Posthofbrug 5366,2022-02-27,14:00:00,164,82,82,FMN GV 16 Berchem TOT
54,Posthofbrug 5366,2022-02-27,15:00:00,153,72,81,FMN GV 16 Berchem TOT
54,Posthofbrug 5366,2022-02-27,16:00:00,200,87,113,FMN GV 16 Berchem TOT
54,Posthofbrug 5366,2022-02-27,17:00:00,165,76,89,FMN GV 16 Berchem TOT
54,Posthofbrug 5366,2022-02-27,18:00:00,86,41,45,FMN GV 16 Berchem TOT
54,Posthofbrug 5366,2022-02-27,19:00:00,79,42,37,FMN GV 16 Berchem TOT
54,Posthofbrug 5366,2022-02-27,20:00:00,57,28,29,FMN GV 16 Berchem TOT
54,Posthofbrug 5366,2022-02-27,21:00:00,48,22,26,FMN GV 16 Berchem TOT
54,Posthofbrug 5366,2022-02-27,22:00:00,47,20,27,FMN GV 16 Berchem TOT
54,Posthofbrug 5366,2022-02-27,23:00:00,21,4,17,FMN GV 16 Berchem TOT
54,Posthofbrug 5366,2022-02-28,00:00:00,12,1,11,FMN GV 16 Berchem TOT
54,Posthofbrug 5366,2022-02-28,01:00:00,9,0,9,FMN GV 16 Berchem TOT
54,Posthofbrug 5366,2022-02-28,02:00:00,0,0,0,FMN GV 16 Berchem TOT
54,Posthofbrug 5366,2022-02-28,03:00:00,1,0,1,FMN GV 16 Berchem TOT
54,Posthofbrug 5366,2022-02-28,04:00:00,10,8,2,FMN GV 16 Berchem TOT
54,Posthofbrug 5366,2022-02-28,05:00:00,23,13,10,FMN GV 16 Berchem TOT
54,Posthofbrug 5366,2022-02-28,06:00:00,80,65,15,FMN GV 16 Berchem TOT
54,Posthofbrug 5366,2022-02-28,07:00:00,206,158,48,FMN GV 16 Berchem TOT
54,Posthofbrug 5366,2022-02-28,08:00:00,392,289,103,FMN GV 16 Berchem TOT
54,Posthofbrug 5366,2022-02-28,09:00:00,185,133,52,FMN GV 16 Berchem TOT
54,Posthofbrug 5366,2022-02-28,10:00:00,114,77,37,FMN GV 16 Berchem TOT
54,Posthofbrug 5366,2022-02-28,11:00:00,107,74,33,FMN GV 16 Berchem TOT
54,Posthofbrug 5366,2022-02-28,12:00:00,151,90,61,FMN GV 16 Berchem TOT
54,Posthofbrug 5366,2022-02-28,13:00:00,146,79,67,FMN GV 16 Berchem TOT
54,Posthofbrug 5366,2022-02-28,14:00:00,158,67,91,FMN GV 16 Berchem TOT
54,Posthofbrug 5366,2022-02-28,15:00:00,168,61,107,FMN GV 16 Berchem TOT
54,Posthofbrug 5366,2022-02-28,16:00:00,298,86,212,FMN GV 16 Berchem TOT
54,Posthofbrug 5366,2022-02-28,17:00:00,397,116,281,FMN GV 16 Berchem TOT
54,Posthofbrug 5366,2022-02-28,18:00:00,246,87,159,FMN GV 16 Berchem TOT
54,Posthofbrug 5366,2022-02-28,19:00:00,133,55,78,FMN GV 16 Berchem TOT
54,Posthofbrug 5366,2022-02-28,20:00:00,81,34,47,FMN GV 16 Berchem TOT
54,Posthofbrug 5366,2022-02-28,21:00:00,70,30,40,FMN GV 16 Berchem TOT
54,Posthofbrug 5366,2022-02-28,22:00:00,54,15,39,FMN GV 16 Berchem TOT
54,Posthofbrug 5366,2022-02-28,23:00:00,29,5,24,FMN GV 16 Berchem TOT
54,Posthofbrug 5366,2022-03-01,00:00:00,25,8,17,FMN GV 16 Berchem TOT
54,Posthofbrug 5366,2022-03-01,01:00:00,3,0,3,FMN GV 16 Berchem TOT
54,Posthofbrug 5366,2022-03-01,02:00:00,4,2,2,FMN GV 16 Berchem TOT
54,Posthofbrug 5366,2022-03-01,03:00:00,5,1,4,FMN GV 16 Berchem TOT
54,Posthofbrug 5366,2022-03-01,04:00:00,9,4,5,FMN GV 16 Berchem TOT
54,Posthofbrug 5366,2022-03-01,05:00:00,27,19,8,FMN GV 16 Berchem TOT
54,Posthofbrug 5366,2022-03-01,06:00:00,80,68,12,FMN GV 16 Berchem TOT
54,Posthofbrug 5366,2022-03-01,07:00:00,227,163,64,FMN GV 16 Berchem TOT
54,Posthofbrug 5366,2022-03-01,08:00:00,416,331,85,FMN GV 16 Berchem TOT
54,Posthofbrug 5366,2022-03-01,09:00:00,213,164,49,FMN GV 16 Berchem TOT
54,Posthofbrug 5366,2022-03-01,10:00:00,96,62,34,FMN GV 16 Berchem TOT
54,Posthofbrug 5366,2022-03-01,11:00:00,78,46,32,FMN GV 16 Berchem TOT
54,Posthofbrug 5366,2022-03-01,12:00:00,115,53,62,FMN GV 16 Berchem TOT
54,Posthofbrug 5366,2022-03-01,13:00:00,109,57,52,FMN GV 16 Berchem TOT
54,Posthofbrug 5366,2022-03-01,14:00:00,109,49,60,FMN GV 16 Berchem TOT
54,Posthofbrug 5366,2022-03-01,15:00:00,132,48,84,FMN GV 16 Berchem TOT
54,Posthofbrug 5366,2022-03-01,16:00:00,279,89,190,FMN GV 16 Berchem TOT
54,Posthofbrug 5366,2022-03-01,17:00:00,366,119,247,FMN GV 16 Berchem TOT
54,Posthofbrug 5366,2022-03-01,18:00:00,264,98,166,FMN GV 16 Berchem TOT
54,Posthofbrug 5366,2022-03-01,19:00:00,143,57,86,FMN GV 16 Berchem TOT
54,Posthofbrug 5366,2022-03-01,20:00:00,78,28,50,FMN GV 16 Berchem TOT
54,Posthofbrug 5366,2022-03-01,21:00:00,67,34,33,FMN GV 16 Berchem TOT
54,Posthofbrug 5366,2022-03-01,22:00:00,56,28,28,FMN GV 16 Berchem TOT
54,Posthofbrug 5366,2022-03-01,23:00:00,39,14,25,FMN GV 16 Berchem TOT
54,Posthofbrug 5366,2022-03-02,00:00:00,25,4,21,FMN GV 16 Berchem TOT
54,Posthofbrug 5366,2022-03-02,01:00:00,6,0,6,FMN GV 16 Berchem TOT
54,Posthofbrug 5366,2022-03-02,02:00:00,8,2,6,FMN GV 16 Berchem TOT
54,Posthofbrug 5366,2022-03-02,03:00:00,4,1,3,FMN GV 16 Berchem TOT
54,Posthofbrug 5366,2022-03-02,04:00:00,6,4,2,FMN GV 16 Berchem TOT
54,Posthofbrug 5366,2022-03-02,05:00:00,27,17,10,FMN GV 16 Berchem TOT
54,Posthofbrug 5366,2022-03-02,06:00:00,83,68,15,FMN GV 16 Berchem TOT
54,Posthofbrug 5366,2022-03-02,07:00:00,217,158,59,FMN GV 16 Berchem TOT
54,Posthofbrug 5366,2022-03-02,08:00:00,367,275,92,FMN GV 16 Berchem TOT
54,Posthofbrug 5366,2022-03-02,09:00:00,174,107,67,FMN GV 16 Berchem TOT
54,Posthofbrug 5366,2022-03-02,10:00:00,111,80,31,FMN GV 16 Berchem TOT
54,Posthofbrug 5366,2022-03-02,11:00:00,98,63,35,FMN GV 16 Berchem TOT
54,Posthofbrug 5366,2022-03-02,12:00:00,146,83,63,FMN GV 16 Berchem TOT
54,Posthofbrug 5366,2022-03-02,13:00:00,136,74,62,FMN GV 16 Berchem TOT
54,Posthofbrug 5366,2022-03-02,14:00:00,120,58,62,FMN GV 16 Berchem TOT
54,Posthofbrug 5366,2022-03-02,15:00:00,174,58,116,FMN GV 16 Berchem TOT
54,Posthofbrug 5366,2022-03-02,16:00:00,248,91,157,FMN GV 16 Berchem TOT
54,Posthofbrug 5366,2022-03-02,17:00:00,348,123,225,FMN GV 16 Berchem TOT
54,Posthofbrug 5366,2022-03-02,18:00:00,270,97,173,FMN GV 16 Berchem TOT
54,Posthofbrug 5366,2022-03-02,19:00:00,139,61,78,FMN GV 16 Berchem TOT
54,Posthofbrug 5366,2022-03-02,20:00:00,80,45,35,FMN GV 16 Berchem TOT
54,Posthofbrug 5366,2022-03-02,21:00:00,62,30,32,FMN GV 16 Berchem TOT
54,Posthofbrug 5366,2022-03-02,22:00:00,61,26,35,FMN GV 16 Berchem TOT
54,Posthofbrug 5366,2022-03-02,23:00:00,54,14,40,FMN GV 16 Berchem TOT
54,Posthofbrug 5366,2022-03-03,00:00:00,27,9,18,FMN GV 16 Berchem TOT
54,Posthofbrug 5366,2022-03-03,01:00:00,10,1,9,FMN GV 16 Berchem TOT
54,Posthofbrug 5366,2022-03-03,02:00:00,7,0,7,FMN GV 16 Berchem TOT
54,Posthofbrug 5366,2022-03-03,03:00:00,5,2,3,FMN GV 16 Berchem TOT
54,Posthofbrug 5366,2022-03-03,04:00:00,13,5,8,FMN GV 16 Berchem TOT
54,Posthofbrug 5366,2022-03-03,05:00:00,22,14,8,FMN GV 16 Berchem TOT
54,Posthofbrug 5366,2022-03-03,06:00:00,74,67,7,FMN GV 16 Berchem TOT
54,Posthofbrug 5366,2022-03-03,07:00:00,232,176,56,FMN GV 16 Berchem TOT
54,Posthofbrug 5366,2022-03-03,08:00:00,378,271,107,FMN GV 16 Berchem TOT
54,Posthofbrug 5366,2022-03-03,09:00:00,202,145,57,FMN GV 16 Berchem TOT
54,Posthofbrug 5366,2022-03-03,10:00:00,150,106,44,FMN GV 16 Berchem TOT
54,Posthofbrug 5366,2022-03-03,11:00:00,120,70,50,FMN GV 16 Berchem TOT
54,Posthofbrug 5366,2022-03-03,12:00:00,167,104,63,FMN GV 16 Berchem TOT
54,Posthofbrug 5366,2022-03-03,13:00:00,155,85,70,FMN GV 16 Berchem TOT
54,Posthofbrug 5366,2022-03-03,14:00:00,149,64,85,FMN GV 16 Berchem TOT
54,Posthofbrug 5366,2022-03-03,15:00:00,163,70,93,FMN GV 16 Berchem TOT
54,Posthofbrug 5366,2022-03-03,16:00:00,335,127,208,FMN GV 16 Berchem TOT
54,Posthofbrug 5366,2022-03-03,17:00:00,401,150,251,FMN GV 16 Berchem TOT
54,Posthofbrug 5366,2022-03-03,18:00:00,0,0,0,FMN GV 16 Berchem TOT
54,Posthofbrug 5366,2022-03-03,19:00:00,0,0,0,FMN GV 16 Berchem TOT
54,Posthofbrug 5366,2022-03-03,20:00:00,0,0,0,FMN GV 16 Berchem TOT
54,Posthofbrug 5366,2022-03-03,21:00:00,0,0,0,FMN GV 16 Berchem TOT
54,Posthofbrug 5366,2022-03-03,22:00:00,71,30,41,FMN GV 16 Berchem TOT
54,Posthofbrug 5366,2022-03-03,23:00:00,35,10,25,FMN GV 16 Berchem TOT
54,Posthofbrug 5366,2022-03-04,00:00:00,26,6,20,FMN GV 16 Berchem TOT
54,Posthofbrug 5366,2022-03-04,01:00:00,18,5,13,FMN GV 16 Berchem TOT
54,Posthofbrug 5366,2022-03-04,02:00:00,14,5,9,FMN GV 16 Berchem TOT
54,Posthofbrug 5366,2022-03-04,03:00:00,6,0,6,FMN GV 16 Berchem TOT
54,Posthofbrug 5366,2022-03-04,04:00:00,14,7,7,FMN GV 16 Berchem TOT
54,Posthofbrug 5366,2022-03-04,05:00:00,25,18,7,FMN GV 16 Berchem TOT
54,Posthofbrug 5366,2022-03-04,06:00:00,61,50,11,FMN GV 16 Berchem TOT
54,Posthofbrug 5366,2022-03-04,07:00:00,175,126,49,FMN GV 16 Berchem TOT
54,Posthofbrug 5366,2022-03-04,08:00:00,324,233,91,FMN GV 16 Berchem TOT
54,Posthofbrug 5366,2022-03-04,09:00:00,179,133,46,FMN GV 16 Berchem TOT
54,Posthofbrug 5366,2022-03-04,10:00:00,104,78,26,FMN GV 16 Berchem TOT
54,Posthofbrug 5366,2022-03-04,11:00:00,94,58,36,FMN GV 16 Berchem TOT
54,Posthofbrug 5366,2022-03-04,12:00:00,195,108,87,FMN GV 16 Berchem TOT
54,Posthofbrug 5366,2022-03-04,13:00:00,179,97,82,FMN GV 16 Berchem TOT
54,Posthofbrug 5366,2022-03-04,14:00:00,187,102,85,FMN GV 16 Berchem TOT
54,Posthofbrug 5366,2022-03-04,15:00:00,203,87,116,FMN GV 16 Berchem TOT
54,Posthofbrug 5366,2022-03-04,16:00:00,323,126,197,FMN GV 16 Berchem TOT
54,Posthofbrug 5366,2022-03-04,17:00:00,317,110,207,FMN GV 16 Berchem TOT
54,Posthofbrug 5366,2022-03-04,18:00:00,244,111,133,FMN GV 16 Berchem TOT
54,Posthofbrug 5366,2022-03-04,19:00:00,158,90,68,FMN GV 16 Berchem TOT
54,Posthofbrug 5366,2022-03-04,20:00:00,97,64,33,FMN GV 16 Berchem TOT
54,Posthofbrug 5366,2022-03-04,21:00:00,65,23,42,FMN GV 16 Berchem TOT
54,Posthofbrug 5366,2022-03-04,22:00:00,75,26,49,FMN GV 16 Berchem TOT
54,Posthofbrug 5366,2022-03-04,23:00:00,46,10,36,FMN GV 16 Berchem TOT
54,Posthofbrug 5366,2022-03-05,00:00:00,51,19,32,FMN GV 16 Berchem TOT
54,Posthofbrug 5366,2022-03-05,01:00:00,65,13,52,FMN GV 16 Berchem TOT
54,Posthofbrug 5366,2022-03-05,02:00:00,32,6,26,FMN GV 16 Berchem TOT
54,Posthofbrug 5366,2022-03-05,03:00:00,26,1,25,FMN GV 16 Berchem TOT
54,Posthofbrug 5366,2022-03-05,04:00:00,12,6,6,FMN GV 16 Berchem TOT
54,Posthofbrug 5366,2022-03-05,05:00:00,14,6,8,FMN GV 16 Berchem TOT
54,Posthofbrug 5366,2022-03-05,06:00:00,20,10,10,FMN GV 16 Berchem TOT
54,Posthofbrug 5366,2022-03-05,07:00:00,25,14,11,FMN GV 16 Berchem TOT
54,Posthofbrug 5366,2022-03-05,08:00:00,57,37,20,FMN GV 16 Berchem TOT
54,Posthofbrug 5366,2022-03-05,09:00:00,95,65,30,FMN GV 16 Berchem TOT
54,Posthofbrug 5366,2022-03-05,10:00:00,145,98,47,FMN GV 16 Berchem TOT
54,Posthofbrug 5366,2022-03-05,11:00:00,127,65,62,FMN GV 16 Berchem TOT
54,Posthofbrug 5366,2022-03-05,12:00:00,164,93,71,FMN GV 16 Berchem TOT
54,Posthofbrug 5366,2022-03-05,13:00:00,192,121,71,FMN GV 16 Berchem TOT
54,Posthofbrug 5366,2022-03-05,14:00:00,240,149,91,FMN GV 16 Berchem TOT
54,Posthofbrug 5366,2022-03-05,15:00:00,192,102,90,FMN GV 16 Berchem TOT
54,Posthofbrug 5366,2022-03-05,16:00:00,179,66,113,FMN GV 16 Berchem TOT
54,Posthofbrug 5366,2022-03-05,17:00:00,204,90,114,FMN GV 16 Berchem TOT
54,Posthofbrug 5366,2022-03-05,18:00:00,148,76,72,FMN GV 16 Berchem TOT
54,Posthofbrug 5366,2022-03-05,19:00:00,108,45,63,FMN GV 16 Berchem TOT
54,Posthofbrug 5366,2022-03-05,20:00:00,78,37,41,FMN GV 16 Berchem TOT
54,Posthofbrug 5366,2022-03-05,21:00:00,66,36,30,FMN GV 16 Berchem TOT
54,Posthofbrug 5366,2022-03-05,22:00:00,81,50,31,FMN GV 16 Berchem TOT
54,Posthofbrug 5366,2022-03-05,23:00:00,81,53,28,FMN GV 16 Berchem TOT
54,Posthofbrug 5366,2022-03-06,00:00:00,48,23,25,FMN GV 16 Berchem TOT
54,Posthofbrug 5366,2022-03-06,01:00:00,32,16,16,FMN GV 16 Berchem TOT
54,Posthofbrug 5366,2022-03-06,02:00:00,28,7,21,FMN GV 16 Berchem TOT
54,Posthofbrug 5366,2022-03-06,03:00:00,18,3,15,FMN GV 16 Berchem TOT
54,Posthofbrug 5366,2022-03-06,04:00:00,14,2,12,FMN GV 16 Berchem TOT
54,Posthofbrug 5366,2022-03-06,05:00:00,14,5,9,FMN GV 16 Berchem TOT
54,Posthofbrug 5366,2022-03-06,06:00:00,21,9,12,FMN GV 16 Berchem TOT
54,Posthofbrug 5366,2022-03-06,07:00:00,26,10,16,FMN GV 16 Berchem TOT
54,Posthofbrug 5366,2022-03-06,08:00:00,46,29,17,FMN GV 16 Berchem TOT
54,Posthofbrug 5366,2022-03-06,09:00:00,79,47,32,FMN GV 16 Berchem TOT
54,Posthofbrug 5366,2022-03-06,10:00:00,108,70,38,FMN GV 16 Berchem TOT
54,Posthofbrug 5366,2022-03-06,11:00:00,151,95,56,FMN GV 16 Berchem TOT
54,Posthofbrug 5366,2022-03-06,12:00:00,145,80,65,FMN GV 16 Berchem TOT
54,Posthofbrug 5366,2022-03-06,13:00:00,174,92,82,FMN GV 16 Berchem TOT
54,Posthofbrug 5366,2022-03-06,14:00:00,188,102,86,FMN GV 16 Berchem TOT
54,Posthofbrug 5366,2022-03-06,15:00:00,166,69,97,FMN GV 16 Berchem TOT
54,Posthofbrug 5366,2022-03-06,16:00:00,154,72,82,FMN GV 16 Berchem TOT
54,Posthofbrug 5366,2022-03-06,17:00:00,170,83,87,FMN GV 16 Berchem TOT
54,Posthofbrug 5366,2022-03-06,18:00:00,123,55,68,FMN GV 16 Berchem TOT
54,Posthofbrug 5366,2022-03-06,19:00:00,57,28,29,FMN GV 16 Berchem TOT
54,Posthofbrug 5366,2022-03-06,20:00:00,40,23,17,FMN GV 16 Berchem TOT
54,Posthofbrug 5366,2022-03-06,21:00:00,60,31,29,FMN GV 16 Berchem TOT
54,Posthofbrug 5366,2022-03-06,22:00:00,35,14,21,FMN GV 16 Berchem TOT
54,Posthofbrug 5366,2022-03-06,23:00:00,11,2,9,FMN GV 16 Berchem TOT
54,Posthofbrug 5366,2022-03-07,00:00:00,15,4,11,FMN GV 16 Berchem TOT
54,Posthofbrug 5366,2022-03-07,01:00:00,6,2,4,FMN GV 16 Berchem TOT
54,Posthofbrug 5366,2022-03-07,02:00:00,2,1,1,FMN GV 16 Berchem TOT
54,Posthofbrug 5366,2022-03-07,03:00:00,2,1,1,FMN GV 16 Berchem TOT
54,Posthofbrug 5366,2022-03-07,04:00:00,12,10,2,FMN GV 16 Berchem TOT
54,Posthofbrug 5366,2022-03-07,05:00:00,21,16,5,FMN GV 16 Berchem TOT
54,Posthofbrug 5366,2022-03-07,06:00:00,86,66,20,FMN GV 16 Berchem TOT
54,Posthofbrug 5366,2022-03-07,07:00:00,386,301,85,FMN GV 16 Berchem TOT
54,Posthofbrug 5366,2022-03-07,08:00:00,673,511,162,FMN GV 16 Berchem TOT
54,Posthofbrug 5366,2022-03-07,09:00:00,217,158,59,FMN GV 16 Berchem TOT
54,Posthofbrug 5366,2022-03-07,10:00:00,0,0,0,FMN GV 16 Berchem TOT
54,Posthofbrug 5366,2022-03-07,11:00:00,0,0,0,FMN GV 16 Berchem TOT
54,Posthofbrug 5366,2022-03-07,12:00:00,0,0,0,FMN GV 16 Berchem TOT
54,Posthofbrug 5366,2022-03-07,13:00:00,0,0,0,FMN GV 16 Berchem TOT
54,Posthofbrug 5366,2022-03-07,14:00:00,0,0,0,FMN GV 16 Berchem TOT
54,Posthofbrug 5366,2022-03-07,15:00:00,0,0,0,FMN GV 16 Berchem TOT
54,Posthofbrug 5366,2022-03-07,16:00:00,0,0,0,FMN GV 16 Berchem TOT
54,Posthofbrug 5366,2022-03-07,17:00:00,0,0,0,FMN GV 16 Berchem TOT
54,Posthofbrug 5366,2022-03-07,18:00:00,307,98,209,FMN GV 16 Berchem TOT
54,Posthofbrug 5366,2022-03-07,19:00:00,149,61,88,FMN GV 16 Berchem TOT
54,Posthofbrug 5366,2022-03-07,20:00:00,77,24,53,FMN GV 16 Berchem TOT
54,Posthofbrug 5366,2022-03-07,21:00:00,88,40,48,FMN GV 16 Berchem TOT
54,Posthofbrug 5366,2022-03-07,22:00:00,59,23,36,FMN GV 16 Berchem TOT
54,Posthofbrug 5366,2022-03-07,23:00:00,33,12,21,FMN GV 16 Berchem TOT
54,Posthofbrug 5366,2022-03-08,00:00:00,12,2,10,FMN GV 16 Berchem TOT
54,Posthofbrug 5366,2022-03-08,01:00:00,10,6,4,FMN GV 16 Berchem TOT
54,Posthofbrug 5366,2022-03-08,02:00:00,1,0,1,FMN GV 16 Berchem TOT
54,Posthofbrug 5366,2022-03-08,03:00:00,6,0,6,FMN GV 16 Berchem TOT
54,Posthofbrug 5366,2022-03-08,04:00:00,12,9,3,FMN GV 16 Berchem TOT
54,Posthofbrug 5366,2022-03-08,05:00:00,27,20,7,FMN GV 16 Berchem TOT
54,Posthofbrug 5366,2022-03-08,06:00:00,105,87,18,FMN GV 16 Berchem TOT
54,Posthofbrug 5366,2022-03-08,07:00:00,447,333,114,FMN GV 16 Berchem TOT
54,Posthofbrug 5366,2022-03-08,08:00:00,748,571,177,FMN GV 16 Berchem TOT
54,Posthofbrug 5366,2022-03-08,09:00:00,247,178,69,FMN GV 16 Berchem TOT
54,Posthofbrug 5366,2022-03-08,10:00:00,125,85,40,FMN GV 16 Berchem TOT
54,Posthofbrug 5366,2022-03-08,11:00:00,112,58,54,FMN GV 16 Berchem TOT
54,Posthofbrug 5366,2022-03-08,12:00:00,178,96,82,FMN GV 16 Berchem TOT
54,Posthofbrug 5366,2022-03-08,13:00:00,145,73,72,FMN GV 16 Berchem TOT
54,Posthofbrug 5366,2022-03-08,14:00:00,156,64,92,FMN GV 16 Berchem TOT
54,Posthofbrug 5366,2022-03-08,15:00:00,239,81,158,FMN GV 16 Berchem TOT
54,Posthofbrug 5366,2022-03-08,16:00:00,448,149,299,FMN GV 16 Berchem TOT
54,Posthofbrug 5366,2022-03-08,17:00:00,546,145,401,FMN GV 16 Berchem TOT
54,Posthofbrug 5366,2022-03-08,18:00:00,382,124,258,FMN GV 16 Berchem TOT
54,Posthofbrug 5366,2022-03-08,19:00:00,189,79,110,FMN GV 16 Berchem TOT
54,Posthofbrug 5366,2022-03-08,20:00:00,97,40,57,FMN GV 16 Berchem TOT
54,Posthofbrug 5366,2022-03-08,21:00:00,84,29,55,FMN GV 16 Berchem TOT
54,Posthofbrug 5366,2022-03-08,22:00:00,87,32,55,FMN GV 16 Berchem TOT
54,Posthofbrug 5366,2022-03-08,23:00:00,37,10,27,FMN GV 16 Berchem TOT
54,Posthofbrug 5366,2022-03-09,00:00:00,25,7,18,FMN GV 16 Berchem TOT
54,Posthofbrug 5366,2022-03-09,01:00:00,10,6,4,FMN GV 16 Berchem TOT
54,Posthofbrug 5366,2022-03-09,02:00:00,1,0,1,FMN GV 16 Berchem TOT
54,Posthofbrug 5366,2022-03-09,03:00:00,4,3,1,FMN GV 16 Berchem TOT
54,Posthofbrug 5366,2022-03-09,04:00:00,10,6,4,FMN GV 16 Berchem TOT
54,Posthofbrug 5366,2022-03-09,05:00:00,29,22,7,FMN GV 16 Berchem TOT
54,Posthofbrug 5366,2022-03-09,06:00:00,108,86,22,FMN GV 16 Berchem TOT
54,Posthofbrug 5366,2022-03-09,07:00:00,384,289,95,FMN GV 16 Berchem TOT
54,Posthofbrug 5366,2022-03-09,08:00:00,578,433,145,FMN GV 16 Berchem TOT
54,Posthofbrug 5366,2022-03-09,09:00:00,210,148,62,FMN GV 16 Berchem TOT
54,Posthofbrug 5366,2022-03-09,10:00:00,123,79,44,FMN GV 16 Berchem TOT
54,Posthofbrug 5366,2022-03-09,11:00:00,116,63,53,FMN GV 16 Berchem TOT
54,Posthofbrug 5366,2022-03-09,12:00:00,287,125,162,FMN GV 16 Berchem TOT
54,Posthofbrug 5366,2022-03-09,13:00:00,242,111,131,FMN GV 16 Berchem TOT
54,Posthofbrug 5366,2022-03-09,14:00:00,176,89,87,FMN GV 16 Berchem TOT
54,Posthofbrug 5366,2022-03-09,15:00:00,212,87,125,FMN GV 16 Berchem TOT
54,Posthofbrug 5366,2022-03-09,16:00:00,384,135,249,FMN GV 16 Berchem TOT
54,Posthofbrug 5366,2022-03-09,17:00:00,491,174,317,FMN GV 16 Berchem TOT
54,Posthofbrug 5366,2022-03-09,18:00:00,335,122,213,FMN GV 16 Berchem TOT
54,Posthofbrug 5366,2022-03-09,19:00:00,168,67,101,FMN GV 16 Berchem TOT
54,Posthofbrug 5366,2022-03-09,20:00:00,102,43,59,FMN GV 16 Berchem TOT
54,Posthofbrug 5366,2022-03-09,21:00:00,95,44,51,FMN GV 16 Berchem TOT
54,Posthofbrug 5366,2022-03-09,22:00:00,105,30,75,FMN GV 16 Berchem TOT
54,Posthofbrug 5366,2022-03-09,23:00:00,54,21,33,FMN GV 16 Berchem TOT
54,Posthofbrug 5366,2022-03-10,00:00:00,30,6,24,FMN GV 16 Berchem TOT
54,Posthofbrug 5366,2022-03-10,01:00:00,5,0,5,FMN GV 16 Berchem TOT
54,Posthofbrug 5366,2022-03-10,02:00:00,7,1,6,FMN GV 16 Berchem TOT
54,Posthofbrug 5366,2022-03-10,03:00:00,6,1,5,FMN GV 16 Berchem TOT
54,Posthofbrug 5366,2022-03-10,04:00:00,11,9,2,FMN GV 16 Berchem TOT
54,Posthofbrug 5366,2022-03-10,05:00:00,22,17,5,FMN GV 16 Berchem TOT
54,Posthofbrug 5366,2022-03-10,06:00:00,122,103,19,FMN GV 16 Berchem TOT
54,Posthofbrug 5366,2022-03-10,07:00:00,409,322,87,FMN GV 16 Berchem TOT
54,Posthofbrug 5366,2022-03-10,08:00:00,729,558,171,FMN GV 16 Berchem TOT
54,Posthofbrug 5366,2022-03-10,09:00:00,246,187,59,FMN GV 16 Berchem TOT
54,Posthofbrug 5366,2022-03-10,10:00:00,123,82,41,FMN GV 16 Berchem TOT
54,Posthofbrug 5366,2022-03-10,11:00:00,124,76,48,FMN GV 16 Berchem TOT
54,Posthofbrug 5366,2022-03-10,12:00:00,205,111,94,FMN GV 16 Berchem TOT
54,Posthofbrug 5366,2022-03-10,13:00:00,210,98,112,FMN GV 16 Berchem TOT
54,Posthofbrug 5366,2022-03-10,14:00:00,1,1,0,FMN GV 16 Berchem TOT
54,Posthofbrug 5366,2022-03-10,15:00:00,0,0,0,FMN GV 16 Berchem TOT
54,Posthofbrug 5366,2022-03-10,16:00:00,0,0,0,FMN GV 16 Berchem TOT
54,Posthofbrug 5366,2022-03-10,17:00:00,0,0,0,FMN GV 16 Berchem TOT
54,Posthofbrug 5366,2022-03-10,18:00:00,0,0,0,FMN GV 16 Berchem TOT
54,Posthofbrug 5366,2022-03-10,19:00:00,0,0,0,FMN GV 16 Berchem TOT
54,Posthofbrug 5366,2022-03-10,20:00:00,117,62,55,FMN GV 16 Berchem TOT
54,Posthofbrug 5366,2022-03-10,21:00:00,91,43,48,FMN GV 16 Berchem TOT
54,Posthofbrug 5366,2022-03-10,22:00:00,123,47,76,FMN GV 16 Berchem TOT
54,Posthofbrug 5366,2022-03-10,23:00:00,71,21,50,FMN GV 16 Berchem TOT
54,Posthofbrug 5366,2022-03-11,00:00:00,30,2,28,FMN GV 16 Berchem TOT
54,Posthofbrug 5366,2022-03-11,01:00:00,17,3,14,FMN GV 16 Berchem TOT
54,Posthofbrug 5366,2022-03-11,02:00:00,9,0,9,FMN GV 16 Berchem TOT
54,Posthofbrug 5366,2022-03-11,03:00:00,11,2,9,FMN GV 16 Berchem TOT
54,Posthofbrug 5366,2022-03-11,04:00:00,16,10,6,FMN GV 16 Berchem TOT
54,Posthofbrug 5366,2022-03-11,05:00:00,36,27,9,FMN GV 16 Berchem TOT
54,Posthofbrug 5366,2022-03-11,06:00:00,95,77,18,FMN GV 16 Berchem TOT
54,Posthofbrug 5366,2022-03-11,07:00:00,326,253,73,FMN GV 16 Berchem TOT
54,Posthofbrug 5366,2022-03-11,08:00:00,587,420,167,FMN GV 16 Berchem TOT
54,Posthofbrug 5366,2022-03-11,09:00:00,212,155,57,FMN GV 16 Berchem TOT
54,Posthofbrug 5366,2022-03-11,10:00:00,140,99,41,FMN GV 16 Berchem TOT
54,Posthofbrug 5366,2022-03-11,11:00:00,126,69,57,FMN GV 16 Berchem TOT
54,Posthofbrug 5366,2022-03-11,12:00:00,204,111,93,FMN GV 16 Berchem TOT
54,Posthofbrug 5366,2022-03-11,13:00:00,198,103,95,FMN GV 16 Berchem TOT
54,Posthofbrug 5366,2022-03-11,14:00:00,0,0,0,FMN GV 16 Berchem TOT
54,Posthofbrug 5366,2022-03-11,15:00:00,0,0,0,FMN GV 16 Berchem TOT
54,Posthofbrug 5366,2022-03-11,16:00:00,0,0,0,FMN GV 16 Berchem TOT
54,Posthofbrug 5366,2022-03-11,17:00:00,0,0,0,FMN GV 16 Berchem TOT
54,Posthofbrug 5366,2022-03-11,18:00:00,0,0,0,FMN GV 16 Berchem TOT
54,Posthofbrug 5366,2022-03-11,19:00:00,0,0,0,FMN GV 16 Berchem TOT
54,Posthofbrug 5366,2022-03-11,20:00:00,0,0,0,FMN GV 16 Berchem TOT
54,Posthofbrug 5366,2022-03-11,21:00:00,0,0,0,FMN GV 16 Berchem TOT
54,Posthofbrug 5366,2022-03-11,22:00:00,97,23,74,FMN GV 16 Berchem TOT
54,Posthofbrug 5366,2022-03-11,23:00:00,90,30,60,FMN GV 16 Berchem TOT
54,Posthofbrug 5366,2022-03-12,00:00:00,56,22,34,FMN GV 16 Berchem TOT
54,Posthofbrug 5366,2022-03-12,01:00:00,45,10,35,FMN GV 16 Berchem TOT
54,Posthofbrug 5366,2022-03-12,02:00:00,28,8,20,FMN GV 16 Berchem TOT
54,Posthofbrug 5366,2022-03-12,03:00:00,19,3,16,FMN GV 16 Berchem TOT
54,Posthofbrug 5366,2022-03-12,04:00:00,16,9,7,FMN GV 16 Berchem TOT
54,Posthofbrug 5366,2022-03-12,05:00:00,12,6,6,FMN GV 16 Berchem TOT
54,Posthofbrug 5366,2022-03-12,06:00:00,19,12,7,FMN GV 16 Berchem TOT
54,Posthofbrug 5366,2022-03-12,07:00:00,41,29,12,FMN GV 16 Berchem TOT
54,Posthofbrug 5366,2022-03-12,08:00:00,76,46,30,FMN GV 16 Berchem TOT
54,Posthofbrug 5366,2022-03-12,09:00:00,109,76,33,FMN GV 16 Berchem TOT
54,Posthofbrug 5366,2022-03-12,10:00:00,164,99,65,FMN GV 16 Berchem TOT
54,Posthofbrug 5366,2022-03-12,11:00:00,157,95,62,FMN GV 16 Berchem TOT
54,Posthofbrug 5366,2022-03-12,12:00:00,200,107,93,FMN GV 16 Berchem TOT
54,Posthofbrug 5366,2022-03-12,13:00:00,211,102,109,FMN GV 16 Berchem TOT
54,Posthofbrug 5366,2022-03-12,14:00:00,201,99,102,FMN GV 16 Berchem TOT
54,Posthofbrug 5366,2022-03-12,15:00:00,187,94,93,FMN GV 16 Berchem TOT
54,Posthofbrug 5366,2022-03-12,16:00:00,194,96,98,FMN GV 16 Berchem TOT
54,Posthofbrug 5366,2022-03-12,17:00:00,220,111,109,FMN GV 16 Berchem TOT
54,Posthofbrug 5366,2022-03-12,18:00:00,178,107,71,FMN GV 16 Berchem TOT
54,Posthofbrug 5366,2022-03-12,19:00:00,144,86,58,FMN GV 16 Berchem TOT
54,Posthofbrug 5366,2022-03-12,20:00:00,87,41,46,FMN GV 16 Berchem TOT
54,Posthofbrug 5366,2022-03-12,21:00:00,83,36,47,FMN GV 16 Berchem TOT
54,Posthofbrug 5366,2022-03-12,22:00:00,69,38,31,FMN GV 16 Berchem TOT
54,Posthofbrug 5366,2022-03-12,23:00:00,64,29,35,FMN GV 16 Berchem TOT
54,Posthofbrug 5366,2022-03-13,00:00:00,58,24,34,FMN GV 16 Berchem TOT
54,Posthofbrug 5366,2022-03-13,01:00:00,69,20,49,FMN GV 16 Berchem TOT
54,Posthofbrug 5366,2022-03-13,02:00:00,27,7,20,FMN GV 16 Berchem TOT
54,Posthofbrug 5366,2022-03-13,03:00:00,30,4,26,FMN GV 16 Berchem TOT
54,Posthofbrug 5366,2022-03-13,04:00:00,29,10,19,FMN GV 16 Berchem TOT
54,Posthofbrug 5366,2022-03-13,05:00:00,31,7,24,FMN GV 16 Berchem TOT
54,Posthofbrug 5366,2022-03-13,06:00:00,27,15,12,FMN GV 16 Berchem TOT
54,Posthofbrug 5366,2022-03-13,07:00:00,45,17,28,FMN GV 16 Berchem TOT
54,Posthofbrug 5366,2022-03-13,08:00:00,51,31,20,FMN GV 16 Berchem TOT
54,Posthofbrug 5366,2022-03-13,09:00:00,129,66,63,FMN GV 16 Berchem TOT
54,Posthofbrug 5366,2022-03-13,10:00:00,133,69,64,FMN GV 16 Berchem TOT
54,Posthofbrug 5366,2022-03-13,11:00:00,149,81,68,FMN GV 16 Berchem TOT
54,Posthofbrug 5366,2022-03-13,12:00:00,194,107,87,FMN GV 16 Berchem TOT
54,Posthofbrug 5366,2022-03-13,13:00:00,198,125,73,FMN GV 16 Berchem TOT
54,Posthofbrug 5366,2022-03-13,14:00:00,194,96,98,FMN GV 16 Berchem TOT
54,Posthofbrug 5366,2022-03-13,15:00:00,190,95,95,FMN GV 16 Berchem TOT
54,Posthofbrug 5366,2022-03-13,16:00:00,176,92,84,FMN GV 16 Berchem TOT
54,Posthofbrug 5366,2022-03-13,17:00:00,182,83,99,FMN GV 16 Berchem TOT
54,Posthofbrug 5366,2022-03-13,18:00:00,123,61,62,FMN GV 16 Berchem TOT
54,Posthofbrug 5366,2022-03-13,19:00:00,98,55,43,FMN GV 16 Berchem TOT
54,Posthofbrug 5366,2022-03-13,20:00:00,76,39,37,FMN GV 16 Berchem TOT
54,Posthofbrug 5366,2022-03-13,21:00:00,52,18,34,FMN GV 16 Berchem TOT
54,Posthofbrug 5366,2022-03-13,22:00:00,45,20,25,FMN GV 16 Berchem TOT
54,Posthofbrug 5366,2022-03-13,23:00:00,25,7,18,FMN GV 16 Berchem TOT
54,Posthofbrug 5366,2022-03-14,00:00:00,12,1,11,FMN GV 16 Berchem TOT
54,Posthofbrug 5366,2022-03-14,01:00:00,7,1,6,FMN GV 16 Berchem TOT
54,Posthofbrug 5366,2022-03-14,02:00:00,4,1,3,FMN GV 16 Berchem TOT
54,Posthofbrug 5366,2022-03-14,03:00:00,1,1,0,FMN GV 16 Berchem TOT
54,Posthofbrug 5366,2022-03-14,04:00:00,10,7,3,FMN GV 16 Berchem TOT
54,Posthofbrug 5366,2022-03-14,05:00:00,37,28,9,FMN GV 16 Berchem TOT
54,Posthofbrug 5366,2022-03-14,06:00:00,105,89,16,FMN GV 16 Berchem TOT
54,Posthofbrug 5366,2022-03-14,07:00:00,389,299,90,FMN GV 16 Berchem TOT
54,Posthofbrug 5366,2022-03-14,08:00:00,714,538,176,FMN GV 16 Berchem TOT
54,Posthofbrug 5366,2022-03-14,09:00:00,214,166,48,FMN GV 16 Berchem TOT
54,Posthofbrug 5366,2022-03-14,10:00:00,108,69,39,FMN GV 16 Berchem TOT
54,Posthofbrug 5366,2022-03-14,11:00:00,104,51,53,FMN GV 16 Berchem TOT
54,Posthofbrug 5366,2022-03-14,12:00:00,135,69,66,FMN GV 16 Berchem TOT
54,Posthofbrug 5366,2022-03-14,13:00:00,148,74,74,FMN GV 16 Berchem TOT
54,Posthofbrug 5366,2022-03-14,14:00:00,138,58,80,FMN GV 16 Berchem TOT
54,Posthofbrug 5366,2022-03-14,15:00:00,212,64,148,FMN GV 16 Berchem TOT
54,Posthofbrug 5366,2022-03-14,16:00:00,389,112,277,FMN GV 16 Berchem TOT
54,Posthofbrug 5366,2022-03-14,17:00:00,536,154,382,FMN GV 16 Berchem TOT
54,Posthofbrug 5366,2022-03-14,18:00:00,329,119,210,FMN GV 16 Berchem TOT
54,Posthofbrug 5366,2022-03-14,19:00:00,154,64,90,FMN GV 16 Berchem TOT
54,Posthofbrug 5366,2022-03-14,20:00:00,78,33,45,FMN GV 16 Berchem TOT
54,Posthofbrug 5366,2022-03-14,21:00:00,84,33,51,FMN GV 16 Berchem TOT
54,Posthofbrug 5366,2022-03-14,22:00:00,64,24,40,FMN GV 16 Berchem TOT
54,Posthofbrug 5366,2022-03-14,23:00:00,31,17,14,FMN GV 16 Berchem TOT
54,Posthofbrug 5366,2022-03-15,00:00:00,12,1,11,FMN GV 16 Berchem TOT
54,Posthofbrug 5366,2022-03-15,01:00:00,12,3,9,FMN GV 16 Berchem TOT
54,Posthofbrug 5366,2022-03-15,02:00:00,4,3,1,FMN GV 16 Berchem TOT
54,Posthofbrug 5366,2022-03-15,03:00:00,6,5,1,FMN GV 16 Berchem TOT
54,Posthofbrug 5366,2022-03-15,04:00:00,12,10,2,FMN GV 16 Berchem TOT
54,Posthofbrug 5366,2022-03-15,05:00:00,38,30,8,FMN GV 16 Berchem TOT
54,Posthofbrug 5366,2022-03-15,06:00:00,111,92,19,FMN GV 16 Berchem TOT
54,Posthofbrug 5366,2022-03-15,07:00:00,436,312,124,FMN GV 16 Berchem TOT
54,Posthofbrug 5366,2022-03-15,08:00:00,749,569,180,FMN GV 16 Berchem TOT
54,Posthofbrug 5366,2022-03-15,09:00:00,217,161,56,FMN GV 16 Berchem TOT
54,Posthofbrug 5366,2022-03-15,10:00:00,106,63,43,FMN GV 16 Berchem TOT
54,Posthofbrug 5366,2022-03-15,11:00:00,99,50,49,FMN GV 16 Berchem TOT
54,Posthofbrug 5366,2022-03-15,12:00:00,181,93,88,FMN GV 16 Berchem TOT
54,Posthofbrug 5366,2022-03-15,13:00:00,147,76,71,FMN GV 16 Berchem TOT
54,Posthofbrug 5366,2022-03-15,14:00:00,124,49,75,FMN GV 16 Berchem TOT
54,Posthofbrug 5366,2022-03-15,15:00:00,226,80,146,FMN GV 16 Berchem TOT
54,Posthofbrug 5366,2022-03-15,16:00:00,436,140,296,FMN GV 16 Berchem TOT
54,Posthofbrug 5366,2022-03-15,17:00:00,550,165,385,FMN GV 16 Berchem TOT
54,Posthofbrug 5366,2022-03-15,18:00:00,334,120,214,FMN GV 16 Berchem TOT
54,Posthofbrug 5366,2022-03-15,19:00:00,181,72,109,FMN GV 16 Berchem TOT
54,Posthofbrug 5366,2022-03-15,20:00:00,114,46,68,FMN GV 16 Berchem TOT
54,Posthofbrug 5366,2022-03-15,21:00:00,82,30,52,FMN GV 16 Berchem TOT
54,Posthofbrug 5366,2022-03-15,22:00:00,87,35,52,FMN GV 16 Berchem TOT
54,Posthofbrug 5366,2022-03-15,23:00:00,52,17,35,FMN GV 16 Berchem TOT
54,Posthofbrug 5366,2022-03-16,00:00:00,26,4,22,FMN GV 16 Berchem TOT
54,Posthofbrug 5366,2022-03-16,01:00:00,8,1,7,FMN GV 16 Berchem TOT
54,Posthofbrug 5366,2022-03-16,02:00:00,2,0,2,FMN GV 16 Berchem TOT
54,Posthofbrug 5366,2022-03-16,03:00:00,2,1,1,FMN GV 16 Berchem TOT
54,Posthofbrug 5366,2022-03-16,04:00:00,15,11,4,FMN GV 16 Berchem TOT
54,Posthofbrug 5366,2022-03-16,05:00:00,30,26,4,FMN GV 16 Berchem TOT
54,Posthofbrug 5366,2022-03-16,06:00:00,122,101,21,FMN GV 16 Berchem TOT
54,Posthofbrug 5366,2022-03-16,07:00:00,387,289,98,FMN GV 16 Berchem TOT
54,Posthofbrug 5366,2022-03-16,08:00:00,629,476,153,FMN GV 16 Berchem TOT
54,Posthofbrug 5366,2022-03-16,09:00:00,232,166,66,FMN GV 16 Berchem TOT
54,Posthofbrug 5366,2022-03-16,10:00:00,146,98,48,FMN GV 16 Berchem TOT
54,Posthofbrug 5366,2022-03-16,11:00:00,130,77,53,FMN GV 16 Berchem TOT
54,Posthofbrug 5366,2022-03-16,12:00:00,312,151,161,FMN GV 16 Berchem TOT
54,Posthofbrug 5366,2022-03-16,13:00:00,205,86,119,FMN GV 16 Berchem TOT
54,Posthofbrug 5366,2022-03-16,14:00:00,191,82,109,FMN GV 16 Berchem TOT
54,Posthofbrug 5366,2022-03-16,15:00:00,217,72,145,FMN GV 16 Berchem TOT
54,Posthofbrug 5366,2022-03-16,16:00:00,385,134,251,FMN GV 16 Berchem TOT
54,Posthofbrug 5366,2022-03-16,17:00:00,492,172,320,FMN GV 16 Berchem TOT
54,Posthofbrug 5366,2022-03-16,18:00:00,370,140,230,FMN GV 16 Berchem TOT
54,Posthofbrug 5366,2022-03-16,19:00:00,193,80,113,FMN GV 16 Berchem TOT
54,Posthofbrug 5366,2022-03-16,20:00:00,97,46,51,FMN GV 16 Berchem TOT
54,Posthofbrug 5366,2022-03-16,21:00:00,101,41,60,FMN GV 16 Berchem TOT
54,Posthofbrug 5366,2022-03-16,22:00:00,94,31,63,FMN GV 16 Berchem TOT
54,Posthofbrug 5366,2022-03-16,23:00:00,60,19,41,FMN GV 16 Berchem TOT
54,Posthofbrug 5366,2022-03-17,00:00:00,25,8,17,FMN GV 16 Berchem TOT
54,Posthofbrug 5366,2022-03-17,01:00:00,11,2,9,FMN GV 16 Berchem TOT
54,Posthofbrug 5366,2022-03-17,02:00:00,7,2,5,FMN GV 16 Berchem TOT
54,Posthofbrug 5366,2022-03-17,03:00:00,8,0,8,FMN GV 16 Berchem TOT
54,Posthofbrug 5366,2022-03-17,04:00:00,23,7,16,FMN GV 16 Berchem TOT
54,Posthofbrug 5366,2022-03-17,05:00:00,49,37,12,FMN GV 16 Berchem TOT
54,Posthofbrug 5366,2022-03-17,06:00:00,112,92,20,FMN GV 16 Berchem TOT
54,Posthofbrug 5366,2022-03-17,07:00:00,403,305,98,FMN GV 16 Berchem TOT
54,Posthofbrug 5366,2022-03-17,08:00:00,713,531,182,FMN GV 16 Berchem TOT
54,Posthofbrug 5366,2022-03-17,09:00:00,242,188,54,FMN GV 16 Berchem TOT
54,Posthofbrug 5366,2022-03-17,10:00:00,100,69,31,FMN GV 16 Berchem TOT
54,Posthofbrug 5366,2022-03-17,11:00:00,111,71,40,FMN GV 16 Berchem TOT
54,Posthofbrug 5366,2022-03-17,12:00:00,174,100,74,FMN GV 16 Berchem TOT
54,Posthofbrug 5366,2022-03-17,13:00:00,146,65,81,FMN GV 16 Berchem TOT
54,Posthofbrug 5366,2022-03-17,14:00:00,166,70,96,FMN GV 16 Berchem TOT
54,Posthofbrug 5366,2022-03-17,15:00:00,271,86,185,FMN GV 16 Berchem TOT
54,Posthofbrug 5366,2022-03-17,16:00:00,401,134,267,FMN GV 16 Berchem TOT
54,Posthofbrug 5366,2022-03-17,17:00:00,558,182,376,FMN GV 16 Berchem TOT
54,Posthofbrug 5366,2022-03-17,18:00:00,360,147,213,FMN GV 16 Berchem TOT
54,Posthofbrug 5366,2022-03-17,19:00:00,204,80,124,FMN GV 16 Berchem TOT
54,Posthofbrug 5366,2022-03-17,20:00:00,116,45,71,FMN GV 16 Berchem TOT
54,Posthofbrug 5366,2022-03-17,21:00:00,85,41,44,FMN GV 16 Berchem TOT
54,Posthofbrug 5366,2022-03-17,22:00:00,108,44,64,FMN GV 16 Berchem TOT
54,Posthofbrug 5366,2022-03-17,23:00:00,77,21,56,FMN GV 16 Berchem TOT
54,Posthofbrug 5366,2022-03-18,00:00:00,38,14,24,FMN GV 16 Berchem TOT
54,Posthofbrug 5366,2022-03-18,01:00:00,17,1,16,FMN GV 16 Berchem TOT
54,Posthofbrug 5366,2022-03-18,02:00:00,21,8,13,FMN GV 16 Berchem TOT
54,Posthofbrug 5366,2022-03-18,03:00:00,32,2,30,FMN GV 16 Berchem TOT
54,Posthofbrug 5366,2022-03-18,04:00:00,17,7,10,FMN GV 16 Berchem TOT
54,Posthofbrug 5366,2022-03-18,05:00:00,37,29,8,FMN GV 16 Berchem TOT
54,Posthofbrug 5366,2022-03-18,06:00:00,97,80,17,FMN GV 16 Berchem TOT
54,Posthofbrug 5366,2022-03-18,07:00:00,341,250,91,FMN GV 16 Berchem TOT
54,Posthofbrug 5366,2022-03-18,08:00:00,604,444,160,FMN GV 16 Berchem TOT
54,Posthofbrug 5366,2022-03-18,09:00:00,196,165,31,FMN GV 16 Berchem TOT
54,Posthofbrug 5366,2022-03-18,10:00:00,131,98,33,FMN GV 16 Berchem TOT
54,Posthofbrug 5366,2022-03-18,11:00:00,136,61,75,FMN GV 16 Berchem TOT
54,Posthofbrug 5366,2022-03-18,12:00:00,210,92,118,FMN GV 16 Berchem TOT
54,Posthofbrug 5366,2022-03-18,13:00:00,188,94,94,FMN GV 16 Berchem TOT
54,Posthofbrug 5366,2022-03-18,14:00:00,190,75,115,FMN GV 16 Berchem TOT
54,Posthofbrug 5366,2022-03-18,15:00:00,286,101,185,FMN GV 16 Berchem TOT
54,Posthofbrug 5366,2022-03-18,16:00:00,395,118,277,FMN GV 16 Berchem TOT
54,Posthofbrug 5366,2022-03-18,17:00:00,438,157,281,FMN GV 16 Berchem TOT
54,Posthofbrug 5366,2022-03-18,18:00:00,1,1,0,FMN GV 16 Berchem TOT
54,Posthofbrug 5366,2022-03-18,19:00:00,0,0,0,FMN GV 16 Berchem TOT
54,Posthofbrug 5366,2022-03-18,20:00:00,0,0,0,FMN GV 16 Berchem TOT
54,Posthofbrug 5366,2022-03-18,21:00:00,0,0,0,FMN GV 16 Berchem TOT
54,Posthofbrug 5366,2022-03-18,22:00:00,92,36,56,FMN GV 16 Berchem TOT
54,Posthofbrug 5366,2022-03-18,23:00:00,91,26,65,FMN GV 16 Berchem TOT
54,Posthofbrug 5366,2022-03-19,00:00:00,47,7,40,FMN GV 16 Berchem TOT
54,Posthofbrug 5366,2022-03-19,01:00:00,57,22,35,FMN GV 16 Berchem TOT
54,Posthofbrug 5366,2022-03-19,02:00:00,27,5,22,FMN GV 16 Berchem TOT
54,Posthofbrug 5366,2022-03-19,03:00:00,16,5,11,FMN GV 16 Berchem TOT
54,Posthofbrug 5366,2022-03-19,04:00:00,25,9,16,FMN GV 16 Berchem TOT
54,Posthofbrug 5366,2022-03-19,05:00:00,14,6,8,FMN GV 16 Berchem TOT
54,Posthofbrug 5366,2022-03-19,06:00:00,24,12,12,FMN GV 16 Berchem TOT
54,Posthofbrug 5366,2022-03-19,07:00:00,29,17,12,FMN GV 16 Berchem TOT
54,Posthofbrug 5366,2022-03-19,08:00:00,63,31,32,FMN GV 16 Berchem TOT
54,Posthofbrug 5366,2022-03-19,09:00:00,157,97,60,FMN GV 16 Berchem TOT
54,Posthofbrug 5366,2022-03-19,10:00:00,167,96,71,FMN GV 16 Berchem TOT
54,Posthofbrug 5366,2022-03-19,11:00:00,179,101,78,FMN GV 16 Berchem TOT
54,Posthofbrug 5366,2022-03-19,12:00:00,0,0,0,FMN GV 16 Berchem TOT
54,Posthofbrug 5366,2022-03-19,13:00:00,0,0,0,FMN GV 16 Berchem TOT
54,Posthofbrug 5366,2022-03-19,14:00:00,0,0,0,FMN GV 16 Berchem TOT
54,Posthofbrug 5366,2022-03-19,15:00:00,0,0,0,FMN GV 16 Berchem TOT
54,Posthofbrug 5366,2022-03-19,16:00:00,0,0,0,FMN GV 16 Berchem TOT
54,Posthofbrug 5366,2022-03-19,17:00:00,0,0,0,FMN GV 16 Berchem TOT
54,Posthofbrug 5366,2022-03-19,18:00:00,0,0,0,FMN GV 16 Berchem TOT
54,Posthofbrug 5366,2022-03-19,19:00:00,0,0,0,FMN GV 16 Berchem TOT
54,Posthofbrug 5366,2022-03-19,20:00:00,73,32,41,FMN GV 16 Berchem TOT
54,Posthofbrug 5366,2022-03-19,21:00:00,60,24,36,FMN GV 16 Berchem TOT
54,Posthofbrug 5366,2022-03-19,22:00:00,62,27,35,FMN GV 16 Berchem TOT
54,Posthofbrug 5366,2022-03-19,23:00:00,48,14,34,FMN GV 16 Berchem TOT
54,Posthofbrug 5366,2022-03-20,00:00:00,46,21,25,FMN GV 16 Berchem TOT
54,Posthofbrug 5366,2022-03-20,01:00:00,55,31,24,FMN GV 16 Berchem TOT
54,Posthofbrug 5366,2022-03-20,02:00:00,19,8,11,FMN GV 16 Berchem TOT
54,Posthofbrug 5366,2022-03-20,03:00:00,28,5,23,FMN GV 16 Berchem TOT
54,Posthofbrug 5366,2022-03-20,04:00:00,28,8,20,FMN GV 16 Berchem TOT
54,Posthofbrug 5366,2022-03-20,05:00:00,23,6,17,FMN GV 16 Berchem TOT
54,Posthofbrug 5366,2022-03-20,06:00:00,14,11,3,FMN GV 16 Berchem TOT
54,Posthofbrug 5366,2022-03-20,07:00:00,29,21,8,FMN GV 16 Berchem TOT
54,Posthofbrug 5366,2022-03-20,08:00:00,39,26,13,FMN GV 16 Berchem TOT
54,Posthofbrug 5366,2022-03-20,09:00:00,68,38,30,FMN GV 16 Berchem TOT
54,Posthofbrug 5366,2022-03-20,10:00:00,88,49,39,FMN GV 16 Berchem TOT
54,Posthofbrug 5366,2022-03-20,11:00:00,103,57,46,FMN GV 16 Berchem TOT
54,Posthofbrug 5366,2022-03-20,12:00:00,119,64,55,FMN GV 16 Berchem TOT
54,Posthofbrug 5366,2022-03-20,13:00:00,127,71,56,FMN GV 16 Berchem TOT
54,Posthofbrug 5366,2022-03-20,14:00:00,165,95,70,FMN GV 16 Berchem TOT
54,Posthofbrug 5366,2022-03-20,15:00:00,139,73,66,FMN GV 16 Berchem TOT
54,Posthofbrug 5366,2022-03-20,16:00:00,128,54,74,FMN GV 16 Berchem TOT
54,Posthofbrug 5366,2022-03-20,17:00:00,138,71,67,FMN GV 16 Berchem TOT
54,Posthofbrug 5366,2022-03-20,18:00:00,125,56,69,FMN GV 16 Berchem TOT
54,Posthofbrug 5366,2022-03-20,19:00:00,76,35,41,FMN GV 16 Berchem TOT
54,Posthofbrug 5366,2022-03-20,20:00:00,48,25,23,FMN GV 16 Berchem TOT
54,Posthofbrug 5366,2022-03-20,21:00:00,55,20,35,FMN GV 16 Berchem TOT
54,Posthofbrug 5366,2022-03-20,22:00:00,47,19,28,FMN GV 16 Berchem TOT
54,Posthofbrug 5366,2022-03-20,23:00:00,20,6,14,FMN GV 16 Berchem TOT
54,Posthofbrug 5366,2022-03-21,00:00:00,10,2,8,FMN GV 16 Berchem TOT
54,Posthofbrug 5366,2022-03-21,01:00:00,5,1,4,FMN GV 16 Berchem TOT
54,Posthofbrug 5366,2022-03-21,02:00:00,3,1,2,FMN GV 16 Berchem TOT
54,Posthofbrug 5366,2022-03-21,03:00:00,3,1,2,FMN GV 16 Berchem TOT
54,Posthofbrug 5366,2022-03-21,04:00:00,10,10,0,FMN GV 16 Berchem TOT
54,Posthofbrug 5366,2022-03-21,05:00:00,43,34,9,FMN GV 16 Berchem TOT
54,Posthofbrug 5366,2022-03-21,06:00:00,102,79,23,FMN GV 16 Berchem TOT
54,Posthofbrug 5366,2022-03-21,07:00:00,400,298,102,FMN GV 16 Berchem TOT
54,Posthofbrug 5366,2022-03-21,08:00:00,703,540,163,FMN GV 16 Berchem TOT
54,Posthofbrug 5366,2022-03-21,09:00:00,220,172,48,FMN GV 16 Berchem TOT
54,Posthofbrug 5366,2022-03-21,10:00:00,0,0,0,FMN GV 16 Berchem TOT
54,Posthofbrug 5366,2022-03-21,11:00:00,0,0,0,FMN GV 16 Berchem TOT
54,Posthofbrug 5366,2022-03-21,12:00:00,0,0,0,FMN GV 16 Berchem TOT
54,Posthofbrug 5366,2022-03-21,13:00:00,0,0,0,FMN GV 16 Berchem TOT
54,Posthofbrug 5366,2022-03-21,14:00:00,0,0,0,FMN GV 16 Berchem TOT
54,Posthofbrug 5366,2022-03-21,15:00:00,0,0,0,FMN GV 16 Berchem TOT
54,Posthofbrug 5366,2022-03-21,16:00:00,0,0,0,FMN GV 16 Berchem TOT
54,Posthofbrug 5366,2022-03-21,17:00:00,0,0,0,FMN GV 16 Berchem TOT
54,Posthofbrug 5366,2022-03-21,18:00:00,342,115,227,FMN GV 16 Berchem TOT
54,Posthofbrug 5366,2022-03-21,19:00:00,191,88,103,FMN GV 16 Berchem TOT
54,Posthofbrug 5366,2022-03-21,20:00:00,90,39,51,FMN GV 16 Berchem TOT
54,Posthofbrug 5366,2022-03-21,21:00:00,90,30,60,FMN GV 16 Berchem TOT
54,Posthofbrug 5366,2022-03-21,22:00:00,79,35,44,FMN GV 16 Berchem TOT
54,Posthofbrug 5366,2022-03-21,23:00:00,41,8,33,FMN GV 16 Berchem TOT
54,Posthofbrug 5366,2022-03-22,00:00:00,17,1,16,FMN GV 16 Berchem TOT
54,Posthofbrug 5366,2022-03-22,01:00:00,11,1,10,FMN GV 16 Berchem TOT
54,Posthofbrug 5366,2022-03-22,02:00:00,8,1,7,FMN GV 16 Berchem TOT
54,Posthofbrug 5366,2022-03-22,03:00:00,0,0,0,FMN GV 16 Berchem TOT
54,Posthofbrug 5366,2022-03-22,04:00:00,11,10,1,FMN GV 16 Berchem TOT
54,Posthofbrug 5366,2022-03-22,05:00:00,38,29,9,FMN GV 16 Berchem TOT
54,Posthofbrug 5366,2022-03-22,06:00:00,126,104,22,FMN GV 16 Berchem TOT
54,Posthofbrug 5366,2022-03-22,07:00:00,472,350,122,FMN GV 16 Berchem TOT
54,Posthofbrug 5366,2022-03-22,08:00:00,803,603,200,FMN GV 16 Berchem TOT
54,Posthofbrug 5366,2022-03-22,09:00:00,277,203,74,FMN GV 16 Berchem TOT
54,Posthofbrug 5366,2022-03-22,10:00:00,141,103,38,FMN GV 16 Berchem TOT
54,Posthofbrug 5366,2022-03-22,11:00:00,148,78,70,FMN GV 16 Berchem TOT
54,Posthofbrug 5366,2022-03-22,12:00:00,180,94,86,FMN GV 16 Berchem TOT
54,Posthofbrug 5366,2022-03-22,13:00:00,201,104,97,FMN GV 16 Berchem TOT
54,Posthofbrug 5366,2022-03-22,14:00:00,1,0,1,FMN GV 16 Berchem TOT
54,Posthofbrug 5366,2022-03-22,15:00:00,0,0,0,FMN GV 16 Berchem TOT
54,Posthofbrug 5366,2022-03-22,16:00:00,0,0,0,FMN GV 16 Berchem TOT
54,Posthofbrug 5366,2022-03-22,17:00:00,0,0,0,FMN GV 16 Berchem TOT
54,Posthofbrug 5366,2022-03-22,18:00:00,385,136,249,FMN GV 16 Berchem TOT
54,Posthofbrug 5366,2022-03-22,19:00:00,204,96,108,FMN GV 16 Berchem TOT
54,Posthofbrug 5366,2022-03-22,20:00:00,121,60,61,FMN GV 16 Berchem TOT
54,Posthofbrug 5366,2022-03-22,21:00:00,90,34,56,FMN GV 16 Berchem TOT
54,Posthofbrug 5366,2022-03-22,22:00:00,86,33,53,FMN GV 16 Berchem TOT
54,Posthofbrug 5366,2022-03-22,23:00:00,54,18,36,FMN GV 16 Berchem TOT
54,Posthofbrug 5366,2022-03-23,00:00:00,21,5,16,FMN GV 16 Berchem TOT
54,Posthofbrug 5366,2022-03-23,01:00:00,12,3,9,FMN GV 16 Berchem TOT
54,Posthofbrug 5366,2022-03-23,02:00:00,2,0,2,FMN GV 16 Berchem TOT
54,Posthofbrug 5366,2022-03-23,03:00:00,1,1,0,FMN GV 16 Berchem TOT
54,Posthofbrug 5366,2022-03-23,04:00:00,11,10,1,FMN GV 16 Berchem TOT
54,Posthofbrug 5366,2022-03-23,05:00:00,46,38,8,FMN GV 16 Berchem TOT
54,Posthofbrug 5366,2022-03-23,06:00:00,97,76,21,FMN GV 16 Berchem TOT
54,Posthofbrug 5366,2022-03-23,07:00:00,394,301,93,FMN GV 16 Berchem TOT
54,Posthofbrug 5366,2022-03-23,08:00:00,607,436,171,FMN GV 16 Berchem TOT
54,Posthofbrug 5366,2022-03-23,09:00:00,256,184,72,FMN GV 16 Berchem TOT
54,Posthofbrug 5366,2022-03-23,10:00:00,126,84,42,FMN GV 16 Berchem TOT
54,Posthofbrug 5366,2022-03-23,11:00:00,127,69,58,FMN GV 16 Berchem TOT
54,Posthofbrug 5366,2022-03-23,12:00:00,304,127,177,FMN GV 16 Berchem TOT
54,Posthofbrug 5366,2022-03-23,13:00:00,232,111,121,FMN GV 16 Berchem TOT
54,Posthofbrug 5366,2022-03-23,14:00:00,221,102,119,FMN GV 16 Berchem TOT
54,Posthofbrug 5366,2022-03-23,15:00:00,249,110,139,FMN GV 16 Berchem TOT
54,Posthofbrug 5366,2022-03-23,16:00:00,417,159,258,FMN GV 16 Berchem TOT
54,Posthofbrug 5366,2022-03-23,17:00:00,496,191,305,FMN GV 16 Berchem TOT
54,Posthofbrug 5366,2022-03-23,18:00:00,366,148,218,FMN GV 16 Berchem TOT
54,Posthofbrug 5366,2022-03-23,19:00:00,201,82,119,FMN GV 16 Berchem TOT
54,Posthofbrug 5366,2022-03-23,20:00:00,110,48,62,FMN GV 16 Berchem TOT
54,Posthofbrug 5366,2022-03-23,21:00:00,104,46,58,FMN GV 16 Berchem TOT
54,Posthofbrug 5366,2022-03-23,22:00:00,97,31,66,FMN GV 16 Berchem TOT
54,Posthofbrug 5366,2022-03-23,23:00:00,70,21,49,FMN GV 16 Berchem TOT
54,Posthofbrug 5366,2022-03-24,00:00:00,24,7,17,FMN GV 16 Berchem TOT
54,Posthofbrug 5366,2022-03-24,01:00:00,24,7,17,FMN GV 16 Berchem TOT
54,Posthofbrug 5366,2022-03-24,02:00:00,5,0,5,FMN GV 16 Berchem TOT
54,Posthofbrug 5366,2022-03-24,03:00:00,4,1,3,FMN GV 16 Berchem TOT
54,Posthofbrug 5366,2022-03-24,04:00:00,23,13,10,FMN GV 16 Berchem TOT
54,Posthofbrug 5366,2022-03-24,05:00:00,45,33,12,FMN GV 16 Berchem TOT
54,Posthofbrug 5366,2022-03-24,06:00:00,114,94,20,FMN GV 16 Berchem TOT
54,Posthofbrug 5366,2022-03-24,07:00:00,442,331,111,FMN GV 16 Berchem TOT
54,Posthofbrug 5366,2022-03-24,08:00:00,756,556,200,FMN GV 16 Berchem TOT
54,Posthofbrug 5366,2022-03-24,09:00:00,293,224,69,FMN GV 16 Berchem TOT
54,Posthofbrug 5366,2022-03-24,10:00:00,157,113,44,FMN GV 16 Berchem TOT
54,Posthofbrug 5366,2022-03-24,11:00:00,140,91,49,FMN GV 16 Berchem TOT
54,Posthofbrug 5366,2022-03-24,12:00:00,213,112,101,FMN GV 16 Berchem TOT
54,Posthofbrug 5366,2022-03-24,13:00:00,190,102,88,FMN GV 16 Berchem TOT
54,Posthofbrug 5366,2022-03-24,14:00:00,191,71,120,FMN GV 16 Berchem TOT
54,Posthofbrug 5366,2022-03-24,15:00:00,295,102,193,FMN GV 16 Berchem TOT
54,Posthofbrug 5366,2022-03-24,16:00:00,532,165,367,FMN GV 16 Berchem TOT
54,Posthofbrug 5366,2022-03-24,17:00:00,586,217,369,FMN GV 16 Berchem TOT
54,Posthofbrug 5366,2022-03-24,18:00:00,4,1,3,FMN GV 16 Berchem TOT
54,Posthofbrug 5366,2022-03-24,19:00:00,0,0,0,FMN GV 16 Berchem TOT
54,Posthofbrug 5366,2022-03-24,20:00:00,126,48,78,FMN GV 16 Berchem TOT
54,Posthofbrug 5366,2022-03-24,21:00:00,111,45,66,FMN GV 16 Berchem TOT
54,Posthofbrug 5366,2022-03-24,22:00:00,121,47,74,FMN GV 16 Berchem TOT
54,Posthofbrug 5366,2022-03-24,23:00:00,71,24,47,FMN GV 16 Berchem TOT
54,Posthofbrug 5366,2022-03-25,00:00:00,45,7,38,FMN GV 16 Berchem TOT
54,Posthofbrug 5366,2022-03-25,01:00:00,21,5,16,FMN GV 16 Berchem TOT
54,Posthofbrug 5366,2022-03-25,02:00:00,19,0,19,FMN GV 16 Berchem TOT
54,Posthofbrug 5366,2022-03-25,03:00:00,6,4,2,FMN GV 16 Berchem TOT
54,Posthofbrug 5366,2022-03-25,04:00:00,18,13,5,FMN GV 16 Berchem TOT
54,Posthofbrug 5366,2022-03-25,05:00:00,31,21,10,FMN GV 16 Berchem TOT
54,Posthofbrug 5366,2022-03-25,06:00:00,94,72,22,FMN GV 16 Berchem TOT
54,Posthofbrug 5366,2022-03-25,07:00:00,342,248,94,FMN GV 16 Berchem TOT
54,Posthofbrug 5366,2022-03-25,08:00:00,625,462,163,FMN GV 16 Berchem TOT
54,Posthofbrug 5366,2022-03-25,09:00:00,236,162,74,FMN GV 16 Berchem TOT
54,Posthofbrug 5366,2022-03-25,10:00:00,138,85,53,FMN GV 16 Berchem TOT
54,Posthofbrug 5366,2022-03-25,11:00:00,165,107,58,FMN GV 16 Berchem TOT
54,Posthofbrug 5366,2022-03-25,12:00:00,233,137,96,FMN GV 16 Berchem TOT
54,Posthofbrug 5366,2022-03-25,13:00:00,190,82,108,FMN GV 16 Berchem TOT
54,Posthofbrug 5366,2022-03-25,14:00:00,215,103,112,FMN GV 16 Berchem TOT
54,Posthofbrug 5366,2022-03-25,15:00:00,282,92,190,FMN GV 16 Berchem TOT
54,Posthofbrug 5366,2022-03-25,16:00:00,479,165,314,FMN GV 16 Berchem TOT
54,Posthofbrug 5366,2022-03-25,17:00:00,431,157,274,FMN GV 16 Berchem TOT
54,Posthofbrug 5366,2022-03-25,18:00:00,353,160,193,FMN GV 16 Berchem TOT
54,Posthofbrug 5366,2022-03-25,19:00:00,224,107,117,FMN GV 16 Berchem TOT
54,Posthofbrug 5366,2022-03-25,20:00:00,106,52,54,FMN GV 16 Berchem TOT
54,Posthofbrug 5366,2022-03-25,21:00:00,77,33,44,FMN GV 16 Berchem TOT
54,Posthofbrug 5366,2022-03-25,22:00:00,108,30,78,FMN GV 16 Berchem TOT
54,Posthofbrug 5366,2022-03-25,23:00:00,98,14,84,FMN GV 16 Berchem TOT
54,Posthofbrug 5366,2022-03-26,00:00:00,71,25,46,FMN GV 16 Berchem TOT
54,Posthofbrug 5366,2022-03-26,01:00:00,59,15,44,FMN GV 16 Berchem TOT
54,Posthofbrug 5366,2022-03-26,02:00:00,27,2,25,FMN GV 16 Berchem TOT
54,Posthofbrug 5366,2022-03-26,03:00:00,20,5,15,FMN GV 16 Berchem TOT
54,Posthofbrug 5366,2022-03-26,04:00:00,29,10,19,FMN GV 16 Berchem TOT
54,Posthofbrug 5366,2022-03-26,05:00:00,11,7,4,FMN GV 16 Berchem TOT
54,Posthofbrug 5366,2022-03-26,06:00:00,20,13,7,FMN GV 16 Berchem TOT
54,Posthofbrug 5366,2022-03-26,07:00:00,49,24,25,FMN GV 16 Berchem TOT
54,Posthofbrug 5366,2022-03-26,08:00:00,81,40,41,FMN GV 16 Berchem TOT
54,Posthofbrug 5366,2022-03-26,09:00:00,156,101,55,FMN GV 16 Berchem TOT
54,Posthofbrug 5366,2022-03-26,10:00:00,185,113,72,FMN GV 16 Berchem TOT
54,Posthofbrug 5366,2022-03-26,11:00:00,190,119,71,FMN GV 16 Berchem TOT
54,Posthofbrug 5366,2022-03-26,12:00:00,194,123,71,FMN GV 16 Berchem TOT
54,Posthofbrug 5366,2022-03-26,13:00:00,240,120,120,FMN GV 16 Berchem TOT
54,Posthofbrug 5366,2022-03-26,14:00:00,292,150,142,FMN GV 16 Berchem TOT
54,Posthofbrug 5366,2022-03-26,15:00:00,224,109,115,FMN GV 16 Berchem TOT
54,Posthofbrug 5366,2022-03-26,16:00:00,194,92,102,FMN GV 16 Berchem TOT
54,Posthofbrug 5366,2022-03-26,17:00:00,242,127,115,FMN GV 16 Berchem TOT
54,Posthofbrug 5366,2022-03-26,18:00:00,209,126,83,FMN GV 16 Berchem TOT
54,Posthofbrug 5366,2022-03-26,19:00:00,150,93,57,FMN GV 16 Berchem TOT
54,Posthofbrug 5366,2022-03-26,20:00:00,92,59,33,FMN GV 16 Berchem TOT
54,Posthofbrug 5366,2022-03-26,21:00:00,61,25,36,FMN GV 16 Berchem TOT
54,Posthofbrug 5366,2022-03-26,22:00:00,80,29,51,FMN GV 16 Berchem TOT
54,Posthofbrug 5366,2022-03-26,23:00:00,107,26,81,FMN GV 16 Berchem TOT
54,Posthofbrug 5366,2022-03-27,00:00:00,62,15,47,FMN GV 16 Berchem TOT
54,Posthofbrug 5366,2022-03-27,01:00:00,57,19,38,FMN GV 16 Berchem TOT
54,Posthofbrug 5366,2022-03-27,02:00:00,0,0,0,FMN GV 16 Berchem TOT
54,Posthofbrug 5366,2022-03-27,03:00:00,32,7,25,FMN GV 16 Berchem TOT
54,Posthofbrug 5366,2022-03-27,04:00:00,22,6,16,FMN GV 16 Berchem TOT
54,Posthofbrug 5366,2022-03-27,05:00:00,28,4,24,FMN GV 16 Berchem TOT
54,Posthofbrug 5366,2022-03-27,06:00:00,23,14,9,FMN GV 16 Berchem TOT
54,Posthofbrug 5366,2022-03-27,07:00:00,36,13,23,FMN GV 16 Berchem TOT
54,Posthofbrug 5366,2022-03-27,08:00:00,47,25,22,FMN GV 16 Berchem TOT
54,Posthofbrug 5366,2022-03-27,09:00:00,82,50,32,FMN GV 16 Berchem TOT
54,Posthofbrug 5366,2022-03-27,10:00:00,121,75,46,FMN GV 16 Berchem TOT
54,Posthofbrug 5366,2022-03-27,11:00:00,147,74,73,FMN GV 16 Berchem TOT
54,Posthofbrug 5366,2022-03-27,12:00:00,135,80,55,FMN GV 16 Berchem TOT
54,Posthofbrug 5366,2022-03-27,13:00:00,153,76,77,FMN GV 16 Berchem TOT
54,Posthofbrug 5366,2022-03-27,14:00:00,174,98,76,FMN GV 16 Berchem TOT
54,Posthofbrug 5366,2022-03-27,15:00:00,112,62,50,FMN GV 16 Berchem TOT
54,Posthofbrug 5366,2022-03-27,16:00:00,176,84,92,FMN GV 16 Berchem TOT
54,Posthofbrug 5366,2022-03-27,17:00:00,182,79,103,FMN GV 16 Berchem TOT
54,Posthofbrug 5366,2022-03-27,18:00:00,127,61,66,FMN GV 16 Berchem TOT
54,Posthofbrug 5366,2022-03-27,19:00:00,126,61,65,FMN GV 16 Berchem TOT
54,Posthofbrug 5366,2022-03-27,20:00:00,82,46,36,FMN GV 16 Berchem TOT
54,Posthofbrug 5366,2022-03-27,21:00:00,63,19,44,FMN GV 16 Berchem TOT
54,Posthofbrug 5366,2022-03-27,22:00:00,51,21,30,FMN GV 16 Berchem TOT
54,Posthofbrug 5366,2022-03-27,23:00:00,24,9,15,FMN GV 16 Berchem TOT
54,Posthofbrug 5366,2022-03-28,00:00:00,12,2,10,FMN GV 16 Berchem TOT
54,Posthofbrug 5366,2022-03-28,01:00:00,8,3,5,FMN GV 16 Berchem TOT
54,Posthofbrug 5366,2022-03-28,02:00:00,2,0,2,FMN GV 16 Berchem TOT
54,Posthofbrug 5366,2022-03-28,03:00:00,5,1,4,FMN GV 16 Berchem TOT
54,Posthofbrug 5366,2022-03-28,04:00:00,16,12,4,FMN GV 16 Berchem TOT
54,Posthofbrug 5366,2022-03-28,05:00:00,29,23,6,FMN GV 16 Berchem TOT
54,Posthofbrug 5366,2022-03-28,06:00:00,107,85,22,FMN GV 16 Berchem TOT
54,Posthofbrug 5366,2022-03-28,07:00:00,397,300,97,FMN GV 16 Berchem TOT
54,Posthofbrug 5366,2022-03-28,08:00:00,683,511,172,FMN GV 16 Berchem TOT
54,Posthofbrug 5366,2022-03-28,09:00:00,231,178,53,FMN GV 16 Berchem TOT
54,Posthofbrug 5366,2022-03-28,10:00:00,134,90,44,FMN GV 16 Berchem TOT
54,Posthofbrug 5366,2022-03-28,11:00:00,119,78,41,FMN GV 16 Berchem TOT
54,Posthofbrug 5366,2022-03-28,12:00:00,180,94,86,FMN GV 16 Berchem TOT
54,Posthofbrug 5366,2022-03-28,13:00:00,156,88,68,FMN GV 16 Berchem TOT
54,Posthofbrug 5366,2022-03-28,14:00:00,0,0,0,FMN GV 16 Berchem TOT
54,Posthofbrug 5366,2022-03-28,15:00:00,0,0,0,FMN GV 16 Berchem TOT
54,Posthofbrug 5366,2022-03-28,16:00:00,0,0,0,FMN GV 16 Berchem TOT
54,Posthofbrug 5366,2022-03-28,17:00:00,0,0,0,FMN GV 16 Berchem TOT
54,Posthofbrug 5366,2022-03-28,18:00:00,0,0,0,FMN GV 16 Berchem TOT
54,Posthofbrug 5366,2022-03-28,19:00:00,0,0,0,FMN GV 16 Berchem TOT
54,Posthofbrug 5366,2022-03-28,20:00:00,0,0,0,FMN GV 16 Berchem TOT
54,Posthofbrug 5366,2022-03-28,21:00:00,0,0,0,FMN GV 16 Berchem TOT
54,Posthofbrug 5366,2022-03-28,22:00:00,89,32,57,FMN GV 16 Berchem TOT
54,Posthofbrug 5366,2022-03-28,23:00:00,33,13,20,FMN GV 16 Berchem TOT
54,Posthofbrug 5366,2022-03-29,00:00:00,10,3,7,FMN GV 16 Berchem TOT
54,Posthofbrug 5366,2022-03-29,01:00:00,15,4,11,FMN GV 16 Berchem TOT
54,Posthofbrug 5366,2022-03-29,02:00:00,6,0,6,FMN GV 16 Berchem TOT
54,Posthofbrug 5366,2022-03-29,03:00:00,1,0,1,FMN GV 16 Berchem TOT
54,Posthofbrug 5366,2022-03-29,04:00:00,10,6,4,FMN GV 16 Berchem TOT
54,Posthofbrug 5366,2022-03-29,05:00:00,30,24,6,FMN GV 16 Berchem TOT
54,Posthofbrug 5366,2022-03-29,06:00:00,116,96,20,FMN GV 16 Berchem TOT
54,Posthofbrug 5366,2022-03-29,07:00:00,420,318,102,FMN GV 16 Berchem TOT
54,Posthofbrug 5366,2022-03-29,08:00:00,780,582,198,FMN GV 16 Berchem TOT
54,Posthofbrug 5366,2022-03-29,09:00:00,281,220,61,FMN GV 16 Berchem TOT
54,Posthofbrug 5366,2022-03-29,10:00:00,117,82,35,FMN GV 16 Berchem TOT
54,Posthofbrug 5366,2022-03-29,11:00:00,104,54,50,FMN GV 16 Berchem TOT
54,Posthofbrug 5366,2022-03-29,12:00:00,146,66,80,FMN GV 16 Berchem TOT
54,Posthofbrug 5366,2022-03-29,13:00:00,173,92,81,FMN GV 16 Berchem TOT
54,Posthofbrug 5366,2022-03-29,14:00:00,144,64,80,FMN GV 16 Berchem TOT
54,Posthofbrug 5366,2022-03-29,15:00:00,232,74,158,FMN GV 16 Berchem TOT
54,Posthofbrug 5366,2022-03-29,16:00:00,424,127,297,FMN GV 16 Berchem TOT
54,Posthofbrug 5366,2022-03-29,17:00:00,572,153,419,FMN GV 16 Berchem TOT
54,Posthofbrug 5366,2022-03-29,18:00:00,366,111,255,FMN GV 16 Berchem TOT
54,Posthofbrug 5366,2022-03-29,19:00:00,201,87,114,FMN GV 16 Berchem TOT
54,Posthofbrug 5366,2022-03-29,20:00:00,112,47,65,FMN GV 16 Berchem TOT
54,Posthofbrug 5366,2022-03-29,21:00:00,101,33,68,FMN GV 16 Berchem TOT
54,Posthofbrug 5366,2022-03-29,22:00:00,87,33,54,FMN GV 16 Berchem TOT
54,Posthofbrug 5366,2022-03-29,23:00:00,48,18,30,FMN GV 16 Berchem TOT
54,Posthofbrug 5366,2022-03-30,00:00:00,27,12,15,FMN GV 16 Berchem TOT
54,Posthofbrug 5366,2022-03-30,01:00:00,8,5,3,FMN GV 16 Berchem TOT
54,Posthofbrug 5366,2022-03-30,02:00:00,10,4,6,FMN GV 16 Berchem TOT
54,Posthofbrug 5366,2022-03-30,03:00:00,2,0,2,FMN GV 16 Berchem TOT
54,Posthofbrug 5366,2022-03-30,04:00:00,13,10,3,FMN GV 16 Berchem TOT
54,Posthofbrug 5366,2022-03-30,05:00:00,32,25,7,FMN GV 16 Berchem TOT
54,Posthofbrug 5366,2022-03-30,06:00:00,99,83,16,FMN GV 16 Berchem TOT
54,Posthofbrug 5366,2022-03-30,07:00:00,363,281,82,FMN GV 16 Berchem TOT
54,Posthofbrug 5366,2022-03-30,08:00:00,608,442,166,FMN GV 16 Berchem TOT
54,Posthofbrug 5366,2022-03-30,09:00:00,231,177,54,FMN GV 16 Berchem TOT
54,Posthofbrug 5366,2022-03-30,10:00:00,117,72,45,FMN GV 16 Berchem TOT
54,Posthofbrug 5366,2022-03-30,11:00:00,135,84,51,FMN GV 16 Berchem TOT
54,Posthofbrug 5366,2022-03-30,12:00:00,299,142,157,FMN GV 16 Berchem TOT
54,Posthofbrug 5366,2022-03-30,13:00:00,212,98,114,FMN GV 16 Berchem TOT
54,Posthofbrug 5366,2022-03-30,14:00:00,155,73,82,FMN GV 16 Berchem TOT
54,Posthofbrug 5366,2022-03-30,15:00:00,205,77,128,FMN GV 16 Berchem TOT
54,Posthofbrug 5366,2022-03-30,16:00:00,335,112,223,FMN GV 16 Berchem TOT
54,Posthofbrug 5366,2022-03-30,17:00:00,469,151,318,FMN GV 16 Berchem TOT
54,Posthofbrug 5366,2022-03-30,18:00:00,379,151,228,FMN GV 16 Berchem TOT
54,Posthofbrug 5366,2022-03-30,19:00:00,165,66,99,FMN GV 16 Berchem TOT
54,Posthofbrug 5366,2022-03-30,20:00:00,111,56,55,FMN GV 16 Berchem TOT
54,Posthofbrug 5366,2022-03-30,21:00:00,105,51,54,FMN GV 16 Berchem TOT
54,Posthofbrug 5366,2022-03-30,22:00:00,106,39,67,FMN GV 16 Berchem TOT
54,Posthofbrug 5366,2022-03-30,23:00:00,64,28,36,FMN GV 16 Berchem TOT
54,Posthofbrug 5366,2022-03-31,00:00:00,43,12,31,FMN GV 16 Berchem TOT
54,Posthofbrug 5366,2022-03-31,01:00:00,17,6,11,FMN GV 16 Berchem TOT
54,Posthofbrug 5366,2022-03-31,02:00:00,13,0,13,FMN GV 16 Berchem TOT
54,Posthofbrug 5366,2022-03-31,03:00:00,8,2,6,FMN GV 16 Berchem TOT
54,Posthofbrug 5366,2022-03-31,04:00:00,15,3,12,FMN GV 16 Berchem TOT
54,Posthofbrug 5366,2022-03-31,05:00:00,28,22,6,FMN GV 16 Berchem TOT
54,Posthofbrug 5366,2022-03-31,06:00:00,90,78,12,FMN GV 16 Berchem TOT
54,Posthofbrug 5366,2022-03-31,07:00:00,330,268,62,FMN GV 16 Berchem TOT
54,Posthofbrug 5366,2022-03-31,08:00:00,616,463,153,FMN GV 16 Berchem TOT
54,Posthofbrug 5366,2022-03-31,09:00:00,209,172,37,FMN GV 16 Berchem TOT
54,Posthofbrug 5366,2022-03-31,10:00:00,102,62,40,FMN GV 16 Berchem TOT
54,Posthofbrug 5366,2022-03-31,11:00:00,85,53,32,FMN GV 16 Berchem TOT
54,Posthofbrug 5366,2022-03-31,12:00:00,131,69,62,FMN GV 16 Berchem TOT
54,Posthofbrug 5366,2022-03-31,13:00:00,129,74,55,FMN GV 16 Berchem TOT
54,Posthofbrug 5366,2022-03-31,14:00:00,107,37,70,FMN GV 16 Berchem TOT
54,Posthofbrug 5366,2022-03-31,15:00:00,188,63,125,FMN GV 16 Berchem TOT
54,Posthofbrug 5366,2022-03-31,16:00:00,339,104,235,FMN GV 16 Berchem TOT
54,Posthofbrug 5366,2022-03-31,17:00:00,463,136,327,FMN GV 16 Berchem TOT
54,Posthofbrug 5366,2022-03-31,18:00:00,299,96,203,FMN GV 16 Berchem TOT
54,Posthofbrug 5366,2022-03-31,19:00:00,171,73,98,FMN GV 16 Berchem TOT
54,Posthofbrug 5366,2022-03-31,20:00:00,115,43,72,FMN GV 16 Berchem TOT
54,Posthofbrug 5366,2022-03-31,21:00:00,96,50,46,FMN GV 16 Berchem TOT
54,Posthofbrug 5366,2022-03-31,22:00:00,91,31,60,FMN GV 16 Berchem TOT
54,Posthofbrug 5366,2022-03-31,23:00:00,57,15,42,FMN GV 16 Berchem TOT
54,Posthofbrug 5366,2022-04-01,00:00:00,24,5,19,FMN GV 16 Berchem TOT
54,Posthofbrug 5366,2022-04-01,01:00:00,16,4,12,FMN GV 16 Berchem TOT
54,Posthofbrug 5366,2022-04-01,02:00:00,3,0,3,FMN GV 16 Berchem TOT
54,Posthofbrug 5366,2022-04-01,03:00:00,10,1,9,FMN GV 16 Berchem TOT
54,Posthofbrug 5366,2022-04-01,04:00:00,4,2,2,FMN GV 16 Berchem TOT
54,Posthofbrug 5366,2022-04-01,05:00:00,25,16,9,FMN GV 16 Berchem TOT
54,Posthofbrug 5366,2022-04-01,06:00:00,63,50,13,FMN GV 16 Berchem TOT
54,Posthofbrug 5366,2022-04-01,07:00:00,207,152,55,FMN GV 16 Berchem TOT
54,Posthofbrug 5366,2022-04-01,08:00:00,407,297,110,FMN GV 16 Berchem TOT
54,Posthofbrug 5366,2022-04-01,09:00:00,160,123,37,FMN GV 16 Berchem TOT
54,Posthofbrug 5366,2022-04-01,10:00:00,80,55,25,FMN GV 16 Berchem TOT
54,Posthofbrug 5366,2022-04-01,11:00:00,79,40,39,FMN GV 16 Berchem TOT
54,Posthofbrug 5366,2022-04-01,12:00:00,116,54,62,FMN GV 16 Berchem TOT
54,Posthofbrug 5366,2022-04-01,13:00:00,127,66,61,FMN GV 16 Berchem TOT
54,Posthofbrug 5366,2022-04-01,14:00:00,113,51,62,FMN GV 16 Berchem TOT
54,Posthofbrug 5366,2022-04-01,15:00:00,154,58,96,FMN GV 16 Berchem TOT
54,Posthofbrug 5366,2022-04-01,16:00:00,219,68,151,FMN GV 16 Berchem TOT
54,Posthofbrug 5366,2022-04-01,17:00:00,265,88,177,FMN GV 16 Berchem TOT
54,Posthofbrug 5366,2022-04-01,18:00:00,219,94,125,FMN GV 16 Berchem TOT
54,Posthofbrug 5366,2022-04-01,19:00:00,144,76,68,FMN GV 16 Berchem TOT
54,Posthofbrug 5366,2022-04-01,20:00:00,71,41,30,FMN GV 16 Berchem TOT
54,Posthofbrug 5366,2022-04-01,21:00:00,56,29,27,FMN GV 16 Berchem TOT
54,Posthofbrug 5366,2022-04-01,22:00:00,75,36,39,FMN GV 16 Berchem TOT
54,Posthofbrug 5366,2022-04-01,23:00:00,85,21,64,FMN GV 16 Berchem TOT
54,Posthofbrug 5366,2022-04-02,00:00:00,43,9,34,FMN GV 16 Berchem TOT
54,Posthofbrug 5366,2022-04-02,01:00:00,23,7,16,FMN GV 16 Berchem TOT
54,Posthofbrug 5366,2022-04-02,02:00:00,26,5,21,FMN GV 16 Berchem TOT
54,Posthofbrug 5366,2022-04-02,03:00:00,21,3,18,FMN GV 16 Berchem TOT
54,Posthofbrug 5366,2022-04-02,04:00:00,33,14,19,FMN GV 16 Berchem TOT
54,Posthofbrug 5366,2022-04-02,05:00:00,20,10,10,FMN GV 16 Berchem TOT
54,Posthofbrug 5366,2022-04-02,06:00:00,39,32,7,FMN GV 16 Berchem TOT
54,Posthofbrug 5366,2022-04-02,07:00:00,23,18,5,FMN GV 16 Berchem TOT
54,Posthofbrug 5366,2022-04-02,08:00:00,58,40,18,FMN GV 16 Berchem TOT
54,Posthofbrug 5366,2022-04-02,09:00:00,103,79,24,FMN GV 16 Berchem TOT
54,Posthofbrug 5366,2022-04-02,10:00:00,96,55,41,FMN GV 16 Berchem TOT
54,Posthofbrug 5366,2022-04-02,11:00:00,99,57,42,FMN GV 16 Berchem TOT
54,Posthofbrug 5366,2022-04-02,12:00:00,108,64,44,FMN GV 16 Berchem TOT
54,Posthofbrug 5366,2022-04-02,13:00:00,128,77,51,FMN GV 16 Berchem TOT
54,Posthofbrug 5366,2022-04-02,14:00:00,121,72,49,FMN GV 16 Berchem TOT
54,Posthofbrug 5366,2022-04-02,15:00:00,111,63,48,FMN GV 16 Berchem TOT
54,Posthofbrug 5366,2022-04-02,16:00:00,121,43,78,FMN GV 16 Berchem TOT
54,Posthofbrug 5366,2022-04-02,17:00:00,127,64,63,FMN GV 16 Berchem TOT
54,Posthofbrug 5366,2022-04-02,18:00:00,136,68,68,FMN GV 16 Berchem TOT
54,Posthofbrug 5366,2022-04-02,19:00:00,102,43,59,FMN GV 16 Berchem TOT
54,Posthofbrug 5366,2022-04-02,20:00:00,64,34,30,FMN GV 16 Berchem TOT
54,Posthofbrug 5366,2022-04-02,21:00:00,45,26,19,FMN GV 16 Berchem TOT
54,Posthofbrug 5366,2022-04-02,22:00:00,84,43,41,FMN GV 16 Berchem TOT
54,Posthofbrug 5366,2022-04-02,23:00:00,73,25,48,FMN GV 16 Berchem TOT
54,Posthofbrug 5366,2022-04-03,00:00:00,34,7,27,FMN GV 16 Berchem TOT
54,Posthofbrug 5366,2022-04-03,01:00:00,24,10,14,FMN GV 16 Berchem TOT
54,Posthofbrug 5366,2022-04-03,02:00:00,26,6,20,FMN GV 16 Berchem TOT
54,Posthofbrug 5366,2022-04-03,03:00:00,19,4,15,FMN GV 16 Berchem TOT
54,Posthofbrug 5366,2022-04-03,04:00:00,13,4,9,FMN GV 16 Berchem TOT
54,Posthofbrug 5366,2022-04-03,05:00:00,17,10,7,FMN GV 16 Berchem TOT
54,Posthofbrug 5366,2022-04-03,06:00:00,11,5,6,FMN GV 16 Berchem TOT
54,Posthofbrug 5366,2022-04-03,07:00:00,18,16,2,FMN GV 16 Berchem TOT
54,Posthofbrug 5366,2022-04-03,08:00:00,78,61,17,FMN GV 16 Berchem TOT
54,Posthofbrug 5366,2022-04-03,09:00:00,115,85,30,FMN GV 16 Berchem TOT
54,Posthofbrug 5366,2022-04-03,10:00:00,128,59,69,FMN GV 16 Berchem TOT
54,Posthofbrug 5366,2022-04-03,11:00:00,140,71,69,FMN GV 16 Berchem TOT
54,Posthofbrug 5366,2022-04-03,12:00:00,163,104,59,FMN GV 16 Berchem TOT
54,Posthofbrug 5366,2022-04-03,13:00:00,157,102,55,FMN GV 16 Berchem TOT
54,Posthofbrug 5366,2022-04-03,14:00:00,124,73,51,FMN GV 16 Berchem TOT
54,Posthofbrug 5366,2022-04-03,15:00:00,90,37,53,FMN GV 16 Berchem TOT
54,Posthofbrug 5366,2022-04-03,16:00:00,109,50,59,FMN GV 16 Berchem TOT
54,Posthofbrug 5366,2022-04-03,17:00:00,134,67,67,FMN GV 16 Berchem TOT
54,Posthofbrug 5366,2022-04-03,18:00:00,110,50,60,FMN GV 16 Berchem TOT
54,Posthofbrug 5366,2022-04-03,19:00:00,82,32,50,FMN GV 16 Berchem TOT
54,Posthofbrug 5366,2022-04-03,20:00:00,70,29,41,FMN GV 16 Berchem TOT
54,Posthofbrug 5366,2022-04-03,21:00:00,54,29,25,FMN GV 16 Berchem TOT
54,Posthofbrug 5366,2022-04-03,22:00:00,41,20,21,FMN GV 16 Berchem TOT
54,Posthofbrug 5366,2022-04-03,23:00:00,25,6,19,FMN GV 16 Berchem TOT
54,Posthofbrug 5366,2022-04-04,00:00:00,11,5,6,FMN GV 16 Berchem TOT
54,Posthofbrug 5366,2022-04-04,01:00:00,2,0,2,FMN GV 16 Berchem TOT
54,Posthofbrug 5366,2022-04-04,02:00:00,3,0,3,FMN GV 16 Berchem TOT
54,Posthofbrug 5366,2022-04-04,03:00:00,2,0,2,FMN GV 16 Berchem TOT
54,Posthofbrug 5366,2022-04-04,04:00:00,11,7,4,FMN GV 16 Berchem TOT
54,Posthofbrug 5366,2022-04-04,05:00:00,29,20,9,FMN GV 16 Berchem TOT
54,Posthofbrug 5366,2022-04-04,06:00:00,77,63,14,FMN GV 16 Berchem TOT
54,Posthofbrug 5366,2022-04-04,07:00:00,234,177,57,FMN GV 16 Berchem TOT
54,Posthofbrug 5366,2022-04-04,08:00:00,361,266,95,FMN GV 16 Berchem TOT
54,Posthofbrug 5366,2022-04-04,09:00:00,166,123,43,FMN GV 16 Berchem TOT
54,Posthofbrug 5366,2022-04-04,10:00:00,61,40,21,FMN GV 16 Berchem TOT
54,Posthofbrug 5366,2022-04-04,11:00:00,73,43,30,FMN GV 16 Berchem TOT
54,Posthofbrug 5366,2022-04-04,12:00:00,72,38,34,FMN GV 16 Berchem TOT
54,Posthofbrug 5366,2022-04-04,13:00:00,57,28,29,FMN GV 16 Berchem TOT
54,Posthofbrug 5366,2022-04-04,14:00:00,58,28,30,FMN GV 16 Berchem TOT
54,Posthofbrug 5366,2022-04-04,15:00:00,86,26,60,FMN GV 16 Berchem TOT
54,Posthofbrug 5366,2022-04-04,16:00:00,173,66,107,FMN GV 16 Berchem TOT
54,Posthofbrug 5366,2022-04-04,17:00:00,301,107,194,FMN GV 16 Berchem TOT
54,Posthofbrug 5366,2022-04-04,18:00:00,199,65,134,FMN GV 16 Berchem TOT
54,Posthofbrug 5366,2022-04-04,19:00:00,94,20,74,FMN GV 16 Berchem TOT
54,Posthofbrug 5366,2022-04-04,20:00:00,47,22,25,FMN GV 16 Berchem TOT
54,Posthofbrug 5366,2022-04-04,21:00:00,37,17,20,FMN GV 16 Berchem TOT
54,Posthofbrug 5366,2022-04-04,22:00:00,42,21,21,FMN GV 16 Berchem TOT
54,Posthofbrug 5366,2022-04-04,23:00:00,17,3,14,FMN GV 16 Berchem TOT
54,Posthofbrug 5366,2022-04-05,00:00:00,10,3,7,FMN GV 16 Berchem TOT
54,Posthofbrug 5366,2022-04-05,01:00:00,6,1,5,FMN GV 16 Berchem TOT
54,Posthofbrug 5366,2022-04-05,02:00:00,1,1,0,FMN GV 16 Berchem TOT
54,Posthofbrug 5366,2022-04-05,03:00:00,1,0,1,FMN GV 16 Berchem TOT
54,Posthofbrug 5366,2022-04-05,04:00:00,9,5,4,FMN GV 16 Berchem TOT
54,Posthofbrug 5366,2022-04-05,05:00:00,27,20,7,FMN GV 16 Berchem TOT
54,Posthofbrug 5366,2022-04-05,06:00:00,72,61,11,FMN GV 16 Berchem TOT
54,Posthofbrug 5366,2022-04-05,07:00:00,233,173,60,FMN GV 16 Berchem TOT
54,Posthofbrug 5366,2022-04-05,08:00:00,368,260,108,FMN GV 16 Berchem TOT
54,Posthofbrug 5366,2022-04-05,09:00:00,181,130,51,FMN GV 16 Berchem TOT
54,Posthofbrug 5366,2022-04-05,10:00:00,72,52,20,FMN GV 16 Berchem TOT
54,Posthofbrug 5366,2022-04-05,11:00:00,68,36,32,FMN GV 16 Berchem TOT
54,Posthofbrug 5366,2022-04-05,12:00:00,74,33,41,FMN GV 16 Berchem TOT
54,Posthofbrug 5366,2022-04-05,13:00:00,77,46,31,FMN GV 16 Berchem TOT
54,Posthofbrug 5366,2022-04-05,14:00:00,76,36,40,FMN GV 16 Berchem TOT
54,Posthofbrug 5366,2022-04-05,15:00:00,107,40,67,FMN GV 16 Berchem TOT
54,Posthofbrug 5366,2022-04-05,16:00:00,258,102,156,FMN GV 16 Berchem TOT
54,Posthofbrug 5366,2022-04-05,17:00:00,319,97,222,FMN GV 16 Berchem TOT
54,Posthofbrug 5366,2022-04-05,18:00:00,227,82,145,FMN GV 16 Berchem TOT
54,Posthofbrug 5366,2022-04-05,19:00:00,128,63,65,FMN GV 16 Berchem TOT
54,Posthofbrug 5366,2022-04-05,20:00:00,67,21,46,FMN GV 16 Berchem TOT
54,Posthofbrug 5366,2022-04-05,21:00:00,39,19,20,FMN GV 16 Berchem TOT
54,Posthofbrug 5366,2022-04-05,22:00:00,82,30,52,FMN GV 16 Berchem TOT
54,Posthofbrug 5366,2022-04-05,23:00:00,35,5,30,FMN GV 16 Berchem TOT
54,Posthofbrug 5366,2022-04-06,00:00:00,28,5,23,FMN GV 16 Berchem TOT
54,Posthofbrug 5366,2022-04-06,01:00:00,13,2,11,FMN GV 16 Berchem TOT
54,Posthofbrug 5366,2022-04-06,02:00:00,5,3,2,FMN GV 16 Berchem TOT
54,Posthofbrug 5366,2022-04-06,03:00:00,4,0,4,FMN GV 16 Berchem TOT
54,Posthofbrug 5366,2022-04-06,04:00:00,10,6,4,FMN GV 16 Berchem TOT
54,Posthofbrug 5366,2022-04-06,05:00:00,23,17,6,FMN GV 16 Berchem TOT
54,Posthofbrug 5366,2022-04-06,06:00:00,76,58,18,FMN GV 16 Berchem TOT
54,Posthofbrug 5366,2022-04-06,07:00:00,209,155,54,FMN GV 16 Berchem TOT
54,Posthofbrug 5366,2022-04-06,08:00:00,294,205,89,FMN GV 16 Berchem TOT
54,Posthofbrug 5366,2022-04-06,09:00:00,164,120,44,FMN GV 16 Berchem TOT
54,Posthofbrug 5366,2022-04-06,10:00:00,68,44,24,FMN GV 16 Berchem TOT
54,Posthofbrug 5366,2022-04-06,11:00:00,77,39,38,FMN GV 16 Berchem TOT
54,Posthofbrug 5366,2022-04-06,12:00:00,99,53,46,FMN GV 16 Berchem TOT
54,Posthofbrug 5366,2022-04-06,13:00:00,97,50,47,FMN GV 16 Berchem TOT
54,Posthofbrug 5366,2022-04-06,14:00:00,72,35,37,FMN GV 16 Berchem TOT
54,Posthofbrug 5366,2022-04-06,15:00:00,100,37,63,FMN GV 16 Berchem TOT
54,Posthofbrug 5366,2022-04-06,16:00:00,204,78,126,FMN GV 16 Berchem TOT
54,Posthofbrug 5366,2022-04-06,17:00:00,298,89,209,FMN GV 16 Berchem TOT
54,Posthofbrug 5366,2022-04-06,18:00:00,211,80,131,FMN GV 16 Berchem TOT
54,Posthofbrug 5366,2022-04-06,19:00:00,97,41,56,FMN GV 16 Berchem TOT
54,Posthofbrug 5366,2022-04-06,20:00:00,61,37,24,FMN GV 16 Berchem TOT
54,Posthofbrug 5366,2022-04-06,21:00:00,42,25,17,FMN GV 16 Berchem TOT
54,Posthofbrug 5366,2022-04-06,22:00:00,55,21,34,FMN GV 16 Berchem TOT
54,Posthofbrug 5366,2022-04-06,23:00:00,32,7,25,FMN GV 16 Berchem TOT
54,Posthofbrug 5366,2022-04-07,00:00:00,28,8,20,FMN GV 16 Berchem TOT
54,Posthofbrug 5366,2022-04-07,01:00:00,14,3,11,FMN GV 16 Berchem TOT
54,Posthofbrug 5366,2022-04-07,02:00:00,10,4,6,FMN GV 16 Berchem TOT
54,Posthofbrug 5366,2022-04-07,03:00:00,0,0,0,FMN GV 16 Berchem TOT
54,Posthofbrug 5366,2022-04-07,04:00:00,0,0,0,FMN GV 16 Berchem TOT
54,Posthofbrug 5366,2022-04-07,05:00:00,0,0,0,FMN GV 16 Berchem TOT
54,Posthofbrug 5366,2022-04-07,06:00:00,0,0,0,FMN GV 16 Berchem TOT
54,Posthofbrug 5366,2022-04-07,07:00:00,0,0,0,FMN GV 16 Berchem TOT
54,Posthofbrug 5366,2022-04-07,08:00:00,0,0,0,FMN GV 16 Berchem TOT
54,Posthofbrug 5366,2022-04-07,09:00:00,0,0,0,FMN GV 16 Berchem TOT
54,Posthofbrug 5366,2022-04-07,10:00:00,0,0,0,FMN GV 16 Berchem TOT
54,Posthofbrug 5366,2022-04-07,11:00:00,0,0,0,FMN GV 16 Berchem TOT
54,Posthofbrug 5366,2022-04-07,12:00:00,0,0,0,FMN GV 16 Berchem TOT
54,Posthofbrug 5366,2022-04-07,13:00:00,0,0,0,FMN GV 16 Berchem TOT
54,Posthofbrug 5366,2022-04-07,14:00:00,0,0,0,FMN GV 16 Berchem TOT
54,Posthofbrug 5366,2022-04-07,15:00:00,0,0,0,FMN GV 16 Berchem TOT
54,Posthofbrug 5366,2022-04-07,16:00:00,0,0,0,FMN GV 16 Berchem TOT
54,Posthofbrug 5366,2022-04-07,17:00:00,0,0,0,FMN GV 16 Berchem TOT
54,Posthofbrug 5366,2022-04-07,18:00:00,0,0,0,FMN GV 16 Berchem TOT
54,Posthofbrug 5366,2022-04-07,19:00:00,0,0,0,FMN GV 16 Berchem TOT
54,Posthofbrug 5366,2022-04-07,20:00:00,0,0,0,FMN GV 16 Berchem TOT
54,Posthofbrug 5366,2022-04-07,21:00:00,0,0,0,FMN GV 16 Berchem TOT
54,Posthofbrug 5366,2022-04-07,22:00:00,0,0,0,FMN GV 16 Berchem TOT
54,Posthofbrug 5366,2022-04-07,23:00:00,0,0,0,FMN GV 16 Berchem TOT
54,Posthofbrug 5366,2022-06-19,00:00:00,0,0,0,FMN GV 16 Berchem TOT
54,Posthofbrug 5366,2022-06-19,01:00:00,27,8,19,FMN GV 16 Berchem TOT
54,Posthofbrug 5366,2022-06-19,02:00:00,23,10,13,FMN GV 16 Berchem TOT
54,Posthofbrug 5366,2022-06-19,03:00:00,15,4,11,FMN GV 16 Berchem TOT
54,Posthofbrug 5366,2022-06-19,04:00:00,8,2,6,FMN GV 16 Berchem TOT
54,Posthofbrug 5366,2022-06-19,05:00:00,19,11,8,FMN GV 16 Berchem TOT
54,Posthofbrug 5366,2022-06-19,06:00:00,18,12,6,FMN GV 16 Berchem TOT
54,Posthofbrug 5366,2022-06-19,07:00:00,19,9,10,FMN GV 16 Berchem TOT
54,Posthofbrug 5366,2022-06-19,08:00:00,40,22,18,FMN GV 16 Berchem TOT
54,Posthofbrug 5366,2022-06-19,09:00:00,91,53,38,FMN GV 16 Berchem TOT
54,Posthofbrug 5366,2022-06-19,10:00:00,124,83,41,FMN GV 16 Berchem TOT
54,Posthofbrug 5366,2022-06-19,11:00:00,146,92,54,FMN GV 16 Berchem TOT
54,Posthofbrug 5366,2022-06-19,12:00:00,161,96,65,FMN GV 16 Berchem TOT
54,Posthofbrug 5366,2022-06-19,13:00:00,180,109,71,FMN GV 16 Berchem TOT
54,Posthofbrug 5366,2022-06-19,14:00:00,191,116,75,FMN GV 16 Berchem TOT
54,Posthofbrug 5366,2022-06-19,15:00:00,165,88,77,FMN GV 16 Berchem TOT
54,Posthofbrug 5366,2022-06-19,16:00:00,151,68,83,FMN GV 16 Berchem TOT
54,Posthofbrug 5366,2022-06-19,17:00:00,152,74,78,FMN GV 16 Berchem TOT
54,Posthofbrug 5366,2022-06-19,18:00:00,122,62,60,FMN GV 16 Berchem TOT
54,Posthofbrug 5366,2022-06-19,19:00:00,87,43,44,FMN GV 16 Berchem TOT
54,Posthofbrug 5366,2022-06-19,20:00:00,80,46,34,FMN GV 16 Berchem TOT
54,Posthofbrug 5366,2022-06-19,21:00:00,63,36,27,FMN GV 16 Berchem TOT
54,Posthofbrug 5366,2022-06-19,22:00:00,45,16,29,FMN GV 16 Berchem TOT
54,Posthofbrug 5366,2022-06-19,23:00:00,26,10,16,FMN GV 16 Berchem TOT
54,Posthofbrug 5366,2022-06-20,00:00:00,0,0,0,FMN GV 16 Berchem TOT
54,Posthofbrug 5366,2022-06-20,01:00:00,5,1,4,FMN GV 16 Berchem TOT
54,Posthofbrug 5366,2022-06-20,02:00:00,5,2,3,FMN GV 16 Berchem TOT
54,Posthofbrug 5366,2022-06-20,03:00:00,2,0,2,FMN GV 16 Berchem TOT
54,Posthofbrug 5366,2022-06-20,04:00:00,7,6,1,FMN GV 16 Berchem TOT
54,Posthofbrug 5366,2022-06-20,05:00:00,30,23,7,FMN GV 16 Berchem TOT
54,Posthofbrug 5366,2022-06-20,06:00:00,110,91,19,FMN GV 16 Berchem TOT
54,Posthofbrug 5366,2022-06-20,07:00:00,386,299,87,FMN GV 16 Berchem TOT
54,Posthofbrug 5366,2022-06-20,08:00:00,626,472,154,FMN GV 16 Berchem TOT
54,Posthofbrug 5366,2022-06-20,09:00:00,230,172,58,FMN GV 16 Berchem TOT
54,Posthofbrug 5366,2022-06-20,10:00:00,121,84,37,FMN GV 16 Berchem TOT
54,Posthofbrug 5366,2022-06-20,11:00:00,125,83,42,FMN GV 16 Berchem TOT
54,Posthofbrug 5366,2022-06-20,12:00:00,161,98,63,FMN GV 16 Berchem TOT
54,Posthofbrug 5366,2022-06-20,13:00:00,154,90,64,FMN GV 16 Berchem TOT
54,Posthofbrug 5366,2022-06-20,14:00:00,135,67,68,FMN GV 16 Berchem TOT
54,Posthofbrug 5366,2022-06-20,15:00:00,225,106,119,FMN GV 16 Berchem TOT
54,Posthofbrug 5366,2022-06-20,16:00:00,360,139,221,FMN GV 16 Berchem TOT
54,Posthofbrug 5366,2022-06-20,17:00:00,466,180,286,FMN GV 16 Berchem TOT
54,Posthofbrug 5366,2022-06-20,18:00:00,304,119,185,FMN GV 16 Berchem TOT
54,Posthofbrug 5366,2022-06-20,19:00:00,147,67,80,FMN GV 16 Berchem TOT
54,Posthofbrug 5366,2022-06-20,20:00:00,104,59,45,FMN GV 16 Berchem TOT
54,Posthofbrug 5366,2022-06-20,21:00:00,73,34,39,FMN GV 16 Berchem TOT
54,Posthofbrug 5366,2022-06-20,22:00:00,62,26,36,FMN GV 16 Berchem TOT
54,Posthofbrug 5366,2022-06-20,23:00:00,43,18,25,FMN GV 16 Berchem TOT
54,Posthofbrug 5366,2022-06-21,00:00:00,0,0,0,FMN GV 16 Berchem TOT
54,Posthofbrug 5366,2022-06-21,01:00:00,10,4,6,FMN GV 16 Berchem TOT
54,Posthofbrug 5366,2022-06-21,02:00:00,5,2,3,FMN GV 16 Berchem TOT
54,Posthofbrug 5366,2022-06-21,03:00:00,4,2,2,FMN GV 16 Berchem TOT
54,Posthofbrug 5366,2022-06-21,04:00:00,13,10,3,FMN GV 16 Berchem TOT
54,Posthofbrug 5366,2022-06-21,05:00:00,35,29,6,FMN GV 16 Berchem TOT
54,Posthofbrug 5366,2022-06-21,06:00:00,130,108,22,FMN GV 16 Berchem TOT
54,Posthofbrug 5366,2022-06-21,07:00:00,430,329,101,FMN GV 16 Berchem TOT
54,Posthofbrug 5366,2022-06-21,08:00:00,681,512,169,FMN GV 16 Berchem TOT
54,Posthofbrug 5366,2022-06-21,09:00:00,262,198,64,FMN GV 16 Berchem TOT
54,Posthofbrug 5366,2022-06-21,10:00:00,125,87,38,FMN GV 16 Berchem TOT
54,Posthofbrug 5366,2022-06-21,11:00:00,118,75,43,FMN GV 16 Berchem TOT
54,Posthofbrug 5366,2022-06-21,12:00:00,169,102,67,FMN GV 16 Berchem TOT
54,Posthofbrug 5366,2022-06-21,13:00:00,164,96,68,FMN GV 16 Berchem TOT
54,Posthofbrug 5366,2022-06-21,14:00:00,152,75,77,FMN GV 16 Berchem TOT
54,Posthofbrug 5366,2022-06-21,15:00:00,220,94,126,FMN GV 16 Berchem TOT
54,Posthofbrug 5366,2022-06-21,16:00:00,398,167,231,FMN GV 16 Berchem TOT
54,Posthofbrug 5366,2022-06-21,17:00:00,484,184,300,FMN GV 16 Berchem TOT
54,Posthofbrug 5366,2022-06-21,18:00:00,327,131,196,FMN GV 16 Berchem TOT
54,Posthofbrug 5366,2022-06-21,19:00:00,164,76,88,FMN GV 16 Berchem TOT
54,Posthofbrug 5366,2022-06-21,20:00:00,115,59,56,FMN GV 16 Berchem TOT
54,Posthofbrug 5366,2022-06-21,21:00:00,89,45,44,FMN GV 16 Berchem TOT
54,Posthofbrug 5366,2022-06-21,22:00:00,79,33,46,FMN GV 16 Berchem TOT
54,Posthofbrug 5366,2022-06-21,23:00:00,52,18,34,FMN GV 16 Berchem TOT
54,Posthofbrug 5366,2022-06-22,00:00:00,0,0,0,FMN GV 16 Berchem TOT
54,Posthofbrug 5366,2022-06-22,01:00:00,9,2,7,FMN GV 16 Berchem TOT
54,Posthofbrug 5366,2022-06-22,02:00:00,4,1,3,FMN GV 16 Berchem TOT
54,Posthofbrug 5366,2022-06-22,03:00:00,3,0,3,FMN GV 16 Berchem TOT
54,Posthofbrug 5366,2022-06-22,04:00:00,7,4,3,FMN GV 16 Berchem TOT
54,Posthofbrug 5366,2022-06-22,05:00:00,13,8,5,FMN GV 16 Berchem TOT
54,Posthofbrug 5366,2022-06-22,06:00:00,55,37,18,FMN GV 16 Berchem TOT
54,Posthofbrug 5366,2022-06-22,07:00:00,173,93,80,FMN GV 16 Berchem TOT
54,Posthofbrug 5366,2022-06-22,08:00:00,280,143,137,FMN GV 16 Berchem TOT
54,Posthofbrug 5366,2022-06-22,09:00:00,116,62,54,FMN GV 16 Berchem TOT
54,Posthofbrug 5366,2022-06-22,10:00:00,65,28,37,FMN GV 16 Berchem TOT
54,Posthofbrug 5366,2022-06-22,11:00:00,83,31,52,FMN GV 16 Berchem TOT
54,Posthofbrug 5366,2022-06-22,12:00:00,147,40,107,FMN GV 16 Berchem TOT
54,Posthofbrug 5366,2022-06-22,13:00:00,128,41,87,FMN GV 16 Berchem TOT
54,Posthofbrug 5366,2022-06-22,14:00:00,110,32,78,FMN GV 16 Berchem TOT
54,Posthofbrug 5366,2022-06-22,15:00:00,131,33,98,FMN GV 16 Berchem TOT
54,Posthofbrug 5366,2022-06-22,16:00:00,234,61,173,FMN GV 16 Berchem TOT
54,Posthofbrug 5366,2022-06-22,17:00:00,320,76,244,FMN GV 16 Berchem TOT
54,Posthofbrug 5366,2022-06-22,18:00:00,217,48,169,FMN GV 16 Berchem TOT
54,Posthofbrug 5366,2022-06-22,19:00:00,111,31,80,FMN GV 16 Berchem TOT
54,Posthofbrug 5366,2022-06-22,20:00:00,72,28,44,FMN GV 16 Berchem TOT
54,Posthofbrug 5366,2022-06-22,21:00:00,53,14,39,FMN GV 16 Berchem TOT
54,Posthofbrug 5366,2022-06-22,22:00:00,61,17,44,FMN GV 16 Berchem TOT
54,Posthofbrug 5366,2022-06-22,23:00:00,41,10,31,FMN GV 16 Berchem TOT
54,Posthofbrug 5366,2022-06-23,00:00:00,0,0,0,FMN GV 16 Berchem TOT
54,Posthofbrug 5366,2022-06-23,01:00:00,0,0,0,FMN GV 16 Berchem TOT
54,Posthofbrug 5366,2022-06-23,02:00:00,0,0,0,FMN GV 16 Berchem TOT
54,Posthofbrug 5366,2022-06-23,03:00:00,0,0,0,FMN GV 16 Berchem TOT
54,Posthofbrug 5366,2022-06-23,04:00:00,0,0,0,FMN GV 16 Berchem TOT
54,Posthofbrug 5366,2022-06-23,05:00:00,0,0,0,FMN GV 16 Berchem TOT
54,Posthofbrug 5366,2022-06-23,06:00:00,0,0,0,FMN GV 16 Berchem TOT
54,Posthofbrug 5366,2022-06-23,07:00:00,0,0,0,FMN GV 16 Berchem TOT
54,Posthofbrug 5366,2022-06-23,08:00:00,0,0,0,FMN GV 16 Berchem TOT
54,Posthofbrug 5366,2022-06-23,09:00:00,0,0,0,FMN GV 16 Berchem TOT
54,Posthofbrug 5366,2022-06-23,10:00:00,0,0,0,FMN GV 16 Berchem TOT
54,Posthofbrug 5366,2022-06-23,11:00:00,0,0,0,FMN GV 16 Berchem TOT
54,Posthofbrug 5366,2022-06-23,12:00:00,0,0,0,FMN GV 16 Berchem TOT
54,Posthofbrug 5366,2022-06-23,13:00:00,153,82,71,FMN GV 16 Berchem TOT
54,Posthofbrug 5366,2022-06-23,14:00:00,193,68,125,FMN GV 16 Berchem TOT
54,Posthofbrug 5366,2022-06-23,15:00:00,314,108,206,FMN GV 16 Berchem TOT
54,Posthofbrug 5366,2022-06-23,16:00:00,479,152,327,FMN GV 16 Berchem TOT
54,Posthofbrug 5366,2022-06-23,17:00:00,608,180,428,FMN GV 16 Berchem TOT
54,Posthofbrug 5366,2022-06-23,18:00:00,478,170,308,FMN GV 16 Berchem TOT
54,Posthofbrug 5366,2022-06-23,19:00:00,251,111,140,FMN GV 16 Berchem TOT
54,Posthofbrug 5366,2022-06-23,20:00:00,169,64,105,FMN GV 16 Berchem TOT
54,Posthofbrug 5366,2022-06-23,21:00:00,173,86,87,FMN GV 16 Berchem TOT
54,Posthofbrug 5366,2022-06-23,22:00:00,176,48,128,FMN GV 16 Berchem TOT
54,Posthofbrug 5366,2022-06-23,23:00:00,134,52,82,FMN GV 16 Berchem TOT
54,Posthofbrug 5366,2022-06-24,00:00:00,78,25,53,FMN GV 16 Berchem TOT
54,Posthofbrug 5366,2022-06-24,01:00:00,30,6,24,FMN GV 16 Berchem TOT
54,Posthofbrug 5366,2022-06-24,02:00:00,8,0,8,FMN GV 16 Berchem TOT
54,Posthofbrug 5366,2022-06-24,03:00:00,9,3,6,FMN GV 16 Berchem TOT
54,Posthofbrug 5366,2022-06-24,04:00:00,15,9,6,FMN GV 16 Berchem TOT
54,Posthofbrug 5366,2022-06-24,05:00:00,30,15,15,FMN GV 16 Berchem TOT
54,Posthofbrug 5366,2022-06-24,06:00:00,102,75,27,FMN GV 16 Berchem TOT
54,Posthofbrug 5366,2022-06-24,07:00:00,276,208,68,FMN GV 16 Berchem TOT
54,Posthofbrug 5366,2022-06-24,08:00:00,510,412,98,FMN GV 16 Berchem TOT
54,Posthofbrug 5366,2022-06-24,09:00:00,247,159,88,FMN GV 16 Berchem TOT
54,Posthofbrug 5366,2022-06-24,10:00:00,130,84,46,FMN GV 16 Berchem TOT
54,Posthofbrug 5366,2022-06-24,11:00:00,118,59,59,FMN GV 16 Berchem TOT
54,Posthofbrug 5366,2022-06-24,12:00:00,150,82,68,FMN GV 16 Berchem TOT
54,Posthofbrug 5366,2022-06-24,13:00:00,187,94,93,FMN GV 16 Berchem TOT
54,Posthofbrug 5366,2022-06-24,14:00:00,196,102,94,FMN GV 16 Berchem TOT
54,Posthofbrug 5366,2022-06-24,15:00:00,247,93,154,FMN GV 16 Berchem TOT
54,Posthofbrug 5366,2022-06-24,16:00:00,320,119,201,FMN GV 16 Berchem TOT
54,Posthofbrug 5366,2022-06-24,17:00:00,319,106,213,FMN GV 16 Berchem TOT
54,Posthofbrug 5366,2022-06-24,18:00:00,269,101,168,FMN GV 16 Berchem TOT
54,Posthofbrug 5366,2022-06-24,19:00:00,186,104,82,FMN GV 16 Berchem TOT
54,Posthofbrug 5366,2022-06-24,20:00:00,114,52,62,FMN GV 16 Berchem TOT
54,Posthofbrug 5366,2022-06-24,21:00:00,92,51,41,FMN GV 16 Berchem TOT
54,Posthofbrug 5366,2022-06-24,22:00:00,100,33,67,FMN GV 16 Berchem TOT
54,Posthofbrug 5366,2022-06-24,23:00:00,82,17,65,FMN GV 16 Berchem TOT
54,Posthofbrug 5366,2022-06-25,00:00:00,74,32,42,FMN GV 16 Berchem TOT
54,Posthofbrug 5366,2022-06-25,01:00:00,58,13,45,FMN GV 16 Berchem TOT
54,Posthofbrug 5366,2022-06-25,02:00:00,34,3,31,FMN GV 16 Berchem TOT
54,Posthofbrug 5366,2022-06-25,03:00:00,18,1,17,FMN GV 16 Berchem TOT
54,Posthofbrug 5366,2022-06-25,04:00:00,23,7,16,FMN GV 16 Berchem TOT
54,Posthofbrug 5366,2022-06-25,05:00:00,20,12,8,FMN GV 16 Berchem TOT
54,Posthofbrug 5366,2022-06-25,06:00:00,24,12,12,FMN GV 16 Berchem TOT
54,Posthofbrug 5366,2022-06-25,07:00:00,36,22,14,FMN GV 16 Berchem TOT
54,Posthofbrug 5366,2022-06-25,08:00:00,86,57,29,FMN GV 16 Berchem TOT
54,Posthofbrug 5366,2022-06-25,09:00:00,196,111,85,FMN GV 16 Berchem TOT
54,Posthofbrug 5366,2022-06-25,10:00:00,154,91,63,FMN GV 16 Berchem TOT
54,Posthofbrug 5366,2022-06-25,11:00:00,154,96,58,FMN GV 16 Berchem TOT
54,Posthofbrug 5366,2022-06-25,12:00:00,164,102,62,FMN GV 16 Berchem TOT
54,Posthofbrug 5366,2022-06-25,13:00:00,192,120,72,FMN GV 16 Berchem TOT
54,Posthofbrug 5366,2022-06-25,14:00:00,167,83,84,FMN GV 16 Berchem TOT
54,Posthofbrug 5366,2022-06-25,15:00:00,196,95,101,FMN GV 16 Berchem TOT
54,Posthofbrug 5366,2022-06-25,16:00:00,155,68,87,FMN GV 16 Berchem TOT
54,Posthofbrug 5366,2022-06-25,17:00:00,143,56,87,FMN GV 16 Berchem TOT
54,Posthofbrug 5366,2022-06-25,18:00:00,131,46,85,FMN GV 16 Berchem TOT
54,Posthofbrug 5366,2022-06-25,19:00:00,103,44,59,FMN GV 16 Berchem TOT
54,Posthofbrug 5366,2022-06-25,20:00:00,57,29,28,FMN GV 16 Berchem TOT
54,Posthofbrug 5366,2022-06-25,21:00:00,67,40,27,FMN GV 16 Berchem TOT
54,Posthofbrug 5366,2022-06-25,22:00:00,57,24,33,FMN GV 16 Berchem TOT
54,Posthofbrug 5366,2022-06-25,23:00:00,35,10,25,FMN GV 16 Berchem TOT
54,Posthofbrug 5366,2022-06-26,00:00:00,31,11,20,FMN GV 16 Berchem TOT
54,Posthofbrug 5366,2022-06-26,01:00:00,35,7,28,FMN GV 16 Berchem TOT
54,Posthofbrug 5366,2022-06-26,02:00:00,29,6,23,FMN GV 16 Berchem TOT
54,Posthofbrug 5366,2022-06-26,03:00:00,22,3,19,FMN GV 16 Berchem TOT
54,Posthofbrug 5366,2022-06-26,04:00:00,21,7,14,FMN GV 16 Berchem TOT
54,Posthofbrug 5366,2022-06-26,05:00:00,15,5,10,FMN GV 16 Berchem TOT
54,Posthofbrug 5366,2022-06-26,06:00:00,24,13,11,FMN GV 16 Berchem TOT
54,Posthofbrug 5366,2022-06-26,07:00:00,33,21,12,FMN GV 16 Berchem TOT
54,Posthofbrug 5366,2022-06-26,08:00:00,37,20,17,FMN GV 16 Berchem TOT
54,Posthofbrug 5366,2022-06-26,09:00:00,118,78,40,FMN GV 16 Berchem TOT
54,Posthofbrug 5366,2022-06-26,10:00:00,147,81,66,FMN GV 16 Berchem TOT
54,Posthofbrug 5366,2022-06-26,11:00:00,163,92,71,FMN GV 16 Berchem TOT
54,Posthofbrug 5366,2022-06-26,12:00:00,168,99,69,FMN GV 16 Berchem TOT
54,Posthofbrug 5366,2022-06-26,13:00:00,155,79,76,FMN GV 16 Berchem TOT
54,Posthofbrug 5366,2022-06-26,14:00:00,71,3,68,FMN GV 16 Berchem TOT
54,Posthofbrug 5366,2022-06-26,15:00:00,135,22,113,FMN GV 16 Berchem TOT
54,Posthofbrug 5366,2022-06-26,16:00:00,178,97,81,FMN GV 16 Berchem TOT
54,Posthofbrug 5366,2022-06-26,17:00:00,214,85,129,FMN GV 16 Berchem TOT
54,Posthofbrug 5366,2022-06-26,18:00:00,169,72,97,FMN GV 16 Berchem TOT
54,Posthofbrug 5366,2022-06-26,19:00:00,145,65,80,FMN GV 16 Berchem TOT
54,Posthofbrug 5366,2022-06-26,20:00:00,144,78,66,FMN GV 16 Berchem TOT
54,Posthofbrug 5366,2022-06-26,21:00:00,103,46,57,FMN GV 16 Berchem TOT
54,Posthofbrug 5366,2022-06-26,22:00:00,91,35,56,FMN GV 16 Berchem TOT
54,Posthofbrug 5366,2022-06-26,23:00:00,40,13,27,FMN GV 16 Berchem TOT
54,Posthofbrug 5366,2022-06-27,00:00:00,32,11,21,FMN GV 16 Berchem TOT
54,Posthofbrug 5366,2022-06-27,01:00:00,32,9,23,FMN GV 16 Berchem TOT
54,Posthofbrug 5366,2022-06-27,02:00:00,10,3,7,FMN GV 16 Berchem TOT
54,Posthofbrug 5366,2022-06-27,03:00:00,16,3,13,FMN GV 16 Berchem TOT
54,Posthofbrug 5366,2022-06-27,04:00:00,29,15,14,FMN GV 16 Berchem TOT
54,Posthofbrug 5366,2022-06-27,05:00:00,27,17,10,FMN GV 16 Berchem TOT
54,Posthofbrug 5366,2022-06-27,06:00:00,120,97,23,FMN GV 16 Berchem TOT
54,Posthofbrug 5366,2022-06-27,07:00:00,425,335,90,FMN GV 16 Berchem TOT
54,Posthofbrug 5366,2022-06-27,08:00:00,773,608,165,FMN GV 16 Berchem TOT
54,Posthofbrug 5366,2022-06-27,09:00:00,248,198,50,FMN GV 16 Berchem TOT
54,Posthofbrug 5366,2022-06-27,10:00:00,127,90,37,FMN GV 16 Berchem TOT
54,Posthofbrug 5366,2022-06-27,11:00:00,114,62,52,FMN GV 16 Berchem TOT
54,Posthofbrug 5366,2022-06-27,12:00:00,148,85,63,FMN GV 16 Berchem TOT
54,Posthofbrug 5366,2022-06-27,13:00:00,116,50,66,FMN GV 16 Berchem TOT
54,Posthofbrug 5366,2022-06-27,14:00:00,113,42,71,FMN GV 16 Berchem TOT
54,Posthofbrug 5366,2022-06-27,15:00:00,220,74,146,FMN GV 16 Berchem TOT
54,Posthofbrug 5366,2022-06-27,16:00:00,412,115,297,FMN GV 16 Berchem TOT
54,Posthofbrug 5366,2022-06-27,17:00:00,551,164,387,FMN GV 16 Berchem TOT
54,Posthofbrug 5366,2022-06-27,18:00:00,406,130,276,FMN GV 16 Berchem TOT
54,Posthofbrug 5366,2022-06-27,19:00:00,213,86,127,FMN GV 16 Berchem TOT
54,Posthofbrug 5366,2022-06-27,20:00:00,146,69,77,FMN GV 16 Berchem TOT
54,Posthofbrug 5366,2022-06-27,21:00:00,108,43,65,FMN GV 16 Berchem TOT
54,Posthofbrug 5366,2022-06-27,22:00:00,105,34,71,FMN GV 16 Berchem TOT
54,Posthofbrug 5366,2022-06-27,23:00:00,64,26,38,FMN GV 16 Berchem TOT
54,Posthofbrug 5366,2022-06-28,00:00:00,37,5,32,FMN GV 16 Berchem TOT
54,Posthofbrug 5366,2022-06-28,01:00:00,18,3,15,FMN GV 16 Berchem TOT
54,Posthofbrug 5366,2022-06-28,02:00:00,15,1,14,FMN GV 16 Berchem TOT
54,Posthofbrug 5366,2022-06-28,03:00:00,6,0,6,FMN GV 16 Berchem TOT
54,Posthofbrug 5366,2022-06-28,04:00:00,24,12,12,FMN GV 16 Berchem TOT
54,Posthofbrug 5366,2022-06-28,05:00:00,44,23,21,FMN GV 16 Berchem TOT
54,Posthofbrug 5366,2022-06-28,06:00:00,131,105,26,FMN GV 16 Berchem TOT
54,Posthofbrug 5366,2022-06-28,07:00:00,499,403,96,FMN GV 16 Berchem TOT
54,Posthofbrug 5366,2022-06-28,08:00:00,859,671,188,FMN GV 16 Berchem TOT
54,Posthofbrug 5366,2022-06-28,09:00:00,336,257,79,FMN GV 16 Berchem TOT
54,Posthofbrug 5366,2022-06-28,10:00:00,185,118,67,FMN GV 16 Berchem TOT
54,Posthofbrug 5366,2022-06-28,11:00:00,154,82,72,FMN GV 16 Berchem TOT
54,Posthofbrug 5366,2022-06-28,12:00:00,229,130,99,FMN GV 16 Berchem TOT
54,Posthofbrug 5366,2022-06-28,13:00:00,212,116,96,FMN GV 16 Berchem TOT
54,Posthofbrug 5366,2022-06-28,14:00:00,274,138,136,FMN GV 16 Berchem TOT
54,Posthofbrug 5366,2022-06-28,15:00:00,303,104,199,FMN GV 16 Berchem TOT
54,Posthofbrug 5366,2022-06-28,16:00:00,495,176,319,FMN GV 16 Berchem TOT
54,Posthofbrug 5366,2022-06-28,17:00:00,687,206,481,FMN GV 16 Berchem TOT
54,Posthofbrug 5366,2022-06-28,18:00:00,477,162,315,FMN GV 16 Berchem TOT
54,Posthofbrug 5366,2022-06-28,19:00:00,275,121,154,FMN GV 16 Berchem TOT
54,Posthofbrug 5366,2022-06-28,20:00:00,166,71,95,FMN GV 16 Berchem TOT
54,Posthofbrug 5366,2022-06-28,21:00:00,195,95,100,FMN GV 16 Berchem TOT
54,Posthofbrug 5366,2022-06-28,22:00:00,168,61,107,FMN GV 16 Berchem TOT
54,Posthofbrug 5366,2022-06-28,23:00:00,106,30,76,FMN GV 16 Berchem TOT
54,Posthofbrug 5366,2022-06-29,00:00:00,49,12,37,FMN GV 16 Berchem TOT
54,Posthofbrug 5366,2022-06-29,01:00:00,28,7,21,FMN GV 16 Berchem TOT
54,Posthofbrug 5366,2022-06-29,02:00:00,15,2,13,FMN GV 16 Berchem TOT
54,Posthofbrug 5366,2022-06-29,03:00:00,10,2,8,FMN GV 16 Berchem TOT
54,Posthofbrug 5366,2022-06-29,04:00:00,20,11,9,FMN GV 16 Berchem TOT
54,Posthofbrug 5366,2022-06-29,05:00:00,37,24,13,FMN GV 16 Berchem TOT
54,Posthofbrug 5366,2022-06-29,06:00:00,144,114,30,FMN GV 16 Berchem TOT
54,Posthofbrug 5366,2022-06-29,07:00:00,432,335,97,FMN GV 16 Berchem TOT
54,Posthofbrug 5366,2022-06-29,08:00:00,709,532,177,FMN GV 16 Berchem TOT
54,Posthofbrug 5366,2022-06-29,09:00:00,313,233,80,FMN GV 16 Berchem TOT
54,Posthofbrug 5366,2022-06-29,10:00:00,168,103,65,FMN GV 16 Berchem TOT
54,Posthofbrug 5366,2022-06-29,11:00:00,213,117,96,FMN GV 16 Berchem TOT
54,Posthofbrug 5366,2022-06-29,12:00:00,317,150,167,FMN GV 16 Berchem TOT
54,Posthofbrug 5366,2022-06-29,13:00:00,283,137,146,FMN GV 16 Berchem TOT
54,Posthofbrug 5366,2022-06-29,14:00:00,269,136,133,FMN GV 16 Berchem TOT
54,Posthofbrug 5366,2022-06-29,15:00:00,297,126,171,FMN GV 16 Berchem TOT
54,Posthofbrug 5366,2022-06-29,16:00:00,422,163,259,FMN GV 16 Berchem TOT
54,Posthofbrug 5366,2022-06-29,17:00:00,630,234,396,FMN GV 16 Berchem TOT
54,Posthofbrug 5366,2022-06-29,18:00:00,462,171,291,FMN GV 16 Berchem TOT
54,Posthofbrug 5366,2022-06-29,19:00:00,241,123,118,FMN GV 16 Berchem TOT
54,Posthofbrug 5366,2022-06-29,20:00:00,183,87,96,FMN GV 16 Berchem TOT
54,Posthofbrug 5366,2022-06-29,21:00:00,157,77,80,FMN GV 16 Berchem TOT
54,Posthofbrug 5366,2022-06-29,22:00:00,155,58,97,FMN GV 16 Berchem TOT
54,Posthofbrug 5366,2022-06-29,23:00:00,102,25,77,FMN GV 16 Berchem TOT
54,Posthofbrug 5366,2022-06-30,00:00:00,63,16,47,FMN GV 16 Berchem TOT
54,Posthofbrug 5366,2022-06-30,01:00:00,43,7,36,FMN GV 16 Berchem TOT
54,Posthofbrug 5366,2022-06-30,02:00:00,44,5,39,FMN GV 16 Berchem TOT
54,Posthofbrug 5366,2022-06-30,03:00:00,11,0,11,FMN GV 16 Berchem TOT
54,Posthofbrug 5366,2022-06-30,04:00:00,26,11,15,FMN GV 16 Berchem TOT
54,Posthofbrug 5366,2022-06-30,05:00:00,38,24,14,FMN GV 16 Berchem TOT
54,Posthofbrug 5366,2022-06-30,06:00:00,113,91,22,FMN GV 16 Berchem TOT
54,Posthofbrug 5366,2022-06-30,07:00:00,352,277,75,FMN GV 16 Berchem TOT
54,Posthofbrug 5366,2022-06-30,08:00:00,691,515,176,FMN GV 16 Berchem TOT
54,Posthofbrug 5366,2022-06-30,09:00:00,276,225,51,FMN GV 16 Berchem TOT
54,Posthofbrug 5366,2022-06-30,10:00:00,147,102,45,FMN GV 16 Berchem TOT
54,Posthofbrug 5366,2022-06-30,11:00:00,180,84,96,FMN GV 16 Berchem TOT
54,Posthofbrug 5366,2022-06-30,12:00:00,203,90,113,FMN GV 16 Berchem TOT
54,Posthofbrug 5366,2022-06-30,13:00:00,155,76,79,FMN GV 16 Berchem TOT
54,Posthofbrug 5366,2022-06-30,14:00:00,141,57,84,FMN GV 16 Berchem TOT
54,Posthofbrug 5366,2022-06-30,15:00:00,202,76,126,FMN GV 16 Berchem TOT
54,Posthofbrug 5366,2022-06-30,16:00:00,361,112,249,FMN GV 16 Berchem TOT
54,Posthofbrug 5366,2022-06-30,17:00:00,326,95,231,FMN GV 16 Berchem TOT
54,Posthofbrug 5366,2022-06-30,18:00:00,220,59,161,FMN GV 16 Berchem TOT
54,Posthofbrug 5366,2022-06-30,19:00:00,142,58,84,FMN GV 16 Berchem TOT
54,Posthofbrug 5366,2022-06-30,20:00:00,79,25,54,FMN GV 16 Berchem TOT
54,Posthofbrug 5366,2022-06-30,21:00:00,57,26,31,FMN GV 16 Berchem TOT
54,Posthofbrug 5366,2022-06-30,22:00:00,81,16,65,FMN GV 16 Berchem TOT
54,Posthofbrug 5366,2022-06-30,23:00:00,68,26,42,FMN GV 16 Berchem TOT
54,Posthofbrug 5366,2022-07-01,00:00:00,46,18,28,FMN GV 16 Berchem TOT
54,Posthofbrug 5366,2022-07-01,01:00:00,25,8,17,FMN GV 16 Berchem TOT
54,Posthofbrug 5366,2022-07-01,02:00:00,12,3,9,FMN GV 16 Berchem TOT
54,Posthofbrug 5366,2022-07-01,03:00:00,15,2,13,FMN GV 16 Berchem TOT
54,Posthofbrug 5366,2022-07-01,04:00:00,12,9,3,FMN GV 16 Berchem TOT
54,Posthofbrug 5366,2022-07-01,05:00:00,35,25,10,FMN GV 16 Berchem TOT
54,Posthofbrug 5366,2022-07-01,06:00:00,87,74,13,FMN GV 16 Berchem TOT
54,Posthofbrug 5366,2022-07-01,07:00:00,238,178,60,FMN GV 16 Berchem TOT
54,Posthofbrug 5366,2022-07-01,08:00:00,441,349,92,FMN GV 16 Berchem TOT
54,Posthofbrug 5366,2022-07-01,09:00:00,263,207,56,FMN GV 16 Berchem TOT
54,Posthofbrug 5366,2022-07-01,10:00:00,164,103,61,FMN GV 16 Berchem TOT
54,Posthofbrug 5366,2022-07-01,11:00:00,165,111,54,FMN GV 16 Berchem TOT
54,Posthofbrug 5366,2022-07-01,12:00:00,187,99,88,FMN GV 16 Berchem TOT
54,Posthofbrug 5366,2022-07-01,13:00:00,214,103,111,FMN GV 16 Berchem TOT
54,Posthofbrug 5366,2022-07-01,14:00:00,175,89,86,FMN GV 16 Berchem TOT
54,Posthofbrug 5366,2022-07-01,15:00:00,235,90,145,FMN GV 16 Berchem TOT
54,Posthofbrug 5366,2022-07-01,16:00:00,331,104,227,FMN GV 16 Berchem TOT
54,Posthofbrug 5366,2022-07-01,17:00:00,420,148,272,FMN GV 16 Berchem TOT
54,Posthofbrug 5366,2022-07-01,18:00:00,314,146,168,FMN GV 16 Berchem TOT
54,Posthofbrug 5366,2022-07-01,19:00:00,184,94,90,FMN GV 16 Berchem TOT
54,Posthofbrug 5366,2022-07-01,20:00:00,166,87,79,FMN GV 16 Berchem TOT
54,Posthofbrug 5366,2022-07-01,21:00:00,99,42,57,FMN GV 16 Berchem TOT
54,Posthofbrug 5366,2022-07-01,22:00:00,99,34,65,FMN GV 16 Berchem TOT
54,Posthofbrug 5366,2022-07-01,23:00:00,116,29,87,FMN GV 16 Berchem TOT
54,Posthofbrug 5366,2022-07-02,00:00:00,68,26,42,FMN GV 16 Berchem TOT
54,Posthofbrug 5366,2022-07-02,01:00:00,54,16,38,FMN GV 16 Berchem TOT
54,Posthofbrug 5366,2022-07-02,02:00:00,22,5,17,FMN GV 16 Berchem TOT
54,Posthofbrug 5366,2022-07-02,03:00:00,15,6,9,FMN GV 16 Berchem TOT
54,Posthofbrug 5366,2022-07-02,04:00:00,14,3,11,FMN GV 16 Berchem TOT
54,Posthofbrug 5366,2022-07-02,05:00:00,21,12,9,FMN GV 16 Berchem TOT
54,Posthofbrug 5366,2022-07-02,06:00:00,26,18,8,FMN GV 16 Berchem TOT
54,Posthofbrug 5366,2022-07-02,07:00:00,40,25,15,FMN GV 16 Berchem TOT
54,Posthofbrug 5366,2022-07-02,08:00:00,83,54,29,FMN GV 16 Berchem TOT
54,Posthofbrug 5366,2022-07-02,09:00:00,132,98,34,FMN GV 16 Berchem TOT
54,Posthofbrug 5366,2022-07-02,10:00:00,169,114,55,FMN GV 16 Berchem TOT
54,Posthofbrug 5366,2022-07-02,11:00:00,175,106,69,FMN GV 16 Berchem TOT
54,Posthofbrug 5366,2022-07-02,12:00:00,202,127,75,FMN GV 16 Berchem TOT
54,Posthofbrug 5366,2022-07-02,13:00:00,217,127,90,FMN GV 16 Berchem TOT
54,Posthofbrug 5366,2022-07-02,14:00:00,223,117,106,FMN GV 16 Berchem TOT
54,Posthofbrug 5366,2022-07-02,15:00:00,238,117,121,FMN GV 16 Berchem TOT
54,Posthofbrug 5366,2022-07-02,16:00:00,200,93,107,FMN GV 16 Berchem TOT
54,Posthofbrug 5366,2022-07-02,17:00:00,222,97,125,FMN GV 16 Berchem TOT
54,Posthofbrug 5366,2022-07-02,18:00:00,203,98,105,FMN GV 16 Berchem TOT
54,Posthofbrug 5366,2022-07-02,19:00:00,155,86,69,FMN GV 16 Berchem TOT
54,Posthofbrug 5366,2022-07-02,20:00:00,121,51,70,FMN GV 16 Berchem TOT
54,Posthofbrug 5366,2022-07-02,21:00:00,107,60,47,FMN GV 16 Berchem TOT
54,Posthofbrug 5366,2022-07-02,22:00:00,97,35,62,FMN GV 16 Berchem TOT
54,Posthofbrug 5366,2022-07-02,23:00:00,75,32,43,FMN GV 16 Berchem TOT
54,Posthofbrug 5366,2022-07-03,00:00:00,50,17,33,FMN GV 16 Berchem TOT
54,Posthofbrug 5366,2022-07-03,01:00:00,60,20,40,FMN GV 16 Berchem TOT
54,Posthofbrug 5366,2022-07-03,02:00:00,40,9,31,FMN GV 16 Berchem TOT
54,Posthofbrug 5366,2022-07-03,03:00:00,20,6,14,FMN GV 16 Berchem TOT
54,Posthofbrug 5366,2022-07-03,04:00:00,19,7,12,FMN GV 16 Berchem TOT
54,Posthofbrug 5366,2022-07-03,05:00:00,16,10,6,FMN GV 16 Berchem TOT
54,Posthofbrug 5366,2022-07-03,06:00:00,24,21,3,FMN GV 16 Berchem TOT
54,Posthofbrug 5366,2022-07-03,07:00:00,37,26,11,FMN GV 16 Berchem TOT
54,Posthofbrug 5366,2022-07-03,08:00:00,66,46,20,FMN GV 16 Berchem TOT
54,Posthofbrug 5366,2022-07-03,09:00:00,122,89,33,FMN GV 16 Berchem TOT
54,Posthofbrug 5366,2022-07-03,10:00:00,185,120,65,FMN GV 16 Berchem TOT
54,Posthofbrug 5366,2022-07-03,11:00:00,158,93,65,FMN GV 16 Berchem TOT
54,Posthofbrug 5366,2022-07-03,12:00:00,228,148,80,FMN GV 16 Berchem TOT
54,Posthofbrug 5366,2022-07-03,13:00:00,246,139,107,FMN GV 16 Berchem TOT
54,Posthofbrug 5366,2022-07-03,14:00:00,214,121,93,FMN GV 16 Berchem TOT
54,Posthofbrug 5366,2022-07-03,15:00:00,222,116,106,FMN GV 16 Berchem TOT
54,Posthofbrug 5366,2022-07-03,16:00:00,188,76,112,FMN GV 16 Berchem TOT
54,Posthofbrug 5366,2022-07-03,17:00:00,201,105,96,FMN GV 16 Berchem TOT
54,Posthofbrug 5366,2022-07-03,18:00:00,181,71,110,FMN GV 16 Berchem TOT
54,Posthofbrug 5366,2022-07-03,19:00:00,129,73,56,FMN GV 16 Berchem TOT
54,Posthofbrug 5366,2022-07-03,20:00:00,100,49,51,FMN GV 16 Berchem TOT
54,Posthofbrug 5366,2022-07-03,21:00:00,113,48,65,FMN GV 16 Berchem TOT
54,Posthofbrug 5366,2022-07-03,22:00:00,58,30,28,FMN GV 16 Berchem TOT
54,Posthofbrug 5366,2022-07-03,23:00:00,39,11,28,FMN GV 16 Berchem TOT
54,Posthofbrug 5366,2022-07-04,00:00:00,28,9,19,FMN GV 16 Berchem TOT
54,Posthofbrug 5366,2022-07-04,01:00:00,13,3,10,FMN GV 16 Berchem TOT
54,Posthofbrug 5366,2022-07-04,02:00:00,6,3,3,FMN GV 16 Berchem TOT
54,Posthofbrug 5366,2022-07-04,03:00:00,12,1,11,FMN GV 16 Berchem TOT
54,Posthofbrug 5366,2022-07-04,04:00:00,10,4,6,FMN GV 16 Berchem TOT
54,Posthofbrug 5366,2022-07-04,05:00:00,30,20,10,FMN GV 16 Berchem TOT
54,Posthofbrug 5366,2022-07-04,06:00:00,110,86,24,FMN GV 16 Berchem TOT
54,Posthofbrug 5366,2022-07-04,07:00:00,308,239,69,FMN GV 16 Berchem TOT
54,Posthofbrug 5366,2022-07-04,08:00:00,595,461,134,FMN GV 16 Berchem TOT
54,Posthofbrug 5366,2022-07-04,09:00:00,303,233,70,FMN GV 16 Berchem TOT
54,Posthofbrug 5366,2022-07-04,10:00:00,136,98,38,FMN GV 16 Berchem TOT
54,Posthofbrug 5366,2022-07-04,11:00:00,139,77,62,FMN GV 16 Berchem TOT
54,Posthofbrug 5366,2022-07-04,12:00:00,190,117,73,FMN GV 16 Berchem TOT
54,Posthofbrug 5366,2022-07-04,13:00:00,176,97,79,FMN GV 16 Berchem TOT
54,Posthofbrug 5366,2022-07-04,14:00:00,170,84,86,FMN GV 16 Berchem TOT
54,Posthofbrug 5366,2022-07-04,15:00:00,220,91,129,FMN GV 16 Berchem TOT
54,Posthofbrug 5366,2022-07-04,16:00:00,358,115,243,FMN GV 16 Berchem TOT
54,Posthofbrug 5366,2022-07-04,17:00:00,555,174,381,FMN GV 16 Berchem TOT
54,Posthofbrug 5366,2022-07-04,18:00:00,361,115,246,FMN GV 16 Berchem TOT
54,Posthofbrug 5366,2022-07-04,19:00:00,201,82,119,FMN GV 16 Berchem TOT
54,Posthofbrug 5366,2022-07-04,20:00:00,127,60,67,FMN GV 16 Berchem TOT
54,Posthofbrug 5366,2022-07-04,21:00:00,98,42,56,FMN GV 16 Berchem TOT
54,Posthofbrug 5366,2022-07-04,22:00:00,107,39,68,FMN GV 16 Berchem TOT
54,Posthofbrug 5366,2022-07-04,23:00:00,45,14,31,FMN GV 16 Berchem TOT
54,Posthofbrug 5366,2022-07-05,00:00:00,37,10,27,FMN GV 16 Berchem TOT
54,Posthofbrug 5366,2022-07-05,01:00:00,11,3,8,FMN GV 16 Berchem TOT
54,Posthofbrug 5366,2022-07-05,02:00:00,4,2,2,FMN GV 16 Berchem TOT
54,Posthofbrug 5366,2022-07-05,03:00:00,4,0,4,FMN GV 16 Berchem TOT
54,Posthofbrug 5366,2022-07-05,04:00:00,16,6,10,FMN GV 16 Berchem TOT
54,Posthofbrug 5366,2022-07-05,05:00:00,36,26,10,FMN GV 16 Berchem TOT
54,Posthofbrug 5366,2022-07-05,06:00:00,135,112,23,FMN GV 16 Berchem TOT
54,Posthofbrug 5366,2022-07-05,07:00:00,345,256,89,FMN GV 16 Berchem TOT
54,Posthofbrug 5366,2022-07-05,08:00:00,623,462,161,FMN GV 16 Berchem TOT
54,Posthofbrug 5366,2022-07-05,09:00:00,326,249,77,FMN GV 16 Berchem TOT
54,Posthofbrug 5366,2022-07-05,10:00:00,187,135,52,FMN GV 16 Berchem TOT
54,Posthofbrug 5366,2022-07-05,11:00:00,144,99,45,FMN GV 16 Berchem TOT
54,Posthofbrug 5366,2022-07-05,12:00:00,180,105,75,FMN GV 16 Berchem TOT
54,Posthofbrug 5366,2022-07-05,13:00:00,167,85,82,FMN GV 16 Berchem TOT
54,Posthofbrug 5366,2022-07-05,14:00:00,170,84,86,FMN GV 16 Berchem TOT
54,Posthofbrug 5366,2022-07-05,15:00:00,215,72,143,FMN GV 16 Berchem TOT
54,Posthofbrug 5366,2022-07-05,16:00:00,431,154,277,FMN GV 16 Berchem TOT
54,Posthofbrug 5366,2022-07-05,17:00:00,558,185,373,FMN GV 16 Berchem TOT
54,Posthofbrug 5366,2022-07-05,18:00:00,417,148,269,FMN GV 16 Berchem TOT
54,Posthofbrug 5366,2022-07-05,19:00:00,198,80,118,FMN GV 16 Berchem TOT
54,Posthofbrug 5366,2022-07-05,20:00:00,144,73,71,FMN GV 16 Berchem TOT
54,Posthofbrug 5366,2022-07-05,21:00:00,114,52,62,FMN GV 16 Berchem TOT
54,Posthofbrug 5366,2022-07-05,22:00:00,105,46,59,FMN GV 16 Berchem TOT
54,Posthofbrug 5366,2022-07-05,23:00:00,75,19,56,FMN GV 16 Berchem TOT
54,Posthofbrug 5366,2022-07-06,00:00:00,42,10,32,FMN GV 16 Berchem TOT
54,Posthofbrug 5366,2022-07-06,01:00:00,10,0,10,FMN GV 16 Berchem TOT
54,Posthofbrug 5366,2022-07-06,02:00:00,8,0,8,FMN GV 16 Berchem TOT
54,Posthofbrug 5366,2022-07-06,03:00:00,1,0,1,FMN GV 16 Berchem TOT
54,Posthofbrug 5366,2022-07-06,04:00:00,18,11,7,FMN GV 16 Berchem TOT
54,Posthofbrug 5366,2022-07-06,05:00:00,33,22,11,FMN GV 16 Berchem TOT
54,Posthofbrug 5366,2022-07-06,06:00:00,108,81,27,FMN GV 16 Berchem TOT
54,Posthofbrug 5366,2022-07-06,07:00:00,323,250,73,FMN GV 16 Berchem TOT
54,Posthofbrug 5366,2022-07-06,08:00:00,524,393,131,FMN GV 16 Berchem TOT
54,Posthofbrug 5366,2022-07-06,09:00:00,265,194,71,FMN GV 16 Berchem TOT
54,Posthofbrug 5366,2022-07-06,10:00:00,143,102,41,FMN GV 16 Berchem TOT
54,Posthofbrug 5366,2022-07-06,11:00:00,151,90,61,FMN GV 16 Berchem TOT
54,Posthofbrug 5366,2022-07-06,12:00:00,169,101,68,FMN GV 16 Berchem TOT
54,Posthofbrug 5366,2022-07-06,13:00:00,193,97,96,FMN GV 16 Berchem TOT
54,Posthofbrug 5366,2022-07-06,14:00:00,188,104,84,FMN GV 16 Berchem TOT
54,Posthofbrug 5366,2022-07-06,15:00:00,213,73,140,FMN GV 16 Berchem TOT
54,Posthofbrug 5366,2022-07-06,16:00:00,399,152,247,FMN GV 16 Berchem TOT
54,Posthofbrug 5366,2022-07-06,17:00:00,513,180,333,FMN GV 16 Berchem TOT
54,Posthofbrug 5366,2022-07-06,18:00:00,391,148,243,FMN GV 16 Berchem TOT
54,Posthofbrug 5366,2022-07-06,19:00:00,189,76,113,FMN GV 16 Berchem TOT
54,Posthofbrug 5366,2022-07-06,20:00:00,134,55,79,FMN GV 16 Berchem TOT
54,Posthofbrug 5366,2022-07-06,21:00:00,109,52,57,FMN GV 16 Berchem TOT
54,Posthofbrug 5366,2022-07-06,22:00:00,112,37,75,FMN GV 16 Berchem TOT
54,Posthofbrug 5366,2022-07-06,23:00:00,71,21,50,FMN GV 16 Berchem TOT
54,Posthofbrug 5366,2022-07-07,00:00:00,38,12,26,FMN GV 16 Berchem TOT
54,Posthofbrug 5366,2022-07-07,01:00:00,25,3,22,FMN GV 16 Berchem TOT
54,Posthofbrug 5366,2022-07-07,02:00:00,6,1,5,FMN GV 16 Berchem TOT
54,Posthofbrug 5366,2022-07-07,03:00:00,6,2,4,FMN GV 16 Berchem TOT
54,Posthofbrug 5366,2022-07-07,04:00:00,12,3,9,FMN GV 16 Berchem TOT
54,Posthofbrug 5366,2022-07-07,05:00:00,39,24,15,FMN GV 16 Berchem TOT
54,Posthofbrug 5366,2022-07-07,06:00:00,110,88,22,FMN GV 16 Berchem TOT
54,Posthofbrug 5366,2022-07-07,07:00:00,286,212,74,FMN GV 16 Berchem TOT
54,Posthofbrug 5366,2022-07-07,08:00:00,493,377,116,FMN GV 16 Berchem TOT
54,Posthofbrug 5366,2022-07-07,09:00:00,277,207,70,FMN GV 16 Berchem TOT
54,Posthofbrug 5366,2022-07-07,10:00:00,101,64,37,FMN GV 16 Berchem TOT
54,Posthofbrug 5366,2022-07-07,11:00:00,104,63,41,FMN GV 16 Berchem TOT
54,Posthofbrug 5366,2022-07-07,12:00:00,130,70,60,FMN GV 16 Berchem TOT
54,Posthofbrug 5366,2022-07-07,13:00:00,124,68,56,FMN GV 16 Berchem TOT
54,Posthofbrug 5366,2022-07-07,14:00:00,135,65,70,FMN GV 16 Berchem TOT
54,Posthofbrug 5366,2022-07-07,15:00:00,174,74,100,FMN GV 16 Berchem TOT
54,Posthofbrug 5366,2022-07-07,16:00:00,317,127,190,FMN GV 16 Berchem TOT
54,Posthofbrug 5366,2022-07-07,17:00:00,484,172,312,FMN GV 16 Berchem TOT
54,Posthofbrug 5366,2022-07-07,18:00:00,300,116,184,FMN GV 16 Berchem TOT
54,Posthofbrug 5366,2022-07-07,19:00:00,184,82,102,FMN GV 16 Berchem TOT
54,Posthofbrug 5366,2022-07-07,20:00:00,139,64,75,FMN GV 16 Berchem TOT
54,Posthofbrug 5366,2022-07-07,21:00:00,99,37,62,FMN GV 16 Berchem TOT
54,Posthofbrug 5366,2022-07-07,22:00:00,133,37,96,FMN GV 16 Berchem TOT
54,Posthofbrug 5366,2022-07-07,23:00:00,59,12,47,FMN GV 16 Berchem TOT
54,Posthofbrug 5366,2022-07-08,00:00:00,34,7,27,FMN GV 16 Berchem TOT
54,Posthofbrug 5366,2022-07-08,01:00:00,19,4,15,FMN GV 16 Berchem TOT
54,Posthofbrug 5366,2022-07-08,02:00:00,9,0,9,FMN GV 16 Berchem TOT
54,Posthofbrug 5366,2022-07-08,03:00:00,6,2,4,FMN GV 16 Berchem TOT
54,Posthofbrug 5366,2022-07-08,04:00:00,18,6,12,FMN GV 16 Berchem TOT
54,Posthofbrug 5366,2022-07-08,05:00:00,31,19,12,FMN GV 16 Berchem TOT
54,Posthofbrug 5366,2022-07-08,06:00:00,89,66,23,FMN GV 16 Berchem TOT
54,Posthofbrug 5366,2022-07-08,07:00:00,244,179,65,FMN GV 16 Berchem TOT
54,Posthofbrug 5366,2022-07-08,08:00:00,402,299,103,FMN GV 16 Berchem TOT
54,Posthofbrug 5366,2022-07-08,09:00:00,238,184,54,FMN GV 16 Berchem TOT
54,Posthofbrug 5366,2022-07-08,10:00:00,152,111,41,FMN GV 16 Berchem TOT
54,Posthofbrug 5366,2022-07-08,11:00:00,162,111,51,FMN GV 16 Berchem TOT
54,Posthofbrug 5366,2022-07-08,12:00:00,180,103,77,FMN GV 16 Berchem TOT
54,Posthofbrug 5366,2022-07-08,13:00:00,188,116,72,FMN GV 16 Berchem TOT
54,Posthofbrug 5366,2022-07-08,14:00:00,203,95,108,FMN GV 16 Berchem TOT
54,Posthofbrug 5366,2022-07-08,15:00:00,223,83,140,FMN GV 16 Berchem TOT
54,Posthofbrug 5366,2022-07-08,16:00:00,345,144,201,FMN GV 16 Berchem TOT
54,Posthofbrug 5366,2022-07-08,17:00:00,394,144,250,FMN GV 16 Berchem TOT
54,Posthofbrug 5366,2022-07-08,18:00:00,283,142,141,FMN GV 16 Berchem TOT
54,Posthofbrug 5366,2022-07-08,19:00:00,212,105,107,FMN GV 16 Berchem TOT
54,Posthofbrug 5366,2022-07-08,20:00:00,112,47,65,FMN GV 16 Berchem TOT
54,Posthofbrug 5366,2022-07-08,21:00:00,100,43,57,FMN GV 16 Berchem TOT
54,Posthofbrug 5366,2022-07-08,22:00:00,116,41,75,FMN GV 16 Berchem TOT
54,Posthofbrug 5366,2022-07-08,23:00:00,91,31,60,FMN GV 16 Berchem TOT
54,Posthofbrug 5366,2022-07-09,00:00:00,69,19,50,FMN GV 16 Berchem TOT
54,Posthofbrug 5366,2022-07-09,01:00:00,35,15,20,FMN GV 16 Berchem TOT
54,Posthofbrug 5366,2022-07-09,02:00:00,21,1,20,FMN GV 16 Berchem TOT
54,Posthofbrug 5366,2022-07-09,03:00:00,31,6,25,FMN GV 16 Berchem TOT
54,Posthofbrug 5366,2022-07-09,04:00:00,32,11,21,FMN GV 16 Berchem TOT
54,Posthofbrug 5366,2022-07-09,05:00:00,19,10,9,FMN GV 16 Berchem TOT
54,Posthofbrug 5366,2022-07-09,06:00:00,17,10,7,FMN GV 16 Berchem TOT
54,Posthofbrug 5366,2022-07-09,07:00:00,40,27,13,FMN GV 16 Berchem TOT
54,Posthofbrug 5366,2022-07-09,08:00:00,50,32,18,FMN GV 16 Berchem TOT
54,Posthofbrug 5366,2022-07-09,09:00:00,127,91,36,FMN GV 16 Berchem TOT
54,Posthofbrug 5366,2022-07-09,10:00:00,172,127,45,FMN GV 16 Berchem TOT
54,Posthofbrug 5366,2022-07-09,11:00:00,218,155,63,FMN GV 16 Berchem TOT
54,Posthofbrug 5366,2022-07-09,12:00:00,171,94,77,FMN GV 16 Berchem TOT
54,Posthofbrug 5366,2022-07-09,13:00:00,199,114,85,FMN GV 16 Berchem TOT
54,Posthofbrug 5366,2022-07-09,14:00:00,215,116,99,FMN GV 16 Berchem TOT
54,Posthofbrug 5366,2022-07-09,15:00:00,194,120,74,FMN GV 16 Berchem TOT
54,Posthofbrug 5366,2022-07-09,16:00:00,182,99,83,FMN GV 16 Berchem TOT
54,Posthofbrug 5366,2022-07-09,17:00:00,179,61,118,FMN GV 16 Berchem TOT
54,Posthofbrug 5366,2022-07-09,18:00:00,175,73,102,FMN GV 16 Berchem TOT
54,Posthofbrug 5366,2022-07-09,19:00:00,142,63,79,FMN GV 16 Berchem TOT
54,Posthofbrug 5366,2022-07-09,20:00:00,101,54,47,FMN GV 16 Berchem TOT
54,Posthofbrug 5366,2022-07-09,21:00:00,76,46,30,FMN GV 16 Berchem TOT
54,Posthofbrug 5366,2022-07-09,22:00:00,94,36,58,FMN GV 16 Berchem TOT
54,Posthofbrug 5366,2022-07-09,23:00:00,66,19,47,FMN GV 16 Berchem TOT
54,Posthofbrug 5366,2022-07-10,00:00:00,43,16,27,FMN GV 16 Berchem TOT
54,Posthofbrug 5366,2022-07-10,01:00:00,44,18,26,FMN GV 16 Berchem TOT
54,Posthofbrug 5366,2022-07-10,02:00:00,40,12,28,FMN GV 16 Berchem TOT
54,Posthofbrug 5366,2022-07-10,03:00:00,33,16,17,FMN GV 16 Berchem TOT
54,Posthofbrug 5366,2022-07-10,04:00:00,13,4,9,FMN GV 16 Berchem TOT
54,Posthofbrug 5366,2022-07-10,05:00:00,19,10,9,FMN GV 16 Berchem TOT
54,Posthofbrug 5366,2022-07-10,06:00:00,15,10,5,FMN GV 16 Berchem TOT
54,Posthofbrug 5366,2022-07-10,07:00:00,26,18,8,FMN GV 16 Berchem TOT
54,Posthofbrug 5366,2022-07-10,08:00:00,40,27,13,FMN GV 16 Berchem TOT
54,Posthofbrug 5366,2022-07-10,09:00:00,99,65,34,FMN GV 16 Berchem TOT
54,Posthofbrug 5366,2022-07-10,10:00:00,119,76,43,FMN GV 16 Berchem TOT
54,Posthofbrug 5366,2022-07-10,11:00:00,156,91,65,FMN GV 16 Berchem TOT
54,Posthofbrug 5366,2022-07-10,12:00:00,199,115,84,FMN GV 16 Berchem TOT
54,Posthofbrug 5366,2022-07-10,13:00:00,152,87,65,FMN GV 16 Berchem TOT
54,Posthofbrug 5366,2022-07-10,14:00:00,205,129,76,FMN GV 16 Berchem TOT
54,Posthofbrug 5366,2022-07-10,15:00:00,196,118,78,FMN GV 16 Berchem TOT
54,Posthofbrug 5366,2022-07-10,16:00:00,209,109,100,FMN GV 16 Berchem TOT
54,Posthofbrug 5366,2022-07-10,17:00:00,199,96,103,FMN GV 16 Berchem TOT
54,Posthofbrug 5366,2022-07-10,18:00:00,143,62,81,FMN GV 16 Berchem TOT
54,Posthofbrug 5366,2022-07-10,19:00:00,136,60,76,FMN GV 16 Berchem TOT
54,Posthofbrug 5366,2022-07-10,20:00:00,103,46,57,FMN GV 16 Berchem TOT
54,Posthofbrug 5366,2022-07-10,21:00:00,105,41,64,FMN GV 16 Berchem TOT
54,Posthofbrug 5366,2022-07-10,22:00:00,71,26,45,FMN GV 16 Berchem TOT
54,Posthofbrug 5366,2022-07-10,23:00:00,64,18,46,FMN GV 16 Berchem TOT
54,Posthofbrug 5366,2022-07-11,00:00:00,42,7,35,FMN GV 16 Berchem TOT
54,Posthofbrug 5366,2022-07-11,01:00:00,13,4,9,FMN GV 16 Berchem TOT
54,Posthofbrug 5366,2022-07-11,02:00:00,7,3,4,FMN GV 16 Berchem TOT
54,Posthofbrug 5366,2022-07-11,03:00:00,8,0,8,FMN GV 16 Berchem TOT
54,Posthofbrug 5366,2022-07-11,04:00:00,9,6,3,FMN GV 16 Berchem TOT
54,Posthofbrug 5366,2022-07-11,05:00:00,32,22,10,FMN GV 16 Berchem TOT
54,Posthofbrug 5366,2022-07-11,06:00:00,74,58,16,FMN GV 16 Berchem TOT
54,Posthofbrug 5366,2022-07-11,07:00:00,211,154,57,FMN GV 16 Berchem TOT
54,Posthofbrug 5366,2022-07-11,08:00:00,340,245,95,FMN GV 16 Berchem TOT
54,Posthofbrug 5366,2022-07-11,09:00:00,207,154,53,FMN GV 16 Berchem TOT
54,Posthofbrug 5366,2022-07-11,10:00:00,124,93,31,FMN GV 16 Berchem TOT
54,Posthofbrug 5366,2022-07-11,11:00:00,126,89,37,FMN GV 16 Berchem TOT
54,Posthofbrug 5366,2022-07-11,12:00:00,187,96,91,FMN GV 16 Berchem TOT
54,Posthofbrug 5366,2022-07-11,13:00:00,176,99,77,FMN GV 16 Berchem TOT
54,Posthofbrug 5366,2022-07-11,14:00:00,180,94,86,FMN GV 16 Berchem TOT
54,Posthofbrug 5366,2022-07-11,15:00:00,210,95,115,FMN GV 16 Berchem TOT
54,Posthofbrug 5366,2022-07-11,16:00:00,282,118,164,FMN GV 16 Berchem TOT
54,Posthofbrug 5366,2022-07-11,17:00:00,425,167,258,FMN GV 16 Berchem TOT
54,Posthofbrug 5366,2022-07-11,18:00:00,286,113,173,FMN GV 16 Berchem TOT
54,Posthofbrug 5366,2022-07-11,19:00:00,174,71,103,FMN GV 16 Berchem TOT
54,Posthofbrug 5366,2022-07-11,20:00:00,148,73,75,FMN GV 16 Berchem TOT
54,Posthofbrug 5366,2022-07-11,21:00:00,121,54,67,FMN GV 16 Berchem TOT
54,Posthofbrug 5366,2022-07-11,22:00:00,112,34,78,FMN GV 16 Berchem TOT
54,Posthofbrug 5366,2022-07-11,23:00:00,82,18,64,FMN GV 16 Berchem TOT
54,Posthofbrug 5366,2022-07-12,00:00:00,21,7,14,FMN GV 16 Berchem TOT
54,Posthofbrug 5366,2022-07-12,01:00:00,16,3,13,FMN GV 16 Berchem TOT
54,Posthofbrug 5366,2022-07-12,02:00:00,3,0,3,FMN GV 16 Berchem TOT
54,Posthofbrug 5366,2022-07-12,03:00:00,6,1,5,FMN GV 16 Berchem TOT
54,Posthofbrug 5366,2022-07-12,04:00:00,12,11,1,FMN GV 16 Berchem TOT
54,Posthofbrug 5366,2022-07-12,05:00:00,27,20,7,FMN GV 16 Berchem TOT
54,Posthofbrug 5366,2022-07-12,06:00:00,113,90,23,FMN GV 16 Berchem TOT
54,Posthofbrug 5366,2022-07-12,07:00:00,322,244,78,FMN GV 16 Berchem TOT
54,Posthofbrug 5366,2022-07-12,08:00:00,538,396,142,FMN GV 16 Berchem TOT
54,Posthofbrug 5366,2022-07-12,09:00:00,259,200,59,FMN GV 16 Berchem TOT
54,Posthofbrug 5366,2022-07-12,10:00:00,174,121,53,FMN GV 16 Berchem TOT
54,Posthofbrug 5366,2022-07-12,11:00:00,140,86,54,FMN GV 16 Berchem TOT
54,Posthofbrug 5366,2022-07-12,12:00:00,148,80,68,FMN GV 16 Berchem TOT
54,Posthofbrug 5366,2022-07-12,13:00:00,153,79,74,FMN GV 16 Berchem TOT
54,Posthofbrug 5366,2022-07-12,14:00:00,159,75,84,FMN GV 16 Berchem TOT
54,Posthofbrug 5366,2022-07-12,15:00:00,195,79,116,FMN GV 16 Berchem TOT
54,Posthofbrug 5366,2022-07-12,16:00:00,375,145,230,FMN GV 16 Berchem TOT
54,Posthofbrug 5366,2022-07-12,17:00:00,527,164,363,FMN GV 16 Berchem TOT
54,Posthofbrug 5366,2022-07-12,18:00:00,328,105,223,FMN GV 16 Berchem TOT
54,Posthofbrug 5366,2022-07-12,19:00:00,180,78,102,FMN GV 16 Berchem TOT
54,Posthofbrug 5366,2022-07-12,20:00:00,153,64,89,FMN GV 16 Berchem TOT
54,Posthofbrug 5366,2022-07-12,21:00:00,126,68,58,FMN GV 16 Berchem TOT
54,Posthofbrug 5366,2022-07-12,22:00:00,114,43,71,FMN GV 16 Berchem TOT
54,Posthofbrug 5366,2022-07-12,23:00:00,73,27,46,FMN GV 16 Berchem TOT
54,Posthofbrug 5366,2022-07-13,00:00:00,48,17,31,FMN GV 16 Berchem TOT
54,Posthofbrug 5366,2022-07-13,01:00:00,14,4,10,FMN GV 16 Berchem TOT
54,Posthofbrug 5366,2022-07-13,02:00:00,15,2,13,FMN GV 16 Berchem TOT
54,Posthofbrug 5366,2022-07-13,03:00:00,3,1,2,FMN GV 16 Berchem TOT
54,Posthofbrug 5366,2022-07-13,04:00:00,13,8,5,FMN GV 16 Berchem TOT
54,Posthofbrug 5366,2022-07-13,05:00:00,27,19,8,FMN GV 16 Berchem TOT
54,Posthofbrug 5366,2022-07-13,06:00:00,102,75,27,FMN GV 16 Berchem TOT
54,Posthofbrug 5366,2022-07-13,07:00:00,271,195,76,FMN GV 16 Berchem TOT
54,Posthofbrug 5366,2022-07-13,08:00:00,456,345,111,FMN GV 16 Berchem TOT
54,Posthofbrug 5366,2022-07-13,09:00:00,212,155,57,FMN GV 16 Berchem TOT
54,Posthofbrug 5366,2022-07-13,10:00:00,144,106,38,FMN GV 16 Berchem TOT
54,Posthofbrug 5366,2022-07-13,11:00:00,161,96,65,FMN GV 16 Berchem TOT
54,Posthofbrug 5366,2022-07-13,12:00:00,161,78,83,FMN GV 16 Berchem TOT
54,Posthofbrug 5366,2022-07-13,13:00:00,154,84,70,FMN GV 16 Berchem TOT
54,Posthofbrug 5366,2022-07-13,14:00:00,151,79,72,FMN GV 16 Berchem TOT
54,Posthofbrug 5366,2022-07-13,15:00:00,169,65,104,FMN GV 16 Berchem TOT
54,Posthofbrug 5366,2022-07-13,16:00:00,341,144,197,FMN GV 16 Berchem TOT
54,Posthofbrug 5366,2022-07-13,17:00:00,481,158,323,FMN GV 16 Berchem TOT
54,Posthofbrug 5366,2022-07-13,18:00:00,307,133,174,FMN GV 16 Berchem TOT
54,Posthofbrug 5366,2022-07-13,19:00:00,189,93,96,FMN GV 16 Berchem TOT
54,Posthofbrug 5366,2022-07-13,20:00:00,150,58,92,FMN GV 16 Berchem TOT
54,Posthofbrug 5366,2022-07-13,21:00:00,126,52,74,FMN GV 16 Berchem TOT
54,Posthofbrug 5366,2022-07-13,22:00:00,113,45,68,FMN GV 16 Berchem TOT
54,Posthofbrug 5366,2022-07-13,23:00:00,56,11,45,FMN GV 16 Berchem TOT
54,Posthofbrug 5366,2022-07-14,00:00:00,48,15,33,FMN GV 16 Berchem TOT
54,Posthofbrug 5366,2022-07-14,01:00:00,29,2,27,FMN GV 16 Berchem TOT
54,Posthofbrug 5366,2022-07-14,02:00:00,12,1,11,FMN GV 16 Berchem TOT
54,Posthofbrug 5366,2022-07-14,03:00:00,6,1,5,FMN GV 16 Berchem TOT
54,Posthofbrug 5366,2022-07-14,04:00:00,12,10,2,FMN GV 16 Berchem TOT
54,Posthofbrug 5366,2022-07-14,05:00:00,30,21,9,FMN GV 16 Berchem TOT
54,Posthofbrug 5366,2022-07-14,06:00:00,118,86,32,FMN GV 16 Berchem TOT
54,Posthofbrug 5366,2022-07-14,07:00:00,291,219,72,FMN GV 16 Berchem TOT
54,Posthofbrug 5366,2022-07-14,08:00:00,516,396,120,FMN GV 16 Berchem TOT
54,Posthofbrug 5366,2022-07-14,09:00:00,263,205,58,FMN GV 16 Berchem TOT
54,Posthofbrug 5366,2022-07-14,10:00:00,140,93,47,FMN GV 16 Berchem TOT
54,Posthofbrug 5366,2022-07-14,11:00:00,127,81,46,FMN GV 16 Berchem TOT
54,Posthofbrug 5366,2022-07-14,12:00:00,172,91,81,FMN GV 16 Berchem TOT
54,Posthofbrug 5366,2022-07-14,13:00:00,152,77,75,FMN GV 16 Berchem TOT
54,Posthofbrug 5366,2022-07-14,14:00:00,174,86,88,FMN GV 16 Berchem TOT
54,Posthofbrug 5366,2022-07-14,15:00:00,191,61,130,FMN GV 16 Berchem TOT
54,Posthofbrug 5366,2022-07-14,16:00:00,382,150,232,FMN GV 16 Berchem TOT
54,Posthofbrug 5366,2022-07-14,17:00:00,449,130,319,FMN GV 16 Berchem TOT
54,Posthofbrug 5366,2022-07-14,18:00:00,326,130,196,FMN GV 16 Berchem TOT
54,Posthofbrug 5366,2022-07-14,19:00:00,193,96,97,FMN GV 16 Berchem TOT
54,Posthofbrug 5366,2022-07-14,20:00:00,132,64,68,FMN GV 16 Berchem TOT
54,Posthofbrug 5366,2022-07-14,21:00:00,115,51,64,FMN GV 16 Berchem TOT
54,Posthofbrug 5366,2022-07-14,22:00:00,97,37,60,FMN GV 16 Berchem TOT
54,Posthofbrug 5366,2022-07-14,23:00:00,76,20,56,FMN GV 16 Berchem TOT
54,Posthofbrug 5366,2022-07-15,00:00:00,42,13,29,FMN GV 16 Berchem TOT
54,Posthofbrug 5366,2022-07-15,01:00:00,28,2,26,FMN GV 16 Berchem TOT
54,Posthofbrug 5366,2022-07-15,02:00:00,6,0,6,FMN GV 16 Berchem TOT
54,Posthofbrug 5366,2022-07-15,03:00:00,7,3,4,FMN GV 16 Berchem TOT
54,Posthofbrug 5366,2022-07-15,04:00:00,12,8,4,FMN GV 16 Berchem TOT
54,Posthofbrug 5366,2022-07-15,05:00:00,24,17,7,FMN GV 16 Berchem TOT
54,Posthofbrug 5366,2022-07-15,06:00:00,81,57,24,FMN GV 16 Berchem TOT
54,Posthofbrug 5366,2022-07-15,07:00:00,201,151,50,FMN GV 16 Berchem TOT
54,Posthofbrug 5366,2022-07-15,08:00:00,346,257,89,FMN GV 16 Berchem TOT
54,Posthofbrug 5366,2022-07-15,09:00:00,230,177,53,FMN GV 16 Berchem TOT
54,Posthofbrug 5366,2022-07-15,10:00:00,148,101,47,FMN GV 16 Berchem TOT
54,Posthofbrug 5366,2022-07-15,11:00:00,157,113,44,FMN GV 16 Berchem TOT
54,Posthofbrug 5366,2022-07-15,12:00:00,169,76,93,FMN GV 16 Berchem TOT
54,Posthofbrug 5366,2022-07-15,13:00:00,187,109,78,FMN GV 16 Berchem TOT
54,Posthofbrug 5366,2022-07-15,14:00:00,195,99,96,FMN GV 16 Berchem TOT
54,Posthofbrug 5366,2022-07-15,15:00:00,223,97,126,FMN GV 16 Berchem TOT
54,Posthofbrug 5366,2022-07-15,16:00:00,313,122,191,FMN GV 16 Berchem TOT
54,Posthofbrug 5366,2022-07-15,17:00:00,359,130,229,FMN GV 16 Berchem TOT
54,Posthofbrug 5366,2022-07-15,18:00:00,247,104,143,FMN GV 16 Berchem TOT
54,Posthofbrug 5366,2022-07-15,19:00:00,171,75,96,FMN GV 16 Berchem TOT
54,Posthofbrug 5366,2022-07-15,20:00:00,117,54,63,FMN GV 16 Berchem TOT
54,Posthofbrug 5366,2022-07-15,21:00:00,94,37,57,FMN GV 16 Berchem TOT
54,Posthofbrug 5366,2022-07-15,22:00:00,68,28,40,FMN GV 16 Berchem TOT
54,Posthofbrug 5366,2022-07-15,23:00:00,78,22,56,FMN GV 16 Berchem TOT
54,Posthofbrug 5366,2022-07-16,00:00:00,73,21,52,FMN GV 16 Berchem TOT
54,Posthofbrug 5366,2022-07-16,01:00:00,36,16,20,FMN GV 16 Berchem TOT
54,Posthofbrug 5366,2022-07-16,02:00:00,20,6,14,FMN GV 16 Berchem TOT
54,Posthofbrug 5366,2022-07-16,03:00:00,10,1,9,FMN GV 16 Berchem TOT
54,Posthofbrug 5366,2022-07-16,04:00:00,14,6,8,FMN GV 16 Berchem TOT
54,Posthofbrug 5366,2022-07-16,05:00:00,20,13,7,FMN GV 16 Berchem TOT
54,Posthofbrug 5366,2022-07-16,06:00:00,33,21,12,FMN GV 16 Berchem TOT
54,Posthofbrug 5366,2022-07-16,07:00:00,49,29,20,FMN GV 16 Berchem TOT
54,Posthofbrug 5366,2022-07-16,08:00:00,63,47,16,FMN GV 16 Berchem TOT
54,Posthofbrug 5366,2022-07-16,09:00:00,126,95,31,FMN GV 16 Berchem TOT
54,Posthofbrug 5366,2022-07-16,10:00:00,157,109,48,FMN GV 16 Berchem TOT
54,Posthofbrug 5366,2022-07-16,11:00:00,181,106,75,FMN GV 16 Berchem TOT
54,Posthofbrug 5366,2022-07-16,12:00:00,178,111,67,FMN GV 16 Berchem TOT
54,Posthofbrug 5366,2022-07-16,13:00:00,175,104,71,FMN GV 16 Berchem TOT
54,Posthofbrug 5366,2022-07-16,14:00:00,194,121,73,FMN GV 16 Berchem TOT
54,Posthofbrug 5366,2022-07-16,15:00:00,195,98,97,FMN GV 16 Berchem TOT
54,Posthofbrug 5366,2022-07-16,16:00:00,198,73,125,FMN GV 16 Berchem TOT
54,Posthofbrug 5366,2022-07-16,17:00:00,192,72,120,FMN GV 16 Berchem TOT
54,Posthofbrug 5366,2022-07-16,18:00:00,190,83,107,FMN GV 16 Berchem TOT
54,Posthofbrug 5366,2022-07-16,19:00:00,142,54,88,FMN GV 16 Berchem TOT
54,Posthofbrug 5366,2022-07-16,20:00:00,103,57,46,FMN GV 16 Berchem TOT
54,Posthofbrug 5366,2022-07-16,21:00:00,67,39,28,FMN GV 16 Berchem TOT
54,Posthofbrug 5366,2022-07-16,22:00:00,61,15,46,FMN GV 16 Berchem TOT
54,Posthofbrug 5366,2022-07-16,23:00:00,66,24,42,FMN GV 16 Berchem TOT
54,Posthofbrug 5366,2022-07-17,00:00:00,45,16,29,FMN GV 16 Berchem TOT
54,Posthofbrug 5366,2022-07-17,01:00:00,33,14,19,FMN GV 16 Berchem TOT
54,Posthofbrug 5366,2022-07-17,02:00:00,32,5,27,FMN GV 16 Berchem TOT
54,Posthofbrug 5366,2022-07-17,03:00:00,22,8,14,FMN GV 16 Berchem TOT
54,Posthofbrug 5366,2022-07-17,04:00:00,14,3,11,FMN GV 16 Berchem TOT
54,Posthofbrug 5366,2022-07-17,05:00:00,15,9,6,FMN GV 16 Berchem TOT
54,Posthofbrug 5366,2022-07-17,06:00:00,24,17,7,FMN GV 16 Berchem TOT
54,Posthofbrug 5366,2022-07-17,07:00:00,44,23,21,FMN GV 16 Berchem TOT
54,Posthofbrug 5366,2022-07-17,08:00:00,72,44,28,FMN GV 16 Berchem TOT
54,Posthofbrug 5366,2022-07-17,09:00:00,90,57,33,FMN GV 16 Berchem TOT
54,Posthofbrug 5366,2022-07-17,10:00:00,164,106,58,FMN GV 16 Berchem TOT
54,Posthofbrug 5366,2022-07-17,11:00:00,155,90,65,FMN GV 16 Berchem TOT
54,Posthofbrug 5366,2022-07-17,12:00:00,163,90,73,FMN GV 16 Berchem TOT
54,Posthofbrug 5366,2022-07-17,13:00:00,205,104,101,FMN GV 16 Berchem TOT
54,Posthofbrug 5366,2022-07-17,14:00:00,179,99,80,FMN GV 16 Berchem TOT
54,Posthofbrug 5366,2022-07-17,15:00:00,176,88,88,FMN GV 16 Berchem TOT
54,Posthofbrug 5366,2022-07-17,16:00:00,170,69,101,FMN GV 16 Berchem TOT
54,Posthofbrug 5366,2022-07-17,17:00:00,144,70,74,FMN GV 16 Berchem TOT
54,Posthofbrug 5366,2022-07-17,18:00:00,161,78,83,FMN GV 16 Berchem TOT
54,Posthofbrug 5366,2022-07-17,19:00:00,100,41,59,FMN GV 16 Berchem TOT
54,Posthofbrug 5366,2022-07-17,20:00:00,132,52,80,FMN GV 16 Berchem TOT
54,Posthofbrug 5366,2022-07-17,21:00:00,86,42,44,FMN GV 16 Berchem TOT
54,Posthofbrug 5366,2022-07-17,22:00:00,65,32,33,FMN GV 16 Berchem TOT
54,Posthofbrug 5366,2022-07-17,23:00:00,42,25,17,FMN GV 16 Berchem TOT
54,Posthofbrug 5366,2022-07-18,00:00:00,23,11,12,FMN GV 16 Berchem TOT
54,Posthofbrug 5366,2022-07-18,01:00:00,16,3,13,FMN GV 16 Berchem TOT
54,Posthofbrug 5366,2022-07-18,02:00:00,8,0,8,FMN GV 16 Berchem TOT
54,Posthofbrug 5366,2022-07-18,03:00:00,5,1,4,FMN GV 16 Berchem TOT
54,Posthofbrug 5366,2022-07-18,04:00:00,13,2,11,FMN GV 16 Berchem TOT
54,Posthofbrug 5366,2022-07-18,05:00:00,25,18,7,FMN GV 16 Berchem TOT
54,Posthofbrug 5366,2022-07-18,06:00:00,98,73,25,FMN GV 16 Berchem TOT
54,Posthofbrug 5366,2022-07-18,07:00:00,252,183,69,FMN GV 16 Berchem TOT
54,Posthofbrug 5366,2022-07-18,08:00:00,423,333,90,FMN GV 16 Berchem TOT
54,Posthofbrug 5366,2022-07-18,09:00:00,194,152,42,FMN GV 16 Berchem TOT
54,Posthofbrug 5366,2022-07-18,10:00:00,157,96,61,FMN GV 16 Berchem TOT
54,Posthofbrug 5366,2022-07-18,11:00:00,107,60,47,FMN GV 16 Berchem TOT
54,Posthofbrug 5366,2022-07-18,12:00:00,112,47,65,FMN GV 16 Berchem TOT
54,Posthofbrug 5366,2022-07-18,13:00:00,124,57,67,FMN GV 16 Berchem TOT
54,Posthofbrug 5366,2022-07-18,14:00:00,122,64,58,FMN GV 16 Berchem TOT
54,Posthofbrug 5366,2022-07-18,15:00:00,140,55,85,FMN GV 16 Berchem TOT
54,Posthofbrug 5366,2022-07-18,16:00:00,247,87,160,FMN GV 16 Berchem TOT
54,Posthofbrug 5366,2022-07-18,17:00:00,391,107,284,FMN GV 16 Berchem TOT
54,Posthofbrug 5366,2022-07-18,18:00:00,236,81,155,FMN GV 16 Berchem TOT
54,Posthofbrug 5366,2022-07-18,19:00:00,125,54,71,FMN GV 16 Berchem TOT
54,Posthofbrug 5366,2022-07-18,20:00:00,107,57,50,FMN GV 16 Berchem TOT
54,Posthofbrug 5366,2022-07-18,21:00:00,77,40,37,FMN GV 16 Berchem TOT
54,Posthofbrug 5366,2022-07-18,22:00:00,74,33,41,FMN GV 16 Berchem TOT
54,Posthofbrug 5366,2022-07-18,23:00:00,50,20,30,FMN GV 16 Berchem TOT
54,Posthofbrug 5366,2022-07-19,00:00:00,18,5,13,FMN GV 16 Berchem TOT
54,Posthofbrug 5366,2022-07-19,01:00:00,12,2,10,FMN GV 16 Berchem TOT
54,Posthofbrug 5366,2022-07-19,02:00:00,14,4,10,FMN GV 16 Berchem TOT
54,Posthofbrug 5366,2022-07-19,03:00:00,8,2,6,FMN GV 16 Berchem TOT
54,Posthofbrug 5366,2022-07-19,04:00:00,7,3,4,FMN GV 16 Berchem TOT
54,Posthofbrug 5366,2022-07-19,05:00:00,31,22,9,FMN GV 16 Berchem TOT
54,Posthofbrug 5366,2022-07-19,06:00:00,84,60,24,FMN GV 16 Berchem TOT
54,Posthofbrug 5366,2022-07-19,07:00:00,212,158,54,FMN GV 16 Berchem TOT
54,Posthofbrug 5366,2022-07-19,08:00:00,404,299,105,FMN GV 16 Berchem TOT
54,Posthofbrug 5366,2022-07-19,09:00:00,174,128,46,FMN GV 16 Berchem TOT
54,Posthofbrug 5366,2022-07-19,10:00:00,117,71,46,FMN GV 16 Berchem TOT
54,Posthofbrug 5366,2022-07-19,11:00:00,86,42,44,FMN GV 16 Berchem TOT
54,Posthofbrug 5366,2022-07-19,12:00:00,81,35,46,FMN GV 16 Berchem TOT
54,Posthofbrug 5366,2022-07-19,13:00:00,90,43,47,FMN GV 16 Berchem TOT
54,Posthofbrug 5366,2022-07-19,14:00:00,90,44,46,FMN GV 16 Berchem TOT
54,Posthofbrug 5366,2022-07-19,15:00:00,132,50,82,FMN GV 16 Berchem TOT
54,Posthofbrug 5366,2022-07-19,16:00:00,222,101,121,FMN GV 16 Berchem TOT
54,Posthofbrug 5366,2022-07-19,17:00:00,304,95,209,FMN GV 16 Berchem TOT
54,Posthofbrug 5366,2022-07-19,18:00:00,197,70,127,FMN GV 16 Berchem TOT
54,Posthofbrug 5366,2022-07-19,19:00:00,118,49,69,FMN GV 16 Berchem TOT
54,Posthofbrug 5366,2022-07-19,20:00:00,91,46,45,FMN GV 16 Berchem TOT
54,Posthofbrug 5366,2022-07-19,21:00:00,99,54,45,FMN GV 16 Berchem TOT
54,Posthofbrug 5366,2022-07-19,22:00:00,56,22,34,FMN GV 16 Berchem TOT
54,Posthofbrug 5366,2022-07-19,23:00:00,55,26,29,FMN GV 16 Berchem TOT
54,Posthofbrug 5366,2022-07-20,00:00:00,28,13,15,FMN GV 16 Berchem TOT
54,Posthofbrug 5366,2022-07-20,01:00:00,18,7,11,FMN GV 16 Berchem TOT
54,Posthofbrug 5366,2022-07-20,02:00:00,4,1,3,FMN GV 16 Berchem TOT
54,Posthofbrug 5366,2022-07-20,03:00:00,4,0,4,FMN GV 16 Berchem TOT
54,Posthofbrug 5366,2022-07-20,04:00:00,11,5,6,FMN GV 16 Berchem TOT
54,Posthofbrug 5366,2022-07-20,05:00:00,28,21,7,FMN GV 16 Berchem TOT
54,Posthofbrug 5366,2022-07-20,06:00:00,81,63,18,FMN GV 16 Berchem TOT
54,Posthofbrug 5366,2022-07-20,07:00:00,190,140,50,FMN GV 16 Berchem TOT
54,Posthofbrug 5366,2022-07-20,08:00:00,297,230,67,FMN GV 16 Berchem TOT
54,Posthofbrug 5366,2022-07-20,09:00:00,184,120,64,FMN GV 16 Berchem TOT
54,Posthofbrug 5366,2022-07-20,10:00:00,81,58,23,FMN GV 16 Berchem TOT
54,Posthofbrug 5366,2022-07-20,11:00:00,91,55,36,FMN GV 16 Berchem TOT
54,Posthofbrug 5366,2022-07-20,12:00:00,96,56,40,FMN GV 16 Berchem TOT
54,Posthofbrug 5366,2022-07-20,13:00:00,126,55,71,FMN GV 16 Berchem TOT
54,Posthofbrug 5366,2022-07-20,14:00:00,122,71,51,FMN GV 16 Berchem TOT
54,Posthofbrug 5366,2022-07-20,15:00:00,146,54,92,FMN GV 16 Berchem TOT
54,Posthofbrug 5366,2022-07-20,16:00:00,203,72,131,FMN GV 16 Berchem TOT
54,Posthofbrug 5366,2022-07-20,17:00:00,322,132,190,FMN GV 16 Berchem TOT
54,Posthofbrug 5366,2022-07-20,18:00:00,219,86,133,FMN GV 16 Berchem TOT
54,Posthofbrug 5366,2022-07-20,19:00:00,121,46,75,FMN GV 16 Berchem TOT
54,Posthofbrug 5366,2022-07-20,20:00:00,75,32,43,FMN GV 16 Berchem TOT
54,Posthofbrug 5366,2022-07-20,21:00:00,59,30,29,FMN GV 16 Berchem TOT
54,Posthofbrug 5366,2022-07-20,22:00:00,51,12,39,FMN GV 16 Berchem TOT
54,Posthofbrug 5366,2022-07-20,23:00:00,36,14,22,FMN GV 16 Berchem TOT
54,Posthofbrug 5366,2022-07-21,00:00:00,35,10,25,FMN GV 16 Berchem TOT
54,Posthofbrug 5366,2022-07-21,01:00:00,30,7,23,FMN GV 16 Berchem TOT
54,Posthofbrug 5366,2022-07-21,02:00:00,9,0,9,FMN GV 16 Berchem TOT
54,Posthofbrug 5366,2022-07-21,03:00:00,7,1,6,FMN GV 16 Berchem TOT
54,Posthofbrug 5366,2022-07-21,04:00:00,9,5,4,FMN GV 16 Berchem TOT
54,Posthofbrug 5366,2022-07-21,05:00:00,15,8,7,FMN GV 16 Berchem TOT
54,Posthofbrug 5366,2022-07-21,06:00:00,21,13,8,FMN GV 16 Berchem TOT
54,Posthofbrug 5366,2022-07-21,07:00:00,33,19,14,FMN GV 16 Berchem TOT
54,Posthofbrug 5366,2022-07-21,08:00:00,25,18,7,FMN GV 16 Berchem TOT
54,Posthofbrug 5366,2022-07-21,09:00:00,26,18,8,FMN GV 16 Berchem TOT
54,Posthofbrug 5366,2022-07-21,10:00:00,37,16,21,FMN GV 16 Berchem TOT
54,Posthofbrug 5366,2022-07-21,11:00:00,58,41,17,FMN GV 16 Berchem TOT
54,Posthofbrug 5366,2022-07-21,12:00:00,69,45,24,FMN GV 16 Berchem TOT
54,Posthofbrug 5366,2022-07-21,13:00:00,82,56,26,FMN GV 16 Berchem TOT
54,Posthofbrug 5366,2022-07-21,14:00:00,106,63,43,FMN GV 16 Berchem TOT
54,Posthofbrug 5366,2022-07-21,15:00:00,100,62,38,FMN GV 16 Berchem TOT
54,Posthofbrug 5366,2022-07-21,16:00:00,126,83,43,FMN GV 16 Berchem TOT
54,Posthofbrug 5366,2022-07-21,17:00:00,100,36,64,FMN GV 16 Berchem TOT
54,Posthofbrug 5366,2022-07-21,18:00:00,92,39,53,FMN GV 16 Berchem TOT
54,Posthofbrug 5366,2022-07-21,19:00:00,84,40,44,FMN GV 16 Berchem TOT
54,Posthofbrug 5366,2022-07-21,20:00:00,97,46,51,FMN GV 16 Berchem TOT
54,Posthofbrug 5366,2022-07-21,21:00:00,59,35,24,FMN GV 16 Berchem TOT
54,Posthofbrug 5366,2022-07-21,22:00:00,81,31,50,FMN GV 16 Berchem TOT
54,Posthofbrug 5366,2022-07-21,23:00:00,41,21,20,FMN GV 16 Berchem TOT
54,Posthofbrug 5366,2022-07-22,00:00:00,28,5,23,FMN GV 16 Berchem TOT
54,Posthofbrug 5366,2022-07-22,01:00:00,20,2,18,FMN GV 16 Berchem TOT
54,Posthofbrug 5366,2022-07-22,02:00:00,10,5,5,FMN GV 16 Berchem TOT
54,Posthofbrug 5366,2022-07-22,03:00:00,6,2,4,FMN GV 16 Berchem TOT
54,Posthofbrug 5366,2022-07-22,04:00:00,9,5,4,FMN GV 16 Berchem TOT
54,Posthofbrug 5366,2022-07-22,05:00:00,17,10,7,FMN GV 16 Berchem TOT
54,Posthofbrug 5366,2022-07-22,06:00:00,40,29,11,FMN GV 16 Berchem TOT
54,Posthofbrug 5366,2022-07-22,07:00:00,107,80,27,FMN GV 16 Berchem TOT
54,Posthofbrug 5366,2022-07-22,08:00:00,196,160,36,FMN GV 16 Berchem TOT
54,Posthofbrug 5366,2022-07-22,09:00:00,136,108,28,FMN GV 16 Berchem TOT
54,Posthofbrug 5366,2022-07-22,10:00:00,154,116,38,FMN GV 16 Berchem TOT
54,Posthofbrug 5366,2022-07-22,11:00:00,208,156,52,FMN GV 16 Berchem TOT
54,Posthofbrug 5366,2022-07-22,12:00:00,196,131,65,FMN GV 16 Berchem TOT
54,Posthofbrug 5366,2022-07-22,13:00:00,266,190,76,FMN GV 16 Berchem TOT
54,Posthofbrug 5366,2022-07-22,14:00:00,276,167,109,FMN GV 16 Berchem TOT
54,Posthofbrug 5366,2022-07-22,15:00:00,236,134,102,FMN GV 16 Berchem TOT
54,Posthofbrug 5366,2022-07-22,16:00:00,303,113,190,FMN GV 16 Berchem TOT
54,Posthofbrug 5366,2022-07-22,17:00:00,285,93,192,FMN GV 16 Berchem TOT
54,Posthofbrug 5366,2022-07-22,18:00:00,286,91,195,FMN GV 16 Berchem TOT
54,Posthofbrug 5366,2022-07-22,19:00:00,154,49,105,FMN GV 16 Berchem TOT
54,Posthofbrug 5366,2022-07-22,20:00:00,114,39,75,FMN GV 16 Berchem TOT
54,Posthofbrug 5366,2022-07-22,21:00:00,76,43,33,FMN GV 16 Berchem TOT
54,Posthofbrug 5366,2022-07-22,22:00:00,83,28,55,FMN GV 16 Berchem TOT
54,Posthofbrug 5366,2022-07-22,23:00:00,62,9,53,FMN GV 16 Berchem TOT
54,Posthofbrug 5366,2022-07-23,00:00:00,53,7,46,FMN GV 16 Berchem TOT
54,Posthofbrug 5366,2022-07-23,01:00:00,31,4,27,FMN GV 16 Berchem TOT
54,Posthofbrug 5366,2022-07-23,02:00:00,53,6,47,FMN GV 16 Berchem TOT
54,Posthofbrug 5366,2022-07-23,03:00:00,25,5,20,FMN GV 16 Berchem TOT
54,Posthofbrug 5366,2022-07-23,04:00:00,14,1,13,FMN GV 16 Berchem TOT
54,Posthofbrug 5366,2022-07-23,05:00:00,17,7,10,FMN GV 16 Berchem TOT
54,Posthofbrug 5366,2022-07-23,06:00:00,21,12,9,FMN GV 16 Berchem TOT
54,Posthofbrug 5366,2022-07-23,07:00:00,41,27,14,FMN GV 16 Berchem TOT
54,Posthofbrug 5366,2022-07-23,08:00:00,68,47,21,FMN GV 16 Berchem TOT
54,Posthofbrug 5366,2022-07-23,09:00:00,131,103,28,FMN GV 16 Berchem TOT
54,Posthofbrug 5366,2022-07-23,10:00:00,186,149,37,FMN GV 16 Berchem TOT
54,Posthofbrug 5366,2022-07-23,11:00:00,244,192,52,FMN GV 16 Berchem TOT
54,Posthofbrug 5366,2022-07-23,12:00:00,228,158,70,FMN GV 16 Berchem TOT
54,Posthofbrug 5366,2022-07-23,13:00:00,326,231,95,FMN GV 16 Berchem TOT
54,Posthofbrug 5366,2022-07-23,14:00:00,403,284,119,FMN GV 16 Berchem TOT
54,Posthofbrug 5366,2022-07-23,15:00:00,269,150,119,FMN GV 16 Berchem TOT
54,Posthofbrug 5366,2022-07-23,16:00:00,333,133,200,FMN GV 16 Berchem TOT
54,Posthofbrug 5366,2022-07-23,17:00:00,288,106,182,FMN GV 16 Berchem TOT
54,Posthofbrug 5366,2022-07-23,18:00:00,234,91,143,FMN GV 16 Berchem TOT
54,Posthofbrug 5366,2022-07-23,19:00:00,278,133,145,FMN GV 16 Berchem TOT
54,Posthofbrug 5366,2022-07-23,20:00:00,158,69,89,FMN GV 16 Berchem TOT
54,Posthofbrug 5366,2022-07-23,21:00:00,123,56,67,FMN GV 16 Berchem TOT
54,Posthofbrug 5366,2022-07-23,22:00:00,108,47,61,FMN GV 16 Berchem TOT
54,Posthofbrug 5366,2022-07-23,23:00:00,156,24,132,FMN GV 16 Berchem TOT
54,Posthofbrug 5366,2022-07-24,00:00:00,132,20,112,FMN GV 16 Berchem TOT
54,Posthofbrug 5366,2022-07-24,01:00:00,49,7,42,FMN GV 16 Berchem TOT
54,Posthofbrug 5366,2022-07-24,02:00:00,30,3,27,FMN GV 16 Berchem TOT
54,Posthofbrug 5366,2022-07-24,03:00:00,31,0,31,FMN GV 16 Berchem TOT
54,Posthofbrug 5366,2022-07-24,04:00:00,11,3,8,FMN GV 16 Berchem TOT
54,Posthofbrug 5366,2022-07-24,05:00:00,18,6,12,FMN GV 16 Berchem TOT
54,Posthofbrug 5366,2022-07-24,06:00:00,20,7,13,FMN GV 16 Berchem TOT
54,Posthofbrug 5366,2022-07-24,07:00:00,32,20,12,FMN GV 16 Berchem TOT
54,Posthofbrug 5366,2022-07-24,08:00:00,48,30,18,FMN GV 16 Berchem TOT
54,Posthofbrug 5366,2022-07-24,09:00:00,150,118,32,FMN GV 16 Berchem TOT
54,Posthofbrug 5366,2022-07-24,10:00:00,286,221,65,FMN GV 16 Berchem TOT
54,Posthofbrug 5366,2022-07-24,11:00:00,276,197,79,FMN GV 16 Berchem TOT
54,Posthofbrug 5366,2022-07-24,12:00:00,285,171,114,FMN GV 16 Berchem TOT
54,Posthofbrug 5366,2022-07-24,13:00:00,340,223,117,FMN GV 16 Berchem TOT
54,Posthofbrug 5366,2022-07-24,14:00:00,314,187,127,FMN GV 16 Berchem TOT
54,Posthofbrug 5366,2022-07-24,15:00:00,277,115,162,FMN GV 16 Berchem TOT
54,Posthofbrug 5366,2022-07-24,16:00:00,246,105,141,FMN GV 16 Berchem TOT
54,Posthofbrug 5366,2022-07-24,17:00:00,220,115,105,FMN GV 16 Berchem TOT
54,Posthofbrug 5366,2022-07-24,18:00:00,209,71,138,FMN GV 16 Berchem TOT
54,Posthofbrug 5366,2022-07-24,19:00:00,163,50,113,FMN GV 16 Berchem TOT
54,Posthofbrug 5366,2022-07-24,20:00:00,128,54,74,FMN GV 16 Berchem TOT
54,Posthofbrug 5366,2022-07-24,21:00:00,119,47,72,FMN GV 16 Berchem TOT
54,Posthofbrug 5366,2022-07-24,22:00:00,95,36,59,FMN GV 16 Berchem TOT
54,Posthofbrug 5366,2022-07-24,23:00:00,88,23,65,FMN GV 16 Berchem TOT
54,Posthofbrug 5366,2022-07-25,00:00:00,23,4,19,FMN GV 16 Berchem TOT
54,Posthofbrug 5366,2022-07-25,01:00:00,10,1,9,FMN GV 16 Berchem TOT
54,Posthofbrug 5366,2022-07-25,02:00:00,4,1,3,FMN GV 16 Berchem TOT
54,Posthofbrug 5366,2022-07-25,03:00:00,8,3,5,FMN GV 16 Berchem TOT
54,Posthofbrug 5366,2022-07-25,04:00:00,15,9,6,FMN GV 16 Berchem TOT
54,Posthofbrug 5366,2022-07-25,05:00:00,33,25,8,FMN GV 16 Berchem TOT
54,Posthofbrug 5366,2022-07-25,06:00:00,84,64,20,FMN GV 16 Berchem TOT
54,Posthofbrug 5366,2022-07-25,07:00:00,240,184,56,FMN GV 16 Berchem TOT
54,Posthofbrug 5366,2022-07-25,08:00:00,411,328,83,FMN GV 16 Berchem TOT
54,Posthofbrug 5366,2022-07-25,09:00:00,215,177,38,FMN GV 16 Berchem TOT
54,Posthofbrug 5366,2022-07-25,10:00:00,154,110,44,FMN GV 16 Berchem TOT
54,Posthofbrug 5366,2022-07-25,11:00:00,161,116,45,FMN GV 16 Berchem TOT
54,Posthofbrug 5366,2022-07-25,12:00:00,139,79,60,FMN GV 16 Berchem TOT
54,Posthofbrug 5366,2022-07-25,13:00:00,174,89,85,FMN GV 16 Berchem TOT
54,Posthofbrug 5366,2022-07-25,14:00:00,144,60,84,FMN GV 16 Berchem TOT
54,Posthofbrug 5366,2022-07-25,15:00:00,185,85,100,FMN GV 16 Berchem TOT
54,Posthofbrug 5366,2022-07-25,16:00:00,329,106,223,FMN GV 16 Berchem TOT
54,Posthofbrug 5366,2022-07-25,17:00:00,417,87,330,FMN GV 16 Berchem TOT
54,Posthofbrug 5366,2022-07-25,18:00:00,328,120,208,FMN GV 16 Berchem TOT
54,Posthofbrug 5366,2022-07-25,19:00:00,131,43,88,FMN GV 16 Berchem TOT
54,Posthofbrug 5366,2022-07-25,20:00:00,101,40,61,FMN GV 16 Berchem TOT
54,Posthofbrug 5366,2022-07-25,21:00:00,61,37,24,FMN GV 16 Berchem TOT
54,Posthofbrug 5366,2022-07-25,22:00:00,73,26,47,FMN GV 16 Berchem TOT
54,Posthofbrug 5366,2022-07-25,23:00:00,40,17,23,FMN GV 16 Berchem TOT
54,Posthofbrug 5366,2022-07-26,00:00:00,21,4,17,FMN GV 16 Berchem TOT
54,Posthofbrug 5366,2022-07-26,01:00:00,18,6,12,FMN GV 16 Berchem TOT
54,Posthofbrug 5366,2022-07-26,02:00:00,6,4,2,FMN GV 16 Berchem TOT
54,Posthofbrug 5366,2022-07-26,03:00:00,2,1,1,FMN GV 16 Berchem TOT
54,Posthofbrug 5366,2022-07-26,04:00:00,10,6,4,FMN GV 16 Berchem TOT
54,Posthofbrug 5366,2022-07-26,05:00:00,30,22,8,FMN GV 16 Berchem TOT
54,Posthofbrug 5366,2022-07-26,06:00:00,100,84,16,FMN GV 16 Berchem TOT
54,Posthofbrug 5366,2022-07-26,07:00:00,264,206,58,FMN GV 16 Berchem TOT
54,Posthofbrug 5366,2022-07-26,08:00:00,460,352,108,FMN GV 16 Berchem TOT
54,Posthofbrug 5366,2022-07-26,09:00:00,197,150,47,FMN GV 16 Berchem TOT
54,Posthofbrug 5366,2022-07-26,10:00:00,133,92,41,FMN GV 16 Berchem TOT
54,Posthofbrug 5366,2022-07-26,11:00:00,81,41,40,FMN GV 16 Berchem TOT
54,Posthofbrug 5366,2022-07-26,12:00:00,106,53,53,FMN GV 16 Berchem TOT
54,Posthofbrug 5366,2022-07-26,13:00:00,90,56,34,FMN GV 16 Berchem TOT
54,Posthofbrug 5366,2022-07-26,14:00:00,65,24,41,FMN GV 16 Berchem TOT
54,Posthofbrug 5366,2022-07-26,15:00:00,108,38,70,FMN GV 16 Berchem TOT
54,Posthofbrug 5366,2022-07-26,16:00:00,255,86,169,FMN GV 16 Berchem TOT
54,Posthofbrug 5366,2022-07-26,17:00:00,401,114,287,FMN GV 16 Berchem TOT
54,Posthofbrug 5366,2022-07-26,18:00:00,274,88,186,FMN GV 16 Berchem TOT
54,Posthofbrug 5366,2022-07-26,19:00:00,146,62,84,FMN GV 16 Berchem TOT
54,Posthofbrug 5366,2022-07-26,20:00:00,89,49,40,FMN GV 16 Berchem TOT
54,Posthofbrug 5366,2022-07-26,21:00:00,79,35,44,FMN GV 16 Berchem TOT
54,Posthofbrug 5366,2022-07-26,22:00:00,66,26,40,FMN GV 16 Berchem TOT
54,Posthofbrug 5366,2022-07-26,23:00:00,53,19,34,FMN GV 16 Berchem TOT
54,Posthofbrug 5366,2022-07-27,00:00:00,18,5,13,FMN GV 16 Berchem TOT
54,Posthofbrug 5366,2022-07-27,01:00:00,14,2,12,FMN GV 16 Berchem TOT
54,Posthofbrug 5366,2022-07-27,02:00:00,4,1,3,FMN GV 16 Berchem TOT
54,Posthofbrug 5366,2022-07-27,03:00:00,7,1,6,FMN GV 16 Berchem TOT
54,Posthofbrug 5366,2022-07-27,04:00:00,14,10,4,FMN GV 16 Berchem TOT
54,Posthofbrug 5366,2022-07-27,05:00:00,33,23,10,FMN GV 16 Berchem TOT
54,Posthofbrug 5366,2022-07-27,06:00:00,87,62,25,FMN GV 16 Berchem TOT
54,Posthofbrug 5366,2022-07-27,07:00:00,265,192,73,FMN GV 16 Berchem TOT
54,Posthofbrug 5366,2022-07-27,08:00:00,393,322,71,FMN GV 16 Berchem TOT
54,Posthofbrug 5366,2022-07-27,09:00:00,205,152,53,FMN GV 16 Berchem TOT
54,Posthofbrug 5366,2022-07-27,10:00:00,125,82,43,FMN GV 16 Berchem TOT
54,Posthofbrug 5366,2022-07-27,11:00:00,133,84,49,FMN GV 16 Berchem TOT
54,Posthofbrug 5366,2022-07-27,12:00:00,145,80,65,FMN GV 16 Berchem TOT
54,Posthofbrug 5366,2022-07-27,13:00:00,151,92,59,FMN GV 16 Berchem TOT
54,Posthofbrug 5366,2022-07-27,14:00:00,139,76,63,FMN GV 16 Berchem TOT
54,Posthofbrug 5366,2022-07-27,15:00:00,188,76,112,FMN GV 16 Berchem TOT
54,Posthofbrug 5366,2022-07-27,16:00:00,318,124,194,FMN GV 16 Berchem TOT
54,Posthofbrug 5366,2022-07-27,17:00:00,441,130,311,FMN GV 16 Berchem TOT
54,Posthofbrug 5366,2022-07-27,18:00:00,294,99,195,FMN GV 16 Berchem TOT
54,Posthofbrug 5366,2022-07-27,19:00:00,174,72,102,FMN GV 16 Berchem TOT
54,Posthofbrug 5366,2022-07-27,20:00:00,152,91,61,FMN GV 16 Berchem TOT
54,Posthofbrug 5366,2022-07-27,21:00:00,117,66,51,FMN GV 16 Berchem TOT
54,Posthofbrug 5366,2022-07-27,22:00:00,98,31,67,FMN GV 16 Berchem TOT
54,Posthofbrug 5366,2022-07-27,23:00:00,67,27,40,FMN GV 16 Berchem TOT
54,Posthofbrug 5366,2022-07-28,00:00:00,37,12,25,FMN GV 16 Berchem TOT
54,Posthofbrug 5366,2022-07-28,01:00:00,11,2,9,FMN GV 16 Berchem TOT
54,Posthofbrug 5366,2022-07-28,02:00:00,11,1,10,FMN GV 16 Berchem TOT
54,Posthofbrug 5366,2022-07-28,03:00:00,5,0,5,FMN GV 16 Berchem TOT
54,Posthofbrug 5366,2022-07-28,04:00:00,11,4,7,FMN GV 16 Berchem TOT
54,Posthofbrug 5366,2022-07-28,05:00:00,34,24,10,FMN GV 16 Berchem TOT
54,Posthofbrug 5366,2022-07-28,06:00:00,104,81,23,FMN GV 16 Berchem TOT
54,Posthofbrug 5366,2022-07-28,07:00:00,267,198,69,FMN GV 16 Berchem TOT
54,Posthofbrug 5366,2022-07-28,08:00:00,411,315,96,FMN GV 16 Berchem TOT
54,Posthofbrug 5366,2022-07-28,09:00:00,206,151,55,FMN GV 16 Berchem TOT
54,Posthofbrug 5366,2022-07-28,10:00:00,134,96,38,FMN GV 16 Berchem TOT
54,Posthofbrug 5366,2022-07-28,11:00:00,117,75,42,FMN GV 16 Berchem TOT
54,Posthofbrug 5366,2022-07-28,12:00:00,163,83,80,FMN GV 16 Berchem TOT
54,Posthofbrug 5366,2022-07-28,13:00:00,142,82,60,FMN GV 16 Berchem TOT
54,Posthofbrug 5366,2022-07-28,14:00:00,190,109,81,FMN GV 16 Berchem TOT
54,Posthofbrug 5366,2022-07-28,15:00:00,166,50,116,FMN GV 16 Berchem TOT
54,Posthofbrug 5366,2022-07-28,16:00:00,347,112,235,FMN GV 16 Berchem TOT
54,Posthofbrug 5366,2022-07-28,17:00:00,481,153,328,FMN GV 16 Berchem TOT
54,Posthofbrug 5366,2022-07-28,18:00:00,303,103,200,FMN GV 16 Berchem TOT
54,Posthofbrug 5366,2022-07-28,19:00:00,187,75,112,FMN GV 16 Berchem TOT
54,Posthofbrug 5366,2022-07-28,20:00:00,172,79,93,FMN GV 16 Berchem TOT
54,Posthofbrug 5366,2022-07-28,21:00:00,100,46,54,FMN GV 16 Berchem TOT
54,Posthofbrug 5366,2022-07-28,22:00:00,125,50,75,FMN GV 16 Berchem TOT
54,Posthofbrug 5366,2022-07-28,23:00:00,81,41,40,FMN GV 16 Berchem TOT
54,Posthofbrug 5366,2022-07-29,00:00:00,55,30,25,FMN GV 16 Berchem TOT
54,Posthofbrug 5366,2022-07-29,01:00:00,37,27,10,FMN GV 16 Berchem TOT
54,Posthofbrug 5366,2022-07-29,02:00:00,8,3,5,FMN GV 16 Berchem TOT
54,Posthofbrug 5366,2022-07-29,03:00:00,7,1,6,FMN GV 16 Berchem TOT
54,Posthofbrug 5366,2022-07-29,04:00:00,15,5,10,FMN GV 16 Berchem TOT
54,Posthofbrug 5366,2022-07-29,05:00:00,30,21,9,FMN GV 16 Berchem TOT
54,Posthofbrug 5366,2022-07-29,06:00:00,66,49,17,FMN GV 16 Berchem TOT
54,Posthofbrug 5366,2022-07-29,07:00:00,198,144,54,FMN GV 16 Berchem TOT
54,Posthofbrug 5366,2022-07-29,08:00:00,309,237,72,FMN GV 16 Berchem TOT
54,Posthofbrug 5366,2022-07-29,09:00:00,171,126,45,FMN GV 16 Berchem TOT
54,Posthofbrug 5366,2022-07-29,10:00:00,123,84,39,FMN GV 16 Berchem TOT
54,Posthofbrug 5366,2022-07-29,11:00:00,128,76,52,FMN GV 16 Berchem TOT
54,Posthofbrug 5366,2022-07-29,12:00:00,167,83,84,FMN GV 16 Berchem TOT
54,Posthofbrug 5366,2022-07-29,13:00:00,171,89,82,FMN GV 16 Berchem TOT
54,Posthofbrug 5366,2022-07-29,14:00:00,160,93,67,FMN GV 16 Berchem TOT
54,Posthofbrug 5366,2022-07-29,15:00:00,214,78,136,FMN GV 16 Berchem TOT
54,Posthofbrug 5366,2022-07-29,16:00:00,320,128,192,FMN GV 16 Berchem TOT
54,Posthofbrug 5366,2022-07-29,17:00:00,339,109,230,FMN GV 16 Berchem TOT
54,Posthofbrug 5366,2022-07-29,18:00:00,265,96,169,FMN GV 16 Berchem TOT
54,Posthofbrug 5366,2022-07-29,19:00:00,186,78,108,FMN GV 16 Berchem TOT
54,Posthofbrug 5366,2022-07-29,20:00:00,127,53,74,FMN GV 16 Berchem TOT
54,Posthofbrug 5366,2022-07-29,21:00:00,110,47,63,FMN GV 16 Berchem TOT
54,Posthofbrug 5366,2022-07-29,22:00:00,67,33,34,FMN GV 16 Berchem TOT
54,Posthofbrug 5366,2022-07-29,23:00:00,81,40,41,FMN GV 16 Berchem TOT
54,Posthofbrug 5366,2022-07-30,00:00:00,81,44,37,FMN GV 16 Berchem TOT
54,Posthofbrug 5366,2022-07-30,01:00:00,58,43,15,FMN GV 16 Berchem TOT
54,Posthofbrug 5366,2022-07-30,02:00:00,66,42,24,FMN GV 16 Berchem TOT
54,Posthofbrug 5366,2022-07-30,03:00:00,62,37,25,FMN GV 16 Berchem TOT
54,Posthofbrug 5366,2022-07-30,04:00:00,22,16,6,FMN GV 16 Berchem TOT
54,Posthofbrug 5366,2022-07-30,05:00:00,21,12,9,FMN GV 16 Berchem TOT
54,Posthofbrug 5366,2022-07-30,06:00:00,29,20,9,FMN GV 16 Berchem TOT
54,Posthofbrug 5366,2022-07-30,07:00:00,37,21,16,FMN GV 16 Berchem TOT
54,Posthofbrug 5366,2022-07-30,08:00:00,58,42,16,FMN GV 16 Berchem TOT
54,Posthofbrug 5366,2022-07-30,09:00:00,113,77,36,FMN GV 16 Berchem TOT
54,Posthofbrug 5366,2022-07-30,10:00:00,176,116,60,FMN GV 16 Berchem TOT
54,Posthofbrug 5366,2022-07-30,11:00:00,178,110,68,FMN GV 16 Berchem TOT
54,Posthofbrug 5366,2022-07-30,12:00:00,163,97,66,FMN GV 16 Berchem TOT
54,Posthofbrug 5366,2022-07-30,13:00:00,187,116,71,FMN GV 16 Berchem TOT
54,Posthofbrug 5366,2022-07-30,14:00:00,252,143,109,FMN GV 16 Berchem TOT
54,Posthofbrug 5366,2022-07-30,15:00:00,196,83,113,FMN GV 16 Berchem TOT
54,Posthofbrug 5366,2022-07-30,16:00:00,192,79,113,FMN GV 16 Berchem TOT
54,Posthofbrug 5366,2022-07-30,17:00:00,208,85,123,FMN GV 16 Berchem TOT
54,Posthofbrug 5366,2022-07-30,18:00:00,159,63,96,FMN GV 16 Berchem TOT
54,Posthofbrug 5366,2022-07-30,19:00:00,137,62,75,FMN GV 16 Berchem TOT
54,Posthofbrug 5366,2022-07-30,20:00:00,119,50,69,FMN GV 16 Berchem TOT
54,Posthofbrug 5366,2022-07-30,21:00:00,85,41,44,FMN GV 16 Berchem TOT
54,Posthofbrug 5366,2022-07-30,22:00:00,81,45,36,FMN GV 16 Berchem TOT
54,Posthofbrug 5366,2022-07-30,23:00:00,96,42,54,FMN GV 16 Berchem TOT
54,Posthofbrug 5366,2022-07-31,00:00:00,50,30,20,FMN GV 16 Berchem TOT
54,Posthofbrug 5366,2022-07-31,01:00:00,72,50,22,FMN GV 16 Berchem TOT
54,Posthofbrug 5366,2022-07-31,02:00:00,90,74,16,FMN GV 16 Berchem TOT
54,Posthofbrug 5366,2022-07-31,03:00:00,46,40,6,FMN GV 16 Berchem TOT
54,Posthofbrug 5366,2022-07-31,04:00:00,19,7,12,FMN GV 16 Berchem TOT
54,Posthofbrug 5366,2022-07-31,05:00:00,16,8,8,FMN GV 16 Berchem TOT
54,Posthofbrug 5366,2022-07-31,06:00:00,27,19,8,FMN GV 16 Berchem TOT
54,Posthofbrug 5366,2022-07-31,07:00:00,30,12,18,FMN GV 16 Berchem TOT
54,Posthofbrug 5366,2022-07-31,08:00:00,59,31,28,FMN GV 16 Berchem TOT
54,Posthofbrug 5366,2022-07-31,09:00:00,65,43,22,FMN GV 16 Berchem TOT
54,Posthofbrug 5366,2022-07-31,10:00:00,137,79,58,FMN GV 16 Berchem TOT
54,Posthofbrug 5366,2022-07-31,11:00:00,118,60,58,FMN GV 16 Berchem TOT
54,Posthofbrug 5366,2022-07-31,12:00:00,140,82,58,FMN GV 16 Berchem TOT
54,Posthofbrug 5366,2022-07-31,13:00:00,168,103,65,FMN GV 16 Berchem TOT
54,Posthofbrug 5366,2022-07-31,14:00:00,189,98,91,FMN GV 16 Berchem TOT
54,Posthofbrug 5366,2022-07-31,15:00:00,145,65,80,FMN GV 16 Berchem TOT
54,Posthofbrug 5366,2022-07-31,16:00:00,142,56,86,FMN GV 16 Berchem TOT
54,Posthofbrug 5366,2022-07-31,17:00:00,136,69,67,FMN GV 16 Berchem TOT
54,Posthofbrug 5366,2022-07-31,18:00:00,135,57,78,FMN GV 16 Berchem TOT
54,Posthofbrug 5366,2022-07-31,19:00:00,103,54,49,FMN GV 16 Berchem TOT
54,Posthofbrug 5366,2022-07-31,20:00:00,81,41,40,FMN GV 16 Berchem TOT
54,Posthofbrug 5366,2022-07-31,21:00:00,74,37,37,FMN GV 16 Berchem TOT
54,Posthofbrug 5366,2022-07-31,22:00:00,76,43,33,FMN GV 16 Berchem TOT
54,Posthofbrug 5366,2022-07-31,23:00:00,60,40,20,FMN GV 16 Berchem TOT
54,Posthofbrug 5366,2022-08-01,00:00:00,34,21,13,FMN GV 16 Berchem TOT
54,Posthofbrug 5366,2022-08-01,01:00:00,17,8,9,FMN GV 16 Berchem TOT
54,Posthofbrug 5366,2022-08-01,02:00:00,20,10,10,FMN GV 16 Berchem TOT
54,Posthofbrug 5366,2022-08-01,03:00:00,7,3,4,FMN GV 16 Berchem TOT
54,Posthofbrug 5366,2022-08-01,04:00:00,11,8,3,FMN GV 16 Berchem TOT
54,Posthofbrug 5366,2022-08-01,05:00:00,28,18,10,FMN GV 16 Berchem TOT
54,Posthofbrug 5366,2022-08-01,06:00:00,99,73,26,FMN GV 16 Berchem TOT
54,Posthofbrug 5366,2022-08-01,07:00:00,267,195,72,FMN GV 16 Berchem TOT
54,Posthofbrug 5366,2022-08-01,08:00:00,426,317,109,FMN GV 16 Berchem TOT
54,Posthofbrug 5366,2022-08-01,09:00:00,192,140,52,FMN GV 16 Berchem TOT
54,Posthofbrug 5366,2022-08-01,10:00:00,105,70,35,FMN GV 16 Berchem TOT
54,Posthofbrug 5366,2022-08-01,11:00:00,92,61,31,FMN GV 16 Berchem TOT
54,Posthofbrug 5366,2022-08-01,12:00:00,143,87,56,FMN GV 16 Berchem TOT
54,Posthofbrug 5366,2022-08-01,13:00:00,130,70,60,FMN GV 16 Berchem TOT
54,Posthofbrug 5366,2022-08-01,14:00:00,157,90,67,FMN GV 16 Berchem TOT
54,Posthofbrug 5366,2022-08-01,15:00:00,190,78,112,FMN GV 16 Berchem TOT
54,Posthofbrug 5366,2022-08-01,16:00:00,321,127,194,FMN GV 16 Berchem TOT
54,Posthofbrug 5366,2022-08-01,17:00:00,475,164,311,FMN GV 16 Berchem TOT
54,Posthofbrug 5366,2022-08-01,18:00:00,318,106,212,FMN GV 16 Berchem TOT
54,Posthofbrug 5366,2022-08-01,19:00:00,156,49,107,FMN GV 16 Berchem TOT
54,Posthofbrug 5366,2022-08-01,20:00:00,118,61,57,FMN GV 16 Berchem TOT
54,Posthofbrug 5366,2022-08-01,21:00:00,97,36,61,FMN GV 16 Berchem TOT
54,Posthofbrug 5366,2022-08-01,22:00:00,101,51,50,FMN GV 16 Berchem TOT
54,Posthofbrug 5366,2022-08-01,23:00:00,54,28,26,FMN GV 16 Berchem TOT
54,Posthofbrug 5366,2022-08-02,00:00:00,20,10,10,FMN GV 16 Berchem TOT
54,Posthofbrug 5366,2022-08-02,01:00:00,13,3,10,FMN GV 16 Berchem TOT
54,Posthofbrug 5366,2022-08-02,02:00:00,6,4,2,FMN GV 16 Berchem TOT
54,Posthofbrug 5366,2022-08-02,03:00:00,5,2,3,FMN GV 16 Berchem TOT
54,Posthofbrug 5366,2022-08-02,04:00:00,13,5,8,FMN GV 16 Berchem TOT
54,Posthofbrug 5366,2022-08-02,05:00:00,43,31,12,FMN GV 16 Berchem TOT
54,Posthofbrug 5366,2022-08-02,06:00:00,107,81,26,FMN GV 16 Berchem TOT
54,Posthofbrug 5366,2022-08-02,07:00:00,304,222,82,FMN GV 16 Berchem TOT
54,Posthofbrug 5366,2022-08-02,08:00:00,497,356,141,FMN GV 16 Berchem TOT
54,Posthofbrug 5366,2022-08-02,09:00:00,250,186,64,FMN GV 16 Berchem TOT
54,Posthofbrug 5366,2022-08-02,10:00:00,134,98,36,FMN GV 16 Berchem TOT
54,Posthofbrug 5366,2022-08-02,11:00:00,124,61,63,FMN GV 16 Berchem TOT
54,Posthofbrug 5366,2022-08-02,12:00:00,145,91,54,FMN GV 16 Berchem TOT
54,Posthofbrug 5366,2022-08-02,13:00:00,178,104,74,FMN GV 16 Berchem TOT
54,Posthofbrug 5366,2022-08-02,14:00:00,167,71,96,FMN GV 16 Berchem TOT
54,Posthofbrug 5366,2022-08-02,15:00:00,189,76,113,FMN GV 16 Berchem TOT
54,Posthofbrug 5366,2022-08-02,16:00:00,389,140,249,FMN GV 16 Berchem TOT
54,Posthofbrug 5366,2022-08-02,17:00:00,544,184,360,FMN GV 16 Berchem TOT
54,Posthofbrug 5366,2022-08-02,18:00:00,351,130,221,FMN GV 16 Berchem TOT
54,Posthofbrug 5366,2022-08-02,19:00:00,202,91,111,FMN GV 16 Berchem TOT
54,Posthofbrug 5366,2022-08-02,20:00:00,145,76,69,FMN GV 16 Berchem TOT
54,Posthofbrug 5366,2022-08-02,21:00:00,136,67,69,FMN GV 16 Berchem TOT
54,Posthofbrug 5366,2022-08-02,22:00:00,112,39,73,FMN GV 16 Berchem TOT
54,Posthofbrug 5366,2022-08-02,23:00:00,74,34,40,FMN GV 16 Berchem TOT
54,Posthofbrug 5366,2022-08-03,00:00:00,29,10,19,FMN GV 16 Berchem TOT
54,Posthofbrug 5366,2022-08-03,01:00:00,21,8,13,FMN GV 16 Berchem TOT
54,Posthofbrug 5366,2022-08-03,02:00:00,11,2,9,FMN GV 16 Berchem TOT
54,Posthofbrug 5366,2022-08-03,03:00:00,8,3,5,FMN GV 16 Berchem TOT
54,Posthofbrug 5366,2022-08-03,04:00:00,15,6,9,FMN GV 16 Berchem TOT
54,Posthofbrug 5366,2022-08-03,05:00:00,41,28,13,FMN GV 16 Berchem TOT
54,Posthofbrug 5366,2022-08-03,06:00:00,101,80,21,FMN GV 16 Berchem TOT
54,Posthofbrug 5366,2022-08-03,07:00:00,269,205,64,FMN GV 16 Berchem TOT
54,Posthofbrug 5366,2022-08-03,08:00:00,478,344,134,FMN GV 16 Berchem TOT
54,Posthofbrug 5366,2022-08-03,09:00:00,208,144,64,FMN GV 16 Berchem TOT
54,Posthofbrug 5366,2022-08-03,10:00:00,129,70,59,FMN GV 16 Berchem TOT
54,Posthofbrug 5366,2022-08-03,11:00:00,109,56,53,FMN GV 16 Berchem TOT
54,Posthofbrug 5366,2022-08-03,12:00:00,152,90,62,FMN GV 16 Berchem TOT
54,Posthofbrug 5366,2022-08-03,13:00:00,152,84,68,FMN GV 16 Berchem TOT
54,Posthofbrug 5366,2022-08-03,14:00:00,156,75,81,FMN GV 16 Berchem TOT
54,Posthofbrug 5366,2022-08-03,15:00:00,154,59,95,FMN GV 16 Berchem TOT
54,Posthofbrug 5366,2022-08-03,16:00:00,315,111,204,FMN GV 16 Berchem TOT
54,Posthofbrug 5366,2022-08-03,17:00:00,460,161,299,FMN GV 16 Berchem TOT
54,Posthofbrug 5366,2022-08-03,18:00:00,307,129,178,FMN GV 16 Berchem TOT
54,Posthofbrug 5366,2022-08-03,19:00:00,174,83,91,FMN GV 16 Berchem TOT
54,Posthofbrug 5366,2022-08-03,20:00:00,133,62,71,FMN GV 16 Berchem TOT
54,Posthofbrug 5366,2022-08-03,21:00:00,137,86,51,FMN GV 16 Berchem TOT
54,Posthofbrug 5366,2022-08-03,22:00:00,117,55,62,FMN GV 16 Berchem TOT
54,Posthofbrug 5366,2022-08-03,23:00:00,69,25,44,FMN GV 16 Berchem TOT
54,Posthofbrug 5366,2022-08-04,00:00:00,35,8,27,FMN GV 16 Berchem TOT
54,Posthofbrug 5366,2022-08-04,01:00:00,24,3,21,FMN GV 16 Berchem TOT
54,Posthofbrug 5366,2022-08-04,02:00:00,10,0,10,FMN GV 16 Berchem TOT
54,Posthofbrug 5366,2022-08-04,03:00:00,10,1,9,FMN GV 16 Berchem TOT
54,Posthofbrug 5366,2022-08-04,04:00:00,10,7,3,FMN GV 16 Berchem TOT
54,Posthofbrug 5366,2022-08-04,05:00:00,42,30,12,FMN GV 16 Berchem TOT
54,Posthofbrug 5366,2022-08-04,06:00:00,105,85,20,FMN GV 16 Berchem TOT
54,Posthofbrug 5366,2022-08-04,07:00:00,285,215,70,FMN GV 16 Berchem TOT
54,Posthofbrug 5366,2022-08-04,08:00:00,486,350,136,FMN GV 16 Berchem TOT
54,Posthofbrug 5366,2022-08-04,09:00:00,238,170,68,FMN GV 16 Berchem TOT
54,Posthofbrug 5366,2022-08-04,10:00:00,118,83,35,FMN GV 16 Berchem TOT
54,Posthofbrug 5366,2022-08-04,11:00:00,80,51,29,FMN GV 16 Berchem TOT
54,Posthofbrug 5366,2022-08-04,12:00:00,130,63,67,FMN GV 16 Berchem TOT
54,Posthofbrug 5366,2022-08-04,13:00:00,148,82,66,FMN GV 16 Berchem TOT
54,Posthofbrug 5366,2022-08-04,14:00:00,158,87,71,FMN GV 16 Berchem TOT
54,Posthofbrug 5366,2022-08-04,15:00:00,164,60,104,FMN GV 16 Berchem TOT
54,Posthofbrug 5366,2022-08-04,16:00:00,344,137,207,FMN GV 16 Berchem TOT
54,Posthofbrug 5366,2022-08-04,17:00:00,450,157,293,FMN GV 16 Berchem TOT
54,Posthofbrug 5366,2022-08-04,18:00:00,308,112,196,FMN GV 16 Berchem TOT
54,Posthofbrug 5366,2022-08-04,19:00:00,189,80,109,FMN GV 16 Berchem TOT
54,Posthofbrug 5366,2022-08-04,20:00:00,140,77,63,FMN GV 16 Berchem TOT
54,Posthofbrug 5366,2022-08-04,21:00:00,91,31,60,FMN GV 16 Berchem TOT
54,Posthofbrug 5366,2022-08-04,22:00:00,78,30,48,FMN GV 16 Berchem TOT
54,Posthofbrug 5366,2022-08-04,23:00:00,65,18,47,FMN GV 16 Berchem TOT
54,Posthofbrug 5366,2022-08-05,00:00:00,41,16,25,FMN GV 16 Berchem TOT
54,Posthofbrug 5366,2022-08-05,01:00:00,20,10,10,FMN GV 16 Berchem TOT
54,Posthofbrug 5366,2022-08-05,02:00:00,19,2,17,FMN GV 16 Berchem TOT
54,Posthofbrug 5366,2022-08-05,03:00:00,3,1,2,FMN GV 16 Berchem TOT
54,Posthofbrug 5366,2022-08-05,04:00:00,16,5,11,FMN GV 16 Berchem TOT
54,Posthofbrug 5366,2022-08-05,05:00:00,41,21,20,FMN GV 16 Berchem TOT
54,Posthofbrug 5366,2022-08-05,06:00:00,75,57,18,FMN GV 16 Berchem TOT
54,Posthofbrug 5366,2022-08-05,07:00:00,211,145,66,FMN GV 16 Berchem TOT
54,Posthofbrug 5366,2022-08-05,08:00:00,332,238,94,FMN GV 16 Berchem TOT
54,Posthofbrug 5366,2022-08-05,09:00:00,183,137,46,FMN GV 16 Berchem TOT
54,Posthofbrug 5366,2022-08-05,10:00:00,124,83,41,FMN GV 16 Berchem TOT
54,Posthofbrug 5366,2022-08-05,11:00:00,131,84,47,FMN GV 16 Berchem TOT
54,Posthofbrug 5366,2022-08-05,12:00:00,148,89,59,FMN GV 16 Berchem TOT
54,Posthofbrug 5366,2022-08-05,13:00:00,152,81,71,FMN GV 16 Berchem TOT
54,Posthofbrug 5366,2022-08-05,14:00:00,167,84,83,FMN GV 16 Berchem TOT
54,Posthofbrug 5366,2022-08-05,15:00:00,174,64,110,FMN GV 16 Berchem TOT
54,Posthofbrug 5366,2022-08-05,16:00:00,321,148,173,FMN GV 16 Berchem TOT
54,Posthofbrug 5366,2022-08-05,17:00:00,343,142,201,FMN GV 16 Berchem TOT
54,Posthofbrug 5366,2022-08-05,18:00:00,262,101,161,FMN GV 16 Berchem TOT
54,Posthofbrug 5366,2022-08-05,19:00:00,188,98,90,FMN GV 16 Berchem TOT
54,Posthofbrug 5366,2022-08-05,20:00:00,136,69,67,FMN GV 16 Berchem TOT
54,Posthofbrug 5366,2022-08-05,21:00:00,88,40,48,FMN GV 16 Berchem TOT
54,Posthofbrug 5366,2022-08-05,22:00:00,89,41,48,FMN GV 16 Berchem TOT
54,Posthofbrug 5366,2022-08-05,23:00:00,75,21,54,FMN GV 16 Berchem TOT
54,Posthofbrug 5366,2022-08-06,00:00:00,38,14,24,FMN GV 16 Berchem TOT
54,Posthofbrug 5366,2022-08-06,01:00:00,50,10,40,FMN GV 16 Berchem TOT
54,Posthofbrug 5366,2022-08-06,02:00:00,35,7,28,FMN GV 16 Berchem TOT
54,Posthofbrug 5366,2022-08-06,03:00:00,29,1,28,FMN GV 16 Berchem TOT
54,Posthofbrug 5366,2022-08-06,04:00:00,26,7,19,FMN GV 16 Berchem TOT
54,Posthofbrug 5366,2022-08-06,05:00:00,22,8,14,FMN GV 16 Berchem TOT
54,Posthofbrug 5366,2022-08-06,06:00:00,16,8,8,FMN GV 16 Berchem TOT
54,Posthofbrug 5366,2022-08-06,07:00:00,45,28,17,FMN GV 16 Berchem TOT
54,Posthofbrug 5366,2022-08-06,08:00:00,46,28,18,FMN GV 16 Berchem TOT
54,Posthofbrug 5366,2022-08-06,09:00:00,98,70,28,FMN GV 16 Berchem TOT
54,Posthofbrug 5366,2022-08-06,10:00:00,135,94,41,FMN GV 16 Berchem TOT
54,Posthofbrug 5366,2022-08-06,11:00:00,173,110,63,FMN GV 16 Berchem TOT
54,Posthofbrug 5366,2022-08-06,12:00:00,179,109,70,FMN GV 16 Berchem TOT
54,Posthofbrug 5366,2022-08-06,13:00:00,186,111,75,FMN GV 16 Berchem TOT
54,Posthofbrug 5366,2022-08-06,14:00:00,195,121,74,FMN GV 16 Berchem TOT
54,Posthofbrug 5366,2022-08-06,15:00:00,173,94,79,FMN GV 16 Berchem TOT
54,Posthofbrug 5366,2022-08-06,16:00:00,191,103,88,FMN GV 16 Berchem TOT
54,Posthofbrug 5366,2022-08-06,17:00:00,153,78,75,FMN GV 16 Berchem TOT
54,Posthofbrug 5366,2022-08-06,18:00:00,191,113,78,FMN GV 16 Berchem TOT
54,Posthofbrug 5366,2022-08-06,19:00:00,98,68,30,FMN GV 16 Berchem TOT
54,Posthofbrug 5366,2022-08-06,20:00:00,113,46,67,FMN GV 16 Berchem TOT
54,Posthofbrug 5366,2022-08-06,21:00:00,80,34,46,FMN GV 16 Berchem TOT
54,Posthofbrug 5366,2022-08-06,22:00:00,46,14,32,FMN GV 16 Berchem TOT
54,Posthofbrug 5366,2022-08-06,23:00:00,70,15,55,FMN GV 16 Berchem TOT
54,Posthofbrug 5366,2022-08-07,00:00:00,75,19,56,FMN GV 16 Berchem TOT
54,Posthofbrug 5366,2022-08-07,01:00:00,43,16,27,FMN GV 16 Berchem TOT
54,Posthofbrug 5366,2022-08-07,02:00:00,23,9,14,FMN GV 16 Berchem TOT
54,Posthofbrug 5366,2022-08-07,03:00:00,7,1,6,FMN GV 16 Berchem TOT
54,Posthofbrug 5366,2022-08-07,04:00:00,9,3,6,FMN GV 16 Berchem TOT
54,Posthofbrug 5366,2022-08-07,05:00:00,25,8,17,FMN GV 16 Berchem TOT
54,Posthofbrug 5366,2022-08-07,06:00:00,14,11,3,FMN GV 16 Berchem TOT
54,Posthofbrug 5366,2022-08-07,07:00:00,26,20,6,FMN GV 16 Berchem TOT
54,Posthofbrug 5366,2022-08-07,08:00:00,55,35,20,FMN GV 16 Berchem TOT
54,Posthofbrug 5366,2022-08-07,09:00:00,102,77,25,FMN GV 16 Berchem TOT
54,Posthofbrug 5366,2022-08-07,10:00:00,165,115,50,FMN GV 16 Berchem TOT
54,Posthofbrug 5366,2022-08-07,11:00:00,199,124,75,FMN GV 16 Berchem TOT
54,Posthofbrug 5366,2022-08-07,12:00:00,192,111,81,FMN GV 16 Berchem TOT
54,Posthofbrug 5366,2022-08-07,13:00:00,186,100,86,FMN GV 16 Berchem TOT
54,Posthofbrug 5366,2022-08-07,14:00:00,218,122,96,FMN GV 16 Berchem TOT
54,Posthofbrug 5366,2022-08-07,15:00:00,240,129,111,FMN GV 16 Berchem TOT
54,Posthofbrug 5366,2022-08-07,16:00:00,222,103,119,FMN GV 16 Berchem TOT
54,Posthofbrug 5366,2022-08-07,17:00:00,184,59,125,FMN GV 16 Berchem TOT
54,Posthofbrug 5366,2022-08-07,18:00:00,150,77,73,FMN GV 16 Berchem TOT
54,Posthofbrug 5366,2022-08-07,19:00:00,181,82,99,FMN GV 16 Berchem TOT
54,Posthofbrug 5366,2022-08-07,20:00:00,117,49,68,FMN GV 16 Berchem TOT
54,Posthofbrug 5366,2022-08-07,21:00:00,102,57,45,FMN GV 16 Berchem TOT
54,Posthofbrug 5366,2022-08-07,22:00:00,72,35,37,FMN GV 16 Berchem TOT
54,Posthofbrug 5366,2022-08-07,23:00:00,46,17,29,FMN GV 16 Berchem TOT
54,Posthofbrug 5366,2022-08-08,00:00:00,19,5,14,FMN GV 16 Berchem TOT
54,Posthofbrug 5366,2022-08-08,01:00:00,7,2,5,FMN GV 16 Berchem TOT
54,Posthofbrug 5366,2022-08-08,02:00:00,15,4,11,FMN GV 16 Berchem TOT
54,Posthofbrug 5366,2022-08-08,03:00:00,1,1,0,FMN GV 16 Berchem TOT
54,Posthofbrug 5366,2022-08-08,04:00:00,17,14,3,FMN GV 16 Berchem TOT
54,Posthofbrug 5366,2022-08-08,05:00:00,28,21,7,FMN GV 16 Berchem TOT
54,Posthofbrug 5366,2022-08-08,06:00:00,101,81,20,FMN GV 16 Berchem TOT
54,Posthofbrug 5366,2022-08-08,07:00:00,283,215,68,FMN GV 16 Berchem TOT
54,Posthofbrug 5366,2022-08-08,08:00:00,473,352,121,FMN GV 16 Berchem TOT
54,Posthofbrug 5366,2022-08-08,09:00:00,193,130,63,FMN GV 16 Berchem TOT
54,Posthofbrug 5366,2022-08-08,10:00:00,122,83,39,FMN GV 16 Berchem TOT
54,Posthofbrug 5366,2022-08-08,11:00:00,131,87,44,FMN GV 16 Berchem TOT
54,Posthofbrug 5366,2022-08-08,12:00:00,163,90,73,FMN GV 16 Berchem TOT
54,Posthofbrug 5366,2022-08-08,13:00:00,154,79,75,FMN GV 16 Berchem TOT
54,Posthofbrug 5366,2022-08-08,14:00:00,141,73,68,FMN GV 16 Berchem TOT
54,Posthofbrug 5366,2022-08-08,15:00:00,182,64,118,FMN GV 16 Berchem TOT
54,Posthofbrug 5366,2022-08-08,16:00:00,332,126,206,FMN GV 16 Berchem TOT
54,Posthofbrug 5366,2022-08-08,17:00:00,466,157,309,FMN GV 16 Berchem TOT
54,Posthofbrug 5366,2022-08-08,18:00:00,336,112,224,FMN GV 16 Berchem TOT
54,Posthofbrug 5366,2022-08-08,19:00:00,162,63,99,FMN GV 16 Berchem TOT
54,Posthofbrug 5366,2022-08-08,20:00:00,118,58,60,FMN GV 16 Berchem TOT
54,Posthofbrug 5366,2022-08-08,21:00:00,103,54,49,FMN GV 16 Berchem TOT
54,Posthofbrug 5366,2022-08-08,22:00:00,89,37,52,FMN GV 16 Berchem TOT
54,Posthofbrug 5366,2022-08-08,23:00:00,53,22,31,FMN GV 16 Berchem TOT
54,Posthofbrug 5366,2022-08-09,00:00:00,26,10,16,FMN GV 16 Berchem TOT
54,Posthofbrug 5366,2022-08-09,01:00:00,16,5,11,FMN GV 16 Berchem TOT
54,Posthofbrug 5366,2022-08-09,02:00:00,15,0,15,FMN GV 16 Berchem TOT
54,Posthofbrug 5366,2022-08-09,03:00:00,10,1,9,FMN GV 16 Berchem TOT
54,Posthofbrug 5366,2022-08-09,04:00:00,13,10,3,FMN GV 16 Berchem TOT
54,Posthofbrug 5366,2022-08-09,05:00:00,38,26,12,FMN GV 16 Berchem TOT
54,Posthofbrug 5366,2022-08-09,06:00:00,120,86,34,FMN GV 16 Berchem TOT
54,Posthofbrug 5366,2022-08-09,07:00:00,289,207,82,FMN GV 16 Berchem TOT
54,Posthofbrug 5366,2022-08-09,08:00:00,561,413,148,FMN GV 16 Berchem TOT
54,Posthofbrug 5366,2022-08-09,09:00:00,285,200,85,FMN GV 16 Berchem TOT
54,Posthofbrug 5366,2022-08-09,10:00:00,158,110,48,FMN GV 16 Berchem TOT
54,Posthofbrug 5366,2022-08-09,11:00:00,153,96,57,FMN GV 16 Berchem TOT
54,Posthofbrug 5366,2022-08-09,12:00:00,139,85,54,FMN GV 16 Berchem TOT
54,Posthofbrug 5366,2022-08-09,13:00:00,170,94,76,FMN GV 16 Berchem TOT
54,Posthofbrug 5366,2022-08-09,14:00:00,146,73,73,FMN GV 16 Berchem TOT
54,Posthofbrug 5366,2022-08-09,15:00:00,210,74,136,FMN GV 16 Berchem TOT
54,Posthofbrug 5366,2022-08-09,16:00:00,396,147,249,FMN GV 16 Berchem TOT
54,Posthofbrug 5366,2022-08-09,17:00:00,535,193,342,FMN GV 16 Berchem TOT
54,Posthofbrug 5366,2022-08-09,18:00:00,367,139,228,FMN GV 16 Berchem TOT
54,Posthofbrug 5366,2022-08-09,19:00:00,202,93,109,FMN GV 16 Berchem TOT
54,Posthofbrug 5366,2022-08-09,20:00:00,135,67,68,FMN GV 16 Berchem TOT
54,Posthofbrug 5366,2022-08-09,21:00:00,121,59,62,FMN GV 16 Berchem TOT
54,Posthofbrug 5366,2022-08-09,22:00:00,124,51,73,FMN GV 16 Berchem TOT
54,Posthofbrug 5366,2022-08-09,23:00:00,67,27,40,FMN GV 16 Berchem TOT
54,Posthofbrug 5366,2022-08-10,00:00:00,31,11,20,FMN GV 16 Berchem TOT
54,Posthofbrug 5366,2022-08-10,01:00:00,13,4,9,FMN GV 16 Berchem TOT
54,Posthofbrug 5366,2022-08-10,02:00:00,12,1,11,FMN GV 16 Berchem TOT
54,Posthofbrug 5366,2022-08-10,03:00:00,7,0,7,FMN GV 16 Berchem TOT
54,Posthofbrug 5366,2022-08-10,04:00:00,12,9,3,FMN GV 16 Berchem TOT
54,Posthofbrug 5366,2022-08-10,05:00:00,27,18,9,FMN GV 16 Berchem TOT
54,Posthofbrug 5366,2022-08-10,06:00:00,103,79,24,FMN GV 16 Berchem TOT
54,Posthofbrug 5366,2022-08-10,07:00:00,284,206,78,FMN GV 16 Berchem TOT
54,Posthofbrug 5366,2022-08-10,08:00:00,444,330,114,FMN GV 16 Berchem TOT
54,Posthofbrug 5366,2022-08-10,09:00:00,231,162,69,FMN GV 16 Berchem TOT
54,Posthofbrug 5366,2022-08-10,10:00:00,140,84,56,FMN GV 16 Berchem TOT
54,Posthofbrug 5366,2022-08-10,11:00:00,131,65,66,FMN GV 16 Berchem TOT
54,Posthofbrug 5366,2022-08-10,12:00:00,160,86,74,FMN GV 16 Berchem TOT
54,Posthofbrug 5366,2022-08-10,13:00:00,142,73,69,FMN GV 16 Berchem TOT
54,Posthofbrug 5366,2022-08-10,14:00:00,143,65,78,FMN GV 16 Berchem TOT
54,Posthofbrug 5366,2022-08-10,15:00:00,181,81,100,FMN GV 16 Berchem TOT
54,Posthofbrug 5366,2022-08-10,16:00:00,327,127,200,FMN GV 16 Berchem TOT
54,Posthofbrug 5366,2022-08-10,17:00:00,450,152,298,FMN GV 16 Berchem TOT
54,Posthofbrug 5366,2022-08-10,18:00:00,297,123,174,FMN GV 16 Berchem TOT
54,Posthofbrug 5366,2022-08-10,19:00:00,176,93,83,FMN GV 16 Berchem TOT
54,Posthofbrug 5366,2022-08-10,20:00:00,153,79,74,FMN GV 16 Berchem TOT
54,Posthofbrug 5366,2022-08-10,21:00:00,122,65,57,FMN GV 16 Berchem TOT
54,Posthofbrug 5366,2022-08-10,22:00:00,108,47,61,FMN GV 16 Berchem TOT
54,Posthofbrug 5366,2022-08-10,23:00:00,87,32,55,FMN GV 16 Berchem TOT
54,Posthofbrug 5366,2022-08-11,00:00:00,47,12,35,FMN GV 16 Berchem TOT
54,Posthofbrug 5366,2022-08-11,01:00:00,16,4,12,FMN GV 16 Berchem TOT
54,Posthofbrug 5366,2022-08-11,02:00:00,10,2,8,FMN GV 16 Berchem TOT
54,Posthofbrug 5366,2022-08-11,03:00:00,9,3,6,FMN GV 16 Berchem TOT
54,Posthofbrug 5366,2022-08-11,04:00:00,10,3,7,FMN GV 16 Berchem TOT
54,Posthofbrug 5366,2022-08-11,05:00:00,43,28,15,FMN GV 16 Berchem TOT
54,Posthofbrug 5366,2022-08-11,06:00:00,108,84,24,FMN GV 16 Berchem TOT
54,Posthofbrug 5366,2022-08-11,07:00:00,289,214,75,FMN GV 16 Berchem TOT
54,Posthofbrug 5366,2022-08-11,08:00:00,494,365,129,FMN GV 16 Berchem TOT
54,Posthofbrug 5366,2022-08-11,09:00:00,258,176,82,FMN GV 16 Berchem TOT
54,Posthofbrug 5366,2022-08-11,10:00:00,139,88,51,FMN GV 16 Berchem TOT
54,Posthofbrug 5366,2022-08-11,11:00:00,120,68,52,FMN GV 16 Berchem TOT
54,Posthofbrug 5366,2022-08-11,12:00:00,156,93,63,FMN GV 16 Berchem TOT
54,Posthofbrug 5366,2022-08-11,13:00:00,134,68,66,FMN GV 16 Berchem TOT
54,Posthofbrug 5366,2022-08-11,14:00:00,124,64,60,FMN GV 16 Berchem TOT
54,Posthofbrug 5366,2022-08-11,15:00:00,186,78,108,FMN GV 16 Berchem TOT
54,Posthofbrug 5366,2022-08-11,16:00:00,320,108,212,FMN GV 16 Berchem TOT
54,Posthofbrug 5366,2022-08-11,17:00:00,405,137,268,FMN GV 16 Berchem TOT
54,Posthofbrug 5366,2022-08-11,18:00:00,302,112,190,FMN GV 16 Berchem TOT
54,Posthofbrug 5366,2022-08-11,19:00:00,186,85,101,FMN GV 16 Berchem TOT
54,Posthofbrug 5366,2022-08-11,20:00:00,144,82,62,FMN GV 16 Berchem TOT
54,Posthofbrug 5366,2022-08-11,21:00:00,126,78,48,FMN GV 16 Berchem TOT
54,Posthofbrug 5366,2022-08-11,22:00:00,134,52,82,FMN GV 16 Berchem TOT
54,Posthofbrug 5366,2022-08-11,23:00:00,113,30,83,FMN GV 16 Berchem TOT
54,Posthofbrug 5366,2022-08-12,00:00:00,57,14,43,FMN GV 16 Berchem TOT
54,Posthofbrug 5366,2022-08-12,01:00:00,31,7,24,FMN GV 16 Berchem TOT
54,Posthofbrug 5366,2022-08-12,02:00:00,21,4,17,FMN GV 16 Berchem TOT
54,Posthofbrug 5366,2022-08-12,03:00:00,19,2,17,FMN GV 16 Berchem TOT
54,Posthofbrug 5366,2022-08-12,04:00:00,12,4,8,FMN GV 16 Berchem TOT
54,Posthofbrug 5366,2022-08-12,05:00:00,29,18,11,FMN GV 16 Berchem TOT
54,Posthofbrug 5366,2022-08-12,06:00:00,88,62,26,FMN GV 16 Berchem TOT
54,Posthofbrug 5366,2022-08-12,07:00:00,189,133,56,FMN GV 16 Berchem TOT
54,Posthofbrug 5366,2022-08-12,08:00:00,327,243,84,FMN GV 16 Berchem TOT
54,Posthofbrug 5366,2022-08-12,09:00:00,189,141,48,FMN GV 16 Berchem TOT
54,Posthofbrug 5366,2022-08-12,10:00:00,158,102,56,FMN GV 16 Berchem TOT
54,Posthofbrug 5366,2022-08-12,11:00:00,118,67,51,FMN GV 16 Berchem TOT
54,Posthofbrug 5366,2022-08-12,12:00:00,130,66,64,FMN GV 16 Berchem TOT
54,Posthofbrug 5366,2022-08-12,13:00:00,104,57,47,FMN GV 16 Berchem TOT
54,Posthofbrug 5366,2022-08-12,14:00:00,144,71,73,FMN GV 16 Berchem TOT
54,Posthofbrug 5366,2022-08-12,15:00:00,171,73,98,FMN GV 16 Berchem TOT
54,Posthofbrug 5366,2022-08-12,16:00:00,279,109,170,FMN GV 16 Berchem TOT
54,Posthofbrug 5366,2022-08-12,17:00:00,314,123,191,FMN GV 16 Berchem TOT
54,Posthofbrug 5366,2022-08-12,18:00:00,261,109,152,FMN GV 16 Berchem TOT
54,Posthofbrug 5366,2022-08-12,19:00:00,152,70,82,FMN GV 16 Berchem TOT
54,Posthofbrug 5366,2022-08-12,20:00:00,133,73,60,FMN GV 16 Berchem TOT
54,Posthofbrug 5366,2022-08-12,21:00:00,105,53,52,FMN GV 16 Berchem TOT
54,Posthofbrug 5366,2022-08-12,22:00:00,103,39,64,FMN GV 16 Berchem TOT
54,Posthofbrug 5366,2022-08-12,23:00:00,73,27,46,FMN GV 16 Berchem TOT
54,Posthofbrug 5366,2022-08-13,00:00:00,58,29,29,FMN GV 16 Berchem TOT
54,Posthofbrug 5366,2022-08-13,01:00:00,40,17,23,FMN GV 16 Berchem TOT
54,Posthofbrug 5366,2022-08-13,02:00:00,30,5,25,FMN GV 16 Berchem TOT
54,Posthofbrug 5366,2022-08-13,03:00:00,13,1,12,FMN GV 16 Berchem TOT
54,Posthofbrug 5366,2022-08-13,04:00:00,17,5,12,FMN GV 16 Berchem TOT
54,Posthofbrug 5366,2022-08-13,05:00:00,18,3,15,FMN GV 16 Berchem TOT
54,Posthofbrug 5366,2022-08-13,06:00:00,37,12,25,FMN GV 16 Berchem TOT
54,Posthofbrug 5366,2022-08-13,07:00:00,47,33,14,FMN GV 16 Berchem TOT
54,Posthofbrug 5366,2022-08-13,08:00:00,64,45,19,FMN GV 16 Berchem TOT
54,Posthofbrug 5366,2022-08-13,09:00:00,122,83,39,FMN GV 16 Berchem TOT
54,Posthofbrug 5366,2022-08-13,10:00:00,188,137,51,FMN GV 16 Berchem TOT
54,Posthofbrug 5366,2022-08-13,11:00:00,137,78,59,FMN GV 16 Berchem TOT
54,Posthofbrug 5366,2022-08-13,12:00:00,164,87,77,FMN GV 16 Berchem TOT
54,Posthofbrug 5366,2022-08-13,13:00:00,208,147,61,FMN GV 16 Berchem TOT
54,Posthofbrug 5366,2022-08-13,14:00:00,160,118,42,FMN GV 16 Berchem TOT
54,Posthofbrug 5366,2022-08-13,15:00:00,151,66,85,FMN GV 16 Berchem TOT
54,Posthofbrug 5366,2022-08-13,16:00:00,140,53,87,FMN GV 16 Berchem TOT
54,Posthofbrug 5366,2022-08-13,17:00:00,136,61,75,FMN GV 16 Berchem TOT
54,Posthofbrug 5366,2022-08-13,18:00:00,135,70,65,FMN GV 16 Berchem TOT
54,Posthofbrug 5366,2022-08-13,19:00:00,133,61,72,FMN GV 16 Berchem TOT
54,Posthofbrug 5366,2022-08-13,20:00:00,121,58,63,FMN GV 16 Berchem TOT
54,Posthofbrug 5366,2022-08-13,21:00:00,79,34,45,FMN GV 16 Berchem TOT
54,Posthofbrug 5366,2022-08-13,22:00:00,65,33,32,FMN GV 16 Berchem TOT
54,Posthofbrug 5366,2022-08-13,23:00:00,57,23,34,FMN GV 16 Berchem TOT
54,Posthofbrug 5366,2022-08-14,00:00:00,60,9,51,FMN GV 16 Berchem TOT
54,Posthofbrug 5366,2022-08-14,01:00:00,42,15,27,FMN GV 16 Berchem TOT
54,Posthofbrug 5366,2022-08-14,02:00:00,33,11,22,FMN GV 16 Berchem TOT
54,Posthofbrug 5366,2022-08-14,03:00:00,21,7,14,FMN GV 16 Berchem TOT
54,Posthofbrug 5366,2022-08-14,04:00:00,15,2,13,FMN GV 16 Berchem TOT
54,Posthofbrug 5366,2022-08-14,05:00:00,21,7,14,FMN GV 16 Berchem TOT
54,Posthofbrug 5366,2022-08-14,06:00:00,22,14,8,FMN GV 16 Berchem TOT
54,Posthofbrug 5366,2022-08-14,07:00:00,22,13,9,FMN GV 16 Berchem TOT
54,Posthofbrug 5366,2022-08-14,08:00:00,60,40,20,FMN GV 16 Berchem TOT
54,Posthofbrug 5366,2022-08-14,09:00:00,88,47,41,FMN GV 16 Berchem TOT
54,Posthofbrug 5366,2022-08-14,10:00:00,125,72,53,FMN GV 16 Berchem TOT
54,Posthofbrug 5366,2022-08-14,11:00:00,120,67,53,FMN GV 16 Berchem TOT
54,Posthofbrug 5366,2022-08-14,12:00:00,117,68,49,FMN GV 16 Berchem TOT
54,Posthofbrug 5366,2022-08-14,13:00:00,123,75,48,FMN GV 16 Berchem TOT
54,Posthofbrug 5366,2022-08-14,14:00:00,114,60,54,FMN GV 16 Berchem TOT
54,Posthofbrug 5366,2022-08-14,15:00:00,136,61,75,FMN GV 16 Berchem TOT
54,Posthofbrug 5366,2022-08-14,16:00:00,136,70,66,FMN GV 16 Berchem TOT
54,Posthofbrug 5366,2022-08-14,17:00:00,134,62,72,FMN GV 16 Berchem TOT
54,Posthofbrug 5366,2022-08-14,18:00:00,128,62,66,FMN GV 16 Berchem TOT
54,Posthofbrug 5366,2022-08-14,19:00:00,97,44,53,FMN GV 16 Berchem TOT
54,Posthofbrug 5366,2022-08-14,20:00:00,123,60,63,FMN GV 16 Berchem TOT
54,Posthofbrug 5366,2022-08-14,21:00:00,100,59,41,FMN GV 16 Berchem TOT
54,Posthofbrug 5366,2022-08-14,22:00:00,91,35,56,FMN GV 16 Berchem TOT
54,Posthofbrug 5366,2022-08-14,23:00:00,49,22,27,FMN GV 16 Berchem TOT
54,Posthofbrug 5366,2022-08-15,00:00:00,54,19,35,FMN GV 16 Berchem TOT
54,Posthofbrug 5366,2022-08-15,01:00:00,23,4,19,FMN GV 16 Berchem TOT
54,Posthofbrug 5366,2022-08-15,02:00:00,29,8,21,FMN GV 16 Berchem TOT
54,Posthofbrug 5366,2022-08-15,03:00:00,15,6,9,FMN GV 16 Berchem TOT
54,Posthofbrug 5366,2022-08-15,04:00:00,9,3,6,FMN GV 16 Berchem TOT
54,Posthofbrug 5366,2022-08-15,05:00:00,15,7,8,FMN GV 16 Berchem TOT
54,Posthofbrug 5366,2022-08-15,06:00:00,16,8,8,FMN GV 16 Berchem TOT
54,Posthofbrug 5366,2022-08-15,07:00:00,33,17,16,FMN GV 16 Berchem TOT
54,Posthofbrug 5366,2022-08-15,08:00:00,44,29,15,FMN GV 16 Berchem TOT
54,Posthofbrug 5366,2022-08-15,09:00:00,94,61,33,FMN GV 16 Berchem TOT
54,Posthofbrug 5366,2022-08-15,10:00:00,109,74,35,FMN GV 16 Berchem TOT
54,Posthofbrug 5366,2022-08-15,11:00:00,146,101,45,FMN GV 16 Berchem TOT
54,Posthofbrug 5366,2022-08-15,12:00:00,183,104,79,FMN GV 16 Berchem TOT
54,Posthofbrug 5366,2022-08-15,13:00:00,180,102,78,FMN GV 16 Berchem TOT
54,Posthofbrug 5366,2022-08-15,14:00:00,203,112,91,FMN GV 16 Berchem TOT
54,Posthofbrug 5366,2022-08-15,15:00:00,189,100,89,FMN GV 16 Berchem TOT
54,Posthofbrug 5366,2022-08-15,16:00:00,186,78,108,FMN GV 16 Berchem TOT
54,Posthofbrug 5366,2022-08-15,17:00:00,141,56,85,FMN GV 16 Berchem TOT
54,Posthofbrug 5366,2022-08-15,18:00:00,144,77,67,FMN GV 16 Berchem TOT
54,Posthofbrug 5366,2022-08-15,19:00:00,137,48,89,FMN GV 16 Berchem TOT
54,Posthofbrug 5366,2022-08-15,20:00:00,114,57,57,FMN GV 16 Berchem TOT
54,Posthofbrug 5366,2022-08-15,21:00:00,128,52,76,FMN GV 16 Berchem TOT
54,Posthofbrug 5366,2022-08-15,22:00:00,63,26,37,FMN GV 16 Berchem TOT
54,Posthofbrug 5366,2022-08-15,23:00:00,43,23,20,FMN GV 16 Berchem TOT
54,Posthofbrug 5366,2022-08-16,00:00:00,27,5,22,FMN GV 16 Berchem TOT
54,Posthofbrug 5366,2022-08-16,01:00:00,10,5,5,FMN GV 16 Berchem TOT
54,Posthofbrug 5366,2022-08-16,02:00:00,8,0,8,FMN GV 16 Berchem TOT
54,Posthofbrug 5366,2022-08-16,03:00:00,3,1,2,FMN GV 16 Berchem TOT
54,Posthofbrug 5366,2022-08-16,04:00:00,14,9,5,FMN GV 16 Berchem TOT
54,Posthofbrug 5366,2022-08-16,05:00:00,30,20,10,FMN GV 16 Berchem TOT
54,Posthofbrug 5366,2022-08-16,06:00:00,118,91,27,FMN GV 16 Berchem TOT
54,Posthofbrug 5366,2022-08-16,07:00:00,301,220,81,FMN GV 16 Berchem TOT
54,Posthofbrug 5366,2022-08-16,08:00:00,555,430,125,FMN GV 16 Berchem TOT
54,Posthofbrug 5366,2022-08-16,09:00:00,275,201,74,FMN GV 16 Berchem TOT
54,Posthofbrug 5366,2022-08-16,10:00:00,133,82,51,FMN GV 16 Berchem TOT
54,Posthofbrug 5366,2022-08-16,11:00:00,119,75,44,FMN GV 16 Berchem TOT
54,Posthofbrug 5366,2022-08-16,12:00:00,131,71,60,FMN GV 16 Berchem TOT
54,Posthofbrug 5366,2022-08-16,13:00:00,156,77,79,FMN GV 16 Berchem TOT
54,Posthofbrug 5366,2022-08-16,14:00:00,161,83,78,FMN GV 16 Berchem TOT
54,Posthofbrug 5366,2022-08-16,15:00:00,184,74,110,FMN GV 16 Berchem TOT
54,Posthofbrug 5366,2022-08-16,16:00:00,361,120,241,FMN GV 16 Berchem TOT
54,Posthofbrug 5366,2022-08-16,17:00:00,531,162,369,FMN GV 16 Berchem TOT
54,Posthofbrug 5366,2022-08-16,18:00:00,351,119,232,FMN GV 16 Berchem TOT
54,Posthofbrug 5366,2022-08-16,19:00:00,213,78,135,FMN GV 16 Berchem TOT
54,Posthofbrug 5366,2022-08-16,20:00:00,137,62,75,FMN GV 16 Berchem TOT
54,Posthofbrug 5366,2022-08-16,21:00:00,105,47,58,FMN GV 16 Berchem TOT
54,Posthofbrug 5366,2022-08-16,22:00:00,91,46,45,FMN GV 16 Berchem TOT
54,Posthofbrug 5366,2022-08-16,23:00:00,66,30,36,FMN GV 16 Berchem TOT
54,Posthofbrug 5366,2022-08-17,00:00:00,48,23,25,FMN GV 16 Berchem TOT
54,Posthofbrug 5366,2022-08-17,01:00:00,16,2,14,FMN GV 16 Berchem TOT
54,Posthofbrug 5366,2022-08-17,02:00:00,11,4,7,FMN GV 16 Berchem TOT
54,Posthofbrug 5366,2022-08-17,03:00:00,12,1,11,FMN GV 16 Berchem TOT
54,Posthofbrug 5366,2022-08-17,04:00:00,9,3,6,FMN GV 16 Berchem TOT
54,Posthofbrug 5366,2022-08-17,05:00:00,33,23,10,FMN GV 16 Berchem TOT
54,Posthofbrug 5366,2022-08-17,06:00:00,105,86,19,FMN GV 16 Berchem TOT
54,Posthofbrug 5366,2022-08-17,07:00:00,250,192,58,FMN GV 16 Berchem TOT
54,Posthofbrug 5366,2022-08-17,08:00:00,436,322,114,FMN GV 16 Berchem TOT
54,Posthofbrug 5366,2022-08-17,09:00:00,191,133,58,FMN GV 16 Berchem TOT
54,Posthofbrug 5366,2022-08-17,10:00:00,102,65,37,FMN GV 16 Berchem TOT
54,Posthofbrug 5366,2022-08-17,11:00:00,60,39,21,FMN GV 16 Berchem TOT
54,Posthofbrug 5366,2022-08-17,12:00:00,72,31,41,FMN GV 16 Berchem TOT
54,Posthofbrug 5366,2022-08-17,13:00:00,119,67,52,FMN GV 16 Berchem TOT
54,Posthofbrug 5366,2022-08-17,14:00:00,97,49,48,FMN GV 16 Berchem TOT
54,Posthofbrug 5366,2022-08-17,15:00:00,107,40,67,FMN GV 16 Berchem TOT
54,Posthofbrug 5366,2022-08-17,16:00:00,302,109,193,FMN GV 16 Berchem TOT
54,Posthofbrug 5366,2022-08-17,17:00:00,355,126,229,FMN GV 16 Berchem TOT
54,Posthofbrug 5366,2022-08-17,18:00:00,248,96,152,FMN GV 16 Berchem TOT
54,Posthofbrug 5366,2022-08-17,19:00:00,157,67,90,FMN GV 16 Berchem TOT
54,Posthofbrug 5366,2022-08-17,20:00:00,89,42,47,FMN GV 16 Berchem TOT
54,Posthofbrug 5366,2022-08-17,21:00:00,76,32,44,FMN GV 16 Berchem TOT
54,Posthofbrug 5366,2022-08-17,22:00:00,70,28,42,FMN GV 16 Berchem TOT
54,Posthofbrug 5366,2022-08-17,23:00:00,65,22,43,FMN GV 16 Berchem TOT
54,Posthofbrug 5366,2022-08-18,00:00:00,29,5,24,FMN GV 16 Berchem TOT
54,Posthofbrug 5366,2022-08-18,01:00:00,15,6,9,FMN GV 16 Berchem TOT
54,Posthofbrug 5366,2022-08-18,02:00:00,4,1,3,FMN GV 16 Berchem TOT
54,Posthofbrug 5366,2022-08-18,03:00:00,6,1,5,FMN GV 16 Berchem TOT
54,Posthofbrug 5366,2022-08-18,04:00:00,8,3,5,FMN GV 16 Berchem TOT
54,Posthofbrug 5366,2022-08-18,05:00:00,34,21,13,FMN GV 16 Berchem TOT
54,Posthofbrug 5366,2022-08-18,06:00:00,108,85,23,FMN GV 16 Berchem TOT
54,Posthofbrug 5366,2022-08-18,07:00:00,304,231,73,FMN GV 16 Berchem TOT
54,Posthofbrug 5366,2022-08-18,08:00:00,552,423,129,FMN GV 16 Berchem TOT
54,Posthofbrug 5366,2022-08-18,09:00:00,236,176,60,FMN GV 16 Berchem TOT
54,Posthofbrug 5366,2022-08-18,10:00:00,141,99,42,FMN GV 16 Berchem TOT
54,Posthofbrug 5366,2022-08-18,11:00:00,121,72,49,FMN GV 16 Berchem TOT
54,Posthofbrug 5366,2022-08-18,12:00:00,156,83,73,FMN GV 16 Berchem TOT
54,Posthofbrug 5366,2022-08-18,13:00:00,160,89,71,FMN GV 16 Berchem TOT
54,Posthofbrug 5366,2022-08-18,14:00:00,152,82,70,FMN GV 16 Berchem TOT
54,Posthofbrug 5366,2022-08-18,15:00:00,215,75,140,FMN GV 16 Berchem TOT
54,Posthofbrug 5366,2022-08-18,16:00:00,381,125,256,FMN GV 16 Berchem TOT
54,Posthofbrug 5366,2022-08-18,17:00:00,523,151,372,FMN GV 16 Berchem TOT
54,Posthofbrug 5366,2022-08-18,18:00:00,331,127,204,FMN GV 16 Berchem TOT
54,Posthofbrug 5366,2022-08-18,19:00:00,235,127,108,FMN GV 16 Berchem TOT
54,Posthofbrug 5366,2022-08-18,20:00:00,167,92,75,FMN GV 16 Berchem TOT
54,Posthofbrug 5366,2022-08-18,21:00:00,118,64,54,FMN GV 16 Berchem TOT
54,Posthofbrug 5366,2022-08-18,22:00:00,100,29,71,FMN GV 16 Berchem TOT
54,Posthofbrug 5366,2022-08-18,23:00:00,90,35,55,FMN GV 16 Berchem TOT
54,Posthofbrug 5366,2022-08-19,00:00:00,53,11,42,FMN GV 16 Berchem TOT
54,Posthofbrug 5366,2022-08-19,01:00:00,27,2,25,FMN GV 16 Berchem TOT
54,Posthofbrug 5366,2022-08-19,02:00:00,20,3,17,FMN GV 16 Berchem TOT
54,Posthofbrug 5366,2022-08-19,03:00:00,8,1,7,FMN GV 16 Berchem TOT
54,Posthofbrug 5366,2022-08-19,04:00:00,10,6,4,FMN GV 16 Berchem TOT
54,Posthofbrug 5366,2022-08-19,05:00:00,33,22,11,FMN GV 16 Berchem TOT
54,Posthofbrug 5366,2022-08-19,06:00:00,72,54,18,FMN GV 16 Berchem TOT
54,Posthofbrug 5366,2022-08-19,07:00:00,206,150,56,FMN GV 16 Berchem TOT
54,Posthofbrug 5366,2022-08-19,08:00:00,380,295,85,FMN GV 16 Berchem TOT
54,Posthofbrug 5366,2022-08-19,09:00:00,201,148,53,FMN GV 16 Berchem TOT
54,Posthofbrug 5366,2022-08-19,10:00:00,129,80,49,FMN GV 16 Berchem TOT
54,Posthofbrug 5366,2022-08-19,11:00:00,109,68,41,FMN GV 16 Berchem TOT
54,Posthofbrug 5366,2022-08-19,12:00:00,144,68,76,FMN GV 16 Berchem TOT
54,Posthofbrug 5366,2022-08-19,13:00:00,156,92,64,FMN GV 16 Berchem TOT
54,Posthofbrug 5366,2022-08-19,14:00:00,146,77,69,FMN GV 16 Berchem TOT
54,Posthofbrug 5366,2022-08-19,15:00:00,188,74,114,FMN GV 16 Berchem TOT
54,Posthofbrug 5366,2022-08-19,16:00:00,286,99,187,FMN GV 16 Berchem TOT
54,Posthofbrug 5366,2022-08-19,17:00:00,275,94,181,FMN GV 16 Berchem TOT
54,Posthofbrug 5366,2022-08-19,18:00:00,231,104,127,FMN GV 16 Berchem TOT
54,Posthofbrug 5366,2022-08-19,19:00:00,124,56,68,FMN GV 16 Berchem TOT
54,Posthofbrug 5366,2022-08-19,20:00:00,95,45,50,FMN GV 16 Berchem TOT
54,Posthofbrug 5366,2022-08-19,21:00:00,78,35,43,FMN GV 16 Berchem TOT
54,Posthofbrug 5366,2022-08-19,22:00:00,67,22,45,FMN GV 16 Berchem TOT
54,Posthofbrug 5366,2022-08-19,23:00:00,70,28,42,FMN GV 16 Berchem TOT
54,Posthofbrug 5366,2022-08-20,00:00:00,52,17,35,FMN GV 16 Berchem TOT
54,Posthofbrug 5366,2022-08-20,01:00:00,30,13,17,FMN GV 16 Berchem TOT
54,Posthofbrug 5366,2022-08-20,02:00:00,18,4,14,FMN GV 16 Berchem TOT
54,Posthofbrug 5366,2022-08-20,03:00:00,28,8,20,FMN GV 16 Berchem TOT
54,Posthofbrug 5366,2022-08-20,04:00:00,12,4,8,FMN GV 16 Berchem TOT
54,Posthofbrug 5366,2022-08-20,05:00:00,16,9,7,FMN GV 16 Berchem TOT
54,Posthofbrug 5366,2022-08-20,06:00:00,21,12,9,FMN GV 16 Berchem TOT
54,Posthofbrug 5366,2022-08-20,07:00:00,37,21,16,FMN GV 16 Berchem TOT
54,Posthofbrug 5366,2022-08-20,08:00:00,65,50,15,FMN GV 16 Berchem TOT
54,Posthofbrug 5366,2022-08-20,09:00:00,114,76,38,FMN GV 16 Berchem TOT
54,Posthofbrug 5366,2022-08-20,10:00:00,164,111,53,FMN GV 16 Berchem TOT
54,Posthofbrug 5366,2022-08-20,11:00:00,173,102,71,FMN GV 16 Berchem TOT
54,Posthofbrug 5366,2022-08-20,12:00:00,202,120,82,FMN GV 16 Berchem TOT
54,Posthofbrug 5366,2022-08-20,13:00:00,188,116,72,FMN GV 16 Berchem TOT
54,Posthofbrug 5366,2022-08-20,14:00:00,218,120,98,FMN GV 16 Berchem TOT
54,Posthofbrug 5366,2022-08-20,15:00:00,183,93,90,FMN GV 16 Berchem TOT
54,Posthofbrug 5366,2022-08-20,16:00:00,176,83,93,FMN GV 16 Berchem TOT
54,Posthofbrug 5366,2022-08-20,17:00:00,207,120,87,FMN GV 16 Berchem TOT
54,Posthofbrug 5366,2022-08-20,18:00:00,173,71,102,FMN GV 16 Berchem TOT
54,Posthofbrug 5366,2022-08-20,19:00:00,127,59,68,FMN GV 16 Berchem TOT
54,Posthofbrug 5366,2022-08-20,20:00:00,111,51,60,FMN GV 16 Berchem TOT
54,Posthofbrug 5366,2022-08-20,21:00:00,86,36,50,FMN GV 16 Berchem TOT
54,Posthofbrug 5366,2022-08-20,22:00:00,93,34,59,FMN GV 16 Berchem TOT
54,Posthofbrug 5366,2022-08-20,23:00:00,61,23,38,FMN GV 16 Berchem TOT
54,Posthofbrug 5366,2022-08-21,00:00:00,43,11,32,FMN GV 16 Berchem TOT
54,Posthofbrug 5366,2022-08-21,01:00:00,42,17,25,FMN GV 16 Berchem TOT
54,Posthofbrug 5366,2022-08-21,02:00:00,17,5,12,FMN GV 16 Berchem TOT
54,Posthofbrug 5366,2022-08-21,03:00:00,18,3,15,FMN GV 16 Berchem TOT
54,Posthofbrug 5366,2022-08-21,04:00:00,20,7,13,FMN GV 16 Berchem TOT
54,Posthofbrug 5366,2022-08-21,05:00:00,23,7,16,FMN GV 16 Berchem TOT
54,Posthofbrug 5366,2022-08-21,06:00:00,13,6,7,FMN GV 16 Berchem TOT
54,Posthofbrug 5366,2022-08-21,07:00:00,29,13,16,FMN GV 16 Berchem TOT
54,Posthofbrug 5366,2022-08-21,08:00:00,57,39,18,FMN GV 16 Berchem TOT
54,Posthofbrug 5366,2022-08-21,09:00:00,101,66,35,FMN GV 16 Berchem TOT
54,Posthofbrug 5366,2022-08-21,10:00:00,151,95,56,FMN GV 16 Berchem TOT
54,Posthofbrug 5366,2022-08-21,11:00:00,151,83,68,FMN GV 16 Berchem TOT
54,Posthofbrug 5366,2022-08-21,12:00:00,208,127,81,FMN GV 16 Berchem TOT
54,Posthofbrug 5366,2022-08-21,13:00:00,191,118,73,FMN GV 16 Berchem TOT
54,Posthofbrug 5366,2022-08-21,14:00:00,225,127,98,FMN GV 16 Berchem TOT
54,Posthofbrug 5366,2022-08-21,15:00:00,224,119,105,FMN GV 16 Berchem TOT
54,Posthofbrug 5366,2022-08-21,16:00:00,200,97,103,FMN GV 16 Berchem TOT
54,Posthofbrug 5366,2022-08-21,17:00:00,176,80,96,FMN GV 16 Berchem TOT
54,Posthofbrug 5366,2022-08-21,18:00:00,183,79,104,FMN GV 16 Berchem TOT
54,Posthofbrug 5366,2022-08-21,19:00:00,113,48,65,FMN GV 16 Berchem TOT
54,Posthofbrug 5366,2022-08-21,20:00:00,128,54,74,FMN GV 16 Berchem TOT
54,Posthofbrug 5366,2022-08-21,21:00:00,98,51,47,FMN GV 16 Berchem TOT
54,Posthofbrug 5366,2022-08-21,22:00:00,64,37,27,FMN GV 16 Berchem TOT
54,Posthofbrug 5366,2022-08-21,23:00:00,38,10,28,FMN GV 16 Berchem TOT
54,Posthofbrug 5366,2022-08-22,00:00:00,20,4,16,FMN GV 16 Berchem TOT
54,Posthofbrug 5366,2022-08-22,01:00:00,17,0,17,FMN GV 16 Berchem TOT
54,Posthofbrug 5366,2022-08-22,02:00:00,7,0,7,FMN GV 16 Berchem TOT
54,Posthofbrug 5366,2022-08-22,03:00:00,7,1,6,FMN GV 16 Berchem TOT
54,Posthofbrug 5366,2022-08-22,04:00:00,8,3,5,FMN GV 16 Berchem TOT
54,Posthofbrug 5366,2022-08-22,05:00:00,25,15,10,FMN GV 16 Berchem TOT
54,Posthofbrug 5366,2022-08-22,06:00:00,118,91,27,FMN GV 16 Berchem TOT
54,Posthofbrug 5366,2022-08-22,07:00:00,295,228,67,FMN GV 16 Berchem TOT
54,Posthofbrug 5366,2022-08-22,08:00:00,606,471,135,FMN GV 16 Berchem TOT
54,Posthofbrug 5366,2022-08-22,09:00:00,261,197,64,FMN GV 16 Berchem TOT
54,Posthofbrug 5366,2022-08-22,10:00:00,147,94,53,FMN GV 16 Berchem TOT
54,Posthofbrug 5366,2022-08-22,11:00:00,132,72,60,FMN GV 16 Berchem TOT
54,Posthofbrug 5366,2022-08-22,12:00:00,165,72,93,FMN GV 16 Berchem TOT
54,Posthofbrug 5366,2022-08-22,13:00:00,139,84,55,FMN GV 16 Berchem TOT
54,Posthofbrug 5366,2022-08-22,14:00:00,155,69,86,FMN GV 16 Berchem TOT
54,Posthofbrug 5366,2022-08-22,15:00:00,220,100,120,FMN GV 16 Berchem TOT
54,Posthofbrug 5366,2022-08-22,16:00:00,389,126,263,FMN GV 16 Berchem TOT
54,Posthofbrug 5366,2022-08-22,17:00:00,580,191,389,FMN GV 16 Berchem TOT
54,Posthofbrug 5366,2022-08-22,18:00:00,381,109,272,FMN GV 16 Berchem TOT
54,Posthofbrug 5366,2022-08-22,19:00:00,203,80,123,FMN GV 16 Berchem TOT
54,Posthofbrug 5366,2022-08-22,20:00:00,148,68,80,FMN GV 16 Berchem TOT
54,Posthofbrug 5366,2022-08-22,21:00:00,92,43,49,FMN GV 16 Berchem TOT
54,Posthofbrug 5366,2022-08-22,22:00:00,89,39,50,FMN GV 16 Berchem TOT
54,Posthofbrug 5366,2022-08-22,23:00:00,65,26,39,FMN GV 16 Berchem TOT
54,Posthofbrug 5366,2022-08-23,00:00:00,26,14,12,FMN GV 16 Berchem TOT
54,Posthofbrug 5366,2022-08-23,01:00:00,17,6,11,FMN GV 16 Berchem TOT
54,Posthofbrug 5366,2022-08-23,02:00:00,4,2,2,FMN GV 16 Berchem TOT
54,Posthofbrug 5366,2022-08-23,03:00:00,8,1,7,FMN GV 16 Berchem TOT
54,Posthofbrug 5366,2022-08-23,04:00:00,9,6,3,FMN GV 16 Berchem TOT
54,Posthofbrug 5366,2022-08-23,05:00:00,35,26,9,FMN GV 16 Berchem TOT
54,Posthofbrug 5366,2022-08-23,06:00:00,147,118,29,FMN GV 16 Berchem TOT
54,Posthofbrug 5366,2022-08-23,07:00:00,388,298,90,FMN GV 16 Berchem TOT
54,Posthofbrug 5366,2022-08-23,08:00:00,748,573,175,FMN GV 16 Berchem TOT
54,Posthofbrug 5366,2022-08-23,09:00:00,361,268,93,FMN GV 16 Berchem TOT
54,Posthofbrug 5366,2022-08-23,10:00:00,163,108,55,FMN GV 16 Berchem TOT
54,Posthofbrug 5366,2022-08-23,11:00:00,183,109,74,FMN GV 16 Berchem TOT
54,Posthofbrug 5366,2022-08-23,12:00:00,165,106,59,FMN GV 16 Berchem TOT
54,Posthofbrug 5366,2022-08-23,13:00:00,160,84,76,FMN GV 16 Berchem TOT
54,Posthofbrug 5366,2022-08-23,14:00:00,184,85,99,FMN GV 16 Berchem TOT
54,Posthofbrug 5366,2022-08-23,15:00:00,235,82,153,FMN GV 16 Berchem TOT
54,Posthofbrug 5366,2022-08-23,16:00:00,474,147,327,FMN GV 16 Berchem TOT
54,Posthofbrug 5366,2022-08-23,17:00:00,666,210,456,FMN GV 16 Berchem TOT
54,Posthofbrug 5366,2022-08-23,18:00:00,501,178,323,FMN GV 16 Berchem TOT
54,Posthofbrug 5366,2022-08-23,19:00:00,231,98,133,FMN GV 16 Berchem TOT
54,Posthofbrug 5366,2022-08-23,20:00:00,192,114,78,FMN GV 16 Berchem TOT
54,Posthofbrug 5366,2022-08-23,21:00:00,132,49,83,FMN GV 16 Berchem TOT
54,Posthofbrug 5366,2022-08-23,22:00:00,134,45,89,FMN GV 16 Berchem TOT
54,Posthofbrug 5366,2022-08-23,23:00:00,81,28,53,FMN GV 16 Berchem TOT
54,Posthofbrug 5366,2022-08-24,00:00:00,42,12,30,FMN GV 16 Berchem TOT
54,Posthofbrug 5366,2022-08-24,01:00:00,10,3,7,FMN GV 16 Berchem TOT
54,Posthofbrug 5366,2022-08-24,02:00:00,6,1,5,FMN GV 16 Berchem TOT
54,Posthofbrug 5366,2022-08-24,03:00:00,3,0,3,FMN GV 16 Berchem TOT
54,Posthofbrug 5366,2022-08-24,04:00:00,14,8,6,FMN GV 16 Berchem TOT
54,Posthofbrug 5366,2022-08-24,05:00:00,28,19,9,FMN GV 16 Berchem TOT
54,Posthofbrug 5366,2022-08-24,06:00:00,121,98,23,FMN GV 16 Berchem TOT
54,Posthofbrug 5366,2022-08-24,07:00:00,348,255,93,FMN GV 16 Berchem TOT
54,Posthofbrug 5366,2022-08-24,08:00:00,663,498,165,FMN GV 16 Berchem TOT
54,Posthofbrug 5366,2022-08-24,09:00:00,284,197,87,FMN GV 16 Berchem TOT
54,Posthofbrug 5366,2022-08-24,10:00:00,149,96,53,FMN GV 16 Berchem TOT
54,Posthofbrug 5366,2022-08-24,11:00:00,160,94,66,FMN GV 16 Berchem TOT
54,Posthofbrug 5366,2022-08-24,12:00:00,200,96,104,FMN GV 16 Berchem TOT
54,Posthofbrug 5366,2022-08-24,13:00:00,189,106,83,FMN GV 16 Berchem TOT
54,Posthofbrug 5366,2022-08-24,14:00:00,159,64,95,FMN GV 16 Berchem TOT
54,Posthofbrug 5366,2022-08-24,15:00:00,205,85,120,FMN GV 16 Berchem TOT
54,Posthofbrug 5366,2022-08-24,16:00:00,408,149,259,FMN GV 16 Berchem TOT
54,Posthofbrug 5366,2022-08-24,17:00:00,579,195,384,FMN GV 16 Berchem TOT
54,Posthofbrug 5366,2022-08-24,18:00:00,437,145,292,FMN GV 16 Berchem TOT
54,Posthofbrug 5366,2022-08-24,19:00:00,245,105,140,FMN GV 16 Berchem TOT
54,Posthofbrug 5366,2022-08-24,20:00:00,192,114,78,FMN GV 16 Berchem TOT
54,Posthofbrug 5366,2022-08-24,21:00:00,136,61,75,FMN GV 16 Berchem TOT
54,Posthofbrug 5366,2022-08-24,22:00:00,156,58,98,FMN GV 16 Berchem TOT
54,Posthofbrug 5366,2022-08-24,23:00:00,100,37,63,FMN GV 16 Berchem TOT
54,Posthofbrug 5366,2022-08-25,00:00:00,49,19,30,FMN GV 16 Berchem TOT
54,Posthofbrug 5366,2022-08-25,01:00:00,11,6,5,FMN GV 16 Berchem TOT
54,Posthofbrug 5366,2022-08-25,02:00:00,10,0,10,FMN GV 16 Berchem TOT
54,Posthofbrug 5366,2022-08-25,03:00:00,13,1,12,FMN GV 16 Berchem TOT
54,Posthofbrug 5366,2022-08-25,04:00:00,9,7,2,FMN GV 16 Berchem TOT
54,Posthofbrug 5366,2022-08-25,05:00:00,43,31,12,FMN GV 16 Berchem TOT
54,Posthofbrug 5366,2022-08-25,06:00:00,116,89,27,FMN GV 16 Berchem TOT
54,Posthofbrug 5366,2022-08-25,07:00:00,364,282,82,FMN GV 16 Berchem TOT
54,Posthofbrug 5366,2022-08-25,08:00:00,718,540,178,FMN GV 16 Berchem TOT
54,Posthofbrug 5366,2022-08-25,09:00:00,301,237,64,FMN GV 16 Berchem TOT
54,Posthofbrug 5366,2022-08-25,10:00:00,153,96,57,FMN GV 16 Berchem TOT
54,Posthofbrug 5366,2022-08-25,11:00:00,156,84,72,FMN GV 16 Berchem TOT
54,Posthofbrug 5366,2022-08-25,12:00:00,181,93,88,FMN GV 16 Berchem TOT
54,Posthofbrug 5366,2022-08-25,13:00:00,170,91,79,FMN GV 16 Berchem TOT
54,Posthofbrug 5366,2022-08-25,14:00:00,152,73,79,FMN GV 16 Berchem TOT
54,Posthofbrug 5366,2022-08-25,15:00:00,220,60,160,FMN GV 16 Berchem TOT
54,Posthofbrug 5366,2022-08-25,16:00:00,442,143,299,FMN GV 16 Berchem TOT
54,Posthofbrug 5366,2022-08-25,17:00:00,517,172,345,FMN GV 16 Berchem TOT
54,Posthofbrug 5366,2022-08-25,18:00:00,405,116,289,FMN GV 16 Berchem TOT
54,Posthofbrug 5366,2022-08-25,19:00:00,236,108,128,FMN GV 16 Berchem TOT
54,Posthofbrug 5366,2022-08-25,20:00:00,206,115,91,FMN GV 16 Berchem TOT
54,Posthofbrug 5366,2022-08-25,21:00:00,164,64,100,FMN GV 16 Berchem TOT
54,Posthofbrug 5366,2022-08-25,22:00:00,106,43,63,FMN GV 16 Berchem TOT
54,Posthofbrug 5366,2022-08-25,23:00:00,100,48,52,FMN GV 16 Berchem TOT
54,Posthofbrug 5366,2022-08-26,00:00:00,42,12,30,FMN GV 16 Berchem TOT
54,Posthofbrug 5366,2022-08-26,01:00:00,31,8,23,FMN GV 16 Berchem TOT
54,Posthofbrug 5366,2022-08-26,02:00:00,11,4,7,FMN GV 16 Berchem TOT
54,Posthofbrug 5366,2022-08-26,03:00:00,15,2,13,FMN GV 16 Berchem TOT
54,Posthofbrug 5366,2022-08-26,04:00:00,16,8,8,FMN GV 16 Berchem TOT
54,Posthofbrug 5366,2022-08-26,05:00:00,42,20,22,FMN GV 16 Berchem TOT
54,Posthofbrug 5366,2022-08-26,06:00:00,104,78,26,FMN GV 16 Berchem TOT
54,Posthofbrug 5366,2022-08-26,07:00:00,271,199,72,FMN GV 16 Berchem TOT
54,Posthofbrug 5366,2022-08-26,08:00:00,529,428,101,FMN GV 16 Berchem TOT
54,Posthofbrug 5366,2022-08-26,09:00:00,265,198,67,FMN GV 16 Berchem TOT
54,Posthofbrug 5366,2022-08-26,10:00:00,144,93,51,FMN GV 16 Berchem TOT
54,Posthofbrug 5366,2022-08-26,11:00:00,147,79,68,FMN GV 16 Berchem TOT
54,Posthofbrug 5366,2022-08-26,12:00:00,199,93,106,FMN GV 16 Berchem TOT
54,Posthofbrug 5366,2022-08-26,13:00:00,163,87,76,FMN GV 16 Berchem TOT
54,Posthofbrug 5366,2022-08-26,14:00:00,212,105,107,FMN GV 16 Berchem TOT
54,Posthofbrug 5366,2022-08-26,15:00:00,254,92,162,FMN GV 16 Berchem TOT
54,Posthofbrug 5366,2022-08-26,16:00:00,396,141,255,FMN GV 16 Berchem TOT
54,Posthofbrug 5366,2022-08-26,17:00:00,434,163,271,FMN GV 16 Berchem TOT
54,Posthofbrug 5366,2022-08-26,18:00:00,307,128,179,FMN GV 16 Berchem TOT
54,Posthofbrug 5366,2022-08-26,19:00:00,189,89,100,FMN GV 16 Berchem TOT
54,Posthofbrug 5366,2022-08-26,20:00:00,111,55,56,FMN GV 16 Berchem TOT
54,Posthofbrug 5366,2022-08-26,21:00:00,130,57,73,FMN GV 16 Berchem TOT
54,Posthofbrug 5366,2022-08-26,22:00:00,102,33,69,FMN GV 16 Berchem TOT
54,Posthofbrug 5366,2022-08-26,23:00:00,84,24,60,FMN GV 16 Berchem TOT
54,Posthofbrug 5366,2022-08-27,00:00:00,88,31,57,FMN GV 16 Berchem TOT
54,Posthofbrug 5366,2022-08-27,01:00:00,57,20,37,FMN GV 16 Berchem TOT
54,Posthofbrug 5366,2022-08-27,02:00:00,35,20,15,FMN GV 16 Berchem TOT
54,Posthofbrug 5366,2022-08-27,03:00:00,24,13,11,FMN GV 16 Berchem TOT
54,Posthofbrug 5366,2022-08-27,04:00:00,20,7,13,FMN GV 16 Berchem TOT
54,Posthofbrug 5366,2022-08-27,05:00:00,25,12,13,FMN GV 16 Berchem TOT
54,Posthofbrug 5366,2022-08-27,06:00:00,22,16,6,FMN GV 16 Berchem TOT
54,Posthofbrug 5366,2022-08-27,07:00:00,46,30,16,FMN GV 16 Berchem TOT
54,Posthofbrug 5366,2022-08-27,08:00:00,84,60,24,FMN GV 16 Berchem TOT
54,Posthofbrug 5366,2022-08-27,09:00:00,134,89,45,FMN GV 16 Berchem TOT
54,Posthofbrug 5366,2022-08-27,10:00:00,214,135,79,FMN GV 16 Berchem TOT
54,Posthofbrug 5366,2022-08-27,11:00:00,188,122,66,FMN GV 16 Berchem TOT
54,Posthofbrug 5366,2022-08-27,12:00:00,198,119,79,FMN GV 16 Berchem TOT
54,Posthofbrug 5366,2022-08-27,13:00:00,224,125,99,FMN GV 16 Berchem TOT
54,Posthofbrug 5366,2022-08-27,14:00:00,250,134,116,FMN GV 16 Berchem TOT
54,Posthofbrug 5366,2022-08-27,15:00:00,209,97,112,FMN GV 16 Berchem TOT
54,Posthofbrug 5366,2022-08-27,16:00:00,217,80,137,FMN GV 16 Berchem TOT
54,Posthofbrug 5366,2022-08-27,17:00:00,164,74,90,FMN GV 16 Berchem TOT
54,Posthofbrug 5366,2022-08-27,18:00:00,192,83,109,FMN GV 16 Berchem TOT
54,Posthofbrug 5366,2022-08-27,19:00:00,153,78,75,FMN GV 16 Berchem TOT
54,Posthofbrug 5366,2022-08-27,20:00:00,99,43,56,FMN GV 16 Berchem TOT
54,Posthofbrug 5366,2022-08-27,21:00:00,101,44,57,FMN GV 16 Berchem TOT
54,Posthofbrug 5366,2022-08-27,22:00:00,90,30,60,FMN GV 16 Berchem TOT
54,Posthofbrug 5366,2022-08-27,23:00:00,95,35,60,FMN GV 16 Berchem TOT
54,Posthofbrug 5366,2022-08-28,00:00:00,60,24,36,FMN GV 16 Berchem TOT
54,Posthofbrug 5366,2022-08-28,01:00:00,41,17,24,FMN GV 16 Berchem TOT
54,Posthofbrug 5366,2022-08-28,02:00:00,47,12,35,FMN GV 16 Berchem TOT
54,Posthofbrug 5366,2022-08-28,03:00:00,35,12,23,FMN GV 16 Berchem TOT
54,Posthofbrug 5366,2022-08-28,04:00:00,25,8,17,FMN GV 16 Berchem TOT
54,Posthofbrug 5366,2022-08-28,05:00:00,16,7,9,FMN GV 16 Berchem TOT
54,Posthofbrug 5366,2022-08-28,06:00:00,22,16,6,FMN GV 16 Berchem TOT
54,Posthofbrug 5366,2022-08-28,07:00:00,29,21,8,FMN GV 16 Berchem TOT
54,Posthofbrug 5366,2022-08-28,08:00:00,66,42,24,FMN GV 16 Berchem TOT
54,Posthofbrug 5366,2022-08-28,09:00:00,114,73,41,FMN GV 16 Berchem TOT
54,Posthofbrug 5366,2022-08-28,10:00:00,167,115,52,FMN GV 16 Berchem TOT
54,Posthofbrug 5366,2022-08-28,11:00:00,211,120,91,FMN GV 16 Berchem TOT
54,Posthofbrug 5366,2022-08-28,12:00:00,205,124,81,FMN GV 16 Berchem TOT
54,Posthofbrug 5366,2022-08-28,13:00:00,242,145,97,FMN GV 16 Berchem TOT
54,Posthofbrug 5366,2022-08-28,14:00:00,223,129,94,FMN GV 16 Berchem TOT
54,Posthofbrug 5366,2022-08-28,15:00:00,268,126,142,FMN GV 16 Berchem TOT
54,Posthofbrug 5366,2022-08-28,16:00:00,203,79,124,FMN GV 16 Berchem TOT
54,Posthofbrug 5366,2022-08-28,17:00:00,193,70,123,FMN GV 16 Berchem TOT
54,Posthofbrug 5366,2022-08-28,18:00:00,216,98,118,FMN GV 16 Berchem TOT
54,Posthofbrug 5366,2022-08-28,19:00:00,153,73,80,FMN GV 16 Berchem TOT
54,Posthofbrug 5366,2022-08-28,20:00:00,126,49,77,FMN GV 16 Berchem TOT
54,Posthofbrug 5366,2022-08-28,21:00:00,111,51,60,FMN GV 16 Berchem TOT
54,Posthofbrug 5366,2022-08-28,22:00:00,108,49,59,FMN GV 16 Berchem TOT
54,Posthofbrug 5366,2022-08-28,23:00:00,32,8,24,FMN GV 16 Berchem TOT
54,Posthofbrug 5366,2022-08-29,00:00:00,21,6,15,FMN GV 16 Berchem TOT
54,Posthofbrug 5366,2022-08-29,01:00:00,11,3,8,FMN GV 16 Berchem TOT
54,Posthofbrug 5366,2022-08-29,02:00:00,13,3,10,FMN GV 16 Berchem TOT
54,Posthofbrug 5366,2022-08-29,03:00:00,5,0,5,FMN GV 16 Berchem TOT
54,Posthofbrug 5366,2022-08-29,04:00:00,11,8,3,FMN GV 16 Berchem TOT
54,Posthofbrug 5366,2022-08-29,05:00:00,25,15,10,FMN GV 16 Berchem TOT
54,Posthofbrug 5366,2022-08-29,06:00:00,112,85,27,FMN GV 16 Berchem TOT
54,Posthofbrug 5366,2022-08-29,07:00:00,345,255,90,FMN GV 16 Berchem TOT
54,Posthofbrug 5366,2022-08-29,08:00:00,694,559,135,FMN GV 16 Berchem TOT
54,Posthofbrug 5366,2022-08-29,09:00:00,315,251,64,FMN GV 16 Berchem TOT
54,Posthofbrug 5366,2022-08-29,10:00:00,145,98,47,FMN GV 16 Berchem TOT
54,Posthofbrug 5366,2022-08-29,11:00:00,127,78,49,FMN GV 16 Berchem TOT
54,Posthofbrug 5366,2022-08-29,12:00:00,194,103,91,FMN GV 16 Berchem TOT
54,Posthofbrug 5366,2022-08-29,13:00:00,196,98,98,FMN GV 16 Berchem TOT
54,Posthofbrug 5366,2022-08-29,14:00:00,181,88,93,FMN GV 16 Berchem TOT
54,Posthofbrug 5366,2022-08-29,15:00:00,251,83,168,FMN GV 16 Berchem TOT
54,Posthofbrug 5366,2022-08-29,16:00:00,451,129,322,FMN GV 16 Berchem TOT
54,Posthofbrug 5366,2022-08-29,17:00:00,625,175,450,FMN GV 16 Berchem TOT
54,Posthofbrug 5366,2022-08-29,18:00:00,417,149,268,FMN GV 16 Berchem TOT
54,Posthofbrug 5366,2022-08-29,19:00:00,202,88,114,FMN GV 16 Berchem TOT
54,Posthofbrug 5366,2022-08-29,20:00:00,162,75,87,FMN GV 16 Berchem TOT
54,Posthofbrug 5366,2022-08-29,21:00:00,115,49,66,FMN GV 16 Berchem TOT
54,Posthofbrug 5366,2022-08-29,22:00:00,108,44,64,FMN GV 16 Berchem TOT
54,Posthofbrug 5366,2022-08-29,23:00:00,48,17,31,FMN GV 16 Berchem TOT
54,Posthofbrug 5366,2022-08-30,00:00:00,23,5,18,FMN GV 16 Berchem TOT
54,Posthofbrug 5366,2022-08-30,01:00:00,16,3,13,FMN GV 16 Berchem TOT
54,Posthofbrug 5366,2022-08-30,02:00:00,4,1,3,FMN GV 16 Berchem TOT
54,Posthofbrug 5366,2022-08-30,03:00:00,4,1,3,FMN GV 16 Berchem TOT
54,Posthofbrug 5366,2022-08-30,04:00:00,10,5,5,FMN GV 16 Berchem TOT
54,Posthofbrug 5366,2022-08-30,05:00:00,39,23,16,FMN GV 16 Berchem TOT
54,Posthofbrug 5366,2022-08-30,06:00:00,140,108,32,FMN GV 16 Berchem TOT
54,Posthofbrug 5366,2022-08-30,07:00:00,420,311,109,FMN GV 16 Berchem TOT
54,Posthofbrug 5366,2022-08-30,08:00:00,751,590,161,FMN GV 16 Berchem TOT
54,Posthofbrug 5366,2022-08-30,09:00:00,339,258,81,FMN GV 16 Berchem TOT
54,Posthofbrug 5366,2022-08-30,10:00:00,178,128,50,FMN GV 16 Berchem TOT
54,Posthofbrug 5366,2022-08-30,11:00:00,152,97,55,FMN GV 16 Berchem TOT
54,Posthofbrug 5366,2022-08-30,12:00:00,160,94,66,FMN GV 16 Berchem TOT
54,Posthofbrug 5366,2022-08-30,13:00:00,242,145,97,FMN GV 16 Berchem TOT
54,Posthofbrug 5366,2022-08-30,14:00:00,218,94,124,FMN GV 16 Berchem TOT
54,Posthofbrug 5366,2022-08-30,15:00:00,280,102,178,FMN GV 16 Berchem TOT
54,Posthofbrug 5366,2022-08-30,16:00:00,518,170,348,FMN GV 16 Berchem TOT
54,Posthofbrug 5366,2022-08-30,17:00:00,677,190,487,FMN GV 16 Berchem TOT
54,Posthofbrug 5366,2022-08-30,18:00:00,500,162,338,FMN GV 16 Berchem TOT
54,Posthofbrug 5366,2022-08-30,19:00:00,246,101,145,FMN GV 16 Berchem TOT
54,Posthofbrug 5366,2022-08-30,20:00:00,189,98,91,FMN GV 16 Berchem TOT
54,Posthofbrug 5366,2022-08-30,21:00:00,164,76,88,FMN GV 16 Berchem TOT
54,Posthofbrug 5366,2022-08-30,22:00:00,121,55,66,FMN GV 16 Berchem TOT
54,Posthofbrug 5366,2022-08-30,23:00:00,80,31,49,FMN GV 16 Berchem TOT
54,Posthofbrug 5366,2022-08-31,00:00:00,37,10,27,FMN GV 16 Berchem TOT
54,Posthofbrug 5366,2022-08-31,01:00:00,19,4,15,FMN GV 16 Berchem TOT
54,Posthofbrug 5366,2022-08-31,02:00:00,14,2,12,FMN GV 16 Berchem TOT
54,Posthofbrug 5366,2022-08-31,03:00:00,23,4,19,FMN GV 16 Berchem TOT
54,Posthofbrug 5366,2022-08-31,04:00:00,19,8,11,FMN GV 16 Berchem TOT
54,Posthofbrug 5366,2022-08-31,05:00:00,32,19,13,FMN GV 16 Berchem TOT
54,Posthofbrug 5366,2022-08-31,06:00:00,127,103,24,FMN GV 16 Berchem TOT
54,Posthofbrug 5366,2022-08-31,07:00:00,339,244,95,FMN GV 16 Berchem TOT
54,Posthofbrug 5366,2022-08-31,08:00:00,629,489,140,FMN GV 16 Berchem TOT
54,Posthofbrug 5366,2022-08-31,09:00:00,333,262,71,FMN GV 16 Berchem TOT
54,Posthofbrug 5366,2022-08-31,10:00:00,178,122,56,FMN GV 16 Berchem TOT
54,Posthofbrug 5366,2022-08-31,11:00:00,160,84,76,FMN GV 16 Berchem TOT
54,Posthofbrug 5366,2022-08-31,12:00:00,221,127,94,FMN GV 16 Berchem TOT
54,Posthofbrug 5366,2022-08-31,13:00:00,238,122,116,FMN GV 16 Berchem TOT
54,Posthofbrug 5366,2022-08-31,14:00:00,262,131,131,FMN GV 16 Berchem TOT
54,Posthofbrug 5366,2022-08-31,15:00:00,244,86,158,FMN GV 16 Berchem TOT
54,Posthofbrug 5366,2022-08-31,16:00:00,453,158,295,FMN GV 16 Berchem TOT
54,Posthofbrug 5366,2022-08-31,17:00:00,604,199,405,FMN GV 16 Berchem TOT
54,Posthofbrug 5366,2022-08-31,18:00:00,447,167,280,FMN GV 16 Berchem TOT
54,Posthofbrug 5366,2022-08-31,19:00:00,261,91,170,FMN GV 16 Berchem TOT
54,Posthofbrug 5366,2022-08-31,20:00:00,180,97,83,FMN GV 16 Berchem TOT
54,Posthofbrug 5366,2022-08-31,21:00:00,135,67,68,FMN GV 16 Berchem TOT
54,Posthofbrug 5366,2022-08-31,22:00:00,105,24,81,FMN GV 16 Berchem TOT
54,Posthofbrug 5366,2022-08-31,23:00:00,75,22,53,FMN GV 16 Berchem TOT
54,Posthofbrug 5366,2022-09-01,00:00:00,33,11,22,FMN GV 16 Berchem TOT
54,Posthofbrug 5366,2022-09-01,01:00:00,25,11,14,FMN GV 16 Berchem TOT
54,Posthofbrug 5366,2022-09-01,02:00:00,10,0,10,FMN GV 16 Berchem TOT
54,Posthofbrug 5366,2022-09-01,03:00:00,6,2,4,FMN GV 16 Berchem TOT
54,Posthofbrug 5366,2022-09-01,04:00:00,20,14,6,FMN GV 16 Berchem TOT
54,Posthofbrug 5366,2022-09-01,05:00:00,33,18,15,FMN GV 16 Berchem TOT
54,Posthofbrug 5366,2022-09-01,06:00:00,143,105,38,FMN GV 16 Berchem TOT
54,Posthofbrug 5366,2022-09-01,07:00:00,479,383,96,FMN GV 16 Berchem TOT
54,Posthofbrug 5366,2022-09-01,08:00:00,853,670,183,FMN GV 16 Berchem TOT
54,Posthofbrug 5366,2022-09-01,09:00:00,383,290,93,FMN GV 16 Berchem TOT
54,Posthofbrug 5366,2022-09-01,10:00:00,172,127,45,FMN GV 16 Berchem TOT
54,Posthofbrug 5366,2022-09-01,11:00:00,157,106,51,FMN GV 16 Berchem TOT
54,Posthofbrug 5366,2022-09-01,12:00:00,245,120,125,FMN GV 16 Berchem TOT
54,Posthofbrug 5366,2022-09-01,13:00:00,216,104,112,FMN GV 16 Berchem TOT
54,Posthofbrug 5366,2022-09-01,14:00:00,236,96,140,FMN GV 16 Berchem TOT
54,Posthofbrug 5366,2022-09-01,15:00:00,371,128,243,FMN GV 16 Berchem TOT
54,Posthofbrug 5366,2022-09-01,16:00:00,521,164,357,FMN GV 16 Berchem TOT
54,Posthofbrug 5366,2022-09-01,17:00:00,625,176,449,FMN GV 16 Berchem TOT
54,Posthofbrug 5366,2022-09-01,18:00:00,447,143,304,FMN GV 16 Berchem TOT
54,Posthofbrug 5366,2022-09-01,19:00:00,289,133,156,FMN GV 16 Berchem TOT
54,Posthofbrug 5366,2022-09-01,20:00:00,187,106,81,FMN GV 16 Berchem TOT
54,Posthofbrug 5366,2022-09-01,21:00:00,138,66,72,FMN GV 16 Berchem TOT
54,Posthofbrug 5366,2022-09-01,22:00:00,124,43,81,FMN GV 16 Berchem TOT
54,Posthofbrug 5366,2022-09-01,23:00:00,75,28,47,FMN GV 16 Berchem TOT
54,Posthofbrug 5366,2022-09-02,00:00:00,45,22,23,FMN GV 16 Berchem TOT
54,Posthofbrug 5366,2022-09-02,01:00:00,24,5,19,FMN GV 16 Berchem TOT
54,Posthofbrug 5366,2022-09-02,02:00:00,11,3,8,FMN GV 16 Berchem TOT
54,Posthofbrug 5366,2022-09-02,03:00:00,8,4,4,FMN GV 16 Berchem TOT
54,Posthofbrug 5366,2022-09-02,04:00:00,22,13,9,FMN GV 16 Berchem TOT
54,Posthofbrug 5366,2022-09-02,05:00:00,30,17,13,FMN GV 16 Berchem TOT
54,Posthofbrug 5366,2022-09-02,06:00:00,125,95,30,FMN GV 16 Berchem TOT
54,Posthofbrug 5366,2022-09-02,07:00:00,431,327,104,FMN GV 16 Berchem TOT
54,Posthofbrug 5366,2022-09-02,08:00:00,725,574,151,FMN GV 16 Berchem TOT
54,Posthofbrug 5366,2022-09-02,09:00:00,277,213,64,FMN GV 16 Berchem TOT
54,Posthofbrug 5366,2022-09-02,10:00:00,185,127,58,FMN GV 16 Berchem TOT
54,Posthofbrug 5366,2022-09-02,11:00:00,187,116,71,FMN GV 16 Berchem TOT
54,Posthofbrug 5366,2022-09-02,12:00:00,226,108,118,FMN GV 16 Berchem TOT
54,Posthofbrug 5366,2022-09-02,13:00:00,211,111,100,FMN GV 16 Berchem TOT
54,Posthofbrug 5366,2022-09-02,14:00:00,239,107,132,FMN GV 16 Berchem TOT
54,Posthofbrug 5366,2022-09-02,15:00:00,356,126,230,FMN GV 16 Berchem TOT
54,Posthofbrug 5366,2022-09-02,16:00:00,472,141,331,FMN GV 16 Berchem TOT
54,Posthofbrug 5366,2022-09-02,17:00:00,521,151,370,FMN GV 16 Berchem TOT
54,Posthofbrug 5366,2022-09-02,18:00:00,407,178,229,FMN GV 16 Berchem TOT
54,Posthofbrug 5366,2022-09-02,19:00:00,253,123,130,FMN GV 16 Berchem TOT
54,Posthofbrug 5366,2022-09-02,20:00:00,172,76,96,FMN GV 16 Berchem TOT
54,Posthofbrug 5366,2022-09-02,21:00:00,123,59,64,FMN GV 16 Berchem TOT
54,Posthofbrug 5366,2022-09-02,22:00:00,121,41,80,FMN GV 16 Berchem TOT
54,Posthofbrug 5366,2022-09-02,23:00:00,96,28,68,FMN GV 16 Berchem TOT
54,Posthofbrug 5366,2022-09-03,00:00:00,99,33,66,FMN GV 16 Berchem TOT
54,Posthofbrug 5366,2022-09-03,01:00:00,57,8,49,FMN GV 16 Berchem TOT
54,Posthofbrug 5366,2022-09-03,02:00:00,28,13,15,FMN GV 16 Berchem TOT
54,Posthofbrug 5366,2022-09-03,03:00:00,24,11,13,FMN GV 16 Berchem TOT
54,Posthofbrug 5366,2022-09-03,04:00:00,18,9,9,FMN GV 16 Berchem TOT
54,Posthofbrug 5366,2022-09-03,05:00:00,14,4,10,FMN GV 16 Berchem TOT
54,Posthofbrug 5366,2022-09-03,06:00:00,22,10,12,FMN GV 16 Berchem TOT
54,Posthofbrug 5366,2022-09-03,07:00:00,53,31,22,FMN GV 16 Berchem TOT
54,Posthofbrug 5366,2022-09-03,08:00:00,71,52,19,FMN GV 16 Berchem TOT
54,Posthofbrug 5366,2022-09-03,09:00:00,176,122,54,FMN GV 16 Berchem TOT
54,Posthofbrug 5366,2022-09-03,10:00:00,162,106,56,FMN GV 16 Berchem TOT
54,Posthofbrug 5366,2022-09-03,11:00:00,174,94,80,FMN GV 16 Berchem TOT
54,Posthofbrug 5366,2022-09-03,12:00:00,206,114,92,FMN GV 16 Berchem TOT
54,Posthofbrug 5366,2022-09-03,13:00:00,176,107,69,FMN GV 16 Berchem TOT
54,Posthofbrug 5366,2022-09-03,14:00:00,205,109,96,FMN GV 16 Berchem TOT
54,Posthofbrug 5366,2022-09-03,15:00:00,208,95,113,FMN GV 16 Berchem TOT
54,Posthofbrug 5366,2022-09-03,16:00:00,217,94,123,FMN GV 16 Berchem TOT
54,Posthofbrug 5366,2022-09-03,17:00:00,204,101,103,FMN GV 16 Berchem TOT
54,Posthofbrug 5366,2022-09-03,18:00:00,166,97,69,FMN GV 16 Berchem TOT
54,Posthofbrug 5366,2022-09-03,19:00:00,145,67,78,FMN GV 16 Berchem TOT
54,Posthofbrug 5366,2022-09-03,20:00:00,101,44,57,FMN GV 16 Berchem TOT
54,Posthofbrug 5366,2022-09-03,21:00:00,90,38,52,FMN GV 16 Berchem TOT
54,Posthofbrug 5366,2022-09-03,22:00:00,83,35,48,FMN GV 16 Berchem TOT
54,Posthofbrug 5366,2022-09-03,23:00:00,71,27,44,FMN GV 16 Berchem TOT
54,Posthofbrug 5366,2022-09-04,00:00:00,69,26,43,FMN GV 16 Berchem TOT
54,Posthofbrug 5366,2022-09-04,01:00:00,35,13,22,FMN GV 16 Berchem TOT
54,Posthofbrug 5366,2022-09-04,02:00:00,24,9,15,FMN GV 16 Berchem TOT
54,Posthofbrug 5366,2022-09-04,03:00:00,20,6,14,FMN GV 16 Berchem TOT
54,Posthofbrug 5366,2022-09-04,04:00:00,11,1,10,FMN GV 16 Berchem TOT
54,Posthofbrug 5366,2022-09-04,05:00:00,16,8,8,FMN GV 16 Berchem TOT
54,Posthofbrug 5366,2022-09-04,06:00:00,15,8,7,FMN GV 16 Berchem TOT
54,Posthofbrug 5366,2022-09-04,07:00:00,34,20,14,FMN GV 16 Berchem TOT
54,Posthofbrug 5366,2022-09-04,08:00:00,81,45,36,FMN GV 16 Berchem TOT
54,Posthofbrug 5366,2022-09-04,09:00:00,126,80,46,FMN GV 16 Berchem TOT
54,Posthofbrug 5366,2022-09-04,10:00:00,193,126,67,FMN GV 16 Berchem TOT
54,Posthofbrug 5366,2022-09-04,11:00:00,203,125,78,FMN GV 16 Berchem TOT
54,Posthofbrug 5366,2022-09-04,12:00:00,225,112,113,FMN GV 16 Berchem TOT
54,Posthofbrug 5366,2022-09-04,13:00:00,272,174,98,FMN GV 16 Berchem TOT
54,Posthofbrug 5366,2022-09-04,14:00:00,206,109,97,FMN GV 16 Berchem TOT
54,Posthofbrug 5366,2022-09-04,15:00:00,259,125,134,FMN GV 16 Berchem TOT
54,Posthofbrug 5366,2022-09-04,16:00:00,196,97,99,FMN GV 16 Berchem TOT
54,Posthofbrug 5366,2022-09-04,17:00:00,209,101,108,FMN GV 16 Berchem TOT
54,Posthofbrug 5366,2022-09-04,18:00:00,231,119,112,FMN GV 16 Berchem TOT
54,Posthofbrug 5366,2022-09-04,19:00:00,162,84,78,FMN GV 16 Berchem TOT
54,Posthofbrug 5366,2022-09-04,20:00:00,128,59,69,FMN GV 16 Berchem TOT
54,Posthofbrug 5366,2022-09-04,21:00:00,120,60,60,FMN GV 16 Berchem TOT
54,Posthofbrug 5366,2022-09-04,22:00:00,65,26,39,FMN GV 16 Berchem TOT
54,Posthofbrug 5366,2022-09-04,23:00:00,44,19,25,FMN GV 16 Berchem TOT
54,Posthofbrug 5366,2022-09-05,00:00:00,14,7,7,FMN GV 16 Berchem TOT
54,Posthofbrug 5366,2022-09-05,01:00:00,14,4,10,FMN GV 16 Berchem TOT
54,Posthofbrug 5366,2022-09-05,02:00:00,8,2,6,FMN GV 16 Berchem TOT
54,Posthofbrug 5366,2022-09-05,03:00:00,9,2,7,FMN GV 16 Berchem TOT
54,Posthofbrug 5366,2022-09-05,04:00:00,13,6,7,FMN GV 16 Berchem TOT
54,Posthofbrug 5366,2022-09-05,05:00:00,32,20,12,FMN GV 16 Berchem TOT
54,Posthofbrug 5366,2022-09-05,06:00:00,144,115,29,FMN GV 16 Berchem TOT
54,Posthofbrug 5366,2022-09-05,07:00:00,529,416,113,FMN GV 16 Berchem TOT
54,Posthofbrug 5366,2022-09-05,08:00:00,860,684,176,FMN GV 16 Berchem TOT
54,Posthofbrug 5366,2022-09-05,09:00:00,279,208,71,FMN GV 16 Berchem TOT
54,Posthofbrug 5366,2022-09-05,10:00:00,138,93,45,FMN GV 16 Berchem TOT
54,Posthofbrug 5366,2022-09-05,11:00:00,169,101,68,FMN GV 16 Berchem TOT
54,Posthofbrug 5366,2022-09-05,12:00:00,178,98,80,FMN GV 16 Berchem TOT
54,Posthofbrug 5366,2022-09-05,13:00:00,176,89,87,FMN GV 16 Berchem TOT
54,Posthofbrug 5366,2022-09-05,14:00:00,172,72,100,FMN GV 16 Berchem TOT
54,Posthofbrug 5366,2022-09-05,15:00:00,328,106,222,FMN GV 16 Berchem TOT
54,Posthofbrug 5366,2022-09-05,16:00:00,542,139,403,FMN GV 16 Berchem TOT
54,Posthofbrug 5366,2022-09-05,17:00:00,628,181,447,FMN GV 16 Berchem TOT
54,Posthofbrug 5366,2022-09-05,18:00:00,358,95,263,FMN GV 16 Berchem TOT
54,Posthofbrug 5366,2022-09-05,19:00:00,191,73,118,FMN GV 16 Berchem TOT
54,Posthofbrug 5366,2022-09-05,20:00:00,116,47,69,FMN GV 16 Berchem TOT
54,Posthofbrug 5366,2022-09-05,21:00:00,78,35,43,FMN GV 16 Berchem TOT
54,Posthofbrug 5366,2022-09-05,22:00:00,78,36,42,FMN GV 16 Berchem TOT
54,Posthofbrug 5366,2022-09-05,23:00:00,31,13,18,FMN GV 16 Berchem TOT
54,Posthofbrug 5366,2022-09-06,00:00:00,10,0,10,FMN GV 16 Berchem TOT
54,Posthofbrug 5366,2022-09-06,01:00:00,10,3,7,FMN GV 16 Berchem TOT
54,Posthofbrug 5366,2022-09-06,02:00:00,4,1,3,FMN GV 16 Berchem TOT
54,Posthofbrug 5366,2022-09-06,03:00:00,1,0,1,FMN GV 16 Berchem TOT
54,Posthofbrug 5366,2022-09-06,04:00:00,5,1,4,FMN GV 16 Berchem TOT
54,Posthofbrug 5366,2022-09-06,05:00:00,13,5,8,FMN GV 16 Berchem TOT
54,Posthofbrug 5366,2022-09-06,06:00:00,28,11,17,FMN GV 16 Berchem TOT
54,Posthofbrug 5366,2022-09-06,07:00:00,134,46,88,FMN GV 16 Berchem TOT
54,Posthofbrug 5366,2022-09-06,08:00:00,219,77,142,FMN GV 16 Berchem TOT
54,Posthofbrug 5366,2022-09-06,09:00:00,96,32,64,FMN GV 16 Berchem TOT
54,Posthofbrug 5366,2022-09-06,10:00:00,46,12,34,FMN GV 16 Berchem TOT
54,Posthofbrug 5366,2022-09-06,11:00:00,48,6,42,FMN GV 16 Berchem TOT
54,Posthofbrug 5366,2022-09-06,12:00:00,74,11,63,FMN GV 16 Berchem TOT
54,Posthofbrug 5366,2022-09-06,13:00:00,80,19,61,FMN GV 16 Berchem TOT
54,Posthofbrug 5366,2022-09-06,14:00:00,81,14,67,FMN GV 16 Berchem TOT
54,Posthofbrug 5366,2022-09-06,15:00:00,136,14,122,FMN GV 16 Berchem TOT
54,Posthofbrug 5366,2022-09-06,16:00:00,243,29,214,FMN GV 16 Berchem TOT
54,Posthofbrug 5366,2022-09-06,17:00:00,328,35,293,FMN GV 16 Berchem TOT
54,Posthofbrug 5366,2022-09-06,18:00:00,222,32,190,FMN GV 16 Berchem TOT
54,Posthofbrug 5366,2022-09-06,19:00:00,112,17,95,FMN GV 16 Berchem TOT
54,Posthofbrug 5366,2022-09-06,20:00:00,58,8,50,FMN GV 16 Berchem TOT
54,Posthofbrug 5366,2022-09-06,21:00:00,51,12,39,FMN GV 16 Berchem TOT
54,Posthofbrug 5366,2022-09-06,22:00:00,58,9,49,FMN GV 16 Berchem TOT
54,Posthofbrug 5366,2022-09-06,23:00:00,31,8,23,FMN GV 16 Berchem TOT
54,Posthofbrug 5366,2022-09-07,00:00:00,0,0,0,FMN GV 16 Berchem TOT
54,Posthofbrug 5366,2022-09-07,01:00:00,0,0,0,FMN GV 16 Berchem TOT
54,Posthofbrug 5366,2022-09-07,02:00:00,0,0,0,FMN GV 16 Berchem TOT
54,Posthofbrug 5366,2022-09-07,03:00:00,0,0,0,FMN GV 16 Berchem TOT
54,Posthofbrug 5366,2022-09-07,04:00:00,0,0,0,FMN GV 16 Berchem TOT
54,Posthofbrug 5366,2022-09-07,05:00:00,0,0,0,FMN GV 16 Berchem TOT
54,Posthofbrug 5366,2022-09-07,06:00:00,0,0,0,FMN GV 16 Berchem TOT
54,Posthofbrug 5366,2022-09-07,07:00:00,0,0,0,FMN GV 16 Berchem TOT
54,Posthofbrug 5366,2022-09-07,08:00:00,0,0,0,FMN GV 16 Berchem TOT
54,Posthofbrug 5366,2022-09-07,09:00:00,0,0,0,FMN GV 16 Berchem TOT
54,Posthofbrug 5366,2022-09-07,10:00:00,0,0,0,FMN GV 16 Berchem TOT
54,Posthofbrug 5366,2022-09-07,11:00:00,0,0,0,FMN GV 16 Berchem TOT
54,Posthofbrug 5366,2022-09-07,12:00:00,0,0,0,FMN GV 16 Berchem TOT
54,Posthofbrug 5366,2022-09-07,13:00:00,0,0,0,FMN GV 16 Berchem TOT
54,Posthofbrug 5366,2022-09-07,14:00:00,0,0,0,FMN GV 16 Berchem TOT
54,Posthofbrug 5366,2022-09-07,15:00:00,0,0,0,FMN GV 16 Berchem TOT
54,Posthofbrug 5366,2022-09-07,16:00:00,0,0,0,FMN GV 16 Berchem TOT
54,Posthofbrug 5366,2022-09-07,17:00:00,0,0,0,FMN GV 16 Berchem TOT
54,Posthofbrug 5366,2022-09-07,18:00:00,0,0,0,FMN GV 16 Berchem TOT
54,Posthofbrug 5366,2022-09-07,19:00:00,0,0,0,FMN GV 16 Berchem TOT
54,Posthofbrug 5366,2022-09-07,20:00:00,0,0,0,FMN GV 16 Berchem TOT
54,Posthofbrug 5366,2022-09-07,21:00:00,0,0,0,FMN GV 16 Berchem TOT
54,Posthofbrug 5366,2022-09-07,22:00:00,0,0,0,FMN GV 16 Berchem TOT
54,Posthofbrug 5366,2022-09-07,23:00:00,0,0,0,FMN GV 16 Berchem TOT
54,Posthofbrug 5366,2022-09-08,00:00:00,0,0,0,FMN GV 16 Berchem TOT
54,Posthofbrug 5366,2022-09-08,01:00:00,0,0,0,FMN GV 16 Berchem TOT
54,Posthofbrug 5366,2022-09-08,02:00:00,0,0,0,FMN GV 16 Berchem TOT
54,Posthofbrug 5366,2022-09-08,03:00:00,0,0,0,FMN GV 16 Berchem TOT
54,Posthofbrug 5366,2022-09-08,04:00:00,0,0,0,FMN GV 16 Berchem TOT
54,Posthofbrug 5366,2022-09-08,05:00:00,0,0,0,FMN GV 16 Berchem TOT
54,Posthofbrug 5366,2022-09-08,06:00:00,0,0,0,FMN GV 16 Berchem TOT
54,Posthofbrug 5366,2022-09-08,07:00:00,0,0,0,FMN GV 16 Berchem TOT
54,Posthofbrug 5366,2022-09-08,08:00:00,0,0,0,FMN GV 16 Berchem TOT
54,Posthofbrug 5366,2022-09-08,09:00:00,0,0,0,FMN GV 16 Berchem TOT
54,Posthofbrug 5366,2022-09-08,10:00:00,0,0,0,FMN GV 16 Berchem TOT
54,Posthofbrug 5366,2022-09-08,11:00:00,0,0,0,FMN GV 16 Berchem TOT
54,Posthofbrug 5366,2022-09-08,12:00:00,0,0,0,FMN GV 16 Berchem TOT
54,Posthofbrug 5366,2022-09-08,13:00:00,0,0,0,FMN GV 16 Berchem TOT
54,Posthofbrug 5366,2022-09-08,14:00:00,0,0,0,FMN GV 16 Berchem TOT
54,Posthofbrug 5366,2022-09-08,15:00:00,0,0,0,FMN GV 16 Berchem TOT
54,Posthofbrug 5366,2022-09-08,16:00:00,0,0,0,FMN GV 16 Berchem TOT
54,Posthofbrug 5366,2022-09-08,17:00:00,0,0,0,FMN GV 16 Berchem TOT
54,Posthofbrug 5366,2022-09-08,18:00:00,0,0,0,FMN GV 16 Berchem TOT
54,Posthofbrug 5366,2022-09-08,19:00:00,0,0,0,FMN GV 16 Berchem TOT
54,Posthofbrug 5366,2022-09-08,20:00:00,0,0,0,FMN GV 16 Berchem TOT
54,Posthofbrug 5366,2022-09-08,21:00:00,0,0,0,FMN GV 16 Berchem TOT
54,Posthofbrug 5366,2022-09-08,22:00:00,0,0,0,FMN GV 16 Berchem TOT
54,Posthofbrug 5366,2022-09-08,23:00:00,0,0,0,FMN GV 16 Berchem TOT
54,Posthofbrug 5366,2022-09-09,00:00:00,0,0,0,FMN GV 16 Berchem TOT
54,Posthofbrug 5366,2022-09-09,01:00:00,0,0,0,FMN GV 16 Berchem TOT
54,Posthofbrug 5366,2022-09-09,02:00:00,0,0,0,FMN GV 16 Berchem TOT
54,Posthofbrug 5366,2022-09-09,03:00:00,0,0,0,FMN GV 16 Berchem TOT
54,Posthofbrug 5366,2022-09-09,04:00:00,0,0,0,FMN GV 16 Berchem TOT
54,Posthofbrug 5366,2022-09-09,05:00:00,0,0,0,FMN GV 16 Berchem TOT
54,Posthofbrug 5366,2022-09-09,06:00:00,0,0,0,FMN GV 16 Berchem TOT
54,Posthofbrug 5366,2022-09-09,07:00:00,0,0,0,FMN GV 16 Berchem TOT
54,Posthofbrug 5366,2022-09-09,08:00:00,0,0,0,FMN GV 16 Berchem TOT
54,Posthofbrug 5366,2022-09-09,09:00:00,0,0,0,FMN GV 16 Berchem TOT
54,Posthofbrug 5366,2022-09-09,10:00:00,0,0,0,FMN GV 16 Berchem TOT
54,Posthofbrug 5366,2022-09-09,11:00:00,0,0,0,FMN GV 16 Berchem TOT
54,Posthofbrug 5366,2022-09-09,12:00:00,0,0,0,FMN GV 16 Berchem TOT
54,Posthofbrug 5366,2022-09-09,13:00:00,0,0,0,FMN GV 16 Berchem TOT
54,Posthofbrug 5366,2022-09-09,14:00:00,0,0,0,FMN GV 16 Berchem TOT
54,Posthofbrug 5366,2022-09-09,15:00:00,0,0,0,FMN GV 16 Berchem TOT
54,Posthofbrug 5366,2022-09-09,16:00:00,0,0,0,FMN GV 16 Berchem TOT
54,Posthofbrug 5366,2022-09-09,17:00:00,0,0,0,FMN GV 16 Berchem TOT
54,Posthofbrug 5366,2022-09-09,18:00:00,0,0,0,FMN GV 16 Berchem TOT
54,Posthofbrug 5366,2022-09-09,19:00:00,0,0,0,FMN GV 16 Berchem TOT
54,Posthofbrug 5366,2022-09-09,20:00:00,0,0,0,FMN GV 16 Berchem TOT
54,Posthofbrug 5366,2022-09-09,21:00:00,0,0,0,FMN GV 16 Berchem TOT
54,Posthofbrug 5366,2022-09-09,22:00:00,0,0,0,FMN GV 16 Berchem TOT
54,Posthofbrug 5366,2022-09-09,23:00:00,0,0,0,FMN GV 16 Berchem TOT
54,Posthofbrug 5366,2022-09-10,00:00:00,0,0,0,FMN GV 16 Berchem TOT
54,Posthofbrug 5366,2022-09-10,01:00:00,0,0,0,FMN GV 16 Berchem TOT
54,Posthofbrug 5366,2022-09-10,02:00:00,0,0,0,FMN GV 16 Berchem TOT
54,Posthofbrug 5366,2022-09-10,03:00:00,0,0,0,FMN GV 16 Berchem TOT
54,Posthofbrug 5366,2022-09-10,04:00:00,0,0,0,FMN GV 16 Berchem TOT
54,Posthofbrug 5366,2022-09-10,05:00:00,0,0,0,FMN GV 16 Berchem TOT
54,Posthofbrug 5366,2022-09-10,06:00:00,0,0,0,FMN GV 16 Berchem TOT
54,Posthofbrug 5366,2022-09-10,07:00:00,0,0,0,FMN GV 16 Berchem TOT
54,Posthofbrug 5366,2022-09-10,08:00:00,0,0,0,FMN GV 16 Berchem TOT
54,Posthofbrug 5366,2022-09-10,09:00:00,0,0,0,FMN GV 16 Berchem TOT
54,Posthofbrug 5366,2022-09-10,10:00:00,0,0,0,FMN GV 16 Berchem TOT
54,Posthofbrug 5366,2022-09-10,11:00:00,0,0,0,FMN GV 16 Berchem TOT
54,Posthofbrug 5366,2022-09-10,12:00:00,0,0,0,FMN GV 16 Berchem TOT
54,Posthofbrug 5366,2022-09-10,13:00:00,0,0,0,FMN GV 16 Berchem TOT
54,Posthofbrug 5366,2022-09-10,14:00:00,0,0,0,FMN GV 16 Berchem TOT
54,Posthofbrug 5366,2022-09-10,15:00:00,0,0,0,FMN GV 16 Berchem TOT
54,Posthofbrug 5366,2022-09-10,16:00:00,0,0,0,FMN GV 16 Berchem TOT
54,Posthofbrug 5366,2022-09-10,17:00:00,0,0,0,FMN GV 16 Berchem TOT
54,Posthofbrug 5366,2022-09-10,18:00:00,0,0,0,FMN GV 16 Berchem TOT
54,Posthofbrug 5366,2022-09-10,19:00:00,0,0,0,FMN GV 16 Berchem TOT
54,Posthofbrug 5366,2022-09-10,20:00:00,0,0,0,FMN GV 16 Berchem TOT
54,Posthofbrug 5366,2022-09-10,21:00:00,0,0,0,FMN GV 16 Berchem TOT
54,Posthofbrug 5366,2022-09-10,22:00:00,0,0,0,FMN GV 16 Berchem TOT
54,Posthofbrug 5366,2022-09-10,23:00:00,0,0,0,FMN GV 16 Berchem TOT
54,Posthofbrug 5366,2022-09-11,00:00:00,0,0,0,FMN GV 16 Berchem TOT
54,Posthofbrug 5366,2022-09-11,01:00:00,0,0,0,FMN GV 16 Berchem TOT
54,Posthofbrug 5366,2022-09-11,02:00:00,0,0,0,FMN GV 16 Berchem TOT
54,Posthofbrug 5366,2022-09-11,03:00:00,0,0,0,FMN GV 16 Berchem TOT
54,Posthofbrug 5366,2022-09-11,04:00:00,0,0,0,FMN GV 16 Berchem TOT
54,Posthofbrug 5366,2022-09-11,05:00:00,0,0,0,FMN GV 16 Berchem TOT
54,Posthofbrug 5366,2022-09-11,06:00:00,0,0,0,FMN GV 16 Berchem TOT
54,Posthofbrug 5366,2022-09-11,07:00:00,0,0,0,FMN GV 16 Berchem TOT
54,Posthofbrug 5366,2022-09-11,08:00:00,0,0,0,FMN GV 16 Berchem TOT
54,Posthofbrug 5366,2022-09-11,09:00:00,0,0,0,FMN GV 16 Berchem TOT
54,Posthofbrug 5366,2022-09-11,10:00:00,0,0,0,FMN GV 16 Berchem TOT
54,Posthofbrug 5366,2022-09-11,11:00:00,0,0,0,FMN GV 16 Berchem TOT
54,Posthofbrug 5366,2022-09-11,12:00:00,0,0,0,FMN GV 16 Berchem TOT
54,Posthofbrug 5366,2022-09-11,13:00:00,0,0,0,FMN GV 16 Berchem TOT
54,Posthofbrug 5366,2022-09-11,14:00:00,0,0,0,FMN GV 16 Berchem TOT
54,Posthofbrug 5366,2022-09-11,15:00:00,0,0,0,FMN GV 16 Berchem TOT
54,Posthofbrug 5366,2022-09-11,16:00:00,0,0,0,FMN GV 16 Berchem TOT
54,Posthofbrug 5366,2022-09-11,17:00:00,0,0,0,FMN GV 16 Berchem TOT
54,Posthofbrug 5366,2022-09-11,18:00:00,0,0,0,FMN GV 16 Berchem TOT
54,Posthofbrug 5366,2022-09-11,19:00:00,0,0,0,FMN GV 16 Berchem TOT
54,Posthofbrug 5366,2022-09-11,20:00:00,0,0,0,FMN GV 16 Berchem TOT
54,Posthofbrug 5366,2022-09-11,21:00:00,0,0,0,FMN GV 16 Berchem TOT
54,Posthofbrug 5366,2022-09-11,22:00:00,0,0,0,FMN GV 16 Berchem TOT
54,Posthofbrug 5366,2022-09-11,23:00:00,0,0,0,FMN GV 16 Berchem TOT
54,Posthofbrug 5366,2022-09-12,00:00:00,0,0,0,FMN GV 16 Berchem TOT
54,Posthofbrug 5366,2022-09-12,01:00:00,0,0,0,FMN GV 16 Berchem TOT
54,Posthofbrug 5366,2022-09-12,02:00:00,0,0,0,FMN GV 16 Berchem TOT
54,Posthofbrug 5366,2022-09-12,03:00:00,0,0,0,FMN GV 16 Berchem TOT
54,Posthofbrug 5366,2022-09-12,04:00:00,0,0,0,FMN GV 16 Berchem TOT
54,Posthofbrug 5366,2022-09-12,05:00:00,0,0,0,FMN GV 16 Berchem TOT
54,Posthofbrug 5366,2022-09-12,06:00:00,0,0,0,FMN GV 16 Berchem TOT
54,Posthofbrug 5366,2022-09-12,07:00:00,0,0,0,FMN GV 16 Berchem TOT
54,Posthofbrug 5366,2022-09-12,08:00:00,0,0,0,FMN GV 16 Berchem TOT
54,Posthofbrug 5366,2022-09-12,09:00:00,0,0,0,FMN GV 16 Berchem TOT
54,Posthofbrug 5366,2022-09-12,10:00:00,0,0,0,FMN GV 16 Berchem TOT
54,Posthofbrug 5366,2022-09-12,11:00:00,0,0,0,FMN GV 16 Berchem TOT
54,Posthofbrug 5366,2022-09-12,12:00:00,0,0,0,FMN GV 16 Berchem TOT
54,Posthofbrug 5366,2022-09-12,13:00:00,0,0,0,FMN GV 16 Berchem TOT
54,Posthofbrug 5366,2022-09-12,14:00:00,0,0,0,FMN GV 16 Berchem TOT
54,Posthofbrug 5366,2022-09-12,15:00:00,0,0,0,FMN GV 16 Berchem TOT
54,Posthofbrug 5366,2022-09-12,16:00:00,0,0,0,FMN GV 16 Berchem TOT
54,Posthofbrug 5366,2022-09-12,17:00:00,0,0,0,FMN GV 16 Berchem TOT
54,Posthofbrug 5366,2022-09-12,18:00:00,0,0,0,FMN GV 16 Berchem TOT
54,Posthofbrug 5366,2022-09-12,19:00:00,0,0,0,FMN GV 16 Berchem TOT
54,Posthofbrug 5366,2022-09-12,20:00:00,0,0,0,FMN GV 16 Berchem TOT
54,Posthofbrug 5366,2022-09-12,21:00:00,0,0,0,FMN GV 16 Berchem TOT
54,Posthofbrug 5366,2022-09-12,22:00:00,0,0,0,FMN GV 16 Berchem TOT
54,Posthofbrug 5366,2022-09-12,23:00:00,0,0,0,FMN GV 16 Berchem TOT
54,Posthofbrug 5366,2022-09-13,00:00:00,0,0,0,FMN GV 16 Berchem TOT
54,Posthofbrug 5366,2022-09-13,01:00:00,0,0,0,FMN GV 16 Berchem TOT
54,Posthofbrug 5366,2022-09-13,02:00:00,0,0,0,FMN GV 16 Berchem TOT
54,Posthofbrug 5366,2022-09-13,03:00:00,0,0,0,FMN GV 16 Berchem TOT
54,Posthofbrug 5366,2022-09-13,04:00:00,0,0,0,FMN GV 16 Berchem TOT
54,Posthofbrug 5366,2022-09-13,05:00:00,0,0,0,FMN GV 16 Berchem TOT
54,Posthofbrug 5366,2022-09-13,06:00:00,0,0,0,FMN GV 16 Berchem TOT
54,Posthofbrug 5366,2022-09-13,07:00:00,0,0,0,FMN GV 16 Berchem TOT
54,Posthofbrug 5366,2022-09-13,08:00:00,0,0,0,FMN GV 16 Berchem TOT
54,Posthofbrug 5366,2022-09-13,09:00:00,0,0,0,FMN GV 16 Berchem TOT
54,Posthofbrug 5366,2022-09-13,10:00:00,0,0,0,FMN GV 16 Berchem TOT
54,Posthofbrug 5366,2022-09-13,11:00:00,0,0,0,FMN GV 16 Berchem TOT
54,Posthofbrug 5366,2022-09-13,12:00:00,0,0,0,FMN GV 16 Berchem TOT
54,Posthofbrug 5366,2022-09-13,13:00:00,0,0,0,FMN GV 16 Berchem TOT
54,Posthofbrug 5366,2022-09-13,14:00:00,0,0,0,FMN GV 16 Berchem TOT
54,Posthofbrug 5366,2022-09-13,15:00:00,0,0,0,FMN GV 16 Berchem TOT
54,Posthofbrug 5366,2022-09-13,16:00:00,0,0,0,FMN GV 16 Berchem TOT
54,Posthofbrug 5366,2022-09-13,17:00:00,0,0,0,FMN GV 16 Berchem TOT
54,Posthofbrug 5366,2022-09-13,18:00:00,0,0,0,FMN GV 16 Berchem TOT
54,Posthofbrug 5366,2022-09-13,19:00:00,0,0,0,FMN GV 16 Berchem TOT
54,Posthofbrug 5366,2022-09-13,20:00:00,0,0,0,FMN GV 16 Berchem TOT
54,Posthofbrug 5366,2022-09-13,21:00:00,0,0,0,FMN GV 16 Berchem TOT
54,Posthofbrug 5366,2022-09-13,22:00:00,0,0,0,FMN GV 16 Berchem TOT
54,Posthofbrug 5366,2022-09-13,23:00:00,0,0,0,FMN GV 16 Berchem TOT
54,Posthofbrug 5366,2022-09-14,00:00:00,0,0,0,FMN GV 16 Berchem TOT
54,Posthofbrug 5366,2022-09-14,01:00:00,0,0,0,FMN GV 16 Berchem TOT
54,Posthofbrug 5366,2022-09-14,02:00:00,0,0,0,FMN GV 16 Berchem TOT
54,Posthofbrug 5366,2022-09-14,03:00:00,0,0,0,FMN GV 16 Berchem TOT
54,Posthofbrug 5366,2022-09-14,04:00:00,0,0,0,FMN GV 16 Berchem TOT
54,Posthofbrug 5366,2022-09-14,05:00:00,0,0,0,FMN GV 16 Berchem TOT
54,Posthofbrug 5366,2022-09-14,06:00:00,0,0,0,FMN GV 16 Berchem TOT
54,Posthofbrug 5366,2022-09-14,07:00:00,0,0,0,FMN GV 16 Berchem TOT
54,Posthofbrug 5366,2022-09-14,08:00:00,0,0,0,FMN GV 16 Berchem TOT
54,Posthofbrug 5366,2022-09-14,09:00:00,0,0,0,FMN GV 16 Berchem TOT
54,Posthofbrug 5366,2022-09-14,10:00:00,0,0,0,FMN GV 16 Berchem TOT
54,Posthofbrug 5366,2022-09-14,11:00:00,0,0,0,FMN GV 16 Berchem TOT
54,Posthofbrug 5366,2022-09-14,12:00:00,0,0,0,FMN GV 16 Berchem TOT
54,Posthofbrug 5366,2022-09-14,13:00:00,0,0,0,FMN GV 16 Berchem TOT
54,Posthofbrug 5366,2022-09-14,14:00:00,0,0,0,FMN GV 16 Berchem TOT
54,Posthofbrug 5366,2022-09-14,15:00:00,0,0,0,FMN GV 16 Berchem TOT
54,Posthofbrug 5366,2022-09-14,16:00:00,0,0,0,FMN GV 16 Berchem TOT
54,Posthofbrug 5366,2022-09-14,17:00:00,0,0,0,FMN GV 16 Berchem TOT
54,Posthofbrug 5366,2022-09-14,18:00:00,0,0,0,FMN GV 16 Berchem TOT
54,Posthofbrug 5366,2022-09-14,19:00:00,0,0,0,FMN GV 16 Berchem TOT
54,Posthofbrug 5366,2022-09-14,20:00:00,0,0,0,FMN GV 16 Berchem TOT
54,Posthofbrug 5366,2022-09-14,21:00:00,0,0,0,FMN GV 16 Berchem TOT
54,Posthofbrug 5366,2022-09-14,22:00:00,0,0,0,FMN GV 16 Berchem TOT
54,Posthofbrug 5366,2022-09-14,23:00:00,0,0,0,FMN GV 16 Berchem TOT
54,Posthofbrug 5366,2022-09-15,00:00:00,0,0,0,FMN GV 16 Berchem TOT
54,Posthofbrug 5366,2022-09-15,01:00:00,0,0,0,FMN GV 16 Berchem TOT
54,Posthofbrug 5366,2022-09-15,02:00:00,0,0,0,FMN GV 16 Berchem TOT
54,Posthofbrug 5366,2022-09-15,03:00:00,0,0,0,FMN GV 16 Berchem TOT
54,Posthofbrug 5366,2022-09-15,04:00:00,0,0,0,FMN GV 16 Berchem TOT
54,Posthofbrug 5366,2022-09-15,05:00:00,0,0,0,FMN GV 16 Berchem TOT
54,Posthofbrug 5366,2022-09-15,06:00:00,0,0,0,FMN GV 16 Berchem TOT
54,Posthofbrug 5366,2022-09-15,07:00:00,0,0,0,FMN GV 16 Berchem TOT
54,Posthofbrug 5366,2022-09-15,08:00:00,0,0,0,FMN GV 16 Berchem TOT
54,Posthofbrug 5366,2022-09-15,09:00:00,0,0,0,FMN GV 16 Berchem TOT
54,Posthofbrug 5366,2022-09-15,10:00:00,0,0,0,FMN GV 16 Berchem TOT
54,Posthofbrug 5366,2022-09-15,11:00:00,0,0,0,FMN GV 16 Berchem TOT
54,Posthofbrug 5366,2022-09-15,12:00:00,0,0,0,FMN GV 16 Berchem TOT
54,Posthofbrug 5366,2022-09-15,13:00:00,0,0,0,FMN GV 16 Berchem TOT
54,Posthofbrug 5366,2022-09-15,14:00:00,0,0,0,FMN GV 16 Berchem TOT
54,Posthofbrug 5366,2022-09-15,15:00:00,0,0,0,FMN GV 16 Berchem TOT
54,Posthofbrug 5366,2022-09-15,16:00:00,0,0,0,FMN GV 16 Berchem TOT
54,Posthofbrug 5366,2022-09-15,17:00:00,0,0,0,FMN GV 16 Berchem TOT
54,Posthofbrug 5366,2022-09-15,18:00:00,0,0,0,FMN GV 16 Berchem TOT
54,Posthofbrug 5366,2022-09-15,19:00:00,0,0,0,FMN GV 16 Berchem TOT
54,Posthofbrug 5366,2022-09-15,20:00:00,0,0,0,FMN GV 16 Berchem TOT
54,Posthofbrug 5366,2022-09-15,21:00:00,0,0,0,FMN GV 16 Berchem TOT
54,Posthofbrug 5366,2022-09-15,22:00:00,0,0,0,FMN GV 16 Berchem TOT
54,Posthofbrug 5366,2022-09-15,23:00:00,0,0,0,FMN GV 16 Berchem TOT
54,Posthofbrug 5366,2022-09-16,00:00:00,0,0,0,FMN GV 16 Berchem TOT
54,Posthofbrug 5366,2022-09-16,01:00:00,0,0,0,FMN GV 16 Berchem TOT
54,Posthofbrug 5366,2022-09-16,02:00:00,0,0,0,FMN GV 16 Berchem TOT
54,Posthofbrug 5366,2022-09-16,03:00:00,0,0,0,FMN GV 16 Berchem TOT
54,Posthofbrug 5366,2022-09-16,04:00:00,0,0,0,FMN GV 16 Berchem TOT
54,Posthofbrug 5366,2022-09-16,05:00:00,0,0,0,FMN GV 16 Berchem TOT
54,Posthofbrug 5366,2022-09-16,06:00:00,0,0,0,FMN GV 16 Berchem TOT
54,Posthofbrug 5366,2022-09-16,07:00:00,0,0,0,FMN GV 16 Berchem TOT
54,Posthofbrug 5366,2022-09-16,08:00:00,0,0,0,FMN GV 16 Berchem TOT
54,Posthofbrug 5366,2022-09-16,09:00:00,0,0,0,FMN GV 16 Berchem TOT
54,Posthofbrug 5366,2022-09-16,10:00:00,0,0,0,FMN GV 16 Berchem TOT
54,Posthofbrug 5366,2022-09-16,11:00:00,0,0,0,FMN GV 16 Berchem TOT
54,Posthofbrug 5366,2022-09-16,12:00:00,0,0,0,FMN GV 16 Berchem TOT
54,Posthofbrug 5366,2022-09-16,13:00:00,0,0,0,FMN GV 16 Berchem TOT
54,Posthofbrug 5366,2022-09-16,14:00:00,0,0,0,FMN GV 16 Berchem TOT
54,Posthofbrug 5366,2022-09-16,15:00:00,0,0,0,FMN GV 16 Berchem TOT
54,Posthofbrug 5366,2022-09-16,16:00:00,0,0,0,FMN GV 16 Berchem TOT
54,Posthofbrug 5366,2022-09-16,17:00:00,0,0,0,FMN GV 16 Berchem TOT
54,Posthofbrug 5366,2022-09-16,18:00:00,0,0,0,FMN GV 16 Berchem TOT
54,Posthofbrug 5366,2022-09-16,19:00:00,0,0,0,FMN GV 16 Berchem TOT
54,Posthofbrug 5366,2022-09-16,20:00:00,0,0,0,FMN GV 16 Berchem TOT
54,Posthofbrug 5366,2022-09-16,21:00:00,0,0,0,FMN GV 16 Berchem TOT
54,Posthofbrug 5366,2022-09-16,22:00:00,0,0,0,FMN GV 16 Berchem TOT
54,Posthofbrug 5366,2022-09-16,23:00:00,0,0,0,FMN GV 16 Berchem TOT
54,Posthofbrug 5366,2022-09-17,00:00:00,0,0,0,FMN GV 16 Berchem TOT
54,Posthofbrug 5366,2022-09-17,01:00:00,0,0,0,FMN GV 16 Berchem TOT
54,Posthofbrug 5366,2022-09-17,02:00:00,0,0,0,FMN GV 16 Berchem TOT
54,Posthofbrug 5366,2022-09-17,03:00:00,0,0,0,FMN GV 16 Berchem TOT
54,Posthofbrug 5366,2022-09-17,04:00:00,0,0,0,FMN GV 16 Berchem TOT
54,Posthofbrug 5366,2022-09-17,05:00:00,0,0,0,FMN GV 16 Berchem TOT
54,Posthofbrug 5366,2022-09-17,06:00:00,0,0,0,FMN GV 16 Berchem TOT
54,Posthofbrug 5366,2022-09-17,07:00:00,0,0,0,FMN GV 16 Berchem TOT
54,Posthofbrug 5366,2022-09-17,08:00:00,0,0,0,FMN GV 16 Berchem TOT
54,Posthofbrug 5366,2022-09-17,09:00:00,0,0,0,FMN GV 16 Berchem TOT
54,Posthofbrug 5366,2022-09-17,10:00:00,0,0,0,FMN GV 16 Berchem TOT
54,Posthofbrug 5366,2022-09-17,11:00:00,0,0,0,FMN GV 16 Berchem TOT
54,Posthofbrug 5366,2022-09-17,12:00:00,0,0,0,FMN GV 16 Berchem TOT
54,Posthofbrug 5366,2022-09-17,13:00:00,0,0,0,FMN GV 16 Berchem TOT
54,Posthofbrug 5366,2022-09-17,14:00:00,0,0,0,FMN GV 16 Berchem TOT
54,Posthofbrug 5366,2022-09-17,15:00:00,0,0,0,FMN GV 16 Berchem TOT
54,Posthofbrug 5366,2022-09-17,16:00:00,0,0,0,FMN GV 16 Berchem TOT
54,Posthofbrug 5366,2022-09-17,17:00:00,0,0,0,FMN GV 16 Berchem TOT
54,Posthofbrug 5366,2022-09-17,18:00:00,0,0,0,FMN GV 16 Berchem TOT
54,Posthofbrug 5366,2022-09-17,19:00:00,0,0,0,FMN GV 16 Berchem TOT
54,Posthofbrug 5366,2022-09-17,20:00:00,0,0,0,FMN GV 16 Berchem TOT
54,Posthofbrug 5366,2022-09-17,21:00:00,0,0,0,FMN GV 16 Berchem TOT
54,Posthofbrug 5366,2022-09-17,22:00:00,0,0,0,FMN GV 16 Berchem TOT
54,Posthofbrug 5366,2022-09-17,23:00:00,0,0,0,FMN GV 16 Berchem TOT
54,Posthofbrug 5366,2022-09-18,00:00:00,0,0,0,FMN GV 16 Berchem TOT
54,Posthofbrug 5366,2022-09-18,01:00:00,0,0,0,FMN GV 16 Berchem TOT
54,Posthofbrug 5366,2022-09-18,02:00:00,0,0,0,FMN GV 16 Berchem TOT
54,Posthofbrug 5366,2022-09-18,03:00:00,0,0,0,FMN GV 16 Berchem TOT
54,Posthofbrug 5366,2022-09-18,04:00:00,0,0,0,FMN GV 16 Berchem TOT
54,Posthofbrug 5366,2022-09-18,05:00:00,0,0,0,FMN GV 16 Berchem TOT
54,Posthofbrug 5366,2022-09-18,06:00:00,0,0,0,FMN GV 16 Berchem TOT
54,Posthofbrug 5366,2022-09-18,07:00:00,0,0,0,FMN GV 16 Berchem TOT
54,Posthofbrug 5366,2022-09-18,08:00:00,0,0,0,FMN GV 16 Berchem TOT
54,Posthofbrug 5366,2022-09-18,09:00:00,0,0,0,FMN GV 16 Berchem TOT
54,Posthofbrug 5366,2022-09-18,10:00:00,0,0,0,FMN GV 16 Berchem TOT
54,Posthofbrug 5366,2022-09-18,11:00:00,0,0,0,FMN GV 16 Berchem TOT
54,Posthofbrug 5366,2022-09-18,12:00:00,0,0,0,FMN GV 16 Berchem TOT
54,Posthofbrug 5366,2022-09-18,13:00:00,0,0,0,FMN GV 16 Berchem TOT
54,Posthofbrug 5366,2022-09-18,14:00:00,0,0,0,FMN GV 16 Berchem TOT
54,Posthofbrug 5366,2022-09-18,15:00:00,0,0,0,FMN GV 16 Berchem TOT
54,Posthofbrug 5366,2022-09-18,16:00:00,0,0,0,FMN GV 16 Berchem TOT
54,Posthofbrug 5366,2022-09-18,17:00:00,0,0,0,FMN GV 16 Berchem TOT
54,Posthofbrug 5366,2022-09-18,18:00:00,0,0,0,FMN GV 16 Berchem TOT
54,Posthofbrug 5366,2022-09-18,19:00:00,0,0,0,FMN GV 16 Berchem TOT
54,Posthofbrug 5366,2022-09-18,20:00:00,0,0,0,FMN GV 16 Berchem TOT
54,Posthofbrug 5366,2022-09-18,21:00:00,0,0,0,FMN GV 16 Berchem TOT
54,Posthofbrug 5366,2022-09-18,22:00:00,0,0,0,FMN GV 16 Berchem TOT
54,Posthofbrug 5366,2022-09-18,23:00:00,0,0,0,FMN GV 16 Berchem TOT
54,Posthofbrug 5366,2022-09-19,00:00:00,0,0,0,FMN GV 16 Berchem TOT
54,Posthofbrug 5366,2022-09-19,01:00:00,0,0,0,FMN GV 16 Berchem TOT
54,Posthofbrug 5366,2022-09-19,02:00:00,0,0,0,FMN GV 16 Berchem TOT
54,Posthofbrug 5366,2022-09-19,03:00:00,0,0,0,FMN GV 16 Berchem TOT
54,Posthofbrug 5366,2022-09-19,04:00:00,0,0,0,FMN GV 16 Berchem TOT
54,Posthofbrug 5366,2022-09-19,05:00:00,0,0,0,FMN GV 16 Berchem TOT
54,Posthofbrug 5366,2022-09-19,06:00:00,0,0,0,FMN GV 16 Berchem TOT
54,Posthofbrug 5366,2022-09-19,07:00:00,0,0,0,FMN GV 16 Berchem TOT
54,Posthofbrug 5366,2022-09-19,08:00:00,0,0,0,FMN GV 16 Berchem TOT
54,Posthofbrug 5366,2022-09-19,09:00:00,0,0,0,FMN GV 16 Berchem TOT
54,Posthofbrug 5366,2022-09-19,10:00:00,0,0,0,FMN GV 16 Berchem TOT
54,Posthofbrug 5366,2022-09-19,11:00:00,116,73,43,FMN GV 16 Berchem TOT
54,Posthofbrug 5366,2022-09-19,12:00:00,178,92,86,FMN GV 16 Berchem TOT
54,Posthofbrug 5366,2022-09-19,13:00:00,167,91,76,FMN GV 16 Berchem TOT
54,Posthofbrug 5366,2022-09-19,14:00:00,177,78,99,FMN GV 16 Berchem TOT
54,Posthofbrug 5366,2022-09-19,15:00:00,265,80,185,FMN GV 16 Berchem TOT
54,Posthofbrug 5366,2022-09-19,16:00:00,491,147,344,FMN GV 16 Berchem TOT
54,Posthofbrug 5366,2022-09-19,17:00:00,649,161,488,FMN GV 16 Berchem TOT
54,Posthofbrug 5366,2022-09-19,18:00:00,363,121,242,FMN GV 16 Berchem TOT
54,Posthofbrug 5366,2022-09-19,19:00:00,213,77,136,FMN GV 16 Berchem TOT
54,Posthofbrug 5366,2022-09-19,20:00:00,96,49,47,FMN GV 16 Berchem TOT
54,Posthofbrug 5366,2022-09-19,21:00:00,89,40,49,FMN GV 16 Berchem TOT
54,Posthofbrug 5366,2022-09-19,22:00:00,86,27,59,FMN GV 16 Berchem TOT
54,Posthofbrug 5366,2022-09-19,23:00:00,37,15,22,FMN GV 16 Berchem TOT
54,Posthofbrug 5366,2022-09-20,00:00:00,26,6,20,FMN GV 16 Berchem TOT
54,Posthofbrug 5366,2022-09-20,01:00:00,8,0,8,FMN GV 16 Berchem TOT
54,Posthofbrug 5366,2022-09-20,02:00:00,3,2,1,FMN GV 16 Berchem TOT
54,Posthofbrug 5366,2022-09-20,03:00:00,1,1,0,FMN GV 16 Berchem TOT
54,Posthofbrug 5366,2022-09-20,04:00:00,11,8,3,FMN GV 16 Berchem TOT
54,Posthofbrug 5366,2022-09-20,05:00:00,34,22,12,FMN GV 16 Berchem TOT
54,Posthofbrug 5366,2022-09-20,06:00:00,140,111,29,FMN GV 16 Berchem TOT
54,Posthofbrug 5366,2022-09-20,07:00:00,479,386,93,FMN GV 16 Berchem TOT
54,Posthofbrug 5366,2022-09-20,08:00:00,887,713,174,FMN GV 16 Berchem TOT
54,Posthofbrug 5366,2022-09-20,09:00:00,319,239,80,FMN GV 16 Berchem TOT
54,Posthofbrug 5366,2022-09-20,10:00:00,140,85,55,FMN GV 16 Berchem TOT
54,Posthofbrug 5366,2022-09-20,11:00:00,130,72,58,FMN GV 16 Berchem TOT
54,Posthofbrug 5366,2022-09-20,12:00:00,179,105,74,FMN GV 16 Berchem TOT
54,Posthofbrug 5366,2022-09-20,13:00:00,159,73,86,FMN GV 16 Berchem TOT
54,Posthofbrug 5366,2022-09-20,14:00:00,172,65,107,FMN GV 16 Berchem TOT
54,Posthofbrug 5366,2022-09-20,15:00:00,296,93,203,FMN GV 16 Berchem TOT
54,Posthofbrug 5366,2022-09-20,16:00:00,518,136,382,FMN GV 16 Berchem TOT
54,Posthofbrug 5366,2022-09-20,17:00:00,683,194,489,FMN GV 16 Berchem TOT
54,Posthofbrug 5366,2022-09-20,18:00:00,406,128,278,FMN GV 16 Berchem TOT
54,Posthofbrug 5366,2022-09-20,19:00:00,238,98,140,FMN GV 16 Berchem TOT
54,Posthofbrug 5366,2022-09-20,20:00:00,137,66,71,FMN GV 16 Berchem TOT
54,Posthofbrug 5366,2022-09-20,21:00:00,139,60,79,FMN GV 16 Berchem TOT
54,Posthofbrug 5366,2022-09-20,22:00:00,104,32,72,FMN GV 16 Berchem TOT
54,Posthofbrug 5366,2022-09-20,23:00:00,67,22,45,FMN GV 16 Berchem TOT
54,Posthofbrug 5366,2022-09-21,00:00:00,24,9,15,FMN GV 16 Berchem TOT
54,Posthofbrug 5366,2022-09-21,01:00:00,6,1,5,FMN GV 16 Berchem TOT
54,Posthofbrug 5366,2022-09-21,02:00:00,7,2,5,FMN GV 16 Berchem TOT
54,Posthofbrug 5366,2022-09-21,03:00:00,9,1,8,FMN GV 16 Berchem TOT
54,Posthofbrug 5366,2022-09-21,04:00:00,9,4,5,FMN GV 16 Berchem TOT
54,Posthofbrug 5366,2022-09-21,05:00:00,36,23,13,FMN GV 16 Berchem TOT
54,Posthofbrug 5366,2022-09-21,06:00:00,128,104,24,FMN GV 16 Berchem TOT
54,Posthofbrug 5366,2022-09-21,07:00:00,444,352,92,FMN GV 16 Berchem TOT
54,Posthofbrug 5366,2022-09-21,08:00:00,776,606,170,FMN GV 16 Berchem TOT
54,Posthofbrug 5366,2022-09-21,09:00:00,300,218,82,FMN GV 16 Berchem TOT
54,Posthofbrug 5366,2022-09-21,10:00:00,163,104,59,FMN GV 16 Berchem TOT
54,Posthofbrug 5366,2022-09-21,11:00:00,153,88,65,FMN GV 16 Berchem TOT
54,Posthofbrug 5366,2022-09-21,12:00:00,352,143,209,FMN GV 16 Berchem TOT
54,Posthofbrug 5366,2022-09-21,13:00:00,279,133,146,FMN GV 16 Berchem TOT
54,Posthofbrug 5366,2022-09-21,14:00:00,251,120,131,FMN GV 16 Berchem TOT
54,Posthofbrug 5366,2022-09-21,15:00:00,259,94,165,FMN GV 16 Berchem TOT
54,Posthofbrug 5366,2022-09-21,16:00:00,429,145,284,FMN GV 16 Berchem TOT
54,Posthofbrug 5366,2022-09-21,17:00:00,573,180,393,FMN GV 16 Berchem TOT
54,Posthofbrug 5366,2022-09-21,18:00:00,371,142,229,FMN GV 16 Berchem TOT
54,Posthofbrug 5366,2022-09-21,19:00:00,275,121,154,FMN GV 16 Berchem TOT
54,Posthofbrug 5366,2022-09-21,20:00:00,128,58,70,FMN GV 16 Berchem TOT
54,Posthofbrug 5366,2022-09-21,21:00:00,132,60,72,FMN GV 16 Berchem TOT
54,Posthofbrug 5366,2022-09-21,22:00:00,111,30,81,FMN GV 16 Berchem TOT
54,Posthofbrug 5366,2022-09-21,23:00:00,82,22,60,FMN GV 16 Berchem TOT
54,Posthofbrug 5366,2022-09-22,00:00:00,38,15,23,FMN GV 16 Berchem TOT
54,Posthofbrug 5366,2022-09-22,01:00:00,11,0,11,FMN GV 16 Berchem TOT
54,Posthofbrug 5366,2022-09-22,02:00:00,9,3,6,FMN GV 16 Berchem TOT
54,Posthofbrug 5366,2022-09-22,03:00:00,2,1,1,FMN GV 16 Berchem TOT
54,Posthofbrug 5366,2022-09-22,04:00:00,6,4,2,FMN GV 16 Berchem TOT
54,Posthofbrug 5366,2022-09-22,05:00:00,24,13,11,FMN GV 16 Berchem TOT
54,Posthofbrug 5366,2022-09-22,06:00:00,132,102,30,FMN GV 16 Berchem TOT
54,Posthofbrug 5366,2022-09-22,07:00:00,503,405,98,FMN GV 16 Berchem TOT
54,Posthofbrug 5366,2022-09-22,08:00:00,913,726,187,FMN GV 16 Berchem TOT
54,Posthofbrug 5366,2022-09-22,09:00:00,342,271,71,FMN GV 16 Berchem TOT
54,Posthofbrug 5366,2022-09-22,10:00:00,147,108,39,FMN GV 16 Berchem TOT
54,Posthofbrug 5366,2022-09-22,11:00:00,151,86,65,FMN GV 16 Berchem TOT
54,Posthofbrug 5366,2022-09-22,12:00:00,237,128,109,FMN GV 16 Berchem TOT
54,Posthofbrug 5366,2022-09-22,13:00:00,216,114,102,FMN GV 16 Berchem TOT
54,Posthofbrug 5366,2022-09-22,14:00:00,216,100,116,FMN GV 16 Berchem TOT
54,Posthofbrug 5366,2022-09-22,15:00:00,324,122,202,FMN GV 16 Berchem TOT
54,Posthofbrug 5366,2022-09-22,16:00:00,564,152,412,FMN GV 16 Berchem TOT
54,Posthofbrug 5366,2022-09-22,17:00:00,677,171,506,FMN GV 16 Berchem TOT
54,Posthofbrug 5366,2022-09-22,18:00:00,407,136,271,FMN GV 16 Berchem TOT
54,Posthofbrug 5366,2022-09-22,19:00:00,260,113,147,FMN GV 16 Berchem TOT
54,Posthofbrug 5366,2022-09-22,20:00:00,148,76,72,FMN GV 16 Berchem TOT
54,Posthofbrug 5366,2022-09-22,21:00:00,149,71,78,FMN GV 16 Berchem TOT
54,Posthofbrug 5366,2022-09-22,22:00:00,144,53,91,FMN GV 16 Berchem TOT
54,Posthofbrug 5366,2022-09-22,23:00:00,76,25,51,FMN GV 16 Berchem TOT
54,Posthofbrug 5366,2022-09-23,00:00:00,41,6,35,FMN GV 16 Berchem TOT
54,Posthofbrug 5366,2022-09-23,01:00:00,29,6,23,FMN GV 16 Berchem TOT
54,Posthofbrug 5366,2022-09-23,02:00:00,20,4,16,FMN GV 16 Berchem TOT
54,Posthofbrug 5366,2022-09-23,03:00:00,1,1,0,FMN GV 16 Berchem TOT
54,Posthofbrug 5366,2022-09-23,04:00:00,5,2,3,FMN GV 16 Berchem TOT
54,Posthofbrug 5366,2022-09-23,05:00:00,35,24,11,FMN GV 16 Berchem TOT
54,Posthofbrug 5366,2022-09-23,06:00:00,113,86,27,FMN GV 16 Berchem TOT
54,Posthofbrug 5366,2022-09-23,07:00:00,406,332,74,FMN GV 16 Berchem TOT
54,Posthofbrug 5366,2022-09-23,08:00:00,639,503,136,FMN GV 16 Berchem TOT
54,Posthofbrug 5366,2022-09-23,09:00:00,293,240,53,FMN GV 16 Berchem TOT
54,Posthofbrug 5366,2022-09-23,10:00:00,136,92,44,FMN GV 16 Berchem TOT
54,Posthofbrug 5366,2022-09-23,11:00:00,144,88,56,FMN GV 16 Berchem TOT
54,Posthofbrug 5366,2022-09-23,12:00:00,222,121,101,FMN GV 16 Berchem TOT
54,Posthofbrug 5366,2022-09-23,13:00:00,190,95,95,FMN GV 16 Berchem TOT
54,Posthofbrug 5366,2022-09-23,14:00:00,195,78,117,FMN GV 16 Berchem TOT
54,Posthofbrug 5366,2022-09-23,15:00:00,305,101,204,FMN GV 16 Berchem TOT
54,Posthofbrug 5366,2022-09-23,16:00:00,443,131,312,FMN GV 16 Berchem TOT
54,Posthofbrug 5366,2022-09-23,17:00:00,452,150,302,FMN GV 16 Berchem TOT
54,Posthofbrug 5366,2022-09-23,18:00:00,288,94,194,FMN GV 16 Berchem TOT
54,Posthofbrug 5366,2022-09-23,19:00:00,182,94,88,FMN GV 16 Berchem TOT
54,Posthofbrug 5366,2022-09-23,20:00:00,84,31,53,FMN GV 16 Berchem TOT
54,Posthofbrug 5366,2022-09-23,21:00:00,74,38,36,FMN GV 16 Berchem TOT
54,Posthofbrug 5366,2022-09-23,22:00:00,98,35,63,FMN GV 16 Berchem TOT
54,Posthofbrug 5366,2022-09-23,23:00:00,73,15,58,FMN GV 16 Berchem TOT
54,Posthofbrug 5366,2022-09-24,00:00:00,53,19,34,FMN GV 16 Berchem TOT
54,Posthofbrug 5366,2022-09-24,01:00:00,48,15,33,FMN GV 16 Berchem TOT
54,Posthofbrug 5366,2022-09-24,02:00:00,19,3,16,FMN GV 16 Berchem TOT
54,Posthofbrug 5366,2022-09-24,03:00:00,12,1,11,FMN GV 16 Berchem TOT
54,Posthofbrug 5366,2022-09-24,04:00:00,14,1,13,FMN GV 16 Berchem TOT
54,Posthofbrug 5366,2022-09-24,05:00:00,21,12,9,FMN GV 16 Berchem TOT
54,Posthofbrug 5366,2022-09-24,06:00:00,21,12,9,FMN GV 16 Berchem TOT
54,Posthofbrug 5366,2022-09-24,07:00:00,31,19,12,FMN GV 16 Berchem TOT
54,Posthofbrug 5366,2022-09-24,08:00:00,71,47,24,FMN GV 16 Berchem TOT
54,Posthofbrug 5366,2022-09-24,09:00:00,109,66,43,FMN GV 16 Berchem TOT
54,Posthofbrug 5366,2022-09-24,10:00:00,86,53,33,FMN GV 16 Berchem TOT
54,Posthofbrug 5366,2022-09-24,11:00:00,72,41,31,FMN GV 16 Berchem TOT
54,Posthofbrug 5366,2022-09-24,12:00:00,96,46,50,FMN GV 16 Berchem TOT
54,Posthofbrug 5366,2022-09-24,13:00:00,92,41,51,FMN GV 16 Berchem TOT
54,Posthofbrug 5366,2022-09-24,14:00:00,116,59,57,FMN GV 16 Berchem TOT
54,Posthofbrug 5366,2022-09-24,15:00:00,151,81,70,FMN GV 16 Berchem TOT
54,Posthofbrug 5366,2022-09-24,16:00:00,111,43,68,FMN GV 16 Berchem TOT
54,Posthofbrug 5366,2022-09-24,17:00:00,117,56,61,FMN GV 16 Berchem TOT
54,Posthofbrug 5366,2022-09-24,18:00:00,132,64,68,FMN GV 16 Berchem TOT
54,Posthofbrug 5366,2022-09-24,19:00:00,108,66,42,FMN GV 16 Berchem TOT
54,Posthofbrug 5366,2022-09-24,20:00:00,79,50,29,FMN GV 16 Berchem TOT
54,Posthofbrug 5366,2022-09-24,21:00:00,65,46,19,FMN GV 16 Berchem TOT
54,Posthofbrug 5366,2022-09-24,22:00:00,73,34,39,FMN GV 16 Berchem TOT
54,Posthofbrug 5366,2022-09-24,23:00:00,80,33,47,FMN GV 16 Berchem TOT
54,Posthofbrug 5366,2022-09-25,00:00:00,55,25,30,FMN GV 16 Berchem TOT
54,Posthofbrug 5366,2022-09-25,01:00:00,40,17,23,FMN GV 16 Berchem TOT
54,Posthofbrug 5366,2022-09-25,02:00:00,47,13,34,FMN GV 16 Berchem TOT
54,Posthofbrug 5366,2022-09-25,03:00:00,26,13,13,FMN GV 16 Berchem TOT
54,Posthofbrug 5366,2022-09-25,04:00:00,12,8,4,FMN GV 16 Berchem TOT
54,Posthofbrug 5366,2022-09-25,05:00:00,21,11,10,FMN GV 16 Berchem TOT
54,Posthofbrug 5366,2022-09-25,06:00:00,24,15,9,FMN GV 16 Berchem TOT
54,Posthofbrug 5366,2022-09-25,07:00:00,30,19,11,FMN GV 16 Berchem TOT
54,Posthofbrug 5366,2022-09-25,08:00:00,65,39,26,FMN GV 16 Berchem TOT
54,Posthofbrug 5366,2022-09-25,09:00:00,100,56,44,FMN GV 16 Berchem TOT
54,Posthofbrug 5366,2022-09-25,10:00:00,178,121,57,FMN GV 16 Berchem TOT
54,Posthofbrug 5366,2022-09-25,11:00:00,184,124,60,FMN GV 16 Berchem TOT
54,Posthofbrug 5366,2022-09-25,12:00:00,197,108,89,FMN GV 16 Berchem TOT
54,Posthofbrug 5366,2022-09-25,13:00:00,176,94,82,FMN GV 16 Berchem TOT
54,Posthofbrug 5366,2022-09-25,14:00:00,195,115,80,FMN GV 16 Berchem TOT
54,Posthofbrug 5366,2022-09-25,15:00:00,168,84,84,FMN GV 16 Berchem TOT
54,Posthofbrug 5366,2022-09-25,16:00:00,177,84,93,FMN GV 16 Berchem TOT
54,Posthofbrug 5366,2022-09-25,17:00:00,195,72,123,FMN GV 16 Berchem TOT
54,Posthofbrug 5366,2022-09-25,18:00:00,176,84,92,FMN GV 16 Berchem TOT
54,Posthofbrug 5366,2022-09-25,19:00:00,121,66,55,FMN GV 16 Berchem TOT
54,Posthofbrug 5366,2022-09-25,20:00:00,90,52,38,FMN GV 16 Berchem TOT
54,Posthofbrug 5366,2022-09-25,21:00:00,60,28,32,FMN GV 16 Berchem TOT
54,Posthofbrug 5366,2022-09-25,22:00:00,55,27,28,FMN GV 16 Berchem TOT
54,Posthofbrug 5366,2022-09-25,23:00:00,26,9,17,FMN GV 16 Berchem TOT
54,Posthofbrug 5366,2022-09-26,00:00:00,20,6,14,FMN GV 16 Berchem TOT
54,Posthofbrug 5366,2022-09-26,01:00:00,14,7,7,FMN GV 16 Berchem TOT
54,Posthofbrug 5366,2022-09-26,02:00:00,7,0,7,FMN GV 16 Berchem TOT
54,Posthofbrug 5366,2022-09-26,03:00:00,6,2,4,FMN GV 16 Berchem TOT
54,Posthofbrug 5366,2022-09-26,04:00:00,7,6,1,FMN GV 16 Berchem TOT
54,Posthofbrug 5366,2022-09-26,05:00:00,28,17,11,FMN GV 16 Berchem TOT
54,Posthofbrug 5366,2022-09-26,06:00:00,113,87,26,FMN GV 16 Berchem TOT
54,Posthofbrug 5366,2022-09-26,07:00:00,401,322,79,FMN GV 16 Berchem TOT
54,Posthofbrug 5366,2022-09-26,08:00:00,764,595,169,FMN GV 16 Berchem TOT
54,Posthofbrug 5366,2022-09-26,09:00:00,272,217,55,FMN GV 16 Berchem TOT
54,Posthofbrug 5366,2022-09-26,10:00:00,96,53,43,FMN GV 16 Berchem TOT
54,Posthofbrug 5366,2022-09-26,11:00:00,84,45,39,FMN GV 16 Berchem TOT
54,Posthofbrug 5366,2022-09-26,12:00:00,132,74,58,FMN GV 16 Berchem TOT
54,Posthofbrug 5366,2022-09-26,13:00:00,97,49,48,FMN GV 16 Berchem TOT
54,Posthofbrug 5366,2022-09-26,14:00:00,123,51,72,FMN GV 16 Berchem TOT
54,Posthofbrug 5366,2022-09-26,15:00:00,226,68,158,FMN GV 16 Berchem TOT
54,Posthofbrug 5366,2022-09-26,16:00:00,373,102,271,FMN GV 16 Berchem TOT
54,Posthofbrug 5366,2022-09-26,17:00:00,473,128,345,FMN GV 16 Berchem TOT
54,Posthofbrug 5366,2022-09-26,18:00:00,319,90,229,FMN GV 16 Berchem TOT
54,Posthofbrug 5366,2022-09-26,19:00:00,147,46,101,FMN GV 16 Berchem TOT
54,Posthofbrug 5366,2022-09-26,20:00:00,84,31,53,FMN GV 16 Berchem TOT
54,Posthofbrug 5366,2022-09-26,21:00:00,82,39,43,FMN GV 16 Berchem TOT
54,Posthofbrug 5366,2022-09-26,22:00:00,68,24,44,FMN GV 16 Berchem TOT
54,Posthofbrug 5366,2022-09-26,23:00:00,29,10,19,FMN GV 16 Berchem TOT
54,Posthofbrug 5366,2022-09-27,00:00:00,10,1,9,FMN GV 16 Berchem TOT
54,Posthofbrug 5366,2022-09-27,01:00:00,15,2,13,FMN GV 16 Berchem TOT
54,Posthofbrug 5366,2022-09-27,02:00:00,3,0,3,FMN GV 16 Berchem TOT
54,Posthofbrug 5366,2022-09-27,03:00:00,4,2,2,FMN GV 16 Berchem TOT
54,Posthofbrug 5366,2022-09-27,04:00:00,6,4,2,FMN GV 16 Berchem TOT
54,Posthofbrug 5366,2022-09-27,05:00:00,31,24,7,FMN GV 16 Berchem TOT
54,Posthofbrug 5366,2022-09-27,06:00:00,87,63,24,FMN GV 16 Berchem TOT
54,Posthofbrug 5366,2022-09-27,07:00:00,393,299,94,FMN GV 16 Berchem TOT
54,Posthofbrug 5366,2022-09-27,08:00:00,684,545,139,FMN GV 16 Berchem TOT
54,Posthofbrug 5366,2022-09-27,09:00:00,252,172,80,FMN GV 16 Berchem TOT
54,Posthofbrug 5366,2022-09-27,10:00:00,104,57,47,FMN GV 16 Berchem TOT
54,Posthofbrug 5366,2022-09-27,11:00:00,86,54,32,FMN GV 16 Berchem TOT
54,Posthofbrug 5366,2022-09-27,12:00:00,139,74,65,FMN GV 16 Berchem TOT
54,Posthofbrug 5366,2022-09-27,13:00:00,128,72,56,FMN GV 16 Berchem TOT
54,Posthofbrug 5366,2022-09-27,14:00:00,118,49,69,FMN GV 16 Berchem TOT
54,Posthofbrug 5366,2022-09-27,15:00:00,249,94,155,FMN GV 16 Berchem TOT
54,Posthofbrug 5366,2022-09-27,16:00:00,427,126,301,FMN GV 16 Berchem TOT
54,Posthofbrug 5366,2022-09-27,17:00:00,499,141,358,FMN GV 16 Berchem TOT
54,Posthofbrug 5366,2022-09-27,18:00:00,339,110,229,FMN GV 16 Berchem TOT
54,Posthofbrug 5366,2022-09-27,19:00:00,151,67,84,FMN GV 16 Berchem TOT
54,Posthofbrug 5366,2022-09-27,20:00:00,106,52,54,FMN GV 16 Berchem TOT
54,Posthofbrug 5366,2022-09-27,21:00:00,86,26,60,FMN GV 16 Berchem TOT
54,Posthofbrug 5366,2022-09-27,22:00:00,73,16,57,FMN GV 16 Berchem TOT
54,Posthofbrug 5366,2022-09-27,23:00:00,45,13,32,FMN GV 16 Berchem TOT
54,Posthofbrug 5366,2022-09-28,00:00:00,23,4,19,FMN GV 16 Berchem TOT
54,Posthofbrug 5366,2022-09-28,01:00:00,5,0,5,FMN GV 16 Berchem TOT
54,Posthofbrug 5366,2022-09-28,02:00:00,3,1,2,FMN GV 16 Berchem TOT
54,Posthofbrug 5366,2022-09-28,03:00:00,4,1,3,FMN GV 16 Berchem TOT
54,Posthofbrug 5366,2022-09-28,04:00:00,9,7,2,FMN GV 16 Berchem TOT
54,Posthofbrug 5366,2022-09-28,05:00:00,30,20,10,FMN GV 16 Berchem TOT
54,Posthofbrug 5366,2022-09-28,06:00:00,100,74,26,FMN GV 16 Berchem TOT
54,Posthofbrug 5366,2022-09-28,07:00:00,390,300,90,FMN GV 16 Berchem TOT
54,Posthofbrug 5366,2022-09-28,08:00:00,728,557,171,FMN GV 16 Berchem TOT
54,Posthofbrug 5366,2022-09-28,09:00:00,269,191,78,FMN GV 16 Berchem TOT
54,Posthofbrug 5366,2022-09-28,10:00:00,126,85,41,FMN GV 16 Berchem TOT
54,Posthofbrug 5366,2022-09-28,11:00:00,128,78,50,FMN GV 16 Berchem TOT
54,Posthofbrug 5366,2022-09-28,12:00:00,308,127,181,FMN GV 16 Berchem TOT
54,Posthofbrug 5366,2022-09-28,13:00:00,245,117,128,FMN GV 16 Berchem TOT
54,Posthofbrug 5366,2022-09-28,14:00:00,169,62,107,FMN GV 16 Berchem TOT
54,Posthofbrug 5366,2022-09-28,15:00:00,210,84,126,FMN GV 16 Berchem TOT
54,Posthofbrug 5366,2022-09-28,16:00:00,368,126,242,FMN GV 16 Berchem TOT
54,Posthofbrug 5366,2022-09-28,17:00:00,540,180,360,FMN GV 16 Berchem TOT
54,Posthofbrug 5366,2022-09-28,18:00:00,341,127,214,FMN GV 16 Berchem TOT
54,Posthofbrug 5366,2022-09-28,19:00:00,197,78,119,FMN GV 16 Berchem TOT
54,Posthofbrug 5366,2022-09-28,20:00:00,109,55,54,FMN GV 16 Berchem TOT
54,Posthofbrug 5366,2022-09-28,21:00:00,110,59,51,FMN GV 16 Berchem TOT
54,Posthofbrug 5366,2022-09-28,22:00:00,91,28,63,FMN GV 16 Berchem TOT
54,Posthofbrug 5366,2022-09-28,23:00:00,59,17,42,FMN GV 16 Berchem TOT
54,Posthofbrug 5366,2022-09-29,00:00:00,21,8,13,FMN GV 16 Berchem TOT
54,Posthofbrug 5366,2022-09-29,01:00:00,10,2,8,FMN GV 16 Berchem TOT
54,Posthofbrug 5366,2022-09-29,02:00:00,6,1,5,FMN GV 16 Berchem TOT
54,Posthofbrug 5366,2022-09-29,03:00:00,4,0,4,FMN GV 16 Berchem TOT
54,Posthofbrug 5366,2022-09-29,04:00:00,17,12,5,FMN GV 16 Berchem TOT
54,Posthofbrug 5366,2022-09-29,05:00:00,33,26,7,FMN GV 16 Berchem TOT
54,Posthofbrug 5366,2022-09-29,06:00:00,127,98,29,FMN GV 16 Berchem TOT
54,Posthofbrug 5366,2022-09-29,07:00:00,485,387,98,FMN GV 16 Berchem TOT
54,Posthofbrug 5366,2022-09-29,08:00:00,840,657,183,FMN GV 16 Berchem TOT
54,Posthofbrug 5366,2022-09-29,09:00:00,322,253,69,FMN GV 16 Berchem TOT
54,Posthofbrug 5366,2022-09-29,10:00:00,160,107,53,FMN GV 16 Berchem TOT
54,Posthofbrug 5366,2022-09-29,11:00:00,130,91,39,FMN GV 16 Berchem TOT
54,Posthofbrug 5366,2022-09-29,12:00:00,237,134,103,FMN GV 16 Berchem TOT
54,Posthofbrug 5366,2022-09-29,13:00:00,223,102,121,FMN GV 16 Berchem TOT
54,Posthofbrug 5366,2022-09-29,14:00:00,206,78,128,FMN GV 16 Berchem TOT
54,Posthofbrug 5366,2022-09-29,15:00:00,300,109,191,FMN GV 16 Berchem TOT
54,Posthofbrug 5366,2022-09-29,16:00:00,474,140,334,FMN GV 16 Berchem TOT
54,Posthofbrug 5366,2022-09-29,17:00:00,635,179,456,FMN GV 16 Berchem TOT
54,Posthofbrug 5366,2022-09-29,18:00:00,394,128,266,FMN GV 16 Berchem TOT
54,Posthofbrug 5366,2022-09-29,19:00:00,249,97,152,FMN GV 16 Berchem TOT
54,Posthofbrug 5366,2022-09-29,20:00:00,127,68,59,FMN GV 16 Berchem TOT
54,Posthofbrug 5366,2022-09-29,21:00:00,111,45,66,FMN GV 16 Berchem TOT
54,Posthofbrug 5366,2022-09-29,22:00:00,143,44,99,FMN GV 16 Berchem TOT
54,Posthofbrug 5366,2022-09-29,23:00:00,74,17,57,FMN GV 16 Berchem TOT
54,Posthofbrug 5366,2022-09-30,00:00:00,44,5,39,FMN GV 16 Berchem TOT
54,Posthofbrug 5366,2022-09-30,01:00:00,45,5,40,FMN GV 16 Berchem TOT
54,Posthofbrug 5366,2022-09-30,02:00:00,21,0,21,FMN GV 16 Berchem TOT
54,Posthofbrug 5366,2022-09-30,03:00:00,8,0,8,FMN GV 16 Berchem TOT
54,Posthofbrug 5366,2022-09-30,04:00:00,19,10,9,FMN GV 16 Berchem TOT
54,Posthofbrug 5366,2022-09-30,05:00:00,37,22,15,FMN GV 16 Berchem TOT
54,Posthofbrug 5366,2022-09-30,06:00:00,108,82,26,FMN GV 16 Berchem TOT
54,Posthofbrug 5366,2022-09-30,07:00:00,372,295,77,FMN GV 16 Berchem TOT
54,Posthofbrug 5366,2022-09-30,08:00:00,738,592,146,FMN GV 16 Berchem TOT
54,Posthofbrug 5366,2022-09-30,09:00:00,256,213,43,FMN GV 16 Berchem TOT
54,Posthofbrug 5366,2022-09-30,10:00:00,196,134,62,FMN GV 16 Berchem TOT
54,Posthofbrug 5366,2022-09-30,11:00:00,156,88,68,FMN GV 16 Berchem TOT
54,Posthofbrug 5366,2022-09-30,12:00:00,208,108,100,FMN GV 16 Berchem TOT
54,Posthofbrug 5366,2022-09-30,13:00:00,224,107,117,FMN GV 16 Berchem TOT
54,Posthofbrug 5366,2022-09-30,14:00:00,266,115,151,FMN GV 16 Berchem TOT
54,Posthofbrug 5366,2022-09-30,15:00:00,323,117,206,FMN GV 16 Berchem TOT
54,Posthofbrug 5366,2022-09-30,16:00:00,460,148,312,FMN GV 16 Berchem TOT
54,Posthofbrug 5366,2022-09-30,17:00:00,557,189,368,FMN GV 16 Berchem TOT
54,Posthofbrug 5366,2022-09-30,18:00:00,337,133,204,FMN GV 16 Berchem TOT
54,Posthofbrug 5366,2022-09-30,19:00:00,235,118,117,FMN GV 16 Berchem TOT
54,Posthofbrug 5366,2022-09-30,20:00:00,145,73,72,FMN GV 16 Berchem TOT
54,Posthofbrug 5366,2022-09-30,21:00:00,95,48,47,FMN GV 16 Berchem TOT
54,Posthofbrug 5366,2022-09-30,22:00:00,117,44,73,FMN GV 16 Berchem TOT
54,Posthofbrug 5366,2022-09-30,23:00:00,78,28,50,FMN GV 16 Berchem TOT
54,Posthofbrug 5366,2022-10-01,00:00:00,55,12,43,FMN GV 16 Berchem TOT
54,Posthofbrug 5366,2022-10-01,01:00:00,56,10,46,FMN GV 16 Berchem TOT
54,Posthofbrug 5366,2022-10-01,02:00:00,30,5,25,FMN GV 16 Berchem TOT
54,Posthofbrug 5366,2022-10-01,03:00:00,32,12,20,FMN GV 16 Berchem TOT
54,Posthofbrug 5366,2022-10-01,04:00:00,20,8,12,FMN GV 16 Berchem TOT
54,Posthofbrug 5366,2022-10-01,05:00:00,20,11,9,FMN GV 16 Berchem TOT
54,Posthofbrug 5366,2022-10-01,06:00:00,14,8,6,FMN GV 16 Berchem TOT
54,Posthofbrug 5366,2022-10-01,07:00:00,41,23,18,FMN GV 16 Berchem TOT
54,Posthofbrug 5366,2022-10-01,08:00:00,66,39,27,FMN GV 16 Berchem TOT
54,Posthofbrug 5366,2022-10-01,09:00:00,113,70,43,FMN GV 16 Berchem TOT
54,Posthofbrug 5366,2022-10-01,10:00:00,120,71,49,FMN GV 16 Berchem TOT
54,Posthofbrug 5366,2022-10-01,11:00:00,159,106,53,FMN GV 16 Berchem TOT
54,Posthofbrug 5366,2022-10-01,12:00:00,139,87,52,FMN GV 16 Berchem TOT
54,Posthofbrug 5366,2022-10-01,13:00:00,169,100,69,FMN GV 16 Berchem TOT
54,Posthofbrug 5366,2022-10-01,14:00:00,168,96,72,FMN GV 16 Berchem TOT
54,Posthofbrug 5366,2022-10-01,15:00:00,163,99,64,FMN GV 16 Berchem TOT
54,Posthofbrug 5366,2022-10-01,16:00:00,183,78,105,FMN GV 16 Berchem TOT
54,Posthofbrug 5366,2022-10-01,17:00:00,185,89,96,FMN GV 16 Berchem TOT
54,Posthofbrug 5366,2022-10-01,18:00:00,175,88,87,FMN GV 16 Berchem TOT
54,Posthofbrug 5366,2022-10-01,19:00:00,129,78,51,FMN GV 16 Berchem TOT
54,Posthofbrug 5366,2022-10-01,20:00:00,85,35,50,FMN GV 16 Berchem TOT
54,Posthofbrug 5366,2022-10-01,21:00:00,70,39,31,FMN GV 16 Berchem TOT
54,Posthofbrug 5366,2022-10-01,22:00:00,70,31,39,FMN GV 16 Berchem TOT
54,Posthofbrug 5366,2022-10-01,23:00:00,59,17,42,FMN GV 16 Berchem TOT
54,Posthofbrug 5366,2022-10-02,00:00:00,53,16,37,FMN GV 16 Berchem TOT
54,Posthofbrug 5366,2022-10-02,01:00:00,47,19,28,FMN GV 16 Berchem TOT
54,Posthofbrug 5366,2022-10-02,02:00:00,34,5,29,FMN GV 16 Berchem TOT
54,Posthofbrug 5366,2022-10-02,03:00:00,18,3,15,FMN GV 16 Berchem TOT
54,Posthofbrug 5366,2022-10-02,04:00:00,26,6,20,FMN GV 16 Berchem TOT
54,Posthofbrug 5366,2022-10-02,05:00:00,26,10,16,FMN GV 16 Berchem TOT
54,Posthofbrug 5366,2022-10-02,06:00:00,19,7,12,FMN GV 16 Berchem TOT
54,Posthofbrug 5366,2022-10-02,07:00:00,20,12,8,FMN GV 16 Berchem TOT
54,Posthofbrug 5366,2022-10-02,08:00:00,29,18,11,FMN GV 16 Berchem TOT
54,Posthofbrug 5366,2022-10-02,09:00:00,82,47,35,FMN GV 16 Berchem TOT
54,Posthofbrug 5366,2022-10-02,10:00:00,91,49,42,FMN GV 16 Berchem TOT
54,Posthofbrug 5366,2022-10-02,11:00:00,106,72,34,FMN GV 16 Berchem TOT
54,Posthofbrug 5366,2022-10-02,12:00:00,178,118,60,FMN GV 16 Berchem TOT
54,Posthofbrug 5366,2022-10-02,13:00:00,157,87,70,FMN GV 16 Berchem TOT
54,Posthofbrug 5366,2022-10-02,14:00:00,152,104,48,FMN GV 16 Berchem TOT
54,Posthofbrug 5366,2022-10-02,15:00:00,123,71,52,FMN GV 16 Berchem TOT
54,Posthofbrug 5366,2022-10-02,16:00:00,152,69,83,FMN GV 16 Berchem TOT
54,Posthofbrug 5366,2022-10-02,17:00:00,172,71,101,FMN GV 16 Berchem TOT
54,Posthofbrug 5366,2022-10-02,18:00:00,148,57,91,FMN GV 16 Berchem TOT
54,Posthofbrug 5366,2022-10-02,19:00:00,83,38,45,FMN GV 16 Berchem TOT
54,Posthofbrug 5366,2022-10-02,20:00:00,84,44,40,FMN GV 16 Berchem TOT
54,Posthofbrug 5366,2022-10-02,21:00:00,83,39,44,FMN GV 16 Berchem TOT
54,Posthofbrug 5366,2022-10-02,22:00:00,63,22,41,FMN GV 16 Berchem TOT
54,Posthofbrug 5366,2022-10-02,23:00:00,32,11,21,FMN GV 16 Berchem TOT
54,Posthofbrug 5366,2022-10-03,00:00:00,12,6,6,FMN GV 16 Berchem TOT
54,Posthofbrug 5366,2022-10-03,01:00:00,5,0,5,FMN GV 16 Berchem TOT
54,Posthofbrug 5366,2022-10-03,02:00:00,2,1,1,FMN GV 16 Berchem TOT
54,Posthofbrug 5366,2022-10-03,03:00:00,3,0,3,FMN GV 16 Berchem TOT
54,Posthofbrug 5366,2022-10-03,04:00:00,15,10,5,FMN GV 16 Berchem TOT
54,Posthofbrug 5366,2022-10-03,05:00:00,30,21,9,FMN GV 16 Berchem TOT
54,Posthofbrug 5366,2022-10-03,06:00:00,134,100,34,FMN GV 16 Berchem TOT
54,Posthofbrug 5366,2022-10-03,07:00:00,446,352,94,FMN GV 16 Berchem TOT
54,Posthofbrug 5366,2022-10-03,08:00:00,867,700,167,FMN GV 16 Berchem TOT
54,Posthofbrug 5366,2022-10-03,09:00:00,285,214,71,FMN GV 16 Berchem TOT
54,Posthofbrug 5366,2022-10-03,10:00:00,191,135,56,FMN GV 16 Berchem TOT
54,Posthofbrug 5366,2022-10-03,11:00:00,160,98,62,FMN GV 16 Berchem TOT
54,Posthofbrug 5366,2022-10-03,12:00:00,236,120,116,FMN GV 16 Berchem TOT
54,Posthofbrug 5366,2022-10-03,13:00:00,220,122,98,FMN GV 16 Berchem TOT
54,Posthofbrug 5366,2022-10-03,14:00:00,176,68,108,FMN GV 16 Berchem TOT
54,Posthofbrug 5366,2022-10-03,15:00:00,315,108,207,FMN GV 16 Berchem TOT
54,Posthofbrug 5366,2022-10-03,16:00:00,482,148,334,FMN GV 16 Berchem TOT
54,Posthofbrug 5366,2022-10-03,17:00:00,728,205,523,FMN GV 16 Berchem TOT
54,Posthofbrug 5366,2022-10-03,18:00:00,444,118,326,FMN GV 16 Berchem TOT
54,Posthofbrug 5366,2022-10-03,19:00:00,213,83,130,FMN GV 16 Berchem TOT
54,Posthofbrug 5366,2022-10-03,20:00:00,106,45,61,FMN GV 16 Berchem TOT
54,Posthofbrug 5366,2022-10-03,21:00:00,113,51,62,FMN GV 16 Berchem TOT
54,Posthofbrug 5366,2022-10-03,22:00:00,98,38,60,FMN GV 16 Berchem TOT
54,Posthofbrug 5366,2022-10-03,23:00:00,34,7,27,FMN GV 16 Berchem TOT
54,Posthofbrug 5366,2022-10-04,00:00:00,12,0,12,FMN GV 16 Berchem TOT
54,Posthofbrug 5366,2022-10-04,01:00:00,6,1,5,FMN GV 16 Berchem TOT
54,Posthofbrug 5366,2022-10-04,02:00:00,3,1,2,FMN GV 16 Berchem TOT
54,Posthofbrug 5366,2022-10-04,03:00:00,3,0,3,FMN GV 16 Berchem TOT
54,Posthofbrug 5366,2022-10-04,04:00:00,4,1,3,FMN GV 16 Berchem TOT
54,Posthofbrug 5366,2022-10-04,05:00:00,12,0,12,FMN GV 16 Berchem TOT
54,Posthofbrug 5366,2022-10-04,06:00:00,35,16,19,FMN GV 16 Berchem TOT
54,Posthofbrug 5366,2022-10-04,07:00:00,133,45,88,FMN GV 16 Berchem TOT
54,Posthofbrug 5366,2022-10-04,08:00:00,221,78,143,FMN GV 16 Berchem TOT
54,Posthofbrug 5366,2022-10-04,09:00:00,85,30,55,FMN GV 16 Berchem TOT
54,Posthofbrug 5366,2022-10-04,10:00:00,49,15,34,FMN GV 16 Berchem TOT
54,Posthofbrug 5366,2022-10-04,11:00:00,55,13,42,FMN GV 16 Berchem TOT
54,Posthofbrug 5366,2022-10-04,12:00:00,77,14,63,FMN GV 16 Berchem TOT
54,Posthofbrug 5366,2022-10-04,13:00:00,79,13,66,FMN GV 16 Berchem TOT
54,Posthofbrug 5366,2022-10-04,14:00:00,80,12,68,FMN GV 16 Berchem TOT
54,Posthofbrug 5366,2022-10-04,15:00:00,135,18,117,FMN GV 16 Berchem TOT
54,Posthofbrug 5366,2022-10-04,16:00:00,248,33,215,FMN GV 16 Berchem TOT
54,Posthofbrug 5366,2022-10-04,17:00:00,323,39,284,FMN GV 16 Berchem TOT
54,Posthofbrug 5366,2022-10-04,18:00:00,213,25,188,FMN GV 16 Berchem TOT
54,Posthofbrug 5366,2022-10-04,19:00:00,101,13,88,FMN GV 16 Berchem TOT
54,Posthofbrug 5366,2022-10-04,20:00:00,63,14,49,FMN GV 16 Berchem TOT
54,Posthofbrug 5366,2022-10-04,21:00:00,52,13,39,FMN GV 16 Berchem TOT
54,Posthofbrug 5366,2022-10-04,22:00:00,51,10,41,FMN GV 16 Berchem TOT
54,Posthofbrug 5366,2022-10-04,23:00:00,33,6,27,FMN GV 16 Berchem TOT
54,Posthofbrug 5366,2022-10-05,00:00:00,15,0,15,FMN GV 16 Berchem TOT
54,Posthofbrug 5366,2022-10-05,01:00:00,7,1,6,FMN GV 16 Berchem TOT
54,Posthofbrug 5366,2022-10-05,02:00:00,4,0,4,FMN GV 16 Berchem TOT
54,Posthofbrug 5366,2022-10-05,03:00:00,2,1,1,FMN GV 16 Berchem TOT
54,Posthofbrug 5366,2022-10-05,04:00:00,5,0,5,FMN GV 16 Berchem TOT
54,Posthofbrug 5366,2022-10-05,05:00:00,10,2,8,FMN GV 16 Berchem TOT
54,Posthofbrug 5366,2022-10-05,06:00:00,31,13,18,FMN GV 16 Berchem TOT
54,Posthofbrug 5366,2022-10-05,07:00:00,115,37,78,FMN GV 16 Berchem TOT
54,Posthofbrug 5366,2022-10-05,08:00:00,187,62,125,FMN GV 16 Berchem TOT
54,Posthofbrug 5366,2022-10-05,09:00:00,80,25,55,FMN GV 16 Berchem TOT
54,Posthofbrug 5366,2022-10-05,10:00:00,50,16,34,FMN GV 16 Berchem TOT
54,Posthofbrug 5366,2022-10-05,11:00:00,64,12,52,FMN GV 16 Berchem TOT
54,Posthofbrug 5366,2022-10-05,12:00:00,121,20,101,FMN GV 16 Berchem TOT
54,Posthofbrug 5366,2022-10-05,13:00:00,99,17,82,FMN GV 16 Berchem TOT
54,Posthofbrug 5366,2022-10-05,14:00:00,88,14,74,FMN GV 16 Berchem TOT
54,Posthofbrug 5366,2022-10-05,15:00:00,112,14,98,FMN GV 16 Berchem TOT
54,Posthofbrug 5366,2022-10-05,16:00:00,192,27,165,FMN GV 16 Berchem TOT
54,Posthofbrug 5366,2022-10-05,17:00:00,273,33,240,FMN GV 16 Berchem TOT
54,Posthofbrug 5366,2022-10-05,18:00:00,189,22,167,FMN GV 16 Berchem TOT
54,Posthofbrug 5366,2022-10-05,19:00:00,92,13,79,FMN GV 16 Berchem TOT
54,Posthofbrug 5366,2022-10-05,20:00:00,56,12,44,FMN GV 16 Berchem TOT
54,Posthofbrug 5366,2022-10-05,21:00:00,45,9,36,FMN GV 16 Berchem TOT
54,Posthofbrug 5366,2022-10-05,22:00:00,50,5,45,FMN GV 16 Berchem TOT
54,Posthofbrug 5366,2022-10-05,23:00:00,34,6,28,FMN GV 16 Berchem TOT
54,Posthofbrug 5366,2022-10-06,00:00:00,20,3,17,FMN GV 16 Berchem TOT
54,Posthofbrug 5366,2022-10-06,01:00:00,6,1,5,FMN GV 16 Berchem TOT
54,Posthofbrug 5366,2022-10-06,02:00:00,6,1,5,FMN GV 16 Berchem TOT
54,Posthofbrug 5366,2022-10-06,03:00:00,2,0,2,FMN GV 16 Berchem TOT
54,Posthofbrug 5366,2022-10-06,04:00:00,6,3,3,FMN GV 16 Berchem TOT
54,Posthofbrug 5366,2022-10-06,05:00:00,17,4,13,FMN GV 16 Berchem TOT
54,Posthofbrug 5366,2022-10-06,06:00:00,25,9,16,FMN GV 16 Berchem TOT
54,Posthofbrug 5366,2022-10-06,07:00:00,126,44,82,FMN GV 16 Berchem TOT
54,Posthofbrug 5366,2022-10-06,08:00:00,210,73,137,FMN GV 16 Berchem TOT
54,Posthofbrug 5366,2022-10-06,09:00:00,74,23,51,FMN GV 16 Berchem TOT
54,Posthofbrug 5366,2022-10-06,10:00:00,60,19,41,FMN GV 16 Berchem TOT
54,Posthofbrug 5366,2022-10-06,11:00:00,58,14,44,FMN GV 16 Berchem TOT
54,Posthofbrug 5366,2022-10-06,12:00:00,96,30,66,FMN GV 16 Berchem TOT
54,Posthofbrug 5366,2022-10-06,13:00:00,87,18,69,FMN GV 16 Berchem TOT
54,Posthofbrug 5366,2022-10-06,14:00:00,85,14,71,FMN GV 16 Berchem TOT
54,Posthofbrug 5366,2022-10-06,15:00:00,128,16,112,FMN GV 16 Berchem TOT
54,Posthofbrug 5366,2022-10-06,16:00:00,253,33,220,FMN GV 16 Berchem TOT
54,Posthofbrug 5366,2022-10-06,17:00:00,312,40,272,FMN GV 16 Berchem TOT
54,Posthofbrug 5366,2022-10-06,18:00:00,213,28,185,FMN GV 16 Berchem TOT
54,Posthofbrug 5366,2022-10-06,19:00:00,108,22,86,FMN GV 16 Berchem TOT
54,Posthofbrug 5366,2022-10-06,20:00:00,67,13,54,FMN GV 16 Berchem TOT
54,Posthofbrug 5366,2022-10-06,21:00:00,50,13,37,FMN GV 16 Berchem TOT
54,Posthofbrug 5366,2022-10-06,22:00:00,59,13,46,FMN GV 16 Berchem TOT
54,Posthofbrug 5366,2022-10-06,23:00:00,57,9,48,FMN GV 16 Berchem TOT
54,Posthofbrug 5366,2022-10-07,00:00:00,28,5,23,FMN GV 16 Berchem TOT
54,Posthofbrug 5366,2022-10-07,01:00:00,20,5,15,FMN GV 16 Berchem TOT
54,Posthofbrug 5366,2022-10-07,02:00:00,5,0,5,FMN GV 16 Berchem TOT
54,Posthofbrug 5366,2022-10-07,03:00:00,5,0,5,FMN GV 16 Berchem TOT
54,Posthofbrug 5366,2022-10-07,04:00:00,6,2,4,FMN GV 16 Berchem TOT
54,Posthofbrug 5366,2022-10-07,05:00:00,15,7,8,FMN GV 16 Berchem TOT
54,Posthofbrug 5366,2022-10-07,06:00:00,25,6,19,FMN GV 16 Berchem TOT
54,Posthofbrug 5366,2022-10-07,07:00:00,110,40,70,FMN GV 16 Berchem TOT
54,Posthofbrug 5366,2022-10-07,08:00:00,178,52,126,FMN GV 16 Berchem TOT
54,Posthofbrug 5366,2022-10-07,09:00:00,78,22,56,FMN GV 16 Berchem TOT
54,Posthofbrug 5366,2022-10-07,10:00:00,53,15,38,FMN GV 16 Berchem TOT
54,Posthofbrug 5366,2022-10-07,11:00:00,57,15,42,FMN GV 16 Berchem TOT
54,Posthofbrug 5366,2022-10-07,12:00:00,97,22,75,FMN GV 16 Berchem TOT
54,Posthofbrug 5366,2022-10-07,13:00:00,100,18,82,FMN GV 16 Berchem TOT
54,Posthofbrug 5366,2022-10-07,14:00:00,91,16,75,FMN GV 16 Berchem TOT
54,Posthofbrug 5366,2022-10-07,15:00:00,148,22,126,FMN GV 16 Berchem TOT
54,Posthofbrug 5366,2022-10-07,16:00:00,217,25,192,FMN GV 16 Berchem TOT
54,Posthofbrug 5366,2022-10-07,17:00:00,253,34,219,FMN GV 16 Berchem TOT
54,Posthofbrug 5366,2022-10-07,18:00:00,167,20,147,FMN GV 16 Berchem TOT
54,Posthofbrug 5366,2022-10-07,19:00:00,95,23,72,FMN GV 16 Berchem TOT
54,Posthofbrug 5366,2022-10-07,20:00:00,47,12,35,FMN GV 16 Berchem TOT
54,Posthofbrug 5366,2022-10-07,21:00:00,40,11,29,FMN GV 16 Berchem TOT
54,Posthofbrug 5366,2022-10-07,22:00:00,44,7,37,FMN GV 16 Berchem TOT
54,Posthofbrug 5366,2022-10-07,23:00:00,38,4,34,FMN GV 16 Berchem TOT
54,Posthofbrug 5366,2022-10-08,00:00:00,38,6,32,FMN GV 16 Berchem TOT
54,Posthofbrug 5366,2022-10-08,01:00:00,27,2,25,FMN GV 16 Berchem TOT
54,Posthofbrug 5366,2022-10-08,02:00:00,16,0,16,FMN GV 16 Berchem TOT
54,Posthofbrug 5366,2022-10-08,03:00:00,13,2,11,FMN GV 16 Berchem TOT
54,Posthofbrug 5366,2022-10-08,04:00:00,9,2,7,FMN GV 16 Berchem TOT
54,Posthofbrug 5366,2022-10-08,05:00:00,9,3,6,FMN GV 16 Berchem TOT
54,Posthofbrug 5366,2022-10-08,06:00:00,10,3,7,FMN GV 16 Berchem TOT
54,Posthofbrug 5366,2022-10-08,07:00:00,16,6,10,FMN GV 16 Berchem TOT
54,Posthofbrug 5366,2022-10-08,08:00:00,30,6,24,FMN GV 16 Berchem TOT
54,Posthofbrug 5366,2022-10-08,09:00:00,51,17,34,FMN GV 16 Berchem TOT
54,Posthofbrug 5366,2022-10-08,10:00:00,65,20,45,FMN GV 16 Berchem TOT
54,Posthofbrug 5366,2022-10-08,11:00:00,74,22,52,FMN GV 16 Berchem TOT
54,Posthofbrug 5366,2022-10-08,12:00:00,82,23,59,FMN GV 16 Berchem TOT
54,Posthofbrug 5366,2022-10-08,13:00:00,92,24,68,FMN GV 16 Berchem TOT
54,Posthofbrug 5366,2022-10-08,14:00:00,102,25,77,FMN GV 16 Berchem TOT
54,Posthofbrug 5366,2022-10-08,15:00:00,99,23,76,FMN GV 16 Berchem TOT
54,Posthofbrug 5366,2022-10-08,16:00:00,101,19,82,FMN GV 16 Berchem TOT
54,Posthofbrug 5366,2022-10-08,17:00:00,101,19,82,FMN GV 16 Berchem TOT
54,Posthofbrug 5366,2022-10-08,18:00:00,86,20,66,FMN GV 16 Berchem TOT
54,Posthofbrug 5366,2022-10-08,19:00:00,63,18,45,FMN GV 16 Berchem TOT
54,Posthofbrug 5366,2022-10-08,20:00:00,47,13,34,FMN GV 16 Berchem TOT
54,Posthofbrug 5366,2022-10-08,21:00:00,38,10,28,FMN GV 16 Berchem TOT
54,Posthofbrug 5366,2022-10-08,22:00:00,40,10,30,FMN GV 16 Berchem TOT
54,Posthofbrug 5366,2022-10-08,23:00:00,43,9,34,FMN GV 16 Berchem TOT
54,Posthofbrug 5366,2022-10-09,00:00:00,37,9,28,FMN GV 16 Berchem TOT
54,Posthofbrug 5366,2022-10-09,01:00:00,27,8,19,FMN GV 16 Berchem TOT
54,Posthofbrug 5366,2022-10-09,02:00:00,17,4,13,FMN GV 16 Berchem TOT
54,Posthofbrug 5366,2022-10-09,03:00:00,13,1,12,FMN GV 16 Berchem TOT
54,Posthofbrug 5366,2022-10-09,04:00:00,9,3,6,FMN GV 16 Berchem TOT
54,Posthofbrug 5366,2022-10-09,05:00:00,8,1,7,FMN GV 16 Berchem TOT
54,Posthofbrug 5366,2022-10-09,06:00:00,9,1,8,FMN GV 16 Berchem TOT
54,Posthofbrug 5366,2022-10-09,07:00:00,15,4,11,FMN GV 16 Berchem TOT
54,Posthofbrug 5366,2022-10-09,08:00:00,29,7,22,FMN GV 16 Berchem TOT
54,Posthofbrug 5366,2022-10-09,09:00:00,57,16,41,FMN GV 16 Berchem TOT
54,Posthofbrug 5366,2022-10-09,10:00:00,75,24,51,FMN GV 16 Berchem TOT
54,Posthofbrug 5366,2022-10-09,11:00:00,87,24,63,FMN GV 16 Berchem TOT
54,Posthofbrug 5366,2022-10-09,12:00:00,102,28,74,FMN GV 16 Berchem TOT
54,Posthofbrug 5366,2022-10-09,13:00:00,106,27,79,FMN GV 16 Berchem TOT
54,Posthofbrug 5366,2022-10-09,14:00:00,116,26,90,FMN GV 16 Berchem TOT
54,Posthofbrug 5366,2022-10-09,15:00:00,113,23,90,FMN GV 16 Berchem TOT
54,Posthofbrug 5366,2022-10-09,16:00:00,114,23,91,FMN GV 16 Berchem TOT
54,Posthofbrug 5366,2022-10-09,17:00:00,111,19,92,FMN GV 16 Berchem TOT
54,Posthofbrug 5366,2022-10-09,18:00:00,88,21,67,FMN GV 16 Berchem TOT
54,Posthofbrug 5366,2022-10-09,19:00:00,62,13,49,FMN GV 16 Berchem TOT
54,Posthofbrug 5366,2022-10-09,20:00:00,50,14,36,FMN GV 16 Berchem TOT
54,Posthofbrug 5366,2022-10-09,21:00:00,42,11,31,FMN GV 16 Berchem TOT
54,Posthofbrug 5366,2022-10-09,22:00:00,36,11,25,FMN GV 16 Berchem TOT
54,Posthofbrug 5366,2022-10-09,23:00:00,23,4,19,FMN GV 16 Berchem TOT
54,Posthofbrug 5366,2022-10-10,00:00:00,8,1,7,FMN GV 16 Berchem TOT
54,Posthofbrug 5366,2022-10-10,01:00:00,5,0,5,FMN GV 16 Berchem TOT
54,Posthofbrug 5366,2022-10-10,02:00:00,3,0,3,FMN GV 16 Berchem TOT
54,Posthofbrug 5366,2022-10-10,03:00:00,1,0,1,FMN GV 16 Berchem TOT
54,Posthofbrug 5366,2022-10-10,04:00:00,4,2,2,FMN GV 16 Berchem TOT
54,Posthofbrug 5366,2022-10-10,05:00:00,8,3,5,FMN GV 16 Berchem TOT
54,Posthofbrug 5366,2022-10-10,06:00:00,27,13,14,FMN GV 16 Berchem TOT
54,Posthofbrug 5366,2022-10-10,07:00:00,101,35,66,FMN GV 16 Berchem TOT
54,Posthofbrug 5366,2022-10-10,08:00:00,177,61,116,FMN GV 16 Berchem TOT
54,Posthofbrug 5366,2022-10-10,09:00:00,69,21,48,FMN GV 16 Berchem TOT
54,Posthofbrug 5366,2022-10-10,10:00:00,42,12,30,FMN GV 16 Berchem TOT
54,Posthofbrug 5366,2022-10-10,11:00:00,46,12,34,FMN GV 16 Berchem TOT
54,Posthofbrug 5366,2022-10-10,12:00:00,68,14,54,FMN GV 16 Berchem TOT
54,Posthofbrug 5366,2022-10-10,13:00:00,67,12,55,FMN GV 16 Berchem TOT
54,Posthofbrug 5366,2022-10-10,14:00:00,71,12,59,FMN GV 16 Berchem TOT
54,Posthofbrug 5366,2022-10-10,15:00:00,118,16,102,FMN GV 16 Berchem TOT
54,Posthofbrug 5366,2022-10-10,16:00:00,209,27,182,FMN GV 16 Berchem TOT
54,Posthofbrug 5366,2022-10-10,17:00:00,273,31,242,FMN GV 16 Berchem TOT
54,Posthofbrug 5366,2022-10-10,18:00:00,179,20,159,FMN GV 16 Berchem TOT
54,Posthofbrug 5366,2022-10-10,19:00:00,82,13,69,FMN GV 16 Berchem TOT
54,Posthofbrug 5366,2022-10-10,20:00:00,48,9,39,FMN GV 16 Berchem TOT
54,Posthofbrug 5366,2022-10-10,21:00:00,39,10,29,FMN GV 16 Berchem TOT
54,Posthofbrug 5366,2022-10-10,22:00:00,37,6,31,FMN GV 16 Berchem TOT
54,Posthofbrug 5366,2022-10-10,23:00:00,21,6,15,FMN GV 16 Berchem TOT
54,Posthofbrug 5366,2022-10-11,00:00:00,12,1,11,FMN GV 16 Berchem TOT
54,Posthofbrug 5366,2022-10-11,01:00:00,7,0,7,FMN GV 16 Berchem TOT
54,Posthofbrug 5366,2022-10-11,02:00:00,3,0,3,FMN GV 16 Berchem TOT
54,Posthofbrug 5366,2022-10-11,03:00:00,3,2,1,FMN GV 16 Berchem TOT
54,Posthofbrug 5366,2022-10-11,04:00:00,4,1,3,FMN GV 16 Berchem TOT
54,Posthofbrug 5366,2022-10-11,05:00:00,13,5,8,FMN GV 16 Berchem TOT
54,Posthofbrug 5366,2022-10-11,06:00:00,36,15,21,FMN GV 16 Berchem TOT
54,Posthofbrug 5366,2022-10-11,07:00:00,137,46,91,FMN GV 16 Berchem TOT
54,Posthofbrug 5366,2022-10-11,08:00:00,229,82,147,FMN GV 16 Berchem TOT
54,Posthofbrug 5366,2022-10-11,09:00:00,88,33,55,FMN GV 16 Berchem TOT
54,Posthofbrug 5366,2022-10-11,10:00:00,51,14,37,FMN GV 16 Berchem TOT
54,Posthofbrug 5366,2022-10-11,11:00:00,57,13,44,FMN GV 16 Berchem TOT
54,Posthofbrug 5366,2022-10-11,12:00:00,80,16,64,FMN GV 16 Berchem TOT
54,Posthofbrug 5366,2022-10-11,13:00:00,81,16,65,FMN GV 16 Berchem TOT
54,Posthofbrug 5366,2022-10-11,14:00:00,83,16,67,FMN GV 16 Berchem TOT
54,Posthofbrug 5366,2022-10-11,15:00:00,141,18,123,FMN GV 16 Berchem TOT
54,Posthofbrug 5366,2022-10-11,16:00:00,256,32,224,FMN GV 16 Berchem TOT
54,Posthofbrug 5366,2022-10-11,17:00:00,334,40,294,FMN GV 16 Berchem TOT
54,Posthofbrug 5366,2022-10-11,18:00:00,221,28,193,FMN GV 16 Berchem TOT
54,Posthofbrug 5366,2022-10-11,19:00:00,105,15,90,FMN GV 16 Berchem TOT
54,Posthofbrug 5366,2022-10-11,20:00:00,65,15,50,FMN GV 16 Berchem TOT
54,Posthofbrug 5366,2022-10-11,21:00:00,54,12,42,FMN GV 16 Berchem TOT
54,Posthofbrug 5366,2022-10-11,22:00:00,53,12,41,FMN GV 16 Berchem TOT
54,Posthofbrug 5366,2022-10-11,23:00:00,34,9,25,FMN GV 16 Berchem TOT
54,Posthofbrug 5366,2022-10-12,00:00:00,15,0,15,FMN GV 16 Berchem TOT
54,Posthofbrug 5366,2022-10-12,01:00:00,7,1,6,FMN GV 16 Berchem TOT
54,Posthofbrug 5366,2022-10-12,02:00:00,4,0,4,FMN GV 16 Berchem TOT
54,Posthofbrug 5366,2022-10-12,03:00:00,2,1,1,FMN GV 16 Berchem TOT
54,Posthofbrug 5366,2022-10-12,04:00:00,5,0,5,FMN GV 16 Berchem TOT
54,Posthofbrug 5366,2022-10-12,05:00:00,10,2,8,FMN GV 16 Berchem TOT
54,Posthofbrug 5366,2022-10-12,06:00:00,31,13,18,FMN GV 16 Berchem TOT
54,Posthofbrug 5366,2022-10-12,07:00:00,115,37,78,FMN GV 16 Berchem TOT
54,Posthofbrug 5366,2022-10-12,08:00:00,187,62,125,FMN GV 16 Berchem TOT
54,Posthofbrug 5366,2022-10-12,09:00:00,80,25,55,FMN GV 16 Berchem TOT
54,Posthofbrug 5366,2022-10-12,10:00:00,50,16,34,FMN GV 16 Berchem TOT
54,Posthofbrug 5366,2022-10-12,11:00:00,64,12,52,FMN GV 16 Berchem TOT
54,Posthofbrug 5366,2022-10-12,12:00:00,121,20,101,FMN GV 16 Berchem TOT
54,Posthofbrug 5366,2022-10-12,13:00:00,99,17,82,FMN GV 16 Berchem TOT
54,Posthofbrug 5366,2022-10-12,14:00:00,88,14,74,FMN GV 16 Berchem TOT
54,Posthofbrug 5366,2022-10-12,15:00:00,112,14,98,FMN GV 16 Berchem TOT
54,Posthofbrug 5366,2022-10-12,16:00:00,192,27,165,FMN GV 16 Berchem TOT
54,Posthofbrug 5366,2022-10-12,17:00:00,273,33,240,FMN GV 16 Berchem TOT
54,Posthofbrug 5366,2022-10-12,18:00:00,189,22,167,FMN GV 16 Berchem TOT
54,Posthofbrug 5366,2022-10-12,19:00:00,92,13,79,FMN GV 16 Berchem TOT
54,Posthofbrug 5366,2022-10-12,20:00:00,56,12,44,FMN GV 16 Berchem TOT
54,Posthofbrug 5366,2022-10-12,21:00:00,45,9,36,FMN GV 16 Berchem TOT
54,Posthofbrug 5366,2022-10-12,22:00:00,50,5,45,FMN GV 16 Berchem TOT
54,Posthofbrug 5366,2022-10-12,23:00:00,34,6,28,FMN GV 16 Berchem TOT
54,Posthofbrug 5366,2022-10-13,00:00:00,15,1,14,FMN GV 16 Berchem TOT
54,Posthofbrug 5366,2022-10-13,01:00:00,7,0,7,FMN GV 16 Berchem TOT
54,Posthofbrug 5366,2022-10-13,02:00:00,2,0,2,FMN GV 16 Berchem TOT
54,Posthofbrug 5366,2022-10-13,03:00:00,5,0,5,FMN GV 16 Berchem TOT
54,Posthofbrug 5366,2022-10-13,04:00:00,8,3,5,FMN GV 16 Berchem TOT
54,Posthofbrug 5366,2022-10-13,05:00:00,14,5,9,FMN GV 16 Berchem TOT
54,Posthofbrug 5366,2022-10-13,06:00:00,28,6,22,FMN GV 16 Berchem TOT
54,Posthofbrug 5366,2022-10-13,07:00:00,93,30,63,FMN GV 16 Berchem TOT
54,Posthofbrug 5366,2022-10-13,08:00:00,154,52,102,FMN GV 16 Berchem TOT
54,Posthofbrug 5366,2022-10-13,09:00:00,65,19,46,FMN GV 16 Berchem TOT
54,Posthofbrug 5366,2022-10-13,10:00:00,32,9,23,FMN GV 16 Berchem TOT
54,Posthofbrug 5366,2022-10-13,11:00:00,53,15,38,FMN GV 16 Berchem TOT
54,Posthofbrug 5366,2022-10-13,12:00:00,64,8,56,FMN GV 16 Berchem TOT
54,Posthofbrug 5366,2022-10-13,13:00:00,69,12,57,FMN GV 16 Berchem TOT
54,Posthofbrug 5366,2022-10-13,14:00:00,75,17,58,FMN GV 16 Berchem TOT
54,Posthofbrug 5366,2022-10-13,15:00:00,104,15,89,FMN GV 16 Berchem TOT
54,Posthofbrug 5366,2022-10-13,16:00:00,195,27,168,FMN GV 16 Berchem TOT
54,Posthofbrug 5366,2022-10-13,17:00:00,242,30,212,FMN GV 16 Berchem TOT
54,Posthofbrug 5366,2022-10-13,18:00:00,161,20,141,FMN GV 16 Berchem TOT
54,Posthofbrug 5366,2022-10-13,19:00:00,83,15,68,FMN GV 16 Berchem TOT
54,Posthofbrug 5366,2022-10-13,20:00:00,53,11,42,FMN GV 16 Berchem TOT
54,Posthofbrug 5366,2022-10-13,21:00:00,41,11,30,FMN GV 16 Berchem TOT
54,Posthofbrug 5366,2022-10-13,22:00:00,46,6,40,FMN GV 16 Berchem TOT
54,Posthofbrug 5366,2022-10-13,23:00:00,39,9,30,FMN GV 16 Berchem TOT
54,Posthofbrug 5366,2022-10-14,00:00:00,36,11,25,FMN GV 16 Berchem TOT
54,Posthofbrug 5366,2022-10-14,01:00:00,21,0,21,FMN GV 16 Berchem TOT
54,Posthofbrug 5366,2022-10-14,02:00:00,18,0,18,FMN GV 16 Berchem TOT
54,Posthofbrug 5366,2022-10-14,03:00:00,13,2,11,FMN GV 16 Berchem TOT
54,Posthofbrug 5366,2022-10-14,04:00:00,13,4,9,FMN GV 16 Berchem TOT
54,Posthofbrug 5366,2022-10-14,05:00:00,35,27,8,FMN GV 16 Berchem TOT
54,Posthofbrug 5366,2022-10-14,06:00:00,121,92,29,FMN GV 16 Berchem TOT
54,Posthofbrug 5366,2022-10-14,07:00:00,374,305,69,FMN GV 16 Berchem TOT
54,Posthofbrug 5366,2022-10-14,08:00:00,742,585,157,FMN GV 16 Berchem TOT
54,Posthofbrug 5366,2022-10-14,09:00:00,195,156,39,FMN GV 16 Berchem TOT
54,Posthofbrug 5366,2022-10-14,10:00:00,119,78,41,FMN GV 16 Berchem TOT
54,Posthofbrug 5366,2022-10-14,11:00:00,112,63,49,FMN GV 16 Berchem TOT
54,Posthofbrug 5366,2022-10-14,12:00:00,167,80,87,FMN GV 16 Berchem TOT
54,Posthofbrug 5366,2022-10-14,13:00:00,163,74,89,FMN GV 16 Berchem TOT
54,Posthofbrug 5366,2022-10-14,14:00:00,163,77,86,FMN GV 16 Berchem TOT
54,Posthofbrug 5366,2022-10-14,15:00:00,298,94,204,FMN GV 16 Berchem TOT
54,Posthofbrug 5366,2022-10-14,16:00:00,423,148,275,FMN GV 16 Berchem TOT
54,Posthofbrug 5366,2022-10-14,17:00:00,504,157,347,FMN GV 16 Berchem TOT
54,Posthofbrug 5366,2022-10-14,18:00:00,306,121,185,FMN GV 16 Berchem TOT
54,Posthofbrug 5366,2022-10-14,19:00:00,212,110,102,FMN GV 16 Berchem TOT
54,Posthofbrug 5366,2022-10-14,20:00:00,128,69,59,FMN GV 16 Berchem TOT
54,Posthofbrug 5366,2022-10-14,21:00:00,82,37,45,FMN GV 16 Berchem TOT
54,Posthofbrug 5366,2022-10-14,22:00:00,93,26,67,FMN GV 16 Berchem TOT
54,Posthofbrug 5366,2022-10-14,23:00:00,81,18,63,FMN GV 16 Berchem TOT
54,Posthofbrug 5366,2022-10-15,00:00:00,79,29,50,FMN GV 16 Berchem TOT
54,Posthofbrug 5366,2022-10-15,01:00:00,57,9,48,FMN GV 16 Berchem TOT
54,Posthofbrug 5366,2022-10-15,02:00:00,24,3,21,FMN GV 16 Berchem TOT
54,Posthofbrug 5366,2022-10-15,03:00:00,31,5,26,FMN GV 16 Berchem TOT
54,Posthofbrug 5366,2022-10-15,04:00:00,20,2,18,FMN GV 16 Berchem TOT
54,Posthofbrug 5366,2022-10-15,05:00:00,26,7,19,FMN GV 16 Berchem TOT
54,Posthofbrug 5366,2022-10-15,06:00:00,25,13,12,FMN GV 16 Berchem TOT
54,Posthofbrug 5366,2022-10-15,07:00:00,33,20,13,FMN GV 16 Berchem TOT
54,Posthofbrug 5366,2022-10-15,08:00:00,69,39,30,FMN GV 16 Berchem TOT
54,Posthofbrug 5366,2022-10-15,09:00:00,145,89,56,FMN GV 16 Berchem TOT
54,Posthofbrug 5366,2022-10-15,10:00:00,131,91,40,FMN GV 16 Berchem TOT
54,Posthofbrug 5366,2022-10-15,11:00:00,145,93,52,FMN GV 16 Berchem TOT
54,Posthofbrug 5366,2022-10-15,12:00:00,116,69,47,FMN GV 16 Berchem TOT
54,Posthofbrug 5366,2022-10-15,13:00:00,130,75,55,FMN GV 16 Berchem TOT
54,Posthofbrug 5366,2022-10-15,14:00:00,192,110,82,FMN GV 16 Berchem TOT
54,Posthofbrug 5366,2022-10-15,15:00:00,172,93,79,FMN GV 16 Berchem TOT
54,Posthofbrug 5366,2022-10-15,16:00:00,172,77,95,FMN GV 16 Berchem TOT
54,Posthofbrug 5366,2022-10-15,17:00:00,189,88,101,FMN GV 16 Berchem TOT
54,Posthofbrug 5366,2022-10-15,18:00:00,180,90,90,FMN GV 16 Berchem TOT
54,Posthofbrug 5366,2022-10-15,19:00:00,158,89,69,FMN GV 16 Berchem TOT
54,Posthofbrug 5366,2022-10-15,20:00:00,96,53,43,FMN GV 16 Berchem TOT
54,Posthofbrug 5366,2022-10-15,21:00:00,78,35,43,FMN GV 16 Berchem TOT
54,Posthofbrug 5366,2022-10-15,22:00:00,69,35,34,FMN GV 16 Berchem TOT
54,Posthofbrug 5366,2022-10-15,23:00:00,101,28,73,FMN GV 16 Berchem TOT
54,Posthofbrug 5366,2022-10-16,00:00:00,78,24,54,FMN GV 16 Berchem TOT
54,Posthofbrug 5366,2022-10-16,01:00:00,50,16,34,FMN GV 16 Berchem TOT
54,Posthofbrug 5366,2022-10-16,02:00:00,31,12,19,FMN GV 16 Berchem TOT
54,Posthofbrug 5366,2022-10-16,03:00:00,20,7,13,FMN GV 16 Berchem TOT
54,Posthofbrug 5366,2022-10-16,04:00:00,10,1,9,FMN GV 16 Berchem TOT
54,Posthofbrug 5366,2022-10-16,05:00:00,18,5,13,FMN GV 16 Berchem TOT
54,Posthofbrug 5366,2022-10-16,06:00:00,20,13,7,FMN GV 16 Berchem TOT
54,Posthofbrug 5366,2022-10-16,07:00:00,33,19,14,FMN GV 16 Berchem TOT
54,Posthofbrug 5366,2022-10-16,08:00:00,53,36,17,FMN GV 16 Berchem TOT
54,Posthofbrug 5366,2022-10-16,09:00:00,99,66,33,FMN GV 16 Berchem TOT
54,Posthofbrug 5366,2022-10-16,10:00:00,152,88,64,FMN GV 16 Berchem TOT
54,Posthofbrug 5366,2022-10-16,11:00:00,170,104,66,FMN GV 16 Berchem TOT
54,Posthofbrug 5366,2022-10-16,12:00:00,198,117,81,FMN GV 16 Berchem TOT
54,Posthofbrug 5366,2022-10-16,13:00:00,225,140,85,FMN GV 16 Berchem TOT
54,Posthofbrug 5366,2022-10-16,14:00:00,228,141,87,FMN GV 16 Berchem TOT
54,Posthofbrug 5366,2022-10-16,15:00:00,215,109,106,FMN GV 16 Berchem TOT
54,Posthofbrug 5366,2022-10-16,16:00:00,165,68,97,FMN GV 16 Berchem TOT
54,Posthofbrug 5366,2022-10-16,17:00:00,204,77,127,FMN GV 16 Berchem TOT
54,Posthofbrug 5366,2022-10-16,18:00:00,157,78,79,FMN GV 16 Berchem TOT
54,Posthofbrug 5366,2022-10-16,19:00:00,145,58,87,FMN GV 16 Berchem TOT
54,Posthofbrug 5366,2022-10-16,20:00:00,67,33,34,FMN GV 16 Berchem TOT
54,Posthofbrug 5366,2022-10-16,21:00:00,71,28,43,FMN GV 16 Berchem TOT
54,Posthofbrug 5366,2022-10-16,22:00:00,56,21,35,FMN GV 16 Berchem TOT
54,Posthofbrug 5366,2022-10-16,23:00:00,26,7,19,FMN GV 16 Berchem TOT
54,Posthofbrug 5366,2022-10-17,00:00:00,11,2,9,FMN GV 16 Berchem TOT
54,Posthofbrug 5366,2022-10-17,01:00:00,2,0,2,FMN GV 16 Berchem TOT
54,Posthofbrug 5366,2022-10-17,02:00:00,5,1,4,FMN GV 16 Berchem TOT
54,Posthofbrug 5366,2022-10-17,03:00:00,2,0,2,FMN GV 16 Berchem TOT
54,Posthofbrug 5366,2022-10-17,04:00:00,6,4,2,FMN GV 16 Berchem TOT
54,Posthofbrug 5366,2022-10-17,05:00:00,33,25,8,FMN GV 16 Berchem TOT
54,Posthofbrug 5366,2022-10-17,06:00:00,130,100,30,FMN GV 16 Berchem TOT
54,Posthofbrug 5366,2022-10-17,07:00:00,464,355,109,FMN GV 16 Berchem TOT
54,Posthofbrug 5366,2022-10-17,08:00:00,843,667,176,FMN GV 16 Berchem TOT
54,Posthofbrug 5366,2022-10-17,09:00:00,196,143,53,FMN GV 16 Berchem TOT
54,Posthofbrug 5366,2022-10-17,10:00:00,93,59,34,FMN GV 16 Berchem TOT
54,Posthofbrug 5366,2022-10-17,11:00:00,87,53,34,FMN GV 16 Berchem TOT
54,Posthofbrug 5366,2022-10-17,12:00:00,149,73,76,FMN GV 16 Berchem TOT
54,Posthofbrug 5366,2022-10-17,13:00:00,135,70,65,FMN GV 16 Berchem TOT
54,Posthofbrug 5366,2022-10-17,14:00:00,134,59,75,FMN GV 16 Berchem TOT
54,Posthofbrug 5366,2022-10-17,15:00:00,252,93,159,FMN GV 16 Berchem TOT
54,Posthofbrug 5366,2022-10-17,16:00:00,435,135,300,FMN GV 16 Berchem TOT
54,Posthofbrug 5366,2022-10-17,17:00:00,644,189,455,FMN GV 16 Berchem TOT
54,Posthofbrug 5366,2022-10-17,18:00:00,397,126,271,FMN GV 16 Berchem TOT
54,Posthofbrug 5366,2022-10-17,19:00:00,183,77,106,FMN GV 16 Berchem TOT
54,Posthofbrug 5366,2022-10-17,20:00:00,115,47,68,FMN GV 16 Berchem TOT
54,Posthofbrug 5366,2022-10-17,21:00:00,107,45,62,FMN GV 16 Berchem TOT
54,Posthofbrug 5366,2022-10-17,22:00:00,89,32,57,FMN GV 16 Berchem TOT
54,Posthofbrug 5366,2022-10-17,23:00:00,36,7,29,FMN GV 16 Berchem TOT
54,Posthofbrug 5366,2022-10-18,00:00:00,26,5,21,FMN GV 16 Berchem TOT
54,Posthofbrug 5366,2022-10-18,01:00:00,8,3,5,FMN GV 16 Berchem TOT
54,Posthofbrug 5366,2022-10-18,02:00:00,6,2,4,FMN GV 16 Berchem TOT
54,Posthofbrug 5366,2022-10-18,03:00:00,1,0,1,FMN GV 16 Berchem TOT
54,Posthofbrug 5366,2022-10-18,04:00:00,11,4,7,FMN GV 16 Berchem TOT
54,Posthofbrug 5366,2022-10-18,05:00:00,43,35,8,FMN GV 16 Berchem TOT
54,Posthofbrug 5366,2022-10-18,06:00:00,142,110,32,FMN GV 16 Berchem TOT
54,Posthofbrug 5366,2022-10-18,07:00:00,562,430,132,FMN GV 16 Berchem TOT
54,Posthofbrug 5366,2022-10-18,08:00:00,950,739,211,FMN GV 16 Berchem TOT
54,Posthofbrug 5366,2022-10-18,09:00:00,358,270,88,FMN GV 16 Berchem TOT
54,Posthofbrug 5366,2022-10-18,10:00:00,176,128,48,FMN GV 16 Berchem TOT
54,Posthofbrug 5366,2022-10-18,11:00:00,156,103,53,FMN GV 16 Berchem TOT
54,Posthofbrug 5366,2022-10-18,12:00:00,226,120,106,FMN GV 16 Berchem TOT
54,Posthofbrug 5366,2022-10-18,13:00:00,231,114,117,FMN GV 16 Berchem TOT
54,Posthofbrug 5366,2022-10-18,14:00:00,216,111,105,FMN GV 16 Berchem TOT
54,Posthofbrug 5366,2022-10-18,15:00:00,356,130,226,FMN GV 16 Berchem TOT
54,Posthofbrug 5366,2022-10-18,16:00:00,581,176,405,FMN GV 16 Berchem TOT
54,Posthofbrug 5366,2022-10-18,17:00:00,812,243,569,FMN GV 16 Berchem TOT
54,Posthofbrug 5366,2022-10-18,18:00:00,502,152,350,FMN GV 16 Berchem TOT
54,Posthofbrug 5366,2022-10-18,19:00:00,252,115,137,FMN GV 16 Berchem TOT
54,Posthofbrug 5366,2022-10-18,20:00:00,155,67,88,FMN GV 16 Berchem TOT
54,Posthofbrug 5366,2022-10-18,21:00:00,118,53,65,FMN GV 16 Berchem TOT
54,Posthofbrug 5366,2022-10-18,22:00:00,122,42,80,FMN GV 16 Berchem TOT
54,Posthofbrug 5366,2022-10-18,23:00:00,71,14,57,FMN GV 16 Berchem TOT
54,Posthofbrug 5366,2022-10-19,00:00:00,31,9,22,FMN GV 16 Berchem TOT
54,Posthofbrug 5366,2022-10-19,01:00:00,9,2,7,FMN GV 16 Berchem TOT
54,Posthofbrug 5366,2022-10-19,02:00:00,10,0,10,FMN GV 16 Berchem TOT
54,Posthofbrug 5366,2022-10-19,03:00:00,7,2,5,FMN GV 16 Berchem TOT
54,Posthofbrug 5366,2022-10-19,04:00:00,14,6,8,FMN GV 16 Berchem TOT
54,Posthofbrug 5366,2022-10-19,05:00:00,42,32,10,FMN GV 16 Berchem TOT
54,Posthofbrug 5366,2022-10-19,06:00:00,146,111,35,FMN GV 16 Berchem TOT
54,Posthofbrug 5366,2022-10-19,07:00:00,455,343,112,FMN GV 16 Berchem TOT
54,Posthofbrug 5366,2022-10-19,08:00:00,853,664,189,FMN GV 16 Berchem TOT
54,Posthofbrug 5366,2022-10-19,09:00:00,287,213,74,FMN GV 16 Berchem TOT
54,Posthofbrug 5366,2022-10-19,10:00:00,174,122,52,FMN GV 16 Berchem TOT
54,Posthofbrug 5366,2022-10-19,11:00:00,164,87,77,FMN GV 16 Berchem TOT
54,Posthofbrug 5366,2022-10-19,12:00:00,372,168,204,FMN GV 16 Berchem TOT
54,Posthofbrug 5366,2022-10-19,13:00:00,249,117,132,FMN GV 16 Berchem TOT
54,Posthofbrug 5366,2022-10-19,14:00:00,233,111,122,FMN GV 16 Berchem TOT
54,Posthofbrug 5366,2022-10-19,15:00:00,251,87,164,FMN GV 16 Berchem TOT
54,Posthofbrug 5366,2022-10-19,16:00:00,435,169,266,FMN GV 16 Berchem TOT
54,Posthofbrug 5366,2022-10-19,17:00:00,661,208,453,FMN GV 16 Berchem TOT
54,Posthofbrug 5366,2022-10-19,18:00:00,427,162,265,FMN GV 16 Berchem TOT
54,Posthofbrug 5366,2022-10-19,19:00:00,254,115,139,FMN GV 16 Berchem TOT
54,Posthofbrug 5366,2022-10-19,20:00:00,142,71,71,FMN GV 16 Berchem TOT
54,Posthofbrug 5366,2022-10-19,21:00:00,111,47,64,FMN GV 16 Berchem TOT
54,Posthofbrug 5366,2022-10-19,22:00:00,128,35,93,FMN GV 16 Berchem TOT
54,Posthofbrug 5366,2022-10-19,23:00:00,91,16,75,FMN GV 16 Berchem TOT
54,Posthofbrug 5366,2022-10-20,00:00:00,33,10,23,FMN GV 16 Berchem TOT
54,Posthofbrug 5366,2022-10-20,01:00:00,15,1,14,FMN GV 16 Berchem TOT
54,Posthofbrug 5366,2022-10-20,02:00:00,12,2,10,FMN GV 16 Berchem TOT
54,Posthofbrug 5366,2022-10-20,03:00:00,4,2,2,FMN GV 16 Berchem TOT
54,Posthofbrug 5366,2022-10-20,04:00:00,5,4,1,FMN GV 16 Berchem TOT
54,Posthofbrug 5366,2022-10-20,05:00:00,40,32,8,FMN GV 16 Berchem TOT
54,Posthofbrug 5366,2022-10-20,06:00:00,136,98,38,FMN GV 16 Berchem TOT
54,Posthofbrug 5366,2022-10-20,07:00:00,479,382,97,FMN GV 16 Berchem TOT
54,Posthofbrug 5366,2022-10-20,08:00:00,974,752,222,FMN GV 16 Berchem TOT
54,Posthofbrug 5366,2022-10-20,09:00:00,309,237,72,FMN GV 16 Berchem TOT
54,Posthofbrug 5366,2022-10-20,10:00:00,158,102,56,FMN GV 16 Berchem TOT
54,Posthofbrug 5366,2022-10-20,11:00:00,87,40,47,FMN GV 16 Berchem TOT
54,Posthofbrug 5366,2022-10-20,12:00:00,172,90,82,FMN GV 16 Berchem TOT
54,Posthofbrug 5366,2022-10-20,13:00:00,173,77,96,FMN GV 16 Berchem TOT
54,Posthofbrug 5366,2022-10-20,14:00:00,142,54,88,FMN GV 16 Berchem TOT
54,Posthofbrug 5366,2022-10-20,15:00:00,239,92,147,FMN GV 16 Berchem TOT
54,Posthofbrug 5366,2022-10-20,16:00:00,521,153,368,FMN GV 16 Berchem TOT
54,Posthofbrug 5366,2022-10-20,17:00:00,727,233,494,FMN GV 16 Berchem TOT
54,Posthofbrug 5366,2022-10-20,18:00:00,424,141,283,FMN GV 16 Berchem TOT
54,Posthofbrug 5366,2022-10-20,19:00:00,259,114,145,FMN GV 16 Berchem TOT
54,Posthofbrug 5366,2022-10-20,20:00:00,148,77,71,FMN GV 16 Berchem TOT
54,Posthofbrug 5366,2022-10-20,21:00:00,143,59,84,FMN GV 16 Berchem TOT
54,Posthofbrug 5366,2022-10-20,22:00:00,136,44,92,FMN GV 16 Berchem TOT
54,Posthofbrug 5366,2022-10-20,23:00:00,83,18,65,FMN GV 16 Berchem TOT
54,Posthofbrug 5366,2022-10-21,00:00:00,0,0,0,FMN GV 16 Berchem TOT
54,Posthofbrug 5366,2022-10-21,01:00:00,19,2,17,FMN GV 16 Berchem TOT
54,Posthofbrug 5366,2022-10-21,02:00:00,15,0,15,FMN GV 16 Berchem TOT
54,Posthofbrug 5366,2022-10-21,03:00:00,12,0,12,FMN GV 16 Berchem TOT
54,Posthofbrug 5366,2022-10-21,04:00:00,16,9,7,FMN GV 16 Berchem TOT
54,Posthofbrug 5366,2022-10-21,05:00:00,56,31,25,FMN GV 16 Berchem TOT
54,Posthofbrug 5366,2022-10-21,06:00:00,170,140,30,FMN GV 16 Berchem TOT
54,Posthofbrug 5366,2022-10-21,07:00:00,423,334,89,FMN GV 16 Berchem TOT
54,Posthofbrug 5366,2022-10-21,08:00:00,742,566,176,FMN GV 16 Berchem TOT
54,Posthofbrug 5366,2022-10-21,09:00:00,258,205,53,FMN GV 16 Berchem TOT
54,Posthofbrug 5366,2022-10-21,10:00:00,168,105,63,FMN GV 16 Berchem TOT
54,Posthofbrug 5366,2022-10-21,11:00:00,139,92,47,FMN GV 16 Berchem TOT
54,Posthofbrug 5366,2022-10-21,12:00:00,226,122,104,FMN GV 16 Berchem TOT
54,Posthofbrug 5366,2022-10-21,13:00:00,221,109,112,FMN GV 16 Berchem TOT
54,Posthofbrug 5366,2022-10-21,14:00:00,227,95,132,FMN GV 16 Berchem TOT
54,Posthofbrug 5366,2022-10-21,15:00:00,317,115,202,FMN GV 16 Berchem TOT
54,Posthofbrug 5366,2022-10-21,16:00:00,486,150,336,FMN GV 16 Berchem TOT
54,Posthofbrug 5366,2022-10-21,17:00:00,566,180,386,FMN GV 16 Berchem TOT
54,Posthofbrug 5366,2022-10-21,18:00:00,394,166,228,FMN GV 16 Berchem TOT
54,Posthofbrug 5366,2022-10-21,19:00:00,257,149,108,FMN GV 16 Berchem TOT
54,Posthofbrug 5366,2022-10-21,20:00:00,144,80,64,FMN GV 16 Berchem TOT
54,Posthofbrug 5366,2022-10-21,21:00:00,105,40,65,FMN GV 16 Berchem TOT
54,Posthofbrug 5366,2022-10-21,22:00:00,119,28,91,FMN GV 16 Berchem TOT
54,Posthofbrug 5366,2022-10-21,23:00:00,98,15,83,FMN GV 16 Berchem TOT
54,Posthofbrug 5366,2022-10-22,00:00:00,0,0,0,FMN GV 16 Berchem TOT
54,Posthofbrug 5366,2022-10-22,01:00:00,64,22,42,FMN GV 16 Berchem TOT
54,Posthofbrug 5366,2022-10-22,02:00:00,31,11,20,FMN GV 16 Berchem TOT
54,Posthofbrug 5366,2022-10-22,03:00:00,31,5,26,FMN GV 16 Berchem TOT
54,Posthofbrug 5366,2022-10-22,04:00:00,33,3,30,FMN GV 16 Berchem TOT
54,Posthofbrug 5366,2022-10-22,05:00:00,25,13,12,FMN GV 16 Berchem TOT
54,Posthofbrug 5366,2022-10-22,06:00:00,22,14,8,FMN GV 16 Berchem TOT
54,Posthofbrug 5366,2022-10-22,07:00:00,43,29,14,FMN GV 16 Berchem TOT
54,Posthofbrug 5366,2022-10-22,08:00:00,106,58,48,FMN GV 16 Berchem TOT
54,Posthofbrug 5366,2022-10-22,09:00:00,153,104,49,FMN GV 16 Berchem TOT
54,Posthofbrug 5366,2022-10-22,10:00:00,150,94,56,FMN GV 16 Berchem TOT
54,Posthofbrug 5366,2022-10-22,11:00:00,195,129,66,FMN GV 16 Berchem TOT
54,Posthofbrug 5366,2022-10-22,12:00:00,205,119,86,FMN GV 16 Berchem TOT
54,Posthofbrug 5366,2022-10-22,13:00:00,241,137,104,FMN GV 16 Berchem TOT
54,Posthofbrug 5366,2022-10-22,14:00:00,225,114,111,FMN GV 16 Berchem TOT
54,Posthofbrug 5366,2022-10-22,15:00:00,202,105,97,FMN GV 16 Berchem TOT
54,Posthofbrug 5366,2022-10-22,16:00:00,218,99,119,FMN GV 16 Berchem TOT
54,Posthofbrug 5366,2022-10-22,17:00:00,211,94,117,FMN GV 16 Berchem TOT
54,Posthofbrug 5366,2022-10-22,18:00:00,187,100,87,FMN GV 16 Berchem TOT
54,Posthofbrug 5366,2022-10-22,19:00:00,172,106,66,FMN GV 16 Berchem TOT
54,Posthofbrug 5366,2022-10-22,20:00:00,81,39,42,FMN GV 16 Berchem TOT
54,Posthofbrug 5366,2022-10-22,21:00:00,113,65,48,FMN GV 16 Berchem TOT
54,Posthofbrug 5366,2022-10-22,22:00:00,94,33,61,FMN GV 16 Berchem TOT
54,Posthofbrug 5366,2022-10-22,23:00:00,80,28,52,FMN GV 16 Berchem TOT
54,Posthofbrug 5366,2022-10-23,00:00:00,0,0,0,FMN GV 16 Berchem TOT
54,Posthofbrug 5366,2022-10-23,01:00:00,44,10,34,FMN GV 16 Berchem TOT
54,Posthofbrug 5366,2022-10-23,02:00:00,35,4,31,FMN GV 16 Berchem TOT
54,Posthofbrug 5366,2022-10-23,03:00:00,26,2,24,FMN GV 16 Berchem TOT
54,Posthofbrug 5366,2022-10-23,04:00:00,23,6,17,FMN GV 16 Berchem TOT
54,Posthofbrug 5366,2022-10-23,05:00:00,11,3,8,FMN GV 16 Berchem TOT
54,Posthofbrug 5366,2022-10-23,06:00:00,25,13,12,FMN GV 16 Berchem TOT
54,Posthofbrug 5366,2022-10-23,07:00:00,28,16,12,FMN GV 16 Berchem TOT
54,Posthofbrug 5366,2022-10-23,08:00:00,63,38,25,FMN GV 16 Berchem TOT
54,Posthofbrug 5366,2022-10-23,09:00:00,110,56,54,FMN GV 16 Berchem TOT
54,Posthofbrug 5366,2022-10-23,10:00:00,140,81,59,FMN GV 16 Berchem TOT
54,Posthofbrug 5366,2022-10-23,11:00:00,145,90,55,FMN GV 16 Berchem TOT
54,Posthofbrug 5366,2022-10-23,12:00:00,190,102,88,FMN GV 16 Berchem TOT
54,Posthofbrug 5366,2022-10-23,13:00:00,199,108,91,FMN GV 16 Berchem TOT
54,Posthofbrug 5366,2022-10-23,14:00:00,194,134,60,FMN GV 16 Berchem TOT
54,Posthofbrug 5366,2022-10-23,15:00:00,185,107,78,FMN GV 16 Berchem TOT
54,Posthofbrug 5366,2022-10-23,16:00:00,151,64,87,FMN GV 16 Berchem TOT
54,Posthofbrug 5366,2022-10-23,17:00:00,209,72,137,FMN GV 16 Berchem TOT
54,Posthofbrug 5366,2022-10-23,18:00:00,154,67,87,FMN GV 16 Berchem TOT
54,Posthofbrug 5366,2022-10-23,19:00:00,101,44,57,FMN GV 16 Berchem TOT
54,Posthofbrug 5366,2022-10-23,20:00:00,61,29,32,FMN GV 16 Berchem TOT
54,Posthofbrug 5366,2022-10-23,21:00:00,75,30,45,FMN GV 16 Berchem TOT
54,Posthofbrug 5366,2022-10-23,22:00:00,52,18,34,FMN GV 16 Berchem TOT
54,Posthofbrug 5366,2022-10-23,23:00:00,30,6,24,FMN GV 16 Berchem TOT
54,Posthofbrug 5366,2022-10-24,00:00:00,0,0,0,FMN GV 16 Berchem TOT
54,Posthofbrug 5366,2022-10-24,01:00:00,7,0,7,FMN GV 16 Berchem TOT
54,Posthofbrug 5366,2022-10-24,02:00:00,6,1,5,FMN GV 16 Berchem TOT
54,Posthofbrug 5366,2022-10-24,03:00:00,3,1,2,FMN GV 16 Berchem TOT
54,Posthofbrug 5366,2022-10-24,04:00:00,11,9,2,FMN GV 16 Berchem TOT
54,Posthofbrug 5366,2022-10-24,05:00:00,33,26,7,FMN GV 16 Berchem TOT
54,Posthofbrug 5366,2022-10-24,06:00:00,135,110,25,FMN GV 16 Berchem TOT
54,Posthofbrug 5366,2022-10-24,07:00:00,451,340,111,FMN GV 16 Berchem TOT
54,Posthofbrug 5366,2022-10-24,08:00:00,865,680,185,FMN GV 16 Berchem TOT
54,Posthofbrug 5366,2022-10-24,09:00:00,303,219,84,FMN GV 16 Berchem TOT
54,Posthofbrug 5366,2022-10-24,10:00:00,134,96,38,FMN GV 16 Berchem TOT
54,Posthofbrug 5366,2022-10-24,11:00:00,130,75,55,FMN GV 16 Berchem TOT
54,Posthofbrug 5366,2022-10-24,12:00:00,182,88,94,FMN GV 16 Berchem TOT
54,Posthofbrug 5366,2022-10-24,13:00:00,165,87,78,FMN GV 16 Berchem TOT
54,Posthofbrug 5366,2022-10-24,14:00:00,152,61,91,FMN GV 16 Berchem TOT
54,Posthofbrug 5366,2022-10-24,15:00:00,233,79,154,FMN GV 16 Berchem TOT
54,Posthofbrug 5366,2022-10-24,16:00:00,446,132,314,FMN GV 16 Berchem TOT
54,Posthofbrug 5366,2022-10-24,17:00:00,675,190,485,FMN GV 16 Berchem TOT
54,Posthofbrug 5366,2022-10-24,18:00:00,411,130,281,FMN GV 16 Berchem TOT
54,Posthofbrug 5366,2022-10-24,19:00:00,172,73,99,FMN GV 16 Berchem TOT
54,Posthofbrug 5366,2022-10-24,20:00:00,109,36,73,FMN GV 16 Berchem TOT
54,Posthofbrug 5366,2022-10-24,21:00:00,78,32,46,FMN GV 16 Berchem TOT
54,Posthofbrug 5366,2022-10-24,22:00:00,78,29,49,FMN GV 16 Berchem TOT
54,Posthofbrug 5366,2022-10-24,23:00:00,35,13,22,FMN GV 16 Berchem TOT
54,Posthofbrug 5366,2022-10-25,00:00:00,0,0,0,FMN GV 16 Berchem TOT
54,Posthofbrug 5366,2022-10-25,01:00:00,11,1,10,FMN GV 16 Berchem TOT
54,Posthofbrug 5366,2022-10-25,02:00:00,8,2,6,FMN GV 16 Berchem TOT
54,Posthofbrug 5366,2022-10-25,03:00:00,3,0,3,FMN GV 16 Berchem TOT
54,Posthofbrug 5366,2022-10-25,04:00:00,14,11,3,FMN GV 16 Berchem TOT
54,Posthofbrug 5366,2022-10-25,05:00:00,43,32,11,FMN GV 16 Berchem TOT
54,Posthofbrug 5366,2022-10-25,06:00:00,152,123,29,FMN GV 16 Berchem TOT
54,Posthofbrug 5366,2022-10-25,07:00:00,549,430,119,FMN GV 16 Berchem TOT
54,Posthofbrug 5366,2022-10-25,08:00:00,966,744,222,FMN GV 16 Berchem TOT
54,Posthofbrug 5366,2022-10-25,09:00:00,354,277,77,FMN GV 16 Berchem TOT
54,Posthofbrug 5366,2022-10-25,10:00:00,169,121,48,FMN GV 16 Berchem TOT
54,Posthofbrug 5366,2022-10-25,11:00:00,155,87,68,FMN GV 16 Berchem TOT
54,Posthofbrug 5366,2022-10-25,12:00:00,216,131,85,FMN GV 16 Berchem TOT
54,Posthofbrug 5366,2022-10-25,13:00:00,219,118,101,FMN GV 16 Berchem TOT
54,Posthofbrug 5366,2022-10-25,14:00:00,190,89,101,FMN GV 16 Berchem TOT
54,Posthofbrug 5366,2022-10-25,15:00:00,341,129,212,FMN GV 16 Berchem TOT
54,Posthofbrug 5366,2022-10-25,16:00:00,559,135,424,FMN GV 16 Berchem TOT
54,Posthofbrug 5366,2022-10-25,17:00:00,754,188,566,FMN GV 16 Berchem TOT
54,Posthofbrug 5366,2022-10-25,18:00:00,512,159,353,FMN GV 16 Berchem TOT
54,Posthofbrug 5366,2022-10-25,19:00:00,244,86,158,FMN GV 16 Berchem TOT
54,Posthofbrug 5366,2022-10-25,20:00:00,170,76,94,FMN GV 16 Berchem TOT
54,Posthofbrug 5366,2022-10-25,21:00:00,143,71,72,FMN GV 16 Berchem TOT
54,Posthofbrug 5366,2022-10-25,22:00:00,117,34,83,FMN GV 16 Berchem TOT
54,Posthofbrug 5366,2022-10-25,23:00:00,79,35,44,FMN GV 16 Berchem TOT
54,Posthofbrug 5366,2022-10-26,00:00:00,0,0,0,FMN GV 16 Berchem TOT
54,Posthofbrug 5366,2022-10-26,01:00:00,16,0,16,FMN GV 16 Berchem TOT
54,Posthofbrug 5366,2022-10-26,02:00:00,6,1,5,FMN GV 16 Berchem TOT
54,Posthofbrug 5366,2022-10-26,03:00:00,4,1,3,FMN GV 16 Berchem TOT
54,Posthofbrug 5366,2022-10-26,04:00:00,20,12,8,FMN GV 16 Berchem TOT
54,Posthofbrug 5366,2022-10-26,05:00:00,46,34,12,FMN GV 16 Berchem TOT
54,Posthofbrug 5366,2022-10-26,06:00:00,142,109,33,FMN GV 16 Berchem TOT
54,Posthofbrug 5366,2022-10-26,07:00:00,461,363,98,FMN GV 16 Berchem TOT
54,Posthofbrug 5366,2022-10-26,08:00:00,813,634,179,FMN GV 16 Berchem TOT
54,Posthofbrug 5366,2022-10-26,09:00:00,308,213,95,FMN GV 16 Berchem TOT
54,Posthofbrug 5366,2022-10-26,10:00:00,156,98,58,FMN GV 16 Berchem TOT
54,Posthofbrug 5366,2022-10-26,11:00:00,175,107,68,FMN GV 16 Berchem TOT
54,Posthofbrug 5366,2022-10-26,12:00:00,354,162,192,FMN GV 16 Berchem TOT
54,Posthofbrug 5366,2022-10-26,13:00:00,318,146,172,FMN GV 16 Berchem TOT
54,Posthofbrug 5366,2022-10-26,14:00:00,215,92,123,FMN GV 16 Berchem TOT
54,Posthofbrug 5366,2022-10-26,15:00:00,296,116,180,FMN GV 16 Berchem TOT
54,Posthofbrug 5366,2022-10-26,16:00:00,465,145,320,FMN GV 16 Berchem TOT
54,Posthofbrug 5366,2022-10-26,17:00:00,626,205,421,FMN GV 16 Berchem TOT
54,Posthofbrug 5366,2022-10-26,18:00:00,448,162,286,FMN GV 16 Berchem TOT
54,Posthofbrug 5366,2022-10-26,19:00:00,236,106,130,FMN GV 16 Berchem TOT
54,Posthofbrug 5366,2022-10-26,20:00:00,126,55,71,FMN GV 16 Berchem TOT
54,Posthofbrug 5366,2022-10-26,21:00:00,104,48,56,FMN GV 16 Berchem TOT
54,Posthofbrug 5366,2022-10-26,22:00:00,128,39,89,FMN GV 16 Berchem TOT
54,Posthofbrug 5366,2022-10-26,23:00:00,64,24,40,FMN GV 16 Berchem TOT
54,Posthofbrug 5366,2022-10-27,00:00:00,0,0,0,FMN GV 16 Berchem TOT
54,Posthofbrug 5366,2022-10-27,01:00:00,18,1,17,FMN GV 16 Berchem TOT
54,Posthofbrug 5366,2022-10-27,02:00:00,8,1,7,FMN GV 16 Berchem TOT
54,Posthofbrug 5366,2022-10-27,03:00:00,4,2,2,FMN GV 16 Berchem TOT
54,Posthofbrug 5366,2022-10-27,04:00:00,15,12,3,FMN GV 16 Berchem TOT
54,Posthofbrug 5366,2022-10-27,05:00:00,52,39,13,FMN GV 16 Berchem TOT
54,Posthofbrug 5366,2022-10-27,06:00:00,146,117,29,FMN GV 16 Berchem TOT
54,Posthofbrug 5366,2022-10-27,07:00:00,547,425,122,FMN GV 16 Berchem TOT
54,Posthofbrug 5366,2022-10-27,08:00:00,1027,811,216,FMN GV 16 Berchem TOT
54,Posthofbrug 5366,2022-10-27,09:00:00,375,279,96,FMN GV 16 Berchem TOT
54,Posthofbrug 5366,2022-10-27,10:00:00,187,130,57,FMN GV 16 Berchem TOT
54,Posthofbrug 5366,2022-10-27,11:00:00,158,97,61,FMN GV 16 Berchem TOT
54,Posthofbrug 5366,2022-10-27,12:00:00,245,135,110,FMN GV 16 Berchem TOT
54,Posthofbrug 5366,2022-10-27,13:00:00,214,111,103,FMN GV 16 Berchem TOT
54,Posthofbrug 5366,2022-10-27,14:00:00,199,79,120,FMN GV 16 Berchem TOT
54,Posthofbrug 5366,2022-10-27,15:00:00,328,113,215,FMN GV 16 Berchem TOT
54,Posthofbrug 5366,2022-10-27,16:00:00,619,193,426,FMN GV 16 Berchem TOT
54,Posthofbrug 5366,2022-10-27,17:00:00,722,211,511,FMN GV 16 Berchem TOT
54,Posthofbrug 5366,2022-10-27,18:00:00,500,176,324,FMN GV 16 Berchem TOT
54,Posthofbrug 5366,2022-10-27,19:00:00,294,112,182,FMN GV 16 Berchem TOT
54,Posthofbrug 5366,2022-10-27,20:00:00,162,61,101,FMN GV 16 Berchem TOT
54,Posthofbrug 5366,2022-10-27,21:00:00,132,61,71,FMN GV 16 Berchem TOT
54,Posthofbrug 5366,2022-10-27,22:00:00,123,42,81,FMN GV 16 Berchem TOT
54,Posthofbrug 5366,2022-10-27,23:00:00,87,29,58,FMN GV 16 Berchem TOT
54,Posthofbrug 5366,2022-10-28,00:00:00,0,0,0,FMN GV 16 Berchem TOT
54,Posthofbrug 5366,2022-10-28,01:00:00,24,9,15,FMN GV 16 Berchem TOT
54,Posthofbrug 5366,2022-10-28,02:00:00,25,2,23,FMN GV 16 Berchem TOT
54,Posthofbrug 5366,2022-10-28,03:00:00,25,3,22,FMN GV 16 Berchem TOT
54,Posthofbrug 5366,2022-10-28,04:00:00,35,7,28,FMN GV 16 Berchem TOT
54,Posthofbrug 5366,2022-10-28,05:00:00,38,28,10,FMN GV 16 Berchem TOT
54,Posthofbrug 5366,2022-10-28,06:00:00,128,101,27,FMN GV 16 Berchem TOT
54,Posthofbrug 5366,2022-10-28,07:00:00,394,313,81,FMN GV 16 Berchem TOT
54,Posthofbrug 5366,2022-10-28,08:00:00,728,570,158,FMN GV 16 Berchem TOT
54,Posthofbrug 5366,2022-10-28,09:00:00,293,225,68,FMN GV 16 Berchem TOT
54,Posthofbrug 5366,2022-10-28,10:00:00,188,124,64,FMN GV 16 Berchem TOT
54,Posthofbrug 5366,2022-10-28,11:00:00,196,125,71,FMN GV 16 Berchem TOT
54,Posthofbrug 5366,2022-10-28,12:00:00,259,139,120,FMN GV 16 Berchem TOT
54,Posthofbrug 5366,2022-10-28,13:00:00,239,117,122,FMN GV 16 Berchem TOT
54,Posthofbrug 5366,2022-10-28,14:00:00,239,90,149,FMN GV 16 Berchem TOT
54,Posthofbrug 5366,2022-10-28,15:00:00,358,116,242,FMN GV 16 Berchem TOT
54,Posthofbrug 5366,2022-10-28,16:00:00,456,145,311,FMN GV 16 Berchem TOT
54,Posthofbrug 5366,2022-10-28,17:00:00,501,157,344,FMN GV 16 Berchem TOT
54,Posthofbrug 5366,2022-10-28,18:00:00,420,170,250,FMN GV 16 Berchem TOT
54,Posthofbrug 5366,2022-10-28,19:00:00,238,110,128,FMN GV 16 Berchem TOT
54,Posthofbrug 5366,2022-10-28,20:00:00,130,63,67,FMN GV 16 Berchem TOT
54,Posthofbrug 5366,2022-10-28,21:00:00,96,59,37,FMN GV 16 Berchem TOT
54,Posthofbrug 5366,2022-10-28,22:00:00,112,30,82,FMN GV 16 Berchem TOT
54,Posthofbrug 5366,2022-10-28,23:00:00,116,36,80,FMN GV 16 Berchem TOT
54,Posthofbrug 5366,2022-10-29,00:00:00,0,0,0,FMN GV 16 Berchem TOT
54,Posthofbrug 5366,2022-10-29,01:00:00,49,12,37,FMN GV 16 Berchem TOT
54,Posthofbrug 5366,2022-10-29,02:00:00,49,16,33,FMN GV 16 Berchem TOT
54,Posthofbrug 5366,2022-10-29,03:00:00,28,6,22,FMN GV 16 Berchem TOT
54,Posthofbrug 5366,2022-10-29,04:00:00,22,3,19,FMN GV 16 Berchem TOT
54,Posthofbrug 5366,2022-10-29,05:00:00,30,9,21,FMN GV 16 Berchem TOT
54,Posthofbrug 5366,2022-10-29,06:00:00,26,14,12,FMN GV 16 Berchem TOT
54,Posthofbrug 5366,2022-10-29,07:00:00,47,18,29,FMN GV 16 Berchem TOT
54,Posthofbrug 5366,2022-10-29,08:00:00,73,38,35,FMN GV 16 Berchem TOT
54,Posthofbrug 5366,2022-10-29,09:00:00,150,103,47,FMN GV 16 Berchem TOT
54,Posthofbrug 5366,2022-10-29,10:00:00,129,86,43,FMN GV 16 Berchem TOT
54,Posthofbrug 5366,2022-10-29,11:00:00,202,129,73,FMN GV 16 Berchem TOT
54,Posthofbrug 5366,2022-10-29,12:00:00,223,150,73,FMN GV 16 Berchem TOT
54,Posthofbrug 5366,2022-10-29,13:00:00,247,148,99,FMN GV 16 Berchem TOT
54,Posthofbrug 5366,2022-10-29,14:00:00,256,149,107,FMN GV 16 Berchem TOT
54,Posthofbrug 5366,2022-10-29,15:00:00,235,139,96,FMN GV 16 Berchem TOT
54,Posthofbrug 5366,2022-10-29,16:00:00,235,122,113,FMN GV 16 Berchem TOT
54,Posthofbrug 5366,2022-10-29,17:00:00,267,131,136,FMN GV 16 Berchem TOT
54,Posthofbrug 5366,2022-10-29,18:00:00,175,95,80,FMN GV 16 Berchem TOT
54,Posthofbrug 5366,2022-10-29,19:00:00,185,93,92,FMN GV 16 Berchem TOT
54,Posthofbrug 5366,2022-10-29,20:00:00,106,55,51,FMN GV 16 Berchem TOT
54,Posthofbrug 5366,2022-10-29,21:00:00,112,69,43,FMN GV 16 Berchem TOT
54,Posthofbrug 5366,2022-10-29,22:00:00,103,38,65,FMN GV 16 Berchem TOT
54,Posthofbrug 5366,2022-10-29,23:00:00,135,38,97,FMN GV 16 Berchem TOT
54,Posthofbrug 5366,2022-10-30,00:00:00,0,0,0,FMN GV 16 Berchem TOT
54,Posthofbrug 5366,2022-10-30,01:00:00,56,13,43,FMN GV 16 Berchem TOT
54,Posthofbrug 5366,2022-10-30,02:00:00,50,10,40,FMN GV 16 Berchem TOT
54,Posthofbrug 5366,2022-10-30,03:00:00,19,6,13,FMN GV 16 Berchem TOT
54,Posthofbrug 5366,2022-10-30,04:00:00,19,8,11,FMN GV 16 Berchem TOT
54,Posthofbrug 5366,2022-10-30,05:00:00,13,4,9,FMN GV 16 Berchem TOT
54,Posthofbrug 5366,2022-10-30,06:00:00,15,9,6,FMN GV 16 Berchem TOT
54,Posthofbrug 5366,2022-10-30,07:00:00,30,16,14,FMN GV 16 Berchem TOT
54,Posthofbrug 5366,2022-10-30,08:00:00,76,33,43,FMN GV 16 Berchem TOT
54,Posthofbrug 5366,2022-10-30,09:00:00,120,73,47,FMN GV 16 Berchem TOT
54,Posthofbrug 5366,2022-10-30,10:00:00,147,97,50,FMN GV 16 Berchem TOT
54,Posthofbrug 5366,2022-10-30,11:00:00,199,125,74,FMN GV 16 Berchem TOT
54,Posthofbrug 5366,2022-10-30,12:00:00,198,116,82,FMN GV 16 Berchem TOT
54,Posthofbrug 5366,2022-10-30,13:00:00,225,134,91,FMN GV 16 Berchem TOT
54,Posthofbrug 5366,2022-10-30,14:00:00,235,133,102,FMN GV 16 Berchem TOT
54,Posthofbrug 5366,2022-10-30,15:00:00,218,98,120,FMN GV 16 Berchem TOT
54,Posthofbrug 5366,2022-10-30,16:00:00,222,83,139,FMN GV 16 Berchem TOT
54,Posthofbrug 5366,2022-10-30,17:00:00,197,99,98,FMN GV 16 Berchem TOT
54,Posthofbrug 5366,2022-10-30,18:00:00,123,58,65,FMN GV 16 Berchem TOT
54,Posthofbrug 5366,2022-10-30,19:00:00,64,32,32,FMN GV 16 Berchem TOT
54,Posthofbrug 5366,2022-10-30,20:00:00,55,28,27,FMN GV 16 Berchem TOT
54,Posthofbrug 5366,2022-10-30,21:00:00,55,15,40,FMN GV 16 Berchem TOT
54,Posthofbrug 5366,2022-10-30,22:00:00,53,17,36,FMN GV 16 Berchem TOT
54,Posthofbrug 5366,2022-10-30,23:00:00,51,20,31,FMN GV 16 Berchem TOT
54,Posthofbrug 5366,2022-10-31,00:00:00,0,0,0,FMN GV 16 Berchem TOT
54,Posthofbrug 5366,2022-10-31,01:00:00,13,3,10,FMN GV 16 Berchem TOT
54,Posthofbrug 5366,2022-10-31,02:00:00,3,0,3,FMN GV 16 Berchem TOT
54,Posthofbrug 5366,2022-10-31,03:00:00,7,1,6,FMN GV 16 Berchem TOT
54,Posthofbrug 5366,2022-10-31,04:00:00,12,8,4,FMN GV 16 Berchem TOT
54,Posthofbrug 5366,2022-10-31,05:00:00,21,15,6,FMN GV 16 Berchem TOT
54,Posthofbrug 5366,2022-10-31,06:00:00,56,45,11,FMN GV 16 Berchem TOT
54,Posthofbrug 5366,2022-10-31,07:00:00,161,119,42,FMN GV 16 Berchem TOT
54,Posthofbrug 5366,2022-10-31,08:00:00,219,172,47,FMN GV 16 Berchem TOT
54,Posthofbrug 5366,2022-10-31,09:00:00,124,96,28,FMN GV 16 Berchem TOT
54,Posthofbrug 5366,2022-10-31,10:00:00,103,70,33,FMN GV 16 Berchem TOT
54,Posthofbrug 5366,2022-10-31,11:00:00,121,77,44,FMN GV 16 Berchem TOT
54,Posthofbrug 5366,2022-10-31,12:00:00,130,78,52,FMN GV 16 Berchem TOT
54,Posthofbrug 5366,2022-10-31,13:00:00,149,86,63,FMN GV 16 Berchem TOT
54,Posthofbrug 5366,2022-10-31,14:00:00,152,84,68,FMN GV 16 Berchem TOT
54,Posthofbrug 5366,2022-10-31,15:00:00,181,74,107,FMN GV 16 Berchem TOT
54,Posthofbrug 5366,2022-10-31,16:00:00,241,85,156,FMN GV 16 Berchem TOT
54,Posthofbrug 5366,2022-10-31,17:00:00,272,103,169,FMN GV 16 Berchem TOT
54,Posthofbrug 5366,2022-10-31,18:00:00,182,73,109,FMN GV 16 Berchem TOT
54,Posthofbrug 5366,2022-10-31,19:00:00,136,76,60,FMN GV 16 Berchem TOT
54,Posthofbrug 5366,2022-10-31,20:00:00,95,51,44,FMN GV 16 Berchem TOT
54,Posthofbrug 5366,2022-10-31,21:00:00,81,52,29,FMN GV 16 Berchem TOT
54,Posthofbrug 5366,2022-10-31,22:00:00,83,39,44,FMN GV 16 Berchem TOT
54,Posthofbrug 5366,2022-10-31,23:00:00,53,12,41,FMN GV 16 Berchem TOT
54,Posthofbrug 5366,2022-11-01,00:00:00,0,0,0,FMN GV 16 Berchem TOT
54,Posthofbrug 5366,2022-11-01,01:00:00,42,7,35,FMN GV 16 Berchem TOT
54,Posthofbrug 5366,2022-11-01,02:00:00,31,12,19,FMN GV 16 Berchem TOT
54,Posthofbrug 5366,2022-11-01,03:00:00,17,5,12,FMN GV 16 Berchem TOT
54,Posthofbrug 5366,2022-11-01,04:00:00,22,3,19,FMN GV 16 Berchem TOT
54,Posthofbrug 5366,2022-11-01,05:00:00,25,7,18,FMN GV 16 Berchem TOT
54,Posthofbrug 5366,2022-11-01,06:00:00,31,17,14,FMN GV 16 Berchem TOT
54,Posthofbrug 5366,2022-11-01,07:00:00,24,16,8,FMN GV 16 Berchem TOT
54,Posthofbrug 5366,2022-11-01,08:00:00,50,37,13,FMN GV 16 Berchem TOT
54,Posthofbrug 5366,2022-11-01,09:00:00,91,67,24,FMN GV 16 Berchem TOT
54,Posthofbrug 5366,2022-11-01,10:00:00,110,67,43,FMN GV 16 Berchem TOT
54,Posthofbrug 5366,2022-11-01,11:00:00,148,87,61,FMN GV 16 Berchem TOT
54,Posthofbrug 5366,2022-11-01,12:00:00,121,56,65,FMN GV 16 Berchem TOT
54,Posthofbrug 5366,2022-11-01,13:00:00,167,98,69,FMN GV 16 Berchem TOT
54,Posthofbrug 5366,2022-11-01,14:00:00,170,105,65,FMN GV 16 Berchem TOT
54,Posthofbrug 5366,2022-11-01,15:00:00,142,65,77,FMN GV 16 Berchem TOT
54,Posthofbrug 5366,2022-11-01,16:00:00,169,58,111,FMN GV 16 Berchem TOT
54,Posthofbrug 5366,2022-11-01,17:00:00,165,70,95,FMN GV 16 Berchem TOT
54,Posthofbrug 5366,2022-11-01,18:00:00,122,52,70,FMN GV 16 Berchem TOT
54,Posthofbrug 5366,2022-11-01,19:00:00,94,43,51,FMN GV 16 Berchem TOT
54,Posthofbrug 5366,2022-11-01,20:00:00,53,30,23,FMN GV 16 Berchem TOT
54,Posthofbrug 5366,2022-11-01,21:00:00,67,32,35,FMN GV 16 Berchem TOT
54,Posthofbrug 5366,2022-11-01,22:00:00,61,22,39,FMN GV 16 Berchem TOT
54,Posthofbrug 5366,2022-11-01,23:00:00,35,15,20,FMN GV 16 Berchem TOT
54,Posthofbrug 5366,2022-11-02,00:00:00,0,0,0,FMN GV 16 Berchem TOT
54,Posthofbrug 5366,2022-11-02,01:00:00,17,3,14,FMN GV 16 Berchem TOT
54,Posthofbrug 5366,2022-11-02,02:00:00,4,0,4,FMN GV 16 Berchem TOT
54,Posthofbrug 5366,2022-11-02,03:00:00,6,4,2,FMN GV 16 Berchem TOT
54,Posthofbrug 5366,2022-11-02,04:00:00,12,9,3,FMN GV 16 Berchem TOT
54,Posthofbrug 5366,2022-11-02,05:00:00,27,22,5,FMN GV 16 Berchem TOT
54,Posthofbrug 5366,2022-11-02,06:00:00,90,61,29,FMN GV 16 Berchem TOT
54,Posthofbrug 5366,2022-11-02,07:00:00,236,175,61,FMN GV 16 Berchem TOT
54,Posthofbrug 5366,2022-11-02,08:00:00,380,268,112,FMN GV 16 Berchem TOT
54,Posthofbrug 5366,2022-11-02,09:00:00,221,168,53,FMN GV 16 Berchem TOT
54,Posthofbrug 5366,2022-11-02,10:00:00,128,87,41,FMN GV 16 Berchem TOT
54,Posthofbrug 5366,2022-11-02,11:00:00,111,61,50,FMN GV 16 Berchem TOT
54,Posthofbrug 5366,2022-11-02,12:00:00,173,101,72,FMN GV 16 Berchem TOT
54,Posthofbrug 5366,2022-11-02,13:00:00,157,85,72,FMN GV 16 Berchem TOT
54,Posthofbrug 5366,2022-11-02,14:00:00,191,105,86,FMN GV 16 Berchem TOT
54,Posthofbrug 5366,2022-11-02,15:00:00,199,74,125,FMN GV 16 Berchem TOT
54,Posthofbrug 5366,2022-11-02,16:00:00,300,116,184,FMN GV 16 Berchem TOT
54,Posthofbrug 5366,2022-11-02,17:00:00,383,134,249,FMN GV 16 Berchem TOT
54,Posthofbrug 5366,2022-11-02,18:00:00,300,124,176,FMN GV 16 Berchem TOT
54,Posthofbrug 5366,2022-11-02,19:00:00,156,68,88,FMN GV 16 Berchem TOT
54,Posthofbrug 5366,2022-11-02,20:00:00,124,55,69,FMN GV 16 Berchem TOT
54,Posthofbrug 5366,2022-11-02,21:00:00,87,38,49,FMN GV 16 Berchem TOT
54,Posthofbrug 5366,2022-11-02,22:00:00,66,13,53,FMN GV 16 Berchem TOT
54,Posthofbrug 5366,2022-11-02,23:00:00,64,19,45,FMN GV 16 Berchem TOT
54,Posthofbrug 5366,2022-11-03,00:00:00,0,0,0,FMN GV 16 Berchem TOT
54,Posthofbrug 5366,2022-11-03,01:00:00,20,3,17,FMN GV 16 Berchem TOT
54,Posthofbrug 5366,2022-11-03,02:00:00,9,0,9,FMN GV 16 Berchem TOT
54,Posthofbrug 5366,2022-11-03,03:00:00,2,0,2,FMN GV 16 Berchem TOT
54,Posthofbrug 5366,2022-11-03,04:00:00,15,9,6,FMN GV 16 Berchem TOT
54,Posthofbrug 5366,2022-11-03,05:00:00,29,21,8,FMN GV 16 Berchem TOT
54,Posthofbrug 5366,2022-11-03,06:00:00,109,83,26,FMN GV 16 Berchem TOT
54,Posthofbrug 5366,2022-11-03,07:00:00,283,214,69,FMN GV 16 Berchem TOT
54,Posthofbrug 5366,2022-11-03,08:00:00,545,394,151,FMN GV 16 Berchem TOT
54,Posthofbrug 5366,2022-11-03,09:00:00,238,188,50,FMN GV 16 Berchem TOT
54,Posthofbrug 5366,2022-11-03,10:00:00,146,105,41,FMN GV 16 Berchem TOT
54,Posthofbrug 5366,2022-11-03,11:00:00,124,77,47,FMN GV 16 Berchem TOT
54,Posthofbrug 5366,2022-11-03,12:00:00,165,78,87,FMN GV 16 Berchem TOT
54,Posthofbrug 5366,2022-11-03,13:00:00,141,71,70,FMN GV 16 Berchem TOT
54,Posthofbrug 5366,2022-11-03,14:00:00,130,57,73,FMN GV 16 Berchem TOT
54,Posthofbrug 5366,2022-11-03,15:00:00,149,53,96,FMN GV 16 Berchem TOT
54,Posthofbrug 5366,2022-11-03,16:00:00,347,111,236,FMN GV 16 Berchem TOT
54,Posthofbrug 5366,2022-11-03,17:00:00,447,138,309,FMN GV 16 Berchem TOT
54,Posthofbrug 5366,2022-11-03,18:00:00,298,106,192,FMN GV 16 Berchem TOT
54,Posthofbrug 5366,2022-11-03,19:00:00,133,51,82,FMN GV 16 Berchem TOT
54,Posthofbrug 5366,2022-11-03,20:00:00,93,44,49,FMN GV 16 Berchem TOT
54,Posthofbrug 5366,2022-11-03,21:00:00,58,24,34,FMN GV 16 Berchem TOT
54,Posthofbrug 5366,2022-11-03,22:00:00,68,26,42,FMN GV 16 Berchem TOT
54,Posthofbrug 5366,2022-11-03,23:00:00,58,13,45,FMN GV 16 Berchem TOT
54,Posthofbrug 5366,2022-11-04,00:00:00,0,0,0,FMN GV 16 Berchem TOT
54,Posthofbrug 5366,2022-11-04,01:00:00,15,7,8,FMN GV 16 Berchem TOT
54,Posthofbrug 5366,2022-11-04,02:00:00,12,1,11,FMN GV 16 Berchem TOT
54,Posthofbrug 5366,2022-11-04,03:00:00,8,1,7,FMN GV 16 Berchem TOT
54,Posthofbrug 5366,2022-11-04,04:00:00,11,8,3,FMN GV 16 Berchem TOT
54,Posthofbrug 5366,2022-11-04,05:00:00,22,13,9,FMN GV 16 Berchem TOT
54,Posthofbrug 5366,2022-11-04,06:00:00,77,57,20,FMN GV 16 Berchem TOT
54,Posthofbrug 5366,2022-11-04,07:00:00,200,152,48,FMN GV 16 Berchem TOT
54,Posthofbrug 5366,2022-11-04,08:00:00,341,262,79,FMN GV 16 Berchem TOT
54,Posthofbrug 5366,2022-11-04,09:00:00,197,146,51,FMN GV 16 Berchem TOT
54,Posthofbrug 5366,2022-11-04,10:00:00,122,86,36,FMN GV 16 Berchem TOT
54,Posthofbrug 5366,2022-11-04,11:00:00,103,59,44,FMN GV 16 Berchem TOT
54,Posthofbrug 5366,2022-11-04,12:00:00,159,80,79,FMN GV 16 Berchem TOT
54,Posthofbrug 5366,2022-11-04,13:00:00,158,88,70,FMN GV 16 Berchem TOT
54,Posthofbrug 5366,2022-11-04,14:00:00,140,70,70,FMN GV 16 Berchem TOT
54,Posthofbrug 5366,2022-11-04,15:00:00,160,67,93,FMN GV 16 Berchem TOT
54,Posthofbrug 5366,2022-11-04,16:00:00,297,108,189,FMN GV 16 Berchem TOT
54,Posthofbrug 5366,2022-11-04,17:00:00,338,117,221,FMN GV 16 Berchem TOT
54,Posthofbrug 5366,2022-11-04,18:00:00,256,109,147,FMN GV 16 Berchem TOT
54,Posthofbrug 5366,2022-11-04,19:00:00,192,107,85,FMN GV 16 Berchem TOT
54,Posthofbrug 5366,2022-11-04,20:00:00,94,53,41,FMN GV 16 Berchem TOT
54,Posthofbrug 5366,2022-11-04,21:00:00,93,40,53,FMN GV 16 Berchem TOT
54,Posthofbrug 5366,2022-11-04,22:00:00,70,13,57,FMN GV 16 Berchem TOT
54,Posthofbrug 5366,2022-11-04,23:00:00,74,24,50,FMN GV 16 Berchem TOT
54,Posthofbrug 5366,2022-11-05,00:00:00,0,0,0,FMN GV 16 Berchem TOT
54,Posthofbrug 5366,2022-11-05,01:00:00,41,13,28,FMN GV 16 Berchem TOT
54,Posthofbrug 5366,2022-11-05,02:00:00,27,7,20,FMN GV 16 Berchem TOT
54,Posthofbrug 5366,2022-11-05,03:00:00,26,2,24,FMN GV 16 Berchem TOT
54,Posthofbrug 5366,2022-11-05,04:00:00,22,8,14,FMN GV 16 Berchem TOT
54,Posthofbrug 5366,2022-11-05,05:00:00,23,10,13,FMN GV 16 Berchem TOT
54,Posthofbrug 5366,2022-11-05,06:00:00,28,16,12,FMN GV 16 Berchem TOT
54,Posthofbrug 5366,2022-11-05,07:00:00,30,19,11,FMN GV 16 Berchem TOT
54,Posthofbrug 5366,2022-11-05,08:00:00,56,34,22,FMN GV 16 Berchem TOT
54,Posthofbrug 5366,2022-11-05,09:00:00,138,100,38,FMN GV 16 Berchem TOT
54,Posthofbrug 5366,2022-11-05,10:00:00,172,109,63,FMN GV 16 Berchem TOT
54,Posthofbrug 5366,2022-11-05,11:00:00,137,75,62,FMN GV 16 Berchem TOT
54,Posthofbrug 5366,2022-11-05,12:00:00,167,97,70,FMN GV 16 Berchem TOT
54,Posthofbrug 5366,2022-11-05,13:00:00,162,107,55,FMN GV 16 Berchem TOT
54,Posthofbrug 5366,2022-11-05,14:00:00,167,85,82,FMN GV 16 Berchem TOT
54,Posthofbrug 5366,2022-11-05,15:00:00,175,75,100,FMN GV 16 Berchem TOT
54,Posthofbrug 5366,2022-11-05,16:00:00,162,81,81,FMN GV 16 Berchem TOT
54,Posthofbrug 5366,2022-11-05,17:00:00,165,74,91,FMN GV 16 Berchem TOT
54,Posthofbrug 5366,2022-11-05,18:00:00,153,75,78,FMN GV 16 Berchem TOT
54,Posthofbrug 5366,2022-11-05,19:00:00,116,70,46,FMN GV 16 Berchem TOT
54,Posthofbrug 5366,2022-11-05,20:00:00,79,40,39,FMN GV 16 Berchem TOT
54,Posthofbrug 5366,2022-11-05,21:00:00,49,26,23,FMN GV 16 Berchem TOT
54,Posthofbrug 5366,2022-11-05,22:00:00,87,30,57,FMN GV 16 Berchem TOT
54,Posthofbrug 5366,2022-11-05,23:00:00,50,10,40,FMN GV 16 Berchem TOT
54,Posthofbrug 5366,2022-11-06,00:00:00,0,0,0,FMN GV 16 Berchem TOT
54,Posthofbrug 5366,2022-11-06,01:00:00,47,19,28,FMN GV 16 Berchem TOT
54,Posthofbrug 5366,2022-11-06,02:00:00,26,5,21,FMN GV 16 Berchem TOT
54,Posthofbrug 5366,2022-11-06,03:00:00,15,3,12,FMN GV 16 Berchem TOT
54,Posthofbrug 5366,2022-11-06,04:00:00,20,3,17,FMN GV 16 Berchem TOT
54,Posthofbrug 5366,2022-11-06,05:00:00,9,2,7,FMN GV 16 Berchem TOT
54,Posthofbrug 5366,2022-11-06,06:00:00,23,15,8,FMN GV 16 Berchem TOT
54,Posthofbrug 5366,2022-11-06,07:00:00,27,13,14,FMN GV 16 Berchem TOT
54,Posthofbrug 5366,2022-11-06,08:00:00,37,22,15,FMN GV 16 Berchem TOT
54,Posthofbrug 5366,2022-11-06,09:00:00,103,63,40,FMN GV 16 Berchem TOT
54,Posthofbrug 5366,2022-11-06,10:00:00,118,77,41,FMN GV 16 Berchem TOT
54,Posthofbrug 5366,2022-11-06,11:00:00,125,75,50,FMN GV 16 Berchem TOT
54,Posthofbrug 5366,2022-11-06,12:00:00,153,77,76,FMN GV 16 Berchem TOT
54,Posthofbrug 5366,2022-11-06,13:00:00,98,55,43,FMN GV 16 Berchem TOT
54,Posthofbrug 5366,2022-11-06,14:00:00,55,32,23,FMN GV 16 Berchem TOT
54,Posthofbrug 5366,2022-11-06,15:00:00,66,21,45,FMN GV 16 Berchem TOT
54,Posthofbrug 5366,2022-11-06,16:00:00,59,33,26,FMN GV 16 Berchem TOT
54,Posthofbrug 5366,2022-11-06,17:00:00,85,31,54,FMN GV 16 Berchem TOT
54,Posthofbrug 5366,2022-11-06,18:00:00,54,27,27,FMN GV 16 Berchem TOT
54,Posthofbrug 5366,2022-11-06,19:00:00,59,20,39,FMN GV 16 Berchem TOT
54,Posthofbrug 5366,2022-11-06,20:00:00,53,34,19,FMN GV 16 Berchem TOT
54,Posthofbrug 5366,2022-11-06,21:00:00,46,21,25,FMN GV 16 Berchem TOT
54,Posthofbrug 5366,2022-11-06,22:00:00,41,16,25,FMN GV 16 Berchem TOT
54,Posthofbrug 5366,2022-11-06,23:00:00,12,4,8,FMN GV 16 Berchem TOT
54,Posthofbrug 5366,2022-11-07,00:00:00,0,0,0,FMN GV 16 Berchem TOT
54,Posthofbrug 5366,2022-11-07,01:00:00,4,1,3,FMN GV 16 Berchem TOT
54,Posthofbrug 5366,2022-11-07,02:00:00,2,1,1,FMN GV 16 Berchem TOT
54,Posthofbrug 5366,2022-11-07,03:00:00,2,0,2,FMN GV 16 Berchem TOT
54,Posthofbrug 5366,2022-11-07,04:00:00,9,7,2,FMN GV 16 Berchem TOT
54,Posthofbrug 5366,2022-11-07,05:00:00,34,25,9,FMN GV 16 Berchem TOT
54,Posthofbrug 5366,2022-11-07,06:00:00,134,109,25,FMN GV 16 Berchem TOT
54,Posthofbrug 5366,2022-11-07,07:00:00,433,347,86,FMN GV 16 Berchem TOT
54,Posthofbrug 5366,2022-11-07,08:00:00,860,660,200,FMN GV 16 Berchem TOT
54,Posthofbrug 5366,2022-11-07,09:00:00,262,203,59,FMN GV 16 Berchem TOT
54,Posthofbrug 5366,2022-11-07,10:00:00,150,112,38,FMN GV 16 Berchem TOT
54,Posthofbrug 5366,2022-11-07,11:00:00,100,64,36,FMN GV 16 Berchem TOT
54,Posthofbrug 5366,2022-11-07,12:00:00,178,93,85,FMN GV 16 Berchem TOT
54,Posthofbrug 5366,2022-11-07,13:00:00,157,88,69,FMN GV 16 Berchem TOT
54,Posthofbrug 5366,2022-11-07,14:00:00,163,66,97,FMN GV 16 Berchem TOT
54,Posthofbrug 5366,2022-11-07,15:00:00,258,84,174,FMN GV 16 Berchem TOT
54,Posthofbrug 5366,2022-11-07,16:00:00,497,129,368,FMN GV 16 Berchem TOT
54,Posthofbrug 5366,2022-11-07,17:00:00,640,169,471,FMN GV 16 Berchem TOT
54,Posthofbrug 5366,2022-11-07,18:00:00,355,115,240,FMN GV 16 Berchem TOT
54,Posthofbrug 5366,2022-11-07,19:00:00,183,65,118,FMN GV 16 Berchem TOT
54,Posthofbrug 5366,2022-11-07,20:00:00,113,50,63,FMN GV 16 Berchem TOT
54,Posthofbrug 5366,2022-11-07,21:00:00,99,43,56,FMN GV 16 Berchem TOT
54,Posthofbrug 5366,2022-11-07,22:00:00,92,34,58,FMN GV 16 Berchem TOT
54,Posthofbrug 5366,2022-11-07,23:00:00,35,7,28,FMN GV 16 Berchem TOT
54,Posthofbrug 5366,2022-11-08,00:00:00,0,0,0,FMN GV 16 Berchem TOT
54,Posthofbrug 5366,2022-11-08,01:00:00,12,4,8,FMN GV 16 Berchem TOT
54,Posthofbrug 5366,2022-11-08,02:00:00,8,0,8,FMN GV 16 Berchem TOT
54,Posthofbrug 5366,2022-11-08,03:00:00,7,3,4,FMN GV 16 Berchem TOT
54,Posthofbrug 5366,2022-11-08,04:00:00,10,7,3,FMN GV 16 Berchem TOT
54,Posthofbrug 5366,2022-11-08,05:00:00,44,36,8,FMN GV 16 Berchem TOT
54,Posthofbrug 5366,2022-11-08,06:00:00,144,111,33,FMN GV 16 Berchem TOT
54,Posthofbrug 5366,2022-11-08,07:00:00,554,442,112,FMN GV 16 Berchem TOT
54,Posthofbrug 5366,2022-11-08,08:00:00,1042,805,237,FMN GV 16 Berchem TOT
54,Posthofbrug 5366,2022-11-08,09:00:00,338,254,84,FMN GV 16 Berchem TOT
54,Posthofbrug 5366,2022-11-08,10:00:00,196,137,59,FMN GV 16 Berchem TOT
54,Posthofbrug 5366,2022-11-08,11:00:00,147,92,55,FMN GV 16 Berchem TOT
54,Posthofbrug 5366,2022-11-08,12:00:00,167,87,80,FMN GV 16 Berchem TOT
54,Posthofbrug 5366,2022-11-08,13:00:00,210,103,107,FMN GV 16 Berchem TOT
54,Posthofbrug 5366,2022-11-08,14:00:00,184,77,107,FMN GV 16 Berchem TOT
54,Posthofbrug 5366,2022-11-08,15:00:00,342,102,240,FMN GV 16 Berchem TOT
54,Posthofbrug 5366,2022-11-08,16:00:00,613,169,444,FMN GV 16 Berchem TOT
54,Posthofbrug 5366,2022-11-08,17:00:00,810,232,578,FMN GV 16 Berchem TOT
54,Posthofbrug 5366,2022-11-08,18:00:00,481,150,331,FMN GV 16 Berchem TOT
54,Posthofbrug 5366,2022-11-08,19:00:00,216,76,140,FMN GV 16 Berchem TOT
54,Posthofbrug 5366,2022-11-08,20:00:00,136,51,85,FMN GV 16 Berchem TOT
54,Posthofbrug 5366,2022-11-08,21:00:00,163,75,88,FMN GV 16 Berchem TOT
54,Posthofbrug 5366,2022-11-08,22:00:00,96,32,64,FMN GV 16 Berchem TOT
54,Posthofbrug 5366,2022-11-08,23:00:00,62,18,44,FMN GV 16 Berchem TOT
54,Posthofbrug 5366,2022-11-09,00:00:00,31,14,17,FMN GV 16 Berchem TOT
54,Posthofbrug 5366,2022-11-09,01:00:00,24,5,19,FMN GV 16 Berchem TOT
54,Posthofbrug 5366,2022-11-09,02:00:00,6,2,4,FMN GV 16 Berchem TOT
54,Posthofbrug 5366,2022-11-09,03:00:00,5,1,4,FMN GV 16 Berchem TOT
54,Posthofbrug 5366,2022-11-09,04:00:00,9,7,2,FMN GV 16 Berchem TOT
54,Posthofbrug 5366,2022-11-09,05:00:00,30,20,10,FMN GV 16 Berchem TOT
54,Posthofbrug 5366,2022-11-09,06:00:00,111,89,22,FMN GV 16 Berchem TOT
54,Posthofbrug 5366,2022-11-09,07:00:00,429,336,93,FMN GV 16 Berchem TOT
54,Posthofbrug 5366,2022-11-09,08:00:00,773,601,172,FMN GV 16 Berchem TOT
54,Posthofbrug 5366,2022-11-09,09:00:00,271,195,76,FMN GV 16 Berchem TOT
54,Posthofbrug 5366,2022-11-09,10:00:00,202,143,59,FMN GV 16 Berchem TOT
54,Posthofbrug 5366,2022-11-09,11:00:00,162,97,65,FMN GV 16 Berchem TOT
54,Posthofbrug 5366,2022-11-09,12:00:00,321,125,196,FMN GV 16 Berchem TOT
54,Posthofbrug 5366,2022-11-09,13:00:00,270,137,133,FMN GV 16 Berchem TOT
54,Posthofbrug 5366,2022-11-09,14:00:00,210,83,127,FMN GV 16 Berchem TOT
54,Posthofbrug 5366,2022-11-09,15:00:00,264,89,175,FMN GV 16 Berchem TOT
54,Posthofbrug 5366,2022-11-09,16:00:00,426,134,292,FMN GV 16 Berchem TOT
54,Posthofbrug 5366,2022-11-09,17:00:00,606,182,424,FMN GV 16 Berchem TOT
54,Posthofbrug 5366,2022-11-09,18:00:00,382,136,246,FMN GV 16 Berchem TOT
54,Posthofbrug 5366,2022-11-09,19:00:00,208,90,118,FMN GV 16 Berchem TOT
54,Posthofbrug 5366,2022-11-09,20:00:00,108,48,60,FMN GV 16 Berchem TOT
54,Posthofbrug 5366,2022-11-09,21:00:00,104,35,69,FMN GV 16 Berchem TOT
54,Posthofbrug 5366,2022-11-09,22:00:00,96,35,61,FMN GV 16 Berchem TOT
54,Posthofbrug 5366,2022-11-09,23:00:00,57,25,32,FMN GV 16 Berchem TOT
54,Posthofbrug 5366,2022-11-10,00:00:00,0,0,0,FMN GV 16 Berchem TOT
54,Posthofbrug 5366,2022-11-10,01:00:00,10,3,7,FMN GV 16 Berchem TOT
54,Posthofbrug 5366,2022-11-10,02:00:00,7,0,7,FMN GV 16 Berchem TOT
54,Posthofbrug 5366,2022-11-10,03:00:00,10,3,7,FMN GV 16 Berchem TOT
54,Posthofbrug 5366,2022-11-10,04:00:00,13,8,5,FMN GV 16 Berchem TOT
54,Posthofbrug 5366,2022-11-10,05:00:00,36,28,8,FMN GV 16 Berchem TOT
54,Posthofbrug 5366,2022-11-10,06:00:00,126,103,23,FMN GV 16 Berchem TOT
54,Posthofbrug 5366,2022-11-10,07:00:00,548,432,116,FMN GV 16 Berchem TOT
54,Posthofbrug 5366,2022-11-10,08:00:00,973,766,207,FMN GV 16 Berchem TOT
54,Posthofbrug 5366,2022-11-10,09:00:00,342,251,91,FMN GV 16 Berchem TOT
54,Posthofbrug 5366,2022-11-10,10:00:00,168,118,50,FMN GV 16 Berchem TOT
54,Posthofbrug 5366,2022-11-10,11:00:00,147,94,53,FMN GV 16 Berchem TOT
54,Posthofbrug 5366,2022-11-10,12:00:00,249,123,126,FMN GV 16 Berchem TOT
54,Posthofbrug 5366,2022-11-10,13:00:00,207,107,100,FMN GV 16 Berchem TOT
54,Posthofbrug 5366,2022-11-10,14:00:00,190,74,116,FMN GV 16 Berchem TOT
54,Posthofbrug 5366,2022-11-10,15:00:00,366,116,250,FMN GV 16 Berchem TOT
54,Posthofbrug 5366,2022-11-10,16:00:00,557,165,392,FMN GV 16 Berchem TOT
54,Posthofbrug 5366,2022-11-10,17:00:00,659,200,459,FMN GV 16 Berchem TOT
54,Posthofbrug 5366,2022-11-10,18:00:00,497,163,334,FMN GV 16 Berchem TOT
54,Posthofbrug 5366,2022-11-10,19:00:00,238,95,143,FMN GV 16 Berchem TOT
54,Posthofbrug 5366,2022-11-10,20:00:00,157,88,69,FMN GV 16 Berchem TOT
54,Posthofbrug 5366,2022-11-10,21:00:00,127,58,69,FMN GV 16 Berchem TOT
54,Posthofbrug 5366,2022-11-10,22:00:00,119,48,71,FMN GV 16 Berchem TOT
54,Posthofbrug 5366,2022-11-10,23:00:00,102,40,62,FMN GV 16 Berchem TOT
54,Posthofbrug 5366,2022-11-11,00:00:00,0,0,0,FMN GV 16 Berchem TOT
54,Posthofbrug 5366,2022-11-11,01:00:00,46,7,39,FMN GV 16 Berchem TOT
54,Posthofbrug 5366,2022-11-11,02:00:00,27,3,24,FMN GV 16 Berchem TOT
54,Posthofbrug 5366,2022-11-11,03:00:00,32,10,22,FMN GV 16 Berchem TOT
54,Posthofbrug 5366,2022-11-11,04:00:00,23,4,19,FMN GV 16 Berchem TOT
54,Posthofbrug 5366,2022-11-11,05:00:00,29,12,17,FMN GV 16 Berchem TOT
54,Posthofbrug 5366,2022-11-11,06:00:00,35,17,18,FMN GV 16 Berchem TOT
54,Posthofbrug 5366,2022-11-11,07:00:00,34,16,18,FMN GV 16 Berchem TOT
54,Posthofbrug 5366,2022-11-11,08:00:00,40,27,13,FMN GV 16 Berchem TOT
54,Posthofbrug 5366,2022-11-11,09:00:00,107,62,45,FMN GV 16 Berchem TOT
54,Posthofbrug 5366,2022-11-11,10:00:00,139,92,47,FMN GV 16 Berchem TOT
54,Posthofbrug 5366,2022-11-11,11:00:00,157,90,67,FMN GV 16 Berchem TOT
54,Posthofbrug 5366,2022-11-11,12:00:00,155,102,53,FMN GV 16 Berchem TOT
54,Posthofbrug 5366,2022-11-11,13:00:00,166,103,63,FMN GV 16 Berchem TOT
54,Posthofbrug 5366,2022-11-11,14:00:00,175,98,77,FMN GV 16 Berchem TOT
54,Posthofbrug 5366,2022-11-11,15:00:00,174,62,112,FMN GV 16 Berchem TOT
54,Posthofbrug 5366,2022-11-11,16:00:00,179,81,98,FMN GV 16 Berchem TOT
54,Posthofbrug 5366,2022-11-11,17:00:00,174,107,67,FMN GV 16 Berchem TOT
54,Posthofbrug 5366,2022-11-11,18:00:00,134,85,49,FMN GV 16 Berchem TOT
54,Posthofbrug 5366,2022-11-11,19:00:00,159,86,73,FMN GV 16 Berchem TOT
54,Posthofbrug 5366,2022-11-11,20:00:00,103,45,58,FMN GV 16 Berchem TOT
54,Posthofbrug 5366,2022-11-11,21:00:00,79,40,39,FMN GV 16 Berchem TOT
54,Posthofbrug 5366,2022-11-11,22:00:00,70,31,39,FMN GV 16 Berchem TOT
54,Posthofbrug 5366,2022-11-11,23:00:00,77,21,56,FMN GV 16 Berchem TOT
54,Posthofbrug 5366,2022-11-12,00:00:00,0,0,0,FMN GV 16 Berchem TOT
54,Posthofbrug 5366,2022-11-12,01:00:00,33,6,27,FMN GV 16 Berchem TOT
54,Posthofbrug 5366,2022-11-12,02:00:00,22,3,19,FMN GV 16 Berchem TOT
54,Posthofbrug 5366,2022-11-12,03:00:00,23,1,22,FMN GV 16 Berchem TOT
54,Posthofbrug 5366,2022-11-12,04:00:00,30,7,23,FMN GV 16 Berchem TOT
54,Posthofbrug 5366,2022-11-12,05:00:00,33,11,22,FMN GV 16 Berchem TOT
54,Posthofbrug 5366,2022-11-12,06:00:00,31,13,18,FMN GV 16 Berchem TOT
54,Posthofbrug 5366,2022-11-12,07:00:00,36,18,18,FMN GV 16 Berchem TOT
54,Posthofbrug 5366,2022-11-12,08:00:00,53,34,19,FMN GV 16 Berchem TOT
54,Posthofbrug 5366,2022-11-12,09:00:00,140,89,51,FMN GV 16 Berchem TOT
54,Posthofbrug 5366,2022-11-12,10:00:00,146,87,59,FMN GV 16 Berchem TOT
54,Posthofbrug 5366,2022-11-12,11:00:00,175,111,64,FMN GV 16 Berchem TOT
54,Posthofbrug 5366,2022-11-12,12:00:00,219,136,83,FMN GV 16 Berchem TOT
54,Posthofbrug 5366,2022-11-12,13:00:00,268,174,94,FMN GV 16 Berchem TOT
54,Posthofbrug 5366,2022-11-12,14:00:00,249,130,119,FMN GV 16 Berchem TOT
54,Posthofbrug 5366,2022-11-12,15:00:00,204,102,102,FMN GV 16 Berchem TOT
54,Posthofbrug 5366,2022-11-12,16:00:00,211,85,126,FMN GV 16 Berchem TOT
54,Posthofbrug 5366,2022-11-12,17:00:00,246,98,148,FMN GV 16 Berchem TOT
54,Posthofbrug 5366,2022-11-12,18:00:00,178,88,90,FMN GV 16 Berchem TOT
54,Posthofbrug 5366,2022-11-12,19:00:00,138,71,67,FMN GV 16 Berchem TOT
54,Posthofbrug 5366,2022-11-12,20:00:00,90,42,48,FMN GV 16 Berchem TOT
54,Posthofbrug 5366,2022-11-12,21:00:00,80,32,48,FMN GV 16 Berchem TOT
54,Posthofbrug 5366,2022-11-12,22:00:00,79,34,45,FMN GV 16 Berchem TOT
54,Posthofbrug 5366,2022-11-12,23:00:00,98,50,48,FMN GV 16 Berchem TOT
54,Posthofbrug 5366,2022-11-13,00:00:00,0,0,0,FMN GV 16 Berchem TOT
54,Posthofbrug 5366,2022-11-13,01:00:00,25,3,22,FMN GV 16 Berchem TOT
54,Posthofbrug 5366,2022-11-13,02:00:00,37,7,30,FMN GV 16 Berchem TOT
54,Posthofbrug 5366,2022-11-13,03:00:00,25,6,19,FMN GV 16 Berchem TOT
54,Posthofbrug 5366,2022-11-13,04:00:00,19,5,14,FMN GV 16 Berchem TOT
54,Posthofbrug 5366,2022-11-13,05:00:00,17,2,15,FMN GV 16 Berchem TOT
54,Posthofbrug 5366,2022-11-13,06:00:00,22,12,10,FMN GV 16 Berchem TOT
54,Posthofbrug 5366,2022-11-13,07:00:00,29,13,16,FMN GV 16 Berchem TOT
54,Posthofbrug 5366,2022-11-13,08:00:00,62,32,30,FMN GV 16 Berchem TOT
54,Posthofbrug 5366,2022-11-13,09:00:00,81,40,41,FMN GV 16 Berchem TOT
54,Posthofbrug 5366,2022-11-13,10:00:00,126,66,60,FMN GV 16 Berchem TOT
54,Posthofbrug 5366,2022-11-13,11:00:00,109,78,31,FMN GV 16 Berchem TOT
54,Posthofbrug 5366,2022-11-13,12:00:00,158,99,59,FMN GV 16 Berchem TOT
54,Posthofbrug 5366,2022-11-13,13:00:00,191,112,79,FMN GV 16 Berchem TOT
54,Posthofbrug 5366,2022-11-13,14:00:00,225,125,100,FMN GV 16 Berchem TOT
54,Posthofbrug 5366,2022-11-13,15:00:00,178,95,83,FMN GV 16 Berchem TOT
54,Posthofbrug 5366,2022-11-13,16:00:00,162,61,101,FMN GV 16 Berchem TOT
54,Posthofbrug 5366,2022-11-13,17:00:00,185,76,109,FMN GV 16 Berchem TOT
54,Posthofbrug 5366,2022-11-13,18:00:00,87,41,46,FMN GV 16 Berchem TOT
54,Posthofbrug 5366,2022-11-13,19:00:00,94,55,39,FMN GV 16 Berchem TOT
54,Posthofbrug 5366,2022-11-13,20:00:00,76,32,44,FMN GV 16 Berchem TOT
54,Posthofbrug 5366,2022-11-13,21:00:00,60,22,38,FMN GV 16 Berchem TOT
54,Posthofbrug 5366,2022-11-13,22:00:00,56,15,41,FMN GV 16 Berchem TOT
54,Posthofbrug 5366,2022-11-13,23:00:00,25,5,20,FMN GV 16 Berchem TOT
54,Posthofbrug 5366,2022-11-14,00:00:00,0,0,0,FMN GV 16 Berchem TOT
54,Posthofbrug 5366,2022-11-14,01:00:00,3,0,3,FMN GV 16 Berchem TOT
54,Posthofbrug 5366,2022-11-14,02:00:00,1,0,1,FMN GV 16 Berchem TOT
54,Posthofbrug 5366,2022-11-14,03:00:00,2,1,1,FMN GV 16 Berchem TOT
54,Posthofbrug 5366,2022-11-14,04:00:00,7,5,2,FMN GV 16 Berchem TOT
54,Posthofbrug 5366,2022-11-14,05:00:00,26,20,6,FMN GV 16 Berchem TOT
54,Posthofbrug 5366,2022-11-14,06:00:00,128,97,31,FMN GV 16 Berchem TOT
54,Posthofbrug 5366,2022-11-14,07:00:00,495,366,129,FMN GV 16 Berchem TOT
54,Posthofbrug 5366,2022-11-14,08:00:00,866,681,185,FMN GV 16 Berchem TOT
54,Posthofbrug 5366,2022-11-14,09:00:00,311,238,73,FMN GV 16 Berchem TOT
54,Posthofbrug 5366,2022-11-14,10:00:00,167,110,57,FMN GV 16 Berchem TOT
54,Posthofbrug 5366,2022-11-14,11:00:00,128,83,45,FMN GV 16 Berchem TOT
54,Posthofbrug 5366,2022-11-14,12:00:00,209,122,87,FMN GV 16 Berchem TOT
54,Posthofbrug 5366,2022-11-14,13:00:00,216,127,89,FMN GV 16 Berchem TOT
54,Posthofbrug 5366,2022-11-14,14:00:00,180,77,103,FMN GV 16 Berchem TOT
54,Posthofbrug 5366,2022-11-14,15:00:00,334,111,223,FMN GV 16 Berchem TOT
54,Posthofbrug 5366,2022-11-14,16:00:00,532,154,378,FMN GV 16 Berchem TOT
54,Posthofbrug 5366,2022-11-14,17:00:00,660,181,479,FMN GV 16 Berchem TOT
54,Posthofbrug 5366,2022-11-14,18:00:00,373,116,257,FMN GV 16 Berchem TOT
54,Posthofbrug 5366,2022-11-14,19:00:00,202,66,136,FMN GV 16 Berchem TOT
54,Posthofbrug 5366,2022-11-14,20:00:00,102,45,57,FMN GV 16 Berchem TOT
54,Posthofbrug 5366,2022-11-14,21:00:00,113,49,64,FMN GV 16 Berchem TOT
54,Posthofbrug 5366,2022-11-14,22:00:00,90,35,55,FMN GV 16 Berchem TOT
54,Posthofbrug 5366,2022-11-14,23:00:00,31,7,24,FMN GV 16 Berchem TOT
54,Posthofbrug 5366,2022-11-15,00:00:00,0,0,0,FMN GV 16 Berchem TOT
54,Posthofbrug 5366,2022-11-15,01:00:00,8,0,8,FMN GV 16 Berchem TOT
54,Posthofbrug 5366,2022-11-15,02:00:00,4,0,4,FMN GV 16 Berchem TOT
54,Posthofbrug 5366,2022-11-15,03:00:00,8,1,7,FMN GV 16 Berchem TOT
54,Posthofbrug 5366,2022-11-15,04:00:00,10,4,6,FMN GV 16 Berchem TOT
54,Posthofbrug 5366,2022-11-15,05:00:00,29,24,5,FMN GV 16 Berchem TOT
54,Posthofbrug 5366,2022-11-15,06:00:00,128,99,29,FMN GV 16 Berchem TOT
54,Posthofbrug 5366,2022-11-15,07:00:00,511,394,117,FMN GV 16 Berchem TOT
54,Posthofbrug 5366,2022-11-15,08:00:00,898,679,219,FMN GV 16 Berchem TOT
54,Posthofbrug 5366,2022-11-15,09:00:00,294,226,68,FMN GV 16 Berchem TOT
54,Posthofbrug 5366,2022-11-15,10:00:00,169,113,56,FMN GV 16 Berchem TOT
54,Posthofbrug 5366,2022-11-15,11:00:00,159,93,66,FMN GV 16 Berchem TOT
54,Posthofbrug 5366,2022-11-15,12:00:00,182,95,87,FMN GV 16 Berchem TOT
54,Posthofbrug 5366,2022-11-15,13:00:00,179,89,90,FMN GV 16 Berchem TOT
54,Posthofbrug 5366,2022-11-15,14:00:00,136,49,87,FMN GV 16 Berchem TOT
54,Posthofbrug 5366,2022-11-15,15:00:00,306,104,202,FMN GV 16 Berchem TOT
54,Posthofbrug 5366,2022-11-15,16:00:00,505,144,361,FMN GV 16 Berchem TOT
54,Posthofbrug 5366,2022-11-15,17:00:00,624,182,442,FMN GV 16 Berchem TOT
54,Posthofbrug 5366,2022-11-15,18:00:00,385,104,281,FMN GV 16 Berchem TOT
54,Posthofbrug 5366,2022-11-15,19:00:00,190,71,119,FMN GV 16 Berchem TOT
54,Posthofbrug 5366,2022-11-15,20:00:00,93,35,58,FMN GV 16 Berchem TOT
54,Posthofbrug 5366,2022-11-15,21:00:00,107,46,61,FMN GV 16 Berchem TOT
54,Posthofbrug 5366,2022-11-15,22:00:00,88,27,61,FMN GV 16 Berchem TOT
54,Posthofbrug 5366,2022-11-15,23:00:00,44,17,27,FMN GV 16 Berchem TOT
54,Posthofbrug 5366,2022-11-16,00:00:00,0,0,0,FMN GV 16 Berchem TOT
54,Posthofbrug 5366,2022-11-16,01:00:00,5,2,3,FMN GV 16 Berchem TOT
54,Posthofbrug 5366,2022-11-16,02:00:00,6,0,6,FMN GV 16 Berchem TOT
54,Posthofbrug 5366,2022-11-16,03:00:00,6,2,4,FMN GV 16 Berchem TOT
54,Posthofbrug 5366,2022-11-16,04:00:00,12,5,7,FMN GV 16 Berchem TOT
54,Posthofbrug 5366,2022-11-16,05:00:00,27,24,3,FMN GV 16 Berchem TOT
54,Posthofbrug 5366,2022-11-16,06:00:00,118,92,26,FMN GV 16 Berchem TOT
54,Posthofbrug 5366,2022-11-16,07:00:00,456,355,101,FMN GV 16 Berchem TOT
54,Posthofbrug 5366,2022-11-16,08:00:00,774,581,193,FMN GV 16 Berchem TOT
54,Posthofbrug 5366,2022-11-16,09:00:00,261,194,67,FMN GV 16 Berchem TOT
54,Posthofbrug 5366,2022-11-16,10:00:00,140,89,51,FMN GV 16 Berchem TOT
54,Posthofbrug 5366,2022-11-16,11:00:00,164,92,72,FMN GV 16 Berchem TOT
54,Posthofbrug 5366,2022-11-16,12:00:00,336,142,194,FMN GV 16 Berchem TOT
54,Posthofbrug 5366,2022-11-16,13:00:00,252,109,143,FMN GV 16 Berchem TOT
54,Posthofbrug 5366,2022-11-16,14:00:00,192,79,113,FMN GV 16 Berchem TOT
54,Posthofbrug 5366,2022-11-16,15:00:00,203,74,129,FMN GV 16 Berchem TOT
54,Posthofbrug 5366,2022-11-16,16:00:00,414,144,270,FMN GV 16 Berchem TOT
54,Posthofbrug 5366,2022-11-16,17:00:00,580,199,381,FMN GV 16 Berchem TOT
54,Posthofbrug 5366,2022-11-16,18:00:00,378,139,239,FMN GV 16 Berchem TOT
54,Posthofbrug 5366,2022-11-16,19:00:00,198,81,117,FMN GV 16 Berchem TOT
54,Posthofbrug 5366,2022-11-16,20:00:00,93,39,54,FMN GV 16 Berchem TOT
54,Posthofbrug 5366,2022-11-16,21:00:00,80,28,52,FMN GV 16 Berchem TOT
54,Posthofbrug 5366,2022-11-16,22:00:00,91,32,59,FMN GV 16 Berchem TOT
54,Posthofbrug 5366,2022-11-16,23:00:00,70,15,55,FMN GV 16 Berchem TOT
54,Posthofbrug 5366,2022-11-17,00:00:00,0,0,0,FMN GV 16 Berchem TOT
54,Posthofbrug 5366,2022-11-17,01:00:00,10,1,9,FMN GV 16 Berchem TOT
54,Posthofbrug 5366,2022-11-17,02:00:00,17,1,16,FMN GV 16 Berchem TOT
54,Posthofbrug 5366,2022-11-17,03:00:00,11,1,10,FMN GV 16 Berchem TOT
54,Posthofbrug 5366,2022-11-17,04:00:00,16,8,8,FMN GV 16 Berchem TOT
54,Posthofbrug 5366,2022-11-17,05:00:00,29,24,5,FMN GV 16 Berchem TOT
54,Posthofbrug 5366,2022-11-17,06:00:00,113,82,31,FMN GV 16 Berchem TOT
54,Posthofbrug 5366,2022-11-17,07:00:00,410,316,94,FMN GV 16 Berchem TOT
54,Posthofbrug 5366,2022-11-17,08:00:00,827,650,177,FMN GV 16 Berchem TOT
54,Posthofbrug 5366,2022-11-17,09:00:00,256,197,59,FMN GV 16 Berchem TOT
54,Posthofbrug 5366,2022-11-17,10:00:00,129,96,33,FMN GV 16 Berchem TOT
54,Posthofbrug 5366,2022-11-17,11:00:00,110,65,45,FMN GV 16 Berchem TOT
54,Posthofbrug 5366,2022-11-17,12:00:00,152,81,71,FMN GV 16 Berchem TOT
54,Posthofbrug 5366,2022-11-17,13:00:00,154,85,69,FMN GV 16 Berchem TOT
54,Posthofbrug 5366,2022-11-17,14:00:00,112,44,68,FMN GV 16 Berchem TOT
54,Posthofbrug 5366,2022-11-17,15:00:00,242,91,151,FMN GV 16 Berchem TOT
54,Posthofbrug 5366,2022-11-17,16:00:00,455,155,300,FMN GV 16 Berchem TOT
54,Posthofbrug 5366,2022-11-17,17:00:00,604,175,429,FMN GV 16 Berchem TOT
54,Posthofbrug 5366,2022-11-17,18:00:00,383,131,252,FMN GV 16 Berchem TOT
54,Posthofbrug 5366,2022-11-17,19:00:00,224,96,128,FMN GV 16 Berchem TOT
54,Posthofbrug 5366,2022-11-17,20:00:00,126,65,61,FMN GV 16 Berchem TOT
54,Posthofbrug 5366,2022-11-17,21:00:00,120,44,76,FMN GV 16 Berchem TOT
54,Posthofbrug 5366,2022-11-17,22:00:00,128,28,100,FMN GV 16 Berchem TOT
54,Posthofbrug 5366,2022-11-17,23:00:00,70,14,56,FMN GV 16 Berchem TOT
54,Posthofbrug 5366,2022-11-18,00:00:00,0,0,0,FMN GV 16 Berchem TOT
54,Posthofbrug 5366,2022-11-18,01:00:00,13,2,11,FMN GV 16 Berchem TOT
54,Posthofbrug 5366,2022-11-18,02:00:00,10,1,9,FMN GV 16 Berchem TOT
54,Posthofbrug 5366,2022-11-18,03:00:00,10,0,10,FMN GV 16 Berchem TOT
54,Posthofbrug 5366,2022-11-18,04:00:00,13,5,8,FMN GV 16 Berchem TOT
54,Posthofbrug 5366,2022-11-18,05:00:00,27,24,3,FMN GV 16 Berchem TOT
54,Posthofbrug 5366,2022-11-18,06:00:00,119,94,25,FMN GV 16 Berchem TOT
54,Posthofbrug 5366,2022-11-18,07:00:00,394,289,105,FMN GV 16 Berchem TOT
54,Posthofbrug 5366,2022-11-18,08:00:00,727,562,165,FMN GV 16 Berchem TOT
54,Posthofbrug 5366,2022-11-18,09:00:00,247,194,53,FMN GV 16 Berchem TOT
54,Posthofbrug 5366,2022-11-18,10:00:00,158,99,59,FMN GV 16 Berchem TOT
54,Posthofbrug 5366,2022-11-18,11:00:00,127,75,52,FMN GV 16 Berchem TOT
54,Posthofbrug 5366,2022-11-18,12:00:00,208,111,97,FMN GV 16 Berchem TOT
54,Posthofbrug 5366,2022-11-18,13:00:00,162,77,85,FMN GV 16 Berchem TOT
54,Posthofbrug 5366,2022-11-18,14:00:00,133,45,88,FMN GV 16 Berchem TOT
54,Posthofbrug 5366,2022-11-18,15:00:00,264,80,184,FMN GV 16 Berchem TOT
54,Posthofbrug 5366,2022-11-18,16:00:00,405,112,293,FMN GV 16 Berchem TOT
54,Posthofbrug 5366,2022-11-18,17:00:00,428,144,284,FMN GV 16 Berchem TOT
54,Posthofbrug 5366,2022-11-18,18:00:00,246,92,154,FMN GV 16 Berchem TOT
54,Posthofbrug 5366,2022-11-18,19:00:00,124,45,79,FMN GV 16 Berchem TOT
54,Posthofbrug 5366,2022-11-18,20:00:00,84,40,44,FMN GV 16 Berchem TOT
54,Posthofbrug 5366,2022-11-18,21:00:00,77,29,48,FMN GV 16 Berchem TOT
54,Posthofbrug 5366,2022-11-18,22:00:00,73,24,49,FMN GV 16 Berchem TOT
54,Posthofbrug 5366,2022-11-18,23:00:00,65,19,46,FMN GV 16 Berchem TOT
54,Posthofbrug 5366,2022-11-19,00:00:00,0,0,0,FMN GV 16 Berchem TOT
54,Posthofbrug 5366,2022-11-19,01:00:00,24,5,19,FMN GV 16 Berchem TOT
54,Posthofbrug 5366,2022-11-19,02:00:00,31,15,16,FMN GV 16 Berchem TOT
54,Posthofbrug 5366,2022-11-19,03:00:00,21,6,15,FMN GV 16 Berchem TOT
54,Posthofbrug 5366,2022-11-19,04:00:00,12,6,6,FMN GV 16 Berchem TOT
54,Posthofbrug 5366,2022-11-19,05:00:00,26,13,13,FMN GV 16 Berchem TOT
54,Posthofbrug 5366,2022-11-19,06:00:00,18,13,5,FMN GV 16 Berchem TOT
54,Posthofbrug 5366,2022-11-19,07:00:00,35,23,12,FMN GV 16 Berchem TOT
54,Posthofbrug 5366,2022-11-19,08:00:00,47,29,18,FMN GV 16 Berchem TOT
54,Posthofbrug 5366,2022-11-19,09:00:00,94,65,29,FMN GV 16 Berchem TOT
54,Posthofbrug 5366,2022-11-19,10:00:00,88,53,35,FMN GV 16 Berchem TOT
54,Posthofbrug 5366,2022-11-19,11:00:00,107,68,39,FMN GV 16 Berchem TOT
54,Posthofbrug 5366,2022-11-19,12:00:00,131,75,56,FMN GV 16 Berchem TOT
54,Posthofbrug 5366,2022-11-19,13:00:00,128,61,67,FMN GV 16 Berchem TOT
54,Posthofbrug 5366,2022-11-19,14:00:00,146,76,70,FMN GV 16 Berchem TOT
54,Posthofbrug 5366,2022-11-19,15:00:00,131,75,56,FMN GV 16 Berchem TOT
54,Posthofbrug 5366,2022-11-19,16:00:00,131,61,70,FMN GV 16 Berchem TOT
54,Posthofbrug 5366,2022-11-19,17:00:00,161,77,84,FMN GV 16 Berchem TOT
54,Posthofbrug 5366,2022-11-19,18:00:00,147,84,63,FMN GV 16 Berchem TOT
54,Posthofbrug 5366,2022-11-19,19:00:00,115,69,46,FMN GV 16 Berchem TOT
54,Posthofbrug 5366,2022-11-19,20:00:00,85,38,47,FMN GV 16 Berchem TOT
54,Posthofbrug 5366,2022-11-19,21:00:00,58,29,29,FMN GV 16 Berchem TOT
54,Posthofbrug 5366,2022-11-19,22:00:00,54,24,30,FMN GV 16 Berchem TOT
54,Posthofbrug 5366,2022-11-19,23:00:00,68,18,50,FMN GV 16 Berchem TOT
54,Posthofbrug 5366,2022-11-20,00:00:00,0,0,0,FMN GV 16 Berchem TOT
54,Posthofbrug 5366,2022-11-20,01:00:00,35,9,26,FMN GV 16 Berchem TOT
54,Posthofbrug 5366,2022-11-20,02:00:00,24,6,18,FMN GV 16 Berchem TOT
54,Posthofbrug 5366,2022-11-20,03:00:00,15,5,10,FMN GV 16 Berchem TOT
54,Posthofbrug 5366,2022-11-20,04:00:00,18,8,10,FMN GV 16 Berchem TOT
54,Posthofbrug 5366,2022-11-20,05:00:00,17,8,9,FMN GV 16 Berchem TOT
54,Posthofbrug 5366,2022-11-20,06:00:00,19,11,8,FMN GV 16 Berchem TOT
54,Posthofbrug 5366,2022-11-20,07:00:00,24,13,11,FMN GV 16 Berchem TOT
54,Posthofbrug 5366,2022-11-20,08:00:00,40,29,11,FMN GV 16 Berchem TOT
54,Posthofbrug 5366,2022-11-20,09:00:00,105,63,42,FMN GV 16 Berchem TOT
54,Posthofbrug 5366,2022-11-20,10:00:00,106,58,48,FMN GV 16 Berchem TOT
54,Posthofbrug 5366,2022-11-20,11:00:00,83,49,34,FMN GV 16 Berchem TOT
54,Posthofbrug 5366,2022-11-20,12:00:00,118,62,56,FMN GV 16 Berchem TOT
54,Posthofbrug 5366,2022-11-20,13:00:00,92,40,52,FMN GV 16 Berchem TOT
54,Posthofbrug 5366,2022-11-20,14:00:00,72,25,47,FMN GV 16 Berchem TOT
54,Posthofbrug 5366,2022-11-20,15:00:00,69,40,29,FMN GV 16 Berchem TOT
54,Posthofbrug 5366,2022-11-20,16:00:00,89,31,58,FMN GV 16 Berchem TOT
54,Posthofbrug 5366,2022-11-20,17:00:00,80,36,44,FMN GV 16 Berchem TOT
54,Posthofbrug 5366,2022-11-20,18:00:00,70,41,29,FMN GV 16 Berchem TOT
54,Posthofbrug 5366,2022-11-20,19:00:00,73,36,37,FMN GV 16 Berchem TOT
54,Posthofbrug 5366,2022-11-20,20:00:00,54,25,29,FMN GV 16 Berchem TOT
54,Posthofbrug 5366,2022-11-20,21:00:00,63,25,38,FMN GV 16 Berchem TOT
54,Posthofbrug 5366,2022-11-20,22:00:00,42,15,27,FMN GV 16 Berchem TOT
54,Posthofbrug 5366,2022-11-20,23:00:00,28,5,23,FMN GV 16 Berchem TOT
54,Posthofbrug 5366,2022-11-21,00:00:00,0,0,0,FMN GV 16 Berchem TOT
54,Posthofbrug 5366,2022-11-21,01:00:00,2,0,2,FMN GV 16 Berchem TOT
54,Posthofbrug 5366,2022-11-21,02:00:00,1,0,1,FMN GV 16 Berchem TOT
54,Posthofbrug 5366,2022-11-21,03:00:00,3,1,2,FMN GV 16 Berchem TOT
54,Posthofbrug 5366,2022-11-21,04:00:00,7,4,3,FMN GV 16 Berchem TOT
54,Posthofbrug 5366,2022-11-21,05:00:00,36,31,5,FMN GV 16 Berchem TOT
54,Posthofbrug 5366,2022-11-21,06:00:00,125,102,23,FMN GV 16 Berchem TOT
54,Posthofbrug 5366,2022-11-21,07:00:00,367,23,344,FMN GV 16 Berchem TOT
54,Posthofbrug 5366,2022-11-21,08:00:00,746,31,715,FMN GV 16 Berchem TOT
54,Posthofbrug 5366,2022-11-21,09:00:00,285,12,273,FMN GV 16 Berchem TOT
54,Posthofbrug 5366,2022-11-21,10:00:00,147,0,147,FMN GV 16 Berchem TOT
54,Posthofbrug 5366,2022-11-21,11:00:00,123,3,120,FMN GV 16 Berchem TOT
54,Posthofbrug 5366,2022-11-21,12:00:00,185,6,179,FMN GV 16 Berchem TOT
54,Posthofbrug 5366,2022-11-21,13:00:00,146,4,142,FMN GV 16 Berchem TOT
54,Posthofbrug 5366,2022-11-21,14:00:00,145,5,140,FMN GV 16 Berchem TOT
54,Posthofbrug 5366,2022-11-21,15:00:00,250,8,242,FMN GV 16 Berchem TOT
54,Posthofbrug 5366,2022-11-21,16:00:00,411,28,383,FMN GV 16 Berchem TOT
54,Posthofbrug 5366,2022-11-21,17:00:00,503,27,476,FMN GV 16 Berchem TOT
54,Posthofbrug 5366,2022-11-21,18:00:00,294,11,283,FMN GV 16 Berchem TOT
54,Posthofbrug 5366,2022-11-21,19:00:00,124,4,120,FMN GV 16 Berchem TOT
54,Posthofbrug 5366,2022-11-21,20:00:00,67,8,59,FMN GV 16 Berchem TOT
54,Posthofbrug 5366,2022-11-21,21:00:00,60,5,55,FMN GV 16 Berchem TOT
54,Posthofbrug 5366,2022-11-21,22:00:00,55,3,52,FMN GV 16 Berchem TOT
54,Posthofbrug 5366,2022-11-21,23:00:00,24,1,23,FMN GV 16 Berchem TOT
54,Posthofbrug 5366,2022-11-22,00:00:00,0,0,0,FMN GV 16 Berchem TOT
54,Posthofbrug 5366,2022-11-22,01:00:00,1,0,1,FMN GV 16 Berchem TOT
54,Posthofbrug 5366,2022-11-22,02:00:00,3,0,3,FMN GV 16 Berchem TOT
54,Posthofbrug 5366,2022-11-22,03:00:00,0,0,0,FMN GV 16 Berchem TOT
54,Posthofbrug 5366,2022-11-22,04:00:00,1,0,1,FMN GV 16 Berchem TOT
54,Posthofbrug 5366,2022-11-22,05:00:00,30,8,22,FMN GV 16 Berchem TOT
54,Posthofbrug 5366,2022-11-22,06:00:00,96,20,76,FMN GV 16 Berchem TOT
54,Posthofbrug 5366,2022-11-22,07:00:00,385,35,350,FMN GV 16 Berchem TOT
54,Posthofbrug 5366,2022-11-22,08:00:00,727,54,673,FMN GV 16 Berchem TOT
54,Posthofbrug 5366,2022-11-22,09:00:00,216,13,203,FMN GV 16 Berchem TOT
54,Posthofbrug 5366,2022-11-22,10:00:00,93,13,80,FMN GV 16 Berchem TOT
54,Posthofbrug 5366,2022-11-22,11:00:00,81,3,78,FMN GV 16 Berchem TOT
54,Posthofbrug 5366,2022-11-22,12:00:00,120,14,106,FMN GV 16 Berchem TOT
54,Posthofbrug 5366,2022-11-22,13:00:00,111,10,101,FMN GV 16 Berchem TOT
54,Posthofbrug 5366,2022-11-22,14:00:00,89,5,84,FMN GV 16 Berchem TOT
54,Posthofbrug 5366,2022-11-22,15:00:00,207,18,189,FMN GV 16 Berchem TOT
54,Posthofbrug 5366,2022-11-22,16:00:00,375,26,349,FMN GV 16 Berchem TOT
54,Posthofbrug 5366,2022-11-22,17:00:00,557,40,517,FMN GV 16 Berchem TOT
54,Posthofbrug 5366,2022-11-22,18:00:00,295,38,257,FMN GV 16 Berchem TOT
54,Posthofbrug 5366,2022-11-22,19:00:00,38,20,18,FMN GV 16 Berchem TOT
54,Posthofbrug 5366,2022-11-22,20:00:00,14,9,5,FMN GV 16 Berchem TOT
54,Posthofbrug 5366,2022-11-22,21:00:00,15,11,4,FMN GV 16 Berchem TOT
54,Posthofbrug 5366,2022-11-22,22:00:00,27,10,17,FMN GV 16 Berchem TOT
54,Posthofbrug 5366,2022-11-22,23:00:00,11,9,2,FMN GV 16 Berchem TOT
54,Posthofbrug 5366,2022-11-23,00:00:00,0,0,0,FMN GV 16 Berchem TOT
54,Posthofbrug 5366,2022-11-23,01:00:00,2,2,0,FMN GV 16 Berchem TOT
54,Posthofbrug 5366,2022-11-23,02:00:00,2,2,0,FMN GV 16 Berchem TOT
54,Posthofbrug 5366,2022-11-23,03:00:00,0,0,0,FMN GV 16 Berchem TOT
54,Posthofbrug 5366,2022-11-23,04:00:00,2,0,2,FMN GV 16 Berchem TOT
54,Posthofbrug 5366,2022-11-23,05:00:00,12,4,8,FMN GV 16 Berchem TOT
54,Posthofbrug 5366,2022-11-23,06:00:00,30,15,15,FMN GV 16 Berchem TOT
54,Posthofbrug 5366,2022-11-23,07:00:00,86,61,25,FMN GV 16 Berchem TOT
54,Posthofbrug 5366,2022-11-23,08:00:00,154,95,59,FMN GV 16 Berchem TOT
54,Posthofbrug 5366,2022-11-23,09:00:00,42,27,15,FMN GV 16 Berchem TOT
54,Posthofbrug 5366,2022-11-23,10:00:00,36,20,16,FMN GV 16 Berchem TOT
54,Posthofbrug 5366,2022-11-23,11:00:00,26,23,3,FMN GV 16 Berchem TOT
54,Posthofbrug 5366,2022-11-23,12:00:00,106,85,21,FMN GV 16 Berchem TOT
54,Posthofbrug 5366,2022-11-23,13:00:00,172,90,82,FMN GV 16 Berchem TOT
54,Posthofbrug 5366,2022-11-23,14:00:00,116,38,78,FMN GV 16 Berchem TOT
54,Posthofbrug 5366,2022-11-23,15:00:00,151,49,102,FMN GV 16 Berchem TOT
54,Posthofbrug 5366,2022-11-23,16:00:00,340,113,227,FMN GV 16 Berchem TOT
54,Posthofbrug 5366,2022-11-23,17:00:00,541,186,355,FMN GV 16 Berchem TOT
54,Posthofbrug 5366,2022-11-23,18:00:00,352,133,219,FMN GV 16 Berchem TOT
54,Posthofbrug 5366,2022-11-23,19:00:00,229,104,125,FMN GV 16 Berchem TOT
54,Posthofbrug 5366,2022-11-23,20:00:00,89,43,46,FMN GV 16 Berchem TOT
54,Posthofbrug 5366,2022-11-23,21:00:00,72,24,48,FMN GV 16 Berchem TOT
54,Posthofbrug 5366,2022-11-23,22:00:00,132,39,93,FMN GV 16 Berchem TOT
54,Posthofbrug 5366,2022-11-23,23:00:00,73,24,49,FMN GV 16 Berchem TOT
54,Posthofbrug 5366,2022-11-24,00:00:00,35,9,26,FMN GV 16 Berchem TOT
54,Posthofbrug 5366,2022-11-24,01:00:00,12,3,9,FMN GV 16 Berchem TOT
54,Posthofbrug 5366,2022-11-24,02:00:00,7,0,7,FMN GV 16 Berchem TOT
54,Posthofbrug 5366,2022-11-24,03:00:00,3,0,3,FMN GV 16 Berchem TOT
54,Posthofbrug 5366,2022-11-24,04:00:00,8,7,1,FMN GV 16 Berchem TOT
54,Posthofbrug 5366,2022-11-24,05:00:00,33,27,6,FMN GV 16 Berchem TOT
54,Posthofbrug 5366,2022-11-24,06:00:00,126,102,24,FMN GV 16 Berchem TOT
54,Posthofbrug 5366,2022-11-24,07:00:00,511,403,108,FMN GV 16 Berchem TOT
54,Posthofbrug 5366,2022-11-24,08:00:00,970,747,223,FMN GV 16 Berchem TOT
54,Posthofbrug 5366,2022-11-24,09:00:00,321,262,59,FMN GV 16 Berchem TOT
54,Posthofbrug 5366,2022-11-24,10:00:00,160,110,50,FMN GV 16 Berchem TOT
54,Posthofbrug 5366,2022-11-24,11:00:00,152,88,64,FMN GV 16 Berchem TOT
54,Posthofbrug 5366,2022-11-24,12:00:00,208,113,95,FMN GV 16 Berchem TOT
54,Posthofbrug 5366,2022-11-24,13:00:00,230,116,114,FMN GV 16 Berchem TOT
54,Posthofbrug 5366,2022-11-24,14:00:00,186,80,106,FMN GV 16 Berchem TOT
54,Posthofbrug 5366,2022-11-24,15:00:00,298,109,189,FMN GV 16 Berchem TOT
54,Posthofbrug 5366,2022-11-24,16:00:00,514,138,376,FMN GV 16 Berchem TOT
54,Posthofbrug 5366,2022-11-24,17:00:00,696,200,496,FMN GV 16 Berchem TOT
54,Posthofbrug 5366,2022-11-24,18:00:00,426,134,292,FMN GV 16 Berchem TOT
54,Posthofbrug 5366,2022-11-24,19:00:00,191,81,110,FMN GV 16 Berchem TOT
54,Posthofbrug 5366,2022-11-24,20:00:00,117,48,69,FMN GV 16 Berchem TOT
54,Posthofbrug 5366,2022-11-24,21:00:00,107,33,74,FMN GV 16 Berchem TOT
54,Posthofbrug 5366,2022-11-24,22:00:00,104,24,80,FMN GV 16 Berchem TOT
54,Posthofbrug 5366,2022-11-24,23:00:00,72,19,53,FMN GV 16 Berchem TOT
54,Posthofbrug 5366,2022-11-25,00:00:00,46,22,24,FMN GV 16 Berchem TOT
54,Posthofbrug 5366,2022-11-25,01:00:00,19,2,17,FMN GV 16 Berchem TOT
54,Posthofbrug 5366,2022-11-25,02:00:00,11,0,11,FMN GV 16 Berchem TOT
54,Posthofbrug 5366,2022-11-25,03:00:00,18,2,16,FMN GV 16 Berchem TOT
54,Posthofbrug 5366,2022-11-25,04:00:00,25,8,17,FMN GV 16 Berchem TOT
54,Posthofbrug 5366,2022-11-25,05:00:00,44,27,17,FMN GV 16 Berchem TOT
54,Posthofbrug 5366,2022-11-25,06:00:00,99,75,24,FMN GV 16 Berchem TOT
54,Posthofbrug 5366,2022-11-25,07:00:00,400,304,96,FMN GV 16 Berchem TOT
54,Posthofbrug 5366,2022-11-25,08:00:00,685,528,157,FMN GV 16 Berchem TOT
54,Posthofbrug 5366,2022-11-25,09:00:00,294,231,63,FMN GV 16 Berchem TOT
54,Posthofbrug 5366,2022-11-25,10:00:00,159,107,52,FMN GV 16 Berchem TOT
54,Posthofbrug 5366,2022-11-25,11:00:00,147,89,58,FMN GV 16 Berchem TOT
54,Posthofbrug 5366,2022-11-25,12:00:00,231,117,114,FMN GV 16 Berchem TOT
54,Posthofbrug 5366,2022-11-25,13:00:00,174,74,100,FMN GV 16 Berchem TOT
54,Posthofbrug 5366,2022-11-25,14:00:00,188,87,101,FMN GV 16 Berchem TOT
54,Posthofbrug 5366,2022-11-25,15:00:00,321,101,220,FMN GV 16 Berchem TOT
54,Posthofbrug 5366,2022-11-25,16:00:00,456,145,311,FMN GV 16 Berchem TOT
54,Posthofbrug 5366,2022-11-25,17:00:00,528,162,366,FMN GV 16 Berchem TOT
54,Posthofbrug 5366,2022-11-25,18:00:00,330,131,199,FMN GV 16 Berchem TOT
54,Posthofbrug 5366,2022-11-25,19:00:00,210,105,105,FMN GV 16 Berchem TOT
54,Posthofbrug 5366,2022-11-25,20:00:00,95,55,40,FMN GV 16 Berchem TOT
54,Posthofbrug 5366,2022-11-25,21:00:00,96,38,58,FMN GV 16 Berchem TOT
54,Posthofbrug 5366,2022-11-25,22:00:00,101,41,60,FMN GV 16 Berchem TOT
54,Posthofbrug 5366,2022-11-25,23:00:00,114,44,70,FMN GV 16 Berchem TOT
54,Posthofbrug 5366,2022-11-26,00:00:00,80,28,52,FMN GV 16 Berchem TOT
54,Posthofbrug 5366,2022-11-26,01:00:00,45,16,29,FMN GV 16 Berchem TOT
54,Posthofbrug 5366,2022-11-26,02:00:00,40,9,31,FMN GV 16 Berchem TOT
54,Posthofbrug 5366,2022-11-26,03:00:00,25,4,21,FMN GV 16 Berchem TOT
54,Posthofbrug 5366,2022-11-26,04:00:00,17,7,10,FMN GV 16 Berchem TOT
54,Posthofbrug 5366,2022-11-26,05:00:00,19,11,8,FMN GV 16 Berchem TOT
54,Posthofbrug 5366,2022-11-26,06:00:00,17,8,9,FMN GV 16 Berchem TOT
54,Posthofbrug 5366,2022-11-26,07:00:00,43,19,24,FMN GV 16 Berchem TOT
54,Posthofbrug 5366,2022-11-26,08:00:00,85,42,43,FMN GV 16 Berchem TOT
54,Posthofbrug 5366,2022-11-26,09:00:00,139,94,45,FMN GV 16 Berchem TOT
54,Posthofbrug 5366,2022-11-26,10:00:00,163,103,60,FMN GV 16 Berchem TOT
54,Posthofbrug 5366,2022-11-26,11:00:00,200,130,70,FMN GV 16 Berchem TOT
54,Posthofbrug 5366,2022-11-26,12:00:00,178,111,67,FMN GV 16 Berchem TOT
54,Posthofbrug 5366,2022-11-26,13:00:00,204,124,80,FMN GV 16 Berchem TOT
54,Posthofbrug 5366,2022-11-26,14:00:00,207,121,86,FMN GV 16 Berchem TOT
54,Posthofbrug 5366,2022-11-26,15:00:00,187,82,105,FMN GV 16 Berchem TOT
54,Posthofbrug 5366,2022-11-26,16:00:00,175,79,96,FMN GV 16 Berchem TOT
54,Posthofbrug 5366,2022-11-26,17:00:00,222,82,140,FMN GV 16 Berchem TOT
54,Posthofbrug 5366,2022-11-26,18:00:00,190,110,80,FMN GV 16 Berchem TOT
54,Posthofbrug 5366,2022-11-26,19:00:00,144,81,63,FMN GV 16 Berchem TOT
54,Posthofbrug 5366,2022-11-26,20:00:00,93,47,46,FMN GV 16 Berchem TOT
54,Posthofbrug 5366,2022-11-26,21:00:00,72,43,29,FMN GV 16 Berchem TOT
54,Posthofbrug 5366,2022-11-26,22:00:00,92,29,63,FMN GV 16 Berchem TOT
54,Posthofbrug 5366,2022-11-26,23:00:00,94,21,73,FMN GV 16 Berchem TOT
54,Posthofbrug 5366,2022-11-27,00:00:00,77,18,59,FMN GV 16 Berchem TOT
54,Posthofbrug 5366,2022-11-27,01:00:00,64,29,35,FMN GV 16 Berchem TOT
54,Posthofbrug 5366,2022-11-27,02:00:00,37,11,26,FMN GV 16 Berchem TOT
54,Posthofbrug 5366,2022-11-27,03:00:00,40,6,34,FMN GV 16 Berchem TOT
54,Posthofbrug 5366,2022-11-27,04:00:00,25,6,19,FMN GV 16 Berchem TOT
54,Posthofbrug 5366,2022-11-27,05:00:00,21,7,14,FMN GV 16 Berchem TOT
54,Posthofbrug 5366,2022-11-27,06:00:00,15,6,9,FMN GV 16 Berchem TOT
54,Posthofbrug 5366,2022-11-27,07:00:00,26,16,10,FMN GV 16 Berchem TOT
54,Posthofbrug 5366,2022-11-27,08:00:00,28,16,12,FMN GV 16 Berchem TOT
54,Posthofbrug 5366,2022-11-27,09:00:00,62,41,21,FMN GV 16 Berchem TOT
54,Posthofbrug 5366,2022-11-27,10:00:00,85,53,32,FMN GV 16 Berchem TOT
54,Posthofbrug 5366,2022-11-27,11:00:00,69,38,31,FMN GV 16 Berchem TOT
54,Posthofbrug 5366,2022-11-27,12:00:00,88,52,36,FMN GV 16 Berchem TOT
54,Posthofbrug 5366,2022-11-27,13:00:00,145,61,84,FMN GV 16 Berchem TOT
54,Posthofbrug 5366,2022-11-27,14:00:00,76,44,32,FMN GV 16 Berchem TOT
54,Posthofbrug 5366,2022-11-27,15:00:00,82,41,41,FMN GV 16 Berchem TOT
54,Posthofbrug 5366,2022-11-27,16:00:00,95,53,42,FMN GV 16 Berchem TOT
54,Posthofbrug 5366,2022-11-27,17:00:00,107,65,42,FMN GV 16 Berchem TOT
54,Posthofbrug 5366,2022-11-27,18:00:00,83,38,45,FMN GV 16 Berchem TOT
54,Posthofbrug 5366,2022-11-27,19:00:00,54,18,36,FMN GV 16 Berchem TOT
54,Posthofbrug 5366,2022-11-27,20:00:00,34,12,22,FMN GV 16 Berchem TOT
54,Posthofbrug 5366,2022-11-27,21:00:00,48,22,26,FMN GV 16 Berchem TOT
54,Posthofbrug 5366,2022-11-27,22:00:00,37,13,24,FMN GV 16 Berchem TOT
54,Posthofbrug 5366,2022-11-27,23:00:00,22,9,13,FMN GV 16 Berchem TOT
54,Posthofbrug 5366,2022-11-28,00:00:00,9,3,6,FMN GV 16 Berchem TOT
54,Posthofbrug 5366,2022-11-28,01:00:00,4,1,3,FMN GV 16 Berchem TOT
54,Posthofbrug 5366,2022-11-28,02:00:00,2,0,2,FMN GV 16 Berchem TOT
54,Posthofbrug 5366,2022-11-28,03:00:00,2,0,2,FMN GV 16 Berchem TOT
54,Posthofbrug 5366,2022-11-28,04:00:00,9,7,2,FMN GV 16 Berchem TOT
54,Posthofbrug 5366,2022-11-28,05:00:00,27,21,6,FMN GV 16 Berchem TOT
54,Posthofbrug 5366,2022-11-28,06:00:00,101,80,21,FMN GV 16 Berchem TOT
54,Posthofbrug 5366,2022-11-28,07:00:00,424,335,89,FMN GV 16 Berchem TOT
54,Posthofbrug 5366,2022-11-28,08:00:00,830,652,178,FMN GV 16 Berchem TOT
54,Posthofbrug 5366,2022-11-28,09:00:00,253,196,57,FMN GV 16 Berchem TOT
54,Posthofbrug 5366,2022-11-28,10:00:00,141,97,44,FMN GV 16 Berchem TOT
54,Posthofbrug 5366,2022-11-28,11:00:00,109,74,35,FMN GV 16 Berchem TOT
54,Posthofbrug 5366,2022-11-28,12:00:00,174,81,93,FMN GV 16 Berchem TOT
54,Posthofbrug 5366,2022-11-28,13:00:00,136,74,62,FMN GV 16 Berchem TOT
54,Posthofbrug 5366,2022-11-28,14:00:00,127,54,73,FMN GV 16 Berchem TOT
54,Posthofbrug 5366,2022-11-28,15:00:00,277,90,187,FMN GV 16 Berchem TOT
54,Posthofbrug 5366,2022-11-28,16:00:00,464,128,336,FMN GV 16 Berchem TOT
54,Posthofbrug 5366,2022-11-28,17:00:00,607,180,427,FMN GV 16 Berchem TOT
54,Posthofbrug 5366,2022-11-28,18:00:00,386,117,269,FMN GV 16 Berchem TOT
54,Posthofbrug 5366,2022-11-28,19:00:00,190,54,136,FMN GV 16 Berchem TOT
54,Posthofbrug 5366,2022-11-28,20:00:00,97,34,63,FMN GV 16 Berchem TOT
54,Posthofbrug 5366,2022-11-28,21:00:00,99,39,60,FMN GV 16 Berchem TOT
54,Posthofbrug 5366,2022-11-28,22:00:00,88,32,56,FMN GV 16 Berchem TOT
54,Posthofbrug 5366,2022-11-28,23:00:00,40,11,29,FMN GV 16 Berchem TOT
54,Posthofbrug 5366,2022-11-29,00:00:00,11,4,7,FMN GV 16 Berchem TOT
54,Posthofbrug 5366,2022-11-29,01:00:00,5,1,4,FMN GV 16 Berchem TOT
54,Posthofbrug 5366,2022-11-29,02:00:00,4,0,4,FMN GV 16 Berchem TOT
54,Posthofbrug 5366,2022-11-29,03:00:00,1,0,1,FMN GV 16 Berchem TOT
54,Posthofbrug 5366,2022-11-29,04:00:00,11,7,4,FMN GV 16 Berchem TOT
54,Posthofbrug 5366,2022-11-29,05:00:00,39,27,12,FMN GV 16 Berchem TOT
54,Posthofbrug 5366,2022-11-29,06:00:00,120,96,24,FMN GV 16 Berchem TOT
54,Posthofbrug 5366,2022-11-29,07:00:00,463,373,90,FMN GV 16 Berchem TOT
54,Posthofbrug 5366,2022-11-29,08:00:00,893,713,180,FMN GV 16 Berchem TOT
54,Posthofbrug 5366,2022-11-29,09:00:00,300,233,67,FMN GV 16 Berchem TOT
54,Posthofbrug 5366,2022-11-29,10:00:00,152,120,32,FMN GV 16 Berchem TOT
54,Posthofbrug 5366,2022-11-29,11:00:00,134,83,51,FMN GV 16 Berchem TOT
54,Posthofbrug 5366,2022-11-29,12:00:00,221,121,100,FMN GV 16 Berchem TOT
54,Posthofbrug 5366,2022-11-29,13:00:00,216,122,94,FMN GV 16 Berchem TOT
54,Posthofbrug 5366,2022-11-29,14:00:00,169,64,105,FMN GV 16 Berchem TOT
54,Posthofbrug 5366,2022-11-29,15:00:00,297,85,212,FMN GV 16 Berchem TOT
54,Posthofbrug 5366,2022-11-29,16:00:00,563,143,420,FMN GV 16 Berchem TOT
54,Posthofbrug 5366,2022-11-29,17:00:00,642,168,474,FMN GV 16 Berchem TOT
54,Posthofbrug 5366,2022-11-29,18:00:00,430,129,301,FMN GV 16 Berchem TOT
54,Posthofbrug 5366,2022-11-29,19:00:00,188,80,108,FMN GV 16 Berchem TOT
54,Posthofbrug 5366,2022-11-29,20:00:00,106,47,59,FMN GV 16 Berchem TOT
54,Posthofbrug 5366,2022-11-29,21:00:00,112,55,57,FMN GV 16 Berchem TOT
54,Posthofbrug 5366,2022-11-29,22:00:00,93,22,71,FMN GV 16 Berchem TOT
54,Posthofbrug 5366,2022-11-29,23:00:00,43,18,25,FMN GV 16 Berchem TOT
54,Posthofbrug 5366,2022-11-30,00:00:00,23,9,14,FMN GV 16 Berchem TOT
54,Posthofbrug 5366,2022-11-30,01:00:00,12,1,11,FMN GV 16 Berchem TOT
54,Posthofbrug 5366,2022-11-30,02:00:00,8,0,8,FMN GV 16 Berchem TOT
54,Posthofbrug 5366,2022-11-30,03:00:00,7,2,5,FMN GV 16 Berchem TOT
54,Posthofbrug 5366,2022-11-30,04:00:00,10,6,4,FMN GV 16 Berchem TOT
54,Posthofbrug 5366,2022-11-30,05:00:00,38,26,12,FMN GV 16 Berchem TOT
54,Posthofbrug 5366,2022-11-30,06:00:00,121,98,23,FMN GV 16 Berchem TOT
54,Posthofbrug 5366,2022-11-30,07:00:00,383,304,79,FMN GV 16 Berchem TOT
54,Posthofbrug 5366,2022-11-30,08:00:00,793,614,179,FMN GV 16 Berchem TOT
54,Posthofbrug 5366,2022-11-30,09:00:00,249,196,53,FMN GV 16 Berchem TOT
54,Posthofbrug 5366,2022-11-30,10:00:00,147,90,57,FMN GV 16 Berchem TOT
54,Posthofbrug 5366,2022-11-30,11:00:00,131,63,68,FMN GV 16 Berchem TOT
54,Posthofbrug 5366,2022-11-30,12:00:00,330,136,194,FMN GV 16 Berchem TOT
54,Posthofbrug 5366,2022-11-30,13:00:00,233,106,127,FMN GV 16 Berchem TOT
54,Posthofbrug 5366,2022-11-30,14:00:00,202,90,112,FMN GV 16 Berchem TOT
54,Posthofbrug 5366,2022-11-30,15:00:00,222,78,144,FMN GV 16 Berchem TOT
54,Posthofbrug 5366,2022-11-30,16:00:00,376,115,261,FMN GV 16 Berchem TOT
54,Posthofbrug 5366,2022-11-30,17:00:00,543,162,381,FMN GV 16 Berchem TOT
54,Posthofbrug 5366,2022-11-30,18:00:00,350,116,234,FMN GV 16 Berchem TOT
54,Posthofbrug 5366,2022-11-30,19:00:00,215,94,121,FMN GV 16 Berchem TOT
54,Posthofbrug 5366,2022-11-30,20:00:00,118,59,59,FMN GV 16 Berchem TOT
54,Posthofbrug 5366,2022-11-30,21:00:00,107,50,57,FMN GV 16 Berchem TOT
54,Posthofbrug 5366,2022-11-30,22:00:00,87,20,67,FMN GV 16 Berchem TOT
54,Posthofbrug 5366,2022-11-30,23:00:00,46,15,31,FMN GV 16 Berchem TOT
54,Posthofbrug 5366,2022-12-01,00:00:00,27,5,22,FMN GV 16 Berchem TOT
54,Posthofbrug 5366,2022-12-01,01:00:00,7,1,6,FMN GV 16 Berchem TOT
54,Posthofbrug 5366,2022-12-01,02:00:00,5,0,5,FMN GV 16 Berchem TOT
54,Posthofbrug 5366,2022-12-01,03:00:00,11,4,7,FMN GV 16 Berchem TOT
54,Posthofbrug 5366,2022-12-01,04:00:00,8,5,3,FMN GV 16 Berchem TOT
54,Posthofbrug 5366,2022-12-01,05:00:00,30,20,10,FMN GV 16 Berchem TOT
54,Posthofbrug 5366,2022-12-01,06:00:00,127,100,27,FMN GV 16 Berchem TOT
54,Posthofbrug 5366,2022-12-01,07:00:00,430,344,86,FMN GV 16 Berchem TOT
54,Posthofbrug 5366,2022-12-01,08:00:00,917,734,183,FMN GV 16 Berchem TOT
54,Posthofbrug 5366,2022-12-01,09:00:00,322,264,58,FMN GV 16 Berchem TOT
54,Posthofbrug 5366,2022-12-01,10:00:00,147,95,52,FMN GV 16 Berchem TOT
54,Posthofbrug 5366,2022-12-01,11:00:00,125,78,47,FMN GV 16 Berchem TOT
54,Posthofbrug 5366,2022-12-01,12:00:00,201,100,101,FMN GV 16 Berchem TOT
54,Posthofbrug 5366,2022-12-01,13:00:00,177,77,100,FMN GV 16 Berchem TOT
54,Posthofbrug 5366,2022-12-01,14:00:00,176,65,111,FMN GV 16 Berchem TOT
54,Posthofbrug 5366,2022-12-01,15:00:00,361,108,253,FMN GV 16 Berchem TOT
54,Posthofbrug 5366,2022-12-01,16:00:00,456,132,324,FMN GV 16 Berchem TOT
54,Posthofbrug 5366,2022-12-01,17:00:00,470,118,352,FMN GV 16 Berchem TOT
54,Posthofbrug 5366,2022-12-01,18:00:00,431,146,285,FMN GV 16 Berchem TOT
54,Posthofbrug 5366,2022-12-01,19:00:00,218,87,131,FMN GV 16 Berchem TOT
54,Posthofbrug 5366,2022-12-01,20:00:00,108,51,57,FMN GV 16 Berchem TOT
54,Posthofbrug 5366,2022-12-01,21:00:00,121,54,67,FMN GV 16 Berchem TOT
54,Posthofbrug 5366,2022-12-01,22:00:00,110,35,75,FMN GV 16 Berchem TOT
54,Posthofbrug 5366,2022-12-01,23:00:00,71,26,45,FMN GV 16 Berchem TOT
54,Posthofbrug 5366,2022-12-02,00:00:00,30,3,27,FMN GV 16 Berchem TOT
54,Posthofbrug 5366,2022-12-02,01:00:00,18,0,18,FMN GV 16 Berchem TOT
54,Posthofbrug 5366,2022-12-02,02:00:00,3,0,3,FMN GV 16 Berchem TOT
54,Posthofbrug 5366,2022-12-02,03:00:00,6,2,4,FMN GV 16 Berchem TOT
54,Posthofbrug 5366,2022-12-02,04:00:00,10,7,3,FMN GV 16 Berchem TOT
54,Posthofbrug 5366,2022-12-02,05:00:00,29,19,10,FMN GV 16 Berchem TOT
54,Posthofbrug 5366,2022-12-02,06:00:00,129,98,31,FMN GV 16 Berchem TOT
54,Posthofbrug 5366,2022-12-02,07:00:00,399,312,87,FMN GV 16 Berchem TOT
54,Posthofbrug 5366,2022-12-02,08:00:00,718,549,169,FMN GV 16 Berchem TOT
54,Posthofbrug 5366,2022-12-02,09:00:00,282,222,60,FMN GV 16 Berchem TOT
54,Posthofbrug 5366,2022-12-02,10:00:00,161,112,49,FMN GV 16 Berchem TOT
54,Posthofbrug 5366,2022-12-02,11:00:00,137,85,52,FMN GV 16 Berchem TOT
54,Posthofbrug 5366,2022-12-02,12:00:00,221,101,120,FMN GV 16 Berchem TOT
54,Posthofbrug 5366,2022-12-02,13:00:00,179,83,96,FMN GV 16 Berchem TOT
54,Posthofbrug 5366,2022-12-02,14:00:00,169,62,107,FMN GV 16 Berchem TOT
54,Posthofbrug 5366,2022-12-02,15:00:00,288,94,194,FMN GV 16 Berchem TOT
54,Posthofbrug 5366,2022-12-02,16:00:00,434,140,294,FMN GV 16 Berchem TOT
54,Posthofbrug 5366,2022-12-02,17:00:00,454,133,321,FMN GV 16 Berchem TOT
54,Posthofbrug 5366,2022-12-02,18:00:00,333,134,199,FMN GV 16 Berchem TOT
54,Posthofbrug 5366,2022-12-02,19:00:00,206,110,96,FMN GV 16 Berchem TOT
54,Posthofbrug 5366,2022-12-02,20:00:00,107,62,45,FMN GV 16 Berchem TOT
54,Posthofbrug 5366,2022-12-02,21:00:00,80,30,50,FMN GV 16 Berchem TOT
54,Posthofbrug 5366,2022-12-02,22:00:00,79,20,59,FMN GV 16 Berchem TOT
54,Posthofbrug 5366,2022-12-02,23:00:00,99,22,77,FMN GV 16 Berchem TOT
54,Posthofbrug 5366,2022-12-03,00:00:00,61,21,40,FMN GV 16 Berchem TOT
54,Posthofbrug 5366,2022-12-03,01:00:00,37,10,27,FMN GV 16 Berchem TOT
54,Posthofbrug 5366,2022-12-03,02:00:00,34,9,25,FMN GV 16 Berchem TOT
54,Posthofbrug 5366,2022-12-03,03:00:00,27,7,20,FMN GV 16 Berchem TOT
54,Posthofbrug 5366,2022-12-03,04:00:00,17,7,10,FMN GV 16 Berchem TOT
54,Posthofbrug 5366,2022-12-03,05:00:00,14,10,4,FMN GV 16 Berchem TOT
54,Posthofbrug 5366,2022-12-03,06:00:00,20,9,11,FMN GV 16 Berchem TOT
54,Posthofbrug 5366,2022-12-03,07:00:00,37,24,13,FMN GV 16 Berchem TOT
54,Posthofbrug 5366,2022-12-03,08:00:00,49,31,18,FMN GV 16 Berchem TOT
54,Posthofbrug 5366,2022-12-03,09:00:00,132,86,46,FMN GV 16 Berchem TOT
54,Posthofbrug 5366,2022-12-03,10:00:00,130,76,54,FMN GV 16 Berchem TOT
54,Posthofbrug 5366,2022-12-03,11:00:00,138,85,53,FMN GV 16 Berchem TOT
54,Posthofbrug 5366,2022-12-03,12:00:00,130,71,59,FMN GV 16 Berchem TOT
54,Posthofbrug 5366,2022-12-03,13:00:00,141,70,71,FMN GV 16 Berchem TOT
54,Posthofbrug 5366,2022-12-03,14:00:00,170,96,74,FMN GV 16 Berchem TOT
54,Posthofbrug 5366,2022-12-03,15:00:00,126,62,64,FMN GV 16 Berchem TOT
54,Posthofbrug 5366,2022-12-03,16:00:00,141,64,77,FMN GV 16 Berchem TOT
54,Posthofbrug 5366,2022-12-03,17:00:00,145,63,82,FMN GV 16 Berchem TOT
54,Posthofbrug 5366,2022-12-03,18:00:00,119,56,63,FMN GV 16 Berchem TOT
54,Posthofbrug 5366,2022-12-03,19:00:00,124,74,50,FMN GV 16 Berchem TOT
54,Posthofbrug 5366,2022-12-03,20:00:00,73,45,28,FMN GV 16 Berchem TOT
54,Posthofbrug 5366,2022-12-03,21:00:00,57,36,21,FMN GV 16 Berchem TOT
54,Posthofbrug 5366,2022-12-03,22:00:00,81,39,42,FMN GV 16 Berchem TOT
54,Posthofbrug 5366,2022-12-03,23:00:00,66,21,45,FMN GV 16 Berchem TOT
54,Posthofbrug 5366,2022-12-04,00:00:00,64,15,49,FMN GV 16 Berchem TOT
54,Posthofbrug 5366,2022-12-04,01:00:00,49,25,24,FMN GV 16 Berchem TOT
54,Posthofbrug 5366,2022-12-04,02:00:00,27,9,18,FMN GV 16 Berchem TOT
54,Posthofbrug 5366,2022-12-04,03:00:00,7,3,4,FMN GV 16 Berchem TOT
54,Posthofbrug 5366,2022-12-04,04:00:00,17,1,16,FMN GV 16 Berchem TOT
54,Posthofbrug 5366,2022-12-04,05:00:00,7,3,4,FMN GV 16 Berchem TOT
54,Posthofbrug 5366,2022-12-04,06:00:00,24,10,14,FMN GV 16 Berchem TOT
54,Posthofbrug 5366,2022-12-04,07:00:00,28,14,14,FMN GV 16 Berchem TOT
54,Posthofbrug 5366,2022-12-04,08:00:00,49,24,25,FMN GV 16 Berchem TOT
54,Posthofbrug 5366,2022-12-04,09:00:00,106,57,49,FMN GV 16 Berchem TOT
54,Posthofbrug 5366,2022-12-04,10:00:00,100,62,38,FMN GV 16 Berchem TOT
54,Posthofbrug 5366,2022-12-04,11:00:00,123,83,40,FMN GV 16 Berchem TOT
54,Posthofbrug 5366,2022-12-04,12:00:00,123,66,57,FMN GV 16 Berchem TOT
54,Posthofbrug 5366,2022-12-04,13:00:00,131,64,67,FMN GV 16 Berchem TOT
54,Posthofbrug 5366,2022-12-04,14:00:00,120,75,45,FMN GV 16 Berchem TOT
54,Posthofbrug 5366,2022-12-04,15:00:00,102,52,50,FMN GV 16 Berchem TOT
54,Posthofbrug 5366,2022-12-04,16:00:00,144,45,99,FMN GV 16 Berchem TOT
54,Posthofbrug 5366,2022-12-04,17:00:00,124,68,56,FMN GV 16 Berchem TOT
54,Posthofbrug 5366,2022-12-04,18:00:00,112,36,76,FMN GV 16 Berchem TOT
54,Posthofbrug 5366,2022-12-04,19:00:00,66,41,25,FMN GV 16 Berchem TOT
54,Posthofbrug 5366,2022-12-04,20:00:00,69,24,45,FMN GV 16 Berchem TOT
54,Posthofbrug 5366,2022-12-04,21:00:00,44,19,25,FMN GV 16 Berchem TOT
54,Posthofbrug 5366,2022-12-04,22:00:00,41,16,25,FMN GV 16 Berchem TOT
54,Posthofbrug 5366,2022-12-04,23:00:00,29,7,22,FMN GV 16 Berchem TOT
54,Posthofbrug 5366,2022-12-05,00:00:00,7,1,6,FMN GV 16 Berchem TOT
54,Posthofbrug 5366,2022-12-05,01:00:00,5,2,3,FMN GV 16 Berchem TOT
54,Posthofbrug 5366,2022-12-05,02:00:00,3,0,3,FMN GV 16 Berchem TOT
54,Posthofbrug 5366,2022-12-05,03:00:00,2,0,2,FMN GV 16 Berchem TOT
54,Posthofbrug 5366,2022-12-05,04:00:00,4,2,2,FMN GV 16 Berchem TOT
54,Posthofbrug 5366,2022-12-05,05:00:00,26,17,9,FMN GV 16 Berchem TOT
54,Posthofbrug 5366,2022-12-05,06:00:00,103,82,21,FMN GV 16 Berchem TOT
54,Posthofbrug 5366,2022-12-05,07:00:00,382,302,80,FMN GV 16 Berchem TOT
54,Posthofbrug 5366,2022-12-05,08:00:00,822,634,188,FMN GV 16 Berchem TOT
54,Posthofbrug 5366,2022-12-05,09:00:00,270,218,52,FMN GV 16 Berchem TOT
54,Posthofbrug 5366,2022-12-05,10:00:00,115,81,34,FMN GV 16 Berchem TOT
54,Posthofbrug 5366,2022-12-05,11:00:00,104,64,40,FMN GV 16 Berchem TOT
54,Posthofbrug 5366,2022-12-05,12:00:00,162,84,78,FMN GV 16 Berchem TOT
54,Posthofbrug 5366,2022-12-05,13:00:00,154,69,85,FMN GV 16 Berchem TOT
54,Posthofbrug 5366,2022-12-05,14:00:00,105,44,61,FMN GV 16 Berchem TOT
54,Posthofbrug 5366,2022-12-05,15:00:00,224,86,138,FMN GV 16 Berchem TOT
54,Posthofbrug 5366,2022-12-05,16:00:00,406,90,316,FMN GV 16 Berchem TOT
54,Posthofbrug 5366,2022-12-05,17:00:00,566,151,415,FMN GV 16 Berchem TOT
54,Posthofbrug 5366,2022-12-05,18:00:00,327,102,225,FMN GV 16 Berchem TOT
54,Posthofbrug 5366,2022-12-05,19:00:00,153,58,95,FMN GV 16 Berchem TOT
54,Posthofbrug 5366,2022-12-05,20:00:00,81,39,42,FMN GV 16 Berchem TOT
54,Posthofbrug 5366,2022-12-05,21:00:00,66,24,42,FMN GV 16 Berchem TOT
54,Posthofbrug 5366,2022-12-05,22:00:00,63,19,44,FMN GV 16 Berchem TOT
54,Posthofbrug 5366,2022-12-05,23:00:00,39,12,27,FMN GV 16 Berchem TOT
54,Posthofbrug 5366,2022-12-06,00:00:00,12,5,7,FMN GV 16 Berchem TOT
54,Posthofbrug 5366,2022-12-06,01:00:00,4,0,4,FMN GV 16 Berchem TOT
54,Posthofbrug 5366,2022-12-06,02:00:00,6,4,2,FMN GV 16 Berchem TOT
54,Posthofbrug 5366,2022-12-06,03:00:00,4,3,1,FMN GV 16 Berchem TOT
54,Posthofbrug 5366,2022-12-06,04:00:00,11,4,7,FMN GV 16 Berchem TOT
54,Posthofbrug 5366,2022-12-06,05:00:00,34,25,9,FMN GV 16 Berchem TOT
54,Posthofbrug 5366,2022-12-06,06:00:00,125,103,22,FMN GV 16 Berchem TOT
54,Posthofbrug 5366,2022-12-06,07:00:00,510,405,105,FMN GV 16 Berchem TOT
54,Posthofbrug 5366,2022-12-06,08:00:00,916,690,226,FMN GV 16 Berchem TOT
54,Posthofbrug 5366,2022-12-06,09:00:00,350,261,89,FMN GV 16 Berchem TOT
54,Posthofbrug 5366,2022-12-06,10:00:00,162,119,43,FMN GV 16 Berchem TOT
54,Posthofbrug 5366,2022-12-06,11:00:00,117,71,46,FMN GV 16 Berchem TOT
54,Posthofbrug 5366,2022-12-06,12:00:00,201,101,100,FMN GV 16 Berchem TOT
54,Posthofbrug 5366,2022-12-06,13:00:00,192,83,109,FMN GV 16 Berchem TOT
54,Posthofbrug 5366,2022-12-06,14:00:00,164,65,99,FMN GV 16 Berchem TOT
54,Posthofbrug 5366,2022-12-06,15:00:00,290,103,187,FMN GV 16 Berchem TOT
54,Posthofbrug 5366,2022-12-06,16:00:00,464,130,334,FMN GV 16 Berchem TOT
54,Posthofbrug 5366,2022-12-06,17:00:00,680,199,481,FMN GV 16 Berchem TOT
54,Posthofbrug 5366,2022-12-06,18:00:00,415,124,291,FMN GV 16 Berchem TOT
54,Posthofbrug 5366,2022-12-06,19:00:00,189,78,111,FMN GV 16 Berchem TOT
54,Posthofbrug 5366,2022-12-06,20:00:00,104,30,74,FMN GV 16 Berchem TOT
54,Posthofbrug 5366,2022-12-06,21:00:00,103,44,59,FMN GV 16 Berchem TOT
54,Posthofbrug 5366,2022-12-06,22:00:00,76,31,45,FMN GV 16 Berchem TOT
54,Posthofbrug 5366,2022-12-06,23:00:00,49,14,35,FMN GV 16 Berchem TOT
54,Posthofbrug 5366,2022-12-07,00:00:00,17,5,12,FMN GV 16 Berchem TOT
54,Posthofbrug 5366,2022-12-07,01:00:00,9,2,7,FMN GV 16 Berchem TOT
54,Posthofbrug 5366,2022-12-07,02:00:00,4,0,4,FMN GV 16 Berchem TOT
54,Posthofbrug 5366,2022-12-07,03:00:00,2,2,0,FMN GV 16 Berchem TOT
54,Posthofbrug 5366,2022-12-07,04:00:00,11,8,3,FMN GV 16 Berchem TOT
54,Posthofbrug 5366,2022-12-07,05:00:00,29,19,10,FMN GV 16 Berchem TOT
54,Posthofbrug 5366,2022-12-07,06:00:00,113,94,19,FMN GV 16 Berchem TOT
54,Posthofbrug 5366,2022-12-07,07:00:00,379,300,79,FMN GV 16 Berchem TOT
54,Posthofbrug 5366,2022-12-07,08:00:00,741,582,159,FMN GV 16 Berchem TOT
54,Posthofbrug 5366,2022-12-07,09:00:00,277,204,73,FMN GV 16 Berchem TOT
54,Posthofbrug 5366,2022-12-07,10:00:00,156,92,64,FMN GV 16 Berchem TOT
54,Posthofbrug 5366,2022-12-07,11:00:00,123,65,58,FMN GV 16 Berchem TOT
54,Posthofbrug 5366,2022-12-07,12:00:00,286,107,179,FMN GV 16 Berchem TOT
54,Posthofbrug 5366,2022-12-07,13:00:00,222,95,127,FMN GV 16 Berchem TOT
54,Posthofbrug 5366,2022-12-07,14:00:00,154,59,95,FMN GV 16 Berchem TOT
54,Posthofbrug 5366,2022-12-07,15:00:00,185,77,108,FMN GV 16 Berchem TOT
54,Posthofbrug 5366,2022-12-07,16:00:00,345,110,235,FMN GV 16 Berchem TOT
54,Posthofbrug 5366,2022-12-07,17:00:00,529,161,368,FMN GV 16 Berchem TOT
54,Posthofbrug 5366,2022-12-07,18:00:00,325,104,221,FMN GV 16 Berchem TOT
54,Posthofbrug 5366,2022-12-07,19:00:00,165,74,91,FMN GV 16 Berchem TOT
54,Posthofbrug 5366,2022-12-07,20:00:00,94,34,60,FMN GV 16 Berchem TOT
54,Posthofbrug 5366,2022-12-07,21:00:00,75,28,47,FMN GV 16 Berchem TOT
54,Posthofbrug 5366,2022-12-07,22:00:00,72,19,53,FMN GV 16 Berchem TOT
54,Posthofbrug 5366,2022-12-07,23:00:00,49,16,33,FMN GV 16 Berchem TOT
54,Posthofbrug 5366,2022-12-08,00:00:00,23,3,20,FMN GV 16 Berchem TOT
54,Posthofbrug 5366,2022-12-08,01:00:00,6,2,4,FMN GV 16 Berchem TOT
54,Posthofbrug 5366,2022-12-08,02:00:00,8,1,7,FMN GV 16 Berchem TOT
54,Posthofbrug 5366,2022-12-08,03:00:00,4,1,3,FMN GV 16 Berchem TOT
54,Posthofbrug 5366,2022-12-08,04:00:00,11,6,5,FMN GV 16 Berchem TOT
54,Posthofbrug 5366,2022-12-08,05:00:00,23,17,6,FMN GV 16 Berchem TOT
54,Posthofbrug 5366,2022-12-08,06:00:00,123,104,19,FMN GV 16 Berchem TOT
54,Posthofbrug 5366,2022-12-08,07:00:00,421,338,83,FMN GV 16 Berchem TOT
54,Posthofbrug 5366,2022-12-08,08:00:00,834,666,168,FMN GV 16 Berchem TOT
54,Posthofbrug 5366,2022-12-08,09:00:00,266,205,61,FMN GV 16 Berchem TOT
54,Posthofbrug 5366,2022-12-08,10:00:00,164,119,45,FMN GV 16 Berchem TOT
54,Posthofbrug 5366,2022-12-08,11:00:00,121,69,52,FMN GV 16 Berchem TOT
54,Posthofbrug 5366,2022-12-08,12:00:00,212,106,106,FMN GV 16 Berchem TOT
54,Posthofbrug 5366,2022-12-08,13:00:00,140,61,79,FMN GV 16 Berchem TOT
54,Posthofbrug 5366,2022-12-08,14:00:00,99,44,55,FMN GV 16 Berchem TOT
54,Posthofbrug 5366,2022-12-08,15:00:00,223,80,143,FMN GV 16 Berchem TOT
54,Posthofbrug 5366,2022-12-08,16:00:00,443,137,306,FMN GV 16 Berchem TOT
54,Posthofbrug 5366,2022-12-08,17:00:00,571,157,414,FMN GV 16 Berchem TOT
54,Posthofbrug 5366,2022-12-08,18:00:00,361,120,241,FMN GV 16 Berchem TOT
54,Posthofbrug 5366,2022-12-08,19:00:00,180,75,105,FMN GV 16 Berchem TOT
54,Posthofbrug 5366,2022-12-08,20:00:00,115,37,78,FMN GV 16 Berchem TOT
54,Posthofbrug 5366,2022-12-08,21:00:00,103,38,65,FMN GV 16 Berchem TOT
54,Posthofbrug 5366,2022-12-08,22:00:00,100,27,73,FMN GV 16 Berchem TOT
54,Posthofbrug 5366,2022-12-08,23:00:00,67,19,48,FMN GV 16 Berchem TOT
54,Posthofbrug 5366,2022-12-09,00:00:00,37,6,31,FMN GV 16 Berchem TOT
54,Posthofbrug 5366,2022-12-09,01:00:00,11,1,10,FMN GV 16 Berchem TOT
54,Posthofbrug 5366,2022-12-09,02:00:00,9,0,9,FMN GV 16 Berchem TOT
54,Posthofbrug 5366,2022-12-09,03:00:00,3,1,2,FMN GV 16 Berchem TOT
54,Posthofbrug 5366,2022-12-09,04:00:00,9,6,3,FMN GV 16 Berchem TOT
54,Posthofbrug 5366,2022-12-09,05:00:00,20,14,6,FMN GV 16 Berchem TOT
54,Posthofbrug 5366,2022-12-09,06:00:00,88,67,21,FMN GV 16 Berchem TOT
54,Posthofbrug 5366,2022-12-09,07:00:00,311,236,75,FMN GV 16 Berchem TOT
54,Posthofbrug 5366,2022-12-09,08:00:00,682,552,130,FMN GV 16 Berchem TOT
54,Posthofbrug 5366,2022-12-09,09:00:00,271,213,58,FMN GV 16 Berchem TOT
54,Posthofbrug 5366,2022-12-09,10:00:00,146,97,49,FMN GV 16 Berchem TOT
54,Posthofbrug 5366,2022-12-09,11:00:00,124,81,43,FMN GV 16 Berchem TOT
54,Posthofbrug 5366,2022-12-09,12:00:00,229,111,118,FMN GV 16 Berchem TOT
54,Posthofbrug 5366,2022-12-09,13:00:00,203,107,96,FMN GV 16 Berchem TOT
54,Posthofbrug 5366,2022-12-09,14:00:00,186,84,102,FMN GV 16 Berchem TOT
54,Posthofbrug 5366,2022-12-09,15:00:00,295,92,203,FMN GV 16 Berchem TOT
54,Posthofbrug 5366,2022-12-09,16:00:00,350,116,234,FMN GV 16 Berchem TOT
54,Posthofbrug 5366,2022-12-09,17:00:00,445,144,301,FMN GV 16 Berchem TOT
54,Posthofbrug 5366,2022-12-09,18:00:00,282,102,180,FMN GV 16 Berchem TOT
54,Posthofbrug 5366,2022-12-09,19:00:00,167,90,77,FMN GV 16 Berchem TOT
54,Posthofbrug 5366,2022-12-09,20:00:00,92,44,48,FMN GV 16 Berchem TOT
54,Posthofbrug 5366,2022-12-09,21:00:00,95,40,55,FMN GV 16 Berchem TOT
54,Posthofbrug 5366,2022-12-09,22:00:00,76,24,52,FMN GV 16 Berchem TOT
54,Posthofbrug 5366,2022-12-09,23:00:00,82,21,61,FMN GV 16 Berchem TOT
54,Posthofbrug 5366,2022-12-10,00:00:00,59,9,50,FMN GV 16 Berchem TOT
54,Posthofbrug 5366,2022-12-10,01:00:00,43,10,33,FMN GV 16 Berchem TOT
54,Posthofbrug 5366,2022-12-10,02:00:00,34,0,34,FMN GV 16 Berchem TOT
54,Posthofbrug 5366,2022-12-10,03:00:00,16,4,12,FMN GV 16 Berchem TOT
54,Posthofbrug 5366,2022-12-10,04:00:00,13,2,11,FMN GV 16 Berchem TOT
54,Posthofbrug 5366,2022-12-10,05:00:00,16,3,13,FMN GV 16 Berchem TOT
54,Posthofbrug 5366,2022-12-10,06:00:00,15,7,8,FMN GV 16 Berchem TOT
54,Posthofbrug 5366,2022-12-10,07:00:00,31,18,13,FMN GV 16 Berchem TOT
54,Posthofbrug 5366,2022-12-10,08:00:00,46,33,13,FMN GV 16 Berchem TOT
54,Posthofbrug 5366,2022-12-10,09:00:00,89,64,25,FMN GV 16 Berchem TOT
54,Posthofbrug 5366,2022-12-10,10:00:00,96,64,32,FMN GV 16 Berchem TOT
54,Posthofbrug 5366,2022-12-10,11:00:00,101,62,39,FMN GV 16 Berchem TOT
54,Posthofbrug 5366,2022-12-10,12:00:00,97,57,40,FMN GV 16 Berchem TOT
54,Posthofbrug 5366,2022-12-10,13:00:00,114,76,38,FMN GV 16 Berchem TOT
54,Posthofbrug 5366,2022-12-10,14:00:00,151,99,52,FMN GV 16 Berchem TOT
54,Posthofbrug 5366,2022-12-10,15:00:00,132,70,62,FMN GV 16 Berchem TOT
54,Posthofbrug 5366,2022-12-10,16:00:00,105,49,56,FMN GV 16 Berchem TOT
54,Posthofbrug 5366,2022-12-10,17:00:00,117,50,67,FMN GV 16 Berchem TOT
54,Posthofbrug 5366,2022-12-10,18:00:00,113,50,63,FMN GV 16 Berchem TOT
54,Posthofbrug 5366,2022-12-10,19:00:00,97,49,48,FMN GV 16 Berchem TOT
54,Posthofbrug 5366,2022-12-10,20:00:00,48,25,23,FMN GV 16 Berchem TOT
54,Posthofbrug 5366,2022-12-10,21:00:00,65,37,28,FMN GV 16 Berchem TOT
54,Posthofbrug 5366,2022-12-10,22:00:00,50,17,33,FMN GV 16 Berchem TOT
54,Posthofbrug 5366,2022-12-10,23:00:00,66,14,52,FMN GV 16 Berchem TOT
54,Posthofbrug 5366,2022-12-11,00:00:00,53,12,41,FMN GV 16 Berchem TOT
54,Posthofbrug 5366,2022-12-11,01:00:00,39,10,29,FMN GV 16 Berchem TOT
54,Posthofbrug 5366,2022-12-11,02:00:00,19,2,17,FMN GV 16 Berchem TOT
54,Posthofbrug 5366,2022-12-11,03:00:00,16,5,11,FMN GV 16 Berchem TOT
54,Posthofbrug 5366,2022-12-11,04:00:00,16,3,13,FMN GV 16 Berchem TOT
54,Posthofbrug 5366,2022-12-11,05:00:00,16,3,13,FMN GV 16 Berchem TOT
54,Posthofbrug 5366,2022-12-11,06:00:00,17,9,8,FMN GV 16 Berchem TOT
54,Posthofbrug 5366,2022-12-11,07:00:00,20,14,6,FMN GV 16 Berchem TOT
54,Posthofbrug 5366,2022-12-11,08:00:00,40,28,12,FMN GV 16 Berchem TOT
54,Posthofbrug 5366,2022-12-11,09:00:00,63,37,26,FMN GV 16 Berchem TOT
54,Posthofbrug 5366,2022-12-11,10:00:00,65,48,17,FMN GV 16 Berchem TOT
54,Posthofbrug 5366,2022-12-11,11:00:00,77,49,28,FMN GV 16 Berchem TOT
54,Posthofbrug 5366,2022-12-11,12:00:00,92,60,32,FMN GV 16 Berchem TOT
54,Posthofbrug 5366,2022-12-11,13:00:00,107,57,50,FMN GV 16 Berchem TOT
54,Posthofbrug 5366,2022-12-11,14:00:00,113,47,66,FMN GV 16 Berchem TOT
54,Posthofbrug 5366,2022-12-11,15:00:00,90,55,35,FMN GV 16 Berchem TOT
54,Posthofbrug 5366,2022-12-11,16:00:00,91,40,51,FMN GV 16 Berchem TOT
54,Posthofbrug 5366,2022-12-11,17:00:00,112,62,50,FMN GV 16 Berchem TOT
54,Posthofbrug 5366,2022-12-11,18:00:00,98,42,56,FMN GV 16 Berchem TOT
54,Posthofbrug 5366,2022-12-11,19:00:00,65,26,39,FMN GV 16 Berchem TOT
54,Posthofbrug 5366,2022-12-11,20:00:00,54,32,22,FMN GV 16 Berchem TOT
54,Posthofbrug 5366,2022-12-11,21:00:00,55,23,32,FMN GV 16 Berchem TOT
54,Posthofbrug 5366,2022-12-11,22:00:00,41,8,33,FMN GV 16 Berchem TOT
54,Posthofbrug 5366,2022-12-11,23:00:00,30,11,19,FMN GV 16 Berchem TOT
54,Posthofbrug 5366,2022-12-12,00:00:00,12,1,11,FMN GV 16 Berchem TOT
54,Posthofbrug 5366,2022-12-12,01:00:00,5,1,4,FMN GV 16 Berchem TOT
54,Posthofbrug 5366,2022-12-12,02:00:00,6,0,6,FMN GV 16 Berchem TOT
54,Posthofbrug 5366,2022-12-12,03:00:00,2,2,0,FMN GV 16 Berchem TOT
54,Posthofbrug 5366,2022-12-12,04:00:00,10,6,4,FMN GV 16 Berchem TOT
54,Posthofbrug 5366,2022-12-12,05:00:00,19,16,3,FMN GV 16 Berchem TOT
54,Posthofbrug 5366,2022-12-12,06:00:00,93,75,18,FMN GV 16 Berchem TOT
54,Posthofbrug 5366,2022-12-12,07:00:00,381,290,91,FMN GV 16 Berchem TOT
54,Posthofbrug 5366,2022-12-12,08:00:00,761,594,167,FMN GV 16 Berchem TOT
54,Posthofbrug 5366,2022-12-12,09:00:00,271,205,66,FMN GV 16 Berchem TOT
54,Posthofbrug 5366,2022-12-12,10:00:00,142,95,47,FMN GV 16 Berchem TOT
54,Posthofbrug 5366,2022-12-12,11:00:00,111,62,49,FMN GV 16 Berchem TOT
54,Posthofbrug 5366,2022-12-12,12:00:00,187,80,107,FMN GV 16 Berchem TOT
54,Posthofbrug 5366,2022-12-12,13:00:00,161,75,86,FMN GV 16 Berchem TOT
54,Posthofbrug 5366,2022-12-12,14:00:00,119,48,71,FMN GV 16 Berchem TOT
54,Posthofbrug 5366,2022-12-12,15:00:00,248,82,166,FMN GV 16 Berchem TOT
54,Posthofbrug 5366,2022-12-12,16:00:00,364,97,267,FMN GV 16 Berchem TOT
54,Posthofbrug 5366,2022-12-12,17:00:00,530,170,360,FMN GV 16 Berchem TOT
54,Posthofbrug 5366,2022-12-12,18:00:00,309,99,210,FMN GV 16 Berchem TOT
54,Posthofbrug 5366,2022-12-12,19:00:00,153,59,94,FMN GV 16 Berchem TOT
54,Posthofbrug 5366,2022-12-12,20:00:00,74,29,45,FMN GV 16 Berchem TOT
54,Posthofbrug 5366,2022-12-12,21:00:00,86,29,57,FMN GV 16 Berchem TOT
54,Posthofbrug 5366,2022-12-12,22:00:00,66,16,50,FMN GV 16 Berchem TOT
54,Posthofbrug 5366,2022-12-12,23:00:00,34,6,28,FMN GV 16 Berchem TOT
54,Posthofbrug 5366,2022-12-13,00:00:00,9,2,7,FMN GV 16 Berchem TOT
54,Posthofbrug 5366,2022-12-13,01:00:00,5,0,5,FMN GV 16 Berchem TOT
54,Posthofbrug 5366,2022-12-13,02:00:00,6,2,4,FMN GV 16 Berchem TOT
54,Posthofbrug 5366,2022-12-13,03:00:00,2,2,0,FMN GV 16 Berchem TOT
54,Posthofbrug 5366,2022-12-13,04:00:00,6,4,2,FMN GV 16 Berchem TOT
54,Posthofbrug 5366,2022-12-13,05:00:00,29,21,8,FMN GV 16 Berchem TOT
54,Posthofbrug 5366,2022-12-13,06:00:00,88,72,16,FMN GV 16 Berchem TOT
54,Posthofbrug 5366,2022-12-13,07:00:00,412,318,94,FMN GV 16 Berchem TOT
54,Posthofbrug 5366,2022-12-13,08:00:00,768,597,171,FMN GV 16 Berchem TOT
54,Posthofbrug 5366,2022-12-13,09:00:00,264,183,81,FMN GV 16 Berchem TOT
54,Posthofbrug 5366,2022-12-13,10:00:00,136,82,54,FMN GV 16 Berchem TOT
54,Posthofbrug 5366,2022-12-13,11:00:00,105,55,50,FMN GV 16 Berchem TOT
54,Posthofbrug 5366,2022-12-13,12:00:00,182,97,85,FMN GV 16 Berchem TOT
54,Posthofbrug 5366,2022-12-13,13:00:00,151,77,74,FMN GV 16 Berchem TOT
54,Posthofbrug 5366,2022-12-13,14:00:00,110,42,68,FMN GV 16 Berchem TOT
54,Posthofbrug 5366,2022-12-13,15:00:00,197,62,135,FMN GV 16 Berchem TOT
54,Posthofbrug 5366,2022-12-13,16:00:00,401,106,295,FMN GV 16 Berchem TOT
54,Posthofbrug 5366,2022-12-13,17:00:00,534,179,355,FMN GV 16 Berchem TOT
54,Posthofbrug 5366,2022-12-13,18:00:00,331,108,223,FMN GV 16 Berchem TOT
54,Posthofbrug 5366,2022-12-13,19:00:00,152,51,101,FMN GV 16 Berchem TOT
54,Posthofbrug 5366,2022-12-13,20:00:00,99,41,58,FMN GV 16 Berchem TOT
54,Posthofbrug 5366,2022-12-13,21:00:00,85,29,56,FMN GV 16 Berchem TOT
54,Posthofbrug 5366,2022-12-13,22:00:00,81,26,55,FMN GV 16 Berchem TOT
54,Posthofbrug 5366,2022-12-13,23:00:00,48,12,36,FMN GV 16 Berchem TOT
54,Posthofbrug 5366,2022-12-14,00:00:00,18,5,13,FMN GV 16 Berchem TOT
54,Posthofbrug 5366,2022-12-14,01:00:00,8,0,8,FMN GV 16 Berchem TOT
54,Posthofbrug 5366,2022-12-14,02:00:00,4,0,4,FMN GV 16 Berchem TOT
54,Posthofbrug 5366,2022-12-14,03:00:00,4,1,3,FMN GV 16 Berchem TOT
54,Posthofbrug 5366,2022-12-14,04:00:00,6,4,2,FMN GV 16 Berchem TOT
54,Posthofbrug 5366,2022-12-14,05:00:00,30,20,10,FMN GV 16 Berchem TOT
54,Posthofbrug 5366,2022-12-14,06:00:00,90,72,18,FMN GV 16 Berchem TOT
54,Posthofbrug 5366,2022-12-14,07:00:00,345,268,77,FMN GV 16 Berchem TOT
54,Posthofbrug 5366,2022-12-14,08:00:00,667,495,172,FMN GV 16 Berchem TOT
54,Posthofbrug 5366,2022-12-14,09:00:00,229,161,68,FMN GV 16 Berchem TOT
54,Posthofbrug 5366,2022-12-14,10:00:00,149,93,56,FMN GV 16 Berchem TOT
54,Posthofbrug 5366,2022-12-14,11:00:00,121,55,66,FMN GV 16 Berchem TOT
54,Posthofbrug 5366,2022-12-14,12:00:00,236,108,128,FMN GV 16 Berchem TOT
54,Posthofbrug 5366,2022-12-14,13:00:00,147,63,84,FMN GV 16 Berchem TOT
54,Posthofbrug 5366,2022-12-14,14:00:00,154,60,94,FMN GV 16 Berchem TOT
54,Posthofbrug 5366,2022-12-14,15:00:00,162,62,100,FMN GV 16 Berchem TOT
54,Posthofbrug 5366,2022-12-14,16:00:00,303,106,197,FMN GV 16 Berchem TOT
54,Posthofbrug 5366,2022-12-14,17:00:00,455,156,299,FMN GV 16 Berchem TOT
54,Posthofbrug 5366,2022-12-14,18:00:00,301,120,181,FMN GV 16 Berchem TOT
54,Posthofbrug 5366,2022-12-14,19:00:00,168,70,98,FMN GV 16 Berchem TOT
54,Posthofbrug 5366,2022-12-14,20:00:00,93,33,60,FMN GV 16 Berchem TOT
54,Posthofbrug 5366,2022-12-14,21:00:00,71,23,48,FMN GV 16 Berchem TOT
54,Posthofbrug 5366,2022-12-14,22:00:00,77,21,56,FMN GV 16 Berchem TOT
54,Posthofbrug 5366,2022-12-14,23:00:00,56,13,43,FMN GV 16 Berchem TOT
54,Posthofbrug 5366,2022-12-15,00:00:00,17,5,12,FMN GV 16 Berchem TOT
54,Posthofbrug 5366,2022-12-15,01:00:00,9,0,9,FMN GV 16 Berchem TOT
54,Posthofbrug 5366,2022-12-15,02:00:00,8,2,6,FMN GV 16 Berchem TOT
54,Posthofbrug 5366,2022-12-15,03:00:00,1,1,0,FMN GV 16 Berchem TOT
54,Posthofbrug 5366,2022-12-15,04:00:00,3,1,2,FMN GV 16 Berchem TOT
54,Posthofbrug 5366,2022-12-15,05:00:00,30,22,8,FMN GV 16 Berchem TOT
54,Posthofbrug 5366,2022-12-15,06:00:00,95,79,16,FMN GV 16 Berchem TOT
54,Posthofbrug 5366,2022-12-15,07:00:00,358,281,77,FMN GV 16 Berchem TOT
54,Posthofbrug 5366,2022-12-15,08:00:00,797,631,166,FMN GV 16 Berchem TOT
54,Posthofbrug 5366,2022-12-15,09:00:00,262,194,68,FMN GV 16 Berchem TOT
54,Posthofbrug 5366,2022-12-15,10:00:00,153,89,64,FMN GV 16 Berchem TOT
54,Posthofbrug 5366,2022-12-15,11:00:00,138,83,55,FMN GV 16 Berchem TOT
54,Posthofbrug 5366,2022-12-15,12:00:00,175,97,78,FMN GV 16 Berchem TOT
54,Posthofbrug 5366,2022-12-15,13:00:00,157,76,81,FMN GV 16 Berchem TOT
54,Posthofbrug 5366,2022-12-15,14:00:00,130,50,80,FMN GV 16 Berchem TOT
54,Posthofbrug 5366,2022-12-15,15:00:00,200,60,140,FMN GV 16 Berchem TOT
54,Posthofbrug 5366,2022-12-15,16:00:00,392,115,277,FMN GV 16 Berchem TOT
54,Posthofbrug 5366,2022-12-15,17:00:00,483,146,337,FMN GV 16 Berchem TOT
54,Posthofbrug 5366,2022-12-15,18:00:00,356,118,238,FMN GV 16 Berchem TOT
54,Posthofbrug 5366,2022-12-15,19:00:00,166,69,97,FMN GV 16 Berchem TOT
54,Posthofbrug 5366,2022-12-15,20:00:00,108,48,60,FMN GV 16 Berchem TOT
54,Posthofbrug 5366,2022-12-15,21:00:00,96,31,65,FMN GV 16 Berchem TOT
54,Posthofbrug 5366,2022-12-15,22:00:00,94,26,68,FMN GV 16 Berchem TOT
54,Posthofbrug 5366,2022-12-15,23:00:00,77,13,64,FMN GV 16 Berchem TOT
54,Posthofbrug 5366,2022-12-16,00:00:00,26,2,24,FMN GV 16 Berchem TOT
54,Posthofbrug 5366,2022-12-16,01:00:00,11,5,6,FMN GV 16 Berchem TOT
54,Posthofbrug 5366,2022-12-16,02:00:00,11,0,11,FMN GV 16 Berchem TOT
54,Posthofbrug 5366,2022-12-16,03:00:00,8,0,8,FMN GV 16 Berchem TOT
54,Posthofbrug 5366,2022-12-16,04:00:00,8,5,3,FMN GV 16 Berchem TOT
54,Posthofbrug 5366,2022-12-16,05:00:00,23,17,6,FMN GV 16 Berchem TOT
54,Posthofbrug 5366,2022-12-16,06:00:00,72,58,14,FMN GV 16 Berchem TOT
54,Posthofbrug 5366,2022-12-16,07:00:00,306,220,86,FMN GV 16 Berchem TOT
54,Posthofbrug 5366,2022-12-16,08:00:00,625,495,130,FMN GV 16 Berchem TOT
54,Posthofbrug 5366,2022-12-16,09:00:00,247,180,67,FMN GV 16 Berchem TOT
54,Posthofbrug 5366,2022-12-16,10:00:00,128,83,45,FMN GV 16 Berchem TOT
54,Posthofbrug 5366,2022-12-16,11:00:00,137,74,63,FMN GV 16 Berchem TOT
54,Posthofbrug 5366,2022-12-16,12:00:00,217,116,101,FMN GV 16 Berchem TOT
54,Posthofbrug 5366,2022-12-16,13:00:00,179,82,97,FMN GV 16 Berchem TOT
54,Posthofbrug 5366,2022-12-16,14:00:00,190,82,108,FMN GV 16 Berchem TOT
54,Posthofbrug 5366,2022-12-16,15:00:00,239,88,151,FMN GV 16 Berchem TOT
54,Posthofbrug 5366,2022-12-16,16:00:00,314,92,222,FMN GV 16 Berchem TOT
54,Posthofbrug 5366,2022-12-16,17:00:00,380,127,253,FMN GV 16 Berchem TOT
54,Posthofbrug 5366,2022-12-16,18:00:00,235,98,137,FMN GV 16 Berchem TOT
54,Posthofbrug 5366,2022-12-16,19:00:00,132,63,69,FMN GV 16 Berchem TOT
54,Posthofbrug 5366,2022-12-16,20:00:00,107,49,58,FMN GV 16 Berchem TOT
54,Posthofbrug 5366,2022-12-16,21:00:00,93,46,47,FMN GV 16 Berchem TOT
54,Posthofbrug 5366,2022-12-16,22:00:00,72,21,51,FMN GV 16 Berchem TOT
54,Posthofbrug 5366,2022-12-16,23:00:00,81,17,64,FMN GV 16 Berchem TOT
54,Posthofbrug 5366,2022-12-17,00:00:00,80,8,72,FMN GV 16 Berchem TOT
54,Posthofbrug 5366,2022-12-17,01:00:00,51,10,41,FMN GV 16 Berchem TOT
54,Posthofbrug 5366,2022-12-17,02:00:00,29,6,23,FMN GV 16 Berchem TOT
54,Posthofbrug 5366,2022-12-17,03:00:00,20,6,14,FMN GV 16 Berchem TOT
54,Posthofbrug 5366,2022-12-17,04:00:00,17,3,14,FMN GV 16 Berchem TOT
54,Posthofbrug 5366,2022-12-17,05:00:00,11,8,3,FMN GV 16 Berchem TOT
54,Posthofbrug 5366,2022-12-17,06:00:00,17,10,7,FMN GV 16 Berchem TOT
54,Posthofbrug 5366,2022-12-17,07:00:00,30,20,10,FMN GV 16 Berchem TOT
54,Posthofbrug 5366,2022-12-17,08:00:00,44,30,14,FMN GV 16 Berchem TOT
54,Posthofbrug 5366,2022-12-17,09:00:00,102,75,27,FMN GV 16 Berchem TOT
54,Posthofbrug 5366,2022-12-17,10:00:00,92,50,42,FMN GV 16 Berchem TOT
54,Posthofbrug 5366,2022-12-17,11:00:00,120,85,35,FMN GV 16 Berchem TOT
54,Posthofbrug 5366,2022-12-17,12:00:00,122,74,48,FMN GV 16 Berchem TOT
54,Posthofbrug 5366,2022-12-17,13:00:00,138,88,50,FMN GV 16 Berchem TOT
54,Posthofbrug 5366,2022-12-17,14:00:00,131,75,56,FMN GV 16 Berchem TOT
54,Posthofbrug 5366,2022-12-17,15:00:00,132,63,69,FMN GV 16 Berchem TOT
54,Posthofbrug 5366,2022-12-17,16:00:00,121,46,75,FMN GV 16 Berchem TOT
54,Posthofbrug 5366,2022-12-17,17:00:00,120,54,66,FMN GV 16 Berchem TOT
54,Posthofbrug 5366,2022-12-17,18:00:00,114,61,53,FMN GV 16 Berchem TOT
54,Posthofbrug 5366,2022-12-17,19:00:00,81,39,42,FMN GV 16 Berchem TOT
54,Posthofbrug 5366,2022-12-17,20:00:00,64,32,32,FMN GV 16 Berchem TOT
54,Posthofbrug 5366,2022-12-17,21:00:00,41,17,24,FMN GV 16 Berchem TOT
54,Posthofbrug 5366,2022-12-17,22:00:00,48,12,36,FMN GV 16 Berchem TOT
54,Posthofbrug 5366,2022-12-17,23:00:00,57,18,39,FMN GV 16 Berchem TOT
54,Posthofbrug 5366,2022-12-18,00:00:00,36,9,27,FMN GV 16 Berchem TOT
54,Posthofbrug 5366,2022-12-18,01:00:00,48,16,32,FMN GV 16 Berchem TOT
54,Posthofbrug 5366,2022-12-18,02:00:00,34,9,25,FMN GV 16 Berchem TOT
54,Posthofbrug 5366,2022-12-18,03:00:00,16,3,13,FMN GV 16 Berchem TOT
54,Posthofbrug 5366,2022-12-18,04:00:00,12,3,9,FMN GV 16 Berchem TOT
54,Posthofbrug 5366,2022-12-18,05:00:00,20,10,10,FMN GV 16 Berchem TOT
54,Posthofbrug 5366,2022-12-18,06:00:00,16,11,5,FMN GV 16 Berchem TOT
54,Posthofbrug 5366,2022-12-18,07:00:00,16,9,7,FMN GV 16 Berchem TOT
54,Posthofbrug 5366,2022-12-18,08:00:00,25,18,7,FMN GV 16 Berchem TOT
54,Posthofbrug 5366,2022-12-18,09:00:00,58,32,26,FMN GV 16 Berchem TOT
54,Posthofbrug 5366,2022-12-18,10:00:00,46,28,18,FMN GV 16 Berchem TOT
54,Posthofbrug 5366,2022-12-18,11:00:00,65,43,22,FMN GV 16 Berchem TOT
54,Posthofbrug 5366,2022-12-18,12:00:00,69,35,34,FMN GV 16 Berchem TOT
54,Posthofbrug 5366,2022-12-18,13:00:00,85,46,39,FMN GV 16 Berchem TOT
54,Posthofbrug 5366,2022-12-18,14:00:00,122,74,48,FMN GV 16 Berchem TOT
54,Posthofbrug 5366,2022-12-18,15:00:00,94,49,45,FMN GV 16 Berchem TOT
54,Posthofbrug 5366,2022-12-18,16:00:00,72,37,35,FMN GV 16 Berchem TOT
54,Posthofbrug 5366,2022-12-18,17:00:00,75,27,48,FMN GV 16 Berchem TOT
54,Posthofbrug 5366,2022-12-18,18:00:00,50,20,30,FMN GV 16 Berchem TOT
54,Posthofbrug 5366,2022-12-18,19:00:00,59,17,42,FMN GV 16 Berchem TOT
54,Posthofbrug 5366,2022-12-18,20:00:00,34,11,23,FMN GV 16 Berchem TOT
54,Posthofbrug 5366,2022-12-18,21:00:00,33,4,29,FMN GV 16 Berchem TOT
54,Posthofbrug 5366,2022-12-18,22:00:00,23,11,12,FMN GV 16 Berchem TOT
54,Posthofbrug 5366,2022-12-18,23:00:00,17,5,12,FMN GV 16 Berchem TOT
54,Posthofbrug 5366,2022-12-19,00:00:00,2,2,0,FMN GV 16 Berchem TOT
54,Posthofbrug 5366,2022-12-19,01:00:00,5,2,3,FMN GV 16 Berchem TOT
54,Posthofbrug 5366,2022-12-19,02:00:00,1,0,1,FMN GV 16 Berchem TOT
54,Posthofbrug 5366,2022-12-19,03:00:00,3,2,1,FMN GV 16 Berchem TOT
54,Posthofbrug 5366,2022-12-19,04:00:00,7,5,2,FMN GV 16 Berchem TOT
54,Posthofbrug 5366,2022-12-19,05:00:00,20,14,6,FMN GV 16 Berchem TOT
54,Posthofbrug 5366,2022-12-19,06:00:00,70,57,13,FMN GV 16 Berchem TOT
54,Posthofbrug 5366,2022-12-19,07:00:00,300,236,64,FMN GV 16 Berchem TOT
54,Posthofbrug 5366,2022-12-19,08:00:00,664,517,147,FMN GV 16 Berchem TOT
54,Posthofbrug 5366,2022-12-19,09:00:00,267,205,62,FMN GV 16 Berchem TOT
54,Posthofbrug 5366,2022-12-19,10:00:00,143,111,32,FMN GV 16 Berchem TOT
54,Posthofbrug 5366,2022-12-19,11:00:00,98,57,41,FMN GV 16 Berchem TOT
54,Posthofbrug 5366,2022-12-19,12:00:00,168,89,79,FMN GV 16 Berchem TOT
54,Posthofbrug 5366,2022-12-19,13:00:00,145,73,72,FMN GV 16 Berchem TOT
54,Posthofbrug 5366,2022-12-19,14:00:00,121,59,62,FMN GV 16 Berchem TOT
54,Posthofbrug 5366,2022-12-19,15:00:00,218,83,135,FMN GV 16 Berchem TOT
54,Posthofbrug 5366,2022-12-19,16:00:00,321,86,235,FMN GV 16 Berchem TOT
54,Posthofbrug 5366,2022-12-19,17:00:00,485,140,345,FMN GV 16 Berchem TOT
54,Posthofbrug 5366,2022-12-19,18:00:00,294,85,209,FMN GV 16 Berchem TOT
54,Posthofbrug 5366,2022-12-19,19:00:00,132,50,82,FMN GV 16 Berchem TOT
54,Posthofbrug 5366,2022-12-19,20:00:00,95,35,60,FMN GV 16 Berchem TOT
54,Posthofbrug 5366,2022-12-19,21:00:00,88,33,55,FMN GV 16 Berchem TOT
54,Posthofbrug 5366,2022-12-19,22:00:00,74,17,57,FMN GV 16 Berchem TOT
54,Posthofbrug 5366,2022-12-19,23:00:00,32,4,28,FMN GV 16 Berchem TOT
54,Posthofbrug 5366,2022-12-20,00:00:00,17,4,13,FMN GV 16 Berchem TOT
54,Posthofbrug 5366,2022-12-20,01:00:00,8,0,8,FMN GV 16 Berchem TOT
54,Posthofbrug 5366,2022-12-20,02:00:00,1,0,1,FMN GV 16 Berchem TOT
54,Posthofbrug 5366,2022-12-20,03:00:00,1,0,1,FMN GV 16 Berchem TOT
54,Posthofbrug 5366,2022-12-20,04:00:00,10,8,2,FMN GV 16 Berchem TOT
54,Posthofbrug 5366,2022-12-20,05:00:00,20,13,7,FMN GV 16 Berchem TOT
54,Posthofbrug 5366,2022-12-20,06:00:00,97,80,17,FMN GV 16 Berchem TOT
54,Posthofbrug 5366,2022-12-20,07:00:00,380,290,90,FMN GV 16 Berchem TOT
54,Posthofbrug 5366,2022-12-20,08:00:00,672,516,156,FMN GV 16 Berchem TOT
54,Posthofbrug 5366,2022-12-20,09:00:00,243,173,70,FMN GV 16 Berchem TOT
54,Posthofbrug 5366,2022-12-20,10:00:00,125,81,44,FMN GV 16 Berchem TOT
54,Posthofbrug 5366,2022-12-20,11:00:00,112,71,41,FMN GV 16 Berchem TOT
54,Posthofbrug 5366,2022-12-20,12:00:00,134,78,56,FMN GV 16 Berchem TOT
54,Posthofbrug 5366,2022-12-20,13:00:00,116,64,52,FMN GV 16 Berchem TOT
54,Posthofbrug 5366,2022-12-20,14:00:00,120,36,84,FMN GV 16 Berchem TOT
54,Posthofbrug 5366,2022-12-20,15:00:00,182,63,119,FMN GV 16 Berchem TOT
54,Posthofbrug 5366,2022-12-20,16:00:00,319,93,226,FMN GV 16 Berchem TOT
54,Posthofbrug 5366,2022-12-20,17:00:00,495,154,341,FMN GV 16 Berchem TOT
54,Posthofbrug 5366,2022-12-20,18:00:00,257,82,175,FMN GV 16 Berchem TOT
54,Posthofbrug 5366,2022-12-20,19:00:00,153,58,95,FMN GV 16 Berchem TOT
54,Posthofbrug 5366,2022-12-20,20:00:00,81,29,52,FMN GV 16 Berchem TOT
54,Posthofbrug 5366,2022-12-20,21:00:00,82,27,55,FMN GV 16 Berchem TOT
54,Posthofbrug 5366,2022-12-20,22:00:00,52,12,40,FMN GV 16 Berchem TOT
54,Posthofbrug 5366,2022-12-20,23:00:00,61,16,45,FMN GV 16 Berchem TOT
54,Posthofbrug 5366,2022-12-21,00:00:00,29,5,24,FMN GV 16 Berchem TOT
54,Posthofbrug 5366,2022-12-21,01:00:00,13,3,10,FMN GV 16 Berchem TOT
54,Posthofbrug 5366,2022-12-21,02:00:00,3,0,3,FMN GV 16 Berchem TOT
54,Posthofbrug 5366,2022-12-21,03:00:00,2,0,2,FMN GV 16 Berchem TOT
54,Posthofbrug 5366,2022-12-21,04:00:00,6,6,0,FMN GV 16 Berchem TOT
54,Posthofbrug 5366,2022-12-21,05:00:00,18,14,4,FMN GV 16 Berchem TOT
54,Posthofbrug 5366,2022-12-21,06:00:00,85,74,11,FMN GV 16 Berchem TOT
54,Posthofbrug 5366,2022-12-21,07:00:00,273,218,55,FMN GV 16 Berchem TOT
54,Posthofbrug 5366,2022-12-21,08:00:00,559,427,132,FMN GV 16 Berchem TOT
54,Posthofbrug 5366,2022-12-21,09:00:00,269,199,70,FMN GV 16 Berchem TOT
54,Posthofbrug 5366,2022-12-21,10:00:00,141,89,52,FMN GV 16 Berchem TOT
54,Posthofbrug 5366,2022-12-21,11:00:00,169,89,80,FMN GV 16 Berchem TOT
54,Posthofbrug 5366,2022-12-21,12:00:00,262,136,126,FMN GV 16 Berchem TOT
54,Posthofbrug 5366,2022-12-21,13:00:00,207,103,104,FMN GV 16 Berchem TOT
54,Posthofbrug 5366,2022-12-21,14:00:00,167,82,85,FMN GV 16 Berchem TOT
54,Posthofbrug 5366,2022-12-21,15:00:00,201,82,119,FMN GV 16 Berchem TOT
54,Posthofbrug 5366,2022-12-21,16:00:00,315,90,225,FMN GV 16 Berchem TOT
54,Posthofbrug 5366,2022-12-21,17:00:00,425,127,298,FMN GV 16 Berchem TOT
54,Posthofbrug 5366,2022-12-21,18:00:00,261,104,157,FMN GV 16 Berchem TOT
54,Posthofbrug 5366,2022-12-21,19:00:00,164,85,79,FMN GV 16 Berchem TOT
54,Posthofbrug 5366,2022-12-21,20:00:00,102,45,57,FMN GV 16 Berchem TOT
54,Posthofbrug 5366,2022-12-21,21:00:00,86,32,54,FMN GV 16 Berchem TOT
54,Posthofbrug 5366,2022-12-21,22:00:00,82,14,68,FMN GV 16 Berchem TOT
54,Posthofbrug 5366,2022-12-21,23:00:00,77,17,60,FMN GV 16 Berchem TOT
54,Posthofbrug 5366,2022-12-22,00:00:00,34,5,29,FMN GV 16 Berchem TOT
54,Posthofbrug 5366,2022-12-22,01:00:00,12,1,11,FMN GV 16 Berchem TOT
54,Posthofbrug 5366,2022-12-22,02:00:00,14,1,13,FMN GV 16 Berchem TOT
54,Posthofbrug 5366,2022-12-22,03:00:00,7,2,5,FMN GV 16 Berchem TOT
54,Posthofbrug 5366,2022-12-22,04:00:00,5,2,3,FMN GV 16 Berchem TOT
54,Posthofbrug 5366,2022-12-22,05:00:00,21,16,5,FMN GV 16 Berchem TOT
54,Posthofbrug 5366,2022-12-22,06:00:00,80,59,21,FMN GV 16 Berchem TOT
54,Posthofbrug 5366,2022-12-22,07:00:00,269,213,56,FMN GV 16 Berchem TOT
54,Posthofbrug 5366,2022-12-22,08:00:00,653,521,132,FMN GV 16 Berchem TOT
54,Posthofbrug 5366,2022-12-22,09:00:00,269,201,68,FMN GV 16 Berchem TOT
54,Posthofbrug 5366,2022-12-22,10:00:00,136,94,42,FMN GV 16 Berchem TOT
54,Posthofbrug 5366,2022-12-22,11:00:00,147,89,58,FMN GV 16 Berchem TOT
54,Posthofbrug 5366,2022-12-22,12:00:00,191,118,73,FMN GV 16 Berchem TOT
54,Posthofbrug 5366,2022-12-22,13:00:00,159,76,83,FMN GV 16 Berchem TOT
54,Posthofbrug 5366,2022-12-22,14:00:00,136,55,81,FMN GV 16 Berchem TOT
54,Posthofbrug 5366,2022-12-22,15:00:00,205,75,130,FMN GV 16 Berchem TOT
54,Posthofbrug 5366,2022-12-22,16:00:00,336,121,215,FMN GV 16 Berchem TOT
54,Posthofbrug 5366,2022-12-22,17:00:00,475,155,320,FMN GV 16 Berchem TOT
54,Posthofbrug 5366,2022-12-22,18:00:00,278,94,184,FMN GV 16 Berchem TOT
54,Posthofbrug 5366,2022-12-22,19:00:00,193,83,110,FMN GV 16 Berchem TOT
54,Posthofbrug 5366,2022-12-22,20:00:00,123,41,82,FMN GV 16 Berchem TOT
54,Posthofbrug 5366,2022-12-22,21:00:00,120,41,79,FMN GV 16 Berchem TOT
54,Posthofbrug 5366,2022-12-22,22:00:00,105,26,79,FMN GV 16 Berchem TOT
54,Posthofbrug 5366,2022-12-22,23:00:00,77,12,65,FMN GV 16 Berchem TOT
54,Posthofbrug 5366,2022-12-23,00:00:00,62,15,47,FMN GV 16 Berchem TOT
54,Posthofbrug 5366,2022-12-23,01:00:00,32,3,29,FMN GV 16 Berchem TOT
54,Posthofbrug 5366,2022-12-23,02:00:00,16,2,14,FMN GV 16 Berchem TOT
54,Posthofbrug 5366,2022-12-23,03:00:00,9,1,8,FMN GV 16 Berchem TOT
54,Posthofbrug 5366,2022-12-23,04:00:00,9,5,4,FMN GV 16 Berchem TOT
54,Posthofbrug 5366,2022-12-23,05:00:00,22,16,6,FMN GV 16 Berchem TOT
54,Posthofbrug 5366,2022-12-23,06:00:00,66,46,20,FMN GV 16 Berchem TOT
54,Posthofbrug 5366,2022-12-23,07:00:00,210,162,48,FMN GV 16 Berchem TOT
54,Posthofbrug 5366,2022-12-23,08:00:00,446,349,97,FMN GV 16 Berchem TOT
54,Posthofbrug 5366,2022-12-23,09:00:00,232,183,49,FMN GV 16 Berchem TOT
54,Posthofbrug 5366,2022-12-23,10:00:00,117,83,34,FMN GV 16 Berchem TOT
54,Posthofbrug 5366,2022-12-23,11:00:00,98,47,51,FMN GV 16 Berchem TOT
54,Posthofbrug 5366,2022-12-23,12:00:00,152,66,86,FMN GV 16 Berchem TOT
54,Posthofbrug 5366,2022-12-23,13:00:00,99,28,71,FMN GV 16 Berchem TOT
54,Posthofbrug 5366,2022-12-23,14:00:00,163,68,95,FMN GV 16 Berchem TOT
54,Posthofbrug 5366,2022-12-23,15:00:00,213,68,145,FMN GV 16 Berchem TOT
54,Posthofbrug 5366,2022-12-23,16:00:00,256,89,167,FMN GV 16 Berchem TOT
54,Posthofbrug 5366,2022-12-23,17:00:00,269,90,179,FMN GV 16 Berchem TOT
54,Posthofbrug 5366,2022-12-23,18:00:00,194,91,103,FMN GV 16 Berchem TOT
54,Posthofbrug 5366,2022-12-23,19:00:00,131,70,61,FMN GV 16 Berchem TOT
54,Posthofbrug 5366,2022-12-23,20:00:00,81,43,38,FMN GV 16 Berchem TOT
54,Posthofbrug 5366,2022-12-23,21:00:00,56,25,31,FMN GV 16 Berchem TOT
54,Posthofbrug 5366,2022-12-23,22:00:00,59,13,46,FMN GV 16 Berchem TOT
54,Posthofbrug 5366,2022-12-23,23:00:00,98,22,76,FMN GV 16 Berchem TOT
54,Posthofbrug 5366,2022-12-24,00:00:00,51,16,35,FMN GV 16 Berchem TOT
54,Posthofbrug 5366,2022-12-24,01:00:00,35,9,26,FMN GV 16 Berchem TOT
54,Posthofbrug 5366,2022-12-24,02:00:00,28,5,23,FMN GV 16 Berchem TOT
54,Posthofbrug 5366,2022-12-24,03:00:00,18,5,13,FMN GV 16 Berchem TOT
54,Posthofbrug 5366,2022-12-24,04:00:00,15,5,10,FMN GV 16 Berchem TOT
54,Posthofbrug 5366,2022-12-24,05:00:00,17,8,9,FMN GV 16 Berchem TOT
54,Posthofbrug 5366,2022-12-24,06:00:00,14,7,7,FMN GV 16 Berchem TOT
54,Posthofbrug 5366,2022-12-24,07:00:00,29,18,11,FMN GV 16 Berchem TOT
54,Posthofbrug 5366,2022-12-24,08:00:00,36,23,13,FMN GV 16 Berchem TOT
54,Posthofbrug 5366,2022-12-24,09:00:00,83,57,26,FMN GV 16 Berchem TOT
54,Posthofbrug 5366,2022-12-24,10:00:00,114,77,37,FMN GV 16 Berchem TOT
54,Posthofbrug 5366,2022-12-24,11:00:00,129,77,52,FMN GV 16 Berchem TOT
54,Posthofbrug 5366,2022-12-24,12:00:00,146,70,76,FMN GV 16 Berchem TOT
54,Posthofbrug 5366,2022-12-24,13:00:00,133,68,65,FMN GV 16 Berchem TOT
54,Posthofbrug 5366,2022-12-24,14:00:00,138,59,79,FMN GV 16 Berchem TOT
54,Posthofbrug 5366,2022-12-24,15:00:00,146,64,82,FMN GV 16 Berchem TOT
54,Posthofbrug 5366,2022-12-24,16:00:00,105,33,72,FMN GV 16 Berchem TOT
54,Posthofbrug 5366,2022-12-24,17:00:00,98,35,63,FMN GV 16 Berchem TOT
54,Posthofbrug 5366,2022-12-24,18:00:00,51,16,35,FMN GV 16 Berchem TOT
54,Posthofbrug 5366,2022-12-24,19:00:00,45,16,29,FMN GV 16 Berchem TOT
54,Posthofbrug 5366,2022-12-24,20:00:00,21,8,13,FMN GV 16 Berchem TOT
54,Posthofbrug 5366,2022-12-24,21:00:00,30,22,8,FMN GV 16 Berchem TOT
54,Posthofbrug 5366,2022-12-24,22:00:00,46,29,17,FMN GV 16 Berchem TOT
54,Posthofbrug 5366,2022-12-24,23:00:00,50,34,16,FMN GV 16 Berchem TOT
54,Posthofbrug 5366,2022-12-25,00:00:00,63,38,25,FMN GV 16 Berchem TOT
54,Posthofbrug 5366,2022-12-25,01:00:00,38,23,15,FMN GV 16 Berchem TOT
54,Posthofbrug 5366,2022-12-25,02:00:00,16,10,6,FMN GV 16 Berchem TOT
54,Posthofbrug 5366,2022-12-25,03:00:00,4,2,2,FMN GV 16 Berchem TOT
54,Posthofbrug 5366,2022-12-25,04:00:00,5,3,2,FMN GV 16 Berchem TOT
54,Posthofbrug 5366,2022-12-25,05:00:00,7,3,4,FMN GV 16 Berchem TOT
54,Posthofbrug 5366,2022-12-25,06:00:00,10,9,1,FMN GV 16 Berchem TOT
54,Posthofbrug 5366,2022-12-25,07:00:00,8,7,1,FMN GV 16 Berchem TOT
54,Posthofbrug 5366,2022-12-25,08:00:00,14,9,5,FMN GV 16 Berchem TOT
54,Posthofbrug 5366,2022-12-25,09:00:00,34,25,9,FMN GV 16 Berchem TOT
54,Posthofbrug 5366,2022-12-25,10:00:00,32,20,12,FMN GV 16 Berchem TOT
54,Posthofbrug 5366,2022-12-25,11:00:00,33,17,16,FMN GV 16 Berchem TOT
54,Posthofbrug 5366,2022-12-25,12:00:00,46,17,29,FMN GV 16 Berchem TOT
54,Posthofbrug 5366,2022-12-25,13:00:00,46,18,28,FMN GV 16 Berchem TOT
54,Posthofbrug 5366,2022-12-25,14:00:00,45,24,21,FMN GV 16 Berchem TOT
54,Posthofbrug 5366,2022-12-25,15:00:00,30,15,15,FMN GV 16 Berchem TOT
54,Posthofbrug 5366,2022-12-25,16:00:00,39,18,21,FMN GV 16 Berchem TOT
54,Posthofbrug 5366,2022-12-25,17:00:00,34,25,9,FMN GV 16 Berchem TOT
54,Posthofbrug 5366,2022-12-25,18:00:00,15,8,7,FMN GV 16 Berchem TOT
54,Posthofbrug 5366,2022-12-25,19:00:00,30,10,20,FMN GV 16 Berchem TOT
54,Posthofbrug 5366,2022-12-25,20:00:00,26,19,7,FMN GV 16 Berchem TOT
54,Posthofbrug 5366,2022-12-25,21:00:00,28,15,13,FMN GV 16 Berchem TOT
54,Posthofbrug 5366,2022-12-25,22:00:00,32,21,11,FMN GV 16 Berchem TOT
54,Posthofbrug 5366,2022-12-25,23:00:00,16,11,5,FMN GV 16 Berchem TOT
54,Posthofbrug 5366,2022-12-26,00:00:00,14,9,5,FMN GV 16 Berchem TOT
54,Posthofbrug 5366,2022-12-26,01:00:00,7,1,6,FMN GV 16 Berchem TOT
54,Posthofbrug 5366,2022-12-26,02:00:00,4,2,2,FMN GV 16 Berchem TOT
54,Posthofbrug 5366,2022-12-26,03:00:00,1,1,0,FMN GV 16 Berchem TOT
54,Posthofbrug 5366,2022-12-26,04:00:00,9,3,6,FMN GV 16 Berchem TOT
54,Posthofbrug 5366,2022-12-26,05:00:00,19,15,4,FMN GV 16 Berchem TOT
54,Posthofbrug 5366,2022-12-26,06:00:00,26,19,7,FMN GV 16 Berchem TOT
54,Posthofbrug 5366,2022-12-26,07:00:00,53,37,16,FMN GV 16 Berchem TOT
54,Posthofbrug 5366,2022-12-26,08:00:00,83,55,28,FMN GV 16 Berchem TOT
54,Posthofbrug 5366,2022-12-26,09:00:00,66,42,24,FMN GV 16 Berchem TOT
54,Posthofbrug 5366,2022-12-26,10:00:00,82,58,24,FMN GV 16 Berchem TOT
54,Posthofbrug 5366,2022-12-26,11:00:00,55,35,20,FMN GV 16 Berchem TOT
54,Posthofbrug 5366,2022-12-26,12:00:00,76,42,34,FMN GV 16 Berchem TOT
54,Posthofbrug 5366,2022-12-26,13:00:00,111,72,39,FMN GV 16 Berchem TOT
54,Posthofbrug 5366,2022-12-26,14:00:00,126,80,46,FMN GV 16 Berchem TOT
54,Posthofbrug 5366,2022-12-26,15:00:00,123,68,55,FMN GV 16 Berchem TOT
54,Posthofbrug 5366,2022-12-26,16:00:00,149,80,69,FMN GV 16 Berchem TOT
54,Posthofbrug 5366,2022-12-26,17:00:00,141,53,88,FMN GV 16 Berchem TOT
54,Posthofbrug 5366,2022-12-26,18:00:00,106,47,59,FMN GV 16 Berchem TOT
54,Posthofbrug 5366,2022-12-26,19:00:00,91,46,45,FMN GV 16 Berchem TOT
54,Posthofbrug 5366,2022-12-26,20:00:00,57,26,31,FMN GV 16 Berchem TOT
54,Posthofbrug 5366,2022-12-26,21:00:00,40,27,13,FMN GV 16 Berchem TOT
54,Posthofbrug 5366,2022-12-26,22:00:00,63,16,47,FMN GV 16 Berchem TOT
54,Posthofbrug 5366,2022-12-26,23:00:00,49,16,33,FMN GV 16 Berchem TOT
54,Posthofbrug 5366,2022-12-27,00:00:00,18,11,7,FMN GV 16 Berchem TOT
54,Posthofbrug 5366,2022-12-27,01:00:00,13,0,13,FMN GV 16 Berchem TOT
54,Posthofbrug 5366,2022-12-27,02:00:00,14,2,12,FMN GV 16 Berchem TOT
54,Posthofbrug 5366,2022-12-27,03:00:00,2,0,2,FMN GV 16 Berchem TOT
54,Posthofbrug 5366,2022-12-27,04:00:00,9,8,1,FMN GV 16 Berchem TOT
54,Posthofbrug 5366,2022-12-27,05:00:00,25,19,6,FMN GV 16 Berchem TOT
54,Posthofbrug 5366,2022-12-27,06:00:00,39,31,8,FMN GV 16 Berchem TOT
54,Posthofbrug 5366,2022-12-27,07:00:00,124,87,37,FMN GV 16 Berchem TOT
54,Posthofbrug 5366,2022-12-27,08:00:00,199,151,48,FMN GV 16 Berchem TOT
54,Posthofbrug 5366,2022-12-27,09:00:00,126,90,36,FMN GV 16 Berchem TOT
54,Posthofbrug 5366,2022-12-27,10:00:00,107,78,29,FMN GV 16 Berchem TOT
54,Posthofbrug 5366,2022-12-27,11:00:00,148,105,43,FMN GV 16 Berchem TOT
54,Posthofbrug 5366,2022-12-27,12:00:00,142,80,62,FMN GV 16 Berchem TOT
54,Posthofbrug 5366,2022-12-27,13:00:00,127,80,47,FMN GV 16 Berchem TOT
54,Posthofbrug 5366,2022-12-27,14:00:00,121,73,48,FMN GV 16 Berchem TOT
54,Posthofbrug 5366,2022-12-27,15:00:00,153,70,83,FMN GV 16 Berchem TOT
54,Posthofbrug 5366,2022-12-27,16:00:00,234,100,134,FMN GV 16 Berchem TOT
54,Posthofbrug 5366,2022-12-27,17:00:00,282,89,193,FMN GV 16 Berchem TOT
54,Posthofbrug 5366,2022-12-27,18:00:00,168,60,108,FMN GV 16 Berchem TOT
54,Posthofbrug 5366,2022-12-27,19:00:00,121,57,64,FMN GV 16 Berchem TOT
54,Posthofbrug 5366,2022-12-27,20:00:00,90,41,49,FMN GV 16 Berchem TOT
54,Posthofbrug 5366,2022-12-27,21:00:00,50,27,23,FMN GV 16 Berchem TOT
54,Posthofbrug 5366,2022-12-27,22:00:00,82,15,67,FMN GV 16 Berchem TOT
54,Posthofbrug 5366,2022-12-27,23:00:00,54,11,43,FMN GV 16 Berchem TOT
54,Posthofbrug 5366,2022-12-28,00:00:00,35,10,25,FMN GV 16 Berchem TOT
54,Posthofbrug 5366,2022-12-28,01:00:00,10,3,7,FMN GV 16 Berchem TOT
54,Posthofbrug 5366,2022-12-28,02:00:00,8,0,8,FMN GV 16 Berchem TOT
54,Posthofbrug 5366,2022-12-28,03:00:00,8,3,5,FMN GV 16 Berchem TOT
54,Posthofbrug 5366,2022-12-28,04:00:00,10,7,3,FMN GV 16 Berchem TOT
54,Posthofbrug 5366,2022-12-28,05:00:00,22,15,7,FMN GV 16 Berchem TOT
54,Posthofbrug 5366,2022-12-28,06:00:00,41,31,10,FMN GV 16 Berchem TOT
54,Posthofbrug 5366,2022-12-28,07:00:00,108,76,32,FMN GV 16 Berchem TOT
54,Posthofbrug 5366,2022-12-28,08:00:00,165,120,45,FMN GV 16 Berchem TOT
54,Posthofbrug 5366,2022-12-28,09:00:00,113,80,33,FMN GV 16 Berchem TOT
54,Posthofbrug 5366,2022-12-28,10:00:00,93,61,32,FMN GV 16 Berchem TOT
54,Posthofbrug 5366,2022-12-28,11:00:00,75,47,28,FMN GV 16 Berchem TOT
54,Posthofbrug 5366,2022-12-28,12:00:00,100,50,50,FMN GV 16 Berchem TOT
54,Posthofbrug 5366,2022-12-28,13:00:00,106,64,42,FMN GV 16 Berchem TOT
54,Posthofbrug 5366,2022-12-28,14:00:00,120,66,54,FMN GV 16 Berchem TOT
54,Posthofbrug 5366,2022-12-28,15:00:00,109,51,58,FMN GV 16 Berchem TOT
54,Posthofbrug 5366,2022-12-28,16:00:00,135,58,77,FMN GV 16 Berchem TOT
54,Posthofbrug 5366,2022-12-28,17:00:00,182,54,128,FMN GV 16 Berchem TOT
54,Posthofbrug 5366,2022-12-28,18:00:00,132,48,84,FMN GV 16 Berchem TOT
54,Posthofbrug 5366,2022-12-28,19:00:00,90,38,52,FMN GV 16 Berchem TOT
54,Posthofbrug 5366,2022-12-28,20:00:00,51,28,23,FMN GV 16 Berchem TOT
54,Posthofbrug 5366,2022-12-28,21:00:00,57,16,41,FMN GV 16 Berchem TOT
54,Posthofbrug 5366,2022-12-28,22:00:00,57,12,45,FMN GV 16 Berchem TOT
54,Posthofbrug 5366,2022-12-28,23:00:00,55,13,42,FMN GV 16 Berchem TOT
54,Posthofbrug 5366,2022-12-29,00:00:00,20,6,14,FMN GV 16 Berchem TOT
54,Posthofbrug 5366,2022-12-29,01:00:00,7,2,5,FMN GV 16 Berchem TOT
54,Posthofbrug 5366,2022-12-29,02:00:00,11,1,10,FMN GV 16 Berchem TOT
54,Posthofbrug 5366,2022-12-29,03:00:00,8,3,5,FMN GV 16 Berchem TOT
54,Posthofbrug 5366,2022-12-29,04:00:00,6,3,3,FMN GV 16 Berchem TOT
54,Posthofbrug 5366,2022-12-29,05:00:00,27,21,6,FMN GV 16 Berchem TOT
54,Posthofbrug 5366,2022-12-29,06:00:00,41,25,16,FMN GV 16 Berchem TOT
54,Posthofbrug 5366,2022-12-29,07:00:00,104,77,27,FMN GV 16 Berchem TOT
54,Posthofbrug 5366,2022-12-29,08:00:00,183,130,53,FMN GV 16 Berchem TOT
54,Posthofbrug 5366,2022-12-29,09:00:00,93,68,25,FMN GV 16 Berchem TOT
54,Posthofbrug 5366,2022-12-29,10:00:00,112,78,34,FMN GV 16 Berchem TOT
54,Posthofbrug 5366,2022-12-29,11:00:00,74,49,25,FMN GV 16 Berchem TOT
54,Posthofbrug 5366,2022-12-29,12:00:00,101,61,40,FMN GV 16 Berchem TOT
54,Posthofbrug 5366,2022-12-29,13:00:00,94,49,45,FMN GV 16 Berchem TOT
54,Posthofbrug 5366,2022-12-29,14:00:00,112,49,63,FMN GV 16 Berchem TOT
54,Posthofbrug 5366,2022-12-29,15:00:00,96,53,43,FMN GV 16 Berchem TOT
54,Posthofbrug 5366,2022-12-29,16:00:00,157,62,95,FMN GV 16 Berchem TOT
54,Posthofbrug 5366,2022-12-29,17:00:00,205,80,125,FMN GV 16 Berchem TOT
54,Posthofbrug 5366,2022-12-29,18:00:00,162,77,85,FMN GV 16 Berchem TOT
54,Posthofbrug 5366,2022-12-29,19:00:00,115,59,56,FMN GV 16 Berchem TOT
54,Posthofbrug 5366,2022-12-29,20:00:00,72,32,40,FMN GV 16 Berchem TOT
54,Posthofbrug 5366,2022-12-29,21:00:00,59,38,21,FMN GV 16 Berchem TOT
54,Posthofbrug 5366,2022-12-29,22:00:00,90,24,66,FMN GV 16 Berchem TOT
54,Posthofbrug 5366,2022-12-29,23:00:00,56,14,42,FMN GV 16 Berchem TOT
54,Posthofbrug 5366,2022-12-30,00:00:00,34,7,27,FMN GV 16 Berchem TOT
54,Posthofbrug 5366,2022-12-30,01:00:00,27,5,22,FMN GV 16 Berchem TOT
54,Posthofbrug 5366,2022-12-30,02:00:00,9,0,9,FMN GV 16 Berchem TOT
54,Posthofbrug 5366,2022-12-30,03:00:00,9,1,8,FMN GV 16 Berchem TOT
54,Posthofbrug 5366,2022-12-30,04:00:00,16,8,8,FMN GV 16 Berchem TOT
54,Posthofbrug 5366,2022-12-30,05:00:00,21,18,3,FMN GV 16 Berchem TOT
54,Posthofbrug 5366,2022-12-30,06:00:00,41,29,12,FMN GV 16 Berchem TOT
54,Posthofbrug 5366,2022-12-30,07:00:00,68,47,21,FMN GV 16 Berchem TOT
54,Posthofbrug 5366,2022-12-30,08:00:00,138,108,30,FMN GV 16 Berchem TOT
54,Posthofbrug 5366,2022-12-30,09:00:00,110,73,37,FMN GV 16 Berchem TOT
54,Posthofbrug 5366,2022-12-30,10:00:00,89,59,30,FMN GV 16 Berchem TOT
54,Posthofbrug 5366,2022-12-30,11:00:00,125,71,54,FMN GV 16 Berchem TOT
54,Posthofbrug 5366,2022-12-30,12:00:00,101,47,54,FMN GV 16 Berchem TOT
54,Posthofbrug 5366,2022-12-30,13:00:00,65,34,31,FMN GV 16 Berchem TOT
54,Posthofbrug 5366,2022-12-30,14:00:00,87,51,36,FMN GV 16 Berchem TOT
54,Posthofbrug 5366,2022-12-30,15:00:00,83,35,48,FMN GV 16 Berchem TOT
54,Posthofbrug 5366,2022-12-30,16:00:00,140,49,91,FMN GV 16 Berchem TOT
54,Posthofbrug 5366,2022-12-30,17:00:00,161,72,89,FMN GV 16 Berchem TOT
54,Posthofbrug 5366,2022-12-30,18:00:00,122,47,75,FMN GV 16 Berchem TOT
54,Posthofbrug 5366,2022-12-30,19:00:00,76,43,33,FMN GV 16 Berchem TOT
54,Posthofbrug 5366,2022-12-30,20:00:00,44,13,31,FMN GV 16 Berchem TOT
54,Posthofbrug 5366,2022-12-30,21:00:00,56,28,28,FMN GV 16 Berchem TOT
54,Posthofbrug 5366,2022-12-30,22:00:00,52,18,34,FMN GV 16 Berchem TOT
54,Posthofbrug 5366,2022-12-30,23:00:00,29,2,27,FMN GV 16 Berchem TOT
54,Posthofbrug 5366,2022-12-31,00:00:00,29,4,25,FMN GV 16 Berchem TOT
54,Posthofbrug 5366,2022-12-31,01:00:00,20,3,17,FMN GV 16 Berchem TOT
54,Posthofbrug 5366,2022-12-31,02:00:00,8,0,8,FMN GV 16 Berchem TOT
54,Posthofbrug 5366,2022-12-31,03:00:00,6,1,5,FMN GV 16 Berchem TOT
54,Posthofbrug 5366,2022-12-31,04:00:00,1,0,1,FMN GV 16 Berchem TOT
54,Posthofbrug 5366,2022-12-31,05:00:00,9,4,5,FMN GV 16 Berchem TOT
54,Posthofbrug 5366,2022-12-31,06:00:00,13,7,6,FMN GV 16 Berchem TOT
54,Posthofbrug 5366,2022-12-31,07:00:00,12,10,2,FMN GV 16 Berchem TOT
54,Posthofbrug 5366,2022-12-31,08:00:00,35,29,6,FMN GV 16 Berchem TOT
54,Posthofbrug 5366,2022-12-31,09:00:00,51,28,23,FMN GV 16 Berchem TOT
54,Posthofbrug 5366,2022-12-31,10:00:00,49,32,17,FMN GV 16 Berchem TOT
54,Posthofbrug 5366,2022-12-31,11:00:00,56,36,20,FMN GV 16 Berchem TOT
54,Posthofbrug 5366,2022-12-31,12:00:00,76,45,31,FMN GV 16 Berchem TOT
54,Posthofbrug 5366,2022-12-31,13:00:00,69,43,26,FMN GV 16 Berchem TOT
54,Posthofbrug 5366,2022-12-31,14:00:00,71,36,35,FMN GV 16 Berchem TOT
54,Posthofbrug 5366,2022-12-31,15:00:00,89,49,40,FMN GV 16 Berchem TOT
54,Posthofbrug 5366,2022-12-31,16:00:00,127,61,66,FMN GV 16 Berchem TOT
54,Posthofbrug 5366,2022-12-31,17:00:00,163,83,80,FMN GV 16 Berchem TOT
54,Posthofbrug 5366,2022-12-31,18:00:00,118,72,46,FMN GV 16 Berchem TOT
54,Posthofbrug 5366,2022-12-31,19:00:00,66,35,31,FMN GV 16 Berchem TOT
54,Posthofbrug 5366,2022-12-31,20:00:00,31,26,5,FMN GV 16 Berchem TOT
54,Posthofbrug 5366,2022-12-31,21:00:00,25,15,10,FMN GV 16 Berchem TOT
54,Posthofbrug 5366,2022-12-31,22:00:00,67,43,24,FMN GV 16 Berchem TOT
54,Posthofbrug 5366,2022-12-31,23:00:00,940,518,422,FMN GV 16 Berchem TOT
54,Posthofbrug 5366,2023-01-01,00:00:00,0,0,0,FMN GV 16 Berchem TOT
54,Posthofbrug 5366,2023-01-01,01:00:00,122,65,57,FMN GV 16 Berchem TOT
54,Posthofbrug 5366,2023-01-01,02:00:00,72,34,38,FMN GV 16 Berchem TOT
54,Posthofbrug 5366,2023-01-01,03:00:00,70,22,48,FMN GV 16 Berchem TOT
54,Posthofbrug 5366,2023-01-01,04:00:00,87,17,70,FMN GV 16 Berchem TOT
54,Posthofbrug 5366,2023-01-01,05:00:00,52,7,45,FMN GV 16 Berchem TOT
54,Posthofbrug 5366,2023-01-01,06:00:00,33,8,25,FMN GV 16 Berchem TOT
54,Posthofbrug 5366,2023-01-01,07:00:00,23,8,15,FMN GV 16 Berchem TOT
54,Posthofbrug 5366,2023-01-01,08:00:00,14,5,9,FMN GV 16 Berchem TOT
54,Posthofbrug 5366,2023-01-01,09:00:00,22,12,10,FMN GV 16 Berchem TOT
54,Posthofbrug 5366,2023-01-01,10:00:00,34,21,13,FMN GV 16 Berchem TOT
54,Posthofbrug 5366,2023-01-01,11:00:00,54,36,18,FMN GV 16 Berchem TOT
54,Posthofbrug 5366,2023-01-01,12:00:00,81,43,38,FMN GV 16 Berchem TOT
54,Posthofbrug 5366,2023-01-01,13:00:00,71,34,37,FMN GV 16 Berchem TOT
54,Posthofbrug 5366,2023-01-01,14:00:00,113,49,64,FMN GV 16 Berchem TOT
54,Posthofbrug 5366,2023-01-01,15:00:00,80,33,47,FMN GV 16 Berchem TOT
54,Posthofbrug 5366,2023-01-01,16:00:00,86,38,48,FMN GV 16 Berchem TOT
54,Posthofbrug 5366,2023-01-01,17:00:00,42,17,25,FMN GV 16 Berchem TOT
54,Posthofbrug 5366,2023-01-01,18:00:00,50,23,27,FMN GV 16 Berchem TOT
54,Posthofbrug 5366,2023-01-01,19:00:00,36,24,12,FMN GV 16 Berchem TOT
54,Posthofbrug 5366,2023-01-01,20:00:00,33,18,15,FMN GV 16 Berchem TOT
54,Posthofbrug 5366,2023-01-01,21:00:00,37,23,14,FMN GV 16 Berchem TOT
54,Posthofbrug 5366,2023-01-01,22:00:00,14,5,9,FMN GV 16 Berchem TOT
54,Posthofbrug 5366,2023-01-01,23:00:00,11,5,6,FMN GV 16 Berchem TOT
54,Posthofbrug 5366,2023-01-02,00:00:00,7,3,4,FMN GV 16 Berchem TOT
54,Posthofbrug 5366,2023-01-02,01:00:00,3,0,3,FMN GV 16 Berchem TOT
54,Posthofbrug 5366,2023-01-02,02:00:00,1,0,1,FMN GV 16 Berchem TOT
54,Posthofbrug 5366,2023-01-02,03:00:00,4,2,2,FMN GV 16 Berchem TOT
54,Posthofbrug 5366,2023-01-02,04:00:00,6,3,3,FMN GV 16 Berchem TOT
54,Posthofbrug 5366,2023-01-02,05:00:00,11,9,2,FMN GV 16 Berchem TOT
54,Posthofbrug 5366,2023-01-02,06:00:00,44,35,9,FMN GV 16 Berchem TOT
54,Posthofbrug 5366,2023-01-02,07:00:00,108,81,27,FMN GV 16 Berchem TOT
54,Posthofbrug 5366,2023-01-02,08:00:00,205,154,51,FMN GV 16 Berchem TOT
54,Posthofbrug 5366,2023-01-02,09:00:00,98,75,23,FMN GV 16 Berchem TOT
54,Posthofbrug 5366,2023-01-02,10:00:00,64,45,19,FMN GV 16 Berchem TOT
54,Posthofbrug 5366,2023-01-02,11:00:00,84,56,28,FMN GV 16 Berchem TOT
54,Posthofbrug 5366,2023-01-02,12:00:00,98,59,39,FMN GV 16 Berchem TOT
54,Posthofbrug 5366,2023-01-02,13:00:00,93,49,44,FMN GV 16 Berchem TOT
54,Posthofbrug 5366,2023-01-02,14:00:00,93,48,45,FMN GV 16 Berchem TOT
54,Posthofbrug 5366,2023-01-02,15:00:00,93,33,60,FMN GV 16 Berchem TOT
54,Posthofbrug 5366,2023-01-02,16:00:00,161,60,101,FMN GV 16 Berchem TOT
54,Posthofbrug 5366,2023-01-02,17:00:00,203,65,138,FMN GV 16 Berchem TOT
54,Posthofbrug 5366,2023-01-02,18:00:00,142,45,97,FMN GV 16 Berchem TOT
54,Posthofbrug 5366,2023-01-02,19:00:00,61,19,42,FMN GV 16 Berchem TOT
54,Posthofbrug 5366,2023-01-02,20:00:00,50,21,29,FMN GV 16 Berchem TOT
54,Posthofbrug 5366,2023-01-02,21:00:00,58,27,31,FMN GV 16 Berchem TOT
54,Posthofbrug 5366,2023-01-02,22:00:00,44,11,33,FMN GV 16 Berchem TOT
54,Posthofbrug 5366,2023-01-02,23:00:00,30,10,20,FMN GV 16 Berchem TOT
54,Posthofbrug 5366,2023-01-03,00:00:00,14,4,10,FMN GV 16 Berchem TOT
54,Posthofbrug 5366,2023-01-03,01:00:00,8,3,5,FMN GV 16 Berchem TOT
54,Posthofbrug 5366,2023-01-03,02:00:00,4,3,1,FMN GV 16 Berchem TOT
54,Posthofbrug 5366,2023-01-03,03:00:00,1,1,0,FMN GV 16 Berchem TOT
54,Posthofbrug 5366,2023-01-03,04:00:00,8,4,4,FMN GV 16 Berchem TOT
54,Posthofbrug 5366,2023-01-03,05:00:00,28,23,5,FMN GV 16 Berchem TOT
54,Posthofbrug 5366,2023-01-03,06:00:00,80,62,18,FMN GV 16 Berchem TOT
54,Posthofbrug 5366,2023-01-03,07:00:00,254,185,69,FMN GV 16 Berchem TOT
54,Posthofbrug 5366,2023-01-03,08:00:00,409,285,124,FMN GV 16 Berchem TOT
54,Posthofbrug 5366,2023-01-03,09:00:00,199,156,43,FMN GV 16 Berchem TOT
54,Posthofbrug 5366,2023-01-03,10:00:00,121,93,28,FMN GV 16 Berchem TOT
54,Posthofbrug 5366,2023-01-03,11:00:00,138,88,50,FMN GV 16 Berchem TOT
54,Posthofbrug 5366,2023-01-03,12:00:00,152,89,63,FMN GV 16 Berchem TOT
54,Posthofbrug 5366,2023-01-03,13:00:00,134,70,64,FMN GV 16 Berchem TOT
54,Posthofbrug 5366,2023-01-03,14:00:00,118,50,68,FMN GV 16 Berchem TOT
54,Posthofbrug 5366,2023-01-03,15:00:00,150,57,93,FMN GV 16 Berchem TOT
54,Posthofbrug 5366,2023-01-03,16:00:00,305,104,201,FMN GV 16 Berchem TOT
54,Posthofbrug 5366,2023-01-03,17:00:00,409,161,248,FMN GV 16 Berchem TOT
54,Posthofbrug 5366,2023-01-03,18:00:00,258,76,182,FMN GV 16 Berchem TOT
54,Posthofbrug 5366,2023-01-03,19:00:00,117,39,78,FMN GV 16 Berchem TOT
54,Posthofbrug 5366,2023-01-03,20:00:00,79,24,55,FMN GV 16 Berchem TOT
54,Posthofbrug 5366,2023-01-03,21:00:00,64,24,40,FMN GV 16 Berchem TOT
54,Posthofbrug 5366,2023-01-03,22:00:00,62,27,35,FMN GV 16 Berchem TOT
54,Posthofbrug 5366,2023-01-03,23:00:00,46,14,32,FMN GV 16 Berchem TOT
54,Posthofbrug 5366,2023-01-04,00:00:00,18,6,12,FMN GV 16 Berchem TOT
54,Posthofbrug 5366,2023-01-04,01:00:00,3,1,2,FMN GV 16 Berchem TOT
54,Posthofbrug 5366,2023-01-04,02:00:00,9,2,7,FMN GV 16 Berchem TOT
54,Posthofbrug 5366,2023-01-04,03:00:00,4,2,2,FMN GV 16 Berchem TOT
54,Posthofbrug 5366,2023-01-04,04:00:00,4,3,1,FMN GV 16 Berchem TOT
54,Posthofbrug 5366,2023-01-04,05:00:00,14,12,2,FMN GV 16 Berchem TOT
54,Posthofbrug 5366,2023-01-04,06:00:00,72,60,12,FMN GV 16 Berchem TOT
54,Posthofbrug 5366,2023-01-04,07:00:00,215,155,60,FMN GV 16 Berchem TOT
54,Posthofbrug 5366,2023-01-04,08:00:00,321,232,89,FMN GV 16 Berchem TOT
54,Posthofbrug 5366,2023-01-04,09:00:00,127,88,39,FMN GV 16 Berchem TOT
54,Posthofbrug 5366,2023-01-04,10:00:00,68,40,28,FMN GV 16 Berchem TOT
54,Posthofbrug 5366,2023-01-04,11:00:00,55,33,22,FMN GV 16 Berchem TOT
54,Posthofbrug 5366,2023-01-04,12:00:00,81,49,32,FMN GV 16 Berchem TOT
54,Posthofbrug 5366,2023-01-04,13:00:00,90,46,44,FMN GV 16 Berchem TOT
54,Posthofbrug 5366,2023-01-04,14:00:00,83,32,51,FMN GV 16 Berchem TOT
54,Posthofbrug 5366,2023-01-04,15:00:00,95,32,63,FMN GV 16 Berchem TOT
54,Posthofbrug 5366,2023-01-04,16:00:00,222,86,136,FMN GV 16 Berchem TOT
54,Posthofbrug 5366,2023-01-04,17:00:00,318,113,205,FMN GV 16 Berchem TOT
54,Posthofbrug 5366,2023-01-04,18:00:00,225,87,138,FMN GV 16 Berchem TOT
54,Posthofbrug 5366,2023-01-04,19:00:00,125,53,72,FMN GV 16 Berchem TOT
54,Posthofbrug 5366,2023-01-04,20:00:00,75,39,36,FMN GV 16 Berchem TOT
54,Posthofbrug 5366,2023-01-04,21:00:00,43,19,24,FMN GV 16 Berchem TOT
54,Posthofbrug 5366,2023-01-04,22:00:00,68,15,53,FMN GV 16 Berchem TOT
54,Posthofbrug 5366,2023-01-04,23:00:00,42,13,29,FMN GV 16 Berchem TOT
54,Posthofbrug 5366,2023-01-05,00:00:00,27,7,20,FMN GV 16 Berchem TOT
54,Posthofbrug 5366,2023-01-05,01:00:00,9,4,5,FMN GV 16 Berchem TOT
54,Posthofbrug 5366,2023-01-05,02:00:00,5,0,5,FMN GV 16 Berchem TOT
54,Posthofbrug 5366,2023-01-05,03:00:00,3,1,2,FMN GV 16 Berchem TOT
54,Posthofbrug 5366,2023-01-05,04:00:00,6,1,5,FMN GV 16 Berchem TOT
54,Posthofbrug 5366,2023-01-05,05:00:00,22,17,5,FMN GV 16 Berchem TOT
54,Posthofbrug 5366,2023-01-05,06:00:00,87,71,16,FMN GV 16 Berchem TOT
54,Posthofbrug 5366,2023-01-05,07:00:00,267,195,72,FMN GV 16 Berchem TOT
54,Posthofbrug 5366,2023-01-05,08:00:00,425,300,125,FMN GV 16 Berchem TOT
54,Posthofbrug 5366,2023-01-05,09:00:00,197,142,55,FMN GV 16 Berchem TOT
54,Posthofbrug 5366,2023-01-05,10:00:00,108,71,37,FMN GV 16 Berchem TOT
54,Posthofbrug 5366,2023-01-05,11:00:00,91,66,25,FMN GV 16 Berchem TOT
54,Posthofbrug 5366,2023-01-05,12:00:00,154,89,65,FMN GV 16 Berchem TOT
54,Posthofbrug 5366,2023-01-05,13:00:00,138,80,58,FMN GV 16 Berchem TOT
54,Posthofbrug 5366,2023-01-05,14:00:00,124,64,60,FMN GV 16 Berchem TOT
54,Posthofbrug 5366,2023-01-05,15:00:00,156,56,100,FMN GV 16 Berchem TOT
54,Posthofbrug 5366,2023-01-05,16:00:00,326,114,212,FMN GV 16 Berchem TOT
54,Posthofbrug 5366,2023-01-05,17:00:00,401,143,258,FMN GV 16 Berchem TOT
54,Posthofbrug 5366,2023-01-05,18:00:00,247,90,157,FMN GV 16 Berchem TOT
54,Posthofbrug 5366,2023-01-05,19:00:00,157,56,101,FMN GV 16 Berchem TOT
54,Posthofbrug 5366,2023-01-05,20:00:00,95,46,49,FMN GV 16 Berchem TOT
54,Posthofbrug 5366,2023-01-05,21:00:00,81,29,52,FMN GV 16 Berchem TOT
54,Posthofbrug 5366,2023-01-05,22:00:00,62,22,40,FMN GV 16 Berchem TOT
54,Posthofbrug 5366,2023-01-05,23:00:00,66,18,48,FMN GV 16 Berchem TOT
54,Posthofbrug 5366,2023-01-06,00:00:00,26,6,20,FMN GV 16 Berchem TOT
54,Posthofbrug 5366,2023-01-06,01:00:00,17,8,9,FMN GV 16 Berchem TOT
54,Posthofbrug 5366,2023-01-06,02:00:00,11,3,8,FMN GV 16 Berchem TOT
54,Posthofbrug 5366,2023-01-06,03:00:00,5,3,2,FMN GV 16 Berchem TOT
54,Posthofbrug 5366,2023-01-06,04:00:00,6,4,2,FMN GV 16 Berchem TOT
54,Posthofbrug 5366,2023-01-06,05:00:00,20,16,4,FMN GV 16 Berchem TOT
54,Posthofbrug 5366,2023-01-06,06:00:00,66,49,17,FMN GV 16 Berchem TOT
54,Posthofbrug 5366,2023-01-06,07:00:00,180,124,56,FMN GV 16 Berchem TOT
54,Posthofbrug 5366,2023-01-06,08:00:00,309,231,78,FMN GV 16 Berchem TOT
54,Posthofbrug 5366,2023-01-06,09:00:00,165,120,45,FMN GV 16 Berchem TOT
54,Posthofbrug 5366,2023-01-06,10:00:00,105,80,25,FMN GV 16 Berchem TOT
54,Posthofbrug 5366,2023-01-06,11:00:00,132,100,32,FMN GV 16 Berchem TOT
54,Posthofbrug 5366,2023-01-06,12:00:00,131,74,57,FMN GV 16 Berchem TOT
54,Posthofbrug 5366,2023-01-06,13:00:00,150,77,73,FMN GV 16 Berchem TOT
54,Posthofbrug 5366,2023-01-06,14:00:00,147,79,68,FMN GV 16 Berchem TOT
54,Posthofbrug 5366,2023-01-06,15:00:00,169,60,109,FMN GV 16 Berchem TOT
54,Posthofbrug 5366,2023-01-06,16:00:00,299,121,178,FMN GV 16 Berchem TOT
54,Posthofbrug 5366,2023-01-06,17:00:00,336,128,208,FMN GV 16 Berchem TOT
54,Posthofbrug 5366,2023-01-06,18:00:00,191,84,107,FMN GV 16 Berchem TOT
54,Posthofbrug 5366,2023-01-06,19:00:00,158,74,84,FMN GV 16 Berchem TOT
54,Posthofbrug 5366,2023-01-06,20:00:00,118,68,50,FMN GV 16 Berchem TOT
54,Posthofbrug 5366,2023-01-06,21:00:00,69,34,35,FMN GV 16 Berchem TOT
54,Posthofbrug 5366,2023-01-06,22:00:00,75,22,53,FMN GV 16 Berchem TOT
54,Posthofbrug 5366,2023-01-06,23:00:00,106,26,80,FMN GV 16 Berchem TOT
54,Posthofbrug 5366,2023-01-07,00:00:00,64,18,46,FMN GV 16 Berchem TOT
54,Posthofbrug 5366,2023-01-07,01:00:00,42,16,26,FMN GV 16 Berchem TOT
54,Posthofbrug 5366,2023-01-07,02:00:00,30,3,27,FMN GV 16 Berchem TOT
54,Posthofbrug 5366,2023-01-07,03:00:00,11,5,6,FMN GV 16 Berchem TOT
54,Posthofbrug 5366,2023-01-07,04:00:00,25,3,22,FMN GV 16 Berchem TOT
54,Posthofbrug 5366,2023-01-07,05:00:00,12,5,7,FMN GV 16 Berchem TOT
54,Posthofbrug 5366,2023-01-07,06:00:00,20,12,8,FMN GV 16 Berchem TOT
54,Posthofbrug 5366,2023-01-07,07:00:00,30,25,5,FMN GV 16 Berchem TOT
54,Posthofbrug 5366,2023-01-07,08:00:00,51,36,15,FMN GV 16 Berchem TOT
54,Posthofbrug 5366,2023-01-07,09:00:00,106,74,32,FMN GV 16 Berchem TOT
54,Posthofbrug 5366,2023-01-07,10:00:00,114,73,41,FMN GV 16 Berchem TOT
54,Posthofbrug 5366,2023-01-07,11:00:00,152,95,57,FMN GV 16 Berchem TOT
54,Posthofbrug 5366,2023-01-07,12:00:00,146,96,50,FMN GV 16 Berchem TOT
54,Posthofbrug 5366,2023-01-07,13:00:00,205,125,80,FMN GV 16 Berchem TOT
54,Posthofbrug 5366,2023-01-07,14:00:00,168,108,60,FMN GV 16 Berchem TOT
54,Posthofbrug 5366,2023-01-07,15:00:00,137,57,80,FMN GV 16 Berchem TOT
54,Posthofbrug 5366,2023-01-07,16:00:00,140,52,88,FMN GV 16 Berchem TOT
54,Posthofbrug 5366,2023-01-07,17:00:00,128,45,83,FMN GV 16 Berchem TOT
54,Posthofbrug 5366,2023-01-07,18:00:00,119,52,67,FMN GV 16 Berchem TOT
54,Posthofbrug 5366,2023-01-07,19:00:00,89,44,45,FMN GV 16 Berchem TOT
54,Posthofbrug 5366,2023-01-07,20:00:00,71,39,32,FMN GV 16 Berchem TOT
54,Posthofbrug 5366,2023-01-07,21:00:00,79,39,40,FMN GV 16 Berchem TOT
54,Posthofbrug 5366,2023-01-07,22:00:00,59,18,41,FMN GV 16 Berchem TOT
54,Posthofbrug 5366,2023-01-07,23:00:00,74,30,44,FMN GV 16 Berchem TOT
54,Posthofbrug 5366,2023-01-08,00:00:00,55,21,34,FMN GV 16 Berchem TOT
54,Posthofbrug 5366,2023-01-08,01:00:00,31,10,21,FMN GV 16 Berchem TOT
54,Posthofbrug 5366,2023-01-08,02:00:00,26,8,18,FMN GV 16 Berchem TOT
54,Posthofbrug 5366,2023-01-08,03:00:00,8,2,6,FMN GV 16 Berchem TOT
54,Posthofbrug 5366,2023-01-08,04:00:00,8,2,6,FMN GV 16 Berchem TOT
54,Posthofbrug 5366,2023-01-08,05:00:00,4,1,3,FMN GV 16 Berchem TOT
54,Posthofbrug 5366,2023-01-08,06:00:00,20,13,7,FMN GV 16 Berchem TOT
54,Posthofbrug 5366,2023-01-08,07:00:00,19,13,6,FMN GV 16 Berchem TOT
54,Posthofbrug 5366,2023-01-08,08:00:00,47,27,20,FMN GV 16 Berchem TOT
54,Posthofbrug 5366,2023-01-08,09:00:00,68,40,28,FMN GV 16 Berchem TOT
54,Posthofbrug 5366,2023-01-08,10:00:00,91,58,33,FMN GV 16 Berchem TOT
54,Posthofbrug 5366,2023-01-08,11:00:00,139,85,54,FMN GV 16 Berchem TOT
54,Posthofbrug 5366,2023-01-08,12:00:00,148,83,65,FMN GV 16 Berchem TOT
54,Posthofbrug 5366,2023-01-08,13:00:00,163,91,72,FMN GV 16 Berchem TOT
54,Posthofbrug 5366,2023-01-08,14:00:00,171,100,71,FMN GV 16 Berchem TOT
54,Posthofbrug 5366,2023-01-08,15:00:00,124,63,61,FMN GV 16 Berchem TOT
54,Posthofbrug 5366,2023-01-08,16:00:00,125,47,78,FMN GV 16 Berchem TOT
54,Posthofbrug 5366,2023-01-08,17:00:00,135,54,81,FMN GV 16 Berchem TOT
54,Posthofbrug 5366,2023-01-08,18:00:00,84,35,49,FMN GV 16 Berchem TOT
54,Posthofbrug 5366,2023-01-08,19:00:00,79,32,47,FMN GV 16 Berchem TOT
54,Posthofbrug 5366,2023-01-08,20:00:00,60,25,35,FMN GV 16 Berchem TOT
54,Posthofbrug 5366,2023-01-08,21:00:00,48,24,24,FMN GV 16 Berchem TOT
54,Posthofbrug 5366,2023-01-08,22:00:00,28,4,24,FMN GV 16 Berchem TOT
54,Posthofbrug 5366,2023-01-08,23:00:00,17,3,14,FMN GV 16 Berchem TOT
54,Posthofbrug 5366,2023-01-09,00:00:00,6,0,6,FMN GV 16 Berchem TOT
54,Posthofbrug 5366,2023-01-09,01:00:00,6,1,5,FMN GV 16 Berchem TOT
54,Posthofbrug 5366,2023-01-09,02:00:00,1,0,1,FMN GV 16 Berchem TOT
54,Posthofbrug 5366,2023-01-09,03:00:00,2,0,2,FMN GV 16 Berchem TOT
54,Posthofbrug 5366,2023-01-09,04:00:00,6,3,3,FMN GV 16 Berchem TOT
54,Posthofbrug 5366,2023-01-09,05:00:00,29,22,7,FMN GV 16 Berchem TOT
54,Posthofbrug 5366,2023-01-09,06:00:00,135,108,27,FMN GV 16 Berchem TOT
54,Posthofbrug 5366,2023-01-09,07:00:00,430,330,100,FMN GV 16 Berchem TOT
54,Posthofbrug 5366,2023-01-09,08:00:00,882,693,189,FMN GV 16 Berchem TOT
54,Posthofbrug 5366,2023-01-09,09:00:00,243,186,57,FMN GV 16 Berchem TOT
54,Posthofbrug 5366,2023-01-09,10:00:00,107,80,27,FMN GV 16 Berchem TOT
54,Posthofbrug 5366,2023-01-09,11:00:00,102,58,44,FMN GV 16 Berchem TOT
54,Posthofbrug 5366,2023-01-09,12:00:00,159,89,70,FMN GV 16 Berchem TOT
54,Posthofbrug 5366,2023-01-09,13:00:00,140,75,65,FMN GV 16 Berchem TOT
54,Posthofbrug 5366,2023-01-09,14:00:00,142,49,93,FMN GV 16 Berchem TOT
54,Posthofbrug 5366,2023-01-09,15:00:00,236,72,164,FMN GV 16 Berchem TOT
54,Posthofbrug 5366,2023-01-09,16:00:00,483,133,350,FMN GV 16 Berchem TOT
54,Posthofbrug 5366,2023-01-09,17:00:00,643,181,462,FMN GV 16 Berchem TOT
54,Posthofbrug 5366,2023-01-09,18:00:00,314,81,233,FMN GV 16 Berchem TOT
54,Posthofbrug 5366,2023-01-09,19:00:00,153,52,101,FMN GV 16 Berchem TOT
54,Posthofbrug 5366,2023-01-09,20:00:00,88,35,53,FMN GV 16 Berchem TOT
54,Posthofbrug 5366,2023-01-09,21:00:00,82,37,45,FMN GV 16 Berchem TOT
54,Posthofbrug 5366,2023-01-09,22:00:00,67,27,40,FMN GV 16 Berchem TOT
54,Posthofbrug 5366,2023-01-09,23:00:00,38,13,25,FMN GV 16 Berchem TOT
54,Posthofbrug 5366,2023-01-10,00:00:00,9,3,6,FMN GV 16 Berchem TOT
54,Posthofbrug 5366,2023-01-10,01:00:00,3,0,3,FMN GV 16 Berchem TOT
54,Posthofbrug 5366,2023-01-10,02:00:00,2,1,1,FMN GV 16 Berchem TOT
54,Posthofbrug 5366,2023-01-10,03:00:00,0,0,0,FMN GV 16 Berchem TOT
54,Posthofbrug 5366,2023-01-10,04:00:00,6,4,2,FMN GV 16 Berchem TOT
54,Posthofbrug 5366,2023-01-10,05:00:00,29,23,6,FMN GV 16 Berchem TOT
54,Posthofbrug 5366,2023-01-10,06:00:00,125,99,26,FMN GV 16 Berchem TOT
54,Posthofbrug 5366,2023-01-10,07:00:00,509,384,125,FMN GV 16 Berchem TOT
54,Posthofbrug 5366,2023-01-10,08:00:00,920,705,215,FMN GV 16 Berchem TOT
54,Posthofbrug 5366,2023-01-10,09:00:00,264,193,71,FMN GV 16 Berchem TOT
54,Posthofbrug 5366,2023-01-10,10:00:00,136,88,48,FMN GV 16 Berchem TOT
54,Posthofbrug 5366,2023-01-10,11:00:00,113,67,46,FMN GV 16 Berchem TOT
54,Posthofbrug 5366,2023-01-10,12:00:00,170,84,86,FMN GV 16 Berchem TOT
54,Posthofbrug 5366,2023-01-10,13:00:00,143,67,76,FMN GV 16 Berchem TOT
54,Posthofbrug 5366,2023-01-10,14:00:00,105,29,76,FMN GV 16 Berchem TOT
54,Posthofbrug 5366,2023-01-10,15:00:00,230,56,174,FMN GV 16 Berchem TOT
54,Posthofbrug 5366,2023-01-10,16:00:00,486,138,348,FMN GV 16 Berchem TOT
54,Posthofbrug 5366,2023-01-10,17:00:00,646,206,440,FMN GV 16 Berchem TOT
54,Posthofbrug 5366,2023-01-10,18:00:00,373,120,253,FMN GV 16 Berchem TOT
54,Posthofbrug 5366,2023-01-10,19:00:00,177,68,109,FMN GV 16 Berchem TOT
54,Posthofbrug 5366,2023-01-10,20:00:00,92,35,57,FMN GV 16 Berchem TOT
54,Posthofbrug 5366,2023-01-10,21:00:00,80,28,52,FMN GV 16 Berchem TOT
54,Posthofbrug 5366,2023-01-10,22:00:00,86,29,57,FMN GV 16 Berchem TOT
54,Posthofbrug 5366,2023-01-10,23:00:00,39,17,22,FMN GV 16 Berchem TOT
54,Posthofbrug 5366,2023-01-11,00:00:00,18,5,13,FMN GV 16 Berchem TOT
54,Posthofbrug 5366,2023-01-11,01:00:00,5,1,4,FMN GV 16 Berchem TOT
54,Posthofbrug 5366,2023-01-11,02:00:00,3,1,2,FMN GV 16 Berchem TOT
54,Posthofbrug 5366,2023-01-11,03:00:00,1,0,1,FMN GV 16 Berchem TOT
54,Posthofbrug 5366,2023-01-11,04:00:00,5,2,3,FMN GV 16 Berchem TOT
54,Posthofbrug 5366,2023-01-11,05:00:00,21,16,5,FMN GV 16 Berchem TOT
54,Posthofbrug 5366,2023-01-11,06:00:00,115,90,25,FMN GV 16 Berchem TOT
54,Posthofbrug 5366,2023-01-11,07:00:00,427,320,107,FMN GV 16 Berchem TOT
54,Posthofbrug 5366,2023-01-11,08:00:00,772,577,195,FMN GV 16 Berchem TOT
54,Posthofbrug 5366,2023-01-11,09:00:00,248,177,71,FMN GV 16 Berchem TOT
54,Posthofbrug 5366,2023-01-11,10:00:00,135,84,51,FMN GV 16 Berchem TOT
54,Posthofbrug 5366,2023-01-11,11:00:00,163,79,84,FMN GV 16 Berchem TOT
54,Posthofbrug 5366,2023-01-11,12:00:00,292,129,163,FMN GV 16 Berchem TOT
54,Posthofbrug 5366,2023-01-11,13:00:00,213,84,129,FMN GV 16 Berchem TOT
54,Posthofbrug 5366,2023-01-11,14:00:00,176,72,104,FMN GV 16 Berchem TOT
54,Posthofbrug 5366,2023-01-11,15:00:00,212,77,135,FMN GV 16 Berchem TOT
54,Posthofbrug 5366,2023-01-11,16:00:00,370,130,240,FMN GV 16 Berchem TOT
54,Posthofbrug 5366,2023-01-11,17:00:00,536,175,361,FMN GV 16 Berchem TOT
54,Posthofbrug 5366,2023-01-11,18:00:00,359,126,233,FMN GV 16 Berchem TOT
54,Posthofbrug 5366,2023-01-11,19:00:00,144,54,90,FMN GV 16 Berchem TOT
54,Posthofbrug 5366,2023-01-11,20:00:00,76,36,40,FMN GV 16 Berchem TOT
54,Posthofbrug 5366,2023-01-11,21:00:00,70,35,35,FMN GV 16 Berchem TOT
54,Posthofbrug 5366,2023-01-11,22:00:00,57,21,36,FMN GV 16 Berchem TOT
54,Posthofbrug 5366,2023-01-11,23:00:00,50,15,35,FMN GV 16 Berchem TOT
54,Posthofbrug 5366,2023-01-12,00:00:00,13,3,10,FMN GV 16 Berchem TOT
54,Posthofbrug 5366,2023-01-12,01:00:00,11,4,7,FMN GV 16 Berchem TOT
54,Posthofbrug 5366,2023-01-12,02:00:00,2,1,1,FMN GV 16 Berchem TOT
54,Posthofbrug 5366,2023-01-12,03:00:00,0,0,0,FMN GV 16 Berchem TOT
54,Posthofbrug 5366,2023-01-12,04:00:00,2,2,0,FMN GV 16 Berchem TOT
54,Posthofbrug 5366,2023-01-12,05:00:00,20,15,5,FMN GV 16 Berchem TOT
54,Posthofbrug 5366,2023-01-12,06:00:00,81,65,16,FMN GV 16 Berchem TOT
54,Posthofbrug 5366,2023-01-12,07:00:00,303,228,75,FMN GV 16 Berchem TOT
54,Posthofbrug 5366,2023-01-12,08:00:00,624,480,144,FMN GV 16 Berchem TOT
54,Posthofbrug 5366,2023-01-12,09:00:00,192,143,49,FMN GV 16 Berchem TOT
54,Posthofbrug 5366,2023-01-12,10:00:00,82,58,24,FMN GV 16 Berchem TOT
54,Posthofbrug 5366,2023-01-12,11:00:00,73,46,27,FMN GV 16 Berchem TOT
54,Posthofbrug 5366,2023-01-12,12:00:00,95,50,45,FMN GV 16 Berchem TOT
54,Posthofbrug 5366,2023-01-12,13:00:00,76,30,46,FMN GV 16 Berchem TOT
54,Posthofbrug 5366,2023-01-12,14:00:00,67,25,42,FMN GV 16 Berchem TOT
54,Posthofbrug 5366,2023-01-12,15:00:00,155,47,108,FMN GV 16 Berchem TOT
54,Posthofbrug 5366,2023-01-12,16:00:00,290,85,205,FMN GV 16 Berchem TOT
54,Posthofbrug 5366,2023-01-12,17:00:00,420,119,301,FMN GV 16 Berchem TOT
54,Posthofbrug 5366,2023-01-12,18:00:00,261,79,182,FMN GV 16 Berchem TOT
54,Posthofbrug 5366,2023-01-12,19:00:00,125,44,81,FMN GV 16 Berchem TOT
54,Posthofbrug 5366,2023-01-12,20:00:00,65,27,38,FMN GV 16 Berchem TOT
54,Posthofbrug 5366,2023-01-12,21:00:00,87,33,54,FMN GV 16 Berchem TOT
54,Posthofbrug 5366,2023-01-12,22:00:00,53,19,34,FMN GV 16 Berchem TOT
54,Posthofbrug 5366,2023-01-12,23:00:00,32,10,22,FMN GV 16 Berchem TOT
54,Posthofbrug 5366,2023-01-13,00:00:00,14,5,9,FMN GV 16 Berchem TOT
54,Posthofbrug 5366,2023-01-13,01:00:00,13,1,12,FMN GV 16 Berchem TOT
54,Posthofbrug 5366,2023-01-13,02:00:00,8,1,7,FMN GV 16 Berchem TOT
54,Posthofbrug 5366,2023-01-13,03:00:00,3,2,1,FMN GV 16 Berchem TOT
54,Posthofbrug 5366,2023-01-13,04:00:00,6,2,4,FMN GV 16 Berchem TOT
54,Posthofbrug 5366,2023-01-13,05:00:00,22,17,5,FMN GV 16 Berchem TOT
54,Posthofbrug 5366,2023-01-13,06:00:00,97,76,21,FMN GV 16 Berchem TOT
54,Posthofbrug 5366,2023-01-13,07:00:00,342,253,89,FMN GV 16 Berchem TOT
54,Posthofbrug 5366,2023-01-13,08:00:00,733,570,163,FMN GV 16 Berchem TOT
54,Posthofbrug 5366,2023-01-13,09:00:00,252,198,54,FMN GV 16 Berchem TOT
54,Posthofbrug 5366,2023-01-13,10:00:00,127,75,52,FMN GV 16 Berchem TOT
54,Posthofbrug 5366,2023-01-13,11:00:00,131,89,42,FMN GV 16 Berchem TOT
54,Posthofbrug 5366,2023-01-13,12:00:00,164,79,85,FMN GV 16 Berchem TOT
54,Posthofbrug 5366,2023-01-13,13:00:00,162,83,79,FMN GV 16 Berchem TOT
54,Posthofbrug 5366,2023-01-13,14:00:00,160,61,99,FMN GV 16 Berchem TOT
54,Posthofbrug 5366,2023-01-13,15:00:00,265,84,181,FMN GV 16 Berchem TOT
54,Posthofbrug 5366,2023-01-13,16:00:00,372,104,268,FMN GV 16 Berchem TOT
54,Posthofbrug 5366,2023-01-13,17:00:00,435,127,308,FMN GV 16 Berchem TOT
54,Posthofbrug 5366,2023-01-13,18:00:00,315,146,169,FMN GV 16 Berchem TOT
54,Posthofbrug 5366,2023-01-13,19:00:00,192,81,111,FMN GV 16 Berchem TOT
54,Posthofbrug 5366,2023-01-13,20:00:00,138,74,64,FMN GV 16 Berchem TOT
54,Posthofbrug 5366,2023-01-13,21:00:00,77,47,30,FMN GV 16 Berchem TOT
54,Posthofbrug 5366,2023-01-13,22:00:00,113,42,71,FMN GV 16 Berchem TOT
54,Posthofbrug 5366,2023-01-13,23:00:00,81,18,63,FMN GV 16 Berchem TOT
54,Posthofbrug 5366,2023-01-14,00:00:00,66,17,49,FMN GV 16 Berchem TOT
54,Posthofbrug 5366,2023-01-14,01:00:00,58,16,42,FMN GV 16 Berchem TOT
54,Posthofbrug 5366,2023-01-14,02:00:00,32,6,26,FMN GV 16 Berchem TOT
54,Posthofbrug 5366,2023-01-14,03:00:00,20,5,15,FMN GV 16 Berchem TOT
54,Posthofbrug 5366,2023-01-14,04:00:00,19,5,14,FMN GV 16 Berchem TOT
54,Posthofbrug 5366,2023-01-14,05:00:00,17,9,8,FMN GV 16 Berchem TOT
54,Posthofbrug 5366,2023-01-14,06:00:00,12,9,3,FMN GV 16 Berchem TOT
54,Posthofbrug 5366,2023-01-14,07:00:00,30,22,8,FMN GV 16 Berchem TOT
54,Posthofbrug 5366,2023-01-14,08:00:00,52,27,25,FMN GV 16 Berchem TOT
54,Posthofbrug 5366,2023-01-14,09:00:00,61,37,24,FMN GV 16 Berchem TOT
54,Posthofbrug 5366,2023-01-14,10:00:00,47,32,15,FMN GV 16 Berchem TOT
54,Posthofbrug 5366,2023-01-14,11:00:00,58,35,23,FMN GV 16 Berchem TOT
54,Posthofbrug 5366,2023-01-14,12:00:00,57,34,23,FMN GV 16 Berchem TOT
54,Posthofbrug 5366,2023-01-14,13:00:00,53,37,16,FMN GV 16 Berchem TOT
54,Posthofbrug 5366,2023-01-14,14:00:00,69,44,25,FMN GV 16 Berchem TOT
54,Posthofbrug 5366,2023-01-14,15:00:00,63,29,34,FMN GV 16 Berchem TOT
54,Posthofbrug 5366,2023-01-14,16:00:00,75,39,36,FMN GV 16 Berchem TOT
54,Posthofbrug 5366,2023-01-14,17:00:00,74,39,35,FMN GV 16 Berchem TOT
54,Posthofbrug 5366,2023-01-14,18:00:00,70,39,31,FMN GV 16 Berchem TOT
54,Posthofbrug 5366,2023-01-14,19:00:00,76,42,34,FMN GV 16 Berchem TOT
54,Posthofbrug 5366,2023-01-14,20:00:00,60,35,25,FMN GV 16 Berchem TOT
54,Posthofbrug 5366,2023-01-14,21:00:00,54,38,16,FMN GV 16 Berchem TOT
54,Posthofbrug 5366,2023-01-14,22:00:00,45,23,22,FMN GV 16 Berchem TOT
54,Posthofbrug 5366,2023-01-14,23:00:00,70,24,46,FMN GV 16 Berchem TOT
54,Posthofbrug 5366,2023-01-15,00:00:00,52,26,26,FMN GV 16 Berchem TOT
54,Posthofbrug 5366,2023-01-15,01:00:00,26,4,22,FMN GV 16 Berchem TOT
54,Posthofbrug 5366,2023-01-15,02:00:00,18,1,17,FMN GV 16 Berchem TOT
54,Posthofbrug 5366,2023-01-15,03:00:00,15,6,9,FMN GV 16 Berchem TOT
54,Posthofbrug 5366,2023-01-15,04:00:00,12,4,8,FMN GV 16 Berchem TOT
54,Posthofbrug 5366,2023-01-15,05:00:00,10,5,5,FMN GV 16 Berchem TOT
54,Posthofbrug 5366,2023-01-15,06:00:00,18,11,7,FMN GV 16 Berchem TOT
54,Posthofbrug 5366,2023-01-15,07:00:00,18,12,6,FMN GV 16 Berchem TOT
54,Posthofbrug 5366,2023-01-15,08:00:00,53,29,24,FMN GV 16 Berchem TOT
54,Posthofbrug 5366,2023-01-15,09:00:00,98,48,50,FMN GV 16 Berchem TOT
54,Posthofbrug 5366,2023-01-15,10:00:00,111,63,48,FMN GV 16 Berchem TOT
54,Posthofbrug 5366,2023-01-15,11:00:00,112,73,39,FMN GV 16 Berchem TOT
54,Posthofbrug 5366,2023-01-15,12:00:00,155,97,58,FMN GV 16 Berchem TOT
54,Posthofbrug 5366,2023-01-15,13:00:00,107,55,52,FMN GV 16 Berchem TOT
54,Posthofbrug 5366,2023-01-15,14:00:00,113,57,56,FMN GV 16 Berchem TOT
54,Posthofbrug 5366,2023-01-15,15:00:00,90,55,35,FMN GV 16 Berchem TOT
54,Posthofbrug 5366,2023-01-15,16:00:00,106,49,57,FMN GV 16 Berchem TOT
54,Posthofbrug 5366,2023-01-15,17:00:00,104,56,48,FMN GV 16 Berchem TOT
54,Posthofbrug 5366,2023-01-15,18:00:00,65,25,40,FMN GV 16 Berchem TOT
54,Posthofbrug 5366,2023-01-15,19:00:00,54,24,30,FMN GV 16 Berchem TOT
54,Posthofbrug 5366,2023-01-15,20:00:00,49,19,30,FMN GV 16 Berchem TOT
54,Posthofbrug 5366,2023-01-15,21:00:00,32,16,16,FMN GV 16 Berchem TOT
54,Posthofbrug 5366,2023-01-15,22:00:00,45,16,29,FMN GV 16 Berchem TOT
54,Posthofbrug 5366,2023-01-15,23:00:00,20,2,18,FMN GV 16 Berchem TOT
54,Posthofbrug 5366,2023-01-16,00:00:00,5,1,4,FMN GV 16 Berchem TOT
54,Posthofbrug 5366,2023-01-16,01:00:00,3,0,3,FMN GV 16 Berchem TOT
54,Posthofbrug 5366,2023-01-16,02:00:00,1,0,1,FMN GV 16 Berchem TOT
54,Posthofbrug 5366,2023-01-16,03:00:00,0,0,0,FMN GV 16 Berchem TOT
54,Posthofbrug 5366,2023-01-16,04:00:00,10,5,5,FMN GV 16 Berchem TOT
54,Posthofbrug 5366,2023-01-16,05:00:00,22,14,8,FMN GV 16 Berchem TOT
54,Posthofbrug 5366,2023-01-16,06:00:00,82,63,19,FMN GV 16 Berchem TOT
54,Posthofbrug 5366,2023-01-16,07:00:00,346,265,81,FMN GV 16 Berchem TOT
54,Posthofbrug 5366,2023-01-16,08:00:00,626,491,135,FMN GV 16 Berchem TOT
54,Posthofbrug 5366,2023-01-16,09:00:00,240,176,64,FMN GV 16 Berchem TOT
54,Posthofbrug 5366,2023-01-16,10:00:00,78,52,26,FMN GV 16 Berchem TOT
54,Posthofbrug 5366,2023-01-16,11:00:00,65,33,32,FMN GV 16 Berchem TOT
54,Posthofbrug 5366,2023-01-16,12:00:00,115,62,53,FMN GV 16 Berchem TOT
54,Posthofbrug 5366,2023-01-16,13:00:00,99,51,48,FMN GV 16 Berchem TOT
54,Posthofbrug 5366,2023-01-16,14:00:00,97,38,59,FMN GV 16 Berchem TOT
54,Posthofbrug 5366,2023-01-16,15:00:00,194,72,122,FMN GV 16 Berchem TOT
54,Posthofbrug 5366,2023-01-16,16:00:00,344,104,240,FMN GV 16 Berchem TOT
54,Posthofbrug 5366,2023-01-16,17:00:00,444,116,328,FMN GV 16 Berchem TOT
54,Posthofbrug 5366,2023-01-16,18:00:00,242,71,171,FMN GV 16 Berchem TOT
54,Posthofbrug 5366,2023-01-16,19:00:00,112,37,75,FMN GV 16 Berchem TOT
54,Posthofbrug 5366,2023-01-16,20:00:00,65,28,37,FMN GV 16 Berchem TOT
54,Posthofbrug 5366,2023-01-16,21:00:00,63,22,41,FMN GV 16 Berchem TOT
54,Posthofbrug 5366,2023-01-16,22:00:00,47,14,33,FMN GV 16 Berchem TOT
54,Posthofbrug 5366,2023-01-16,23:00:00,24,8,16,FMN GV 16 Berchem TOT
54,Posthofbrug 5366,2023-01-17,00:00:00,10,4,6,FMN GV 16 Berchem TOT
54,Posthofbrug 5366,2023-01-17,01:00:00,2,2,0,FMN GV 16 Berchem TOT
54,Posthofbrug 5366,2023-01-17,02:00:00,4,1,3,FMN GV 16 Berchem TOT
54,Posthofbrug 5366,2023-01-17,03:00:00,5,1,4,FMN GV 16 Berchem TOT
54,Posthofbrug 5366,2023-01-17,04:00:00,8,3,5,FMN GV 16 Berchem TOT
54,Posthofbrug 5366,2023-01-17,05:00:00,28,22,6,FMN GV 16 Berchem TOT
54,Posthofbrug 5366,2023-01-17,06:00:00,118,95,23,FMN GV 16 Berchem TOT
54,Posthofbrug 5366,2023-01-17,07:00:00,455,328,127,FMN GV 16 Berchem TOT
54,Posthofbrug 5366,2023-01-17,08:00:00,863,649,214,FMN GV 16 Berchem TOT
54,Posthofbrug 5366,2023-01-17,09:00:00,285,222,63,FMN GV 16 Berchem TOT
54,Posthofbrug 5366,2023-01-17,10:00:00,126,80,46,FMN GV 16 Berchem TOT
54,Posthofbrug 5366,2023-01-17,11:00:00,100,64,36,FMN GV 16 Berchem TOT
54,Posthofbrug 5366,2023-01-17,12:00:00,155,88,67,FMN GV 16 Berchem TOT
54,Posthofbrug 5366,2023-01-17,13:00:00,136,73,63,FMN GV 16 Berchem TOT
54,Posthofbrug 5366,2023-01-17,14:00:00,135,53,82,FMN GV 16 Berchem TOT
54,Posthofbrug 5366,2023-01-17,15:00:00,281,95,186,FMN GV 16 Berchem TOT
54,Posthofbrug 5366,2023-01-17,16:00:00,464,148,316,FMN GV 16 Berchem TOT
54,Posthofbrug 5366,2023-01-17,17:00:00,624,202,422,FMN GV 16 Berchem TOT
54,Posthofbrug 5366,2023-01-17,18:00:00,412,122,290,FMN GV 16 Berchem TOT
54,Posthofbrug 5366,2023-01-17,19:00:00,159,53,106,FMN GV 16 Berchem TOT
54,Posthofbrug 5366,2023-01-17,20:00:00,101,29,72,FMN GV 16 Berchem TOT
54,Posthofbrug 5366,2023-01-17,21:00:00,91,37,54,FMN GV 16 Berchem TOT
54,Posthofbrug 5366,2023-01-17,22:00:00,74,22,52,FMN GV 16 Berchem TOT
54,Posthofbrug 5366,2023-01-17,23:00:00,36,10,26,FMN GV 16 Berchem TOT
54,Posthofbrug 5366,2023-01-18,00:00:00,22,8,14,FMN GV 16 Berchem TOT
54,Posthofbrug 5366,2023-01-18,01:00:00,9,0,9,FMN GV 16 Berchem TOT
54,Posthofbrug 5366,2023-01-18,02:00:00,1,0,1,FMN GV 16 Berchem TOT
54,Posthofbrug 5366,2023-01-18,03:00:00,3,1,2,FMN GV 16 Berchem TOT
54,Posthofbrug 5366,2023-01-18,04:00:00,7,4,3,FMN GV 16 Berchem TOT
54,Posthofbrug 5366,2023-01-18,05:00:00,30,19,11,FMN GV 16 Berchem TOT
54,Posthofbrug 5366,2023-01-18,06:00:00,100,81,19,FMN GV 16 Berchem TOT
54,Posthofbrug 5366,2023-01-18,07:00:00,368,260,108,FMN GV 16 Berchem TOT
54,Posthofbrug 5366,2023-01-18,08:00:00,698,530,168,FMN GV 16 Berchem TOT
54,Posthofbrug 5366,2023-01-18,09:00:00,231,167,64,FMN GV 16 Berchem TOT
54,Posthofbrug 5366,2023-01-18,10:00:00,103,76,27,FMN GV 16 Berchem TOT
54,Posthofbrug 5366,2023-01-18,11:00:00,132,69,63,FMN GV 16 Berchem TOT
54,Posthofbrug 5366,2023-01-18,12:00:00,244,106,138,FMN GV 16 Berchem TOT
54,Posthofbrug 5366,2023-01-18,13:00:00,206,77,129,FMN GV 16 Berchem TOT
54,Posthofbrug 5366,2023-01-18,14:00:00,178,77,101,FMN GV 16 Berchem TOT
54,Posthofbrug 5366,2023-01-18,15:00:00,185,69,116,FMN GV 16 Berchem TOT
54,Posthofbrug 5366,2023-01-18,16:00:00,329,126,203,FMN GV 16 Berchem TOT
54,Posthofbrug 5366,2023-01-18,17:00:00,513,168,345,FMN GV 16 Berchem TOT
54,Posthofbrug 5366,2023-01-18,18:00:00,324,105,219,FMN GV 16 Berchem TOT
54,Posthofbrug 5366,2023-01-18,19:00:00,196,89,107,FMN GV 16 Berchem TOT
54,Posthofbrug 5366,2023-01-18,20:00:00,103,52,51,FMN GV 16 Berchem TOT
54,Posthofbrug 5366,2023-01-18,21:00:00,80,29,51,FMN GV 16 Berchem TOT
54,Posthofbrug 5366,2023-01-18,22:00:00,90,35,55,FMN GV 16 Berchem TOT
54,Posthofbrug 5366,2023-01-18,23:00:00,50,15,35,FMN GV 16 Berchem TOT
54,Posthofbrug 5366,2023-01-19,00:00:00,17,5,12,FMN GV 16 Berchem TOT
54,Posthofbrug 5366,2023-01-19,01:00:00,11,0,11,FMN GV 16 Berchem TOT
54,Posthofbrug 5366,2023-01-19,02:00:00,1,0,1,FMN GV 16 Berchem TOT
54,Posthofbrug 5366,2023-01-19,03:00:00,1,0,1,FMN GV 16 Berchem TOT
54,Posthofbrug 5366,2023-01-19,04:00:00,10,8,2,FMN GV 16 Berchem TOT
54,Posthofbrug 5366,2023-01-19,05:00:00,28,20,8,FMN GV 16 Berchem TOT
54,Posthofbrug 5366,2023-01-19,06:00:00,100,73,27,FMN GV 16 Berchem TOT
54,Posthofbrug 5366,2023-01-19,07:00:00,354,267,87,FMN GV 16 Berchem TOT
54,Posthofbrug 5366,2023-01-19,08:00:00,763,589,174,FMN GV 16 Berchem TOT
54,Posthofbrug 5366,2023-01-19,09:00:00,249,196,53,FMN GV 16 Berchem TOT
54,Posthofbrug 5366,2023-01-19,10:00:00,109,75,34,FMN GV 16 Berchem TOT
54,Posthofbrug 5366,2023-01-19,11:00:00,88,61,27,FMN GV 16 Berchem TOT
54,Posthofbrug 5366,2023-01-19,12:00:00,137,79,58,FMN GV 16 Berchem TOT
54,Posthofbrug 5366,2023-01-19,13:00:00,131,64,67,FMN GV 16 Berchem TOT
54,Posthofbrug 5366,2023-01-19,14:00:00,131,64,67,FMN GV 16 Berchem TOT
54,Posthofbrug 5366,2023-01-19,15:00:00,222,78,144,FMN GV 16 Berchem TOT
54,Posthofbrug 5366,2023-01-19,16:00:00,421,115,306,FMN GV 16 Berchem TOT
54,Posthofbrug 5366,2023-01-19,17:00:00,509,150,359,FMN GV 16 Berchem TOT
54,Posthofbrug 5366,2023-01-19,18:00:00,353,118,235,FMN GV 16 Berchem TOT
54,Posthofbrug 5366,2023-01-19,19:00:00,168,49,119,FMN GV 16 Berchem TOT
54,Posthofbrug 5366,2023-01-19,20:00:00,95,35,60,FMN GV 16 Berchem TOT
54,Posthofbrug 5366,2023-01-19,21:00:00,96,42,54,FMN GV 16 Berchem TOT
54,Posthofbrug 5366,2023-01-19,22:00:00,74,29,45,FMN GV 16 Berchem TOT
54,Posthofbrug 5366,2023-01-19,23:00:00,43,15,28,FMN GV 16 Berchem TOT
54,Posthofbrug 5366,2023-01-20,00:00:00,16,4,12,FMN GV 16 Berchem TOT
54,Posthofbrug 5366,2023-01-20,01:00:00,15,0,15,FMN GV 16 Berchem TOT
54,Posthofbrug 5366,2023-01-20,02:00:00,12,8,4,FMN GV 16 Berchem TOT
54,Posthofbrug 5366,2023-01-20,03:00:00,5,3,2,FMN GV 16 Berchem TOT
54,Posthofbrug 5366,2023-01-20,04:00:00,7,4,3,FMN GV 16 Berchem TOT
54,Posthofbrug 5366,2023-01-20,05:00:00,23,12,11,FMN GV 16 Berchem TOT
54,Posthofbrug 5366,2023-01-20,06:00:00,79,59,20,FMN GV 16 Berchem TOT
54,Posthofbrug 5366,2023-01-20,07:00:00,294,219,75,FMN GV 16 Berchem TOT
54,Posthofbrug 5366,2023-01-20,08:00:00,474,371,103,FMN GV 16 Berchem TOT
54,Posthofbrug 5366,2023-01-20,09:00:00,173,142,31,FMN GV 16 Berchem TOT
54,Posthofbrug 5366,2023-01-20,10:00:00,86,55,31,FMN GV 16 Berchem TOT
54,Posthofbrug 5366,2023-01-20,11:00:00,67,42,25,FMN GV 16 Berchem TOT
54,Posthofbrug 5366,2023-01-20,12:00:00,93,32,61,FMN GV 16 Berchem TOT
54,Posthofbrug 5366,2023-01-20,13:00:00,103,48,55,FMN GV 16 Berchem TOT
54,Posthofbrug 5366,2023-01-20,14:00:00,107,49,58,FMN GV 16 Berchem TOT
54,Posthofbrug 5366,2023-01-20,15:00:00,173,62,111,FMN GV 16 Berchem TOT
54,Posthofbrug 5366,2023-01-20,16:00:00,289,103,186,FMN GV 16 Berchem TOT
54,Posthofbrug 5366,2023-01-20,17:00:00,303,109,194,FMN GV 16 Berchem TOT
54,Posthofbrug 5366,2023-01-20,18:00:00,182,70,112,FMN GV 16 Berchem TOT
54,Posthofbrug 5366,2023-01-20,19:00:00,130,72,58,FMN GV 16 Berchem TOT
54,Posthofbrug 5366,2023-01-20,20:00:00,77,38,39,FMN GV 16 Berchem TOT
54,Posthofbrug 5366,2023-01-20,21:00:00,50,18,32,FMN GV 16 Berchem TOT
54,Posthofbrug 5366,2023-01-20,22:00:00,79,24,55,FMN GV 16 Berchem TOT
54,Posthofbrug 5366,2023-01-20,23:00:00,60,18,42,FMN GV 16 Berchem TOT
54,Posthofbrug 5366,2023-01-21,00:00:00,40,4,36,FMN GV 16 Berchem TOT
54,Posthofbrug 5366,2023-01-21,01:00:00,29,8,21,FMN GV 16 Berchem TOT
54,Posthofbrug 5366,2023-01-21,02:00:00,35,20,15,FMN GV 16 Berchem TOT
54,Posthofbrug 5366,2023-01-21,03:00:00,9,3,6,FMN GV 16 Berchem TOT
54,Posthofbrug 5366,2023-01-21,04:00:00,12,2,10,FMN GV 16 Berchem TOT
54,Posthofbrug 5366,2023-01-21,05:00:00,11,4,7,FMN GV 16 Berchem TOT
54,Posthofbrug 5366,2023-01-21,06:00:00,9,5,4,FMN GV 16 Berchem TOT
54,Posthofbrug 5366,2023-01-21,07:00:00,20,15,5,FMN GV 16 Berchem TOT
54,Posthofbrug 5366,2023-01-21,08:00:00,52,32,20,FMN GV 16 Berchem TOT
54,Posthofbrug 5366,2023-01-21,09:00:00,89,54,35,FMN GV 16 Berchem TOT
54,Posthofbrug 5366,2023-01-21,10:00:00,73,49,24,FMN GV 16 Berchem TOT
54,Posthofbrug 5366,2023-01-21,11:00:00,105,73,32,FMN GV 16 Berchem TOT
54,Posthofbrug 5366,2023-01-21,12:00:00,122,74,48,FMN GV 16 Berchem TOT
54,Posthofbrug 5366,2023-01-21,13:00:00,176,112,64,FMN GV 16 Berchem TOT
54,Posthofbrug 5366,2023-01-21,14:00:00,156,91,65,FMN GV 16 Berchem TOT
54,Posthofbrug 5366,2023-01-21,15:00:00,135,63,72,FMN GV 16 Berchem TOT
54,Posthofbrug 5366,2023-01-21,16:00:00,152,48,104,FMN GV 16 Berchem TOT
54,Posthofbrug 5366,2023-01-21,17:00:00,163,75,88,FMN GV 16 Berchem TOT
54,Posthofbrug 5366,2023-01-21,18:00:00,127,73,54,FMN GV 16 Berchem TOT
54,Posthofbrug 5366,2023-01-21,19:00:00,88,42,46,FMN GV 16 Berchem TOT
54,Posthofbrug 5366,2023-01-21,20:00:00,83,44,39,FMN GV 16 Berchem TOT
54,Posthofbrug 5366,2023-01-21,21:00:00,56,28,28,FMN GV 16 Berchem TOT
54,Posthofbrug 5366,2023-01-21,22:00:00,57,21,36,FMN GV 16 Berchem TOT
54,Posthofbrug 5366,2023-01-21,23:00:00,58,21,37,FMN GV 16 Berchem TOT
54,Posthofbrug 5366,2023-01-22,00:00:00,48,15,33,FMN GV 16 Berchem TOT
54,Posthofbrug 5366,2023-01-22,01:00:00,34,12,22,FMN GV 16 Berchem TOT
54,Posthofbrug 5366,2023-01-22,02:00:00,25,6,19,FMN GV 16 Berchem TOT
54,Posthofbrug 5366,2023-01-22,03:00:00,18,9,9,FMN GV 16 Berchem TOT
54,Posthofbrug 5366,2023-01-22,04:00:00,13,3,10,FMN GV 16 Berchem TOT
54,Posthofbrug 5366,2023-01-22,05:00:00,18,8,10,FMN GV 16 Berchem TOT
54,Posthofbrug 5366,2023-01-22,06:00:00,16,9,7,FMN GV 16 Berchem TOT
54,Posthofbrug 5366,2023-01-22,07:00:00,23,16,7,FMN GV 16 Berchem TOT
54,Posthofbrug 5366,2023-01-22,08:00:00,30,19,11,FMN GV 16 Berchem TOT
54,Posthofbrug 5366,2023-01-22,09:00:00,60,29,31,FMN GV 16 Berchem TOT
54,Posthofbrug 5366,2023-01-22,10:00:00,88,51,37,FMN GV 16 Berchem TOT
54,Posthofbrug 5366,2023-01-22,11:00:00,87,57,30,FMN GV 16 Berchem TOT
54,Posthofbrug 5366,2023-01-22,12:00:00,93,57,36,FMN GV 16 Berchem TOT
54,Posthofbrug 5366,2023-01-22,13:00:00,102,58,44,FMN GV 16 Berchem TOT
54,Posthofbrug 5366,2023-01-22,14:00:00,111,69,42,FMN GV 16 Berchem TOT
54,Posthofbrug 5366,2023-01-22,15:00:00,85,43,42,FMN GV 16 Berchem TOT
54,Posthofbrug 5366,2023-01-22,16:00:00,81,34,47,FMN GV 16 Berchem TOT
54,Posthofbrug 5366,2023-01-22,17:00:00,101,49,52,FMN GV 16 Berchem TOT
54,Posthofbrug 5366,2023-01-22,18:00:00,83,30,53,FMN GV 16 Berchem TOT
54,Posthofbrug 5366,2023-01-22,19:00:00,61,33,28,FMN GV 16 Berchem TOT
54,Posthofbrug 5366,2023-01-22,20:00:00,53,24,29,FMN GV 16 Berchem TOT
54,Posthofbrug 5366,2023-01-22,21:00:00,36,14,22,FMN GV 16 Berchem TOT
54,Posthofbrug 5366,2023-01-22,22:00:00,28,11,17,FMN GV 16 Berchem TOT
54,Posthofbrug 5366,2023-01-22,23:00:00,19,6,13,FMN GV 16 Berchem TOT
54,Posthofbrug 5366,2023-01-23,00:00:00,8,2,6,FMN GV 16 Berchem TOT
54,Posthofbrug 5366,2023-01-23,01:00:00,2,1,1,FMN GV 16 Berchem TOT
54,Posthofbrug 5366,2023-01-23,02:00:00,1,0,1,FMN GV 16 Berchem TOT
54,Posthofbrug 5366,2023-01-23,03:00:00,2,0,2,FMN GV 16 Berchem TOT
54,Posthofbrug 5366,2023-01-23,04:00:00,9,5,4,FMN GV 16 Berchem TOT
54,Posthofbrug 5366,2023-01-23,05:00:00,21,17,4,FMN GV 16 Berchem TOT
54,Posthofbrug 5366,2023-01-23,06:00:00,114,94,20,FMN GV 16 Berchem TOT
54,Posthofbrug 5366,2023-01-23,07:00:00,427,312,115,FMN GV 16 Berchem TOT
54,Posthofbrug 5366,2023-01-23,08:00:00,839,665,174,FMN GV 16 Berchem TOT
54,Posthofbrug 5366,2023-01-23,09:00:00,259,219,40,FMN GV 16 Berchem TOT
54,Posthofbrug 5366,2023-01-23,10:00:00,113,69,44,FMN GV 16 Berchem TOT
54,Posthofbrug 5366,2023-01-23,11:00:00,103,67,36,FMN GV 16 Berchem TOT
54,Posthofbrug 5366,2023-01-23,12:00:00,158,64,94,FMN GV 16 Berchem TOT
54,Posthofbrug 5366,2023-01-23,13:00:00,135,73,62,FMN GV 16 Berchem TOT
54,Posthofbrug 5366,2023-01-23,14:00:00,140,53,87,FMN GV 16 Berchem TOT
54,Posthofbrug 5366,2023-01-23,15:00:00,221,72,149,FMN GV 16 Berchem TOT
54,Posthofbrug 5366,2023-01-23,16:00:00,412,123,289,FMN GV 16 Berchem TOT
54,Posthofbrug 5366,2023-01-23,17:00:00,583,154,429,FMN GV 16 Berchem TOT
54,Posthofbrug 5366,2023-01-23,18:00:00,327,90,237,FMN GV 16 Berchem TOT
54,Posthofbrug 5366,2023-01-23,19:00:00,178,81,97,FMN GV 16 Berchem TOT
54,Posthofbrug 5366,2023-01-23,20:00:00,99,33,66,FMN GV 16 Berchem TOT
54,Posthofbrug 5366,2023-01-23,21:00:00,95,32,63,FMN GV 16 Berchem TOT
54,Posthofbrug 5366,2023-01-23,22:00:00,75,21,54,FMN GV 16 Berchem TOT
54,Posthofbrug 5366,2023-01-23,23:00:00,43,14,29,FMN GV 16 Berchem TOT
54,Posthofbrug 5366,2023-01-24,00:00:00,19,2,17,FMN GV 16 Berchem TOT
54,Posthofbrug 5366,2023-01-24,01:00:00,7,1,6,FMN GV 16 Berchem TOT
54,Posthofbrug 5366,2023-01-24,02:00:00,2,0,2,FMN GV 16 Berchem TOT
54,Posthofbrug 5366,2023-01-24,03:00:00,3,1,2,FMN GV 16 Berchem TOT
54,Posthofbrug 5366,2023-01-24,04:00:00,8,4,4,FMN GV 16 Berchem TOT
54,Posthofbrug 5366,2023-01-24,05:00:00,29,24,5,FMN GV 16 Berchem TOT
54,Posthofbrug 5366,2023-01-24,06:00:00,96,77,19,FMN GV 16 Berchem TOT
54,Posthofbrug 5366,2023-01-24,07:00:00,454,329,125,FMN GV 16 Berchem TOT
54,Posthofbrug 5366,2023-01-24,08:00:00,900,706,194,FMN GV 16 Berchem TOT
54,Posthofbrug 5366,2023-01-24,09:00:00,280,218,62,FMN GV 16 Berchem TOT
54,Posthofbrug 5366,2023-01-24,10:00:00,120,85,35,FMN GV 16 Berchem TOT
54,Posthofbrug 5366,2023-01-24,11:00:00,109,59,50,FMN GV 16 Berchem TOT
54,Posthofbrug 5366,2023-01-24,12:00:00,162,90,72,FMN GV 16 Berchem TOT
54,Posthofbrug 5366,2023-01-24,13:00:00,159,79,80,FMN GV 16 Berchem TOT
54,Posthofbrug 5366,2023-01-24,14:00:00,130,61,69,FMN GV 16 Berchem TOT
54,Posthofbrug 5366,2023-01-24,15:00:00,218,75,143,FMN GV 16 Berchem TOT
54,Posthofbrug 5366,2023-01-24,16:00:00,454,144,310,FMN GV 16 Berchem TOT
54,Posthofbrug 5366,2023-01-24,17:00:00,657,165,492,FMN GV 16 Berchem TOT
54,Posthofbrug 5366,2023-01-24,18:00:00,379,122,257,FMN GV 16 Berchem TOT
54,Posthofbrug 5366,2023-01-24,19:00:00,194,79,115,FMN GV 16 Berchem TOT
54,Posthofbrug 5366,2023-01-24,20:00:00,108,40,68,FMN GV 16 Berchem TOT
54,Posthofbrug 5366,2023-01-24,21:00:00,109,46,63,FMN GV 16 Berchem TOT
54,Posthofbrug 5366,2023-01-24,22:00:00,88,28,60,FMN GV 16 Berchem TOT
54,Posthofbrug 5366,2023-01-24,23:00:00,44,13,31,FMN GV 16 Berchem TOT
54,Posthofbrug 5366,2023-01-25,00:00:00,24,7,17,FMN GV 16 Berchem TOT
54,Posthofbrug 5366,2023-01-25,01:00:00,9,4,5,FMN GV 16 Berchem TOT
54,Posthofbrug 5366,2023-01-25,02:00:00,3,0,3,FMN GV 16 Berchem TOT
54,Posthofbrug 5366,2023-01-25,03:00:00,2,0,2,FMN GV 16 Berchem TOT
54,Posthofbrug 5366,2023-01-25,04:00:00,6,3,3,FMN GV 16 Berchem TOT
54,Posthofbrug 5366,2023-01-25,05:00:00,24,18,6,FMN GV 16 Berchem TOT
54,Posthofbrug 5366,2023-01-25,06:00:00,98,79,19,FMN GV 16 Berchem TOT
54,Posthofbrug 5366,2023-01-25,07:00:00,380,280,100,FMN GV 16 Berchem TOT
54,Posthofbrug 5366,2023-01-25,08:00:00,710,530,180,FMN GV 16 Berchem TOT
54,Posthofbrug 5366,2023-01-25,09:00:00,235,168,67,FMN GV 16 Berchem TOT
54,Posthofbrug 5366,2023-01-25,10:00:00,103,58,45,FMN GV 16 Berchem TOT
54,Posthofbrug 5366,2023-01-25,11:00:00,120,69,51,FMN GV 16 Berchem TOT
54,Posthofbrug 5366,2023-01-25,12:00:00,254,115,139,FMN GV 16 Berchem TOT
54,Posthofbrug 5366,2023-01-25,13:00:00,208,94,114,FMN GV 16 Berchem TOT
54,Posthofbrug 5366,2023-01-25,14:00:00,153,69,84,FMN GV 16 Berchem TOT
54,Posthofbrug 5366,2023-01-25,15:00:00,181,65,116,FMN GV 16 Berchem TOT
54,Posthofbrug 5366,2023-01-25,16:00:00,310,109,201,FMN GV 16 Berchem TOT
54,Posthofbrug 5366,2023-01-25,17:00:00,513,157,356,FMN GV 16 Berchem TOT
54,Posthofbrug 5366,2023-01-25,18:00:00,300,107,193,FMN GV 16 Berchem TOT
54,Posthofbrug 5366,2023-01-25,19:00:00,168,67,101,FMN GV 16 Berchem TOT
54,Posthofbrug 5366,2023-01-25,20:00:00,97,45,52,FMN GV 16 Berchem TOT
54,Posthofbrug 5366,2023-01-25,21:00:00,93,35,58,FMN GV 16 Berchem TOT
54,Posthofbrug 5366,2023-01-25,22:00:00,90,32,58,FMN GV 16 Berchem TOT
54,Posthofbrug 5366,2023-01-25,23:00:00,42,10,32,FMN GV 16 Berchem TOT
54,Posthofbrug 5366,2023-01-26,00:00:00,27,8,19,FMN GV 16 Berchem TOT
54,Posthofbrug 5366,2023-01-26,01:00:00,7,4,3,FMN GV 16 Berchem TOT
54,Posthofbrug 5366,2023-01-26,02:00:00,2,0,2,FMN GV 16 Berchem TOT
54,Posthofbrug 5366,2023-01-26,03:00:00,2,1,1,FMN GV 16 Berchem TOT
54,Posthofbrug 5366,2023-01-26,04:00:00,8,4,4,FMN GV 16 Berchem TOT
54,Posthofbrug 5366,2023-01-26,05:00:00,26,20,6,FMN GV 16 Berchem TOT
54,Posthofbrug 5366,2023-01-26,06:00:00,117,98,19,FMN GV 16 Berchem TOT
54,Posthofbrug 5366,2023-01-26,07:00:00,394,291,103,FMN GV 16 Berchem TOT
54,Posthofbrug 5366,2023-01-26,08:00:00,768,600,168,FMN GV 16 Berchem TOT
54,Posthofbrug 5366,2023-01-26,09:00:00,239,187,52,FMN GV 16 Berchem TOT
54,Posthofbrug 5366,2023-01-26,10:00:00,118,82,36,FMN GV 16 Berchem TOT
54,Posthofbrug 5366,2023-01-26,11:00:00,103,66,37,FMN GV 16 Berchem TOT
54,Posthofbrug 5366,2023-01-26,12:00:00,140,77,63,FMN GV 16 Berchem TOT
54,Posthofbrug 5366,2023-01-26,13:00:00,149,65,84,FMN GV 16 Berchem TOT
54,Posthofbrug 5366,2023-01-26,14:00:00,124,52,72,FMN GV 16 Berchem TOT
54,Posthofbrug 5366,2023-01-26,15:00:00,226,66,160,FMN GV 16 Berchem TOT
54,Posthofbrug 5366,2023-01-26,16:00:00,440,145,295,FMN GV 16 Berchem TOT
54,Posthofbrug 5366,2023-01-26,17:00:00,560,175,385,FMN GV 16 Berchem TOT
54,Posthofbrug 5366,2023-01-26,18:00:00,332,97,235,FMN GV 16 Berchem TOT
54,Posthofbrug 5366,2023-01-26,19:00:00,216,96,120,FMN GV 16 Berchem TOT
54,Posthofbrug 5366,2023-01-26,20:00:00,110,53,57,FMN GV 16 Berchem TOT
54,Posthofbrug 5366,2023-01-26,21:00:00,104,46,58,FMN GV 16 Berchem TOT
54,Posthofbrug 5366,2023-01-26,22:00:00,102,29,73,FMN GV 16 Berchem TOT
54,Posthofbrug 5366,2023-01-26,23:00:00,67,27,40,FMN GV 16 Berchem TOT
54,Posthofbrug 5366,2023-01-27,00:00:00,33,4,29,FMN GV 16 Berchem TOT
54,Posthofbrug 5366,2023-01-27,01:00:00,8,1,7,FMN GV 16 Berchem TOT
54,Posthofbrug 5366,2023-01-27,02:00:00,19,0,19,FMN GV 16 Berchem TOT
54,Posthofbrug 5366,2023-01-27,03:00:00,18,2,16,FMN GV 16 Berchem TOT
54,Posthofbrug 5366,2023-01-27,04:00:00,13,3,10,FMN GV 16 Berchem TOT
54,Posthofbrug 5366,2023-01-27,05:00:00,28,16,12,FMN GV 16 Berchem TOT
54,Posthofbrug 5366,2023-01-27,06:00:00,101,79,22,FMN GV 16 Berchem TOT
54,Posthofbrug 5366,2023-01-27,07:00:00,367,260,107,FMN GV 16 Berchem TOT
54,Posthofbrug 5366,2023-01-27,08:00:00,653,500,153,FMN GV 16 Berchem TOT
54,Posthofbrug 5366,2023-01-27,09:00:00,213,166,47,FMN GV 16 Berchem TOT
54,Posthofbrug 5366,2023-01-27,10:00:00,124,87,37,FMN GV 16 Berchem TOT
54,Posthofbrug 5366,2023-01-27,11:00:00,126,80,46,FMN GV 16 Berchem TOT
54,Posthofbrug 5366,2023-01-27,12:00:00,159,89,70,FMN GV 16 Berchem TOT
54,Posthofbrug 5366,2023-01-27,13:00:00,178,89,89,FMN GV 16 Berchem TOT
54,Posthofbrug 5366,2023-01-27,14:00:00,159,57,102,FMN GV 16 Berchem TOT
54,Posthofbrug 5366,2023-01-27,15:00:00,249,86,163,FMN GV 16 Berchem TOT
54,Posthofbrug 5366,2023-01-27,16:00:00,360,119,241,FMN GV 16 Berchem TOT
54,Posthofbrug 5366,2023-01-27,17:00:00,471,149,322,FMN GV 16 Berchem TOT
54,Posthofbrug 5366,2023-01-27,18:00:00,281,127,154,FMN GV 16 Berchem TOT
54,Posthofbrug 5366,2023-01-27,19:00:00,154,88,66,FMN GV 16 Berchem TOT
54,Posthofbrug 5366,2023-01-27,20:00:00,113,57,56,FMN GV 16 Berchem TOT
54,Posthofbrug 5366,2023-01-27,21:00:00,74,32,42,FMN GV 16 Berchem TOT
54,Posthofbrug 5366,2023-01-27,22:00:00,109,45,64,FMN GV 16 Berchem TOT
54,Posthofbrug 5366,2023-01-27,23:00:00,97,28,69,FMN GV 16 Berchem TOT
54,Posthofbrug 5366,2023-01-28,00:00:00,65,16,49,FMN GV 16 Berchem TOT
54,Posthofbrug 5366,2023-01-28,01:00:00,52,15,37,FMN GV 16 Berchem TOT
54,Posthofbrug 5366,2023-01-28,02:00:00,51,2,49,FMN GV 16 Berchem TOT
54,Posthofbrug 5366,2023-01-28,03:00:00,50,4,46,FMN GV 16 Berchem TOT
54,Posthofbrug 5366,2023-01-28,04:00:00,29,6,23,FMN GV 16 Berchem TOT
54,Posthofbrug 5366,2023-01-28,05:00:00,16,6,10,FMN GV 16 Berchem TOT
54,Posthofbrug 5366,2023-01-28,06:00:00,21,10,11,FMN GV 16 Berchem TOT
54,Posthofbrug 5366,2023-01-28,07:00:00,37,23,14,FMN GV 16 Berchem TOT
54,Posthofbrug 5366,2023-01-28,08:00:00,72,42,30,FMN GV 16 Berchem TOT
54,Posthofbrug 5366,2023-01-28,09:00:00,107,80,27,FMN GV 16 Berchem TOT
54,Posthofbrug 5366,2023-01-28,10:00:00,137,99,38,FMN GV 16 Berchem TOT
54,Posthofbrug 5366,2023-01-28,11:00:00,134,79,55,FMN GV 16 Berchem TOT
54,Posthofbrug 5366,2023-01-28,12:00:00,181,95,86,FMN GV 16 Berchem TOT
54,Posthofbrug 5366,2023-01-28,13:00:00,185,114,71,FMN GV 16 Berchem TOT
54,Posthofbrug 5366,2023-01-28,14:00:00,179,112,67,FMN GV 16 Berchem TOT
54,Posthofbrug 5366,2023-01-28,15:00:00,177,94,83,FMN GV 16 Berchem TOT
54,Posthofbrug 5366,2023-01-28,16:00:00,171,67,104,FMN GV 16 Berchem TOT
54,Posthofbrug 5366,2023-01-28,17:00:00,182,73,109,FMN GV 16 Berchem TOT
54,Posthofbrug 5366,2023-01-28,18:00:00,156,89,67,FMN GV 16 Berchem TOT
54,Posthofbrug 5366,2023-01-28,19:00:00,144,82,62,FMN GV 16 Berchem TOT
54,Posthofbrug 5366,2023-01-28,20:00:00,78,49,29,FMN GV 16 Berchem TOT
54,Posthofbrug 5366,2023-01-28,21:00:00,70,45,25,FMN GV 16 Berchem TOT
54,Posthofbrug 5366,2023-01-28,22:00:00,92,32,60,FMN GV 16 Berchem TOT
54,Posthofbrug 5366,2023-01-28,23:00:00,108,42,66,FMN GV 16 Berchem TOT
54,Posthofbrug 5366,2023-01-29,00:00:00,63,31,32,FMN GV 16 Berchem TOT
54,Posthofbrug 5366,2023-01-29,01:00:00,58,34,24,FMN GV 16 Berchem TOT
54,Posthofbrug 5366,2023-01-29,02:00:00,32,11,21,FMN GV 16 Berchem TOT
54,Posthofbrug 5366,2023-01-29,03:00:00,21,6,15,FMN GV 16 Berchem TOT
54,Posthofbrug 5366,2023-01-29,04:00:00,28,7,21,FMN GV 16 Berchem TOT
54,Posthofbrug 5366,2023-01-29,05:00:00,19,5,14,FMN GV 16 Berchem TOT
54,Posthofbrug 5366,2023-01-29,06:00:00,15,5,10,FMN GV 16 Berchem TOT
54,Posthofbrug 5366,2023-01-29,07:00:00,53,21,32,FMN GV 16 Berchem TOT
54,Posthofbrug 5366,2023-01-29,08:00:00,39,23,16,FMN GV 16 Berchem TOT
54,Posthofbrug 5366,2023-01-29,09:00:00,95,50,45,FMN GV 16 Berchem TOT
54,Posthofbrug 5366,2023-01-29,10:00:00,99,68,31,FMN GV 16 Berchem TOT
54,Posthofbrug 5366,2023-01-29,11:00:00,90,63,27,FMN GV 16 Berchem TOT
54,Posthofbrug 5366,2023-01-29,12:00:00,104,57,47,FMN GV 16 Berchem TOT
54,Posthofbrug 5366,2023-01-29,13:00:00,135,83,52,FMN GV 16 Berchem TOT
54,Posthofbrug 5366,2023-01-29,14:00:00,155,78,77,FMN GV 16 Berchem TOT
54,Posthofbrug 5366,2023-01-29,15:00:00,107,52,55,FMN GV 16 Berchem TOT
54,Posthofbrug 5366,2023-01-29,16:00:00,130,46,84,FMN GV 16 Berchem TOT
54,Posthofbrug 5366,2023-01-29,17:00:00,131,57,74,FMN GV 16 Berchem TOT
54,Posthofbrug 5366,2023-01-29,18:00:00,100,39,61,FMN GV 16 Berchem TOT
54,Posthofbrug 5366,2023-01-29,19:00:00,70,29,41,FMN GV 16 Berchem TOT
54,Posthofbrug 5366,2023-01-29,20:00:00,48,26,22,FMN GV 16 Berchem TOT
54,Posthofbrug 5366,2023-01-29,21:00:00,57,28,29,FMN GV 16 Berchem TOT
54,Posthofbrug 5366,2023-01-29,22:00:00,36,14,22,FMN GV 16 Berchem TOT
54,Posthofbrug 5366,2023-01-29,23:00:00,16,2,14,FMN GV 16 Berchem TOT
54,Posthofbrug 5366,2023-01-30,00:00:00,9,2,7,FMN GV 16 Berchem TOT
54,Posthofbrug 5366,2023-01-30,01:00:00,11,3,8,FMN GV 16 Berchem TOT
54,Posthofbrug 5366,2023-01-30,02:00:00,1,0,1,FMN GV 16 Berchem TOT
54,Posthofbrug 5366,2023-01-30,03:00:00,5,1,4,FMN GV 16 Berchem TOT
54,Posthofbrug 5366,2023-01-30,04:00:00,5,4,1,FMN GV 16 Berchem TOT
54,Posthofbrug 5366,2023-01-30,05:00:00,26,19,7,FMN GV 16 Berchem TOT
54,Posthofbrug 5366,2023-01-30,06:00:00,114,90,24,FMN GV 16 Berchem TOT
54,Posthofbrug 5366,2023-01-30,07:00:00,398,306,92,FMN GV 16 Berchem TOT
54,Posthofbrug 5366,2023-01-30,08:00:00,851,673,178,FMN GV 16 Berchem TOT
54,Posthofbrug 5366,2023-01-30,09:00:00,278,206,72,FMN GV 16 Berchem TOT
54,Posthofbrug 5366,2023-01-30,10:00:00,124,86,38,FMN GV 16 Berchem TOT
54,Posthofbrug 5366,2023-01-30,11:00:00,114,75,39,FMN GV 16 Berchem TOT
54,Posthofbrug 5366,2023-01-30,12:00:00,143,72,71,FMN GV 16 Berchem TOT
54,Posthofbrug 5366,2023-01-30,13:00:00,160,84,76,FMN GV 16 Berchem TOT
54,Posthofbrug 5366,2023-01-30,14:00:00,134,57,77,FMN GV 16 Berchem TOT
54,Posthofbrug 5366,2023-01-30,15:00:00,239,84,155,FMN GV 16 Berchem TOT
54,Posthofbrug 5366,2023-01-30,16:00:00,443,127,316,FMN GV 16 Berchem TOT
54,Posthofbrug 5366,2023-01-30,17:00:00,597,162,435,FMN GV 16 Berchem TOT
54,Posthofbrug 5366,2023-01-30,18:00:00,352,92,260,FMN GV 16 Berchem TOT
54,Posthofbrug 5366,2023-01-30,19:00:00,141,56,85,FMN GV 16 Berchem TOT
54,Posthofbrug 5366,2023-01-30,20:00:00,101,48,53,FMN GV 16 Berchem TOT
54,Posthofbrug 5366,2023-01-30,21:00:00,116,57,59,FMN GV 16 Berchem TOT
54,Posthofbrug 5366,2023-01-30,22:00:00,69,20,49,FMN GV 16 Berchem TOT
54,Posthofbrug 5366,2023-01-30,23:00:00,34,6,28,FMN GV 16 Berchem TOT
54,Posthofbrug 5366,2023-01-31,00:00:00,16,7,9,FMN GV 16 Berchem TOT
54,Posthofbrug 5366,2023-01-31,01:00:00,9,1,8,FMN GV 16 Berchem TOT
54,Posthofbrug 5366,2023-01-31,02:00:00,7,1,6,FMN GV 16 Berchem TOT
54,Posthofbrug 5366,2023-01-31,03:00:00,5,1,4,FMN GV 16 Berchem TOT
54,Posthofbrug 5366,2023-01-31,04:00:00,12,5,7,FMN GV 16 Berchem TOT
54,Posthofbrug 5366,2023-01-31,05:00:00,30,23,7,FMN GV 16 Berchem TOT
54,Posthofbrug 5366,2023-01-31,06:00:00,117,89,28,FMN GV 16 Berchem TOT
54,Posthofbrug 5366,2023-01-31,07:00:00,484,374,110,FMN GV 16 Berchem TOT
54,Posthofbrug 5366,2023-01-31,08:00:00,932,695,237,FMN GV 16 Berchem TOT
54,Posthofbrug 5366,2023-01-31,09:00:00,267,203,64,FMN GV 16 Berchem TOT
54,Posthofbrug 5366,2023-01-31,10:00:00,100,70,30,FMN GV 16 Berchem TOT
54,Posthofbrug 5366,2023-01-31,11:00:00,105,52,53,FMN GV 16 Berchem TOT
54,Posthofbrug 5366,2023-01-31,12:00:00,159,91,68,FMN GV 16 Berchem TOT
54,Posthofbrug 5366,2023-01-31,13:00:00,157,73,84,FMN GV 16 Berchem TOT
54,Posthofbrug 5366,2023-01-31,14:00:00,127,46,81,FMN GV 16 Berchem TOT
54,Posthofbrug 5366,2023-01-31,15:00:00,253,77,176,FMN GV 16 Berchem TOT
54,Posthofbrug 5366,2023-01-31,16:00:00,458,128,330,FMN GV 16 Berchem TOT
54,Posthofbrug 5366,2023-01-31,17:00:00,669,194,475,FMN GV 16 Berchem TOT
54,Posthofbrug 5366,2023-01-31,18:00:00,412,128,284,FMN GV 16 Berchem TOT
54,Posthofbrug 5366,2023-01-31,19:00:00,184,71,113,FMN GV 16 Berchem TOT
54,Posthofbrug 5366,2023-01-31,20:00:00,102,40,62,FMN GV 16 Berchem TOT
54,Posthofbrug 5366,2023-01-31,21:00:00,79,35,44,FMN GV 16 Berchem TOT
54,Posthofbrug 5366,2023-01-31,22:00:00,74,30,44,FMN GV 16 Berchem TOT
54,Posthofbrug 5366,2023-01-31,23:00:00,44,17,27,FMN GV 16 Berchem TOT
54,Posthofbrug 5366,2023-02-01,00:00:00,23,7,16,FMN GV 16 Berchem TOT
54,Posthofbrug 5366,2023-02-01,01:00:00,11,2,9,FMN GV 16 Berchem TOT
54,Posthofbrug 5366,2023-02-01,02:00:00,7,3,4,FMN GV 16 Berchem TOT
54,Posthofbrug 5366,2023-02-01,03:00:00,4,2,2,FMN GV 16 Berchem TOT
54,Posthofbrug 5366,2023-02-01,04:00:00,9,5,4,FMN GV 16 Berchem TOT
54,Posthofbrug 5366,2023-02-01,05:00:00,26,17,9,FMN GV 16 Berchem TOT
54,Posthofbrug 5366,2023-02-01,06:00:00,117,92,25,FMN GV 16 Berchem TOT
54,Posthofbrug 5366,2023-02-01,07:00:00,392,292,100,FMN GV 16 Berchem TOT
54,Posthofbrug 5366,2023-02-01,08:00:00,714,549,165,FMN GV 16 Berchem TOT
54,Posthofbrug 5366,2023-02-01,09:00:00,224,160,64,FMN GV 16 Berchem TOT
54,Posthofbrug 5366,2023-02-01,10:00:00,108,75,33,FMN GV 16 Berchem TOT
54,Posthofbrug 5366,2023-02-01,11:00:00,122,54,68,FMN GV 16 Berchem TOT
54,Posthofbrug 5366,2023-02-01,12:00:00,286,138,148,FMN GV 16 Berchem TOT
54,Posthofbrug 5366,2023-02-01,13:00:00,197,94,103,FMN GV 16 Berchem TOT
54,Posthofbrug 5366,2023-02-01,14:00:00,162,61,101,FMN GV 16 Berchem TOT
54,Posthofbrug 5366,2023-02-01,15:00:00,208,69,139,FMN GV 16 Berchem TOT
54,Posthofbrug 5366,2023-02-01,16:00:00,313,109,204,FMN GV 16 Berchem TOT
54,Posthofbrug 5366,2023-02-01,17:00:00,497,159,338,FMN GV 16 Berchem TOT
54,Posthofbrug 5366,2023-02-01,18:00:00,326,121,205,FMN GV 16 Berchem TOT
54,Posthofbrug 5366,2023-02-01,19:00:00,191,91,100,FMN GV 16 Berchem TOT
54,Posthofbrug 5366,2023-02-01,20:00:00,122,52,70,FMN GV 16 Berchem TOT
54,Posthofbrug 5366,2023-02-01,21:00:00,67,35,32,FMN GV 16 Berchem TOT
54,Posthofbrug 5366,2023-02-01,22:00:00,108,40,68,FMN GV 16 Berchem TOT
54,Posthofbrug 5366,2023-02-01,23:00:00,76,24,52,FMN GV 16 Berchem TOT
54,Posthofbrug 5366,2023-02-02,00:00:00,36,14,22,FMN GV 16 Berchem TOT
54,Posthofbrug 5366,2023-02-02,01:00:00,17,1,16,FMN GV 16 Berchem TOT
54,Posthofbrug 5366,2023-02-02,02:00:00,15,3,12,FMN GV 16 Berchem TOT
54,Posthofbrug 5366,2023-02-02,03:00:00,14,1,13,FMN GV 16 Berchem TOT
54,Posthofbrug 5366,2023-02-02,04:00:00,29,7,22,FMN GV 16 Berchem TOT
54,Posthofbrug 5366,2023-02-02,05:00:00,32,19,13,FMN GV 16 Berchem TOT
54,Posthofbrug 5366,2023-02-02,06:00:00,122,99,23,FMN GV 16 Berchem TOT
54,Posthofbrug 5366,2023-02-02,07:00:00,450,348,102,FMN GV 16 Berchem TOT
54,Posthofbrug 5366,2023-02-02,08:00:00,911,714,197,FMN GV 16 Berchem TOT
54,Posthofbrug 5366,2023-02-02,09:00:00,273,221,52,FMN GV 16 Berchem TOT
54,Posthofbrug 5366,2023-02-02,10:00:00,137,98,39,FMN GV 16 Berchem TOT
54,Posthofbrug 5366,2023-02-02,11:00:00,129,71,58,FMN GV 16 Berchem TOT
54,Posthofbrug 5366,2023-02-02,12:00:00,162,90,72,FMN GV 16 Berchem TOT
54,Posthofbrug 5366,2023-02-02,13:00:00,165,84,81,FMN GV 16 Berchem TOT
54,Posthofbrug 5366,2023-02-02,14:00:00,157,62,95,FMN GV 16 Berchem TOT
54,Posthofbrug 5366,2023-02-02,15:00:00,252,88,164,FMN GV 16 Berchem TOT
54,Posthofbrug 5366,2023-02-02,16:00:00,476,131,345,FMN GV 16 Berchem TOT
54,Posthofbrug 5366,2023-02-02,17:00:00,644,182,462,FMN GV 16 Berchem TOT
54,Posthofbrug 5366,2023-02-02,18:00:00,377,121,256,FMN GV 16 Berchem TOT
54,Posthofbrug 5366,2023-02-02,19:00:00,183,73,110,FMN GV 16 Berchem TOT
54,Posthofbrug 5366,2023-02-02,20:00:00,129,60,69,FMN GV 16 Berchem TOT
54,Posthofbrug 5366,2023-02-02,21:00:00,92,39,53,FMN GV 16 Berchem TOT
54,Posthofbrug 5366,2023-02-02,22:00:00,117,40,77,FMN GV 16 Berchem TOT
54,Posthofbrug 5366,2023-02-02,23:00:00,83,32,51,FMN GV 16 Berchem TOT
54,Posthofbrug 5366,2023-02-03,00:00:00,31,3,28,FMN GV 16 Berchem TOT
54,Posthofbrug 5366,2023-02-03,01:00:00,9,2,7,FMN GV 16 Berchem TOT
54,Posthofbrug 5366,2023-02-03,02:00:00,13,0,13,FMN GV 16 Berchem TOT
54,Posthofbrug 5366,2023-02-03,03:00:00,13,0,13,FMN GV 16 Berchem TOT
54,Posthofbrug 5366,2023-02-03,04:00:00,15,5,10,FMN GV 16 Berchem TOT
54,Posthofbrug 5366,2023-02-03,05:00:00,24,15,9,FMN GV 16 Berchem TOT
54,Posthofbrug 5366,2023-02-03,06:00:00,102,74,28,FMN GV 16 Berchem TOT
54,Posthofbrug 5366,2023-02-03,07:00:00,338,262,76,FMN GV 16 Berchem TOT
54,Posthofbrug 5366,2023-02-03,08:00:00,676,525,151,FMN GV 16 Berchem TOT
54,Posthofbrug 5366,2023-02-03,09:00:00,247,185,62,FMN GV 16 Berchem TOT
54,Posthofbrug 5366,2023-02-03,10:00:00,135,100,35,FMN GV 16 Berchem TOT
54,Posthofbrug 5366,2023-02-03,11:00:00,115,74,41,FMN GV 16 Berchem TOT
54,Posthofbrug 5366,2023-02-03,12:00:00,167,90,77,FMN GV 16 Berchem TOT
54,Posthofbrug 5366,2023-02-03,13:00:00,164,66,98,FMN GV 16 Berchem TOT
54,Posthofbrug 5366,2023-02-03,14:00:00,157,51,106,FMN GV 16 Berchem TOT
54,Posthofbrug 5366,2023-02-03,15:00:00,243,86,157,FMN GV 16 Berchem TOT
54,Posthofbrug 5366,2023-02-03,16:00:00,365,120,245,FMN GV 16 Berchem TOT
54,Posthofbrug 5366,2023-02-03,17:00:00,483,170,313,FMN GV 16 Berchem TOT
54,Posthofbrug 5366,2023-02-03,18:00:00,296,108,188,FMN GV 16 Berchem TOT
54,Posthofbrug 5366,2023-02-03,19:00:00,172,98,74,FMN GV 16 Berchem TOT
54,Posthofbrug 5366,2023-02-03,20:00:00,95,49,46,FMN GV 16 Berchem TOT
54,Posthofbrug 5366,2023-02-03,21:00:00,79,38,41,FMN GV 16 Berchem TOT
54,Posthofbrug 5366,2023-02-03,22:00:00,76,23,53,FMN GV 16 Berchem TOT
54,Posthofbrug 5366,2023-02-03,23:00:00,87,29,58,FMN GV 16 Berchem TOT
54,Posthofbrug 5366,2023-02-04,00:00:00,74,28,46,FMN GV 16 Berchem TOT
54,Posthofbrug 5366,2023-02-04,01:00:00,64,28,36,FMN GV 16 Berchem TOT
54,Posthofbrug 5366,2023-02-04,02:00:00,31,11,20,FMN GV 16 Berchem TOT
54,Posthofbrug 5366,2023-02-04,03:00:00,33,1,32,FMN GV 16 Berchem TOT
54,Posthofbrug 5366,2023-02-04,04:00:00,11,3,8,FMN GV 16 Berchem TOT
54,Posthofbrug 5366,2023-02-04,05:00:00,19,8,11,FMN GV 16 Berchem TOT
54,Posthofbrug 5366,2023-02-04,06:00:00,22,12,10,FMN GV 16 Berchem TOT
54,Posthofbrug 5366,2023-02-04,07:00:00,38,25,13,FMN GV 16 Berchem TOT
54,Posthofbrug 5366,2023-02-04,08:00:00,47,28,19,FMN GV 16 Berchem TOT
54,Posthofbrug 5366,2023-02-04,09:00:00,113,68,45,FMN GV 16 Berchem TOT
54,Posthofbrug 5366,2023-02-04,10:00:00,94,53,41,FMN GV 16 Berchem TOT
54,Posthofbrug 5366,2023-02-04,11:00:00,115,75,40,FMN GV 16 Berchem TOT
54,Posthofbrug 5366,2023-02-04,12:00:00,105,61,44,FMN GV 16 Berchem TOT
54,Posthofbrug 5366,2023-02-04,13:00:00,139,83,56,FMN GV 16 Berchem TOT
54,Posthofbrug 5366,2023-02-04,14:00:00,148,92,56,FMN GV 16 Berchem TOT
54,Posthofbrug 5366,2023-02-04,15:00:00,107,61,46,FMN GV 16 Berchem TOT
54,Posthofbrug 5366,2023-02-04,16:00:00,149,77,72,FMN GV 16 Berchem TOT
54,Posthofbrug 5366,2023-02-04,17:00:00,180,103,77,FMN GV 16 Berchem TOT
54,Posthofbrug 5366,2023-02-04,18:00:00,155,91,64,FMN GV 16 Berchem TOT
54,Posthofbrug 5366,2023-02-04,19:00:00,98,55,43,FMN GV 16 Berchem TOT
54,Posthofbrug 5366,2023-02-04,20:00:00,78,45,33,FMN GV 16 Berchem TOT
54,Posthofbrug 5366,2023-02-04,21:00:00,70,39,31,FMN GV 16 Berchem TOT
54,Posthofbrug 5366,2023-02-04,22:00:00,56,12,44,FMN GV 16 Berchem TOT
54,Posthofbrug 5366,2023-02-04,23:00:00,72,24,48,FMN GV 16 Berchem TOT
54,Posthofbrug 5366,2023-02-05,00:00:00,61,26,35,FMN GV 16 Berchem TOT
54,Posthofbrug 5366,2023-02-05,01:00:00,44,11,33,FMN GV 16 Berchem TOT
54,Posthofbrug 5366,2023-02-05,02:00:00,19,8,11,FMN GV 16 Berchem TOT
54,Posthofbrug 5366,2023-02-05,03:00:00,16,8,8,FMN GV 16 Berchem TOT
54,Posthofbrug 5366,2023-02-05,04:00:00,14,7,7,FMN GV 16 Berchem TOT
54,Posthofbrug 5366,2023-02-05,05:00:00,11,2,9,FMN GV 16 Berchem TOT
54,Posthofbrug 5366,2023-02-05,06:00:00,15,8,7,FMN GV 16 Berchem TOT
54,Posthofbrug 5366,2023-02-05,07:00:00,23,11,12,FMN GV 16 Berchem TOT
54,Posthofbrug 5366,2023-02-05,08:00:00,45,27,18,FMN GV 16 Berchem TOT
54,Posthofbrug 5366,2023-02-05,09:00:00,118,93,25,FMN GV 16 Berchem TOT
54,Posthofbrug 5366,2023-02-05,10:00:00,102,69,33,FMN GV 16 Berchem TOT
54,Posthofbrug 5366,2023-02-05,11:00:00,91,51,40,FMN GV 16 Berchem TOT
54,Posthofbrug 5366,2023-02-05,12:00:00,180,83,97,FMN GV 16 Berchem TOT
54,Posthofbrug 5366,2023-02-05,13:00:00,184,112,72,FMN GV 16 Berchem TOT
54,Posthofbrug 5366,2023-02-05,14:00:00,172,97,75,FMN GV 16 Berchem TOT
54,Posthofbrug 5366,2023-02-05,15:00:00,123,52,71,FMN GV 16 Berchem TOT
54,Posthofbrug 5366,2023-02-05,16:00:00,137,70,67,FMN GV 16 Berchem TOT
54,Posthofbrug 5366,2023-02-05,17:00:00,123,57,66,FMN GV 16 Berchem TOT
54,Posthofbrug 5366,2023-02-05,18:00:00,114,43,71,FMN GV 16 Berchem TOT
54,Posthofbrug 5366,2023-02-05,19:00:00,50,29,21,FMN GV 16 Berchem TOT
54,Posthofbrug 5366,2023-02-05,20:00:00,64,29,35,FMN GV 16 Berchem TOT
54,Posthofbrug 5366,2023-02-05,21:00:00,67,25,42,FMN GV 16 Berchem TOT
54,Posthofbrug 5366,2023-02-05,22:00:00,51,13,38,FMN GV 16 Berchem TOT
54,Posthofbrug 5366,2023-02-05,23:00:00,28,9,19,FMN GV 16 Berchem TOT
54,Posthofbrug 5366,2023-02-06,00:00:00,13,4,9,FMN GV 16 Berchem TOT
54,Posthofbrug 5366,2023-02-06,01:00:00,9,0,9,FMN GV 16 Berchem TOT
54,Posthofbrug 5366,2023-02-06,02:00:00,3,1,2,FMN GV 16 Berchem TOT
54,Posthofbrug 5366,2023-02-06,03:00:00,1,0,1,FMN GV 16 Berchem TOT
54,Posthofbrug 5366,2023-02-06,04:00:00,15,11,4,FMN GV 16 Berchem TOT
54,Posthofbrug 5366,2023-02-06,05:00:00,15,10,5,FMN GV 16 Berchem TOT
54,Posthofbrug 5366,2023-02-06,06:00:00,124,93,31,FMN GV 16 Berchem TOT
54,Posthofbrug 5366,2023-02-06,07:00:00,429,329,100,FMN GV 16 Berchem TOT
54,Posthofbrug 5366,2023-02-06,08:00:00,867,682,185,FMN GV 16 Berchem TOT
54,Posthofbrug 5366,2023-02-06,09:00:00,271,212,59,FMN GV 16 Berchem TOT
54,Posthofbrug 5366,2023-02-06,10:00:00,90,63,27,FMN GV 16 Berchem TOT
54,Posthofbrug 5366,2023-02-06,11:00:00,95,60,35,FMN GV 16 Berchem TOT
54,Posthofbrug 5366,2023-02-06,12:00:00,151,72,79,FMN GV 16 Berchem TOT
54,Posthofbrug 5366,2023-02-06,13:00:00,152,81,71,FMN GV 16 Berchem TOT
54,Posthofbrug 5366,2023-02-06,14:00:00,151,68,83,FMN GV 16 Berchem TOT
54,Posthofbrug 5366,2023-02-06,15:00:00,269,94,175,FMN GV 16 Berchem TOT
54,Posthofbrug 5366,2023-02-06,16:00:00,433,117,316,FMN GV 16 Berchem TOT
54,Posthofbrug 5366,2023-02-06,17:00:00,676,198,478,FMN GV 16 Berchem TOT
54,Posthofbrug 5366,2023-02-06,18:00:00,399,112,287,FMN GV 16 Berchem TOT
54,Posthofbrug 5366,2023-02-06,19:00:00,131,49,82,FMN GV 16 Berchem TOT
54,Posthofbrug 5366,2023-02-06,20:00:00,103,47,56,FMN GV 16 Berchem TOT
54,Posthofbrug 5366,2023-02-06,21:00:00,73,32,41,FMN GV 16 Berchem TOT
54,Posthofbrug 5366,2023-02-06,22:00:00,68,20,48,FMN GV 16 Berchem TOT
54,Posthofbrug 5366,2023-02-06,23:00:00,30,9,21,FMN GV 16 Berchem TOT
54,Posthofbrug 5366,2023-02-07,00:00:00,14,3,11,FMN GV 16 Berchem TOT
54,Posthofbrug 5366,2023-02-07,01:00:00,4,0,4,FMN GV 16 Berchem TOT
54,Posthofbrug 5366,2023-02-07,02:00:00,2,0,2,FMN GV 16 Berchem TOT
54,Posthofbrug 5366,2023-02-07,03:00:00,1,0,1,FMN GV 16 Berchem TOT
54,Posthofbrug 5366,2023-02-07,04:00:00,9,6,3,FMN GV 16 Berchem TOT
54,Posthofbrug 5366,2023-02-07,05:00:00,33,28,5,FMN GV 16 Berchem TOT
54,Posthofbrug 5366,2023-02-07,06:00:00,123,97,26,FMN GV 16 Berchem TOT
54,Posthofbrug 5366,2023-02-07,07:00:00,458,358,100,FMN GV 16 Berchem TOT
54,Posthofbrug 5366,2023-02-07,08:00:00,912,700,212,FMN GV 16 Berchem TOT
54,Posthofbrug 5366,2023-02-07,09:00:00,303,212,91,FMN GV 16 Berchem TOT
54,Posthofbrug 5366,2023-02-07,10:00:00,152,99,53,FMN GV 16 Berchem TOT
54,Posthofbrug 5366,2023-02-07,11:00:00,130,77,53,FMN GV 16 Berchem TOT
54,Posthofbrug 5366,2023-02-07,12:00:00,148,75,73,FMN GV 16 Berchem TOT
54,Posthofbrug 5366,2023-02-07,13:00:00,145,77,68,FMN GV 16 Berchem TOT
54,Posthofbrug 5366,2023-02-07,14:00:00,153,59,94,FMN GV 16 Berchem TOT
54,Posthofbrug 5366,2023-02-07,15:00:00,250,70,180,FMN GV 16 Berchem TOT
54,Posthofbrug 5366,2023-02-07,16:00:00,538,155,383,FMN GV 16 Berchem TOT
54,Posthofbrug 5366,2023-02-07,17:00:00,687,195,492,FMN GV 16 Berchem TOT
54,Posthofbrug 5366,2023-02-07,18:00:00,398,113,285,FMN GV 16 Berchem TOT
54,Posthofbrug 5366,2023-02-07,19:00:00,205,86,119,FMN GV 16 Berchem TOT
54,Posthofbrug 5366,2023-02-07,20:00:00,88,39,49,FMN GV 16 Berchem TOT
54,Posthofbrug 5366,2023-02-07,21:00:00,121,53,68,FMN GV 16 Berchem TOT
54,Posthofbrug 5366,2023-02-07,22:00:00,114,37,77,FMN GV 16 Berchem TOT
54,Posthofbrug 5366,2023-02-07,23:00:00,54,11,43,FMN GV 16 Berchem TOT
54,Posthofbrug 5366,2023-02-08,00:00:00,22,7,15,FMN GV 16 Berchem TOT
54,Posthofbrug 5366,2023-02-08,01:00:00,19,5,14,FMN GV 16 Berchem TOT
54,Posthofbrug 5366,2023-02-08,02:00:00,5,0,5,FMN GV 16 Berchem TOT
54,Posthofbrug 5366,2023-02-08,03:00:00,4,2,2,FMN GV 16 Berchem TOT
54,Posthofbrug 5366,2023-02-08,04:00:00,8,6,2,FMN GV 16 Berchem TOT
54,Posthofbrug 5366,2023-02-08,05:00:00,30,22,8,FMN GV 16 Berchem TOT
54,Posthofbrug 5366,2023-02-08,06:00:00,115,88,27,FMN GV 16 Berchem TOT
54,Posthofbrug 5366,2023-02-08,07:00:00,382,294,88,FMN GV 16 Berchem TOT
54,Posthofbrug 5366,2023-02-08,08:00:00,722,537,185,FMN GV 16 Berchem TOT
54,Posthofbrug 5366,2023-02-08,09:00:00,224,163,61,FMN GV 16 Berchem TOT
54,Posthofbrug 5366,2023-02-08,10:00:00,109,75,34,FMN GV 16 Berchem TOT
54,Posthofbrug 5366,2023-02-08,11:00:00,112,64,48,FMN GV 16 Berchem TOT
54,Posthofbrug 5366,2023-02-08,12:00:00,265,121,144,FMN GV 16 Berchem TOT
54,Posthofbrug 5366,2023-02-08,13:00:00,231,111,120,FMN GV 16 Berchem TOT
54,Posthofbrug 5366,2023-02-08,14:00:00,150,75,75,FMN GV 16 Berchem TOT
54,Posthofbrug 5366,2023-02-08,15:00:00,266,100,166,FMN GV 16 Berchem TOT
54,Posthofbrug 5366,2023-02-08,16:00:00,360,125,235,FMN GV 16 Berchem TOT
54,Posthofbrug 5366,2023-02-08,17:00:00,519,181,338,FMN GV 16 Berchem TOT
54,Posthofbrug 5366,2023-02-08,18:00:00,319,120,199,FMN GV 16 Berchem TOT
54,Posthofbrug 5366,2023-02-08,19:00:00,175,75,100,FMN GV 16 Berchem TOT
54,Posthofbrug 5366,2023-02-08,20:00:00,110,42,68,FMN GV 16 Berchem TOT
54,Posthofbrug 5366,2023-02-08,21:00:00,83,33,50,FMN GV 16 Berchem TOT
54,Posthofbrug 5366,2023-02-08,22:00:00,77,21,56,FMN GV 16 Berchem TOT
54,Posthofbrug 5366,2023-02-08,23:00:00,62,17,45,FMN GV 16 Berchem TOT
54,Posthofbrug 5366,2023-02-09,00:00:00,36,7,29,FMN GV 16 Berchem TOT
54,Posthofbrug 5366,2023-02-09,01:00:00,18,5,13,FMN GV 16 Berchem TOT
54,Posthofbrug 5366,2023-02-09,02:00:00,6,2,4,FMN GV 16 Berchem TOT
54,Posthofbrug 5366,2023-02-09,03:00:00,5,4,1,FMN GV 16 Berchem TOT
54,Posthofbrug 5366,2023-02-09,04:00:00,13,9,4,FMN GV 16 Berchem TOT
54,Posthofbrug 5366,2023-02-09,05:00:00,27,20,7,FMN GV 16 Berchem TOT
54,Posthofbrug 5366,2023-02-09,06:00:00,122,94,28,FMN GV 16 Berchem TOT
54,Posthofbrug 5366,2023-02-09,07:00:00,414,327,87,FMN GV 16 Berchem TOT
54,Posthofbrug 5366,2023-02-09,08:00:00,872,672,200,FMN GV 16 Berchem TOT
54,Posthofbrug 5366,2023-02-09,09:00:00,273,210,63,FMN GV 16 Berchem TOT
54,Posthofbrug 5366,2023-02-09,10:00:00,123,78,45,FMN GV 16 Berchem TOT
54,Posthofbrug 5366,2023-02-09,11:00:00,118,76,42,FMN GV 16 Berchem TOT
54,Posthofbrug 5366,2023-02-09,12:00:00,166,90,76,FMN GV 16 Berchem TOT
54,Posthofbrug 5366,2023-02-09,13:00:00,149,64,85,FMN GV 16 Berchem TOT
54,Posthofbrug 5366,2023-02-09,14:00:00,155,58,97,FMN GV 16 Berchem TOT
54,Posthofbrug 5366,2023-02-09,15:00:00,229,72,157,FMN GV 16 Berchem TOT
54,Posthofbrug 5366,2023-02-09,16:00:00,482,144,338,FMN GV 16 Berchem TOT
54,Posthofbrug 5366,2023-02-09,17:00:00,602,190,412,FMN GV 16 Berchem TOT
54,Posthofbrug 5366,2023-02-09,18:00:00,378,132,246,FMN GV 16 Berchem TOT
54,Posthofbrug 5366,2023-02-09,19:00:00,173,64,109,FMN GV 16 Berchem TOT
54,Posthofbrug 5366,2023-02-09,20:00:00,104,57,47,FMN GV 16 Berchem TOT
54,Posthofbrug 5366,2023-02-09,21:00:00,79,30,49,FMN GV 16 Berchem TOT
54,Posthofbrug 5366,2023-02-09,22:00:00,105,41,64,FMN GV 16 Berchem TOT
54,Posthofbrug 5366,2023-02-09,23:00:00,62,8,54,FMN GV 16 Berchem TOT
54,Posthofbrug 5366,2023-02-10,00:00:00,31,7,24,FMN GV 16 Berchem TOT
54,Posthofbrug 5366,2023-02-10,01:00:00,14,0,14,FMN GV 16 Berchem TOT
54,Posthofbrug 5366,2023-02-10,02:00:00,7,1,6,FMN GV 16 Berchem TOT
54,Posthofbrug 5366,2023-02-10,03:00:00,5,0,5,FMN GV 16 Berchem TOT
54,Posthofbrug 5366,2023-02-10,04:00:00,12,6,6,FMN GV 16 Berchem TOT
54,Posthofbrug 5366,2023-02-10,05:00:00,27,21,6,FMN GV 16 Berchem TOT
54,Posthofbrug 5366,2023-02-10,06:00:00,83,61,22,FMN GV 16 Berchem TOT
54,Posthofbrug 5366,2023-02-10,07:00:00,355,256,99,FMN GV 16 Berchem TOT
54,Posthofbrug 5366,2023-02-10,08:00:00,663,526,137,FMN GV 16 Berchem TOT
54,Posthofbrug 5366,2023-02-10,09:00:00,236,189,47,FMN GV 16 Berchem TOT
54,Posthofbrug 5366,2023-02-10,10:00:00,120,74,46,FMN GV 16 Berchem TOT
54,Posthofbrug 5366,2023-02-10,11:00:00,105,65,40,FMN GV 16 Berchem TOT
54,Posthofbrug 5366,2023-02-10,12:00:00,178,94,84,FMN GV 16 Berchem TOT
54,Posthofbrug 5366,2023-02-10,13:00:00,148,72,76,FMN GV 16 Berchem TOT
54,Posthofbrug 5366,2023-02-10,14:00:00,176,71,105,FMN GV 16 Berchem TOT
54,Posthofbrug 5366,2023-02-10,15:00:00,237,78,159,FMN GV 16 Berchem TOT
54,Posthofbrug 5366,2023-02-10,16:00:00,384,111,273,FMN GV 16 Berchem TOT
54,Posthofbrug 5366,2023-02-10,17:00:00,437,146,291,FMN GV 16 Berchem TOT
54,Posthofbrug 5366,2023-02-10,18:00:00,295,121,174,FMN GV 16 Berchem TOT
54,Posthofbrug 5366,2023-02-10,19:00:00,187,104,83,FMN GV 16 Berchem TOT
54,Posthofbrug 5366,2023-02-10,20:00:00,102,55,47,FMN GV 16 Berchem TOT
54,Posthofbrug 5366,2023-02-10,21:00:00,85,43,42,FMN GV 16 Berchem TOT
54,Posthofbrug 5366,2023-02-10,22:00:00,117,44,73,FMN GV 16 Berchem TOT
54,Posthofbrug 5366,2023-02-10,23:00:00,98,32,66,FMN GV 16 Berchem TOT
54,Posthofbrug 5366,2023-02-11,00:00:00,70,12,58,FMN GV 16 Berchem TOT
54,Posthofbrug 5366,2023-02-11,01:00:00,47,8,39,FMN GV 16 Berchem TOT
54,Posthofbrug 5366,2023-02-11,02:00:00,28,11,17,FMN GV 16 Berchem TOT
54,Posthofbrug 5366,2023-02-11,03:00:00,19,5,14,FMN GV 16 Berchem TOT
54,Posthofbrug 5366,2023-02-11,04:00:00,9,4,5,FMN GV 16 Berchem TOT
54,Posthofbrug 5366,2023-02-11,05:00:00,28,9,19,FMN GV 16 Berchem TOT
54,Posthofbrug 5366,2023-02-11,06:00:00,15,10,5,FMN GV 16 Berchem TOT
54,Posthofbrug 5366,2023-02-11,07:00:00,30,22,8,FMN GV 16 Berchem TOT
54,Posthofbrug 5366,2023-02-11,08:00:00,68,46,22,FMN GV 16 Berchem TOT
54,Posthofbrug 5366,2023-02-11,09:00:00,150,100,50,FMN GV 16 Berchem TOT
54,Posthofbrug 5366,2023-02-11,10:00:00,129,83,46,FMN GV 16 Berchem TOT
54,Posthofbrug 5366,2023-02-11,11:00:00,148,104,44,FMN GV 16 Berchem TOT
54,Posthofbrug 5366,2023-02-11,12:00:00,143,79,64,FMN GV 16 Berchem TOT
54,Posthofbrug 5366,2023-02-11,13:00:00,150,99,51,FMN GV 16 Berchem TOT
54,Posthofbrug 5366,2023-02-11,14:00:00,139,71,68,FMN GV 16 Berchem TOT
54,Posthofbrug 5366,2023-02-11,15:00:00,160,91,69,FMN GV 16 Berchem TOT
54,Posthofbrug 5366,2023-02-11,16:00:00,146,67,79,FMN GV 16 Berchem TOT
54,Posthofbrug 5366,2023-02-11,17:00:00,153,72,81,FMN GV 16 Berchem TOT
54,Posthofbrug 5366,2023-02-11,18:00:00,133,68,65,FMN GV 16 Berchem TOT
54,Posthofbrug 5366,2023-02-11,19:00:00,143,65,78,FMN GV 16 Berchem TOT
54,Posthofbrug 5366,2023-02-11,20:00:00,67,33,34,FMN GV 16 Berchem TOT
54,Posthofbrug 5366,2023-02-11,21:00:00,71,35,36,FMN GV 16 Berchem TOT
54,Posthofbrug 5366,2023-02-11,22:00:00,79,28,51,FMN GV 16 Berchem TOT
54,Posthofbrug 5366,2023-02-11,23:00:00,44,12,32,FMN GV 16 Berchem TOT
54,Posthofbrug 5366,2023-02-12,00:00:00,72,16,56,FMN GV 16 Berchem TOT
54,Posthofbrug 5366,2023-02-12,01:00:00,45,8,37,FMN GV 16 Berchem TOT
54,Posthofbrug 5366,2023-02-12,02:00:00,19,7,12,FMN GV 16 Berchem TOT
54,Posthofbrug 5366,2023-02-12,03:00:00,14,3,11,FMN GV 16 Berchem TOT
54,Posthofbrug 5366,2023-02-12,04:00:00,14,4,10,FMN GV 16 Berchem TOT
54,Posthofbrug 5366,2023-02-12,05:00:00,8,5,3,FMN GV 16 Berchem TOT
54,Posthofbrug 5366,2023-02-12,06:00:00,22,16,6,FMN GV 16 Berchem TOT
54,Posthofbrug 5366,2023-02-12,07:00:00,28,17,11,FMN GV 16 Berchem TOT
54,Posthofbrug 5366,2023-02-12,08:00:00,56,33,23,FMN GV 16 Berchem TOT
54,Posthofbrug 5366,2023-02-12,09:00:00,115,72,43,FMN GV 16 Berchem TOT
54,Posthofbrug 5366,2023-02-12,10:00:00,124,75,49,FMN GV 16 Berchem TOT
54,Posthofbrug 5366,2023-02-12,11:00:00,131,83,48,FMN GV 16 Berchem TOT
54,Posthofbrug 5366,2023-02-12,12:00:00,142,85,57,FMN GV 16 Berchem TOT
54,Posthofbrug 5366,2023-02-12,13:00:00,145,77,68,FMN GV 16 Berchem TOT
54,Posthofbrug 5366,2023-02-12,14:00:00,160,87,73,FMN GV 16 Berchem TOT
54,Posthofbrug 5366,2023-02-12,15:00:00,124,57,67,FMN GV 16 Berchem TOT
54,Posthofbrug 5366,2023-02-12,16:00:00,138,72,66,FMN GV 16 Berchem TOT
54,Posthofbrug 5366,2023-02-12,17:00:00,126,75,51,FMN GV 16 Berchem TOT
54,Posthofbrug 5366,2023-02-12,18:00:00,97,50,47,FMN GV 16 Berchem TOT
54,Posthofbrug 5366,2023-02-12,19:00:00,95,46,49,FMN GV 16 Berchem TOT
54,Posthofbrug 5366,2023-02-12,20:00:00,46,24,22,FMN GV 16 Berchem TOT
54,Posthofbrug 5366,2023-02-12,21:00:00,62,27,35,FMN GV 16 Berchem TOT
54,Posthofbrug 5366,2023-02-12,22:00:00,57,23,34,FMN GV 16 Berchem TOT
54,Posthofbrug 5366,2023-02-12,23:00:00,28,11,17,FMN GV 16 Berchem TOT
54,Posthofbrug 5366,2023-02-13,00:00:00,13,2,11,FMN GV 16 Berchem TOT
54,Posthofbrug 5366,2023-02-13,01:00:00,5,1,4,FMN GV 16 Berchem TOT
54,Posthofbrug 5366,2023-02-13,02:00:00,1,0,1,FMN GV 16 Berchem TOT
54,Posthofbrug 5366,2023-02-13,03:00:00,3,0,3,FMN GV 16 Berchem TOT
54,Posthofbrug 5366,2023-02-13,04:00:00,15,12,3,FMN GV 16 Berchem TOT
54,Posthofbrug 5366,2023-02-13,05:00:00,24,19,5,FMN GV 16 Berchem TOT
54,Posthofbrug 5366,2023-02-13,06:00:00,117,101,16,FMN GV 16 Berchem TOT
54,Posthofbrug 5366,2023-02-13,07:00:00,430,351,79,FMN GV 16 Berchem TOT
54,Posthofbrug 5366,2023-02-13,08:00:00,916,709,207,FMN GV 16 Berchem TOT
54,Posthofbrug 5366,2023-02-13,09:00:00,279,218,61,FMN GV 16 Berchem TOT
54,Posthofbrug 5366,2023-02-13,10:00:00,136,100,36,FMN GV 16 Berchem TOT
54,Posthofbrug 5366,2023-02-13,11:00:00,129,93,36,FMN GV 16 Berchem TOT
54,Posthofbrug 5366,2023-02-13,12:00:00,213,103,110,FMN GV 16 Berchem TOT
54,Posthofbrug 5366,2023-02-13,13:00:00,181,94,87,FMN GV 16 Berchem TOT
54,Posthofbrug 5366,2023-02-13,14:00:00,175,69,106,FMN GV 16 Berchem TOT
54,Posthofbrug 5366,2023-02-13,15:00:00,295,99,196,FMN GV 16 Berchem TOT
54,Posthofbrug 5366,2023-02-13,16:00:00,482,129,353,FMN GV 16 Berchem TOT
54,Posthofbrug 5366,2023-02-13,17:00:00,683,182,501,FMN GV 16 Berchem TOT
54,Posthofbrug 5366,2023-02-13,18:00:00,392,126,266,FMN GV 16 Berchem TOT
54,Posthofbrug 5366,2023-02-13,19:00:00,178,56,122,FMN GV 16 Berchem TOT
54,Posthofbrug 5366,2023-02-13,20:00:00,150,63,87,FMN GV 16 Berchem TOT
54,Posthofbrug 5366,2023-02-13,21:00:00,85,29,56,FMN GV 16 Berchem TOT
54,Posthofbrug 5366,2023-02-13,22:00:00,94,29,65,FMN GV 16 Berchem TOT
54,Posthofbrug 5366,2023-02-13,23:00:00,35,12,23,FMN GV 16 Berchem TOT
54,Posthofbrug 5366,2023-02-14,00:00:00,18,2,16,FMN GV 16 Berchem TOT
54,Posthofbrug 5366,2023-02-14,01:00:00,10,1,9,FMN GV 16 Berchem TOT
54,Posthofbrug 5366,2023-02-14,02:00:00,5,0,5,FMN GV 16 Berchem TOT
54,Posthofbrug 5366,2023-02-14,03:00:00,6,3,3,FMN GV 16 Berchem TOT
54,Posthofbrug 5366,2023-02-14,04:00:00,12,8,4,FMN GV 16 Berchem TOT
54,Posthofbrug 5366,2023-02-14,05:00:00,29,25,4,FMN GV 16 Berchem TOT
54,Posthofbrug 5366,2023-02-14,06:00:00,124,104,20,FMN GV 16 Berchem TOT
54,Posthofbrug 5366,2023-02-14,07:00:00,554,430,124,FMN GV 16 Berchem TOT
54,Posthofbrug 5366,2023-02-14,08:00:00,1034,799,235,FMN GV 16 Berchem TOT
54,Posthofbrug 5366,2023-02-14,09:00:00,318,249,69,FMN GV 16 Berchem TOT
54,Posthofbrug 5366,2023-02-14,10:00:00,206,138,68,FMN GV 16 Berchem TOT
54,Posthofbrug 5366,2023-02-14,11:00:00,123,83,40,FMN GV 16 Berchem TOT
54,Posthofbrug 5366,2023-02-14,12:00:00,224,123,101,FMN GV 16 Berchem TOT
54,Posthofbrug 5366,2023-02-14,13:00:00,201,111,90,FMN GV 16 Berchem TOT
54,Posthofbrug 5366,2023-02-14,14:00:00,210,86,124,FMN GV 16 Berchem TOT
54,Posthofbrug 5366,2023-02-14,15:00:00,357,111,246,FMN GV 16 Berchem TOT
54,Posthofbrug 5366,2023-02-14,16:00:00,598,174,424,FMN GV 16 Berchem TOT
54,Posthofbrug 5366,2023-02-14,17:00:00,768,227,541,FMN GV 16 Berchem TOT
54,Posthofbrug 5366,2023-02-14,18:00:00,446,140,306,FMN GV 16 Berchem TOT
54,Posthofbrug 5366,2023-02-14,19:00:00,206,72,134,FMN GV 16 Berchem TOT
54,Posthofbrug 5366,2023-02-14,20:00:00,138,55,83,FMN GV 16 Berchem TOT
54,Posthofbrug 5366,2023-02-14,21:00:00,114,39,75,FMN GV 16 Berchem TOT
54,Posthofbrug 5366,2023-02-14,22:00:00,104,45,59,FMN GV 16 Berchem TOT
54,Posthofbrug 5366,2023-02-14,23:00:00,63,20,43,FMN GV 16 Berchem TOT
54,Posthofbrug 5366,2023-02-15,00:00:00,25,7,18,FMN GV 16 Berchem TOT
54,Posthofbrug 5366,2023-02-15,01:00:00,6,0,6,FMN GV 16 Berchem TOT
54,Posthofbrug 5366,2023-02-15,02:00:00,4,0,4,FMN GV 16 Berchem TOT
54,Posthofbrug 5366,2023-02-15,03:00:00,6,2,4,FMN GV 16 Berchem TOT
54,Posthofbrug 5366,2023-02-15,04:00:00,11,5,6,FMN GV 16 Berchem TOT
54,Posthofbrug 5366,2023-02-15,05:00:00,38,31,7,FMN GV 16 Berchem TOT
54,Posthofbrug 5366,2023-02-15,06:00:00,119,99,20,FMN GV 16 Berchem TOT
54,Posthofbrug 5366,2023-02-15,07:00:00,450,334,116,FMN GV 16 Berchem TOT
54,Posthofbrug 5366,2023-02-15,08:00:00,774,602,172,FMN GV 16 Berchem TOT
54,Posthofbrug 5366,2023-02-15,09:00:00,271,191,80,FMN GV 16 Berchem TOT
54,Posthofbrug 5366,2023-02-15,10:00:00,171,100,71,FMN GV 16 Berchem TOT
54,Posthofbrug 5366,2023-02-15,11:00:00,147,77,70,FMN GV 16 Berchem TOT
54,Posthofbrug 5366,2023-02-15,12:00:00,318,153,165,FMN GV 16 Berchem TOT
54,Posthofbrug 5366,2023-02-15,13:00:00,256,117,139,FMN GV 16 Berchem TOT
54,Posthofbrug 5366,2023-02-15,14:00:00,213,106,107,FMN GV 16 Berchem TOT
54,Posthofbrug 5366,2023-02-15,15:00:00,255,88,167,FMN GV 16 Berchem TOT
54,Posthofbrug 5366,2023-02-15,16:00:00,389,135,254,FMN GV 16 Berchem TOT
54,Posthofbrug 5366,2023-02-15,17:00:00,573,189,384,FMN GV 16 Berchem TOT
54,Posthofbrug 5366,2023-02-15,18:00:00,418,151,267,FMN GV 16 Berchem TOT
54,Posthofbrug 5366,2023-02-15,19:00:00,182,80,102,FMN GV 16 Berchem TOT
54,Posthofbrug 5366,2023-02-15,20:00:00,119,57,62,FMN GV 16 Berchem TOT
54,Posthofbrug 5366,2023-02-15,21:00:00,93,39,54,FMN GV 16 Berchem TOT
54,Posthofbrug 5366,2023-02-15,22:00:00,97,37,60,FMN GV 16 Berchem TOT
54,Posthofbrug 5366,2023-02-15,23:00:00,61,17,44,FMN GV 16 Berchem TOT
54,Posthofbrug 5366,2023-02-16,00:00:00,28,7,21,FMN GV 16 Berchem TOT
54,Posthofbrug 5366,2023-02-16,01:00:00,6,0,6,FMN GV 16 Berchem TOT
54,Posthofbrug 5366,2023-02-16,02:00:00,1,0,1,FMN GV 16 Berchem TOT
54,Posthofbrug 5366,2023-02-16,03:00:00,4,1,3,FMN GV 16 Berchem TOT
54,Posthofbrug 5366,2023-02-16,04:00:00,11,4,7,FMN GV 16 Berchem TOT
54,Posthofbrug 5366,2023-02-16,05:00:00,35,29,6,FMN GV 16 Berchem TOT
54,Posthofbrug 5366,2023-02-16,06:00:00,138,113,25,FMN GV 16 Berchem TOT
54,Posthofbrug 5366,2023-02-16,07:00:00,464,358,106,FMN GV 16 Berchem TOT
54,Posthofbrug 5366,2023-02-16,08:00:00,930,708,222,FMN GV 16 Berchem TOT
54,Posthofbrug 5366,2023-02-16,09:00:00,279,222,57,FMN GV 16 Berchem TOT
54,Posthofbrug 5366,2023-02-16,10:00:00,112,73,39,FMN GV 16 Berchem TOT
54,Posthofbrug 5366,2023-02-16,11:00:00,119,70,49,FMN GV 16 Berchem TOT
54,Posthofbrug 5366,2023-02-16,12:00:00,188,105,83,FMN GV 16 Berchem TOT
54,Posthofbrug 5366,2023-02-16,13:00:00,159,82,77,FMN GV 16 Berchem TOT
54,Posthofbrug 5366,2023-02-16,14:00:00,125,47,78,FMN GV 16 Berchem TOT
54,Posthofbrug 5366,2023-02-16,15:00:00,254,79,175,FMN GV 16 Berchem TOT
54,Posthofbrug 5366,2023-02-16,16:00:00,512,157,355,FMN GV 16 Berchem TOT
54,Posthofbrug 5366,2023-02-16,17:00:00,631,201,430,FMN GV 16 Berchem TOT
54,Posthofbrug 5366,2023-02-16,18:00:00,401,125,276,FMN GV 16 Berchem TOT
54,Posthofbrug 5366,2023-02-16,19:00:00,216,99,117,FMN GV 16 Berchem TOT
54,Posthofbrug 5366,2023-02-16,20:00:00,124,52,72,FMN GV 16 Berchem TOT
54,Posthofbrug 5366,2023-02-16,21:00:00,110,31,79,FMN GV 16 Berchem TOT
54,Posthofbrug 5366,2023-02-16,22:00:00,120,45,75,FMN GV 16 Berchem TOT
54,Posthofbrug 5366,2023-02-16,23:00:00,74,20,54,FMN GV 16 Berchem TOT
54,Posthofbrug 5366,2023-02-17,00:00:00,28,9,19,FMN GV 16 Berchem TOT
54,Posthofbrug 5366,2023-02-17,01:00:00,16,2,14,FMN GV 16 Berchem TOT
54,Posthofbrug 5366,2023-02-17,02:00:00,11,2,9,FMN GV 16 Berchem TOT
54,Posthofbrug 5366,2023-02-17,03:00:00,5,0,5,FMN GV 16 Berchem TOT
54,Posthofbrug 5366,2023-02-17,04:00:00,12,9,3,FMN GV 16 Berchem TOT
54,Posthofbrug 5366,2023-02-17,05:00:00,24,17,7,FMN GV 16 Berchem TOT
54,Posthofbrug 5366,2023-02-17,06:00:00,96,73,23,FMN GV 16 Berchem TOT
54,Posthofbrug 5366,2023-02-17,07:00:00,378,285,93,FMN GV 16 Berchem TOT
54,Posthofbrug 5366,2023-02-17,08:00:00,703,545,158,FMN GV 16 Berchem TOT
54,Posthofbrug 5366,2023-02-17,09:00:00,240,193,47,FMN GV 16 Berchem TOT
54,Posthofbrug 5366,2023-02-17,10:00:00,139,92,47,FMN GV 16 Berchem TOT
54,Posthofbrug 5366,2023-02-17,11:00:00,139,91,48,FMN GV 16 Berchem TOT
54,Posthofbrug 5366,2023-02-17,12:00:00,203,94,109,FMN GV 16 Berchem TOT
54,Posthofbrug 5366,2023-02-17,13:00:00,181,83,98,FMN GV 16 Berchem TOT
54,Posthofbrug 5366,2023-02-17,14:00:00,164,58,106,FMN GV 16 Berchem TOT
54,Posthofbrug 5366,2023-02-17,15:00:00,264,88,176,FMN GV 16 Berchem TOT
54,Posthofbrug 5366,2023-02-17,16:00:00,422,128,294,FMN GV 16 Berchem TOT
54,Posthofbrug 5366,2023-02-17,17:00:00,484,164,320,FMN GV 16 Berchem TOT
54,Posthofbrug 5366,2023-02-17,18:00:00,307,142,165,FMN GV 16 Berchem TOT
54,Posthofbrug 5366,2023-02-17,19:00:00,195,117,78,FMN GV 16 Berchem TOT
54,Posthofbrug 5366,2023-02-17,20:00:00,113,67,46,FMN GV 16 Berchem TOT
54,Posthofbrug 5366,2023-02-17,21:00:00,70,33,37,FMN GV 16 Berchem TOT
54,Posthofbrug 5366,2023-02-17,22:00:00,100,23,77,FMN GV 16 Berchem TOT
54,Posthofbrug 5366,2023-02-17,23:00:00,105,29,76,FMN GV 16 Berchem TOT
54,Posthofbrug 5366,2023-02-18,00:00:00,92,24,68,FMN GV 16 Berchem TOT
54,Posthofbrug 5366,2023-02-18,01:00:00,64,11,53,FMN GV 16 Berchem TOT
54,Posthofbrug 5366,2023-02-18,02:00:00,30,2,28,FMN GV 16 Berchem TOT
54,Posthofbrug 5366,2023-02-18,03:00:00,25,1,24,FMN GV 16 Berchem TOT
54,Posthofbrug 5366,2023-02-18,04:00:00,22,4,18,FMN GV 16 Berchem TOT
54,Posthofbrug 5366,2023-02-18,05:00:00,16,4,12,FMN GV 16 Berchem TOT
54,Posthofbrug 5366,2023-02-18,06:00:00,23,9,14,FMN GV 16 Berchem TOT
54,Posthofbrug 5366,2023-02-18,07:00:00,24,13,11,FMN GV 16 Berchem TOT
54,Posthofbrug 5366,2023-02-18,08:00:00,58,41,17,FMN GV 16 Berchem TOT
54,Posthofbrug 5366,2023-02-18,09:00:00,115,82,33,FMN GV 16 Berchem TOT
54,Posthofbrug 5366,2023-02-18,10:00:00,127,73,54,FMN GV 16 Berchem TOT
54,Posthofbrug 5366,2023-02-18,11:00:00,123,68,55,FMN GV 16 Berchem TOT
54,Posthofbrug 5366,2023-02-18,12:00:00,144,88,56,FMN GV 16 Berchem TOT
54,Posthofbrug 5366,2023-02-18,13:00:00,171,99,72,FMN GV 16 Berchem TOT
54,Posthofbrug 5366,2023-02-18,14:00:00,149,88,61,FMN GV 16 Berchem TOT
54,Posthofbrug 5366,2023-02-18,15:00:00,145,62,83,FMN GV 16 Berchem TOT
54,Posthofbrug 5366,2023-02-18,16:00:00,122,56,66,FMN GV 16 Berchem TOT
54,Posthofbrug 5366,2023-02-18,17:00:00,155,79,76,FMN GV 16 Berchem TOT
54,Posthofbrug 5366,2023-02-18,18:00:00,160,72,88,FMN GV 16 Berchem TOT
54,Posthofbrug 5366,2023-02-18,19:00:00,107,73,34,FMN GV 16 Berchem TOT
54,Posthofbrug 5366,2023-02-18,20:00:00,80,46,34,FMN GV 16 Berchem TOT
54,Posthofbrug 5366,2023-02-18,21:00:00,76,37,39,FMN GV 16 Berchem TOT
54,Posthofbrug 5366,2023-02-18,22:00:00,71,28,43,FMN GV 16 Berchem TOT
54,Posthofbrug 5366,2023-02-18,23:00:00,88,32,56,FMN GV 16 Berchem TOT
54,Posthofbrug 5366,2023-02-19,00:00:00,62,18,44,FMN GV 16 Berchem TOT
54,Posthofbrug 5366,2023-02-19,01:00:00,61,16,45,FMN GV 16 Berchem TOT
54,Posthofbrug 5366,2023-02-19,02:00:00,23,3,20,FMN GV 16 Berchem TOT
54,Posthofbrug 5366,2023-02-19,03:00:00,24,4,20,FMN GV 16 Berchem TOT
54,Posthofbrug 5366,2023-02-19,04:00:00,13,1,12,FMN GV 16 Berchem TOT
54,Posthofbrug 5366,2023-02-19,05:00:00,16,6,10,FMN GV 16 Berchem TOT
54,Posthofbrug 5366,2023-02-19,06:00:00,30,15,15,FMN GV 16 Berchem TOT
54,Posthofbrug 5366,2023-02-19,07:00:00,25,14,11,FMN GV 16 Berchem TOT
54,Posthofbrug 5366,2023-02-19,08:00:00,42,28,14,FMN GV 16 Berchem TOT
54,Posthofbrug 5366,2023-02-19,09:00:00,103,59,44,FMN GV 16 Berchem TOT
54,Posthofbrug 5366,2023-02-19,10:00:00,137,90,47,FMN GV 16 Berchem TOT
54,Posthofbrug 5366,2023-02-19,11:00:00,101,61,40,FMN GV 16 Berchem TOT
54,Posthofbrug 5366,2023-02-19,12:00:00,134,87,47,FMN GV 16 Berchem TOT
54,Posthofbrug 5366,2023-02-19,13:00:00,120,67,53,FMN GV 16 Berchem TOT
54,Posthofbrug 5366,2023-02-19,14:00:00,168,106,62,FMN GV 16 Berchem TOT
54,Posthofbrug 5366,2023-02-19,15:00:00,129,60,69,FMN GV 16 Berchem TOT
54,Posthofbrug 5366,2023-02-19,16:00:00,127,48,79,FMN GV 16 Berchem TOT
54,Posthofbrug 5366,2023-02-19,17:00:00,121,56,65,FMN GV 16 Berchem TOT
54,Posthofbrug 5366,2023-02-19,18:00:00,102,39,63,FMN GV 16 Berchem TOT
54,Posthofbrug 5366,2023-02-19,19:00:00,73,36,37,FMN GV 16 Berchem TOT
54,Posthofbrug 5366,2023-02-19,20:00:00,54,25,29,FMN GV 16 Berchem TOT
54,Posthofbrug 5366,2023-02-19,21:00:00,65,33,32,FMN GV 16 Berchem TOT
54,Posthofbrug 5366,2023-02-19,22:00:00,42,12,30,FMN GV 16 Berchem TOT
54,Posthofbrug 5366,2023-02-19,23:00:00,22,7,15,FMN GV 16 Berchem TOT
54,Posthofbrug 5366,2023-02-20,00:00:00,14,2,12,FMN GV 16 Berchem TOT
54,Posthofbrug 5366,2023-02-20,01:00:00,6,0,6,FMN GV 16 Berchem TOT
54,Posthofbrug 5366,2023-02-20,02:00:00,2,1,1,FMN GV 16 Berchem TOT
54,Posthofbrug 5366,2023-02-20,03:00:00,8,2,6,FMN GV 16 Berchem TOT
54,Posthofbrug 5366,2023-02-20,04:00:00,11,6,5,FMN GV 16 Berchem TOT
54,Posthofbrug 5366,2023-02-20,05:00:00,31,25,6,FMN GV 16 Berchem TOT
54,Posthofbrug 5366,2023-02-20,06:00:00,88,70,18,FMN GV 16 Berchem TOT
54,Posthofbrug 5366,2023-02-20,07:00:00,295,215,80,FMN GV 16 Berchem TOT
54,Posthofbrug 5366,2023-02-20,08:00:00,540,414,126,FMN GV 16 Berchem TOT
54,Posthofbrug 5366,2023-02-20,09:00:00,240,198,42,FMN GV 16 Berchem TOT
54,Posthofbrug 5366,2023-02-20,10:00:00,124,79,45,FMN GV 16 Berchem TOT
54,Posthofbrug 5366,2023-02-20,11:00:00,112,73,39,FMN GV 16 Berchem TOT
54,Posthofbrug 5366,2023-02-20,12:00:00,155,84,71,FMN GV 16 Berchem TOT
54,Posthofbrug 5366,2023-02-20,13:00:00,128,71,57,FMN GV 16 Berchem TOT
54,Posthofbrug 5366,2023-02-20,14:00:00,123,58,65,FMN GV 16 Berchem TOT
54,Posthofbrug 5366,2023-02-20,15:00:00,168,64,104,FMN GV 16 Berchem TOT
54,Posthofbrug 5366,2023-02-20,16:00:00,328,110,218,FMN GV 16 Berchem TOT
54,Posthofbrug 5366,2023-02-20,17:00:00,500,147,353,FMN GV 16 Berchem TOT
54,Posthofbrug 5366,2023-02-20,18:00:00,300,80,220,FMN GV 16 Berchem TOT
54,Posthofbrug 5366,2023-02-20,19:00:00,163,63,100,FMN GV 16 Berchem TOT
54,Posthofbrug 5366,2023-02-20,20:00:00,88,46,42,FMN GV 16 Berchem TOT
54,Posthofbrug 5366,2023-02-20,21:00:00,89,42,47,FMN GV 16 Berchem TOT
54,Posthofbrug 5366,2023-02-20,22:00:00,59,17,42,FMN GV 16 Berchem TOT
54,Posthofbrug 5366,2023-02-20,23:00:00,37,5,32,FMN GV 16 Berchem TOT
54,Posthofbrug 5366,2023-02-21,00:00:00,23,10,13,FMN GV 16 Berchem TOT
54,Posthofbrug 5366,2023-02-21,01:00:00,7,1,6,FMN GV 16 Berchem TOT
54,Posthofbrug 5366,2023-02-21,02:00:00,13,2,11,FMN GV 16 Berchem TOT
54,Posthofbrug 5366,2023-02-21,03:00:00,10,1,9,FMN GV 16 Berchem TOT
54,Posthofbrug 5366,2023-02-21,04:00:00,13,7,6,FMN GV 16 Berchem TOT
54,Posthofbrug 5366,2023-02-21,05:00:00,30,23,7,FMN GV 16 Berchem TOT
54,Posthofbrug 5366,2023-02-21,06:00:00,96,72,24,FMN GV 16 Berchem TOT
54,Posthofbrug 5366,2023-02-21,07:00:00,331,242,89,FMN GV 16 Berchem TOT
54,Posthofbrug 5366,2023-02-21,08:00:00,657,488,169,FMN GV 16 Berchem TOT
54,Posthofbrug 5366,2023-02-21,09:00:00,247,199,48,FMN GV 16 Berchem TOT
54,Posthofbrug 5366,2023-02-21,10:00:00,151,98,53,FMN GV 16 Berchem TOT
54,Posthofbrug 5366,2023-02-21,11:00:00,79,47,32,FMN GV 16 Berchem TOT
54,Posthofbrug 5366,2023-02-21,12:00:00,145,82,63,FMN GV 16 Berchem TOT
54,Posthofbrug 5366,2023-02-21,13:00:00,169,95,74,FMN GV 16 Berchem TOT
54,Posthofbrug 5366,2023-02-21,14:00:00,108,54,54,FMN GV 16 Berchem TOT
54,Posthofbrug 5366,2023-02-21,15:00:00,157,63,94,FMN GV 16 Berchem TOT
54,Posthofbrug 5366,2023-02-21,16:00:00,354,111,243,FMN GV 16 Berchem TOT
54,Posthofbrug 5366,2023-02-21,17:00:00,529,154,375,FMN GV 16 Berchem TOT
54,Posthofbrug 5366,2023-02-21,18:00:00,365,126,239,FMN GV 16 Berchem TOT
54,Posthofbrug 5366,2023-02-21,19:00:00,175,63,112,FMN GV 16 Berchem TOT
54,Posthofbrug 5366,2023-02-21,20:00:00,105,41,64,FMN GV 16 Berchem TOT
54,Posthofbrug 5366,2023-02-21,21:00:00,83,29,54,FMN GV 16 Berchem TOT
54,Posthofbrug 5366,2023-02-21,22:00:00,75,28,47,FMN GV 16 Berchem TOT
54,Posthofbrug 5366,2023-02-21,23:00:00,57,12,45,FMN GV 16 Berchem TOT
54,Posthofbrug 5366,2023-02-22,00:00:00,31,12,19,FMN GV 16 Berchem TOT
54,Posthofbrug 5366,2023-02-22,01:00:00,14,4,10,FMN GV 16 Berchem TOT
54,Posthofbrug 5366,2023-02-22,02:00:00,7,4,3,FMN GV 16 Berchem TOT
54,Posthofbrug 5366,2023-02-22,03:00:00,5,2,3,FMN GV 16 Berchem TOT
54,Posthofbrug 5366,2023-02-22,04:00:00,6,3,3,FMN GV 16 Berchem TOT
54,Posthofbrug 5366,2023-02-22,05:00:00,30,19,11,FMN GV 16 Berchem TOT
54,Posthofbrug 5366,2023-02-22,06:00:00,87,68,19,FMN GV 16 Berchem TOT
54,Posthofbrug 5366,2023-02-22,07:00:00,255,181,74,FMN GV 16 Berchem TOT
54,Posthofbrug 5366,2023-02-22,08:00:00,500,359,141,FMN GV 16 Berchem TOT
54,Posthofbrug 5366,2023-02-22,09:00:00,236,177,59,FMN GV 16 Berchem TOT
54,Posthofbrug 5366,2023-02-22,10:00:00,114,84,30,FMN GV 16 Berchem TOT
54,Posthofbrug 5366,2023-02-22,11:00:00,114,68,46,FMN GV 16 Berchem TOT
54,Posthofbrug 5366,2023-02-22,12:00:00,146,75,71,FMN GV 16 Berchem TOT
54,Posthofbrug 5366,2023-02-22,13:00:00,143,78,65,FMN GV 16 Berchem TOT
54,Posthofbrug 5366,2023-02-22,14:00:00,139,68,71,FMN GV 16 Berchem TOT
54,Posthofbrug 5366,2023-02-22,15:00:00,157,56,101,FMN GV 16 Berchem TOT
54,Posthofbrug 5366,2023-02-22,16:00:00,301,110,191,FMN GV 16 Berchem TOT
54,Posthofbrug 5366,2023-02-22,17:00:00,463,156,307,FMN GV 16 Berchem TOT
54,Posthofbrug 5366,2023-02-22,18:00:00,292,114,178,FMN GV 16 Berchem TOT
54,Posthofbrug 5366,2023-02-22,19:00:00,124,52,72,FMN GV 16 Berchem TOT
54,Posthofbrug 5366,2023-02-22,20:00:00,105,43,62,FMN GV 16 Berchem TOT
54,Posthofbrug 5366,2023-02-22,21:00:00,77,31,46,FMN GV 16 Berchem TOT
54,Posthofbrug 5366,2023-02-22,22:00:00,65,19,46,FMN GV 16 Berchem TOT
54,Posthofbrug 5366,2023-02-22,23:00:00,61,10,51,FMN GV 16 Berchem TOT
54,Posthofbrug 5366,2023-02-23,00:00:00,16,7,9,FMN GV 16 Berchem TOT
54,Posthofbrug 5366,2023-02-23,01:00:00,15,1,14,FMN GV 16 Berchem TOT
54,Posthofbrug 5366,2023-02-23,02:00:00,16,2,14,FMN GV 16 Berchem TOT
54,Posthofbrug 5366,2023-02-23,03:00:00,5,1,4,FMN GV 16 Berchem TOT
54,Posthofbrug 5366,2023-02-23,04:00:00,11,7,4,FMN GV 16 Berchem TOT
54,Posthofbrug 5366,2023-02-23,05:00:00,25,18,7,FMN GV 16 Berchem TOT
54,Posthofbrug 5366,2023-02-23,06:00:00,89,73,16,FMN GV 16 Berchem TOT
54,Posthofbrug 5366,2023-02-23,07:00:00,289,212,77,FMN GV 16 Berchem TOT
54,Posthofbrug 5366,2023-02-23,08:00:00,579,445,134,FMN GV 16 Berchem TOT
54,Posthofbrug 5366,2023-02-23,09:00:00,232,173,59,FMN GV 16 Berchem TOT
54,Posthofbrug 5366,2023-02-23,10:00:00,121,91,30,FMN GV 16 Berchem TOT
54,Posthofbrug 5366,2023-02-23,11:00:00,116,75,41,FMN GV 16 Berchem TOT
54,Posthofbrug 5366,2023-02-23,12:00:00,148,73,75,FMN GV 16 Berchem TOT
54,Posthofbrug 5366,2023-02-23,13:00:00,138,90,48,FMN GV 16 Berchem TOT
54,Posthofbrug 5366,2023-02-23,14:00:00,121,58,63,FMN GV 16 Berchem TOT
54,Posthofbrug 5366,2023-02-23,15:00:00,153,53,100,FMN GV 16 Berchem TOT
54,Posthofbrug 5366,2023-02-23,16:00:00,332,119,213,FMN GV 16 Berchem TOT
54,Posthofbrug 5366,2023-02-23,17:00:00,492,143,349,FMN GV 16 Berchem TOT
54,Posthofbrug 5366,2023-02-23,18:00:00,331,114,217,FMN GV 16 Berchem TOT
54,Posthofbrug 5366,2023-02-23,19:00:00,220,87,133,FMN GV 16 Berchem TOT
54,Posthofbrug 5366,2023-02-23,20:00:00,110,54,56,FMN GV 16 Berchem TOT
54,Posthofbrug 5366,2023-02-23,21:00:00,84,34,50,FMN GV 16 Berchem TOT
54,Posthofbrug 5366,2023-02-23,22:00:00,103,45,58,FMN GV 16 Berchem TOT
54,Posthofbrug 5366,2023-02-23,23:00:00,86,28,58,FMN GV 16 Berchem TOT
54,Posthofbrug 5366,2023-02-24,00:00:00,41,11,30,FMN GV 16 Berchem TOT
54,Posthofbrug 5366,2023-02-24,01:00:00,17,4,13,FMN GV 16 Berchem TOT
54,Posthofbrug 5366,2023-02-24,02:00:00,8,2,6,FMN GV 16 Berchem TOT
54,Posthofbrug 5366,2023-02-24,03:00:00,5,0,5,FMN GV 16 Berchem TOT
54,Posthofbrug 5366,2023-02-24,04:00:00,24,7,17,FMN GV 16 Berchem TOT
54,Posthofbrug 5366,2023-02-24,05:00:00,22,11,11,FMN GV 16 Berchem TOT
54,Posthofbrug 5366,2023-02-24,06:00:00,81,66,15,FMN GV 16 Berchem TOT
54,Posthofbrug 5366,2023-02-24,07:00:00,210,156,54,FMN GV 16 Berchem TOT
54,Posthofbrug 5366,2023-02-24,08:00:00,386,277,109,FMN GV 16 Berchem TOT
54,Posthofbrug 5366,2023-02-24,09:00:00,186,140,46,FMN GV 16 Berchem TOT
54,Posthofbrug 5366,2023-02-24,10:00:00,128,84,44,FMN GV 16 Berchem TOT
54,Posthofbrug 5366,2023-02-24,11:00:00,120,76,44,FMN GV 16 Berchem TOT
54,Posthofbrug 5366,2023-02-24,12:00:00,156,90,66,FMN GV 16 Berchem TOT
54,Posthofbrug 5366,2023-02-24,13:00:00,162,83,79,FMN GV 16 Berchem TOT
54,Posthofbrug 5366,2023-02-24,14:00:00,117,55,62,FMN GV 16 Berchem TOT
54,Posthofbrug 5366,2023-02-24,15:00:00,137,53,84,FMN GV 16 Berchem TOT
54,Posthofbrug 5366,2023-02-24,16:00:00,259,81,178,FMN GV 16 Berchem TOT
54,Posthofbrug 5366,2023-02-24,17:00:00,339,117,222,FMN GV 16 Berchem TOT
54,Posthofbrug 5366,2023-02-24,18:00:00,264,113,151,FMN GV 16 Berchem TOT
54,Posthofbrug 5366,2023-02-24,19:00:00,198,120,78,FMN GV 16 Berchem TOT
54,Posthofbrug 5366,2023-02-24,20:00:00,131,87,44,FMN GV 16 Berchem TOT
54,Posthofbrug 5366,2023-02-24,21:00:00,88,44,44,FMN GV 16 Berchem TOT
54,Posthofbrug 5366,2023-02-24,22:00:00,86,36,50,FMN GV 16 Berchem TOT
54,Posthofbrug 5366,2023-02-24,23:00:00,90,30,60,FMN GV 16 Berchem TOT
54,Posthofbrug 5366,2023-02-25,00:00:00,64,13,51,FMN GV 16 Berchem TOT
54,Posthofbrug 5366,2023-02-25,01:00:00,47,8,39,FMN GV 16 Berchem TOT
54,Posthofbrug 5366,2023-02-25,02:00:00,37,11,26,FMN GV 16 Berchem TOT
54,Posthofbrug 5366,2023-02-25,03:00:00,23,3,20,FMN GV 16 Berchem TOT
54,Posthofbrug 5366,2023-02-25,04:00:00,27,7,20,FMN GV 16 Berchem TOT
54,Posthofbrug 5366,2023-02-25,05:00:00,19,9,10,FMN GV 16 Berchem TOT
54,Posthofbrug 5366,2023-02-25,06:00:00,21,9,12,FMN GV 16 Berchem TOT
54,Posthofbrug 5366,2023-02-25,07:00:00,36,23,13,FMN GV 16 Berchem TOT
54,Posthofbrug 5366,2023-02-25,08:00:00,35,22,13,FMN GV 16 Berchem TOT
54,Posthofbrug 5366,2023-02-25,09:00:00,142,97,45,FMN GV 16 Berchem TOT
54,Posthofbrug 5366,2023-02-25,10:00:00,117,65,52,FMN GV 16 Berchem TOT
54,Posthofbrug 5366,2023-02-25,11:00:00,134,87,47,FMN GV 16 Berchem TOT
54,Posthofbrug 5366,2023-02-25,12:00:00,120,66,54,FMN GV 16 Berchem TOT
54,Posthofbrug 5366,2023-02-25,13:00:00,144,85,59,FMN GV 16 Berchem TOT
54,Posthofbrug 5366,2023-02-25,14:00:00,145,79,66,FMN GV 16 Berchem TOT
54,Posthofbrug 5366,2023-02-25,15:00:00,124,66,58,FMN GV 16 Berchem TOT
54,Posthofbrug 5366,2023-02-25,16:00:00,154,65,89,FMN GV 16 Berchem TOT
54,Posthofbrug 5366,2023-02-25,17:00:00,163,73,90,FMN GV 16 Berchem TOT
54,Posthofbrug 5366,2023-02-25,18:00:00,150,76,74,FMN GV 16 Berchem TOT
54,Posthofbrug 5366,2023-02-25,19:00:00,153,73,80,FMN GV 16 Berchem TOT
54,Posthofbrug 5366,2023-02-25,20:00:00,91,49,42,FMN GV 16 Berchem TOT
54,Posthofbrug 5366,2023-02-25,21:00:00,75,38,37,FMN GV 16 Berchem TOT
54,Posthofbrug 5366,2023-02-25,22:00:00,83,54,29,FMN GV 16 Berchem TOT
54,Posthofbrug 5366,2023-02-25,23:00:00,98,44,54,FMN GV 16 Berchem TOT
54,Posthofbrug 5366,2023-02-26,00:00:00,64,25,39,FMN GV 16 Berchem TOT
54,Posthofbrug 5366,2023-02-26,01:00:00,43,18,25,FMN GV 16 Berchem TOT
54,Posthofbrug 5366,2023-02-26,02:00:00,40,18,22,FMN GV 16 Berchem TOT
54,Posthofbrug 5366,2023-02-26,03:00:00,23,7,16,FMN GV 16 Berchem TOT
54,Posthofbrug 5366,2023-02-26,04:00:00,16,0,16,FMN GV 16 Berchem TOT
54,Posthofbrug 5366,2023-02-26,05:00:00,17,6,11,FMN GV 16 Berchem TOT
54,Posthofbrug 5366,2023-02-26,06:00:00,23,7,16,FMN GV 16 Berchem TOT
54,Posthofbrug 5366,2023-02-26,07:00:00,38,16,22,FMN GV 16 Berchem TOT
54,Posthofbrug 5366,2023-02-26,08:00:00,51,24,27,FMN GV 16 Berchem TOT
54,Posthofbrug 5366,2023-02-26,09:00:00,93,50,43,FMN GV 16 Berchem TOT
54,Posthofbrug 5366,2023-02-26,10:00:00,114,79,35,FMN GV 16 Berchem TOT
54,Posthofbrug 5366,2023-02-26,11:00:00,122,65,57,FMN GV 16 Berchem TOT
54,Posthofbrug 5366,2023-02-26,12:00:00,151,84,67,FMN GV 16 Berchem TOT
54,Posthofbrug 5366,2023-02-26,13:00:00,170,100,70,FMN GV 16 Berchem TOT
54,Posthofbrug 5366,2023-02-26,14:00:00,147,72,75,FMN GV 16 Berchem TOT
54,Posthofbrug 5366,2023-02-26,15:00:00,137,75,62,FMN GV 16 Berchem TOT
54,Posthofbrug 5366,2023-02-26,16:00:00,113,45,68,FMN GV 16 Berchem TOT
54,Posthofbrug 5366,2023-02-26,17:00:00,141,66,75,FMN GV 16 Berchem TOT
54,Posthofbrug 5366,2023-02-26,18:00:00,90,52,38,FMN GV 16 Berchem TOT
54,Posthofbrug 5366,2023-02-26,19:00:00,78,37,41,FMN GV 16 Berchem TOT
54,Posthofbrug 5366,2023-02-26,20:00:00,85,27,58,FMN GV 16 Berchem TOT
54,Posthofbrug 5366,2023-02-26,21:00:00,59,18,41,FMN GV 16 Berchem TOT
54,Posthofbrug 5366,2023-02-26,22:00:00,42,20,22,FMN GV 16 Berchem TOT
54,Posthofbrug 5366,2023-02-26,23:00:00,20,5,15,FMN GV 16 Berchem TOT
54,Posthofbrug 5366,2023-02-27,00:00:00,16,6,10,FMN GV 16 Berchem TOT
54,Posthofbrug 5366,2023-02-27,01:00:00,4,1,3,FMN GV 16 Berchem TOT
54,Posthofbrug 5366,2023-02-27,02:00:00,2,0,2,FMN GV 16 Berchem TOT
54,Posthofbrug 5366,2023-02-27,03:00:00,3,1,2,FMN GV 16 Berchem TOT
54,Posthofbrug 5366,2023-02-27,04:00:00,10,8,2,FMN GV 16 Berchem TOT
54,Posthofbrug 5366,2023-02-27,05:00:00,30,24,6,FMN GV 16 Berchem TOT
54,Posthofbrug 5366,2023-02-27,06:00:00,104,83,21,FMN GV 16 Berchem TOT
54,Posthofbrug 5366,2023-02-27,07:00:00,497,379,118,FMN GV 16 Berchem TOT
54,Posthofbrug 5366,2023-02-27,08:00:00,881,703,178,FMN GV 16 Berchem TOT
54,Posthofbrug 5366,2023-02-27,09:00:00,312,238,74,FMN GV 16 Berchem TOT
54,Posthofbrug 5366,2023-02-27,10:00:00,134,89,45,FMN GV 16 Berchem TOT
54,Posthofbrug 5366,2023-02-27,11:00:00,117,78,39,FMN GV 16 Berchem TOT
54,Posthofbrug 5366,2023-02-27,12:00:00,202,102,100,FMN GV 16 Berchem TOT
54,Posthofbrug 5366,2023-02-27,13:00:00,169,108,61,FMN GV 16 Berchem TOT
54,Posthofbrug 5366,2023-02-27,14:00:00,146,64,82,FMN GV 16 Berchem TOT
54,Posthofbrug 5366,2023-02-27,15:00:00,272,86,186,FMN GV 16 Berchem TOT
54,Posthofbrug 5366,2023-02-27,16:00:00,501,150,351,FMN GV 16 Berchem TOT
54,Posthofbrug 5366,2023-02-27,17:00:00,685,173,512,FMN GV 16 Berchem TOT
54,Posthofbrug 5366,2023-02-27,18:00:00,428,134,294,FMN GV 16 Berchem TOT
54,Posthofbrug 5366,2023-02-27,19:00:00,169,65,104,FMN GV 16 Berchem TOT
54,Posthofbrug 5366,2023-02-27,20:00:00,121,55,66,FMN GV 16 Berchem TOT
54,Posthofbrug 5366,2023-02-27,21:00:00,100,37,63,FMN GV 16 Berchem TOT
54,Posthofbrug 5366,2023-02-27,22:00:00,81,28,53,FMN GV 16 Berchem TOT
54,Posthofbrug 5366,2023-02-27,23:00:00,30,6,24,FMN GV 16 Berchem TOT
54,Posthofbrug 5366,2023-02-28,00:00:00,16,7,9,FMN GV 16 Berchem TOT
54,Posthofbrug 5366,2023-02-28,01:00:00,6,3,3,FMN GV 16 Berchem TOT
54,Posthofbrug 5366,2023-02-28,02:00:00,1,0,1,FMN GV 16 Berchem TOT
54,Posthofbrug 5366,2023-02-28,03:00:00,4,2,2,FMN GV 16 Berchem TOT
54,Posthofbrug 5366,2023-02-28,04:00:00,11,8,3,FMN GV 16 Berchem TOT
54,Posthofbrug 5366,2023-02-28,05:00:00,33,25,8,FMN GV 16 Berchem TOT
54,Posthofbrug 5366,2023-02-28,06:00:00,125,100,25,FMN GV 16 Berchem TOT
54,Posthofbrug 5366,2023-02-28,07:00:00,500,386,114,FMN GV 16 Berchem TOT
54,Posthofbrug 5366,2023-02-28,08:00:00,948,716,232,FMN GV 16 Berchem TOT
54,Posthofbrug 5366,2023-02-28,09:00:00,307,254,53,FMN GV 16 Berchem TOT
54,Posthofbrug 5366,2023-02-28,10:00:00,151,104,47,FMN GV 16 Berchem TOT
54,Posthofbrug 5366,2023-02-28,11:00:00,111,74,37,FMN GV 16 Berchem TOT
54,Posthofbrug 5366,2023-02-28,12:00:00,194,103,91,FMN GV 16 Berchem TOT
54,Posthofbrug 5366,2023-02-28,13:00:00,174,87,87,FMN GV 16 Berchem TOT
54,Posthofbrug 5366,2023-02-28,14:00:00,164,57,107,FMN GV 16 Berchem TOT
54,Posthofbrug 5366,2023-02-28,15:00:00,228,77,151,FMN GV 16 Berchem TOT
54,Posthofbrug 5366,2023-02-28,16:00:00,513,154,359,FMN GV 16 Berchem TOT
54,Posthofbrug 5366,2023-02-28,17:00:00,684,197,487,FMN GV 16 Berchem TOT
54,Posthofbrug 5366,2023-02-28,18:00:00,462,143,319,FMN GV 16 Berchem TOT
54,Posthofbrug 5366,2023-02-28,19:00:00,224,79,145,FMN GV 16 Berchem TOT
54,Posthofbrug 5366,2023-02-28,20:00:00,114,42,72,FMN GV 16 Berchem TOT
54,Posthofbrug 5366,2023-02-28,21:00:00,106,36,70,FMN GV 16 Berchem TOT
54,Posthofbrug 5366,2023-02-28,22:00:00,78,29,49,FMN GV 16 Berchem TOT
54,Posthofbrug 5366,2023-02-28,23:00:00,55,16,39,FMN GV 16 Berchem TOT
54,Posthofbrug 5366,2023-03-01,00:00:00,26,9,17,FMN GV 16 Berchem TOT
54,Posthofbrug 5366,2023-03-01,01:00:00,7,2,5,FMN GV 16 Berchem TOT
54,Posthofbrug 5366,2023-03-01,02:00:00,6,1,5,FMN GV 16 Berchem TOT
54,Posthofbrug 5366,2023-03-01,03:00:00,6,2,4,FMN GV 16 Berchem TOT
54,Posthofbrug 5366,2023-03-01,04:00:00,6,4,2,FMN GV 16 Berchem TOT
54,Posthofbrug 5366,2023-03-01,05:00:00,35,25,10,FMN GV 16 Berchem TOT
54,Posthofbrug 5366,2023-03-01,06:00:00,97,80,17,FMN GV 16 Berchem TOT
54,Posthofbrug 5366,2023-03-01,07:00:00,440,324,116,FMN GV 16 Berchem TOT
54,Posthofbrug 5366,2023-03-01,08:00:00,801,592,209,FMN GV 16 Berchem TOT
54,Posthofbrug 5366,2023-03-01,09:00:00,242,180,62,FMN GV 16 Berchem TOT
54,Posthofbrug 5366,2023-03-01,10:00:00,159,106,53,FMN GV 16 Berchem TOT
54,Posthofbrug 5366,2023-03-01,11:00:00,153,87,66,FMN GV 16 Berchem TOT
54,Posthofbrug 5366,2023-03-01,12:00:00,326,143,183,FMN GV 16 Berchem TOT
54,Posthofbrug 5366,2023-03-01,13:00:00,233,100,133,FMN GV 16 Berchem TOT
54,Posthofbrug 5366,2023-03-01,14:00:00,178,86,92,FMN GV 16 Berchem TOT
54,Posthofbrug 5366,2023-03-01,15:00:00,230,87,143,FMN GV 16 Berchem TOT
54,Posthofbrug 5366,2023-03-01,16:00:00,403,141,262,FMN GV 16 Berchem TOT
54,Posthofbrug 5366,2023-03-01,17:00:00,554,188,366,FMN GV 16 Berchem TOT
54,Posthofbrug 5366,2023-03-01,18:00:00,422,142,280,FMN GV 16 Berchem TOT
54,Posthofbrug 5366,2023-03-01,19:00:00,193,70,123,FMN GV 16 Berchem TOT
54,Posthofbrug 5366,2023-03-01,20:00:00,113,45,68,FMN GV 16 Berchem TOT
54,Posthofbrug 5366,2023-03-01,21:00:00,99,39,60,FMN GV 16 Berchem TOT
54,Posthofbrug 5366,2023-03-01,22:00:00,88,30,58,FMN GV 16 Berchem TOT
54,Posthofbrug 5366,2023-03-01,23:00:00,46,14,32,FMN GV 16 Berchem TOT
54,Posthofbrug 5366,2023-03-02,00:00:00,19,4,15,FMN GV 16 Berchem TOT
54,Posthofbrug 5366,2023-03-02,01:00:00,6,3,3,FMN GV 16 Berchem TOT
54,Posthofbrug 5366,2023-03-02,02:00:00,8,2,6,FMN GV 16 Berchem TOT
54,Posthofbrug 5366,2023-03-02,03:00:00,3,0,3,FMN GV 16 Berchem TOT
54,Posthofbrug 5366,2023-03-02,04:00:00,10,7,3,FMN GV 16 Berchem TOT
54,Posthofbrug 5366,2023-03-02,05:00:00,29,22,7,FMN GV 16 Berchem TOT
54,Posthofbrug 5366,2023-03-02,06:00:00,123,99,24,FMN GV 16 Berchem TOT
54,Posthofbrug 5366,2023-03-02,07:00:00,502,383,119,FMN GV 16 Berchem TOT
54,Posthofbrug 5366,2023-03-02,08:00:00,944,722,222,FMN GV 16 Berchem TOT
54,Posthofbrug 5366,2023-03-02,09:00:00,298,243,55,FMN GV 16 Berchem TOT
54,Posthofbrug 5366,2023-03-02,10:00:00,147,110,37,FMN GV 16 Berchem TOT
54,Posthofbrug 5366,2023-03-02,11:00:00,148,104,44,FMN GV 16 Berchem TOT
54,Posthofbrug 5366,2023-03-02,12:00:00,196,106,90,FMN GV 16 Berchem TOT
54,Posthofbrug 5366,2023-03-02,13:00:00,204,105,99,FMN GV 16 Berchem TOT
54,Posthofbrug 5366,2023-03-02,14:00:00,171,73,98,FMN GV 16 Berchem TOT
54,Posthofbrug 5366,2023-03-02,15:00:00,299,102,197,FMN GV 16 Berchem TOT
54,Posthofbrug 5366,2023-03-02,16:00:00,556,150,406,FMN GV 16 Berchem TOT
54,Posthofbrug 5366,2023-03-02,17:00:00,654,195,459,FMN GV 16 Berchem TOT
54,Posthofbrug 5366,2023-03-02,18:00:00,409,156,253,FMN GV 16 Berchem TOT
54,Posthofbrug 5366,2023-03-02,19:00:00,213,74,139,FMN GV 16 Berchem TOT
54,Posthofbrug 5366,2023-03-02,20:00:00,140,65,75,FMN GV 16 Berchem TOT
54,Posthofbrug 5366,2023-03-02,21:00:00,131,52,79,FMN GV 16 Berchem TOT
54,Posthofbrug 5366,2023-03-02,22:00:00,120,36,84,FMN GV 16 Berchem TOT
54,Posthofbrug 5366,2023-03-02,23:00:00,76,17,59,FMN GV 16 Berchem TOT
54,Posthofbrug 5366,2023-03-03,00:00:00,42,15,27,FMN GV 16 Berchem TOT
54,Posthofbrug 5366,2023-03-03,01:00:00,15,4,11,FMN GV 16 Berchem TOT
54,Posthofbrug 5366,2023-03-03,02:00:00,19,1,18,FMN GV 16 Berchem TOT
54,Posthofbrug 5366,2023-03-03,03:00:00,11,3,8,FMN GV 16 Berchem TOT
54,Posthofbrug 5366,2023-03-03,04:00:00,7,2,5,FMN GV 16 Berchem TOT
54,Posthofbrug 5366,2023-03-03,05:00:00,26,17,9,FMN GV 16 Berchem TOT
54,Posthofbrug 5366,2023-03-03,06:00:00,106,79,27,FMN GV 16 Berchem TOT
54,Posthofbrug 5366,2023-03-03,07:00:00,394,296,98,FMN GV 16 Berchem TOT
54,Posthofbrug 5366,2023-03-03,08:00:00,741,584,157,FMN GV 16 Berchem TOT
54,Posthofbrug 5366,2023-03-03,09:00:00,245,195,50,FMN GV 16 Berchem TOT
54,Posthofbrug 5366,2023-03-03,10:00:00,158,110,48,FMN GV 16 Berchem TOT
54,Posthofbrug 5366,2023-03-03,11:00:00,107,61,46,FMN GV 16 Berchem TOT
54,Posthofbrug 5366,2023-03-03,12:00:00,204,109,95,FMN GV 16 Berchem TOT
54,Posthofbrug 5366,2023-03-03,13:00:00,205,81,124,FMN GV 16 Berchem TOT
54,Posthofbrug 5366,2023-03-03,14:00:00,166,72,94,FMN GV 16 Berchem TOT
54,Posthofbrug 5366,2023-03-03,15:00:00,297,101,196,FMN GV 16 Berchem TOT
54,Posthofbrug 5366,2023-03-03,16:00:00,425,129,296,FMN GV 16 Berchem TOT
54,Posthofbrug 5366,2023-03-03,17:00:00,521,173,348,FMN GV 16 Berchem TOT
54,Posthofbrug 5366,2023-03-03,18:00:00,335,134,201,FMN GV 16 Berchem TOT
54,Posthofbrug 5366,2023-03-03,19:00:00,194,93,101,FMN GV 16 Berchem TOT
54,Posthofbrug 5366,2023-03-03,20:00:00,151,79,72,FMN GV 16 Berchem TOT
54,Posthofbrug 5366,2023-03-03,21:00:00,88,39,49,FMN GV 16 Berchem TOT
54,Posthofbrug 5366,2023-03-03,22:00:00,113,58,55,FMN GV 16 Berchem TOT
54,Posthofbrug 5366,2023-03-03,23:00:00,117,35,82,FMN GV 16 Berchem TOT
54,Posthofbrug 5366,2023-03-04,00:00:00,77,24,53,FMN GV 16 Berchem TOT
54,Posthofbrug 5366,2023-03-04,01:00:00,51,24,27,FMN GV 16 Berchem TOT
54,Posthofbrug 5366,2023-03-04,02:00:00,39,10,29,FMN GV 16 Berchem TOT
54,Posthofbrug 5366,2023-03-04,03:00:00,33,4,29,FMN GV 16 Berchem TOT
54,Posthofbrug 5366,2023-03-04,04:00:00,22,4,18,FMN GV 16 Berchem TOT
54,Posthofbrug 5366,2023-03-04,05:00:00,26,5,21,FMN GV 16 Berchem TOT
54,Posthofbrug 5366,2023-03-04,06:00:00,39,18,21,FMN GV 16 Berchem TOT
54,Posthofbrug 5366,2023-03-04,07:00:00,40,20,20,FMN GV 16 Berchem TOT
54,Posthofbrug 5366,2023-03-04,08:00:00,77,43,34,FMN GV 16 Berchem TOT
54,Posthofbrug 5366,2023-03-04,09:00:00,154,105,49,FMN GV 16 Berchem TOT
54,Posthofbrug 5366,2023-03-04,10:00:00,170,110,60,FMN GV 16 Berchem TOT
54,Posthofbrug 5366,2023-03-04,11:00:00,152,80,72,FMN GV 16 Berchem TOT
54,Posthofbrug 5366,2023-03-04,12:00:00,134,76,58,FMN GV 16 Berchem TOT
54,Posthofbrug 5366,2023-03-04,13:00:00,163,97,66,FMN GV 16 Berchem TOT
54,Posthofbrug 5366,2023-03-04,14:00:00,181,104,77,FMN GV 16 Berchem TOT
54,Posthofbrug 5366,2023-03-04,15:00:00,130,62,68,FMN GV 16 Berchem TOT
54,Posthofbrug 5366,2023-03-04,16:00:00,169,80,89,FMN GV 16 Berchem TOT
54,Posthofbrug 5366,2023-03-04,17:00:00,168,81,87,FMN GV 16 Berchem TOT
54,Posthofbrug 5366,2023-03-04,18:00:00,169,97,72,FMN GV 16 Berchem TOT
54,Posthofbrug 5366,2023-03-04,19:00:00,120,69,51,FMN GV 16 Berchem TOT
54,Posthofbrug 5366,2023-03-04,20:00:00,83,48,35,FMN GV 16 Berchem TOT
54,Posthofbrug 5366,2023-03-04,21:00:00,78,37,41,FMN GV 16 Berchem TOT
54,Posthofbrug 5366,2023-03-04,22:00:00,72,35,37,FMN GV 16 Berchem TOT
54,Posthofbrug 5366,2023-03-04,23:00:00,95,24,71,FMN GV 16 Berchem TOT
54,Posthofbrug 5366,2023-03-05,00:00:00,66,23,43,FMN GV 16 Berchem TOT
54,Posthofbrug 5366,2023-03-05,01:00:00,46,17,29,FMN GV 16 Berchem TOT
54,Posthofbrug 5366,2023-03-05,02:00:00,40,19,21,FMN GV 16 Berchem TOT
54,Posthofbrug 5366,2023-03-05,03:00:00,21,2,19,FMN GV 16 Berchem TOT
54,Posthofbrug 5366,2023-03-05,04:00:00,25,6,19,FMN GV 16 Berchem TOT
54,Posthofbrug 5366,2023-03-05,05:00:00,18,3,15,FMN GV 16 Berchem TOT
54,Posthofbrug 5366,2023-03-05,06:00:00,16,11,5,FMN GV 16 Berchem TOT
54,Posthofbrug 5366,2023-03-05,07:00:00,24,13,11,FMN GV 16 Berchem TOT
54,Posthofbrug 5366,2023-03-05,08:00:00,40,29,11,FMN GV 16 Berchem TOT
54,Posthofbrug 5366,2023-03-05,09:00:00,77,39,38,FMN GV 16 Berchem TOT
54,Posthofbrug 5366,2023-03-05,10:00:00,126,96,30,FMN GV 16 Berchem TOT
54,Posthofbrug 5366,2023-03-05,11:00:00,97,60,37,FMN GV 16 Berchem TOT
54,Posthofbrug 5366,2023-03-05,12:00:00,157,69,88,FMN GV 16 Berchem TOT
54,Posthofbrug 5366,2023-03-05,13:00:00,122,68,54,FMN GV 16 Berchem TOT
54,Posthofbrug 5366,2023-03-05,14:00:00,109,73,36,FMN GV 16 Berchem TOT
54,Posthofbrug 5366,2023-03-05,15:00:00,109,68,41,FMN GV 16 Berchem TOT
54,Posthofbrug 5366,2023-03-05,16:00:00,126,44,82,FMN GV 16 Berchem TOT
54,Posthofbrug 5366,2023-03-05,17:00:00,94,35,59,FMN GV 16 Berchem TOT
54,Posthofbrug 5366,2023-03-05,18:00:00,107,44,63,FMN GV 16 Berchem TOT
54,Posthofbrug 5366,2023-03-05,19:00:00,91,37,54,FMN GV 16 Berchem TOT
54,Posthofbrug 5366,2023-03-05,20:00:00,64,30,34,FMN GV 16 Berchem TOT
54,Posthofbrug 5366,2023-03-05,21:00:00,63,34,29,FMN GV 16 Berchem TOT
54,Posthofbrug 5366,2023-03-05,22:00:00,51,19,32,FMN GV 16 Berchem TOT
54,Posthofbrug 5366,2023-03-05,23:00:00,19,5,14,FMN GV 16 Berchem TOT
54,Posthofbrug 5366,2023-03-06,00:00:00,10,3,7,FMN GV 16 Berchem TOT
54,Posthofbrug 5366,2023-03-06,01:00:00,2,0,2,FMN GV 16 Berchem TOT
54,Posthofbrug 5366,2023-03-06,02:00:00,3,1,2,FMN GV 16 Berchem TOT
54,Posthofbrug 5366,2023-03-06,03:00:00,1,0,1,FMN GV 16 Berchem TOT
54,Posthofbrug 5366,2023-03-06,04:00:00,8,3,5,FMN GV 16 Berchem TOT
54,Posthofbrug 5366,2023-03-06,05:00:00,30,23,7,FMN GV 16 Berchem TOT
54,Posthofbrug 5366,2023-03-06,06:00:00,120,94,26,FMN GV 16 Berchem TOT
54,Posthofbrug 5366,2023-03-06,07:00:00,432,327,105,FMN GV 16 Berchem TOT
54,Posthofbrug 5366,2023-03-06,08:00:00,864,695,169,FMN GV 16 Berchem TOT
54,Posthofbrug 5366,2023-03-06,09:00:00,267,218,49,FMN GV 16 Berchem TOT
54,Posthofbrug 5366,2023-03-06,10:00:00,108,83,25,FMN GV 16 Berchem TOT
54,Posthofbrug 5366,2023-03-06,11:00:00,137,81,56,FMN GV 16 Berchem TOT
54,Posthofbrug 5366,2023-03-06,12:00:00,177,94,83,FMN GV 16 Berchem TOT
54,Posthofbrug 5366,2023-03-06,13:00:00,165,87,78,FMN GV 16 Berchem TOT
54,Posthofbrug 5366,2023-03-06,14:00:00,135,48,87,FMN GV 16 Berchem TOT
54,Posthofbrug 5366,2023-03-06,15:00:00,244,79,165,FMN GV 16 Berchem TOT
54,Posthofbrug 5366,2023-03-06,16:00:00,501,146,355,FMN GV 16 Berchem TOT
54,Posthofbrug 5366,2023-03-06,17:00:00,634,157,477,FMN GV 16 Berchem TOT
54,Posthofbrug 5366,2023-03-06,18:00:00,373,105,268,FMN GV 16 Berchem TOT
54,Posthofbrug 5366,2023-03-06,19:00:00,161,50,111,FMN GV 16 Berchem TOT
54,Posthofbrug 5366,2023-03-06,20:00:00,87,47,40,FMN GV 16 Berchem TOT
54,Posthofbrug 5366,2023-03-06,21:00:00,98,42,56,FMN GV 16 Berchem TOT
54,Posthofbrug 5366,2023-03-06,22:00:00,68,32,36,FMN GV 16 Berchem TOT
54,Posthofbrug 5366,2023-03-06,23:00:00,37,11,26,FMN GV 16 Berchem TOT
54,Posthofbrug 5366,2023-03-07,00:00:00,14,3,11,FMN GV 16 Berchem TOT
54,Posthofbrug 5366,2023-03-07,01:00:00,10,2,8,FMN GV 16 Berchem TOT
54,Posthofbrug 5366,2023-03-07,02:00:00,4,1,3,FMN GV 16 Berchem TOT
54,Posthofbrug 5366,2023-03-07,03:00:00,12,2,10,FMN GV 16 Berchem TOT
54,Posthofbrug 5366,2023-03-07,04:00:00,8,4,4,FMN GV 16 Berchem TOT
54,Posthofbrug 5366,2023-03-07,05:00:00,31,24,7,FMN GV 16 Berchem TOT
54,Posthofbrug 5366,2023-03-07,06:00:00,89,72,17,FMN GV 16 Berchem TOT
54,Posthofbrug 5366,2023-03-07,07:00:00,464,353,111,FMN GV 16 Berchem TOT
54,Posthofbrug 5366,2023-03-07,08:00:00,776,605,171,FMN GV 16 Berchem TOT
54,Posthofbrug 5366,2023-03-07,09:00:00,224,160,64,FMN GV 16 Berchem TOT
54,Posthofbrug 5366,2023-03-07,10:00:00,97,59,38,FMN GV 16 Berchem TOT
54,Posthofbrug 5366,2023-03-07,11:00:00,73,46,27,FMN GV 16 Berchem TOT
54,Posthofbrug 5366,2023-03-07,12:00:00,112,55,57,FMN GV 16 Berchem TOT
54,Posthofbrug 5366,2023-03-07,13:00:00,115,55,60,FMN GV 16 Berchem TOT
54,Posthofbrug 5366,2023-03-07,14:00:00,84,40,44,FMN GV 16 Berchem TOT
54,Posthofbrug 5366,2023-03-07,15:00:00,191,73,118,FMN GV 16 Berchem TOT
54,Posthofbrug 5366,2023-03-07,16:00:00,404,121,283,FMN GV 16 Berchem TOT
54,Posthofbrug 5366,2023-03-07,17:00:00,544,152,392,FMN GV 16 Berchem TOT
54,Posthofbrug 5366,2023-03-07,18:00:00,327,102,225,FMN GV 16 Berchem TOT
54,Posthofbrug 5366,2023-03-07,19:00:00,152,62,90,FMN GV 16 Berchem TOT
54,Posthofbrug 5366,2023-03-07,20:00:00,93,33,60,FMN GV 16 Berchem TOT
54,Posthofbrug 5366,2023-03-07,21:00:00,79,24,55,FMN GV 16 Berchem TOT
54,Posthofbrug 5366,2023-03-07,22:00:00,62,25,37,FMN GV 16 Berchem TOT
54,Posthofbrug 5366,2023-03-07,23:00:00,32,8,24,FMN GV 16 Berchem TOT
54,Posthofbrug 5366,2023-03-08,00:00:00,18,9,9,FMN GV 16 Berchem TOT
54,Posthofbrug 5366,2023-03-08,01:00:00,2,0,2,FMN GV 16 Berchem TOT
54,Posthofbrug 5366,2023-03-08,02:00:00,5,2,3,FMN GV 16 Berchem TOT
54,Posthofbrug 5366,2023-03-08,03:00:00,0,0,0,FMN GV 16 Berchem TOT
54,Posthofbrug 5366,2023-03-08,04:00:00,5,4,1,FMN GV 16 Berchem TOT
54,Posthofbrug 5366,2023-03-08,05:00:00,23,14,9,FMN GV 16 Berchem TOT
54,Posthofbrug 5366,2023-03-08,06:00:00,84,71,13,FMN GV 16 Berchem TOT
54,Posthofbrug 5366,2023-03-08,07:00:00,295,222,73,FMN GV 16 Berchem TOT
54,Posthofbrug 5366,2023-03-08,08:00:00,434,321,113,FMN GV 16 Berchem TOT
54,Posthofbrug 5366,2023-03-08,09:00:00,153,106,47,FMN GV 16 Berchem TOT
54,Posthofbrug 5366,2023-03-08,10:00:00,71,40,31,FMN GV 16 Berchem TOT
54,Posthofbrug 5366,2023-03-08,11:00:00,75,38,37,FMN GV 16 Berchem TOT
54,Posthofbrug 5366,2023-03-08,12:00:00,197,88,109,FMN GV 16 Berchem TOT
54,Posthofbrug 5366,2023-03-08,13:00:00,150,70,80,FMN GV 16 Berchem TOT
54,Posthofbrug 5366,2023-03-08,14:00:00,84,42,42,FMN GV 16 Berchem TOT
54,Posthofbrug 5366,2023-03-08,15:00:00,123,42,81,FMN GV 16 Berchem TOT
54,Posthofbrug 5366,2023-03-08,16:00:00,262,110,152,FMN GV 16 Berchem TOT
54,Posthofbrug 5366,2023-03-08,17:00:00,326,108,218,FMN GV 16 Berchem TOT
54,Posthofbrug 5366,2023-03-08,18:00:00,232,83,149,FMN GV 16 Berchem TOT
54,Posthofbrug 5366,2023-03-08,19:00:00,118,51,67,FMN GV 16 Berchem TOT
54,Posthofbrug 5366,2023-03-08,20:00:00,76,34,42,FMN GV 16 Berchem TOT
54,Posthofbrug 5366,2023-03-08,21:00:00,63,19,44,FMN GV 16 Berchem TOT
54,Posthofbrug 5366,2023-03-08,22:00:00,60,15,45,FMN GV 16 Berchem TOT
54,Posthofbrug 5366,2023-03-08,23:00:00,34,7,27,FMN GV 16 Berchem TOT
54,Posthofbrug 5366,2023-03-09,00:00:00,24,7,17,FMN GV 16 Berchem TOT
54,Posthofbrug 5366,2023-03-09,01:00:00,4,1,3,FMN GV 16 Berchem TOT
54,Posthofbrug 5366,2023-03-09,02:00:00,2,0,2,FMN GV 16 Berchem TOT
54,Posthofbrug 5366,2023-03-09,03:00:00,3,2,1,FMN GV 16 Berchem TOT
54,Posthofbrug 5366,2023-03-09,04:00:00,8,3,5,FMN GV 16 Berchem TOT
54,Posthofbrug 5366,2023-03-09,05:00:00,30,23,7,FMN GV 16 Berchem TOT
54,Posthofbrug 5366,2023-03-09,06:00:00,92,78,14,FMN GV 16 Berchem TOT
54,Posthofbrug 5366,2023-03-09,07:00:00,395,305,90,FMN GV 16 Berchem TOT
54,Posthofbrug 5366,2023-03-09,08:00:00,792,621,171,FMN GV 16 Berchem TOT
54,Posthofbrug 5366,2023-03-09,09:00:00,267,195,72,FMN GV 16 Berchem TOT
54,Posthofbrug 5366,2023-03-09,10:00:00,106,67,39,FMN GV 16 Berchem TOT
54,Posthofbrug 5366,2023-03-09,11:00:00,106,68,38,FMN GV 16 Berchem TOT
54,Posthofbrug 5366,2023-03-09,12:00:00,174,66,108,FMN GV 16 Berchem TOT
54,Posthofbrug 5366,2023-03-09,13:00:00,133,65,68,FMN GV 16 Berchem TOT
54,Posthofbrug 5366,2023-03-09,14:00:00,124,49,75,FMN GV 16 Berchem TOT
54,Posthofbrug 5366,2023-03-09,15:00:00,201,71,130,FMN GV 16 Berchem TOT
54,Posthofbrug 5366,2023-03-09,16:00:00,416,115,301,FMN GV 16 Berchem TOT
54,Posthofbrug 5366,2023-03-09,17:00:00,495,146,349,FMN GV 16 Berchem TOT
54,Posthofbrug 5366,2023-03-09,18:00:00,323,93,230,FMN GV 16 Berchem TOT
54,Posthofbrug 5366,2023-03-09,19:00:00,152,52,100,FMN GV 16 Berchem TOT
54,Posthofbrug 5366,2023-03-09,20:00:00,95,41,54,FMN GV 16 Berchem TOT
54,Posthofbrug 5366,2023-03-09,21:00:00,78,27,51,FMN GV 16 Berchem TOT
54,Posthofbrug 5366,2023-03-09,22:00:00,68,19,49,FMN GV 16 Berchem TOT
54,Posthofbrug 5366,2023-03-09,23:00:00,37,13,24,FMN GV 16 Berchem TOT
54,Posthofbrug 5366,2023-03-10,00:00:00,27,3,24,FMN GV 16 Berchem TOT
54,Posthofbrug 5366,2023-03-10,01:00:00,13,4,9,FMN GV 16 Berchem TOT
54,Posthofbrug 5366,2023-03-10,02:00:00,3,0,3,FMN GV 16 Berchem TOT
54,Posthofbrug 5366,2023-03-10,03:00:00,2,0,2,FMN GV 16 Berchem TOT
54,Posthofbrug 5366,2023-03-10,04:00:00,8,5,3,FMN GV 16 Berchem TOT
54,Posthofbrug 5366,2023-03-10,05:00:00,20,13,7,FMN GV 16 Berchem TOT
54,Posthofbrug 5366,2023-03-10,06:00:00,66,50,16,FMN GV 16 Berchem TOT
54,Posthofbrug 5366,2023-03-10,07:00:00,329,264,65,FMN GV 16 Berchem TOT
54,Posthofbrug 5366,2023-03-10,08:00:00,644,512,132,FMN GV 16 Berchem TOT
54,Posthofbrug 5366,2023-03-10,09:00:00,261,213,48,FMN GV 16 Berchem TOT
54,Posthofbrug 5366,2023-03-10,10:00:00,83,51,32,FMN GV 16 Berchem TOT
54,Posthofbrug 5366,2023-03-10,11:00:00,109,61,48,FMN GV 16 Berchem TOT
54,Posthofbrug 5366,2023-03-10,12:00:00,163,71,92,FMN GV 16 Berchem TOT
54,Posthofbrug 5366,2023-03-10,13:00:00,112,53,59,FMN GV 16 Berchem TOT
54,Posthofbrug 5366,2023-03-10,14:00:00,128,52,76,FMN GV 16 Berchem TOT
54,Posthofbrug 5366,2023-03-10,15:00:00,243,69,174,FMN GV 16 Berchem TOT
54,Posthofbrug 5366,2023-03-10,16:00:00,351,81,270,FMN GV 16 Berchem TOT
54,Posthofbrug 5366,2023-03-10,17:00:00,377,104,273,FMN GV 16 Berchem TOT
54,Posthofbrug 5366,2023-03-10,18:00:00,213,88,125,FMN GV 16 Berchem TOT
54,Posthofbrug 5366,2023-03-10,19:00:00,132,77,55,FMN GV 16 Berchem TOT
54,Posthofbrug 5366,2023-03-10,20:00:00,90,46,44,FMN GV 16 Berchem TOT
54,Posthofbrug 5366,2023-03-10,21:00:00,73,40,33,FMN GV 16 Berchem TOT
54,Posthofbrug 5366,2023-03-10,22:00:00,58,21,37,FMN GV 16 Berchem TOT
54,Posthofbrug 5366,2023-03-10,23:00:00,53,15,38,FMN GV 16 Berchem TOT
54,Posthofbrug 5366,2023-03-11,00:00:00,45,11,34,FMN GV 16 Berchem TOT
54,Posthofbrug 5366,2023-03-11,01:00:00,34,4,30,FMN GV 16 Berchem TOT
54,Posthofbrug 5366,2023-03-11,02:00:00,24,7,17,FMN GV 16 Berchem TOT
54,Posthofbrug 5366,2023-03-11,03:00:00,22,2,20,FMN GV 16 Berchem TOT
54,Posthofbrug 5366,2023-03-11,04:00:00,20,3,17,FMN GV 16 Berchem TOT
54,Posthofbrug 5366,2023-03-11,05:00:00,21,11,10,FMN GV 16 Berchem TOT
54,Posthofbrug 5366,2023-03-11,06:00:00,25,14,11,FMN GV 16 Berchem TOT
54,Posthofbrug 5366,2023-03-11,07:00:00,48,30,18,FMN GV 16 Berchem TOT
54,Posthofbrug 5366,2023-03-11,08:00:00,63,40,23,FMN GV 16 Berchem TOT
54,Posthofbrug 5366,2023-03-11,09:00:00,146,106,40,FMN GV 16 Berchem TOT
54,Posthofbrug 5366,2023-03-11,10:00:00,158,100,58,FMN GV 16 Berchem TOT
54,Posthofbrug 5366,2023-03-11,11:00:00,200,119,81,FMN GV 16 Berchem TOT
54,Posthofbrug 5366,2023-03-11,12:00:00,177,109,68,FMN GV 16 Berchem TOT
54,Posthofbrug 5366,2023-03-11,13:00:00,192,108,84,FMN GV 16 Berchem TOT
54,Posthofbrug 5366,2023-03-11,14:00:00,234,132,102,FMN GV 16 Berchem TOT
54,Posthofbrug 5366,2023-03-11,15:00:00,202,108,94,FMN GV 16 Berchem TOT
54,Posthofbrug 5366,2023-03-11,16:00:00,222,75,147,FMN GV 16 Berchem TOT
54,Posthofbrug 5366,2023-03-11,17:00:00,205,80,125,FMN GV 16 Berchem TOT
54,Posthofbrug 5366,2023-03-11,18:00:00,196,86,110,FMN GV 16 Berchem TOT
54,Posthofbrug 5366,2023-03-11,19:00:00,159,80,79,FMN GV 16 Berchem TOT
54,Posthofbrug 5366,2023-03-11,20:00:00,96,62,34,FMN GV 16 Berchem TOT
54,Posthofbrug 5366,2023-03-11,21:00:00,57,36,21,FMN GV 16 Berchem TOT
54,Posthofbrug 5366,2023-03-11,22:00:00,100,45,55,FMN GV 16 Berchem TOT
54,Posthofbrug 5366,2023-03-11,23:00:00,73,21,52,FMN GV 16 Berchem TOT
54,Posthofbrug 5366,2023-03-12,00:00:00,50,16,34,FMN GV 16 Berchem TOT
54,Posthofbrug 5366,2023-03-12,01:00:00,40,8,32,FMN GV 16 Berchem TOT
54,Posthofbrug 5366,2023-03-12,02:00:00,43,13,30,FMN GV 16 Berchem TOT
54,Posthofbrug 5366,2023-03-12,03:00:00,27,3,24,FMN GV 16 Berchem TOT
54,Posthofbrug 5366,2023-03-12,04:00:00,18,4,14,FMN GV 16 Berchem TOT
54,Posthofbrug 5366,2023-03-12,05:00:00,22,9,13,FMN GV 16 Berchem TOT
54,Posthofbrug 5366,2023-03-12,06:00:00,28,19,9,FMN GV 16 Berchem TOT
54,Posthofbrug 5366,2023-03-12,07:00:00,30,21,9,FMN GV 16 Berchem TOT
54,Posthofbrug 5366,2023-03-12,08:00:00,60,31,29,FMN GV 16 Berchem TOT
54,Posthofbrug 5366,2023-03-12,09:00:00,72,41,31,FMN GV 16 Berchem TOT
54,Posthofbrug 5366,2023-03-12,10:00:00,85,50,35,FMN GV 16 Berchem TOT
54,Posthofbrug 5366,2023-03-12,11:00:00,111,61,50,FMN GV 16 Berchem TOT
54,Posthofbrug 5366,2023-03-12,12:00:00,111,68,43,FMN GV 16 Berchem TOT
54,Posthofbrug 5366,2023-03-12,13:00:00,127,62,65,FMN GV 16 Berchem TOT
54,Posthofbrug 5366,2023-03-12,14:00:00,133,85,48,FMN GV 16 Berchem TOT
54,Posthofbrug 5366,2023-03-12,15:00:00,120,61,59,FMN GV 16 Berchem TOT
54,Posthofbrug 5366,2023-03-12,16:00:00,113,59,54,FMN GV 16 Berchem TOT
54,Posthofbrug 5366,2023-03-12,17:00:00,124,50,74,FMN GV 16 Berchem TOT
54,Posthofbrug 5366,2023-03-12,18:00:00,96,37,59,FMN GV 16 Berchem TOT
54,Posthofbrug 5366,2023-03-12,19:00:00,105,41,64,FMN GV 16 Berchem TOT
54,Posthofbrug 5366,2023-03-12,20:00:00,46,23,23,FMN GV 16 Berchem TOT
54,Posthofbrug 5366,2023-03-12,21:00:00,44,20,24,FMN GV 16 Berchem TOT
54,Posthofbrug 5366,2023-03-12,22:00:00,33,13,20,FMN GV 16 Berchem TOT
54,Posthofbrug 5366,2023-03-12,23:00:00,20,12,8,FMN GV 16 Berchem TOT
54,Posthofbrug 5366,2023-03-13,00:00:00,10,3,7,FMN GV 16 Berchem TOT
54,Posthofbrug 5366,2023-03-13,01:00:00,4,1,3,FMN GV 16 Berchem TOT
54,Posthofbrug 5366,2023-03-13,02:00:00,2,0,2,FMN GV 16 Berchem TOT
54,Posthofbrug 5366,2023-03-13,03:00:00,1,0,1,FMN GV 16 Berchem TOT
54,Posthofbrug 5366,2023-03-13,04:00:00,9,4,5,FMN GV 16 Berchem TOT
54,Posthofbrug 5366,2023-03-13,05:00:00,27,19,8,FMN GV 16 Berchem TOT
54,Posthofbrug 5366,2023-03-13,06:00:00,117,99,18,FMN GV 16 Berchem TOT
54,Posthofbrug 5366,2023-03-13,07:00:00,436,339,97,FMN GV 16 Berchem TOT
54,Posthofbrug 5366,2023-03-13,08:00:00,800,631,169,FMN GV 16 Berchem TOT
54,Posthofbrug 5366,2023-03-13,09:00:00,244,193,51,FMN GV 16 Berchem TOT
54,Posthofbrug 5366,2023-03-13,10:00:00,131,94,37,FMN GV 16 Berchem TOT
54,Posthofbrug 5366,2023-03-13,11:00:00,118,71,47,FMN GV 16 Berchem TOT
54,Posthofbrug 5366,2023-03-13,12:00:00,149,72,77,FMN GV 16 Berchem TOT
54,Posthofbrug 5366,2023-03-13,13:00:00,158,81,77,FMN GV 16 Berchem TOT
54,Posthofbrug 5366,2023-03-13,14:00:00,147,61,86,FMN GV 16 Berchem TOT
54,Posthofbrug 5366,2023-03-13,15:00:00,263,84,179,FMN GV 16 Berchem TOT
54,Posthofbrug 5366,2023-03-13,16:00:00,484,141,343,FMN GV 16 Berchem TOT
54,Posthofbrug 5366,2023-03-13,17:00:00,641,183,458,FMN GV 16 Berchem TOT
54,Posthofbrug 5366,2023-03-13,18:00:00,397,113,284,FMN GV 16 Berchem TOT
54,Posthofbrug 5366,2023-03-13,19:00:00,200,83,117,FMN GV 16 Berchem TOT
54,Posthofbrug 5366,2023-03-13,20:00:00,120,51,69,FMN GV 16 Berchem TOT
54,Posthofbrug 5366,2023-03-13,21:00:00,114,51,63,FMN GV 16 Berchem TOT
54,Posthofbrug 5366,2023-03-13,22:00:00,91,32,59,FMN GV 16 Berchem TOT
54,Posthofbrug 5366,2023-03-13,23:00:00,40,13,27,FMN GV 16 Berchem TOT
54,Posthofbrug 5366,2023-03-14,00:00:00,14,3,11,FMN GV 16 Berchem TOT
54,Posthofbrug 5366,2023-03-14,01:00:00,4,0,4,FMN GV 16 Berchem TOT
54,Posthofbrug 5366,2023-03-14,02:00:00,5,0,5,FMN GV 16 Berchem TOT
54,Posthofbrug 5366,2023-03-14,03:00:00,4,0,4,FMN GV 16 Berchem TOT
54,Posthofbrug 5366,2023-03-14,04:00:00,8,5,3,FMN GV 16 Berchem TOT
54,Posthofbrug 5366,2023-03-14,05:00:00,32,24,8,FMN GV 16 Berchem TOT
54,Posthofbrug 5366,2023-03-14,06:00:00,124,102,22,FMN GV 16 Berchem TOT
54,Posthofbrug 5366,2023-03-14,07:00:00,417,313,104,FMN GV 16 Berchem TOT
54,Posthofbrug 5366,2023-03-14,08:00:00,740,575,165,FMN GV 16 Berchem TOT
54,Posthofbrug 5366,2023-03-14,09:00:00,268,194,74,FMN GV 16 Berchem TOT
54,Posthofbrug 5366,2023-03-14,10:00:00,109,75,34,FMN GV 16 Berchem TOT
54,Posthofbrug 5366,2023-03-14,11:00:00,94,55,39,FMN GV 16 Berchem TOT
54,Posthofbrug 5366,2023-03-14,12:00:00,133,74,59,FMN GV 16 Berchem TOT
54,Posthofbrug 5366,2023-03-14,13:00:00,141,72,69,FMN GV 16 Berchem TOT
54,Posthofbrug 5366,2023-03-14,14:00:00,114,47,67,FMN GV 16 Berchem TOT
54,Posthofbrug 5366,2023-03-14,15:00:00,251,82,169,FMN GV 16 Berchem TOT
54,Posthofbrug 5366,2023-03-14,16:00:00,455,144,311,FMN GV 16 Berchem TOT
54,Posthofbrug 5366,2023-03-14,17:00:00,558,179,379,FMN GV 16 Berchem TOT
54,Posthofbrug 5366,2023-03-14,18:00:00,373,143,230,FMN GV 16 Berchem TOT
54,Posthofbrug 5366,2023-03-14,19:00:00,195,69,126,FMN GV 16 Berchem TOT
54,Posthofbrug 5366,2023-03-14,20:00:00,106,47,59,FMN GV 16 Berchem TOT
54,Posthofbrug 5366,2023-03-14,21:00:00,109,44,65,FMN GV 16 Berchem TOT
54,Posthofbrug 5366,2023-03-14,22:00:00,66,20,46,FMN GV 16 Berchem TOT
54,Posthofbrug 5366,2023-03-14,23:00:00,62,29,33,FMN GV 16 Berchem TOT
54,Posthofbrug 5366,2023-03-15,00:00:00,18,5,13,FMN GV 16 Berchem TOT
54,Posthofbrug 5366,2023-03-15,01:00:00,7,2,5,FMN GV 16 Berchem TOT
54,Posthofbrug 5366,2023-03-15,02:00:00,4,1,3,FMN GV 16 Berchem TOT
54,Posthofbrug 5366,2023-03-15,03:00:00,3,1,2,FMN GV 16 Berchem TOT
54,Posthofbrug 5366,2023-03-15,04:00:00,12,7,5,FMN GV 16 Berchem TOT
54,Posthofbrug 5366,2023-03-15,05:00:00,28,23,5,FMN GV 16 Berchem TOT
54,Posthofbrug 5366,2023-03-15,06:00:00,97,81,16,FMN GV 16 Berchem TOT
54,Posthofbrug 5366,2023-03-15,07:00:00,419,319,100,FMN GV 16 Berchem TOT
54,Posthofbrug 5366,2023-03-15,08:00:00,695,515,180,FMN GV 16 Berchem TOT
54,Posthofbrug 5366,2023-03-15,09:00:00,249,187,62,FMN GV 16 Berchem TOT
54,Posthofbrug 5366,2023-03-15,10:00:00,132,86,46,FMN GV 16 Berchem TOT
54,Posthofbrug 5366,2023-03-15,11:00:00,118,60,58,FMN GV 16 Berchem TOT
54,Posthofbrug 5366,2023-03-15,12:00:00,300,122,178,FMN GV 16 Berchem TOT
54,Posthofbrug 5366,2023-03-15,13:00:00,197,88,109,FMN GV 16 Berchem TOT
54,Posthofbrug 5366,2023-03-15,14:00:00,168,63,105,FMN GV 16 Berchem TOT
54,Posthofbrug 5366,2023-03-15,15:00:00,231,85,146,FMN GV 16 Berchem TOT
54,Posthofbrug 5366,2023-03-15,16:00:00,381,132,249,FMN GV 16 Berchem TOT
54,Posthofbrug 5366,2023-03-15,17:00:00,518,181,337,FMN GV 16 Berchem TOT
54,Posthofbrug 5366,2023-03-15,18:00:00,375,141,234,FMN GV 16 Berchem TOT
54,Posthofbrug 5366,2023-03-15,19:00:00,217,109,108,FMN GV 16 Berchem TOT
54,Posthofbrug 5366,2023-03-15,20:00:00,135,55,80,FMN GV 16 Berchem TOT
54,Posthofbrug 5366,2023-03-15,21:00:00,98,35,63,FMN GV 16 Berchem TOT
54,Posthofbrug 5366,2023-03-15,22:00:00,118,38,80,FMN GV 16 Berchem TOT
54,Posthofbrug 5366,2023-03-15,23:00:00,57,15,42,FMN GV 16 Berchem TOT
54,Posthofbrug 5366,2023-03-16,00:00:00,29,9,20,FMN GV 16 Berchem TOT
54,Posthofbrug 5366,2023-03-16,01:00:00,7,1,6,FMN GV 16 Berchem TOT
54,Posthofbrug 5366,2023-03-16,02:00:00,8,1,7,FMN GV 16 Berchem TOT
54,Posthofbrug 5366,2023-03-16,03:00:00,3,0,3,FMN GV 16 Berchem TOT
54,Posthofbrug 5366,2023-03-16,04:00:00,10,6,4,FMN GV 16 Berchem TOT
54,Posthofbrug 5366,2023-03-16,05:00:00,30,26,4,FMN GV 16 Berchem TOT
54,Posthofbrug 5366,2023-03-16,06:00:00,145,118,27,FMN GV 16 Berchem TOT
54,Posthofbrug 5366,2023-03-16,07:00:00,494,387,107,FMN GV 16 Berchem TOT
54,Posthofbrug 5366,2023-03-16,08:00:00,871,662,209,FMN GV 16 Berchem TOT
54,Posthofbrug 5366,2023-03-16,09:00:00,281,211,70,FMN GV 16 Berchem TOT
54,Posthofbrug 5366,2023-03-16,10:00:00,145,110,35,FMN GV 16 Berchem TOT
54,Posthofbrug 5366,2023-03-16,11:00:00,125,72,53,FMN GV 16 Berchem TOT
54,Posthofbrug 5366,2023-03-16,12:00:00,191,106,85,FMN GV 16 Berchem TOT
54,Posthofbrug 5366,2023-03-16,13:00:00,211,115,96,FMN GV 16 Berchem TOT
54,Posthofbrug 5366,2023-03-16,14:00:00,165,66,99,FMN GV 16 Berchem TOT
54,Posthofbrug 5366,2023-03-16,15:00:00,279,88,191,FMN GV 16 Berchem TOT
54,Posthofbrug 5366,2023-03-16,16:00:00,552,166,386,FMN GV 16 Berchem TOT
54,Posthofbrug 5366,2023-03-16,17:00:00,661,208,453,FMN GV 16 Berchem TOT
54,Posthofbrug 5366,2023-03-16,18:00:00,425,132,293,FMN GV 16 Berchem TOT
54,Posthofbrug 5366,2023-03-16,19:00:00,233,88,145,FMN GV 16 Berchem TOT
54,Posthofbrug 5366,2023-03-16,20:00:00,135,61,74,FMN GV 16 Berchem TOT
54,Posthofbrug 5366,2023-03-16,21:00:00,119,50,69,FMN GV 16 Berchem TOT
54,Posthofbrug 5366,2023-03-16,22:00:00,124,38,86,FMN GV 16 Berchem TOT
54,Posthofbrug 5366,2023-03-16,23:00:00,67,23,44,FMN GV 16 Berchem TOT
54,Posthofbrug 5366,2023-03-17,00:00:00,39,11,28,FMN GV 16 Berchem TOT
54,Posthofbrug 5366,2023-03-17,01:00:00,16,1,15,FMN GV 16 Berchem TOT
54,Posthofbrug 5366,2023-03-17,02:00:00,8,0,8,FMN GV 16 Berchem TOT
54,Posthofbrug 5366,2023-03-17,03:00:00,14,2,12,FMN GV 16 Berchem TOT
54,Posthofbrug 5366,2023-03-17,04:00:00,24,8,16,FMN GV 16 Berchem TOT
54,Posthofbrug 5366,2023-03-17,05:00:00,30,21,9,FMN GV 16 Berchem TOT
54,Posthofbrug 5366,2023-03-17,06:00:00,104,81,23,FMN GV 16 Berchem TOT
54,Posthofbrug 5366,2023-03-17,07:00:00,412,312,100,FMN GV 16 Berchem TOT
54,Posthofbrug 5366,2023-03-17,08:00:00,741,557,184,FMN GV 16 Berchem TOT
54,Posthofbrug 5366,2023-03-17,09:00:00,277,233,44,FMN GV 16 Berchem TOT
54,Posthofbrug 5366,2023-03-17,10:00:00,163,110,53,FMN GV 16 Berchem TOT
54,Posthofbrug 5366,2023-03-17,11:00:00,121,63,58,FMN GV 16 Berchem TOT
54,Posthofbrug 5366,2023-03-17,12:00:00,202,94,108,FMN GV 16 Berchem TOT
54,Posthofbrug 5366,2023-03-17,13:00:00,195,100,95,FMN GV 16 Berchem TOT
54,Posthofbrug 5366,2023-03-17,14:00:00,195,82,113,FMN GV 16 Berchem TOT
54,Posthofbrug 5366,2023-03-17,15:00:00,329,99,230,FMN GV 16 Berchem TOT
54,Posthofbrug 5366,2023-03-17,16:00:00,459,146,313,FMN GV 16 Berchem TOT
54,Posthofbrug 5366,2023-03-17,17:00:00,539,196,343,FMN GV 16 Berchem TOT
54,Posthofbrug 5366,2023-03-17,18:00:00,331,139,192,FMN GV 16 Berchem TOT
54,Posthofbrug 5366,2023-03-17,19:00:00,241,130,111,FMN GV 16 Berchem TOT
54,Posthofbrug 5366,2023-03-17,20:00:00,114,72,42,FMN GV 16 Berchem TOT
54,Posthofbrug 5366,2023-03-17,21:00:00,88,37,51,FMN GV 16 Berchem TOT
54,Posthofbrug 5366,2023-03-17,22:00:00,108,42,66,FMN GV 16 Berchem TOT
54,Posthofbrug 5366,2023-03-17,23:00:00,111,32,79,FMN GV 16 Berchem TOT
54,Posthofbrug 5366,2023-03-18,00:00:00,79,30,49,FMN GV 16 Berchem TOT
54,Posthofbrug 5366,2023-03-18,01:00:00,64,20,44,FMN GV 16 Berchem TOT
54,Posthofbrug 5366,2023-03-18,02:00:00,34,6,28,FMN GV 16 Berchem TOT
54,Posthofbrug 5366,2023-03-18,03:00:00,27,6,21,FMN GV 16 Berchem TOT
54,Posthofbrug 5366,2023-03-18,04:00:00,31,6,25,FMN GV 16 Berchem TOT
54,Posthofbrug 5366,2023-03-18,05:00:00,20,6,14,FMN GV 16 Berchem TOT
54,Posthofbrug 5366,2023-03-18,06:00:00,23,15,8,FMN GV 16 Berchem TOT
54,Posthofbrug 5366,2023-03-18,07:00:00,57,32,25,FMN GV 16 Berchem TOT
54,Posthofbrug 5366,2023-03-18,08:00:00,92,61,31,FMN GV 16 Berchem TOT
54,Posthofbrug 5366,2023-03-18,09:00:00,178,117,61,FMN GV 16 Berchem TOT
54,Posthofbrug 5366,2023-03-18,10:00:00,175,129,46,FMN GV 16 Berchem TOT
54,Posthofbrug 5366,2023-03-18,11:00:00,180,97,83,FMN GV 16 Berchem TOT
54,Posthofbrug 5366,2023-03-18,12:00:00,174,93,81,FMN GV 16 Berchem TOT
54,Posthofbrug 5366,2023-03-18,13:00:00,193,102,91,FMN GV 16 Berchem TOT
54,Posthofbrug 5366,2023-03-18,14:00:00,201,118,83,FMN GV 16 Berchem TOT
54,Posthofbrug 5366,2023-03-18,15:00:00,169,82,87,FMN GV 16 Berchem TOT
54,Posthofbrug 5366,2023-03-18,16:00:00,200,77,123,FMN GV 16 Berchem TOT
54,Posthofbrug 5366,2023-03-18,17:00:00,217,101,116,FMN GV 16 Berchem TOT
54,Posthofbrug 5366,2023-03-18,18:00:00,160,74,86,FMN GV 16 Berchem TOT
54,Posthofbrug 5366,2023-03-18,19:00:00,112,51,61,FMN GV 16 Berchem TOT
54,Posthofbrug 5366,2023-03-18,20:00:00,70,33,37,FMN GV 16 Berchem TOT
54,Posthofbrug 5366,2023-03-18,21:00:00,79,42,37,FMN GV 16 Berchem TOT
54,Posthofbrug 5366,2023-03-18,22:00:00,56,27,29,FMN GV 16 Berchem TOT
54,Posthofbrug 5366,2023-03-18,23:00:00,84,27,57,FMN GV 16 Berchem TOT
54,Posthofbrug 5366,2023-03-19,00:00:00,66,29,37,FMN GV 16 Berchem TOT
54,Posthofbrug 5366,2023-03-19,01:00:00,63,25,38,FMN GV 16 Berchem TOT
54,Posthofbrug 5366,2023-03-19,02:00:00,32,3,29,FMN GV 16 Berchem TOT
54,Posthofbrug 5366,2023-03-19,03:00:00,29,6,23,FMN GV 16 Berchem TOT
54,Posthofbrug 5366,2023-03-19,04:00:00,13,2,11,FMN GV 16 Berchem TOT
54,Posthofbrug 5366,2023-03-19,05:00:00,17,10,7,FMN GV 16 Berchem TOT
54,Posthofbrug 5366,2023-03-19,06:00:00,27,20,7,FMN GV 16 Berchem TOT
54,Posthofbrug 5366,2023-03-19,07:00:00,35,20,15,FMN GV 16 Berchem TOT
54,Posthofbrug 5366,2023-03-19,08:00:00,71,41,30,FMN GV 16 Berchem TOT
54,Posthofbrug 5366,2023-03-19,09:00:00,128,81,47,FMN GV 16 Berchem TOT
54,Posthofbrug 5366,2023-03-19,10:00:00,164,104,60,FMN GV 16 Berchem TOT
54,Posthofbrug 5366,2023-03-19,11:00:00,147,83,64,FMN GV 16 Berchem TOT
54,Posthofbrug 5366,2023-03-19,12:00:00,152,86,66,FMN GV 16 Berchem TOT
54,Posthofbrug 5366,2023-03-19,13:00:00,189,109,80,FMN GV 16 Berchem TOT
54,Posthofbrug 5366,2023-03-19,14:00:00,187,115,72,FMN GV 16 Berchem TOT
54,Posthofbrug 5366,2023-03-19,15:00:00,141,56,85,FMN GV 16 Berchem TOT
54,Posthofbrug 5366,2023-03-19,16:00:00,176,69,107,FMN GV 16 Berchem TOT
54,Posthofbrug 5366,2023-03-19,17:00:00,129,55,74,FMN GV 16 Berchem TOT
54,Posthofbrug 5366,2023-03-19,18:00:00,119,57,62,FMN GV 16 Berchem TOT
54,Posthofbrug 5366,2023-03-19,19:00:00,97,40,57,FMN GV 16 Berchem TOT
54,Posthofbrug 5366,2023-03-19,20:00:00,66,31,35,FMN GV 16 Berchem TOT
54,Posthofbrug 5366,2023-03-19,21:00:00,76,35,41,FMN GV 16 Berchem TOT
54,Posthofbrug 5366,2023-03-19,22:00:00,49,24,25,FMN GV 16 Berchem TOT
54,Posthofbrug 5366,2023-03-19,23:00:00,32,11,21,FMN GV 16 Berchem TOT
54,Posthofbrug 5366,2023-03-20,00:00:00,2,0,2,FMN GV 16 Berchem TOT
54,Posthofbrug 5366,2023-03-20,01:00:00,7,1,6,FMN GV 16 Berchem TOT
54,Posthofbrug 5366,2023-03-20,02:00:00,3,0,3,FMN GV 16 Berchem TOT
54,Posthofbrug 5366,2023-03-20,03:00:00,3,1,2,FMN GV 16 Berchem TOT
54,Posthofbrug 5366,2023-03-20,04:00:00,12,7,5,FMN GV 16 Berchem TOT
54,Posthofbrug 5366,2023-03-20,05:00:00,26,20,6,FMN GV 16 Berchem TOT
54,Posthofbrug 5366,2023-03-20,06:00:00,137,109,28,FMN GV 16 Berchem TOT
54,Posthofbrug 5366,2023-03-20,07:00:00,497,383,114,FMN GV 16 Berchem TOT
54,Posthofbrug 5366,2023-03-20,08:00:00,895,711,184,FMN GV 16 Berchem TOT
54,Posthofbrug 5366,2023-03-20,09:00:00,270,194,76,FMN GV 16 Berchem TOT
54,Posthofbrug 5366,2023-03-20,10:00:00,120,87,33,FMN GV 16 Berchem TOT
54,Posthofbrug 5366,2023-03-20,11:00:00,126,83,43,FMN GV 16 Berchem TOT
54,Posthofbrug 5366,2023-03-20,12:00:00,180,101,79,FMN GV 16 Berchem TOT
54,Posthofbrug 5366,2023-03-20,13:00:00,168,89,79,FMN GV 16 Berchem TOT
54,Posthofbrug 5366,2023-03-20,14:00:00,162,68,94,FMN GV 16 Berchem TOT
54,Posthofbrug 5366,2023-03-20,15:00:00,226,77,149,FMN GV 16 Berchem TOT
54,Posthofbrug 5366,2023-03-20,16:00:00,498,126,372,FMN GV 16 Berchem TOT
54,Posthofbrug 5366,2023-03-20,17:00:00,668,182,486,FMN GV 16 Berchem TOT
54,Posthofbrug 5366,2023-03-20,18:00:00,390,106,284,FMN GV 16 Berchem TOT
54,Posthofbrug 5366,2023-03-20,19:00:00,173,72,101,FMN GV 16 Berchem TOT
54,Posthofbrug 5366,2023-03-20,20:00:00,106,40,66,FMN GV 16 Berchem TOT
54,Posthofbrug 5366,2023-03-20,21:00:00,116,34,82,FMN GV 16 Berchem TOT
54,Posthofbrug 5366,2023-03-20,22:00:00,92,41,51,FMN GV 16 Berchem TOT
54,Posthofbrug 5366,2023-03-20,23:00:00,52,13,39,FMN GV 16 Berchem TOT
54,Posthofbrug 5366,2023-03-21,00:00:00,6,1,5,FMN GV 16 Berchem TOT
54,Posthofbrug 5366,2023-03-21,01:00:00,7,0,7,FMN GV 16 Berchem TOT
54,Posthofbrug 5366,2023-03-21,02:00:00,4,1,3,FMN GV 16 Berchem TOT
54,Posthofbrug 5366,2023-03-21,03:00:00,3,1,2,FMN GV 16 Berchem TOT
54,Posthofbrug 5366,2023-03-21,04:00:00,12,6,6,FMN GV 16 Berchem TOT
54,Posthofbrug 5366,2023-03-21,05:00:00,38,30,8,FMN GV 16 Berchem TOT
54,Posthofbrug 5366,2023-03-21,06:00:00,128,102,26,FMN GV 16 Berchem TOT
54,Posthofbrug 5366,2023-03-21,07:00:00,444,339,105,FMN GV 16 Berchem TOT
54,Posthofbrug 5366,2023-03-21,08:00:00,881,706,175,FMN GV 16 Berchem TOT
54,Posthofbrug 5366,2023-03-21,09:00:00,300,217,83,FMN GV 16 Berchem TOT
54,Posthofbrug 5366,2023-03-21,10:00:00,132,90,42,FMN GV 16 Berchem TOT
54,Posthofbrug 5366,2023-03-21,11:00:00,124,78,46,FMN GV 16 Berchem TOT
54,Posthofbrug 5366,2023-03-21,12:00:00,183,96,87,FMN GV 16 Berchem TOT
54,Posthofbrug 5366,2023-03-21,13:00:00,177,95,82,FMN GV 16 Berchem TOT
54,Posthofbrug 5366,2023-03-21,14:00:00,183,76,107,FMN GV 16 Berchem TOT
54,Posthofbrug 5366,2023-03-21,15:00:00,259,93,166,FMN GV 16 Berchem TOT
54,Posthofbrug 5366,2023-03-21,16:00:00,497,156,341,FMN GV 16 Berchem TOT
54,Posthofbrug 5366,2023-03-21,17:00:00,657,188,469,FMN GV 16 Berchem TOT
54,Posthofbrug 5366,2023-03-21,18:00:00,428,158,270,FMN GV 16 Berchem TOT
54,Posthofbrug 5366,2023-03-21,19:00:00,177,81,96,FMN GV 16 Berchem TOT
54,Posthofbrug 5366,2023-03-21,20:00:00,100,45,55,FMN GV 16 Berchem TOT
54,Posthofbrug 5366,2023-03-21,21:00:00,113,48,65,FMN GV 16 Berchem TOT
54,Posthofbrug 5366,2023-03-21,22:00:00,108,27,81,FMN GV 16 Berchem TOT
54,Posthofbrug 5366,2023-03-21,23:00:00,56,16,40,FMN GV 16 Berchem TOT
54,Posthofbrug 5366,2023-03-22,00:00:00,25,3,22,FMN GV 16 Berchem TOT
54,Posthofbrug 5366,2023-03-22,01:00:00,6,2,4,FMN GV 16 Berchem TOT
54,Posthofbrug 5366,2023-03-22,02:00:00,3,0,3,FMN GV 16 Berchem TOT
54,Posthofbrug 5366,2023-03-22,03:00:00,3,0,3,FMN GV 16 Berchem TOT
54,Posthofbrug 5366,2023-03-22,04:00:00,11,5,6,FMN GV 16 Berchem TOT
54,Posthofbrug 5366,2023-03-22,05:00:00,23,19,4,FMN GV 16 Berchem TOT
54,Posthofbrug 5366,2023-03-22,06:00:00,106,88,18,FMN GV 16 Berchem TOT
54,Posthofbrug 5366,2023-03-22,07:00:00,428,323,105,FMN GV 16 Berchem TOT
54,Posthofbrug 5366,2023-03-22,08:00:00,711,524,187,FMN GV 16 Berchem TOT
54,Posthofbrug 5366,2023-03-22,09:00:00,253,181,72,FMN GV 16 Berchem TOT
54,Posthofbrug 5366,2023-03-22,10:00:00,146,82,64,FMN GV 16 Berchem TOT
54,Posthofbrug 5366,2023-03-22,11:00:00,111,58,53,FMN GV 16 Berchem TOT
54,Posthofbrug 5366,2023-03-22,12:00:00,274,122,152,FMN GV 16 Berchem TOT
54,Posthofbrug 5366,2023-03-22,13:00:00,190,74,116,FMN GV 16 Berchem TOT
54,Posthofbrug 5366,2023-03-22,14:00:00,178,87,91,FMN GV 16 Berchem TOT
54,Posthofbrug 5366,2023-03-22,15:00:00,182,65,117,FMN GV 16 Berchem TOT
54,Posthofbrug 5366,2023-03-22,16:00:00,326,116,210,FMN GV 16 Berchem TOT
54,Posthofbrug 5366,2023-03-22,17:00:00,506,147,359,FMN GV 16 Berchem TOT
54,Posthofbrug 5366,2023-03-22,18:00:00,339,115,224,FMN GV 16 Berchem TOT
54,Posthofbrug 5366,2023-03-22,19:00:00,155,62,93,FMN GV 16 Berchem TOT
54,Posthofbrug 5366,2023-03-22,20:00:00,88,38,50,FMN GV 16 Berchem TOT
54,Posthofbrug 5366,2023-03-22,21:00:00,86,37,49,FMN GV 16 Berchem TOT
54,Posthofbrug 5366,2023-03-22,22:00:00,88,34,54,FMN GV 16 Berchem TOT
54,Posthofbrug 5366,2023-03-22,23:00:00,48,19,29,FMN GV 16 Berchem TOT
54,Posthofbrug 5366,2023-03-23,00:00:00,14,2,12,FMN GV 16 Berchem TOT
54,Posthofbrug 5366,2023-03-23,01:00:00,11,2,9,FMN GV 16 Berchem TOT
54,Posthofbrug 5366,2023-03-23,02:00:00,5,1,4,FMN GV 16 Berchem TOT
54,Posthofbrug 5366,2023-03-23,03:00:00,3,0,3,FMN GV 16 Berchem TOT
54,Posthofbrug 5366,2023-03-23,04:00:00,10,7,3,FMN GV 16 Berchem TOT
54,Posthofbrug 5366,2023-03-23,05:00:00,33,27,6,FMN GV 16 Berchem TOT
54,Posthofbrug 5366,2023-03-23,06:00:00,130,99,31,FMN GV 16 Berchem TOT
54,Posthofbrug 5366,2023-03-23,07:00:00,339,254,85,FMN GV 16 Berchem TOT
54,Posthofbrug 5366,2023-03-23,08:00:00,728,578,150,FMN GV 16 Berchem TOT
54,Posthofbrug 5366,2023-03-23,09:00:00,267,214,53,FMN GV 16 Berchem TOT
54,Posthofbrug 5366,2023-03-23,10:00:00,130,91,39,FMN GV 16 Berchem TOT
54,Posthofbrug 5366,2023-03-23,11:00:00,103,69,34,FMN GV 16 Berchem TOT
54,Posthofbrug 5366,2023-03-23,12:00:00,192,92,100,FMN GV 16 Berchem TOT
54,Posthofbrug 5366,2023-03-23,13:00:00,160,89,71,FMN GV 16 Berchem TOT
54,Posthofbrug 5366,2023-03-23,14:00:00,129,38,91,FMN GV 16 Berchem TOT
54,Posthofbrug 5366,2023-03-23,15:00:00,217,85,132,FMN GV 16 Berchem TOT
54,Posthofbrug 5366,2023-03-23,16:00:00,456,129,327,FMN GV 16 Berchem TOT
54,Posthofbrug 5366,2023-03-23,17:00:00,522,160,362,FMN GV 16 Berchem TOT
54,Posthofbrug 5366,2023-03-23,18:00:00,371,131,240,FMN GV 16 Berchem TOT
54,Posthofbrug 5366,2023-03-23,19:00:00,204,91,113,FMN GV 16 Berchem TOT
54,Posthofbrug 5366,2023-03-23,20:00:00,121,62,59,FMN GV 16 Berchem TOT
54,Posthofbrug 5366,2023-03-23,21:00:00,100,32,68,FMN GV 16 Berchem TOT
54,Posthofbrug 5366,2023-03-23,22:00:00,119,45,74,FMN GV 16 Berchem TOT
54,Posthofbrug 5366,2023-03-23,23:00:00,73,24,49,FMN GV 16 Berchem TOT
54,Posthofbrug 5366,2023-03-24,00:00:00,44,17,27,FMN GV 16 Berchem TOT
54,Posthofbrug 5366,2023-03-24,01:00:00,11,1,10,FMN GV 16 Berchem TOT
54,Posthofbrug 5366,2023-03-24,02:00:00,11,3,8,FMN GV 16 Berchem TOT
54,Posthofbrug 5366,2023-03-24,03:00:00,7,0,7,FMN GV 16 Berchem TOT
54,Posthofbrug 5366,2023-03-24,04:00:00,30,8,22,FMN GV 16 Berchem TOT
54,Posthofbrug 5366,2023-03-24,05:00:00,32,15,17,FMN GV 16 Berchem TOT
54,Posthofbrug 5366,2023-03-24,06:00:00,109,82,27,FMN GV 16 Berchem TOT
54,Posthofbrug 5366,2023-03-24,07:00:00,364,274,90,FMN GV 16 Berchem TOT
54,Posthofbrug 5366,2023-03-24,08:00:00,674,525,149,FMN GV 16 Berchem TOT
54,Posthofbrug 5366,2023-03-24,09:00:00,272,214,58,FMN GV 16 Berchem TOT
54,Posthofbrug 5366,2023-03-24,10:00:00,167,119,48,FMN GV 16 Berchem TOT
54,Posthofbrug 5366,2023-03-24,11:00:00,122,76,46,FMN GV 16 Berchem TOT
54,Posthofbrug 5366,2023-03-24,12:00:00,174,80,94,FMN GV 16 Berchem TOT
54,Posthofbrug 5366,2023-03-24,13:00:00,181,82,99,FMN GV 16 Berchem TOT
54,Posthofbrug 5366,2023-03-24,14:00:00,142,61,81,FMN GV 16 Berchem TOT
54,Posthofbrug 5366,2023-03-24,15:00:00,252,62,190,FMN GV 16 Berchem TOT
54,Posthofbrug 5366,2023-03-24,16:00:00,399,113,286,FMN GV 16 Berchem TOT
54,Posthofbrug 5366,2023-03-24,17:00:00,440,140,300,FMN GV 16 Berchem TOT
54,Posthofbrug 5366,2023-03-24,18:00:00,280,114,166,FMN GV 16 Berchem TOT
54,Posthofbrug 5366,2023-03-24,19:00:00,167,83,84,FMN GV 16 Berchem TOT
54,Posthofbrug 5366,2023-03-24,20:00:00,183,117,66,FMN GV 16 Berchem TOT
54,Posthofbrug 5366,2023-03-24,21:00:00,75,30,45,FMN GV 16 Berchem TOT
54,Posthofbrug 5366,2023-03-24,22:00:00,103,27,76,FMN GV 16 Berchem TOT
54,Posthofbrug 5366,2023-03-24,23:00:00,91,37,54,FMN GV 16 Berchem TOT
54,Posthofbrug 5366,2023-03-25,00:00:00,0,0,0,FMN GV 16 Berchem TOT
54,Posthofbrug 5366,2023-03-25,01:00:00,52,8,44,FMN GV 16 Berchem TOT
54,Posthofbrug 5366,2023-03-25,02:00:00,28,12,16,FMN GV 16 Berchem TOT
54,Posthofbrug 5366,2023-03-25,03:00:00,28,6,22,FMN GV 16 Berchem TOT
54,Posthofbrug 5366,2023-03-25,04:00:00,36,6,30,FMN GV 16 Berchem TOT
54,Posthofbrug 5366,2023-03-25,05:00:00,20,4,16,FMN GV 16 Berchem TOT
54,Posthofbrug 5366,2023-03-25,06:00:00,23,11,12,FMN GV 16 Berchem TOT
54,Posthofbrug 5366,2023-03-25,07:00:00,41,20,21,FMN GV 16 Berchem TOT
54,Posthofbrug 5366,2023-03-25,08:00:00,79,54,25,FMN GV 16 Berchem TOT
54,Posthofbrug 5366,2023-03-25,09:00:00,107,68,39,FMN GV 16 Berchem TOT
54,Posthofbrug 5366,2023-03-25,10:00:00,126,86,40,FMN GV 16 Berchem TOT
54,Posthofbrug 5366,2023-03-25,11:00:00,153,95,58,FMN GV 16 Berchem TOT
54,Posthofbrug 5366,2023-03-25,12:00:00,127,64,63,FMN GV 16 Berchem TOT
54,Posthofbrug 5366,2023-03-25,13:00:00,128,57,71,FMN GV 16 Berchem TOT
54,Posthofbrug 5366,2023-03-25,14:00:00,139,81,58,FMN GV 16 Berchem TOT
54,Posthofbrug 5366,2023-03-25,15:00:00,105,55,50,FMN GV 16 Berchem TOT
54,Posthofbrug 5366,2023-03-25,16:00:00,126,64,62,FMN GV 16 Berchem TOT
54,Posthofbrug 5366,2023-03-25,17:00:00,133,69,64,FMN GV 16 Berchem TOT
54,Posthofbrug 5366,2023-03-25,18:00:00,135,70,65,FMN GV 16 Berchem TOT
54,Posthofbrug 5366,2023-03-25,19:00:00,112,60,52,FMN GV 16 Berchem TOT
54,Posthofbrug 5366,2023-03-25,20:00:00,75,41,34,FMN GV 16 Berchem TOT
54,Posthofbrug 5366,2023-03-25,21:00:00,51,18,33,FMN GV 16 Berchem TOT
54,Posthofbrug 5366,2023-03-25,22:00:00,75,27,48,FMN GV 16 Berchem TOT
54,Posthofbrug 5366,2023-03-25,23:00:00,81,28,53,FMN GV 16 Berchem TOT
54,Posthofbrug 5366,2023-03-26,00:00:00,56,21,35,FMN GV 16 Berchem TOT
54,Posthofbrug 5366,2023-03-26,01:00:00,33,13,20,FMN GV 16 Berchem TOT
54,Posthofbrug 5366,2023-03-26,02:00:00,0,0,0,FMN GV 16 Berchem TOT
54,Posthofbrug 5366,2023-03-26,03:00:00,35,21,14,FMN GV 16 Berchem TOT
54,Posthofbrug 5366,2023-03-26,04:00:00,23,10,13,FMN GV 16 Berchem TOT
54,Posthofbrug 5366,2023-03-26,05:00:00,17,5,12,FMN GV 16 Berchem TOT
54,Posthofbrug 5366,2023-03-26,06:00:00,32,16,16,FMN GV 16 Berchem TOT
54,Posthofbrug 5366,2023-03-26,07:00:00,34,21,13,FMN GV 16 Berchem TOT
54,Posthofbrug 5366,2023-03-26,08:00:00,25,17,8,FMN GV 16 Berchem TOT
54,Posthofbrug 5366,2023-03-26,09:00:00,51,27,24,FMN GV 16 Berchem TOT
54,Posthofbrug 5366,2023-03-26,10:00:00,54,30,24,FMN GV 16 Berchem TOT
54,Posthofbrug 5366,2023-03-26,11:00:00,68,38,30,FMN GV 16 Berchem TOT
54,Posthofbrug 5366,2023-03-26,12:00:00,53,31,22,FMN GV 16 Berchem TOT
54,Posthofbrug 5366,2023-03-26,13:00:00,62,26,36,FMN GV 16 Berchem TOT
54,Posthofbrug 5366,2023-03-26,14:00:00,87,54,33,FMN GV 16 Berchem TOT
54,Posthofbrug 5366,2023-03-26,15:00:00,79,33,46,FMN GV 16 Berchem TOT
54,Posthofbrug 5366,2023-03-26,16:00:00,84,44,40,FMN GV 16 Berchem TOT
54,Posthofbrug 5366,2023-03-26,17:00:00,103,43,60,FMN GV 16 Berchem TOT
54,Posthofbrug 5366,2023-03-26,18:00:00,87,41,46,FMN GV 16 Berchem TOT
54,Posthofbrug 5366,2023-03-26,19:00:00,75,42,33,FMN GV 16 Berchem TOT
54,Posthofbrug 5366,2023-03-26,20:00:00,57,23,34,FMN GV 16 Berchem TOT
54,Posthofbrug 5366,2023-03-26,21:00:00,52,29,23,FMN GV 16 Berchem TOT
54,Posthofbrug 5366,2023-03-26,22:00:00,43,22,21,FMN GV 16 Berchem TOT
54,Posthofbrug 5366,2023-03-26,23:00:00,29,5,24,FMN GV 16 Berchem TOT
54,Posthofbrug 5366,2023-03-27,00:00:00,12,4,8,FMN GV 16 Berchem TOT
54,Posthofbrug 5366,2023-03-27,01:00:00,4,2,2,FMN GV 16 Berchem TOT
54,Posthofbrug 5366,2023-03-27,02:00:00,2,1,1,FMN GV 16 Berchem TOT
54,Posthofbrug 5366,2023-03-27,03:00:00,3,0,3,FMN GV 16 Berchem TOT
54,Posthofbrug 5366,2023-03-27,04:00:00,5,1,4,FMN GV 16 Berchem TOT
54,Posthofbrug 5366,2023-03-27,05:00:00,28,21,7,FMN GV 16 Berchem TOT
54,Posthofbrug 5366,2023-03-27,06:00:00,116,92,24,FMN GV 16 Berchem TOT
54,Posthofbrug 5366,2023-03-27,07:00:00,390,302,88,FMN GV 16 Berchem TOT
54,Posthofbrug 5366,2023-03-27,08:00:00,833,672,161,FMN GV 16 Berchem TOT
54,Posthofbrug 5366,2023-03-27,09:00:00,260,208,52,FMN GV 16 Berchem TOT
54,Posthofbrug 5366,2023-03-27,10:00:00,137,97,40,FMN GV 16 Berchem TOT
54,Posthofbrug 5366,2023-03-27,11:00:00,112,77,35,FMN GV 16 Berchem TOT
54,Posthofbrug 5366,2023-03-27,12:00:00,192,96,96,FMN GV 16 Berchem TOT
54,Posthofbrug 5366,2023-03-27,13:00:00,138,72,66,FMN GV 16 Berchem TOT
54,Posthofbrug 5366,2023-03-27,14:00:00,153,67,86,FMN GV 16 Berchem TOT
54,Posthofbrug 5366,2023-03-27,15:00:00,249,83,166,FMN GV 16 Berchem TOT
54,Posthofbrug 5366,2023-03-27,16:00:00,491,138,353,FMN GV 16 Berchem TOT
54,Posthofbrug 5366,2023-03-27,17:00:00,581,170,411,FMN GV 16 Berchem TOT
54,Posthofbrug 5366,2023-03-27,18:00:00,380,105,275,FMN GV 16 Berchem TOT
54,Posthofbrug 5366,2023-03-27,19:00:00,151,67,84,FMN GV 16 Berchem TOT
54,Posthofbrug 5366,2023-03-27,20:00:00,112,46,66,FMN GV 16 Berchem TOT
54,Posthofbrug 5366,2023-03-27,21:00:00,100,43,57,FMN GV 16 Berchem TOT
54,Posthofbrug 5366,2023-03-27,22:00:00,63,21,42,FMN GV 16 Berchem TOT
54,Posthofbrug 5366,2023-03-27,23:00:00,44,17,27,FMN GV 16 Berchem TOT
54,Posthofbrug 5366,2023-03-28,00:00:00,25,6,19,FMN GV 16 Berchem TOT
54,Posthofbrug 5366,2023-03-28,01:00:00,7,3,4,FMN GV 16 Berchem TOT
54,Posthofbrug 5366,2023-03-28,02:00:00,6,2,4,FMN GV 16 Berchem TOT
54,Posthofbrug 5366,2023-03-28,03:00:00,4,0,4,FMN GV 16 Berchem TOT
54,Posthofbrug 5366,2023-03-28,04:00:00,8,5,3,FMN GV 16 Berchem TOT
54,Posthofbrug 5366,2023-03-28,05:00:00,28,22,6,FMN GV 16 Berchem TOT
54,Posthofbrug 5366,2023-03-28,06:00:00,122,98,24,FMN GV 16 Berchem TOT
54,Posthofbrug 5366,2023-03-28,07:00:00,478,363,115,FMN GV 16 Berchem TOT
54,Posthofbrug 5366,2023-03-28,08:00:00,885,690,195,FMN GV 16 Berchem TOT
54,Posthofbrug 5366,2023-03-28,09:00:00,323,240,83,FMN GV 16 Berchem TOT
54,Posthofbrug 5366,2023-03-28,10:00:00,152,109,43,FMN GV 16 Berchem TOT
54,Posthofbrug 5366,2023-03-28,11:00:00,144,84,60,FMN GV 16 Berchem TOT
54,Posthofbrug 5366,2023-03-28,12:00:00,193,100,93,FMN GV 16 Berchem TOT
54,Posthofbrug 5366,2023-03-28,13:00:00,170,94,76,FMN GV 16 Berchem TOT
54,Posthofbrug 5366,2023-03-28,14:00:00,161,70,91,FMN GV 16 Berchem TOT
54,Posthofbrug 5366,2023-03-28,15:00:00,273,97,176,FMN GV 16 Berchem TOT
54,Posthofbrug 5366,2023-03-28,16:00:00,508,150,358,FMN GV 16 Berchem TOT
54,Posthofbrug 5366,2023-03-28,17:00:00,674,181,493,FMN GV 16 Berchem TOT
54,Posthofbrug 5366,2023-03-28,18:00:00,429,140,289,FMN GV 16 Berchem TOT
54,Posthofbrug 5366,2023-03-28,19:00:00,175,68,107,FMN GV 16 Berchem TOT
54,Posthofbrug 5366,2023-03-28,20:00:00,117,46,71,FMN GV 16 Berchem TOT
54,Posthofbrug 5366,2023-03-28,21:00:00,109,41,68,FMN GV 16 Berchem TOT
54,Posthofbrug 5366,2023-03-28,22:00:00,83,20,63,FMN GV 16 Berchem TOT
54,Posthofbrug 5366,2023-03-28,23:00:00,66,17,49,FMN GV 16 Berchem TOT
54,Posthofbrug 5366,2023-03-29,00:00:00,26,9,17,FMN GV 16 Berchem TOT
54,Posthofbrug 5366,2023-03-29,01:00:00,10,3,7,FMN GV 16 Berchem TOT
54,Posthofbrug 5366,2023-03-29,02:00:00,3,0,3,FMN GV 16 Berchem TOT
54,Posthofbrug 5366,2023-03-29,03:00:00,1,0,1,FMN GV 16 Berchem TOT
54,Posthofbrug 5366,2023-03-29,04:00:00,12,9,3,FMN GV 16 Berchem TOT
54,Posthofbrug 5366,2023-03-29,05:00:00,28,24,4,FMN GV 16 Berchem TOT
54,Posthofbrug 5366,2023-03-29,06:00:00,122,98,24,FMN GV 16 Berchem TOT
54,Posthofbrug 5366,2023-03-29,07:00:00,410,321,89,FMN GV 16 Berchem TOT
54,Posthofbrug 5366,2023-03-29,08:00:00,713,525,188,FMN GV 16 Berchem TOT
54,Posthofbrug 5366,2023-03-29,09:00:00,261,190,71,FMN GV 16 Berchem TOT
54,Posthofbrug 5366,2023-03-29,10:00:00,161,104,57,FMN GV 16 Berchem TOT
54,Posthofbrug 5366,2023-03-29,11:00:00,151,85,66,FMN GV 16 Berchem TOT
54,Posthofbrug 5366,2023-03-29,12:00:00,330,150,180,FMN GV 16 Berchem TOT
54,Posthofbrug 5366,2023-03-29,13:00:00,243,110,133,FMN GV 16 Berchem TOT
54,Posthofbrug 5366,2023-03-29,14:00:00,218,101,117,FMN GV 16 Berchem TOT
54,Posthofbrug 5366,2023-03-29,15:00:00,238,83,155,FMN GV 16 Berchem TOT
54,Posthofbrug 5366,2023-03-29,16:00:00,376,155,221,FMN GV 16 Berchem TOT
54,Posthofbrug 5366,2023-03-29,17:00:00,591,196,395,FMN GV 16 Berchem TOT
54,Posthofbrug 5366,2023-03-29,18:00:00,421,163,258,FMN GV 16 Berchem TOT
54,Posthofbrug 5366,2023-03-29,19:00:00,220,94,126,FMN GV 16 Berchem TOT
54,Posthofbrug 5366,2023-03-29,20:00:00,129,77,52,FMN GV 16 Berchem TOT
54,Posthofbrug 5366,2023-03-29,21:00:00,142,61,81,FMN GV 16 Berchem TOT
54,Posthofbrug 5366,2023-03-29,22:00:00,109,30,79,FMN GV 16 Berchem TOT
54,Posthofbrug 5366,2023-03-29,23:00:00,89,31,58,FMN GV 16 Berchem TOT
54,Posthofbrug 5366,2023-03-30,00:00:00,34,9,25,FMN GV 16 Berchem TOT
54,Posthofbrug 5366,2023-03-30,01:00:00,23,7,16,FMN GV 16 Berchem TOT
54,Posthofbrug 5366,2023-03-30,02:00:00,14,0,14,FMN GV 16 Berchem TOT
54,Posthofbrug 5366,2023-03-30,03:00:00,19,2,17,FMN GV 16 Berchem TOT
54,Posthofbrug 5366,2023-03-30,04:00:00,13,6,7,FMN GV 16 Berchem TOT
54,Posthofbrug 5366,2023-03-30,05:00:00,32,27,5,FMN GV 16 Berchem TOT
54,Posthofbrug 5366,2023-03-30,06:00:00,120,101,19,FMN GV 16 Berchem TOT
54,Posthofbrug 5366,2023-03-30,07:00:00,437,348,89,FMN GV 16 Berchem TOT
54,Posthofbrug 5366,2023-03-30,08:00:00,835,641,194,FMN GV 16 Berchem TOT
54,Posthofbrug 5366,2023-03-30,09:00:00,305,239,66,FMN GV 16 Berchem TOT
54,Posthofbrug 5366,2023-03-30,10:00:00,143,92,51,FMN GV 16 Berchem TOT
54,Posthofbrug 5366,2023-03-30,11:00:00,132,88,44,FMN GV 16 Berchem TOT
54,Posthofbrug 5366,2023-03-30,12:00:00,158,76,82,FMN GV 16 Berchem TOT
54,Posthofbrug 5366,2023-03-30,13:00:00,153,83,70,FMN GV 16 Berchem TOT
54,Posthofbrug 5366,2023-03-30,14:00:00,162,64,98,FMN GV 16 Berchem TOT
54,Posthofbrug 5366,2023-03-30,15:00:00,242,85,157,FMN GV 16 Berchem TOT
54,Posthofbrug 5366,2023-03-30,16:00:00,442,132,310,FMN GV 16 Berchem TOT
54,Posthofbrug 5366,2023-03-30,17:00:00,579,165,414,FMN GV 16 Berchem TOT
54,Posthofbrug 5366,2023-03-30,18:00:00,427,137,290,FMN GV 16 Berchem TOT
54,Posthofbrug 5366,2023-03-30,19:00:00,239,98,141,FMN GV 16 Berchem TOT
54,Posthofbrug 5366,2023-03-30,20:00:00,136,54,82,FMN GV 16 Berchem TOT
54,Posthofbrug 5366,2023-03-30,21:00:00,142,58,84,FMN GV 16 Berchem TOT
54,Posthofbrug 5366,2023-03-30,22:00:00,129,43,86,FMN GV 16 Berchem TOT
54,Posthofbrug 5366,2023-03-30,23:00:00,88,20,68,FMN GV 16 Berchem TOT
54,Posthofbrug 5366,2023-03-31,00:00:00,48,4,44,FMN GV 16 Berchem TOT
54,Posthofbrug 5366,2023-03-31,01:00:00,26,6,20,FMN GV 16 Berchem TOT
54,Posthofbrug 5366,2023-03-31,02:00:00,9,1,8,FMN GV 16 Berchem TOT
54,Posthofbrug 5366,2023-03-31,03:00:00,10,1,9,FMN GV 16 Berchem TOT
54,Posthofbrug 5366,2023-03-31,04:00:00,7,4,3,FMN GV 16 Berchem TOT
54,Posthofbrug 5366,2023-03-31,05:00:00,15,12,3,FMN GV 16 Berchem TOT
54,Posthofbrug 5366,2023-03-31,06:00:00,64,49,15,FMN GV 16 Berchem TOT
54,Posthofbrug 5366,2023-03-31,07:00:00,247,194,53,FMN GV 16 Berchem TOT
54,Posthofbrug 5366,2023-03-31,08:00:00,519,388,131,FMN GV 16 Berchem TOT
54,Posthofbrug 5366,2023-03-31,09:00:00,182,144,38,FMN GV 16 Berchem TOT
54,Posthofbrug 5366,2023-03-31,10:00:00,96,68,28,FMN GV 16 Berchem TOT
54,Posthofbrug 5366,2023-03-31,11:00:00,108,72,36,FMN GV 16 Berchem TOT
54,Posthofbrug 5366,2023-03-31,12:00:00,140,63,77,FMN GV 16 Berchem TOT
54,Posthofbrug 5366,2023-03-31,13:00:00,136,64,72,FMN GV 16 Berchem TOT
54,Posthofbrug 5366,2023-03-31,14:00:00,143,48,95,FMN GV 16 Berchem TOT
54,Posthofbrug 5366,2023-03-31,15:00:00,196,54,142,FMN GV 16 Berchem TOT
54,Posthofbrug 5366,2023-03-31,16:00:00,263,71,192,FMN GV 16 Berchem TOT
54,Posthofbrug 5366,2023-03-31,17:00:00,337,126,211,FMN GV 16 Berchem TOT
54,Posthofbrug 5366,2023-03-31,18:00:00,248,113,135,FMN GV 16 Berchem TOT
54,Posthofbrug 5366,2023-03-31,19:00:00,165,91,74,FMN GV 16 Berchem TOT
54,Posthofbrug 5366,2023-03-31,20:00:00,97,55,42,FMN GV 16 Berchem TOT
54,Posthofbrug 5366,2023-03-31,21:00:00,74,27,47,FMN GV 16 Berchem TOT
54,Posthofbrug 5366,2023-03-31,22:00:00,83,27,56,FMN GV 16 Berchem TOT
54,Posthofbrug 5366,2023-03-31,23:00:00,88,16,72,FMN GV 16 Berchem TOT
54,Posthofbrug 5366,2023-04-01,00:00:00,73,32,41,FMN GV 16 Berchem TOT
54,Posthofbrug 5366,2023-04-01,01:00:00,57,22,35,FMN GV 16 Berchem TOT
54,Posthofbrug 5366,2023-04-01,02:00:00,28,10,18,FMN GV 16 Berchem TOT
54,Posthofbrug 5366,2023-04-01,03:00:00,21,3,18,FMN GV 16 Berchem TOT
54,Posthofbrug 5366,2023-04-01,04:00:00,27,4,23,FMN GV 16 Berchem TOT
54,Posthofbrug 5366,2023-04-01,05:00:00,15,8,7,FMN GV 16 Berchem TOT
54,Posthofbrug 5366,2023-04-01,06:00:00,23,16,7,FMN GV 16 Berchem TOT
54,Posthofbrug 5366,2023-04-01,07:00:00,25,18,7,FMN GV 16 Berchem TOT
54,Posthofbrug 5366,2023-04-01,08:00:00,33,17,16,FMN GV 16 Berchem TOT
54,Posthofbrug 5366,2023-04-01,09:00:00,57,37,20,FMN GV 16 Berchem TOT
54,Posthofbrug 5366,2023-04-01,10:00:00,68,50,18,FMN GV 16 Berchem TOT
54,Posthofbrug 5366,2023-04-01,11:00:00,68,44,24,FMN GV 16 Berchem TOT
54,Posthofbrug 5366,2023-04-01,12:00:00,50,28,22,FMN GV 16 Berchem TOT
54,Posthofbrug 5366,2023-04-01,13:00:00,93,53,40,FMN GV 16 Berchem TOT
54,Posthofbrug 5366,2023-04-01,14:00:00,85,49,36,FMN GV 16 Berchem TOT
54,Posthofbrug 5366,2023-04-01,15:00:00,59,26,33,FMN GV 16 Berchem TOT
54,Posthofbrug 5366,2023-04-01,16:00:00,68,34,34,FMN GV 16 Berchem TOT
54,Posthofbrug 5366,2023-04-01,17:00:00,80,34,46,FMN GV 16 Berchem TOT
54,Posthofbrug 5366,2023-04-01,18:00:00,96,47,49,FMN GV 16 Berchem TOT
54,Posthofbrug 5366,2023-04-01,19:00:00,65,35,30,FMN GV 16 Berchem TOT
54,Posthofbrug 5366,2023-04-01,20:00:00,54,32,22,FMN GV 16 Berchem TOT
54,Posthofbrug 5366,2023-04-01,21:00:00,48,31,17,FMN GV 16 Berchem TOT
54,Posthofbrug 5366,2023-04-01,22:00:00,69,31,38,FMN GV 16 Berchem TOT
54,Posthofbrug 5366,2023-04-01,23:00:00,70,24,46,FMN GV 16 Berchem TOT
54,Posthofbrug 5366,2023-04-02,00:00:00,54,27,27,FMN GV 16 Berchem TOT
54,Posthofbrug 5366,2023-04-02,01:00:00,44,17,27,FMN GV 16 Berchem TOT
54,Posthofbrug 5366,2023-04-02,02:00:00,20,6,14,FMN GV 16 Berchem TOT
54,Posthofbrug 5366,2023-04-02,03:00:00,17,5,12,FMN GV 16 Berchem TOT
54,Posthofbrug 5366,2023-04-02,04:00:00,10,1,9,FMN GV 16 Berchem TOT
54,Posthofbrug 5366,2023-04-02,05:00:00,20,6,14,FMN GV 16 Berchem TOT
54,Posthofbrug 5366,2023-04-02,06:00:00,24,9,15,FMN GV 16 Berchem TOT
54,Posthofbrug 5366,2023-04-02,07:00:00,15,9,6,FMN GV 16 Berchem TOT
54,Posthofbrug 5366,2023-04-02,08:00:00,61,27,34,FMN GV 16 Berchem TOT
54,Posthofbrug 5366,2023-04-02,09:00:00,101,64,37,FMN GV 16 Berchem TOT
54,Posthofbrug 5366,2023-04-02,10:00:00,140,90,50,FMN GV 16 Berchem TOT
54,Posthofbrug 5366,2023-04-02,11:00:00,128,71,57,FMN GV 16 Berchem TOT
54,Posthofbrug 5366,2023-04-02,12:00:00,156,80,76,FMN GV 16 Berchem TOT
54,Posthofbrug 5366,2023-04-02,13:00:00,133,75,58,FMN GV 16 Berchem TOT
54,Posthofbrug 5366,2023-04-02,14:00:00,142,80,62,FMN GV 16 Berchem TOT
54,Posthofbrug 5366,2023-04-02,15:00:00,104,62,42,FMN GV 16 Berchem TOT
54,Posthofbrug 5366,2023-04-02,16:00:00,107,50,57,FMN GV 16 Berchem TOT
54,Posthofbrug 5366,2023-04-02,17:00:00,133,47,86,FMN GV 16 Berchem TOT
54,Posthofbrug 5366,2023-04-02,18:00:00,111,49,62,FMN GV 16 Berchem TOT
54,Posthofbrug 5366,2023-04-02,19:00:00,74,48,26,FMN GV 16 Berchem TOT
54,Posthofbrug 5366,2023-04-02,20:00:00,81,47,34,FMN GV 16 Berchem TOT
54,Posthofbrug 5366,2023-04-02,21:00:00,66,25,41,FMN GV 16 Berchem TOT
54,Posthofbrug 5366,2023-04-02,22:00:00,56,21,35,FMN GV 16 Berchem TOT
54,Posthofbrug 5366,2023-04-02,23:00:00,35,10,25,FMN GV 16 Berchem TOT
54,Posthofbrug 5366,2023-04-03,00:00:00,22,3,19,FMN GV 16 Berchem TOT
54,Posthofbrug 5366,2023-04-03,01:00:00,6,2,4,FMN GV 16 Berchem TOT
54,Posthofbrug 5366,2023-04-03,02:00:00,6,1,5,FMN GV 16 Berchem TOT
54,Posthofbrug 5366,2023-04-03,03:00:00,2,1,1,FMN GV 16 Berchem TOT
54,Posthofbrug 5366,2023-04-03,04:00:00,8,5,3,FMN GV 16 Berchem TOT
54,Posthofbrug 5366,2023-04-03,05:00:00,18,13,5,FMN GV 16 Berchem TOT
54,Posthofbrug 5366,2023-04-03,06:00:00,113,92,21,FMN GV 16 Berchem TOT
54,Posthofbrug 5366,2023-04-03,07:00:00,301,222,79,FMN GV 16 Berchem TOT
54,Posthofbrug 5366,2023-04-03,08:00:00,501,360,141,FMN GV 16 Berchem TOT
54,Posthofbrug 5366,2023-04-03,09:00:00,266,203,63,FMN GV 16 Berchem TOT
54,Posthofbrug 5366,2023-04-03,10:00:00,124,79,45,FMN GV 16 Berchem TOT
54,Posthofbrug 5366,2023-04-03,11:00:00,106,80,26,FMN GV 16 Berchem TOT
54,Posthofbrug 5366,2023-04-03,12:00:00,150,89,61,FMN GV 16 Berchem TOT
54,Posthofbrug 5366,2023-04-03,13:00:00,135,70,65,FMN GV 16 Berchem TOT
54,Posthofbrug 5366,2023-04-03,14:00:00,147,62,85,FMN GV 16 Berchem TOT
54,Posthofbrug 5366,2023-04-03,15:00:00,183,69,114,FMN GV 16 Berchem TOT
54,Posthofbrug 5366,2023-04-03,16:00:00,376,139,237,FMN GV 16 Berchem TOT
54,Posthofbrug 5366,2023-04-03,17:00:00,537,174,363,FMN GV 16 Berchem TOT
54,Posthofbrug 5366,2023-04-03,18:00:00,367,129,238,FMN GV 16 Berchem TOT
54,Posthofbrug 5366,2023-04-03,19:00:00,137,54,83,FMN GV 16 Berchem TOT
54,Posthofbrug 5366,2023-04-03,20:00:00,110,56,54,FMN GV 16 Berchem TOT
54,Posthofbrug 5366,2023-04-03,21:00:00,81,32,49,FMN GV 16 Berchem TOT
54,Posthofbrug 5366,2023-04-03,22:00:00,92,34,58,FMN GV 16 Berchem TOT
54,Posthofbrug 5366,2023-04-03,23:00:00,37,11,26,FMN GV 16 Berchem TOT
54,Posthofbrug 5366,2023-04-04,00:00:00,18,3,15,FMN GV 16 Berchem TOT
54,Posthofbrug 5366,2023-04-04,01:00:00,9,5,4,FMN GV 16 Berchem TOT
54,Posthofbrug 5366,2023-04-04,02:00:00,6,3,3,FMN GV 16 Berchem TOT
54,Posthofbrug 5366,2023-04-04,03:00:00,4,1,3,FMN GV 16 Berchem TOT
54,Posthofbrug 5366,2023-04-04,04:00:00,8,5,3,FMN GV 16 Berchem TOT
54,Posthofbrug 5366,2023-04-04,05:00:00,30,27,3,FMN GV 16 Berchem TOT
54,Posthofbrug 5366,2023-04-04,06:00:00,113,87,26,FMN GV 16 Berchem TOT
54,Posthofbrug 5366,2023-04-04,07:00:00,340,245,95,FMN GV 16 Berchem TOT
54,Posthofbrug 5366,2023-04-04,08:00:00,579,417,162,FMN GV 16 Berchem TOT
54,Posthofbrug 5366,2023-04-04,09:00:00,266,201,65,FMN GV 16 Berchem TOT
54,Posthofbrug 5366,2023-04-04,10:00:00,99,67,32,FMN GV 16 Berchem TOT
54,Posthofbrug 5366,2023-04-04,11:00:00,113,71,42,FMN GV 16 Berchem TOT
54,Posthofbrug 5366,2023-04-04,12:00:00,155,71,84,FMN GV 16 Berchem TOT
54,Posthofbrug 5366,2023-04-04,13:00:00,154,81,73,FMN GV 16 Berchem TOT
54,Posthofbrug 5366,2023-04-04,14:00:00,142,74,68,FMN GV 16 Berchem TOT
54,Posthofbrug 5366,2023-04-04,15:00:00,191,73,118,FMN GV 16 Berchem TOT
54,Posthofbrug 5366,2023-04-04,16:00:00,384,153,231,FMN GV 16 Berchem TOT
54,Posthofbrug 5366,2023-04-04,17:00:00,574,174,400,FMN GV 16 Berchem TOT
54,Posthofbrug 5366,2023-04-04,18:00:00,366,131,235,FMN GV 16 Berchem TOT
54,Posthofbrug 5366,2023-04-04,19:00:00,159,66,93,FMN GV 16 Berchem TOT
54,Posthofbrug 5366,2023-04-04,20:00:00,81,41,40,FMN GV 16 Berchem TOT
54,Posthofbrug 5366,2023-04-04,21:00:00,81,43,38,FMN GV 16 Berchem TOT
54,Posthofbrug 5366,2023-04-04,22:00:00,84,27,57,FMN GV 16 Berchem TOT
54,Posthofbrug 5366,2023-04-04,23:00:00,56,9,47,FMN GV 16 Berchem TOT
54,Posthofbrug 5366,2023-04-05,00:00:00,23,4,19,FMN GV 16 Berchem TOT
54,Posthofbrug 5366,2023-04-05,01:00:00,9,3,6,FMN GV 16 Berchem TOT
54,Posthofbrug 5366,2023-04-05,02:00:00,7,1,6,FMN GV 16 Berchem TOT
54,Posthofbrug 5366,2023-04-05,03:00:00,1,1,0,FMN GV 16 Berchem TOT
54,Posthofbrug 5366,2023-04-05,04:00:00,12,5,7,FMN GV 16 Berchem TOT
54,Posthofbrug 5366,2023-04-05,05:00:00,25,20,5,FMN GV 16 Berchem TOT
54,Posthofbrug 5366,2023-04-05,06:00:00,109,79,30,FMN GV 16 Berchem TOT
54,Posthofbrug 5366,2023-04-05,07:00:00,265,185,80,FMN GV 16 Berchem TOT
54,Posthofbrug 5366,2023-04-05,08:00:00,493,345,148,FMN GV 16 Berchem TOT
54,Posthofbrug 5366,2023-04-05,09:00:00,225,164,61,FMN GV 16 Berchem TOT
54,Posthofbrug 5366,2023-04-05,10:00:00,124,79,45,FMN GV 16 Berchem TOT
54,Posthofbrug 5366,2023-04-05,11:00:00,122,63,59,FMN GV 16 Berchem TOT
54,Posthofbrug 5366,2023-04-05,12:00:00,161,85,76,FMN GV 16 Berchem TOT
54,Posthofbrug 5366,2023-04-05,13:00:00,157,85,72,FMN GV 16 Berchem TOT
54,Posthofbrug 5366,2023-04-05,14:00:00,143,84,59,FMN GV 16 Berchem TOT
54,Posthofbrug 5366,2023-04-05,15:00:00,209,69,140,FMN GV 16 Berchem TOT
54,Posthofbrug 5366,2023-04-05,16:00:00,324,130,194,FMN GV 16 Berchem TOT
54,Posthofbrug 5366,2023-04-05,17:00:00,475,163,312,FMN GV 16 Berchem TOT
54,Posthofbrug 5366,2023-04-05,18:00:00,372,134,238,FMN GV 16 Berchem TOT
54,Posthofbrug 5366,2023-04-05,19:00:00,182,93,89,FMN GV 16 Berchem TOT
54,Posthofbrug 5366,2023-04-05,20:00:00,134,79,55,FMN GV 16 Berchem TOT
54,Posthofbrug 5366,2023-04-05,21:00:00,114,56,58,FMN GV 16 Berchem TOT
54,Posthofbrug 5366,2023-04-05,22:00:00,89,35,54,FMN GV 16 Berchem TOT
54,Posthofbrug 5366,2023-04-05,23:00:00,54,13,41,FMN GV 16 Berchem TOT
54,Posthofbrug 5366,2023-04-06,00:00:00,41,10,31,FMN GV 16 Berchem TOT
54,Posthofbrug 5366,2023-04-06,01:00:00,11,4,7,FMN GV 16 Berchem TOT
54,Posthofbrug 5366,2023-04-06,02:00:00,11,3,8,FMN GV 16 Berchem TOT
54,Posthofbrug 5366,2023-04-06,03:00:00,4,0,4,FMN GV 16 Berchem TOT
54,Posthofbrug 5366,2023-04-06,04:00:00,10,8,2,FMN GV 16 Berchem TOT
54,Posthofbrug 5366,2023-04-06,05:00:00,24,17,7,FMN GV 16 Berchem TOT
54,Posthofbrug 5366,2023-04-06,06:00:00,100,80,20,FMN GV 16 Berchem TOT
54,Posthofbrug 5366,2023-04-06,07:00:00,268,191,77,FMN GV 16 Berchem TOT
54,Posthofbrug 5366,2023-04-06,08:00:00,475,353,122,FMN GV 16 Berchem TOT
54,Posthofbrug 5366,2023-04-06,09:00:00,182,137,45,FMN GV 16 Berchem TOT
54,Posthofbrug 5366,2023-04-06,10:00:00,78,57,21,FMN GV 16 Berchem TOT
54,Posthofbrug 5366,2023-04-06,11:00:00,60,31,29,FMN GV 16 Berchem TOT
54,Posthofbrug 5366,2023-04-06,12:00:00,73,39,34,FMN GV 16 Berchem TOT
54,Posthofbrug 5366,2023-04-06,13:00:00,79,39,40,FMN GV 16 Berchem TOT
54,Posthofbrug 5366,2023-04-06,14:00:00,70,36,34,FMN GV 16 Berchem TOT
54,Posthofbrug 5366,2023-04-06,15:00:00,101,26,75,FMN GV 16 Berchem TOT
54,Posthofbrug 5366,2023-04-06,16:00:00,265,110,155,FMN GV 16 Berchem TOT
54,Posthofbrug 5366,2023-04-06,17:00:00,384,123,261,FMN GV 16 Berchem TOT
54,Posthofbrug 5366,2023-04-06,18:00:00,265,94,171,FMN GV 16 Berchem TOT
54,Posthofbrug 5366,2023-04-06,19:00:00,124,43,81,FMN GV 16 Berchem TOT
54,Posthofbrug 5366,2023-04-06,20:00:00,73,33,40,FMN GV 16 Berchem TOT
54,Posthofbrug 5366,2023-04-06,21:00:00,55,24,31,FMN GV 16 Berchem TOT
54,Posthofbrug 5366,2023-04-06,22:00:00,71,28,43,FMN GV 16 Berchem TOT
54,Posthofbrug 5366,2023-04-06,23:00:00,54,15,39,FMN GV 16 Berchem TOT
54,Posthofbrug 5366,2023-04-07,00:00:00,30,16,14,FMN GV 16 Berchem TOT
54,Posthofbrug 5366,2023-04-07,01:00:00,15,3,12,FMN GV 16 Berchem TOT
54,Posthofbrug 5366,2023-04-07,02:00:00,7,0,7,FMN GV 16 Berchem TOT
54,Posthofbrug 5366,2023-04-07,03:00:00,13,3,10,FMN GV 16 Berchem TOT
54,Posthofbrug 5366,2023-04-07,04:00:00,21,7,14,FMN GV 16 Berchem TOT
54,Posthofbrug 5366,2023-04-07,05:00:00,15,8,7,FMN GV 16 Berchem TOT
54,Posthofbrug 5366,2023-04-07,06:00:00,62,42,20,FMN GV 16 Berchem TOT
54,Posthofbrug 5366,2023-04-07,07:00:00,192,131,61,FMN GV 16 Berchem TOT
54,Posthofbrug 5366,2023-04-07,08:00:00,324,226,98,FMN GV 16 Berchem TOT
54,Posthofbrug 5366,2023-04-07,09:00:00,172,135,37,FMN GV 16 Berchem TOT
54,Posthofbrug 5366,2023-04-07,10:00:00,104,64,40,FMN GV 16 Berchem TOT
54,Posthofbrug 5366,2023-04-07,11:00:00,118,68,50,FMN GV 16 Berchem TOT
54,Posthofbrug 5366,2023-04-07,12:00:00,149,88,61,FMN GV 16 Berchem TOT
54,Posthofbrug 5366,2023-04-07,13:00:00,142,76,66,FMN GV 16 Berchem TOT
54,Posthofbrug 5366,2023-04-07,14:00:00,134,72,62,FMN GV 16 Berchem TOT
54,Posthofbrug 5366,2023-04-07,15:00:00,171,70,101,FMN GV 16 Berchem TOT
54,Posthofbrug 5366,2023-04-07,16:00:00,265,102,163,FMN GV 16 Berchem TOT
54,Posthofbrug 5366,2023-04-07,17:00:00,332,136,196,FMN GV 16 Berchem TOT
54,Posthofbrug 5366,2023-04-07,18:00:00,193,99,94,FMN GV 16 Berchem TOT
54,Posthofbrug 5366,2023-04-07,19:00:00,171,105,66,FMN GV 16 Berchem TOT
54,Posthofbrug 5366,2023-04-07,20:00:00,103,45,58,FMN GV 16 Berchem TOT
54,Posthofbrug 5366,2023-04-07,21:00:00,87,46,41,FMN GV 16 Berchem TOT
54,Posthofbrug 5366,2023-04-07,22:00:00,63,21,42,FMN GV 16 Berchem TOT
54,Posthofbrug 5366,2023-04-07,23:00:00,71,26,45,FMN GV 16 Berchem TOT
54,Posthofbrug 5366,2023-04-08,00:00:00,75,9,66,FMN GV 16 Berchem TOT
54,Posthofbrug 5366,2023-04-08,01:00:00,34,4,30,FMN GV 16 Berchem TOT
54,Posthofbrug 5366,2023-04-08,02:00:00,36,3,33,FMN GV 16 Berchem TOT
54,Posthofbrug 5366,2023-04-08,03:00:00,20,6,14,FMN GV 16 Berchem TOT
54,Posthofbrug 5366,2023-04-08,04:00:00,14,3,11,FMN GV 16 Berchem TOT
54,Posthofbrug 5366,2023-04-08,05:00:00,26,8,18,FMN GV 16 Berchem TOT
54,Posthofbrug 5366,2023-04-08,06:00:00,30,19,11,FMN GV 16 Berchem TOT
54,Posthofbrug 5366,2023-04-08,07:00:00,28,18,10,FMN GV 16 Berchem TOT
54,Posthofbrug 5366,2023-04-08,08:00:00,51,38,13,FMN GV 16 Berchem TOT
54,Posthofbrug 5366,2023-04-08,09:00:00,98,69,29,FMN GV 16 Berchem TOT
54,Posthofbrug 5366,2023-04-08,10:00:00,101,74,27,FMN GV 16 Berchem TOT
54,Posthofbrug 5366,2023-04-08,11:00:00,114,75,39,FMN GV 16 Berchem TOT
54,Posthofbrug 5366,2023-04-08,12:00:00,119,70,49,FMN GV 16 Berchem TOT
54,Posthofbrug 5366,2023-04-08,13:00:00,149,90,59,FMN GV 16 Berchem TOT
54,Posthofbrug 5366,2023-04-08,14:00:00,184,118,66,FMN GV 16 Berchem TOT
54,Posthofbrug 5366,2023-04-08,15:00:00,165,95,70,FMN GV 16 Berchem TOT
54,Posthofbrug 5366,2023-04-08,16:00:00,164,63,101,FMN GV 16 Berchem TOT
54,Posthofbrug 5366,2023-04-08,17:00:00,143,60,83,FMN GV 16 Berchem TOT
54,Posthofbrug 5366,2023-04-08,18:00:00,150,63,87,FMN GV 16 Berchem TOT
54,Posthofbrug 5366,2023-04-08,19:00:00,150,81,69,FMN GV 16 Berchem TOT
54,Posthofbrug 5366,2023-04-08,20:00:00,75,40,35,FMN GV 16 Berchem TOT
54,Posthofbrug 5366,2023-04-08,21:00:00,67,28,39,FMN GV 16 Berchem TOT
54,Posthofbrug 5366,2023-04-08,22:00:00,49,25,24,FMN GV 16 Berchem TOT
54,Posthofbrug 5366,2023-04-08,23:00:00,65,19,46,FMN GV 16 Berchem TOT
54,Posthofbrug 5366,2023-04-09,00:00:00,43,13,30,FMN GV 16 Berchem TOT
54,Posthofbrug 5366,2023-04-09,01:00:00,44,10,34,FMN GV 16 Berchem TOT
54,Posthofbrug 5366,2023-04-09,02:00:00,34,5,29,FMN GV 16 Berchem TOT
54,Posthofbrug 5366,2023-04-09,03:00:00,14,3,11,FMN GV 16 Berchem TOT
54,Posthofbrug 5366,2023-04-09,04:00:00,12,2,10,FMN GV 16 Berchem TOT
54,Posthofbrug 5366,2023-04-09,05:00:00,18,5,13,FMN GV 16 Berchem TOT
54,Posthofbrug 5366,2023-04-09,06:00:00,31,25,6,FMN GV 16 Berchem TOT
54,Posthofbrug 5366,2023-04-09,07:00:00,25,15,10,FMN GV 16 Berchem TOT
54,Posthofbrug 5366,2023-04-09,08:00:00,41,18,23,FMN GV 16 Berchem TOT
54,Posthofbrug 5366,2023-04-09,09:00:00,110,63,47,FMN GV 16 Berchem TOT
54,Posthofbrug 5366,2023-04-09,10:00:00,146,81,65,FMN GV 16 Berchem TOT
54,Posthofbrug 5366,2023-04-09,11:00:00,171,94,77,FMN GV 16 Berchem TOT
54,Posthofbrug 5366,2023-04-09,12:00:00,182,90,92,FMN GV 16 Berchem TOT
54,Posthofbrug 5366,2023-04-09,13:00:00,148,77,71,FMN GV 16 Berchem TOT
54,Posthofbrug 5366,2023-04-09,14:00:00,166,81,85,FMN GV 16 Berchem TOT
54,Posthofbrug 5366,2023-04-09,15:00:00,153,78,75,FMN GV 16 Berchem TOT
54,Posthofbrug 5366,2023-04-09,16:00:00,176,103,73,FMN GV 16 Berchem TOT
54,Posthofbrug 5366,2023-04-09,17:00:00,156,86,70,FMN GV 16 Berchem TOT
54,Posthofbrug 5366,2023-04-09,18:00:00,121,51,70,FMN GV 16 Berchem TOT
54,Posthofbrug 5366,2023-04-09,19:00:00,123,79,44,FMN GV 16 Berchem TOT
54,Posthofbrug 5366,2023-04-09,20:00:00,79,37,42,FMN GV 16 Berchem TOT
54,Posthofbrug 5366,2023-04-09,21:00:00,77,44,33,FMN GV 16 Berchem TOT
54,Posthofbrug 5366,2023-04-09,22:00:00,61,29,32,FMN GV 16 Berchem TOT
54,Posthofbrug 5366,2023-04-09,23:00:00,33,7,26,FMN GV 16 Berchem TOT
54,Posthofbrug 5366,2023-04-10,00:00:00,22,10,12,FMN GV 16 Berchem TOT
54,Posthofbrug 5366,2023-04-10,01:00:00,12,3,9,FMN GV 16 Berchem TOT
54,Posthofbrug 5366,2023-04-10,02:00:00,15,4,11,FMN GV 16 Berchem TOT
54,Posthofbrug 5366,2023-04-10,03:00:00,9,2,7,FMN GV 16 Berchem TOT
54,Posthofbrug 5366,2023-04-10,04:00:00,20,10,10,FMN GV 16 Berchem TOT
54,Posthofbrug 5366,2023-04-10,05:00:00,16,12,4,FMN GV 16 Berchem TOT
54,Posthofbrug 5366,2023-04-10,06:00:00,32,20,12,FMN GV 16 Berchem TOT
54,Posthofbrug 5366,2023-04-10,07:00:00,14,13,1,FMN GV 16 Berchem TOT
54,Posthofbrug 5366,2023-04-10,08:00:00,37,20,17,FMN GV 16 Berchem TOT
54,Posthofbrug 5366,2023-04-10,09:00:00,117,68,49,FMN GV 16 Berchem TOT
54,Posthofbrug 5366,2023-04-10,10:00:00,108,55,53,FMN GV 16 Berchem TOT
54,Posthofbrug 5366,2023-04-10,11:00:00,113,70,43,FMN GV 16 Berchem TOT
54,Posthofbrug 5366,2023-04-10,12:00:00,130,70,60,FMN GV 16 Berchem TOT
54,Posthofbrug 5366,2023-04-10,13:00:00,136,68,68,FMN GV 16 Berchem TOT
54,Posthofbrug 5366,2023-04-10,14:00:00,109,45,64,FMN GV 16 Berchem TOT
54,Posthofbrug 5366,2023-04-10,15:00:00,83,44,39,FMN GV 16 Berchem TOT
54,Posthofbrug 5366,2023-04-10,16:00:00,74,38,36,FMN GV 16 Berchem TOT
54,Posthofbrug 5366,2023-04-10,17:00:00,63,24,39,FMN GV 16 Berchem TOT
54,Posthofbrug 5366,2023-04-10,18:00:00,65,33,32,FMN GV 16 Berchem TOT
54,Posthofbrug 5366,2023-04-10,19:00:00,63,31,32,FMN GV 16 Berchem TOT
54,Posthofbrug 5366,2023-04-10,20:00:00,55,33,22,FMN GV 16 Berchem TOT
54,Posthofbrug 5366,2023-04-10,21:00:00,48,22,26,FMN GV 16 Berchem TOT
54,Posthofbrug 5366,2023-04-10,22:00:00,35,12,23,FMN GV 16 Berchem TOT
54,Posthofbrug 5366,2023-04-10,23:00:00,31,12,19,FMN GV 16 Berchem TOT
54,Posthofbrug 5366,2023-04-11,00:00:00,20,7,13,FMN GV 16 Berchem TOT
54,Posthofbrug 5366,2023-04-11,01:00:00,5,3,2,FMN GV 16 Berchem TOT
54,Posthofbrug 5366,2023-04-11,02:00:00,4,1,3,FMN GV 16 Berchem TOT
54,Posthofbrug 5366,2023-04-11,03:00:00,3,3,0,FMN GV 16 Berchem TOT
54,Posthofbrug 5366,2023-04-11,04:00:00,16,10,6,FMN GV 16 Berchem TOT
54,Posthofbrug 5366,2023-04-11,05:00:00,33,28,5,FMN GV 16 Berchem TOT
54,Posthofbrug 5366,2023-04-11,06:00:00,73,48,25,FMN GV 16 Berchem TOT
54,Posthofbrug 5366,2023-04-11,07:00:00,295,212,83,FMN GV 16 Berchem TOT
54,Posthofbrug 5366,2023-04-11,08:00:00,559,414,145,FMN GV 16 Berchem TOT
54,Posthofbrug 5366,2023-04-11,09:00:00,253,184,69,FMN GV 16 Berchem TOT
54,Posthofbrug 5366,2023-04-11,10:00:00,120,81,39,FMN GV 16 Berchem TOT
54,Posthofbrug 5366,2023-04-11,11:00:00,141,74,67,FMN GV 16 Berchem TOT
54,Posthofbrug 5366,2023-04-11,12:00:00,146,77,69,FMN GV 16 Berchem TOT
54,Posthofbrug 5366,2023-04-11,13:00:00,146,73,73,FMN GV 16 Berchem TOT
54,Posthofbrug 5366,2023-04-11,14:00:00,156,64,92,FMN GV 16 Berchem TOT
54,Posthofbrug 5366,2023-04-11,15:00:00,165,76,89,FMN GV 16 Berchem TOT
54,Posthofbrug 5366,2023-04-11,16:00:00,363,137,226,FMN GV 16 Berchem TOT
54,Posthofbrug 5366,2023-04-11,17:00:00,519,187,332,FMN GV 16 Berchem TOT
54,Posthofbrug 5366,2023-04-11,18:00:00,335,112,223,FMN GV 16 Berchem TOT
54,Posthofbrug 5366,2023-04-11,19:00:00,134,59,75,FMN GV 16 Berchem TOT
54,Posthofbrug 5366,2023-04-11,20:00:00,103,53,50,FMN GV 16 Berchem TOT
54,Posthofbrug 5366,2023-04-11,21:00:00,67,23,44,FMN GV 16 Berchem TOT
54,Posthofbrug 5366,2023-04-11,22:00:00,75,29,46,FMN GV 16 Berchem TOT
54,Posthofbrug 5366,2023-04-11,23:00:00,47,15,32,FMN GV 16 Berchem TOT
54,Posthofbrug 5366,2023-04-12,00:00:00,17,6,11,FMN GV 16 Berchem TOT
54,Posthofbrug 5366,2023-04-12,01:00:00,10,3,7,FMN GV 16 Berchem TOT
54,Posthofbrug 5366,2023-04-12,02:00:00,5,0,5,FMN GV 16 Berchem TOT
54,Posthofbrug 5366,2023-04-12,03:00:00,6,2,4,FMN GV 16 Berchem TOT
54,Posthofbrug 5366,2023-04-12,04:00:00,12,7,5,FMN GV 16 Berchem TOT
54,Posthofbrug 5366,2023-04-12,05:00:00,23,19,4,FMN GV 16 Berchem TOT
54,Posthofbrug 5366,2023-04-12,06:00:00,68,47,21,FMN GV 16 Berchem TOT
54,Posthofbrug 5366,2023-04-12,07:00:00,188,134,54,FMN GV 16 Berchem TOT
54,Posthofbrug 5366,2023-04-12,08:00:00,321,241,80,FMN GV 16 Berchem TOT
54,Posthofbrug 5366,2023-04-12,09:00:00,212,141,71,FMN GV 16 Berchem TOT
54,Posthofbrug 5366,2023-04-12,10:00:00,79,54,25,FMN GV 16 Berchem TOT
54,Posthofbrug 5366,2023-04-12,11:00:00,76,50,26,FMN GV 16 Berchem TOT
54,Posthofbrug 5366,2023-04-12,12:00:00,65,36,29,FMN GV 16 Berchem TOT
54,Posthofbrug 5366,2023-04-12,13:00:00,83,39,44,FMN GV 16 Berchem TOT
54,Posthofbrug 5366,2023-04-12,14:00:00,97,50,47,FMN GV 16 Berchem TOT
54,Posthofbrug 5366,2023-04-12,15:00:00,96,42,54,FMN GV 16 Berchem TOT
54,Posthofbrug 5366,2023-04-12,16:00:00,212,75,137,FMN GV 16 Berchem TOT
54,Posthofbrug 5366,2023-04-12,17:00:00,356,131,225,FMN GV 16 Berchem TOT
54,Posthofbrug 5366,2023-04-12,18:00:00,284,108,176,FMN GV 16 Berchem TOT
54,Posthofbrug 5366,2023-04-12,19:00:00,149,56,93,FMN GV 16 Berchem TOT
54,Posthofbrug 5366,2023-04-12,20:00:00,92,49,43,FMN GV 16 Berchem TOT
54,Posthofbrug 5366,2023-04-12,21:00:00,73,41,32,FMN GV 16 Berchem TOT
54,Posthofbrug 5366,2023-04-12,22:00:00,99,28,71,FMN GV 16 Berchem TOT
54,Posthofbrug 5366,2023-04-12,23:00:00,65,19,46,FMN GV 16 Berchem TOT
54,Posthofbrug 5366,2023-04-13,00:00:00,25,3,22,FMN GV 16 Berchem TOT
54,Posthofbrug 5366,2023-04-13,01:00:00,15,3,12,FMN GV 16 Berchem TOT
54,Posthofbrug 5366,2023-04-13,02:00:00,4,2,2,FMN GV 16 Berchem TOT
54,Posthofbrug 5366,2023-04-13,03:00:00,4,1,3,FMN GV 16 Berchem TOT
54,Posthofbrug 5366,2023-04-13,04:00:00,14,10,4,FMN GV 16 Berchem TOT
54,Posthofbrug 5366,2023-04-13,05:00:00,31,27,4,FMN GV 16 Berchem TOT
54,Posthofbrug 5366,2023-04-13,06:00:00,87,65,22,FMN GV 16 Berchem TOT
54,Posthofbrug 5366,2023-04-13,07:00:00,271,209,62,FMN GV 16 Berchem TOT
54,Posthofbrug 5366,2023-04-13,08:00:00,467,340,127,FMN GV 16 Berchem TOT
54,Posthofbrug 5366,2023-04-13,09:00:00,219,161,58,FMN GV 16 Berchem TOT
54,Posthofbrug 5366,2023-04-13,10:00:00,113,83,30,FMN GV 16 Berchem TOT
54,Posthofbrug 5366,2023-04-13,11:00:00,85,57,28,FMN GV 16 Berchem TOT
54,Posthofbrug 5366,2023-04-13,12:00:00,134,71,63,FMN GV 16 Berchem TOT
54,Posthofbrug 5366,2023-04-13,13:00:00,120,74,46,FMN GV 16 Berchem TOT
54,Posthofbrug 5366,2023-04-13,14:00:00,112,57,55,FMN GV 16 Berchem TOT
54,Posthofbrug 5366,2023-04-13,15:00:00,177,88,89,FMN GV 16 Berchem TOT
54,Posthofbrug 5366,2023-04-13,16:00:00,325,124,201,FMN GV 16 Berchem TOT
54,Posthofbrug 5366,2023-04-13,17:00:00,416,135,281,FMN GV 16 Berchem TOT
54,Posthofbrug 5366,2023-04-13,18:00:00,324,124,200,FMN GV 16 Berchem TOT
54,Posthofbrug 5366,2023-04-13,19:00:00,185,69,116,FMN GV 16 Berchem TOT
54,Posthofbrug 5366,2023-04-13,20:00:00,136,71,65,FMN GV 16 Berchem TOT
54,Posthofbrug 5366,2023-04-13,21:00:00,68,30,38,FMN GV 16 Berchem TOT
54,Posthofbrug 5366,2023-04-13,22:00:00,100,43,57,FMN GV 16 Berchem TOT
54,Posthofbrug 5366,2023-04-13,23:00:00,72,21,51,FMN GV 16 Berchem TOT
54,Posthofbrug 5366,2023-04-14,00:00:00,41,11,30,FMN GV 16 Berchem TOT
54,Posthofbrug 5366,2023-04-14,01:00:00,17,6,11,FMN GV 16 Berchem TOT
54,Posthofbrug 5366,2023-04-14,02:00:00,9,2,7,FMN GV 16 Berchem TOT
54,Posthofbrug 5366,2023-04-14,03:00:00,3,1,2,FMN GV 16 Berchem TOT
54,Posthofbrug 5366,2023-04-14,04:00:00,18,14,4,FMN GV 16 Berchem TOT
54,Posthofbrug 5366,2023-04-14,05:00:00,30,25,5,FMN GV 16 Berchem TOT
54,Posthofbrug 5366,2023-04-14,06:00:00,77,62,15,FMN GV 16 Berchem TOT
54,Posthofbrug 5366,2023-04-14,07:00:00,199,145,54,FMN GV 16 Berchem TOT
54,Posthofbrug 5366,2023-04-14,08:00:00,388,283,105,FMN GV 16 Berchem TOT
54,Posthofbrug 5366,2023-04-14,09:00:00,193,150,43,FMN GV 16 Berchem TOT
54,Posthofbrug 5366,2023-04-14,10:00:00,158,110,48,FMN GV 16 Berchem TOT
54,Posthofbrug 5366,2023-04-14,11:00:00,151,94,57,FMN GV 16 Berchem TOT
54,Posthofbrug 5366,2023-04-14,12:00:00,158,88,70,FMN GV 16 Berchem TOT
54,Posthofbrug 5366,2023-04-14,13:00:00,181,80,101,FMN GV 16 Berchem TOT
54,Posthofbrug 5366,2023-04-14,14:00:00,170,67,103,FMN GV 16 Berchem TOT
54,Posthofbrug 5366,2023-04-14,15:00:00,218,91,127,FMN GV 16 Berchem TOT
54,Posthofbrug 5366,2023-04-14,16:00:00,344,140,204,FMN GV 16 Berchem TOT
54,Posthofbrug 5366,2023-04-14,17:00:00,373,117,256,FMN GV 16 Berchem TOT
54,Posthofbrug 5366,2023-04-14,18:00:00,263,117,146,FMN GV 16 Berchem TOT
54,Posthofbrug 5366,2023-04-14,19:00:00,184,97,87,FMN GV 16 Berchem TOT
54,Posthofbrug 5366,2023-04-14,20:00:00,112,73,39,FMN GV 16 Berchem TOT
54,Posthofbrug 5366,2023-04-14,21:00:00,83,40,43,FMN GV 16 Berchem TOT
54,Posthofbrug 5366,2023-04-14,22:00:00,70,27,43,FMN GV 16 Berchem TOT
54,Posthofbrug 5366,2023-04-14,23:00:00,83,19,64,FMN GV 16 Berchem TOT
54,Posthofbrug 5366,2023-04-15,00:00:00,49,15,34,FMN GV 16 Berchem TOT
54,Posthofbrug 5366,2023-04-15,01:00:00,45,13,32,FMN GV 16 Berchem TOT
54,Posthofbrug 5366,2023-04-15,02:00:00,23,9,14,FMN GV 16 Berchem TOT
54,Posthofbrug 5366,2023-04-15,03:00:00,20,4,16,FMN GV 16 Berchem TOT
54,Posthofbrug 5366,2023-04-15,04:00:00,24,5,19,FMN GV 16 Berchem TOT
54,Posthofbrug 5366,2023-04-15,05:00:00,22,11,11,FMN GV 16 Berchem TOT
54,Posthofbrug 5366,2023-04-15,06:00:00,13,6,7,FMN GV 16 Berchem TOT
54,Posthofbrug 5366,2023-04-15,07:00:00,34,22,12,FMN GV 16 Berchem TOT
54,Posthofbrug 5366,2023-04-15,08:00:00,63,37,26,FMN GV 16 Berchem TOT
54,Posthofbrug 5366,2023-04-15,09:00:00,122,77,45,FMN GV 16 Berchem TOT
54,Posthofbrug 5366,2023-04-15,10:00:00,163,110,53,FMN GV 16 Berchem TOT
54,Posthofbrug 5366,2023-04-15,11:00:00,176,121,55,FMN GV 16 Berchem TOT
54,Posthofbrug 5366,2023-04-15,12:00:00,177,101,76,FMN GV 16 Berchem TOT
54,Posthofbrug 5366,2023-04-15,13:00:00,239,140,99,FMN GV 16 Berchem TOT
54,Posthofbrug 5366,2023-04-15,14:00:00,226,134,92,FMN GV 16 Berchem TOT
54,Posthofbrug 5366,2023-04-15,15:00:00,213,114,99,FMN GV 16 Berchem TOT
54,Posthofbrug 5366,2023-04-15,16:00:00,229,97,132,FMN GV 16 Berchem TOT
54,Posthofbrug 5366,2023-04-15,17:00:00,228,113,115,FMN GV 16 Berchem TOT
54,Posthofbrug 5366,2023-04-15,18:00:00,193,82,111,FMN GV 16 Berchem TOT
54,Posthofbrug 5366,2023-04-15,19:00:00,180,88,92,FMN GV 16 Berchem TOT
54,Posthofbrug 5366,2023-04-15,20:00:00,99,56,43,FMN GV 16 Berchem TOT
54,Posthofbrug 5366,2023-04-15,21:00:00,82,42,40,FMN GV 16 Berchem TOT
54,Posthofbrug 5366,2023-04-15,22:00:00,107,49,58,FMN GV 16 Berchem TOT
54,Posthofbrug 5366,2023-04-15,23:00:00,89,38,51,FMN GV 16 Berchem TOT
54,Posthofbrug 5366,2023-04-16,00:00:00,64,12,52,FMN GV 16 Berchem TOT
54,Posthofbrug 5366,2023-04-16,01:00:00,43,10,33,FMN GV 16 Berchem TOT
54,Posthofbrug 5366,2023-04-16,02:00:00,25,10,15,FMN GV 16 Berchem TOT
54,Posthofbrug 5366,2023-04-16,03:00:00,16,3,13,FMN GV 16 Berchem TOT
54,Posthofbrug 5366,2023-04-16,04:00:00,19,2,17,FMN GV 16 Berchem TOT
54,Posthofbrug 5366,2023-04-16,05:00:00,19,9,10,FMN GV 16 Berchem TOT
54,Posthofbrug 5366,2023-04-16,06:00:00,19,13,6,FMN GV 16 Berchem TOT
54,Posthofbrug 5366,2023-04-16,07:00:00,22,15,7,FMN GV 16 Berchem TOT
54,Posthofbrug 5366,2023-04-16,08:00:00,38,25,13,FMN GV 16 Berchem TOT
54,Posthofbrug 5366,2023-04-16,09:00:00,96,43,53,FMN GV 16 Berchem TOT
54,Posthofbrug 5366,2023-04-16,10:00:00,98,65,33,FMN GV 16 Berchem TOT
54,Posthofbrug 5366,2023-04-16,11:00:00,97,49,48,FMN GV 16 Berchem TOT
54,Posthofbrug 5366,2023-04-16,12:00:00,130,66,64,FMN GV 16 Berchem TOT
54,Posthofbrug 5366,2023-04-16,13:00:00,145,80,65,FMN GV 16 Berchem TOT
54,Posthofbrug 5366,2023-04-16,14:00:00,128,67,61,FMN GV 16 Berchem TOT
54,Posthofbrug 5366,2023-04-16,15:00:00,130,64,66,FMN GV 16 Berchem TOT
54,Posthofbrug 5366,2023-04-16,16:00:00,110,48,62,FMN GV 16 Berchem TOT
54,Posthofbrug 5366,2023-04-16,17:00:00,130,65,65,FMN GV 16 Berchem TOT
54,Posthofbrug 5366,2023-04-16,18:00:00,105,54,51,FMN GV 16 Berchem TOT
54,Posthofbrug 5366,2023-04-16,19:00:00,115,63,52,FMN GV 16 Berchem TOT
54,Posthofbrug 5366,2023-04-16,20:00:00,75,39,36,FMN GV 16 Berchem TOT
54,Posthofbrug 5366,2023-04-16,21:00:00,59,22,37,FMN GV 16 Berchem TOT
54,Posthofbrug 5366,2023-04-16,22:00:00,51,19,32,FMN GV 16 Berchem TOT
54,Posthofbrug 5366,2023-04-16,23:00:00,24,9,15,FMN GV 16 Berchem TOT
54,Posthofbrug 5366,2023-04-17,00:00:00,13,4,9,FMN GV 16 Berchem TOT
54,Posthofbrug 5366,2023-04-17,01:00:00,2,0,2,FMN GV 16 Berchem TOT
54,Posthofbrug 5366,2023-04-17,02:00:00,4,1,3,FMN GV 16 Berchem TOT
54,Posthofbrug 5366,2023-04-17,03:00:00,2,0,2,FMN GV 16 Berchem TOT
54,Posthofbrug 5366,2023-04-17,04:00:00,7,3,4,FMN GV 16 Berchem TOT
54,Posthofbrug 5366,2023-04-17,05:00:00,36,31,5,FMN GV 16 Berchem TOT
54,Posthofbrug 5366,2023-04-17,06:00:00,135,105,30,FMN GV 16 Berchem TOT
54,Posthofbrug 5366,2023-04-17,07:00:00,530,406,124,FMN GV 16 Berchem TOT
54,Posthofbrug 5366,2023-04-17,08:00:00,966,731,235,FMN GV 16 Berchem TOT
54,Posthofbrug 5366,2023-04-17,09:00:00,279,226,53,FMN GV 16 Berchem TOT
54,Posthofbrug 5366,2023-04-17,10:00:00,137,95,42,FMN GV 16 Berchem TOT
54,Posthofbrug 5366,2023-04-17,11:00:00,121,83,38,FMN GV 16 Berchem TOT
54,Posthofbrug 5366,2023-04-17,12:00:00,193,105,88,FMN GV 16 Berchem TOT
54,Posthofbrug 5366,2023-04-17,13:00:00,178,96,82,FMN GV 16 Berchem TOT
54,Posthofbrug 5366,2023-04-17,14:00:00,184,75,109,FMN GV 16 Berchem TOT
54,Posthofbrug 5366,2023-04-17,15:00:00,281,77,204,FMN GV 16 Berchem TOT
54,Posthofbrug 5366,2023-04-17,16:00:00,536,161,375,FMN GV 16 Berchem TOT
54,Posthofbrug 5366,2023-04-17,17:00:00,766,214,552,FMN GV 16 Berchem TOT
54,Posthofbrug 5366,2023-04-17,18:00:00,486,159,327,FMN GV 16 Berchem TOT
54,Posthofbrug 5366,2023-04-17,19:00:00,192,71,121,FMN GV 16 Berchem TOT
54,Posthofbrug 5366,2023-04-17,20:00:00,112,52,60,FMN GV 16 Berchem TOT
54,Posthofbrug 5366,2023-04-17,21:00:00,113,49,64,FMN GV 16 Berchem TOT
54,Posthofbrug 5366,2023-04-17,22:00:00,104,47,57,FMN GV 16 Berchem TOT
54,Posthofbrug 5366,2023-04-17,23:00:00,38,10,28,FMN GV 16 Berchem TOT
54,Posthofbrug 5366,2023-04-18,00:00:00,21,5,16,FMN GV 16 Berchem TOT
54,Posthofbrug 5366,2023-04-18,01:00:00,11,4,7,FMN GV 16 Berchem TOT
54,Posthofbrug 5366,2023-04-18,02:00:00,3,1,2,FMN GV 16 Berchem TOT
54,Posthofbrug 5366,2023-04-18,03:00:00,7,3,4,FMN GV 16 Berchem TOT
54,Posthofbrug 5366,2023-04-18,04:00:00,6,2,4,FMN GV 16 Berchem TOT
54,Posthofbrug 5366,2023-04-18,05:00:00,39,29,10,FMN GV 16 Berchem TOT
54,Posthofbrug 5366,2023-04-18,06:00:00,140,101,39,FMN GV 16 Berchem TOT
54,Posthofbrug 5366,2023-04-18,07:00:00,590,457,133,FMN GV 16 Berchem TOT
54,Posthofbrug 5366,2023-04-18,08:00:00,1085,841,244,FMN GV 16 Berchem TOT
54,Posthofbrug 5366,2023-04-18,09:00:00,355,280,75,FMN GV 16 Berchem TOT
54,Posthofbrug 5366,2023-04-18,10:00:00,162,113,49,FMN GV 16 Berchem TOT
54,Posthofbrug 5366,2023-04-18,11:00:00,121,72,49,FMN GV 16 Berchem TOT
54,Posthofbrug 5366,2023-04-18,12:00:00,195,108,87,FMN GV 16 Berchem TOT
54,Posthofbrug 5366,2023-04-18,13:00:00,184,97,87,FMN GV 16 Berchem TOT
54,Posthofbrug 5366,2023-04-18,14:00:00,151,59,92,FMN GV 16 Berchem TOT
54,Posthofbrug 5366,2023-04-18,15:00:00,302,112,190,FMN GV 16 Berchem TOT
54,Posthofbrug 5366,2023-04-18,16:00:00,594,167,427,FMN GV 16 Berchem TOT
54,Posthofbrug 5366,2023-04-18,17:00:00,792,214,578,FMN GV 16 Berchem TOT
54,Posthofbrug 5366,2023-04-18,18:00:00,500,181,319,FMN GV 16 Berchem TOT
54,Posthofbrug 5366,2023-04-18,19:00:00,259,118,141,FMN GV 16 Berchem TOT
54,Posthofbrug 5366,2023-04-18,20:00:00,154,59,95,FMN GV 16 Berchem TOT
54,Posthofbrug 5366,2023-04-18,21:00:00,115,49,66,FMN GV 16 Berchem TOT
54,Posthofbrug 5366,2023-04-18,22:00:00,133,41,92,FMN GV 16 Berchem TOT
54,Posthofbrug 5366,2023-04-18,23:00:00,66,23,43,FMN GV 16 Berchem TOT
54,Posthofbrug 5366,2023-04-19,00:00:00,24,10,14,FMN GV 16 Berchem TOT
54,Posthofbrug 5366,2023-04-19,01:00:00,19,3,16,FMN GV 16 Berchem TOT
54,Posthofbrug 5366,2023-04-19,02:00:00,2,0,2,FMN GV 16 Berchem TOT
54,Posthofbrug 5366,2023-04-19,03:00:00,3,2,1,FMN GV 16 Berchem TOT
54,Posthofbrug 5366,2023-04-19,04:00:00,8,5,3,FMN GV 16 Berchem TOT
54,Posthofbrug 5366,2023-04-19,05:00:00,36,31,5,FMN GV 16 Berchem TOT
54,Posthofbrug 5366,2023-04-19,06:00:00,121,95,26,FMN GV 16 Berchem TOT
54,Posthofbrug 5366,2023-04-19,07:00:00,503,380,123,FMN GV 16 Berchem TOT
54,Posthofbrug 5366,2023-04-19,08:00:00,864,654,210,FMN GV 16 Berchem TOT
54,Posthofbrug 5366,2023-04-19,09:00:00,301,231,70,FMN GV 16 Berchem TOT
54,Posthofbrug 5366,2023-04-19,10:00:00,157,105,52,FMN GV 16 Berchem TOT
54,Posthofbrug 5366,2023-04-19,11:00:00,170,78,92,FMN GV 16 Berchem TOT
54,Posthofbrug 5366,2023-04-19,12:00:00,390,170,220,FMN GV 16 Berchem TOT
54,Posthofbrug 5366,2023-04-19,13:00:00,233,111,122,FMN GV 16 Berchem TOT
54,Posthofbrug 5366,2023-04-19,14:00:00,203,90,113,FMN GV 16 Berchem TOT
54,Posthofbrug 5366,2023-04-19,15:00:00,246,90,156,FMN GV 16 Berchem TOT
54,Posthofbrug 5366,2023-04-19,16:00:00,462,162,300,FMN GV 16 Berchem TOT
54,Posthofbrug 5366,2023-04-19,17:00:00,665,211,454,FMN GV 16 Berchem TOT
54,Posthofbrug 5366,2023-04-19,18:00:00,485,187,298,FMN GV 16 Berchem TOT
54,Posthofbrug 5366,2023-04-19,19:00:00,300,126,174,FMN GV 16 Berchem TOT
54,Posthofbrug 5366,2023-04-19,20:00:00,182,106,76,FMN GV 16 Berchem TOT
54,Posthofbrug 5366,2023-04-19,21:00:00,143,81,62,FMN GV 16 Berchem TOT
54,Posthofbrug 5366,2023-04-19,22:00:00,156,54,102,FMN GV 16 Berchem TOT
54,Posthofbrug 5366,2023-04-19,23:00:00,93,31,62,FMN GV 16 Berchem TOT
54,Posthofbrug 5366,2023-04-20,00:00:00,32,7,25,FMN GV 16 Berchem TOT
54,Posthofbrug 5366,2023-04-20,01:00:00,6,0,6,FMN GV 16 Berchem TOT
54,Posthofbrug 5366,2023-04-20,02:00:00,6,0,6,FMN GV 16 Berchem TOT
54,Posthofbrug 5366,2023-04-20,03:00:00,2,2,0,FMN GV 16 Berchem TOT
54,Posthofbrug 5366,2023-04-20,04:00:00,8,5,3,FMN GV 16 Berchem TOT
54,Posthofbrug 5366,2023-04-20,05:00:00,37,33,4,FMN GV 16 Berchem TOT
54,Posthofbrug 5366,2023-04-20,06:00:00,139,104,35,FMN GV 16 Berchem TOT
54,Posthofbrug 5366,2023-04-20,07:00:00,510,381,129,FMN GV 16 Berchem TOT
54,Posthofbrug 5366,2023-04-20,08:00:00,900,693,207,FMN GV 16 Berchem TOT
54,Posthofbrug 5366,2023-04-20,09:00:00,277,224,53,FMN GV 16 Berchem TOT
54,Posthofbrug 5366,2023-04-20,10:00:00,135,92,43,FMN GV 16 Berchem TOT
54,Posthofbrug 5366,2023-04-20,11:00:00,114,70,44,FMN GV 16 Berchem TOT
54,Posthofbrug 5366,2023-04-20,12:00:00,167,96,71,FMN GV 16 Berchem TOT
54,Posthofbrug 5366,2023-04-20,13:00:00,134,71,63,FMN GV 16 Berchem TOT
54,Posthofbrug 5366,2023-04-20,14:00:00,147,51,96,FMN GV 16 Berchem TOT
54,Posthofbrug 5366,2023-04-20,15:00:00,252,95,157,FMN GV 16 Berchem TOT
54,Posthofbrug 5366,2023-04-20,16:00:00,477,133,344,FMN GV 16 Berchem TOT
54,Posthofbrug 5366,2023-04-20,17:00:00,635,175,460,FMN GV 16 Berchem TOT
54,Posthofbrug 5366,2023-04-20,18:00:00,415,138,277,FMN GV 16 Berchem TOT
54,Posthofbrug 5366,2023-04-20,19:00:00,233,96,137,FMN GV 16 Berchem TOT
54,Posthofbrug 5366,2023-04-20,20:00:00,164,86,78,FMN GV 16 Berchem TOT
54,Posthofbrug 5366,2023-04-20,21:00:00,123,48,75,FMN GV 16 Berchem TOT
54,Posthofbrug 5366,2023-04-20,22:00:00,130,44,86,FMN GV 16 Berchem TOT
54,Posthofbrug 5366,2023-04-20,23:00:00,86,20,66,FMN GV 16 Berchem TOT
54,Posthofbrug 5366,2023-04-21,00:00:00,28,5,23,FMN GV 16 Berchem TOT
54,Posthofbrug 5366,2023-04-21,01:00:00,13,3,10,FMN GV 16 Berchem TOT
54,Posthofbrug 5366,2023-04-21,02:00:00,10,4,6,FMN GV 16 Berchem TOT
54,Posthofbrug 5366,2023-04-21,03:00:00,8,2,6,FMN GV 16 Berchem TOT
54,Posthofbrug 5366,2023-04-21,04:00:00,16,9,7,FMN GV 16 Berchem TOT
54,Posthofbrug 5366,2023-04-21,05:00:00,32,25,7,FMN GV 16 Berchem TOT
54,Posthofbrug 5366,2023-04-21,06:00:00,106,79,27,FMN GV 16 Berchem TOT
54,Posthofbrug 5366,2023-04-21,07:00:00,396,306,90,FMN GV 16 Berchem TOT
54,Posthofbrug 5366,2023-04-21,08:00:00,779,601,178,FMN GV 16 Berchem TOT
54,Posthofbrug 5366,2023-04-21,09:00:00,284,219,65,FMN GV 16 Berchem TOT
54,Posthofbrug 5366,2023-04-21,10:00:00,185,134,51,FMN GV 16 Berchem TOT
54,Posthofbrug 5366,2023-04-21,11:00:00,145,75,70,FMN GV 16 Berchem TOT
54,Posthofbrug 5366,2023-04-21,12:00:00,222,111,111,FMN GV 16 Berchem TOT
54,Posthofbrug 5366,2023-04-21,13:00:00,213,106,107,FMN GV 16 Berchem TOT
54,Posthofbrug 5366,2023-04-21,14:00:00,240,94,146,FMN GV 16 Berchem TOT
54,Posthofbrug 5366,2023-04-21,15:00:00,332,121,211,FMN GV 16 Berchem TOT
54,Posthofbrug 5366,2023-04-21,16:00:00,515,160,355,FMN GV 16 Berchem TOT
54,Posthofbrug 5366,2023-04-21,17:00:00,535,176,359,FMN GV 16 Berchem TOT
54,Posthofbrug 5366,2023-04-21,18:00:00,328,136,192,FMN GV 16 Berchem TOT
54,Posthofbrug 5366,2023-04-21,19:00:00,218,105,113,FMN GV 16 Berchem TOT
54,Posthofbrug 5366,2023-04-21,20:00:00,130,65,65,FMN GV 16 Berchem TOT
54,Posthofbrug 5366,2023-04-21,21:00:00,95,42,53,FMN GV 16 Berchem TOT
54,Posthofbrug 5366,2023-04-21,22:00:00,99,41,58,FMN GV 16 Berchem TOT
54,Posthofbrug 5366,2023-04-21,23:00:00,103,31,72,FMN GV 16 Berchem TOT
54,Posthofbrug 5366,2023-04-22,00:00:00,74,29,45,FMN GV 16 Berchem TOT
54,Posthofbrug 5366,2023-04-22,01:00:00,44,12,32,FMN GV 16 Berchem TOT
54,Posthofbrug 5366,2023-04-22,02:00:00,39,13,26,FMN GV 16 Berchem TOT
54,Posthofbrug 5366,2023-04-22,03:00:00,24,8,16,FMN GV 16 Berchem TOT
54,Posthofbrug 5366,2023-04-22,04:00:00,26,7,19,FMN GV 16 Berchem TOT
54,Posthofbrug 5366,2023-04-22,05:00:00,23,8,15,FMN GV 16 Berchem TOT
54,Posthofbrug 5366,2023-04-22,06:00:00,30,11,19,FMN GV 16 Berchem TOT
54,Posthofbrug 5366,2023-04-22,07:00:00,47,32,15,FMN GV 16 Berchem TOT
54,Posthofbrug 5366,2023-04-22,08:00:00,92,58,34,FMN GV 16 Berchem TOT
54,Posthofbrug 5366,2023-04-22,09:00:00,198,135,63,FMN GV 16 Berchem TOT
54,Posthofbrug 5366,2023-04-22,10:00:00,166,107,59,FMN GV 16 Berchem TOT
54,Posthofbrug 5366,2023-04-22,11:00:00,155,86,69,FMN GV 16 Berchem TOT
54,Posthofbrug 5366,2023-04-22,12:00:00,126,55,71,FMN GV 16 Berchem TOT
54,Posthofbrug 5366,2023-04-22,13:00:00,112,59,53,FMN GV 16 Berchem TOT
54,Posthofbrug 5366,2023-04-22,14:00:00,145,82,63,FMN GV 16 Berchem TOT
54,Posthofbrug 5366,2023-04-22,15:00:00,113,56,57,FMN GV 16 Berchem TOT
54,Posthofbrug 5366,2023-04-22,16:00:00,133,53,80,FMN GV 16 Berchem TOT
54,Posthofbrug 5366,2023-04-22,17:00:00,137,68,69,FMN GV 16 Berchem TOT
54,Posthofbrug 5366,2023-04-22,18:00:00,136,69,67,FMN GV 16 Berchem TOT
54,Posthofbrug 5366,2023-04-22,19:00:00,114,60,54,FMN GV 16 Berchem TOT
54,Posthofbrug 5366,2023-04-22,20:00:00,71,49,22,FMN GV 16 Berchem TOT
54,Posthofbrug 5366,2023-04-22,21:00:00,81,38,43,FMN GV 16 Berchem TOT
54,Posthofbrug 5366,2023-04-22,22:00:00,79,43,36,FMN GV 16 Berchem TOT
54,Posthofbrug 5366,2023-04-22,23:00:00,74,23,51,FMN GV 16 Berchem TOT
54,Posthofbrug 5366,2023-04-23,00:00:00,77,29,48,FMN GV 16 Berchem TOT
54,Posthofbrug 5366,2023-04-23,01:00:00,38,13,25,FMN GV 16 Berchem TOT
54,Posthofbrug 5366,2023-04-23,02:00:00,24,7,17,FMN GV 16 Berchem TOT
54,Posthofbrug 5366,2023-04-23,03:00:00,29,4,25,FMN GV 16 Berchem TOT
54,Posthofbrug 5366,2023-04-23,04:00:00,8,2,6,FMN GV 16 Berchem TOT
54,Posthofbrug 5366,2023-04-23,05:00:00,11,7,4,FMN GV 16 Berchem TOT
54,Posthofbrug 5366,2023-04-23,06:00:00,18,14,4,FMN GV 16 Berchem TOT
54,Posthofbrug 5366,2023-04-23,07:00:00,37,21,16,FMN GV 16 Berchem TOT
54,Posthofbrug 5366,2023-04-23,08:00:00,73,47,26,FMN GV 16 Berchem TOT
54,Posthofbrug 5366,2023-04-23,09:00:00,158,103,55,FMN GV 16 Berchem TOT
54,Posthofbrug 5366,2023-04-23,10:00:00,182,122,60,FMN GV 16 Berchem TOT
54,Posthofbrug 5366,2023-04-23,11:00:00,203,120,83,FMN GV 16 Berchem TOT
54,Posthofbrug 5366,2023-04-23,12:00:00,281,202,79,FMN GV 16 Berchem TOT
54,Posthofbrug 5366,2023-04-23,13:00:00,230,158,72,FMN GV 16 Berchem TOT
54,Posthofbrug 5366,2023-04-23,14:00:00,178,126,52,FMN GV 16 Berchem TOT
54,Posthofbrug 5366,2023-04-23,15:00:00,136,57,79,FMN GV 16 Berchem TOT
54,Posthofbrug 5366,2023-04-23,16:00:00,204,52,152,FMN GV 16 Berchem TOT
54,Posthofbrug 5366,2023-04-23,17:00:00,192,42,150,FMN GV 16 Berchem TOT
54,Posthofbrug 5366,2023-04-23,18:00:00,153,37,116,FMN GV 16 Berchem TOT
54,Posthofbrug 5366,2023-04-23,19:00:00,117,34,83,FMN GV 16 Berchem TOT
54,Posthofbrug 5366,2023-04-23,20:00:00,75,23,52,FMN GV 16 Berchem TOT
54,Posthofbrug 5366,2023-04-23,21:00:00,69,22,47,FMN GV 16 Berchem TOT
54,Posthofbrug 5366,2023-04-23,22:00:00,56,18,38,FMN GV 16 Berchem TOT
54,Posthofbrug 5366,2023-04-23,23:00:00,10,0,10,FMN GV 16 Berchem TOT
54,Posthofbrug 5366,2023-04-24,00:00:00,9,2,7,FMN GV 16 Berchem TOT
54,Posthofbrug 5366,2023-04-24,01:00:00,3,0,3,FMN GV 16 Berchem TOT
54,Posthofbrug 5366,2023-04-24,02:00:00,1,0,1,FMN GV 16 Berchem TOT
54,Posthofbrug 5366,2023-04-24,03:00:00,2,1,1,FMN GV 16 Berchem TOT
54,Posthofbrug 5366,2023-04-24,04:00:00,10,4,6,FMN GV 16 Berchem TOT
54,Posthofbrug 5366,2023-04-24,05:00:00,29,22,7,FMN GV 16 Berchem TOT
54,Posthofbrug 5366,2023-04-24,06:00:00,98,77,21,FMN GV 16 Berchem TOT
54,Posthofbrug 5366,2023-04-24,07:00:00,356,260,96,FMN GV 16 Berchem TOT
54,Posthofbrug 5366,2023-04-24,08:00:00,712,550,162,FMN GV 16 Berchem TOT
54,Posthofbrug 5366,2023-04-24,09:00:00,259,197,62,FMN GV 16 Berchem TOT
54,Posthofbrug 5366,2023-04-24,10:00:00,103,76,27,FMN GV 16 Berchem TOT
54,Posthofbrug 5366,2023-04-24,11:00:00,98,61,37,FMN GV 16 Berchem TOT
54,Posthofbrug 5366,2023-04-24,12:00:00,146,78,68,FMN GV 16 Berchem TOT
54,Posthofbrug 5366,2023-04-24,13:00:00,104,57,47,FMN GV 16 Berchem TOT
54,Posthofbrug 5366,2023-04-24,14:00:00,124,55,69,FMN GV 16 Berchem TOT
54,Posthofbrug 5366,2023-04-24,15:00:00,246,97,149,FMN GV 16 Berchem TOT
54,Posthofbrug 5366,2023-04-24,16:00:00,394,130,264,FMN GV 16 Berchem TOT
54,Posthofbrug 5366,2023-04-24,17:00:00,577,172,405,FMN GV 16 Berchem TOT
54,Posthofbrug 5366,2023-04-24,18:00:00,382,124,258,FMN GV 16 Berchem TOT
54,Posthofbrug 5366,2023-04-24,19:00:00,178,70,108,FMN GV 16 Berchem TOT
54,Posthofbrug 5366,2023-04-24,20:00:00,128,58,70,FMN GV 16 Berchem TOT
54,Posthofbrug 5366,2023-04-24,21:00:00,115,49,66,FMN GV 16 Berchem TOT
54,Posthofbrug 5366,2023-04-24,22:00:00,89,37,52,FMN GV 16 Berchem TOT
54,Posthofbrug 5366,2023-04-24,23:00:00,63,24,39,FMN GV 16 Berchem TOT
54,Posthofbrug 5366,2023-04-25,00:00:00,15,5,10,FMN GV 16 Berchem TOT
54,Posthofbrug 5366,2023-04-25,01:00:00,5,1,4,FMN GV 16 Berchem TOT
54,Posthofbrug 5366,2023-04-25,02:00:00,6,1,5,FMN GV 16 Berchem TOT
54,Posthofbrug 5366,2023-04-25,03:00:00,1,1,0,FMN GV 16 Berchem TOT
54,Posthofbrug 5366,2023-04-25,04:00:00,8,3,5,FMN GV 16 Berchem TOT
54,Posthofbrug 5366,2023-04-25,05:00:00,37,27,10,FMN GV 16 Berchem TOT
54,Posthofbrug 5366,2023-04-25,06:00:00,138,105,33,FMN GV 16 Berchem TOT
54,Posthofbrug 5366,2023-04-25,07:00:00,555,417,138,FMN GV 16 Berchem TOT
54,Posthofbrug 5366,2023-04-25,08:00:00,993,761,232,FMN GV 16 Berchem TOT
54,Posthofbrug 5366,2023-04-25,09:00:00,302,226,76,FMN GV 16 Berchem TOT
54,Posthofbrug 5366,2023-04-25,10:00:00,146,91,55,FMN GV 16 Berchem TOT
54,Posthofbrug 5366,2023-04-25,11:00:00,157,92,65,FMN GV 16 Berchem TOT
54,Posthofbrug 5366,2023-04-25,12:00:00,176,81,95,FMN GV 16 Berchem TOT
54,Posthofbrug 5366,2023-04-25,13:00:00,188,109,79,FMN GV 16 Berchem TOT
54,Posthofbrug 5366,2023-04-25,14:00:00,148,70,78,FMN GV 16 Berchem TOT
54,Posthofbrug 5366,2023-04-25,15:00:00,303,90,213,FMN GV 16 Berchem TOT
54,Posthofbrug 5366,2023-04-25,16:00:00,591,180,411,FMN GV 16 Berchem TOT
54,Posthofbrug 5366,2023-04-25,17:00:00,726,213,513,FMN GV 16 Berchem TOT
54,Posthofbrug 5366,2023-04-25,18:00:00,483,181,302,FMN GV 16 Berchem TOT
54,Posthofbrug 5366,2023-04-25,19:00:00,235,105,130,FMN GV 16 Berchem TOT
54,Posthofbrug 5366,2023-04-25,20:00:00,141,60,81,FMN GV 16 Berchem TOT
54,Posthofbrug 5366,2023-04-25,21:00:00,135,58,77,FMN GV 16 Berchem TOT
54,Posthofbrug 5366,2023-04-25,22:00:00,130,40,90,FMN GV 16 Berchem TOT
54,Posthofbrug 5366,2023-04-25,23:00:00,61,26,35,FMN GV 16 Berchem TOT
54,Posthofbrug 5366,2023-04-26,00:00:00,21,2,19,FMN GV 16 Berchem TOT
54,Posthofbrug 5366,2023-04-26,01:00:00,10,1,9,FMN GV 16 Berchem TOT
54,Posthofbrug 5366,2023-04-26,02:00:00,6,0,6,FMN GV 16 Berchem TOT
54,Posthofbrug 5366,2023-04-26,03:00:00,7,1,6,FMN GV 16 Berchem TOT
54,Posthofbrug 5366,2023-04-26,04:00:00,11,6,5,FMN GV 16 Berchem TOT
54,Posthofbrug 5366,2023-04-26,05:00:00,33,21,12,FMN GV 16 Berchem TOT
54,Posthofbrug 5366,2023-04-26,06:00:00,127,97,30,FMN GV 16 Berchem TOT
54,Posthofbrug 5366,2023-04-26,07:00:00,482,369,113,FMN GV 16 Berchem TOT
54,Posthofbrug 5366,2023-04-26,08:00:00,812,600,212,FMN GV 16 Berchem TOT
54,Posthofbrug 5366,2023-04-26,09:00:00,269,204,65,FMN GV 16 Berchem TOT
54,Posthofbrug 5366,2023-04-26,10:00:00,164,101,63,FMN GV 16 Berchem TOT
54,Posthofbrug 5366,2023-04-26,11:00:00,166,75,91,FMN GV 16 Berchem TOT
54,Posthofbrug 5366,2023-04-26,12:00:00,364,164,200,FMN GV 16 Berchem TOT
54,Posthofbrug 5366,2023-04-26,13:00:00,262,123,139,FMN GV 16 Berchem TOT
54,Posthofbrug 5366,2023-04-26,14:00:00,225,106,119,FMN GV 16 Berchem TOT
54,Posthofbrug 5366,2023-04-26,15:00:00,255,104,151,FMN GV 16 Berchem TOT
54,Posthofbrug 5366,2023-04-26,16:00:00,457,140,317,FMN GV 16 Berchem TOT
54,Posthofbrug 5366,2023-04-26,17:00:00,615,222,393,FMN GV 16 Berchem TOT
54,Posthofbrug 5366,2023-04-26,18:00:00,435,172,263,FMN GV 16 Berchem TOT
54,Posthofbrug 5366,2023-04-26,19:00:00,223,101,122,FMN GV 16 Berchem TOT
54,Posthofbrug 5366,2023-04-26,20:00:00,156,91,65,FMN GV 16 Berchem TOT
54,Posthofbrug 5366,2023-04-26,21:00:00,108,44,64,FMN GV 16 Berchem TOT
54,Posthofbrug 5366,2023-04-26,22:00:00,137,35,102,FMN GV 16 Berchem TOT
54,Posthofbrug 5366,2023-04-26,23:00:00,84,20,64,FMN GV 16 Berchem TOT
54,Posthofbrug 5366,2023-04-27,00:00:00,19,11,8,FMN GV 16 Berchem TOT
54,Posthofbrug 5366,2023-04-27,01:00:00,6,1,5,FMN GV 16 Berchem TOT
54,Posthofbrug 5366,2023-04-27,02:00:00,6,1,5,FMN GV 16 Berchem TOT
54,Posthofbrug 5366,2023-04-27,03:00:00,5,2,3,FMN GV 16 Berchem TOT
54,Posthofbrug 5366,2023-04-27,04:00:00,13,8,5,FMN GV 16 Berchem TOT
54,Posthofbrug 5366,2023-04-27,05:00:00,34,26,8,FMN GV 16 Berchem TOT
54,Posthofbrug 5366,2023-04-27,06:00:00,135,92,43,FMN GV 16 Berchem TOT
54,Posthofbrug 5366,2023-04-27,07:00:00,523,411,112,FMN GV 16 Berchem TOT
54,Posthofbrug 5366,2023-04-27,08:00:00,1046,772,274,FMN GV 16 Berchem TOT
54,Posthofbrug 5366,2023-04-27,09:00:00,320,249,71,FMN GV 16 Berchem TOT
54,Posthofbrug 5366,2023-04-27,10:00:00,156,107,49,FMN GV 16 Berchem TOT
54,Posthofbrug 5366,2023-04-27,11:00:00,147,86,61,FMN GV 16 Berchem TOT
54,Posthofbrug 5366,2023-04-27,12:00:00,232,138,94,FMN GV 16 Berchem TOT
54,Posthofbrug 5366,2023-04-27,13:00:00,205,108,97,FMN GV 16 Berchem TOT
54,Posthofbrug 5366,2023-04-27,14:00:00,198,77,121,FMN GV 16 Berchem TOT
54,Posthofbrug 5366,2023-04-27,15:00:00,333,129,204,FMN GV 16 Berchem TOT
54,Posthofbrug 5366,2023-04-27,16:00:00,582,170,412,FMN GV 16 Berchem TOT
54,Posthofbrug 5366,2023-04-27,17:00:00,687,168,519,FMN GV 16 Berchem TOT
54,Posthofbrug 5366,2023-04-27,18:00:00,470,162,308,FMN GV 16 Berchem TOT
54,Posthofbrug 5366,2023-04-27,19:00:00,221,106,115,FMN GV 16 Berchem TOT
54,Posthofbrug 5366,2023-04-27,20:00:00,162,79,83,FMN GV 16 Berchem TOT
54,Posthofbrug 5366,2023-04-27,21:00:00,151,53,98,FMN GV 16 Berchem TOT
54,Posthofbrug 5366,2023-04-27,22:00:00,166,51,115,FMN GV 16 Berchem TOT
54,Posthofbrug 5366,2023-04-27,23:00:00,85,16,69,FMN GV 16 Berchem TOT
54,Posthofbrug 5366,2023-04-28,00:00:00,41,8,33,FMN GV 16 Berchem TOT
54,Posthofbrug 5366,2023-04-28,01:00:00,17,5,12,FMN GV 16 Berchem TOT
54,Posthofbrug 5366,2023-04-28,02:00:00,10,1,9,FMN GV 16 Berchem TOT
54,Posthofbrug 5366,2023-04-28,03:00:00,4,0,4,FMN GV 16 Berchem TOT
54,Posthofbrug 5366,2023-04-28,04:00:00,19,10,9,FMN GV 16 Berchem TOT
54,Posthofbrug 5366,2023-04-28,05:00:00,28,20,8,FMN GV 16 Berchem TOT
54,Posthofbrug 5366,2023-04-28,06:00:00,100,73,27,FMN GV 16 Berchem TOT
54,Posthofbrug 5366,2023-04-28,07:00:00,369,268,101,FMN GV 16 Berchem TOT
54,Posthofbrug 5366,2023-04-28,08:00:00,700,549,151,FMN GV 16 Berchem TOT
54,Posthofbrug 5366,2023-04-28,09:00:00,253,204,49,FMN GV 16 Berchem TOT
54,Posthofbrug 5366,2023-04-28,10:00:00,137,87,50,FMN GV 16 Berchem TOT
54,Posthofbrug 5366,2023-04-28,11:00:00,106,70,36,FMN GV 16 Berchem TOT
54,Posthofbrug 5366,2023-04-28,12:00:00,203,102,101,FMN GV 16 Berchem TOT
54,Posthofbrug 5366,2023-04-28,13:00:00,158,79,79,FMN GV 16 Berchem TOT
54,Posthofbrug 5366,2023-04-28,14:00:00,162,68,94,FMN GV 16 Berchem TOT
54,Posthofbrug 5366,2023-04-28,15:00:00,317,105,212,FMN GV 16 Berchem TOT
54,Posthofbrug 5366,2023-04-28,16:00:00,430,136,294,FMN GV 16 Berchem TOT
54,Posthofbrug 5366,2023-04-28,17:00:00,471,145,326,FMN GV 16 Berchem TOT
54,Posthofbrug 5366,2023-04-28,18:00:00,308,113,195,FMN GV 16 Berchem TOT
54,Posthofbrug 5366,2023-04-28,19:00:00,204,116,88,FMN GV 16 Berchem TOT
54,Posthofbrug 5366,2023-04-28,20:00:00,112,51,61,FMN GV 16 Berchem TOT
54,Posthofbrug 5366,2023-04-28,21:00:00,109,60,49,FMN GV 16 Berchem TOT
54,Posthofbrug 5366,2023-04-28,22:00:00,103,32,71,FMN GV 16 Berchem TOT
54,Posthofbrug 5366,2023-04-28,23:00:00,114,28,86,FMN GV 16 Berchem TOT
54,Posthofbrug 5366,2023-04-29,00:00:00,69,17,52,FMN GV 16 Berchem TOT
54,Posthofbrug 5366,2023-04-29,01:00:00,26,6,20,FMN GV 16 Berchem TOT
54,Posthofbrug 5366,2023-04-29,02:00:00,32,9,23,FMN GV 16 Berchem TOT
54,Posthofbrug 5366,2023-04-29,03:00:00,19,4,15,FMN GV 16 Berchem TOT
54,Posthofbrug 5366,2023-04-29,04:00:00,31,5,26,FMN GV 16 Berchem TOT
54,Posthofbrug 5366,2023-04-29,05:00:00,26,10,16,FMN GV 16 Berchem TOT
54,Posthofbrug 5366,2023-04-29,06:00:00,28,16,12,FMN GV 16 Berchem TOT
54,Posthofbrug 5366,2023-04-29,07:00:00,35,23,12,FMN GV 16 Berchem TOT
54,Posthofbrug 5366,2023-04-29,08:00:00,69,43,26,FMN GV 16 Berchem TOT
54,Posthofbrug 5366,2023-04-29,09:00:00,153,100,53,FMN GV 16 Berchem TOT
54,Posthofbrug 5366,2023-04-29,10:00:00,178,120,58,FMN GV 16 Berchem TOT
54,Posthofbrug 5366,2023-04-29,11:00:00,172,96,76,FMN GV 16 Berchem TOT
54,Posthofbrug 5366,2023-04-29,12:00:00,169,102,67,FMN GV 16 Berchem TOT
54,Posthofbrug 5366,2023-04-29,13:00:00,210,135,75,FMN GV 16 Berchem TOT
54,Posthofbrug 5366,2023-04-29,14:00:00,225,129,96,FMN GV 16 Berchem TOT
54,Posthofbrug 5366,2023-04-29,15:00:00,163,80,83,FMN GV 16 Berchem TOT
54,Posthofbrug 5366,2023-04-29,16:00:00,190,90,100,FMN GV 16 Berchem TOT
54,Posthofbrug 5366,2023-04-29,17:00:00,204,101,103,FMN GV 16 Berchem TOT
54,Posthofbrug 5366,2023-04-29,18:00:00,175,92,83,FMN GV 16 Berchem TOT
54,Posthofbrug 5366,2023-04-29,19:00:00,162,93,69,FMN GV 16 Berchem TOT
54,Posthofbrug 5366,2023-04-29,20:00:00,90,51,39,FMN GV 16 Berchem TOT
54,Posthofbrug 5366,2023-04-29,21:00:00,101,50,51,FMN GV 16 Berchem TOT
54,Posthofbrug 5366,2023-04-29,22:00:00,99,32,67,FMN GV 16 Berchem TOT
54,Posthofbrug 5366,2023-04-29,23:00:00,93,39,54,FMN GV 16 Berchem TOT
54,Posthofbrug 5366,2023-04-30,00:00:00,66,19,47,FMN GV 16 Berchem TOT
54,Posthofbrug 5366,2023-04-30,01:00:00,64,24,40,FMN GV 16 Berchem TOT
54,Posthofbrug 5366,2023-04-30,02:00:00,40,18,22,FMN GV 16 Berchem TOT
54,Posthofbrug 5366,2023-04-30,03:00:00,14,4,10,FMN GV 16 Berchem TOT
54,Posthofbrug 5366,2023-04-30,04:00:00,26,5,21,FMN GV 16 Berchem TOT
54,Posthofbrug 5366,2023-04-30,05:00:00,21,8,13,FMN GV 16 Berchem TOT
54,Posthofbrug 5366,2023-04-30,06:00:00,19,10,9,FMN GV 16 Berchem TOT
54,Posthofbrug 5366,2023-04-30,07:00:00,48,21,27,FMN GV 16 Berchem TOT
54,Posthofbrug 5366,2023-04-30,08:00:00,78,49,29,FMN GV 16 Berchem TOT
54,Posthofbrug 5366,2023-04-30,09:00:00,144,99,45,FMN GV 16 Berchem TOT
54,Posthofbrug 5366,2023-04-30,10:00:00,181,119,62,FMN GV 16 Berchem TOT
54,Posthofbrug 5366,2023-04-30,11:00:00,220,128,92,FMN GV 16 Berchem TOT
54,Posthofbrug 5366,2023-04-30,12:00:00,210,99,111,FMN GV 16 Berchem TOT
54,Posthofbrug 5366,2023-04-30,13:00:00,252,152,100,FMN GV 16 Berchem TOT
54,Posthofbrug 5366,2023-04-30,14:00:00,241,140,101,FMN GV 16 Berchem TOT
54,Posthofbrug 5366,2023-04-30,15:00:00,215,94,121,FMN GV 16 Berchem TOT
54,Posthofbrug 5366,2023-04-30,16:00:00,176,73,103,FMN GV 16 Berchem TOT
54,Posthofbrug 5366,2023-04-30,17:00:00,212,84,128,FMN GV 16 Berchem TOT
54,Posthofbrug 5366,2023-04-30,18:00:00,178,90,88,FMN GV 16 Berchem TOT
54,Posthofbrug 5366,2023-04-30,19:00:00,132,66,66,FMN GV 16 Berchem TOT
54,Posthofbrug 5366,2023-04-30,20:00:00,132,64,68,FMN GV 16 Berchem TOT
54,Posthofbrug 5366,2023-04-30,21:00:00,106,49,57,FMN GV 16 Berchem TOT
54,Posthofbrug 5366,2023-04-30,22:00:00,94,37,57,FMN GV 16 Berchem TOT
54,Posthofbrug 5366,2023-04-30,23:00:00,67,22,45,FMN GV 16 Berchem TOT
54,Posthofbrug 5366,2023-05-01,00:00:00,38,8,30,FMN GV 16 Berchem TOT
54,Posthofbrug 5366,2023-05-01,01:00:00,42,16,26,FMN GV 16 Berchem TOT
54,Posthofbrug 5366,2023-05-01,02:00:00,13,2,11,FMN GV 16 Berchem TOT
54,Posthofbrug 5366,2023-05-01,03:00:00,13,4,9,FMN GV 16 Berchem TOT
54,Posthofbrug 5366,2023-05-01,04:00:00,9,3,6,FMN GV 16 Berchem TOT
54,Posthofbrug 5366,2023-05-01,05:00:00,19,7,12,FMN GV 16 Berchem TOT
54,Posthofbrug 5366,2023-05-01,06:00:00,30,19,11,FMN GV 16 Berchem TOT
54,Posthofbrug 5366,2023-05-01,07:00:00,58,21,37,FMN GV 16 Berchem TOT
54,Posthofbrug 5366,2023-05-01,08:00:00,210,41,169,FMN GV 16 Berchem TOT
54,Posthofbrug 5366,2023-05-01,09:00:00,615,150,465,FMN GV 16 Berchem TOT
54,Posthofbrug 5366,2023-05-01,10:00:00,908,156,752,FMN GV 16 Berchem TOT
54,Posthofbrug 5366,2023-05-01,11:00:00,974,173,801,FMN GV 16 Berchem TOT
54,Posthofbrug 5366,2023-05-01,12:00:00,808,114,694,FMN GV 16 Berchem TOT
54,Posthofbrug 5366,2023-05-01,13:00:00,447,92,355,FMN GV 16 Berchem TOT
54,Posthofbrug 5366,2023-05-01,14:00:00,318,134,184,FMN GV 16 Berchem TOT
54,Posthofbrug 5366,2023-05-01,15:00:00,232,63,169,FMN GV 16 Berchem TOT
54,Posthofbrug 5366,2023-05-01,16:00:00,199,81,118,FMN GV 16 Berchem TOT
54,Posthofbrug 5366,2023-05-01,17:00:00,236,121,115,FMN GV 16 Berchem TOT
54,Posthofbrug 5366,2023-05-01,18:00:00,139,68,71,FMN GV 16 Berchem TOT
54,Posthofbrug 5366,2023-05-01,19:00:00,106,58,48,FMN GV 16 Berchem TOT
54,Posthofbrug 5366,2023-05-01,20:00:00,99,51,48,FMN GV 16 Berchem TOT
54,Posthofbrug 5366,2023-05-01,21:00:00,82,34,48,FMN GV 16 Berchem TOT
54,Posthofbrug 5366,2023-05-01,22:00:00,57,22,35,FMN GV 16 Berchem TOT
54,Posthofbrug 5366,2023-05-01,23:00:00,28,15,13,FMN GV 16 Berchem TOT
54,Posthofbrug 5366,2023-05-02,00:00:00,19,4,15,FMN GV 16 Berchem TOT
54,Posthofbrug 5366,2023-05-02,01:00:00,8,3,5,FMN GV 16 Berchem TOT
54,Posthofbrug 5366,2023-05-02,02:00:00,6,1,5,FMN GV 16 Berchem TOT
54,Posthofbrug 5366,2023-05-02,03:00:00,3,2,1,FMN GV 16 Berchem TOT
54,Posthofbrug 5366,2023-05-02,04:00:00,11,6,5,FMN GV 16 Berchem TOT
54,Posthofbrug 5366,2023-05-02,05:00:00,29,23,6,FMN GV 16 Berchem TOT
54,Posthofbrug 5366,2023-05-02,06:00:00,152,119,33,FMN GV 16 Berchem TOT
54,Posthofbrug 5366,2023-05-02,07:00:00,583,467,116,FMN GV 16 Berchem TOT
54,Posthofbrug 5366,2023-05-02,08:00:00,1007,795,212,FMN GV 16 Berchem TOT
54,Posthofbrug 5366,2023-05-02,09:00:00,368,284,84,FMN GV 16 Berchem TOT
54,Posthofbrug 5366,2023-05-02,10:00:00,164,103,61,FMN GV 16 Berchem TOT
54,Posthofbrug 5366,2023-05-02,11:00:00,153,83,70,FMN GV 16 Berchem TOT
54,Posthofbrug 5366,2023-05-02,12:00:00,208,100,108,FMN GV 16 Berchem TOT
54,Posthofbrug 5366,2023-05-02,13:00:00,181,90,91,FMN GV 16 Berchem TOT
54,Posthofbrug 5366,2023-05-02,14:00:00,166,85,81,FMN GV 16 Berchem TOT
54,Posthofbrug 5366,2023-05-02,15:00:00,314,112,202,FMN GV 16 Berchem TOT
54,Posthofbrug 5366,2023-05-02,16:00:00,587,180,407,FMN GV 16 Berchem TOT
54,Posthofbrug 5366,2023-05-02,17:00:00,803,224,579,FMN GV 16 Berchem TOT
54,Posthofbrug 5366,2023-05-02,18:00:00,522,165,357,FMN GV 16 Berchem TOT
54,Posthofbrug 5366,2023-05-02,19:00:00,263,91,172,FMN GV 16 Berchem TOT
54,Posthofbrug 5366,2023-05-02,20:00:00,158,78,80,FMN GV 16 Berchem TOT
54,Posthofbrug 5366,2023-05-02,21:00:00,138,61,77,FMN GV 16 Berchem TOT
54,Posthofbrug 5366,2023-05-02,22:00:00,110,36,74,FMN GV 16 Berchem TOT
54,Posthofbrug 5366,2023-05-02,23:00:00,62,23,39,FMN GV 16 Berchem TOT
54,Posthofbrug 5366,2023-05-03,00:00:00,18,3,15,FMN GV 16 Berchem TOT
54,Posthofbrug 5366,2023-05-03,01:00:00,8,2,6,FMN GV 16 Berchem TOT
54,Posthofbrug 5366,2023-05-03,02:00:00,2,0,2,FMN GV 16 Berchem TOT
54,Posthofbrug 5366,2023-05-03,03:00:00,6,1,5,FMN GV 16 Berchem TOT
54,Posthofbrug 5366,2023-05-03,04:00:00,11,6,5,FMN GV 16 Berchem TOT
54,Posthofbrug 5366,2023-05-03,05:00:00,30,24,6,FMN GV 16 Berchem TOT
54,Posthofbrug 5366,2023-05-03,06:00:00,158,119,39,FMN GV 16 Berchem TOT
54,Posthofbrug 5366,2023-05-03,07:00:00,531,400,131,FMN GV 16 Berchem TOT
54,Posthofbrug 5366,2023-05-03,08:00:00,865,659,206,FMN GV 16 Berchem TOT
54,Posthofbrug 5366,2023-05-03,09:00:00,294,219,75,FMN GV 16 Berchem TOT
54,Posthofbrug 5366,2023-05-03,10:00:00,152,104,48,FMN GV 16 Berchem TOT
54,Posthofbrug 5366,2023-05-03,11:00:00,153,86,67,FMN GV 16 Berchem TOT
54,Posthofbrug 5366,2023-05-03,12:00:00,366,157,209,FMN GV 16 Berchem TOT
54,Posthofbrug 5366,2023-05-03,13:00:00,287,119,168,FMN GV 16 Berchem TOT
54,Posthofbrug 5366,2023-05-03,14:00:00,207,86,121,FMN GV 16 Berchem TOT
54,Posthofbrug 5366,2023-05-03,15:00:00,266,106,160,FMN GV 16 Berchem TOT
54,Posthofbrug 5366,2023-05-03,16:00:00,466,161,305,FMN GV 16 Berchem TOT
54,Posthofbrug 5366,2023-05-03,17:00:00,667,211,456,FMN GV 16 Berchem TOT
54,Posthofbrug 5366,2023-05-03,18:00:00,519,211,308,FMN GV 16 Berchem TOT
54,Posthofbrug 5366,2023-05-03,19:00:00,250,119,131,FMN GV 16 Berchem TOT
54,Posthofbrug 5366,2023-05-03,20:00:00,175,82,93,FMN GV 16 Berchem TOT
54,Posthofbrug 5366,2023-05-03,21:00:00,164,70,94,FMN GV 16 Berchem TOT
54,Posthofbrug 5366,2023-05-03,22:00:00,117,42,75,FMN GV 16 Berchem TOT
54,Posthofbrug 5366,2023-05-03,23:00:00,69,22,47,FMN GV 16 Berchem TOT
54,Posthofbrug 5366,2023-05-04,00:00:00,36,12,24,FMN GV 16 Berchem TOT
54,Posthofbrug 5366,2023-05-04,01:00:00,12,3,9,FMN GV 16 Berchem TOT
54,Posthofbrug 5366,2023-05-04,02:00:00,1,0,1,FMN GV 16 Berchem TOT
54,Posthofbrug 5366,2023-05-04,03:00:00,7,1,6,FMN GV 16 Berchem TOT
54,Posthofbrug 5366,2023-05-04,04:00:00,14,7,7,FMN GV 16 Berchem TOT
54,Posthofbrug 5366,2023-05-04,05:00:00,37,25,12,FMN GV 16 Berchem TOT
54,Posthofbrug 5366,2023-05-04,06:00:00,163,117,46,FMN GV 16 Berchem TOT
54,Posthofbrug 5366,2023-05-04,07:00:00,567,443,124,FMN GV 16 Berchem TOT
54,Posthofbrug 5366,2023-05-04,08:00:00,1089,828,261,FMN GV 16 Berchem TOT
54,Posthofbrug 5366,2023-05-04,09:00:00,359,282,77,FMN GV 16 Berchem TOT
54,Posthofbrug 5366,2023-05-04,10:00:00,159,116,43,FMN GV 16 Berchem TOT
54,Posthofbrug 5366,2023-05-04,11:00:00,159,97,62,FMN GV 16 Berchem TOT
54,Posthofbrug 5366,2023-05-04,12:00:00,262,153,109,FMN GV 16 Berchem TOT
54,Posthofbrug 5366,2023-05-04,13:00:00,252,122,130,FMN GV 16 Berchem TOT
54,Posthofbrug 5366,2023-05-04,14:00:00,228,95,133,FMN GV 16 Berchem TOT
54,Posthofbrug 5366,2023-05-04,15:00:00,351,116,235,FMN GV 16 Berchem TOT
54,Posthofbrug 5366,2023-05-04,16:00:00,674,212,462,FMN GV 16 Berchem TOT
54,Posthofbrug 5366,2023-05-04,17:00:00,821,262,559,FMN GV 16 Berchem TOT
54,Posthofbrug 5366,2023-05-04,18:00:00,525,184,341,FMN GV 16 Berchem TOT
54,Posthofbrug 5366,2023-05-04,19:00:00,290,113,177,FMN GV 16 Berchem TOT
54,Posthofbrug 5366,2023-05-04,20:00:00,225,132,93,FMN GV 16 Berchem TOT
54,Posthofbrug 5366,2023-05-04,21:00:00,155,71,84,FMN GV 16 Berchem TOT
54,Posthofbrug 5366,2023-05-04,22:00:00,124,39,85,FMN GV 16 Berchem TOT
54,Posthofbrug 5366,2023-05-04,23:00:00,118,32,86,FMN GV 16 Berchem TOT
54,Posthofbrug 5366,2023-05-05,00:00:00,45,5,40,FMN GV 16 Berchem TOT
54,Posthofbrug 5366,2023-05-05,01:00:00,30,7,23,FMN GV 16 Berchem TOT
54,Posthofbrug 5366,2023-05-05,02:00:00,8,1,7,FMN GV 16 Berchem TOT
54,Posthofbrug 5366,2023-05-05,03:00:00,6,1,5,FMN GV 16 Berchem TOT
54,Posthofbrug 5366,2023-05-05,04:00:00,23,12,11,FMN GV 16 Berchem TOT
54,Posthofbrug 5366,2023-05-05,05:00:00,32,25,7,FMN GV 16 Berchem TOT
54,Posthofbrug 5366,2023-05-05,06:00:00,114,79,35,FMN GV 16 Berchem TOT
54,Posthofbrug 5366,2023-05-05,07:00:00,429,305,124,FMN GV 16 Berchem TOT
54,Posthofbrug 5366,2023-05-05,08:00:00,762,601,161,FMN GV 16 Berchem TOT
54,Posthofbrug 5366,2023-05-05,09:00:00,256,189,67,FMN GV 16 Berchem TOT
54,Posthofbrug 5366,2023-05-05,10:00:00,151,94,57,FMN GV 16 Berchem TOT
54,Posthofbrug 5366,2023-05-05,11:00:00,97,46,51,FMN GV 16 Berchem TOT
54,Posthofbrug 5366,2023-05-05,12:00:00,209,107,102,FMN GV 16 Berchem TOT
54,Posthofbrug 5366,2023-05-05,13:00:00,157,80,77,FMN GV 16 Berchem TOT
54,Posthofbrug 5366,2023-05-05,14:00:00,163,60,103,FMN GV 16 Berchem TOT
54,Posthofbrug 5366,2023-05-05,15:00:00,355,99,256,FMN GV 16 Berchem TOT
54,Posthofbrug 5366,2023-05-05,16:00:00,452,138,314,FMN GV 16 Berchem TOT
54,Posthofbrug 5366,2023-05-05,17:00:00,476,151,325,FMN GV 16 Berchem TOT
54,Posthofbrug 5366,2023-05-05,18:00:00,329,139,190,FMN GV 16 Berchem TOT
54,Posthofbrug 5366,2023-05-05,19:00:00,187,100,87,FMN GV 16 Berchem TOT
54,Posthofbrug 5366,2023-05-05,20:00:00,127,66,61,FMN GV 16 Berchem TOT
54,Posthofbrug 5366,2023-05-05,21:00:00,83,46,37,FMN GV 16 Berchem TOT
54,Posthofbrug 5366,2023-05-05,22:00:00,120,43,77,FMN GV 16 Berchem TOT
54,Posthofbrug 5366,2023-05-05,23:00:00,110,34,76,FMN GV 16 Berchem TOT
54,Posthofbrug 5366,2023-05-06,00:00:00,97,34,63,FMN GV 16 Berchem TOT
54,Posthofbrug 5366,2023-05-06,01:00:00,51,12,39,FMN GV 16 Berchem TOT
54,Posthofbrug 5366,2023-05-06,02:00:00,31,9,22,FMN GV 16 Berchem TOT
54,Posthofbrug 5366,2023-05-06,03:00:00,21,6,15,FMN GV 16 Berchem TOT
54,Posthofbrug 5366,2023-05-06,04:00:00,28,8,20,FMN GV 16 Berchem TOT
54,Posthofbrug 5366,2023-05-06,05:00:00,31,9,22,FMN GV 16 Berchem TOT
54,Posthofbrug 5366,2023-05-06,06:00:00,27,14,13,FMN GV 16 Berchem TOT
54,Posthofbrug 5366,2023-05-06,07:00:00,59,33,26,FMN GV 16 Berchem TOT
54,Posthofbrug 5366,2023-05-06,08:00:00,118,59,59,FMN GV 16 Berchem TOT
54,Posthofbrug 5366,2023-05-06,09:00:00,201,129,72,FMN GV 16 Berchem TOT
54,Posthofbrug 5366,2023-05-06,10:00:00,203,130,73,FMN GV 16 Berchem TOT
54,Posthofbrug 5366,2023-05-06,11:00:00,256,147,109,FMN GV 16 Berchem TOT
54,Posthofbrug 5366,2023-05-06,12:00:00,224,115,109,FMN GV 16 Berchem TOT
54,Posthofbrug 5366,2023-05-06,13:00:00,239,114,125,FMN GV 16 Berchem TOT
54,Posthofbrug 5366,2023-05-06,14:00:00,244,133,111,FMN GV 16 Berchem TOT
54,Posthofbrug 5366,2023-05-06,15:00:00,219,99,120,FMN GV 16 Berchem TOT
54,Posthofbrug 5366,2023-05-06,16:00:00,203,76,127,FMN GV 16 Berchem TOT
54,Posthofbrug 5366,2023-05-06,17:00:00,231,123,108,FMN GV 16 Berchem TOT
54,Posthofbrug 5366,2023-05-06,18:00:00,187,107,80,FMN GV 16 Berchem TOT
54,Posthofbrug 5366,2023-05-06,19:00:00,121,68,53,FMN GV 16 Berchem TOT
54,Posthofbrug 5366,2023-05-06,20:00:00,84,42,42,FMN GV 16 Berchem TOT
54,Posthofbrug 5366,2023-05-06,21:00:00,76,39,37,FMN GV 16 Berchem TOT
54,Posthofbrug 5366,2023-05-06,22:00:00,81,20,61,FMN GV 16 Berchem TOT
54,Posthofbrug 5366,2023-05-06,23:00:00,95,29,66,FMN GV 16 Berchem TOT
54,Posthofbrug 5366,2023-05-07,00:00:00,75,23,52,FMN GV 16 Berchem TOT
54,Posthofbrug 5366,2023-05-07,01:00:00,44,19,25,FMN GV 16 Berchem TOT
54,Posthofbrug 5366,2023-05-07,02:00:00,43,6,37,FMN GV 16 Berchem TOT
54,Posthofbrug 5366,2023-05-07,03:00:00,14,1,13,FMN GV 16 Berchem TOT
54,Posthofbrug 5366,2023-05-07,04:00:00,17,4,13,FMN GV 16 Berchem TOT
54,Posthofbrug 5366,2023-05-07,05:00:00,17,6,11,FMN GV 16 Berchem TOT
54,Posthofbrug 5366,2023-05-07,06:00:00,25,19,6,FMN GV 16 Berchem TOT
54,Posthofbrug 5366,2023-05-07,07:00:00,38,24,14,FMN GV 16 Berchem TOT
54,Posthofbrug 5366,2023-05-07,08:00:00,129,85,44,FMN GV 16 Berchem TOT
54,Posthofbrug 5366,2023-05-07,09:00:00,125,79,46,FMN GV 16 Berchem TOT
54,Posthofbrug 5366,2023-05-07,10:00:00,125,81,44,FMN GV 16 Berchem TOT
54,Posthofbrug 5366,2023-05-07,11:00:00,97,48,49,FMN GV 16 Berchem TOT
54,Posthofbrug 5366,2023-05-07,12:00:00,114,46,68,FMN GV 16 Berchem TOT
54,Posthofbrug 5366,2023-05-07,13:00:00,122,53,69,FMN GV 16 Berchem TOT
54,Posthofbrug 5366,2023-05-07,14:00:00,108,53,55,FMN GV 16 Berchem TOT
54,Posthofbrug 5366,2023-05-07,15:00:00,106,49,57,FMN GV 16 Berchem TOT
54,Posthofbrug 5366,2023-05-07,16:00:00,101,50,51,FMN GV 16 Berchem TOT
54,Posthofbrug 5366,2023-05-07,17:00:00,136,67,69,FMN GV 16 Berchem TOT
54,Posthofbrug 5366,2023-05-07,18:00:00,157,61,96,FMN GV 16 Berchem TOT
54,Posthofbrug 5366,2023-05-07,19:00:00,120,59,61,FMN GV 16 Berchem TOT
54,Posthofbrug 5366,2023-05-07,20:00:00,93,42,51,FMN GV 16 Berchem TOT
54,Posthofbrug 5366,2023-05-07,21:00:00,56,29,27,FMN GV 16 Berchem TOT
54,Posthofbrug 5366,2023-05-07,22:00:00,56,27,29,FMN GV 16 Berchem TOT
54,Posthofbrug 5366,2023-05-07,23:00:00,35,12,23,FMN GV 16 Berchem TOT
54,Posthofbrug 5366,2023-05-08,00:00:00,19,2,17,FMN GV 16 Berchem TOT
54,Posthofbrug 5366,2023-05-08,01:00:00,11,6,5,FMN GV 16 Berchem TOT
54,Posthofbrug 5366,2023-05-08,02:00:00,4,1,3,FMN GV 16 Berchem TOT
54,Posthofbrug 5366,2023-05-08,03:00:00,8,4,4,FMN GV 16 Berchem TOT
54,Posthofbrug 5366,2023-05-08,04:00:00,13,9,4,FMN GV 16 Berchem TOT
54,Posthofbrug 5366,2023-05-08,05:00:00,28,22,6,FMN GV 16 Berchem TOT
54,Posthofbrug 5366,2023-05-08,06:00:00,142,103,39,FMN GV 16 Berchem TOT
54,Posthofbrug 5366,2023-05-08,07:00:00,509,377,132,FMN GV 16 Berchem TOT
54,Posthofbrug 5366,2023-05-08,08:00:00,910,737,173,FMN GV 16 Berchem TOT
54,Posthofbrug 5366,2023-05-08,09:00:00,276,220,56,FMN GV 16 Berchem TOT
54,Posthofbrug 5366,2023-05-08,10:00:00,135,103,32,FMN GV 16 Berchem TOT
54,Posthofbrug 5366,2023-05-08,11:00:00,143,90,53,FMN GV 16 Berchem TOT
54,Posthofbrug 5366,2023-05-08,12:00:00,202,126,76,FMN GV 16 Berchem TOT
54,Posthofbrug 5366,2023-05-08,13:00:00,178,89,89,FMN GV 16 Berchem TOT
54,Posthofbrug 5366,2023-05-08,14:00:00,182,70,112,FMN GV 16 Berchem TOT
54,Posthofbrug 5366,2023-05-08,15:00:00,305,83,222,FMN GV 16 Berchem TOT
54,Posthofbrug 5366,2023-05-08,16:00:00,555,169,386,FMN GV 16 Berchem TOT
54,Posthofbrug 5366,2023-05-08,17:00:00,716,200,516,FMN GV 16 Berchem TOT
54,Posthofbrug 5366,2023-05-08,18:00:00,451,124,327,FMN GV 16 Berchem TOT
54,Posthofbrug 5366,2023-05-08,19:00:00,189,75,114,FMN GV 16 Berchem TOT
54,Posthofbrug 5366,2023-05-08,20:00:00,132,54,78,FMN GV 16 Berchem TOT
54,Posthofbrug 5366,2023-05-08,21:00:00,121,57,64,FMN GV 16 Berchem TOT
54,Posthofbrug 5366,2023-05-08,22:00:00,104,41,63,FMN GV 16 Berchem TOT
54,Posthofbrug 5366,2023-05-08,23:00:00,47,8,39,FMN GV 16 Berchem TOT
54,Posthofbrug 5366,2023-05-09,00:00:00,19,5,14,FMN GV 16 Berchem TOT
54,Posthofbrug 5366,2023-05-09,01:00:00,15,4,11,FMN GV 16 Berchem TOT
54,Posthofbrug 5366,2023-05-09,02:00:00,4,1,3,FMN GV 16 Berchem TOT
54,Posthofbrug 5366,2023-05-09,03:00:00,2,1,1,FMN GV 16 Berchem TOT
54,Posthofbrug 5366,2023-05-09,04:00:00,15,9,6,FMN GV 16 Berchem TOT
54,Posthofbrug 5366,2023-05-09,05:00:00,31,22,9,FMN GV 16 Berchem TOT
54,Posthofbrug 5366,2023-05-09,06:00:00,113,91,22,FMN GV 16 Berchem TOT
54,Posthofbrug 5366,2023-05-09,07:00:00,505,382,123,FMN GV 16 Berchem TOT
54,Posthofbrug 5366,2023-05-09,08:00:00,870,675,195,FMN GV 16 Berchem TOT
54,Posthofbrug 5366,2023-05-09,09:00:00,306,184,122,FMN GV 16 Berchem TOT
54,Posthofbrug 5366,2023-05-09,10:00:00,111,66,45,FMN GV 16 Berchem TOT
54,Posthofbrug 5366,2023-05-09,11:00:00,82,51,31,FMN GV 16 Berchem TOT
54,Posthofbrug 5366,2023-05-09,12:00:00,127,64,63,FMN GV 16 Berchem TOT
54,Posthofbrug 5366,2023-05-09,13:00:00,148,76,72,FMN GV 16 Berchem TOT
54,Posthofbrug 5366,2023-05-09,14:00:00,88,34,54,FMN GV 16 Berchem TOT
54,Posthofbrug 5366,2023-05-09,15:00:00,190,59,131,FMN GV 16 Berchem TOT
54,Posthofbrug 5366,2023-05-09,16:00:00,445,147,298,FMN GV 16 Berchem TOT
54,Posthofbrug 5366,2023-05-09,17:00:00,633,187,446,FMN GV 16 Berchem TOT
54,Posthofbrug 5366,2023-05-09,18:00:00,356,112,244,FMN GV 16 Berchem TOT
54,Posthofbrug 5366,2023-05-09,19:00:00,132,42,90,FMN GV 16 Berchem TOT
54,Posthofbrug 5366,2023-05-09,20:00:00,114,48,66,FMN GV 16 Berchem TOT
54,Posthofbrug 5366,2023-05-09,21:00:00,89,33,56,FMN GV 16 Berchem TOT
54,Posthofbrug 5366,2023-05-09,22:00:00,58,18,40,FMN GV 16 Berchem TOT
54,Posthofbrug 5366,2023-05-09,23:00:00,54,21,33,FMN GV 16 Berchem TOT
54,Posthofbrug 5366,2023-05-10,00:00:00,16,4,12,FMN GV 16 Berchem TOT
54,Posthofbrug 5366,2023-05-10,01:00:00,8,2,6,FMN GV 16 Berchem TOT
54,Posthofbrug 5366,2023-05-10,02:00:00,4,1,3,FMN GV 16 Berchem TOT
54,Posthofbrug 5366,2023-05-10,03:00:00,4,3,1,FMN GV 16 Berchem TOT
54,Posthofbrug 5366,2023-05-10,04:00:00,11,4,7,FMN GV 16 Berchem TOT
54,Posthofbrug 5366,2023-05-10,05:00:00,25,19,6,FMN GV 16 Berchem TOT
54,Posthofbrug 5366,2023-05-10,06:00:00,118,93,25,FMN GV 16 Berchem TOT
54,Posthofbrug 5366,2023-05-10,07:00:00,453,337,116,FMN GV 16 Berchem TOT
54,Posthofbrug 5366,2023-05-10,08:00:00,733,536,197,FMN GV 16 Berchem TOT
54,Posthofbrug 5366,2023-05-10,09:00:00,230,170,60,FMN GV 16 Berchem TOT
54,Posthofbrug 5366,2023-05-10,10:00:00,128,83,45,FMN GV 16 Berchem TOT
54,Posthofbrug 5366,2023-05-10,11:00:00,130,69,61,FMN GV 16 Berchem TOT
54,Posthofbrug 5366,2023-05-10,12:00:00,307,120,187,FMN GV 16 Berchem TOT
54,Posthofbrug 5366,2023-05-10,13:00:00,194,97,97,FMN GV 16 Berchem TOT
54,Posthofbrug 5366,2023-05-10,14:00:00,140,63,77,FMN GV 16 Berchem TOT
54,Posthofbrug 5366,2023-05-10,15:00:00,195,77,118,FMN GV 16 Berchem TOT
54,Posthofbrug 5366,2023-05-10,16:00:00,347,109,238,FMN GV 16 Berchem TOT
54,Posthofbrug 5366,2023-05-10,17:00:00,471,172,299,FMN GV 16 Berchem TOT
54,Posthofbrug 5366,2023-05-10,18:00:00,359,121,238,FMN GV 16 Berchem TOT
54,Posthofbrug 5366,2023-05-10,19:00:00,203,86,117,FMN GV 16 Berchem TOT
54,Posthofbrug 5366,2023-05-10,20:00:00,113,52,61,FMN GV 16 Berchem TOT
54,Posthofbrug 5366,2023-05-10,21:00:00,107,46,61,FMN GV 16 Berchem TOT
54,Posthofbrug 5366,2023-05-10,22:00:00,104,27,77,FMN GV 16 Berchem TOT
54,Posthofbrug 5366,2023-05-10,23:00:00,50,11,39,FMN GV 16 Berchem TOT
54,Posthofbrug 5366,2023-05-11,00:00:00,20,5,15,FMN GV 16 Berchem TOT
54,Posthofbrug 5366,2023-05-11,01:00:00,8,3,5,FMN GV 16 Berchem TOT
54,Posthofbrug 5366,2023-05-11,02:00:00,5,0,5,FMN GV 16 Berchem TOT
54,Posthofbrug 5366,2023-05-11,03:00:00,6,2,4,FMN GV 16 Berchem TOT
54,Posthofbrug 5366,2023-05-11,04:00:00,14,10,4,FMN GV 16 Berchem TOT
54,Posthofbrug 5366,2023-05-11,05:00:00,30,24,6,FMN GV 16 Berchem TOT
54,Posthofbrug 5366,2023-05-11,06:00:00,137,107,30,FMN GV 16 Berchem TOT
54,Posthofbrug 5366,2023-05-11,07:00:00,496,380,116,FMN GV 16 Berchem TOT
54,Posthofbrug 5366,2023-05-11,08:00:00,995,771,224,FMN GV 16 Berchem TOT
54,Posthofbrug 5366,2023-05-11,09:00:00,290,222,68,FMN GV 16 Berchem TOT
54,Posthofbrug 5366,2023-05-11,10:00:00,150,97,53,FMN GV 16 Berchem TOT
54,Posthofbrug 5366,2023-05-11,11:00:00,148,96,52,FMN GV 16 Berchem TOT
54,Posthofbrug 5366,2023-05-11,12:00:00,206,119,87,FMN GV 16 Berchem TOT
54,Posthofbrug 5366,2023-05-11,13:00:00,201,106,95,FMN GV 16 Berchem TOT
54,Posthofbrug 5366,2023-05-11,14:00:00,202,110,92,FMN GV 16 Berchem TOT
54,Posthofbrug 5366,2023-05-11,15:00:00,304,96,208,FMN GV 16 Berchem TOT
54,Posthofbrug 5366,2023-05-11,16:00:00,489,152,337,FMN GV 16 Berchem TOT
54,Posthofbrug 5366,2023-05-11,17:00:00,761,240,521,FMN GV 16 Berchem TOT
54,Posthofbrug 5366,2023-05-11,18:00:00,402,121,281,FMN GV 16 Berchem TOT
54,Posthofbrug 5366,2023-05-11,19:00:00,190,76,114,FMN GV 16 Berchem TOT
54,Posthofbrug 5366,2023-05-11,20:00:00,142,63,79,FMN GV 16 Berchem TOT
54,Posthofbrug 5366,2023-05-11,21:00:00,119,53,66,FMN GV 16 Berchem TOT
54,Posthofbrug 5366,2023-05-11,22:00:00,164,59,105,FMN GV 16 Berchem TOT
54,Posthofbrug 5366,2023-05-11,23:00:00,54,19,35,FMN GV 16 Berchem TOT
54,Posthofbrug 5366,2023-05-12,00:00:00,32,4,28,FMN GV 16 Berchem TOT
54,Posthofbrug 5366,2023-05-12,01:00:00,8,1,7,FMN GV 16 Berchem TOT
54,Posthofbrug 5366,2023-05-12,02:00:00,8,0,8,FMN GV 16 Berchem TOT
54,Posthofbrug 5366,2023-05-12,03:00:00,7,3,4,FMN GV 16 Berchem TOT
54,Posthofbrug 5366,2023-05-12,04:00:00,17,7,10,FMN GV 16 Berchem TOT
54,Posthofbrug 5366,2023-05-12,05:00:00,31,20,11,FMN GV 16 Berchem TOT
54,Posthofbrug 5366,2023-05-12,06:00:00,83,61,22,FMN GV 16 Berchem TOT
54,Posthofbrug 5366,2023-05-12,07:00:00,299,224,75,FMN GV 16 Berchem TOT
54,Posthofbrug 5366,2023-05-12,08:00:00,645,514,131,FMN GV 16 Berchem TOT
54,Posthofbrug 5366,2023-05-12,09:00:00,226,173,53,FMN GV 16 Berchem TOT
54,Posthofbrug 5366,2023-05-12,10:00:00,117,75,42,FMN GV 16 Berchem TOT
54,Posthofbrug 5366,2023-05-12,11:00:00,94,54,40,FMN GV 16 Berchem TOT
54,Posthofbrug 5366,2023-05-12,12:00:00,158,71,87,FMN GV 16 Berchem TOT
54,Posthofbrug 5366,2023-05-12,13:00:00,181,99,82,FMN GV 16 Berchem TOT
54,Posthofbrug 5366,2023-05-12,14:00:00,152,63,89,FMN GV 16 Berchem TOT
54,Posthofbrug 5366,2023-05-12,15:00:00,294,114,180,FMN GV 16 Berchem TOT
54,Posthofbrug 5366,2023-05-12,16:00:00,352,128,224,FMN GV 16 Berchem TOT
54,Posthofbrug 5366,2023-05-12,17:00:00,492,160,332,FMN GV 16 Berchem TOT
54,Posthofbrug 5366,2023-05-12,18:00:00,362,154,208,FMN GV 16 Berchem TOT
54,Posthofbrug 5366,2023-05-12,19:00:00,214,131,83,FMN GV 16 Berchem TOT
54,Posthofbrug 5366,2023-05-12,20:00:00,132,74,58,FMN GV 16 Berchem TOT
54,Posthofbrug 5366,2023-05-12,21:00:00,104,59,45,FMN GV 16 Berchem TOT
54,Posthofbrug 5366,2023-05-12,22:00:00,133,39,94,FMN GV 16 Berchem TOT
54,Posthofbrug 5366,2023-05-12,23:00:00,114,43,71,FMN GV 16 Berchem TOT
54,Posthofbrug 5366,2023-05-13,00:00:00,91,30,61,FMN GV 16 Berchem TOT
54,Posthofbrug 5366,2023-05-13,01:00:00,43,16,27,FMN GV 16 Berchem TOT
54,Posthofbrug 5366,2023-05-13,02:00:00,46,17,29,FMN GV 16 Berchem TOT
54,Posthofbrug 5366,2023-05-13,03:00:00,25,11,14,FMN GV 16 Berchem TOT
54,Posthofbrug 5366,2023-05-13,04:00:00,23,11,12,FMN GV 16 Berchem TOT
54,Posthofbrug 5366,2023-05-13,05:00:00,21,9,12,FMN GV 16 Berchem TOT
54,Posthofbrug 5366,2023-05-13,06:00:00,22,8,14,FMN GV 16 Berchem TOT
54,Posthofbrug 5366,2023-05-13,07:00:00,52,35,17,FMN GV 16 Berchem TOT
54,Posthofbrug 5366,2023-05-13,08:00:00,70,37,33,FMN GV 16 Berchem TOT
54,Posthofbrug 5366,2023-05-13,09:00:00,242,133,109,FMN GV 16 Berchem TOT
54,Posthofbrug 5366,2023-05-13,10:00:00,226,158,68,FMN GV 16 Berchem TOT
54,Posthofbrug 5366,2023-05-13,11:00:00,208,132,76,FMN GV 16 Berchem TOT
54,Posthofbrug 5366,2023-05-13,12:00:00,229,126,103,FMN GV 16 Berchem TOT
54,Posthofbrug 5366,2023-05-13,13:00:00,294,166,128,FMN GV 16 Berchem TOT
54,Posthofbrug 5366,2023-05-13,14:00:00,290,150,140,FMN GV 16 Berchem TOT
54,Posthofbrug 5366,2023-05-13,15:00:00,279,134,145,FMN GV 16 Berchem TOT
54,Posthofbrug 5366,2023-05-13,16:00:00,229,97,132,FMN GV 16 Berchem TOT
54,Posthofbrug 5366,2023-05-13,17:00:00,231,100,131,FMN GV 16 Berchem TOT
54,Posthofbrug 5366,2023-05-13,18:00:00,222,108,114,FMN GV 16 Berchem TOT
54,Posthofbrug 5366,2023-05-13,19:00:00,169,103,66,FMN GV 16 Berchem TOT
54,Posthofbrug 5366,2023-05-13,20:00:00,146,79,67,FMN GV 16 Berchem TOT
54,Posthofbrug 5366,2023-05-13,21:00:00,130,64,66,FMN GV 16 Berchem TOT
54,Posthofbrug 5366,2023-05-13,22:00:00,79,39,40,FMN GV 16 Berchem TOT
54,Posthofbrug 5366,2023-05-13,23:00:00,85,21,64,FMN GV 16 Berchem TOT
54,Posthofbrug 5366,2023-05-14,00:00:00,63,16,47,FMN GV 16 Berchem TOT
54,Posthofbrug 5366,2023-05-14,01:00:00,74,16,58,FMN GV 16 Berchem TOT
54,Posthofbrug 5366,2023-05-14,02:00:00,38,9,29,FMN GV 16 Berchem TOT
54,Posthofbrug 5366,2023-05-14,03:00:00,28,2,26,FMN GV 16 Berchem TOT
54,Posthofbrug 5366,2023-05-14,04:00:00,18,4,14,FMN GV 16 Berchem TOT
54,Posthofbrug 5366,2023-05-14,05:00:00,18,7,11,FMN GV 16 Berchem TOT
54,Posthofbrug 5366,2023-05-14,06:00:00,19,15,4,FMN GV 16 Berchem TOT
54,Posthofbrug 5366,2023-05-14,07:00:00,27,16,11,FMN GV 16 Berchem TOT
54,Posthofbrug 5366,2023-05-14,08:00:00,73,57,16,FMN GV 16 Berchem TOT
54,Posthofbrug 5366,2023-05-14,09:00:00,156,112,44,FMN GV 16 Berchem TOT
54,Posthofbrug 5366,2023-05-14,10:00:00,163,66,97,FMN GV 16 Berchem TOT
54,Posthofbrug 5366,2023-05-14,11:00:00,176,95,81,FMN GV 16 Berchem TOT
54,Posthofbrug 5366,2023-05-14,12:00:00,203,101,102,FMN GV 16 Berchem TOT
54,Posthofbrug 5366,2023-05-14,13:00:00,219,119,100,FMN GV 16 Berchem TOT
54,Posthofbrug 5366,2023-05-14,14:00:00,223,122,101,FMN GV 16 Berchem TOT
54,Posthofbrug 5366,2023-05-14,15:00:00,199,96,103,FMN GV 16 Berchem TOT
54,Posthofbrug 5366,2023-05-14,16:00:00,184,88,96,FMN GV 16 Berchem TOT
54,Posthofbrug 5366,2023-05-14,17:00:00,243,114,129,FMN GV 16 Berchem TOT
54,Posthofbrug 5366,2023-05-14,18:00:00,180,86,94,FMN GV 16 Berchem TOT
54,Posthofbrug 5366,2023-05-14,19:00:00,135,73,62,FMN GV 16 Berchem TOT
54,Posthofbrug 5366,2023-05-14,20:00:00,117,56,61,FMN GV 16 Berchem TOT
54,Posthofbrug 5366,2023-05-14,21:00:00,84,38,46,FMN GV 16 Berchem TOT
54,Posthofbrug 5366,2023-05-14,22:00:00,69,30,39,FMN GV 16 Berchem TOT
54,Posthofbrug 5366,2023-05-14,23:00:00,30,9,21,FMN GV 16 Berchem TOT
54,Posthofbrug 5366,2023-05-15,00:00:00,15,1,14,FMN GV 16 Berchem TOT
54,Posthofbrug 5366,2023-05-15,01:00:00,13,3,10,FMN GV 16 Berchem TOT
54,Posthofbrug 5366,2023-05-15,02:00:00,3,0,3,FMN GV 16 Berchem TOT
54,Posthofbrug 5366,2023-05-15,03:00:00,2,2,0,FMN GV 16 Berchem TOT
54,Posthofbrug 5366,2023-05-15,04:00:00,15,9,6,FMN GV 16 Berchem TOT
54,Posthofbrug 5366,2023-05-15,05:00:00,32,23,9,FMN GV 16 Berchem TOT
54,Posthofbrug 5366,2023-05-15,06:00:00,143,110,33,FMN GV 16 Berchem TOT
54,Posthofbrug 5366,2023-05-15,07:00:00,461,357,104,FMN GV 16 Berchem TOT
54,Posthofbrug 5366,2023-05-15,08:00:00,910,717,193,FMN GV 16 Berchem TOT
54,Posthofbrug 5366,2023-05-15,09:00:00,292,222,70,FMN GV 16 Berchem TOT
54,Posthofbrug 5366,2023-05-15,10:00:00,123,88,35,FMN GV 16 Berchem TOT
54,Posthofbrug 5366,2023-05-15,11:00:00,126,77,49,FMN GV 16 Berchem TOT
54,Posthofbrug 5366,2023-05-15,12:00:00,183,94,89,FMN GV 16 Berchem TOT
54,Posthofbrug 5366,2023-05-15,13:00:00,143,62,81,FMN GV 16 Berchem TOT
54,Posthofbrug 5366,2023-05-15,14:00:00,119,40,79,FMN GV 16 Berchem TOT
54,Posthofbrug 5366,2023-05-15,15:00:00,258,78,180,FMN GV 16 Berchem TOT
54,Posthofbrug 5366,2023-05-15,16:00:00,501,133,368,FMN GV 16 Berchem TOT
54,Posthofbrug 5366,2023-05-15,17:00:00,576,171,405,FMN GV 16 Berchem TOT
54,Posthofbrug 5366,2023-05-15,18:00:00,389,99,290,FMN GV 16 Berchem TOT
54,Posthofbrug 5366,2023-05-15,19:00:00,192,64,128,FMN GV 16 Berchem TOT
54,Posthofbrug 5366,2023-05-15,20:00:00,100,43,57,FMN GV 16 Berchem TOT
54,Posthofbrug 5366,2023-05-15,21:00:00,91,34,57,FMN GV 16 Berchem TOT
54,Posthofbrug 5366,2023-05-15,22:00:00,80,29,51,FMN GV 16 Berchem TOT
54,Posthofbrug 5366,2023-05-15,23:00:00,42,16,26,FMN GV 16 Berchem TOT
54,Posthofbrug 5366,2023-05-16,00:00:00,11,3,8,FMN GV 16 Berchem TOT
54,Posthofbrug 5366,2023-05-16,01:00:00,8,3,5,FMN GV 16 Berchem TOT
54,Posthofbrug 5366,2023-05-16,02:00:00,2,0,2,FMN GV 16 Berchem TOT
54,Posthofbrug 5366,2023-05-16,03:00:00,1,0,1,FMN GV 16 Berchem TOT
54,Posthofbrug 5366,2023-05-16,04:00:00,19,14,5,FMN GV 16 Berchem TOT
54,Posthofbrug 5366,2023-05-16,05:00:00,39,31,8,FMN GV 16 Berchem TOT
54,Posthofbrug 5366,2023-05-16,06:00:00,152,114,38,FMN GV 16 Berchem TOT
54,Posthofbrug 5366,2023-05-16,07:00:00,523,401,122,FMN GV 16 Berchem TOT
54,Posthofbrug 5366,2023-05-16,08:00:00,1032,806,226,FMN GV 16 Berchem TOT
54,Posthofbrug 5366,2023-05-16,09:00:00,342,253,89,FMN GV 16 Berchem TOT
54,Posthofbrug 5366,2023-05-16,10:00:00,186,131,55,FMN GV 16 Berchem TOT
54,Posthofbrug 5366,2023-05-16,11:00:00,127,77,50,FMN GV 16 Berchem TOT
54,Posthofbrug 5366,2023-05-16,12:00:00,219,112,107,FMN GV 16 Berchem TOT
54,Posthofbrug 5366,2023-05-16,13:00:00,222,119,103,FMN GV 16 Berchem TOT
54,Posthofbrug 5366,2023-05-16,14:00:00,195,86,109,FMN GV 16 Berchem TOT
54,Posthofbrug 5366,2023-05-16,15:00:00,291,90,201,FMN GV 16 Berchem TOT
54,Posthofbrug 5366,2023-05-16,16:00:00,579,173,406,FMN GV 16 Berchem TOT
54,Posthofbrug 5366,2023-05-16,17:00:00,803,212,591,FMN GV 16 Berchem TOT
54,Posthofbrug 5366,2023-05-16,18:00:00,475,165,310,FMN GV 16 Berchem TOT
54,Posthofbrug 5366,2023-05-16,19:00:00,234,84,150,FMN GV 16 Berchem TOT
54,Posthofbrug 5366,2023-05-16,20:00:00,173,76,97,FMN GV 16 Berchem TOT
54,Posthofbrug 5366,2023-05-16,21:00:00,127,46,81,FMN GV 16 Berchem TOT
54,Posthofbrug 5366,2023-05-16,22:00:00,93,28,65,FMN GV 16 Berchem TOT
54,Posthofbrug 5366,2023-05-16,23:00:00,68,24,44,FMN GV 16 Berchem TOT
54,Posthofbrug 5366,2023-05-17,00:00:00,16,4,12,FMN GV 16 Berchem TOT
54,Posthofbrug 5366,2023-05-17,01:00:00,13,2,11,FMN GV 16 Berchem TOT
54,Posthofbrug 5366,2023-05-17,02:00:00,5,0,5,FMN GV 16 Berchem TOT
54,Posthofbrug 5366,2023-05-17,03:00:00,4,1,3,FMN GV 16 Berchem TOT
54,Posthofbrug 5366,2023-05-17,04:00:00,12,8,4,FMN GV 16 Berchem TOT
54,Posthofbrug 5366,2023-05-17,05:00:00,42,32,10,FMN GV 16 Berchem TOT
54,Posthofbrug 5366,2023-05-17,06:00:00,106,82,24,FMN GV 16 Berchem TOT
54,Posthofbrug 5366,2023-05-17,07:00:00,439,330,109,FMN GV 16 Berchem TOT
54,Posthofbrug 5366,2023-05-17,08:00:00,746,561,185,FMN GV 16 Berchem TOT
54,Posthofbrug 5366,2023-05-17,09:00:00,280,217,63,FMN GV 16 Berchem TOT
54,Posthofbrug 5366,2023-05-17,10:00:00,172,108,64,FMN GV 16 Berchem TOT
54,Posthofbrug 5366,2023-05-17,11:00:00,175,104,71,FMN GV 16 Berchem TOT
54,Posthofbrug 5366,2023-05-17,12:00:00,333,136,197,FMN GV 16 Berchem TOT
54,Posthofbrug 5366,2023-05-17,13:00:00,277,138,139,FMN GV 16 Berchem TOT
54,Posthofbrug 5366,2023-05-17,14:00:00,205,101,104,FMN GV 16 Berchem TOT
54,Posthofbrug 5366,2023-05-17,15:00:00,232,91,141,FMN GV 16 Berchem TOT
54,Posthofbrug 5366,2023-05-17,16:00:00,415,145,270,FMN GV 16 Berchem TOT
54,Posthofbrug 5366,2023-05-17,17:00:00,523,172,351,FMN GV 16 Berchem TOT
54,Posthofbrug 5366,2023-05-17,18:00:00,420,168,252,FMN GV 16 Berchem TOT
54,Posthofbrug 5366,2023-05-17,19:00:00,238,141,97,FMN GV 16 Berchem TOT
54,Posthofbrug 5366,2023-05-17,20:00:00,181,83,98,FMN GV 16 Berchem TOT
54,Posthofbrug 5366,2023-05-17,21:00:00,140,52,88,FMN GV 16 Berchem TOT
54,Posthofbrug 5366,2023-05-17,22:00:00,99,31,68,FMN GV 16 Berchem TOT
54,Posthofbrug 5366,2023-05-17,23:00:00,105,27,78,FMN GV 16 Berchem TOT
54,Posthofbrug 5366,2023-05-18,00:00:00,65,14,51,FMN GV 16 Berchem TOT
54,Posthofbrug 5366,2023-05-18,01:00:00,63,17,46,FMN GV 16 Berchem TOT
54,Posthofbrug 5366,2023-05-18,02:00:00,30,11,19,FMN GV 16 Berchem TOT
54,Posthofbrug 5366,2023-05-18,03:00:00,19,8,11,FMN GV 16 Berchem TOT
54,Posthofbrug 5366,2023-05-18,04:00:00,24,4,20,FMN GV 16 Berchem TOT
54,Posthofbrug 5366,2023-05-18,05:00:00,14,9,5,FMN GV 16 Berchem TOT
54,Posthofbrug 5366,2023-05-18,06:00:00,36,21,15,FMN GV 16 Berchem TOT
54,Posthofbrug 5366,2023-05-18,07:00:00,48,27,21,FMN GV 16 Berchem TOT
54,Posthofbrug 5366,2023-05-18,08:00:00,43,30,13,FMN GV 16 Berchem TOT
54,Posthofbrug 5366,2023-05-18,09:00:00,109,75,34,FMN GV 16 Berchem TOT
54,Posthofbrug 5366,2023-05-18,10:00:00,169,104,65,FMN GV 16 Berchem TOT
54,Posthofbrug 5366,2023-05-18,11:00:00,187,100,87,FMN GV 16 Berchem TOT
54,Posthofbrug 5366,2023-05-18,12:00:00,194,114,80,FMN GV 16 Berchem TOT
54,Posthofbrug 5366,2023-05-18,13:00:00,230,119,111,FMN GV 16 Berchem TOT
54,Posthofbrug 5366,2023-05-18,14:00:00,274,141,133,FMN GV 16 Berchem TOT
54,Posthofbrug 5366,2023-05-18,15:00:00,248,104,144,FMN GV 16 Berchem TOT
54,Posthofbrug 5366,2023-05-18,16:00:00,222,117,105,FMN GV 16 Berchem TOT
54,Posthofbrug 5366,2023-05-18,17:00:00,187,96,91,FMN GV 16 Berchem TOT
54,Posthofbrug 5366,2023-05-18,18:00:00,225,123,102,FMN GV 16 Berchem TOT
54,Posthofbrug 5366,2023-05-18,19:00:00,177,94,83,FMN GV 16 Berchem TOT
54,Posthofbrug 5366,2023-05-18,20:00:00,131,72,59,FMN GV 16 Berchem TOT
54,Posthofbrug 5366,2023-05-18,21:00:00,123,60,63,FMN GV 16 Berchem TOT
54,Posthofbrug 5366,2023-05-18,22:00:00,96,45,51,FMN GV 16 Berchem TOT
54,Posthofbrug 5366,2023-05-18,23:00:00,97,51,46,FMN GV 16 Berchem TOT
54,Posthofbrug 5366,2023-05-19,00:00:00,79,56,23,FMN GV 16 Berchem TOT
54,Posthofbrug 5366,2023-05-19,01:00:00,46,34,12,FMN GV 16 Berchem TOT
54,Posthofbrug 5366,2023-05-19,02:00:00,11,4,7,FMN GV 16 Berchem TOT
54,Posthofbrug 5366,2023-05-19,03:00:00,20,5,15,FMN GV 16 Berchem TOT
54,Posthofbrug 5366,2023-05-19,04:00:00,12,5,7,FMN GV 16 Berchem TOT
54,Posthofbrug 5366,2023-05-19,05:00:00,23,17,6,FMN GV 16 Berchem TOT
54,Posthofbrug 5366,2023-05-19,06:00:00,51,33,18,FMN GV 16 Berchem TOT
54,Posthofbrug 5366,2023-05-19,07:00:00,89,54,35,FMN GV 16 Berchem TOT
54,Posthofbrug 5366,2023-05-19,08:00:00,161,115,46,FMN GV 16 Berchem TOT
54,Posthofbrug 5366,2023-05-19,09:00:00,154,122,32,FMN GV 16 Berchem TOT
54,Posthofbrug 5366,2023-05-19,10:00:00,178,132,46,FMN GV 16 Berchem TOT
54,Posthofbrug 5366,2023-05-19,11:00:00,171,123,48,FMN GV 16 Berchem TOT
54,Posthofbrug 5366,2023-05-19,12:00:00,205,111,94,FMN GV 16 Berchem TOT
54,Posthofbrug 5366,2023-05-19,13:00:00,208,106,102,FMN GV 16 Berchem TOT
54,Posthofbrug 5366,2023-05-19,14:00:00,223,123,100,FMN GV 16 Berchem TOT
54,Posthofbrug 5366,2023-05-19,15:00:00,235,99,136,FMN GV 16 Berchem TOT
54,Posthofbrug 5366,2023-05-19,16:00:00,275,132,143,FMN GV 16 Berchem TOT
54,Posthofbrug 5366,2023-05-19,17:00:00,287,146,141,FMN GV 16 Berchem TOT
54,Posthofbrug 5366,2023-05-19,18:00:00,242,97,145,FMN GV 16 Berchem TOT
54,Posthofbrug 5366,2023-05-19,19:00:00,170,84,86,FMN GV 16 Berchem TOT
54,Posthofbrug 5366,2023-05-19,20:00:00,128,53,75,FMN GV 16 Berchem TOT
54,Posthofbrug 5366,2023-05-19,21:00:00,115,59,56,FMN GV 16 Berchem TOT
54,Posthofbrug 5366,2023-05-19,22:00:00,122,42,80,FMN GV 16 Berchem TOT
54,Posthofbrug 5366,2023-05-19,23:00:00,74,25,49,FMN GV 16 Berchem TOT
54,Posthofbrug 5366,2023-05-20,00:00:00,60,16,44,FMN GV 16 Berchem TOT
54,Posthofbrug 5366,2023-05-20,01:00:00,56,15,41,FMN GV 16 Berchem TOT
54,Posthofbrug 5366,2023-05-20,02:00:00,19,2,17,FMN GV 16 Berchem TOT
54,Posthofbrug 5366,2023-05-20,03:00:00,19,4,15,FMN GV 16 Berchem TOT
54,Posthofbrug 5366,2023-05-20,04:00:00,19,6,13,FMN GV 16 Berchem TOT
54,Posthofbrug 5366,2023-05-20,05:00:00,18,14,4,FMN GV 16 Berchem TOT
54,Posthofbrug 5366,2023-05-20,06:00:00,42,24,18,FMN GV 16 Berchem TOT
54,Posthofbrug 5366,2023-05-20,07:00:00,39,21,18,FMN GV 16 Berchem TOT
54,Posthofbrug 5366,2023-05-20,08:00:00,62,40,22,FMN GV 16 Berchem TOT
54,Posthofbrug 5366,2023-05-20,09:00:00,158,112,46,FMN GV 16 Berchem TOT
54,Posthofbrug 5366,2023-05-20,10:00:00,166,112,54,FMN GV 16 Berchem TOT
54,Posthofbrug 5366,2023-05-20,11:00:00,180,110,70,FMN GV 16 Berchem TOT
54,Posthofbrug 5366,2023-05-20,12:00:00,218,130,88,FMN GV 16 Berchem TOT
54,Posthofbrug 5366,2023-05-20,13:00:00,203,118,85,FMN GV 16 Berchem TOT
54,Posthofbrug 5366,2023-05-20,14:00:00,304,174,130,FMN GV 16 Berchem TOT
54,Posthofbrug 5366,2023-05-20,15:00:00,204,99,105,FMN GV 16 Berchem TOT
54,Posthofbrug 5366,2023-05-20,16:00:00,248,109,139,FMN GV 16 Berchem TOT
54,Posthofbrug 5366,2023-05-20,17:00:00,212,99,113,FMN GV 16 Berchem TOT
54,Posthofbrug 5366,2023-05-20,18:00:00,202,94,108,FMN GV 16 Berchem TOT
54,Posthofbrug 5366,2023-05-20,19:00:00,154,87,67,FMN GV 16 Berchem TOT
54,Posthofbrug 5366,2023-05-20,20:00:00,95,52,43,FMN GV 16 Berchem TOT
54,Posthofbrug 5366,2023-05-20,21:00:00,126,56,70,FMN GV 16 Berchem TOT
54,Posthofbrug 5366,2023-05-20,22:00:00,96,36,60,FMN GV 16 Berchem TOT
54,Posthofbrug 5366,2023-05-20,23:00:00,101,30,71,FMN GV 16 Berchem TOT
54,Posthofbrug 5366,2023-05-21,00:00:00,49,15,34,FMN GV 16 Berchem TOT
54,Posthofbrug 5366,2023-05-21,01:00:00,29,5,24,FMN GV 16 Berchem TOT
54,Posthofbrug 5366,2023-05-21,02:00:00,20,2,18,FMN GV 16 Berchem TOT
54,Posthofbrug 5366,2023-05-21,03:00:00,11,1,10,FMN GV 16 Berchem TOT
54,Posthofbrug 5366,2023-05-21,04:00:00,8,1,7,FMN GV 16 Berchem TOT
54,Posthofbrug 5366,2023-05-21,05:00:00,17,2,15,FMN GV 16 Berchem TOT
54,Posthofbrug 5366,2023-05-21,06:00:00,22,15,7,FMN GV 16 Berchem TOT
54,Posthofbrug 5366,2023-05-21,07:00:00,47,23,24,FMN GV 16 Berchem TOT
54,Posthofbrug 5366,2023-05-21,08:00:00,52,41,11,FMN GV 16 Berchem TOT
54,Posthofbrug 5366,2023-05-21,09:00:00,131,72,59,FMN GV 16 Berchem TOT
54,Posthofbrug 5366,2023-05-21,10:00:00,145,77,68,FMN GV 16 Berchem TOT
54,Posthofbrug 5366,2023-05-21,11:00:00,197,119,78,FMN GV 16 Berchem TOT
54,Posthofbrug 5366,2023-05-21,12:00:00,213,116,97,FMN GV 16 Berchem TOT
54,Posthofbrug 5366,2023-05-21,13:00:00,323,176,147,FMN GV 16 Berchem TOT
54,Posthofbrug 5366,2023-05-21,14:00:00,248,131,117,FMN GV 16 Berchem TOT
54,Posthofbrug 5366,2023-05-21,15:00:00,265,128,137,FMN GV 16 Berchem TOT
54,Posthofbrug 5366,2023-05-21,16:00:00,221,103,118,FMN GV 16 Berchem TOT
54,Posthofbrug 5366,2023-05-21,17:00:00,226,96,130,FMN GV 16 Berchem TOT
54,Posthofbrug 5366,2023-05-21,18:00:00,169,95,74,FMN GV 16 Berchem TOT
54,Posthofbrug 5366,2023-05-21,19:00:00,117,60,57,FMN GV 16 Berchem TOT
54,Posthofbrug 5366,2023-05-21,20:00:00,134,70,64,FMN GV 16 Berchem TOT
54,Posthofbrug 5366,2023-05-21,21:00:00,89,45,44,FMN GV 16 Berchem TOT
54,Posthofbrug 5366,2023-05-21,22:00:00,77,32,45,FMN GV 16 Berchem TOT
54,Posthofbrug 5366,2023-05-21,23:00:00,39,19,20,FMN GV 16 Berchem TOT
54,Posthofbrug 5366,2023-05-22,00:00:00,10,6,4,FMN GV 16 Berchem TOT
54,Posthofbrug 5366,2023-05-22,01:00:00,4,1,3,FMN GV 16 Berchem TOT
54,Posthofbrug 5366,2023-05-22,02:00:00,1,0,1,FMN GV 16 Berchem TOT
54,Posthofbrug 5366,2023-05-22,03:00:00,7,5,2,FMN GV 16 Berchem TOT
54,Posthofbrug 5366,2023-05-22,04:00:00,7,3,4,FMN GV 16 Berchem TOT
54,Posthofbrug 5366,2023-05-22,05:00:00,26,21,5,FMN GV 16 Berchem TOT
54,Posthofbrug 5366,2023-05-22,06:00:00,127,104,23,FMN GV 16 Berchem TOT
54,Posthofbrug 5366,2023-05-22,07:00:00,531,417,114,FMN GV 16 Berchem TOT
54,Posthofbrug 5366,2023-05-22,08:00:00,946,753,193,FMN GV 16 Berchem TOT
54,Posthofbrug 5366,2023-05-22,09:00:00,353,282,71,FMN GV 16 Berchem TOT
54,Posthofbrug 5366,2023-05-22,10:00:00,169,104,65,FMN GV 16 Berchem TOT
54,Posthofbrug 5366,2023-05-22,11:00:00,135,92,43,FMN GV 16 Berchem TOT
54,Posthofbrug 5366,2023-05-22,12:00:00,204,109,95,FMN GV 16 Berchem TOT
54,Posthofbrug 5366,2023-05-22,13:00:00,163,74,89,FMN GV 16 Berchem TOT
54,Posthofbrug 5366,2023-05-22,14:00:00,179,74,105,FMN GV 16 Berchem TOT
54,Posthofbrug 5366,2023-05-22,15:00:00,336,111,225,FMN GV 16 Berchem TOT
54,Posthofbrug 5366,2023-05-22,16:00:00,582,153,429,FMN GV 16 Berchem TOT
54,Posthofbrug 5366,2023-05-22,17:00:00,707,204,503,FMN GV 16 Berchem TOT
54,Posthofbrug 5366,2023-05-22,18:00:00,465,146,319,FMN GV 16 Berchem TOT
54,Posthofbrug 5366,2023-05-22,19:00:00,197,70,127,FMN GV 16 Berchem TOT
54,Posthofbrug 5366,2023-05-22,20:00:00,129,60,69,FMN GV 16 Berchem TOT
54,Posthofbrug 5366,2023-05-22,21:00:00,112,50,62,FMN GV 16 Berchem TOT
54,Posthofbrug 5366,2023-05-22,22:00:00,83,30,53,FMN GV 16 Berchem TOT
54,Posthofbrug 5366,2023-05-22,23:00:00,42,13,29,FMN GV 16 Berchem TOT
54,Posthofbrug 5366,2023-05-23,00:00:00,19,6,13,FMN GV 16 Berchem TOT
54,Posthofbrug 5366,2023-05-23,01:00:00,8,0,8,FMN GV 16 Berchem TOT
54,Posthofbrug 5366,2023-05-23,02:00:00,3,0,3,FMN GV 16 Berchem TOT
54,Posthofbrug 5366,2023-05-23,03:00:00,4,3,1,FMN GV 16 Berchem TOT
54,Posthofbrug 5366,2023-05-23,04:00:00,13,8,5,FMN GV 16 Berchem TOT
54,Posthofbrug 5366,2023-05-23,05:00:00,33,26,7,FMN GV 16 Berchem TOT
54,Posthofbrug 5366,2023-05-23,06:00:00,148,117,31,FMN GV 16 Berchem TOT
54,Posthofbrug 5366,2023-05-23,07:00:00,588,442,146,FMN GV 16 Berchem TOT
54,Posthofbrug 5366,2023-05-23,08:00:00,1023,799,224,FMN GV 16 Berchem TOT
54,Posthofbrug 5366,2023-05-23,09:00:00,403,307,96,FMN GV 16 Berchem TOT
54,Posthofbrug 5366,2023-05-23,10:00:00,159,120,39,FMN GV 16 Berchem TOT
54,Posthofbrug 5366,2023-05-23,11:00:00,122,75,47,FMN GV 16 Berchem TOT
54,Posthofbrug 5366,2023-05-23,12:00:00,222,126,96,FMN GV 16 Berchem TOT
54,Posthofbrug 5366,2023-05-23,13:00:00,170,84,86,FMN GV 16 Berchem TOT
54,Posthofbrug 5366,2023-05-23,14:00:00,201,74,127,FMN GV 16 Berchem TOT
54,Posthofbrug 5366,2023-05-23,15:00:00,307,108,199,FMN GV 16 Berchem TOT
54,Posthofbrug 5366,2023-05-23,16:00:00,667,214,453,FMN GV 16 Berchem TOT
54,Posthofbrug 5366,2023-05-23,17:00:00,783,228,555,FMN GV 16 Berchem TOT
54,Posthofbrug 5366,2023-05-23,18:00:00,489,149,340,FMN GV 16 Berchem TOT
54,Posthofbrug 5366,2023-05-23,19:00:00,216,87,129,FMN GV 16 Berchem TOT
54,Posthofbrug 5366,2023-05-23,20:00:00,162,74,88,FMN GV 16 Berchem TOT
54,Posthofbrug 5366,2023-05-23,21:00:00,117,49,68,FMN GV 16 Berchem TOT
54,Posthofbrug 5366,2023-05-23,22:00:00,110,43,67,FMN GV 16 Berchem TOT
54,Posthofbrug 5366,2023-05-23,23:00:00,57,11,46,FMN GV 16 Berchem TOT
54,Posthofbrug 5366,2023-05-24,00:00:00,28,8,20,FMN GV 16 Berchem TOT
54,Posthofbrug 5366,2023-05-24,01:00:00,6,1,5,FMN GV 16 Berchem TOT
54,Posthofbrug 5366,2023-05-24,02:00:00,1,1,0,FMN GV 16 Berchem TOT
54,Posthofbrug 5366,2023-05-24,03:00:00,1,1,0,FMN GV 16 Berchem TOT
54,Posthofbrug 5366,2023-05-24,04:00:00,16,8,8,FMN GV 16 Berchem TOT
54,Posthofbrug 5366,2023-05-24,05:00:00,28,25,3,FMN GV 16 Berchem TOT
54,Posthofbrug 5366,2023-05-24,06:00:00,150,119,31,FMN GV 16 Berchem TOT
54,Posthofbrug 5366,2023-05-24,07:00:00,516,395,121,FMN GV 16 Berchem TOT
54,Posthofbrug 5366,2023-05-24,08:00:00,803,607,196,FMN GV 16 Berchem TOT
54,Posthofbrug 5366,2023-05-24,09:00:00,306,226,80,FMN GV 16 Berchem TOT
54,Posthofbrug 5366,2023-05-24,10:00:00,149,85,64,FMN GV 16 Berchem TOT
54,Posthofbrug 5366,2023-05-24,11:00:00,171,100,71,FMN GV 16 Berchem TOT
54,Posthofbrug 5366,2023-05-24,12:00:00,356,163,193,FMN GV 16 Berchem TOT
54,Posthofbrug 5366,2023-05-24,13:00:00,258,106,152,FMN GV 16 Berchem TOT
54,Posthofbrug 5366,2023-05-24,14:00:00,241,97,144,FMN GV 16 Berchem TOT
54,Posthofbrug 5366,2023-05-24,15:00:00,222,80,142,FMN GV 16 Berchem TOT
54,Posthofbrug 5366,2023-05-24,16:00:00,452,157,295,FMN GV 16 Berchem TOT
54,Posthofbrug 5366,2023-05-24,17:00:00,587,173,414,FMN GV 16 Berchem TOT
54,Posthofbrug 5366,2023-05-24,18:00:00,454,190,264,FMN GV 16 Berchem TOT
54,Posthofbrug 5366,2023-05-24,19:00:00,211,84,127,FMN GV 16 Berchem TOT
54,Posthofbrug 5366,2023-05-24,20:00:00,151,77,74,FMN GV 16 Berchem TOT
54,Posthofbrug 5366,2023-05-24,21:00:00,136,57,79,FMN GV 16 Berchem TOT
54,Posthofbrug 5366,2023-05-24,22:00:00,126,39,87,FMN GV 16 Berchem TOT
54,Posthofbrug 5366,2023-05-24,23:00:00,63,16,47,FMN GV 16 Berchem TOT
54,Posthofbrug 5366,2023-05-25,00:00:00,28,7,21,FMN GV 16 Berchem TOT
54,Posthofbrug 5366,2023-05-25,01:00:00,6,2,4,FMN GV 16 Berchem TOT
54,Posthofbrug 5366,2023-05-25,02:00:00,4,1,3,FMN GV 16 Berchem TOT
54,Posthofbrug 5366,2023-05-25,03:00:00,1,0,1,FMN GV 16 Berchem TOT
54,Posthofbrug 5366,2023-05-25,04:00:00,17,10,7,FMN GV 16 Berchem TOT
54,Posthofbrug 5366,2023-05-25,05:00:00,28,23,5,FMN GV 16 Berchem TOT
54,Posthofbrug 5366,2023-05-25,06:00:00,142,113,29,FMN GV 16 Berchem TOT
54,Posthofbrug 5366,2023-05-25,07:00:00,573,427,146,FMN GV 16 Berchem TOT
54,Posthofbrug 5366,2023-05-25,08:00:00,983,794,189,FMN GV 16 Berchem TOT
54,Posthofbrug 5366,2023-05-25,09:00:00,355,271,84,FMN GV 16 Berchem TOT
54,Posthofbrug 5366,2023-05-25,10:00:00,151,97,54,FMN GV 16 Berchem TOT
54,Posthofbrug 5366,2023-05-25,11:00:00,147,84,63,FMN GV 16 Berchem TOT
54,Posthofbrug 5366,2023-05-25,12:00:00,231,134,97,FMN GV 16 Berchem TOT
54,Posthofbrug 5366,2023-05-25,13:00:00,205,109,96,FMN GV 16 Berchem TOT
54,Posthofbrug 5366,2023-05-25,14:00:00,185,70,115,FMN GV 16 Berchem TOT
54,Posthofbrug 5366,2023-05-25,15:00:00,344,130,214,FMN GV 16 Berchem TOT
54,Posthofbrug 5366,2023-05-25,16:00:00,591,157,434,FMN GV 16 Berchem TOT
54,Posthofbrug 5366,2023-05-25,17:00:00,761,222,539,FMN GV 16 Berchem TOT
54,Posthofbrug 5366,2023-05-25,18:00:00,461,172,289,FMN GV 16 Berchem TOT
54,Posthofbrug 5366,2023-05-25,19:00:00,271,113,158,FMN GV 16 Berchem TOT
54,Posthofbrug 5366,2023-05-25,20:00:00,193,97,96,FMN GV 16 Berchem TOT
54,Posthofbrug 5366,2023-05-25,21:00:00,147,59,88,FMN GV 16 Berchem TOT
54,Posthofbrug 5366,2023-05-25,22:00:00,158,46,112,FMN GV 16 Berchem TOT
54,Posthofbrug 5366,2023-05-25,23:00:00,86,15,71,FMN GV 16 Berchem TOT
54,Posthofbrug 5366,2023-05-26,00:00:00,29,6,23,FMN GV 16 Berchem TOT
54,Posthofbrug 5366,2023-05-26,01:00:00,12,4,8,FMN GV 16 Berchem TOT
54,Posthofbrug 5366,2023-05-26,02:00:00,4,1,3,FMN GV 16 Berchem TOT
54,Posthofbrug 5366,2023-05-26,03:00:00,4,1,3,FMN GV 16 Berchem TOT
54,Posthofbrug 5366,2023-05-26,04:00:00,12,7,5,FMN GV 16 Berchem TOT
54,Posthofbrug 5366,2023-05-26,05:00:00,30,23,7,FMN GV 16 Berchem TOT
54,Posthofbrug 5366,2023-05-26,06:00:00,111,79,32,FMN GV 16 Berchem TOT
54,Posthofbrug 5366,2023-05-26,07:00:00,429,324,105,FMN GV 16 Berchem TOT
54,Posthofbrug 5366,2023-05-26,08:00:00,749,584,165,FMN GV 16 Berchem TOT
54,Posthofbrug 5366,2023-05-26,09:00:00,303,241,62,FMN GV 16 Berchem TOT
54,Posthofbrug 5366,2023-05-26,10:00:00,180,114,66,FMN GV 16 Berchem TOT
54,Posthofbrug 5366,2023-05-26,11:00:00,137,78,59,FMN GV 16 Berchem TOT
54,Posthofbrug 5366,2023-05-26,12:00:00,251,122,129,FMN GV 16 Berchem TOT
54,Posthofbrug 5366,2023-05-26,13:00:00,242,120,122,FMN GV 16 Berchem TOT
54,Posthofbrug 5366,2023-05-26,14:00:00,235,104,131,FMN GV 16 Berchem TOT
54,Posthofbrug 5366,2023-05-26,15:00:00,355,116,239,FMN GV 16 Berchem TOT
54,Posthofbrug 5366,2023-05-26,16:00:00,497,162,335,FMN GV 16 Berchem TOT
54,Posthofbrug 5366,2023-05-26,17:00:00,538,178,360,FMN GV 16 Berchem TOT
54,Posthofbrug 5366,2023-05-26,18:00:00,364,150,214,FMN GV 16 Berchem TOT
54,Posthofbrug 5366,2023-05-26,19:00:00,233,131,102,FMN GV 16 Berchem TOT
54,Posthofbrug 5366,2023-05-26,20:00:00,172,75,97,FMN GV 16 Berchem TOT
54,Posthofbrug 5366,2023-05-26,21:00:00,129,52,77,FMN GV 16 Berchem TOT
54,Posthofbrug 5366,2023-05-26,22:00:00,141,47,94,FMN GV 16 Berchem TOT
54,Posthofbrug 5366,2023-05-26,23:00:00,123,33,90,FMN GV 16 Berchem TOT
54,Posthofbrug 5366,2023-05-27,00:00:00,90,27,63,FMN GV 16 Berchem TOT
54,Posthofbrug 5366,2023-05-27,01:00:00,39,11,28,FMN GV 16 Berchem TOT
54,Posthofbrug 5366,2023-05-27,02:00:00,24,4,20,FMN GV 16 Berchem TOT
54,Posthofbrug 5366,2023-05-27,03:00:00,20,4,16,FMN GV 16 Berchem TOT
54,Posthofbrug 5366,2023-05-27,04:00:00,21,7,14,FMN GV 16 Berchem TOT
54,Posthofbrug 5366,2023-05-27,05:00:00,15,8,7,FMN GV 16 Berchem TOT
54,Posthofbrug 5366,2023-05-27,06:00:00,26,16,10,FMN GV 16 Berchem TOT
54,Posthofbrug 5366,2023-05-27,07:00:00,45,29,16,FMN GV 16 Berchem TOT
54,Posthofbrug 5366,2023-05-27,08:00:00,63,39,24,FMN GV 16 Berchem TOT
54,Posthofbrug 5366,2023-05-27,09:00:00,182,104,78,FMN GV 16 Berchem TOT
54,Posthofbrug 5366,2023-05-27,10:00:00,165,118,47,FMN GV 16 Berchem TOT
54,Posthofbrug 5366,2023-05-27,11:00:00,221,122,99,FMN GV 16 Berchem TOT
54,Posthofbrug 5366,2023-05-27,12:00:00,238,123,115,FMN GV 16 Berchem TOT
54,Posthofbrug 5366,2023-05-27,13:00:00,250,143,107,FMN GV 16 Berchem TOT
54,Posthofbrug 5366,2023-05-27,14:00:00,292,162,130,FMN GV 16 Berchem TOT
54,Posthofbrug 5366,2023-05-27,15:00:00,245,133,112,FMN GV 16 Berchem TOT
54,Posthofbrug 5366,2023-05-27,16:00:00,242,108,134,FMN GV 16 Berchem TOT
54,Posthofbrug 5366,2023-05-27,17:00:00,231,93,138,FMN GV 16 Berchem TOT
54,Posthofbrug 5366,2023-05-27,18:00:00,220,102,118,FMN GV 16 Berchem TOT
54,Posthofbrug 5366,2023-05-27,19:00:00,157,94,63,FMN GV 16 Berchem TOT
54,Posthofbrug 5366,2023-05-27,20:00:00,119,65,54,FMN GV 16 Berchem TOT
54,Posthofbrug 5366,2023-05-27,21:00:00,94,39,55,FMN GV 16 Berchem TOT
54,Posthofbrug 5366,2023-05-27,22:00:00,135,69,66,FMN GV 16 Berchem TOT
54,Posthofbrug 5366,2023-05-27,23:00:00,114,46,68,FMN GV 16 Berchem TOT
54,Posthofbrug 5366,2023-05-28,00:00:00,55,18,37,FMN GV 16 Berchem TOT
54,Posthofbrug 5366,2023-05-28,01:00:00,43,13,30,FMN GV 16 Berchem TOT
54,Posthofbrug 5366,2023-05-28,02:00:00,26,9,17,FMN GV 16 Berchem TOT
54,Posthofbrug 5366,2023-05-28,03:00:00,17,6,11,FMN GV 16 Berchem TOT
54,Posthofbrug 5366,2023-05-28,04:00:00,16,6,10,FMN GV 16 Berchem TOT
54,Posthofbrug 5366,2023-05-28,05:00:00,16,6,10,FMN GV 16 Berchem TOT
54,Posthofbrug 5366,2023-05-28,06:00:00,21,13,8,FMN GV 16 Berchem TOT
54,Posthofbrug 5366,2023-05-28,07:00:00,27,19,8,FMN GV 16 Berchem TOT
54,Posthofbrug 5366,2023-05-28,08:00:00,83,60,23,FMN GV 16 Berchem TOT
54,Posthofbrug 5366,2023-05-28,09:00:00,111,71,40,FMN GV 16 Berchem TOT
54,Posthofbrug 5366,2023-05-28,10:00:00,192,124,68,FMN GV 16 Berchem TOT
54,Posthofbrug 5366,2023-05-28,11:00:00,194,113,81,FMN GV 16 Berchem TOT
54,Posthofbrug 5366,2023-05-28,12:00:00,217,129,88,FMN GV 16 Berchem TOT
54,Posthofbrug 5366,2023-05-28,13:00:00,245,134,111,FMN GV 16 Berchem TOT
54,Posthofbrug 5366,2023-05-28,14:00:00,275,143,132,FMN GV 16 Berchem TOT
54,Posthofbrug 5366,2023-05-28,15:00:00,235,120,115,FMN GV 16 Berchem TOT
54,Posthofbrug 5366,2023-05-28,16:00:00,200,88,112,FMN GV 16 Berchem TOT
54,Posthofbrug 5366,2023-05-28,17:00:00,260,98,162,FMN GV 16 Berchem TOT
54,Posthofbrug 5366,2023-05-28,18:00:00,197,92,105,FMN GV 16 Berchem TOT
54,Posthofbrug 5366,2023-05-28,19:00:00,162,96,66,FMN GV 16 Berchem TOT
54,Posthofbrug 5366,2023-05-28,20:00:00,123,61,62,FMN GV 16 Berchem TOT
54,Posthofbrug 5366,2023-05-28,21:00:00,96,49,47,FMN GV 16 Berchem TOT
54,Posthofbrug 5366,2023-05-28,22:00:00,82,32,50,FMN GV 16 Berchem TOT
54,Posthofbrug 5366,2023-05-28,23:00:00,73,35,38,FMN GV 16 Berchem TOT
54,Posthofbrug 5366,2023-05-29,00:00:00,64,29,35,FMN GV 16 Berchem TOT
54,Posthofbrug 5366,2023-05-29,01:00:00,39,9,30,FMN GV 16 Berchem TOT
54,Posthofbrug 5366,2023-05-29,02:00:00,28,4,24,FMN GV 16 Berchem TOT
54,Posthofbrug 5366,2023-05-29,03:00:00,10,4,6,FMN GV 16 Berchem TOT
54,Posthofbrug 5366,2023-05-29,04:00:00,9,1,8,FMN GV 16 Berchem TOT
54,Posthofbrug 5366,2023-05-29,05:00:00,24,10,14,FMN GV 16 Berchem TOT
54,Posthofbrug 5366,2023-05-29,06:00:00,27,16,11,FMN GV 16 Berchem TOT
54,Posthofbrug 5366,2023-05-29,07:00:00,28,14,14,FMN GV 16 Berchem TOT
54,Posthofbrug 5366,2023-05-29,08:00:00,74,46,28,FMN GV 16 Berchem TOT
54,Posthofbrug 5366,2023-05-29,09:00:00,83,50,33,FMN GV 16 Berchem TOT
54,Posthofbrug 5366,2023-05-29,10:00:00,167,98,69,FMN GV 16 Berchem TOT
54,Posthofbrug 5366,2023-05-29,11:00:00,183,113,70,FMN GV 16 Berchem TOT
54,Posthofbrug 5366,2023-05-29,12:00:00,196,99,97,FMN GV 16 Berchem TOT
54,Posthofbrug 5366,2023-05-29,13:00:00,251,137,114,FMN GV 16 Berchem TOT
54,Posthofbrug 5366,2023-05-29,14:00:00,274,132,142,FMN GV 16 Berchem TOT
54,Posthofbrug 5366,2023-05-29,15:00:00,248,115,133,FMN GV 16 Berchem TOT
54,Posthofbrug 5366,2023-05-29,16:00:00,207,98,109,FMN GV 16 Berchem TOT
54,Posthofbrug 5366,2023-05-29,17:00:00,233,113,120,FMN GV 16 Berchem TOT
54,Posthofbrug 5366,2023-05-29,18:00:00,161,94,67,FMN GV 16 Berchem TOT
54,Posthofbrug 5366,2023-05-29,19:00:00,141,66,75,FMN GV 16 Berchem TOT
54,Posthofbrug 5366,2023-05-29,20:00:00,121,66,55,FMN GV 16 Berchem TOT
54,Posthofbrug 5366,2023-05-29,21:00:00,101,51,50,FMN GV 16 Berchem TOT
54,Posthofbrug 5366,2023-05-29,22:00:00,70,19,51,FMN GV 16 Berchem TOT
54,Posthofbrug 5366,2023-05-29,23:00:00,46,18,28,FMN GV 16 Berchem TOT
54,Posthofbrug 5366,2023-05-30,00:00:00,16,2,14,FMN GV 16 Berchem TOT
54,Posthofbrug 5366,2023-05-30,01:00:00,5,2,3,FMN GV 16 Berchem TOT
54,Posthofbrug 5366,2023-05-30,02:00:00,5,3,2,FMN GV 16 Berchem TOT
54,Posthofbrug 5366,2023-05-30,03:00:00,1,1,0,FMN GV 16 Berchem TOT
54,Posthofbrug 5366,2023-05-30,04:00:00,15,8,7,FMN GV 16 Berchem TOT
54,Posthofbrug 5366,2023-05-30,05:00:00,41,33,8,FMN GV 16 Berchem TOT
54,Posthofbrug 5366,2023-05-30,06:00:00,141,107,34,FMN GV 16 Berchem TOT
54,Posthofbrug 5366,2023-05-30,07:00:00,544,403,141,FMN GV 16 Berchem TOT
54,Posthofbrug 5366,2023-05-30,08:00:00,1005,788,217,FMN GV 16 Berchem TOT
54,Posthofbrug 5366,2023-05-30,09:00:00,331,256,75,FMN GV 16 Berchem TOT
54,Posthofbrug 5366,2023-05-30,10:00:00,172,114,58,FMN GV 16 Berchem TOT
54,Posthofbrug 5366,2023-05-30,11:00:00,173,103,70,FMN GV 16 Berchem TOT
54,Posthofbrug 5366,2023-05-30,12:00:00,201,98,103,FMN GV 16 Berchem TOT
54,Posthofbrug 5366,2023-05-30,13:00:00,189,96,93,FMN GV 16 Berchem TOT
54,Posthofbrug 5366,2023-05-30,14:00:00,164,75,89,FMN GV 16 Berchem TOT
54,Posthofbrug 5366,2023-05-30,15:00:00,299,112,187,FMN GV 16 Berchem TOT
54,Posthofbrug 5366,2023-05-30,16:00:00,580,160,420,FMN GV 16 Berchem TOT
54,Posthofbrug 5366,2023-05-30,17:00:00,778,225,553,FMN GV 16 Berchem TOT
54,Posthofbrug 5366,2023-05-30,18:00:00,496,171,325,FMN GV 16 Berchem TOT
54,Posthofbrug 5366,2023-05-30,19:00:00,245,110,135,FMN GV 16 Berchem TOT
54,Posthofbrug 5366,2023-05-30,20:00:00,179,75,104,FMN GV 16 Berchem TOT
54,Posthofbrug 5366,2023-05-30,21:00:00,143,64,79,FMN GV 16 Berchem TOT
54,Posthofbrug 5366,2023-05-30,22:00:00,101,37,64,FMN GV 16 Berchem TOT
54,Posthofbrug 5366,2023-05-30,23:00:00,57,17,40,FMN GV 16 Berchem TOT
54,Posthofbrug 5366,2023-05-31,00:00:00,23,12,11,FMN GV 16 Berchem TOT
54,Posthofbrug 5366,2023-05-31,01:00:00,9,2,7,FMN GV 16 Berchem TOT
54,Posthofbrug 5366,2023-05-31,02:00:00,6,0,6,FMN GV 16 Berchem TOT
54,Posthofbrug 5366,2023-05-31,03:00:00,2,2,0,FMN GV 16 Berchem TOT
54,Posthofbrug 5366,2023-05-31,04:00:00,15,7,8,FMN GV 16 Berchem TOT
54,Posthofbrug 5366,2023-05-31,05:00:00,32,22,10,FMN GV 16 Berchem TOT
54,Posthofbrug 5366,2023-05-31,06:00:00,157,124,33,FMN GV 16 Berchem TOT
54,Posthofbrug 5366,2023-05-31,07:00:00,519,396,123,FMN GV 16 Berchem TOT
54,Posthofbrug 5366,2023-05-31,08:00:00,827,632,195,FMN GV 16 Berchem TOT
54,Posthofbrug 5366,2023-05-31,09:00:00,307,222,85,FMN GV 16 Berchem TOT
54,Posthofbrug 5366,2023-05-31,10:00:00,146,96,50,FMN GV 16 Berchem TOT
54,Posthofbrug 5366,2023-05-31,11:00:00,208,109,99,FMN GV 16 Berchem TOT
54,Posthofbrug 5366,2023-05-31,12:00:00,362,165,197,FMN GV 16 Berchem TOT
54,Posthofbrug 5366,2023-05-31,13:00:00,293,144,149,FMN GV 16 Berchem TOT
54,Posthofbrug 5366,2023-05-31,14:00:00,187,91,96,FMN GV 16 Berchem TOT
54,Posthofbrug 5366,2023-05-31,15:00:00,260,97,163,FMN GV 16 Berchem TOT
54,Posthofbrug 5366,2023-05-31,16:00:00,469,168,301,FMN GV 16 Berchem TOT
54,Posthofbrug 5366,2023-05-31,17:00:00,677,219,458,FMN GV 16 Berchem TOT
54,Posthofbrug 5366,2023-05-31,18:00:00,463,184,279,FMN GV 16 Berchem TOT
54,Posthofbrug 5366,2023-05-31,19:00:00,290,124,166,FMN GV 16 Berchem TOT
54,Posthofbrug 5366,2023-05-31,20:00:00,187,101,86,FMN GV 16 Berchem TOT
54,Posthofbrug 5366,2023-05-31,21:00:00,152,66,86,FMN GV 16 Berchem TOT
54,Posthofbrug 5366,2023-05-31,22:00:00,160,46,114,FMN GV 16 Berchem TOT
54,Posthofbrug 5366,2023-05-31,23:00:00,78,15,63,FMN GV 16 Berchem TOT
54,Posthofbrug 5366,2023-06-01,00:00:00,40,13,27,FMN GV 16 Berchem TOT
54,Posthofbrug 5366,2023-06-01,01:00:00,9,2,7,FMN GV 16 Berchem TOT
54,Posthofbrug 5366,2023-06-01,02:00:00,6,1,5,FMN GV 16 Berchem TOT
54,Posthofbrug 5366,2023-06-01,03:00:00,3,1,2,FMN GV 16 Berchem TOT
54,Posthofbrug 5366,2023-06-01,04:00:00,14,8,6,FMN GV 16 Berchem TOT
54,Posthofbrug 5366,2023-06-01,05:00:00,38,25,13,FMN GV 16 Berchem TOT
54,Posthofbrug 5366,2023-06-01,06:00:00,157,124,33,FMN GV 16 Berchem TOT
54,Posthofbrug 5366,2023-06-01,07:00:00,497,387,110,FMN GV 16 Berchem TOT
54,Posthofbrug 5366,2023-06-01,08:00:00,1079,847,232,FMN GV 16 Berchem TOT
54,Posthofbrug 5366,2023-06-01,09:00:00,347,274,73,FMN GV 16 Berchem TOT
54,Posthofbrug 5366,2023-06-01,10:00:00,197,150,47,FMN GV 16 Berchem TOT
54,Posthofbrug 5366,2023-06-01,11:00:00,194,114,80,FMN GV 16 Berchem TOT
54,Posthofbrug 5366,2023-06-01,12:00:00,247,155,92,FMN GV 16 Berchem TOT
54,Posthofbrug 5366,2023-06-01,13:00:00,215,111,104,FMN GV 16 Berchem TOT
54,Posthofbrug 5366,2023-06-01,14:00:00,221,91,130,FMN GV 16 Berchem TOT
54,Posthofbrug 5366,2023-06-01,15:00:00,338,103,235,FMN GV 16 Berchem TOT
54,Posthofbrug 5366,2023-06-01,16:00:00,597,178,419,FMN GV 16 Berchem TOT
54,Posthofbrug 5366,2023-06-01,17:00:00,785,220,565,FMN GV 16 Berchem TOT
54,Posthofbrug 5366,2023-06-01,18:00:00,519,188,331,FMN GV 16 Berchem TOT
54,Posthofbrug 5366,2023-06-01,19:00:00,262,115,147,FMN GV 16 Berchem TOT
54,Posthofbrug 5366,2023-06-01,20:00:00,185,77,108,FMN GV 16 Berchem TOT
54,Posthofbrug 5366,2023-06-01,21:00:00,168,82,86,FMN GV 16 Berchem TOT
54,Posthofbrug 5366,2023-06-01,22:00:00,157,55,102,FMN GV 16 Berchem TOT
54,Posthofbrug 5366,2023-06-01,23:00:00,94,34,60,FMN GV 16 Berchem TOT
54,Posthofbrug 5366,2023-06-02,00:00:00,29,5,24,FMN GV 16 Berchem TOT
54,Posthofbrug 5366,2023-06-02,01:00:00,14,1,13,FMN GV 16 Berchem TOT
54,Posthofbrug 5366,2023-06-02,02:00:00,7,2,5,FMN GV 16 Berchem TOT
54,Posthofbrug 5366,2023-06-02,03:00:00,5,0,5,FMN GV 16 Berchem TOT
54,Posthofbrug 5366,2023-06-02,04:00:00,18,11,7,FMN GV 16 Berchem TOT
54,Posthofbrug 5366,2023-06-02,05:00:00,34,23,11,FMN GV 16 Berchem TOT
54,Posthofbrug 5366,2023-06-02,06:00:00,133,102,31,FMN GV 16 Berchem TOT
54,Posthofbrug 5366,2023-06-02,07:00:00,438,323,115,FMN GV 16 Berchem TOT
54,Posthofbrug 5366,2023-06-02,08:00:00,795,629,166,FMN GV 16 Berchem TOT
54,Posthofbrug 5366,2023-06-02,09:00:00,304,241,63,FMN GV 16 Berchem TOT
54,Posthofbrug 5366,2023-06-02,10:00:00,178,111,67,FMN GV 16 Berchem TOT
54,Posthofbrug 5366,2023-06-02,11:00:00,176,115,61,FMN GV 16 Berchem TOT
54,Posthofbrug 5366,2023-06-02,12:00:00,227,109,118,FMN GV 16 Berchem TOT
54,Posthofbrug 5366,2023-06-02,13:00:00,227,106,121,FMN GV 16 Berchem TOT
54,Posthofbrug 5366,2023-06-02,14:00:00,241,92,149,FMN GV 16 Berchem TOT
54,Posthofbrug 5366,2023-06-02,15:00:00,387,127,260,FMN GV 16 Berchem TOT
54,Posthofbrug 5366,2023-06-02,16:00:00,479,169,310,FMN GV 16 Berchem TOT
54,Posthofbrug 5366,2023-06-02,17:00:00,569,203,366,FMN GV 16 Berchem TOT
54,Posthofbrug 5366,2023-06-02,18:00:00,371,164,207,FMN GV 16 Berchem TOT
54,Posthofbrug 5366,2023-06-02,19:00:00,231,119,112,FMN GV 16 Berchem TOT
54,Posthofbrug 5366,2023-06-02,20:00:00,162,92,70,FMN GV 16 Berchem TOT
54,Posthofbrug 5366,2023-06-02,21:00:00,160,69,91,FMN GV 16 Berchem TOT
54,Posthofbrug 5366,2023-06-02,22:00:00,143,40,103,FMN GV 16 Berchem TOT
54,Posthofbrug 5366,2023-06-02,23:00:00,133,38,95,FMN GV 16 Berchem TOT
54,Posthofbrug 5366,2023-06-03,00:00:00,99,27,72,FMN GV 16 Berchem TOT
54,Posthofbrug 5366,2023-06-03,01:00:00,60,13,47,FMN GV 16 Berchem TOT
54,Posthofbrug 5366,2023-06-03,02:00:00,43,12,31,FMN GV 16 Berchem TOT
54,Posthofbrug 5366,2023-06-03,03:00:00,23,4,19,FMN GV 16 Berchem TOT
54,Posthofbrug 5366,2023-06-03,04:00:00,22,4,18,FMN GV 16 Berchem TOT
54,Posthofbrug 5366,2023-06-03,05:00:00,19,12,7,FMN GV 16 Berchem TOT
54,Posthofbrug 5366,2023-06-03,06:00:00,28,17,11,FMN GV 16 Berchem TOT
54,Posthofbrug 5366,2023-06-03,07:00:00,47,28,19,FMN GV 16 Berchem TOT
54,Posthofbrug 5366,2023-06-03,08:00:00,91,62,29,FMN GV 16 Berchem TOT
54,Posthofbrug 5366,2023-06-03,09:00:00,202,128,74,FMN GV 16 Berchem TOT
54,Posthofbrug 5366,2023-06-03,10:00:00,213,140,73,FMN GV 16 Berchem TOT
54,Posthofbrug 5366,2023-06-03,11:00:00,238,144,94,FMN GV 16 Berchem TOT
54,Posthofbrug 5366,2023-06-03,12:00:00,262,149,113,FMN GV 16 Berchem TOT
54,Posthofbrug 5366,2023-06-03,13:00:00,280,165,115,FMN GV 16 Berchem TOT
54,Posthofbrug 5366,2023-06-03,14:00:00,280,152,128,FMN GV 16 Berchem TOT
54,Posthofbrug 5366,2023-06-03,15:00:00,289,137,152,FMN GV 16 Berchem TOT
54,Posthofbrug 5366,2023-06-03,16:00:00,291,132,159,FMN GV 16 Berchem TOT
54,Posthofbrug 5366,2023-06-03,17:00:00,255,135,120,FMN GV 16 Berchem TOT
54,Posthofbrug 5366,2023-06-03,18:00:00,247,116,131,FMN GV 16 Berchem TOT
54,Posthofbrug 5366,2023-06-03,19:00:00,179,101,78,FMN GV 16 Berchem TOT
54,Posthofbrug 5366,2023-06-03,20:00:00,143,83,60,FMN GV 16 Berchem TOT
54,Posthofbrug 5366,2023-06-03,21:00:00,121,61,60,FMN GV 16 Berchem TOT
54,Posthofbrug 5366,2023-06-03,22:00:00,90,32,58,FMN GV 16 Berchem TOT
54,Posthofbrug 5366,2023-06-03,23:00:00,118,38,80,FMN GV 16 Berchem TOT
54,Posthofbrug 5366,2023-06-04,00:00:00,98,27,71,FMN GV 16 Berchem TOT
54,Posthofbrug 5366,2023-06-04,01:00:00,51,15,36,FMN GV 16 Berchem TOT
54,Posthofbrug 5366,2023-06-04,02:00:00,40,10,30,FMN GV 16 Berchem TOT
54,Posthofbrug 5366,2023-06-04,03:00:00,42,5,37,FMN GV 16 Berchem TOT
54,Posthofbrug 5366,2023-06-04,04:00:00,16,4,12,FMN GV 16 Berchem TOT
54,Posthofbrug 5366,2023-06-04,05:00:00,12,7,5,FMN GV 16 Berchem TOT
54,Posthofbrug 5366,2023-06-04,06:00:00,27,20,7,FMN GV 16 Berchem TOT
54,Posthofbrug 5366,2023-06-04,07:00:00,37,23,14,FMN GV 16 Berchem TOT
54,Posthofbrug 5366,2023-06-04,08:00:00,79,55,24,FMN GV 16 Berchem TOT
54,Posthofbrug 5366,2023-06-04,09:00:00,143,90,53,FMN GV 16 Berchem TOT
54,Posthofbrug 5366,2023-06-04,10:00:00,178,120,58,FMN GV 16 Berchem TOT
54,Posthofbrug 5366,2023-06-04,11:00:00,243,152,91,FMN GV 16 Berchem TOT
54,Posthofbrug 5366,2023-06-04,12:00:00,286,143,143,FMN GV 16 Berchem TOT
54,Posthofbrug 5366,2023-06-04,13:00:00,266,149,117,FMN GV 16 Berchem TOT
54,Posthofbrug 5366,2023-06-04,14:00:00,313,164,149,FMN GV 16 Berchem TOT
54,Posthofbrug 5366,2023-06-04,15:00:00,276,141,135,FMN GV 16 Berchem TOT
54,Posthofbrug 5366,2023-06-04,16:00:00,295,130,165,FMN GV 16 Berchem TOT
54,Posthofbrug 5366,2023-06-04,17:00:00,254,105,149,FMN GV 16 Berchem TOT
54,Posthofbrug 5366,2023-06-04,18:00:00,256,123,133,FMN GV 16 Berchem TOT
54,Posthofbrug 5366,2023-06-04,19:00:00,161,75,86,FMN GV 16 Berchem TOT
54,Posthofbrug 5366,2023-06-04,20:00:00,123,55,68,FMN GV 16 Berchem TOT
54,Posthofbrug 5366,2023-06-04,21:00:00,119,65,54,FMN GV 16 Berchem TOT
54,Posthofbrug 5366,2023-06-04,22:00:00,93,34,59,FMN GV 16 Berchem TOT
54,Posthofbrug 5366,2023-06-04,23:00:00,41,17,24,FMN GV 16 Berchem TOT
54,Posthofbrug 5366,2023-06-05,00:00:00,24,7,17,FMN GV 16 Berchem TOT
54,Posthofbrug 5366,2023-06-05,01:00:00,8,1,7,FMN GV 16 Berchem TOT
54,Posthofbrug 5366,2023-06-05,02:00:00,2,0,2,FMN GV 16 Berchem TOT
54,Posthofbrug 5366,2023-06-05,03:00:00,1,1,0,FMN GV 16 Berchem TOT
54,Posthofbrug 5366,2023-06-05,04:00:00,17,8,9,FMN GV 16 Berchem TOT
54,Posthofbrug 5366,2023-06-05,05:00:00,36,26,10,FMN GV 16 Berchem TOT
54,Posthofbrug 5366,2023-06-05,06:00:00,136,104,32,FMN GV 16 Berchem TOT
54,Posthofbrug 5366,2023-06-05,07:00:00,578,453,125,FMN GV 16 Berchem TOT
54,Posthofbrug 5366,2023-06-05,08:00:00,1033,823,210,FMN GV 16 Berchem TOT
54,Posthofbrug 5366,2023-06-05,09:00:00,352,270,82,FMN GV 16 Berchem TOT
54,Posthofbrug 5366,2023-06-05,10:00:00,192,121,71,FMN GV 16 Berchem TOT
54,Posthofbrug 5366,2023-06-05,11:00:00,171,108,63,FMN GV 16 Berchem TOT
54,Posthofbrug 5366,2023-06-05,12:00:00,223,125,98,FMN GV 16 Berchem TOT
54,Posthofbrug 5366,2023-06-05,13:00:00,203,109,94,FMN GV 16 Berchem TOT
54,Posthofbrug 5366,2023-06-05,14:00:00,208,87,121,FMN GV 16 Berchem TOT
54,Posthofbrug 5366,2023-06-05,15:00:00,367,132,235,FMN GV 16 Berchem TOT
54,Posthofbrug 5366,2023-06-05,16:00:00,610,196,414,FMN GV 16 Berchem TOT
54,Posthofbrug 5366,2023-06-05,17:00:00,843,253,590,FMN GV 16 Berchem TOT
54,Posthofbrug 5366,2023-06-05,18:00:00,504,169,335,FMN GV 16 Berchem TOT
54,Posthofbrug 5366,2023-06-05,19:00:00,240,94,146,FMN GV 16 Berchem TOT
54,Posthofbrug 5366,2023-06-05,20:00:00,176,69,107,FMN GV 16 Berchem TOT
54,Posthofbrug 5366,2023-06-05,21:00:00,168,57,111,FMN GV 16 Berchem TOT
54,Posthofbrug 5366,2023-06-05,22:00:00,116,49,67,FMN GV 16 Berchem TOT
54,Posthofbrug 5366,2023-06-05,23:00:00,65,13,52,FMN GV 16 Berchem TOT
54,Posthofbrug 5366,2023-06-06,00:00:00,24,14,10,FMN GV 16 Berchem TOT
54,Posthofbrug 5366,2023-06-06,01:00:00,13,2,11,FMN GV 16 Berchem TOT
54,Posthofbrug 5366,2023-06-06,02:00:00,10,3,7,FMN GV 16 Berchem TOT
54,Posthofbrug 5366,2023-06-06,03:00:00,2,1,1,FMN GV 16 Berchem TOT
54,Posthofbrug 5366,2023-06-06,04:00:00,14,7,7,FMN GV 16 Berchem TOT
54,Posthofbrug 5366,2023-06-06,05:00:00,44,32,12,FMN GV 16 Berchem TOT
54,Posthofbrug 5366,2023-06-06,06:00:00,145,110,35,FMN GV 16 Berchem TOT
54,Posthofbrug 5366,2023-06-06,07:00:00,659,507,152,FMN GV 16 Berchem TOT
54,Posthofbrug 5366,2023-06-06,08:00:00,1108,857,251,FMN GV 16 Berchem TOT
54,Posthofbrug 5366,2023-06-06,09:00:00,369,297,72,FMN GV 16 Berchem TOT
54,Posthofbrug 5366,2023-06-06,10:00:00,211,146,65,FMN GV 16 Berchem TOT
54,Posthofbrug 5366,2023-06-06,11:00:00,173,100,73,FMN GV 16 Berchem TOT
54,Posthofbrug 5366,2023-06-06,12:00:00,229,131,98,FMN GV 16 Berchem TOT
54,Posthofbrug 5366,2023-06-06,13:00:00,211,105,106,FMN GV 16 Berchem TOT
54,Posthofbrug 5366,2023-06-06,14:00:00,230,118,112,FMN GV 16 Berchem TOT
54,Posthofbrug 5366,2023-06-06,15:00:00,342,113,229,FMN GV 16 Berchem TOT
54,Posthofbrug 5366,2023-06-06,16:00:00,675,208,467,FMN GV 16 Berchem TOT
54,Posthofbrug 5366,2023-06-06,17:00:00,888,270,618,FMN GV 16 Berchem TOT
54,Posthofbrug 5366,2023-06-06,18:00:00,523,174,349,FMN GV 16 Berchem TOT
54,Posthofbrug 5366,2023-06-06,19:00:00,263,110,153,FMN GV 16 Berchem TOT
54,Posthofbrug 5366,2023-06-06,20:00:00,180,91,89,FMN GV 16 Berchem TOT
54,Posthofbrug 5366,2023-06-06,21:00:00,155,69,86,FMN GV 16 Berchem TOT
54,Posthofbrug 5366,2023-06-06,22:00:00,142,63,79,FMN GV 16 Berchem TOT
54,Posthofbrug 5366,2023-06-06,23:00:00,86,32,54,FMN GV 16 Berchem TOT
54,Posthofbrug 5366,2023-06-07,00:00:00,27,6,21,FMN GV 16 Berchem TOT
54,Posthofbrug 5366,2023-06-07,01:00:00,8,3,5,FMN GV 16 Berchem TOT
54,Posthofbrug 5366,2023-06-07,02:00:00,11,3,8,FMN GV 16 Berchem TOT
54,Posthofbrug 5366,2023-06-07,03:00:00,0,0,0,FMN GV 16 Berchem TOT
54,Posthofbrug 5366,2023-06-07,04:00:00,21,12,9,FMN GV 16 Berchem TOT
54,Posthofbrug 5366,2023-06-07,05:00:00,36,27,9,FMN GV 16 Berchem TOT
54,Posthofbrug 5366,2023-06-07,06:00:00,142,115,27,FMN GV 16 Berchem TOT
54,Posthofbrug 5366,2023-06-07,07:00:00,545,419,126,FMN GV 16 Berchem TOT
54,Posthofbrug 5366,2023-06-07,08:00:00,867,665,202,FMN GV 16 Berchem TOT
54,Posthofbrug 5366,2023-06-07,09:00:00,288,220,68,FMN GV 16 Berchem TOT
54,Posthofbrug 5366,2023-06-07,10:00:00,213,140,73,FMN GV 16 Berchem TOT
54,Posthofbrug 5366,2023-06-07,11:00:00,183,113,70,FMN GV 16 Berchem TOT
54,Posthofbrug 5366,2023-06-07,12:00:00,385,171,214,FMN GV 16 Berchem TOT
54,Posthofbrug 5366,2023-06-07,13:00:00,300,136,164,FMN GV 16 Berchem TOT
54,Posthofbrug 5366,2023-06-07,14:00:00,238,102,136,FMN GV 16 Berchem TOT
54,Posthofbrug 5366,2023-06-07,15:00:00,276,105,171,FMN GV 16 Berchem TOT
54,Posthofbrug 5366,2023-06-07,16:00:00,470,164,306,FMN GV 16 Berchem TOT
54,Posthofbrug 5366,2023-06-07,17:00:00,662,224,438,FMN GV 16 Berchem TOT
54,Posthofbrug 5366,2023-06-07,18:00:00,482,191,291,FMN GV 16 Berchem TOT
54,Posthofbrug 5366,2023-06-07,19:00:00,259,110,149,FMN GV 16 Berchem TOT
54,Posthofbrug 5366,2023-06-07,20:00:00,176,90,86,FMN GV 16 Berchem TOT
54,Posthofbrug 5366,2023-06-07,21:00:00,134,70,64,FMN GV 16 Berchem TOT
54,Posthofbrug 5366,2023-06-07,22:00:00,172,59,113,FMN GV 16 Berchem TOT
54,Posthofbrug 5366,2023-06-07,23:00:00,76,25,51,FMN GV 16 Berchem TOT
54,Posthofbrug 5366,2023-06-08,00:00:00,33,10,23,FMN GV 16 Berchem TOT
54,Posthofbrug 5366,2023-06-08,01:00:00,14,1,13,FMN GV 16 Berchem TOT
54,Posthofbrug 5366,2023-06-08,02:00:00,6,0,6,FMN GV 16 Berchem TOT
54,Posthofbrug 5366,2023-06-08,03:00:00,1,1,0,FMN GV 16 Berchem TOT
54,Posthofbrug 5366,2023-06-08,04:00:00,14,6,8,FMN GV 16 Berchem TOT
54,Posthofbrug 5366,2023-06-08,05:00:00,41,31,10,FMN GV 16 Berchem TOT
54,Posthofbrug 5366,2023-06-08,06:00:00,159,124,35,FMN GV 16 Berchem TOT
54,Posthofbrug 5366,2023-06-08,07:00:00,624,477,147,FMN GV 16 Berchem TOT
54,Posthofbrug 5366,2023-06-08,08:00:00,1107,895,212,FMN GV 16 Berchem TOT
54,Posthofbrug 5366,2023-06-08,09:00:00,370,295,75,FMN GV 16 Berchem TOT
54,Posthofbrug 5366,2023-06-08,10:00:00,181,132,49,FMN GV 16 Berchem TOT
54,Posthofbrug 5366,2023-06-08,11:00:00,217,133,84,FMN GV 16 Berchem TOT
54,Posthofbrug 5366,2023-06-08,12:00:00,245,118,127,FMN GV 16 Berchem TOT
54,Posthofbrug 5366,2023-06-08,13:00:00,230,121,109,FMN GV 16 Berchem TOT
54,Posthofbrug 5366,2023-06-08,14:00:00,222,103,119,FMN GV 16 Berchem TOT
54,Posthofbrug 5366,2023-06-08,15:00:00,390,134,256,FMN GV 16 Berchem TOT
54,Posthofbrug 5366,2023-06-08,16:00:00,613,214,399,FMN GV 16 Berchem TOT
54,Posthofbrug 5366,2023-06-08,17:00:00,773,236,537,FMN GV 16 Berchem TOT
54,Posthofbrug 5366,2023-06-08,18:00:00,529,190,339,FMN GV 16 Berchem TOT
54,Posthofbrug 5366,2023-06-08,19:00:00,315,120,195,FMN GV 16 Berchem TOT
54,Posthofbrug 5366,2023-06-08,20:00:00,200,89,111,FMN GV 16 Berchem TOT
54,Posthofbrug 5366,2023-06-08,21:00:00,184,70,114,FMN GV 16 Berchem TOT
54,Posthofbrug 5366,2023-06-08,22:00:00,152,51,101,FMN GV 16 Berchem TOT
54,Posthofbrug 5366,2023-06-08,23:00:00,116,31,85,FMN GV 16 Berchem TOT
54,Posthofbrug 5366,2023-06-09,00:00:00,59,16,43,FMN GV 16 Berchem TOT
54,Posthofbrug 5366,2023-06-09,01:00:00,21,7,14,FMN GV 16 Berchem TOT
54,Posthofbrug 5366,2023-06-09,02:00:00,5,2,3,FMN GV 16 Berchem TOT
54,Posthofbrug 5366,2023-06-09,03:00:00,2,0,2,FMN GV 16 Berchem TOT
54,Posthofbrug 5366,2023-06-09,04:00:00,16,7,9,FMN GV 16 Berchem TOT
54,Posthofbrug 5366,2023-06-09,05:00:00,45,30,15,FMN GV 16 Berchem TOT
54,Posthofbrug 5366,2023-06-09,06:00:00,118,93,25,FMN GV 16 Berchem TOT
54,Posthofbrug 5366,2023-06-09,07:00:00,502,379,123,FMN GV 16 Berchem TOT
54,Posthofbrug 5366,2023-06-09,08:00:00,881,686,195,FMN GV 16 Berchem TOT
54,Posthofbrug 5366,2023-06-09,09:00:00,318,242,76,FMN GV 16 Berchem TOT
54,Posthofbrug 5366,2023-06-09,10:00:00,200,141,59,FMN GV 16 Berchem TOT
54,Posthofbrug 5366,2023-06-09,11:00:00,224,132,92,FMN GV 16 Berchem TOT
54,Posthofbrug 5366,2023-06-09,12:00:00,296,147,149,FMN GV 16 Berchem TOT
54,Posthofbrug 5366,2023-06-09,13:00:00,253,127,126,FMN GV 16 Berchem TOT
54,Posthofbrug 5366,2023-06-09,14:00:00,266,101,165,FMN GV 16 Berchem TOT
54,Posthofbrug 5366,2023-06-09,15:00:00,410,128,282,FMN GV 16 Berchem TOT
54,Posthofbrug 5366,2023-06-09,16:00:00,539,198,341,FMN GV 16 Berchem TOT
54,Posthofbrug 5366,2023-06-09,17:00:00,625,246,379,FMN GV 16 Berchem TOT
54,Posthofbrug 5366,2023-06-09,18:00:00,416,207,209,FMN GV 16 Berchem TOT
54,Posthofbrug 5366,2023-06-09,19:00:00,239,112,127,FMN GV 16 Berchem TOT
54,Posthofbrug 5366,2023-06-09,20:00:00,198,90,108,FMN GV 16 Berchem TOT
54,Posthofbrug 5366,2023-06-09,21:00:00,150,57,93,FMN GV 16 Berchem TOT
54,Posthofbrug 5366,2023-06-09,22:00:00,154,48,106,FMN GV 16 Berchem TOT
54,Posthofbrug 5366,2023-06-09,23:00:00,145,46,99,FMN GV 16 Berchem TOT
54,Posthofbrug 5366,2023-06-10,00:00:00,117,36,81,FMN GV 16 Berchem TOT
54,Posthofbrug 5366,2023-06-10,01:00:00,56,13,43,FMN GV 16 Berchem TOT
54,Posthofbrug 5366,2023-06-10,02:00:00,37,4,33,FMN GV 16 Berchem TOT
54,Posthofbrug 5366,2023-06-10,03:00:00,12,3,9,FMN GV 16 Berchem TOT
54,Posthofbrug 5366,2023-06-10,04:00:00,21,7,14,FMN GV 16 Berchem TOT
54,Posthofbrug 5366,2023-06-10,05:00:00,12,8,4,FMN GV 16 Berchem TOT
54,Posthofbrug 5366,2023-06-10,06:00:00,24,18,6,FMN GV 16 Berchem TOT
54,Posthofbrug 5366,2023-06-10,07:00:00,58,38,20,FMN GV 16 Berchem TOT
54,Posthofbrug 5366,2023-06-10,08:00:00,81,52,29,FMN GV 16 Berchem TOT
54,Posthofbrug 5366,2023-06-10,09:00:00,229,157,72,FMN GV 16 Berchem TOT
54,Posthofbrug 5366,2023-06-10,10:00:00,261,182,79,FMN GV 16 Berchem TOT
54,Posthofbrug 5366,2023-06-10,11:00:00,236,125,111,FMN GV 16 Berchem TOT
54,Posthofbrug 5366,2023-06-10,12:00:00,234,126,108,FMN GV 16 Berchem TOT
54,Posthofbrug 5366,2023-06-10,13:00:00,281,149,132,FMN GV 16 Berchem TOT
54,Posthofbrug 5366,2023-06-10,14:00:00,274,156,118,FMN GV 16 Berchem TOT
54,Posthofbrug 5366,2023-06-10,15:00:00,234,103,131,FMN GV 16 Berchem TOT
54,Posthofbrug 5366,2023-06-10,16:00:00,241,116,125,FMN GV 16 Berchem TOT
54,Posthofbrug 5366,2023-06-10,17:00:00,248,121,127,FMN GV 16 Berchem TOT
54,Posthofbrug 5366,2023-06-10,18:00:00,243,130,113,FMN GV 16 Berchem TOT
54,Posthofbrug 5366,2023-06-10,19:00:00,171,112,59,FMN GV 16 Berchem TOT
54,Posthofbrug 5366,2023-06-10,20:00:00,157,78,79,FMN GV 16 Berchem TOT
54,Posthofbrug 5366,2023-06-10,21:00:00,117,51,66,FMN GV 16 Berchem TOT
54,Posthofbrug 5366,2023-06-10,22:00:00,115,43,72,FMN GV 16 Berchem TOT
54,Posthofbrug 5366,2023-06-10,23:00:00,164,64,100,FMN GV 16 Berchem TOT
54,Posthofbrug 5366,2023-06-11,00:00:00,119,23,96,FMN GV 16 Berchem TOT
54,Posthofbrug 5366,2023-06-11,01:00:00,63,32,31,FMN GV 16 Berchem TOT
54,Posthofbrug 5366,2023-06-11,02:00:00,49,21,28,FMN GV 16 Berchem TOT
54,Posthofbrug 5366,2023-06-11,03:00:00,43,9,34,FMN GV 16 Berchem TOT
54,Posthofbrug 5366,2023-06-11,04:00:00,15,3,12,FMN GV 16 Berchem TOT
54,Posthofbrug 5366,2023-06-11,05:00:00,9,5,4,FMN GV 16 Berchem TOT
54,Posthofbrug 5366,2023-06-11,06:00:00,28,17,11,FMN GV 16 Berchem TOT
54,Posthofbrug 5366,2023-06-11,07:00:00,44,23,21,FMN GV 16 Berchem TOT
54,Posthofbrug 5366,2023-06-11,08:00:00,107,72,35,FMN GV 16 Berchem TOT
54,Posthofbrug 5366,2023-06-11,09:00:00,170,93,77,FMN GV 16 Berchem TOT
54,Posthofbrug 5366,2023-06-11,10:00:00,213,127,86,FMN GV 16 Berchem TOT
54,Posthofbrug 5366,2023-06-11,11:00:00,202,113,89,FMN GV 16 Berchem TOT
54,Posthofbrug 5366,2023-06-11,12:00:00,201,112,89,FMN GV 16 Berchem TOT
54,Posthofbrug 5366,2023-06-11,13:00:00,205,90,115,FMN GV 16 Berchem TOT
54,Posthofbrug 5366,2023-06-11,14:00:00,209,115,94,FMN GV 16 Berchem TOT
54,Posthofbrug 5366,2023-06-11,15:00:00,180,94,86,FMN GV 16 Berchem TOT
54,Posthofbrug 5366,2023-06-11,16:00:00,177,81,96,FMN GV 16 Berchem TOT
54,Posthofbrug 5366,2023-06-11,17:00:00,188,104,84,FMN GV 16 Berchem TOT
54,Posthofbrug 5366,2023-06-11,18:00:00,172,98,74,FMN GV 16 Berchem TOT
54,Posthofbrug 5366,2023-06-11,19:00:00,145,79,66,FMN GV 16 Berchem TOT
54,Posthofbrug 5366,2023-06-11,20:00:00,137,70,67,FMN GV 16 Berchem TOT
54,Posthofbrug 5366,2023-06-11,21:00:00,143,60,83,FMN GV 16 Berchem TOT
54,Posthofbrug 5366,2023-06-11,22:00:00,73,32,41,FMN GV 16 Berchem TOT
54,Posthofbrug 5366,2023-06-11,23:00:00,40,17,23,FMN GV 16 Berchem TOT
54,Posthofbrug 5366,2023-06-12,00:00:00,25,10,15,FMN GV 16 Berchem TOT
54,Posthofbrug 5366,2023-06-12,01:00:00,9,2,7,FMN GV 16 Berchem TOT
54,Posthofbrug 5366,2023-06-12,02:00:00,7,1,6,FMN GV 16 Berchem TOT
54,Posthofbrug 5366,2023-06-12,03:00:00,6,3,3,FMN GV 16 Berchem TOT
54,Posthofbrug 5366,2023-06-12,04:00:00,14,9,5,FMN GV 16 Berchem TOT
54,Posthofbrug 5366,2023-06-12,05:00:00,39,28,11,FMN GV 16 Berchem TOT
54,Posthofbrug 5366,2023-06-12,06:00:00,169,132,37,FMN GV 16 Berchem TOT
54,Posthofbrug 5366,2023-06-12,07:00:00,595,473,122,FMN GV 16 Berchem TOT
54,Posthofbrug 5366,2023-06-12,08:00:00,1049,849,200,FMN GV 16 Berchem TOT
54,Posthofbrug 5366,2023-06-12,09:00:00,353,268,85,FMN GV 16 Berchem TOT
54,Posthofbrug 5366,2023-06-12,10:00:00,196,120,76,FMN GV 16 Berchem TOT
54,Posthofbrug 5366,2023-06-12,11:00:00,172,102,70,FMN GV 16 Berchem TOT
54,Posthofbrug 5366,2023-06-12,12:00:00,262,117,145,FMN GV 16 Berchem TOT
54,Posthofbrug 5366,2023-06-12,13:00:00,189,95,94,FMN GV 16 Berchem TOT
54,Posthofbrug 5366,2023-06-12,14:00:00,208,84,124,FMN GV 16 Berchem TOT
54,Posthofbrug 5366,2023-06-12,15:00:00,322,97,225,FMN GV 16 Berchem TOT
54,Posthofbrug 5366,2023-06-12,16:00:00,564,152,412,FMN GV 16 Berchem TOT
54,Posthofbrug 5366,2023-06-12,17:00:00,721,198,523,FMN GV 16 Berchem TOT
54,Posthofbrug 5366,2023-06-12,18:00:00,460,144,316,FMN GV 16 Berchem TOT
54,Posthofbrug 5366,2023-06-12,19:00:00,231,93,138,FMN GV 16 Berchem TOT
54,Posthofbrug 5366,2023-06-12,20:00:00,146,75,71,FMN GV 16 Berchem TOT
54,Posthofbrug 5366,2023-06-12,21:00:00,140,60,80,FMN GV 16 Berchem TOT
54,Posthofbrug 5366,2023-06-12,22:00:00,115,50,65,FMN GV 16 Berchem TOT
54,Posthofbrug 5366,2023-06-12,23:00:00,52,19,33,FMN GV 16 Berchem TOT
54,Posthofbrug 5366,2023-06-13,00:00:00,30,7,23,FMN GV 16 Berchem TOT
54,Posthofbrug 5366,2023-06-13,01:00:00,8,3,5,FMN GV 16 Berchem TOT
54,Posthofbrug 5366,2023-06-13,02:00:00,4,0,4,FMN GV 16 Berchem TOT
54,Posthofbrug 5366,2023-06-13,03:00:00,7,3,4,FMN GV 16 Berchem TOT
54,Posthofbrug 5366,2023-06-13,04:00:00,18,11,7,FMN GV 16 Berchem TOT
54,Posthofbrug 5366,2023-06-13,05:00:00,62,45,17,FMN GV 16 Berchem TOT
54,Posthofbrug 5366,2023-06-13,06:00:00,169,132,37,FMN GV 16 Berchem TOT
54,Posthofbrug 5366,2023-06-13,07:00:00,689,534,155,FMN GV 16 Berchem TOT
54,Posthofbrug 5366,2023-06-13,08:00:00,1156,905,251,FMN GV 16 Berchem TOT
54,Posthofbrug 5366,2023-06-13,09:00:00,381,277,104,FMN GV 16 Berchem TOT
54,Posthofbrug 5366,2023-06-13,10:00:00,203,146,57,FMN GV 16 Berchem TOT
54,Posthofbrug 5366,2023-06-13,11:00:00,212,120,92,FMN GV 16 Berchem TOT
54,Posthofbrug 5366,2023-06-13,12:00:00,284,135,149,FMN GV 16 Berchem TOT
54,Posthofbrug 5366,2023-06-13,13:00:00,228,105,123,FMN GV 16 Berchem TOT
54,Posthofbrug 5366,2023-06-13,14:00:00,209,83,126,FMN GV 16 Berchem TOT
54,Posthofbrug 5366,2023-06-13,15:00:00,332,118,214,FMN GV 16 Berchem TOT
54,Posthofbrug 5366,2023-06-13,16:00:00,614,161,453,FMN GV 16 Berchem TOT
54,Posthofbrug 5366,2023-06-13,17:00:00,826,228,598,FMN GV 16 Berchem TOT
54,Posthofbrug 5366,2023-06-13,18:00:00,519,171,348,FMN GV 16 Berchem TOT
54,Posthofbrug 5366,2023-06-13,19:00:00,273,125,148,FMN GV 16 Berchem TOT
54,Posthofbrug 5366,2023-06-13,20:00:00,201,98,103,FMN GV 16 Berchem TOT
54,Posthofbrug 5366,2023-06-13,21:00:00,182,103,79,FMN GV 16 Berchem TOT
54,Posthofbrug 5366,2023-06-13,22:00:00,162,51,111,FMN GV 16 Berchem TOT
54,Posthofbrug 5366,2023-06-13,23:00:00,73,23,50,FMN GV 16 Berchem TOT
54,Posthofbrug 5366,2023-06-14,00:00:00,49,12,37,FMN GV 16 Berchem TOT
54,Posthofbrug 5366,2023-06-14,01:00:00,8,0,8,FMN GV 16 Berchem TOT
54,Posthofbrug 5366,2023-06-14,02:00:00,4,3,1,FMN GV 16 Berchem TOT
54,Posthofbrug 5366,2023-06-14,03:00:00,6,2,4,FMN GV 16 Berchem TOT
54,Posthofbrug 5366,2023-06-14,04:00:00,19,12,7,FMN GV 16 Berchem TOT
54,Posthofbrug 5366,2023-06-14,05:00:00,46,34,12,FMN GV 16 Berchem TOT
54,Posthofbrug 5366,2023-06-14,06:00:00,166,121,45,FMN GV 16 Berchem TOT
54,Posthofbrug 5366,2023-06-14,07:00:00,551,415,136,FMN GV 16 Berchem TOT
54,Posthofbrug 5366,2023-06-14,08:00:00,925,691,234,FMN GV 16 Berchem TOT
54,Posthofbrug 5366,2023-06-14,09:00:00,353,245,108,FMN GV 16 Berchem TOT
54,Posthofbrug 5366,2023-06-14,10:00:00,232,144,88,FMN GV 16 Berchem TOT
54,Posthofbrug 5366,2023-06-14,11:00:00,202,106,96,FMN GV 16 Berchem TOT
54,Posthofbrug 5366,2023-06-14,12:00:00,379,161,218,FMN GV 16 Berchem TOT
54,Posthofbrug 5366,2023-06-14,13:00:00,277,125,152,FMN GV 16 Berchem TOT
54,Posthofbrug 5366,2023-06-14,14:00:00,228,103,125,FMN GV 16 Berchem TOT
54,Posthofbrug 5366,2023-06-14,15:00:00,288,123,165,FMN GV 16 Berchem TOT
54,Posthofbrug 5366,2023-06-14,16:00:00,449,138,311,FMN GV 16 Berchem TOT
54,Posthofbrug 5366,2023-06-14,17:00:00,664,227,437,FMN GV 16 Berchem TOT
54,Posthofbrug 5366,2023-06-14,18:00:00,471,175,296,FMN GV 16 Berchem TOT
54,Posthofbrug 5366,2023-06-14,19:00:00,279,123,156,FMN GV 16 Berchem TOT
54,Posthofbrug 5366,2023-06-14,20:00:00,187,91,96,FMN GV 16 Berchem TOT
54,Posthofbrug 5366,2023-06-14,21:00:00,187,94,93,FMN GV 16 Berchem TOT
54,Posthofbrug 5366,2023-06-14,22:00:00,161,70,91,FMN GV 16 Berchem TOT
54,Posthofbrug 5366,2023-06-14,23:00:00,107,36,71,FMN GV 16 Berchem TOT
54,Posthofbrug 5366,2023-06-15,00:00:00,50,18,32,FMN GV 16 Berchem TOT
54,Posthofbrug 5366,2023-06-15,01:00:00,15,3,12,FMN GV 16 Berchem TOT
54,Posthofbrug 5366,2023-06-15,02:00:00,2,0,2,FMN GV 16 Berchem TOT
54,Posthofbrug 5366,2023-06-15,03:00:00,2,0,2,FMN GV 16 Berchem TOT
54,Posthofbrug 5366,2023-06-15,04:00:00,18,12,6,FMN GV 16 Berchem TOT
54,Posthofbrug 5366,2023-06-15,05:00:00,58,42,16,FMN GV 16 Berchem TOT
54,Posthofbrug 5366,2023-06-15,06:00:00,174,128,46,FMN GV 16 Berchem TOT
54,Posthofbrug 5366,2023-06-15,07:00:00,618,498,120,FMN GV 16 Berchem TOT
54,Posthofbrug 5366,2023-06-15,08:00:00,1124,884,240,FMN GV 16 Berchem TOT
54,Posthofbrug 5366,2023-06-15,09:00:00,369,265,104,FMN GV 16 Berchem TOT
54,Posthofbrug 5366,2023-06-15,10:00:00,235,158,77,FMN GV 16 Berchem TOT
54,Posthofbrug 5366,2023-06-15,11:00:00,212,129,83,FMN GV 16 Berchem TOT
54,Posthofbrug 5366,2023-06-15,12:00:00,265,133,132,FMN GV 16 Berchem TOT
54,Posthofbrug 5366,2023-06-15,13:00:00,244,120,124,FMN GV 16 Berchem TOT
54,Posthofbrug 5366,2023-06-15,14:00:00,234,74,160,FMN GV 16 Berchem TOT
54,Posthofbrug 5366,2023-06-15,15:00:00,351,129,222,FMN GV 16 Berchem TOT
54,Posthofbrug 5366,2023-06-15,16:00:00,624,192,432,FMN GV 16 Berchem TOT
54,Posthofbrug 5366,2023-06-15,17:00:00,770,247,523,FMN GV 16 Berchem TOT
54,Posthofbrug 5366,2023-06-15,18:00:00,485,168,317,FMN GV 16 Berchem TOT
54,Posthofbrug 5366,2023-06-15,19:00:00,259,107,152,FMN GV 16 Berchem TOT
54,Posthofbrug 5366,2023-06-15,20:00:00,208,91,117,FMN GV 16 Berchem TOT
54,Posthofbrug 5366,2023-06-15,21:00:00,208,89,119,FMN GV 16 Berchem TOT
54,Posthofbrug 5366,2023-06-15,22:00:00,152,67,85,FMN GV 16 Berchem TOT
54,Posthofbrug 5366,2023-06-15,23:00:00,121,36,85,FMN GV 16 Berchem TOT
54,Posthofbrug 5366,2023-06-16,00:00:00,57,13,44,FMN GV 16 Berchem TOT
54,Posthofbrug 5366,2023-06-16,01:00:00,26,4,22,FMN GV 16 Berchem TOT
54,Posthofbrug 5366,2023-06-16,02:00:00,11,1,10,FMN GV 16 Berchem TOT
54,Posthofbrug 5366,2023-06-16,03:00:00,6,1,5,FMN GV 16 Berchem TOT
54,Posthofbrug 5366,2023-06-16,04:00:00,24,15,9,FMN GV 16 Berchem TOT
54,Posthofbrug 5366,2023-06-16,05:00:00,39,25,14,FMN GV 16 Berchem TOT
54,Posthofbrug 5366,2023-06-16,06:00:00,154,115,39,FMN GV 16 Berchem TOT
54,Posthofbrug 5366,2023-06-16,07:00:00,503,393,110,FMN GV 16 Berchem TOT
54,Posthofbrug 5366,2023-06-16,08:00:00,845,686,159,FMN GV 16 Berchem TOT
54,Posthofbrug 5366,2023-06-16,09:00:00,340,249,91,FMN GV 16 Berchem TOT
54,Posthofbrug 5366,2023-06-16,10:00:00,229,149,80,FMN GV 16 Berchem TOT
54,Posthofbrug 5366,2023-06-16,11:00:00,260,149,111,FMN GV 16 Berchem TOT
54,Posthofbrug 5366,2023-06-16,12:00:00,310,150,160,FMN GV 16 Berchem TOT
54,Posthofbrug 5366,2023-06-16,13:00:00,267,126,141,FMN GV 16 Berchem TOT
54,Posthofbrug 5366,2023-06-16,14:00:00,280,112,168,FMN GV 16 Berchem TOT
54,Posthofbrug 5366,2023-06-16,15:00:00,359,135,224,FMN GV 16 Berchem TOT
54,Posthofbrug 5366,2023-06-16,16:00:00,571,207,364,FMN GV 16 Berchem TOT
54,Posthofbrug 5366,2023-06-16,17:00:00,557,195,362,FMN GV 16 Berchem TOT
54,Posthofbrug 5366,2023-06-16,18:00:00,418,183,235,FMN GV 16 Berchem TOT
54,Posthofbrug 5366,2023-06-16,19:00:00,310,148,162,FMN GV 16 Berchem TOT
54,Posthofbrug 5366,2023-06-16,20:00:00,161,87,74,FMN GV 16 Berchem TOT
54,Posthofbrug 5366,2023-06-16,21:00:00,148,72,76,FMN GV 16 Berchem TOT
54,Posthofbrug 5366,2023-06-16,22:00:00,140,55,85,FMN GV 16 Berchem TOT
54,Posthofbrug 5366,2023-06-16,23:00:00,152,51,101,FMN GV 16 Berchem TOT
54,Posthofbrug 5366,2023-06-17,00:00:00,113,36,77,FMN GV 16 Berchem TOT
54,Posthofbrug 5366,2023-06-17,01:00:00,69,19,50,FMN GV 16 Berchem TOT
54,Posthofbrug 5366,2023-06-17,02:00:00,35,5,30,FMN GV 16 Berchem TOT
54,Posthofbrug 5366,2023-06-17,03:00:00,20,3,17,FMN GV 16 Berchem TOT
54,Posthofbrug 5366,2023-06-17,04:00:00,29,9,20,FMN GV 16 Berchem TOT
54,Posthofbrug 5366,2023-06-17,05:00:00,26,13,13,FMN GV 16 Berchem TOT
54,Posthofbrug 5366,2023-06-17,06:00:00,34,25,9,FMN GV 16 Berchem TOT
54,Posthofbrug 5366,2023-06-17,07:00:00,54,31,23,FMN GV 16 Berchem TOT
54,Posthofbrug 5366,2023-06-17,08:00:00,101,69,32,FMN GV 16 Berchem TOT
54,Posthofbrug 5366,2023-06-17,09:00:00,213,119,94,FMN GV 16 Berchem TOT
54,Posthofbrug 5366,2023-06-17,10:00:00,238,149,89,FMN GV 16 Berchem TOT
54,Posthofbrug 5366,2023-06-17,11:00:00,219,136,83,FMN GV 16 Berchem TOT
54,Posthofbrug 5366,2023-06-17,12:00:00,245,145,100,FMN GV 16 Berchem TOT
54,Posthofbrug 5366,2023-06-17,13:00:00,233,106,127,FMN GV 16 Berchem TOT
54,Posthofbrug 5366,2023-06-17,14:00:00,237,136,101,FMN GV 16 Berchem TOT
54,Posthofbrug 5366,2023-06-17,15:00:00,230,116,114,FMN GV 16 Berchem TOT
54,Posthofbrug 5366,2023-06-17,16:00:00,248,111,137,FMN GV 16 Berchem TOT
54,Posthofbrug 5366,2023-06-17,17:00:00,207,90,117,FMN GV 16 Berchem TOT
54,Posthofbrug 5366,2023-06-17,18:00:00,262,154,108,FMN GV 16 Berchem TOT
54,Posthofbrug 5366,2023-06-17,19:00:00,165,81,84,FMN GV 16 Berchem TOT
54,Posthofbrug 5366,2023-06-17,20:00:00,171,92,79,FMN GV 16 Berchem TOT
54,Posthofbrug 5366,2023-06-17,21:00:00,132,73,59,FMN GV 16 Berchem TOT
54,Posthofbrug 5366,2023-06-17,22:00:00,94,47,47,FMN GV 16 Berchem TOT
54,Posthofbrug 5366,2023-06-17,23:00:00,121,42,79,FMN GV 16 Berchem TOT
54,Posthofbrug 5366,2023-06-18,00:00:00,95,25,70,FMN GV 16 Berchem TOT
54,Posthofbrug 5366,2023-06-18,01:00:00,51,23,28,FMN GV 16 Berchem TOT
54,Posthofbrug 5366,2023-06-18,02:00:00,32,4,28,FMN GV 16 Berchem TOT
54,Posthofbrug 5366,2023-06-18,03:00:00,31,8,23,FMN GV 16 Berchem TOT
54,Posthofbrug 5366,2023-06-18,04:00:00,27,7,20,FMN GV 16 Berchem TOT
54,Posthofbrug 5366,2023-06-18,05:00:00,22,11,11,FMN GV 16 Berchem TOT
54,Posthofbrug 5366,2023-06-18,06:00:00,17,10,7,FMN GV 16 Berchem TOT
54,Posthofbrug 5366,2023-06-18,07:00:00,53,25,28,FMN GV 16 Berchem TOT
54,Posthofbrug 5366,2023-06-18,08:00:00,79,52,27,FMN GV 16 Berchem TOT
54,Posthofbrug 5366,2023-06-18,09:00:00,94,51,43,FMN GV 16 Berchem TOT
54,Posthofbrug 5366,2023-06-18,10:00:00,97,64,33,FMN GV 16 Berchem TOT
54,Posthofbrug 5366,2023-06-18,11:00:00,93,45,48,FMN GV 16 Berchem TOT
54,Posthofbrug 5366,2023-06-18,12:00:00,140,69,71,FMN GV 16 Berchem TOT
54,Posthofbrug 5366,2023-06-18,13:00:00,202,105,97,FMN GV 16 Berchem TOT
54,Posthofbrug 5366,2023-06-18,14:00:00,183,114,69,FMN GV 16 Berchem TOT
54,Posthofbrug 5366,2023-06-18,15:00:00,172,109,63,FMN GV 16 Berchem TOT
54,Posthofbrug 5366,2023-06-18,16:00:00,182,82,100,FMN GV 16 Berchem TOT
54,Posthofbrug 5366,2023-06-18,17:00:00,209,89,120,FMN GV 16 Berchem TOT
54,Posthofbrug 5366,2023-06-18,18:00:00,140,77,63,FMN GV 16 Berchem TOT
54,Posthofbrug 5366,2023-06-18,19:00:00,144,80,64,FMN GV 16 Berchem TOT
54,Posthofbrug 5366,2023-06-18,20:00:00,114,48,66,FMN GV 16 Berchem TOT
54,Posthofbrug 5366,2023-06-18,21:00:00,96,47,49,FMN GV 16 Berchem TOT
54,Posthofbrug 5366,2023-06-18,22:00:00,101,42,59,FMN GV 16 Berchem TOT
54,Posthofbrug 5366,2023-06-18,23:00:00,40,13,27,FMN GV 16 Berchem TOT
54,Posthofbrug 5366,2023-06-19,00:00:00,15,7,8,FMN GV 16 Berchem TOT
54,Posthofbrug 5366,2023-06-19,01:00:00,4,0,4,FMN GV 16 Berchem TOT
54,Posthofbrug 5366,2023-06-19,02:00:00,4,2,2,FMN GV 16 Berchem TOT
54,Posthofbrug 5366,2023-06-19,03:00:00,14,4,10,FMN GV 16 Berchem TOT
54,Posthofbrug 5366,2023-06-19,04:00:00,18,11,7,FMN GV 16 Berchem TOT
54,Posthofbrug 5366,2023-06-19,05:00:00,40,32,8,FMN GV 16 Berchem TOT
54,Posthofbrug 5366,2023-06-19,06:00:00,147,106,41,FMN GV 16 Berchem TOT
54,Posthofbrug 5366,2023-06-19,07:00:00,598,459,139,FMN GV 16 Berchem TOT
54,Posthofbrug 5366,2023-06-19,08:00:00,1069,861,208,FMN GV 16 Berchem TOT
54,Posthofbrug 5366,2023-06-19,09:00:00,324,241,83,FMN GV 16 Berchem TOT
54,Posthofbrug 5366,2023-06-19,10:00:00,192,113,79,FMN GV 16 Berchem TOT
54,Posthofbrug 5366,2023-06-19,11:00:00,206,115,91,FMN GV 16 Berchem TOT
54,Posthofbrug 5366,2023-06-19,12:00:00,269,132,137,FMN GV 16 Berchem TOT
54,Posthofbrug 5366,2023-06-19,13:00:00,247,132,115,FMN GV 16 Berchem TOT
54,Posthofbrug 5366,2023-06-19,14:00:00,219,84,135,FMN GV 16 Berchem TOT
54,Posthofbrug 5366,2023-06-19,15:00:00,315,118,197,FMN GV 16 Berchem TOT
54,Posthofbrug 5366,2023-06-19,16:00:00,511,129,382,FMN GV 16 Berchem TOT
54,Posthofbrug 5366,2023-06-19,17:00:00,774,219,555,FMN GV 16 Berchem TOT
54,Posthofbrug 5366,2023-06-19,18:00:00,450,131,319,FMN GV 16 Berchem TOT
54,Posthofbrug 5366,2023-06-19,19:00:00,229,83,146,FMN GV 16 Berchem TOT
54,Posthofbrug 5366,2023-06-19,20:00:00,166,78,88,FMN GV 16 Berchem TOT
54,Posthofbrug 5366,2023-06-19,21:00:00,145,66,79,FMN GV 16 Berchem TOT
54,Posthofbrug 5366,2023-06-19,22:00:00,141,61,80,FMN GV 16 Berchem TOT
54,Posthofbrug 5366,2023-06-19,23:00:00,53,9,44,FMN GV 16 Berchem TOT
54,Posthofbrug 5366,2023-06-20,00:00:00,25,8,17,FMN GV 16 Berchem TOT
54,Posthofbrug 5366,2023-06-20,01:00:00,5,3,2,FMN GV 16 Berchem TOT
54,Posthofbrug 5366,2023-06-20,02:00:00,7,1,6,FMN GV 16 Berchem TOT
54,Posthofbrug 5366,2023-06-20,03:00:00,7,3,4,FMN GV 16 Berchem TOT
54,Posthofbrug 5366,2023-06-20,04:00:00,12,5,7,FMN GV 16 Berchem TOT
54,Posthofbrug 5366,2023-06-20,05:00:00,48,37,11,FMN GV 16 Berchem TOT
54,Posthofbrug 5366,2023-06-20,06:00:00,157,119,38,FMN GV 16 Berchem TOT
54,Posthofbrug 5366,2023-06-20,07:00:00,630,485,145,FMN GV 16 Berchem TOT
54,Posthofbrug 5366,2023-06-20,08:00:00,1136,886,250,FMN GV 16 Berchem TOT
54,Posthofbrug 5366,2023-06-20,09:00:00,361,256,105,FMN GV 16 Berchem TOT
54,Posthofbrug 5366,2023-06-20,10:00:00,217,147,70,FMN GV 16 Berchem TOT
54,Posthofbrug 5366,2023-06-20,11:00:00,217,123,94,FMN GV 16 Berchem TOT
54,Posthofbrug 5366,2023-06-20,12:00:00,319,159,160,FMN GV 16 Berchem TOT
54,Posthofbrug 5366,2023-06-20,13:00:00,249,122,127,FMN GV 16 Berchem TOT
54,Posthofbrug 5366,2023-06-20,14:00:00,188,75,113,FMN GV 16 Berchem TOT
54,Posthofbrug 5366,2023-06-20,15:00:00,373,114,259,FMN GV 16 Berchem TOT
54,Posthofbrug 5366,2023-06-20,16:00:00,634,181,453,FMN GV 16 Berchem TOT
54,Posthofbrug 5366,2023-06-20,17:00:00,619,202,417,FMN GV 16 Berchem TOT
54,Posthofbrug 5366,2023-06-20,18:00:00,330,102,228,FMN GV 16 Berchem TOT
54,Posthofbrug 5366,2023-06-20,19:00:00,169,68,101,FMN GV 16 Berchem TOT
54,Posthofbrug 5366,2023-06-20,20:00:00,87,26,61,FMN GV 16 Berchem TOT
54,Posthofbrug 5366,2023-06-20,21:00:00,80,30,50,FMN GV 16 Berchem TOT
54,Posthofbrug 5366,2023-06-20,22:00:00,93,26,67,FMN GV 16 Berchem TOT
54,Posthofbrug 5366,2023-06-20,23:00:00,45,10,35,FMN GV 16 Berchem TOT
54,Posthofbrug 5366,2023-06-21,00:00:00,20,5,15,FMN GV 16 Berchem TOT
54,Posthofbrug 5366,2023-06-21,01:00:00,12,2,10,FMN GV 16 Berchem TOT
54,Posthofbrug 5366,2023-06-21,02:00:00,13,0,13,FMN GV 16 Berchem TOT
54,Posthofbrug 5366,2023-06-21,03:00:00,9,2,7,FMN GV 16 Berchem TOT
54,Posthofbrug 5366,2023-06-21,04:00:00,13,8,5,FMN GV 16 Berchem TOT
54,Posthofbrug 5366,2023-06-21,05:00:00,38,31,7,FMN GV 16 Berchem TOT
54,Posthofbrug 5366,2023-06-21,06:00:00,140,105,35,FMN GV 16 Berchem TOT
54,Posthofbrug 5366,2023-06-21,07:00:00,522,403,119,FMN GV 16 Berchem TOT
54,Posthofbrug 5366,2023-06-21,08:00:00,910,698,212,FMN GV 16 Berchem TOT
54,Posthofbrug 5366,2023-06-21,09:00:00,361,258,103,FMN GV 16 Berchem TOT
54,Posthofbrug 5366,2023-06-21,10:00:00,215,132,83,FMN GV 16 Berchem TOT
54,Posthofbrug 5366,2023-06-21,11:00:00,227,120,107,FMN GV 16 Berchem TOT
54,Posthofbrug 5366,2023-06-21,12:00:00,410,185,225,FMN GV 16 Berchem TOT
54,Posthofbrug 5366,2023-06-21,13:00:00,259,118,141,FMN GV 16 Berchem TOT
54,Posthofbrug 5366,2023-06-21,14:00:00,221,99,122,FMN GV 16 Berchem TOT
54,Posthofbrug 5366,2023-06-21,15:00:00,280,115,165,FMN GV 16 Berchem TOT
54,Posthofbrug 5366,2023-06-21,16:00:00,449,162,287,FMN GV 16 Berchem TOT
54,Posthofbrug 5366,2023-06-21,17:00:00,689,225,464,FMN GV 16 Berchem TOT
54,Posthofbrug 5366,2023-06-21,18:00:00,489,186,303,FMN GV 16 Berchem TOT
54,Posthofbrug 5366,2023-06-21,19:00:00,283,139,144,FMN GV 16 Berchem TOT
54,Posthofbrug 5366,2023-06-21,20:00:00,176,86,90,FMN GV 16 Berchem TOT
54,Posthofbrug 5366,2023-06-21,21:00:00,170,77,93,FMN GV 16 Berchem TOT
54,Posthofbrug 5366,2023-06-21,22:00:00,181,69,112,FMN GV 16 Berchem TOT
54,Posthofbrug 5366,2023-06-21,23:00:00,112,47,65,FMN GV 16 Berchem TOT
54,Posthofbrug 5366,2023-06-22,00:00:00,48,12,36,FMN GV 16 Berchem TOT
54,Posthofbrug 5366,2023-06-22,01:00:00,22,5,17,FMN GV 16 Berchem TOT
54,Posthofbrug 5366,2023-06-22,02:00:00,8,2,6,FMN GV 16 Berchem TOT
54,Posthofbrug 5366,2023-06-22,03:00:00,3,1,2,FMN GV 16 Berchem TOT
54,Posthofbrug 5366,2023-06-22,04:00:00,16,10,6,FMN GV 16 Berchem TOT
54,Posthofbrug 5366,2023-06-22,05:00:00,37,20,17,FMN GV 16 Berchem TOT
54,Posthofbrug 5366,2023-06-22,06:00:00,126,97,29,FMN GV 16 Berchem TOT
54,Posthofbrug 5366,2023-06-22,07:00:00,555,415,140,FMN GV 16 Berchem TOT
54,Posthofbrug 5366,2023-06-22,08:00:00,952,754,198,FMN GV 16 Berchem TOT
54,Posthofbrug 5366,2023-06-22,09:00:00,295,216,79,FMN GV 16 Berchem TOT
54,Posthofbrug 5366,2023-06-22,10:00:00,176,114,62,FMN GV 16 Berchem TOT
54,Posthofbrug 5366,2023-06-22,11:00:00,188,96,92,FMN GV 16 Berchem TOT
54,Posthofbrug 5366,2023-06-22,12:00:00,209,82,127,FMN GV 16 Berchem TOT
54,Posthofbrug 5366,2023-06-22,13:00:00,133,50,83,FMN GV 16 Berchem TOT
54,Posthofbrug 5366,2023-06-22,14:00:00,128,47,81,FMN GV 16 Berchem TOT
54,Posthofbrug 5366,2023-06-22,15:00:00,219,73,146,FMN GV 16 Berchem TOT
54,Posthofbrug 5366,2023-06-22,16:00:00,350,114,236,FMN GV 16 Berchem TOT
54,Posthofbrug 5366,2023-06-22,17:00:00,510,163,347,FMN GV 16 Berchem TOT
54,Posthofbrug 5366,2023-06-22,18:00:00,312,96,216,FMN GV 16 Berchem TOT
54,Posthofbrug 5366,2023-06-22,19:00:00,177,67,110,FMN GV 16 Berchem TOT
54,Posthofbrug 5366,2023-06-22,20:00:00,125,50,75,FMN GV 16 Berchem TOT
54,Posthofbrug 5366,2023-06-22,21:00:00,117,42,75,FMN GV 16 Berchem TOT
54,Posthofbrug 5366,2023-06-22,22:00:00,116,51,65,FMN GV 16 Berchem TOT
54,Posthofbrug 5366,2023-06-22,23:00:00,54,9,45,FMN GV 16 Berchem TOT
54,Posthofbrug 5366,2023-06-23,00:00:00,44,10,34,FMN GV 16 Berchem TOT
54,Posthofbrug 5366,2023-06-23,01:00:00,23,6,17,FMN GV 16 Berchem TOT
54,Posthofbrug 5366,2023-06-23,02:00:00,9,5,4,FMN GV 16 Berchem TOT
54,Posthofbrug 5366,2023-06-23,03:00:00,7,2,5,FMN GV 16 Berchem TOT
54,Posthofbrug 5366,2023-06-23,04:00:00,18,9,9,FMN GV 16 Berchem TOT
54,Posthofbrug 5366,2023-06-23,05:00:00,34,26,8,FMN GV 16 Berchem TOT
54,Posthofbrug 5366,2023-06-23,06:00:00,143,108,35,FMN GV 16 Berchem TOT
54,Posthofbrug 5366,2023-06-23,07:00:00,461,357,104,FMN GV 16 Berchem TOT
54,Posthofbrug 5366,2023-06-23,08:00:00,819,639,180,FMN GV 16 Berchem TOT
54,Posthofbrug 5366,2023-06-23,09:00:00,356,265,91,FMN GV 16 Berchem TOT
54,Posthofbrug 5366,2023-06-23,10:00:00,213,138,75,FMN GV 16 Berchem TOT
54,Posthofbrug 5366,2023-06-23,11:00:00,236,130,106,FMN GV 16 Berchem TOT
54,Posthofbrug 5366,2023-06-23,12:00:00,295,140,155,FMN GV 16 Berchem TOT
54,Posthofbrug 5366,2023-06-23,13:00:00,320,176,144,FMN GV 16 Berchem TOT
54,Posthofbrug 5366,2023-06-23,14:00:00,295,131,164,FMN GV 16 Berchem TOT
54,Posthofbrug 5366,2023-06-23,15:00:00,462,193,269,FMN GV 16 Berchem TOT
54,Posthofbrug 5366,2023-06-23,16:00:00,525,180,345,FMN GV 16 Berchem TOT
54,Posthofbrug 5366,2023-06-23,17:00:00,571,223,348,FMN GV 16 Berchem TOT
54,Posthofbrug 5366,2023-06-23,18:00:00,450,204,246,FMN GV 16 Berchem TOT
54,Posthofbrug 5366,2023-06-23,19:00:00,322,170,152,FMN GV 16 Berchem TOT
54,Posthofbrug 5366,2023-06-23,20:00:00,170,86,84,FMN GV 16 Berchem TOT
54,Posthofbrug 5366,2023-06-23,21:00:00,166,72,94,FMN GV 16 Berchem TOT
54,Posthofbrug 5366,2023-06-23,22:00:00,179,65,114,FMN GV 16 Berchem TOT
54,Posthofbrug 5366,2023-06-23,23:00:00,169,52,117,FMN GV 16 Berchem TOT
54,Posthofbrug 5366,2023-06-24,00:00:00,153,57,96,FMN GV 16 Berchem TOT
54,Posthofbrug 5366,2023-06-24,01:00:00,69,27,42,FMN GV 16 Berchem TOT
54,Posthofbrug 5366,2023-06-24,02:00:00,51,15,36,FMN GV 16 Berchem TOT
54,Posthofbrug 5366,2023-06-24,03:00:00,54,8,46,FMN GV 16 Berchem TOT
54,Posthofbrug 5366,2023-06-24,04:00:00,37,7,30,FMN GV 16 Berchem TOT
54,Posthofbrug 5366,2023-06-24,05:00:00,20,9,11,FMN GV 16 Berchem TOT
54,Posthofbrug 5366,2023-06-24,06:00:00,44,35,9,FMN GV 16 Berchem TOT
54,Posthofbrug 5366,2023-06-24,07:00:00,57,40,17,FMN GV 16 Berchem TOT
54,Posthofbrug 5366,2023-06-24,08:00:00,105,75,30,FMN GV 16 Berchem TOT
54,Posthofbrug 5366,2023-06-24,09:00:00,229,169,60,FMN GV 16 Berchem TOT
54,Posthofbrug 5366,2023-06-24,10:00:00,273,182,91,FMN GV 16 Berchem TOT
54,Posthofbrug 5366,2023-06-24,11:00:00,284,174,110,FMN GV 16 Berchem TOT
54,Posthofbrug 5366,2023-06-24,12:00:00,290,154,136,FMN GV 16 Berchem TOT
54,Posthofbrug 5366,2023-06-24,13:00:00,345,218,127,FMN GV 16 Berchem TOT
54,Posthofbrug 5366,2023-06-24,14:00:00,311,167,144,FMN GV 16 Berchem TOT
54,Posthofbrug 5366,2023-06-24,15:00:00,298,165,133,FMN GV 16 Berchem TOT
54,Posthofbrug 5366,2023-06-24,16:00:00,242,113,129,FMN GV 16 Berchem TOT
54,Posthofbrug 5366,2023-06-24,17:00:00,255,106,149,FMN GV 16 Berchem TOT
54,Posthofbrug 5366,2023-06-24,18:00:00,241,121,120,FMN GV 16 Berchem TOT
54,Posthofbrug 5366,2023-06-24,19:00:00,160,86,74,FMN GV 16 Berchem TOT
54,Posthofbrug 5366,2023-06-24,20:00:00,155,63,92,FMN GV 16 Berchem TOT
54,Posthofbrug 5366,2023-06-24,21:00:00,130,63,67,FMN GV 16 Berchem TOT
54,Posthofbrug 5366,2023-06-24,22:00:00,132,54,78,FMN GV 16 Berchem TOT
54,Posthofbrug 5366,2023-06-24,23:00:00,99,44,55,FMN GV 16 Berchem TOT
54,Posthofbrug 5366,2023-06-25,00:00:00,112,19,93,FMN GV 16 Berchem TOT
54,Posthofbrug 5366,2023-06-25,01:00:00,71,17,54,FMN GV 16 Berchem TOT
54,Posthofbrug 5366,2023-06-25,02:00:00,66,12,54,FMN GV 16 Berchem TOT
54,Posthofbrug 5366,2023-06-25,03:00:00,25,4,21,FMN GV 16 Berchem TOT
54,Posthofbrug 5366,2023-06-25,04:00:00,22,4,18,FMN GV 16 Berchem TOT
54,Posthofbrug 5366,2023-06-25,05:00:00,18,9,9,FMN GV 16 Berchem TOT
54,Posthofbrug 5366,2023-06-25,06:00:00,29,21,8,FMN GV 16 Berchem TOT
54,Posthofbrug 5366,2023-06-25,07:00:00,39,23,16,FMN GV 16 Berchem TOT
54,Posthofbrug 5366,2023-06-25,08:00:00,108,64,44,FMN GV 16 Berchem TOT
54,Posthofbrug 5366,2023-06-25,09:00:00,157,84,73,FMN GV 16 Berchem TOT
54,Posthofbrug 5366,2023-06-25,10:00:00,209,128,81,FMN GV 16 Berchem TOT
54,Posthofbrug 5366,2023-06-25,11:00:00,198,107,91,FMN GV 16 Berchem TOT
54,Posthofbrug 5366,2023-06-25,12:00:00,248,159,89,FMN GV 16 Berchem TOT
54,Posthofbrug 5366,2023-06-25,13:00:00,281,185,96,FMN GV 16 Berchem TOT
54,Posthofbrug 5366,2023-06-25,14:00:00,237,132,105,FMN GV 16 Berchem TOT
54,Posthofbrug 5366,2023-06-25,15:00:00,202,96,106,FMN GV 16 Berchem TOT
54,Posthofbrug 5366,2023-06-25,16:00:00,190,98,92,FMN GV 16 Berchem TOT
54,Posthofbrug 5366,2023-06-25,17:00:00,203,87,116,FMN GV 16 Berchem TOT
54,Posthofbrug 5366,2023-06-25,18:00:00,243,130,113,FMN GV 16 Berchem TOT
54,Posthofbrug 5366,2023-06-25,19:00:00,161,80,81,FMN GV 16 Berchem TOT
54,Posthofbrug 5366,2023-06-25,20:00:00,147,72,75,FMN GV 16 Berchem TOT
54,Posthofbrug 5366,2023-06-25,21:00:00,97,47,50,FMN GV 16 Berchem TOT
54,Posthofbrug 5366,2023-06-25,22:00:00,118,49,69,FMN GV 16 Berchem TOT
54,Posthofbrug 5366,2023-06-25,23:00:00,61,23,38,FMN GV 16 Berchem TOT
54,Posthofbrug 5366,2023-06-26,00:00:00,51,9,42,FMN GV 16 Berchem TOT
54,Posthofbrug 5366,2023-06-26,01:00:00,32,2,30,FMN GV 16 Berchem TOT
54,Posthofbrug 5366,2023-06-26,02:00:00,10,1,9,FMN GV 16 Berchem TOT
54,Posthofbrug 5366,2023-06-26,03:00:00,4,1,3,FMN GV 16 Berchem TOT
54,Posthofbrug 5366,2023-06-26,04:00:00,18,10,8,FMN GV 16 Berchem TOT
54,Posthofbrug 5366,2023-06-26,05:00:00,38,30,8,FMN GV 16 Berchem TOT
54,Posthofbrug 5366,2023-06-26,06:00:00,150,114,36,FMN GV 16 Berchem TOT
54,Posthofbrug 5366,2023-06-26,07:00:00,523,415,108,FMN GV 16 Berchem TOT
54,Posthofbrug 5366,2023-06-26,08:00:00,1059,851,208,FMN GV 16 Berchem TOT
54,Posthofbrug 5366,2023-06-26,09:00:00,375,272,103,FMN GV 16 Berchem TOT
54,Posthofbrug 5366,2023-06-26,10:00:00,217,140,77,FMN GV 16 Berchem TOT
54,Posthofbrug 5366,2023-06-26,11:00:00,189,119,70,FMN GV 16 Berchem TOT
54,Posthofbrug 5366,2023-06-26,12:00:00,275,166,109,FMN GV 16 Berchem TOT
54,Posthofbrug 5366,2023-06-26,13:00:00,246,116,130,FMN GV 16 Berchem TOT
54,Posthofbrug 5366,2023-06-26,14:00:00,266,129,137,FMN GV 16 Berchem TOT
54,Posthofbrug 5366,2023-06-26,15:00:00,325,108,217,FMN GV 16 Berchem TOT
54,Posthofbrug 5366,2023-06-26,16:00:00,602,187,415,FMN GV 16 Berchem TOT
54,Posthofbrug 5366,2023-06-26,17:00:00,845,286,559,FMN GV 16 Berchem TOT
54,Posthofbrug 5366,2023-06-26,18:00:00,446,140,306,FMN GV 16 Berchem TOT
54,Posthofbrug 5366,2023-06-26,19:00:00,264,112,152,FMN GV 16 Berchem TOT
54,Posthofbrug 5366,2023-06-26,20:00:00,188,76,112,FMN GV 16 Berchem TOT
54,Posthofbrug 5366,2023-06-26,21:00:00,157,60,97,FMN GV 16 Berchem TOT
54,Posthofbrug 5366,2023-06-26,22:00:00,158,45,113,FMN GV 16 Berchem TOT
54,Posthofbrug 5366,2023-06-26,23:00:00,88,35,53,FMN GV 16 Berchem TOT
54,Posthofbrug 5366,2023-06-27,00:00:00,36,9,27,FMN GV 16 Berchem TOT
54,Posthofbrug 5366,2023-06-27,01:00:00,7,4,3,FMN GV 16 Berchem TOT
54,Posthofbrug 5366,2023-06-27,02:00:00,28,4,24,FMN GV 16 Berchem TOT
54,Posthofbrug 5366,2023-06-27,03:00:00,14,5,9,FMN GV 16 Berchem TOT
54,Posthofbrug 5366,2023-06-27,04:00:00,24,8,16,FMN GV 16 Berchem TOT
54,Posthofbrug 5366,2023-06-27,05:00:00,41,33,8,FMN GV 16 Berchem TOT
54,Posthofbrug 5366,2023-06-27,06:00:00,174,133,41,FMN GV 16 Berchem TOT
54,Posthofbrug 5366,2023-06-27,07:00:00,618,474,144,FMN GV 16 Berchem TOT
54,Posthofbrug 5366,2023-06-27,08:00:00,1111,879,232,FMN GV 16 Berchem TOT
54,Posthofbrug 5366,2023-06-27,09:00:00,367,271,96,FMN GV 16 Berchem TOT
54,Posthofbrug 5366,2023-06-27,10:00:00,189,128,61,FMN GV 16 Berchem TOT
54,Posthofbrug 5366,2023-06-27,11:00:00,190,127,63,FMN GV 16 Berchem TOT
54,Posthofbrug 5366,2023-06-27,12:00:00,275,151,124,FMN GV 16 Berchem TOT
54,Posthofbrug 5366,2023-06-27,13:00:00,235,116,119,FMN GV 16 Berchem TOT
54,Posthofbrug 5366,2023-06-27,14:00:00,260,108,152,FMN GV 16 Berchem TOT
54,Posthofbrug 5366,2023-06-27,15:00:00,374,141,233,FMN GV 16 Berchem TOT
54,Posthofbrug 5366,2023-06-27,16:00:00,624,209,415,FMN GV 16 Berchem TOT
54,Posthofbrug 5366,2023-06-27,17:00:00,864,291,573,FMN GV 16 Berchem TOT
54,Posthofbrug 5366,2023-06-27,18:00:00,539,203,336,FMN GV 16 Berchem TOT
54,Posthofbrug 5366,2023-06-27,19:00:00,282,115,167,FMN GV 16 Berchem TOT
54,Posthofbrug 5366,2023-06-27,20:00:00,203,85,118,FMN GV 16 Berchem TOT
54,Posthofbrug 5366,2023-06-27,21:00:00,172,53,119,FMN GV 16 Berchem TOT
54,Posthofbrug 5366,2023-06-27,22:00:00,164,55,109,FMN GV 16 Berchem TOT
54,Posthofbrug 5366,2023-06-27,23:00:00,139,50,89,FMN GV 16 Berchem TOT
54,Posthofbrug 5366,2023-06-28,00:00:00,41,15,26,FMN GV 16 Berchem TOT
54,Posthofbrug 5366,2023-06-28,01:00:00,29,8,21,FMN GV 16 Berchem TOT
54,Posthofbrug 5366,2023-06-28,02:00:00,10,1,9,FMN GV 16 Berchem TOT
54,Posthofbrug 5366,2023-06-28,03:00:00,11,3,8,FMN GV 16 Berchem TOT
54,Posthofbrug 5366,2023-06-28,04:00:00,17,10,7,FMN GV 16 Berchem TOT
54,Posthofbrug 5366,2023-06-28,05:00:00,33,26,7,FMN GV 16 Berchem TOT
54,Posthofbrug 5366,2023-06-28,06:00:00,129,97,32,FMN GV 16 Berchem TOT
54,Posthofbrug 5366,2023-06-28,07:00:00,447,358,89,FMN GV 16 Berchem TOT
54,Posthofbrug 5366,2023-06-28,08:00:00,801,612,189,FMN GV 16 Berchem TOT
54,Posthofbrug 5366,2023-06-28,09:00:00,352,255,97,FMN GV 16 Berchem TOT
54,Posthofbrug 5366,2023-06-28,10:00:00,210,144,66,FMN GV 16 Berchem TOT
54,Posthofbrug 5366,2023-06-28,11:00:00,214,120,94,FMN GV 16 Berchem TOT
54,Posthofbrug 5366,2023-06-28,12:00:00,348,153,195,FMN GV 16 Berchem TOT
54,Posthofbrug 5366,2023-06-28,13:00:00,304,160,144,FMN GV 16 Berchem TOT
54,Posthofbrug 5366,2023-06-28,14:00:00,260,126,134,FMN GV 16 Berchem TOT
54,Posthofbrug 5366,2023-06-28,15:00:00,309,137,172,FMN GV 16 Berchem TOT
54,Posthofbrug 5366,2023-06-28,16:00:00,446,163,283,FMN GV 16 Berchem TOT
54,Posthofbrug 5366,2023-06-28,17:00:00,678,236,442,FMN GV 16 Berchem TOT
54,Posthofbrug 5366,2023-06-28,18:00:00,460,209,251,FMN GV 16 Berchem TOT
54,Posthofbrug 5366,2023-06-28,19:00:00,241,116,125,FMN GV 16 Berchem TOT
54,Posthofbrug 5366,2023-06-28,20:00:00,165,76,89,FMN GV 16 Berchem TOT
54,Posthofbrug 5366,2023-06-28,21:00:00,149,54,95,FMN GV 16 Berchem TOT
54,Posthofbrug 5366,2023-06-28,22:00:00,162,55,107,FMN GV 16 Berchem TOT
54,Posthofbrug 5366,2023-06-28,23:00:00,127,26,101,FMN GV 16 Berchem TOT
54,Posthofbrug 5366,2023-06-29,00:00:00,77,17,60,FMN GV 16 Berchem TOT
54,Posthofbrug 5366,2023-06-29,01:00:00,32,4,28,FMN GV 16 Berchem TOT
54,Posthofbrug 5366,2023-06-29,02:00:00,22,1,21,FMN GV 16 Berchem TOT
54,Posthofbrug 5366,2023-06-29,03:00:00,14,0,14,FMN GV 16 Berchem TOT
54,Posthofbrug 5366,2023-06-29,04:00:00,24,14,10,FMN GV 16 Berchem TOT
54,Posthofbrug 5366,2023-06-29,05:00:00,41,27,14,FMN GV 16 Berchem TOT
54,Posthofbrug 5366,2023-06-29,06:00:00,116,89,27,FMN GV 16 Berchem TOT
54,Posthofbrug 5366,2023-06-29,07:00:00,469,367,102,FMN GV 16 Berchem TOT
54,Posthofbrug 5366,2023-06-29,08:00:00,996,758,238,FMN GV 16 Berchem TOT
54,Posthofbrug 5366,2023-06-29,09:00:00,356,278,78,FMN GV 16 Berchem TOT
54,Posthofbrug 5366,2023-06-29,10:00:00,178,119,59,FMN GV 16 Berchem TOT
54,Posthofbrug 5366,2023-06-29,11:00:00,195,109,86,FMN GV 16 Berchem TOT
54,Posthofbrug 5366,2023-06-29,12:00:00,266,146,120,FMN GV 16 Berchem TOT
54,Posthofbrug 5366,2023-06-29,13:00:00,247,121,126,FMN GV 16 Berchem TOT
54,Posthofbrug 5366,2023-06-29,14:00:00,217,89,128,FMN GV 16 Berchem TOT
54,Posthofbrug 5366,2023-06-29,15:00:00,308,125,183,FMN GV 16 Berchem TOT
54,Posthofbrug 5366,2023-06-29,16:00:00,516,187,329,FMN GV 16 Berchem TOT
54,Posthofbrug 5366,2023-06-29,17:00:00,726,244,482,FMN GV 16 Berchem TOT
54,Posthofbrug 5366,2023-06-29,18:00:00,466,173,293,FMN GV 16 Berchem TOT
54,Posthofbrug 5366,2023-06-29,19:00:00,251,98,153,FMN GV 16 Berchem TOT
54,Posthofbrug 5366,2023-06-29,20:00:00,183,88,95,FMN GV 16 Berchem TOT
54,Posthofbrug 5366,2023-06-29,21:00:00,150,41,109,FMN GV 16 Berchem TOT
54,Posthofbrug 5366,2023-06-29,22:00:00,131,40,91,FMN GV 16 Berchem TOT
54,Posthofbrug 5366,2023-06-29,23:00:00,100,12,88,FMN GV 16 Berchem TOT
54,Posthofbrug 5366,2023-06-30,00:00:00,67,29,38,FMN GV 16 Berchem TOT
54,Posthofbrug 5366,2023-06-30,01:00:00,32,8,24,FMN GV 16 Berchem TOT
54,Posthofbrug 5366,2023-06-30,02:00:00,9,2,7,FMN GV 16 Berchem TOT
54,Posthofbrug 5366,2023-06-30,03:00:00,15,1,14,FMN GV 16 Berchem TOT
54,Posthofbrug 5366,2023-06-30,04:00:00,23,13,10,FMN GV 16 Berchem TOT
54,Posthofbrug 5366,2023-06-30,05:00:00,27,18,9,FMN GV 16 Berchem TOT
54,Posthofbrug 5366,2023-06-30,06:00:00,119,84,35,FMN GV 16 Berchem TOT
54,Posthofbrug 5366,2023-06-30,07:00:00,390,305,85,FMN GV 16 Berchem TOT
54,Posthofbrug 5366,2023-06-30,08:00:00,693,531,162,FMN GV 16 Berchem TOT
54,Posthofbrug 5366,2023-06-30,09:00:00,362,278,84,FMN GV 16 Berchem TOT
54,Posthofbrug 5366,2023-06-30,10:00:00,191,135,56,FMN GV 16 Berchem TOT
54,Posthofbrug 5366,2023-06-30,11:00:00,217,125,92,FMN GV 16 Berchem TOT
54,Posthofbrug 5366,2023-06-30,12:00:00,337,171,166,FMN GV 16 Berchem TOT
54,Posthofbrug 5366,2023-06-30,13:00:00,289,141,148,FMN GV 16 Berchem TOT
54,Posthofbrug 5366,2023-06-30,14:00:00,270,124,146,FMN GV 16 Berchem TOT
54,Posthofbrug 5366,2023-06-30,15:00:00,313,124,189,FMN GV 16 Berchem TOT
54,Posthofbrug 5366,2023-06-30,16:00:00,489,174,315,FMN GV 16 Berchem TOT
54,Posthofbrug 5366,2023-06-30,17:00:00,475,170,305,FMN GV 16 Berchem TOT
54,Posthofbrug 5366,2023-06-30,18:00:00,393,154,239,FMN GV 16 Berchem TOT
54,Posthofbrug 5366,2023-06-30,19:00:00,211,105,106,FMN GV 16 Berchem TOT
54,Posthofbrug 5366,2023-06-30,20:00:00,167,89,78,FMN GV 16 Berchem TOT
54,Posthofbrug 5366,2023-06-30,21:00:00,136,57,79,FMN GV 16 Berchem TOT
54,Posthofbrug 5366,2023-06-30,22:00:00,147,60,87,FMN GV 16 Berchem TOT
54,Posthofbrug 5366,2023-06-30,23:00:00,107,48,59,FMN GV 16 Berchem TOT
54,Posthofbrug 5366,2023-07-01,00:00:00,75,23,52,FMN GV 16 Berchem TOT
54,Posthofbrug 5366,2023-07-01,01:00:00,65,8,57,FMN GV 16 Berchem TOT
54,Posthofbrug 5366,2023-07-01,02:00:00,42,15,27,FMN GV 16 Berchem TOT
54,Posthofbrug 5366,2023-07-01,03:00:00,21,8,13,FMN GV 16 Berchem TOT
54,Posthofbrug 5366,2023-07-01,04:00:00,27,7,20,FMN GV 16 Berchem TOT
54,Posthofbrug 5366,2023-07-01,05:00:00,20,9,11,FMN GV 16 Berchem TOT
54,Posthofbrug 5366,2023-07-01,06:00:00,34,17,17,FMN GV 16 Berchem TOT
54,Posthofbrug 5366,2023-07-01,07:00:00,41,28,13,FMN GV 16 Berchem TOT
54,Posthofbrug 5366,2023-07-01,08:00:00,63,43,20,FMN GV 16 Berchem TOT
54,Posthofbrug 5366,2023-07-01,09:00:00,88,59,29,FMN GV 16 Berchem TOT
54,Posthofbrug 5366,2023-07-01,10:00:00,115,75,40,FMN GV 16 Berchem TOT
54,Posthofbrug 5366,2023-07-01,11:00:00,138,78,60,FMN GV 16 Berchem TOT
54,Posthofbrug 5366,2023-07-01,12:00:00,124,77,47,FMN GV 16 Berchem TOT
54,Posthofbrug 5366,2023-07-01,13:00:00,128,74,54,FMN GV 16 Berchem TOT
54,Posthofbrug 5366,2023-07-01,14:00:00,139,89,50,FMN GV 16 Berchem TOT
54,Posthofbrug 5366,2023-07-01,15:00:00,111,56,55,FMN GV 16 Berchem TOT
54,Posthofbrug 5366,2023-07-01,16:00:00,144,78,66,FMN GV 16 Berchem TOT
54,Posthofbrug 5366,2023-07-01,17:00:00,124,60,64,FMN GV 16 Berchem TOT
54,Posthofbrug 5366,2023-07-01,18:00:00,168,86,82,FMN GV 16 Berchem TOT
54,Posthofbrug 5366,2023-07-01,19:00:00,137,84,53,FMN GV 16 Berchem TOT
54,Posthofbrug 5366,2023-07-01,20:00:00,120,62,58,FMN GV 16 Berchem TOT
54,Posthofbrug 5366,2023-07-01,21:00:00,101,49,52,FMN GV 16 Berchem TOT
54,Posthofbrug 5366,2023-07-01,22:00:00,76,30,46,FMN GV 16 Berchem TOT
54,Posthofbrug 5366,2023-07-01,23:00:00,83,30,53,FMN GV 16 Berchem TOT
54,Posthofbrug 5366,2023-07-02,00:00:00,78,33,45,FMN GV 16 Berchem TOT
54,Posthofbrug 5366,2023-07-02,01:00:00,39,5,34,FMN GV 16 Berchem TOT
54,Posthofbrug 5366,2023-07-02,02:00:00,41,9,32,FMN GV 16 Berchem TOT
54,Posthofbrug 5366,2023-07-02,03:00:00,29,1,28,FMN GV 16 Berchem TOT
54,Posthofbrug 5366,2023-07-02,04:00:00,28,11,17,FMN GV 16 Berchem TOT
54,Posthofbrug 5366,2023-07-02,05:00:00,15,9,6,FMN GV 16 Berchem TOT
54,Posthofbrug 5366,2023-07-02,06:00:00,29,18,11,FMN GV 16 Berchem TOT
54,Posthofbrug 5366,2023-07-02,07:00:00,34,18,16,FMN GV 16 Berchem TOT
54,Posthofbrug 5366,2023-07-02,08:00:00,69,43,26,FMN GV 16 Berchem TOT
54,Posthofbrug 5366,2023-07-02,09:00:00,132,93,39,FMN GV 16 Berchem TOT
54,Posthofbrug 5366,2023-07-02,10:00:00,160,108,52,FMN GV 16 Berchem TOT
54,Posthofbrug 5366,2023-07-02,11:00:00,246,158,88,FMN GV 16 Berchem TOT
54,Posthofbrug 5366,2023-07-02,12:00:00,228,137,91,FMN GV 16 Berchem TOT
54,Posthofbrug 5366,2023-07-02,13:00:00,261,117,144,FMN GV 16 Berchem TOT
54,Posthofbrug 5366,2023-07-02,14:00:00,291,150,141,FMN GV 16 Berchem TOT
54,Posthofbrug 5366,2023-07-02,15:00:00,266,155,111,FMN GV 16 Berchem TOT
54,Posthofbrug 5366,2023-07-02,16:00:00,266,147,119,FMN GV 16 Berchem TOT
54,Posthofbrug 5366,2023-07-02,17:00:00,249,116,133,FMN GV 16 Berchem TOT
54,Posthofbrug 5366,2023-07-02,18:00:00,202,94,108,FMN GV 16 Berchem TOT
54,Posthofbrug 5366,2023-07-02,19:00:00,133,61,72,FMN GV 16 Berchem TOT
54,Posthofbrug 5366,2023-07-02,20:00:00,134,61,73,FMN GV 16 Berchem TOT
54,Posthofbrug 5366,2023-07-02,21:00:00,104,55,49,FMN GV 16 Berchem TOT
54,Posthofbrug 5366,2023-07-02,22:00:00,96,39,57,FMN GV 16 Berchem TOT
54,Posthofbrug 5366,2023-07-02,23:00:00,49,15,34,FMN GV 16 Berchem TOT
54,Posthofbrug 5366,2023-07-03,00:00:00,20,10,10,FMN GV 16 Berchem TOT
54,Posthofbrug 5366,2023-07-03,01:00:00,10,2,8,FMN GV 16 Berchem TOT
54,Posthofbrug 5366,2023-07-03,02:00:00,9,4,5,FMN GV 16 Berchem TOT
54,Posthofbrug 5366,2023-07-03,03:00:00,8,4,4,FMN GV 16 Berchem TOT
54,Posthofbrug 5366,2023-07-03,04:00:00,16,10,6,FMN GV 16 Berchem TOT
54,Posthofbrug 5366,2023-07-03,05:00:00,33,23,10,FMN GV 16 Berchem TOT
54,Posthofbrug 5366,2023-07-03,06:00:00,153,119,34,FMN GV 16 Berchem TOT
54,Posthofbrug 5366,2023-07-03,07:00:00,403,307,96,FMN GV 16 Berchem TOT
54,Posthofbrug 5366,2023-07-03,08:00:00,724,582,142,FMN GV 16 Berchem TOT
54,Posthofbrug 5366,2023-07-03,09:00:00,335,266,69,FMN GV 16 Berchem TOT
54,Posthofbrug 5366,2023-07-03,10:00:00,139,95,44,FMN GV 16 Berchem TOT
54,Posthofbrug 5366,2023-07-03,11:00:00,160,99,61,FMN GV 16 Berchem TOT
54,Posthofbrug 5366,2023-07-03,12:00:00,188,102,86,FMN GV 16 Berchem TOT
54,Posthofbrug 5366,2023-07-03,13:00:00,215,112,103,FMN GV 16 Berchem TOT
54,Posthofbrug 5366,2023-07-03,14:00:00,212,97,115,FMN GV 16 Berchem TOT
54,Posthofbrug 5366,2023-07-03,15:00:00,240,91,149,FMN GV 16 Berchem TOT
54,Posthofbrug 5366,2023-07-03,16:00:00,456,153,303,FMN GV 16 Berchem TOT
54,Posthofbrug 5366,2023-07-03,17:00:00,639,202,437,FMN GV 16 Berchem TOT
54,Posthofbrug 5366,2023-07-03,18:00:00,393,145,248,FMN GV 16 Berchem TOT
54,Posthofbrug 5366,2023-07-03,19:00:00,219,75,144,FMN GV 16 Berchem TOT
54,Posthofbrug 5366,2023-07-03,20:00:00,139,60,79,FMN GV 16 Berchem TOT
54,Posthofbrug 5366,2023-07-03,21:00:00,95,47,48,FMN GV 16 Berchem TOT
54,Posthofbrug 5366,2023-07-03,22:00:00,105,35,70,FMN GV 16 Berchem TOT
54,Posthofbrug 5366,2023-07-03,23:00:00,70,26,44,FMN GV 16 Berchem TOT
54,Posthofbrug 5366,2023-07-04,00:00:00,30,11,19,FMN GV 16 Berchem TOT
54,Posthofbrug 5366,2023-07-04,01:00:00,9,4,5,FMN GV 16 Berchem TOT
54,Posthofbrug 5366,2023-07-04,02:00:00,6,1,5,FMN GV 16 Berchem TOT
54,Posthofbrug 5366,2023-07-04,03:00:00,8,3,5,FMN GV 16 Berchem TOT
54,Posthofbrug 5366,2023-07-04,04:00:00,20,13,7,FMN GV 16 Berchem TOT
54,Posthofbrug 5366,2023-07-04,05:00:00,41,29,12,FMN GV 16 Berchem TOT
54,Posthofbrug 5366,2023-07-04,06:00:00,141,107,34,FMN GV 16 Berchem TOT
54,Posthofbrug 5366,2023-07-04,07:00:00,430,321,109,FMN GV 16 Berchem TOT
54,Posthofbrug 5366,2023-07-04,08:00:00,748,571,177,FMN GV 16 Berchem TOT
54,Posthofbrug 5366,2023-07-04,09:00:00,352,265,87,FMN GV 16 Berchem TOT
54,Posthofbrug 5366,2023-07-04,10:00:00,185,131,54,FMN GV 16 Berchem TOT
54,Posthofbrug 5366,2023-07-04,11:00:00,139,82,57,FMN GV 16 Berchem TOT
54,Posthofbrug 5366,2023-07-04,12:00:00,207,121,86,FMN GV 16 Berchem TOT
54,Posthofbrug 5366,2023-07-04,13:00:00,213,126,87,FMN GV 16 Berchem TOT
54,Posthofbrug 5366,2023-07-04,14:00:00,171,74,97,FMN GV 16 Berchem TOT
54,Posthofbrug 5366,2023-07-04,15:00:00,257,109,148,FMN GV 16 Berchem TOT
54,Posthofbrug 5366,2023-07-04,16:00:00,548,180,368,FMN GV 16 Berchem TOT
54,Posthofbrug 5366,2023-07-04,17:00:00,687,232,455,FMN GV 16 Berchem TOT
54,Posthofbrug 5366,2023-07-04,18:00:00,450,183,267,FMN GV 16 Berchem TOT
54,Posthofbrug 5366,2023-07-04,19:00:00,200,92,108,FMN GV 16 Berchem TOT
54,Posthofbrug 5366,2023-07-04,20:00:00,123,49,74,FMN GV 16 Berchem TOT
54,Posthofbrug 5366,2023-07-04,21:00:00,107,49,58,FMN GV 16 Berchem TOT
54,Posthofbrug 5366,2023-07-04,22:00:00,139,51,88,FMN GV 16 Berchem TOT
54,Posthofbrug 5366,2023-07-04,23:00:00,81,18,63,FMN GV 16 Berchem TOT
54,Posthofbrug 5366,2023-07-05,00:00:00,27,8,19,FMN GV 16 Berchem TOT
54,Posthofbrug 5366,2023-07-05,01:00:00,16,7,9,FMN GV 16 Berchem TOT
54,Posthofbrug 5366,2023-07-05,02:00:00,7,3,4,FMN GV 16 Berchem TOT
54,Posthofbrug 5366,2023-07-05,03:00:00,11,4,7,FMN GV 16 Berchem TOT
54,Posthofbrug 5366,2023-07-05,04:00:00,15,8,7,FMN GV 16 Berchem TOT
54,Posthofbrug 5366,2023-07-05,05:00:00,37,28,9,FMN GV 16 Berchem TOT
54,Posthofbrug 5366,2023-07-05,06:00:00,98,72,26,FMN GV 16 Berchem TOT
54,Posthofbrug 5366,2023-07-05,07:00:00,312,241,71,FMN GV 16 Berchem TOT
54,Posthofbrug 5366,2023-07-05,08:00:00,524,390,134,FMN GV 16 Berchem TOT
54,Posthofbrug 5366,2023-07-05,09:00:00,260,187,73,FMN GV 16 Berchem TOT
54,Posthofbrug 5366,2023-07-05,10:00:00,123,79,44,FMN GV 16 Berchem TOT
54,Posthofbrug 5366,2023-07-05,11:00:00,131,85,46,FMN GV 16 Berchem TOT
54,Posthofbrug 5366,2023-07-05,12:00:00,170,97,73,FMN GV 16 Berchem TOT
54,Posthofbrug 5366,2023-07-05,13:00:00,185,96,89,FMN GV 16 Berchem TOT
54,Posthofbrug 5366,2023-07-05,14:00:00,145,62,83,FMN GV 16 Berchem TOT
54,Posthofbrug 5366,2023-07-05,15:00:00,185,70,115,FMN GV 16 Berchem TOT
54,Posthofbrug 5366,2023-07-05,16:00:00,384,150,234,FMN GV 16 Berchem TOT
54,Posthofbrug 5366,2023-07-05,17:00:00,525,215,310,FMN GV 16 Berchem TOT
54,Posthofbrug 5366,2023-07-05,18:00:00,292,107,185,FMN GV 16 Berchem TOT
54,Posthofbrug 5366,2023-07-05,19:00:00,165,63,102,FMN GV 16 Berchem TOT
54,Posthofbrug 5366,2023-07-05,20:00:00,131,56,75,FMN GV 16 Berchem TOT
54,Posthofbrug 5366,2023-07-05,21:00:00,113,45,68,FMN GV 16 Berchem TOT
54,Posthofbrug 5366,2023-07-05,22:00:00,87,24,63,FMN GV 16 Berchem TOT
54,Posthofbrug 5366,2023-07-05,23:00:00,72,22,50,FMN GV 16 Berchem TOT
54,Posthofbrug 5366,2023-07-06,00:00:00,31,5,26,FMN GV 16 Berchem TOT
54,Posthofbrug 5366,2023-07-06,01:00:00,20,3,17,FMN GV 16 Berchem TOT
54,Posthofbrug 5366,2023-07-06,02:00:00,7,1,6,FMN GV 16 Berchem TOT
54,Posthofbrug 5366,2023-07-06,03:00:00,4,0,4,FMN GV 16 Berchem TOT
54,Posthofbrug 5366,2023-07-06,04:00:00,22,13,9,FMN GV 16 Berchem TOT
54,Posthofbrug 5366,2023-07-06,05:00:00,37,25,12,FMN GV 16 Berchem TOT
54,Posthofbrug 5366,2023-07-06,06:00:00,123,100,23,FMN GV 16 Berchem TOT
54,Posthofbrug 5366,2023-07-06,07:00:00,387,280,107,FMN GV 16 Berchem TOT
54,Posthofbrug 5366,2023-07-06,08:00:00,700,529,171,FMN GV 16 Berchem TOT
54,Posthofbrug 5366,2023-07-06,09:00:00,335,257,78,FMN GV 16 Berchem TOT
54,Posthofbrug 5366,2023-07-06,10:00:00,200,147,53,FMN GV 16 Berchem TOT
54,Posthofbrug 5366,2023-07-06,11:00:00,169,104,65,FMN GV 16 Berchem TOT
54,Posthofbrug 5366,2023-07-06,12:00:00,207,125,82,FMN GV 16 Berchem TOT
54,Posthofbrug 5366,2023-07-06,13:00:00,221,118,103,FMN GV 16 Berchem TOT
54,Posthofbrug 5366,2023-07-06,14:00:00,205,100,105,FMN GV 16 Berchem TOT
54,Posthofbrug 5366,2023-07-06,15:00:00,269,102,167,FMN GV 16 Berchem TOT
54,Posthofbrug 5366,2023-07-06,16:00:00,463,165,298,FMN GV 16 Berchem TOT
54,Posthofbrug 5366,2023-07-06,17:00:00,644,219,425,FMN GV 16 Berchem TOT
54,Posthofbrug 5366,2023-07-06,18:00:00,475,192,283,FMN GV 16 Berchem TOT
54,Posthofbrug 5366,2023-07-06,19:00:00,250,110,140,FMN GV 16 Berchem TOT
54,Posthofbrug 5366,2023-07-06,20:00:00,191,94,97,FMN GV 16 Berchem TOT
54,Posthofbrug 5366,2023-07-06,21:00:00,163,70,93,FMN GV 16 Berchem TOT
54,Posthofbrug 5366,2023-07-06,22:00:00,145,46,99,FMN GV 16 Berchem TOT
54,Posthofbrug 5366,2023-07-06,23:00:00,116,29,87,FMN GV 16 Berchem TOT
54,Posthofbrug 5366,2023-07-07,00:00:00,52,23,29,FMN GV 16 Berchem TOT
54,Posthofbrug 5366,2023-07-07,01:00:00,30,3,27,FMN GV 16 Berchem TOT
54,Posthofbrug 5366,2023-07-07,02:00:00,10,4,6,FMN GV 16 Berchem TOT
54,Posthofbrug 5366,2023-07-07,03:00:00,10,5,5,FMN GV 16 Berchem TOT
54,Posthofbrug 5366,2023-07-07,04:00:00,19,13,6,FMN GV 16 Berchem TOT
54,Posthofbrug 5366,2023-07-07,05:00:00,39,25,14,FMN GV 16 Berchem TOT
54,Posthofbrug 5366,2023-07-07,06:00:00,116,83,33,FMN GV 16 Berchem TOT
54,Posthofbrug 5366,2023-07-07,07:00:00,309,222,87,FMN GV 16 Berchem TOT
54,Posthofbrug 5366,2023-07-07,08:00:00,521,410,111,FMN GV 16 Berchem TOT
54,Posthofbrug 5366,2023-07-07,09:00:00,305,231,74,FMN GV 16 Berchem TOT
54,Posthofbrug 5366,2023-07-07,10:00:00,201,125,76,FMN GV 16 Berchem TOT
54,Posthofbrug 5366,2023-07-07,11:00:00,198,125,73,FMN GV 16 Berchem TOT
54,Posthofbrug 5366,2023-07-07,12:00:00,236,136,100,FMN GV 16 Berchem TOT
54,Posthofbrug 5366,2023-07-07,13:00:00,267,149,118,FMN GV 16 Berchem TOT
54,Posthofbrug 5366,2023-07-07,14:00:00,234,112,122,FMN GV 16 Berchem TOT
54,Posthofbrug 5366,2023-07-07,15:00:00,300,129,171,FMN GV 16 Berchem TOT
54,Posthofbrug 5366,2023-07-07,16:00:00,389,150,239,FMN GV 16 Berchem TOT
54,Posthofbrug 5366,2023-07-07,17:00:00,463,169,294,FMN GV 16 Berchem TOT
54,Posthofbrug 5366,2023-07-07,18:00:00,344,159,185,FMN GV 16 Berchem TOT
54,Posthofbrug 5366,2023-07-07,19:00:00,237,107,130,FMN GV 16 Berchem TOT
54,Posthofbrug 5366,2023-07-07,20:00:00,165,86,79,FMN GV 16 Berchem TOT
54,Posthofbrug 5366,2023-07-07,21:00:00,131,49,82,FMN GV 16 Berchem TOT
54,Posthofbrug 5366,2023-07-07,22:00:00,126,51,75,FMN GV 16 Berchem TOT
54,Posthofbrug 5366,2023-07-07,23:00:00,122,38,84,FMN GV 16 Berchem TOT
54,Posthofbrug 5366,2023-07-08,00:00:00,92,31,61,FMN GV 16 Berchem TOT
54,Posthofbrug 5366,2023-07-08,01:00:00,65,13,52,FMN GV 16 Berchem TOT
54,Posthofbrug 5366,2023-07-08,02:00:00,36,15,21,FMN GV 16 Berchem TOT
54,Posthofbrug 5366,2023-07-08,03:00:00,21,5,16,FMN GV 16 Berchem TOT
54,Posthofbrug 5366,2023-07-08,04:00:00,23,4,19,FMN GV 16 Berchem TOT
54,Posthofbrug 5366,2023-07-08,05:00:00,26,15,11,FMN GV 16 Berchem TOT
54,Posthofbrug 5366,2023-07-08,06:00:00,35,23,12,FMN GV 16 Berchem TOT
54,Posthofbrug 5366,2023-07-08,07:00:00,38,28,10,FMN GV 16 Berchem TOT
54,Posthofbrug 5366,2023-07-08,08:00:00,80,57,23,FMN GV 16 Berchem TOT
54,Posthofbrug 5366,2023-07-08,09:00:00,212,155,57,FMN GV 16 Berchem TOT
54,Posthofbrug 5366,2023-07-08,10:00:00,223,157,66,FMN GV 16 Berchem TOT
54,Posthofbrug 5366,2023-07-08,11:00:00,203,117,86,FMN GV 16 Berchem TOT
54,Posthofbrug 5366,2023-07-08,12:00:00,225,124,101,FMN GV 16 Berchem TOT
54,Posthofbrug 5366,2023-07-08,13:00:00,213,129,84,FMN GV 16 Berchem TOT
54,Posthofbrug 5366,2023-07-08,14:00:00,264,157,107,FMN GV 16 Berchem TOT
54,Posthofbrug 5366,2023-07-08,15:00:00,196,96,100,FMN GV 16 Berchem TOT
54,Posthofbrug 5366,2023-07-08,16:00:00,198,93,105,FMN GV 16 Berchem TOT
54,Posthofbrug 5366,2023-07-08,17:00:00,208,114,94,FMN GV 16 Berchem TOT
54,Posthofbrug 5366,2023-07-08,18:00:00,167,86,81,FMN GV 16 Berchem TOT
54,Posthofbrug 5366,2023-07-08,19:00:00,166,94,72,FMN GV 16 Berchem TOT
54,Posthofbrug 5366,2023-07-08,20:00:00,133,62,71,FMN GV 16 Berchem TOT
54,Posthofbrug 5366,2023-07-08,21:00:00,139,72,67,FMN GV 16 Berchem TOT
54,Posthofbrug 5366,2023-07-08,22:00:00,106,36,70,FMN GV 16 Berchem TOT
54,Posthofbrug 5366,2023-07-08,23:00:00,132,57,75,FMN GV 16 Berchem TOT
54,Posthofbrug 5366,2023-07-09,00:00:00,75,31,44,FMN GV 16 Berchem TOT
54,Posthofbrug 5366,2023-07-09,01:00:00,44,13,31,FMN GV 16 Berchem TOT
54,Posthofbrug 5366,2023-07-09,02:00:00,19,3,16,FMN GV 16 Berchem TOT
54,Posthofbrug 5366,2023-07-09,03:00:00,22,1,21,FMN GV 16 Berchem TOT
54,Posthofbrug 5366,2023-07-09,04:00:00,35,6,29,FMN GV 16 Berchem TOT
54,Posthofbrug 5366,2023-07-09,05:00:00,19,10,9,FMN GV 16 Berchem TOT
54,Posthofbrug 5366,2023-07-09,06:00:00,23,14,9,FMN GV 16 Berchem TOT
54,Posthofbrug 5366,2023-07-09,07:00:00,37,19,18,FMN GV 16 Berchem TOT
54,Posthofbrug 5366,2023-07-09,08:00:00,84,51,33,FMN GV 16 Berchem TOT
54,Posthofbrug 5366,2023-07-09,09:00:00,131,78,53,FMN GV 16 Berchem TOT
54,Posthofbrug 5366,2023-07-09,10:00:00,157,98,59,FMN GV 16 Berchem TOT
54,Posthofbrug 5366,2023-07-09,11:00:00,169,107,62,FMN GV 16 Berchem TOT
54,Posthofbrug 5366,2023-07-09,12:00:00,230,133,97,FMN GV 16 Berchem TOT
54,Posthofbrug 5366,2023-07-09,13:00:00,193,102,91,FMN GV 16 Berchem TOT
54,Posthofbrug 5366,2023-07-09,14:00:00,143,69,74,FMN GV 16 Berchem TOT
54,Posthofbrug 5366,2023-07-09,15:00:00,54,23,31,FMN GV 16 Berchem TOT
54,Posthofbrug 5366,2023-07-09,16:00:00,109,61,48,FMN GV 16 Berchem TOT
54,Posthofbrug 5366,2023-07-09,17:00:00,119,58,61,FMN GV 16 Berchem TOT
54,Posthofbrug 5366,2023-07-09,18:00:00,131,73,58,FMN GV 16 Berchem TOT
54,Posthofbrug 5366,2023-07-09,19:00:00,120,67,53,FMN GV 16 Berchem TOT
54,Posthofbrug 5366,2023-07-09,20:00:00,96,66,30,FMN GV 16 Berchem TOT
54,Posthofbrug 5366,2023-07-09,21:00:00,91,43,48,FMN GV 16 Berchem TOT
54,Posthofbrug 5366,2023-07-09,22:00:00,81,29,52,FMN GV 16 Berchem TOT
54,Posthofbrug 5366,2023-07-09,23:00:00,40,17,23,FMN GV 16 Berchem TOT
54,Posthofbrug 5366,2023-07-10,00:00:00,35,7,28,FMN GV 16 Berchem TOT
54,Posthofbrug 5366,2023-07-10,01:00:00,11,2,9,FMN GV 16 Berchem TOT
54,Posthofbrug 5366,2023-07-10,02:00:00,7,1,6,FMN GV 16 Berchem TOT
54,Posthofbrug 5366,2023-07-10,03:00:00,1,1,0,FMN GV 16 Berchem TOT
54,Posthofbrug 5366,2023-07-10,04:00:00,12,9,3,FMN GV 16 Berchem TOT
54,Posthofbrug 5366,2023-07-10,05:00:00,35,32,3,FMN GV 16 Berchem TOT
54,Posthofbrug 5366,2023-07-10,06:00:00,116,93,23,FMN GV 16 Berchem TOT
54,Posthofbrug 5366,2023-07-10,07:00:00,314,223,91,FMN GV 16 Berchem TOT
54,Posthofbrug 5366,2023-07-10,08:00:00,546,390,156,FMN GV 16 Berchem TOT
54,Posthofbrug 5366,2023-07-10,09:00:00,301,230,71,FMN GV 16 Berchem TOT
54,Posthofbrug 5366,2023-07-10,10:00:00,193,134,59,FMN GV 16 Berchem TOT
54,Posthofbrug 5366,2023-07-10,11:00:00,177,115,62,FMN GV 16 Berchem TOT
54,Posthofbrug 5366,2023-07-10,12:00:00,227,143,84,FMN GV 16 Berchem TOT
54,Posthofbrug 5366,2023-07-10,13:00:00,187,87,100,FMN GV 16 Berchem TOT
54,Posthofbrug 5366,2023-07-10,14:00:00,201,108,93,FMN GV 16 Berchem TOT
54,Posthofbrug 5366,2023-07-10,15:00:00,224,80,144,FMN GV 16 Berchem TOT
54,Posthofbrug 5366,2023-07-10,16:00:00,427,169,258,FMN GV 16 Berchem TOT
54,Posthofbrug 5366,2023-07-10,17:00:00,606,214,392,FMN GV 16 Berchem TOT
54,Posthofbrug 5366,2023-07-10,18:00:00,340,155,185,FMN GV 16 Berchem TOT
54,Posthofbrug 5366,2023-07-10,19:00:00,258,133,125,FMN GV 16 Berchem TOT
54,Posthofbrug 5366,2023-07-10,20:00:00,118,54,64,FMN GV 16 Berchem TOT
54,Posthofbrug 5366,2023-07-10,21:00:00,137,62,75,FMN GV 16 Berchem TOT
54,Posthofbrug 5366,2023-07-10,22:00:00,95,35,60,FMN GV 16 Berchem TOT
54,Posthofbrug 5366,2023-07-10,23:00:00,69,23,46,FMN GV 16 Berchem TOT
54,Posthofbrug 5366,2023-07-11,00:00:00,36,10,26,FMN GV 16 Berchem TOT
54,Posthofbrug 5366,2023-07-11,01:00:00,23,12,11,FMN GV 16 Berchem TOT
54,Posthofbrug 5366,2023-07-11,02:00:00,8,0,8,FMN GV 16 Berchem TOT
54,Posthofbrug 5366,2023-07-11,03:00:00,6,2,4,FMN GV 16 Berchem TOT
54,Posthofbrug 5366,2023-07-11,04:00:00,22,11,11,FMN GV 16 Berchem TOT
54,Posthofbrug 5366,2023-07-11,05:00:00,42,29,13,FMN GV 16 Berchem TOT
54,Posthofbrug 5366,2023-07-11,06:00:00,132,100,32,FMN GV 16 Berchem TOT
54,Posthofbrug 5366,2023-07-11,07:00:00,286,197,89,FMN GV 16 Berchem TOT
54,Posthofbrug 5366,2023-07-11,08:00:00,531,371,160,FMN GV 16 Berchem TOT
54,Posthofbrug 5366,2023-07-11,09:00:00,292,213,79,FMN GV 16 Berchem TOT
54,Posthofbrug 5366,2023-07-11,10:00:00,195,135,60,FMN GV 16 Berchem TOT
54,Posthofbrug 5366,2023-07-11,11:00:00,195,114,81,FMN GV 16 Berchem TOT
54,Posthofbrug 5366,2023-07-11,12:00:00,171,101,70,FMN GV 16 Berchem TOT
54,Posthofbrug 5366,2023-07-11,13:00:00,222,131,91,FMN GV 16 Berchem TOT
54,Posthofbrug 5366,2023-07-11,14:00:00,224,119,105,FMN GV 16 Berchem TOT
54,Posthofbrug 5366,2023-07-11,15:00:00,253,110,143,FMN GV 16 Berchem TOT
54,Posthofbrug 5366,2023-07-11,16:00:00,394,161,233,FMN GV 16 Berchem TOT
54,Posthofbrug 5366,2023-07-11,17:00:00,517,218,299,FMN GV 16 Berchem TOT
54,Posthofbrug 5366,2023-07-11,18:00:00,327,127,200,FMN GV 16 Berchem TOT
54,Posthofbrug 5366,2023-07-11,19:00:00,240,124,116,FMN GV 16 Berchem TOT
54,Posthofbrug 5366,2023-07-11,20:00:00,179,105,74,FMN GV 16 Berchem TOT
54,Posthofbrug 5366,2023-07-11,21:00:00,147,70,77,FMN GV 16 Berchem TOT
54,Posthofbrug 5366,2023-07-11,22:00:00,151,46,105,FMN GV 16 Berchem TOT
54,Posthofbrug 5366,2023-07-11,23:00:00,118,28,90,FMN GV 16 Berchem TOT
54,Posthofbrug 5366,2023-07-12,00:00:00,70,24,46,FMN GV 16 Berchem TOT
54,Posthofbrug 5366,2023-07-12,01:00:00,32,4,28,FMN GV 16 Berchem TOT
54,Posthofbrug 5366,2023-07-12,02:00:00,11,3,8,FMN GV 16 Berchem TOT
54,Posthofbrug 5366,2023-07-12,03:00:00,5,0,5,FMN GV 16 Berchem TOT
54,Posthofbrug 5366,2023-07-12,04:00:00,17,9,8,FMN GV 16 Berchem TOT
54,Posthofbrug 5366,2023-07-12,05:00:00,42,28,14,FMN GV 16 Berchem TOT
54,Posthofbrug 5366,2023-07-12,06:00:00,120,98,22,FMN GV 16 Berchem TOT
54,Posthofbrug 5366,2023-07-12,07:00:00,302,213,89,FMN GV 16 Berchem TOT
54,Posthofbrug 5366,2023-07-12,08:00:00,544,399,145,FMN GV 16 Berchem TOT
54,Posthofbrug 5366,2023-07-12,09:00:00,284,219,65,FMN GV 16 Berchem TOT
54,Posthofbrug 5366,2023-07-12,10:00:00,165,118,47,FMN GV 16 Berchem TOT
54,Posthofbrug 5366,2023-07-12,11:00:00,146,89,57,FMN GV 16 Berchem TOT
54,Posthofbrug 5366,2023-07-12,12:00:00,154,80,74,FMN GV 16 Berchem TOT
54,Posthofbrug 5366,2023-07-12,13:00:00,181,99,82,FMN GV 16 Berchem TOT
54,Posthofbrug 5366,2023-07-12,14:00:00,177,94,83,FMN GV 16 Berchem TOT
54,Posthofbrug 5366,2023-07-12,15:00:00,239,94,145,FMN GV 16 Berchem TOT
54,Posthofbrug 5366,2023-07-12,16:00:00,423,150,273,FMN GV 16 Berchem TOT
54,Posthofbrug 5366,2023-07-12,17:00:00,552,207,345,FMN GV 16 Berchem TOT
54,Posthofbrug 5366,2023-07-12,18:00:00,374,164,210,FMN GV 16 Berchem TOT
54,Posthofbrug 5366,2023-07-12,19:00:00,207,89,118,FMN GV 16 Berchem TOT
54,Posthofbrug 5366,2023-07-12,20:00:00,161,82,79,FMN GV 16 Berchem TOT
54,Posthofbrug 5366,2023-07-12,21:00:00,124,43,81,FMN GV 16 Berchem TOT
54,Posthofbrug 5366,2023-07-12,22:00:00,116,44,72,FMN GV 16 Berchem TOT
54,Posthofbrug 5366,2023-07-12,23:00:00,97,34,63,FMN GV 16 Berchem TOT
54,Posthofbrug 5366,2023-07-13,00:00:00,40,12,28,FMN GV 16 Berchem TOT
54,Posthofbrug 5366,2023-07-13,01:00:00,27,8,19,FMN GV 16 Berchem TOT
54,Posthofbrug 5366,2023-07-13,02:00:00,7,0,7,FMN GV 16 Berchem TOT
54,Posthofbrug 5366,2023-07-13,03:00:00,7,3,4,FMN GV 16 Berchem TOT
54,Posthofbrug 5366,2023-07-13,04:00:00,17,9,8,FMN GV 16 Berchem TOT
54,Posthofbrug 5366,2023-07-13,05:00:00,45,34,11,FMN GV 16 Berchem TOT
54,Posthofbrug 5366,2023-07-13,06:00:00,111,90,21,FMN GV 16 Berchem TOT
54,Posthofbrug 5366,2023-07-13,07:00:00,330,242,88,FMN GV 16 Berchem TOT
54,Posthofbrug 5366,2023-07-13,08:00:00,645,471,174,FMN GV 16 Berchem TOT
54,Posthofbrug 5366,2023-07-13,09:00:00,288,210,78,FMN GV 16 Berchem TOT
54,Posthofbrug 5366,2023-07-13,10:00:00,159,103,56,FMN GV 16 Berchem TOT
54,Posthofbrug 5366,2023-07-13,11:00:00,151,108,43,FMN GV 16 Berchem TOT
54,Posthofbrug 5366,2023-07-13,12:00:00,172,98,74,FMN GV 16 Berchem TOT
54,Posthofbrug 5366,2023-07-13,13:00:00,146,91,55,FMN GV 16 Berchem TOT
54,Posthofbrug 5366,2023-07-13,14:00:00,160,58,102,FMN GV 16 Berchem TOT
54,Posthofbrug 5366,2023-07-13,15:00:00,215,97,118,FMN GV 16 Berchem TOT
54,Posthofbrug 5366,2023-07-13,16:00:00,433,163,270,FMN GV 16 Berchem TOT
54,Posthofbrug 5366,2023-07-13,17:00:00,575,199,376,FMN GV 16 Berchem TOT
54,Posthofbrug 5366,2023-07-13,18:00:00,347,134,213,FMN GV 16 Berchem TOT
54,Posthofbrug 5366,2023-07-13,19:00:00,216,92,124,FMN GV 16 Berchem TOT
54,Posthofbrug 5366,2023-07-13,20:00:00,111,48,63,FMN GV 16 Berchem TOT
54,Posthofbrug 5366,2023-07-13,21:00:00,166,95,71,FMN GV 16 Berchem TOT
54,Posthofbrug 5366,2023-07-13,22:00:00,99,35,64,FMN GV 16 Berchem TOT
54,Posthofbrug 5366,2023-07-13,23:00:00,63,15,48,FMN GV 16 Berchem TOT
54,Posthofbrug 5366,2023-07-14,00:00:00,65,20,45,FMN GV 16 Berchem TOT
54,Posthofbrug 5366,2023-07-14,01:00:00,25,6,19,FMN GV 16 Berchem TOT
54,Posthofbrug 5366,2023-07-14,02:00:00,7,3,4,FMN GV 16 Berchem TOT
54,Posthofbrug 5366,2023-07-14,03:00:00,14,7,7,FMN GV 16 Berchem TOT
54,Posthofbrug 5366,2023-07-14,04:00:00,19,8,11,FMN GV 16 Berchem TOT
54,Posthofbrug 5366,2023-07-14,05:00:00,37,25,12,FMN GV 16 Berchem TOT
54,Posthofbrug 5366,2023-07-14,06:00:00,105,77,28,FMN GV 16 Berchem TOT
54,Posthofbrug 5366,2023-07-14,07:00:00,267,192,75,FMN GV 16 Berchem TOT
54,Posthofbrug 5366,2023-07-14,08:00:00,454,341,113,FMN GV 16 Berchem TOT
54,Posthofbrug 5366,2023-07-14,09:00:00,326,246,80,FMN GV 16 Berchem TOT
54,Posthofbrug 5366,2023-07-14,10:00:00,162,118,44,FMN GV 16 Berchem TOT
54,Posthofbrug 5366,2023-07-14,11:00:00,199,124,75,FMN GV 16 Berchem TOT
54,Posthofbrug 5366,2023-07-14,12:00:00,212,126,86,FMN GV 16 Berchem TOT
54,Posthofbrug 5366,2023-07-14,13:00:00,224,114,110,FMN GV 16 Berchem TOT
54,Posthofbrug 5366,2023-07-14,14:00:00,247,128,119,FMN GV 16 Berchem TOT
54,Posthofbrug 5366,2023-07-14,15:00:00,287,128,159,FMN GV 16 Berchem TOT
54,Posthofbrug 5366,2023-07-14,16:00:00,392,149,243,FMN GV 16 Berchem TOT
54,Posthofbrug 5366,2023-07-14,17:00:00,432,183,249,FMN GV 16 Berchem TOT
54,Posthofbrug 5366,2023-07-14,18:00:00,313,133,180,FMN GV 16 Berchem TOT
54,Posthofbrug 5366,2023-07-14,19:00:00,214,114,100,FMN GV 16 Berchem TOT
54,Posthofbrug 5366,2023-07-14,20:00:00,146,67,79,FMN GV 16 Berchem TOT
54,Posthofbrug 5366,2023-07-14,21:00:00,132,48,84,FMN GV 16 Berchem TOT
54,Posthofbrug 5366,2023-07-14,22:00:00,102,50,52,FMN GV 16 Berchem TOT
54,Posthofbrug 5366,2023-07-14,23:00:00,126,53,73,FMN GV 16 Berchem TOT
54,Posthofbrug 5366,2023-07-15,00:00:00,67,22,45,FMN GV 16 Berchem TOT
54,Posthofbrug 5366,2023-07-15,01:00:00,49,21,28,FMN GV 16 Berchem TOT
54,Posthofbrug 5366,2023-07-15,02:00:00,25,2,23,FMN GV 16 Berchem TOT
54,Posthofbrug 5366,2023-07-15,03:00:00,23,5,18,FMN GV 16 Berchem TOT
54,Posthofbrug 5366,2023-07-15,04:00:00,23,6,17,FMN GV 16 Berchem TOT
54,Posthofbrug 5366,2023-07-15,05:00:00,20,10,10,FMN GV 16 Berchem TOT
54,Posthofbrug 5366,2023-07-15,06:00:00,29,14,15,FMN GV 16 Berchem TOT
54,Posthofbrug 5366,2023-07-15,07:00:00,52,35,17,FMN GV 16 Berchem TOT
54,Posthofbrug 5366,2023-07-15,08:00:00,68,49,19,FMN GV 16 Berchem TOT
54,Posthofbrug 5366,2023-07-15,09:00:00,140,103,37,FMN GV 16 Berchem TOT
54,Posthofbrug 5366,2023-07-15,10:00:00,182,123,59,FMN GV 16 Berchem TOT
54,Posthofbrug 5366,2023-07-15,11:00:00,214,129,85,FMN GV 16 Berchem TOT
54,Posthofbrug 5366,2023-07-15,12:00:00,196,122,74,FMN GV 16 Berchem TOT
54,Posthofbrug 5366,2023-07-15,13:00:00,178,112,66,FMN GV 16 Berchem TOT
54,Posthofbrug 5366,2023-07-15,14:00:00,219,129,90,FMN GV 16 Berchem TOT
54,Posthofbrug 5366,2023-07-15,15:00:00,200,101,99,FMN GV 16 Berchem TOT
54,Posthofbrug 5366,2023-07-15,16:00:00,200,89,111,FMN GV 16 Berchem TOT
54,Posthofbrug 5366,2023-07-15,17:00:00,168,60,108,FMN GV 16 Berchem TOT
54,Posthofbrug 5366,2023-07-15,18:00:00,204,95,109,FMN GV 16 Berchem TOT
54,Posthofbrug 5366,2023-07-15,19:00:00,127,55,72,FMN GV 16 Berchem TOT
54,Posthofbrug 5366,2023-07-15,20:00:00,103,44,59,FMN GV 16 Berchem TOT
54,Posthofbrug 5366,2023-07-15,21:00:00,81,43,38,FMN GV 16 Berchem TOT
54,Posthofbrug 5366,2023-07-15,22:00:00,91,32,59,FMN GV 16 Berchem TOT
54,Posthofbrug 5366,2023-07-15,23:00:00,89,32,57,FMN GV 16 Berchem TOT
54,Posthofbrug 5366,2023-07-16,00:00:00,98,43,55,FMN GV 16 Berchem TOT
54,Posthofbrug 5366,2023-07-16,01:00:00,38,12,26,FMN GV 16 Berchem TOT
54,Posthofbrug 5366,2023-07-16,02:00:00,25,6,19,FMN GV 16 Berchem TOT
54,Posthofbrug 5366,2023-07-16,03:00:00,16,4,12,FMN GV 16 Berchem TOT
54,Posthofbrug 5366,2023-07-16,04:00:00,15,3,12,FMN GV 16 Berchem TOT
54,Posthofbrug 5366,2023-07-16,05:00:00,16,7,9,FMN GV 16 Berchem TOT
54,Posthofbrug 5366,2023-07-16,06:00:00,22,14,8,FMN GV 16 Berchem TOT
54,Posthofbrug 5366,2023-07-16,07:00:00,61,34,27,FMN GV 16 Berchem TOT
54,Posthofbrug 5366,2023-07-16,08:00:00,56,39,17,FMN GV 16 Berchem TOT
54,Posthofbrug 5366,2023-07-16,09:00:00,98,54,44,FMN GV 16 Berchem TOT
54,Posthofbrug 5366,2023-07-16,10:00:00,159,83,76,FMN GV 16 Berchem TOT
54,Posthofbrug 5366,2023-07-16,11:00:00,162,99,63,FMN GV 16 Berchem TOT
54,Posthofbrug 5366,2023-07-16,12:00:00,173,97,76,FMN GV 16 Berchem TOT
54,Posthofbrug 5366,2023-07-16,13:00:00,153,86,67,FMN GV 16 Berchem TOT
54,Posthofbrug 5366,2023-07-16,14:00:00,142,82,60,FMN GV 16 Berchem TOT
54,Posthofbrug 5366,2023-07-16,15:00:00,173,90,83,FMN GV 16 Berchem TOT
54,Posthofbrug 5366,2023-07-16,16:00:00,140,64,76,FMN GV 16 Berchem TOT
54,Posthofbrug 5366,2023-07-16,17:00:00,148,61,87,FMN GV 16 Berchem TOT
54,Posthofbrug 5366,2023-07-16,18:00:00,103,47,56,FMN GV 16 Berchem TOT
54,Posthofbrug 5366,2023-07-16,19:00:00,101,50,51,FMN GV 16 Berchem TOT
54,Posthofbrug 5366,2023-07-16,20:00:00,101,59,42,FMN GV 16 Berchem TOT
54,Posthofbrug 5366,2023-07-16,21:00:00,85,37,48,FMN GV 16 Berchem TOT
54,Posthofbrug 5366,2023-07-16,22:00:00,60,15,45,FMN GV 16 Berchem TOT
54,Posthofbrug 5366,2023-07-16,23:00:00,38,10,28,FMN GV 16 Berchem TOT
54,Posthofbrug 5366,2023-07-17,00:00:00,17,5,12,FMN GV 16 Berchem TOT
54,Posthofbrug 5366,2023-07-17,01:00:00,10,3,7,FMN GV 16 Berchem TOT
54,Posthofbrug 5366,2023-07-17,02:00:00,6,2,4,FMN GV 16 Berchem TOT
54,Posthofbrug 5366,2023-07-17,03:00:00,3,1,2,FMN GV 16 Berchem TOT
54,Posthofbrug 5366,2023-07-17,04:00:00,12,7,5,FMN GV 16 Berchem TOT
54,Posthofbrug 5366,2023-07-17,05:00:00,35,26,9,FMN GV 16 Berchem TOT
54,Posthofbrug 5366,2023-07-17,06:00:00,122,95,27,FMN GV 16 Berchem TOT
54,Posthofbrug 5366,2023-07-17,07:00:00,290,216,74,FMN GV 16 Berchem TOT
54,Posthofbrug 5366,2023-07-17,08:00:00,526,401,125,FMN GV 16 Berchem TOT
54,Posthofbrug 5366,2023-07-17,09:00:00,250,183,67,FMN GV 16 Berchem TOT
54,Posthofbrug 5366,2023-07-17,10:00:00,171,110,61,FMN GV 16 Berchem TOT
54,Posthofbrug 5366,2023-07-17,11:00:00,132,81,51,FMN GV 16 Berchem TOT
54,Posthofbrug 5366,2023-07-17,12:00:00,148,87,61,FMN GV 16 Berchem TOT
54,Posthofbrug 5366,2023-07-17,13:00:00,157,80,77,FMN GV 16 Berchem TOT
54,Posthofbrug 5366,2023-07-17,14:00:00,133,51,82,FMN GV 16 Berchem TOT
54,Posthofbrug 5366,2023-07-17,15:00:00,179,74,105,FMN GV 16 Berchem TOT
54,Posthofbrug 5366,2023-07-17,16:00:00,293,106,187,FMN GV 16 Berchem TOT
54,Posthofbrug 5366,2023-07-17,17:00:00,525,167,358,FMN GV 16 Berchem TOT
54,Posthofbrug 5366,2023-07-17,18:00:00,321,118,203,FMN GV 16 Berchem TOT
54,Posthofbrug 5366,2023-07-17,19:00:00,178,76,102,FMN GV 16 Berchem TOT
54,Posthofbrug 5366,2023-07-17,20:00:00,120,57,63,FMN GV 16 Berchem TOT
54,Posthofbrug 5366,2023-07-17,21:00:00,94,49,45,FMN GV 16 Berchem TOT
54,Posthofbrug 5366,2023-07-17,22:00:00,95,41,54,FMN GV 16 Berchem TOT
54,Posthofbrug 5366,2023-07-17,23:00:00,54,17,37,FMN GV 16 Berchem TOT
54,Posthofbrug 5366,2023-07-18,00:00:00,21,4,17,FMN GV 16 Berchem TOT
54,Posthofbrug 5366,2023-07-18,01:00:00,10,5,5,FMN GV 16 Berchem TOT
54,Posthofbrug 5366,2023-07-18,02:00:00,3,2,1,FMN GV 16 Berchem TOT
54,Posthofbrug 5366,2023-07-18,03:00:00,3,1,2,FMN GV 16 Berchem TOT
54,Posthofbrug 5366,2023-07-18,04:00:00,22,11,11,FMN GV 16 Berchem TOT
54,Posthofbrug 5366,2023-07-18,05:00:00,42,33,9,FMN GV 16 Berchem TOT
54,Posthofbrug 5366,2023-07-18,06:00:00,101,84,17,FMN GV 16 Berchem TOT
54,Posthofbrug 5366,2023-07-18,07:00:00,346,246,100,FMN GV 16 Berchem TOT
54,Posthofbrug 5366,2023-07-18,08:00:00,602,456,146,FMN GV 16 Berchem TOT
54,Posthofbrug 5366,2023-07-18,09:00:00,299,224,75,FMN GV 16 Berchem TOT
54,Posthofbrug 5366,2023-07-18,10:00:00,187,121,66,FMN GV 16 Berchem TOT
54,Posthofbrug 5366,2023-07-18,11:00:00,165,108,57,FMN GV 16 Berchem TOT
54,Posthofbrug 5366,2023-07-18,12:00:00,212,118,94,FMN GV 16 Berchem TOT
54,Posthofbrug 5366,2023-07-18,13:00:00,200,124,76,FMN GV 16 Berchem TOT
54,Posthofbrug 5366,2023-07-18,14:00:00,205,97,108,FMN GV 16 Berchem TOT
54,Posthofbrug 5366,2023-07-18,15:00:00,267,107,160,FMN GV 16 Berchem TOT
54,Posthofbrug 5366,2023-07-18,16:00:00,447,161,286,FMN GV 16 Berchem TOT
54,Posthofbrug 5366,2023-07-18,17:00:00,637,246,391,FMN GV 16 Berchem TOT
54,Posthofbrug 5366,2023-07-18,18:00:00,433,170,263,FMN GV 16 Berchem TOT
54,Posthofbrug 5366,2023-07-18,19:00:00,232,87,145,FMN GV 16 Berchem TOT
54,Posthofbrug 5366,2023-07-18,20:00:00,163,73,90,FMN GV 16 Berchem TOT
54,Posthofbrug 5366,2023-07-18,21:00:00,122,53,69,FMN GV 16 Berchem TOT
54,Posthofbrug 5366,2023-07-18,22:00:00,127,56,71,FMN GV 16 Berchem TOT
54,Posthofbrug 5366,2023-07-18,23:00:00,78,25,53,FMN GV 16 Berchem TOT
54,Posthofbrug 5366,2023-07-19,00:00:00,43,23,20,FMN GV 16 Berchem TOT
54,Posthofbrug 5366,2023-07-19,01:00:00,20,7,13,FMN GV 16 Berchem TOT
54,Posthofbrug 5366,2023-07-19,02:00:00,16,1,15,FMN GV 16 Berchem TOT
54,Posthofbrug 5366,2023-07-19,03:00:00,3,1,2,FMN GV 16 Berchem TOT
54,Posthofbrug 5366,2023-07-19,04:00:00,18,13,5,FMN GV 16 Berchem TOT
54,Posthofbrug 5366,2023-07-19,05:00:00,31,22,9,FMN GV 16 Berchem TOT
54,Posthofbrug 5366,2023-07-19,06:00:00,113,84,29,FMN GV 16 Berchem TOT
54,Posthofbrug 5366,2023-07-19,07:00:00,273,202,71,FMN GV 16 Berchem TOT
54,Posthofbrug 5366,2023-07-19,08:00:00,480,348,132,FMN GV 16 Berchem TOT
54,Posthofbrug 5366,2023-07-19,09:00:00,263,190,73,FMN GV 16 Berchem TOT
54,Posthofbrug 5366,2023-07-19,10:00:00,174,121,53,FMN GV 16 Berchem TOT
54,Posthofbrug 5366,2023-07-19,11:00:00,161,107,54,FMN GV 16 Berchem TOT
54,Posthofbrug 5366,2023-07-19,12:00:00,190,101,89,FMN GV 16 Berchem TOT
54,Posthofbrug 5366,2023-07-19,13:00:00,170,91,79,FMN GV 16 Berchem TOT
54,Posthofbrug 5366,2023-07-19,14:00:00,185,110,75,FMN GV 16 Berchem TOT
54,Posthofbrug 5366,2023-07-19,15:00:00,238,118,120,FMN GV 16 Berchem TOT
54,Posthofbrug 5366,2023-07-19,16:00:00,348,131,217,FMN GV 16 Berchem TOT
54,Posthofbrug 5366,2023-07-19,17:00:00,463,168,295,FMN GV 16 Berchem TOT
54,Posthofbrug 5366,2023-07-19,18:00:00,299,100,199,FMN GV 16 Berchem TOT
54,Posthofbrug 5366,2023-07-19,19:00:00,165,85,80,FMN GV 16 Berchem TOT
54,Posthofbrug 5366,2023-07-19,20:00:00,113,57,56,FMN GV 16 Berchem TOT
54,Posthofbrug 5366,2023-07-19,21:00:00,98,47,51,FMN GV 16 Berchem TOT
54,Posthofbrug 5366,2023-07-19,22:00:00,85,36,49,FMN GV 16 Berchem TOT
54,Posthofbrug 5366,2023-07-19,23:00:00,68,15,53,FMN GV 16 Berchem TOT
54,Posthofbrug 5366,2023-07-20,00:00:00,44,11,33,FMN GV 16 Berchem TOT
54,Posthofbrug 5366,2023-07-20,01:00:00,21,5,16,FMN GV 16 Berchem TOT
54,Posthofbrug 5366,2023-07-20,02:00:00,2,0,2,FMN GV 16 Berchem TOT
54,Posthofbrug 5366,2023-07-20,03:00:00,5,3,2,FMN GV 16 Berchem TOT
54,Posthofbrug 5366,2023-07-20,04:00:00,18,8,10,FMN GV 16 Berchem TOT
54,Posthofbrug 5366,2023-07-20,05:00:00,29,18,11,FMN GV 16 Berchem TOT
54,Posthofbrug 5366,2023-07-20,06:00:00,103,84,19,FMN GV 16 Berchem TOT
54,Posthofbrug 5366,2023-07-20,07:00:00,270,194,76,FMN GV 16 Berchem TOT
54,Posthofbrug 5366,2023-07-20,08:00:00,462,343,119,FMN GV 16 Berchem TOT
54,Posthofbrug 5366,2023-07-20,09:00:00,238,190,48,FMN GV 16 Berchem TOT
54,Posthofbrug 5366,2023-07-20,10:00:00,178,118,60,FMN GV 16 Berchem TOT
54,Posthofbrug 5366,2023-07-20,11:00:00,189,137,52,FMN GV 16 Berchem TOT
54,Posthofbrug 5366,2023-07-20,12:00:00,209,125,84,FMN GV 16 Berchem TOT
54,Posthofbrug 5366,2023-07-20,13:00:00,189,106,83,FMN GV 16 Berchem TOT
54,Posthofbrug 5366,2023-07-20,14:00:00,211,109,102,FMN GV 16 Berchem TOT
54,Posthofbrug 5366,2023-07-20,15:00:00,219,105,114,FMN GV 16 Berchem TOT
54,Posthofbrug 5366,2023-07-20,16:00:00,399,161,238,FMN GV 16 Berchem TOT
54,Posthofbrug 5366,2023-07-20,17:00:00,434,158,276,FMN GV 16 Berchem TOT
54,Posthofbrug 5366,2023-07-20,18:00:00,273,108,165,FMN GV 16 Berchem TOT
54,Posthofbrug 5366,2023-07-20,19:00:00,185,77,108,FMN GV 16 Berchem TOT
54,Posthofbrug 5366,2023-07-20,20:00:00,113,51,62,FMN GV 16 Berchem TOT
54,Posthofbrug 5366,2023-07-20,21:00:00,129,56,73,FMN GV 16 Berchem TOT
54,Posthofbrug 5366,2023-07-20,22:00:00,67,32,35,FMN GV 16 Berchem TOT
54,Posthofbrug 5366,2023-07-20,23:00:00,99,37,62,FMN GV 16 Berchem TOT
54,Posthofbrug 5366,2023-07-21,00:00:00,44,19,25,FMN GV 16 Berchem TOT
54,Posthofbrug 5366,2023-07-21,01:00:00,32,7,25,FMN GV 16 Berchem TOT
54,Posthofbrug 5366,2023-07-21,02:00:00,27,6,21,FMN GV 16 Berchem TOT
54,Posthofbrug 5366,2023-07-21,03:00:00,13,0,13,FMN GV 16 Berchem TOT
54,Posthofbrug 5366,2023-07-21,04:00:00,13,2,11,FMN GV 16 Berchem TOT
54,Posthofbrug 5366,2023-07-21,05:00:00,23,13,10,FMN GV 16 Berchem TOT
54,Posthofbrug 5366,2023-07-21,06:00:00,31,21,10,FMN GV 16 Berchem TOT
54,Posthofbrug 5366,2023-07-21,07:00:00,45,23,22,FMN GV 16 Berchem TOT
54,Posthofbrug 5366,2023-07-21,08:00:00,57,39,18,FMN GV 16 Berchem TOT
54,Posthofbrug 5366,2023-07-21,09:00:00,92,66,26,FMN GV 16 Berchem TOT
54,Posthofbrug 5366,2023-07-21,10:00:00,239,133,106,FMN GV 16 Berchem TOT
54,Posthofbrug 5366,2023-07-21,11:00:00,121,80,41,FMN GV 16 Berchem TOT
54,Posthofbrug 5366,2023-07-21,12:00:00,104,57,47,FMN GV 16 Berchem TOT
54,Posthofbrug 5366,2023-07-21,13:00:00,117,66,51,FMN GV 16 Berchem TOT
54,Posthofbrug 5366,2023-07-21,14:00:00,130,69,61,FMN GV 16 Berchem TOT
54,Posthofbrug 5366,2023-07-21,15:00:00,152,89,63,FMN GV 16 Berchem TOT
54,Posthofbrug 5366,2023-07-21,16:00:00,153,86,67,FMN GV 16 Berchem TOT
54,Posthofbrug 5366,2023-07-21,17:00:00,161,97,64,FMN GV 16 Berchem TOT
54,Posthofbrug 5366,2023-07-21,18:00:00,165,97,68,FMN GV 16 Berchem TOT
54,Posthofbrug 5366,2023-07-21,19:00:00,144,80,64,FMN GV 16 Berchem TOT
54,Posthofbrug 5366,2023-07-21,20:00:00,102,45,57,FMN GV 16 Berchem TOT
54,Posthofbrug 5366,2023-07-21,21:00:00,86,32,54,FMN GV 16 Berchem TOT
54,Posthofbrug 5366,2023-07-21,22:00:00,71,24,47,FMN GV 16 Berchem TOT
54,Posthofbrug 5366,2023-07-21,23:00:00,71,17,54,FMN GV 16 Berchem TOT
54,Posthofbrug 5366,2023-07-22,00:00:00,55,21,34,FMN GV 16 Berchem TOT
54,Posthofbrug 5366,2023-07-22,01:00:00,29,6,23,FMN GV 16 Berchem TOT
54,Posthofbrug 5366,2023-07-22,02:00:00,18,4,14,FMN GV 16 Berchem TOT
54,Posthofbrug 5366,2023-07-22,03:00:00,17,4,13,FMN GV 16 Berchem TOT
54,Posthofbrug 5366,2023-07-22,04:00:00,15,2,13,FMN GV 16 Berchem TOT
54,Posthofbrug 5366,2023-07-22,05:00:00,22,16,6,FMN GV 16 Berchem TOT
54,Posthofbrug 5366,2023-07-22,06:00:00,28,19,9,FMN GV 16 Berchem TOT
54,Posthofbrug 5366,2023-07-22,07:00:00,37,19,18,FMN GV 16 Berchem TOT
54,Posthofbrug 5366,2023-07-22,08:00:00,76,55,21,FMN GV 16 Berchem TOT
54,Posthofbrug 5366,2023-07-22,09:00:00,122,89,33,FMN GV 16 Berchem TOT
54,Posthofbrug 5366,2023-07-22,10:00:00,174,115,59,FMN GV 16 Berchem TOT
54,Posthofbrug 5366,2023-07-22,11:00:00,171,111,60,FMN GV 16 Berchem TOT
54,Posthofbrug 5366,2023-07-22,12:00:00,222,127,95,FMN GV 16 Berchem TOT
54,Posthofbrug 5366,2023-07-22,13:00:00,189,124,65,FMN GV 16 Berchem TOT
54,Posthofbrug 5366,2023-07-22,14:00:00,234,150,84,FMN GV 16 Berchem TOT
54,Posthofbrug 5366,2023-07-22,15:00:00,174,86,88,FMN GV 16 Berchem TOT
54,Posthofbrug 5366,2023-07-22,16:00:00,205,78,127,FMN GV 16 Berchem TOT
54,Posthofbrug 5366,2023-07-22,17:00:00,174,76,98,FMN GV 16 Berchem TOT
54,Posthofbrug 5366,2023-07-22,18:00:00,141,58,83,FMN GV 16 Berchem TOT
54,Posthofbrug 5366,2023-07-22,19:00:00,116,57,59,FMN GV 16 Berchem TOT
54,Posthofbrug 5366,2023-07-22,20:00:00,73,46,27,FMN GV 16 Berchem TOT
54,Posthofbrug 5366,2023-07-22,21:00:00,51,19,32,FMN GV 16 Berchem TOT
54,Posthofbrug 5366,2023-07-22,22:00:00,70,27,43,FMN GV 16 Berchem TOT
54,Posthofbrug 5366,2023-07-22,23:00:00,61,12,49,FMN GV 16 Berchem TOT
54,Posthofbrug 5366,2023-07-23,00:00:00,37,11,26,FMN GV 16 Berchem TOT
54,Posthofbrug 5366,2023-07-23,01:00:00,21,6,15,FMN GV 16 Berchem TOT
54,Posthofbrug 5366,2023-07-23,02:00:00,18,6,12,FMN GV 16 Berchem TOT
54,Posthofbrug 5366,2023-07-23,03:00:00,17,3,14,FMN GV 16 Berchem TOT
54,Posthofbrug 5366,2023-07-23,04:00:00,17,8,9,FMN GV 16 Berchem TOT
54,Posthofbrug 5366,2023-07-23,05:00:00,12,6,6,FMN GV 16 Berchem TOT
54,Posthofbrug 5366,2023-07-23,06:00:00,8,4,4,FMN GV 16 Berchem TOT
54,Posthofbrug 5366,2023-07-23,07:00:00,24,8,16,FMN GV 16 Berchem TOT
54,Posthofbrug 5366,2023-07-23,08:00:00,39,32,7,FMN GV 16 Berchem TOT
54,Posthofbrug 5366,2023-07-23,09:00:00,39,22,17,FMN GV 16 Berchem TOT
54,Posthofbrug 5366,2023-07-23,10:00:00,77,49,28,FMN GV 16 Berchem TOT
54,Posthofbrug 5366,2023-07-23,11:00:00,74,50,24,FMN GV 16 Berchem TOT
54,Posthofbrug 5366,2023-07-23,12:00:00,76,40,36,FMN GV 16 Berchem TOT
54,Posthofbrug 5366,2023-07-23,13:00:00,136,76,60,FMN GV 16 Berchem TOT
54,Posthofbrug 5366,2023-07-23,14:00:00,105,60,45,FMN GV 16 Berchem TOT
54,Posthofbrug 5366,2023-07-23,15:00:00,105,53,52,FMN GV 16 Berchem TOT
54,Posthofbrug 5366,2023-07-23,16:00:00,106,61,45,FMN GV 16 Berchem TOT
54,Posthofbrug 5366,2023-07-23,17:00:00,127,62,65,FMN GV 16 Berchem TOT
54,Posthofbrug 5366,2023-07-23,18:00:00,78,38,40,FMN GV 16 Berchem TOT
54,Posthofbrug 5366,2023-07-23,19:00:00,42,20,22,FMN GV 16 Berchem TOT
54,Posthofbrug 5366,2023-07-23,20:00:00,61,27,34,FMN GV 16 Berchem TOT
54,Posthofbrug 5366,2023-07-23,21:00:00,36,14,22,FMN GV 16 Berchem TOT
54,Posthofbrug 5366,2023-07-23,22:00:00,51,17,34,FMN GV 16 Berchem TOT
54,Posthofbrug 5366,2023-07-23,23:00:00,27,15,12,FMN GV 16 Berchem TOT
54,Posthofbrug 5366,2023-07-24,00:00:00,10,2,8,FMN GV 16 Berchem TOT
54,Posthofbrug 5366,2023-07-24,01:00:00,7,5,2,FMN GV 16 Berchem TOT
54,Posthofbrug 5366,2023-07-24,02:00:00,6,3,3,FMN GV 16 Berchem TOT
54,Posthofbrug 5366,2023-07-24,03:00:00,4,1,3,FMN GV 16 Berchem TOT
54,Posthofbrug 5366,2023-07-24,04:00:00,13,8,5,FMN GV 16 Berchem TOT
54,Posthofbrug 5366,2023-07-24,05:00:00,20,14,6,FMN GV 16 Berchem TOT
54,Posthofbrug 5366,2023-07-24,06:00:00,74,50,24,FMN GV 16 Berchem TOT
54,Posthofbrug 5366,2023-07-24,07:00:00,237,175,62,FMN GV 16 Berchem TOT
54,Posthofbrug 5366,2023-07-24,08:00:00,402,304,98,FMN GV 16 Berchem TOT
54,Posthofbrug 5366,2023-07-24,09:00:00,163,122,41,FMN GV 16 Berchem TOT
54,Posthofbrug 5366,2023-07-24,10:00:00,114,72,42,FMN GV 16 Berchem TOT
54,Posthofbrug 5366,2023-07-24,11:00:00,88,54,34,FMN GV 16 Berchem TOT
54,Posthofbrug 5366,2023-07-24,12:00:00,91,43,48,FMN GV 16 Berchem TOT
54,Posthofbrug 5366,2023-07-24,13:00:00,113,61,52,FMN GV 16 Berchem TOT
54,Posthofbrug 5366,2023-07-24,14:00:00,117,68,49,FMN GV 16 Berchem TOT
54,Posthofbrug 5366,2023-07-24,15:00:00,113,54,59,FMN GV 16 Berchem TOT
54,Posthofbrug 5366,2023-07-24,16:00:00,240,94,146,FMN GV 16 Berchem TOT
54,Posthofbrug 5366,2023-07-24,17:00:00,357,116,241,FMN GV 16 Berchem TOT
54,Posthofbrug 5366,2023-07-24,18:00:00,257,83,174,FMN GV 16 Berchem TOT
54,Posthofbrug 5366,2023-07-24,19:00:00,110,38,72,FMN GV 16 Berchem TOT
54,Posthofbrug 5366,2023-07-24,20:00:00,113,52,61,FMN GV 16 Berchem TOT
54,Posthofbrug 5366,2023-07-24,21:00:00,73,43,30,FMN GV 16 Berchem TOT
54,Posthofbrug 5366,2023-07-24,22:00:00,53,20,33,FMN GV 16 Berchem TOT
54,Posthofbrug 5366,2023-07-24,23:00:00,31,12,19,FMN GV 16 Berchem TOT
54,Posthofbrug 5366,2023-07-25,00:00:00,26,11,15,FMN GV 16 Berchem TOT
54,Posthofbrug 5366,2023-07-25,01:00:00,14,8,6,FMN GV 16 Berchem TOT
54,Posthofbrug 5366,2023-07-25,02:00:00,5,2,3,FMN GV 16 Berchem TOT
54,Posthofbrug 5366,2023-07-25,03:00:00,6,3,3,FMN GV 16 Berchem TOT
54,Posthofbrug 5366,2023-07-25,04:00:00,21,10,11,FMN GV 16 Berchem TOT
54,Posthofbrug 5366,2023-07-25,05:00:00,33,26,7,FMN GV 16 Berchem TOT
54,Posthofbrug 5366,2023-07-25,06:00:00,123,96,27,FMN GV 16 Berchem TOT
54,Posthofbrug 5366,2023-07-25,07:00:00,306,214,92,FMN GV 16 Berchem TOT
54,Posthofbrug 5366,2023-07-25,08:00:00,455,343,112,FMN GV 16 Berchem TOT
54,Posthofbrug 5366,2023-07-25,09:00:00,245,190,55,FMN GV 16 Berchem TOT
54,Posthofbrug 5366,2023-07-25,10:00:00,155,101,54,FMN GV 16 Berchem TOT
54,Posthofbrug 5366,2023-07-25,11:00:00,145,97,48,FMN GV 16 Berchem TOT
54,Posthofbrug 5366,2023-07-25,12:00:00,177,91,86,FMN GV 16 Berchem TOT
54,Posthofbrug 5366,2023-07-25,13:00:00,178,112,66,FMN GV 16 Berchem TOT
54,Posthofbrug 5366,2023-07-25,14:00:00,211,115,96,FMN GV 16 Berchem TOT
54,Posthofbrug 5366,2023-07-25,15:00:00,208,82,126,FMN GV 16 Berchem TOT
54,Posthofbrug 5366,2023-07-25,16:00:00,389,143,246,FMN GV 16 Berchem TOT
54,Posthofbrug 5366,2023-07-25,17:00:00,549,197,352,FMN GV 16 Berchem TOT
54,Posthofbrug 5366,2023-07-25,18:00:00,332,126,206,FMN GV 16 Berchem TOT
54,Posthofbrug 5366,2023-07-25,19:00:00,215,90,125,FMN GV 16 Berchem TOT
54,Posthofbrug 5366,2023-07-25,20:00:00,146,92,54,FMN GV 16 Berchem TOT
54,Posthofbrug 5366,2023-07-25,21:00:00,101,44,57,FMN GV 16 Berchem TOT
54,Posthofbrug 5366,2023-07-25,22:00:00,100,45,55,FMN GV 16 Berchem TOT
54,Posthofbrug 5366,2023-07-25,23:00:00,76,23,53,FMN GV 16 Berchem TOT
54,Posthofbrug 5366,2023-07-26,00:00:00,41,16,25,FMN GV 16 Berchem TOT
54,Posthofbrug 5366,2023-07-26,01:00:00,22,3,19,FMN GV 16 Berchem TOT
54,Posthofbrug 5366,2023-07-26,02:00:00,12,1,11,FMN GV 16 Berchem TOT
54,Posthofbrug 5366,2023-07-26,03:00:00,13,1,12,FMN GV 16 Berchem TOT
54,Posthofbrug 5366,2023-07-26,04:00:00,19,11,8,FMN GV 16 Berchem TOT
54,Posthofbrug 5366,2023-07-26,05:00:00,28,20,8,FMN GV 16 Berchem TOT
54,Posthofbrug 5366,2023-07-26,06:00:00,116,82,34,FMN GV 16 Berchem TOT
54,Posthofbrug 5366,2023-07-26,07:00:00,302,220,82,FMN GV 16 Berchem TOT
54,Posthofbrug 5366,2023-07-26,08:00:00,448,337,111,FMN GV 16 Berchem TOT
54,Posthofbrug 5366,2023-07-26,09:00:00,237,174,63,FMN GV 16 Berchem TOT
54,Posthofbrug 5366,2023-07-26,10:00:00,179,122,57,FMN GV 16 Berchem TOT
54,Posthofbrug 5366,2023-07-26,11:00:00,186,118,68,FMN GV 16 Berchem TOT
54,Posthofbrug 5366,2023-07-26,12:00:00,178,106,72,FMN GV 16 Berchem TOT
54,Posthofbrug 5366,2023-07-26,13:00:00,188,113,75,FMN GV 16 Berchem TOT
54,Posthofbrug 5366,2023-07-26,14:00:00,181,101,80,FMN GV 16 Berchem TOT
54,Posthofbrug 5366,2023-07-26,15:00:00,199,96,103,FMN GV 16 Berchem TOT
54,Posthofbrug 5366,2023-07-26,16:00:00,370,146,224,FMN GV 16 Berchem TOT
54,Posthofbrug 5366,2023-07-26,17:00:00,515,192,323,FMN GV 16 Berchem TOT
54,Posthofbrug 5366,2023-07-26,18:00:00,358,140,218,FMN GV 16 Berchem TOT
54,Posthofbrug 5366,2023-07-26,19:00:00,206,95,111,FMN GV 16 Berchem TOT
54,Posthofbrug 5366,2023-07-26,20:00:00,154,72,82,FMN GV 16 Berchem TOT
54,Posthofbrug 5366,2023-07-26,21:00:00,168,74,94,FMN GV 16 Berchem TOT
54,Posthofbrug 5366,2023-07-26,22:00:00,92,24,68,FMN GV 16 Berchem TOT
54,Posthofbrug 5366,2023-07-26,23:00:00,74,23,51,FMN GV 16 Berchem TOT
54,Posthofbrug 5366,2023-07-27,00:00:00,37,15,22,FMN GV 16 Berchem TOT
54,Posthofbrug 5366,2023-07-27,01:00:00,16,3,13,FMN GV 16 Berchem TOT
54,Posthofbrug 5366,2023-07-27,02:00:00,10,3,7,FMN GV 16 Berchem TOT
54,Posthofbrug 5366,2023-07-27,03:00:00,5,1,4,FMN GV 16 Berchem TOT
54,Posthofbrug 5366,2023-07-27,04:00:00,14,10,4,FMN GV 16 Berchem TOT
54,Posthofbrug 5366,2023-07-27,05:00:00,24,18,6,FMN GV 16 Berchem TOT
54,Posthofbrug 5366,2023-07-27,06:00:00,72,52,20,FMN GV 16 Berchem TOT
54,Posthofbrug 5366,2023-07-27,07:00:00,159,118,41,FMN GV 16 Berchem TOT
54,Posthofbrug 5366,2023-07-27,08:00:00,365,269,96,FMN GV 16 Berchem TOT
54,Posthofbrug 5366,2023-07-27,09:00:00,192,147,45,FMN GV 16 Berchem TOT
54,Posthofbrug 5366,2023-07-27,10:00:00,81,55,26,FMN GV 16 Berchem TOT
54,Posthofbrug 5366,2023-07-27,11:00:00,78,49,29,FMN GV 16 Berchem TOT
54,Posthofbrug 5366,2023-07-27,12:00:00,95,45,50,FMN GV 16 Berchem TOT
54,Posthofbrug 5366,2023-07-27,13:00:00,85,45,40,FMN GV 16 Berchem TOT
54,Posthofbrug 5366,2023-07-27,14:00:00,88,42,46,FMN GV 16 Berchem TOT
54,Posthofbrug 5366,2023-07-27,15:00:00,100,43,57,FMN GV 16 Berchem TOT
54,Posthofbrug 5366,2023-07-27,16:00:00,240,83,157,FMN GV 16 Berchem TOT
54,Posthofbrug 5366,2023-07-27,17:00:00,309,104,205,FMN GV 16 Berchem TOT
54,Posthofbrug 5366,2023-07-27,18:00:00,224,67,157,FMN GV 16 Berchem TOT
54,Posthofbrug 5366,2023-07-27,19:00:00,118,36,82,FMN GV 16 Berchem TOT
54,Posthofbrug 5366,2023-07-27,20:00:00,77,25,52,FMN GV 16 Berchem TOT
54,Posthofbrug 5366,2023-07-27,21:00:00,78,39,39,FMN GV 16 Berchem TOT
54,Posthofbrug 5366,2023-07-27,22:00:00,60,35,25,FMN GV 16 Berchem TOT
54,Posthofbrug 5366,2023-07-27,23:00:00,46,32,14,FMN GV 16 Berchem TOT
54,Posthofbrug 5366,2023-07-28,00:00:00,28,25,3,FMN GV 16 Berchem TOT
54,Posthofbrug 5366,2023-07-28,01:00:00,17,9,8,FMN GV 16 Berchem TOT
54,Posthofbrug 5366,2023-07-28,02:00:00,11,4,7,FMN GV 16 Berchem TOT
54,Posthofbrug 5366,2023-07-28,03:00:00,8,4,4,FMN GV 16 Berchem TOT
54,Posthofbrug 5366,2023-07-28,04:00:00,20,12,8,FMN GV 16 Berchem TOT
54,Posthofbrug 5366,2023-07-28,05:00:00,30,16,14,FMN GV 16 Berchem TOT
54,Posthofbrug 5366,2023-07-28,06:00:00,79,61,18,FMN GV 16 Berchem TOT
54,Posthofbrug 5366,2023-07-28,07:00:00,207,149,58,FMN GV 16 Berchem TOT
54,Posthofbrug 5366,2023-07-28,08:00:00,347,263,84,FMN GV 16 Berchem TOT
54,Posthofbrug 5366,2023-07-28,09:00:00,217,160,57,FMN GV 16 Berchem TOT
54,Posthofbrug 5366,2023-07-28,10:00:00,134,88,46,FMN GV 16 Berchem TOT
54,Posthofbrug 5366,2023-07-28,11:00:00,167,101,66,FMN GV 16 Berchem TOT
54,Posthofbrug 5366,2023-07-28,12:00:00,189,110,79,FMN GV 16 Berchem TOT
54,Posthofbrug 5366,2023-07-28,13:00:00,154,93,61,FMN GV 16 Berchem TOT
54,Posthofbrug 5366,2023-07-28,14:00:00,192,88,104,FMN GV 16 Berchem TOT
54,Posthofbrug 5366,2023-07-28,15:00:00,234,103,131,FMN GV 16 Berchem TOT
54,Posthofbrug 5366,2023-07-28,16:00:00,288,101,187,FMN GV 16 Berchem TOT
54,Posthofbrug 5366,2023-07-28,17:00:00,394,149,245,FMN GV 16 Berchem TOT
54,Posthofbrug 5366,2023-07-28,18:00:00,292,118,174,FMN GV 16 Berchem TOT
54,Posthofbrug 5366,2023-07-28,19:00:00,202,95,107,FMN GV 16 Berchem TOT
54,Posthofbrug 5366,2023-07-28,20:00:00,142,65,77,FMN GV 16 Berchem TOT
54,Posthofbrug 5366,2023-07-28,21:00:00,111,40,71,FMN GV 16 Berchem TOT
54,Posthofbrug 5366,2023-07-28,22:00:00,92,37,55,FMN GV 16 Berchem TOT
54,Posthofbrug 5366,2023-07-28,23:00:00,97,34,63,FMN GV 16 Berchem TOT
54,Posthofbrug 5366,2023-07-29,00:00:00,75,33,42,FMN GV 16 Berchem TOT
54,Posthofbrug 5366,2023-07-29,01:00:00,54,31,23,FMN GV 16 Berchem TOT
54,Posthofbrug 5366,2023-07-29,02:00:00,68,50,18,FMN GV 16 Berchem TOT
54,Posthofbrug 5366,2023-07-29,03:00:00,77,63,14,FMN GV 16 Berchem TOT
54,Posthofbrug 5366,2023-07-29,04:00:00,35,21,14,FMN GV 16 Berchem TOT
54,Posthofbrug 5366,2023-07-29,05:00:00,16,7,9,FMN GV 16 Berchem TOT
54,Posthofbrug 5366,2023-07-29,06:00:00,27,17,10,FMN GV 16 Berchem TOT
54,Posthofbrug 5366,2023-07-29,07:00:00,40,23,17,FMN GV 16 Berchem TOT
54,Posthofbrug 5366,2023-07-29,08:00:00,54,39,15,FMN GV 16 Berchem TOT
54,Posthofbrug 5366,2023-07-29,09:00:00,143,105,38,FMN GV 16 Berchem TOT
54,Posthofbrug 5366,2023-07-29,10:00:00,141,100,41,FMN GV 16 Berchem TOT
54,Posthofbrug 5366,2023-07-29,11:00:00,170,118,52,FMN GV 16 Berchem TOT
54,Posthofbrug 5366,2023-07-29,12:00:00,139,87,52,FMN GV 16 Berchem TOT
54,Posthofbrug 5366,2023-07-29,13:00:00,99,57,42,FMN GV 16 Berchem TOT
54,Posthofbrug 5366,2023-07-29,14:00:00,200,103,97,FMN GV 16 Berchem TOT
54,Posthofbrug 5366,2023-07-29,15:00:00,188,102,86,FMN GV 16 Berchem TOT
54,Posthofbrug 5366,2023-07-29,16:00:00,153,53,100,FMN GV 16 Berchem TOT
54,Posthofbrug 5366,2023-07-29,17:00:00,166,63,103,FMN GV 16 Berchem TOT
54,Posthofbrug 5366,2023-07-29,18:00:00,171,72,99,FMN GV 16 Berchem TOT
54,Posthofbrug 5366,2023-07-29,19:00:00,156,62,94,FMN GV 16 Berchem TOT
54,Posthofbrug 5366,2023-07-29,20:00:00,130,57,73,FMN GV 16 Berchem TOT
54,Posthofbrug 5366,2023-07-29,21:00:00,102,46,56,FMN GV 16 Berchem TOT
54,Posthofbrug 5366,2023-07-29,22:00:00,83,40,43,FMN GV 16 Berchem TOT
54,Posthofbrug 5366,2023-07-29,23:00:00,82,40,42,FMN GV 16 Berchem TOT
54,Posthofbrug 5366,2023-07-30,00:00:00,68,36,32,FMN GV 16 Berchem TOT
54,Posthofbrug 5366,2023-07-30,01:00:00,67,41,26,FMN GV 16 Berchem TOT
54,Posthofbrug 5366,2023-07-30,02:00:00,79,68,11,FMN GV 16 Berchem TOT
54,Posthofbrug 5366,2023-07-30,03:00:00,66,57,9,FMN GV 16 Berchem TOT
54,Posthofbrug 5366,2023-07-30,04:00:00,29,19,10,FMN GV 16 Berchem TOT
54,Posthofbrug 5366,2023-07-30,05:00:00,29,16,13,FMN GV 16 Berchem TOT
54,Posthofbrug 5366,2023-07-30,06:00:00,18,12,6,FMN GV 16 Berchem TOT
54,Posthofbrug 5366,2023-07-30,07:00:00,33,22,11,FMN GV 16 Berchem TOT
54,Posthofbrug 5366,2023-07-30,08:00:00,50,30,20,FMN GV 16 Berchem TOT
54,Posthofbrug 5366,2023-07-30,09:00:00,87,61,26,FMN GV 16 Berchem TOT
54,Posthofbrug 5366,2023-07-30,10:00:00,128,77,51,FMN GV 16 Berchem TOT
54,Posthofbrug 5366,2023-07-30,11:00:00,124,66,58,FMN GV 16 Berchem TOT
54,Posthofbrug 5366,2023-07-30,12:00:00,183,101,82,FMN GV 16 Berchem TOT
54,Posthofbrug 5366,2023-07-30,13:00:00,179,95,84,FMN GV 16 Berchem TOT
54,Posthofbrug 5366,2023-07-30,14:00:00,178,84,94,FMN GV 16 Berchem TOT
54,Posthofbrug 5366,2023-07-30,15:00:00,188,100,88,FMN GV 16 Berchem TOT
54,Posthofbrug 5366,2023-07-30,16:00:00,179,91,88,FMN GV 16 Berchem TOT
54,Posthofbrug 5366,2023-07-30,17:00:00,189,95,94,FMN GV 16 Berchem TOT
54,Posthofbrug 5366,2023-07-30,18:00:00,159,92,67,FMN GV 16 Berchem TOT
54,Posthofbrug 5366,2023-07-30,19:00:00,71,45,26,FMN GV 16 Berchem TOT
54,Posthofbrug 5366,2023-07-30,20:00:00,57,28,29,FMN GV 16 Berchem TOT
54,Posthofbrug 5366,2023-07-30,21:00:00,74,31,43,FMN GV 16 Berchem TOT
54,Posthofbrug 5366,2023-07-30,22:00:00,43,21,22,FMN GV 16 Berchem TOT
54,Posthofbrug 5366,2023-07-30,23:00:00,35,21,14,FMN GV 16 Berchem TOT
54,Posthofbrug 5366,2023-07-31,00:00:00,19,10,9,FMN GV 16 Berchem TOT
54,Posthofbrug 5366,2023-07-31,01:00:00,12,6,6,FMN GV 16 Berchem TOT
54,Posthofbrug 5366,2023-07-31,02:00:00,6,0,6,FMN GV 16 Berchem TOT
54,Posthofbrug 5366,2023-07-31,03:00:00,5,4,1,FMN GV 16 Berchem TOT
54,Posthofbrug 5366,2023-07-31,04:00:00,18,9,9,FMN GV 16 Berchem TOT
54,Posthofbrug 5366,2023-07-31,05:00:00,25,16,9,FMN GV 16 Berchem TOT
54,Posthofbrug 5366,2023-07-31,06:00:00,80,63,17,FMN GV 16 Berchem TOT
54,Posthofbrug 5366,2023-07-31,07:00:00,215,152,63,FMN GV 16 Berchem TOT
54,Posthofbrug 5366,2023-07-31,08:00:00,367,258,109,FMN GV 16 Berchem TOT
54,Posthofbrug 5366,2023-07-31,09:00:00,164,126,38,FMN GV 16 Berchem TOT
54,Posthofbrug 5366,2023-07-31,10:00:00,105,77,28,FMN GV 16 Berchem TOT
54,Posthofbrug 5366,2023-07-31,11:00:00,101,61,40,FMN GV 16 Berchem TOT
54,Posthofbrug 5366,2023-07-31,12:00:00,123,72,51,FMN GV 16 Berchem TOT
54,Posthofbrug 5366,2023-07-31,13:00:00,135,76,59,FMN GV 16 Berchem TOT
54,Posthofbrug 5366,2023-07-31,14:00:00,97,43,54,FMN GV 16 Berchem TOT
54,Posthofbrug 5366,2023-07-31,15:00:00,186,54,132,FMN GV 16 Berchem TOT
54,Posthofbrug 5366,2023-07-31,16:00:00,228,106,122,FMN GV 16 Berchem TOT
54,Posthofbrug 5366,2023-07-31,17:00:00,329,99,230,FMN GV 16 Berchem TOT
54,Posthofbrug 5366,2023-07-31,18:00:00,211,58,153,FMN GV 16 Berchem TOT
54,Posthofbrug 5366,2023-07-31,19:00:00,60,18,42,FMN GV 16 Berchem TOT
54,Posthofbrug 5366,2023-07-31,20:00:00,43,16,27,FMN GV 16 Berchem TOT
54,Posthofbrug 5366,2023-07-31,21:00:00,34,18,16,FMN GV 16 Berchem TOT
54,Posthofbrug 5366,2023-07-31,22:00:00,36,13,23,FMN GV 16 Berchem TOT
54,Posthofbrug 5366,2023-07-31,23:00:00,20,7,13,FMN GV 16 Berchem TOT
54,Posthofbrug 5366,2023-08-01,00:00:00,13,5,8,FMN GV 16 Berchem TOT
54,Posthofbrug 5366,2023-08-01,01:00:00,7,2,5,FMN GV 16 Berchem TOT
54,Posthofbrug 5366,2023-08-01,02:00:00,6,1,5,FMN GV 16 Berchem TOT
54,Posthofbrug 5366,2023-08-01,03:00:00,2,0,2,FMN GV 16 Berchem TOT
54,Posthofbrug 5366,2023-08-01,04:00:00,20,12,8,FMN GV 16 Berchem TOT
54,Posthofbrug 5366,2023-08-01,05:00:00,31,19,12,FMN GV 16 Berchem TOT
54,Posthofbrug 5366,2023-08-01,06:00:00,105,79,26,FMN GV 16 Berchem TOT
54,Posthofbrug 5366,2023-08-01,07:00:00,325,238,87,FMN GV 16 Berchem TOT
54,Posthofbrug 5366,2023-08-01,08:00:00,492,341,151,FMN GV 16 Berchem TOT
54,Posthofbrug 5366,2023-08-01,09:00:00,259,201,58,FMN GV 16 Berchem TOT
54,Posthofbrug 5366,2023-08-01,10:00:00,124,82,42,FMN GV 16 Berchem TOT
54,Posthofbrug 5366,2023-08-01,11:00:00,127,72,55,FMN GV 16 Berchem TOT
54,Posthofbrug 5366,2023-08-01,12:00:00,147,85,62,FMN GV 16 Berchem TOT
54,Posthofbrug 5366,2023-08-01,13:00:00,152,99,53,FMN GV 16 Berchem TOT
54,Posthofbrug 5366,2023-08-01,14:00:00,162,97,65,FMN GV 16 Berchem TOT
54,Posthofbrug 5366,2023-08-01,15:00:00,204,93,111,FMN GV 16 Berchem TOT
54,Posthofbrug 5366,2023-08-01,16:00:00,412,157,255,FMN GV 16 Berchem TOT
54,Posthofbrug 5366,2023-08-01,17:00:00,482,168,314,FMN GV 16 Berchem TOT
54,Posthofbrug 5366,2023-08-01,18:00:00,351,139,212,FMN GV 16 Berchem TOT
54,Posthofbrug 5366,2023-08-01,19:00:00,178,78,100,FMN GV 16 Berchem TOT
54,Posthofbrug 5366,2023-08-01,20:00:00,158,94,64,FMN GV 16 Berchem TOT
54,Posthofbrug 5366,2023-08-01,21:00:00,113,62,51,FMN GV 16 Berchem TOT
54,Posthofbrug 5366,2023-08-01,22:00:00,87,35,52,FMN GV 16 Berchem TOT
54,Posthofbrug 5366,2023-08-01,23:00:00,81,29,52,FMN GV 16 Berchem TOT
54,Posthofbrug 5366,2023-08-02,00:00:00,51,12,39,FMN GV 16 Berchem TOT
54,Posthofbrug 5366,2023-08-02,01:00:00,18,5,13,FMN GV 16 Berchem TOT
54,Posthofbrug 5366,2023-08-02,02:00:00,5,0,5,FMN GV 16 Berchem TOT
54,Posthofbrug 5366,2023-08-02,03:00:00,6,3,3,FMN GV 16 Berchem TOT
54,Posthofbrug 5366,2023-08-02,04:00:00,16,7,9,FMN GV 16 Berchem TOT
54,Posthofbrug 5366,2023-08-02,05:00:00,35,22,13,FMN GV 16 Berchem TOT
54,Posthofbrug 5366,2023-08-02,06:00:00,73,56,17,FMN GV 16 Berchem TOT
54,Posthofbrug 5366,2023-08-02,07:00:00,184,128,56,FMN GV 16 Berchem TOT
54,Posthofbrug 5366,2023-08-02,08:00:00,307,221,86,FMN GV 16 Berchem TOT
54,Posthofbrug 5366,2023-08-02,09:00:00,152,111,41,FMN GV 16 Berchem TOT
54,Posthofbrug 5366,2023-08-02,10:00:00,85,51,34,FMN GV 16 Berchem TOT
54,Posthofbrug 5366,2023-08-02,11:00:00,93,62,31,FMN GV 16 Berchem TOT
54,Posthofbrug 5366,2023-08-02,12:00:00,107,58,49,FMN GV 16 Berchem TOT
54,Posthofbrug 5366,2023-08-02,13:00:00,120,69,51,FMN GV 16 Berchem TOT
54,Posthofbrug 5366,2023-08-02,14:00:00,121,65,56,FMN GV 16 Berchem TOT
54,Posthofbrug 5366,2023-08-02,15:00:00,117,53,64,FMN GV 16 Berchem TOT
54,Posthofbrug 5366,2023-08-02,16:00:00,228,92,136,FMN GV 16 Berchem TOT
54,Posthofbrug 5366,2023-08-02,17:00:00,369,150,219,FMN GV 16 Berchem TOT
54,Posthofbrug 5366,2023-08-02,18:00:00,217,85,132,FMN GV 16 Berchem TOT
54,Posthofbrug 5366,2023-08-02,19:00:00,110,64,46,FMN GV 16 Berchem TOT
54,Posthofbrug 5366,2023-08-02,20:00:00,71,33,38,FMN GV 16 Berchem TOT
54,Posthofbrug 5366,2023-08-02,21:00:00,61,23,38,FMN GV 16 Berchem TOT
54,Posthofbrug 5366,2023-08-02,22:00:00,53,21,32,FMN GV 16 Berchem TOT
54,Posthofbrug 5366,2023-08-02,23:00:00,49,10,39,FMN GV 16 Berchem TOT
54,Posthofbrug 5366,2023-08-03,00:00:00,31,11,20,FMN GV 16 Berchem TOT
54,Posthofbrug 5366,2023-08-03,01:00:00,13,4,9,FMN GV 16 Berchem TOT
54,Posthofbrug 5366,2023-08-03,02:00:00,9,3,6,FMN GV 16 Berchem TOT
54,Posthofbrug 5366,2023-08-03,03:00:00,7,4,3,FMN GV 16 Berchem TOT
54,Posthofbrug 5366,2023-08-03,04:00:00,17,12,5,FMN GV 16 Berchem TOT
54,Posthofbrug 5366,2023-08-03,05:00:00,25,20,5,FMN GV 16 Berchem TOT
54,Posthofbrug 5366,2023-08-03,06:00:00,71,51,20,FMN GV 16 Berchem TOT
54,Posthofbrug 5366,2023-08-03,07:00:00,249,175,74,FMN GV 16 Berchem TOT
54,Posthofbrug 5366,2023-08-03,08:00:00,444,318,126,FMN GV 16 Berchem TOT
54,Posthofbrug 5366,2023-08-03,09:00:00,214,166,48,FMN GV 16 Berchem TOT
54,Posthofbrug 5366,2023-08-03,10:00:00,86,58,28,FMN GV 16 Berchem TOT
54,Posthofbrug 5366,2023-08-03,11:00:00,81,51,30,FMN GV 16 Berchem TOT
54,Posthofbrug 5366,2023-08-03,12:00:00,108,62,46,FMN GV 16 Berchem TOT
54,Posthofbrug 5366,2023-08-03,13:00:00,86,50,36,FMN GV 16 Berchem TOT
54,Posthofbrug 5366,2023-08-03,14:00:00,92,46,46,FMN GV 16 Berchem TOT
54,Posthofbrug 5366,2023-08-03,15:00:00,151,60,91,FMN GV 16 Berchem TOT
54,Posthofbrug 5366,2023-08-03,16:00:00,271,100,171,FMN GV 16 Berchem TOT
54,Posthofbrug 5366,2023-08-03,17:00:00,396,151,245,FMN GV 16 Berchem TOT
54,Posthofbrug 5366,2023-08-03,18:00:00,239,94,145,FMN GV 16 Berchem TOT
54,Posthofbrug 5366,2023-08-03,19:00:00,175,88,87,FMN GV 16 Berchem TOT
54,Posthofbrug 5366,2023-08-03,20:00:00,107,57,50,FMN GV 16 Berchem TOT
54,Posthofbrug 5366,2023-08-03,21:00:00,97,40,57,FMN GV 16 Berchem TOT
54,Posthofbrug 5366,2023-08-03,22:00:00,90,39,51,FMN GV 16 Berchem TOT
54,Posthofbrug 5366,2023-08-03,23:00:00,83,26,57,FMN GV 16 Berchem TOT
54,Posthofbrug 5366,2023-08-04,00:00:00,52,14,38,FMN GV 16 Berchem TOT
54,Posthofbrug 5366,2023-08-04,01:00:00,21,5,16,FMN GV 16 Berchem TOT
54,Posthofbrug 5366,2023-08-04,02:00:00,15,8,7,FMN GV 16 Berchem TOT
54,Posthofbrug 5366,2023-08-04,03:00:00,8,3,5,FMN GV 16 Berchem TOT
54,Posthofbrug 5366,2023-08-04,04:00:00,27,8,19,FMN GV 16 Berchem TOT
54,Posthofbrug 5366,2023-08-04,05:00:00,29,22,7,FMN GV 16 Berchem TOT
54,Posthofbrug 5366,2023-08-04,06:00:00,74,55,19,FMN GV 16 Berchem TOT
54,Posthofbrug 5366,2023-08-04,07:00:00,184,135,49,FMN GV 16 Berchem TOT
54,Posthofbrug 5366,2023-08-04,08:00:00,323,232,91,FMN GV 16 Berchem TOT
54,Posthofbrug 5366,2023-08-04,09:00:00,203,157,46,FMN GV 16 Berchem TOT
54,Posthofbrug 5366,2023-08-04,10:00:00,115,82,33,FMN GV 16 Berchem TOT
54,Posthofbrug 5366,2023-08-04,11:00:00,111,66,45,FMN GV 16 Berchem TOT
54,Posthofbrug 5366,2023-08-04,12:00:00,139,63,76,FMN GV 16 Berchem TOT
54,Posthofbrug 5366,2023-08-04,13:00:00,141,88,53,FMN GV 16 Berchem TOT
54,Posthofbrug 5366,2023-08-04,14:00:00,155,84,71,FMN GV 16 Berchem TOT
54,Posthofbrug 5366,2023-08-04,15:00:00,190,75,115,FMN GV 16 Berchem TOT
54,Posthofbrug 5366,2023-08-04,16:00:00,318,125,193,FMN GV 16 Berchem TOT
54,Posthofbrug 5366,2023-08-04,17:00:00,333,141,192,FMN GV 16 Berchem TOT
54,Posthofbrug 5366,2023-08-04,18:00:00,243,125,118,FMN GV 16 Berchem TOT
54,Posthofbrug 5366,2023-08-04,19:00:00,152,86,66,FMN GV 16 Berchem TOT
54,Posthofbrug 5366,2023-08-04,20:00:00,143,90,53,FMN GV 16 Berchem TOT
54,Posthofbrug 5366,2023-08-04,21:00:00,131,64,67,FMN GV 16 Berchem TOT
54,Posthofbrug 5366,2023-08-04,22:00:00,112,53,59,FMN GV 16 Berchem TOT
54,Posthofbrug 5366,2023-08-04,23:00:00,78,21,57,FMN GV 16 Berchem TOT
54,Posthofbrug 5366,2023-08-05,00:00:00,68,19,49,FMN GV 16 Berchem TOT
54,Posthofbrug 5366,2023-08-05,01:00:00,46,12,34,FMN GV 16 Berchem TOT
54,Posthofbrug 5366,2023-08-05,02:00:00,35,12,23,FMN GV 16 Berchem TOT
54,Posthofbrug 5366,2023-08-05,03:00:00,38,6,32,FMN GV 16 Berchem TOT
54,Posthofbrug 5366,2023-08-05,04:00:00,28,5,23,FMN GV 16 Berchem TOT
54,Posthofbrug 5366,2023-08-05,05:00:00,27,10,17,FMN GV 16 Berchem TOT
54,Posthofbrug 5366,2023-08-05,06:00:00,16,10,6,FMN GV 16 Berchem TOT
54,Posthofbrug 5366,2023-08-05,07:00:00,41,25,16,FMN GV 16 Berchem TOT
54,Posthofbrug 5366,2023-08-05,08:00:00,66,45,21,FMN GV 16 Berchem TOT
54,Posthofbrug 5366,2023-08-05,09:00:00,134,94,40,FMN GV 16 Berchem TOT
54,Posthofbrug 5366,2023-08-05,10:00:00,163,109,54,FMN GV 16 Berchem TOT
54,Posthofbrug 5366,2023-08-05,11:00:00,178,116,62,FMN GV 16 Berchem TOT
54,Posthofbrug 5366,2023-08-05,12:00:00,149,98,51,FMN GV 16 Berchem TOT
54,Posthofbrug 5366,2023-08-05,13:00:00,102,60,42,FMN GV 16 Berchem TOT
54,Posthofbrug 5366,2023-08-05,14:00:00,110,46,64,FMN GV 16 Berchem TOT
54,Posthofbrug 5366,2023-08-05,15:00:00,74,39,35,FMN GV 16 Berchem TOT
54,Posthofbrug 5366,2023-08-05,16:00:00,106,53,53,FMN GV 16 Berchem TOT
54,Posthofbrug 5366,2023-08-05,17:00:00,106,56,50,FMN GV 16 Berchem TOT
54,Posthofbrug 5366,2023-08-05,18:00:00,114,73,41,FMN GV 16 Berchem TOT
54,Posthofbrug 5366,2023-08-05,19:00:00,93,50,43,FMN GV 16 Berchem TOT
54,Posthofbrug 5366,2023-08-05,20:00:00,68,38,30,FMN GV 16 Berchem TOT
54,Posthofbrug 5366,2023-08-05,21:00:00,62,30,32,FMN GV 16 Berchem TOT
54,Posthofbrug 5366,2023-08-05,22:00:00,52,13,39,FMN GV 16 Berchem TOT
54,Posthofbrug 5366,2023-08-05,23:00:00,54,9,45,FMN GV 16 Berchem TOT
54,Posthofbrug 5366,2023-08-06,00:00:00,37,9,28,FMN GV 16 Berchem TOT
54,Posthofbrug 5366,2023-08-06,01:00:00,42,7,35,FMN GV 16 Berchem TOT
54,Posthofbrug 5366,2023-08-06,02:00:00,26,6,20,FMN GV 16 Berchem TOT
54,Posthofbrug 5366,2023-08-06,03:00:00,21,3,18,FMN GV 16 Berchem TOT
54,Posthofbrug 5366,2023-08-06,04:00:00,12,3,9,FMN GV 16 Berchem TOT
54,Posthofbrug 5366,2023-08-06,05:00:00,5,4,1,FMN GV 16 Berchem TOT
54,Posthofbrug 5366,2023-08-06,06:00:00,10,5,5,FMN GV 16 Berchem TOT
54,Posthofbrug 5366,2023-08-06,07:00:00,9,7,2,FMN GV 16 Berchem TOT
54,Posthofbrug 5366,2023-08-06,08:00:00,19,11,8,FMN GV 16 Berchem TOT
54,Posthofbrug 5366,2023-08-06,09:00:00,47,35,12,FMN GV 16 Berchem TOT
54,Posthofbrug 5366,2023-08-06,10:00:00,53,36,17,FMN GV 16 Berchem TOT
54,Posthofbrug 5366,2023-08-06,11:00:00,60,38,22,FMN GV 16 Berchem TOT
54,Posthofbrug 5366,2023-08-06,12:00:00,70,23,47,FMN GV 16 Berchem TOT
54,Posthofbrug 5366,2023-08-06,13:00:00,73,54,19,FMN GV 16 Berchem TOT
54,Posthofbrug 5366,2023-08-06,14:00:00,55,26,29,FMN GV 16 Berchem TOT
54,Posthofbrug 5366,2023-08-06,15:00:00,42,22,20,FMN GV 16 Berchem TOT
54,Posthofbrug 5366,2023-08-06,16:00:00,39,18,21,FMN GV 16 Berchem TOT
54,Posthofbrug 5366,2023-08-06,17:00:00,41,22,19,FMN GV 16 Berchem TOT
54,Posthofbrug 5366,2023-08-06,18:00:00,81,38,43,FMN GV 16 Berchem TOT
54,Posthofbrug 5366,2023-08-06,19:00:00,51,23,28,FMN GV 16 Berchem TOT
54,Posthofbrug 5366,2023-08-06,20:00:00,50,19,31,FMN GV 16 Berchem TOT
54,Posthofbrug 5366,2023-08-06,21:00:00,52,31,21,FMN GV 16 Berchem TOT
54,Posthofbrug 5366,2023-08-06,22:00:00,32,11,21,FMN GV 16 Berchem TOT
54,Posthofbrug 5366,2023-08-06,23:00:00,28,10,18,FMN GV 16 Berchem TOT
54,Posthofbrug 5366,2023-08-07,00:00:00,14,7,7,FMN GV 16 Berchem TOT
54,Posthofbrug 5366,2023-08-07,01:00:00,6,3,3,FMN GV 16 Berchem TOT
54,Posthofbrug 5366,2023-08-07,02:00:00,3,1,2,FMN GV 16 Berchem TOT
54,Posthofbrug 5366,2023-08-07,03:00:00,3,2,1,FMN GV 16 Berchem TOT
54,Posthofbrug 5366,2023-08-07,04:00:00,16,10,6,FMN GV 16 Berchem TOT
54,Posthofbrug 5366,2023-08-07,05:00:00,28,22,6,FMN GV 16 Berchem TOT
54,Posthofbrug 5366,2023-08-07,06:00:00,102,78,24,FMN GV 16 Berchem TOT
54,Posthofbrug 5366,2023-08-07,07:00:00,290,210,80,FMN GV 16 Berchem TOT
54,Posthofbrug 5366,2023-08-07,08:00:00,518,378,140,FMN GV 16 Berchem TOT
54,Posthofbrug 5366,2023-08-07,09:00:00,252,191,61,FMN GV 16 Berchem TOT
54,Posthofbrug 5366,2023-08-07,10:00:00,134,93,41,FMN GV 16 Berchem TOT
54,Posthofbrug 5366,2023-08-07,11:00:00,131,86,45,FMN GV 16 Berchem TOT
54,Posthofbrug 5366,2023-08-07,12:00:00,154,84,70,FMN GV 16 Berchem TOT
54,Posthofbrug 5366,2023-08-07,13:00:00,146,88,58,FMN GV 16 Berchem TOT
54,Posthofbrug 5366,2023-08-07,14:00:00,202,123,79,FMN GV 16 Berchem TOT
54,Posthofbrug 5366,2023-08-07,15:00:00,198,104,94,FMN GV 16 Berchem TOT
54,Posthofbrug 5366,2023-08-07,16:00:00,349,139,210,FMN GV 16 Berchem TOT
54,Posthofbrug 5366,2023-08-07,17:00:00,565,198,367,FMN GV 16 Berchem TOT
54,Posthofbrug 5366,2023-08-07,18:00:00,350,123,227,FMN GV 16 Berchem TOT
54,Posthofbrug 5366,2023-08-07,19:00:00,170,87,83,FMN GV 16 Berchem TOT
54,Posthofbrug 5366,2023-08-07,20:00:00,128,70,58,FMN GV 16 Berchem TOT
54,Posthofbrug 5366,2023-08-07,21:00:00,103,56,47,FMN GV 16 Berchem TOT
54,Posthofbrug 5366,2023-08-07,22:00:00,92,32,60,FMN GV 16 Berchem TOT
54,Posthofbrug 5366,2023-08-07,23:00:00,58,10,48,FMN GV 16 Berchem TOT
54,Posthofbrug 5366,2023-08-08,00:00:00,33,4,29,FMN GV 16 Berchem TOT
54,Posthofbrug 5366,2023-08-08,01:00:00,10,1,9,FMN GV 16 Berchem TOT
54,Posthofbrug 5366,2023-08-08,02:00:00,10,1,9,FMN GV 16 Berchem TOT
54,Posthofbrug 5366,2023-08-08,03:00:00,3,2,1,FMN GV 16 Berchem TOT
54,Posthofbrug 5366,2023-08-08,04:00:00,22,13,9,FMN GV 16 Berchem TOT
54,Posthofbrug 5366,2023-08-08,05:00:00,39,28,11,FMN GV 16 Berchem TOT
54,Posthofbrug 5366,2023-08-08,06:00:00,120,89,31,FMN GV 16 Berchem TOT
54,Posthofbrug 5366,2023-08-08,07:00:00,338,249,89,FMN GV 16 Berchem TOT
54,Posthofbrug 5366,2023-08-08,08:00:00,566,403,163,FMN GV 16 Berchem TOT
54,Posthofbrug 5366,2023-08-08,09:00:00,261,195,66,FMN GV 16 Berchem TOT
54,Posthofbrug 5366,2023-08-08,10:00:00,132,104,28,FMN GV 16 Berchem TOT
54,Posthofbrug 5366,2023-08-08,11:00:00,124,87,37,FMN GV 16 Berchem TOT
54,Posthofbrug 5366,2023-08-08,12:00:00,165,90,75,FMN GV 16 Berchem TOT
54,Posthofbrug 5366,2023-08-08,13:00:00,159,94,65,FMN GV 16 Berchem TOT
54,Posthofbrug 5366,2023-08-08,14:00:00,138,72,66,FMN GV 16 Berchem TOT
54,Posthofbrug 5366,2023-08-08,15:00:00,193,90,103,FMN GV 16 Berchem TOT
54,Posthofbrug 5366,2023-08-08,16:00:00,423,173,250,FMN GV 16 Berchem TOT
54,Posthofbrug 5366,2023-08-08,17:00:00,574,201,373,FMN GV 16 Berchem TOT
54,Posthofbrug 5366,2023-08-08,18:00:00,322,122,200,FMN GV 16 Berchem TOT
54,Posthofbrug 5366,2023-08-08,19:00:00,165,71,94,FMN GV 16 Berchem TOT
54,Posthofbrug 5366,2023-08-08,20:00:00,86,39,47,FMN GV 16 Berchem TOT
54,Posthofbrug 5366,2023-08-08,21:00:00,60,29,31,FMN GV 16 Berchem TOT
54,Posthofbrug 5366,2023-08-08,22:00:00,81,22,59,FMN GV 16 Berchem TOT
54,Posthofbrug 5366,2023-08-08,23:00:00,45,16,29,FMN GV 16 Berchem TOT
54,Posthofbrug 5366,2023-08-09,00:00:00,29,5,24,FMN GV 16 Berchem TOT
54,Posthofbrug 5366,2023-08-09,01:00:00,10,1,9,FMN GV 16 Berchem TOT
54,Posthofbrug 5366,2023-08-09,02:00:00,6,2,4,FMN GV 16 Berchem TOT
54,Posthofbrug 5366,2023-08-09,03:00:00,14,3,11,FMN GV 16 Berchem TOT
54,Posthofbrug 5366,2023-08-09,04:00:00,22,13,9,FMN GV 16 Berchem TOT
54,Posthofbrug 5366,2023-08-09,05:00:00,32,24,8,FMN GV 16 Berchem TOT
54,Posthofbrug 5366,2023-08-09,06:00:00,104,81,23,FMN GV 16 Berchem TOT
54,Posthofbrug 5366,2023-08-09,07:00:00,286,208,78,FMN GV 16 Berchem TOT
54,Posthofbrug 5366,2023-08-09,08:00:00,457,318,139,FMN GV 16 Berchem TOT
54,Posthofbrug 5366,2023-08-09,09:00:00,229,175,54,FMN GV 16 Berchem TOT
54,Posthofbrug 5366,2023-08-09,10:00:00,122,76,46,FMN GV 16 Berchem TOT
54,Posthofbrug 5366,2023-08-09,11:00:00,159,104,55,FMN GV 16 Berchem TOT
54,Posthofbrug 5366,2023-08-09,12:00:00,169,97,72,FMN GV 16 Berchem TOT
54,Posthofbrug 5366,2023-08-09,13:00:00,175,107,68,FMN GV 16 Berchem TOT
54,Posthofbrug 5366,2023-08-09,14:00:00,233,124,109,FMN GV 16 Berchem TOT
54,Posthofbrug 5366,2023-08-09,15:00:00,224,123,101,FMN GV 16 Berchem TOT
54,Posthofbrug 5366,2023-08-09,16:00:00,381,149,232,FMN GV 16 Berchem TOT
54,Posthofbrug 5366,2023-08-09,17:00:00,543,221,322,FMN GV 16 Berchem TOT
54,Posthofbrug 5366,2023-08-09,18:00:00,355,153,202,FMN GV 16 Berchem TOT
54,Posthofbrug 5366,2023-08-09,19:00:00,214,100,114,FMN GV 16 Berchem TOT
54,Posthofbrug 5366,2023-08-09,20:00:00,147,74,73,FMN GV 16 Berchem TOT
54,Posthofbrug 5366,2023-08-09,21:00:00,131,70,61,FMN GV 16 Berchem TOT
54,Posthofbrug 5366,2023-08-09,22:00:00,111,41,70,FMN GV 16 Berchem TOT
54,Posthofbrug 5366,2023-08-09,23:00:00,86,24,62,FMN GV 16 Berchem TOT
54,Posthofbrug 5366,2023-08-10,00:00:00,31,12,19,FMN GV 16 Berchem TOT
54,Posthofbrug 5366,2023-08-10,01:00:00,21,3,18,FMN GV 16 Berchem TOT
54,Posthofbrug 5366,2023-08-10,02:00:00,14,2,12,FMN GV 16 Berchem TOT
54,Posthofbrug 5366,2023-08-10,03:00:00,7,6,1,FMN GV 16 Berchem TOT
54,Posthofbrug 5366,2023-08-10,04:00:00,26,11,15,FMN GV 16 Berchem TOT
54,Posthofbrug 5366,2023-08-10,05:00:00,42,30,12,FMN GV 16 Berchem TOT
54,Posthofbrug 5366,2023-08-10,06:00:00,119,89,30,FMN GV 16 Berchem TOT
54,Posthofbrug 5366,2023-08-10,07:00:00,322,245,77,FMN GV 16 Berchem TOT
54,Posthofbrug 5366,2023-08-10,08:00:00,588,415,173,FMN GV 16 Berchem TOT
54,Posthofbrug 5366,2023-08-10,09:00:00,312,240,72,FMN GV 16 Berchem TOT
54,Posthofbrug 5366,2023-08-10,10:00:00,159,118,41,FMN GV 16 Berchem TOT
54,Posthofbrug 5366,2023-08-10,11:00:00,154,84,70,FMN GV 16 Berchem TOT
54,Posthofbrug 5366,2023-08-10,12:00:00,215,131,84,FMN GV 16 Berchem TOT
54,Posthofbrug 5366,2023-08-10,13:00:00,217,124,93,FMN GV 16 Berchem TOT
54,Posthofbrug 5366,2023-08-10,14:00:00,211,112,99,FMN GV 16 Berchem TOT
54,Posthofbrug 5366,2023-08-10,15:00:00,255,116,139,FMN GV 16 Berchem TOT
54,Posthofbrug 5366,2023-08-10,16:00:00,459,167,292,FMN GV 16 Berchem TOT
54,Posthofbrug 5366,2023-08-10,17:00:00,602,248,354,FMN GV 16 Berchem TOT
54,Posthofbrug 5366,2023-08-10,18:00:00,421,167,254,FMN GV 16 Berchem TOT
54,Posthofbrug 5366,2023-08-10,19:00:00,300,154,146,FMN GV 16 Berchem TOT
54,Posthofbrug 5366,2023-08-10,20:00:00,179,107,72,FMN GV 16 Berchem TOT
54,Posthofbrug 5366,2023-08-10,21:00:00,190,115,75,FMN GV 16 Berchem TOT
54,Posthofbrug 5366,2023-08-10,22:00:00,148,64,84,FMN GV 16 Berchem TOT
54,Posthofbrug 5366,2023-08-10,23:00:00,130,36,94,FMN GV 16 Berchem TOT
54,Posthofbrug 5366,2023-08-11,00:00:00,49,12,37,FMN GV 16 Berchem TOT
54,Posthofbrug 5366,2023-08-11,01:00:00,37,7,30,FMN GV 16 Berchem TOT
54,Posthofbrug 5366,2023-08-11,02:00:00,23,5,18,FMN GV 16 Berchem TOT
54,Posthofbrug 5366,2023-08-11,03:00:00,18,2,16,FMN GV 16 Berchem TOT
54,Posthofbrug 5366,2023-08-11,04:00:00,27,11,16,FMN GV 16 Berchem TOT
54,Posthofbrug 5366,2023-08-11,05:00:00,29,18,11,FMN GV 16 Berchem TOT
54,Posthofbrug 5366,2023-08-11,06:00:00,105,76,29,FMN GV 16 Berchem TOT
54,Posthofbrug 5366,2023-08-11,07:00:00,207,152,55,FMN GV 16 Berchem TOT
54,Posthofbrug 5366,2023-08-11,08:00:00,395,287,108,FMN GV 16 Berchem TOT
54,Posthofbrug 5366,2023-08-11,09:00:00,251,185,66,FMN GV 16 Berchem TOT
54,Posthofbrug 5366,2023-08-11,10:00:00,156,100,56,FMN GV 16 Berchem TOT
54,Posthofbrug 5366,2023-08-11,11:00:00,178,109,69,FMN GV 16 Berchem TOT
54,Posthofbrug 5366,2023-08-11,12:00:00,194,120,74,FMN GV 16 Berchem TOT
54,Posthofbrug 5366,2023-08-11,13:00:00,233,134,99,FMN GV 16 Berchem TOT
54,Posthofbrug 5366,2023-08-11,14:00:00,262,131,131,FMN GV 16 Berchem TOT
54,Posthofbrug 5366,2023-08-11,15:00:00,240,104,136,FMN GV 16 Berchem TOT
54,Posthofbrug 5366,2023-08-11,16:00:00,374,145,229,FMN GV 16 Berchem TOT
54,Posthofbrug 5366,2023-08-11,17:00:00,379,156,223,FMN GV 16 Berchem TOT
54,Posthofbrug 5366,2023-08-11,18:00:00,326,166,160,FMN GV 16 Berchem TOT
54,Posthofbrug 5366,2023-08-11,19:00:00,163,88,75,FMN GV 16 Berchem TOT
54,Posthofbrug 5366,2023-08-11,20:00:00,134,69,65,FMN GV 16 Berchem TOT
54,Posthofbrug 5366,2023-08-11,21:00:00,107,45,62,FMN GV 16 Berchem TOT
54,Posthofbrug 5366,2023-08-11,22:00:00,82,30,52,FMN GV 16 Berchem TOT
54,Posthofbrug 5366,2023-08-11,23:00:00,98,29,69,FMN GV 16 Berchem TOT
54,Posthofbrug 5366,2023-08-12,00:00:00,67,21,46,FMN GV 16 Berchem TOT
54,Posthofbrug 5366,2023-08-12,01:00:00,43,12,31,FMN GV 16 Berchem TOT
54,Posthofbrug 5366,2023-08-12,02:00:00,27,7,20,FMN GV 16 Berchem TOT
54,Posthofbrug 5366,2023-08-12,03:00:00,11,0,11,FMN GV 16 Berchem TOT
54,Posthofbrug 5366,2023-08-12,04:00:00,16,5,11,FMN GV 16 Berchem TOT
54,Posthofbrug 5366,2023-08-12,05:00:00,17,10,7,FMN GV 16 Berchem TOT
54,Posthofbrug 5366,2023-08-12,06:00:00,25,14,11,FMN GV 16 Berchem TOT
54,Posthofbrug 5366,2023-08-12,07:00:00,33,17,16,FMN GV 16 Berchem TOT
54,Posthofbrug 5366,2023-08-12,08:00:00,46,27,19,FMN GV 16 Berchem TOT
54,Posthofbrug 5366,2023-08-12,09:00:00,106,73,33,FMN GV 16 Berchem TOT
54,Posthofbrug 5366,2023-08-12,10:00:00,113,82,31,FMN GV 16 Berchem TOT
54,Posthofbrug 5366,2023-08-12,11:00:00,120,86,34,FMN GV 16 Berchem TOT
54,Posthofbrug 5366,2023-08-12,12:00:00,152,101,51,FMN GV 16 Berchem TOT
54,Posthofbrug 5366,2023-08-12,13:00:00,199,148,51,FMN GV 16 Berchem TOT
54,Posthofbrug 5366,2023-08-12,14:00:00,250,177,73,FMN GV 16 Berchem TOT
54,Posthofbrug 5366,2023-08-12,15:00:00,201,137,64,FMN GV 16 Berchem TOT
54,Posthofbrug 5366,2023-08-12,16:00:00,206,99,107,FMN GV 16 Berchem TOT
54,Posthofbrug 5366,2023-08-12,17:00:00,212,71,141,FMN GV 16 Berchem TOT
54,Posthofbrug 5366,2023-08-12,18:00:00,172,91,81,FMN GV 16 Berchem TOT
54,Posthofbrug 5366,2023-08-12,19:00:00,155,69,86,FMN GV 16 Berchem TOT
54,Posthofbrug 5366,2023-08-12,20:00:00,139,87,52,FMN GV 16 Berchem TOT
54,Posthofbrug 5366,2023-08-12,21:00:00,97,48,49,FMN GV 16 Berchem TOT
54,Posthofbrug 5366,2023-08-12,22:00:00,105,38,67,FMN GV 16 Berchem TOT
54,Posthofbrug 5366,2023-08-12,23:00:00,88,32,56,FMN GV 16 Berchem TOT
54,Posthofbrug 5366,2023-08-13,00:00:00,73,22,51,FMN GV 16 Berchem TOT
54,Posthofbrug 5366,2023-08-13,01:00:00,65,26,39,FMN GV 16 Berchem TOT
54,Posthofbrug 5366,2023-08-13,02:00:00,35,7,28,FMN GV 16 Berchem TOT
54,Posthofbrug 5366,2023-08-13,03:00:00,29,3,26,FMN GV 16 Berchem TOT
54,Posthofbrug 5366,2023-08-13,04:00:00,16,5,11,FMN GV 16 Berchem TOT
54,Posthofbrug 5366,2023-08-13,05:00:00,29,6,23,FMN GV 16 Berchem TOT
54,Posthofbrug 5366,2023-08-13,06:00:00,19,7,12,FMN GV 16 Berchem TOT
54,Posthofbrug 5366,2023-08-13,07:00:00,38,18,20,FMN GV 16 Berchem TOT
54,Posthofbrug 5366,2023-08-13,08:00:00,47,34,13,FMN GV 16 Berchem TOT
54,Posthofbrug 5366,2023-08-13,09:00:00,88,58,30,FMN GV 16 Berchem TOT
54,Posthofbrug 5366,2023-08-13,10:00:00,132,86,46,FMN GV 16 Berchem TOT
54,Posthofbrug 5366,2023-08-13,11:00:00,156,95,61,FMN GV 16 Berchem TOT
54,Posthofbrug 5366,2023-08-13,12:00:00,179,116,63,FMN GV 16 Berchem TOT
54,Posthofbrug 5366,2023-08-13,13:00:00,184,94,90,FMN GV 16 Berchem TOT
54,Posthofbrug 5366,2023-08-13,14:00:00,276,168,108,FMN GV 16 Berchem TOT
54,Posthofbrug 5366,2023-08-13,15:00:00,215,129,86,FMN GV 16 Berchem TOT
54,Posthofbrug 5366,2023-08-13,16:00:00,219,114,105,FMN GV 16 Berchem TOT
54,Posthofbrug 5366,2023-08-13,17:00:00,186,88,98,FMN GV 16 Berchem TOT
54,Posthofbrug 5366,2023-08-13,18:00:00,191,94,97,FMN GV 16 Berchem TOT
54,Posthofbrug 5366,2023-08-13,19:00:00,123,82,41,FMN GV 16 Berchem TOT
54,Posthofbrug 5366,2023-08-13,20:00:00,120,71,49,FMN GV 16 Berchem TOT
54,Posthofbrug 5366,2023-08-13,21:00:00,99,42,57,FMN GV 16 Berchem TOT
54,Posthofbrug 5366,2023-08-13,22:00:00,76,29,47,FMN GV 16 Berchem TOT
54,Posthofbrug 5366,2023-08-13,23:00:00,89,24,65,FMN GV 16 Berchem TOT
54,Posthofbrug 5366,2023-08-14,00:00:00,40,8,32,FMN GV 16 Berchem TOT
54,Posthofbrug 5366,2023-08-14,01:00:00,16,2,14,FMN GV 16 Berchem TOT
54,Posthofbrug 5366,2023-08-14,02:00:00,15,2,13,FMN GV 16 Berchem TOT
54,Posthofbrug 5366,2023-08-14,03:00:00,18,3,15,FMN GV 16 Berchem TOT
54,Posthofbrug 5366,2023-08-14,04:00:00,18,8,10,FMN GV 16 Berchem TOT
54,Posthofbrug 5366,2023-08-14,05:00:00,16,12,4,FMN GV 16 Berchem TOT
54,Posthofbrug 5366,2023-08-14,06:00:00,68,51,17,FMN GV 16 Berchem TOT
54,Posthofbrug 5366,2023-08-14,07:00:00,132,101,31,FMN GV 16 Berchem TOT
54,Posthofbrug 5366,2023-08-14,08:00:00,232,174,58,FMN GV 16 Berchem TOT
54,Posthofbrug 5366,2023-08-14,09:00:00,149,105,44,FMN GV 16 Berchem TOT
54,Posthofbrug 5366,2023-08-14,10:00:00,139,91,48,FMN GV 16 Berchem TOT
54,Posthofbrug 5366,2023-08-14,11:00:00,188,127,61,FMN GV 16 Berchem TOT
54,Posthofbrug 5366,2023-08-14,12:00:00,203,112,91,FMN GV 16 Berchem TOT
54,Posthofbrug 5366,2023-08-14,13:00:00,192,125,67,FMN GV 16 Berchem TOT
54,Posthofbrug 5366,2023-08-14,14:00:00,260,130,130,FMN GV 16 Berchem TOT
54,Posthofbrug 5366,2023-08-14,15:00:00,222,87,135,FMN GV 16 Berchem TOT
54,Posthofbrug 5366,2023-08-14,16:00:00,319,145,174,FMN GV 16 Berchem TOT
54,Posthofbrug 5366,2023-08-14,17:00:00,345,131,214,FMN GV 16 Berchem TOT
54,Posthofbrug 5366,2023-08-14,18:00:00,236,104,132,FMN GV 16 Berchem TOT
54,Posthofbrug 5366,2023-08-14,19:00:00,183,103,80,FMN GV 16 Berchem TOT
54,Posthofbrug 5366,2023-08-14,20:00:00,169,92,77,FMN GV 16 Berchem TOT
54,Posthofbrug 5366,2023-08-14,21:00:00,128,68,60,FMN GV 16 Berchem TOT
54,Posthofbrug 5366,2023-08-14,22:00:00,115,63,52,FMN GV 16 Berchem TOT
54,Posthofbrug 5366,2023-08-14,23:00:00,70,23,47,FMN GV 16 Berchem TOT
54,Posthofbrug 5366,2023-08-15,00:00:00,41,17,24,FMN GV 16 Berchem TOT
54,Posthofbrug 5366,2023-08-15,01:00:00,35,9,26,FMN GV 16 Berchem TOT
54,Posthofbrug 5366,2023-08-15,02:00:00,28,4,24,FMN GV 16 Berchem TOT
54,Posthofbrug 5366,2023-08-15,03:00:00,19,1,18,FMN GV 16 Berchem TOT
54,Posthofbrug 5366,2023-08-15,04:00:00,9,3,6,FMN GV 16 Berchem TOT
54,Posthofbrug 5366,2023-08-15,05:00:00,20,12,8,FMN GV 16 Berchem TOT
54,Posthofbrug 5366,2023-08-15,06:00:00,25,15,10,FMN GV 16 Berchem TOT
54,Posthofbrug 5366,2023-08-15,07:00:00,37,20,17,FMN GV 16 Berchem TOT
54,Posthofbrug 5366,2023-08-15,08:00:00,55,42,13,FMN GV 16 Berchem TOT
54,Posthofbrug 5366,2023-08-15,09:00:00,192,142,50,FMN GV 16 Berchem TOT
54,Posthofbrug 5366,2023-08-15,10:00:00,191,145,46,FMN GV 16 Berchem TOT
54,Posthofbrug 5366,2023-08-15,11:00:00,280,176,104,FMN GV 16 Berchem TOT
54,Posthofbrug 5366,2023-08-15,12:00:00,245,159,86,FMN GV 16 Berchem TOT
54,Posthofbrug 5366,2023-08-15,13:00:00,294,179,115,FMN GV 16 Berchem TOT
54,Posthofbrug 5366,2023-08-15,14:00:00,332,169,163,FMN GV 16 Berchem TOT
54,Posthofbrug 5366,2023-08-15,15:00:00,345,159,186,FMN GV 16 Berchem TOT
54,Posthofbrug 5366,2023-08-15,16:00:00,227,104,123,FMN GV 16 Berchem TOT
54,Posthofbrug 5366,2023-08-15,17:00:00,315,117,198,FMN GV 16 Berchem TOT
54,Posthofbrug 5366,2023-08-15,18:00:00,245,138,107,FMN GV 16 Berchem TOT
54,Posthofbrug 5366,2023-08-15,19:00:00,195,98,97,FMN GV 16 Berchem TOT
54,Posthofbrug 5366,2023-08-15,20:00:00,181,89,92,FMN GV 16 Berchem TOT
54,Posthofbrug 5366,2023-08-15,21:00:00,141,73,68,FMN GV 16 Berchem TOT
54,Posthofbrug 5366,2023-08-15,22:00:00,120,50,70,FMN GV 16 Berchem TOT
54,Posthofbrug 5366,2023-08-15,23:00:00,42,11,31,FMN GV 16 Berchem TOT
54,Posthofbrug 5366,2023-08-16,00:00:00,30,9,21,FMN GV 16 Berchem TOT
54,Posthofbrug 5366,2023-08-16,01:00:00,10,3,7,FMN GV 16 Berchem TOT
54,Posthofbrug 5366,2023-08-16,02:00:00,8,2,6,FMN GV 16 Berchem TOT
54,Posthofbrug 5366,2023-08-16,03:00:00,7,4,3,FMN GV 16 Berchem TOT
54,Posthofbrug 5366,2023-08-16,04:00:00,16,11,5,FMN GV 16 Berchem TOT
54,Posthofbrug 5366,2023-08-16,05:00:00,38,29,9,FMN GV 16 Berchem TOT
54,Posthofbrug 5366,2023-08-16,06:00:00,103,71,32,FMN GV 16 Berchem TOT
54,Posthofbrug 5366,2023-08-16,07:00:00,305,229,76,FMN GV 16 Berchem TOT
54,Posthofbrug 5366,2023-08-16,08:00:00,568,443,125,FMN GV 16 Berchem TOT
54,Posthofbrug 5366,2023-08-16,09:00:00,271,208,63,FMN GV 16 Berchem TOT
54,Posthofbrug 5366,2023-08-16,10:00:00,168,108,60,FMN GV 16 Berchem TOT
54,Posthofbrug 5366,2023-08-16,11:00:00,158,87,71,FMN GV 16 Berchem TOT
54,Posthofbrug 5366,2023-08-16,12:00:00,192,119,73,FMN GV 16 Berchem TOT
54,Posthofbrug 5366,2023-08-16,13:00:00,196,99,97,FMN GV 16 Berchem TOT
54,Posthofbrug 5366,2023-08-16,14:00:00,206,100,106,FMN GV 16 Berchem TOT
54,Posthofbrug 5366,2023-08-16,15:00:00,253,105,148,FMN GV 16 Berchem TOT
54,Posthofbrug 5366,2023-08-16,16:00:00,391,160,231,FMN GV 16 Berchem TOT
54,Posthofbrug 5366,2023-08-16,17:00:00,573,193,380,FMN GV 16 Berchem TOT
54,Posthofbrug 5366,2023-08-16,18:00:00,378,147,231,FMN GV 16 Berchem TOT
54,Posthofbrug 5366,2023-08-16,19:00:00,183,89,94,FMN GV 16 Berchem TOT
54,Posthofbrug 5366,2023-08-16,20:00:00,181,97,84,FMN GV 16 Berchem TOT
54,Posthofbrug 5366,2023-08-16,21:00:00,123,61,62,FMN GV 16 Berchem TOT
54,Posthofbrug 5366,2023-08-16,22:00:00,104,46,58,FMN GV 16 Berchem TOT
54,Posthofbrug 5366,2023-08-16,23:00:00,63,22,41,FMN GV 16 Berchem TOT
54,Posthofbrug 5366,2023-08-17,00:00:00,42,18,24,FMN GV 16 Berchem TOT
54,Posthofbrug 5366,2023-08-17,01:00:00,19,3,16,FMN GV 16 Berchem TOT
54,Posthofbrug 5366,2023-08-17,02:00:00,5,3,2,FMN GV 16 Berchem TOT
54,Posthofbrug 5366,2023-08-17,03:00:00,6,3,3,FMN GV 16 Berchem TOT
54,Posthofbrug 5366,2023-08-17,04:00:00,16,12,4,FMN GV 16 Berchem TOT
54,Posthofbrug 5366,2023-08-17,05:00:00,36,29,7,FMN GV 16 Berchem TOT
54,Posthofbrug 5366,2023-08-17,06:00:00,127,94,33,FMN GV 16 Berchem TOT
54,Posthofbrug 5366,2023-08-17,07:00:00,379,291,88,FMN GV 16 Berchem TOT
54,Posthofbrug 5366,2023-08-17,08:00:00,662,498,164,FMN GV 16 Berchem TOT
54,Posthofbrug 5366,2023-08-17,09:00:00,282,212,70,FMN GV 16 Berchem TOT
54,Posthofbrug 5366,2023-08-17,10:00:00,207,158,49,FMN GV 16 Berchem TOT
54,Posthofbrug 5366,2023-08-17,11:00:00,174,116,58,FMN GV 16 Berchem TOT
54,Posthofbrug 5366,2023-08-17,12:00:00,218,118,100,FMN GV 16 Berchem TOT
54,Posthofbrug 5366,2023-08-17,13:00:00,212,117,95,FMN GV 16 Berchem TOT
54,Posthofbrug 5366,2023-08-17,14:00:00,240,108,132,FMN GV 16 Berchem TOT
54,Posthofbrug 5366,2023-08-17,15:00:00,255,115,140,FMN GV 16 Berchem TOT
54,Posthofbrug 5366,2023-08-17,16:00:00,475,186,289,FMN GV 16 Berchem TOT
54,Posthofbrug 5366,2023-08-17,17:00:00,587,181,406,FMN GV 16 Berchem TOT
54,Posthofbrug 5366,2023-08-17,18:00:00,430,161,269,FMN GV 16 Berchem TOT
54,Posthofbrug 5366,2023-08-17,19:00:00,221,91,130,FMN GV 16 Berchem TOT
54,Posthofbrug 5366,2023-08-17,20:00:00,153,74,79,FMN GV 16 Berchem TOT
54,Posthofbrug 5366,2023-08-17,21:00:00,139,61,78,FMN GV 16 Berchem TOT
54,Posthofbrug 5366,2023-08-17,22:00:00,123,71,52,FMN GV 16 Berchem TOT
54,Posthofbrug 5366,2023-08-17,23:00:00,85,35,50,FMN GV 16 Berchem TOT
54,Posthofbrug 5366,2023-08-18,00:00:00,61,30,31,FMN GV 16 Berchem TOT
54,Posthofbrug 5366,2023-08-18,01:00:00,16,3,13,FMN GV 16 Berchem TOT
54,Posthofbrug 5366,2023-08-18,02:00:00,13,3,10,FMN GV 16 Berchem TOT
54,Posthofbrug 5366,2023-08-18,03:00:00,25,6,19,FMN GV 16 Berchem TOT
54,Posthofbrug 5366,2023-08-18,04:00:00,15,11,4,FMN GV 16 Berchem TOT
54,Posthofbrug 5366,2023-08-18,05:00:00,38,26,12,FMN GV 16 Berchem TOT
54,Posthofbrug 5366,2023-08-18,06:00:00,115,78,37,FMN GV 16 Berchem TOT
54,Posthofbrug 5366,2023-08-18,07:00:00,263,197,66,FMN GV 16 Berchem TOT
54,Posthofbrug 5366,2023-08-18,08:00:00,461,353,108,FMN GV 16 Berchem TOT
54,Posthofbrug 5366,2023-08-18,09:00:00,282,208,74,FMN GV 16 Berchem TOT
54,Posthofbrug 5366,2023-08-18,10:00:00,175,110,65,FMN GV 16 Berchem TOT
54,Posthofbrug 5366,2023-08-18,11:00:00,158,104,54,FMN GV 16 Berchem TOT
54,Posthofbrug 5366,2023-08-18,12:00:00,200,114,86,FMN GV 16 Berchem TOT
54,Posthofbrug 5366,2023-08-18,13:00:00,202,128,74,FMN GV 16 Berchem TOT
54,Posthofbrug 5366,2023-08-18,14:00:00,233,120,113,FMN GV 16 Berchem TOT
54,Posthofbrug 5366,2023-08-18,15:00:00,281,126,155,FMN GV 16 Berchem TOT
54,Posthofbrug 5366,2023-08-18,16:00:00,428,151,277,FMN GV 16 Berchem TOT
54,Posthofbrug 5366,2023-08-18,17:00:00,527,228,299,FMN GV 16 Berchem TOT
54,Posthofbrug 5366,2023-08-18,18:00:00,376,191,185,FMN GV 16 Berchem TOT
54,Posthofbrug 5366,2023-08-18,19:00:00,238,139,99,FMN GV 16 Berchem TOT
54,Posthofbrug 5366,2023-08-18,20:00:00,201,129,72,FMN GV 16 Berchem TOT
54,Posthofbrug 5366,2023-08-18,21:00:00,177,78,99,FMN GV 16 Berchem TOT
54,Posthofbrug 5366,2023-08-18,22:00:00,147,62,85,FMN GV 16 Berchem TOT
54,Posthofbrug 5366,2023-08-18,23:00:00,124,18,106,FMN GV 16 Berchem TOT
54,Posthofbrug 5366,2023-08-19,00:00:00,143,23,120,FMN GV 16 Berchem TOT
54,Posthofbrug 5366,2023-08-19,01:00:00,104,24,80,FMN GV 16 Berchem TOT
54,Posthofbrug 5366,2023-08-19,02:00:00,48,8,40,FMN GV 16 Berchem TOT
54,Posthofbrug 5366,2023-08-19,03:00:00,22,6,16,FMN GV 16 Berchem TOT
54,Posthofbrug 5366,2023-08-19,04:00:00,24,4,20,FMN GV 16 Berchem TOT
54,Posthofbrug 5366,2023-08-19,05:00:00,23,9,14,FMN GV 16 Berchem TOT
54,Posthofbrug 5366,2023-08-19,06:00:00,31,17,14,FMN GV 16 Berchem TOT
54,Posthofbrug 5366,2023-08-19,07:00:00,44,29,15,FMN GV 16 Berchem TOT
54,Posthofbrug 5366,2023-08-19,08:00:00,62,45,17,FMN GV 16 Berchem TOT
54,Posthofbrug 5366,2023-08-19,09:00:00,172,113,59,FMN GV 16 Berchem TOT
54,Posthofbrug 5366,2023-08-19,10:00:00,229,138,91,FMN GV 16 Berchem TOT
54,Posthofbrug 5366,2023-08-19,11:00:00,175,115,60,FMN GV 16 Berchem TOT
54,Posthofbrug 5366,2023-08-19,12:00:00,209,114,95,FMN GV 16 Berchem TOT
54,Posthofbrug 5366,2023-08-19,13:00:00,216,134,82,FMN GV 16 Berchem TOT
54,Posthofbrug 5366,2023-08-19,14:00:00,223,136,87,FMN GV 16 Berchem TOT
54,Posthofbrug 5366,2023-08-19,15:00:00,204,109,95,FMN GV 16 Berchem TOT
54,Posthofbrug 5366,2023-08-19,16:00:00,218,120,98,FMN GV 16 Berchem TOT
54,Posthofbrug 5366,2023-08-19,17:00:00,223,122,101,FMN GV 16 Berchem TOT
54,Posthofbrug 5366,2023-08-19,18:00:00,195,98,97,FMN GV 16 Berchem TOT
54,Posthofbrug 5366,2023-08-19,19:00:00,175,94,81,FMN GV 16 Berchem TOT
54,Posthofbrug 5366,2023-08-19,20:00:00,157,103,54,FMN GV 16 Berchem TOT
54,Posthofbrug 5366,2023-08-19,21:00:00,139,69,70,FMN GV 16 Berchem TOT
54,Posthofbrug 5366,2023-08-19,22:00:00,129,48,81,FMN GV 16 Berchem TOT
54,Posthofbrug 5366,2023-08-19,23:00:00,85,22,63,FMN GV 16 Berchem TOT
54,Posthofbrug 5366,2023-08-20,00:00:00,91,21,70,FMN GV 16 Berchem TOT
54,Posthofbrug 5366,2023-08-20,01:00:00,57,17,40,FMN GV 16 Berchem TOT
54,Posthofbrug 5366,2023-08-20,02:00:00,62,12,50,FMN GV 16 Berchem TOT
54,Posthofbrug 5366,2023-08-20,03:00:00,50,4,46,FMN GV 16 Berchem TOT
54,Posthofbrug 5366,2023-08-20,04:00:00,30,10,20,FMN GV 16 Berchem TOT
54,Posthofbrug 5366,2023-08-20,05:00:00,22,5,17,FMN GV 16 Berchem TOT
54,Posthofbrug 5366,2023-08-20,06:00:00,22,10,12,FMN GV 16 Berchem TOT
54,Posthofbrug 5366,2023-08-20,07:00:00,40,26,14,FMN GV 16 Berchem TOT
54,Posthofbrug 5366,2023-08-20,08:00:00,63,43,20,FMN GV 16 Berchem TOT
54,Posthofbrug 5366,2023-08-20,09:00:00,145,99,46,FMN GV 16 Berchem TOT
54,Posthofbrug 5366,2023-08-20,10:00:00,196,122,74,FMN GV 16 Berchem TOT
54,Posthofbrug 5366,2023-08-20,11:00:00,237,139,98,FMN GV 16 Berchem TOT
54,Posthofbrug 5366,2023-08-20,12:00:00,256,181,75,FMN GV 16 Berchem TOT
54,Posthofbrug 5366,2023-08-20,13:00:00,306,174,132,FMN GV 16 Berchem TOT
54,Posthofbrug 5366,2023-08-20,14:00:00,340,206,134,FMN GV 16 Berchem TOT
54,Posthofbrug 5366,2023-08-20,15:00:00,261,150,111,FMN GV 16 Berchem TOT
54,Posthofbrug 5366,2023-08-20,16:00:00,253,120,133,FMN GV 16 Berchem TOT
54,Posthofbrug 5366,2023-08-20,17:00:00,270,127,143,FMN GV 16 Berchem TOT
54,Posthofbrug 5366,2023-08-20,18:00:00,207,124,83,FMN GV 16 Berchem TOT
54,Posthofbrug 5366,2023-08-20,19:00:00,176,95,81,FMN GV 16 Berchem TOT
54,Posthofbrug 5366,2023-08-20,20:00:00,143,70,73,FMN GV 16 Berchem TOT
54,Posthofbrug 5366,2023-08-20,21:00:00,123,45,78,FMN GV 16 Berchem TOT
54,Posthofbrug 5366,2023-08-20,22:00:00,101,33,68,FMN GV 16 Berchem TOT
54,Posthofbrug 5366,2023-08-20,23:00:00,36,18,18,FMN GV 16 Berchem TOT
54,Posthofbrug 5366,2023-08-21,00:00:00,18,2,16,FMN GV 16 Berchem TOT
54,Posthofbrug 5366,2023-08-21,01:00:00,8,0,8,FMN GV 16 Berchem TOT
54,Posthofbrug 5366,2023-08-21,02:00:00,8,3,5,FMN GV 16 Berchem TOT
54,Posthofbrug 5366,2023-08-21,03:00:00,7,5,2,FMN GV 16 Berchem TOT
54,Posthofbrug 5366,2023-08-21,04:00:00,17,7,10,FMN GV 16 Berchem TOT
54,Posthofbrug 5366,2023-08-21,05:00:00,38,27,11,FMN GV 16 Berchem TOT
54,Posthofbrug 5366,2023-08-21,06:00:00,139,107,32,FMN GV 16 Berchem TOT
54,Posthofbrug 5366,2023-08-21,07:00:00,379,300,79,FMN GV 16 Berchem TOT
54,Posthofbrug 5366,2023-08-21,08:00:00,767,591,176,FMN GV 16 Berchem TOT
54,Posthofbrug 5366,2023-08-21,09:00:00,320,255,65,FMN GV 16 Berchem TOT
54,Posthofbrug 5366,2023-08-21,10:00:00,188,132,56,FMN GV 16 Berchem TOT
54,Posthofbrug 5366,2023-08-21,11:00:00,199,128,71,FMN GV 16 Berchem TOT
54,Posthofbrug 5366,2023-08-21,12:00:00,234,126,108,FMN GV 16 Berchem TOT
54,Posthofbrug 5366,2023-08-21,13:00:00,241,136,105,FMN GV 16 Berchem TOT
54,Posthofbrug 5366,2023-08-21,14:00:00,254,123,131,FMN GV 16 Berchem TOT
54,Posthofbrug 5366,2023-08-21,15:00:00,274,103,171,FMN GV 16 Berchem TOT
54,Posthofbrug 5366,2023-08-21,16:00:00,557,202,355,FMN GV 16 Berchem TOT
54,Posthofbrug 5366,2023-08-21,17:00:00,646,199,447,FMN GV 16 Berchem TOT
54,Posthofbrug 5366,2023-08-21,18:00:00,427,157,270,FMN GV 16 Berchem TOT
54,Posthofbrug 5366,2023-08-21,19:00:00,216,90,126,FMN GV 16 Berchem TOT
54,Posthofbrug 5366,2023-08-21,20:00:00,167,91,76,FMN GV 16 Berchem TOT
54,Posthofbrug 5366,2023-08-21,21:00:00,122,61,61,FMN GV 16 Berchem TOT
54,Posthofbrug 5366,2023-08-21,22:00:00,149,69,80,FMN GV 16 Berchem TOT
54,Posthofbrug 5366,2023-08-21,23:00:00,65,19,46,FMN GV 16 Berchem TOT
54,Posthofbrug 5366,2023-08-22,00:00:00,37,13,24,FMN GV 16 Berchem TOT
54,Posthofbrug 5366,2023-08-22,01:00:00,15,2,13,FMN GV 16 Berchem TOT
54,Posthofbrug 5366,2023-08-22,02:00:00,15,3,12,FMN GV 16 Berchem TOT
54,Posthofbrug 5366,2023-08-22,03:00:00,5,2,3,FMN GV 16 Berchem TOT
54,Posthofbrug 5366,2023-08-22,04:00:00,18,10,8,FMN GV 16 Berchem TOT
54,Posthofbrug 5366,2023-08-22,05:00:00,40,29,11,FMN GV 16 Berchem TOT
54,Posthofbrug 5366,2023-08-22,06:00:00,156,110,46,FMN GV 16 Berchem TOT
54,Posthofbrug 5366,2023-08-22,07:00:00,440,353,87,FMN GV 16 Berchem TOT
54,Posthofbrug 5366,2023-08-22,08:00:00,863,640,223,FMN GV 16 Berchem TOT
54,Posthofbrug 5366,2023-08-22,09:00:00,371,292,79,FMN GV 16 Berchem TOT
54,Posthofbrug 5366,2023-08-22,10:00:00,235,145,90,FMN GV 16 Berchem TOT
54,Posthofbrug 5366,2023-08-22,11:00:00,171,98,73,FMN GV 16 Berchem TOT
54,Posthofbrug 5366,2023-08-22,12:00:00,275,161,114,FMN GV 16 Berchem TOT
54,Posthofbrug 5366,2023-08-22,13:00:00,235,127,108,FMN GV 16 Berchem TOT
54,Posthofbrug 5366,2023-08-22,14:00:00,241,116,125,FMN GV 16 Berchem TOT
54,Posthofbrug 5366,2023-08-22,15:00:00,305,155,150,FMN GV 16 Berchem TOT
54,Posthofbrug 5366,2023-08-22,16:00:00,521,194,327,FMN GV 16 Berchem TOT
54,Posthofbrug 5366,2023-08-22,17:00:00,757,243,514,FMN GV 16 Berchem TOT
54,Posthofbrug 5366,2023-08-22,18:00:00,496,184,312,FMN GV 16 Berchem TOT
54,Posthofbrug 5366,2023-08-22,19:00:00,255,114,141,FMN GV 16 Berchem TOT
54,Posthofbrug 5366,2023-08-22,20:00:00,187,80,107,FMN GV 16 Berchem TOT
54,Posthofbrug 5366,2023-08-22,21:00:00,150,58,92,FMN GV 16 Berchem TOT
54,Posthofbrug 5366,2023-08-22,22:00:00,127,43,84,FMN GV 16 Berchem TOT
54,Posthofbrug 5366,2023-08-22,23:00:00,93,41,52,FMN GV 16 Berchem TOT
54,Posthofbrug 5366,2023-08-23,00:00:00,39,14,25,FMN GV 16 Berchem TOT
54,Posthofbrug 5366,2023-08-23,01:00:00,27,5,22,FMN GV 16 Berchem TOT
54,Posthofbrug 5366,2023-08-23,02:00:00,11,1,10,FMN GV 16 Berchem TOT
54,Posthofbrug 5366,2023-08-23,03:00:00,13,7,6,FMN GV 16 Berchem TOT
54,Posthofbrug 5366,2023-08-23,04:00:00,17,9,8,FMN GV 16 Berchem TOT
54,Posthofbrug 5366,2023-08-23,05:00:00,42,28,14,FMN GV 16 Berchem TOT
54,Posthofbrug 5366,2023-08-23,06:00:00,145,105,40,FMN GV 16 Berchem TOT
54,Posthofbrug 5366,2023-08-23,07:00:00,365,281,84,FMN GV 16 Berchem TOT
54,Posthofbrug 5366,2023-08-23,08:00:00,710,506,204,FMN GV 16 Berchem TOT
54,Posthofbrug 5366,2023-08-23,09:00:00,382,294,88,FMN GV 16 Berchem TOT
54,Posthofbrug 5366,2023-08-23,10:00:00,214,154,60,FMN GV 16 Berchem TOT
54,Posthofbrug 5366,2023-08-23,11:00:00,194,125,69,FMN GV 16 Berchem TOT
54,Posthofbrug 5366,2023-08-23,12:00:00,275,153,122,FMN GV 16 Berchem TOT
54,Posthofbrug 5366,2023-08-23,13:00:00,259,160,99,FMN GV 16 Berchem TOT
54,Posthofbrug 5366,2023-08-23,14:00:00,234,114,120,FMN GV 16 Berchem TOT
54,Posthofbrug 5366,2023-08-23,15:00:00,312,132,180,FMN GV 16 Berchem TOT
54,Posthofbrug 5366,2023-08-23,16:00:00,508,199,309,FMN GV 16 Berchem TOT
54,Posthofbrug 5366,2023-08-23,17:00:00,682,209,473,FMN GV 16 Berchem TOT
54,Posthofbrug 5366,2023-08-23,18:00:00,448,167,281,FMN GV 16 Berchem TOT
54,Posthofbrug 5366,2023-08-23,19:00:00,331,163,168,FMN GV 16 Berchem TOT
54,Posthofbrug 5366,2023-08-23,20:00:00,232,129,103,FMN GV 16 Berchem TOT
54,Posthofbrug 5366,2023-08-23,21:00:00,156,69,87,FMN GV 16 Berchem TOT
54,Posthofbrug 5366,2023-08-23,22:00:00,145,60,85,FMN GV 16 Berchem TOT
54,Posthofbrug 5366,2023-08-23,23:00:00,91,45,46,FMN GV 16 Berchem TOT
54,Posthofbrug 5366,2023-08-24,00:00:00,45,17,28,FMN GV 16 Berchem TOT
54,Posthofbrug 5366,2023-08-24,01:00:00,26,3,23,FMN GV 16 Berchem TOT
54,Posthofbrug 5366,2023-08-24,02:00:00,5,1,4,FMN GV 16 Berchem TOT
54,Posthofbrug 5366,2023-08-24,03:00:00,6,4,2,FMN GV 16 Berchem TOT
54,Posthofbrug 5366,2023-08-24,04:00:00,18,7,11,FMN GV 16 Berchem TOT
54,Posthofbrug 5366,2023-08-24,05:00:00,44,30,14,FMN GV 16 Berchem TOT
54,Posthofbrug 5366,2023-08-24,06:00:00,133,96,37,FMN GV 16 Berchem TOT
54,Posthofbrug 5366,2023-08-24,07:00:00,378,300,78,FMN GV 16 Berchem TOT
54,Posthofbrug 5366,2023-08-24,08:00:00,803,595,208,FMN GV 16 Berchem TOT
54,Posthofbrug 5366,2023-08-24,09:00:00,365,272,93,FMN GV 16 Berchem TOT
54,Posthofbrug 5366,2023-08-24,10:00:00,172,121,51,FMN GV 16 Berchem TOT
54,Posthofbrug 5366,2023-08-24,11:00:00,161,85,76,FMN GV 16 Berchem TOT
54,Posthofbrug 5366,2023-08-24,12:00:00,156,76,80,FMN GV 16 Berchem TOT
54,Posthofbrug 5366,2023-08-24,13:00:00,175,94,81,FMN GV 16 Berchem TOT
54,Posthofbrug 5366,2023-08-24,14:00:00,171,84,87,FMN GV 16 Berchem TOT
54,Posthofbrug 5366,2023-08-24,15:00:00,214,78,136,FMN GV 16 Berchem TOT
54,Posthofbrug 5366,2023-08-24,16:00:00,488,187,301,FMN GV 16 Berchem TOT
54,Posthofbrug 5366,2023-08-24,17:00:00,629,219,410,FMN GV 16 Berchem TOT
54,Posthofbrug 5366,2023-08-24,18:00:00,407,140,267,FMN GV 16 Berchem TOT
54,Posthofbrug 5366,2023-08-24,19:00:00,223,96,127,FMN GV 16 Berchem TOT
54,Posthofbrug 5366,2023-08-24,20:00:00,204,113,91,FMN GV 16 Berchem TOT
54,Posthofbrug 5366,2023-08-24,21:00:00,145,78,67,FMN GV 16 Berchem TOT
54,Posthofbrug 5366,2023-08-24,22:00:00,121,50,71,FMN GV 16 Berchem TOT
54,Posthofbrug 5366,2023-08-24,23:00:00,88,25,63,FMN GV 16 Berchem TOT
54,Posthofbrug 5366,2023-08-25,00:00:00,55,14,41,FMN GV 16 Berchem TOT
54,Posthofbrug 5366,2023-08-25,01:00:00,13,4,9,FMN GV 16 Berchem TOT
54,Posthofbrug 5366,2023-08-25,02:00:00,7,3,4,FMN GV 16 Berchem TOT
54,Posthofbrug 5366,2023-08-25,03:00:00,9,4,5,FMN GV 16 Berchem TOT
54,Posthofbrug 5366,2023-08-25,04:00:00,22,11,11,FMN GV 16 Berchem TOT
54,Posthofbrug 5366,2023-08-25,05:00:00,31,19,12,FMN GV 16 Berchem TOT
54,Posthofbrug 5366,2023-08-25,06:00:00,106,72,34,FMN GV 16 Berchem TOT
54,Posthofbrug 5366,2023-08-25,07:00:00,301,225,76,FMN GV 16 Berchem TOT
54,Posthofbrug 5366,2023-08-25,08:00:00,439,323,116,FMN GV 16 Berchem TOT
54,Posthofbrug 5366,2023-08-25,09:00:00,286,227,59,FMN GV 16 Berchem TOT
54,Posthofbrug 5366,2023-08-25,10:00:00,161,115,46,FMN GV 16 Berchem TOT
54,Posthofbrug 5366,2023-08-25,11:00:00,191,126,65,FMN GV 16 Berchem TOT
54,Posthofbrug 5366,2023-08-25,12:00:00,222,118,104,FMN GV 16 Berchem TOT
54,Posthofbrug 5366,2023-08-25,13:00:00,249,136,113,FMN GV 16 Berchem TOT
54,Posthofbrug 5366,2023-08-25,14:00:00,261,153,108,FMN GV 16 Berchem TOT
54,Posthofbrug 5366,2023-08-25,15:00:00,296,140,156,FMN GV 16 Berchem TOT
54,Posthofbrug 5366,2023-08-25,16:00:00,534,205,329,FMN GV 16 Berchem TOT
54,Posthofbrug 5366,2023-08-25,17:00:00,444,168,276,FMN GV 16 Berchem TOT
54,Posthofbrug 5366,2023-08-25,18:00:00,356,150,206,FMN GV 16 Berchem TOT
54,Posthofbrug 5366,2023-08-25,19:00:00,205,84,121,FMN GV 16 Berchem TOT
54,Posthofbrug 5366,2023-08-25,20:00:00,185,98,87,FMN GV 16 Berchem TOT
54,Posthofbrug 5366,2023-08-25,21:00:00,123,62,61,FMN GV 16 Berchem TOT
54,Posthofbrug 5366,2023-08-25,22:00:00,100,38,62,FMN GV 16 Berchem TOT
54,Posthofbrug 5366,2023-08-25,23:00:00,96,40,56,FMN GV 16 Berchem TOT
54,Posthofbrug 5366,2023-08-26,00:00:00,77,29,48,FMN GV 16 Berchem TOT
54,Posthofbrug 5366,2023-08-26,01:00:00,52,22,30,FMN GV 16 Berchem TOT
54,Posthofbrug 5366,2023-08-26,02:00:00,43,7,36,FMN GV 16 Berchem TOT
54,Posthofbrug 5366,2023-08-26,03:00:00,20,8,12,FMN GV 16 Berchem TOT
54,Posthofbrug 5366,2023-08-26,04:00:00,24,8,16,FMN GV 16 Berchem TOT
54,Posthofbrug 5366,2023-08-26,05:00:00,18,11,7,FMN GV 16 Berchem TOT
54,Posthofbrug 5366,2023-08-26,06:00:00,29,19,10,FMN GV 16 Berchem TOT
54,Posthofbrug 5366,2023-08-26,07:00:00,50,34,16,FMN GV 16 Berchem TOT
54,Posthofbrug 5366,2023-08-26,08:00:00,123,88,35,FMN GV 16 Berchem TOT
54,Posthofbrug 5366,2023-08-26,09:00:00,271,227,44,FMN GV 16 Berchem TOT
54,Posthofbrug 5366,2023-08-26,10:00:00,306,235,71,FMN GV 16 Berchem TOT
54,Posthofbrug 5366,2023-08-26,11:00:00,279,178,101,FMN GV 16 Berchem TOT
54,Posthofbrug 5366,2023-08-26,12:00:00,312,201,111,FMN GV 16 Berchem TOT
54,Posthofbrug 5366,2023-08-26,13:00:00,370,225,145,FMN GV 16 Berchem TOT
54,Posthofbrug 5366,2023-08-26,14:00:00,479,313,166,FMN GV 16 Berchem TOT
54,Posthofbrug 5366,2023-08-26,15:00:00,352,209,143,FMN GV 16 Berchem TOT
54,Posthofbrug 5366,2023-08-26,16:00:00,240,114,126,FMN GV 16 Berchem TOT
54,Posthofbrug 5366,2023-08-26,17:00:00,345,98,247,FMN GV 16 Berchem TOT
54,Posthofbrug 5366,2023-08-26,18:00:00,251,97,154,FMN GV 16 Berchem TOT
54,Posthofbrug 5366,2023-08-26,19:00:00,148,56,92,FMN GV 16 Berchem TOT
54,Posthofbrug 5366,2023-08-26,20:00:00,125,48,77,FMN GV 16 Berchem TOT
54,Posthofbrug 5366,2023-08-26,21:00:00,105,54,51,FMN GV 16 Berchem TOT
54,Posthofbrug 5366,2023-08-26,22:00:00,79,31,48,FMN GV 16 Berchem TOT
54,Posthofbrug 5366,2023-08-26,23:00:00,97,42,55,FMN GV 16 Berchem TOT
54,Posthofbrug 5366,2023-08-27,00:00:00,77,13,64,FMN GV 16 Berchem TOT
54,Posthofbrug 5366,2023-08-27,01:00:00,51,18,33,FMN GV 16 Berchem TOT
54,Posthofbrug 5366,2023-08-27,02:00:00,40,14,26,FMN GV 16 Berchem TOT
54,Posthofbrug 5366,2023-08-27,03:00:00,32,9,23,FMN GV 16 Berchem TOT
54,Posthofbrug 5366,2023-08-27,04:00:00,23,5,18,FMN GV 16 Berchem TOT
54,Posthofbrug 5366,2023-08-27,05:00:00,16,9,7,FMN GV 16 Berchem TOT
54,Posthofbrug 5366,2023-08-27,06:00:00,27,19,8,FMN GV 16 Berchem TOT
54,Posthofbrug 5366,2023-08-27,07:00:00,46,28,18,FMN GV 16 Berchem TOT
54,Posthofbrug 5366,2023-08-27,08:00:00,59,36,23,FMN GV 16 Berchem TOT
54,Posthofbrug 5366,2023-08-27,09:00:00,137,91,46,FMN GV 16 Berchem TOT
54,Posthofbrug 5366,2023-08-27,10:00:00,190,124,66,FMN GV 16 Berchem TOT
54,Posthofbrug 5366,2023-08-27,11:00:00,198,130,68,FMN GV 16 Berchem TOT
54,Posthofbrug 5366,2023-08-27,12:00:00,218,124,94,FMN GV 16 Berchem TOT
54,Posthofbrug 5366,2023-08-27,13:00:00,208,120,88,FMN GV 16 Berchem TOT
54,Posthofbrug 5366,2023-08-27,14:00:00,219,133,86,FMN GV 16 Berchem TOT
54,Posthofbrug 5366,2023-08-27,15:00:00,142,94,48,FMN GV 16 Berchem TOT
54,Posthofbrug 5366,2023-08-27,16:00:00,212,121,91,FMN GV 16 Berchem TOT
54,Posthofbrug 5366,2023-08-27,17:00:00,210,96,114,FMN GV 16 Berchem TOT
54,Posthofbrug 5366,2023-08-27,18:00:00,204,113,91,FMN GV 16 Berchem TOT
54,Posthofbrug 5366,2023-08-27,19:00:00,145,72,73,FMN GV 16 Berchem TOT
54,Posthofbrug 5366,2023-08-27,20:00:00,129,66,63,FMN GV 16 Berchem TOT
54,Posthofbrug 5366,2023-08-27,21:00:00,127,57,70,FMN GV 16 Berchem TOT
54,Posthofbrug 5366,2023-08-27,22:00:00,89,36,53,FMN GV 16 Berchem TOT
54,Posthofbrug 5366,2023-08-27,23:00:00,49,15,34,FMN GV 16 Berchem TOT
54,Posthofbrug 5366,2023-08-28,00:00:00,40,15,25,FMN GV 16 Berchem TOT
54,Posthofbrug 5366,2023-08-28,01:00:00,10,3,7,FMN GV 16 Berchem TOT
54,Posthofbrug 5366,2023-08-28,02:00:00,14,0,14,FMN GV 16 Berchem TOT
54,Posthofbrug 5366,2023-08-28,03:00:00,2,0,2,FMN GV 16 Berchem TOT
54,Posthofbrug 5366,2023-08-28,04:00:00,10,5,5,FMN GV 16 Berchem TOT
54,Posthofbrug 5366,2023-08-28,05:00:00,43,31,12,FMN GV 16 Berchem TOT
54,Posthofbrug 5366,2023-08-28,06:00:00,131,104,27,FMN GV 16 Berchem TOT
54,Posthofbrug 5366,2023-08-28,07:00:00,358,268,90,FMN GV 16 Berchem TOT
54,Posthofbrug 5366,2023-08-28,08:00:00,828,650,178,FMN GV 16 Berchem TOT
54,Posthofbrug 5366,2023-08-28,09:00:00,328,254,74,FMN GV 16 Berchem TOT
54,Posthofbrug 5366,2023-08-28,10:00:00,179,124,55,FMN GV 16 Berchem TOT
54,Posthofbrug 5366,2023-08-28,11:00:00,160,97,63,FMN GV 16 Berchem TOT
54,Posthofbrug 5366,2023-08-28,12:00:00,229,127,102,FMN GV 16 Berchem TOT
54,Posthofbrug 5366,2023-08-28,13:00:00,217,106,111,FMN GV 16 Berchem TOT
54,Posthofbrug 5366,2023-08-28,14:00:00,217,99,118,FMN GV 16 Berchem TOT
54,Posthofbrug 5366,2023-08-28,15:00:00,291,132,159,FMN GV 16 Berchem TOT
54,Posthofbrug 5366,2023-08-28,16:00:00,455,155,300,FMN GV 16 Berchem TOT
54,Posthofbrug 5366,2023-08-28,17:00:00,668,189,479,FMN GV 16 Berchem TOT
54,Posthofbrug 5366,2023-08-28,18:00:00,385,128,257,FMN GV 16 Berchem TOT
54,Posthofbrug 5366,2023-08-28,19:00:00,198,67,131,FMN GV 16 Berchem TOT
54,Posthofbrug 5366,2023-08-28,20:00:00,128,62,66,FMN GV 16 Berchem TOT
54,Posthofbrug 5366,2023-08-28,21:00:00,110,53,57,FMN GV 16 Berchem TOT
54,Posthofbrug 5366,2023-08-28,22:00:00,98,35,63,FMN GV 16 Berchem TOT
54,Posthofbrug 5366,2023-08-28,23:00:00,68,21,47,FMN GV 16 Berchem TOT
54,Posthofbrug 5366,2023-08-29,00:00:00,26,9,17,FMN GV 16 Berchem TOT
54,Posthofbrug 5366,2023-08-29,01:00:00,6,4,2,FMN GV 16 Berchem TOT
54,Posthofbrug 5366,2023-08-29,02:00:00,8,4,4,FMN GV 16 Berchem TOT
54,Posthofbrug 5366,2023-08-29,03:00:00,3,2,1,FMN GV 16 Berchem TOT
54,Posthofbrug 5366,2023-08-29,04:00:00,15,7,8,FMN GV 16 Berchem TOT
54,Posthofbrug 5366,2023-08-29,05:00:00,44,34,10,FMN GV 16 Berchem TOT
54,Posthofbrug 5366,2023-08-29,06:00:00,158,122,36,FMN GV 16 Berchem TOT
54,Posthofbrug 5366,2023-08-29,07:00:00,471,363,108,FMN GV 16 Berchem TOT
54,Posthofbrug 5366,2023-08-29,08:00:00,954,751,203,FMN GV 16 Berchem TOT
54,Posthofbrug 5366,2023-08-29,09:00:00,354,271,83,FMN GV 16 Berchem TOT
54,Posthofbrug 5366,2023-08-29,10:00:00,209,144,65,FMN GV 16 Berchem TOT
54,Posthofbrug 5366,2023-08-29,11:00:00,196,119,77,FMN GV 16 Berchem TOT
54,Posthofbrug 5366,2023-08-29,12:00:00,232,125,107,FMN GV 16 Berchem TOT
54,Posthofbrug 5366,2023-08-29,13:00:00,240,130,110,FMN GV 16 Berchem TOT
54,Posthofbrug 5366,2023-08-29,14:00:00,250,129,121,FMN GV 16 Berchem TOT
54,Posthofbrug 5366,2023-08-29,15:00:00,286,115,171,FMN GV 16 Berchem TOT
54,Posthofbrug 5366,2023-08-29,16:00:00,575,205,370,FMN GV 16 Berchem TOT
54,Posthofbrug 5366,2023-08-29,17:00:00,788,244,544,FMN GV 16 Berchem TOT
54,Posthofbrug 5366,2023-08-29,18:00:00,541,185,356,FMN GV 16 Berchem TOT
54,Posthofbrug 5366,2023-08-29,19:00:00,256,111,145,FMN GV 16 Berchem TOT
54,Posthofbrug 5366,2023-08-29,20:00:00,179,93,86,FMN GV 16 Berchem TOT
54,Posthofbrug 5366,2023-08-29,21:00:00,156,75,81,FMN GV 16 Berchem TOT
54,Posthofbrug 5366,2023-08-29,22:00:00,145,54,91,FMN GV 16 Berchem TOT
54,Posthofbrug 5366,2023-08-29,23:00:00,89,28,61,FMN GV 16 Berchem TOT
54,Posthofbrug 5366,2023-08-30,00:00:00,45,14,31,FMN GV 16 Berchem TOT
54,Posthofbrug 5366,2023-08-30,01:00:00,26,9,17,FMN GV 16 Berchem TOT
54,Posthofbrug 5366,2023-08-30,02:00:00,15,3,12,FMN GV 16 Berchem TOT
54,Posthofbrug 5366,2023-08-30,03:00:00,5,2,3,FMN GV 16 Berchem TOT
54,Posthofbrug 5366,2023-08-30,04:00:00,13,5,8,FMN GV 16 Berchem TOT
54,Posthofbrug 5366,2023-08-30,05:00:00,43,34,9,FMN GV 16 Berchem TOT
54,Posthofbrug 5366,2023-08-30,06:00:00,122,96,26,FMN GV 16 Berchem TOT
54,Posthofbrug 5366,2023-08-30,07:00:00,347,268,79,FMN GV 16 Berchem TOT
54,Posthofbrug 5366,2023-08-30,08:00:00,547,435,112,FMN GV 16 Berchem TOT
54,Posthofbrug 5366,2023-08-30,09:00:00,272,204,68,FMN GV 16 Berchem TOT
54,Posthofbrug 5366,2023-08-30,10:00:00,134,90,44,FMN GV 16 Berchem TOT
54,Posthofbrug 5366,2023-08-30,11:00:00,150,96,54,FMN GV 16 Berchem TOT
54,Posthofbrug 5366,2023-08-30,12:00:00,183,114,69,FMN GV 16 Berchem TOT
54,Posthofbrug 5366,2023-08-30,13:00:00,192,104,88,FMN GV 16 Berchem TOT
54,Posthofbrug 5366,2023-08-30,14:00:00,216,112,104,FMN GV 16 Berchem TOT
54,Posthofbrug 5366,2023-08-30,15:00:00,266,104,162,FMN GV 16 Berchem TOT
54,Posthofbrug 5366,2023-08-30,16:00:00,426,157,269,FMN GV 16 Berchem TOT
54,Posthofbrug 5366,2023-08-30,17:00:00,546,185,361,FMN GV 16 Berchem TOT
54,Posthofbrug 5366,2023-08-30,18:00:00,389,162,227,FMN GV 16 Berchem TOT
54,Posthofbrug 5366,2023-08-30,19:00:00,225,95,130,FMN GV 16 Berchem TOT
54,Posthofbrug 5366,2023-08-30,20:00:00,164,94,70,FMN GV 16 Berchem TOT
54,Posthofbrug 5366,2023-08-30,21:00:00,119,54,65,FMN GV 16 Berchem TOT
54,Posthofbrug 5366,2023-08-30,22:00:00,140,56,84,FMN GV 16 Berchem TOT
54,Posthofbrug 5366,2023-08-30,23:00:00,95,35,60,FMN GV 16 Berchem TOT
54,Posthofbrug 5366,2023-08-31,00:00:00,51,18,33,FMN GV 16 Berchem TOT
54,Posthofbrug 5366,2023-08-31,01:00:00,25,2,23,FMN GV 16 Berchem TOT
54,Posthofbrug 5366,2023-08-31,02:00:00,18,4,14,FMN GV 16 Berchem TOT
54,Posthofbrug 5366,2023-08-31,03:00:00,10,3,7,FMN GV 16 Berchem TOT
54,Posthofbrug 5366,2023-08-31,04:00:00,20,7,13,FMN GV 16 Berchem TOT
54,Posthofbrug 5366,2023-08-31,05:00:00,41,28,13,FMN GV 16 Berchem TOT
54,Posthofbrug 5366,2023-08-31,06:00:00,135,101,34,FMN GV 16 Berchem TOT
54,Posthofbrug 5366,2023-08-31,07:00:00,375,287,88,FMN GV 16 Berchem TOT
54,Posthofbrug 5366,2023-08-31,08:00:00,826,668,158,FMN GV 16 Berchem TOT
54,Posthofbrug 5366,2023-08-31,09:00:00,362,287,75,FMN GV 16 Berchem TOT
54,Posthofbrug 5366,2023-08-31,10:00:00,220,152,68,FMN GV 16 Berchem TOT
54,Posthofbrug 5366,2023-08-31,11:00:00,241,150,91,FMN GV 16 Berchem TOT
54,Posthofbrug 5366,2023-08-31,12:00:00,259,130,129,FMN GV 16 Berchem TOT
54,Posthofbrug 5366,2023-08-31,13:00:00,266,159,107,FMN GV 16 Berchem TOT
54,Posthofbrug 5366,2023-08-31,14:00:00,261,127,134,FMN GV 16 Berchem TOT
54,Posthofbrug 5366,2023-08-31,15:00:00,309,121,188,FMN GV 16 Berchem TOT
54,Posthofbrug 5366,2023-08-31,16:00:00,519,184,335,FMN GV 16 Berchem TOT
54,Posthofbrug 5366,2023-08-31,17:00:00,734,202,532,FMN GV 16 Berchem TOT
54,Posthofbrug 5366,2023-08-31,18:00:00,459,143,316,FMN GV 16 Berchem TOT
54,Posthofbrug 5366,2023-08-31,19:00:00,259,105,154,FMN GV 16 Berchem TOT
54,Posthofbrug 5366,2023-08-31,20:00:00,175,110,65,FMN GV 16 Berchem TOT
54,Posthofbrug 5366,2023-08-31,21:00:00,127,59,68,FMN GV 16 Berchem TOT
54,Posthofbrug 5366,2023-08-31,22:00:00,144,71,73,FMN GV 16 Berchem TOT
54,Posthofbrug 5366,2023-08-31,23:00:00,70,23,47,FMN GV 16 Berchem TOT
54,Posthofbrug 5366,2023-09-01,00:00:00,39,12,27,FMN GV 16 Berchem TOT
54,Posthofbrug 5366,2023-09-01,01:00:00,33,8,25,FMN GV 16 Berchem TOT
54,Posthofbrug 5366,2023-09-01,02:00:00,7,0,7,FMN GV 16 Berchem TOT
54,Posthofbrug 5366,2023-09-01,03:00:00,10,2,8,FMN GV 16 Berchem TOT
54,Posthofbrug 5366,2023-09-01,04:00:00,17,7,10,FMN GV 16 Berchem TOT
54,Posthofbrug 5366,2023-09-01,05:00:00,26,19,7,FMN GV 16 Berchem TOT
54,Posthofbrug 5366,2023-09-01,06:00:00,95,70,25,FMN GV 16 Berchem TOT
54,Posthofbrug 5366,2023-09-01,07:00:00,309,257,52,FMN GV 16 Berchem TOT
54,Posthofbrug 5366,2023-09-01,08:00:00,574,451,123,FMN GV 16 Berchem TOT
54,Posthofbrug 5366,2023-09-01,09:00:00,261,201,60,FMN GV 16 Berchem TOT
54,Posthofbrug 5366,2023-09-01,10:00:00,90,52,38,FMN GV 16 Berchem TOT
54,Posthofbrug 5366,2023-09-01,11:00:00,73,39,34,FMN GV 16 Berchem TOT
54,Posthofbrug 5366,2023-09-01,12:00:00,117,53,64,FMN GV 16 Berchem TOT
54,Posthofbrug 5366,2023-09-01,13:00:00,134,67,67,FMN GV 16 Berchem TOT
54,Posthofbrug 5366,2023-09-01,14:00:00,176,74,102,FMN GV 16 Berchem TOT
54,Posthofbrug 5366,2023-09-01,15:00:00,301,122,179,FMN GV 16 Berchem TOT
54,Posthofbrug 5366,2023-09-01,16:00:00,377,137,240,FMN GV 16 Berchem TOT
54,Posthofbrug 5366,2023-09-01,17:00:00,413,158,255,FMN GV 16 Berchem TOT
54,Posthofbrug 5366,2023-09-01,18:00:00,308,132,176,FMN GV 16 Berchem TOT
54,Posthofbrug 5366,2023-09-01,19:00:00,218,112,106,FMN GV 16 Berchem TOT
54,Posthofbrug 5366,2023-09-01,20:00:00,122,61,61,FMN GV 16 Berchem TOT
54,Posthofbrug 5366,2023-09-01,21:00:00,117,54,63,FMN GV 16 Berchem TOT
54,Posthofbrug 5366,2023-09-01,22:00:00,106,36,70,FMN GV 16 Berchem TOT
54,Posthofbrug 5366,2023-09-01,23:00:00,81,21,60,FMN GV 16 Berchem TOT
54,Posthofbrug 5366,2023-09-02,00:00:00,73,16,57,FMN GV 16 Berchem TOT
54,Posthofbrug 5366,2023-09-02,01:00:00,45,11,34,FMN GV 16 Berchem TOT
54,Posthofbrug 5366,2023-09-02,02:00:00,38,11,27,FMN GV 16 Berchem TOT
54,Posthofbrug 5366,2023-09-02,03:00:00,28,11,17,FMN GV 16 Berchem TOT
54,Posthofbrug 5366,2023-09-02,04:00:00,18,9,9,FMN GV 16 Berchem TOT
54,Posthofbrug 5366,2023-09-02,05:00:00,23,12,11,FMN GV 16 Berchem TOT
54,Posthofbrug 5366,2023-09-02,06:00:00,21,11,10,FMN GV 16 Berchem TOT
54,Posthofbrug 5366,2023-09-02,07:00:00,60,41,19,FMN GV 16 Berchem TOT
54,Posthofbrug 5366,2023-09-02,08:00:00,86,52,34,FMN GV 16 Berchem TOT
54,Posthofbrug 5366,2023-09-02,09:00:00,147,112,35,FMN GV 16 Berchem TOT
54,Posthofbrug 5366,2023-09-02,10:00:00,206,139,67,FMN GV 16 Berchem TOT
54,Posthofbrug 5366,2023-09-02,11:00:00,186,121,65,FMN GV 16 Berchem TOT
54,Posthofbrug 5366,2023-09-02,12:00:00,243,154,89,FMN GV 16 Berchem TOT
54,Posthofbrug 5366,2023-09-02,13:00:00,313,184,129,FMN GV 16 Berchem TOT
54,Posthofbrug 5366,2023-09-02,14:00:00,328,175,153,FMN GV 16 Berchem TOT
54,Posthofbrug 5366,2023-09-02,15:00:00,255,138,117,FMN GV 16 Berchem TOT
54,Posthofbrug 5366,2023-09-02,16:00:00,284,139,145,FMN GV 16 Berchem TOT
54,Posthofbrug 5366,2023-09-02,17:00:00,282,138,144,FMN GV 16 Berchem TOT
54,Posthofbrug 5366,2023-09-02,18:00:00,224,115,109,FMN GV 16 Berchem TOT
54,Posthofbrug 5366,2023-09-02,19:00:00,202,112,90,FMN GV 16 Berchem TOT
54,Posthofbrug 5366,2023-09-02,20:00:00,164,75,89,FMN GV 16 Berchem TOT
54,Posthofbrug 5366,2023-09-02,21:00:00,111,60,51,FMN GV 16 Berchem TOT
54,Posthofbrug 5366,2023-09-02,22:00:00,133,66,67,FMN GV 16 Berchem TOT
54,Posthofbrug 5366,2023-09-02,23:00:00,86,28,58,FMN GV 16 Berchem TOT
54,Posthofbrug 5366,2023-09-03,00:00:00,77,25,52,FMN GV 16 Berchem TOT
54,Posthofbrug 5366,2023-09-03,01:00:00,74,34,40,FMN GV 16 Berchem TOT
54,Posthofbrug 5366,2023-09-03,02:00:00,43,13,30,FMN GV 16 Berchem TOT
54,Posthofbrug 5366,2023-09-03,03:00:00,26,9,17,FMN GV 16 Berchem TOT
54,Posthofbrug 5366,2023-09-03,04:00:00,21,9,12,FMN GV 16 Berchem TOT
54,Posthofbrug 5366,2023-09-03,05:00:00,25,7,18,FMN GV 16 Berchem TOT
54,Posthofbrug 5366,2023-09-03,06:00:00,16,12,4,FMN GV 16 Berchem TOT
54,Posthofbrug 5366,2023-09-03,07:00:00,35,24,11,FMN GV 16 Berchem TOT
54,Posthofbrug 5366,2023-09-03,08:00:00,72,39,33,FMN GV 16 Berchem TOT
54,Posthofbrug 5366,2023-09-03,09:00:00,124,85,39,FMN GV 16 Berchem TOT
54,Posthofbrug 5366,2023-09-03,10:00:00,253,182,71,FMN GV 16 Berchem TOT
54,Posthofbrug 5366,2023-09-03,11:00:00,248,139,109,FMN GV 16 Berchem TOT
54,Posthofbrug 5366,2023-09-03,12:00:00,266,158,108,FMN GV 16 Berchem TOT
54,Posthofbrug 5366,2023-09-03,13:00:00,318,175,143,FMN GV 16 Berchem TOT
54,Posthofbrug 5366,2023-09-03,14:00:00,323,211,112,FMN GV 16 Berchem TOT
54,Posthofbrug 5366,2023-09-03,15:00:00,328,172,156,FMN GV 16 Berchem TOT
54,Posthofbrug 5366,2023-09-03,16:00:00,281,162,119,FMN GV 16 Berchem TOT
54,Posthofbrug 5366,2023-09-03,17:00:00,273,135,138,FMN GV 16 Berchem TOT
54,Posthofbrug 5366,2023-09-03,18:00:00,279,148,131,FMN GV 16 Berchem TOT
54,Posthofbrug 5366,2023-09-03,19:00:00,188,88,100,FMN GV 16 Berchem TOT
54,Posthofbrug 5366,2023-09-03,20:00:00,145,64,81,FMN GV 16 Berchem TOT
54,Posthofbrug 5366,2023-09-03,21:00:00,157,54,103,FMN GV 16 Berchem TOT
54,Posthofbrug 5366,2023-09-03,22:00:00,70,28,42,FMN GV 16 Berchem TOT
54,Posthofbrug 5366,2023-09-03,23:00:00,32,12,20,FMN GV 16 Berchem TOT
54,Posthofbrug 5366,2023-09-04,00:00:00,19,3,16,FMN GV 16 Berchem TOT
54,Posthofbrug 5366,2023-09-04,01:00:00,4,1,3,FMN GV 16 Berchem TOT
54,Posthofbrug 5366,2023-09-04,02:00:00,7,1,6,FMN GV 16 Berchem TOT
54,Posthofbrug 5366,2023-09-04,03:00:00,5,1,4,FMN GV 16 Berchem TOT
54,Posthofbrug 5366,2023-09-04,04:00:00,19,13,6,FMN GV 16 Berchem TOT
54,Posthofbrug 5366,2023-09-04,05:00:00,32,26,6,FMN GV 16 Berchem TOT
54,Posthofbrug 5366,2023-09-04,06:00:00,156,122,34,FMN GV 16 Berchem TOT
54,Posthofbrug 5366,2023-09-04,07:00:00,605,476,129,FMN GV 16 Berchem TOT
54,Posthofbrug 5366,2023-09-04,08:00:00,1090,867,223,FMN GV 16 Berchem TOT
54,Posthofbrug 5366,2023-09-04,09:00:00,349,271,78,FMN GV 16 Berchem TOT
54,Posthofbrug 5366,2023-09-04,10:00:00,190,133,57,FMN GV 16 Berchem TOT
54,Posthofbrug 5366,2023-09-04,11:00:00,187,123,64,FMN GV 16 Berchem TOT
54,Posthofbrug 5366,2023-09-04,12:00:00,240,124,116,FMN GV 16 Berchem TOT
54,Posthofbrug 5366,2023-09-04,13:00:00,240,129,111,FMN GV 16 Berchem TOT
54,Posthofbrug 5366,2023-09-04,14:00:00,258,110,148,FMN GV 16 Berchem TOT
54,Posthofbrug 5366,2023-09-04,15:00:00,400,135,265,FMN GV 16 Berchem TOT
54,Posthofbrug 5366,2023-09-04,16:00:00,659,201,458,FMN GV 16 Berchem TOT
54,Posthofbrug 5366,2023-09-04,17:00:00,816,220,596,FMN GV 16 Berchem TOT
54,Posthofbrug 5366,2023-09-04,18:00:00,515,162,353,FMN GV 16 Berchem TOT
54,Posthofbrug 5366,2023-09-04,19:00:00,253,87,166,FMN GV 16 Berchem TOT
54,Posthofbrug 5366,2023-09-04,20:00:00,173,87,86,FMN GV 16 Berchem TOT
54,Posthofbrug 5366,2023-09-04,21:00:00,156,70,86,FMN GV 16 Berchem TOT
54,Posthofbrug 5366,2023-09-04,22:00:00,122,56,66,FMN GV 16 Berchem TOT
54,Posthofbrug 5366,2023-09-04,23:00:00,60,29,31,FMN GV 16 Berchem TOT
54,Posthofbrug 5366,2023-09-05,00:00:00,26,11,15,FMN GV 16 Berchem TOT
54,Posthofbrug 5366,2023-09-05,01:00:00,19,8,11,FMN GV 16 Berchem TOT
54,Posthofbrug 5366,2023-09-05,02:00:00,5,2,3,FMN GV 16 Berchem TOT
54,Posthofbrug 5366,2023-09-05,03:00:00,8,2,6,FMN GV 16 Berchem TOT
54,Posthofbrug 5366,2023-09-05,04:00:00,26,14,12,FMN GV 16 Berchem TOT
54,Posthofbrug 5366,2023-09-05,05:00:00,38,28,10,FMN GV 16 Berchem TOT
54,Posthofbrug 5366,2023-09-05,06:00:00,169,133,36,FMN GV 16 Berchem TOT
54,Posthofbrug 5366,2023-09-05,07:00:00,692,533,159,FMN GV 16 Berchem TOT
54,Posthofbrug 5366,2023-09-05,08:00:00,1201,968,233,FMN GV 16 Berchem TOT
54,Posthofbrug 5366,2023-09-05,09:00:00,374,274,100,FMN GV 16 Berchem TOT
54,Posthofbrug 5366,2023-09-05,10:00:00,171,116,55,FMN GV 16 Berchem TOT
54,Posthofbrug 5366,2023-09-05,11:00:00,177,98,79,FMN GV 16 Berchem TOT
54,Posthofbrug 5366,2023-09-05,12:00:00,243,144,99,FMN GV 16 Berchem TOT
54,Posthofbrug 5366,2023-09-05,13:00:00,242,120,122,FMN GV 16 Berchem TOT
54,Posthofbrug 5366,2023-09-05,14:00:00,222,94,128,FMN GV 16 Berchem TOT
54,Posthofbrug 5366,2023-09-05,15:00:00,359,114,245,FMN GV 16 Berchem TOT
54,Posthofbrug 5366,2023-09-05,16:00:00,734,214,520,FMN GV 16 Berchem TOT
54,Posthofbrug 5366,2023-09-05,17:00:00,906,276,630,FMN GV 16 Berchem TOT
54,Posthofbrug 5366,2023-09-05,18:00:00,546,181,365,FMN GV 16 Berchem TOT
54,Posthofbrug 5366,2023-09-05,19:00:00,302,121,181,FMN GV 16 Berchem TOT
54,Posthofbrug 5366,2023-09-05,20:00:00,198,95,103,FMN GV 16 Berchem TOT
54,Posthofbrug 5366,2023-09-05,21:00:00,194,88,106,FMN GV 16 Berchem TOT
54,Posthofbrug 5366,2023-09-05,22:00:00,147,48,99,FMN GV 16 Berchem TOT
54,Posthofbrug 5366,2023-09-05,23:00:00,95,45,50,FMN GV 16 Berchem TOT
54,Posthofbrug 5366,2023-09-06,00:00:00,27,8,19,FMN GV 16 Berchem TOT
54,Posthofbrug 5366,2023-09-06,01:00:00,15,1,14,FMN GV 16 Berchem TOT
54,Posthofbrug 5366,2023-09-06,02:00:00,13,1,12,FMN GV 16 Berchem TOT
54,Posthofbrug 5366,2023-09-06,03:00:00,11,5,6,FMN GV 16 Berchem TOT
54,Posthofbrug 5366,2023-09-06,04:00:00,19,13,6,FMN GV 16 Berchem TOT
54,Posthofbrug 5366,2023-09-06,05:00:00,43,37,6,FMN GV 16 Berchem TOT
54,Posthofbrug 5366,2023-09-06,06:00:00,149,105,44,FMN GV 16 Berchem TOT
54,Posthofbrug 5366,2023-09-06,07:00:00,552,425,127,FMN GV 16 Berchem TOT
54,Posthofbrug 5366,2023-09-06,08:00:00,908,717,191,FMN GV 16 Berchem TOT
54,Posthofbrug 5366,2023-09-06,09:00:00,367,256,111,FMN GV 16 Berchem TOT
54,Posthofbrug 5366,2023-09-06,10:00:00,173,108,65,FMN GV 16 Berchem TOT
54,Posthofbrug 5366,2023-09-06,11:00:00,208,121,87,FMN GV 16 Berchem TOT
54,Posthofbrug 5366,2023-09-06,12:00:00,417,190,227,FMN GV 16 Berchem TOT
54,Posthofbrug 5366,2023-09-06,13:00:00,348,155,193,FMN GV 16 Berchem TOT
54,Posthofbrug 5366,2023-09-06,14:00:00,281,134,147,FMN GV 16 Berchem TOT
54,Posthofbrug 5366,2023-09-06,15:00:00,313,122,191,FMN GV 16 Berchem TOT
54,Posthofbrug 5366,2023-09-06,16:00:00,516,190,326,FMN GV 16 Berchem TOT
54,Posthofbrug 5366,2023-09-06,17:00:00,646,220,426,FMN GV 16 Berchem TOT
54,Posthofbrug 5366,2023-09-06,18:00:00,507,213,294,FMN GV 16 Berchem TOT
54,Posthofbrug 5366,2023-09-06,19:00:00,284,118,166,FMN GV 16 Berchem TOT
54,Posthofbrug 5366,2023-09-06,20:00:00,254,137,117,FMN GV 16 Berchem TOT
54,Posthofbrug 5366,2023-09-06,21:00:00,175,66,109,FMN GV 16 Berchem TOT
54,Posthofbrug 5366,2023-09-06,22:00:00,146,47,99,FMN GV 16 Berchem TOT
54,Posthofbrug 5366,2023-09-06,23:00:00,91,29,62,FMN GV 16 Berchem TOT
54,Posthofbrug 5366,2023-09-07,00:00:00,28,11,17,FMN GV 16 Berchem TOT
54,Posthofbrug 5366,2023-09-07,01:00:00,22,4,18,FMN GV 16 Berchem TOT
54,Posthofbrug 5366,2023-09-07,02:00:00,8,1,7,FMN GV 16 Berchem TOT
54,Posthofbrug 5366,2023-09-07,03:00:00,5,2,3,FMN GV 16 Berchem TOT
54,Posthofbrug 5366,2023-09-07,04:00:00,20,12,8,FMN GV 16 Berchem TOT
54,Posthofbrug 5366,2023-09-07,05:00:00,46,26,20,FMN GV 16 Berchem TOT
54,Posthofbrug 5366,2023-09-07,06:00:00,186,144,42,FMN GV 16 Berchem TOT
54,Posthofbrug 5366,2023-09-07,07:00:00,683,517,166,FMN GV 16 Berchem TOT
54,Posthofbrug 5366,2023-09-07,08:00:00,1086,851,235,FMN GV 16 Berchem TOT
54,Posthofbrug 5366,2023-09-07,09:00:00,371,288,83,FMN GV 16 Berchem TOT
54,Posthofbrug 5366,2023-09-07,10:00:00,163,113,50,FMN GV 16 Berchem TOT
54,Posthofbrug 5366,2023-09-07,11:00:00,204,140,64,FMN GV 16 Berchem TOT
54,Posthofbrug 5366,2023-09-07,12:00:00,244,145,99,FMN GV 16 Berchem TOT
54,Posthofbrug 5366,2023-09-07,13:00:00,265,134,131,FMN GV 16 Berchem TOT
54,Posthofbrug 5366,2023-09-07,14:00:00,241,106,135,FMN GV 16 Berchem TOT
54,Posthofbrug 5366,2023-09-07,15:00:00,396,128,268,FMN GV 16 Berchem TOT
54,Posthofbrug 5366,2023-09-07,16:00:00,692,204,488,FMN GV 16 Berchem TOT
54,Posthofbrug 5366,2023-09-07,17:00:00,836,257,579,FMN GV 16 Berchem TOT
54,Posthofbrug 5366,2023-09-07,18:00:00,500,171,329,FMN GV 16 Berchem TOT
54,Posthofbrug 5366,2023-09-07,19:00:00,337,137,200,FMN GV 16 Berchem TOT
54,Posthofbrug 5366,2023-09-07,20:00:00,263,145,118,FMN GV 16 Berchem TOT
54,Posthofbrug 5366,2023-09-07,21:00:00,231,110,121,FMN GV 16 Berchem TOT
54,Posthofbrug 5366,2023-09-07,22:00:00,172,69,103,FMN GV 16 Berchem TOT
54,Posthofbrug 5366,2023-09-07,23:00:00,124,31,93,FMN GV 16 Berchem TOT
54,Posthofbrug 5366,2023-09-08,00:00:00,58,18,40,FMN GV 16 Berchem TOT
54,Posthofbrug 5366,2023-09-08,01:00:00,28,7,21,FMN GV 16 Berchem TOT
54,Posthofbrug 5366,2023-09-08,02:00:00,7,1,6,FMN GV 16 Berchem TOT
54,Posthofbrug 5366,2023-09-08,03:00:00,5,1,4,FMN GV 16 Berchem TOT
54,Posthofbrug 5366,2023-09-08,04:00:00,33,16,17,FMN GV 16 Berchem TOT
54,Posthofbrug 5366,2023-09-08,05:00:00,37,24,13,FMN GV 16 Berchem TOT
54,Posthofbrug 5366,2023-09-08,06:00:00,138,99,39,FMN GV 16 Berchem TOT
54,Posthofbrug 5366,2023-09-08,07:00:00,511,382,129,FMN GV 16 Berchem TOT
54,Posthofbrug 5366,2023-09-08,08:00:00,808,631,177,FMN GV 16 Berchem TOT
54,Posthofbrug 5366,2023-09-08,09:00:00,331,266,65,FMN GV 16 Berchem TOT
54,Posthofbrug 5366,2023-09-08,10:00:00,191,132,59,FMN GV 16 Berchem TOT
54,Posthofbrug 5366,2023-09-08,11:00:00,201,116,85,FMN GV 16 Berchem TOT
54,Posthofbrug 5366,2023-09-08,12:00:00,263,132,131,FMN GV 16 Berchem TOT
54,Posthofbrug 5366,2023-09-08,13:00:00,245,118,127,FMN GV 16 Berchem TOT
54,Posthofbrug 5366,2023-09-08,14:00:00,256,108,148,FMN GV 16 Berchem TOT
54,Posthofbrug 5366,2023-09-08,15:00:00,402,145,257,FMN GV 16 Berchem TOT
54,Posthofbrug 5366,2023-09-08,16:00:00,557,197,360,FMN GV 16 Berchem TOT
54,Posthofbrug 5366,2023-09-08,17:00:00,585,201,384,FMN GV 16 Berchem TOT
54,Posthofbrug 5366,2023-09-08,18:00:00,365,174,191,FMN GV 16 Berchem TOT
54,Posthofbrug 5366,2023-09-08,19:00:00,273,151,122,FMN GV 16 Berchem TOT
54,Posthofbrug 5366,2023-09-08,20:00:00,197,107,90,FMN GV 16 Berchem TOT
54,Posthofbrug 5366,2023-09-08,21:00:00,167,69,98,FMN GV 16 Berchem TOT
54,Posthofbrug 5366,2023-09-08,22:00:00,169,47,122,FMN GV 16 Berchem TOT
54,Posthofbrug 5366,2023-09-08,23:00:00,135,34,101,FMN GV 16 Berchem TOT
54,Posthofbrug 5366,2023-09-09,00:00:00,91,28,63,FMN GV 16 Berchem TOT
54,Posthofbrug 5366,2023-09-09,01:00:00,82,30,52,FMN GV 16 Berchem TOT
54,Posthofbrug 5366,2023-09-09,02:00:00,63,24,39,FMN GV 16 Berchem TOT
54,Posthofbrug 5366,2023-09-09,03:00:00,51,22,29,FMN GV 16 Berchem TOT
54,Posthofbrug 5366,2023-09-09,04:00:00,26,12,14,FMN GV 16 Berchem TOT
54,Posthofbrug 5366,2023-09-09,05:00:00,27,11,16,FMN GV 16 Berchem TOT
54,Posthofbrug 5366,2023-09-09,06:00:00,30,17,13,FMN GV 16 Berchem TOT
54,Posthofbrug 5366,2023-09-09,07:00:00,61,33,28,FMN GV 16 Berchem TOT
54,Posthofbrug 5366,2023-09-09,08:00:00,122,79,43,FMN GV 16 Berchem TOT
54,Posthofbrug 5366,2023-09-09,09:00:00,232,140,92,FMN GV 16 Berchem TOT
54,Posthofbrug 5366,2023-09-09,10:00:00,210,151,59,FMN GV 16 Berchem TOT
54,Posthofbrug 5366,2023-09-09,11:00:00,207,109,98,FMN GV 16 Berchem TOT
54,Posthofbrug 5366,2023-09-09,12:00:00,251,142,109,FMN GV 16 Berchem TOT
54,Posthofbrug 5366,2023-09-09,13:00:00,254,151,103,FMN GV 16 Berchem TOT
54,Posthofbrug 5366,2023-09-09,14:00:00,239,137,102,FMN GV 16 Berchem TOT
54,Posthofbrug 5366,2023-09-09,15:00:00,233,137,96,FMN GV 16 Berchem TOT
54,Posthofbrug 5366,2023-09-09,16:00:00,228,108,120,FMN GV 16 Berchem TOT
54,Posthofbrug 5366,2023-09-09,17:00:00,252,123,129,FMN GV 16 Berchem TOT
54,Posthofbrug 5366,2023-09-09,18:00:00,256,116,140,FMN GV 16 Berchem TOT
54,Posthofbrug 5366,2023-09-09,19:00:00,181,107,74,FMN GV 16 Berchem TOT
54,Posthofbrug 5366,2023-09-09,20:00:00,163,72,91,FMN GV 16 Berchem TOT
54,Posthofbrug 5366,2023-09-09,21:00:00,145,72,73,FMN GV 16 Berchem TOT
54,Posthofbrug 5366,2023-09-09,22:00:00,118,43,75,FMN GV 16 Berchem TOT
54,Posthofbrug 5366,2023-09-09,23:00:00,103,28,75,FMN GV 16 Berchem TOT
54,Posthofbrug 5366,2023-09-10,00:00:00,103,41,62,FMN GV 16 Berchem TOT
54,Posthofbrug 5366,2023-09-10,01:00:00,66,18,48,FMN GV 16 Berchem TOT
54,Posthofbrug 5366,2023-09-10,02:00:00,37,12,25,FMN GV 16 Berchem TOT
54,Posthofbrug 5366,2023-09-10,03:00:00,26,7,19,FMN GV 16 Berchem TOT
54,Posthofbrug 5366,2023-09-10,04:00:00,14,2,12,FMN GV 16 Berchem TOT
54,Posthofbrug 5366,2023-09-10,05:00:00,15,9,6,FMN GV 16 Berchem TOT
54,Posthofbrug 5366,2023-09-10,06:00:00,26,15,11,FMN GV 16 Berchem TOT
54,Posthofbrug 5366,2023-09-10,07:00:00,42,24,18,FMN GV 16 Berchem TOT
54,Posthofbrug 5366,2023-09-10,08:00:00,97,52,45,FMN GV 16 Berchem TOT
54,Posthofbrug 5366,2023-09-10,09:00:00,165,106,59,FMN GV 16 Berchem TOT
54,Posthofbrug 5366,2023-09-10,10:00:00,248,164,84,FMN GV 16 Berchem TOT
54,Posthofbrug 5366,2023-09-10,11:00:00,255,154,101,FMN GV 16 Berchem TOT
54,Posthofbrug 5366,2023-09-10,12:00:00,291,185,106,FMN GV 16 Berchem TOT
54,Posthofbrug 5366,2023-09-10,13:00:00,200,76,124,FMN GV 16 Berchem TOT
54,Posthofbrug 5366,2023-09-10,14:00:00,133,14,119,FMN GV 16 Berchem TOT
54,Posthofbrug 5366,2023-09-10,15:00:00,85,11,74,FMN GV 16 Berchem TOT
54,Posthofbrug 5366,2023-09-10,16:00:00,240,84,156,FMN GV 16 Berchem TOT
54,Posthofbrug 5366,2023-09-10,17:00:00,245,94,151,FMN GV 16 Berchem TOT
54,Posthofbrug 5366,2023-09-10,18:00:00,235,115,120,FMN GV 16 Berchem TOT
54,Posthofbrug 5366,2023-09-10,19:00:00,154,78,76,FMN GV 16 Berchem TOT
54,Posthofbrug 5366,2023-09-10,20:00:00,143,72,71,FMN GV 16 Berchem TOT
54,Posthofbrug 5366,2023-09-10,21:00:00,125,47,78,FMN GV 16 Berchem TOT
54,Posthofbrug 5366,2023-09-10,22:00:00,94,44,50,FMN GV 16 Berchem TOT
54,Posthofbrug 5366,2023-09-10,23:00:00,43,9,34,FMN GV 16 Berchem TOT
54,Posthofbrug 5366,2023-09-11,00:00:00,23,6,17,FMN GV 16 Berchem TOT
54,Posthofbrug 5366,2023-09-11,01:00:00,5,2,3,FMN GV 16 Berchem TOT
54,Posthofbrug 5366,2023-09-11,02:00:00,5,0,5,FMN GV 16 Berchem TOT
54,Posthofbrug 5366,2023-09-11,03:00:00,4,1,3,FMN GV 16 Berchem TOT
54,Posthofbrug 5366,2023-09-11,04:00:00,17,11,6,FMN GV 16 Berchem TOT
54,Posthofbrug 5366,2023-09-11,05:00:00,32,24,8,FMN GV 16 Berchem TOT
54,Posthofbrug 5366,2023-09-11,06:00:00,150,110,40,FMN GV 16 Berchem TOT
54,Posthofbrug 5366,2023-09-11,07:00:00,600,457,143,FMN GV 16 Berchem TOT
54,Posthofbrug 5366,2023-09-11,08:00:00,1022,805,217,FMN GV 16 Berchem TOT
54,Posthofbrug 5366,2023-09-11,09:00:00,338,253,85,FMN GV 16 Berchem TOT
54,Posthofbrug 5366,2023-09-11,10:00:00,165,113,52,FMN GV 16 Berchem TOT
54,Posthofbrug 5366,2023-09-11,11:00:00,170,108,62,FMN GV 16 Berchem TOT
54,Posthofbrug 5366,2023-09-11,12:00:00,203,133,70,FMN GV 16 Berchem TOT
54,Posthofbrug 5366,2023-09-11,13:00:00,187,92,95,FMN GV 16 Berchem TOT
54,Posthofbrug 5366,2023-09-11,14:00:00,183,69,114,FMN GV 16 Berchem TOT
54,Posthofbrug 5366,2023-09-11,15:00:00,396,144,252,FMN GV 16 Berchem TOT
54,Posthofbrug 5366,2023-09-11,16:00:00,645,174,471,FMN GV 16 Berchem TOT
54,Posthofbrug 5366,2023-09-11,17:00:00,741,210,531,FMN GV 16 Berchem TOT
54,Posthofbrug 5366,2023-09-11,18:00:00,459,133,326,FMN GV 16 Berchem TOT
54,Posthofbrug 5366,2023-09-11,19:00:00,241,91,150,FMN GV 16 Berchem TOT
54,Posthofbrug 5366,2023-09-11,20:00:00,157,79,78,FMN GV 16 Berchem TOT
54,Posthofbrug 5366,2023-09-11,21:00:00,138,54,84,FMN GV 16 Berchem TOT
54,Posthofbrug 5366,2023-09-11,22:00:00,109,47,62,FMN GV 16 Berchem TOT
54,Posthofbrug 5366,2023-09-11,23:00:00,32,15,17,FMN GV 16 Berchem TOT
54,Posthofbrug 5366,2023-09-12,00:00:00,17,3,14,FMN GV 16 Berchem TOT
54,Posthofbrug 5366,2023-09-12,01:00:00,6,0,6,FMN GV 16 Berchem TOT
54,Posthofbrug 5366,2023-09-12,02:00:00,2,0,2,FMN GV 16 Berchem TOT
54,Posthofbrug 5366,2023-09-12,03:00:00,0,0,0,FMN GV 16 Berchem TOT
54,Posthofbrug 5366,2023-09-12,04:00:00,14,10,4,FMN GV 16 Berchem TOT
54,Posthofbrug 5366,2023-09-12,05:00:00,44,33,11,FMN GV 16 Berchem TOT
54,Posthofbrug 5366,2023-09-12,06:00:00,151,121,30,FMN GV 16 Berchem TOT
54,Posthofbrug 5366,2023-09-12,07:00:00,621,478,143,FMN GV 16 Berchem TOT
54,Posthofbrug 5366,2023-09-12,08:00:00,1032,807,225,FMN GV 16 Berchem TOT
54,Posthofbrug 5366,2023-09-12,09:00:00,338,267,71,FMN GV 16 Berchem TOT
54,Posthofbrug 5366,2023-09-12,10:00:00,152,104,48,FMN GV 16 Berchem TOT
54,Posthofbrug 5366,2023-09-12,11:00:00,128,77,51,FMN GV 16 Berchem TOT
54,Posthofbrug 5366,2023-09-12,12:00:00,212,112,100,FMN GV 16 Berchem TOT
54,Posthofbrug 5366,2023-09-12,13:00:00,212,102,110,FMN GV 16 Berchem TOT
54,Posthofbrug 5366,2023-09-12,14:00:00,205,91,114,FMN GV 16 Berchem TOT
54,Posthofbrug 5366,2023-09-12,15:00:00,341,121,220,FMN GV 16 Berchem TOT
54,Posthofbrug 5366,2023-09-12,16:00:00,659,213,446,FMN GV 16 Berchem TOT
54,Posthofbrug 5366,2023-09-12,17:00:00,816,232,584,FMN GV 16 Berchem TOT
54,Posthofbrug 5366,2023-09-12,18:00:00,482,158,324,FMN GV 16 Berchem TOT
54,Posthofbrug 5366,2023-09-12,19:00:00,228,94,134,FMN GV 16 Berchem TOT
54,Posthofbrug 5366,2023-09-12,20:00:00,167,78,89,FMN GV 16 Berchem TOT
54,Posthofbrug 5366,2023-09-12,21:00:00,134,53,81,FMN GV 16 Berchem TOT
54,Posthofbrug 5366,2023-09-12,22:00:00,106,35,71,FMN GV 16 Berchem TOT
54,Posthofbrug 5366,2023-09-12,23:00:00,50,19,31,FMN GV 16 Berchem TOT
54,Posthofbrug 5366,2023-09-13,00:00:00,20,8,12,FMN GV 16 Berchem TOT
54,Posthofbrug 5366,2023-09-13,01:00:00,11,3,8,FMN GV 16 Berchem TOT
54,Posthofbrug 5366,2023-09-13,02:00:00,3,0,3,FMN GV 16 Berchem TOT
54,Posthofbrug 5366,2023-09-13,03:00:00,7,4,3,FMN GV 16 Berchem TOT
54,Posthofbrug 5366,2023-09-13,04:00:00,10,8,2,FMN GV 16 Berchem TOT
54,Posthofbrug 5366,2023-09-13,05:00:00,36,28,8,FMN GV 16 Berchem TOT
54,Posthofbrug 5366,2023-09-13,06:00:00,132,108,24,FMN GV 16 Berchem TOT
54,Posthofbrug 5366,2023-09-13,07:00:00,512,391,121,FMN GV 16 Berchem TOT
54,Posthofbrug 5366,2023-09-13,08:00:00,890,669,221,FMN GV 16 Berchem TOT
54,Posthofbrug 5366,2023-09-13,09:00:00,290,227,63,FMN GV 16 Berchem TOT
54,Posthofbrug 5366,2023-09-13,10:00:00,146,96,50,FMN GV 16 Berchem TOT
54,Posthofbrug 5366,2023-09-13,11:00:00,175,91,84,FMN GV 16 Berchem TOT
54,Posthofbrug 5366,2023-09-13,12:00:00,373,160,213,FMN GV 16 Berchem TOT
54,Posthofbrug 5366,2023-09-13,13:00:00,283,114,169,FMN GV 16 Berchem TOT
54,Posthofbrug 5366,2023-09-13,14:00:00,209,102,107,FMN GV 16 Berchem TOT
54,Posthofbrug 5366,2023-09-13,15:00:00,271,124,147,FMN GV 16 Berchem TOT
54,Posthofbrug 5366,2023-09-13,16:00:00,455,156,299,FMN GV 16 Berchem TOT
54,Posthofbrug 5366,2023-09-13,17:00:00,646,226,420,FMN GV 16 Berchem TOT
54,Posthofbrug 5366,2023-09-13,18:00:00,439,163,276,FMN GV 16 Berchem TOT
54,Posthofbrug 5366,2023-09-13,19:00:00,264,125,139,FMN GV 16 Berchem TOT
54,Posthofbrug 5366,2023-09-13,20:00:00,157,72,85,FMN GV 16 Berchem TOT
54,Posthofbrug 5366,2023-09-13,21:00:00,169,62,107,FMN GV 16 Berchem TOT
54,Posthofbrug 5366,2023-09-13,22:00:00,139,52,87,FMN GV 16 Berchem TOT
54,Posthofbrug 5366,2023-09-13,23:00:00,62,20,42,FMN GV 16 Berchem TOT
54,Posthofbrug 5366,2023-09-14,00:00:00,39,12,27,FMN GV 16 Berchem TOT
54,Posthofbrug 5366,2023-09-14,01:00:00,13,2,11,FMN GV 16 Berchem TOT
54,Posthofbrug 5366,2023-09-14,02:00:00,17,2,15,FMN GV 16 Berchem TOT
54,Posthofbrug 5366,2023-09-14,03:00:00,4,1,3,FMN GV 16 Berchem TOT
54,Posthofbrug 5366,2023-09-14,04:00:00,18,12,6,FMN GV 16 Berchem TOT
54,Posthofbrug 5366,2023-09-14,05:00:00,39,31,8,FMN GV 16 Berchem TOT
54,Posthofbrug 5366,2023-09-14,06:00:00,163,132,31,FMN GV 16 Berchem TOT
54,Posthofbrug 5366,2023-09-14,07:00:00,604,472,132,FMN GV 16 Berchem TOT
54,Posthofbrug 5366,2023-09-14,08:00:00,1116,890,226,FMN GV 16 Berchem TOT
54,Posthofbrug 5366,2023-09-14,09:00:00,318,243,75,FMN GV 16 Berchem TOT
54,Posthofbrug 5366,2023-09-14,10:00:00,162,116,46,FMN GV 16 Berchem TOT
54,Posthofbrug 5366,2023-09-14,11:00:00,194,126,68,FMN GV 16 Berchem TOT
54,Posthofbrug 5366,2023-09-14,12:00:00,252,144,108,FMN GV 16 Berchem TOT
54,Posthofbrug 5366,2023-09-14,13:00:00,227,123,104,FMN GV 16 Berchem TOT
54,Posthofbrug 5366,2023-09-14,14:00:00,235,111,124,FMN GV 16 Berchem TOT
54,Posthofbrug 5366,2023-09-14,15:00:00,351,126,225,FMN GV 16 Berchem TOT
54,Posthofbrug 5366,2023-09-14,16:00:00,653,173,480,FMN GV 16 Berchem TOT
54,Posthofbrug 5366,2023-09-14,17:00:00,813,226,587,FMN GV 16 Berchem TOT
54,Posthofbrug 5366,2023-09-14,18:00:00,504,168,336,FMN GV 16 Berchem TOT
54,Posthofbrug 5366,2023-09-14,19:00:00,309,149,160,FMN GV 16 Berchem TOT
54,Posthofbrug 5366,2023-09-14,20:00:00,214,103,111,FMN GV 16 Berchem TOT
54,Posthofbrug 5366,2023-09-14,21:00:00,169,50,119,FMN GV 16 Berchem TOT
54,Posthofbrug 5366,2023-09-14,22:00:00,169,58,111,FMN GV 16 Berchem TOT
54,Posthofbrug 5366,2023-09-14,23:00:00,77,18,59,FMN GV 16 Berchem TOT
54,Posthofbrug 5366,2023-09-15,00:00:00,32,2,30,FMN GV 16 Berchem TOT
54,Posthofbrug 5366,2023-09-15,01:00:00,15,1,14,FMN GV 16 Berchem TOT
54,Posthofbrug 5366,2023-09-15,02:00:00,7,1,6,FMN GV 16 Berchem TOT
54,Posthofbrug 5366,2023-09-15,03:00:00,7,2,5,FMN GV 16 Berchem TOT
54,Posthofbrug 5366,2023-09-15,04:00:00,17,7,10,FMN GV 16 Berchem TOT
54,Posthofbrug 5366,2023-09-15,05:00:00,37,28,9,FMN GV 16 Berchem TOT
54,Posthofbrug 5366,2023-09-15,06:00:00,135,103,32,FMN GV 16 Berchem TOT
54,Posthofbrug 5366,2023-09-15,07:00:00,462,363,99,FMN GV 16 Berchem TOT
54,Posthofbrug 5366,2023-09-15,08:00:00,845,646,199,FMN GV 16 Berchem TOT
54,Posthofbrug 5366,2023-09-15,09:00:00,304,233,71,FMN GV 16 Berchem TOT
54,Posthofbrug 5366,2023-09-15,10:00:00,185,128,57,FMN GV 16 Berchem TOT
54,Posthofbrug 5366,2023-09-15,11:00:00,185,110,75,FMN GV 16 Berchem TOT
54,Posthofbrug 5366,2023-09-15,12:00:00,227,111,116,FMN GV 16 Berchem TOT
54,Posthofbrug 5366,2023-09-15,13:00:00,246,117,129,FMN GV 16 Berchem TOT
54,Posthofbrug 5366,2023-09-15,14:00:00,252,100,152,FMN GV 16 Berchem TOT
54,Posthofbrug 5366,2023-09-15,15:00:00,367,147,220,FMN GV 16 Berchem TOT
54,Posthofbrug 5366,2023-09-15,16:00:00,563,153,410,FMN GV 16 Berchem TOT
54,Posthofbrug 5366,2023-09-15,17:00:00,574,208,366,FMN GV 16 Berchem TOT
54,Posthofbrug 5366,2023-09-15,18:00:00,457,207,250,FMN GV 16 Berchem TOT
54,Posthofbrug 5366,2023-09-15,19:00:00,284,153,131,FMN GV 16 Berchem TOT
54,Posthofbrug 5366,2023-09-15,20:00:00,198,114,84,FMN GV 16 Berchem TOT
54,Posthofbrug 5366,2023-09-15,21:00:00,118,58,60,FMN GV 16 Berchem TOT
54,Posthofbrug 5366,2023-09-15,22:00:00,120,34,86,FMN GV 16 Berchem TOT
54,Posthofbrug 5366,2023-09-15,23:00:00,132,30,102,FMN GV 16 Berchem TOT
54,Posthofbrug 5366,2023-09-16,00:00:00,94,25,69,FMN GV 16 Berchem TOT
54,Posthofbrug 5366,2023-09-16,01:00:00,51,9,42,FMN GV 16 Berchem TOT
54,Posthofbrug 5366,2023-09-16,02:00:00,25,3,22,FMN GV 16 Berchem TOT
54,Posthofbrug 5366,2023-09-16,03:00:00,22,3,19,FMN GV 16 Berchem TOT
54,Posthofbrug 5366,2023-09-16,04:00:00,26,6,20,FMN GV 16 Berchem TOT
54,Posthofbrug 5366,2023-09-16,05:00:00,24,13,11,FMN GV 16 Berchem TOT
54,Posthofbrug 5366,2023-09-16,06:00:00,35,18,17,FMN GV 16 Berchem TOT
54,Posthofbrug 5366,2023-09-16,07:00:00,62,36,26,FMN GV 16 Berchem TOT
54,Posthofbrug 5366,2023-09-16,08:00:00,99,56,43,FMN GV 16 Berchem TOT
54,Posthofbrug 5366,2023-09-16,09:00:00,224,143,81,FMN GV 16 Berchem TOT
54,Posthofbrug 5366,2023-09-16,10:00:00,212,143,69,FMN GV 16 Berchem TOT
54,Posthofbrug 5366,2023-09-16,11:00:00,192,106,86,FMN GV 16 Berchem TOT
54,Posthofbrug 5366,2023-09-16,12:00:00,259,139,120,FMN GV 16 Berchem TOT
54,Posthofbrug 5366,2023-09-16,13:00:00,253,136,117,FMN GV 16 Berchem TOT
54,Posthofbrug 5366,2023-09-16,14:00:00,265,157,108,FMN GV 16 Berchem TOT
54,Posthofbrug 5366,2023-09-16,15:00:00,267,152,115,FMN GV 16 Berchem TOT
54,Posthofbrug 5366,2023-09-16,16:00:00,255,110,145,FMN GV 16 Berchem TOT
54,Posthofbrug 5366,2023-09-16,17:00:00,313,153,160,FMN GV 16 Berchem TOT
54,Posthofbrug 5366,2023-09-16,18:00:00,245,130,115,FMN GV 16 Berchem TOT
54,Posthofbrug 5366,2023-09-16,19:00:00,193,96,97,FMN GV 16 Berchem TOT
54,Posthofbrug 5366,2023-09-16,20:00:00,137,78,59,FMN GV 16 Berchem TOT
54,Posthofbrug 5366,2023-09-16,21:00:00,92,46,46,FMN GV 16 Berchem TOT
54,Posthofbrug 5366,2023-09-16,22:00:00,105,34,71,FMN GV 16 Berchem TOT
54,Posthofbrug 5366,2023-09-16,23:00:00,96,36,60,FMN GV 16 Berchem TOT
54,Posthofbrug 5366,2023-09-17,00:00:00,78,37,41,FMN GV 16 Berchem TOT
54,Posthofbrug 5366,2023-09-17,01:00:00,50,18,32,FMN GV 16 Berchem TOT
54,Posthofbrug 5366,2023-09-17,02:00:00,27,7,20,FMN GV 16 Berchem TOT
54,Posthofbrug 5366,2023-09-17,03:00:00,28,13,15,FMN GV 16 Berchem TOT
54,Posthofbrug 5366,2023-09-17,04:00:00,11,5,6,FMN GV 16 Berchem TOT
54,Posthofbrug 5366,2023-09-17,05:00:00,17,7,10,FMN GV 16 Berchem TOT
54,Posthofbrug 5366,2023-09-17,06:00:00,23,18,5,FMN GV 16 Berchem TOT
54,Posthofbrug 5366,2023-09-17,07:00:00,51,25,26,FMN GV 16 Berchem TOT
54,Posthofbrug 5366,2023-09-17,08:00:00,64,43,21,FMN GV 16 Berchem TOT
54,Posthofbrug 5366,2023-09-17,09:00:00,160,97,63,FMN GV 16 Berchem TOT
54,Posthofbrug 5366,2023-09-17,10:00:00,193,148,45,FMN GV 16 Berchem TOT
54,Posthofbrug 5366,2023-09-17,11:00:00,190,128,62,FMN GV 16 Berchem TOT
54,Posthofbrug 5366,2023-09-17,12:00:00,247,140,107,FMN GV 16 Berchem TOT
54,Posthofbrug 5366,2023-09-17,13:00:00,344,204,140,FMN GV 16 Berchem TOT
54,Posthofbrug 5366,2023-09-17,14:00:00,347,236,111,FMN GV 16 Berchem TOT
54,Posthofbrug 5366,2023-09-17,15:00:00,286,168,118,FMN GV 16 Berchem TOT
54,Posthofbrug 5366,2023-09-17,16:00:00,279,114,165,FMN GV 16 Berchem TOT
54,Posthofbrug 5366,2023-09-17,17:00:00,281,101,180,FMN GV 16 Berchem TOT
54,Posthofbrug 5366,2023-09-17,18:00:00,211,83,128,FMN GV 16 Berchem TOT
54,Posthofbrug 5366,2023-09-17,19:00:00,142,55,87,FMN GV 16 Berchem TOT
54,Posthofbrug 5366,2023-09-17,20:00:00,125,63,62,FMN GV 16 Berchem TOT
54,Posthofbrug 5366,2023-09-17,21:00:00,89,36,53,FMN GV 16 Berchem TOT
54,Posthofbrug 5366,2023-09-17,22:00:00,51,20,31,FMN GV 16 Berchem TOT
54,Posthofbrug 5366,2023-09-17,23:00:00,23,8,15,FMN GV 16 Berchem TOT
54,Posthofbrug 5366,2023-09-18,00:00:00,17,3,14,FMN GV 16 Berchem TOT
54,Posthofbrug 5366,2023-09-18,01:00:00,4,1,3,FMN GV 16 Berchem TOT
54,Posthofbrug 5366,2023-09-18,02:00:00,6,1,5,FMN GV 16 Berchem TOT
54,Posthofbrug 5366,2023-09-18,03:00:00,1,0,1,FMN GV 16 Berchem TOT
54,Posthofbrug 5366,2023-09-18,04:00:00,13,10,3,FMN GV 16 Berchem TOT
54,Posthofbrug 5366,2023-09-18,05:00:00,30,24,6,FMN GV 16 Berchem TOT
54,Posthofbrug 5366,2023-09-18,06:00:00,130,101,29,FMN GV 16 Berchem TOT
54,Posthofbrug 5366,2023-09-18,07:00:00,516,389,127,FMN GV 16 Berchem TOT
54,Posthofbrug 5366,2023-09-18,08:00:00,963,773,190,FMN GV 16 Berchem TOT
54,Posthofbrug 5366,2023-09-18,09:00:00,310,243,67,FMN GV 16 Berchem TOT
54,Posthofbrug 5366,2023-09-18,10:00:00,166,115,51,FMN GV 16 Berchem TOT
54,Posthofbrug 5366,2023-09-18,11:00:00,162,99,63,FMN GV 16 Berchem TOT
54,Posthofbrug 5366,2023-09-18,12:00:00,196,96,100,FMN GV 16 Berchem TOT
54,Posthofbrug 5366,2023-09-18,13:00:00,152,75,77,FMN GV 16 Berchem TOT
54,Posthofbrug 5366,2023-09-18,14:00:00,165,69,96,FMN GV 16 Berchem TOT
54,Posthofbrug 5366,2023-09-18,15:00:00,342,116,226,FMN GV 16 Berchem TOT
54,Posthofbrug 5366,2023-09-18,16:00:00,482,129,353,FMN GV 16 Berchem TOT
54,Posthofbrug 5366,2023-09-18,17:00:00,751,202,549,FMN GV 16 Berchem TOT
54,Posthofbrug 5366,2023-09-18,18:00:00,448,135,313,FMN GV 16 Berchem TOT
54,Posthofbrug 5366,2023-09-18,19:00:00,193,76,117,FMN GV 16 Berchem TOT
54,Posthofbrug 5366,2023-09-18,20:00:00,150,67,83,FMN GV 16 Berchem TOT
54,Posthofbrug 5366,2023-09-18,21:00:00,100,49,51,FMN GV 16 Berchem TOT
54,Posthofbrug 5366,2023-09-18,22:00:00,136,61,75,FMN GV 16 Berchem TOT
54,Posthofbrug 5366,2023-09-18,23:00:00,45,16,29,FMN GV 16 Berchem TOT
54,Posthofbrug 5366,2023-09-19,00:00:00,12,5,7,FMN GV 16 Berchem TOT
54,Posthofbrug 5366,2023-09-19,01:00:00,6,0,6,FMN GV 16 Berchem TOT
54,Posthofbrug 5366,2023-09-19,02:00:00,7,0,7,FMN GV 16 Berchem TOT
54,Posthofbrug 5366,2023-09-19,03:00:00,3,1,2,FMN GV 16 Berchem TOT
54,Posthofbrug 5366,2023-09-19,04:00:00,15,12,3,FMN GV 16 Berchem TOT
54,Posthofbrug 5366,2023-09-19,05:00:00,42,32,10,FMN GV 16 Berchem TOT
54,Posthofbrug 5366,2023-09-19,06:00:00,171,135,36,FMN GV 16 Berchem TOT
54,Posthofbrug 5366,2023-09-19,07:00:00,598,471,127,FMN GV 16 Berchem TOT
54,Posthofbrug 5366,2023-09-19,08:00:00,1084,874,210,FMN GV 16 Berchem TOT
54,Posthofbrug 5366,2023-09-19,09:00:00,311,255,56,FMN GV 16 Berchem TOT
54,Posthofbrug 5366,2023-09-19,10:00:00,173,112,61,FMN GV 16 Berchem TOT
54,Posthofbrug 5366,2023-09-19,11:00:00,163,103,60,FMN GV 16 Berchem TOT
54,Posthofbrug 5366,2023-09-19,12:00:00,218,112,106,FMN GV 16 Berchem TOT
54,Posthofbrug 5366,2023-09-19,13:00:00,180,86,94,FMN GV 16 Berchem TOT
54,Posthofbrug 5366,2023-09-19,14:00:00,183,58,125,FMN GV 16 Berchem TOT
54,Posthofbrug 5366,2023-09-19,15:00:00,344,121,223,FMN GV 16 Berchem TOT
54,Posthofbrug 5366,2023-09-19,16:00:00,669,201,468,FMN GV 16 Berchem TOT
54,Posthofbrug 5366,2023-09-19,17:00:00,845,234,611,FMN GV 16 Berchem TOT
54,Posthofbrug 5366,2023-09-19,18:00:00,513,160,353,FMN GV 16 Berchem TOT
54,Posthofbrug 5366,2023-09-19,19:00:00,221,87,134,FMN GV 16 Berchem TOT
54,Posthofbrug 5366,2023-09-19,20:00:00,144,62,82,FMN GV 16 Berchem TOT
54,Posthofbrug 5366,2023-09-19,21:00:00,98,39,59,FMN GV 16 Berchem TOT
54,Posthofbrug 5366,2023-09-19,22:00:00,127,52,75,FMN GV 16 Berchem TOT
54,Posthofbrug 5366,2023-09-19,23:00:00,85,20,65,FMN GV 16 Berchem TOT
54,Posthofbrug 5366,2023-09-20,00:00:00,28,12,16,FMN GV 16 Berchem TOT
54,Posthofbrug 5366,2023-09-20,01:00:00,3,1,2,FMN GV 16 Berchem TOT
54,Posthofbrug 5366,2023-09-20,02:00:00,9,1,8,FMN GV 16 Berchem TOT
54,Posthofbrug 5366,2023-09-20,03:00:00,9,4,5,FMN GV 16 Berchem TOT
54,Posthofbrug 5366,2023-09-20,04:00:00,17,13,4,FMN GV 16 Berchem TOT
54,Posthofbrug 5366,2023-09-20,05:00:00,33,29,4,FMN GV 16 Berchem TOT
54,Posthofbrug 5366,2023-09-20,06:00:00,139,101,38,FMN GV 16 Berchem TOT
54,Posthofbrug 5366,2023-09-20,07:00:00,536,414,122,FMN GV 16 Berchem TOT
54,Posthofbrug 5366,2023-09-20,08:00:00,861,653,208,FMN GV 16 Berchem TOT
54,Posthofbrug 5366,2023-09-20,09:00:00,283,207,76,FMN GV 16 Berchem TOT
54,Posthofbrug 5366,2023-09-20,10:00:00,144,97,47,FMN GV 16 Berchem TOT
54,Posthofbrug 5366,2023-09-20,11:00:00,171,96,75,FMN GV 16 Berchem TOT
54,Posthofbrug 5366,2023-09-20,12:00:00,424,194,230,FMN GV 16 Berchem TOT
54,Posthofbrug 5366,2023-09-20,13:00:00,288,119,169,FMN GV 16 Berchem TOT
54,Posthofbrug 5366,2023-09-20,14:00:00,208,86,122,FMN GV 16 Berchem TOT
54,Posthofbrug 5366,2023-09-20,15:00:00,291,121,170,FMN GV 16 Berchem TOT
54,Posthofbrug 5366,2023-09-20,16:00:00,438,155,283,FMN GV 16 Berchem TOT
54,Posthofbrug 5366,2023-09-20,17:00:00,612,191,421,FMN GV 16 Berchem TOT
54,Posthofbrug 5366,2023-09-20,18:00:00,462,183,279,FMN GV 16 Berchem TOT
54,Posthofbrug 5366,2023-09-20,19:00:00,244,113,131,FMN GV 16 Berchem TOT
54,Posthofbrug 5366,2023-09-20,20:00:00,158,79,79,FMN GV 16 Berchem TOT
54,Posthofbrug 5366,2023-09-20,21:00:00,149,52,97,FMN GV 16 Berchem TOT
54,Posthofbrug 5366,2023-09-20,22:00:00,150,51,99,FMN GV 16 Berchem TOT
54,Posthofbrug 5366,2023-09-20,23:00:00,77,22,55,FMN GV 16 Berchem TOT
54,Posthofbrug 5366,2023-09-21,00:00:00,31,8,23,FMN GV 16 Berchem TOT
54,Posthofbrug 5366,2023-09-21,01:00:00,18,3,15,FMN GV 16 Berchem TOT
54,Posthofbrug 5366,2023-09-21,02:00:00,10,2,8,FMN GV 16 Berchem TOT
54,Posthofbrug 5366,2023-09-21,03:00:00,9,3,6,FMN GV 16 Berchem TOT
54,Posthofbrug 5366,2023-09-21,04:00:00,16,12,4,FMN GV 16 Berchem TOT
54,Posthofbrug 5366,2023-09-21,05:00:00,35,27,8,FMN GV 16 Berchem TOT
54,Posthofbrug 5366,2023-09-21,06:00:00,104,81,23,FMN GV 16 Berchem TOT
54,Posthofbrug 5366,2023-09-21,07:00:00,413,320,93,FMN GV 16 Berchem TOT
54,Posthofbrug 5366,2023-09-21,08:00:00,839,668,171,FMN GV 16 Berchem TOT
54,Posthofbrug 5366,2023-09-21,09:00:00,239,189,50,FMN GV 16 Berchem TOT
54,Posthofbrug 5366,2023-09-21,10:00:00,112,78,34,FMN GV 16 Berchem TOT
54,Posthofbrug 5366,2023-09-21,11:00:00,79,52,27,FMN GV 16 Berchem TOT
54,Posthofbrug 5366,2023-09-21,12:00:00,133,60,73,FMN GV 16 Berchem TOT
54,Posthofbrug 5366,2023-09-21,13:00:00,135,51,84,FMN GV 16 Berchem TOT
54,Posthofbrug 5366,2023-09-21,14:00:00,115,47,68,FMN GV 16 Berchem TOT
54,Posthofbrug 5366,2023-09-21,15:00:00,196,62,134,FMN GV 16 Berchem TOT
54,Posthofbrug 5366,2023-09-21,16:00:00,421,103,318,FMN GV 16 Berchem TOT
54,Posthofbrug 5366,2023-09-21,17:00:00,561,155,406,FMN GV 16 Berchem TOT
54,Posthofbrug 5366,2023-09-21,18:00:00,347,111,236,FMN GV 16 Berchem TOT
54,Posthofbrug 5366,2023-09-21,19:00:00,169,74,95,FMN GV 16 Berchem TOT
54,Posthofbrug 5366,2023-09-21,20:00:00,131,68,63,FMN GV 16 Berchem TOT
54,Posthofbrug 5366,2023-09-21,21:00:00,93,44,49,FMN GV 16 Berchem TOT
54,Posthofbrug 5366,2023-09-21,22:00:00,117,50,67,FMN GV 16 Berchem TOT
54,Posthofbrug 5366,2023-09-21,23:00:00,65,13,52,FMN GV 16 Berchem TOT
54,Posthofbrug 5366,2023-09-22,00:00:00,31,8,23,FMN GV 16 Berchem TOT
54,Posthofbrug 5366,2023-09-22,01:00:00,20,1,19,FMN GV 16 Berchem TOT
54,Posthofbrug 5366,2023-09-22,02:00:00,9,1,8,FMN GV 16 Berchem TOT
54,Posthofbrug 5366,2023-09-22,03:00:00,10,3,7,FMN GV 16 Berchem TOT
54,Posthofbrug 5366,2023-09-22,04:00:00,23,9,14,FMN GV 16 Berchem TOT
54,Posthofbrug 5366,2023-09-22,05:00:00,28,19,9,FMN GV 16 Berchem TOT
54,Posthofbrug 5366,2023-09-22,06:00:00,119,89,30,FMN GV 16 Berchem TOT
54,Posthofbrug 5366,2023-09-22,07:00:00,418,329,89,FMN GV 16 Berchem TOT
54,Posthofbrug 5366,2023-09-22,08:00:00,764,571,193,FMN GV 16 Berchem TOT
54,Posthofbrug 5366,2023-09-22,09:00:00,296,230,66,FMN GV 16 Berchem TOT
54,Posthofbrug 5366,2023-09-22,10:00:00,157,96,61,FMN GV 16 Berchem TOT
54,Posthofbrug 5366,2023-09-22,11:00:00,145,80,65,FMN GV 16 Berchem TOT
54,Posthofbrug 5366,2023-09-22,12:00:00,254,118,136,FMN GV 16 Berchem TOT
54,Posthofbrug 5366,2023-09-22,13:00:00,194,95,99,FMN GV 16 Berchem TOT
54,Posthofbrug 5366,2023-09-22,14:00:00,193,82,111,FMN GV 16 Berchem TOT
54,Posthofbrug 5366,2023-09-22,15:00:00,323,113,210,FMN GV 16 Berchem TOT
54,Posthofbrug 5366,2023-09-22,16:00:00,492,136,356,FMN GV 16 Berchem TOT
54,Posthofbrug 5366,2023-09-22,17:00:00,465,153,312,FMN GV 16 Berchem TOT
54,Posthofbrug 5366,2023-09-22,18:00:00,312,126,186,FMN GV 16 Berchem TOT
54,Posthofbrug 5366,2023-09-22,19:00:00,200,97,103,FMN GV 16 Berchem TOT
54,Posthofbrug 5366,2023-09-22,20:00:00,123,61,62,FMN GV 16 Berchem TOT
54,Posthofbrug 5366,2023-09-22,21:00:00,115,69,46,FMN GV 16 Berchem TOT
54,Posthofbrug 5366,2023-09-22,22:00:00,116,48,68,FMN GV 16 Berchem TOT
54,Posthofbrug 5366,2023-09-22,23:00:00,103,37,66,FMN GV 16 Berchem TOT
54,Posthofbrug 5366,2023-09-23,00:00:00,85,29,56,FMN GV 16 Berchem TOT
54,Posthofbrug 5366,2023-09-23,01:00:00,57,20,37,FMN GV 16 Berchem TOT
54,Posthofbrug 5366,2023-09-23,02:00:00,34,5,29,FMN GV 16 Berchem TOT
54,Posthofbrug 5366,2023-09-23,03:00:00,28,2,26,FMN GV 16 Berchem TOT
54,Posthofbrug 5366,2023-09-23,04:00:00,33,8,25,FMN GV 16 Berchem TOT
54,Posthofbrug 5366,2023-09-23,05:00:00,17,13,4,FMN GV 16 Berchem TOT
54,Posthofbrug 5366,2023-09-23,06:00:00,23,14,9,FMN GV 16 Berchem TOT
54,Posthofbrug 5366,2023-09-23,07:00:00,67,35,32,FMN GV 16 Berchem TOT
54,Posthofbrug 5366,2023-09-23,08:00:00,90,53,37,FMN GV 16 Berchem TOT
54,Posthofbrug 5366,2023-09-23,09:00:00,179,127,52,FMN GV 16 Berchem TOT
54,Posthofbrug 5366,2023-09-23,10:00:00,199,131,68,FMN GV 16 Berchem TOT
54,Posthofbrug 5366,2023-09-23,11:00:00,175,109,66,FMN GV 16 Berchem TOT
54,Posthofbrug 5366,2023-09-23,12:00:00,205,125,80,FMN GV 16 Berchem TOT
54,Posthofbrug 5366,2023-09-23,13:00:00,262,158,104,FMN GV 16 Berchem TOT
54,Posthofbrug 5366,2023-09-23,14:00:00,264,143,121,FMN GV 16 Berchem TOT
54,Posthofbrug 5366,2023-09-23,15:00:00,230,116,114,FMN GV 16 Berchem TOT
54,Posthofbrug 5366,2023-09-23,16:00:00,221,94,127,FMN GV 16 Berchem TOT
54,Posthofbrug 5366,2023-09-23,17:00:00,251,116,135,FMN GV 16 Berchem TOT
54,Posthofbrug 5366,2023-09-23,18:00:00,231,99,132,FMN GV 16 Berchem TOT
54,Posthofbrug 5366,2023-09-23,19:00:00,184,105,79,FMN GV 16 Berchem TOT
54,Posthofbrug 5366,2023-09-23,20:00:00,151,84,67,FMN GV 16 Berchem TOT
54,Posthofbrug 5366,2023-09-23,21:00:00,112,51,61,FMN GV 16 Berchem TOT
54,Posthofbrug 5366,2023-09-23,22:00:00,89,37,52,FMN GV 16 Berchem TOT
54,Posthofbrug 5366,2023-09-23,23:00:00,102,43,59,FMN GV 16 Berchem TOT
54,Posthofbrug 5366,2023-09-24,00:00:00,82,24,58,FMN GV 16 Berchem TOT
54,Posthofbrug 5366,2023-09-24,01:00:00,69,41,28,FMN GV 16 Berchem TOT
54,Posthofbrug 5366,2023-09-24,02:00:00,58,23,35,FMN GV 16 Berchem TOT
54,Posthofbrug 5366,2023-09-24,03:00:00,40,12,28,FMN GV 16 Berchem TOT
54,Posthofbrug 5366,2023-09-24,04:00:00,22,10,12,FMN GV 16 Berchem TOT
54,Posthofbrug 5366,2023-09-24,05:00:00,29,11,18,FMN GV 16 Berchem TOT
54,Posthofbrug 5366,2023-09-24,06:00:00,20,15,5,FMN GV 16 Berchem TOT
54,Posthofbrug 5366,2023-09-24,07:00:00,44,25,19,FMN GV 16 Berchem TOT
54,Posthofbrug 5366,2023-09-24,08:00:00,88,52,36,FMN GV 16 Berchem TOT
54,Posthofbrug 5366,2023-09-24,09:00:00,147,81,66,FMN GV 16 Berchem TOT
54,Posthofbrug 5366,2023-09-24,10:00:00,200,106,94,FMN GV 16 Berchem TOT
54,Posthofbrug 5366,2023-09-24,11:00:00,220,121,99,FMN GV 16 Berchem TOT
54,Posthofbrug 5366,2023-09-24,12:00:00,234,139,95,FMN GV 16 Berchem TOT
54,Posthofbrug 5366,2023-09-24,13:00:00,289,172,117,FMN GV 16 Berchem TOT
54,Posthofbrug 5366,2023-09-24,14:00:00,267,148,119,FMN GV 16 Berchem TOT
54,Posthofbrug 5366,2023-09-24,15:00:00,327,185,142,FMN GV 16 Berchem TOT
54,Posthofbrug 5366,2023-09-24,16:00:00,239,104,135,FMN GV 16 Berchem TOT
54,Posthofbrug 5366,2023-09-24,17:00:00,241,124,117,FMN GV 16 Berchem TOT
54,Posthofbrug 5366,2023-09-24,18:00:00,238,104,134,FMN GV 16 Berchem TOT
54,Posthofbrug 5366,2023-09-24,19:00:00,133,64,69,FMN GV 16 Berchem TOT
54,Posthofbrug 5366,2023-09-24,20:00:00,139,49,90,FMN GV 16 Berchem TOT
54,Posthofbrug 5366,2023-09-24,21:00:00,108,58,50,FMN GV 16 Berchem TOT
54,Posthofbrug 5366,2023-09-24,22:00:00,63,27,36,FMN GV 16 Berchem TOT
54,Posthofbrug 5366,2023-09-24,23:00:00,37,13,24,FMN GV 16 Berchem TOT
54,Posthofbrug 5366,2023-09-25,00:00:00,11,2,9,FMN GV 16 Berchem TOT
54,Posthofbrug 5366,2023-09-25,01:00:00,9,2,7,FMN GV 16 Berchem TOT
54,Posthofbrug 5366,2023-09-25,02:00:00,3,0,3,FMN GV 16 Berchem TOT
54,Posthofbrug 5366,2023-09-25,03:00:00,4,2,2,FMN GV 16 Berchem TOT
54,Posthofbrug 5366,2023-09-25,04:00:00,15,9,6,FMN GV 16 Berchem TOT
54,Posthofbrug 5366,2023-09-25,05:00:00,34,26,8,FMN GV 16 Berchem TOT
54,Posthofbrug 5366,2023-09-25,06:00:00,155,124,31,FMN GV 16 Berchem TOT
54,Posthofbrug 5366,2023-09-25,07:00:00,539,430,109,FMN GV 16 Berchem TOT
54,Posthofbrug 5366,2023-09-25,08:00:00,1060,830,230,FMN GV 16 Berchem TOT
54,Posthofbrug 5366,2023-09-25,09:00:00,382,298,84,FMN GV 16 Berchem TOT
54,Posthofbrug 5366,2023-09-25,10:00:00,247,158,89,FMN GV 16 Berchem TOT
54,Posthofbrug 5366,2023-09-25,11:00:00,201,125,76,FMN GV 16 Berchem TOT
54,Posthofbrug 5366,2023-09-25,12:00:00,254,155,99,FMN GV 16 Berchem TOT
54,Posthofbrug 5366,2023-09-25,13:00:00,256,131,125,FMN GV 16 Berchem TOT
54,Posthofbrug 5366,2023-09-25,14:00:00,266,118,148,FMN GV 16 Berchem TOT
54,Posthofbrug 5366,2023-09-25,15:00:00,407,162,245,FMN GV 16 Berchem TOT
54,Posthofbrug 5366,2023-09-25,16:00:00,606,185,421,FMN GV 16 Berchem TOT
54,Posthofbrug 5366,2023-09-25,17:00:00,852,237,615,FMN GV 16 Berchem TOT
54,Posthofbrug 5366,2023-09-25,18:00:00,478,150,328,FMN GV 16 Berchem TOT
54,Posthofbrug 5366,2023-09-25,19:00:00,248,81,167,FMN GV 16 Berchem TOT
54,Posthofbrug 5366,2023-09-25,20:00:00,166,59,107,FMN GV 16 Berchem TOT
54,Posthofbrug 5366,2023-09-25,21:00:00,159,51,108,FMN GV 16 Berchem TOT
54,Posthofbrug 5366,2023-09-25,22:00:00,140,48,92,FMN GV 16 Berchem TOT
54,Posthofbrug 5366,2023-09-25,23:00:00,57,17,40,FMN GV 16 Berchem TOT
54,Posthofbrug 5366,2023-09-26,00:00:00,36,7,29,FMN GV 16 Berchem TOT
54,Posthofbrug 5366,2023-09-26,01:00:00,12,1,11,FMN GV 16 Berchem TOT
54,Posthofbrug 5366,2023-09-26,02:00:00,21,0,21,FMN GV 16 Berchem TOT
54,Posthofbrug 5366,2023-09-26,03:00:00,12,6,6,FMN GV 16 Berchem TOT
54,Posthofbrug 5366,2023-09-26,04:00:00,15,4,11,FMN GV 16 Berchem TOT
54,Posthofbrug 5366,2023-09-26,05:00:00,38,29,9,FMN GV 16 Berchem TOT
54,Posthofbrug 5366,2023-09-26,06:00:00,186,153,33,FMN GV 16 Berchem TOT
54,Posthofbrug 5366,2023-09-26,07:00:00,670,525,145,FMN GV 16 Berchem TOT
54,Posthofbrug 5366,2023-09-26,08:00:00,1181,932,249,FMN GV 16 Berchem TOT
54,Posthofbrug 5366,2023-09-26,09:00:00,370,291,79,FMN GV 16 Berchem TOT
54,Posthofbrug 5366,2023-09-26,10:00:00,172,122,50,FMN GV 16 Berchem TOT
54,Posthofbrug 5366,2023-09-26,11:00:00,164,95,69,FMN GV 16 Berchem TOT
54,Posthofbrug 5366,2023-09-26,12:00:00,282,162,120,FMN GV 16 Berchem TOT
54,Posthofbrug 5366,2023-09-26,13:00:00,252,133,119,FMN GV 16 Berchem TOT
54,Posthofbrug 5366,2023-09-26,14:00:00,231,97,134,FMN GV 16 Berchem TOT
54,Posthofbrug 5366,2023-09-26,15:00:00,397,131,266,FMN GV 16 Berchem TOT
54,Posthofbrug 5366,2023-09-26,16:00:00,679,173,506,FMN GV 16 Berchem TOT
54,Posthofbrug 5366,2023-09-26,17:00:00,889,253,636,FMN GV 16 Berchem TOT
54,Posthofbrug 5366,2023-09-26,18:00:00,549,177,372,FMN GV 16 Berchem TOT
54,Posthofbrug 5366,2023-09-26,19:00:00,304,113,191,FMN GV 16 Berchem TOT
54,Posthofbrug 5366,2023-09-26,20:00:00,174,80,94,FMN GV 16 Berchem TOT
54,Posthofbrug 5366,2023-09-26,21:00:00,149,59,90,FMN GV 16 Berchem TOT
54,Posthofbrug 5366,2023-09-26,22:00:00,162,64,98,FMN GV 16 Berchem TOT
54,Posthofbrug 5366,2023-09-26,23:00:00,70,24,46,FMN GV 16 Berchem TOT
54,Posthofbrug 5366,2023-09-27,00:00:00,31,10,21,FMN GV 16 Berchem TOT
54,Posthofbrug 5366,2023-09-27,01:00:00,10,1,9,FMN GV 16 Berchem TOT
54,Posthofbrug 5366,2023-09-27,02:00:00,9,3,6,FMN GV 16 Berchem TOT
54,Posthofbrug 5366,2023-09-27,03:00:00,9,2,7,FMN GV 16 Berchem TOT
54,Posthofbrug 5366,2023-09-27,04:00:00,0,0,0,FMN GV 16 Berchem TOT
54,Posthofbrug 5366,2023-09-27,05:00:00,0,0,0,FMN GV 16 Berchem TOT
54,Posthofbrug 5366,2023-09-27,06:00:00,0,0,0,FMN GV 16 Berchem TOT
54,Posthofbrug 5366,2023-09-27,07:00:00,0,0,0,FMN GV 16 Berchem TOT
54,Posthofbrug 5366,2023-09-27,08:00:00,0,0,0,FMN GV 16 Berchem TOT
54,Posthofbrug 5366,2023-09-27,09:00:00,0,0,0,FMN GV 16 Berchem TOT
54,Posthofbrug 5366,2023-09-27,10:00:00,0,0,0,FMN GV 16 Berchem TOT
54,Posthofbrug 5366,2023-09-27,11:00:00,0,0,0,FMN GV 16 Berchem TOT
54,Posthofbrug 5366,2023-09-27,12:00:00,0,0,0,FMN GV 16 Berchem TOT
54,Posthofbrug 5366,2023-09-27,13:00:00,0,0,0,FMN GV 16 Berchem TOT
54,Posthofbrug 5366,2023-09-27,14:00:00,0,0,0,FMN GV 16 Berchem TOT
54,Posthofbrug 5366,2023-09-27,15:00:00,0,0,0,FMN GV 16 Berchem TOT
54,Posthofbrug 5366,2023-09-27,16:00:00,0,0,0,FMN GV 16 Berchem TOT
54,Posthofbrug 5366,2023-09-27,17:00:00,0,0,0,FMN GV 16 Berchem TOT
54,Posthofbrug 5366,2023-09-27,18:00:00,0,0,0,FMN GV 16 Berchem TOT
54,Posthofbrug 5366,2023-09-27,19:00:00,0,0,0,FMN GV 16 Berchem TOT
54,Posthofbrug 5366,2023-09-27,20:00:00,0,0,0,FMN GV 16 Berchem TOT
54,Posthofbrug 5366,2023-09-27,21:00:00,0,0,0,FMN GV 16 Berchem TOT
54,Posthofbrug 5366,2023-09-27,22:00:00,0,0,0,FMN GV 16 Berchem TOT
54,Posthofbrug 5366,2023-09-27,23:00:00,0,0,0,FMN GV 16 Berchem TOT
