Meetpunt surrogate key,Meetpunt locatie,Datum,Tijd,Aantal fietsers,Aantal fietsers van,Aantal fietsers naar,Meetpunt code
658,Ringfietspad Jan Van Rijswijcklaan,2022-08-22,00:00:00,3,3,0,FMN 11 A Jan Van Rijswijcklaan Ringfietspad
658,Ringfietspad Jan Van Rijswijcklaan,2022-08-22,01:00:00,2,2,0,FMN 11 A Jan Van Rijswijcklaan Ringfietspad
658,Ringfietspad Jan Van Rijswijcklaan,2022-08-22,02:00:00,2,2,0,FMN 11 A Jan Van Rijswijcklaan Ringfietspad
658,Ringfietspad Jan Van Rijswijcklaan,2022-08-22,03:00:00,1,0,1,FMN 11 A Jan Van Rijswijcklaan Ringfietspad
658,Ringfietspad Jan Van Rijswijcklaan,2022-08-22,04:00:00,6,1,5,FMN 11 A Jan Van Rijswijcklaan Ringfietspad
658,Ringfietspad Jan Van Rijswijcklaan,2022-08-22,05:00:00,26,6,20,FMN 11 A Jan Van Rijswijcklaan Ringfietspad
658,Ringfietspad Jan Van Rijswijcklaan,2022-08-22,06:00:00,40,10,30,FMN 11 A Jan Van Rijswijcklaan Ringfietspad
658,Ringfietspad Jan Van Rijswijcklaan,2022-08-22,07:00:00,114,39,75,FMN 11 A Jan Van Rijswijcklaan Ringfietspad
658,Ringfietspad Jan Van Rijswijcklaan,2022-08-22,08:00:00,115,35,80,FMN 11 A Jan Van Rijswijcklaan Ringfietspad
658,Ringfietspad Jan Van Rijswijcklaan,2022-08-22,09:00:00,41,18,23,FMN 11 A Jan Van Rijswijcklaan Ringfietspad
658,Ringfietspad Jan Van Rijswijcklaan,2022-08-22,10:00:00,32,14,18,FMN 11 A Jan Van Rijswijcklaan Ringfietspad
658,Ringfietspad Jan Van Rijswijcklaan,2022-08-22,11:00:00,36,20,16,FMN 11 A Jan Van Rijswijcklaan Ringfietspad
658,Ringfietspad Jan Van Rijswijcklaan,2022-08-22,12:00:00,56,26,30,FMN 11 A Jan Van Rijswijcklaan Ringfietspad
658,Ringfietspad Jan Van Rijswijcklaan,2022-08-22,13:00:00,41,22,19,FMN 11 A Jan Van Rijswijcklaan Ringfietspad
658,Ringfietspad Jan Van Rijswijcklaan,2022-08-22,14:00:00,81,45,36,FMN 11 A Jan Van Rijswijcklaan Ringfietspad
658,Ringfietspad Jan Van Rijswijcklaan,2022-08-22,15:00:00,78,55,23,FMN 11 A Jan Van Rijswijcklaan Ringfietspad
658,Ringfietspad Jan Van Rijswijcklaan,2022-08-22,16:00:00,134,94,40,FMN 11 A Jan Van Rijswijcklaan Ringfietspad
658,Ringfietspad Jan Van Rijswijcklaan,2022-08-22,17:00:00,140,101,39,FMN 11 A Jan Van Rijswijcklaan Ringfietspad
658,Ringfietspad Jan Van Rijswijcklaan,2022-08-22,18:00:00,88,58,30,FMN 11 A Jan Van Rijswijcklaan Ringfietspad
658,Ringfietspad Jan Van Rijswijcklaan,2022-08-22,19:00:00,39,22,17,FMN 11 A Jan Van Rijswijcklaan Ringfietspad
658,Ringfietspad Jan Van Rijswijcklaan,2022-08-22,20:00:00,37,19,18,FMN 11 A Jan Van Rijswijcklaan Ringfietspad
658,Ringfietspad Jan Van Rijswijcklaan,2022-08-22,21:00:00,31,14,17,FMN 11 A Jan Van Rijswijcklaan Ringfietspad
658,Ringfietspad Jan Van Rijswijcklaan,2022-08-22,22:00:00,17,13,4,FMN 11 A Jan Van Rijswijcklaan Ringfietspad
658,Ringfietspad Jan Van Rijswijcklaan,2022-08-22,23:00:00,7,3,4,FMN 11 A Jan Van Rijswijcklaan Ringfietspad
658,Ringfietspad Jan Van Rijswijcklaan,2022-08-23,00:00:00,2,1,1,FMN 11 A Jan Van Rijswijcklaan Ringfietspad
658,Ringfietspad Jan Van Rijswijcklaan,2022-08-23,01:00:00,3,1,2,FMN 11 A Jan Van Rijswijcklaan Ringfietspad
658,Ringfietspad Jan Van Rijswijcklaan,2022-08-23,02:00:00,4,2,2,FMN 11 A Jan Van Rijswijcklaan Ringfietspad
658,Ringfietspad Jan Van Rijswijcklaan,2022-08-23,03:00:00,0,0,0,FMN 11 A Jan Van Rijswijcklaan Ringfietspad
658,Ringfietspad Jan Van Rijswijcklaan,2022-08-23,04:00:00,8,2,6,FMN 11 A Jan Van Rijswijcklaan Ringfietspad
658,Ringfietspad Jan Van Rijswijcklaan,2022-08-23,05:00:00,25,6,19,FMN 11 A Jan Van Rijswijcklaan Ringfietspad
658,Ringfietspad Jan Van Rijswijcklaan,2022-08-23,06:00:00,52,18,34,FMN 11 A Jan Van Rijswijcklaan Ringfietspad
658,Ringfietspad Jan Van Rijswijcklaan,2022-08-23,07:00:00,127,41,86,FMN 11 A Jan Van Rijswijcklaan Ringfietspad
658,Ringfietspad Jan Van Rijswijcklaan,2022-08-23,08:00:00,148,47,101,FMN 11 A Jan Van Rijswijcklaan Ringfietspad
658,Ringfietspad Jan Van Rijswijcklaan,2022-08-23,09:00:00,71,31,40,FMN 11 A Jan Van Rijswijcklaan Ringfietspad
658,Ringfietspad Jan Van Rijswijcklaan,2022-08-23,10:00:00,33,13,20,FMN 11 A Jan Van Rijswijcklaan Ringfietspad
658,Ringfietspad Jan Van Rijswijcklaan,2022-08-23,11:00:00,51,22,29,FMN 11 A Jan Van Rijswijcklaan Ringfietspad
658,Ringfietspad Jan Van Rijswijcklaan,2022-08-23,12:00:00,54,30,24,FMN 11 A Jan Van Rijswijcklaan Ringfietspad
658,Ringfietspad Jan Van Rijswijcklaan,2022-08-23,13:00:00,47,23,24,FMN 11 A Jan Van Rijswijcklaan Ringfietspad
658,Ringfietspad Jan Van Rijswijcklaan,2022-08-23,14:00:00,59,39,20,FMN 11 A Jan Van Rijswijcklaan Ringfietspad
658,Ringfietspad Jan Van Rijswijcklaan,2022-08-23,15:00:00,94,67,27,FMN 11 A Jan Van Rijswijcklaan Ringfietspad
658,Ringfietspad Jan Van Rijswijcklaan,2022-08-23,16:00:00,147,102,45,FMN 11 A Jan Van Rijswijcklaan Ringfietspad
658,Ringfietspad Jan Van Rijswijcklaan,2022-08-23,17:00:00,160,102,58,FMN 11 A Jan Van Rijswijcklaan Ringfietspad
658,Ringfietspad Jan Van Rijswijcklaan,2022-08-23,18:00:00,92,62,30,FMN 11 A Jan Van Rijswijcklaan Ringfietspad
658,Ringfietspad Jan Van Rijswijcklaan,2022-08-23,19:00:00,48,25,23,FMN 11 A Jan Van Rijswijcklaan Ringfietspad
658,Ringfietspad Jan Van Rijswijcklaan,2022-08-23,20:00:00,38,15,23,FMN 11 A Jan Van Rijswijcklaan Ringfietspad
658,Ringfietspad Jan Van Rijswijcklaan,2022-08-23,21:00:00,21,9,12,FMN 11 A Jan Van Rijswijcklaan Ringfietspad
658,Ringfietspad Jan Van Rijswijcklaan,2022-08-23,22:00:00,31,28,3,FMN 11 A Jan Van Rijswijcklaan Ringfietspad
658,Ringfietspad Jan Van Rijswijcklaan,2022-08-23,23:00:00,8,5,3,FMN 11 A Jan Van Rijswijcklaan Ringfietspad
658,Ringfietspad Jan Van Rijswijcklaan,2022-08-24,00:00:00,7,4,3,FMN 11 A Jan Van Rijswijcklaan Ringfietspad
658,Ringfietspad Jan Van Rijswijcklaan,2022-08-24,01:00:00,1,1,0,FMN 11 A Jan Van Rijswijcklaan Ringfietspad
658,Ringfietspad Jan Van Rijswijcklaan,2022-08-24,02:00:00,4,3,1,FMN 11 A Jan Van Rijswijcklaan Ringfietspad
658,Ringfietspad Jan Van Rijswijcklaan,2022-08-24,03:00:00,1,0,1,FMN 11 A Jan Van Rijswijcklaan Ringfietspad
658,Ringfietspad Jan Van Rijswijcklaan,2022-08-24,04:00:00,7,2,5,FMN 11 A Jan Van Rijswijcklaan Ringfietspad
658,Ringfietspad Jan Van Rijswijcklaan,2022-08-24,05:00:00,28,4,24,FMN 11 A Jan Van Rijswijcklaan Ringfietspad
658,Ringfietspad Jan Van Rijswijcklaan,2022-08-24,06:00:00,58,18,40,FMN 11 A Jan Van Rijswijcklaan Ringfietspad
658,Ringfietspad Jan Van Rijswijcklaan,2022-08-24,07:00:00,122,41,81,FMN 11 A Jan Van Rijswijcklaan Ringfietspad
658,Ringfietspad Jan Van Rijswijcklaan,2022-08-24,08:00:00,108,42,66,FMN 11 A Jan Van Rijswijcklaan Ringfietspad
658,Ringfietspad Jan Van Rijswijcklaan,2022-08-24,09:00:00,53,22,31,FMN 11 A Jan Van Rijswijcklaan Ringfietspad
658,Ringfietspad Jan Van Rijswijcklaan,2022-08-24,10:00:00,68,39,29,FMN 11 A Jan Van Rijswijcklaan Ringfietspad
658,Ringfietspad Jan Van Rijswijcklaan,2022-08-24,11:00:00,53,22,31,FMN 11 A Jan Van Rijswijcklaan Ringfietspad
658,Ringfietspad Jan Van Rijswijcklaan,2022-08-24,12:00:00,51,30,21,FMN 11 A Jan Van Rijswijcklaan Ringfietspad
658,Ringfietspad Jan Van Rijswijcklaan,2022-08-24,13:00:00,61,39,22,FMN 11 A Jan Van Rijswijcklaan Ringfietspad
658,Ringfietspad Jan Van Rijswijcklaan,2022-08-24,14:00:00,73,43,30,FMN 11 A Jan Van Rijswijcklaan Ringfietspad
658,Ringfietspad Jan Van Rijswijcklaan,2022-08-24,15:00:00,99,58,41,FMN 11 A Jan Van Rijswijcklaan Ringfietspad
658,Ringfietspad Jan Van Rijswijcklaan,2022-08-24,16:00:00,135,88,47,FMN 11 A Jan Van Rijswijcklaan Ringfietspad
658,Ringfietspad Jan Van Rijswijcklaan,2022-08-24,17:00:00,152,98,54,FMN 11 A Jan Van Rijswijcklaan Ringfietspad
658,Ringfietspad Jan Van Rijswijcklaan,2022-08-24,18:00:00,91,46,45,FMN 11 A Jan Van Rijswijcklaan Ringfietspad
658,Ringfietspad Jan Van Rijswijcklaan,2022-08-24,19:00:00,56,26,30,FMN 11 A Jan Van Rijswijcklaan Ringfietspad
658,Ringfietspad Jan Van Rijswijcklaan,2022-08-24,20:00:00,28,11,17,FMN 11 A Jan Van Rijswijcklaan Ringfietspad
658,Ringfietspad Jan Van Rijswijcklaan,2022-08-24,21:00:00,34,19,15,FMN 11 A Jan Van Rijswijcklaan Ringfietspad
658,Ringfietspad Jan Van Rijswijcklaan,2022-08-24,22:00:00,35,24,11,FMN 11 A Jan Van Rijswijcklaan Ringfietspad
658,Ringfietspad Jan Van Rijswijcklaan,2022-08-24,23:00:00,9,7,2,FMN 11 A Jan Van Rijswijcklaan Ringfietspad
658,Ringfietspad Jan Van Rijswijcklaan,2022-08-25,00:00:00,7,5,2,FMN 11 A Jan Van Rijswijcklaan Ringfietspad
658,Ringfietspad Jan Van Rijswijcklaan,2022-08-25,01:00:00,1,1,0,FMN 11 A Jan Van Rijswijcklaan Ringfietspad
658,Ringfietspad Jan Van Rijswijcklaan,2022-08-25,02:00:00,5,2,3,FMN 11 A Jan Van Rijswijcklaan Ringfietspad
658,Ringfietspad Jan Van Rijswijcklaan,2022-08-25,03:00:00,1,1,0,FMN 11 A Jan Van Rijswijcklaan Ringfietspad
658,Ringfietspad Jan Van Rijswijcklaan,2022-08-25,04:00:00,7,2,5,FMN 11 A Jan Van Rijswijcklaan Ringfietspad
658,Ringfietspad Jan Van Rijswijcklaan,2022-08-25,05:00:00,26,10,16,FMN 11 A Jan Van Rijswijcklaan Ringfietspad
658,Ringfietspad Jan Van Rijswijcklaan,2022-08-25,06:00:00,54,15,39,FMN 11 A Jan Van Rijswijcklaan Ringfietspad
658,Ringfietspad Jan Van Rijswijcklaan,2022-08-25,07:00:00,111,40,71,FMN 11 A Jan Van Rijswijcklaan Ringfietspad
658,Ringfietspad Jan Van Rijswijcklaan,2022-08-25,08:00:00,161,46,115,FMN 11 A Jan Van Rijswijcklaan Ringfietspad
658,Ringfietspad Jan Van Rijswijcklaan,2022-08-25,09:00:00,88,41,47,FMN 11 A Jan Van Rijswijcklaan Ringfietspad
658,Ringfietspad Jan Van Rijswijcklaan,2022-08-25,10:00:00,33,13,20,FMN 11 A Jan Van Rijswijcklaan Ringfietspad
658,Ringfietspad Jan Van Rijswijcklaan,2022-08-25,11:00:00,57,26,31,FMN 11 A Jan Van Rijswijcklaan Ringfietspad
658,Ringfietspad Jan Van Rijswijcklaan,2022-08-25,12:00:00,55,23,32,FMN 11 A Jan Van Rijswijcklaan Ringfietspad
658,Ringfietspad Jan Van Rijswijcklaan,2022-08-25,13:00:00,59,38,21,FMN 11 A Jan Van Rijswijcklaan Ringfietspad
658,Ringfietspad Jan Van Rijswijcklaan,2022-08-25,14:00:00,52,34,18,FMN 11 A Jan Van Rijswijcklaan Ringfietspad
658,Ringfietspad Jan Van Rijswijcklaan,2022-08-25,15:00:00,106,73,33,FMN 11 A Jan Van Rijswijcklaan Ringfietspad
658,Ringfietspad Jan Van Rijswijcklaan,2022-08-25,16:00:00,141,90,51,FMN 11 A Jan Van Rijswijcklaan Ringfietspad
658,Ringfietspad Jan Van Rijswijcklaan,2022-08-25,17:00:00,147,98,49,FMN 11 A Jan Van Rijswijcklaan Ringfietspad
658,Ringfietspad Jan Van Rijswijcklaan,2022-08-25,18:00:00,89,51,38,FMN 11 A Jan Van Rijswijcklaan Ringfietspad
658,Ringfietspad Jan Van Rijswijcklaan,2022-08-25,19:00:00,80,55,25,FMN 11 A Jan Van Rijswijcklaan Ringfietspad
658,Ringfietspad Jan Van Rijswijcklaan,2022-08-25,20:00:00,51,31,20,FMN 11 A Jan Van Rijswijcklaan Ringfietspad
658,Ringfietspad Jan Van Rijswijcklaan,2022-08-25,21:00:00,27,11,16,FMN 11 A Jan Van Rijswijcklaan Ringfietspad
658,Ringfietspad Jan Van Rijswijcklaan,2022-08-25,22:00:00,29,19,10,FMN 11 A Jan Van Rijswijcklaan Ringfietspad
658,Ringfietspad Jan Van Rijswijcklaan,2022-08-25,23:00:00,16,5,11,FMN 11 A Jan Van Rijswijcklaan Ringfietspad
658,Ringfietspad Jan Van Rijswijcklaan,2022-08-26,00:00:00,9,5,4,FMN 11 A Jan Van Rijswijcklaan Ringfietspad
658,Ringfietspad Jan Van Rijswijcklaan,2022-08-26,01:00:00,3,1,2,FMN 11 A Jan Van Rijswijcklaan Ringfietspad
658,Ringfietspad Jan Van Rijswijcklaan,2022-08-26,02:00:00,4,2,2,FMN 11 A Jan Van Rijswijcklaan Ringfietspad
658,Ringfietspad Jan Van Rijswijcklaan,2022-08-26,03:00:00,3,3,0,FMN 11 A Jan Van Rijswijcklaan Ringfietspad
658,Ringfietspad Jan Van Rijswijcklaan,2022-08-26,04:00:00,4,2,2,FMN 11 A Jan Van Rijswijcklaan Ringfietspad
658,Ringfietspad Jan Van Rijswijcklaan,2022-08-26,05:00:00,26,8,18,FMN 11 A Jan Van Rijswijcklaan Ringfietspad
658,Ringfietspad Jan Van Rijswijcklaan,2022-08-26,06:00:00,50,18,32,FMN 11 A Jan Van Rijswijcklaan Ringfietspad
658,Ringfietspad Jan Van Rijswijcklaan,2022-08-26,07:00:00,90,28,62,FMN 11 A Jan Van Rijswijcklaan Ringfietspad
658,Ringfietspad Jan Van Rijswijcklaan,2022-08-26,08:00:00,91,39,52,FMN 11 A Jan Van Rijswijcklaan Ringfietspad
658,Ringfietspad Jan Van Rijswijcklaan,2022-08-26,09:00:00,41,21,20,FMN 11 A Jan Van Rijswijcklaan Ringfietspad
658,Ringfietspad Jan Van Rijswijcklaan,2022-08-26,10:00:00,38,25,13,FMN 11 A Jan Van Rijswijcklaan Ringfietspad
658,Ringfietspad Jan Van Rijswijcklaan,2022-08-26,11:00:00,24,8,16,FMN 11 A Jan Van Rijswijcklaan Ringfietspad
658,Ringfietspad Jan Van Rijswijcklaan,2022-08-26,12:00:00,37,25,12,FMN 11 A Jan Van Rijswijcklaan Ringfietspad
658,Ringfietspad Jan Van Rijswijcklaan,2022-08-26,13:00:00,58,31,27,FMN 11 A Jan Van Rijswijcklaan Ringfietspad
658,Ringfietspad Jan Van Rijswijcklaan,2022-08-26,14:00:00,65,39,26,FMN 11 A Jan Van Rijswijcklaan Ringfietspad
658,Ringfietspad Jan Van Rijswijcklaan,2022-08-26,15:00:00,92,67,25,FMN 11 A Jan Van Rijswijcklaan Ringfietspad
658,Ringfietspad Jan Van Rijswijcklaan,2022-08-26,16:00:00,101,62,39,FMN 11 A Jan Van Rijswijcklaan Ringfietspad
658,Ringfietspad Jan Van Rijswijcklaan,2022-08-26,17:00:00,101,64,37,FMN 11 A Jan Van Rijswijcklaan Ringfietspad
658,Ringfietspad Jan Van Rijswijcklaan,2022-08-26,18:00:00,72,40,32,FMN 11 A Jan Van Rijswijcklaan Ringfietspad
658,Ringfietspad Jan Van Rijswijcklaan,2022-08-26,19:00:00,42,27,15,FMN 11 A Jan Van Rijswijcklaan Ringfietspad
658,Ringfietspad Jan Van Rijswijcklaan,2022-08-26,20:00:00,39,22,17,FMN 11 A Jan Van Rijswijcklaan Ringfietspad
658,Ringfietspad Jan Van Rijswijcklaan,2022-08-26,21:00:00,23,14,9,FMN 11 A Jan Van Rijswijcklaan Ringfietspad
658,Ringfietspad Jan Van Rijswijcklaan,2022-08-26,22:00:00,20,11,9,FMN 11 A Jan Van Rijswijcklaan Ringfietspad
658,Ringfietspad Jan Van Rijswijcklaan,2022-08-26,23:00:00,17,5,12,FMN 11 A Jan Van Rijswijcklaan Ringfietspad
658,Ringfietspad Jan Van Rijswijcklaan,2022-08-27,00:00:00,13,8,5,FMN 11 A Jan Van Rijswijcklaan Ringfietspad
658,Ringfietspad Jan Van Rijswijcklaan,2022-08-27,01:00:00,9,3,6,FMN 11 A Jan Van Rijswijcklaan Ringfietspad
658,Ringfietspad Jan Van Rijswijcklaan,2022-08-27,02:00:00,8,6,2,FMN 11 A Jan Van Rijswijcklaan Ringfietspad
658,Ringfietspad Jan Van Rijswijcklaan,2022-08-27,03:00:00,7,6,1,FMN 11 A Jan Van Rijswijcklaan Ringfietspad
658,Ringfietspad Jan Van Rijswijcklaan,2022-08-27,04:00:00,4,2,2,FMN 11 A Jan Van Rijswijcklaan Ringfietspad
658,Ringfietspad Jan Van Rijswijcklaan,2022-08-27,05:00:00,4,3,1,FMN 11 A Jan Van Rijswijcklaan Ringfietspad
658,Ringfietspad Jan Van Rijswijcklaan,2022-08-27,06:00:00,6,4,2,FMN 11 A Jan Van Rijswijcklaan Ringfietspad
658,Ringfietspad Jan Van Rijswijcklaan,2022-08-27,07:00:00,10,3,7,FMN 11 A Jan Van Rijswijcklaan Ringfietspad
658,Ringfietspad Jan Van Rijswijcklaan,2022-08-27,08:00:00,13,7,6,FMN 11 A Jan Van Rijswijcklaan Ringfietspad
658,Ringfietspad Jan Van Rijswijcklaan,2022-08-27,09:00:00,33,18,15,FMN 11 A Jan Van Rijswijcklaan Ringfietspad
658,Ringfietspad Jan Van Rijswijcklaan,2022-08-27,10:00:00,47,20,27,FMN 11 A Jan Van Rijswijcklaan Ringfietspad
658,Ringfietspad Jan Van Rijswijcklaan,2022-08-27,11:00:00,63,26,37,FMN 11 A Jan Van Rijswijcklaan Ringfietspad
658,Ringfietspad Jan Van Rijswijcklaan,2022-08-27,12:00:00,61,44,17,FMN 11 A Jan Van Rijswijcklaan Ringfietspad
658,Ringfietspad Jan Van Rijswijcklaan,2022-08-27,13:00:00,65,29,36,FMN 11 A Jan Van Rijswijcklaan Ringfietspad
658,Ringfietspad Jan Van Rijswijcklaan,2022-08-27,14:00:00,81,46,35,FMN 11 A Jan Van Rijswijcklaan Ringfietspad
658,Ringfietspad Jan Van Rijswijcklaan,2022-08-27,15:00:00,59,17,42,FMN 11 A Jan Van Rijswijcklaan Ringfietspad
658,Ringfietspad Jan Van Rijswijcklaan,2022-08-27,16:00:00,51,30,21,FMN 11 A Jan Van Rijswijcklaan Ringfietspad
658,Ringfietspad Jan Van Rijswijcklaan,2022-08-27,17:00:00,39,26,13,FMN 11 A Jan Van Rijswijcklaan Ringfietspad
658,Ringfietspad Jan Van Rijswijcklaan,2022-08-27,18:00:00,41,29,12,FMN 11 A Jan Van Rijswijcklaan Ringfietspad
658,Ringfietspad Jan Van Rijswijcklaan,2022-08-27,19:00:00,20,6,14,FMN 11 A Jan Van Rijswijcklaan Ringfietspad
658,Ringfietspad Jan Van Rijswijcklaan,2022-08-27,20:00:00,28,16,12,FMN 11 A Jan Van Rijswijcklaan Ringfietspad
658,Ringfietspad Jan Van Rijswijcklaan,2022-08-27,21:00:00,16,8,8,FMN 11 A Jan Van Rijswijcklaan Ringfietspad
658,Ringfietspad Jan Van Rijswijcklaan,2022-08-27,22:00:00,16,10,6,FMN 11 A Jan Van Rijswijcklaan Ringfietspad
658,Ringfietspad Jan Van Rijswijcklaan,2022-08-27,23:00:00,10,5,5,FMN 11 A Jan Van Rijswijcklaan Ringfietspad
658,Ringfietspad Jan Van Rijswijcklaan,2022-08-28,00:00:00,11,4,7,FMN 11 A Jan Van Rijswijcklaan Ringfietspad
658,Ringfietspad Jan Van Rijswijcklaan,2022-08-28,01:00:00,0,0,0,FMN 11 A Jan Van Rijswijcklaan Ringfietspad
658,Ringfietspad Jan Van Rijswijcklaan,2022-08-28,02:00:00,2,1,1,FMN 11 A Jan Van Rijswijcklaan Ringfietspad
658,Ringfietspad Jan Van Rijswijcklaan,2022-08-28,03:00:00,5,3,2,FMN 11 A Jan Van Rijswijcklaan Ringfietspad
658,Ringfietspad Jan Van Rijswijcklaan,2022-08-28,04:00:00,1,0,1,FMN 11 A Jan Van Rijswijcklaan Ringfietspad
658,Ringfietspad Jan Van Rijswijcklaan,2022-08-28,05:00:00,2,1,1,FMN 11 A Jan Van Rijswijcklaan Ringfietspad
658,Ringfietspad Jan Van Rijswijcklaan,2022-08-28,06:00:00,7,6,1,FMN 11 A Jan Van Rijswijcklaan Ringfietspad
658,Ringfietspad Jan Van Rijswijcklaan,2022-08-28,07:00:00,8,1,7,FMN 11 A Jan Van Rijswijcklaan Ringfietspad
658,Ringfietspad Jan Van Rijswijcklaan,2022-08-28,08:00:00,14,5,9,FMN 11 A Jan Van Rijswijcklaan Ringfietspad
658,Ringfietspad Jan Van Rijswijcklaan,2022-08-28,09:00:00,42,18,24,FMN 11 A Jan Van Rijswijcklaan Ringfietspad
658,Ringfietspad Jan Van Rijswijcklaan,2022-08-28,10:00:00,49,24,25,FMN 11 A Jan Van Rijswijcklaan Ringfietspad
658,Ringfietspad Jan Van Rijswijcklaan,2022-08-28,11:00:00,30,12,18,FMN 11 A Jan Van Rijswijcklaan Ringfietspad
658,Ringfietspad Jan Van Rijswijcklaan,2022-08-28,12:00:00,52,24,28,FMN 11 A Jan Van Rijswijcklaan Ringfietspad
658,Ringfietspad Jan Van Rijswijcklaan,2022-08-28,13:00:00,71,40,31,FMN 11 A Jan Van Rijswijcklaan Ringfietspad
658,Ringfietspad Jan Van Rijswijcklaan,2022-08-28,14:00:00,76,33,43,FMN 11 A Jan Van Rijswijcklaan Ringfietspad
658,Ringfietspad Jan Van Rijswijcklaan,2022-08-28,15:00:00,85,42,43,FMN 11 A Jan Van Rijswijcklaan Ringfietspad
658,Ringfietspad Jan Van Rijswijcklaan,2022-08-28,16:00:00,86,60,26,FMN 11 A Jan Van Rijswijcklaan Ringfietspad
658,Ringfietspad Jan Van Rijswijcklaan,2022-08-28,17:00:00,94,70,24,FMN 11 A Jan Van Rijswijcklaan Ringfietspad
658,Ringfietspad Jan Van Rijswijcklaan,2022-08-28,18:00:00,61,38,23,FMN 11 A Jan Van Rijswijcklaan Ringfietspad
658,Ringfietspad Jan Van Rijswijcklaan,2022-08-28,19:00:00,40,21,19,FMN 11 A Jan Van Rijswijcklaan Ringfietspad
658,Ringfietspad Jan Van Rijswijcklaan,2022-08-28,20:00:00,35,20,15,FMN 11 A Jan Van Rijswijcklaan Ringfietspad
658,Ringfietspad Jan Van Rijswijcklaan,2022-08-28,21:00:00,31,21,10,FMN 11 A Jan Van Rijswijcklaan Ringfietspad
658,Ringfietspad Jan Van Rijswijcklaan,2022-08-28,22:00:00,17,13,4,FMN 11 A Jan Van Rijswijcklaan Ringfietspad
658,Ringfietspad Jan Van Rijswijcklaan,2022-08-28,23:00:00,7,3,4,FMN 11 A Jan Van Rijswijcklaan Ringfietspad
658,Ringfietspad Jan Van Rijswijcklaan,2022-08-29,00:00:00,3,3,0,FMN 11 A Jan Van Rijswijcklaan Ringfietspad
658,Ringfietspad Jan Van Rijswijcklaan,2022-08-29,01:00:00,0,0,0,FMN 11 A Jan Van Rijswijcklaan Ringfietspad
658,Ringfietspad Jan Van Rijswijcklaan,2022-08-29,02:00:00,1,0,1,FMN 11 A Jan Van Rijswijcklaan Ringfietspad
658,Ringfietspad Jan Van Rijswijcklaan,2022-08-29,03:00:00,5,4,1,FMN 11 A Jan Van Rijswijcklaan Ringfietspad
658,Ringfietspad Jan Van Rijswijcklaan,2022-08-29,04:00:00,4,1,3,FMN 11 A Jan Van Rijswijcklaan Ringfietspad
658,Ringfietspad Jan Van Rijswijcklaan,2022-08-29,05:00:00,24,6,18,FMN 11 A Jan Van Rijswijcklaan Ringfietspad
658,Ringfietspad Jan Van Rijswijcklaan,2022-08-29,06:00:00,61,10,51,FMN 11 A Jan Van Rijswijcklaan Ringfietspad
658,Ringfietspad Jan Van Rijswijcklaan,2022-08-29,07:00:00,107,36,71,FMN 11 A Jan Van Rijswijcklaan Ringfietspad
658,Ringfietspad Jan Van Rijswijcklaan,2022-08-29,08:00:00,136,48,88,FMN 11 A Jan Van Rijswijcklaan Ringfietspad
658,Ringfietspad Jan Van Rijswijcklaan,2022-08-29,09:00:00,60,26,34,FMN 11 A Jan Van Rijswijcklaan Ringfietspad
658,Ringfietspad Jan Van Rijswijcklaan,2022-08-29,10:00:00,30,12,18,FMN 11 A Jan Van Rijswijcklaan Ringfietspad
658,Ringfietspad Jan Van Rijswijcklaan,2022-08-29,11:00:00,29,11,18,FMN 11 A Jan Van Rijswijcklaan Ringfietspad
658,Ringfietspad Jan Van Rijswijcklaan,2022-08-29,12:00:00,57,31,26,FMN 11 A Jan Van Rijswijcklaan Ringfietspad
658,Ringfietspad Jan Van Rijswijcklaan,2022-08-29,13:00:00,58,32,26,FMN 11 A Jan Van Rijswijcklaan Ringfietspad
658,Ringfietspad Jan Van Rijswijcklaan,2022-08-29,14:00:00,65,45,20,FMN 11 A Jan Van Rijswijcklaan Ringfietspad
658,Ringfietspad Jan Van Rijswijcklaan,2022-08-29,15:00:00,106,71,35,FMN 11 A Jan Van Rijswijcklaan Ringfietspad
658,Ringfietspad Jan Van Rijswijcklaan,2022-08-29,16:00:00,139,104,35,FMN 11 A Jan Van Rijswijcklaan Ringfietspad
658,Ringfietspad Jan Van Rijswijcklaan,2022-08-29,17:00:00,134,91,43,FMN 11 A Jan Van Rijswijcklaan Ringfietspad
658,Ringfietspad Jan Van Rijswijcklaan,2022-08-29,18:00:00,79,49,30,FMN 11 A Jan Van Rijswijcklaan Ringfietspad
658,Ringfietspad Jan Van Rijswijcklaan,2022-08-29,19:00:00,43,20,23,FMN 11 A Jan Van Rijswijcklaan Ringfietspad
658,Ringfietspad Jan Van Rijswijcklaan,2022-08-29,20:00:00,26,14,12,FMN 11 A Jan Van Rijswijcklaan Ringfietspad
658,Ringfietspad Jan Van Rijswijcklaan,2022-08-29,21:00:00,28,15,13,FMN 11 A Jan Van Rijswijcklaan Ringfietspad
658,Ringfietspad Jan Van Rijswijcklaan,2022-08-29,22:00:00,25,13,12,FMN 11 A Jan Van Rijswijcklaan Ringfietspad
658,Ringfietspad Jan Van Rijswijcklaan,2022-08-29,23:00:00,13,5,8,FMN 11 A Jan Van Rijswijcklaan Ringfietspad
658,Ringfietspad Jan Van Rijswijcklaan,2022-08-30,00:00:00,1,0,1,FMN 11 A Jan Van Rijswijcklaan Ringfietspad
658,Ringfietspad Jan Van Rijswijcklaan,2022-08-30,01:00:00,3,1,2,FMN 11 A Jan Van Rijswijcklaan Ringfietspad
658,Ringfietspad Jan Van Rijswijcklaan,2022-08-30,02:00:00,4,2,2,FMN 11 A Jan Van Rijswijcklaan Ringfietspad
658,Ringfietspad Jan Van Rijswijcklaan,2022-08-30,03:00:00,1,1,0,FMN 11 A Jan Van Rijswijcklaan Ringfietspad
658,Ringfietspad Jan Van Rijswijcklaan,2022-08-30,04:00:00,3,1,2,FMN 11 A Jan Van Rijswijcklaan Ringfietspad
658,Ringfietspad Jan Van Rijswijcklaan,2022-08-30,05:00:00,29,6,23,FMN 11 A Jan Van Rijswijcklaan Ringfietspad
658,Ringfietspad Jan Van Rijswijcklaan,2022-08-30,06:00:00,66,16,50,FMN 11 A Jan Van Rijswijcklaan Ringfietspad
658,Ringfietspad Jan Van Rijswijcklaan,2022-08-30,07:00:00,129,48,81,FMN 11 A Jan Van Rijswijcklaan Ringfietspad
658,Ringfietspad Jan Van Rijswijcklaan,2022-08-30,08:00:00,169,62,107,FMN 11 A Jan Van Rijswijcklaan Ringfietspad
658,Ringfietspad Jan Van Rijswijcklaan,2022-08-30,09:00:00,63,28,35,FMN 11 A Jan Van Rijswijcklaan Ringfietspad
658,Ringfietspad Jan Van Rijswijcklaan,2022-08-30,10:00:00,56,27,29,FMN 11 A Jan Van Rijswijcklaan Ringfietspad
658,Ringfietspad Jan Van Rijswijcklaan,2022-08-30,11:00:00,43,23,20,FMN 11 A Jan Van Rijswijcklaan Ringfietspad
658,Ringfietspad Jan Van Rijswijcklaan,2022-08-30,12:00:00,67,32,35,FMN 11 A Jan Van Rijswijcklaan Ringfietspad
658,Ringfietspad Jan Van Rijswijcklaan,2022-08-30,13:00:00,62,27,35,FMN 11 A Jan Van Rijswijcklaan Ringfietspad
658,Ringfietspad Jan Van Rijswijcklaan,2022-08-30,14:00:00,69,38,31,FMN 11 A Jan Van Rijswijcklaan Ringfietspad
658,Ringfietspad Jan Van Rijswijcklaan,2022-08-30,15:00:00,76,57,19,FMN 11 A Jan Van Rijswijcklaan Ringfietspad
658,Ringfietspad Jan Van Rijswijcklaan,2022-08-30,16:00:00,173,108,65,FMN 11 A Jan Van Rijswijcklaan Ringfietspad
658,Ringfietspad Jan Van Rijswijcklaan,2022-08-30,17:00:00,196,134,62,FMN 11 A Jan Van Rijswijcklaan Ringfietspad
658,Ringfietspad Jan Van Rijswijcklaan,2022-08-30,18:00:00,102,66,36,FMN 11 A Jan Van Rijswijcklaan Ringfietspad
658,Ringfietspad Jan Van Rijswijcklaan,2022-08-30,19:00:00,40,25,15,FMN 11 A Jan Van Rijswijcklaan Ringfietspad
658,Ringfietspad Jan Van Rijswijcklaan,2022-08-30,20:00:00,32,13,19,FMN 11 A Jan Van Rijswijcklaan Ringfietspad
658,Ringfietspad Jan Van Rijswijcklaan,2022-08-30,21:00:00,24,13,11,FMN 11 A Jan Van Rijswijcklaan Ringfietspad
658,Ringfietspad Jan Van Rijswijcklaan,2022-08-30,22:00:00,28,15,13,FMN 11 A Jan Van Rijswijcklaan Ringfietspad
658,Ringfietspad Jan Van Rijswijcklaan,2022-08-30,23:00:00,9,7,2,FMN 11 A Jan Van Rijswijcklaan Ringfietspad
658,Ringfietspad Jan Van Rijswijcklaan,2022-08-31,00:00:00,4,4,0,FMN 11 A Jan Van Rijswijcklaan Ringfietspad
658,Ringfietspad Jan Van Rijswijcklaan,2022-08-31,01:00:00,0,0,0,FMN 11 A Jan Van Rijswijcklaan Ringfietspad
658,Ringfietspad Jan Van Rijswijcklaan,2022-08-31,02:00:00,1,1,0,FMN 11 A Jan Van Rijswijcklaan Ringfietspad
658,Ringfietspad Jan Van Rijswijcklaan,2022-08-31,03:00:00,2,2,0,FMN 11 A Jan Van Rijswijcklaan Ringfietspad
658,Ringfietspad Jan Van Rijswijcklaan,2022-08-31,04:00:00,6,2,4,FMN 11 A Jan Van Rijswijcklaan Ringfietspad
658,Ringfietspad Jan Van Rijswijcklaan,2022-08-31,05:00:00,34,6,28,FMN 11 A Jan Van Rijswijcklaan Ringfietspad
658,Ringfietspad Jan Van Rijswijcklaan,2022-08-31,06:00:00,65,16,49,FMN 11 A Jan Van Rijswijcklaan Ringfietspad
658,Ringfietspad Jan Van Rijswijcklaan,2022-08-31,07:00:00,120,45,75,FMN 11 A Jan Van Rijswijcklaan Ringfietspad
658,Ringfietspad Jan Van Rijswijcklaan,2022-08-31,08:00:00,116,47,69,FMN 11 A Jan Van Rijswijcklaan Ringfietspad
658,Ringfietspad Jan Van Rijswijcklaan,2022-08-31,09:00:00,65,24,41,FMN 11 A Jan Van Rijswijcklaan Ringfietspad
658,Ringfietspad Jan Van Rijswijcklaan,2022-08-31,10:00:00,42,23,19,FMN 11 A Jan Van Rijswijcklaan Ringfietspad
658,Ringfietspad Jan Van Rijswijcklaan,2022-08-31,11:00:00,40,20,20,FMN 11 A Jan Van Rijswijcklaan Ringfietspad
658,Ringfietspad Jan Van Rijswijcklaan,2022-08-31,12:00:00,59,26,33,FMN 11 A Jan Van Rijswijcklaan Ringfietspad
658,Ringfietspad Jan Van Rijswijcklaan,2022-08-31,13:00:00,72,40,32,FMN 11 A Jan Van Rijswijcklaan Ringfietspad
658,Ringfietspad Jan Van Rijswijcklaan,2022-08-31,14:00:00,74,55,19,FMN 11 A Jan Van Rijswijcklaan Ringfietspad
658,Ringfietspad Jan Van Rijswijcklaan,2022-08-31,15:00:00,97,73,24,FMN 11 A Jan Van Rijswijcklaan Ringfietspad
658,Ringfietspad Jan Van Rijswijcklaan,2022-08-31,16:00:00,123,85,38,FMN 11 A Jan Van Rijswijcklaan Ringfietspad
658,Ringfietspad Jan Van Rijswijcklaan,2022-08-31,17:00:00,136,95,41,FMN 11 A Jan Van Rijswijcklaan Ringfietspad
658,Ringfietspad Jan Van Rijswijcklaan,2022-08-31,18:00:00,101,58,43,FMN 11 A Jan Van Rijswijcklaan Ringfietspad
658,Ringfietspad Jan Van Rijswijcklaan,2022-08-31,19:00:00,41,29,12,FMN 11 A Jan Van Rijswijcklaan Ringfietspad
658,Ringfietspad Jan Van Rijswijcklaan,2022-08-31,20:00:00,41,23,18,FMN 11 A Jan Van Rijswijcklaan Ringfietspad
658,Ringfietspad Jan Van Rijswijcklaan,2022-08-31,21:00:00,26,16,10,FMN 11 A Jan Van Rijswijcklaan Ringfietspad
658,Ringfietspad Jan Van Rijswijcklaan,2022-08-31,22:00:00,17,13,4,FMN 11 A Jan Van Rijswijcklaan Ringfietspad
658,Ringfietspad Jan Van Rijswijcklaan,2022-08-31,23:00:00,11,3,8,FMN 11 A Jan Van Rijswijcklaan Ringfietspad
658,Ringfietspad Jan Van Rijswijcklaan,2022-09-01,00:00:00,6,5,1,FMN 11 A Jan Van Rijswijcklaan Ringfietspad
658,Ringfietspad Jan Van Rijswijcklaan,2022-09-01,01:00:00,1,1,0,FMN 11 A Jan Van Rijswijcklaan Ringfietspad
658,Ringfietspad Jan Van Rijswijcklaan,2022-09-01,02:00:00,3,2,1,FMN 11 A Jan Van Rijswijcklaan Ringfietspad
658,Ringfietspad Jan Van Rijswijcklaan,2022-09-01,03:00:00,1,0,1,FMN 11 A Jan Van Rijswijcklaan Ringfietspad
658,Ringfietspad Jan Van Rijswijcklaan,2022-09-01,04:00:00,4,1,3,FMN 11 A Jan Van Rijswijcklaan Ringfietspad
658,Ringfietspad Jan Van Rijswijcklaan,2022-09-01,05:00:00,25,5,20,FMN 11 A Jan Van Rijswijcklaan Ringfietspad
658,Ringfietspad Jan Van Rijswijcklaan,2022-09-01,06:00:00,62,13,49,FMN 11 A Jan Van Rijswijcklaan Ringfietspad
658,Ringfietspad Jan Van Rijswijcklaan,2022-09-01,07:00:00,131,45,86,FMN 11 A Jan Van Rijswijcklaan Ringfietspad
658,Ringfietspad Jan Van Rijswijcklaan,2022-09-01,08:00:00,208,75,133,FMN 11 A Jan Van Rijswijcklaan Ringfietspad
658,Ringfietspad Jan Van Rijswijcklaan,2022-09-01,09:00:00,85,38,47,FMN 11 A Jan Van Rijswijcklaan Ringfietspad
658,Ringfietspad Jan Van Rijswijcklaan,2022-09-01,10:00:00,51,16,35,FMN 11 A Jan Van Rijswijcklaan Ringfietspad
658,Ringfietspad Jan Van Rijswijcklaan,2022-09-01,11:00:00,48,26,22,FMN 11 A Jan Van Rijswijcklaan Ringfietspad
658,Ringfietspad Jan Van Rijswijcklaan,2022-09-01,12:00:00,65,31,34,FMN 11 A Jan Van Rijswijcklaan Ringfietspad
658,Ringfietspad Jan Van Rijswijcklaan,2022-09-01,13:00:00,79,40,39,FMN 11 A Jan Van Rijswijcklaan Ringfietspad
658,Ringfietspad Jan Van Rijswijcklaan,2022-09-01,14:00:00,73,52,21,FMN 11 A Jan Van Rijswijcklaan Ringfietspad
658,Ringfietspad Jan Van Rijswijcklaan,2022-09-01,15:00:00,114,84,30,FMN 11 A Jan Van Rijswijcklaan Ringfietspad
658,Ringfietspad Jan Van Rijswijcklaan,2022-09-01,16:00:00,162,101,61,FMN 11 A Jan Van Rijswijcklaan Ringfietspad
658,Ringfietspad Jan Van Rijswijcklaan,2022-09-01,17:00:00,154,108,46,FMN 11 A Jan Van Rijswijcklaan Ringfietspad
658,Ringfietspad Jan Van Rijswijcklaan,2022-09-01,18:00:00,101,58,43,FMN 11 A Jan Van Rijswijcklaan Ringfietspad
658,Ringfietspad Jan Van Rijswijcklaan,2022-09-01,19:00:00,37,24,13,FMN 11 A Jan Van Rijswijcklaan Ringfietspad
658,Ringfietspad Jan Van Rijswijcklaan,2022-09-01,20:00:00,41,15,26,FMN 11 A Jan Van Rijswijcklaan Ringfietspad
658,Ringfietspad Jan Van Rijswijcklaan,2022-09-01,21:00:00,28,12,16,FMN 11 A Jan Van Rijswijcklaan Ringfietspad
658,Ringfietspad Jan Van Rijswijcklaan,2022-09-01,22:00:00,23,15,8,FMN 11 A Jan Van Rijswijcklaan Ringfietspad
658,Ringfietspad Jan Van Rijswijcklaan,2022-09-01,23:00:00,12,4,8,FMN 11 A Jan Van Rijswijcklaan Ringfietspad
658,Ringfietspad Jan Van Rijswijcklaan,2022-09-02,00:00:00,3,3,0,FMN 11 A Jan Van Rijswijcklaan Ringfietspad
658,Ringfietspad Jan Van Rijswijcklaan,2022-09-02,01:00:00,2,1,1,FMN 11 A Jan Van Rijswijcklaan Ringfietspad
658,Ringfietspad Jan Van Rijswijcklaan,2022-09-02,02:00:00,2,2,0,FMN 11 A Jan Van Rijswijcklaan Ringfietspad
658,Ringfietspad Jan Van Rijswijcklaan,2022-09-02,03:00:00,2,0,2,FMN 11 A Jan Van Rijswijcklaan Ringfietspad
658,Ringfietspad Jan Van Rijswijcklaan,2022-09-02,04:00:00,3,1,2,FMN 11 A Jan Van Rijswijcklaan Ringfietspad
658,Ringfietspad Jan Van Rijswijcklaan,2022-09-02,05:00:00,24,4,20,FMN 11 A Jan Van Rijswijcklaan Ringfietspad
658,Ringfietspad Jan Van Rijswijcklaan,2022-09-02,06:00:00,61,16,45,FMN 11 A Jan Van Rijswijcklaan Ringfietspad
658,Ringfietspad Jan Van Rijswijcklaan,2022-09-02,07:00:00,113,49,64,FMN 11 A Jan Van Rijswijcklaan Ringfietspad
658,Ringfietspad Jan Van Rijswijcklaan,2022-09-02,08:00:00,181,71,110,FMN 11 A Jan Van Rijswijcklaan Ringfietspad
658,Ringfietspad Jan Van Rijswijcklaan,2022-09-02,09:00:00,48,20,28,FMN 11 A Jan Van Rijswijcklaan Ringfietspad
658,Ringfietspad Jan Van Rijswijcklaan,2022-09-02,10:00:00,50,26,24,FMN 11 A Jan Van Rijswijcklaan Ringfietspad
658,Ringfietspad Jan Van Rijswijcklaan,2022-09-02,11:00:00,43,18,25,FMN 11 A Jan Van Rijswijcklaan Ringfietspad
658,Ringfietspad Jan Van Rijswijcklaan,2022-09-02,12:00:00,71,39,32,FMN 11 A Jan Van Rijswijcklaan Ringfietspad
658,Ringfietspad Jan Van Rijswijcklaan,2022-09-02,13:00:00,69,34,35,FMN 11 A Jan Van Rijswijcklaan Ringfietspad
658,Ringfietspad Jan Van Rijswijcklaan,2022-09-02,14:00:00,94,48,46,FMN 11 A Jan Van Rijswijcklaan Ringfietspad
658,Ringfietspad Jan Van Rijswijcklaan,2022-09-02,15:00:00,111,83,28,FMN 11 A Jan Van Rijswijcklaan Ringfietspad
658,Ringfietspad Jan Van Rijswijcklaan,2022-09-02,16:00:00,137,87,50,FMN 11 A Jan Van Rijswijcklaan Ringfietspad
658,Ringfietspad Jan Van Rijswijcklaan,2022-09-02,17:00:00,107,71,36,FMN 11 A Jan Van Rijswijcklaan Ringfietspad
658,Ringfietspad Jan Van Rijswijcklaan,2022-09-02,18:00:00,72,52,20,FMN 11 A Jan Van Rijswijcklaan Ringfietspad
658,Ringfietspad Jan Van Rijswijcklaan,2022-09-02,19:00:00,38,20,18,FMN 11 A Jan Van Rijswijcklaan Ringfietspad
658,Ringfietspad Jan Van Rijswijcklaan,2022-09-02,20:00:00,31,14,17,FMN 11 A Jan Van Rijswijcklaan Ringfietspad
658,Ringfietspad Jan Van Rijswijcklaan,2022-09-02,21:00:00,23,13,10,FMN 11 A Jan Van Rijswijcklaan Ringfietspad
658,Ringfietspad Jan Van Rijswijcklaan,2022-09-02,22:00:00,19,8,11,FMN 11 A Jan Van Rijswijcklaan Ringfietspad
658,Ringfietspad Jan Van Rijswijcklaan,2022-09-02,23:00:00,10,5,5,FMN 11 A Jan Van Rijswijcklaan Ringfietspad
658,Ringfietspad Jan Van Rijswijcklaan,2022-09-03,00:00:00,7,4,3,FMN 11 A Jan Van Rijswijcklaan Ringfietspad
658,Ringfietspad Jan Van Rijswijcklaan,2022-09-03,01:00:00,3,2,1,FMN 11 A Jan Van Rijswijcklaan Ringfietspad
658,Ringfietspad Jan Van Rijswijcklaan,2022-09-03,02:00:00,7,7,0,FMN 11 A Jan Van Rijswijcklaan Ringfietspad
658,Ringfietspad Jan Van Rijswijcklaan,2022-09-03,03:00:00,4,2,2,FMN 11 A Jan Van Rijswijcklaan Ringfietspad
658,Ringfietspad Jan Van Rijswijcklaan,2022-09-03,04:00:00,0,0,0,FMN 11 A Jan Van Rijswijcklaan Ringfietspad
658,Ringfietspad Jan Van Rijswijcklaan,2022-09-03,05:00:00,10,3,7,FMN 11 A Jan Van Rijswijcklaan Ringfietspad
658,Ringfietspad Jan Van Rijswijcklaan,2022-09-03,06:00:00,8,5,3,FMN 11 A Jan Van Rijswijcklaan Ringfietspad
658,Ringfietspad Jan Van Rijswijcklaan,2022-09-03,07:00:00,9,2,7,FMN 11 A Jan Van Rijswijcklaan Ringfietspad
658,Ringfietspad Jan Van Rijswijcklaan,2022-09-03,08:00:00,12,9,3,FMN 11 A Jan Van Rijswijcklaan Ringfietspad
658,Ringfietspad Jan Van Rijswijcklaan,2022-09-03,09:00:00,39,20,19,FMN 11 A Jan Van Rijswijcklaan Ringfietspad
658,Ringfietspad Jan Van Rijswijcklaan,2022-09-03,10:00:00,41,20,21,FMN 11 A Jan Van Rijswijcklaan Ringfietspad
658,Ringfietspad Jan Van Rijswijcklaan,2022-09-03,11:00:00,43,25,18,FMN 11 A Jan Van Rijswijcklaan Ringfietspad
658,Ringfietspad Jan Van Rijswijcklaan,2022-09-03,12:00:00,37,18,19,FMN 11 A Jan Van Rijswijcklaan Ringfietspad
658,Ringfietspad Jan Van Rijswijcklaan,2022-09-03,13:00:00,44,29,15,FMN 11 A Jan Van Rijswijcklaan Ringfietspad
658,Ringfietspad Jan Van Rijswijcklaan,2022-09-03,14:00:00,46,22,24,FMN 11 A Jan Van Rijswijcklaan Ringfietspad
658,Ringfietspad Jan Van Rijswijcklaan,2022-09-03,15:00:00,41,26,15,FMN 11 A Jan Van Rijswijcklaan Ringfietspad
658,Ringfietspad Jan Van Rijswijcklaan,2022-09-03,16:00:00,53,19,34,FMN 11 A Jan Van Rijswijcklaan Ringfietspad
658,Ringfietspad Jan Van Rijswijcklaan,2022-09-03,17:00:00,33,23,10,FMN 11 A Jan Van Rijswijcklaan Ringfietspad
658,Ringfietspad Jan Van Rijswijcklaan,2022-09-03,18:00:00,27,17,10,FMN 11 A Jan Van Rijswijcklaan Ringfietspad
658,Ringfietspad Jan Van Rijswijcklaan,2022-09-03,19:00:00,31,18,13,FMN 11 A Jan Van Rijswijcklaan Ringfietspad
658,Ringfietspad Jan Van Rijswijcklaan,2022-09-03,20:00:00,23,16,7,FMN 11 A Jan Van Rijswijcklaan Ringfietspad
658,Ringfietspad Jan Van Rijswijcklaan,2022-09-03,21:00:00,18,9,9,FMN 11 A Jan Van Rijswijcklaan Ringfietspad
658,Ringfietspad Jan Van Rijswijcklaan,2022-09-03,22:00:00,10,7,3,FMN 11 A Jan Van Rijswijcklaan Ringfietspad
658,Ringfietspad Jan Van Rijswijcklaan,2022-09-03,23:00:00,4,2,2,FMN 11 A Jan Van Rijswijcklaan Ringfietspad
658,Ringfietspad Jan Van Rijswijcklaan,2022-09-04,00:00:00,11,6,5,FMN 11 A Jan Van Rijswijcklaan Ringfietspad
658,Ringfietspad Jan Van Rijswijcklaan,2022-09-04,01:00:00,4,0,4,FMN 11 A Jan Van Rijswijcklaan Ringfietspad
658,Ringfietspad Jan Van Rijswijcklaan,2022-09-04,02:00:00,3,2,1,FMN 11 A Jan Van Rijswijcklaan Ringfietspad
658,Ringfietspad Jan Van Rijswijcklaan,2022-09-04,03:00:00,7,6,1,FMN 11 A Jan Van Rijswijcklaan Ringfietspad
658,Ringfietspad Jan Van Rijswijcklaan,2022-09-04,04:00:00,2,2,0,FMN 11 A Jan Van Rijswijcklaan Ringfietspad
658,Ringfietspad Jan Van Rijswijcklaan,2022-09-04,05:00:00,4,2,2,FMN 11 A Jan Van Rijswijcklaan Ringfietspad
658,Ringfietspad Jan Van Rijswijcklaan,2022-09-04,06:00:00,9,5,4,FMN 11 A Jan Van Rijswijcklaan Ringfietspad
658,Ringfietspad Jan Van Rijswijcklaan,2022-09-04,07:00:00,8,4,4,FMN 11 A Jan Van Rijswijcklaan Ringfietspad
658,Ringfietspad Jan Van Rijswijcklaan,2022-09-04,08:00:00,29,10,19,FMN 11 A Jan Van Rijswijcklaan Ringfietspad
658,Ringfietspad Jan Van Rijswijcklaan,2022-09-04,09:00:00,51,18,33,FMN 11 A Jan Van Rijswijcklaan Ringfietspad
658,Ringfietspad Jan Van Rijswijcklaan,2022-09-04,10:00:00,77,33,44,FMN 11 A Jan Van Rijswijcklaan Ringfietspad
658,Ringfietspad Jan Van Rijswijcklaan,2022-09-04,11:00:00,52,37,15,FMN 11 A Jan Van Rijswijcklaan Ringfietspad
658,Ringfietspad Jan Van Rijswijcklaan,2022-09-04,12:00:00,66,34,32,FMN 11 A Jan Van Rijswijcklaan Ringfietspad
658,Ringfietspad Jan Van Rijswijcklaan,2022-09-04,13:00:00,95,59,36,FMN 11 A Jan Van Rijswijcklaan Ringfietspad
658,Ringfietspad Jan Van Rijswijcklaan,2022-09-04,14:00:00,88,48,40,FMN 11 A Jan Van Rijswijcklaan Ringfietspad
658,Ringfietspad Jan Van Rijswijcklaan,2022-09-04,15:00:00,86,54,32,FMN 11 A Jan Van Rijswijcklaan Ringfietspad
658,Ringfietspad Jan Van Rijswijcklaan,2022-09-04,16:00:00,58,17,41,FMN 11 A Jan Van Rijswijcklaan Ringfietspad
658,Ringfietspad Jan Van Rijswijcklaan,2022-09-04,17:00:00,65,30,35,FMN 11 A Jan Van Rijswijcklaan Ringfietspad
658,Ringfietspad Jan Van Rijswijcklaan,2022-09-04,18:00:00,49,29,20,FMN 11 A Jan Van Rijswijcklaan Ringfietspad
658,Ringfietspad Jan Van Rijswijcklaan,2022-09-04,19:00:00,32,11,21,FMN 11 A Jan Van Rijswijcklaan Ringfietspad
658,Ringfietspad Jan Van Rijswijcklaan,2022-09-04,20:00:00,32,16,16,FMN 11 A Jan Van Rijswijcklaan Ringfietspad
658,Ringfietspad Jan Van Rijswijcklaan,2022-09-04,21:00:00,15,11,4,FMN 11 A Jan Van Rijswijcklaan Ringfietspad
658,Ringfietspad Jan Van Rijswijcklaan,2022-09-04,22:00:00,11,8,3,FMN 11 A Jan Van Rijswijcklaan Ringfietspad
658,Ringfietspad Jan Van Rijswijcklaan,2022-09-04,23:00:00,6,4,2,FMN 11 A Jan Van Rijswijcklaan Ringfietspad
658,Ringfietspad Jan Van Rijswijcklaan,2022-09-05,00:00:00,3,3,0,FMN 11 A Jan Van Rijswijcklaan Ringfietspad
658,Ringfietspad Jan Van Rijswijcklaan,2022-09-05,01:00:00,1,0,1,FMN 11 A Jan Van Rijswijcklaan Ringfietspad
658,Ringfietspad Jan Van Rijswijcklaan,2022-09-05,02:00:00,2,1,1,FMN 11 A Jan Van Rijswijcklaan Ringfietspad
658,Ringfietspad Jan Van Rijswijcklaan,2022-09-05,03:00:00,2,1,1,FMN 11 A Jan Van Rijswijcklaan Ringfietspad
658,Ringfietspad Jan Van Rijswijcklaan,2022-09-05,04:00:00,6,2,4,FMN 11 A Jan Van Rijswijcklaan Ringfietspad
658,Ringfietspad Jan Van Rijswijcklaan,2022-09-05,05:00:00,29,6,23,FMN 11 A Jan Van Rijswijcklaan Ringfietspad
658,Ringfietspad Jan Van Rijswijcklaan,2022-09-05,06:00:00,57,14,43,FMN 11 A Jan Van Rijswijcklaan Ringfietspad
658,Ringfietspad Jan Van Rijswijcklaan,2022-09-05,07:00:00,140,68,72,FMN 11 A Jan Van Rijswijcklaan Ringfietspad
658,Ringfietspad Jan Van Rijswijcklaan,2022-09-05,08:00:00,178,63,115,FMN 11 A Jan Van Rijswijcklaan Ringfietspad
658,Ringfietspad Jan Van Rijswijcklaan,2022-09-05,09:00:00,60,24,36,FMN 11 A Jan Van Rijswijcklaan Ringfietspad
658,Ringfietspad Jan Van Rijswijcklaan,2022-09-05,10:00:00,33,19,14,FMN 11 A Jan Van Rijswijcklaan Ringfietspad
658,Ringfietspad Jan Van Rijswijcklaan,2022-09-05,11:00:00,41,21,20,FMN 11 A Jan Van Rijswijcklaan Ringfietspad
658,Ringfietspad Jan Van Rijswijcklaan,2022-09-05,12:00:00,64,37,27,FMN 11 A Jan Van Rijswijcklaan Ringfietspad
658,Ringfietspad Jan Van Rijswijcklaan,2022-09-05,13:00:00,80,35,45,FMN 11 A Jan Van Rijswijcklaan Ringfietspad
658,Ringfietspad Jan Van Rijswijcklaan,2022-09-05,14:00:00,55,30,25,FMN 11 A Jan Van Rijswijcklaan Ringfietspad
658,Ringfietspad Jan Van Rijswijcklaan,2022-09-05,15:00:00,104,65,39,FMN 11 A Jan Van Rijswijcklaan Ringfietspad
658,Ringfietspad Jan Van Rijswijcklaan,2022-09-05,16:00:00,182,124,58,FMN 11 A Jan Van Rijswijcklaan Ringfietspad
658,Ringfietspad Jan Van Rijswijcklaan,2022-09-05,17:00:00,153,97,56,FMN 11 A Jan Van Rijswijcklaan Ringfietspad
658,Ringfietspad Jan Van Rijswijcklaan,2022-09-05,18:00:00,78,50,28,FMN 11 A Jan Van Rijswijcklaan Ringfietspad
658,Ringfietspad Jan Van Rijswijcklaan,2022-09-05,19:00:00,32,14,18,FMN 11 A Jan Van Rijswijcklaan Ringfietspad
658,Ringfietspad Jan Van Rijswijcklaan,2022-09-05,20:00:00,28,12,16,FMN 11 A Jan Van Rijswijcklaan Ringfietspad
658,Ringfietspad Jan Van Rijswijcklaan,2022-09-05,21:00:00,13,4,9,FMN 11 A Jan Van Rijswijcklaan Ringfietspad
658,Ringfietspad Jan Van Rijswijcklaan,2022-09-05,22:00:00,21,20,1,FMN 11 A Jan Van Rijswijcklaan Ringfietspad
658,Ringfietspad Jan Van Rijswijcklaan,2022-09-05,23:00:00,6,4,2,FMN 11 A Jan Van Rijswijcklaan Ringfietspad
658,Ringfietspad Jan Van Rijswijcklaan,2022-09-06,00:00:00,0,0,0,FMN 11 A Jan Van Rijswijcklaan Ringfietspad
658,Ringfietspad Jan Van Rijswijcklaan,2022-09-06,01:00:00,0,0,0,FMN 11 A Jan Van Rijswijcklaan Ringfietspad
658,Ringfietspad Jan Van Rijswijcklaan,2022-09-06,02:00:00,3,2,1,FMN 11 A Jan Van Rijswijcklaan Ringfietspad
658,Ringfietspad Jan Van Rijswijcklaan,2022-09-06,03:00:00,2,1,1,FMN 11 A Jan Van Rijswijcklaan Ringfietspad
658,Ringfietspad Jan Van Rijswijcklaan,2022-09-06,04:00:00,5,2,3,FMN 11 A Jan Van Rijswijcklaan Ringfietspad
658,Ringfietspad Jan Van Rijswijcklaan,2022-09-06,05:00:00,38,9,29,FMN 11 A Jan Van Rijswijcklaan Ringfietspad
658,Ringfietspad Jan Van Rijswijcklaan,2022-09-06,06:00:00,56,15,41,FMN 11 A Jan Van Rijswijcklaan Ringfietspad
658,Ringfietspad Jan Van Rijswijcklaan,2022-09-06,07:00:00,138,48,90,FMN 11 A Jan Van Rijswijcklaan Ringfietspad
658,Ringfietspad Jan Van Rijswijcklaan,2022-09-06,08:00:00,214,97,117,FMN 11 A Jan Van Rijswijcklaan Ringfietspad
658,Ringfietspad Jan Van Rijswijcklaan,2022-09-06,09:00:00,77,31,46,FMN 11 A Jan Van Rijswijcklaan Ringfietspad
658,Ringfietspad Jan Van Rijswijcklaan,2022-09-06,10:00:00,33,13,20,FMN 11 A Jan Van Rijswijcklaan Ringfietspad
658,Ringfietspad Jan Van Rijswijcklaan,2022-09-06,11:00:00,24,17,7,FMN 11 A Jan Van Rijswijcklaan Ringfietspad
658,Ringfietspad Jan Van Rijswijcklaan,2022-09-06,12:00:00,63,31,32,FMN 11 A Jan Van Rijswijcklaan Ringfietspad
658,Ringfietspad Jan Van Rijswijcklaan,2022-09-06,13:00:00,69,29,40,FMN 11 A Jan Van Rijswijcklaan Ringfietspad
658,Ringfietspad Jan Van Rijswijcklaan,2022-09-06,14:00:00,79,57,22,FMN 11 A Jan Van Rijswijcklaan Ringfietspad
658,Ringfietspad Jan Van Rijswijcklaan,2022-09-06,15:00:00,90,66,24,FMN 11 A Jan Van Rijswijcklaan Ringfietspad
658,Ringfietspad Jan Van Rijswijcklaan,2022-09-06,16:00:00,174,116,58,FMN 11 A Jan Van Rijswijcklaan Ringfietspad
658,Ringfietspad Jan Van Rijswijcklaan,2022-09-06,17:00:00,180,112,68,FMN 11 A Jan Van Rijswijcklaan Ringfietspad
658,Ringfietspad Jan Van Rijswijcklaan,2022-09-06,18:00:00,92,62,30,FMN 11 A Jan Van Rijswijcklaan Ringfietspad
658,Ringfietspad Jan Van Rijswijcklaan,2022-09-06,19:00:00,38,23,15,FMN 11 A Jan Van Rijswijcklaan Ringfietspad
658,Ringfietspad Jan Van Rijswijcklaan,2022-09-06,20:00:00,40,21,19,FMN 11 A Jan Van Rijswijcklaan Ringfietspad
658,Ringfietspad Jan Van Rijswijcklaan,2022-09-06,21:00:00,26,14,12,FMN 11 A Jan Van Rijswijcklaan Ringfietspad
658,Ringfietspad Jan Van Rijswijcklaan,2022-09-06,22:00:00,15,13,2,FMN 11 A Jan Van Rijswijcklaan Ringfietspad
658,Ringfietspad Jan Van Rijswijcklaan,2022-09-06,23:00:00,6,4,2,FMN 11 A Jan Van Rijswijcklaan Ringfietspad
658,Ringfietspad Jan Van Rijswijcklaan,2022-09-07,00:00:00,4,2,2,FMN 11 A Jan Van Rijswijcklaan Ringfietspad
658,Ringfietspad Jan Van Rijswijcklaan,2022-09-07,01:00:00,0,0,0,FMN 11 A Jan Van Rijswijcklaan Ringfietspad
658,Ringfietspad Jan Van Rijswijcklaan,2022-09-07,02:00:00,3,2,1,FMN 11 A Jan Van Rijswijcklaan Ringfietspad
658,Ringfietspad Jan Van Rijswijcklaan,2022-09-07,03:00:00,2,1,1,FMN 11 A Jan Van Rijswijcklaan Ringfietspad
658,Ringfietspad Jan Van Rijswijcklaan,2022-09-07,04:00:00,5,1,4,FMN 11 A Jan Van Rijswijcklaan Ringfietspad
658,Ringfietspad Jan Van Rijswijcklaan,2022-09-07,05:00:00,34,9,25,FMN 11 A Jan Van Rijswijcklaan Ringfietspad
658,Ringfietspad Jan Van Rijswijcklaan,2022-09-07,06:00:00,62,15,47,FMN 11 A Jan Van Rijswijcklaan Ringfietspad
658,Ringfietspad Jan Van Rijswijcklaan,2022-09-07,07:00:00,115,41,74,FMN 11 A Jan Van Rijswijcklaan Ringfietspad
658,Ringfietspad Jan Van Rijswijcklaan,2022-09-07,08:00:00,153,58,95,FMN 11 A Jan Van Rijswijcklaan Ringfietspad
658,Ringfietspad Jan Van Rijswijcklaan,2022-09-07,09:00:00,55,24,31,FMN 11 A Jan Van Rijswijcklaan Ringfietspad
658,Ringfietspad Jan Van Rijswijcklaan,2022-09-07,10:00:00,27,14,13,FMN 11 A Jan Van Rijswijcklaan Ringfietspad
658,Ringfietspad Jan Van Rijswijcklaan,2022-09-07,11:00:00,40,19,21,FMN 11 A Jan Van Rijswijcklaan Ringfietspad
658,Ringfietspad Jan Van Rijswijcklaan,2022-09-07,12:00:00,79,51,28,FMN 11 A Jan Van Rijswijcklaan Ringfietspad
658,Ringfietspad Jan Van Rijswijcklaan,2022-09-07,13:00:00,78,33,45,FMN 11 A Jan Van Rijswijcklaan Ringfietspad
658,Ringfietspad Jan Van Rijswijcklaan,2022-09-07,14:00:00,63,37,26,FMN 11 A Jan Van Rijswijcklaan Ringfietspad
658,Ringfietspad Jan Van Rijswijcklaan,2022-09-07,15:00:00,71,49,22,FMN 11 A Jan Van Rijswijcklaan Ringfietspad
658,Ringfietspad Jan Van Rijswijcklaan,2022-09-07,16:00:00,114,81,33,FMN 11 A Jan Van Rijswijcklaan Ringfietspad
658,Ringfietspad Jan Van Rijswijcklaan,2022-09-07,17:00:00,134,91,43,FMN 11 A Jan Van Rijswijcklaan Ringfietspad
658,Ringfietspad Jan Van Rijswijcklaan,2022-09-07,18:00:00,88,48,40,FMN 11 A Jan Van Rijswijcklaan Ringfietspad
658,Ringfietspad Jan Van Rijswijcklaan,2022-09-07,19:00:00,46,32,14,FMN 11 A Jan Van Rijswijcklaan Ringfietspad
658,Ringfietspad Jan Van Rijswijcklaan,2022-09-07,20:00:00,30,17,13,FMN 11 A Jan Van Rijswijcklaan Ringfietspad
658,Ringfietspad Jan Van Rijswijcklaan,2022-09-07,21:00:00,19,7,12,FMN 11 A Jan Van Rijswijcklaan Ringfietspad
658,Ringfietspad Jan Van Rijswijcklaan,2022-09-07,22:00:00,35,20,15,FMN 11 A Jan Van Rijswijcklaan Ringfietspad
658,Ringfietspad Jan Van Rijswijcklaan,2022-09-07,23:00:00,7,4,3,FMN 11 A Jan Van Rijswijcklaan Ringfietspad
658,Ringfietspad Jan Van Rijswijcklaan,2022-09-08,00:00:00,5,3,2,FMN 11 A Jan Van Rijswijcklaan Ringfietspad
658,Ringfietspad Jan Van Rijswijcklaan,2022-09-08,01:00:00,1,1,0,FMN 11 A Jan Van Rijswijcklaan Ringfietspad
658,Ringfietspad Jan Van Rijswijcklaan,2022-09-08,02:00:00,3,2,1,FMN 11 A Jan Van Rijswijcklaan Ringfietspad
658,Ringfietspad Jan Van Rijswijcklaan,2022-09-08,03:00:00,0,0,0,FMN 11 A Jan Van Rijswijcklaan Ringfietspad
658,Ringfietspad Jan Van Rijswijcklaan,2022-09-08,04:00:00,4,2,2,FMN 11 A Jan Van Rijswijcklaan Ringfietspad
658,Ringfietspad Jan Van Rijswijcklaan,2022-09-08,05:00:00,30,6,24,FMN 11 A Jan Van Rijswijcklaan Ringfietspad
658,Ringfietspad Jan Van Rijswijcklaan,2022-09-08,06:00:00,36,8,28,FMN 11 A Jan Van Rijswijcklaan Ringfietspad
658,Ringfietspad Jan Van Rijswijcklaan,2022-09-08,07:00:00,101,34,67,FMN 11 A Jan Van Rijswijcklaan Ringfietspad
658,Ringfietspad Jan Van Rijswijcklaan,2022-09-08,08:00:00,175,63,112,FMN 11 A Jan Van Rijswijcklaan Ringfietspad
658,Ringfietspad Jan Van Rijswijcklaan,2022-09-08,09:00:00,44,19,25,FMN 11 A Jan Van Rijswijcklaan Ringfietspad
658,Ringfietspad Jan Van Rijswijcklaan,2022-09-08,10:00:00,26,13,13,FMN 11 A Jan Van Rijswijcklaan Ringfietspad
658,Ringfietspad Jan Van Rijswijcklaan,2022-09-08,11:00:00,32,12,20,FMN 11 A Jan Van Rijswijcklaan Ringfietspad
658,Ringfietspad Jan Van Rijswijcklaan,2022-09-08,12:00:00,60,36,24,FMN 11 A Jan Van Rijswijcklaan Ringfietspad
658,Ringfietspad Jan Van Rijswijcklaan,2022-09-08,13:00:00,60,25,35,FMN 11 A Jan Van Rijswijcklaan Ringfietspad
658,Ringfietspad Jan Van Rijswijcklaan,2022-09-08,14:00:00,58,33,25,FMN 11 A Jan Van Rijswijcklaan Ringfietspad
658,Ringfietspad Jan Van Rijswijcklaan,2022-09-08,15:00:00,82,56,26,FMN 11 A Jan Van Rijswijcklaan Ringfietspad
658,Ringfietspad Jan Van Rijswijcklaan,2022-09-08,16:00:00,139,104,35,FMN 11 A Jan Van Rijswijcklaan Ringfietspad
658,Ringfietspad Jan Van Rijswijcklaan,2022-09-08,17:00:00,137,100,37,FMN 11 A Jan Van Rijswijcklaan Ringfietspad
658,Ringfietspad Jan Van Rijswijcklaan,2022-09-08,18:00:00,53,29,24,FMN 11 A Jan Van Rijswijcklaan Ringfietspad
658,Ringfietspad Jan Van Rijswijcklaan,2022-09-08,19:00:00,35,18,17,FMN 11 A Jan Van Rijswijcklaan Ringfietspad
658,Ringfietspad Jan Van Rijswijcklaan,2022-09-08,20:00:00,15,8,7,FMN 11 A Jan Van Rijswijcklaan Ringfietspad
658,Ringfietspad Jan Van Rijswijcklaan,2022-09-08,21:00:00,21,8,13,FMN 11 A Jan Van Rijswijcklaan Ringfietspad
658,Ringfietspad Jan Van Rijswijcklaan,2022-09-08,22:00:00,25,17,8,FMN 11 A Jan Van Rijswijcklaan Ringfietspad
658,Ringfietspad Jan Van Rijswijcklaan,2022-09-08,23:00:00,6,3,3,FMN 11 A Jan Van Rijswijcklaan Ringfietspad
658,Ringfietspad Jan Van Rijswijcklaan,2022-09-09,00:00:00,3,1,2,FMN 11 A Jan Van Rijswijcklaan Ringfietspad
658,Ringfietspad Jan Van Rijswijcklaan,2022-09-09,01:00:00,4,3,1,FMN 11 A Jan Van Rijswijcklaan Ringfietspad
658,Ringfietspad Jan Van Rijswijcklaan,2022-09-09,02:00:00,2,2,0,FMN 11 A Jan Van Rijswijcklaan Ringfietspad
658,Ringfietspad Jan Van Rijswijcklaan,2022-09-09,03:00:00,1,0,1,FMN 11 A Jan Van Rijswijcklaan Ringfietspad
658,Ringfietspad Jan Van Rijswijcklaan,2022-09-09,04:00:00,3,1,2,FMN 11 A Jan Van Rijswijcklaan Ringfietspad
658,Ringfietspad Jan Van Rijswijcklaan,2022-09-09,05:00:00,21,4,17,FMN 11 A Jan Van Rijswijcklaan Ringfietspad
658,Ringfietspad Jan Van Rijswijcklaan,2022-09-09,06:00:00,43,8,35,FMN 11 A Jan Van Rijswijcklaan Ringfietspad
658,Ringfietspad Jan Van Rijswijcklaan,2022-09-09,07:00:00,76,26,50,FMN 11 A Jan Van Rijswijcklaan Ringfietspad
658,Ringfietspad Jan Van Rijswijcklaan,2022-09-09,08:00:00,132,43,89,FMN 11 A Jan Van Rijswijcklaan Ringfietspad
658,Ringfietspad Jan Van Rijswijcklaan,2022-09-09,09:00:00,37,15,22,FMN 11 A Jan Van Rijswijcklaan Ringfietspad
658,Ringfietspad Jan Van Rijswijcklaan,2022-09-09,10:00:00,17,13,4,FMN 11 A Jan Van Rijswijcklaan Ringfietspad
658,Ringfietspad Jan Van Rijswijcklaan,2022-09-09,11:00:00,22,12,10,FMN 11 A Jan Van Rijswijcklaan Ringfietspad
658,Ringfietspad Jan Van Rijswijcklaan,2022-09-09,12:00:00,38,28,10,FMN 11 A Jan Van Rijswijcklaan Ringfietspad
658,Ringfietspad Jan Van Rijswijcklaan,2022-09-09,13:00:00,72,24,48,FMN 11 A Jan Van Rijswijcklaan Ringfietspad
658,Ringfietspad Jan Van Rijswijcklaan,2022-09-09,14:00:00,39,27,12,FMN 11 A Jan Van Rijswijcklaan Ringfietspad
658,Ringfietspad Jan Van Rijswijcklaan,2022-09-09,15:00:00,70,56,14,FMN 11 A Jan Van Rijswijcklaan Ringfietspad
658,Ringfietspad Jan Van Rijswijcklaan,2022-09-09,16:00:00,94,64,30,FMN 11 A Jan Van Rijswijcklaan Ringfietspad
658,Ringfietspad Jan Van Rijswijcklaan,2022-09-09,17:00:00,81,64,17,FMN 11 A Jan Van Rijswijcklaan Ringfietspad
658,Ringfietspad Jan Van Rijswijcklaan,2022-09-09,18:00:00,48,32,16,FMN 11 A Jan Van Rijswijcklaan Ringfietspad
658,Ringfietspad Jan Van Rijswijcklaan,2022-09-09,19:00:00,27,12,15,FMN 11 A Jan Van Rijswijcklaan Ringfietspad
658,Ringfietspad Jan Van Rijswijcklaan,2022-09-09,20:00:00,18,4,14,FMN 11 A Jan Van Rijswijcklaan Ringfietspad
658,Ringfietspad Jan Van Rijswijcklaan,2022-09-09,21:00:00,18,11,7,FMN 11 A Jan Van Rijswijcklaan Ringfietspad
658,Ringfietspad Jan Van Rijswijcklaan,2022-09-09,22:00:00,17,11,6,FMN 11 A Jan Van Rijswijcklaan Ringfietspad
658,Ringfietspad Jan Van Rijswijcklaan,2022-09-09,23:00:00,7,4,3,FMN 11 A Jan Van Rijswijcklaan Ringfietspad
658,Ringfietspad Jan Van Rijswijcklaan,2022-09-10,00:00:00,6,2,4,FMN 11 A Jan Van Rijswijcklaan Ringfietspad
658,Ringfietspad Jan Van Rijswijcklaan,2022-09-10,01:00:00,2,2,0,FMN 11 A Jan Van Rijswijcklaan Ringfietspad
658,Ringfietspad Jan Van Rijswijcklaan,2022-09-10,02:00:00,2,2,0,FMN 11 A Jan Van Rijswijcklaan Ringfietspad
658,Ringfietspad Jan Van Rijswijcklaan,2022-09-10,03:00:00,3,1,2,FMN 11 A Jan Van Rijswijcklaan Ringfietspad
658,Ringfietspad Jan Van Rijswijcklaan,2022-09-10,04:00:00,4,1,3,FMN 11 A Jan Van Rijswijcklaan Ringfietspad
658,Ringfietspad Jan Van Rijswijcklaan,2022-09-10,05:00:00,1,1,0,FMN 11 A Jan Van Rijswijcklaan Ringfietspad
658,Ringfietspad Jan Van Rijswijcklaan,2022-09-10,06:00:00,6,4,2,FMN 11 A Jan Van Rijswijcklaan Ringfietspad
658,Ringfietspad Jan Van Rijswijcklaan,2022-09-10,07:00:00,8,5,3,FMN 11 A Jan Van Rijswijcklaan Ringfietspad
658,Ringfietspad Jan Van Rijswijcklaan,2022-09-10,08:00:00,6,2,4,FMN 11 A Jan Van Rijswijcklaan Ringfietspad
658,Ringfietspad Jan Van Rijswijcklaan,2022-09-10,09:00:00,6,5,1,FMN 11 A Jan Van Rijswijcklaan Ringfietspad
658,Ringfietspad Jan Van Rijswijcklaan,2022-09-10,10:00:00,4,3,1,FMN 11 A Jan Van Rijswijcklaan Ringfietspad
658,Ringfietspad Jan Van Rijswijcklaan,2022-09-10,11:00:00,7,5,2,FMN 11 A Jan Van Rijswijcklaan Ringfietspad
658,Ringfietspad Jan Van Rijswijcklaan,2022-09-10,12:00:00,14,7,7,FMN 11 A Jan Van Rijswijcklaan Ringfietspad
658,Ringfietspad Jan Van Rijswijcklaan,2022-09-10,13:00:00,13,5,8,FMN 11 A Jan Van Rijswijcklaan Ringfietspad
658,Ringfietspad Jan Van Rijswijcklaan,2022-09-10,14:00:00,17,10,7,FMN 11 A Jan Van Rijswijcklaan Ringfietspad
658,Ringfietspad Jan Van Rijswijcklaan,2022-09-10,15:00:00,20,15,5,FMN 11 A Jan Van Rijswijcklaan Ringfietspad
658,Ringfietspad Jan Van Rijswijcklaan,2022-09-10,16:00:00,20,10,10,FMN 11 A Jan Van Rijswijcklaan Ringfietspad
658,Ringfietspad Jan Van Rijswijcklaan,2022-09-10,17:00:00,17,8,9,FMN 11 A Jan Van Rijswijcklaan Ringfietspad
658,Ringfietspad Jan Van Rijswijcklaan,2022-09-10,18:00:00,26,17,9,FMN 11 A Jan Van Rijswijcklaan Ringfietspad
658,Ringfietspad Jan Van Rijswijcklaan,2022-09-10,19:00:00,20,17,3,FMN 11 A Jan Van Rijswijcklaan Ringfietspad
658,Ringfietspad Jan Van Rijswijcklaan,2022-09-10,20:00:00,13,2,11,FMN 11 A Jan Van Rijswijcklaan Ringfietspad
658,Ringfietspad Jan Van Rijswijcklaan,2022-09-10,21:00:00,7,2,5,FMN 11 A Jan Van Rijswijcklaan Ringfietspad
658,Ringfietspad Jan Van Rijswijcklaan,2022-09-10,22:00:00,11,7,4,FMN 11 A Jan Van Rijswijcklaan Ringfietspad
658,Ringfietspad Jan Van Rijswijcklaan,2022-09-10,23:00:00,3,2,1,FMN 11 A Jan Van Rijswijcklaan Ringfietspad
658,Ringfietspad Jan Van Rijswijcklaan,2022-09-11,00:00:00,3,1,2,FMN 11 A Jan Van Rijswijcklaan Ringfietspad
658,Ringfietspad Jan Van Rijswijcklaan,2022-09-11,01:00:00,3,0,3,FMN 11 A Jan Van Rijswijcklaan Ringfietspad
658,Ringfietspad Jan Van Rijswijcklaan,2022-09-11,02:00:00,3,1,2,FMN 11 A Jan Van Rijswijcklaan Ringfietspad
658,Ringfietspad Jan Van Rijswijcklaan,2022-09-11,03:00:00,1,1,0,FMN 11 A Jan Van Rijswijcklaan Ringfietspad
658,Ringfietspad Jan Van Rijswijcklaan,2022-09-11,04:00:00,5,2,3,FMN 11 A Jan Van Rijswijcklaan Ringfietspad
658,Ringfietspad Jan Van Rijswijcklaan,2022-09-11,05:00:00,4,0,4,FMN 11 A Jan Van Rijswijcklaan Ringfietspad
658,Ringfietspad Jan Van Rijswijcklaan,2022-09-11,06:00:00,5,4,1,FMN 11 A Jan Van Rijswijcklaan Ringfietspad
658,Ringfietspad Jan Van Rijswijcklaan,2022-09-11,07:00:00,5,3,2,FMN 11 A Jan Van Rijswijcklaan Ringfietspad
658,Ringfietspad Jan Van Rijswijcklaan,2022-09-11,08:00:00,25,14,11,FMN 11 A Jan Van Rijswijcklaan Ringfietspad
658,Ringfietspad Jan Van Rijswijcklaan,2022-09-11,09:00:00,43,30,13,FMN 11 A Jan Van Rijswijcklaan Ringfietspad
658,Ringfietspad Jan Van Rijswijcklaan,2022-09-11,10:00:00,8,5,3,FMN 11 A Jan Van Rijswijcklaan Ringfietspad
658,Ringfietspad Jan Van Rijswijcklaan,2022-09-11,11:00:00,0,0,0,FMN 11 A Jan Van Rijswijcklaan Ringfietspad
658,Ringfietspad Jan Van Rijswijcklaan,2022-09-11,12:00:00,0,0,0,FMN 11 A Jan Van Rijswijcklaan Ringfietspad
658,Ringfietspad Jan Van Rijswijcklaan,2022-09-11,13:00:00,0,0,0,FMN 11 A Jan Van Rijswijcklaan Ringfietspad
658,Ringfietspad Jan Van Rijswijcklaan,2022-09-11,14:00:00,0,0,0,FMN 11 A Jan Van Rijswijcklaan Ringfietspad
658,Ringfietspad Jan Van Rijswijcklaan,2022-09-11,15:00:00,0,0,0,FMN 11 A Jan Van Rijswijcklaan Ringfietspad
658,Ringfietspad Jan Van Rijswijcklaan,2022-09-11,16:00:00,0,0,0,FMN 11 A Jan Van Rijswijcklaan Ringfietspad
658,Ringfietspad Jan Van Rijswijcklaan,2022-09-11,17:00:00,0,0,0,FMN 11 A Jan Van Rijswijcklaan Ringfietspad
658,Ringfietspad Jan Van Rijswijcklaan,2022-09-11,18:00:00,0,0,0,FMN 11 A Jan Van Rijswijcklaan Ringfietspad
658,Ringfietspad Jan Van Rijswijcklaan,2022-09-11,19:00:00,0,0,0,FMN 11 A Jan Van Rijswijcklaan Ringfietspad
658,Ringfietspad Jan Van Rijswijcklaan,2022-09-11,20:00:00,0,0,0,FMN 11 A Jan Van Rijswijcklaan Ringfietspad
658,Ringfietspad Jan Van Rijswijcklaan,2022-09-11,21:00:00,0,0,0,FMN 11 A Jan Van Rijswijcklaan Ringfietspad
658,Ringfietspad Jan Van Rijswijcklaan,2022-09-11,22:00:00,0,0,0,FMN 11 A Jan Van Rijswijcklaan Ringfietspad
658,Ringfietspad Jan Van Rijswijcklaan,2022-09-11,23:00:00,0,0,0,FMN 11 A Jan Van Rijswijcklaan Ringfietspad
658,Ringfietspad Jan Van Rijswijcklaan,2022-11-19,00:00:00,5,2,3,FMN 11 A Jan Van Rijswijcklaan Ringfietspad
658,Ringfietspad Jan Van Rijswijcklaan,2022-11-19,01:00:00,3,2,1,FMN 11 A Jan Van Rijswijcklaan Ringfietspad
658,Ringfietspad Jan Van Rijswijcklaan,2022-11-19,02:00:00,3,2,1,FMN 11 A Jan Van Rijswijcklaan Ringfietspad
658,Ringfietspad Jan Van Rijswijcklaan,2022-11-19,03:00:00,1,0,1,FMN 11 A Jan Van Rijswijcklaan Ringfietspad
658,Ringfietspad Jan Van Rijswijcklaan,2022-11-19,04:00:00,3,2,1,FMN 11 A Jan Van Rijswijcklaan Ringfietspad
658,Ringfietspad Jan Van Rijswijcklaan,2022-11-19,05:00:00,4,1,3,FMN 11 A Jan Van Rijswijcklaan Ringfietspad
658,Ringfietspad Jan Van Rijswijcklaan,2022-11-19,06:00:00,7,4,3,FMN 11 A Jan Van Rijswijcklaan Ringfietspad
658,Ringfietspad Jan Van Rijswijcklaan,2022-11-19,07:00:00,7,4,3,FMN 11 A Jan Van Rijswijcklaan Ringfietspad
658,Ringfietspad Jan Van Rijswijcklaan,2022-11-19,08:00:00,14,9,5,FMN 11 A Jan Van Rijswijcklaan Ringfietspad
658,Ringfietspad Jan Van Rijswijcklaan,2022-11-19,09:00:00,27,12,15,FMN 11 A Jan Van Rijswijcklaan Ringfietspad
658,Ringfietspad Jan Van Rijswijcklaan,2022-11-19,10:00:00,31,12,19,FMN 11 A Jan Van Rijswijcklaan Ringfietspad
658,Ringfietspad Jan Van Rijswijcklaan,2022-11-19,11:00:00,35,14,21,FMN 11 A Jan Van Rijswijcklaan Ringfietspad
658,Ringfietspad Jan Van Rijswijcklaan,2022-11-19,12:00:00,37,16,21,FMN 11 A Jan Van Rijswijcklaan Ringfietspad
658,Ringfietspad Jan Van Rijswijcklaan,2022-11-19,13:00:00,46,21,25,FMN 11 A Jan Van Rijswijcklaan Ringfietspad
658,Ringfietspad Jan Van Rijswijcklaan,2022-11-19,14:00:00,54,27,27,FMN 11 A Jan Van Rijswijcklaan Ringfietspad
658,Ringfietspad Jan Van Rijswijcklaan,2022-11-19,15:00:00,51,28,23,FMN 11 A Jan Van Rijswijcklaan Ringfietspad
658,Ringfietspad Jan Van Rijswijcklaan,2022-11-19,16:00:00,46,31,15,FMN 11 A Jan Van Rijswijcklaan Ringfietspad
658,Ringfietspad Jan Van Rijswijcklaan,2022-11-19,17:00:00,36,21,15,FMN 11 A Jan Van Rijswijcklaan Ringfietspad
658,Ringfietspad Jan Van Rijswijcklaan,2022-11-19,18:00:00,28,15,13,FMN 11 A Jan Van Rijswijcklaan Ringfietspad
658,Ringfietspad Jan Van Rijswijcklaan,2022-11-19,19:00:00,19,12,7,FMN 11 A Jan Van Rijswijcklaan Ringfietspad
658,Ringfietspad Jan Van Rijswijcklaan,2022-11-19,20:00:00,15,8,7,FMN 11 A Jan Van Rijswijcklaan Ringfietspad
658,Ringfietspad Jan Van Rijswijcklaan,2022-11-19,21:00:00,11,4,7,FMN 11 A Jan Van Rijswijcklaan Ringfietspad
658,Ringfietspad Jan Van Rijswijcklaan,2022-11-19,22:00:00,9,6,3,FMN 11 A Jan Van Rijswijcklaan Ringfietspad
658,Ringfietspad Jan Van Rijswijcklaan,2022-11-19,23:00:00,6,3,3,FMN 11 A Jan Van Rijswijcklaan Ringfietspad
658,Ringfietspad Jan Van Rijswijcklaan,2022-11-20,00:00:00,2,2,0,FMN 11 A Jan Van Rijswijcklaan Ringfietspad
658,Ringfietspad Jan Van Rijswijcklaan,2022-11-20,01:00:00,2,0,2,FMN 11 A Jan Van Rijswijcklaan Ringfietspad
658,Ringfietspad Jan Van Rijswijcklaan,2022-11-20,02:00:00,1,0,1,FMN 11 A Jan Van Rijswijcklaan Ringfietspad
658,Ringfietspad Jan Van Rijswijcklaan,2022-11-20,03:00:00,1,0,1,FMN 11 A Jan Van Rijswijcklaan Ringfietspad
658,Ringfietspad Jan Van Rijswijcklaan,2022-11-20,04:00:00,0,0,0,FMN 11 A Jan Van Rijswijcklaan Ringfietspad
658,Ringfietspad Jan Van Rijswijcklaan,2022-11-20,05:00:00,2,1,1,FMN 11 A Jan Van Rijswijcklaan Ringfietspad
658,Ringfietspad Jan Van Rijswijcklaan,2022-11-20,06:00:00,2,1,1,FMN 11 A Jan Van Rijswijcklaan Ringfietspad
658,Ringfietspad Jan Van Rijswijcklaan,2022-11-20,07:00:00,3,1,2,FMN 11 A Jan Van Rijswijcklaan Ringfietspad
658,Ringfietspad Jan Van Rijswijcklaan,2022-11-20,08:00:00,10,6,4,FMN 11 A Jan Van Rijswijcklaan Ringfietspad
658,Ringfietspad Jan Van Rijswijcklaan,2022-11-20,09:00:00,19,8,11,FMN 11 A Jan Van Rijswijcklaan Ringfietspad
658,Ringfietspad Jan Van Rijswijcklaan,2022-11-20,10:00:00,24,9,15,FMN 11 A Jan Van Rijswijcklaan Ringfietspad
658,Ringfietspad Jan Van Rijswijcklaan,2022-11-20,11:00:00,27,12,15,FMN 11 A Jan Van Rijswijcklaan Ringfietspad
658,Ringfietspad Jan Van Rijswijcklaan,2022-11-20,12:00:00,31,16,15,FMN 11 A Jan Van Rijswijcklaan Ringfietspad
658,Ringfietspad Jan Van Rijswijcklaan,2022-11-20,13:00:00,34,16,18,FMN 11 A Jan Van Rijswijcklaan Ringfietspad
658,Ringfietspad Jan Van Rijswijcklaan,2022-11-20,14:00:00,38,20,18,FMN 11 A Jan Van Rijswijcklaan Ringfietspad
658,Ringfietspad Jan Van Rijswijcklaan,2022-11-20,15:00:00,36,17,19,FMN 11 A Jan Van Rijswijcklaan Ringfietspad
658,Ringfietspad Jan Van Rijswijcklaan,2022-11-20,16:00:00,30,17,13,FMN 11 A Jan Van Rijswijcklaan Ringfietspad
658,Ringfietspad Jan Van Rijswijcklaan,2022-11-20,17:00:00,24,17,7,FMN 11 A Jan Van Rijswijcklaan Ringfietspad
658,Ringfietspad Jan Van Rijswijcklaan,2022-11-20,18:00:00,16,8,8,FMN 11 A Jan Van Rijswijcklaan Ringfietspad
658,Ringfietspad Jan Van Rijswijcklaan,2022-11-20,19:00:00,11,2,9,FMN 11 A Jan Van Rijswijcklaan Ringfietspad
658,Ringfietspad Jan Van Rijswijcklaan,2022-11-20,20:00:00,9,5,4,FMN 11 A Jan Van Rijswijcklaan Ringfietspad
658,Ringfietspad Jan Van Rijswijcklaan,2022-11-20,21:00:00,5,4,1,FMN 11 A Jan Van Rijswijcklaan Ringfietspad
658,Ringfietspad Jan Van Rijswijcklaan,2022-11-20,22:00:00,4,2,2,FMN 11 A Jan Van Rijswijcklaan Ringfietspad
658,Ringfietspad Jan Van Rijswijcklaan,2022-11-20,23:00:00,2,1,1,FMN 11 A Jan Van Rijswijcklaan Ringfietspad
658,Ringfietspad Jan Van Rijswijcklaan,2022-11-21,00:00:00,2,1,1,FMN 11 A Jan Van Rijswijcklaan Ringfietspad
658,Ringfietspad Jan Van Rijswijcklaan,2022-11-21,01:00:00,1,1,0,FMN 11 A Jan Van Rijswijcklaan Ringfietspad
658,Ringfietspad Jan Van Rijswijcklaan,2022-11-21,02:00:00,1,0,1,FMN 11 A Jan Van Rijswijcklaan Ringfietspad
658,Ringfietspad Jan Van Rijswijcklaan,2022-11-21,03:00:00,2,2,0,FMN 11 A Jan Van Rijswijcklaan Ringfietspad
658,Ringfietspad Jan Van Rijswijcklaan,2022-11-21,04:00:00,7,0,7,FMN 11 A Jan Van Rijswijcklaan Ringfietspad
658,Ringfietspad Jan Van Rijswijcklaan,2022-11-21,05:00:00,21,6,15,FMN 11 A Jan Van Rijswijcklaan Ringfietspad
658,Ringfietspad Jan Van Rijswijcklaan,2022-11-21,06:00:00,55,13,42,FMN 11 A Jan Van Rijswijcklaan Ringfietspad
658,Ringfietspad Jan Van Rijswijcklaan,2022-11-21,07:00:00,112,38,74,FMN 11 A Jan Van Rijswijcklaan Ringfietspad
658,Ringfietspad Jan Van Rijswijcklaan,2022-11-21,08:00:00,147,49,98,FMN 11 A Jan Van Rijswijcklaan Ringfietspad
658,Ringfietspad Jan Van Rijswijcklaan,2022-11-21,09:00:00,53,20,33,FMN 11 A Jan Van Rijswijcklaan Ringfietspad
658,Ringfietspad Jan Van Rijswijcklaan,2022-11-21,10:00:00,36,16,20,FMN 11 A Jan Van Rijswijcklaan Ringfietspad
658,Ringfietspad Jan Van Rijswijcklaan,2022-11-21,11:00:00,34,16,18,FMN 11 A Jan Van Rijswijcklaan Ringfietspad
658,Ringfietspad Jan Van Rijswijcklaan,2022-11-21,12:00:00,51,27,24,FMN 11 A Jan Van Rijswijcklaan Ringfietspad
658,Ringfietspad Jan Van Rijswijcklaan,2022-11-21,13:00:00,53,23,30,FMN 11 A Jan Van Rijswijcklaan Ringfietspad
658,Ringfietspad Jan Van Rijswijcklaan,2022-11-21,14:00:00,61,35,26,FMN 11 A Jan Van Rijswijcklaan Ringfietspad
658,Ringfietspad Jan Van Rijswijcklaan,2022-11-21,15:00:00,85,56,29,FMN 11 A Jan Van Rijswijcklaan Ringfietspad
658,Ringfietspad Jan Van Rijswijcklaan,2022-11-21,16:00:00,134,90,44,FMN 11 A Jan Van Rijswijcklaan Ringfietspad
658,Ringfietspad Jan Van Rijswijcklaan,2022-11-21,17:00:00,142,92,50,FMN 11 A Jan Van Rijswijcklaan Ringfietspad
658,Ringfietspad Jan Van Rijswijcklaan,2022-11-21,18:00:00,82,51,31,FMN 11 A Jan Van Rijswijcklaan Ringfietspad
658,Ringfietspad Jan Van Rijswijcklaan,2022-11-21,19:00:00,39,20,19,FMN 11 A Jan Van Rijswijcklaan Ringfietspad
658,Ringfietspad Jan Van Rijswijcklaan,2022-11-21,20:00:00,27,15,12,FMN 11 A Jan Van Rijswijcklaan Ringfietspad
658,Ringfietspad Jan Van Rijswijcklaan,2022-11-21,21:00:00,19,8,11,FMN 11 A Jan Van Rijswijcklaan Ringfietspad
658,Ringfietspad Jan Van Rijswijcklaan,2022-11-21,22:00:00,17,13,4,FMN 11 A Jan Van Rijswijcklaan Ringfietspad
658,Ringfietspad Jan Van Rijswijcklaan,2022-11-21,23:00:00,6,4,2,FMN 11 A Jan Van Rijswijcklaan Ringfietspad
658,Ringfietspad Jan Van Rijswijcklaan,2022-11-22,00:00:00,2,2,0,FMN 11 A Jan Van Rijswijcklaan Ringfietspad
658,Ringfietspad Jan Van Rijswijcklaan,2022-11-22,01:00:00,1,0,1,FMN 11 A Jan Van Rijswijcklaan Ringfietspad
658,Ringfietspad Jan Van Rijswijcklaan,2022-11-22,02:00:00,1,1,0,FMN 11 A Jan Van Rijswijcklaan Ringfietspad
658,Ringfietspad Jan Van Rijswijcklaan,2022-11-22,03:00:00,2,0,2,FMN 11 A Jan Van Rijswijcklaan Ringfietspad
658,Ringfietspad Jan Van Rijswijcklaan,2022-11-22,04:00:00,7,5,2,FMN 11 A Jan Van Rijswijcklaan Ringfietspad
658,Ringfietspad Jan Van Rijswijcklaan,2022-11-22,05:00:00,23,8,15,FMN 11 A Jan Van Rijswijcklaan Ringfietspad
658,Ringfietspad Jan Van Rijswijcklaan,2022-11-22,06:00:00,61,15,46,FMN 11 A Jan Van Rijswijcklaan Ringfietspad
658,Ringfietspad Jan Van Rijswijcklaan,2022-11-22,07:00:00,120,46,74,FMN 11 A Jan Van Rijswijcklaan Ringfietspad
658,Ringfietspad Jan Van Rijswijcklaan,2022-11-22,08:00:00,154,52,102,FMN 11 A Jan Van Rijswijcklaan Ringfietspad
658,Ringfietspad Jan Van Rijswijcklaan,2022-11-22,09:00:00,58,23,35,FMN 11 A Jan Van Rijswijcklaan Ringfietspad
658,Ringfietspad Jan Van Rijswijcklaan,2022-11-22,10:00:00,37,15,22,FMN 11 A Jan Van Rijswijcklaan Ringfietspad
658,Ringfietspad Jan Van Rijswijcklaan,2022-11-22,11:00:00,34,15,19,FMN 11 A Jan Van Rijswijcklaan Ringfietspad
658,Ringfietspad Jan Van Rijswijcklaan,2022-11-22,12:00:00,50,26,24,FMN 11 A Jan Van Rijswijcklaan Ringfietspad
658,Ringfietspad Jan Van Rijswijcklaan,2022-11-22,13:00:00,52,26,26,FMN 11 A Jan Van Rijswijcklaan Ringfietspad
658,Ringfietspad Jan Van Rijswijcklaan,2022-11-22,14:00:00,57,32,25,FMN 11 A Jan Van Rijswijcklaan Ringfietspad
658,Ringfietspad Jan Van Rijswijcklaan,2022-11-22,15:00:00,86,58,28,FMN 11 A Jan Van Rijswijcklaan Ringfietspad
658,Ringfietspad Jan Van Rijswijcklaan,2022-11-22,16:00:00,140,94,46,FMN 11 A Jan Van Rijswijcklaan Ringfietspad
658,Ringfietspad Jan Van Rijswijcklaan,2022-11-22,17:00:00,148,96,52,FMN 11 A Jan Van Rijswijcklaan Ringfietspad
658,Ringfietspad Jan Van Rijswijcklaan,2022-11-22,18:00:00,91,56,35,FMN 11 A Jan Van Rijswijcklaan Ringfietspad
658,Ringfietspad Jan Van Rijswijcklaan,2022-11-22,19:00:00,38,20,18,FMN 11 A Jan Van Rijswijcklaan Ringfietspad
658,Ringfietspad Jan Van Rijswijcklaan,2022-11-22,20:00:00,29,13,16,FMN 11 A Jan Van Rijswijcklaan Ringfietspad
658,Ringfietspad Jan Van Rijswijcklaan,2022-11-22,21:00:00,19,10,9,FMN 11 A Jan Van Rijswijcklaan Ringfietspad
658,Ringfietspad Jan Van Rijswijcklaan,2022-11-22,22:00:00,18,9,9,FMN 11 A Jan Van Rijswijcklaan Ringfietspad
658,Ringfietspad Jan Van Rijswijcklaan,2022-11-22,23:00:00,7,4,3,FMN 11 A Jan Van Rijswijcklaan Ringfietspad
658,Ringfietspad Jan Van Rijswijcklaan,2022-11-23,00:00:00,3,1,2,FMN 11 A Jan Van Rijswijcklaan Ringfietspad
658,Ringfietspad Jan Van Rijswijcklaan,2022-11-23,01:00:00,1,1,0,FMN 11 A Jan Van Rijswijcklaan Ringfietspad
658,Ringfietspad Jan Van Rijswijcklaan,2022-11-23,02:00:00,1,0,1,FMN 11 A Jan Van Rijswijcklaan Ringfietspad
658,Ringfietspad Jan Van Rijswijcklaan,2022-11-23,03:00:00,2,1,1,FMN 11 A Jan Van Rijswijcklaan Ringfietspad
658,Ringfietspad Jan Van Rijswijcklaan,2022-11-23,04:00:00,7,3,4,FMN 11 A Jan Van Rijswijcklaan Ringfietspad
658,Ringfietspad Jan Van Rijswijcklaan,2022-11-23,05:00:00,23,5,18,FMN 11 A Jan Van Rijswijcklaan Ringfietspad
658,Ringfietspad Jan Van Rijswijcklaan,2022-11-23,06:00:00,60,16,44,FMN 11 A Jan Van Rijswijcklaan Ringfietspad
658,Ringfietspad Jan Van Rijswijcklaan,2022-11-23,07:00:00,114,38,76,FMN 11 A Jan Van Rijswijcklaan Ringfietspad
658,Ringfietspad Jan Van Rijswijcklaan,2022-11-23,08:00:00,134,47,87,FMN 11 A Jan Van Rijswijcklaan Ringfietspad
658,Ringfietspad Jan Van Rijswijcklaan,2022-11-23,09:00:00,52,21,31,FMN 11 A Jan Van Rijswijcklaan Ringfietspad
658,Ringfietspad Jan Van Rijswijcklaan,2022-11-23,10:00:00,37,18,19,FMN 11 A Jan Van Rijswijcklaan Ringfietspad
658,Ringfietspad Jan Van Rijswijcklaan,2022-11-23,11:00:00,39,23,16,FMN 11 A Jan Van Rijswijcklaan Ringfietspad
658,Ringfietspad Jan Van Rijswijcklaan,2022-11-23,12:00:00,60,33,27,FMN 11 A Jan Van Rijswijcklaan Ringfietspad
658,Ringfietspad Jan Van Rijswijcklaan,2022-11-23,13:00:00,59,30,29,FMN 11 A Jan Van Rijswijcklaan Ringfietspad
658,Ringfietspad Jan Van Rijswijcklaan,2022-11-23,14:00:00,64,35,29,FMN 11 A Jan Van Rijswijcklaan Ringfietspad
658,Ringfietspad Jan Van Rijswijcklaan,2022-11-23,15:00:00,81,52,29,FMN 11 A Jan Van Rijswijcklaan Ringfietspad
658,Ringfietspad Jan Van Rijswijcklaan,2022-11-23,16:00:00,127,85,42,FMN 11 A Jan Van Rijswijcklaan Ringfietspad
658,Ringfietspad Jan Van Rijswijcklaan,2022-11-23,17:00:00,138,88,50,FMN 11 A Jan Van Rijswijcklaan Ringfietspad
658,Ringfietspad Jan Van Rijswijcklaan,2022-11-23,18:00:00,82,50,32,FMN 11 A Jan Van Rijswijcklaan Ringfietspad
658,Ringfietspad Jan Van Rijswijcklaan,2022-11-23,19:00:00,44,24,20,FMN 11 A Jan Van Rijswijcklaan Ringfietspad
658,Ringfietspad Jan Van Rijswijcklaan,2022-11-23,20:00:00,30,15,15,FMN 11 A Jan Van Rijswijcklaan Ringfietspad
658,Ringfietspad Jan Van Rijswijcklaan,2022-11-23,21:00:00,21,10,11,FMN 11 A Jan Van Rijswijcklaan Ringfietspad
658,Ringfietspad Jan Van Rijswijcklaan,2022-11-23,22:00:00,18,13,5,FMN 11 A Jan Van Rijswijcklaan Ringfietspad
658,Ringfietspad Jan Van Rijswijcklaan,2022-11-23,23:00:00,8,5,3,FMN 11 A Jan Van Rijswijcklaan Ringfietspad
658,Ringfietspad Jan Van Rijswijcklaan,2022-11-24,00:00:00,4,1,3,FMN 11 A Jan Van Rijswijcklaan Ringfietspad
658,Ringfietspad Jan Van Rijswijcklaan,2022-11-24,01:00:00,1,1,0,FMN 11 A Jan Van Rijswijcklaan Ringfietspad
658,Ringfietspad Jan Van Rijswijcklaan,2022-11-24,02:00:00,1,1,0,FMN 11 A Jan Van Rijswijcklaan Ringfietspad
658,Ringfietspad Jan Van Rijswijcklaan,2022-11-24,03:00:00,3,3,0,FMN 11 A Jan Van Rijswijcklaan Ringfietspad
658,Ringfietspad Jan Van Rijswijcklaan,2022-11-24,04:00:00,7,6,1,FMN 11 A Jan Van Rijswijcklaan Ringfietspad
658,Ringfietspad Jan Van Rijswijcklaan,2022-11-24,05:00:00,26,7,19,FMN 11 A Jan Van Rijswijcklaan Ringfietspad
658,Ringfietspad Jan Van Rijswijcklaan,2022-11-24,06:00:00,66,14,52,FMN 11 A Jan Van Rijswijcklaan Ringfietspad
658,Ringfietspad Jan Van Rijswijcklaan,2022-11-24,07:00:00,126,43,83,FMN 11 A Jan Van Rijswijcklaan Ringfietspad
658,Ringfietspad Jan Van Rijswijcklaan,2022-11-24,08:00:00,171,57,114,FMN 11 A Jan Van Rijswijcklaan Ringfietspad
658,Ringfietspad Jan Van Rijswijcklaan,2022-11-24,09:00:00,66,24,42,FMN 11 A Jan Van Rijswijcklaan Ringfietspad
658,Ringfietspad Jan Van Rijswijcklaan,2022-11-24,10:00:00,43,19,24,FMN 11 A Jan Van Rijswijcklaan Ringfietspad
658,Ringfietspad Jan Van Rijswijcklaan,2022-11-24,11:00:00,42,18,24,FMN 11 A Jan Van Rijswijcklaan Ringfietspad
658,Ringfietspad Jan Van Rijswijcklaan,2022-11-24,12:00:00,61,30,31,FMN 11 A Jan Van Rijswijcklaan Ringfietspad
658,Ringfietspad Jan Van Rijswijcklaan,2022-11-24,13:00:00,62,32,30,FMN 11 A Jan Van Rijswijcklaan Ringfietspad
658,Ringfietspad Jan Van Rijswijcklaan,2022-11-24,14:00:00,71,40,31,FMN 11 A Jan Van Rijswijcklaan Ringfietspad
658,Ringfietspad Jan Van Rijswijcklaan,2022-11-24,15:00:00,99,66,33,FMN 11 A Jan Van Rijswijcklaan Ringfietspad
658,Ringfietspad Jan Van Rijswijcklaan,2022-11-24,16:00:00,150,102,48,FMN 11 A Jan Van Rijswijcklaan Ringfietspad
658,Ringfietspad Jan Van Rijswijcklaan,2022-11-24,17:00:00,154,103,51,FMN 11 A Jan Van Rijswijcklaan Ringfietspad
658,Ringfietspad Jan Van Rijswijcklaan,2022-11-24,18:00:00,96,57,39,FMN 11 A Jan Van Rijswijcklaan Ringfietspad
658,Ringfietspad Jan Van Rijswijcklaan,2022-11-24,19:00:00,51,29,22,FMN 11 A Jan Van Rijswijcklaan Ringfietspad
658,Ringfietspad Jan Van Rijswijcklaan,2022-11-24,20:00:00,34,15,19,FMN 11 A Jan Van Rijswijcklaan Ringfietspad
658,Ringfietspad Jan Van Rijswijcklaan,2022-11-24,21:00:00,23,12,11,FMN 11 A Jan Van Rijswijcklaan Ringfietspad
658,Ringfietspad Jan Van Rijswijcklaan,2022-11-24,22:00:00,21,16,5,FMN 11 A Jan Van Rijswijcklaan Ringfietspad
658,Ringfietspad Jan Van Rijswijcklaan,2022-11-24,23:00:00,10,8,2,FMN 11 A Jan Van Rijswijcklaan Ringfietspad
658,Ringfietspad Jan Van Rijswijcklaan,2022-11-25,00:00:00,4,3,1,FMN 11 A Jan Van Rijswijcklaan Ringfietspad
658,Ringfietspad Jan Van Rijswijcklaan,2022-11-25,01:00:00,3,3,0,FMN 11 A Jan Van Rijswijcklaan Ringfietspad
658,Ringfietspad Jan Van Rijswijcklaan,2022-11-25,02:00:00,1,0,1,FMN 11 A Jan Van Rijswijcklaan Ringfietspad
658,Ringfietspad Jan Van Rijswijcklaan,2022-11-25,03:00:00,3,3,0,FMN 11 A Jan Van Rijswijcklaan Ringfietspad
658,Ringfietspad Jan Van Rijswijcklaan,2022-11-25,04:00:00,7,4,3,FMN 11 A Jan Van Rijswijcklaan Ringfietspad
658,Ringfietspad Jan Van Rijswijcklaan,2022-11-25,05:00:00,21,6,15,FMN 11 A Jan Van Rijswijcklaan Ringfietspad
658,Ringfietspad Jan Van Rijswijcklaan,2022-11-25,06:00:00,56,14,42,FMN 11 A Jan Van Rijswijcklaan Ringfietspad
658,Ringfietspad Jan Van Rijswijcklaan,2022-11-25,07:00:00,107,38,69,FMN 11 A Jan Van Rijswijcklaan Ringfietspad
658,Ringfietspad Jan Van Rijswijcklaan,2022-11-25,08:00:00,151,51,100,FMN 11 A Jan Van Rijswijcklaan Ringfietspad
658,Ringfietspad Jan Van Rijswijcklaan,2022-11-25,09:00:00,63,24,39,FMN 11 A Jan Van Rijswijcklaan Ringfietspad
658,Ringfietspad Jan Van Rijswijcklaan,2022-11-25,10:00:00,46,19,27,FMN 11 A Jan Van Rijswijcklaan Ringfietspad
658,Ringfietspad Jan Van Rijswijcklaan,2022-11-25,11:00:00,44,20,24,FMN 11 A Jan Van Rijswijcklaan Ringfietspad
658,Ringfietspad Jan Van Rijswijcklaan,2022-11-25,12:00:00,62,31,31,FMN 11 A Jan Van Rijswijcklaan Ringfietspad
658,Ringfietspad Jan Van Rijswijcklaan,2022-11-25,13:00:00,63,32,31,FMN 11 A Jan Van Rijswijcklaan Ringfietspad
658,Ringfietspad Jan Van Rijswijcklaan,2022-11-25,14:00:00,74,44,30,FMN 11 A Jan Van Rijswijcklaan Ringfietspad
658,Ringfietspad Jan Van Rijswijcklaan,2022-11-25,15:00:00,105,70,35,FMN 11 A Jan Van Rijswijcklaan Ringfietspad
658,Ringfietspad Jan Van Rijswijcklaan,2022-11-25,16:00:00,140,93,47,FMN 11 A Jan Van Rijswijcklaan Ringfietspad
658,Ringfietspad Jan Van Rijswijcklaan,2022-11-25,17:00:00,119,77,42,FMN 11 A Jan Van Rijswijcklaan Ringfietspad
658,Ringfietspad Jan Van Rijswijcklaan,2022-11-25,18:00:00,73,44,29,FMN 11 A Jan Van Rijswijcklaan Ringfietspad
658,Ringfietspad Jan Van Rijswijcklaan,2022-11-25,19:00:00,45,26,19,FMN 11 A Jan Van Rijswijcklaan Ringfietspad
658,Ringfietspad Jan Van Rijswijcklaan,2022-11-25,20:00:00,29,13,16,FMN 11 A Jan Van Rijswijcklaan Ringfietspad
658,Ringfietspad Jan Van Rijswijcklaan,2022-11-25,21:00:00,20,12,8,FMN 11 A Jan Van Rijswijcklaan Ringfietspad
658,Ringfietspad Jan Van Rijswijcklaan,2022-11-25,22:00:00,19,11,8,FMN 11 A Jan Van Rijswijcklaan Ringfietspad
658,Ringfietspad Jan Van Rijswijcklaan,2022-11-25,23:00:00,11,6,5,FMN 11 A Jan Van Rijswijcklaan Ringfietspad
658,Ringfietspad Jan Van Rijswijcklaan,2022-11-26,00:00:00,7,3,4,FMN 11 A Jan Van Rijswijcklaan Ringfietspad
658,Ringfietspad Jan Van Rijswijcklaan,2022-11-26,01:00:00,4,3,1,FMN 11 A Jan Van Rijswijcklaan Ringfietspad
658,Ringfietspad Jan Van Rijswijcklaan,2022-11-26,02:00:00,3,3,0,FMN 11 A Jan Van Rijswijcklaan Ringfietspad
658,Ringfietspad Jan Van Rijswijcklaan,2022-11-26,03:00:00,3,3,0,FMN 11 A Jan Van Rijswijcklaan Ringfietspad
658,Ringfietspad Jan Van Rijswijcklaan,2022-11-26,04:00:00,4,1,3,FMN 11 A Jan Van Rijswijcklaan Ringfietspad
658,Ringfietspad Jan Van Rijswijcklaan,2022-11-26,05:00:00,5,2,3,FMN 11 A Jan Van Rijswijcklaan Ringfietspad
658,Ringfietspad Jan Van Rijswijcklaan,2022-11-26,06:00:00,9,4,5,FMN 11 A Jan Van Rijswijcklaan Ringfietspad
658,Ringfietspad Jan Van Rijswijcklaan,2022-11-26,07:00:00,10,5,5,FMN 11 A Jan Van Rijswijcklaan Ringfietspad
658,Ringfietspad Jan Van Rijswijcklaan,2022-11-26,08:00:00,19,8,11,FMN 11 A Jan Van Rijswijcklaan Ringfietspad
658,Ringfietspad Jan Van Rijswijcklaan,2022-11-26,09:00:00,36,19,17,FMN 11 A Jan Van Rijswijcklaan Ringfietspad
658,Ringfietspad Jan Van Rijswijcklaan,2022-11-26,10:00:00,43,18,25,FMN 11 A Jan Van Rijswijcklaan Ringfietspad
658,Ringfietspad Jan Van Rijswijcklaan,2022-11-26,11:00:00,47,22,25,FMN 11 A Jan Van Rijswijcklaan Ringfietspad
658,Ringfietspad Jan Van Rijswijcklaan,2022-11-26,12:00:00,51,26,25,FMN 11 A Jan Van Rijswijcklaan Ringfietspad
658,Ringfietspad Jan Van Rijswijcklaan,2022-11-26,13:00:00,62,29,33,FMN 11 A Jan Van Rijswijcklaan Ringfietspad
658,Ringfietspad Jan Van Rijswijcklaan,2022-11-26,14:00:00,73,36,37,FMN 11 A Jan Van Rijswijcklaan Ringfietspad
658,Ringfietspad Jan Van Rijswijcklaan,2022-11-26,15:00:00,69,37,32,FMN 11 A Jan Van Rijswijcklaan Ringfietspad
658,Ringfietspad Jan Van Rijswijcklaan,2022-11-26,16:00:00,63,38,25,FMN 11 A Jan Van Rijswijcklaan Ringfietspad
658,Ringfietspad Jan Van Rijswijcklaan,2022-11-26,17:00:00,48,33,15,FMN 11 A Jan Van Rijswijcklaan Ringfietspad
658,Ringfietspad Jan Van Rijswijcklaan,2022-11-26,18:00:00,38,24,14,FMN 11 A Jan Van Rijswijcklaan Ringfietspad
658,Ringfietspad Jan Van Rijswijcklaan,2022-11-26,19:00:00,26,13,13,FMN 11 A Jan Van Rijswijcklaan Ringfietspad
658,Ringfietspad Jan Van Rijswijcklaan,2022-11-26,20:00:00,21,11,10,FMN 11 A Jan Van Rijswijcklaan Ringfietspad
658,Ringfietspad Jan Van Rijswijcklaan,2022-11-26,21:00:00,15,8,7,FMN 11 A Jan Van Rijswijcklaan Ringfietspad
658,Ringfietspad Jan Van Rijswijcklaan,2022-11-26,22:00:00,12,6,6,FMN 11 A Jan Van Rijswijcklaan Ringfietspad
658,Ringfietspad Jan Van Rijswijcklaan,2022-11-26,23:00:00,7,5,2,FMN 11 A Jan Van Rijswijcklaan Ringfietspad
658,Ringfietspad Jan Van Rijswijcklaan,2022-11-27,00:00:00,2,2,0,FMN 11 A Jan Van Rijswijcklaan Ringfietspad
658,Ringfietspad Jan Van Rijswijcklaan,2022-11-27,01:00:00,1,1,0,FMN 11 A Jan Van Rijswijcklaan Ringfietspad
658,Ringfietspad Jan Van Rijswijcklaan,2022-11-27,02:00:00,1,1,0,FMN 11 A Jan Van Rijswijcklaan Ringfietspad
658,Ringfietspad Jan Van Rijswijcklaan,2022-11-27,03:00:00,1,0,1,FMN 11 A Jan Van Rijswijcklaan Ringfietspad
658,Ringfietspad Jan Van Rijswijcklaan,2022-11-27,04:00:00,1,0,1,FMN 11 A Jan Van Rijswijcklaan Ringfietspad
658,Ringfietspad Jan Van Rijswijcklaan,2022-11-27,05:00:00,1,0,1,FMN 11 A Jan Van Rijswijcklaan Ringfietspad
658,Ringfietspad Jan Van Rijswijcklaan,2022-11-27,06:00:00,2,0,2,FMN 11 A Jan Van Rijswijcklaan Ringfietspad
658,Ringfietspad Jan Van Rijswijcklaan,2022-11-27,07:00:00,3,1,2,FMN 11 A Jan Van Rijswijcklaan Ringfietspad
658,Ringfietspad Jan Van Rijswijcklaan,2022-11-27,08:00:00,7,1,6,FMN 11 A Jan Van Rijswijcklaan Ringfietspad
658,Ringfietspad Jan Van Rijswijcklaan,2022-11-27,09:00:00,17,9,8,FMN 11 A Jan Van Rijswijcklaan Ringfietspad
658,Ringfietspad Jan Van Rijswijcklaan,2022-11-27,10:00:00,20,10,10,FMN 11 A Jan Van Rijswijcklaan Ringfietspad
658,Ringfietspad Jan Van Rijswijcklaan,2022-11-27,11:00:00,24,11,13,FMN 11 A Jan Van Rijswijcklaan Ringfietspad
658,Ringfietspad Jan Van Rijswijcklaan,2022-11-27,12:00:00,26,14,12,FMN 11 A Jan Van Rijswijcklaan Ringfietspad
658,Ringfietspad Jan Van Rijswijcklaan,2022-11-27,13:00:00,30,15,15,FMN 11 A Jan Van Rijswijcklaan Ringfietspad
658,Ringfietspad Jan Van Rijswijcklaan,2022-11-27,14:00:00,33,16,17,FMN 11 A Jan Van Rijswijcklaan Ringfietspad
658,Ringfietspad Jan Van Rijswijcklaan,2022-11-27,15:00:00,30,17,13,FMN 11 A Jan Van Rijswijcklaan Ringfietspad
658,Ringfietspad Jan Van Rijswijcklaan,2022-11-27,16:00:00,25,15,10,FMN 11 A Jan Van Rijswijcklaan Ringfietspad
658,Ringfietspad Jan Van Rijswijcklaan,2022-11-27,17:00:00,21,12,9,FMN 11 A Jan Van Rijswijcklaan Ringfietspad
658,Ringfietspad Jan Van Rijswijcklaan,2022-11-27,18:00:00,14,11,3,FMN 11 A Jan Van Rijswijcklaan Ringfietspad
658,Ringfietspad Jan Van Rijswijcklaan,2022-11-27,19:00:00,9,5,4,FMN 11 A Jan Van Rijswijcklaan Ringfietspad
658,Ringfietspad Jan Van Rijswijcklaan,2022-11-27,20:00:00,8,2,6,FMN 11 A Jan Van Rijswijcklaan Ringfietspad
658,Ringfietspad Jan Van Rijswijcklaan,2022-11-27,21:00:00,5,1,4,FMN 11 A Jan Van Rijswijcklaan Ringfietspad
658,Ringfietspad Jan Van Rijswijcklaan,2022-11-27,22:00:00,3,3,0,FMN 11 A Jan Van Rijswijcklaan Ringfietspad
658,Ringfietspad Jan Van Rijswijcklaan,2022-11-27,23:00:00,2,1,1,FMN 11 A Jan Van Rijswijcklaan Ringfietspad
658,Ringfietspad Jan Van Rijswijcklaan,2022-11-28,00:00:00,2,1,1,FMN 11 A Jan Van Rijswijcklaan Ringfietspad
658,Ringfietspad Jan Van Rijswijcklaan,2022-11-28,01:00:00,1,1,0,FMN 11 A Jan Van Rijswijcklaan Ringfietspad
658,Ringfietspad Jan Van Rijswijcklaan,2022-11-28,02:00:00,1,1,0,FMN 11 A Jan Van Rijswijcklaan Ringfietspad
658,Ringfietspad Jan Van Rijswijcklaan,2022-11-28,03:00:00,1,1,0,FMN 11 A Jan Van Rijswijcklaan Ringfietspad
658,Ringfietspad Jan Van Rijswijcklaan,2022-11-28,04:00:00,8,3,5,FMN 11 A Jan Van Rijswijcklaan Ringfietspad
658,Ringfietspad Jan Van Rijswijcklaan,2022-11-28,05:00:00,20,7,13,FMN 11 A Jan Van Rijswijcklaan Ringfietspad
658,Ringfietspad Jan Van Rijswijcklaan,2022-11-28,06:00:00,54,14,40,FMN 11 A Jan Van Rijswijcklaan Ringfietspad
658,Ringfietspad Jan Van Rijswijcklaan,2022-11-28,07:00:00,110,36,74,FMN 11 A Jan Van Rijswijcklaan Ringfietspad
658,Ringfietspad Jan Van Rijswijcklaan,2022-11-28,08:00:00,144,49,95,FMN 11 A Jan Van Rijswijcklaan Ringfietspad
658,Ringfietspad Jan Van Rijswijcklaan,2022-11-28,09:00:00,52,18,34,FMN 11 A Jan Van Rijswijcklaan Ringfietspad
658,Ringfietspad Jan Van Rijswijcklaan,2022-11-28,10:00:00,36,18,18,FMN 11 A Jan Van Rijswijcklaan Ringfietspad
658,Ringfietspad Jan Van Rijswijcklaan,2022-11-28,11:00:00,33,14,19,FMN 11 A Jan Van Rijswijcklaan Ringfietspad
658,Ringfietspad Jan Van Rijswijcklaan,2022-11-28,12:00:00,50,24,26,FMN 11 A Jan Van Rijswijcklaan Ringfietspad
658,Ringfietspad Jan Van Rijswijcklaan,2022-11-28,13:00:00,51,25,26,FMN 11 A Jan Van Rijswijcklaan Ringfietspad
658,Ringfietspad Jan Van Rijswijcklaan,2022-11-28,14:00:00,60,35,25,FMN 11 A Jan Van Rijswijcklaan Ringfietspad
658,Ringfietspad Jan Van Rijswijcklaan,2022-11-28,15:00:00,84,55,29,FMN 11 A Jan Van Rijswijcklaan Ringfietspad
658,Ringfietspad Jan Van Rijswijcklaan,2022-11-28,16:00:00,131,89,42,FMN 11 A Jan Van Rijswijcklaan Ringfietspad
658,Ringfietspad Jan Van Rijswijcklaan,2022-11-28,17:00:00,139,91,48,FMN 11 A Jan Van Rijswijcklaan Ringfietspad
658,Ringfietspad Jan Van Rijswijcklaan,2022-11-28,18:00:00,80,51,29,FMN 11 A Jan Van Rijswijcklaan Ringfietspad
658,Ringfietspad Jan Van Rijswijcklaan,2022-11-28,19:00:00,38,20,18,FMN 11 A Jan Van Rijswijcklaan Ringfietspad
658,Ringfietspad Jan Van Rijswijcklaan,2022-11-28,20:00:00,27,13,14,FMN 11 A Jan Van Rijswijcklaan Ringfietspad
658,Ringfietspad Jan Van Rijswijcklaan,2022-11-28,21:00:00,19,11,8,FMN 11 A Jan Van Rijswijcklaan Ringfietspad
658,Ringfietspad Jan Van Rijswijcklaan,2022-11-28,22:00:00,16,12,4,FMN 11 A Jan Van Rijswijcklaan Ringfietspad
658,Ringfietspad Jan Van Rijswijcklaan,2022-11-28,23:00:00,6,4,2,FMN 11 A Jan Van Rijswijcklaan Ringfietspad
658,Ringfietspad Jan Van Rijswijcklaan,2022-11-29,00:00:00,2,2,0,FMN 11 A Jan Van Rijswijcklaan Ringfietspad
658,Ringfietspad Jan Van Rijswijcklaan,2022-11-29,01:00:00,1,0,1,FMN 11 A Jan Van Rijswijcklaan Ringfietspad
658,Ringfietspad Jan Van Rijswijcklaan,2022-11-29,02:00:00,1,1,0,FMN 11 A Jan Van Rijswijcklaan Ringfietspad
658,Ringfietspad Jan Van Rijswijcklaan,2022-11-29,03:00:00,2,2,0,FMN 11 A Jan Van Rijswijcklaan Ringfietspad
658,Ringfietspad Jan Van Rijswijcklaan,2022-11-29,04:00:00,8,1,7,FMN 11 A Jan Van Rijswijcklaan Ringfietspad
658,Ringfietspad Jan Van Rijswijcklaan,2022-11-29,05:00:00,24,7,17,FMN 11 A Jan Van Rijswijcklaan Ringfietspad
658,Ringfietspad Jan Van Rijswijcklaan,2022-11-29,06:00:00,65,16,49,FMN 11 A Jan Van Rijswijcklaan Ringfietspad
658,Ringfietspad Jan Van Rijswijcklaan,2022-11-29,07:00:00,127,46,81,FMN 11 A Jan Van Rijswijcklaan Ringfietspad
658,Ringfietspad Jan Van Rijswijcklaan,2022-11-29,08:00:00,164,57,107,FMN 11 A Jan Van Rijswijcklaan Ringfietspad
658,Ringfietspad Jan Van Rijswijcklaan,2022-11-29,09:00:00,61,23,38,FMN 11 A Jan Van Rijswijcklaan Ringfietspad
658,Ringfietspad Jan Van Rijswijcklaan,2022-11-29,10:00:00,39,19,20,FMN 11 A Jan Van Rijswijcklaan Ringfietspad
658,Ringfietspad Jan Van Rijswijcklaan,2022-11-29,11:00:00,37,22,15,FMN 11 A Jan Van Rijswijcklaan Ringfietspad
658,Ringfietspad Jan Van Rijswijcklaan,2022-11-29,12:00:00,53,26,27,FMN 11 A Jan Van Rijswijcklaan Ringfietspad
658,Ringfietspad Jan Van Rijswijcklaan,2022-11-29,13:00:00,55,28,27,FMN 11 A Jan Van Rijswijcklaan Ringfietspad
658,Ringfietspad Jan Van Rijswijcklaan,2022-11-29,14:00:00,61,32,29,FMN 11 A Jan Van Rijswijcklaan Ringfietspad
658,Ringfietspad Jan Van Rijswijcklaan,2022-11-29,15:00:00,91,62,29,FMN 11 A Jan Van Rijswijcklaan Ringfietspad
658,Ringfietspad Jan Van Rijswijcklaan,2022-11-29,16:00:00,148,97,51,FMN 11 A Jan Van Rijswijcklaan Ringfietspad
658,Ringfietspad Jan Van Rijswijcklaan,2022-11-29,17:00:00,158,102,56,FMN 11 A Jan Van Rijswijcklaan Ringfietspad
658,Ringfietspad Jan Van Rijswijcklaan,2022-11-29,18:00:00,96,61,35,FMN 11 A Jan Van Rijswijcklaan Ringfietspad
658,Ringfietspad Jan Van Rijswijcklaan,2022-11-29,19:00:00,41,20,21,FMN 11 A Jan Van Rijswijcklaan Ringfietspad
658,Ringfietspad Jan Van Rijswijcklaan,2022-11-29,20:00:00,31,15,16,FMN 11 A Jan Van Rijswijcklaan Ringfietspad
658,Ringfietspad Jan Van Rijswijcklaan,2022-11-29,21:00:00,20,8,12,FMN 11 A Jan Van Rijswijcklaan Ringfietspad
658,Ringfietspad Jan Van Rijswijcklaan,2022-11-29,22:00:00,19,13,6,FMN 11 A Jan Van Rijswijcklaan Ringfietspad
658,Ringfietspad Jan Van Rijswijcklaan,2022-11-29,23:00:00,7,5,2,FMN 11 A Jan Van Rijswijcklaan Ringfietspad
658,Ringfietspad Jan Van Rijswijcklaan,2022-11-30,00:00:00,3,0,3,FMN 11 A Jan Van Rijswijcklaan Ringfietspad
658,Ringfietspad Jan Van Rijswijcklaan,2022-11-30,01:00:00,1,0,1,FMN 11 A Jan Van Rijswijcklaan Ringfietspad
658,Ringfietspad Jan Van Rijswijcklaan,2022-11-30,02:00:00,1,1,0,FMN 11 A Jan Van Rijswijcklaan Ringfietspad
658,Ringfietspad Jan Van Rijswijcklaan,2022-11-30,03:00:00,2,2,0,FMN 11 A Jan Van Rijswijcklaan Ringfietspad
658,Ringfietspad Jan Van Rijswijcklaan,2022-11-30,04:00:00,7,2,5,FMN 11 A Jan Van Rijswijcklaan Ringfietspad
658,Ringfietspad Jan Van Rijswijcklaan,2022-11-30,05:00:00,24,8,16,FMN 11 A Jan Van Rijswijcklaan Ringfietspad
658,Ringfietspad Jan Van Rijswijcklaan,2022-11-30,06:00:00,63,15,48,FMN 11 A Jan Van Rijswijcklaan Ringfietspad
658,Ringfietspad Jan Van Rijswijcklaan,2022-11-30,07:00:00,117,40,77,FMN 11 A Jan Van Rijswijcklaan Ringfietspad
658,Ringfietspad Jan Van Rijswijcklaan,2022-11-30,08:00:00,140,48,92,FMN 11 A Jan Van Rijswijcklaan Ringfietspad
658,Ringfietspad Jan Van Rijswijcklaan,2022-11-30,09:00:00,53,20,33,FMN 11 A Jan Van Rijswijcklaan Ringfietspad
658,Ringfietspad Jan Van Rijswijcklaan,2022-11-30,10:00:00,39,19,20,FMN 11 A Jan Van Rijswijcklaan Ringfietspad
658,Ringfietspad Jan Van Rijswijcklaan,2022-11-30,11:00:00,40,20,20,FMN 11 A Jan Van Rijswijcklaan Ringfietspad
658,Ringfietspad Jan Van Rijswijcklaan,2022-11-30,12:00:00,63,32,31,FMN 11 A Jan Van Rijswijcklaan Ringfietspad
658,Ringfietspad Jan Van Rijswijcklaan,2022-11-30,13:00:00,61,29,32,FMN 11 A Jan Van Rijswijcklaan Ringfietspad
658,Ringfietspad Jan Van Rijswijcklaan,2022-11-30,14:00:00,66,40,26,FMN 11 A Jan Van Rijswijcklaan Ringfietspad
658,Ringfietspad Jan Van Rijswijcklaan,2022-11-30,15:00:00,84,52,32,FMN 11 A Jan Van Rijswijcklaan Ringfietspad
658,Ringfietspad Jan Van Rijswijcklaan,2022-11-30,16:00:00,131,88,43,FMN 11 A Jan Van Rijswijcklaan Ringfietspad
658,Ringfietspad Jan Van Rijswijcklaan,2022-11-30,17:00:00,143,92,51,FMN 11 A Jan Van Rijswijcklaan Ringfietspad
658,Ringfietspad Jan Van Rijswijcklaan,2022-11-30,18:00:00,85,51,34,FMN 11 A Jan Van Rijswijcklaan Ringfietspad
658,Ringfietspad Jan Van Rijswijcklaan,2022-11-30,19:00:00,46,24,22,FMN 11 A Jan Van Rijswijcklaan Ringfietspad
658,Ringfietspad Jan Van Rijswijcklaan,2022-11-30,20:00:00,31,15,16,FMN 11 A Jan Van Rijswijcklaan Ringfietspad
658,Ringfietspad Jan Van Rijswijcklaan,2022-11-30,21:00:00,21,11,10,FMN 11 A Jan Van Rijswijcklaan Ringfietspad
658,Ringfietspad Jan Van Rijswijcklaan,2022-11-30,22:00:00,20,15,5,FMN 11 A Jan Van Rijswijcklaan Ringfietspad
658,Ringfietspad Jan Van Rijswijcklaan,2022-11-30,23:00:00,7,4,3,FMN 11 A Jan Van Rijswijcklaan Ringfietspad
658,Ringfietspad Jan Van Rijswijcklaan,2022-12-01,00:00:00,3,1,2,FMN 11 A Jan Van Rijswijcklaan Ringfietspad
658,Ringfietspad Jan Van Rijswijcklaan,2022-12-01,01:00:00,2,0,2,FMN 11 A Jan Van Rijswijcklaan Ringfietspad
658,Ringfietspad Jan Van Rijswijcklaan,2022-12-01,02:00:00,1,0,1,FMN 11 A Jan Van Rijswijcklaan Ringfietspad
658,Ringfietspad Jan Van Rijswijcklaan,2022-12-01,03:00:00,2,2,0,FMN 11 A Jan Van Rijswijcklaan Ringfietspad
658,Ringfietspad Jan Van Rijswijcklaan,2022-12-01,04:00:00,7,3,4,FMN 11 A Jan Van Rijswijcklaan Ringfietspad
658,Ringfietspad Jan Van Rijswijcklaan,2022-12-01,05:00:00,25,9,16,FMN 11 A Jan Van Rijswijcklaan Ringfietspad
658,Ringfietspad Jan Van Rijswijcklaan,2022-12-01,06:00:00,62,17,45,FMN 11 A Jan Van Rijswijcklaan Ringfietspad
658,Ringfietspad Jan Van Rijswijcklaan,2022-12-01,07:00:00,119,40,79,FMN 11 A Jan Van Rijswijcklaan Ringfietspad
658,Ringfietspad Jan Van Rijswijcklaan,2022-12-01,08:00:00,161,52,109,FMN 11 A Jan Van Rijswijcklaan Ringfietspad
658,Ringfietspad Jan Van Rijswijcklaan,2022-12-01,09:00:00,63,24,39,FMN 11 A Jan Van Rijswijcklaan Ringfietspad
658,Ringfietspad Jan Van Rijswijcklaan,2022-12-01,10:00:00,41,17,24,FMN 11 A Jan Van Rijswijcklaan Ringfietspad
658,Ringfietspad Jan Van Rijswijcklaan,2022-12-01,11:00:00,39,18,21,FMN 11 A Jan Van Rijswijcklaan Ringfietspad
658,Ringfietspad Jan Van Rijswijcklaan,2022-12-01,12:00:00,58,30,28,FMN 11 A Jan Van Rijswijcklaan Ringfietspad
658,Ringfietspad Jan Van Rijswijcklaan,2022-12-01,13:00:00,58,33,25,FMN 11 A Jan Van Rijswijcklaan Ringfietspad
658,Ringfietspad Jan Van Rijswijcklaan,2022-12-01,14:00:00,68,38,30,FMN 11 A Jan Van Rijswijcklaan Ringfietspad
658,Ringfietspad Jan Van Rijswijcklaan,2022-12-01,15:00:00,94,60,34,FMN 11 A Jan Van Rijswijcklaan Ringfietspad
658,Ringfietspad Jan Van Rijswijcklaan,2022-12-01,16:00:00,141,93,48,FMN 11 A Jan Van Rijswijcklaan Ringfietspad
658,Ringfietspad Jan Van Rijswijcklaan,2022-12-01,17:00:00,145,97,48,FMN 11 A Jan Van Rijswijcklaan Ringfietspad
658,Ringfietspad Jan Van Rijswijcklaan,2022-12-01,18:00:00,91,53,38,FMN 11 A Jan Van Rijswijcklaan Ringfietspad
658,Ringfietspad Jan Van Rijswijcklaan,2022-12-01,19:00:00,48,28,20,FMN 11 A Jan Van Rijswijcklaan Ringfietspad
658,Ringfietspad Jan Van Rijswijcklaan,2022-12-01,20:00:00,33,17,16,FMN 11 A Jan Van Rijswijcklaan Ringfietspad
658,Ringfietspad Jan Van Rijswijcklaan,2022-12-01,21:00:00,22,11,11,FMN 11 A Jan Van Rijswijcklaan Ringfietspad
658,Ringfietspad Jan Van Rijswijcklaan,2022-12-01,22:00:00,19,14,5,FMN 11 A Jan Van Rijswijcklaan Ringfietspad
658,Ringfietspad Jan Van Rijswijcklaan,2022-12-01,23:00:00,10,6,4,FMN 11 A Jan Van Rijswijcklaan Ringfietspad
658,Ringfietspad Jan Van Rijswijcklaan,2022-12-02,00:00:00,4,3,1,FMN 11 A Jan Van Rijswijcklaan Ringfietspad
658,Ringfietspad Jan Van Rijswijcklaan,2022-12-02,01:00:00,2,1,1,FMN 11 A Jan Van Rijswijcklaan Ringfietspad
658,Ringfietspad Jan Van Rijswijcklaan,2022-12-02,02:00:00,1,1,0,FMN 11 A Jan Van Rijswijcklaan Ringfietspad
658,Ringfietspad Jan Van Rijswijcklaan,2022-12-02,03:00:00,2,1,1,FMN 11 A Jan Van Rijswijcklaan Ringfietspad
658,Ringfietspad Jan Van Rijswijcklaan,2022-12-02,04:00:00,7,5,2,FMN 11 A Jan Van Rijswijcklaan Ringfietspad
658,Ringfietspad Jan Van Rijswijcklaan,2022-12-02,05:00:00,18,4,14,FMN 11 A Jan Van Rijswijcklaan Ringfietspad
658,Ringfietspad Jan Van Rijswijcklaan,2022-12-02,06:00:00,50,13,37,FMN 11 A Jan Van Rijswijcklaan Ringfietspad
658,Ringfietspad Jan Van Rijswijcklaan,2022-12-02,07:00:00,96,34,62,FMN 11 A Jan Van Rijswijcklaan Ringfietspad
658,Ringfietspad Jan Van Rijswijcklaan,2022-12-02,08:00:00,134,45,89,FMN 11 A Jan Van Rijswijcklaan Ringfietspad
658,Ringfietspad Jan Van Rijswijcklaan,2022-12-02,09:00:00,55,23,32,FMN 11 A Jan Van Rijswijcklaan Ringfietspad
658,Ringfietspad Jan Van Rijswijcklaan,2022-12-02,10:00:00,41,20,21,FMN 11 A Jan Van Rijswijcklaan Ringfietspad
658,Ringfietspad Jan Van Rijswijcklaan,2022-12-02,11:00:00,39,19,20,FMN 11 A Jan Van Rijswijcklaan Ringfietspad
658,Ringfietspad Jan Van Rijswijcklaan,2022-12-02,12:00:00,55,27,28,FMN 11 A Jan Van Rijswijcklaan Ringfietspad
658,Ringfietspad Jan Van Rijswijcklaan,2022-12-02,13:00:00,56,28,28,FMN 11 A Jan Van Rijswijcklaan Ringfietspad
658,Ringfietspad Jan Van Rijswijcklaan,2022-12-02,14:00:00,66,37,29,FMN 11 A Jan Van Rijswijcklaan Ringfietspad
658,Ringfietspad Jan Van Rijswijcklaan,2022-12-02,15:00:00,94,65,29,FMN 11 A Jan Van Rijswijcklaan Ringfietspad
658,Ringfietspad Jan Van Rijswijcklaan,2022-12-02,16:00:00,124,82,42,FMN 11 A Jan Van Rijswijcklaan Ringfietspad
658,Ringfietspad Jan Van Rijswijcklaan,2022-12-02,17:00:00,105,68,37,FMN 11 A Jan Van Rijswijcklaan Ringfietspad
658,Ringfietspad Jan Van Rijswijcklaan,2022-12-02,18:00:00,65,42,23,FMN 11 A Jan Van Rijswijcklaan Ringfietspad
658,Ringfietspad Jan Van Rijswijcklaan,2022-12-02,19:00:00,40,23,17,FMN 11 A Jan Van Rijswijcklaan Ringfietspad
658,Ringfietspad Jan Van Rijswijcklaan,2022-12-02,20:00:00,26,13,13,FMN 11 A Jan Van Rijswijcklaan Ringfietspad
658,Ringfietspad Jan Van Rijswijcklaan,2022-12-02,21:00:00,17,11,6,FMN 11 A Jan Van Rijswijcklaan Ringfietspad
658,Ringfietspad Jan Van Rijswijcklaan,2022-12-02,22:00:00,17,10,7,FMN 11 A Jan Van Rijswijcklaan Ringfietspad
658,Ringfietspad Jan Van Rijswijcklaan,2022-12-02,23:00:00,10,6,4,FMN 11 A Jan Van Rijswijcklaan Ringfietspad
658,Ringfietspad Jan Van Rijswijcklaan,2022-12-03,00:00:00,5,3,2,FMN 11 A Jan Van Rijswijcklaan Ringfietspad
658,Ringfietspad Jan Van Rijswijcklaan,2022-12-03,01:00:00,3,2,1,FMN 11 A Jan Van Rijswijcklaan Ringfietspad
658,Ringfietspad Jan Van Rijswijcklaan,2022-12-03,02:00:00,3,3,0,FMN 11 A Jan Van Rijswijcklaan Ringfietspad
658,Ringfietspad Jan Van Rijswijcklaan,2022-12-03,03:00:00,1,1,0,FMN 11 A Jan Van Rijswijcklaan Ringfietspad
658,Ringfietspad Jan Van Rijswijcklaan,2022-12-03,04:00:00,3,2,1,FMN 11 A Jan Van Rijswijcklaan Ringfietspad
658,Ringfietspad Jan Van Rijswijcklaan,2022-12-03,05:00:00,4,3,1,FMN 11 A Jan Van Rijswijcklaan Ringfietspad
658,Ringfietspad Jan Van Rijswijcklaan,2022-12-03,06:00:00,7,4,3,FMN 11 A Jan Van Rijswijcklaan Ringfietspad
658,Ringfietspad Jan Van Rijswijcklaan,2022-12-03,07:00:00,7,1,6,FMN 11 A Jan Van Rijswijcklaan Ringfietspad
658,Ringfietspad Jan Van Rijswijcklaan,2022-12-03,08:00:00,14,6,8,FMN 11 A Jan Van Rijswijcklaan Ringfietspad
658,Ringfietspad Jan Van Rijswijcklaan,2022-12-03,09:00:00,27,12,15,FMN 11 A Jan Van Rijswijcklaan Ringfietspad
658,Ringfietspad Jan Van Rijswijcklaan,2022-12-03,10:00:00,32,16,16,FMN 11 A Jan Van Rijswijcklaan Ringfietspad
658,Ringfietspad Jan Van Rijswijcklaan,2022-12-03,11:00:00,35,15,20,FMN 11 A Jan Van Rijswijcklaan Ringfietspad
658,Ringfietspad Jan Van Rijswijcklaan,2022-12-03,12:00:00,37,19,18,FMN 11 A Jan Van Rijswijcklaan Ringfietspad
658,Ringfietspad Jan Van Rijswijcklaan,2022-12-03,13:00:00,46,21,25,FMN 11 A Jan Van Rijswijcklaan Ringfietspad
658,Ringfietspad Jan Van Rijswijcklaan,2022-12-03,14:00:00,54,26,28,FMN 11 A Jan Van Rijswijcklaan Ringfietspad
658,Ringfietspad Jan Van Rijswijcklaan,2022-12-03,15:00:00,52,29,23,FMN 11 A Jan Van Rijswijcklaan Ringfietspad
658,Ringfietspad Jan Van Rijswijcklaan,2022-12-03,16:00:00,46,27,19,FMN 11 A Jan Van Rijswijcklaan Ringfietspad
658,Ringfietspad Jan Van Rijswijcklaan,2022-12-03,17:00:00,36,21,15,FMN 11 A Jan Van Rijswijcklaan Ringfietspad
658,Ringfietspad Jan Van Rijswijcklaan,2022-12-03,18:00:00,28,17,11,FMN 11 A Jan Van Rijswijcklaan Ringfietspad
658,Ringfietspad Jan Van Rijswijcklaan,2022-12-03,19:00:00,20,10,10,FMN 11 A Jan Van Rijswijcklaan Ringfietspad
658,Ringfietspad Jan Van Rijswijcklaan,2022-12-03,20:00:00,15,7,8,FMN 11 A Jan Van Rijswijcklaan Ringfietspad
658,Ringfietspad Jan Van Rijswijcklaan,2022-12-03,21:00:00,11,8,3,FMN 11 A Jan Van Rijswijcklaan Ringfietspad
658,Ringfietspad Jan Van Rijswijcklaan,2022-12-03,22:00:00,9,6,3,FMN 11 A Jan Van Rijswijcklaan Ringfietspad
658,Ringfietspad Jan Van Rijswijcklaan,2022-12-03,23:00:00,5,4,1,FMN 11 A Jan Van Rijswijcklaan Ringfietspad
658,Ringfietspad Jan Van Rijswijcklaan,2022-12-04,00:00:00,2,2,0,FMN 11 A Jan Van Rijswijcklaan Ringfietspad
658,Ringfietspad Jan Van Rijswijcklaan,2022-12-04,01:00:00,2,1,1,FMN 11 A Jan Van Rijswijcklaan Ringfietspad
658,Ringfietspad Jan Van Rijswijcklaan,2022-12-04,02:00:00,1,0,1,FMN 11 A Jan Van Rijswijcklaan Ringfietspad
658,Ringfietspad Jan Van Rijswijcklaan,2022-12-04,03:00:00,1,1,0,FMN 11 A Jan Van Rijswijcklaan Ringfietspad
658,Ringfietspad Jan Van Rijswijcklaan,2022-12-04,04:00:00,1,0,1,FMN 11 A Jan Van Rijswijcklaan Ringfietspad
658,Ringfietspad Jan Van Rijswijcklaan,2022-12-04,05:00:00,1,0,1,FMN 11 A Jan Van Rijswijcklaan Ringfietspad
658,Ringfietspad Jan Van Rijswijcklaan,2022-12-04,06:00:00,2,1,1,FMN 11 A Jan Van Rijswijcklaan Ringfietspad
658,Ringfietspad Jan Van Rijswijcklaan,2022-12-04,07:00:00,4,2,2,FMN 11 A Jan Van Rijswijcklaan Ringfietspad
658,Ringfietspad Jan Van Rijswijcklaan,2022-12-04,08:00:00,9,1,8,FMN 11 A Jan Van Rijswijcklaan Ringfietspad
658,Ringfietspad Jan Van Rijswijcklaan,2022-12-04,09:00:00,20,7,13,FMN 11 A Jan Van Rijswijcklaan Ringfietspad
658,Ringfietspad Jan Van Rijswijcklaan,2022-12-04,10:00:00,24,9,15,FMN 11 A Jan Van Rijswijcklaan Ringfietspad
658,Ringfietspad Jan Van Rijswijcklaan,2022-12-04,11:00:00,27,13,14,FMN 11 A Jan Van Rijswijcklaan Ringfietspad
658,Ringfietspad Jan Van Rijswijcklaan,2022-12-04,12:00:00,32,19,13,FMN 11 A Jan Van Rijswijcklaan Ringfietspad
658,Ringfietspad Jan Van Rijswijcklaan,2022-12-04,13:00:00,35,17,18,FMN 11 A Jan Van Rijswijcklaan Ringfietspad
658,Ringfietspad Jan Van Rijswijcklaan,2022-12-04,14:00:00,39,18,21,FMN 11 A Jan Van Rijswijcklaan Ringfietspad
658,Ringfietspad Jan Van Rijswijcklaan,2022-12-04,15:00:00,36,22,14,FMN 11 A Jan Van Rijswijcklaan Ringfietspad
658,Ringfietspad Jan Van Rijswijcklaan,2022-12-04,16:00:00,30,19,11,FMN 11 A Jan Van Rijswijcklaan Ringfietspad
658,Ringfietspad Jan Van Rijswijcklaan,2022-12-04,17:00:00,24,15,9,FMN 11 A Jan Van Rijswijcklaan Ringfietspad
658,Ringfietspad Jan Van Rijswijcklaan,2022-12-04,18:00:00,17,7,10,FMN 11 A Jan Van Rijswijcklaan Ringfietspad
658,Ringfietspad Jan Van Rijswijcklaan,2022-12-04,19:00:00,11,6,5,FMN 11 A Jan Van Rijswijcklaan Ringfietspad
658,Ringfietspad Jan Van Rijswijcklaan,2022-12-04,20:00:00,9,5,4,FMN 11 A Jan Van Rijswijcklaan Ringfietspad
658,Ringfietspad Jan Van Rijswijcklaan,2022-12-04,21:00:00,6,5,1,FMN 11 A Jan Van Rijswijcklaan Ringfietspad
658,Ringfietspad Jan Van Rijswijcklaan,2022-12-04,22:00:00,4,2,2,FMN 11 A Jan Van Rijswijcklaan Ringfietspad
658,Ringfietspad Jan Van Rijswijcklaan,2022-12-04,23:00:00,1,0,1,FMN 11 A Jan Van Rijswijcklaan Ringfietspad
658,Ringfietspad Jan Van Rijswijcklaan,2022-12-05,00:00:00,2,1,1,FMN 11 A Jan Van Rijswijcklaan Ringfietspad
658,Ringfietspad Jan Van Rijswijcklaan,2022-12-05,01:00:00,0,0,0,FMN 11 A Jan Van Rijswijcklaan Ringfietspad
658,Ringfietspad Jan Van Rijswijcklaan,2022-12-05,02:00:00,1,1,0,FMN 11 A Jan Van Rijswijcklaan Ringfietspad
658,Ringfietspad Jan Van Rijswijcklaan,2022-12-05,03:00:00,2,2,0,FMN 11 A Jan Van Rijswijcklaan Ringfietspad
658,Ringfietspad Jan Van Rijswijcklaan,2022-12-05,04:00:00,6,1,5,FMN 11 A Jan Van Rijswijcklaan Ringfietspad
658,Ringfietspad Jan Van Rijswijcklaan,2022-12-05,05:00:00,17,7,10,FMN 11 A Jan Van Rijswijcklaan Ringfietspad
658,Ringfietspad Jan Van Rijswijcklaan,2022-12-05,06:00:00,45,12,33,FMN 11 A Jan Van Rijswijcklaan Ringfietspad
658,Ringfietspad Jan Van Rijswijcklaan,2022-12-05,07:00:00,92,32,60,FMN 11 A Jan Van Rijswijcklaan Ringfietspad
658,Ringfietspad Jan Van Rijswijcklaan,2022-12-05,08:00:00,121,40,81,FMN 11 A Jan Van Rijswijcklaan Ringfietspad
658,Ringfietspad Jan Van Rijswijcklaan,2022-12-05,09:00:00,43,17,26,FMN 11 A Jan Van Rijswijcklaan Ringfietspad
658,Ringfietspad Jan Van Rijswijcklaan,2022-12-05,10:00:00,30,15,15,FMN 11 A Jan Van Rijswijcklaan Ringfietspad
658,Ringfietspad Jan Van Rijswijcklaan,2022-12-05,11:00:00,28,15,13,FMN 11 A Jan Van Rijswijcklaan Ringfietspad
658,Ringfietspad Jan Van Rijswijcklaan,2022-12-05,12:00:00,42,19,23,FMN 11 A Jan Van Rijswijcklaan Ringfietspad
658,Ringfietspad Jan Van Rijswijcklaan,2022-12-05,13:00:00,43,22,21,FMN 11 A Jan Van Rijswijcklaan Ringfietspad
658,Ringfietspad Jan Van Rijswijcklaan,2022-12-05,14:00:00,50,29,21,FMN 11 A Jan Van Rijswijcklaan Ringfietspad
658,Ringfietspad Jan Van Rijswijcklaan,2022-12-05,15:00:00,70,47,23,FMN 11 A Jan Van Rijswijcklaan Ringfietspad
658,Ringfietspad Jan Van Rijswijcklaan,2022-12-05,16:00:00,110,76,34,FMN 11 A Jan Van Rijswijcklaan Ringfietspad
658,Ringfietspad Jan Van Rijswijcklaan,2022-12-05,17:00:00,116,74,42,FMN 11 A Jan Van Rijswijcklaan Ringfietspad
658,Ringfietspad Jan Van Rijswijcklaan,2022-12-05,18:00:00,67,43,24,FMN 11 A Jan Van Rijswijcklaan Ringfietspad
658,Ringfietspad Jan Van Rijswijcklaan,2022-12-05,19:00:00,32,17,15,FMN 11 A Jan Van Rijswijcklaan Ringfietspad
658,Ringfietspad Jan Van Rijswijcklaan,2022-12-05,20:00:00,23,11,12,FMN 11 A Jan Van Rijswijcklaan Ringfietspad
658,Ringfietspad Jan Van Rijswijcklaan,2022-12-05,21:00:00,15,8,7,FMN 11 A Jan Van Rijswijcklaan Ringfietspad
658,Ringfietspad Jan Van Rijswijcklaan,2022-12-05,22:00:00,14,9,5,FMN 11 A Jan Van Rijswijcklaan Ringfietspad
658,Ringfietspad Jan Van Rijswijcklaan,2022-12-05,23:00:00,5,4,1,FMN 11 A Jan Van Rijswijcklaan Ringfietspad
658,Ringfietspad Jan Van Rijswijcklaan,2022-12-06,00:00:00,2,1,1,FMN 11 A Jan Van Rijswijcklaan Ringfietspad
658,Ringfietspad Jan Van Rijswijcklaan,2022-12-06,01:00:00,1,0,1,FMN 11 A Jan Van Rijswijcklaan Ringfietspad
658,Ringfietspad Jan Van Rijswijcklaan,2022-12-06,02:00:00,1,0,1,FMN 11 A Jan Van Rijswijcklaan Ringfietspad
658,Ringfietspad Jan Van Rijswijcklaan,2022-12-06,03:00:00,2,1,1,FMN 11 A Jan Van Rijswijcklaan Ringfietspad
658,Ringfietspad Jan Van Rijswijcklaan,2022-12-06,04:00:00,7,2,5,FMN 11 A Jan Van Rijswijcklaan Ringfietspad
658,Ringfietspad Jan Van Rijswijcklaan,2022-12-06,05:00:00,22,5,17,FMN 11 A Jan Van Rijswijcklaan Ringfietspad
658,Ringfietspad Jan Van Rijswijcklaan,2022-12-06,06:00:00,60,16,44,FMN 11 A Jan Van Rijswijcklaan Ringfietspad
658,Ringfietspad Jan Van Rijswijcklaan,2022-12-06,07:00:00,117,41,76,FMN 11 A Jan Van Rijswijcklaan Ringfietspad
658,Ringfietspad Jan Van Rijswijcklaan,2022-12-06,08:00:00,151,51,100,FMN 11 A Jan Van Rijswijcklaan Ringfietspad
658,Ringfietspad Jan Van Rijswijcklaan,2022-12-06,09:00:00,56,18,38,FMN 11 A Jan Van Rijswijcklaan Ringfietspad
658,Ringfietspad Jan Van Rijswijcklaan,2022-12-06,10:00:00,36,14,22,FMN 11 A Jan Van Rijswijcklaan Ringfietspad
658,Ringfietspad Jan Van Rijswijcklaan,2022-12-06,11:00:00,34,18,16,FMN 11 A Jan Van Rijswijcklaan Ringfietspad
658,Ringfietspad Jan Van Rijswijcklaan,2022-12-06,12:00:00,48,24,24,FMN 11 A Jan Van Rijswijcklaan Ringfietspad
658,Ringfietspad Jan Van Rijswijcklaan,2022-12-06,13:00:00,52,28,24,FMN 11 A Jan Van Rijswijcklaan Ringfietspad
658,Ringfietspad Jan Van Rijswijcklaan,2022-12-06,14:00:00,55,31,24,FMN 11 A Jan Van Rijswijcklaan Ringfietspad
658,Ringfietspad Jan Van Rijswijcklaan,2022-12-06,15:00:00,84,57,27,FMN 11 A Jan Van Rijswijcklaan Ringfietspad
658,Ringfietspad Jan Van Rijswijcklaan,2022-12-06,16:00:00,137,93,44,FMN 11 A Jan Van Rijswijcklaan Ringfietspad
658,Ringfietspad Jan Van Rijswijcklaan,2022-12-06,17:00:00,145,95,50,FMN 11 A Jan Van Rijswijcklaan Ringfietspad
658,Ringfietspad Jan Van Rijswijcklaan,2022-12-06,18:00:00,88,55,33,FMN 11 A Jan Van Rijswijcklaan Ringfietspad
658,Ringfietspad Jan Van Rijswijcklaan,2022-12-06,19:00:00,38,19,19,FMN 11 A Jan Van Rijswijcklaan Ringfietspad
658,Ringfietspad Jan Van Rijswijcklaan,2022-12-06,20:00:00,28,12,16,FMN 11 A Jan Van Rijswijcklaan Ringfietspad
658,Ringfietspad Jan Van Rijswijcklaan,2022-12-06,21:00:00,19,8,11,FMN 11 A Jan Van Rijswijcklaan Ringfietspad
658,Ringfietspad Jan Van Rijswijcklaan,2022-12-06,22:00:00,17,12,5,FMN 11 A Jan Van Rijswijcklaan Ringfietspad
658,Ringfietspad Jan Van Rijswijcklaan,2022-12-06,23:00:00,7,4,3,FMN 11 A Jan Van Rijswijcklaan Ringfietspad
658,Ringfietspad Jan Van Rijswijcklaan,2022-12-07,00:00:00,2,2,0,FMN 11 A Jan Van Rijswijcklaan Ringfietspad
658,Ringfietspad Jan Van Rijswijcklaan,2022-12-07,01:00:00,2,1,1,FMN 11 A Jan Van Rijswijcklaan Ringfietspad
658,Ringfietspad Jan Van Rijswijcklaan,2022-12-07,02:00:00,1,1,0,FMN 11 A Jan Van Rijswijcklaan Ringfietspad
658,Ringfietspad Jan Van Rijswijcklaan,2022-12-07,03:00:00,1,1,0,FMN 11 A Jan Van Rijswijcklaan Ringfietspad
658,Ringfietspad Jan Van Rijswijcklaan,2022-12-07,04:00:00,6,2,4,FMN 11 A Jan Van Rijswijcklaan Ringfietspad
658,Ringfietspad Jan Van Rijswijcklaan,2022-12-07,05:00:00,21,9,12,FMN 11 A Jan Van Rijswijcklaan Ringfietspad
658,Ringfietspad Jan Van Rijswijcklaan,2022-12-07,06:00:00,54,14,40,FMN 11 A Jan Van Rijswijcklaan Ringfietspad
658,Ringfietspad Jan Van Rijswijcklaan,2022-12-07,07:00:00,102,38,64,FMN 11 A Jan Van Rijswijcklaan Ringfietspad
658,Ringfietspad Jan Van Rijswijcklaan,2022-12-07,08:00:00,121,41,80,FMN 11 A Jan Van Rijswijcklaan Ringfietspad
658,Ringfietspad Jan Van Rijswijcklaan,2022-12-07,09:00:00,46,19,27,FMN 11 A Jan Van Rijswijcklaan Ringfietspad
658,Ringfietspad Jan Van Rijswijcklaan,2022-12-07,10:00:00,34,17,17,FMN 11 A Jan Van Rijswijcklaan Ringfietspad
658,Ringfietspad Jan Van Rijswijcklaan,2022-12-07,11:00:00,35,14,21,FMN 11 A Jan Van Rijswijcklaan Ringfietspad
658,Ringfietspad Jan Van Rijswijcklaan,2022-12-07,12:00:00,54,28,26,FMN 11 A Jan Van Rijswijcklaan Ringfietspad
658,Ringfietspad Jan Van Rijswijcklaan,2022-12-07,13:00:00,53,26,27,FMN 11 A Jan Van Rijswijcklaan Ringfietspad
658,Ringfietspad Jan Van Rijswijcklaan,2022-12-07,14:00:00,57,30,27,FMN 11 A Jan Van Rijswijcklaan Ringfietspad
658,Ringfietspad Jan Van Rijswijcklaan,2022-12-07,15:00:00,73,45,28,FMN 11 A Jan Van Rijswijcklaan Ringfietspad
658,Ringfietspad Jan Van Rijswijcklaan,2022-12-07,16:00:00,114,77,37,FMN 11 A Jan Van Rijswijcklaan Ringfietspad
658,Ringfietspad Jan Van Rijswijcklaan,2022-12-07,17:00:00,124,82,42,FMN 11 A Jan Van Rijswijcklaan Ringfietspad
658,Ringfietspad Jan Van Rijswijcklaan,2022-12-07,18:00:00,74,43,31,FMN 11 A Jan Van Rijswijcklaan Ringfietspad
658,Ringfietspad Jan Van Rijswijcklaan,2022-12-07,19:00:00,39,19,20,FMN 11 A Jan Van Rijswijcklaan Ringfietspad
658,Ringfietspad Jan Van Rijswijcklaan,2022-12-07,20:00:00,27,14,13,FMN 11 A Jan Van Rijswijcklaan Ringfietspad
658,Ringfietspad Jan Van Rijswijcklaan,2022-12-07,21:00:00,19,11,8,FMN 11 A Jan Van Rijswijcklaan Ringfietspad
658,Ringfietspad Jan Van Rijswijcklaan,2022-12-07,22:00:00,17,11,6,FMN 11 A Jan Van Rijswijcklaan Ringfietspad
658,Ringfietspad Jan Van Rijswijcklaan,2022-12-07,23:00:00,6,5,1,FMN 11 A Jan Van Rijswijcklaan Ringfietspad
658,Ringfietspad Jan Van Rijswijcklaan,2022-12-08,00:00:00,3,2,1,FMN 11 A Jan Van Rijswijcklaan Ringfietspad
658,Ringfietspad Jan Van Rijswijcklaan,2022-12-08,01:00:00,1,0,1,FMN 11 A Jan Van Rijswijcklaan Ringfietspad
658,Ringfietspad Jan Van Rijswijcklaan,2022-12-08,02:00:00,1,1,0,FMN 11 A Jan Van Rijswijcklaan Ringfietspad
658,Ringfietspad Jan Van Rijswijcklaan,2022-12-08,03:00:00,1,0,1,FMN 11 A Jan Van Rijswijcklaan Ringfietspad
658,Ringfietspad Jan Van Rijswijcklaan,2022-12-08,04:00:00,6,4,2,FMN 11 A Jan Van Rijswijcklaan Ringfietspad
658,Ringfietspad Jan Van Rijswijcklaan,2022-12-08,05:00:00,20,8,12,FMN 11 A Jan Van Rijswijcklaan Ringfietspad
658,Ringfietspad Jan Van Rijswijcklaan,2022-12-08,06:00:00,50,12,38,FMN 11 A Jan Van Rijswijcklaan Ringfietspad
658,Ringfietspad Jan Van Rijswijcklaan,2022-12-08,07:00:00,95,32,63,FMN 11 A Jan Van Rijswijcklaan Ringfietspad
658,Ringfietspad Jan Van Rijswijcklaan,2022-12-08,08:00:00,129,41,88,FMN 11 A Jan Van Rijswijcklaan Ringfietspad
658,Ringfietspad Jan Van Rijswijcklaan,2022-12-08,09:00:00,51,19,32,FMN 11 A Jan Van Rijswijcklaan Ringfietspad
658,Ringfietspad Jan Van Rijswijcklaan,2022-12-08,10:00:00,32,14,18,FMN 11 A Jan Van Rijswijcklaan Ringfietspad
658,Ringfietspad Jan Van Rijswijcklaan,2022-12-08,11:00:00,32,13,19,FMN 11 A Jan Van Rijswijcklaan Ringfietspad
658,Ringfietspad Jan Van Rijswijcklaan,2022-12-08,12:00:00,46,21,25,FMN 11 A Jan Van Rijswijcklaan Ringfietspad
658,Ringfietspad Jan Van Rijswijcklaan,2022-12-08,13:00:00,47,27,20,FMN 11 A Jan Van Rijswijcklaan Ringfietspad
658,Ringfietspad Jan Van Rijswijcklaan,2022-12-08,14:00:00,53,30,23,FMN 11 A Jan Van Rijswijcklaan Ringfietspad
658,Ringfietspad Jan Van Rijswijcklaan,2022-12-08,15:00:00,76,49,27,FMN 11 A Jan Van Rijswijcklaan Ringfietspad
658,Ringfietspad Jan Van Rijswijcklaan,2022-12-08,16:00:00,113,77,36,FMN 11 A Jan Van Rijswijcklaan Ringfietspad
658,Ringfietspad Jan Van Rijswijcklaan,2022-12-08,17:00:00,116,74,42,FMN 11 A Jan Van Rijswijcklaan Ringfietspad
658,Ringfietspad Jan Van Rijswijcklaan,2022-12-08,18:00:00,73,44,29,FMN 11 A Jan Van Rijswijcklaan Ringfietspad
658,Ringfietspad Jan Van Rijswijcklaan,2022-12-08,19:00:00,39,22,17,FMN 11 A Jan Van Rijswijcklaan Ringfietspad
658,Ringfietspad Jan Van Rijswijcklaan,2022-12-08,20:00:00,25,12,13,FMN 11 A Jan Van Rijswijcklaan Ringfietspad
658,Ringfietspad Jan Van Rijswijcklaan,2022-12-08,21:00:00,18,11,7,FMN 11 A Jan Van Rijswijcklaan Ringfietspad
658,Ringfietspad Jan Van Rijswijcklaan,2022-12-08,22:00:00,16,10,6,FMN 11 A Jan Van Rijswijcklaan Ringfietspad
658,Ringfietspad Jan Van Rijswijcklaan,2022-12-08,23:00:00,7,3,4,FMN 11 A Jan Van Rijswijcklaan Ringfietspad
658,Ringfietspad Jan Van Rijswijcklaan,2022-12-09,00:00:00,3,3,0,FMN 11 A Jan Van Rijswijcklaan Ringfietspad
658,Ringfietspad Jan Van Rijswijcklaan,2022-12-09,01:00:00,2,1,1,FMN 11 A Jan Van Rijswijcklaan Ringfietspad
658,Ringfietspad Jan Van Rijswijcklaan,2022-12-09,02:00:00,1,1,0,FMN 11 A Jan Van Rijswijcklaan Ringfietspad
658,Ringfietspad Jan Van Rijswijcklaan,2022-12-09,03:00:00,2,1,1,FMN 11 A Jan Van Rijswijcklaan Ringfietspad
658,Ringfietspad Jan Van Rijswijcklaan,2022-12-09,04:00:00,5,1,4,FMN 11 A Jan Van Rijswijcklaan Ringfietspad
658,Ringfietspad Jan Van Rijswijcklaan,2022-12-09,05:00:00,15,4,11,FMN 11 A Jan Van Rijswijcklaan Ringfietspad
658,Ringfietspad Jan Van Rijswijcklaan,2022-12-09,06:00:00,40,11,29,FMN 11 A Jan Van Rijswijcklaan Ringfietspad
658,Ringfietspad Jan Van Rijswijcklaan,2022-12-09,07:00:00,77,25,52,FMN 11 A Jan Van Rijswijcklaan Ringfietspad
658,Ringfietspad Jan Van Rijswijcklaan,2022-12-09,08:00:00,108,34,74,FMN 11 A Jan Van Rijswijcklaan Ringfietspad
658,Ringfietspad Jan Van Rijswijcklaan,2022-12-09,09:00:00,44,17,27,FMN 11 A Jan Van Rijswijcklaan Ringfietspad
658,Ringfietspad Jan Van Rijswijcklaan,2022-12-09,10:00:00,34,16,18,FMN 11 A Jan Van Rijswijcklaan Ringfietspad
658,Ringfietspad Jan Van Rijswijcklaan,2022-12-09,11:00:00,31,14,17,FMN 11 A Jan Van Rijswijcklaan Ringfietspad
658,Ringfietspad Jan Van Rijswijcklaan,2022-12-09,12:00:00,44,24,20,FMN 11 A Jan Van Rijswijcklaan Ringfietspad
658,Ringfietspad Jan Van Rijswijcklaan,2022-12-09,13:00:00,45,26,19,FMN 11 A Jan Van Rijswijcklaan Ringfietspad
658,Ringfietspad Jan Van Rijswijcklaan,2022-12-09,14:00:00,53,30,23,FMN 11 A Jan Van Rijswijcklaan Ringfietspad
658,Ringfietspad Jan Van Rijswijcklaan,2022-12-09,15:00:00,76,51,25,FMN 11 A Jan Van Rijswijcklaan Ringfietspad
658,Ringfietspad Jan Van Rijswijcklaan,2022-12-09,16:00:00,100,66,34,FMN 11 A Jan Van Rijswijcklaan Ringfietspad
658,Ringfietspad Jan Van Rijswijcklaan,2022-12-09,17:00:00,85,56,29,FMN 11 A Jan Van Rijswijcklaan Ringfietspad
658,Ringfietspad Jan Van Rijswijcklaan,2022-12-09,18:00:00,52,31,21,FMN 11 A Jan Van Rijswijcklaan Ringfietspad
658,Ringfietspad Jan Van Rijswijcklaan,2022-12-09,19:00:00,33,17,16,FMN 11 A Jan Van Rijswijcklaan Ringfietspad
658,Ringfietspad Jan Van Rijswijcklaan,2022-12-09,20:00:00,20,11,9,FMN 11 A Jan Van Rijswijcklaan Ringfietspad
658,Ringfietspad Jan Van Rijswijcklaan,2022-12-09,21:00:00,14,6,8,FMN 11 A Jan Van Rijswijcklaan Ringfietspad
658,Ringfietspad Jan Van Rijswijcklaan,2022-12-09,22:00:00,14,10,4,FMN 11 A Jan Van Rijswijcklaan Ringfietspad
658,Ringfietspad Jan Van Rijswijcklaan,2022-12-09,23:00:00,8,5,3,FMN 11 A Jan Van Rijswijcklaan Ringfietspad
658,Ringfietspad Jan Van Rijswijcklaan,2022-12-10,00:00:00,4,3,1,FMN 11 A Jan Van Rijswijcklaan Ringfietspad
658,Ringfietspad Jan Van Rijswijcklaan,2022-12-10,01:00:00,2,0,2,FMN 11 A Jan Van Rijswijcklaan Ringfietspad
658,Ringfietspad Jan Van Rijswijcklaan,2022-12-10,02:00:00,2,2,0,FMN 11 A Jan Van Rijswijcklaan Ringfietspad
658,Ringfietspad Jan Van Rijswijcklaan,2022-12-10,03:00:00,1,0,1,FMN 11 A Jan Van Rijswijcklaan Ringfietspad
658,Ringfietspad Jan Van Rijswijcklaan,2022-12-10,04:00:00,3,1,2,FMN 11 A Jan Van Rijswijcklaan Ringfietspad
658,Ringfietspad Jan Van Rijswijcklaan,2022-12-10,05:00:00,2,1,1,FMN 11 A Jan Van Rijswijcklaan Ringfietspad
658,Ringfietspad Jan Van Rijswijcklaan,2022-12-10,06:00:00,6,4,2,FMN 11 A Jan Van Rijswijcklaan Ringfietspad
658,Ringfietspad Jan Van Rijswijcklaan,2022-12-10,07:00:00,5,2,3,FMN 11 A Jan Van Rijswijcklaan Ringfietspad
658,Ringfietspad Jan Van Rijswijcklaan,2022-12-10,08:00:00,11,6,5,FMN 11 A Jan Van Rijswijcklaan Ringfietspad
658,Ringfietspad Jan Van Rijswijcklaan,2022-12-10,09:00:00,20,7,13,FMN 11 A Jan Van Rijswijcklaan Ringfietspad
658,Ringfietspad Jan Van Rijswijcklaan,2022-12-10,10:00:00,24,12,12,FMN 11 A Jan Van Rijswijcklaan Ringfietspad
658,Ringfietspad Jan Van Rijswijcklaan,2022-12-10,11:00:00,27,14,13,FMN 11 A Jan Van Rijswijcklaan Ringfietspad
658,Ringfietspad Jan Van Rijswijcklaan,2022-12-10,12:00:00,28,14,14,FMN 11 A Jan Van Rijswijcklaan Ringfietspad
658,Ringfietspad Jan Van Rijswijcklaan,2022-12-10,13:00:00,35,18,17,FMN 11 A Jan Van Rijswijcklaan Ringfietspad
658,Ringfietspad Jan Van Rijswijcklaan,2022-12-10,14:00:00,41,21,20,FMN 11 A Jan Van Rijswijcklaan Ringfietspad
658,Ringfietspad Jan Van Rijswijcklaan,2022-12-10,15:00:00,40,23,17,FMN 11 A Jan Van Rijswijcklaan Ringfietspad
658,Ringfietspad Jan Van Rijswijcklaan,2022-12-10,16:00:00,35,21,14,FMN 11 A Jan Van Rijswijcklaan Ringfietspad
658,Ringfietspad Jan Van Rijswijcklaan,2022-12-10,17:00:00,27,15,12,FMN 11 A Jan Van Rijswijcklaan Ringfietspad
658,Ringfietspad Jan Van Rijswijcklaan,2022-12-10,18:00:00,21,12,9,FMN 11 A Jan Van Rijswijcklaan Ringfietspad
658,Ringfietspad Jan Van Rijswijcklaan,2022-12-10,19:00:00,15,8,7,FMN 11 A Jan Van Rijswijcklaan Ringfietspad
658,Ringfietspad Jan Van Rijswijcklaan,2022-12-10,20:00:00,12,11,1,FMN 11 A Jan Van Rijswijcklaan Ringfietspad
658,Ringfietspad Jan Van Rijswijcklaan,2022-12-10,21:00:00,8,4,4,FMN 11 A Jan Van Rijswijcklaan Ringfietspad
658,Ringfietspad Jan Van Rijswijcklaan,2022-12-10,22:00:00,7,6,1,FMN 11 A Jan Van Rijswijcklaan Ringfietspad
658,Ringfietspad Jan Van Rijswijcklaan,2022-12-10,23:00:00,4,3,1,FMN 11 A Jan Van Rijswijcklaan Ringfietspad
658,Ringfietspad Jan Van Rijswijcklaan,2022-12-11,00:00:00,2,2,0,FMN 11 A Jan Van Rijswijcklaan Ringfietspad
658,Ringfietspad Jan Van Rijswijcklaan,2022-12-11,01:00:00,1,0,1,FMN 11 A Jan Van Rijswijcklaan Ringfietspad
658,Ringfietspad Jan Van Rijswijcklaan,2022-12-11,02:00:00,1,1,0,FMN 11 A Jan Van Rijswijcklaan Ringfietspad
658,Ringfietspad Jan Van Rijswijcklaan,2022-12-11,03:00:00,1,1,0,FMN 11 A Jan Van Rijswijcklaan Ringfietspad
658,Ringfietspad Jan Van Rijswijcklaan,2022-12-11,04:00:00,0,0,0,FMN 11 A Jan Van Rijswijcklaan Ringfietspad
658,Ringfietspad Jan Van Rijswijcklaan,2022-12-11,05:00:00,1,0,1,FMN 11 A Jan Van Rijswijcklaan Ringfietspad
658,Ringfietspad Jan Van Rijswijcklaan,2022-12-11,06:00:00,2,1,1,FMN 11 A Jan Van Rijswijcklaan Ringfietspad
658,Ringfietspad Jan Van Rijswijcklaan,2022-12-11,07:00:00,3,1,2,FMN 11 A Jan Van Rijswijcklaan Ringfietspad
658,Ringfietspad Jan Van Rijswijcklaan,2022-12-11,08:00:00,8,2,6,FMN 11 A Jan Van Rijswijcklaan Ringfietspad
658,Ringfietspad Jan Van Rijswijcklaan,2022-12-11,09:00:00,16,5,11,FMN 11 A Jan Van Rijswijcklaan Ringfietspad
658,Ringfietspad Jan Van Rijswijcklaan,2022-12-11,10:00:00,20,7,13,FMN 11 A Jan Van Rijswijcklaan Ringfietspad
658,Ringfietspad Jan Van Rijswijcklaan,2022-12-11,11:00:00,22,10,12,FMN 11 A Jan Van Rijswijcklaan Ringfietspad
658,Ringfietspad Jan Van Rijswijcklaan,2022-12-11,12:00:00,26,14,12,FMN 11 A Jan Van Rijswijcklaan Ringfietspad
658,Ringfietspad Jan Van Rijswijcklaan,2022-12-11,13:00:00,28,16,12,FMN 11 A Jan Van Rijswijcklaan Ringfietspad
658,Ringfietspad Jan Van Rijswijcklaan,2022-12-11,14:00:00,32,16,16,FMN 11 A Jan Van Rijswijcklaan Ringfietspad
658,Ringfietspad Jan Van Rijswijcklaan,2022-12-11,15:00:00,30,16,14,FMN 11 A Jan Van Rijswijcklaan Ringfietspad
658,Ringfietspad Jan Van Rijswijcklaan,2022-12-11,16:00:00,24,13,11,FMN 11 A Jan Van Rijswijcklaan Ringfietspad
658,Ringfietspad Jan Van Rijswijcklaan,2022-12-11,17:00:00,21,13,8,FMN 11 A Jan Van Rijswijcklaan Ringfietspad
658,Ringfietspad Jan Van Rijswijcklaan,2022-12-11,18:00:00,13,9,4,FMN 11 A Jan Van Rijswijcklaan Ringfietspad
658,Ringfietspad Jan Van Rijswijcklaan,2022-12-11,19:00:00,9,3,6,FMN 11 A Jan Van Rijswijcklaan Ringfietspad
658,Ringfietspad Jan Van Rijswijcklaan,2022-12-11,20:00:00,7,4,3,FMN 11 A Jan Van Rijswijcklaan Ringfietspad
658,Ringfietspad Jan Van Rijswijcklaan,2022-12-11,21:00:00,5,4,1,FMN 11 A Jan Van Rijswijcklaan Ringfietspad
658,Ringfietspad Jan Van Rijswijcklaan,2022-12-11,22:00:00,3,1,2,FMN 11 A Jan Van Rijswijcklaan Ringfietspad
658,Ringfietspad Jan Van Rijswijcklaan,2022-12-11,23:00:00,2,2,0,FMN 11 A Jan Van Rijswijcklaan Ringfietspad
658,Ringfietspad Jan Van Rijswijcklaan,2022-12-12,00:00:00,1,0,1,FMN 11 A Jan Van Rijswijcklaan Ringfietspad
658,Ringfietspad Jan Van Rijswijcklaan,2022-12-12,01:00:00,1,1,0,FMN 11 A Jan Van Rijswijcklaan Ringfietspad
658,Ringfietspad Jan Van Rijswijcklaan,2022-12-12,02:00:00,1,0,1,FMN 11 A Jan Van Rijswijcklaan Ringfietspad
658,Ringfietspad Jan Van Rijswijcklaan,2022-12-12,03:00:00,1,1,0,FMN 11 A Jan Van Rijswijcklaan Ringfietspad
658,Ringfietspad Jan Van Rijswijcklaan,2022-12-12,04:00:00,5,2,3,FMN 11 A Jan Van Rijswijcklaan Ringfietspad
658,Ringfietspad Jan Van Rijswijcklaan,2022-12-12,05:00:00,16,2,14,FMN 11 A Jan Van Rijswijcklaan Ringfietspad
658,Ringfietspad Jan Van Rijswijcklaan,2022-12-12,06:00:00,40,11,29,FMN 11 A Jan Van Rijswijcklaan Ringfietspad
658,Ringfietspad Jan Van Rijswijcklaan,2022-12-12,07:00:00,82,27,55,FMN 11 A Jan Van Rijswijcklaan Ringfietspad
658,Ringfietspad Jan Van Rijswijcklaan,2022-12-12,08:00:00,109,35,74,FMN 11 A Jan Van Rijswijcklaan Ringfietspad
658,Ringfietspad Jan Van Rijswijcklaan,2022-12-12,09:00:00,38,13,25,FMN 11 A Jan Van Rijswijcklaan Ringfietspad
658,Ringfietspad Jan Van Rijswijcklaan,2022-12-12,10:00:00,27,12,15,FMN 11 A Jan Van Rijswijcklaan Ringfietspad
658,Ringfietspad Jan Van Rijswijcklaan,2022-12-12,11:00:00,25,12,13,FMN 11 A Jan Van Rijswijcklaan Ringfietspad
658,Ringfietspad Jan Van Rijswijcklaan,2022-12-12,12:00:00,37,17,20,FMN 11 A Jan Van Rijswijcklaan Ringfietspad
658,Ringfietspad Jan Van Rijswijcklaan,2022-12-12,13:00:00,39,19,20,FMN 11 A Jan Van Rijswijcklaan Ringfietspad
658,Ringfietspad Jan Van Rijswijcklaan,2022-12-12,14:00:00,44,26,18,FMN 11 A Jan Van Rijswijcklaan Ringfietspad
658,Ringfietspad Jan Van Rijswijcklaan,2022-12-12,15:00:00,63,40,23,FMN 11 A Jan Van Rijswijcklaan Ringfietspad
658,Ringfietspad Jan Van Rijswijcklaan,2022-12-12,16:00:00,99,67,32,FMN 11 A Jan Van Rijswijcklaan Ringfietspad
658,Ringfietspad Jan Van Rijswijcklaan,2022-12-12,17:00:00,103,66,37,FMN 11 A Jan Van Rijswijcklaan Ringfietspad
658,Ringfietspad Jan Van Rijswijcklaan,2022-12-12,18:00:00,60,37,23,FMN 11 A Jan Van Rijswijcklaan Ringfietspad
658,Ringfietspad Jan Van Rijswijcklaan,2022-12-12,19:00:00,29,15,14,FMN 11 A Jan Van Rijswijcklaan Ringfietspad
658,Ringfietspad Jan Van Rijswijcklaan,2022-12-12,20:00:00,20,10,10,FMN 11 A Jan Van Rijswijcklaan Ringfietspad
658,Ringfietspad Jan Van Rijswijcklaan,2022-12-12,21:00:00,14,7,7,FMN 11 A Jan Van Rijswijcklaan Ringfietspad
658,Ringfietspad Jan Van Rijswijcklaan,2022-12-12,22:00:00,13,9,4,FMN 11 A Jan Van Rijswijcklaan Ringfietspad
658,Ringfietspad Jan Van Rijswijcklaan,2022-12-12,23:00:00,4,3,1,FMN 11 A Jan Van Rijswijcklaan Ringfietspad
658,Ringfietspad Jan Van Rijswijcklaan,2022-12-13,00:00:00,1,0,1,FMN 11 A Jan Van Rijswijcklaan Ringfietspad
658,Ringfietspad Jan Van Rijswijcklaan,2022-12-13,01:00:00,1,0,1,FMN 11 A Jan Van Rijswijcklaan Ringfietspad
658,Ringfietspad Jan Van Rijswijcklaan,2022-12-13,02:00:00,1,1,0,FMN 11 A Jan Van Rijswijcklaan Ringfietspad
658,Ringfietspad Jan Van Rijswijcklaan,2022-12-13,03:00:00,1,0,1,FMN 11 A Jan Van Rijswijcklaan Ringfietspad
658,Ringfietspad Jan Van Rijswijcklaan,2022-12-13,04:00:00,5,2,3,FMN 11 A Jan Van Rijswijcklaan Ringfietspad
658,Ringfietspad Jan Van Rijswijcklaan,2022-12-13,05:00:00,18,6,12,FMN 11 A Jan Van Rijswijcklaan Ringfietspad
658,Ringfietspad Jan Van Rijswijcklaan,2022-12-13,06:00:00,44,11,33,FMN 11 A Jan Van Rijswijcklaan Ringfietspad
658,Ringfietspad Jan Van Rijswijcklaan,2022-12-13,07:00:00,89,33,56,FMN 11 A Jan Van Rijswijcklaan Ringfietspad
658,Ringfietspad Jan Van Rijswijcklaan,2022-12-13,08:00:00,114,36,78,FMN 11 A Jan Van Rijswijcklaan Ringfietspad
658,Ringfietspad Jan Van Rijswijcklaan,2022-12-13,09:00:00,42,15,27,FMN 11 A Jan Van Rijswijcklaan Ringfietspad
658,Ringfietspad Jan Van Rijswijcklaan,2022-12-13,10:00:00,27,13,14,FMN 11 A Jan Van Rijswijcklaan Ringfietspad
658,Ringfietspad Jan Van Rijswijcklaan,2022-12-13,11:00:00,26,14,12,FMN 11 A Jan Van Rijswijcklaan Ringfietspad
658,Ringfietspad Jan Van Rijswijcklaan,2022-12-13,12:00:00,36,20,16,FMN 11 A Jan Van Rijswijcklaan Ringfietspad
658,Ringfietspad Jan Van Rijswijcklaan,2022-12-13,13:00:00,39,19,20,FMN 11 A Jan Van Rijswijcklaan Ringfietspad
658,Ringfietspad Jan Van Rijswijcklaan,2022-12-13,14:00:00,42,24,18,FMN 11 A Jan Van Rijswijcklaan Ringfietspad
658,Ringfietspad Jan Van Rijswijcklaan,2022-12-13,15:00:00,63,41,22,FMN 11 A Jan Van Rijswijcklaan Ringfietspad
658,Ringfietspad Jan Van Rijswijcklaan,2022-12-13,16:00:00,103,71,32,FMN 11 A Jan Van Rijswijcklaan Ringfietspad
658,Ringfietspad Jan Van Rijswijcklaan,2022-12-13,17:00:00,110,72,38,FMN 11 A Jan Van Rijswijcklaan Ringfietspad
658,Ringfietspad Jan Van Rijswijcklaan,2022-12-13,18:00:00,66,41,25,FMN 11 A Jan Van Rijswijcklaan Ringfietspad
658,Ringfietspad Jan Van Rijswijcklaan,2022-12-13,19:00:00,29,18,11,FMN 11 A Jan Van Rijswijcklaan Ringfietspad
658,Ringfietspad Jan Van Rijswijcklaan,2022-12-13,20:00:00,21,12,9,FMN 11 A Jan Van Rijswijcklaan Ringfietspad
658,Ringfietspad Jan Van Rijswijcklaan,2022-12-13,21:00:00,14,8,6,FMN 11 A Jan Van Rijswijcklaan Ringfietspad
658,Ringfietspad Jan Van Rijswijcklaan,2022-12-13,22:00:00,13,8,5,FMN 11 A Jan Van Rijswijcklaan Ringfietspad
658,Ringfietspad Jan Van Rijswijcklaan,2022-12-13,23:00:00,6,4,2,FMN 11 A Jan Van Rijswijcklaan Ringfietspad
658,Ringfietspad Jan Van Rijswijcklaan,2022-12-14,00:00:00,2,2,0,FMN 11 A Jan Van Rijswijcklaan Ringfietspad
658,Ringfietspad Jan Van Rijswijcklaan,2022-12-14,01:00:00,1,0,1,FMN 11 A Jan Van Rijswijcklaan Ringfietspad
658,Ringfietspad Jan Van Rijswijcklaan,2022-12-14,02:00:00,1,1,0,FMN 11 A Jan Van Rijswijcklaan Ringfietspad
658,Ringfietspad Jan Van Rijswijcklaan,2022-12-14,03:00:00,1,1,0,FMN 11 A Jan Van Rijswijcklaan Ringfietspad
658,Ringfietspad Jan Van Rijswijcklaan,2022-12-14,04:00:00,5,3,2,FMN 11 A Jan Van Rijswijcklaan Ringfietspad
658,Ringfietspad Jan Van Rijswijcklaan,2022-12-14,05:00:00,18,6,12,FMN 11 A Jan Van Rijswijcklaan Ringfietspad
658,Ringfietspad Jan Van Rijswijcklaan,2022-12-14,06:00:00,45,10,35,FMN 11 A Jan Van Rijswijcklaan Ringfietspad
658,Ringfietspad Jan Van Rijswijcklaan,2022-12-14,07:00:00,85,30,55,FMN 11 A Jan Van Rijswijcklaan Ringfietspad
658,Ringfietspad Jan Van Rijswijcklaan,2022-12-14,08:00:00,101,35,66,FMN 11 A Jan Van Rijswijcklaan Ringfietspad
658,Ringfietspad Jan Van Rijswijcklaan,2022-12-14,09:00:00,38,15,23,FMN 11 A Jan Van Rijswijcklaan Ringfietspad
658,Ringfietspad Jan Van Rijswijcklaan,2022-12-14,10:00:00,28,12,16,FMN 11 A Jan Van Rijswijcklaan Ringfietspad
658,Ringfietspad Jan Van Rijswijcklaan,2022-12-14,11:00:00,29,13,16,FMN 11 A Jan Van Rijswijcklaan Ringfietspad
658,Ringfietspad Jan Van Rijswijcklaan,2022-12-14,12:00:00,46,23,23,FMN 11 A Jan Van Rijswijcklaan Ringfietspad
658,Ringfietspad Jan Van Rijswijcklaan,2022-12-14,13:00:00,44,23,21,FMN 11 A Jan Van Rijswijcklaan Ringfietspad
658,Ringfietspad Jan Van Rijswijcklaan,2022-12-14,14:00:00,47,28,19,FMN 11 A Jan Van Rijswijcklaan Ringfietspad
658,Ringfietspad Jan Van Rijswijcklaan,2022-12-14,15:00:00,61,40,21,FMN 11 A Jan Van Rijswijcklaan Ringfietspad
658,Ringfietspad Jan Van Rijswijcklaan,2022-12-14,16:00:00,95,65,30,FMN 11 A Jan Van Rijswijcklaan Ringfietspad
658,Ringfietspad Jan Van Rijswijcklaan,2022-12-14,17:00:00,103,67,36,FMN 11 A Jan Van Rijswijcklaan Ringfietspad
658,Ringfietspad Jan Van Rijswijcklaan,2022-12-14,18:00:00,62,37,25,FMN 11 A Jan Van Rijswijcklaan Ringfietspad
658,Ringfietspad Jan Van Rijswijcklaan,2022-12-14,19:00:00,33,15,18,FMN 11 A Jan Van Rijswijcklaan Ringfietspad
658,Ringfietspad Jan Van Rijswijcklaan,2022-12-14,20:00:00,22,10,12,FMN 11 A Jan Van Rijswijcklaan Ringfietspad
658,Ringfietspad Jan Van Rijswijcklaan,2022-12-14,21:00:00,16,10,6,FMN 11 A Jan Van Rijswijcklaan Ringfietspad
658,Ringfietspad Jan Van Rijswijcklaan,2022-12-14,22:00:00,14,11,3,FMN 11 A Jan Van Rijswijcklaan Ringfietspad
658,Ringfietspad Jan Van Rijswijcklaan,2022-12-14,23:00:00,5,4,1,FMN 11 A Jan Van Rijswijcklaan Ringfietspad
658,Ringfietspad Jan Van Rijswijcklaan,2022-12-15,00:00:00,2,2,0,FMN 11 A Jan Van Rijswijcklaan Ringfietspad
658,Ringfietspad Jan Van Rijswijcklaan,2022-12-15,01:00:00,1,1,0,FMN 11 A Jan Van Rijswijcklaan Ringfietspad
658,Ringfietspad Jan Van Rijswijcklaan,2022-12-15,02:00:00,1,0,1,FMN 11 A Jan Van Rijswijcklaan Ringfietspad
658,Ringfietspad Jan Van Rijswijcklaan,2022-12-15,03:00:00,2,1,1,FMN 11 A Jan Van Rijswijcklaan Ringfietspad
658,Ringfietspad Jan Van Rijswijcklaan,2022-12-15,04:00:00,5,2,3,FMN 11 A Jan Van Rijswijcklaan Ringfietspad
658,Ringfietspad Jan Van Rijswijcklaan,2022-12-15,05:00:00,17,3,14,FMN 11 A Jan Van Rijswijcklaan Ringfietspad
658,Ringfietspad Jan Van Rijswijcklaan,2022-12-15,06:00:00,43,10,33,FMN 11 A Jan Van Rijswijcklaan Ringfietspad
658,Ringfietspad Jan Van Rijswijcklaan,2022-12-15,07:00:00,83,28,55,FMN 11 A Jan Van Rijswijcklaan Ringfietspad
658,Ringfietspad Jan Van Rijswijcklaan,2022-12-15,08:00:00,112,36,76,FMN 11 A Jan Van Rijswijcklaan Ringfietspad
658,Ringfietspad Jan Van Rijswijcklaan,2022-12-15,09:00:00,44,16,28,FMN 11 A Jan Van Rijswijcklaan Ringfietspad
658,Ringfietspad Jan Van Rijswijcklaan,2022-12-15,10:00:00,28,13,15,FMN 11 A Jan Van Rijswijcklaan Ringfietspad
658,Ringfietspad Jan Van Rijswijcklaan,2022-12-15,11:00:00,27,13,14,FMN 11 A Jan Van Rijswijcklaan Ringfietspad
658,Ringfietspad Jan Van Rijswijcklaan,2022-12-15,12:00:00,40,20,20,FMN 11 A Jan Van Rijswijcklaan Ringfietspad
658,Ringfietspad Jan Van Rijswijcklaan,2022-12-15,13:00:00,41,21,20,FMN 11 A Jan Van Rijswijcklaan Ringfietspad
658,Ringfietspad Jan Van Rijswijcklaan,2022-12-15,14:00:00,47,26,21,FMN 11 A Jan Van Rijswijcklaan Ringfietspad
658,Ringfietspad Jan Van Rijswijcklaan,2022-12-15,15:00:00,65,44,21,FMN 11 A Jan Van Rijswijcklaan Ringfietspad
658,Ringfietspad Jan Van Rijswijcklaan,2022-12-15,16:00:00,99,65,34,FMN 11 A Jan Van Rijswijcklaan Ringfietspad
658,Ringfietspad Jan Van Rijswijcklaan,2022-12-15,17:00:00,100,64,36,FMN 11 A Jan Van Rijswijcklaan Ringfietspad
658,Ringfietspad Jan Van Rijswijcklaan,2022-12-15,18:00:00,64,37,27,FMN 11 A Jan Van Rijswijcklaan Ringfietspad
658,Ringfietspad Jan Van Rijswijcklaan,2022-12-15,19:00:00,33,20,13,FMN 11 A Jan Van Rijswijcklaan Ringfietspad
658,Ringfietspad Jan Van Rijswijcklaan,2022-12-15,20:00:00,23,12,11,FMN 11 A Jan Van Rijswijcklaan Ringfietspad
658,Ringfietspad Jan Van Rijswijcklaan,2022-12-15,21:00:00,15,7,8,FMN 11 A Jan Van Rijswijcklaan Ringfietspad
658,Ringfietspad Jan Van Rijswijcklaan,2022-12-15,22:00:00,14,9,5,FMN 11 A Jan Van Rijswijcklaan Ringfietspad
658,Ringfietspad Jan Van Rijswijcklaan,2022-12-15,23:00:00,6,5,1,FMN 11 A Jan Van Rijswijcklaan Ringfietspad
658,Ringfietspad Jan Van Rijswijcklaan,2022-12-16,00:00:00,3,2,1,FMN 11 A Jan Van Rijswijcklaan Ringfietspad
658,Ringfietspad Jan Van Rijswijcklaan,2022-12-16,01:00:00,2,1,1,FMN 11 A Jan Van Rijswijcklaan Ringfietspad
658,Ringfietspad Jan Van Rijswijcklaan,2022-12-16,02:00:00,1,0,1,FMN 11 A Jan Van Rijswijcklaan Ringfietspad
658,Ringfietspad Jan Van Rijswijcklaan,2022-12-16,03:00:00,1,0,1,FMN 11 A Jan Van Rijswijcklaan Ringfietspad
658,Ringfietspad Jan Van Rijswijcklaan,2022-12-16,04:00:00,5,2,3,FMN 11 A Jan Van Rijswijcklaan Ringfietspad
658,Ringfietspad Jan Van Rijswijcklaan,2022-12-16,05:00:00,14,4,10,FMN 11 A Jan Van Rijswijcklaan Ringfietspad
658,Ringfietspad Jan Van Rijswijcklaan,2022-12-16,06:00:00,39,10,29,FMN 11 A Jan Van Rijswijcklaan Ringfietspad
658,Ringfietspad Jan Van Rijswijcklaan,2022-12-16,07:00:00,73,23,50,FMN 11 A Jan Van Rijswijcklaan Ringfietspad
658,Ringfietspad Jan Van Rijswijcklaan,2022-12-16,08:00:00,103,32,71,FMN 11 A Jan Van Rijswijcklaan Ringfietspad
658,Ringfietspad Jan Van Rijswijcklaan,2022-12-16,09:00:00,43,15,28,FMN 11 A Jan Van Rijswijcklaan Ringfietspad
658,Ringfietspad Jan Van Rijswijcklaan,2022-12-16,10:00:00,31,15,16,FMN 11 A Jan Van Rijswijcklaan Ringfietspad
658,Ringfietspad Jan Van Rijswijcklaan,2022-12-16,11:00:00,30,14,16,FMN 11 A Jan Van Rijswijcklaan Ringfietspad
658,Ringfietspad Jan Van Rijswijcklaan,2022-12-16,12:00:00,43,21,22,FMN 11 A Jan Van Rijswijcklaan Ringfietspad
658,Ringfietspad Jan Van Rijswijcklaan,2022-12-16,13:00:00,42,22,20,FMN 11 A Jan Van Rijswijcklaan Ringfietspad
658,Ringfietspad Jan Van Rijswijcklaan,2022-12-16,14:00:00,51,33,18,FMN 11 A Jan Van Rijswijcklaan Ringfietspad
658,Ringfietspad Jan Van Rijswijcklaan,2022-12-16,15:00:00,72,49,23,FMN 11 A Jan Van Rijswijcklaan Ringfietspad
658,Ringfietspad Jan Van Rijswijcklaan,2022-12-16,16:00:00,95,63,32,FMN 11 A Jan Van Rijswijcklaan Ringfietspad
658,Ringfietspad Jan Van Rijswijcklaan,2022-12-16,17:00:00,81,55,26,FMN 11 A Jan Van Rijswijcklaan Ringfietspad
658,Ringfietspad Jan Van Rijswijcklaan,2022-12-16,18:00:00,50,31,19,FMN 11 A Jan Van Rijswijcklaan Ringfietspad
658,Ringfietspad Jan Van Rijswijcklaan,2022-12-16,19:00:00,31,18,13,FMN 11 A Jan Van Rijswijcklaan Ringfietspad
658,Ringfietspad Jan Van Rijswijcklaan,2022-12-16,20:00:00,20,10,10,FMN 11 A Jan Van Rijswijcklaan Ringfietspad
658,Ringfietspad Jan Van Rijswijcklaan,2022-12-16,21:00:00,13,8,5,FMN 11 A Jan Van Rijswijcklaan Ringfietspad
658,Ringfietspad Jan Van Rijswijcklaan,2022-12-16,22:00:00,13,11,2,FMN 11 A Jan Van Rijswijcklaan Ringfietspad
658,Ringfietspad Jan Van Rijswijcklaan,2022-12-16,23:00:00,8,3,5,FMN 11 A Jan Van Rijswijcklaan Ringfietspad
658,Ringfietspad Jan Van Rijswijcklaan,2022-12-17,00:00:00,4,3,1,FMN 11 A Jan Van Rijswijcklaan Ringfietspad
658,Ringfietspad Jan Van Rijswijcklaan,2022-12-17,01:00:00,2,1,1,FMN 11 A Jan Van Rijswijcklaan Ringfietspad
658,Ringfietspad Jan Van Rijswijcklaan,2022-12-17,02:00:00,2,1,1,FMN 11 A Jan Van Rijswijcklaan Ringfietspad
658,Ringfietspad Jan Van Rijswijcklaan,2022-12-17,03:00:00,1,1,0,FMN 11 A Jan Van Rijswijcklaan Ringfietspad
658,Ringfietspad Jan Van Rijswijcklaan,2022-12-17,04:00:00,2,2,0,FMN 11 A Jan Van Rijswijcklaan Ringfietspad
658,Ringfietspad Jan Van Rijswijcklaan,2022-12-17,05:00:00,3,0,3,FMN 11 A Jan Van Rijswijcklaan Ringfietspad
658,Ringfietspad Jan Van Rijswijcklaan,2022-12-17,06:00:00,5,1,4,FMN 11 A Jan Van Rijswijcklaan Ringfietspad
658,Ringfietspad Jan Van Rijswijcklaan,2022-12-17,07:00:00,5,4,1,FMN 11 A Jan Van Rijswijcklaan Ringfietspad
658,Ringfietspad Jan Van Rijswijcklaan,2022-12-17,08:00:00,11,7,4,FMN 11 A Jan Van Rijswijcklaan Ringfietspad
658,Ringfietspad Jan Van Rijswijcklaan,2022-12-17,09:00:00,19,8,11,FMN 11 A Jan Van Rijswijcklaan Ringfietspad
658,Ringfietspad Jan Van Rijswijcklaan,2022-12-17,10:00:00,23,11,12,FMN 11 A Jan Van Rijswijcklaan Ringfietspad
658,Ringfietspad Jan Van Rijswijcklaan,2022-12-17,11:00:00,26,12,14,FMN 11 A Jan Van Rijswijcklaan Ringfietspad
658,Ringfietspad Jan Van Rijswijcklaan,2022-12-17,12:00:00,27,13,14,FMN 11 A Jan Van Rijswijcklaan Ringfietspad
658,Ringfietspad Jan Van Rijswijcklaan,2022-12-17,13:00:00,34,15,19,FMN 11 A Jan Van Rijswijcklaan Ringfietspad
658,Ringfietspad Jan Van Rijswijcklaan,2022-12-17,14:00:00,39,20,19,FMN 11 A Jan Van Rijswijcklaan Ringfietspad
658,Ringfietspad Jan Van Rijswijcklaan,2022-12-17,15:00:00,38,21,17,FMN 11 A Jan Van Rijswijcklaan Ringfietspad
658,Ringfietspad Jan Van Rijswijcklaan,2022-12-17,16:00:00,34,21,13,FMN 11 A Jan Van Rijswijcklaan Ringfietspad
658,Ringfietspad Jan Van Rijswijcklaan,2022-12-17,17:00:00,26,15,11,FMN 11 A Jan Van Rijswijcklaan Ringfietspad
658,Ringfietspad Jan Van Rijswijcklaan,2022-12-17,18:00:00,21,12,9,FMN 11 A Jan Van Rijswijcklaan Ringfietspad
658,Ringfietspad Jan Van Rijswijcklaan,2022-12-17,19:00:00,14,7,7,FMN 11 A Jan Van Rijswijcklaan Ringfietspad
658,Ringfietspad Jan Van Rijswijcklaan,2022-12-17,20:00:00,11,2,9,FMN 11 A Jan Van Rijswijcklaan Ringfietspad
658,Ringfietspad Jan Van Rijswijcklaan,2022-12-17,21:00:00,8,3,5,FMN 11 A Jan Van Rijswijcklaan Ringfietspad
658,Ringfietspad Jan Van Rijswijcklaan,2022-12-17,22:00:00,6,6,0,FMN 11 A Jan Van Rijswijcklaan Ringfietspad
658,Ringfietspad Jan Van Rijswijcklaan,2022-12-17,23:00:00,5,4,1,FMN 11 A Jan Van Rijswijcklaan Ringfietspad
658,Ringfietspad Jan Van Rijswijcklaan,2022-12-18,00:00:00,1,1,0,FMN 11 A Jan Van Rijswijcklaan Ringfietspad
658,Ringfietspad Jan Van Rijswijcklaan,2022-12-18,01:00:00,1,1,0,FMN 11 A Jan Van Rijswijcklaan Ringfietspad
658,Ringfietspad Jan Van Rijswijcklaan,2022-12-18,02:00:00,1,1,0,FMN 11 A Jan Van Rijswijcklaan Ringfietspad
658,Ringfietspad Jan Van Rijswijcklaan,2022-12-18,03:00:00,0,0,0,FMN 11 A Jan Van Rijswijcklaan Ringfietspad
658,Ringfietspad Jan Van Rijswijcklaan,2022-12-18,04:00:00,1,0,1,FMN 11 A Jan Van Rijswijcklaan Ringfietspad
658,Ringfietspad Jan Van Rijswijcklaan,2022-12-18,05:00:00,0,0,0,FMN 11 A Jan Van Rijswijcklaan Ringfietspad
658,Ringfietspad Jan Van Rijswijcklaan,2022-12-18,06:00:00,2,0,2,FMN 11 A Jan Van Rijswijcklaan Ringfietspad
658,Ringfietspad Jan Van Rijswijcklaan,2022-12-18,07:00:00,1,0,1,FMN 11 A Jan Van Rijswijcklaan Ringfietspad
658,Ringfietspad Jan Van Rijswijcklaan,2022-12-18,08:00:00,5,1,4,FMN 11 A Jan Van Rijswijcklaan Ringfietspad
658,Ringfietspad Jan Van Rijswijcklaan,2022-12-18,09:00:00,11,4,7,FMN 11 A Jan Van Rijswijcklaan Ringfietspad
658,Ringfietspad Jan Van Rijswijcklaan,2022-12-18,10:00:00,13,4,9,FMN 11 A Jan Van Rijswijcklaan Ringfietspad
658,Ringfietspad Jan Van Rijswijcklaan,2022-12-18,11:00:00,15,7,8,FMN 11 A Jan Van Rijswijcklaan Ringfietspad
658,Ringfietspad Jan Van Rijswijcklaan,2022-12-18,12:00:00,17,8,9,FMN 11 A Jan Van Rijswijcklaan Ringfietspad
658,Ringfietspad Jan Van Rijswijcklaan,2022-12-18,13:00:00,19,9,10,FMN 11 A Jan Van Rijswijcklaan Ringfietspad
658,Ringfietspad Jan Van Rijswijcklaan,2022-12-18,14:00:00,21,11,10,FMN 11 A Jan Van Rijswijcklaan Ringfietspad
658,Ringfietspad Jan Van Rijswijcklaan,2022-12-18,15:00:00,20,12,8,FMN 11 A Jan Van Rijswijcklaan Ringfietspad
658,Ringfietspad Jan Van Rijswijcklaan,2022-12-18,16:00:00,16,9,7,FMN 11 A Jan Van Rijswijcklaan Ringfietspad
658,Ringfietspad Jan Van Rijswijcklaan,2022-12-18,17:00:00,13,11,2,FMN 11 A Jan Van Rijswijcklaan Ringfietspad
658,Ringfietspad Jan Van Rijswijcklaan,2022-12-18,18:00:00,9,6,3,FMN 11 A Jan Van Rijswijcklaan Ringfietspad
658,Ringfietspad Jan Van Rijswijcklaan,2022-12-18,19:00:00,6,2,4,FMN 11 A Jan Van Rijswijcklaan Ringfietspad
658,Ringfietspad Jan Van Rijswijcklaan,2022-12-18,20:00:00,5,3,2,FMN 11 A Jan Van Rijswijcklaan Ringfietspad
658,Ringfietspad Jan Van Rijswijcklaan,2022-12-18,21:00:00,3,2,1,FMN 11 A Jan Van Rijswijcklaan Ringfietspad
658,Ringfietspad Jan Van Rijswijcklaan,2022-12-18,22:00:00,2,0,2,FMN 11 A Jan Van Rijswijcklaan Ringfietspad
658,Ringfietspad Jan Van Rijswijcklaan,2022-12-18,23:00:00,1,1,0,FMN 11 A Jan Van Rijswijcklaan Ringfietspad
658,Ringfietspad Jan Van Rijswijcklaan,2022-12-19,00:00:00,1,0,1,FMN 11 A Jan Van Rijswijcklaan Ringfietspad
658,Ringfietspad Jan Van Rijswijcklaan,2022-12-19,01:00:00,1,0,1,FMN 11 A Jan Van Rijswijcklaan Ringfietspad
658,Ringfietspad Jan Van Rijswijcklaan,2022-12-19,02:00:00,1,1,0,FMN 11 A Jan Van Rijswijcklaan Ringfietspad
658,Ringfietspad Jan Van Rijswijcklaan,2022-12-19,03:00:00,1,1,0,FMN 11 A Jan Van Rijswijcklaan Ringfietspad
658,Ringfietspad Jan Van Rijswijcklaan,2022-12-19,04:00:00,5,2,3,FMN 11 A Jan Van Rijswijcklaan Ringfietspad
658,Ringfietspad Jan Van Rijswijcklaan,2022-12-19,05:00:00,15,5,10,FMN 11 A Jan Van Rijswijcklaan Ringfietspad
658,Ringfietspad Jan Van Rijswijcklaan,2022-12-19,06:00:00,40,11,29,FMN 11 A Jan Van Rijswijcklaan Ringfietspad
658,Ringfietspad Jan Van Rijswijcklaan,2022-12-19,07:00:00,82,29,53,FMN 11 A Jan Van Rijswijcklaan Ringfietspad
658,Ringfietspad Jan Van Rijswijcklaan,2022-12-19,08:00:00,107,35,72,FMN 11 A Jan Van Rijswijcklaan Ringfietspad
658,Ringfietspad Jan Van Rijswijcklaan,2022-12-19,09:00:00,38,10,28,FMN 11 A Jan Van Rijswijcklaan Ringfietspad
658,Ringfietspad Jan Van Rijswijcklaan,2022-12-19,10:00:00,26,13,13,FMN 11 A Jan Van Rijswijcklaan Ringfietspad
658,Ringfietspad Jan Van Rijswijcklaan,2022-12-19,11:00:00,25,12,13,FMN 11 A Jan Van Rijswijcklaan Ringfietspad
658,Ringfietspad Jan Van Rijswijcklaan,2022-12-19,12:00:00,37,18,19,FMN 11 A Jan Van Rijswijcklaan Ringfietspad
658,Ringfietspad Jan Van Rijswijcklaan,2022-12-19,13:00:00,38,20,18,FMN 11 A Jan Van Rijswijcklaan Ringfietspad
658,Ringfietspad Jan Van Rijswijcklaan,2022-12-19,14:00:00,44,26,18,FMN 11 A Jan Van Rijswijcklaan Ringfietspad
658,Ringfietspad Jan Van Rijswijcklaan,2022-12-19,15:00:00,62,43,19,FMN 11 A Jan Van Rijswijcklaan Ringfietspad
658,Ringfietspad Jan Van Rijswijcklaan,2022-12-19,16:00:00,97,66,31,FMN 11 A Jan Van Rijswijcklaan Ringfietspad
658,Ringfietspad Jan Van Rijswijcklaan,2022-12-19,17:00:00,103,68,35,FMN 11 A Jan Van Rijswijcklaan Ringfietspad
658,Ringfietspad Jan Van Rijswijcklaan,2022-12-19,18:00:00,59,36,23,FMN 11 A Jan Van Rijswijcklaan Ringfietspad
658,Ringfietspad Jan Van Rijswijcklaan,2022-12-19,19:00:00,29,17,12,FMN 11 A Jan Van Rijswijcklaan Ringfietspad
658,Ringfietspad Jan Van Rijswijcklaan,2022-12-19,20:00:00,20,10,10,FMN 11 A Jan Van Rijswijcklaan Ringfietspad
658,Ringfietspad Jan Van Rijswijcklaan,2022-12-19,21:00:00,13,4,9,FMN 11 A Jan Van Rijswijcklaan Ringfietspad
658,Ringfietspad Jan Van Rijswijcklaan,2022-12-19,22:00:00,13,9,4,FMN 11 A Jan Van Rijswijcklaan Ringfietspad
658,Ringfietspad Jan Van Rijswijcklaan,2022-12-19,23:00:00,4,3,1,FMN 11 A Jan Van Rijswijcklaan Ringfietspad
658,Ringfietspad Jan Van Rijswijcklaan,2022-12-20,00:00:00,1,1,0,FMN 11 A Jan Van Rijswijcklaan Ringfietspad
658,Ringfietspad Jan Van Rijswijcklaan,2022-12-20,01:00:00,1,1,0,FMN 11 A Jan Van Rijswijcklaan Ringfietspad
658,Ringfietspad Jan Van Rijswijcklaan,2022-12-20,02:00:00,0,0,0,FMN 11 A Jan Van Rijswijcklaan Ringfietspad
658,Ringfietspad Jan Van Rijswijcklaan,2022-12-20,03:00:00,1,1,0,FMN 11 A Jan Van Rijswijcklaan Ringfietspad
658,Ringfietspad Jan Van Rijswijcklaan,2022-12-20,04:00:00,5,3,2,FMN 11 A Jan Van Rijswijcklaan Ringfietspad
658,Ringfietspad Jan Van Rijswijcklaan,2022-12-20,05:00:00,14,2,12,FMN 11 A Jan Van Rijswijcklaan Ringfietspad
658,Ringfietspad Jan Van Rijswijcklaan,2022-12-20,06:00:00,38,7,31,FMN 11 A Jan Van Rijswijcklaan Ringfietspad
658,Ringfietspad Jan Van Rijswijcklaan,2022-12-20,07:00:00,74,26,48,FMN 11 A Jan Van Rijswijcklaan Ringfietspad
658,Ringfietspad Jan Van Rijswijcklaan,2022-12-20,08:00:00,96,35,61,FMN 11 A Jan Van Rijswijcklaan Ringfietspad
658,Ringfietspad Jan Van Rijswijcklaan,2022-12-20,09:00:00,36,13,23,FMN 11 A Jan Van Rijswijcklaan Ringfietspad
658,Ringfietspad Jan Van Rijswijcklaan,2022-12-20,10:00:00,22,9,13,FMN 11 A Jan Van Rijswijcklaan Ringfietspad
658,Ringfietspad Jan Van Rijswijcklaan,2022-12-20,11:00:00,22,10,12,FMN 11 A Jan Van Rijswijcklaan Ringfietspad
658,Ringfietspad Jan Van Rijswijcklaan,2022-12-20,12:00:00,31,13,18,FMN 11 A Jan Van Rijswijcklaan Ringfietspad
658,Ringfietspad Jan Van Rijswijcklaan,2022-12-20,13:00:00,32,18,14,FMN 11 A Jan Van Rijswijcklaan Ringfietspad
658,Ringfietspad Jan Van Rijswijcklaan,2022-12-20,14:00:00,35,19,16,FMN 11 A Jan Van Rijswijcklaan Ringfietspad
658,Ringfietspad Jan Van Rijswijcklaan,2022-12-20,15:00:00,53,36,17,FMN 11 A Jan Van Rijswijcklaan Ringfietspad
658,Ringfietspad Jan Van Rijswijcklaan,2022-12-20,16:00:00,87,60,27,FMN 11 A Jan Van Rijswijcklaan Ringfietspad
658,Ringfietspad Jan Van Rijswijcklaan,2022-12-20,17:00:00,92,59,33,FMN 11 A Jan Van Rijswijcklaan Ringfietspad
658,Ringfietspad Jan Van Rijswijcklaan,2022-12-20,18:00:00,56,34,22,FMN 11 A Jan Van Rijswijcklaan Ringfietspad
658,Ringfietspad Jan Van Rijswijcklaan,2022-12-20,19:00:00,24,13,11,FMN 11 A Jan Van Rijswijcklaan Ringfietspad
658,Ringfietspad Jan Van Rijswijcklaan,2022-12-20,20:00:00,18,7,11,FMN 11 A Jan Van Rijswijcklaan Ringfietspad
658,Ringfietspad Jan Van Rijswijcklaan,2022-12-20,21:00:00,12,5,7,FMN 11 A Jan Van Rijswijcklaan Ringfietspad
658,Ringfietspad Jan Van Rijswijcklaan,2022-12-20,22:00:00,11,9,2,FMN 11 A Jan Van Rijswijcklaan Ringfietspad
658,Ringfietspad Jan Van Rijswijcklaan,2022-12-20,23:00:00,4,1,3,FMN 11 A Jan Van Rijswijcklaan Ringfietspad
658,Ringfietspad Jan Van Rijswijcklaan,2022-12-21,00:00:00,2,2,0,FMN 11 A Jan Van Rijswijcklaan Ringfietspad
658,Ringfietspad Jan Van Rijswijcklaan,2022-12-21,01:00:00,1,1,0,FMN 11 A Jan Van Rijswijcklaan Ringfietspad
658,Ringfietspad Jan Van Rijswijcklaan,2022-12-21,02:00:00,1,0,1,FMN 11 A Jan Van Rijswijcklaan Ringfietspad
658,Ringfietspad Jan Van Rijswijcklaan,2022-12-21,03:00:00,1,1,0,FMN 11 A Jan Van Rijswijcklaan Ringfietspad
658,Ringfietspad Jan Van Rijswijcklaan,2022-12-21,04:00:00,5,0,5,FMN 11 A Jan Van Rijswijcklaan Ringfietspad
658,Ringfietspad Jan Van Rijswijcklaan,2022-12-21,05:00:00,17,4,13,FMN 11 A Jan Van Rijswijcklaan Ringfietspad
658,Ringfietspad Jan Van Rijswijcklaan,2022-12-21,06:00:00,44,10,34,FMN 11 A Jan Van Rijswijcklaan Ringfietspad
658,Ringfietspad Jan Van Rijswijcklaan,2022-12-21,07:00:00,84,28,56,FMN 11 A Jan Van Rijswijcklaan Ringfietspad
658,Ringfietspad Jan Van Rijswijcklaan,2022-12-21,08:00:00,99,34,65,FMN 11 A Jan Van Rijswijcklaan Ringfietspad
658,Ringfietspad Jan Van Rijswijcklaan,2022-12-21,09:00:00,38,13,25,FMN 11 A Jan Van Rijswijcklaan Ringfietspad
658,Ringfietspad Jan Van Rijswijcklaan,2022-12-21,10:00:00,28,14,14,FMN 11 A Jan Van Rijswijcklaan Ringfietspad
658,Ringfietspad Jan Van Rijswijcklaan,2022-12-21,11:00:00,28,14,14,FMN 11 A Jan Van Rijswijcklaan Ringfietspad
658,Ringfietspad Jan Van Rijswijcklaan,2022-12-21,12:00:00,45,21,24,FMN 11 A Jan Van Rijswijcklaan Ringfietspad
658,Ringfietspad Jan Van Rijswijcklaan,2022-12-21,13:00:00,43,20,23,FMN 11 A Jan Van Rijswijcklaan Ringfietspad
658,Ringfietspad Jan Van Rijswijcklaan,2022-12-21,14:00:00,47,26,21,FMN 11 A Jan Van Rijswijcklaan Ringfietspad
658,Ringfietspad Jan Van Rijswijcklaan,2022-12-21,15:00:00,60,36,24,FMN 11 A Jan Van Rijswijcklaan Ringfietspad
658,Ringfietspad Jan Van Rijswijcklaan,2022-12-21,16:00:00,93,63,30,FMN 11 A Jan Van Rijswijcklaan Ringfietspad
658,Ringfietspad Jan Van Rijswijcklaan,2022-12-21,17:00:00,101,65,36,FMN 11 A Jan Van Rijswijcklaan Ringfietspad
658,Ringfietspad Jan Van Rijswijcklaan,2022-12-21,18:00:00,61,35,26,FMN 11 A Jan Van Rijswijcklaan Ringfietspad
658,Ringfietspad Jan Van Rijswijcklaan,2022-12-21,19:00:00,32,17,15,FMN 11 A Jan Van Rijswijcklaan Ringfietspad
658,Ringfietspad Jan Van Rijswijcklaan,2022-12-21,20:00:00,22,10,12,FMN 11 A Jan Van Rijswijcklaan Ringfietspad
658,Ringfietspad Jan Van Rijswijcklaan,2022-12-21,21:00:00,16,7,9,FMN 11 A Jan Van Rijswijcklaan Ringfietspad
658,Ringfietspad Jan Van Rijswijcklaan,2022-12-21,22:00:00,13,4,9,FMN 11 A Jan Van Rijswijcklaan Ringfietspad
658,Ringfietspad Jan Van Rijswijcklaan,2022-12-21,23:00:00,6,3,3,FMN 11 A Jan Van Rijswijcklaan Ringfietspad
658,Ringfietspad Jan Van Rijswijcklaan,2022-12-22,00:00:00,2,2,0,FMN 11 A Jan Van Rijswijcklaan Ringfietspad
658,Ringfietspad Jan Van Rijswijcklaan,2022-12-22,01:00:00,1,1,0,FMN 11 A Jan Van Rijswijcklaan Ringfietspad
658,Ringfietspad Jan Van Rijswijcklaan,2022-12-22,02:00:00,1,1,0,FMN 11 A Jan Van Rijswijcklaan Ringfietspad
658,Ringfietspad Jan Van Rijswijcklaan,2022-12-22,03:00:00,2,2,0,FMN 11 A Jan Van Rijswijcklaan Ringfietspad
658,Ringfietspad Jan Van Rijswijcklaan,2022-12-22,04:00:00,5,3,2,FMN 11 A Jan Van Rijswijcklaan Ringfietspad
658,Ringfietspad Jan Van Rijswijcklaan,2022-12-22,05:00:00,17,3,14,FMN 11 A Jan Van Rijswijcklaan Ringfietspad
658,Ringfietspad Jan Van Rijswijcklaan,2022-12-22,06:00:00,43,11,32,FMN 11 A Jan Van Rijswijcklaan Ringfietspad
658,Ringfietspad Jan Van Rijswijcklaan,2022-12-22,07:00:00,81,27,54,FMN 11 A Jan Van Rijswijcklaan Ringfietspad
658,Ringfietspad Jan Van Rijswijcklaan,2022-12-22,08:00:00,112,36,76,FMN 11 A Jan Van Rijswijcklaan Ringfietspad
658,Ringfietspad Jan Van Rijswijcklaan,2022-12-22,09:00:00,43,15,28,FMN 11 A Jan Van Rijswijcklaan Ringfietspad
658,Ringfietspad Jan Van Rijswijcklaan,2022-12-22,10:00:00,28,12,16,FMN 11 A Jan Van Rijswijcklaan Ringfietspad
658,Ringfietspad Jan Van Rijswijcklaan,2022-12-22,11:00:00,28,13,15,FMN 11 A Jan Van Rijswijcklaan Ringfietspad
658,Ringfietspad Jan Van Rijswijcklaan,2022-12-22,12:00:00,39,19,20,FMN 11 A Jan Van Rijswijcklaan Ringfietspad
658,Ringfietspad Jan Van Rijswijcklaan,2022-12-22,13:00:00,41,21,20,FMN 11 A Jan Van Rijswijcklaan Ringfietspad
658,Ringfietspad Jan Van Rijswijcklaan,2022-12-22,14:00:00,46,27,19,FMN 11 A Jan Van Rijswijcklaan Ringfietspad
658,Ringfietspad Jan Van Rijswijcklaan,2022-12-22,15:00:00,65,46,19,FMN 11 A Jan Van Rijswijcklaan Ringfietspad
658,Ringfietspad Jan Van Rijswijcklaan,2022-12-22,16:00:00,98,63,35,FMN 11 A Jan Van Rijswijcklaan Ringfietspad
658,Ringfietspad Jan Van Rijswijcklaan,2022-12-22,17:00:00,100,68,32,FMN 11 A Jan Van Rijswijcklaan Ringfietspad
658,Ringfietspad Jan Van Rijswijcklaan,2022-12-22,18:00:00,63,38,25,FMN 11 A Jan Van Rijswijcklaan Ringfietspad
658,Ringfietspad Jan Van Rijswijcklaan,2022-12-22,19:00:00,33,21,12,FMN 11 A Jan Van Rijswijcklaan Ringfietspad
658,Ringfietspad Jan Van Rijswijcklaan,2022-12-22,20:00:00,22,10,12,FMN 11 A Jan Van Rijswijcklaan Ringfietspad
658,Ringfietspad Jan Van Rijswijcklaan,2022-12-22,21:00:00,16,6,10,FMN 11 A Jan Van Rijswijcklaan Ringfietspad
658,Ringfietspad Jan Van Rijswijcklaan,2022-12-22,22:00:00,13,8,5,FMN 11 A Jan Van Rijswijcklaan Ringfietspad
658,Ringfietspad Jan Van Rijswijcklaan,2022-12-22,23:00:00,7,5,2,FMN 11 A Jan Van Rijswijcklaan Ringfietspad
658,Ringfietspad Jan Van Rijswijcklaan,2022-12-23,00:00:00,3,2,1,FMN 11 A Jan Van Rijswijcklaan Ringfietspad
658,Ringfietspad Jan Van Rijswijcklaan,2022-12-23,01:00:00,1,1,0,FMN 11 A Jan Van Rijswijcklaan Ringfietspad
658,Ringfietspad Jan Van Rijswijcklaan,2022-12-23,02:00:00,1,1,0,FMN 11 A Jan Van Rijswijcklaan Ringfietspad
658,Ringfietspad Jan Van Rijswijcklaan,2022-12-23,03:00:00,1,0,1,FMN 11 A Jan Van Rijswijcklaan Ringfietspad
658,Ringfietspad Jan Van Rijswijcklaan,2022-12-23,04:00:00,5,2,3,FMN 11 A Jan Van Rijswijcklaan Ringfietspad
658,Ringfietspad Jan Van Rijswijcklaan,2022-12-23,05:00:00,12,3,9,FMN 11 A Jan Van Rijswijcklaan Ringfietspad
658,Ringfietspad Jan Van Rijswijcklaan,2022-12-23,06:00:00,35,10,25,FMN 11 A Jan Van Rijswijcklaan Ringfietspad
658,Ringfietspad Jan Van Rijswijcklaan,2022-12-23,07:00:00,65,23,42,FMN 11 A Jan Van Rijswijcklaan Ringfietspad
658,Ringfietspad Jan Van Rijswijcklaan,2022-12-23,08:00:00,92,31,61,FMN 11 A Jan Van Rijswijcklaan Ringfietspad
658,Ringfietspad Jan Van Rijswijcklaan,2022-12-23,09:00:00,38,15,23,FMN 11 A Jan Van Rijswijcklaan Ringfietspad
658,Ringfietspad Jan Van Rijswijcklaan,2022-12-23,10:00:00,28,13,15,FMN 11 A Jan Van Rijswijcklaan Ringfietspad
658,Ringfietspad Jan Van Rijswijcklaan,2022-12-23,11:00:00,27,14,13,FMN 11 A Jan Van Rijswijcklaan Ringfietspad
658,Ringfietspad Jan Van Rijswijcklaan,2022-12-23,12:00:00,37,17,20,FMN 11 A Jan Van Rijswijcklaan Ringfietspad
658,Ringfietspad Jan Van Rijswijcklaan,2022-12-23,13:00:00,38,23,15,FMN 11 A Jan Van Rijswijcklaan Ringfietspad
658,Ringfietspad Jan Van Rijswijcklaan,2022-12-23,14:00:00,45,27,18,FMN 11 A Jan Van Rijswijcklaan Ringfietspad
658,Ringfietspad Jan Van Rijswijcklaan,2022-12-23,15:00:00,65,42,23,FMN 11 A Jan Van Rijswijcklaan Ringfietspad
658,Ringfietspad Jan Van Rijswijcklaan,2022-12-23,16:00:00,85,55,30,FMN 11 A Jan Van Rijswijcklaan Ringfietspad
658,Ringfietspad Jan Van Rijswijcklaan,2022-12-23,17:00:00,72,47,25,FMN 11 A Jan Van Rijswijcklaan Ringfietspad
658,Ringfietspad Jan Van Rijswijcklaan,2022-12-23,18:00:00,44,26,18,FMN 11 A Jan Van Rijswijcklaan Ringfietspad
658,Ringfietspad Jan Van Rijswijcklaan,2022-12-23,19:00:00,28,15,13,FMN 11 A Jan Van Rijswijcklaan Ringfietspad
658,Ringfietspad Jan Van Rijswijcklaan,2022-12-23,20:00:00,17,9,8,FMN 11 A Jan Van Rijswijcklaan Ringfietspad
658,Ringfietspad Jan Van Rijswijcklaan,2022-12-23,21:00:00,12,7,5,FMN 11 A Jan Van Rijswijcklaan Ringfietspad
658,Ringfietspad Jan Van Rijswijcklaan,2022-12-23,22:00:00,12,7,5,FMN 11 A Jan Van Rijswijcklaan Ringfietspad
658,Ringfietspad Jan Van Rijswijcklaan,2022-12-23,23:00:00,6,4,2,FMN 11 A Jan Van Rijswijcklaan Ringfietspad
658,Ringfietspad Jan Van Rijswijcklaan,2022-12-24,00:00:00,4,2,2,FMN 11 A Jan Van Rijswijcklaan Ringfietspad
658,Ringfietspad Jan Van Rijswijcklaan,2022-12-24,01:00:00,2,1,1,FMN 11 A Jan Van Rijswijcklaan Ringfietspad
658,Ringfietspad Jan Van Rijswijcklaan,2022-12-24,02:00:00,1,1,0,FMN 11 A Jan Van Rijswijcklaan Ringfietspad
658,Ringfietspad Jan Van Rijswijcklaan,2022-12-24,03:00:00,2,2,0,FMN 11 A Jan Van Rijswijcklaan Ringfietspad
658,Ringfietspad Jan Van Rijswijcklaan,2022-12-24,04:00:00,2,1,1,FMN 11 A Jan Van Rijswijcklaan Ringfietspad
658,Ringfietspad Jan Van Rijswijcklaan,2022-12-24,05:00:00,2,2,0,FMN 11 A Jan Van Rijswijcklaan Ringfietspad
658,Ringfietspad Jan Van Rijswijcklaan,2022-12-24,06:00:00,5,4,1,FMN 11 A Jan Van Rijswijcklaan Ringfietspad
658,Ringfietspad Jan Van Rijswijcklaan,2022-12-24,07:00:00,5,1,4,FMN 11 A Jan Van Rijswijcklaan Ringfietspad
658,Ringfietspad Jan Van Rijswijcklaan,2022-12-24,08:00:00,10,9,1,FMN 11 A Jan Van Rijswijcklaan Ringfietspad
658,Ringfietspad Jan Van Rijswijcklaan,2022-12-24,09:00:00,19,9,10,FMN 11 A Jan Van Rijswijcklaan Ringfietspad
658,Ringfietspad Jan Van Rijswijcklaan,2022-12-24,10:00:00,23,12,11,FMN 11 A Jan Van Rijswijcklaan Ringfietspad
658,Ringfietspad Jan Van Rijswijcklaan,2022-12-24,11:00:00,24,10,14,FMN 11 A Jan Van Rijswijcklaan Ringfietspad
658,Ringfietspad Jan Van Rijswijcklaan,2022-12-24,12:00:00,27,12,15,FMN 11 A Jan Van Rijswijcklaan Ringfietspad
658,Ringfietspad Jan Van Rijswijcklaan,2022-12-24,13:00:00,32,15,17,FMN 11 A Jan Van Rijswijcklaan Ringfietspad
658,Ringfietspad Jan Van Rijswijcklaan,2022-12-24,14:00:00,39,22,17,FMN 11 A Jan Van Rijswijcklaan Ringfietspad
658,Ringfietspad Jan Van Rijswijcklaan,2022-12-24,15:00:00,36,21,15,FMN 11 A Jan Van Rijswijcklaan Ringfietspad
658,Ringfietspad Jan Van Rijswijcklaan,2022-12-24,16:00:00,33,21,12,FMN 11 A Jan Van Rijswijcklaan Ringfietspad
658,Ringfietspad Jan Van Rijswijcklaan,2022-12-24,17:00:00,25,15,10,FMN 11 A Jan Van Rijswijcklaan Ringfietspad
658,Ringfietspad Jan Van Rijswijcklaan,2022-12-24,18:00:00,20,12,8,FMN 11 A Jan Van Rijswijcklaan Ringfietspad
658,Ringfietspad Jan Van Rijswijcklaan,2022-12-24,19:00:00,14,10,4,FMN 11 A Jan Van Rijswijcklaan Ringfietspad
658,Ringfietspad Jan Van Rijswijcklaan,2022-12-24,20:00:00,10,7,3,FMN 11 A Jan Van Rijswijcklaan Ringfietspad
658,Ringfietspad Jan Van Rijswijcklaan,2022-12-24,21:00:00,8,4,4,FMN 11 A Jan Van Rijswijcklaan Ringfietspad
658,Ringfietspad Jan Van Rijswijcklaan,2022-12-24,22:00:00,6,2,4,FMN 11 A Jan Van Rijswijcklaan Ringfietspad
658,Ringfietspad Jan Van Rijswijcklaan,2022-12-24,23:00:00,4,2,2,FMN 11 A Jan Van Rijswijcklaan Ringfietspad
658,Ringfietspad Jan Van Rijswijcklaan,2022-12-25,00:00:00,1,1,0,FMN 11 A Jan Van Rijswijcklaan Ringfietspad
658,Ringfietspad Jan Van Rijswijcklaan,2022-12-25,01:00:00,0,0,0,FMN 11 A Jan Van Rijswijcklaan Ringfietspad
658,Ringfietspad Jan Van Rijswijcklaan,2022-12-25,02:00:00,0,0,0,FMN 11 A Jan Van Rijswijcklaan Ringfietspad
658,Ringfietspad Jan Van Rijswijcklaan,2022-12-25,03:00:00,1,0,1,FMN 11 A Jan Van Rijswijcklaan Ringfietspad
658,Ringfietspad Jan Van Rijswijcklaan,2022-12-25,04:00:00,0,0,0,FMN 11 A Jan Van Rijswijcklaan Ringfietspad
658,Ringfietspad Jan Van Rijswijcklaan,2022-12-25,05:00:00,0,0,0,FMN 11 A Jan Van Rijswijcklaan Ringfietspad
658,Ringfietspad Jan Van Rijswijcklaan,2022-12-25,06:00:00,1,0,1,FMN 11 A Jan Van Rijswijcklaan Ringfietspad
658,Ringfietspad Jan Van Rijswijcklaan,2022-12-25,07:00:00,1,0,1,FMN 11 A Jan Van Rijswijcklaan Ringfietspad
658,Ringfietspad Jan Van Rijswijcklaan,2022-12-25,08:00:00,2,0,2,FMN 11 A Jan Van Rijswijcklaan Ringfietspad
658,Ringfietspad Jan Van Rijswijcklaan,2022-12-25,09:00:00,6,6,0,FMN 11 A Jan Van Rijswijcklaan Ringfietspad
658,Ringfietspad Jan Van Rijswijcklaan,2022-12-25,10:00:00,7,4,3,FMN 11 A Jan Van Rijswijcklaan Ringfietspad
658,Ringfietspad Jan Van Rijswijcklaan,2022-12-25,11:00:00,8,4,4,FMN 11 A Jan Van Rijswijcklaan Ringfietspad
658,Ringfietspad Jan Van Rijswijcklaan,2022-12-25,12:00:00,8,4,4,FMN 11 A Jan Van Rijswijcklaan Ringfietspad
658,Ringfietspad Jan Van Rijswijcklaan,2022-12-25,13:00:00,10,5,5,FMN 11 A Jan Van Rijswijcklaan Ringfietspad
658,Ringfietspad Jan Van Rijswijcklaan,2022-12-25,14:00:00,11,5,6,FMN 11 A Jan Van Rijswijcklaan Ringfietspad
658,Ringfietspad Jan Van Rijswijcklaan,2022-12-25,15:00:00,10,5,5,FMN 11 A Jan Van Rijswijcklaan Ringfietspad
658,Ringfietspad Jan Van Rijswijcklaan,2022-12-25,16:00:00,9,6,3,FMN 11 A Jan Van Rijswijcklaan Ringfietspad
658,Ringfietspad Jan Van Rijswijcklaan,2022-12-25,17:00:00,7,4,3,FMN 11 A Jan Van Rijswijcklaan Ringfietspad
658,Ringfietspad Jan Van Rijswijcklaan,2022-12-25,18:00:00,4,2,2,FMN 11 A Jan Van Rijswijcklaan Ringfietspad
658,Ringfietspad Jan Van Rijswijcklaan,2022-12-25,19:00:00,3,2,1,FMN 11 A Jan Van Rijswijcklaan Ringfietspad
658,Ringfietspad Jan Van Rijswijcklaan,2022-12-25,20:00:00,3,2,1,FMN 11 A Jan Van Rijswijcklaan Ringfietspad
658,Ringfietspad Jan Van Rijswijcklaan,2022-12-25,21:00:00,2,2,0,FMN 11 A Jan Van Rijswijcklaan Ringfietspad
658,Ringfietspad Jan Van Rijswijcklaan,2022-12-25,22:00:00,1,0,1,FMN 11 A Jan Van Rijswijcklaan Ringfietspad
658,Ringfietspad Jan Van Rijswijcklaan,2022-12-25,23:00:00,0,0,0,FMN 11 A Jan Van Rijswijcklaan Ringfietspad
658,Ringfietspad Jan Van Rijswijcklaan,2022-12-26,00:00:00,1,0,1,FMN 11 A Jan Van Rijswijcklaan Ringfietspad
658,Ringfietspad Jan Van Rijswijcklaan,2022-12-26,01:00:00,0,0,0,FMN 11 A Jan Van Rijswijcklaan Ringfietspad
658,Ringfietspad Jan Van Rijswijcklaan,2022-12-26,02:00:00,0,0,0,FMN 11 A Jan Van Rijswijcklaan Ringfietspad
658,Ringfietspad Jan Van Rijswijcklaan,2022-12-26,03:00:00,0,0,0,FMN 11 A Jan Van Rijswijcklaan Ringfietspad
658,Ringfietspad Jan Van Rijswijcklaan,2022-12-26,04:00:00,2,2,0,FMN 11 A Jan Van Rijswijcklaan Ringfietspad
658,Ringfietspad Jan Van Rijswijcklaan,2022-12-26,05:00:00,6,1,5,FMN 11 A Jan Van Rijswijcklaan Ringfietspad
658,Ringfietspad Jan Van Rijswijcklaan,2022-12-26,06:00:00,15,2,13,FMN 11 A Jan Van Rijswijcklaan Ringfietspad
658,Ringfietspad Jan Van Rijswijcklaan,2022-12-26,07:00:00,30,12,18,FMN 11 A Jan Van Rijswijcklaan Ringfietspad
658,Ringfietspad Jan Van Rijswijcklaan,2022-12-26,08:00:00,39,12,27,FMN 11 A Jan Van Rijswijcklaan Ringfietspad
658,Ringfietspad Jan Van Rijswijcklaan,2022-12-26,09:00:00,14,5,9,FMN 11 A Jan Van Rijswijcklaan Ringfietspad
658,Ringfietspad Jan Van Rijswijcklaan,2022-12-26,10:00:00,10,6,4,FMN 11 A Jan Van Rijswijcklaan Ringfietspad
658,Ringfietspad Jan Van Rijswijcklaan,2022-12-26,11:00:00,9,4,5,FMN 11 A Jan Van Rijswijcklaan Ringfietspad
658,Ringfietspad Jan Van Rijswijcklaan,2022-12-26,12:00:00,14,5,9,FMN 11 A Jan Van Rijswijcklaan Ringfietspad
658,Ringfietspad Jan Van Rijswijcklaan,2022-12-26,13:00:00,14,8,6,FMN 11 A Jan Van Rijswijcklaan Ringfietspad
658,Ringfietspad Jan Van Rijswijcklaan,2022-12-26,14:00:00,16,9,7,FMN 11 A Jan Van Rijswijcklaan Ringfietspad
658,Ringfietspad Jan Van Rijswijcklaan,2022-12-26,15:00:00,23,14,9,FMN 11 A Jan Van Rijswijcklaan Ringfietspad
658,Ringfietspad Jan Van Rijswijcklaan,2022-12-26,16:00:00,36,24,12,FMN 11 A Jan Van Rijswijcklaan Ringfietspad
658,Ringfietspad Jan Van Rijswijcklaan,2022-12-26,17:00:00,38,24,14,FMN 11 A Jan Van Rijswijcklaan Ringfietspad
658,Ringfietspad Jan Van Rijswijcklaan,2022-12-26,18:00:00,21,12,9,FMN 11 A Jan Van Rijswijcklaan Ringfietspad
658,Ringfietspad Jan Van Rijswijcklaan,2022-12-26,19:00:00,11,6,5,FMN 11 A Jan Van Rijswijcklaan Ringfietspad
658,Ringfietspad Jan Van Rijswijcklaan,2022-12-26,20:00:00,7,3,4,FMN 11 A Jan Van Rijswijcklaan Ringfietspad
658,Ringfietspad Jan Van Rijswijcklaan,2022-12-26,21:00:00,5,5,0,FMN 11 A Jan Van Rijswijcklaan Ringfietspad
658,Ringfietspad Jan Van Rijswijcklaan,2022-12-26,22:00:00,5,4,1,FMN 11 A Jan Van Rijswijcklaan Ringfietspad
658,Ringfietspad Jan Van Rijswijcklaan,2022-12-26,23:00:00,1,0,1,FMN 11 A Jan Van Rijswijcklaan Ringfietspad
658,Ringfietspad Jan Van Rijswijcklaan,2022-12-27,00:00:00,1,0,1,FMN 11 A Jan Van Rijswijcklaan Ringfietspad
658,Ringfietspad Jan Van Rijswijcklaan,2022-12-27,01:00:00,0,0,0,FMN 11 A Jan Van Rijswijcklaan Ringfietspad
658,Ringfietspad Jan Van Rijswijcklaan,2022-12-27,02:00:00,1,1,0,FMN 11 A Jan Van Rijswijcklaan Ringfietspad
658,Ringfietspad Jan Van Rijswijcklaan,2022-12-27,03:00:00,0,0,0,FMN 11 A Jan Van Rijswijcklaan Ringfietspad
658,Ringfietspad Jan Van Rijswijcklaan,2022-12-27,04:00:00,3,1,2,FMN 11 A Jan Van Rijswijcklaan Ringfietspad
658,Ringfietspad Jan Van Rijswijcklaan,2022-12-27,05:00:00,10,2,8,FMN 11 A Jan Van Rijswijcklaan Ringfietspad
658,Ringfietspad Jan Van Rijswijcklaan,2022-12-27,06:00:00,25,8,17,FMN 11 A Jan Van Rijswijcklaan Ringfietspad
658,Ringfietspad Jan Van Rijswijcklaan,2022-12-27,07:00:00,50,17,33,FMN 11 A Jan Van Rijswijcklaan Ringfietspad
658,Ringfietspad Jan Van Rijswijcklaan,2022-12-27,08:00:00,63,21,42,FMN 11 A Jan Van Rijswijcklaan Ringfietspad
658,Ringfietspad Jan Van Rijswijcklaan,2022-12-27,09:00:00,24,7,17,FMN 11 A Jan Van Rijswijcklaan Ringfietspad
658,Ringfietspad Jan Van Rijswijcklaan,2022-12-27,10:00:00,15,7,8,FMN 11 A Jan Van Rijswijcklaan Ringfietspad
658,Ringfietspad Jan Van Rijswijcklaan,2022-12-27,11:00:00,15,8,7,FMN 11 A Jan Van Rijswijcklaan Ringfietspad
658,Ringfietspad Jan Van Rijswijcklaan,2022-12-27,12:00:00,20,9,11,FMN 11 A Jan Van Rijswijcklaan Ringfietspad
658,Ringfietspad Jan Van Rijswijcklaan,2022-12-27,13:00:00,22,10,12,FMN 11 A Jan Van Rijswijcklaan Ringfietspad
658,Ringfietspad Jan Van Rijswijcklaan,2022-12-27,14:00:00,23,16,7,FMN 11 A Jan Van Rijswijcklaan Ringfietspad
658,Ringfietspad Jan Van Rijswijcklaan,2022-12-27,15:00:00,36,25,11,FMN 11 A Jan Van Rijswijcklaan Ringfietspad
658,Ringfietspad Jan Van Rijswijcklaan,2022-12-27,16:00:00,57,39,18,FMN 11 A Jan Van Rijswijcklaan Ringfietspad
658,Ringfietspad Jan Van Rijswijcklaan,2022-12-27,17:00:00,62,42,20,FMN 11 A Jan Van Rijswijcklaan Ringfietspad
658,Ringfietspad Jan Van Rijswijcklaan,2022-12-27,18:00:00,37,24,13,FMN 11 A Jan Van Rijswijcklaan Ringfietspad
658,Ringfietspad Jan Van Rijswijcklaan,2022-12-27,19:00:00,16,10,6,FMN 11 A Jan Van Rijswijcklaan Ringfietspad
658,Ringfietspad Jan Van Rijswijcklaan,2022-12-27,20:00:00,12,6,6,FMN 11 A Jan Van Rijswijcklaan Ringfietspad
658,Ringfietspad Jan Van Rijswijcklaan,2022-12-27,21:00:00,8,4,4,FMN 11 A Jan Van Rijswijcklaan Ringfietspad
658,Ringfietspad Jan Van Rijswijcklaan,2022-12-27,22:00:00,7,3,4,FMN 11 A Jan Van Rijswijcklaan Ringfietspad
658,Ringfietspad Jan Van Rijswijcklaan,2022-12-27,23:00:00,3,2,1,FMN 11 A Jan Van Rijswijcklaan Ringfietspad
658,Ringfietspad Jan Van Rijswijcklaan,2022-12-28,00:00:00,1,1,0,FMN 11 A Jan Van Rijswijcklaan Ringfietspad
658,Ringfietspad Jan Van Rijswijcklaan,2022-12-28,01:00:00,0,0,0,FMN 11 A Jan Van Rijswijcklaan Ringfietspad
658,Ringfietspad Jan Van Rijswijcklaan,2022-12-28,02:00:00,1,1,0,FMN 11 A Jan Van Rijswijcklaan Ringfietspad
658,Ringfietspad Jan Van Rijswijcklaan,2022-12-28,03:00:00,0,0,0,FMN 11 A Jan Van Rijswijcklaan Ringfietspad
658,Ringfietspad Jan Van Rijswijcklaan,2022-12-28,04:00:00,2,0,2,FMN 11 A Jan Van Rijswijcklaan Ringfietspad
658,Ringfietspad Jan Van Rijswijcklaan,2022-12-28,05:00:00,7,3,4,FMN 11 A Jan Van Rijswijcklaan Ringfietspad
658,Ringfietspad Jan Van Rijswijcklaan,2022-12-28,06:00:00,18,5,13,FMN 11 A Jan Van Rijswijcklaan Ringfietspad
658,Ringfietspad Jan Van Rijswijcklaan,2022-12-28,07:00:00,35,12,23,FMN 11 A Jan Van Rijswijcklaan Ringfietspad
658,Ringfietspad Jan Van Rijswijcklaan,2022-12-28,08:00:00,40,14,26,FMN 11 A Jan Van Rijswijcklaan Ringfietspad
658,Ringfietspad Jan Van Rijswijcklaan,2022-12-28,09:00:00,16,5,11,FMN 11 A Jan Van Rijswijcklaan Ringfietspad
658,Ringfietspad Jan Van Rijswijcklaan,2022-12-28,10:00:00,11,0,11,FMN 11 A Jan Van Rijswijcklaan Ringfietspad
658,Ringfietspad Jan Van Rijswijcklaan,2022-12-28,11:00:00,12,6,6,FMN 11 A Jan Van Rijswijcklaan Ringfietspad
658,Ringfietspad Jan Van Rijswijcklaan,2022-12-28,12:00:00,18,8,10,FMN 11 A Jan Van Rijswijcklaan Ringfietspad
658,Ringfietspad Jan Van Rijswijcklaan,2022-12-28,13:00:00,18,8,10,FMN 11 A Jan Van Rijswijcklaan Ringfietspad
658,Ringfietspad Jan Van Rijswijcklaan,2022-12-28,14:00:00,20,13,7,FMN 11 A Jan Van Rijswijcklaan Ringfietspad
658,Ringfietspad Jan Van Rijswijcklaan,2022-12-28,15:00:00,24,15,9,FMN 11 A Jan Van Rijswijcklaan Ringfietspad
658,Ringfietspad Jan Van Rijswijcklaan,2022-12-28,16:00:00,38,26,12,FMN 11 A Jan Van Rijswijcklaan Ringfietspad
658,Ringfietspad Jan Van Rijswijcklaan,2022-12-28,17:00:00,42,28,14,FMN 11 A Jan Van Rijswijcklaan Ringfietspad
658,Ringfietspad Jan Van Rijswijcklaan,2022-12-28,18:00:00,25,16,9,FMN 11 A Jan Van Rijswijcklaan Ringfietspad
658,Ringfietspad Jan Van Rijswijcklaan,2022-12-28,19:00:00,13,6,7,FMN 11 A Jan Van Rijswijcklaan Ringfietspad
658,Ringfietspad Jan Van Rijswijcklaan,2022-12-28,20:00:00,9,4,5,FMN 11 A Jan Van Rijswijcklaan Ringfietspad
658,Ringfietspad Jan Van Rijswijcklaan,2022-12-28,21:00:00,7,3,4,FMN 11 A Jan Van Rijswijcklaan Ringfietspad
658,Ringfietspad Jan Van Rijswijcklaan,2022-12-28,22:00:00,5,2,3,FMN 11 A Jan Van Rijswijcklaan Ringfietspad
658,Ringfietspad Jan Van Rijswijcklaan,2022-12-28,23:00:00,3,2,1,FMN 11 A Jan Van Rijswijcklaan Ringfietspad
658,Ringfietspad Jan Van Rijswijcklaan,2022-12-29,00:00:00,1,1,0,FMN 11 A Jan Van Rijswijcklaan Ringfietspad
658,Ringfietspad Jan Van Rijswijcklaan,2022-12-29,01:00:00,1,0,1,FMN 11 A Jan Van Rijswijcklaan Ringfietspad
658,Ringfietspad Jan Van Rijswijcklaan,2022-12-29,02:00:00,0,0,0,FMN 11 A Jan Van Rijswijcklaan Ringfietspad
658,Ringfietspad Jan Van Rijswijcklaan,2022-12-29,03:00:00,1,0,1,FMN 11 A Jan Van Rijswijcklaan Ringfietspad
658,Ringfietspad Jan Van Rijswijcklaan,2022-12-29,04:00:00,2,0,2,FMN 11 A Jan Van Rijswijcklaan Ringfietspad
658,Ringfietspad Jan Van Rijswijcklaan,2022-12-29,05:00:00,8,1,7,FMN 11 A Jan Van Rijswijcklaan Ringfietspad
658,Ringfietspad Jan Van Rijswijcklaan,2022-12-29,06:00:00,19,8,11,FMN 11 A Jan Van Rijswijcklaan Ringfietspad
658,Ringfietspad Jan Van Rijswijcklaan,2022-12-29,07:00:00,38,12,26,FMN 11 A Jan Van Rijswijcklaan Ringfietspad
658,Ringfietspad Jan Van Rijswijcklaan,2022-12-29,08:00:00,51,17,34,FMN 11 A Jan Van Rijswijcklaan Ringfietspad
658,Ringfietspad Jan Van Rijswijcklaan,2022-12-29,09:00:00,19,4,15,FMN 11 A Jan Van Rijswijcklaan Ringfietspad
658,Ringfietspad Jan Van Rijswijcklaan,2022-12-29,10:00:00,13,8,5,FMN 11 A Jan Van Rijswijcklaan Ringfietspad
658,Ringfietspad Jan Van Rijswijcklaan,2022-12-29,11:00:00,13,12,1,FMN 11 A Jan Van Rijswijcklaan Ringfietspad
658,Ringfietspad Jan Van Rijswijcklaan,2022-12-29,12:00:00,18,9,9,FMN 11 A Jan Van Rijswijcklaan Ringfietspad
658,Ringfietspad Jan Van Rijswijcklaan,2022-12-29,13:00:00,18,10,8,FMN 11 A Jan Van Rijswijcklaan Ringfietspad
658,Ringfietspad Jan Van Rijswijcklaan,2022-12-29,14:00:00,21,12,9,FMN 11 A Jan Van Rijswijcklaan Ringfietspad
658,Ringfietspad Jan Van Rijswijcklaan,2022-12-29,15:00:00,30,22,8,FMN 11 A Jan Van Rijswijcklaan Ringfietspad
658,Ringfietspad Jan Van Rijswijcklaan,2022-12-29,16:00:00,45,32,13,FMN 11 A Jan Van Rijswijcklaan Ringfietspad
658,Ringfietspad Jan Van Rijswijcklaan,2022-12-29,17:00:00,45,30,15,FMN 11 A Jan Van Rijswijcklaan Ringfietspad
658,Ringfietspad Jan Van Rijswijcklaan,2022-12-29,18:00:00,29,19,10,FMN 11 A Jan Van Rijswijcklaan Ringfietspad
658,Ringfietspad Jan Van Rijswijcklaan,2022-12-29,19:00:00,15,12,3,FMN 11 A Jan Van Rijswijcklaan Ringfietspad
658,Ringfietspad Jan Van Rijswijcklaan,2022-12-29,20:00:00,10,4,6,FMN 11 A Jan Van Rijswijcklaan Ringfietspad
658,Ringfietspad Jan Van Rijswijcklaan,2022-12-29,21:00:00,7,3,4,FMN 11 A Jan Van Rijswijcklaan Ringfietspad
658,Ringfietspad Jan Van Rijswijcklaan,2022-12-29,22:00:00,7,7,0,FMN 11 A Jan Van Rijswijcklaan Ringfietspad
658,Ringfietspad Jan Van Rijswijcklaan,2022-12-29,23:00:00,3,1,2,FMN 11 A Jan Van Rijswijcklaan Ringfietspad
658,Ringfietspad Jan Van Rijswijcklaan,2022-12-30,00:00:00,1,0,1,FMN 11 A Jan Van Rijswijcklaan Ringfietspad
658,Ringfietspad Jan Van Rijswijcklaan,2022-12-30,01:00:00,1,0,1,FMN 11 A Jan Van Rijswijcklaan Ringfietspad
658,Ringfietspad Jan Van Rijswijcklaan,2022-12-30,02:00:00,0,0,0,FMN 11 A Jan Van Rijswijcklaan Ringfietspad
658,Ringfietspad Jan Van Rijswijcklaan,2022-12-30,03:00:00,1,1,0,FMN 11 A Jan Van Rijswijcklaan Ringfietspad
658,Ringfietspad Jan Van Rijswijcklaan,2022-12-30,04:00:00,2,0,2,FMN 11 A Jan Van Rijswijcklaan Ringfietspad
658,Ringfietspad Jan Van Rijswijcklaan,2022-12-30,05:00:00,6,0,6,FMN 11 A Jan Van Rijswijcklaan Ringfietspad
658,Ringfietspad Jan Van Rijswijcklaan,2022-12-30,06:00:00,16,3,13,FMN 11 A Jan Van Rijswijcklaan Ringfietspad
658,Ringfietspad Jan Van Rijswijcklaan,2022-12-30,07:00:00,30,12,18,FMN 11 A Jan Van Rijswijcklaan Ringfietspad
658,Ringfietspad Jan Van Rijswijcklaan,2022-12-30,08:00:00,42,16,26,FMN 11 A Jan Van Rijswijcklaan Ringfietspad
658,Ringfietspad Jan Van Rijswijcklaan,2022-12-30,09:00:00,18,7,11,FMN 11 A Jan Van Rijswijcklaan Ringfietspad
658,Ringfietspad Jan Van Rijswijcklaan,2022-12-30,10:00:00,13,4,9,FMN 11 A Jan Van Rijswijcklaan Ringfietspad
658,Ringfietspad Jan Van Rijswijcklaan,2022-12-30,11:00:00,12,2,10,FMN 11 A Jan Van Rijswijcklaan Ringfietspad
658,Ringfietspad Jan Van Rijswijcklaan,2022-12-30,12:00:00,17,12,5,FMN 11 A Jan Van Rijswijcklaan Ringfietspad
658,Ringfietspad Jan Van Rijswijcklaan,2022-12-30,13:00:00,18,10,8,FMN 11 A Jan Van Rijswijcklaan Ringfietspad
658,Ringfietspad Jan Van Rijswijcklaan,2022-12-30,14:00:00,21,13,8,FMN 11 A Jan Van Rijswijcklaan Ringfietspad
658,Ringfietspad Jan Van Rijswijcklaan,2022-12-30,15:00:00,29,21,8,FMN 11 A Jan Van Rijswijcklaan Ringfietspad
658,Ringfietspad Jan Van Rijswijcklaan,2022-12-30,16:00:00,40,28,12,FMN 11 A Jan Van Rijswijcklaan Ringfietspad
658,Ringfietspad Jan Van Rijswijcklaan,2022-12-30,17:00:00,33,22,11,FMN 11 A Jan Van Rijswijcklaan Ringfietspad
658,Ringfietspad Jan Van Rijswijcklaan,2022-12-30,18:00:00,21,11,10,FMN 11 A Jan Van Rijswijcklaan Ringfietspad
658,Ringfietspad Jan Van Rijswijcklaan,2022-12-30,19:00:00,12,4,8,FMN 11 A Jan Van Rijswijcklaan Ringfietspad
658,Ringfietspad Jan Van Rijswijcklaan,2022-12-30,20:00:00,8,5,3,FMN 11 A Jan Van Rijswijcklaan Ringfietspad
658,Ringfietspad Jan Van Rijswijcklaan,2022-12-30,21:00:00,6,6,0,FMN 11 A Jan Van Rijswijcklaan Ringfietspad
658,Ringfietspad Jan Van Rijswijcklaan,2022-12-30,22:00:00,5,3,2,FMN 11 A Jan Van Rijswijcklaan Ringfietspad
658,Ringfietspad Jan Van Rijswijcklaan,2022-12-30,23:00:00,3,0,3,FMN 11 A Jan Van Rijswijcklaan Ringfietspad
658,Ringfietspad Jan Van Rijswijcklaan,2022-12-31,00:00:00,3,1,2,FMN 11 A Jan Van Rijswijcklaan Ringfietspad
658,Ringfietspad Jan Van Rijswijcklaan,2022-12-31,01:00:00,2,1,1,FMN 11 A Jan Van Rijswijcklaan Ringfietspad
658,Ringfietspad Jan Van Rijswijcklaan,2022-12-31,02:00:00,2,1,1,FMN 11 A Jan Van Rijswijcklaan Ringfietspad
658,Ringfietspad Jan Van Rijswijcklaan,2022-12-31,03:00:00,1,1,0,FMN 11 A Jan Van Rijswijcklaan Ringfietspad
658,Ringfietspad Jan Van Rijswijcklaan,2022-12-31,04:00:00,2,0,2,FMN 11 A Jan Van Rijswijcklaan Ringfietspad
658,Ringfietspad Jan Van Rijswijcklaan,2022-12-31,05:00:00,2,1,1,FMN 11 A Jan Van Rijswijcklaan Ringfietspad
658,Ringfietspad Jan Van Rijswijcklaan,2022-12-31,06:00:00,4,1,3,FMN 11 A Jan Van Rijswijcklaan Ringfietspad
658,Ringfietspad Jan Van Rijswijcklaan,2022-12-31,07:00:00,4,2,2,FMN 11 A Jan Van Rijswijcklaan Ringfietspad
658,Ringfietspad Jan Van Rijswijcklaan,2022-12-31,08:00:00,9,6,3,FMN 11 A Jan Van Rijswijcklaan Ringfietspad
658,Ringfietspad Jan Van Rijswijcklaan,2022-12-31,09:00:00,17,8,9,FMN 11 A Jan Van Rijswijcklaan Ringfietspad
658,Ringfietspad Jan Van Rijswijcklaan,2022-12-31,10:00:00,19,7,12,FMN 11 A Jan Van Rijswijcklaan Ringfietspad
658,Ringfietspad Jan Van Rijswijcklaan,2022-12-31,11:00:00,22,10,12,FMN 11 A Jan Van Rijswijcklaan Ringfietspad
658,Ringfietspad Jan Van Rijswijcklaan,2022-12-31,12:00:00,23,10,13,FMN 11 A Jan Van Rijswijcklaan Ringfietspad
658,Ringfietspad Jan Van Rijswijcklaan,2022-12-31,13:00:00,28,14,14,FMN 11 A Jan Van Rijswijcklaan Ringfietspad
658,Ringfietspad Jan Van Rijswijcklaan,2022-12-31,14:00:00,33,16,17,FMN 11 A Jan Van Rijswijcklaan Ringfietspad
658,Ringfietspad Jan Van Rijswijcklaan,2022-12-31,15:00:00,32,18,14,FMN 11 A Jan Van Rijswijcklaan Ringfietspad
658,Ringfietspad Jan Van Rijswijcklaan,2022-12-31,16:00:00,29,18,11,FMN 11 A Jan Van Rijswijcklaan Ringfietspad
658,Ringfietspad Jan Van Rijswijcklaan,2022-12-31,17:00:00,22,14,8,FMN 11 A Jan Van Rijswijcklaan Ringfietspad
658,Ringfietspad Jan Van Rijswijcklaan,2022-12-31,18:00:00,17,11,6,FMN 11 A Jan Van Rijswijcklaan Ringfietspad
658,Ringfietspad Jan Van Rijswijcklaan,2022-12-31,19:00:00,12,6,6,FMN 11 A Jan Van Rijswijcklaan Ringfietspad
658,Ringfietspad Jan Van Rijswijcklaan,2022-12-31,20:00:00,9,5,4,FMN 11 A Jan Van Rijswijcklaan Ringfietspad
658,Ringfietspad Jan Van Rijswijcklaan,2022-12-31,21:00:00,7,2,5,FMN 11 A Jan Van Rijswijcklaan Ringfietspad
658,Ringfietspad Jan Van Rijswijcklaan,2022-12-31,22:00:00,5,4,1,FMN 11 A Jan Van Rijswijcklaan Ringfietspad
658,Ringfietspad Jan Van Rijswijcklaan,2022-12-31,23:00:00,4,3,1,FMN 11 A Jan Van Rijswijcklaan Ringfietspad
658,Ringfietspad Jan Van Rijswijcklaan,2023-01-01,00:00:00,2,1,1,FMN 11 A Jan Van Rijswijcklaan Ringfietspad
658,Ringfietspad Jan Van Rijswijcklaan,2023-01-01,01:00:00,1,1,0,FMN 11 A Jan Van Rijswijcklaan Ringfietspad
658,Ringfietspad Jan Van Rijswijcklaan,2023-01-01,02:00:00,1,1,0,FMN 11 A Jan Van Rijswijcklaan Ringfietspad
658,Ringfietspad Jan Van Rijswijcklaan,2023-01-01,03:00:00,0,0,0,FMN 11 A Jan Van Rijswijcklaan Ringfietspad
658,Ringfietspad Jan Van Rijswijcklaan,2023-01-01,04:00:00,1,1,0,FMN 11 A Jan Van Rijswijcklaan Ringfietspad
658,Ringfietspad Jan Van Rijswijcklaan,2023-01-01,05:00:00,1,0,1,FMN 11 A Jan Van Rijswijcklaan Ringfietspad
658,Ringfietspad Jan Van Rijswijcklaan,2023-01-01,06:00:00,1,1,0,FMN 11 A Jan Van Rijswijcklaan Ringfietspad
658,Ringfietspad Jan Van Rijswijcklaan,2023-01-01,07:00:00,3,0,3,FMN 11 A Jan Van Rijswijcklaan Ringfietspad
658,Ringfietspad Jan Van Rijswijcklaan,2023-01-01,08:00:00,7,3,4,FMN 11 A Jan Van Rijswijcklaan Ringfietspad
658,Ringfietspad Jan Van Rijswijcklaan,2023-01-01,09:00:00,14,7,7,FMN 11 A Jan Van Rijswijcklaan Ringfietspad
658,Ringfietspad Jan Van Rijswijcklaan,2023-01-01,10:00:00,17,7,10,FMN 11 A Jan Van Rijswijcklaan Ringfietspad
658,Ringfietspad Jan Van Rijswijcklaan,2023-01-01,11:00:00,20,9,11,FMN 11 A Jan Van Rijswijcklaan Ringfietspad
658,Ringfietspad Jan Van Rijswijcklaan,2023-01-01,12:00:00,23,11,12,FMN 11 A Jan Van Rijswijcklaan Ringfietspad
658,Ringfietspad Jan Van Rijswijcklaan,2023-01-01,13:00:00,25,13,12,FMN 11 A Jan Van Rijswijcklaan Ringfietspad
658,Ringfietspad Jan Van Rijswijcklaan,2023-01-01,14:00:00,28,15,13,FMN 11 A Jan Van Rijswijcklaan Ringfietspad
658,Ringfietspad Jan Van Rijswijcklaan,2023-01-01,15:00:00,27,15,12,FMN 11 A Jan Van Rijswijcklaan Ringfietspad
658,Ringfietspad Jan Van Rijswijcklaan,2023-01-01,16:00:00,21,15,6,FMN 11 A Jan Van Rijswijcklaan Ringfietspad
658,Ringfietspad Jan Van Rijswijcklaan,2023-01-01,17:00:00,18,13,5,FMN 11 A Jan Van Rijswijcklaan Ringfietspad
658,Ringfietspad Jan Van Rijswijcklaan,2023-01-01,18:00:00,12,5,7,FMN 11 A Jan Van Rijswijcklaan Ringfietspad
658,Ringfietspad Jan Van Rijswijcklaan,2023-01-01,19:00:00,8,4,4,FMN 11 A Jan Van Rijswijcklaan Ringfietspad
658,Ringfietspad Jan Van Rijswijcklaan,2023-01-01,20:00:00,7,1,6,FMN 11 A Jan Van Rijswijcklaan Ringfietspad
658,Ringfietspad Jan Van Rijswijcklaan,2023-01-01,21:00:00,4,3,1,FMN 11 A Jan Van Rijswijcklaan Ringfietspad
658,Ringfietspad Jan Van Rijswijcklaan,2023-01-01,22:00:00,3,1,2,FMN 11 A Jan Van Rijswijcklaan Ringfietspad
658,Ringfietspad Jan Van Rijswijcklaan,2023-01-01,23:00:00,1,1,0,FMN 11 A Jan Van Rijswijcklaan Ringfietspad
658,Ringfietspad Jan Van Rijswijcklaan,2023-01-02,00:00:00,1,1,0,FMN 11 A Jan Van Rijswijcklaan Ringfietspad
658,Ringfietspad Jan Van Rijswijcklaan,2023-01-02,01:00:00,0,0,0,FMN 11 A Jan Van Rijswijcklaan Ringfietspad
658,Ringfietspad Jan Van Rijswijcklaan,2023-01-02,02:00:00,0,0,0,FMN 11 A Jan Van Rijswijcklaan Ringfietspad
658,Ringfietspad Jan Van Rijswijcklaan,2023-01-02,03:00:00,1,1,0,FMN 11 A Jan Van Rijswijcklaan Ringfietspad
658,Ringfietspad Jan Van Rijswijcklaan,2023-01-02,04:00:00,2,2,0,FMN 11 A Jan Van Rijswijcklaan Ringfietspad
658,Ringfietspad Jan Van Rijswijcklaan,2023-01-02,05:00:00,6,1,5,FMN 11 A Jan Van Rijswijcklaan Ringfietspad
658,Ringfietspad Jan Van Rijswijcklaan,2023-01-02,06:00:00,16,5,11,FMN 11 A Jan Van Rijswijcklaan Ringfietspad
658,Ringfietspad Jan Van Rijswijcklaan,2023-01-02,07:00:00,34,10,24,FMN 11 A Jan Van Rijswijcklaan Ringfietspad
658,Ringfietspad Jan Van Rijswijcklaan,2023-01-02,08:00:00,43,12,31,FMN 11 A Jan Van Rijswijcklaan Ringfietspad
658,Ringfietspad Jan Van Rijswijcklaan,2023-01-02,09:00:00,16,8,8,FMN 11 A Jan Van Rijswijcklaan Ringfietspad
658,Ringfietspad Jan Van Rijswijcklaan,2023-01-02,10:00:00,11,7,4,FMN 11 A Jan Van Rijswijcklaan Ringfietspad
658,Ringfietspad Jan Van Rijswijcklaan,2023-01-02,11:00:00,10,5,5,FMN 11 A Jan Van Rijswijcklaan Ringfietspad
658,Ringfietspad Jan Van Rijswijcklaan,2023-01-02,12:00:00,15,5,10,FMN 11 A Jan Van Rijswijcklaan Ringfietspad
658,Ringfietspad Jan Van Rijswijcklaan,2023-01-02,13:00:00,16,8,8,FMN 11 A Jan Van Rijswijcklaan Ringfietspad
658,Ringfietspad Jan Van Rijswijcklaan,2023-01-02,14:00:00,18,10,8,FMN 11 A Jan Van Rijswijcklaan Ringfietspad
658,Ringfietspad Jan Van Rijswijcklaan,2023-01-02,15:00:00,25,14,11,FMN 11 A Jan Van Rijswijcklaan Ringfietspad
658,Ringfietspad Jan Van Rijswijcklaan,2023-01-02,16:00:00,40,29,11,FMN 11 A Jan Van Rijswijcklaan Ringfietspad
658,Ringfietspad Jan Van Rijswijcklaan,2023-01-02,17:00:00,42,27,15,FMN 11 A Jan Van Rijswijcklaan Ringfietspad
658,Ringfietspad Jan Van Rijswijcklaan,2023-01-02,18:00:00,24,16,8,FMN 11 A Jan Van Rijswijcklaan Ringfietspad
658,Ringfietspad Jan Van Rijswijcklaan,2023-01-02,19:00:00,12,11,1,FMN 11 A Jan Van Rijswijcklaan Ringfietspad
658,Ringfietspad Jan Van Rijswijcklaan,2023-01-02,20:00:00,8,3,5,FMN 11 A Jan Van Rijswijcklaan Ringfietspad
658,Ringfietspad Jan Van Rijswijcklaan,2023-01-02,21:00:00,5,1,4,FMN 11 A Jan Van Rijswijcklaan Ringfietspad
658,Ringfietspad Jan Van Rijswijcklaan,2023-01-02,22:00:00,5,3,2,FMN 11 A Jan Van Rijswijcklaan Ringfietspad
658,Ringfietspad Jan Van Rijswijcklaan,2023-01-02,23:00:00,2,2,0,FMN 11 A Jan Van Rijswijcklaan Ringfietspad
658,Ringfietspad Jan Van Rijswijcklaan,2023-01-03,00:00:00,1,1,0,FMN 11 A Jan Van Rijswijcklaan Ringfietspad
658,Ringfietspad Jan Van Rijswijcklaan,2023-01-03,01:00:00,0,0,0,FMN 11 A Jan Van Rijswijcklaan Ringfietspad
658,Ringfietspad Jan Van Rijswijcklaan,2023-01-03,02:00:00,1,1,0,FMN 11 A Jan Van Rijswijcklaan Ringfietspad
658,Ringfietspad Jan Van Rijswijcklaan,2023-01-03,03:00:00,1,0,1,FMN 11 A Jan Van Rijswijcklaan Ringfietspad
658,Ringfietspad Jan Van Rijswijcklaan,2023-01-03,04:00:00,4,0,4,FMN 11 A Jan Van Rijswijcklaan Ringfietspad
658,Ringfietspad Jan Van Rijswijcklaan,2023-01-03,05:00:00,11,5,6,FMN 11 A Jan Van Rijswijcklaan Ringfietspad
658,Ringfietspad Jan Van Rijswijcklaan,2023-01-03,06:00:00,31,10,21,FMN 11 A Jan Van Rijswijcklaan Ringfietspad
658,Ringfietspad Jan Van Rijswijcklaan,2023-01-03,07:00:00,61,22,39,FMN 11 A Jan Van Rijswijcklaan Ringfietspad
658,Ringfietspad Jan Van Rijswijcklaan,2023-01-03,08:00:00,79,27,52,FMN 11 A Jan Van Rijswijcklaan Ringfietspad
658,Ringfietspad Jan Van Rijswijcklaan,2023-01-03,09:00:00,29,9,20,FMN 11 A Jan Van Rijswijcklaan Ringfietspad
658,Ringfietspad Jan Van Rijswijcklaan,2023-01-03,10:00:00,19,8,11,FMN 11 A Jan Van Rijswijcklaan Ringfietspad
658,Ringfietspad Jan Van Rijswijcklaan,2023-01-03,11:00:00,18,10,8,FMN 11 A Jan Van Rijswijcklaan Ringfietspad
658,Ringfietspad Jan Van Rijswijcklaan,2023-01-03,12:00:00,25,12,13,FMN 11 A Jan Van Rijswijcklaan Ringfietspad
658,Ringfietspad Jan Van Rijswijcklaan,2023-01-03,13:00:00,27,14,13,FMN 11 A Jan Van Rijswijcklaan Ringfietspad
658,Ringfietspad Jan Van Rijswijcklaan,2023-01-03,14:00:00,29,14,15,FMN 11 A Jan Van Rijswijcklaan Ringfietspad
658,Ringfietspad Jan Van Rijswijcklaan,2023-01-03,15:00:00,43,26,17,FMN 11 A Jan Van Rijswijcklaan Ringfietspad
658,Ringfietspad Jan Van Rijswijcklaan,2023-01-03,16:00:00,71,47,24,FMN 11 A Jan Van Rijswijcklaan Ringfietspad
658,Ringfietspad Jan Van Rijswijcklaan,2023-01-03,17:00:00,76,50,26,FMN 11 A Jan Van Rijswijcklaan Ringfietspad
658,Ringfietspad Jan Van Rijswijcklaan,2023-01-03,18:00:00,46,28,18,FMN 11 A Jan Van Rijswijcklaan Ringfietspad
658,Ringfietspad Jan Van Rijswijcklaan,2023-01-03,19:00:00,19,10,9,FMN 11 A Jan Van Rijswijcklaan Ringfietspad
658,Ringfietspad Jan Van Rijswijcklaan,2023-01-03,20:00:00,15,7,8,FMN 11 A Jan Van Rijswijcklaan Ringfietspad
658,Ringfietspad Jan Van Rijswijcklaan,2023-01-03,21:00:00,10,6,4,FMN 11 A Jan Van Rijswijcklaan Ringfietspad
658,Ringfietspad Jan Van Rijswijcklaan,2023-01-03,22:00:00,9,7,2,FMN 11 A Jan Van Rijswijcklaan Ringfietspad
658,Ringfietspad Jan Van Rijswijcklaan,2023-01-03,23:00:00,4,3,1,FMN 11 A Jan Van Rijswijcklaan Ringfietspad
658,Ringfietspad Jan Van Rijswijcklaan,2023-01-04,00:00:00,1,0,1,FMN 11 A Jan Van Rijswijcklaan Ringfietspad
658,Ringfietspad Jan Van Rijswijcklaan,2023-01-04,01:00:00,1,0,1,FMN 11 A Jan Van Rijswijcklaan Ringfietspad
658,Ringfietspad Jan Van Rijswijcklaan,2023-01-04,02:00:00,0,0,0,FMN 11 A Jan Van Rijswijcklaan Ringfietspad
658,Ringfietspad Jan Van Rijswijcklaan,2023-01-04,03:00:00,1,1,0,FMN 11 A Jan Van Rijswijcklaan Ringfietspad
658,Ringfietspad Jan Van Rijswijcklaan,2023-01-04,04:00:00,2,1,1,FMN 11 A Jan Van Rijswijcklaan Ringfietspad
658,Ringfietspad Jan Van Rijswijcklaan,2023-01-04,05:00:00,10,2,8,FMN 11 A Jan Van Rijswijcklaan Ringfietspad
658,Ringfietspad Jan Van Rijswijcklaan,2023-01-04,06:00:00,24,6,18,FMN 11 A Jan Van Rijswijcklaan Ringfietspad
658,Ringfietspad Jan Van Rijswijcklaan,2023-01-04,07:00:00,46,17,29,FMN 11 A Jan Van Rijswijcklaan Ringfietspad
658,Ringfietspad Jan Van Rijswijcklaan,2023-01-04,08:00:00,55,21,34,FMN 11 A Jan Van Rijswijcklaan Ringfietspad
658,Ringfietspad Jan Van Rijswijcklaan,2023-01-04,09:00:00,20,6,14,FMN 11 A Jan Van Rijswijcklaan Ringfietspad
658,Ringfietspad Jan Van Rijswijcklaan,2023-01-04,10:00:00,15,7,8,FMN 11 A Jan Van Rijswijcklaan Ringfietspad
658,Ringfietspad Jan Van Rijswijcklaan,2023-01-04,11:00:00,16,7,9,FMN 11 A Jan Van Rijswijcklaan Ringfietspad
658,Ringfietspad Jan Van Rijswijcklaan,2023-01-04,12:00:00,25,13,12,FMN 11 A Jan Van Rijswijcklaan Ringfietspad
658,Ringfietspad Jan Van Rijswijcklaan,2023-01-04,13:00:00,23,12,11,FMN 11 A Jan Van Rijswijcklaan Ringfietspad
658,Ringfietspad Jan Van Rijswijcklaan,2023-01-04,14:00:00,26,14,12,FMN 11 A Jan Van Rijswijcklaan Ringfietspad
658,Ringfietspad Jan Van Rijswijcklaan,2023-01-04,15:00:00,33,22,11,FMN 11 A Jan Van Rijswijcklaan Ringfietspad
658,Ringfietspad Jan Van Rijswijcklaan,2023-01-04,16:00:00,51,35,16,FMN 11 A Jan Van Rijswijcklaan Ringfietspad
658,Ringfietspad Jan Van Rijswijcklaan,2023-01-04,17:00:00,56,38,18,FMN 11 A Jan Van Rijswijcklaan Ringfietspad
658,Ringfietspad Jan Van Rijswijcklaan,2023-01-04,18:00:00,33,21,12,FMN 11 A Jan Van Rijswijcklaan Ringfietspad
658,Ringfietspad Jan Van Rijswijcklaan,2023-01-04,19:00:00,18,9,9,FMN 11 A Jan Van Rijswijcklaan Ringfietspad
658,Ringfietspad Jan Van Rijswijcklaan,2023-01-04,20:00:00,12,7,5,FMN 11 A Jan Van Rijswijcklaan Ringfietspad
658,Ringfietspad Jan Van Rijswijcklaan,2023-01-04,21:00:00,9,3,6,FMN 11 A Jan Van Rijswijcklaan Ringfietspad
658,Ringfietspad Jan Van Rijswijcklaan,2023-01-04,22:00:00,7,5,2,FMN 11 A Jan Van Rijswijcklaan Ringfietspad
658,Ringfietspad Jan Van Rijswijcklaan,2023-01-04,23:00:00,3,1,2,FMN 11 A Jan Van Rijswijcklaan Ringfietspad
658,Ringfietspad Jan Van Rijswijcklaan,2023-01-05,00:00:00,2,0,2,FMN 11 A Jan Van Rijswijcklaan Ringfietspad
658,Ringfietspad Jan Van Rijswijcklaan,2023-01-05,01:00:00,0,0,0,FMN 11 A Jan Van Rijswijcklaan Ringfietspad
658,Ringfietspad Jan Van Rijswijcklaan,2023-01-05,02:00:00,1,1,0,FMN 11 A Jan Van Rijswijcklaan Ringfietspad
658,Ringfietspad Jan Van Rijswijcklaan,2023-01-05,03:00:00,1,1,0,FMN 11 A Jan Van Rijswijcklaan Ringfietspad
658,Ringfietspad Jan Van Rijswijcklaan,2023-01-05,04:00:00,4,2,2,FMN 11 A Jan Van Rijswijcklaan Ringfietspad
658,Ringfietspad Jan Van Rijswijcklaan,2023-01-05,05:00:00,12,2,10,FMN 11 A Jan Van Rijswijcklaan Ringfietspad
658,Ringfietspad Jan Van Rijswijcklaan,2023-01-05,06:00:00,32,8,24,FMN 11 A Jan Van Rijswijcklaan Ringfietspad
658,Ringfietspad Jan Van Rijswijcklaan,2023-01-05,07:00:00,60,21,39,FMN 11 A Jan Van Rijswijcklaan Ringfietspad
658,Ringfietspad Jan Van Rijswijcklaan,2023-01-05,08:00:00,82,26,56,FMN 11 A Jan Van Rijswijcklaan Ringfietspad
658,Ringfietspad Jan Van Rijswijcklaan,2023-01-05,09:00:00,32,12,20,FMN 11 A Jan Van Rijswijcklaan Ringfietspad
658,Ringfietspad Jan Van Rijswijcklaan,2023-01-05,10:00:00,21,9,12,FMN 11 A Jan Van Rijswijcklaan Ringfietspad
658,Ringfietspad Jan Van Rijswijcklaan,2023-01-05,11:00:00,20,10,10,FMN 11 A Jan Van Rijswijcklaan Ringfietspad
658,Ringfietspad Jan Van Rijswijcklaan,2023-01-05,12:00:00,29,13,16,FMN 11 A Jan Van Rijswijcklaan Ringfietspad
658,Ringfietspad Jan Van Rijswijcklaan,2023-01-05,13:00:00,30,14,16,FMN 11 A Jan Van Rijswijcklaan Ringfietspad
658,Ringfietspad Jan Van Rijswijcklaan,2023-01-05,14:00:00,34,20,14,FMN 11 A Jan Van Rijswijcklaan Ringfietspad
658,Ringfietspad Jan Van Rijswijcklaan,2023-01-05,15:00:00,48,30,18,FMN 11 A Jan Van Rijswijcklaan Ringfietspad
658,Ringfietspad Jan Van Rijswijcklaan,2023-01-05,16:00:00,72,47,25,FMN 11 A Jan Van Rijswijcklaan Ringfietspad
658,Ringfietspad Jan Van Rijswijcklaan,2023-01-05,17:00:00,73,47,26,FMN 11 A Jan Van Rijswijcklaan Ringfietspad
658,Ringfietspad Jan Van Rijswijcklaan,2023-01-05,18:00:00,47,28,19,FMN 11 A Jan Van Rijswijcklaan Ringfietspad
658,Ringfietspad Jan Van Rijswijcklaan,2023-01-05,19:00:00,24,12,12,FMN 11 A Jan Van Rijswijcklaan Ringfietspad
658,Ringfietspad Jan Van Rijswijcklaan,2023-01-05,20:00:00,16,7,9,FMN 11 A Jan Van Rijswijcklaan Ringfietspad
658,Ringfietspad Jan Van Rijswijcklaan,2023-01-05,21:00:00,12,3,9,FMN 11 A Jan Van Rijswijcklaan Ringfietspad
658,Ringfietspad Jan Van Rijswijcklaan,2023-01-05,22:00:00,10,6,4,FMN 11 A Jan Van Rijswijcklaan Ringfietspad
658,Ringfietspad Jan Van Rijswijcklaan,2023-01-05,23:00:00,4,3,1,FMN 11 A Jan Van Rijswijcklaan Ringfietspad
658,Ringfietspad Jan Van Rijswijcklaan,2023-01-06,00:00:00,2,1,1,FMN 11 A Jan Van Rijswijcklaan Ringfietspad
658,Ringfietspad Jan Van Rijswijcklaan,2023-01-06,01:00:00,1,1,0,FMN 11 A Jan Van Rijswijcklaan Ringfietspad
658,Ringfietspad Jan Van Rijswijcklaan,2023-01-06,02:00:00,1,0,1,FMN 11 A Jan Van Rijswijcklaan Ringfietspad
658,Ringfietspad Jan Van Rijswijcklaan,2023-01-06,03:00:00,1,1,0,FMN 11 A Jan Van Rijswijcklaan Ringfietspad
658,Ringfietspad Jan Van Rijswijcklaan,2023-01-06,04:00:00,4,1,3,FMN 11 A Jan Van Rijswijcklaan Ringfietspad
658,Ringfietspad Jan Van Rijswijcklaan,2023-01-06,05:00:00,10,1,9,FMN 11 A Jan Van Rijswijcklaan Ringfietspad
658,Ringfietspad Jan Van Rijswijcklaan,2023-01-06,06:00:00,28,6,22,FMN 11 A Jan Van Rijswijcklaan Ringfietspad
658,Ringfietspad Jan Van Rijswijcklaan,2023-01-06,07:00:00,53,18,35,FMN 11 A Jan Van Rijswijcklaan Ringfietspad
658,Ringfietspad Jan Van Rijswijcklaan,2023-01-06,08:00:00,74,25,49,FMN 11 A Jan Van Rijswijcklaan Ringfietspad
658,Ringfietspad Jan Van Rijswijcklaan,2023-01-06,09:00:00,30,13,17,FMN 11 A Jan Van Rijswijcklaan Ringfietspad
658,Ringfietspad Jan Van Rijswijcklaan,2023-01-06,10:00:00,23,8,15,FMN 11 A Jan Van Rijswijcklaan Ringfietspad
658,Ringfietspad Jan Van Rijswijcklaan,2023-01-06,11:00:00,22,11,11,FMN 11 A Jan Van Rijswijcklaan Ringfietspad
658,Ringfietspad Jan Van Rijswijcklaan,2023-01-06,12:00:00,30,16,14,FMN 11 A Jan Van Rijswijcklaan Ringfietspad
658,Ringfietspad Jan Van Rijswijcklaan,2023-01-06,13:00:00,31,17,14,FMN 11 A Jan Van Rijswijcklaan Ringfietspad
658,Ringfietspad Jan Van Rijswijcklaan,2023-01-06,14:00:00,37,23,14,FMN 11 A Jan Van Rijswijcklaan Ringfietspad
658,Ringfietspad Jan Van Rijswijcklaan,2023-01-06,15:00:00,52,36,16,FMN 11 A Jan Van Rijswijcklaan Ringfietspad
658,Ringfietspad Jan Van Rijswijcklaan,2023-01-06,16:00:00,68,46,22,FMN 11 A Jan Van Rijswijcklaan Ringfietspad
658,Ringfietspad Jan Van Rijswijcklaan,2023-01-06,17:00:00,59,36,23,FMN 11 A Jan Van Rijswijcklaan Ringfietspad
658,Ringfietspad Jan Van Rijswijcklaan,2023-01-06,18:00:00,36,22,14,FMN 11 A Jan Van Rijswijcklaan Ringfietspad
658,Ringfietspad Jan Van Rijswijcklaan,2023-01-06,19:00:00,22,11,11,FMN 11 A Jan Van Rijswijcklaan Ringfietspad
658,Ringfietspad Jan Van Rijswijcklaan,2023-01-06,20:00:00,14,9,5,FMN 11 A Jan Van Rijswijcklaan Ringfietspad
658,Ringfietspad Jan Van Rijswijcklaan,2023-01-06,21:00:00,10,4,6,FMN 11 A Jan Van Rijswijcklaan Ringfietspad
658,Ringfietspad Jan Van Rijswijcklaan,2023-01-06,22:00:00,9,6,3,FMN 11 A Jan Van Rijswijcklaan Ringfietspad
658,Ringfietspad Jan Van Rijswijcklaan,2023-01-06,23:00:00,5,2,3,FMN 11 A Jan Van Rijswijcklaan Ringfietspad
658,Ringfietspad Jan Van Rijswijcklaan,2023-01-07,00:00:00,4,4,0,FMN 11 A Jan Van Rijswijcklaan Ringfietspad
658,Ringfietspad Jan Van Rijswijcklaan,2023-01-07,01:00:00,3,2,1,FMN 11 A Jan Van Rijswijcklaan Ringfietspad
658,Ringfietspad Jan Van Rijswijcklaan,2023-01-07,02:00:00,2,0,2,FMN 11 A Jan Van Rijswijcklaan Ringfietspad
658,Ringfietspad Jan Van Rijswijcklaan,2023-01-07,03:00:00,2,2,0,FMN 11 A Jan Van Rijswijcklaan Ringfietspad
658,Ringfietspad Jan Van Rijswijcklaan,2023-01-07,04:00:00,3,0,3,FMN 11 A Jan Van Rijswijcklaan Ringfietspad
658,Ringfietspad Jan Van Rijswijcklaan,2023-01-07,05:00:00,3,0,3,FMN 11 A Jan Van Rijswijcklaan Ringfietspad
658,Ringfietspad Jan Van Rijswijcklaan,2023-01-07,06:00:00,6,4,2,FMN 11 A Jan Van Rijswijcklaan Ringfietspad
658,Ringfietspad Jan Van Rijswijcklaan,2023-01-07,07:00:00,6,2,4,FMN 11 A Jan Van Rijswijcklaan Ringfietspad
658,Ringfietspad Jan Van Rijswijcklaan,2023-01-07,08:00:00,13,8,5,FMN 11 A Jan Van Rijswijcklaan Ringfietspad
658,Ringfietspad Jan Van Rijswijcklaan,2023-01-07,09:00:00,24,11,13,FMN 11 A Jan Van Rijswijcklaan Ringfietspad
658,Ringfietspad Jan Van Rijswijcklaan,2023-01-07,10:00:00,28,13,15,FMN 11 A Jan Van Rijswijcklaan Ringfietspad
658,Ringfietspad Jan Van Rijswijcklaan,2023-01-07,11:00:00,31,15,16,FMN 11 A Jan Van Rijswijcklaan Ringfietspad
658,Ringfietspad Jan Van Rijswijcklaan,2023-01-07,12:00:00,33,17,16,FMN 11 A Jan Van Rijswijcklaan Ringfietspad
658,Ringfietspad Jan Van Rijswijcklaan,2023-01-07,13:00:00,41,17,24,FMN 11 A Jan Van Rijswijcklaan Ringfietspad
658,Ringfietspad Jan Van Rijswijcklaan,2023-01-07,14:00:00,48,24,24,FMN 11 A Jan Van Rijswijcklaan Ringfietspad
658,Ringfietspad Jan Van Rijswijcklaan,2023-01-07,15:00:00,46,24,22,FMN 11 A Jan Van Rijswijcklaan Ringfietspad
658,Ringfietspad Jan Van Rijswijcklaan,2023-01-07,16:00:00,41,24,17,FMN 11 A Jan Van Rijswijcklaan Ringfietspad
658,Ringfietspad Jan Van Rijswijcklaan,2023-01-07,17:00:00,32,19,13,FMN 11 A Jan Van Rijswijcklaan Ringfietspad
658,Ringfietspad Jan Van Rijswijcklaan,2023-01-07,18:00:00,25,19,6,FMN 11 A Jan Van Rijswijcklaan Ringfietspad
658,Ringfietspad Jan Van Rijswijcklaan,2023-01-07,19:00:00,17,9,8,FMN 11 A Jan Van Rijswijcklaan Ringfietspad
658,Ringfietspad Jan Van Rijswijcklaan,2023-01-07,20:00:00,14,6,8,FMN 11 A Jan Van Rijswijcklaan Ringfietspad
658,Ringfietspad Jan Van Rijswijcklaan,2023-01-07,21:00:00,10,3,7,FMN 11 A Jan Van Rijswijcklaan Ringfietspad
658,Ringfietspad Jan Van Rijswijcklaan,2023-01-07,22:00:00,7,4,3,FMN 11 A Jan Van Rijswijcklaan Ringfietspad
658,Ringfietspad Jan Van Rijswijcklaan,2023-01-07,23:00:00,6,5,1,FMN 11 A Jan Van Rijswijcklaan Ringfietspad
658,Ringfietspad Jan Van Rijswijcklaan,2023-01-08,00:00:00,3,2,1,FMN 11 A Jan Van Rijswijcklaan Ringfietspad
658,Ringfietspad Jan Van Rijswijcklaan,2023-01-08,01:00:00,2,0,2,FMN 11 A Jan Van Rijswijcklaan Ringfietspad
658,Ringfietspad Jan Van Rijswijcklaan,2023-01-08,02:00:00,1,1,0,FMN 11 A Jan Van Rijswijcklaan Ringfietspad
658,Ringfietspad Jan Van Rijswijcklaan,2023-01-08,03:00:00,1,1,0,FMN 11 A Jan Van Rijswijcklaan Ringfietspad
658,Ringfietspad Jan Van Rijswijcklaan,2023-01-08,04:00:00,1,0,1,FMN 11 A Jan Van Rijswijcklaan Ringfietspad
658,Ringfietspad Jan Van Rijswijcklaan,2023-01-08,05:00:00,1,0,1,FMN 11 A Jan Van Rijswijcklaan Ringfietspad
658,Ringfietspad Jan Van Rijswijcklaan,2023-01-08,06:00:00,3,1,2,FMN 11 A Jan Van Rijswijcklaan Ringfietspad
658,Ringfietspad Jan Van Rijswijcklaan,2023-01-08,07:00:00,4,1,3,FMN 11 A Jan Van Rijswijcklaan Ringfietspad
658,Ringfietspad Jan Van Rijswijcklaan,2023-01-08,08:00:00,11,2,9,FMN 11 A Jan Van Rijswijcklaan Ringfietspad
658,Ringfietspad Jan Van Rijswijcklaan,2023-01-08,09:00:00,23,10,13,FMN 11 A Jan Van Rijswijcklaan Ringfietspad
658,Ringfietspad Jan Van Rijswijcklaan,2023-01-08,10:00:00,29,12,17,FMN 11 A Jan Van Rijswijcklaan Ringfietspad
658,Ringfietspad Jan Van Rijswijcklaan,2023-01-08,11:00:00,32,16,16,FMN 11 A Jan Van Rijswijcklaan Ringfietspad
658,Ringfietspad Jan Van Rijswijcklaan,2023-01-08,12:00:00,37,18,19,FMN 11 A Jan Van Rijswijcklaan Ringfietspad
658,Ringfietspad Jan Van Rijswijcklaan,2023-01-08,13:00:00,41,19,22,FMN 11 A Jan Van Rijswijcklaan Ringfietspad
658,Ringfietspad Jan Van Rijswijcklaan,2023-01-08,14:00:00,46,23,23,FMN 11 A Jan Van Rijswijcklaan Ringfietspad
658,Ringfietspad Jan Van Rijswijcklaan,2023-01-08,15:00:00,42,23,19,FMN 11 A Jan Van Rijswijcklaan Ringfietspad
658,Ringfietspad Jan Van Rijswijcklaan,2023-01-08,16:00:00,36,22,14,FMN 11 A Jan Van Rijswijcklaan Ringfietspad
658,Ringfietspad Jan Van Rijswijcklaan,2023-01-08,17:00:00,29,17,12,FMN 11 A Jan Van Rijswijcklaan Ringfietspad
658,Ringfietspad Jan Van Rijswijcklaan,2023-01-08,18:00:00,19,12,7,FMN 11 A Jan Van Rijswijcklaan Ringfietspad
658,Ringfietspad Jan Van Rijswijcklaan,2023-01-08,19:00:00,13,6,7,FMN 11 A Jan Van Rijswijcklaan Ringfietspad
658,Ringfietspad Jan Van Rijswijcklaan,2023-01-08,20:00:00,11,4,7,FMN 11 A Jan Van Rijswijcklaan Ringfietspad
658,Ringfietspad Jan Van Rijswijcklaan,2023-01-08,21:00:00,6,4,2,FMN 11 A Jan Van Rijswijcklaan Ringfietspad
658,Ringfietspad Jan Van Rijswijcklaan,2023-01-08,22:00:00,5,5,0,FMN 11 A Jan Van Rijswijcklaan Ringfietspad
658,Ringfietspad Jan Van Rijswijcklaan,2023-01-08,23:00:00,2,0,2,FMN 11 A Jan Van Rijswijcklaan Ringfietspad
658,Ringfietspad Jan Van Rijswijcklaan,2023-01-09,00:00:00,2,2,0,FMN 11 A Jan Van Rijswijcklaan Ringfietspad
658,Ringfietspad Jan Van Rijswijcklaan,2023-01-09,01:00:00,0,0,0,FMN 11 A Jan Van Rijswijcklaan Ringfietspad
658,Ringfietspad Jan Van Rijswijcklaan,2023-01-09,02:00:00,1,1,0,FMN 11 A Jan Van Rijswijcklaan Ringfietspad
658,Ringfietspad Jan Van Rijswijcklaan,2023-01-09,03:00:00,2,2,0,FMN 11 A Jan Van Rijswijcklaan Ringfietspad
658,Ringfietspad Jan Van Rijswijcklaan,2023-01-09,04:00:00,6,3,3,FMN 11 A Jan Van Rijswijcklaan Ringfietspad
658,Ringfietspad Jan Van Rijswijcklaan,2023-01-09,05:00:00,17,4,13,FMN 11 A Jan Van Rijswijcklaan Ringfietspad
658,Ringfietspad Jan Van Rijswijcklaan,2023-01-09,06:00:00,46,14,32,FMN 11 A Jan Van Rijswijcklaan Ringfietspad
658,Ringfietspad Jan Van Rijswijcklaan,2023-01-09,07:00:00,93,34,59,FMN 11 A Jan Van Rijswijcklaan Ringfietspad
658,Ringfietspad Jan Van Rijswijcklaan,2023-01-09,08:00:00,123,39,84,FMN 11 A Jan Van Rijswijcklaan Ringfietspad
658,Ringfietspad Jan Van Rijswijcklaan,2023-01-09,09:00:00,43,18,25,FMN 11 A Jan Van Rijswijcklaan Ringfietspad
658,Ringfietspad Jan Van Rijswijcklaan,2023-01-09,10:00:00,31,14,17,FMN 11 A Jan Van Rijswijcklaan Ringfietspad
658,Ringfietspad Jan Van Rijswijcklaan,2023-01-09,11:00:00,28,15,13,FMN 11 A Jan Van Rijswijcklaan Ringfietspad
658,Ringfietspad Jan Van Rijswijcklaan,2023-01-09,12:00:00,42,21,21,FMN 11 A Jan Van Rijswijcklaan Ringfietspad
658,Ringfietspad Jan Van Rijswijcklaan,2023-01-09,13:00:00,44,24,20,FMN 11 A Jan Van Rijswijcklaan Ringfietspad
658,Ringfietspad Jan Van Rijswijcklaan,2023-01-09,14:00:00,51,28,23,FMN 11 A Jan Van Rijswijcklaan Ringfietspad
658,Ringfietspad Jan Van Rijswijcklaan,2023-01-09,15:00:00,71,48,23,FMN 11 A Jan Van Rijswijcklaan Ringfietspad
658,Ringfietspad Jan Van Rijswijcklaan,2023-01-09,16:00:00,111,76,35,FMN 11 A Jan Van Rijswijcklaan Ringfietspad
658,Ringfietspad Jan Van Rijswijcklaan,2023-01-09,17:00:00,118,77,41,FMN 11 A Jan Van Rijswijcklaan Ringfietspad
658,Ringfietspad Jan Van Rijswijcklaan,2023-01-09,18:00:00,68,41,27,FMN 11 A Jan Van Rijswijcklaan Ringfietspad
658,Ringfietspad Jan Van Rijswijcklaan,2023-01-09,19:00:00,33,17,16,FMN 11 A Jan Van Rijswijcklaan Ringfietspad
658,Ringfietspad Jan Van Rijswijcklaan,2023-01-09,20:00:00,23,9,14,FMN 11 A Jan Van Rijswijcklaan Ringfietspad
658,Ringfietspad Jan Van Rijswijcklaan,2023-01-09,21:00:00,15,8,7,FMN 11 A Jan Van Rijswijcklaan Ringfietspad
658,Ringfietspad Jan Van Rijswijcklaan,2023-01-09,22:00:00,14,9,5,FMN 11 A Jan Van Rijswijcklaan Ringfietspad
658,Ringfietspad Jan Van Rijswijcklaan,2023-01-09,23:00:00,5,4,1,FMN 11 A Jan Van Rijswijcklaan Ringfietspad
658,Ringfietspad Jan Van Rijswijcklaan,2023-01-10,00:00:00,1,1,0,FMN 11 A Jan Van Rijswijcklaan Ringfietspad
658,Ringfietspad Jan Van Rijswijcklaan,2023-01-10,01:00:00,1,0,1,FMN 11 A Jan Van Rijswijcklaan Ringfietspad
658,Ringfietspad Jan Van Rijswijcklaan,2023-01-10,02:00:00,1,0,1,FMN 11 A Jan Van Rijswijcklaan Ringfietspad
658,Ringfietspad Jan Van Rijswijcklaan,2023-01-10,03:00:00,2,1,1,FMN 11 A Jan Van Rijswijcklaan Ringfietspad
658,Ringfietspad Jan Van Rijswijcklaan,2023-01-10,04:00:00,5,3,2,FMN 11 A Jan Van Rijswijcklaan Ringfietspad
658,Ringfietspad Jan Van Rijswijcklaan,2023-01-10,05:00:00,19,8,11,FMN 11 A Jan Van Rijswijcklaan Ringfietspad
658,Ringfietspad Jan Van Rijswijcklaan,2023-01-10,06:00:00,49,14,35,FMN 11 A Jan Van Rijswijcklaan Ringfietspad
658,Ringfietspad Jan Van Rijswijcklaan,2023-01-10,07:00:00,96,35,61,FMN 11 A Jan Van Rijswijcklaan Ringfietspad
658,Ringfietspad Jan Van Rijswijcklaan,2023-01-10,08:00:00,123,43,80,FMN 11 A Jan Van Rijswijcklaan Ringfietspad
658,Ringfietspad Jan Van Rijswijcklaan,2023-01-10,09:00:00,46,18,28,FMN 11 A Jan Van Rijswijcklaan Ringfietspad
658,Ringfietspad Jan Van Rijswijcklaan,2023-01-10,10:00:00,30,12,18,FMN 11 A Jan Van Rijswijcklaan Ringfietspad
658,Ringfietspad Jan Van Rijswijcklaan,2023-01-10,11:00:00,28,14,14,FMN 11 A Jan Van Rijswijcklaan Ringfietspad
658,Ringfietspad Jan Van Rijswijcklaan,2023-01-10,12:00:00,39,21,18,FMN 11 A Jan Van Rijswijcklaan Ringfietspad
658,Ringfietspad Jan Van Rijswijcklaan,2023-01-10,13:00:00,42,23,19,FMN 11 A Jan Van Rijswijcklaan Ringfietspad
658,Ringfietspad Jan Van Rijswijcklaan,2023-01-10,14:00:00,46,24,22,FMN 11 A Jan Van Rijswijcklaan Ringfietspad
658,Ringfietspad Jan Van Rijswijcklaan,2023-01-10,15:00:00,68,46,22,FMN 11 A Jan Van Rijswijcklaan Ringfietspad
658,Ringfietspad Jan Van Rijswijcklaan,2023-01-10,16:00:00,112,77,35,FMN 11 A Jan Van Rijswijcklaan Ringfietspad
658,Ringfietspad Jan Van Rijswijcklaan,2023-01-10,17:00:00,119,79,40,FMN 11 A Jan Van Rijswijcklaan Ringfietspad
658,Ringfietspad Jan Van Rijswijcklaan,2023-01-10,18:00:00,73,42,31,FMN 11 A Jan Van Rijswijcklaan Ringfietspad
658,Ringfietspad Jan Van Rijswijcklaan,2023-01-10,19:00:00,30,16,14,FMN 11 A Jan Van Rijswijcklaan Ringfietspad
658,Ringfietspad Jan Van Rijswijcklaan,2023-01-10,20:00:00,24,11,13,FMN 11 A Jan Van Rijswijcklaan Ringfietspad
658,Ringfietspad Jan Van Rijswijcklaan,2023-01-10,21:00:00,15,8,7,FMN 11 A Jan Van Rijswijcklaan Ringfietspad
658,Ringfietspad Jan Van Rijswijcklaan,2023-01-10,22:00:00,14,10,4,FMN 11 A Jan Van Rijswijcklaan Ringfietspad
658,Ringfietspad Jan Van Rijswijcklaan,2023-01-10,23:00:00,6,3,3,FMN 11 A Jan Van Rijswijcklaan Ringfietspad
658,Ringfietspad Jan Van Rijswijcklaan,2023-01-11,00:00:00,2,2,0,FMN 11 A Jan Van Rijswijcklaan Ringfietspad
658,Ringfietspad Jan Van Rijswijcklaan,2023-01-11,01:00:00,2,1,1,FMN 11 A Jan Van Rijswijcklaan Ringfietspad
658,Ringfietspad Jan Van Rijswijcklaan,2023-01-11,02:00:00,1,1,0,FMN 11 A Jan Van Rijswijcklaan Ringfietspad
658,Ringfietspad Jan Van Rijswijcklaan,2023-01-11,03:00:00,1,1,0,FMN 11 A Jan Van Rijswijcklaan Ringfietspad
658,Ringfietspad Jan Van Rijswijcklaan,2023-01-11,04:00:00,6,3,3,FMN 11 A Jan Van Rijswijcklaan Ringfietspad
658,Ringfietspad Jan Van Rijswijcklaan,2023-01-11,05:00:00,21,9,12,FMN 11 A Jan Van Rijswijcklaan Ringfietspad
658,Ringfietspad Jan Van Rijswijcklaan,2023-01-11,06:00:00,54,15,39,FMN 11 A Jan Van Rijswijcklaan Ringfietspad
658,Ringfietspad Jan Van Rijswijcklaan,2023-01-11,07:00:00,102,38,64,FMN 11 A Jan Van Rijswijcklaan Ringfietspad
658,Ringfietspad Jan Van Rijswijcklaan,2023-01-11,08:00:00,121,40,81,FMN 11 A Jan Van Rijswijcklaan Ringfietspad
658,Ringfietspad Jan Van Rijswijcklaan,2023-01-11,09:00:00,46,15,31,FMN 11 A Jan Van Rijswijcklaan Ringfietspad
658,Ringfietspad Jan Van Rijswijcklaan,2023-01-11,10:00:00,34,18,16,FMN 11 A Jan Van Rijswijcklaan Ringfietspad
658,Ringfietspad Jan Van Rijswijcklaan,2023-01-11,11:00:00,35,18,17,FMN 11 A Jan Van Rijswijcklaan Ringfietspad
658,Ringfietspad Jan Van Rijswijcklaan,2023-01-11,12:00:00,54,25,29,FMN 11 A Jan Van Rijswijcklaan Ringfietspad
658,Ringfietspad Jan Van Rijswijcklaan,2023-01-11,13:00:00,53,27,26,FMN 11 A Jan Van Rijswijcklaan Ringfietspad
658,Ringfietspad Jan Van Rijswijcklaan,2023-01-11,14:00:00,57,32,25,FMN 11 A Jan Van Rijswijcklaan Ringfietspad
658,Ringfietspad Jan Van Rijswijcklaan,2023-01-11,15:00:00,73,47,26,FMN 11 A Jan Van Rijswijcklaan Ringfietspad
658,Ringfietspad Jan Van Rijswijcklaan,2023-01-11,16:00:00,113,77,36,FMN 11 A Jan Van Rijswijcklaan Ringfietspad
658,Ringfietspad Jan Van Rijswijcklaan,2023-01-11,17:00:00,124,82,42,FMN 11 A Jan Van Rijswijcklaan Ringfietspad
658,Ringfietspad Jan Van Rijswijcklaan,2023-01-11,18:00:00,74,44,30,FMN 11 A Jan Van Rijswijcklaan Ringfietspad
658,Ringfietspad Jan Van Rijswijcklaan,2023-01-11,19:00:00,40,19,21,FMN 11 A Jan Van Rijswijcklaan Ringfietspad
658,Ringfietspad Jan Van Rijswijcklaan,2023-01-11,20:00:00,26,14,12,FMN 11 A Jan Van Rijswijcklaan Ringfietspad
658,Ringfietspad Jan Van Rijswijcklaan,2023-01-11,21:00:00,19,12,7,FMN 11 A Jan Van Rijswijcklaan Ringfietspad
658,Ringfietspad Jan Van Rijswijcklaan,2023-01-11,22:00:00,17,8,9,FMN 11 A Jan Van Rijswijcklaan Ringfietspad
658,Ringfietspad Jan Van Rijswijcklaan,2023-01-11,23:00:00,6,3,3,FMN 11 A Jan Van Rijswijcklaan Ringfietspad
658,Ringfietspad Jan Van Rijswijcklaan,2023-01-12,00:00:00,2,0,2,FMN 11 A Jan Van Rijswijcklaan Ringfietspad
658,Ringfietspad Jan Van Rijswijcklaan,2023-01-12,01:00:00,1,0,1,FMN 11 A Jan Van Rijswijcklaan Ringfietspad
658,Ringfietspad Jan Van Rijswijcklaan,2023-01-12,02:00:00,0,0,0,FMN 11 A Jan Van Rijswijcklaan Ringfietspad
658,Ringfietspad Jan Van Rijswijcklaan,2023-01-12,03:00:00,1,1,0,FMN 11 A Jan Van Rijswijcklaan Ringfietspad
658,Ringfietspad Jan Van Rijswijcklaan,2023-01-12,04:00:00,4,1,3,FMN 11 A Jan Van Rijswijcklaan Ringfietspad
658,Ringfietspad Jan Van Rijswijcklaan,2023-01-12,05:00:00,13,5,8,FMN 11 A Jan Van Rijswijcklaan Ringfietspad
658,Ringfietspad Jan Van Rijswijcklaan,2023-01-12,06:00:00,33,8,25,FMN 11 A Jan Van Rijswijcklaan Ringfietspad
658,Ringfietspad Jan Van Rijswijcklaan,2023-01-12,07:00:00,62,21,41,FMN 11 A Jan Van Rijswijcklaan Ringfietspad
658,Ringfietspad Jan Van Rijswijcklaan,2023-01-12,08:00:00,84,27,57,FMN 11 A Jan Van Rijswijcklaan Ringfietspad
658,Ringfietspad Jan Van Rijswijcklaan,2023-01-12,09:00:00,33,10,23,FMN 11 A Jan Van Rijswijcklaan Ringfietspad
658,Ringfietspad Jan Van Rijswijcklaan,2023-01-12,10:00:00,21,9,12,FMN 11 A Jan Van Rijswijcklaan Ringfietspad
658,Ringfietspad Jan Van Rijswijcklaan,2023-01-12,11:00:00,21,9,12,FMN 11 A Jan Van Rijswijcklaan Ringfietspad
658,Ringfietspad Jan Van Rijswijcklaan,2023-01-12,12:00:00,30,16,14,FMN 11 A Jan Van Rijswijcklaan Ringfietspad
658,Ringfietspad Jan Van Rijswijcklaan,2023-01-12,13:00:00,31,15,16,FMN 11 A Jan Van Rijswijcklaan Ringfietspad
658,Ringfietspad Jan Van Rijswijcklaan,2023-01-12,14:00:00,35,16,19,FMN 11 A Jan Van Rijswijcklaan Ringfietspad
658,Ringfietspad Jan Van Rijswijcklaan,2023-01-12,15:00:00,49,31,18,FMN 11 A Jan Van Rijswijcklaan Ringfietspad
658,Ringfietspad Jan Van Rijswijcklaan,2023-01-12,16:00:00,74,49,25,FMN 11 A Jan Van Rijswijcklaan Ringfietspad
658,Ringfietspad Jan Van Rijswijcklaan,2023-01-12,17:00:00,76,51,25,FMN 11 A Jan Van Rijswijcklaan Ringfietspad
658,Ringfietspad Jan Van Rijswijcklaan,2023-01-12,18:00:00,47,29,18,FMN 11 A Jan Van Rijswijcklaan Ringfietspad
658,Ringfietspad Jan Van Rijswijcklaan,2023-01-12,19:00:00,26,14,12,FMN 11 A Jan Van Rijswijcklaan Ringfietspad
658,Ringfietspad Jan Van Rijswijcklaan,2023-01-12,20:00:00,16,9,7,FMN 11 A Jan Van Rijswijcklaan Ringfietspad
658,Ringfietspad Jan Van Rijswijcklaan,2023-01-12,21:00:00,12,5,7,FMN 11 A Jan Van Rijswijcklaan Ringfietspad
658,Ringfietspad Jan Van Rijswijcklaan,2023-01-12,22:00:00,10,7,3,FMN 11 A Jan Van Rijswijcklaan Ringfietspad
658,Ringfietspad Jan Van Rijswijcklaan,2023-01-12,23:00:00,5,3,2,FMN 11 A Jan Van Rijswijcklaan Ringfietspad
658,Ringfietspad Jan Van Rijswijcklaan,2023-01-13,00:00:00,4,2,2,FMN 11 A Jan Van Rijswijcklaan Ringfietspad
658,Ringfietspad Jan Van Rijswijcklaan,2023-01-13,01:00:00,1,0,1,FMN 11 A Jan Van Rijswijcklaan Ringfietspad
658,Ringfietspad Jan Van Rijswijcklaan,2023-01-13,02:00:00,2,2,0,FMN 11 A Jan Van Rijswijcklaan Ringfietspad
658,Ringfietspad Jan Van Rijswijcklaan,2023-01-13,03:00:00,2,2,0,FMN 11 A Jan Van Rijswijcklaan Ringfietspad
658,Ringfietspad Jan Van Rijswijcklaan,2023-01-13,04:00:00,6,2,4,FMN 11 A Jan Van Rijswijcklaan Ringfietspad
658,Ringfietspad Jan Van Rijswijcklaan,2023-01-13,05:00:00,16,4,12,FMN 11 A Jan Van Rijswijcklaan Ringfietspad
658,Ringfietspad Jan Van Rijswijcklaan,2023-01-13,06:00:00,46,15,31,FMN 11 A Jan Van Rijswijcklaan Ringfietspad
658,Ringfietspad Jan Van Rijswijcklaan,2023-01-13,07:00:00,88,31,57,FMN 11 A Jan Van Rijswijcklaan Ringfietspad
658,Ringfietspad Jan Van Rijswijcklaan,2023-01-13,08:00:00,122,40,82,FMN 11 A Jan Van Rijswijcklaan Ringfietspad
658,Ringfietspad Jan Van Rijswijcklaan,2023-01-13,09:00:00,51,18,33,FMN 11 A Jan Van Rijswijcklaan Ringfietspad
658,Ringfietspad Jan Van Rijswijcklaan,2023-01-13,10:00:00,37,16,21,FMN 11 A Jan Van Rijswijcklaan Ringfietspad
658,Ringfietspad Jan Van Rijswijcklaan,2023-01-13,11:00:00,36,17,19,FMN 11 A Jan Van Rijswijcklaan Ringfietspad
658,Ringfietspad Jan Van Rijswijcklaan,2023-01-13,12:00:00,51,27,24,FMN 11 A Jan Van Rijswijcklaan Ringfietspad
658,Ringfietspad Jan Van Rijswijcklaan,2023-01-13,13:00:00,50,27,23,FMN 11 A Jan Van Rijswijcklaan Ringfietspad
658,Ringfietspad Jan Van Rijswijcklaan,2023-01-13,14:00:00,61,37,24,FMN 11 A Jan Van Rijswijcklaan Ringfietspad
658,Ringfietspad Jan Van Rijswijcklaan,2023-01-13,15:00:00,86,56,30,FMN 11 A Jan Van Rijswijcklaan Ringfietspad
658,Ringfietspad Jan Van Rijswijcklaan,2023-01-13,16:00:00,113,76,37,FMN 11 A Jan Van Rijswijcklaan Ringfietspad
658,Ringfietspad Jan Van Rijswijcklaan,2023-01-13,17:00:00,97,62,35,FMN 11 A Jan Van Rijswijcklaan Ringfietspad
658,Ringfietspad Jan Van Rijswijcklaan,2023-01-13,18:00:00,59,36,23,FMN 11 A Jan Van Rijswijcklaan Ringfietspad
658,Ringfietspad Jan Van Rijswijcklaan,2023-01-13,19:00:00,37,19,18,FMN 11 A Jan Van Rijswijcklaan Ringfietspad
658,Ringfietspad Jan Van Rijswijcklaan,2023-01-13,20:00:00,23,11,12,FMN 11 A Jan Van Rijswijcklaan Ringfietspad
658,Ringfietspad Jan Van Rijswijcklaan,2023-01-13,21:00:00,16,11,5,FMN 11 A Jan Van Rijswijcklaan Ringfietspad
658,Ringfietspad Jan Van Rijswijcklaan,2023-01-13,22:00:00,16,8,8,FMN 11 A Jan Van Rijswijcklaan Ringfietspad
658,Ringfietspad Jan Van Rijswijcklaan,2023-01-13,23:00:00,9,3,6,FMN 11 A Jan Van Rijswijcklaan Ringfietspad
658,Ringfietspad Jan Van Rijswijcklaan,2023-01-14,00:00:00,3,2,1,FMN 11 A Jan Van Rijswijcklaan Ringfietspad
658,Ringfietspad Jan Van Rijswijcklaan,2023-01-14,01:00:00,2,2,0,FMN 11 A Jan Van Rijswijcklaan Ringfietspad
658,Ringfietspad Jan Van Rijswijcklaan,2023-01-14,02:00:00,1,1,0,FMN 11 A Jan Van Rijswijcklaan Ringfietspad
658,Ringfietspad Jan Van Rijswijcklaan,2023-01-14,03:00:00,1,1,0,FMN 11 A Jan Van Rijswijcklaan Ringfietspad
658,Ringfietspad Jan Van Rijswijcklaan,2023-01-14,04:00:00,2,0,2,FMN 11 A Jan Van Rijswijcklaan Ringfietspad
658,Ringfietspad Jan Van Rijswijcklaan,2023-01-14,05:00:00,2,1,1,FMN 11 A Jan Van Rijswijcklaan Ringfietspad
658,Ringfietspad Jan Van Rijswijcklaan,2023-01-14,06:00:00,4,0,4,FMN 11 A Jan Van Rijswijcklaan Ringfietspad
658,Ringfietspad Jan Van Rijswijcklaan,2023-01-14,07:00:00,4,2,2,FMN 11 A Jan Van Rijswijcklaan Ringfietspad
658,Ringfietspad Jan Van Rijswijcklaan,2023-01-14,08:00:00,8,4,4,FMN 11 A Jan Van Rijswijcklaan Ringfietspad
658,Ringfietspad Jan Van Rijswijcklaan,2023-01-14,09:00:00,15,5,10,FMN 11 A Jan Van Rijswijcklaan Ringfietspad
658,Ringfietspad Jan Van Rijswijcklaan,2023-01-14,10:00:00,18,7,11,FMN 11 A Jan Van Rijswijcklaan Ringfietspad
658,Ringfietspad Jan Van Rijswijcklaan,2023-01-14,11:00:00,20,10,10,FMN 11 A Jan Van Rijswijcklaan Ringfietspad
658,Ringfietspad Jan Van Rijswijcklaan,2023-01-14,12:00:00,21,11,10,FMN 11 A Jan Van Rijswijcklaan Ringfietspad
658,Ringfietspad Jan Van Rijswijcklaan,2023-01-14,13:00:00,26,12,14,FMN 11 A Jan Van Rijswijcklaan Ringfietspad
658,Ringfietspad Jan Van Rijswijcklaan,2023-01-14,14:00:00,31,15,16,FMN 11 A Jan Van Rijswijcklaan Ringfietspad
658,Ringfietspad Jan Van Rijswijcklaan,2023-01-14,15:00:00,29,15,14,FMN 11 A Jan Van Rijswijcklaan Ringfietspad
658,Ringfietspad Jan Van Rijswijcklaan,2023-01-14,16:00:00,27,15,12,FMN 11 A Jan Van Rijswijcklaan Ringfietspad
658,Ringfietspad Jan Van Rijswijcklaan,2023-01-14,17:00:00,20,13,7,FMN 11 A Jan Van Rijswijcklaan Ringfietspad
658,Ringfietspad Jan Van Rijswijcklaan,2023-01-14,18:00:00,16,10,6,FMN 11 A Jan Van Rijswijcklaan Ringfietspad
658,Ringfietspad Jan Van Rijswijcklaan,2023-01-14,19:00:00,11,7,4,FMN 11 A Jan Van Rijswijcklaan Ringfietspad
658,Ringfietspad Jan Van Rijswijcklaan,2023-01-14,20:00:00,8,5,3,FMN 11 A Jan Van Rijswijcklaan Ringfietspad
658,Ringfietspad Jan Van Rijswijcklaan,2023-01-14,21:00:00,7,6,1,FMN 11 A Jan Van Rijswijcklaan Ringfietspad
658,Ringfietspad Jan Van Rijswijcklaan,2023-01-14,22:00:00,5,2,3,FMN 11 A Jan Van Rijswijcklaan Ringfietspad
658,Ringfietspad Jan Van Rijswijcklaan,2023-01-14,23:00:00,3,2,1,FMN 11 A Jan Van Rijswijcklaan Ringfietspad
658,Ringfietspad Jan Van Rijswijcklaan,2023-01-15,00:00:00,2,1,1,FMN 11 A Jan Van Rijswijcklaan Ringfietspad
658,Ringfietspad Jan Van Rijswijcklaan,2023-01-15,01:00:00,2,1,1,FMN 11 A Jan Van Rijswijcklaan Ringfietspad
658,Ringfietspad Jan Van Rijswijcklaan,2023-01-15,02:00:00,1,1,0,FMN 11 A Jan Van Rijswijcklaan Ringfietspad
658,Ringfietspad Jan Van Rijswijcklaan,2023-01-15,03:00:00,0,0,0,FMN 11 A Jan Van Rijswijcklaan Ringfietspad
658,Ringfietspad Jan Van Rijswijcklaan,2023-01-15,04:00:00,1,0,1,FMN 11 A Jan Van Rijswijcklaan Ringfietspad
658,Ringfietspad Jan Van Rijswijcklaan,2023-01-15,05:00:00,1,0,1,FMN 11 A Jan Van Rijswijcklaan Ringfietspad
658,Ringfietspad Jan Van Rijswijcklaan,2023-01-15,06:00:00,3,2,1,FMN 11 A Jan Van Rijswijcklaan Ringfietspad
658,Ringfietspad Jan Van Rijswijcklaan,2023-01-15,07:00:00,3,1,2,FMN 11 A Jan Van Rijswijcklaan Ringfietspad
658,Ringfietspad Jan Van Rijswijcklaan,2023-01-15,08:00:00,9,1,8,FMN 11 A Jan Van Rijswijcklaan Ringfietspad
658,Ringfietspad Jan Van Rijswijcklaan,2023-01-15,09:00:00,18,5,13,FMN 11 A Jan Van Rijswijcklaan Ringfietspad
658,Ringfietspad Jan Van Rijswijcklaan,2023-01-15,10:00:00,23,9,14,FMN 11 A Jan Van Rijswijcklaan Ringfietspad
658,Ringfietspad Jan Van Rijswijcklaan,2023-01-15,11:00:00,26,13,13,FMN 11 A Jan Van Rijswijcklaan Ringfietspad
658,Ringfietspad Jan Van Rijswijcklaan,2023-01-15,12:00:00,30,17,13,FMN 11 A Jan Van Rijswijcklaan Ringfietspad
658,Ringfietspad Jan Van Rijswijcklaan,2023-01-15,13:00:00,33,16,17,FMN 11 A Jan Van Rijswijcklaan Ringfietspad
658,Ringfietspad Jan Van Rijswijcklaan,2023-01-15,14:00:00,37,18,19,FMN 11 A Jan Van Rijswijcklaan Ringfietspad
658,Ringfietspad Jan Van Rijswijcklaan,2023-01-15,15:00:00,34,21,13,FMN 11 A Jan Van Rijswijcklaan Ringfietspad
658,Ringfietspad Jan Van Rijswijcklaan,2023-01-15,16:00:00,29,17,12,FMN 11 A Jan Van Rijswijcklaan Ringfietspad
658,Ringfietspad Jan Van Rijswijcklaan,2023-01-15,17:00:00,23,14,9,FMN 11 A Jan Van Rijswijcklaan Ringfietspad
658,Ringfietspad Jan Van Rijswijcklaan,2023-01-15,18:00:00,15,8,7,FMN 11 A Jan Van Rijswijcklaan Ringfietspad
658,Ringfietspad Jan Van Rijswijcklaan,2023-01-15,19:00:00,11,8,3,FMN 11 A Jan Van Rijswijcklaan Ringfietspad
658,Ringfietspad Jan Van Rijswijcklaan,2023-01-15,20:00:00,9,4,5,FMN 11 A Jan Van Rijswijcklaan Ringfietspad
658,Ringfietspad Jan Van Rijswijcklaan,2023-01-15,21:00:00,5,3,2,FMN 11 A Jan Van Rijswijcklaan Ringfietspad
658,Ringfietspad Jan Van Rijswijcklaan,2023-01-15,22:00:00,4,3,1,FMN 11 A Jan Van Rijswijcklaan Ringfietspad
658,Ringfietspad Jan Van Rijswijcklaan,2023-01-15,23:00:00,1,0,1,FMN 11 A Jan Van Rijswijcklaan Ringfietspad
658,Ringfietspad Jan Van Rijswijcklaan,2023-01-16,00:00:00,1,1,0,FMN 11 A Jan Van Rijswijcklaan Ringfietspad
658,Ringfietspad Jan Van Rijswijcklaan,2023-01-16,01:00:00,1,1,0,FMN 11 A Jan Van Rijswijcklaan Ringfietspad
658,Ringfietspad Jan Van Rijswijcklaan,2023-01-16,02:00:00,0,0,0,FMN 11 A Jan Van Rijswijcklaan Ringfietspad
658,Ringfietspad Jan Van Rijswijcklaan,2023-01-16,03:00:00,1,0,1,FMN 11 A Jan Van Rijswijcklaan Ringfietspad
658,Ringfietspad Jan Van Rijswijcklaan,2023-01-16,04:00:00,5,3,2,FMN 11 A Jan Van Rijswijcklaan Ringfietspad
658,Ringfietspad Jan Van Rijswijcklaan,2023-01-16,05:00:00,12,3,9,FMN 11 A Jan Van Rijswijcklaan Ringfietspad
658,Ringfietspad Jan Van Rijswijcklaan,2023-01-16,06:00:00,32,10,22,FMN 11 A Jan Van Rijswijcklaan Ringfietspad
658,Ringfietspad Jan Van Rijswijcklaan,2023-01-16,07:00:00,67,23,44,FMN 11 A Jan Van Rijswijcklaan Ringfietspad
658,Ringfietspad Jan Van Rijswijcklaan,2023-01-16,08:00:00,87,29,58,FMN 11 A Jan Van Rijswijcklaan Ringfietspad
658,Ringfietspad Jan Van Rijswijcklaan,2023-01-16,09:00:00,31,11,20,FMN 11 A Jan Van Rijswijcklaan Ringfietspad
658,Ringfietspad Jan Van Rijswijcklaan,2023-01-16,10:00:00,21,7,14,FMN 11 A Jan Van Rijswijcklaan Ringfietspad
658,Ringfietspad Jan Van Rijswijcklaan,2023-01-16,11:00:00,20,8,12,FMN 11 A Jan Van Rijswijcklaan Ringfietspad
658,Ringfietspad Jan Van Rijswijcklaan,2023-01-16,12:00:00,30,16,14,FMN 11 A Jan Van Rijswijcklaan Ringfietspad
658,Ringfietspad Jan Van Rijswijcklaan,2023-01-16,13:00:00,31,17,14,FMN 11 A Jan Van Rijswijcklaan Ringfietspad
658,Ringfietspad Jan Van Rijswijcklaan,2023-01-16,14:00:00,36,20,16,FMN 11 A Jan Van Rijswijcklaan Ringfietspad
658,Ringfietspad Jan Van Rijswijcklaan,2023-01-16,15:00:00,51,34,17,FMN 11 A Jan Van Rijswijcklaan Ringfietspad
658,Ringfietspad Jan Van Rijswijcklaan,2023-01-16,16:00:00,79,54,25,FMN 11 A Jan Van Rijswijcklaan Ringfietspad
658,Ringfietspad Jan Van Rijswijcklaan,2023-01-16,17:00:00,83,55,28,FMN 11 A Jan Van Rijswijcklaan Ringfietspad
658,Ringfietspad Jan Van Rijswijcklaan,2023-01-16,18:00:00,49,32,17,FMN 11 A Jan Van Rijswijcklaan Ringfietspad
658,Ringfietspad Jan Van Rijswijcklaan,2023-01-16,19:00:00,23,12,11,FMN 11 A Jan Van Rijswijcklaan Ringfietspad
658,Ringfietspad Jan Van Rijswijcklaan,2023-01-16,20:00:00,16,7,9,FMN 11 A Jan Van Rijswijcklaan Ringfietspad
658,Ringfietspad Jan Van Rijswijcklaan,2023-01-16,21:00:00,11,7,4,FMN 11 A Jan Van Rijswijcklaan Ringfietspad
658,Ringfietspad Jan Van Rijswijcklaan,2023-01-16,22:00:00,10,7,3,FMN 11 A Jan Van Rijswijcklaan Ringfietspad
658,Ringfietspad Jan Van Rijswijcklaan,2023-01-16,23:00:00,3,2,1,FMN 11 A Jan Van Rijswijcklaan Ringfietspad
658,Ringfietspad Jan Van Rijswijcklaan,2023-01-17,00:00:00,1,1,0,FMN 11 A Jan Van Rijswijcklaan Ringfietspad
658,Ringfietspad Jan Van Rijswijcklaan,2023-01-17,01:00:00,1,1,0,FMN 11 A Jan Van Rijswijcklaan Ringfietspad
658,Ringfietspad Jan Van Rijswijcklaan,2023-01-17,02:00:00,1,1,0,FMN 11 A Jan Van Rijswijcklaan Ringfietspad
658,Ringfietspad Jan Van Rijswijcklaan,2023-01-17,03:00:00,1,1,0,FMN 11 A Jan Van Rijswijcklaan Ringfietspad
658,Ringfietspad Jan Van Rijswijcklaan,2023-01-17,04:00:00,6,3,3,FMN 11 A Jan Van Rijswijcklaan Ringfietspad
658,Ringfietspad Jan Van Rijswijcklaan,2023-01-17,05:00:00,18,5,13,FMN 11 A Jan Van Rijswijcklaan Ringfietspad
658,Ringfietspad Jan Van Rijswijcklaan,2023-01-17,06:00:00,48,10,38,FMN 11 A Jan Van Rijswijcklaan Ringfietspad
658,Ringfietspad Jan Van Rijswijcklaan,2023-01-17,07:00:00,94,32,62,FMN 11 A Jan Van Rijswijcklaan Ringfietspad
658,Ringfietspad Jan Van Rijswijcklaan,2023-01-17,08:00:00,121,41,80,FMN 11 A Jan Van Rijswijcklaan Ringfietspad
658,Ringfietspad Jan Van Rijswijcklaan,2023-01-17,09:00:00,45,17,28,FMN 11 A Jan Van Rijswijcklaan Ringfietspad
658,Ringfietspad Jan Van Rijswijcklaan,2023-01-17,10:00:00,29,13,16,FMN 11 A Jan Van Rijswijcklaan Ringfietspad
658,Ringfietspad Jan Van Rijswijcklaan,2023-01-17,11:00:00,27,14,13,FMN 11 A Jan Van Rijswijcklaan Ringfietspad
658,Ringfietspad Jan Van Rijswijcklaan,2023-01-17,12:00:00,39,19,20,FMN 11 A Jan Van Rijswijcklaan Ringfietspad
658,Ringfietspad Jan Van Rijswijcklaan,2023-01-17,13:00:00,41,21,20,FMN 11 A Jan Van Rijswijcklaan Ringfietspad
658,Ringfietspad Jan Van Rijswijcklaan,2023-01-17,14:00:00,45,23,22,FMN 11 A Jan Van Rijswijcklaan Ringfietspad
658,Ringfietspad Jan Van Rijswijcklaan,2023-01-17,15:00:00,66,43,23,FMN 11 A Jan Van Rijswijcklaan Ringfietspad
658,Ringfietspad Jan Van Rijswijcklaan,2023-01-17,16:00:00,110,75,35,FMN 11 A Jan Van Rijswijcklaan Ringfietspad
658,Ringfietspad Jan Van Rijswijcklaan,2023-01-17,17:00:00,117,78,39,FMN 11 A Jan Van Rijswijcklaan Ringfietspad
658,Ringfietspad Jan Van Rijswijcklaan,2023-01-17,18:00:00,70,42,28,FMN 11 A Jan Van Rijswijcklaan Ringfietspad
658,Ringfietspad Jan Van Rijswijcklaan,2023-01-17,19:00:00,30,16,14,FMN 11 A Jan Van Rijswijcklaan Ringfietspad
658,Ringfietspad Jan Van Rijswijcklaan,2023-01-17,20:00:00,24,12,12,FMN 11 A Jan Van Rijswijcklaan Ringfietspad
658,Ringfietspad Jan Van Rijswijcklaan,2023-01-17,21:00:00,14,7,7,FMN 11 A Jan Van Rijswijcklaan Ringfietspad
658,Ringfietspad Jan Van Rijswijcklaan,2023-01-17,22:00:00,14,10,4,FMN 11 A Jan Van Rijswijcklaan Ringfietspad
658,Ringfietspad Jan Van Rijswijcklaan,2023-01-17,23:00:00,6,5,1,FMN 11 A Jan Van Rijswijcklaan Ringfietspad
658,Ringfietspad Jan Van Rijswijcklaan,2023-01-18,00:00:00,2,2,0,FMN 11 A Jan Van Rijswijcklaan Ringfietspad
658,Ringfietspad Jan Van Rijswijcklaan,2023-01-18,01:00:00,1,1,0,FMN 11 A Jan Van Rijswijcklaan Ringfietspad
658,Ringfietspad Jan Van Rijswijcklaan,2023-01-18,02:00:00,1,1,0,FMN 11 A Jan Van Rijswijcklaan Ringfietspad
658,Ringfietspad Jan Van Rijswijcklaan,2023-01-18,03:00:00,2,1,1,FMN 11 A Jan Van Rijswijcklaan Ringfietspad
658,Ringfietspad Jan Van Rijswijcklaan,2023-01-18,04:00:00,5,2,3,FMN 11 A Jan Van Rijswijcklaan Ringfietspad
658,Ringfietspad Jan Van Rijswijcklaan,2023-01-18,05:00:00,19,7,12,FMN 11 A Jan Van Rijswijcklaan Ringfietspad
658,Ringfietspad Jan Van Rijswijcklaan,2023-01-18,06:00:00,49,13,36,FMN 11 A Jan Van Rijswijcklaan Ringfietspad
658,Ringfietspad Jan Van Rijswijcklaan,2023-01-18,07:00:00,93,36,57,FMN 11 A Jan Van Rijswijcklaan Ringfietspad
658,Ringfietspad Jan Van Rijswijcklaan,2023-01-18,08:00:00,111,40,71,FMN 11 A Jan Van Rijswijcklaan Ringfietspad
658,Ringfietspad Jan Van Rijswijcklaan,2023-01-18,09:00:00,42,15,27,FMN 11 A Jan Van Rijswijcklaan Ringfietspad
658,Ringfietspad Jan Van Rijswijcklaan,2023-01-18,10:00:00,30,15,15,FMN 11 A Jan Van Rijswijcklaan Ringfietspad
658,Ringfietspad Jan Van Rijswijcklaan,2023-01-18,11:00:00,32,14,18,FMN 11 A Jan Van Rijswijcklaan Ringfietspad
658,Ringfietspad Jan Van Rijswijcklaan,2023-01-18,12:00:00,49,25,24,FMN 11 A Jan Van Rijswijcklaan Ringfietspad
658,Ringfietspad Jan Van Rijswijcklaan,2023-01-18,13:00:00,49,25,24,FMN 11 A Jan Van Rijswijcklaan Ringfietspad
658,Ringfietspad Jan Van Rijswijcklaan,2023-01-18,14:00:00,52,26,26,FMN 11 A Jan Van Rijswijcklaan Ringfietspad
658,Ringfietspad Jan Van Rijswijcklaan,2023-01-18,15:00:00,66,41,25,FMN 11 A Jan Van Rijswijcklaan Ringfietspad
658,Ringfietspad Jan Van Rijswijcklaan,2023-01-18,16:00:00,104,70,34,FMN 11 A Jan Van Rijswijcklaan Ringfietspad
658,Ringfietspad Jan Van Rijswijcklaan,2023-01-18,17:00:00,113,76,37,FMN 11 A Jan Van Rijswijcklaan Ringfietspad
658,Ringfietspad Jan Van Rijswijcklaan,2023-01-18,18:00:00,67,40,27,FMN 11 A Jan Van Rijswijcklaan Ringfietspad
658,Ringfietspad Jan Van Rijswijcklaan,2023-01-18,19:00:00,36,19,17,FMN 11 A Jan Van Rijswijcklaan Ringfietspad
658,Ringfietspad Jan Van Rijswijcklaan,2023-01-18,20:00:00,25,10,15,FMN 11 A Jan Van Rijswijcklaan Ringfietspad
658,Ringfietspad Jan Van Rijswijcklaan,2023-01-18,21:00:00,17,7,10,FMN 11 A Jan Van Rijswijcklaan Ringfietspad
658,Ringfietspad Jan Van Rijswijcklaan,2023-01-18,22:00:00,15,8,7,FMN 11 A Jan Van Rijswijcklaan Ringfietspad
658,Ringfietspad Jan Van Rijswijcklaan,2023-01-18,23:00:00,6,5,1,FMN 11 A Jan Van Rijswijcklaan Ringfietspad
658,Ringfietspad Jan Van Rijswijcklaan,2023-01-19,00:00:00,2,1,1,FMN 11 A Jan Van Rijswijcklaan Ringfietspad
658,Ringfietspad Jan Van Rijswijcklaan,2023-01-19,01:00:00,1,1,0,FMN 11 A Jan Van Rijswijcklaan Ringfietspad
658,Ringfietspad Jan Van Rijswijcklaan,2023-01-19,02:00:00,1,1,0,FMN 11 A Jan Van Rijswijcklaan Ringfietspad
658,Ringfietspad Jan Van Rijswijcklaan,2023-01-19,03:00:00,1,1,0,FMN 11 A Jan Van Rijswijcklaan Ringfietspad
658,Ringfietspad Jan Van Rijswijcklaan,2023-01-19,04:00:00,5,1,4,FMN 11 A Jan Van Rijswijcklaan Ringfietspad
658,Ringfietspad Jan Van Rijswijcklaan,2023-01-19,05:00:00,17,3,14,FMN 11 A Jan Van Rijswijcklaan Ringfietspad
658,Ringfietspad Jan Van Rijswijcklaan,2023-01-19,06:00:00,42,8,34,FMN 11 A Jan Van Rijswijcklaan Ringfietspad
658,Ringfietspad Jan Van Rijswijcklaan,2023-01-19,07:00:00,80,26,54,FMN 11 A Jan Van Rijswijcklaan Ringfietspad
658,Ringfietspad Jan Van Rijswijcklaan,2023-01-19,08:00:00,108,37,71,FMN 11 A Jan Van Rijswijcklaan Ringfietspad
658,Ringfietspad Jan Van Rijswijcklaan,2023-01-19,09:00:00,43,14,29,FMN 11 A Jan Van Rijswijcklaan Ringfietspad
658,Ringfietspad Jan Van Rijswijcklaan,2023-01-19,10:00:00,27,12,15,FMN 11 A Jan Van Rijswijcklaan Ringfietspad
658,Ringfietspad Jan Van Rijswijcklaan,2023-01-19,11:00:00,27,13,14,FMN 11 A Jan Van Rijswijcklaan Ringfietspad
658,Ringfietspad Jan Van Rijswijcklaan,2023-01-19,12:00:00,38,19,19,FMN 11 A Jan Van Rijswijcklaan Ringfietspad
658,Ringfietspad Jan Van Rijswijcklaan,2023-01-19,13:00:00,40,21,19,FMN 11 A Jan Van Rijswijcklaan Ringfietspad
658,Ringfietspad Jan Van Rijswijcklaan,2023-01-19,14:00:00,45,29,16,FMN 11 A Jan Van Rijswijcklaan Ringfietspad
658,Ringfietspad Jan Van Rijswijcklaan,2023-01-19,15:00:00,64,41,23,FMN 11 A Jan Van Rijswijcklaan Ringfietspad
658,Ringfietspad Jan Van Rijswijcklaan,2023-01-19,16:00:00,95,62,33,FMN 11 A Jan Van Rijswijcklaan Ringfietspad
658,Ringfietspad Jan Van Rijswijcklaan,2023-01-19,17:00:00,98,63,35,FMN 11 A Jan Van Rijswijcklaan Ringfietspad
658,Ringfietspad Jan Van Rijswijcklaan,2023-01-19,18:00:00,61,35,26,FMN 11 A Jan Van Rijswijcklaan Ringfietspad
658,Ringfietspad Jan Van Rijswijcklaan,2023-01-19,19:00:00,32,19,13,FMN 11 A Jan Van Rijswijcklaan Ringfietspad
658,Ringfietspad Jan Van Rijswijcklaan,2023-01-19,20:00:00,22,10,12,FMN 11 A Jan Van Rijswijcklaan Ringfietspad
658,Ringfietspad Jan Van Rijswijcklaan,2023-01-19,21:00:00,15,8,7,FMN 11 A Jan Van Rijswijcklaan Ringfietspad
658,Ringfietspad Jan Van Rijswijcklaan,2023-01-19,22:00:00,13,8,5,FMN 11 A Jan Van Rijswijcklaan Ringfietspad
658,Ringfietspad Jan Van Rijswijcklaan,2023-01-19,23:00:00,6,4,2,FMN 11 A Jan Van Rijswijcklaan Ringfietspad
658,Ringfietspad Jan Van Rijswijcklaan,2023-01-20,00:00:00,3,0,3,FMN 11 A Jan Van Rijswijcklaan Ringfietspad
658,Ringfietspad Jan Van Rijswijcklaan,2023-01-20,01:00:00,1,1,0,FMN 11 A Jan Van Rijswijcklaan Ringfietspad
658,Ringfietspad Jan Van Rijswijcklaan,2023-01-20,02:00:00,1,1,0,FMN 11 A Jan Van Rijswijcklaan Ringfietspad
658,Ringfietspad Jan Van Rijswijcklaan,2023-01-20,03:00:00,1,1,0,FMN 11 A Jan Van Rijswijcklaan Ringfietspad
658,Ringfietspad Jan Van Rijswijcklaan,2023-01-20,04:00:00,5,1,4,FMN 11 A Jan Van Rijswijcklaan Ringfietspad
658,Ringfietspad Jan Van Rijswijcklaan,2023-01-20,05:00:00,12,6,6,FMN 11 A Jan Van Rijswijcklaan Ringfietspad
658,Ringfietspad Jan Van Rijswijcklaan,2023-01-20,06:00:00,33,8,25,FMN 11 A Jan Van Rijswijcklaan Ringfietspad
658,Ringfietspad Jan Van Rijswijcklaan,2023-01-20,07:00:00,64,23,41,FMN 11 A Jan Van Rijswijcklaan Ringfietspad
658,Ringfietspad Jan Van Rijswijcklaan,2023-01-20,08:00:00,90,29,61,FMN 11 A Jan Van Rijswijcklaan Ringfietspad
658,Ringfietspad Jan Van Rijswijcklaan,2023-01-20,09:00:00,37,15,22,FMN 11 A Jan Van Rijswijcklaan Ringfietspad
658,Ringfietspad Jan Van Rijswijcklaan,2023-01-20,10:00:00,27,12,15,FMN 11 A Jan Van Rijswijcklaan Ringfietspad
658,Ringfietspad Jan Van Rijswijcklaan,2023-01-20,11:00:00,27,14,13,FMN 11 A Jan Van Rijswijcklaan Ringfietspad
658,Ringfietspad Jan Van Rijswijcklaan,2023-01-20,12:00:00,36,19,17,FMN 11 A Jan Van Rijswijcklaan Ringfietspad
658,Ringfietspad Jan Van Rijswijcklaan,2023-01-20,13:00:00,38,21,17,FMN 11 A Jan Van Rijswijcklaan Ringfietspad
658,Ringfietspad Jan Van Rijswijcklaan,2023-01-20,14:00:00,44,26,18,FMN 11 A Jan Van Rijswijcklaan Ringfietspad
658,Ringfietspad Jan Van Rijswijcklaan,2023-01-20,15:00:00,62,41,21,FMN 11 A Jan Van Rijswijcklaan Ringfietspad
658,Ringfietspad Jan Van Rijswijcklaan,2023-01-20,16:00:00,84,56,28,FMN 11 A Jan Van Rijswijcklaan Ringfietspad
658,Ringfietspad Jan Van Rijswijcklaan,2023-01-20,17:00:00,70,48,22,FMN 11 A Jan Van Rijswijcklaan Ringfietspad
658,Ringfietspad Jan Van Rijswijcklaan,2023-01-20,18:00:00,44,26,18,FMN 11 A Jan Van Rijswijcklaan Ringfietspad
658,Ringfietspad Jan Van Rijswijcklaan,2023-01-20,19:00:00,26,14,12,FMN 11 A Jan Van Rijswijcklaan Ringfietspad
658,Ringfietspad Jan Van Rijswijcklaan,2023-01-20,20:00:00,17,8,9,FMN 11 A Jan Van Rijswijcklaan Ringfietspad
658,Ringfietspad Jan Van Rijswijcklaan,2023-01-20,21:00:00,12,7,5,FMN 11 A Jan Van Rijswijcklaan Ringfietspad
658,Ringfietspad Jan Van Rijswijcklaan,2023-01-20,22:00:00,11,4,7,FMN 11 A Jan Van Rijswijcklaan Ringfietspad
658,Ringfietspad Jan Van Rijswijcklaan,2023-01-20,23:00:00,7,5,2,FMN 11 A Jan Van Rijswijcklaan Ringfietspad
658,Ringfietspad Jan Van Rijswijcklaan,2023-01-21,00:00:00,4,4,0,FMN 11 A Jan Van Rijswijcklaan Ringfietspad
658,Ringfietspad Jan Van Rijswijcklaan,2023-01-21,01:00:00,3,3,0,FMN 11 A Jan Van Rijswijcklaan Ringfietspad
658,Ringfietspad Jan Van Rijswijcklaan,2023-01-21,02:00:00,2,2,0,FMN 11 A Jan Van Rijswijcklaan Ringfietspad
658,Ringfietspad Jan Van Rijswijcklaan,2023-01-21,03:00:00,2,2,0,FMN 11 A Jan Van Rijswijcklaan Ringfietspad
658,Ringfietspad Jan Van Rijswijcklaan,2023-01-21,04:00:00,2,0,2,FMN 11 A Jan Van Rijswijcklaan Ringfietspad
658,Ringfietspad Jan Van Rijswijcklaan,2023-01-21,05:00:00,4,1,3,FMN 11 A Jan Van Rijswijcklaan Ringfietspad
658,Ringfietspad Jan Van Rijswijcklaan,2023-01-21,06:00:00,5,3,2,FMN 11 A Jan Van Rijswijcklaan Ringfietspad
658,Ringfietspad Jan Van Rijswijcklaan,2023-01-21,07:00:00,7,6,1,FMN 11 A Jan Van Rijswijcklaan Ringfietspad
658,Ringfietspad Jan Van Rijswijcklaan,2023-01-21,08:00:00,12,4,8,FMN 11 A Jan Van Rijswijcklaan Ringfietspad
658,Ringfietspad Jan Van Rijswijcklaan,2023-01-21,09:00:00,24,11,13,FMN 11 A Jan Van Rijswijcklaan Ringfietspad
658,Ringfietspad Jan Van Rijswijcklaan,2023-01-21,10:00:00,27,13,14,FMN 11 A Jan Van Rijswijcklaan Ringfietspad
658,Ringfietspad Jan Van Rijswijcklaan,2023-01-21,11:00:00,31,15,16,FMN 11 A Jan Van Rijswijcklaan Ringfietspad
658,Ringfietspad Jan Van Rijswijcklaan,2023-01-21,12:00:00,33,14,19,FMN 11 A Jan Van Rijswijcklaan Ringfietspad
658,Ringfietspad Jan Van Rijswijcklaan,2023-01-21,13:00:00,40,18,22,FMN 11 A Jan Van Rijswijcklaan Ringfietspad
658,Ringfietspad Jan Van Rijswijcklaan,2023-01-21,14:00:00,47,23,24,FMN 11 A Jan Van Rijswijcklaan Ringfietspad
658,Ringfietspad Jan Van Rijswijcklaan,2023-01-21,15:00:00,45,27,18,FMN 11 A Jan Van Rijswijcklaan Ringfietspad
658,Ringfietspad Jan Van Rijswijcklaan,2023-01-21,16:00:00,40,25,15,FMN 11 A Jan Van Rijswijcklaan Ringfietspad
658,Ringfietspad Jan Van Rijswijcklaan,2023-01-21,17:00:00,32,19,13,FMN 11 A Jan Van Rijswijcklaan Ringfietspad
658,Ringfietspad Jan Van Rijswijcklaan,2023-01-21,18:00:00,24,14,10,FMN 11 A Jan Van Rijswijcklaan Ringfietspad
658,Ringfietspad Jan Van Rijswijcklaan,2023-01-21,19:00:00,17,9,8,FMN 11 A Jan Van Rijswijcklaan Ringfietspad
658,Ringfietspad Jan Van Rijswijcklaan,2023-01-21,20:00:00,13,8,5,FMN 11 A Jan Van Rijswijcklaan Ringfietspad
658,Ringfietspad Jan Van Rijswijcklaan,2023-01-21,21:00:00,10,7,3,FMN 11 A Jan Van Rijswijcklaan Ringfietspad
658,Ringfietspad Jan Van Rijswijcklaan,2023-01-21,22:00:00,8,3,5,FMN 11 A Jan Van Rijswijcklaan Ringfietspad
658,Ringfietspad Jan Van Rijswijcklaan,2023-01-21,23:00:00,5,2,3,FMN 11 A Jan Van Rijswijcklaan Ringfietspad
658,Ringfietspad Jan Van Rijswijcklaan,2023-01-22,00:00:00,2,2,0,FMN 11 A Jan Van Rijswijcklaan Ringfietspad
658,Ringfietspad Jan Van Rijswijcklaan,2023-01-22,01:00:00,1,0,1,FMN 11 A Jan Van Rijswijcklaan Ringfietspad
658,Ringfietspad Jan Van Rijswijcklaan,2023-01-22,02:00:00,0,0,0,FMN 11 A Jan Van Rijswijcklaan Ringfietspad
658,Ringfietspad Jan Van Rijswijcklaan,2023-01-22,03:00:00,1,0,1,FMN 11 A Jan Van Rijswijcklaan Ringfietspad
658,Ringfietspad Jan Van Rijswijcklaan,2023-01-22,04:00:00,1,0,1,FMN 11 A Jan Van Rijswijcklaan Ringfietspad
658,Ringfietspad Jan Van Rijswijcklaan,2023-01-22,05:00:00,0,0,0,FMN 11 A Jan Van Rijswijcklaan Ringfietspad
658,Ringfietspad Jan Van Rijswijcklaan,2023-01-22,06:00:00,2,1,1,FMN 11 A Jan Van Rijswijcklaan Ringfietspad
658,Ringfietspad Jan Van Rijswijcklaan,2023-01-22,07:00:00,3,2,1,FMN 11 A Jan Van Rijswijcklaan Ringfietspad
658,Ringfietspad Jan Van Rijswijcklaan,2023-01-22,08:00:00,6,2,4,FMN 11 A Jan Van Rijswijcklaan Ringfietspad
658,Ringfietspad Jan Van Rijswijcklaan,2023-01-22,09:00:00,14,6,8,FMN 11 A Jan Van Rijswijcklaan Ringfietspad
658,Ringfietspad Jan Van Rijswijcklaan,2023-01-22,10:00:00,17,6,11,FMN 11 A Jan Van Rijswijcklaan Ringfietspad
658,Ringfietspad Jan Van Rijswijcklaan,2023-01-22,11:00:00,20,9,11,FMN 11 A Jan Van Rijswijcklaan Ringfietspad
658,Ringfietspad Jan Van Rijswijcklaan,2023-01-22,12:00:00,22,12,10,FMN 11 A Jan Van Rijswijcklaan Ringfietspad
658,Ringfietspad Jan Van Rijswijcklaan,2023-01-22,13:00:00,24,12,12,FMN 11 A Jan Van Rijswijcklaan Ringfietspad
658,Ringfietspad Jan Van Rijswijcklaan,2023-01-22,14:00:00,28,14,14,FMN 11 A Jan Van Rijswijcklaan Ringfietspad
658,Ringfietspad Jan Van Rijswijcklaan,2023-01-22,15:00:00,26,16,10,FMN 11 A Jan Van Rijswijcklaan Ringfietspad
658,Ringfietspad Jan Van Rijswijcklaan,2023-01-22,16:00:00,21,14,7,FMN 11 A Jan Van Rijswijcklaan Ringfietspad
658,Ringfietspad Jan Van Rijswijcklaan,2023-01-22,17:00:00,17,12,5,FMN 11 A Jan Van Rijswijcklaan Ringfietspad
658,Ringfietspad Jan Van Rijswijcklaan,2023-01-22,18:00:00,12,8,4,FMN 11 A Jan Van Rijswijcklaan Ringfietspad
658,Ringfietspad Jan Van Rijswijcklaan,2023-01-22,19:00:00,7,4,3,FMN 11 A Jan Van Rijswijcklaan Ringfietspad
658,Ringfietspad Jan Van Rijswijcklaan,2023-01-22,20:00:00,7,4,3,FMN 11 A Jan Van Rijswijcklaan Ringfietspad
658,Ringfietspad Jan Van Rijswijcklaan,2023-01-22,21:00:00,4,3,1,FMN 11 A Jan Van Rijswijcklaan Ringfietspad
658,Ringfietspad Jan Van Rijswijcklaan,2023-01-22,22:00:00,3,1,2,FMN 11 A Jan Van Rijswijcklaan Ringfietspad
658,Ringfietspad Jan Van Rijswijcklaan,2023-01-22,23:00:00,1,1,0,FMN 11 A Jan Van Rijswijcklaan Ringfietspad
658,Ringfietspad Jan Van Rijswijcklaan,2023-01-23,00:00:00,1,1,0,FMN 11 A Jan Van Rijswijcklaan Ringfietspad
658,Ringfietspad Jan Van Rijswijcklaan,2023-01-23,01:00:00,1,1,0,FMN 11 A Jan Van Rijswijcklaan Ringfietspad
658,Ringfietspad Jan Van Rijswijcklaan,2023-01-23,02:00:00,1,1,0,FMN 11 A Jan Van Rijswijcklaan Ringfietspad
658,Ringfietspad Jan Van Rijswijcklaan,2023-01-23,03:00:00,1,1,0,FMN 11 A Jan Van Rijswijcklaan Ringfietspad
658,Ringfietspad Jan Van Rijswijcklaan,2023-01-23,04:00:00,6,2,4,FMN 11 A Jan Van Rijswijcklaan Ringfietspad
658,Ringfietspad Jan Van Rijswijcklaan,2023-01-23,05:00:00,16,7,9,FMN 11 A Jan Van Rijswijcklaan Ringfietspad
658,Ringfietspad Jan Van Rijswijcklaan,2023-01-23,06:00:00,43,9,34,FMN 11 A Jan Van Rijswijcklaan Ringfietspad
658,Ringfietspad Jan Van Rijswijcklaan,2023-01-23,07:00:00,87,29,58,FMN 11 A Jan Van Rijswijcklaan Ringfietspad
658,Ringfietspad Jan Van Rijswijcklaan,2023-01-23,08:00:00,114,37,77,FMN 11 A Jan Van Rijswijcklaan Ringfietspad
658,Ringfietspad Jan Van Rijswijcklaan,2023-01-23,09:00:00,41,18,23,FMN 11 A Jan Van Rijswijcklaan Ringfietspad
658,Ringfietspad Jan Van Rijswijcklaan,2023-01-23,10:00:00,28,13,15,FMN 11 A Jan Van Rijswijcklaan Ringfietspad
658,Ringfietspad Jan Van Rijswijcklaan,2023-01-23,11:00:00,26,12,14,FMN 11 A Jan Van Rijswijcklaan Ringfietspad
658,Ringfietspad Jan Van Rijswijcklaan,2023-01-23,12:00:00,40,18,22,FMN 11 A Jan Van Rijswijcklaan Ringfietspad
658,Ringfietspad Jan Van Rijswijcklaan,2023-01-23,13:00:00,40,21,19,FMN 11 A Jan Van Rijswijcklaan Ringfietspad
658,Ringfietspad Jan Van Rijswijcklaan,2023-01-23,14:00:00,48,29,19,FMN 11 A Jan Van Rijswijcklaan Ringfietspad
658,Ringfietspad Jan Van Rijswijcklaan,2023-01-23,15:00:00,66,44,22,FMN 11 A Jan Van Rijswijcklaan Ringfietspad
658,Ringfietspad Jan Van Rijswijcklaan,2023-01-23,16:00:00,104,71,33,FMN 11 A Jan Van Rijswijcklaan Ringfietspad
658,Ringfietspad Jan Van Rijswijcklaan,2023-01-23,17:00:00,110,73,37,FMN 11 A Jan Van Rijswijcklaan Ringfietspad
658,Ringfietspad Jan Van Rijswijcklaan,2023-01-23,18:00:00,63,41,22,FMN 11 A Jan Van Rijswijcklaan Ringfietspad
658,Ringfietspad Jan Van Rijswijcklaan,2023-01-23,19:00:00,30,17,13,FMN 11 A Jan Van Rijswijcklaan Ringfietspad
658,Ringfietspad Jan Van Rijswijcklaan,2023-01-23,20:00:00,22,11,11,FMN 11 A Jan Van Rijswijcklaan Ringfietspad
658,Ringfietspad Jan Van Rijswijcklaan,2023-01-23,21:00:00,14,6,8,FMN 11 A Jan Van Rijswijcklaan Ringfietspad
658,Ringfietspad Jan Van Rijswijcklaan,2023-01-23,22:00:00,13,7,6,FMN 11 A Jan Van Rijswijcklaan Ringfietspad
658,Ringfietspad Jan Van Rijswijcklaan,2023-01-23,23:00:00,5,4,1,FMN 11 A Jan Van Rijswijcklaan Ringfietspad
658,Ringfietspad Jan Van Rijswijcklaan,2023-01-24,00:00:00,1,1,0,FMN 11 A Jan Van Rijswijcklaan Ringfietspad
658,Ringfietspad Jan Van Rijswijcklaan,2023-01-24,01:00:00,1,1,0,FMN 11 A Jan Van Rijswijcklaan Ringfietspad
658,Ringfietspad Jan Van Rijswijcklaan,2023-01-24,02:00:00,1,1,0,FMN 11 A Jan Van Rijswijcklaan Ringfietspad
658,Ringfietspad Jan Van Rijswijcklaan,2023-01-24,03:00:00,2,2,0,FMN 11 A Jan Van Rijswijcklaan Ringfietspad
658,Ringfietspad Jan Van Rijswijcklaan,2023-01-24,04:00:00,6,1,5,FMN 11 A Jan Van Rijswijcklaan Ringfietspad
658,Ringfietspad Jan Van Rijswijcklaan,2023-01-24,05:00:00,19,6,13,FMN 11 A Jan Van Rijswijcklaan Ringfietspad
658,Ringfietspad Jan Van Rijswijcklaan,2023-01-24,06:00:00,51,13,38,FMN 11 A Jan Van Rijswijcklaan Ringfietspad
658,Ringfietspad Jan Van Rijswijcklaan,2023-01-24,07:00:00,100,35,65,FMN 11 A Jan Van Rijswijcklaan Ringfietspad
658,Ringfietspad Jan Van Rijswijcklaan,2023-01-24,08:00:00,129,42,87,FMN 11 A Jan Van Rijswijcklaan Ringfietspad
658,Ringfietspad Jan Van Rijswijcklaan,2023-01-24,09:00:00,48,16,32,FMN 11 A Jan Van Rijswijcklaan Ringfietspad
658,Ringfietspad Jan Van Rijswijcklaan,2023-01-24,10:00:00,31,14,17,FMN 11 A Jan Van Rijswijcklaan Ringfietspad
658,Ringfietspad Jan Van Rijswijcklaan,2023-01-24,11:00:00,29,15,14,FMN 11 A Jan Van Rijswijcklaan Ringfietspad
658,Ringfietspad Jan Van Rijswijcklaan,2023-01-24,12:00:00,41,19,22,FMN 11 A Jan Van Rijswijcklaan Ringfietspad
658,Ringfietspad Jan Van Rijswijcklaan,2023-01-24,13:00:00,44,21,23,FMN 11 A Jan Van Rijswijcklaan Ringfietspad
658,Ringfietspad Jan Van Rijswijcklaan,2023-01-24,14:00:00,47,28,19,FMN 11 A Jan Van Rijswijcklaan Ringfietspad
658,Ringfietspad Jan Van Rijswijcklaan,2023-01-24,15:00:00,72,47,25,FMN 11 A Jan Van Rijswijcklaan Ringfietspad
658,Ringfietspad Jan Van Rijswijcklaan,2023-01-24,16:00:00,116,80,36,FMN 11 A Jan Van Rijswijcklaan Ringfietspad
658,Ringfietspad Jan Van Rijswijcklaan,2023-01-24,17:00:00,124,82,42,FMN 11 A Jan Van Rijswijcklaan Ringfietspad
658,Ringfietspad Jan Van Rijswijcklaan,2023-01-24,18:00:00,76,47,29,FMN 11 A Jan Van Rijswijcklaan Ringfietspad
658,Ringfietspad Jan Van Rijswijcklaan,2023-01-24,19:00:00,32,18,14,FMN 11 A Jan Van Rijswijcklaan Ringfietspad
658,Ringfietspad Jan Van Rijswijcklaan,2023-01-24,20:00:00,25,12,13,FMN 11 A Jan Van Rijswijcklaan Ringfietspad
658,Ringfietspad Jan Van Rijswijcklaan,2023-01-24,21:00:00,15,9,6,FMN 11 A Jan Van Rijswijcklaan Ringfietspad
658,Ringfietspad Jan Van Rijswijcklaan,2023-01-24,22:00:00,15,10,5,FMN 11 A Jan Van Rijswijcklaan Ringfietspad
658,Ringfietspad Jan Van Rijswijcklaan,2023-01-24,23:00:00,6,3,3,FMN 11 A Jan Van Rijswijcklaan Ringfietspad
658,Ringfietspad Jan Van Rijswijcklaan,2023-01-25,00:00:00,2,1,1,FMN 11 A Jan Van Rijswijcklaan Ringfietspad
658,Ringfietspad Jan Van Rijswijcklaan,2023-01-25,01:00:00,1,0,1,FMN 11 A Jan Van Rijswijcklaan Ringfietspad
658,Ringfietspad Jan Van Rijswijcklaan,2023-01-25,02:00:00,1,1,0,FMN 11 A Jan Van Rijswijcklaan Ringfietspad
658,Ringfietspad Jan Van Rijswijcklaan,2023-01-25,03:00:00,1,1,0,FMN 11 A Jan Van Rijswijcklaan Ringfietspad
658,Ringfietspad Jan Van Rijswijcklaan,2023-01-25,04:00:00,5,3,2,FMN 11 A Jan Van Rijswijcklaan Ringfietspad
658,Ringfietspad Jan Van Rijswijcklaan,2023-01-25,05:00:00,19,3,16,FMN 11 A Jan Van Rijswijcklaan Ringfietspad
658,Ringfietspad Jan Van Rijswijcklaan,2023-01-25,06:00:00,46,13,33,FMN 11 A Jan Van Rijswijcklaan Ringfietspad
658,Ringfietspad Jan Van Rijswijcklaan,2023-01-25,07:00:00,87,31,56,FMN 11 A Jan Van Rijswijcklaan Ringfietspad
658,Ringfietspad Jan Van Rijswijcklaan,2023-01-25,08:00:00,103,33,70,FMN 11 A Jan Van Rijswijcklaan Ringfietspad
658,Ringfietspad Jan Van Rijswijcklaan,2023-01-25,09:00:00,40,15,25,FMN 11 A Jan Van Rijswijcklaan Ringfietspad
658,Ringfietspad Jan Van Rijswijcklaan,2023-01-25,10:00:00,28,13,15,FMN 11 A Jan Van Rijswijcklaan Ringfietspad
658,Ringfietspad Jan Van Rijswijcklaan,2023-01-25,11:00:00,30,16,14,FMN 11 A Jan Van Rijswijcklaan Ringfietspad
658,Ringfietspad Jan Van Rijswijcklaan,2023-01-25,12:00:00,47,23,24,FMN 11 A Jan Van Rijswijcklaan Ringfietspad
658,Ringfietspad Jan Van Rijswijcklaan,2023-01-25,13:00:00,45,21,24,FMN 11 A Jan Van Rijswijcklaan Ringfietspad
658,Ringfietspad Jan Van Rijswijcklaan,2023-01-25,14:00:00,49,26,23,FMN 11 A Jan Van Rijswijcklaan Ringfietspad
658,Ringfietspad Jan Van Rijswijcklaan,2023-01-25,15:00:00,62,40,22,FMN 11 A Jan Van Rijswijcklaan Ringfietspad
658,Ringfietspad Jan Van Rijswijcklaan,2023-01-25,16:00:00,97,66,31,FMN 11 A Jan Van Rijswijcklaan Ringfietspad
658,Ringfietspad Jan Van Rijswijcklaan,2023-01-25,17:00:00,106,68,38,FMN 11 A Jan Van Rijswijcklaan Ringfietspad
658,Ringfietspad Jan Van Rijswijcklaan,2023-01-25,18:00:00,63,39,24,FMN 11 A Jan Van Rijswijcklaan Ringfietspad
658,Ringfietspad Jan Van Rijswijcklaan,2023-01-25,19:00:00,34,17,17,FMN 11 A Jan Van Rijswijcklaan Ringfietspad
658,Ringfietspad Jan Van Rijswijcklaan,2023-01-25,20:00:00,23,13,10,FMN 11 A Jan Van Rijswijcklaan Ringfietspad
658,Ringfietspad Jan Van Rijswijcklaan,2023-01-25,21:00:00,16,7,9,FMN 11 A Jan Van Rijswijcklaan Ringfietspad
658,Ringfietspad Jan Van Rijswijcklaan,2023-01-25,22:00:00,15,7,8,FMN 11 A Jan Van Rijswijcklaan Ringfietspad
658,Ringfietspad Jan Van Rijswijcklaan,2023-01-25,23:00:00,5,2,3,FMN 11 A Jan Van Rijswijcklaan Ringfietspad
658,Ringfietspad Jan Van Rijswijcklaan,2023-01-26,00:00:00,2,2,0,FMN 11 A Jan Van Rijswijcklaan Ringfietspad
658,Ringfietspad Jan Van Rijswijcklaan,2023-01-26,01:00:00,1,0,1,FMN 11 A Jan Van Rijswijcklaan Ringfietspad
658,Ringfietspad Jan Van Rijswijcklaan,2023-01-26,02:00:00,1,1,0,FMN 11 A Jan Van Rijswijcklaan Ringfietspad
658,Ringfietspad Jan Van Rijswijcklaan,2023-01-26,03:00:00,2,2,0,FMN 11 A Jan Van Rijswijcklaan Ringfietspad
658,Ringfietspad Jan Van Rijswijcklaan,2023-01-26,04:00:00,5,2,3,FMN 11 A Jan Van Rijswijcklaan Ringfietspad
658,Ringfietspad Jan Van Rijswijcklaan,2023-01-26,05:00:00,18,4,14,FMN 11 A Jan Van Rijswijcklaan Ringfietspad
658,Ringfietspad Jan Van Rijswijcklaan,2023-01-26,06:00:00,44,10,34,FMN 11 A Jan Van Rijswijcklaan Ringfietspad
658,Ringfietspad Jan Van Rijswijcklaan,2023-01-26,07:00:00,85,27,58,FMN 11 A Jan Van Rijswijcklaan Ringfietspad
658,Ringfietspad Jan Van Rijswijcklaan,2023-01-26,08:00:00,115,38,77,FMN 11 A Jan Van Rijswijcklaan Ringfietspad
658,Ringfietspad Jan Van Rijswijcklaan,2023-01-26,09:00:00,45,15,30,FMN 11 A Jan Van Rijswijcklaan Ringfietspad
658,Ringfietspad Jan Van Rijswijcklaan,2023-01-26,10:00:00,29,13,16,FMN 11 A Jan Van Rijswijcklaan Ringfietspad
658,Ringfietspad Jan Van Rijswijcklaan,2023-01-26,11:00:00,29,14,15,FMN 11 A Jan Van Rijswijcklaan Ringfietspad
658,Ringfietspad Jan Van Rijswijcklaan,2023-01-26,12:00:00,41,20,21,FMN 11 A Jan Van Rijswijcklaan Ringfietspad
658,Ringfietspad Jan Van Rijswijcklaan,2023-01-26,13:00:00,42,24,18,FMN 11 A Jan Van Rijswijcklaan Ringfietspad
658,Ringfietspad Jan Van Rijswijcklaan,2023-01-26,14:00:00,48,25,23,FMN 11 A Jan Van Rijswijcklaan Ringfietspad
658,Ringfietspad Jan Van Rijswijcklaan,2023-01-26,15:00:00,67,44,23,FMN 11 A Jan Van Rijswijcklaan Ringfietspad
658,Ringfietspad Jan Van Rijswijcklaan,2023-01-26,16:00:00,101,67,34,FMN 11 A Jan Van Rijswijcklaan Ringfietspad
658,Ringfietspad Jan Van Rijswijcklaan,2023-01-26,17:00:00,104,69,35,FMN 11 A Jan Van Rijswijcklaan Ringfietspad
658,Ringfietspad Jan Van Rijswijcklaan,2023-01-26,18:00:00,65,40,25,FMN 11 A Jan Van Rijswijcklaan Ringfietspad
658,Ringfietspad Jan Van Rijswijcklaan,2023-01-26,19:00:00,34,15,19,FMN 11 A Jan Van Rijswijcklaan Ringfietspad
658,Ringfietspad Jan Van Rijswijcklaan,2023-01-26,20:00:00,23,11,12,FMN 11 A Jan Van Rijswijcklaan Ringfietspad
658,Ringfietspad Jan Van Rijswijcklaan,2023-01-26,21:00:00,16,7,9,FMN 11 A Jan Van Rijswijcklaan Ringfietspad
658,Ringfietspad Jan Van Rijswijcklaan,2023-01-26,22:00:00,14,10,4,FMN 11 A Jan Van Rijswijcklaan Ringfietspad
658,Ringfietspad Jan Van Rijswijcklaan,2023-01-26,23:00:00,7,3,4,FMN 11 A Jan Van Rijswijcklaan Ringfietspad
658,Ringfietspad Jan Van Rijswijcklaan,2023-01-27,00:00:00,3,3,0,FMN 11 A Jan Van Rijswijcklaan Ringfietspad
658,Ringfietspad Jan Van Rijswijcklaan,2023-01-27,01:00:00,2,0,2,FMN 11 A Jan Van Rijswijcklaan Ringfietspad
658,Ringfietspad Jan Van Rijswijcklaan,2023-01-27,02:00:00,1,1,0,FMN 11 A Jan Van Rijswijcklaan Ringfietspad
658,Ringfietspad Jan Van Rijswijcklaan,2023-01-27,03:00:00,2,2,0,FMN 11 A Jan Van Rijswijcklaan Ringfietspad
658,Ringfietspad Jan Van Rijswijcklaan,2023-01-27,04:00:00,5,2,3,FMN 11 A Jan Van Rijswijcklaan Ringfietspad
658,Ringfietspad Jan Van Rijswijcklaan,2023-01-27,05:00:00,15,6,9,FMN 11 A Jan Van Rijswijcklaan Ringfietspad
658,Ringfietspad Jan Van Rijswijcklaan,2023-01-27,06:00:00,40,14,26,FMN 11 A Jan Van Rijswijcklaan Ringfietspad
658,Ringfietspad Jan Van Rijswijcklaan,2023-01-27,07:00:00,78,26,52,FMN 11 A Jan Van Rijswijcklaan Ringfietspad
658,Ringfietspad Jan Van Rijswijcklaan,2023-01-27,08:00:00,109,35,74,FMN 11 A Jan Van Rijswijcklaan Ringfietspad
658,Ringfietspad Jan Van Rijswijcklaan,2023-01-27,09:00:00,45,19,26,FMN 11 A Jan Van Rijswijcklaan Ringfietspad
658,Ringfietspad Jan Van Rijswijcklaan,2023-01-27,10:00:00,33,15,18,FMN 11 A Jan Van Rijswijcklaan Ringfietspad
658,Ringfietspad Jan Van Rijswijcklaan,2023-01-27,11:00:00,32,15,17,FMN 11 A Jan Van Rijswijcklaan Ringfietspad
658,Ringfietspad Jan Van Rijswijcklaan,2023-01-27,12:00:00,45,26,19,FMN 11 A Jan Van Rijswijcklaan Ringfietspad
658,Ringfietspad Jan Van Rijswijcklaan,2023-01-27,13:00:00,45,23,22,FMN 11 A Jan Van Rijswijcklaan Ringfietspad
658,Ringfietspad Jan Van Rijswijcklaan,2023-01-27,14:00:00,54,30,24,FMN 11 A Jan Van Rijswijcklaan Ringfietspad
658,Ringfietspad Jan Van Rijswijcklaan,2023-01-27,15:00:00,76,50,26,FMN 11 A Jan Van Rijswijcklaan Ringfietspad
658,Ringfietspad Jan Van Rijswijcklaan,2023-01-27,16:00:00,101,67,34,FMN 11 A Jan Van Rijswijcklaan Ringfietspad
658,Ringfietspad Jan Van Rijswijcklaan,2023-01-27,17:00:00,85,56,29,FMN 11 A Jan Van Rijswijcklaan Ringfietspad
658,Ringfietspad Jan Van Rijswijcklaan,2023-01-27,18:00:00,53,30,23,FMN 11 A Jan Van Rijswijcklaan Ringfietspad
658,Ringfietspad Jan Van Rijswijcklaan,2023-01-27,19:00:00,33,17,16,FMN 11 A Jan Van Rijswijcklaan Ringfietspad
658,Ringfietspad Jan Van Rijswijcklaan,2023-01-27,20:00:00,21,11,10,FMN 11 A Jan Van Rijswijcklaan Ringfietspad
658,Ringfietspad Jan Van Rijswijcklaan,2023-01-27,21:00:00,14,8,6,FMN 11 A Jan Van Rijswijcklaan Ringfietspad
658,Ringfietspad Jan Van Rijswijcklaan,2023-01-27,22:00:00,13,5,8,FMN 11 A Jan Van Rijswijcklaan Ringfietspad
658,Ringfietspad Jan Van Rijswijcklaan,2023-01-27,23:00:00,8,5,3,FMN 11 A Jan Van Rijswijcklaan Ringfietspad
658,Ringfietspad Jan Van Rijswijcklaan,2023-01-28,00:00:00,5,3,2,FMN 11 A Jan Van Rijswijcklaan Ringfietspad
658,Ringfietspad Jan Van Rijswijcklaan,2023-01-28,01:00:00,4,3,1,FMN 11 A Jan Van Rijswijcklaan Ringfietspad
658,Ringfietspad Jan Van Rijswijcklaan,2023-01-28,02:00:00,2,1,1,FMN 11 A Jan Van Rijswijcklaan Ringfietspad
658,Ringfietspad Jan Van Rijswijcklaan,2023-01-28,03:00:00,2,1,1,FMN 11 A Jan Van Rijswijcklaan Ringfietspad
658,Ringfietspad Jan Van Rijswijcklaan,2023-01-28,04:00:00,4,2,2,FMN 11 A Jan Van Rijswijcklaan Ringfietspad
658,Ringfietspad Jan Van Rijswijcklaan,2023-01-28,05:00:00,3,2,1,FMN 11 A Jan Van Rijswijcklaan Ringfietspad
658,Ringfietspad Jan Van Rijswijcklaan,2023-01-28,06:00:00,8,4,4,FMN 11 A Jan Van Rijswijcklaan Ringfietspad
658,Ringfietspad Jan Van Rijswijcklaan,2023-01-28,07:00:00,8,4,4,FMN 11 A Jan Van Rijswijcklaan Ringfietspad
658,Ringfietspad Jan Van Rijswijcklaan,2023-01-28,08:00:00,15,6,9,FMN 11 A Jan Van Rijswijcklaan Ringfietspad
658,Ringfietspad Jan Van Rijswijcklaan,2023-01-28,09:00:00,29,12,17,FMN 11 A Jan Van Rijswijcklaan Ringfietspad
658,Ringfietspad Jan Van Rijswijcklaan,2023-01-28,10:00:00,34,14,20,FMN 11 A Jan Van Rijswijcklaan Ringfietspad
658,Ringfietspad Jan Van Rijswijcklaan,2023-01-28,11:00:00,37,17,20,FMN 11 A Jan Van Rijswijcklaan Ringfietspad
658,Ringfietspad Jan Van Rijswijcklaan,2023-01-28,12:00:00,40,20,20,FMN 11 A Jan Van Rijswijcklaan Ringfietspad
658,Ringfietspad Jan Van Rijswijcklaan,2023-01-28,13:00:00,50,26,24,FMN 11 A Jan Van Rijswijcklaan Ringfietspad
658,Ringfietspad Jan Van Rijswijcklaan,2023-01-28,14:00:00,58,28,30,FMN 11 A Jan Van Rijswijcklaan Ringfietspad
658,Ringfietspad Jan Van Rijswijcklaan,2023-01-28,15:00:00,55,31,24,FMN 11 A Jan Van Rijswijcklaan Ringfietspad
658,Ringfietspad Jan Van Rijswijcklaan,2023-01-28,16:00:00,50,32,18,FMN 11 A Jan Van Rijswijcklaan Ringfietspad
658,Ringfietspad Jan Van Rijswijcklaan,2023-01-28,17:00:00,38,23,15,FMN 11 A Jan Van Rijswijcklaan Ringfietspad
658,Ringfietspad Jan Van Rijswijcklaan,2023-01-28,18:00:00,30,19,11,FMN 11 A Jan Van Rijswijcklaan Ringfietspad
658,Ringfietspad Jan Van Rijswijcklaan,2023-01-28,19:00:00,22,12,10,FMN 11 A Jan Van Rijswijcklaan Ringfietspad
658,Ringfietspad Jan Van Rijswijcklaan,2023-01-28,20:00:00,16,7,9,FMN 11 A Jan Van Rijswijcklaan Ringfietspad
658,Ringfietspad Jan Van Rijswijcklaan,2023-01-28,21:00:00,12,10,2,FMN 11 A Jan Van Rijswijcklaan Ringfietspad
658,Ringfietspad Jan Van Rijswijcklaan,2023-01-28,22:00:00,9,6,3,FMN 11 A Jan Van Rijswijcklaan Ringfietspad
658,Ringfietspad Jan Van Rijswijcklaan,2023-01-28,23:00:00,6,4,2,FMN 11 A Jan Van Rijswijcklaan Ringfietspad
658,Ringfietspad Jan Van Rijswijcklaan,2023-01-29,00:00:00,2,2,0,FMN 11 A Jan Van Rijswijcklaan Ringfietspad
658,Ringfietspad Jan Van Rijswijcklaan,2023-01-29,01:00:00,2,0,2,FMN 11 A Jan Van Rijswijcklaan Ringfietspad
658,Ringfietspad Jan Van Rijswijcklaan,2023-01-29,02:00:00,1,1,0,FMN 11 A Jan Van Rijswijcklaan Ringfietspad
658,Ringfietspad Jan Van Rijswijcklaan,2023-01-29,03:00:00,1,1,0,FMN 11 A Jan Van Rijswijcklaan Ringfietspad
658,Ringfietspad Jan Van Rijswijcklaan,2023-01-29,04:00:00,1,1,0,FMN 11 A Jan Van Rijswijcklaan Ringfietspad
658,Ringfietspad Jan Van Rijswijcklaan,2023-01-29,05:00:00,1,1,0,FMN 11 A Jan Van Rijswijcklaan Ringfietspad
658,Ringfietspad Jan Van Rijswijcklaan,2023-01-29,06:00:00,2,2,0,FMN 11 A Jan Van Rijswijcklaan Ringfietspad
658,Ringfietspad Jan Van Rijswijcklaan,2023-01-29,07:00:00,4,2,2,FMN 11 A Jan Van Rijswijcklaan Ringfietspad
658,Ringfietspad Jan Van Rijswijcklaan,2023-01-29,08:00:00,9,3,6,FMN 11 A Jan Van Rijswijcklaan Ringfietspad
658,Ringfietspad Jan Van Rijswijcklaan,2023-01-29,09:00:00,19,6,13,FMN 11 A Jan Van Rijswijcklaan Ringfietspad
658,Ringfietspad Jan Van Rijswijcklaan,2023-01-29,10:00:00,25,11,14,FMN 11 A Jan Van Rijswijcklaan Ringfietspad
658,Ringfietspad Jan Van Rijswijcklaan,2023-01-29,11:00:00,27,12,15,FMN 11 A Jan Van Rijswijcklaan Ringfietspad
658,Ringfietspad Jan Van Rijswijcklaan,2023-01-29,12:00:00,31,16,15,FMN 11 A Jan Van Rijswijcklaan Ringfietspad
658,Ringfietspad Jan Van Rijswijcklaan,2023-01-29,13:00:00,35,17,18,FMN 11 A Jan Van Rijswijcklaan Ringfietspad
658,Ringfietspad Jan Van Rijswijcklaan,2023-01-29,14:00:00,38,19,19,FMN 11 A Jan Van Rijswijcklaan Ringfietspad
658,Ringfietspad Jan Van Rijswijcklaan,2023-01-29,15:00:00,37,21,16,FMN 11 A Jan Van Rijswijcklaan Ringfietspad
658,Ringfietspad Jan Van Rijswijcklaan,2023-01-29,16:00:00,29,17,12,FMN 11 A Jan Van Rijswijcklaan Ringfietspad
658,Ringfietspad Jan Van Rijswijcklaan,2023-01-29,17:00:00,25,19,6,FMN 11 A Jan Van Rijswijcklaan Ringfietspad
658,Ringfietspad Jan Van Rijswijcklaan,2023-01-29,18:00:00,16,10,6,FMN 11 A Jan Van Rijswijcklaan Ringfietspad
658,Ringfietspad Jan Van Rijswijcklaan,2023-01-29,19:00:00,11,9,2,FMN 11 A Jan Van Rijswijcklaan Ringfietspad
658,Ringfietspad Jan Van Rijswijcklaan,2023-01-29,20:00:00,9,3,6,FMN 11 A Jan Van Rijswijcklaan Ringfietspad
658,Ringfietspad Jan Van Rijswijcklaan,2023-01-29,21:00:00,6,5,1,FMN 11 A Jan Van Rijswijcklaan Ringfietspad
658,Ringfietspad Jan Van Rijswijcklaan,2023-01-29,22:00:00,4,2,2,FMN 11 A Jan Van Rijswijcklaan Ringfietspad
658,Ringfietspad Jan Van Rijswijcklaan,2023-01-29,23:00:00,1,0,1,FMN 11 A Jan Van Rijswijcklaan Ringfietspad
658,Ringfietspad Jan Van Rijswijcklaan,2023-01-30,00:00:00,2,2,0,FMN 11 A Jan Van Rijswijcklaan Ringfietspad
658,Ringfietspad Jan Van Rijswijcklaan,2023-01-30,01:00:00,0,0,0,FMN 11 A Jan Van Rijswijcklaan Ringfietspad
658,Ringfietspad Jan Van Rijswijcklaan,2023-01-30,02:00:00,1,1,0,FMN 11 A Jan Van Rijswijcklaan Ringfietspad
658,Ringfietspad Jan Van Rijswijcklaan,2023-01-30,03:00:00,2,2,0,FMN 11 A Jan Van Rijswijcklaan Ringfietspad
658,Ringfietspad Jan Van Rijswijcklaan,2023-01-30,04:00:00,6,3,3,FMN 11 A Jan Van Rijswijcklaan Ringfietspad
658,Ringfietspad Jan Van Rijswijcklaan,2023-01-30,05:00:00,17,4,13,FMN 11 A Jan Van Rijswijcklaan Ringfietspad
658,Ringfietspad Jan Van Rijswijcklaan,2023-01-30,06:00:00,46,10,36,FMN 11 A Jan Van Rijswijcklaan Ringfietspad
658,Ringfietspad Jan Van Rijswijcklaan,2023-01-30,07:00:00,93,33,60,FMN 11 A Jan Van Rijswijcklaan Ringfietspad
658,Ringfietspad Jan Van Rijswijcklaan,2023-01-30,08:00:00,122,39,83,FMN 11 A Jan Van Rijswijcklaan Ringfietspad
658,Ringfietspad Jan Van Rijswijcklaan,2023-01-30,09:00:00,44,15,29,FMN 11 A Jan Van Rijswijcklaan Ringfietspad
658,Ringfietspad Jan Van Rijswijcklaan,2023-01-30,10:00:00,30,14,16,FMN 11 A Jan Van Rijswijcklaan Ringfietspad
658,Ringfietspad Jan Van Rijswijcklaan,2023-01-30,11:00:00,28,13,15,FMN 11 A Jan Van Rijswijcklaan Ringfietspad
658,Ringfietspad Jan Van Rijswijcklaan,2023-01-30,12:00:00,42,21,21,FMN 11 A Jan Van Rijswijcklaan Ringfietspad
658,Ringfietspad Jan Van Rijswijcklaan,2023-01-30,13:00:00,44,22,22,FMN 11 A Jan Van Rijswijcklaan Ringfietspad
658,Ringfietspad Jan Van Rijswijcklaan,2023-01-30,14:00:00,51,27,24,FMN 11 A Jan Van Rijswijcklaan Ringfietspad
658,Ringfietspad Jan Van Rijswijcklaan,2023-01-30,15:00:00,71,46,25,FMN 11 A Jan Van Rijswijcklaan Ringfietspad
658,Ringfietspad Jan Van Rijswijcklaan,2023-01-30,16:00:00,111,76,35,FMN 11 A Jan Van Rijswijcklaan Ringfietspad
658,Ringfietspad Jan Van Rijswijcklaan,2023-01-30,17:00:00,117,77,40,FMN 11 A Jan Van Rijswijcklaan Ringfietspad
658,Ringfietspad Jan Van Rijswijcklaan,2023-01-30,18:00:00,68,41,27,FMN 11 A Jan Van Rijswijcklaan Ringfietspad
658,Ringfietspad Jan Van Rijswijcklaan,2023-01-30,19:00:00,33,19,14,FMN 11 A Jan Van Rijswijcklaan Ringfietspad
658,Ringfietspad Jan Van Rijswijcklaan,2023-01-30,20:00:00,23,10,13,FMN 11 A Jan Van Rijswijcklaan Ringfietspad
658,Ringfietspad Jan Van Rijswijcklaan,2023-01-30,21:00:00,15,8,7,FMN 11 A Jan Van Rijswijcklaan Ringfietspad
658,Ringfietspad Jan Van Rijswijcklaan,2023-01-30,22:00:00,14,9,5,FMN 11 A Jan Van Rijswijcklaan Ringfietspad
658,Ringfietspad Jan Van Rijswijcklaan,2023-01-30,23:00:00,5,4,1,FMN 11 A Jan Van Rijswijcklaan Ringfietspad
658,Ringfietspad Jan Van Rijswijcklaan,2023-01-31,00:00:00,1,1,0,FMN 11 A Jan Van Rijswijcklaan Ringfietspad
658,Ringfietspad Jan Van Rijswijcklaan,2023-01-31,01:00:00,1,0,1,FMN 11 A Jan Van Rijswijcklaan Ringfietspad
658,Ringfietspad Jan Van Rijswijcklaan,2023-01-31,02:00:00,1,0,1,FMN 11 A Jan Van Rijswijcklaan Ringfietspad
658,Ringfietspad Jan Van Rijswijcklaan,2023-01-31,03:00:00,2,1,1,FMN 11 A Jan Van Rijswijcklaan Ringfietspad
658,Ringfietspad Jan Van Rijswijcklaan,2023-01-31,04:00:00,6,2,4,FMN 11 A Jan Van Rijswijcklaan Ringfietspad
658,Ringfietspad Jan Van Rijswijcklaan,2023-01-31,05:00:00,20,8,12,FMN 11 A Jan Van Rijswijcklaan Ringfietspad
658,Ringfietspad Jan Van Rijswijcklaan,2023-01-31,06:00:00,51,11,40,FMN 11 A Jan Van Rijswijcklaan Ringfietspad
658,Ringfietspad Jan Van Rijswijcklaan,2023-01-31,07:00:00,102,36,66,FMN 11 A Jan Van Rijswijcklaan Ringfietspad
658,Ringfietspad Jan Van Rijswijcklaan,2023-01-31,08:00:00,131,41,90,FMN 11 A Jan Van Rijswijcklaan Ringfietspad
658,Ringfietspad Jan Van Rijswijcklaan,2023-01-31,09:00:00,48,17,31,FMN 11 A Jan Van Rijswijcklaan Ringfietspad
658,Ringfietspad Jan Van Rijswijcklaan,2023-01-31,10:00:00,32,15,17,FMN 11 A Jan Van Rijswijcklaan Ringfietspad
658,Ringfietspad Jan Van Rijswijcklaan,2023-01-31,11:00:00,29,14,15,FMN 11 A Jan Van Rijswijcklaan Ringfietspad
658,Ringfietspad Jan Van Rijswijcklaan,2023-01-31,12:00:00,42,21,21,FMN 11 A Jan Van Rijswijcklaan Ringfietspad
658,Ringfietspad Jan Van Rijswijcklaan,2023-01-31,13:00:00,45,25,20,FMN 11 A Jan Van Rijswijcklaan Ringfietspad
658,Ringfietspad Jan Van Rijswijcklaan,2023-01-31,14:00:00,48,25,23,FMN 11 A Jan Van Rijswijcklaan Ringfietspad
658,Ringfietspad Jan Van Rijswijcklaan,2023-01-31,15:00:00,72,48,24,FMN 11 A Jan Van Rijswijcklaan Ringfietspad
658,Ringfietspad Jan Van Rijswijcklaan,2023-01-31,16:00:00,119,81,38,FMN 11 A Jan Van Rijswijcklaan Ringfietspad
658,Ringfietspad Jan Van Rijswijcklaan,2023-01-31,17:00:00,126,82,44,FMN 11 A Jan Van Rijswijcklaan Ringfietspad
658,Ringfietspad Jan Van Rijswijcklaan,2023-01-31,18:00:00,76,46,30,FMN 11 A Jan Van Rijswijcklaan Ringfietspad
658,Ringfietspad Jan Van Rijswijcklaan,2023-01-31,19:00:00,33,19,14,FMN 11 A Jan Van Rijswijcklaan Ringfietspad
658,Ringfietspad Jan Van Rijswijcklaan,2023-01-31,20:00:00,25,10,15,FMN 11 A Jan Van Rijswijcklaan Ringfietspad
658,Ringfietspad Jan Van Rijswijcklaan,2023-01-31,21:00:00,16,6,10,FMN 11 A Jan Van Rijswijcklaan Ringfietspad
658,Ringfietspad Jan Van Rijswijcklaan,2023-01-31,22:00:00,15,11,4,FMN 11 A Jan Van Rijswijcklaan Ringfietspad
658,Ringfietspad Jan Van Rijswijcklaan,2023-01-31,23:00:00,6,3,3,FMN 11 A Jan Van Rijswijcklaan Ringfietspad
658,Ringfietspad Jan Van Rijswijcklaan,2023-02-01,00:00:00,1,0,1,FMN 11 A Jan Van Rijswijcklaan Ringfietspad
658,Ringfietspad Jan Van Rijswijcklaan,2023-02-01,01:00:00,0,0,0,FMN 11 A Jan Van Rijswijcklaan Ringfietspad
658,Ringfietspad Jan Van Rijswijcklaan,2023-02-01,02:00:00,0,0,0,FMN 11 A Jan Van Rijswijcklaan Ringfietspad
658,Ringfietspad Jan Van Rijswijcklaan,2023-02-01,03:00:00,1,1,0,FMN 11 A Jan Van Rijswijcklaan Ringfietspad
658,Ringfietspad Jan Van Rijswijcklaan,2023-02-01,04:00:00,7,3,4,FMN 11 A Jan Van Rijswijcklaan Ringfietspad
658,Ringfietspad Jan Van Rijswijcklaan,2023-02-01,05:00:00,22,8,14,FMN 11 A Jan Van Rijswijcklaan Ringfietspad
658,Ringfietspad Jan Van Rijswijcklaan,2023-02-01,06:00:00,54,12,42,FMN 11 A Jan Van Rijswijcklaan Ringfietspad
658,Ringfietspad Jan Van Rijswijcklaan,2023-02-01,07:00:00,82,33,49,FMN 11 A Jan Van Rijswijcklaan Ringfietspad
658,Ringfietspad Jan Van Rijswijcklaan,2023-02-01,08:00:00,116,40,76,FMN 11 A Jan Van Rijswijcklaan Ringfietspad
658,Ringfietspad Jan Van Rijswijcklaan,2023-02-01,09:00:00,44,19,25,FMN 11 A Jan Van Rijswijcklaan Ringfietspad
658,Ringfietspad Jan Van Rijswijcklaan,2023-02-01,10:00:00,30,15,15,FMN 11 A Jan Van Rijswijcklaan Ringfietspad
658,Ringfietspad Jan Van Rijswijcklaan,2023-02-01,11:00:00,44,23,21,FMN 11 A Jan Van Rijswijcklaan Ringfietspad
658,Ringfietspad Jan Van Rijswijcklaan,2023-02-01,12:00:00,53,28,25,FMN 11 A Jan Van Rijswijcklaan Ringfietspad
658,Ringfietspad Jan Van Rijswijcklaan,2023-02-01,13:00:00,53,24,29,FMN 11 A Jan Van Rijswijcklaan Ringfietspad
658,Ringfietspad Jan Van Rijswijcklaan,2023-02-01,14:00:00,64,31,33,FMN 11 A Jan Van Rijswijcklaan Ringfietspad
658,Ringfietspad Jan Van Rijswijcklaan,2023-02-01,15:00:00,78,48,30,FMN 11 A Jan Van Rijswijcklaan Ringfietspad
658,Ringfietspad Jan Van Rijswijcklaan,2023-02-01,16:00:00,99,72,27,FMN 11 A Jan Van Rijswijcklaan Ringfietspad
658,Ringfietspad Jan Van Rijswijcklaan,2023-02-01,17:00:00,116,74,42,FMN 11 A Jan Van Rijswijcklaan Ringfietspad
658,Ringfietspad Jan Van Rijswijcklaan,2023-02-01,18:00:00,67,40,27,FMN 11 A Jan Van Rijswijcklaan Ringfietspad
658,Ringfietspad Jan Van Rijswijcklaan,2023-02-01,19:00:00,44,19,25,FMN 11 A Jan Van Rijswijcklaan Ringfietspad
658,Ringfietspad Jan Van Rijswijcklaan,2023-02-01,20:00:00,27,14,13,FMN 11 A Jan Van Rijswijcklaan Ringfietspad
658,Ringfietspad Jan Van Rijswijcklaan,2023-02-01,21:00:00,17,9,8,FMN 11 A Jan Van Rijswijcklaan Ringfietspad
658,Ringfietspad Jan Van Rijswijcklaan,2023-02-01,22:00:00,16,7,9,FMN 11 A Jan Van Rijswijcklaan Ringfietspad
658,Ringfietspad Jan Van Rijswijcklaan,2023-02-01,23:00:00,6,4,2,FMN 11 A Jan Van Rijswijcklaan Ringfietspad
658,Ringfietspad Jan Van Rijswijcklaan,2023-02-02,00:00:00,10,6,4,FMN 11 A Jan Van Rijswijcklaan Ringfietspad
658,Ringfietspad Jan Van Rijswijcklaan,2023-02-02,01:00:00,1,1,0,FMN 11 A Jan Van Rijswijcklaan Ringfietspad
658,Ringfietspad Jan Van Rijswijcklaan,2023-02-02,02:00:00,1,0,1,FMN 11 A Jan Van Rijswijcklaan Ringfietspad
658,Ringfietspad Jan Van Rijswijcklaan,2023-02-02,03:00:00,2,1,1,FMN 11 A Jan Van Rijswijcklaan Ringfietspad
658,Ringfietspad Jan Van Rijswijcklaan,2023-02-02,04:00:00,9,2,7,FMN 11 A Jan Van Rijswijcklaan Ringfietspad
658,Ringfietspad Jan Van Rijswijcklaan,2023-02-02,05:00:00,22,6,16,FMN 11 A Jan Van Rijswijcklaan Ringfietspad
658,Ringfietspad Jan Van Rijswijcklaan,2023-02-02,06:00:00,59,18,41,FMN 11 A Jan Van Rijswijcklaan Ringfietspad
658,Ringfietspad Jan Van Rijswijcklaan,2023-02-02,07:00:00,99,33,66,FMN 11 A Jan Van Rijswijcklaan Ringfietspad
658,Ringfietspad Jan Van Rijswijcklaan,2023-02-02,08:00:00,138,47,91,FMN 11 A Jan Van Rijswijcklaan Ringfietspad
658,Ringfietspad Jan Van Rijswijcklaan,2023-02-02,09:00:00,54,19,35,FMN 11 A Jan Van Rijswijcklaan Ringfietspad
658,Ringfietspad Jan Van Rijswijcklaan,2023-02-02,10:00:00,23,8,15,FMN 11 A Jan Van Rijswijcklaan Ringfietspad
658,Ringfietspad Jan Van Rijswijcklaan,2023-02-02,11:00:00,39,19,20,FMN 11 A Jan Van Rijswijcklaan Ringfietspad
658,Ringfietspad Jan Van Rijswijcklaan,2023-02-02,12:00:00,45,23,22,FMN 11 A Jan Van Rijswijcklaan Ringfietspad
658,Ringfietspad Jan Van Rijswijcklaan,2023-02-02,13:00:00,48,27,21,FMN 11 A Jan Van Rijswijcklaan Ringfietspad
658,Ringfietspad Jan Van Rijswijcklaan,2023-02-02,14:00:00,65,34,31,FMN 11 A Jan Van Rijswijcklaan Ringfietspad
658,Ringfietspad Jan Van Rijswijcklaan,2023-02-02,15:00:00,82,54,28,FMN 11 A Jan Van Rijswijcklaan Ringfietspad
658,Ringfietspad Jan Van Rijswijcklaan,2023-02-02,16:00:00,122,74,48,FMN 11 A Jan Van Rijswijcklaan Ringfietspad
658,Ringfietspad Jan Van Rijswijcklaan,2023-02-02,17:00:00,114,74,40,FMN 11 A Jan Van Rijswijcklaan Ringfietspad
658,Ringfietspad Jan Van Rijswijcklaan,2023-02-02,18:00:00,78,48,30,FMN 11 A Jan Van Rijswijcklaan Ringfietspad
658,Ringfietspad Jan Van Rijswijcklaan,2023-02-02,19:00:00,33,19,14,FMN 11 A Jan Van Rijswijcklaan Ringfietspad
658,Ringfietspad Jan Van Rijswijcklaan,2023-02-02,20:00:00,40,22,18,FMN 11 A Jan Van Rijswijcklaan Ringfietspad
658,Ringfietspad Jan Van Rijswijcklaan,2023-02-02,21:00:00,15,7,8,FMN 11 A Jan Van Rijswijcklaan Ringfietspad
658,Ringfietspad Jan Van Rijswijcklaan,2023-02-02,22:00:00,13,7,6,FMN 11 A Jan Van Rijswijcklaan Ringfietspad
658,Ringfietspad Jan Van Rijswijcklaan,2023-02-02,23:00:00,9,4,5,FMN 11 A Jan Van Rijswijcklaan Ringfietspad
658,Ringfietspad Jan Van Rijswijcklaan,2023-02-03,00:00:00,5,2,3,FMN 11 A Jan Van Rijswijcklaan Ringfietspad
658,Ringfietspad Jan Van Rijswijcklaan,2023-02-03,01:00:00,1,1,0,FMN 11 A Jan Van Rijswijcklaan Ringfietspad
658,Ringfietspad Jan Van Rijswijcklaan,2023-02-03,02:00:00,2,1,1,FMN 11 A Jan Van Rijswijcklaan Ringfietspad
658,Ringfietspad Jan Van Rijswijcklaan,2023-02-03,03:00:00,2,0,2,FMN 11 A Jan Van Rijswijcklaan Ringfietspad
658,Ringfietspad Jan Van Rijswijcklaan,2023-02-03,04:00:00,7,3,4,FMN 11 A Jan Van Rijswijcklaan Ringfietspad
658,Ringfietspad Jan Van Rijswijcklaan,2023-02-03,05:00:00,17,7,10,FMN 11 A Jan Van Rijswijcklaan Ringfietspad
658,Ringfietspad Jan Van Rijswijcklaan,2023-02-03,06:00:00,54,11,43,FMN 11 A Jan Van Rijswijcklaan Ringfietspad
658,Ringfietspad Jan Van Rijswijcklaan,2023-02-03,07:00:00,86,27,59,FMN 11 A Jan Van Rijswijcklaan Ringfietspad
658,Ringfietspad Jan Van Rijswijcklaan,2023-02-03,08:00:00,130,38,92,FMN 11 A Jan Van Rijswijcklaan Ringfietspad
658,Ringfietspad Jan Van Rijswijcklaan,2023-02-03,09:00:00,48,16,32,FMN 11 A Jan Van Rijswijcklaan Ringfietspad
658,Ringfietspad Jan Van Rijswijcklaan,2023-02-03,10:00:00,39,14,25,FMN 11 A Jan Van Rijswijcklaan Ringfietspad
658,Ringfietspad Jan Van Rijswijcklaan,2023-02-03,11:00:00,43,20,23,FMN 11 A Jan Van Rijswijcklaan Ringfietspad
658,Ringfietspad Jan Van Rijswijcklaan,2023-02-03,12:00:00,60,26,34,FMN 11 A Jan Van Rijswijcklaan Ringfietspad
658,Ringfietspad Jan Van Rijswijcklaan,2023-02-03,13:00:00,42,21,21,FMN 11 A Jan Van Rijswijcklaan Ringfietspad
658,Ringfietspad Jan Van Rijswijcklaan,2023-02-03,14:00:00,55,32,23,FMN 11 A Jan Van Rijswijcklaan Ringfietspad
658,Ringfietspad Jan Van Rijswijcklaan,2023-02-03,15:00:00,88,56,32,FMN 11 A Jan Van Rijswijcklaan Ringfietspad
658,Ringfietspad Jan Van Rijswijcklaan,2023-02-03,16:00:00,102,71,31,FMN 11 A Jan Van Rijswijcklaan Ringfietspad
658,Ringfietspad Jan Van Rijswijcklaan,2023-02-03,17:00:00,97,63,34,FMN 11 A Jan Van Rijswijcklaan Ringfietspad
658,Ringfietspad Jan Van Rijswijcklaan,2023-02-03,18:00:00,75,43,32,FMN 11 A Jan Van Rijswijcklaan Ringfietspad
658,Ringfietspad Jan Van Rijswijcklaan,2023-02-03,19:00:00,42,28,14,FMN 11 A Jan Van Rijswijcklaan Ringfietspad
658,Ringfietspad Jan Van Rijswijcklaan,2023-02-03,20:00:00,22,12,10,FMN 11 A Jan Van Rijswijcklaan Ringfietspad
658,Ringfietspad Jan Van Rijswijcklaan,2023-02-03,21:00:00,22,15,7,FMN 11 A Jan Van Rijswijcklaan Ringfietspad
658,Ringfietspad Jan Van Rijswijcklaan,2023-02-03,22:00:00,15,7,8,FMN 11 A Jan Van Rijswijcklaan Ringfietspad
658,Ringfietspad Jan Van Rijswijcklaan,2023-02-03,23:00:00,8,3,5,FMN 11 A Jan Van Rijswijcklaan Ringfietspad
658,Ringfietspad Jan Van Rijswijcklaan,2023-02-04,00:00:00,3,1,2,FMN 11 A Jan Van Rijswijcklaan Ringfietspad
658,Ringfietspad Jan Van Rijswijcklaan,2023-02-04,01:00:00,7,4,3,FMN 11 A Jan Van Rijswijcklaan Ringfietspad
658,Ringfietspad Jan Van Rijswijcklaan,2023-02-04,02:00:00,1,0,1,FMN 11 A Jan Van Rijswijcklaan Ringfietspad
658,Ringfietspad Jan Van Rijswijcklaan,2023-02-04,03:00:00,1,1,0,FMN 11 A Jan Van Rijswijcklaan Ringfietspad
658,Ringfietspad Jan Van Rijswijcklaan,2023-02-04,04:00:00,6,3,3,FMN 11 A Jan Van Rijswijcklaan Ringfietspad
658,Ringfietspad Jan Van Rijswijcklaan,2023-02-04,05:00:00,6,3,3,FMN 11 A Jan Van Rijswijcklaan Ringfietspad
658,Ringfietspad Jan Van Rijswijcklaan,2023-02-04,06:00:00,11,2,9,FMN 11 A Jan Van Rijswijcklaan Ringfietspad
658,Ringfietspad Jan Van Rijswijcklaan,2023-02-04,07:00:00,8,3,5,FMN 11 A Jan Van Rijswijcklaan Ringfietspad
658,Ringfietspad Jan Van Rijswijcklaan,2023-02-04,08:00:00,20,6,14,FMN 11 A Jan Van Rijswijcklaan Ringfietspad
658,Ringfietspad Jan Van Rijswijcklaan,2023-02-04,09:00:00,27,12,15,FMN 11 A Jan Van Rijswijcklaan Ringfietspad
658,Ringfietspad Jan Van Rijswijcklaan,2023-02-04,10:00:00,41,17,24,FMN 11 A Jan Van Rijswijcklaan Ringfietspad
658,Ringfietspad Jan Van Rijswijcklaan,2023-02-04,11:00:00,41,20,21,FMN 11 A Jan Van Rijswijcklaan Ringfietspad
658,Ringfietspad Jan Van Rijswijcklaan,2023-02-04,12:00:00,43,26,17,FMN 11 A Jan Van Rijswijcklaan Ringfietspad
658,Ringfietspad Jan Van Rijswijcklaan,2023-02-04,13:00:00,47,26,21,FMN 11 A Jan Van Rijswijcklaan Ringfietspad
658,Ringfietspad Jan Van Rijswijcklaan,2023-02-04,14:00:00,53,19,34,FMN 11 A Jan Van Rijswijcklaan Ringfietspad
658,Ringfietspad Jan Van Rijswijcklaan,2023-02-04,15:00:00,57,34,23,FMN 11 A Jan Van Rijswijcklaan Ringfietspad
658,Ringfietspad Jan Van Rijswijcklaan,2023-02-04,16:00:00,48,30,18,FMN 11 A Jan Van Rijswijcklaan Ringfietspad
658,Ringfietspad Jan Van Rijswijcklaan,2023-02-04,17:00:00,46,30,16,FMN 11 A Jan Van Rijswijcklaan Ringfietspad
658,Ringfietspad Jan Van Rijswijcklaan,2023-02-04,18:00:00,30,17,13,FMN 11 A Jan Van Rijswijcklaan Ringfietspad
658,Ringfietspad Jan Van Rijswijcklaan,2023-02-04,19:00:00,16,8,8,FMN 11 A Jan Van Rijswijcklaan Ringfietspad
658,Ringfietspad Jan Van Rijswijcklaan,2023-02-04,20:00:00,9,4,5,FMN 11 A Jan Van Rijswijcklaan Ringfietspad
658,Ringfietspad Jan Van Rijswijcklaan,2023-02-04,21:00:00,11,5,6,FMN 11 A Jan Van Rijswijcklaan Ringfietspad
658,Ringfietspad Jan Van Rijswijcklaan,2023-02-04,22:00:00,10,7,3,FMN 11 A Jan Van Rijswijcklaan Ringfietspad
658,Ringfietspad Jan Van Rijswijcklaan,2023-02-04,23:00:00,9,5,4,FMN 11 A Jan Van Rijswijcklaan Ringfietspad
658,Ringfietspad Jan Van Rijswijcklaan,2023-02-05,00:00:00,0,0,0,FMN 11 A Jan Van Rijswijcklaan Ringfietspad
658,Ringfietspad Jan Van Rijswijcklaan,2023-02-05,01:00:00,1,0,1,FMN 11 A Jan Van Rijswijcklaan Ringfietspad
658,Ringfietspad Jan Van Rijswijcklaan,2023-02-05,02:00:00,4,4,0,FMN 11 A Jan Van Rijswijcklaan Ringfietspad
658,Ringfietspad Jan Van Rijswijcklaan,2023-02-05,03:00:00,1,1,0,FMN 11 A Jan Van Rijswijcklaan Ringfietspad
658,Ringfietspad Jan Van Rijswijcklaan,2023-02-05,04:00:00,0,0,0,FMN 11 A Jan Van Rijswijcklaan Ringfietspad
658,Ringfietspad Jan Van Rijswijcklaan,2023-02-05,05:00:00,3,0,3,FMN 11 A Jan Van Rijswijcklaan Ringfietspad
658,Ringfietspad Jan Van Rijswijcklaan,2023-02-05,06:00:00,4,2,2,FMN 11 A Jan Van Rijswijcklaan Ringfietspad
658,Ringfietspad Jan Van Rijswijcklaan,2023-02-05,07:00:00,3,2,1,FMN 11 A Jan Van Rijswijcklaan Ringfietspad
658,Ringfietspad Jan Van Rijswijcklaan,2023-02-05,08:00:00,13,6,7,FMN 11 A Jan Van Rijswijcklaan Ringfietspad
658,Ringfietspad Jan Van Rijswijcklaan,2023-02-05,09:00:00,23,10,13,FMN 11 A Jan Van Rijswijcklaan Ringfietspad
658,Ringfietspad Jan Van Rijswijcklaan,2023-02-05,10:00:00,27,6,21,FMN 11 A Jan Van Rijswijcklaan Ringfietspad
658,Ringfietspad Jan Van Rijswijcklaan,2023-02-05,11:00:00,26,6,20,FMN 11 A Jan Van Rijswijcklaan Ringfietspad
658,Ringfietspad Jan Van Rijswijcklaan,2023-02-05,12:00:00,48,20,28,FMN 11 A Jan Van Rijswijcklaan Ringfietspad
658,Ringfietspad Jan Van Rijswijcklaan,2023-02-05,13:00:00,43,18,25,FMN 11 A Jan Van Rijswijcklaan Ringfietspad
658,Ringfietspad Jan Van Rijswijcklaan,2023-02-05,14:00:00,42,18,24,FMN 11 A Jan Van Rijswijcklaan Ringfietspad
658,Ringfietspad Jan Van Rijswijcklaan,2023-02-05,15:00:00,49,31,18,FMN 11 A Jan Van Rijswijcklaan Ringfietspad
658,Ringfietspad Jan Van Rijswijcklaan,2023-02-05,16:00:00,40,20,20,FMN 11 A Jan Van Rijswijcklaan Ringfietspad
658,Ringfietspad Jan Van Rijswijcklaan,2023-02-05,17:00:00,38,24,14,FMN 11 A Jan Van Rijswijcklaan Ringfietspad
658,Ringfietspad Jan Van Rijswijcklaan,2023-02-05,18:00:00,15,13,2,FMN 11 A Jan Van Rijswijcklaan Ringfietspad
658,Ringfietspad Jan Van Rijswijcklaan,2023-02-05,19:00:00,18,10,8,FMN 11 A Jan Van Rijswijcklaan Ringfietspad
658,Ringfietspad Jan Van Rijswijcklaan,2023-02-05,20:00:00,9,7,2,FMN 11 A Jan Van Rijswijcklaan Ringfietspad
658,Ringfietspad Jan Van Rijswijcklaan,2023-02-05,21:00:00,4,3,1,FMN 11 A Jan Van Rijswijcklaan Ringfietspad
658,Ringfietspad Jan Van Rijswijcklaan,2023-02-05,22:00:00,2,1,1,FMN 11 A Jan Van Rijswijcklaan Ringfietspad
658,Ringfietspad Jan Van Rijswijcklaan,2023-02-05,23:00:00,0,0,0,FMN 11 A Jan Van Rijswijcklaan Ringfietspad
658,Ringfietspad Jan Van Rijswijcklaan,2023-02-06,00:00:00,3,3,0,FMN 11 A Jan Van Rijswijcklaan Ringfietspad
658,Ringfietspad Jan Van Rijswijcklaan,2023-02-06,01:00:00,1,0,1,FMN 11 A Jan Van Rijswijcklaan Ringfietspad
658,Ringfietspad Jan Van Rijswijcklaan,2023-02-06,02:00:00,1,1,0,FMN 11 A Jan Van Rijswijcklaan Ringfietspad
658,Ringfietspad Jan Van Rijswijcklaan,2023-02-06,03:00:00,1,1,0,FMN 11 A Jan Van Rijswijcklaan Ringfietspad
658,Ringfietspad Jan Van Rijswijcklaan,2023-02-06,04:00:00,7,4,3,FMN 11 A Jan Van Rijswijcklaan Ringfietspad
658,Ringfietspad Jan Van Rijswijcklaan,2023-02-06,05:00:00,15,2,13,FMN 11 A Jan Van Rijswijcklaan Ringfietspad
658,Ringfietspad Jan Van Rijswijcklaan,2023-02-06,06:00:00,47,13,34,FMN 11 A Jan Van Rijswijcklaan Ringfietspad
658,Ringfietspad Jan Van Rijswijcklaan,2023-02-06,07:00:00,94,36,58,FMN 11 A Jan Van Rijswijcklaan Ringfietspad
658,Ringfietspad Jan Van Rijswijcklaan,2023-02-06,08:00:00,132,43,89,FMN 11 A Jan Van Rijswijcklaan Ringfietspad
658,Ringfietspad Jan Van Rijswijcklaan,2023-02-06,09:00:00,35,16,19,FMN 11 A Jan Van Rijswijcklaan Ringfietspad
658,Ringfietspad Jan Van Rijswijcklaan,2023-02-06,10:00:00,32,18,14,FMN 11 A Jan Van Rijswijcklaan Ringfietspad
658,Ringfietspad Jan Van Rijswijcklaan,2023-02-06,11:00:00,37,20,17,FMN 11 A Jan Van Rijswijcklaan Ringfietspad
658,Ringfietspad Jan Van Rijswijcklaan,2023-02-06,12:00:00,46,22,24,FMN 11 A Jan Van Rijswijcklaan Ringfietspad
658,Ringfietspad Jan Van Rijswijcklaan,2023-02-06,13:00:00,40,20,20,FMN 11 A Jan Van Rijswijcklaan Ringfietspad
658,Ringfietspad Jan Van Rijswijcklaan,2023-02-06,14:00:00,57,29,28,FMN 11 A Jan Van Rijswijcklaan Ringfietspad
658,Ringfietspad Jan Van Rijswijcklaan,2023-02-06,15:00:00,91,54,37,FMN 11 A Jan Van Rijswijcklaan Ringfietspad
658,Ringfietspad Jan Van Rijswijcklaan,2023-02-06,16:00:00,117,80,37,FMN 11 A Jan Van Rijswijcklaan Ringfietspad
658,Ringfietspad Jan Van Rijswijcklaan,2023-02-06,17:00:00,115,74,41,FMN 11 A Jan Van Rijswijcklaan Ringfietspad
658,Ringfietspad Jan Van Rijswijcklaan,2023-02-06,18:00:00,67,32,35,FMN 11 A Jan Van Rijswijcklaan Ringfietspad
658,Ringfietspad Jan Van Rijswijcklaan,2023-02-06,19:00:00,30,13,17,FMN 11 A Jan Van Rijswijcklaan Ringfietspad
658,Ringfietspad Jan Van Rijswijcklaan,2023-02-06,20:00:00,21,9,12,FMN 11 A Jan Van Rijswijcklaan Ringfietspad
658,Ringfietspad Jan Van Rijswijcklaan,2023-02-06,21:00:00,18,9,9,FMN 11 A Jan Van Rijswijcklaan Ringfietspad
658,Ringfietspad Jan Van Rijswijcklaan,2023-02-06,22:00:00,21,13,8,FMN 11 A Jan Van Rijswijcklaan Ringfietspad
658,Ringfietspad Jan Van Rijswijcklaan,2023-02-06,23:00:00,4,1,3,FMN 11 A Jan Van Rijswijcklaan Ringfietspad
658,Ringfietspad Jan Van Rijswijcklaan,2023-02-07,00:00:00,2,2,0,FMN 11 A Jan Van Rijswijcklaan Ringfietspad
658,Ringfietspad Jan Van Rijswijcklaan,2023-02-07,01:00:00,1,0,1,FMN 11 A Jan Van Rijswijcklaan Ringfietspad
658,Ringfietspad Jan Van Rijswijcklaan,2023-02-07,02:00:00,1,1,0,FMN 11 A Jan Van Rijswijcklaan Ringfietspad
658,Ringfietspad Jan Van Rijswijcklaan,2023-02-07,03:00:00,3,3,0,FMN 11 A Jan Van Rijswijcklaan Ringfietspad
658,Ringfietspad Jan Van Rijswijcklaan,2023-02-07,04:00:00,8,3,5,FMN 11 A Jan Van Rijswijcklaan Ringfietspad
658,Ringfietspad Jan Van Rijswijcklaan,2023-02-07,05:00:00,26,8,18,FMN 11 A Jan Van Rijswijcklaan Ringfietspad
658,Ringfietspad Jan Van Rijswijcklaan,2023-02-07,06:00:00,52,11,41,FMN 11 A Jan Van Rijswijcklaan Ringfietspad
658,Ringfietspad Jan Van Rijswijcklaan,2023-02-07,07:00:00,101,34,67,FMN 11 A Jan Van Rijswijcklaan Ringfietspad
658,Ringfietspad Jan Van Rijswijcklaan,2023-02-07,08:00:00,133,47,86,FMN 11 A Jan Van Rijswijcklaan Ringfietspad
658,Ringfietspad Jan Van Rijswijcklaan,2023-02-07,09:00:00,47,17,30,FMN 11 A Jan Van Rijswijcklaan Ringfietspad
658,Ringfietspad Jan Van Rijswijcklaan,2023-02-07,10:00:00,22,9,13,FMN 11 A Jan Van Rijswijcklaan Ringfietspad
658,Ringfietspad Jan Van Rijswijcklaan,2023-02-07,11:00:00,28,12,16,FMN 11 A Jan Van Rijswijcklaan Ringfietspad
658,Ringfietspad Jan Van Rijswijcklaan,2023-02-07,12:00:00,43,14,29,FMN 11 A Jan Van Rijswijcklaan Ringfietspad
658,Ringfietspad Jan Van Rijswijcklaan,2023-02-07,13:00:00,42,25,17,FMN 11 A Jan Van Rijswijcklaan Ringfietspad
658,Ringfietspad Jan Van Rijswijcklaan,2023-02-07,14:00:00,54,29,25,FMN 11 A Jan Van Rijswijcklaan Ringfietspad
658,Ringfietspad Jan Van Rijswijcklaan,2023-02-07,15:00:00,66,42,24,FMN 11 A Jan Van Rijswijcklaan Ringfietspad
658,Ringfietspad Jan Van Rijswijcklaan,2023-02-07,16:00:00,120,82,38,FMN 11 A Jan Van Rijswijcklaan Ringfietspad
658,Ringfietspad Jan Van Rijswijcklaan,2023-02-07,17:00:00,125,84,41,FMN 11 A Jan Van Rijswijcklaan Ringfietspad
658,Ringfietspad Jan Van Rijswijcklaan,2023-02-07,18:00:00,63,45,18,FMN 11 A Jan Van Rijswijcklaan Ringfietspad
658,Ringfietspad Jan Van Rijswijcklaan,2023-02-07,19:00:00,29,19,10,FMN 11 A Jan Van Rijswijcklaan Ringfietspad
658,Ringfietspad Jan Van Rijswijcklaan,2023-02-07,20:00:00,24,11,13,FMN 11 A Jan Van Rijswijcklaan Ringfietspad
658,Ringfietspad Jan Van Rijswijcklaan,2023-02-07,21:00:00,20,9,11,FMN 11 A Jan Van Rijswijcklaan Ringfietspad
658,Ringfietspad Jan Van Rijswijcklaan,2023-02-07,22:00:00,13,7,6,FMN 11 A Jan Van Rijswijcklaan Ringfietspad
658,Ringfietspad Jan Van Rijswijcklaan,2023-02-07,23:00:00,5,4,1,FMN 11 A Jan Van Rijswijcklaan Ringfietspad
658,Ringfietspad Jan Van Rijswijcklaan,2023-02-08,00:00:00,3,1,2,FMN 11 A Jan Van Rijswijcklaan Ringfietspad
658,Ringfietspad Jan Van Rijswijcklaan,2023-02-08,01:00:00,2,2,0,FMN 11 A Jan Van Rijswijcklaan Ringfietspad
658,Ringfietspad Jan Van Rijswijcklaan,2023-02-08,02:00:00,1,1,0,FMN 11 A Jan Van Rijswijcklaan Ringfietspad
658,Ringfietspad Jan Van Rijswijcklaan,2023-02-08,03:00:00,0,0,0,FMN 11 A Jan Van Rijswijcklaan Ringfietspad
658,Ringfietspad Jan Van Rijswijcklaan,2023-02-08,04:00:00,8,3,5,FMN 11 A Jan Van Rijswijcklaan Ringfietspad
658,Ringfietspad Jan Van Rijswijcklaan,2023-02-08,05:00:00,23,9,14,FMN 11 A Jan Van Rijswijcklaan Ringfietspad
658,Ringfietspad Jan Van Rijswijcklaan,2023-02-08,06:00:00,48,13,35,FMN 11 A Jan Van Rijswijcklaan Ringfietspad
658,Ringfietspad Jan Van Rijswijcklaan,2023-02-08,07:00:00,100,28,72,FMN 11 A Jan Van Rijswijcklaan Ringfietspad
658,Ringfietspad Jan Van Rijswijcklaan,2023-02-08,08:00:00,120,47,73,FMN 11 A Jan Van Rijswijcklaan Ringfietspad
658,Ringfietspad Jan Van Rijswijcklaan,2023-02-08,09:00:00,40,13,27,FMN 11 A Jan Van Rijswijcklaan Ringfietspad
658,Ringfietspad Jan Van Rijswijcklaan,2023-02-08,10:00:00,35,17,18,FMN 11 A Jan Van Rijswijcklaan Ringfietspad
658,Ringfietspad Jan Van Rijswijcklaan,2023-02-08,11:00:00,38,19,19,FMN 11 A Jan Van Rijswijcklaan Ringfietspad
658,Ringfietspad Jan Van Rijswijcklaan,2023-02-08,12:00:00,48,24,24,FMN 11 A Jan Van Rijswijcklaan Ringfietspad
658,Ringfietspad Jan Van Rijswijcklaan,2023-02-08,13:00:00,46,26,20,FMN 11 A Jan Van Rijswijcklaan Ringfietspad
658,Ringfietspad Jan Van Rijswijcklaan,2023-02-08,14:00:00,62,36,26,FMN 11 A Jan Van Rijswijcklaan Ringfietspad
658,Ringfietspad Jan Van Rijswijcklaan,2023-02-08,15:00:00,70,41,29,FMN 11 A Jan Van Rijswijcklaan Ringfietspad
658,Ringfietspad Jan Van Rijswijcklaan,2023-02-08,16:00:00,105,77,28,FMN 11 A Jan Van Rijswijcklaan Ringfietspad
658,Ringfietspad Jan Van Rijswijcklaan,2023-02-08,17:00:00,102,72,30,FMN 11 A Jan Van Rijswijcklaan Ringfietspad
658,Ringfietspad Jan Van Rijswijcklaan,2023-02-08,18:00:00,69,47,22,FMN 11 A Jan Van Rijswijcklaan Ringfietspad
658,Ringfietspad Jan Van Rijswijcklaan,2023-02-08,19:00:00,29,20,9,FMN 11 A Jan Van Rijswijcklaan Ringfietspad
658,Ringfietspad Jan Van Rijswijcklaan,2023-02-08,20:00:00,21,15,6,FMN 11 A Jan Van Rijswijcklaan Ringfietspad
658,Ringfietspad Jan Van Rijswijcklaan,2023-02-08,21:00:00,12,5,7,FMN 11 A Jan Van Rijswijcklaan Ringfietspad
658,Ringfietspad Jan Van Rijswijcklaan,2023-02-08,22:00:00,17,11,6,FMN 11 A Jan Van Rijswijcklaan Ringfietspad
658,Ringfietspad Jan Van Rijswijcklaan,2023-02-08,23:00:00,7,5,2,FMN 11 A Jan Van Rijswijcklaan Ringfietspad
658,Ringfietspad Jan Van Rijswijcklaan,2023-02-09,00:00:00,3,2,1,FMN 11 A Jan Van Rijswijcklaan Ringfietspad
658,Ringfietspad Jan Van Rijswijcklaan,2023-02-09,01:00:00,1,0,1,FMN 11 A Jan Van Rijswijcklaan Ringfietspad
658,Ringfietspad Jan Van Rijswijcklaan,2023-02-09,02:00:00,0,0,0,FMN 11 A Jan Van Rijswijcklaan Ringfietspad
658,Ringfietspad Jan Van Rijswijcklaan,2023-02-09,03:00:00,0,0,0,FMN 11 A Jan Van Rijswijcklaan Ringfietspad
658,Ringfietspad Jan Van Rijswijcklaan,2023-02-09,04:00:00,4,1,3,FMN 11 A Jan Van Rijswijcklaan Ringfietspad
658,Ringfietspad Jan Van Rijswijcklaan,2023-02-09,05:00:00,18,7,11,FMN 11 A Jan Van Rijswijcklaan Ringfietspad
658,Ringfietspad Jan Van Rijswijcklaan,2023-02-09,06:00:00,58,16,42,FMN 11 A Jan Van Rijswijcklaan Ringfietspad
658,Ringfietspad Jan Van Rijswijcklaan,2023-02-09,07:00:00,90,28,62,FMN 11 A Jan Van Rijswijcklaan Ringfietspad
658,Ringfietspad Jan Van Rijswijcklaan,2023-02-09,08:00:00,130,37,93,FMN 11 A Jan Van Rijswijcklaan Ringfietspad
658,Ringfietspad Jan Van Rijswijcklaan,2023-02-09,09:00:00,49,21,28,FMN 11 A Jan Van Rijswijcklaan Ringfietspad
658,Ringfietspad Jan Van Rijswijcklaan,2023-02-09,10:00:00,27,9,18,FMN 11 A Jan Van Rijswijcklaan Ringfietspad
658,Ringfietspad Jan Van Rijswijcklaan,2023-02-09,11:00:00,43,20,23,FMN 11 A Jan Van Rijswijcklaan Ringfietspad
658,Ringfietspad Jan Van Rijswijcklaan,2023-02-09,12:00:00,45,20,25,FMN 11 A Jan Van Rijswijcklaan Ringfietspad
658,Ringfietspad Jan Van Rijswijcklaan,2023-02-09,13:00:00,45,24,21,FMN 11 A Jan Van Rijswijcklaan Ringfietspad
658,Ringfietspad Jan Van Rijswijcklaan,2023-02-09,14:00:00,53,29,24,FMN 11 A Jan Van Rijswijcklaan Ringfietspad
658,Ringfietspad Jan Van Rijswijcklaan,2023-02-09,15:00:00,86,53,33,FMN 11 A Jan Van Rijswijcklaan Ringfietspad
658,Ringfietspad Jan Van Rijswijcklaan,2023-02-09,16:00:00,119,77,42,FMN 11 A Jan Van Rijswijcklaan Ringfietspad
658,Ringfietspad Jan Van Rijswijcklaan,2023-02-09,17:00:00,106,70,36,FMN 11 A Jan Van Rijswijcklaan Ringfietspad
658,Ringfietspad Jan Van Rijswijcklaan,2023-02-09,18:00:00,72,41,31,FMN 11 A Jan Van Rijswijcklaan Ringfietspad
658,Ringfietspad Jan Van Rijswijcklaan,2023-02-09,19:00:00,27,16,11,FMN 11 A Jan Van Rijswijcklaan Ringfietspad
658,Ringfietspad Jan Van Rijswijcklaan,2023-02-09,20:00:00,23,13,10,FMN 11 A Jan Van Rijswijcklaan Ringfietspad
658,Ringfietspad Jan Van Rijswijcklaan,2023-02-09,21:00:00,11,1,10,FMN 11 A Jan Van Rijswijcklaan Ringfietspad
658,Ringfietspad Jan Van Rijswijcklaan,2023-02-09,22:00:00,14,9,5,FMN 11 A Jan Van Rijswijcklaan Ringfietspad
658,Ringfietspad Jan Van Rijswijcklaan,2023-02-09,23:00:00,8,4,4,FMN 11 A Jan Van Rijswijcklaan Ringfietspad
658,Ringfietspad Jan Van Rijswijcklaan,2023-02-10,00:00:00,5,2,3,FMN 11 A Jan Van Rijswijcklaan Ringfietspad
658,Ringfietspad Jan Van Rijswijcklaan,2023-02-10,01:00:00,3,1,2,FMN 11 A Jan Van Rijswijcklaan Ringfietspad
658,Ringfietspad Jan Van Rijswijcklaan,2023-02-10,02:00:00,0,0,0,FMN 11 A Jan Van Rijswijcklaan Ringfietspad
658,Ringfietspad Jan Van Rijswijcklaan,2023-02-10,03:00:00,2,1,1,FMN 11 A Jan Van Rijswijcklaan Ringfietspad
658,Ringfietspad Jan Van Rijswijcklaan,2023-02-10,04:00:00,8,3,5,FMN 11 A Jan Van Rijswijcklaan Ringfietspad
658,Ringfietspad Jan Van Rijswijcklaan,2023-02-10,05:00:00,18,4,14,FMN 11 A Jan Van Rijswijcklaan Ringfietspad
658,Ringfietspad Jan Van Rijswijcklaan,2023-02-10,06:00:00,51,12,39,FMN 11 A Jan Van Rijswijcklaan Ringfietspad
658,Ringfietspad Jan Van Rijswijcklaan,2023-02-10,07:00:00,84,33,51,FMN 11 A Jan Van Rijswijcklaan Ringfietspad
658,Ringfietspad Jan Van Rijswijcklaan,2023-02-10,08:00:00,108,33,75,FMN 11 A Jan Van Rijswijcklaan Ringfietspad
658,Ringfietspad Jan Van Rijswijcklaan,2023-02-10,09:00:00,47,18,29,FMN 11 A Jan Van Rijswijcklaan Ringfietspad
658,Ringfietspad Jan Van Rijswijcklaan,2023-02-10,10:00:00,40,21,19,FMN 11 A Jan Van Rijswijcklaan Ringfietspad
658,Ringfietspad Jan Van Rijswijcklaan,2023-02-10,11:00:00,31,16,15,FMN 11 A Jan Van Rijswijcklaan Ringfietspad
658,Ringfietspad Jan Van Rijswijcklaan,2023-02-10,12:00:00,54,30,24,FMN 11 A Jan Van Rijswijcklaan Ringfietspad
658,Ringfietspad Jan Van Rijswijcklaan,2023-02-10,13:00:00,35,19,16,FMN 11 A Jan Van Rijswijcklaan Ringfietspad
658,Ringfietspad Jan Van Rijswijcklaan,2023-02-10,14:00:00,61,37,24,FMN 11 A Jan Van Rijswijcklaan Ringfietspad
658,Ringfietspad Jan Van Rijswijcklaan,2023-02-10,15:00:00,77,54,23,FMN 11 A Jan Van Rijswijcklaan Ringfietspad
658,Ringfietspad Jan Van Rijswijcklaan,2023-02-10,16:00:00,108,78,30,FMN 11 A Jan Van Rijswijcklaan Ringfietspad
658,Ringfietspad Jan Van Rijswijcklaan,2023-02-10,17:00:00,94,64,30,FMN 11 A Jan Van Rijswijcklaan Ringfietspad
658,Ringfietspad Jan Van Rijswijcklaan,2023-02-10,18:00:00,64,40,24,FMN 11 A Jan Van Rijswijcklaan Ringfietspad
658,Ringfietspad Jan Van Rijswijcklaan,2023-02-10,19:00:00,33,17,16,FMN 11 A Jan Van Rijswijcklaan Ringfietspad
658,Ringfietspad Jan Van Rijswijcklaan,2023-02-10,20:00:00,26,15,11,FMN 11 A Jan Van Rijswijcklaan Ringfietspad
658,Ringfietspad Jan Van Rijswijcklaan,2023-02-10,21:00:00,19,14,5,FMN 11 A Jan Van Rijswijcklaan Ringfietspad
658,Ringfietspad Jan Van Rijswijcklaan,2023-02-10,22:00:00,16,10,6,FMN 11 A Jan Van Rijswijcklaan Ringfietspad
658,Ringfietspad Jan Van Rijswijcklaan,2023-02-10,23:00:00,9,4,5,FMN 11 A Jan Van Rijswijcklaan Ringfietspad
658,Ringfietspad Jan Van Rijswijcklaan,2023-02-11,00:00:00,5,4,1,FMN 11 A Jan Van Rijswijcklaan Ringfietspad
658,Ringfietspad Jan Van Rijswijcklaan,2023-02-11,01:00:00,5,4,1,FMN 11 A Jan Van Rijswijcklaan Ringfietspad
658,Ringfietspad Jan Van Rijswijcklaan,2023-02-11,02:00:00,1,0,1,FMN 11 A Jan Van Rijswijcklaan Ringfietspad
658,Ringfietspad Jan Van Rijswijcklaan,2023-02-11,03:00:00,0,0,0,FMN 11 A Jan Van Rijswijcklaan Ringfietspad
658,Ringfietspad Jan Van Rijswijcklaan,2023-02-11,04:00:00,4,1,3,FMN 11 A Jan Van Rijswijcklaan Ringfietspad
658,Ringfietspad Jan Van Rijswijcklaan,2023-02-11,05:00:00,2,1,1,FMN 11 A Jan Van Rijswijcklaan Ringfietspad
658,Ringfietspad Jan Van Rijswijcklaan,2023-02-11,06:00:00,6,1,5,FMN 11 A Jan Van Rijswijcklaan Ringfietspad
658,Ringfietspad Jan Van Rijswijcklaan,2023-02-11,07:00:00,3,2,1,FMN 11 A Jan Van Rijswijcklaan Ringfietspad
658,Ringfietspad Jan Van Rijswijcklaan,2023-02-11,08:00:00,20,9,11,FMN 11 A Jan Van Rijswijcklaan Ringfietspad
658,Ringfietspad Jan Van Rijswijcklaan,2023-02-11,09:00:00,29,3,26,FMN 11 A Jan Van Rijswijcklaan Ringfietspad
658,Ringfietspad Jan Van Rijswijcklaan,2023-02-11,10:00:00,34,16,18,FMN 11 A Jan Van Rijswijcklaan Ringfietspad
658,Ringfietspad Jan Van Rijswijcklaan,2023-02-11,11:00:00,42,16,26,FMN 11 A Jan Van Rijswijcklaan Ringfietspad
658,Ringfietspad Jan Van Rijswijcklaan,2023-02-11,12:00:00,42,17,25,FMN 11 A Jan Van Rijswijcklaan Ringfietspad
658,Ringfietspad Jan Van Rijswijcklaan,2023-02-11,13:00:00,43,25,18,FMN 11 A Jan Van Rijswijcklaan Ringfietspad
658,Ringfietspad Jan Van Rijswijcklaan,2023-02-11,14:00:00,58,28,30,FMN 11 A Jan Van Rijswijcklaan Ringfietspad
658,Ringfietspad Jan Van Rijswijcklaan,2023-02-11,15:00:00,64,32,32,FMN 11 A Jan Van Rijswijcklaan Ringfietspad
658,Ringfietspad Jan Van Rijswijcklaan,2023-02-11,16:00:00,57,34,23,FMN 11 A Jan Van Rijswijcklaan Ringfietspad
658,Ringfietspad Jan Van Rijswijcklaan,2023-02-11,17:00:00,47,28,19,FMN 11 A Jan Van Rijswijcklaan Ringfietspad
658,Ringfietspad Jan Van Rijswijcklaan,2023-02-11,18:00:00,38,21,17,FMN 11 A Jan Van Rijswijcklaan Ringfietspad
658,Ringfietspad Jan Van Rijswijcklaan,2023-02-11,19:00:00,15,7,8,FMN 11 A Jan Van Rijswijcklaan Ringfietspad
658,Ringfietspad Jan Van Rijswijcklaan,2023-02-11,20:00:00,12,5,7,FMN 11 A Jan Van Rijswijcklaan Ringfietspad
658,Ringfietspad Jan Van Rijswijcklaan,2023-02-11,21:00:00,9,4,5,FMN 11 A Jan Van Rijswijcklaan Ringfietspad
658,Ringfietspad Jan Van Rijswijcklaan,2023-02-11,22:00:00,10,5,5,FMN 11 A Jan Van Rijswijcklaan Ringfietspad
658,Ringfietspad Jan Van Rijswijcklaan,2023-02-11,23:00:00,8,3,5,FMN 11 A Jan Van Rijswijcklaan Ringfietspad
658,Ringfietspad Jan Van Rijswijcklaan,2023-02-12,00:00:00,3,1,2,FMN 11 A Jan Van Rijswijcklaan Ringfietspad
658,Ringfietspad Jan Van Rijswijcklaan,2023-02-12,01:00:00,1,1,0,FMN 11 A Jan Van Rijswijcklaan Ringfietspad
658,Ringfietspad Jan Van Rijswijcklaan,2023-02-12,02:00:00,1,1,0,FMN 11 A Jan Van Rijswijcklaan Ringfietspad
658,Ringfietspad Jan Van Rijswijcklaan,2023-02-12,03:00:00,1,1,0,FMN 11 A Jan Van Rijswijcklaan Ringfietspad
658,Ringfietspad Jan Van Rijswijcklaan,2023-02-12,04:00:00,0,0,0,FMN 11 A Jan Van Rijswijcklaan Ringfietspad
658,Ringfietspad Jan Van Rijswijcklaan,2023-02-12,05:00:00,1,0,1,FMN 11 A Jan Van Rijswijcklaan Ringfietspad
658,Ringfietspad Jan Van Rijswijcklaan,2023-02-12,06:00:00,2,1,1,FMN 11 A Jan Van Rijswijcklaan Ringfietspad
658,Ringfietspad Jan Van Rijswijcklaan,2023-02-12,07:00:00,8,5,3,FMN 11 A Jan Van Rijswijcklaan Ringfietspad
658,Ringfietspad Jan Van Rijswijcklaan,2023-02-12,08:00:00,7,2,5,FMN 11 A Jan Van Rijswijcklaan Ringfietspad
658,Ringfietspad Jan Van Rijswijcklaan,2023-02-12,09:00:00,31,13,18,FMN 11 A Jan Van Rijswijcklaan Ringfietspad
658,Ringfietspad Jan Van Rijswijcklaan,2023-02-12,10:00:00,37,9,28,FMN 11 A Jan Van Rijswijcklaan Ringfietspad
658,Ringfietspad Jan Van Rijswijcklaan,2023-02-12,11:00:00,32,17,15,FMN 11 A Jan Van Rijswijcklaan Ringfietspad
658,Ringfietspad Jan Van Rijswijcklaan,2023-02-12,12:00:00,53,25,28,FMN 11 A Jan Van Rijswijcklaan Ringfietspad
658,Ringfietspad Jan Van Rijswijcklaan,2023-02-12,13:00:00,55,25,30,FMN 11 A Jan Van Rijswijcklaan Ringfietspad
658,Ringfietspad Jan Van Rijswijcklaan,2023-02-12,14:00:00,48,26,22,FMN 11 A Jan Van Rijswijcklaan Ringfietspad
658,Ringfietspad Jan Van Rijswijcklaan,2023-02-12,15:00:00,55,31,24,FMN 11 A Jan Van Rijswijcklaan Ringfietspad
658,Ringfietspad Jan Van Rijswijcklaan,2023-02-12,16:00:00,44,27,17,FMN 11 A Jan Van Rijswijcklaan Ringfietspad
658,Ringfietspad Jan Van Rijswijcklaan,2023-02-12,17:00:00,35,25,10,FMN 11 A Jan Van Rijswijcklaan Ringfietspad
658,Ringfietspad Jan Van Rijswijcklaan,2023-02-12,18:00:00,18,11,7,FMN 11 A Jan Van Rijswijcklaan Ringfietspad
658,Ringfietspad Jan Van Rijswijcklaan,2023-02-12,19:00:00,22,16,6,FMN 11 A Jan Van Rijswijcklaan Ringfietspad
658,Ringfietspad Jan Van Rijswijcklaan,2023-02-12,20:00:00,16,7,9,FMN 11 A Jan Van Rijswijcklaan Ringfietspad
658,Ringfietspad Jan Van Rijswijcklaan,2023-02-12,21:00:00,14,9,5,FMN 11 A Jan Van Rijswijcklaan Ringfietspad
658,Ringfietspad Jan Van Rijswijcklaan,2023-02-12,22:00:00,7,3,4,FMN 11 A Jan Van Rijswijcklaan Ringfietspad
658,Ringfietspad Jan Van Rijswijcklaan,2023-02-12,23:00:00,0,0,0,FMN 11 A Jan Van Rijswijcklaan Ringfietspad
658,Ringfietspad Jan Van Rijswijcklaan,2023-02-13,00:00:00,1,1,0,FMN 11 A Jan Van Rijswijcklaan Ringfietspad
658,Ringfietspad Jan Van Rijswijcklaan,2023-02-13,01:00:00,1,0,1,FMN 11 A Jan Van Rijswijcklaan Ringfietspad
658,Ringfietspad Jan Van Rijswijcklaan,2023-02-13,02:00:00,1,0,1,FMN 11 A Jan Van Rijswijcklaan Ringfietspad
658,Ringfietspad Jan Van Rijswijcklaan,2023-02-13,03:00:00,2,2,0,FMN 11 A Jan Van Rijswijcklaan Ringfietspad
658,Ringfietspad Jan Van Rijswijcklaan,2023-02-13,04:00:00,9,5,4,FMN 11 A Jan Van Rijswijcklaan Ringfietspad
658,Ringfietspad Jan Van Rijswijcklaan,2023-02-13,05:00:00,21,4,17,FMN 11 A Jan Van Rijswijcklaan Ringfietspad
658,Ringfietspad Jan Van Rijswijcklaan,2023-02-13,06:00:00,51,12,39,FMN 11 A Jan Van Rijswijcklaan Ringfietspad
658,Ringfietspad Jan Van Rijswijcklaan,2023-02-13,07:00:00,122,45,77,FMN 11 A Jan Van Rijswijcklaan Ringfietspad
658,Ringfietspad Jan Van Rijswijcklaan,2023-02-13,08:00:00,164,59,105,FMN 11 A Jan Van Rijswijcklaan Ringfietspad
658,Ringfietspad Jan Van Rijswijcklaan,2023-02-13,09:00:00,64,26,38,FMN 11 A Jan Van Rijswijcklaan Ringfietspad
658,Ringfietspad Jan Van Rijswijcklaan,2023-02-13,10:00:00,45,15,30,FMN 11 A Jan Van Rijswijcklaan Ringfietspad
658,Ringfietspad Jan Van Rijswijcklaan,2023-02-13,11:00:00,38,18,20,FMN 11 A Jan Van Rijswijcklaan Ringfietspad
658,Ringfietspad Jan Van Rijswijcklaan,2023-02-13,12:00:00,54,31,23,FMN 11 A Jan Van Rijswijcklaan Ringfietspad
658,Ringfietspad Jan Van Rijswijcklaan,2023-02-13,13:00:00,45,19,26,FMN 11 A Jan Van Rijswijcklaan Ringfietspad
658,Ringfietspad Jan Van Rijswijcklaan,2023-02-13,14:00:00,66,38,28,FMN 11 A Jan Van Rijswijcklaan Ringfietspad
658,Ringfietspad Jan Van Rijswijcklaan,2023-02-13,15:00:00,87,57,30,FMN 11 A Jan Van Rijswijcklaan Ringfietspad
658,Ringfietspad Jan Van Rijswijcklaan,2023-02-13,16:00:00,142,96,46,FMN 11 A Jan Van Rijswijcklaan Ringfietspad
658,Ringfietspad Jan Van Rijswijcklaan,2023-02-13,17:00:00,151,107,44,FMN 11 A Jan Van Rijswijcklaan Ringfietspad
658,Ringfietspad Jan Van Rijswijcklaan,2023-02-13,18:00:00,80,51,29,FMN 11 A Jan Van Rijswijcklaan Ringfietspad
658,Ringfietspad Jan Van Rijswijcklaan,2023-02-13,19:00:00,44,20,24,FMN 11 A Jan Van Rijswijcklaan Ringfietspad
658,Ringfietspad Jan Van Rijswijcklaan,2023-02-13,20:00:00,28,14,14,FMN 11 A Jan Van Rijswijcklaan Ringfietspad
658,Ringfietspad Jan Van Rijswijcklaan,2023-02-13,21:00:00,23,9,14,FMN 11 A Jan Van Rijswijcklaan Ringfietspad
658,Ringfietspad Jan Van Rijswijcklaan,2023-02-13,22:00:00,24,14,10,FMN 11 A Jan Van Rijswijcklaan Ringfietspad
658,Ringfietspad Jan Van Rijswijcklaan,2023-02-13,23:00:00,8,5,3,FMN 11 A Jan Van Rijswijcklaan Ringfietspad
658,Ringfietspad Jan Van Rijswijcklaan,2023-02-14,00:00:00,2,1,1,FMN 11 A Jan Van Rijswijcklaan Ringfietspad
658,Ringfietspad Jan Van Rijswijcklaan,2023-02-14,01:00:00,0,0,0,FMN 11 A Jan Van Rijswijcklaan Ringfietspad
658,Ringfietspad Jan Van Rijswijcklaan,2023-02-14,02:00:00,1,0,1,FMN 11 A Jan Van Rijswijcklaan Ringfietspad
658,Ringfietspad Jan Van Rijswijcklaan,2023-02-14,03:00:00,3,3,0,FMN 11 A Jan Van Rijswijcklaan Ringfietspad
658,Ringfietspad Jan Van Rijswijcklaan,2023-02-14,04:00:00,9,3,6,FMN 11 A Jan Van Rijswijcklaan Ringfietspad
658,Ringfietspad Jan Van Rijswijcklaan,2023-02-14,05:00:00,22,7,15,FMN 11 A Jan Van Rijswijcklaan Ringfietspad
658,Ringfietspad Jan Van Rijswijcklaan,2023-02-14,06:00:00,68,20,48,FMN 11 A Jan Van Rijswijcklaan Ringfietspad
658,Ringfietspad Jan Van Rijswijcklaan,2023-02-14,07:00:00,147,58,89,FMN 11 A Jan Van Rijswijcklaan Ringfietspad
658,Ringfietspad Jan Van Rijswijcklaan,2023-02-14,08:00:00,181,61,120,FMN 11 A Jan Van Rijswijcklaan Ringfietspad
658,Ringfietspad Jan Van Rijswijcklaan,2023-02-14,09:00:00,78,28,50,FMN 11 A Jan Van Rijswijcklaan Ringfietspad
658,Ringfietspad Jan Van Rijswijcklaan,2023-02-14,10:00:00,46,17,29,FMN 11 A Jan Van Rijswijcklaan Ringfietspad
658,Ringfietspad Jan Van Rijswijcklaan,2023-02-14,11:00:00,39,17,22,FMN 11 A Jan Van Rijswijcklaan Ringfietspad
658,Ringfietspad Jan Van Rijswijcklaan,2023-02-14,12:00:00,53,26,27,FMN 11 A Jan Van Rijswijcklaan Ringfietspad
658,Ringfietspad Jan Van Rijswijcklaan,2023-02-14,13:00:00,58,30,28,FMN 11 A Jan Van Rijswijcklaan Ringfietspad
658,Ringfietspad Jan Van Rijswijcklaan,2023-02-14,14:00:00,67,42,25,FMN 11 A Jan Van Rijswijcklaan Ringfietspad
658,Ringfietspad Jan Van Rijswijcklaan,2023-02-14,15:00:00,98,65,33,FMN 11 A Jan Van Rijswijcklaan Ringfietspad
658,Ringfietspad Jan Van Rijswijcklaan,2023-02-14,16:00:00,170,113,57,FMN 11 A Jan Van Rijswijcklaan Ringfietspad
658,Ringfietspad Jan Van Rijswijcklaan,2023-02-14,17:00:00,167,111,56,FMN 11 A Jan Van Rijswijcklaan Ringfietspad
658,Ringfietspad Jan Van Rijswijcklaan,2023-02-14,18:00:00,103,63,40,FMN 11 A Jan Van Rijswijcklaan Ringfietspad
658,Ringfietspad Jan Van Rijswijcklaan,2023-02-14,19:00:00,52,28,24,FMN 11 A Jan Van Rijswijcklaan Ringfietspad
658,Ringfietspad Jan Van Rijswijcklaan,2023-02-14,20:00:00,24,12,12,FMN 11 A Jan Van Rijswijcklaan Ringfietspad
658,Ringfietspad Jan Van Rijswijcklaan,2023-02-14,21:00:00,25,8,17,FMN 11 A Jan Van Rijswijcklaan Ringfietspad
658,Ringfietspad Jan Van Rijswijcklaan,2023-02-14,22:00:00,21,11,10,FMN 11 A Jan Van Rijswijcklaan Ringfietspad
658,Ringfietspad Jan Van Rijswijcklaan,2023-02-14,23:00:00,14,11,3,FMN 11 A Jan Van Rijswijcklaan Ringfietspad
658,Ringfietspad Jan Van Rijswijcklaan,2023-02-15,00:00:00,3,1,2,FMN 11 A Jan Van Rijswijcklaan Ringfietspad
658,Ringfietspad Jan Van Rijswijcklaan,2023-02-15,01:00:00,0,0,0,FMN 11 A Jan Van Rijswijcklaan Ringfietspad
658,Ringfietspad Jan Van Rijswijcklaan,2023-02-15,02:00:00,2,1,1,FMN 11 A Jan Van Rijswijcklaan Ringfietspad
658,Ringfietspad Jan Van Rijswijcklaan,2023-02-15,03:00:00,4,3,1,FMN 11 A Jan Van Rijswijcklaan Ringfietspad
658,Ringfietspad Jan Van Rijswijcklaan,2023-02-15,04:00:00,4,2,2,FMN 11 A Jan Van Rijswijcklaan Ringfietspad
658,Ringfietspad Jan Van Rijswijcklaan,2023-02-15,05:00:00,30,10,20,FMN 11 A Jan Van Rijswijcklaan Ringfietspad
658,Ringfietspad Jan Van Rijswijcklaan,2023-02-15,06:00:00,62,14,48,FMN 11 A Jan Van Rijswijcklaan Ringfietspad
658,Ringfietspad Jan Van Rijswijcklaan,2023-02-15,07:00:00,120,46,74,FMN 11 A Jan Van Rijswijcklaan Ringfietspad
658,Ringfietspad Jan Van Rijswijcklaan,2023-02-15,08:00:00,158,56,102,FMN 11 A Jan Van Rijswijcklaan Ringfietspad
658,Ringfietspad Jan Van Rijswijcklaan,2023-02-15,09:00:00,45,18,27,FMN 11 A Jan Van Rijswijcklaan Ringfietspad
658,Ringfietspad Jan Van Rijswijcklaan,2023-02-15,10:00:00,49,21,28,FMN 11 A Jan Van Rijswijcklaan Ringfietspad
658,Ringfietspad Jan Van Rijswijcklaan,2023-02-15,11:00:00,44,14,30,FMN 11 A Jan Van Rijswijcklaan Ringfietspad
658,Ringfietspad Jan Van Rijswijcklaan,2023-02-15,12:00:00,70,40,30,FMN 11 A Jan Van Rijswijcklaan Ringfietspad
658,Ringfietspad Jan Van Rijswijcklaan,2023-02-15,13:00:00,69,27,42,FMN 11 A Jan Van Rijswijcklaan Ringfietspad
658,Ringfietspad Jan Van Rijswijcklaan,2023-02-15,14:00:00,73,37,36,FMN 11 A Jan Van Rijswijcklaan Ringfietspad
658,Ringfietspad Jan Van Rijswijcklaan,2023-02-15,15:00:00,89,57,32,FMN 11 A Jan Van Rijswijcklaan Ringfietspad
658,Ringfietspad Jan Van Rijswijcklaan,2023-02-15,16:00:00,141,96,45,FMN 11 A Jan Van Rijswijcklaan Ringfietspad
658,Ringfietspad Jan Van Rijswijcklaan,2023-02-15,17:00:00,149,92,57,FMN 11 A Jan Van Rijswijcklaan Ringfietspad
658,Ringfietspad Jan Van Rijswijcklaan,2023-02-15,18:00:00,92,54,38,FMN 11 A Jan Van Rijswijcklaan Ringfietspad
658,Ringfietspad Jan Van Rijswijcklaan,2023-02-15,19:00:00,47,27,20,FMN 11 A Jan Van Rijswijcklaan Ringfietspad
658,Ringfietspad Jan Van Rijswijcklaan,2023-02-15,20:00:00,36,22,14,FMN 11 A Jan Van Rijswijcklaan Ringfietspad
658,Ringfietspad Jan Van Rijswijcklaan,2023-02-15,21:00:00,15,8,7,FMN 11 A Jan Van Rijswijcklaan Ringfietspad
658,Ringfietspad Jan Van Rijswijcklaan,2023-02-15,22:00:00,20,15,5,FMN 11 A Jan Van Rijswijcklaan Ringfietspad
658,Ringfietspad Jan Van Rijswijcklaan,2023-02-15,23:00:00,7,3,4,FMN 11 A Jan Van Rijswijcklaan Ringfietspad
658,Ringfietspad Jan Van Rijswijcklaan,2023-02-16,00:00:00,5,1,4,FMN 11 A Jan Van Rijswijcklaan Ringfietspad
658,Ringfietspad Jan Van Rijswijcklaan,2023-02-16,01:00:00,4,1,3,FMN 11 A Jan Van Rijswijcklaan Ringfietspad
658,Ringfietspad Jan Van Rijswijcklaan,2023-02-16,02:00:00,1,0,1,FMN 11 A Jan Van Rijswijcklaan Ringfietspad
658,Ringfietspad Jan Van Rijswijcklaan,2023-02-16,03:00:00,4,4,0,FMN 11 A Jan Van Rijswijcklaan Ringfietspad
658,Ringfietspad Jan Van Rijswijcklaan,2023-02-16,04:00:00,7,4,3,FMN 11 A Jan Van Rijswijcklaan Ringfietspad
658,Ringfietspad Jan Van Rijswijcklaan,2023-02-16,05:00:00,21,7,14,FMN 11 A Jan Van Rijswijcklaan Ringfietspad
658,Ringfietspad Jan Van Rijswijcklaan,2023-02-16,06:00:00,58,20,38,FMN 11 A Jan Van Rijswijcklaan Ringfietspad
658,Ringfietspad Jan Van Rijswijcklaan,2023-02-16,07:00:00,105,32,73,FMN 11 A Jan Van Rijswijcklaan Ringfietspad
658,Ringfietspad Jan Van Rijswijcklaan,2023-02-16,08:00:00,146,44,102,FMN 11 A Jan Van Rijswijcklaan Ringfietspad
658,Ringfietspad Jan Van Rijswijcklaan,2023-02-16,09:00:00,65,27,38,FMN 11 A Jan Van Rijswijcklaan Ringfietspad
658,Ringfietspad Jan Van Rijswijcklaan,2023-02-16,10:00:00,32,11,21,FMN 11 A Jan Van Rijswijcklaan Ringfietspad
658,Ringfietspad Jan Van Rijswijcklaan,2023-02-16,11:00:00,31,15,16,FMN 11 A Jan Van Rijswijcklaan Ringfietspad
658,Ringfietspad Jan Van Rijswijcklaan,2023-02-16,12:00:00,67,34,33,FMN 11 A Jan Van Rijswijcklaan Ringfietspad
658,Ringfietspad Jan Van Rijswijcklaan,2023-02-16,13:00:00,51,31,20,FMN 11 A Jan Van Rijswijcklaan Ringfietspad
658,Ringfietspad Jan Van Rijswijcklaan,2023-02-16,14:00:00,58,32,26,FMN 11 A Jan Van Rijswijcklaan Ringfietspad
658,Ringfietspad Jan Van Rijswijcklaan,2023-02-16,15:00:00,91,63,28,FMN 11 A Jan Van Rijswijcklaan Ringfietspad
658,Ringfietspad Jan Van Rijswijcklaan,2023-02-16,16:00:00,137,92,45,FMN 11 A Jan Van Rijswijcklaan Ringfietspad
658,Ringfietspad Jan Van Rijswijcklaan,2023-02-16,17:00:00,121,79,42,FMN 11 A Jan Van Rijswijcklaan Ringfietspad
658,Ringfietspad Jan Van Rijswijcklaan,2023-02-16,18:00:00,83,55,28,FMN 11 A Jan Van Rijswijcklaan Ringfietspad
658,Ringfietspad Jan Van Rijswijcklaan,2023-02-16,19:00:00,43,27,16,FMN 11 A Jan Van Rijswijcklaan Ringfietspad
658,Ringfietspad Jan Van Rijswijcklaan,2023-02-16,20:00:00,28,13,15,FMN 11 A Jan Van Rijswijcklaan Ringfietspad
658,Ringfietspad Jan Van Rijswijcklaan,2023-02-16,21:00:00,24,12,12,FMN 11 A Jan Van Rijswijcklaan Ringfietspad
658,Ringfietspad Jan Van Rijswijcklaan,2023-02-16,22:00:00,25,18,7,FMN 11 A Jan Van Rijswijcklaan Ringfietspad
658,Ringfietspad Jan Van Rijswijcklaan,2023-02-16,23:00:00,6,4,2,FMN 11 A Jan Van Rijswijcklaan Ringfietspad
658,Ringfietspad Jan Van Rijswijcklaan,2023-02-17,00:00:00,2,2,0,FMN 11 A Jan Van Rijswijcklaan Ringfietspad
658,Ringfietspad Jan Van Rijswijcklaan,2023-02-17,01:00:00,3,1,2,FMN 11 A Jan Van Rijswijcklaan Ringfietspad
658,Ringfietspad Jan Van Rijswijcklaan,2023-02-17,02:00:00,1,1,0,FMN 11 A Jan Van Rijswijcklaan Ringfietspad
658,Ringfietspad Jan Van Rijswijcklaan,2023-02-17,03:00:00,2,1,1,FMN 11 A Jan Van Rijswijcklaan Ringfietspad
658,Ringfietspad Jan Van Rijswijcklaan,2023-02-17,04:00:00,2,0,2,FMN 11 A Jan Van Rijswijcklaan Ringfietspad
658,Ringfietspad Jan Van Rijswijcklaan,2023-02-17,05:00:00,20,8,12,FMN 11 A Jan Van Rijswijcklaan Ringfietspad
658,Ringfietspad Jan Van Rijswijcklaan,2023-02-17,06:00:00,57,11,46,FMN 11 A Jan Van Rijswijcklaan Ringfietspad
658,Ringfietspad Jan Van Rijswijcklaan,2023-02-17,07:00:00,85,26,59,FMN 11 A Jan Van Rijswijcklaan Ringfietspad
658,Ringfietspad Jan Van Rijswijcklaan,2023-02-17,08:00:00,143,41,102,FMN 11 A Jan Van Rijswijcklaan Ringfietspad
658,Ringfietspad Jan Van Rijswijcklaan,2023-02-17,09:00:00,53,20,33,FMN 11 A Jan Van Rijswijcklaan Ringfietspad
658,Ringfietspad Jan Van Rijswijcklaan,2023-02-17,10:00:00,35,12,23,FMN 11 A Jan Van Rijswijcklaan Ringfietspad
658,Ringfietspad Jan Van Rijswijcklaan,2023-02-17,11:00:00,42,18,24,FMN 11 A Jan Van Rijswijcklaan Ringfietspad
658,Ringfietspad Jan Van Rijswijcklaan,2023-02-17,12:00:00,60,29,31,FMN 11 A Jan Van Rijswijcklaan Ringfietspad
658,Ringfietspad Jan Van Rijswijcklaan,2023-02-17,13:00:00,59,34,25,FMN 11 A Jan Van Rijswijcklaan Ringfietspad
658,Ringfietspad Jan Van Rijswijcklaan,2023-02-17,14:00:00,66,37,29,FMN 11 A Jan Van Rijswijcklaan Ringfietspad
658,Ringfietspad Jan Van Rijswijcklaan,2023-02-17,15:00:00,102,70,32,FMN 11 A Jan Van Rijswijcklaan Ringfietspad
658,Ringfietspad Jan Van Rijswijcklaan,2023-02-17,16:00:00,122,80,42,FMN 11 A Jan Van Rijswijcklaan Ringfietspad
658,Ringfietspad Jan Van Rijswijcklaan,2023-02-17,17:00:00,106,73,33,FMN 11 A Jan Van Rijswijcklaan Ringfietspad
658,Ringfietspad Jan Van Rijswijcklaan,2023-02-17,18:00:00,72,44,28,FMN 11 A Jan Van Rijswijcklaan Ringfietspad
658,Ringfietspad Jan Van Rijswijcklaan,2023-02-17,19:00:00,46,24,22,FMN 11 A Jan Van Rijswijcklaan Ringfietspad
658,Ringfietspad Jan Van Rijswijcklaan,2023-02-17,20:00:00,22,7,15,FMN 11 A Jan Van Rijswijcklaan Ringfietspad
658,Ringfietspad Jan Van Rijswijcklaan,2023-02-17,21:00:00,13,11,2,FMN 11 A Jan Van Rijswijcklaan Ringfietspad
658,Ringfietspad Jan Van Rijswijcklaan,2023-02-17,22:00:00,14,9,5,FMN 11 A Jan Van Rijswijcklaan Ringfietspad
658,Ringfietspad Jan Van Rijswijcklaan,2023-02-17,23:00:00,7,5,2,FMN 11 A Jan Van Rijswijcklaan Ringfietspad
658,Ringfietspad Jan Van Rijswijcklaan,2023-02-18,00:00:00,10,6,4,FMN 11 A Jan Van Rijswijcklaan Ringfietspad
658,Ringfietspad Jan Van Rijswijcklaan,2023-02-18,01:00:00,2,1,1,FMN 11 A Jan Van Rijswijcklaan Ringfietspad
658,Ringfietspad Jan Van Rijswijcklaan,2023-02-18,02:00:00,1,0,1,FMN 11 A Jan Van Rijswijcklaan Ringfietspad
658,Ringfietspad Jan Van Rijswijcklaan,2023-02-18,03:00:00,2,2,0,FMN 11 A Jan Van Rijswijcklaan Ringfietspad
658,Ringfietspad Jan Van Rijswijcklaan,2023-02-18,04:00:00,0,0,0,FMN 11 A Jan Van Rijswijcklaan Ringfietspad
658,Ringfietspad Jan Van Rijswijcklaan,2023-02-18,05:00:00,4,1,3,FMN 11 A Jan Van Rijswijcklaan Ringfietspad
658,Ringfietspad Jan Van Rijswijcklaan,2023-02-18,06:00:00,6,4,2,FMN 11 A Jan Van Rijswijcklaan Ringfietspad
658,Ringfietspad Jan Van Rijswijcklaan,2023-02-18,07:00:00,7,4,3,FMN 11 A Jan Van Rijswijcklaan Ringfietspad
658,Ringfietspad Jan Van Rijswijcklaan,2023-02-18,08:00:00,11,5,6,FMN 11 A Jan Van Rijswijcklaan Ringfietspad
658,Ringfietspad Jan Van Rijswijcklaan,2023-02-18,09:00:00,27,13,14,FMN 11 A Jan Van Rijswijcklaan Ringfietspad
658,Ringfietspad Jan Van Rijswijcklaan,2023-02-18,10:00:00,28,14,14,FMN 11 A Jan Van Rijswijcklaan Ringfietspad
658,Ringfietspad Jan Van Rijswijcklaan,2023-02-18,11:00:00,37,12,25,FMN 11 A Jan Van Rijswijcklaan Ringfietspad
658,Ringfietspad Jan Van Rijswijcklaan,2023-02-18,12:00:00,40,20,20,FMN 11 A Jan Van Rijswijcklaan Ringfietspad
658,Ringfietspad Jan Van Rijswijcklaan,2023-02-18,13:00:00,46,21,25,FMN 11 A Jan Van Rijswijcklaan Ringfietspad
658,Ringfietspad Jan Van Rijswijcklaan,2023-02-18,14:00:00,60,33,27,FMN 11 A Jan Van Rijswijcklaan Ringfietspad
658,Ringfietspad Jan Van Rijswijcklaan,2023-02-18,15:00:00,53,29,24,FMN 11 A Jan Van Rijswijcklaan Ringfietspad
658,Ringfietspad Jan Van Rijswijcklaan,2023-02-18,16:00:00,53,33,20,FMN 11 A Jan Van Rijswijcklaan Ringfietspad
658,Ringfietspad Jan Van Rijswijcklaan,2023-02-18,17:00:00,50,36,14,FMN 11 A Jan Van Rijswijcklaan Ringfietspad
658,Ringfietspad Jan Van Rijswijcklaan,2023-02-18,18:00:00,33,19,14,FMN 11 A Jan Van Rijswijcklaan Ringfietspad
658,Ringfietspad Jan Van Rijswijcklaan,2023-02-18,19:00:00,17,11,6,FMN 11 A Jan Van Rijswijcklaan Ringfietspad
658,Ringfietspad Jan Van Rijswijcklaan,2023-02-18,20:00:00,11,8,3,FMN 11 A Jan Van Rijswijcklaan Ringfietspad
658,Ringfietspad Jan Van Rijswijcklaan,2023-02-18,21:00:00,12,7,5,FMN 11 A Jan Van Rijswijcklaan Ringfietspad
658,Ringfietspad Jan Van Rijswijcklaan,2023-02-18,22:00:00,10,3,7,FMN 11 A Jan Van Rijswijcklaan Ringfietspad
658,Ringfietspad Jan Van Rijswijcklaan,2023-02-18,23:00:00,6,1,5,FMN 11 A Jan Van Rijswijcklaan Ringfietspad
658,Ringfietspad Jan Van Rijswijcklaan,2023-02-19,00:00:00,1,0,1,FMN 11 A Jan Van Rijswijcklaan Ringfietspad
658,Ringfietspad Jan Van Rijswijcklaan,2023-02-19,01:00:00,3,2,1,FMN 11 A Jan Van Rijswijcklaan Ringfietspad
658,Ringfietspad Jan Van Rijswijcklaan,2023-02-19,02:00:00,2,1,1,FMN 11 A Jan Van Rijswijcklaan Ringfietspad
658,Ringfietspad Jan Van Rijswijcklaan,2023-02-19,03:00:00,0,0,0,FMN 11 A Jan Van Rijswijcklaan Ringfietspad
658,Ringfietspad Jan Van Rijswijcklaan,2023-02-19,04:00:00,0,0,0,FMN 11 A Jan Van Rijswijcklaan Ringfietspad
658,Ringfietspad Jan Van Rijswijcklaan,2023-02-19,05:00:00,2,1,1,FMN 11 A Jan Van Rijswijcklaan Ringfietspad
658,Ringfietspad Jan Van Rijswijcklaan,2023-02-19,06:00:00,1,0,1,FMN 11 A Jan Van Rijswijcklaan Ringfietspad
658,Ringfietspad Jan Van Rijswijcklaan,2023-02-19,07:00:00,6,1,5,FMN 11 A Jan Van Rijswijcklaan Ringfietspad
658,Ringfietspad Jan Van Rijswijcklaan,2023-02-19,08:00:00,8,1,7,FMN 11 A Jan Van Rijswijcklaan Ringfietspad
658,Ringfietspad Jan Van Rijswijcklaan,2023-02-19,09:00:00,22,10,12,FMN 11 A Jan Van Rijswijcklaan Ringfietspad
658,Ringfietspad Jan Van Rijswijcklaan,2023-02-19,10:00:00,33,16,17,FMN 11 A Jan Van Rijswijcklaan Ringfietspad
658,Ringfietspad Jan Van Rijswijcklaan,2023-02-19,11:00:00,31,14,17,FMN 11 A Jan Van Rijswijcklaan Ringfietspad
658,Ringfietspad Jan Van Rijswijcklaan,2023-02-19,12:00:00,39,16,23,FMN 11 A Jan Van Rijswijcklaan Ringfietspad
658,Ringfietspad Jan Van Rijswijcklaan,2023-02-19,13:00:00,39,20,19,FMN 11 A Jan Van Rijswijcklaan Ringfietspad
658,Ringfietspad Jan Van Rijswijcklaan,2023-02-19,14:00:00,53,31,22,FMN 11 A Jan Van Rijswijcklaan Ringfietspad
658,Ringfietspad Jan Van Rijswijcklaan,2023-02-19,15:00:00,48,25,23,FMN 11 A Jan Van Rijswijcklaan Ringfietspad
658,Ringfietspad Jan Van Rijswijcklaan,2023-02-19,16:00:00,46,29,17,FMN 11 A Jan Van Rijswijcklaan Ringfietspad
658,Ringfietspad Jan Van Rijswijcklaan,2023-02-19,17:00:00,29,20,9,FMN 11 A Jan Van Rijswijcklaan Ringfietspad
658,Ringfietspad Jan Van Rijswijcklaan,2023-02-19,18:00:00,22,15,7,FMN 11 A Jan Van Rijswijcklaan Ringfietspad
658,Ringfietspad Jan Van Rijswijcklaan,2023-02-19,19:00:00,14,10,4,FMN 11 A Jan Van Rijswijcklaan Ringfietspad
658,Ringfietspad Jan Van Rijswijcklaan,2023-02-19,20:00:00,14,7,7,FMN 11 A Jan Van Rijswijcklaan Ringfietspad
658,Ringfietspad Jan Van Rijswijcklaan,2023-02-19,21:00:00,7,4,3,FMN 11 A Jan Van Rijswijcklaan Ringfietspad
658,Ringfietspad Jan Van Rijswijcklaan,2023-02-19,22:00:00,9,6,3,FMN 11 A Jan Van Rijswijcklaan Ringfietspad
658,Ringfietspad Jan Van Rijswijcklaan,2023-02-19,23:00:00,3,1,2,FMN 11 A Jan Van Rijswijcklaan Ringfietspad
658,Ringfietspad Jan Van Rijswijcklaan,2023-02-20,00:00:00,2,2,0,FMN 11 A Jan Van Rijswijcklaan Ringfietspad
658,Ringfietspad Jan Van Rijswijcklaan,2023-02-20,01:00:00,0,0,0,FMN 11 A Jan Van Rijswijcklaan Ringfietspad
658,Ringfietspad Jan Van Rijswijcklaan,2023-02-20,02:00:00,0,0,0,FMN 11 A Jan Van Rijswijcklaan Ringfietspad
658,Ringfietspad Jan Van Rijswijcklaan,2023-02-20,03:00:00,1,1,0,FMN 11 A Jan Van Rijswijcklaan Ringfietspad
658,Ringfietspad Jan Van Rijswijcklaan,2023-02-20,04:00:00,9,2,7,FMN 11 A Jan Van Rijswijcklaan Ringfietspad
658,Ringfietspad Jan Van Rijswijcklaan,2023-02-20,05:00:00,19,3,16,FMN 11 A Jan Van Rijswijcklaan Ringfietspad
658,Ringfietspad Jan Van Rijswijcklaan,2023-02-20,06:00:00,43,10,33,FMN 11 A Jan Van Rijswijcklaan Ringfietspad
658,Ringfietspad Jan Van Rijswijcklaan,2023-02-20,07:00:00,79,23,56,FMN 11 A Jan Van Rijswijcklaan Ringfietspad
658,Ringfietspad Jan Van Rijswijcklaan,2023-02-20,08:00:00,97,27,70,FMN 11 A Jan Van Rijswijcklaan Ringfietspad
658,Ringfietspad Jan Van Rijswijcklaan,2023-02-20,09:00:00,46,15,31,FMN 11 A Jan Van Rijswijcklaan Ringfietspad
658,Ringfietspad Jan Van Rijswijcklaan,2023-02-20,10:00:00,28,14,14,FMN 11 A Jan Van Rijswijcklaan Ringfietspad
658,Ringfietspad Jan Van Rijswijcklaan,2023-02-20,11:00:00,26,13,13,FMN 11 A Jan Van Rijswijcklaan Ringfietspad
658,Ringfietspad Jan Van Rijswijcklaan,2023-02-20,12:00:00,46,21,25,FMN 11 A Jan Van Rijswijcklaan Ringfietspad
658,Ringfietspad Jan Van Rijswijcklaan,2023-02-20,13:00:00,43,22,21,FMN 11 A Jan Van Rijswijcklaan Ringfietspad
658,Ringfietspad Jan Van Rijswijcklaan,2023-02-20,14:00:00,31,17,14,FMN 11 A Jan Van Rijswijcklaan Ringfietspad
658,Ringfietspad Jan Van Rijswijcklaan,2023-02-20,15:00:00,61,42,19,FMN 11 A Jan Van Rijswijcklaan Ringfietspad
658,Ringfietspad Jan Van Rijswijcklaan,2023-02-20,16:00:00,91,63,28,FMN 11 A Jan Van Rijswijcklaan Ringfietspad
658,Ringfietspad Jan Van Rijswijcklaan,2023-02-20,17:00:00,114,70,44,FMN 11 A Jan Van Rijswijcklaan Ringfietspad
658,Ringfietspad Jan Van Rijswijcklaan,2023-02-20,18:00:00,68,50,18,FMN 11 A Jan Van Rijswijcklaan Ringfietspad
658,Ringfietspad Jan Van Rijswijcklaan,2023-02-20,19:00:00,28,15,13,FMN 11 A Jan Van Rijswijcklaan Ringfietspad
658,Ringfietspad Jan Van Rijswijcklaan,2023-02-20,20:00:00,19,9,10,FMN 11 A Jan Van Rijswijcklaan Ringfietspad
658,Ringfietspad Jan Van Rijswijcklaan,2023-02-20,21:00:00,7,1,6,FMN 11 A Jan Van Rijswijcklaan Ringfietspad
658,Ringfietspad Jan Van Rijswijcklaan,2023-02-20,22:00:00,15,11,4,FMN 11 A Jan Van Rijswijcklaan Ringfietspad
658,Ringfietspad Jan Van Rijswijcklaan,2023-02-20,23:00:00,2,1,1,FMN 11 A Jan Van Rijswijcklaan Ringfietspad
658,Ringfietspad Jan Van Rijswijcklaan,2023-02-21,00:00:00,0,0,0,FMN 11 A Jan Van Rijswijcklaan Ringfietspad
658,Ringfietspad Jan Van Rijswijcklaan,2023-02-21,01:00:00,2,0,2,FMN 11 A Jan Van Rijswijcklaan Ringfietspad
658,Ringfietspad Jan Van Rijswijcklaan,2023-02-21,02:00:00,0,0,0,FMN 11 A Jan Van Rijswijcklaan Ringfietspad
658,Ringfietspad Jan Van Rijswijcklaan,2023-02-21,03:00:00,2,2,0,FMN 11 A Jan Van Rijswijcklaan Ringfietspad
658,Ringfietspad Jan Van Rijswijcklaan,2023-02-21,04:00:00,6,4,2,FMN 11 A Jan Van Rijswijcklaan Ringfietspad
658,Ringfietspad Jan Van Rijswijcklaan,2023-02-21,05:00:00,15,3,12,FMN 11 A Jan Van Rijswijcklaan Ringfietspad
658,Ringfietspad Jan Van Rijswijcklaan,2023-02-21,06:00:00,43,7,36,FMN 11 A Jan Van Rijswijcklaan Ringfietspad
658,Ringfietspad Jan Van Rijswijcklaan,2023-02-21,07:00:00,96,38,58,FMN 11 A Jan Van Rijswijcklaan Ringfietspad
658,Ringfietspad Jan Van Rijswijcklaan,2023-02-21,08:00:00,123,42,81,FMN 11 A Jan Van Rijswijcklaan Ringfietspad
658,Ringfietspad Jan Van Rijswijcklaan,2023-02-21,09:00:00,40,12,28,FMN 11 A Jan Van Rijswijcklaan Ringfietspad
658,Ringfietspad Jan Van Rijswijcklaan,2023-02-21,10:00:00,29,11,18,FMN 11 A Jan Van Rijswijcklaan Ringfietspad
658,Ringfietspad Jan Van Rijswijcklaan,2023-02-21,11:00:00,31,15,16,FMN 11 A Jan Van Rijswijcklaan Ringfietspad
658,Ringfietspad Jan Van Rijswijcklaan,2023-02-21,12:00:00,37,22,15,FMN 11 A Jan Van Rijswijcklaan Ringfietspad
658,Ringfietspad Jan Van Rijswijcklaan,2023-02-21,13:00:00,48,24,24,FMN 11 A Jan Van Rijswijcklaan Ringfietspad
658,Ringfietspad Jan Van Rijswijcklaan,2023-02-21,14:00:00,37,14,23,FMN 11 A Jan Van Rijswijcklaan Ringfietspad
658,Ringfietspad Jan Van Rijswijcklaan,2023-02-21,15:00:00,67,49,18,FMN 11 A Jan Van Rijswijcklaan Ringfietspad
658,Ringfietspad Jan Van Rijswijcklaan,2023-02-21,16:00:00,112,73,39,FMN 11 A Jan Van Rijswijcklaan Ringfietspad
658,Ringfietspad Jan Van Rijswijcklaan,2023-02-21,17:00:00,122,78,44,FMN 11 A Jan Van Rijswijcklaan Ringfietspad
658,Ringfietspad Jan Van Rijswijcklaan,2023-02-21,18:00:00,71,50,21,FMN 11 A Jan Van Rijswijcklaan Ringfietspad
658,Ringfietspad Jan Van Rijswijcklaan,2023-02-21,19:00:00,29,18,11,FMN 11 A Jan Van Rijswijcklaan Ringfietspad
658,Ringfietspad Jan Van Rijswijcklaan,2023-02-21,20:00:00,21,8,13,FMN 11 A Jan Van Rijswijcklaan Ringfietspad
658,Ringfietspad Jan Van Rijswijcklaan,2023-02-21,21:00:00,11,6,5,FMN 11 A Jan Van Rijswijcklaan Ringfietspad
658,Ringfietspad Jan Van Rijswijcklaan,2023-02-21,22:00:00,12,7,5,FMN 11 A Jan Van Rijswijcklaan Ringfietspad
658,Ringfietspad Jan Van Rijswijcklaan,2023-02-21,23:00:00,8,6,2,FMN 11 A Jan Van Rijswijcklaan Ringfietspad
658,Ringfietspad Jan Van Rijswijcklaan,2023-02-22,00:00:00,2,1,1,FMN 11 A Jan Van Rijswijcklaan Ringfietspad
658,Ringfietspad Jan Van Rijswijcklaan,2023-02-22,01:00:00,0,0,0,FMN 11 A Jan Van Rijswijcklaan Ringfietspad
658,Ringfietspad Jan Van Rijswijcklaan,2023-02-22,02:00:00,1,1,0,FMN 11 A Jan Van Rijswijcklaan Ringfietspad
658,Ringfietspad Jan Van Rijswijcklaan,2023-02-22,03:00:00,1,0,1,FMN 11 A Jan Van Rijswijcklaan Ringfietspad
658,Ringfietspad Jan Van Rijswijcklaan,2023-02-22,04:00:00,4,1,3,FMN 11 A Jan Van Rijswijcklaan Ringfietspad
658,Ringfietspad Jan Van Rijswijcklaan,2023-02-22,05:00:00,14,6,8,FMN 11 A Jan Van Rijswijcklaan Ringfietspad
658,Ringfietspad Jan Van Rijswijcklaan,2023-02-22,06:00:00,40,9,31,FMN 11 A Jan Van Rijswijcklaan Ringfietspad
658,Ringfietspad Jan Van Rijswijcklaan,2023-02-22,07:00:00,82,37,45,FMN 11 A Jan Van Rijswijcklaan Ringfietspad
658,Ringfietspad Jan Van Rijswijcklaan,2023-02-22,08:00:00,100,37,63,FMN 11 A Jan Van Rijswijcklaan Ringfietspad
658,Ringfietspad Jan Van Rijswijcklaan,2023-02-22,09:00:00,33,10,23,FMN 11 A Jan Van Rijswijcklaan Ringfietspad
658,Ringfietspad Jan Van Rijswijcklaan,2023-02-22,10:00:00,18,9,9,FMN 11 A Jan Van Rijswijcklaan Ringfietspad
658,Ringfietspad Jan Van Rijswijcklaan,2023-02-22,11:00:00,44,25,19,FMN 11 A Jan Van Rijswijcklaan Ringfietspad
658,Ringfietspad Jan Van Rijswijcklaan,2023-02-22,12:00:00,46,22,24,FMN 11 A Jan Van Rijswijcklaan Ringfietspad
658,Ringfietspad Jan Van Rijswijcklaan,2023-02-22,13:00:00,32,16,16,FMN 11 A Jan Van Rijswijcklaan Ringfietspad
658,Ringfietspad Jan Van Rijswijcklaan,2023-02-22,14:00:00,49,26,23,FMN 11 A Jan Van Rijswijcklaan Ringfietspad
658,Ringfietspad Jan Van Rijswijcklaan,2023-02-22,15:00:00,51,33,18,FMN 11 A Jan Van Rijswijcklaan Ringfietspad
658,Ringfietspad Jan Van Rijswijcklaan,2023-02-22,16:00:00,94,67,27,FMN 11 A Jan Van Rijswijcklaan Ringfietspad
658,Ringfietspad Jan Van Rijswijcklaan,2023-02-22,17:00:00,102,64,38,FMN 11 A Jan Van Rijswijcklaan Ringfietspad
658,Ringfietspad Jan Van Rijswijcklaan,2023-02-22,18:00:00,62,36,26,FMN 11 A Jan Van Rijswijcklaan Ringfietspad
658,Ringfietspad Jan Van Rijswijcklaan,2023-02-22,19:00:00,30,19,11,FMN 11 A Jan Van Rijswijcklaan Ringfietspad
658,Ringfietspad Jan Van Rijswijcklaan,2023-02-22,20:00:00,21,8,13,FMN 11 A Jan Van Rijswijcklaan Ringfietspad
658,Ringfietspad Jan Van Rijswijcklaan,2023-02-22,21:00:00,8,5,3,FMN 11 A Jan Van Rijswijcklaan Ringfietspad
658,Ringfietspad Jan Van Rijswijcklaan,2023-02-22,22:00:00,15,12,3,FMN 11 A Jan Van Rijswijcklaan Ringfietspad
658,Ringfietspad Jan Van Rijswijcklaan,2023-02-22,23:00:00,5,2,3,FMN 11 A Jan Van Rijswijcklaan Ringfietspad
658,Ringfietspad Jan Van Rijswijcklaan,2023-02-23,00:00:00,2,2,0,FMN 11 A Jan Van Rijswijcklaan Ringfietspad
658,Ringfietspad Jan Van Rijswijcklaan,2023-02-23,01:00:00,1,1,0,FMN 11 A Jan Van Rijswijcklaan Ringfietspad
658,Ringfietspad Jan Van Rijswijcklaan,2023-02-23,02:00:00,1,0,1,FMN 11 A Jan Van Rijswijcklaan Ringfietspad
658,Ringfietspad Jan Van Rijswijcklaan,2023-02-23,03:00:00,0,0,0,FMN 11 A Jan Van Rijswijcklaan Ringfietspad
658,Ringfietspad Jan Van Rijswijcklaan,2023-02-23,04:00:00,4,0,4,FMN 11 A Jan Van Rijswijcklaan Ringfietspad
658,Ringfietspad Jan Van Rijswijcklaan,2023-02-23,05:00:00,23,6,17,FMN 11 A Jan Van Rijswijcklaan Ringfietspad
658,Ringfietspad Jan Van Rijswijcklaan,2023-02-23,06:00:00,43,11,32,FMN 11 A Jan Van Rijswijcklaan Ringfietspad
658,Ringfietspad Jan Van Rijswijcklaan,2023-02-23,07:00:00,82,34,48,FMN 11 A Jan Van Rijswijcklaan Ringfietspad
658,Ringfietspad Jan Van Rijswijcklaan,2023-02-23,08:00:00,115,42,73,FMN 11 A Jan Van Rijswijcklaan Ringfietspad
658,Ringfietspad Jan Van Rijswijcklaan,2023-02-23,09:00:00,50,23,27,FMN 11 A Jan Van Rijswijcklaan Ringfietspad
658,Ringfietspad Jan Van Rijswijcklaan,2023-02-23,10:00:00,33,18,15,FMN 11 A Jan Van Rijswijcklaan Ringfietspad
658,Ringfietspad Jan Van Rijswijcklaan,2023-02-23,11:00:00,27,12,15,FMN 11 A Jan Van Rijswijcklaan Ringfietspad
658,Ringfietspad Jan Van Rijswijcklaan,2023-02-23,12:00:00,43,27,16,FMN 11 A Jan Van Rijswijcklaan Ringfietspad
658,Ringfietspad Jan Van Rijswijcklaan,2023-02-23,13:00:00,43,22,21,FMN 11 A Jan Van Rijswijcklaan Ringfietspad
658,Ringfietspad Jan Van Rijswijcklaan,2023-02-23,14:00:00,50,30,20,FMN 11 A Jan Van Rijswijcklaan Ringfietspad
658,Ringfietspad Jan Van Rijswijcklaan,2023-02-23,15:00:00,65,40,25,FMN 11 A Jan Van Rijswijcklaan Ringfietspad
658,Ringfietspad Jan Van Rijswijcklaan,2023-02-23,16:00:00,90,59,31,FMN 11 A Jan Van Rijswijcklaan Ringfietspad
658,Ringfietspad Jan Van Rijswijcklaan,2023-02-23,17:00:00,104,63,41,FMN 11 A Jan Van Rijswijcklaan Ringfietspad
658,Ringfietspad Jan Van Rijswijcklaan,2023-02-23,18:00:00,64,34,30,FMN 11 A Jan Van Rijswijcklaan Ringfietspad
658,Ringfietspad Jan Van Rijswijcklaan,2023-02-23,19:00:00,31,17,14,FMN 11 A Jan Van Rijswijcklaan Ringfietspad
658,Ringfietspad Jan Van Rijswijcklaan,2023-02-23,20:00:00,28,13,15,FMN 11 A Jan Van Rijswijcklaan Ringfietspad
658,Ringfietspad Jan Van Rijswijcklaan,2023-02-23,21:00:00,14,7,7,FMN 11 A Jan Van Rijswijcklaan Ringfietspad
658,Ringfietspad Jan Van Rijswijcklaan,2023-02-23,22:00:00,12,9,3,FMN 11 A Jan Van Rijswijcklaan Ringfietspad
658,Ringfietspad Jan Van Rijswijcklaan,2023-02-23,23:00:00,6,5,1,FMN 11 A Jan Van Rijswijcklaan Ringfietspad
658,Ringfietspad Jan Van Rijswijcklaan,2023-02-24,00:00:00,5,5,0,FMN 11 A Jan Van Rijswijcklaan Ringfietspad
658,Ringfietspad Jan Van Rijswijcklaan,2023-02-24,01:00:00,1,0,1,FMN 11 A Jan Van Rijswijcklaan Ringfietspad
658,Ringfietspad Jan Van Rijswijcklaan,2023-02-24,02:00:00,3,3,0,FMN 11 A Jan Van Rijswijcklaan Ringfietspad
658,Ringfietspad Jan Van Rijswijcklaan,2023-02-24,03:00:00,1,1,0,FMN 11 A Jan Van Rijswijcklaan Ringfietspad
658,Ringfietspad Jan Van Rijswijcklaan,2023-02-24,04:00:00,5,2,3,FMN 11 A Jan Van Rijswijcklaan Ringfietspad
658,Ringfietspad Jan Van Rijswijcklaan,2023-02-24,05:00:00,9,4,5,FMN 11 A Jan Van Rijswijcklaan Ringfietspad
658,Ringfietspad Jan Van Rijswijcklaan,2023-02-24,06:00:00,34,8,26,FMN 11 A Jan Van Rijswijcklaan Ringfietspad
658,Ringfietspad Jan Van Rijswijcklaan,2023-02-24,07:00:00,66,25,41,FMN 11 A Jan Van Rijswijcklaan Ringfietspad
658,Ringfietspad Jan Van Rijswijcklaan,2023-02-24,08:00:00,101,30,71,FMN 11 A Jan Van Rijswijcklaan Ringfietspad
658,Ringfietspad Jan Van Rijswijcklaan,2023-02-24,09:00:00,35,15,20,FMN 11 A Jan Van Rijswijcklaan Ringfietspad
658,Ringfietspad Jan Van Rijswijcklaan,2023-02-24,10:00:00,26,14,12,FMN 11 A Jan Van Rijswijcklaan Ringfietspad
658,Ringfietspad Jan Van Rijswijcklaan,2023-02-24,11:00:00,29,14,15,FMN 11 A Jan Van Rijswijcklaan Ringfietspad
658,Ringfietspad Jan Van Rijswijcklaan,2023-02-24,12:00:00,40,23,17,FMN 11 A Jan Van Rijswijcklaan Ringfietspad
658,Ringfietspad Jan Van Rijswijcklaan,2023-02-24,13:00:00,40,19,21,FMN 11 A Jan Van Rijswijcklaan Ringfietspad
658,Ringfietspad Jan Van Rijswijcklaan,2023-02-24,14:00:00,46,26,20,FMN 11 A Jan Van Rijswijcklaan Ringfietspad
658,Ringfietspad Jan Van Rijswijcklaan,2023-02-24,15:00:00,79,54,25,FMN 11 A Jan Van Rijswijcklaan Ringfietspad
658,Ringfietspad Jan Van Rijswijcklaan,2023-02-24,16:00:00,83,55,28,FMN 11 A Jan Van Rijswijcklaan Ringfietspad
658,Ringfietspad Jan Van Rijswijcklaan,2023-02-24,17:00:00,76,51,25,FMN 11 A Jan Van Rijswijcklaan Ringfietspad
658,Ringfietspad Jan Van Rijswijcklaan,2023-02-24,18:00:00,44,30,14,FMN 11 A Jan Van Rijswijcklaan Ringfietspad
658,Ringfietspad Jan Van Rijswijcklaan,2023-02-24,19:00:00,32,17,15,FMN 11 A Jan Van Rijswijcklaan Ringfietspad
658,Ringfietspad Jan Van Rijswijcklaan,2023-02-24,20:00:00,21,14,7,FMN 11 A Jan Van Rijswijcklaan Ringfietspad
658,Ringfietspad Jan Van Rijswijcklaan,2023-02-24,21:00:00,14,9,5,FMN 11 A Jan Van Rijswijcklaan Ringfietspad
658,Ringfietspad Jan Van Rijswijcklaan,2023-02-24,22:00:00,12,8,4,FMN 11 A Jan Van Rijswijcklaan Ringfietspad
658,Ringfietspad Jan Van Rijswijcklaan,2023-02-24,23:00:00,7,3,4,FMN 11 A Jan Van Rijswijcklaan Ringfietspad
658,Ringfietspad Jan Van Rijswijcklaan,2023-02-25,00:00:00,8,5,3,FMN 11 A Jan Van Rijswijcklaan Ringfietspad
658,Ringfietspad Jan Van Rijswijcklaan,2023-02-25,01:00:00,8,6,2,FMN 11 A Jan Van Rijswijcklaan Ringfietspad
658,Ringfietspad Jan Van Rijswijcklaan,2023-02-25,02:00:00,6,5,1,FMN 11 A Jan Van Rijswijcklaan Ringfietspad
658,Ringfietspad Jan Van Rijswijcklaan,2023-02-25,03:00:00,1,1,0,FMN 11 A Jan Van Rijswijcklaan Ringfietspad
658,Ringfietspad Jan Van Rijswijcklaan,2023-02-25,04:00:00,5,1,4,FMN 11 A Jan Van Rijswijcklaan Ringfietspad
658,Ringfietspad Jan Van Rijswijcklaan,2023-02-25,05:00:00,4,2,2,FMN 11 A Jan Van Rijswijcklaan Ringfietspad
658,Ringfietspad Jan Van Rijswijcklaan,2023-02-25,06:00:00,7,2,5,FMN 11 A Jan Van Rijswijcklaan Ringfietspad
658,Ringfietspad Jan Van Rijswijcklaan,2023-02-25,07:00:00,12,7,5,FMN 11 A Jan Van Rijswijcklaan Ringfietspad
658,Ringfietspad Jan Van Rijswijcklaan,2023-02-25,08:00:00,18,9,9,FMN 11 A Jan Van Rijswijcklaan Ringfietspad
658,Ringfietspad Jan Van Rijswijcklaan,2023-02-25,09:00:00,32,13,19,FMN 11 A Jan Van Rijswijcklaan Ringfietspad
658,Ringfietspad Jan Van Rijswijcklaan,2023-02-25,10:00:00,31,14,17,FMN 11 A Jan Van Rijswijcklaan Ringfietspad
658,Ringfietspad Jan Van Rijswijcklaan,2023-02-25,11:00:00,32,17,15,FMN 11 A Jan Van Rijswijcklaan Ringfietspad
658,Ringfietspad Jan Van Rijswijcklaan,2023-02-25,12:00:00,48,22,26,FMN 11 A Jan Van Rijswijcklaan Ringfietspad
658,Ringfietspad Jan Van Rijswijcklaan,2023-02-25,13:00:00,50,26,24,FMN 11 A Jan Van Rijswijcklaan Ringfietspad
658,Ringfietspad Jan Van Rijswijcklaan,2023-02-25,14:00:00,52,26,26,FMN 11 A Jan Van Rijswijcklaan Ringfietspad
658,Ringfietspad Jan Van Rijswijcklaan,2023-02-25,15:00:00,50,25,25,FMN 11 A Jan Van Rijswijcklaan Ringfietspad
658,Ringfietspad Jan Van Rijswijcklaan,2023-02-25,16:00:00,40,31,9,FMN 11 A Jan Van Rijswijcklaan Ringfietspad
658,Ringfietspad Jan Van Rijswijcklaan,2023-02-25,17:00:00,37,18,19,FMN 11 A Jan Van Rijswijcklaan Ringfietspad
658,Ringfietspad Jan Van Rijswijcklaan,2023-02-25,18:00:00,25,17,8,FMN 11 A Jan Van Rijswijcklaan Ringfietspad
658,Ringfietspad Jan Van Rijswijcklaan,2023-02-25,19:00:00,15,8,7,FMN 11 A Jan Van Rijswijcklaan Ringfietspad
658,Ringfietspad Jan Van Rijswijcklaan,2023-02-25,20:00:00,14,5,9,FMN 11 A Jan Van Rijswijcklaan Ringfietspad
658,Ringfietspad Jan Van Rijswijcklaan,2023-02-25,21:00:00,10,5,5,FMN 11 A Jan Van Rijswijcklaan Ringfietspad
658,Ringfietspad Jan Van Rijswijcklaan,2023-02-25,22:00:00,7,6,1,FMN 11 A Jan Van Rijswijcklaan Ringfietspad
658,Ringfietspad Jan Van Rijswijcklaan,2023-02-25,23:00:00,4,3,1,FMN 11 A Jan Van Rijswijcklaan Ringfietspad
658,Ringfietspad Jan Van Rijswijcklaan,2023-02-26,00:00:00,3,2,1,FMN 11 A Jan Van Rijswijcklaan Ringfietspad
658,Ringfietspad Jan Van Rijswijcklaan,2023-02-26,01:00:00,2,1,1,FMN 11 A Jan Van Rijswijcklaan Ringfietspad
658,Ringfietspad Jan Van Rijswijcklaan,2023-02-26,02:00:00,2,0,2,FMN 11 A Jan Van Rijswijcklaan Ringfietspad
658,Ringfietspad Jan Van Rijswijcklaan,2023-02-26,03:00:00,2,1,1,FMN 11 A Jan Van Rijswijcklaan Ringfietspad
658,Ringfietspad Jan Van Rijswijcklaan,2023-02-26,04:00:00,1,0,1,FMN 11 A Jan Van Rijswijcklaan Ringfietspad
658,Ringfietspad Jan Van Rijswijcklaan,2023-02-26,05:00:00,1,0,1,FMN 11 A Jan Van Rijswijcklaan Ringfietspad
658,Ringfietspad Jan Van Rijswijcklaan,2023-02-26,06:00:00,3,3,0,FMN 11 A Jan Van Rijswijcklaan Ringfietspad
658,Ringfietspad Jan Van Rijswijcklaan,2023-02-26,07:00:00,5,1,4,FMN 11 A Jan Van Rijswijcklaan Ringfietspad
658,Ringfietspad Jan Van Rijswijcklaan,2023-02-26,08:00:00,8,3,5,FMN 11 A Jan Van Rijswijcklaan Ringfietspad
658,Ringfietspad Jan Van Rijswijcklaan,2023-02-26,09:00:00,35,12,23,FMN 11 A Jan Van Rijswijcklaan Ringfietspad
658,Ringfietspad Jan Van Rijswijcklaan,2023-02-26,10:00:00,39,12,27,FMN 11 A Jan Van Rijswijcklaan Ringfietspad
658,Ringfietspad Jan Van Rijswijcklaan,2023-02-26,11:00:00,37,15,22,FMN 11 A Jan Van Rijswijcklaan Ringfietspad
658,Ringfietspad Jan Van Rijswijcklaan,2023-02-26,12:00:00,44,23,21,FMN 11 A Jan Van Rijswijcklaan Ringfietspad
658,Ringfietspad Jan Van Rijswijcklaan,2023-02-26,13:00:00,35,16,19,FMN 11 A Jan Van Rijswijcklaan Ringfietspad
658,Ringfietspad Jan Van Rijswijcklaan,2023-02-26,14:00:00,50,24,26,FMN 11 A Jan Van Rijswijcklaan Ringfietspad
658,Ringfietspad Jan Van Rijswijcklaan,2023-02-26,15:00:00,42,20,22,FMN 11 A Jan Van Rijswijcklaan Ringfietspad
658,Ringfietspad Jan Van Rijswijcklaan,2023-02-26,16:00:00,42,22,20,FMN 11 A Jan Van Rijswijcklaan Ringfietspad
658,Ringfietspad Jan Van Rijswijcklaan,2023-02-26,17:00:00,36,25,11,FMN 11 A Jan Van Rijswijcklaan Ringfietspad
658,Ringfietspad Jan Van Rijswijcklaan,2023-02-26,18:00:00,23,18,5,FMN 11 A Jan Van Rijswijcklaan Ringfietspad
658,Ringfietspad Jan Van Rijswijcklaan,2023-02-26,19:00:00,17,12,5,FMN 11 A Jan Van Rijswijcklaan Ringfietspad
658,Ringfietspad Jan Van Rijswijcklaan,2023-02-26,20:00:00,15,5,10,FMN 11 A Jan Van Rijswijcklaan Ringfietspad
658,Ringfietspad Jan Van Rijswijcklaan,2023-02-26,21:00:00,5,2,3,FMN 11 A Jan Van Rijswijcklaan Ringfietspad
658,Ringfietspad Jan Van Rijswijcklaan,2023-02-26,22:00:00,6,5,1,FMN 11 A Jan Van Rijswijcklaan Ringfietspad
658,Ringfietspad Jan Van Rijswijcklaan,2023-02-26,23:00:00,4,0,4,FMN 11 A Jan Van Rijswijcklaan Ringfietspad
658,Ringfietspad Jan Van Rijswijcklaan,2023-02-27,00:00:00,3,1,2,FMN 11 A Jan Van Rijswijcklaan Ringfietspad
658,Ringfietspad Jan Van Rijswijcklaan,2023-02-27,01:00:00,1,1,0,FMN 11 A Jan Van Rijswijcklaan Ringfietspad
658,Ringfietspad Jan Van Rijswijcklaan,2023-02-27,02:00:00,1,0,1,FMN 11 A Jan Van Rijswijcklaan Ringfietspad
658,Ringfietspad Jan Van Rijswijcklaan,2023-02-27,03:00:00,2,1,1,FMN 11 A Jan Van Rijswijcklaan Ringfietspad
658,Ringfietspad Jan Van Rijswijcklaan,2023-02-27,04:00:00,4,1,3,FMN 11 A Jan Van Rijswijcklaan Ringfietspad
658,Ringfietspad Jan Van Rijswijcklaan,2023-02-27,05:00:00,20,7,13,FMN 11 A Jan Van Rijswijcklaan Ringfietspad
658,Ringfietspad Jan Van Rijswijcklaan,2023-02-27,06:00:00,60,22,38,FMN 11 A Jan Van Rijswijcklaan Ringfietspad
658,Ringfietspad Jan Van Rijswijcklaan,2023-02-27,07:00:00,117,36,81,FMN 11 A Jan Van Rijswijcklaan Ringfietspad
658,Ringfietspad Jan Van Rijswijcklaan,2023-02-27,08:00:00,152,48,104,FMN 11 A Jan Van Rijswijcklaan Ringfietspad
658,Ringfietspad Jan Van Rijswijcklaan,2023-02-27,09:00:00,48,16,32,FMN 11 A Jan Van Rijswijcklaan Ringfietspad
658,Ringfietspad Jan Van Rijswijcklaan,2023-02-27,10:00:00,38,14,24,FMN 11 A Jan Van Rijswijcklaan Ringfietspad
658,Ringfietspad Jan Van Rijswijcklaan,2023-02-27,11:00:00,35,16,19,FMN 11 A Jan Van Rijswijcklaan Ringfietspad
658,Ringfietspad Jan Van Rijswijcklaan,2023-02-27,12:00:00,57,28,29,FMN 11 A Jan Van Rijswijcklaan Ringfietspad
658,Ringfietspad Jan Van Rijswijcklaan,2023-02-27,13:00:00,58,30,28,FMN 11 A Jan Van Rijswijcklaan Ringfietspad
658,Ringfietspad Jan Van Rijswijcklaan,2023-02-27,14:00:00,70,41,29,FMN 11 A Jan Van Rijswijcklaan Ringfietspad
658,Ringfietspad Jan Van Rijswijcklaan,2023-02-27,15:00:00,86,57,29,FMN 11 A Jan Van Rijswijcklaan Ringfietspad
658,Ringfietspad Jan Van Rijswijcklaan,2023-02-27,16:00:00,139,91,48,FMN 11 A Jan Van Rijswijcklaan Ringfietspad
658,Ringfietspad Jan Van Rijswijcklaan,2023-02-27,17:00:00,142,91,51,FMN 11 A Jan Van Rijswijcklaan Ringfietspad
658,Ringfietspad Jan Van Rijswijcklaan,2023-02-27,18:00:00,72,44,28,FMN 11 A Jan Van Rijswijcklaan Ringfietspad
658,Ringfietspad Jan Van Rijswijcklaan,2023-02-27,19:00:00,33,19,14,FMN 11 A Jan Van Rijswijcklaan Ringfietspad
658,Ringfietspad Jan Van Rijswijcklaan,2023-02-27,20:00:00,31,12,19,FMN 11 A Jan Van Rijswijcklaan Ringfietspad
658,Ringfietspad Jan Van Rijswijcklaan,2023-02-27,21:00:00,22,13,9,FMN 11 A Jan Van Rijswijcklaan Ringfietspad
658,Ringfietspad Jan Van Rijswijcklaan,2023-02-27,22:00:00,16,8,8,FMN 11 A Jan Van Rijswijcklaan Ringfietspad
658,Ringfietspad Jan Van Rijswijcklaan,2023-02-27,23:00:00,8,5,3,FMN 11 A Jan Van Rijswijcklaan Ringfietspad
658,Ringfietspad Jan Van Rijswijcklaan,2023-02-28,00:00:00,1,0,1,FMN 11 A Jan Van Rijswijcklaan Ringfietspad
658,Ringfietspad Jan Van Rijswijcklaan,2023-02-28,01:00:00,2,1,1,FMN 11 A Jan Van Rijswijcklaan Ringfietspad
658,Ringfietspad Jan Van Rijswijcklaan,2023-02-28,02:00:00,0,0,0,FMN 11 A Jan Van Rijswijcklaan Ringfietspad
658,Ringfietspad Jan Van Rijswijcklaan,2023-02-28,03:00:00,1,0,1,FMN 11 A Jan Van Rijswijcklaan Ringfietspad
658,Ringfietspad Jan Van Rijswijcklaan,2023-02-28,04:00:00,10,2,8,FMN 11 A Jan Van Rijswijcklaan Ringfietspad
658,Ringfietspad Jan Van Rijswijcklaan,2023-02-28,05:00:00,26,8,18,FMN 11 A Jan Van Rijswijcklaan Ringfietspad
658,Ringfietspad Jan Van Rijswijcklaan,2023-02-28,06:00:00,65,11,54,FMN 11 A Jan Van Rijswijcklaan Ringfietspad
658,Ringfietspad Jan Van Rijswijcklaan,2023-02-28,07:00:00,110,39,71,FMN 11 A Jan Van Rijswijcklaan Ringfietspad
658,Ringfietspad Jan Van Rijswijcklaan,2023-02-28,08:00:00,155,51,104,FMN 11 A Jan Van Rijswijcklaan Ringfietspad
658,Ringfietspad Jan Van Rijswijcklaan,2023-02-28,09:00:00,67,25,42,FMN 11 A Jan Van Rijswijcklaan Ringfietspad
658,Ringfietspad Jan Van Rijswijcklaan,2023-02-28,10:00:00,37,18,19,FMN 11 A Jan Van Rijswijcklaan Ringfietspad
658,Ringfietspad Jan Van Rijswijcklaan,2023-02-28,11:00:00,34,18,16,FMN 11 A Jan Van Rijswijcklaan Ringfietspad
658,Ringfietspad Jan Van Rijswijcklaan,2023-02-28,12:00:00,50,29,21,FMN 11 A Jan Van Rijswijcklaan Ringfietspad
658,Ringfietspad Jan Van Rijswijcklaan,2023-02-28,13:00:00,51,28,23,FMN 11 A Jan Van Rijswijcklaan Ringfietspad
658,Ringfietspad Jan Van Rijswijcklaan,2023-02-28,14:00:00,64,35,29,FMN 11 A Jan Van Rijswijcklaan Ringfietspad
658,Ringfietspad Jan Van Rijswijcklaan,2023-02-28,15:00:00,87,54,33,FMN 11 A Jan Van Rijswijcklaan Ringfietspad
658,Ringfietspad Jan Van Rijswijcklaan,2023-02-28,16:00:00,138,94,44,FMN 11 A Jan Van Rijswijcklaan Ringfietspad
658,Ringfietspad Jan Van Rijswijcklaan,2023-02-28,17:00:00,143,89,54,FMN 11 A Jan Van Rijswijcklaan Ringfietspad
658,Ringfietspad Jan Van Rijswijcklaan,2023-02-28,18:00:00,86,51,35,FMN 11 A Jan Van Rijswijcklaan Ringfietspad
658,Ringfietspad Jan Van Rijswijcklaan,2023-02-28,19:00:00,37,20,17,FMN 11 A Jan Van Rijswijcklaan Ringfietspad
658,Ringfietspad Jan Van Rijswijcklaan,2023-02-28,20:00:00,28,14,14,FMN 11 A Jan Van Rijswijcklaan Ringfietspad
658,Ringfietspad Jan Van Rijswijcklaan,2023-02-28,21:00:00,18,10,8,FMN 11 A Jan Van Rijswijcklaan Ringfietspad
658,Ringfietspad Jan Van Rijswijcklaan,2023-02-28,22:00:00,19,11,8,FMN 11 A Jan Van Rijswijcklaan Ringfietspad
658,Ringfietspad Jan Van Rijswijcklaan,2023-02-28,23:00:00,6,0,6,FMN 11 A Jan Van Rijswijcklaan Ringfietspad
658,Ringfietspad Jan Van Rijswijcklaan,2023-03-01,00:00:00,3,1,2,FMN 11 A Jan Van Rijswijcklaan Ringfietspad
658,Ringfietspad Jan Van Rijswijcklaan,2023-03-01,01:00:00,1,1,0,FMN 11 A Jan Van Rijswijcklaan Ringfietspad
658,Ringfietspad Jan Van Rijswijcklaan,2023-03-01,02:00:00,0,0,0,FMN 11 A Jan Van Rijswijcklaan Ringfietspad
658,Ringfietspad Jan Van Rijswijcklaan,2023-03-01,03:00:00,4,3,1,FMN 11 A Jan Van Rijswijcklaan Ringfietspad
658,Ringfietspad Jan Van Rijswijcklaan,2023-03-01,04:00:00,5,3,2,FMN 11 A Jan Van Rijswijcklaan Ringfietspad
658,Ringfietspad Jan Van Rijswijcklaan,2023-03-01,05:00:00,24,5,19,FMN 11 A Jan Van Rijswijcklaan Ringfietspad
658,Ringfietspad Jan Van Rijswijcklaan,2023-03-01,06:00:00,57,15,42,FMN 11 A Jan Van Rijswijcklaan Ringfietspad
658,Ringfietspad Jan Van Rijswijcklaan,2023-03-01,07:00:00,123,49,74,FMN 11 A Jan Van Rijswijcklaan Ringfietspad
658,Ringfietspad Jan Van Rijswijcklaan,2023-03-01,08:00:00,137,45,92,FMN 11 A Jan Van Rijswijcklaan Ringfietspad
658,Ringfietspad Jan Van Rijswijcklaan,2023-03-01,09:00:00,54,26,28,FMN 11 A Jan Van Rijswijcklaan Ringfietspad
658,Ringfietspad Jan Van Rijswijcklaan,2023-03-01,10:00:00,32,13,19,FMN 11 A Jan Van Rijswijcklaan Ringfietspad
658,Ringfietspad Jan Van Rijswijcklaan,2023-03-01,11:00:00,32,14,18,FMN 11 A Jan Van Rijswijcklaan Ringfietspad
658,Ringfietspad Jan Van Rijswijcklaan,2023-03-01,12:00:00,69,35,34,FMN 11 A Jan Van Rijswijcklaan Ringfietspad
658,Ringfietspad Jan Van Rijswijcklaan,2023-03-01,13:00:00,71,37,34,FMN 11 A Jan Van Rijswijcklaan Ringfietspad
658,Ringfietspad Jan Van Rijswijcklaan,2023-03-01,14:00:00,64,37,27,FMN 11 A Jan Van Rijswijcklaan Ringfietspad
658,Ringfietspad Jan Van Rijswijcklaan,2023-03-01,15:00:00,81,58,23,FMN 11 A Jan Van Rijswijcklaan Ringfietspad
658,Ringfietspad Jan Van Rijswijcklaan,2023-03-01,16:00:00,131,95,36,FMN 11 A Jan Van Rijswijcklaan Ringfietspad
658,Ringfietspad Jan Van Rijswijcklaan,2023-03-01,17:00:00,158,100,58,FMN 11 A Jan Van Rijswijcklaan Ringfietspad
658,Ringfietspad Jan Van Rijswijcklaan,2023-03-01,18:00:00,84,52,32,FMN 11 A Jan Van Rijswijcklaan Ringfietspad
658,Ringfietspad Jan Van Rijswijcklaan,2023-03-01,19:00:00,44,26,18,FMN 11 A Jan Van Rijswijcklaan Ringfietspad
658,Ringfietspad Jan Van Rijswijcklaan,2023-03-01,20:00:00,30,19,11,FMN 11 A Jan Van Rijswijcklaan Ringfietspad
658,Ringfietspad Jan Van Rijswijcklaan,2023-03-01,21:00:00,21,11,10,FMN 11 A Jan Van Rijswijcklaan Ringfietspad
658,Ringfietspad Jan Van Rijswijcklaan,2023-03-01,22:00:00,24,15,9,FMN 11 A Jan Van Rijswijcklaan Ringfietspad
658,Ringfietspad Jan Van Rijswijcklaan,2023-03-01,23:00:00,6,2,4,FMN 11 A Jan Van Rijswijcklaan Ringfietspad
658,Ringfietspad Jan Van Rijswijcklaan,2023-03-02,00:00:00,3,2,1,FMN 11 A Jan Van Rijswijcklaan Ringfietspad
658,Ringfietspad Jan Van Rijswijcklaan,2023-03-02,01:00:00,0,0,0,FMN 11 A Jan Van Rijswijcklaan Ringfietspad
658,Ringfietspad Jan Van Rijswijcklaan,2023-03-02,02:00:00,0,0,0,FMN 11 A Jan Van Rijswijcklaan Ringfietspad
658,Ringfietspad Jan Van Rijswijcklaan,2023-03-02,03:00:00,0,0,0,FMN 11 A Jan Van Rijswijcklaan Ringfietspad
658,Ringfietspad Jan Van Rijswijcklaan,2023-03-02,04:00:00,10,4,6,FMN 11 A Jan Van Rijswijcklaan Ringfietspad
658,Ringfietspad Jan Van Rijswijcklaan,2023-03-02,05:00:00,29,7,22,FMN 11 A Jan Van Rijswijcklaan Ringfietspad
658,Ringfietspad Jan Van Rijswijcklaan,2023-03-02,06:00:00,60,21,39,FMN 11 A Jan Van Rijswijcklaan Ringfietspad
658,Ringfietspad Jan Van Rijswijcklaan,2023-03-02,07:00:00,129,48,81,FMN 11 A Jan Van Rijswijcklaan Ringfietspad
658,Ringfietspad Jan Van Rijswijcklaan,2023-03-02,08:00:00,164,58,106,FMN 11 A Jan Van Rijswijcklaan Ringfietspad
658,Ringfietspad Jan Van Rijswijcklaan,2023-03-02,09:00:00,60,23,37,FMN 11 A Jan Van Rijswijcklaan Ringfietspad
658,Ringfietspad Jan Van Rijswijcklaan,2023-03-02,10:00:00,35,17,18,FMN 11 A Jan Van Rijswijcklaan Ringfietspad
658,Ringfietspad Jan Van Rijswijcklaan,2023-03-02,11:00:00,46,18,28,FMN 11 A Jan Van Rijswijcklaan Ringfietspad
658,Ringfietspad Jan Van Rijswijcklaan,2023-03-02,12:00:00,48,24,24,FMN 11 A Jan Van Rijswijcklaan Ringfietspad
658,Ringfietspad Jan Van Rijswijcklaan,2023-03-02,13:00:00,61,33,28,FMN 11 A Jan Van Rijswijcklaan Ringfietspad
658,Ringfietspad Jan Van Rijswijcklaan,2023-03-02,14:00:00,79,46,33,FMN 11 A Jan Van Rijswijcklaan Ringfietspad
658,Ringfietspad Jan Van Rijswijcklaan,2023-03-02,15:00:00,112,74,38,FMN 11 A Jan Van Rijswijcklaan Ringfietspad
658,Ringfietspad Jan Van Rijswijcklaan,2023-03-02,16:00:00,135,87,48,FMN 11 A Jan Van Rijswijcklaan Ringfietspad
658,Ringfietspad Jan Van Rijswijcklaan,2023-03-02,17:00:00,134,85,49,FMN 11 A Jan Van Rijswijcklaan Ringfietspad
658,Ringfietspad Jan Van Rijswijcklaan,2023-03-02,18:00:00,91,54,37,FMN 11 A Jan Van Rijswijcklaan Ringfietspad
658,Ringfietspad Jan Van Rijswijcklaan,2023-03-02,19:00:00,43,23,20,FMN 11 A Jan Van Rijswijcklaan Ringfietspad
658,Ringfietspad Jan Van Rijswijcklaan,2023-03-02,20:00:00,36,11,25,FMN 11 A Jan Van Rijswijcklaan Ringfietspad
658,Ringfietspad Jan Van Rijswijcklaan,2023-03-02,21:00:00,18,9,9,FMN 11 A Jan Van Rijswijcklaan Ringfietspad
658,Ringfietspad Jan Van Rijswijcklaan,2023-03-02,22:00:00,16,12,4,FMN 11 A Jan Van Rijswijcklaan Ringfietspad
658,Ringfietspad Jan Van Rijswijcklaan,2023-03-02,23:00:00,9,6,3,FMN 11 A Jan Van Rijswijcklaan Ringfietspad
658,Ringfietspad Jan Van Rijswijcklaan,2023-03-03,00:00:00,1,1,0,FMN 11 A Jan Van Rijswijcklaan Ringfietspad
658,Ringfietspad Jan Van Rijswijcklaan,2023-03-03,01:00:00,2,2,0,FMN 11 A Jan Van Rijswijcklaan Ringfietspad
658,Ringfietspad Jan Van Rijswijcklaan,2023-03-03,02:00:00,2,2,0,FMN 11 A Jan Van Rijswijcklaan Ringfietspad
658,Ringfietspad Jan Van Rijswijcklaan,2023-03-03,03:00:00,2,2,0,FMN 11 A Jan Van Rijswijcklaan Ringfietspad
658,Ringfietspad Jan Van Rijswijcklaan,2023-03-03,04:00:00,11,3,8,FMN 11 A Jan Van Rijswijcklaan Ringfietspad
658,Ringfietspad Jan Van Rijswijcklaan,2023-03-03,05:00:00,21,9,12,FMN 11 A Jan Van Rijswijcklaan Ringfietspad
658,Ringfietspad Jan Van Rijswijcklaan,2023-03-03,06:00:00,39,14,25,FMN 11 A Jan Van Rijswijcklaan Ringfietspad
658,Ringfietspad Jan Van Rijswijcklaan,2023-03-03,07:00:00,111,40,71,FMN 11 A Jan Van Rijswijcklaan Ringfietspad
658,Ringfietspad Jan Van Rijswijcklaan,2023-03-03,08:00:00,138,47,91,FMN 11 A Jan Van Rijswijcklaan Ringfietspad
658,Ringfietspad Jan Van Rijswijcklaan,2023-03-03,09:00:00,44,17,27,FMN 11 A Jan Van Rijswijcklaan Ringfietspad
658,Ringfietspad Jan Van Rijswijcklaan,2023-03-03,10:00:00,43,18,25,FMN 11 A Jan Van Rijswijcklaan Ringfietspad
658,Ringfietspad Jan Van Rijswijcklaan,2023-03-03,11:00:00,53,27,26,FMN 11 A Jan Van Rijswijcklaan Ringfietspad
658,Ringfietspad Jan Van Rijswijcklaan,2023-03-03,12:00:00,63,27,36,FMN 11 A Jan Van Rijswijcklaan Ringfietspad
658,Ringfietspad Jan Van Rijswijcklaan,2023-03-03,13:00:00,57,31,26,FMN 11 A Jan Van Rijswijcklaan Ringfietspad
658,Ringfietspad Jan Van Rijswijcklaan,2023-03-03,14:00:00,76,43,33,FMN 11 A Jan Van Rijswijcklaan Ringfietspad
658,Ringfietspad Jan Van Rijswijcklaan,2023-03-03,15:00:00,100,72,28,FMN 11 A Jan Van Rijswijcklaan Ringfietspad
658,Ringfietspad Jan Van Rijswijcklaan,2023-03-03,16:00:00,129,82,47,FMN 11 A Jan Van Rijswijcklaan Ringfietspad
658,Ringfietspad Jan Van Rijswijcklaan,2023-03-03,17:00:00,117,80,37,FMN 11 A Jan Van Rijswijcklaan Ringfietspad
658,Ringfietspad Jan Van Rijswijcklaan,2023-03-03,18:00:00,53,29,24,FMN 11 A Jan Van Rijswijcklaan Ringfietspad
658,Ringfietspad Jan Van Rijswijcklaan,2023-03-03,19:00:00,43,30,13,FMN 11 A Jan Van Rijswijcklaan Ringfietspad
658,Ringfietspad Jan Van Rijswijcklaan,2023-03-03,20:00:00,34,14,20,FMN 11 A Jan Van Rijswijcklaan Ringfietspad
658,Ringfietspad Jan Van Rijswijcklaan,2023-03-03,21:00:00,20,12,8,FMN 11 A Jan Van Rijswijcklaan Ringfietspad
658,Ringfietspad Jan Van Rijswijcklaan,2023-03-03,22:00:00,20,12,8,FMN 11 A Jan Van Rijswijcklaan Ringfietspad
658,Ringfietspad Jan Van Rijswijcklaan,2023-03-03,23:00:00,12,10,2,FMN 11 A Jan Van Rijswijcklaan Ringfietspad
658,Ringfietspad Jan Van Rijswijcklaan,2023-03-04,00:00:00,9,3,6,FMN 11 A Jan Van Rijswijcklaan Ringfietspad
658,Ringfietspad Jan Van Rijswijcklaan,2023-03-04,01:00:00,4,2,2,FMN 11 A Jan Van Rijswijcklaan Ringfietspad
658,Ringfietspad Jan Van Rijswijcklaan,2023-03-04,02:00:00,0,0,0,FMN 11 A Jan Van Rijswijcklaan Ringfietspad
658,Ringfietspad Jan Van Rijswijcklaan,2023-03-04,03:00:00,1,1,0,FMN 11 A Jan Van Rijswijcklaan Ringfietspad
658,Ringfietspad Jan Van Rijswijcklaan,2023-03-04,04:00:00,6,4,2,FMN 11 A Jan Van Rijswijcklaan Ringfietspad
658,Ringfietspad Jan Van Rijswijcklaan,2023-03-04,05:00:00,4,1,3,FMN 11 A Jan Van Rijswijcklaan Ringfietspad
658,Ringfietspad Jan Van Rijswijcklaan,2023-03-04,06:00:00,10,9,1,FMN 11 A Jan Van Rijswijcklaan Ringfietspad
658,Ringfietspad Jan Van Rijswijcklaan,2023-03-04,07:00:00,11,4,7,FMN 11 A Jan Van Rijswijcklaan Ringfietspad
658,Ringfietspad Jan Van Rijswijcklaan,2023-03-04,08:00:00,16,10,6,FMN 11 A Jan Van Rijswijcklaan Ringfietspad
658,Ringfietspad Jan Van Rijswijcklaan,2023-03-04,09:00:00,33,11,22,FMN 11 A Jan Van Rijswijcklaan Ringfietspad
658,Ringfietspad Jan Van Rijswijcklaan,2023-03-04,10:00:00,29,17,12,FMN 11 A Jan Van Rijswijcklaan Ringfietspad
658,Ringfietspad Jan Van Rijswijcklaan,2023-03-04,11:00:00,40,20,20,FMN 11 A Jan Van Rijswijcklaan Ringfietspad
658,Ringfietspad Jan Van Rijswijcklaan,2023-03-04,12:00:00,44,24,20,FMN 11 A Jan Van Rijswijcklaan Ringfietspad
658,Ringfietspad Jan Van Rijswijcklaan,2023-03-04,13:00:00,57,30,27,FMN 11 A Jan Van Rijswijcklaan Ringfietspad
658,Ringfietspad Jan Van Rijswijcklaan,2023-03-04,14:00:00,67,40,27,FMN 11 A Jan Van Rijswijcklaan Ringfietspad
658,Ringfietspad Jan Van Rijswijcklaan,2023-03-04,15:00:00,57,28,29,FMN 11 A Jan Van Rijswijcklaan Ringfietspad
658,Ringfietspad Jan Van Rijswijcklaan,2023-03-04,16:00:00,46,23,23,FMN 11 A Jan Van Rijswijcklaan Ringfietspad
658,Ringfietspad Jan Van Rijswijcklaan,2023-03-04,17:00:00,39,22,17,FMN 11 A Jan Van Rijswijcklaan Ringfietspad
658,Ringfietspad Jan Van Rijswijcklaan,2023-03-04,18:00:00,33,19,14,FMN 11 A Jan Van Rijswijcklaan Ringfietspad
658,Ringfietspad Jan Van Rijswijcklaan,2023-03-04,19:00:00,16,9,7,FMN 11 A Jan Van Rijswijcklaan Ringfietspad
658,Ringfietspad Jan Van Rijswijcklaan,2023-03-04,20:00:00,13,5,8,FMN 11 A Jan Van Rijswijcklaan Ringfietspad
658,Ringfietspad Jan Van Rijswijcklaan,2023-03-04,21:00:00,17,12,5,FMN 11 A Jan Van Rijswijcklaan Ringfietspad
658,Ringfietspad Jan Van Rijswijcklaan,2023-03-04,22:00:00,10,4,6,FMN 11 A Jan Van Rijswijcklaan Ringfietspad
658,Ringfietspad Jan Van Rijswijcklaan,2023-03-04,23:00:00,8,2,6,FMN 11 A Jan Van Rijswijcklaan Ringfietspad
658,Ringfietspad Jan Van Rijswijcklaan,2023-03-05,00:00:00,2,0,2,FMN 11 A Jan Van Rijswijcklaan Ringfietspad
658,Ringfietspad Jan Van Rijswijcklaan,2023-03-05,01:00:00,2,1,1,FMN 11 A Jan Van Rijswijcklaan Ringfietspad
658,Ringfietspad Jan Van Rijswijcklaan,2023-03-05,02:00:00,3,2,1,FMN 11 A Jan Van Rijswijcklaan Ringfietspad
658,Ringfietspad Jan Van Rijswijcklaan,2023-03-05,03:00:00,1,1,0,FMN 11 A Jan Van Rijswijcklaan Ringfietspad
658,Ringfietspad Jan Van Rijswijcklaan,2023-03-05,04:00:00,0,0,0,FMN 11 A Jan Van Rijswijcklaan Ringfietspad
658,Ringfietspad Jan Van Rijswijcklaan,2023-03-05,05:00:00,1,0,1,FMN 11 A Jan Van Rijswijcklaan Ringfietspad
658,Ringfietspad Jan Van Rijswijcklaan,2023-03-05,06:00:00,2,1,1,FMN 11 A Jan Van Rijswijcklaan Ringfietspad
658,Ringfietspad Jan Van Rijswijcklaan,2023-03-05,07:00:00,3,3,0,FMN 11 A Jan Van Rijswijcklaan Ringfietspad
658,Ringfietspad Jan Van Rijswijcklaan,2023-03-05,08:00:00,6,1,5,FMN 11 A Jan Van Rijswijcklaan Ringfietspad
658,Ringfietspad Jan Van Rijswijcklaan,2023-03-05,09:00:00,20,11,9,FMN 11 A Jan Van Rijswijcklaan Ringfietspad
658,Ringfietspad Jan Van Rijswijcklaan,2023-03-05,10:00:00,25,14,11,FMN 11 A Jan Van Rijswijcklaan Ringfietspad
658,Ringfietspad Jan Van Rijswijcklaan,2023-03-05,11:00:00,28,16,12,FMN 11 A Jan Van Rijswijcklaan Ringfietspad
658,Ringfietspad Jan Van Rijswijcklaan,2023-03-05,12:00:00,22,10,12,FMN 11 A Jan Van Rijswijcklaan Ringfietspad
658,Ringfietspad Jan Van Rijswijcklaan,2023-03-05,13:00:00,38,20,18,FMN 11 A Jan Van Rijswijcklaan Ringfietspad
658,Ringfietspad Jan Van Rijswijcklaan,2023-03-05,14:00:00,45,25,20,FMN 11 A Jan Van Rijswijcklaan Ringfietspad
658,Ringfietspad Jan Van Rijswijcklaan,2023-03-05,15:00:00,46,25,21,FMN 11 A Jan Van Rijswijcklaan Ringfietspad
658,Ringfietspad Jan Van Rijswijcklaan,2023-03-05,16:00:00,27,17,10,FMN 11 A Jan Van Rijswijcklaan Ringfietspad
658,Ringfietspad Jan Van Rijswijcklaan,2023-03-05,17:00:00,32,20,12,FMN 11 A Jan Van Rijswijcklaan Ringfietspad
658,Ringfietspad Jan Van Rijswijcklaan,2023-03-05,18:00:00,15,8,7,FMN 11 A Jan Van Rijswijcklaan Ringfietspad
658,Ringfietspad Jan Van Rijswijcklaan,2023-03-05,19:00:00,10,7,3,FMN 11 A Jan Van Rijswijcklaan Ringfietspad
658,Ringfietspad Jan Van Rijswijcklaan,2023-03-05,20:00:00,9,4,5,FMN 11 A Jan Van Rijswijcklaan Ringfietspad
658,Ringfietspad Jan Van Rijswijcklaan,2023-03-05,21:00:00,10,3,7,FMN 11 A Jan Van Rijswijcklaan Ringfietspad
658,Ringfietspad Jan Van Rijswijcklaan,2023-03-05,22:00:00,3,1,2,FMN 11 A Jan Van Rijswijcklaan Ringfietspad
658,Ringfietspad Jan Van Rijswijcklaan,2023-03-05,23:00:00,1,0,1,FMN 11 A Jan Van Rijswijcklaan Ringfietspad
658,Ringfietspad Jan Van Rijswijcklaan,2023-03-06,00:00:00,0,0,0,FMN 11 A Jan Van Rijswijcklaan Ringfietspad
658,Ringfietspad Jan Van Rijswijcklaan,2023-03-06,01:00:00,0,0,0,FMN 11 A Jan Van Rijswijcklaan Ringfietspad
658,Ringfietspad Jan Van Rijswijcklaan,2023-03-06,02:00:00,0,0,0,FMN 11 A Jan Van Rijswijcklaan Ringfietspad
658,Ringfietspad Jan Van Rijswijcklaan,2023-03-06,03:00:00,1,1,0,FMN 11 A Jan Van Rijswijcklaan Ringfietspad
658,Ringfietspad Jan Van Rijswijcklaan,2023-03-06,04:00:00,9,3,6,FMN 11 A Jan Van Rijswijcklaan Ringfietspad
658,Ringfietspad Jan Van Rijswijcklaan,2023-03-06,05:00:00,25,7,18,FMN 11 A Jan Van Rijswijcklaan Ringfietspad
658,Ringfietspad Jan Van Rijswijcklaan,2023-03-06,06:00:00,46,14,32,FMN 11 A Jan Van Rijswijcklaan Ringfietspad
658,Ringfietspad Jan Van Rijswijcklaan,2023-03-06,07:00:00,115,45,70,FMN 11 A Jan Van Rijswijcklaan Ringfietspad
658,Ringfietspad Jan Van Rijswijcklaan,2023-03-06,08:00:00,138,52,86,FMN 11 A Jan Van Rijswijcklaan Ringfietspad
658,Ringfietspad Jan Van Rijswijcklaan,2023-03-06,09:00:00,50,16,34,FMN 11 A Jan Van Rijswijcklaan Ringfietspad
658,Ringfietspad Jan Van Rijswijcklaan,2023-03-06,10:00:00,43,18,25,FMN 11 A Jan Van Rijswijcklaan Ringfietspad
658,Ringfietspad Jan Van Rijswijcklaan,2023-03-06,11:00:00,32,16,16,FMN 11 A Jan Van Rijswijcklaan Ringfietspad
658,Ringfietspad Jan Van Rijswijcklaan,2023-03-06,12:00:00,49,28,21,FMN 11 A Jan Van Rijswijcklaan Ringfietspad
658,Ringfietspad Jan Van Rijswijcklaan,2023-03-06,13:00:00,46,20,26,FMN 11 A Jan Van Rijswijcklaan Ringfietspad
658,Ringfietspad Jan Van Rijswijcklaan,2023-03-06,14:00:00,56,31,25,FMN 11 A Jan Van Rijswijcklaan Ringfietspad
658,Ringfietspad Jan Van Rijswijcklaan,2023-03-06,15:00:00,76,56,20,FMN 11 A Jan Van Rijswijcklaan Ringfietspad
658,Ringfietspad Jan Van Rijswijcklaan,2023-03-06,16:00:00,130,89,41,FMN 11 A Jan Van Rijswijcklaan Ringfietspad
658,Ringfietspad Jan Van Rijswijcklaan,2023-03-06,17:00:00,131,82,49,FMN 11 A Jan Van Rijswijcklaan Ringfietspad
658,Ringfietspad Jan Van Rijswijcklaan,2023-03-06,18:00:00,75,46,29,FMN 11 A Jan Van Rijswijcklaan Ringfietspad
658,Ringfietspad Jan Van Rijswijcklaan,2023-03-06,19:00:00,36,19,17,FMN 11 A Jan Van Rijswijcklaan Ringfietspad
658,Ringfietspad Jan Van Rijswijcklaan,2023-03-06,20:00:00,29,15,14,FMN 11 A Jan Van Rijswijcklaan Ringfietspad
658,Ringfietspad Jan Van Rijswijcklaan,2023-03-06,21:00:00,17,5,12,FMN 11 A Jan Van Rijswijcklaan Ringfietspad
658,Ringfietspad Jan Van Rijswijcklaan,2023-03-06,22:00:00,19,14,5,FMN 11 A Jan Van Rijswijcklaan Ringfietspad
658,Ringfietspad Jan Van Rijswijcklaan,2023-03-06,23:00:00,5,2,3,FMN 11 A Jan Van Rijswijcklaan Ringfietspad
658,Ringfietspad Jan Van Rijswijcklaan,2023-03-07,00:00:00,1,1,0,FMN 11 A Jan Van Rijswijcklaan Ringfietspad
658,Ringfietspad Jan Van Rijswijcklaan,2023-03-07,01:00:00,1,1,0,FMN 11 A Jan Van Rijswijcklaan Ringfietspad
658,Ringfietspad Jan Van Rijswijcklaan,2023-03-07,02:00:00,2,2,0,FMN 11 A Jan Van Rijswijcklaan Ringfietspad
658,Ringfietspad Jan Van Rijswijcklaan,2023-03-07,03:00:00,1,1,0,FMN 11 A Jan Van Rijswijcklaan Ringfietspad
658,Ringfietspad Jan Van Rijswijcklaan,2023-03-07,04:00:00,7,1,6,FMN 11 A Jan Van Rijswijcklaan Ringfietspad
658,Ringfietspad Jan Van Rijswijcklaan,2023-03-07,05:00:00,6,3,3,FMN 11 A Jan Van Rijswijcklaan Ringfietspad
658,Ringfietspad Jan Van Rijswijcklaan,2023-03-07,06:00:00,39,10,29,FMN 11 A Jan Van Rijswijcklaan Ringfietspad
658,Ringfietspad Jan Van Rijswijcklaan,2023-03-07,07:00:00,102,39,63,FMN 11 A Jan Van Rijswijcklaan Ringfietspad
658,Ringfietspad Jan Van Rijswijcklaan,2023-03-07,08:00:00,113,36,77,FMN 11 A Jan Van Rijswijcklaan Ringfietspad
658,Ringfietspad Jan Van Rijswijcklaan,2023-03-07,09:00:00,41,11,30,FMN 11 A Jan Van Rijswijcklaan Ringfietspad
658,Ringfietspad Jan Van Rijswijcklaan,2023-03-07,10:00:00,32,19,13,FMN 11 A Jan Van Rijswijcklaan Ringfietspad
658,Ringfietspad Jan Van Rijswijcklaan,2023-03-07,11:00:00,24,14,10,FMN 11 A Jan Van Rijswijcklaan Ringfietspad
658,Ringfietspad Jan Van Rijswijcklaan,2023-03-07,12:00:00,41,16,25,FMN 11 A Jan Van Rijswijcklaan Ringfietspad
658,Ringfietspad Jan Van Rijswijcklaan,2023-03-07,13:00:00,34,19,15,FMN 11 A Jan Van Rijswijcklaan Ringfietspad
658,Ringfietspad Jan Van Rijswijcklaan,2023-03-07,14:00:00,50,23,27,FMN 11 A Jan Van Rijswijcklaan Ringfietspad
658,Ringfietspad Jan Van Rijswijcklaan,2023-03-07,15:00:00,66,45,21,FMN 11 A Jan Van Rijswijcklaan Ringfietspad
658,Ringfietspad Jan Van Rijswijcklaan,2023-03-07,16:00:00,92,64,28,FMN 11 A Jan Van Rijswijcklaan Ringfietspad
658,Ringfietspad Jan Van Rijswijcklaan,2023-03-07,17:00:00,103,71,32,FMN 11 A Jan Van Rijswijcklaan Ringfietspad
658,Ringfietspad Jan Van Rijswijcklaan,2023-03-07,18:00:00,73,47,26,FMN 11 A Jan Van Rijswijcklaan Ringfietspad
658,Ringfietspad Jan Van Rijswijcklaan,2023-03-07,19:00:00,31,14,17,FMN 11 A Jan Van Rijswijcklaan Ringfietspad
658,Ringfietspad Jan Van Rijswijcklaan,2023-03-07,20:00:00,18,10,8,FMN 11 A Jan Van Rijswijcklaan Ringfietspad
658,Ringfietspad Jan Van Rijswijcklaan,2023-03-07,21:00:00,14,8,6,FMN 11 A Jan Van Rijswijcklaan Ringfietspad
658,Ringfietspad Jan Van Rijswijcklaan,2023-03-07,22:00:00,15,10,5,FMN 11 A Jan Van Rijswijcklaan Ringfietspad
658,Ringfietspad Jan Van Rijswijcklaan,2023-03-07,23:00:00,6,2,4,FMN 11 A Jan Van Rijswijcklaan Ringfietspad
658,Ringfietspad Jan Van Rijswijcklaan,2023-03-08,00:00:00,0,0,0,FMN 11 A Jan Van Rijswijcklaan Ringfietspad
658,Ringfietspad Jan Van Rijswijcklaan,2023-03-08,01:00:00,0,0,0,FMN 11 A Jan Van Rijswijcklaan Ringfietspad
658,Ringfietspad Jan Van Rijswijcklaan,2023-03-08,02:00:00,3,2,1,FMN 11 A Jan Van Rijswijcklaan Ringfietspad
658,Ringfietspad Jan Van Rijswijcklaan,2023-03-08,03:00:00,2,2,0,FMN 11 A Jan Van Rijswijcklaan Ringfietspad
658,Ringfietspad Jan Van Rijswijcklaan,2023-03-08,04:00:00,3,1,2,FMN 11 A Jan Van Rijswijcklaan Ringfietspad
658,Ringfietspad Jan Van Rijswijcklaan,2023-03-08,05:00:00,19,7,12,FMN 11 A Jan Van Rijswijcklaan Ringfietspad
658,Ringfietspad Jan Van Rijswijcklaan,2023-03-08,06:00:00,35,8,27,FMN 11 A Jan Van Rijswijcklaan Ringfietspad
658,Ringfietspad Jan Van Rijswijcklaan,2023-03-08,07:00:00,63,26,37,FMN 11 A Jan Van Rijswijcklaan Ringfietspad
658,Ringfietspad Jan Van Rijswijcklaan,2023-03-08,08:00:00,70,23,47,FMN 11 A Jan Van Rijswijcklaan Ringfietspad
658,Ringfietspad Jan Van Rijswijcklaan,2023-03-08,09:00:00,28,8,20,FMN 11 A Jan Van Rijswijcklaan Ringfietspad
658,Ringfietspad Jan Van Rijswijcklaan,2023-03-08,10:00:00,23,8,15,FMN 11 A Jan Van Rijswijcklaan Ringfietspad
658,Ringfietspad Jan Van Rijswijcklaan,2023-03-08,11:00:00,26,10,16,FMN 11 A Jan Van Rijswijcklaan Ringfietspad
658,Ringfietspad Jan Van Rijswijcklaan,2023-03-08,12:00:00,32,19,13,FMN 11 A Jan Van Rijswijcklaan Ringfietspad
658,Ringfietspad Jan Van Rijswijcklaan,2023-03-08,13:00:00,32,13,19,FMN 11 A Jan Van Rijswijcklaan Ringfietspad
658,Ringfietspad Jan Van Rijswijcklaan,2023-03-08,14:00:00,30,14,16,FMN 11 A Jan Van Rijswijcklaan Ringfietspad
658,Ringfietspad Jan Van Rijswijcklaan,2023-03-08,15:00:00,45,29,16,FMN 11 A Jan Van Rijswijcklaan Ringfietspad
658,Ringfietspad Jan Van Rijswijcklaan,2023-03-08,16:00:00,75,55,20,FMN 11 A Jan Van Rijswijcklaan Ringfietspad
658,Ringfietspad Jan Van Rijswijcklaan,2023-03-08,17:00:00,92,60,32,FMN 11 A Jan Van Rijswijcklaan Ringfietspad
658,Ringfietspad Jan Van Rijswijcklaan,2023-03-08,18:00:00,44,26,18,FMN 11 A Jan Van Rijswijcklaan Ringfietspad
658,Ringfietspad Jan Van Rijswijcklaan,2023-03-08,19:00:00,34,16,18,FMN 11 A Jan Van Rijswijcklaan Ringfietspad
658,Ringfietspad Jan Van Rijswijcklaan,2023-03-08,20:00:00,23,9,14,FMN 11 A Jan Van Rijswijcklaan Ringfietspad
658,Ringfietspad Jan Van Rijswijcklaan,2023-03-08,21:00:00,24,10,14,FMN 11 A Jan Van Rijswijcklaan Ringfietspad
658,Ringfietspad Jan Van Rijswijcklaan,2023-03-08,22:00:00,9,4,5,FMN 11 A Jan Van Rijswijcklaan Ringfietspad
658,Ringfietspad Jan Van Rijswijcklaan,2023-03-08,23:00:00,8,3,5,FMN 11 A Jan Van Rijswijcklaan Ringfietspad
658,Ringfietspad Jan Van Rijswijcklaan,2023-03-09,00:00:00,3,2,1,FMN 11 A Jan Van Rijswijcklaan Ringfietspad
658,Ringfietspad Jan Van Rijswijcklaan,2023-03-09,01:00:00,1,0,1,FMN 11 A Jan Van Rijswijcklaan Ringfietspad
658,Ringfietspad Jan Van Rijswijcklaan,2023-03-09,02:00:00,0,0,0,FMN 11 A Jan Van Rijswijcklaan Ringfietspad
658,Ringfietspad Jan Van Rijswijcklaan,2023-03-09,03:00:00,3,1,2,FMN 11 A Jan Van Rijswijcklaan Ringfietspad
658,Ringfietspad Jan Van Rijswijcklaan,2023-03-09,04:00:00,3,2,1,FMN 11 A Jan Van Rijswijcklaan Ringfietspad
658,Ringfietspad Jan Van Rijswijcklaan,2023-03-09,05:00:00,19,5,14,FMN 11 A Jan Van Rijswijcklaan Ringfietspad
658,Ringfietspad Jan Van Rijswijcklaan,2023-03-09,06:00:00,53,15,38,FMN 11 A Jan Van Rijswijcklaan Ringfietspad
658,Ringfietspad Jan Van Rijswijcklaan,2023-03-09,07:00:00,90,32,58,FMN 11 A Jan Van Rijswijcklaan Ringfietspad
658,Ringfietspad Jan Van Rijswijcklaan,2023-03-09,08:00:00,130,46,84,FMN 11 A Jan Van Rijswijcklaan Ringfietspad
658,Ringfietspad Jan Van Rijswijcklaan,2023-03-09,09:00:00,50,18,32,FMN 11 A Jan Van Rijswijcklaan Ringfietspad
658,Ringfietspad Jan Van Rijswijcklaan,2023-03-09,10:00:00,28,12,16,FMN 11 A Jan Van Rijswijcklaan Ringfietspad
658,Ringfietspad Jan Van Rijswijcklaan,2023-03-09,11:00:00,35,16,19,FMN 11 A Jan Van Rijswijcklaan Ringfietspad
658,Ringfietspad Jan Van Rijswijcklaan,2023-03-09,12:00:00,36,21,15,FMN 11 A Jan Van Rijswijcklaan Ringfietspad
658,Ringfietspad Jan Van Rijswijcklaan,2023-03-09,13:00:00,44,27,17,FMN 11 A Jan Van Rijswijcklaan Ringfietspad
658,Ringfietspad Jan Van Rijswijcklaan,2023-03-09,14:00:00,46,26,20,FMN 11 A Jan Van Rijswijcklaan Ringfietspad
658,Ringfietspad Jan Van Rijswijcklaan,2023-03-09,15:00:00,67,47,20,FMN 11 A Jan Van Rijswijcklaan Ringfietspad
658,Ringfietspad Jan Van Rijswijcklaan,2023-03-09,16:00:00,99,77,22,FMN 11 A Jan Van Rijswijcklaan Ringfietspad
658,Ringfietspad Jan Van Rijswijcklaan,2023-03-09,17:00:00,105,67,38,FMN 11 A Jan Van Rijswijcklaan Ringfietspad
658,Ringfietspad Jan Van Rijswijcklaan,2023-03-09,18:00:00,61,37,24,FMN 11 A Jan Van Rijswijcklaan Ringfietspad
658,Ringfietspad Jan Van Rijswijcklaan,2023-03-09,19:00:00,42,18,24,FMN 11 A Jan Van Rijswijcklaan Ringfietspad
658,Ringfietspad Jan Van Rijswijcklaan,2023-03-09,20:00:00,22,13,9,FMN 11 A Jan Van Rijswijcklaan Ringfietspad
658,Ringfietspad Jan Van Rijswijcklaan,2023-03-09,21:00:00,20,10,10,FMN 11 A Jan Van Rijswijcklaan Ringfietspad
658,Ringfietspad Jan Van Rijswijcklaan,2023-03-09,22:00:00,11,5,6,FMN 11 A Jan Van Rijswijcklaan Ringfietspad
658,Ringfietspad Jan Van Rijswijcklaan,2023-03-09,23:00:00,9,3,6,FMN 11 A Jan Van Rijswijcklaan Ringfietspad
658,Ringfietspad Jan Van Rijswijcklaan,2023-03-10,00:00:00,3,2,1,FMN 11 A Jan Van Rijswijcklaan Ringfietspad
658,Ringfietspad Jan Van Rijswijcklaan,2023-03-10,01:00:00,1,0,1,FMN 11 A Jan Van Rijswijcklaan Ringfietspad
658,Ringfietspad Jan Van Rijswijcklaan,2023-03-10,02:00:00,1,1,0,FMN 11 A Jan Van Rijswijcklaan Ringfietspad
658,Ringfietspad Jan Van Rijswijcklaan,2023-03-10,03:00:00,4,4,0,FMN 11 A Jan Van Rijswijcklaan Ringfietspad
658,Ringfietspad Jan Van Rijswijcklaan,2023-03-10,04:00:00,6,4,2,FMN 11 A Jan Van Rijswijcklaan Ringfietspad
658,Ringfietspad Jan Van Rijswijcklaan,2023-03-10,05:00:00,9,1,8,FMN 11 A Jan Van Rijswijcklaan Ringfietspad
658,Ringfietspad Jan Van Rijswijcklaan,2023-03-10,06:00:00,37,10,27,FMN 11 A Jan Van Rijswijcklaan Ringfietspad
658,Ringfietspad Jan Van Rijswijcklaan,2023-03-10,07:00:00,76,29,47,FMN 11 A Jan Van Rijswijcklaan Ringfietspad
658,Ringfietspad Jan Van Rijswijcklaan,2023-03-10,08:00:00,107,31,76,FMN 11 A Jan Van Rijswijcklaan Ringfietspad
658,Ringfietspad Jan Van Rijswijcklaan,2023-03-10,09:00:00,42,14,28,FMN 11 A Jan Van Rijswijcklaan Ringfietspad
658,Ringfietspad Jan Van Rijswijcklaan,2023-03-10,10:00:00,27,11,16,FMN 11 A Jan Van Rijswijcklaan Ringfietspad
658,Ringfietspad Jan Van Rijswijcklaan,2023-03-10,11:00:00,33,13,20,FMN 11 A Jan Van Rijswijcklaan Ringfietspad
658,Ringfietspad Jan Van Rijswijcklaan,2023-03-10,12:00:00,48,28,20,FMN 11 A Jan Van Rijswijcklaan Ringfietspad
658,Ringfietspad Jan Van Rijswijcklaan,2023-03-10,13:00:00,39,21,18,FMN 11 A Jan Van Rijswijcklaan Ringfietspad
658,Ringfietspad Jan Van Rijswijcklaan,2023-03-10,14:00:00,58,32,26,FMN 11 A Jan Van Rijswijcklaan Ringfietspad
658,Ringfietspad Jan Van Rijswijcklaan,2023-03-10,15:00:00,69,48,21,FMN 11 A Jan Van Rijswijcklaan Ringfietspad
658,Ringfietspad Jan Van Rijswijcklaan,2023-03-10,16:00:00,91,63,28,FMN 11 A Jan Van Rijswijcklaan Ringfietspad
658,Ringfietspad Jan Van Rijswijcklaan,2023-03-10,17:00:00,85,55,30,FMN 11 A Jan Van Rijswijcklaan Ringfietspad
658,Ringfietspad Jan Van Rijswijcklaan,2023-03-10,18:00:00,49,24,25,FMN 11 A Jan Van Rijswijcklaan Ringfietspad
658,Ringfietspad Jan Van Rijswijcklaan,2023-03-10,19:00:00,29,12,17,FMN 11 A Jan Van Rijswijcklaan Ringfietspad
658,Ringfietspad Jan Van Rijswijcklaan,2023-03-10,20:00:00,20,9,11,FMN 11 A Jan Van Rijswijcklaan Ringfietspad
658,Ringfietspad Jan Van Rijswijcklaan,2023-03-10,21:00:00,16,5,11,FMN 11 A Jan Van Rijswijcklaan Ringfietspad
658,Ringfietspad Jan Van Rijswijcklaan,2023-03-10,22:00:00,20,10,10,FMN 11 A Jan Van Rijswijcklaan Ringfietspad
658,Ringfietspad Jan Van Rijswijcklaan,2023-03-10,23:00:00,12,6,6,FMN 11 A Jan Van Rijswijcklaan Ringfietspad
658,Ringfietspad Jan Van Rijswijcklaan,2023-03-11,00:00:00,8,5,3,FMN 11 A Jan Van Rijswijcklaan Ringfietspad
658,Ringfietspad Jan Van Rijswijcklaan,2023-03-11,01:00:00,7,5,2,FMN 11 A Jan Van Rijswijcklaan Ringfietspad
658,Ringfietspad Jan Van Rijswijcklaan,2023-03-11,02:00:00,5,4,1,FMN 11 A Jan Van Rijswijcklaan Ringfietspad
658,Ringfietspad Jan Van Rijswijcklaan,2023-03-11,03:00:00,0,0,0,FMN 11 A Jan Van Rijswijcklaan Ringfietspad
658,Ringfietspad Jan Van Rijswijcklaan,2023-03-11,04:00:00,3,3,0,FMN 11 A Jan Van Rijswijcklaan Ringfietspad
658,Ringfietspad Jan Van Rijswijcklaan,2023-03-11,05:00:00,7,5,2,FMN 11 A Jan Van Rijswijcklaan Ringfietspad
658,Ringfietspad Jan Van Rijswijcklaan,2023-03-11,06:00:00,9,3,6,FMN 11 A Jan Van Rijswijcklaan Ringfietspad
658,Ringfietspad Jan Van Rijswijcklaan,2023-03-11,07:00:00,9,3,6,FMN 11 A Jan Van Rijswijcklaan Ringfietspad
658,Ringfietspad Jan Van Rijswijcklaan,2023-03-11,08:00:00,26,12,14,FMN 11 A Jan Van Rijswijcklaan Ringfietspad
658,Ringfietspad Jan Van Rijswijcklaan,2023-03-11,09:00:00,47,19,28,FMN 11 A Jan Van Rijswijcklaan Ringfietspad
658,Ringfietspad Jan Van Rijswijcklaan,2023-03-11,10:00:00,53,26,27,FMN 11 A Jan Van Rijswijcklaan Ringfietspad
658,Ringfietspad Jan Van Rijswijcklaan,2023-03-11,11:00:00,41,21,20,FMN 11 A Jan Van Rijswijcklaan Ringfietspad
658,Ringfietspad Jan Van Rijswijcklaan,2023-03-11,12:00:00,38,21,17,FMN 11 A Jan Van Rijswijcklaan Ringfietspad
658,Ringfietspad Jan Van Rijswijcklaan,2023-03-11,13:00:00,53,21,32,FMN 11 A Jan Van Rijswijcklaan Ringfietspad
658,Ringfietspad Jan Van Rijswijcklaan,2023-03-11,14:00:00,75,39,36,FMN 11 A Jan Van Rijswijcklaan Ringfietspad
658,Ringfietspad Jan Van Rijswijcklaan,2023-03-11,15:00:00,74,41,33,FMN 11 A Jan Van Rijswijcklaan Ringfietspad
658,Ringfietspad Jan Van Rijswijcklaan,2023-03-11,16:00:00,69,40,29,FMN 11 A Jan Van Rijswijcklaan Ringfietspad
658,Ringfietspad Jan Van Rijswijcklaan,2023-03-11,17:00:00,60,37,23,FMN 11 A Jan Van Rijswijcklaan Ringfietspad
658,Ringfietspad Jan Van Rijswijcklaan,2023-03-11,18:00:00,38,20,18,FMN 11 A Jan Van Rijswijcklaan Ringfietspad
658,Ringfietspad Jan Van Rijswijcklaan,2023-03-11,19:00:00,33,17,16,FMN 11 A Jan Van Rijswijcklaan Ringfietspad
658,Ringfietspad Jan Van Rijswijcklaan,2023-03-11,20:00:00,19,7,12,FMN 11 A Jan Van Rijswijcklaan Ringfietspad
658,Ringfietspad Jan Van Rijswijcklaan,2023-03-11,21:00:00,22,12,10,FMN 11 A Jan Van Rijswijcklaan Ringfietspad
658,Ringfietspad Jan Van Rijswijcklaan,2023-03-11,22:00:00,10,8,2,FMN 11 A Jan Van Rijswijcklaan Ringfietspad
658,Ringfietspad Jan Van Rijswijcklaan,2023-03-11,23:00:00,5,2,3,FMN 11 A Jan Van Rijswijcklaan Ringfietspad
658,Ringfietspad Jan Van Rijswijcklaan,2023-03-12,00:00:00,3,2,1,FMN 11 A Jan Van Rijswijcklaan Ringfietspad
658,Ringfietspad Jan Van Rijswijcklaan,2023-03-12,01:00:00,1,1,0,FMN 11 A Jan Van Rijswijcklaan Ringfietspad
658,Ringfietspad Jan Van Rijswijcklaan,2023-03-12,02:00:00,0,0,0,FMN 11 A Jan Van Rijswijcklaan Ringfietspad
658,Ringfietspad Jan Van Rijswijcklaan,2023-03-12,03:00:00,0,0,0,FMN 11 A Jan Van Rijswijcklaan Ringfietspad
658,Ringfietspad Jan Van Rijswijcklaan,2023-03-12,04:00:00,1,0,1,FMN 11 A Jan Van Rijswijcklaan Ringfietspad
658,Ringfietspad Jan Van Rijswijcklaan,2023-03-12,05:00:00,1,0,1,FMN 11 A Jan Van Rijswijcklaan Ringfietspad
658,Ringfietspad Jan Van Rijswijcklaan,2023-03-12,06:00:00,4,2,2,FMN 11 A Jan Van Rijswijcklaan Ringfietspad
658,Ringfietspad Jan Van Rijswijcklaan,2023-03-12,07:00:00,5,2,3,FMN 11 A Jan Van Rijswijcklaan Ringfietspad
658,Ringfietspad Jan Van Rijswijcklaan,2023-03-12,08:00:00,7,1,6,FMN 11 A Jan Van Rijswijcklaan Ringfietspad
658,Ringfietspad Jan Van Rijswijcklaan,2023-03-12,09:00:00,26,9,17,FMN 11 A Jan Van Rijswijcklaan Ringfietspad
658,Ringfietspad Jan Van Rijswijcklaan,2023-03-12,10:00:00,27,8,19,FMN 11 A Jan Van Rijswijcklaan Ringfietspad
658,Ringfietspad Jan Van Rijswijcklaan,2023-03-12,11:00:00,35,14,21,FMN 11 A Jan Van Rijswijcklaan Ringfietspad
658,Ringfietspad Jan Van Rijswijcklaan,2023-03-12,12:00:00,31,18,13,FMN 11 A Jan Van Rijswijcklaan Ringfietspad
658,Ringfietspad Jan Van Rijswijcklaan,2023-03-12,13:00:00,42,18,24,FMN 11 A Jan Van Rijswijcklaan Ringfietspad
658,Ringfietspad Jan Van Rijswijcklaan,2023-03-12,14:00:00,45,22,23,FMN 11 A Jan Van Rijswijcklaan Ringfietspad
658,Ringfietspad Jan Van Rijswijcklaan,2023-03-12,15:00:00,51,27,24,FMN 11 A Jan Van Rijswijcklaan Ringfietspad
658,Ringfietspad Jan Van Rijswijcklaan,2023-03-12,16:00:00,39,22,17,FMN 11 A Jan Van Rijswijcklaan Ringfietspad
658,Ringfietspad Jan Van Rijswijcklaan,2023-03-12,17:00:00,33,20,13,FMN 11 A Jan Van Rijswijcklaan Ringfietspad
658,Ringfietspad Jan Van Rijswijcklaan,2023-03-12,18:00:00,20,11,9,FMN 11 A Jan Van Rijswijcklaan Ringfietspad
658,Ringfietspad Jan Van Rijswijcklaan,2023-03-12,19:00:00,13,4,9,FMN 11 A Jan Van Rijswijcklaan Ringfietspad
658,Ringfietspad Jan Van Rijswijcklaan,2023-03-12,20:00:00,14,7,7,FMN 11 A Jan Van Rijswijcklaan Ringfietspad
658,Ringfietspad Jan Van Rijswijcklaan,2023-03-12,21:00:00,8,6,2,FMN 11 A Jan Van Rijswijcklaan Ringfietspad
658,Ringfietspad Jan Van Rijswijcklaan,2023-03-12,22:00:00,8,3,5,FMN 11 A Jan Van Rijswijcklaan Ringfietspad
658,Ringfietspad Jan Van Rijswijcklaan,2023-03-12,23:00:00,1,1,0,FMN 11 A Jan Van Rijswijcklaan Ringfietspad
658,Ringfietspad Jan Van Rijswijcklaan,2023-03-13,00:00:00,2,2,0,FMN 11 A Jan Van Rijswijcklaan Ringfietspad
658,Ringfietspad Jan Van Rijswijcklaan,2023-03-13,01:00:00,1,0,1,FMN 11 A Jan Van Rijswijcklaan Ringfietspad
658,Ringfietspad Jan Van Rijswijcklaan,2023-03-13,02:00:00,0,0,0,FMN 11 A Jan Van Rijswijcklaan Ringfietspad
658,Ringfietspad Jan Van Rijswijcklaan,2023-03-13,03:00:00,0,0,0,FMN 11 A Jan Van Rijswijcklaan Ringfietspad
658,Ringfietspad Jan Van Rijswijcklaan,2023-03-13,04:00:00,4,2,2,FMN 11 A Jan Van Rijswijcklaan Ringfietspad
658,Ringfietspad Jan Van Rijswijcklaan,2023-03-13,05:00:00,22,7,15,FMN 11 A Jan Van Rijswijcklaan Ringfietspad
658,Ringfietspad Jan Van Rijswijcklaan,2023-03-13,06:00:00,54,10,44,FMN 11 A Jan Van Rijswijcklaan Ringfietspad
658,Ringfietspad Jan Van Rijswijcklaan,2023-03-13,07:00:00,112,37,75,FMN 11 A Jan Van Rijswijcklaan Ringfietspad
658,Ringfietspad Jan Van Rijswijcklaan,2023-03-13,08:00:00,144,49,95,FMN 11 A Jan Van Rijswijcklaan Ringfietspad
658,Ringfietspad Jan Van Rijswijcklaan,2023-03-13,09:00:00,49,16,33,FMN 11 A Jan Van Rijswijcklaan Ringfietspad
658,Ringfietspad Jan Van Rijswijcklaan,2023-03-13,10:00:00,35,11,24,FMN 11 A Jan Van Rijswijcklaan Ringfietspad
658,Ringfietspad Jan Van Rijswijcklaan,2023-03-13,11:00:00,25,10,15,FMN 11 A Jan Van Rijswijcklaan Ringfietspad
658,Ringfietspad Jan Van Rijswijcklaan,2023-03-13,12:00:00,47,21,26,FMN 11 A Jan Van Rijswijcklaan Ringfietspad
658,Ringfietspad Jan Van Rijswijcklaan,2023-03-13,13:00:00,58,33,25,FMN 11 A Jan Van Rijswijcklaan Ringfietspad
658,Ringfietspad Jan Van Rijswijcklaan,2023-03-13,14:00:00,58,38,20,FMN 11 A Jan Van Rijswijcklaan Ringfietspad
658,Ringfietspad Jan Van Rijswijcklaan,2023-03-13,15:00:00,83,58,25,FMN 11 A Jan Van Rijswijcklaan Ringfietspad
658,Ringfietspad Jan Van Rijswijcklaan,2023-03-13,16:00:00,142,98,44,FMN 11 A Jan Van Rijswijcklaan Ringfietspad
658,Ringfietspad Jan Van Rijswijcklaan,2023-03-13,17:00:00,133,87,46,FMN 11 A Jan Van Rijswijcklaan Ringfietspad
658,Ringfietspad Jan Van Rijswijcklaan,2023-03-13,18:00:00,74,49,25,FMN 11 A Jan Van Rijswijcklaan Ringfietspad
658,Ringfietspad Jan Van Rijswijcklaan,2023-03-13,19:00:00,42,26,16,FMN 11 A Jan Van Rijswijcklaan Ringfietspad
658,Ringfietspad Jan Van Rijswijcklaan,2023-03-13,20:00:00,23,9,14,FMN 11 A Jan Van Rijswijcklaan Ringfietspad
658,Ringfietspad Jan Van Rijswijcklaan,2023-03-13,21:00:00,20,10,10,FMN 11 A Jan Van Rijswijcklaan Ringfietspad
658,Ringfietspad Jan Van Rijswijcklaan,2023-03-13,22:00:00,18,9,9,FMN 11 A Jan Van Rijswijcklaan Ringfietspad
658,Ringfietspad Jan Van Rijswijcklaan,2023-03-13,23:00:00,5,4,1,FMN 11 A Jan Van Rijswijcklaan Ringfietspad
658,Ringfietspad Jan Van Rijswijcklaan,2023-03-14,00:00:00,1,1,0,FMN 11 A Jan Van Rijswijcklaan Ringfietspad
658,Ringfietspad Jan Van Rijswijcklaan,2023-03-14,01:00:00,0,0,0,FMN 11 A Jan Van Rijswijcklaan Ringfietspad
658,Ringfietspad Jan Van Rijswijcklaan,2023-03-14,02:00:00,1,1,0,FMN 11 A Jan Van Rijswijcklaan Ringfietspad
658,Ringfietspad Jan Van Rijswijcklaan,2023-03-14,03:00:00,1,1,0,FMN 11 A Jan Van Rijswijcklaan Ringfietspad
658,Ringfietspad Jan Van Rijswijcklaan,2023-03-14,04:00:00,2,2,0,FMN 11 A Jan Van Rijswijcklaan Ringfietspad
658,Ringfietspad Jan Van Rijswijcklaan,2023-03-14,05:00:00,16,4,12,FMN 11 A Jan Van Rijswijcklaan Ringfietspad
658,Ringfietspad Jan Van Rijswijcklaan,2023-03-14,06:00:00,42,9,33,FMN 11 A Jan Van Rijswijcklaan Ringfietspad
658,Ringfietspad Jan Van Rijswijcklaan,2023-03-14,07:00:00,108,42,66,FMN 11 A Jan Van Rijswijcklaan Ringfietspad
658,Ringfietspad Jan Van Rijswijcklaan,2023-03-14,08:00:00,116,38,78,FMN 11 A Jan Van Rijswijcklaan Ringfietspad
658,Ringfietspad Jan Van Rijswijcklaan,2023-03-14,09:00:00,52,16,36,FMN 11 A Jan Van Rijswijcklaan Ringfietspad
658,Ringfietspad Jan Van Rijswijcklaan,2023-03-14,10:00:00,26,12,14,FMN 11 A Jan Van Rijswijcklaan Ringfietspad
658,Ringfietspad Jan Van Rijswijcklaan,2023-03-14,11:00:00,31,14,17,FMN 11 A Jan Van Rijswijcklaan Ringfietspad
658,Ringfietspad Jan Van Rijswijcklaan,2023-03-14,12:00:00,36,16,20,FMN 11 A Jan Van Rijswijcklaan Ringfietspad
658,Ringfietspad Jan Van Rijswijcklaan,2023-03-14,13:00:00,31,15,16,FMN 11 A Jan Van Rijswijcklaan Ringfietspad
658,Ringfietspad Jan Van Rijswijcklaan,2023-03-14,14:00:00,44,21,23,FMN 11 A Jan Van Rijswijcklaan Ringfietspad
658,Ringfietspad Jan Van Rijswijcklaan,2023-03-14,15:00:00,80,50,30,FMN 11 A Jan Van Rijswijcklaan Ringfietspad
658,Ringfietspad Jan Van Rijswijcklaan,2023-03-14,16:00:00,114,76,38,FMN 11 A Jan Van Rijswijcklaan Ringfietspad
658,Ringfietspad Jan Van Rijswijcklaan,2023-03-14,17:00:00,118,83,35,FMN 11 A Jan Van Rijswijcklaan Ringfietspad
658,Ringfietspad Jan Van Rijswijcklaan,2023-03-14,18:00:00,70,43,27,FMN 11 A Jan Van Rijswijcklaan Ringfietspad
658,Ringfietspad Jan Van Rijswijcklaan,2023-03-14,19:00:00,32,20,12,FMN 11 A Jan Van Rijswijcklaan Ringfietspad
658,Ringfietspad Jan Van Rijswijcklaan,2023-03-14,20:00:00,16,3,13,FMN 11 A Jan Van Rijswijcklaan Ringfietspad
658,Ringfietspad Jan Van Rijswijcklaan,2023-03-14,21:00:00,13,7,6,FMN 11 A Jan Van Rijswijcklaan Ringfietspad
658,Ringfietspad Jan Van Rijswijcklaan,2023-03-14,22:00:00,19,10,9,FMN 11 A Jan Van Rijswijcklaan Ringfietspad
658,Ringfietspad Jan Van Rijswijcklaan,2023-03-14,23:00:00,3,2,1,FMN 11 A Jan Van Rijswijcklaan Ringfietspad
658,Ringfietspad Jan Van Rijswijcklaan,2023-03-15,00:00:00,3,3,0,FMN 11 A Jan Van Rijswijcklaan Ringfietspad
658,Ringfietspad Jan Van Rijswijcklaan,2023-03-15,01:00:00,1,0,1,FMN 11 A Jan Van Rijswijcklaan Ringfietspad
658,Ringfietspad Jan Van Rijswijcklaan,2023-03-15,02:00:00,1,0,1,FMN 11 A Jan Van Rijswijcklaan Ringfietspad
658,Ringfietspad Jan Van Rijswijcklaan,2023-03-15,03:00:00,3,2,1,FMN 11 A Jan Van Rijswijcklaan Ringfietspad
658,Ringfietspad Jan Van Rijswijcklaan,2023-03-15,04:00:00,5,2,3,FMN 11 A Jan Van Rijswijcklaan Ringfietspad
658,Ringfietspad Jan Van Rijswijcklaan,2023-03-15,05:00:00,23,4,19,FMN 11 A Jan Van Rijswijcklaan Ringfietspad
658,Ringfietspad Jan Van Rijswijcklaan,2023-03-15,06:00:00,72,20,52,FMN 11 A Jan Van Rijswijcklaan Ringfietspad
658,Ringfietspad Jan Van Rijswijcklaan,2023-03-15,07:00:00,124,46,78,FMN 11 A Jan Van Rijswijcklaan Ringfietspad
658,Ringfietspad Jan Van Rijswijcklaan,2023-03-15,08:00:00,133,50,83,FMN 11 A Jan Van Rijswijcklaan Ringfietspad
658,Ringfietspad Jan Van Rijswijcklaan,2023-03-15,09:00:00,58,20,38,FMN 11 A Jan Van Rijswijcklaan Ringfietspad
658,Ringfietspad Jan Van Rijswijcklaan,2023-03-15,10:00:00,43,20,23,FMN 11 A Jan Van Rijswijcklaan Ringfietspad
658,Ringfietspad Jan Van Rijswijcklaan,2023-03-15,11:00:00,42,16,26,FMN 11 A Jan Van Rijswijcklaan Ringfietspad
658,Ringfietspad Jan Van Rijswijcklaan,2023-03-15,12:00:00,58,29,29,FMN 11 A Jan Van Rijswijcklaan Ringfietspad
658,Ringfietspad Jan Van Rijswijcklaan,2023-03-15,13:00:00,60,38,22,FMN 11 A Jan Van Rijswijcklaan Ringfietspad
658,Ringfietspad Jan Van Rijswijcklaan,2023-03-15,14:00:00,64,37,27,FMN 11 A Jan Van Rijswijcklaan Ringfietspad
658,Ringfietspad Jan Van Rijswijcklaan,2023-03-15,15:00:00,75,43,32,FMN 11 A Jan Van Rijswijcklaan Ringfietspad
658,Ringfietspad Jan Van Rijswijcklaan,2023-03-15,16:00:00,124,85,39,FMN 11 A Jan Van Rijswijcklaan Ringfietspad
658,Ringfietspad Jan Van Rijswijcklaan,2023-03-15,17:00:00,145,99,46,FMN 11 A Jan Van Rijswijcklaan Ringfietspad
658,Ringfietspad Jan Van Rijswijcklaan,2023-03-15,18:00:00,85,54,31,FMN 11 A Jan Van Rijswijcklaan Ringfietspad
658,Ringfietspad Jan Van Rijswijcklaan,2023-03-15,19:00:00,34,20,14,FMN 11 A Jan Van Rijswijcklaan Ringfietspad
658,Ringfietspad Jan Van Rijswijcklaan,2023-03-15,20:00:00,32,19,13,FMN 11 A Jan Van Rijswijcklaan Ringfietspad
658,Ringfietspad Jan Van Rijswijcklaan,2023-03-15,21:00:00,26,15,11,FMN 11 A Jan Van Rijswijcklaan Ringfietspad
658,Ringfietspad Jan Van Rijswijcklaan,2023-03-15,22:00:00,21,12,9,FMN 11 A Jan Van Rijswijcklaan Ringfietspad
658,Ringfietspad Jan Van Rijswijcklaan,2023-03-15,23:00:00,15,10,5,FMN 11 A Jan Van Rijswijcklaan Ringfietspad
658,Ringfietspad Jan Van Rijswijcklaan,2023-03-16,00:00:00,2,2,0,FMN 11 A Jan Van Rijswijcklaan Ringfietspad
658,Ringfietspad Jan Van Rijswijcklaan,2023-03-16,01:00:00,4,3,1,FMN 11 A Jan Van Rijswijcklaan Ringfietspad
658,Ringfietspad Jan Van Rijswijcklaan,2023-03-16,02:00:00,2,2,0,FMN 11 A Jan Van Rijswijcklaan Ringfietspad
658,Ringfietspad Jan Van Rijswijcklaan,2023-03-16,03:00:00,3,3,0,FMN 11 A Jan Van Rijswijcklaan Ringfietspad
658,Ringfietspad Jan Van Rijswijcklaan,2023-03-16,04:00:00,6,5,1,FMN 11 A Jan Van Rijswijcklaan Ringfietspad
658,Ringfietspad Jan Van Rijswijcklaan,2023-03-16,05:00:00,28,11,17,FMN 11 A Jan Van Rijswijcklaan Ringfietspad
658,Ringfietspad Jan Van Rijswijcklaan,2023-03-16,06:00:00,63,15,48,FMN 11 A Jan Van Rijswijcklaan Ringfietspad
658,Ringfietspad Jan Van Rijswijcklaan,2023-03-16,07:00:00,126,41,85,FMN 11 A Jan Van Rijswijcklaan Ringfietspad
658,Ringfietspad Jan Van Rijswijcklaan,2023-03-16,08:00:00,174,66,108,FMN 11 A Jan Van Rijswijcklaan Ringfietspad
658,Ringfietspad Jan Van Rijswijcklaan,2023-03-16,09:00:00,70,29,41,FMN 11 A Jan Van Rijswijcklaan Ringfietspad
658,Ringfietspad Jan Van Rijswijcklaan,2023-03-16,10:00:00,45,22,23,FMN 11 A Jan Van Rijswijcklaan Ringfietspad
658,Ringfietspad Jan Van Rijswijcklaan,2023-03-16,11:00:00,39,13,26,FMN 11 A Jan Van Rijswijcklaan Ringfietspad
658,Ringfietspad Jan Van Rijswijcklaan,2023-03-16,12:00:00,65,31,34,FMN 11 A Jan Van Rijswijcklaan Ringfietspad
658,Ringfietspad Jan Van Rijswijcklaan,2023-03-16,13:00:00,62,33,29,FMN 11 A Jan Van Rijswijcklaan Ringfietspad
658,Ringfietspad Jan Van Rijswijcklaan,2023-03-16,14:00:00,80,48,32,FMN 11 A Jan Van Rijswijcklaan Ringfietspad
658,Ringfietspad Jan Van Rijswijcklaan,2023-03-16,15:00:00,102,65,37,FMN 11 A Jan Van Rijswijcklaan Ringfietspad
658,Ringfietspad Jan Van Rijswijcklaan,2023-03-16,16:00:00,159,104,55,FMN 11 A Jan Van Rijswijcklaan Ringfietspad
658,Ringfietspad Jan Van Rijswijcklaan,2023-03-16,17:00:00,161,105,56,FMN 11 A Jan Van Rijswijcklaan Ringfietspad
658,Ringfietspad Jan Van Rijswijcklaan,2023-03-16,18:00:00,95,56,39,FMN 11 A Jan Van Rijswijcklaan Ringfietspad
658,Ringfietspad Jan Van Rijswijcklaan,2023-03-16,19:00:00,54,28,26,FMN 11 A Jan Van Rijswijcklaan Ringfietspad
658,Ringfietspad Jan Van Rijswijcklaan,2023-03-16,20:00:00,24,11,13,FMN 11 A Jan Van Rijswijcklaan Ringfietspad
658,Ringfietspad Jan Van Rijswijcklaan,2023-03-16,21:00:00,24,16,8,FMN 11 A Jan Van Rijswijcklaan Ringfietspad
658,Ringfietspad Jan Van Rijswijcklaan,2023-03-16,22:00:00,19,9,10,FMN 11 A Jan Van Rijswijcklaan Ringfietspad
658,Ringfietspad Jan Van Rijswijcklaan,2023-03-16,23:00:00,5,2,3,FMN 11 A Jan Van Rijswijcklaan Ringfietspad
658,Ringfietspad Jan Van Rijswijcklaan,2023-03-17,00:00:00,4,2,2,FMN 11 A Jan Van Rijswijcklaan Ringfietspad
658,Ringfietspad Jan Van Rijswijcklaan,2023-03-17,01:00:00,0,0,0,FMN 11 A Jan Van Rijswijcklaan Ringfietspad
658,Ringfietspad Jan Van Rijswijcklaan,2023-03-17,02:00:00,2,2,0,FMN 11 A Jan Van Rijswijcklaan Ringfietspad
658,Ringfietspad Jan Van Rijswijcklaan,2023-03-17,03:00:00,3,2,1,FMN 11 A Jan Van Rijswijcklaan Ringfietspad
658,Ringfietspad Jan Van Rijswijcklaan,2023-03-17,04:00:00,8,4,4,FMN 11 A Jan Van Rijswijcklaan Ringfietspad
658,Ringfietspad Jan Van Rijswijcklaan,2023-03-17,05:00:00,19,5,14,FMN 11 A Jan Van Rijswijcklaan Ringfietspad
658,Ringfietspad Jan Van Rijswijcklaan,2023-03-17,06:00:00,64,17,47,FMN 11 A Jan Van Rijswijcklaan Ringfietspad
658,Ringfietspad Jan Van Rijswijcklaan,2023-03-17,07:00:00,117,40,77,FMN 11 A Jan Van Rijswijcklaan Ringfietspad
658,Ringfietspad Jan Van Rijswijcklaan,2023-03-17,08:00:00,156,50,106,FMN 11 A Jan Van Rijswijcklaan Ringfietspad
658,Ringfietspad Jan Van Rijswijcklaan,2023-03-17,09:00:00,67,21,46,FMN 11 A Jan Van Rijswijcklaan Ringfietspad
658,Ringfietspad Jan Van Rijswijcklaan,2023-03-17,10:00:00,51,27,24,FMN 11 A Jan Van Rijswijcklaan Ringfietspad
658,Ringfietspad Jan Van Rijswijcklaan,2023-03-17,11:00:00,49,23,26,FMN 11 A Jan Van Rijswijcklaan Ringfietspad
658,Ringfietspad Jan Van Rijswijcklaan,2023-03-17,12:00:00,74,33,41,FMN 11 A Jan Van Rijswijcklaan Ringfietspad
658,Ringfietspad Jan Van Rijswijcklaan,2023-03-17,13:00:00,73,40,33,FMN 11 A Jan Van Rijswijcklaan Ringfietspad
658,Ringfietspad Jan Van Rijswijcklaan,2023-03-17,14:00:00,73,38,35,FMN 11 A Jan Van Rijswijcklaan Ringfietspad
658,Ringfietspad Jan Van Rijswijcklaan,2023-03-17,15:00:00,102,71,31,FMN 11 A Jan Van Rijswijcklaan Ringfietspad
658,Ringfietspad Jan Van Rijswijcklaan,2023-03-17,16:00:00,153,102,51,FMN 11 A Jan Van Rijswijcklaan Ringfietspad
658,Ringfietspad Jan Van Rijswijcklaan,2023-03-17,17:00:00,125,88,37,FMN 11 A Jan Van Rijswijcklaan Ringfietspad
658,Ringfietspad Jan Van Rijswijcklaan,2023-03-17,18:00:00,82,50,32,FMN 11 A Jan Van Rijswijcklaan Ringfietspad
658,Ringfietspad Jan Van Rijswijcklaan,2023-03-17,19:00:00,45,26,19,FMN 11 A Jan Van Rijswijcklaan Ringfietspad
658,Ringfietspad Jan Van Rijswijcklaan,2023-03-17,20:00:00,20,8,12,FMN 11 A Jan Van Rijswijcklaan Ringfietspad
658,Ringfietspad Jan Van Rijswijcklaan,2023-03-17,21:00:00,19,7,12,FMN 11 A Jan Van Rijswijcklaan Ringfietspad
658,Ringfietspad Jan Van Rijswijcklaan,2023-03-17,22:00:00,18,10,8,FMN 11 A Jan Van Rijswijcklaan Ringfietspad
658,Ringfietspad Jan Van Rijswijcklaan,2023-03-17,23:00:00,12,10,2,FMN 11 A Jan Van Rijswijcklaan Ringfietspad
658,Ringfietspad Jan Van Rijswijcklaan,2023-03-18,00:00:00,6,3,3,FMN 11 A Jan Van Rijswijcklaan Ringfietspad
658,Ringfietspad Jan Van Rijswijcklaan,2023-03-18,01:00:00,11,8,3,FMN 11 A Jan Van Rijswijcklaan Ringfietspad
658,Ringfietspad Jan Van Rijswijcklaan,2023-03-18,02:00:00,1,1,0,FMN 11 A Jan Van Rijswijcklaan Ringfietspad
658,Ringfietspad Jan Van Rijswijcklaan,2023-03-18,03:00:00,6,3,3,FMN 11 A Jan Van Rijswijcklaan Ringfietspad
658,Ringfietspad Jan Van Rijswijcklaan,2023-03-18,04:00:00,2,2,0,FMN 11 A Jan Van Rijswijcklaan Ringfietspad
658,Ringfietspad Jan Van Rijswijcklaan,2023-03-18,05:00:00,6,5,1,FMN 11 A Jan Van Rijswijcklaan Ringfietspad
658,Ringfietspad Jan Van Rijswijcklaan,2023-03-18,06:00:00,7,3,4,FMN 11 A Jan Van Rijswijcklaan Ringfietspad
658,Ringfietspad Jan Van Rijswijcklaan,2023-03-18,07:00:00,11,4,7,FMN 11 A Jan Van Rijswijcklaan Ringfietspad
658,Ringfietspad Jan Van Rijswijcklaan,2023-03-18,08:00:00,30,14,16,FMN 11 A Jan Van Rijswijcklaan Ringfietspad
658,Ringfietspad Jan Van Rijswijcklaan,2023-03-18,09:00:00,43,19,24,FMN 11 A Jan Van Rijswijcklaan Ringfietspad
658,Ringfietspad Jan Van Rijswijcklaan,2023-03-18,10:00:00,38,15,23,FMN 11 A Jan Van Rijswijcklaan Ringfietspad
658,Ringfietspad Jan Van Rijswijcklaan,2023-03-18,11:00:00,45,26,19,FMN 11 A Jan Van Rijswijcklaan Ringfietspad
658,Ringfietspad Jan Van Rijswijcklaan,2023-03-18,12:00:00,51,24,27,FMN 11 A Jan Van Rijswijcklaan Ringfietspad
658,Ringfietspad Jan Van Rijswijcklaan,2023-03-18,13:00:00,54,26,28,FMN 11 A Jan Van Rijswijcklaan Ringfietspad
658,Ringfietspad Jan Van Rijswijcklaan,2023-03-18,14:00:00,67,39,28,FMN 11 A Jan Van Rijswijcklaan Ringfietspad
658,Ringfietspad Jan Van Rijswijcklaan,2023-03-18,15:00:00,82,41,41,FMN 11 A Jan Van Rijswijcklaan Ringfietspad
658,Ringfietspad Jan Van Rijswijcklaan,2023-03-18,16:00:00,62,38,24,FMN 11 A Jan Van Rijswijcklaan Ringfietspad
658,Ringfietspad Jan Van Rijswijcklaan,2023-03-18,17:00:00,47,31,16,FMN 11 A Jan Van Rijswijcklaan Ringfietspad
658,Ringfietspad Jan Van Rijswijcklaan,2023-03-18,18:00:00,39,21,18,FMN 11 A Jan Van Rijswijcklaan Ringfietspad
658,Ringfietspad Jan Van Rijswijcklaan,2023-03-18,19:00:00,32,15,17,FMN 11 A Jan Van Rijswijcklaan Ringfietspad
658,Ringfietspad Jan Van Rijswijcklaan,2023-03-18,20:00:00,21,12,9,FMN 11 A Jan Van Rijswijcklaan Ringfietspad
658,Ringfietspad Jan Van Rijswijcklaan,2023-03-18,21:00:00,18,10,8,FMN 11 A Jan Van Rijswijcklaan Ringfietspad
658,Ringfietspad Jan Van Rijswijcklaan,2023-03-18,22:00:00,17,8,9,FMN 11 A Jan Van Rijswijcklaan Ringfietspad
658,Ringfietspad Jan Van Rijswijcklaan,2023-03-18,23:00:00,7,6,1,FMN 11 A Jan Van Rijswijcklaan Ringfietspad
658,Ringfietspad Jan Van Rijswijcklaan,2023-03-19,00:00:00,5,5,0,FMN 11 A Jan Van Rijswijcklaan Ringfietspad
658,Ringfietspad Jan Van Rijswijcklaan,2023-03-19,01:00:00,3,1,2,FMN 11 A Jan Van Rijswijcklaan Ringfietspad
658,Ringfietspad Jan Van Rijswijcklaan,2023-03-19,02:00:00,2,1,1,FMN 11 A Jan Van Rijswijcklaan Ringfietspad
658,Ringfietspad Jan Van Rijswijcklaan,2023-03-19,03:00:00,1,0,1,FMN 11 A Jan Van Rijswijcklaan Ringfietspad
658,Ringfietspad Jan Van Rijswijcklaan,2023-03-19,04:00:00,1,1,0,FMN 11 A Jan Van Rijswijcklaan Ringfietspad
658,Ringfietspad Jan Van Rijswijcklaan,2023-03-19,05:00:00,2,1,1,FMN 11 A Jan Van Rijswijcklaan Ringfietspad
658,Ringfietspad Jan Van Rijswijcklaan,2023-03-19,06:00:00,5,3,2,FMN 11 A Jan Van Rijswijcklaan Ringfietspad
658,Ringfietspad Jan Van Rijswijcklaan,2023-03-19,07:00:00,10,5,5,FMN 11 A Jan Van Rijswijcklaan Ringfietspad
658,Ringfietspad Jan Van Rijswijcklaan,2023-03-19,08:00:00,18,4,14,FMN 11 A Jan Van Rijswijcklaan Ringfietspad
658,Ringfietspad Jan Van Rijswijcklaan,2023-03-19,09:00:00,22,8,14,FMN 11 A Jan Van Rijswijcklaan Ringfietspad
658,Ringfietspad Jan Van Rijswijcklaan,2023-03-19,10:00:00,34,13,21,FMN 11 A Jan Van Rijswijcklaan Ringfietspad
658,Ringfietspad Jan Van Rijswijcklaan,2023-03-19,11:00:00,46,20,26,FMN 11 A Jan Van Rijswijcklaan Ringfietspad
658,Ringfietspad Jan Van Rijswijcklaan,2023-03-19,12:00:00,51,27,24,FMN 11 A Jan Van Rijswijcklaan Ringfietspad
658,Ringfietspad Jan Van Rijswijcklaan,2023-03-19,13:00:00,56,30,26,FMN 11 A Jan Van Rijswijcklaan Ringfietspad
658,Ringfietspad Jan Van Rijswijcklaan,2023-03-19,14:00:00,63,36,27,FMN 11 A Jan Van Rijswijcklaan Ringfietspad
658,Ringfietspad Jan Van Rijswijcklaan,2023-03-19,15:00:00,61,39,22,FMN 11 A Jan Van Rijswijcklaan Ringfietspad
658,Ringfietspad Jan Van Rijswijcklaan,2023-03-19,16:00:00,48,33,15,FMN 11 A Jan Van Rijswijcklaan Ringfietspad
658,Ringfietspad Jan Van Rijswijcklaan,2023-03-19,17:00:00,42,24,18,FMN 11 A Jan Van Rijswijcklaan Ringfietspad
658,Ringfietspad Jan Van Rijswijcklaan,2023-03-19,18:00:00,30,21,9,FMN 11 A Jan Van Rijswijcklaan Ringfietspad
658,Ringfietspad Jan Van Rijswijcklaan,2023-03-19,19:00:00,19,9,10,FMN 11 A Jan Van Rijswijcklaan Ringfietspad
658,Ringfietspad Jan Van Rijswijcklaan,2023-03-19,20:00:00,13,6,7,FMN 11 A Jan Van Rijswijcklaan Ringfietspad
658,Ringfietspad Jan Van Rijswijcklaan,2023-03-19,21:00:00,6,3,3,FMN 11 A Jan Van Rijswijcklaan Ringfietspad
658,Ringfietspad Jan Van Rijswijcklaan,2023-03-19,22:00:00,2,0,2,FMN 11 A Jan Van Rijswijcklaan Ringfietspad
658,Ringfietspad Jan Van Rijswijcklaan,2023-03-19,23:00:00,4,2,2,FMN 11 A Jan Van Rijswijcklaan Ringfietspad
658,Ringfietspad Jan Van Rijswijcklaan,2023-03-20,00:00:00,3,2,1,FMN 11 A Jan Van Rijswijcklaan Ringfietspad
658,Ringfietspad Jan Van Rijswijcklaan,2023-03-20,01:00:00,0,0,0,FMN 11 A Jan Van Rijswijcklaan Ringfietspad
658,Ringfietspad Jan Van Rijswijcklaan,2023-03-20,02:00:00,0,0,0,FMN 11 A Jan Van Rijswijcklaan Ringfietspad
658,Ringfietspad Jan Van Rijswijcklaan,2023-03-20,03:00:00,2,2,0,FMN 11 A Jan Van Rijswijcklaan Ringfietspad
658,Ringfietspad Jan Van Rijswijcklaan,2023-03-20,04:00:00,6,2,4,FMN 11 A Jan Van Rijswijcklaan Ringfietspad
658,Ringfietspad Jan Van Rijswijcklaan,2023-03-20,05:00:00,8,4,4,FMN 11 A Jan Van Rijswijcklaan Ringfietspad
658,Ringfietspad Jan Van Rijswijcklaan,2023-03-20,06:00:00,48,11,37,FMN 11 A Jan Van Rijswijcklaan Ringfietspad
658,Ringfietspad Jan Van Rijswijcklaan,2023-03-20,07:00:00,126,44,82,FMN 11 A Jan Van Rijswijcklaan Ringfietspad
658,Ringfietspad Jan Van Rijswijcklaan,2023-03-20,08:00:00,146,49,97,FMN 11 A Jan Van Rijswijcklaan Ringfietspad
658,Ringfietspad Jan Van Rijswijcklaan,2023-03-20,09:00:00,50,14,36,FMN 11 A Jan Van Rijswijcklaan Ringfietspad
658,Ringfietspad Jan Van Rijswijcklaan,2023-03-20,10:00:00,40,16,24,FMN 11 A Jan Van Rijswijcklaan Ringfietspad
658,Ringfietspad Jan Van Rijswijcklaan,2023-03-20,11:00:00,27,11,16,FMN 11 A Jan Van Rijswijcklaan Ringfietspad
658,Ringfietspad Jan Van Rijswijcklaan,2023-03-20,12:00:00,64,34,30,FMN 11 A Jan Van Rijswijcklaan Ringfietspad
658,Ringfietspad Jan Van Rijswijcklaan,2023-03-20,13:00:00,52,26,26,FMN 11 A Jan Van Rijswijcklaan Ringfietspad
658,Ringfietspad Jan Van Rijswijcklaan,2023-03-20,14:00:00,69,41,28,FMN 11 A Jan Van Rijswijcklaan Ringfietspad
658,Ringfietspad Jan Van Rijswijcklaan,2023-03-20,15:00:00,91,55,36,FMN 11 A Jan Van Rijswijcklaan Ringfietspad
658,Ringfietspad Jan Van Rijswijcklaan,2023-03-20,16:00:00,140,97,43,FMN 11 A Jan Van Rijswijcklaan Ringfietspad
658,Ringfietspad Jan Van Rijswijcklaan,2023-03-20,17:00:00,131,85,46,FMN 11 A Jan Van Rijswijcklaan Ringfietspad
658,Ringfietspad Jan Van Rijswijcklaan,2023-03-20,18:00:00,87,55,32,FMN 11 A Jan Van Rijswijcklaan Ringfietspad
658,Ringfietspad Jan Van Rijswijcklaan,2023-03-20,19:00:00,51,27,24,FMN 11 A Jan Van Rijswijcklaan Ringfietspad
658,Ringfietspad Jan Van Rijswijcklaan,2023-03-20,20:00:00,26,10,16,FMN 11 A Jan Van Rijswijcklaan Ringfietspad
658,Ringfietspad Jan Van Rijswijcklaan,2023-03-20,21:00:00,21,9,12,FMN 11 A Jan Van Rijswijcklaan Ringfietspad
658,Ringfietspad Jan Van Rijswijcklaan,2023-03-20,22:00:00,14,8,6,FMN 11 A Jan Van Rijswijcklaan Ringfietspad
658,Ringfietspad Jan Van Rijswijcklaan,2023-03-20,23:00:00,11,9,2,FMN 11 A Jan Van Rijswijcklaan Ringfietspad
658,Ringfietspad Jan Van Rijswijcklaan,2023-03-21,00:00:00,2,0,2,FMN 11 A Jan Van Rijswijcklaan Ringfietspad
658,Ringfietspad Jan Van Rijswijcklaan,2023-03-21,01:00:00,0,0,0,FMN 11 A Jan Van Rijswijcklaan Ringfietspad
658,Ringfietspad Jan Van Rijswijcklaan,2023-03-21,02:00:00,2,1,1,FMN 11 A Jan Van Rijswijcklaan Ringfietspad
658,Ringfietspad Jan Van Rijswijcklaan,2023-03-21,03:00:00,1,1,0,FMN 11 A Jan Van Rijswijcklaan Ringfietspad
658,Ringfietspad Jan Van Rijswijcklaan,2023-03-21,04:00:00,12,4,8,FMN 11 A Jan Van Rijswijcklaan Ringfietspad
658,Ringfietspad Jan Van Rijswijcklaan,2023-03-21,05:00:00,20,5,15,FMN 11 A Jan Van Rijswijcklaan Ringfietspad
658,Ringfietspad Jan Van Rijswijcklaan,2023-03-21,06:00:00,63,16,47,FMN 11 A Jan Van Rijswijcklaan Ringfietspad
658,Ringfietspad Jan Van Rijswijcklaan,2023-03-21,07:00:00,105,39,66,FMN 11 A Jan Van Rijswijcklaan Ringfietspad
658,Ringfietspad Jan Van Rijswijcklaan,2023-03-21,08:00:00,152,54,98,FMN 11 A Jan Van Rijswijcklaan Ringfietspad
658,Ringfietspad Jan Van Rijswijcklaan,2023-03-21,09:00:00,62,27,35,FMN 11 A Jan Van Rijswijcklaan Ringfietspad
658,Ringfietspad Jan Van Rijswijcklaan,2023-03-21,10:00:00,41,20,21,FMN 11 A Jan Van Rijswijcklaan Ringfietspad
658,Ringfietspad Jan Van Rijswijcklaan,2023-03-21,11:00:00,44,16,28,FMN 11 A Jan Van Rijswijcklaan Ringfietspad
658,Ringfietspad Jan Van Rijswijcklaan,2023-03-21,12:00:00,43,26,17,FMN 11 A Jan Van Rijswijcklaan Ringfietspad
658,Ringfietspad Jan Van Rijswijcklaan,2023-03-21,13:00:00,50,22,28,FMN 11 A Jan Van Rijswijcklaan Ringfietspad
658,Ringfietspad Jan Van Rijswijcklaan,2023-03-21,14:00:00,60,34,26,FMN 11 A Jan Van Rijswijcklaan Ringfietspad
658,Ringfietspad Jan Van Rijswijcklaan,2023-03-21,15:00:00,88,56,32,FMN 11 A Jan Van Rijswijcklaan Ringfietspad
658,Ringfietspad Jan Van Rijswijcklaan,2023-03-21,16:00:00,145,104,41,FMN 11 A Jan Van Rijswijcklaan Ringfietspad
658,Ringfietspad Jan Van Rijswijcklaan,2023-03-21,17:00:00,150,97,53,FMN 11 A Jan Van Rijswijcklaan Ringfietspad
658,Ringfietspad Jan Van Rijswijcklaan,2023-03-21,18:00:00,102,65,37,FMN 11 A Jan Van Rijswijcklaan Ringfietspad
658,Ringfietspad Jan Van Rijswijcklaan,2023-03-21,19:00:00,40,26,14,FMN 11 A Jan Van Rijswijcklaan Ringfietspad
658,Ringfietspad Jan Van Rijswijcklaan,2023-03-21,20:00:00,26,11,15,FMN 11 A Jan Van Rijswijcklaan Ringfietspad
658,Ringfietspad Jan Van Rijswijcklaan,2023-03-21,21:00:00,26,14,12,FMN 11 A Jan Van Rijswijcklaan Ringfietspad
658,Ringfietspad Jan Van Rijswijcklaan,2023-03-21,22:00:00,23,11,12,FMN 11 A Jan Van Rijswijcklaan Ringfietspad
658,Ringfietspad Jan Van Rijswijcklaan,2023-03-21,23:00:00,7,3,4,FMN 11 A Jan Van Rijswijcklaan Ringfietspad
658,Ringfietspad Jan Van Rijswijcklaan,2023-03-22,00:00:00,1,0,1,FMN 11 A Jan Van Rijswijcklaan Ringfietspad
658,Ringfietspad Jan Van Rijswijcklaan,2023-03-22,01:00:00,2,2,0,FMN 11 A Jan Van Rijswijcklaan Ringfietspad
658,Ringfietspad Jan Van Rijswijcklaan,2023-03-22,02:00:00,4,4,0,FMN 11 A Jan Van Rijswijcklaan Ringfietspad
658,Ringfietspad Jan Van Rijswijcklaan,2023-03-22,03:00:00,2,2,0,FMN 11 A Jan Van Rijswijcklaan Ringfietspad
658,Ringfietspad Jan Van Rijswijcklaan,2023-03-22,04:00:00,5,2,3,FMN 11 A Jan Van Rijswijcklaan Ringfietspad
658,Ringfietspad Jan Van Rijswijcklaan,2023-03-22,05:00:00,16,3,13,FMN 11 A Jan Van Rijswijcklaan Ringfietspad
658,Ringfietspad Jan Van Rijswijcklaan,2023-03-22,06:00:00,61,19,42,FMN 11 A Jan Van Rijswijcklaan Ringfietspad
658,Ringfietspad Jan Van Rijswijcklaan,2023-03-22,07:00:00,106,41,65,FMN 11 A Jan Van Rijswijcklaan Ringfietspad
658,Ringfietspad Jan Van Rijswijcklaan,2023-03-22,08:00:00,128,41,87,FMN 11 A Jan Van Rijswijcklaan Ringfietspad
658,Ringfietspad Jan Van Rijswijcklaan,2023-03-22,09:00:00,44,18,26,FMN 11 A Jan Van Rijswijcklaan Ringfietspad
658,Ringfietspad Jan Van Rijswijcklaan,2023-03-22,10:00:00,39,18,21,FMN 11 A Jan Van Rijswijcklaan Ringfietspad
658,Ringfietspad Jan Van Rijswijcklaan,2023-03-22,11:00:00,34,20,14,FMN 11 A Jan Van Rijswijcklaan Ringfietspad
658,Ringfietspad Jan Van Rijswijcklaan,2023-03-22,12:00:00,58,29,29,FMN 11 A Jan Van Rijswijcklaan Ringfietspad
658,Ringfietspad Jan Van Rijswijcklaan,2023-03-22,13:00:00,58,27,31,FMN 11 A Jan Van Rijswijcklaan Ringfietspad
658,Ringfietspad Jan Van Rijswijcklaan,2023-03-22,14:00:00,51,31,20,FMN 11 A Jan Van Rijswijcklaan Ringfietspad
658,Ringfietspad Jan Van Rijswijcklaan,2023-03-22,15:00:00,80,53,27,FMN 11 A Jan Van Rijswijcklaan Ringfietspad
658,Ringfietspad Jan Van Rijswijcklaan,2023-03-22,16:00:00,123,81,42,FMN 11 A Jan Van Rijswijcklaan Ringfietspad
658,Ringfietspad Jan Van Rijswijcklaan,2023-03-22,17:00:00,124,78,46,FMN 11 A Jan Van Rijswijcklaan Ringfietspad
658,Ringfietspad Jan Van Rijswijcklaan,2023-03-22,18:00:00,67,38,29,FMN 11 A Jan Van Rijswijcklaan Ringfietspad
658,Ringfietspad Jan Van Rijswijcklaan,2023-03-22,19:00:00,42,25,17,FMN 11 A Jan Van Rijswijcklaan Ringfietspad
658,Ringfietspad Jan Van Rijswijcklaan,2023-03-22,20:00:00,26,15,11,FMN 11 A Jan Van Rijswijcklaan Ringfietspad
658,Ringfietspad Jan Van Rijswijcklaan,2023-03-22,21:00:00,12,9,3,FMN 11 A Jan Van Rijswijcklaan Ringfietspad
658,Ringfietspad Jan Van Rijswijcklaan,2023-03-22,22:00:00,20,13,7,FMN 11 A Jan Van Rijswijcklaan Ringfietspad
658,Ringfietspad Jan Van Rijswijcklaan,2023-03-22,23:00:00,6,5,1,FMN 11 A Jan Van Rijswijcklaan Ringfietspad
658,Ringfietspad Jan Van Rijswijcklaan,2023-03-23,00:00:00,3,1,2,FMN 11 A Jan Van Rijswijcklaan Ringfietspad
658,Ringfietspad Jan Van Rijswijcklaan,2023-03-23,01:00:00,3,2,1,FMN 11 A Jan Van Rijswijcklaan Ringfietspad
658,Ringfietspad Jan Van Rijswijcklaan,2023-03-23,02:00:00,0,0,0,FMN 11 A Jan Van Rijswijcklaan Ringfietspad
658,Ringfietspad Jan Van Rijswijcklaan,2023-03-23,03:00:00,2,2,0,FMN 11 A Jan Van Rijswijcklaan Ringfietspad
658,Ringfietspad Jan Van Rijswijcklaan,2023-03-23,04:00:00,3,1,2,FMN 11 A Jan Van Rijswijcklaan Ringfietspad
658,Ringfietspad Jan Van Rijswijcklaan,2023-03-23,05:00:00,22,5,17,FMN 11 A Jan Van Rijswijcklaan Ringfietspad
658,Ringfietspad Jan Van Rijswijcklaan,2023-03-23,06:00:00,57,15,42,FMN 11 A Jan Van Rijswijcklaan Ringfietspad
658,Ringfietspad Jan Van Rijswijcklaan,2023-03-23,07:00:00,99,33,66,FMN 11 A Jan Van Rijswijcklaan Ringfietspad
658,Ringfietspad Jan Van Rijswijcklaan,2023-03-23,08:00:00,127,41,86,FMN 11 A Jan Van Rijswijcklaan Ringfietspad
658,Ringfietspad Jan Van Rijswijcklaan,2023-03-23,09:00:00,57,25,32,FMN 11 A Jan Van Rijswijcklaan Ringfietspad
658,Ringfietspad Jan Van Rijswijcklaan,2023-03-23,10:00:00,36,13,23,FMN 11 A Jan Van Rijswijcklaan Ringfietspad
658,Ringfietspad Jan Van Rijswijcklaan,2023-03-23,11:00:00,27,15,12,FMN 11 A Jan Van Rijswijcklaan Ringfietspad
658,Ringfietspad Jan Van Rijswijcklaan,2023-03-23,12:00:00,44,20,24,FMN 11 A Jan Van Rijswijcklaan Ringfietspad
658,Ringfietspad Jan Van Rijswijcklaan,2023-03-23,13:00:00,52,27,25,FMN 11 A Jan Van Rijswijcklaan Ringfietspad
658,Ringfietspad Jan Van Rijswijcklaan,2023-03-23,14:00:00,61,34,27,FMN 11 A Jan Van Rijswijcklaan Ringfietspad
658,Ringfietspad Jan Van Rijswijcklaan,2023-03-23,15:00:00,72,50,22,FMN 11 A Jan Van Rijswijcklaan Ringfietspad
658,Ringfietspad Jan Van Rijswijcklaan,2023-03-23,16:00:00,119,80,39,FMN 11 A Jan Van Rijswijcklaan Ringfietspad
658,Ringfietspad Jan Van Rijswijcklaan,2023-03-23,17:00:00,130,89,41,FMN 11 A Jan Van Rijswijcklaan Ringfietspad
658,Ringfietspad Jan Van Rijswijcklaan,2023-03-23,18:00:00,76,40,36,FMN 11 A Jan Van Rijswijcklaan Ringfietspad
658,Ringfietspad Jan Van Rijswijcklaan,2023-03-23,19:00:00,41,21,20,FMN 11 A Jan Van Rijswijcklaan Ringfietspad
658,Ringfietspad Jan Van Rijswijcklaan,2023-03-23,20:00:00,30,18,12,FMN 11 A Jan Van Rijswijcklaan Ringfietspad
658,Ringfietspad Jan Van Rijswijcklaan,2023-03-23,21:00:00,10,3,7,FMN 11 A Jan Van Rijswijcklaan Ringfietspad
658,Ringfietspad Jan Van Rijswijcklaan,2023-03-23,22:00:00,15,8,7,FMN 11 A Jan Van Rijswijcklaan Ringfietspad
658,Ringfietspad Jan Van Rijswijcklaan,2023-03-23,23:00:00,12,9,3,FMN 11 A Jan Van Rijswijcklaan Ringfietspad
658,Ringfietspad Jan Van Rijswijcklaan,2023-03-24,00:00:00,4,2,2,FMN 11 A Jan Van Rijswijcklaan Ringfietspad
658,Ringfietspad Jan Van Rijswijcklaan,2023-03-24,01:00:00,6,4,2,FMN 11 A Jan Van Rijswijcklaan Ringfietspad
658,Ringfietspad Jan Van Rijswijcklaan,2023-03-24,02:00:00,0,0,0,FMN 11 A Jan Van Rijswijcklaan Ringfietspad
658,Ringfietspad Jan Van Rijswijcklaan,2023-03-24,03:00:00,2,2,0,FMN 11 A Jan Van Rijswijcklaan Ringfietspad
658,Ringfietspad Jan Van Rijswijcklaan,2023-03-24,04:00:00,4,1,3,FMN 11 A Jan Van Rijswijcklaan Ringfietspad
658,Ringfietspad Jan Van Rijswijcklaan,2023-03-24,05:00:00,17,3,14,FMN 11 A Jan Van Rijswijcklaan Ringfietspad
658,Ringfietspad Jan Van Rijswijcklaan,2023-03-24,06:00:00,49,14,35,FMN 11 A Jan Van Rijswijcklaan Ringfietspad
658,Ringfietspad Jan Van Rijswijcklaan,2023-03-24,07:00:00,89,32,57,FMN 11 A Jan Van Rijswijcklaan Ringfietspad
658,Ringfietspad Jan Van Rijswijcklaan,2023-03-24,08:00:00,134,43,91,FMN 11 A Jan Van Rijswijcklaan Ringfietspad
658,Ringfietspad Jan Van Rijswijcklaan,2023-03-24,09:00:00,51,16,35,FMN 11 A Jan Van Rijswijcklaan Ringfietspad
658,Ringfietspad Jan Van Rijswijcklaan,2023-03-24,10:00:00,39,18,21,FMN 11 A Jan Van Rijswijcklaan Ringfietspad
658,Ringfietspad Jan Van Rijswijcklaan,2023-03-24,11:00:00,37,13,24,FMN 11 A Jan Van Rijswijcklaan Ringfietspad
658,Ringfietspad Jan Van Rijswijcklaan,2023-03-24,12:00:00,56,27,29,FMN 11 A Jan Van Rijswijcklaan Ringfietspad
658,Ringfietspad Jan Van Rijswijcklaan,2023-03-24,13:00:00,55,24,31,FMN 11 A Jan Van Rijswijcklaan Ringfietspad
658,Ringfietspad Jan Van Rijswijcklaan,2023-03-24,14:00:00,62,35,27,FMN 11 A Jan Van Rijswijcklaan Ringfietspad
658,Ringfietspad Jan Van Rijswijcklaan,2023-03-24,15:00:00,90,59,31,FMN 11 A Jan Van Rijswijcklaan Ringfietspad
658,Ringfietspad Jan Van Rijswijcklaan,2023-03-24,16:00:00,124,85,39,FMN 11 A Jan Van Rijswijcklaan Ringfietspad
658,Ringfietspad Jan Van Rijswijcklaan,2023-03-24,17:00:00,106,67,39,FMN 11 A Jan Van Rijswijcklaan Ringfietspad
658,Ringfietspad Jan Van Rijswijcklaan,2023-03-24,18:00:00,56,31,25,FMN 11 A Jan Van Rijswijcklaan Ringfietspad
658,Ringfietspad Jan Van Rijswijcklaan,2023-03-24,19:00:00,43,25,18,FMN 11 A Jan Van Rijswijcklaan Ringfietspad
658,Ringfietspad Jan Van Rijswijcklaan,2023-03-24,20:00:00,28,15,13,FMN 11 A Jan Van Rijswijcklaan Ringfietspad
658,Ringfietspad Jan Van Rijswijcklaan,2023-03-24,21:00:00,16,7,9,FMN 11 A Jan Van Rijswijcklaan Ringfietspad
658,Ringfietspad Jan Van Rijswijcklaan,2023-03-24,22:00:00,25,17,8,FMN 11 A Jan Van Rijswijcklaan Ringfietspad
658,Ringfietspad Jan Van Rijswijcklaan,2023-03-24,23:00:00,9,6,3,FMN 11 A Jan Van Rijswijcklaan Ringfietspad
658,Ringfietspad Jan Van Rijswijcklaan,2023-03-25,00:00:00,5,3,2,FMN 11 A Jan Van Rijswijcklaan Ringfietspad
658,Ringfietspad Jan Van Rijswijcklaan,2023-03-25,01:00:00,3,2,1,FMN 11 A Jan Van Rijswijcklaan Ringfietspad
658,Ringfietspad Jan Van Rijswijcklaan,2023-03-25,02:00:00,3,2,1,FMN 11 A Jan Van Rijswijcklaan Ringfietspad
658,Ringfietspad Jan Van Rijswijcklaan,2023-03-25,03:00:00,0,0,0,FMN 11 A Jan Van Rijswijcklaan Ringfietspad
658,Ringfietspad Jan Van Rijswijcklaan,2023-03-25,04:00:00,5,1,4,FMN 11 A Jan Van Rijswijcklaan Ringfietspad
658,Ringfietspad Jan Van Rijswijcklaan,2023-03-25,05:00:00,4,1,3,FMN 11 A Jan Van Rijswijcklaan Ringfietspad
658,Ringfietspad Jan Van Rijswijcklaan,2023-03-25,06:00:00,7,2,5,FMN 11 A Jan Van Rijswijcklaan Ringfietspad
658,Ringfietspad Jan Van Rijswijcklaan,2023-03-25,07:00:00,6,2,4,FMN 11 A Jan Van Rijswijcklaan Ringfietspad
658,Ringfietspad Jan Van Rijswijcklaan,2023-03-25,08:00:00,14,3,11,FMN 11 A Jan Van Rijswijcklaan Ringfietspad
658,Ringfietspad Jan Van Rijswijcklaan,2023-03-25,09:00:00,33,13,20,FMN 11 A Jan Van Rijswijcklaan Ringfietspad
658,Ringfietspad Jan Van Rijswijcklaan,2023-03-25,10:00:00,26,11,15,FMN 11 A Jan Van Rijswijcklaan Ringfietspad
658,Ringfietspad Jan Van Rijswijcklaan,2023-03-25,11:00:00,39,22,17,FMN 11 A Jan Van Rijswijcklaan Ringfietspad
658,Ringfietspad Jan Van Rijswijcklaan,2023-03-25,12:00:00,40,15,25,FMN 11 A Jan Van Rijswijcklaan Ringfietspad
658,Ringfietspad Jan Van Rijswijcklaan,2023-03-25,13:00:00,50,23,27,FMN 11 A Jan Van Rijswijcklaan Ringfietspad
658,Ringfietspad Jan Van Rijswijcklaan,2023-03-25,14:00:00,61,33,28,FMN 11 A Jan Van Rijswijcklaan Ringfietspad
658,Ringfietspad Jan Van Rijswijcklaan,2023-03-25,15:00:00,50,29,21,FMN 11 A Jan Van Rijswijcklaan Ringfietspad
658,Ringfietspad Jan Van Rijswijcklaan,2023-03-25,16:00:00,49,33,16,FMN 11 A Jan Van Rijswijcklaan Ringfietspad
658,Ringfietspad Jan Van Rijswijcklaan,2023-03-25,17:00:00,39,27,12,FMN 11 A Jan Van Rijswijcklaan Ringfietspad
658,Ringfietspad Jan Van Rijswijcklaan,2023-03-25,18:00:00,25,14,11,FMN 11 A Jan Van Rijswijcklaan Ringfietspad
658,Ringfietspad Jan Van Rijswijcklaan,2023-03-25,19:00:00,15,8,7,FMN 11 A Jan Van Rijswijcklaan Ringfietspad
658,Ringfietspad Jan Van Rijswijcklaan,2023-03-25,20:00:00,23,11,12,FMN 11 A Jan Van Rijswijcklaan Ringfietspad
658,Ringfietspad Jan Van Rijswijcklaan,2023-03-25,21:00:00,9,8,1,FMN 11 A Jan Van Rijswijcklaan Ringfietspad
658,Ringfietspad Jan Van Rijswijcklaan,2023-03-25,22:00:00,10,4,6,FMN 11 A Jan Van Rijswijcklaan Ringfietspad
658,Ringfietspad Jan Van Rijswijcklaan,2023-03-25,23:00:00,7,4,3,FMN 11 A Jan Van Rijswijcklaan Ringfietspad
658,Ringfietspad Jan Van Rijswijcklaan,2023-03-26,00:00:00,5,2,3,FMN 11 A Jan Van Rijswijcklaan Ringfietspad
658,Ringfietspad Jan Van Rijswijcklaan,2023-03-26,01:00:00,1,1,0,FMN 11 A Jan Van Rijswijcklaan Ringfietspad
658,Ringfietspad Jan Van Rijswijcklaan,2023-03-26,02:00:00,0,0,0,FMN 11 A Jan Van Rijswijcklaan Ringfietspad
658,Ringfietspad Jan Van Rijswijcklaan,2023-03-26,03:00:00,0,0,0,FMN 11 A Jan Van Rijswijcklaan Ringfietspad
658,Ringfietspad Jan Van Rijswijcklaan,2023-03-26,04:00:00,1,1,0,FMN 11 A Jan Van Rijswijcklaan Ringfietspad
658,Ringfietspad Jan Van Rijswijcklaan,2023-03-26,05:00:00,2,0,2,FMN 11 A Jan Van Rijswijcklaan Ringfietspad
658,Ringfietspad Jan Van Rijswijcklaan,2023-03-26,06:00:00,1,1,0,FMN 11 A Jan Van Rijswijcklaan Ringfietspad
658,Ringfietspad Jan Van Rijswijcklaan,2023-03-26,07:00:00,3,1,2,FMN 11 A Jan Van Rijswijcklaan Ringfietspad
658,Ringfietspad Jan Van Rijswijcklaan,2023-03-26,08:00:00,5,3,2,FMN 11 A Jan Van Rijswijcklaan Ringfietspad
658,Ringfietspad Jan Van Rijswijcklaan,2023-03-26,09:00:00,20,8,12,FMN 11 A Jan Van Rijswijcklaan Ringfietspad
658,Ringfietspad Jan Van Rijswijcklaan,2023-03-26,10:00:00,19,5,14,FMN 11 A Jan Van Rijswijcklaan Ringfietspad
658,Ringfietspad Jan Van Rijswijcklaan,2023-03-26,11:00:00,26,11,15,FMN 11 A Jan Van Rijswijcklaan Ringfietspad
658,Ringfietspad Jan Van Rijswijcklaan,2023-03-26,12:00:00,30,19,11,FMN 11 A Jan Van Rijswijcklaan Ringfietspad
658,Ringfietspad Jan Van Rijswijcklaan,2023-03-26,13:00:00,22,12,10,FMN 11 A Jan Van Rijswijcklaan Ringfietspad
658,Ringfietspad Jan Van Rijswijcklaan,2023-03-26,14:00:00,30,16,14,FMN 11 A Jan Van Rijswijcklaan Ringfietspad
658,Ringfietspad Jan Van Rijswijcklaan,2023-03-26,15:00:00,35,20,15,FMN 11 A Jan Van Rijswijcklaan Ringfietspad
658,Ringfietspad Jan Van Rijswijcklaan,2023-03-26,16:00:00,22,12,10,FMN 11 A Jan Van Rijswijcklaan Ringfietspad
658,Ringfietspad Jan Van Rijswijcklaan,2023-03-26,17:00:00,17,11,6,FMN 11 A Jan Van Rijswijcklaan Ringfietspad
658,Ringfietspad Jan Van Rijswijcklaan,2023-03-26,18:00:00,12,9,3,FMN 11 A Jan Van Rijswijcklaan Ringfietspad
658,Ringfietspad Jan Van Rijswijcklaan,2023-03-26,19:00:00,10,7,3,FMN 11 A Jan Van Rijswijcklaan Ringfietspad
658,Ringfietspad Jan Van Rijswijcklaan,2023-03-26,20:00:00,10,6,4,FMN 11 A Jan Van Rijswijcklaan Ringfietspad
658,Ringfietspad Jan Van Rijswijcklaan,2023-03-26,21:00:00,5,3,2,FMN 11 A Jan Van Rijswijcklaan Ringfietspad
658,Ringfietspad Jan Van Rijswijcklaan,2023-03-26,22:00:00,3,3,0,FMN 11 A Jan Van Rijswijcklaan Ringfietspad
658,Ringfietspad Jan Van Rijswijcklaan,2023-03-26,23:00:00,2,2,0,FMN 11 A Jan Van Rijswijcklaan Ringfietspad
658,Ringfietspad Jan Van Rijswijcklaan,2023-03-27,00:00:00,1,1,0,FMN 11 A Jan Van Rijswijcklaan Ringfietspad
658,Ringfietspad Jan Van Rijswijcklaan,2023-03-27,01:00:00,1,1,0,FMN 11 A Jan Van Rijswijcklaan Ringfietspad
658,Ringfietspad Jan Van Rijswijcklaan,2023-03-27,02:00:00,0,0,0,FMN 11 A Jan Van Rijswijcklaan Ringfietspad
658,Ringfietspad Jan Van Rijswijcklaan,2023-03-27,03:00:00,0,0,0,FMN 11 A Jan Van Rijswijcklaan Ringfietspad
658,Ringfietspad Jan Van Rijswijcklaan,2023-03-27,04:00:00,7,4,3,FMN 11 A Jan Van Rijswijcklaan Ringfietspad
658,Ringfietspad Jan Van Rijswijcklaan,2023-03-27,05:00:00,28,7,21,FMN 11 A Jan Van Rijswijcklaan Ringfietspad
658,Ringfietspad Jan Van Rijswijcklaan,2023-03-27,06:00:00,52,14,38,FMN 11 A Jan Van Rijswijcklaan Ringfietspad
658,Ringfietspad Jan Van Rijswijcklaan,2023-03-27,07:00:00,106,40,66,FMN 11 A Jan Van Rijswijcklaan Ringfietspad
658,Ringfietspad Jan Van Rijswijcklaan,2023-03-27,08:00:00,144,46,98,FMN 11 A Jan Van Rijswijcklaan Ringfietspad
658,Ringfietspad Jan Van Rijswijcklaan,2023-03-27,09:00:00,48,19,29,FMN 11 A Jan Van Rijswijcklaan Ringfietspad
658,Ringfietspad Jan Van Rijswijcklaan,2023-03-27,10:00:00,35,14,21,FMN 11 A Jan Van Rijswijcklaan Ringfietspad
658,Ringfietspad Jan Van Rijswijcklaan,2023-03-27,11:00:00,27,11,16,FMN 11 A Jan Van Rijswijcklaan Ringfietspad
658,Ringfietspad Jan Van Rijswijcklaan,2023-03-27,12:00:00,49,20,29,FMN 11 A Jan Van Rijswijcklaan Ringfietspad
658,Ringfietspad Jan Van Rijswijcklaan,2023-03-27,13:00:00,49,18,31,FMN 11 A Jan Van Rijswijcklaan Ringfietspad
658,Ringfietspad Jan Van Rijswijcklaan,2023-03-27,14:00:00,59,33,26,FMN 11 A Jan Van Rijswijcklaan Ringfietspad
658,Ringfietspad Jan Van Rijswijcklaan,2023-03-27,15:00:00,81,61,20,FMN 11 A Jan Van Rijswijcklaan Ringfietspad
658,Ringfietspad Jan Van Rijswijcklaan,2023-03-27,16:00:00,128,88,40,FMN 11 A Jan Van Rijswijcklaan Ringfietspad
658,Ringfietspad Jan Van Rijswijcklaan,2023-03-27,17:00:00,135,93,42,FMN 11 A Jan Van Rijswijcklaan Ringfietspad
658,Ringfietspad Jan Van Rijswijcklaan,2023-03-27,18:00:00,74,46,28,FMN 11 A Jan Van Rijswijcklaan Ringfietspad
658,Ringfietspad Jan Van Rijswijcklaan,2023-03-27,19:00:00,43,25,18,FMN 11 A Jan Van Rijswijcklaan Ringfietspad
658,Ringfietspad Jan Van Rijswijcklaan,2023-03-27,20:00:00,29,12,17,FMN 11 A Jan Van Rijswijcklaan Ringfietspad
658,Ringfietspad Jan Van Rijswijcklaan,2023-03-27,21:00:00,23,11,12,FMN 11 A Jan Van Rijswijcklaan Ringfietspad
658,Ringfietspad Jan Van Rijswijcklaan,2023-03-27,22:00:00,22,19,3,FMN 11 A Jan Van Rijswijcklaan Ringfietspad
658,Ringfietspad Jan Van Rijswijcklaan,2023-03-27,23:00:00,1,1,0,FMN 11 A Jan Van Rijswijcklaan Ringfietspad
658,Ringfietspad Jan Van Rijswijcklaan,2023-03-28,00:00:00,0,0,0,FMN 11 A Jan Van Rijswijcklaan Ringfietspad
658,Ringfietspad Jan Van Rijswijcklaan,2023-03-28,01:00:00,1,0,1,FMN 11 A Jan Van Rijswijcklaan Ringfietspad
658,Ringfietspad Jan Van Rijswijcklaan,2023-03-28,02:00:00,1,0,1,FMN 11 A Jan Van Rijswijcklaan Ringfietspad
658,Ringfietspad Jan Van Rijswijcklaan,2023-03-28,03:00:00,3,2,1,FMN 11 A Jan Van Rijswijcklaan Ringfietspad
658,Ringfietspad Jan Van Rijswijcklaan,2023-03-28,04:00:00,8,5,3,FMN 11 A Jan Van Rijswijcklaan Ringfietspad
658,Ringfietspad Jan Van Rijswijcklaan,2023-03-28,05:00:00,25,5,20,FMN 11 A Jan Van Rijswijcklaan Ringfietspad
658,Ringfietspad Jan Van Rijswijcklaan,2023-03-28,06:00:00,64,17,47,FMN 11 A Jan Van Rijswijcklaan Ringfietspad
658,Ringfietspad Jan Van Rijswijcklaan,2023-03-28,07:00:00,123,46,77,FMN 11 A Jan Van Rijswijcklaan Ringfietspad
658,Ringfietspad Jan Van Rijswijcklaan,2023-03-28,08:00:00,148,51,97,FMN 11 A Jan Van Rijswijcklaan Ringfietspad
658,Ringfietspad Jan Van Rijswijcklaan,2023-03-28,09:00:00,59,18,41,FMN 11 A Jan Van Rijswijcklaan Ringfietspad
658,Ringfietspad Jan Van Rijswijcklaan,2023-03-28,10:00:00,30,15,15,FMN 11 A Jan Van Rijswijcklaan Ringfietspad
658,Ringfietspad Jan Van Rijswijcklaan,2023-03-28,11:00:00,39,18,21,FMN 11 A Jan Van Rijswijcklaan Ringfietspad
658,Ringfietspad Jan Van Rijswijcklaan,2023-03-28,12:00:00,50,24,26,FMN 11 A Jan Van Rijswijcklaan Ringfietspad
658,Ringfietspad Jan Van Rijswijcklaan,2023-03-28,13:00:00,64,34,30,FMN 11 A Jan Van Rijswijcklaan Ringfietspad
658,Ringfietspad Jan Van Rijswijcklaan,2023-03-28,14:00:00,58,32,26,FMN 11 A Jan Van Rijswijcklaan Ringfietspad
658,Ringfietspad Jan Van Rijswijcklaan,2023-03-28,15:00:00,86,58,28,FMN 11 A Jan Van Rijswijcklaan Ringfietspad
658,Ringfietspad Jan Van Rijswijcklaan,2023-03-28,16:00:00,130,89,41,FMN 11 A Jan Van Rijswijcklaan Ringfietspad
658,Ringfietspad Jan Van Rijswijcklaan,2023-03-28,17:00:00,155,104,51,FMN 11 A Jan Van Rijswijcklaan Ringfietspad
658,Ringfietspad Jan Van Rijswijcklaan,2023-03-28,18:00:00,88,49,39,FMN 11 A Jan Van Rijswijcklaan Ringfietspad
658,Ringfietspad Jan Van Rijswijcklaan,2023-03-28,19:00:00,37,24,13,FMN 11 A Jan Van Rijswijcklaan Ringfietspad
658,Ringfietspad Jan Van Rijswijcklaan,2023-03-28,20:00:00,37,15,22,FMN 11 A Jan Van Rijswijcklaan Ringfietspad
658,Ringfietspad Jan Van Rijswijcklaan,2023-03-28,21:00:00,21,14,7,FMN 11 A Jan Van Rijswijcklaan Ringfietspad
658,Ringfietspad Jan Van Rijswijcklaan,2023-03-28,22:00:00,12,8,4,FMN 11 A Jan Van Rijswijcklaan Ringfietspad
658,Ringfietspad Jan Van Rijswijcklaan,2023-03-28,23:00:00,3,1,2,FMN 11 A Jan Van Rijswijcklaan Ringfietspad
658,Ringfietspad Jan Van Rijswijcklaan,2023-03-29,00:00:00,2,2,0,FMN 11 A Jan Van Rijswijcklaan Ringfietspad
658,Ringfietspad Jan Van Rijswijcklaan,2023-03-29,01:00:00,2,2,0,FMN 11 A Jan Van Rijswijcklaan Ringfietspad
658,Ringfietspad Jan Van Rijswijcklaan,2023-03-29,02:00:00,0,0,0,FMN 11 A Jan Van Rijswijcklaan Ringfietspad
658,Ringfietspad Jan Van Rijswijcklaan,2023-03-29,03:00:00,0,0,0,FMN 11 A Jan Van Rijswijcklaan Ringfietspad
658,Ringfietspad Jan Van Rijswijcklaan,2023-03-29,04:00:00,5,1,4,FMN 11 A Jan Van Rijswijcklaan Ringfietspad
658,Ringfietspad Jan Van Rijswijcklaan,2023-03-29,05:00:00,19,6,13,FMN 11 A Jan Van Rijswijcklaan Ringfietspad
658,Ringfietspad Jan Van Rijswijcklaan,2023-03-29,06:00:00,65,15,50,FMN 11 A Jan Van Rijswijcklaan Ringfietspad
658,Ringfietspad Jan Van Rijswijcklaan,2023-03-29,07:00:00,126,44,82,FMN 11 A Jan Van Rijswijcklaan Ringfietspad
658,Ringfietspad Jan Van Rijswijcklaan,2023-03-29,08:00:00,156,60,96,FMN 11 A Jan Van Rijswijcklaan Ringfietspad
658,Ringfietspad Jan Van Rijswijcklaan,2023-03-29,09:00:00,59,21,38,FMN 11 A Jan Van Rijswijcklaan Ringfietspad
658,Ringfietspad Jan Van Rijswijcklaan,2023-03-29,10:00:00,36,14,22,FMN 11 A Jan Van Rijswijcklaan Ringfietspad
658,Ringfietspad Jan Van Rijswijcklaan,2023-03-29,11:00:00,52,27,25,FMN 11 A Jan Van Rijswijcklaan Ringfietspad
658,Ringfietspad Jan Van Rijswijcklaan,2023-03-29,12:00:00,62,29,33,FMN 11 A Jan Van Rijswijcklaan Ringfietspad
658,Ringfietspad Jan Van Rijswijcklaan,2023-03-29,13:00:00,66,32,34,FMN 11 A Jan Van Rijswijcklaan Ringfietspad
658,Ringfietspad Jan Van Rijswijcklaan,2023-03-29,14:00:00,71,36,35,FMN 11 A Jan Van Rijswijcklaan Ringfietspad
658,Ringfietspad Jan Van Rijswijcklaan,2023-03-29,15:00:00,83,52,31,FMN 11 A Jan Van Rijswijcklaan Ringfietspad
658,Ringfietspad Jan Van Rijswijcklaan,2023-03-29,16:00:00,122,80,42,FMN 11 A Jan Van Rijswijcklaan Ringfietspad
658,Ringfietspad Jan Van Rijswijcklaan,2023-03-29,17:00:00,143,89,54,FMN 11 A Jan Van Rijswijcklaan Ringfietspad
658,Ringfietspad Jan Van Rijswijcklaan,2023-03-29,18:00:00,98,49,49,FMN 11 A Jan Van Rijswijcklaan Ringfietspad
658,Ringfietspad Jan Van Rijswijcklaan,2023-03-29,19:00:00,52,30,22,FMN 11 A Jan Van Rijswijcklaan Ringfietspad
658,Ringfietspad Jan Van Rijswijcklaan,2023-03-29,20:00:00,19,9,10,FMN 11 A Jan Van Rijswijcklaan Ringfietspad
658,Ringfietspad Jan Van Rijswijcklaan,2023-03-29,21:00:00,24,15,9,FMN 11 A Jan Van Rijswijcklaan Ringfietspad
658,Ringfietspad Jan Van Rijswijcklaan,2023-03-29,22:00:00,30,24,6,FMN 11 A Jan Van Rijswijcklaan Ringfietspad
658,Ringfietspad Jan Van Rijswijcklaan,2023-03-29,23:00:00,8,6,2,FMN 11 A Jan Van Rijswijcklaan Ringfietspad
658,Ringfietspad Jan Van Rijswijcklaan,2023-03-30,00:00:00,1,0,1,FMN 11 A Jan Van Rijswijcklaan Ringfietspad
658,Ringfietspad Jan Van Rijswijcklaan,2023-03-30,01:00:00,1,0,1,FMN 11 A Jan Van Rijswijcklaan Ringfietspad
658,Ringfietspad Jan Van Rijswijcklaan,2023-03-30,02:00:00,2,1,1,FMN 11 A Jan Van Rijswijcklaan Ringfietspad
658,Ringfietspad Jan Van Rijswijcklaan,2023-03-30,03:00:00,5,4,1,FMN 11 A Jan Van Rijswijcklaan Ringfietspad
658,Ringfietspad Jan Van Rijswijcklaan,2023-03-30,04:00:00,11,5,6,FMN 11 A Jan Van Rijswijcklaan Ringfietspad
658,Ringfietspad Jan Van Rijswijcklaan,2023-03-30,05:00:00,16,5,11,FMN 11 A Jan Van Rijswijcklaan Ringfietspad
658,Ringfietspad Jan Van Rijswijcklaan,2023-03-30,06:00:00,53,15,38,FMN 11 A Jan Van Rijswijcklaan Ringfietspad
658,Ringfietspad Jan Van Rijswijcklaan,2023-03-30,07:00:00,121,44,77,FMN 11 A Jan Van Rijswijcklaan Ringfietspad
658,Ringfietspad Jan Van Rijswijcklaan,2023-03-30,08:00:00,147,51,96,FMN 11 A Jan Van Rijswijcklaan Ringfietspad
658,Ringfietspad Jan Van Rijswijcklaan,2023-03-30,09:00:00,56,20,36,FMN 11 A Jan Van Rijswijcklaan Ringfietspad
658,Ringfietspad Jan Van Rijswijcklaan,2023-03-30,10:00:00,39,16,23,FMN 11 A Jan Van Rijswijcklaan Ringfietspad
658,Ringfietspad Jan Van Rijswijcklaan,2023-03-30,11:00:00,38,16,22,FMN 11 A Jan Van Rijswijcklaan Ringfietspad
658,Ringfietspad Jan Van Rijswijcklaan,2023-03-30,12:00:00,40,17,23,FMN 11 A Jan Van Rijswijcklaan Ringfietspad
658,Ringfietspad Jan Van Rijswijcklaan,2023-03-30,13:00:00,57,24,33,FMN 11 A Jan Van Rijswijcklaan Ringfietspad
658,Ringfietspad Jan Van Rijswijcklaan,2023-03-30,14:00:00,62,38,24,FMN 11 A Jan Van Rijswijcklaan Ringfietspad
658,Ringfietspad Jan Van Rijswijcklaan,2023-03-30,15:00:00,92,63,29,FMN 11 A Jan Van Rijswijcklaan Ringfietspad
658,Ringfietspad Jan Van Rijswijcklaan,2023-03-30,16:00:00,143,101,42,FMN 11 A Jan Van Rijswijcklaan Ringfietspad
658,Ringfietspad Jan Van Rijswijcklaan,2023-03-30,17:00:00,141,99,42,FMN 11 A Jan Van Rijswijcklaan Ringfietspad
658,Ringfietspad Jan Van Rijswijcklaan,2023-03-30,18:00:00,88,50,38,FMN 11 A Jan Van Rijswijcklaan Ringfietspad
658,Ringfietspad Jan Van Rijswijcklaan,2023-03-30,19:00:00,49,28,21,FMN 11 A Jan Van Rijswijcklaan Ringfietspad
658,Ringfietspad Jan Van Rijswijcklaan,2023-03-30,20:00:00,26,15,11,FMN 11 A Jan Van Rijswijcklaan Ringfietspad
658,Ringfietspad Jan Van Rijswijcklaan,2023-03-30,21:00:00,21,10,11,FMN 11 A Jan Van Rijswijcklaan Ringfietspad
658,Ringfietspad Jan Van Rijswijcklaan,2023-03-30,22:00:00,16,10,6,FMN 11 A Jan Van Rijswijcklaan Ringfietspad
658,Ringfietspad Jan Van Rijswijcklaan,2023-03-30,23:00:00,7,6,1,FMN 11 A Jan Van Rijswijcklaan Ringfietspad
658,Ringfietspad Jan Van Rijswijcklaan,2023-03-31,00:00:00,1,1,0,FMN 11 A Jan Van Rijswijcklaan Ringfietspad
658,Ringfietspad Jan Van Rijswijcklaan,2023-03-31,01:00:00,0,0,0,FMN 11 A Jan Van Rijswijcklaan Ringfietspad
658,Ringfietspad Jan Van Rijswijcklaan,2023-03-31,02:00:00,2,2,0,FMN 11 A Jan Van Rijswijcklaan Ringfietspad
658,Ringfietspad Jan Van Rijswijcklaan,2023-03-31,03:00:00,1,1,0,FMN 11 A Jan Van Rijswijcklaan Ringfietspad
658,Ringfietspad Jan Van Rijswijcklaan,2023-03-31,04:00:00,9,4,5,FMN 11 A Jan Van Rijswijcklaan Ringfietspad
658,Ringfietspad Jan Van Rijswijcklaan,2023-03-31,05:00:00,18,5,13,FMN 11 A Jan Van Rijswijcklaan Ringfietspad
658,Ringfietspad Jan Van Rijswijcklaan,2023-03-31,06:00:00,43,14,29,FMN 11 A Jan Van Rijswijcklaan Ringfietspad
658,Ringfietspad Jan Van Rijswijcklaan,2023-03-31,07:00:00,77,27,50,FMN 11 A Jan Van Rijswijcklaan Ringfietspad
658,Ringfietspad Jan Van Rijswijcklaan,2023-03-31,08:00:00,106,37,69,FMN 11 A Jan Van Rijswijcklaan Ringfietspad
658,Ringfietspad Jan Van Rijswijcklaan,2023-03-31,09:00:00,38,11,27,FMN 11 A Jan Van Rijswijcklaan Ringfietspad
658,Ringfietspad Jan Van Rijswijcklaan,2023-03-31,10:00:00,35,21,14,FMN 11 A Jan Van Rijswijcklaan Ringfietspad
658,Ringfietspad Jan Van Rijswijcklaan,2023-03-31,11:00:00,25,13,12,FMN 11 A Jan Van Rijswijcklaan Ringfietspad
658,Ringfietspad Jan Van Rijswijcklaan,2023-03-31,12:00:00,31,15,16,FMN 11 A Jan Van Rijswijcklaan Ringfietspad
658,Ringfietspad Jan Van Rijswijcklaan,2023-03-31,13:00:00,46,27,19,FMN 11 A Jan Van Rijswijcklaan Ringfietspad
658,Ringfietspad Jan Van Rijswijcklaan,2023-03-31,14:00:00,41,26,15,FMN 11 A Jan Van Rijswijcklaan Ringfietspad
658,Ringfietspad Jan Van Rijswijcklaan,2023-03-31,15:00:00,70,45,25,FMN 11 A Jan Van Rijswijcklaan Ringfietspad
658,Ringfietspad Jan Van Rijswijcklaan,2023-03-31,16:00:00,98,61,37,FMN 11 A Jan Van Rijswijcklaan Ringfietspad
658,Ringfietspad Jan Van Rijswijcklaan,2023-03-31,17:00:00,72,45,27,FMN 11 A Jan Van Rijswijcklaan Ringfietspad
658,Ringfietspad Jan Van Rijswijcklaan,2023-03-31,18:00:00,44,29,15,FMN 11 A Jan Van Rijswijcklaan Ringfietspad
658,Ringfietspad Jan Van Rijswijcklaan,2023-03-31,19:00:00,29,17,12,FMN 11 A Jan Van Rijswijcklaan Ringfietspad
658,Ringfietspad Jan Van Rijswijcklaan,2023-03-31,20:00:00,26,12,14,FMN 11 A Jan Van Rijswijcklaan Ringfietspad
658,Ringfietspad Jan Van Rijswijcklaan,2023-03-31,21:00:00,10,6,4,FMN 11 A Jan Van Rijswijcklaan Ringfietspad
658,Ringfietspad Jan Van Rijswijcklaan,2023-03-31,22:00:00,12,10,2,FMN 11 A Jan Van Rijswijcklaan Ringfietspad
658,Ringfietspad Jan Van Rijswijcklaan,2023-03-31,23:00:00,6,3,3,FMN 11 A Jan Van Rijswijcklaan Ringfietspad
658,Ringfietspad Jan Van Rijswijcklaan,2023-04-01,00:00:00,1,0,1,FMN 11 A Jan Van Rijswijcklaan Ringfietspad
658,Ringfietspad Jan Van Rijswijcklaan,2023-04-01,01:00:00,1,0,1,FMN 11 A Jan Van Rijswijcklaan Ringfietspad
658,Ringfietspad Jan Van Rijswijcklaan,2023-04-01,02:00:00,3,3,0,FMN 11 A Jan Van Rijswijcklaan Ringfietspad
658,Ringfietspad Jan Van Rijswijcklaan,2023-04-01,03:00:00,3,3,0,FMN 11 A Jan Van Rijswijcklaan Ringfietspad
658,Ringfietspad Jan Van Rijswijcklaan,2023-04-01,04:00:00,2,0,2,FMN 11 A Jan Van Rijswijcklaan Ringfietspad
658,Ringfietspad Jan Van Rijswijcklaan,2023-04-01,05:00:00,2,0,2,FMN 11 A Jan Van Rijswijcklaan Ringfietspad
658,Ringfietspad Jan Van Rijswijcklaan,2023-04-01,06:00:00,2,1,1,FMN 11 A Jan Van Rijswijcklaan Ringfietspad
658,Ringfietspad Jan Van Rijswijcklaan,2023-04-01,07:00:00,4,2,2,FMN 11 A Jan Van Rijswijcklaan Ringfietspad
658,Ringfietspad Jan Van Rijswijcklaan,2023-04-01,08:00:00,9,4,5,FMN 11 A Jan Van Rijswijcklaan Ringfietspad
658,Ringfietspad Jan Van Rijswijcklaan,2023-04-01,09:00:00,19,7,12,FMN 11 A Jan Van Rijswijcklaan Ringfietspad
658,Ringfietspad Jan Van Rijswijcklaan,2023-04-01,10:00:00,14,6,8,FMN 11 A Jan Van Rijswijcklaan Ringfietspad
658,Ringfietspad Jan Van Rijswijcklaan,2023-04-01,11:00:00,19,7,12,FMN 11 A Jan Van Rijswijcklaan Ringfietspad
658,Ringfietspad Jan Van Rijswijcklaan,2023-04-01,12:00:00,24,15,9,FMN 11 A Jan Van Rijswijcklaan Ringfietspad
658,Ringfietspad Jan Van Rijswijcklaan,2023-04-01,13:00:00,40,22,18,FMN 11 A Jan Van Rijswijcklaan Ringfietspad
658,Ringfietspad Jan Van Rijswijcklaan,2023-04-01,14:00:00,28,15,13,FMN 11 A Jan Van Rijswijcklaan Ringfietspad
658,Ringfietspad Jan Van Rijswijcklaan,2023-04-01,15:00:00,22,9,13,FMN 11 A Jan Van Rijswijcklaan Ringfietspad
658,Ringfietspad Jan Van Rijswijcklaan,2023-04-01,16:00:00,35,23,12,FMN 11 A Jan Van Rijswijcklaan Ringfietspad
658,Ringfietspad Jan Van Rijswijcklaan,2023-04-01,17:00:00,22,15,7,FMN 11 A Jan Van Rijswijcklaan Ringfietspad
658,Ringfietspad Jan Van Rijswijcklaan,2023-04-01,18:00:00,22,10,12,FMN 11 A Jan Van Rijswijcklaan Ringfietspad
658,Ringfietspad Jan Van Rijswijcklaan,2023-04-01,19:00:00,8,4,4,FMN 11 A Jan Van Rijswijcklaan Ringfietspad
658,Ringfietspad Jan Van Rijswijcklaan,2023-04-01,20:00:00,7,5,2,FMN 11 A Jan Van Rijswijcklaan Ringfietspad
658,Ringfietspad Jan Van Rijswijcklaan,2023-04-01,21:00:00,8,5,3,FMN 11 A Jan Van Rijswijcklaan Ringfietspad
658,Ringfietspad Jan Van Rijswijcklaan,2023-04-01,22:00:00,4,3,1,FMN 11 A Jan Van Rijswijcklaan Ringfietspad
658,Ringfietspad Jan Van Rijswijcklaan,2023-04-01,23:00:00,2,2,0,FMN 11 A Jan Van Rijswijcklaan Ringfietspad
658,Ringfietspad Jan Van Rijswijcklaan,2023-04-02,00:00:00,3,2,1,FMN 11 A Jan Van Rijswijcklaan Ringfietspad
658,Ringfietspad Jan Van Rijswijcklaan,2023-04-02,01:00:00,2,1,1,FMN 11 A Jan Van Rijswijcklaan Ringfietspad
658,Ringfietspad Jan Van Rijswijcklaan,2023-04-02,02:00:00,2,1,1,FMN 11 A Jan Van Rijswijcklaan Ringfietspad
658,Ringfietspad Jan Van Rijswijcklaan,2023-04-02,03:00:00,2,2,0,FMN 11 A Jan Van Rijswijcklaan Ringfietspad
658,Ringfietspad Jan Van Rijswijcklaan,2023-04-02,04:00:00,1,0,1,FMN 11 A Jan Van Rijswijcklaan Ringfietspad
658,Ringfietspad Jan Van Rijswijcklaan,2023-04-02,05:00:00,1,0,1,FMN 11 A Jan Van Rijswijcklaan Ringfietspad
658,Ringfietspad Jan Van Rijswijcklaan,2023-04-02,06:00:00,6,3,3,FMN 11 A Jan Van Rijswijcklaan Ringfietspad
658,Ringfietspad Jan Van Rijswijcklaan,2023-04-02,07:00:00,7,3,4,FMN 11 A Jan Van Rijswijcklaan Ringfietspad
658,Ringfietspad Jan Van Rijswijcklaan,2023-04-02,08:00:00,18,7,11,FMN 11 A Jan Van Rijswijcklaan Ringfietspad
658,Ringfietspad Jan Van Rijswijcklaan,2023-04-02,09:00:00,28,11,17,FMN 11 A Jan Van Rijswijcklaan Ringfietspad
658,Ringfietspad Jan Van Rijswijcklaan,2023-04-02,10:00:00,35,13,22,FMN 11 A Jan Van Rijswijcklaan Ringfietspad
658,Ringfietspad Jan Van Rijswijcklaan,2023-04-02,11:00:00,31,21,10,FMN 11 A Jan Van Rijswijcklaan Ringfietspad
658,Ringfietspad Jan Van Rijswijcklaan,2023-04-02,12:00:00,36,19,17,FMN 11 A Jan Van Rijswijcklaan Ringfietspad
658,Ringfietspad Jan Van Rijswijcklaan,2023-04-02,13:00:00,45,20,25,FMN 11 A Jan Van Rijswijcklaan Ringfietspad
658,Ringfietspad Jan Van Rijswijcklaan,2023-04-02,14:00:00,51,23,28,FMN 11 A Jan Van Rijswijcklaan Ringfietspad
658,Ringfietspad Jan Van Rijswijcklaan,2023-04-02,15:00:00,45,24,21,FMN 11 A Jan Van Rijswijcklaan Ringfietspad
658,Ringfietspad Jan Van Rijswijcklaan,2023-04-02,16:00:00,31,17,14,FMN 11 A Jan Van Rijswijcklaan Ringfietspad
658,Ringfietspad Jan Van Rijswijcklaan,2023-04-02,17:00:00,31,23,8,FMN 11 A Jan Van Rijswijcklaan Ringfietspad
658,Ringfietspad Jan Van Rijswijcklaan,2023-04-02,18:00:00,21,12,9,FMN 11 A Jan Van Rijswijcklaan Ringfietspad
658,Ringfietspad Jan Van Rijswijcklaan,2023-04-02,19:00:00,15,6,9,FMN 11 A Jan Van Rijswijcklaan Ringfietspad
658,Ringfietspad Jan Van Rijswijcklaan,2023-04-02,20:00:00,7,3,4,FMN 11 A Jan Van Rijswijcklaan Ringfietspad
658,Ringfietspad Jan Van Rijswijcklaan,2023-04-02,21:00:00,8,4,4,FMN 11 A Jan Van Rijswijcklaan Ringfietspad
658,Ringfietspad Jan Van Rijswijcklaan,2023-04-02,22:00:00,8,3,5,FMN 11 A Jan Van Rijswijcklaan Ringfietspad
658,Ringfietspad Jan Van Rijswijcklaan,2023-04-02,23:00:00,4,3,1,FMN 11 A Jan Van Rijswijcklaan Ringfietspad
658,Ringfietspad Jan Van Rijswijcklaan,2023-04-03,00:00:00,0,0,0,FMN 11 A Jan Van Rijswijcklaan Ringfietspad
658,Ringfietspad Jan Van Rijswijcklaan,2023-04-03,01:00:00,0,0,0,FMN 11 A Jan Van Rijswijcklaan Ringfietspad
658,Ringfietspad Jan Van Rijswijcklaan,2023-04-03,02:00:00,0,0,0,FMN 11 A Jan Van Rijswijcklaan Ringfietspad
658,Ringfietspad Jan Van Rijswijcklaan,2023-04-03,03:00:00,2,2,0,FMN 11 A Jan Van Rijswijcklaan Ringfietspad
658,Ringfietspad Jan Van Rijswijcklaan,2023-04-03,04:00:00,6,4,2,FMN 11 A Jan Van Rijswijcklaan Ringfietspad
658,Ringfietspad Jan Van Rijswijcklaan,2023-04-03,05:00:00,15,5,10,FMN 11 A Jan Van Rijswijcklaan Ringfietspad
658,Ringfietspad Jan Van Rijswijcklaan,2023-04-03,06:00:00,33,7,26,FMN 11 A Jan Van Rijswijcklaan Ringfietspad
658,Ringfietspad Jan Van Rijswijcklaan,2023-04-03,07:00:00,79,25,54,FMN 11 A Jan Van Rijswijcklaan Ringfietspad
658,Ringfietspad Jan Van Rijswijcklaan,2023-04-03,08:00:00,110,42,68,FMN 11 A Jan Van Rijswijcklaan Ringfietspad
658,Ringfietspad Jan Van Rijswijcklaan,2023-04-03,09:00:00,32,10,22,FMN 11 A Jan Van Rijswijcklaan Ringfietspad
658,Ringfietspad Jan Van Rijswijcklaan,2023-04-03,10:00:00,24,13,11,FMN 11 A Jan Van Rijswijcklaan Ringfietspad
658,Ringfietspad Jan Van Rijswijcklaan,2023-04-03,11:00:00,25,13,12,FMN 11 A Jan Van Rijswijcklaan Ringfietspad
658,Ringfietspad Jan Van Rijswijcklaan,2023-04-03,12:00:00,35,18,17,FMN 11 A Jan Van Rijswijcklaan Ringfietspad
658,Ringfietspad Jan Van Rijswijcklaan,2023-04-03,13:00:00,25,10,15,FMN 11 A Jan Van Rijswijcklaan Ringfietspad
658,Ringfietspad Jan Van Rijswijcklaan,2023-04-03,14:00:00,49,26,23,FMN 11 A Jan Van Rijswijcklaan Ringfietspad
658,Ringfietspad Jan Van Rijswijcklaan,2023-04-03,15:00:00,64,36,28,FMN 11 A Jan Van Rijswijcklaan Ringfietspad
658,Ringfietspad Jan Van Rijswijcklaan,2023-04-03,16:00:00,92,67,25,FMN 11 A Jan Van Rijswijcklaan Ringfietspad
658,Ringfietspad Jan Van Rijswijcklaan,2023-04-03,17:00:00,106,73,33,FMN 11 A Jan Van Rijswijcklaan Ringfietspad
658,Ringfietspad Jan Van Rijswijcklaan,2023-04-03,18:00:00,54,32,22,FMN 11 A Jan Van Rijswijcklaan Ringfietspad
658,Ringfietspad Jan Van Rijswijcklaan,2023-04-03,19:00:00,34,13,21,FMN 11 A Jan Van Rijswijcklaan Ringfietspad
658,Ringfietspad Jan Van Rijswijcklaan,2023-04-03,20:00:00,19,9,10,FMN 11 A Jan Van Rijswijcklaan Ringfietspad
658,Ringfietspad Jan Van Rijswijcklaan,2023-04-03,21:00:00,14,7,7,FMN 11 A Jan Van Rijswijcklaan Ringfietspad
658,Ringfietspad Jan Van Rijswijcklaan,2023-04-03,22:00:00,20,12,8,FMN 11 A Jan Van Rijswijcklaan Ringfietspad
658,Ringfietspad Jan Van Rijswijcklaan,2023-04-03,23:00:00,7,6,1,FMN 11 A Jan Van Rijswijcklaan Ringfietspad
658,Ringfietspad Jan Van Rijswijcklaan,2023-04-04,00:00:00,1,0,1,FMN 11 A Jan Van Rijswijcklaan Ringfietspad
658,Ringfietspad Jan Van Rijswijcklaan,2023-04-04,01:00:00,0,0,0,FMN 11 A Jan Van Rijswijcklaan Ringfietspad
658,Ringfietspad Jan Van Rijswijcklaan,2023-04-04,02:00:00,0,0,0,FMN 11 A Jan Van Rijswijcklaan Ringfietspad
658,Ringfietspad Jan Van Rijswijcklaan,2023-04-04,03:00:00,1,1,0,FMN 11 A Jan Van Rijswijcklaan Ringfietspad
658,Ringfietspad Jan Van Rijswijcklaan,2023-04-04,04:00:00,5,2,3,FMN 11 A Jan Van Rijswijcklaan Ringfietspad
658,Ringfietspad Jan Van Rijswijcklaan,2023-04-04,05:00:00,16,4,12,FMN 11 A Jan Van Rijswijcklaan Ringfietspad
658,Ringfietspad Jan Van Rijswijcklaan,2023-04-04,06:00:00,46,11,35,FMN 11 A Jan Van Rijswijcklaan Ringfietspad
658,Ringfietspad Jan Van Rijswijcklaan,2023-04-04,07:00:00,76,29,47,FMN 11 A Jan Van Rijswijcklaan Ringfietspad
658,Ringfietspad Jan Van Rijswijcklaan,2023-04-04,08:00:00,102,31,71,FMN 11 A Jan Van Rijswijcklaan Ringfietspad
658,Ringfietspad Jan Van Rijswijcklaan,2023-04-04,09:00:00,42,14,28,FMN 11 A Jan Van Rijswijcklaan Ringfietspad
658,Ringfietspad Jan Van Rijswijcklaan,2023-04-04,10:00:00,28,10,18,FMN 11 A Jan Van Rijswijcklaan Ringfietspad
658,Ringfietspad Jan Van Rijswijcklaan,2023-04-04,11:00:00,34,15,19,FMN 11 A Jan Van Rijswijcklaan Ringfietspad
658,Ringfietspad Jan Van Rijswijcklaan,2023-04-04,12:00:00,33,16,17,FMN 11 A Jan Van Rijswijcklaan Ringfietspad
658,Ringfietspad Jan Van Rijswijcklaan,2023-04-04,13:00:00,40,21,19,FMN 11 A Jan Van Rijswijcklaan Ringfietspad
658,Ringfietspad Jan Van Rijswijcklaan,2023-04-04,14:00:00,40,20,20,FMN 11 A Jan Van Rijswijcklaan Ringfietspad
658,Ringfietspad Jan Van Rijswijcklaan,2023-04-04,15:00:00,62,46,16,FMN 11 A Jan Van Rijswijcklaan Ringfietspad
658,Ringfietspad Jan Van Rijswijcklaan,2023-04-04,16:00:00,101,66,35,FMN 11 A Jan Van Rijswijcklaan Ringfietspad
658,Ringfietspad Jan Van Rijswijcklaan,2023-04-04,17:00:00,110,71,39,FMN 11 A Jan Van Rijswijcklaan Ringfietspad
658,Ringfietspad Jan Van Rijswijcklaan,2023-04-04,18:00:00,56,32,24,FMN 11 A Jan Van Rijswijcklaan Ringfietspad
658,Ringfietspad Jan Van Rijswijcklaan,2023-04-04,19:00:00,26,14,12,FMN 11 A Jan Van Rijswijcklaan Ringfietspad
658,Ringfietspad Jan Van Rijswijcklaan,2023-04-04,20:00:00,18,7,11,FMN 11 A Jan Van Rijswijcklaan Ringfietspad
658,Ringfietspad Jan Van Rijswijcklaan,2023-04-04,21:00:00,8,3,5,FMN 11 A Jan Van Rijswijcklaan Ringfietspad
658,Ringfietspad Jan Van Rijswijcklaan,2023-04-04,22:00:00,11,6,5,FMN 11 A Jan Van Rijswijcklaan Ringfietspad
658,Ringfietspad Jan Van Rijswijcklaan,2023-04-04,23:00:00,6,4,2,FMN 11 A Jan Van Rijswijcklaan Ringfietspad
658,Ringfietspad Jan Van Rijswijcklaan,2023-04-05,00:00:00,3,2,1,FMN 11 A Jan Van Rijswijcklaan Ringfietspad
658,Ringfietspad Jan Van Rijswijcklaan,2023-04-05,01:00:00,1,1,0,FMN 11 A Jan Van Rijswijcklaan Ringfietspad
658,Ringfietspad Jan Van Rijswijcklaan,2023-04-05,02:00:00,1,0,1,FMN 11 A Jan Van Rijswijcklaan Ringfietspad
658,Ringfietspad Jan Van Rijswijcklaan,2023-04-05,03:00:00,1,1,0,FMN 11 A Jan Van Rijswijcklaan Ringfietspad
658,Ringfietspad Jan Van Rijswijcklaan,2023-04-05,04:00:00,7,3,4,FMN 11 A Jan Van Rijswijcklaan Ringfietspad
658,Ringfietspad Jan Van Rijswijcklaan,2023-04-05,05:00:00,17,6,11,FMN 11 A Jan Van Rijswijcklaan Ringfietspad
658,Ringfietspad Jan Van Rijswijcklaan,2023-04-05,06:00:00,50,13,37,FMN 11 A Jan Van Rijswijcklaan Ringfietspad
658,Ringfietspad Jan Van Rijswijcklaan,2023-04-05,07:00:00,99,37,62,FMN 11 A Jan Van Rijswijcklaan Ringfietspad
658,Ringfietspad Jan Van Rijswijcklaan,2023-04-05,08:00:00,99,32,67,FMN 11 A Jan Van Rijswijcklaan Ringfietspad
658,Ringfietspad Jan Van Rijswijcklaan,2023-04-05,09:00:00,32,13,19,FMN 11 A Jan Van Rijswijcklaan Ringfietspad
658,Ringfietspad Jan Van Rijswijcklaan,2023-04-05,10:00:00,26,7,19,FMN 11 A Jan Van Rijswijcklaan Ringfietspad
658,Ringfietspad Jan Van Rijswijcklaan,2023-04-05,11:00:00,24,12,12,FMN 11 A Jan Van Rijswijcklaan Ringfietspad
658,Ringfietspad Jan Van Rijswijcklaan,2023-04-05,12:00:00,42,22,20,FMN 11 A Jan Van Rijswijcklaan Ringfietspad
658,Ringfietspad Jan Van Rijswijcklaan,2023-04-05,13:00:00,48,20,28,FMN 11 A Jan Van Rijswijcklaan Ringfietspad
658,Ringfietspad Jan Van Rijswijcklaan,2023-04-05,14:00:00,57,29,28,FMN 11 A Jan Van Rijswijcklaan Ringfietspad
658,Ringfietspad Jan Van Rijswijcklaan,2023-04-05,15:00:00,62,39,23,FMN 11 A Jan Van Rijswijcklaan Ringfietspad
658,Ringfietspad Jan Van Rijswijcklaan,2023-04-05,16:00:00,101,69,32,FMN 11 A Jan Van Rijswijcklaan Ringfietspad
658,Ringfietspad Jan Van Rijswijcklaan,2023-04-05,17:00:00,108,71,37,FMN 11 A Jan Van Rijswijcklaan Ringfietspad
658,Ringfietspad Jan Van Rijswijcklaan,2023-04-05,18:00:00,67,42,25,FMN 11 A Jan Van Rijswijcklaan Ringfietspad
658,Ringfietspad Jan Van Rijswijcklaan,2023-04-05,19:00:00,31,17,14,FMN 11 A Jan Van Rijswijcklaan Ringfietspad
658,Ringfietspad Jan Van Rijswijcklaan,2023-04-05,20:00:00,25,18,7,FMN 11 A Jan Van Rijswijcklaan Ringfietspad
658,Ringfietspad Jan Van Rijswijcklaan,2023-04-05,21:00:00,19,10,9,FMN 11 A Jan Van Rijswijcklaan Ringfietspad
658,Ringfietspad Jan Van Rijswijcklaan,2023-04-05,22:00:00,11,7,4,FMN 11 A Jan Van Rijswijcklaan Ringfietspad
658,Ringfietspad Jan Van Rijswijcklaan,2023-04-05,23:00:00,7,4,3,FMN 11 A Jan Van Rijswijcklaan Ringfietspad
658,Ringfietspad Jan Van Rijswijcklaan,2023-04-06,00:00:00,2,1,1,FMN 11 A Jan Van Rijswijcklaan Ringfietspad
658,Ringfietspad Jan Van Rijswijcklaan,2023-04-06,01:00:00,0,0,0,FMN 11 A Jan Van Rijswijcklaan Ringfietspad
658,Ringfietspad Jan Van Rijswijcklaan,2023-04-06,02:00:00,1,1,0,FMN 11 A Jan Van Rijswijcklaan Ringfietspad
658,Ringfietspad Jan Van Rijswijcklaan,2023-04-06,03:00:00,1,1,0,FMN 11 A Jan Van Rijswijcklaan Ringfietspad
658,Ringfietspad Jan Van Rijswijcklaan,2023-04-06,04:00:00,1,1,0,FMN 11 A Jan Van Rijswijcklaan Ringfietspad
658,Ringfietspad Jan Van Rijswijcklaan,2023-04-06,05:00:00,18,3,15,FMN 11 A Jan Van Rijswijcklaan Ringfietspad
658,Ringfietspad Jan Van Rijswijcklaan,2023-04-06,06:00:00,34,6,28,FMN 11 A Jan Van Rijswijcklaan Ringfietspad
658,Ringfietspad Jan Van Rijswijcklaan,2023-04-06,07:00:00,50,17,33,FMN 11 A Jan Van Rijswijcklaan Ringfietspad
658,Ringfietspad Jan Van Rijswijcklaan,2023-04-06,08:00:00,71,21,50,FMN 11 A Jan Van Rijswijcklaan Ringfietspad
658,Ringfietspad Jan Van Rijswijcklaan,2023-04-06,09:00:00,26,7,19,FMN 11 A Jan Van Rijswijcklaan Ringfietspad
658,Ringfietspad Jan Van Rijswijcklaan,2023-04-06,10:00:00,20,11,9,FMN 11 A Jan Van Rijswijcklaan Ringfietspad
658,Ringfietspad Jan Van Rijswijcklaan,2023-04-06,11:00:00,19,10,9,FMN 11 A Jan Van Rijswijcklaan Ringfietspad
658,Ringfietspad Jan Van Rijswijcklaan,2023-04-06,12:00:00,29,15,14,FMN 11 A Jan Van Rijswijcklaan Ringfietspad
658,Ringfietspad Jan Van Rijswijcklaan,2023-04-06,13:00:00,27,11,16,FMN 11 A Jan Van Rijswijcklaan Ringfietspad
658,Ringfietspad Jan Van Rijswijcklaan,2023-04-06,14:00:00,35,21,14,FMN 11 A Jan Van Rijswijcklaan Ringfietspad
658,Ringfietspad Jan Van Rijswijcklaan,2023-04-06,15:00:00,33,24,9,FMN 11 A Jan Van Rijswijcklaan Ringfietspad
658,Ringfietspad Jan Van Rijswijcklaan,2023-04-06,16:00:00,72,48,24,FMN 11 A Jan Van Rijswijcklaan Ringfietspad
658,Ringfietspad Jan Van Rijswijcklaan,2023-04-06,17:00:00,74,44,30,FMN 11 A Jan Van Rijswijcklaan Ringfietspad
658,Ringfietspad Jan Van Rijswijcklaan,2023-04-06,18:00:00,40,25,15,FMN 11 A Jan Van Rijswijcklaan Ringfietspad
658,Ringfietspad Jan Van Rijswijcklaan,2023-04-06,19:00:00,22,12,10,FMN 11 A Jan Van Rijswijcklaan Ringfietspad
658,Ringfietspad Jan Van Rijswijcklaan,2023-04-06,20:00:00,12,4,8,FMN 11 A Jan Van Rijswijcklaan Ringfietspad
658,Ringfietspad Jan Van Rijswijcklaan,2023-04-06,21:00:00,14,11,3,FMN 11 A Jan Van Rijswijcklaan Ringfietspad
658,Ringfietspad Jan Van Rijswijcklaan,2023-04-06,22:00:00,12,10,2,FMN 11 A Jan Van Rijswijcklaan Ringfietspad
658,Ringfietspad Jan Van Rijswijcklaan,2023-04-06,23:00:00,1,0,1,FMN 11 A Jan Van Rijswijcklaan Ringfietspad
658,Ringfietspad Jan Van Rijswijcklaan,2023-04-07,00:00:00,1,0,1,FMN 11 A Jan Van Rijswijcklaan Ringfietspad
658,Ringfietspad Jan Van Rijswijcklaan,2023-04-07,01:00:00,0,0,0,FMN 11 A Jan Van Rijswijcklaan Ringfietspad
658,Ringfietspad Jan Van Rijswijcklaan,2023-04-07,02:00:00,0,0,0,FMN 11 A Jan Van Rijswijcklaan Ringfietspad
658,Ringfietspad Jan Van Rijswijcklaan,2023-04-07,03:00:00,2,1,1,FMN 11 A Jan Van Rijswijcklaan Ringfietspad
658,Ringfietspad Jan Van Rijswijcklaan,2023-04-07,04:00:00,4,1,3,FMN 11 A Jan Van Rijswijcklaan Ringfietspad
658,Ringfietspad Jan Van Rijswijcklaan,2023-04-07,05:00:00,17,5,12,FMN 11 A Jan Van Rijswijcklaan Ringfietspad
658,Ringfietspad Jan Van Rijswijcklaan,2023-04-07,06:00:00,35,11,24,FMN 11 A Jan Van Rijswijcklaan Ringfietspad
658,Ringfietspad Jan Van Rijswijcklaan,2023-04-07,07:00:00,62,26,36,FMN 11 A Jan Van Rijswijcklaan Ringfietspad
658,Ringfietspad Jan Van Rijswijcklaan,2023-04-07,08:00:00,88,26,62,FMN 11 A Jan Van Rijswijcklaan Ringfietspad
658,Ringfietspad Jan Van Rijswijcklaan,2023-04-07,09:00:00,33,10,23,FMN 11 A Jan Van Rijswijcklaan Ringfietspad
658,Ringfietspad Jan Van Rijswijcklaan,2023-04-07,10:00:00,21,12,9,FMN 11 A Jan Van Rijswijcklaan Ringfietspad
658,Ringfietspad Jan Van Rijswijcklaan,2023-04-07,11:00:00,25,14,11,FMN 11 A Jan Van Rijswijcklaan Ringfietspad
658,Ringfietspad Jan Van Rijswijcklaan,2023-04-07,12:00:00,34,21,13,FMN 11 A Jan Van Rijswijcklaan Ringfietspad
658,Ringfietspad Jan Van Rijswijcklaan,2023-04-07,13:00:00,37,16,21,FMN 11 A Jan Van Rijswijcklaan Ringfietspad
658,Ringfietspad Jan Van Rijswijcklaan,2023-04-07,14:00:00,29,17,12,FMN 11 A Jan Van Rijswijcklaan Ringfietspad
658,Ringfietspad Jan Van Rijswijcklaan,2023-04-07,15:00:00,62,44,18,FMN 11 A Jan Van Rijswijcklaan Ringfietspad
658,Ringfietspad Jan Van Rijswijcklaan,2023-04-07,16:00:00,75,51,24,FMN 11 A Jan Van Rijswijcklaan Ringfietspad
658,Ringfietspad Jan Van Rijswijcklaan,2023-04-07,17:00:00,69,48,21,FMN 11 A Jan Van Rijswijcklaan Ringfietspad
658,Ringfietspad Jan Van Rijswijcklaan,2023-04-07,18:00:00,47,30,17,FMN 11 A Jan Van Rijswijcklaan Ringfietspad
658,Ringfietspad Jan Van Rijswijcklaan,2023-04-07,19:00:00,25,13,12,FMN 11 A Jan Van Rijswijcklaan Ringfietspad
658,Ringfietspad Jan Van Rijswijcklaan,2023-04-07,20:00:00,29,11,18,FMN 11 A Jan Van Rijswijcklaan Ringfietspad
658,Ringfietspad Jan Van Rijswijcklaan,2023-04-07,21:00:00,11,5,6,FMN 11 A Jan Van Rijswijcklaan Ringfietspad
658,Ringfietspad Jan Van Rijswijcklaan,2023-04-07,22:00:00,8,3,5,FMN 11 A Jan Van Rijswijcklaan Ringfietspad
658,Ringfietspad Jan Van Rijswijcklaan,2023-04-07,23:00:00,7,1,6,FMN 11 A Jan Van Rijswijcklaan Ringfietspad
658,Ringfietspad Jan Van Rijswijcklaan,2023-04-08,00:00:00,10,5,5,FMN 11 A Jan Van Rijswijcklaan Ringfietspad
658,Ringfietspad Jan Van Rijswijcklaan,2023-04-08,01:00:00,3,1,2,FMN 11 A Jan Van Rijswijcklaan Ringfietspad
658,Ringfietspad Jan Van Rijswijcklaan,2023-04-08,02:00:00,2,1,1,FMN 11 A Jan Van Rijswijcklaan Ringfietspad
658,Ringfietspad Jan Van Rijswijcklaan,2023-04-08,03:00:00,3,2,1,FMN 11 A Jan Van Rijswijcklaan Ringfietspad
658,Ringfietspad Jan Van Rijswijcklaan,2023-04-08,04:00:00,3,2,1,FMN 11 A Jan Van Rijswijcklaan Ringfietspad
658,Ringfietspad Jan Van Rijswijcklaan,2023-04-08,05:00:00,4,2,2,FMN 11 A Jan Van Rijswijcklaan Ringfietspad
658,Ringfietspad Jan Van Rijswijcklaan,2023-04-08,06:00:00,5,2,3,FMN 11 A Jan Van Rijswijcklaan Ringfietspad
658,Ringfietspad Jan Van Rijswijcklaan,2023-04-08,07:00:00,8,6,2,FMN 11 A Jan Van Rijswijcklaan Ringfietspad
658,Ringfietspad Jan Van Rijswijcklaan,2023-04-08,08:00:00,17,11,6,FMN 11 A Jan Van Rijswijcklaan Ringfietspad
658,Ringfietspad Jan Van Rijswijcklaan,2023-04-08,09:00:00,32,16,16,FMN 11 A Jan Van Rijswijcklaan Ringfietspad
658,Ringfietspad Jan Van Rijswijcklaan,2023-04-08,10:00:00,37,13,24,FMN 11 A Jan Van Rijswijcklaan Ringfietspad
658,Ringfietspad Jan Van Rijswijcklaan,2023-04-08,11:00:00,39,19,20,FMN 11 A Jan Van Rijswijcklaan Ringfietspad
658,Ringfietspad Jan Van Rijswijcklaan,2023-04-08,12:00:00,47,20,27,FMN 11 A Jan Van Rijswijcklaan Ringfietspad
658,Ringfietspad Jan Van Rijswijcklaan,2023-04-08,13:00:00,55,26,29,FMN 11 A Jan Van Rijswijcklaan Ringfietspad
658,Ringfietspad Jan Van Rijswijcklaan,2023-04-08,14:00:00,57,24,33,FMN 11 A Jan Van Rijswijcklaan Ringfietspad
658,Ringfietspad Jan Van Rijswijcklaan,2023-04-08,15:00:00,62,32,30,FMN 11 A Jan Van Rijswijcklaan Ringfietspad
658,Ringfietspad Jan Van Rijswijcklaan,2023-04-08,16:00:00,51,35,16,FMN 11 A Jan Van Rijswijcklaan Ringfietspad
658,Ringfietspad Jan Van Rijswijcklaan,2023-04-08,17:00:00,47,29,18,FMN 11 A Jan Van Rijswijcklaan Ringfietspad
658,Ringfietspad Jan Van Rijswijcklaan,2023-04-08,18:00:00,31,17,14,FMN 11 A Jan Van Rijswijcklaan Ringfietspad
658,Ringfietspad Jan Van Rijswijcklaan,2023-04-08,19:00:00,19,12,7,FMN 11 A Jan Van Rijswijcklaan Ringfietspad
658,Ringfietspad Jan Van Rijswijcklaan,2023-04-08,20:00:00,18,12,6,FMN 11 A Jan Van Rijswijcklaan Ringfietspad
658,Ringfietspad Jan Van Rijswijcklaan,2023-04-08,21:00:00,9,5,4,FMN 11 A Jan Van Rijswijcklaan Ringfietspad
658,Ringfietspad Jan Van Rijswijcklaan,2023-04-08,22:00:00,6,2,4,FMN 11 A Jan Van Rijswijcklaan Ringfietspad
658,Ringfietspad Jan Van Rijswijcklaan,2023-04-08,23:00:00,6,3,3,FMN 11 A Jan Van Rijswijcklaan Ringfietspad
658,Ringfietspad Jan Van Rijswijcklaan,2023-04-09,00:00:00,5,4,1,FMN 11 A Jan Van Rijswijcklaan Ringfietspad
658,Ringfietspad Jan Van Rijswijcklaan,2023-04-09,01:00:00,2,2,0,FMN 11 A Jan Van Rijswijcklaan Ringfietspad
658,Ringfietspad Jan Van Rijswijcklaan,2023-04-09,02:00:00,0,0,0,FMN 11 A Jan Van Rijswijcklaan Ringfietspad
658,Ringfietspad Jan Van Rijswijcklaan,2023-04-09,03:00:00,2,2,0,FMN 11 A Jan Van Rijswijcklaan Ringfietspad
658,Ringfietspad Jan Van Rijswijcklaan,2023-04-09,04:00:00,2,0,2,FMN 11 A Jan Van Rijswijcklaan Ringfietspad
658,Ringfietspad Jan Van Rijswijcklaan,2023-04-09,05:00:00,1,0,1,FMN 11 A Jan Van Rijswijcklaan Ringfietspad
658,Ringfietspad Jan Van Rijswijcklaan,2023-04-09,06:00:00,0,0,0,FMN 11 A Jan Van Rijswijcklaan Ringfietspad
658,Ringfietspad Jan Van Rijswijcklaan,2023-04-09,07:00:00,4,0,4,FMN 11 A Jan Van Rijswijcklaan Ringfietspad
658,Ringfietspad Jan Van Rijswijcklaan,2023-04-09,08:00:00,15,5,10,FMN 11 A Jan Van Rijswijcklaan Ringfietspad
658,Ringfietspad Jan Van Rijswijcklaan,2023-04-09,09:00:00,30,10,20,FMN 11 A Jan Van Rijswijcklaan Ringfietspad
658,Ringfietspad Jan Van Rijswijcklaan,2023-04-09,10:00:00,42,13,29,FMN 11 A Jan Van Rijswijcklaan Ringfietspad
658,Ringfietspad Jan Van Rijswijcklaan,2023-04-09,11:00:00,45,19,26,FMN 11 A Jan Van Rijswijcklaan Ringfietspad
658,Ringfietspad Jan Van Rijswijcklaan,2023-04-09,12:00:00,45,21,24,FMN 11 A Jan Van Rijswijcklaan Ringfietspad
658,Ringfietspad Jan Van Rijswijcklaan,2023-04-09,13:00:00,50,22,28,FMN 11 A Jan Van Rijswijcklaan Ringfietspad
658,Ringfietspad Jan Van Rijswijcklaan,2023-04-09,14:00:00,53,27,26,FMN 11 A Jan Van Rijswijcklaan Ringfietspad
658,Ringfietspad Jan Van Rijswijcklaan,2023-04-09,15:00:00,52,26,26,FMN 11 A Jan Van Rijswijcklaan Ringfietspad
658,Ringfietspad Jan Van Rijswijcklaan,2023-04-09,16:00:00,54,34,20,FMN 11 A Jan Van Rijswijcklaan Ringfietspad
658,Ringfietspad Jan Van Rijswijcklaan,2023-04-09,17:00:00,33,23,10,FMN 11 A Jan Van Rijswijcklaan Ringfietspad
658,Ringfietspad Jan Van Rijswijcklaan,2023-04-09,18:00:00,17,9,8,FMN 11 A Jan Van Rijswijcklaan Ringfietspad
658,Ringfietspad Jan Van Rijswijcklaan,2023-04-09,19:00:00,18,9,9,FMN 11 A Jan Van Rijswijcklaan Ringfietspad
658,Ringfietspad Jan Van Rijswijcklaan,2023-04-09,20:00:00,10,8,2,FMN 11 A Jan Van Rijswijcklaan Ringfietspad
658,Ringfietspad Jan Van Rijswijcklaan,2023-04-09,21:00:00,6,1,5,FMN 11 A Jan Van Rijswijcklaan Ringfietspad
658,Ringfietspad Jan Van Rijswijcklaan,2023-04-09,22:00:00,10,4,6,FMN 11 A Jan Van Rijswijcklaan Ringfietspad
658,Ringfietspad Jan Van Rijswijcklaan,2023-04-09,23:00:00,3,1,2,FMN 11 A Jan Van Rijswijcklaan Ringfietspad
658,Ringfietspad Jan Van Rijswijcklaan,2023-04-10,00:00:00,0,0,0,FMN 11 A Jan Van Rijswijcklaan Ringfietspad
658,Ringfietspad Jan Van Rijswijcklaan,2023-04-10,01:00:00,0,0,0,FMN 11 A Jan Van Rijswijcklaan Ringfietspad
658,Ringfietspad Jan Van Rijswijcklaan,2023-04-10,02:00:00,0,0,0,FMN 11 A Jan Van Rijswijcklaan Ringfietspad
658,Ringfietspad Jan Van Rijswijcklaan,2023-04-10,03:00:00,2,2,0,FMN 11 A Jan Van Rijswijcklaan Ringfietspad
658,Ringfietspad Jan Van Rijswijcklaan,2023-04-10,04:00:00,4,1,3,FMN 11 A Jan Van Rijswijcklaan Ringfietspad
658,Ringfietspad Jan Van Rijswijcklaan,2023-04-10,05:00:00,10,0,10,FMN 11 A Jan Van Rijswijcklaan Ringfietspad
658,Ringfietspad Jan Van Rijswijcklaan,2023-04-10,06:00:00,18,4,14,FMN 11 A Jan Van Rijswijcklaan Ringfietspad
658,Ringfietspad Jan Van Rijswijcklaan,2023-04-10,07:00:00,34,13,21,FMN 11 A Jan Van Rijswijcklaan Ringfietspad
658,Ringfietspad Jan Van Rijswijcklaan,2023-04-10,08:00:00,42,16,26,FMN 11 A Jan Van Rijswijcklaan Ringfietspad
658,Ringfietspad Jan Van Rijswijcklaan,2023-04-10,09:00:00,11,7,4,FMN 11 A Jan Van Rijswijcklaan Ringfietspad
658,Ringfietspad Jan Van Rijswijcklaan,2023-04-10,10:00:00,6,2,4,FMN 11 A Jan Van Rijswijcklaan Ringfietspad
658,Ringfietspad Jan Van Rijswijcklaan,2023-04-10,11:00:00,12,7,5,FMN 11 A Jan Van Rijswijcklaan Ringfietspad
658,Ringfietspad Jan Van Rijswijcklaan,2023-04-10,12:00:00,8,6,2,FMN 11 A Jan Van Rijswijcklaan Ringfietspad
658,Ringfietspad Jan Van Rijswijcklaan,2023-04-10,13:00:00,14,5,9,FMN 11 A Jan Van Rijswijcklaan Ringfietspad
658,Ringfietspad Jan Van Rijswijcklaan,2023-04-10,14:00:00,17,8,9,FMN 11 A Jan Van Rijswijcklaan Ringfietspad
658,Ringfietspad Jan Van Rijswijcklaan,2023-04-10,15:00:00,20,16,4,FMN 11 A Jan Van Rijswijcklaan Ringfietspad
658,Ringfietspad Jan Van Rijswijcklaan,2023-04-10,16:00:00,32,22,10,FMN 11 A Jan Van Rijswijcklaan Ringfietspad
658,Ringfietspad Jan Van Rijswijcklaan,2023-04-10,17:00:00,30,18,12,FMN 11 A Jan Van Rijswijcklaan Ringfietspad
658,Ringfietspad Jan Van Rijswijcklaan,2023-04-10,18:00:00,27,15,12,FMN 11 A Jan Van Rijswijcklaan Ringfietspad
658,Ringfietspad Jan Van Rijswijcklaan,2023-04-10,19:00:00,8,3,5,FMN 11 A Jan Van Rijswijcklaan Ringfietspad
658,Ringfietspad Jan Van Rijswijcklaan,2023-04-10,20:00:00,3,0,3,FMN 11 A Jan Van Rijswijcklaan Ringfietspad
658,Ringfietspad Jan Van Rijswijcklaan,2023-04-10,21:00:00,2,2,0,FMN 11 A Jan Van Rijswijcklaan Ringfietspad
658,Ringfietspad Jan Van Rijswijcklaan,2023-04-10,22:00:00,5,3,2,FMN 11 A Jan Van Rijswijcklaan Ringfietspad
658,Ringfietspad Jan Van Rijswijcklaan,2023-04-10,23:00:00,2,0,2,FMN 11 A Jan Van Rijswijcklaan Ringfietspad
658,Ringfietspad Jan Van Rijswijcklaan,2023-04-11,00:00:00,2,1,1,FMN 11 A Jan Van Rijswijcklaan Ringfietspad
658,Ringfietspad Jan Van Rijswijcklaan,2023-04-11,01:00:00,1,0,1,FMN 11 A Jan Van Rijswijcklaan Ringfietspad
658,Ringfietspad Jan Van Rijswijcklaan,2023-04-11,02:00:00,0,0,0,FMN 11 A Jan Van Rijswijcklaan Ringfietspad
658,Ringfietspad Jan Van Rijswijcklaan,2023-04-11,03:00:00,0,0,0,FMN 11 A Jan Van Rijswijcklaan Ringfietspad
658,Ringfietspad Jan Van Rijswijcklaan,2023-04-11,04:00:00,2,0,2,FMN 11 A Jan Van Rijswijcklaan Ringfietspad
658,Ringfietspad Jan Van Rijswijcklaan,2023-04-11,05:00:00,12,4,8,FMN 11 A Jan Van Rijswijcklaan Ringfietspad
658,Ringfietspad Jan Van Rijswijcklaan,2023-04-11,06:00:00,41,9,32,FMN 11 A Jan Van Rijswijcklaan Ringfietspad
658,Ringfietspad Jan Van Rijswijcklaan,2023-04-11,07:00:00,79,31,48,FMN 11 A Jan Van Rijswijcklaan Ringfietspad
658,Ringfietspad Jan Van Rijswijcklaan,2023-04-11,08:00:00,109,45,64,FMN 11 A Jan Van Rijswijcklaan Ringfietspad
658,Ringfietspad Jan Van Rijswijcklaan,2023-04-11,09:00:00,35,12,23,FMN 11 A Jan Van Rijswijcklaan Ringfietspad
658,Ringfietspad Jan Van Rijswijcklaan,2023-04-11,10:00:00,31,12,19,FMN 11 A Jan Van Rijswijcklaan Ringfietspad
658,Ringfietspad Jan Van Rijswijcklaan,2023-04-11,11:00:00,25,7,18,FMN 11 A Jan Van Rijswijcklaan Ringfietspad
658,Ringfietspad Jan Van Rijswijcklaan,2023-04-11,12:00:00,35,16,19,FMN 11 A Jan Van Rijswijcklaan Ringfietspad
658,Ringfietspad Jan Van Rijswijcklaan,2023-04-11,13:00:00,28,12,16,FMN 11 A Jan Van Rijswijcklaan Ringfietspad
658,Ringfietspad Jan Van Rijswijcklaan,2023-04-11,14:00:00,36,18,18,FMN 11 A Jan Van Rijswijcklaan Ringfietspad
658,Ringfietspad Jan Van Rijswijcklaan,2023-04-11,15:00:00,40,25,15,FMN 11 A Jan Van Rijswijcklaan Ringfietspad
658,Ringfietspad Jan Van Rijswijcklaan,2023-04-11,16:00:00,89,58,31,FMN 11 A Jan Van Rijswijcklaan Ringfietspad
658,Ringfietspad Jan Van Rijswijcklaan,2023-04-11,17:00:00,99,64,35,FMN 11 A Jan Van Rijswijcklaan Ringfietspad
658,Ringfietspad Jan Van Rijswijcklaan,2023-04-11,18:00:00,54,30,24,FMN 11 A Jan Van Rijswijcklaan Ringfietspad
658,Ringfietspad Jan Van Rijswijcklaan,2023-04-11,19:00:00,18,10,8,FMN 11 A Jan Van Rijswijcklaan Ringfietspad
658,Ringfietspad Jan Van Rijswijcklaan,2023-04-11,20:00:00,15,5,10,FMN 11 A Jan Van Rijswijcklaan Ringfietspad
658,Ringfietspad Jan Van Rijswijcklaan,2023-04-11,21:00:00,13,5,8,FMN 11 A Jan Van Rijswijcklaan Ringfietspad
658,Ringfietspad Jan Van Rijswijcklaan,2023-04-11,22:00:00,11,4,7,FMN 11 A Jan Van Rijswijcklaan Ringfietspad
658,Ringfietspad Jan Van Rijswijcklaan,2023-04-11,23:00:00,7,4,3,FMN 11 A Jan Van Rijswijcklaan Ringfietspad
658,Ringfietspad Jan Van Rijswijcklaan,2023-04-12,00:00:00,4,2,2,FMN 11 A Jan Van Rijswijcklaan Ringfietspad
658,Ringfietspad Jan Van Rijswijcklaan,2023-04-12,01:00:00,0,0,0,FMN 11 A Jan Van Rijswijcklaan Ringfietspad
658,Ringfietspad Jan Van Rijswijcklaan,2023-04-12,02:00:00,1,1,0,FMN 11 A Jan Van Rijswijcklaan Ringfietspad
658,Ringfietspad Jan Van Rijswijcklaan,2023-04-12,03:00:00,2,2,0,FMN 11 A Jan Van Rijswijcklaan Ringfietspad
658,Ringfietspad Jan Van Rijswijcklaan,2023-04-12,04:00:00,3,0,3,FMN 11 A Jan Van Rijswijcklaan Ringfietspad
658,Ringfietspad Jan Van Rijswijcklaan,2023-04-12,05:00:00,19,10,9,FMN 11 A Jan Van Rijswijcklaan Ringfietspad
658,Ringfietspad Jan Van Rijswijcklaan,2023-04-12,06:00:00,26,11,15,FMN 11 A Jan Van Rijswijcklaan Ringfietspad
658,Ringfietspad Jan Van Rijswijcklaan,2023-04-12,07:00:00,49,20,29,FMN 11 A Jan Van Rijswijcklaan Ringfietspad
658,Ringfietspad Jan Van Rijswijcklaan,2023-04-12,08:00:00,69,23,46,FMN 11 A Jan Van Rijswijcklaan Ringfietspad
658,Ringfietspad Jan Van Rijswijcklaan,2023-04-12,09:00:00,30,12,18,FMN 11 A Jan Van Rijswijcklaan Ringfietspad
658,Ringfietspad Jan Van Rijswijcklaan,2023-04-12,10:00:00,14,6,8,FMN 11 A Jan Van Rijswijcklaan Ringfietspad
658,Ringfietspad Jan Van Rijswijcklaan,2023-04-12,11:00:00,20,11,9,FMN 11 A Jan Van Rijswijcklaan Ringfietspad
658,Ringfietspad Jan Van Rijswijcklaan,2023-04-12,12:00:00,38,18,20,FMN 11 A Jan Van Rijswijcklaan Ringfietspad
658,Ringfietspad Jan Van Rijswijcklaan,2023-04-12,13:00:00,33,19,14,FMN 11 A Jan Van Rijswijcklaan Ringfietspad
658,Ringfietspad Jan Van Rijswijcklaan,2023-04-12,14:00:00,43,21,22,FMN 11 A Jan Van Rijswijcklaan Ringfietspad
658,Ringfietspad Jan Van Rijswijcklaan,2023-04-12,15:00:00,43,27,16,FMN 11 A Jan Van Rijswijcklaan Ringfietspad
658,Ringfietspad Jan Van Rijswijcklaan,2023-04-12,16:00:00,66,43,23,FMN 11 A Jan Van Rijswijcklaan Ringfietspad
658,Ringfietspad Jan Van Rijswijcklaan,2023-04-12,17:00:00,87,53,34,FMN 11 A Jan Van Rijswijcklaan Ringfietspad
658,Ringfietspad Jan Van Rijswijcklaan,2023-04-12,18:00:00,48,31,17,FMN 11 A Jan Van Rijswijcklaan Ringfietspad
658,Ringfietspad Jan Van Rijswijcklaan,2023-04-12,19:00:00,22,7,15,FMN 11 A Jan Van Rijswijcklaan Ringfietspad
658,Ringfietspad Jan Van Rijswijcklaan,2023-04-12,20:00:00,17,7,10,FMN 11 A Jan Van Rijswijcklaan Ringfietspad
658,Ringfietspad Jan Van Rijswijcklaan,2023-04-12,21:00:00,12,7,5,FMN 11 A Jan Van Rijswijcklaan Ringfietspad
658,Ringfietspad Jan Van Rijswijcklaan,2023-04-12,22:00:00,6,1,5,FMN 11 A Jan Van Rijswijcklaan Ringfietspad
658,Ringfietspad Jan Van Rijswijcklaan,2023-04-12,23:00:00,4,3,1,FMN 11 A Jan Van Rijswijcklaan Ringfietspad
658,Ringfietspad Jan Van Rijswijcklaan,2023-04-13,00:00:00,4,2,2,FMN 11 A Jan Van Rijswijcklaan Ringfietspad
658,Ringfietspad Jan Van Rijswijcklaan,2023-04-13,01:00:00,1,0,1,FMN 11 A Jan Van Rijswijcklaan Ringfietspad
658,Ringfietspad Jan Van Rijswijcklaan,2023-04-13,02:00:00,0,0,0,FMN 11 A Jan Van Rijswijcklaan Ringfietspad
658,Ringfietspad Jan Van Rijswijcklaan,2023-04-13,03:00:00,3,3,0,FMN 11 A Jan Van Rijswijcklaan Ringfietspad
658,Ringfietspad Jan Van Rijswijcklaan,2023-04-13,04:00:00,0,0,0,FMN 11 A Jan Van Rijswijcklaan Ringfietspad
658,Ringfietspad Jan Van Rijswijcklaan,2023-04-13,05:00:00,15,3,12,FMN 11 A Jan Van Rijswijcklaan Ringfietspad
658,Ringfietspad Jan Van Rijswijcklaan,2023-04-13,06:00:00,46,11,35,FMN 11 A Jan Van Rijswijcklaan Ringfietspad
658,Ringfietspad Jan Van Rijswijcklaan,2023-04-13,07:00:00,80,27,53,FMN 11 A Jan Van Rijswijcklaan Ringfietspad
658,Ringfietspad Jan Van Rijswijcklaan,2023-04-13,08:00:00,100,34,66,FMN 11 A Jan Van Rijswijcklaan Ringfietspad
658,Ringfietspad Jan Van Rijswijcklaan,2023-04-13,09:00:00,44,18,26,FMN 11 A Jan Van Rijswijcklaan Ringfietspad
658,Ringfietspad Jan Van Rijswijcklaan,2023-04-13,10:00:00,26,13,13,FMN 11 A Jan Van Rijswijcklaan Ringfietspad
658,Ringfietspad Jan Van Rijswijcklaan,2023-04-13,11:00:00,20,11,9,FMN 11 A Jan Van Rijswijcklaan Ringfietspad
658,Ringfietspad Jan Van Rijswijcklaan,2023-04-13,12:00:00,33,17,16,FMN 11 A Jan Van Rijswijcklaan Ringfietspad
658,Ringfietspad Jan Van Rijswijcklaan,2023-04-13,13:00:00,35,17,18,FMN 11 A Jan Van Rijswijcklaan Ringfietspad
658,Ringfietspad Jan Van Rijswijcklaan,2023-04-13,14:00:00,42,23,19,FMN 11 A Jan Van Rijswijcklaan Ringfietspad
658,Ringfietspad Jan Van Rijswijcklaan,2023-04-13,15:00:00,56,41,15,FMN 11 A Jan Van Rijswijcklaan Ringfietspad
658,Ringfietspad Jan Van Rijswijcklaan,2023-04-13,16:00:00,90,68,22,FMN 11 A Jan Van Rijswijcklaan Ringfietspad
658,Ringfietspad Jan Van Rijswijcklaan,2023-04-13,17:00:00,90,59,31,FMN 11 A Jan Van Rijswijcklaan Ringfietspad
658,Ringfietspad Jan Van Rijswijcklaan,2023-04-13,18:00:00,56,34,22,FMN 11 A Jan Van Rijswijcklaan Ringfietspad
658,Ringfietspad Jan Van Rijswijcklaan,2023-04-13,19:00:00,33,21,12,FMN 11 A Jan Van Rijswijcklaan Ringfietspad
658,Ringfietspad Jan Van Rijswijcklaan,2023-04-13,20:00:00,25,13,12,FMN 11 A Jan Van Rijswijcklaan Ringfietspad
658,Ringfietspad Jan Van Rijswijcklaan,2023-04-13,21:00:00,14,10,4,FMN 11 A Jan Van Rijswijcklaan Ringfietspad
658,Ringfietspad Jan Van Rijswijcklaan,2023-04-13,22:00:00,9,6,3,FMN 11 A Jan Van Rijswijcklaan Ringfietspad
658,Ringfietspad Jan Van Rijswijcklaan,2023-04-13,23:00:00,3,1,2,FMN 11 A Jan Van Rijswijcklaan Ringfietspad
658,Ringfietspad Jan Van Rijswijcklaan,2023-04-14,00:00:00,3,2,1,FMN 11 A Jan Van Rijswijcklaan Ringfietspad
658,Ringfietspad Jan Van Rijswijcklaan,2023-04-14,01:00:00,1,1,0,FMN 11 A Jan Van Rijswijcklaan Ringfietspad
658,Ringfietspad Jan Van Rijswijcklaan,2023-04-14,02:00:00,2,2,0,FMN 11 A Jan Van Rijswijcklaan Ringfietspad
658,Ringfietspad Jan Van Rijswijcklaan,2023-04-14,03:00:00,2,2,0,FMN 11 A Jan Van Rijswijcklaan Ringfietspad
658,Ringfietspad Jan Van Rijswijcklaan,2023-04-14,04:00:00,7,0,7,FMN 11 A Jan Van Rijswijcklaan Ringfietspad
658,Ringfietspad Jan Van Rijswijcklaan,2023-04-14,05:00:00,12,5,7,FMN 11 A Jan Van Rijswijcklaan Ringfietspad
658,Ringfietspad Jan Van Rijswijcklaan,2023-04-14,06:00:00,35,7,28,FMN 11 A Jan Van Rijswijcklaan Ringfietspad
658,Ringfietspad Jan Van Rijswijcklaan,2023-04-14,07:00:00,63,21,42,FMN 11 A Jan Van Rijswijcklaan Ringfietspad
658,Ringfietspad Jan Van Rijswijcklaan,2023-04-14,08:00:00,100,34,66,FMN 11 A Jan Van Rijswijcklaan Ringfietspad
658,Ringfietspad Jan Van Rijswijcklaan,2023-04-14,09:00:00,46,18,28,FMN 11 A Jan Van Rijswijcklaan Ringfietspad
658,Ringfietspad Jan Van Rijswijcklaan,2023-04-14,10:00:00,37,15,22,FMN 11 A Jan Van Rijswijcklaan Ringfietspad
658,Ringfietspad Jan Van Rijswijcklaan,2023-04-14,11:00:00,36,16,20,FMN 11 A Jan Van Rijswijcklaan Ringfietspad
658,Ringfietspad Jan Van Rijswijcklaan,2023-04-14,12:00:00,40,20,20,FMN 11 A Jan Van Rijswijcklaan Ringfietspad
658,Ringfietspad Jan Van Rijswijcklaan,2023-04-14,13:00:00,42,20,22,FMN 11 A Jan Van Rijswijcklaan Ringfietspad
658,Ringfietspad Jan Van Rijswijcklaan,2023-04-14,14:00:00,50,32,18,FMN 11 A Jan Van Rijswijcklaan Ringfietspad
658,Ringfietspad Jan Van Rijswijcklaan,2023-04-14,15:00:00,69,45,24,FMN 11 A Jan Van Rijswijcklaan Ringfietspad
658,Ringfietspad Jan Van Rijswijcklaan,2023-04-14,16:00:00,94,63,31,FMN 11 A Jan Van Rijswijcklaan Ringfietspad
658,Ringfietspad Jan Van Rijswijcklaan,2023-04-14,17:00:00,81,47,34,FMN 11 A Jan Van Rijswijcklaan Ringfietspad
658,Ringfietspad Jan Van Rijswijcklaan,2023-04-14,18:00:00,37,23,14,FMN 11 A Jan Van Rijswijcklaan Ringfietspad
658,Ringfietspad Jan Van Rijswijcklaan,2023-04-14,19:00:00,24,12,12,FMN 11 A Jan Van Rijswijcklaan Ringfietspad
658,Ringfietspad Jan Van Rijswijcklaan,2023-04-14,20:00:00,17,8,9,FMN 11 A Jan Van Rijswijcklaan Ringfietspad
658,Ringfietspad Jan Van Rijswijcklaan,2023-04-14,21:00:00,18,8,10,FMN 11 A Jan Van Rijswijcklaan Ringfietspad
658,Ringfietspad Jan Van Rijswijcklaan,2023-04-14,22:00:00,18,9,9,FMN 11 A Jan Van Rijswijcklaan Ringfietspad
658,Ringfietspad Jan Van Rijswijcklaan,2023-04-14,23:00:00,8,3,5,FMN 11 A Jan Van Rijswijcklaan Ringfietspad
658,Ringfietspad Jan Van Rijswijcklaan,2023-04-15,00:00:00,3,2,1,FMN 11 A Jan Van Rijswijcklaan Ringfietspad
658,Ringfietspad Jan Van Rijswijcklaan,2023-04-15,01:00:00,6,3,3,FMN 11 A Jan Van Rijswijcklaan Ringfietspad
658,Ringfietspad Jan Van Rijswijcklaan,2023-04-15,02:00:00,6,4,2,FMN 11 A Jan Van Rijswijcklaan Ringfietspad
658,Ringfietspad Jan Van Rijswijcklaan,2023-04-15,03:00:00,3,3,0,FMN 11 A Jan Van Rijswijcklaan Ringfietspad
658,Ringfietspad Jan Van Rijswijcklaan,2023-04-15,04:00:00,3,1,2,FMN 11 A Jan Van Rijswijcklaan Ringfietspad
658,Ringfietspad Jan Van Rijswijcklaan,2023-04-15,05:00:00,3,1,2,FMN 11 A Jan Van Rijswijcklaan Ringfietspad
658,Ringfietspad Jan Van Rijswijcklaan,2023-04-15,06:00:00,13,7,6,FMN 11 A Jan Van Rijswijcklaan Ringfietspad
658,Ringfietspad Jan Van Rijswijcklaan,2023-04-15,07:00:00,10,3,7,FMN 11 A Jan Van Rijswijcklaan Ringfietspad
658,Ringfietspad Jan Van Rijswijcklaan,2023-04-15,08:00:00,19,8,11,FMN 11 A Jan Van Rijswijcklaan Ringfietspad
658,Ringfietspad Jan Van Rijswijcklaan,2023-04-15,09:00:00,42,18,24,FMN 11 A Jan Van Rijswijcklaan Ringfietspad
658,Ringfietspad Jan Van Rijswijcklaan,2023-04-15,10:00:00,38,20,18,FMN 11 A Jan Van Rijswijcklaan Ringfietspad
658,Ringfietspad Jan Van Rijswijcklaan,2023-04-15,11:00:00,45,20,25,FMN 11 A Jan Van Rijswijcklaan Ringfietspad
658,Ringfietspad Jan Van Rijswijcklaan,2023-04-15,12:00:00,61,32,29,FMN 11 A Jan Van Rijswijcklaan Ringfietspad
658,Ringfietspad Jan Van Rijswijcklaan,2023-04-15,13:00:00,68,37,31,FMN 11 A Jan Van Rijswijcklaan Ringfietspad
658,Ringfietspad Jan Van Rijswijcklaan,2023-04-15,14:00:00,70,34,36,FMN 11 A Jan Van Rijswijcklaan Ringfietspad
658,Ringfietspad Jan Van Rijswijcklaan,2023-04-15,15:00:00,75,38,37,FMN 11 A Jan Van Rijswijcklaan Ringfietspad
658,Ringfietspad Jan Van Rijswijcklaan,2023-04-15,16:00:00,71,49,22,FMN 11 A Jan Van Rijswijcklaan Ringfietspad
658,Ringfietspad Jan Van Rijswijcklaan,2023-04-15,17:00:00,49,34,15,FMN 11 A Jan Van Rijswijcklaan Ringfietspad
658,Ringfietspad Jan Van Rijswijcklaan,2023-04-15,18:00:00,40,21,19,FMN 11 A Jan Van Rijswijcklaan Ringfietspad
658,Ringfietspad Jan Van Rijswijcklaan,2023-04-15,19:00:00,34,17,17,FMN 11 A Jan Van Rijswijcklaan Ringfietspad
658,Ringfietspad Jan Van Rijswijcklaan,2023-04-15,20:00:00,18,10,8,FMN 11 A Jan Van Rijswijcklaan Ringfietspad
658,Ringfietspad Jan Van Rijswijcklaan,2023-04-15,21:00:00,18,9,9,FMN 11 A Jan Van Rijswijcklaan Ringfietspad
658,Ringfietspad Jan Van Rijswijcklaan,2023-04-15,22:00:00,17,9,8,FMN 11 A Jan Van Rijswijcklaan Ringfietspad
658,Ringfietspad Jan Van Rijswijcklaan,2023-04-15,23:00:00,8,2,6,FMN 11 A Jan Van Rijswijcklaan Ringfietspad
658,Ringfietspad Jan Van Rijswijcklaan,2023-04-16,00:00:00,2,2,0,FMN 11 A Jan Van Rijswijcklaan Ringfietspad
658,Ringfietspad Jan Van Rijswijcklaan,2023-04-16,01:00:00,0,0,0,FMN 11 A Jan Van Rijswijcklaan Ringfietspad
658,Ringfietspad Jan Van Rijswijcklaan,2023-04-16,02:00:00,3,1,2,FMN 11 A Jan Van Rijswijcklaan Ringfietspad
658,Ringfietspad Jan Van Rijswijcklaan,2023-04-16,03:00:00,2,2,0,FMN 11 A Jan Van Rijswijcklaan Ringfietspad
658,Ringfietspad Jan Van Rijswijcklaan,2023-04-16,04:00:00,2,1,1,FMN 11 A Jan Van Rijswijcklaan Ringfietspad
658,Ringfietspad Jan Van Rijswijcklaan,2023-04-16,05:00:00,4,1,3,FMN 11 A Jan Van Rijswijcklaan Ringfietspad
658,Ringfietspad Jan Van Rijswijcklaan,2023-04-16,06:00:00,5,2,3,FMN 11 A Jan Van Rijswijcklaan Ringfietspad
658,Ringfietspad Jan Van Rijswijcklaan,2023-04-16,07:00:00,3,0,3,FMN 11 A Jan Van Rijswijcklaan Ringfietspad
658,Ringfietspad Jan Van Rijswijcklaan,2023-04-16,08:00:00,13,4,9,FMN 11 A Jan Van Rijswijcklaan Ringfietspad
658,Ringfietspad Jan Van Rijswijcklaan,2023-04-16,09:00:00,23,9,14,FMN 11 A Jan Van Rijswijcklaan Ringfietspad
658,Ringfietspad Jan Van Rijswijcklaan,2023-04-16,10:00:00,28,11,17,FMN 11 A Jan Van Rijswijcklaan Ringfietspad
658,Ringfietspad Jan Van Rijswijcklaan,2023-04-16,11:00:00,36,20,16,FMN 11 A Jan Van Rijswijcklaan Ringfietspad
658,Ringfietspad Jan Van Rijswijcklaan,2023-04-16,12:00:00,39,22,17,FMN 11 A Jan Van Rijswijcklaan Ringfietspad
658,Ringfietspad Jan Van Rijswijcklaan,2023-04-16,13:00:00,49,25,24,FMN 11 A Jan Van Rijswijcklaan Ringfietspad
658,Ringfietspad Jan Van Rijswijcklaan,2023-04-16,14:00:00,55,28,27,FMN 11 A Jan Van Rijswijcklaan Ringfietspad
658,Ringfietspad Jan Van Rijswijcklaan,2023-04-16,15:00:00,46,32,14,FMN 11 A Jan Van Rijswijcklaan Ringfietspad
658,Ringfietspad Jan Van Rijswijcklaan,2023-04-16,16:00:00,39,22,17,FMN 11 A Jan Van Rijswijcklaan Ringfietspad
658,Ringfietspad Jan Van Rijswijcklaan,2023-04-16,17:00:00,37,21,16,FMN 11 A Jan Van Rijswijcklaan Ringfietspad
658,Ringfietspad Jan Van Rijswijcklaan,2023-04-16,18:00:00,29,20,9,FMN 11 A Jan Van Rijswijcklaan Ringfietspad
658,Ringfietspad Jan Van Rijswijcklaan,2023-04-16,19:00:00,17,12,5,FMN 11 A Jan Van Rijswijcklaan Ringfietspad
658,Ringfietspad Jan Van Rijswijcklaan,2023-04-16,20:00:00,20,8,12,FMN 11 A Jan Van Rijswijcklaan Ringfietspad
658,Ringfietspad Jan Van Rijswijcklaan,2023-04-16,21:00:00,6,3,3,FMN 11 A Jan Van Rijswijcklaan Ringfietspad
658,Ringfietspad Jan Van Rijswijcklaan,2023-04-16,22:00:00,4,3,1,FMN 11 A Jan Van Rijswijcklaan Ringfietspad
658,Ringfietspad Jan Van Rijswijcklaan,2023-04-16,23:00:00,2,0,2,FMN 11 A Jan Van Rijswijcklaan Ringfietspad
658,Ringfietspad Jan Van Rijswijcklaan,2023-04-17,00:00:00,2,1,1,FMN 11 A Jan Van Rijswijcklaan Ringfietspad
658,Ringfietspad Jan Van Rijswijcklaan,2023-04-17,01:00:00,1,0,1,FMN 11 A Jan Van Rijswijcklaan Ringfietspad
658,Ringfietspad Jan Van Rijswijcklaan,2023-04-17,02:00:00,0,0,0,FMN 11 A Jan Van Rijswijcklaan Ringfietspad
658,Ringfietspad Jan Van Rijswijcklaan,2023-04-17,03:00:00,1,1,0,FMN 11 A Jan Van Rijswijcklaan Ringfietspad
658,Ringfietspad Jan Van Rijswijcklaan,2023-04-17,04:00:00,4,2,2,FMN 11 A Jan Van Rijswijcklaan Ringfietspad
658,Ringfietspad Jan Van Rijswijcklaan,2023-04-17,05:00:00,19,6,13,FMN 11 A Jan Van Rijswijcklaan Ringfietspad
658,Ringfietspad Jan Van Rijswijcklaan,2023-04-17,06:00:00,56,13,43,FMN 11 A Jan Van Rijswijcklaan Ringfietspad
658,Ringfietspad Jan Van Rijswijcklaan,2023-04-17,07:00:00,129,43,86,FMN 11 A Jan Van Rijswijcklaan Ringfietspad
658,Ringfietspad Jan Van Rijswijcklaan,2023-04-17,08:00:00,174,53,121,FMN 11 A Jan Van Rijswijcklaan Ringfietspad
658,Ringfietspad Jan Van Rijswijcklaan,2023-04-17,09:00:00,70,26,44,FMN 11 A Jan Van Rijswijcklaan Ringfietspad
658,Ringfietspad Jan Van Rijswijcklaan,2023-04-17,10:00:00,44,21,23,FMN 11 A Jan Van Rijswijcklaan Ringfietspad
658,Ringfietspad Jan Van Rijswijcklaan,2023-04-17,11:00:00,34,18,16,FMN 11 A Jan Van Rijswijcklaan Ringfietspad
658,Ringfietspad Jan Van Rijswijcklaan,2023-04-17,12:00:00,63,32,31,FMN 11 A Jan Van Rijswijcklaan Ringfietspad
658,Ringfietspad Jan Van Rijswijcklaan,2023-04-17,13:00:00,62,31,31,FMN 11 A Jan Van Rijswijcklaan Ringfietspad
658,Ringfietspad Jan Van Rijswijcklaan,2023-04-17,14:00:00,65,39,26,FMN 11 A Jan Van Rijswijcklaan Ringfietspad
658,Ringfietspad Jan Van Rijswijcklaan,2023-04-17,15:00:00,116,72,44,FMN 11 A Jan Van Rijswijcklaan Ringfietspad
658,Ringfietspad Jan Van Rijswijcklaan,2023-04-17,16:00:00,159,106,53,FMN 11 A Jan Van Rijswijcklaan Ringfietspad
658,Ringfietspad Jan Van Rijswijcklaan,2023-04-17,17:00:00,173,112,61,FMN 11 A Jan Van Rijswijcklaan Ringfietspad
658,Ringfietspad Jan Van Rijswijcklaan,2023-04-17,18:00:00,104,69,35,FMN 11 A Jan Van Rijswijcklaan Ringfietspad
658,Ringfietspad Jan Van Rijswijcklaan,2023-04-17,19:00:00,41,16,25,FMN 11 A Jan Van Rijswijcklaan Ringfietspad
658,Ringfietspad Jan Van Rijswijcklaan,2023-04-17,20:00:00,28,11,17,FMN 11 A Jan Van Rijswijcklaan Ringfietspad
658,Ringfietspad Jan Van Rijswijcklaan,2023-04-17,21:00:00,23,11,12,FMN 11 A Jan Van Rijswijcklaan Ringfietspad
658,Ringfietspad Jan Van Rijswijcklaan,2023-04-17,22:00:00,12,10,2,FMN 11 A Jan Van Rijswijcklaan Ringfietspad
658,Ringfietspad Jan Van Rijswijcklaan,2023-04-17,23:00:00,4,2,2,FMN 11 A Jan Van Rijswijcklaan Ringfietspad
658,Ringfietspad Jan Van Rijswijcklaan,2023-04-18,00:00:00,1,0,1,FMN 11 A Jan Van Rijswijcklaan Ringfietspad
658,Ringfietspad Jan Van Rijswijcklaan,2023-04-18,01:00:00,0,0,0,FMN 11 A Jan Van Rijswijcklaan Ringfietspad
658,Ringfietspad Jan Van Rijswijcklaan,2023-04-18,02:00:00,2,1,1,FMN 11 A Jan Van Rijswijcklaan Ringfietspad
658,Ringfietspad Jan Van Rijswijcklaan,2023-04-18,03:00:00,0,0,0,FMN 11 A Jan Van Rijswijcklaan Ringfietspad
658,Ringfietspad Jan Van Rijswijcklaan,2023-04-18,04:00:00,7,4,3,FMN 11 A Jan Van Rijswijcklaan Ringfietspad
658,Ringfietspad Jan Van Rijswijcklaan,2023-04-18,05:00:00,28,7,21,FMN 11 A Jan Van Rijswijcklaan Ringfietspad
658,Ringfietspad Jan Van Rijswijcklaan,2023-04-18,06:00:00,75,21,54,FMN 11 A Jan Van Rijswijcklaan Ringfietspad
658,Ringfietspad Jan Van Rijswijcklaan,2023-04-18,07:00:00,140,50,90,FMN 11 A Jan Van Rijswijcklaan Ringfietspad
658,Ringfietspad Jan Van Rijswijcklaan,2023-04-18,08:00:00,187,62,125,FMN 11 A Jan Van Rijswijcklaan Ringfietspad
658,Ringfietspad Jan Van Rijswijcklaan,2023-04-18,09:00:00,69,22,47,FMN 11 A Jan Van Rijswijcklaan Ringfietspad
658,Ringfietspad Jan Van Rijswijcklaan,2023-04-18,10:00:00,44,23,21,FMN 11 A Jan Van Rijswijcklaan Ringfietspad
658,Ringfietspad Jan Van Rijswijcklaan,2023-04-18,11:00:00,49,21,28,FMN 11 A Jan Van Rijswijcklaan Ringfietspad
658,Ringfietspad Jan Van Rijswijcklaan,2023-04-18,12:00:00,60,25,35,FMN 11 A Jan Van Rijswijcklaan Ringfietspad
658,Ringfietspad Jan Van Rijswijcklaan,2023-04-18,13:00:00,58,26,32,FMN 11 A Jan Van Rijswijcklaan Ringfietspad
658,Ringfietspad Jan Van Rijswijcklaan,2023-04-18,14:00:00,83,46,37,FMN 11 A Jan Van Rijswijcklaan Ringfietspad
658,Ringfietspad Jan Van Rijswijcklaan,2023-04-18,15:00:00,109,70,39,FMN 11 A Jan Van Rijswijcklaan Ringfietspad
658,Ringfietspad Jan Van Rijswijcklaan,2023-04-18,16:00:00,184,128,56,FMN 11 A Jan Van Rijswijcklaan Ringfietspad
658,Ringfietspad Jan Van Rijswijcklaan,2023-04-18,17:00:00,178,112,66,FMN 11 A Jan Van Rijswijcklaan Ringfietspad
658,Ringfietspad Jan Van Rijswijcklaan,2023-04-18,18:00:00,124,74,50,FMN 11 A Jan Van Rijswijcklaan Ringfietspad
658,Ringfietspad Jan Van Rijswijcklaan,2023-04-18,19:00:00,57,29,28,FMN 11 A Jan Van Rijswijcklaan Ringfietspad
658,Ringfietspad Jan Van Rijswijcklaan,2023-04-18,20:00:00,31,14,17,FMN 11 A Jan Van Rijswijcklaan Ringfietspad
658,Ringfietspad Jan Van Rijswijcklaan,2023-04-18,21:00:00,19,11,8,FMN 11 A Jan Van Rijswijcklaan Ringfietspad
658,Ringfietspad Jan Van Rijswijcklaan,2023-04-18,22:00:00,15,10,5,FMN 11 A Jan Van Rijswijcklaan Ringfietspad
658,Ringfietspad Jan Van Rijswijcklaan,2023-04-18,23:00:00,6,4,2,FMN 11 A Jan Van Rijswijcklaan Ringfietspad
658,Ringfietspad Jan Van Rijswijcklaan,2023-04-19,00:00:00,3,2,1,FMN 11 A Jan Van Rijswijcklaan Ringfietspad
658,Ringfietspad Jan Van Rijswijcklaan,2023-04-19,01:00:00,1,1,0,FMN 11 A Jan Van Rijswijcklaan Ringfietspad
658,Ringfietspad Jan Van Rijswijcklaan,2023-04-19,02:00:00,1,0,1,FMN 11 A Jan Van Rijswijcklaan Ringfietspad
658,Ringfietspad Jan Van Rijswijcklaan,2023-04-19,03:00:00,3,2,1,FMN 11 A Jan Van Rijswijcklaan Ringfietspad
658,Ringfietspad Jan Van Rijswijcklaan,2023-04-19,04:00:00,9,2,7,FMN 11 A Jan Van Rijswijcklaan Ringfietspad
658,Ringfietspad Jan Van Rijswijcklaan,2023-04-19,05:00:00,40,12,28,FMN 11 A Jan Van Rijswijcklaan Ringfietspad
658,Ringfietspad Jan Van Rijswijcklaan,2023-04-19,06:00:00,61,13,48,FMN 11 A Jan Van Rijswijcklaan Ringfietspad
658,Ringfietspad Jan Van Rijswijcklaan,2023-04-19,07:00:00,135,50,85,FMN 11 A Jan Van Rijswijcklaan Ringfietspad
658,Ringfietspad Jan Van Rijswijcklaan,2023-04-19,08:00:00,166,59,107,FMN 11 A Jan Van Rijswijcklaan Ringfietspad
658,Ringfietspad Jan Van Rijswijcklaan,2023-04-19,09:00:00,68,33,35,FMN 11 A Jan Van Rijswijcklaan Ringfietspad
658,Ringfietspad Jan Van Rijswijcklaan,2023-04-19,10:00:00,46,20,26,FMN 11 A Jan Van Rijswijcklaan Ringfietspad
658,Ringfietspad Jan Van Rijswijcklaan,2023-04-19,11:00:00,48,22,26,FMN 11 A Jan Van Rijswijcklaan Ringfietspad
658,Ringfietspad Jan Van Rijswijcklaan,2023-04-19,12:00:00,69,36,33,FMN 11 A Jan Van Rijswijcklaan Ringfietspad
658,Ringfietspad Jan Van Rijswijcklaan,2023-04-19,13:00:00,75,37,38,FMN 11 A Jan Van Rijswijcklaan Ringfietspad
658,Ringfietspad Jan Van Rijswijcklaan,2023-04-19,14:00:00,89,46,43,FMN 11 A Jan Van Rijswijcklaan Ringfietspad
658,Ringfietspad Jan Van Rijswijcklaan,2023-04-19,15:00:00,97,63,34,FMN 11 A Jan Van Rijswijcklaan Ringfietspad
658,Ringfietspad Jan Van Rijswijcklaan,2023-04-19,16:00:00,164,114,50,FMN 11 A Jan Van Rijswijcklaan Ringfietspad
658,Ringfietspad Jan Van Rijswijcklaan,2023-04-19,17:00:00,193,125,68,FMN 11 A Jan Van Rijswijcklaan Ringfietspad
658,Ringfietspad Jan Van Rijswijcklaan,2023-04-19,18:00:00,88,52,36,FMN 11 A Jan Van Rijswijcklaan Ringfietspad
658,Ringfietspad Jan Van Rijswijcklaan,2023-04-19,19:00:00,59,27,32,FMN 11 A Jan Van Rijswijcklaan Ringfietspad
658,Ringfietspad Jan Van Rijswijcklaan,2023-04-19,20:00:00,41,19,22,FMN 11 A Jan Van Rijswijcklaan Ringfietspad
658,Ringfietspad Jan Van Rijswijcklaan,2023-04-19,21:00:00,33,20,13,FMN 11 A Jan Van Rijswijcklaan Ringfietspad
658,Ringfietspad Jan Van Rijswijcklaan,2023-04-19,22:00:00,20,15,5,FMN 11 A Jan Van Rijswijcklaan Ringfietspad
658,Ringfietspad Jan Van Rijswijcklaan,2023-04-19,23:00:00,13,10,3,FMN 11 A Jan Van Rijswijcklaan Ringfietspad
658,Ringfietspad Jan Van Rijswijcklaan,2023-04-20,00:00:00,2,1,1,FMN 11 A Jan Van Rijswijcklaan Ringfietspad
658,Ringfietspad Jan Van Rijswijcklaan,2023-04-20,01:00:00,1,1,0,FMN 11 A Jan Van Rijswijcklaan Ringfietspad
658,Ringfietspad Jan Van Rijswijcklaan,2023-04-20,02:00:00,3,1,2,FMN 11 A Jan Van Rijswijcklaan Ringfietspad
658,Ringfietspad Jan Van Rijswijcklaan,2023-04-20,03:00:00,2,2,0,FMN 11 A Jan Van Rijswijcklaan Ringfietspad
658,Ringfietspad Jan Van Rijswijcklaan,2023-04-20,04:00:00,5,2,3,FMN 11 A Jan Van Rijswijcklaan Ringfietspad
658,Ringfietspad Jan Van Rijswijcklaan,2023-04-20,05:00:00,22,2,20,FMN 11 A Jan Van Rijswijcklaan Ringfietspad
658,Ringfietspad Jan Van Rijswijcklaan,2023-04-20,06:00:00,59,16,43,FMN 11 A Jan Van Rijswijcklaan Ringfietspad
658,Ringfietspad Jan Van Rijswijcklaan,2023-04-20,07:00:00,125,40,85,FMN 11 A Jan Van Rijswijcklaan Ringfietspad
658,Ringfietspad Jan Van Rijswijcklaan,2023-04-20,08:00:00,148,41,107,FMN 11 A Jan Van Rijswijcklaan Ringfietspad
658,Ringfietspad Jan Van Rijswijcklaan,2023-04-20,09:00:00,71,26,45,FMN 11 A Jan Van Rijswijcklaan Ringfietspad
658,Ringfietspad Jan Van Rijswijcklaan,2023-04-20,10:00:00,41,17,24,FMN 11 A Jan Van Rijswijcklaan Ringfietspad
658,Ringfietspad Jan Van Rijswijcklaan,2023-04-20,11:00:00,46,20,26,FMN 11 A Jan Van Rijswijcklaan Ringfietspad
658,Ringfietspad Jan Van Rijswijcklaan,2023-04-20,12:00:00,58,24,34,FMN 11 A Jan Van Rijswijcklaan Ringfietspad
658,Ringfietspad Jan Van Rijswijcklaan,2023-04-20,13:00:00,57,31,26,FMN 11 A Jan Van Rijswijcklaan Ringfietspad
658,Ringfietspad Jan Van Rijswijcklaan,2023-04-20,14:00:00,69,49,20,FMN 11 A Jan Van Rijswijcklaan Ringfietspad
658,Ringfietspad Jan Van Rijswijcklaan,2023-04-20,15:00:00,104,69,35,FMN 11 A Jan Van Rijswijcklaan Ringfietspad
658,Ringfietspad Jan Van Rijswijcklaan,2023-04-20,16:00:00,152,94,58,FMN 11 A Jan Van Rijswijcklaan Ringfietspad
658,Ringfietspad Jan Van Rijswijcklaan,2023-04-20,17:00:00,138,90,48,FMN 11 A Jan Van Rijswijcklaan Ringfietspad
658,Ringfietspad Jan Van Rijswijcklaan,2023-04-20,18:00:00,81,49,32,FMN 11 A Jan Van Rijswijcklaan Ringfietspad
658,Ringfietspad Jan Van Rijswijcklaan,2023-04-20,19:00:00,41,21,20,FMN 11 A Jan Van Rijswijcklaan Ringfietspad
658,Ringfietspad Jan Van Rijswijcklaan,2023-04-20,20:00:00,30,15,15,FMN 11 A Jan Van Rijswijcklaan Ringfietspad
658,Ringfietspad Jan Van Rijswijcklaan,2023-04-20,21:00:00,19,9,10,FMN 11 A Jan Van Rijswijcklaan Ringfietspad
658,Ringfietspad Jan Van Rijswijcklaan,2023-04-20,22:00:00,21,16,5,FMN 11 A Jan Van Rijswijcklaan Ringfietspad
658,Ringfietspad Jan Van Rijswijcklaan,2023-04-20,23:00:00,12,7,5,FMN 11 A Jan Van Rijswijcklaan Ringfietspad
658,Ringfietspad Jan Van Rijswijcklaan,2023-04-21,00:00:00,5,3,2,FMN 11 A Jan Van Rijswijcklaan Ringfietspad
658,Ringfietspad Jan Van Rijswijcklaan,2023-04-21,01:00:00,3,2,1,FMN 11 A Jan Van Rijswijcklaan Ringfietspad
658,Ringfietspad Jan Van Rijswijcklaan,2023-04-21,02:00:00,3,1,2,FMN 11 A Jan Van Rijswijcklaan Ringfietspad
658,Ringfietspad Jan Van Rijswijcklaan,2023-04-21,03:00:00,3,1,2,FMN 11 A Jan Van Rijswijcklaan Ringfietspad
658,Ringfietspad Jan Van Rijswijcklaan,2023-04-21,04:00:00,9,3,6,FMN 11 A Jan Van Rijswijcklaan Ringfietspad
658,Ringfietspad Jan Van Rijswijcklaan,2023-04-21,05:00:00,25,8,17,FMN 11 A Jan Van Rijswijcklaan Ringfietspad
658,Ringfietspad Jan Van Rijswijcklaan,2023-04-21,06:00:00,66,18,48,FMN 11 A Jan Van Rijswijcklaan Ringfietspad
658,Ringfietspad Jan Van Rijswijcklaan,2023-04-21,07:00:00,100,29,71,FMN 11 A Jan Van Rijswijcklaan Ringfietspad
658,Ringfietspad Jan Van Rijswijcklaan,2023-04-21,08:00:00,154,54,100,FMN 11 A Jan Van Rijswijcklaan Ringfietspad
658,Ringfietspad Jan Van Rijswijcklaan,2023-04-21,09:00:00,61,27,34,FMN 11 A Jan Van Rijswijcklaan Ringfietspad
658,Ringfietspad Jan Van Rijswijcklaan,2023-04-21,10:00:00,45,24,21,FMN 11 A Jan Van Rijswijcklaan Ringfietspad
658,Ringfietspad Jan Van Rijswijcklaan,2023-04-21,11:00:00,46,20,26,FMN 11 A Jan Van Rijswijcklaan Ringfietspad
658,Ringfietspad Jan Van Rijswijcklaan,2023-04-21,12:00:00,64,32,32,FMN 11 A Jan Van Rijswijcklaan Ringfietspad
658,Ringfietspad Jan Van Rijswijcklaan,2023-04-21,13:00:00,54,28,26,FMN 11 A Jan Van Rijswijcklaan Ringfietspad
658,Ringfietspad Jan Van Rijswijcklaan,2023-04-21,14:00:00,84,51,33,FMN 11 A Jan Van Rijswijcklaan Ringfietspad
658,Ringfietspad Jan Van Rijswijcklaan,2023-04-21,15:00:00,106,79,27,FMN 11 A Jan Van Rijswijcklaan Ringfietspad
658,Ringfietspad Jan Van Rijswijcklaan,2023-04-21,16:00:00,142,89,53,FMN 11 A Jan Van Rijswijcklaan Ringfietspad
658,Ringfietspad Jan Van Rijswijcklaan,2023-04-21,17:00:00,126,83,43,FMN 11 A Jan Van Rijswijcklaan Ringfietspad
658,Ringfietspad Jan Van Rijswijcklaan,2023-04-21,18:00:00,63,43,20,FMN 11 A Jan Van Rijswijcklaan Ringfietspad
658,Ringfietspad Jan Van Rijswijcklaan,2023-04-21,19:00:00,51,28,23,FMN 11 A Jan Van Rijswijcklaan Ringfietspad
658,Ringfietspad Jan Van Rijswijcklaan,2023-04-21,20:00:00,29,18,11,FMN 11 A Jan Van Rijswijcklaan Ringfietspad
658,Ringfietspad Jan Van Rijswijcklaan,2023-04-21,21:00:00,24,11,13,FMN 11 A Jan Van Rijswijcklaan Ringfietspad
658,Ringfietspad Jan Van Rijswijcklaan,2023-04-21,22:00:00,20,15,5,FMN 11 A Jan Van Rijswijcklaan Ringfietspad
658,Ringfietspad Jan Van Rijswijcklaan,2023-04-21,23:00:00,10,2,8,FMN 11 A Jan Van Rijswijcklaan Ringfietspad
658,Ringfietspad Jan Van Rijswijcklaan,2023-04-22,00:00:00,4,3,1,FMN 11 A Jan Van Rijswijcklaan Ringfietspad
658,Ringfietspad Jan Van Rijswijcklaan,2023-04-22,01:00:00,1,1,0,FMN 11 A Jan Van Rijswijcklaan Ringfietspad
658,Ringfietspad Jan Van Rijswijcklaan,2023-04-22,02:00:00,1,0,1,FMN 11 A Jan Van Rijswijcklaan Ringfietspad
658,Ringfietspad Jan Van Rijswijcklaan,2023-04-22,03:00:00,2,2,0,FMN 11 A Jan Van Rijswijcklaan Ringfietspad
658,Ringfietspad Jan Van Rijswijcklaan,2023-04-22,04:00:00,7,2,5,FMN 11 A Jan Van Rijswijcklaan Ringfietspad
658,Ringfietspad Jan Van Rijswijcklaan,2023-04-22,05:00:00,4,1,3,FMN 11 A Jan Van Rijswijcklaan Ringfietspad
658,Ringfietspad Jan Van Rijswijcklaan,2023-04-22,06:00:00,4,3,1,FMN 11 A Jan Van Rijswijcklaan Ringfietspad
658,Ringfietspad Jan Van Rijswijcklaan,2023-04-22,07:00:00,10,5,5,FMN 11 A Jan Van Rijswijcklaan Ringfietspad
658,Ringfietspad Jan Van Rijswijcklaan,2023-04-22,08:00:00,18,10,8,FMN 11 A Jan Van Rijswijcklaan Ringfietspad
658,Ringfietspad Jan Van Rijswijcklaan,2023-04-22,09:00:00,23,10,13,FMN 11 A Jan Van Rijswijcklaan Ringfietspad
658,Ringfietspad Jan Van Rijswijcklaan,2023-04-22,10:00:00,32,14,18,FMN 11 A Jan Van Rijswijcklaan Ringfietspad
658,Ringfietspad Jan Van Rijswijcklaan,2023-04-22,11:00:00,39,19,20,FMN 11 A Jan Van Rijswijcklaan Ringfietspad
658,Ringfietspad Jan Van Rijswijcklaan,2023-04-22,12:00:00,38,22,16,FMN 11 A Jan Van Rijswijcklaan Ringfietspad
658,Ringfietspad Jan Van Rijswijcklaan,2023-04-22,13:00:00,52,24,28,FMN 11 A Jan Van Rijswijcklaan Ringfietspad
658,Ringfietspad Jan Van Rijswijcklaan,2023-04-22,14:00:00,60,28,32,FMN 11 A Jan Van Rijswijcklaan Ringfietspad
658,Ringfietspad Jan Van Rijswijcklaan,2023-04-22,15:00:00,67,36,31,FMN 11 A Jan Van Rijswijcklaan Ringfietspad
658,Ringfietspad Jan Van Rijswijcklaan,2023-04-22,16:00:00,60,36,24,FMN 11 A Jan Van Rijswijcklaan Ringfietspad
658,Ringfietspad Jan Van Rijswijcklaan,2023-04-22,17:00:00,45,19,26,FMN 11 A Jan Van Rijswijcklaan Ringfietspad
658,Ringfietspad Jan Van Rijswijcklaan,2023-04-22,18:00:00,39,21,18,FMN 11 A Jan Van Rijswijcklaan Ringfietspad
658,Ringfietspad Jan Van Rijswijcklaan,2023-04-22,19:00:00,21,13,8,FMN 11 A Jan Van Rijswijcklaan Ringfietspad
658,Ringfietspad Jan Van Rijswijcklaan,2023-04-22,20:00:00,22,13,9,FMN 11 A Jan Van Rijswijcklaan Ringfietspad
658,Ringfietspad Jan Van Rijswijcklaan,2023-04-22,21:00:00,9,5,4,FMN 11 A Jan Van Rijswijcklaan Ringfietspad
658,Ringfietspad Jan Van Rijswijcklaan,2023-04-22,22:00:00,7,5,2,FMN 11 A Jan Van Rijswijcklaan Ringfietspad
658,Ringfietspad Jan Van Rijswijcklaan,2023-04-22,23:00:00,8,5,3,FMN 11 A Jan Van Rijswijcklaan Ringfietspad
658,Ringfietspad Jan Van Rijswijcklaan,2023-04-23,00:00:00,2,1,1,FMN 11 A Jan Van Rijswijcklaan Ringfietspad
658,Ringfietspad Jan Van Rijswijcklaan,2023-04-23,01:00:00,4,2,2,FMN 11 A Jan Van Rijswijcklaan Ringfietspad
658,Ringfietspad Jan Van Rijswijcklaan,2023-04-23,02:00:00,2,1,1,FMN 11 A Jan Van Rijswijcklaan Ringfietspad
658,Ringfietspad Jan Van Rijswijcklaan,2023-04-23,03:00:00,0,0,0,FMN 11 A Jan Van Rijswijcklaan Ringfietspad
658,Ringfietspad Jan Van Rijswijcklaan,2023-04-23,04:00:00,4,1,3,FMN 11 A Jan Van Rijswijcklaan Ringfietspad
658,Ringfietspad Jan Van Rijswijcklaan,2023-04-23,05:00:00,3,2,1,FMN 11 A Jan Van Rijswijcklaan Ringfietspad
658,Ringfietspad Jan Van Rijswijcklaan,2023-04-23,06:00:00,2,1,1,FMN 11 A Jan Van Rijswijcklaan Ringfietspad
658,Ringfietspad Jan Van Rijswijcklaan,2023-04-23,07:00:00,4,1,3,FMN 11 A Jan Van Rijswijcklaan Ringfietspad
658,Ringfietspad Jan Van Rijswijcklaan,2023-04-23,08:00:00,15,6,9,FMN 11 A Jan Van Rijswijcklaan Ringfietspad
658,Ringfietspad Jan Van Rijswijcklaan,2023-04-23,09:00:00,30,10,20,FMN 11 A Jan Van Rijswijcklaan Ringfietspad
658,Ringfietspad Jan Van Rijswijcklaan,2023-04-23,10:00:00,30,12,18,FMN 11 A Jan Van Rijswijcklaan Ringfietspad
658,Ringfietspad Jan Van Rijswijcklaan,2023-04-23,11:00:00,52,23,29,FMN 11 A Jan Van Rijswijcklaan Ringfietspad
658,Ringfietspad Jan Van Rijswijcklaan,2023-04-23,12:00:00,41,23,18,FMN 11 A Jan Van Rijswijcklaan Ringfietspad
658,Ringfietspad Jan Van Rijswijcklaan,2023-04-23,13:00:00,54,27,27,FMN 11 A Jan Van Rijswijcklaan Ringfietspad
658,Ringfietspad Jan Van Rijswijcklaan,2023-04-23,14:00:00,54,29,25,FMN 11 A Jan Van Rijswijcklaan Ringfietspad
658,Ringfietspad Jan Van Rijswijcklaan,2023-04-23,15:00:00,53,27,26,FMN 11 A Jan Van Rijswijcklaan Ringfietspad
658,Ringfietspad Jan Van Rijswijcklaan,2023-04-23,16:00:00,45,26,19,FMN 11 A Jan Van Rijswijcklaan Ringfietspad
658,Ringfietspad Jan Van Rijswijcklaan,2023-04-23,17:00:00,44,28,16,FMN 11 A Jan Van Rijswijcklaan Ringfietspad
658,Ringfietspad Jan Van Rijswijcklaan,2023-04-23,18:00:00,34,19,15,FMN 11 A Jan Van Rijswijcklaan Ringfietspad
658,Ringfietspad Jan Van Rijswijcklaan,2023-04-23,19:00:00,16,8,8,FMN 11 A Jan Van Rijswijcklaan Ringfietspad
658,Ringfietspad Jan Van Rijswijcklaan,2023-04-23,20:00:00,11,3,8,FMN 11 A Jan Van Rijswijcklaan Ringfietspad
658,Ringfietspad Jan Van Rijswijcklaan,2023-04-23,21:00:00,18,9,9,FMN 11 A Jan Van Rijswijcklaan Ringfietspad
658,Ringfietspad Jan Van Rijswijcklaan,2023-04-23,22:00:00,4,3,1,FMN 11 A Jan Van Rijswijcklaan Ringfietspad
658,Ringfietspad Jan Van Rijswijcklaan,2023-04-23,23:00:00,3,3,0,FMN 11 A Jan Van Rijswijcklaan Ringfietspad
658,Ringfietspad Jan Van Rijswijcklaan,2023-04-24,00:00:00,4,1,3,FMN 11 A Jan Van Rijswijcklaan Ringfietspad
658,Ringfietspad Jan Van Rijswijcklaan,2023-04-24,01:00:00,1,0,1,FMN 11 A Jan Van Rijswijcklaan Ringfietspad
658,Ringfietspad Jan Van Rijswijcklaan,2023-04-24,02:00:00,0,0,0,FMN 11 A Jan Van Rijswijcklaan Ringfietspad
658,Ringfietspad Jan Van Rijswijcklaan,2023-04-24,03:00:00,2,0,2,FMN 11 A Jan Van Rijswijcklaan Ringfietspad
658,Ringfietspad Jan Van Rijswijcklaan,2023-04-24,04:00:00,5,2,3,FMN 11 A Jan Van Rijswijcklaan Ringfietspad
658,Ringfietspad Jan Van Rijswijcklaan,2023-04-24,05:00:00,11,2,9,FMN 11 A Jan Van Rijswijcklaan Ringfietspad
658,Ringfietspad Jan Van Rijswijcklaan,2023-04-24,06:00:00,41,10,31,FMN 11 A Jan Van Rijswijcklaan Ringfietspad
658,Ringfietspad Jan Van Rijswijcklaan,2023-04-24,07:00:00,96,33,63,FMN 11 A Jan Van Rijswijcklaan Ringfietspad
658,Ringfietspad Jan Van Rijswijcklaan,2023-04-24,08:00:00,144,45,99,FMN 11 A Jan Van Rijswijcklaan Ringfietspad
658,Ringfietspad Jan Van Rijswijcklaan,2023-04-24,09:00:00,50,19,31,FMN 11 A Jan Van Rijswijcklaan Ringfietspad
658,Ringfietspad Jan Van Rijswijcklaan,2023-04-24,10:00:00,35,13,22,FMN 11 A Jan Van Rijswijcklaan Ringfietspad
658,Ringfietspad Jan Van Rijswijcklaan,2023-04-24,11:00:00,30,15,15,FMN 11 A Jan Van Rijswijcklaan Ringfietspad
658,Ringfietspad Jan Van Rijswijcklaan,2023-04-24,12:00:00,52,27,25,FMN 11 A Jan Van Rijswijcklaan Ringfietspad
658,Ringfietspad Jan Van Rijswijcklaan,2023-04-24,13:00:00,44,26,18,FMN 11 A Jan Van Rijswijcklaan Ringfietspad
658,Ringfietspad Jan Van Rijswijcklaan,2023-04-24,14:00:00,62,37,25,FMN 11 A Jan Van Rijswijcklaan Ringfietspad
658,Ringfietspad Jan Van Rijswijcklaan,2023-04-24,15:00:00,89,53,36,FMN 11 A Jan Van Rijswijcklaan Ringfietspad
658,Ringfietspad Jan Van Rijswijcklaan,2023-04-24,16:00:00,131,92,39,FMN 11 A Jan Van Rijswijcklaan Ringfietspad
658,Ringfietspad Jan Van Rijswijcklaan,2023-04-24,17:00:00,136,91,45,FMN 11 A Jan Van Rijswijcklaan Ringfietspad
658,Ringfietspad Jan Van Rijswijcklaan,2023-04-24,18:00:00,77,51,26,FMN 11 A Jan Van Rijswijcklaan Ringfietspad
658,Ringfietspad Jan Van Rijswijcklaan,2023-04-24,19:00:00,29,17,12,FMN 11 A Jan Van Rijswijcklaan Ringfietspad
658,Ringfietspad Jan Van Rijswijcklaan,2023-04-24,20:00:00,31,12,19,FMN 11 A Jan Van Rijswijcklaan Ringfietspad
658,Ringfietspad Jan Van Rijswijcklaan,2023-04-24,21:00:00,21,8,13,FMN 11 A Jan Van Rijswijcklaan Ringfietspad
658,Ringfietspad Jan Van Rijswijcklaan,2023-04-24,22:00:00,22,11,11,FMN 11 A Jan Van Rijswijcklaan Ringfietspad
658,Ringfietspad Jan Van Rijswijcklaan,2023-04-24,23:00:00,3,2,1,FMN 11 A Jan Van Rijswijcklaan Ringfietspad
658,Ringfietspad Jan Van Rijswijcklaan,2023-04-25,00:00:00,4,2,2,FMN 11 A Jan Van Rijswijcklaan Ringfietspad
658,Ringfietspad Jan Van Rijswijcklaan,2023-04-25,01:00:00,1,0,1,FMN 11 A Jan Van Rijswijcklaan Ringfietspad
658,Ringfietspad Jan Van Rijswijcklaan,2023-04-25,02:00:00,0,0,0,FMN 11 A Jan Van Rijswijcklaan Ringfietspad
658,Ringfietspad Jan Van Rijswijcklaan,2023-04-25,03:00:00,1,0,1,FMN 11 A Jan Van Rijswijcklaan Ringfietspad
658,Ringfietspad Jan Van Rijswijcklaan,2023-04-25,04:00:00,11,5,6,FMN 11 A Jan Van Rijswijcklaan Ringfietspad
658,Ringfietspad Jan Van Rijswijcklaan,2023-04-25,05:00:00,32,15,17,FMN 11 A Jan Van Rijswijcklaan Ringfietspad
658,Ringfietspad Jan Van Rijswijcklaan,2023-04-25,06:00:00,53,10,43,FMN 11 A Jan Van Rijswijcklaan Ringfietspad
658,Ringfietspad Jan Van Rijswijcklaan,2023-04-25,07:00:00,132,45,87,FMN 11 A Jan Van Rijswijcklaan Ringfietspad
658,Ringfietspad Jan Van Rijswijcklaan,2023-04-25,08:00:00,180,66,114,FMN 11 A Jan Van Rijswijcklaan Ringfietspad
658,Ringfietspad Jan Van Rijswijcklaan,2023-04-25,09:00:00,70,26,44,FMN 11 A Jan Van Rijswijcklaan Ringfietspad
658,Ringfietspad Jan Van Rijswijcklaan,2023-04-25,10:00:00,40,18,22,FMN 11 A Jan Van Rijswijcklaan Ringfietspad
658,Ringfietspad Jan Van Rijswijcklaan,2023-04-25,11:00:00,34,13,21,FMN 11 A Jan Van Rijswijcklaan Ringfietspad
658,Ringfietspad Jan Van Rijswijcklaan,2023-04-25,12:00:00,61,35,26,FMN 11 A Jan Van Rijswijcklaan Ringfietspad
658,Ringfietspad Jan Van Rijswijcklaan,2023-04-25,13:00:00,52,25,27,FMN 11 A Jan Van Rijswijcklaan Ringfietspad
658,Ringfietspad Jan Van Rijswijcklaan,2023-04-25,14:00:00,67,38,29,FMN 11 A Jan Van Rijswijcklaan Ringfietspad
658,Ringfietspad Jan Van Rijswijcklaan,2023-04-25,15:00:00,98,60,38,FMN 11 A Jan Van Rijswijcklaan Ringfietspad
658,Ringfietspad Jan Van Rijswijcklaan,2023-04-25,16:00:00,164,108,56,FMN 11 A Jan Van Rijswijcklaan Ringfietspad
658,Ringfietspad Jan Van Rijswijcklaan,2023-04-25,17:00:00,171,114,57,FMN 11 A Jan Van Rijswijcklaan Ringfietspad
658,Ringfietspad Jan Van Rijswijcklaan,2023-04-25,18:00:00,92,50,42,FMN 11 A Jan Van Rijswijcklaan Ringfietspad
658,Ringfietspad Jan Van Rijswijcklaan,2023-04-25,19:00:00,32,19,13,FMN 11 A Jan Van Rijswijcklaan Ringfietspad
658,Ringfietspad Jan Van Rijswijcklaan,2023-04-25,20:00:00,30,14,16,FMN 11 A Jan Van Rijswijcklaan Ringfietspad
658,Ringfietspad Jan Van Rijswijcklaan,2023-04-25,21:00:00,26,11,15,FMN 11 A Jan Van Rijswijcklaan Ringfietspad
658,Ringfietspad Jan Van Rijswijcklaan,2023-04-25,22:00:00,23,14,9,FMN 11 A Jan Van Rijswijcklaan Ringfietspad
658,Ringfietspad Jan Van Rijswijcklaan,2023-04-25,23:00:00,3,1,2,FMN 11 A Jan Van Rijswijcklaan Ringfietspad
658,Ringfietspad Jan Van Rijswijcklaan,2023-04-26,00:00:00,1,0,1,FMN 11 A Jan Van Rijswijcklaan Ringfietspad
658,Ringfietspad Jan Van Rijswijcklaan,2023-04-26,01:00:00,1,1,0,FMN 11 A Jan Van Rijswijcklaan Ringfietspad
658,Ringfietspad Jan Van Rijswijcklaan,2023-04-26,02:00:00,2,1,1,FMN 11 A Jan Van Rijswijcklaan Ringfietspad
658,Ringfietspad Jan Van Rijswijcklaan,2023-04-26,03:00:00,2,1,1,FMN 11 A Jan Van Rijswijcklaan Ringfietspad
658,Ringfietspad Jan Van Rijswijcklaan,2023-04-26,04:00:00,10,4,6,FMN 11 A Jan Van Rijswijcklaan Ringfietspad
658,Ringfietspad Jan Van Rijswijcklaan,2023-04-26,05:00:00,20,4,16,FMN 11 A Jan Van Rijswijcklaan Ringfietspad
658,Ringfietspad Jan Van Rijswijcklaan,2023-04-26,06:00:00,58,11,47,FMN 11 A Jan Van Rijswijcklaan Ringfietspad
658,Ringfietspad Jan Van Rijswijcklaan,2023-04-26,07:00:00,132,51,81,FMN 11 A Jan Van Rijswijcklaan Ringfietspad
658,Ringfietspad Jan Van Rijswijcklaan,2023-04-26,08:00:00,162,54,108,FMN 11 A Jan Van Rijswijcklaan Ringfietspad
658,Ringfietspad Jan Van Rijswijcklaan,2023-04-26,09:00:00,68,25,43,FMN 11 A Jan Van Rijswijcklaan Ringfietspad
658,Ringfietspad Jan Van Rijswijcklaan,2023-04-26,10:00:00,48,20,28,FMN 11 A Jan Van Rijswijcklaan Ringfietspad
658,Ringfietspad Jan Van Rijswijcklaan,2023-04-26,11:00:00,41,21,20,FMN 11 A Jan Van Rijswijcklaan Ringfietspad
658,Ringfietspad Jan Van Rijswijcklaan,2023-04-26,12:00:00,85,44,41,FMN 11 A Jan Van Rijswijcklaan Ringfietspad
658,Ringfietspad Jan Van Rijswijcklaan,2023-04-26,13:00:00,60,29,31,FMN 11 A Jan Van Rijswijcklaan Ringfietspad
658,Ringfietspad Jan Van Rijswijcklaan,2023-04-26,14:00:00,72,41,31,FMN 11 A Jan Van Rijswijcklaan Ringfietspad
658,Ringfietspad Jan Van Rijswijcklaan,2023-04-26,15:00:00,87,46,41,FMN 11 A Jan Van Rijswijcklaan Ringfietspad
658,Ringfietspad Jan Van Rijswijcklaan,2023-04-26,16:00:00,147,95,52,FMN 11 A Jan Van Rijswijcklaan Ringfietspad
658,Ringfietspad Jan Van Rijswijcklaan,2023-04-26,17:00:00,158,103,55,FMN 11 A Jan Van Rijswijcklaan Ringfietspad
658,Ringfietspad Jan Van Rijswijcklaan,2023-04-26,18:00:00,95,59,36,FMN 11 A Jan Van Rijswijcklaan Ringfietspad
658,Ringfietspad Jan Van Rijswijcklaan,2023-04-26,19:00:00,48,27,21,FMN 11 A Jan Van Rijswijcklaan Ringfietspad
658,Ringfietspad Jan Van Rijswijcklaan,2023-04-26,20:00:00,37,17,20,FMN 11 A Jan Van Rijswijcklaan Ringfietspad
658,Ringfietspad Jan Van Rijswijcklaan,2023-04-26,21:00:00,22,13,9,FMN 11 A Jan Van Rijswijcklaan Ringfietspad
658,Ringfietspad Jan Van Rijswijcklaan,2023-04-26,22:00:00,31,19,12,FMN 11 A Jan Van Rijswijcklaan Ringfietspad
658,Ringfietspad Jan Van Rijswijcklaan,2023-04-26,23:00:00,7,4,3,FMN 11 A Jan Van Rijswijcklaan Ringfietspad
658,Ringfietspad Jan Van Rijswijcklaan,2023-04-27,00:00:00,2,1,1,FMN 11 A Jan Van Rijswijcklaan Ringfietspad
658,Ringfietspad Jan Van Rijswijcklaan,2023-04-27,01:00:00,0,0,0,FMN 11 A Jan Van Rijswijcklaan Ringfietspad
658,Ringfietspad Jan Van Rijswijcklaan,2023-04-27,02:00:00,0,0,0,FMN 11 A Jan Van Rijswijcklaan Ringfietspad
658,Ringfietspad Jan Van Rijswijcklaan,2023-04-27,03:00:00,5,5,0,FMN 11 A Jan Van Rijswijcklaan Ringfietspad
658,Ringfietspad Jan Van Rijswijcklaan,2023-04-27,04:00:00,3,0,3,FMN 11 A Jan Van Rijswijcklaan Ringfietspad
658,Ringfietspad Jan Van Rijswijcklaan,2023-04-27,05:00:00,29,9,20,FMN 11 A Jan Van Rijswijcklaan Ringfietspad
658,Ringfietspad Jan Van Rijswijcklaan,2023-04-27,06:00:00,78,18,60,FMN 11 A Jan Van Rijswijcklaan Ringfietspad
658,Ringfietspad Jan Van Rijswijcklaan,2023-04-27,07:00:00,133,44,89,FMN 11 A Jan Van Rijswijcklaan Ringfietspad
658,Ringfietspad Jan Van Rijswijcklaan,2023-04-27,08:00:00,179,56,123,FMN 11 A Jan Van Rijswijcklaan Ringfietspad
658,Ringfietspad Jan Van Rijswijcklaan,2023-04-27,09:00:00,76,31,45,FMN 11 A Jan Van Rijswijcklaan Ringfietspad
658,Ringfietspad Jan Van Rijswijcklaan,2023-04-27,10:00:00,44,19,25,FMN 11 A Jan Van Rijswijcklaan Ringfietspad
658,Ringfietspad Jan Van Rijswijcklaan,2023-04-27,11:00:00,46,24,22,FMN 11 A Jan Van Rijswijcklaan Ringfietspad
658,Ringfietspad Jan Van Rijswijcklaan,2023-04-27,12:00:00,64,29,35,FMN 11 A Jan Van Rijswijcklaan Ringfietspad
658,Ringfietspad Jan Van Rijswijcklaan,2023-04-27,13:00:00,75,42,33,FMN 11 A Jan Van Rijswijcklaan Ringfietspad
658,Ringfietspad Jan Van Rijswijcklaan,2023-04-27,14:00:00,79,45,34,FMN 11 A Jan Van Rijswijcklaan Ringfietspad
658,Ringfietspad Jan Van Rijswijcklaan,2023-04-27,15:00:00,98,67,31,FMN 11 A Jan Van Rijswijcklaan Ringfietspad
658,Ringfietspad Jan Van Rijswijcklaan,2023-04-27,16:00:00,167,110,57,FMN 11 A Jan Van Rijswijcklaan Ringfietspad
658,Ringfietspad Jan Van Rijswijcklaan,2023-04-27,17:00:00,175,109,66,FMN 11 A Jan Van Rijswijcklaan Ringfietspad
658,Ringfietspad Jan Van Rijswijcklaan,2023-04-27,18:00:00,105,62,43,FMN 11 A Jan Van Rijswijcklaan Ringfietspad
658,Ringfietspad Jan Van Rijswijcklaan,2023-04-27,19:00:00,52,32,20,FMN 11 A Jan Van Rijswijcklaan Ringfietspad
658,Ringfietspad Jan Van Rijswijcklaan,2023-04-27,20:00:00,32,12,20,FMN 11 A Jan Van Rijswijcklaan Ringfietspad
658,Ringfietspad Jan Van Rijswijcklaan,2023-04-27,21:00:00,34,20,14,FMN 11 A Jan Van Rijswijcklaan Ringfietspad
658,Ringfietspad Jan Van Rijswijcklaan,2023-04-27,22:00:00,25,16,9,FMN 11 A Jan Van Rijswijcklaan Ringfietspad
658,Ringfietspad Jan Van Rijswijcklaan,2023-04-27,23:00:00,13,6,7,FMN 11 A Jan Van Rijswijcklaan Ringfietspad
658,Ringfietspad Jan Van Rijswijcklaan,2023-04-28,00:00:00,5,3,2,FMN 11 A Jan Van Rijswijcklaan Ringfietspad
658,Ringfietspad Jan Van Rijswijcklaan,2023-04-28,01:00:00,2,2,0,FMN 11 A Jan Van Rijswijcklaan Ringfietspad
658,Ringfietspad Jan Van Rijswijcklaan,2023-04-28,02:00:00,2,2,0,FMN 11 A Jan Van Rijswijcklaan Ringfietspad
658,Ringfietspad Jan Van Rijswijcklaan,2023-04-28,03:00:00,1,1,0,FMN 11 A Jan Van Rijswijcklaan Ringfietspad
658,Ringfietspad Jan Van Rijswijcklaan,2023-04-28,04:00:00,9,2,7,FMN 11 A Jan Van Rijswijcklaan Ringfietspad
658,Ringfietspad Jan Van Rijswijcklaan,2023-04-28,05:00:00,19,7,12,FMN 11 A Jan Van Rijswijcklaan Ringfietspad
658,Ringfietspad Jan Van Rijswijcklaan,2023-04-28,06:00:00,46,14,32,FMN 11 A Jan Van Rijswijcklaan Ringfietspad
658,Ringfietspad Jan Van Rijswijcklaan,2023-04-28,07:00:00,95,38,57,FMN 11 A Jan Van Rijswijcklaan Ringfietspad
658,Ringfietspad Jan Van Rijswijcklaan,2023-04-28,08:00:00,149,49,100,FMN 11 A Jan Van Rijswijcklaan Ringfietspad
658,Ringfietspad Jan Van Rijswijcklaan,2023-04-28,09:00:00,56,24,32,FMN 11 A Jan Van Rijswijcklaan Ringfietspad
658,Ringfietspad Jan Van Rijswijcklaan,2023-04-28,10:00:00,50,21,29,FMN 11 A Jan Van Rijswijcklaan Ringfietspad
658,Ringfietspad Jan Van Rijswijcklaan,2023-04-28,11:00:00,41,20,21,FMN 11 A Jan Van Rijswijcklaan Ringfietspad
658,Ringfietspad Jan Van Rijswijcklaan,2023-04-28,12:00:00,55,28,27,FMN 11 A Jan Van Rijswijcklaan Ringfietspad
658,Ringfietspad Jan Van Rijswijcklaan,2023-04-28,13:00:00,53,24,29,FMN 11 A Jan Van Rijswijcklaan Ringfietspad
658,Ringfietspad Jan Van Rijswijcklaan,2023-04-28,14:00:00,62,35,27,FMN 11 A Jan Van Rijswijcklaan Ringfietspad
658,Ringfietspad Jan Van Rijswijcklaan,2023-04-28,15:00:00,102,71,31,FMN 11 A Jan Van Rijswijcklaan Ringfietspad
658,Ringfietspad Jan Van Rijswijcklaan,2023-04-28,16:00:00,140,89,51,FMN 11 A Jan Van Rijswijcklaan Ringfietspad
658,Ringfietspad Jan Van Rijswijcklaan,2023-04-28,17:00:00,110,70,40,FMN 11 A Jan Van Rijswijcklaan Ringfietspad
658,Ringfietspad Jan Van Rijswijcklaan,2023-04-28,18:00:00,65,45,20,FMN 11 A Jan Van Rijswijcklaan Ringfietspad
658,Ringfietspad Jan Van Rijswijcklaan,2023-04-28,19:00:00,29,15,14,FMN 11 A Jan Van Rijswijcklaan Ringfietspad
658,Ringfietspad Jan Van Rijswijcklaan,2023-04-28,20:00:00,23,11,12,FMN 11 A Jan Van Rijswijcklaan Ringfietspad
658,Ringfietspad Jan Van Rijswijcklaan,2023-04-28,21:00:00,22,12,10,FMN 11 A Jan Van Rijswijcklaan Ringfietspad
658,Ringfietspad Jan Van Rijswijcklaan,2023-04-28,22:00:00,22,13,9,FMN 11 A Jan Van Rijswijcklaan Ringfietspad
658,Ringfietspad Jan Van Rijswijcklaan,2023-04-28,23:00:00,14,7,7,FMN 11 A Jan Van Rijswijcklaan Ringfietspad
658,Ringfietspad Jan Van Rijswijcklaan,2023-04-29,00:00:00,5,3,2,FMN 11 A Jan Van Rijswijcklaan Ringfietspad
658,Ringfietspad Jan Van Rijswijcklaan,2023-04-29,01:00:00,8,6,2,FMN 11 A Jan Van Rijswijcklaan Ringfietspad
658,Ringfietspad Jan Van Rijswijcklaan,2023-04-29,02:00:00,3,2,1,FMN 11 A Jan Van Rijswijcklaan Ringfietspad
658,Ringfietspad Jan Van Rijswijcklaan,2023-04-29,03:00:00,2,1,1,FMN 11 A Jan Van Rijswijcklaan Ringfietspad
658,Ringfietspad Jan Van Rijswijcklaan,2023-04-29,04:00:00,6,4,2,FMN 11 A Jan Van Rijswijcklaan Ringfietspad
658,Ringfietspad Jan Van Rijswijcklaan,2023-04-29,05:00:00,5,1,4,FMN 11 A Jan Van Rijswijcklaan Ringfietspad
658,Ringfietspad Jan Van Rijswijcklaan,2023-04-29,06:00:00,12,5,7,FMN 11 A Jan Van Rijswijcklaan Ringfietspad
658,Ringfietspad Jan Van Rijswijcklaan,2023-04-29,07:00:00,9,4,5,FMN 11 A Jan Van Rijswijcklaan Ringfietspad
658,Ringfietspad Jan Van Rijswijcklaan,2023-04-29,08:00:00,21,11,10,FMN 11 A Jan Van Rijswijcklaan Ringfietspad
658,Ringfietspad Jan Van Rijswijcklaan,2023-04-29,09:00:00,41,16,25,FMN 11 A Jan Van Rijswijcklaan Ringfietspad
658,Ringfietspad Jan Van Rijswijcklaan,2023-04-29,10:00:00,58,26,32,FMN 11 A Jan Van Rijswijcklaan Ringfietspad
658,Ringfietspad Jan Van Rijswijcklaan,2023-04-29,11:00:00,70,33,37,FMN 11 A Jan Van Rijswijcklaan Ringfietspad
658,Ringfietspad Jan Van Rijswijcklaan,2023-04-29,12:00:00,55,28,27,FMN 11 A Jan Van Rijswijcklaan Ringfietspad
658,Ringfietspad Jan Van Rijswijcklaan,2023-04-29,13:00:00,63,32,31,FMN 11 A Jan Van Rijswijcklaan Ringfietspad
658,Ringfietspad Jan Van Rijswijcklaan,2023-04-29,14:00:00,61,29,32,FMN 11 A Jan Van Rijswijcklaan Ringfietspad
658,Ringfietspad Jan Van Rijswijcklaan,2023-04-29,15:00:00,74,42,32,FMN 11 A Jan Van Rijswijcklaan Ringfietspad
658,Ringfietspad Jan Van Rijswijcklaan,2023-04-29,16:00:00,75,47,28,FMN 11 A Jan Van Rijswijcklaan Ringfietspad
658,Ringfietspad Jan Van Rijswijcklaan,2023-04-29,17:00:00,55,30,25,FMN 11 A Jan Van Rijswijcklaan Ringfietspad
658,Ringfietspad Jan Van Rijswijcklaan,2023-04-29,18:00:00,40,26,14,FMN 11 A Jan Van Rijswijcklaan Ringfietspad
658,Ringfietspad Jan Van Rijswijcklaan,2023-04-29,19:00:00,20,12,8,FMN 11 A Jan Van Rijswijcklaan Ringfietspad
658,Ringfietspad Jan Van Rijswijcklaan,2023-04-29,20:00:00,17,7,10,FMN 11 A Jan Van Rijswijcklaan Ringfietspad
658,Ringfietspad Jan Van Rijswijcklaan,2023-04-29,21:00:00,15,7,8,FMN 11 A Jan Van Rijswijcklaan Ringfietspad
658,Ringfietspad Jan Van Rijswijcklaan,2023-04-29,22:00:00,13,8,5,FMN 11 A Jan Van Rijswijcklaan Ringfietspad
658,Ringfietspad Jan Van Rijswijcklaan,2023-04-29,23:00:00,15,9,6,FMN 11 A Jan Van Rijswijcklaan Ringfietspad
658,Ringfietspad Jan Van Rijswijcklaan,2023-04-30,00:00:00,8,6,2,FMN 11 A Jan Van Rijswijcklaan Ringfietspad
658,Ringfietspad Jan Van Rijswijcklaan,2023-04-30,01:00:00,1,0,1,FMN 11 A Jan Van Rijswijcklaan Ringfietspad
658,Ringfietspad Jan Van Rijswijcklaan,2023-04-30,02:00:00,0,0,0,FMN 11 A Jan Van Rijswijcklaan Ringfietspad
658,Ringfietspad Jan Van Rijswijcklaan,2023-04-30,03:00:00,3,1,2,FMN 11 A Jan Van Rijswijcklaan Ringfietspad
658,Ringfietspad Jan Van Rijswijcklaan,2023-04-30,04:00:00,4,3,1,FMN 11 A Jan Van Rijswijcklaan Ringfietspad
658,Ringfietspad Jan Van Rijswijcklaan,2023-04-30,05:00:00,3,1,2,FMN 11 A Jan Van Rijswijcklaan Ringfietspad
658,Ringfietspad Jan Van Rijswijcklaan,2023-04-30,06:00:00,6,3,3,FMN 11 A Jan Van Rijswijcklaan Ringfietspad
658,Ringfietspad Jan Van Rijswijcklaan,2023-04-30,07:00:00,8,4,4,FMN 11 A Jan Van Rijswijcklaan Ringfietspad
658,Ringfietspad Jan Van Rijswijcklaan,2023-04-30,08:00:00,15,4,11,FMN 11 A Jan Van Rijswijcklaan Ringfietspad
658,Ringfietspad Jan Van Rijswijcklaan,2023-04-30,09:00:00,59,23,36,FMN 11 A Jan Van Rijswijcklaan Ringfietspad
658,Ringfietspad Jan Van Rijswijcklaan,2023-04-30,10:00:00,67,26,41,FMN 11 A Jan Van Rijswijcklaan Ringfietspad
658,Ringfietspad Jan Van Rijswijcklaan,2023-04-30,11:00:00,67,31,36,FMN 11 A Jan Van Rijswijcklaan Ringfietspad
658,Ringfietspad Jan Van Rijswijcklaan,2023-04-30,12:00:00,86,50,36,FMN 11 A Jan Van Rijswijcklaan Ringfietspad
658,Ringfietspad Jan Van Rijswijcklaan,2023-04-30,13:00:00,76,37,39,FMN 11 A Jan Van Rijswijcklaan Ringfietspad
658,Ringfietspad Jan Van Rijswijcklaan,2023-04-30,14:00:00,93,46,47,FMN 11 A Jan Van Rijswijcklaan Ringfietspad
658,Ringfietspad Jan Van Rijswijcklaan,2023-04-30,15:00:00,87,49,38,FMN 11 A Jan Van Rijswijcklaan Ringfietspad
658,Ringfietspad Jan Van Rijswijcklaan,2023-04-30,16:00:00,58,34,24,FMN 11 A Jan Van Rijswijcklaan Ringfietspad
658,Ringfietspad Jan Van Rijswijcklaan,2023-04-30,17:00:00,51,31,20,FMN 11 A Jan Van Rijswijcklaan Ringfietspad
658,Ringfietspad Jan Van Rijswijcklaan,2023-04-30,18:00:00,46,30,16,FMN 11 A Jan Van Rijswijcklaan Ringfietspad
658,Ringfietspad Jan Van Rijswijcklaan,2023-04-30,19:00:00,20,9,11,FMN 11 A Jan Van Rijswijcklaan Ringfietspad
658,Ringfietspad Jan Van Rijswijcklaan,2023-04-30,20:00:00,24,11,13,FMN 11 A Jan Van Rijswijcklaan Ringfietspad
658,Ringfietspad Jan Van Rijswijcklaan,2023-04-30,21:00:00,8,2,6,FMN 11 A Jan Van Rijswijcklaan Ringfietspad
658,Ringfietspad Jan Van Rijswijcklaan,2023-04-30,22:00:00,6,5,1,FMN 11 A Jan Van Rijswijcklaan Ringfietspad
658,Ringfietspad Jan Van Rijswijcklaan,2023-04-30,23:00:00,6,1,5,FMN 11 A Jan Van Rijswijcklaan Ringfietspad
658,Ringfietspad Jan Van Rijswijcklaan,2023-05-01,00:00:00,0,0,0,FMN 11 A Jan Van Rijswijcklaan Ringfietspad
658,Ringfietspad Jan Van Rijswijcklaan,2023-05-01,01:00:00,2,0,2,FMN 11 A Jan Van Rijswijcklaan Ringfietspad
658,Ringfietspad Jan Van Rijswijcklaan,2023-05-01,02:00:00,0,0,0,FMN 11 A Jan Van Rijswijcklaan Ringfietspad
658,Ringfietspad Jan Van Rijswijcklaan,2023-05-01,03:00:00,1,1,0,FMN 11 A Jan Van Rijswijcklaan Ringfietspad
658,Ringfietspad Jan Van Rijswijcklaan,2023-05-01,04:00:00,3,2,1,FMN 11 A Jan Van Rijswijcklaan Ringfietspad
658,Ringfietspad Jan Van Rijswijcklaan,2023-05-01,05:00:00,10,3,7,FMN 11 A Jan Van Rijswijcklaan Ringfietspad
658,Ringfietspad Jan Van Rijswijcklaan,2023-05-01,06:00:00,41,12,29,FMN 11 A Jan Van Rijswijcklaan Ringfietspad
658,Ringfietspad Jan Van Rijswijcklaan,2023-05-01,07:00:00,73,26,47,FMN 11 A Jan Van Rijswijcklaan Ringfietspad
658,Ringfietspad Jan Van Rijswijcklaan,2023-05-01,08:00:00,108,40,68,FMN 11 A Jan Van Rijswijcklaan Ringfietspad
658,Ringfietspad Jan Van Rijswijcklaan,2023-05-01,09:00:00,32,11,21,FMN 11 A Jan Van Rijswijcklaan Ringfietspad
658,Ringfietspad Jan Van Rijswijcklaan,2023-05-01,10:00:00,34,15,19,FMN 11 A Jan Van Rijswijcklaan Ringfietspad
658,Ringfietspad Jan Van Rijswijcklaan,2023-05-01,11:00:00,25,16,9,FMN 11 A Jan Van Rijswijcklaan Ringfietspad
658,Ringfietspad Jan Van Rijswijcklaan,2023-05-01,12:00:00,34,14,20,FMN 11 A Jan Van Rijswijcklaan Ringfietspad
658,Ringfietspad Jan Van Rijswijcklaan,2023-05-01,13:00:00,25,11,14,FMN 11 A Jan Van Rijswijcklaan Ringfietspad
658,Ringfietspad Jan Van Rijswijcklaan,2023-05-01,14:00:00,37,22,15,FMN 11 A Jan Van Rijswijcklaan Ringfietspad
658,Ringfietspad Jan Van Rijswijcklaan,2023-05-01,15:00:00,52,30,22,FMN 11 A Jan Van Rijswijcklaan Ringfietspad
658,Ringfietspad Jan Van Rijswijcklaan,2023-05-01,16:00:00,81,53,28,FMN 11 A Jan Van Rijswijcklaan Ringfietspad
658,Ringfietspad Jan Van Rijswijcklaan,2023-05-01,17:00:00,107,72,35,FMN 11 A Jan Van Rijswijcklaan Ringfietspad
658,Ringfietspad Jan Van Rijswijcklaan,2023-05-01,18:00:00,63,36,27,FMN 11 A Jan Van Rijswijcklaan Ringfietspad
658,Ringfietspad Jan Van Rijswijcklaan,2023-05-01,19:00:00,26,11,15,FMN 11 A Jan Van Rijswijcklaan Ringfietspad
658,Ringfietspad Jan Van Rijswijcklaan,2023-05-01,20:00:00,20,10,10,FMN 11 A Jan Van Rijswijcklaan Ringfietspad
658,Ringfietspad Jan Van Rijswijcklaan,2023-05-01,21:00:00,13,6,7,FMN 11 A Jan Van Rijswijcklaan Ringfietspad
658,Ringfietspad Jan Van Rijswijcklaan,2023-05-01,22:00:00,8,7,1,FMN 11 A Jan Van Rijswijcklaan Ringfietspad
658,Ringfietspad Jan Van Rijswijcklaan,2023-05-01,23:00:00,6,3,3,FMN 11 A Jan Van Rijswijcklaan Ringfietspad
658,Ringfietspad Jan Van Rijswijcklaan,2023-05-02,00:00:00,1,1,0,FMN 11 A Jan Van Rijswijcklaan Ringfietspad
658,Ringfietspad Jan Van Rijswijcklaan,2023-05-02,01:00:00,1,1,0,FMN 11 A Jan Van Rijswijcklaan Ringfietspad
658,Ringfietspad Jan Van Rijswijcklaan,2023-05-02,02:00:00,0,0,0,FMN 11 A Jan Van Rijswijcklaan Ringfietspad
658,Ringfietspad Jan Van Rijswijcklaan,2023-05-02,03:00:00,0,0,0,FMN 11 A Jan Van Rijswijcklaan Ringfietspad
658,Ringfietspad Jan Van Rijswijcklaan,2023-05-02,04:00:00,17,10,7,FMN 11 A Jan Van Rijswijcklaan Ringfietspad
658,Ringfietspad Jan Van Rijswijcklaan,2023-05-02,05:00:00,32,10,22,FMN 11 A Jan Van Rijswijcklaan Ringfietspad
658,Ringfietspad Jan Van Rijswijcklaan,2023-05-02,06:00:00,72,14,58,FMN 11 A Jan Van Rijswijcklaan Ringfietspad
658,Ringfietspad Jan Van Rijswijcklaan,2023-05-02,07:00:00,150,54,96,FMN 11 A Jan Van Rijswijcklaan Ringfietspad
658,Ringfietspad Jan Van Rijswijcklaan,2023-05-02,08:00:00,185,59,126,FMN 11 A Jan Van Rijswijcklaan Ringfietspad
658,Ringfietspad Jan Van Rijswijcklaan,2023-05-02,09:00:00,69,24,45,FMN 11 A Jan Van Rijswijcklaan Ringfietspad
658,Ringfietspad Jan Van Rijswijcklaan,2023-05-02,10:00:00,39,16,23,FMN 11 A Jan Van Rijswijcklaan Ringfietspad
658,Ringfietspad Jan Van Rijswijcklaan,2023-05-02,11:00:00,31,13,18,FMN 11 A Jan Van Rijswijcklaan Ringfietspad
658,Ringfietspad Jan Van Rijswijcklaan,2023-05-02,12:00:00,56,23,33,FMN 11 A Jan Van Rijswijcklaan Ringfietspad
658,Ringfietspad Jan Van Rijswijcklaan,2023-05-02,13:00:00,70,33,37,FMN 11 A Jan Van Rijswijcklaan Ringfietspad
658,Ringfietspad Jan Van Rijswijcklaan,2023-05-02,14:00:00,68,38,30,FMN 11 A Jan Van Rijswijcklaan Ringfietspad
658,Ringfietspad Jan Van Rijswijcklaan,2023-05-02,15:00:00,108,69,39,FMN 11 A Jan Van Rijswijcklaan Ringfietspad
658,Ringfietspad Jan Van Rijswijcklaan,2023-05-02,16:00:00,189,134,55,FMN 11 A Jan Van Rijswijcklaan Ringfietspad
658,Ringfietspad Jan Van Rijswijcklaan,2023-05-02,17:00:00,190,123,67,FMN 11 A Jan Van Rijswijcklaan Ringfietspad
658,Ringfietspad Jan Van Rijswijcklaan,2023-05-02,18:00:00,112,61,51,FMN 11 A Jan Van Rijswijcklaan Ringfietspad
658,Ringfietspad Jan Van Rijswijcklaan,2023-05-02,19:00:00,45,26,19,FMN 11 A Jan Van Rijswijcklaan Ringfietspad
658,Ringfietspad Jan Van Rijswijcklaan,2023-05-02,20:00:00,36,15,21,FMN 11 A Jan Van Rijswijcklaan Ringfietspad
658,Ringfietspad Jan Van Rijswijcklaan,2023-05-02,21:00:00,23,16,7,FMN 11 A Jan Van Rijswijcklaan Ringfietspad
658,Ringfietspad Jan Van Rijswijcklaan,2023-05-02,22:00:00,17,6,11,FMN 11 A Jan Van Rijswijcklaan Ringfietspad
658,Ringfietspad Jan Van Rijswijcklaan,2023-05-02,23:00:00,8,2,6,FMN 11 A Jan Van Rijswijcklaan Ringfietspad
658,Ringfietspad Jan Van Rijswijcklaan,2023-05-03,00:00:00,3,1,2,FMN 11 A Jan Van Rijswijcklaan Ringfietspad
658,Ringfietspad Jan Van Rijswijcklaan,2023-05-03,01:00:00,1,0,1,FMN 11 A Jan Van Rijswijcklaan Ringfietspad
658,Ringfietspad Jan Van Rijswijcklaan,2023-05-03,02:00:00,2,2,0,FMN 11 A Jan Van Rijswijcklaan Ringfietspad
658,Ringfietspad Jan Van Rijswijcklaan,2023-05-03,03:00:00,2,2,0,FMN 11 A Jan Van Rijswijcklaan Ringfietspad
658,Ringfietspad Jan Van Rijswijcklaan,2023-05-03,04:00:00,8,2,6,FMN 11 A Jan Van Rijswijcklaan Ringfietspad
658,Ringfietspad Jan Van Rijswijcklaan,2023-05-03,05:00:00,31,7,24,FMN 11 A Jan Van Rijswijcklaan Ringfietspad
658,Ringfietspad Jan Van Rijswijcklaan,2023-05-03,06:00:00,71,17,54,FMN 11 A Jan Van Rijswijcklaan Ringfietspad
658,Ringfietspad Jan Van Rijswijcklaan,2023-05-03,07:00:00,152,58,94,FMN 11 A Jan Van Rijswijcklaan Ringfietspad
658,Ringfietspad Jan Van Rijswijcklaan,2023-05-03,08:00:00,186,63,123,FMN 11 A Jan Van Rijswijcklaan Ringfietspad
658,Ringfietspad Jan Van Rijswijcklaan,2023-05-03,09:00:00,60,15,45,FMN 11 A Jan Van Rijswijcklaan Ringfietspad
658,Ringfietspad Jan Van Rijswijcklaan,2023-05-03,10:00:00,44,20,24,FMN 11 A Jan Van Rijswijcklaan Ringfietspad
658,Ringfietspad Jan Van Rijswijcklaan,2023-05-03,11:00:00,52,28,24,FMN 11 A Jan Van Rijswijcklaan Ringfietspad
658,Ringfietspad Jan Van Rijswijcklaan,2023-05-03,12:00:00,84,48,36,FMN 11 A Jan Van Rijswijcklaan Ringfietspad
658,Ringfietspad Jan Van Rijswijcklaan,2023-05-03,13:00:00,85,45,40,FMN 11 A Jan Van Rijswijcklaan Ringfietspad
658,Ringfietspad Jan Van Rijswijcklaan,2023-05-03,14:00:00,81,40,41,FMN 11 A Jan Van Rijswijcklaan Ringfietspad
658,Ringfietspad Jan Van Rijswijcklaan,2023-05-03,15:00:00,113,78,35,FMN 11 A Jan Van Rijswijcklaan Ringfietspad
658,Ringfietspad Jan Van Rijswijcklaan,2023-05-03,16:00:00,174,117,57,FMN 11 A Jan Van Rijswijcklaan Ringfietspad
658,Ringfietspad Jan Van Rijswijcklaan,2023-05-03,17:00:00,162,112,50,FMN 11 A Jan Van Rijswijcklaan Ringfietspad
658,Ringfietspad Jan Van Rijswijcklaan,2023-05-03,18:00:00,100,58,42,FMN 11 A Jan Van Rijswijcklaan Ringfietspad
658,Ringfietspad Jan Van Rijswijcklaan,2023-05-03,19:00:00,58,29,29,FMN 11 A Jan Van Rijswijcklaan Ringfietspad
658,Ringfietspad Jan Van Rijswijcklaan,2023-05-03,20:00:00,36,19,17,FMN 11 A Jan Van Rijswijcklaan Ringfietspad
658,Ringfietspad Jan Van Rijswijcklaan,2023-05-03,21:00:00,25,12,13,FMN 11 A Jan Van Rijswijcklaan Ringfietspad
658,Ringfietspad Jan Van Rijswijcklaan,2023-05-03,22:00:00,17,12,5,FMN 11 A Jan Van Rijswijcklaan Ringfietspad
658,Ringfietspad Jan Van Rijswijcklaan,2023-05-03,23:00:00,12,7,5,FMN 11 A Jan Van Rijswijcklaan Ringfietspad
658,Ringfietspad Jan Van Rijswijcklaan,2023-05-04,00:00:00,2,0,2,FMN 11 A Jan Van Rijswijcklaan Ringfietspad
658,Ringfietspad Jan Van Rijswijcklaan,2023-05-04,01:00:00,0,0,0,FMN 11 A Jan Van Rijswijcklaan Ringfietspad
658,Ringfietspad Jan Van Rijswijcklaan,2023-05-04,02:00:00,0,0,0,FMN 11 A Jan Van Rijswijcklaan Ringfietspad
658,Ringfietspad Jan Van Rijswijcklaan,2023-05-04,03:00:00,5,5,0,FMN 11 A Jan Van Rijswijcklaan Ringfietspad
658,Ringfietspad Jan Van Rijswijcklaan,2023-05-04,04:00:00,8,4,4,FMN 11 A Jan Van Rijswijcklaan Ringfietspad
658,Ringfietspad Jan Van Rijswijcklaan,2023-05-04,05:00:00,35,10,25,FMN 11 A Jan Van Rijswijcklaan Ringfietspad
658,Ringfietspad Jan Van Rijswijcklaan,2023-05-04,06:00:00,88,25,63,FMN 11 A Jan Van Rijswijcklaan Ringfietspad
658,Ringfietspad Jan Van Rijswijcklaan,2023-05-04,07:00:00,162,62,100,FMN 11 A Jan Van Rijswijcklaan Ringfietspad
658,Ringfietspad Jan Van Rijswijcklaan,2023-05-04,08:00:00,209,68,141,FMN 11 A Jan Van Rijswijcklaan Ringfietspad
658,Ringfietspad Jan Van Rijswijcklaan,2023-05-04,09:00:00,86,30,56,FMN 11 A Jan Van Rijswijcklaan Ringfietspad
658,Ringfietspad Jan Van Rijswijcklaan,2023-05-04,10:00:00,54,23,31,FMN 11 A Jan Van Rijswijcklaan Ringfietspad
658,Ringfietspad Jan Van Rijswijcklaan,2023-05-04,11:00:00,51,32,19,FMN 11 A Jan Van Rijswijcklaan Ringfietspad
658,Ringfietspad Jan Van Rijswijcklaan,2023-05-04,12:00:00,75,41,34,FMN 11 A Jan Van Rijswijcklaan Ringfietspad
658,Ringfietspad Jan Van Rijswijcklaan,2023-05-04,13:00:00,83,41,42,FMN 11 A Jan Van Rijswijcklaan Ringfietspad
658,Ringfietspad Jan Van Rijswijcklaan,2023-05-04,14:00:00,98,56,42,FMN 11 A Jan Van Rijswijcklaan Ringfietspad
658,Ringfietspad Jan Van Rijswijcklaan,2023-05-04,15:00:00,128,83,45,FMN 11 A Jan Van Rijswijcklaan Ringfietspad
658,Ringfietspad Jan Van Rijswijcklaan,2023-05-04,16:00:00,200,143,57,FMN 11 A Jan Van Rijswijcklaan Ringfietspad
658,Ringfietspad Jan Van Rijswijcklaan,2023-05-04,17:00:00,198,129,69,FMN 11 A Jan Van Rijswijcklaan Ringfietspad
658,Ringfietspad Jan Van Rijswijcklaan,2023-05-04,18:00:00,116,68,48,FMN 11 A Jan Van Rijswijcklaan Ringfietspad
658,Ringfietspad Jan Van Rijswijcklaan,2023-05-04,19:00:00,69,41,28,FMN 11 A Jan Van Rijswijcklaan Ringfietspad
658,Ringfietspad Jan Van Rijswijcklaan,2023-05-04,20:00:00,49,29,20,FMN 11 A Jan Van Rijswijcklaan Ringfietspad
658,Ringfietspad Jan Van Rijswijcklaan,2023-05-04,21:00:00,36,16,20,FMN 11 A Jan Van Rijswijcklaan Ringfietspad
658,Ringfietspad Jan Van Rijswijcklaan,2023-05-04,22:00:00,36,25,11,FMN 11 A Jan Van Rijswijcklaan Ringfietspad
658,Ringfietspad Jan Van Rijswijcklaan,2023-05-04,23:00:00,12,6,6,FMN 11 A Jan Van Rijswijcklaan Ringfietspad
658,Ringfietspad Jan Van Rijswijcklaan,2023-05-05,00:00:00,9,4,5,FMN 11 A Jan Van Rijswijcklaan Ringfietspad
658,Ringfietspad Jan Van Rijswijcklaan,2023-05-05,01:00:00,2,2,0,FMN 11 A Jan Van Rijswijcklaan Ringfietspad
658,Ringfietspad Jan Van Rijswijcklaan,2023-05-05,02:00:00,2,1,1,FMN 11 A Jan Van Rijswijcklaan Ringfietspad
658,Ringfietspad Jan Van Rijswijcklaan,2023-05-05,03:00:00,3,2,1,FMN 11 A Jan Van Rijswijcklaan Ringfietspad
658,Ringfietspad Jan Van Rijswijcklaan,2023-05-05,04:00:00,6,1,5,FMN 11 A Jan Van Rijswijcklaan Ringfietspad
658,Ringfietspad Jan Van Rijswijcklaan,2023-05-05,05:00:00,27,11,16,FMN 11 A Jan Van Rijswijcklaan Ringfietspad
658,Ringfietspad Jan Van Rijswijcklaan,2023-05-05,06:00:00,58,19,39,FMN 11 A Jan Van Rijswijcklaan Ringfietspad
658,Ringfietspad Jan Van Rijswijcklaan,2023-05-05,07:00:00,103,38,65,FMN 11 A Jan Van Rijswijcklaan Ringfietspad
658,Ringfietspad Jan Van Rijswijcklaan,2023-05-05,08:00:00,164,51,113,FMN 11 A Jan Van Rijswijcklaan Ringfietspad
658,Ringfietspad Jan Van Rijswijcklaan,2023-05-05,09:00:00,70,27,43,FMN 11 A Jan Van Rijswijcklaan Ringfietspad
658,Ringfietspad Jan Van Rijswijcklaan,2023-05-05,10:00:00,42,20,22,FMN 11 A Jan Van Rijswijcklaan Ringfietspad
658,Ringfietspad Jan Van Rijswijcklaan,2023-05-05,11:00:00,48,17,31,FMN 11 A Jan Van Rijswijcklaan Ringfietspad
658,Ringfietspad Jan Van Rijswijcklaan,2023-05-05,12:00:00,64,36,28,FMN 11 A Jan Van Rijswijcklaan Ringfietspad
658,Ringfietspad Jan Van Rijswijcklaan,2023-05-05,13:00:00,68,38,30,FMN 11 A Jan Van Rijswijcklaan Ringfietspad
658,Ringfietspad Jan Van Rijswijcklaan,2023-05-05,14:00:00,78,46,32,FMN 11 A Jan Van Rijswijcklaan Ringfietspad
658,Ringfietspad Jan Van Rijswijcklaan,2023-05-05,15:00:00,116,78,38,FMN 11 A Jan Van Rijswijcklaan Ringfietspad
658,Ringfietspad Jan Van Rijswijcklaan,2023-05-05,16:00:00,144,94,50,FMN 11 A Jan Van Rijswijcklaan Ringfietspad
658,Ringfietspad Jan Van Rijswijcklaan,2023-05-05,17:00:00,117,84,33,FMN 11 A Jan Van Rijswijcklaan Ringfietspad
658,Ringfietspad Jan Van Rijswijcklaan,2023-05-05,18:00:00,72,46,26,FMN 11 A Jan Van Rijswijcklaan Ringfietspad
658,Ringfietspad Jan Van Rijswijcklaan,2023-05-05,19:00:00,41,22,19,FMN 11 A Jan Van Rijswijcklaan Ringfietspad
658,Ringfietspad Jan Van Rijswijcklaan,2023-05-05,20:00:00,33,12,21,FMN 11 A Jan Van Rijswijcklaan Ringfietspad
658,Ringfietspad Jan Van Rijswijcklaan,2023-05-05,21:00:00,26,20,6,FMN 11 A Jan Van Rijswijcklaan Ringfietspad
658,Ringfietspad Jan Van Rijswijcklaan,2023-05-05,22:00:00,21,14,7,FMN 11 A Jan Van Rijswijcklaan Ringfietspad
658,Ringfietspad Jan Van Rijswijcklaan,2023-05-05,23:00:00,9,4,5,FMN 11 A Jan Van Rijswijcklaan Ringfietspad
658,Ringfietspad Jan Van Rijswijcklaan,2023-05-06,00:00:00,8,6,2,FMN 11 A Jan Van Rijswijcklaan Ringfietspad
658,Ringfietspad Jan Van Rijswijcklaan,2023-05-06,01:00:00,1,0,1,FMN 11 A Jan Van Rijswijcklaan Ringfietspad
658,Ringfietspad Jan Van Rijswijcklaan,2023-05-06,02:00:00,4,3,1,FMN 11 A Jan Van Rijswijcklaan Ringfietspad
658,Ringfietspad Jan Van Rijswijcklaan,2023-05-06,03:00:00,5,4,1,FMN 11 A Jan Van Rijswijcklaan Ringfietspad
658,Ringfietspad Jan Van Rijswijcklaan,2023-05-06,04:00:00,3,0,3,FMN 11 A Jan Van Rijswijcklaan Ringfietspad
658,Ringfietspad Jan Van Rijswijcklaan,2023-05-06,05:00:00,9,2,7,FMN 11 A Jan Van Rijswijcklaan Ringfietspad
658,Ringfietspad Jan Van Rijswijcklaan,2023-05-06,06:00:00,19,10,9,FMN 11 A Jan Van Rijswijcklaan Ringfietspad
658,Ringfietspad Jan Van Rijswijcklaan,2023-05-06,07:00:00,19,11,8,FMN 11 A Jan Van Rijswijcklaan Ringfietspad
658,Ringfietspad Jan Van Rijswijcklaan,2023-05-06,08:00:00,26,10,16,FMN 11 A Jan Van Rijswijcklaan Ringfietspad
658,Ringfietspad Jan Van Rijswijcklaan,2023-05-06,09:00:00,51,21,30,FMN 11 A Jan Van Rijswijcklaan Ringfietspad
658,Ringfietspad Jan Van Rijswijcklaan,2023-05-06,10:00:00,51,19,32,FMN 11 A Jan Van Rijswijcklaan Ringfietspad
658,Ringfietspad Jan Van Rijswijcklaan,2023-05-06,11:00:00,62,26,36,FMN 11 A Jan Van Rijswijcklaan Ringfietspad
658,Ringfietspad Jan Van Rijswijcklaan,2023-05-06,12:00:00,61,26,35,FMN 11 A Jan Van Rijswijcklaan Ringfietspad
658,Ringfietspad Jan Van Rijswijcklaan,2023-05-06,13:00:00,72,38,34,FMN 11 A Jan Van Rijswijcklaan Ringfietspad
658,Ringfietspad Jan Van Rijswijcklaan,2023-05-06,14:00:00,100,53,47,FMN 11 A Jan Van Rijswijcklaan Ringfietspad
658,Ringfietspad Jan Van Rijswijcklaan,2023-05-06,15:00:00,96,52,44,FMN 11 A Jan Van Rijswijcklaan Ringfietspad
658,Ringfietspad Jan Van Rijswijcklaan,2023-05-06,16:00:00,88,53,35,FMN 11 A Jan Van Rijswijcklaan Ringfietspad
658,Ringfietspad Jan Van Rijswijcklaan,2023-05-06,17:00:00,65,38,27,FMN 11 A Jan Van Rijswijcklaan Ringfietspad
658,Ringfietspad Jan Van Rijswijcklaan,2023-05-06,18:00:00,49,27,22,FMN 11 A Jan Van Rijswijcklaan Ringfietspad
658,Ringfietspad Jan Van Rijswijcklaan,2023-05-06,19:00:00,43,21,22,FMN 11 A Jan Van Rijswijcklaan Ringfietspad
658,Ringfietspad Jan Van Rijswijcklaan,2023-05-06,20:00:00,32,18,14,FMN 11 A Jan Van Rijswijcklaan Ringfietspad
658,Ringfietspad Jan Van Rijswijcklaan,2023-05-06,21:00:00,21,13,8,FMN 11 A Jan Van Rijswijcklaan Ringfietspad
658,Ringfietspad Jan Van Rijswijcklaan,2023-05-06,22:00:00,14,7,7,FMN 11 A Jan Van Rijswijcklaan Ringfietspad
658,Ringfietspad Jan Van Rijswijcklaan,2023-05-06,23:00:00,9,3,6,FMN 11 A Jan Van Rijswijcklaan Ringfietspad
658,Ringfietspad Jan Van Rijswijcklaan,2023-05-07,00:00:00,2,1,1,FMN 11 A Jan Van Rijswijcklaan Ringfietspad
658,Ringfietspad Jan Van Rijswijcklaan,2023-05-07,01:00:00,2,2,0,FMN 11 A Jan Van Rijswijcklaan Ringfietspad
658,Ringfietspad Jan Van Rijswijcklaan,2023-05-07,02:00:00,1,1,0,FMN 11 A Jan Van Rijswijcklaan Ringfietspad
658,Ringfietspad Jan Van Rijswijcklaan,2023-05-07,03:00:00,3,2,1,FMN 11 A Jan Van Rijswijcklaan Ringfietspad
658,Ringfietspad Jan Van Rijswijcklaan,2023-05-07,04:00:00,1,1,0,FMN 11 A Jan Van Rijswijcklaan Ringfietspad
658,Ringfietspad Jan Van Rijswijcklaan,2023-05-07,05:00:00,4,2,2,FMN 11 A Jan Van Rijswijcklaan Ringfietspad
658,Ringfietspad Jan Van Rijswijcklaan,2023-05-07,06:00:00,8,3,5,FMN 11 A Jan Van Rijswijcklaan Ringfietspad
658,Ringfietspad Jan Van Rijswijcklaan,2023-05-07,07:00:00,2,2,0,FMN 11 A Jan Van Rijswijcklaan Ringfietspad
658,Ringfietspad Jan Van Rijswijcklaan,2023-05-07,08:00:00,16,8,8,FMN 11 A Jan Van Rijswijcklaan Ringfietspad
658,Ringfietspad Jan Van Rijswijcklaan,2023-05-07,09:00:00,36,11,25,FMN 11 A Jan Van Rijswijcklaan Ringfietspad
658,Ringfietspad Jan Van Rijswijcklaan,2023-05-07,10:00:00,25,10,15,FMN 11 A Jan Van Rijswijcklaan Ringfietspad
658,Ringfietspad Jan Van Rijswijcklaan,2023-05-07,11:00:00,46,23,23,FMN 11 A Jan Van Rijswijcklaan Ringfietspad
658,Ringfietspad Jan Van Rijswijcklaan,2023-05-07,12:00:00,44,25,19,FMN 11 A Jan Van Rijswijcklaan Ringfietspad
658,Ringfietspad Jan Van Rijswijcklaan,2023-05-07,13:00:00,48,28,20,FMN 11 A Jan Van Rijswijcklaan Ringfietspad
658,Ringfietspad Jan Van Rijswijcklaan,2023-05-07,14:00:00,52,27,25,FMN 11 A Jan Van Rijswijcklaan Ringfietspad
658,Ringfietspad Jan Van Rijswijcklaan,2023-05-07,15:00:00,42,21,21,FMN 11 A Jan Van Rijswijcklaan Ringfietspad
658,Ringfietspad Jan Van Rijswijcklaan,2023-05-07,16:00:00,37,19,18,FMN 11 A Jan Van Rijswijcklaan Ringfietspad
658,Ringfietspad Jan Van Rijswijcklaan,2023-05-07,17:00:00,40,26,14,FMN 11 A Jan Van Rijswijcklaan Ringfietspad
658,Ringfietspad Jan Van Rijswijcklaan,2023-05-07,18:00:00,16,8,8,FMN 11 A Jan Van Rijswijcklaan Ringfietspad
658,Ringfietspad Jan Van Rijswijcklaan,2023-05-07,19:00:00,20,12,8,FMN 11 A Jan Van Rijswijcklaan Ringfietspad
658,Ringfietspad Jan Van Rijswijcklaan,2023-05-07,20:00:00,12,7,5,FMN 11 A Jan Van Rijswijcklaan Ringfietspad
658,Ringfietspad Jan Van Rijswijcklaan,2023-05-07,21:00:00,9,6,3,FMN 11 A Jan Van Rijswijcklaan Ringfietspad
658,Ringfietspad Jan Van Rijswijcklaan,2023-05-07,22:00:00,4,1,3,FMN 11 A Jan Van Rijswijcklaan Ringfietspad
658,Ringfietspad Jan Van Rijswijcklaan,2023-05-07,23:00:00,0,0,0,FMN 11 A Jan Van Rijswijcklaan Ringfietspad
658,Ringfietspad Jan Van Rijswijcklaan,2023-05-08,00:00:00,4,2,2,FMN 11 A Jan Van Rijswijcklaan Ringfietspad
658,Ringfietspad Jan Van Rijswijcklaan,2023-05-08,01:00:00,0,0,0,FMN 11 A Jan Van Rijswijcklaan Ringfietspad
658,Ringfietspad Jan Van Rijswijcklaan,2023-05-08,02:00:00,0,0,0,FMN 11 A Jan Van Rijswijcklaan Ringfietspad
658,Ringfietspad Jan Van Rijswijcklaan,2023-05-08,03:00:00,1,1,0,FMN 11 A Jan Van Rijswijcklaan Ringfietspad
658,Ringfietspad Jan Van Rijswijcklaan,2023-05-08,04:00:00,15,4,11,FMN 11 A Jan Van Rijswijcklaan Ringfietspad
658,Ringfietspad Jan Van Rijswijcklaan,2023-05-08,05:00:00,25,7,18,FMN 11 A Jan Van Rijswijcklaan Ringfietspad
658,Ringfietspad Jan Van Rijswijcklaan,2023-05-08,06:00:00,62,18,44,FMN 11 A Jan Van Rijswijcklaan Ringfietspad
658,Ringfietspad Jan Van Rijswijcklaan,2023-05-08,07:00:00,131,49,82,FMN 11 A Jan Van Rijswijcklaan Ringfietspad
658,Ringfietspad Jan Van Rijswijcklaan,2023-05-08,08:00:00,194,68,126,FMN 11 A Jan Van Rijswijcklaan Ringfietspad
658,Ringfietspad Jan Van Rijswijcklaan,2023-05-08,09:00:00,67,25,42,FMN 11 A Jan Van Rijswijcklaan Ringfietspad
658,Ringfietspad Jan Van Rijswijcklaan,2023-05-08,10:00:00,46,14,32,FMN 11 A Jan Van Rijswijcklaan Ringfietspad
658,Ringfietspad Jan Van Rijswijcklaan,2023-05-08,11:00:00,46,27,19,FMN 11 A Jan Van Rijswijcklaan Ringfietspad
658,Ringfietspad Jan Van Rijswijcklaan,2023-05-08,12:00:00,58,25,33,FMN 11 A Jan Van Rijswijcklaan Ringfietspad
658,Ringfietspad Jan Van Rijswijcklaan,2023-05-08,13:00:00,67,34,33,FMN 11 A Jan Van Rijswijcklaan Ringfietspad
658,Ringfietspad Jan Van Rijswijcklaan,2023-05-08,14:00:00,74,41,33,FMN 11 A Jan Van Rijswijcklaan Ringfietspad
658,Ringfietspad Jan Van Rijswijcklaan,2023-05-08,15:00:00,103,68,35,FMN 11 A Jan Van Rijswijcklaan Ringfietspad
658,Ringfietspad Jan Van Rijswijcklaan,2023-05-08,16:00:00,158,108,50,FMN 11 A Jan Van Rijswijcklaan Ringfietspad
658,Ringfietspad Jan Van Rijswijcklaan,2023-05-08,17:00:00,167,105,62,FMN 11 A Jan Van Rijswijcklaan Ringfietspad
658,Ringfietspad Jan Van Rijswijcklaan,2023-05-08,18:00:00,96,59,37,FMN 11 A Jan Van Rijswijcklaan Ringfietspad
658,Ringfietspad Jan Van Rijswijcklaan,2023-05-08,19:00:00,44,26,18,FMN 11 A Jan Van Rijswijcklaan Ringfietspad
658,Ringfietspad Jan Van Rijswijcklaan,2023-05-08,20:00:00,34,15,19,FMN 11 A Jan Van Rijswijcklaan Ringfietspad
658,Ringfietspad Jan Van Rijswijcklaan,2023-05-08,21:00:00,16,8,8,FMN 11 A Jan Van Rijswijcklaan Ringfietspad
658,Ringfietspad Jan Van Rijswijcklaan,2023-05-08,22:00:00,15,12,3,FMN 11 A Jan Van Rijswijcklaan Ringfietspad
658,Ringfietspad Jan Van Rijswijcklaan,2023-05-08,23:00:00,5,2,3,FMN 11 A Jan Van Rijswijcklaan Ringfietspad
658,Ringfietspad Jan Van Rijswijcklaan,2023-05-09,00:00:00,3,1,2,FMN 11 A Jan Van Rijswijcklaan Ringfietspad
658,Ringfietspad Jan Van Rijswijcklaan,2023-05-09,01:00:00,3,1,2,FMN 11 A Jan Van Rijswijcklaan Ringfietspad
658,Ringfietspad Jan Van Rijswijcklaan,2023-05-09,02:00:00,0,0,0,FMN 11 A Jan Van Rijswijcklaan Ringfietspad
658,Ringfietspad Jan Van Rijswijcklaan,2023-05-09,03:00:00,2,2,0,FMN 11 A Jan Van Rijswijcklaan Ringfietspad
658,Ringfietspad Jan Van Rijswijcklaan,2023-05-09,04:00:00,6,0,6,FMN 11 A Jan Van Rijswijcklaan Ringfietspad
658,Ringfietspad Jan Van Rijswijcklaan,2023-05-09,05:00:00,22,7,15,FMN 11 A Jan Van Rijswijcklaan Ringfietspad
658,Ringfietspad Jan Van Rijswijcklaan,2023-05-09,06:00:00,50,14,36,FMN 11 A Jan Van Rijswijcklaan Ringfietspad
658,Ringfietspad Jan Van Rijswijcklaan,2023-05-09,07:00:00,106,38,68,FMN 11 A Jan Van Rijswijcklaan Ringfietspad
658,Ringfietspad Jan Van Rijswijcklaan,2023-05-09,08:00:00,133,45,88,FMN 11 A Jan Van Rijswijcklaan Ringfietspad
658,Ringfietspad Jan Van Rijswijcklaan,2023-05-09,09:00:00,44,20,24,FMN 11 A Jan Van Rijswijcklaan Ringfietspad
658,Ringfietspad Jan Van Rijswijcklaan,2023-05-09,10:00:00,34,17,17,FMN 11 A Jan Van Rijswijcklaan Ringfietspad
658,Ringfietspad Jan Van Rijswijcklaan,2023-05-09,11:00:00,32,16,16,FMN 11 A Jan Van Rijswijcklaan Ringfietspad
658,Ringfietspad Jan Van Rijswijcklaan,2023-05-09,12:00:00,42,21,21,FMN 11 A Jan Van Rijswijcklaan Ringfietspad
658,Ringfietspad Jan Van Rijswijcklaan,2023-05-09,13:00:00,47,19,28,FMN 11 A Jan Van Rijswijcklaan Ringfietspad
658,Ringfietspad Jan Van Rijswijcklaan,2023-05-09,14:00:00,40,23,17,FMN 11 A Jan Van Rijswijcklaan Ringfietspad
658,Ringfietspad Jan Van Rijswijcklaan,2023-05-09,15:00:00,69,47,22,FMN 11 A Jan Van Rijswijcklaan Ringfietspad
658,Ringfietspad Jan Van Rijswijcklaan,2023-05-09,16:00:00,115,84,31,FMN 11 A Jan Van Rijswijcklaan Ringfietspad
658,Ringfietspad Jan Van Rijswijcklaan,2023-05-09,17:00:00,126,78,48,FMN 11 A Jan Van Rijswijcklaan Ringfietspad
658,Ringfietspad Jan Van Rijswijcklaan,2023-05-09,18:00:00,76,49,27,FMN 11 A Jan Van Rijswijcklaan Ringfietspad
658,Ringfietspad Jan Van Rijswijcklaan,2023-05-09,19:00:00,36,20,16,FMN 11 A Jan Van Rijswijcklaan Ringfietspad
658,Ringfietspad Jan Van Rijswijcklaan,2023-05-09,20:00:00,22,9,13,FMN 11 A Jan Van Rijswijcklaan Ringfietspad
658,Ringfietspad Jan Van Rijswijcklaan,2023-05-09,21:00:00,17,8,9,FMN 11 A Jan Van Rijswijcklaan Ringfietspad
658,Ringfietspad Jan Van Rijswijcklaan,2023-05-09,22:00:00,15,8,7,FMN 11 A Jan Van Rijswijcklaan Ringfietspad
658,Ringfietspad Jan Van Rijswijcklaan,2023-05-09,23:00:00,9,3,6,FMN 11 A Jan Van Rijswijcklaan Ringfietspad
658,Ringfietspad Jan Van Rijswijcklaan,2023-05-10,00:00:00,3,2,1,FMN 11 A Jan Van Rijswijcklaan Ringfietspad
658,Ringfietspad Jan Van Rijswijcklaan,2023-05-10,01:00:00,5,3,2,FMN 11 A Jan Van Rijswijcklaan Ringfietspad
658,Ringfietspad Jan Van Rijswijcklaan,2023-05-10,02:00:00,0,0,0,FMN 11 A Jan Van Rijswijcklaan Ringfietspad
658,Ringfietspad Jan Van Rijswijcklaan,2023-05-10,03:00:00,3,2,1,FMN 11 A Jan Van Rijswijcklaan Ringfietspad
658,Ringfietspad Jan Van Rijswijcklaan,2023-05-10,04:00:00,6,1,5,FMN 11 A Jan Van Rijswijcklaan Ringfietspad
658,Ringfietspad Jan Van Rijswijcklaan,2023-05-10,05:00:00,14,6,8,FMN 11 A Jan Van Rijswijcklaan Ringfietspad
658,Ringfietspad Jan Van Rijswijcklaan,2023-05-10,06:00:00,56,12,44,FMN 11 A Jan Van Rijswijcklaan Ringfietspad
658,Ringfietspad Jan Van Rijswijcklaan,2023-05-10,07:00:00,111,41,70,FMN 11 A Jan Van Rijswijcklaan Ringfietspad
658,Ringfietspad Jan Van Rijswijcklaan,2023-05-10,08:00:00,132,46,86,FMN 11 A Jan Van Rijswijcklaan Ringfietspad
658,Ringfietspad Jan Van Rijswijcklaan,2023-05-10,09:00:00,48,17,31,FMN 11 A Jan Van Rijswijcklaan Ringfietspad
658,Ringfietspad Jan Van Rijswijcklaan,2023-05-10,10:00:00,41,18,23,FMN 11 A Jan Van Rijswijcklaan Ringfietspad
658,Ringfietspad Jan Van Rijswijcklaan,2023-05-10,11:00:00,32,16,16,FMN 11 A Jan Van Rijswijcklaan Ringfietspad
658,Ringfietspad Jan Van Rijswijcklaan,2023-05-10,12:00:00,47,22,25,FMN 11 A Jan Van Rijswijcklaan Ringfietspad
658,Ringfietspad Jan Van Rijswijcklaan,2023-05-10,13:00:00,62,30,32,FMN 11 A Jan Van Rijswijcklaan Ringfietspad
658,Ringfietspad Jan Van Rijswijcklaan,2023-05-10,14:00:00,66,42,24,FMN 11 A Jan Van Rijswijcklaan Ringfietspad
658,Ringfietspad Jan Van Rijswijcklaan,2023-05-10,15:00:00,76,47,29,FMN 11 A Jan Van Rijswijcklaan Ringfietspad
658,Ringfietspad Jan Van Rijswijcklaan,2023-05-10,16:00:00,113,87,26,FMN 11 A Jan Van Rijswijcklaan Ringfietspad
658,Ringfietspad Jan Van Rijswijcklaan,2023-05-10,17:00:00,129,80,49,FMN 11 A Jan Van Rijswijcklaan Ringfietspad
658,Ringfietspad Jan Van Rijswijcklaan,2023-05-10,18:00:00,82,51,31,FMN 11 A Jan Van Rijswijcklaan Ringfietspad
658,Ringfietspad Jan Van Rijswijcklaan,2023-05-10,19:00:00,49,29,20,FMN 11 A Jan Van Rijswijcklaan Ringfietspad
658,Ringfietspad Jan Van Rijswijcklaan,2023-05-10,20:00:00,37,18,19,FMN 11 A Jan Van Rijswijcklaan Ringfietspad
658,Ringfietspad Jan Van Rijswijcklaan,2023-05-10,21:00:00,23,13,10,FMN 11 A Jan Van Rijswijcklaan Ringfietspad
658,Ringfietspad Jan Van Rijswijcklaan,2023-05-10,22:00:00,14,8,6,FMN 11 A Jan Van Rijswijcklaan Ringfietspad
658,Ringfietspad Jan Van Rijswijcklaan,2023-05-10,23:00:00,6,5,1,FMN 11 A Jan Van Rijswijcklaan Ringfietspad
658,Ringfietspad Jan Van Rijswijcklaan,2023-05-11,00:00:00,2,2,0,FMN 11 A Jan Van Rijswijcklaan Ringfietspad
658,Ringfietspad Jan Van Rijswijcklaan,2023-05-11,01:00:00,3,1,2,FMN 11 A Jan Van Rijswijcklaan Ringfietspad
658,Ringfietspad Jan Van Rijswijcklaan,2023-05-11,02:00:00,0,0,0,FMN 11 A Jan Van Rijswijcklaan Ringfietspad
658,Ringfietspad Jan Van Rijswijcklaan,2023-05-11,03:00:00,1,1,0,FMN 11 A Jan Van Rijswijcklaan Ringfietspad
658,Ringfietspad Jan Van Rijswijcklaan,2023-05-11,04:00:00,7,2,5,FMN 11 A Jan Van Rijswijcklaan Ringfietspad
658,Ringfietspad Jan Van Rijswijcklaan,2023-05-11,05:00:00,37,8,29,FMN 11 A Jan Van Rijswijcklaan Ringfietspad
658,Ringfietspad Jan Van Rijswijcklaan,2023-05-11,06:00:00,71,14,57,FMN 11 A Jan Van Rijswijcklaan Ringfietspad
658,Ringfietspad Jan Van Rijswijcklaan,2023-05-11,07:00:00,121,41,80,FMN 11 A Jan Van Rijswijcklaan Ringfietspad
658,Ringfietspad Jan Van Rijswijcklaan,2023-05-11,08:00:00,162,54,108,FMN 11 A Jan Van Rijswijcklaan Ringfietspad
658,Ringfietspad Jan Van Rijswijcklaan,2023-05-11,09:00:00,72,28,44,FMN 11 A Jan Van Rijswijcklaan Ringfietspad
658,Ringfietspad Jan Van Rijswijcklaan,2023-05-11,10:00:00,48,21,27,FMN 11 A Jan Van Rijswijcklaan Ringfietspad
658,Ringfietspad Jan Van Rijswijcklaan,2023-05-11,11:00:00,39,20,19,FMN 11 A Jan Van Rijswijcklaan Ringfietspad
658,Ringfietspad Jan Van Rijswijcklaan,2023-05-11,12:00:00,70,33,37,FMN 11 A Jan Van Rijswijcklaan Ringfietspad
658,Ringfietspad Jan Van Rijswijcklaan,2023-05-11,13:00:00,60,31,29,FMN 11 A Jan Van Rijswijcklaan Ringfietspad
658,Ringfietspad Jan Van Rijswijcklaan,2023-05-11,14:00:00,69,41,28,FMN 11 A Jan Van Rijswijcklaan Ringfietspad
658,Ringfietspad Jan Van Rijswijcklaan,2023-05-11,15:00:00,94,64,30,FMN 11 A Jan Van Rijswijcklaan Ringfietspad
658,Ringfietspad Jan Van Rijswijcklaan,2023-05-11,16:00:00,146,96,50,FMN 11 A Jan Van Rijswijcklaan Ringfietspad
658,Ringfietspad Jan Van Rijswijcklaan,2023-05-11,17:00:00,144,97,47,FMN 11 A Jan Van Rijswijcklaan Ringfietspad
658,Ringfietspad Jan Van Rijswijcklaan,2023-05-11,18:00:00,95,49,46,FMN 11 A Jan Van Rijswijcklaan Ringfietspad
658,Ringfietspad Jan Van Rijswijcklaan,2023-05-11,19:00:00,54,30,24,FMN 11 A Jan Van Rijswijcklaan Ringfietspad
658,Ringfietspad Jan Van Rijswijcklaan,2023-05-11,20:00:00,32,15,17,FMN 11 A Jan Van Rijswijcklaan Ringfietspad
658,Ringfietspad Jan Van Rijswijcklaan,2023-05-11,21:00:00,21,7,14,FMN 11 A Jan Van Rijswijcklaan Ringfietspad
658,Ringfietspad Jan Van Rijswijcklaan,2023-05-11,22:00:00,20,11,9,FMN 11 A Jan Van Rijswijcklaan Ringfietspad
658,Ringfietspad Jan Van Rijswijcklaan,2023-05-11,23:00:00,10,8,2,FMN 11 A Jan Van Rijswijcklaan Ringfietspad
658,Ringfietspad Jan Van Rijswijcklaan,2023-05-12,00:00:00,3,2,1,FMN 11 A Jan Van Rijswijcklaan Ringfietspad
658,Ringfietspad Jan Van Rijswijcklaan,2023-05-12,01:00:00,4,2,2,FMN 11 A Jan Van Rijswijcklaan Ringfietspad
658,Ringfietspad Jan Van Rijswijcklaan,2023-05-12,02:00:00,2,0,2,FMN 11 A Jan Van Rijswijcklaan Ringfietspad
658,Ringfietspad Jan Van Rijswijcklaan,2023-05-12,03:00:00,3,2,1,FMN 11 A Jan Van Rijswijcklaan Ringfietspad
658,Ringfietspad Jan Van Rijswijcklaan,2023-05-12,04:00:00,3,2,1,FMN 11 A Jan Van Rijswijcklaan Ringfietspad
658,Ringfietspad Jan Van Rijswijcklaan,2023-05-12,05:00:00,22,5,17,FMN 11 A Jan Van Rijswijcklaan Ringfietspad
658,Ringfietspad Jan Van Rijswijcklaan,2023-05-12,06:00:00,52,14,38,FMN 11 A Jan Van Rijswijcklaan Ringfietspad
658,Ringfietspad Jan Van Rijswijcklaan,2023-05-12,07:00:00,92,31,61,FMN 11 A Jan Van Rijswijcklaan Ringfietspad
658,Ringfietspad Jan Van Rijswijcklaan,2023-05-12,08:00:00,123,35,88,FMN 11 A Jan Van Rijswijcklaan Ringfietspad
658,Ringfietspad Jan Van Rijswijcklaan,2023-05-12,09:00:00,60,22,38,FMN 11 A Jan Van Rijswijcklaan Ringfietspad
658,Ringfietspad Jan Van Rijswijcklaan,2023-05-12,10:00:00,52,22,30,FMN 11 A Jan Van Rijswijcklaan Ringfietspad
658,Ringfietspad Jan Van Rijswijcklaan,2023-05-12,11:00:00,34,17,17,FMN 11 A Jan Van Rijswijcklaan Ringfietspad
658,Ringfietspad Jan Van Rijswijcklaan,2023-05-12,12:00:00,40,23,17,FMN 11 A Jan Van Rijswijcklaan Ringfietspad
658,Ringfietspad Jan Van Rijswijcklaan,2023-05-12,13:00:00,53,30,23,FMN 11 A Jan Van Rijswijcklaan Ringfietspad
658,Ringfietspad Jan Van Rijswijcklaan,2023-05-12,14:00:00,57,31,26,FMN 11 A Jan Van Rijswijcklaan Ringfietspad
658,Ringfietspad Jan Van Rijswijcklaan,2023-05-12,15:00:00,88,59,29,FMN 11 A Jan Van Rijswijcklaan Ringfietspad
658,Ringfietspad Jan Van Rijswijcklaan,2023-05-12,16:00:00,122,76,46,FMN 11 A Jan Van Rijswijcklaan Ringfietspad
658,Ringfietspad Jan Van Rijswijcklaan,2023-05-12,17:00:00,94,58,36,FMN 11 A Jan Van Rijswijcklaan Ringfietspad
658,Ringfietspad Jan Van Rijswijcklaan,2023-05-12,18:00:00,55,37,18,FMN 11 A Jan Van Rijswijcklaan Ringfietspad
658,Ringfietspad Jan Van Rijswijcklaan,2023-05-12,19:00:00,40,25,15,FMN 11 A Jan Van Rijswijcklaan Ringfietspad
658,Ringfietspad Jan Van Rijswijcklaan,2023-05-12,20:00:00,19,12,7,FMN 11 A Jan Van Rijswijcklaan Ringfietspad
658,Ringfietspad Jan Van Rijswijcklaan,2023-05-12,21:00:00,18,9,9,FMN 11 A Jan Van Rijswijcklaan Ringfietspad
658,Ringfietspad Jan Van Rijswijcklaan,2023-05-12,22:00:00,19,13,6,FMN 11 A Jan Van Rijswijcklaan Ringfietspad
658,Ringfietspad Jan Van Rijswijcklaan,2023-05-12,23:00:00,6,1,5,FMN 11 A Jan Van Rijswijcklaan Ringfietspad
658,Ringfietspad Jan Van Rijswijcklaan,2023-05-13,00:00:00,10,4,6,FMN 11 A Jan Van Rijswijcklaan Ringfietspad
658,Ringfietspad Jan Van Rijswijcklaan,2023-05-13,01:00:00,6,2,4,FMN 11 A Jan Van Rijswijcklaan Ringfietspad
658,Ringfietspad Jan Van Rijswijcklaan,2023-05-13,02:00:00,5,3,2,FMN 11 A Jan Van Rijswijcklaan Ringfietspad
658,Ringfietspad Jan Van Rijswijcklaan,2023-05-13,03:00:00,3,3,0,FMN 11 A Jan Van Rijswijcklaan Ringfietspad
658,Ringfietspad Jan Van Rijswijcklaan,2023-05-13,04:00:00,6,2,4,FMN 11 A Jan Van Rijswijcklaan Ringfietspad
658,Ringfietspad Jan Van Rijswijcklaan,2023-05-13,05:00:00,7,4,3,FMN 11 A Jan Van Rijswijcklaan Ringfietspad
658,Ringfietspad Jan Van Rijswijcklaan,2023-05-13,06:00:00,13,4,9,FMN 11 A Jan Van Rijswijcklaan Ringfietspad
658,Ringfietspad Jan Van Rijswijcklaan,2023-05-13,07:00:00,14,6,8,FMN 11 A Jan Van Rijswijcklaan Ringfietspad
658,Ringfietspad Jan Van Rijswijcklaan,2023-05-13,08:00:00,28,14,14,FMN 11 A Jan Van Rijswijcklaan Ringfietspad
658,Ringfietspad Jan Van Rijswijcklaan,2023-05-13,09:00:00,52,22,30,FMN 11 A Jan Van Rijswijcklaan Ringfietspad
658,Ringfietspad Jan Van Rijswijcklaan,2023-05-13,10:00:00,61,27,34,FMN 11 A Jan Van Rijswijcklaan Ringfietspad
658,Ringfietspad Jan Van Rijswijcklaan,2023-05-13,11:00:00,67,32,35,FMN 11 A Jan Van Rijswijcklaan Ringfietspad
658,Ringfietspad Jan Van Rijswijcklaan,2023-05-13,12:00:00,73,37,36,FMN 11 A Jan Van Rijswijcklaan Ringfietspad
658,Ringfietspad Jan Van Rijswijcklaan,2023-05-13,13:00:00,89,43,46,FMN 11 A Jan Van Rijswijcklaan Ringfietspad
658,Ringfietspad Jan Van Rijswijcklaan,2023-05-13,14:00:00,104,54,50,FMN 11 A Jan Van Rijswijcklaan Ringfietspad
658,Ringfietspad Jan Van Rijswijcklaan,2023-05-13,15:00:00,100,55,45,FMN 11 A Jan Van Rijswijcklaan Ringfietspad
658,Ringfietspad Jan Van Rijswijcklaan,2023-05-13,16:00:00,90,57,33,FMN 11 A Jan Van Rijswijcklaan Ringfietspad
658,Ringfietspad Jan Van Rijswijcklaan,2023-05-13,17:00:00,69,44,25,FMN 11 A Jan Van Rijswijcklaan Ringfietspad
658,Ringfietspad Jan Van Rijswijcklaan,2023-05-13,18:00:00,54,31,23,FMN 11 A Jan Van Rijswijcklaan Ringfietspad
658,Ringfietspad Jan Van Rijswijcklaan,2023-05-13,19:00:00,38,20,18,FMN 11 A Jan Van Rijswijcklaan Ringfietspad
658,Ringfietspad Jan Van Rijswijcklaan,2023-05-13,20:00:00,30,14,16,FMN 11 A Jan Van Rijswijcklaan Ringfietspad
658,Ringfietspad Jan Van Rijswijcklaan,2023-05-13,21:00:00,21,12,9,FMN 11 A Jan Van Rijswijcklaan Ringfietspad
658,Ringfietspad Jan Van Rijswijcklaan,2023-05-13,22:00:00,17,10,7,FMN 11 A Jan Van Rijswijcklaan Ringfietspad
658,Ringfietspad Jan Van Rijswijcklaan,2023-05-13,23:00:00,11,9,2,FMN 11 A Jan Van Rijswijcklaan Ringfietspad
658,Ringfietspad Jan Van Rijswijcklaan,2023-05-14,00:00:00,5,4,1,FMN 11 A Jan Van Rijswijcklaan Ringfietspad
658,Ringfietspad Jan Van Rijswijcklaan,2023-05-14,01:00:00,3,1,2,FMN 11 A Jan Van Rijswijcklaan Ringfietspad
658,Ringfietspad Jan Van Rijswijcklaan,2023-05-14,02:00:00,2,1,1,FMN 11 A Jan Van Rijswijcklaan Ringfietspad
658,Ringfietspad Jan Van Rijswijcklaan,2023-05-14,03:00:00,2,2,0,FMN 11 A Jan Van Rijswijcklaan Ringfietspad
658,Ringfietspad Jan Van Rijswijcklaan,2023-05-14,04:00:00,2,0,2,FMN 11 A Jan Van Rijswijcklaan Ringfietspad
658,Ringfietspad Jan Van Rijswijcklaan,2023-05-14,05:00:00,2,0,2,FMN 11 A Jan Van Rijswijcklaan Ringfietspad
658,Ringfietspad Jan Van Rijswijcklaan,2023-05-14,06:00:00,6,4,2,FMN 11 A Jan Van Rijswijcklaan Ringfietspad
658,Ringfietspad Jan Van Rijswijcklaan,2023-05-14,07:00:00,7,3,4,FMN 11 A Jan Van Rijswijcklaan Ringfietspad
658,Ringfietspad Jan Van Rijswijcklaan,2023-05-14,08:00:00,19,8,11,FMN 11 A Jan Van Rijswijcklaan Ringfietspad
658,Ringfietspad Jan Van Rijswijcklaan,2023-05-14,09:00:00,42,15,27,FMN 11 A Jan Van Rijswijcklaan Ringfietspad
658,Ringfietspad Jan Van Rijswijcklaan,2023-05-14,10:00:00,51,20,31,FMN 11 A Jan Van Rijswijcklaan Ringfietspad
658,Ringfietspad Jan Van Rijswijcklaan,2023-05-14,11:00:00,58,26,32,FMN 11 A Jan Van Rijswijcklaan Ringfietspad
658,Ringfietspad Jan Van Rijswijcklaan,2023-05-14,12:00:00,67,36,31,FMN 11 A Jan Van Rijswijcklaan Ringfietspad
658,Ringfietspad Jan Van Rijswijcklaan,2023-05-14,13:00:00,73,37,36,FMN 11 A Jan Van Rijswijcklaan Ringfietspad
658,Ringfietspad Jan Van Rijswijcklaan,2023-05-14,14:00:00,82,38,44,FMN 11 A Jan Van Rijswijcklaan Ringfietspad
658,Ringfietspad Jan Van Rijswijcklaan,2023-05-14,15:00:00,77,46,31,FMN 11 A Jan Van Rijswijcklaan Ringfietspad
658,Ringfietspad Jan Van Rijswijcklaan,2023-05-14,16:00:00,63,39,24,FMN 11 A Jan Van Rijswijcklaan Ringfietspad
658,Ringfietspad Jan Van Rijswijcklaan,2023-05-14,17:00:00,52,34,18,FMN 11 A Jan Van Rijswijcklaan Ringfietspad
658,Ringfietspad Jan Van Rijswijcklaan,2023-05-14,18:00:00,35,20,15,FMN 11 A Jan Van Rijswijcklaan Ringfietspad
658,Ringfietspad Jan Van Rijswijcklaan,2023-05-14,19:00:00,23,14,9,FMN 11 A Jan Van Rijswijcklaan Ringfietspad
658,Ringfietspad Jan Van Rijswijcklaan,2023-05-14,20:00:00,19,9,10,FMN 11 A Jan Van Rijswijcklaan Ringfietspad
658,Ringfietspad Jan Van Rijswijcklaan,2023-05-14,21:00:00,13,10,3,FMN 11 A Jan Van Rijswijcklaan Ringfietspad
658,Ringfietspad Jan Van Rijswijcklaan,2023-05-14,22:00:00,7,3,4,FMN 11 A Jan Van Rijswijcklaan Ringfietspad
658,Ringfietspad Jan Van Rijswijcklaan,2023-05-14,23:00:00,4,2,2,FMN 11 A Jan Van Rijswijcklaan Ringfietspad
658,Ringfietspad Jan Van Rijswijcklaan,2023-05-15,00:00:00,2,1,1,FMN 11 A Jan Van Rijswijcklaan Ringfietspad
658,Ringfietspad Jan Van Rijswijcklaan,2023-05-15,01:00:00,1,1,0,FMN 11 A Jan Van Rijswijcklaan Ringfietspad
658,Ringfietspad Jan Van Rijswijcklaan,2023-05-15,02:00:00,1,1,0,FMN 11 A Jan Van Rijswijcklaan Ringfietspad
658,Ringfietspad Jan Van Rijswijcklaan,2023-05-15,03:00:00,2,1,1,FMN 11 A Jan Van Rijswijcklaan Ringfietspad
658,Ringfietspad Jan Van Rijswijcklaan,2023-05-15,04:00:00,7,3,4,FMN 11 A Jan Van Rijswijcklaan Ringfietspad
658,Ringfietspad Jan Van Rijswijcklaan,2023-05-15,05:00:00,21,2,19,FMN 11 A Jan Van Rijswijcklaan Ringfietspad
658,Ringfietspad Jan Van Rijswijcklaan,2023-05-15,06:00:00,55,13,42,FMN 11 A Jan Van Rijswijcklaan Ringfietspad
658,Ringfietspad Jan Van Rijswijcklaan,2023-05-15,07:00:00,113,38,75,FMN 11 A Jan Van Rijswijcklaan Ringfietspad
658,Ringfietspad Jan Van Rijswijcklaan,2023-05-15,08:00:00,148,49,99,FMN 11 A Jan Van Rijswijcklaan Ringfietspad
658,Ringfietspad Jan Van Rijswijcklaan,2023-05-15,09:00:00,53,18,35,FMN 11 A Jan Van Rijswijcklaan Ringfietspad
658,Ringfietspad Jan Van Rijswijcklaan,2023-05-15,10:00:00,37,17,20,FMN 11 A Jan Van Rijswijcklaan Ringfietspad
658,Ringfietspad Jan Van Rijswijcklaan,2023-05-15,11:00:00,34,15,19,FMN 11 A Jan Van Rijswijcklaan Ringfietspad
658,Ringfietspad Jan Van Rijswijcklaan,2023-05-15,12:00:00,51,25,26,FMN 11 A Jan Van Rijswijcklaan Ringfietspad
658,Ringfietspad Jan Van Rijswijcklaan,2023-05-15,13:00:00,53,25,28,FMN 11 A Jan Van Rijswijcklaan Ringfietspad
658,Ringfietspad Jan Van Rijswijcklaan,2023-05-15,14:00:00,61,34,27,FMN 11 A Jan Van Rijswijcklaan Ringfietspad
658,Ringfietspad Jan Van Rijswijcklaan,2023-05-15,15:00:00,86,55,31,FMN 11 A Jan Van Rijswijcklaan Ringfietspad
658,Ringfietspad Jan Van Rijswijcklaan,2023-05-15,16:00:00,135,93,42,FMN 11 A Jan Van Rijswijcklaan Ringfietspad
658,Ringfietspad Jan Van Rijswijcklaan,2023-05-15,17:00:00,142,93,49,FMN 11 A Jan Van Rijswijcklaan Ringfietspad
658,Ringfietspad Jan Van Rijswijcklaan,2023-05-15,18:00:00,82,52,30,FMN 11 A Jan Van Rijswijcklaan Ringfietspad
658,Ringfietspad Jan Van Rijswijcklaan,2023-05-15,19:00:00,39,21,18,FMN 11 A Jan Van Rijswijcklaan Ringfietspad
658,Ringfietspad Jan Van Rijswijcklaan,2023-05-15,20:00:00,28,15,13,FMN 11 A Jan Van Rijswijcklaan Ringfietspad
658,Ringfietspad Jan Van Rijswijcklaan,2023-05-15,21:00:00,19,9,10,FMN 11 A Jan Van Rijswijcklaan Ringfietspad
658,Ringfietspad Jan Van Rijswijcklaan,2023-05-15,22:00:00,17,15,2,FMN 11 A Jan Van Rijswijcklaan Ringfietspad
658,Ringfietspad Jan Van Rijswijcklaan,2023-05-15,23:00:00,6,2,4,FMN 11 A Jan Van Rijswijcklaan Ringfietspad
658,Ringfietspad Jan Van Rijswijcklaan,2023-05-16,00:00:00,2,1,1,FMN 11 A Jan Van Rijswijcklaan Ringfietspad
658,Ringfietspad Jan Van Rijswijcklaan,2023-05-16,01:00:00,1,1,0,FMN 11 A Jan Van Rijswijcklaan Ringfietspad
658,Ringfietspad Jan Van Rijswijcklaan,2023-05-16,02:00:00,1,1,0,FMN 11 A Jan Van Rijswijcklaan Ringfietspad
658,Ringfietspad Jan Van Rijswijcklaan,2023-05-16,03:00:00,2,2,0,FMN 11 A Jan Van Rijswijcklaan Ringfietspad
658,Ringfietspad Jan Van Rijswijcklaan,2023-05-16,04:00:00,7,4,3,FMN 11 A Jan Van Rijswijcklaan Ringfietspad
658,Ringfietspad Jan Van Rijswijcklaan,2023-05-16,05:00:00,24,6,18,FMN 11 A Jan Van Rijswijcklaan Ringfietspad
658,Ringfietspad Jan Van Rijswijcklaan,2023-05-16,06:00:00,63,14,49,FMN 11 A Jan Van Rijswijcklaan Ringfietspad
658,Ringfietspad Jan Van Rijswijcklaan,2023-05-16,07:00:00,123,45,78,FMN 11 A Jan Van Rijswijcklaan Ringfietspad
658,Ringfietspad Jan Van Rijswijcklaan,2023-05-16,08:00:00,159,53,106,FMN 11 A Jan Van Rijswijcklaan Ringfietspad
658,Ringfietspad Jan Van Rijswijcklaan,2023-05-16,09:00:00,59,23,36,FMN 11 A Jan Van Rijswijcklaan Ringfietspad
658,Ringfietspad Jan Van Rijswijcklaan,2023-05-16,10:00:00,39,18,21,FMN 11 A Jan Van Rijswijcklaan Ringfietspad
658,Ringfietspad Jan Van Rijswijcklaan,2023-05-16,11:00:00,36,19,17,FMN 11 A Jan Van Rijswijcklaan Ringfietspad
658,Ringfietspad Jan Van Rijswijcklaan,2023-05-16,12:00:00,50,21,29,FMN 11 A Jan Van Rijswijcklaan Ringfietspad
658,Ringfietspad Jan Van Rijswijcklaan,2023-05-16,13:00:00,54,27,27,FMN 11 A Jan Van Rijswijcklaan Ringfietspad
658,Ringfietspad Jan Van Rijswijcklaan,2023-05-16,14:00:00,59,31,28,FMN 11 A Jan Van Rijswijcklaan Ringfietspad
658,Ringfietspad Jan Van Rijswijcklaan,2023-05-16,15:00:00,88,60,28,FMN 11 A Jan Van Rijswijcklaan Ringfietspad
658,Ringfietspad Jan Van Rijswijcklaan,2023-05-16,16:00:00,144,98,46,FMN 11 A Jan Van Rijswijcklaan Ringfietspad
658,Ringfietspad Jan Van Rijswijcklaan,2023-05-16,17:00:00,153,99,54,FMN 11 A Jan Van Rijswijcklaan Ringfietspad
658,Ringfietspad Jan Van Rijswijcklaan,2023-05-16,18:00:00,93,58,35,FMN 11 A Jan Van Rijswijcklaan Ringfietspad
658,Ringfietspad Jan Van Rijswijcklaan,2023-05-16,19:00:00,40,24,16,FMN 11 A Jan Van Rijswijcklaan Ringfietspad
658,Ringfietspad Jan Van Rijswijcklaan,2023-05-16,20:00:00,30,13,17,FMN 11 A Jan Van Rijswijcklaan Ringfietspad
658,Ringfietspad Jan Van Rijswijcklaan,2023-05-16,21:00:00,20,10,10,FMN 11 A Jan Van Rijswijcklaan Ringfietspad
658,Ringfietspad Jan Van Rijswijcklaan,2023-05-16,22:00:00,18,10,8,FMN 11 A Jan Van Rijswijcklaan Ringfietspad
658,Ringfietspad Jan Van Rijswijcklaan,2023-05-16,23:00:00,7,6,1,FMN 11 A Jan Van Rijswijcklaan Ringfietspad
658,Ringfietspad Jan Van Rijswijcklaan,2023-05-17,00:00:00,1,1,0,FMN 11 A Jan Van Rijswijcklaan Ringfietspad
658,Ringfietspad Jan Van Rijswijcklaan,2023-05-17,01:00:00,0,0,0,FMN 11 A Jan Van Rijswijcklaan Ringfietspad
658,Ringfietspad Jan Van Rijswijcklaan,2023-05-17,02:00:00,0,0,0,FMN 11 A Jan Van Rijswijcklaan Ringfietspad
658,Ringfietspad Jan Van Rijswijcklaan,2023-05-17,03:00:00,3,2,1,FMN 11 A Jan Van Rijswijcklaan Ringfietspad
658,Ringfietspad Jan Van Rijswijcklaan,2023-05-17,04:00:00,3,2,1,FMN 11 A Jan Van Rijswijcklaan Ringfietspad
658,Ringfietspad Jan Van Rijswijcklaan,2023-05-17,05:00:00,22,4,18,FMN 11 A Jan Van Rijswijcklaan Ringfietspad
658,Ringfietspad Jan Van Rijswijcklaan,2023-05-17,06:00:00,64,17,47,FMN 11 A Jan Van Rijswijcklaan Ringfietspad
658,Ringfietspad Jan Van Rijswijcklaan,2023-05-17,07:00:00,121,46,75,FMN 11 A Jan Van Rijswijcklaan Ringfietspad
658,Ringfietspad Jan Van Rijswijcklaan,2023-05-17,08:00:00,146,45,101,FMN 11 A Jan Van Rijswijcklaan Ringfietspad
658,Ringfietspad Jan Van Rijswijcklaan,2023-05-17,09:00:00,64,22,42,FMN 11 A Jan Van Rijswijcklaan Ringfietspad
658,Ringfietspad Jan Van Rijswijcklaan,2023-05-17,10:00:00,32,17,15,FMN 11 A Jan Van Rijswijcklaan Ringfietspad
658,Ringfietspad Jan Van Rijswijcklaan,2023-05-17,11:00:00,43,16,27,FMN 11 A Jan Van Rijswijcklaan Ringfietspad
658,Ringfietspad Jan Van Rijswijcklaan,2023-05-17,12:00:00,68,32,36,FMN 11 A Jan Van Rijswijcklaan Ringfietspad
658,Ringfietspad Jan Van Rijswijcklaan,2023-05-17,13:00:00,61,27,34,FMN 11 A Jan Van Rijswijcklaan Ringfietspad
658,Ringfietspad Jan Van Rijswijcklaan,2023-05-17,14:00:00,77,44,33,FMN 11 A Jan Van Rijswijcklaan Ringfietspad
658,Ringfietspad Jan Van Rijswijcklaan,2023-05-17,15:00:00,99,62,37,FMN 11 A Jan Van Rijswijcklaan Ringfietspad
658,Ringfietspad Jan Van Rijswijcklaan,2023-05-17,16:00:00,135,90,45,FMN 11 A Jan Van Rijswijcklaan Ringfietspad
658,Ringfietspad Jan Van Rijswijcklaan,2023-05-17,17:00:00,159,104,55,FMN 11 A Jan Van Rijswijcklaan Ringfietspad
658,Ringfietspad Jan Van Rijswijcklaan,2023-05-17,18:00:00,95,60,35,FMN 11 A Jan Van Rijswijcklaan Ringfietspad
658,Ringfietspad Jan Van Rijswijcklaan,2023-05-17,19:00:00,53,28,25,FMN 11 A Jan Van Rijswijcklaan Ringfietspad
658,Ringfietspad Jan Van Rijswijcklaan,2023-05-17,20:00:00,31,16,15,FMN 11 A Jan Van Rijswijcklaan Ringfietspad
658,Ringfietspad Jan Van Rijswijcklaan,2023-05-17,21:00:00,27,18,9,FMN 11 A Jan Van Rijswijcklaan Ringfietspad
658,Ringfietspad Jan Van Rijswijcklaan,2023-05-17,22:00:00,28,21,7,FMN 11 A Jan Van Rijswijcklaan Ringfietspad
658,Ringfietspad Jan Van Rijswijcklaan,2023-05-17,23:00:00,3,2,1,FMN 11 A Jan Van Rijswijcklaan Ringfietspad
658,Ringfietspad Jan Van Rijswijcklaan,2023-05-18,00:00:00,1,0,1,FMN 11 A Jan Van Rijswijcklaan Ringfietspad
658,Ringfietspad Jan Van Rijswijcklaan,2023-05-18,01:00:00,1,0,1,FMN 11 A Jan Van Rijswijcklaan Ringfietspad
658,Ringfietspad Jan Van Rijswijcklaan,2023-05-18,02:00:00,0,0,0,FMN 11 A Jan Van Rijswijcklaan Ringfietspad
658,Ringfietspad Jan Van Rijswijcklaan,2023-05-18,03:00:00,1,1,0,FMN 11 A Jan Van Rijswijcklaan Ringfietspad
658,Ringfietspad Jan Van Rijswijcklaan,2023-05-18,04:00:00,6,4,2,FMN 11 A Jan Van Rijswijcklaan Ringfietspad
658,Ringfietspad Jan Van Rijswijcklaan,2023-05-18,05:00:00,17,6,11,FMN 11 A Jan Van Rijswijcklaan Ringfietspad
658,Ringfietspad Jan Van Rijswijcklaan,2023-05-18,06:00:00,42,11,31,FMN 11 A Jan Van Rijswijcklaan Ringfietspad
658,Ringfietspad Jan Van Rijswijcklaan,2023-05-18,07:00:00,54,23,31,FMN 11 A Jan Van Rijswijcklaan Ringfietspad
658,Ringfietspad Jan Van Rijswijcklaan,2023-05-18,08:00:00,89,27,62,FMN 11 A Jan Van Rijswijcklaan Ringfietspad
658,Ringfietspad Jan Van Rijswijcklaan,2023-05-18,09:00:00,34,10,24,FMN 11 A Jan Van Rijswijcklaan Ringfietspad
658,Ringfietspad Jan Van Rijswijcklaan,2023-05-18,10:00:00,17,10,7,FMN 11 A Jan Van Rijswijcklaan Ringfietspad
658,Ringfietspad Jan Van Rijswijcklaan,2023-05-18,11:00:00,25,11,14,FMN 11 A Jan Van Rijswijcklaan Ringfietspad
658,Ringfietspad Jan Van Rijswijcklaan,2023-05-18,12:00:00,28,13,15,FMN 11 A Jan Van Rijswijcklaan Ringfietspad
658,Ringfietspad Jan Van Rijswijcklaan,2023-05-18,13:00:00,33,21,12,FMN 11 A Jan Van Rijswijcklaan Ringfietspad
658,Ringfietspad Jan Van Rijswijcklaan,2023-05-18,14:00:00,39,23,16,FMN 11 A Jan Van Rijswijcklaan Ringfietspad
658,Ringfietspad Jan Van Rijswijcklaan,2023-05-18,15:00:00,62,38,24,FMN 11 A Jan Van Rijswijcklaan Ringfietspad
658,Ringfietspad Jan Van Rijswijcklaan,2023-05-18,16:00:00,88,56,32,FMN 11 A Jan Van Rijswijcklaan Ringfietspad
658,Ringfietspad Jan Van Rijswijcklaan,2023-05-18,17:00:00,82,55,27,FMN 11 A Jan Van Rijswijcklaan Ringfietspad
658,Ringfietspad Jan Van Rijswijcklaan,2023-05-18,18:00:00,55,32,23,FMN 11 A Jan Van Rijswijcklaan Ringfietspad
658,Ringfietspad Jan Van Rijswijcklaan,2023-05-18,19:00:00,31,20,11,FMN 11 A Jan Van Rijswijcklaan Ringfietspad
658,Ringfietspad Jan Van Rijswijcklaan,2023-05-18,20:00:00,19,8,11,FMN 11 A Jan Van Rijswijcklaan Ringfietspad
658,Ringfietspad Jan Van Rijswijcklaan,2023-05-18,21:00:00,11,4,7,FMN 11 A Jan Van Rijswijcklaan Ringfietspad
658,Ringfietspad Jan Van Rijswijcklaan,2023-05-18,22:00:00,16,10,6,FMN 11 A Jan Van Rijswijcklaan Ringfietspad
658,Ringfietspad Jan Van Rijswijcklaan,2023-05-18,23:00:00,3,1,2,FMN 11 A Jan Van Rijswijcklaan Ringfietspad
658,Ringfietspad Jan Van Rijswijcklaan,2023-05-19,00:00:00,5,2,3,FMN 11 A Jan Van Rijswijcklaan Ringfietspad
658,Ringfietspad Jan Van Rijswijcklaan,2023-05-19,01:00:00,2,1,1,FMN 11 A Jan Van Rijswijcklaan Ringfietspad
658,Ringfietspad Jan Van Rijswijcklaan,2023-05-19,02:00:00,1,1,0,FMN 11 A Jan Van Rijswijcklaan Ringfietspad
658,Ringfietspad Jan Van Rijswijcklaan,2023-05-19,03:00:00,2,1,1,FMN 11 A Jan Van Rijswijcklaan Ringfietspad
658,Ringfietspad Jan Van Rijswijcklaan,2023-05-19,04:00:00,7,4,3,FMN 11 A Jan Van Rijswijcklaan Ringfietspad
658,Ringfietspad Jan Van Rijswijcklaan,2023-05-19,05:00:00,14,3,11,FMN 11 A Jan Van Rijswijcklaan Ringfietspad
658,Ringfietspad Jan Van Rijswijcklaan,2023-05-19,06:00:00,40,12,28,FMN 11 A Jan Van Rijswijcklaan Ringfietspad
658,Ringfietspad Jan Van Rijswijcklaan,2023-05-19,07:00:00,58,16,42,FMN 11 A Jan Van Rijswijcklaan Ringfietspad
658,Ringfietspad Jan Van Rijswijcklaan,2023-05-19,08:00:00,93,30,63,FMN 11 A Jan Van Rijswijcklaan Ringfietspad
658,Ringfietspad Jan Van Rijswijcklaan,2023-05-19,09:00:00,39,17,22,FMN 11 A Jan Van Rijswijcklaan Ringfietspad
658,Ringfietspad Jan Van Rijswijcklaan,2023-05-19,10:00:00,30,16,14,FMN 11 A Jan Van Rijswijcklaan Ringfietspad
658,Ringfietspad Jan Van Rijswijcklaan,2023-05-19,11:00:00,26,16,10,FMN 11 A Jan Van Rijswijcklaan Ringfietspad
658,Ringfietspad Jan Van Rijswijcklaan,2023-05-19,12:00:00,47,29,18,FMN 11 A Jan Van Rijswijcklaan Ringfietspad
658,Ringfietspad Jan Van Rijswijcklaan,2023-05-19,13:00:00,44,19,25,FMN 11 A Jan Van Rijswijcklaan Ringfietspad
658,Ringfietspad Jan Van Rijswijcklaan,2023-05-19,14:00:00,51,28,23,FMN 11 A Jan Van Rijswijcklaan Ringfietspad
658,Ringfietspad Jan Van Rijswijcklaan,2023-05-19,15:00:00,60,39,21,FMN 11 A Jan Van Rijswijcklaan Ringfietspad
658,Ringfietspad Jan Van Rijswijcklaan,2023-05-19,16:00:00,108,70,38,FMN 11 A Jan Van Rijswijcklaan Ringfietspad
658,Ringfietspad Jan Van Rijswijcklaan,2023-05-19,17:00:00,73,52,21,FMN 11 A Jan Van Rijswijcklaan Ringfietspad
658,Ringfietspad Jan Van Rijswijcklaan,2023-05-19,18:00:00,57,35,22,FMN 11 A Jan Van Rijswijcklaan Ringfietspad
658,Ringfietspad Jan Van Rijswijcklaan,2023-05-19,19:00:00,33,24,9,FMN 11 A Jan Van Rijswijcklaan Ringfietspad
658,Ringfietspad Jan Van Rijswijcklaan,2023-05-19,20:00:00,24,13,11,FMN 11 A Jan Van Rijswijcklaan Ringfietspad
658,Ringfietspad Jan Van Rijswijcklaan,2023-05-19,21:00:00,14,10,4,FMN 11 A Jan Van Rijswijcklaan Ringfietspad
658,Ringfietspad Jan Van Rijswijcklaan,2023-05-19,22:00:00,11,4,7,FMN 11 A Jan Van Rijswijcklaan Ringfietspad
658,Ringfietspad Jan Van Rijswijcklaan,2023-05-19,23:00:00,1,0,1,FMN 11 A Jan Van Rijswijcklaan Ringfietspad
658,Ringfietspad Jan Van Rijswijcklaan,2023-05-20,00:00:00,6,5,1,FMN 11 A Jan Van Rijswijcklaan Ringfietspad
658,Ringfietspad Jan Van Rijswijcklaan,2023-05-20,01:00:00,4,4,0,FMN 11 A Jan Van Rijswijcklaan Ringfietspad
658,Ringfietspad Jan Van Rijswijcklaan,2023-05-20,02:00:00,2,2,0,FMN 11 A Jan Van Rijswijcklaan Ringfietspad
658,Ringfietspad Jan Van Rijswijcklaan,2023-05-20,03:00:00,5,4,1,FMN 11 A Jan Van Rijswijcklaan Ringfietspad
658,Ringfietspad Jan Van Rijswijcklaan,2023-05-20,04:00:00,4,2,2,FMN 11 A Jan Van Rijswijcklaan Ringfietspad
658,Ringfietspad Jan Van Rijswijcklaan,2023-05-20,05:00:00,7,2,5,FMN 11 A Jan Van Rijswijcklaan Ringfietspad
658,Ringfietspad Jan Van Rijswijcklaan,2023-05-20,06:00:00,9,4,5,FMN 11 A Jan Van Rijswijcklaan Ringfietspad
658,Ringfietspad Jan Van Rijswijcklaan,2023-05-20,07:00:00,13,9,4,FMN 11 A Jan Van Rijswijcklaan Ringfietspad
658,Ringfietspad Jan Van Rijswijcklaan,2023-05-20,08:00:00,23,6,17,FMN 11 A Jan Van Rijswijcklaan Ringfietspad
658,Ringfietspad Jan Van Rijswijcklaan,2023-05-20,09:00:00,47,20,27,FMN 11 A Jan Van Rijswijcklaan Ringfietspad
658,Ringfietspad Jan Van Rijswijcklaan,2023-05-20,10:00:00,40,14,26,FMN 11 A Jan Van Rijswijcklaan Ringfietspad
658,Ringfietspad Jan Van Rijswijcklaan,2023-05-20,11:00:00,63,31,32,FMN 11 A Jan Van Rijswijcklaan Ringfietspad
658,Ringfietspad Jan Van Rijswijcklaan,2023-05-20,12:00:00,59,32,27,FMN 11 A Jan Van Rijswijcklaan Ringfietspad
658,Ringfietspad Jan Van Rijswijcklaan,2023-05-20,13:00:00,74,31,43,FMN 11 A Jan Van Rijswijcklaan Ringfietspad
658,Ringfietspad Jan Van Rijswijcklaan,2023-05-20,14:00:00,89,46,43,FMN 11 A Jan Van Rijswijcklaan Ringfietspad
658,Ringfietspad Jan Van Rijswijcklaan,2023-05-20,15:00:00,80,44,36,FMN 11 A Jan Van Rijswijcklaan Ringfietspad
658,Ringfietspad Jan Van Rijswijcklaan,2023-05-20,16:00:00,73,48,25,FMN 11 A Jan Van Rijswijcklaan Ringfietspad
658,Ringfietspad Jan Van Rijswijcklaan,2023-05-20,17:00:00,59,32,27,FMN 11 A Jan Van Rijswijcklaan Ringfietspad
658,Ringfietspad Jan Van Rijswijcklaan,2023-05-20,18:00:00,43,25,18,FMN 11 A Jan Van Rijswijcklaan Ringfietspad
658,Ringfietspad Jan Van Rijswijcklaan,2023-05-20,19:00:00,23,13,10,FMN 11 A Jan Van Rijswijcklaan Ringfietspad
658,Ringfietspad Jan Van Rijswijcklaan,2023-05-20,20:00:00,28,15,13,FMN 11 A Jan Van Rijswijcklaan Ringfietspad
658,Ringfietspad Jan Van Rijswijcklaan,2023-05-20,21:00:00,17,10,7,FMN 11 A Jan Van Rijswijcklaan Ringfietspad
658,Ringfietspad Jan Van Rijswijcklaan,2023-05-20,22:00:00,10,6,4,FMN 11 A Jan Van Rijswijcklaan Ringfietspad
658,Ringfietspad Jan Van Rijswijcklaan,2023-05-20,23:00:00,15,10,5,FMN 11 A Jan Van Rijswijcklaan Ringfietspad
658,Ringfietspad Jan Van Rijswijcklaan,2023-05-21,00:00:00,7,6,1,FMN 11 A Jan Van Rijswijcklaan Ringfietspad
658,Ringfietspad Jan Van Rijswijcklaan,2023-05-21,01:00:00,2,0,2,FMN 11 A Jan Van Rijswijcklaan Ringfietspad
658,Ringfietspad Jan Van Rijswijcklaan,2023-05-21,02:00:00,3,1,2,FMN 11 A Jan Van Rijswijcklaan Ringfietspad
658,Ringfietspad Jan Van Rijswijcklaan,2023-05-21,03:00:00,2,1,1,FMN 11 A Jan Van Rijswijcklaan Ringfietspad
658,Ringfietspad Jan Van Rijswijcklaan,2023-05-21,04:00:00,4,3,1,FMN 11 A Jan Van Rijswijcklaan Ringfietspad
658,Ringfietspad Jan Van Rijswijcklaan,2023-05-21,05:00:00,0,0,0,FMN 11 A Jan Van Rijswijcklaan Ringfietspad
658,Ringfietspad Jan Van Rijswijcklaan,2023-05-21,06:00:00,6,2,4,FMN 11 A Jan Van Rijswijcklaan Ringfietspad
658,Ringfietspad Jan Van Rijswijcklaan,2023-05-21,07:00:00,6,3,3,FMN 11 A Jan Van Rijswijcklaan Ringfietspad
658,Ringfietspad Jan Van Rijswijcklaan,2023-05-21,08:00:00,19,8,11,FMN 11 A Jan Van Rijswijcklaan Ringfietspad
658,Ringfietspad Jan Van Rijswijcklaan,2023-05-21,09:00:00,35,12,23,FMN 11 A Jan Van Rijswijcklaan Ringfietspad
658,Ringfietspad Jan Van Rijswijcklaan,2023-05-21,10:00:00,62,27,35,FMN 11 A Jan Van Rijswijcklaan Ringfietspad
658,Ringfietspad Jan Van Rijswijcklaan,2023-05-21,11:00:00,62,26,36,FMN 11 A Jan Van Rijswijcklaan Ringfietspad
658,Ringfietspad Jan Van Rijswijcklaan,2023-05-21,12:00:00,75,37,38,FMN 11 A Jan Van Rijswijcklaan Ringfietspad
658,Ringfietspad Jan Van Rijswijcklaan,2023-05-21,13:00:00,89,48,41,FMN 11 A Jan Van Rijswijcklaan Ringfietspad
658,Ringfietspad Jan Van Rijswijcklaan,2023-05-21,14:00:00,85,45,40,FMN 11 A Jan Van Rijswijcklaan Ringfietspad
658,Ringfietspad Jan Van Rijswijcklaan,2023-05-21,15:00:00,91,52,39,FMN 11 A Jan Van Rijswijcklaan Ringfietspad
658,Ringfietspad Jan Van Rijswijcklaan,2023-05-21,16:00:00,58,37,21,FMN 11 A Jan Van Rijswijcklaan Ringfietspad
658,Ringfietspad Jan Van Rijswijcklaan,2023-05-21,17:00:00,46,27,19,FMN 11 A Jan Van Rijswijcklaan Ringfietspad
658,Ringfietspad Jan Van Rijswijcklaan,2023-05-21,18:00:00,45,25,20,FMN 11 A Jan Van Rijswijcklaan Ringfietspad
658,Ringfietspad Jan Van Rijswijcklaan,2023-05-21,19:00:00,22,15,7,FMN 11 A Jan Van Rijswijcklaan Ringfietspad
658,Ringfietspad Jan Van Rijswijcklaan,2023-05-21,20:00:00,27,15,12,FMN 11 A Jan Van Rijswijcklaan Ringfietspad
658,Ringfietspad Jan Van Rijswijcklaan,2023-05-21,21:00:00,17,10,7,FMN 11 A Jan Van Rijswijcklaan Ringfietspad
658,Ringfietspad Jan Van Rijswijcklaan,2023-05-21,22:00:00,9,3,6,FMN 11 A Jan Van Rijswijcklaan Ringfietspad
658,Ringfietspad Jan Van Rijswijcklaan,2023-05-21,23:00:00,3,0,3,FMN 11 A Jan Van Rijswijcklaan Ringfietspad
658,Ringfietspad Jan Van Rijswijcklaan,2023-05-22,00:00:00,2,1,1,FMN 11 A Jan Van Rijswijcklaan Ringfietspad
658,Ringfietspad Jan Van Rijswijcklaan,2023-05-22,01:00:00,0,0,0,FMN 11 A Jan Van Rijswijcklaan Ringfietspad
658,Ringfietspad Jan Van Rijswijcklaan,2023-05-22,02:00:00,1,0,1,FMN 11 A Jan Van Rijswijcklaan Ringfietspad
658,Ringfietspad Jan Van Rijswijcklaan,2023-05-22,03:00:00,2,2,0,FMN 11 A Jan Van Rijswijcklaan Ringfietspad
658,Ringfietspad Jan Van Rijswijcklaan,2023-05-22,04:00:00,3,1,2,FMN 11 A Jan Van Rijswijcklaan Ringfietspad
658,Ringfietspad Jan Van Rijswijcklaan,2023-05-22,05:00:00,28,10,18,FMN 11 A Jan Van Rijswijcklaan Ringfietspad
658,Ringfietspad Jan Van Rijswijcklaan,2023-05-22,06:00:00,49,15,34,FMN 11 A Jan Van Rijswijcklaan Ringfietspad
658,Ringfietspad Jan Van Rijswijcklaan,2023-05-22,07:00:00,126,42,84,FMN 11 A Jan Van Rijswijcklaan Ringfietspad
658,Ringfietspad Jan Van Rijswijcklaan,2023-05-22,08:00:00,162,54,108,FMN 11 A Jan Van Rijswijcklaan Ringfietspad
658,Ringfietspad Jan Van Rijswijcklaan,2023-05-22,09:00:00,70,27,43,FMN 11 A Jan Van Rijswijcklaan Ringfietspad
658,Ringfietspad Jan Van Rijswijcklaan,2023-05-22,10:00:00,38,14,24,FMN 11 A Jan Van Rijswijcklaan Ringfietspad
658,Ringfietspad Jan Van Rijswijcklaan,2023-05-22,11:00:00,36,12,24,FMN 11 A Jan Van Rijswijcklaan Ringfietspad
658,Ringfietspad Jan Van Rijswijcklaan,2023-05-22,12:00:00,68,28,40,FMN 11 A Jan Van Rijswijcklaan Ringfietspad
658,Ringfietspad Jan Van Rijswijcklaan,2023-05-22,13:00:00,58,28,30,FMN 11 A Jan Van Rijswijcklaan Ringfietspad
658,Ringfietspad Jan Van Rijswijcklaan,2023-05-22,14:00:00,75,51,24,FMN 11 A Jan Van Rijswijcklaan Ringfietspad
658,Ringfietspad Jan Van Rijswijcklaan,2023-05-22,15:00:00,96,62,34,FMN 11 A Jan Van Rijswijcklaan Ringfietspad
658,Ringfietspad Jan Van Rijswijcklaan,2023-05-22,16:00:00,146,100,46,FMN 11 A Jan Van Rijswijcklaan Ringfietspad
658,Ringfietspad Jan Van Rijswijcklaan,2023-05-22,17:00:00,174,107,67,FMN 11 A Jan Van Rijswijcklaan Ringfietspad
658,Ringfietspad Jan Van Rijswijcklaan,2023-05-22,18:00:00,85,56,29,FMN 11 A Jan Van Rijswijcklaan Ringfietspad
658,Ringfietspad Jan Van Rijswijcklaan,2023-05-22,19:00:00,54,29,25,FMN 11 A Jan Van Rijswijcklaan Ringfietspad
658,Ringfietspad Jan Van Rijswijcklaan,2023-05-22,20:00:00,29,13,16,FMN 11 A Jan Van Rijswijcklaan Ringfietspad
658,Ringfietspad Jan Van Rijswijcklaan,2023-05-22,21:00:00,21,11,10,FMN 11 A Jan Van Rijswijcklaan Ringfietspad
658,Ringfietspad Jan Van Rijswijcklaan,2023-05-22,22:00:00,18,12,6,FMN 11 A Jan Van Rijswijcklaan Ringfietspad
658,Ringfietspad Jan Van Rijswijcklaan,2023-05-22,23:00:00,3,1,2,FMN 11 A Jan Van Rijswijcklaan Ringfietspad
658,Ringfietspad Jan Van Rijswijcklaan,2023-05-23,00:00:00,0,0,0,FMN 11 A Jan Van Rijswijcklaan Ringfietspad
658,Ringfietspad Jan Van Rijswijcklaan,2023-05-23,01:00:00,0,0,0,FMN 11 A Jan Van Rijswijcklaan Ringfietspad
658,Ringfietspad Jan Van Rijswijcklaan,2023-05-23,02:00:00,3,2,1,FMN 11 A Jan Van Rijswijcklaan Ringfietspad
658,Ringfietspad Jan Van Rijswijcklaan,2023-05-23,03:00:00,1,1,0,FMN 11 A Jan Van Rijswijcklaan Ringfietspad
658,Ringfietspad Jan Van Rijswijcklaan,2023-05-23,04:00:00,11,7,4,FMN 11 A Jan Van Rijswijcklaan Ringfietspad
658,Ringfietspad Jan Van Rijswijcklaan,2023-05-23,05:00:00,35,9,26,FMN 11 A Jan Van Rijswijcklaan Ringfietspad
658,Ringfietspad Jan Van Rijswijcklaan,2023-05-23,06:00:00,72,12,60,FMN 11 A Jan Van Rijswijcklaan Ringfietspad
658,Ringfietspad Jan Van Rijswijcklaan,2023-05-23,07:00:00,137,44,93,FMN 11 A Jan Van Rijswijcklaan Ringfietspad
658,Ringfietspad Jan Van Rijswijcklaan,2023-05-23,08:00:00,184,61,123,FMN 11 A Jan Van Rijswijcklaan Ringfietspad
658,Ringfietspad Jan Van Rijswijcklaan,2023-05-23,09:00:00,74,30,44,FMN 11 A Jan Van Rijswijcklaan Ringfietspad
658,Ringfietspad Jan Van Rijswijcklaan,2023-05-23,10:00:00,51,24,27,FMN 11 A Jan Van Rijswijcklaan Ringfietspad
658,Ringfietspad Jan Van Rijswijcklaan,2023-05-23,11:00:00,45,20,25,FMN 11 A Jan Van Rijswijcklaan Ringfietspad
658,Ringfietspad Jan Van Rijswijcklaan,2023-05-23,12:00:00,48,29,19,FMN 11 A Jan Van Rijswijcklaan Ringfietspad
658,Ringfietspad Jan Van Rijswijcklaan,2023-05-23,13:00:00,57,27,30,FMN 11 A Jan Van Rijswijcklaan Ringfietspad
658,Ringfietspad Jan Van Rijswijcklaan,2023-05-23,14:00:00,65,33,32,FMN 11 A Jan Van Rijswijcklaan Ringfietspad
658,Ringfietspad Jan Van Rijswijcklaan,2023-05-23,15:00:00,94,63,31,FMN 11 A Jan Van Rijswijcklaan Ringfietspad
658,Ringfietspad Jan Van Rijswijcklaan,2023-05-23,16:00:00,188,130,58,FMN 11 A Jan Van Rijswijcklaan Ringfietspad
658,Ringfietspad Jan Van Rijswijcklaan,2023-05-23,17:00:00,188,122,66,FMN 11 A Jan Van Rijswijcklaan Ringfietspad
658,Ringfietspad Jan Van Rijswijcklaan,2023-05-23,18:00:00,111,67,44,FMN 11 A Jan Van Rijswijcklaan Ringfietspad
658,Ringfietspad Jan Van Rijswijcklaan,2023-05-23,19:00:00,39,26,13,FMN 11 A Jan Van Rijswijcklaan Ringfietspad
658,Ringfietspad Jan Van Rijswijcklaan,2023-05-23,20:00:00,30,21,9,FMN 11 A Jan Van Rijswijcklaan Ringfietspad
658,Ringfietspad Jan Van Rijswijcklaan,2023-05-23,21:00:00,18,11,7,FMN 11 A Jan Van Rijswijcklaan Ringfietspad
658,Ringfietspad Jan Van Rijswijcklaan,2023-05-23,22:00:00,12,9,3,FMN 11 A Jan Van Rijswijcklaan Ringfietspad
658,Ringfietspad Jan Van Rijswijcklaan,2023-05-23,23:00:00,10,7,3,FMN 11 A Jan Van Rijswijcklaan Ringfietspad
658,Ringfietspad Jan Van Rijswijcklaan,2023-05-24,00:00:00,4,3,1,FMN 11 A Jan Van Rijswijcklaan Ringfietspad
658,Ringfietspad Jan Van Rijswijcklaan,2023-05-24,01:00:00,2,1,1,FMN 11 A Jan Van Rijswijcklaan Ringfietspad
658,Ringfietspad Jan Van Rijswijcklaan,2023-05-24,02:00:00,0,0,0,FMN 11 A Jan Van Rijswijcklaan Ringfietspad
658,Ringfietspad Jan Van Rijswijcklaan,2023-05-24,03:00:00,2,1,1,FMN 11 A Jan Van Rijswijcklaan Ringfietspad
658,Ringfietspad Jan Van Rijswijcklaan,2023-05-24,04:00:00,6,2,4,FMN 11 A Jan Van Rijswijcklaan Ringfietspad
658,Ringfietspad Jan Van Rijswijcklaan,2023-05-24,05:00:00,27,6,21,FMN 11 A Jan Van Rijswijcklaan Ringfietspad
658,Ringfietspad Jan Van Rijswijcklaan,2023-05-24,06:00:00,59,13,46,FMN 11 A Jan Van Rijswijcklaan Ringfietspad
658,Ringfietspad Jan Van Rijswijcklaan,2023-05-24,07:00:00,125,42,83,FMN 11 A Jan Van Rijswijcklaan Ringfietspad
658,Ringfietspad Jan Van Rijswijcklaan,2023-05-24,08:00:00,150,52,98,FMN 11 A Jan Van Rijswijcklaan Ringfietspad
658,Ringfietspad Jan Van Rijswijcklaan,2023-05-24,09:00:00,50,20,30,FMN 11 A Jan Van Rijswijcklaan Ringfietspad
658,Ringfietspad Jan Van Rijswijcklaan,2023-05-24,10:00:00,52,27,25,FMN 11 A Jan Van Rijswijcklaan Ringfietspad
658,Ringfietspad Jan Van Rijswijcklaan,2023-05-24,11:00:00,36,17,19,FMN 11 A Jan Van Rijswijcklaan Ringfietspad
658,Ringfietspad Jan Van Rijswijcklaan,2023-05-24,12:00:00,64,33,31,FMN 11 A Jan Van Rijswijcklaan Ringfietspad
658,Ringfietspad Jan Van Rijswijcklaan,2023-05-24,13:00:00,67,27,40,FMN 11 A Jan Van Rijswijcklaan Ringfietspad
658,Ringfietspad Jan Van Rijswijcklaan,2023-05-24,14:00:00,76,42,34,FMN 11 A Jan Van Rijswijcklaan Ringfietspad
658,Ringfietspad Jan Van Rijswijcklaan,2023-05-24,15:00:00,100,58,42,FMN 11 A Jan Van Rijswijcklaan Ringfietspad
658,Ringfietspad Jan Van Rijswijcklaan,2023-05-24,16:00:00,133,95,38,FMN 11 A Jan Van Rijswijcklaan Ringfietspad
658,Ringfietspad Jan Van Rijswijcklaan,2023-05-24,17:00:00,159,99,60,FMN 11 A Jan Van Rijswijcklaan Ringfietspad
658,Ringfietspad Jan Van Rijswijcklaan,2023-05-24,18:00:00,102,63,39,FMN 11 A Jan Van Rijswijcklaan Ringfietspad
658,Ringfietspad Jan Van Rijswijcklaan,2023-05-24,19:00:00,39,19,20,FMN 11 A Jan Van Rijswijcklaan Ringfietspad
658,Ringfietspad Jan Van Rijswijcklaan,2023-05-24,20:00:00,32,14,18,FMN 11 A Jan Van Rijswijcklaan Ringfietspad
658,Ringfietspad Jan Van Rijswijcklaan,2023-05-24,21:00:00,27,14,13,FMN 11 A Jan Van Rijswijcklaan Ringfietspad
658,Ringfietspad Jan Van Rijswijcklaan,2023-05-24,22:00:00,19,13,6,FMN 11 A Jan Van Rijswijcklaan Ringfietspad
658,Ringfietspad Jan Van Rijswijcklaan,2023-05-24,23:00:00,6,4,2,FMN 11 A Jan Van Rijswijcklaan Ringfietspad
658,Ringfietspad Jan Van Rijswijcklaan,2023-05-25,00:00:00,5,2,3,FMN 11 A Jan Van Rijswijcklaan Ringfietspad
658,Ringfietspad Jan Van Rijswijcklaan,2023-05-25,01:00:00,1,1,0,FMN 11 A Jan Van Rijswijcklaan Ringfietspad
658,Ringfietspad Jan Van Rijswijcklaan,2023-05-25,02:00:00,1,1,0,FMN 11 A Jan Van Rijswijcklaan Ringfietspad
658,Ringfietspad Jan Van Rijswijcklaan,2023-05-25,03:00:00,4,3,1,FMN 11 A Jan Van Rijswijcklaan Ringfietspad
658,Ringfietspad Jan Van Rijswijcklaan,2023-05-25,04:00:00,8,3,5,FMN 11 A Jan Van Rijswijcklaan Ringfietspad
658,Ringfietspad Jan Van Rijswijcklaan,2023-05-25,05:00:00,25,6,19,FMN 11 A Jan Van Rijswijcklaan Ringfietspad
658,Ringfietspad Jan Van Rijswijcklaan,2023-05-25,06:00:00,58,13,45,FMN 11 A Jan Van Rijswijcklaan Ringfietspad
658,Ringfietspad Jan Van Rijswijcklaan,2023-05-25,07:00:00,129,42,87,FMN 11 A Jan Van Rijswijcklaan Ringfietspad
658,Ringfietspad Jan Van Rijswijcklaan,2023-05-25,08:00:00,180,59,121,FMN 11 A Jan Van Rijswijcklaan Ringfietspad
658,Ringfietspad Jan Van Rijswijcklaan,2023-05-25,09:00:00,62,22,40,FMN 11 A Jan Van Rijswijcklaan Ringfietspad
658,Ringfietspad Jan Van Rijswijcklaan,2023-05-25,10:00:00,50,25,25,FMN 11 A Jan Van Rijswijcklaan Ringfietspad
658,Ringfietspad Jan Van Rijswijcklaan,2023-05-25,11:00:00,42,25,17,FMN 11 A Jan Van Rijswijcklaan Ringfietspad
658,Ringfietspad Jan Van Rijswijcklaan,2023-05-25,12:00:00,57,32,25,FMN 11 A Jan Van Rijswijcklaan Ringfietspad
658,Ringfietspad Jan Van Rijswijcklaan,2023-05-25,13:00:00,75,35,40,FMN 11 A Jan Van Rijswijcklaan Ringfietspad
658,Ringfietspad Jan Van Rijswijcklaan,2023-05-25,14:00:00,86,52,34,FMN 11 A Jan Van Rijswijcklaan Ringfietspad
658,Ringfietspad Jan Van Rijswijcklaan,2023-05-25,15:00:00,97,63,34,FMN 11 A Jan Van Rijswijcklaan Ringfietspad
658,Ringfietspad Jan Van Rijswijcklaan,2023-05-25,16:00:00,163,111,52,FMN 11 A Jan Van Rijswijcklaan Ringfietspad
658,Ringfietspad Jan Van Rijswijcklaan,2023-05-25,17:00:00,165,110,55,FMN 11 A Jan Van Rijswijcklaan Ringfietspad
658,Ringfietspad Jan Van Rijswijcklaan,2023-05-25,18:00:00,105,62,43,FMN 11 A Jan Van Rijswijcklaan Ringfietspad
658,Ringfietspad Jan Van Rijswijcklaan,2023-05-25,19:00:00,57,34,23,FMN 11 A Jan Van Rijswijcklaan Ringfietspad
658,Ringfietspad Jan Van Rijswijcklaan,2023-05-25,20:00:00,29,15,14,FMN 11 A Jan Van Rijswijcklaan Ringfietspad
658,Ringfietspad Jan Van Rijswijcklaan,2023-05-25,21:00:00,17,6,11,FMN 11 A Jan Van Rijswijcklaan Ringfietspad
658,Ringfietspad Jan Van Rijswijcklaan,2023-05-25,22:00:00,25,15,10,FMN 11 A Jan Van Rijswijcklaan Ringfietspad
658,Ringfietspad Jan Van Rijswijcklaan,2023-05-25,23:00:00,9,7,2,FMN 11 A Jan Van Rijswijcklaan Ringfietspad
658,Ringfietspad Jan Van Rijswijcklaan,2023-05-26,00:00:00,6,1,5,FMN 11 A Jan Van Rijswijcklaan Ringfietspad
658,Ringfietspad Jan Van Rijswijcklaan,2023-05-26,01:00:00,4,4,0,FMN 11 A Jan Van Rijswijcklaan Ringfietspad
658,Ringfietspad Jan Van Rijswijcklaan,2023-05-26,02:00:00,1,1,0,FMN 11 A Jan Van Rijswijcklaan Ringfietspad
658,Ringfietspad Jan Van Rijswijcklaan,2023-05-26,03:00:00,3,2,1,FMN 11 A Jan Van Rijswijcklaan Ringfietspad
658,Ringfietspad Jan Van Rijswijcklaan,2023-05-26,04:00:00,6,5,1,FMN 11 A Jan Van Rijswijcklaan Ringfietspad
658,Ringfietspad Jan Van Rijswijcklaan,2023-05-26,05:00:00,18,4,14,FMN 11 A Jan Van Rijswijcklaan Ringfietspad
658,Ringfietspad Jan Van Rijswijcklaan,2023-05-26,06:00:00,50,14,36,FMN 11 A Jan Van Rijswijcklaan Ringfietspad
658,Ringfietspad Jan Van Rijswijcklaan,2023-05-26,07:00:00,112,37,75,FMN 11 A Jan Van Rijswijcklaan Ringfietspad
658,Ringfietspad Jan Van Rijswijcklaan,2023-05-26,08:00:00,154,47,107,FMN 11 A Jan Van Rijswijcklaan Ringfietspad
658,Ringfietspad Jan Van Rijswijcklaan,2023-05-26,09:00:00,52,22,30,FMN 11 A Jan Van Rijswijcklaan Ringfietspad
658,Ringfietspad Jan Van Rijswijcklaan,2023-05-26,10:00:00,36,18,18,FMN 11 A Jan Van Rijswijcklaan Ringfietspad
658,Ringfietspad Jan Van Rijswijcklaan,2023-05-26,11:00:00,43,21,22,FMN 11 A Jan Van Rijswijcklaan Ringfietspad
658,Ringfietspad Jan Van Rijswijcklaan,2023-05-26,12:00:00,76,39,37,FMN 11 A Jan Van Rijswijcklaan Ringfietspad
658,Ringfietspad Jan Van Rijswijcklaan,2023-05-26,13:00:00,65,37,28,FMN 11 A Jan Van Rijswijcklaan Ringfietspad
658,Ringfietspad Jan Van Rijswijcklaan,2023-05-26,14:00:00,83,42,41,FMN 11 A Jan Van Rijswijcklaan Ringfietspad
658,Ringfietspad Jan Van Rijswijcklaan,2023-05-26,15:00:00,108,68,40,FMN 11 A Jan Van Rijswijcklaan Ringfietspad
658,Ringfietspad Jan Van Rijswijcklaan,2023-05-26,16:00:00,147,97,50,FMN 11 A Jan Van Rijswijcklaan Ringfietspad
658,Ringfietspad Jan Van Rijswijcklaan,2023-05-26,17:00:00,112,70,42,FMN 11 A Jan Van Rijswijcklaan Ringfietspad
658,Ringfietspad Jan Van Rijswijcklaan,2023-05-26,18:00:00,79,42,37,FMN 11 A Jan Van Rijswijcklaan Ringfietspad
658,Ringfietspad Jan Van Rijswijcklaan,2023-05-26,19:00:00,43,26,17,FMN 11 A Jan Van Rijswijcklaan Ringfietspad
658,Ringfietspad Jan Van Rijswijcklaan,2023-05-26,20:00:00,29,11,18,FMN 11 A Jan Van Rijswijcklaan Ringfietspad
658,Ringfietspad Jan Van Rijswijcklaan,2023-05-26,21:00:00,19,8,11,FMN 11 A Jan Van Rijswijcklaan Ringfietspad
658,Ringfietspad Jan Van Rijswijcklaan,2023-05-26,22:00:00,23,12,11,FMN 11 A Jan Van Rijswijcklaan Ringfietspad
658,Ringfietspad Jan Van Rijswijcklaan,2023-05-26,23:00:00,10,5,5,FMN 11 A Jan Van Rijswijcklaan Ringfietspad
658,Ringfietspad Jan Van Rijswijcklaan,2023-05-27,00:00:00,8,4,4,FMN 11 A Jan Van Rijswijcklaan Ringfietspad
658,Ringfietspad Jan Van Rijswijcklaan,2023-05-27,01:00:00,6,4,2,FMN 11 A Jan Van Rijswijcklaan Ringfietspad
658,Ringfietspad Jan Van Rijswijcklaan,2023-05-27,02:00:00,1,0,1,FMN 11 A Jan Van Rijswijcklaan Ringfietspad
658,Ringfietspad Jan Van Rijswijcklaan,2023-05-27,03:00:00,2,2,0,FMN 11 A Jan Van Rijswijcklaan Ringfietspad
658,Ringfietspad Jan Van Rijswijcklaan,2023-05-27,04:00:00,2,0,2,FMN 11 A Jan Van Rijswijcklaan Ringfietspad
658,Ringfietspad Jan Van Rijswijcklaan,2023-05-27,05:00:00,3,1,2,FMN 11 A Jan Van Rijswijcklaan Ringfietspad
658,Ringfietspad Jan Van Rijswijcklaan,2023-05-27,06:00:00,12,6,6,FMN 11 A Jan Van Rijswijcklaan Ringfietspad
658,Ringfietspad Jan Van Rijswijcklaan,2023-05-27,07:00:00,10,4,6,FMN 11 A Jan Van Rijswijcklaan Ringfietspad
658,Ringfietspad Jan Van Rijswijcklaan,2023-05-27,08:00:00,26,13,13,FMN 11 A Jan Van Rijswijcklaan Ringfietspad
658,Ringfietspad Jan Van Rijswijcklaan,2023-05-27,09:00:00,51,20,31,FMN 11 A Jan Van Rijswijcklaan Ringfietspad
658,Ringfietspad Jan Van Rijswijcklaan,2023-05-27,10:00:00,68,31,37,FMN 11 A Jan Van Rijswijcklaan Ringfietspad
658,Ringfietspad Jan Van Rijswijcklaan,2023-05-27,11:00:00,60,24,36,FMN 11 A Jan Van Rijswijcklaan Ringfietspad
658,Ringfietspad Jan Van Rijswijcklaan,2023-05-27,12:00:00,63,29,34,FMN 11 A Jan Van Rijswijcklaan Ringfietspad
658,Ringfietspad Jan Van Rijswijcklaan,2023-05-27,13:00:00,87,41,46,FMN 11 A Jan Van Rijswijcklaan Ringfietspad
658,Ringfietspad Jan Van Rijswijcklaan,2023-05-27,14:00:00,99,53,46,FMN 11 A Jan Van Rijswijcklaan Ringfietspad
658,Ringfietspad Jan Van Rijswijcklaan,2023-05-27,15:00:00,88,47,41,FMN 11 A Jan Van Rijswijcklaan Ringfietspad
658,Ringfietspad Jan Van Rijswijcklaan,2023-05-27,16:00:00,83,52,31,FMN 11 A Jan Van Rijswijcklaan Ringfietspad
658,Ringfietspad Jan Van Rijswijcklaan,2023-05-27,17:00:00,56,34,22,FMN 11 A Jan Van Rijswijcklaan Ringfietspad
658,Ringfietspad Jan Van Rijswijcklaan,2023-05-27,18:00:00,56,37,19,FMN 11 A Jan Van Rijswijcklaan Ringfietspad
658,Ringfietspad Jan Van Rijswijcklaan,2023-05-27,19:00:00,35,21,14,FMN 11 A Jan Van Rijswijcklaan Ringfietspad
658,Ringfietspad Jan Van Rijswijcklaan,2023-05-27,20:00:00,31,18,13,FMN 11 A Jan Van Rijswijcklaan Ringfietspad
658,Ringfietspad Jan Van Rijswijcklaan,2023-05-27,21:00:00,20,12,8,FMN 11 A Jan Van Rijswijcklaan Ringfietspad
658,Ringfietspad Jan Van Rijswijcklaan,2023-05-27,22:00:00,17,9,8,FMN 11 A Jan Van Rijswijcklaan Ringfietspad
658,Ringfietspad Jan Van Rijswijcklaan,2023-05-27,23:00:00,15,7,8,FMN 11 A Jan Van Rijswijcklaan Ringfietspad
658,Ringfietspad Jan Van Rijswijcklaan,2023-05-28,00:00:00,5,2,3,FMN 11 A Jan Van Rijswijcklaan Ringfietspad
658,Ringfietspad Jan Van Rijswijcklaan,2023-05-28,01:00:00,3,2,1,FMN 11 A Jan Van Rijswijcklaan Ringfietspad
658,Ringfietspad Jan Van Rijswijcklaan,2023-05-28,02:00:00,3,3,0,FMN 11 A Jan Van Rijswijcklaan Ringfietspad
658,Ringfietspad Jan Van Rijswijcklaan,2023-05-28,03:00:00,2,1,1,FMN 11 A Jan Van Rijswijcklaan Ringfietspad
658,Ringfietspad Jan Van Rijswijcklaan,2023-05-28,04:00:00,2,0,2,FMN 11 A Jan Van Rijswijcklaan Ringfietspad
658,Ringfietspad Jan Van Rijswijcklaan,2023-05-28,05:00:00,1,0,1,FMN 11 A Jan Van Rijswijcklaan Ringfietspad
658,Ringfietspad Jan Van Rijswijcklaan,2023-05-28,06:00:00,5,2,3,FMN 11 A Jan Van Rijswijcklaan Ringfietspad
658,Ringfietspad Jan Van Rijswijcklaan,2023-05-28,07:00:00,4,4,0,FMN 11 A Jan Van Rijswijcklaan Ringfietspad
658,Ringfietspad Jan Van Rijswijcklaan,2023-05-28,08:00:00,31,11,20,FMN 11 A Jan Van Rijswijcklaan Ringfietspad
658,Ringfietspad Jan Van Rijswijcklaan,2023-05-28,09:00:00,54,23,31,FMN 11 A Jan Van Rijswijcklaan Ringfietspad
658,Ringfietspad Jan Van Rijswijcklaan,2023-05-28,10:00:00,61,22,39,FMN 11 A Jan Van Rijswijcklaan Ringfietspad
658,Ringfietspad Jan Van Rijswijcklaan,2023-05-28,11:00:00,73,38,35,FMN 11 A Jan Van Rijswijcklaan Ringfietspad
658,Ringfietspad Jan Van Rijswijcklaan,2023-05-28,12:00:00,85,43,42,FMN 11 A Jan Van Rijswijcklaan Ringfietspad
658,Ringfietspad Jan Van Rijswijcklaan,2023-05-28,13:00:00,87,45,42,FMN 11 A Jan Van Rijswijcklaan Ringfietspad
658,Ringfietspad Jan Van Rijswijcklaan,2023-05-28,14:00:00,94,43,51,FMN 11 A Jan Van Rijswijcklaan Ringfietspad
658,Ringfietspad Jan Van Rijswijcklaan,2023-05-28,15:00:00,102,60,42,FMN 11 A Jan Van Rijswijcklaan Ringfietspad
658,Ringfietspad Jan Van Rijswijcklaan,2023-05-28,16:00:00,86,52,34,FMN 11 A Jan Van Rijswijcklaan Ringfietspad
658,Ringfietspad Jan Van Rijswijcklaan,2023-05-28,17:00:00,63,38,25,FMN 11 A Jan Van Rijswijcklaan Ringfietspad
658,Ringfietspad Jan Van Rijswijcklaan,2023-05-28,18:00:00,49,31,18,FMN 11 A Jan Van Rijswijcklaan Ringfietspad
658,Ringfietspad Jan Van Rijswijcklaan,2023-05-28,19:00:00,26,16,10,FMN 11 A Jan Van Rijswijcklaan Ringfietspad
658,Ringfietspad Jan Van Rijswijcklaan,2023-05-28,20:00:00,26,16,10,FMN 11 A Jan Van Rijswijcklaan Ringfietspad
658,Ringfietspad Jan Van Rijswijcklaan,2023-05-28,21:00:00,15,12,3,FMN 11 A Jan Van Rijswijcklaan Ringfietspad
658,Ringfietspad Jan Van Rijswijcklaan,2023-05-28,22:00:00,11,6,5,FMN 11 A Jan Van Rijswijcklaan Ringfietspad
658,Ringfietspad Jan Van Rijswijcklaan,2023-05-28,23:00:00,2,1,1,FMN 11 A Jan Van Rijswijcklaan Ringfietspad
658,Ringfietspad Jan Van Rijswijcklaan,2023-05-29,00:00:00,0,0,0,FMN 11 A Jan Van Rijswijcklaan Ringfietspad
658,Ringfietspad Jan Van Rijswijcklaan,2023-05-29,01:00:00,1,0,1,FMN 11 A Jan Van Rijswijcklaan Ringfietspad
658,Ringfietspad Jan Van Rijswijcklaan,2023-05-29,02:00:00,1,1,0,FMN 11 A Jan Van Rijswijcklaan Ringfietspad
658,Ringfietspad Jan Van Rijswijcklaan,2023-05-29,03:00:00,1,1,0,FMN 11 A Jan Van Rijswijcklaan Ringfietspad
658,Ringfietspad Jan Van Rijswijcklaan,2023-05-29,04:00:00,3,2,1,FMN 11 A Jan Van Rijswijcklaan Ringfietspad
658,Ringfietspad Jan Van Rijswijcklaan,2023-05-29,05:00:00,14,6,8,FMN 11 A Jan Van Rijswijcklaan Ringfietspad
658,Ringfietspad Jan Van Rijswijcklaan,2023-05-29,06:00:00,31,6,25,FMN 11 A Jan Van Rijswijcklaan Ringfietspad
658,Ringfietspad Jan Van Rijswijcklaan,2023-05-29,07:00:00,74,24,50,FMN 11 A Jan Van Rijswijcklaan Ringfietspad
658,Ringfietspad Jan Van Rijswijcklaan,2023-05-29,08:00:00,80,28,52,FMN 11 A Jan Van Rijswijcklaan Ringfietspad
658,Ringfietspad Jan Van Rijswijcklaan,2023-05-29,09:00:00,44,12,32,FMN 11 A Jan Van Rijswijcklaan Ringfietspad
658,Ringfietspad Jan Van Rijswijcklaan,2023-05-29,10:00:00,21,13,8,FMN 11 A Jan Van Rijswijcklaan Ringfietspad
658,Ringfietspad Jan Van Rijswijcklaan,2023-05-29,11:00:00,18,7,11,FMN 11 A Jan Van Rijswijcklaan Ringfietspad
658,Ringfietspad Jan Van Rijswijcklaan,2023-05-29,12:00:00,29,19,10,FMN 11 A Jan Van Rijswijcklaan Ringfietspad
658,Ringfietspad Jan Van Rijswijcklaan,2023-05-29,13:00:00,26,15,11,FMN 11 A Jan Van Rijswijcklaan Ringfietspad
658,Ringfietspad Jan Van Rijswijcklaan,2023-05-29,14:00:00,42,22,20,FMN 11 A Jan Van Rijswijcklaan Ringfietspad
658,Ringfietspad Jan Van Rijswijcklaan,2023-05-29,15:00:00,48,33,15,FMN 11 A Jan Van Rijswijcklaan Ringfietspad
658,Ringfietspad Jan Van Rijswijcklaan,2023-05-29,16:00:00,78,51,27,FMN 11 A Jan Van Rijswijcklaan Ringfietspad
658,Ringfietspad Jan Van Rijswijcklaan,2023-05-29,17:00:00,70,47,23,FMN 11 A Jan Van Rijswijcklaan Ringfietspad
658,Ringfietspad Jan Van Rijswijcklaan,2023-05-29,18:00:00,47,26,21,FMN 11 A Jan Van Rijswijcklaan Ringfietspad
658,Ringfietspad Jan Van Rijswijcklaan,2023-05-29,19:00:00,25,12,13,FMN 11 A Jan Van Rijswijcklaan Ringfietspad
658,Ringfietspad Jan Van Rijswijcklaan,2023-05-29,20:00:00,16,7,9,FMN 11 A Jan Van Rijswijcklaan Ringfietspad
658,Ringfietspad Jan Van Rijswijcklaan,2023-05-29,21:00:00,10,4,6,FMN 11 A Jan Van Rijswijcklaan Ringfietspad
658,Ringfietspad Jan Van Rijswijcklaan,2023-05-29,22:00:00,8,4,4,FMN 11 A Jan Van Rijswijcklaan Ringfietspad
658,Ringfietspad Jan Van Rijswijcklaan,2023-05-29,23:00:00,7,2,5,FMN 11 A Jan Van Rijswijcklaan Ringfietspad
658,Ringfietspad Jan Van Rijswijcklaan,2023-05-30,00:00:00,5,3,2,FMN 11 A Jan Van Rijswijcklaan Ringfietspad
658,Ringfietspad Jan Van Rijswijcklaan,2023-05-30,01:00:00,1,1,0,FMN 11 A Jan Van Rijswijcklaan Ringfietspad
658,Ringfietspad Jan Van Rijswijcklaan,2023-05-30,02:00:00,2,1,1,FMN 11 A Jan Van Rijswijcklaan Ringfietspad
658,Ringfietspad Jan Van Rijswijcklaan,2023-05-30,03:00:00,3,1,2,FMN 11 A Jan Van Rijswijcklaan Ringfietspad
658,Ringfietspad Jan Van Rijswijcklaan,2023-05-30,04:00:00,8,4,4,FMN 11 A Jan Van Rijswijcklaan Ringfietspad
658,Ringfietspad Jan Van Rijswijcklaan,2023-05-30,05:00:00,21,11,10,FMN 11 A Jan Van Rijswijcklaan Ringfietspad
658,Ringfietspad Jan Van Rijswijcklaan,2023-05-30,06:00:00,68,18,50,FMN 11 A Jan Van Rijswijcklaan Ringfietspad
658,Ringfietspad Jan Van Rijswijcklaan,2023-05-30,07:00:00,135,43,92,FMN 11 A Jan Van Rijswijcklaan Ringfietspad
658,Ringfietspad Jan Van Rijswijcklaan,2023-05-30,08:00:00,195,69,126,FMN 11 A Jan Van Rijswijcklaan Ringfietspad
658,Ringfietspad Jan Van Rijswijcklaan,2023-05-30,09:00:00,65,24,41,FMN 11 A Jan Van Rijswijcklaan Ringfietspad
658,Ringfietspad Jan Van Rijswijcklaan,2023-05-30,10:00:00,45,22,23,FMN 11 A Jan Van Rijswijcklaan Ringfietspad
658,Ringfietspad Jan Van Rijswijcklaan,2023-05-30,11:00:00,36,17,19,FMN 11 A Jan Van Rijswijcklaan Ringfietspad
658,Ringfietspad Jan Van Rijswijcklaan,2023-05-30,12:00:00,53,23,30,FMN 11 A Jan Van Rijswijcklaan Ringfietspad
658,Ringfietspad Jan Van Rijswijcklaan,2023-05-30,13:00:00,64,29,35,FMN 11 A Jan Van Rijswijcklaan Ringfietspad
658,Ringfietspad Jan Van Rijswijcklaan,2023-05-30,14:00:00,60,29,31,FMN 11 A Jan Van Rijswijcklaan Ringfietspad
658,Ringfietspad Jan Van Rijswijcklaan,2023-05-30,15:00:00,100,64,36,FMN 11 A Jan Van Rijswijcklaan Ringfietspad
658,Ringfietspad Jan Van Rijswijcklaan,2023-05-30,16:00:00,164,115,49,FMN 11 A Jan Van Rijswijcklaan Ringfietspad
658,Ringfietspad Jan Van Rijswijcklaan,2023-05-30,17:00:00,168,109,59,FMN 11 A Jan Van Rijswijcklaan Ringfietspad
658,Ringfietspad Jan Van Rijswijcklaan,2023-05-30,18:00:00,98,58,40,FMN 11 A Jan Van Rijswijcklaan Ringfietspad
658,Ringfietspad Jan Van Rijswijcklaan,2023-05-30,19:00:00,49,25,24,FMN 11 A Jan Van Rijswijcklaan Ringfietspad
658,Ringfietspad Jan Van Rijswijcklaan,2023-05-30,20:00:00,44,20,24,FMN 11 A Jan Van Rijswijcklaan Ringfietspad
658,Ringfietspad Jan Van Rijswijcklaan,2023-05-30,21:00:00,19,8,11,FMN 11 A Jan Van Rijswijcklaan Ringfietspad
658,Ringfietspad Jan Van Rijswijcklaan,2023-05-30,22:00:00,20,12,8,FMN 11 A Jan Van Rijswijcklaan Ringfietspad
658,Ringfietspad Jan Van Rijswijcklaan,2023-05-30,23:00:00,10,6,4,FMN 11 A Jan Van Rijswijcklaan Ringfietspad
658,Ringfietspad Jan Van Rijswijcklaan,2023-05-31,00:00:00,3,1,2,FMN 11 A Jan Van Rijswijcklaan Ringfietspad
658,Ringfietspad Jan Van Rijswijcklaan,2023-05-31,01:00:00,0,0,0,FMN 11 A Jan Van Rijswijcklaan Ringfietspad
658,Ringfietspad Jan Van Rijswijcklaan,2023-05-31,02:00:00,0,0,0,FMN 11 A Jan Van Rijswijcklaan Ringfietspad
658,Ringfietspad Jan Van Rijswijcklaan,2023-05-31,03:00:00,0,0,0,FMN 11 A Jan Van Rijswijcklaan Ringfietspad
658,Ringfietspad Jan Van Rijswijcklaan,2023-05-31,04:00:00,6,1,5,FMN 11 A Jan Van Rijswijcklaan Ringfietspad
658,Ringfietspad Jan Van Rijswijcklaan,2023-05-31,05:00:00,32,10,22,FMN 11 A Jan Van Rijswijcklaan Ringfietspad
658,Ringfietspad Jan Van Rijswijcklaan,2023-05-31,06:00:00,77,26,51,FMN 11 A Jan Van Rijswijcklaan Ringfietspad
658,Ringfietspad Jan Van Rijswijcklaan,2023-05-31,07:00:00,150,56,94,FMN 11 A Jan Van Rijswijcklaan Ringfietspad
658,Ringfietspad Jan Van Rijswijcklaan,2023-05-31,08:00:00,164,67,97,FMN 11 A Jan Van Rijswijcklaan Ringfietspad
658,Ringfietspad Jan Van Rijswijcklaan,2023-05-31,09:00:00,65,31,34,FMN 11 A Jan Van Rijswijcklaan Ringfietspad
658,Ringfietspad Jan Van Rijswijcklaan,2023-05-31,10:00:00,42,24,18,FMN 11 A Jan Van Rijswijcklaan Ringfietspad
658,Ringfietspad Jan Van Rijswijcklaan,2023-05-31,11:00:00,48,21,27,FMN 11 A Jan Van Rijswijcklaan Ringfietspad
658,Ringfietspad Jan Van Rijswijcklaan,2023-05-31,12:00:00,76,37,39,FMN 11 A Jan Van Rijswijcklaan Ringfietspad
658,Ringfietspad Jan Van Rijswijcklaan,2023-05-31,13:00:00,73,35,38,FMN 11 A Jan Van Rijswijcklaan Ringfietspad
658,Ringfietspad Jan Van Rijswijcklaan,2023-05-31,14:00:00,63,41,22,FMN 11 A Jan Van Rijswijcklaan Ringfietspad
658,Ringfietspad Jan Van Rijswijcklaan,2023-05-31,15:00:00,102,69,33,FMN 11 A Jan Van Rijswijcklaan Ringfietspad
658,Ringfietspad Jan Van Rijswijcklaan,2023-05-31,16:00:00,154,107,47,FMN 11 A Jan Van Rijswijcklaan Ringfietspad
658,Ringfietspad Jan Van Rijswijcklaan,2023-05-31,17:00:00,182,116,66,FMN 11 A Jan Van Rijswijcklaan Ringfietspad
658,Ringfietspad Jan Van Rijswijcklaan,2023-05-31,18:00:00,88,53,35,FMN 11 A Jan Van Rijswijcklaan Ringfietspad
658,Ringfietspad Jan Van Rijswijcklaan,2023-05-31,19:00:00,56,27,29,FMN 11 A Jan Van Rijswijcklaan Ringfietspad
658,Ringfietspad Jan Van Rijswijcklaan,2023-05-31,20:00:00,37,16,21,FMN 11 A Jan Van Rijswijcklaan Ringfietspad
658,Ringfietspad Jan Van Rijswijcklaan,2023-05-31,21:00:00,36,19,17,FMN 11 A Jan Van Rijswijcklaan Ringfietspad
658,Ringfietspad Jan Van Rijswijcklaan,2023-05-31,22:00:00,23,14,9,FMN 11 A Jan Van Rijswijcklaan Ringfietspad
658,Ringfietspad Jan Van Rijswijcklaan,2023-05-31,23:00:00,10,7,3,FMN 11 A Jan Van Rijswijcklaan Ringfietspad
658,Ringfietspad Jan Van Rijswijcklaan,2023-06-01,00:00:00,3,1,2,FMN 11 A Jan Van Rijswijcklaan Ringfietspad
658,Ringfietspad Jan Van Rijswijcklaan,2023-06-01,01:00:00,2,1,1,FMN 11 A Jan Van Rijswijcklaan Ringfietspad
658,Ringfietspad Jan Van Rijswijcklaan,2023-06-01,02:00:00,1,0,1,FMN 11 A Jan Van Rijswijcklaan Ringfietspad
658,Ringfietspad Jan Van Rijswijcklaan,2023-06-01,03:00:00,3,2,1,FMN 11 A Jan Van Rijswijcklaan Ringfietspad
658,Ringfietspad Jan Van Rijswijcklaan,2023-06-01,04:00:00,3,2,1,FMN 11 A Jan Van Rijswijcklaan Ringfietspad
658,Ringfietspad Jan Van Rijswijcklaan,2023-06-01,05:00:00,31,8,23,FMN 11 A Jan Van Rijswijcklaan Ringfietspad
658,Ringfietspad Jan Van Rijswijcklaan,2023-06-01,06:00:00,80,19,61,FMN 11 A Jan Van Rijswijcklaan Ringfietspad
658,Ringfietspad Jan Van Rijswijcklaan,2023-06-01,07:00:00,139,45,94,FMN 11 A Jan Van Rijswijcklaan Ringfietspad
658,Ringfietspad Jan Van Rijswijcklaan,2023-06-01,08:00:00,180,54,126,FMN 11 A Jan Van Rijswijcklaan Ringfietspad
658,Ringfietspad Jan Van Rijswijcklaan,2023-06-01,09:00:00,78,30,48,FMN 11 A Jan Van Rijswijcklaan Ringfietspad
658,Ringfietspad Jan Van Rijswijcklaan,2023-06-01,10:00:00,41,18,23,FMN 11 A Jan Van Rijswijcklaan Ringfietspad
658,Ringfietspad Jan Van Rijswijcklaan,2023-06-01,11:00:00,52,27,25,FMN 11 A Jan Van Rijswijcklaan Ringfietspad
658,Ringfietspad Jan Van Rijswijcklaan,2023-06-01,12:00:00,65,33,32,FMN 11 A Jan Van Rijswijcklaan Ringfietspad
658,Ringfietspad Jan Van Rijswijcklaan,2023-06-01,13:00:00,62,29,33,FMN 11 A Jan Van Rijswijcklaan Ringfietspad
658,Ringfietspad Jan Van Rijswijcklaan,2023-06-01,14:00:00,82,43,39,FMN 11 A Jan Van Rijswijcklaan Ringfietspad
658,Ringfietspad Jan Van Rijswijcklaan,2023-06-01,15:00:00,113,82,31,FMN 11 A Jan Van Rijswijcklaan Ringfietspad
658,Ringfietspad Jan Van Rijswijcklaan,2023-06-01,16:00:00,171,109,62,FMN 11 A Jan Van Rijswijcklaan Ringfietspad
658,Ringfietspad Jan Van Rijswijcklaan,2023-06-01,17:00:00,168,110,58,FMN 11 A Jan Van Rijswijcklaan Ringfietspad
658,Ringfietspad Jan Van Rijswijcklaan,2023-06-01,18:00:00,112,70,42,FMN 11 A Jan Van Rijswijcklaan Ringfietspad
658,Ringfietspad Jan Van Rijswijcklaan,2023-06-01,19:00:00,51,33,18,FMN 11 A Jan Van Rijswijcklaan Ringfietspad
658,Ringfietspad Jan Van Rijswijcklaan,2023-06-01,20:00:00,36,20,16,FMN 11 A Jan Van Rijswijcklaan Ringfietspad
658,Ringfietspad Jan Van Rijswijcklaan,2023-06-01,21:00:00,22,10,12,FMN 11 A Jan Van Rijswijcklaan Ringfietspad
658,Ringfietspad Jan Van Rijswijcklaan,2023-06-01,22:00:00,24,17,7,FMN 11 A Jan Van Rijswijcklaan Ringfietspad
658,Ringfietspad Jan Van Rijswijcklaan,2023-06-01,23:00:00,11,6,5,FMN 11 A Jan Van Rijswijcklaan Ringfietspad
658,Ringfietspad Jan Van Rijswijcklaan,2023-06-02,00:00:00,10,6,4,FMN 11 A Jan Van Rijswijcklaan Ringfietspad
658,Ringfietspad Jan Van Rijswijcklaan,2023-06-02,01:00:00,0,0,0,FMN 11 A Jan Van Rijswijcklaan Ringfietspad
658,Ringfietspad Jan Van Rijswijcklaan,2023-06-02,02:00:00,2,2,0,FMN 11 A Jan Van Rijswijcklaan Ringfietspad
658,Ringfietspad Jan Van Rijswijcklaan,2023-06-02,03:00:00,2,2,0,FMN 11 A Jan Van Rijswijcklaan Ringfietspad
658,Ringfietspad Jan Van Rijswijcklaan,2023-06-02,04:00:00,8,5,3,FMN 11 A Jan Van Rijswijcklaan Ringfietspad
658,Ringfietspad Jan Van Rijswijcklaan,2023-06-02,05:00:00,31,11,20,FMN 11 A Jan Van Rijswijcklaan Ringfietspad
658,Ringfietspad Jan Van Rijswijcklaan,2023-06-02,06:00:00,70,23,47,FMN 11 A Jan Van Rijswijcklaan Ringfietspad
658,Ringfietspad Jan Van Rijswijcklaan,2023-06-02,07:00:00,118,37,81,FMN 11 A Jan Van Rijswijcklaan Ringfietspad
658,Ringfietspad Jan Van Rijswijcklaan,2023-06-02,08:00:00,162,49,113,FMN 11 A Jan Van Rijswijcklaan Ringfietspad
658,Ringfietspad Jan Van Rijswijcklaan,2023-06-02,09:00:00,70,28,42,FMN 11 A Jan Van Rijswijcklaan Ringfietspad
658,Ringfietspad Jan Van Rijswijcklaan,2023-06-02,10:00:00,53,24,29,FMN 11 A Jan Van Rijswijcklaan Ringfietspad
658,Ringfietspad Jan Van Rijswijcklaan,2023-06-02,11:00:00,49,30,19,FMN 11 A Jan Van Rijswijcklaan Ringfietspad
658,Ringfietspad Jan Van Rijswijcklaan,2023-06-02,12:00:00,83,46,37,FMN 11 A Jan Van Rijswijcklaan Ringfietspad
658,Ringfietspad Jan Van Rijswijcklaan,2023-06-02,13:00:00,69,35,34,FMN 11 A Jan Van Rijswijcklaan Ringfietspad
658,Ringfietspad Jan Van Rijswijcklaan,2023-06-02,14:00:00,85,48,37,FMN 11 A Jan Van Rijswijcklaan Ringfietspad
658,Ringfietspad Jan Van Rijswijcklaan,2023-06-02,15:00:00,118,82,36,FMN 11 A Jan Van Rijswijcklaan Ringfietspad
658,Ringfietspad Jan Van Rijswijcklaan,2023-06-02,16:00:00,142,101,41,FMN 11 A Jan Van Rijswijcklaan Ringfietspad
658,Ringfietspad Jan Van Rijswijcklaan,2023-06-02,17:00:00,128,85,43,FMN 11 A Jan Van Rijswijcklaan Ringfietspad
658,Ringfietspad Jan Van Rijswijcklaan,2023-06-02,18:00:00,62,43,19,FMN 11 A Jan Van Rijswijcklaan Ringfietspad
658,Ringfietspad Jan Van Rijswijcklaan,2023-06-02,19:00:00,53,23,30,FMN 11 A Jan Van Rijswijcklaan Ringfietspad
658,Ringfietspad Jan Van Rijswijcklaan,2023-06-02,20:00:00,33,12,21,FMN 11 A Jan Van Rijswijcklaan Ringfietspad
658,Ringfietspad Jan Van Rijswijcklaan,2023-06-02,21:00:00,14,8,6,FMN 11 A Jan Van Rijswijcklaan Ringfietspad
658,Ringfietspad Jan Van Rijswijcklaan,2023-06-02,22:00:00,26,19,7,FMN 11 A Jan Van Rijswijcklaan Ringfietspad
658,Ringfietspad Jan Van Rijswijcklaan,2023-06-02,23:00:00,13,5,8,FMN 11 A Jan Van Rijswijcklaan Ringfietspad
658,Ringfietspad Jan Van Rijswijcklaan,2023-06-03,00:00:00,4,3,1,FMN 11 A Jan Van Rijswijcklaan Ringfietspad
658,Ringfietspad Jan Van Rijswijcklaan,2023-06-03,01:00:00,4,3,1,FMN 11 A Jan Van Rijswijcklaan Ringfietspad
658,Ringfietspad Jan Van Rijswijcklaan,2023-06-03,02:00:00,9,7,2,FMN 11 A Jan Van Rijswijcklaan Ringfietspad
658,Ringfietspad Jan Van Rijswijcklaan,2023-06-03,03:00:00,2,2,0,FMN 11 A Jan Van Rijswijcklaan Ringfietspad
658,Ringfietspad Jan Van Rijswijcklaan,2023-06-03,04:00:00,10,9,1,FMN 11 A Jan Van Rijswijcklaan Ringfietspad
658,Ringfietspad Jan Van Rijswijcklaan,2023-06-03,05:00:00,9,2,7,FMN 11 A Jan Van Rijswijcklaan Ringfietspad
658,Ringfietspad Jan Van Rijswijcklaan,2023-06-03,06:00:00,19,11,8,FMN 11 A Jan Van Rijswijcklaan Ringfietspad
658,Ringfietspad Jan Van Rijswijcklaan,2023-06-03,07:00:00,19,7,12,FMN 11 A Jan Van Rijswijcklaan Ringfietspad
658,Ringfietspad Jan Van Rijswijcklaan,2023-06-03,08:00:00,31,15,16,FMN 11 A Jan Van Rijswijcklaan Ringfietspad
658,Ringfietspad Jan Van Rijswijcklaan,2023-06-03,09:00:00,44,17,27,FMN 11 A Jan Van Rijswijcklaan Ringfietspad
658,Ringfietspad Jan Van Rijswijcklaan,2023-06-03,10:00:00,51,19,32,FMN 11 A Jan Van Rijswijcklaan Ringfietspad
658,Ringfietspad Jan Van Rijswijcklaan,2023-06-03,11:00:00,63,22,41,FMN 11 A Jan Van Rijswijcklaan Ringfietspad
658,Ringfietspad Jan Van Rijswijcklaan,2023-06-03,12:00:00,71,35,36,FMN 11 A Jan Van Rijswijcklaan Ringfietspad
658,Ringfietspad Jan Van Rijswijcklaan,2023-06-03,13:00:00,91,47,44,FMN 11 A Jan Van Rijswijcklaan Ringfietspad
658,Ringfietspad Jan Van Rijswijcklaan,2023-06-03,14:00:00,92,56,36,FMN 11 A Jan Van Rijswijcklaan Ringfietspad
658,Ringfietspad Jan Van Rijswijcklaan,2023-06-03,15:00:00,99,62,37,FMN 11 A Jan Van Rijswijcklaan Ringfietspad
658,Ringfietspad Jan Van Rijswijcklaan,2023-06-03,16:00:00,84,57,27,FMN 11 A Jan Van Rijswijcklaan Ringfietspad
658,Ringfietspad Jan Van Rijswijcklaan,2023-06-03,17:00:00,66,43,23,FMN 11 A Jan Van Rijswijcklaan Ringfietspad
658,Ringfietspad Jan Van Rijswijcklaan,2023-06-03,18:00:00,65,31,34,FMN 11 A Jan Van Rijswijcklaan Ringfietspad
658,Ringfietspad Jan Van Rijswijcklaan,2023-06-03,19:00:00,33,17,16,FMN 11 A Jan Van Rijswijcklaan Ringfietspad
658,Ringfietspad Jan Van Rijswijcklaan,2023-06-03,20:00:00,30,20,10,FMN 11 A Jan Van Rijswijcklaan Ringfietspad
658,Ringfietspad Jan Van Rijswijcklaan,2023-06-03,21:00:00,25,13,12,FMN 11 A Jan Van Rijswijcklaan Ringfietspad
658,Ringfietspad Jan Van Rijswijcklaan,2023-06-03,22:00:00,19,11,8,FMN 11 A Jan Van Rijswijcklaan Ringfietspad
658,Ringfietspad Jan Van Rijswijcklaan,2023-06-03,23:00:00,8,5,3,FMN 11 A Jan Van Rijswijcklaan Ringfietspad
658,Ringfietspad Jan Van Rijswijcklaan,2023-06-04,00:00:00,6,5,1,FMN 11 A Jan Van Rijswijcklaan Ringfietspad
658,Ringfietspad Jan Van Rijswijcklaan,2023-06-04,01:00:00,3,3,0,FMN 11 A Jan Van Rijswijcklaan Ringfietspad
658,Ringfietspad Jan Van Rijswijcklaan,2023-06-04,02:00:00,4,3,1,FMN 11 A Jan Van Rijswijcklaan Ringfietspad
658,Ringfietspad Jan Van Rijswijcklaan,2023-06-04,03:00:00,4,4,0,FMN 11 A Jan Van Rijswijcklaan Ringfietspad
658,Ringfietspad Jan Van Rijswijcklaan,2023-06-04,04:00:00,2,0,2,FMN 11 A Jan Van Rijswijcklaan Ringfietspad
658,Ringfietspad Jan Van Rijswijcklaan,2023-06-04,05:00:00,6,3,3,FMN 11 A Jan Van Rijswijcklaan Ringfietspad
658,Ringfietspad Jan Van Rijswijcklaan,2023-06-04,06:00:00,4,1,3,FMN 11 A Jan Van Rijswijcklaan Ringfietspad
658,Ringfietspad Jan Van Rijswijcklaan,2023-06-04,07:00:00,10,4,6,FMN 11 A Jan Van Rijswijcklaan Ringfietspad
658,Ringfietspad Jan Van Rijswijcklaan,2023-06-04,08:00:00,23,7,16,FMN 11 A Jan Van Rijswijcklaan Ringfietspad
658,Ringfietspad Jan Van Rijswijcklaan,2023-06-04,09:00:00,54,18,36,FMN 11 A Jan Van Rijswijcklaan Ringfietspad
658,Ringfietspad Jan Van Rijswijcklaan,2023-06-04,10:00:00,67,21,46,FMN 11 A Jan Van Rijswijcklaan Ringfietspad
658,Ringfietspad Jan Van Rijswijcklaan,2023-06-04,11:00:00,79,40,39,FMN 11 A Jan Van Rijswijcklaan Ringfietspad
658,Ringfietspad Jan Van Rijswijcklaan,2023-06-04,12:00:00,92,50,42,FMN 11 A Jan Van Rijswijcklaan Ringfietspad
658,Ringfietspad Jan Van Rijswijcklaan,2023-06-04,13:00:00,102,53,49,FMN 11 A Jan Van Rijswijcklaan Ringfietspad
658,Ringfietspad Jan Van Rijswijcklaan,2023-06-04,14:00:00,90,43,47,FMN 11 A Jan Van Rijswijcklaan Ringfietspad
658,Ringfietspad Jan Van Rijswijcklaan,2023-06-04,15:00:00,109,58,51,FMN 11 A Jan Van Rijswijcklaan Ringfietspad
658,Ringfietspad Jan Van Rijswijcklaan,2023-06-04,16:00:00,81,50,31,FMN 11 A Jan Van Rijswijcklaan Ringfietspad
658,Ringfietspad Jan Van Rijswijcklaan,2023-06-04,17:00:00,69,50,19,FMN 11 A Jan Van Rijswijcklaan Ringfietspad
658,Ringfietspad Jan Van Rijswijcklaan,2023-06-04,18:00:00,45,30,15,FMN 11 A Jan Van Rijswijcklaan Ringfietspad
658,Ringfietspad Jan Van Rijswijcklaan,2023-06-04,19:00:00,40,25,15,FMN 11 A Jan Van Rijswijcklaan Ringfietspad
658,Ringfietspad Jan Van Rijswijcklaan,2023-06-04,20:00:00,23,11,12,FMN 11 A Jan Van Rijswijcklaan Ringfietspad
658,Ringfietspad Jan Van Rijswijcklaan,2023-06-04,21:00:00,13,6,7,FMN 11 A Jan Van Rijswijcklaan Ringfietspad
658,Ringfietspad Jan Van Rijswijcklaan,2023-06-04,22:00:00,9,3,6,FMN 11 A Jan Van Rijswijcklaan Ringfietspad
658,Ringfietspad Jan Van Rijswijcklaan,2023-06-04,23:00:00,5,3,2,FMN 11 A Jan Van Rijswijcklaan Ringfietspad
658,Ringfietspad Jan Van Rijswijcklaan,2023-06-05,00:00:00,2,1,1,FMN 11 A Jan Van Rijswijcklaan Ringfietspad
658,Ringfietspad Jan Van Rijswijcklaan,2023-06-05,01:00:00,0,0,0,FMN 11 A Jan Van Rijswijcklaan Ringfietspad
658,Ringfietspad Jan Van Rijswijcklaan,2023-06-05,02:00:00,0,0,0,FMN 11 A Jan Van Rijswijcklaan Ringfietspad
658,Ringfietspad Jan Van Rijswijcklaan,2023-06-05,03:00:00,0,0,0,FMN 11 A Jan Van Rijswijcklaan Ringfietspad
658,Ringfietspad Jan Van Rijswijcklaan,2023-06-05,04:00:00,6,3,3,FMN 11 A Jan Van Rijswijcklaan Ringfietspad
658,Ringfietspad Jan Van Rijswijcklaan,2023-06-05,05:00:00,19,7,12,FMN 11 A Jan Van Rijswijcklaan Ringfietspad
658,Ringfietspad Jan Van Rijswijcklaan,2023-06-05,06:00:00,49,10,39,FMN 11 A Jan Van Rijswijcklaan Ringfietspad
658,Ringfietspad Jan Van Rijswijcklaan,2023-06-05,07:00:00,124,44,80,FMN 11 A Jan Van Rijswijcklaan Ringfietspad
658,Ringfietspad Jan Van Rijswijcklaan,2023-06-05,08:00:00,148,47,101,FMN 11 A Jan Van Rijswijcklaan Ringfietspad
658,Ringfietspad Jan Van Rijswijcklaan,2023-06-05,09:00:00,51,18,33,FMN 11 A Jan Van Rijswijcklaan Ringfietspad
658,Ringfietspad Jan Van Rijswijcklaan,2023-06-05,10:00:00,31,16,15,FMN 11 A Jan Van Rijswijcklaan Ringfietspad
658,Ringfietspad Jan Van Rijswijcklaan,2023-06-05,11:00:00,41,22,19,FMN 11 A Jan Van Rijswijcklaan Ringfietspad
658,Ringfietspad Jan Van Rijswijcklaan,2023-06-05,12:00:00,58,31,27,FMN 11 A Jan Van Rijswijcklaan Ringfietspad
658,Ringfietspad Jan Van Rijswijcklaan,2023-06-05,13:00:00,53,28,25,FMN 11 A Jan Van Rijswijcklaan Ringfietspad
658,Ringfietspad Jan Van Rijswijcklaan,2023-06-05,14:00:00,61,43,18,FMN 11 A Jan Van Rijswijcklaan Ringfietspad
658,Ringfietspad Jan Van Rijswijcklaan,2023-06-05,15:00:00,80,49,31,FMN 11 A Jan Van Rijswijcklaan Ringfietspad
658,Ringfietspad Jan Van Rijswijcklaan,2023-06-05,16:00:00,147,104,43,FMN 11 A Jan Van Rijswijcklaan Ringfietspad
658,Ringfietspad Jan Van Rijswijcklaan,2023-06-05,17:00:00,147,100,47,FMN 11 A Jan Van Rijswijcklaan Ringfietspad
658,Ringfietspad Jan Van Rijswijcklaan,2023-06-05,18:00:00,77,48,29,FMN 11 A Jan Van Rijswijcklaan Ringfietspad
658,Ringfietspad Jan Van Rijswijcklaan,2023-06-05,19:00:00,36,22,14,FMN 11 A Jan Van Rijswijcklaan Ringfietspad
658,Ringfietspad Jan Van Rijswijcklaan,2023-06-05,20:00:00,30,15,15,FMN 11 A Jan Van Rijswijcklaan Ringfietspad
658,Ringfietspad Jan Van Rijswijcklaan,2023-06-05,21:00:00,21,11,10,FMN 11 A Jan Van Rijswijcklaan Ringfietspad
658,Ringfietspad Jan Van Rijswijcklaan,2023-06-05,22:00:00,22,11,11,FMN 11 A Jan Van Rijswijcklaan Ringfietspad
658,Ringfietspad Jan Van Rijswijcklaan,2023-06-05,23:00:00,3,1,2,FMN 11 A Jan Van Rijswijcklaan Ringfietspad
658,Ringfietspad Jan Van Rijswijcklaan,2023-06-06,00:00:00,0,0,0,FMN 11 A Jan Van Rijswijcklaan Ringfietspad
658,Ringfietspad Jan Van Rijswijcklaan,2023-06-06,01:00:00,1,0,1,FMN 11 A Jan Van Rijswijcklaan Ringfietspad
658,Ringfietspad Jan Van Rijswijcklaan,2023-06-06,02:00:00,3,2,1,FMN 11 A Jan Van Rijswijcklaan Ringfietspad
658,Ringfietspad Jan Van Rijswijcklaan,2023-06-06,03:00:00,0,0,0,FMN 11 A Jan Van Rijswijcklaan Ringfietspad
658,Ringfietspad Jan Van Rijswijcklaan,2023-06-06,04:00:00,3,1,2,FMN 11 A Jan Van Rijswijcklaan Ringfietspad
658,Ringfietspad Jan Van Rijswijcklaan,2023-06-06,05:00:00,34,10,24,FMN 11 A Jan Van Rijswijcklaan Ringfietspad
658,Ringfietspad Jan Van Rijswijcklaan,2023-06-06,06:00:00,86,18,68,FMN 11 A Jan Van Rijswijcklaan Ringfietspad
658,Ringfietspad Jan Van Rijswijcklaan,2023-06-06,07:00:00,160,53,107,FMN 11 A Jan Van Rijswijcklaan Ringfietspad
658,Ringfietspad Jan Van Rijswijcklaan,2023-06-06,08:00:00,196,58,138,FMN 11 A Jan Van Rijswijcklaan Ringfietspad
658,Ringfietspad Jan Van Rijswijcklaan,2023-06-06,09:00:00,76,34,42,FMN 11 A Jan Van Rijswijcklaan Ringfietspad
658,Ringfietspad Jan Van Rijswijcklaan,2023-06-06,10:00:00,45,19,26,FMN 11 A Jan Van Rijswijcklaan Ringfietspad
658,Ringfietspad Jan Van Rijswijcklaan,2023-06-06,11:00:00,42,24,18,FMN 11 A Jan Van Rijswijcklaan Ringfietspad
658,Ringfietspad Jan Van Rijswijcklaan,2023-06-06,12:00:00,55,25,30,FMN 11 A Jan Van Rijswijcklaan Ringfietspad
658,Ringfietspad Jan Van Rijswijcklaan,2023-06-06,13:00:00,70,40,30,FMN 11 A Jan Van Rijswijcklaan Ringfietspad
658,Ringfietspad Jan Van Rijswijcklaan,2023-06-06,14:00:00,76,41,35,FMN 11 A Jan Van Rijswijcklaan Ringfietspad
658,Ringfietspad Jan Van Rijswijcklaan,2023-06-06,15:00:00,108,75,33,FMN 11 A Jan Van Rijswijcklaan Ringfietspad
658,Ringfietspad Jan Van Rijswijcklaan,2023-06-06,16:00:00,181,117,64,FMN 11 A Jan Van Rijswijcklaan Ringfietspad
658,Ringfietspad Jan Van Rijswijcklaan,2023-06-06,17:00:00,192,124,68,FMN 11 A Jan Van Rijswijcklaan Ringfietspad
658,Ringfietspad Jan Van Rijswijcklaan,2023-06-06,18:00:00,120,73,47,FMN 11 A Jan Van Rijswijcklaan Ringfietspad
658,Ringfietspad Jan Van Rijswijcklaan,2023-06-06,19:00:00,45,25,20,FMN 11 A Jan Van Rijswijcklaan Ringfietspad
658,Ringfietspad Jan Van Rijswijcklaan,2023-06-06,20:00:00,40,19,21,FMN 11 A Jan Van Rijswijcklaan Ringfietspad
658,Ringfietspad Jan Van Rijswijcklaan,2023-06-06,21:00:00,25,11,14,FMN 11 A Jan Van Rijswijcklaan Ringfietspad
658,Ringfietspad Jan Van Rijswijcklaan,2023-06-06,22:00:00,21,11,10,FMN 11 A Jan Van Rijswijcklaan Ringfietspad
658,Ringfietspad Jan Van Rijswijcklaan,2023-06-06,23:00:00,9,4,5,FMN 11 A Jan Van Rijswijcklaan Ringfietspad
658,Ringfietspad Jan Van Rijswijcklaan,2023-06-07,00:00:00,0,0,0,FMN 11 A Jan Van Rijswijcklaan Ringfietspad
658,Ringfietspad Jan Van Rijswijcklaan,2023-06-07,01:00:00,2,0,2,FMN 11 A Jan Van Rijswijcklaan Ringfietspad
658,Ringfietspad Jan Van Rijswijcklaan,2023-06-07,02:00:00,3,1,2,FMN 11 A Jan Van Rijswijcklaan Ringfietspad
658,Ringfietspad Jan Van Rijswijcklaan,2023-06-07,03:00:00,1,1,0,FMN 11 A Jan Van Rijswijcklaan Ringfietspad
658,Ringfietspad Jan Van Rijswijcklaan,2023-06-07,04:00:00,9,6,3,FMN 11 A Jan Van Rijswijcklaan Ringfietspad
658,Ringfietspad Jan Van Rijswijcklaan,2023-06-07,05:00:00,29,9,20,FMN 11 A Jan Van Rijswijcklaan Ringfietspad
658,Ringfietspad Jan Van Rijswijcklaan,2023-06-07,06:00:00,75,19,56,FMN 11 A Jan Van Rijswijcklaan Ringfietspad
658,Ringfietspad Jan Van Rijswijcklaan,2023-06-07,07:00:00,139,46,93,FMN 11 A Jan Van Rijswijcklaan Ringfietspad
658,Ringfietspad Jan Van Rijswijcklaan,2023-06-07,08:00:00,175,70,105,FMN 11 A Jan Van Rijswijcklaan Ringfietspad
658,Ringfietspad Jan Van Rijswijcklaan,2023-06-07,09:00:00,68,26,42,FMN 11 A Jan Van Rijswijcklaan Ringfietspad
658,Ringfietspad Jan Van Rijswijcklaan,2023-06-07,10:00:00,49,24,25,FMN 11 A Jan Van Rijswijcklaan Ringfietspad
658,Ringfietspad Jan Van Rijswijcklaan,2023-06-07,11:00:00,46,27,19,FMN 11 A Jan Van Rijswijcklaan Ringfietspad
658,Ringfietspad Jan Van Rijswijcklaan,2023-06-07,12:00:00,89,43,46,FMN 11 A Jan Van Rijswijcklaan Ringfietspad
658,Ringfietspad Jan Van Rijswijcklaan,2023-06-07,13:00:00,77,43,34,FMN 11 A Jan Van Rijswijcklaan Ringfietspad
658,Ringfietspad Jan Van Rijswijcklaan,2023-06-07,14:00:00,80,40,40,FMN 11 A Jan Van Rijswijcklaan Ringfietspad
658,Ringfietspad Jan Van Rijswijcklaan,2023-06-07,15:00:00,102,68,34,FMN 11 A Jan Van Rijswijcklaan Ringfietspad
658,Ringfietspad Jan Van Rijswijcklaan,2023-06-07,16:00:00,138,99,39,FMN 11 A Jan Van Rijswijcklaan Ringfietspad
658,Ringfietspad Jan Van Rijswijcklaan,2023-06-07,17:00:00,172,117,55,FMN 11 A Jan Van Rijswijcklaan Ringfietspad
658,Ringfietspad Jan Van Rijswijcklaan,2023-06-07,18:00:00,105,61,44,FMN 11 A Jan Van Rijswijcklaan Ringfietspad
658,Ringfietspad Jan Van Rijswijcklaan,2023-06-07,19:00:00,57,32,25,FMN 11 A Jan Van Rijswijcklaan Ringfietspad
658,Ringfietspad Jan Van Rijswijcklaan,2023-06-07,20:00:00,36,20,16,FMN 11 A Jan Van Rijswijcklaan Ringfietspad
658,Ringfietspad Jan Van Rijswijcklaan,2023-06-07,21:00:00,28,15,13,FMN 11 A Jan Van Rijswijcklaan Ringfietspad
658,Ringfietspad Jan Van Rijswijcklaan,2023-06-07,22:00:00,19,14,5,FMN 11 A Jan Van Rijswijcklaan Ringfietspad
658,Ringfietspad Jan Van Rijswijcklaan,2023-06-07,23:00:00,5,2,3,FMN 11 A Jan Van Rijswijcklaan Ringfietspad
658,Ringfietspad Jan Van Rijswijcklaan,2023-06-08,00:00:00,8,6,2,FMN 11 A Jan Van Rijswijcklaan Ringfietspad
658,Ringfietspad Jan Van Rijswijcklaan,2023-06-08,01:00:00,0,0,0,FMN 11 A Jan Van Rijswijcklaan Ringfietspad
658,Ringfietspad Jan Van Rijswijcklaan,2023-06-08,02:00:00,1,1,0,FMN 11 A Jan Van Rijswijcklaan Ringfietspad
658,Ringfietspad Jan Van Rijswijcklaan,2023-06-08,03:00:00,3,3,0,FMN 11 A Jan Van Rijswijcklaan Ringfietspad
658,Ringfietspad Jan Van Rijswijcklaan,2023-06-08,04:00:00,14,3,11,FMN 11 A Jan Van Rijswijcklaan Ringfietspad
658,Ringfietspad Jan Van Rijswijcklaan,2023-06-08,05:00:00,37,9,28,FMN 11 A Jan Van Rijswijcklaan Ringfietspad
658,Ringfietspad Jan Van Rijswijcklaan,2023-06-08,06:00:00,78,17,61,FMN 11 A Jan Van Rijswijcklaan Ringfietspad
658,Ringfietspad Jan Van Rijswijcklaan,2023-06-08,07:00:00,148,51,97,FMN 11 A Jan Van Rijswijcklaan Ringfietspad
658,Ringfietspad Jan Van Rijswijcklaan,2023-06-08,08:00:00,195,71,124,FMN 11 A Jan Van Rijswijcklaan Ringfietspad
658,Ringfietspad Jan Van Rijswijcklaan,2023-06-08,09:00:00,80,23,57,FMN 11 A Jan Van Rijswijcklaan Ringfietspad
658,Ringfietspad Jan Van Rijswijcklaan,2023-06-08,10:00:00,48,23,25,FMN 11 A Jan Van Rijswijcklaan Ringfietspad
658,Ringfietspad Jan Van Rijswijcklaan,2023-06-08,11:00:00,52,28,24,FMN 11 A Jan Van Rijswijcklaan Ringfietspad
658,Ringfietspad Jan Van Rijswijcklaan,2023-06-08,12:00:00,74,38,36,FMN 11 A Jan Van Rijswijcklaan Ringfietspad
658,Ringfietspad Jan Van Rijswijcklaan,2023-06-08,13:00:00,69,31,38,FMN 11 A Jan Van Rijswijcklaan Ringfietspad
658,Ringfietspad Jan Van Rijswijcklaan,2023-06-08,14:00:00,70,42,28,FMN 11 A Jan Van Rijswijcklaan Ringfietspad
658,Ringfietspad Jan Van Rijswijcklaan,2023-06-08,15:00:00,114,75,39,FMN 11 A Jan Van Rijswijcklaan Ringfietspad
658,Ringfietspad Jan Van Rijswijcklaan,2023-06-08,16:00:00,190,124,66,FMN 11 A Jan Van Rijswijcklaan Ringfietspad
658,Ringfietspad Jan Van Rijswijcklaan,2023-06-08,17:00:00,172,112,60,FMN 11 A Jan Van Rijswijcklaan Ringfietspad
658,Ringfietspad Jan Van Rijswijcklaan,2023-06-08,18:00:00,122,68,54,FMN 11 A Jan Van Rijswijcklaan Ringfietspad
658,Ringfietspad Jan Van Rijswijcklaan,2023-06-08,19:00:00,66,36,30,FMN 11 A Jan Van Rijswijcklaan Ringfietspad
658,Ringfietspad Jan Van Rijswijcklaan,2023-06-08,20:00:00,43,27,16,FMN 11 A Jan Van Rijswijcklaan Ringfietspad
658,Ringfietspad Jan Van Rijswijcklaan,2023-06-08,21:00:00,22,9,13,FMN 11 A Jan Van Rijswijcklaan Ringfietspad
658,Ringfietspad Jan Van Rijswijcklaan,2023-06-08,22:00:00,21,16,5,FMN 11 A Jan Van Rijswijcklaan Ringfietspad
658,Ringfietspad Jan Van Rijswijcklaan,2023-06-08,23:00:00,11,8,3,FMN 11 A Jan Van Rijswijcklaan Ringfietspad
658,Ringfietspad Jan Van Rijswijcklaan,2023-06-09,00:00:00,4,3,1,FMN 11 A Jan Van Rijswijcklaan Ringfietspad
658,Ringfietspad Jan Van Rijswijcklaan,2023-06-09,01:00:00,2,1,1,FMN 11 A Jan Van Rijswijcklaan Ringfietspad
658,Ringfietspad Jan Van Rijswijcklaan,2023-06-09,02:00:00,4,3,1,FMN 11 A Jan Van Rijswijcklaan Ringfietspad
658,Ringfietspad Jan Van Rijswijcklaan,2023-06-09,03:00:00,3,2,1,FMN 11 A Jan Van Rijswijcklaan Ringfietspad
658,Ringfietspad Jan Van Rijswijcklaan,2023-06-09,04:00:00,7,5,2,FMN 11 A Jan Van Rijswijcklaan Ringfietspad
658,Ringfietspad Jan Van Rijswijcklaan,2023-06-09,05:00:00,28,5,23,FMN 11 A Jan Van Rijswijcklaan Ringfietspad
658,Ringfietspad Jan Van Rijswijcklaan,2023-06-09,06:00:00,75,21,54,FMN 11 A Jan Van Rijswijcklaan Ringfietspad
658,Ringfietspad Jan Van Rijswijcklaan,2023-06-09,07:00:00,132,46,86,FMN 11 A Jan Van Rijswijcklaan Ringfietspad
658,Ringfietspad Jan Van Rijswijcklaan,2023-06-09,08:00:00,172,49,123,FMN 11 A Jan Van Rijswijcklaan Ringfietspad
658,Ringfietspad Jan Van Rijswijcklaan,2023-06-09,09:00:00,82,35,47,FMN 11 A Jan Van Rijswijcklaan Ringfietspad
658,Ringfietspad Jan Van Rijswijcklaan,2023-06-09,10:00:00,59,26,33,FMN 11 A Jan Van Rijswijcklaan Ringfietspad
658,Ringfietspad Jan Van Rijswijcklaan,2023-06-09,11:00:00,64,27,37,FMN 11 A Jan Van Rijswijcklaan Ringfietspad
658,Ringfietspad Jan Van Rijswijcklaan,2023-06-09,12:00:00,74,33,41,FMN 11 A Jan Van Rijswijcklaan Ringfietspad
658,Ringfietspad Jan Van Rijswijcklaan,2023-06-09,13:00:00,77,42,35,FMN 11 A Jan Van Rijswijcklaan Ringfietspad
658,Ringfietspad Jan Van Rijswijcklaan,2023-06-09,14:00:00,87,56,31,FMN 11 A Jan Van Rijswijcklaan Ringfietspad
658,Ringfietspad Jan Van Rijswijcklaan,2023-06-09,15:00:00,129,89,40,FMN 11 A Jan Van Rijswijcklaan Ringfietspad
658,Ringfietspad Jan Van Rijswijcklaan,2023-06-09,16:00:00,158,106,52,FMN 11 A Jan Van Rijswijcklaan Ringfietspad
658,Ringfietspad Jan Van Rijswijcklaan,2023-06-09,17:00:00,148,100,48,FMN 11 A Jan Van Rijswijcklaan Ringfietspad
658,Ringfietspad Jan Van Rijswijcklaan,2023-06-09,18:00:00,91,53,38,FMN 11 A Jan Van Rijswijcklaan Ringfietspad
658,Ringfietspad Jan Van Rijswijcklaan,2023-06-09,19:00:00,63,32,31,FMN 11 A Jan Van Rijswijcklaan Ringfietspad
658,Ringfietspad Jan Van Rijswijcklaan,2023-06-09,20:00:00,32,17,15,FMN 11 A Jan Van Rijswijcklaan Ringfietspad
658,Ringfietspad Jan Van Rijswijcklaan,2023-06-09,21:00:00,24,9,15,FMN 11 A Jan Van Rijswijcklaan Ringfietspad
658,Ringfietspad Jan Van Rijswijcklaan,2023-06-09,22:00:00,25,16,9,FMN 11 A Jan Van Rijswijcklaan Ringfietspad
658,Ringfietspad Jan Van Rijswijcklaan,2023-06-09,23:00:00,16,7,9,FMN 11 A Jan Van Rijswijcklaan Ringfietspad
658,Ringfietspad Jan Van Rijswijcklaan,2023-06-10,00:00:00,5,2,3,FMN 11 A Jan Van Rijswijcklaan Ringfietspad
658,Ringfietspad Jan Van Rijswijcklaan,2023-06-10,01:00:00,7,5,2,FMN 11 A Jan Van Rijswijcklaan Ringfietspad
658,Ringfietspad Jan Van Rijswijcklaan,2023-06-10,02:00:00,3,3,0,FMN 11 A Jan Van Rijswijcklaan Ringfietspad
658,Ringfietspad Jan Van Rijswijcklaan,2023-06-10,03:00:00,7,4,3,FMN 11 A Jan Van Rijswijcklaan Ringfietspad
658,Ringfietspad Jan Van Rijswijcklaan,2023-06-10,04:00:00,3,2,1,FMN 11 A Jan Van Rijswijcklaan Ringfietspad
658,Ringfietspad Jan Van Rijswijcklaan,2023-06-10,05:00:00,7,3,4,FMN 11 A Jan Van Rijswijcklaan Ringfietspad
658,Ringfietspad Jan Van Rijswijcklaan,2023-06-10,06:00:00,9,6,3,FMN 11 A Jan Van Rijswijcklaan Ringfietspad
658,Ringfietspad Jan Van Rijswijcklaan,2023-06-10,07:00:00,16,7,9,FMN 11 A Jan Van Rijswijcklaan Ringfietspad
658,Ringfietspad Jan Van Rijswijcklaan,2023-06-10,08:00:00,21,7,14,FMN 11 A Jan Van Rijswijcklaan Ringfietspad
658,Ringfietspad Jan Van Rijswijcklaan,2023-06-10,09:00:00,53,27,26,FMN 11 A Jan Van Rijswijcklaan Ringfietspad
658,Ringfietspad Jan Van Rijswijcklaan,2023-06-10,10:00:00,68,32,36,FMN 11 A Jan Van Rijswijcklaan Ringfietspad
658,Ringfietspad Jan Van Rijswijcklaan,2023-06-10,11:00:00,62,28,34,FMN 11 A Jan Van Rijswijcklaan Ringfietspad
658,Ringfietspad Jan Van Rijswijcklaan,2023-06-10,12:00:00,70,38,32,FMN 11 A Jan Van Rijswijcklaan Ringfietspad
658,Ringfietspad Jan Van Rijswijcklaan,2023-06-10,13:00:00,86,43,43,FMN 11 A Jan Van Rijswijcklaan Ringfietspad
658,Ringfietspad Jan Van Rijswijcklaan,2023-06-10,14:00:00,113,63,50,FMN 11 A Jan Van Rijswijcklaan Ringfietspad
658,Ringfietspad Jan Van Rijswijcklaan,2023-06-10,15:00:00,87,48,39,FMN 11 A Jan Van Rijswijcklaan Ringfietspad
658,Ringfietspad Jan Van Rijswijcklaan,2023-06-10,16:00:00,81,50,31,FMN 11 A Jan Van Rijswijcklaan Ringfietspad
658,Ringfietspad Jan Van Rijswijcklaan,2023-06-10,17:00:00,67,31,36,FMN 11 A Jan Van Rijswijcklaan Ringfietspad
658,Ringfietspad Jan Van Rijswijcklaan,2023-06-10,18:00:00,50,31,19,FMN 11 A Jan Van Rijswijcklaan Ringfietspad
658,Ringfietspad Jan Van Rijswijcklaan,2023-06-10,19:00:00,31,14,17,FMN 11 A Jan Van Rijswijcklaan Ringfietspad
658,Ringfietspad Jan Van Rijswijcklaan,2023-06-10,20:00:00,29,14,15,FMN 11 A Jan Van Rijswijcklaan Ringfietspad
658,Ringfietspad Jan Van Rijswijcklaan,2023-06-10,21:00:00,22,16,6,FMN 11 A Jan Van Rijswijcklaan Ringfietspad
658,Ringfietspad Jan Van Rijswijcklaan,2023-06-10,22:00:00,12,7,5,FMN 11 A Jan Van Rijswijcklaan Ringfietspad
658,Ringfietspad Jan Van Rijswijcklaan,2023-06-10,23:00:00,8,4,4,FMN 11 A Jan Van Rijswijcklaan Ringfietspad
658,Ringfietspad Jan Van Rijswijcklaan,2023-06-11,00:00:00,2,2,0,FMN 11 A Jan Van Rijswijcklaan Ringfietspad
658,Ringfietspad Jan Van Rijswijcklaan,2023-06-11,01:00:00,1,1,0,FMN 11 A Jan Van Rijswijcklaan Ringfietspad
658,Ringfietspad Jan Van Rijswijcklaan,2023-06-11,02:00:00,0,0,0,FMN 11 A Jan Van Rijswijcklaan Ringfietspad
658,Ringfietspad Jan Van Rijswijcklaan,2023-06-11,03:00:00,0,0,0,FMN 11 A Jan Van Rijswijcklaan Ringfietspad
658,Ringfietspad Jan Van Rijswijcklaan,2023-06-11,04:00:00,0,0,0,FMN 11 A Jan Van Rijswijcklaan Ringfietspad
658,Ringfietspad Jan Van Rijswijcklaan,2023-06-11,05:00:00,1,0,1,FMN 11 A Jan Van Rijswijcklaan Ringfietspad
658,Ringfietspad Jan Van Rijswijcklaan,2023-06-11,06:00:00,11,7,4,FMN 11 A Jan Van Rijswijcklaan Ringfietspad
658,Ringfietspad Jan Van Rijswijcklaan,2023-06-11,07:00:00,4,1,3,FMN 11 A Jan Van Rijswijcklaan Ringfietspad
658,Ringfietspad Jan Van Rijswijcklaan,2023-06-11,08:00:00,24,12,12,FMN 11 A Jan Van Rijswijcklaan Ringfietspad
658,Ringfietspad Jan Van Rijswijcklaan,2023-06-11,09:00:00,39,14,25,FMN 11 A Jan Van Rijswijcklaan Ringfietspad
658,Ringfietspad Jan Van Rijswijcklaan,2023-06-11,10:00:00,48,19,29,FMN 11 A Jan Van Rijswijcklaan Ringfietspad
658,Ringfietspad Jan Van Rijswijcklaan,2023-06-11,11:00:00,62,36,26,FMN 11 A Jan Van Rijswijcklaan Ringfietspad
658,Ringfietspad Jan Van Rijswijcklaan,2023-06-11,12:00:00,66,39,27,FMN 11 A Jan Van Rijswijcklaan Ringfietspad
658,Ringfietspad Jan Van Rijswijcklaan,2023-06-11,13:00:00,100,50,50,FMN 11 A Jan Van Rijswijcklaan Ringfietspad
658,Ringfietspad Jan Van Rijswijcklaan,2023-06-11,14:00:00,77,35,42,FMN 11 A Jan Van Rijswijcklaan Ringfietspad
658,Ringfietspad Jan Van Rijswijcklaan,2023-06-11,15:00:00,81,54,27,FMN 11 A Jan Van Rijswijcklaan Ringfietspad
658,Ringfietspad Jan Van Rijswijcklaan,2023-06-11,16:00:00,76,43,33,FMN 11 A Jan Van Rijswijcklaan Ringfietspad
658,Ringfietspad Jan Van Rijswijcklaan,2023-06-11,17:00:00,45,31,14,FMN 11 A Jan Van Rijswijcklaan Ringfietspad
658,Ringfietspad Jan Van Rijswijcklaan,2023-06-11,18:00:00,27,19,8,FMN 11 A Jan Van Rijswijcklaan Ringfietspad
658,Ringfietspad Jan Van Rijswijcklaan,2023-06-11,19:00:00,28,20,8,FMN 11 A Jan Van Rijswijcklaan Ringfietspad
658,Ringfietspad Jan Van Rijswijcklaan,2023-06-11,20:00:00,18,9,9,FMN 11 A Jan Van Rijswijcklaan Ringfietspad
658,Ringfietspad Jan Van Rijswijcklaan,2023-06-11,21:00:00,16,10,6,FMN 11 A Jan Van Rijswijcklaan Ringfietspad
658,Ringfietspad Jan Van Rijswijcklaan,2023-06-11,22:00:00,6,4,2,FMN 11 A Jan Van Rijswijcklaan Ringfietspad
658,Ringfietspad Jan Van Rijswijcklaan,2023-06-11,23:00:00,5,3,2,FMN 11 A Jan Van Rijswijcklaan Ringfietspad
658,Ringfietspad Jan Van Rijswijcklaan,2023-06-12,00:00:00,2,1,1,FMN 11 A Jan Van Rijswijcklaan Ringfietspad
658,Ringfietspad Jan Van Rijswijcklaan,2023-06-12,01:00:00,1,0,1,FMN 11 A Jan Van Rijswijcklaan Ringfietspad
658,Ringfietspad Jan Van Rijswijcklaan,2023-06-12,02:00:00,0,0,0,FMN 11 A Jan Van Rijswijcklaan Ringfietspad
658,Ringfietspad Jan Van Rijswijcklaan,2023-06-12,03:00:00,1,0,1,FMN 11 A Jan Van Rijswijcklaan Ringfietspad
658,Ringfietspad Jan Van Rijswijcklaan,2023-06-12,04:00:00,5,4,1,FMN 11 A Jan Van Rijswijcklaan Ringfietspad
658,Ringfietspad Jan Van Rijswijcklaan,2023-06-12,05:00:00,33,6,27,FMN 11 A Jan Van Rijswijcklaan Ringfietspad
658,Ringfietspad Jan Van Rijswijcklaan,2023-06-12,06:00:00,69,19,50,FMN 11 A Jan Van Rijswijcklaan Ringfietspad
658,Ringfietspad Jan Van Rijswijcklaan,2023-06-12,07:00:00,148,50,98,FMN 11 A Jan Van Rijswijcklaan Ringfietspad
658,Ringfietspad Jan Van Rijswijcklaan,2023-06-12,08:00:00,180,54,126,FMN 11 A Jan Van Rijswijcklaan Ringfietspad
658,Ringfietspad Jan Van Rijswijcklaan,2023-06-12,09:00:00,63,22,41,FMN 11 A Jan Van Rijswijcklaan Ringfietspad
658,Ringfietspad Jan Van Rijswijcklaan,2023-06-12,10:00:00,47,20,27,FMN 11 A Jan Van Rijswijcklaan Ringfietspad
658,Ringfietspad Jan Van Rijswijcklaan,2023-06-12,11:00:00,41,16,25,FMN 11 A Jan Van Rijswijcklaan Ringfietspad
658,Ringfietspad Jan Van Rijswijcklaan,2023-06-12,12:00:00,63,30,33,FMN 11 A Jan Van Rijswijcklaan Ringfietspad
658,Ringfietspad Jan Van Rijswijcklaan,2023-06-12,13:00:00,67,39,28,FMN 11 A Jan Van Rijswijcklaan Ringfietspad
658,Ringfietspad Jan Van Rijswijcklaan,2023-06-12,14:00:00,83,52,31,FMN 11 A Jan Van Rijswijcklaan Ringfietspad
658,Ringfietspad Jan Van Rijswijcklaan,2023-06-12,15:00:00,107,68,39,FMN 11 A Jan Van Rijswijcklaan Ringfietspad
658,Ringfietspad Jan Van Rijswijcklaan,2023-06-12,16:00:00,175,116,59,FMN 11 A Jan Van Rijswijcklaan Ringfietspad
658,Ringfietspad Jan Van Rijswijcklaan,2023-06-12,17:00:00,184,118,66,FMN 11 A Jan Van Rijswijcklaan Ringfietspad
658,Ringfietspad Jan Van Rijswijcklaan,2023-06-12,18:00:00,106,61,45,FMN 11 A Jan Van Rijswijcklaan Ringfietspad
658,Ringfietspad Jan Van Rijswijcklaan,2023-06-12,19:00:00,49,26,23,FMN 11 A Jan Van Rijswijcklaan Ringfietspad
658,Ringfietspad Jan Van Rijswijcklaan,2023-06-12,20:00:00,31,17,14,FMN 11 A Jan Van Rijswijcklaan Ringfietspad
658,Ringfietspad Jan Van Rijswijcklaan,2023-06-12,21:00:00,26,14,12,FMN 11 A Jan Van Rijswijcklaan Ringfietspad
658,Ringfietspad Jan Van Rijswijcklaan,2023-06-12,22:00:00,17,10,7,FMN 11 A Jan Van Rijswijcklaan Ringfietspad
658,Ringfietspad Jan Van Rijswijcklaan,2023-06-12,23:00:00,9,3,6,FMN 11 A Jan Van Rijswijcklaan Ringfietspad
658,Ringfietspad Jan Van Rijswijcklaan,2023-06-13,00:00:00,3,3,0,FMN 11 A Jan Van Rijswijcklaan Ringfietspad
658,Ringfietspad Jan Van Rijswijcklaan,2023-06-13,01:00:00,1,0,1,FMN 11 A Jan Van Rijswijcklaan Ringfietspad
658,Ringfietspad Jan Van Rijswijcklaan,2023-06-13,02:00:00,1,0,1,FMN 11 A Jan Van Rijswijcklaan Ringfietspad
658,Ringfietspad Jan Van Rijswijcklaan,2023-06-13,03:00:00,0,0,0,FMN 11 A Jan Van Rijswijcklaan Ringfietspad
658,Ringfietspad Jan Van Rijswijcklaan,2023-06-13,04:00:00,9,5,4,FMN 11 A Jan Van Rijswijcklaan Ringfietspad
658,Ringfietspad Jan Van Rijswijcklaan,2023-06-13,05:00:00,37,12,25,FMN 11 A Jan Van Rijswijcklaan Ringfietspad
658,Ringfietspad Jan Van Rijswijcklaan,2023-06-13,06:00:00,85,23,62,FMN 11 A Jan Van Rijswijcklaan Ringfietspad
658,Ringfietspad Jan Van Rijswijcklaan,2023-06-13,07:00:00,157,51,106,FMN 11 A Jan Van Rijswijcklaan Ringfietspad
658,Ringfietspad Jan Van Rijswijcklaan,2023-06-13,08:00:00,209,75,134,FMN 11 A Jan Van Rijswijcklaan Ringfietspad
658,Ringfietspad Jan Van Rijswijcklaan,2023-06-13,09:00:00,84,28,56,FMN 11 A Jan Van Rijswijcklaan Ringfietspad
658,Ringfietspad Jan Van Rijswijcklaan,2023-06-13,10:00:00,43,20,23,FMN 11 A Jan Van Rijswijcklaan Ringfietspad
658,Ringfietspad Jan Van Rijswijcklaan,2023-06-13,11:00:00,50,26,24,FMN 11 A Jan Van Rijswijcklaan Ringfietspad
658,Ringfietspad Jan Van Rijswijcklaan,2023-06-13,12:00:00,59,32,27,FMN 11 A Jan Van Rijswijcklaan Ringfietspad
658,Ringfietspad Jan Van Rijswijcklaan,2023-06-13,13:00:00,87,48,39,FMN 11 A Jan Van Rijswijcklaan Ringfietspad
658,Ringfietspad Jan Van Rijswijcklaan,2023-06-13,14:00:00,71,44,27,FMN 11 A Jan Van Rijswijcklaan Ringfietspad
658,Ringfietspad Jan Van Rijswijcklaan,2023-06-13,15:00:00,113,79,34,FMN 11 A Jan Van Rijswijcklaan Ringfietspad
658,Ringfietspad Jan Van Rijswijcklaan,2023-06-13,16:00:00,182,120,62,FMN 11 A Jan Van Rijswijcklaan Ringfietspad
658,Ringfietspad Jan Van Rijswijcklaan,2023-06-13,17:00:00,186,123,63,FMN 11 A Jan Van Rijswijcklaan Ringfietspad
658,Ringfietspad Jan Van Rijswijcklaan,2023-06-13,18:00:00,131,79,52,FMN 11 A Jan Van Rijswijcklaan Ringfietspad
658,Ringfietspad Jan Van Rijswijcklaan,2023-06-13,19:00:00,53,34,19,FMN 11 A Jan Van Rijswijcklaan Ringfietspad
658,Ringfietspad Jan Van Rijswijcklaan,2023-06-13,20:00:00,31,16,15,FMN 11 A Jan Van Rijswijcklaan Ringfietspad
658,Ringfietspad Jan Van Rijswijcklaan,2023-06-13,21:00:00,24,10,14,FMN 11 A Jan Van Rijswijcklaan Ringfietspad
658,Ringfietspad Jan Van Rijswijcklaan,2023-06-13,22:00:00,25,20,5,FMN 11 A Jan Van Rijswijcklaan Ringfietspad
658,Ringfietspad Jan Van Rijswijcklaan,2023-06-13,23:00:00,7,6,1,FMN 11 A Jan Van Rijswijcklaan Ringfietspad
658,Ringfietspad Jan Van Rijswijcklaan,2023-06-14,00:00:00,3,2,1,FMN 11 A Jan Van Rijswijcklaan Ringfietspad
658,Ringfietspad Jan Van Rijswijcklaan,2023-06-14,01:00:00,0,0,0,FMN 11 A Jan Van Rijswijcklaan Ringfietspad
658,Ringfietspad Jan Van Rijswijcklaan,2023-06-14,02:00:00,0,0,0,FMN 11 A Jan Van Rijswijcklaan Ringfietspad
658,Ringfietspad Jan Van Rijswijcklaan,2023-06-14,03:00:00,3,1,2,FMN 11 A Jan Van Rijswijcklaan Ringfietspad
658,Ringfietspad Jan Van Rijswijcklaan,2023-06-14,04:00:00,12,2,10,FMN 11 A Jan Van Rijswijcklaan Ringfietspad
658,Ringfietspad Jan Van Rijswijcklaan,2023-06-14,05:00:00,34,10,24,FMN 11 A Jan Van Rijswijcklaan Ringfietspad
658,Ringfietspad Jan Van Rijswijcklaan,2023-06-14,06:00:00,68,17,51,FMN 11 A Jan Van Rijswijcklaan Ringfietspad
658,Ringfietspad Jan Van Rijswijcklaan,2023-06-14,07:00:00,141,52,89,FMN 11 A Jan Van Rijswijcklaan Ringfietspad
658,Ringfietspad Jan Van Rijswijcklaan,2023-06-14,08:00:00,162,58,104,FMN 11 A Jan Van Rijswijcklaan Ringfietspad
658,Ringfietspad Jan Van Rijswijcklaan,2023-06-14,09:00:00,68,26,42,FMN 11 A Jan Van Rijswijcklaan Ringfietspad
658,Ringfietspad Jan Van Rijswijcklaan,2023-06-14,10:00:00,42,18,24,FMN 11 A Jan Van Rijswijcklaan Ringfietspad
658,Ringfietspad Jan Van Rijswijcklaan,2023-06-14,11:00:00,65,35,30,FMN 11 A Jan Van Rijswijcklaan Ringfietspad
658,Ringfietspad Jan Van Rijswijcklaan,2023-06-14,12:00:00,79,39,40,FMN 11 A Jan Van Rijswijcklaan Ringfietspad
658,Ringfietspad Jan Van Rijswijcklaan,2023-06-14,13:00:00,61,29,32,FMN 11 A Jan Van Rijswijcklaan Ringfietspad
658,Ringfietspad Jan Van Rijswijcklaan,2023-06-14,14:00:00,88,50,38,FMN 11 A Jan Van Rijswijcklaan Ringfietspad
658,Ringfietspad Jan Van Rijswijcklaan,2023-06-14,15:00:00,100,69,31,FMN 11 A Jan Van Rijswijcklaan Ringfietspad
658,Ringfietspad Jan Van Rijswijcklaan,2023-06-14,16:00:00,169,114,55,FMN 11 A Jan Van Rijswijcklaan Ringfietspad
658,Ringfietspad Jan Van Rijswijcklaan,2023-06-14,17:00:00,177,115,62,FMN 11 A Jan Van Rijswijcklaan Ringfietspad
658,Ringfietspad Jan Van Rijswijcklaan,2023-06-14,18:00:00,99,58,41,FMN 11 A Jan Van Rijswijcklaan Ringfietspad
658,Ringfietspad Jan Van Rijswijcklaan,2023-06-14,19:00:00,57,29,28,FMN 11 A Jan Van Rijswijcklaan Ringfietspad
658,Ringfietspad Jan Van Rijswijcklaan,2023-06-14,20:00:00,38,20,18,FMN 11 A Jan Van Rijswijcklaan Ringfietspad
658,Ringfietspad Jan Van Rijswijcklaan,2023-06-14,21:00:00,29,15,14,FMN 11 A Jan Van Rijswijcklaan Ringfietspad
658,Ringfietspad Jan Van Rijswijcklaan,2023-06-14,22:00:00,25,16,9,FMN 11 A Jan Van Rijswijcklaan Ringfietspad
658,Ringfietspad Jan Van Rijswijcklaan,2023-06-14,23:00:00,13,9,4,FMN 11 A Jan Van Rijswijcklaan Ringfietspad
658,Ringfietspad Jan Van Rijswijcklaan,2023-06-15,00:00:00,8,3,5,FMN 11 A Jan Van Rijswijcklaan Ringfietspad
658,Ringfietspad Jan Van Rijswijcklaan,2023-06-15,01:00:00,4,2,2,FMN 11 A Jan Van Rijswijcklaan Ringfietspad
658,Ringfietspad Jan Van Rijswijcklaan,2023-06-15,02:00:00,0,0,0,FMN 11 A Jan Van Rijswijcklaan Ringfietspad
658,Ringfietspad Jan Van Rijswijcklaan,2023-06-15,03:00:00,1,1,0,FMN 11 A Jan Van Rijswijcklaan Ringfietspad
658,Ringfietspad Jan Van Rijswijcklaan,2023-06-15,04:00:00,7,3,4,FMN 11 A Jan Van Rijswijcklaan Ringfietspad
658,Ringfietspad Jan Van Rijswijcklaan,2023-06-15,05:00:00,36,14,22,FMN 11 A Jan Van Rijswijcklaan Ringfietspad
658,Ringfietspad Jan Van Rijswijcklaan,2023-06-15,06:00:00,72,23,49,FMN 11 A Jan Van Rijswijcklaan Ringfietspad
658,Ringfietspad Jan Van Rijswijcklaan,2023-06-15,07:00:00,135,50,85,FMN 11 A Jan Van Rijswijcklaan Ringfietspad
658,Ringfietspad Jan Van Rijswijcklaan,2023-06-15,08:00:00,185,61,124,FMN 11 A Jan Van Rijswijcklaan Ringfietspad
658,Ringfietspad Jan Van Rijswijcklaan,2023-06-15,09:00:00,84,31,53,FMN 11 A Jan Van Rijswijcklaan Ringfietspad
658,Ringfietspad Jan Van Rijswijcklaan,2023-06-15,10:00:00,52,22,30,FMN 11 A Jan Van Rijswijcklaan Ringfietspad
658,Ringfietspad Jan Van Rijswijcklaan,2023-06-15,11:00:00,33,12,21,FMN 11 A Jan Van Rijswijcklaan Ringfietspad
658,Ringfietspad Jan Van Rijswijcklaan,2023-06-15,12:00:00,68,34,34,FMN 11 A Jan Van Rijswijcklaan Ringfietspad
658,Ringfietspad Jan Van Rijswijcklaan,2023-06-15,13:00:00,79,43,36,FMN 11 A Jan Van Rijswijcklaan Ringfietspad
658,Ringfietspad Jan Van Rijswijcklaan,2023-06-15,14:00:00,79,52,27,FMN 11 A Jan Van Rijswijcklaan Ringfietspad
658,Ringfietspad Jan Van Rijswijcklaan,2023-06-15,15:00:00,96,65,31,FMN 11 A Jan Van Rijswijcklaan Ringfietspad
658,Ringfietspad Jan Van Rijswijcklaan,2023-06-15,16:00:00,171,114,57,FMN 11 A Jan Van Rijswijcklaan Ringfietspad
658,Ringfietspad Jan Van Rijswijcklaan,2023-06-15,17:00:00,170,112,58,FMN 11 A Jan Van Rijswijcklaan Ringfietspad
658,Ringfietspad Jan Van Rijswijcklaan,2023-06-15,18:00:00,112,70,42,FMN 11 A Jan Van Rijswijcklaan Ringfietspad
658,Ringfietspad Jan Van Rijswijcklaan,2023-06-15,19:00:00,53,31,22,FMN 11 A Jan Van Rijswijcklaan Ringfietspad
658,Ringfietspad Jan Van Rijswijcklaan,2023-06-15,20:00:00,42,22,20,FMN 11 A Jan Van Rijswijcklaan Ringfietspad
658,Ringfietspad Jan Van Rijswijcklaan,2023-06-15,21:00:00,19,10,9,FMN 11 A Jan Van Rijswijcklaan Ringfietspad
658,Ringfietspad Jan Van Rijswijcklaan,2023-06-15,22:00:00,23,17,6,FMN 11 A Jan Van Rijswijcklaan Ringfietspad
658,Ringfietspad Jan Van Rijswijcklaan,2023-06-15,23:00:00,17,14,3,FMN 11 A Jan Van Rijswijcklaan Ringfietspad
658,Ringfietspad Jan Van Rijswijcklaan,2023-06-16,00:00:00,8,4,4,FMN 11 A Jan Van Rijswijcklaan Ringfietspad
658,Ringfietspad Jan Van Rijswijcklaan,2023-06-16,01:00:00,6,4,2,FMN 11 A Jan Van Rijswijcklaan Ringfietspad
658,Ringfietspad Jan Van Rijswijcklaan,2023-06-16,02:00:00,2,2,0,FMN 11 A Jan Van Rijswijcklaan Ringfietspad
658,Ringfietspad Jan Van Rijswijcklaan,2023-06-16,03:00:00,2,2,0,FMN 11 A Jan Van Rijswijcklaan Ringfietspad
658,Ringfietspad Jan Van Rijswijcklaan,2023-06-16,04:00:00,6,2,4,FMN 11 A Jan Van Rijswijcklaan Ringfietspad
658,Ringfietspad Jan Van Rijswijcklaan,2023-06-16,05:00:00,20,6,14,FMN 11 A Jan Van Rijswijcklaan Ringfietspad
658,Ringfietspad Jan Van Rijswijcklaan,2023-06-16,06:00:00,62,15,47,FMN 11 A Jan Van Rijswijcklaan Ringfietspad
658,Ringfietspad Jan Van Rijswijcklaan,2023-06-16,07:00:00,121,43,78,FMN 11 A Jan Van Rijswijcklaan Ringfietspad
658,Ringfietspad Jan Van Rijswijcklaan,2023-06-16,08:00:00,189,63,126,FMN 11 A Jan Van Rijswijcklaan Ringfietspad
658,Ringfietspad Jan Van Rijswijcklaan,2023-06-16,09:00:00,81,36,45,FMN 11 A Jan Van Rijswijcklaan Ringfietspad
658,Ringfietspad Jan Van Rijswijcklaan,2023-06-16,10:00:00,58,25,33,FMN 11 A Jan Van Rijswijcklaan Ringfietspad
658,Ringfietspad Jan Van Rijswijcklaan,2023-06-16,11:00:00,56,26,30,FMN 11 A Jan Van Rijswijcklaan Ringfietspad
658,Ringfietspad Jan Van Rijswijcklaan,2023-06-16,12:00:00,74,38,36,FMN 11 A Jan Van Rijswijcklaan Ringfietspad
658,Ringfietspad Jan Van Rijswijcklaan,2023-06-16,13:00:00,74,32,42,FMN 11 A Jan Van Rijswijcklaan Ringfietspad
658,Ringfietspad Jan Van Rijswijcklaan,2023-06-16,14:00:00,85,51,34,FMN 11 A Jan Van Rijswijcklaan Ringfietspad
658,Ringfietspad Jan Van Rijswijcklaan,2023-06-16,15:00:00,138,89,49,FMN 11 A Jan Van Rijswijcklaan Ringfietspad
658,Ringfietspad Jan Van Rijswijcklaan,2023-06-16,16:00:00,175,114,61,FMN 11 A Jan Van Rijswijcklaan Ringfietspad
658,Ringfietspad Jan Van Rijswijcklaan,2023-06-16,17:00:00,142,93,49,FMN 11 A Jan Van Rijswijcklaan Ringfietspad
658,Ringfietspad Jan Van Rijswijcklaan,2023-06-16,18:00:00,100,60,40,FMN 11 A Jan Van Rijswijcklaan Ringfietspad
658,Ringfietspad Jan Van Rijswijcklaan,2023-06-16,19:00:00,55,33,22,FMN 11 A Jan Van Rijswijcklaan Ringfietspad
658,Ringfietspad Jan Van Rijswijcklaan,2023-06-16,20:00:00,31,14,17,FMN 11 A Jan Van Rijswijcklaan Ringfietspad
658,Ringfietspad Jan Van Rijswijcklaan,2023-06-16,21:00:00,27,13,14,FMN 11 A Jan Van Rijswijcklaan Ringfietspad
658,Ringfietspad Jan Van Rijswijcklaan,2023-06-16,22:00:00,25,16,9,FMN 11 A Jan Van Rijswijcklaan Ringfietspad
658,Ringfietspad Jan Van Rijswijcklaan,2023-06-16,23:00:00,12,7,5,FMN 11 A Jan Van Rijswijcklaan Ringfietspad
658,Ringfietspad Jan Van Rijswijcklaan,2023-06-17,00:00:00,8,5,3,FMN 11 A Jan Van Rijswijcklaan Ringfietspad
658,Ringfietspad Jan Van Rijswijcklaan,2023-06-17,01:00:00,3,2,1,FMN 11 A Jan Van Rijswijcklaan Ringfietspad
658,Ringfietspad Jan Van Rijswijcklaan,2023-06-17,02:00:00,7,4,3,FMN 11 A Jan Van Rijswijcklaan Ringfietspad
658,Ringfietspad Jan Van Rijswijcklaan,2023-06-17,03:00:00,4,2,2,FMN 11 A Jan Van Rijswijcklaan Ringfietspad
658,Ringfietspad Jan Van Rijswijcklaan,2023-06-17,04:00:00,4,1,3,FMN 11 A Jan Van Rijswijcklaan Ringfietspad
658,Ringfietspad Jan Van Rijswijcklaan,2023-06-17,05:00:00,7,3,4,FMN 11 A Jan Van Rijswijcklaan Ringfietspad
658,Ringfietspad Jan Van Rijswijcklaan,2023-06-17,06:00:00,13,7,6,FMN 11 A Jan Van Rijswijcklaan Ringfietspad
658,Ringfietspad Jan Van Rijswijcklaan,2023-06-17,07:00:00,15,6,9,FMN 11 A Jan Van Rijswijcklaan Ringfietspad
658,Ringfietspad Jan Van Rijswijcklaan,2023-06-17,08:00:00,27,14,13,FMN 11 A Jan Van Rijswijcklaan Ringfietspad
658,Ringfietspad Jan Van Rijswijcklaan,2023-06-17,09:00:00,44,17,27,FMN 11 A Jan Van Rijswijcklaan Ringfietspad
658,Ringfietspad Jan Van Rijswijcklaan,2023-06-17,10:00:00,68,27,41,FMN 11 A Jan Van Rijswijcklaan Ringfietspad
658,Ringfietspad Jan Van Rijswijcklaan,2023-06-17,11:00:00,60,29,31,FMN 11 A Jan Van Rijswijcklaan Ringfietspad
658,Ringfietspad Jan Van Rijswijcklaan,2023-06-17,12:00:00,69,33,36,FMN 11 A Jan Van Rijswijcklaan Ringfietspad
658,Ringfietspad Jan Van Rijswijcklaan,2023-06-17,13:00:00,88,42,46,FMN 11 A Jan Van Rijswijcklaan Ringfietspad
658,Ringfietspad Jan Van Rijswijcklaan,2023-06-17,14:00:00,96,46,50,FMN 11 A Jan Van Rijswijcklaan Ringfietspad
658,Ringfietspad Jan Van Rijswijcklaan,2023-06-17,15:00:00,87,45,42,FMN 11 A Jan Van Rijswijcklaan Ringfietspad
658,Ringfietspad Jan Van Rijswijcklaan,2023-06-17,16:00:00,85,54,31,FMN 11 A Jan Van Rijswijcklaan Ringfietspad
658,Ringfietspad Jan Van Rijswijcklaan,2023-06-17,17:00:00,61,34,27,FMN 11 A Jan Van Rijswijcklaan Ringfietspad
658,Ringfietspad Jan Van Rijswijcklaan,2023-06-17,18:00:00,44,27,17,FMN 11 A Jan Van Rijswijcklaan Ringfietspad
658,Ringfietspad Jan Van Rijswijcklaan,2023-06-17,19:00:00,30,12,18,FMN 11 A Jan Van Rijswijcklaan Ringfietspad
658,Ringfietspad Jan Van Rijswijcklaan,2023-06-17,20:00:00,25,13,12,FMN 11 A Jan Van Rijswijcklaan Ringfietspad
658,Ringfietspad Jan Van Rijswijcklaan,2023-06-17,21:00:00,15,9,6,FMN 11 A Jan Van Rijswijcklaan Ringfietspad
658,Ringfietspad Jan Van Rijswijcklaan,2023-06-17,22:00:00,25,15,10,FMN 11 A Jan Van Rijswijcklaan Ringfietspad
658,Ringfietspad Jan Van Rijswijcklaan,2023-06-17,23:00:00,11,5,6,FMN 11 A Jan Van Rijswijcklaan Ringfietspad
658,Ringfietspad Jan Van Rijswijcklaan,2023-06-18,00:00:00,5,3,2,FMN 11 A Jan Van Rijswijcklaan Ringfietspad
658,Ringfietspad Jan Van Rijswijcklaan,2023-06-18,01:00:00,4,2,2,FMN 11 A Jan Van Rijswijcklaan Ringfietspad
658,Ringfietspad Jan Van Rijswijcklaan,2023-06-18,02:00:00,0,0,0,FMN 11 A Jan Van Rijswijcklaan Ringfietspad
658,Ringfietspad Jan Van Rijswijcklaan,2023-06-18,03:00:00,2,0,2,FMN 11 A Jan Van Rijswijcklaan Ringfietspad
658,Ringfietspad Jan Van Rijswijcklaan,2023-06-18,04:00:00,1,0,1,FMN 11 A Jan Van Rijswijcklaan Ringfietspad
658,Ringfietspad Jan Van Rijswijcklaan,2023-06-18,05:00:00,5,1,4,FMN 11 A Jan Van Rijswijcklaan Ringfietspad
658,Ringfietspad Jan Van Rijswijcklaan,2023-06-18,06:00:00,4,1,3,FMN 11 A Jan Van Rijswijcklaan Ringfietspad
658,Ringfietspad Jan Van Rijswijcklaan,2023-06-18,07:00:00,5,2,3,FMN 11 A Jan Van Rijswijcklaan Ringfietspad
658,Ringfietspad Jan Van Rijswijcklaan,2023-06-18,08:00:00,18,5,13,FMN 11 A Jan Van Rijswijcklaan Ringfietspad
658,Ringfietspad Jan Van Rijswijcklaan,2023-06-18,09:00:00,26,16,10,FMN 11 A Jan Van Rijswijcklaan Ringfietspad
658,Ringfietspad Jan Van Rijswijcklaan,2023-06-18,10:00:00,45,22,23,FMN 11 A Jan Van Rijswijcklaan Ringfietspad
658,Ringfietspad Jan Van Rijswijcklaan,2023-06-18,11:00:00,49,20,29,FMN 11 A Jan Van Rijswijcklaan Ringfietspad
658,Ringfietspad Jan Van Rijswijcklaan,2023-06-18,12:00:00,60,37,23,FMN 11 A Jan Van Rijswijcklaan Ringfietspad
658,Ringfietspad Jan Van Rijswijcklaan,2023-06-18,13:00:00,68,33,35,FMN 11 A Jan Van Rijswijcklaan Ringfietspad
658,Ringfietspad Jan Van Rijswijcklaan,2023-06-18,14:00:00,70,34,36,FMN 11 A Jan Van Rijswijcklaan Ringfietspad
658,Ringfietspad Jan Van Rijswijcklaan,2023-06-18,15:00:00,65,35,30,FMN 11 A Jan Van Rijswijcklaan Ringfietspad
658,Ringfietspad Jan Van Rijswijcklaan,2023-06-18,16:00:00,59,33,26,FMN 11 A Jan Van Rijswijcklaan Ringfietspad
658,Ringfietspad Jan Van Rijswijcklaan,2023-06-18,17:00:00,39,26,13,FMN 11 A Jan Van Rijswijcklaan Ringfietspad
658,Ringfietspad Jan Van Rijswijcklaan,2023-06-18,18:00:00,27,17,10,FMN 11 A Jan Van Rijswijcklaan Ringfietspad
658,Ringfietspad Jan Van Rijswijcklaan,2023-06-18,19:00:00,22,11,11,FMN 11 A Jan Van Rijswijcklaan Ringfietspad
658,Ringfietspad Jan Van Rijswijcklaan,2023-06-18,20:00:00,22,10,12,FMN 11 A Jan Van Rijswijcklaan Ringfietspad
658,Ringfietspad Jan Van Rijswijcklaan,2023-06-18,21:00:00,10,4,6,FMN 11 A Jan Van Rijswijcklaan Ringfietspad
658,Ringfietspad Jan Van Rijswijcklaan,2023-06-18,22:00:00,7,2,5,FMN 11 A Jan Van Rijswijcklaan Ringfietspad
658,Ringfietspad Jan Van Rijswijcklaan,2023-06-18,23:00:00,7,2,5,FMN 11 A Jan Van Rijswijcklaan Ringfietspad
658,Ringfietspad Jan Van Rijswijcklaan,2023-06-19,00:00:00,2,1,1,FMN 11 A Jan Van Rijswijcklaan Ringfietspad
658,Ringfietspad Jan Van Rijswijcklaan,2023-06-19,01:00:00,2,0,2,FMN 11 A Jan Van Rijswijcklaan Ringfietspad
658,Ringfietspad Jan Van Rijswijcklaan,2023-06-19,02:00:00,2,2,0,FMN 11 A Jan Van Rijswijcklaan Ringfietspad
658,Ringfietspad Jan Van Rijswijcklaan,2023-06-19,03:00:00,1,1,0,FMN 11 A Jan Van Rijswijcklaan Ringfietspad
658,Ringfietspad Jan Van Rijswijcklaan,2023-06-19,04:00:00,14,8,6,FMN 11 A Jan Van Rijswijcklaan Ringfietspad
658,Ringfietspad Jan Van Rijswijcklaan,2023-06-19,05:00:00,23,6,17,FMN 11 A Jan Van Rijswijcklaan Ringfietspad
658,Ringfietspad Jan Van Rijswijcklaan,2023-06-19,06:00:00,62,16,46,FMN 11 A Jan Van Rijswijcklaan Ringfietspad
658,Ringfietspad Jan Van Rijswijcklaan,2023-06-19,07:00:00,148,50,98,FMN 11 A Jan Van Rijswijcklaan Ringfietspad
658,Ringfietspad Jan Van Rijswijcklaan,2023-06-19,08:00:00,169,56,113,FMN 11 A Jan Van Rijswijcklaan Ringfietspad
658,Ringfietspad Jan Van Rijswijcklaan,2023-06-19,09:00:00,66,28,38,FMN 11 A Jan Van Rijswijcklaan Ringfietspad
658,Ringfietspad Jan Van Rijswijcklaan,2023-06-19,10:00:00,48,23,25,FMN 11 A Jan Van Rijswijcklaan Ringfietspad
658,Ringfietspad Jan Van Rijswijcklaan,2023-06-19,11:00:00,44,30,14,FMN 11 A Jan Van Rijswijcklaan Ringfietspad
658,Ringfietspad Jan Van Rijswijcklaan,2023-06-19,12:00:00,62,26,36,FMN 11 A Jan Van Rijswijcklaan Ringfietspad
658,Ringfietspad Jan Van Rijswijcklaan,2023-06-19,13:00:00,72,30,42,FMN 11 A Jan Van Rijswijcklaan Ringfietspad
658,Ringfietspad Jan Van Rijswijcklaan,2023-06-19,14:00:00,73,40,33,FMN 11 A Jan Van Rijswijcklaan Ringfietspad
658,Ringfietspad Jan Van Rijswijcklaan,2023-06-19,15:00:00,104,69,35,FMN 11 A Jan Van Rijswijcklaan Ringfietspad
658,Ringfietspad Jan Van Rijswijcklaan,2023-06-19,16:00:00,162,109,53,FMN 11 A Jan Van Rijswijcklaan Ringfietspad
658,Ringfietspad Jan Van Rijswijcklaan,2023-06-19,17:00:00,179,117,62,FMN 11 A Jan Van Rijswijcklaan Ringfietspad
658,Ringfietspad Jan Van Rijswijcklaan,2023-06-19,18:00:00,95,59,36,FMN 11 A Jan Van Rijswijcklaan Ringfietspad
658,Ringfietspad Jan Van Rijswijcklaan,2023-06-19,19:00:00,37,17,20,FMN 11 A Jan Van Rijswijcklaan Ringfietspad
658,Ringfietspad Jan Van Rijswijcklaan,2023-06-19,20:00:00,35,17,18,FMN 11 A Jan Van Rijswijcklaan Ringfietspad
658,Ringfietspad Jan Van Rijswijcklaan,2023-06-19,21:00:00,15,10,5,FMN 11 A Jan Van Rijswijcklaan Ringfietspad
658,Ringfietspad Jan Van Rijswijcklaan,2023-06-19,22:00:00,17,13,4,FMN 11 A Jan Van Rijswijcklaan Ringfietspad
658,Ringfietspad Jan Van Rijswijcklaan,2023-06-19,23:00:00,3,2,1,FMN 11 A Jan Van Rijswijcklaan Ringfietspad
658,Ringfietspad Jan Van Rijswijcklaan,2023-06-20,00:00:00,2,0,2,FMN 11 A Jan Van Rijswijcklaan Ringfietspad
658,Ringfietspad Jan Van Rijswijcklaan,2023-06-20,01:00:00,1,0,1,FMN 11 A Jan Van Rijswijcklaan Ringfietspad
658,Ringfietspad Jan Van Rijswijcklaan,2023-06-20,02:00:00,1,0,1,FMN 11 A Jan Van Rijswijcklaan Ringfietspad
658,Ringfietspad Jan Van Rijswijcklaan,2023-06-20,03:00:00,3,2,1,FMN 11 A Jan Van Rijswijcklaan Ringfietspad
658,Ringfietspad Jan Van Rijswijcklaan,2023-06-20,04:00:00,7,3,4,FMN 11 A Jan Van Rijswijcklaan Ringfietspad
658,Ringfietspad Jan Van Rijswijcklaan,2023-06-20,05:00:00,27,9,18,FMN 11 A Jan Van Rijswijcklaan Ringfietspad
658,Ringfietspad Jan Van Rijswijcklaan,2023-06-20,06:00:00,72,15,57,FMN 11 A Jan Van Rijswijcklaan Ringfietspad
658,Ringfietspad Jan Van Rijswijcklaan,2023-06-20,07:00:00,132,51,81,FMN 11 A Jan Van Rijswijcklaan Ringfietspad
658,Ringfietspad Jan Van Rijswijcklaan,2023-06-20,08:00:00,161,54,107,FMN 11 A Jan Van Rijswijcklaan Ringfietspad
658,Ringfietspad Jan Van Rijswijcklaan,2023-06-20,09:00:00,46,18,28,FMN 11 A Jan Van Rijswijcklaan Ringfietspad
658,Ringfietspad Jan Van Rijswijcklaan,2023-06-20,10:00:00,48,22,26,FMN 11 A Jan Van Rijswijcklaan Ringfietspad
658,Ringfietspad Jan Van Rijswijcklaan,2023-06-20,11:00:00,60,27,33,FMN 11 A Jan Van Rijswijcklaan Ringfietspad
658,Ringfietspad Jan Van Rijswijcklaan,2023-06-20,12:00:00,57,29,28,FMN 11 A Jan Van Rijswijcklaan Ringfietspad
658,Ringfietspad Jan Van Rijswijcklaan,2023-06-20,13:00:00,56,29,27,FMN 11 A Jan Van Rijswijcklaan Ringfietspad
658,Ringfietspad Jan Van Rijswijcklaan,2023-06-20,14:00:00,50,28,22,FMN 11 A Jan Van Rijswijcklaan Ringfietspad
658,Ringfietspad Jan Van Rijswijcklaan,2023-06-20,15:00:00,87,61,26,FMN 11 A Jan Van Rijswijcklaan Ringfietspad
658,Ringfietspad Jan Van Rijswijcklaan,2023-06-20,16:00:00,137,98,39,FMN 11 A Jan Van Rijswijcklaan Ringfietspad
658,Ringfietspad Jan Van Rijswijcklaan,2023-06-20,17:00:00,160,108,52,FMN 11 A Jan Van Rijswijcklaan Ringfietspad
658,Ringfietspad Jan Van Rijswijcklaan,2023-06-20,18:00:00,95,53,42,FMN 11 A Jan Van Rijswijcklaan Ringfietspad
658,Ringfietspad Jan Van Rijswijcklaan,2023-06-20,19:00:00,31,16,15,FMN 11 A Jan Van Rijswijcklaan Ringfietspad
658,Ringfietspad Jan Van Rijswijcklaan,2023-06-20,20:00:00,30,14,16,FMN 11 A Jan Van Rijswijcklaan Ringfietspad
658,Ringfietspad Jan Van Rijswijcklaan,2023-06-20,21:00:00,21,9,12,FMN 11 A Jan Van Rijswijcklaan Ringfietspad
658,Ringfietspad Jan Van Rijswijcklaan,2023-06-20,22:00:00,15,8,7,FMN 11 A Jan Van Rijswijcklaan Ringfietspad
658,Ringfietspad Jan Van Rijswijcklaan,2023-06-20,23:00:00,8,5,3,FMN 11 A Jan Van Rijswijcklaan Ringfietspad
658,Ringfietspad Jan Van Rijswijcklaan,2023-06-21,00:00:00,4,2,2,FMN 11 A Jan Van Rijswijcklaan Ringfietspad
658,Ringfietspad Jan Van Rijswijcklaan,2023-06-21,01:00:00,2,2,0,FMN 11 A Jan Van Rijswijcklaan Ringfietspad
658,Ringfietspad Jan Van Rijswijcklaan,2023-06-21,02:00:00,1,0,1,FMN 11 A Jan Van Rijswijcklaan Ringfietspad
658,Ringfietspad Jan Van Rijswijcklaan,2023-06-21,03:00:00,1,1,0,FMN 11 A Jan Van Rijswijcklaan Ringfietspad
658,Ringfietspad Jan Van Rijswijcklaan,2023-06-21,04:00:00,7,2,5,FMN 11 A Jan Van Rijswijcklaan Ringfietspad
658,Ringfietspad Jan Van Rijswijcklaan,2023-06-21,05:00:00,35,10,25,FMN 11 A Jan Van Rijswijcklaan Ringfietspad
658,Ringfietspad Jan Van Rijswijcklaan,2023-06-21,06:00:00,80,19,61,FMN 11 A Jan Van Rijswijcklaan Ringfietspad
658,Ringfietspad Jan Van Rijswijcklaan,2023-06-21,07:00:00,146,49,97,FMN 11 A Jan Van Rijswijcklaan Ringfietspad
658,Ringfietspad Jan Van Rijswijcklaan,2023-06-21,08:00:00,175,57,118,FMN 11 A Jan Van Rijswijcklaan Ringfietspad
658,Ringfietspad Jan Van Rijswijcklaan,2023-06-21,09:00:00,70,24,46,FMN 11 A Jan Van Rijswijcklaan Ringfietspad
658,Ringfietspad Jan Van Rijswijcklaan,2023-06-21,10:00:00,53,27,26,FMN 11 A Jan Van Rijswijcklaan Ringfietspad
658,Ringfietspad Jan Van Rijswijcklaan,2023-06-21,11:00:00,47,27,20,FMN 11 A Jan Van Rijswijcklaan Ringfietspad
658,Ringfietspad Jan Van Rijswijcklaan,2023-06-21,12:00:00,76,43,33,FMN 11 A Jan Van Rijswijcklaan Ringfietspad
658,Ringfietspad Jan Van Rijswijcklaan,2023-06-21,13:00:00,69,33,36,FMN 11 A Jan Van Rijswijcklaan Ringfietspad
658,Ringfietspad Jan Van Rijswijcklaan,2023-06-21,14:00:00,100,56,44,FMN 11 A Jan Van Rijswijcklaan Ringfietspad
658,Ringfietspad Jan Van Rijswijcklaan,2023-06-21,15:00:00,114,77,37,FMN 11 A Jan Van Rijswijcklaan Ringfietspad
658,Ringfietspad Jan Van Rijswijcklaan,2023-06-21,16:00:00,173,113,60,FMN 11 A Jan Van Rijswijcklaan Ringfietspad
658,Ringfietspad Jan Van Rijswijcklaan,2023-06-21,17:00:00,181,117,64,FMN 11 A Jan Van Rijswijcklaan Ringfietspad
658,Ringfietspad Jan Van Rijswijcklaan,2023-06-21,18:00:00,111,61,50,FMN 11 A Jan Van Rijswijcklaan Ringfietspad
658,Ringfietspad Jan Van Rijswijcklaan,2023-06-21,19:00:00,52,27,25,FMN 11 A Jan Van Rijswijcklaan Ringfietspad
658,Ringfietspad Jan Van Rijswijcklaan,2023-06-21,20:00:00,43,21,22,FMN 11 A Jan Van Rijswijcklaan Ringfietspad
658,Ringfietspad Jan Van Rijswijcklaan,2023-06-21,21:00:00,24,13,11,FMN 11 A Jan Van Rijswijcklaan Ringfietspad
658,Ringfietspad Jan Van Rijswijcklaan,2023-06-21,22:00:00,32,21,11,FMN 11 A Jan Van Rijswijcklaan Ringfietspad
658,Ringfietspad Jan Van Rijswijcklaan,2023-06-21,23:00:00,14,9,5,FMN 11 A Jan Van Rijswijcklaan Ringfietspad
658,Ringfietspad Jan Van Rijswijcklaan,2023-06-22,00:00:00,2,2,0,FMN 11 A Jan Van Rijswijcklaan Ringfietspad
658,Ringfietspad Jan Van Rijswijcklaan,2023-06-22,01:00:00,0,0,0,FMN 11 A Jan Van Rijswijcklaan Ringfietspad
658,Ringfietspad Jan Van Rijswijcklaan,2023-06-22,02:00:00,0,0,0,FMN 11 A Jan Van Rijswijcklaan Ringfietspad
658,Ringfietspad Jan Van Rijswijcklaan,2023-06-22,03:00:00,1,1,0,FMN 11 A Jan Van Rijswijcklaan Ringfietspad
658,Ringfietspad Jan Van Rijswijcklaan,2023-06-22,04:00:00,7,4,3,FMN 11 A Jan Van Rijswijcklaan Ringfietspad
658,Ringfietspad Jan Van Rijswijcklaan,2023-06-22,05:00:00,26,6,20,FMN 11 A Jan Van Rijswijcklaan Ringfietspad
658,Ringfietspad Jan Van Rijswijcklaan,2023-06-22,06:00:00,58,15,43,FMN 11 A Jan Van Rijswijcklaan Ringfietspad
658,Ringfietspad Jan Van Rijswijcklaan,2023-06-22,07:00:00,102,38,64,FMN 11 A Jan Van Rijswijcklaan Ringfietspad
658,Ringfietspad Jan Van Rijswijcklaan,2023-06-22,08:00:00,148,48,100,FMN 11 A Jan Van Rijswijcklaan Ringfietspad
658,Ringfietspad Jan Van Rijswijcklaan,2023-06-22,09:00:00,54,22,32,FMN 11 A Jan Van Rijswijcklaan Ringfietspad
658,Ringfietspad Jan Van Rijswijcklaan,2023-06-22,10:00:00,36,19,17,FMN 11 A Jan Van Rijswijcklaan Ringfietspad
658,Ringfietspad Jan Van Rijswijcklaan,2023-06-22,11:00:00,43,19,24,FMN 11 A Jan Van Rijswijcklaan Ringfietspad
658,Ringfietspad Jan Van Rijswijcklaan,2023-06-22,12:00:00,57,31,26,FMN 11 A Jan Van Rijswijcklaan Ringfietspad
658,Ringfietspad Jan Van Rijswijcklaan,2023-06-22,13:00:00,48,22,26,FMN 11 A Jan Van Rijswijcklaan Ringfietspad
658,Ringfietspad Jan Van Rijswijcklaan,2023-06-22,14:00:00,65,32,33,FMN 11 A Jan Van Rijswijcklaan Ringfietspad
658,Ringfietspad Jan Van Rijswijcklaan,2023-06-22,15:00:00,82,53,29,FMN 11 A Jan Van Rijswijcklaan Ringfietspad
658,Ringfietspad Jan Van Rijswijcklaan,2023-06-22,16:00:00,139,94,45,FMN 11 A Jan Van Rijswijcklaan Ringfietspad
658,Ringfietspad Jan Van Rijswijcklaan,2023-06-22,17:00:00,132,80,52,FMN 11 A Jan Van Rijswijcklaan Ringfietspad
658,Ringfietspad Jan Van Rijswijcklaan,2023-06-22,18:00:00,79,47,32,FMN 11 A Jan Van Rijswijcklaan Ringfietspad
658,Ringfietspad Jan Van Rijswijcklaan,2023-06-22,19:00:00,45,26,19,FMN 11 A Jan Van Rijswijcklaan Ringfietspad
658,Ringfietspad Jan Van Rijswijcklaan,2023-06-22,20:00:00,35,14,21,FMN 11 A Jan Van Rijswijcklaan Ringfietspad
658,Ringfietspad Jan Van Rijswijcklaan,2023-06-22,21:00:00,18,8,10,FMN 11 A Jan Van Rijswijcklaan Ringfietspad
658,Ringfietspad Jan Van Rijswijcklaan,2023-06-22,22:00:00,22,16,6,FMN 11 A Jan Van Rijswijcklaan Ringfietspad
658,Ringfietspad Jan Van Rijswijcklaan,2023-06-22,23:00:00,5,4,1,FMN 11 A Jan Van Rijswijcklaan Ringfietspad
658,Ringfietspad Jan Van Rijswijcklaan,2023-06-23,00:00:00,5,3,2,FMN 11 A Jan Van Rijswijcklaan Ringfietspad
658,Ringfietspad Jan Van Rijswijcklaan,2023-06-23,01:00:00,2,2,0,FMN 11 A Jan Van Rijswijcklaan Ringfietspad
658,Ringfietspad Jan Van Rijswijcklaan,2023-06-23,02:00:00,2,2,0,FMN 11 A Jan Van Rijswijcklaan Ringfietspad
658,Ringfietspad Jan Van Rijswijcklaan,2023-06-23,03:00:00,2,2,0,FMN 11 A Jan Van Rijswijcklaan Ringfietspad
658,Ringfietspad Jan Van Rijswijcklaan,2023-06-23,04:00:00,7,4,3,FMN 11 A Jan Van Rijswijcklaan Ringfietspad
658,Ringfietspad Jan Van Rijswijcklaan,2023-06-23,05:00:00,29,9,20,FMN 11 A Jan Van Rijswijcklaan Ringfietspad
658,Ringfietspad Jan Van Rijswijcklaan,2023-06-23,06:00:00,68,21,47,FMN 11 A Jan Van Rijswijcklaan Ringfietspad
658,Ringfietspad Jan Van Rijswijcklaan,2023-06-23,07:00:00,128,45,83,FMN 11 A Jan Van Rijswijcklaan Ringfietspad
658,Ringfietspad Jan Van Rijswijcklaan,2023-06-23,08:00:00,188,66,122,FMN 11 A Jan Van Rijswijcklaan Ringfietspad
658,Ringfietspad Jan Van Rijswijcklaan,2023-06-23,09:00:00,73,28,45,FMN 11 A Jan Van Rijswijcklaan Ringfietspad
658,Ringfietspad Jan Van Rijswijcklaan,2023-06-23,10:00:00,59,28,31,FMN 11 A Jan Van Rijswijcklaan Ringfietspad
658,Ringfietspad Jan Van Rijswijcklaan,2023-06-23,11:00:00,58,24,34,FMN 11 A Jan Van Rijswijcklaan Ringfietspad
658,Ringfietspad Jan Van Rijswijcklaan,2023-06-23,12:00:00,83,47,36,FMN 11 A Jan Van Rijswijcklaan Ringfietspad
658,Ringfietspad Jan Van Rijswijcklaan,2023-06-23,13:00:00,78,39,39,FMN 11 A Jan Van Rijswijcklaan Ringfietspad
658,Ringfietspad Jan Van Rijswijcklaan,2023-06-23,14:00:00,99,61,38,FMN 11 A Jan Van Rijswijcklaan Ringfietspad
658,Ringfietspad Jan Van Rijswijcklaan,2023-06-23,15:00:00,131,80,51,FMN 11 A Jan Van Rijswijcklaan Ringfietspad
658,Ringfietspad Jan Van Rijswijcklaan,2023-06-23,16:00:00,173,116,57,FMN 11 A Jan Van Rijswijcklaan Ringfietspad
658,Ringfietspad Jan Van Rijswijcklaan,2023-06-23,17:00:00,161,105,56,FMN 11 A Jan Van Rijswijcklaan Ringfietspad
658,Ringfietspad Jan Van Rijswijcklaan,2023-06-23,18:00:00,85,49,36,FMN 11 A Jan Van Rijswijcklaan Ringfietspad
658,Ringfietspad Jan Van Rijswijcklaan,2023-06-23,19:00:00,63,33,30,FMN 11 A Jan Van Rijswijcklaan Ringfietspad
658,Ringfietspad Jan Van Rijswijcklaan,2023-06-23,20:00:00,29,14,15,FMN 11 A Jan Van Rijswijcklaan Ringfietspad
658,Ringfietspad Jan Van Rijswijcklaan,2023-06-23,21:00:00,20,11,9,FMN 11 A Jan Van Rijswijcklaan Ringfietspad
658,Ringfietspad Jan Van Rijswijcklaan,2023-06-23,22:00:00,24,12,12,FMN 11 A Jan Van Rijswijcklaan Ringfietspad
658,Ringfietspad Jan Van Rijswijcklaan,2023-06-23,23:00:00,13,6,7,FMN 11 A Jan Van Rijswijcklaan Ringfietspad
658,Ringfietspad Jan Van Rijswijcklaan,2023-06-24,00:00:00,9,5,4,FMN 11 A Jan Van Rijswijcklaan Ringfietspad
658,Ringfietspad Jan Van Rijswijcklaan,2023-06-24,01:00:00,7,4,3,FMN 11 A Jan Van Rijswijcklaan Ringfietspad
658,Ringfietspad Jan Van Rijswijcklaan,2023-06-24,02:00:00,6,5,1,FMN 11 A Jan Van Rijswijcklaan Ringfietspad
658,Ringfietspad Jan Van Rijswijcklaan,2023-06-24,03:00:00,3,3,0,FMN 11 A Jan Van Rijswijcklaan Ringfietspad
658,Ringfietspad Jan Van Rijswijcklaan,2023-06-24,04:00:00,5,1,4,FMN 11 A Jan Van Rijswijcklaan Ringfietspad
658,Ringfietspad Jan Van Rijswijcklaan,2023-06-24,05:00:00,7,2,5,FMN 11 A Jan Van Rijswijcklaan Ringfietspad
658,Ringfietspad Jan Van Rijswijcklaan,2023-06-24,06:00:00,19,6,13,FMN 11 A Jan Van Rijswijcklaan Ringfietspad
658,Ringfietspad Jan Van Rijswijcklaan,2023-06-24,07:00:00,18,7,11,FMN 11 A Jan Van Rijswijcklaan Ringfietspad
658,Ringfietspad Jan Van Rijswijcklaan,2023-06-24,08:00:00,30,16,14,FMN 11 A Jan Van Rijswijcklaan Ringfietspad
658,Ringfietspad Jan Van Rijswijcklaan,2023-06-24,09:00:00,54,17,37,FMN 11 A Jan Van Rijswijcklaan Ringfietspad
658,Ringfietspad Jan Van Rijswijcklaan,2023-06-24,10:00:00,65,31,34,FMN 11 A Jan Van Rijswijcklaan Ringfietspad
658,Ringfietspad Jan Van Rijswijcklaan,2023-06-24,11:00:00,81,40,41,FMN 11 A Jan Van Rijswijcklaan Ringfietspad
658,Ringfietspad Jan Van Rijswijcklaan,2023-06-24,12:00:00,76,37,39,FMN 11 A Jan Van Rijswijcklaan Ringfietspad
658,Ringfietspad Jan Van Rijswijcklaan,2023-06-24,13:00:00,95,46,49,FMN 11 A Jan Van Rijswijcklaan Ringfietspad
658,Ringfietspad Jan Van Rijswijcklaan,2023-06-24,14:00:00,114,59,55,FMN 11 A Jan Van Rijswijcklaan Ringfietspad
658,Ringfietspad Jan Van Rijswijcklaan,2023-06-24,15:00:00,112,65,47,FMN 11 A Jan Van Rijswijcklaan Ringfietspad
658,Ringfietspad Jan Van Rijswijcklaan,2023-06-24,16:00:00,99,62,37,FMN 11 A Jan Van Rijswijcklaan Ringfietspad
658,Ringfietspad Jan Van Rijswijcklaan,2023-06-24,17:00:00,66,50,16,FMN 11 A Jan Van Rijswijcklaan Ringfietspad
658,Ringfietspad Jan Van Rijswijcklaan,2023-06-24,18:00:00,57,31,26,FMN 11 A Jan Van Rijswijcklaan Ringfietspad
658,Ringfietspad Jan Van Rijswijcklaan,2023-06-24,19:00:00,43,23,20,FMN 11 A Jan Van Rijswijcklaan Ringfietspad
658,Ringfietspad Jan Van Rijswijcklaan,2023-06-24,20:00:00,42,19,23,FMN 11 A Jan Van Rijswijcklaan Ringfietspad
658,Ringfietspad Jan Van Rijswijcklaan,2023-06-24,21:00:00,21,10,11,FMN 11 A Jan Van Rijswijcklaan Ringfietspad
658,Ringfietspad Jan Van Rijswijcklaan,2023-06-24,22:00:00,12,9,3,FMN 11 A Jan Van Rijswijcklaan Ringfietspad
658,Ringfietspad Jan Van Rijswijcklaan,2023-06-24,23:00:00,9,5,4,FMN 11 A Jan Van Rijswijcklaan Ringfietspad
658,Ringfietspad Jan Van Rijswijcklaan,2023-06-25,00:00:00,11,7,4,FMN 11 A Jan Van Rijswijcklaan Ringfietspad
658,Ringfietspad Jan Van Rijswijcklaan,2023-06-25,01:00:00,9,5,4,FMN 11 A Jan Van Rijswijcklaan Ringfietspad
658,Ringfietspad Jan Van Rijswijcklaan,2023-06-25,02:00:00,1,1,0,FMN 11 A Jan Van Rijswijcklaan Ringfietspad
658,Ringfietspad Jan Van Rijswijcklaan,2023-06-25,03:00:00,0,0,0,FMN 11 A Jan Van Rijswijcklaan Ringfietspad
658,Ringfietspad Jan Van Rijswijcklaan,2023-06-25,04:00:00,0,0,0,FMN 11 A Jan Van Rijswijcklaan Ringfietspad
658,Ringfietspad Jan Van Rijswijcklaan,2023-06-25,05:00:00,5,2,3,FMN 11 A Jan Van Rijswijcklaan Ringfietspad
658,Ringfietspad Jan Van Rijswijcklaan,2023-06-25,06:00:00,6,2,4,FMN 11 A Jan Van Rijswijcklaan Ringfietspad
658,Ringfietspad Jan Van Rijswijcklaan,2023-06-25,07:00:00,14,7,7,FMN 11 A Jan Van Rijswijcklaan Ringfietspad
658,Ringfietspad Jan Van Rijswijcklaan,2023-06-25,08:00:00,21,8,13,FMN 11 A Jan Van Rijswijcklaan Ringfietspad
658,Ringfietspad Jan Van Rijswijcklaan,2023-06-25,09:00:00,49,18,31,FMN 11 A Jan Van Rijswijcklaan Ringfietspad
658,Ringfietspad Jan Van Rijswijcklaan,2023-06-25,10:00:00,63,26,37,FMN 11 A Jan Van Rijswijcklaan Ringfietspad
658,Ringfietspad Jan Van Rijswijcklaan,2023-06-25,11:00:00,74,35,39,FMN 11 A Jan Van Rijswijcklaan Ringfietspad
658,Ringfietspad Jan Van Rijswijcklaan,2023-06-25,12:00:00,95,46,49,FMN 11 A Jan Van Rijswijcklaan Ringfietspad
658,Ringfietspad Jan Van Rijswijcklaan,2023-06-25,13:00:00,84,39,45,FMN 11 A Jan Van Rijswijcklaan Ringfietspad
658,Ringfietspad Jan Van Rijswijcklaan,2023-06-25,14:00:00,109,52,57,FMN 11 A Jan Van Rijswijcklaan Ringfietspad
658,Ringfietspad Jan Van Rijswijcklaan,2023-06-25,15:00:00,92,53,39,FMN 11 A Jan Van Rijswijcklaan Ringfietspad
658,Ringfietspad Jan Van Rijswijcklaan,2023-06-25,16:00:00,82,50,32,FMN 11 A Jan Van Rijswijcklaan Ringfietspad
658,Ringfietspad Jan Van Rijswijcklaan,2023-06-25,17:00:00,54,33,21,FMN 11 A Jan Van Rijswijcklaan Ringfietspad
658,Ringfietspad Jan Van Rijswijcklaan,2023-06-25,18:00:00,41,24,17,FMN 11 A Jan Van Rijswijcklaan Ringfietspad
658,Ringfietspad Jan Van Rijswijcklaan,2023-06-25,19:00:00,26,13,13,FMN 11 A Jan Van Rijswijcklaan Ringfietspad
658,Ringfietspad Jan Van Rijswijcklaan,2023-06-25,20:00:00,30,14,16,FMN 11 A Jan Van Rijswijcklaan Ringfietspad
658,Ringfietspad Jan Van Rijswijcklaan,2023-06-25,21:00:00,13,3,10,FMN 11 A Jan Van Rijswijcklaan Ringfietspad
658,Ringfietspad Jan Van Rijswijcklaan,2023-06-25,22:00:00,12,8,4,FMN 11 A Jan Van Rijswijcklaan Ringfietspad
658,Ringfietspad Jan Van Rijswijcklaan,2023-06-25,23:00:00,4,2,2,FMN 11 A Jan Van Rijswijcklaan Ringfietspad
658,Ringfietspad Jan Van Rijswijcklaan,2023-06-26,00:00:00,4,4,0,FMN 11 A Jan Van Rijswijcklaan Ringfietspad
658,Ringfietspad Jan Van Rijswijcklaan,2023-06-26,01:00:00,0,0,0,FMN 11 A Jan Van Rijswijcklaan Ringfietspad
658,Ringfietspad Jan Van Rijswijcklaan,2023-06-26,02:00:00,1,1,0,FMN 11 A Jan Van Rijswijcklaan Ringfietspad
658,Ringfietspad Jan Van Rijswijcklaan,2023-06-26,03:00:00,3,3,0,FMN 11 A Jan Van Rijswijcklaan Ringfietspad
658,Ringfietspad Jan Van Rijswijcklaan,2023-06-26,04:00:00,6,2,4,FMN 11 A Jan Van Rijswijcklaan Ringfietspad
658,Ringfietspad Jan Van Rijswijcklaan,2023-06-26,05:00:00,14,4,10,FMN 11 A Jan Van Rijswijcklaan Ringfietspad
658,Ringfietspad Jan Van Rijswijcklaan,2023-06-26,06:00:00,61,17,44,FMN 11 A Jan Van Rijswijcklaan Ringfietspad
658,Ringfietspad Jan Van Rijswijcklaan,2023-06-26,07:00:00,135,51,84,FMN 11 A Jan Van Rijswijcklaan Ringfietspad
658,Ringfietspad Jan Van Rijswijcklaan,2023-06-26,08:00:00,186,61,125,FMN 11 A Jan Van Rijswijcklaan Ringfietspad
658,Ringfietspad Jan Van Rijswijcklaan,2023-06-26,09:00:00,66,21,45,FMN 11 A Jan Van Rijswijcklaan Ringfietspad
658,Ringfietspad Jan Van Rijswijcklaan,2023-06-26,10:00:00,41,15,26,FMN 11 A Jan Van Rijswijcklaan Ringfietspad
658,Ringfietspad Jan Van Rijswijcklaan,2023-06-26,11:00:00,48,22,26,FMN 11 A Jan Van Rijswijcklaan Ringfietspad
658,Ringfietspad Jan Van Rijswijcklaan,2023-06-26,12:00:00,69,31,38,FMN 11 A Jan Van Rijswijcklaan Ringfietspad
658,Ringfietspad Jan Van Rijswijcklaan,2023-06-26,13:00:00,63,31,32,FMN 11 A Jan Van Rijswijcklaan Ringfietspad
658,Ringfietspad Jan Van Rijswijcklaan,2023-06-26,14:00:00,72,43,29,FMN 11 A Jan Van Rijswijcklaan Ringfietspad
658,Ringfietspad Jan Van Rijswijcklaan,2023-06-26,15:00:00,101,65,36,FMN 11 A Jan Van Rijswijcklaan Ringfietspad
658,Ringfietspad Jan Van Rijswijcklaan,2023-06-26,16:00:00,163,112,51,FMN 11 A Jan Van Rijswijcklaan Ringfietspad
658,Ringfietspad Jan Van Rijswijcklaan,2023-06-26,17:00:00,178,118,60,FMN 11 A Jan Van Rijswijcklaan Ringfietspad
658,Ringfietspad Jan Van Rijswijcklaan,2023-06-26,18:00:00,94,60,34,FMN 11 A Jan Van Rijswijcklaan Ringfietspad
658,Ringfietspad Jan Van Rijswijcklaan,2023-06-26,19:00:00,47,23,24,FMN 11 A Jan Van Rijswijcklaan Ringfietspad
658,Ringfietspad Jan Van Rijswijcklaan,2023-06-26,20:00:00,32,16,16,FMN 11 A Jan Van Rijswijcklaan Ringfietspad
658,Ringfietspad Jan Van Rijswijcklaan,2023-06-26,21:00:00,15,5,10,FMN 11 A Jan Van Rijswijcklaan Ringfietspad
658,Ringfietspad Jan Van Rijswijcklaan,2023-06-26,22:00:00,17,12,5,FMN 11 A Jan Van Rijswijcklaan Ringfietspad
658,Ringfietspad Jan Van Rijswijcklaan,2023-06-26,23:00:00,7,5,2,FMN 11 A Jan Van Rijswijcklaan Ringfietspad
658,Ringfietspad Jan Van Rijswijcklaan,2023-06-27,00:00:00,1,0,1,FMN 11 A Jan Van Rijswijcklaan Ringfietspad
658,Ringfietspad Jan Van Rijswijcklaan,2023-06-27,01:00:00,2,1,1,FMN 11 A Jan Van Rijswijcklaan Ringfietspad
658,Ringfietspad Jan Van Rijswijcklaan,2023-06-27,02:00:00,0,0,0,FMN 11 A Jan Van Rijswijcklaan Ringfietspad
658,Ringfietspad Jan Van Rijswijcklaan,2023-06-27,03:00:00,3,2,1,FMN 11 A Jan Van Rijswijcklaan Ringfietspad
658,Ringfietspad Jan Van Rijswijcklaan,2023-06-27,04:00:00,11,4,7,FMN 11 A Jan Van Rijswijcklaan Ringfietspad
658,Ringfietspad Jan Van Rijswijcklaan,2023-06-27,05:00:00,31,11,20,FMN 11 A Jan Van Rijswijcklaan Ringfietspad
658,Ringfietspad Jan Van Rijswijcklaan,2023-06-27,06:00:00,74,24,50,FMN 11 A Jan Van Rijswijcklaan Ringfietspad
658,Ringfietspad Jan Van Rijswijcklaan,2023-06-27,07:00:00,153,53,100,FMN 11 A Jan Van Rijswijcklaan Ringfietspad
658,Ringfietspad Jan Van Rijswijcklaan,2023-06-27,08:00:00,193,60,133,FMN 11 A Jan Van Rijswijcklaan Ringfietspad
658,Ringfietspad Jan Van Rijswijcklaan,2023-06-27,09:00:00,75,32,43,FMN 11 A Jan Van Rijswijcklaan Ringfietspad
658,Ringfietspad Jan Van Rijswijcklaan,2023-06-27,10:00:00,42,21,21,FMN 11 A Jan Van Rijswijcklaan Ringfietspad
658,Ringfietspad Jan Van Rijswijcklaan,2023-06-27,11:00:00,49,24,25,FMN 11 A Jan Van Rijswijcklaan Ringfietspad
658,Ringfietspad Jan Van Rijswijcklaan,2023-06-27,12:00:00,53,30,23,FMN 11 A Jan Van Rijswijcklaan Ringfietspad
658,Ringfietspad Jan Van Rijswijcklaan,2023-06-27,13:00:00,68,37,31,FMN 11 A Jan Van Rijswijcklaan Ringfietspad
658,Ringfietspad Jan Van Rijswijcklaan,2023-06-27,14:00:00,70,44,26,FMN 11 A Jan Van Rijswijcklaan Ringfietspad
658,Ringfietspad Jan Van Rijswijcklaan,2023-06-27,15:00:00,114,79,35,FMN 11 A Jan Van Rijswijcklaan Ringfietspad
658,Ringfietspad Jan Van Rijswijcklaan,2023-06-27,16:00:00,171,114,57,FMN 11 A Jan Van Rijswijcklaan Ringfietspad
658,Ringfietspad Jan Van Rijswijcklaan,2023-06-27,17:00:00,190,129,61,FMN 11 A Jan Van Rijswijcklaan Ringfietspad
658,Ringfietspad Jan Van Rijswijcklaan,2023-06-27,18:00:00,124,75,49,FMN 11 A Jan Van Rijswijcklaan Ringfietspad
658,Ringfietspad Jan Van Rijswijcklaan,2023-06-27,19:00:00,36,20,16,FMN 11 A Jan Van Rijswijcklaan Ringfietspad
658,Ringfietspad Jan Van Rijswijcklaan,2023-06-27,20:00:00,37,14,23,FMN 11 A Jan Van Rijswijcklaan Ringfietspad
658,Ringfietspad Jan Van Rijswijcklaan,2023-06-27,21:00:00,23,10,13,FMN 11 A Jan Van Rijswijcklaan Ringfietspad
658,Ringfietspad Jan Van Rijswijcklaan,2023-06-27,22:00:00,25,16,9,FMN 11 A Jan Van Rijswijcklaan Ringfietspad
658,Ringfietspad Jan Van Rijswijcklaan,2023-06-27,23:00:00,9,4,5,FMN 11 A Jan Van Rijswijcklaan Ringfietspad
658,Ringfietspad Jan Van Rijswijcklaan,2023-06-28,00:00:00,3,3,0,FMN 11 A Jan Van Rijswijcklaan Ringfietspad
658,Ringfietspad Jan Van Rijswijcklaan,2023-06-28,01:00:00,0,0,0,FMN 11 A Jan Van Rijswijcklaan Ringfietspad
658,Ringfietspad Jan Van Rijswijcklaan,2023-06-28,02:00:00,3,1,2,FMN 11 A Jan Van Rijswijcklaan Ringfietspad
658,Ringfietspad Jan Van Rijswijcklaan,2023-06-28,03:00:00,0,0,0,FMN 11 A Jan Van Rijswijcklaan Ringfietspad
658,Ringfietspad Jan Van Rijswijcklaan,2023-06-28,04:00:00,4,1,3,FMN 11 A Jan Van Rijswijcklaan Ringfietspad
658,Ringfietspad Jan Van Rijswijcklaan,2023-06-28,05:00:00,27,8,19,FMN 11 A Jan Van Rijswijcklaan Ringfietspad
658,Ringfietspad Jan Van Rijswijcklaan,2023-06-28,06:00:00,64,16,48,FMN 11 A Jan Van Rijswijcklaan Ringfietspad
658,Ringfietspad Jan Van Rijswijcklaan,2023-06-28,07:00:00,136,53,83,FMN 11 A Jan Van Rijswijcklaan Ringfietspad
658,Ringfietspad Jan Van Rijswijcklaan,2023-06-28,08:00:00,151,55,96,FMN 11 A Jan Van Rijswijcklaan Ringfietspad
658,Ringfietspad Jan Van Rijswijcklaan,2023-06-28,09:00:00,56,21,35,FMN 11 A Jan Van Rijswijcklaan Ringfietspad
658,Ringfietspad Jan Van Rijswijcklaan,2023-06-28,10:00:00,42,18,24,FMN 11 A Jan Van Rijswijcklaan Ringfietspad
658,Ringfietspad Jan Van Rijswijcklaan,2023-06-28,11:00:00,54,22,32,FMN 11 A Jan Van Rijswijcklaan Ringfietspad
658,Ringfietspad Jan Van Rijswijcklaan,2023-06-28,12:00:00,75,38,37,FMN 11 A Jan Van Rijswijcklaan Ringfietspad
658,Ringfietspad Jan Van Rijswijcklaan,2023-06-28,13:00:00,72,36,36,FMN 11 A Jan Van Rijswijcklaan Ringfietspad
658,Ringfietspad Jan Van Rijswijcklaan,2023-06-28,14:00:00,80,42,38,FMN 11 A Jan Van Rijswijcklaan Ringfietspad
658,Ringfietspad Jan Van Rijswijcklaan,2023-06-28,15:00:00,93,59,34,FMN 11 A Jan Van Rijswijcklaan Ringfietspad
658,Ringfietspad Jan Van Rijswijcklaan,2023-06-28,16:00:00,160,106,54,FMN 11 A Jan Van Rijswijcklaan Ringfietspad
658,Ringfietspad Jan Van Rijswijcklaan,2023-06-28,17:00:00,154,101,53,FMN 11 A Jan Van Rijswijcklaan Ringfietspad
658,Ringfietspad Jan Van Rijswijcklaan,2023-06-28,18:00:00,98,62,36,FMN 11 A Jan Van Rijswijcklaan Ringfietspad
658,Ringfietspad Jan Van Rijswijcklaan,2023-06-28,19:00:00,46,22,24,FMN 11 A Jan Van Rijswijcklaan Ringfietspad
658,Ringfietspad Jan Van Rijswijcklaan,2023-06-28,20:00:00,32,16,16,FMN 11 A Jan Van Rijswijcklaan Ringfietspad
658,Ringfietspad Jan Van Rijswijcklaan,2023-06-28,21:00:00,31,20,11,FMN 11 A Jan Van Rijswijcklaan Ringfietspad
658,Ringfietspad Jan Van Rijswijcklaan,2023-06-28,22:00:00,18,9,9,FMN 11 A Jan Van Rijswijcklaan Ringfietspad
658,Ringfietspad Jan Van Rijswijcklaan,2023-06-28,23:00:00,9,5,4,FMN 11 A Jan Van Rijswijcklaan Ringfietspad
658,Ringfietspad Jan Van Rijswijcklaan,2023-06-29,00:00:00,2,2,0,FMN 11 A Jan Van Rijswijcklaan Ringfietspad
658,Ringfietspad Jan Van Rijswijcklaan,2023-06-29,01:00:00,1,0,1,FMN 11 A Jan Van Rijswijcklaan Ringfietspad
658,Ringfietspad Jan Van Rijswijcklaan,2023-06-29,02:00:00,3,2,1,FMN 11 A Jan Van Rijswijcklaan Ringfietspad
658,Ringfietspad Jan Van Rijswijcklaan,2023-06-29,03:00:00,3,3,0,FMN 11 A Jan Van Rijswijcklaan Ringfietspad
658,Ringfietspad Jan Van Rijswijcklaan,2023-06-29,04:00:00,11,6,5,FMN 11 A Jan Van Rijswijcklaan Ringfietspad
658,Ringfietspad Jan Van Rijswijcklaan,2023-06-29,05:00:00,29,6,23,FMN 11 A Jan Van Rijswijcklaan Ringfietspad
658,Ringfietspad Jan Van Rijswijcklaan,2023-06-29,06:00:00,65,14,51,FMN 11 A Jan Van Rijswijcklaan Ringfietspad
658,Ringfietspad Jan Van Rijswijcklaan,2023-06-29,07:00:00,121,43,78,FMN 11 A Jan Van Rijswijcklaan Ringfietspad
658,Ringfietspad Jan Van Rijswijcklaan,2023-06-29,08:00:00,161,55,106,FMN 11 A Jan Van Rijswijcklaan Ringfietspad
658,Ringfietspad Jan Van Rijswijcklaan,2023-06-29,09:00:00,56,21,35,FMN 11 A Jan Van Rijswijcklaan Ringfietspad
658,Ringfietspad Jan Van Rijswijcklaan,2023-06-29,10:00:00,37,18,19,FMN 11 A Jan Van Rijswijcklaan Ringfietspad
658,Ringfietspad Jan Van Rijswijcklaan,2023-06-29,11:00:00,45,27,18,FMN 11 A Jan Van Rijswijcklaan Ringfietspad
658,Ringfietspad Jan Van Rijswijcklaan,2023-06-29,12:00:00,54,23,31,FMN 11 A Jan Van Rijswijcklaan Ringfietspad
658,Ringfietspad Jan Van Rijswijcklaan,2023-06-29,13:00:00,63,34,29,FMN 11 A Jan Van Rijswijcklaan Ringfietspad
658,Ringfietspad Jan Van Rijswijcklaan,2023-06-29,14:00:00,62,36,26,FMN 11 A Jan Van Rijswijcklaan Ringfietspad
658,Ringfietspad Jan Van Rijswijcklaan,2023-06-29,15:00:00,103,66,37,FMN 11 A Jan Van Rijswijcklaan Ringfietspad
658,Ringfietspad Jan Van Rijswijcklaan,2023-06-29,16:00:00,145,91,54,FMN 11 A Jan Van Rijswijcklaan Ringfietspad
658,Ringfietspad Jan Van Rijswijcklaan,2023-06-29,17:00:00,157,98,59,FMN 11 A Jan Van Rijswijcklaan Ringfietspad
658,Ringfietspad Jan Van Rijswijcklaan,2023-06-29,18:00:00,84,46,38,FMN 11 A Jan Van Rijswijcklaan Ringfietspad
658,Ringfietspad Jan Van Rijswijcklaan,2023-06-29,19:00:00,47,29,18,FMN 11 A Jan Van Rijswijcklaan Ringfietspad
658,Ringfietspad Jan Van Rijswijcklaan,2023-06-29,20:00:00,35,19,16,FMN 11 A Jan Van Rijswijcklaan Ringfietspad
658,Ringfietspad Jan Van Rijswijcklaan,2023-06-29,21:00:00,25,13,12,FMN 11 A Jan Van Rijswijcklaan Ringfietspad
658,Ringfietspad Jan Van Rijswijcklaan,2023-06-29,22:00:00,28,18,10,FMN 11 A Jan Van Rijswijcklaan Ringfietspad
658,Ringfietspad Jan Van Rijswijcklaan,2023-06-29,23:00:00,12,7,5,FMN 11 A Jan Van Rijswijcklaan Ringfietspad
658,Ringfietspad Jan Van Rijswijcklaan,2023-06-30,00:00:00,4,1,3,FMN 11 A Jan Van Rijswijcklaan Ringfietspad
658,Ringfietspad Jan Van Rijswijcklaan,2023-06-30,01:00:00,2,0,2,FMN 11 A Jan Van Rijswijcklaan Ringfietspad
658,Ringfietspad Jan Van Rijswijcklaan,2023-06-30,02:00:00,0,0,0,FMN 11 A Jan Van Rijswijcklaan Ringfietspad
658,Ringfietspad Jan Van Rijswijcklaan,2023-06-30,03:00:00,4,4,0,FMN 11 A Jan Van Rijswijcklaan Ringfietspad
658,Ringfietspad Jan Van Rijswijcklaan,2023-06-30,04:00:00,4,0,4,FMN 11 A Jan Van Rijswijcklaan Ringfietspad
658,Ringfietspad Jan Van Rijswijcklaan,2023-06-30,05:00:00,19,3,16,FMN 11 A Jan Van Rijswijcklaan Ringfietspad
658,Ringfietspad Jan Van Rijswijcklaan,2023-06-30,06:00:00,58,15,43,FMN 11 A Jan Van Rijswijcklaan Ringfietspad
658,Ringfietspad Jan Van Rijswijcklaan,2023-06-30,07:00:00,123,42,81,FMN 11 A Jan Van Rijswijcklaan Ringfietspad
658,Ringfietspad Jan Van Rijswijcklaan,2023-06-30,08:00:00,161,58,103,FMN 11 A Jan Van Rijswijcklaan Ringfietspad
658,Ringfietspad Jan Van Rijswijcklaan,2023-06-30,09:00:00,80,26,54,FMN 11 A Jan Van Rijswijcklaan Ringfietspad
658,Ringfietspad Jan Van Rijswijcklaan,2023-06-30,10:00:00,48,28,20,FMN 11 A Jan Van Rijswijcklaan Ringfietspad
658,Ringfietspad Jan Van Rijswijcklaan,2023-06-30,11:00:00,44,15,29,FMN 11 A Jan Van Rijswijcklaan Ringfietspad
658,Ringfietspad Jan Van Rijswijcklaan,2023-06-30,12:00:00,60,31,29,FMN 11 A Jan Van Rijswijcklaan Ringfietspad
658,Ringfietspad Jan Van Rijswijcklaan,2023-06-30,13:00:00,72,40,32,FMN 11 A Jan Van Rijswijcklaan Ringfietspad
658,Ringfietspad Jan Van Rijswijcklaan,2023-06-30,14:00:00,81,48,33,FMN 11 A Jan Van Rijswijcklaan Ringfietspad
658,Ringfietspad Jan Van Rijswijcklaan,2023-06-30,15:00:00,116,71,45,FMN 11 A Jan Van Rijswijcklaan Ringfietspad
658,Ringfietspad Jan Van Rijswijcklaan,2023-06-30,16:00:00,161,105,56,FMN 11 A Jan Van Rijswijcklaan Ringfietspad
658,Ringfietspad Jan Van Rijswijcklaan,2023-06-30,17:00:00,129,87,42,FMN 11 A Jan Van Rijswijcklaan Ringfietspad
658,Ringfietspad Jan Van Rijswijcklaan,2023-06-30,18:00:00,78,48,30,FMN 11 A Jan Van Rijswijcklaan Ringfietspad
658,Ringfietspad Jan Van Rijswijcklaan,2023-06-30,19:00:00,53,28,25,FMN 11 A Jan Van Rijswijcklaan Ringfietspad
658,Ringfietspad Jan Van Rijswijcklaan,2023-06-30,20:00:00,31,16,15,FMN 11 A Jan Van Rijswijcklaan Ringfietspad
658,Ringfietspad Jan Van Rijswijcklaan,2023-06-30,21:00:00,18,10,8,FMN 11 A Jan Van Rijswijcklaan Ringfietspad
658,Ringfietspad Jan Van Rijswijcklaan,2023-06-30,22:00:00,22,10,12,FMN 11 A Jan Van Rijswijcklaan Ringfietspad
658,Ringfietspad Jan Van Rijswijcklaan,2023-06-30,23:00:00,17,11,6,FMN 11 A Jan Van Rijswijcklaan Ringfietspad
658,Ringfietspad Jan Van Rijswijcklaan,2023-07-01,00:00:00,6,3,3,FMN 11 A Jan Van Rijswijcklaan Ringfietspad
658,Ringfietspad Jan Van Rijswijcklaan,2023-07-01,01:00:00,5,2,3,FMN 11 A Jan Van Rijswijcklaan Ringfietspad
658,Ringfietspad Jan Van Rijswijcklaan,2023-07-01,02:00:00,3,2,1,FMN 11 A Jan Van Rijswijcklaan Ringfietspad
658,Ringfietspad Jan Van Rijswijcklaan,2023-07-01,03:00:00,3,2,1,FMN 11 A Jan Van Rijswijcklaan Ringfietspad
658,Ringfietspad Jan Van Rijswijcklaan,2023-07-01,04:00:00,4,2,2,FMN 11 A Jan Van Rijswijcklaan Ringfietspad
658,Ringfietspad Jan Van Rijswijcklaan,2023-07-01,05:00:00,4,2,2,FMN 11 A Jan Van Rijswijcklaan Ringfietspad
658,Ringfietspad Jan Van Rijswijcklaan,2023-07-01,06:00:00,7,3,4,FMN 11 A Jan Van Rijswijcklaan Ringfietspad
658,Ringfietspad Jan Van Rijswijcklaan,2023-07-01,07:00:00,7,4,3,FMN 11 A Jan Van Rijswijcklaan Ringfietspad
658,Ringfietspad Jan Van Rijswijcklaan,2023-07-01,08:00:00,11,4,7,FMN 11 A Jan Van Rijswijcklaan Ringfietspad
658,Ringfietspad Jan Van Rijswijcklaan,2023-07-01,09:00:00,30,11,19,FMN 11 A Jan Van Rijswijcklaan Ringfietspad
658,Ringfietspad Jan Van Rijswijcklaan,2023-07-01,10:00:00,37,15,22,FMN 11 A Jan Van Rijswijcklaan Ringfietspad
658,Ringfietspad Jan Van Rijswijcklaan,2023-07-01,11:00:00,37,19,18,FMN 11 A Jan Van Rijswijcklaan Ringfietspad
658,Ringfietspad Jan Van Rijswijcklaan,2023-07-01,12:00:00,38,19,19,FMN 11 A Jan Van Rijswijcklaan Ringfietspad
658,Ringfietspad Jan Van Rijswijcklaan,2023-07-01,13:00:00,48,28,20,FMN 11 A Jan Van Rijswijcklaan Ringfietspad
658,Ringfietspad Jan Van Rijswijcklaan,2023-07-01,14:00:00,61,30,31,FMN 11 A Jan Van Rijswijcklaan Ringfietspad
658,Ringfietspad Jan Van Rijswijcklaan,2023-07-01,15:00:00,54,35,19,FMN 11 A Jan Van Rijswijcklaan Ringfietspad
658,Ringfietspad Jan Van Rijswijcklaan,2023-07-01,16:00:00,46,31,15,FMN 11 A Jan Van Rijswijcklaan Ringfietspad
658,Ringfietspad Jan Van Rijswijcklaan,2023-07-01,17:00:00,32,19,13,FMN 11 A Jan Van Rijswijcklaan Ringfietspad
658,Ringfietspad Jan Van Rijswijcklaan,2023-07-01,18:00:00,40,24,16,FMN 11 A Jan Van Rijswijcklaan Ringfietspad
658,Ringfietspad Jan Van Rijswijcklaan,2023-07-01,19:00:00,16,9,7,FMN 11 A Jan Van Rijswijcklaan Ringfietspad
658,Ringfietspad Jan Van Rijswijcklaan,2023-07-01,20:00:00,11,8,3,FMN 11 A Jan Van Rijswijcklaan Ringfietspad
658,Ringfietspad Jan Van Rijswijcklaan,2023-07-01,21:00:00,6,2,4,FMN 11 A Jan Van Rijswijcklaan Ringfietspad
658,Ringfietspad Jan Van Rijswijcklaan,2023-07-01,22:00:00,11,7,4,FMN 11 A Jan Van Rijswijcklaan Ringfietspad
658,Ringfietspad Jan Van Rijswijcklaan,2023-07-01,23:00:00,7,3,4,FMN 11 A Jan Van Rijswijcklaan Ringfietspad
658,Ringfietspad Jan Van Rijswijcklaan,2023-07-02,00:00:00,5,1,4,FMN 11 A Jan Van Rijswijcklaan Ringfietspad
658,Ringfietspad Jan Van Rijswijcklaan,2023-07-02,01:00:00,6,4,2,FMN 11 A Jan Van Rijswijcklaan Ringfietspad
658,Ringfietspad Jan Van Rijswijcklaan,2023-07-02,02:00:00,4,3,1,FMN 11 A Jan Van Rijswijcklaan Ringfietspad
658,Ringfietspad Jan Van Rijswijcklaan,2023-07-02,03:00:00,0,0,0,FMN 11 A Jan Van Rijswijcklaan Ringfietspad
658,Ringfietspad Jan Van Rijswijcklaan,2023-07-02,04:00:00,1,0,1,FMN 11 A Jan Van Rijswijcklaan Ringfietspad
658,Ringfietspad Jan Van Rijswijcklaan,2023-07-02,05:00:00,4,1,3,FMN 11 A Jan Van Rijswijcklaan Ringfietspad
658,Ringfietspad Jan Van Rijswijcklaan,2023-07-02,06:00:00,2,2,0,FMN 11 A Jan Van Rijswijcklaan Ringfietspad
658,Ringfietspad Jan Van Rijswijcklaan,2023-07-02,07:00:00,13,9,4,FMN 11 A Jan Van Rijswijcklaan Ringfietspad
658,Ringfietspad Jan Van Rijswijcklaan,2023-07-02,08:00:00,21,10,11,FMN 11 A Jan Van Rijswijcklaan Ringfietspad
658,Ringfietspad Jan Van Rijswijcklaan,2023-07-02,09:00:00,50,18,32,FMN 11 A Jan Van Rijswijcklaan Ringfietspad
658,Ringfietspad Jan Van Rijswijcklaan,2023-07-02,10:00:00,59,20,39,FMN 11 A Jan Van Rijswijcklaan Ringfietspad
658,Ringfietspad Jan Van Rijswijcklaan,2023-07-02,11:00:00,47,20,27,FMN 11 A Jan Van Rijswijcklaan Ringfietspad
658,Ringfietspad Jan Van Rijswijcklaan,2023-07-02,12:00:00,66,39,27,FMN 11 A Jan Van Rijswijcklaan Ringfietspad
658,Ringfietspad Jan Van Rijswijcklaan,2023-07-02,13:00:00,68,33,35,FMN 11 A Jan Van Rijswijcklaan Ringfietspad
658,Ringfietspad Jan Van Rijswijcklaan,2023-07-02,14:00:00,87,45,42,FMN 11 A Jan Van Rijswijcklaan Ringfietspad
658,Ringfietspad Jan Van Rijswijcklaan,2023-07-02,15:00:00,72,42,30,FMN 11 A Jan Van Rijswijcklaan Ringfietspad
658,Ringfietspad Jan Van Rijswijcklaan,2023-07-02,16:00:00,79,47,32,FMN 11 A Jan Van Rijswijcklaan Ringfietspad
658,Ringfietspad Jan Van Rijswijcklaan,2023-07-02,17:00:00,60,29,31,FMN 11 A Jan Van Rijswijcklaan Ringfietspad
658,Ringfietspad Jan Van Rijswijcklaan,2023-07-02,18:00:00,39,21,18,FMN 11 A Jan Van Rijswijcklaan Ringfietspad
658,Ringfietspad Jan Van Rijswijcklaan,2023-07-02,19:00:00,27,20,7,FMN 11 A Jan Van Rijswijcklaan Ringfietspad
658,Ringfietspad Jan Van Rijswijcklaan,2023-07-02,20:00:00,18,8,10,FMN 11 A Jan Van Rijswijcklaan Ringfietspad
658,Ringfietspad Jan Van Rijswijcklaan,2023-07-02,21:00:00,11,8,3,FMN 11 A Jan Van Rijswijcklaan Ringfietspad
658,Ringfietspad Jan Van Rijswijcklaan,2023-07-02,22:00:00,6,4,2,FMN 11 A Jan Van Rijswijcklaan Ringfietspad
658,Ringfietspad Jan Van Rijswijcklaan,2023-07-02,23:00:00,3,2,1,FMN 11 A Jan Van Rijswijcklaan Ringfietspad
658,Ringfietspad Jan Van Rijswijcklaan,2023-07-03,00:00:00,1,1,0,FMN 11 A Jan Van Rijswijcklaan Ringfietspad
658,Ringfietspad Jan Van Rijswijcklaan,2023-07-03,01:00:00,0,0,0,FMN 11 A Jan Van Rijswijcklaan Ringfietspad
658,Ringfietspad Jan Van Rijswijcklaan,2023-07-03,02:00:00,2,1,1,FMN 11 A Jan Van Rijswijcklaan Ringfietspad
658,Ringfietspad Jan Van Rijswijcklaan,2023-07-03,03:00:00,1,0,1,FMN 11 A Jan Van Rijswijcklaan Ringfietspad
658,Ringfietspad Jan Van Rijswijcklaan,2023-07-03,04:00:00,8,4,4,FMN 11 A Jan Van Rijswijcklaan Ringfietspad
658,Ringfietspad Jan Van Rijswijcklaan,2023-07-03,05:00:00,27,5,22,FMN 11 A Jan Van Rijswijcklaan Ringfietspad
658,Ringfietspad Jan Van Rijswijcklaan,2023-07-03,06:00:00,53,12,41,FMN 11 A Jan Van Rijswijcklaan Ringfietspad
658,Ringfietspad Jan Van Rijswijcklaan,2023-07-03,07:00:00,103,36,67,FMN 11 A Jan Van Rijswijcklaan Ringfietspad
658,Ringfietspad Jan Van Rijswijcklaan,2023-07-03,08:00:00,131,40,91,FMN 11 A Jan Van Rijswijcklaan Ringfietspad
658,Ringfietspad Jan Van Rijswijcklaan,2023-07-03,09:00:00,44,14,30,FMN 11 A Jan Van Rijswijcklaan Ringfietspad
658,Ringfietspad Jan Van Rijswijcklaan,2023-07-03,10:00:00,36,15,21,FMN 11 A Jan Van Rijswijcklaan Ringfietspad
658,Ringfietspad Jan Van Rijswijcklaan,2023-07-03,11:00:00,20,7,13,FMN 11 A Jan Van Rijswijcklaan Ringfietspad
658,Ringfietspad Jan Van Rijswijcklaan,2023-07-03,12:00:00,44,20,24,FMN 11 A Jan Van Rijswijcklaan Ringfietspad
658,Ringfietspad Jan Van Rijswijcklaan,2023-07-03,13:00:00,54,27,27,FMN 11 A Jan Van Rijswijcklaan Ringfietspad
658,Ringfietspad Jan Van Rijswijcklaan,2023-07-03,14:00:00,53,23,30,FMN 11 A Jan Van Rijswijcklaan Ringfietspad
658,Ringfietspad Jan Van Rijswijcklaan,2023-07-03,15:00:00,76,43,33,FMN 11 A Jan Van Rijswijcklaan Ringfietspad
658,Ringfietspad Jan Van Rijswijcklaan,2023-07-03,16:00:00,109,73,36,FMN 11 A Jan Van Rijswijcklaan Ringfietspad
658,Ringfietspad Jan Van Rijswijcklaan,2023-07-03,17:00:00,123,87,36,FMN 11 A Jan Van Rijswijcklaan Ringfietspad
658,Ringfietspad Jan Van Rijswijcklaan,2023-07-03,18:00:00,72,42,30,FMN 11 A Jan Van Rijswijcklaan Ringfietspad
658,Ringfietspad Jan Van Rijswijcklaan,2023-07-03,19:00:00,27,12,15,FMN 11 A Jan Van Rijswijcklaan Ringfietspad
658,Ringfietspad Jan Van Rijswijcklaan,2023-07-03,20:00:00,14,9,5,FMN 11 A Jan Van Rijswijcklaan Ringfietspad
658,Ringfietspad Jan Van Rijswijcklaan,2023-07-03,21:00:00,21,10,11,FMN 11 A Jan Van Rijswijcklaan Ringfietspad
658,Ringfietspad Jan Van Rijswijcklaan,2023-07-03,22:00:00,21,14,7,FMN 11 A Jan Van Rijswijcklaan Ringfietspad
658,Ringfietspad Jan Van Rijswijcklaan,2023-07-03,23:00:00,7,5,2,FMN 11 A Jan Van Rijswijcklaan Ringfietspad
658,Ringfietspad Jan Van Rijswijcklaan,2023-07-04,00:00:00,3,3,0,FMN 11 A Jan Van Rijswijcklaan Ringfietspad
658,Ringfietspad Jan Van Rijswijcklaan,2023-07-04,01:00:00,0,0,0,FMN 11 A Jan Van Rijswijcklaan Ringfietspad
658,Ringfietspad Jan Van Rijswijcklaan,2023-07-04,02:00:00,1,0,1,FMN 11 A Jan Van Rijswijcklaan Ringfietspad
658,Ringfietspad Jan Van Rijswijcklaan,2023-07-04,03:00:00,2,1,1,FMN 11 A Jan Van Rijswijcklaan Ringfietspad
658,Ringfietspad Jan Van Rijswijcklaan,2023-07-04,04:00:00,10,3,7,FMN 11 A Jan Van Rijswijcklaan Ringfietspad
658,Ringfietspad Jan Van Rijswijcklaan,2023-07-04,05:00:00,24,8,16,FMN 11 A Jan Van Rijswijcklaan Ringfietspad
658,Ringfietspad Jan Van Rijswijcklaan,2023-07-04,06:00:00,57,17,40,FMN 11 A Jan Van Rijswijcklaan Ringfietspad
658,Ringfietspad Jan Van Rijswijcklaan,2023-07-04,07:00:00,101,34,67,FMN 11 A Jan Van Rijswijcklaan Ringfietspad
658,Ringfietspad Jan Van Rijswijcklaan,2023-07-04,08:00:00,152,52,100,FMN 11 A Jan Van Rijswijcklaan Ringfietspad
658,Ringfietspad Jan Van Rijswijcklaan,2023-07-04,09:00:00,52,18,34,FMN 11 A Jan Van Rijswijcklaan Ringfietspad
658,Ringfietspad Jan Van Rijswijcklaan,2023-07-04,10:00:00,29,16,13,FMN 11 A Jan Van Rijswijcklaan Ringfietspad
658,Ringfietspad Jan Van Rijswijcklaan,2023-07-04,11:00:00,28,13,15,FMN 11 A Jan Van Rijswijcklaan Ringfietspad
658,Ringfietspad Jan Van Rijswijcklaan,2023-07-04,12:00:00,48,23,25,FMN 11 A Jan Van Rijswijcklaan Ringfietspad
658,Ringfietspad Jan Van Rijswijcklaan,2023-07-04,13:00:00,47,15,32,FMN 11 A Jan Van Rijswijcklaan Ringfietspad
658,Ringfietspad Jan Van Rijswijcklaan,2023-07-04,14:00:00,52,25,27,FMN 11 A Jan Van Rijswijcklaan Ringfietspad
658,Ringfietspad Jan Van Rijswijcklaan,2023-07-04,15:00:00,70,44,26,FMN 11 A Jan Van Rijswijcklaan Ringfietspad
658,Ringfietspad Jan Van Rijswijcklaan,2023-07-04,16:00:00,131,86,45,FMN 11 A Jan Van Rijswijcklaan Ringfietspad
658,Ringfietspad Jan Van Rijswijcklaan,2023-07-04,17:00:00,134,94,40,FMN 11 A Jan Van Rijswijcklaan Ringfietspad
658,Ringfietspad Jan Van Rijswijcklaan,2023-07-04,18:00:00,77,48,29,FMN 11 A Jan Van Rijswijcklaan Ringfietspad
658,Ringfietspad Jan Van Rijswijcklaan,2023-07-04,19:00:00,40,21,19,FMN 11 A Jan Van Rijswijcklaan Ringfietspad
658,Ringfietspad Jan Van Rijswijcklaan,2023-07-04,20:00:00,29,13,16,FMN 11 A Jan Van Rijswijcklaan Ringfietspad
658,Ringfietspad Jan Van Rijswijcklaan,2023-07-04,21:00:00,19,6,13,FMN 11 A Jan Van Rijswijcklaan Ringfietspad
658,Ringfietspad Jan Van Rijswijcklaan,2023-07-04,22:00:00,16,11,5,FMN 11 A Jan Van Rijswijcklaan Ringfietspad
658,Ringfietspad Jan Van Rijswijcklaan,2023-07-04,23:00:00,4,3,1,FMN 11 A Jan Van Rijswijcklaan Ringfietspad
658,Ringfietspad Jan Van Rijswijcklaan,2023-07-05,00:00:00,5,5,0,FMN 11 A Jan Van Rijswijcklaan Ringfietspad
658,Ringfietspad Jan Van Rijswijcklaan,2023-07-05,01:00:00,1,1,0,FMN 11 A Jan Van Rijswijcklaan Ringfietspad
658,Ringfietspad Jan Van Rijswijcklaan,2023-07-05,02:00:00,2,1,1,FMN 11 A Jan Van Rijswijcklaan Ringfietspad
658,Ringfietspad Jan Van Rijswijcklaan,2023-07-05,03:00:00,1,1,0,FMN 11 A Jan Van Rijswijcklaan Ringfietspad
658,Ringfietspad Jan Van Rijswijcklaan,2023-07-05,04:00:00,7,4,3,FMN 11 A Jan Van Rijswijcklaan Ringfietspad
658,Ringfietspad Jan Van Rijswijcklaan,2023-07-05,05:00:00,19,10,9,FMN 11 A Jan Van Rijswijcklaan Ringfietspad
658,Ringfietspad Jan Van Rijswijcklaan,2023-07-05,06:00:00,47,10,37,FMN 11 A Jan Van Rijswijcklaan Ringfietspad
658,Ringfietspad Jan Van Rijswijcklaan,2023-07-05,07:00:00,93,36,57,FMN 11 A Jan Van Rijswijcklaan Ringfietspad
658,Ringfietspad Jan Van Rijswijcklaan,2023-07-05,08:00:00,90,37,53,FMN 11 A Jan Van Rijswijcklaan Ringfietspad
658,Ringfietspad Jan Van Rijswijcklaan,2023-07-05,09:00:00,35,10,25,FMN 11 A Jan Van Rijswijcklaan Ringfietspad
658,Ringfietspad Jan Van Rijswijcklaan,2023-07-05,10:00:00,29,14,15,FMN 11 A Jan Van Rijswijcklaan Ringfietspad
658,Ringfietspad Jan Van Rijswijcklaan,2023-07-05,11:00:00,26,9,17,FMN 11 A Jan Van Rijswijcklaan Ringfietspad
658,Ringfietspad Jan Van Rijswijcklaan,2023-07-05,12:00:00,53,28,25,FMN 11 A Jan Van Rijswijcklaan Ringfietspad
658,Ringfietspad Jan Van Rijswijcklaan,2023-07-05,13:00:00,39,20,19,FMN 11 A Jan Van Rijswijcklaan Ringfietspad
658,Ringfietspad Jan Van Rijswijcklaan,2023-07-05,14:00:00,41,20,21,FMN 11 A Jan Van Rijswijcklaan Ringfietspad
658,Ringfietspad Jan Van Rijswijcklaan,2023-07-05,15:00:00,62,40,22,FMN 11 A Jan Van Rijswijcklaan Ringfietspad
658,Ringfietspad Jan Van Rijswijcklaan,2023-07-05,16:00:00,96,67,29,FMN 11 A Jan Van Rijswijcklaan Ringfietspad
658,Ringfietspad Jan Van Rijswijcklaan,2023-07-05,17:00:00,103,68,35,FMN 11 A Jan Van Rijswijcklaan Ringfietspad
658,Ringfietspad Jan Van Rijswijcklaan,2023-07-05,18:00:00,51,34,17,FMN 11 A Jan Van Rijswijcklaan Ringfietspad
658,Ringfietspad Jan Van Rijswijcklaan,2023-07-05,19:00:00,32,16,16,FMN 11 A Jan Van Rijswijcklaan Ringfietspad
658,Ringfietspad Jan Van Rijswijcklaan,2023-07-05,20:00:00,26,12,14,FMN 11 A Jan Van Rijswijcklaan Ringfietspad
658,Ringfietspad Jan Van Rijswijcklaan,2023-07-05,21:00:00,12,6,6,FMN 11 A Jan Van Rijswijcklaan Ringfietspad
658,Ringfietspad Jan Van Rijswijcklaan,2023-07-05,22:00:00,10,9,1,FMN 11 A Jan Van Rijswijcklaan Ringfietspad
658,Ringfietspad Jan Van Rijswijcklaan,2023-07-05,23:00:00,7,3,4,FMN 11 A Jan Van Rijswijcklaan Ringfietspad
658,Ringfietspad Jan Van Rijswijcklaan,2023-07-06,00:00:00,1,0,1,FMN 11 A Jan Van Rijswijcklaan Ringfietspad
658,Ringfietspad Jan Van Rijswijcklaan,2023-07-06,01:00:00,1,1,0,FMN 11 A Jan Van Rijswijcklaan Ringfietspad
658,Ringfietspad Jan Van Rijswijcklaan,2023-07-06,02:00:00,1,1,0,FMN 11 A Jan Van Rijswijcklaan Ringfietspad
658,Ringfietspad Jan Van Rijswijcklaan,2023-07-06,03:00:00,1,1,0,FMN 11 A Jan Van Rijswijcklaan Ringfietspad
658,Ringfietspad Jan Van Rijswijcklaan,2023-07-06,04:00:00,12,3,9,FMN 11 A Jan Van Rijswijcklaan Ringfietspad
658,Ringfietspad Jan Van Rijswijcklaan,2023-07-06,05:00:00,29,12,17,FMN 11 A Jan Van Rijswijcklaan Ringfietspad
658,Ringfietspad Jan Van Rijswijcklaan,2023-07-06,06:00:00,62,12,50,FMN 11 A Jan Van Rijswijcklaan Ringfietspad
658,Ringfietspad Jan Van Rijswijcklaan,2023-07-06,07:00:00,104,35,69,FMN 11 A Jan Van Rijswijcklaan Ringfietspad
658,Ringfietspad Jan Van Rijswijcklaan,2023-07-06,08:00:00,161,52,109,FMN 11 A Jan Van Rijswijcklaan Ringfietspad
658,Ringfietspad Jan Van Rijswijcklaan,2023-07-06,09:00:00,58,22,36,FMN 11 A Jan Van Rijswijcklaan Ringfietspad
658,Ringfietspad Jan Van Rijswijcklaan,2023-07-06,10:00:00,38,15,23,FMN 11 A Jan Van Rijswijcklaan Ringfietspad
658,Ringfietspad Jan Van Rijswijcklaan,2023-07-06,11:00:00,43,19,24,FMN 11 A Jan Van Rijswijcklaan Ringfietspad
658,Ringfietspad Jan Van Rijswijcklaan,2023-07-06,12:00:00,56,25,31,FMN 11 A Jan Van Rijswijcklaan Ringfietspad
658,Ringfietspad Jan Van Rijswijcklaan,2023-07-06,13:00:00,52,26,26,FMN 11 A Jan Van Rijswijcklaan Ringfietspad
658,Ringfietspad Jan Van Rijswijcklaan,2023-07-06,14:00:00,72,40,32,FMN 11 A Jan Van Rijswijcklaan Ringfietspad
658,Ringfietspad Jan Van Rijswijcklaan,2023-07-06,15:00:00,99,68,31,FMN 11 A Jan Van Rijswijcklaan Ringfietspad
658,Ringfietspad Jan Van Rijswijcklaan,2023-07-06,16:00:00,139,95,44,FMN 11 A Jan Van Rijswijcklaan Ringfietspad
658,Ringfietspad Jan Van Rijswijcklaan,2023-07-06,17:00:00,146,98,48,FMN 11 A Jan Van Rijswijcklaan Ringfietspad
658,Ringfietspad Jan Van Rijswijcklaan,2023-07-06,18:00:00,85,47,38,FMN 11 A Jan Van Rijswijcklaan Ringfietspad
658,Ringfietspad Jan Van Rijswijcklaan,2023-07-06,19:00:00,42,27,15,FMN 11 A Jan Van Rijswijcklaan Ringfietspad
658,Ringfietspad Jan Van Rijswijcklaan,2023-07-06,20:00:00,26,15,11,FMN 11 A Jan Van Rijswijcklaan Ringfietspad
658,Ringfietspad Jan Van Rijswijcklaan,2023-07-06,21:00:00,19,10,9,FMN 11 A Jan Van Rijswijcklaan Ringfietspad
658,Ringfietspad Jan Van Rijswijcklaan,2023-07-06,22:00:00,16,10,6,FMN 11 A Jan Van Rijswijcklaan Ringfietspad
658,Ringfietspad Jan Van Rijswijcklaan,2023-07-06,23:00:00,5,3,2,FMN 11 A Jan Van Rijswijcklaan Ringfietspad
658,Ringfietspad Jan Van Rijswijcklaan,2023-07-07,00:00:00,3,1,2,FMN 11 A Jan Van Rijswijcklaan Ringfietspad
658,Ringfietspad Jan Van Rijswijcklaan,2023-07-07,01:00:00,2,1,1,FMN 11 A Jan Van Rijswijcklaan Ringfietspad
658,Ringfietspad Jan Van Rijswijcklaan,2023-07-07,02:00:00,1,1,0,FMN 11 A Jan Van Rijswijcklaan Ringfietspad
658,Ringfietspad Jan Van Rijswijcklaan,2023-07-07,03:00:00,3,1,2,FMN 11 A Jan Van Rijswijcklaan Ringfietspad
658,Ringfietspad Jan Van Rijswijcklaan,2023-07-07,04:00:00,9,5,4,FMN 11 A Jan Van Rijswijcklaan Ringfietspad
658,Ringfietspad Jan Van Rijswijcklaan,2023-07-07,05:00:00,15,4,11,FMN 11 A Jan Van Rijswijcklaan Ringfietspad
658,Ringfietspad Jan Van Rijswijcklaan,2023-07-07,06:00:00,63,13,50,FMN 11 A Jan Van Rijswijcklaan Ringfietspad
658,Ringfietspad Jan Van Rijswijcklaan,2023-07-07,07:00:00,104,31,73,FMN 11 A Jan Van Rijswijcklaan Ringfietspad
658,Ringfietspad Jan Van Rijswijcklaan,2023-07-07,08:00:00,154,55,99,FMN 11 A Jan Van Rijswijcklaan Ringfietspad
658,Ringfietspad Jan Van Rijswijcklaan,2023-07-07,09:00:00,50,16,34,FMN 11 A Jan Van Rijswijcklaan Ringfietspad
658,Ringfietspad Jan Van Rijswijcklaan,2023-07-07,10:00:00,51,23,28,FMN 11 A Jan Van Rijswijcklaan Ringfietspad
658,Ringfietspad Jan Van Rijswijcklaan,2023-07-07,11:00:00,33,13,20,FMN 11 A Jan Van Rijswijcklaan Ringfietspad
658,Ringfietspad Jan Van Rijswijcklaan,2023-07-07,12:00:00,70,31,39,FMN 11 A Jan Van Rijswijcklaan Ringfietspad
658,Ringfietspad Jan Van Rijswijcklaan,2023-07-07,13:00:00,55,22,33,FMN 11 A Jan Van Rijswijcklaan Ringfietspad
658,Ringfietspad Jan Van Rijswijcklaan,2023-07-07,14:00:00,68,42,26,FMN 11 A Jan Van Rijswijcklaan Ringfietspad
658,Ringfietspad Jan Van Rijswijcklaan,2023-07-07,15:00:00,92,62,30,FMN 11 A Jan Van Rijswijcklaan Ringfietspad
658,Ringfietspad Jan Van Rijswijcklaan,2023-07-07,16:00:00,129,86,43,FMN 11 A Jan Van Rijswijcklaan Ringfietspad
658,Ringfietspad Jan Van Rijswijcklaan,2023-07-07,17:00:00,114,68,46,FMN 11 A Jan Van Rijswijcklaan Ringfietspad
658,Ringfietspad Jan Van Rijswijcklaan,2023-07-07,18:00:00,67,44,23,FMN 11 A Jan Van Rijswijcklaan Ringfietspad
658,Ringfietspad Jan Van Rijswijcklaan,2023-07-07,19:00:00,39,19,20,FMN 11 A Jan Van Rijswijcklaan Ringfietspad
658,Ringfietspad Jan Van Rijswijcklaan,2023-07-07,20:00:00,20,9,11,FMN 11 A Jan Van Rijswijcklaan Ringfietspad
658,Ringfietspad Jan Van Rijswijcklaan,2023-07-07,21:00:00,17,9,8,FMN 11 A Jan Van Rijswijcklaan Ringfietspad
658,Ringfietspad Jan Van Rijswijcklaan,2023-07-07,22:00:00,24,17,7,FMN 11 A Jan Van Rijswijcklaan Ringfietspad
658,Ringfietspad Jan Van Rijswijcklaan,2023-07-07,23:00:00,11,4,7,FMN 11 A Jan Van Rijswijcklaan Ringfietspad
658,Ringfietspad Jan Van Rijswijcklaan,2023-07-08,00:00:00,11,3,8,FMN 11 A Jan Van Rijswijcklaan Ringfietspad
658,Ringfietspad Jan Van Rijswijcklaan,2023-07-08,01:00:00,8,6,2,FMN 11 A Jan Van Rijswijcklaan Ringfietspad
658,Ringfietspad Jan Van Rijswijcklaan,2023-07-08,02:00:00,0,0,0,FMN 11 A Jan Van Rijswijcklaan Ringfietspad
658,Ringfietspad Jan Van Rijswijcklaan,2023-07-08,03:00:00,3,3,0,FMN 11 A Jan Van Rijswijcklaan Ringfietspad
658,Ringfietspad Jan Van Rijswijcklaan,2023-07-08,04:00:00,5,2,3,FMN 11 A Jan Van Rijswijcklaan Ringfietspad
658,Ringfietspad Jan Van Rijswijcklaan,2023-07-08,05:00:00,10,3,7,FMN 11 A Jan Van Rijswijcklaan Ringfietspad
658,Ringfietspad Jan Van Rijswijcklaan,2023-07-08,06:00:00,15,7,8,FMN 11 A Jan Van Rijswijcklaan Ringfietspad
658,Ringfietspad Jan Van Rijswijcklaan,2023-07-08,07:00:00,9,6,3,FMN 11 A Jan Van Rijswijcklaan Ringfietspad
658,Ringfietspad Jan Van Rijswijcklaan,2023-07-08,08:00:00,23,7,16,FMN 11 A Jan Van Rijswijcklaan Ringfietspad
658,Ringfietspad Jan Van Rijswijcklaan,2023-07-08,09:00:00,43,24,19,FMN 11 A Jan Van Rijswijcklaan Ringfietspad
658,Ringfietspad Jan Van Rijswijcklaan,2023-07-08,10:00:00,59,32,27,FMN 11 A Jan Van Rijswijcklaan Ringfietspad
658,Ringfietspad Jan Van Rijswijcklaan,2023-07-08,11:00:00,53,31,22,FMN 11 A Jan Van Rijswijcklaan Ringfietspad
658,Ringfietspad Jan Van Rijswijcklaan,2023-07-08,12:00:00,63,31,32,FMN 11 A Jan Van Rijswijcklaan Ringfietspad
658,Ringfietspad Jan Van Rijswijcklaan,2023-07-08,13:00:00,74,36,38,FMN 11 A Jan Van Rijswijcklaan Ringfietspad
658,Ringfietspad Jan Van Rijswijcklaan,2023-07-08,14:00:00,84,42,42,FMN 11 A Jan Van Rijswijcklaan Ringfietspad
658,Ringfietspad Jan Van Rijswijcklaan,2023-07-08,15:00:00,78,41,37,FMN 11 A Jan Van Rijswijcklaan Ringfietspad
658,Ringfietspad Jan Van Rijswijcklaan,2023-07-08,16:00:00,74,43,31,FMN 11 A Jan Van Rijswijcklaan Ringfietspad
658,Ringfietspad Jan Van Rijswijcklaan,2023-07-08,17:00:00,61,37,24,FMN 11 A Jan Van Rijswijcklaan Ringfietspad
658,Ringfietspad Jan Van Rijswijcklaan,2023-07-08,18:00:00,35,20,15,FMN 11 A Jan Van Rijswijcklaan Ringfietspad
658,Ringfietspad Jan Van Rijswijcklaan,2023-07-08,19:00:00,36,23,13,FMN 11 A Jan Van Rijswijcklaan Ringfietspad
658,Ringfietspad Jan Van Rijswijcklaan,2023-07-08,20:00:00,21,9,12,FMN 11 A Jan Van Rijswijcklaan Ringfietspad
658,Ringfietspad Jan Van Rijswijcklaan,2023-07-08,21:00:00,21,15,6,FMN 11 A Jan Van Rijswijcklaan Ringfietspad
658,Ringfietspad Jan Van Rijswijcklaan,2023-07-08,22:00:00,9,6,3,FMN 11 A Jan Van Rijswijcklaan Ringfietspad
658,Ringfietspad Jan Van Rijswijcklaan,2023-07-08,23:00:00,12,8,4,FMN 11 A Jan Van Rijswijcklaan Ringfietspad
658,Ringfietspad Jan Van Rijswijcklaan,2023-07-09,00:00:00,6,3,3,FMN 11 A Jan Van Rijswijcklaan Ringfietspad
658,Ringfietspad Jan Van Rijswijcklaan,2023-07-09,01:00:00,2,1,1,FMN 11 A Jan Van Rijswijcklaan Ringfietspad
658,Ringfietspad Jan Van Rijswijcklaan,2023-07-09,02:00:00,3,2,1,FMN 11 A Jan Van Rijswijcklaan Ringfietspad
658,Ringfietspad Jan Van Rijswijcklaan,2023-07-09,03:00:00,2,2,0,FMN 11 A Jan Van Rijswijcklaan Ringfietspad
658,Ringfietspad Jan Van Rijswijcklaan,2023-07-09,04:00:00,2,0,2,FMN 11 A Jan Van Rijswijcklaan Ringfietspad
658,Ringfietspad Jan Van Rijswijcklaan,2023-07-09,05:00:00,1,1,0,FMN 11 A Jan Van Rijswijcklaan Ringfietspad
658,Ringfietspad Jan Van Rijswijcklaan,2023-07-09,06:00:00,5,3,2,FMN 11 A Jan Van Rijswijcklaan Ringfietspad
658,Ringfietspad Jan Van Rijswijcklaan,2023-07-09,07:00:00,3,1,2,FMN 11 A Jan Van Rijswijcklaan Ringfietspad
658,Ringfietspad Jan Van Rijswijcklaan,2023-07-09,08:00:00,14,5,9,FMN 11 A Jan Van Rijswijcklaan Ringfietspad
658,Ringfietspad Jan Van Rijswijcklaan,2023-07-09,09:00:00,35,12,23,FMN 11 A Jan Van Rijswijcklaan Ringfietspad
658,Ringfietspad Jan Van Rijswijcklaan,2023-07-09,10:00:00,46,19,27,FMN 11 A Jan Van Rijswijcklaan Ringfietspad
658,Ringfietspad Jan Van Rijswijcklaan,2023-07-09,11:00:00,54,27,27,FMN 11 A Jan Van Rijswijcklaan Ringfietspad
658,Ringfietspad Jan Van Rijswijcklaan,2023-07-09,12:00:00,53,29,24,FMN 11 A Jan Van Rijswijcklaan Ringfietspad
658,Ringfietspad Jan Van Rijswijcklaan,2023-07-09,13:00:00,59,27,32,FMN 11 A Jan Van Rijswijcklaan Ringfietspad
658,Ringfietspad Jan Van Rijswijcklaan,2023-07-09,14:00:00,74,35,39,FMN 11 A Jan Van Rijswijcklaan Ringfietspad
658,Ringfietspad Jan Van Rijswijcklaan,2023-07-09,15:00:00,62,42,20,FMN 11 A Jan Van Rijswijcklaan Ringfietspad
658,Ringfietspad Jan Van Rijswijcklaan,2023-07-09,16:00:00,46,31,15,FMN 11 A Jan Van Rijswijcklaan Ringfietspad
658,Ringfietspad Jan Van Rijswijcklaan,2023-07-09,17:00:00,42,28,14,FMN 11 A Jan Van Rijswijcklaan Ringfietspad
658,Ringfietspad Jan Van Rijswijcklaan,2023-07-09,18:00:00,34,22,12,FMN 11 A Jan Van Rijswijcklaan Ringfietspad
658,Ringfietspad Jan Van Rijswijcklaan,2023-07-09,19:00:00,22,15,7,FMN 11 A Jan Van Rijswijcklaan Ringfietspad
658,Ringfietspad Jan Van Rijswijcklaan,2023-07-09,20:00:00,17,10,7,FMN 11 A Jan Van Rijswijcklaan Ringfietspad
658,Ringfietspad Jan Van Rijswijcklaan,2023-07-09,21:00:00,12,4,8,FMN 11 A Jan Van Rijswijcklaan Ringfietspad
658,Ringfietspad Jan Van Rijswijcklaan,2023-07-09,22:00:00,7,5,2,FMN 11 A Jan Van Rijswijcklaan Ringfietspad
658,Ringfietspad Jan Van Rijswijcklaan,2023-07-09,23:00:00,4,2,2,FMN 11 A Jan Van Rijswijcklaan Ringfietspad
658,Ringfietspad Jan Van Rijswijcklaan,2023-07-10,00:00:00,2,1,1,FMN 11 A Jan Van Rijswijcklaan Ringfietspad
658,Ringfietspad Jan Van Rijswijcklaan,2023-07-10,01:00:00,1,0,1,FMN 11 A Jan Van Rijswijcklaan Ringfietspad
658,Ringfietspad Jan Van Rijswijcklaan,2023-07-10,02:00:00,0,0,0,FMN 11 A Jan Van Rijswijcklaan Ringfietspad
658,Ringfietspad Jan Van Rijswijcklaan,2023-07-10,03:00:00,2,0,2,FMN 11 A Jan Van Rijswijcklaan Ringfietspad
658,Ringfietspad Jan Van Rijswijcklaan,2023-07-10,04:00:00,4,4,0,FMN 11 A Jan Van Rijswijcklaan Ringfietspad
658,Ringfietspad Jan Van Rijswijcklaan,2023-07-10,05:00:00,15,5,10,FMN 11 A Jan Van Rijswijcklaan Ringfietspad
658,Ringfietspad Jan Van Rijswijcklaan,2023-07-10,06:00:00,50,7,43,FMN 11 A Jan Van Rijswijcklaan Ringfietspad
658,Ringfietspad Jan Van Rijswijcklaan,2023-07-10,07:00:00,92,29,63,FMN 11 A Jan Van Rijswijcklaan Ringfietspad
658,Ringfietspad Jan Van Rijswijcklaan,2023-07-10,08:00:00,140,55,85,FMN 11 A Jan Van Rijswijcklaan Ringfietspad
658,Ringfietspad Jan Van Rijswijcklaan,2023-07-10,09:00:00,52,18,34,FMN 11 A Jan Van Rijswijcklaan Ringfietspad
658,Ringfietspad Jan Van Rijswijcklaan,2023-07-10,10:00:00,32,13,19,FMN 11 A Jan Van Rijswijcklaan Ringfietspad
658,Ringfietspad Jan Van Rijswijcklaan,2023-07-10,11:00:00,29,18,11,FMN 11 A Jan Van Rijswijcklaan Ringfietspad
658,Ringfietspad Jan Van Rijswijcklaan,2023-07-10,12:00:00,49,25,24,FMN 11 A Jan Van Rijswijcklaan Ringfietspad
658,Ringfietspad Jan Van Rijswijcklaan,2023-07-10,13:00:00,46,21,25,FMN 11 A Jan Van Rijswijcklaan Ringfietspad
658,Ringfietspad Jan Van Rijswijcklaan,2023-07-10,14:00:00,55,29,26,FMN 11 A Jan Van Rijswijcklaan Ringfietspad
658,Ringfietspad Jan Van Rijswijcklaan,2023-07-10,15:00:00,77,50,27,FMN 11 A Jan Van Rijswijcklaan Ringfietspad
658,Ringfietspad Jan Van Rijswijcklaan,2023-07-10,16:00:00,104,77,27,FMN 11 A Jan Van Rijswijcklaan Ringfietspad
658,Ringfietspad Jan Van Rijswijcklaan,2023-07-10,17:00:00,124,82,42,FMN 11 A Jan Van Rijswijcklaan Ringfietspad
658,Ringfietspad Jan Van Rijswijcklaan,2023-07-10,18:00:00,66,41,25,FMN 11 A Jan Van Rijswijcklaan Ringfietspad
658,Ringfietspad Jan Van Rijswijcklaan,2023-07-10,19:00:00,36,17,19,FMN 11 A Jan Van Rijswijcklaan Ringfietspad
658,Ringfietspad Jan Van Rijswijcklaan,2023-07-10,20:00:00,25,12,13,FMN 11 A Jan Van Rijswijcklaan Ringfietspad
658,Ringfietspad Jan Van Rijswijcklaan,2023-07-10,21:00:00,22,8,14,FMN 11 A Jan Van Rijswijcklaan Ringfietspad
658,Ringfietspad Jan Van Rijswijcklaan,2023-07-10,22:00:00,16,13,3,FMN 11 A Jan Van Rijswijcklaan Ringfietspad
658,Ringfietspad Jan Van Rijswijcklaan,2023-07-10,23:00:00,3,2,1,FMN 11 A Jan Van Rijswijcklaan Ringfietspad
658,Ringfietspad Jan Van Rijswijcklaan,2023-07-11,00:00:00,2,1,1,FMN 11 A Jan Van Rijswijcklaan Ringfietspad
658,Ringfietspad Jan Van Rijswijcklaan,2023-07-11,01:00:00,1,0,1,FMN 11 A Jan Van Rijswijcklaan Ringfietspad
658,Ringfietspad Jan Van Rijswijcklaan,2023-07-11,02:00:00,2,1,1,FMN 11 A Jan Van Rijswijcklaan Ringfietspad
658,Ringfietspad Jan Van Rijswijcklaan,2023-07-11,03:00:00,5,4,1,FMN 11 A Jan Van Rijswijcklaan Ringfietspad
658,Ringfietspad Jan Van Rijswijcklaan,2023-07-11,04:00:00,6,5,1,FMN 11 A Jan Van Rijswijcklaan Ringfietspad
658,Ringfietspad Jan Van Rijswijcklaan,2023-07-11,05:00:00,21,10,11,FMN 11 A Jan Van Rijswijcklaan Ringfietspad
658,Ringfietspad Jan Van Rijswijcklaan,2023-07-11,06:00:00,51,9,42,FMN 11 A Jan Van Rijswijcklaan Ringfietspad
658,Ringfietspad Jan Van Rijswijcklaan,2023-07-11,07:00:00,102,30,72,FMN 11 A Jan Van Rijswijcklaan Ringfietspad
658,Ringfietspad Jan Van Rijswijcklaan,2023-07-11,08:00:00,141,40,101,FMN 11 A Jan Van Rijswijcklaan Ringfietspad
658,Ringfietspad Jan Van Rijswijcklaan,2023-07-11,09:00:00,45,19,26,FMN 11 A Jan Van Rijswijcklaan Ringfietspad
658,Ringfietspad Jan Van Rijswijcklaan,2023-07-11,10:00:00,32,17,15,FMN 11 A Jan Van Rijswijcklaan Ringfietspad
658,Ringfietspad Jan Van Rijswijcklaan,2023-07-11,11:00:00,26,10,16,FMN 11 A Jan Van Rijswijcklaan Ringfietspad
658,Ringfietspad Jan Van Rijswijcklaan,2023-07-11,12:00:00,37,19,18,FMN 11 A Jan Van Rijswijcklaan Ringfietspad
658,Ringfietspad Jan Van Rijswijcklaan,2023-07-11,13:00:00,50,24,26,FMN 11 A Jan Van Rijswijcklaan Ringfietspad
658,Ringfietspad Jan Van Rijswijcklaan,2023-07-11,14:00:00,45,24,21,FMN 11 A Jan Van Rijswijcklaan Ringfietspad
658,Ringfietspad Jan Van Rijswijcklaan,2023-07-11,15:00:00,76,48,28,FMN 11 A Jan Van Rijswijcklaan Ringfietspad
658,Ringfietspad Jan Van Rijswijcklaan,2023-07-11,16:00:00,139,93,46,FMN 11 A Jan Van Rijswijcklaan Ringfietspad
658,Ringfietspad Jan Van Rijswijcklaan,2023-07-11,17:00:00,134,83,51,FMN 11 A Jan Van Rijswijcklaan Ringfietspad
658,Ringfietspad Jan Van Rijswijcklaan,2023-07-11,18:00:00,77,50,27,FMN 11 A Jan Van Rijswijcklaan Ringfietspad
658,Ringfietspad Jan Van Rijswijcklaan,2023-07-11,19:00:00,36,22,14,FMN 11 A Jan Van Rijswijcklaan Ringfietspad
658,Ringfietspad Jan Van Rijswijcklaan,2023-07-11,20:00:00,28,16,12,FMN 11 A Jan Van Rijswijcklaan Ringfietspad
658,Ringfietspad Jan Van Rijswijcklaan,2023-07-11,21:00:00,16,10,6,FMN 11 A Jan Van Rijswijcklaan Ringfietspad
658,Ringfietspad Jan Van Rijswijcklaan,2023-07-11,22:00:00,15,6,9,FMN 11 A Jan Van Rijswijcklaan Ringfietspad
658,Ringfietspad Jan Van Rijswijcklaan,2023-07-11,23:00:00,9,7,2,FMN 11 A Jan Van Rijswijcklaan Ringfietspad
658,Ringfietspad Jan Van Rijswijcklaan,2023-07-12,00:00:00,2,1,1,FMN 11 A Jan Van Rijswijcklaan Ringfietspad
658,Ringfietspad Jan Van Rijswijcklaan,2023-07-12,01:00:00,0,0,0,FMN 11 A Jan Van Rijswijcklaan Ringfietspad
658,Ringfietspad Jan Van Rijswijcklaan,2023-07-12,02:00:00,1,1,0,FMN 11 A Jan Van Rijswijcklaan Ringfietspad
658,Ringfietspad Jan Van Rijswijcklaan,2023-07-12,03:00:00,0,0,0,FMN 11 A Jan Van Rijswijcklaan Ringfietspad
658,Ringfietspad Jan Van Rijswijcklaan,2023-07-12,04:00:00,6,3,3,FMN 11 A Jan Van Rijswijcklaan Ringfietspad
658,Ringfietspad Jan Van Rijswijcklaan,2023-07-12,05:00:00,20,4,16,FMN 11 A Jan Van Rijswijcklaan Ringfietspad
658,Ringfietspad Jan Van Rijswijcklaan,2023-07-12,06:00:00,47,10,37,FMN 11 A Jan Van Rijswijcklaan Ringfietspad
658,Ringfietspad Jan Van Rijswijcklaan,2023-07-12,07:00:00,101,35,66,FMN 11 A Jan Van Rijswijcklaan Ringfietspad
658,Ringfietspad Jan Van Rijswijcklaan,2023-07-12,08:00:00,122,44,78,FMN 11 A Jan Van Rijswijcklaan Ringfietspad
658,Ringfietspad Jan Van Rijswijcklaan,2023-07-12,09:00:00,40,17,23,FMN 11 A Jan Van Rijswijcklaan Ringfietspad
658,Ringfietspad Jan Van Rijswijcklaan,2023-07-12,10:00:00,34,16,18,FMN 11 A Jan Van Rijswijcklaan Ringfietspad
658,Ringfietspad Jan Van Rijswijcklaan,2023-07-12,11:00:00,49,29,20,FMN 11 A Jan Van Rijswijcklaan Ringfietspad
658,Ringfietspad Jan Van Rijswijcklaan,2023-07-12,12:00:00,51,28,23,FMN 11 A Jan Van Rijswijcklaan Ringfietspad
658,Ringfietspad Jan Van Rijswijcklaan,2023-07-12,13:00:00,50,25,25,FMN 11 A Jan Van Rijswijcklaan Ringfietspad
658,Ringfietspad Jan Van Rijswijcklaan,2023-07-12,14:00:00,41,23,18,FMN 11 A Jan Van Rijswijcklaan Ringfietspad
658,Ringfietspad Jan Van Rijswijcklaan,2023-07-12,15:00:00,66,42,24,FMN 11 A Jan Van Rijswijcklaan Ringfietspad
658,Ringfietspad Jan Van Rijswijcklaan,2023-07-12,16:00:00,119,79,40,FMN 11 A Jan Van Rijswijcklaan Ringfietspad
658,Ringfietspad Jan Van Rijswijcklaan,2023-07-12,17:00:00,116,80,36,FMN 11 A Jan Van Rijswijcklaan Ringfietspad
658,Ringfietspad Jan Van Rijswijcklaan,2023-07-12,18:00:00,78,44,34,FMN 11 A Jan Van Rijswijcklaan Ringfietspad
658,Ringfietspad Jan Van Rijswijcklaan,2023-07-12,19:00:00,44,22,22,FMN 11 A Jan Van Rijswijcklaan Ringfietspad
658,Ringfietspad Jan Van Rijswijcklaan,2023-07-12,20:00:00,30,13,17,FMN 11 A Jan Van Rijswijcklaan Ringfietspad
658,Ringfietspad Jan Van Rijswijcklaan,2023-07-12,21:00:00,26,9,17,FMN 11 A Jan Van Rijswijcklaan Ringfietspad
658,Ringfietspad Jan Van Rijswijcklaan,2023-07-12,22:00:00,18,12,6,FMN 11 A Jan Van Rijswijcklaan Ringfietspad
658,Ringfietspad Jan Van Rijswijcklaan,2023-07-12,23:00:00,5,3,2,FMN 11 A Jan Van Rijswijcklaan Ringfietspad
658,Ringfietspad Jan Van Rijswijcklaan,2023-07-13,00:00:00,2,1,1,FMN 11 A Jan Van Rijswijcklaan Ringfietspad
658,Ringfietspad Jan Van Rijswijcklaan,2023-07-13,01:00:00,1,1,0,FMN 11 A Jan Van Rijswijcklaan Ringfietspad
658,Ringfietspad Jan Van Rijswijcklaan,2023-07-13,02:00:00,1,0,1,FMN 11 A Jan Van Rijswijcklaan Ringfietspad
658,Ringfietspad Jan Van Rijswijcklaan,2023-07-13,03:00:00,1,1,0,FMN 11 A Jan Van Rijswijcklaan Ringfietspad
658,Ringfietspad Jan Van Rijswijcklaan,2023-07-13,04:00:00,5,2,3,FMN 11 A Jan Van Rijswijcklaan Ringfietspad
658,Ringfietspad Jan Van Rijswijcklaan,2023-07-13,05:00:00,23,8,15,FMN 11 A Jan Van Rijswijcklaan Ringfietspad
658,Ringfietspad Jan Van Rijswijcklaan,2023-07-13,06:00:00,57,15,42,FMN 11 A Jan Van Rijswijcklaan Ringfietspad
658,Ringfietspad Jan Van Rijswijcklaan,2023-07-13,07:00:00,94,34,60,FMN 11 A Jan Van Rijswijcklaan Ringfietspad
658,Ringfietspad Jan Van Rijswijcklaan,2023-07-13,08:00:00,128,28,100,FMN 11 A Jan Van Rijswijcklaan Ringfietspad
658,Ringfietspad Jan Van Rijswijcklaan,2023-07-13,09:00:00,57,26,31,FMN 11 A Jan Van Rijswijcklaan Ringfietspad
658,Ringfietspad Jan Van Rijswijcklaan,2023-07-13,10:00:00,32,12,20,FMN 11 A Jan Van Rijswijcklaan Ringfietspad
658,Ringfietspad Jan Van Rijswijcklaan,2023-07-13,11:00:00,34,19,15,FMN 11 A Jan Van Rijswijcklaan Ringfietspad
658,Ringfietspad Jan Van Rijswijcklaan,2023-07-13,12:00:00,46,25,21,FMN 11 A Jan Van Rijswijcklaan Ringfietspad
658,Ringfietspad Jan Van Rijswijcklaan,2023-07-13,13:00:00,57,37,20,FMN 11 A Jan Van Rijswijcklaan Ringfietspad
658,Ringfietspad Jan Van Rijswijcklaan,2023-07-13,14:00:00,47,27,20,FMN 11 A Jan Van Rijswijcklaan Ringfietspad
658,Ringfietspad Jan Van Rijswijcklaan,2023-07-13,15:00:00,86,64,22,FMN 11 A Jan Van Rijswijcklaan Ringfietspad
658,Ringfietspad Jan Van Rijswijcklaan,2023-07-13,16:00:00,129,86,43,FMN 11 A Jan Van Rijswijcklaan Ringfietspad
658,Ringfietspad Jan Van Rijswijcklaan,2023-07-13,17:00:00,125,80,45,FMN 11 A Jan Van Rijswijcklaan Ringfietspad
658,Ringfietspad Jan Van Rijswijcklaan,2023-07-13,18:00:00,84,48,36,FMN 11 A Jan Van Rijswijcklaan Ringfietspad
658,Ringfietspad Jan Van Rijswijcklaan,2023-07-13,19:00:00,44,27,17,FMN 11 A Jan Van Rijswijcklaan Ringfietspad
658,Ringfietspad Jan Van Rijswijcklaan,2023-07-13,20:00:00,28,10,18,FMN 11 A Jan Van Rijswijcklaan Ringfietspad
658,Ringfietspad Jan Van Rijswijcklaan,2023-07-13,21:00:00,10,7,3,FMN 11 A Jan Van Rijswijcklaan Ringfietspad
658,Ringfietspad Jan Van Rijswijcklaan,2023-07-13,22:00:00,15,10,5,FMN 11 A Jan Van Rijswijcklaan Ringfietspad
658,Ringfietspad Jan Van Rijswijcklaan,2023-07-13,23:00:00,8,5,3,FMN 11 A Jan Van Rijswijcklaan Ringfietspad
